complexity,token_count,loc,lloc,sloc,comments,multi,blank,code_comment,h1,h2,N1,N2,vocabulary,length,calculated_length,volume,difficulty,effort,time,bugs,change_type,added,removed,introspection,object_changes,code_generation,library_loading,defect
19,473,182,127,129,0,0,53,182,5,39,21,42,44,63,217,343,2,926,51,0,0,80,0,170,62,16,132,1
19,473,1165,710,800,67,119,181,1232,18,243,153,282,261,435,2000,3492,10,36473,2026,1,0,80,0,180,62,17,133,1
12,234,1392,870,1177,35,17,170,1427,14,494,280,531,508,811,4473,7289,7,54850,3047,2,0,40,0,180,65,18,134,1
62,1372,773,419,590,28,0,166,801,10,204,113,217,214,330,1598,2554,5,13587,754,0,0,282,0,180,65,19,135,1
62,1372,421,273,302,44,34,57,465,17,81,59,107,98,166,583,1098,11,12329,684,0,0,282,0,180,65,20,136,1
9,297,182,127,129,0,0,53,182,5,39,21,42,44,63,217,343,2,926,51,0,0,51,0,190,69,22,144,1
43,971,1392,870,1177,35,17,170,1427,14,494,280,531,508,811,4473,7289,7,54850,3047,2,0,208,0,190,72,23,145,1
40,1319,773,419,590,28,0,166,801,10,204,113,217,214,330,1598,2554,5,13587,754,0,0,283,0,190,72,24,146,1
1,28,127,75,83,2,11,30,129,4,14,7,14,18,21,61,87,2,175,9,0,0,5,0,200,76,25,154,1
1,28,652,304,544,16,6,88,668,6,89,51,101,95,152,591,998,3,3399,188,0,0,5,0,200,77,25,155,1
1,28,2,2,2,0,0,0,2,0,0,0,0,0,0,0,0,0,0,0,0,0,5,0,200,77,25,155,1
1,28,8,5,5,0,0,3,8,0,0,0,0,0,0,0,0,0,0,0,0,0,5,0,200,77,25,156,1
1,28,2,2,2,0,0,0,2,0,0,0,0,0,0,0,0,0,0,0,0,0,5,0,200,77,25,156,1
1,28,14,8,8,0,0,6,14,0,0,0,0,0,0,0,0,0,0,0,0,0,5,0,200,77,25,157,1
1,28,6,4,4,0,0,2,6,0,0,0,0,0,0,0,0,0,0,0,0,0,5,0,200,77,25,158,1
1,28,6,4,4,0,0,2,6,1,2,1,2,3,3,2,4,0,2,0,0,0,5,0,200,77,25,159,1
1,28,6,4,4,0,0,2,6,0,0,0,0,0,0,0,0,0,0,0,0,0,5,0,200,77,25,160,1
1,28,7,5,5,0,0,2,7,0,0,0,0,0,0,0,0,0,0,0,0,0,5,0,200,77,25,161,1
1,28,6,4,4,0,0,2,6,0,0,0,0,0,0,0,0,0,0,0,0,0,5,0,200,77,25,162,1
1,28,10,6,6,0,0,4,10,0,0,0,0,0,0,0,0,0,0,0,0,0,5,0,200,77,25,163,1
1,28,1,1,1,0,0,0,1,0,0,0,0,0,0,0,0,0,0,0,0,0,5,0,200,77,25,163,1
1,28,14,10,10,0,0,4,14,1,1,1,1,2,2,0,2,0,1,0,0,0,5,0,200,77,25,164,1
1,28,46,26,30,3,0,12,49,3,6,3,6,9,9,20,28,1,42,2,0,0,5,0,210,77,25,165,1
307,7640,1455,414,1257,16,76,112,1471,5,41,23,46,46,69,231,381,2,1069,59,0,0,2672,0,210,78,25,166,1
307,7640,669,365,481,22,61,110,691,15,103,63,122,118,185,747,1273,8,11311,628,0,0,2672,0,220,78,26,167,1
25,593,1455,414,1257,16,76,112,1471,5,41,23,46,46,69,231,381,2,1069,59,0,0,2394,0,230,83,27,175,1
71,1529,127,75,83,2,11,30,129,4,14,7,14,18,21,61,87,2,175,9,0,0,240,0,250,88,28,195,1
71,1529,652,304,544,16,6,88,668,6,89,51,101,95,152,591,998,3,3399,188,0,0,240,0,250,89,28,196,1
71,1529,2,2,2,0,0,0,2,0,0,0,0,0,0,0,0,0,0,0,0,0,240,0,250,89,28,196,1
71,1529,8,5,5,0,0,3,8,0,0,0,0,0,0,0,0,0,0,0,0,0,240,0,250,89,28,197,1
71,1529,2,2,2,0,0,0,2,0,0,0,0,0,0,0,0,0,0,0,0,0,240,0,250,89,28,197,1
71,1529,14,8,8,0,0,6,14,0,0,0,0,0,0,0,0,0,0,0,0,0,240,0,250,89,28,198,1
71,1529,6,4,4,0,0,2,6,0,0,0,0,0,0,0,0,0,0,0,0,0,240,0,250,89,28,199,1
71,1529,6,4,4,0,0,2,6,1,2,1,2,3,3,2,4,0,2,0,0,0,240,0,250,89,28,200,1
71,1529,6,4,4,0,0,2,6,0,0,0,0,0,0,0,0,0,0,0,0,0,240,0,250,89,28,201,1
71,1529,7,5,5,0,0,2,7,0,0,0,0,0,0,0,0,0,0,0,0,0,240,0,250,89,28,202,1
71,1529,6,4,4,0,0,2,6,0,0,0,0,0,0,0,0,0,0,0,0,0,240,0,250,89,28,203,1
71,1529,10,6,6,0,0,4,10,0,0,0,0,0,0,0,0,0,0,0,0,0,240,0,250,89,28,204,1
71,1529,1,1,1,0,0,0,1,0,0,0,0,0,0,0,0,0,0,0,0,0,240,0,250,89,28,204,1
71,1529,14,10,10,0,0,4,14,1,1,1,1,2,2,0,2,0,1,0,0,0,240,0,250,89,28,205,1
71,1529,46,26,30,3,0,12,49,3,6,3,6,9,9,20,28,1,42,2,0,0,240,0,260,89,28,206,1
35,478,282,196,195,3,0,86,285,8,130,71,141,138,212,936,1507,4,6538,363,0,0,120,0,260,89,29,207,1
1,96,13,10,10,0,0,3,13,1,2,1,2,3,3,2,4,0,2,0,0,0,12,0,260,89,29,208,1
7,111,44,19,17,0,16,11,44,3,14,7,14,17,21,58,85,1,128,7,0,0,42,0,260,89,29,209,1
4,431,652,304,544,16,6,88,668,6,89,51,101,95,152,591,998,3,3399,188,0,0,74,0,260,90,29,210,1
19,557,14,9,9,0,0,5,14,0,0,0,0,0,0,0,0,0,0,0,0,0,102,0,270,94,30,218,1
19,557,16,9,9,0,0,7,16,0,0,0,0,0,0,0,0,0,0,0,0,0,102,0,270,94,30,219,1
17,403,1513,682,1277,25,13,200,1538,11,199,116,219,210,335,1557,2584,6,15641,868,0,0,74,0,290,104,32,234,1
17,403,819,519,539,24,98,155,843,15,96,57,106,111,163,690,1107,8,9171,509,0,0,74,0,300,106,32,235,1
14,747,1513,682,1277,25,13,200,1538,11,199,116,219,210,335,1557,2584,6,15641,868,0,0,129,0,310,112,33,243,1
7,179,1450,624,1228,12,26,181,1462,14,306,186,354,320,540,2580,4493,8,36391,2021,1,0,31,0,340,126,37,265,1
4,116,447,308,343,6,5,95,453,7,96,59,111,103,170,651,1136,4,4600,255,0,0,26,0,340,129,37,266,1
4,116,322,174,179,16,74,51,338,10,41,26,46,51,72,252,408,5,2291,127,0,0,26,0,340,132,38,267,1
23,383,1450,624,1228,12,26,181,1462,14,306,186,354,320,540,2580,4493,8,36391,2021,1,0,98,0,350,138,40,275,1
7,305,1513,682,1277,25,13,200,1538,11,199,116,219,210,335,1557,2584,6,15641,868,0,0,49,0,360,144,41,283,1
7,305,819,519,539,24,98,155,843,15,96,57,106,111,163,690,1107,8,9171,509,0,0,49,0,370,146,41,284,1
9,378,15,9,9,0,0,6,15,0,0,0,0,0,0,0,0,0,0,0,0,0,79,0,380,150,42,292,1
158,2888,1338,495,1086,10,64,173,1348,11,122,82,157,133,239,883,1686,7,11934,663,0,0,526,0,520,208,56,391,1
6,264,207,111,150,11,0,50,218,5,26,19,36,31,55,133,272,3,943,52,0,0,58,0,520,208,56,392,1
6,264,410,198,237,31,55,97,441,11,63,38,72,74,110,414,683,6,4293,238,0,0,58,0,530,209,57,393,1
30,664,1457,730,1242,11,6,188,1468,10,292,166,329,302,495,2424,4078,5,22973,1276,1,0,148,0,530,211,57,394,1
30,664,74,35,59,1,0,14,75,3,14,7,14,17,21,58,85,1,128,7,0,0,148,0,530,212,57,395,1
30,664,245,125,200,5,7,34,250,7,30,17,34,37,51,166,265,3,1053,58,0,0,148,0,540,213,57,396,1
4,109,1455,414,1257,16,76,112,1471,5,41,23,46,46,69,231,381,2,1069,59,0,0,33,0,540,214,57,397,1
4,109,669,365,481,22,61,110,691,15,103,63,122,118,185,747,1273,8,11311,628,0,0,33,0,550,214,58,398,1
6,202,256,139,192,9,7,47,265,4,23,12,24,27,36,112,171,2,357,19,0,0,39,0,550,215,58,399,1
1,129,1457,730,1242,11,6,188,1468,10,292,166,329,302,495,2424,4078,5,22973,1276,1,0,24,0,580,226,60,426,1
53,870,373,158,315,8,0,51,381,5,76,44,79,81,123,486,779,2,2026,112,0,0,154,0,590,230,61,434,1
126,3063,1943,715,1694,26,18,214,1969,12,185,120,237,197,357,1436,2721,7,20915,1161,0,0,479,0,600,236,62,442,1
126,3063,1168,838,957,57,25,144,1225,19,348,224,416,367,640,3018,5452,11,61921,3440,1,0,479,0,610,238,62,443,1
4,217,207,111,150,11,0,50,218,5,26,19,36,31,55,133,272,3,943,52,0,0,51,0,630,246,64,458,1
7,467,1457,730,1242,11,6,188,1468,10,292,166,329,302,495,2424,4078,5,22973,1276,1,0,74,0,630,248,64,459,1
4,184,1455,414,1257,16,76,112,1471,5,41,23,46,46,69,231,381,2,1069,59,0,0,43,0,630,249,64,460,1
35,2376,373,158,315,8,0,51,381,5,76,44,79,81,123,486,779,2,2026,112,0,0,389,0,630,249,64,461,1
67,1751,477,336,357,30,23,73,507,16,194,134,250,210,384,1538,2962,10,30538,1696,0,0,291,0,670,262,67,483,1
12,285,1523,757,1297,19,12,193,1542,12,193,117,230,205,347,1508,2664,7,19053,1058,0,0,58,0,750,292,74,533,1
12,285,701,378,504,33,58,109,734,13,110,68,126,123,194,794,1346,7,10027,557,0,0,58,0,750,293,75,534,1
1,85,13,10,10,0,0,3,13,1,2,1,2,3,3,2,4,0,2,0,0,2,1,1,760,297,76,544,1
4,403,652,304,544,16,6,88,668,6,89,51,101,95,152,591,998,3,3399,188,0,2,2,3,760,298,76,545,1
4,89,1943,715,1694,26,18,214,1969,12,185,120,237,197,357,1436,2721,7,20915,1161,0,0,21,0,760,300,76,546,1
153,2747,1338,495,1086,10,64,173,1348,11,122,82,157,133,239,883,1686,7,11934,663,0,2,16,35,760,302,76,547,1
69,1398,1457,730,1242,11,6,188,1468,10,292,166,329,302,495,2424,4078,5,22973,1276,1,2,201,61,760,304,76,548,1
69,1398,74,35,59,1,0,14,75,3,14,7,14,17,21,58,85,1,128,7,0,2,201,61,760,305,76,549,1
69,1398,245,125,200,5,7,34,250,7,30,17,34,37,51,166,265,3,1053,58,0,2,201,61,770,306,76,550,1
40,618,373,158,315,8,0,51,381,5,76,44,79,81,123,486,779,2,2026,112,0,2,2,39,780,309,76,564,1
74,1856,1943,715,1694,26,18,214,1969,12,185,120,237,197,357,1436,2721,7,20915,1161,0,2,9,197,780,311,76,565,1
74,1856,1168,838,957,57,25,144,1225,19,348,224,416,367,640,3018,5452,11,61921,3440,1,2,9,197,790,313,76,566,1
42,2602,1457,730,1242,11,6,188,1468,10,292,166,329,302,495,2424,4078,5,22973,1276,1,2,265,0,790,315,76,567,1
4,190,1455,414,1257,16,76,112,1471,5,41,23,46,46,69,231,381,2,1069,59,0,2,2,2,790,316,76,568,1
34,2129,373,158,315,8,0,51,381,5,76,44,79,81,123,486,779,2,2026,112,0,2,21,48,790,316,76,569,1
40,612,373,158,315,8,0,51,381,5,76,44,79,81,123,486,779,2,2026,112,0,2,6,7,790,316,76,570,0
73,1454,1457,730,1242,11,6,188,1468,10,292,166,329,302,495,2424,4078,5,22973,1276,1,2,12,1,790,318,76,571,0
73,1454,74,35,59,1,0,14,75,3,14,7,14,17,21,58,85,1,128,7,0,2,12,1,790,319,76,572,0
73,1454,245,125,200,5,7,34,250,7,30,17,34,37,51,166,265,3,1053,58,0,2,12,1,800,320,76,573,0
44,2661,1457,730,1242,11,6,188,1468,10,292,166,329,302,495,2424,4078,5,22973,1276,1,2,23,5,800,322,76,574,0
74,1467,1457,730,1242,11,6,188,1468,10,292,166,329,302,495,2424,4078,5,22973,1276,1,2,3,1,800,324,76,575,1
74,1467,74,35,59,1,0,14,75,3,14,7,14,17,21,58,85,1,128,7,0,2,3,1,800,325,76,576,1
74,1467,245,125,200,5,7,34,250,7,30,17,34,37,51,166,265,3,1053,58,0,2,3,1,810,326,76,577,1
153,2741,1338,495,1086,10,64,173,1348,11,122,82,157,133,239,883,1686,7,11934,663,0,2,3,3,810,328,76,578,0
17,403,1513,682,1277,25,13,200,1538,11,199,116,219,210,335,1557,2584,6,15641,868,0,2,1,0,810,330,76,579,0
17,403,819,519,539,24,98,155,843,15,96,57,106,111,163,690,1107,8,9171,509,0,2,1,0,820,332,76,580,0
5,104,1943,715,1694,26,18,214,1969,12,185,120,237,197,357,1436,2721,7,20915,1161,0,2,8,4,820,334,76,581,0
44,2697,1457,730,1242,11,6,188,1468,10,292,166,329,302,495,2424,4078,5,22973,1276,1,2,4,2,820,336,76,582,0
74,1599,127,75,83,2,11,30,129,4,14,7,14,18,21,61,87,2,175,9,0,2,23,7,820,336,76,583,0
74,1599,652,304,544,16,6,88,668,6,89,51,101,95,152,591,998,3,3399,188,0,2,23,7,820,337,76,584,0
74,1599,2,2,2,0,0,0,2,0,0,0,0,0,0,0,0,0,0,0,0,2,23,7,820,337,76,584,0
74,1599,8,5,5,0,0,3,8,0,0,0,0,0,0,0,0,0,0,0,0,2,23,7,820,337,76,585,0
74,1599,2,2,2,0,0,0,2,0,0,0,0,0,0,0,0,0,0,0,0,2,23,7,820,337,76,585,0
74,1599,14,8,8,0,0,6,14,0,0,0,0,0,0,0,0,0,0,0,0,2,23,7,820,337,76,586,0
74,1599,6,4,4,0,0,2,6,0,0,0,0,0,0,0,0,0,0,0,0,2,23,7,820,337,76,587,0
74,1599,6,4,4,0,0,2,6,1,2,1,2,3,3,2,4,0,2,0,0,2,23,7,820,337,76,588,0
74,1599,6,4,4,0,0,2,6,0,0,0,0,0,0,0,0,0,0,0,0,2,23,7,820,337,76,589,0
74,1599,7,5,5,0,0,2,7,0,0,0,0,0,0,0,0,0,0,0,0,2,23,7,820,337,76,590,0
74,1599,6,4,4,0,0,2,6,0,0,0,0,0,0,0,0,0,0,0,0,2,23,7,820,337,76,591,0
74,1599,10,6,6,0,0,4,10,0,0,0,0,0,0,0,0,0,0,0,0,2,23,7,820,337,76,592,0
74,1599,1,1,1,0,0,0,1,0,0,0,0,0,0,0,0,0,0,0,0,2,23,7,820,337,76,592,0
74,1599,14,10,10,0,0,4,14,1,1,1,1,2,2,0,2,0,1,0,0,2,23,7,820,337,76,593,0
74,1599,46,26,30,3,0,12,49,3,6,3,6,9,9,20,28,1,42,2,0,2,23,7,830,337,76,594,0
5,535,652,304,544,16,6,88,668,6,89,51,101,95,152,591,998,3,3399,188,0,2,15,0,830,338,76,595,0
74,1848,1943,715,1694,26,18,214,1969,12,185,120,237,197,357,1436,2721,7,20915,1161,0,2,0,1,830,340,76,596,0
74,1848,1168,838,957,57,25,144,1225,19,348,224,416,367,640,3018,5452,11,61921,3440,1,2,0,1,840,342,76,597,0
20,484,182,127,129,0,0,53,182,5,39,21,42,44,63,217,343,2,926,51,0,2,4,1,840,342,77,598,0
20,484,1165,710,800,67,119,181,1232,18,243,153,282,261,435,2000,3492,10,36473,2026,1,2,4,1,850,342,78,599,0
154,2757,1338,495,1086,10,64,173,1348,11,122,82,157,133,239,883,1686,7,11934,663,0,2,6,1,850,344,78,600,0
20,486,182,127,129,0,0,53,182,5,39,21,42,44,63,217,343,2,926,51,0,2,1,1,850,344,79,601,0
20,486,1165,710,800,67,119,181,1232,18,243,153,282,261,435,2000,3492,10,36473,2026,1,2,1,1,860,344,80,602,0
10,344,182,127,129,0,0,53,182,5,39,21,42,44,63,217,343,2,926,51,0,2,6,0,860,344,81,603,0
75,1511,1457,730,1242,11,6,188,1468,10,292,166,329,302,495,2424,4078,5,22973,1276,1,2,8,1,860,346,81,604,0
75,1511,74,35,59,1,0,14,75,3,14,7,14,17,21,58,85,1,128,7,0,2,8,1,860,347,81,605,0
75,1511,245,125,200,5,7,34,250,7,30,17,34,37,51,166,265,3,1053,58,0,2,8,1,870,348,81,606,0
75,1611,127,75,83,2,11,30,129,4,14,7,14,18,21,61,87,2,175,9,0,2,7,3,870,348,81,607,1
75,1611,652,304,544,16,6,88,668,6,89,51,101,95,152,591,998,3,3399,188,0,2,7,3,870,349,81,608,1
75,1611,2,2,2,0,0,0,2,0,0,0,0,0,0,0,0,0,0,0,0,2,7,3,870,349,81,608,1
75,1611,8,5,5,0,0,3,8,0,0,0,0,0,0,0,0,0,0,0,0,2,7,3,870,349,81,609,1
75,1611,2,2,2,0,0,0,2,0,0,0,0,0,0,0,0,0,0,0,0,2,7,3,870,349,81,609,1
75,1611,14,8,8,0,0,6,14,0,0,0,0,0,0,0,0,0,0,0,0,2,7,3,870,349,81,610,1
75,1611,6,4,4,0,0,2,6,0,0,0,0,0,0,0,0,0,0,0,0,2,7,3,870,349,81,611,1
75,1611,6,4,4,0,0,2,6,1,2,1,2,3,3,2,4,0,2,0,0,2,7,3,870,349,81,612,1
75,1611,6,4,4,0,0,2,6,0,0,0,0,0,0,0,0,0,0,0,0,2,7,3,870,349,81,613,1
75,1611,7,5,5,0,0,2,7,0,0,0,0,0,0,0,0,0,0,0,0,2,7,3,870,349,81,614,1
75,1611,6,4,4,0,0,2,6,0,0,0,0,0,0,0,0,0,0,0,0,2,7,3,870,349,81,615,1
75,1611,10,6,6,0,0,4,10,0,0,0,0,0,0,0,0,0,0,0,0,2,7,3,870,349,81,616,1
75,1611,1,1,1,0,0,0,1,0,0,0,0,0,0,0,0,0,0,0,0,2,7,3,870,349,81,616,1
75,1611,14,10,10,0,0,4,14,1,1,1,1,2,2,0,2,0,1,0,0,2,7,3,870,349,81,617,1
75,1611,46,26,30,3,0,12,49,3,6,3,6,9,9,20,28,1,42,2,0,2,7,3,880,349,81,618,1
75,1516,1457,730,1242,11,6,188,1468,10,292,166,329,302,495,2424,4078,5,22973,1276,1,2,1,0,880,351,81,619,0
75,1516,74,35,59,1,0,14,75,3,14,7,14,17,21,58,85,1,128,7,0,2,1,0,880,352,81,620,0
75,1516,245,125,200,5,7,34,250,7,30,17,34,37,51,166,265,3,1053,58,0,2,1,0,890,353,81,621,0
63,1425,1457,730,1242,11,6,188,1468,10,292,166,329,302,495,2424,4078,5,22973,1276,1,2,1,26,890,355,81,622,1
63,1425,74,35,59,1,0,14,75,3,14,7,14,17,21,58,85,1,128,7,0,2,1,26,890,356,81,623,1
63,1425,245,125,200,5,7,34,250,7,30,17,34,37,51,166,265,3,1053,58,0,2,1,26,900,357,81,624,1
49,681,373,158,315,8,0,51,381,5,76,44,79,81,123,486,779,2,2026,112,0,2,15,0,900,357,81,625,1
44,2697,1457,730,1242,11,6,188,1468,10,292,166,329,302,495,2424,4078,5,22973,1276,1,2,3,1,900,359,81,626,1
28,1795,373,158,315,8,0,51,381,5,76,44,79,81,123,486,779,2,2026,112,0,2,33,81,900,359,81,627,1
63,1425,1457,730,1242,11,6,188,1468,10,292,166,329,302,495,2424,4078,5,22973,1276,1,2,1,1,900,361,81,628,0
63,1425,74,35,59,1,0,14,75,3,14,7,14,17,21,58,85,1,128,7,0,2,1,1,900,362,81,629,0
63,1425,245,125,200,5,7,34,250,7,30,17,34,37,51,166,265,3,1053,58,0,2,1,1,910,363,81,630,0
62,1381,1457,730,1242,11,6,188,1468,10,292,166,329,302,495,2424,4078,5,22973,1276,1,2,0,7,910,365,81,631,0
62,1381,74,35,59,1,0,14,75,3,14,7,14,17,21,58,85,1,128,7,0,2,0,7,910,366,81,632,0
62,1381,245,125,200,5,7,34,250,7,30,17,34,37,51,166,265,3,1053,58,0,2,0,7,920,367,81,633,0
64,1421,1457,730,1242,11,6,188,1468,10,292,166,329,302,495,2424,4078,5,22973,1276,1,2,8,0,920,369,81,634,0
64,1421,74,35,59,1,0,14,75,3,14,7,14,17,21,58,85,1,128,7,0,2,8,0,920,370,81,635,0
64,1421,245,125,200,5,7,34,250,7,30,17,34,37,51,166,265,3,1053,58,0,2,8,0,930,371,81,636,0
63,1405,1457,730,1242,11,6,188,1468,10,292,166,329,302,495,2424,4078,5,22973,1276,1,2,0,4,930,373,81,637,0
63,1405,74,35,59,1,0,14,75,3,14,7,14,17,21,58,85,1,128,7,0,2,0,4,930,374,81,638,0
63,1405,245,125,200,5,7,34,250,7,30,17,34,37,51,166,265,3,1053,58,0,2,0,4,940,375,81,639,0
43,2647,1457,730,1242,11,6,188,1468,10,292,166,329,302,495,2424,4078,5,22973,1276,1,2,0,5,940,377,81,640,0
307,7644,1455,414,1257,16,76,112,1471,5,41,23,46,46,69,231,381,2,1069,59,0,2,1,1,980,391,84,663,0
307,7644,669,365,481,22,61,110,691,15,103,63,122,118,185,747,1273,8,11311,628,0,2,1,1,990,391,85,664,0
75,1589,127,75,83,2,11,30,129,4,14,7,14,18,21,61,87,2,175,9,0,2,0,3,990,391,85,665,0
75,1589,652,304,544,16,6,88,668,6,89,51,101,95,152,591,998,3,3399,188,0,2,0,3,990,392,85,666,0
75,1589,2,2,2,0,0,0,2,0,0,0,0,0,0,0,0,0,0,0,0,2,0,3,990,392,85,666,0
75,1589,8,5,5,0,0,3,8,0,0,0,0,0,0,0,0,0,0,0,0,2,0,3,990,392,85,667,0
75,1589,2,2,2,0,0,0,2,0,0,0,0,0,0,0,0,0,0,0,0,2,0,3,990,392,85,667,0
75,1589,14,8,8,0,0,6,14,0,0,0,0,0,0,0,0,0,0,0,0,2,0,3,990,392,85,668,0
75,1589,6,4,4,0,0,2,6,0,0,0,0,0,0,0,0,0,0,0,0,2,0,3,990,392,85,669,0
75,1589,6,4,4,0,0,2,6,1,2,1,2,3,3,2,4,0,2,0,0,2,0,3,990,392,85,670,0
75,1589,6,4,4,0,0,2,6,0,0,0,0,0,0,0,0,0,0,0,0,2,0,3,990,392,85,671,0
75,1589,7,5,5,0,0,2,7,0,0,0,0,0,0,0,0,0,0,0,0,2,0,3,990,392,85,672,0
75,1589,6,4,4,0,0,2,6,0,0,0,0,0,0,0,0,0,0,0,0,2,0,3,990,392,85,673,0
75,1589,10,6,6,0,0,4,10,0,0,0,0,0,0,0,0,0,0,0,0,2,0,3,990,392,85,674,0
75,1589,1,1,1,0,0,0,1,0,0,0,0,0,0,0,0,0,0,0,0,2,0,3,990,392,85,674,0
75,1589,14,10,10,0,0,4,14,1,1,1,1,2,2,0,2,0,1,0,0,2,0,3,990,392,85,675,0
75,1589,46,26,30,3,0,12,49,3,6,3,6,9,9,20,28,1,42,2,0,2,0,3,1000,392,85,676,0
20,491,182,127,129,0,0,53,182,5,39,21,42,44,63,217,343,2,926,51,0,2,9,0,1030,404,89,698,0
20,491,1165,710,800,67,119,181,1232,18,243,153,282,261,435,2000,3492,10,36473,2026,1,2,9,0,1040,404,90,699,0
12,236,1392,870,1177,35,17,170,1427,14,494,280,531,508,811,4473,7289,7,54850,3047,2,2,8,0,1040,407,91,700,0
23,517,1513,682,1277,25,13,200,1538,11,199,116,219,210,335,1557,2584,6,15641,868,0,2,41,1,1080,422,95,727,0
23,517,819,519,539,24,98,155,843,15,96,57,106,111,163,690,1107,8,9171,509,0,2,41,1,1090,424,95,728,0
18,917,1513,682,1277,25,13,200,1538,11,199,116,219,210,335,1557,2584,6,15641,868,0,2,27,0,1090,426,95,729,0
19,455,1513,682,1277,25,13,200,1538,11,199,116,219,210,335,1557,2584,6,15641,868,0,2,0,14,1090,428,95,730,0
19,455,819,519,539,24,98,155,843,15,96,57,106,111,163,690,1107,8,9171,509,0,2,0,14,1100,430,95,731,0
18,919,1513,682,1277,25,13,200,1538,11,199,116,219,210,335,1557,2584,6,15641,868,0,2,5,5,1110,436,96,739,1
154,2757,1338,495,1086,10,64,173,1348,11,122,82,157,133,239,883,1686,7,11934,663,0,2,1,5,1120,442,96,742,1
28,1795,373,158,315,8,0,51,381,5,76,44,79,81,123,486,779,2,2026,112,0,2,1,1,1120,442,96,743,1
22,1090,1513,682,1277,25,13,200,1538,11,199,116,219,210,335,1557,2584,6,15641,868,0,2,54,32,1120,444,96,744,1
23,1138,1513,682,1277,25,13,200,1538,11,199,116,219,210,335,1557,2584,6,15641,868,0,2,9,1,1120,446,96,745,0
78,1665,127,75,83,2,11,30,129,4,14,7,14,18,21,61,87,2,175,9,0,2,35,25,1120,446,96,746,1
78,1665,652,304,544,16,6,88,668,6,89,51,101,95,152,591,998,3,3399,188,0,2,35,25,1120,447,96,747,1
78,1665,2,2,2,0,0,0,2,0,0,0,0,0,0,0,0,0,0,0,0,2,35,25,1120,447,96,747,1
78,1665,8,5,5,0,0,3,8,0,0,0,0,0,0,0,0,0,0,0,0,2,35,25,1120,447,96,748,1
78,1665,2,2,2,0,0,0,2,0,0,0,0,0,0,0,0,0,0,0,0,2,35,25,1120,447,96,748,1
78,1665,14,8,8,0,0,6,14,0,0,0,0,0,0,0,0,0,0,0,0,2,35,25,1120,447,96,749,1
78,1665,6,4,4,0,0,2,6,0,0,0,0,0,0,0,0,0,0,0,0,2,35,25,1120,447,96,750,1
78,1665,6,4,4,0,0,2,6,1,2,1,2,3,3,2,4,0,2,0,0,2,35,25,1120,447,96,751,1
78,1665,6,4,4,0,0,2,6,0,0,0,0,0,0,0,0,0,0,0,0,2,35,25,1120,447,96,752,1
78,1665,7,5,5,0,0,2,7,0,0,0,0,0,0,0,0,0,0,0,0,2,35,25,1120,447,96,753,1
78,1665,6,4,4,0,0,2,6,0,0,0,0,0,0,0,0,0,0,0,0,2,35,25,1120,447,96,754,1
78,1665,10,6,6,0,0,4,10,0,0,0,0,0,0,0,0,0,0,0,0,2,35,25,1120,447,96,755,1
78,1665,1,1,1,0,0,0,1,0,0,0,0,0,0,0,0,0,0,0,0,2,35,25,1120,447,96,755,1
78,1665,14,10,10,0,0,4,14,1,1,1,1,2,2,0,2,0,1,0,0,2,35,25,1120,447,96,756,1
78,1665,46,26,30,3,0,12,49,3,6,3,6,9,9,20,28,1,42,2,0,2,35,25,1130,447,96,757,1
6,609,652,304,544,16,6,88,668,6,89,51,101,95,152,591,998,3,3399,188,0,2,13,1,1130,448,96,758,1
78,1680,127,75,83,2,11,30,129,4,14,7,14,18,21,61,87,2,175,9,0,2,13,10,1130,448,96,759,0
78,1680,652,304,544,16,6,88,668,6,89,51,101,95,152,591,998,3,3399,188,0,2,13,10,1130,449,96,760,0
78,1680,2,2,2,0,0,0,2,0,0,0,0,0,0,0,0,0,0,0,0,2,13,10,1130,449,96,760,0
78,1680,8,5,5,0,0,3,8,0,0,0,0,0,0,0,0,0,0,0,0,2,13,10,1130,449,96,761,0
78,1680,2,2,2,0,0,0,2,0,0,0,0,0,0,0,0,0,0,0,0,2,13,10,1130,449,96,761,0
78,1680,14,8,8,0,0,6,14,0,0,0,0,0,0,0,0,0,0,0,0,2,13,10,1130,449,96,762,0
78,1680,6,4,4,0,0,2,6,0,0,0,0,0,0,0,0,0,0,0,0,2,13,10,1130,449,96,763,0
78,1680,6,4,4,0,0,2,6,1,2,1,2,3,3,2,4,0,2,0,0,2,13,10,1130,449,96,764,0
78,1680,6,4,4,0,0,2,6,0,0,0,0,0,0,0,0,0,0,0,0,2,13,10,1130,449,96,765,0
78,1680,7,5,5,0,0,2,7,0,0,0,0,0,0,0,0,0,0,0,0,2,13,10,1130,449,96,766,0
78,1680,6,4,4,0,0,2,6,0,0,0,0,0,0,0,0,0,0,0,0,2,13,10,1130,449,96,767,0
78,1680,10,6,6,0,0,4,10,0,0,0,0,0,0,0,0,0,0,0,0,2,13,10,1130,449,96,768,0
78,1680,1,1,1,0,0,0,1,0,0,0,0,0,0,0,0,0,0,0,0,2,13,10,1130,449,96,768,0
78,1680,14,10,10,0,0,4,14,1,1,1,1,2,2,0,2,0,1,0,0,2,13,10,1130,449,96,769,0
78,1680,46,26,30,3,0,12,49,3,6,3,6,9,9,20,28,1,42,2,0,2,13,10,1140,449,96,770,0
79,1683,127,75,83,2,11,30,129,4,14,7,14,18,21,61,87,2,175,9,0,2,45,40,1140,449,96,771,0
79,1683,652,304,544,16,6,88,668,6,89,51,101,95,152,591,998,3,3399,188,0,2,45,40,1140,450,96,772,0
79,1683,2,2,2,0,0,0,2,0,0,0,0,0,0,0,0,0,0,0,0,2,45,40,1140,450,96,772,0
79,1683,8,5,5,0,0,3,8,0,0,0,0,0,0,0,0,0,0,0,0,2,45,40,1140,450,96,773,0
79,1683,2,2,2,0,0,0,2,0,0,0,0,0,0,0,0,0,0,0,0,2,45,40,1140,450,96,773,0
79,1683,14,8,8,0,0,6,14,0,0,0,0,0,0,0,0,0,0,0,0,2,45,40,1140,450,96,774,0
79,1683,6,4,4,0,0,2,6,0,0,0,0,0,0,0,0,0,0,0,0,2,45,40,1140,450,96,775,0
79,1683,6,4,4,0,0,2,6,1,2,1,2,3,3,2,4,0,2,0,0,2,45,40,1140,450,96,776,0
79,1683,6,4,4,0,0,2,6,0,0,0,0,0,0,0,0,0,0,0,0,2,45,40,1140,450,96,777,0
79,1683,7,5,5,0,0,2,7,0,0,0,0,0,0,0,0,0,0,0,0,2,45,40,1140,450,96,778,0
79,1683,6,4,4,0,0,2,6,0,0,0,0,0,0,0,0,0,0,0,0,2,45,40,1140,450,96,779,0
79,1683,10,6,6,0,0,4,10,0,0,0,0,0,0,0,0,0,0,0,0,2,45,40,1140,450,96,780,0
79,1683,1,1,1,0,0,0,1,0,0,0,0,0,0,0,0,0,0,0,0,2,45,40,1140,450,96,780,0
79,1683,14,10,10,0,0,4,14,1,1,1,1,2,2,0,2,0,1,0,0,2,45,40,1140,450,96,781,0
79,1683,46,26,30,3,0,12,49,3,6,3,6,9,9,20,28,1,42,2,0,2,45,40,1150,450,96,782,0
7,611,652,304,544,16,6,88,668,6,89,51,101,95,152,591,998,3,3399,188,0,2,16,17,1150,451,96,783,0
19,557,14,9,9,0,0,5,14,0,0,0,0,0,0,0,0,0,0,0,0,2,8,8,1150,451,96,784,1
19,557,16,9,9,0,0,7,16,0,0,0,0,0,0,0,0,0,0,0,0,2,8,8,1150,451,96,785,1
1,85,13,10,10,0,0,3,13,1,2,1,2,3,3,2,4,0,2,0,0,2,3,2,1160,455,97,793,0
7,571,652,304,544,16,6,88,668,6,89,51,101,95,152,591,998,3,3399,188,0,2,10,9,1160,456,97,794,0
150,2630,1338,495,1086,10,64,173,1348,11,122,82,157,133,239,883,1686,7,11934,663,0,2,0,21,1160,458,97,795,0
6,203,256,139,192,9,7,47,265,4,23,12,24,27,36,112,171,2,357,19,0,2,1,1,1160,459,97,796,0
49,683,373,158,315,8,0,51,381,5,76,44,79,81,123,486,779,2,2026,112,0,2,6,5,1160,459,97,797,0
74,1822,1943,715,1694,26,18,214,1969,12,185,120,237,197,357,1436,2721,7,20915,1161,0,2,13,12,1160,461,97,798,0
74,1822,1168,838,957,57,25,144,1225,19,348,224,416,367,640,3018,5452,11,61921,3440,1,2,13,12,1170,463,97,799,0
4,200,1455,414,1257,16,76,112,1471,5,41,23,46,46,69,231,381,2,1069,59,0,2,2,1,1170,464,97,800,0
28,1715,373,158,315,8,0,51,381,5,76,44,79,81,123,486,779,2,2026,112,0,2,17,16,1170,464,97,801,0
150,2630,1338,495,1086,10,64,173,1348,11,122,82,157,133,239,883,1686,7,11934,663,0,2,1,1,1180,470,98,809,0
152,2651,1338,495,1086,10,64,173,1348,11,122,82,157,133,239,883,1686,7,11934,663,0,2,29,24,1180,472,98,810,0
63,1405,1457,730,1242,11,6,188,1468,10,292,166,329,302,495,2424,4078,5,22973,1276,1,2,2,2,1180,474,98,811,0
63,1405,74,35,59,1,0,14,75,3,14,7,14,17,21,58,85,1,128,7,0,2,2,2,1180,475,98,812,0
63,1405,245,125,200,5,7,34,250,7,30,17,34,37,51,166,265,3,1053,58,0,2,2,2,1190,476,98,813,0
49,683,373,158,315,8,0,51,381,5,76,44,79,81,123,486,779,2,2026,112,0,2,1,1,1190,476,98,814,0
74,1822,1943,715,1694,26,18,214,1969,12,185,120,237,197,357,1436,2721,7,20915,1161,0,2,4,4,1190,478,98,815,0
74,1822,1168,838,957,57,25,144,1225,19,348,224,416,367,640,3018,5452,11,61921,3440,1,2,4,4,1200,480,98,816,0
43,2647,1457,730,1242,11,6,188,1468,10,292,166,329,302,495,2424,4078,5,22973,1276,1,2,5,5,1200,482,98,817,0
28,1715,373,158,315,8,0,51,381,5,76,44,79,81,123,486,779,2,2026,112,0,2,3,3,1200,482,98,818,0
152,2651,1338,495,1086,10,64,173,1348,11,122,82,157,133,239,883,1686,7,11934,663,0,2,6,6,1200,484,98,819,1
74,1822,1943,715,1694,26,18,214,1969,12,185,120,237,197,357,1436,2721,7,20915,1161,0,2,2,2,1200,486,98,820,1
74,1822,1168,838,957,57,25,144,1225,19,348,224,416,367,640,3018,5452,11,61921,3440,1,2,2,2,1210,488,98,821,1
4,200,1455,414,1257,16,76,112,1471,5,41,23,46,46,69,231,381,2,1069,59,0,2,1,1,1210,489,98,822,1
61,1365,1457,730,1242,11,6,188,1468,10,292,166,329,302,495,2424,4078,5,22973,1276,1,2,0,8,1210,491,98,823,0
61,1365,74,35,59,1,0,14,75,3,14,7,14,17,21,58,85,1,128,7,0,2,0,8,1210,492,98,824,0
61,1365,245,125,200,5,7,34,250,7,30,17,34,37,51,166,265,3,1053,58,0,2,0,8,1220,493,98,825,0
152,2651,1338,495,1086,10,64,173,1348,11,122,82,157,133,239,883,1686,7,11934,663,0,2,1,1,1220,495,98,826,1
49,683,373,158,315,8,0,51,381,5,76,44,79,81,123,486,779,2,2026,112,0,2,1,1,1220,495,98,827,1
74,1813,1943,715,1694,26,18,214,1969,12,185,120,237,197,357,1436,2721,7,20915,1161,0,2,1,2,1220,497,98,828,1
74,1813,1168,838,957,57,25,144,1225,19,348,224,416,367,640,3018,5452,11,61921,3440,1,2,1,2,1230,499,98,829,1
152,2659,1338,495,1086,10,64,173,1348,11,122,82,157,133,239,883,1686,7,11934,663,0,2,2,1,1230,501,98,830,0
152,2655,1338,495,1086,10,64,173,1348,11,122,82,157,133,239,883,1686,7,11934,663,0,2,1,1,1230,503,98,831,0
64,1432,1457,730,1242,11,6,188,1468,10,292,166,329,302,495,2424,4078,5,22973,1276,1,2,14,0,1230,505,98,832,1
64,1432,74,35,59,1,0,14,75,3,14,7,14,17,21,58,85,1,128,7,0,2,14,0,1230,506,98,833,1
64,1432,245,125,200,5,7,34,250,7,30,17,34,37,51,166,265,3,1053,58,0,2,14,0,1240,507,98,834,1
44,2743,1457,730,1242,11,6,188,1468,10,292,166,329,302,495,2424,4078,5,22973,1276,1,2,13,1,1240,509,98,835,1
62,1413,1457,730,1242,11,6,188,1468,10,292,166,329,302,495,2424,4078,5,22973,1276,1,2,2,6,1370,560,110,932,0
62,1413,74,35,59,1,0,14,75,3,14,7,14,17,21,58,85,1,128,7,0,2,2,6,1370,561,110,933,0
62,1413,245,125,200,5,7,34,250,7,30,17,34,37,51,166,265,3,1053,58,0,2,2,6,1380,562,110,934,0
44,2833,1457,730,1242,11,6,188,1468,10,292,166,329,302,495,2424,4078,5,22973,1276,1,2,23,15,1380,564,110,935,0
29,1741,373,158,315,8,0,51,381,5,76,44,79,81,123,486,779,2,2026,112,0,2,4,0,1380,564,110,936,0
44,2848,1457,730,1242,11,6,188,1468,10,292,166,329,302,495,2424,4078,5,22973,1276,1,2,4,2,1380,566,110,937,0
44,2906,1457,730,1242,11,6,188,1468,10,292,166,329,302,495,2424,4078,5,22973,1276,1,2,8,3,1380,568,110,938,0
79,1690,127,75,83,2,11,30,129,4,14,7,14,18,21,61,87,2,175,9,0,2,1,0,1380,568,110,939,0
79,1690,652,304,544,16,6,88,668,6,89,51,101,95,152,591,998,3,3399,188,0,2,1,0,1380,569,110,940,0
79,1690,2,2,2,0,0,0,2,0,0,0,0,0,0,0,0,0,0,0,0,2,1,0,1380,569,110,940,0
79,1690,8,5,5,0,0,3,8,0,0,0,0,0,0,0,0,0,0,0,0,2,1,0,1380,569,110,941,0
79,1690,2,2,2,0,0,0,2,0,0,0,0,0,0,0,0,0,0,0,0,2,1,0,1380,569,110,941,0
79,1690,14,8,8,0,0,6,14,0,0,0,0,0,0,0,0,0,0,0,0,2,1,0,1380,569,110,942,0
79,1690,6,4,4,0,0,2,6,0,0,0,0,0,0,0,0,0,0,0,0,2,1,0,1380,569,110,943,0
79,1690,6,4,4,0,0,2,6,1,2,1,2,3,3,2,4,0,2,0,0,2,1,0,1380,569,110,944,0
79,1690,6,4,4,0,0,2,6,0,0,0,0,0,0,0,0,0,0,0,0,2,1,0,1380,569,110,945,0
79,1690,7,5,5,0,0,2,7,0,0,0,0,0,0,0,0,0,0,0,0,2,1,0,1380,569,110,946,0
79,1690,6,4,4,0,0,2,6,0,0,0,0,0,0,0,0,0,0,0,0,2,1,0,1380,569,110,947,0
79,1690,10,6,6,0,0,4,10,0,0,0,0,0,0,0,0,0,0,0,0,2,1,0,1380,569,110,948,0
79,1690,1,1,1,0,0,0,1,0,0,0,0,0,0,0,0,0,0,0,0,2,1,0,1380,569,110,948,0
79,1690,14,10,10,0,0,4,14,1,1,1,1,2,2,0,2,0,1,0,0,2,1,0,1380,569,110,949,0
79,1690,46,26,30,3,0,12,49,3,6,3,6,9,9,20,28,1,42,2,0,2,1,0,1390,569,110,950,0
8,660,652,304,544,16,6,88,668,6,89,51,101,95,152,591,998,3,3399,188,0,2,15,0,1390,570,110,951,0
79,1690,127,75,83,2,11,30,129,4,14,7,14,18,21,61,87,2,175,9,0,2,2,2,1390,570,110,952,0
79,1690,652,304,544,16,6,88,668,6,89,51,101,95,152,591,998,3,3399,188,0,2,2,2,1390,571,110,953,0
79,1690,2,2,2,0,0,0,2,0,0,0,0,0,0,0,0,0,0,0,0,2,2,2,1390,571,110,953,0
79,1690,8,5,5,0,0,3,8,0,0,0,0,0,0,0,0,0,0,0,0,2,2,2,1390,571,110,954,0
79,1690,2,2,2,0,0,0,2,0,0,0,0,0,0,0,0,0,0,0,0,2,2,2,1390,571,110,954,0
79,1690,14,8,8,0,0,6,14,0,0,0,0,0,0,0,0,0,0,0,0,2,2,2,1390,571,110,955,0
79,1690,6,4,4,0,0,2,6,0,0,0,0,0,0,0,0,0,0,0,0,2,2,2,1390,571,110,956,0
79,1690,6,4,4,0,0,2,6,1,2,1,2,3,3,2,4,0,2,0,0,2,2,2,1390,571,110,957,0
79,1690,6,4,4,0,0,2,6,0,0,0,0,0,0,0,0,0,0,0,0,2,2,2,1390,571,110,958,0
79,1690,7,5,5,0,0,2,7,0,0,0,0,0,0,0,0,0,0,0,0,2,2,2,1390,571,110,959,0
79,1690,6,4,4,0,0,2,6,0,0,0,0,0,0,0,0,0,0,0,0,2,2,2,1390,571,110,960,0
79,1690,10,6,6,0,0,4,10,0,0,0,0,0,0,0,0,0,0,0,0,2,2,2,1390,571,110,961,0
79,1690,1,1,1,0,0,0,1,0,0,0,0,0,0,0,0,0,0,0,0,2,2,2,1390,571,110,961,0
79,1690,14,10,10,0,0,4,14,1,1,1,1,2,2,0,2,0,1,0,0,2,2,2,1390,571,110,962,0
79,1690,46,26,30,3,0,12,49,3,6,3,6,9,9,20,28,1,42,2,0,2,2,2,1400,571,110,963,0
47,2925,1457,730,1242,11,6,188,1468,10,292,166,329,302,495,2424,4078,5,22973,1276,1,2,11,7,1400,573,110,964,0
87,1812,127,75,83,2,11,30,129,4,14,7,14,18,21,61,87,2,175,9,0,2,22,4,1400,573,110,965,0
87,1812,652,304,544,16,6,88,668,6,89,51,101,95,152,591,998,3,3399,188,0,2,22,4,1400,574,110,966,0
87,1812,2,2,2,0,0,0,2,0,0,0,0,0,0,0,0,0,0,0,0,2,22,4,1400,574,110,966,0
87,1812,8,5,5,0,0,3,8,0,0,0,0,0,0,0,0,0,0,0,0,2,22,4,1400,574,110,967,0
87,1812,2,2,2,0,0,0,2,0,0,0,0,0,0,0,0,0,0,0,0,2,22,4,1400,574,110,967,0
87,1812,14,8,8,0,0,6,14,0,0,0,0,0,0,0,0,0,0,0,0,2,22,4,1400,574,110,968,0
87,1812,6,4,4,0,0,2,6,0,0,0,0,0,0,0,0,0,0,0,0,2,22,4,1400,574,110,969,0
87,1812,6,4,4,0,0,2,6,1,2,1,2,3,3,2,4,0,2,0,0,2,22,4,1400,574,110,970,0
87,1812,6,4,4,0,0,2,6,0,0,0,0,0,0,0,0,0,0,0,0,2,22,4,1400,574,110,971,0
87,1812,7,5,5,0,0,2,7,0,0,0,0,0,0,0,0,0,0,0,0,2,22,4,1400,574,110,972,0
87,1812,6,4,4,0,0,2,6,0,0,0,0,0,0,0,0,0,0,0,0,2,22,4,1400,574,110,973,0
87,1812,10,6,6,0,0,4,10,0,0,0,0,0,0,0,0,0,0,0,0,2,22,4,1400,574,110,974,0
87,1812,1,1,1,0,0,0,1,0,0,0,0,0,0,0,0,0,0,0,0,2,22,4,1400,574,110,974,0
87,1812,14,10,10,0,0,4,14,1,1,1,1,2,2,0,2,0,1,0,0,2,22,4,1400,574,110,975,0
87,1812,46,26,30,3,0,12,49,3,6,3,6,9,9,20,28,1,42,2,0,2,22,4,1410,574,110,976,0
10,824,652,304,544,16,6,88,668,6,89,51,101,95,152,591,998,3,3399,188,0,2,24,0,1410,575,110,977,0
63,1436,1457,730,1242,11,6,188,1468,10,292,166,329,302,495,2424,4078,5,22973,1276,1,2,5,2,1410,577,110,978,0
63,1436,74,35,59,1,0,14,75,3,14,7,14,17,21,58,85,1,128,7,0,2,5,2,1410,578,110,979,0
63,1436,245,125,200,5,7,34,250,7,30,17,34,37,51,166,265,3,1053,58,0,2,5,2,1420,579,110,980,0
50,2993,1457,730,1242,11,6,188,1468,10,292,166,329,302,495,2424,4078,5,22973,1276,1,2,15,0,1420,581,110,981,0
62,1440,1457,730,1242,11,6,188,1468,10,292,166,329,302,495,2424,4078,5,22973,1276,1,2,7,8,1420,583,110,982,0
62,1440,74,35,59,1,0,14,75,3,14,7,14,17,21,58,85,1,128,7,0,2,7,8,1420,584,110,983,0
62,1440,245,125,200,5,7,34,250,7,30,17,34,37,51,166,265,3,1053,58,0,2,7,8,1430,585,110,984,0
62,1413,1457,730,1242,11,6,188,1468,10,292,166,329,302,495,2424,4078,5,22973,1276,1,2,4,6,1430,587,110,985,0
62,1413,74,35,59,1,0,14,75,3,14,7,14,17,21,58,85,1,128,7,0,2,4,6,1430,588,110,986,0
62,1413,245,125,200,5,7,34,250,7,30,17,34,37,51,166,265,3,1053,58,0,2,4,6,1440,589,110,987,0
47,2925,1457,730,1242,11,6,188,1468,10,292,166,329,302,495,2424,4078,5,22973,1276,1,2,0,15,1440,591,110,988,0
63,1428,1457,730,1242,11,6,188,1468,10,292,166,329,302,495,2424,4078,5,22973,1276,1,2,4,0,1480,597,110,1037,0
63,1428,74,35,59,1,0,14,75,3,14,7,14,17,21,58,85,1,128,7,0,2,4,0,1480,598,110,1038,0
63,1428,245,125,200,5,7,34,250,7,30,17,34,37,51,166,265,3,1053,58,0,2,4,0,1490,599,110,1039,0
150,2618,1338,495,1086,10,64,173,1348,11,122,82,157,133,239,883,1686,7,11934,663,0,2,2,7,1500,605,111,1047,0
69,1548,1457,730,1242,11,6,188,1468,10,292,166,329,302,495,2424,4078,5,22973,1276,1,2,18,0,1500,607,111,1048,0
69,1548,74,35,59,1,0,14,75,3,14,7,14,17,21,58,85,1,128,7,0,2,18,0,1500,608,111,1049,0
69,1548,245,125,200,5,7,34,250,7,30,17,34,37,51,166,265,3,1053,58,0,2,18,0,1510,609,111,1050,0
48,3110,1457,730,1242,11,6,188,1468,10,292,166,329,302,495,2424,4078,5,22973,1276,1,2,24,0,1510,611,111,1051,0
29,1712,373,158,315,8,0,51,381,5,76,44,79,81,123,486,779,2,2026,112,0,2,2,5,1510,611,111,1052,0
68,1525,1457,730,1242,11,6,188,1468,10,292,166,329,302,495,2424,4078,5,22973,1276,1,2,2,8,1510,613,111,1053,0
68,1525,74,35,59,1,0,14,75,3,14,7,14,17,21,58,85,1,128,7,0,2,2,8,1510,614,111,1054,0
68,1525,245,125,200,5,7,34,250,7,30,17,34,37,51,166,265,3,1053,58,0,2,2,8,1520,615,111,1055,0
48,3109,1457,730,1242,11,6,188,1468,10,292,166,329,302,495,2424,4078,5,22973,1276,1,2,1,1,1520,617,111,1056,0
74,1795,1943,715,1694,26,18,214,1969,12,185,120,237,197,357,1436,2721,7,20915,1161,0,2,2,2,1520,619,111,1057,0
74,1795,1168,838,957,57,25,144,1225,19,348,224,416,367,640,3018,5452,11,61921,3440,1,2,2,2,1530,621,111,1058,0
68,1525,1457,730,1242,11,6,188,1468,10,292,166,329,302,495,2424,4078,5,22973,1276,1,2,3,2,1530,623,111,1059,0
68,1525,74,35,59,1,0,14,75,3,14,7,14,17,21,58,85,1,128,7,0,2,3,2,1530,624,111,1060,0
68,1525,245,125,200,5,7,34,250,7,30,17,34,37,51,166,265,3,1053,58,0,2,3,2,1540,625,111,1061,0
69,1539,1457,730,1242,11,6,188,1468,10,292,166,329,302,495,2424,4078,5,22973,1276,1,2,8,5,1540,627,111,1062,0
69,1539,74,35,59,1,0,14,75,3,14,7,14,17,21,58,85,1,128,7,0,2,8,5,1540,628,111,1063,0
69,1539,245,125,200,5,7,34,250,7,30,17,34,37,51,166,265,3,1053,58,0,2,8,5,1550,629,111,1064,0
48,3144,1457,730,1242,11,6,188,1468,10,292,166,329,302,495,2424,4078,5,22973,1276,1,2,4,0,1550,631,111,1065,0
88,1867,127,75,83,2,11,30,129,4,14,7,14,18,21,61,87,2,175,9,0,2,12,3,1550,631,111,1066,1
88,1867,652,304,544,16,6,88,668,6,89,51,101,95,152,591,998,3,3399,188,0,2,12,3,1550,632,111,1067,1
88,1867,2,2,2,0,0,0,2,0,0,0,0,0,0,0,0,0,0,0,0,2,12,3,1550,632,111,1067,1
88,1867,8,5,5,0,0,3,8,0,0,0,0,0,0,0,0,0,0,0,0,2,12,3,1550,632,111,1068,1
88,1867,2,2,2,0,0,0,2,0,0,0,0,0,0,0,0,0,0,0,0,2,12,3,1550,632,111,1068,1
88,1867,14,8,8,0,0,6,14,0,0,0,0,0,0,0,0,0,0,0,0,2,12,3,1550,632,111,1069,1
88,1867,6,4,4,0,0,2,6,0,0,0,0,0,0,0,0,0,0,0,0,2,12,3,1550,632,111,1070,1
88,1867,6,4,4,0,0,2,6,1,2,1,2,3,3,2,4,0,2,0,0,2,12,3,1550,632,111,1071,1
88,1867,6,4,4,0,0,2,6,0,0,0,0,0,0,0,0,0,0,0,0,2,12,3,1550,632,111,1072,1
88,1867,7,5,5,0,0,2,7,0,0,0,0,0,0,0,0,0,0,0,0,2,12,3,1550,632,111,1073,1
88,1867,6,4,4,0,0,2,6,0,0,0,0,0,0,0,0,0,0,0,0,2,12,3,1550,632,111,1074,1
88,1867,10,6,6,0,0,4,10,0,0,0,0,0,0,0,0,0,0,0,0,2,12,3,1550,632,111,1075,1
88,1867,1,1,1,0,0,0,1,0,0,0,0,0,0,0,0,0,0,0,0,2,12,3,1550,632,111,1075,1
88,1867,14,10,10,0,0,4,14,1,1,1,1,2,2,0,2,0,1,0,0,2,12,3,1550,632,111,1076,1
88,1867,46,26,30,3,0,12,49,3,6,3,6,9,9,20,28,1,42,2,0,2,12,3,1560,632,111,1077,1
10,851,652,304,544,16,6,88,668,6,89,51,101,95,152,591,998,3,3399,188,0,2,8,6,1560,633,111,1078,1
88,1870,127,75,83,2,11,30,129,4,14,7,14,18,21,61,87,2,175,9,0,2,2,1,1560,633,111,1079,1
88,1870,652,304,544,16,6,88,668,6,89,51,101,95,152,591,998,3,3399,188,0,2,2,1,1560,634,111,1080,1
88,1870,2,2,2,0,0,0,2,0,0,0,0,0,0,0,0,0,0,0,0,2,2,1,1560,634,111,1080,1
88,1870,8,5,5,0,0,3,8,0,0,0,0,0,0,0,0,0,0,0,0,2,2,1,1560,634,111,1081,1
88,1870,2,2,2,0,0,0,2,0,0,0,0,0,0,0,0,0,0,0,0,2,2,1,1560,634,111,1081,1
88,1870,14,8,8,0,0,6,14,0,0,0,0,0,0,0,0,0,0,0,0,2,2,1,1560,634,111,1082,1
88,1870,6,4,4,0,0,2,6,0,0,0,0,0,0,0,0,0,0,0,0,2,2,1,1560,634,111,1083,1
88,1870,6,4,4,0,0,2,6,1,2,1,2,3,3,2,4,0,2,0,0,2,2,1,1560,634,111,1084,1
88,1870,6,4,4,0,0,2,6,0,0,0,0,0,0,0,0,0,0,0,0,2,2,1,1560,634,111,1085,1
88,1870,7,5,5,0,0,2,7,0,0,0,0,0,0,0,0,0,0,0,0,2,2,1,1560,634,111,1086,1
88,1870,6,4,4,0,0,2,6,0,0,0,0,0,0,0,0,0,0,0,0,2,2,1,1560,634,111,1087,1
88,1870,10,6,6,0,0,4,10,0,0,0,0,0,0,0,0,0,0,0,0,2,2,1,1560,634,111,1088,1
88,1870,1,1,1,0,0,0,1,0,0,0,0,0,0,0,0,0,0,0,0,2,2,1,1560,634,111,1088,1
88,1870,14,10,10,0,0,4,14,1,1,1,1,2,2,0,2,0,1,0,0,2,2,1,1560,634,111,1089,1
88,1870,46,26,30,3,0,12,49,3,6,3,6,9,9,20,28,1,42,2,0,2,2,1,1570,634,111,1090,1
69,1539,1457,730,1242,11,6,188,1468,10,292,166,329,302,495,2424,4078,5,22973,1276,1,2,4,4,1570,636,111,1091,0
69,1539,74,35,59,1,0,14,75,3,14,7,14,17,21,58,85,1,128,7,0,2,4,4,1570,637,111,1092,0
69,1539,245,125,200,5,7,34,250,7,30,17,34,37,51,166,265,3,1053,58,0,2,4,4,1580,638,111,1093,0
48,3144,1457,730,1242,11,6,188,1468,10,292,166,329,302,495,2424,4078,5,22973,1276,1,2,11,11,1580,640,111,1094,0
69,1539,1457,730,1242,11,6,188,1468,10,292,166,329,302,495,2424,4078,5,22973,1276,1,2,1,1,1580,642,111,1095,0
69,1539,74,35,59,1,0,14,75,3,14,7,14,17,21,58,85,1,128,7,0,2,1,1,1580,643,111,1096,0
69,1539,245,125,200,5,7,34,250,7,30,17,34,37,51,166,265,3,1053,58,0,2,1,1,1590,644,111,1097,0
48,3144,1457,730,1242,11,6,188,1468,10,292,166,329,302,495,2424,4078,5,22973,1276,1,2,4,4,1590,646,111,1098,0
148,2598,1338,495,1086,10,64,173,1348,11,122,82,157,133,239,883,1686,7,11934,663,0,2,10,9,1590,648,111,1099,0
50,3161,1457,730,1242,11,6,188,1468,10,292,166,329,302,495,2424,4078,5,22973,1276,1,2,2,1,1590,650,111,1100,0
148,2599,1338,495,1086,10,64,173,1348,11,122,82,157,133,239,883,1686,7,11934,663,0,2,3,5,1590,652,111,1101,0
48,3144,1457,730,1242,11,6,188,1468,10,292,166,329,302,495,2424,4078,5,22973,1276,1,2,1,2,1590,654,111,1102,0
88,1875,127,75,83,2,11,30,129,4,14,7,14,18,21,61,87,2,175,9,0,2,1,1,1610,662,113,1117,1
88,1875,652,304,544,16,6,88,668,6,89,51,101,95,152,591,998,3,3399,188,0,2,1,1,1610,663,113,1118,1
88,1875,2,2,2,0,0,0,2,0,0,0,0,0,0,0,0,0,0,0,0,2,1,1,1610,663,113,1118,1
88,1875,8,5,5,0,0,3,8,0,0,0,0,0,0,0,0,0,0,0,0,2,1,1,1610,663,113,1119,1
88,1875,2,2,2,0,0,0,2,0,0,0,0,0,0,0,0,0,0,0,0,2,1,1,1610,663,113,1119,1
88,1875,14,8,8,0,0,6,14,0,0,0,0,0,0,0,0,0,0,0,0,2,1,1,1610,663,113,1120,1
88,1875,6,4,4,0,0,2,6,0,0,0,0,0,0,0,0,0,0,0,0,2,1,1,1610,663,113,1121,1
88,1875,6,4,4,0,0,2,6,1,2,1,2,3,3,2,4,0,2,0,0,2,1,1,1610,663,113,1122,1
88,1875,6,4,4,0,0,2,6,0,0,0,0,0,0,0,0,0,0,0,0,2,1,1,1610,663,113,1123,1
88,1875,7,5,5,0,0,2,7,0,0,0,0,0,0,0,0,0,0,0,0,2,1,1,1610,663,113,1124,1
88,1875,6,4,4,0,0,2,6,0,0,0,0,0,0,0,0,0,0,0,0,2,1,1,1610,663,113,1125,1
88,1875,10,6,6,0,0,4,10,0,0,0,0,0,0,0,0,0,0,0,0,2,1,1,1610,663,113,1126,1
88,1875,1,1,1,0,0,0,1,0,0,0,0,0,0,0,0,0,0,0,0,2,1,1,1610,663,113,1126,1
88,1875,14,10,10,0,0,4,14,1,1,1,1,2,2,0,2,0,1,0,0,2,1,1,1610,663,113,1127,1
88,1875,46,26,30,3,0,12,49,3,6,3,6,9,9,20,28,1,42,2,0,2,1,1,1620,663,113,1128,1
69,1539,1457,730,1242,11,6,188,1468,10,292,166,329,302,495,2424,4078,5,22973,1276,1,2,9,9,1620,665,113,1129,0
69,1539,74,35,59,1,0,14,75,3,14,7,14,17,21,58,85,1,128,7,0,2,9,9,1620,666,113,1130,0
69,1539,245,125,200,5,7,34,250,7,30,17,34,37,51,166,265,3,1053,58,0,2,9,9,1630,667,113,1131,0
74,1795,1943,715,1694,26,18,214,1969,12,185,120,237,197,357,1436,2721,7,20915,1161,0,2,1,1,1630,669,113,1132,0
74,1795,1168,838,957,57,25,144,1225,19,348,224,416,367,640,3018,5452,11,61921,3440,1,2,1,1,1640,671,113,1133,0
88,1881,127,75,83,2,11,30,129,4,14,7,14,18,21,61,87,2,175,9,0,2,3,3,1650,675,114,1141,1
88,1881,652,304,544,16,6,88,668,6,89,51,101,95,152,591,998,3,3399,188,0,2,3,3,1650,676,114,1142,1
88,1881,2,2,2,0,0,0,2,0,0,0,0,0,0,0,0,0,0,0,0,2,3,3,1650,676,114,1142,1
88,1881,8,5,5,0,0,3,8,0,0,0,0,0,0,0,0,0,0,0,0,2,3,3,1650,676,114,1143,1
88,1881,2,2,2,0,0,0,2,0,0,0,0,0,0,0,0,0,0,0,0,2,3,3,1650,676,114,1143,1
88,1881,14,8,8,0,0,6,14,0,0,0,0,0,0,0,0,0,0,0,0,2,3,3,1650,676,114,1144,1
88,1881,6,4,4,0,0,2,6,0,0,0,0,0,0,0,0,0,0,0,0,2,3,3,1650,676,114,1145,1
88,1881,6,4,4,0,0,2,6,1,2,1,2,3,3,2,4,0,2,0,0,2,3,3,1650,676,114,1146,1
88,1881,6,4,4,0,0,2,6,0,0,0,0,0,0,0,0,0,0,0,0,2,3,3,1650,676,114,1147,1
88,1881,7,5,5,0,0,2,7,0,0,0,0,0,0,0,0,0,0,0,0,2,3,3,1650,676,114,1148,1
88,1881,6,4,4,0,0,2,6,0,0,0,0,0,0,0,0,0,0,0,0,2,3,3,1650,676,114,1149,1
88,1881,10,6,6,0,0,4,10,0,0,0,0,0,0,0,0,0,0,0,0,2,3,3,1650,676,114,1150,1
88,1881,1,1,1,0,0,0,1,0,0,0,0,0,0,0,0,0,0,0,0,2,3,3,1650,676,114,1150,1
88,1881,14,10,10,0,0,4,14,1,1,1,1,2,2,0,2,0,1,0,0,2,3,3,1650,676,114,1151,1
88,1881,46,26,30,3,0,12,49,3,6,3,6,9,9,20,28,1,42,2,0,2,3,3,1660,676,114,1152,1
148,2605,1338,495,1086,10,64,173,1348,11,122,82,157,133,239,883,1686,7,11934,663,0,2,3,3,1660,678,114,1153,1
4,111,1455,414,1257,16,76,112,1471,5,41,23,46,46,69,231,381,2,1069,59,0,2,1,1,1660,679,114,1154,1
4,111,669,365,481,22,61,110,691,15,103,63,122,118,185,747,1273,8,11311,628,0,2,1,1,1670,679,115,1155,1
49,689,373,158,315,8,0,51,381,5,76,44,79,81,123,486,779,2,2026,112,0,2,3,3,1670,679,115,1156,1
74,1799,1943,715,1694,26,18,214,1969,12,185,120,237,197,357,1436,2721,7,20915,1161,0,2,2,2,1670,681,115,1157,1
74,1799,1168,838,957,57,25,144,1225,19,348,224,416,367,640,3018,5452,11,61921,3440,1,2,2,2,1680,683,115,1158,1
4,202,1455,414,1257,16,76,112,1471,5,41,23,46,46,69,231,381,2,1069,59,0,2,1,1,1680,684,115,1159,1
29,1712,373,158,315,8,0,51,381,5,76,44,79,81,123,486,779,2,2026,112,0,2,1,1,1680,684,115,1160,1
92,1971,127,75,83,2,11,30,129,4,14,7,14,18,21,61,87,2,175,9,0,2,20,8,1690,685,115,1173,0
92,1971,652,304,544,16,6,88,668,6,89,51,101,95,152,591,998,3,3399,188,0,2,20,8,1690,686,115,1174,0
92,1971,2,2,2,0,0,0,2,0,0,0,0,0,0,0,0,0,0,0,0,2,20,8,1690,686,115,1174,0
92,1971,8,5,5,0,0,3,8,0,0,0,0,0,0,0,0,0,0,0,0,2,20,8,1690,686,115,1175,0
92,1971,2,2,2,0,0,0,2,0,0,0,0,0,0,0,0,0,0,0,0,2,20,8,1690,686,115,1175,0
92,1971,14,8,8,0,0,6,14,0,0,0,0,0,0,0,0,0,0,0,0,2,20,8,1690,686,115,1176,0
92,1971,6,4,4,0,0,2,6,0,0,0,0,0,0,0,0,0,0,0,0,2,20,8,1690,686,115,1177,0
92,1971,6,4,4,0,0,2,6,1,2,1,2,3,3,2,4,0,2,0,0,2,20,8,1690,686,115,1178,0
92,1971,6,4,4,0,0,2,6,0,0,0,0,0,0,0,0,0,0,0,0,2,20,8,1690,686,115,1179,0
92,1971,7,5,5,0,0,2,7,0,0,0,0,0,0,0,0,0,0,0,0,2,20,8,1690,686,115,1180,0
92,1971,6,4,4,0,0,2,6,0,0,0,0,0,0,0,0,0,0,0,0,2,20,8,1690,686,115,1181,0
92,1971,10,6,6,0,0,4,10,0,0,0,0,0,0,0,0,0,0,0,0,2,20,8,1690,686,115,1182,0
92,1971,1,1,1,0,0,0,1,0,0,0,0,0,0,0,0,0,0,0,0,2,20,8,1690,686,115,1182,0
92,1971,14,10,10,0,0,4,14,1,1,1,1,2,2,0,2,0,1,0,0,2,20,8,1690,686,115,1183,0
92,1971,46,26,30,3,0,12,49,3,6,3,6,9,9,20,28,1,42,2,0,2,20,8,1700,686,115,1184,0
92,1991,127,75,83,2,11,30,129,4,14,7,14,18,21,61,87,2,175,9,0,2,4,2,1710,687,115,1197,0
92,1991,652,304,544,16,6,88,668,6,89,51,101,95,152,591,998,3,3399,188,0,2,4,2,1710,688,115,1198,0
92,1991,2,2,2,0,0,0,2,0,0,0,0,0,0,0,0,0,0,0,0,2,4,2,1710,688,115,1198,0
92,1991,8,5,5,0,0,3,8,0,0,0,0,0,0,0,0,0,0,0,0,2,4,2,1710,688,115,1199,0
92,1991,2,2,2,0,0,0,2,0,0,0,0,0,0,0,0,0,0,0,0,2,4,2,1710,688,115,1199,0
92,1991,14,8,8,0,0,6,14,0,0,0,0,0,0,0,0,0,0,0,0,2,4,2,1710,688,115,1200,0
92,1991,6,4,4,0,0,2,6,0,0,0,0,0,0,0,0,0,0,0,0,2,4,2,1710,688,115,1201,0
92,1991,6,4,4,0,0,2,6,1,2,1,2,3,3,2,4,0,2,0,0,2,4,2,1710,688,115,1202,0
92,1991,6,4,4,0,0,2,6,0,0,0,0,0,0,0,0,0,0,0,0,2,4,2,1710,688,115,1203,0
92,1991,7,5,5,0,0,2,7,0,0,0,0,0,0,0,0,0,0,0,0,2,4,2,1710,688,115,1204,0
92,1991,6,4,4,0,0,2,6,0,0,0,0,0,0,0,0,0,0,0,0,2,4,2,1710,688,115,1205,0
92,1991,10,6,6,0,0,4,10,0,0,0,0,0,0,0,0,0,0,0,0,2,4,2,1710,688,115,1206,0
92,1991,1,1,1,0,0,0,1,0,0,0,0,0,0,0,0,0,0,0,0,2,4,2,1710,688,115,1206,0
92,1991,14,10,10,0,0,4,14,1,1,1,1,2,2,0,2,0,1,0,0,2,4,2,1710,688,115,1207,0
92,1991,46,26,30,3,0,12,49,3,6,3,6,9,9,20,28,1,42,2,0,2,4,2,1720,688,115,1208,0
92,1995,127,75,83,2,11,30,129,4,14,7,14,18,21,61,87,2,175,9,0,2,2,1,1720,688,115,1209,0
92,1995,652,304,544,16,6,88,668,6,89,51,101,95,152,591,998,3,3399,188,0,2,2,1,1720,689,115,1210,0
92,1995,2,2,2,0,0,0,2,0,0,0,0,0,0,0,0,0,0,0,0,2,2,1,1720,689,115,1210,0
92,1995,8,5,5,0,0,3,8,0,0,0,0,0,0,0,0,0,0,0,0,2,2,1,1720,689,115,1211,0
92,1995,2,2,2,0,0,0,2,0,0,0,0,0,0,0,0,0,0,0,0,2,2,1,1720,689,115,1211,0
92,1995,14,8,8,0,0,6,14,0,0,0,0,0,0,0,0,0,0,0,0,2,2,1,1720,689,115,1212,0
92,1995,6,4,4,0,0,2,6,0,0,0,0,0,0,0,0,0,0,0,0,2,2,1,1720,689,115,1213,0
92,1995,6,4,4,0,0,2,6,1,2,1,2,3,3,2,4,0,2,0,0,2,2,1,1720,689,115,1214,0
92,1995,6,4,4,0,0,2,6,0,0,0,0,0,0,0,0,0,0,0,0,2,2,1,1720,689,115,1215,0
92,1995,7,5,5,0,0,2,7,0,0,0,0,0,0,0,0,0,0,0,0,2,2,1,1720,689,115,1216,0
92,1995,6,4,4,0,0,2,6,0,0,0,0,0,0,0,0,0,0,0,0,2,2,1,1720,689,115,1217,0
92,1995,10,6,6,0,0,4,10,0,0,0,0,0,0,0,0,0,0,0,0,2,2,1,1720,689,115,1218,0
92,1995,1,1,1,0,0,0,1,0,0,0,0,0,0,0,0,0,0,0,0,2,2,1,1720,689,115,1218,0
92,1995,14,10,10,0,0,4,14,1,1,1,1,2,2,0,2,0,1,0,0,2,2,1,1720,689,115,1219,0
92,1995,46,26,30,3,0,12,49,3,6,3,6,9,9,20,28,1,42,2,0,2,2,1,1730,689,115,1220,0
93,1999,127,75,83,2,11,30,129,4,14,7,14,18,21,61,87,2,175,9,0,2,7,6,1740,693,116,1228,0
93,1999,652,304,544,16,6,88,668,6,89,51,101,95,152,591,998,3,3399,188,0,2,7,6,1740,694,116,1229,0
93,1999,2,2,2,0,0,0,2,0,0,0,0,0,0,0,0,0,0,0,0,2,7,6,1740,694,116,1229,0
93,1999,8,5,5,0,0,3,8,0,0,0,0,0,0,0,0,0,0,0,0,2,7,6,1740,694,116,1230,0
93,1999,2,2,2,0,0,0,2,0,0,0,0,0,0,0,0,0,0,0,0,2,7,6,1740,694,116,1230,0
93,1999,14,8,8,0,0,6,14,0,0,0,0,0,0,0,0,0,0,0,0,2,7,6,1740,694,116,1231,0
93,1999,6,4,4,0,0,2,6,0,0,0,0,0,0,0,0,0,0,0,0,2,7,6,1740,694,116,1232,0
93,1999,6,4,4,0,0,2,6,1,2,1,2,3,3,2,4,0,2,0,0,2,7,6,1740,694,116,1233,0
93,1999,6,4,4,0,0,2,6,0,0,0,0,0,0,0,0,0,0,0,0,2,7,6,1740,694,116,1234,0
93,1999,7,5,5,0,0,2,7,0,0,0,0,0,0,0,0,0,0,0,0,2,7,6,1740,694,116,1235,0
93,1999,6,4,4,0,0,2,6,0,0,0,0,0,0,0,0,0,0,0,0,2,7,6,1740,694,116,1236,0
93,1999,10,6,6,0,0,4,10,0,0,0,0,0,0,0,0,0,0,0,0,2,7,6,1740,694,116,1237,0
93,1999,1,1,1,0,0,0,1,0,0,0,0,0,0,0,0,0,0,0,0,2,7,6,1740,694,116,1237,0
93,1999,14,10,10,0,0,4,14,1,1,1,1,2,2,0,2,0,1,0,0,2,7,6,1740,694,116,1238,0
93,1999,46,26,30,3,0,12,49,3,6,3,6,9,9,20,28,1,42,2,0,2,7,6,1750,694,116,1239,0
94,2025,127,75,83,2,11,30,129,4,14,7,14,18,21,61,87,2,175,9,0,2,3,0,1750,694,116,1240,0
94,2025,652,304,544,16,6,88,668,6,89,51,101,95,152,591,998,3,3399,188,0,2,3,0,1750,695,116,1241,0
94,2025,2,2,2,0,0,0,2,0,0,0,0,0,0,0,0,0,0,0,0,2,3,0,1750,695,116,1241,0
94,2025,8,5,5,0,0,3,8,0,0,0,0,0,0,0,0,0,0,0,0,2,3,0,1750,695,116,1242,0
94,2025,2,2,2,0,0,0,2,0,0,0,0,0,0,0,0,0,0,0,0,2,3,0,1750,695,116,1242,0
94,2025,14,8,8,0,0,6,14,0,0,0,0,0,0,0,0,0,0,0,0,2,3,0,1750,695,116,1243,0
94,2025,6,4,4,0,0,2,6,0,0,0,0,0,0,0,0,0,0,0,0,2,3,0,1750,695,116,1244,0
94,2025,6,4,4,0,0,2,6,1,2,1,2,3,3,2,4,0,2,0,0,2,3,0,1750,695,116,1245,0
94,2025,6,4,4,0,0,2,6,0,0,0,0,0,0,0,0,0,0,0,0,2,3,0,1750,695,116,1246,0
94,2025,7,5,5,0,0,2,7,0,0,0,0,0,0,0,0,0,0,0,0,2,3,0,1750,695,116,1247,0
94,2025,6,4,4,0,0,2,6,0,0,0,0,0,0,0,0,0,0,0,0,2,3,0,1750,695,116,1248,0
94,2025,10,6,6,0,0,4,10,0,0,0,0,0,0,0,0,0,0,0,0,2,3,0,1750,695,116,1249,0
94,2025,1,1,1,0,0,0,1,0,0,0,0,0,0,0,0,0,0,0,0,2,3,0,1750,695,116,1249,0
94,2025,14,10,10,0,0,4,14,1,1,1,1,2,2,0,2,0,1,0,0,2,3,0,1750,695,116,1250,0
94,2025,46,26,30,3,0,12,49,3,6,3,6,9,9,20,28,1,42,2,0,2,3,0,1760,695,116,1251,0
74,1803,1943,715,1694,26,18,214,1969,12,185,120,237,197,357,1436,2721,7,20915,1161,0,2,9,5,1800,713,120,1280,0
74,1803,1168,838,957,57,25,144,1225,19,348,224,416,367,640,3018,5452,11,61921,3440,1,2,9,5,1810,715,120,1281,0
146,2579,1338,495,1086,10,64,173,1348,11,122,82,157,133,239,883,1686,7,11934,663,0,2,3,8,1820,721,121,1289,0
41,1388,773,419,590,28,0,166,801,10,204,113,217,214,330,1598,2554,5,13587,754,0,2,12,0,1890,749,129,1339,0
154,2728,1338,495,1086,10,64,173,1348,11,122,82,157,133,239,883,1686,7,11934,663,0,2,32,1,1890,751,129,1340,0
54,751,373,158,315,8,0,51,381,5,76,44,79,81,123,486,779,2,2026,112,0,2,16,5,1890,751,129,1341,0
30,1793,373,158,315,8,0,51,381,5,76,44,79,81,123,486,779,2,2026,112,0,2,14,2,1890,751,129,1342,0
52,722,373,158,315,8,0,51,381,5,76,44,79,81,123,486,779,2,2026,112,0,2,6,11,1890,751,129,1343,0
30,1793,373,158,315,8,0,51,381,5,76,44,79,81,123,486,779,2,2026,112,0,2,1,2,1890,751,129,1344,0
6,265,207,111,150,11,0,50,218,5,26,19,36,31,55,133,272,3,943,52,0,0,59,0,1890,751,129,1345,0
6,265,410,198,237,31,55,97,441,11,63,38,72,74,110,414,683,6,4293,238,0,0,59,0,1900,752,130,1346,0
4,225,207,111,150,11,0,50,218,5,26,19,36,31,55,133,272,3,943,52,0,0,53,0,1900,752,130,1347,0
154,2728,1338,495,1086,10,64,173,1348,11,122,82,157,133,239,883,1686,7,11934,663,0,2,1,1,1910,758,131,1355,0
154,2732,1338,495,1086,10,64,173,1348,11,122,82,157,133,239,883,1686,7,11934,663,0,2,1,1,1910,760,131,1356,0
13,259,1392,870,1177,35,17,170,1427,14,494,280,531,508,811,4473,7289,7,54850,3047,2,2,3,0,1910,763,132,1357,0
12,243,1392,870,1177,35,17,170,1427,14,494,280,531,508,811,4473,7289,7,54850,3047,2,2,1,4,1910,766,133,1358,0
31,1899,373,158,315,8,0,51,381,5,76,44,79,81,123,486,779,2,2026,112,0,2,21,0,1930,771,134,1378,1
152,2711,1338,495,1086,10,64,173,1348,11,122,82,157,133,239,883,1686,7,11934,663,0,2,1,4,1940,777,135,1386,0
148,2629,1338,495,1086,10,64,173,1348,11,122,82,157,133,239,883,1686,7,11934,663,0,2,5,16,1940,779,135,1387,0
59,833,373,158,315,8,0,51,381,5,76,44,79,81,123,486,779,2,2026,112,0,2,37,19,1940,779,135,1388,0
48,3132,1457,730,1242,11,6,188,1468,10,292,166,329,302,495,2424,4078,5,22973,1276,1,2,0,1,1940,781,135,1389,0
74,1813,1943,715,1694,26,18,214,1969,12,185,120,237,197,357,1436,2721,7,20915,1161,0,2,2,2,1960,791,137,1404,0
74,1813,1168,838,957,57,25,144,1225,19,348,224,416,367,640,3018,5452,11,61921,3440,1,2,2,2,1970,793,137,1405,0
74,1815,1943,715,1694,26,18,214,1969,12,185,120,237,197,357,1436,2721,7,20915,1161,0,2,1,1,1970,795,137,1406,0
74,1815,1168,838,957,57,25,144,1225,19,348,224,416,367,640,3018,5452,11,61921,3440,1,2,1,1,1980,797,137,1407,0
157,2724,1338,495,1086,10,64,173,1348,11,122,82,157,133,239,883,1686,7,11934,663,0,2,23,8,1980,799,137,1408,0
59,833,373,158,315,8,0,51,381,5,76,44,79,81,123,486,779,2,2026,112,0,2,1,1,1980,799,137,1409,0
32,1923,373,158,315,8,0,51,381,5,76,44,79,81,123,486,779,2,2026,112,0,2,13,10,1980,799,137,1410,0
59,840,373,158,315,8,0,51,381,5,76,44,79,81,123,486,779,2,2026,112,0,2,1,0,1980,799,137,1411,0
95,2040,127,75,83,2,11,30,129,4,14,7,14,18,21,61,87,2,175,9,0,2,3,2,1980,799,137,1412,0
95,2040,652,304,544,16,6,88,668,6,89,51,101,95,152,591,998,3,3399,188,0,2,3,2,1980,800,137,1413,0
95,2040,2,2,2,0,0,0,2,0,0,0,0,0,0,0,0,0,0,0,0,2,3,2,1980,800,137,1413,0
95,2040,8,5,5,0,0,3,8,0,0,0,0,0,0,0,0,0,0,0,0,2,3,2,1980,800,137,1414,0
95,2040,2,2,2,0,0,0,2,0,0,0,0,0,0,0,0,0,0,0,0,2,3,2,1980,800,137,1414,0
95,2040,14,8,8,0,0,6,14,0,0,0,0,0,0,0,0,0,0,0,0,2,3,2,1980,800,137,1415,0
95,2040,6,4,4,0,0,2,6,0,0,0,0,0,0,0,0,0,0,0,0,2,3,2,1980,800,137,1416,0
95,2040,6,4,4,0,0,2,6,1,2,1,2,3,3,2,4,0,2,0,0,2,3,2,1980,800,137,1417,0
95,2040,6,4,4,0,0,2,6,0,0,0,0,0,0,0,0,0,0,0,0,2,3,2,1980,800,137,1418,0
95,2040,7,5,5,0,0,2,7,0,0,0,0,0,0,0,0,0,0,0,0,2,3,2,1980,800,137,1419,0
95,2040,6,4,4,0,0,2,6,0,0,0,0,0,0,0,0,0,0,0,0,2,3,2,1980,800,137,1420,0
95,2040,10,6,6,0,0,4,10,0,0,0,0,0,0,0,0,0,0,0,0,2,3,2,1980,800,137,1421,0
95,2040,1,1,1,0,0,0,1,0,0,0,0,0,0,0,0,0,0,0,0,2,3,2,1980,800,137,1421,0
95,2040,14,10,10,0,0,4,14,1,1,1,1,2,2,0,2,0,1,0,0,2,3,2,1980,800,137,1422,0
95,2040,46,26,30,3,0,12,49,3,6,3,6,9,9,20,28,1,42,2,0,2,3,2,1990,800,137,1423,0
62,1372,773,419,590,28,0,166,801,10,204,113,217,214,330,1598,2554,5,13587,754,0,2,1,1,1990,800,138,1424,0
62,1372,421,273,302,44,34,57,465,17,81,59,107,98,166,583,1098,11,12329,684,0,2,1,1,1990,800,139,1425,0
1,70,13,10,10,0,0,3,13,1,2,1,2,3,3,2,4,0,2,0,0,2,4,6,2000,804,140,1433,1
16,823,652,304,544,16,6,88,668,6,89,51,101,95,152,591,998,3,3399,188,0,2,32,28,2000,805,140,1434,1
157,2724,1338,495,1086,10,64,173,1348,11,122,82,157,133,239,883,1686,7,11934,663,0,2,1,1,2000,807,140,1435,1
67,1507,1457,730,1242,11,6,188,1468,10,292,166,329,302,495,2424,4078,5,22973,1276,1,2,7,14,2000,809,140,1436,1
67,1507,74,35,59,1,0,14,75,3,14,7,14,17,21,58,85,1,128,7,0,2,7,14,2000,810,140,1437,1
67,1507,245,125,200,5,7,34,250,7,30,17,34,37,51,166,265,3,1053,58,0,2,7,14,2010,811,140,1438,1
47,906,373,158,315,8,0,51,381,5,76,44,79,81,123,486,779,2,2026,112,0,2,94,86,2010,811,140,1439,1
47,3118,1457,730,1242,11,6,188,1468,10,292,166,329,302,495,2424,4078,5,22973,1276,1,2,9,7,2020,817,140,1442,1
48,1730,373,158,315,8,0,51,381,5,76,44,79,81,123,486,779,2,2026,112,0,2,94,146,2020,817,140,1443,1
2,50,127,75,83,2,11,30,129,4,14,7,14,18,21,61,87,2,175,9,0,2,6,2,2020,817,140,1444,1
2,50,652,304,544,16,6,88,668,6,89,51,101,95,152,591,998,3,3399,188,0,2,6,2,2020,818,140,1445,1
2,50,2,2,2,0,0,0,2,0,0,0,0,0,0,0,0,0,0,0,0,2,6,2,2020,818,140,1445,1
2,50,8,5,5,0,0,3,8,0,0,0,0,0,0,0,0,0,0,0,0,2,6,2,2020,818,140,1446,1
2,50,2,2,2,0,0,0,2,0,0,0,0,0,0,0,0,0,0,0,0,2,6,2,2020,818,140,1446,1
2,50,14,8,8,0,0,6,14,0,0,0,0,0,0,0,0,0,0,0,0,2,6,2,2020,818,140,1447,1
2,50,6,4,4,0,0,2,6,0,0,0,0,0,0,0,0,0,0,0,0,2,6,2,2020,818,140,1448,1
2,50,6,4,4,0,0,2,6,1,2,1,2,3,3,2,4,0,2,0,0,2,6,2,2020,818,140,1449,1
2,50,6,4,4,0,0,2,6,0,0,0,0,0,0,0,0,0,0,0,0,2,6,2,2020,818,140,1450,1
2,50,7,5,5,0,0,2,7,0,0,0,0,0,0,0,0,0,0,0,0,2,6,2,2020,818,140,1451,1
2,50,6,4,4,0,0,2,6,0,0,0,0,0,0,0,0,0,0,0,0,2,6,2,2020,818,140,1452,1
2,50,10,6,6,0,0,4,10,0,0,0,0,0,0,0,0,0,0,0,0,2,6,2,2020,818,140,1453,1
2,50,1,1,1,0,0,0,1,0,0,0,0,0,0,0,0,0,0,0,0,2,6,2,2020,818,140,1453,1
2,50,14,10,10,0,0,4,14,1,1,1,1,2,2,0,2,0,1,0,0,2,6,2,2020,818,140,1454,1
2,50,46,26,30,3,0,12,49,3,6,3,6,9,9,20,28,1,42,2,0,2,6,2,2030,818,140,1455,1
95,2040,127,75,83,2,11,30,129,4,14,7,14,18,21,61,87,2,175,9,0,2,1,1,2040,822,141,1463,0
95,2040,652,304,544,16,6,88,668,6,89,51,101,95,152,591,998,3,3399,188,0,2,1,1,2040,823,141,1464,0
95,2040,2,2,2,0,0,0,2,0,0,0,0,0,0,0,0,0,0,0,0,2,1,1,2040,823,141,1464,0
95,2040,8,5,5,0,0,3,8,0,0,0,0,0,0,0,0,0,0,0,0,2,1,1,2040,823,141,1465,0
95,2040,2,2,2,0,0,0,2,0,0,0,0,0,0,0,0,0,0,0,0,2,1,1,2040,823,141,1465,0
95,2040,14,8,8,0,0,6,14,0,0,0,0,0,0,0,0,0,0,0,0,2,1,1,2040,823,141,1466,0
95,2040,6,4,4,0,0,2,6,0,0,0,0,0,0,0,0,0,0,0,0,2,1,1,2040,823,141,1467,0
95,2040,6,4,4,0,0,2,6,1,2,1,2,3,3,2,4,0,2,0,0,2,1,1,2040,823,141,1468,0
95,2040,6,4,4,0,0,2,6,0,0,0,0,0,0,0,0,0,0,0,0,2,1,1,2040,823,141,1469,0
95,2040,7,5,5,0,0,2,7,0,0,0,0,0,0,0,0,0,0,0,0,2,1,1,2040,823,141,1470,0
95,2040,6,4,4,0,0,2,6,0,0,0,0,0,0,0,0,0,0,0,0,2,1,1,2040,823,141,1471,0
95,2040,10,6,6,0,0,4,10,0,0,0,0,0,0,0,0,0,0,0,0,2,1,1,2040,823,141,1472,0
95,2040,1,1,1,0,0,0,1,0,0,0,0,0,0,0,0,0,0,0,0,2,1,1,2040,823,141,1472,0
95,2040,14,10,10,0,0,4,14,1,1,1,1,2,2,0,2,0,1,0,0,2,1,1,2040,823,141,1473,0
95,2040,46,26,30,3,0,12,49,3,6,3,6,9,9,20,28,1,42,2,0,2,1,1,2050,823,141,1474,0
47,906,373,158,315,8,0,51,381,5,76,44,79,81,123,486,779,2,2026,112,0,2,2,2,2070,828,142,1494,0
48,908,373,158,315,8,0,51,381,5,76,44,79,81,123,486,779,2,2026,112,0,2,1,1,2070,828,142,1495,0
48,1730,373,158,315,8,0,51,381,5,76,44,79,81,123,486,779,2,2026,112,0,2,3,3,2070,828,142,1496,0
49,934,373,158,315,8,0,51,381,5,76,44,79,81,123,486,779,2,2026,112,0,2,2,0,2070,828,142,1497,0
48,1742,373,158,315,8,0,51,381,5,76,44,79,81,123,486,779,2,2026,112,0,2,4,4,2080,832,143,1505,1
157,2702,1338,495,1086,10,64,173,1348,11,122,82,157,133,239,883,1686,7,11934,663,0,2,10,6,2080,834,143,1506,0
3,79,1455,414,1257,16,76,112,1471,5,41,23,46,46,69,231,381,2,1069,59,0,2,6,15,2080,835,143,1507,0
3,79,669,365,481,22,61,110,691,15,103,63,122,118,185,747,1273,8,11311,628,0,2,6,15,2090,835,144,1508,0
5,262,1455,414,1257,16,76,112,1471,5,41,23,46,46,69,231,381,2,1069,59,0,2,19,14,2090,836,144,1509,0
41,1405,773,419,590,28,0,166,801,10,204,113,217,214,330,1598,2554,5,13587,754,0,2,10,7,2090,836,145,1510,0
41,1405,773,419,590,28,0,166,801,10,204,113,217,214,330,1598,2554,5,13587,754,0,2,1,1,2090,836,146,1511,0
22,535,182,127,129,0,0,53,182,5,39,21,42,44,63,217,343,2,926,51,0,0,102,0,2330,934,177,1685,1
22,535,1165,710,800,67,119,181,1232,18,243,153,282,261,435,2000,3492,10,36473,2026,1,0,102,0,2340,934,178,1686,1
84,1873,1392,870,1177,35,17,170,1427,14,494,280,531,508,811,4473,7289,7,54850,3047,2,0,325,0,2340,937,179,1687,1
62,1415,773,419,590,28,0,166,801,10,204,113,217,214,330,1598,2554,5,13587,754,0,0,287,0,2340,937,180,1688,1
62,1415,421,273,302,44,34,57,465,17,81,59,107,98,166,583,1098,11,12329,684,0,0,287,0,2340,937,181,1689,1
13,518,182,127,129,0,0,53,182,5,39,21,42,44,63,217,343,2,926,51,0,0,85,0,2350,941,183,1697,1
88,3213,1392,870,1177,35,17,170,1427,14,494,280,531,508,811,4473,7289,7,54850,3047,2,0,584,0,2350,944,184,1698,1
46,1526,773,419,590,28,0,166,801,10,204,113,217,214,330,1598,2554,5,13587,754,0,0,316,0,2350,944,185,1699,1
1,28,127,75,83,2,11,30,129,4,14,7,14,18,21,61,87,2,175,9,0,2,1,1,2350,944,185,1700,1
1,28,652,304,544,16,6,88,668,6,89,51,101,95,152,591,998,3,3399,188,0,2,1,1,2350,945,185,1701,1
1,28,2,2,2,0,0,0,2,0,0,0,0,0,0,0,0,0,0,0,0,2,1,1,2350,945,185,1701,1
1,28,8,5,5,0,0,3,8,0,0,0,0,0,0,0,0,0,0,0,0,2,1,1,2350,945,185,1702,1
1,28,2,2,2,0,0,0,2,0,0,0,0,0,0,0,0,0,0,0,0,2,1,1,2350,945,185,1702,1
1,28,14,8,8,0,0,6,14,0,0,0,0,0,0,0,0,0,0,0,0,2,1,1,2350,945,185,1703,1
1,28,6,4,4,0,0,2,6,0,0,0,0,0,0,0,0,0,0,0,0,2,1,1,2350,945,185,1704,1
1,28,6,4,4,0,0,2,6,1,2,1,2,3,3,2,4,0,2,0,0,2,1,1,2350,945,185,1705,1
1,28,6,4,4,0,0,2,6,0,0,0,0,0,0,0,0,0,0,0,0,2,1,1,2350,945,185,1706,1
1,28,7,5,5,0,0,2,7,0,0,0,0,0,0,0,0,0,0,0,0,2,1,1,2350,945,185,1707,1
1,28,6,4,4,0,0,2,6,0,0,0,0,0,0,0,0,0,0,0,0,2,1,1,2350,945,185,1708,1
1,28,10,6,6,0,0,4,10,0,0,0,0,0,0,0,0,0,0,0,0,2,1,1,2350,945,185,1709,1
1,28,1,1,1,0,0,0,1,0,0,0,0,0,0,0,0,0,0,0,0,2,1,1,2350,945,185,1709,1
1,28,14,10,10,0,0,4,14,1,1,1,1,2,2,0,2,0,1,0,0,2,1,1,2350,945,185,1710,1
1,28,46,26,30,3,0,12,49,3,6,3,6,9,9,20,28,1,42,2,0,2,1,1,2360,945,185,1711,1
102,2207,127,75,83,2,11,30,129,4,14,7,14,18,21,61,87,2,175,9,0,0,344,0,2370,949,186,1719,1
102,2207,652,304,544,16,6,88,668,6,89,51,101,95,152,591,998,3,3399,188,0,0,344,0,2370,950,186,1720,1
102,2207,2,2,2,0,0,0,2,0,0,0,0,0,0,0,0,0,0,0,0,0,344,0,2370,950,186,1720,1
102,2207,8,5,5,0,0,3,8,0,0,0,0,0,0,0,0,0,0,0,0,0,344,0,2370,950,186,1721,1
102,2207,2,2,2,0,0,0,2,0,0,0,0,0,0,0,0,0,0,0,0,0,344,0,2370,950,186,1721,1
102,2207,14,8,8,0,0,6,14,0,0,0,0,0,0,0,0,0,0,0,0,0,344,0,2370,950,186,1722,1
102,2207,6,4,4,0,0,2,6,0,0,0,0,0,0,0,0,0,0,0,0,0,344,0,2370,950,186,1723,1
102,2207,6,4,4,0,0,2,6,1,2,1,2,3,3,2,4,0,2,0,0,0,344,0,2370,950,186,1724,1
102,2207,6,4,4,0,0,2,6,0,0,0,0,0,0,0,0,0,0,0,0,0,344,0,2370,950,186,1725,1
102,2207,7,5,5,0,0,2,7,0,0,0,0,0,0,0,0,0,0,0,0,0,344,0,2370,950,186,1726,1
102,2207,6,4,4,0,0,2,6,0,0,0,0,0,0,0,0,0,0,0,0,0,344,0,2370,950,186,1727,1
102,2207,10,6,6,0,0,4,10,0,0,0,0,0,0,0,0,0,0,0,0,0,344,0,2370,950,186,1728,1
102,2207,1,1,1,0,0,0,1,0,0,0,0,0,0,0,0,0,0,0,0,0,344,0,2370,950,186,1728,1
102,2207,14,10,10,0,0,4,14,1,1,1,1,2,2,0,2,0,1,0,0,0,344,0,2370,950,186,1729,1
102,2207,46,26,30,3,0,12,49,3,6,3,6,9,9,20,28,1,42,2,0,0,344,0,2380,950,186,1730,1
35,478,282,196,195,3,0,86,285,8,130,71,141,138,212,936,1507,4,6538,363,0,0,120,0,2380,950,187,1731,1
1,70,13,10,10,0,0,3,13,1,2,1,2,3,3,2,4,0,2,0,0,0,11,0,2380,950,187,1732,1
7,111,44,19,17,0,16,11,44,3,14,7,14,17,21,58,85,1,128,7,0,0,42,0,2380,950,187,1733,1
17,841,652,304,544,16,6,88,668,6,89,51,101,95,152,591,998,3,3399,188,0,0,148,0,2380,951,187,1734,1
2,50,127,75,83,2,11,30,129,4,14,7,14,18,21,61,87,2,175,9,0,2,2,2,2380,951,187,1735,1
2,50,652,304,544,16,6,88,668,6,89,51,101,95,152,591,998,3,3399,188,0,2,2,2,2380,952,187,1736,1
2,50,2,2,2,0,0,0,2,0,0,0,0,0,0,0,0,0,0,0,0,2,2,2,2380,952,187,1736,1
2,50,8,5,5,0,0,3,8,0,0,0,0,0,0,0,0,0,0,0,0,2,2,2,2380,952,187,1737,1
2,50,2,2,2,0,0,0,2,0,0,0,0,0,0,0,0,0,0,0,0,2,2,2,2380,952,187,1737,1
2,50,14,8,8,0,0,6,14,0,0,0,0,0,0,0,0,0,0,0,0,2,2,2,2380,952,187,1738,1
2,50,6,4,4,0,0,2,6,0,0,0,0,0,0,0,0,0,0,0,0,2,2,2,2380,952,187,1739,1
2,50,6,4,4,0,0,2,6,1,2,1,2,3,3,2,4,0,2,0,0,2,2,2,2380,952,187,1740,1
2,50,6,4,4,0,0,2,6,0,0,0,0,0,0,0,0,0,0,0,0,2,2,2,2380,952,187,1741,1
2,50,7,5,5,0,0,2,7,0,0,0,0,0,0,0,0,0,0,0,0,2,2,2,2380,952,187,1742,1
2,50,6,4,4,0,0,2,6,0,0,0,0,0,0,0,0,0,0,0,0,2,2,2,2380,952,187,1743,1
2,50,10,6,6,0,0,4,10,0,0,0,0,0,0,0,0,0,0,0,0,2,2,2,2380,952,187,1744,1
2,50,1,1,1,0,0,0,1,0,0,0,0,0,0,0,0,0,0,0,0,2,2,2,2380,952,187,1744,1
2,50,14,10,10,0,0,4,14,1,1,1,1,2,2,0,2,0,1,0,0,2,2,2,2380,952,187,1745,1
2,50,46,26,30,3,0,12,49,3,6,3,6,9,9,20,28,1,42,2,0,2,2,2,2390,952,187,1746,1
9,378,15,9,9,0,0,6,15,0,0,0,0,0,0,0,0,0,0,0,0,0,79,0,2430,968,191,1775,1
5,104,1943,715,1694,26,18,214,1969,12,185,120,237,197,357,1436,2721,7,20915,1161,0,0,25,0,2440,974,192,1783,1
114,2015,1338,495,1086,10,64,173,1348,11,122,82,157,133,239,883,1686,7,11934,663,0,0,413,0,2450,980,193,1791,1
6,254,207,111,150,11,0,50,218,5,26,19,36,31,55,133,272,3,943,52,0,0,58,0,2450,980,193,1792,1
6,254,410,198,237,31,55,97,441,11,63,38,72,74,110,414,683,6,4293,238,0,0,58,0,2460,981,194,1793,1
58,1278,1457,730,1242,11,6,188,1468,10,292,166,329,302,495,2424,4078,5,22973,1276,1,0,256,0,2460,983,194,1794,1
58,1278,74,35,59,1,0,14,75,3,14,7,14,17,21,58,85,1,128,7,0,0,256,0,2460,984,194,1795,1
58,1278,245,125,200,5,7,34,250,7,30,17,34,37,51,166,265,3,1053,58,0,0,256,0,2470,985,194,1796,1
26,384,477,336,357,30,23,73,507,16,194,134,250,210,384,1538,2962,10,30538,1696,0,0,70,0,2520,1002,198,1825,1
61,1388,1943,715,1694,26,18,214,1969,12,185,120,237,197,357,1436,2721,7,20915,1161,0,0,199,0,2530,1008,199,1833,1
61,1388,1168,838,957,57,25,144,1225,19,348,224,416,367,640,3018,5452,11,61921,3440,1,0,199,0,2540,1010,199,1834,1
13,1034,1943,715,1694,26,18,214,1969,12,185,120,237,197,357,1436,2721,7,20915,1161,0,0,164,0,2550,1016,200,1842,1
33,845,1043,504,840,53,9,147,1096,9,180,112,198,189,310,1377,2344,4,11604,644,0,0,146,0,2560,1022,201,1850,1
33,845,383,288,292,26,6,62,409,11,65,38,67,76,105,429,656,5,3719,206,0,0,146,0,2560,1023,201,1851,1
48,883,373,158,315,8,0,51,381,5,76,44,79,81,123,486,779,2,2026,112,0,0,151,0,2560,1023,201,1852,1
32,1506,1289,550,1043,56,32,155,1345,10,167,93,185,177,278,1266,2075,5,11498,638,0,0,425,0,2570,1029,203,1860,1
4,225,207,111,150,11,0,50,218,5,26,19,36,31,55,133,272,3,943,52,0,0,53,0,2580,1033,204,1868,1
58,3609,1457,730,1242,11,6,188,1468,10,292,166,329,302,495,2424,4078,5,22973,1276,1,0,493,0,2580,1035,204,1869,1
3,185,1455,414,1257,16,76,112,1471,5,41,23,46,46,69,231,381,2,1069,59,0,0,34,0,2580,1036,204,1870,1
31,1367,373,158,315,8,0,51,381,5,76,44,79,81,123,486,779,2,2026,112,0,0,274,0,2580,1036,204,1871,1
1,76,42,7,35,4,0,5,46,1,2,1,2,3,3,2,4,0,2,0,0,0,10,0,2630,1053,208,1912,1
1,76,11,6,10,0,0,1,11,2,4,2,4,6,6,10,15,1,15,0,0,0,10,0,2630,1053,208,1913,1
6,596,42,7,35,4,0,5,46,1,2,1,2,3,3,2,4,0,2,0,0,2,207,3,2630,1053,208,1914,1
6,596,11,6,10,0,0,1,11,2,4,2,4,6,6,10,15,1,15,0,0,2,207,3,2630,1053,208,1915,1
32,1379,373,158,315,8,0,51,381,5,76,44,79,81,123,486,779,2,2026,112,0,2,2,1,2630,1053,208,1916,1
32,1517,1289,550,1043,56,32,155,1345,10,167,93,185,177,278,1266,2075,5,11498,638,0,2,2,1,2630,1055,209,1917,0
21,1028,42,7,35,4,0,5,46,1,2,1,2,3,3,2,4,0,2,0,0,2,106,13,2630,1055,209,1918,1
21,1028,11,6,10,0,0,1,11,2,4,2,4,6,6,10,15,1,15,0,0,2,106,13,2630,1055,209,1919,1
84,1873,1392,870,1177,35,17,170,1427,14,494,280,531,508,811,4473,7289,7,54850,3047,2,2,1,1,2640,1062,211,1927,0
1,485,42,7,35,4,0,5,46,1,2,1,2,3,3,2,4,0,2,0,0,2,45,111,2670,1074,214,1949,1
1,485,11,6,10,0,0,1,11,2,4,2,4,6,6,10,15,1,15,0,0,2,45,111,2670,1074,214,1950,1
33,845,1043,504,840,53,9,147,1096,9,180,112,198,189,310,1377,2344,4,11604,644,0,2,1,1,2680,1080,215,1958,1
33,845,383,288,292,26,6,62,409,11,65,38,67,76,105,429,656,5,3719,206,0,2,1,1,2680,1081,215,1959,1
1,487,42,7,35,4,0,5,46,1,2,1,2,3,3,2,4,0,2,0,0,2,2,1,2690,1085,216,1967,0
1,487,11,6,10,0,0,1,11,2,4,2,4,6,6,10,15,1,15,0,0,2,2,1,2690,1085,216,1968,0
9,213,1450,624,1228,12,26,181,1462,14,306,186,354,320,540,2580,4493,8,36391,2021,1,2,8,1,2690,1087,217,1969,0
25,429,1450,624,1228,12,26,181,1462,14,306,186,354,320,540,2580,4493,8,36391,2021,1,2,8,0,2690,1089,218,1970,0
35,1582,1289,550,1043,56,32,155,1345,10,167,93,185,177,278,1266,2075,5,11498,638,0,2,15,5,2690,1091,219,1971,0
60,1308,1457,730,1242,11,6,188,1468,10,292,166,329,302,495,2424,4078,5,22973,1276,1,2,6,0,2690,1093,219,1972,0
60,1308,74,35,59,1,0,14,75,3,14,7,14,17,21,58,85,1,128,7,0,2,6,0,2690,1094,219,1973,0
60,1308,245,125,200,5,7,34,250,7,30,17,34,37,51,166,265,3,1053,58,0,2,6,0,2700,1095,219,1974,0
59,3677,1457,730,1242,11,6,188,1468,10,292,166,329,302,495,2424,4078,5,22973,1276,1,2,8,0,2700,1097,219,1975,0
68,1461,1457,730,1242,11,6,188,1468,10,292,166,329,302,495,2424,4078,5,22973,1276,1,2,27,0,2700,1099,219,1976,0
68,1461,74,35,59,1,0,14,75,3,14,7,14,17,21,58,85,1,128,7,0,2,27,0,2700,1100,219,1977,0
68,1461,245,125,200,5,7,34,250,7,30,17,34,37,51,166,265,3,1053,58,0,2,27,0,2710,1101,219,1978,0
60,3777,1457,730,1242,11,6,188,1468,10,292,166,329,302,495,2424,4078,5,22973,1276,1,2,16,1,2710,1103,219,1979,0
1,487,42,7,35,4,0,5,46,1,2,1,2,3,3,2,4,0,2,0,0,2,1,1,2710,1103,219,1980,1
1,487,11,6,10,0,0,1,11,2,4,2,4,6,6,10,15,1,15,0,0,2,1,1,2710,1103,219,1981,1
68,1469,1457,730,1242,11,6,188,1468,10,292,166,329,302,495,2424,4078,5,22973,1276,1,2,3,2,2710,1105,219,1982,0
68,1469,74,35,59,1,0,14,75,3,14,7,14,17,21,58,85,1,128,7,0,2,3,2,2710,1106,219,1983,0
68,1469,245,125,200,5,7,34,250,7,30,17,34,37,51,166,265,3,1053,58,0,2,3,2,2720,1107,219,1984,0
60,3773,1457,730,1242,11,6,188,1468,10,292,166,329,302,495,2424,4078,5,22973,1276,1,2,2,2,2720,1109,219,1985,0
116,2055,1338,495,1086,10,64,173,1348,11,122,82,157,133,239,883,1686,7,11934,663,0,2,8,2,2720,1111,219,1986,1
68,1487,1457,730,1242,11,6,188,1468,10,292,166,329,302,495,2424,4078,5,22973,1276,1,2,2,1,2720,1113,219,1987,1
68,1487,74,35,59,1,0,14,75,3,14,7,14,17,21,58,85,1,128,7,0,2,2,1,2720,1114,219,1988,1
68,1487,245,125,200,5,7,34,250,7,30,17,34,37,51,166,265,3,1053,58,0,2,2,1,2730,1115,219,1989,1
60,3776,1457,730,1242,11,6,188,1468,10,292,166,329,302,495,2424,4078,5,22973,1276,1,2,1,1,2730,1117,219,1990,0
142,2436,1338,495,1086,10,64,173,1348,11,122,82,157,133,239,883,1686,7,11934,663,0,2,136,58,2730,1119,219,1991,1
6,254,207,111,150,11,0,50,218,5,26,19,36,31,55,133,272,3,943,52,0,2,1,1,2730,1119,219,1992,1
6,254,410,198,237,31,55,97,441,11,63,38,72,74,110,414,683,6,4293,238,0,2,1,1,2740,1120,220,1993,1
12,1018,1943,715,1694,26,18,214,1969,12,185,120,237,197,357,1436,2721,7,20915,1161,0,2,2,3,2740,1122,220,1994,1
32,832,1043,504,840,53,9,147,1096,9,180,112,198,189,310,1377,2344,4,11604,644,0,2,2,2,2740,1124,220,1995,1
32,832,383,288,292,26,6,62,409,11,65,38,67,76,105,429,656,5,3719,206,0,2,2,2,2740,1125,220,1996,1
35,1582,1289,550,1043,56,32,155,1345,10,167,93,185,177,278,1266,2075,5,11498,638,0,2,2,2,2740,1127,221,1997,1
58,3584,1457,730,1242,11,6,188,1468,10,292,166,329,302,495,2424,4078,5,22973,1276,1,2,4,30,2740,1129,221,1998,1
3,185,1455,414,1257,16,76,112,1471,5,41,23,46,46,69,231,381,2,1069,59,0,2,2,2,2740,1130,221,1999,1
33,1436,373,158,315,8,0,51,381,5,76,44,79,81,123,486,779,2,2026,112,0,2,16,1,2740,1130,221,2000,1
1,28,127,75,83,2,11,30,129,4,14,7,14,18,21,61,87,2,175,9,0,2,2,2,2750,1134,222,2008,1
1,28,652,304,544,16,6,88,668,6,89,51,101,95,152,591,998,3,3399,188,0,2,2,2,2750,1135,222,2009,1
1,28,2,2,2,0,0,0,2,0,0,0,0,0,0,0,0,0,0,0,0,2,2,2,2750,1135,222,2009,1
1,28,8,5,5,0,0,3,8,0,0,0,0,0,0,0,0,0,0,0,0,2,2,2,2750,1135,222,2010,1
1,28,2,2,2,0,0,0,2,0,0,0,0,0,0,0,0,0,0,0,0,2,2,2,2750,1135,222,2010,1
1,28,14,8,8,0,0,6,14,0,0,0,0,0,0,0,0,0,0,0,0,2,2,2,2750,1135,222,2011,1
1,28,6,4,4,0,0,2,6,0,0,0,0,0,0,0,0,0,0,0,0,2,2,2,2750,1135,222,2012,1
1,28,6,4,4,0,0,2,6,1,2,1,2,3,3,2,4,0,2,0,0,2,2,2,2750,1135,222,2013,1
1,28,6,4,4,0,0,2,6,0,0,0,0,0,0,0,0,0,0,0,0,2,2,2,2750,1135,222,2014,1
1,28,7,5,5,0,0,2,7,0,0,0,0,0,0,0,0,0,0,0,0,2,2,2,2750,1135,222,2015,1
1,28,6,4,4,0,0,2,6,0,0,0,0,0,0,0,0,0,0,0,0,2,2,2,2750,1135,222,2016,1
1,28,10,6,6,0,0,4,10,0,0,0,0,0,0,0,0,0,0,0,0,2,2,2,2750,1135,222,2017,1
1,28,1,1,1,0,0,0,1,0,0,0,0,0,0,0,0,0,0,0,0,2,2,2,2750,1135,222,2017,1
1,28,14,10,10,0,0,4,14,1,1,1,1,2,2,0,2,0,1,0,0,2,2,2,2750,1135,222,2018,1
1,28,46,26,30,3,0,12,49,3,6,3,6,9,9,20,28,1,42,2,0,2,2,2,2760,1135,222,2019,1
88,2029,127,75,83,2,11,30,129,4,14,7,14,18,21,61,87,2,175,9,0,2,20,41,2760,1135,222,2020,1
88,2029,652,304,544,16,6,88,668,6,89,51,101,95,152,591,998,3,3399,188,0,2,20,41,2760,1136,222,2021,1
88,2029,2,2,2,0,0,0,2,0,0,0,0,0,0,0,0,0,0,0,0,2,20,41,2760,1136,222,2021,1
88,2029,8,5,5,0,0,3,8,0,0,0,0,0,0,0,0,0,0,0,0,2,20,41,2760,1136,222,2022,1
88,2029,2,2,2,0,0,0,2,0,0,0,0,0,0,0,0,0,0,0,0,2,20,41,2760,1136,222,2022,1
88,2029,14,8,8,0,0,6,14,0,0,0,0,0,0,0,0,0,0,0,0,2,20,41,2760,1136,222,2023,1
88,2029,6,4,4,0,0,2,6,0,0,0,0,0,0,0,0,0,0,0,0,2,20,41,2760,1136,222,2024,1
88,2029,6,4,4,0,0,2,6,1,2,1,2,3,3,2,4,0,2,0,0,2,20,41,2760,1136,222,2025,1
88,2029,6,4,4,0,0,2,6,0,0,0,0,0,0,0,0,0,0,0,0,2,20,41,2760,1136,222,2026,1
88,2029,7,5,5,0,0,2,7,0,0,0,0,0,0,0,0,0,0,0,0,2,20,41,2760,1136,222,2027,1
88,2029,6,4,4,0,0,2,6,0,0,0,0,0,0,0,0,0,0,0,0,2,20,41,2760,1136,222,2028,1
88,2029,10,6,6,0,0,4,10,0,0,0,0,0,0,0,0,0,0,0,0,2,20,41,2760,1136,222,2029,1
88,2029,1,1,1,0,0,0,1,0,0,0,0,0,0,0,0,0,0,0,0,2,20,41,2760,1136,222,2029,1
88,2029,14,10,10,0,0,4,14,1,1,1,1,2,2,0,2,0,1,0,0,2,20,41,2760,1136,222,2030,1
88,2029,46,26,30,3,0,12,49,3,6,3,6,9,9,20,28,1,42,2,0,2,20,41,2770,1136,222,2031,1
2,98,13,10,10,0,0,3,13,1,2,1,2,3,3,2,4,0,2,0,0,2,9,5,2770,1136,222,2032,1
11,596,652,304,544,16,6,88,668,6,89,51,101,95,152,591,998,3,3399,188,0,2,71,104,2770,1137,222,2033,1
2,50,127,75,83,2,11,30,129,4,14,7,14,18,21,61,87,2,175,9,0,2,2,2,2770,1137,222,2034,1
2,50,652,304,544,16,6,88,668,6,89,51,101,95,152,591,998,3,3399,188,0,2,2,2,2770,1138,222,2035,1
2,50,2,2,2,0,0,0,2,0,0,0,0,0,0,0,0,0,0,0,0,2,2,2,2770,1138,222,2035,1
2,50,8,5,5,0,0,3,8,0,0,0,0,0,0,0,0,0,0,0,0,2,2,2,2770,1138,222,2036,1
2,50,2,2,2,0,0,0,2,0,0,0,0,0,0,0,0,0,0,0,0,2,2,2,2770,1138,222,2036,1
2,50,14,8,8,0,0,6,14,0,0,0,0,0,0,0,0,0,0,0,0,2,2,2,2770,1138,222,2037,1
2,50,6,4,4,0,0,2,6,0,0,0,0,0,0,0,0,0,0,0,0,2,2,2,2770,1138,222,2038,1
2,50,6,4,4,0,0,2,6,1,2,1,2,3,3,2,4,0,2,0,0,2,2,2,2770,1138,222,2039,1
2,50,6,4,4,0,0,2,6,0,0,0,0,0,0,0,0,0,0,0,0,2,2,2,2770,1138,222,2040,1
2,50,7,5,5,0,0,2,7,0,0,0,0,0,0,0,0,0,0,0,0,2,2,2,2770,1138,222,2041,1
2,50,6,4,4,0,0,2,6,0,0,0,0,0,0,0,0,0,0,0,0,2,2,2,2770,1138,222,2042,1
2,50,10,6,6,0,0,4,10,0,0,0,0,0,0,0,0,0,0,0,0,2,2,2,2770,1138,222,2043,1
2,50,1,1,1,0,0,0,1,0,0,0,0,0,0,0,0,0,0,0,0,2,2,2,2770,1138,222,2043,1
2,50,14,10,10,0,0,4,14,1,1,1,1,2,2,0,2,0,1,0,0,2,2,2,2770,1138,222,2044,1
2,50,46,26,30,3,0,12,49,3,6,3,6,9,9,20,28,1,42,2,0,2,2,2,2780,1138,222,2045,1
144,2476,1338,495,1086,10,64,173,1348,11,122,82,157,133,239,883,1686,7,11934,663,0,2,18,14,2780,1140,222,2046,1
1,477,42,7,35,4,0,5,46,1,2,1,2,3,3,2,4,0,2,0,0,2,1,6,2780,1140,222,2047,0
1,477,11,6,10,0,0,1,11,2,4,2,4,6,6,10,15,1,15,0,0,2,1,6,2780,1140,222,2048,0
2,50,127,75,83,2,11,30,129,4,14,7,14,18,21,61,87,2,175,9,0,3,1,1,2790,1144,223,2056,0
2,50,652,304,544,16,6,88,668,6,89,51,101,95,152,591,998,3,3399,188,0,3,1,1,2790,1145,223,2057,0
2,50,2,2,2,0,0,0,2,0,0,0,0,0,0,0,0,0,0,0,0,3,1,1,2790,1145,223,2057,0
2,50,8,5,5,0,0,3,8,0,0,0,0,0,0,0,0,0,0,0,0,3,1,1,2790,1145,223,2058,0
2,50,2,2,2,0,0,0,2,0,0,0,0,0,0,0,0,0,0,0,0,3,1,1,2790,1145,223,2058,0
2,50,14,8,8,0,0,6,14,0,0,0,0,0,0,0,0,0,0,0,0,3,1,1,2790,1145,223,2059,0
2,50,6,4,4,0,0,2,6,0,0,0,0,0,0,0,0,0,0,0,0,3,1,1,2790,1145,223,2060,0
2,50,6,4,4,0,0,2,6,1,2,1,2,3,3,2,4,0,2,0,0,3,1,1,2790,1145,223,2061,0
2,50,6,4,4,0,0,2,6,0,0,0,0,0,0,0,0,0,0,0,0,3,1,1,2790,1145,223,2062,0
2,50,7,5,5,0,0,2,7,0,0,0,0,0,0,0,0,0,0,0,0,3,1,1,2790,1145,223,2063,0
2,50,6,4,4,0,0,2,6,0,0,0,0,0,0,0,0,0,0,0,0,3,1,1,2790,1145,223,2064,0
2,50,10,6,6,0,0,4,10,0,0,0,0,0,0,0,0,0,0,0,0,3,1,1,2790,1145,223,2065,0
2,50,1,1,1,0,0,0,1,0,0,0,0,0,0,0,0,0,0,0,0,3,1,1,2790,1145,223,2065,0
2,50,14,10,10,0,0,4,14,1,1,1,1,2,2,0,2,0,1,0,0,3,1,1,2790,1145,223,2066,0
2,50,46,26,30,3,0,12,49,3,6,3,6,9,9,20,28,1,42,2,0,3,1,1,2800,1145,223,2067,0
88,3213,1392,870,1177,35,17,170,1427,14,494,280,531,508,811,4473,7289,7,54850,3047,2,2,1,1,2830,1160,227,2089,0
61,1386,1943,715,1694,26,18,214,1969,12,185,120,237,197,357,1436,2721,7,20915,1161,0,2,1,1,2830,1162,227,2090,1
61,1386,1168,838,957,57,25,144,1225,19,348,224,416,367,640,3018,5452,11,61921,3440,1,2,1,1,2840,1164,227,2091,1
57,3573,1457,730,1242,11,6,188,1468,10,292,166,329,302,495,2424,4078,5,22973,1276,1,2,17,11,2840,1166,227,2092,1
33,1460,373,158,315,8,0,51,381,5,76,44,79,81,123,486,779,2,2026,112,0,2,16,7,2840,1166,227,2093,1
19,444,127,75,83,2,11,30,129,4,14,7,14,18,21,61,87,2,175,9,0,0,71,0,2840,1166,227,2094,1
19,444,652,304,544,16,6,88,668,6,89,51,101,95,152,591,998,3,3399,188,0,0,71,0,2840,1167,227,2095,1
19,444,2,2,2,0,0,0,2,0,0,0,0,0,0,0,0,0,0,0,0,0,71,0,2840,1167,227,2095,1
19,444,8,5,5,0,0,3,8,0,0,0,0,0,0,0,0,0,0,0,0,0,71,0,2840,1167,227,2096,1
19,444,2,2,2,0,0,0,2,0,0,0,0,0,0,0,0,0,0,0,0,0,71,0,2840,1167,227,2096,1
19,444,14,8,8,0,0,6,14,0,0,0,0,0,0,0,0,0,0,0,0,0,71,0,2840,1167,227,2097,1
19,444,6,4,4,0,0,2,6,0,0,0,0,0,0,0,0,0,0,0,0,0,71,0,2840,1167,227,2098,1
19,444,6,4,4,0,0,2,6,1,2,1,2,3,3,2,4,0,2,0,0,0,71,0,2840,1167,227,2099,1
19,444,6,4,4,0,0,2,6,0,0,0,0,0,0,0,0,0,0,0,0,0,71,0,2840,1167,227,2100,1
19,444,7,5,5,0,0,2,7,0,0,0,0,0,0,0,0,0,0,0,0,0,71,0,2840,1167,227,2101,1
19,444,6,4,4,0,0,2,6,0,0,0,0,0,0,0,0,0,0,0,0,0,71,0,2840,1167,227,2102,1
19,444,10,6,6,0,0,4,10,0,0,0,0,0,0,0,0,0,0,0,0,0,71,0,2840,1167,227,2103,1
19,444,1,1,1,0,0,0,1,0,0,0,0,0,0,0,0,0,0,0,0,0,71,0,2840,1167,227,2103,1
19,444,14,10,10,0,0,4,14,1,1,1,1,2,2,0,2,0,1,0,0,0,71,0,2840,1167,227,2104,1
19,444,46,26,30,3,0,12,49,3,6,3,6,9,9,20,28,1,42,2,0,0,71,0,2850,1167,227,2105,1
5,247,652,304,544,16,6,88,668,6,89,51,101,95,152,591,998,3,3399,188,0,0,64,0,2850,1168,227,2106,1
84,1874,1392,870,1177,35,17,170,1427,14,494,280,531,508,811,4473,7289,7,54850,3047,2,2,4,3,2850,1171,228,2107,1
144,2486,1338,495,1086,10,64,173,1348,11,122,82,157,133,239,883,1686,7,11934,663,0,2,2,1,2850,1173,228,2108,1
62,1396,1943,715,1694,26,18,214,1969,12,185,120,237,197,357,1436,2721,7,20915,1161,0,2,1,1,2850,1175,228,2109,1
62,1396,1168,838,957,57,25,144,1225,19,348,224,416,367,640,3018,5452,11,61921,3440,1,2,1,1,2860,1177,228,2110,1
17,1181,1943,715,1694,26,18,214,1969,12,185,120,237,197,357,1436,2721,7,20915,1161,0,2,31,0,2860,1179,228,2111,1
144,2489,1338,495,1086,10,64,173,1348,11,122,82,157,133,239,883,1686,7,11934,663,0,2,1,1,2860,1181,228,2112,0
85,1888,1392,870,1177,35,17,170,1427,14,494,280,531,508,811,4473,7289,7,54850,3047,2,2,9,5,2860,1184,229,2113,1
95,3486,1392,870,1177,35,17,170,1427,14,494,280,531,508,811,4473,7289,7,54850,3047,2,2,59,1,2860,1187,230,2114,1
95,3490,1392,870,1177,35,17,170,1427,14,494,280,531,508,811,4473,7289,7,54850,3047,2,2,1,1,2860,1190,231,2115,0
88,2032,127,75,83,2,11,30,129,4,14,7,14,18,21,61,87,2,175,9,0,2,2,0,2870,1194,232,2123,0
88,2032,652,304,544,16,6,88,668,6,89,51,101,95,152,591,998,3,3399,188,0,2,2,0,2870,1195,232,2124,0
88,2032,2,2,2,0,0,0,2,0,0,0,0,0,0,0,0,0,0,0,0,2,2,0,2870,1195,232,2124,0
88,2032,8,5,5,0,0,3,8,0,0,0,0,0,0,0,0,0,0,0,0,2,2,0,2870,1195,232,2125,0
88,2032,2,2,2,0,0,0,2,0,0,0,0,0,0,0,0,0,0,0,0,2,2,0,2870,1195,232,2125,0
88,2032,14,8,8,0,0,6,14,0,0,0,0,0,0,0,0,0,0,0,0,2,2,0,2870,1195,232,2126,0
88,2032,6,4,4,0,0,2,6,0,0,0,0,0,0,0,0,0,0,0,0,2,2,0,2870,1195,232,2127,0
88,2032,6,4,4,0,0,2,6,1,2,1,2,3,3,2,4,0,2,0,0,2,2,0,2870,1195,232,2128,0
88,2032,6,4,4,0,0,2,6,0,0,0,0,0,0,0,0,0,0,0,0,2,2,0,2870,1195,232,2129,0
88,2032,7,5,5,0,0,2,7,0,0,0,0,0,0,0,0,0,0,0,0,2,2,0,2870,1195,232,2130,0
88,2032,6,4,4,0,0,2,6,0,0,0,0,0,0,0,0,0,0,0,0,2,2,0,2870,1195,232,2131,0
88,2032,10,6,6,0,0,4,10,0,0,0,0,0,0,0,0,0,0,0,0,2,2,0,2870,1195,232,2132,0
88,2032,1,1,1,0,0,0,1,0,0,0,0,0,0,0,0,0,0,0,0,2,2,0,2870,1195,232,2132,0
88,2032,14,10,10,0,0,4,14,1,1,1,1,2,2,0,2,0,1,0,0,2,2,0,2870,1195,232,2133,0
88,2032,46,26,30,3,0,12,49,3,6,3,6,9,9,20,28,1,42,2,0,2,2,0,2880,1195,232,2134,0
35,1582,1289,550,1043,56,32,155,1345,10,167,93,185,177,278,1266,2075,5,11498,638,0,2,2,2,2880,1197,233,2135,0
36,1582,1289,550,1043,56,32,155,1345,10,167,93,185,177,278,1266,2075,5,11498,638,0,2,6,5,2880,1199,234,2136,0
1,467,42,7,35,4,0,5,46,1,2,1,2,3,3,2,4,0,2,0,0,2,0,5,2880,1199,234,2137,0
1,467,11,6,10,0,0,1,11,2,4,2,4,6,6,10,15,1,15,0,0,2,0,5,2880,1199,234,2138,0
37,1615,1289,550,1043,56,32,155,1345,10,167,93,185,177,278,1266,2075,5,11498,638,0,2,6,2,2880,1201,235,2139,0
38,1647,1289,550,1043,56,32,155,1345,10,167,93,185,177,278,1266,2075,5,11498,638,0,2,9,6,2880,1203,236,2140,1
96,3511,1392,870,1177,35,17,170,1427,14,494,280,531,508,811,4473,7289,7,54850,3047,2,2,5,2,2890,1210,238,2148,0
18,419,386,256,301,16,9,68,402,4,59,35,69,63,104,355,621,2,1453,80,0,0,74,0,2890,1210,238,2149,0
18,419,264,131,164,11,41,46,275,6,38,22,40,44,62,214,338,3,1068,59,0,0,74,0,2900,1210,239,2150,0
144,2509,1338,495,1086,10,64,173,1348,11,122,82,157,133,239,883,1686,7,11934,663,0,2,10,3,2900,1212,239,2151,0
145,2522,1338,495,1086,10,64,173,1348,11,122,82,157,133,239,883,1686,7,11934,663,0,2,8,1,2900,1214,239,2152,0
64,1428,1943,715,1694,26,18,214,1969,12,185,120,237,197,357,1436,2721,7,20915,1161,0,2,12,6,2900,1216,239,2153,0
64,1428,1168,838,957,57,25,144,1225,19,348,224,416,367,640,3018,5452,11,61921,3440,1,2,12,6,2910,1218,239,2154,0
64,1445,1943,715,1694,26,18,214,1969,12,185,120,237,197,357,1436,2721,7,20915,1161,0,2,5,0,2910,1220,239,2155,0
64,1445,1168,838,957,57,25,144,1225,19,348,224,416,367,640,3018,5452,11,61921,3440,1,2,5,0,2920,1222,239,2156,0
18,1284,1943,715,1694,26,18,214,1969,12,185,120,237,197,357,1436,2721,7,20915,1161,0,2,14,0,2920,1224,239,2157,0
62,1432,1943,715,1694,26,18,214,1969,12,185,120,237,197,357,1436,2721,7,20915,1161,0,2,3,4,2920,1226,239,2158,0
62,1432,1168,838,957,57,25,144,1225,19,348,224,416,367,640,3018,5452,11,61921,3440,1,2,3,4,2930,1228,239,2159,0
20,1426,1943,715,1694,26,18,214,1969,12,185,120,237,197,357,1436,2721,7,20915,1161,0,2,23,0,2930,1230,239,2160,0
63,1445,1943,715,1694,26,18,214,1969,12,185,120,237,197,357,1436,2721,7,20915,1161,0,2,3,2,2930,1232,239,2161,0
63,1445,1168,838,957,57,25,144,1225,19,348,224,416,367,640,3018,5452,11,61921,3440,1,2,3,2,2940,1234,239,2162,0
66,1504,1943,715,1694,26,18,214,1969,12,185,120,237,197,357,1436,2721,7,20915,1161,0,2,9,0,2940,1236,239,2163,0
66,1504,1168,838,957,57,25,144,1225,19,348,224,416,367,640,3018,5452,11,61921,3440,1,2,9,0,2950,1238,239,2164,0
23,1499,1943,715,1694,26,18,214,1969,12,185,120,237,197,357,1436,2721,7,20915,1161,0,2,24,8,2950,1240,239,2165,0
48,907,373,158,315,8,0,51,381,5,76,44,79,81,123,486,779,2,2026,112,0,2,6,3,2950,1240,239,2166,0
15,361,373,158,315,8,0,51,381,5,76,44,79,81,123,486,779,2,2026,112,0,0,58,0,2960,1244,240,2174,0
16,406,373,158,315,8,0,51,381,5,76,44,79,81,123,486,779,2,2026,112,0,2,8,0,2970,1248,241,2182,0
62,1415,773,419,590,28,0,166,801,10,204,113,217,214,330,1598,2554,5,13587,754,0,2,0,2,2980,1252,243,2190,0
62,1415,421,273,302,44,34,57,465,17,81,59,107,98,166,583,1098,11,12329,684,0,2,0,2,2980,1252,244,2191,0
19,432,127,75,83,2,11,30,129,4,14,7,14,18,21,61,87,2,175,9,0,2,1,2,2980,1252,244,2192,0
19,432,652,304,544,16,6,88,668,6,89,51,101,95,152,591,998,3,3399,188,0,2,1,2,2980,1253,244,2193,0
19,432,2,2,2,0,0,0,2,0,0,0,0,0,0,0,0,0,0,0,0,2,1,2,2980,1253,244,2193,0
19,432,8,5,5,0,0,3,8,0,0,0,0,0,0,0,0,0,0,0,0,2,1,2,2980,1253,244,2194,0
19,432,2,2,2,0,0,0,2,0,0,0,0,0,0,0,0,0,0,0,0,2,1,2,2980,1253,244,2194,0
19,432,14,8,8,0,0,6,14,0,0,0,0,0,0,0,0,0,0,0,0,2,1,2,2980,1253,244,2195,0
19,432,6,4,4,0,0,2,6,0,0,0,0,0,0,0,0,0,0,0,0,2,1,2,2980,1253,244,2196,0
19,432,6,4,4,0,0,2,6,1,2,1,2,3,3,2,4,0,2,0,0,2,1,2,2980,1253,244,2197,0
19,432,6,4,4,0,0,2,6,0,0,0,0,0,0,0,0,0,0,0,0,2,1,2,2980,1253,244,2198,0
19,432,7,5,5,0,0,2,7,0,0,0,0,0,0,0,0,0,0,0,0,2,1,2,2980,1253,244,2199,0
19,432,6,4,4,0,0,2,6,0,0,0,0,0,0,0,0,0,0,0,0,2,1,2,2980,1253,244,2200,0
19,432,10,6,6,0,0,4,10,0,0,0,0,0,0,0,0,0,0,0,0,2,1,2,2980,1253,244,2201,0
19,432,1,1,1,0,0,0,1,0,0,0,0,0,0,0,0,0,0,0,0,2,1,2,2980,1253,244,2201,0
19,432,14,10,10,0,0,4,14,1,1,1,1,2,2,0,2,0,1,0,0,2,1,2,2980,1253,244,2202,0
19,432,46,26,30,3,0,12,49,3,6,3,6,9,9,20,28,1,42,2,0,2,1,2,2990,1253,244,2203,0
5,247,652,304,544,16,6,88,668,6,89,51,101,95,152,591,998,3,3399,188,0,2,2,2,2990,1254,244,2204,0
19,438,127,75,83,2,11,30,129,4,14,7,14,18,21,61,87,2,175,9,0,2,17,1,2990,1254,244,2205,0
19,438,652,304,544,16,6,88,668,6,89,51,101,95,152,591,998,3,3399,188,0,2,17,1,2990,1255,244,2206,0
19,438,2,2,2,0,0,0,2,0,0,0,0,0,0,0,0,0,0,0,0,2,17,1,2990,1255,244,2206,0
19,438,8,5,5,0,0,3,8,0,0,0,0,0,0,0,0,0,0,0,0,2,17,1,2990,1255,244,2207,0
19,438,2,2,2,0,0,0,2,0,0,0,0,0,0,0,0,0,0,0,0,2,17,1,2990,1255,244,2207,0
19,438,14,8,8,0,0,6,14,0,0,0,0,0,0,0,0,0,0,0,0,2,17,1,2990,1255,244,2208,0
19,438,6,4,4,0,0,2,6,0,0,0,0,0,0,0,0,0,0,0,0,2,17,1,2990,1255,244,2209,0
19,438,6,4,4,0,0,2,6,1,2,1,2,3,3,2,4,0,2,0,0,2,17,1,2990,1255,244,2210,0
19,438,6,4,4,0,0,2,6,0,0,0,0,0,0,0,0,0,0,0,0,2,17,1,2990,1255,244,2211,0
19,438,7,5,5,0,0,2,7,0,0,0,0,0,0,0,0,0,0,0,0,2,17,1,2990,1255,244,2212,0
19,438,6,4,4,0,0,2,6,0,0,0,0,0,0,0,0,0,0,0,0,2,17,1,2990,1255,244,2213,0
19,438,10,6,6,0,0,4,10,0,0,0,0,0,0,0,0,0,0,0,0,2,17,1,2990,1255,244,2214,0
19,438,1,1,1,0,0,0,1,0,0,0,0,0,0,0,0,0,0,0,0,2,17,1,2990,1255,244,2214,0
19,438,14,10,10,0,0,4,14,1,1,1,1,2,2,0,2,0,1,0,0,2,17,1,2990,1255,244,2215,0
19,438,46,26,30,3,0,12,49,3,6,3,6,9,9,20,28,1,42,2,0,2,17,1,3000,1255,244,2216,0
19,438,127,75,83,2,11,30,129,4,14,7,14,18,21,61,87,2,175,9,0,2,10,10,3000,1255,244,2217,0
19,438,652,304,544,16,6,88,668,6,89,51,101,95,152,591,998,3,3399,188,0,2,10,10,3000,1256,244,2218,0
19,438,2,2,2,0,0,0,2,0,0,0,0,0,0,0,0,0,0,0,0,2,10,10,3000,1256,244,2218,0
19,438,8,5,5,0,0,3,8,0,0,0,0,0,0,0,0,0,0,0,0,2,10,10,3000,1256,244,2219,0
19,438,2,2,2,0,0,0,2,0,0,0,0,0,0,0,0,0,0,0,0,2,10,10,3000,1256,244,2219,0
19,438,14,8,8,0,0,6,14,0,0,0,0,0,0,0,0,0,0,0,0,2,10,10,3000,1256,244,2220,0
19,438,6,4,4,0,0,2,6,0,0,0,0,0,0,0,0,0,0,0,0,2,10,10,3000,1256,244,2221,0
19,438,6,4,4,0,0,2,6,1,2,1,2,3,3,2,4,0,2,0,0,2,10,10,3000,1256,244,2222,0
19,438,6,4,4,0,0,2,6,0,0,0,0,0,0,0,0,0,0,0,0,2,10,10,3000,1256,244,2223,0
19,438,7,5,5,0,0,2,7,0,0,0,0,0,0,0,0,0,0,0,0,2,10,10,3000,1256,244,2224,0
19,438,6,4,4,0,0,2,6,0,0,0,0,0,0,0,0,0,0,0,0,2,10,10,3000,1256,244,2225,0
19,438,10,6,6,0,0,4,10,0,0,0,0,0,0,0,0,0,0,0,0,2,10,10,3000,1256,244,2226,0
19,438,1,1,1,0,0,0,1,0,0,0,0,0,0,0,0,0,0,0,0,2,10,10,3000,1256,244,2226,0
19,438,14,10,10,0,0,4,14,1,1,1,1,2,2,0,2,0,1,0,0,2,10,10,3000,1256,244,2227,0
19,438,46,26,30,3,0,12,49,3,6,3,6,9,9,20,28,1,42,2,0,2,10,10,3010,1256,244,2228,0
6,266,652,304,544,16,6,88,668,6,89,51,101,95,152,591,998,3,3399,188,0,2,4,0,3010,1257,244,2229,0
19,438,127,75,83,2,11,30,129,4,14,7,14,18,21,61,87,2,175,9,0,2,3,3,3010,1257,244,2230,0
19,438,652,304,544,16,6,88,668,6,89,51,101,95,152,591,998,3,3399,188,0,2,3,3,3010,1258,244,2231,0
19,438,2,2,2,0,0,0,2,0,0,0,0,0,0,0,0,0,0,0,0,2,3,3,3010,1258,244,2231,0
19,438,8,5,5,0,0,3,8,0,0,0,0,0,0,0,0,0,0,0,0,2,3,3,3010,1258,244,2232,0
19,438,2,2,2,0,0,0,2,0,0,0,0,0,0,0,0,0,0,0,0,2,3,3,3010,1258,244,2232,0
19,438,14,8,8,0,0,6,14,0,0,0,0,0,0,0,0,0,0,0,0,2,3,3,3010,1258,244,2233,0
19,438,6,4,4,0,0,2,6,0,0,0,0,0,0,0,0,0,0,0,0,2,3,3,3010,1258,244,2234,0
19,438,6,4,4,0,0,2,6,1,2,1,2,3,3,2,4,0,2,0,0,2,3,3,3010,1258,244,2235,0
19,438,6,4,4,0,0,2,6,0,0,0,0,0,0,0,0,0,0,0,0,2,3,3,3010,1258,244,2236,0
19,438,7,5,5,0,0,2,7,0,0,0,0,0,0,0,0,0,0,0,0,2,3,3,3010,1258,244,2237,0
19,438,6,4,4,0,0,2,6,0,0,0,0,0,0,0,0,0,0,0,0,2,3,3,3010,1258,244,2238,0
19,438,10,6,6,0,0,4,10,0,0,0,0,0,0,0,0,0,0,0,0,2,3,3,3010,1258,244,2239,0
19,438,1,1,1,0,0,0,1,0,0,0,0,0,0,0,0,0,0,0,0,2,3,3,3010,1258,244,2239,0
19,438,14,10,10,0,0,4,14,1,1,1,1,2,2,0,2,0,1,0,0,2,3,3,3010,1258,244,2240,0
19,438,46,26,30,3,0,12,49,3,6,3,6,9,9,20,28,1,42,2,0,2,3,3,3020,1258,244,2241,0
37,1648,1289,550,1043,56,32,155,1345,10,167,93,185,177,278,1266,2075,5,11498,638,0,2,1,4,3020,1260,245,2242,0
87,2025,127,75,83,2,11,30,129,4,14,7,14,18,21,61,87,2,175,9,0,2,1,4,3030,1264,246,2250,1
87,2025,652,304,544,16,6,88,668,6,89,51,101,95,152,591,998,3,3399,188,0,2,1,4,3030,1265,246,2251,1
87,2025,2,2,2,0,0,0,2,0,0,0,0,0,0,0,0,0,0,0,0,2,1,4,3030,1265,246,2251,1
87,2025,8,5,5,0,0,3,8,0,0,0,0,0,0,0,0,0,0,0,0,2,1,4,3030,1265,246,2252,1
87,2025,2,2,2,0,0,0,2,0,0,0,0,0,0,0,0,0,0,0,0,2,1,4,3030,1265,246,2252,1
87,2025,14,8,8,0,0,6,14,0,0,0,0,0,0,0,0,0,0,0,0,2,1,4,3030,1265,246,2253,1
87,2025,6,4,4,0,0,2,6,0,0,0,0,0,0,0,0,0,0,0,0,2,1,4,3030,1265,246,2254,1
87,2025,6,4,4,0,0,2,6,1,2,1,2,3,3,2,4,0,2,0,0,2,1,4,3030,1265,246,2255,1
87,2025,6,4,4,0,0,2,6,0,0,0,0,0,0,0,0,0,0,0,0,2,1,4,3030,1265,246,2256,1
87,2025,7,5,5,0,0,2,7,0,0,0,0,0,0,0,0,0,0,0,0,2,1,4,3030,1265,246,2257,1
87,2025,6,4,4,0,0,2,6,0,0,0,0,0,0,0,0,0,0,0,0,2,1,4,3030,1265,246,2258,1
87,2025,10,6,6,0,0,4,10,0,0,0,0,0,0,0,0,0,0,0,0,2,1,4,3030,1265,246,2259,1
87,2025,1,1,1,0,0,0,1,0,0,0,0,0,0,0,0,0,0,0,0,2,1,4,3030,1265,246,2259,1
87,2025,14,10,10,0,0,4,14,1,1,1,1,2,2,0,2,0,1,0,0,2,1,4,3030,1265,246,2260,1
87,2025,46,26,30,3,0,12,49,3,6,3,6,9,9,20,28,1,42,2,0,2,1,4,3040,1265,246,2261,1
1,76,42,7,35,4,0,5,46,1,2,1,2,3,3,2,4,0,2,0,0,2,1,0,3040,1265,246,2262,1
1,76,11,6,10,0,0,1,11,2,4,2,4,6,6,10,15,1,15,0,0,2,1,0,3040,1265,246,2263,1
37,1642,1289,550,1043,56,32,155,1345,10,167,93,185,177,278,1266,2075,5,11498,638,0,2,1,1,3040,1267,247,2264,1
144,2506,1338,495,1086,10,64,173,1348,11,122,82,157,133,239,883,1686,7,11934,663,0,2,0,3,3040,1269,247,2265,0
14,320,215,129,180,6,0,29,221,8,65,43,72,73,115,415,711,4,3153,175,0,0,54,0,3040,1269,247,2266,0
14,320,97,69,77,3,3,16,100,6,22,13,23,28,36,113,173,3,542,30,0,0,54,0,3040,1270,247,2267,0
49,956,373,158,315,8,0,51,381,5,76,44,79,81,123,486,779,2,2026,112,0,2,5,0,3040,1270,247,2268,0
58,3702,1457,730,1242,11,6,188,1468,10,292,166,329,302,495,2424,4078,5,22973,1276,1,2,21,0,3040,1272,247,2269,0
15,1127,215,129,180,6,0,29,221,8,65,43,72,73,115,415,711,4,3153,175,0,0,184,0,3040,1272,247,2270,0
1,473,42,7,35,4,0,5,46,1,2,1,2,3,3,2,4,0,2,0,0,2,5,2,3070,1284,250,2293,0
1,473,11,6,10,0,0,1,11,2,4,2,4,6,6,10,15,1,15,0,0,2,5,2,3070,1284,250,2294,0
32,845,1043,504,840,53,9,147,1096,9,180,112,198,189,310,1377,2344,4,11604,644,0,2,6,3,3070,1286,250,2295,0
32,845,383,288,292,26,6,62,409,11,65,38,67,76,105,429,656,5,3719,206,0,2,6,3,3070,1287,250,2296,0
37,1642,1289,550,1043,56,32,155,1345,10,167,93,185,177,278,1266,2075,5,11498,638,0,2,3,2,3070,1289,251,2297,0
86,1899,1392,870,1177,35,17,170,1427,14,494,280,531,508,811,4473,7289,7,54850,3047,2,2,3,1,3070,1292,252,2298,0
97,3521,1392,870,1177,35,17,170,1427,14,494,280,531,508,811,4473,7289,7,54850,3047,2,2,2,0,3070,1295,253,2299,0
14,320,215,129,180,6,0,29,221,8,65,43,72,73,115,415,711,4,3153,175,0,2,1,1,3070,1295,253,2300,0
14,320,97,69,77,3,3,16,100,6,22,13,23,28,36,113,173,3,542,30,0,2,1,1,3070,1296,253,2301,0
49,951,373,158,315,8,0,51,381,5,76,44,79,81,123,486,779,2,2026,112,0,2,1,1,3070,1296,253,2302,0
58,3693,1457,730,1242,11,6,188,1468,10,292,166,329,302,495,2424,4078,5,22973,1276,1,2,0,2,3070,1298,253,2303,0
87,1905,1392,870,1177,35,17,170,1427,14,494,280,531,508,811,4473,7289,7,54850,3047,2,2,4,1,3070,1301,254,2304,0
16,586,182,127,129,0,0,53,182,5,39,21,42,44,63,217,343,2,926,51,0,2,16,0,3070,1301,255,2305,0
22,528,182,127,129,0,0,53,182,5,39,21,42,44,63,217,343,2,926,51,0,2,1,2,3070,1301,256,2306,0
22,528,1165,710,800,67,119,181,1232,18,243,153,282,261,435,2000,3492,10,36473,2026,1,2,1,2,3080,1301,257,2307,0
20,496,182,127,129,0,0,53,182,5,39,21,42,44,63,217,343,2,926,51,0,2,3,8,3080,1301,258,2308,1
20,496,1165,710,800,67,119,181,1232,18,243,153,282,261,435,2000,3492,10,36473,2026,1,2,3,8,3090,1301,259,2309,1
68,1530,773,419,590,28,0,166,801,10,204,113,217,214,330,1598,2554,5,13587,754,0,2,23,1,3090,1301,260,2310,1
68,1530,421,273,302,44,34,57,465,17,81,59,107,98,166,583,1098,11,12329,684,0,2,23,1,3090,1301,261,2311,1
97,3521,1392,870,1177,35,17,170,1427,14,494,280,531,508,811,4473,7289,7,54850,3047,2,2,1,1,3090,1304,262,2312,1
51,1685,773,419,590,28,0,166,801,10,204,113,217,214,330,1598,2554,5,13587,754,0,2,40,0,3090,1304,263,2313,1
36,1557,373,158,315,8,0,51,381,5,76,44,79,81,123,486,779,2,2026,112,0,2,14,0,3090,1304,263,2314,1
1,35,127,75,83,2,11,30,129,4,14,7,14,18,21,61,87,2,175,9,0,2,4,6,3120,1311,264,2347,1
1,35,652,304,544,16,6,88,668,6,89,51,101,95,152,591,998,3,3399,188,0,2,4,6,3120,1312,264,2348,1
1,35,2,2,2,0,0,0,2,0,0,0,0,0,0,0,0,0,0,0,0,2,4,6,3120,1312,264,2348,1
1,35,8,5,5,0,0,3,8,0,0,0,0,0,0,0,0,0,0,0,0,2,4,6,3120,1312,264,2349,1
1,35,2,2,2,0,0,0,2,0,0,0,0,0,0,0,0,0,0,0,0,2,4,6,3120,1312,264,2349,1
1,35,14,8,8,0,0,6,14,0,0,0,0,0,0,0,0,0,0,0,0,2,4,6,3120,1312,264,2350,1
1,35,6,4,4,0,0,2,6,0,0,0,0,0,0,0,0,0,0,0,0,2,4,6,3120,1312,264,2351,1
1,35,6,4,4,0,0,2,6,1,2,1,2,3,3,2,4,0,2,0,0,2,4,6,3120,1312,264,2352,1
1,35,6,4,4,0,0,2,6,0,0,0,0,0,0,0,0,0,0,0,0,2,4,6,3120,1312,264,2353,1
1,35,7,5,5,0,0,2,7,0,0,0,0,0,0,0,0,0,0,0,0,2,4,6,3120,1312,264,2354,1
1,35,6,4,4,0,0,2,6,0,0,0,0,0,0,0,0,0,0,0,0,2,4,6,3120,1312,264,2355,1
1,35,10,6,6,0,0,4,10,0,0,0,0,0,0,0,0,0,0,0,0,2,4,6,3120,1312,264,2356,1
1,35,1,1,1,0,0,0,1,0,0,0,0,0,0,0,0,0,0,0,0,2,4,6,3120,1312,264,2356,1
1,35,14,10,10,0,0,4,14,1,1,1,1,2,2,0,2,0,1,0,0,2,4,6,3120,1312,264,2357,1
1,35,46,26,30,3,0,12,49,3,6,3,6,9,9,20,28,1,42,2,0,2,4,6,3130,1312,264,2358,1
1,85,127,75,83,2,11,30,129,4,14,7,14,18,21,61,87,2,175,9,0,2,12,35,3130,1312,264,2359,1
1,85,652,304,544,16,6,88,668,6,89,51,101,95,152,591,998,3,3399,188,0,2,12,35,3130,1313,264,2360,1
1,85,2,2,2,0,0,0,2,0,0,0,0,0,0,0,0,0,0,0,0,2,12,35,3130,1313,264,2360,1
1,85,8,5,5,0,0,3,8,0,0,0,0,0,0,0,0,0,0,0,0,2,12,35,3130,1313,264,2361,1
1,85,2,2,2,0,0,0,2,0,0,0,0,0,0,0,0,0,0,0,0,2,12,35,3130,1313,264,2361,1
1,85,14,8,8,0,0,6,14,0,0,0,0,0,0,0,0,0,0,0,0,2,12,35,3130,1313,264,2362,1
1,85,6,4,4,0,0,2,6,0,0,0,0,0,0,0,0,0,0,0,0,2,12,35,3130,1313,264,2363,1
1,85,6,4,4,0,0,2,6,1,2,1,2,3,3,2,4,0,2,0,0,2,12,35,3130,1313,264,2364,1
1,85,6,4,4,0,0,2,6,0,0,0,0,0,0,0,0,0,0,0,0,2,12,35,3130,1313,264,2365,1
1,85,7,5,5,0,0,2,7,0,0,0,0,0,0,0,0,0,0,0,0,2,12,35,3130,1313,264,2366,1
1,85,6,4,4,0,0,2,6,0,0,0,0,0,0,0,0,0,0,0,0,2,12,35,3130,1313,264,2367,1
1,85,10,6,6,0,0,4,10,0,0,0,0,0,0,0,0,0,0,0,0,2,12,35,3130,1313,264,2368,1
1,85,1,1,1,0,0,0,1,0,0,0,0,0,0,0,0,0,0,0,0,2,12,35,3130,1313,264,2368,1
1,85,14,10,10,0,0,4,14,1,1,1,1,2,2,0,2,0,1,0,0,2,12,35,3130,1313,264,2369,1
1,85,46,26,30,3,0,12,49,3,6,3,6,9,9,20,28,1,42,2,0,2,12,35,3140,1313,264,2370,1
2,80,13,10,10,0,0,3,13,1,2,1,2,3,3,2,4,0,2,0,0,2,4,5,3150,1314,264,2383,1
15,369,386,256,301,16,9,68,402,4,59,35,69,63,104,355,621,2,1453,80,0,2,11,16,3150,1315,264,2385,1
15,369,264,131,164,11,41,46,275,6,38,22,40,44,62,214,338,3,1068,59,0,2,11,16,3160,1315,265,2386,1
151,2585,1338,495,1086,10,64,173,1348,11,122,82,157,133,239,883,1686,7,11934,663,0,2,88,57,3190,1329,268,2408,1
57,1285,1457,730,1242,11,6,188,1468,10,292,166,329,302,495,2424,4078,5,22973,1276,1,2,46,80,3190,1331,268,2409,1
57,1285,74,35,59,1,0,14,75,3,14,7,14,17,21,58,85,1,128,7,0,2,46,80,3190,1332,268,2410,1
57,1285,245,125,200,5,7,34,250,7,30,17,34,37,51,166,265,3,1053,58,0,2,46,80,3200,1333,268,2411,1
19,284,477,336,357,30,23,73,507,16,194,134,250,210,384,1538,2962,10,30538,1696,0,2,0,16,3210,1334,268,2412,1
26,496,334,251,279,10,4,40,344,5,127,74,143,132,217,899,1528,2,4303,239,0,0,92,0,3210,1335,268,2413,1
3,50,127,75,83,2,11,30,129,4,14,7,14,18,21,61,87,2,175,9,0,0,10,0,3220,1339,269,2421,1
3,50,652,304,544,16,6,88,668,6,89,51,101,95,152,591,998,3,3399,188,0,0,10,0,3220,1340,269,2422,1
3,50,2,2,2,0,0,0,2,0,0,0,0,0,0,0,0,0,0,0,0,0,10,0,3220,1340,269,2422,1
3,50,8,5,5,0,0,3,8,0,0,0,0,0,0,0,0,0,0,0,0,0,10,0,3220,1340,269,2423,1
3,50,2,2,2,0,0,0,2,0,0,0,0,0,0,0,0,0,0,0,0,0,10,0,3220,1340,269,2423,1
3,50,14,8,8,0,0,6,14,0,0,0,0,0,0,0,0,0,0,0,0,0,10,0,3220,1340,269,2424,1
3,50,6,4,4,0,0,2,6,0,0,0,0,0,0,0,0,0,0,0,0,0,10,0,3220,1340,269,2425,1
3,50,6,4,4,0,0,2,6,1,2,1,2,3,3,2,4,0,2,0,0,0,10,0,3220,1340,269,2426,1
3,50,6,4,4,0,0,2,6,0,0,0,0,0,0,0,0,0,0,0,0,0,10,0,3220,1340,269,2427,1
3,50,7,5,5,0,0,2,7,0,0,0,0,0,0,0,0,0,0,0,0,0,10,0,3220,1340,269,2428,1
3,50,6,4,4,0,0,2,6,0,0,0,0,0,0,0,0,0,0,0,0,0,10,0,3220,1340,269,2429,1
3,50,10,6,6,0,0,4,10,0,0,0,0,0,0,0,0,0,0,0,0,0,10,0,3220,1340,269,2430,1
3,50,1,1,1,0,0,0,1,0,0,0,0,0,0,0,0,0,0,0,0,0,10,0,3220,1340,269,2430,1
3,50,14,10,10,0,0,4,14,1,1,1,1,2,2,0,2,0,1,0,0,0,10,0,3220,1340,269,2431,1
3,50,46,26,30,3,0,12,49,3,6,3,6,9,9,20,28,1,42,2,0,0,10,0,3230,1340,269,2432,1
25,611,1043,504,840,53,9,147,1096,9,180,112,198,189,310,1377,2344,4,11604,644,0,2,13,42,3240,1349,269,2438,1
25,611,383,288,292,26,6,62,409,11,65,38,67,76,105,429,656,5,3719,206,0,2,13,42,3240,1350,269,2439,1
46,833,373,158,315,8,0,51,381,5,76,44,79,81,123,486,779,2,2026,112,0,2,33,44,3240,1350,269,2440,1
25,1269,1289,550,1043,56,32,155,1345,10,167,93,185,177,278,1266,2075,5,11498,638,0,2,121,181,3240,1352,270,2441,1
48,3264,1457,730,1242,11,6,188,1468,10,292,166,329,302,495,2424,4078,5,22973,1276,1,2,339,396,3250,1355,270,2454,1
13,660,334,251,279,10,4,40,344,5,127,74,143,132,217,899,1528,2,4303,239,0,0,90,0,3250,1357,270,2456,1
23,1008,373,158,315,8,0,51,381,5,76,44,79,81,123,486,779,2,2026,112,0,2,44,128,3250,1357,270,2458,1
48,3264,1457,730,1242,11,6,188,1468,10,292,166,329,302,495,2424,4078,5,22973,1276,1,2,9,9,3250,1359,270,2459,0
57,1281,1457,730,1242,11,6,188,1468,10,292,166,329,302,495,2424,4078,5,22973,1276,1,2,4,6,3250,1361,270,2460,0
57,1281,74,35,59,1,0,14,75,3,14,7,14,17,21,58,85,1,128,7,0,2,4,6,3250,1362,270,2461,0
57,1281,245,125,200,5,7,34,250,7,30,17,34,37,51,166,265,3,1053,58,0,2,4,6,3260,1363,270,2462,0
48,3264,1457,730,1242,11,6,188,1468,10,292,166,329,302,495,2424,4078,5,22973,1276,1,2,3,3,3270,1369,271,2470,0
51,1168,1457,730,1242,11,6,188,1468,10,292,166,329,302,495,2424,4078,5,22973,1276,1,2,12,39,3270,1371,271,2471,1
51,1168,74,35,59,1,0,14,75,3,14,7,14,17,21,58,85,1,128,7,0,2,12,39,3270,1372,271,2472,1
51,1168,245,125,200,5,7,34,250,7,30,17,34,37,51,166,265,3,1053,58,0,2,12,39,3280,1373,271,2473,1
44,2896,1457,730,1242,11,6,188,1468,10,292,166,329,302,495,2424,4078,5,22973,1276,1,2,30,73,3280,1375,271,2474,1
24,1043,373,158,315,8,0,51,381,5,76,44,79,81,123,486,779,2,2026,112,0,2,5,0,3280,1375,271,2475,1
98,3601,1392,870,1177,35,17,170,1427,14,494,280,531,508,811,4473,7289,7,54850,3047,2,2,9,0,3280,1378,272,2476,1
52,1181,1457,730,1242,11,6,188,1468,10,292,166,329,302,495,2424,4078,5,22973,1276,1,2,12,8,3280,1380,272,2477,1
52,1181,74,35,59,1,0,14,75,3,14,7,14,17,21,58,85,1,128,7,0,2,12,8,3280,1381,272,2478,1
52,1181,245,125,200,5,7,34,250,7,30,17,34,37,51,166,265,3,1053,58,0,2,12,8,3290,1382,272,2479,1
44,2900,1457,730,1242,11,6,188,1468,10,292,166,329,302,495,2424,4078,5,22973,1276,1,2,21,9,3290,1384,272,2480,1
61,1328,1457,730,1242,11,6,188,1468,10,292,166,329,302,495,2424,4078,5,22973,1276,1,2,22,1,3290,1386,272,2481,0
61,1328,74,35,59,1,0,14,75,3,14,7,14,17,21,58,85,1,128,7,0,2,22,1,3290,1387,272,2482,0
61,1328,245,125,200,5,7,34,250,7,30,17,34,37,51,166,265,3,1053,58,0,2,22,1,3300,1388,272,2483,0
46,3133,1457,730,1242,11,6,188,1468,10,292,166,329,302,495,2424,4078,5,22973,1276,1,2,29,0,3300,1390,272,2484,0
150,2573,1338,495,1086,10,64,173,1348,11,122,82,157,133,239,883,1686,7,11934,663,0,2,0,3,3300,1392,272,2485,1
58,1297,1457,730,1242,11,6,188,1468,10,292,166,329,302,495,2424,4078,5,22973,1276,1,2,17,28,3300,1394,272,2486,1
58,1297,74,35,59,1,0,14,75,3,14,7,14,17,21,58,85,1,128,7,0,2,17,28,3300,1395,272,2487,1
58,1297,245,125,200,5,7,34,250,7,30,17,34,37,51,166,265,3,1053,58,0,2,17,28,3310,1396,272,2488,1
46,833,373,158,315,8,0,51,381,5,76,44,79,81,123,486,779,2,2026,112,0,2,1,1,3310,1396,272,2489,1
38,2138,1457,730,1242,11,6,188,1468,10,292,166,329,302,495,2424,4078,5,22973,1276,1,2,0,144,3310,1398,272,2490,1
140,2408,1338,495,1086,10,64,173,1348,11,122,82,157,133,239,883,1686,7,11934,663,0,2,0,33,3430,1445,283,2580,1
68,1464,1457,730,1242,11,6,188,1468,10,292,166,329,302,495,2424,4078,5,22973,1276,1,2,36,5,3430,1447,283,2581,1
68,1464,74,35,59,1,0,14,75,3,14,7,14,17,21,58,85,1,128,7,0,2,36,5,3430,1448,283,2582,1
68,1464,245,125,200,5,7,34,250,7,30,17,34,37,51,166,265,3,1053,58,0,2,36,5,3440,1449,283,2583,1
25,615,1043,504,840,53,9,147,1096,9,180,112,198,189,310,1377,2344,4,11604,644,0,2,2,2,3440,1451,283,2584,1
25,615,383,288,292,26,6,62,409,11,65,38,67,76,105,429,656,5,3719,206,0,2,2,2,3440,1452,283,2585,1
46,829,373,158,315,8,0,51,381,5,76,44,79,81,123,486,779,2,2026,112,0,2,1,1,3440,1452,283,2586,1
137,2384,1338,495,1086,10,64,173,1348,11,122,82,157,133,239,883,1686,7,11934,663,0,2,13,21,3470,1466,286,2608,0
139,2411,1338,495,1086,10,64,173,1348,11,122,82,157,133,239,883,1686,7,11934,663,0,2,5,2,3470,1468,286,2609,0
25,631,1043,504,840,53,9,147,1096,9,180,112,198,189,310,1377,2344,4,11604,644,0,2,3,1,3470,1470,286,2610,1
25,631,383,288,292,26,6,62,409,11,65,38,67,76,105,429,656,5,3719,206,0,2,3,1,3470,1471,286,2611,1
1,445,42,7,35,4,0,5,46,1,2,1,2,3,3,2,4,0,2,0,0,2,1,15,3470,1471,286,2612,0
1,445,11,6,10,0,0,1,11,2,4,2,4,6,6,10,15,1,15,0,0,2,1,15,3470,1471,286,2613,0
139,2416,1338,495,1086,10,64,173,1348,11,122,82,157,133,239,883,1686,7,11934,663,0,2,2,0,3470,1473,286,2614,0
87,1898,1392,870,1177,35,17,170,1427,14,494,280,531,508,811,4473,7289,7,54850,3047,2,2,1,1,3470,1476,287,2615,1
98,3604,1392,870,1177,35,17,170,1427,14,494,280,531,508,811,4473,7289,7,54850,3047,2,2,1,1,3470,1479,288,2616,0
1,87,127,75,83,2,11,30,129,4,14,7,14,18,21,61,87,2,175,9,0,2,1,1,3470,1479,288,2617,1
1,87,652,304,544,16,6,88,668,6,89,51,101,95,152,591,998,3,3399,188,0,2,1,1,3470,1480,288,2618,1
1,87,2,2,2,0,0,0,2,0,0,0,0,0,0,0,0,0,0,0,0,2,1,1,3470,1480,288,2618,1
1,87,8,5,5,0,0,3,8,0,0,0,0,0,0,0,0,0,0,0,0,2,1,1,3470,1480,288,2619,1
1,87,2,2,2,0,0,0,2,0,0,0,0,0,0,0,0,0,0,0,0,2,1,1,3470,1480,288,2619,1
1,87,14,8,8,0,0,6,14,0,0,0,0,0,0,0,0,0,0,0,0,2,1,1,3470,1480,288,2620,1
1,87,6,4,4,0,0,2,6,0,0,0,0,0,0,0,0,0,0,0,0,2,1,1,3470,1480,288,2621,1
1,87,6,4,4,0,0,2,6,1,2,1,2,3,3,2,4,0,2,0,0,2,1,1,3470,1480,288,2622,1
1,87,6,4,4,0,0,2,6,0,0,0,0,0,0,0,0,0,0,0,0,2,1,1,3470,1480,288,2623,1
1,87,7,5,5,0,0,2,7,0,0,0,0,0,0,0,0,0,0,0,0,2,1,1,3470,1480,288,2624,1
1,87,6,4,4,0,0,2,6,0,0,0,0,0,0,0,0,0,0,0,0,2,1,1,3470,1480,288,2625,1
1,87,10,6,6,0,0,4,10,0,0,0,0,0,0,0,0,0,0,0,0,2,1,1,3470,1480,288,2626,1
1,87,1,1,1,0,0,0,1,0,0,0,0,0,0,0,0,0,0,0,0,2,1,1,3470,1480,288,2626,1
1,87,14,10,10,0,0,4,14,1,1,1,1,2,2,0,2,0,1,0,0,2,1,1,3470,1480,288,2627,1
1,87,46,26,30,3,0,12,49,3,6,3,6,9,9,20,28,1,42,2,0,2,1,1,3480,1480,288,2628,1
1,85,127,75,83,2,11,30,129,4,14,7,14,18,21,61,87,2,175,9,0,2,1,1,3480,1480,288,2629,0
1,85,652,304,544,16,6,88,668,6,89,51,101,95,152,591,998,3,3399,188,0,2,1,1,3480,1481,288,2630,0
1,85,2,2,2,0,0,0,2,0,0,0,0,0,0,0,0,0,0,0,0,2,1,1,3480,1481,288,2630,0
1,85,8,5,5,0,0,3,8,0,0,0,0,0,0,0,0,0,0,0,0,2,1,1,3480,1481,288,2631,0
1,85,2,2,2,0,0,0,2,0,0,0,0,0,0,0,0,0,0,0,0,2,1,1,3480,1481,288,2631,0
1,85,14,8,8,0,0,6,14,0,0,0,0,0,0,0,0,0,0,0,0,2,1,1,3480,1481,288,2632,0
1,85,6,4,4,0,0,2,6,0,0,0,0,0,0,0,0,0,0,0,0,2,1,1,3480,1481,288,2633,0
1,85,6,4,4,0,0,2,6,1,2,1,2,3,3,2,4,0,2,0,0,2,1,1,3480,1481,288,2634,0
1,85,6,4,4,0,0,2,6,0,0,0,0,0,0,0,0,0,0,0,0,2,1,1,3480,1481,288,2635,0
1,85,7,5,5,0,0,2,7,0,0,0,0,0,0,0,0,0,0,0,0,2,1,1,3480,1481,288,2636,0
1,85,6,4,4,0,0,2,6,0,0,0,0,0,0,0,0,0,0,0,0,2,1,1,3480,1481,288,2637,0
1,85,10,6,6,0,0,4,10,0,0,0,0,0,0,0,0,0,0,0,0,2,1,1,3480,1481,288,2638,0
1,85,1,1,1,0,0,0,1,0,0,0,0,0,0,0,0,0,0,0,0,2,1,1,3480,1481,288,2638,0
1,85,14,10,10,0,0,4,14,1,1,1,1,2,2,0,2,0,1,0,0,2,1,1,3480,1481,288,2639,0
1,85,46,26,30,3,0,12,49,3,6,3,6,9,9,20,28,1,42,2,0,2,1,1,3490,1481,288,2640,0
27,503,334,251,279,10,4,40,344,5,127,74,143,132,217,899,1528,2,4303,239,0,2,2,1,3490,1482,288,2641,0
70,1507,1457,730,1242,11,6,188,1468,10,292,166,329,302,495,2424,4078,5,22973,1276,1,2,15,10,3490,1484,288,2642,1
70,1507,74,35,59,1,0,14,75,3,14,7,14,17,21,58,85,1,128,7,0,2,15,10,3490,1485,288,2643,1
70,1507,245,125,200,5,7,34,250,7,30,17,34,37,51,166,265,3,1053,58,0,2,15,10,3500,1486,288,2644,1
44,814,373,158,315,8,0,51,381,5,76,44,79,81,123,486,779,2,2026,112,0,2,3,3,3500,1486,288,2645,1
25,1266,1289,550,1043,56,32,155,1345,10,167,93,185,177,278,1266,2075,5,11498,638,0,2,8,13,3500,1488,289,2646,1
38,2103,1457,730,1242,11,6,188,1468,10,292,166,329,302,495,2424,4078,5,22973,1276,1,2,4,7,3500,1490,289,2647,1
71,1538,1457,730,1242,11,6,188,1468,10,292,166,329,302,495,2424,4078,5,22973,1276,1,2,6,0,3500,1492,289,2648,1
71,1538,74,35,59,1,0,14,75,3,14,7,14,17,21,58,85,1,128,7,0,2,6,0,3500,1493,289,2649,1
71,1538,245,125,200,5,7,34,250,7,30,17,34,37,51,166,265,3,1053,58,0,2,6,0,3510,1494,289,2650,1
26,1318,1289,550,1043,56,32,155,1345,10,167,93,185,177,278,1266,2075,5,11498,638,0,2,25,0,3510,1496,290,2651,1
39,2134,1457,730,1242,11,6,188,1468,10,292,166,329,302,495,2424,4078,5,22973,1276,1,2,6,0,3510,1498,290,2652,1
72,1555,1457,730,1242,11,6,188,1468,10,292,166,329,302,495,2424,4078,5,22973,1276,1,2,6,1,3510,1500,290,2653,1
72,1555,74,35,59,1,0,14,75,3,14,7,14,17,21,58,85,1,128,7,0,2,6,1,3510,1501,290,2654,1
72,1555,245,125,200,5,7,34,250,7,30,17,34,37,51,166,265,3,1053,58,0,2,6,1,3520,1502,290,2655,1
27,1359,1289,550,1043,56,32,155,1345,10,167,93,185,177,278,1266,2075,5,11498,638,0,2,13,1,3520,1504,291,2656,1
45,820,373,158,315,8,0,51,381,5,76,44,79,81,123,486,779,2,2026,112,0,2,2,0,3520,1504,291,2657,1
24,1006,373,158,315,8,0,51,381,5,76,44,79,81,123,486,779,2,2026,112,0,2,4,11,3520,1504,291,2658,1
45,825,373,158,315,8,0,51,381,5,76,44,79,81,123,486,779,2,2026,112,0,2,1,0,3520,1504,291,2659,1
75,1627,1457,730,1242,11,6,188,1468,10,292,166,329,302,495,2424,4078,5,22973,1276,1,2,14,6,3520,1506,291,2660,1
75,1627,74,35,59,1,0,14,75,3,14,7,14,17,21,58,85,1,128,7,0,2,14,6,3520,1507,291,2661,1
75,1627,245,125,200,5,7,34,250,7,30,17,34,37,51,166,265,3,1053,58,0,2,14,6,3530,1508,291,2662,1
28,1417,1289,550,1043,56,32,155,1345,10,167,93,185,177,278,1266,2075,5,11498,638,0,2,11,0,3530,1510,292,2663,1
39,2134,1457,730,1242,11,6,188,1468,10,292,166,329,302,495,2424,4078,5,22973,1276,1,2,2,1,3530,1512,292,2664,1
24,1014,373,158,315,8,0,51,381,5,76,44,79,81,123,486,779,2,2026,112,0,2,1,0,3530,1512,292,2665,1
78,1708,1457,730,1242,11,6,188,1468,10,292,166,329,302,495,2424,4078,5,22973,1276,1,2,15,3,3530,1514,292,2666,1
78,1708,74,35,59,1,0,14,75,3,14,7,14,17,21,58,85,1,128,7,0,2,15,3,3530,1515,292,2667,1
78,1708,245,125,200,5,7,34,250,7,30,17,34,37,51,166,265,3,1053,58,0,2,15,3,3540,1516,292,2668,1
42,2340,1457,730,1242,11,6,188,1468,10,292,166,329,302,495,2424,4078,5,22973,1276,1,2,33,7,3540,1518,292,2669,1
28,1435,1289,550,1043,56,32,155,1345,10,167,93,185,177,278,1266,2075,5,11498,638,0,2,2,1,3540,1520,293,2670,1
78,1712,1457,730,1242,11,6,188,1468,10,292,166,329,302,495,2424,4078,5,22973,1276,1,2,1,1,3540,1522,293,2671,0
78,1712,74,35,59,1,0,14,75,3,14,7,14,17,21,58,85,1,128,7,0,2,1,1,3540,1523,293,2672,0
78,1712,245,125,200,5,7,34,250,7,30,17,34,37,51,166,265,3,1053,58,0,2,1,1,3550,1524,293,2673,0
31,1528,1289,550,1043,56,32,155,1345,10,167,93,185,177,278,1266,2075,5,11498,638,0,2,21,3,3550,1526,294,2674,1
139,2413,1338,495,1086,10,64,173,1348,11,122,82,157,133,239,883,1686,7,11934,663,0,2,13,13,3550,1528,294,2675,1
25,631,1043,504,840,53,9,147,1096,9,180,112,198,189,310,1377,2344,4,11604,644,0,2,5,5,3550,1530,294,2676,1
25,631,383,288,292,26,6,62,409,11,65,38,67,76,105,429,656,5,3719,206,0,2,5,5,3550,1531,294,2677,1
45,825,373,158,315,8,0,51,381,5,76,44,79,81,123,486,779,2,2026,112,0,2,1,1,3550,1531,294,2678,1
42,2340,1457,730,1242,11,6,188,1468,10,292,166,329,302,495,2424,4078,5,22973,1276,1,2,5,5,3550,1533,294,2679,1
31,1528,1289,550,1043,56,32,155,1345,10,167,93,185,177,278,1266,2075,5,11498,638,0,2,3,3,3550,1535,295,2680,1
31,1536,1289,550,1043,56,32,155,1345,10,167,93,185,177,278,1266,2075,5,11498,638,0,2,2,2,3560,1541,297,2688,1
51,1713,773,419,590,28,0,166,801,10,204,113,217,214,330,1598,2554,5,13587,754,0,2,13,12,3560,1541,298,2689,0
98,3604,1392,870,1177,35,17,170,1427,14,494,280,531,508,811,4473,7289,7,54850,3047,2,2,1,1,3560,1544,299,2690,0
140,2422,1338,495,1086,10,64,173,1348,11,122,82,157,133,239,883,1686,7,11934,663,0,2,19,10,3560,1546,299,2691,1
140,2417,1338,495,1086,10,64,173,1348,11,122,82,157,133,239,883,1686,7,11934,663,0,2,1,1,3560,1548,299,2692,1
1,90,127,75,83,2,11,30,129,4,14,7,14,18,21,61,87,2,175,9,0,2,2,0,3560,1548,299,2693,1
1,90,652,304,544,16,6,88,668,6,89,51,101,95,152,591,998,3,3399,188,0,2,2,0,3560,1549,299,2694,1
1,90,2,2,2,0,0,0,2,0,0,0,0,0,0,0,0,0,0,0,0,2,2,0,3560,1549,299,2694,1
1,90,8,5,5,0,0,3,8,0,0,0,0,0,0,0,0,0,0,0,0,2,2,0,3560,1549,299,2695,1
1,90,2,2,2,0,0,0,2,0,0,0,0,0,0,0,0,0,0,0,0,2,2,0,3560,1549,299,2695,1
1,90,14,8,8,0,0,6,14,0,0,0,0,0,0,0,0,0,0,0,0,2,2,0,3560,1549,299,2696,1
1,90,6,4,4,0,0,2,6,0,0,0,0,0,0,0,0,0,0,0,0,2,2,0,3560,1549,299,2697,1
1,90,6,4,4,0,0,2,6,1,2,1,2,3,3,2,4,0,2,0,0,2,2,0,3560,1549,299,2698,1
1,90,6,4,4,0,0,2,6,0,0,0,0,0,0,0,0,0,0,0,0,2,2,0,3560,1549,299,2699,1
1,90,7,5,5,0,0,2,7,0,0,0,0,0,0,0,0,0,0,0,0,2,2,0,3560,1549,299,2700,1
1,90,6,4,4,0,0,2,6,0,0,0,0,0,0,0,0,0,0,0,0,2,2,0,3560,1549,299,2701,1
1,90,10,6,6,0,0,4,10,0,0,0,0,0,0,0,0,0,0,0,0,2,2,0,3560,1549,299,2702,1
1,90,1,1,1,0,0,0,1,0,0,0,0,0,0,0,0,0,0,0,0,2,2,0,3560,1549,299,2702,1
1,90,14,10,10,0,0,4,14,1,1,1,1,2,2,0,2,0,1,0,0,2,2,0,3560,1549,299,2703,1
1,90,46,26,30,3,0,12,49,3,6,3,6,9,9,20,28,1,42,2,0,2,2,0,3570,1549,299,2704,1
78,1737,1457,730,1242,11,6,188,1468,10,292,166,329,302,495,2424,4078,5,22973,1276,1,2,5,1,3570,1551,299,2705,1
78,1737,74,35,59,1,0,14,75,3,14,7,14,17,21,58,85,1,128,7,0,2,5,1,3570,1552,299,2706,1
78,1737,245,125,200,5,7,34,250,7,30,17,34,37,51,166,265,3,1053,58,0,2,5,1,3580,1553,299,2707,1
45,825,373,158,315,8,0,51,381,5,76,44,79,81,123,486,779,2,2026,112,0,2,2,2,3590,1557,300,2715,0
13,255,127,75,83,2,11,30,129,4,14,7,14,18,21,61,87,2,175,9,0,2,31,6,3600,1561,301,2723,1
13,255,652,304,544,16,6,88,668,6,89,51,101,95,152,591,998,3,3399,188,0,2,31,6,3600,1562,301,2724,1
13,255,2,2,2,0,0,0,2,0,0,0,0,0,0,0,0,0,0,0,0,2,31,6,3600,1562,301,2724,1
13,255,8,5,5,0,0,3,8,0,0,0,0,0,0,0,0,0,0,0,0,2,31,6,3600,1562,301,2725,1
13,255,2,2,2,0,0,0,2,0,0,0,0,0,0,0,0,0,0,0,0,2,31,6,3600,1562,301,2725,1
13,255,14,8,8,0,0,6,14,0,0,0,0,0,0,0,0,0,0,0,0,2,31,6,3600,1562,301,2726,1
13,255,6,4,4,0,0,2,6,0,0,0,0,0,0,0,0,0,0,0,0,2,31,6,3600,1562,301,2727,1
13,255,6,4,4,0,0,2,6,1,2,1,2,3,3,2,4,0,2,0,0,2,31,6,3600,1562,301,2728,1
13,255,6,4,4,0,0,2,6,0,0,0,0,0,0,0,0,0,0,0,0,2,31,6,3600,1562,301,2729,1
13,255,7,5,5,0,0,2,7,0,0,0,0,0,0,0,0,0,0,0,0,2,31,6,3600,1562,301,2730,1
13,255,6,4,4,0,0,2,6,0,0,0,0,0,0,0,0,0,0,0,0,2,31,6,3600,1562,301,2731,1
13,255,10,6,6,0,0,4,10,0,0,0,0,0,0,0,0,0,0,0,0,2,31,6,3600,1562,301,2732,1
13,255,1,1,1,0,0,0,1,0,0,0,0,0,0,0,0,0,0,0,0,2,31,6,3600,1562,301,2732,1
13,255,14,10,10,0,0,4,14,1,1,1,1,2,2,0,2,0,1,0,0,2,31,6,3600,1562,301,2733,1
13,255,46,26,30,3,0,12,49,3,6,3,6,9,9,20,28,1,42,2,0,2,31,6,3610,1562,301,2734,1
13,271,127,75,83,2,11,30,129,4,14,7,14,18,21,61,87,2,175,9,0,2,2,0,3620,1566,302,2742,1
13,271,652,304,544,16,6,88,668,6,89,51,101,95,152,591,998,3,3399,188,0,2,2,0,3620,1567,302,2743,1
13,271,2,2,2,0,0,0,2,0,0,0,0,0,0,0,0,0,0,0,0,2,2,0,3620,1567,302,2743,1
13,271,8,5,5,0,0,3,8,0,0,0,0,0,0,0,0,0,0,0,0,2,2,0,3620,1567,302,2744,1
13,271,2,2,2,0,0,0,2,0,0,0,0,0,0,0,0,0,0,0,0,2,2,0,3620,1567,302,2744,1
13,271,14,8,8,0,0,6,14,0,0,0,0,0,0,0,0,0,0,0,0,2,2,0,3620,1567,302,2745,1
13,271,6,4,4,0,0,2,6,0,0,0,0,0,0,0,0,0,0,0,0,2,2,0,3620,1567,302,2746,1
13,271,6,4,4,0,0,2,6,1,2,1,2,3,3,2,4,0,2,0,0,2,2,0,3620,1567,302,2747,1
13,271,6,4,4,0,0,2,6,0,0,0,0,0,0,0,0,0,0,0,0,2,2,0,3620,1567,302,2748,1
13,271,7,5,5,0,0,2,7,0,0,0,0,0,0,0,0,0,0,0,0,2,2,0,3620,1567,302,2749,1
13,271,6,4,4,0,0,2,6,0,0,0,0,0,0,0,0,0,0,0,0,2,2,0,3620,1567,302,2750,1
13,271,10,6,6,0,0,4,10,0,0,0,0,0,0,0,0,0,0,0,0,2,2,0,3620,1567,302,2751,1
13,271,1,1,1,0,0,0,1,0,0,0,0,0,0,0,0,0,0,0,0,2,2,0,3620,1567,302,2751,1
13,271,14,10,10,0,0,4,14,1,1,1,1,2,2,0,2,0,1,0,0,2,2,0,3620,1567,302,2752,1
13,271,46,26,30,3,0,12,49,3,6,3,6,9,9,20,28,1,42,2,0,2,2,0,3630,1567,302,2753,1
31,1539,1289,550,1043,56,32,155,1345,10,167,93,185,177,278,1266,2075,5,11498,638,0,2,7,4,3630,1569,303,2754,0
45,801,373,158,315,8,0,51,381,5,76,44,79,81,123,486,779,2,2026,112,0,2,1,2,3630,1569,303,2755,1
42,2324,1457,730,1242,11,6,188,1468,10,292,166,329,302,495,2424,4078,5,22973,1276,1,2,0,3,3630,1571,303,2756,0
94,1980,1457,730,1242,11,6,188,1468,10,292,166,329,302,495,2424,4078,5,22973,1276,1,2,39,0,3640,1574,303,2769,1
94,1980,74,35,59,1,0,14,75,3,14,7,14,17,21,58,85,1,128,7,0,2,39,0,3640,1575,303,2770,1
94,1980,245,125,200,5,7,34,250,7,30,17,34,37,51,166,265,3,1053,58,0,2,39,0,3650,1576,303,2771,1
31,1539,1289,550,1043,56,32,155,1345,10,167,93,185,177,278,1266,2075,5,11498,638,0,2,10,11,3650,1578,304,2772,1
42,2324,1457,730,1242,11,6,188,1468,10,292,166,329,302,495,2424,4078,5,22973,1276,1,2,0,2,3650,1580,304,2773,1
45,796,373,158,315,8,0,51,381,5,76,44,79,81,123,486,779,2,2026,112,0,2,1,1,3650,1580,304,2774,1
31,1539,1289,550,1043,56,32,155,1345,10,167,93,185,177,278,1266,2075,5,11498,638,0,2,4,4,3650,1582,305,2775,1
1,449,42,7,35,4,0,5,46,1,2,1,2,3,3,2,4,0,2,0,0,2,20,17,3660,1586,306,2783,1
1,449,11,6,10,0,0,1,11,2,4,2,4,6,6,10,15,1,15,0,0,2,20,17,3660,1586,306,2784,1
93,1970,1457,730,1242,11,6,188,1468,10,292,166,329,302,495,2424,4078,5,22973,1276,1,2,4,6,3670,1592,307,2792,1
93,1970,74,35,59,1,0,14,75,3,14,7,14,17,21,58,85,1,128,7,0,2,4,6,3670,1593,307,2793,1
93,1970,245,125,200,5,7,34,250,7,30,17,34,37,51,166,265,3,1053,58,0,2,4,6,3680,1594,307,2794,1
40,756,373,158,315,8,0,51,381,5,76,44,79,81,123,486,779,2,2026,112,0,2,0,12,3680,1594,307,2795,1
31,1539,1289,550,1043,56,32,155,1345,10,167,93,185,177,278,1266,2075,5,11498,638,0,2,1,1,3680,1596,308,2796,1
37,2114,1457,730,1242,11,6,188,1468,10,292,166,329,302,495,2424,4078,5,22973,1276,1,2,0,32,3680,1598,308,2797,1
25,631,1043,504,840,53,9,147,1096,9,180,112,198,189,310,1377,2344,4,11604,644,0,2,1,1,3700,1608,310,2812,1
25,631,383,288,292,26,6,62,409,11,65,38,67,76,105,429,656,5,3719,206,0,2,1,1,3700,1609,310,2813,1
93,1972,1457,730,1242,11,6,188,1468,10,292,166,329,302,495,2424,4078,5,22973,1276,1,2,2,2,3700,1611,310,2814,1
93,1972,74,35,59,1,0,14,75,3,14,7,14,17,21,58,85,1,128,7,0,2,2,2,3700,1612,310,2815,1
93,1972,245,125,200,5,7,34,250,7,30,17,34,37,51,166,265,3,1053,58,0,2,2,2,3710,1613,310,2816,1
37,2114,1457,730,1242,11,6,188,1468,10,292,166,329,302,495,2424,4078,5,22973,1276,1,2,4,4,3710,1615,310,2817,1
92,1962,1457,730,1242,11,6,188,1468,10,292,166,329,302,495,2424,4078,5,22973,1276,1,2,4,7,3710,1617,310,2818,0
92,1962,74,35,59,1,0,14,75,3,14,7,14,17,21,58,85,1,128,7,0,2,4,7,3710,1618,310,2819,0
92,1962,245,125,200,5,7,34,250,7,30,17,34,37,51,166,265,3,1053,58,0,2,4,7,3720,1619,310,2820,0
31,1539,1289,550,1043,56,32,155,1345,10,167,93,185,177,278,1266,2075,5,11498,638,0,2,4,4,3720,1621,311,2821,0
93,2003,1457,730,1242,11,6,188,1468,10,292,166,329,302,495,2424,4078,5,22973,1276,1,2,12,7,3720,1623,311,2822,0
93,2003,74,35,59,1,0,14,75,3,14,7,14,17,21,58,85,1,128,7,0,2,12,7,3720,1624,311,2823,0
93,2003,245,125,200,5,7,34,250,7,30,17,34,37,51,166,265,3,1053,58,0,2,12,7,3730,1625,311,2824,0
31,1539,1289,550,1043,56,32,155,1345,10,167,93,185,177,278,1266,2075,5,11498,638,0,2,2,2,3730,1627,312,2825,0
43,2395,1457,730,1242,11,6,188,1468,10,292,166,329,302,495,2424,4078,5,22973,1276,1,2,42,0,3730,1629,312,2826,0
92,1980,1457,730,1242,11,6,188,1468,10,292,166,329,302,495,2424,4078,5,22973,1276,1,2,10,14,3730,1631,313,2830,1
92,1980,74,35,59,1,0,14,75,3,14,7,14,17,21,58,85,1,128,7,0,2,10,14,3730,1632,313,2831,1
92,1980,245,125,200,5,7,34,250,7,30,17,34,37,51,166,265,3,1053,58,0,2,10,14,3740,1633,313,2832,1
33,1753,1289,550,1043,56,32,155,1345,10,167,93,185,177,278,1266,2075,5,11498,638,0,2,88,39,3740,1635,314,2833,1
37,2114,1457,730,1242,11,6,188,1468,10,292,166,329,302,495,2424,4078,5,22973,1276,1,2,1,45,3740,1637,314,2834,1
13,269,127,75,83,2,11,30,129,4,14,7,14,18,21,61,87,2,175,9,0,2,2,3,3740,1637,314,2835,0
13,269,652,304,544,16,6,88,668,6,89,51,101,95,152,591,998,3,3399,188,0,2,2,3,3740,1638,314,2836,0
13,269,2,2,2,0,0,0,2,0,0,0,0,0,0,0,0,0,0,0,0,2,2,3,3740,1638,314,2836,0
13,269,8,5,5,0,0,3,8,0,0,0,0,0,0,0,0,0,0,0,0,2,2,3,3740,1638,314,2837,0
13,269,2,2,2,0,0,0,2,0,0,0,0,0,0,0,0,0,0,0,0,2,2,3,3740,1638,314,2837,0
13,269,14,8,8,0,0,6,14,0,0,0,0,0,0,0,0,0,0,0,0,2,2,3,3740,1638,314,2838,0
13,269,6,4,4,0,0,2,6,0,0,0,0,0,0,0,0,0,0,0,0,2,2,3,3740,1638,314,2839,0
13,269,6,4,4,0,0,2,6,1,2,1,2,3,3,2,4,0,2,0,0,2,2,3,3740,1638,314,2840,0
13,269,6,4,4,0,0,2,6,0,0,0,0,0,0,0,0,0,0,0,0,2,2,3,3740,1638,314,2841,0
13,269,7,5,5,0,0,2,7,0,0,0,0,0,0,0,0,0,0,0,0,2,2,3,3740,1638,314,2842,0
13,269,6,4,4,0,0,2,6,0,0,0,0,0,0,0,0,0,0,0,0,2,2,3,3740,1638,314,2843,0
13,269,10,6,6,0,0,4,10,0,0,0,0,0,0,0,0,0,0,0,0,2,2,3,3740,1638,314,2844,0
13,269,1,1,1,0,0,0,1,0,0,0,0,0,0,0,0,0,0,0,0,2,2,3,3740,1638,314,2844,0
13,269,14,10,10,0,0,4,14,1,1,1,1,2,2,0,2,0,1,0,0,2,2,3,3740,1638,314,2845,0
13,269,46,26,30,3,0,12,49,3,6,3,6,9,9,20,28,1,42,2,0,2,2,3,3750,1638,314,2846,0
33,1781,1289,550,1043,56,32,155,1345,10,167,93,185,177,278,1266,2075,5,11498,638,0,2,21,22,3750,1640,315,2847,0
1,461,42,7,35,4,0,5,46,1,2,1,2,3,3,2,4,0,2,0,0,2,18,12,3750,1640,315,2848,1
1,461,11,6,10,0,0,1,11,2,4,2,4,6,6,10,15,1,15,0,0,2,18,12,3750,1640,315,2849,1
1,459,42,7,35,4,0,5,46,1,2,1,2,3,3,2,4,0,2,0,0,2,1,2,3750,1640,315,2850,0
1,459,11,6,10,0,0,1,11,2,4,2,4,6,6,10,15,1,15,0,0,2,1,2,3750,1640,315,2851,0
1,459,42,7,35,4,0,5,46,1,2,1,2,3,3,2,4,0,2,0,0,2,1,1,3750,1640,315,2852,1
1,459,11,6,10,0,0,1,11,2,4,2,4,6,6,10,15,1,15,0,0,2,1,1,3750,1640,315,2853,1
1,449,42,7,35,4,0,5,46,1,2,1,2,3,3,2,4,0,2,0,0,2,2,7,3750,1640,315,2854,1
1,449,11,6,10,0,0,1,11,2,4,2,4,6,6,10,15,1,15,0,0,2,2,7,3750,1640,315,2855,1
1,445,42,7,35,4,0,5,46,1,2,1,2,3,3,2,4,0,2,0,0,2,3,5,3760,1644,316,2863,0
1,445,11,6,10,0,0,1,11,2,4,2,4,6,6,10,15,1,15,0,0,2,3,5,3760,1644,316,2864,0
1,445,42,7,35,4,0,5,46,1,2,1,2,3,3,2,4,0,2,0,0,2,4,4,3770,1648,317,2872,1
1,445,11,6,10,0,0,1,11,2,4,2,4,6,6,10,15,1,15,0,0,2,4,4,3770,1648,317,2873,1
1,433,42,7,35,4,0,5,46,1,2,1,2,3,3,2,4,0,2,0,0,2,6,12,3780,1652,318,2881,1
1,433,11,6,10,0,0,1,11,2,4,2,4,6,6,10,15,1,15,0,0,2,6,12,3780,1652,318,2882,1
96,2109,1457,730,1242,11,6,188,1468,10,292,166,329,302,495,2424,4078,5,22973,1276,1,2,18,1,3780,1654,318,2883,0
96,2109,74,35,59,1,0,14,75,3,14,7,14,17,21,58,85,1,128,7,0,2,18,1,3780,1655,318,2884,0
96,2109,245,125,200,5,7,34,250,7,30,17,34,37,51,166,265,3,1053,58,0,2,18,1,3790,1656,318,2885,0
43,2292,1457,730,1242,11,6,188,1468,10,292,166,329,302,495,2424,4078,5,22973,1276,1,2,28,0,3790,1658,318,2886,0
33,1810,1289,550,1043,56,32,155,1345,10,167,93,185,177,278,1266,2075,5,11498,638,0,2,8,3,3800,1664,320,2894,1
3,441,42,7,35,4,0,5,46,1,2,1,2,3,3,2,4,0,2,0,0,2,8,5,3800,1664,320,2895,1
3,441,11,6,10,0,0,1,11,2,4,2,4,6,6,10,15,1,15,0,0,2,8,5,3800,1664,320,2896,1
13,269,127,75,83,2,11,30,129,4,14,7,14,18,21,61,87,2,175,9,0,2,2,2,3800,1664,320,2897,1
13,269,652,304,544,16,6,88,668,6,89,51,101,95,152,591,998,3,3399,188,0,2,2,2,3800,1665,320,2898,1
13,269,2,2,2,0,0,0,2,0,0,0,0,0,0,0,0,0,0,0,0,2,2,2,3800,1665,320,2898,1
13,269,8,5,5,0,0,3,8,0,0,0,0,0,0,0,0,0,0,0,0,2,2,2,3800,1665,320,2899,1
13,269,2,2,2,0,0,0,2,0,0,0,0,0,0,0,0,0,0,0,0,2,2,2,3800,1665,320,2899,1
13,269,14,8,8,0,0,6,14,0,0,0,0,0,0,0,0,0,0,0,0,2,2,2,3800,1665,320,2900,1
13,269,6,4,4,0,0,2,6,0,0,0,0,0,0,0,0,0,0,0,0,2,2,2,3800,1665,320,2901,1
13,269,6,4,4,0,0,2,6,1,2,1,2,3,3,2,4,0,2,0,0,2,2,2,3800,1665,320,2902,1
13,269,6,4,4,0,0,2,6,0,0,0,0,0,0,0,0,0,0,0,0,2,2,2,3800,1665,320,2903,1
13,269,7,5,5,0,0,2,7,0,0,0,0,0,0,0,0,0,0,0,0,2,2,2,3800,1665,320,2904,1
13,269,6,4,4,0,0,2,6,0,0,0,0,0,0,0,0,0,0,0,0,2,2,2,3800,1665,320,2905,1
13,269,10,6,6,0,0,4,10,0,0,0,0,0,0,0,0,0,0,0,0,2,2,2,3800,1665,320,2906,1
13,269,1,1,1,0,0,0,1,0,0,0,0,0,0,0,0,0,0,0,0,2,2,2,3800,1665,320,2906,1
13,269,14,10,10,0,0,4,14,1,1,1,1,2,2,0,2,0,1,0,0,2,2,2,3800,1665,320,2907,1
13,269,46,26,30,3,0,12,49,3,6,3,6,9,9,20,28,1,42,2,0,2,2,2,3810,1665,320,2908,1
92,1980,1457,730,1242,11,6,188,1468,10,292,166,329,302,495,2424,4078,5,22973,1276,1,2,1,18,3810,1667,320,2909,0
92,1980,74,35,59,1,0,14,75,3,14,7,14,17,21,58,85,1,128,7,0,2,1,18,3810,1668,320,2910,0
92,1980,245,125,200,5,7,34,250,7,30,17,34,37,51,166,265,3,1053,58,0,2,1,18,3820,1669,320,2911,0
37,2114,1457,730,1242,11,6,188,1468,10,292,166,329,302,495,2424,4078,5,22973,1276,1,2,0,28,3820,1671,320,2912,0
3,399,42,7,35,4,0,5,46,1,2,1,2,3,3,2,4,0,2,0,0,2,2,25,3840,1679,322,2929,0
3,399,11,6,10,0,0,1,11,2,4,2,4,6,6,10,15,1,15,0,0,2,2,25,3840,1679,322,2930,0
3,399,42,7,35,4,0,5,46,1,2,1,2,3,3,2,4,0,2,0,0,2,1,1,3840,1679,322,2931,0
3,399,11,6,10,0,0,1,11,2,4,2,4,6,6,10,15,1,15,0,0,2,1,1,3840,1679,322,2932,0
27,519,334,251,279,10,4,40,344,5,127,74,143,132,217,899,1528,2,4303,239,0,2,4,2,3840,1680,322,2933,0
13,660,334,251,279,10,4,40,344,5,127,74,143,132,217,899,1528,2,4303,239,0,2,1,1,3840,1681,322,2934,0
3,399,42,7,35,4,0,5,46,1,2,1,2,3,3,2,4,0,2,0,0,2,2,2,3850,1685,323,2942,0
3,399,11,6,10,0,0,1,11,2,4,2,4,6,6,10,15,1,15,0,0,2,2,2,3850,1685,323,2943,0
13,269,127,75,83,2,11,30,129,4,14,7,14,18,21,61,87,2,175,9,0,2,2,2,3850,1685,323,2944,1
13,269,652,304,544,16,6,88,668,6,89,51,101,95,152,591,998,3,3399,188,0,2,2,2,3850,1686,323,2945,1
13,269,2,2,2,0,0,0,2,0,0,0,0,0,0,0,0,0,0,0,0,2,2,2,3850,1686,323,2945,1
13,269,8,5,5,0,0,3,8,0,0,0,0,0,0,0,0,0,0,0,0,2,2,2,3850,1686,323,2946,1
13,269,2,2,2,0,0,0,2,0,0,0,0,0,0,0,0,0,0,0,0,2,2,2,3850,1686,323,2946,1
13,269,14,8,8,0,0,6,14,0,0,0,0,0,0,0,0,0,0,0,0,2,2,2,3850,1686,323,2947,1
13,269,6,4,4,0,0,2,6,0,0,0,0,0,0,0,0,0,0,0,0,2,2,2,3850,1686,323,2948,1
13,269,6,4,4,0,0,2,6,1,2,1,2,3,3,2,4,0,2,0,0,2,2,2,3850,1686,323,2949,1
13,269,6,4,4,0,0,2,6,0,0,0,0,0,0,0,0,0,0,0,0,2,2,2,3850,1686,323,2950,1
13,269,7,5,5,0,0,2,7,0,0,0,0,0,0,0,0,0,0,0,0,2,2,2,3850,1686,323,2951,1
13,269,6,4,4,0,0,2,6,0,0,0,0,0,0,0,0,0,0,0,0,2,2,2,3850,1686,323,2952,1
13,269,10,6,6,0,0,4,10,0,0,0,0,0,0,0,0,0,0,0,0,2,2,2,3850,1686,323,2953,1
13,269,1,1,1,0,0,0,1,0,0,0,0,0,0,0,0,0,0,0,0,2,2,2,3850,1686,323,2953,1
13,269,14,10,10,0,0,4,14,1,1,1,1,2,2,0,2,0,1,0,0,2,2,2,3850,1686,323,2954,1
13,269,46,26,30,3,0,12,49,3,6,3,6,9,9,20,28,1,42,2,0,2,2,2,3860,1686,323,2955,1
3,399,42,7,35,4,0,5,46,1,2,1,2,3,3,2,4,0,2,0,0,2,3,3,3870,1690,324,2963,0
3,399,11,6,10,0,0,1,11,2,4,2,4,6,6,10,15,1,15,0,0,2,3,3,3870,1690,324,2964,0
1,383,42,7,35,4,0,5,46,1,2,1,2,3,3,2,4,0,2,0,0,2,7,9,3880,1700,331,2978,0
1,383,11,6,10,0,0,1,11,2,4,2,4,6,6,10,15,1,15,0,0,2,7,9,3880,1700,331,2979,0
36,2098,1457,730,1242,11,6,188,1468,10,292,166,329,302,495,2424,4078,5,22973,1276,1,2,3,7,3880,1702,331,2980,0
13,267,127,75,83,2,11,30,129,4,14,7,14,18,21,61,87,2,175,9,0,2,1,1,3930,1719,335,3021,1
13,267,652,304,544,16,6,88,668,6,89,51,101,95,152,591,998,3,3399,188,0,2,1,1,3930,1720,335,3022,1
13,267,2,2,2,0,0,0,2,0,0,0,0,0,0,0,0,0,0,0,0,2,1,1,3930,1720,335,3022,1
13,267,8,5,5,0,0,3,8,0,0,0,0,0,0,0,0,0,0,0,0,2,1,1,3930,1720,335,3023,1
13,267,2,2,2,0,0,0,2,0,0,0,0,0,0,0,0,0,0,0,0,2,1,1,3930,1720,335,3023,1
13,267,14,8,8,0,0,6,14,0,0,0,0,0,0,0,0,0,0,0,0,2,1,1,3930,1720,335,3024,1
13,267,6,4,4,0,0,2,6,0,0,0,0,0,0,0,0,0,0,0,0,2,1,1,3930,1720,335,3025,1
13,267,6,4,4,0,0,2,6,1,2,1,2,3,3,2,4,0,2,0,0,2,1,1,3930,1720,335,3026,1
13,267,6,4,4,0,0,2,6,0,0,0,0,0,0,0,0,0,0,0,0,2,1,1,3930,1720,335,3027,1
13,267,7,5,5,0,0,2,7,0,0,0,0,0,0,0,0,0,0,0,0,2,1,1,3930,1720,335,3028,1
13,267,6,4,4,0,0,2,6,0,0,0,0,0,0,0,0,0,0,0,0,2,1,1,3930,1720,335,3029,1
13,267,10,6,6,0,0,4,10,0,0,0,0,0,0,0,0,0,0,0,0,2,1,1,3930,1720,335,3030,1
13,267,1,1,1,0,0,0,1,0,0,0,0,0,0,0,0,0,0,0,0,2,1,1,3930,1720,335,3030,1
13,267,14,10,10,0,0,4,14,1,1,1,1,2,2,0,2,0,1,0,0,2,1,1,3930,1720,335,3031,1
13,267,46,26,30,3,0,12,49,3,6,3,6,9,9,20,28,1,42,2,0,2,1,1,3940,1720,335,3032,1
1,319,42,7,35,4,0,5,46,1,2,1,2,3,3,2,4,0,2,0,0,2,2,34,3940,1720,335,3033,0
1,319,11,6,10,0,0,1,11,2,4,2,4,6,6,10,15,1,15,0,0,2,2,34,3940,1720,335,3034,0
15,369,386,256,301,16,9,68,402,4,59,35,69,63,104,355,621,2,1453,80,0,2,1,1,3940,1720,335,3035,1
15,369,264,131,164,11,41,46,275,6,38,22,40,44,62,214,338,3,1068,59,0,2,1,1,3950,1720,336,3036,1
40,756,373,158,315,8,0,51,381,5,76,44,79,81,123,486,779,2,2026,112,0,2,2,2,3950,1720,336,3037,1
31,322,757,253,292,73,244,162,830,13,61,38,67,74,105,409,651,7,4654,258,0,0,120,0,3950,1722,337,3039,0
13,272,127,75,83,2,11,30,129,4,14,7,14,18,21,61,87,2,175,9,0,2,1,0,3970,1724,337,3064,1
13,272,652,304,544,16,6,88,668,6,89,51,101,95,152,591,998,3,3399,188,0,2,1,0,3970,1725,337,3065,1
13,272,2,2,2,0,0,0,2,0,0,0,0,0,0,0,0,0,0,0,0,2,1,0,3970,1725,337,3065,1
13,272,8,5,5,0,0,3,8,0,0,0,0,0,0,0,0,0,0,0,0,2,1,0,3970,1725,337,3066,1
13,272,2,2,2,0,0,0,2,0,0,0,0,0,0,0,0,0,0,0,0,2,1,0,3970,1725,337,3066,1
13,272,14,8,8,0,0,6,14,0,0,0,0,0,0,0,0,0,0,0,0,2,1,0,3970,1725,337,3067,1
13,272,6,4,4,0,0,2,6,0,0,0,0,0,0,0,0,0,0,0,0,2,1,0,3970,1725,337,3068,1
13,272,6,4,4,0,0,2,6,1,2,1,2,3,3,2,4,0,2,0,0,2,1,0,3970,1725,337,3069,1
13,272,6,4,4,0,0,2,6,0,0,0,0,0,0,0,0,0,0,0,0,2,1,0,3970,1725,337,3070,1
13,272,7,5,5,0,0,2,7,0,0,0,0,0,0,0,0,0,0,0,0,2,1,0,3970,1725,337,3071,1
13,272,6,4,4,0,0,2,6,0,0,0,0,0,0,0,0,0,0,0,0,2,1,0,3970,1725,337,3072,1
13,272,10,6,6,0,0,4,10,0,0,0,0,0,0,0,0,0,0,0,0,2,1,0,3970,1725,337,3073,1
13,272,1,1,1,0,0,0,1,0,0,0,0,0,0,0,0,0,0,0,0,2,1,0,3970,1725,337,3073,1
13,272,14,10,10,0,0,4,14,1,1,1,1,2,2,0,2,0,1,0,0,2,1,0,3970,1725,337,3074,1
13,272,46,26,30,3,0,12,49,3,6,3,6,9,9,20,28,1,42,2,0,2,1,0,3980,1725,337,3075,1
31,320,757,253,292,73,244,162,830,13,61,38,67,74,105,409,651,7,4654,258,0,2,3,3,3980,1726,337,3076,1
40,750,373,158,315,8,0,51,381,5,76,44,79,81,123,486,779,2,2026,112,0,2,1,1,3980,1726,337,3077,1
24,1016,373,158,315,8,0,51,381,5,76,44,79,81,123,486,779,2,2026,112,0,2,3,3,3980,1726,337,3078,1
31,324,757,253,292,73,244,162,830,13,61,38,67,74,105,409,651,7,4654,258,0,2,1,1,3980,1727,337,3079,1
42,753,373,158,315,8,0,51,381,5,76,44,79,81,123,486,779,2,2026,112,0,2,2,1,3980,1727,337,3080,1
31,324,757,253,292,73,244,162,830,13,61,38,67,74,105,409,651,7,4654,258,0,2,1,1,3980,1728,337,3081,1
42,748,373,158,315,8,0,51,381,5,76,44,79,81,123,486,779,2,2026,112,0,2,1,1,3980,1728,337,3082,1
31,324,757,253,292,73,244,162,830,13,61,38,67,74,105,409,651,7,4654,258,0,2,3,3,3980,1729,337,3083,1
42,737,373,158,315,8,0,51,381,5,76,44,79,81,123,486,779,2,2026,112,0,2,2,2,3980,1729,337,3084,1
24,1014,373,158,315,8,0,51,381,5,76,44,79,81,123,486,779,2,2026,112,0,2,2,2,3980,1729,337,3085,1
31,326,757,253,292,73,244,162,830,13,61,38,67,74,105,409,651,7,4654,258,0,2,2,2,3980,1730,337,3086,1
23,632,1043,504,840,53,9,147,1096,9,180,112,198,189,310,1377,2344,4,11604,644,0,2,24,23,3980,1732,337,3087,0
23,632,383,288,292,26,6,62,409,11,65,38,67,76,105,429,656,5,3719,206,0,2,24,23,3980,1733,337,3088,0
23,1002,373,158,315,8,0,51,381,5,76,44,79,81,123,486,779,2,2026,112,0,2,4,6,3990,1737,338,3096,0
19,509,1043,504,840,53,9,147,1096,9,180,112,198,189,310,1377,2344,4,11604,644,0,2,39,60,3990,1739,338,3097,1
19,509,383,288,292,26,6,62,409,11,65,38,67,76,105,429,656,5,3719,206,0,2,39,60,3990,1740,338,3098,1
138,2386,1338,495,1086,10,64,173,1348,11,122,82,157,133,239,883,1686,7,11934,663,0,2,0,6,3990,1742,338,3099,0
32,339,757,253,292,73,244,162,830,13,61,38,67,74,105,409,651,7,4654,258,0,2,3,0,3990,1743,338,3100,0
42,736,373,158,315,8,0,51,381,5,76,44,79,81,123,486,779,2,2026,112,0,2,2,3,3990,1743,338,3101,0
42,724,373,158,315,8,0,51,381,5,76,44,79,81,123,486,779,2,2026,112,0,2,1,3,3990,1743,338,3102,0
17,451,1043,504,840,53,9,147,1096,9,180,112,198,189,310,1377,2344,4,11604,644,0,2,0,13,3990,1745,338,3103,0
17,451,383,288,292,26,6,62,409,11,65,38,67,76,105,429,656,5,3719,206,0,2,0,13,3990,1746,338,3104,0
19,276,477,336,357,30,23,73,507,16,194,134,250,210,384,1538,2962,10,30538,1696,0,2,0,1,4000,1747,338,3105,0
42,722,373,158,315,8,0,51,381,5,76,44,79,81,123,486,779,2,2026,112,0,2,1,1,4000,1747,338,3106,0
33,872,1043,504,840,53,9,147,1096,9,180,112,198,189,310,1377,2344,4,11604,644,0,2,83,6,4000,1749,338,3107,1
33,872,383,288,292,26,6,62,409,11,65,38,67,76,105,429,656,5,3719,206,0,2,83,6,4000,1750,338,3108,1
82,1830,1457,730,1242,11,6,188,1468,10,292,166,329,302,495,2424,4078,5,22973,1276,1,2,1,28,4000,1752,338,3109,1
82,1830,74,35,59,1,0,14,75,3,14,7,14,17,21,58,85,1,128,7,0,2,1,28,4000,1753,338,3110,1
82,1830,245,125,200,5,7,34,250,7,30,17,34,37,51,166,265,3,1053,58,0,2,1,28,4010,1754,338,3111,1
33,348,757,253,292,73,244,162,830,13,61,38,67,74,105,409,651,7,4654,258,0,2,3,0,4010,1755,338,3112,1
53,1236,1043,504,840,53,9,147,1096,9,180,112,198,189,310,1377,2344,4,11604,644,0,2,69,3,4010,1757,338,3113,1
53,1236,383,288,292,26,6,62,409,11,65,38,67,76,105,429,656,5,3719,206,0,2,69,3,4010,1758,338,3114,1
34,361,757,253,292,73,244,162,830,13,61,38,67,74,105,409,651,7,4654,258,0,2,4,1,4010,1759,338,3115,1
55,1341,1043,504,840,53,9,147,1096,9,180,112,198,189,310,1377,2344,4,11604,644,0,2,36,21,4010,1761,338,3116,1
55,1341,383,288,292,26,6,62,409,11,65,38,67,76,105,429,656,5,3719,206,0,2,36,21,4010,1762,338,3117,1
6,416,1043,504,840,53,9,147,1096,9,180,112,198,189,310,1377,2344,4,11604,644,0,0,91,0,4010,1764,338,3118,1
34,361,757,253,292,73,244,162,830,13,61,38,67,74,105,409,651,7,4654,258,0,2,2,2,4010,1765,338,3119,1
42,722,373,158,315,8,0,51,381,5,76,44,79,81,123,486,779,2,2026,112,0,2,4,4,4010,1765,338,3120,1
6,416,1043,504,840,53,9,147,1096,9,180,112,198,189,310,1377,2344,4,11604,644,0,2,1,1,4010,1767,338,3121,1
138,2386,1338,495,1086,10,64,173,1348,11,122,82,157,133,239,883,1686,7,11934,663,0,2,3,18,4010,1769,338,3122,0
53,1303,1043,504,840,53,9,147,1096,9,180,112,198,189,310,1377,2344,4,11604,644,0,2,0,7,4010,1771,338,3123,0
53,1303,383,288,292,26,6,62,409,11,65,38,67,76,105,429,656,5,3719,206,0,2,0,7,4010,1772,338,3124,0
6,416,1043,504,840,53,9,147,1096,9,180,112,198,189,310,1377,2344,4,11604,644,0,2,6,6,4010,1774,338,3125,0
23,1002,373,158,315,8,0,51,381,5,76,44,79,81,123,486,779,2,2026,112,0,2,3,3,4010,1774,338,3126,0
35,374,757,253,292,73,244,162,830,13,61,38,67,74,105,409,651,7,4654,258,0,2,3,0,4010,1775,338,3127,1
53,1303,1043,504,840,53,9,147,1096,9,180,112,198,189,310,1377,2344,4,11604,644,0,2,3,0,4010,1777,338,3128,1
53,1303,383,288,292,26,6,62,409,11,65,38,67,76,105,429,656,5,3719,206,0,2,3,0,4010,1778,338,3129,1
23,1002,373,158,315,8,0,51,381,5,76,44,79,81,123,486,779,2,2026,112,0,2,8,8,4010,1778,338,3130,1
35,374,757,253,292,73,244,162,830,13,61,38,67,74,105,409,651,7,4654,258,0,2,1,1,4010,1779,338,3131,0
53,1300,1043,504,840,53,9,147,1096,9,180,112,198,189,310,1377,2344,4,11604,644,0,2,2,7,4010,1781,338,3132,0
53,1300,383,288,292,26,6,62,409,11,65,38,67,76,105,429,656,5,3719,206,0,2,2,7,4010,1782,338,3133,0
42,722,373,158,315,8,0,51,381,5,76,44,79,81,123,486,779,2,2026,112,0,2,2,2,4010,1782,338,3134,0
23,1002,373,158,315,8,0,51,381,5,76,44,79,81,123,486,779,2,2026,112,0,2,3,3,4010,1782,338,3135,0
45,1284,2,2,2,0,0,0,2,0,0,0,0,0,0,0,0,0,0,0,0,0,346,0,4010,1782,338,3135,0
45,1284,99,48,90,1,3,5,100,0,0,0,0,0,0,0,0,0,0,0,0,0,346,0,4010,1783,338,3136,0
45,1284,8,5,5,2,0,1,10,0,0,0,0,0,0,0,0,0,0,0,0,0,346,0,4010,1783,338,3137,0
45,1284,1217,716,841,84,126,174,1301,14,185,118,215,199,333,1446,2542,8,20687,1149,0,0,346,0,4020,1785,338,3138,0
45,1284,160,89,115,0,13,31,160,7,15,11,17,22,28,78,124,3,495,27,0,0,346,0,4020,1785,338,3139,0
45,1284,10,10,9,9,0,0,19,0,0,0,0,0,0,0,0,0,0,0,0,0,346,0,4020,1785,339,3140,0
45,1284,173,84,99,8,29,36,181,5,12,7,13,17,20,54,81,2,221,12,0,0,346,0,4020,1786,339,3141,0
45,1284,3,1,1,3,0,0,6,0,0,0,0,0,0,0,0,0,0,0,0,0,346,0,4020,1786,339,3142,0
16,393,2,2,2,0,0,0,2,0,0,0,0,0,0,0,0,0,0,0,0,0,114,0,4020,1786,339,3142,0
16,393,99,48,90,1,3,5,100,0,0,0,0,0,0,0,0,0,0,0,0,0,114,0,4020,1787,339,3143,0
16,393,8,5,5,2,0,1,10,0,0,0,0,0,0,0,0,0,0,0,0,0,114,0,4020,1787,339,3144,0
16,393,1217,716,841,84,126,174,1301,14,185,118,215,199,333,1446,2542,8,20687,1149,0,0,114,0,4030,1789,339,3145,0
16,393,160,89,115,0,13,31,160,7,15,11,17,22,28,78,124,3,495,27,0,0,114,0,4030,1789,339,3146,0
16,393,10,10,9,9,0,0,19,0,0,0,0,0,0,0,0,0,0,0,0,0,114,0,4030,1789,340,3147,0
16,393,173,84,99,8,29,36,181,5,12,7,13,17,20,54,81,2,221,12,0,0,114,0,4030,1790,340,3148,0
16,393,3,1,1,3,0,0,6,0,0,0,0,0,0,0,0,0,0,0,0,0,114,0,4030,1790,340,3149,0
88,1951,1457,730,1242,11,6,188,1468,10,292,166,329,302,495,2424,4078,5,22973,1276,1,2,22,0,4030,1792,340,3150,1
88,1951,74,35,59,1,0,14,75,3,14,7,14,17,21,58,85,1,128,7,0,2,22,0,4030,1793,340,3151,1
88,1951,245,125,200,5,7,34,250,7,30,17,34,37,51,166,265,3,1053,58,0,2,22,0,4040,1794,340,3152,1
49,1248,1043,504,840,53,9,147,1096,9,180,112,198,189,310,1377,2344,4,11604,644,0,2,8,27,4040,1796,340,3153,1
49,1248,383,288,292,26,6,62,409,11,65,38,67,76,105,429,656,5,3719,206,0,2,8,27,4040,1797,340,3154,1
42,2284,1457,730,1242,11,6,188,1468,10,292,166,329,302,495,2424,4078,5,22973,1276,1,2,32,3,4040,1799,340,3155,1
44,1071,1043,504,840,53,9,147,1096,9,180,112,198,189,310,1377,2344,4,11604,644,0,2,0,21,4040,1801,340,3156,0
44,1071,383,288,292,26,6,62,409,11,65,38,67,76,105,429,656,5,3719,206,0,2,0,21,4040,1802,340,3157,0
6,419,1043,504,840,53,9,147,1096,9,180,112,198,189,310,1377,2344,4,11604,644,0,2,1,0,4040,1804,340,3158,0
88,1960,1457,730,1242,11,6,188,1468,10,292,166,329,302,495,2424,4078,5,22973,1276,1,2,1,0,4060,1814,342,3173,1
88,1960,74,35,59,1,0,14,75,3,14,7,14,17,21,58,85,1,128,7,0,2,1,0,4060,1815,342,3174,1
88,1960,245,125,200,5,7,34,250,7,30,17,34,37,51,166,265,3,1053,58,0,2,1,0,4070,1816,342,3175,1
36,387,757,253,292,73,244,162,830,13,61,38,67,74,105,409,651,7,4654,258,0,2,4,0,4070,1817,342,3176,1
16,393,2,2,2,0,0,0,2,0,0,0,0,0,0,0,0,0,0,0,0,2,1,0,4070,1817,342,3176,0
16,393,99,48,90,1,3,5,100,0,0,0,0,0,0,0,0,0,0,0,0,2,1,0,4070,1818,342,3177,0
16,393,8,5,5,2,0,1,10,0,0,0,0,0,0,0,0,0,0,0,0,2,1,0,4070,1818,342,3178,0
16,393,1217,716,841,84,126,174,1301,14,185,118,215,199,333,1446,2542,8,20687,1149,0,2,1,0,4080,1820,342,3179,0
16,393,160,89,115,0,13,31,160,7,15,11,17,22,28,78,124,3,495,27,0,2,1,0,4080,1820,342,3180,0
16,393,10,10,9,9,0,0,19,0,0,0,0,0,0,0,0,0,0,0,0,2,1,0,4080,1820,343,3181,0
16,393,173,84,99,8,29,36,181,5,12,7,13,17,20,54,81,2,221,12,0,2,1,0,4080,1821,343,3182,0
16,393,3,1,1,3,0,0,6,0,0,0,0,0,0,0,0,0,0,0,0,2,1,0,4080,1821,343,3183,0
138,2382,1338,495,1086,10,64,173,1348,11,122,82,157,133,239,883,1686,7,11934,663,0,2,3,4,4080,1823,343,3184,0
37,416,757,253,292,73,244,162,830,13,61,38,67,74,105,409,651,7,4654,258,0,2,10,1,4080,1824,343,3185,0
44,1069,1043,504,840,53,9,147,1096,9,180,112,198,189,310,1377,2344,4,11604,644,0,2,2,3,4080,1826,343,3186,0
44,1069,383,288,292,26,6,62,409,11,65,38,67,76,105,429,656,5,3719,206,0,2,2,3,4080,1827,343,3187,0
13,274,127,75,83,2,11,30,129,4,14,7,14,18,21,61,87,2,175,9,0,2,2,1,4080,1827,343,3188,1
13,274,652,304,544,16,6,88,668,6,89,51,101,95,152,591,998,3,3399,188,0,2,2,1,4080,1828,343,3189,1
13,274,2,2,2,0,0,0,2,0,0,0,0,0,0,0,0,0,0,0,0,2,2,1,4080,1828,343,3189,1
13,274,8,5,5,0,0,3,8,0,0,0,0,0,0,0,0,0,0,0,0,2,2,1,4080,1828,343,3190,1
13,274,2,2,2,0,0,0,2,0,0,0,0,0,0,0,0,0,0,0,0,2,2,1,4080,1828,343,3190,1
13,274,14,8,8,0,0,6,14,0,0,0,0,0,0,0,0,0,0,0,0,2,2,1,4080,1828,343,3191,1
13,274,6,4,4,0,0,2,6,0,0,0,0,0,0,0,0,0,0,0,0,2,2,1,4080,1828,343,3192,1
13,274,6,4,4,0,0,2,6,1,2,1,2,3,3,2,4,0,2,0,0,2,2,1,4080,1828,343,3193,1
13,274,6,4,4,0,0,2,6,0,0,0,0,0,0,0,0,0,0,0,0,2,2,1,4080,1828,343,3194,1
13,274,7,5,5,0,0,2,7,0,0,0,0,0,0,0,0,0,0,0,0,2,2,1,4080,1828,343,3195,1
13,274,6,4,4,0,0,2,6,0,0,0,0,0,0,0,0,0,0,0,0,2,2,1,4080,1828,343,3196,1
13,274,10,6,6,0,0,4,10,0,0,0,0,0,0,0,0,0,0,0,0,2,2,1,4080,1828,343,3197,1
13,274,1,1,1,0,0,0,1,0,0,0,0,0,0,0,0,0,0,0,0,2,2,1,4080,1828,343,3197,1
13,274,14,10,10,0,0,4,14,1,1,1,1,2,2,0,2,0,1,0,0,2,2,1,4080,1828,343,3198,1
13,274,46,26,30,3,0,12,49,3,6,3,6,9,9,20,28,1,42,2,0,2,2,1,4090,1828,343,3199,1
37,418,757,253,292,73,244,162,830,13,61,38,67,74,105,409,651,7,4654,258,0,2,1,1,4090,1829,343,3200,1
37,416,757,253,292,73,244,162,830,13,61,38,67,74,105,409,651,7,4654,258,0,2,1,1,4090,1830,343,3201,0
33,376,757,253,292,73,244,162,830,13,61,38,67,74,105,409,651,7,4654,258,0,2,0,12,4100,1835,344,3209,1
34,385,757,253,292,73,244,162,830,13,61,38,67,74,105,409,651,7,4654,258,0,2,31,26,4100,1836,344,3210,1
44,1069,1043,504,840,53,9,147,1096,9,180,112,198,189,310,1377,2344,4,11604,644,0,2,1,0,4100,1838,344,3211,1
44,1069,383,288,292,26,6,62,409,11,65,38,67,76,105,429,656,5,3719,206,0,2,1,0,4100,1839,344,3212,1
42,733,373,158,315,8,0,51,381,5,76,44,79,81,123,486,779,2,2026,112,0,2,5,6,4100,1839,344,3213,1
6,419,1043,504,840,53,9,147,1096,9,180,112,198,189,310,1377,2344,4,11604,644,0,2,6,6,4100,1841,344,3214,1
23,1002,373,158,315,8,0,51,381,5,76,44,79,81,123,486,779,2,2026,112,0,2,3,3,4100,1841,344,3215,1
33,376,757,253,292,73,244,162,830,13,61,38,67,74,105,409,651,7,4654,258,0,2,7,13,4100,1842,344,3216,0
42,734,373,158,315,8,0,51,381,5,76,44,79,81,123,486,779,2,2026,112,0,2,5,4,4100,1842,344,3217,0
33,376,757,253,292,73,244,162,830,13,61,38,67,74,105,409,651,7,4654,258,0,2,8,9,4100,1843,344,3218,1
42,736,373,158,315,8,0,51,381,5,76,44,79,81,123,486,779,2,2026,112,0,2,1,1,4100,1843,344,3219,1
88,1958,1457,730,1242,11,6,188,1468,10,292,166,329,302,495,2424,4078,5,22973,1276,1,2,1,1,4100,1845,344,3220,1
88,1958,74,35,59,1,0,14,75,3,14,7,14,17,21,58,85,1,128,7,0,2,1,1,4100,1846,344,3221,1
88,1958,245,125,200,5,7,34,250,7,30,17,34,37,51,166,265,3,1053,58,0,2,1,1,4110,1847,344,3222,1
31,347,757,253,292,73,244,162,830,13,61,38,67,74,105,409,651,7,4654,258,0,2,3,13,4110,1848,344,3223,1
15,369,386,256,301,16,9,68,402,4,59,35,69,63,104,355,621,2,1453,80,0,2,1,1,4110,1848,344,3224,0
15,369,264,131,164,11,41,46,275,6,38,22,40,44,62,214,338,3,1068,59,0,2,1,1,4120,1848,345,3225,0
88,1960,1457,730,1242,11,6,188,1468,10,292,166,329,302,495,2424,4078,5,22973,1276,1,2,1,1,4120,1850,345,3226,0
88,1960,74,35,59,1,0,14,75,3,14,7,14,17,21,58,85,1,128,7,0,2,1,1,4120,1851,345,3227,0
88,1960,245,125,200,5,7,34,250,7,30,17,34,37,51,166,265,3,1053,58,0,2,1,1,4130,1852,345,3228,0
31,347,757,253,292,73,244,162,830,13,61,38,67,74,105,409,651,7,4654,258,0,2,2,1,4130,1853,345,3229,0
31,347,757,253,292,73,244,162,830,13,61,38,67,74,105,409,651,7,4654,258,0,2,32,25,4130,1854,345,3230,0
15,369,386,256,301,16,9,68,402,4,59,35,69,63,104,355,621,2,1453,80,0,2,4,4,4140,1858,346,3238,1
15,369,264,131,164,11,41,46,275,6,38,22,40,44,62,214,338,3,1068,59,0,2,4,4,4150,1858,347,3239,1
138,2382,1338,495,1086,10,64,173,1348,11,122,82,157,133,239,883,1686,7,11934,663,0,2,1,1,4150,1860,347,3240,1
88,1953,1457,730,1242,11,6,188,1468,10,292,166,329,302,495,2424,4078,5,22973,1276,1,2,11,12,4150,1862,347,3241,1
88,1953,74,35,59,1,0,14,75,3,14,7,14,17,21,58,85,1,128,7,0,2,11,12,4150,1863,347,3242,1
88,1953,245,125,200,5,7,34,250,7,30,17,34,37,51,166,265,3,1053,58,0,2,11,12,4160,1864,347,3243,1
42,736,373,158,315,8,0,51,381,5,76,44,79,81,123,486,779,2,2026,112,0,2,5,5,4160,1864,347,3244,1
42,2286,1457,730,1242,11,6,188,1468,10,292,166,329,302,495,2424,4078,5,22973,1276,1,2,1,1,4160,1866,347,3245,1
42,905,384,251,317,7,8,52,391,11,70,44,84,81,128,467,811,6,5355,297,0,3,8,2,4170,1870,348,3253,0
33,1623,384,251,317,7,8,52,391,11,70,44,84,81,128,467,811,6,5355,297,0,3,3,3,4170,1870,348,3254,0
42,906,384,251,317,7,8,52,391,11,70,44,84,81,128,467,811,6,5355,297,0,2,9,9,4170,1870,348,3255,1
31,347,757,253,292,73,244,162,830,13,61,38,67,74,105,409,651,7,4654,258,0,2,27,15,4170,1871,348,3256,1
42,924,384,251,317,7,8,52,391,11,70,44,84,81,128,467,811,6,5355,297,0,2,5,1,4170,1871,348,3257,1
33,1629,384,251,317,7,8,52,391,11,70,44,84,81,128,467,811,6,5355,297,0,2,49,49,4170,1871,348,3258,1
88,1953,1457,730,1242,11,6,188,1468,10,292,166,329,302,495,2424,4078,5,22973,1276,1,2,3,1,4170,1873,348,3259,1
88,1953,74,35,59,1,0,14,75,3,14,7,14,17,21,58,85,1,128,7,0,2,3,1,4170,1874,348,3260,1
88,1953,245,125,200,5,7,34,250,7,30,17,34,37,51,166,265,3,1053,58,0,2,3,1,4180,1875,348,3261,1
42,2286,1457,730,1242,11,6,188,1468,10,292,166,329,302,495,2424,4078,5,22973,1276,1,2,1,1,4180,1877,348,3262,1
138,2380,1338,495,1086,10,64,173,1348,11,122,82,157,133,239,883,1686,7,11934,663,0,2,1,2,4180,1879,348,3263,1
31,352,757,253,292,73,244,162,830,13,61,38,67,74,105,409,651,7,4654,258,0,2,1,0,4180,1880,348,3264,1
42,944,384,251,317,7,8,52,391,11,70,44,84,81,128,467,811,6,5355,297,0,2,8,8,4180,1880,348,3265,1
30,1516,384,251,317,7,8,52,391,11,70,44,84,81,128,467,811,6,5355,297,0,2,1,18,4180,1880,348,3266,1
138,2382,1338,495,1086,10,64,173,1348,11,122,82,157,133,239,883,1686,7,11934,663,0,2,3,4,4190,1886,349,3274,0
88,1947,1457,730,1242,11,6,188,1468,10,292,166,329,302,495,2424,4078,5,22973,1276,1,2,1,2,4190,1888,349,3275,0
88,1947,74,35,59,1,0,14,75,3,14,7,14,17,21,58,85,1,128,7,0,2,1,2,4190,1889,349,3276,0
88,1947,245,125,200,5,7,34,250,7,30,17,34,37,51,166,265,3,1053,58,0,2,1,2,4200,1890,349,3277,0
138,2382,1338,495,1086,10,64,173,1348,11,122,82,157,133,239,883,1686,7,11934,663,0,2,3,3,4210,1896,350,3285,0
88,1947,1457,730,1242,11,6,188,1468,10,292,166,329,302,495,2424,4078,5,22973,1276,1,2,1,1,4210,1898,350,3286,0
88,1947,74,35,59,1,0,14,75,3,14,7,14,17,21,58,85,1,128,7,0,2,1,1,4210,1899,350,3287,0
88,1947,245,125,200,5,7,34,250,7,30,17,34,37,51,166,265,3,1053,58,0,2,1,1,4220,1900,350,3288,0
20,481,2,2,2,0,0,0,2,0,0,0,0,0,0,0,0,0,0,0,0,2,131,40,4220,1900,350,3288,1
20,481,99,48,90,1,3,5,100,0,0,0,0,0,0,0,0,0,0,0,0,2,131,40,4220,1901,350,3289,1
20,481,8,5,5,2,0,1,10,0,0,0,0,0,0,0,0,0,0,0,0,2,131,40,4220,1901,350,3290,1
20,481,1217,716,841,84,126,174,1301,14,185,118,215,199,333,1446,2542,8,20687,1149,0,2,131,40,4230,1903,350,3291,1
20,481,160,89,115,0,13,31,160,7,15,11,17,22,28,78,124,3,495,27,0,2,131,40,4230,1903,350,3292,1
20,481,10,10,9,9,0,0,19,0,0,0,0,0,0,0,0,0,0,0,0,2,131,40,4230,1903,351,3293,1
20,481,173,84,99,8,29,36,181,5,12,7,13,17,20,54,81,2,221,12,0,2,131,40,4230,1904,351,3294,1
20,481,3,1,1,3,0,0,6,0,0,0,0,0,0,0,0,0,0,0,0,2,131,40,4230,1904,351,3295,1
45,1292,2,2,2,0,0,0,2,0,0,0,0,0,0,0,0,0,0,0,0,2,4,2,4230,1904,351,3295,0
45,1292,99,48,90,1,3,5,100,0,0,0,0,0,0,0,0,0,0,0,0,2,4,2,4230,1905,351,3296,0
45,1292,8,5,5,2,0,1,10,0,0,0,0,0,0,0,0,0,0,0,0,2,4,2,4230,1905,351,3297,0
45,1292,1217,716,841,84,126,174,1301,14,185,118,215,199,333,1446,2542,8,20687,1149,0,2,4,2,4240,1907,351,3298,0
45,1292,160,89,115,0,13,31,160,7,15,11,17,22,28,78,124,3,495,27,0,2,4,2,4240,1907,351,3299,0
45,1292,10,10,9,9,0,0,19,0,0,0,0,0,0,0,0,0,0,0,0,2,4,2,4240,1907,352,3300,0
45,1292,173,84,99,8,29,36,181,5,12,7,13,17,20,54,81,2,221,12,0,2,4,2,4240,1908,352,3301,0
45,1292,3,1,1,3,0,0,6,0,0,0,0,0,0,0,0,0,0,0,0,2,4,2,4240,1908,352,3302,0
1,312,42,7,35,4,0,5,46,1,2,1,2,3,3,2,4,0,2,0,0,2,12,14,4250,1912,353,3310,1
1,312,11,6,10,0,0,1,11,2,4,2,4,6,6,10,15,1,15,0,0,2,12,14,4250,1912,353,3311,1
27,522,334,251,279,10,4,40,344,5,127,74,143,132,217,899,1528,2,4303,239,0,2,2,2,4250,1913,353,3312,0
14,695,334,251,279,10,4,40,344,5,127,74,143,132,217,899,1528,2,4303,239,0,2,9,1,4250,1914,353,3313,0
2,32,127,75,83,2,11,30,129,4,14,7,14,18,21,61,87,2,175,9,0,0,10,0,4270,1920,355,3334,1
2,32,652,304,544,16,6,88,668,6,89,51,101,95,152,591,998,3,3399,188,0,0,10,0,4270,1921,355,3335,1
2,32,2,2,2,0,0,0,2,0,0,0,0,0,0,0,0,0,0,0,0,0,10,0,4270,1921,355,3335,1
2,32,8,5,5,0,0,3,8,0,0,0,0,0,0,0,0,0,0,0,0,0,10,0,4270,1921,355,3336,1
2,32,2,2,2,0,0,0,2,0,0,0,0,0,0,0,0,0,0,0,0,0,10,0,4270,1921,355,3336,1
2,32,14,8,8,0,0,6,14,0,0,0,0,0,0,0,0,0,0,0,0,0,10,0,4270,1921,355,3337,1
2,32,6,4,4,0,0,2,6,0,0,0,0,0,0,0,0,0,0,0,0,0,10,0,4270,1921,355,3338,1
2,32,6,4,4,0,0,2,6,1,2,1,2,3,3,2,4,0,2,0,0,0,10,0,4270,1921,355,3339,1
2,32,6,4,4,0,0,2,6,0,0,0,0,0,0,0,0,0,0,0,0,0,10,0,4270,1921,355,3340,1
2,32,7,5,5,0,0,2,7,0,0,0,0,0,0,0,0,0,0,0,0,0,10,0,4270,1921,355,3341,1
2,32,6,4,4,0,0,2,6,0,0,0,0,0,0,0,0,0,0,0,0,0,10,0,4270,1921,355,3342,1
2,32,10,6,6,0,0,4,10,0,0,0,0,0,0,0,0,0,0,0,0,0,10,0,4270,1921,355,3343,1
2,32,1,1,1,0,0,0,1,0,0,0,0,0,0,0,0,0,0,0,0,0,10,0,4270,1921,355,3343,1
2,32,14,10,10,0,0,4,14,1,1,1,1,2,2,0,2,0,1,0,0,0,10,0,4270,1921,355,3344,1
2,32,46,26,30,3,0,12,49,3,6,3,6,9,9,20,28,1,42,2,0,0,10,0,4280,1921,355,3345,1
42,953,384,251,317,7,8,52,391,11,70,44,84,81,128,467,811,6,5355,297,0,2,2,2,4280,1921,355,3346,1
13,274,127,75,83,2,11,30,129,4,14,7,14,18,21,61,87,2,175,9,0,2,4,4,4280,1921,355,3347,1
13,274,652,304,544,16,6,88,668,6,89,51,101,95,152,591,998,3,3399,188,0,2,4,4,4280,1922,355,3348,1
13,274,2,2,2,0,0,0,2,0,0,0,0,0,0,0,0,0,0,0,0,2,4,4,4280,1922,355,3348,1
13,274,8,5,5,0,0,3,8,0,0,0,0,0,0,0,0,0,0,0,0,2,4,4,4280,1922,355,3349,1
13,274,2,2,2,0,0,0,2,0,0,0,0,0,0,0,0,0,0,0,0,2,4,4,4280,1922,355,3349,1
13,274,14,8,8,0,0,6,14,0,0,0,0,0,0,0,0,0,0,0,0,2,4,4,4280,1922,355,3350,1
13,274,6,4,4,0,0,2,6,0,0,0,0,0,0,0,0,0,0,0,0,2,4,4,4280,1922,355,3351,1
13,274,6,4,4,0,0,2,6,1,2,1,2,3,3,2,4,0,2,0,0,2,4,4,4280,1922,355,3352,1
13,274,6,4,4,0,0,2,6,0,0,0,0,0,0,0,0,0,0,0,0,2,4,4,4280,1922,355,3353,1
13,274,7,5,5,0,0,2,7,0,0,0,0,0,0,0,0,0,0,0,0,2,4,4,4280,1922,355,3354,1
13,274,6,4,4,0,0,2,6,0,0,0,0,0,0,0,0,0,0,0,0,2,4,4,4280,1922,355,3355,1
13,274,10,6,6,0,0,4,10,0,0,0,0,0,0,0,0,0,0,0,0,2,4,4,4280,1922,355,3356,1
13,274,1,1,1,0,0,0,1,0,0,0,0,0,0,0,0,0,0,0,0,2,4,4,4280,1922,355,3356,1
13,274,14,10,10,0,0,4,14,1,1,1,1,2,2,0,2,0,1,0,0,2,4,4,4280,1922,355,3357,1
13,274,46,26,30,3,0,12,49,3,6,3,6,9,9,20,28,1,42,2,0,2,4,4,4290,1922,355,3358,1
42,955,384,251,317,7,8,52,391,11,70,44,84,81,128,467,811,6,5355,297,0,2,1,0,4290,1922,355,3359,1
2,32,127,75,83,2,11,30,129,4,14,7,14,18,21,61,87,2,175,9,0,0,10,0,4300,1923,355,3372,0
2,32,652,304,544,16,6,88,668,6,89,51,101,95,152,591,998,3,3399,188,0,0,10,0,4300,1924,355,3373,0
2,32,2,2,2,0,0,0,2,0,0,0,0,0,0,0,0,0,0,0,0,0,10,0,4300,1924,355,3373,0
2,32,8,5,5,0,0,3,8,0,0,0,0,0,0,0,0,0,0,0,0,0,10,0,4300,1924,355,3374,0
2,32,2,2,2,0,0,0,2,0,0,0,0,0,0,0,0,0,0,0,0,0,10,0,4300,1924,355,3374,0
2,32,14,8,8,0,0,6,14,0,0,0,0,0,0,0,0,0,0,0,0,0,10,0,4300,1924,355,3375,0
2,32,6,4,4,0,0,2,6,0,0,0,0,0,0,0,0,0,0,0,0,0,10,0,4300,1924,355,3376,0
2,32,6,4,4,0,0,2,6,1,2,1,2,3,3,2,4,0,2,0,0,0,10,0,4300,1924,355,3377,0
2,32,6,4,4,0,0,2,6,0,0,0,0,0,0,0,0,0,0,0,0,0,10,0,4300,1924,355,3378,0
2,32,7,5,5,0,0,2,7,0,0,0,0,0,0,0,0,0,0,0,0,0,10,0,4300,1924,355,3379,0
2,32,6,4,4,0,0,2,6,0,0,0,0,0,0,0,0,0,0,0,0,0,10,0,4300,1924,355,3380,0
2,32,10,6,6,0,0,4,10,0,0,0,0,0,0,0,0,0,0,0,0,0,10,0,4300,1924,355,3381,0
2,32,1,1,1,0,0,0,1,0,0,0,0,0,0,0,0,0,0,0,0,0,10,0,4300,1924,355,3381,0
2,32,14,10,10,0,0,4,14,1,1,1,1,2,2,0,2,0,1,0,0,0,10,0,4300,1924,355,3382,0
2,32,46,26,30,3,0,12,49,3,6,3,6,9,9,20,28,1,42,2,0,0,10,0,4310,1924,355,3383,0
13,274,127,75,83,2,11,30,129,4,14,7,14,18,21,61,87,2,175,9,0,2,4,4,4310,1924,355,3384,0
13,274,652,304,544,16,6,88,668,6,89,51,101,95,152,591,998,3,3399,188,0,2,4,4,4310,1925,355,3385,0
13,274,2,2,2,0,0,0,2,0,0,0,0,0,0,0,0,0,0,0,0,2,4,4,4310,1925,355,3385,0
13,274,8,5,5,0,0,3,8,0,0,0,0,0,0,0,0,0,0,0,0,2,4,4,4310,1925,355,3386,0
13,274,2,2,2,0,0,0,2,0,0,0,0,0,0,0,0,0,0,0,0,2,4,4,4310,1925,355,3386,0
13,274,14,8,8,0,0,6,14,0,0,0,0,0,0,0,0,0,0,0,0,2,4,4,4310,1925,355,3387,0
13,274,6,4,4,0,0,2,6,0,0,0,0,0,0,0,0,0,0,0,0,2,4,4,4310,1925,355,3388,0
13,274,6,4,4,0,0,2,6,1,2,1,2,3,3,2,4,0,2,0,0,2,4,4,4310,1925,355,3389,0
13,274,6,4,4,0,0,2,6,0,0,0,0,0,0,0,0,0,0,0,0,2,4,4,4310,1925,355,3390,0
13,274,7,5,5,0,0,2,7,0,0,0,0,0,0,0,0,0,0,0,0,2,4,4,4310,1925,355,3391,0
13,274,6,4,4,0,0,2,6,0,0,0,0,0,0,0,0,0,0,0,0,2,4,4,4310,1925,355,3392,0
13,274,10,6,6,0,0,4,10,0,0,0,0,0,0,0,0,0,0,0,0,2,4,4,4310,1925,355,3393,0
13,274,1,1,1,0,0,0,1,0,0,0,0,0,0,0,0,0,0,0,0,2,4,4,4310,1925,355,3393,0
13,274,14,10,10,0,0,4,14,1,1,1,1,2,2,0,2,0,1,0,0,2,4,4,4310,1925,355,3394,0
13,274,46,26,30,3,0,12,49,3,6,3,6,9,9,20,28,1,42,2,0,2,4,4,4320,1925,355,3395,0
42,955,384,251,317,7,8,52,391,11,70,44,84,81,128,467,811,6,5355,297,0,2,3,2,4320,1925,355,3396,0
1,312,42,7,35,4,0,5,46,1,2,1,2,3,3,2,4,0,2,0,0,2,1,1,4330,1926,355,3409,0
1,312,11,6,10,0,0,1,11,2,4,2,4,6,6,10,15,1,15,0,0,2,1,1,4330,1926,355,3410,0
1,312,42,7,35,4,0,5,46,1,2,1,2,3,3,2,4,0,2,0,0,2,1,1,4330,1926,355,3411,1
1,312,11,6,10,0,0,1,11,2,4,2,4,6,6,10,15,1,15,0,0,2,1,1,4330,1926,355,3412,1
30,339,757,253,292,73,244,162,830,13,61,38,67,74,105,409,651,7,4654,258,0,2,0,3,4330,1927,355,3413,0
30,339,757,253,292,73,244,162,830,13,61,38,67,74,105,409,651,7,4654,258,0,2,0,3,4330,1928,355,3414,0
44,1063,1043,504,840,53,9,147,1096,9,180,112,198,189,310,1377,2344,4,11604,644,0,2,0,2,4330,1930,355,3415,0
44,1063,383,288,292,26,6,62,409,11,65,38,67,76,105,429,656,5,3719,206,0,2,0,2,4330,1931,355,3416,0
30,344,757,253,292,73,244,162,830,13,61,38,67,74,105,409,651,7,4654,258,0,2,1,0,4330,1932,355,3417,0
18,462,2,2,2,0,0,0,2,0,0,0,0,0,0,0,0,0,0,0,0,2,7,12,4330,1932,355,3417,0
18,462,99,48,90,1,3,5,100,0,0,0,0,0,0,0,0,0,0,0,0,2,7,12,4330,1933,355,3418,0
18,462,8,5,5,2,0,1,10,0,0,0,0,0,0,0,0,0,0,0,0,2,7,12,4330,1933,355,3419,0
18,462,1217,716,841,84,126,174,1301,14,185,118,215,199,333,1446,2542,8,20687,1149,0,2,7,12,4340,1935,355,3420,0
18,462,160,89,115,0,13,31,160,7,15,11,17,22,28,78,124,3,495,27,0,2,7,12,4340,1935,355,3421,0
18,462,10,10,9,9,0,0,19,0,0,0,0,0,0,0,0,0,0,0,0,2,7,12,4340,1935,356,3422,0
18,462,173,84,99,8,29,36,181,5,12,7,13,17,20,54,81,2,221,12,0,2,7,12,4340,1936,356,3423,0
18,462,3,1,1,3,0,0,6,0,0,0,0,0,0,0,0,0,0,0,0,2,7,12,4340,1936,356,3424,0
88,1955,1457,730,1242,11,6,188,1468,10,292,166,329,302,495,2424,4078,5,22973,1276,1,2,1,0,4340,1938,356,3425,1
88,1955,74,35,59,1,0,14,75,3,14,7,14,17,21,58,85,1,128,7,0,2,1,0,4340,1939,356,3426,1
88,1955,245,125,200,5,7,34,250,7,30,17,34,37,51,166,265,3,1053,58,0,2,1,0,4350,1940,356,3427,1
45,990,384,251,317,7,8,52,391,11,70,44,84,81,128,467,811,6,5355,297,0,2,5,0,4350,1940,356,3428,1
34,1864,1289,550,1043,56,32,155,1345,10,167,93,185,177,278,1266,2075,5,11498,638,0,2,17,0,4350,1942,357,3429,1
31,1539,384,251,317,7,8,52,391,11,70,44,84,81,128,467,811,6,5355,297,0,2,6,0,4350,1942,357,3430,1
7,97,127,75,83,2,11,30,129,4,14,7,14,18,21,61,87,2,175,9,0,0,22,0,4350,1942,357,3431,1
7,97,652,304,544,16,6,88,668,6,89,51,101,95,152,591,998,3,3399,188,0,0,22,0,4350,1943,357,3432,1
7,97,2,2,2,0,0,0,2,0,0,0,0,0,0,0,0,0,0,0,0,0,22,0,4350,1943,357,3432,1
7,97,8,5,5,0,0,3,8,0,0,0,0,0,0,0,0,0,0,0,0,0,22,0,4350,1943,357,3433,1
7,97,2,2,2,0,0,0,2,0,0,0,0,0,0,0,0,0,0,0,0,0,22,0,4350,1943,357,3433,1
7,97,14,8,8,0,0,6,14,0,0,0,0,0,0,0,0,0,0,0,0,0,22,0,4350,1943,357,3434,1
7,97,6,4,4,0,0,2,6,0,0,0,0,0,0,0,0,0,0,0,0,0,22,0,4350,1943,357,3435,1
7,97,6,4,4,0,0,2,6,1,2,1,2,3,3,2,4,0,2,0,0,0,22,0,4350,1943,357,3436,1
7,97,6,4,4,0,0,2,6,0,0,0,0,0,0,0,0,0,0,0,0,0,22,0,4350,1943,357,3437,1
7,97,7,5,5,0,0,2,7,0,0,0,0,0,0,0,0,0,0,0,0,0,22,0,4350,1943,357,3438,1
7,97,6,4,4,0,0,2,6,0,0,0,0,0,0,0,0,0,0,0,0,0,22,0,4350,1943,357,3439,1
7,97,10,6,6,0,0,4,10,0,0,0,0,0,0,0,0,0,0,0,0,0,22,0,4350,1943,357,3440,1
7,97,1,1,1,0,0,0,1,0,0,0,0,0,0,0,0,0,0,0,0,0,22,0,4350,1943,357,3440,1
7,97,14,10,10,0,0,4,14,1,1,1,1,2,2,0,2,0,1,0,0,0,22,0,4350,1943,357,3441,1
7,97,46,26,30,3,0,12,49,3,6,3,6,9,9,20,28,1,42,2,0,0,22,0,4360,1943,357,3442,1
138,2407,1338,495,1086,10,64,173,1348,11,122,82,157,133,239,883,1686,7,11934,663,0,2,10,11,4370,1946,357,3455,1
123,2176,1338,495,1086,10,64,173,1348,11,122,82,157,133,239,883,1686,7,11934,663,0,2,6,42,4370,1948,357,3456,1
45,1069,1043,504,840,53,9,147,1096,9,180,112,198,189,310,1377,2344,4,11604,644,0,2,2,1,4370,1950,357,3457,0
45,1069,383,288,292,26,6,62,409,11,65,38,67,76,105,429,656,5,3719,206,0,2,2,1,4370,1951,357,3458,0
13,269,127,75,83,2,11,30,129,4,14,7,14,18,21,61,87,2,175,9,0,2,0,1,4370,1951,357,3459,0
13,269,652,304,544,16,6,88,668,6,89,51,101,95,152,591,998,3,3399,188,0,2,0,1,4370,1952,357,3460,0
13,269,2,2,2,0,0,0,2,0,0,0,0,0,0,0,0,0,0,0,0,2,0,1,4370,1952,357,3460,0
13,269,8,5,5,0,0,3,8,0,0,0,0,0,0,0,0,0,0,0,0,2,0,1,4370,1952,357,3461,0
13,269,2,2,2,0,0,0,2,0,0,0,0,0,0,0,0,0,0,0,0,2,0,1,4370,1952,357,3461,0
13,269,14,8,8,0,0,6,14,0,0,0,0,0,0,0,0,0,0,0,0,2,0,1,4370,1952,357,3462,0
13,269,6,4,4,0,0,2,6,0,0,0,0,0,0,0,0,0,0,0,0,2,0,1,4370,1952,357,3463,0
13,269,6,4,4,0,0,2,6,1,2,1,2,3,3,2,4,0,2,0,0,2,0,1,4370,1952,357,3464,0
13,269,6,4,4,0,0,2,6,0,0,0,0,0,0,0,0,0,0,0,0,2,0,1,4370,1952,357,3465,0
13,269,7,5,5,0,0,2,7,0,0,0,0,0,0,0,0,0,0,0,0,2,0,1,4370,1952,357,3466,0
13,269,6,4,4,0,0,2,6,0,0,0,0,0,0,0,0,0,0,0,0,2,0,1,4370,1952,357,3467,0
13,269,10,6,6,0,0,4,10,0,0,0,0,0,0,0,0,0,0,0,0,2,0,1,4370,1952,357,3468,0
13,269,1,1,1,0,0,0,1,0,0,0,0,0,0,0,0,0,0,0,0,2,0,1,4370,1952,357,3468,0
13,269,14,10,10,0,0,4,14,1,1,1,1,2,2,0,2,0,1,0,0,2,0,1,4370,1952,357,3469,0
13,269,46,26,30,3,0,12,49,3,6,3,6,9,9,20,28,1,42,2,0,2,0,1,4380,1952,357,3470,0
30,1650,1289,550,1043,56,32,155,1345,10,167,93,185,177,278,1266,2075,5,11498,638,0,2,2,23,4380,1954,358,3471,1
124,2190,1338,495,1086,10,64,173,1348,11,122,82,157,133,239,883,1686,7,11934,663,0,2,2,0,4380,1956,358,3472,1
124,2190,1338,495,1086,10,64,173,1348,11,122,82,157,133,239,883,1686,7,11934,663,0,2,3,3,4390,1962,359,3480,1
88,1955,1457,730,1242,11,6,188,1468,10,292,166,329,302,495,2424,4078,5,22973,1276,1,2,2,2,4390,1964,359,3481,1
88,1955,74,35,59,1,0,14,75,3,14,7,14,17,21,58,85,1,128,7,0,2,2,2,4390,1965,359,3482,1
88,1955,245,125,200,5,7,34,250,7,30,17,34,37,51,166,265,3,1053,58,0,2,2,2,4400,1966,359,3483,1
45,990,384,251,317,7,8,52,391,11,70,44,84,81,128,467,811,6,5355,297,0,2,7,7,4400,1966,359,3484,1
45,1069,1043,504,840,53,9,147,1096,9,180,112,198,189,310,1377,2344,4,11604,644,0,2,1,1,4400,1968,359,3485,1
45,1069,383,288,292,26,6,62,409,11,65,38,67,76,105,429,656,5,3719,206,0,2,1,1,4400,1969,359,3486,1
42,736,373,158,315,8,0,51,381,5,76,44,79,81,123,486,779,2,2026,112,0,2,6,6,4400,1969,359,3487,1
31,1539,384,251,317,7,8,52,391,11,70,44,84,81,128,467,811,6,5355,297,0,2,1,1,4400,1969,359,3488,1
31,1517,384,251,317,7,8,52,391,11,70,44,84,81,128,467,811,6,5355,297,0,2,0,2,4410,1973,360,3496,1
30,344,757,253,292,73,244,162,830,13,61,38,67,74,105,409,651,7,4654,258,0,2,2,2,4410,1974,360,3497,0
31,353,757,253,292,73,244,162,830,13,61,38,67,74,105,409,651,7,4654,258,0,2,3,1,4410,1975,360,3498,1
31,353,757,253,292,73,244,162,830,13,61,38,67,74,105,409,651,7,4654,258,0,2,1,1,4410,1976,360,3499,1
75,1630,773,419,590,28,0,166,801,10,204,113,217,214,330,1598,2554,5,13587,754,0,2,20,0,4410,1976,361,3500,1
75,1630,421,273,302,44,34,57,465,17,81,59,107,98,166,583,1098,11,12329,684,0,2,20,0,4410,1976,362,3501,1
53,1808,773,419,590,28,0,166,801,10,204,113,217,214,330,1598,2554,5,13587,754,0,2,20,0,4410,1976,363,3502,1
54,1831,773,419,590,28,0,166,801,10,204,113,217,214,330,1598,2554,5,13587,754,0,2,6,2,4410,1976,364,3503,1
45,1069,1043,504,840,53,9,147,1096,9,180,112,198,189,310,1377,2344,4,11604,644,0,2,1,1,4420,1982,365,3511,0
45,1069,383,288,292,26,6,62,409,11,65,38,67,76,105,429,656,5,3719,206,0,2,1,1,4420,1983,365,3512,0
32,362,757,253,292,73,244,162,830,13,61,38,67,74,105,409,651,7,4654,258,0,2,5,0,4420,1984,365,3513,0
54,1827,773,419,590,28,0,166,801,10,204,113,217,214,330,1598,2554,5,13587,754,0,2,1,1,4420,1984,366,3514,0
124,2190,1338,495,1086,10,64,173,1348,11,122,82,157,133,239,883,1686,7,11934,663,0,2,1,1,4420,1986,366,3515,1
32,367,757,253,292,73,244,162,830,13,61,38,67,74,105,409,651,7,4654,258,0,2,6,5,4420,1987,366,3516,1
75,1630,773,419,590,28,0,166,801,10,204,113,217,214,330,1598,2554,5,13587,754,0,2,20,0,4430,1991,368,3524,0
75,1630,421,273,302,44,34,57,465,17,81,59,107,98,166,583,1098,11,12329,684,0,2,20,0,4430,1991,369,3525,0
54,1827,773,419,590,28,0,166,801,10,204,113,217,214,330,1598,2554,5,13587,754,0,2,24,0,4430,1991,370,3526,0
124,2190,1338,495,1086,10,64,173,1348,11,122,82,157,133,239,883,1686,7,11934,663,0,2,1,1,4430,1993,370,3527,0
32,367,757,253,292,73,244,162,830,13,61,38,67,74,105,409,651,7,4654,258,0,2,6,0,4430,1994,370,3528,0
45,1069,1043,504,840,53,9,147,1096,9,180,112,198,189,310,1377,2344,4,11604,644,0,2,1,1,4430,1996,370,3529,0
45,1069,383,288,292,26,6,62,409,11,65,38,67,76,105,429,656,5,3719,206,0,2,1,1,4430,1997,370,3530,0
32,367,757,253,292,73,244,162,830,13,61,38,67,74,105,409,651,7,4654,258,0,2,1,1,4430,1998,370,3531,1
7,97,127,75,83,2,11,30,129,4,14,7,14,18,21,61,87,2,175,9,0,3,2,2,4430,1998,370,3532,1
7,97,652,304,544,16,6,88,668,6,89,51,101,95,152,591,998,3,3399,188,0,3,2,2,4430,1999,370,3533,1
7,97,2,2,2,0,0,0,2,0,0,0,0,0,0,0,0,0,0,0,0,3,2,2,4430,1999,370,3533,1
7,97,8,5,5,0,0,3,8,0,0,0,0,0,0,0,0,0,0,0,0,3,2,2,4430,1999,370,3534,1
7,97,2,2,2,0,0,0,2,0,0,0,0,0,0,0,0,0,0,0,0,3,2,2,4430,1999,370,3534,1
7,97,14,8,8,0,0,6,14,0,0,0,0,0,0,0,0,0,0,0,0,3,2,2,4430,1999,370,3535,1
7,97,6,4,4,0,0,2,6,0,0,0,0,0,0,0,0,0,0,0,0,3,2,2,4430,1999,370,3536,1
7,97,6,4,4,0,0,2,6,1,2,1,2,3,3,2,4,0,2,0,0,3,2,2,4430,1999,370,3537,1
7,97,6,4,4,0,0,2,6,0,0,0,0,0,0,0,0,0,0,0,0,3,2,2,4430,1999,370,3538,1
7,97,7,5,5,0,0,2,7,0,0,0,0,0,0,0,0,0,0,0,0,3,2,2,4430,1999,370,3539,1
7,97,6,4,4,0,0,2,6,0,0,0,0,0,0,0,0,0,0,0,0,3,2,2,4430,1999,370,3540,1
7,97,10,6,6,0,0,4,10,0,0,0,0,0,0,0,0,0,0,0,0,3,2,2,4430,1999,370,3541,1
7,97,1,1,1,0,0,0,1,0,0,0,0,0,0,0,0,0,0,0,0,3,2,2,4430,1999,370,3541,1
7,97,14,10,10,0,0,4,14,1,1,1,1,2,2,0,2,0,1,0,0,3,2,2,4430,1999,370,3542,1
7,97,46,26,30,3,0,12,49,3,6,3,6,9,9,20,28,1,42,2,0,3,2,2,4440,1999,370,3543,1
3,48,127,75,83,2,11,30,129,4,14,7,14,18,21,61,87,2,175,9,0,2,3,1,4450,2003,371,3551,1
3,48,652,304,544,16,6,88,668,6,89,51,101,95,152,591,998,3,3399,188,0,2,3,1,4450,2004,371,3552,1
3,48,2,2,2,0,0,0,2,0,0,0,0,0,0,0,0,0,0,0,0,2,3,1,4450,2004,371,3552,1
3,48,8,5,5,0,0,3,8,0,0,0,0,0,0,0,0,0,0,0,0,2,3,1,4450,2004,371,3553,1
3,48,2,2,2,0,0,0,2,0,0,0,0,0,0,0,0,0,0,0,0,2,3,1,4450,2004,371,3553,1
3,48,14,8,8,0,0,6,14,0,0,0,0,0,0,0,0,0,0,0,0,2,3,1,4450,2004,371,3554,1
3,48,6,4,4,0,0,2,6,0,0,0,0,0,0,0,0,0,0,0,0,2,3,1,4450,2004,371,3555,1
3,48,6,4,4,0,0,2,6,1,2,1,2,3,3,2,4,0,2,0,0,2,3,1,4450,2004,371,3556,1
3,48,6,4,4,0,0,2,6,0,0,0,0,0,0,0,0,0,0,0,0,2,3,1,4450,2004,371,3557,1
3,48,7,5,5,0,0,2,7,0,0,0,0,0,0,0,0,0,0,0,0,2,3,1,4450,2004,371,3558,1
3,48,6,4,4,0,0,2,6,0,0,0,0,0,0,0,0,0,0,0,0,2,3,1,4450,2004,371,3559,1
3,48,10,6,6,0,0,4,10,0,0,0,0,0,0,0,0,0,0,0,0,2,3,1,4450,2004,371,3560,1
3,48,1,1,1,0,0,0,1,0,0,0,0,0,0,0,0,0,0,0,0,2,3,1,4450,2004,371,3560,1
3,48,14,10,10,0,0,4,14,1,1,1,1,2,2,0,2,0,1,0,0,2,3,1,4450,2004,371,3561,1
3,48,46,26,30,3,0,12,49,3,6,3,6,9,9,20,28,1,42,2,0,2,3,1,4460,2004,371,3562,1
6,113,127,75,83,2,11,30,129,4,14,7,14,18,21,61,87,2,175,9,0,0,25,0,4470,2008,372,3570,1
6,113,652,304,544,16,6,88,668,6,89,51,101,95,152,591,998,3,3399,188,0,0,25,0,4470,2009,372,3571,1
6,113,2,2,2,0,0,0,2,0,0,0,0,0,0,0,0,0,0,0,0,0,25,0,4470,2009,372,3571,1
6,113,8,5,5,0,0,3,8,0,0,0,0,0,0,0,0,0,0,0,0,0,25,0,4470,2009,372,3572,1
6,113,2,2,2,0,0,0,2,0,0,0,0,0,0,0,0,0,0,0,0,0,25,0,4470,2009,372,3572,1
6,113,14,8,8,0,0,6,14,0,0,0,0,0,0,0,0,0,0,0,0,0,25,0,4470,2009,372,3573,1
6,113,6,4,4,0,0,2,6,0,0,0,0,0,0,0,0,0,0,0,0,0,25,0,4470,2009,372,3574,1
6,113,6,4,4,0,0,2,6,1,2,1,2,3,3,2,4,0,2,0,0,0,25,0,4470,2009,372,3575,1
6,113,6,4,4,0,0,2,6,0,0,0,0,0,0,0,0,0,0,0,0,0,25,0,4470,2009,372,3576,1
6,113,7,5,5,0,0,2,7,0,0,0,0,0,0,0,0,0,0,0,0,0,25,0,4470,2009,372,3577,1
6,113,6,4,4,0,0,2,6,0,0,0,0,0,0,0,0,0,0,0,0,0,25,0,4470,2009,372,3578,1
6,113,10,6,6,0,0,4,10,0,0,0,0,0,0,0,0,0,0,0,0,0,25,0,4470,2009,372,3579,1
6,113,1,1,1,0,0,0,1,0,0,0,0,0,0,0,0,0,0,0,0,0,25,0,4470,2009,372,3579,1
6,113,14,10,10,0,0,4,14,1,1,1,1,2,2,0,2,0,1,0,0,0,25,0,4470,2009,372,3580,1
6,113,46,26,30,3,0,12,49,3,6,3,6,9,9,20,28,1,42,2,0,0,25,0,4480,2009,372,3581,1
2,32,127,75,83,2,11,30,129,4,14,7,14,18,21,61,87,2,175,9,0,2,1,3,4480,2009,372,3582,1
2,32,652,304,544,16,6,88,668,6,89,51,101,95,152,591,998,3,3399,188,0,2,1,3,4480,2010,372,3583,1
2,32,2,2,2,0,0,0,2,0,0,0,0,0,0,0,0,0,0,0,0,2,1,3,4480,2010,372,3583,1
2,32,8,5,5,0,0,3,8,0,0,0,0,0,0,0,0,0,0,0,0,2,1,3,4480,2010,372,3584,1
2,32,2,2,2,0,0,0,2,0,0,0,0,0,0,0,0,0,0,0,0,2,1,3,4480,2010,372,3584,1
2,32,14,8,8,0,0,6,14,0,0,0,0,0,0,0,0,0,0,0,0,2,1,3,4480,2010,372,3585,1
2,32,6,4,4,0,0,2,6,0,0,0,0,0,0,0,0,0,0,0,0,2,1,3,4480,2010,372,3586,1
2,32,6,4,4,0,0,2,6,1,2,1,2,3,3,2,4,0,2,0,0,2,1,3,4480,2010,372,3587,1
2,32,6,4,4,0,0,2,6,0,0,0,0,0,0,0,0,0,0,0,0,2,1,3,4480,2010,372,3588,1
2,32,7,5,5,0,0,2,7,0,0,0,0,0,0,0,0,0,0,0,0,2,1,3,4480,2010,372,3589,1
2,32,6,4,4,0,0,2,6,0,0,0,0,0,0,0,0,0,0,0,0,2,1,3,4480,2010,372,3590,1
2,32,10,6,6,0,0,4,10,0,0,0,0,0,0,0,0,0,0,0,0,2,1,3,4480,2010,372,3591,1
2,32,1,1,1,0,0,0,1,0,0,0,0,0,0,0,0,0,0,0,0,2,1,3,4480,2010,372,3591,1
2,32,14,10,10,0,0,4,14,1,1,1,1,2,2,0,2,0,1,0,0,2,1,3,4480,2010,372,3592,1
2,32,46,26,30,3,0,12,49,3,6,3,6,9,9,20,28,1,42,2,0,2,1,3,4490,2010,372,3593,1
49,1165,1043,504,840,53,9,147,1096,9,180,112,198,189,310,1377,2344,4,11604,644,0,2,19,3,4490,2012,372,3594,1
49,1165,383,288,292,26,6,62,409,11,65,38,67,76,105,429,656,5,3719,206,0,2,19,3,4490,2013,372,3595,1
7,469,1043,504,840,53,9,147,1096,9,180,112,198,189,310,1377,2344,4,11604,644,0,2,10,0,4490,2015,372,3596,1
13,257,127,75,83,2,11,30,129,4,14,7,14,18,21,61,87,2,175,9,0,2,15,17,4490,2015,372,3597,1
13,257,652,304,544,16,6,88,668,6,89,51,101,95,152,591,998,3,3399,188,0,2,15,17,4490,2016,372,3598,1
13,257,2,2,2,0,0,0,2,0,0,0,0,0,0,0,0,0,0,0,0,2,15,17,4490,2016,372,3598,1
13,257,8,5,5,0,0,3,8,0,0,0,0,0,0,0,0,0,0,0,0,2,15,17,4490,2016,372,3599,1
13,257,2,2,2,0,0,0,2,0,0,0,0,0,0,0,0,0,0,0,0,2,15,17,4490,2016,372,3599,1
13,257,14,8,8,0,0,6,14,0,0,0,0,0,0,0,0,0,0,0,0,2,15,17,4490,2016,372,3600,1
13,257,6,4,4,0,0,2,6,0,0,0,0,0,0,0,0,0,0,0,0,2,15,17,4490,2016,372,3601,1
13,257,6,4,4,0,0,2,6,1,2,1,2,3,3,2,4,0,2,0,0,2,15,17,4490,2016,372,3602,1
13,257,6,4,4,0,0,2,6,0,0,0,0,0,0,0,0,0,0,0,0,2,15,17,4490,2016,372,3603,1
13,257,7,5,5,0,0,2,7,0,0,0,0,0,0,0,0,0,0,0,0,2,15,17,4490,2016,372,3604,1
13,257,6,4,4,0,0,2,6,0,0,0,0,0,0,0,0,0,0,0,0,2,15,17,4490,2016,372,3605,1
13,257,10,6,6,0,0,4,10,0,0,0,0,0,0,0,0,0,0,0,0,2,15,17,4490,2016,372,3606,1
13,257,1,1,1,0,0,0,1,0,0,0,0,0,0,0,0,0,0,0,0,2,15,17,4490,2016,372,3606,1
13,257,14,10,10,0,0,4,14,1,1,1,1,2,2,0,2,0,1,0,0,2,15,17,4490,2016,372,3607,1
13,257,46,26,30,3,0,12,49,3,6,3,6,9,9,20,28,1,42,2,0,2,15,17,4500,2016,372,3608,1
5,100,127,75,83,2,11,30,129,4,14,7,14,18,21,61,87,2,175,9,0,2,19,5,4500,2016,372,3609,1
5,100,652,304,544,16,6,88,668,6,89,51,101,95,152,591,998,3,3399,188,0,2,19,5,4500,2017,372,3610,1
5,100,2,2,2,0,0,0,2,0,0,0,0,0,0,0,0,0,0,0,0,2,19,5,4500,2017,372,3610,1
5,100,8,5,5,0,0,3,8,0,0,0,0,0,0,0,0,0,0,0,0,2,19,5,4500,2017,372,3611,1
5,100,2,2,2,0,0,0,2,0,0,0,0,0,0,0,0,0,0,0,0,2,19,5,4500,2017,372,3611,1
5,100,14,8,8,0,0,6,14,0,0,0,0,0,0,0,0,0,0,0,0,2,19,5,4500,2017,372,3612,1
5,100,6,4,4,0,0,2,6,0,0,0,0,0,0,0,0,0,0,0,0,2,19,5,4500,2017,372,3613,1
5,100,6,4,4,0,0,2,6,1,2,1,2,3,3,2,4,0,2,0,0,2,19,5,4500,2017,372,3614,1
5,100,6,4,4,0,0,2,6,0,0,0,0,0,0,0,0,0,0,0,0,2,19,5,4500,2017,372,3615,1
5,100,7,5,5,0,0,2,7,0,0,0,0,0,0,0,0,0,0,0,0,2,19,5,4500,2017,372,3616,1
5,100,6,4,4,0,0,2,6,0,0,0,0,0,0,0,0,0,0,0,0,2,19,5,4500,2017,372,3617,1
5,100,10,6,6,0,0,4,10,0,0,0,0,0,0,0,0,0,0,0,0,2,19,5,4500,2017,372,3618,1
5,100,1,1,1,0,0,0,1,0,0,0,0,0,0,0,0,0,0,0,0,2,19,5,4500,2017,372,3618,1
5,100,14,10,10,0,0,4,14,1,1,1,1,2,2,0,2,0,1,0,0,2,19,5,4500,2017,372,3619,1
5,100,46,26,30,3,0,12,49,3,6,3,6,9,9,20,28,1,42,2,0,2,19,5,4510,2017,372,3620,1
49,1034,384,251,317,7,8,52,391,11,70,44,84,81,128,467,811,6,5355,297,0,2,29,24,4510,2017,372,3621,1
30,1650,1289,550,1043,56,32,155,1345,10,167,93,185,177,278,1266,2075,5,11498,638,0,2,4,6,4510,2019,373,3622,1
25,1340,384,251,317,7,8,52,391,11,70,44,84,81,128,467,811,6,5355,297,0,2,21,50,4510,2019,373,3623,1
127,2219,1338,495,1086,10,64,173,1348,11,122,82,157,133,239,883,1686,7,11934,663,0,2,6,0,4510,2021,373,3624,0
124,2168,1338,495,1086,10,64,173,1348,11,122,82,157,133,239,883,1686,7,11934,663,0,2,0,10,4510,2023,373,3625,1
124,2168,1338,495,1086,10,64,173,1348,11,122,82,157,133,239,883,1686,7,11934,663,0,2,6,10,4510,2025,373,3626,0
50,1088,384,251,317,7,8,52,391,11,70,44,84,81,128,467,811,6,5355,297,0,2,18,10,4510,2025,373,3627,1
26,1428,384,251,317,7,8,52,391,11,70,44,84,81,128,467,811,6,5355,297,0,2,15,2,4510,2025,373,3628,1
7,469,1043,504,840,53,9,147,1096,9,180,112,198,189,310,1377,2344,4,11604,644,0,2,12,12,4510,2027,373,3629,1
23,1002,373,158,315,8,0,51,381,5,76,44,79,81,123,486,779,2,2026,112,0,2,6,6,4510,2027,373,3630,1
32,372,757,253,292,73,244,162,830,13,61,38,67,74,105,409,651,7,4654,258,0,2,1,0,4510,2028,373,3631,0
49,1061,384,251,317,7,8,52,391,11,70,44,84,81,128,467,811,6,5355,297,0,2,1,4,4510,2028,373,3632,0
22,1316,384,251,317,7,8,52,391,11,70,44,84,81,128,467,811,6,5355,297,0,2,0,20,4510,2028,373,3633,0
5,108,127,75,83,2,11,30,129,4,14,7,14,18,21,61,87,2,175,9,0,2,1,0,4510,2028,373,3634,1
5,108,652,304,544,16,6,88,668,6,89,51,101,95,152,591,998,3,3399,188,0,2,1,0,4510,2029,373,3635,1
5,108,2,2,2,0,0,0,2,0,0,0,0,0,0,0,0,0,0,0,0,2,1,0,4510,2029,373,3635,1
5,108,8,5,5,0,0,3,8,0,0,0,0,0,0,0,0,0,0,0,0,2,1,0,4510,2029,373,3636,1
5,108,2,2,2,0,0,0,2,0,0,0,0,0,0,0,0,0,0,0,0,2,1,0,4510,2029,373,3636,1
5,108,14,8,8,0,0,6,14,0,0,0,0,0,0,0,0,0,0,0,0,2,1,0,4510,2029,373,3637,1
5,108,6,4,4,0,0,2,6,0,0,0,0,0,0,0,0,0,0,0,0,2,1,0,4510,2029,373,3638,1
5,108,6,4,4,0,0,2,6,1,2,1,2,3,3,2,4,0,2,0,0,2,1,0,4510,2029,373,3639,1
5,108,6,4,4,0,0,2,6,0,0,0,0,0,0,0,0,0,0,0,0,2,1,0,4510,2029,373,3640,1
5,108,7,5,5,0,0,2,7,0,0,0,0,0,0,0,0,0,0,0,0,2,1,0,4510,2029,373,3641,1
5,108,6,4,4,0,0,2,6,0,0,0,0,0,0,0,0,0,0,0,0,2,1,0,4510,2029,373,3642,1
5,108,10,6,6,0,0,4,10,0,0,0,0,0,0,0,0,0,0,0,0,2,1,0,4510,2029,373,3643,1
5,108,1,1,1,0,0,0,1,0,0,0,0,0,0,0,0,0,0,0,0,2,1,0,4510,2029,373,3643,1
5,108,14,10,10,0,0,4,14,1,1,1,1,2,2,0,2,0,1,0,0,2,1,0,4510,2029,373,3644,1
5,108,46,26,30,3,0,12,49,3,6,3,6,9,9,20,28,1,42,2,0,2,1,0,4520,2029,373,3645,1
14,695,334,251,279,10,4,40,344,5,127,74,143,132,217,899,1528,2,4303,239,0,2,2,2,4520,2030,373,3646,1
42,2286,1457,730,1242,11,6,188,1468,10,292,166,329,302,495,2424,4078,5,22973,1276,1,2,2,2,4520,2032,373,3647,1
22,1316,384,251,317,7,8,52,391,11,70,44,84,81,128,467,811,6,5355,297,0,2,3,3,4520,2032,373,3648,1
23,1002,373,158,315,8,0,51,381,5,76,44,79,81,123,486,779,2,2026,112,0,2,29,29,4520,2032,373,3649,1
3,67,127,75,83,2,11,30,129,4,14,7,14,18,21,61,87,2,175,9,0,2,6,12,4520,2032,373,3650,1
3,67,652,304,544,16,6,88,668,6,89,51,101,95,152,591,998,3,3399,188,0,2,6,12,4520,2033,373,3651,1
3,67,2,2,2,0,0,0,2,0,0,0,0,0,0,0,0,0,0,0,0,2,6,12,4520,2033,373,3651,1
3,67,8,5,5,0,0,3,8,0,0,0,0,0,0,0,0,0,0,0,0,2,6,12,4520,2033,373,3652,1
3,67,2,2,2,0,0,0,2,0,0,0,0,0,0,0,0,0,0,0,0,2,6,12,4520,2033,373,3652,1
3,67,14,8,8,0,0,6,14,0,0,0,0,0,0,0,0,0,0,0,0,2,6,12,4520,2033,373,3653,1
3,67,6,4,4,0,0,2,6,0,0,0,0,0,0,0,0,0,0,0,0,2,6,12,4520,2033,373,3654,1
3,67,6,4,4,0,0,2,6,1,2,1,2,3,3,2,4,0,2,0,0,2,6,12,4520,2033,373,3655,1
3,67,6,4,4,0,0,2,6,0,0,0,0,0,0,0,0,0,0,0,0,2,6,12,4520,2033,373,3656,1
3,67,7,5,5,0,0,2,7,0,0,0,0,0,0,0,0,0,0,0,0,2,6,12,4520,2033,373,3657,1
3,67,6,4,4,0,0,2,6,0,0,0,0,0,0,0,0,0,0,0,0,2,6,12,4520,2033,373,3658,1
3,67,10,6,6,0,0,4,10,0,0,0,0,0,0,0,0,0,0,0,0,2,6,12,4520,2033,373,3659,1
3,67,1,1,1,0,0,0,1,0,0,0,0,0,0,0,0,0,0,0,0,2,6,12,4520,2033,373,3659,1
3,67,14,10,10,0,0,4,14,1,1,1,1,2,2,0,2,0,1,0,0,2,6,12,4520,2033,373,3660,1
3,67,46,26,30,3,0,12,49,3,6,3,6,9,9,20,28,1,42,2,0,2,6,12,4530,2033,373,3661,1
2,27,127,75,83,2,11,30,129,4,14,7,14,18,21,61,87,2,175,9,0,2,2,3,4530,2033,373,3662,1
2,27,652,304,544,16,6,88,668,6,89,51,101,95,152,591,998,3,3399,188,0,2,2,3,4530,2034,373,3663,1
2,27,2,2,2,0,0,0,2,0,0,0,0,0,0,0,0,0,0,0,0,2,2,3,4530,2034,373,3663,1
2,27,8,5,5,0,0,3,8,0,0,0,0,0,0,0,0,0,0,0,0,2,2,3,4530,2034,373,3664,1
2,27,2,2,2,0,0,0,2,0,0,0,0,0,0,0,0,0,0,0,0,2,2,3,4530,2034,373,3664,1
2,27,14,8,8,0,0,6,14,0,0,0,0,0,0,0,0,0,0,0,0,2,2,3,4530,2034,373,3665,1
2,27,6,4,4,0,0,2,6,0,0,0,0,0,0,0,0,0,0,0,0,2,2,3,4530,2034,373,3666,1
2,27,6,4,4,0,0,2,6,1,2,1,2,3,3,2,4,0,2,0,0,2,2,3,4530,2034,373,3667,1
2,27,6,4,4,0,0,2,6,0,0,0,0,0,0,0,0,0,0,0,0,2,2,3,4530,2034,373,3668,1
2,27,7,5,5,0,0,2,7,0,0,0,0,0,0,0,0,0,0,0,0,2,2,3,4530,2034,373,3669,1
2,27,6,4,4,0,0,2,6,0,0,0,0,0,0,0,0,0,0,0,0,2,2,3,4530,2034,373,3670,1
2,27,10,6,6,0,0,4,10,0,0,0,0,0,0,0,0,0,0,0,0,2,2,3,4530,2034,373,3671,1
2,27,1,1,1,0,0,0,1,0,0,0,0,0,0,0,0,0,0,0,0,2,2,3,4530,2034,373,3671,1
2,27,14,10,10,0,0,4,14,1,1,1,1,2,2,0,2,0,1,0,0,2,2,3,4530,2034,373,3672,1
2,27,46,26,30,3,0,12,49,3,6,3,6,9,9,20,28,1,42,2,0,2,2,3,4540,2034,373,3673,1
6,106,127,75,83,2,11,30,129,4,14,7,14,18,21,61,87,2,175,9,0,2,5,6,4540,2034,373,3674,1
6,106,652,304,544,16,6,88,668,6,89,51,101,95,152,591,998,3,3399,188,0,2,5,6,4540,2035,373,3675,1
6,106,2,2,2,0,0,0,2,0,0,0,0,0,0,0,0,0,0,0,0,2,5,6,4540,2035,373,3675,1
6,106,8,5,5,0,0,3,8,0,0,0,0,0,0,0,0,0,0,0,0,2,5,6,4540,2035,373,3676,1
6,106,2,2,2,0,0,0,2,0,0,0,0,0,0,0,0,0,0,0,0,2,5,6,4540,2035,373,3676,1
6,106,14,8,8,0,0,6,14,0,0,0,0,0,0,0,0,0,0,0,0,2,5,6,4540,2035,373,3677,1
6,106,6,4,4,0,0,2,6,0,0,0,0,0,0,0,0,0,0,0,0,2,5,6,4540,2035,373,3678,1
6,106,6,4,4,0,0,2,6,1,2,1,2,3,3,2,4,0,2,0,0,2,5,6,4540,2035,373,3679,1
6,106,6,4,4,0,0,2,6,0,0,0,0,0,0,0,0,0,0,0,0,2,5,6,4540,2035,373,3680,1
6,106,7,5,5,0,0,2,7,0,0,0,0,0,0,0,0,0,0,0,0,2,5,6,4540,2035,373,3681,1
6,106,6,4,4,0,0,2,6,0,0,0,0,0,0,0,0,0,0,0,0,2,5,6,4540,2035,373,3682,1
6,106,10,6,6,0,0,4,10,0,0,0,0,0,0,0,0,0,0,0,0,2,5,6,4540,2035,373,3683,1
6,106,1,1,1,0,0,0,1,0,0,0,0,0,0,0,0,0,0,0,0,2,5,6,4540,2035,373,3683,1
6,106,14,10,10,0,0,4,14,1,1,1,1,2,2,0,2,0,1,0,0,2,5,6,4540,2035,373,3684,1
6,106,46,26,30,3,0,12,49,3,6,3,6,9,9,20,28,1,42,2,0,2,5,6,4550,2035,373,3685,1
2,80,13,10,10,0,0,3,13,1,2,1,2,3,3,2,4,0,2,0,0,2,3,3,4550,2035,373,3686,1
51,1169,1043,504,840,53,9,147,1096,9,180,112,198,189,310,1377,2344,4,11604,644,0,2,17,10,4550,2037,373,3687,1
51,1169,383,288,292,26,6,62,409,11,65,38,67,76,105,429,656,5,3719,206,0,2,17,10,4550,2038,373,3688,1
8,544,1043,504,840,53,9,147,1096,9,180,112,198,189,310,1377,2344,4,11604,644,0,2,17,1,4550,2040,373,3689,1
1,306,42,7,35,4,0,5,46,1,2,1,2,3,3,2,4,0,2,0,0,2,3,4,4560,2044,374,3697,0
1,306,11,6,10,0,0,1,11,2,4,2,4,6,6,10,15,1,15,0,0,2,3,4,4560,2044,374,3698,0
51,1158,1043,504,840,53,9,147,1096,9,180,112,198,189,310,1377,2344,4,11604,644,0,2,5,5,4590,2058,377,3720,0
51,1158,383,288,292,26,6,62,409,11,65,38,67,76,105,429,656,5,3719,206,0,2,5,5,4590,2059,377,3721,0
32,372,757,253,292,73,244,162,830,13,61,38,67,74,105,409,651,7,4654,258,0,2,2,1,4590,2060,377,3722,1
48,1080,1043,504,840,53,9,147,1096,9,180,112,198,189,310,1377,2344,4,11604,644,0,2,26,42,4590,2062,377,3723,1
48,1080,383,288,292,26,6,62,409,11,65,38,67,76,105,429,656,5,3719,206,0,2,26,42,4590,2063,377,3724,1
26,913,1043,504,840,53,9,147,1096,9,180,112,198,189,310,1377,2344,4,11604,644,0,2,244,73,4590,2065,377,3725,1
23,1002,373,158,315,8,0,51,381,5,76,44,79,81,123,486,779,2,2026,112,0,2,3,3,4590,2065,377,3726,1
51,1155,1043,504,840,53,9,147,1096,9,180,112,198,189,310,1377,2344,4,11604,644,0,2,27,21,4590,2067,377,3727,1
51,1155,383,288,292,26,6,62,409,11,65,38,67,76,105,429,656,5,3719,206,0,2,27,21,4590,2068,377,3728,1
30,350,757,253,292,73,244,162,830,13,61,38,67,74,105,409,651,7,4654,258,0,2,7,13,4590,2069,377,3729,1
49,1053,384,251,317,7,8,52,391,11,70,44,84,81,128,467,811,6,5355,297,0,2,2,2,4590,2069,377,3730,1
49,1106,1043,504,840,53,9,147,1096,9,180,112,198,189,310,1377,2344,4,11604,644,0,2,5,10,4590,2071,377,3731,1
49,1106,383,288,292,26,6,62,409,11,65,38,67,76,105,429,656,5,3719,206,0,2,5,10,4590,2072,377,3732,1
38,676,373,158,315,8,0,51,381,5,76,44,79,81,123,486,779,2,2026,112,0,2,1,10,4590,2072,377,3733,1
28,1589,1289,550,1043,56,32,155,1345,10,167,93,185,177,278,1266,2075,5,11498,638,0,2,0,15,4590,2074,378,3734,1
24,833,1043,504,840,53,9,147,1096,9,180,112,198,189,310,1377,2344,4,11604,644,0,2,0,20,4590,2076,378,3735,1
21,888,373,158,315,8,0,51,381,5,76,44,79,81,123,486,779,2,2026,112,0,2,0,16,4590,2076,378,3736,1
30,354,757,253,292,73,244,162,830,13,61,38,67,74,105,409,651,7,4654,258,0,2,3,5,4590,2077,378,3737,1
38,683,373,158,315,8,0,51,381,5,76,44,79,81,123,486,779,2,2026,112,0,2,3,2,4590,2077,378,3738,1
45,1291,2,2,2,0,0,0,2,0,0,0,0,0,0,0,0,0,0,0,0,2,0,19,4590,2077,378,3738,1
45,1291,99,48,90,1,3,5,100,0,0,0,0,0,0,0,0,0,0,0,0,2,0,19,4590,2078,378,3739,1
45,1291,8,5,5,2,0,1,10,0,0,0,0,0,0,0,0,0,0,0,0,2,0,19,4590,2078,378,3740,1
45,1291,1217,716,841,84,126,174,1301,14,185,118,215,199,333,1446,2542,8,20687,1149,0,2,0,19,4600,2080,378,3741,1
45,1291,160,89,115,0,13,31,160,7,15,11,17,22,28,78,124,3,495,27,0,2,0,19,4600,2080,378,3742,1
45,1291,10,10,9,9,0,0,19,0,0,0,0,0,0,0,0,0,0,0,0,2,0,19,4600,2080,379,3743,1
45,1291,173,84,99,8,29,36,181,5,12,7,13,17,20,54,81,2,221,12,0,2,0,19,4600,2081,379,3744,1
45,1291,3,1,1,3,0,0,6,0,0,0,0,0,0,0,0,0,0,0,0,2,0,19,4600,2081,379,3745,1
18,449,2,2,2,0,0,0,2,0,0,0,0,0,0,0,0,0,0,0,0,2,1,4,4600,2081,379,3745,1
18,449,99,48,90,1,3,5,100,0,0,0,0,0,0,0,0,0,0,0,0,2,1,4,4600,2082,379,3746,1
18,449,8,5,5,2,0,1,10,0,0,0,0,0,0,0,0,0,0,0,0,2,1,4,4600,2082,379,3747,1
18,449,1217,716,841,84,126,174,1301,14,185,118,215,199,333,1446,2542,8,20687,1149,0,2,1,4,4610,2084,379,3748,1
18,449,160,89,115,0,13,31,160,7,15,11,17,22,28,78,124,3,495,27,0,2,1,4,4610,2084,379,3749,1
18,449,10,10,9,9,0,0,19,0,0,0,0,0,0,0,0,0,0,0,0,2,1,4,4610,2084,380,3750,1
18,449,173,84,99,8,29,36,181,5,12,7,13,17,20,54,81,2,221,12,0,2,1,4,4610,2085,380,3751,1
18,449,3,1,1,3,0,0,6,0,0,0,0,0,0,0,0,0,0,0,0,2,1,4,4610,2085,380,3752,1
5,106,127,75,83,2,11,30,129,4,14,7,14,18,21,61,87,2,175,9,0,2,1,1,4610,2085,380,3753,1
5,106,652,304,544,16,6,88,668,6,89,51,101,95,152,591,998,3,3399,188,0,2,1,1,4610,2086,380,3754,1
5,106,2,2,2,0,0,0,2,0,0,0,0,0,0,0,0,0,0,0,0,2,1,1,4610,2086,380,3754,1
5,106,8,5,5,0,0,3,8,0,0,0,0,0,0,0,0,0,0,0,0,2,1,1,4610,2086,380,3755,1
5,106,2,2,2,0,0,0,2,0,0,0,0,0,0,0,0,0,0,0,0,2,1,1,4610,2086,380,3755,1
5,106,14,8,8,0,0,6,14,0,0,0,0,0,0,0,0,0,0,0,0,2,1,1,4610,2086,380,3756,1
5,106,6,4,4,0,0,2,6,0,0,0,0,0,0,0,0,0,0,0,0,2,1,1,4610,2086,380,3757,1
5,106,6,4,4,0,0,2,6,1,2,1,2,3,3,2,4,0,2,0,0,2,1,1,4610,2086,380,3758,1
5,106,6,4,4,0,0,2,6,0,0,0,0,0,0,0,0,0,0,0,0,2,1,1,4610,2086,380,3759,1
5,106,7,5,5,0,0,2,7,0,0,0,0,0,0,0,0,0,0,0,0,2,1,1,4610,2086,380,3760,1
5,106,6,4,4,0,0,2,6,0,0,0,0,0,0,0,0,0,0,0,0,2,1,1,4610,2086,380,3761,1
5,106,10,6,6,0,0,4,10,0,0,0,0,0,0,0,0,0,0,0,0,2,1,1,4610,2086,380,3762,1
5,106,1,1,1,0,0,0,1,0,0,0,0,0,0,0,0,0,0,0,0,2,1,1,4610,2086,380,3762,1
5,106,14,10,10,0,0,4,14,1,1,1,1,2,2,0,2,0,1,0,0,2,1,1,4610,2086,380,3763,1
5,106,46,26,30,3,0,12,49,3,6,3,6,9,9,20,28,1,42,2,0,2,1,1,4620,2086,380,3764,1
70,1433,384,251,317,7,8,52,391,11,70,44,84,81,128,467,811,6,5355,297,0,2,70,0,4620,2086,380,3765,1
29,1470,384,251,317,7,8,52,391,11,70,44,84,81,128,467,811,6,5355,297,0,2,28,2,4620,2086,380,3766,1
18,449,2,2,2,0,0,0,2,0,0,0,0,0,0,0,0,0,0,0,0,2,3,3,4620,2086,380,3766,0
18,449,99,48,90,1,3,5,100,0,0,0,0,0,0,0,0,0,0,0,0,2,3,3,4620,2087,380,3767,0
18,449,8,5,5,2,0,1,10,0,0,0,0,0,0,0,0,0,0,0,0,2,3,3,4620,2087,380,3768,0
18,449,1217,716,841,84,126,174,1301,14,185,118,215,199,333,1446,2542,8,20687,1149,0,2,3,3,4630,2089,380,3769,0
18,449,160,89,115,0,13,31,160,7,15,11,17,22,28,78,124,3,495,27,0,2,3,3,4630,2089,380,3770,0
18,449,10,10,9,9,0,0,19,0,0,0,0,0,0,0,0,0,0,0,0,2,3,3,4630,2089,381,3771,0
18,449,173,84,99,8,29,36,181,5,12,7,13,17,20,54,81,2,221,12,0,2,3,3,4630,2090,381,3772,0
18,449,3,1,1,3,0,0,6,0,0,0,0,0,0,0,0,0,0,0,0,2,3,3,4630,2090,381,3773,0
19,456,2,2,2,0,0,0,2,0,0,0,0,0,0,0,0,0,0,0,0,2,1,0,4630,2090,381,3773,0
19,456,99,48,90,1,3,5,100,0,0,0,0,0,0,0,0,0,0,0,0,2,1,0,4630,2091,381,3774,0
19,456,8,5,5,2,0,1,10,0,0,0,0,0,0,0,0,0,0,0,0,2,1,0,4630,2091,381,3775,0
19,456,1217,716,841,84,126,174,1301,14,185,118,215,199,333,1446,2542,8,20687,1149,0,2,1,0,4640,2093,381,3776,0
19,456,160,89,115,0,13,31,160,7,15,11,17,22,28,78,124,3,495,27,0,2,1,0,4640,2093,381,3777,0
19,456,10,10,9,9,0,0,19,0,0,0,0,0,0,0,0,0,0,0,0,2,1,0,4640,2093,382,3778,0
19,456,173,84,99,8,29,36,181,5,12,7,13,17,20,54,81,2,221,12,0,2,1,0,4640,2094,382,3779,0
19,456,3,1,1,3,0,0,6,0,0,0,0,0,0,0,0,0,0,0,0,2,1,0,4640,2094,382,3780,0
16,369,2,2,2,0,0,0,2,0,0,0,0,0,0,0,0,0,0,0,0,2,29,48,4640,2094,382,3780,0
16,369,99,48,90,1,3,5,100,0,0,0,0,0,0,0,0,0,0,0,0,2,29,48,4640,2095,382,3781,0
16,369,8,5,5,2,0,1,10,0,0,0,0,0,0,0,0,0,0,0,0,2,29,48,4640,2095,382,3782,0
16,369,1217,716,841,84,126,174,1301,14,185,118,215,199,333,1446,2542,8,20687,1149,0,2,29,48,4650,2097,382,3783,0
16,369,160,89,115,0,13,31,160,7,15,11,17,22,28,78,124,3,495,27,0,2,29,48,4650,2097,382,3784,0
16,369,10,10,9,9,0,0,19,0,0,0,0,0,0,0,0,0,0,0,0,2,29,48,4650,2097,383,3785,0
16,369,173,84,99,8,29,36,181,5,12,7,13,17,20,54,81,2,221,12,0,2,29,48,4650,2098,383,3786,0
16,369,3,1,1,3,0,0,6,0,0,0,0,0,0,0,0,0,0,0,0,2,29,48,4650,2098,383,3787,0
19,404,2,2,2,0,0,0,2,0,0,0,0,0,0,0,0,0,0,0,0,2,12,1,4650,2098,383,3787,0
19,404,99,48,90,1,3,5,100,0,0,0,0,0,0,0,0,0,0,0,0,2,12,1,4650,2099,383,3788,0
19,404,8,5,5,2,0,1,10,0,0,0,0,0,0,0,0,0,0,0,0,2,12,1,4650,2099,383,3789,0
19,404,1217,716,841,84,126,174,1301,14,185,118,215,199,333,1446,2542,8,20687,1149,0,2,12,1,4660,2101,383,3790,0
19,404,160,89,115,0,13,31,160,7,15,11,17,22,28,78,124,3,495,27,0,2,12,1,4660,2101,383,3791,0
19,404,10,10,9,9,0,0,19,0,0,0,0,0,0,0,0,0,0,0,0,2,12,1,4660,2101,384,3792,0
19,404,173,84,99,8,29,36,181,5,12,7,13,17,20,54,81,2,221,12,0,2,12,1,4660,2102,384,3793,0
19,404,3,1,1,3,0,0,6,0,0,0,0,0,0,0,0,0,0,0,0,2,12,1,4660,2102,384,3794,0
88,1938,1457,730,1242,11,6,188,1468,10,292,166,329,302,495,2424,4078,5,22973,1276,1,2,0,2,4660,2104,384,3795,1
88,1938,74,35,59,1,0,14,75,3,14,7,14,17,21,58,85,1,128,7,0,2,0,2,4660,2105,384,3796,1
88,1938,245,125,200,5,7,34,250,7,30,17,34,37,51,166,265,3,1053,58,0,2,0,2,4670,2106,384,3797,1
34,391,757,253,292,73,244,162,830,13,61,38,67,74,105,409,651,7,4654,258,0,2,19,6,4670,2107,384,3798,1
68,1398,384,251,317,7,8,52,391,11,70,44,84,81,128,467,811,6,5355,297,0,2,0,5,4670,2107,384,3799,1
38,680,373,158,315,8,0,51,381,5,76,44,79,81,123,486,779,2,2026,112,0,2,4,6,4670,2107,384,3800,1
21,888,373,158,315,8,0,51,381,5,76,44,79,81,123,486,779,2,2026,112,0,2,1,1,4670,2107,384,3801,1
34,387,757,253,292,73,244,162,830,13,61,38,67,74,105,409,651,7,4654,258,0,2,8,9,4670,2108,384,3802,1
34,316,647,139,84,35,284,233,682,0,0,0,0,0,0,0,0,0,0,0,0,0,153,0,4670,2109,384,3804,1
68,1394,384,251,317,7,8,52,391,11,70,44,84,81,128,467,811,6,5355,297,0,2,3,3,4670,2109,384,3805,1
66,1372,384,251,317,7,8,52,391,11,70,44,84,81,128,467,811,6,5355,297,0,2,2,6,4670,2109,384,3806,0
28,1427,384,251,317,7,8,52,391,11,70,44,84,81,128,467,811,6,5355,297,0,2,0,9,4670,2109,384,3807,0
123,2153,1338,495,1086,10,64,173,1348,11,122,82,157,133,239,883,1686,7,11934,663,0,2,4,8,4670,2111,384,3808,1
88,1939,1457,730,1242,11,6,188,1468,10,292,166,329,302,495,2424,4078,5,22973,1276,1,2,2,1,4670,2113,384,3809,1
88,1939,74,35,59,1,0,14,75,3,14,7,14,17,21,58,85,1,128,7,0,2,2,1,4670,2114,384,3810,1
88,1939,245,125,200,5,7,34,250,7,30,17,34,37,51,166,265,3,1053,58,0,2,2,1,4680,2115,384,3811,1
5,107,127,75,83,2,11,30,129,4,14,7,14,18,21,61,87,2,175,9,0,2,1,1,4680,2115,384,3812,1
5,107,652,304,544,16,6,88,668,6,89,51,101,95,152,591,998,3,3399,188,0,2,1,1,4680,2116,384,3813,1
5,107,2,2,2,0,0,0,2,0,0,0,0,0,0,0,0,0,0,0,0,2,1,1,4680,2116,384,3813,1
5,107,8,5,5,0,0,3,8,0,0,0,0,0,0,0,0,0,0,0,0,2,1,1,4680,2116,384,3814,1
5,107,2,2,2,0,0,0,2,0,0,0,0,0,0,0,0,0,0,0,0,2,1,1,4680,2116,384,3814,1
5,107,14,8,8,0,0,6,14,0,0,0,0,0,0,0,0,0,0,0,0,2,1,1,4680,2116,384,3815,1
5,107,6,4,4,0,0,2,6,0,0,0,0,0,0,0,0,0,0,0,0,2,1,1,4680,2116,384,3816,1
5,107,6,4,4,0,0,2,6,1,2,1,2,3,3,2,4,0,2,0,0,2,1,1,4680,2116,384,3817,1
5,107,6,4,4,0,0,2,6,0,0,0,0,0,0,0,0,0,0,0,0,2,1,1,4680,2116,384,3818,1
5,107,7,5,5,0,0,2,7,0,0,0,0,0,0,0,0,0,0,0,0,2,1,1,4680,2116,384,3819,1
5,107,6,4,4,0,0,2,6,0,0,0,0,0,0,0,0,0,0,0,0,2,1,1,4680,2116,384,3820,1
5,107,10,6,6,0,0,4,10,0,0,0,0,0,0,0,0,0,0,0,0,2,1,1,4680,2116,384,3821,1
5,107,1,1,1,0,0,0,1,0,0,0,0,0,0,0,0,0,0,0,0,2,1,1,4680,2116,384,3821,1
5,107,14,10,10,0,0,4,14,1,1,1,1,2,2,0,2,0,1,0,0,2,1,1,4680,2116,384,3822,1
5,107,46,26,30,3,0,12,49,3,6,3,6,9,9,20,28,1,42,2,0,2,1,1,4690,2116,384,3823,1
18,389,2,2,2,0,0,0,2,0,0,0,0,0,0,0,0,0,0,0,0,2,2,3,4690,2116,384,3823,1
18,389,99,48,90,1,3,5,100,0,0,0,0,0,0,0,0,0,0,0,0,2,2,3,4690,2117,384,3824,1
18,389,8,5,5,2,0,1,10,0,0,0,0,0,0,0,0,0,0,0,0,2,2,3,4690,2117,384,3825,1
18,389,1217,716,841,84,126,174,1301,14,185,118,215,199,333,1446,2542,8,20687,1149,0,2,2,3,4700,2119,384,3826,1
18,389,160,89,115,0,13,31,160,7,15,11,17,22,28,78,124,3,495,27,0,2,2,3,4700,2119,384,3827,1
18,389,10,10,9,9,0,0,19,0,0,0,0,0,0,0,0,0,0,0,0,2,2,3,4700,2119,385,3828,1
18,389,173,84,99,8,29,36,181,5,12,7,13,17,20,54,81,2,221,12,0,2,2,3,4700,2120,385,3829,1
18,389,3,1,1,3,0,0,6,0,0,0,0,0,0,0,0,0,0,0,0,2,2,3,4700,2120,385,3830,1
123,2143,1338,495,1086,10,64,173,1348,11,122,82,157,133,239,883,1686,7,11934,663,0,2,3,3,4700,2122,385,3831,1
34,312,647,139,84,35,284,233,682,0,0,0,0,0,0,0,0,0,0,0,0,2,23,18,4700,2122,385,3832,1
124,2163,1338,495,1086,10,64,173,1348,11,122,82,157,133,239,883,1686,7,11934,663,0,2,10,5,4700,2124,385,3833,1
33,298,647,139,84,35,284,233,682,0,0,0,0,0,0,0,0,0,0,0,0,2,6,14,4700,2124,385,3834,1
1,319,42,7,35,4,0,5,46,1,2,1,2,3,3,2,4,0,2,0,0,2,18,16,4700,2124,385,3835,1
1,319,11,6,10,0,0,1,11,2,4,2,4,6,6,10,15,1,15,0,0,2,18,16,4700,2124,385,3836,1
34,305,647,139,84,35,284,233,682,0,0,0,0,0,0,0,0,0,0,0,0,2,4,0,4710,2128,386,3844,1
71,1431,384,251,317,7,8,52,391,11,70,44,84,81,128,467,811,6,5355,297,0,2,12,0,4710,2128,386,3845,1
42,2275,1457,730,1242,11,6,188,1468,10,292,166,329,302,495,2424,4078,5,22973,1276,1,2,2,1,4710,2130,386,3846,1
29,1463,384,251,317,7,8,52,391,11,70,44,84,81,128,467,811,6,5355,297,0,2,17,1,4710,2130,386,3847,1
72,1433,384,251,317,7,8,52,391,11,70,44,84,81,128,467,811,6,5355,297,0,2,2,1,4730,2138,388,3862,0
1,319,42,7,35,4,0,5,46,1,2,1,2,3,3,2,4,0,2,0,0,2,1,1,4730,2138,388,3863,0
1,319,11,6,10,0,0,1,11,2,4,2,4,6,6,10,15,1,15,0,0,2,1,1,4730,2138,388,3864,0
1,319,42,7,35,4,0,5,46,1,2,1,2,3,3,2,4,0,2,0,0,2,11,5,4730,2138,388,3865,1
1,319,11,6,10,0,0,1,11,2,4,2,4,6,6,10,15,1,15,0,0,2,11,5,4730,2138,388,3866,1
1,136,42,7,35,4,0,5,46,1,2,1,2,3,3,2,4,0,2,0,0,2,7,97,4740,2142,389,3874,0
1,136,11,6,10,0,0,1,11,2,4,2,4,6,6,10,15,1,15,0,0,2,7,97,4740,2142,389,3875,0
124,2163,1338,495,1086,10,64,173,1348,11,122,82,157,133,239,883,1686,7,11934,663,0,2,1,1,4740,2144,389,3876,0
1,220,42,7,35,4,0,5,46,1,2,1,2,3,3,2,4,0,2,0,0,2,51,9,4750,2148,390,3884,1
1,220,11,6,10,0,0,1,11,2,4,2,4,6,6,10,15,1,15,0,0,2,51,9,4750,2148,390,3885,1
1,311,42,7,35,4,0,5,46,1,2,1,2,3,3,2,4,0,2,0,0,2,49,8,4750,2148,390,3886,1
1,311,11,6,10,0,0,1,11,2,4,2,4,6,6,10,15,1,15,0,0,2,49,8,4750,2148,390,3887,1
1,311,42,7,35,4,0,5,46,1,2,1,2,3,3,2,4,0,2,0,0,2,3,4,4760,2152,391,3895,0
1,311,11,6,10,0,0,1,11,2,4,2,4,6,6,10,15,1,15,0,0,2,3,4,4760,2152,391,3896,0
1,311,42,7,35,4,0,5,46,1,2,1,2,3,3,2,4,0,2,0,0,2,1,1,4760,2152,391,3897,0
1,311,11,6,10,0,0,1,11,2,4,2,4,6,6,10,15,1,15,0,0,2,1,1,4760,2152,391,3898,0
124,2163,1338,495,1086,10,64,173,1348,11,122,82,157,133,239,883,1686,7,11934,663,0,2,1,1,4770,2158,392,3906,1
1,311,42,7,35,4,0,5,46,1,2,1,2,3,3,2,4,0,2,0,0,2,6,14,4770,2158,392,3907,1
1,311,11,6,10,0,0,1,11,2,4,2,4,6,6,10,15,1,15,0,0,2,6,14,4770,2158,392,3908,1
1,313,42,7,35,4,0,5,46,1,2,1,2,3,3,2,4,0,2,0,0,2,4,4,4780,2162,393,3916,1
1,313,11,6,10,0,0,1,11,2,4,2,4,6,6,10,15,1,15,0,0,2,4,4,4780,2162,393,3917,1
1,311,42,7,35,4,0,5,46,1,2,1,2,3,3,2,4,0,2,0,0,2,1,1,4780,2162,393,3918,0
1,311,11,6,10,0,0,1,11,2,4,2,4,6,6,10,15,1,15,0,0,2,1,1,4780,2162,393,3919,0
1,313,42,7,35,4,0,5,46,1,2,1,2,3,3,2,4,0,2,0,0,2,2,5,4800,2170,395,3934,1
1,313,11,6,10,0,0,1,11,2,4,2,4,6,6,10,15,1,15,0,0,2,2,5,4800,2170,395,3935,1
29,1465,384,251,317,7,8,52,391,11,70,44,84,81,128,467,811,6,5355,297,0,2,1,1,4800,2170,395,3936,1
34,305,647,139,84,35,284,233,682,0,0,0,0,0,0,0,0,0,0,0,0,2,1,1,4800,2170,395,3937,0
34,305,647,139,84,35,284,233,682,0,0,0,0,0,0,0,0,0,0,0,0,2,1,1,4800,2170,395,3938,0
29,1465,384,251,317,7,8,52,391,11,70,44,84,81,128,467,811,6,5355,297,0,2,1,1,4800,2170,395,3939,0
1,306,42,7,35,4,0,5,46,1,2,1,2,3,3,2,4,0,2,0,0,2,1,3,4810,2174,396,3947,1
1,306,11,6,10,0,0,1,11,2,4,2,4,6,6,10,15,1,15,0,0,2,1,3,4810,2174,396,3948,1
1,306,42,7,35,4,0,5,46,1,2,1,2,3,3,2,4,0,2,0,0,2,2,6,4810,2174,396,3949,0
1,306,11,6,10,0,0,1,11,2,4,2,4,6,6,10,15,1,15,0,0,2,2,6,4810,2174,396,3950,0
28,1379,384,251,317,7,8,52,391,11,70,44,84,81,128,467,811,6,5355,297,0,2,0,24,4820,2178,397,3958,1
1,306,42,7,35,4,0,5,46,1,2,1,2,3,3,2,4,0,2,0,0,2,4,4,4820,2178,397,3959,1
1,306,11,6,10,0,0,1,11,2,4,2,4,6,6,10,15,1,15,0,0,2,4,4,4820,2178,397,3960,1
2,80,13,10,10,0,0,3,13,1,2,1,2,3,3,2,4,0,2,0,0,3,1,1,4820,2178,398,3962,1
75,1676,384,251,317,7,8,52,391,11,70,44,84,81,128,467,811,6,5355,297,0,2,48,4,4830,2179,398,3976,1
29,1440,384,251,317,7,8,52,391,11,70,44,84,81,128,467,811,6,5355,297,0,2,16,1,4830,2179,398,3977,1
2,80,13,10,10,0,0,3,13,1,2,1,2,3,3,2,4,0,2,0,0,3,1,1,4830,2179,399,3979,0
75,1676,384,251,317,7,8,52,391,11,70,44,84,81,128,467,811,6,5355,297,0,2,48,4,4840,2180,399,3993,0
29,1440,384,251,317,7,8,52,391,11,70,44,84,81,128,467,811,6,5355,297,0,2,16,25,4840,2180,399,3994,0
1,306,42,7,35,4,0,5,46,1,2,1,2,3,3,2,4,0,2,0,0,2,2,3,4840,2180,399,3995,0
1,306,11,6,10,0,0,1,11,2,4,2,4,6,6,10,15,1,15,0,0,2,2,3,4840,2180,399,3996,0
34,305,647,139,84,35,284,233,682,0,0,0,0,0,0,0,0,0,0,0,0,2,55,53,4840,2180,399,3997,1
2,311,42,7,35,4,0,5,46,1,2,1,2,3,3,2,4,0,2,0,0,2,2,1,4850,2184,400,4005,0
2,311,11,6,10,0,0,1,11,2,4,2,4,6,6,10,15,1,15,0,0,2,2,1,4850,2184,400,4006,0
34,305,647,139,84,35,284,233,682,0,0,0,0,0,0,0,0,0,0,0,0,2,55,53,4860,2188,401,4014,0
2,311,42,7,35,4,0,5,46,1,2,1,2,3,3,2,4,0,2,0,0,2,2,1,4860,2188,401,4015,0
2,311,11,6,10,0,0,1,11,2,4,2,4,6,6,10,15,1,15,0,0,2,2,1,4860,2188,401,4016,0
34,304,647,139,84,35,284,233,682,0,0,0,0,0,0,0,0,0,0,0,0,2,3,3,4860,2188,401,4017,1
75,1673,384,251,317,7,8,52,391,11,70,44,84,81,128,467,811,6,5355,297,0,2,2,2,4860,2188,401,4018,1
29,1440,384,251,317,7,8,52,391,11,70,44,84,81,128,467,811,6,5355,297,0,2,1,1,4860,2188,401,4019,1
35,307,647,139,84,35,284,233,682,0,0,0,0,0,0,0,0,0,0,0,0,2,6,3,4860,2188,401,4020,1
36,671,373,158,315,8,0,51,381,5,76,44,79,81,123,486,779,2,2026,112,0,2,5,5,4860,2188,401,4021,1
35,307,647,139,84,35,284,233,682,0,0,0,0,0,0,0,0,0,0,0,0,2,1,2,4860,2188,401,4022,1
35,307,647,139,84,35,284,233,682,0,0,0,0,0,0,0,0,0,0,0,0,2,10,8,4860,2188,401,4023,0
75,1673,384,251,317,7,8,52,391,11,70,44,84,81,128,467,811,6,5355,297,0,2,2,2,4860,2188,401,4024,0
36,671,373,158,315,8,0,51,381,5,76,44,79,81,123,486,779,2,2026,112,0,2,5,5,4860,2188,401,4025,0
29,1440,384,251,317,7,8,52,391,11,70,44,84,81,128,467,811,6,5355,297,0,2,1,1,4860,2188,401,4026,0
36,671,373,158,315,8,0,51,381,5,76,44,79,81,123,486,779,2,2026,112,0,2,1,1,4860,2188,401,4027,1
36,671,373,158,315,8,0,51,381,5,76,44,79,81,123,486,779,2,2026,112,0,2,1,1,4860,2188,401,4028,0
2,311,42,7,35,4,0,5,46,1,2,1,2,3,3,2,4,0,2,0,0,2,1,1,4870,2192,402,4036,0
2,311,11,6,10,0,0,1,11,2,4,2,4,6,6,10,15,1,15,0,0,2,1,1,4870,2192,402,4037,0
122,2141,1338,495,1086,10,64,173,1348,11,122,82,157,133,239,883,1686,7,11934,663,0,2,6,8,4870,2194,402,4038,1
77,1723,1457,730,1242,11,6,188,1468,10,292,166,329,302,495,2424,4078,5,22973,1276,1,2,0,37,4870,2196,402,4039,1
77,1723,74,35,59,1,0,14,75,3,14,7,14,17,21,58,85,1,128,7,0,2,0,37,4870,2197,402,4040,1
77,1723,245,125,200,5,7,34,250,7,30,17,34,37,51,166,265,3,1053,58,0,2,0,37,4880,2198,402,4041,1
27,1540,1289,550,1043,56,32,155,1345,10,167,93,185,177,278,1266,2075,5,11498,638,0,2,0,22,4880,2200,403,4042,1
34,1908,1457,730,1242,11,6,188,1468,10,292,166,329,302,495,2424,4078,5,22973,1276,1,2,0,55,4880,2202,403,4043,1
124,2153,1338,495,1086,10,64,173,1348,11,122,82,157,133,239,883,1686,7,11934,663,0,2,5,1,4880,2204,403,4044,0
17,320,127,75,83,2,11,30,129,4,14,7,14,18,21,61,87,2,175,9,0,2,10,0,4880,2204,403,4045,1
17,320,652,304,544,16,6,88,668,6,89,51,101,95,152,591,998,3,3399,188,0,2,10,0,4880,2205,403,4046,1
17,320,2,2,2,0,0,0,2,0,0,0,0,0,0,0,0,0,0,0,0,2,10,0,4880,2205,403,4046,1
17,320,8,5,5,0,0,3,8,0,0,0,0,0,0,0,0,0,0,0,0,2,10,0,4880,2205,403,4047,1
17,320,2,2,2,0,0,0,2,0,0,0,0,0,0,0,0,0,0,0,0,2,10,0,4880,2205,403,4047,1
17,320,14,8,8,0,0,6,14,0,0,0,0,0,0,0,0,0,0,0,0,2,10,0,4880,2205,403,4048,1
17,320,6,4,4,0,0,2,6,0,0,0,0,0,0,0,0,0,0,0,0,2,10,0,4880,2205,403,4049,1
17,320,6,4,4,0,0,2,6,1,2,1,2,3,3,2,4,0,2,0,0,2,10,0,4880,2205,403,4050,1
17,320,6,4,4,0,0,2,6,0,0,0,0,0,0,0,0,0,0,0,0,2,10,0,4880,2205,403,4051,1
17,320,7,5,5,0,0,2,7,0,0,0,0,0,0,0,0,0,0,0,0,2,10,0,4880,2205,403,4052,1
17,320,6,4,4,0,0,2,6,0,0,0,0,0,0,0,0,0,0,0,0,2,10,0,4880,2205,403,4053,1
17,320,10,6,6,0,0,4,10,0,0,0,0,0,0,0,0,0,0,0,0,2,10,0,4880,2205,403,4054,1
17,320,1,1,1,0,0,0,1,0,0,0,0,0,0,0,0,0,0,0,0,2,10,0,4880,2205,403,4054,1
17,320,14,10,10,0,0,4,14,1,1,1,1,2,2,0,2,0,1,0,0,2,10,0,4880,2205,403,4055,1
17,320,46,26,30,3,0,12,49,3,6,3,6,9,9,20,28,1,42,2,0,2,10,0,4890,2205,403,4056,1
14,692,334,251,279,10,4,40,344,5,127,74,143,132,217,899,1528,2,4303,239,0,2,1,3,4890,2206,403,4057,1
37,326,647,139,84,35,284,233,682,0,0,0,0,0,0,0,0,0,0,0,0,2,8,0,4890,2206,403,4058,1
17,320,127,75,83,2,11,30,129,4,14,7,14,18,21,61,87,2,175,9,0,2,10,0,4900,2210,404,4066,0
17,320,652,304,544,16,6,88,668,6,89,51,101,95,152,591,998,3,3399,188,0,2,10,0,4900,2211,404,4067,0
17,320,2,2,2,0,0,0,2,0,0,0,0,0,0,0,0,0,0,0,0,2,10,0,4900,2211,404,4067,0
17,320,8,5,5,0,0,3,8,0,0,0,0,0,0,0,0,0,0,0,0,2,10,0,4900,2211,404,4068,0
17,320,2,2,2,0,0,0,2,0,0,0,0,0,0,0,0,0,0,0,0,2,10,0,4900,2211,404,4068,0
17,320,14,8,8,0,0,6,14,0,0,0,0,0,0,0,0,0,0,0,0,2,10,0,4900,2211,404,4069,0
17,320,6,4,4,0,0,2,6,0,0,0,0,0,0,0,0,0,0,0,0,2,10,0,4900,2211,404,4070,0
17,320,6,4,4,0,0,2,6,1,2,1,2,3,3,2,4,0,2,0,0,2,10,0,4900,2211,404,4071,0
17,320,6,4,4,0,0,2,6,0,0,0,0,0,0,0,0,0,0,0,0,2,10,0,4900,2211,404,4072,0
17,320,7,5,5,0,0,2,7,0,0,0,0,0,0,0,0,0,0,0,0,2,10,0,4900,2211,404,4073,0
17,320,6,4,4,0,0,2,6,0,0,0,0,0,0,0,0,0,0,0,0,2,10,0,4900,2211,404,4074,0
17,320,10,6,6,0,0,4,10,0,0,0,0,0,0,0,0,0,0,0,0,2,10,0,4900,2211,404,4075,0
17,320,1,1,1,0,0,0,1,0,0,0,0,0,0,0,0,0,0,0,0,2,10,0,4900,2211,404,4075,0
17,320,14,10,10,0,0,4,14,1,1,1,1,2,2,0,2,0,1,0,0,2,10,0,4900,2211,404,4076,0
17,320,46,26,30,3,0,12,49,3,6,3,6,9,9,20,28,1,42,2,0,2,10,0,4910,2211,404,4077,0
124,2153,1338,495,1086,10,64,173,1348,11,122,82,157,133,239,883,1686,7,11934,663,0,2,11,9,4910,2213,404,4078,0
77,1723,1457,730,1242,11,6,188,1468,10,292,166,329,302,495,2424,4078,5,22973,1276,1,2,0,37,4910,2215,404,4079,0
77,1723,74,35,59,1,0,14,75,3,14,7,14,17,21,58,85,1,128,7,0,2,0,37,4910,2216,404,4080,0
77,1723,245,125,200,5,7,34,250,7,30,17,34,37,51,166,265,3,1053,58,0,2,0,37,4920,2217,404,4081,0
37,326,647,139,84,35,284,233,682,0,0,0,0,0,0,0,0,0,0,0,0,2,8,0,4920,2217,404,4082,0
27,1540,1289,550,1043,56,32,155,1345,10,167,93,185,177,278,1266,2075,5,11498,638,0,2,0,22,4920,2219,405,4083,0
34,1908,1457,730,1242,11,6,188,1468,10,292,166,329,302,495,2424,4078,5,22973,1276,1,2,0,55,4920,2221,405,4084,0
14,692,334,251,279,10,4,40,344,5,127,74,143,132,217,899,1528,2,4303,239,0,2,1,3,4920,2222,405,4085,0
2,311,42,7,35,4,0,5,46,1,2,1,2,3,3,2,4,0,2,0,0,2,1,1,4920,2222,405,4086,0
2,311,11,6,10,0,0,1,11,2,4,2,4,6,6,10,15,1,15,0,0,2,1,1,4920,2222,405,4087,0
25,1394,1289,550,1043,56,32,155,1345,10,167,93,185,177,278,1266,2075,5,11498,638,0,0,422,0,4920,2224,406,4088,1
16,927,1289,550,1043,56,32,155,1345,10,167,93,185,177,278,1266,2075,5,11498,638,0,2,0,203,4920,2226,407,4089,1
90,1970,1392,870,1177,35,17,170,1427,14,494,280,531,508,811,4473,7289,7,54850,3047,2,2,17,6,4930,2233,409,4097,1
100,3732,1392,870,1177,35,17,170,1427,14,494,280,531,508,811,4473,7289,7,54850,3047,2,2,21,0,4930,2236,410,4098,1
2,311,42,7,35,4,0,5,46,1,2,1,2,3,3,2,4,0,2,0,0,2,1,1,4930,2236,410,4099,1
2,311,11,6,10,0,0,1,11,2,4,2,4,6,6,10,15,1,15,0,0,2,1,1,4930,2236,410,4100,1
101,3760,1392,870,1177,35,17,170,1427,14,494,280,531,508,811,4473,7289,7,54850,3047,2,2,3,1,4930,2239,411,4101,0
9,518,1289,550,1043,56,32,155,1345,10,167,93,185,177,278,1266,2075,5,11498,638,0,2,0,274,4960,2253,415,4123,1
37,326,647,139,84,35,284,233,682,0,0,0,0,0,0,0,0,0,0,0,0,2,2,2,4960,2253,415,4124,1
36,671,373,158,315,8,0,51,381,5,76,44,79,81,123,486,779,2,2026,112,0,2,3,3,4960,2253,415,4125,1
5,261,1289,550,1043,56,32,155,1345,10,167,93,185,177,278,1266,2075,5,11498,638,0,2,0,184,4960,2255,416,4126,1
2,311,42,7,35,4,0,5,46,1,2,1,2,3,3,2,4,0,2,0,0,2,1,1,4960,2255,416,4127,1
2,311,11,6,10,0,0,1,11,2,4,2,4,6,6,10,15,1,15,0,0,2,1,1,4960,2255,416,4128,1
2,311,42,7,35,4,0,5,46,1,2,1,2,3,3,2,4,0,2,0,0,2,1,1,4970,2259,417,4136,0
2,311,11,6,10,0,0,1,11,2,4,2,4,6,6,10,15,1,15,0,0,2,1,1,4970,2259,417,4137,0
90,1970,1392,870,1177,35,17,170,1427,14,494,280,531,508,811,4473,7289,7,54850,3047,2,2,17,6,5000,2274,421,4159,0
101,3760,1392,870,1177,35,17,170,1427,14,494,280,531,508,811,4473,7289,7,54850,3047,2,2,23,0,5000,2277,422,4160,0
9,518,1289,550,1043,56,32,155,1345,10,167,93,185,177,278,1266,2075,5,11498,638,0,0,148,0,5000,2279,423,4161,0
37,326,647,139,84,35,284,233,682,0,0,0,0,0,0,0,0,0,0,0,0,2,2,2,5000,2279,423,4162,0
36,671,373,158,315,8,0,51,381,5,76,44,79,81,123,486,779,2,2026,112,0,2,3,3,5000,2279,423,4163,0
5,261,1289,550,1043,56,32,155,1345,10,167,93,185,177,278,1266,2075,5,11498,638,0,2,0,387,5000,2281,424,4164,0
2,311,42,7,35,4,0,5,46,1,2,1,2,3,3,2,4,0,2,0,0,2,2,2,5000,2281,424,4165,0
2,311,11,6,10,0,0,1,11,2,4,2,4,6,6,10,15,1,15,0,0,2,2,2,5000,2281,424,4166,0
127,2226,1338,495,1086,10,64,173,1348,11,122,82,157,133,239,883,1686,7,11934,663,0,2,10,0,5010,2287,425,4174,1
2,311,42,7,35,4,0,5,46,1,2,1,2,3,3,2,4,0,2,0,0,2,1,1,5010,2287,425,4175,1
2,311,11,6,10,0,0,1,11,2,4,2,4,6,6,10,15,1,15,0,0,2,1,1,5010,2287,425,4176,1
37,326,647,139,84,35,284,233,682,0,0,0,0,0,0,0,0,0,0,0,0,2,3,3,5010,2287,425,4177,1
127,2230,1338,495,1086,10,64,173,1348,11,122,82,157,133,239,883,1686,7,11934,663,0,2,2,5,5010,2289,425,4178,1
6,319,1289,550,1043,56,32,155,1345,10,167,93,185,177,278,1266,2075,5,11498,638,0,2,9,0,5010,2291,426,4179,1
127,2230,1338,495,1086,10,64,173,1348,11,122,82,157,133,239,883,1686,7,11934,663,0,2,12,5,5020,2297,427,4187,0
37,326,647,139,84,35,284,233,682,0,0,0,0,0,0,0,0,0,0,0,0,2,3,3,5020,2297,427,4188,0
6,319,1289,550,1043,56,32,155,1345,10,167,93,185,177,278,1266,2075,5,11498,638,0,2,9,0,5020,2299,428,4189,0
2,311,42,7,35,4,0,5,46,1,2,1,2,3,3,2,4,0,2,0,0,2,1,1,5020,2299,428,4190,0
2,311,11,6,10,0,0,1,11,2,4,2,4,6,6,10,15,1,15,0,0,2,1,1,5020,2299,428,4191,0
89,1961,1392,870,1177,35,17,170,1427,14,494,280,531,508,811,4473,7289,7,54850,3047,2,2,1,2,5020,2302,429,4192,1
101,3788,1392,870,1177,35,17,170,1427,14,494,280,531,508,811,4473,7289,7,54850,3047,2,2,5,1,5020,2305,430,4193,1
54,1827,773,419,590,28,0,166,801,10,204,113,217,214,330,1598,2554,5,13587,754,0,2,2,2,5020,2305,431,4194,1
75,1669,384,251,317,7,8,52,391,11,70,44,84,81,128,467,811,6,5355,297,0,2,0,3,5020,2305,431,4195,1
30,1475,384,251,317,7,8,52,391,11,70,44,84,81,128,467,811,6,5355,297,0,2,10,1,5020,2305,431,4196,1
75,1674,384,251,317,7,8,52,391,11,70,44,84,81,128,467,811,6,5355,297,0,2,12,9,5030,2309,432,4204,1
29,1457,384,251,317,7,8,52,391,11,70,44,84,81,128,467,811,6,5355,297,0,2,0,4,5030,2309,432,4205,1
131,2252,1338,495,1086,10,64,173,1348,11,122,82,157,133,239,883,1686,7,11934,663,0,2,6,1,5030,2311,432,4206,1
5,107,127,75,83,2,11,30,129,4,14,7,14,18,21,61,87,2,175,9,0,2,8,3,5030,2311,432,4207,1
5,107,652,304,544,16,6,88,668,6,89,51,101,95,152,591,998,3,3399,188,0,2,8,3,5030,2312,432,4208,1
5,107,2,2,2,0,0,0,2,0,0,0,0,0,0,0,0,0,0,0,0,2,8,3,5030,2312,432,4208,1
5,107,8,5,5,0,0,3,8,0,0,0,0,0,0,0,0,0,0,0,0,2,8,3,5030,2312,432,4209,1
5,107,2,2,2,0,0,0,2,0,0,0,0,0,0,0,0,0,0,0,0,2,8,3,5030,2312,432,4209,1
5,107,14,8,8,0,0,6,14,0,0,0,0,0,0,0,0,0,0,0,0,2,8,3,5030,2312,432,4210,1
5,107,6,4,4,0,0,2,6,0,0,0,0,0,0,0,0,0,0,0,0,2,8,3,5030,2312,432,4211,1
5,107,6,4,4,0,0,2,6,1,2,1,2,3,3,2,4,0,2,0,0,2,8,3,5030,2312,432,4212,1
5,107,6,4,4,0,0,2,6,0,0,0,0,0,0,0,0,0,0,0,0,2,8,3,5030,2312,432,4213,1
5,107,7,5,5,0,0,2,7,0,0,0,0,0,0,0,0,0,0,0,0,2,8,3,5030,2312,432,4214,1
5,107,6,4,4,0,0,2,6,0,0,0,0,0,0,0,0,0,0,0,0,2,8,3,5030,2312,432,4215,1
5,107,10,6,6,0,0,4,10,0,0,0,0,0,0,0,0,0,0,0,0,2,8,3,5030,2312,432,4216,1
5,107,1,1,1,0,0,0,1,0,0,0,0,0,0,0,0,0,0,0,0,2,8,3,5030,2312,432,4216,1
5,107,14,10,10,0,0,4,14,1,1,1,1,2,2,0,2,0,1,0,0,2,8,3,5030,2312,432,4217,1
5,107,46,26,30,3,0,12,49,3,6,3,6,9,9,20,28,1,42,2,0,2,8,3,5040,2312,432,4218,1
75,1669,384,251,317,7,8,52,391,11,70,44,84,81,128,467,811,6,5355,297,0,2,8,7,5040,2312,432,4219,1
29,1457,384,251,317,7,8,52,391,11,70,44,84,81,128,467,811,6,5355,297,0,2,2,2,5040,2312,432,4220,1
7,384,1289,550,1043,56,32,155,1345,10,167,93,185,177,278,1266,2075,5,11498,638,0,2,8,0,5040,2314,433,4221,1
89,1961,1392,870,1177,35,17,170,1427,14,494,280,531,508,811,4473,7289,7,54850,3047,2,2,1,2,5050,2321,435,4229,0
101,3788,1392,870,1177,35,17,170,1427,14,494,280,531,508,811,4473,7289,7,54850,3047,2,2,5,1,5050,2324,436,4230,0
54,1827,773,419,590,28,0,166,801,10,204,113,217,214,330,1598,2554,5,13587,754,0,2,2,2,5050,2324,437,4231,0
131,2252,1338,495,1086,10,64,173,1348,11,122,82,157,133,239,883,1686,7,11934,663,0,2,6,1,5050,2326,437,4232,0
5,107,127,75,83,2,11,30,129,4,14,7,14,18,21,61,87,2,175,9,0,2,8,3,5050,2326,437,4233,0
5,107,652,304,544,16,6,88,668,6,89,51,101,95,152,591,998,3,3399,188,0,2,8,3,5050,2327,437,4234,0
5,107,2,2,2,0,0,0,2,0,0,0,0,0,0,0,0,0,0,0,0,2,8,3,5050,2327,437,4234,0
5,107,8,5,5,0,0,3,8,0,0,0,0,0,0,0,0,0,0,0,0,2,8,3,5050,2327,437,4235,0
5,107,2,2,2,0,0,0,2,0,0,0,0,0,0,0,0,0,0,0,0,2,8,3,5050,2327,437,4235,0
5,107,14,8,8,0,0,6,14,0,0,0,0,0,0,0,0,0,0,0,0,2,8,3,5050,2327,437,4236,0
5,107,6,4,4,0,0,2,6,0,0,0,0,0,0,0,0,0,0,0,0,2,8,3,5050,2327,437,4237,0
5,107,6,4,4,0,0,2,6,1,2,1,2,3,3,2,4,0,2,0,0,2,8,3,5050,2327,437,4238,0
5,107,6,4,4,0,0,2,6,0,0,0,0,0,0,0,0,0,0,0,0,2,8,3,5050,2327,437,4239,0
5,107,7,5,5,0,0,2,7,0,0,0,0,0,0,0,0,0,0,0,0,2,8,3,5050,2327,437,4240,0
5,107,6,4,4,0,0,2,6,0,0,0,0,0,0,0,0,0,0,0,0,2,8,3,5050,2327,437,4241,0
5,107,10,6,6,0,0,4,10,0,0,0,0,0,0,0,0,0,0,0,0,2,8,3,5050,2327,437,4242,0
5,107,1,1,1,0,0,0,1,0,0,0,0,0,0,0,0,0,0,0,0,2,8,3,5050,2327,437,4242,0
5,107,14,10,10,0,0,4,14,1,1,1,1,2,2,0,2,0,1,0,0,2,8,3,5050,2327,437,4243,0
5,107,46,26,30,3,0,12,49,3,6,3,6,9,9,20,28,1,42,2,0,2,8,3,5060,2327,437,4244,0
75,1669,384,251,317,7,8,52,391,11,70,44,84,81,128,467,811,6,5355,297,0,2,20,19,5060,2327,437,4245,0
7,384,1289,550,1043,56,32,155,1345,10,167,93,185,177,278,1266,2075,5,11498,638,0,2,8,0,5060,2329,438,4246,0
29,1457,384,251,317,7,8,52,391,11,70,44,84,81,128,467,811,6,5355,297,0,2,12,7,5060,2329,438,4247,0
7,379,1289,550,1043,56,32,155,1345,10,167,93,185,177,278,1266,2075,5,11498,638,0,2,1,3,5070,2335,440,4255,0
2,311,42,7,35,4,0,5,46,1,2,1,2,3,3,2,4,0,2,0,0,2,1,1,5070,2335,440,4256,0
2,311,11,6,10,0,0,1,11,2,4,2,4,6,6,10,15,1,15,0,0,2,1,1,5070,2335,440,4257,0
36,504,282,196,195,3,0,86,285,8,130,71,141,138,212,936,1507,4,6538,363,0,2,7,5,5080,2336,441,4270,1
2,311,42,7,35,4,0,5,46,1,2,1,2,3,3,2,4,0,2,0,0,2,1,1,5090,2340,442,4278,1
2,311,11,6,10,0,0,1,11,2,4,2,4,6,6,10,15,1,15,0,0,2,1,1,5090,2340,442,4279,1
2,80,13,10,10,0,0,3,13,1,2,1,2,3,3,2,4,0,2,0,0,2,1,1,5090,2340,442,4280,1
77,1723,1457,730,1242,11,6,188,1468,10,292,166,329,302,495,2424,4078,5,22973,1276,1,2,1,1,5090,2342,442,4281,1
77,1723,74,35,59,1,0,14,75,3,14,7,14,17,21,58,85,1,128,7,0,2,1,1,5090,2343,442,4282,1
77,1723,245,125,200,5,7,34,250,7,30,17,34,37,51,166,265,3,1053,58,0,2,1,1,5100,2344,442,4283,1
9,518,1289,550,1043,56,32,155,1345,10,167,93,185,177,278,1266,2075,5,11498,638,0,2,1,1,5100,2346,443,4284,1
74,1661,384,251,317,7,8,52,391,11,70,44,84,81,128,467,811,6,5355,297,0,2,1,2,5100,2346,443,4285,1
6,314,1289,550,1043,56,32,155,1345,10,167,93,185,177,278,1266,2075,5,11498,638,0,2,0,8,5100,2348,444,4286,1
34,1908,1457,730,1242,11,6,188,1468,10,292,166,329,302,495,2424,4078,5,22973,1276,1,2,1,1,5100,2350,444,4287,1
2,307,42,7,35,4,0,5,46,1,2,1,2,3,3,2,4,0,2,0,0,2,0,2,5100,2350,444,4288,1
2,307,11,6,10,0,0,1,11,2,4,2,4,6,6,10,15,1,15,0,0,2,0,2,5100,2350,444,4289,1
36,504,282,196,195,3,0,86,285,8,130,71,141,138,212,936,1507,4,6538,363,0,2,7,5,5110,2351,445,4302,0
2,80,13,10,10,0,0,3,13,1,2,1,2,3,3,2,4,0,2,0,0,2,1,1,5110,2351,445,4303,0
77,1723,1457,730,1242,11,6,188,1468,10,292,166,329,302,495,2424,4078,5,22973,1276,1,2,1,1,5110,2353,445,4304,0
77,1723,74,35,59,1,0,14,75,3,14,7,14,17,21,58,85,1,128,7,0,2,1,1,5110,2354,445,4305,0
77,1723,245,125,200,5,7,34,250,7,30,17,34,37,51,166,265,3,1053,58,0,2,1,1,5120,2355,445,4306,0
9,518,1289,550,1043,56,32,155,1345,10,167,93,185,177,278,1266,2075,5,11498,638,0,2,1,1,5120,2357,446,4307,0
74,1661,384,251,317,7,8,52,391,11,70,44,84,81,128,467,811,6,5355,297,0,2,1,2,5120,2357,446,4308,0
6,314,1289,550,1043,56,32,155,1345,10,167,93,185,177,278,1266,2075,5,11498,638,0,2,0,10,5120,2359,447,4309,0
34,1908,1457,730,1242,11,6,188,1468,10,292,166,329,302,495,2424,4078,5,22973,1276,1,2,1,1,5120,2361,447,4310,0
2,307,42,7,35,4,0,5,46,1,2,1,2,3,3,2,4,0,2,0,0,2,0,2,5120,2361,447,4311,0
2,307,11,6,10,0,0,1,11,2,4,2,4,6,6,10,15,1,15,0,0,2,0,2,5120,2361,447,4312,0
17,322,127,75,83,2,11,30,129,4,14,7,14,18,21,61,87,2,175,9,0,2,1,1,5130,2365,448,4320,1
17,322,652,304,544,16,6,88,668,6,89,51,101,95,152,591,998,3,3399,188,0,2,1,1,5130,2366,448,4321,1
17,322,2,2,2,0,0,0,2,0,0,0,0,0,0,0,0,0,0,0,0,2,1,1,5130,2366,448,4321,1
17,322,8,5,5,0,0,3,8,0,0,0,0,0,0,0,0,0,0,0,0,2,1,1,5130,2366,448,4322,1
17,322,2,2,2,0,0,0,2,0,0,0,0,0,0,0,0,0,0,0,0,2,1,1,5130,2366,448,4322,1
17,322,14,8,8,0,0,6,14,0,0,0,0,0,0,0,0,0,0,0,0,2,1,1,5130,2366,448,4323,1
17,322,6,4,4,0,0,2,6,0,0,0,0,0,0,0,0,0,0,0,0,2,1,1,5130,2366,448,4324,1
17,322,6,4,4,0,0,2,6,1,2,1,2,3,3,2,4,0,2,0,0,2,1,1,5130,2366,448,4325,1
17,322,6,4,4,0,0,2,6,0,0,0,0,0,0,0,0,0,0,0,0,2,1,1,5130,2366,448,4326,1
17,322,7,5,5,0,0,2,7,0,0,0,0,0,0,0,0,0,0,0,0,2,1,1,5130,2366,448,4327,1
17,322,6,4,4,0,0,2,6,0,0,0,0,0,0,0,0,0,0,0,0,2,1,1,5130,2366,448,4328,1
17,322,10,6,6,0,0,4,10,0,0,0,0,0,0,0,0,0,0,0,0,2,1,1,5130,2366,448,4329,1
17,322,1,1,1,0,0,0,1,0,0,0,0,0,0,0,0,0,0,0,0,2,1,1,5130,2366,448,4329,1
17,322,14,10,10,0,0,4,14,1,1,1,1,2,2,0,2,0,1,0,0,2,1,1,5130,2366,448,4330,1
17,322,46,26,30,3,0,12,49,3,6,3,6,9,9,20,28,1,42,2,0,2,1,1,5140,2366,448,4331,1
2,307,42,7,35,4,0,5,46,1,2,1,2,3,3,2,4,0,2,0,0,2,2,2,5140,2366,448,4332,1
2,307,11,6,10,0,0,1,11,2,4,2,4,6,6,10,15,1,15,0,0,2,2,2,5140,2366,448,4333,1
2,307,42,7,35,4,0,5,46,1,2,1,2,3,3,2,4,0,2,0,0,2,1,2,5180,2382,452,4362,1
2,307,11,6,10,0,0,1,11,2,4,2,4,6,6,10,15,1,15,0,0,2,1,2,5180,2382,452,4363,1
57,1511,1513,682,1277,25,13,200,1538,11,199,116,219,210,335,1557,2584,6,15641,868,0,3,96,4,5220,2400,456,4392,1
57,1511,819,519,539,24,98,155,843,15,96,57,106,111,163,690,1107,8,9171,509,0,3,96,4,5230,2402,456,4393,1
38,1736,1513,682,1277,25,13,200,1538,11,199,116,219,210,335,1557,2584,6,15641,868,0,3,101,3,5230,2404,456,4394,1
74,1659,384,251,317,7,8,52,391,11,70,44,84,81,128,467,811,6,5355,297,0,2,1,1,5230,2404,456,4395,1
43,844,215,129,180,6,0,29,221,8,65,43,72,73,115,415,711,4,3153,175,0,0,183,0,5270,2420,460,4424,1
43,844,97,69,77,3,3,16,100,6,22,13,23,28,36,113,173,3,542,30,0,0,183,0,5270,2421,460,4425,1
12,379,15,9,9,0,0,6,15,0,0,0,0,0,0,0,0,0,0,0,0,0,80,0,5280,2425,461,4433,1
12,380,15,9,9,0,0,6,15,0,0,0,0,0,0,0,0,0,0,0,0,2,3,0,5300,2433,463,4449,1
2,299,42,7,35,4,0,5,46,1,2,1,2,3,3,2,4,0,2,0,0,2,7,10,5300,2435,463,4451,1
2,299,11,6,10,0,0,1,11,2,4,2,4,6,6,10,15,1,15,0,0,2,7,10,5300,2435,463,4452,1
176,3856,182,127,129,0,0,53,182,5,39,21,42,44,63,217,343,2,926,51,0,2,634,1,5330,2447,467,4474,1
176,3856,1165,710,800,67,119,181,1232,18,243,153,282,261,435,2000,3492,10,36473,2026,1,2,634,1,5340,2447,468,4475,1
75,1638,773,419,590,28,0,166,801,10,204,113,217,214,330,1598,2554,5,13587,754,0,2,2,1,5340,2450,470,4477,1
75,1638,421,273,302,44,34,57,465,17,81,59,107,98,166,583,1098,11,12329,684,0,2,2,1,5340,2450,471,4478,1
31,977,182,127,129,0,0,53,182,5,39,21,42,44,63,217,343,2,926,51,0,2,68,1,5340,2450,472,4479,1
101,3788,1392,870,1177,35,17,170,1427,14,494,280,531,508,811,4473,7289,7,54850,3047,2,2,1,1,5340,2453,473,4480,1
2,307,42,7,35,4,0,5,46,1,2,1,2,3,3,2,4,0,2,0,0,2,1,1,5350,2457,474,4488,1
2,307,11,6,10,0,0,1,11,2,4,2,4,6,6,10,15,1,15,0,0,2,1,1,5350,2457,474,4489,1
2,307,42,7,35,4,0,5,46,1,2,1,2,3,3,2,4,0,2,0,0,2,1,1,5360,2461,475,4497,1
2,307,11,6,10,0,0,1,11,2,4,2,4,6,6,10,15,1,15,0,0,2,1,1,5360,2461,475,4498,1
2,297,42,7,35,4,0,5,46,1,2,1,2,3,3,2,4,0,2,0,0,2,3,4,5370,2465,476,4506,0
2,297,11,6,10,0,0,1,11,2,4,2,4,6,6,10,15,1,15,0,0,2,3,4,5370,2465,476,4507,0
2,307,42,7,35,4,0,5,46,1,2,1,2,3,3,2,4,0,2,0,0,2,1,1,5380,2469,477,4515,0
2,307,11,6,10,0,0,1,11,2,4,2,4,6,6,10,15,1,15,0,0,2,1,1,5380,2469,477,4516,0
125,3182,1450,624,1228,12,26,181,1462,14,306,186,354,320,540,2580,4493,8,36391,2021,1,3,127,13,5400,2479,480,4531,1
182,3987,182,127,129,0,0,53,182,5,39,21,42,44,63,217,343,2,926,51,0,2,28,5,5400,2479,481,4532,1
182,3987,1165,710,800,67,119,181,1232,18,243,153,282,261,435,2000,3492,10,36473,2026,1,2,28,5,5410,2479,482,4533,1
37,828,1450,624,1228,12,26,181,1462,14,306,186,354,320,540,2580,4493,8,36391,2021,1,0,173,0,5410,2481,483,4534,1
33,1067,182,127,129,0,0,53,182,5,39,21,42,44,63,217,343,2,926,51,0,2,15,2,5410,2481,484,4535,1
101,3788,1392,870,1177,35,17,170,1427,14,494,280,531,508,811,4473,7289,7,54850,3047,2,2,2,2,5410,2484,485,4536,1
36,799,1450,624,1228,12,26,181,1462,14,306,186,354,320,540,2580,4493,8,36391,2021,1,2,0,10,5420,2500,490,4548,1
1,73,42,7,35,4,0,5,46,1,2,1,2,3,3,2,4,0,2,0,0,2,1,1,5440,2508,492,4563,1
1,73,11,6,10,0,0,1,11,2,4,2,4,6,6,10,15,1,15,0,0,2,1,1,5440,2508,492,4564,1
77,1723,1457,730,1242,11,6,188,1468,10,292,166,329,302,495,2424,4078,5,22973,1276,1,2,1,1,5470,2517,494,4587,1
77,1723,74,35,59,1,0,14,75,3,14,7,14,17,21,58,85,1,128,7,0,2,1,1,5470,2518,494,4588,1
77,1723,245,125,200,5,7,34,250,7,30,17,34,37,51,166,265,3,1053,58,0,2,1,1,5480,2519,494,4589,1
27,510,334,251,279,10,4,40,344,5,127,74,143,132,217,899,1528,2,4303,239,0,2,3,3,5480,2520,494,4590,1
14,690,334,251,279,10,4,40,344,5,127,74,143,132,217,899,1528,2,4303,239,0,2,2,2,5480,2521,494,4591,1
20,854,373,158,315,8,0,51,381,5,76,44,79,81,123,486,779,2,2026,112,0,2,1,11,5480,2521,494,4592,0
182,3979,182,127,129,0,0,53,182,5,39,21,42,44,63,217,343,2,926,51,0,2,2,2,5490,2525,496,4600,1
182,3979,1165,710,800,67,119,181,1232,18,243,153,282,261,435,2000,3492,10,36473,2026,1,2,2,2,5500,2525,497,4601,1
185,4091,182,127,129,0,0,53,182,5,39,21,42,44,63,217,343,2,926,51,0,2,34,21,5510,2531,500,4610,1
185,4091,1165,710,800,67,119,181,1232,18,243,153,282,261,435,2000,3492,10,36473,2026,1,2,34,21,5520,2531,501,4611,1
73,1622,773,419,590,28,0,166,801,10,204,113,217,214,330,1598,2554,5,13587,754,0,2,12,13,5520,2531,502,4612,1
73,1622,421,273,302,44,34,57,465,17,81,59,107,98,166,583,1098,11,12329,684,0,2,12,13,5520,2531,503,4613,1
37,841,1450,624,1228,12,26,181,1462,14,306,186,354,320,540,2580,4493,8,36391,2021,1,2,19,9,5520,2533,504,4614,1
34,1106,182,127,129,0,0,53,182,5,39,21,42,44,63,217,343,2,926,51,0,2,15,8,5520,2533,505,4615,1
101,3798,1392,870,1177,35,17,170,1427,14,494,280,531,508,811,4473,7289,7,54850,3047,2,2,10,16,5520,2536,506,4616,1
54,1866,773,419,590,28,0,166,801,10,204,113,217,214,330,1598,2554,5,13587,754,0,2,15,13,5520,2536,507,4617,1
57,1522,1513,682,1277,25,13,200,1538,11,199,116,219,210,335,1557,2584,6,15641,868,0,2,5,4,5520,2538,507,4618,1
57,1522,819,519,539,24,98,155,843,15,96,57,106,111,163,690,1107,8,9171,509,0,2,5,4,5530,2540,507,4619,1
131,2259,1338,495,1086,10,64,173,1348,11,122,82,157,133,239,883,1686,7,11934,663,0,2,3,2,5530,2542,507,4620,1
80,1742,1457,730,1242,11,6,188,1468,10,292,166,329,302,495,2424,4078,5,22973,1276,1,2,4,2,5530,2544,507,4621,1
80,1742,74,35,59,1,0,14,75,3,14,7,14,17,21,58,85,1,128,7,0,2,4,2,5530,2545,507,4622,1
80,1742,245,125,200,5,7,34,250,7,30,17,34,37,51,166,265,3,1053,58,0,2,4,2,5540,2546,507,4623,1
74,1711,384,251,317,7,8,52,391,11,70,44,84,81,128,467,811,6,5355,297,0,2,12,9,5540,2546,507,4624,1
185,4091,182,127,129,0,0,53,182,5,39,21,42,44,63,217,343,2,926,51,0,2,2,2,5550,2550,509,4632,0
185,4091,1165,710,800,67,119,181,1232,18,243,153,282,261,435,2000,3492,10,36473,2026,1,2,2,2,5560,2550,510,4633,0
73,1676,773,419,590,28,0,166,801,10,204,113,217,214,330,1598,2554,5,13587,754,0,2,13,0,5560,2550,511,4634,0
73,1676,421,273,302,44,34,57,465,17,81,59,107,98,166,583,1098,11,12329,684,0,2,13,0,5560,2550,512,4635,0
56,1928,773,419,590,28,0,166,801,10,204,113,217,214,330,1598,2554,5,13587,754,0,2,9,0,5560,2550,513,4636,0
127,3221,1450,624,1228,12,26,181,1462,14,306,186,354,320,540,2580,4493,8,36391,2021,1,2,45,33,5560,2552,514,4637,1
2,293,42,7,35,4,0,5,46,1,2,1,2,3,3,2,4,0,2,0,0,2,1,3,5560,2552,514,4638,0
2,293,11,6,10,0,0,1,11,2,4,2,4,6,6,10,15,1,15,0,0,2,1,3,5560,2552,514,4639,0
15,423,1450,624,1228,12,26,181,1462,14,306,186,354,320,540,2580,4493,8,36391,2021,1,0,76,0,5570,2558,516,4647,1
185,4091,182,127,129,0,0,53,182,5,39,21,42,44,63,217,343,2,926,51,0,2,4,4,5570,2558,517,4648,1
185,4091,1165,710,800,67,119,181,1232,18,243,153,282,261,435,2000,3492,10,36473,2026,1,2,4,4,5580,2558,518,4649,1
37,841,1450,624,1228,12,26,181,1462,14,306,186,354,320,540,2580,4493,8,36391,2021,1,2,1,1,5580,2560,519,4650,1
39,869,1450,624,1228,12,26,181,1462,14,306,186,354,320,540,2580,4493,8,36391,2021,1,2,11,3,5580,2562,520,4651,1
43,937,1450,624,1228,12,26,181,1462,14,306,186,354,320,540,2580,4493,8,36391,2021,1,2,16,0,5580,2564,521,4652,0
43,937,1450,624,1228,12,26,181,1462,14,306,186,354,320,540,2580,4493,8,36391,2021,1,2,16,0,5580,2566,522,4653,0
58,1569,1513,682,1277,25,13,200,1538,11,199,116,219,210,335,1557,2584,6,15641,868,0,2,21,15,5590,2572,523,4661,1
58,1569,819,519,539,24,98,155,843,15,96,57,106,111,163,690,1107,8,9171,509,0,2,21,15,5600,2574,523,4662,1
47,1955,1513,682,1277,25,13,200,1538,11,199,116,219,210,335,1557,2584,6,15641,868,0,2,122,93,5600,2576,523,4663,1
101,3809,1392,870,1177,35,17,170,1427,14,494,280,531,508,811,4473,7289,7,54850,3047,2,2,10,7,5600,2579,524,4664,1
15,439,1450,624,1228,12,26,181,1462,14,306,186,354,320,540,2580,4493,8,36391,2021,1,2,3,0,5600,2581,525,4665,0
102,3827,1392,870,1177,35,17,170,1427,14,494,280,531,508,811,4473,7289,7,54850,3047,2,2,9,5,5600,2584,526,4666,0
73,1676,773,419,590,28,0,166,801,10,204,113,217,214,330,1598,2554,5,13587,754,0,2,1,1,5610,2588,528,4674,1
73,1676,421,273,302,44,34,57,465,17,81,59,107,98,166,583,1098,11,12329,684,0,2,1,1,5610,2588,529,4675,1
6,256,207,111,150,11,0,50,218,5,26,19,36,31,55,133,272,3,943,52,0,2,1,1,5610,2588,529,4676,1
6,256,410,198,237,31,55,97,441,11,63,38,72,74,110,414,683,6,4293,238,0,2,1,1,5620,2589,530,4677,1
19,282,477,336,357,30,23,73,507,16,194,134,250,210,384,1538,2962,10,30538,1696,0,2,1,1,5630,2590,530,4678,1
4,227,207,111,150,11,0,50,218,5,26,19,36,31,55,133,272,3,943,52,0,2,1,1,5630,2590,530,4679,1
34,1912,1457,730,1242,11,6,188,1468,10,292,166,329,302,495,2424,4078,5,22973,1276,1,2,2,2,5630,2592,530,4680,1
29,1459,384,251,317,7,8,52,391,11,70,44,84,81,128,467,811,6,5355,297,0,2,1,1,5630,2592,530,4681,1
20,856,373,158,315,8,0,51,381,5,76,44,79,81,123,486,779,2,2026,112,0,2,1,1,5630,2592,530,4682,1
12,284,1523,757,1297,19,12,193,1542,12,193,117,230,205,347,1508,2664,7,19053,1058,0,2,1,1,5640,2594,530,4683,1
12,284,701,378,504,33,58,109,734,13,110,68,126,123,194,794,1346,7,10027,557,0,2,1,1,5640,2595,531,4684,1
9,518,1289,550,1043,56,32,155,1345,10,167,93,185,177,278,1266,2075,5,11498,638,0,2,9,9,5640,2597,532,4685,1
29,1459,384,251,317,7,8,52,391,11,70,44,84,81,128,467,811,6,5355,297,0,2,4,4,5640,2597,532,4686,1
15,432,1450,624,1228,12,26,181,1462,14,306,186,354,320,540,2580,4493,8,36391,2021,1,2,1,5,5640,2599,533,4687,0
6,282,207,111,150,11,0,50,218,5,26,19,36,31,55,133,272,3,943,52,0,2,6,1,5660,2607,535,4702,1
6,282,410,198,237,31,55,97,441,11,63,38,72,74,110,414,683,6,4293,238,0,2,6,1,5670,2608,536,4703,1
11,497,127,75,83,2,11,30,129,4,14,7,14,18,21,61,87,2,175,9,0,0,71,0,5680,2612,537,4711,1
11,497,652,304,544,16,6,88,668,6,89,51,101,95,152,591,998,3,3399,188,0,0,71,0,5680,2613,537,4712,1
11,497,2,2,2,0,0,0,2,0,0,0,0,0,0,0,0,0,0,0,0,0,71,0,5680,2613,537,4712,1
11,497,8,5,5,0,0,3,8,0,0,0,0,0,0,0,0,0,0,0,0,0,71,0,5680,2613,537,4713,1
11,497,2,2,2,0,0,0,2,0,0,0,0,0,0,0,0,0,0,0,0,0,71,0,5680,2613,537,4713,1
11,497,14,8,8,0,0,6,14,0,0,0,0,0,0,0,0,0,0,0,0,0,71,0,5680,2613,537,4714,1
11,497,6,4,4,0,0,2,6,0,0,0,0,0,0,0,0,0,0,0,0,0,71,0,5680,2613,537,4715,1
11,497,6,4,4,0,0,2,6,1,2,1,2,3,3,2,4,0,2,0,0,0,71,0,5680,2613,537,4716,1
11,497,6,4,4,0,0,2,6,0,0,0,0,0,0,0,0,0,0,0,0,0,71,0,5680,2613,537,4717,1
11,497,7,5,5,0,0,2,7,0,0,0,0,0,0,0,0,0,0,0,0,0,71,0,5680,2613,537,4718,1
11,497,6,4,4,0,0,2,6,0,0,0,0,0,0,0,0,0,0,0,0,0,71,0,5680,2613,537,4719,1
11,497,10,6,6,0,0,4,10,0,0,0,0,0,0,0,0,0,0,0,0,0,71,0,5680,2613,537,4720,1
11,497,1,1,1,0,0,0,1,0,0,0,0,0,0,0,0,0,0,0,0,0,71,0,5680,2613,537,4720,1
11,497,14,10,10,0,0,4,14,1,1,1,1,2,2,0,2,0,1,0,0,0,71,0,5680,2613,537,4721,1
11,497,46,26,30,3,0,12,49,3,6,3,6,9,9,20,28,1,42,2,0,0,71,0,5690,2613,537,4722,1
36,512,282,196,195,3,0,86,285,8,130,71,141,138,212,936,1507,4,6538,363,0,2,2,2,5690,2613,538,4723,0
65,1702,1513,682,1277,25,13,200,1538,11,199,116,219,210,335,1557,2584,6,15641,868,0,2,28,4,5720,2624,540,4752,1
65,1702,819,519,539,24,98,155,843,15,96,57,106,111,163,690,1107,8,9171,509,0,2,28,4,5730,2626,540,4753,1
43,852,215,129,180,6,0,29,221,8,65,43,72,73,115,415,711,4,3153,175,0,2,18,17,5730,2626,540,4754,1
43,852,97,69,77,3,3,16,100,6,22,13,23,28,36,113,173,3,542,30,0,2,18,17,5730,2627,540,4755,1
133,2262,1338,495,1086,10,64,173,1348,11,122,82,157,133,239,883,1686,7,11934,663,0,2,1,1,5730,2629,540,4756,1
6,261,207,111,150,11,0,50,218,5,26,19,36,31,55,133,272,3,943,52,0,2,1,6,5730,2629,540,4757,1
6,261,410,198,237,31,55,97,441,11,63,38,72,74,110,414,683,6,4293,238,0,2,1,6,5740,2630,541,4758,1
73,1676,773,419,590,28,0,166,801,10,204,113,217,214,330,1598,2554,5,13587,754,0,2,1,1,5760,2638,544,4773,0
73,1676,421,273,302,44,34,57,465,17,81,59,107,98,166,583,1098,11,12329,684,0,2,1,1,5760,2638,545,4774,0
185,4092,182,127,129,0,0,53,182,5,39,21,42,44,63,217,343,2,926,51,0,2,1,4,5850,2673,555,4833,1
185,4092,1165,710,800,67,119,181,1232,18,243,153,282,261,435,2000,3492,10,36473,2026,1,2,1,4,5860,2673,556,4834,1
102,3828,1392,870,1177,35,17,170,1427,14,494,280,531,508,811,4473,7289,7,54850,3047,2,2,1,4,5860,2676,557,4835,1
9,526,1289,550,1043,56,32,155,1345,10,167,93,185,177,278,1266,2075,5,11498,638,0,2,15,11,5860,2678,558,4836,1
73,1670,773,419,590,28,0,166,801,10,204,113,217,214,330,1598,2554,5,13587,754,0,2,2,3,5880,2686,561,4851,1
73,1670,421,273,302,44,34,57,465,17,81,59,107,98,166,583,1098,11,12329,684,0,2,2,3,5880,2686,562,4852,1
11,515,127,75,83,2,11,30,129,4,14,7,14,18,21,61,87,2,175,9,0,2,7,5,5880,2686,562,4853,1
11,515,652,304,544,16,6,88,668,6,89,51,101,95,152,591,998,3,3399,188,0,2,7,5,5880,2687,562,4854,1
11,515,2,2,2,0,0,0,2,0,0,0,0,0,0,0,0,0,0,0,0,2,7,5,5880,2687,562,4854,1
11,515,8,5,5,0,0,3,8,0,0,0,0,0,0,0,0,0,0,0,0,2,7,5,5880,2687,562,4855,1
11,515,2,2,2,0,0,0,2,0,0,0,0,0,0,0,0,0,0,0,0,2,7,5,5880,2687,562,4855,1
11,515,14,8,8,0,0,6,14,0,0,0,0,0,0,0,0,0,0,0,0,2,7,5,5880,2687,562,4856,1
11,515,6,4,4,0,0,2,6,0,0,0,0,0,0,0,0,0,0,0,0,2,7,5,5880,2687,562,4857,1
11,515,6,4,4,0,0,2,6,1,2,1,2,3,3,2,4,0,2,0,0,2,7,5,5880,2687,562,4858,1
11,515,6,4,4,0,0,2,6,0,0,0,0,0,0,0,0,0,0,0,0,2,7,5,5880,2687,562,4859,1
11,515,7,5,5,0,0,2,7,0,0,0,0,0,0,0,0,0,0,0,0,2,7,5,5880,2687,562,4860,1
11,515,6,4,4,0,0,2,6,0,0,0,0,0,0,0,0,0,0,0,0,2,7,5,5880,2687,562,4861,1
11,515,10,6,6,0,0,4,10,0,0,0,0,0,0,0,0,0,0,0,0,2,7,5,5880,2687,562,4862,1
11,515,1,1,1,0,0,0,1,0,0,0,0,0,0,0,0,0,0,0,0,2,7,5,5880,2687,562,4862,1
11,515,14,10,10,0,0,4,14,1,1,1,1,2,2,0,2,0,1,0,0,2,7,5,5880,2687,562,4863,1
11,515,46,26,30,3,0,12,49,3,6,3,6,9,9,20,28,1,42,2,0,2,7,5,5890,2687,562,4864,1
74,1693,773,419,590,28,0,166,801,10,204,113,217,214,330,1598,2554,5,13587,754,0,2,9,1,5890,2687,563,4865,0
74,1693,421,273,302,44,34,57,465,17,81,59,107,98,166,583,1098,11,12329,684,0,2,9,1,5890,2687,564,4866,0
17,326,127,75,83,2,11,30,129,4,14,7,14,18,21,61,87,2,175,9,0,3,1,1,5900,2691,565,4874,1
17,326,652,304,544,16,6,88,668,6,89,51,101,95,152,591,998,3,3399,188,0,3,1,1,5900,2692,565,4875,1
17,326,2,2,2,0,0,0,2,0,0,0,0,0,0,0,0,0,0,0,0,3,1,1,5900,2692,565,4875,1
17,326,8,5,5,0,0,3,8,0,0,0,0,0,0,0,0,0,0,0,0,3,1,1,5900,2692,565,4876,1
17,326,2,2,2,0,0,0,2,0,0,0,0,0,0,0,0,0,0,0,0,3,1,1,5900,2692,565,4876,1
17,326,14,8,8,0,0,6,14,0,0,0,0,0,0,0,0,0,0,0,0,3,1,1,5900,2692,565,4877,1
17,326,6,4,4,0,0,2,6,0,0,0,0,0,0,0,0,0,0,0,0,3,1,1,5900,2692,565,4878,1
17,326,6,4,4,0,0,2,6,1,2,1,2,3,3,2,4,0,2,0,0,3,1,1,5900,2692,565,4879,1
17,326,6,4,4,0,0,2,6,0,0,0,0,0,0,0,0,0,0,0,0,3,1,1,5900,2692,565,4880,1
17,326,7,5,5,0,0,2,7,0,0,0,0,0,0,0,0,0,0,0,0,3,1,1,5900,2692,565,4881,1
17,326,6,4,4,0,0,2,6,0,0,0,0,0,0,0,0,0,0,0,0,3,1,1,5900,2692,565,4882,1
17,326,10,6,6,0,0,4,10,0,0,0,0,0,0,0,0,0,0,0,0,3,1,1,5900,2692,565,4883,1
17,326,1,1,1,0,0,0,1,0,0,0,0,0,0,0,0,0,0,0,0,3,1,1,5900,2692,565,4883,1
17,326,14,10,10,0,0,4,14,1,1,1,1,2,2,0,2,0,1,0,0,3,1,1,5900,2692,565,4884,1
17,326,46,26,30,3,0,12,49,3,6,3,6,9,9,20,28,1,42,2,0,3,1,1,5910,2692,565,4885,1
7,111,44,19,17,0,16,11,44,3,14,7,14,17,21,58,85,1,128,7,0,2,1,1,5910,2692,565,4886,1
2,29,127,75,83,2,11,30,129,4,14,7,14,18,21,61,87,2,175,9,0,2,1,1,5910,2692,565,4887,1
2,29,652,304,544,16,6,88,668,6,89,51,101,95,152,591,998,3,3399,188,0,2,1,1,5910,2693,565,4888,1
2,29,2,2,2,0,0,0,2,0,0,0,0,0,0,0,0,0,0,0,0,2,1,1,5910,2693,565,4888,1
2,29,8,5,5,0,0,3,8,0,0,0,0,0,0,0,0,0,0,0,0,2,1,1,5910,2693,565,4889,1
2,29,2,2,2,0,0,0,2,0,0,0,0,0,0,0,0,0,0,0,0,2,1,1,5910,2693,565,4889,1
2,29,14,8,8,0,0,6,14,0,0,0,0,0,0,0,0,0,0,0,0,2,1,1,5910,2693,565,4890,1
2,29,6,4,4,0,0,2,6,0,0,0,0,0,0,0,0,0,0,0,0,2,1,1,5910,2693,565,4891,1
2,29,6,4,4,0,0,2,6,1,2,1,2,3,3,2,4,0,2,0,0,2,1,1,5910,2693,565,4892,1
2,29,6,4,4,0,0,2,6,0,0,0,0,0,0,0,0,0,0,0,0,2,1,1,5910,2693,565,4893,1
2,29,7,5,5,0,0,2,7,0,0,0,0,0,0,0,0,0,0,0,0,2,1,1,5910,2693,565,4894,1
2,29,6,4,4,0,0,2,6,0,0,0,0,0,0,0,0,0,0,0,0,2,1,1,5910,2693,565,4895,1
2,29,10,6,6,0,0,4,10,0,0,0,0,0,0,0,0,0,0,0,0,2,1,1,5910,2693,565,4896,1
2,29,1,1,1,0,0,0,1,0,0,0,0,0,0,0,0,0,0,0,0,2,1,1,5910,2693,565,4896,1
2,29,14,10,10,0,0,4,14,1,1,1,1,2,2,0,2,0,1,0,0,2,1,1,5910,2693,565,4897,1
2,29,46,26,30,3,0,12,49,3,6,3,6,9,9,20,28,1,42,2,0,2,1,1,5920,2693,565,4898,1
6,108,127,75,83,2,11,30,129,4,14,7,14,18,21,61,87,2,175,9,0,2,1,1,5920,2693,565,4899,1
6,108,652,304,544,16,6,88,668,6,89,51,101,95,152,591,998,3,3399,188,0,2,1,1,5920,2694,565,4900,1
6,108,2,2,2,0,0,0,2,0,0,0,0,0,0,0,0,0,0,0,0,2,1,1,5920,2694,565,4900,1
6,108,8,5,5,0,0,3,8,0,0,0,0,0,0,0,0,0,0,0,0,2,1,1,5920,2694,565,4901,1
6,108,2,2,2,0,0,0,2,0,0,0,0,0,0,0,0,0,0,0,0,2,1,1,5920,2694,565,4901,1
6,108,14,8,8,0,0,6,14,0,0,0,0,0,0,0,0,0,0,0,0,2,1,1,5920,2694,565,4902,1
6,108,6,4,4,0,0,2,6,0,0,0,0,0,0,0,0,0,0,0,0,2,1,1,5920,2694,565,4903,1
6,108,6,4,4,0,0,2,6,1,2,1,2,3,3,2,4,0,2,0,0,2,1,1,5920,2694,565,4904,1
6,108,6,4,4,0,0,2,6,0,0,0,0,0,0,0,0,0,0,0,0,2,1,1,5920,2694,565,4905,1
6,108,7,5,5,0,0,2,7,0,0,0,0,0,0,0,0,0,0,0,0,2,1,1,5920,2694,565,4906,1
6,108,6,4,4,0,0,2,6,0,0,0,0,0,0,0,0,0,0,0,0,2,1,1,5920,2694,565,4907,1
6,108,10,6,6,0,0,4,10,0,0,0,0,0,0,0,0,0,0,0,0,2,1,1,5920,2694,565,4908,1
6,108,1,1,1,0,0,0,1,0,0,0,0,0,0,0,0,0,0,0,0,2,1,1,5920,2694,565,4908,1
6,108,14,10,10,0,0,4,14,1,1,1,1,2,2,0,2,0,1,0,0,2,1,1,5920,2694,565,4909,1
6,108,46,26,30,3,0,12,49,3,6,3,6,9,9,20,28,1,42,2,0,2,1,1,5930,2694,565,4910,1
7,169,127,75,83,2,11,30,129,4,14,7,14,18,21,61,87,2,175,9,0,3,10,4,6080,2759,584,5035,1
7,169,652,304,544,16,6,88,668,6,89,51,101,95,152,591,998,3,3399,188,0,3,10,4,6080,2760,584,5036,1
7,169,2,2,2,0,0,0,2,0,0,0,0,0,0,0,0,0,0,0,0,3,10,4,6080,2760,584,5036,1
7,169,8,5,5,0,0,3,8,0,0,0,0,0,0,0,0,0,0,0,0,3,10,4,6080,2760,584,5037,1
7,169,2,2,2,0,0,0,2,0,0,0,0,0,0,0,0,0,0,0,0,3,10,4,6080,2760,584,5037,1
7,169,14,8,8,0,0,6,14,0,0,0,0,0,0,0,0,0,0,0,0,3,10,4,6080,2760,584,5038,1
7,169,6,4,4,0,0,2,6,0,0,0,0,0,0,0,0,0,0,0,0,3,10,4,6080,2760,584,5039,1
7,169,6,4,4,0,0,2,6,1,2,1,2,3,3,2,4,0,2,0,0,3,10,4,6080,2760,584,5040,1
7,169,6,4,4,0,0,2,6,0,0,0,0,0,0,0,0,0,0,0,0,3,10,4,6080,2760,584,5041,1
7,169,7,5,5,0,0,2,7,0,0,0,0,0,0,0,0,0,0,0,0,3,10,4,6080,2760,584,5042,1
7,169,6,4,4,0,0,2,6,0,0,0,0,0,0,0,0,0,0,0,0,3,10,4,6080,2760,584,5043,1
7,169,10,6,6,0,0,4,10,0,0,0,0,0,0,0,0,0,0,0,0,3,10,4,6080,2760,584,5044,1
7,169,1,1,1,0,0,0,1,0,0,0,0,0,0,0,0,0,0,0,0,3,10,4,6080,2760,584,5044,1
7,169,14,10,10,0,0,4,14,1,1,1,1,2,2,0,2,0,1,0,0,3,10,4,6080,2760,584,5045,1
7,169,46,26,30,3,0,12,49,3,6,3,6,9,9,20,28,1,42,2,0,3,10,4,6090,2760,584,5046,1
1,71,42,7,35,4,0,5,46,1,2,1,2,3,3,2,4,0,2,0,0,0,11,0,6100,2767,585,5059,1
1,71,11,6,10,0,0,1,11,2,4,2,4,6,6,10,15,1,15,0,0,0,11,0,6100,2767,585,5060,1
2,223,42,7,35,4,0,5,46,1,2,1,2,3,3,2,4,0,2,0,0,2,5,39,6120,2775,587,5075,1
2,223,11,6,10,0,0,1,11,2,4,2,4,6,6,10,15,1,15,0,0,2,5,39,6120,2775,587,5076,1
186,4149,182,127,129,0,0,53,182,5,39,21,42,44,63,217,343,2,926,51,0,2,12,10,6120,2775,588,5077,0
186,4149,1165,710,800,67,119,181,1232,18,243,153,282,261,435,2000,3492,10,36473,2026,1,2,12,10,6130,2775,589,5078,0
34,1110,182,127,129,0,0,53,182,5,39,21,42,44,63,217,343,2,926,51,0,2,1,1,6130,2775,590,5079,0
11,269,127,75,83,2,11,30,129,4,14,7,14,18,21,61,87,2,175,9,0,0,46,0,6130,2775,590,5080,0
11,269,652,304,544,16,6,88,668,6,89,51,101,95,152,591,998,3,3399,188,0,0,46,0,6130,2776,590,5081,0
11,269,2,2,2,0,0,0,2,0,0,0,0,0,0,0,0,0,0,0,0,0,46,0,6130,2776,590,5081,0
11,269,8,5,5,0,0,3,8,0,0,0,0,0,0,0,0,0,0,0,0,0,46,0,6130,2776,590,5082,0
11,269,2,2,2,0,0,0,2,0,0,0,0,0,0,0,0,0,0,0,0,0,46,0,6130,2776,590,5082,0
11,269,14,8,8,0,0,6,14,0,0,0,0,0,0,0,0,0,0,0,0,0,46,0,6130,2776,590,5083,0
11,269,6,4,4,0,0,2,6,0,0,0,0,0,0,0,0,0,0,0,0,0,46,0,6130,2776,590,5084,0
11,269,6,4,4,0,0,2,6,1,2,1,2,3,3,2,4,0,2,0,0,0,46,0,6130,2776,590,5085,0
11,269,6,4,4,0,0,2,6,0,0,0,0,0,0,0,0,0,0,0,0,0,46,0,6130,2776,590,5086,0
11,269,7,5,5,0,0,2,7,0,0,0,0,0,0,0,0,0,0,0,0,0,46,0,6130,2776,590,5087,0
11,269,6,4,4,0,0,2,6,0,0,0,0,0,0,0,0,0,0,0,0,0,46,0,6130,2776,590,5088,0
11,269,10,6,6,0,0,4,10,0,0,0,0,0,0,0,0,0,0,0,0,0,46,0,6130,2776,590,5089,0
11,269,1,1,1,0,0,0,1,0,0,0,0,0,0,0,0,0,0,0,0,0,46,0,6130,2776,590,5089,0
11,269,14,10,10,0,0,4,14,1,1,1,1,2,2,0,2,0,1,0,0,0,46,0,6130,2776,590,5090,0
11,269,46,26,30,3,0,12,49,3,6,3,6,9,9,20,28,1,42,2,0,0,46,0,6140,2776,590,5091,0
40,353,647,139,84,35,284,233,682,0,0,0,0,0,0,0,0,0,0,0,0,2,9,0,6140,2776,590,5092,0
11,269,127,75,83,2,11,30,129,4,14,7,14,18,21,61,87,2,175,9,0,2,1,1,6140,2776,590,5093,1
11,269,652,304,544,16,6,88,668,6,89,51,101,95,152,591,998,3,3399,188,0,2,1,1,6140,2777,590,5094,1
11,269,2,2,2,0,0,0,2,0,0,0,0,0,0,0,0,0,0,0,0,2,1,1,6140,2777,590,5094,1
11,269,8,5,5,0,0,3,8,0,0,0,0,0,0,0,0,0,0,0,0,2,1,1,6140,2777,590,5095,1
11,269,2,2,2,0,0,0,2,0,0,0,0,0,0,0,0,0,0,0,0,2,1,1,6140,2777,590,5095,1
11,269,14,8,8,0,0,6,14,0,0,0,0,0,0,0,0,0,0,0,0,2,1,1,6140,2777,590,5096,1
11,269,6,4,4,0,0,2,6,0,0,0,0,0,0,0,0,0,0,0,0,2,1,1,6140,2777,590,5097,1
11,269,6,4,4,0,0,2,6,1,2,1,2,3,3,2,4,0,2,0,0,2,1,1,6140,2777,590,5098,1
11,269,6,4,4,0,0,2,6,0,0,0,0,0,0,0,0,0,0,0,0,2,1,1,6140,2777,590,5099,1
11,269,7,5,5,0,0,2,7,0,0,0,0,0,0,0,0,0,0,0,0,2,1,1,6140,2777,590,5100,1
11,269,6,4,4,0,0,2,6,0,0,0,0,0,0,0,0,0,0,0,0,2,1,1,6140,2777,590,5101,1
11,269,10,6,6,0,0,4,10,0,0,0,0,0,0,0,0,0,0,0,0,2,1,1,6140,2777,590,5102,1
11,269,1,1,1,0,0,0,1,0,0,0,0,0,0,0,0,0,0,0,0,2,1,1,6140,2777,590,5102,1
11,269,14,10,10,0,0,4,14,1,1,1,1,2,2,0,2,0,1,0,0,2,1,1,6140,2777,590,5103,1
11,269,46,26,30,3,0,12,49,3,6,3,6,9,9,20,28,1,42,2,0,2,1,1,6150,2777,590,5104,1
11,269,127,75,83,2,11,30,129,4,14,7,14,18,21,61,87,2,175,9,0,2,1,1,6150,2777,590,5105,1
11,269,652,304,544,16,6,88,668,6,89,51,101,95,152,591,998,3,3399,188,0,2,1,1,6150,2778,590,5106,1
11,269,2,2,2,0,0,0,2,0,0,0,0,0,0,0,0,0,0,0,0,2,1,1,6150,2778,590,5106,1
11,269,8,5,5,0,0,3,8,0,0,0,0,0,0,0,0,0,0,0,0,2,1,1,6150,2778,590,5107,1
11,269,2,2,2,0,0,0,2,0,0,0,0,0,0,0,0,0,0,0,0,2,1,1,6150,2778,590,5107,1
11,269,14,8,8,0,0,6,14,0,0,0,0,0,0,0,0,0,0,0,0,2,1,1,6150,2778,590,5108,1
11,269,6,4,4,0,0,2,6,0,0,0,0,0,0,0,0,0,0,0,0,2,1,1,6150,2778,590,5109,1
11,269,6,4,4,0,0,2,6,1,2,1,2,3,3,2,4,0,2,0,0,2,1,1,6150,2778,590,5110,1
11,269,6,4,4,0,0,2,6,0,0,0,0,0,0,0,0,0,0,0,0,2,1,1,6150,2778,590,5111,1
11,269,7,5,5,0,0,2,7,0,0,0,0,0,0,0,0,0,0,0,0,2,1,1,6150,2778,590,5112,1
11,269,6,4,4,0,0,2,6,0,0,0,0,0,0,0,0,0,0,0,0,2,1,1,6150,2778,590,5113,1
11,269,10,6,6,0,0,4,10,0,0,0,0,0,0,0,0,0,0,0,0,2,1,1,6150,2778,590,5114,1
11,269,1,1,1,0,0,0,1,0,0,0,0,0,0,0,0,0,0,0,0,2,1,1,6150,2778,590,5114,1
11,269,14,10,10,0,0,4,14,1,1,1,1,2,2,0,2,0,1,0,0,2,1,1,6150,2778,590,5115,1
11,269,46,26,30,3,0,12,49,3,6,3,6,9,9,20,28,1,42,2,0,2,1,1,6160,2778,590,5116,1
3,58,127,75,83,2,11,30,129,4,14,7,14,18,21,61,87,2,175,9,0,0,7,0,6160,2778,590,5117,1
3,58,652,304,544,16,6,88,668,6,89,51,101,95,152,591,998,3,3399,188,0,0,7,0,6160,2779,590,5118,1
3,58,2,2,2,0,0,0,2,0,0,0,0,0,0,0,0,0,0,0,0,0,7,0,6160,2779,590,5118,1
3,58,8,5,5,0,0,3,8,0,0,0,0,0,0,0,0,0,0,0,0,0,7,0,6160,2779,590,5119,1
3,58,2,2,2,0,0,0,2,0,0,0,0,0,0,0,0,0,0,0,0,0,7,0,6160,2779,590,5119,1
3,58,14,8,8,0,0,6,14,0,0,0,0,0,0,0,0,0,0,0,0,0,7,0,6160,2779,590,5120,1
3,58,6,4,4,0,0,2,6,0,0,0,0,0,0,0,0,0,0,0,0,0,7,0,6160,2779,590,5121,1
3,58,6,4,4,0,0,2,6,1,2,1,2,3,3,2,4,0,2,0,0,0,7,0,6160,2779,590,5122,1
3,58,6,4,4,0,0,2,6,0,0,0,0,0,0,0,0,0,0,0,0,0,7,0,6160,2779,590,5123,1
3,58,7,5,5,0,0,2,7,0,0,0,0,0,0,0,0,0,0,0,0,0,7,0,6160,2779,590,5124,1
3,58,6,4,4,0,0,2,6,0,0,0,0,0,0,0,0,0,0,0,0,0,7,0,6160,2779,590,5125,1
3,58,10,6,6,0,0,4,10,0,0,0,0,0,0,0,0,0,0,0,0,0,7,0,6160,2779,590,5126,1
3,58,1,1,1,0,0,0,1,0,0,0,0,0,0,0,0,0,0,0,0,0,7,0,6160,2779,590,5126,1
3,58,14,10,10,0,0,4,14,1,1,1,1,2,2,0,2,0,1,0,0,0,7,0,6160,2779,590,5127,1
3,58,46,26,30,3,0,12,49,3,6,3,6,9,9,20,28,1,42,2,0,0,7,0,6170,2779,590,5128,1
1,9,2,2,2,0,0,0,2,0,0,0,0,0,0,0,0,0,0,0,0,0,5,0,6170,2779,590,5128,1
3,65,127,75,83,2,11,30,129,4,14,7,14,18,21,61,87,2,175,9,0,0,15,0,6170,2779,590,5129,1
3,65,652,304,544,16,6,88,668,6,89,51,101,95,152,591,998,3,3399,188,0,0,15,0,6170,2780,590,5130,1
3,65,2,2,2,0,0,0,2,0,0,0,0,0,0,0,0,0,0,0,0,0,15,0,6170,2780,590,5130,1
3,65,8,5,5,0,0,3,8,0,0,0,0,0,0,0,0,0,0,0,0,0,15,0,6170,2780,590,5131,1
3,65,2,2,2,0,0,0,2,0,0,0,0,0,0,0,0,0,0,0,0,0,15,0,6170,2780,590,5131,1
3,65,14,8,8,0,0,6,14,0,0,0,0,0,0,0,0,0,0,0,0,0,15,0,6170,2780,590,5132,1
3,65,6,4,4,0,0,2,6,0,0,0,0,0,0,0,0,0,0,0,0,0,15,0,6170,2780,590,5133,1
3,65,6,4,4,0,0,2,6,1,2,1,2,3,3,2,4,0,2,0,0,0,15,0,6170,2780,590,5134,1
3,65,6,4,4,0,0,2,6,0,0,0,0,0,0,0,0,0,0,0,0,0,15,0,6170,2780,590,5135,1
3,65,7,5,5,0,0,2,7,0,0,0,0,0,0,0,0,0,0,0,0,0,15,0,6170,2780,590,5136,1
3,65,6,4,4,0,0,2,6,0,0,0,0,0,0,0,0,0,0,0,0,0,15,0,6170,2780,590,5137,1
3,65,10,6,6,0,0,4,10,0,0,0,0,0,0,0,0,0,0,0,0,0,15,0,6170,2780,590,5138,1
3,65,1,1,1,0,0,0,1,0,0,0,0,0,0,0,0,0,0,0,0,0,15,0,6170,2780,590,5138,1
3,65,14,10,10,0,0,4,14,1,1,1,1,2,2,0,2,0,1,0,0,0,15,0,6170,2780,590,5139,1
3,65,46,26,30,3,0,12,49,3,6,3,6,9,9,20,28,1,42,2,0,0,15,0,6180,2780,590,5140,1
56,1928,773,419,590,28,0,166,801,10,204,113,217,214,330,1598,2554,5,13587,754,0,2,5,5,6180,2780,591,5141,1
12,380,15,9,9,0,0,6,15,0,0,0,0,0,0,0,0,0,0,0,0,2,1,1,6180,2780,591,5142,0
12,380,15,9,9,0,0,6,15,0,0,0,0,0,0,0,0,0,0,0,0,2,1,1,6180,2780,591,5143,0
19,349,127,75,83,2,11,30,129,4,14,7,14,18,21,61,87,2,175,9,0,2,6,3,6180,2780,591,5144,1
19,349,652,304,544,16,6,88,668,6,89,51,101,95,152,591,998,3,3399,188,0,2,6,3,6180,2781,591,5145,1
19,349,2,2,2,0,0,0,2,0,0,0,0,0,0,0,0,0,0,0,0,2,6,3,6180,2781,591,5145,1
19,349,8,5,5,0,0,3,8,0,0,0,0,0,0,0,0,0,0,0,0,2,6,3,6180,2781,591,5146,1
19,349,2,2,2,0,0,0,2,0,0,0,0,0,0,0,0,0,0,0,0,2,6,3,6180,2781,591,5146,1
19,349,14,8,8,0,0,6,14,0,0,0,0,0,0,0,0,0,0,0,0,2,6,3,6180,2781,591,5147,1
19,349,6,4,4,0,0,2,6,0,0,0,0,0,0,0,0,0,0,0,0,2,6,3,6180,2781,591,5148,1
19,349,6,4,4,0,0,2,6,1,2,1,2,3,3,2,4,0,2,0,0,2,6,3,6180,2781,591,5149,1
19,349,6,4,4,0,0,2,6,0,0,0,0,0,0,0,0,0,0,0,0,2,6,3,6180,2781,591,5150,1
19,349,7,5,5,0,0,2,7,0,0,0,0,0,0,0,0,0,0,0,0,2,6,3,6180,2781,591,5151,1
19,349,6,4,4,0,0,2,6,0,0,0,0,0,0,0,0,0,0,0,0,2,6,3,6180,2781,591,5152,1
19,349,10,6,6,0,0,4,10,0,0,0,0,0,0,0,0,0,0,0,0,2,6,3,6180,2781,591,5153,1
19,349,1,1,1,0,0,0,1,0,0,0,0,0,0,0,0,0,0,0,0,2,6,3,6180,2781,591,5153,1
19,349,14,10,10,0,0,4,14,1,1,1,1,2,2,0,2,0,1,0,0,2,6,3,6180,2781,591,5154,1
19,349,46,26,30,3,0,12,49,3,6,3,6,9,9,20,28,1,42,2,0,2,6,3,6190,2781,591,5155,1
6,106,127,75,83,2,11,30,129,4,14,7,14,18,21,61,87,2,175,9,0,2,1,1,6190,2781,591,5156,1
6,106,652,304,544,16,6,88,668,6,89,51,101,95,152,591,998,3,3399,188,0,2,1,1,6190,2782,591,5157,1
6,106,2,2,2,0,0,0,2,0,0,0,0,0,0,0,0,0,0,0,0,2,1,1,6190,2782,591,5157,1
6,106,8,5,5,0,0,3,8,0,0,0,0,0,0,0,0,0,0,0,0,2,1,1,6190,2782,591,5158,1
6,106,2,2,2,0,0,0,2,0,0,0,0,0,0,0,0,0,0,0,0,2,1,1,6190,2782,591,5158,1
6,106,14,8,8,0,0,6,14,0,0,0,0,0,0,0,0,0,0,0,0,2,1,1,6190,2782,591,5159,1
6,106,6,4,4,0,0,2,6,0,0,0,0,0,0,0,0,0,0,0,0,2,1,1,6190,2782,591,5160,1
6,106,6,4,4,0,0,2,6,1,2,1,2,3,3,2,4,0,2,0,0,2,1,1,6190,2782,591,5161,1
6,106,6,4,4,0,0,2,6,0,0,0,0,0,0,0,0,0,0,0,0,2,1,1,6190,2782,591,5162,1
6,106,7,5,5,0,0,2,7,0,0,0,0,0,0,0,0,0,0,0,0,2,1,1,6190,2782,591,5163,1
6,106,6,4,4,0,0,2,6,0,0,0,0,0,0,0,0,0,0,0,0,2,1,1,6190,2782,591,5164,1
6,106,10,6,6,0,0,4,10,0,0,0,0,0,0,0,0,0,0,0,0,2,1,1,6190,2782,591,5165,1
6,106,1,1,1,0,0,0,1,0,0,0,0,0,0,0,0,0,0,0,0,2,1,1,6190,2782,591,5165,1
6,106,14,10,10,0,0,4,14,1,1,1,1,2,2,0,2,0,1,0,0,2,1,1,6190,2782,591,5166,1
6,106,46,26,30,3,0,12,49,3,6,3,6,9,9,20,28,1,42,2,0,2,1,1,6200,2782,591,5167,1
80,1742,1457,730,1242,11,6,188,1468,10,292,166,329,302,495,2424,4078,5,22973,1276,1,2,2,1,6230,2796,594,5189,1
80,1742,74,35,59,1,0,14,75,3,14,7,14,17,21,58,85,1,128,7,0,2,2,1,6230,2797,594,5190,1
80,1742,245,125,200,5,7,34,250,7,30,17,34,37,51,166,265,3,1053,58,0,2,2,1,6240,2798,594,5191,1
2,219,42,7,35,4,0,5,46,1,2,1,2,3,3,2,4,0,2,0,0,2,4,8,6240,2798,594,5192,1
2,219,11,6,10,0,0,1,11,2,4,2,4,6,6,10,15,1,15,0,0,2,4,8,6240,2798,594,5193,1
28,538,334,251,279,10,4,40,344,5,127,74,143,132,217,899,1528,2,4303,239,0,2,5,0,6260,2804,595,5213,1
34,1920,1457,730,1242,11,6,188,1468,10,292,166,329,302,495,2424,4078,5,22973,1276,1,2,1,0,6270,2807,595,5226,1
16,752,334,251,279,10,4,40,344,5,127,74,143,132,217,899,1528,2,4303,239,0,2,15,0,6270,2808,595,5227,1
2,219,42,7,35,4,0,5,46,1,2,1,2,3,3,2,4,0,2,0,0,2,4,4,6280,2812,596,5235,1
2,219,11,6,10,0,0,1,11,2,4,2,4,6,6,10,15,1,15,0,0,2,4,4,6280,2812,596,5236,1
15,428,1450,624,1228,12,26,181,1462,14,306,186,354,320,540,2580,4493,8,36391,2021,1,3,2,2,6320,2830,601,5265,1
186,4143,182,127,129,0,0,53,182,5,39,21,42,44,63,217,343,2,926,51,0,3,3,3,6320,2830,602,5266,1
186,4143,1165,710,800,67,119,181,1232,18,243,153,282,261,435,2000,3492,10,36473,2026,1,3,3,3,6330,2830,603,5267,1
133,2264,1338,495,1086,10,64,173,1348,11,122,82,157,133,239,883,1686,7,11934,663,0,3,1,1,6420,2869,613,5331,1
79,1733,1457,730,1242,11,6,188,1468,10,292,166,329,302,495,2424,4078,5,22973,1276,1,3,11,13,6430,2872,614,5334,1
79,1733,74,35,59,1,0,14,75,3,14,7,14,17,21,58,85,1,128,7,0,3,11,13,6430,2873,614,5335,1
79,1733,245,125,200,5,7,34,250,7,30,17,34,37,51,166,265,3,1053,58,0,3,11,13,6440,2874,614,5336,1
74,1701,384,251,317,7,8,52,391,11,70,44,84,81,128,467,811,6,5355,297,0,3,6,6,6480,2888,617,5361,1
36,669,373,158,315,8,0,51,381,5,76,44,79,81,123,486,779,2,2026,112,0,3,1,1,6480,2888,617,5362,1
2,221,42,7,35,4,0,5,46,1,2,1,2,3,3,2,4,0,2,0,0,2,27,32,6510,2900,620,5384,1
2,221,11,6,10,0,0,1,11,2,4,2,4,6,6,10,15,1,15,0,0,2,27,32,6510,2900,620,5385,1
43,935,1450,624,1228,12,26,181,1462,14,306,186,354,320,540,2580,4493,8,36391,2021,1,2,1,1,6510,2902,621,5386,1
34,1106,182,127,129,0,0,53,182,5,39,21,42,44,63,217,343,2,926,51,0,2,2,2,6510,2902,622,5387,1
102,3828,1392,870,1177,35,17,170,1427,14,494,280,531,508,811,4473,7289,7,54850,3047,2,2,3,3,6510,2905,623,5388,1
56,1918,773,419,590,28,0,166,801,10,204,113,217,214,330,1598,2554,5,13587,754,0,2,5,5,6510,2905,624,5389,1
47,1953,1513,682,1277,25,13,200,1538,11,199,116,219,210,335,1557,2584,6,15641,868,0,2,1,1,6510,2907,624,5390,1
11,513,127,75,83,2,11,30,129,4,14,7,14,18,21,61,87,2,175,9,0,2,1,1,6510,2907,624,5391,1
11,513,652,304,544,16,6,88,668,6,89,51,101,95,152,591,998,3,3399,188,0,2,1,1,6510,2908,624,5392,1
11,513,2,2,2,0,0,0,2,0,0,0,0,0,0,0,0,0,0,0,0,2,1,1,6510,2908,624,5392,1
11,513,8,5,5,0,0,3,8,0,0,0,0,0,0,0,0,0,0,0,0,2,1,1,6510,2908,624,5393,1
11,513,2,2,2,0,0,0,2,0,0,0,0,0,0,0,0,0,0,0,0,2,1,1,6510,2908,624,5393,1
11,513,14,8,8,0,0,6,14,0,0,0,0,0,0,0,0,0,0,0,0,2,1,1,6510,2908,624,5394,1
11,513,6,4,4,0,0,2,6,0,0,0,0,0,0,0,0,0,0,0,0,2,1,1,6510,2908,624,5395,1
11,513,6,4,4,0,0,2,6,1,2,1,2,3,3,2,4,0,2,0,0,2,1,1,6510,2908,624,5396,1
11,513,6,4,4,0,0,2,6,0,0,0,0,0,0,0,0,0,0,0,0,2,1,1,6510,2908,624,5397,1
11,513,7,5,5,0,0,2,7,0,0,0,0,0,0,0,0,0,0,0,0,2,1,1,6510,2908,624,5398,1
11,513,6,4,4,0,0,2,6,0,0,0,0,0,0,0,0,0,0,0,0,2,1,1,6510,2908,624,5399,1
11,513,10,6,6,0,0,4,10,0,0,0,0,0,0,0,0,0,0,0,0,2,1,1,6510,2908,624,5400,1
11,513,1,1,1,0,0,0,1,0,0,0,0,0,0,0,0,0,0,0,0,2,1,1,6510,2908,624,5400,1
11,513,14,10,10,0,0,4,14,1,1,1,1,2,2,0,2,0,1,0,0,2,1,1,6510,2908,624,5401,1
11,513,46,26,30,3,0,12,49,3,6,3,6,9,9,20,28,1,42,2,0,2,1,1,6520,2908,624,5402,1
7,169,127,75,83,2,11,30,129,4,14,7,14,18,21,61,87,2,175,9,0,2,2,2,6520,2908,624,5403,1
7,169,652,304,544,16,6,88,668,6,89,51,101,95,152,591,998,3,3399,188,0,2,2,2,6520,2909,624,5404,1
7,169,2,2,2,0,0,0,2,0,0,0,0,0,0,0,0,0,0,0,0,2,2,2,6520,2909,624,5404,1
7,169,8,5,5,0,0,3,8,0,0,0,0,0,0,0,0,0,0,0,0,2,2,2,6520,2909,624,5405,1
7,169,2,2,2,0,0,0,2,0,0,0,0,0,0,0,0,0,0,0,0,2,2,2,6520,2909,624,5405,1
7,169,14,8,8,0,0,6,14,0,0,0,0,0,0,0,0,0,0,0,0,2,2,2,6520,2909,624,5406,1
7,169,6,4,4,0,0,2,6,0,0,0,0,0,0,0,0,0,0,0,0,2,2,2,6520,2909,624,5407,1
7,169,6,4,4,0,0,2,6,1,2,1,2,3,3,2,4,0,2,0,0,2,2,2,6520,2909,624,5408,1
7,169,6,4,4,0,0,2,6,0,0,0,0,0,0,0,0,0,0,0,0,2,2,2,6520,2909,624,5409,1
7,169,7,5,5,0,0,2,7,0,0,0,0,0,0,0,0,0,0,0,0,2,2,2,6520,2909,624,5410,1
7,169,6,4,4,0,0,2,6,0,0,0,0,0,0,0,0,0,0,0,0,2,2,2,6520,2909,624,5411,1
7,169,10,6,6,0,0,4,10,0,0,0,0,0,0,0,0,0,0,0,0,2,2,2,6520,2909,624,5412,1
7,169,1,1,1,0,0,0,1,0,0,0,0,0,0,0,0,0,0,0,0,2,2,2,6520,2909,624,5412,1
7,169,14,10,10,0,0,4,14,1,1,1,1,2,2,0,2,0,1,0,0,2,2,2,6520,2909,624,5413,1
7,169,46,26,30,3,0,12,49,3,6,3,6,9,9,20,28,1,42,2,0,2,2,2,6530,2909,624,5414,1
4,223,207,111,150,11,0,50,218,5,26,19,36,31,55,133,272,3,943,52,0,2,2,2,6530,2909,624,5415,1
34,1914,1457,730,1242,11,6,188,1468,10,292,166,329,302,495,2424,4078,5,22973,1276,1,2,3,3,6530,2911,624,5416,1
16,750,334,251,279,10,4,40,344,5,127,74,143,132,217,899,1528,2,4303,239,0,2,1,1,6530,2912,624,5417,1
29,1453,384,251,317,7,8,52,391,11,70,44,84,81,128,467,811,6,5355,297,0,2,3,3,6530,2912,624,5418,1
2,223,42,7,35,4,0,5,46,1,2,1,2,3,3,2,4,0,2,0,0,2,3,5,6550,2920,626,5433,1
2,223,11,6,10,0,0,1,11,2,4,2,4,6,6,10,15,1,15,0,0,2,3,5,6550,2920,626,5434,1
16,759,334,251,279,10,4,40,344,5,127,74,143,132,217,899,1528,2,4303,239,0,2,12,10,6580,2930,628,5461,1
42,923,1450,624,1228,12,26,181,1462,14,306,186,354,320,540,2580,4493,8,36391,2021,1,2,1,5,6590,2936,630,5469,1
55,1910,773,419,590,28,0,166,801,10,204,113,217,214,330,1598,2554,5,13587,754,0,2,1,3,6590,2936,631,5470,1
78,1734,384,251,317,7,8,52,391,11,70,44,84,81,128,467,811,6,5355,297,0,2,17,10,6590,2936,631,5471,1
30,1536,384,251,317,7,8,52,391,11,70,44,84,81,128,467,811,6,5355,297,0,2,11,1,6590,2936,631,5472,1
28,548,334,251,279,10,4,40,344,5,127,74,143,132,217,899,1528,2,4303,239,0,2,12,10,6590,2937,631,5473,1
19,349,127,75,83,2,11,30,129,4,14,7,14,18,21,61,87,2,175,9,0,2,1,1,6590,2937,631,5474,1
19,349,652,304,544,16,6,88,668,6,89,51,101,95,152,591,998,3,3399,188,0,2,1,1,6590,2938,631,5475,1
19,349,2,2,2,0,0,0,2,0,0,0,0,0,0,0,0,0,0,0,0,2,1,1,6590,2938,631,5475,1
19,349,8,5,5,0,0,3,8,0,0,0,0,0,0,0,0,0,0,0,0,2,1,1,6590,2938,631,5476,1
19,349,2,2,2,0,0,0,2,0,0,0,0,0,0,0,0,0,0,0,0,2,1,1,6590,2938,631,5476,1
19,349,14,8,8,0,0,6,14,0,0,0,0,0,0,0,0,0,0,0,0,2,1,1,6590,2938,631,5477,1
19,349,6,4,4,0,0,2,6,0,0,0,0,0,0,0,0,0,0,0,0,2,1,1,6590,2938,631,5478,1
19,349,6,4,4,0,0,2,6,1,2,1,2,3,3,2,4,0,2,0,0,2,1,1,6590,2938,631,5479,1
19,349,6,4,4,0,0,2,6,0,0,0,0,0,0,0,0,0,0,0,0,2,1,1,6590,2938,631,5480,1
19,349,7,5,5,0,0,2,7,0,0,0,0,0,0,0,0,0,0,0,0,2,1,1,6590,2938,631,5481,1
19,349,6,4,4,0,0,2,6,0,0,0,0,0,0,0,0,0,0,0,0,2,1,1,6590,2938,631,5482,1
19,349,10,6,6,0,0,4,10,0,0,0,0,0,0,0,0,0,0,0,0,2,1,1,6590,2938,631,5483,1
19,349,1,1,1,0,0,0,1,0,0,0,0,0,0,0,0,0,0,0,0,2,1,1,6590,2938,631,5483,1
19,349,14,10,10,0,0,4,14,1,1,1,1,2,2,0,2,0,1,0,0,2,1,1,6590,2938,631,5484,1
19,349,46,26,30,3,0,12,49,3,6,3,6,9,9,20,28,1,42,2,0,2,1,1,6600,2938,631,5485,1
19,842,334,251,279,10,4,40,344,5,127,74,143,132,217,899,1528,2,4303,239,0,2,15,3,6600,2939,631,5486,1
19,349,127,75,83,2,11,30,129,4,14,7,14,18,21,61,87,2,175,9,0,2,2,2,6600,2939,631,5487,1
19,349,652,304,544,16,6,88,668,6,89,51,101,95,152,591,998,3,3399,188,0,2,2,2,6600,2940,631,5488,1
19,349,2,2,2,0,0,0,2,0,0,0,0,0,0,0,0,0,0,0,0,2,2,2,6600,2940,631,5488,1
19,349,8,5,5,0,0,3,8,0,0,0,0,0,0,0,0,0,0,0,0,2,2,2,6600,2940,631,5489,1
19,349,2,2,2,0,0,0,2,0,0,0,0,0,0,0,0,0,0,0,0,2,2,2,6600,2940,631,5489,1
19,349,14,8,8,0,0,6,14,0,0,0,0,0,0,0,0,0,0,0,0,2,2,2,6600,2940,631,5490,1
19,349,6,4,4,0,0,2,6,0,0,0,0,0,0,0,0,0,0,0,0,2,2,2,6600,2940,631,5491,1
19,349,6,4,4,0,0,2,6,1,2,1,2,3,3,2,4,0,2,0,0,2,2,2,6600,2940,631,5492,1
19,349,6,4,4,0,0,2,6,0,0,0,0,0,0,0,0,0,0,0,0,2,2,2,6600,2940,631,5493,1
19,349,7,5,5,0,0,2,7,0,0,0,0,0,0,0,0,0,0,0,0,2,2,2,6600,2940,631,5494,1
19,349,6,4,4,0,0,2,6,0,0,0,0,0,0,0,0,0,0,0,0,2,2,2,6600,2940,631,5495,1
19,349,10,6,6,0,0,4,10,0,0,0,0,0,0,0,0,0,0,0,0,2,2,2,6600,2940,631,5496,1
19,349,1,1,1,0,0,0,1,0,0,0,0,0,0,0,0,0,0,0,0,2,2,2,6600,2940,631,5496,1
19,349,14,10,10,0,0,4,14,1,1,1,1,2,2,0,2,0,1,0,0,2,2,2,6600,2940,631,5497,1
19,349,46,26,30,3,0,12,49,3,6,3,6,9,9,20,28,1,42,2,0,2,2,2,6610,2940,631,5498,1
19,349,127,75,83,2,11,30,129,4,14,7,14,18,21,61,87,2,175,9,0,2,2,2,6610,2940,631,5499,1
19,349,652,304,544,16,6,88,668,6,89,51,101,95,152,591,998,3,3399,188,0,2,2,2,6610,2941,631,5500,1
19,349,2,2,2,0,0,0,2,0,0,0,0,0,0,0,0,0,0,0,0,2,2,2,6610,2941,631,5500,1
19,349,8,5,5,0,0,3,8,0,0,0,0,0,0,0,0,0,0,0,0,2,2,2,6610,2941,631,5501,1
19,349,2,2,2,0,0,0,2,0,0,0,0,0,0,0,0,0,0,0,0,2,2,2,6610,2941,631,5501,1
19,349,14,8,8,0,0,6,14,0,0,0,0,0,0,0,0,0,0,0,0,2,2,2,6610,2941,631,5502,1
19,349,6,4,4,0,0,2,6,0,0,0,0,0,0,0,0,0,0,0,0,2,2,2,6610,2941,631,5503,1
19,349,6,4,4,0,0,2,6,1,2,1,2,3,3,2,4,0,2,0,0,2,2,2,6610,2941,631,5504,1
19,349,6,4,4,0,0,2,6,0,0,0,0,0,0,0,0,0,0,0,0,2,2,2,6610,2941,631,5505,1
19,349,7,5,5,0,0,2,7,0,0,0,0,0,0,0,0,0,0,0,0,2,2,2,6610,2941,631,5506,1
19,349,6,4,4,0,0,2,6,0,0,0,0,0,0,0,0,0,0,0,0,2,2,2,6610,2941,631,5507,1
19,349,10,6,6,0,0,4,10,0,0,0,0,0,0,0,0,0,0,0,0,2,2,2,6610,2941,631,5508,1
19,349,1,1,1,0,0,0,1,0,0,0,0,0,0,0,0,0,0,0,0,2,2,2,6610,2941,631,5508,1
19,349,14,10,10,0,0,4,14,1,1,1,1,2,2,0,2,0,1,0,0,2,2,2,6610,2941,631,5509,1
19,349,46,26,30,3,0,12,49,3,6,3,6,9,9,20,28,1,42,2,0,2,2,2,6620,2941,631,5510,1
3,65,127,75,83,2,11,30,129,4,14,7,14,18,21,61,87,2,175,9,0,2,1,1,6620,2941,631,5511,0
3,65,652,304,544,16,6,88,668,6,89,51,101,95,152,591,998,3,3399,188,0,2,1,1,6620,2942,631,5512,0
3,65,2,2,2,0,0,0,2,0,0,0,0,0,0,0,0,0,0,0,0,2,1,1,6620,2942,631,5512,0
3,65,8,5,5,0,0,3,8,0,0,0,0,0,0,0,0,0,0,0,0,2,1,1,6620,2942,631,5513,0
3,65,2,2,2,0,0,0,2,0,0,0,0,0,0,0,0,0,0,0,0,2,1,1,6620,2942,631,5513,0
3,65,14,8,8,0,0,6,14,0,0,0,0,0,0,0,0,0,0,0,0,2,1,1,6620,2942,631,5514,0
3,65,6,4,4,0,0,2,6,0,0,0,0,0,0,0,0,0,0,0,0,2,1,1,6620,2942,631,5515,0
3,65,6,4,4,0,0,2,6,1,2,1,2,3,3,2,4,0,2,0,0,2,1,1,6620,2942,631,5516,0
3,65,6,4,4,0,0,2,6,0,0,0,0,0,0,0,0,0,0,0,0,2,1,1,6620,2942,631,5517,0
3,65,7,5,5,0,0,2,7,0,0,0,0,0,0,0,0,0,0,0,0,2,1,1,6620,2942,631,5518,0
3,65,6,4,4,0,0,2,6,0,0,0,0,0,0,0,0,0,0,0,0,2,1,1,6620,2942,631,5519,0
3,65,10,6,6,0,0,4,10,0,0,0,0,0,0,0,0,0,0,0,0,2,1,1,6620,2942,631,5520,0
3,65,1,1,1,0,0,0,1,0,0,0,0,0,0,0,0,0,0,0,0,2,1,1,6620,2942,631,5520,0
3,65,14,10,10,0,0,4,14,1,1,1,1,2,2,0,2,0,1,0,0,2,1,1,6620,2942,631,5521,0
3,65,46,26,30,3,0,12,49,3,6,3,6,9,9,20,28,1,42,2,0,2,1,1,6630,2942,631,5522,0
34,1914,1457,730,1242,11,6,188,1468,10,292,166,329,302,495,2424,4078,5,22973,1276,1,2,1,1,6630,2944,631,5523,0
133,2248,1338,495,1086,10,64,173,1348,11,122,82,157,133,239,883,1686,7,11934,663,0,2,1,2,6630,2946,631,5524,1
78,1725,1457,730,1242,11,6,188,1468,10,292,166,329,302,495,2424,4078,5,22973,1276,1,2,2,2,6630,2948,631,5525,1
78,1725,74,35,59,1,0,14,75,3,14,7,14,17,21,58,85,1,128,7,0,2,2,2,6630,2949,631,5526,1
78,1725,245,125,200,5,7,34,250,7,30,17,34,37,51,166,265,3,1053,58,0,2,2,2,6640,2950,631,5527,1
102,3815,1392,870,1177,35,17,170,1427,14,494,280,531,508,811,4473,7289,7,54850,3047,2,2,1,1,6650,2957,633,5535,1
7,160,127,75,83,2,11,30,129,4,14,7,14,18,21,61,87,2,175,9,0,2,1,1,6650,2957,633,5536,1
7,160,652,304,544,16,6,88,668,6,89,51,101,95,152,591,998,3,3399,188,0,2,1,1,6650,2958,633,5537,1
7,160,2,2,2,0,0,0,2,0,0,0,0,0,0,0,0,0,0,0,0,2,1,1,6650,2958,633,5537,1
7,160,8,5,5,0,0,3,8,0,0,0,0,0,0,0,0,0,0,0,0,2,1,1,6650,2958,633,5538,1
7,160,2,2,2,0,0,0,2,0,0,0,0,0,0,0,0,0,0,0,0,2,1,1,6650,2958,633,5538,1
7,160,14,8,8,0,0,6,14,0,0,0,0,0,0,0,0,0,0,0,0,2,1,1,6650,2958,633,5539,1
7,160,6,4,4,0,0,2,6,0,0,0,0,0,0,0,0,0,0,0,0,2,1,1,6650,2958,633,5540,1
7,160,6,4,4,0,0,2,6,1,2,1,2,3,3,2,4,0,2,0,0,2,1,1,6650,2958,633,5541,1
7,160,6,4,4,0,0,2,6,0,0,0,0,0,0,0,0,0,0,0,0,2,1,1,6650,2958,633,5542,1
7,160,7,5,5,0,0,2,7,0,0,0,0,0,0,0,0,0,0,0,0,2,1,1,6650,2958,633,5543,1
7,160,6,4,4,0,0,2,6,0,0,0,0,0,0,0,0,0,0,0,0,2,1,1,6650,2958,633,5544,1
7,160,10,6,6,0,0,4,10,0,0,0,0,0,0,0,0,0,0,0,0,2,1,1,6650,2958,633,5545,1
7,160,1,1,1,0,0,0,1,0,0,0,0,0,0,0,0,0,0,0,0,2,1,1,6650,2958,633,5545,1
7,160,14,10,10,0,0,4,14,1,1,1,1,2,2,0,2,0,1,0,0,2,1,1,6650,2958,633,5546,1
7,160,46,26,30,3,0,12,49,3,6,3,6,9,9,20,28,1,42,2,0,2,1,1,6660,2958,633,5547,1
15,439,1450,624,1228,12,26,181,1462,14,306,186,354,320,540,2580,4493,8,36391,2021,1,2,1,1,6660,2960,634,5548,1
187,4157,182,127,129,0,0,53,182,5,39,21,42,44,63,217,343,2,926,51,0,2,3,0,6660,2960,635,5549,1
187,4157,1165,710,800,67,119,181,1232,18,243,153,282,261,435,2000,3492,10,36473,2026,1,2,3,0,6670,2960,636,5550,1
42,935,1450,624,1228,12,26,181,1462,14,306,186,354,320,540,2580,4493,8,36391,2021,1,2,2,0,6670,2962,637,5551,1
34,1126,182,127,129,0,0,53,182,5,39,21,42,44,63,217,343,2,926,51,0,2,6,0,6670,2962,638,5552,1
102,3816,1392,870,1177,35,17,170,1427,14,494,280,531,508,811,4473,7289,7,54850,3047,2,2,1,1,6670,2965,639,5553,1
42,923,1450,624,1228,12,26,181,1462,14,306,186,354,320,540,2580,4493,8,36391,2021,1,2,1,1,6670,2967,640,5554,0
42,923,1450,624,1228,12,26,181,1462,14,306,186,354,320,540,2580,4493,8,36391,2021,1,2,1,1,6670,2969,641,5555,0
2,206,42,7,35,4,0,5,46,1,2,1,2,3,3,2,4,0,2,0,0,2,8,13,6710,2985,645,5584,1
2,206,11,6,10,0,0,1,11,2,4,2,4,6,6,10,15,1,15,0,0,2,8,13,6710,2985,645,5585,1
2,180,42,7,35,4,0,5,46,1,2,1,2,3,3,2,4,0,2,0,0,2,7,22,6720,2989,646,5595,1
2,180,11,6,10,0,0,1,11,2,4,2,4,6,6,10,15,1,15,0,0,2,7,22,6720,2989,646,5596,1
19,385,127,75,83,2,11,30,129,4,14,7,14,18,21,61,87,2,175,9,0,2,10,1,6820,3011,651,5700,0
19,385,652,304,544,16,6,88,668,6,89,51,101,95,152,591,998,3,3399,188,0,2,10,1,6820,3012,651,5701,0
19,385,2,2,2,0,0,0,2,0,0,0,0,0,0,0,0,0,0,0,0,2,10,1,6820,3012,651,5701,0
19,385,8,5,5,0,0,3,8,0,0,0,0,0,0,0,0,0,0,0,0,2,10,1,6820,3012,651,5702,0
19,385,2,2,2,0,0,0,2,0,0,0,0,0,0,0,0,0,0,0,0,2,10,1,6820,3012,651,5702,0
19,385,14,8,8,0,0,6,14,0,0,0,0,0,0,0,0,0,0,0,0,2,10,1,6820,3012,651,5703,0
19,385,6,4,4,0,0,2,6,0,0,0,0,0,0,0,0,0,0,0,0,2,10,1,6820,3012,651,5704,0
19,385,6,4,4,0,0,2,6,1,2,1,2,3,3,2,4,0,2,0,0,2,10,1,6820,3012,651,5705,0
19,385,6,4,4,0,0,2,6,0,0,0,0,0,0,0,0,0,0,0,0,2,10,1,6820,3012,651,5706,0
19,385,7,5,5,0,0,2,7,0,0,0,0,0,0,0,0,0,0,0,0,2,10,1,6820,3012,651,5707,0
19,385,6,4,4,0,0,2,6,0,0,0,0,0,0,0,0,0,0,0,0,2,10,1,6820,3012,651,5708,0
19,385,10,6,6,0,0,4,10,0,0,0,0,0,0,0,0,0,0,0,0,2,10,1,6820,3012,651,5709,0
19,385,1,1,1,0,0,0,1,0,0,0,0,0,0,0,0,0,0,0,0,2,10,1,6820,3012,651,5709,0
19,385,14,10,10,0,0,4,14,1,1,1,1,2,2,0,2,0,1,0,0,2,10,1,6820,3012,651,5710,0
19,385,46,26,30,3,0,12,49,3,6,3,6,9,9,20,28,1,42,2,0,2,10,1,6830,3012,651,5711,0
79,1735,1457,730,1242,11,6,188,1468,10,292,166,329,302,495,2424,4078,5,22973,1276,1,2,2,2,6830,3014,651,5712,1
79,1735,74,35,59,1,0,14,75,3,14,7,14,17,21,58,85,1,128,7,0,2,2,2,6830,3015,651,5713,1
79,1735,245,125,200,5,7,34,250,7,30,17,34,37,51,166,265,3,1053,58,0,2,2,2,6840,3016,651,5714,1
15,443,1450,624,1228,12,26,181,1462,14,306,186,354,320,540,2580,4493,8,36391,2021,1,3,2,2,6880,3034,656,5743,1
187,4163,182,127,129,0,0,53,182,5,39,21,42,44,63,217,343,2,926,51,0,3,3,3,6880,3034,657,5744,1
187,4163,1165,710,800,67,119,181,1232,18,243,153,282,261,435,2000,3492,10,36473,2026,1,3,3,3,6890,3034,658,5745,1
133,2248,1338,495,1086,10,64,173,1348,11,122,82,157,133,239,883,1686,7,11934,663,0,3,1,1,6970,3069,667,5802,1
79,1724,1457,730,1242,11,6,188,1468,10,292,166,329,302,495,2424,4078,5,22973,1276,1,3,4,5,6980,3072,668,5805,1
79,1724,74,35,59,1,0,14,75,3,14,7,14,17,21,58,85,1,128,7,0,3,4,5,6980,3073,668,5806,1
79,1724,245,125,200,5,7,34,250,7,30,17,34,37,51,166,265,3,1053,58,0,3,4,5,6990,3074,668,5807,1
78,1724,384,251,317,7,8,52,391,11,70,44,84,81,128,467,811,6,5355,297,0,3,7,6,7020,3084,670,5824,1
36,671,373,158,315,8,0,51,381,5,76,44,79,81,123,486,779,2,2026,112,0,3,1,1,7020,3084,670,5825,1
2,180,42,7,35,4,0,5,46,1,2,1,2,3,3,2,4,0,2,0,0,2,13,12,7030,3088,671,5834,1
2,180,11,6,10,0,0,1,11,2,4,2,4,6,6,10,15,1,15,0,0,2,13,12,7030,3088,671,5835,1
42,923,1450,624,1228,12,26,181,1462,14,306,186,354,320,540,2580,4493,8,36391,2021,1,2,1,1,7030,3090,672,5836,1
34,1130,182,127,129,0,0,53,182,5,39,21,42,44,63,217,343,2,926,51,0,2,2,2,7030,3090,673,5837,1
102,3818,1392,870,1177,35,17,170,1427,14,494,280,531,508,811,4473,7289,7,54850,3047,2,2,1,1,7030,3093,674,5838,1
55,1920,773,419,590,28,0,166,801,10,204,113,217,214,330,1598,2554,5,13587,754,0,2,5,5,7030,3093,675,5839,1
47,1955,1513,682,1277,25,13,200,1538,11,199,116,219,210,335,1557,2584,6,15641,868,0,2,1,1,7030,3095,675,5840,1
11,515,127,75,83,2,11,30,129,4,14,7,14,18,21,61,87,2,175,9,0,2,1,1,7030,3095,675,5841,1
11,515,652,304,544,16,6,88,668,6,89,51,101,95,152,591,998,3,3399,188,0,2,1,1,7030,3096,675,5842,1
11,515,2,2,2,0,0,0,2,0,0,0,0,0,0,0,0,0,0,0,0,2,1,1,7030,3096,675,5842,1
11,515,8,5,5,0,0,3,8,0,0,0,0,0,0,0,0,0,0,0,0,2,1,1,7030,3096,675,5843,1
11,515,2,2,2,0,0,0,2,0,0,0,0,0,0,0,0,0,0,0,0,2,1,1,7030,3096,675,5843,1
11,515,14,8,8,0,0,6,14,0,0,0,0,0,0,0,0,0,0,0,0,2,1,1,7030,3096,675,5844,1
11,515,6,4,4,0,0,2,6,0,0,0,0,0,0,0,0,0,0,0,0,2,1,1,7030,3096,675,5845,1
11,515,6,4,4,0,0,2,6,1,2,1,2,3,3,2,4,0,2,0,0,2,1,1,7030,3096,675,5846,1
11,515,6,4,4,0,0,2,6,0,0,0,0,0,0,0,0,0,0,0,0,2,1,1,7030,3096,675,5847,1
11,515,7,5,5,0,0,2,7,0,0,0,0,0,0,0,0,0,0,0,0,2,1,1,7030,3096,675,5848,1
11,515,6,4,4,0,0,2,6,0,0,0,0,0,0,0,0,0,0,0,0,2,1,1,7030,3096,675,5849,1
11,515,10,6,6,0,0,4,10,0,0,0,0,0,0,0,0,0,0,0,0,2,1,1,7030,3096,675,5850,1
11,515,1,1,1,0,0,0,1,0,0,0,0,0,0,0,0,0,0,0,0,2,1,1,7030,3096,675,5850,1
11,515,14,10,10,0,0,4,14,1,1,1,1,2,2,0,2,0,1,0,0,2,1,1,7030,3096,675,5851,1
11,515,46,26,30,3,0,12,49,3,6,3,6,9,9,20,28,1,42,2,0,2,1,1,7040,3096,675,5852,1
7,172,127,75,83,2,11,30,129,4,14,7,14,18,21,61,87,2,175,9,0,3,3,2,7050,3100,676,5860,1
7,172,652,304,544,16,6,88,668,6,89,51,101,95,152,591,998,3,3399,188,0,3,3,2,7050,3101,676,5861,1
7,172,2,2,2,0,0,0,2,0,0,0,0,0,0,0,0,0,0,0,0,3,3,2,7050,3101,676,5861,1
7,172,8,5,5,0,0,3,8,0,0,0,0,0,0,0,0,0,0,0,0,3,3,2,7050,3101,676,5862,1
7,172,2,2,2,0,0,0,2,0,0,0,0,0,0,0,0,0,0,0,0,3,3,2,7050,3101,676,5862,1
7,172,14,8,8,0,0,6,14,0,0,0,0,0,0,0,0,0,0,0,0,3,3,2,7050,3101,676,5863,1
7,172,6,4,4,0,0,2,6,0,0,0,0,0,0,0,0,0,0,0,0,3,3,2,7050,3101,676,5864,1
7,172,6,4,4,0,0,2,6,1,2,1,2,3,3,2,4,0,2,0,0,3,3,2,7050,3101,676,5865,1
7,172,6,4,4,0,0,2,6,0,0,0,0,0,0,0,0,0,0,0,0,3,3,2,7050,3101,676,5866,1
7,172,7,5,5,0,0,2,7,0,0,0,0,0,0,0,0,0,0,0,0,3,3,2,7050,3101,676,5867,1
7,172,6,4,4,0,0,2,6,0,0,0,0,0,0,0,0,0,0,0,0,3,3,2,7050,3101,676,5868,1
7,172,10,6,6,0,0,4,10,0,0,0,0,0,0,0,0,0,0,0,0,3,3,2,7050,3101,676,5869,1
7,172,1,1,1,0,0,0,1,0,0,0,0,0,0,0,0,0,0,0,0,3,3,2,7050,3101,676,5869,1
7,172,14,10,10,0,0,4,14,1,1,1,1,2,2,0,2,0,1,0,0,3,3,2,7050,3101,676,5870,1
7,172,46,26,30,3,0,12,49,3,6,3,6,9,9,20,28,1,42,2,0,3,3,2,7060,3101,676,5871,1
4,227,207,111,150,11,0,50,218,5,26,19,36,31,55,133,272,3,943,52,0,2,2,2,7060,3101,676,5872,1
34,1920,1457,730,1242,11,6,188,1468,10,292,166,329,302,495,2424,4078,5,22973,1276,1,2,3,3,7060,3103,676,5873,1
19,844,334,251,279,10,4,40,344,5,127,74,143,132,217,899,1528,2,4303,239,0,2,1,1,7060,3104,676,5874,1
30,1542,384,251,317,7,8,52,391,11,70,44,84,81,128,467,811,6,5355,297,0,2,3,3,7060,3104,676,5875,1
28,551,334,251,279,10,4,40,344,5,127,74,143,132,217,899,1528,2,4303,239,0,2,1,0,7080,3113,678,5890,1
2,178,42,7,35,4,0,5,46,1,2,1,2,3,3,2,4,0,2,0,0,2,2,3,7080,3113,678,5891,1
2,178,11,6,10,0,0,1,11,2,4,2,4,6,6,10,15,1,15,0,0,2,2,3,7080,3113,678,5892,1
2,178,42,7,35,4,0,5,46,1,2,1,2,3,3,2,4,0,2,0,0,2,1,1,7090,3117,679,5900,0
2,178,11,6,10,0,0,1,11,2,4,2,4,6,6,10,15,1,15,0,0,2,1,1,7090,3117,679,5901,0
9,523,1289,550,1043,56,32,155,1345,10,167,93,185,177,278,1266,2075,5,11498,638,0,2,3,3,7090,3119,680,5902,0
79,1731,1457,730,1242,11,6,188,1468,10,292,166,329,302,495,2424,4078,5,22973,1276,1,2,1,0,7100,3125,681,5910,1
79,1731,74,35,59,1,0,14,75,3,14,7,14,17,21,58,85,1,128,7,0,2,1,0,7100,3126,681,5911,1
79,1731,245,125,200,5,7,34,250,7,30,17,34,37,51,166,265,3,1053,58,0,2,1,0,7110,3127,681,5912,1
81,1771,384,251,317,7,8,52,391,11,70,44,84,81,128,467,811,6,5355,297,0,2,8,0,7110,3127,681,5913,1
33,1635,384,251,317,7,8,52,391,11,70,44,84,81,128,467,811,6,5355,297,0,2,18,0,7110,3127,681,5914,1
82,1777,384,251,317,7,8,52,391,11,70,44,84,81,128,467,811,6,5355,297,0,2,4,1,7110,3127,681,5915,0
34,1678,384,251,317,7,8,52,391,11,70,44,84,81,128,467,811,6,5355,297,0,2,7,0,7110,3127,681,5916,0
44,869,215,129,180,6,0,29,221,8,65,43,72,73,115,415,711,4,3153,175,0,2,2,0,7110,3127,681,5917,0
44,869,97,69,77,3,3,16,100,6,22,13,23,28,36,113,173,3,542,30,0,2,2,0,7110,3128,681,5918,0
4,84,127,75,83,2,11,30,129,4,14,7,14,18,21,61,87,2,175,9,0,2,3,0,7110,3128,681,5919,1
4,84,652,304,544,16,6,88,668,6,89,51,101,95,152,591,998,3,3399,188,0,2,3,0,7110,3129,681,5920,1
4,84,2,2,2,0,0,0,2,0,0,0,0,0,0,0,0,0,0,0,0,2,3,0,7110,3129,681,5920,1
4,84,8,5,5,0,0,3,8,0,0,0,0,0,0,0,0,0,0,0,0,2,3,0,7110,3129,681,5921,1
4,84,2,2,2,0,0,0,2,0,0,0,0,0,0,0,0,0,0,0,0,2,3,0,7110,3129,681,5921,1
4,84,14,8,8,0,0,6,14,0,0,0,0,0,0,0,0,0,0,0,0,2,3,0,7110,3129,681,5922,1
4,84,6,4,4,0,0,2,6,0,0,0,0,0,0,0,0,0,0,0,0,2,3,0,7110,3129,681,5923,1
4,84,6,4,4,0,0,2,6,1,2,1,2,3,3,2,4,0,2,0,0,2,3,0,7110,3129,681,5924,1
4,84,6,4,4,0,0,2,6,0,0,0,0,0,0,0,0,0,0,0,0,2,3,0,7110,3129,681,5925,1
4,84,7,5,5,0,0,2,7,0,0,0,0,0,0,0,0,0,0,0,0,2,3,0,7110,3129,681,5926,1
4,84,6,4,4,0,0,2,6,0,0,0,0,0,0,0,0,0,0,0,0,2,3,0,7110,3129,681,5927,1
4,84,10,6,6,0,0,4,10,0,0,0,0,0,0,0,0,0,0,0,0,2,3,0,7110,3129,681,5928,1
4,84,1,1,1,0,0,0,1,0,0,0,0,0,0,0,0,0,0,0,0,2,3,0,7110,3129,681,5928,1
4,84,14,10,10,0,0,4,14,1,1,1,1,2,2,0,2,0,1,0,0,2,3,0,7110,3129,681,5929,1
4,84,46,26,30,3,0,12,49,3,6,3,6,9,9,20,28,1,42,2,0,2,3,0,7120,3129,681,5930,1
45,961,1450,624,1228,12,26,181,1462,14,306,186,354,320,540,2580,4493,8,36391,2021,1,2,8,0,7120,3131,682,5931,0
19,392,127,75,83,2,11,30,129,4,14,7,14,18,21,61,87,2,175,9,0,2,2,0,7120,3131,682,5932,0
19,392,652,304,544,16,6,88,668,6,89,51,101,95,152,591,998,3,3399,188,0,2,2,0,7120,3132,682,5933,0
19,392,2,2,2,0,0,0,2,0,0,0,0,0,0,0,0,0,0,0,0,2,2,0,7120,3132,682,5933,0
19,392,8,5,5,0,0,3,8,0,0,0,0,0,0,0,0,0,0,0,0,2,2,0,7120,3132,682,5934,0
19,392,2,2,2,0,0,0,2,0,0,0,0,0,0,0,0,0,0,0,0,2,2,0,7120,3132,682,5934,0
19,392,14,8,8,0,0,6,14,0,0,0,0,0,0,0,0,0,0,0,0,2,2,0,7120,3132,682,5935,0
19,392,6,4,4,0,0,2,6,0,0,0,0,0,0,0,0,0,0,0,0,2,2,0,7120,3132,682,5936,0
19,392,6,4,4,0,0,2,6,1,2,1,2,3,3,2,4,0,2,0,0,2,2,0,7120,3132,682,5937,0
19,392,6,4,4,0,0,2,6,0,0,0,0,0,0,0,0,0,0,0,0,2,2,0,7120,3132,682,5938,0
19,392,7,5,5,0,0,2,7,0,0,0,0,0,0,0,0,0,0,0,0,2,2,0,7120,3132,682,5939,0
19,392,6,4,4,0,0,2,6,0,0,0,0,0,0,0,0,0,0,0,0,2,2,0,7120,3132,682,5940,0
19,392,10,6,6,0,0,4,10,0,0,0,0,0,0,0,0,0,0,0,0,2,2,0,7120,3132,682,5941,0
19,392,1,1,1,0,0,0,1,0,0,0,0,0,0,0,0,0,0,0,0,2,2,0,7120,3132,682,5941,0
19,392,14,10,10,0,0,4,14,1,1,1,1,2,2,0,2,0,1,0,0,2,2,0,7120,3132,682,5942,0
19,392,46,26,30,3,0,12,49,3,6,3,6,9,9,20,28,1,42,2,0,2,2,0,7130,3132,682,5943,0
40,353,647,139,84,35,284,233,682,0,0,0,0,0,0,0,0,0,0,0,0,2,3,3,7130,3132,682,5944,0
8,346,42,7,35,4,0,5,46,1,2,1,2,3,3,2,4,0,2,0,0,2,27,9,7140,3136,683,5952,1
8,346,11,6,10,0,0,1,11,2,4,2,4,6,6,10,15,1,15,0,0,2,27,9,7140,3136,683,5953,1
8,346,42,7,35,4,0,5,46,1,2,1,2,3,3,2,4,0,2,0,0,2,1,1,7150,3140,684,5961,0
8,346,11,6,10,0,0,1,11,2,4,2,4,6,6,10,15,1,15,0,0,2,1,1,7150,3140,684,5962,0
9,523,1289,550,1043,56,32,155,1345,10,167,93,185,177,278,1266,2075,5,11498,638,0,2,3,3,7150,3142,685,5963,0
135,2281,1338,495,1086,10,64,173,1348,11,122,82,157,133,239,883,1686,7,11934,663,0,2,6,2,7150,3144,685,5964,0
11,531,127,75,83,2,11,30,129,4,14,7,14,18,21,61,87,2,175,9,0,2,10,7,7160,3145,685,5977,0
11,531,652,304,544,16,6,88,668,6,89,51,101,95,152,591,998,3,3399,188,0,2,10,7,7160,3146,685,5978,0
11,531,2,2,2,0,0,0,2,0,0,0,0,0,0,0,0,0,0,0,0,2,10,7,7160,3146,685,5978,0
11,531,8,5,5,0,0,3,8,0,0,0,0,0,0,0,0,0,0,0,0,2,10,7,7160,3146,685,5979,0
11,531,2,2,2,0,0,0,2,0,0,0,0,0,0,0,0,0,0,0,0,2,10,7,7160,3146,685,5979,0
11,531,14,8,8,0,0,6,14,0,0,0,0,0,0,0,0,0,0,0,0,2,10,7,7160,3146,685,5980,0
11,531,6,4,4,0,0,2,6,0,0,0,0,0,0,0,0,0,0,0,0,2,10,7,7160,3146,685,5981,0
11,531,6,4,4,0,0,2,6,1,2,1,2,3,3,2,4,0,2,0,0,2,10,7,7160,3146,685,5982,0
11,531,6,4,4,0,0,2,6,0,0,0,0,0,0,0,0,0,0,0,0,2,10,7,7160,3146,685,5983,0
11,531,7,5,5,0,0,2,7,0,0,0,0,0,0,0,0,0,0,0,0,2,10,7,7160,3146,685,5984,0
11,531,6,4,4,0,0,2,6,0,0,0,0,0,0,0,0,0,0,0,0,2,10,7,7160,3146,685,5985,0
11,531,10,6,6,0,0,4,10,0,0,0,0,0,0,0,0,0,0,0,0,2,10,7,7160,3146,685,5986,0
11,531,1,1,1,0,0,0,1,0,0,0,0,0,0,0,0,0,0,0,0,2,10,7,7160,3146,685,5986,0
11,531,14,10,10,0,0,4,14,1,1,1,1,2,2,0,2,0,1,0,0,2,10,7,7160,3146,685,5987,0
11,531,46,26,30,3,0,12,49,3,6,3,6,9,9,20,28,1,42,2,0,2,10,7,7170,3146,685,5988,0
135,2281,1338,495,1086,10,64,173,1348,11,122,82,157,133,239,883,1686,7,11934,663,0,2,1,1,7170,3148,685,5989,0
81,1777,1457,730,1242,11,6,188,1468,10,292,166,329,302,495,2424,4078,5,22973,1276,1,2,8,1,7170,3150,685,5990,0
81,1777,74,35,59,1,0,14,75,3,14,7,14,17,21,58,85,1,128,7,0,2,8,1,7170,3151,685,5991,0
81,1777,245,125,200,5,7,34,250,7,30,17,34,37,51,166,265,3,1053,58,0,2,8,1,7180,3152,685,5992,0
80,1795,384,251,317,7,8,52,391,11,70,44,84,81,128,467,811,6,5355,297,0,2,12,11,7180,3152,685,5993,0
7,170,127,75,83,2,11,30,129,4,14,7,14,18,21,61,87,2,175,9,0,2,1,1,7180,3152,685,5994,0
7,170,652,304,544,16,6,88,668,6,89,51,101,95,152,591,998,3,3399,188,0,2,1,1,7180,3153,685,5995,0
7,170,2,2,2,0,0,0,2,0,0,0,0,0,0,0,0,0,0,0,0,2,1,1,7180,3153,685,5995,0
7,170,8,5,5,0,0,3,8,0,0,0,0,0,0,0,0,0,0,0,0,2,1,1,7180,3153,685,5996,0
7,170,2,2,2,0,0,0,2,0,0,0,0,0,0,0,0,0,0,0,0,2,1,1,7180,3153,685,5996,0
7,170,14,8,8,0,0,6,14,0,0,0,0,0,0,0,0,0,0,0,0,2,1,1,7180,3153,685,5997,0
7,170,6,4,4,0,0,2,6,0,0,0,0,0,0,0,0,0,0,0,0,2,1,1,7180,3153,685,5998,0
7,170,6,4,4,0,0,2,6,1,2,1,2,3,3,2,4,0,2,0,0,2,1,1,7180,3153,685,5999,0
7,170,6,4,4,0,0,2,6,0,0,0,0,0,0,0,0,0,0,0,0,2,1,1,7180,3153,685,6000,0
7,170,7,5,5,0,0,2,7,0,0,0,0,0,0,0,0,0,0,0,0,2,1,1,7180,3153,685,6001,0
7,170,6,4,4,0,0,2,6,0,0,0,0,0,0,0,0,0,0,0,0,2,1,1,7180,3153,685,6002,0
7,170,10,6,6,0,0,4,10,0,0,0,0,0,0,0,0,0,0,0,0,2,1,1,7180,3153,685,6003,0
7,170,1,1,1,0,0,0,1,0,0,0,0,0,0,0,0,0,0,0,0,2,1,1,7180,3153,685,6003,0
7,170,14,10,10,0,0,4,14,1,1,1,1,2,2,0,2,0,1,0,0,2,1,1,7180,3153,685,6004,0
7,170,46,26,30,3,0,12,49,3,6,3,6,9,9,20,28,1,42,2,0,2,1,1,7190,3153,685,6005,0
34,1680,384,251,317,7,8,52,391,11,70,44,84,81,128,467,811,6,5355,297,0,2,6,3,7190,3153,685,6006,0
60,1259,384,251,317,7,8,52,391,11,70,44,84,81,128,467,811,6,5355,297,0,2,1,101,7190,3153,685,6007,1
40,355,647,139,84,35,284,233,682,0,0,0,0,0,0,0,0,0,0,0,0,2,1,1,7190,3153,685,6008,1
31,1596,384,251,317,7,8,52,391,11,70,44,84,81,128,467,811,6,5355,297,0,2,3,15,7190,3153,685,6009,1
81,1754,1457,730,1242,11,6,188,1468,10,292,166,329,302,495,2424,4078,5,22973,1276,1,2,2,3,7200,3159,686,6017,1
81,1754,74,35,59,1,0,14,75,3,14,7,14,17,21,58,85,1,128,7,0,2,2,3,7200,3160,686,6018,1
81,1754,245,125,200,5,7,34,250,7,30,17,34,37,51,166,265,3,1053,58,0,2,2,3,7210,3161,686,6019,1
93,1908,384,251,317,7,8,52,391,11,70,44,84,81,128,467,811,6,5355,297,0,2,127,16,7210,3161,686,6020,1
33,1899,1457,730,1242,11,6,188,1468,10,292,166,329,302,495,2424,4078,5,22973,1276,1,2,0,3,7210,3163,686,6021,1
61,2672,384,251,317,7,8,52,391,11,70,44,84,81,128,467,811,6,5355,297,0,2,183,0,7210,3163,686,6022,1
80,1713,1457,730,1242,11,6,188,1468,10,292,166,329,302,495,2424,4078,5,22973,1276,1,2,11,24,7210,3165,686,6023,1
80,1713,74,35,59,1,0,14,75,3,14,7,14,17,21,58,85,1,128,7,0,2,11,24,7210,3166,686,6024,1
80,1713,245,125,200,5,7,34,250,7,30,17,34,37,51,166,265,3,1053,58,0,2,11,24,7220,3167,686,6025,1
81,1725,1457,730,1242,11,6,188,1468,10,292,166,329,302,495,2424,4078,5,22973,1276,1,2,14,6,7240,3177,688,6040,1
81,1725,74,35,59,1,0,14,75,3,14,7,14,17,21,58,85,1,128,7,0,2,14,6,7240,3178,688,6041,1
81,1725,245,125,200,5,7,34,250,7,30,17,34,37,51,166,265,3,1053,58,0,2,14,6,7250,3179,688,6042,1
93,1911,384,251,317,7,8,52,391,11,70,44,84,81,128,467,811,6,5355,297,0,2,1,2,7250,3179,688,6043,1
8,391,1289,550,1043,56,32,155,1345,10,167,93,185,177,278,1266,2075,5,11498,638,0,2,16,1,7250,3181,689,6044,1
61,2672,384,251,317,7,8,52,391,11,70,44,84,81,128,467,811,6,5355,297,0,2,1,0,7250,3181,689,6045,1
17,360,127,75,83,2,11,30,129,4,14,7,14,18,21,61,87,2,175,9,0,2,4,8,7250,3181,689,6046,1
17,360,652,304,544,16,6,88,668,6,89,51,101,95,152,591,998,3,3399,188,0,2,4,8,7250,3182,689,6047,1
17,360,2,2,2,0,0,0,2,0,0,0,0,0,0,0,0,0,0,0,0,2,4,8,7250,3182,689,6047,1
17,360,8,5,5,0,0,3,8,0,0,0,0,0,0,0,0,0,0,0,0,2,4,8,7250,3182,689,6048,1
17,360,2,2,2,0,0,0,2,0,0,0,0,0,0,0,0,0,0,0,0,2,4,8,7250,3182,689,6048,1
17,360,14,8,8,0,0,6,14,0,0,0,0,0,0,0,0,0,0,0,0,2,4,8,7250,3182,689,6049,1
17,360,6,4,4,0,0,2,6,0,0,0,0,0,0,0,0,0,0,0,0,2,4,8,7250,3182,689,6050,1
17,360,6,4,4,0,0,2,6,1,2,1,2,3,3,2,4,0,2,0,0,2,4,8,7250,3182,689,6051,1
17,360,6,4,4,0,0,2,6,0,0,0,0,0,0,0,0,0,0,0,0,2,4,8,7250,3182,689,6052,1
17,360,7,5,5,0,0,2,7,0,0,0,0,0,0,0,0,0,0,0,0,2,4,8,7250,3182,689,6053,1
17,360,6,4,4,0,0,2,6,0,0,0,0,0,0,0,0,0,0,0,0,2,4,8,7250,3182,689,6054,1
17,360,10,6,6,0,0,4,10,0,0,0,0,0,0,0,0,0,0,0,0,2,4,8,7250,3182,689,6055,1
17,360,1,1,1,0,0,0,1,0,0,0,0,0,0,0,0,0,0,0,0,2,4,8,7250,3182,689,6055,1
17,360,14,10,10,0,0,4,14,1,1,1,1,2,2,0,2,0,1,0,0,2,4,8,7250,3182,689,6056,1
17,360,46,26,30,3,0,12,49,3,6,3,6,9,9,20,28,1,42,2,0,2,4,8,7260,3182,689,6057,1
79,1661,1457,730,1242,11,6,188,1468,10,292,166,329,302,495,2424,4078,5,22973,1276,1,2,0,13,7260,3184,689,6058,1
79,1661,74,35,59,1,0,14,75,3,14,7,14,17,21,58,85,1,128,7,0,2,0,13,7260,3185,689,6059,1
79,1661,245,125,200,5,7,34,250,7,30,17,34,37,51,166,265,3,1053,58,0,2,0,13,7270,3186,689,6060,1
33,1845,1457,730,1242,11,6,188,1468,10,292,166,329,302,495,2424,4078,5,22973,1276,1,2,29,31,7270,3188,689,6061,1
61,2664,384,251,317,7,8,52,391,11,70,44,84,81,128,467,811,6,5355,297,0,2,0,1,7270,3188,689,6062,1
20,851,373,158,315,8,0,51,381,5,76,44,79,81,123,486,779,2,2026,112,0,2,2,2,7270,3188,689,6063,1
32,1814,1457,730,1242,11,6,188,1468,10,292,166,329,302,495,2424,4078,5,22973,1276,1,2,0,14,7270,3190,689,6064,0
11,552,127,75,83,2,11,30,129,4,14,7,14,18,21,61,87,2,175,9,0,2,4,2,7270,3190,689,6065,1
11,552,652,304,544,16,6,88,668,6,89,51,101,95,152,591,998,3,3399,188,0,2,4,2,7270,3191,689,6066,1
11,552,2,2,2,0,0,0,2,0,0,0,0,0,0,0,0,0,0,0,0,2,4,2,7270,3191,689,6066,1
11,552,8,5,5,0,0,3,8,0,0,0,0,0,0,0,0,0,0,0,0,2,4,2,7270,3191,689,6067,1
11,552,2,2,2,0,0,0,2,0,0,0,0,0,0,0,0,0,0,0,0,2,4,2,7270,3191,689,6067,1
11,552,14,8,8,0,0,6,14,0,0,0,0,0,0,0,0,0,0,0,0,2,4,2,7270,3191,689,6068,1
11,552,6,4,4,0,0,2,6,0,0,0,0,0,0,0,0,0,0,0,0,2,4,2,7270,3191,689,6069,1
11,552,6,4,4,0,0,2,6,1,2,1,2,3,3,2,4,0,2,0,0,2,4,2,7270,3191,689,6070,1
11,552,6,4,4,0,0,2,6,0,0,0,0,0,0,0,0,0,0,0,0,2,4,2,7270,3191,689,6071,1
11,552,7,5,5,0,0,2,7,0,0,0,0,0,0,0,0,0,0,0,0,2,4,2,7270,3191,689,6072,1
11,552,6,4,4,0,0,2,6,0,0,0,0,0,0,0,0,0,0,0,0,2,4,2,7270,3191,689,6073,1
11,552,10,6,6,0,0,4,10,0,0,0,0,0,0,0,0,0,0,0,0,2,4,2,7270,3191,689,6074,1
11,552,1,1,1,0,0,0,1,0,0,0,0,0,0,0,0,0,0,0,0,2,4,2,7270,3191,689,6074,1
11,552,14,10,10,0,0,4,14,1,1,1,1,2,2,0,2,0,1,0,0,2,4,2,7270,3191,689,6075,1
11,552,46,26,30,3,0,12,49,3,6,3,6,9,9,20,28,1,42,2,0,2,4,2,7280,3191,689,6076,1
79,1661,1457,730,1242,11,6,188,1468,10,292,166,329,302,495,2424,4078,5,22973,1276,1,2,1,0,7280,3193,689,6077,1
79,1661,74,35,59,1,0,14,75,3,14,7,14,17,21,58,85,1,128,7,0,2,1,0,7280,3194,689,6078,1
79,1661,245,125,200,5,7,34,250,7,30,17,34,37,51,166,265,3,1053,58,0,2,1,0,7290,3195,689,6079,1
95,3781,1392,870,1177,35,17,170,1427,14,494,280,531,508,811,4473,7289,7,54850,3047,2,2,48,58,7290,3198,690,6080,1
55,1911,773,419,590,28,0,166,801,10,204,113,217,214,330,1598,2554,5,13587,754,0,2,1,2,7290,3198,691,6081,1
8,388,1289,550,1043,56,32,155,1345,10,167,93,185,177,278,1266,2075,5,11498,638,0,2,3,3,7290,3200,692,6082,1
32,1815,1457,730,1242,11,6,188,1468,10,292,166,329,302,495,2424,4078,5,22973,1276,1,2,2,2,7290,3202,692,6083,1
139,2371,1338,495,1086,10,64,173,1348,11,122,82,157,133,239,883,1686,7,11934,663,0,2,15,3,7290,3204,692,6084,1
82,1712,1457,730,1242,11,6,188,1468,10,292,166,329,302,495,2424,4078,5,22973,1276,1,2,7,0,7290,3206,692,6085,1
82,1712,74,35,59,1,0,14,75,3,14,7,14,17,21,58,85,1,128,7,0,2,7,0,7290,3207,692,6086,1
82,1712,245,125,200,5,7,34,250,7,30,17,34,37,51,166,265,3,1053,58,0,2,7,0,7300,3208,692,6087,1
90,1868,384,251,317,7,8,52,391,11,70,44,84,81,128,467,811,6,5355,297,0,2,14,18,7300,3208,692,6088,1
57,2496,384,251,317,7,8,52,391,11,70,44,84,81,128,467,811,6,5355,297,0,2,0,26,7300,3208,692,6089,1
140,2381,1338,495,1086,10,64,173,1348,11,122,82,157,133,239,883,1686,7,11934,663,0,2,4,1,7300,3210,692,6090,1
82,1712,1457,730,1242,11,6,188,1468,10,292,166,329,302,495,2424,4078,5,22973,1276,1,2,1,1,7300,3212,692,6091,1
82,1712,74,35,59,1,0,14,75,3,14,7,14,17,21,58,85,1,128,7,0,2,1,1,7300,3213,692,6092,1
82,1712,245,125,200,5,7,34,250,7,30,17,34,37,51,166,265,3,1053,58,0,2,1,1,7310,3214,692,6093,1
11,574,127,75,83,2,11,30,129,4,14,7,14,18,21,61,87,2,175,9,0,2,2,0,7310,3214,692,6094,0
11,574,652,304,544,16,6,88,668,6,89,51,101,95,152,591,998,3,3399,188,0,2,2,0,7310,3215,692,6095,0
11,574,2,2,2,0,0,0,2,0,0,0,0,0,0,0,0,0,0,0,0,2,2,0,7310,3215,692,6095,0
11,574,8,5,5,0,0,3,8,0,0,0,0,0,0,0,0,0,0,0,0,2,2,0,7310,3215,692,6096,0
11,574,2,2,2,0,0,0,2,0,0,0,0,0,0,0,0,0,0,0,0,2,2,0,7310,3215,692,6096,0
11,574,14,8,8,0,0,6,14,0,0,0,0,0,0,0,0,0,0,0,0,2,2,0,7310,3215,692,6097,0
11,574,6,4,4,0,0,2,6,0,0,0,0,0,0,0,0,0,0,0,0,2,2,0,7310,3215,692,6098,0
11,574,6,4,4,0,0,2,6,1,2,1,2,3,3,2,4,0,2,0,0,2,2,0,7310,3215,692,6099,0
11,574,6,4,4,0,0,2,6,0,0,0,0,0,0,0,0,0,0,0,0,2,2,0,7310,3215,692,6100,0
11,574,7,5,5,0,0,2,7,0,0,0,0,0,0,0,0,0,0,0,0,2,2,0,7310,3215,692,6101,0
11,574,6,4,4,0,0,2,6,0,0,0,0,0,0,0,0,0,0,0,0,2,2,0,7310,3215,692,6102,0
11,574,10,6,6,0,0,4,10,0,0,0,0,0,0,0,0,0,0,0,0,2,2,0,7310,3215,692,6103,0
11,574,1,1,1,0,0,0,1,0,0,0,0,0,0,0,0,0,0,0,0,2,2,0,7310,3215,692,6103,0
11,574,14,10,10,0,0,4,14,1,1,1,1,2,2,0,2,0,1,0,0,2,2,0,7310,3215,692,6104,0
11,574,46,26,30,3,0,12,49,3,6,3,6,9,9,20,28,1,42,2,0,2,2,0,7320,3215,692,6105,0
139,2371,1338,495,1086,10,64,173,1348,11,122,82,157,133,239,883,1686,7,11934,663,0,2,1,4,7320,3217,692,6106,1
82,1712,1457,730,1242,11,6,188,1468,10,292,166,329,302,495,2424,4078,5,22973,1276,1,2,1,1,7320,3219,692,6107,0
82,1712,74,35,59,1,0,14,75,3,14,7,14,17,21,58,85,1,128,7,0,2,1,1,7320,3220,692,6108,0
82,1712,245,125,200,5,7,34,250,7,30,17,34,37,51,166,265,3,1053,58,0,2,1,1,7330,3221,692,6109,0
8,420,1289,550,1043,56,32,155,1345,10,167,93,185,177,278,1266,2075,5,11498,638,0,2,0,33,7330,3223,693,6110,0
31,1779,1457,730,1242,11,6,188,1468,10,292,166,329,302,495,2424,4078,5,22973,1276,1,2,0,17,7330,3225,693,6111,0
140,2380,1338,495,1086,10,64,173,1348,11,122,82,157,133,239,883,1686,7,11934,663,0,2,4,4,7330,3227,693,6112,1
82,1749,1457,730,1242,11,6,188,1468,10,292,166,329,302,495,2424,4078,5,22973,1276,1,2,8,4,7330,3229,693,6113,1
82,1749,74,35,59,1,0,14,75,3,14,7,14,17,21,58,85,1,128,7,0,2,8,4,7330,3230,693,6114,1
82,1749,245,125,200,5,7,34,250,7,30,17,34,37,51,166,265,3,1053,58,0,2,8,4,7340,3231,693,6115,1
40,360,647,139,84,35,284,233,682,0,0,0,0,0,0,0,0,0,0,0,0,2,1,0,7340,3231,693,6116,1
31,606,127,75,83,2,11,30,129,4,14,7,14,18,21,61,87,2,175,9,0,2,44,0,7340,3231,693,6117,1
31,606,652,304,544,16,6,88,668,6,89,51,101,95,152,591,998,3,3399,188,0,2,44,0,7340,3232,693,6118,1
31,606,2,2,2,0,0,0,2,0,0,0,0,0,0,0,0,0,0,0,0,2,44,0,7340,3232,693,6118,1
31,606,8,5,5,0,0,3,8,0,0,0,0,0,0,0,0,0,0,0,0,2,44,0,7340,3232,693,6119,1
31,606,2,2,2,0,0,0,2,0,0,0,0,0,0,0,0,0,0,0,0,2,44,0,7340,3232,693,6119,1
31,606,14,8,8,0,0,6,14,0,0,0,0,0,0,0,0,0,0,0,0,2,44,0,7340,3232,693,6120,1
31,606,6,4,4,0,0,2,6,0,0,0,0,0,0,0,0,0,0,0,0,2,44,0,7340,3232,693,6121,1
31,606,6,4,4,0,0,2,6,1,2,1,2,3,3,2,4,0,2,0,0,2,44,0,7340,3232,693,6122,1
31,606,6,4,4,0,0,2,6,0,0,0,0,0,0,0,0,0,0,0,0,2,44,0,7340,3232,693,6123,1
31,606,7,5,5,0,0,2,7,0,0,0,0,0,0,0,0,0,0,0,0,2,44,0,7340,3232,693,6124,1
31,606,6,4,4,0,0,2,6,0,0,0,0,0,0,0,0,0,0,0,0,2,44,0,7340,3232,693,6125,1
31,606,10,6,6,0,0,4,10,0,0,0,0,0,0,0,0,0,0,0,0,2,44,0,7340,3232,693,6126,1
31,606,1,1,1,0,0,0,1,0,0,0,0,0,0,0,0,0,0,0,0,2,44,0,7340,3232,693,6126,1
31,606,14,10,10,0,0,4,14,1,1,1,1,2,2,0,2,0,1,0,0,2,44,0,7340,3232,693,6127,1
31,606,46,26,30,3,0,12,49,3,6,3,6,9,9,20,28,1,42,2,0,2,44,0,7350,3232,693,6128,1
30,602,127,75,83,2,11,30,129,4,14,7,14,18,21,61,87,2,175,9,0,2,10,12,7350,3232,693,6129,0
30,602,652,304,544,16,6,88,668,6,89,51,101,95,152,591,998,3,3399,188,0,2,10,12,7350,3233,693,6130,0
30,602,2,2,2,0,0,0,2,0,0,0,0,0,0,0,0,0,0,0,0,2,10,12,7350,3233,693,6130,0
30,602,8,5,5,0,0,3,8,0,0,0,0,0,0,0,0,0,0,0,0,2,10,12,7350,3233,693,6131,0
30,602,2,2,2,0,0,0,2,0,0,0,0,0,0,0,0,0,0,0,0,2,10,12,7350,3233,693,6131,0
30,602,14,8,8,0,0,6,14,0,0,0,0,0,0,0,0,0,0,0,0,2,10,12,7350,3233,693,6132,0
30,602,6,4,4,0,0,2,6,0,0,0,0,0,0,0,0,0,0,0,0,2,10,12,7350,3233,693,6133,0
30,602,6,4,4,0,0,2,6,1,2,1,2,3,3,2,4,0,2,0,0,2,10,12,7350,3233,693,6134,0
30,602,6,4,4,0,0,2,6,0,0,0,0,0,0,0,0,0,0,0,0,2,10,12,7350,3233,693,6135,0
30,602,7,5,5,0,0,2,7,0,0,0,0,0,0,0,0,0,0,0,0,2,10,12,7350,3233,693,6136,0
30,602,6,4,4,0,0,2,6,0,0,0,0,0,0,0,0,0,0,0,0,2,10,12,7350,3233,693,6137,0
30,602,10,6,6,0,0,4,10,0,0,0,0,0,0,0,0,0,0,0,0,2,10,12,7350,3233,693,6138,0
30,602,1,1,1,0,0,0,1,0,0,0,0,0,0,0,0,0,0,0,0,2,10,12,7350,3233,693,6138,0
30,602,14,10,10,0,0,4,14,1,1,1,1,2,2,0,2,0,1,0,0,2,10,12,7350,3233,693,6139,0
30,602,46,26,30,3,0,12,49,3,6,3,6,9,9,20,28,1,42,2,0,2,10,12,7360,3233,693,6140,0
83,1755,1457,730,1242,11,6,188,1468,10,292,166,329,302,495,2424,4078,5,22973,1276,1,2,4,1,7360,3235,693,6141,1
83,1755,74,35,59,1,0,14,75,3,14,7,14,17,21,58,85,1,128,7,0,2,4,1,7360,3236,693,6142,1
83,1755,245,125,200,5,7,34,250,7,30,17,34,37,51,166,265,3,1053,58,0,2,4,1,7370,3237,693,6143,1
187,4173,182,127,129,0,0,53,182,5,39,21,42,44,63,217,343,2,926,51,0,2,2,1,7370,3237,694,6144,1
187,4173,1165,710,800,67,119,181,1232,18,243,153,282,261,435,2000,3492,10,36473,2026,1,2,2,1,7380,3237,695,6145,1
90,1868,384,251,317,7,8,52,391,11,70,44,84,81,128,467,811,6,5355,297,0,2,1,1,7380,3237,695,6146,1
90,1869,384,251,317,7,8,52,391,11,70,44,84,81,128,467,811,6,5355,297,0,2,2,1,7380,3237,695,6147,1
140,2370,1338,495,1086,10,64,173,1348,11,122,82,157,133,239,883,1686,7,11934,663,0,2,6,18,7380,3239,695,6148,0
83,1755,1457,730,1242,11,6,188,1468,10,292,166,329,302,495,2424,4078,5,22973,1276,1,2,2,2,7380,3241,695,6149,1
83,1755,74,35,59,1,0,14,75,3,14,7,14,17,21,58,85,1,128,7,0,2,2,2,7380,3242,695,6150,1
83,1755,245,125,200,5,7,34,250,7,30,17,34,37,51,166,265,3,1053,58,0,2,2,2,7390,3243,695,6151,1
90,1873,384,251,317,7,8,52,391,11,70,44,84,81,128,467,811,6,5355,297,0,2,3,2,7390,3243,695,6152,1
34,1885,1457,730,1242,11,6,188,1468,10,292,166,329,302,495,2424,4078,5,22973,1276,1,2,21,0,7390,3245,695,6153,1
57,2508,384,251,317,7,8,52,391,11,70,44,84,81,128,467,811,6,5355,297,0,2,2,0,7390,3245,695,6154,1
83,1769,1457,730,1242,11,6,188,1468,10,292,166,329,302,495,2424,4078,5,22973,1276,1,2,1,0,7390,3247,695,6155,0
83,1769,74,35,59,1,0,14,75,3,14,7,14,17,21,58,85,1,128,7,0,2,1,0,7390,3248,695,6156,0
83,1769,245,125,200,5,7,34,250,7,30,17,34,37,51,166,265,3,1053,58,0,2,1,0,7400,3249,695,6157,0
32,621,334,251,279,10,4,40,344,5,127,74,143,132,217,899,1528,2,4303,239,0,2,14,5,7400,3250,695,6158,0
92,1901,384,251,317,7,8,52,391,11,70,44,84,81,128,467,811,6,5355,297,0,2,11,10,7400,3250,695,6159,0
18,815,334,251,279,10,4,40,344,5,127,74,143,132,217,899,1528,2,4303,239,0,2,2,8,7400,3251,695,6160,0
57,2515,384,251,317,7,8,52,391,11,70,44,84,81,128,467,811,6,5355,297,0,2,7,8,7400,3251,695,6161,0
92,1901,384,251,317,7,8,52,391,11,70,44,84,81,128,467,811,6,5355,297,0,2,1,1,7400,3251,695,6162,1
139,2342,1338,495,1086,10,64,173,1348,11,122,82,157,133,239,883,1686,7,11934,663,0,2,72,101,7400,3253,695,6163,1
79,1704,1457,730,1242,11,6,188,1468,10,292,166,329,302,495,2424,4078,5,22973,1276,1,2,4,11,7400,3255,695,6164,1
79,1704,74,35,59,1,0,14,75,3,14,7,14,17,21,58,85,1,128,7,0,2,4,11,7400,3256,695,6165,1
79,1704,245,125,200,5,7,34,250,7,30,17,34,37,51,166,265,3,1053,58,0,2,4,11,7410,3257,695,6166,1
34,1906,1457,730,1242,11,6,188,1468,10,292,166,329,302,495,2424,4078,5,22973,1276,1,2,4,3,7410,3259,695,6167,1
92,1901,384,251,317,7,8,52,391,11,70,44,84,81,128,467,811,6,5355,297,0,2,1,1,7410,3259,695,6168,0
8,346,42,7,35,4,0,5,46,1,2,1,2,3,3,2,4,0,2,0,0,2,2,2,7420,3263,696,6176,0
8,346,11,6,10,0,0,1,11,2,4,2,4,6,6,10,15,1,15,0,0,2,2,2,7420,3263,696,6177,0
11,544,127,75,83,2,11,30,129,4,14,7,14,18,21,61,87,2,175,9,0,2,2,2,7430,3267,697,6185,1
11,544,652,304,544,16,6,88,668,6,89,51,101,95,152,591,998,3,3399,188,0,2,2,2,7430,3268,697,6186,1
11,544,2,2,2,0,0,0,2,0,0,0,0,0,0,0,0,0,0,0,0,2,2,2,7430,3268,697,6186,1
11,544,8,5,5,0,0,3,8,0,0,0,0,0,0,0,0,0,0,0,0,2,2,2,7430,3268,697,6187,1
11,544,2,2,2,0,0,0,2,0,0,0,0,0,0,0,0,0,0,0,0,2,2,2,7430,3268,697,6187,1
11,544,14,8,8,0,0,6,14,0,0,0,0,0,0,0,0,0,0,0,0,2,2,2,7430,3268,697,6188,1
11,544,6,4,4,0,0,2,6,0,0,0,0,0,0,0,0,0,0,0,0,2,2,2,7430,3268,697,6189,1
11,544,6,4,4,0,0,2,6,1,2,1,2,3,3,2,4,0,2,0,0,2,2,2,7430,3268,697,6190,1
11,544,6,4,4,0,0,2,6,0,0,0,0,0,0,0,0,0,0,0,0,2,2,2,7430,3268,697,6191,1
11,544,7,5,5,0,0,2,7,0,0,0,0,0,0,0,0,0,0,0,0,2,2,2,7430,3268,697,6192,1
11,544,6,4,4,0,0,2,6,0,0,0,0,0,0,0,0,0,0,0,0,2,2,2,7430,3268,697,6193,1
11,544,10,6,6,0,0,4,10,0,0,0,0,0,0,0,0,0,0,0,0,2,2,2,7430,3268,697,6194,1
11,544,1,1,1,0,0,0,1,0,0,0,0,0,0,0,0,0,0,0,0,2,2,2,7430,3268,697,6194,1
11,544,14,10,10,0,0,4,14,1,1,1,1,2,2,0,2,0,1,0,0,2,2,2,7430,3268,697,6195,1
11,544,46,26,30,3,0,12,49,3,6,3,6,9,9,20,28,1,42,2,0,2,2,2,7440,3268,697,6196,1
8,348,42,7,35,4,0,5,46,1,2,1,2,3,3,2,4,0,2,0,0,2,13,12,7440,3268,697,6197,1
8,348,11,6,10,0,0,1,11,2,4,2,4,6,6,10,15,1,15,0,0,2,13,12,7440,3268,697,6198,1
8,386,1289,550,1043,56,32,155,1345,10,167,93,185,177,278,1266,2075,5,11498,638,0,2,1,1,7440,3270,698,6199,1
8,376,1289,550,1043,56,32,155,1345,10,167,93,185,177,278,1266,2075,5,11498,638,0,2,2,2,7440,3272,699,6200,1
135,2241,1338,495,1086,10,64,173,1348,11,122,82,157,133,239,883,1686,7,11934,663,0,2,7,17,7440,3274,699,6201,1
85,1902,1457,730,1242,11,6,188,1468,10,292,166,329,302,495,2424,4078,5,22973,1276,1,2,34,11,7440,3276,699,6202,1
85,1902,74,35,59,1,0,14,75,3,14,7,14,17,21,58,85,1,128,7,0,2,34,11,7440,3277,699,6203,1
85,1902,245,125,200,5,7,34,250,7,30,17,34,37,51,166,265,3,1053,58,0,2,34,11,7450,3278,699,6204,1
33,626,373,158,315,8,0,51,381,5,76,44,79,81,123,486,779,2,2026,112,0,2,1,8,7450,3278,699,6205,1
34,1943,1457,730,1242,11,6,188,1468,10,292,166,329,302,495,2424,4078,5,22973,1276,1,2,16,14,7450,3280,699,6206,1
8,347,42,7,35,4,0,5,46,1,2,1,2,3,3,2,4,0,2,0,0,2,1,2,7450,3280,699,6207,1
8,347,11,6,10,0,0,1,11,2,4,2,4,6,6,10,15,1,15,0,0,2,1,2,7450,3280,699,6208,1
85,1902,1457,730,1242,11,6,188,1468,10,292,166,329,302,495,2424,4078,5,22973,1276,1,2,2,2,7450,3282,699,6209,1
85,1902,74,35,59,1,0,14,75,3,14,7,14,17,21,58,85,1,128,7,0,2,2,2,7450,3283,699,6210,1
85,1902,245,125,200,5,7,34,250,7,30,17,34,37,51,166,265,3,1053,58,0,2,2,2,7460,3284,699,6211,1
135,2241,1338,495,1086,10,64,173,1348,11,122,82,157,133,239,883,1686,7,11934,663,0,2,1,1,7470,3290,700,6219,1
81,1873,1457,730,1242,11,6,188,1468,10,292,166,329,302,495,2424,4078,5,22973,1276,1,2,7,11,7470,3292,700,6220,1
81,1873,74,35,59,1,0,14,75,3,14,7,14,17,21,58,85,1,128,7,0,2,7,11,7470,3293,700,6221,1
81,1873,245,125,200,5,7,34,250,7,30,17,34,37,51,166,265,3,1053,58,0,2,7,11,7480,3294,700,6222,1
95,3781,1392,870,1177,35,17,170,1427,14,494,280,531,508,811,4473,7289,7,54850,3047,2,2,1,1,7480,3297,701,6223,1
33,628,373,158,315,8,0,51,381,5,76,44,79,81,123,486,779,2,2026,112,0,2,1,4,7480,3297,701,6224,1
81,1888,1457,730,1242,11,6,188,1468,10,292,166,329,302,495,2424,4078,5,22973,1276,1,2,3,2,7480,3299,701,6225,0
81,1888,74,35,59,1,0,14,75,3,14,7,14,17,21,58,85,1,128,7,0,2,3,2,7480,3300,701,6226,0
81,1888,245,125,200,5,7,34,250,7,30,17,34,37,51,166,265,3,1053,58,0,2,3,2,7490,3301,701,6227,0
41,367,647,139,84,35,284,233,682,0,0,0,0,0,0,0,0,0,0,0,0,2,3,0,7490,3301,701,6228,1
20,429,127,75,83,2,11,30,129,4,14,7,14,18,21,61,87,2,175,9,0,2,5,38,7490,3301,701,6229,1
20,429,652,304,544,16,6,88,668,6,89,51,101,95,152,591,998,3,3399,188,0,2,5,38,7490,3302,701,6230,1
20,429,2,2,2,0,0,0,2,0,0,0,0,0,0,0,0,0,0,0,0,2,5,38,7490,3302,701,6230,1
20,429,8,5,5,0,0,3,8,0,0,0,0,0,0,0,0,0,0,0,0,2,5,38,7490,3302,701,6231,1
20,429,2,2,2,0,0,0,2,0,0,0,0,0,0,0,0,0,0,0,0,2,5,38,7490,3302,701,6231,1
20,429,14,8,8,0,0,6,14,0,0,0,0,0,0,0,0,0,0,0,0,2,5,38,7490,3302,701,6232,1
20,429,6,4,4,0,0,2,6,0,0,0,0,0,0,0,0,0,0,0,0,2,5,38,7490,3302,701,6233,1
20,429,6,4,4,0,0,2,6,1,2,1,2,3,3,2,4,0,2,0,0,2,5,38,7490,3302,701,6234,1
20,429,6,4,4,0,0,2,6,0,0,0,0,0,0,0,0,0,0,0,0,2,5,38,7490,3302,701,6235,1
20,429,7,5,5,0,0,2,7,0,0,0,0,0,0,0,0,0,0,0,0,2,5,38,7490,3302,701,6236,1
20,429,6,4,4,0,0,2,6,0,0,0,0,0,0,0,0,0,0,0,0,2,5,38,7490,3302,701,6237,1
20,429,10,6,6,0,0,4,10,0,0,0,0,0,0,0,0,0,0,0,0,2,5,38,7490,3302,701,6238,1
20,429,1,1,1,0,0,0,1,0,0,0,0,0,0,0,0,0,0,0,0,2,5,38,7490,3302,701,6238,1
20,429,14,10,10,0,0,4,14,1,1,1,1,2,2,0,2,0,1,0,0,2,5,38,7490,3302,701,6239,1
20,429,46,26,30,3,0,12,49,3,6,3,6,9,9,20,28,1,42,2,0,2,5,38,7500,3302,701,6240,1
70,1681,1457,730,1242,11,6,188,1468,10,292,166,329,302,495,2424,4078,5,22973,1276,1,2,4,38,7500,3304,701,6241,1
70,1681,74,35,59,1,0,14,75,3,14,7,14,17,21,58,85,1,128,7,0,2,4,38,7500,3305,701,6242,1
70,1681,245,125,200,5,7,34,250,7,30,17,34,37,51,166,265,3,1053,58,0,2,4,38,7510,3306,701,6243,1
96,1953,384,251,317,7,8,52,391,11,70,44,84,81,128,467,811,6,5355,297,0,2,12,0,7540,3315,703,6259,1
8,343,42,7,35,4,0,5,46,1,2,1,2,3,3,2,4,0,2,0,0,2,0,2,7540,3315,703,6260,1
8,343,11,6,10,0,0,1,11,2,4,2,4,6,6,10,15,1,15,0,0,2,0,2,7540,3315,703,6261,1
32,1840,1457,730,1242,11,6,188,1468,10,292,166,329,302,495,2424,4078,5,22973,1276,1,2,0,15,7570,3328,706,6289,1
15,439,1450,624,1228,12,26,181,1462,14,306,186,354,320,540,2580,4493,8,36391,2021,1,3,2,2,7620,3352,712,6336,1
187,4167,182,127,129,0,0,53,182,5,39,21,42,44,63,217,343,2,926,51,0,3,3,3,7620,3352,713,6337,1
187,4167,1165,710,800,67,119,181,1232,18,243,153,282,261,435,2000,3492,10,36473,2026,1,3,3,3,7630,3352,714,6338,1
70,1671,1457,730,1242,11,6,188,1468,10,292,166,329,302,495,2424,4078,5,22973,1276,1,3,5,5,7730,3394,725,6406,1
70,1671,74,35,59,1,0,14,75,3,14,7,14,17,21,58,85,1,128,7,0,3,5,5,7730,3395,725,6407,1
70,1671,245,125,200,5,7,34,250,7,30,17,34,37,51,166,265,3,1053,58,0,3,5,5,7740,3396,725,6408,1
96,1951,384,251,317,7,8,52,391,11,70,44,84,81,128,467,811,6,5355,297,0,3,3,3,7740,3397,725,6410,1
33,626,373,158,315,8,0,51,381,5,76,44,79,81,123,486,779,2,2026,112,0,3,1,1,7740,3397,725,6411,1
8,341,42,7,35,4,0,5,46,1,2,1,2,3,3,2,4,0,2,0,0,2,9,10,7750,3401,726,6419,1
8,341,11,6,10,0,0,1,11,2,4,2,4,6,6,10,15,1,15,0,0,2,9,10,7750,3401,726,6420,1
45,961,1450,624,1228,12,26,181,1462,14,306,186,354,320,540,2580,4493,8,36391,2021,1,2,1,1,7750,3403,727,6421,1
34,1126,182,127,129,0,0,53,182,5,39,21,42,44,63,217,343,2,926,51,0,2,2,2,7750,3403,728,6422,1
95,3779,1392,870,1177,35,17,170,1427,14,494,280,531,508,811,4473,7289,7,54850,3047,2,2,1,1,7750,3406,729,6423,1
55,1901,773,419,590,28,0,166,801,10,204,113,217,214,330,1598,2554,5,13587,754,0,2,5,5,7750,3406,730,6424,1
47,1953,1513,682,1277,25,13,200,1538,11,199,116,219,210,335,1557,2584,6,15641,868,0,2,1,1,7750,3408,730,6425,1
11,542,127,75,83,2,11,30,129,4,14,7,14,18,21,61,87,2,175,9,0,2,1,1,7750,3408,730,6426,1
11,542,652,304,544,16,6,88,668,6,89,51,101,95,152,591,998,3,3399,188,0,2,1,1,7750,3409,730,6427,1
11,542,2,2,2,0,0,0,2,0,0,0,0,0,0,0,0,0,0,0,0,2,1,1,7750,3409,730,6427,1
11,542,8,5,5,0,0,3,8,0,0,0,0,0,0,0,0,0,0,0,0,2,1,1,7750,3409,730,6428,1
11,542,2,2,2,0,0,0,2,0,0,0,0,0,0,0,0,0,0,0,0,2,1,1,7750,3409,730,6428,1
11,542,14,8,8,0,0,6,14,0,0,0,0,0,0,0,0,0,0,0,0,2,1,1,7750,3409,730,6429,1
11,542,6,4,4,0,0,2,6,0,0,0,0,0,0,0,0,0,0,0,0,2,1,1,7750,3409,730,6430,1
11,542,6,4,4,0,0,2,6,1,2,1,2,3,3,2,4,0,2,0,0,2,1,1,7750,3409,730,6431,1
11,542,6,4,4,0,0,2,6,0,0,0,0,0,0,0,0,0,0,0,0,2,1,1,7750,3409,730,6432,1
11,542,7,5,5,0,0,2,7,0,0,0,0,0,0,0,0,0,0,0,0,2,1,1,7750,3409,730,6433,1
11,542,6,4,4,0,0,2,6,0,0,0,0,0,0,0,0,0,0,0,0,2,1,1,7750,3409,730,6434,1
11,542,10,6,6,0,0,4,10,0,0,0,0,0,0,0,0,0,0,0,0,2,1,1,7750,3409,730,6435,1
11,542,1,1,1,0,0,0,1,0,0,0,0,0,0,0,0,0,0,0,0,2,1,1,7750,3409,730,6435,1
11,542,14,10,10,0,0,4,14,1,1,1,1,2,2,0,2,0,1,0,0,2,1,1,7750,3409,730,6436,1
11,542,46,26,30,3,0,12,49,3,6,3,6,9,9,20,28,1,42,2,0,2,1,1,7760,3409,730,6437,1
7,168,127,75,83,2,11,30,129,4,14,7,14,18,21,61,87,2,175,9,0,2,3,3,7760,3409,730,6438,1
7,168,652,304,544,16,6,88,668,6,89,51,101,95,152,591,998,3,3399,188,0,2,3,3,7760,3410,730,6439,1
7,168,2,2,2,0,0,0,2,0,0,0,0,0,0,0,0,0,0,0,0,2,3,3,7760,3410,730,6439,1
7,168,8,5,5,0,0,3,8,0,0,0,0,0,0,0,0,0,0,0,0,2,3,3,7760,3410,730,6440,1
7,168,2,2,2,0,0,0,2,0,0,0,0,0,0,0,0,0,0,0,0,2,3,3,7760,3410,730,6440,1
7,168,14,8,8,0,0,6,14,0,0,0,0,0,0,0,0,0,0,0,0,2,3,3,7760,3410,730,6441,1
7,168,6,4,4,0,0,2,6,0,0,0,0,0,0,0,0,0,0,0,0,2,3,3,7760,3410,730,6442,1
7,168,6,4,4,0,0,2,6,1,2,1,2,3,3,2,4,0,2,0,0,2,3,3,7760,3410,730,6443,1
7,168,6,4,4,0,0,2,6,0,0,0,0,0,0,0,0,0,0,0,0,2,3,3,7760,3410,730,6444,1
7,168,7,5,5,0,0,2,7,0,0,0,0,0,0,0,0,0,0,0,0,2,3,3,7760,3410,730,6445,1
7,168,6,4,4,0,0,2,6,0,0,0,0,0,0,0,0,0,0,0,0,2,3,3,7760,3410,730,6446,1
7,168,10,6,6,0,0,4,10,0,0,0,0,0,0,0,0,0,0,0,0,2,3,3,7760,3410,730,6447,1
7,168,1,1,1,0,0,0,1,0,0,0,0,0,0,0,0,0,0,0,0,2,3,3,7760,3410,730,6447,1
7,168,14,10,10,0,0,4,14,1,1,1,1,2,2,0,2,0,1,0,0,2,3,3,7760,3410,730,6448,1
7,168,46,26,30,3,0,12,49,3,6,3,6,9,9,20,28,1,42,2,0,2,3,3,7770,3410,730,6449,1
4,223,207,111,150,11,0,50,218,5,26,19,36,31,55,133,272,3,943,52,0,2,2,2,7770,3410,730,6450,1
32,1832,1457,730,1242,11,6,188,1468,10,292,166,329,302,495,2424,4078,5,22973,1276,1,2,4,4,7770,3412,730,6451,1
18,813,334,251,279,10,4,40,344,5,127,74,143,132,217,899,1528,2,4303,239,0,2,1,1,7770,3413,730,6452,1
57,2507,384,251,317,7,8,52,391,11,70,44,84,81,128,467,811,6,5355,297,0,2,4,4,7770,3413,730,6453,1
8,376,1289,550,1043,56,32,155,1345,10,167,93,185,177,278,1266,2075,5,11498,638,0,2,2,2,7770,3415,731,6454,1
57,2507,384,251,317,7,8,52,391,11,70,44,84,81,128,467,811,6,5355,297,0,2,2,2,7770,3415,731,6455,1
2,80,13,10,10,0,0,3,13,1,2,1,2,3,3,2,4,0,2,0,0,2,1,1,7770,3415,731,6456,1
96,1951,384,251,317,7,8,52,391,11,70,44,84,81,128,467,811,6,5355,297,0,2,1,1,7780,3416,732,6460,1
2,81,13,10,10,0,0,3,13,1,2,1,2,3,3,2,4,0,2,0,0,2,1,1,7780,3416,732,6461,0
136,2272,1338,495,1086,10,64,173,1348,11,122,82,157,133,239,883,1686,7,11934,663,0,2,26,25,7780,3418,732,6462,1
72,1693,1457,730,1242,11,6,188,1468,10,292,166,329,302,495,2424,4078,5,22973,1276,1,2,14,14,7780,3420,732,6463,1
72,1693,74,35,59,1,0,14,75,3,14,7,14,17,21,58,85,1,128,7,0,2,14,14,7780,3421,732,6464,1
72,1693,245,125,200,5,7,34,250,7,30,17,34,37,51,166,265,3,1053,58,0,2,14,14,7790,3422,732,6465,1
34,635,373,158,315,8,0,51,381,5,76,44,79,81,123,486,779,2,2026,112,0,2,2,0,7790,3422,732,6466,1
44,2711,1457,730,1242,11,6,188,1468,10,292,166,329,302,495,2424,4078,5,22973,1276,1,2,129,0,7790,3424,732,6467,1
19,818,373,158,315,8,0,51,381,5,76,44,79,81,123,486,779,2,2026,112,0,2,0,5,7790,3424,732,6468,1
187,4166,182,127,129,0,0,53,182,5,39,21,42,44,63,217,343,2,926,51,0,2,2,2,7790,3424,733,6469,0
187,4166,1165,710,800,67,119,181,1232,18,243,153,282,261,435,2000,3492,10,36473,2026,1,2,2,2,7800,3424,734,6470,0
97,3803,1392,870,1177,35,17,170,1427,14,494,280,531,508,811,4473,7289,7,54850,3047,2,2,4,2,7800,3427,735,6471,0
8,341,42,7,35,4,0,5,46,1,2,1,2,3,3,2,4,0,2,0,0,2,1,1,7810,3431,736,6479,1
8,341,11,6,10,0,0,1,11,2,4,2,4,6,6,10,15,1,15,0,0,2,1,1,7810,3431,736,6480,1
187,4169,182,127,129,0,0,53,182,5,39,21,42,44,63,217,343,2,926,51,0,2,5,5,7810,3431,737,6481,0
187,4169,1165,710,800,67,119,181,1232,18,243,153,282,261,435,2000,3492,10,36473,2026,1,2,5,5,7820,3431,738,6482,0
98,3979,1392,870,1177,35,17,170,1427,14,494,280,531,508,811,4473,7289,7,54850,3047,2,2,26,0,7820,3434,739,6483,0
1,83,13,10,10,0,0,3,13,1,2,1,2,3,3,2,4,0,2,0,0,2,8,7,7820,3434,739,6484,0
8,341,42,7,35,4,0,5,46,1,2,1,2,3,3,2,4,0,2,0,0,2,1,1,7830,3438,740,6492,1
8,341,11,6,10,0,0,1,11,2,4,2,4,6,6,10,15,1,15,0,0,2,1,1,7830,3438,740,6493,1
2,29,127,75,83,2,11,30,129,4,14,7,14,18,21,61,87,2,175,9,0,2,4,0,7830,3438,740,6494,0
2,29,652,304,544,16,6,88,668,6,89,51,101,95,152,591,998,3,3399,188,0,2,4,0,7830,3439,740,6495,0
2,29,2,2,2,0,0,0,2,0,0,0,0,0,0,0,0,0,0,0,0,2,4,0,7830,3439,740,6495,0
2,29,8,5,5,0,0,3,8,0,0,0,0,0,0,0,0,0,0,0,0,2,4,0,7830,3439,740,6496,0
2,29,2,2,2,0,0,0,2,0,0,0,0,0,0,0,0,0,0,0,0,2,4,0,7830,3439,740,6496,0
2,29,14,8,8,0,0,6,14,0,0,0,0,0,0,0,0,0,0,0,0,2,4,0,7830,3439,740,6497,0
2,29,6,4,4,0,0,2,6,0,0,0,0,0,0,0,0,0,0,0,0,2,4,0,7830,3439,740,6498,0
2,29,6,4,4,0,0,2,6,1,2,1,2,3,3,2,4,0,2,0,0,2,4,0,7830,3439,740,6499,0
2,29,6,4,4,0,0,2,6,0,0,0,0,0,0,0,0,0,0,0,0,2,4,0,7830,3439,740,6500,0
2,29,7,5,5,0,0,2,7,0,0,0,0,0,0,0,0,0,0,0,0,2,4,0,7830,3439,740,6501,0
2,29,6,4,4,0,0,2,6,0,0,0,0,0,0,0,0,0,0,0,0,2,4,0,7830,3439,740,6502,0
2,29,10,6,6,0,0,4,10,0,0,0,0,0,0,0,0,0,0,0,0,2,4,0,7830,3439,740,6503,0
2,29,1,1,1,0,0,0,1,0,0,0,0,0,0,0,0,0,0,0,0,2,4,0,7830,3439,740,6503,0
2,29,14,10,10,0,0,4,14,1,1,1,1,2,2,0,2,0,1,0,0,2,4,0,7830,3439,740,6504,0
2,29,46,26,30,3,0,12,49,3,6,3,6,9,9,20,28,1,42,2,0,2,4,0,7840,3439,740,6505,0
8,341,42,7,35,4,0,5,46,1,2,1,2,3,3,2,4,0,2,0,0,2,1,1,7850,3443,741,6513,0
8,341,11,6,10,0,0,1,11,2,4,2,4,6,6,10,15,1,15,0,0,2,1,1,7850,3443,741,6514,0
2,35,127,75,83,2,11,30,129,4,14,7,14,18,21,61,87,2,175,9,0,2,1,2,7850,3443,741,6515,0
2,35,652,304,544,16,6,88,668,6,89,51,101,95,152,591,998,3,3399,188,0,2,1,2,7850,3444,741,6516,0
2,35,2,2,2,0,0,0,2,0,0,0,0,0,0,0,0,0,0,0,0,2,1,2,7850,3444,741,6516,0
2,35,8,5,5,0,0,3,8,0,0,0,0,0,0,0,0,0,0,0,0,2,1,2,7850,3444,741,6517,0
2,35,2,2,2,0,0,0,2,0,0,0,0,0,0,0,0,0,0,0,0,2,1,2,7850,3444,741,6517,0
2,35,14,8,8,0,0,6,14,0,0,0,0,0,0,0,0,0,0,0,0,2,1,2,7850,3444,741,6518,0
2,35,6,4,4,0,0,2,6,0,0,0,0,0,0,0,0,0,0,0,0,2,1,2,7850,3444,741,6519,0
2,35,6,4,4,0,0,2,6,1,2,1,2,3,3,2,4,0,2,0,0,2,1,2,7850,3444,741,6520,0
2,35,6,4,4,0,0,2,6,0,0,0,0,0,0,0,0,0,0,0,0,2,1,2,7850,3444,741,6521,0
2,35,7,5,5,0,0,2,7,0,0,0,0,0,0,0,0,0,0,0,0,2,1,2,7850,3444,741,6522,0
2,35,6,4,4,0,0,2,6,0,0,0,0,0,0,0,0,0,0,0,0,2,1,2,7850,3444,741,6523,0
2,35,10,6,6,0,0,4,10,0,0,0,0,0,0,0,0,0,0,0,0,2,1,2,7850,3444,741,6524,0
2,35,1,1,1,0,0,0,1,0,0,0,0,0,0,0,0,0,0,0,0,2,1,2,7850,3444,741,6524,0
2,35,14,10,10,0,0,4,14,1,1,1,1,2,2,0,2,0,1,0,0,2,1,2,7850,3444,741,6525,0
2,35,46,26,30,3,0,12,49,3,6,3,6,9,9,20,28,1,42,2,0,2,1,2,7860,3444,741,6526,0
8,376,1289,550,1043,56,32,155,1345,10,167,93,185,177,278,1266,2075,5,11498,638,0,2,1,1,7860,3446,742,6527,1
8,376,1289,550,1043,56,32,155,1345,10,167,93,185,177,278,1266,2075,5,11498,638,0,2,1,1,7860,3448,743,6528,0
35,315,647,139,84,35,284,233,682,0,0,0,0,0,0,0,0,0,0,0,0,2,3,25,7870,3452,744,6536,1
100,2023,384,251,317,7,8,52,391,11,70,44,84,81,128,467,811,6,5355,297,0,2,16,3,7870,3452,744,6537,1
8,341,42,7,35,4,0,5,46,1,2,1,2,3,3,2,4,0,2,0,0,2,1,1,7870,3452,744,6538,1
8,341,11,6,10,0,0,1,11,2,4,2,4,6,6,10,15,1,15,0,0,2,1,1,7870,3452,744,6539,1
7,336,42,7,35,4,0,5,46,1,2,1,2,3,3,2,4,0,2,0,0,2,1,2,7880,3456,745,6547,0
7,336,11,6,10,0,0,1,11,2,4,2,4,6,6,10,15,1,15,0,0,2,1,2,7880,3456,745,6548,0
47,1977,1513,682,1277,25,13,200,1538,11,199,116,219,210,335,1557,2584,6,15641,868,0,2,9,0,7880,3458,745,6549,0
98,3995,1392,870,1177,35,17,170,1427,14,494,280,531,508,811,4473,7289,7,54850,3047,2,2,5,1,7880,3461,746,6550,0
55,1929,773,419,590,28,0,166,801,10,204,113,217,214,330,1598,2554,5,13587,754,0,2,10,0,7880,3461,747,6551,0
187,4174,182,127,129,0,0,53,182,5,39,21,42,44,63,217,343,2,926,51,0,2,2,1,7880,3461,748,6552,0
187,4174,1165,710,800,67,119,181,1232,18,243,153,282,261,435,2000,3492,10,36473,2026,1,2,2,1,7890,3461,749,6553,0
47,1957,1513,682,1277,25,13,200,1538,11,199,116,219,210,335,1557,2584,6,15641,868,0,2,1,1,7890,3463,749,6554,1
187,4174,182,127,129,0,0,53,182,5,39,21,42,44,63,217,343,2,926,51,0,2,2,1,7890,3463,750,6555,0
187,4174,1165,710,800,67,119,181,1232,18,243,153,282,261,435,2000,3492,10,36473,2026,1,2,2,1,7900,3463,751,6556,0
98,3995,1392,870,1177,35,17,170,1427,14,494,280,531,508,811,4473,7289,7,54850,3047,2,2,5,1,7900,3466,752,6557,0
55,1929,773,419,590,28,0,166,801,10,204,113,217,214,330,1598,2554,5,13587,754,0,2,10,0,7900,3466,753,6558,0
47,1981,1513,682,1277,25,13,200,1538,11,199,116,219,210,335,1557,2584,6,15641,868,0,2,9,0,7900,3468,753,6559,0
35,663,373,158,315,8,0,51,381,5,76,44,79,81,123,486,779,2,2026,112,0,2,14,10,7910,3472,754,6567,1
188,4195,182,127,129,0,0,53,182,5,39,21,42,44,63,217,343,2,926,51,0,2,4,1,7910,3472,755,6568,1
188,4195,1165,710,800,67,119,181,1232,18,243,153,282,261,435,2000,3492,10,36473,2026,1,2,4,1,7920,3472,756,6569,1
36,1177,182,127,129,0,0,53,182,5,39,21,42,44,63,217,343,2,926,51,0,2,7,0,7920,3472,757,6570,1
190,4250,182,127,129,0,0,53,182,5,39,21,42,44,63,217,343,2,926,51,0,2,12,2,7920,3472,758,6571,1
190,4250,1165,710,800,67,119,181,1232,18,243,153,282,261,435,2000,3492,10,36473,2026,1,2,12,2,7930,3472,759,6572,1
37,1193,182,127,129,0,0,53,182,5,39,21,42,44,63,217,343,2,926,51,0,2,2,0,7930,3472,760,6573,1
44,2719,1457,730,1242,11,6,188,1468,10,292,166,329,302,495,2424,4078,5,22973,1276,1,2,1,0,7930,3474,760,6574,1
72,1691,1457,730,1242,11,6,188,1468,10,292,166,329,302,495,2424,4078,5,22973,1276,1,2,1,1,7930,3476,760,6575,1
72,1691,74,35,59,1,0,14,75,3,14,7,14,17,21,58,85,1,128,7,0,2,1,1,7930,3477,760,6576,1
72,1691,245,125,200,5,7,34,250,7,30,17,34,37,51,166,265,3,1053,58,0,2,1,1,7940,3478,760,6577,1
135,2260,1338,495,1086,10,64,173,1348,11,122,82,157,133,239,883,1686,7,11934,663,0,2,4,6,7940,3480,760,6578,0
100,2021,384,251,317,7,8,52,391,11,70,44,84,81,128,467,811,6,5355,297,0,2,1,2,7950,3484,761,6586,1
35,660,373,158,315,8,0,51,381,5,76,44,79,81,123,486,779,2,2026,112,0,2,12,6,7950,3484,761,6587,1
44,2723,1457,730,1242,11,6,188,1468,10,292,166,329,302,495,2424,4078,5,22973,1276,1,2,4,3,7950,3486,761,6588,1
100,2021,384,251,317,7,8,52,391,11,70,44,84,81,128,467,811,6,5355,297,0,2,1,1,7950,3486,761,6589,1
44,2723,1457,730,1242,11,6,188,1468,10,292,166,329,302,495,2424,4078,5,22973,1276,1,2,2,2,7950,3488,761,6590,1
65,1718,1513,682,1277,25,13,200,1538,11,199,116,219,210,335,1557,2584,6,15641,868,0,2,2,0,7950,3490,761,6591,1
65,1718,819,519,539,24,98,155,843,15,96,57,106,111,163,690,1107,8,9171,509,0,2,2,0,7960,3492,761,6592,1
193,4289,182,127,129,0,0,53,182,5,39,21,42,44,63,217,343,2,926,51,0,2,17,8,7960,3492,762,6593,1
193,4289,1165,710,800,67,119,181,1232,18,243,153,282,261,435,2000,3492,10,36473,2026,1,2,17,8,7970,3492,763,6594,1
40,1273,182,127,129,0,0,53,182,5,39,21,42,44,63,217,343,2,926,51,0,2,17,1,7970,3492,764,6595,1
8,369,1289,550,1043,56,32,155,1345,10,167,93,185,177,278,1266,2075,5,11498,638,0,2,5,5,7970,3494,765,6596,1
18,812,334,251,279,10,4,40,344,5,127,74,143,132,217,899,1528,2,4303,239,0,2,1,1,7970,3495,765,6597,1
57,2505,384,251,317,7,8,52,391,11,70,44,84,81,128,467,811,6,5355,297,0,2,1,1,7970,3495,765,6598,1
15,451,1450,624,1228,12,26,181,1462,14,306,186,354,320,540,2580,4493,8,36391,2021,1,2,9,7,7980,3501,767,6606,0
193,4285,182,127,129,0,0,53,182,5,39,21,42,44,63,217,343,2,926,51,0,2,1,2,7980,3501,768,6607,0
193,4285,1165,710,800,67,119,181,1232,18,243,153,282,261,435,2000,3492,10,36473,2026,1,2,1,2,7990,3501,769,6608,0
46,981,1450,624,1228,12,26,181,1462,14,306,186,354,320,540,2580,4493,8,36391,2021,1,2,4,2,7990,3503,770,6609,0
47,1972,1513,682,1277,25,13,200,1538,11,199,116,219,210,335,1557,2584,6,15641,868,0,2,1,2,8000,3509,771,6617,0
184,4050,182,127,129,0,0,53,182,5,39,21,42,44,63,217,343,2,926,51,0,2,3,45,8010,3513,773,6625,1
184,4050,1165,710,800,67,119,181,1232,18,243,153,282,261,435,2000,3492,10,36473,2026,1,2,3,45,8020,3513,774,6626,1
9,265,149,95,105,2,0,41,151,8,54,28,55,62,83,334,494,4,2013,111,0,0,55,0,8020,3513,774,6627,1
9,265,82,56,54,0,13,15,82,4,13,8,16,17,24,56,98,2,241,13,0,0,55,0,8030,3513,774,6628,1
31,1044,182,127,129,0,0,53,182,5,39,21,42,44,63,217,343,2,926,51,0,2,0,38,8030,3513,775,6629,1
21,588,149,95,105,2,0,41,151,8,54,28,55,62,83,334,494,4,2013,111,0,0,99,0,8030,3513,775,6630,1
9,270,149,95,105,2,0,41,151,8,54,28,55,62,83,334,494,4,2013,111,0,2,1,0,8030,3513,775,6631,0
9,270,82,56,54,0,13,15,82,4,13,8,16,17,24,56,98,2,241,13,0,2,1,0,8040,3513,775,6632,0
36,329,647,139,84,35,284,233,682,0,0,0,0,0,0,0,0,0,0,0,0,2,7,0,8040,3513,775,6633,0
127,2187,1338,495,1086,10,64,173,1348,11,122,82,157,133,239,883,1686,7,11934,663,0,2,3,16,8040,3515,775,6634,0
37,343,647,139,84,35,284,233,682,0,0,0,0,0,0,0,0,0,0,0,0,2,8,0,8040,3515,775,6635,0
66,1725,1513,682,1277,25,13,200,1538,11,199,116,219,210,335,1557,2584,6,15641,868,0,2,2,0,8040,3517,775,6636,0
66,1725,819,519,539,24,98,155,843,15,96,57,106,111,163,690,1107,8,9171,509,0,2,2,0,8050,3519,775,6637,0
47,1977,1513,682,1277,25,13,200,1538,11,199,116,219,210,335,1557,2584,6,15641,868,0,2,1,0,8050,3521,775,6638,0
7,336,42,7,35,4,0,5,46,1,2,1,2,3,3,2,4,0,2,0,0,2,1,1,8060,3525,776,6646,1
7,336,11,6,10,0,0,1,11,2,4,2,4,6,6,10,15,1,15,0,0,2,1,1,8060,3525,776,6647,1
37,343,647,139,84,35,284,233,682,0,0,0,0,0,0,0,0,0,0,0,0,2,2,2,8060,3525,776,6648,0
127,2187,1338,495,1086,10,64,173,1348,11,122,82,157,133,239,883,1686,7,11934,663,0,2,1,1,8060,3527,776,6649,0
37,343,647,139,84,35,284,233,682,0,0,0,0,0,0,0,0,0,0,0,0,2,6,6,8060,3527,776,6650,1
102,2071,384,251,317,7,8,52,391,11,70,44,84,81,128,467,811,6,5355,297,0,2,16,8,8060,3527,776,6651,1
61,2680,384,251,317,7,8,52,391,11,70,44,84,81,128,467,811,6,5355,297,0,2,59,6,8060,3527,776,6652,1
7,338,42,7,35,4,0,5,46,1,2,1,2,3,3,2,4,0,2,0,0,2,2,1,8060,3527,776,6653,1
7,338,11,6,10,0,0,1,11,2,4,2,4,6,6,10,15,1,15,0,0,2,2,1,8060,3527,776,6654,1
7,338,42,7,35,4,0,5,46,1,2,1,2,3,3,2,4,0,2,0,0,2,1,1,8060,3527,776,6655,1
7,338,11,6,10,0,0,1,11,2,4,2,4,6,6,10,15,1,15,0,0,2,1,1,8060,3527,776,6656,1
9,414,1289,550,1043,56,32,155,1345,10,167,93,185,177,278,1266,2075,5,11498,638,0,2,16,0,8070,3533,778,6664,1
170,3700,182,127,129,0,0,53,182,5,39,21,42,44,63,217,343,2,926,51,0,2,6,56,8070,3533,779,6665,1
170,3700,1165,710,800,67,119,181,1232,18,243,153,282,261,435,2000,3492,10,36473,2026,1,2,6,56,8080,3533,780,6666,1
72,1616,773,419,590,28,0,166,801,10,204,113,217,214,330,1598,2554,5,13587,754,0,2,20,40,8080,3533,781,6667,1
72,1616,421,273,302,44,34,57,465,17,81,59,107,98,166,583,1098,11,12329,684,0,2,20,40,8080,3533,782,6668,1
20,590,182,127,129,0,0,53,182,5,39,21,42,44,63,217,343,2,926,51,0,2,0,75,8080,3533,783,6669,1
98,3993,1392,870,1177,35,17,170,1427,14,494,280,531,508,811,4473,7289,7,54850,3047,2,2,0,1,8080,3536,784,6670,1
55,1917,773,419,590,28,0,166,801,10,204,113,217,214,330,1598,2554,5,13587,754,0,2,3,11,8080,3536,785,6671,1
7,338,42,7,35,4,0,5,46,1,2,1,2,3,3,2,4,0,2,0,0,2,1,1,8090,3540,786,6679,0
7,338,11,6,10,0,0,1,11,2,4,2,4,6,6,10,15,1,15,0,0,2,1,1,8090,3540,786,6680,0
170,3700,182,127,129,0,0,53,182,5,39,21,42,44,63,217,343,2,926,51,0,2,6,56,8100,3544,788,6688,0
170,3700,1165,710,800,67,119,181,1232,18,243,153,282,261,435,2000,3492,10,36473,2026,1,2,6,56,8110,3544,789,6689,0
72,1616,773,419,590,28,0,166,801,10,204,113,217,214,330,1598,2554,5,13587,754,0,2,20,40,8110,3544,790,6690,0
72,1616,421,273,302,44,34,57,465,17,81,59,107,98,166,583,1098,11,12329,684,0,2,20,40,8110,3544,791,6691,0
7,338,42,7,35,4,0,5,46,1,2,1,2,3,3,2,4,0,2,0,0,2,1,1,8110,3544,791,6692,0
7,338,11,6,10,0,0,1,11,2,4,2,4,6,6,10,15,1,15,0,0,2,1,1,8110,3544,791,6693,0
9,414,1289,550,1043,56,32,155,1345,10,167,93,185,177,278,1266,2075,5,11498,638,0,2,16,0,8110,3546,792,6694,0
20,590,182,127,129,0,0,53,182,5,39,21,42,44,63,217,343,2,926,51,0,2,0,75,8110,3546,793,6695,0
98,3993,1392,870,1177,35,17,170,1427,14,494,280,531,508,811,4473,7289,7,54850,3047,2,2,0,1,8110,3549,794,6696,0
55,1917,773,419,590,28,0,166,801,10,204,113,217,214,330,1598,2554,5,13587,754,0,2,3,11,8110,3549,795,6697,0
54,1911,773,419,590,28,0,166,801,10,204,113,217,214,330,1598,2554,5,13587,754,0,2,1,2,8110,3549,796,6698,1
12,564,1289,550,1043,56,32,155,1345,10,167,93,185,177,278,1266,2075,5,11498,638,0,2,42,0,8110,3551,797,6699,1
54,1884,773,419,590,28,0,166,801,10,204,113,217,214,330,1598,2554,5,13587,754,0,2,2,5,8110,3551,798,6700,0
72,1661,773,419,590,28,0,166,801,10,204,113,217,214,330,1598,2554,5,13587,754,0,2,9,1,8110,3551,799,6701,0
72,1661,421,273,302,44,34,57,465,17,81,59,107,98,166,583,1098,11,12329,684,0,2,9,1,8110,3551,800,6702,0
87,1695,1513,682,1277,25,13,200,1538,11,199,116,219,210,335,1557,2584,6,15641,868,0,2,103,103,8110,3553,800,6703,1
87,1695,819,519,539,24,98,155,843,15,96,57,106,111,163,690,1107,8,9171,509,0,2,103,103,8120,3555,800,6704,1
51,2204,1513,682,1277,25,13,200,1538,11,199,116,219,210,335,1557,2584,6,15641,868,0,2,43,3,8120,3557,800,6705,1
89,1783,1513,682,1277,25,13,200,1538,11,199,116,219,210,335,1557,2584,6,15641,868,0,2,29,25,8120,3559,800,6706,0
89,1783,819,519,539,24,98,155,843,15,96,57,106,111,163,690,1107,8,9171,509,0,2,29,25,8130,3561,800,6707,0
66,2628,1513,682,1277,25,13,200,1538,11,199,116,219,210,335,1557,2584,6,15641,868,0,2,81,8,8130,3563,800,6708,0
92,1793,1513,682,1277,25,13,200,1538,11,199,116,219,210,335,1557,2584,6,15641,868,0,2,16,6,8130,3565,800,6709,0
92,1793,819,519,539,24,98,155,843,15,96,57,106,111,163,690,1107,8,9171,509,0,2,16,6,8140,3567,800,6710,0
67,2673,1513,682,1277,25,13,200,1538,11,199,116,219,210,335,1557,2584,6,15641,868,0,2,22,0,8140,3569,800,6711,0
91,1781,1513,682,1277,25,13,200,1538,11,199,116,219,210,335,1557,2584,6,15641,868,0,2,26,35,8140,3571,800,6712,0
91,1781,819,519,539,24,98,155,843,15,96,57,106,111,163,690,1107,8,9171,509,0,2,26,35,8150,3573,800,6713,0
67,2671,1513,682,1277,25,13,200,1538,11,199,116,219,210,335,1557,2584,6,15641,868,0,2,1,2,8150,3575,800,6714,0
68,2725,1513,682,1277,25,13,200,1538,11,199,116,219,210,335,1557,2584,6,15641,868,0,2,11,1,8150,3577,800,6715,0
95,1800,1513,682,1277,25,13,200,1538,11,199,116,219,210,335,1557,2584,6,15641,868,0,2,18,20,8150,3579,800,6716,0
95,1800,819,519,539,24,98,155,843,15,96,57,106,111,163,690,1107,8,9171,509,0,2,18,20,8160,3581,800,6717,0
67,2671,1513,682,1277,25,13,200,1538,11,199,116,219,210,335,1557,2584,6,15641,868,0,2,1,11,8160,3583,800,6718,0
95,1806,1513,682,1277,25,13,200,1538,11,199,116,219,210,335,1557,2584,6,15641,868,0,2,1,0,8160,3585,800,6719,0
95,1806,819,519,539,24,98,155,843,15,96,57,106,111,163,690,1107,8,9171,509,0,2,1,0,8170,3587,800,6720,0
105,2122,384,251,317,7,8,52,391,11,70,44,84,81,128,467,811,6,5355,297,0,2,7,0,8170,3587,800,6721,1
62,2713,384,251,317,7,8,52,391,11,70,44,84,81,128,467,811,6,5355,297,0,2,26,0,8170,3587,800,6722,1
102,2071,384,251,317,7,8,52,391,11,70,44,84,81,128,467,811,6,5355,297,0,2,0,7,8170,3587,800,6723,1
61,2680,384,251,317,7,8,52,391,11,70,44,84,81,128,467,811,6,5355,297,0,2,0,26,8170,3587,800,6724,1
75,1691,773,419,590,28,0,166,801,10,204,113,217,214,330,1598,2554,5,13587,754,0,2,5,1,8170,3587,801,6725,1
75,1691,421,273,302,44,34,57,465,17,81,59,107,98,166,583,1098,11,12329,684,0,2,5,1,8170,3587,802,6726,1
57,1972,773,419,590,28,0,166,801,10,204,113,217,214,330,1598,2554,5,13587,754,0,2,14,0,8170,3587,803,6727,1
175,3745,182,127,129,0,0,53,182,5,39,21,42,44,63,217,343,2,926,51,0,2,30,18,8170,3587,804,6728,1
175,3745,1165,710,800,67,119,181,1232,18,243,153,282,261,435,2000,3492,10,36473,2026,1,2,30,18,8180,3587,805,6729,1
128,2196,1338,495,1086,10,64,173,1348,11,122,82,157,133,239,883,1686,7,11934,663,0,2,6,5,8180,3589,805,6730,1
98,3995,1392,870,1177,35,17,170,1427,14,494,280,531,508,811,4473,7289,7,54850,3047,2,2,10,10,8180,3592,806,6731,1
7,338,42,7,35,4,0,5,46,1,2,1,2,3,3,2,4,0,2,0,0,2,1,1,8190,3596,807,6739,1
7,338,11,6,10,0,0,1,11,2,4,2,4,6,6,10,15,1,15,0,0,2,1,1,8190,3596,807,6740,1
4,68,38,23,23,0,0,15,38,0,0,0,0,0,0,0,0,0,0,0,0,0,16,0,8190,3596,807,6741,0
29,591,127,75,83,2,11,30,129,4,14,7,14,18,21,61,87,2,175,9,0,2,22,1,8190,3596,807,6742,0
29,591,652,304,544,16,6,88,668,6,89,51,101,95,152,591,998,3,3399,188,0,2,22,1,8190,3597,807,6743,0
29,591,2,2,2,0,0,0,2,0,0,0,0,0,0,0,0,0,0,0,0,2,22,1,8190,3597,807,6743,0
29,591,8,5,5,0,0,3,8,0,0,0,0,0,0,0,0,0,0,0,0,2,22,1,8190,3597,807,6744,0
29,591,2,2,2,0,0,0,2,0,0,0,0,0,0,0,0,0,0,0,0,2,22,1,8190,3597,807,6744,0
29,591,14,8,8,0,0,6,14,0,0,0,0,0,0,0,0,0,0,0,0,2,22,1,8190,3597,807,6745,0
29,591,6,4,4,0,0,2,6,0,0,0,0,0,0,0,0,0,0,0,0,2,22,1,8190,3597,807,6746,0
29,591,6,4,4,0,0,2,6,1,2,1,2,3,3,2,4,0,2,0,0,2,22,1,8190,3597,807,6747,0
29,591,6,4,4,0,0,2,6,0,0,0,0,0,0,0,0,0,0,0,0,2,22,1,8190,3597,807,6748,0
29,591,7,5,5,0,0,2,7,0,0,0,0,0,0,0,0,0,0,0,0,2,22,1,8190,3597,807,6749,0
29,591,6,4,4,0,0,2,6,0,0,0,0,0,0,0,0,0,0,0,0,2,22,1,8190,3597,807,6750,0
29,591,10,6,6,0,0,4,10,0,0,0,0,0,0,0,0,0,0,0,0,2,22,1,8190,3597,807,6751,0
29,591,1,1,1,0,0,0,1,0,0,0,0,0,0,0,0,0,0,0,0,2,22,1,8190,3597,807,6751,0
29,591,14,10,10,0,0,4,14,1,1,1,1,2,2,0,2,0,1,0,0,2,22,1,8190,3597,807,6752,0
29,591,46,26,30,3,0,12,49,3,6,3,6,9,9,20,28,1,42,2,0,2,22,1,8200,3597,807,6753,0
29,591,127,75,83,2,11,30,129,4,14,7,14,18,21,61,87,2,175,9,0,2,22,1,8200,3597,807,6754,0
29,591,652,304,544,16,6,88,668,6,89,51,101,95,152,591,998,3,3399,188,0,2,22,1,8200,3598,807,6755,0
29,591,2,2,2,0,0,0,2,0,0,0,0,0,0,0,0,0,0,0,0,2,22,1,8200,3598,807,6755,0
29,591,8,5,5,0,0,3,8,0,0,0,0,0,0,0,0,0,0,0,0,2,22,1,8200,3598,807,6756,0
29,591,2,2,2,0,0,0,2,0,0,0,0,0,0,0,0,0,0,0,0,2,22,1,8200,3598,807,6756,0
29,591,14,8,8,0,0,6,14,0,0,0,0,0,0,0,0,0,0,0,0,2,22,1,8200,3598,807,6757,0
29,591,6,4,4,0,0,2,6,0,0,0,0,0,0,0,0,0,0,0,0,2,22,1,8200,3598,807,6758,0
29,591,6,4,4,0,0,2,6,1,2,1,2,3,3,2,4,0,2,0,0,2,22,1,8200,3598,807,6759,0
29,591,6,4,4,0,0,2,6,0,0,0,0,0,0,0,0,0,0,0,0,2,22,1,8200,3598,807,6760,0
29,591,7,5,5,0,0,2,7,0,0,0,0,0,0,0,0,0,0,0,0,2,22,1,8200,3598,807,6761,0
29,591,6,4,4,0,0,2,6,0,0,0,0,0,0,0,0,0,0,0,0,2,22,1,8200,3598,807,6762,0
29,591,10,6,6,0,0,4,10,0,0,0,0,0,0,0,0,0,0,0,0,2,22,1,8200,3598,807,6763,0
29,591,1,1,1,0,0,0,1,0,0,0,0,0,0,0,0,0,0,0,0,2,22,1,8200,3598,807,6763,0
29,591,14,10,10,0,0,4,14,1,1,1,1,2,2,0,2,0,1,0,0,2,22,1,8200,3598,807,6764,0
29,591,46,26,30,3,0,12,49,3,6,3,6,9,9,20,28,1,42,2,0,2,22,1,8210,3598,807,6765,0
36,699,373,158,315,8,0,51,381,5,76,44,79,81,123,486,779,2,2026,112,0,2,13,7,8210,3598,807,6766,1
20,857,373,158,315,8,0,51,381,5,76,44,79,81,123,486,779,2,2026,112,0,2,10,0,8210,3598,807,6767,1
36,702,373,158,315,8,0,51,381,5,76,44,79,81,123,486,779,2,2026,112,0,2,1,0,8210,3598,807,6768,1
7,338,42,7,35,4,0,5,46,1,2,1,2,3,3,2,4,0,2,0,0,2,1,1,8220,3602,808,6776,1
7,338,11,6,10,0,0,1,11,2,4,2,4,6,6,10,15,1,15,0,0,2,1,1,8220,3602,808,6777,1
12,386,15,9,9,0,0,6,15,0,0,0,0,0,0,0,0,0,0,0,0,2,2,2,8220,3602,808,6778,0
75,1712,773,419,590,28,0,166,801,10,204,113,217,214,330,1598,2554,5,13587,754,0,2,5,2,8240,3610,811,6793,0
75,1712,421,273,302,44,34,57,465,17,81,59,107,98,166,583,1098,11,12329,684,0,2,5,2,8240,3610,812,6794,0
59,2040,773,419,590,28,0,166,801,10,204,113,217,214,330,1598,2554,5,13587,754,0,2,19,3,8240,3610,813,6795,0
128,2201,1338,495,1086,10,64,173,1348,11,122,82,157,133,239,883,1686,7,11934,663,0,2,2,1,8250,3616,814,6803,1
48,1010,1450,624,1228,12,26,181,1462,14,306,186,354,320,540,2580,4493,8,36391,2021,1,2,7,0,8260,3622,816,6811,1
50,1037,1450,624,1228,12,26,181,1462,14,306,186,354,320,540,2580,4493,8,36391,2021,1,2,7,0,8260,3624,817,6812,1
102,2071,384,251,317,7,8,52,391,11,70,44,84,81,128,467,811,6,5355,297,0,2,2,2,8260,3624,817,6813,1
50,1037,1450,624,1228,12,26,181,1462,14,306,186,354,320,540,2580,4493,8,36391,2021,1,2,1,1,8260,3626,818,6814,0
7,338,42,7,35,4,0,5,46,1,2,1,2,3,3,2,4,0,2,0,0,2,3,3,8260,3626,818,6815,0
7,338,11,6,10,0,0,1,11,2,4,2,4,6,6,10,15,1,15,0,0,2,3,3,8260,3626,818,6816,0
130,2241,1338,495,1086,10,64,173,1348,11,122,82,157,133,239,883,1686,7,11934,663,0,2,11,4,8260,3628,818,6817,1
20,856,373,158,315,8,0,51,381,5,76,44,79,81,123,486,779,2,2026,112,0,2,1,1,8260,3628,818,6818,1
59,2043,773,419,590,28,0,166,801,10,204,113,217,214,330,1598,2554,5,13587,754,0,2,1,1,8260,3628,819,6819,1
7,338,42,7,35,4,0,5,46,1,2,1,2,3,3,2,4,0,2,0,0,2,1,1,8270,3632,820,6827,1
7,338,11,6,10,0,0,1,11,2,4,2,4,6,6,10,15,1,15,0,0,2,1,1,8270,3632,820,6828,1
7,338,42,7,35,4,0,5,46,1,2,1,2,3,3,2,4,0,2,0,0,2,1,1,8280,3636,821,6836,1
7,338,11,6,10,0,0,1,11,2,4,2,4,6,6,10,15,1,15,0,0,2,1,1,8280,3636,821,6837,1
29,591,127,75,83,2,11,30,129,4,14,7,14,18,21,61,87,2,175,9,0,2,5,5,8280,3636,821,6838,1
29,591,652,304,544,16,6,88,668,6,89,51,101,95,152,591,998,3,3399,188,0,2,5,5,8280,3637,821,6839,1
29,591,2,2,2,0,0,0,2,0,0,0,0,0,0,0,0,0,0,0,0,2,5,5,8280,3637,821,6839,1
29,591,8,5,5,0,0,3,8,0,0,0,0,0,0,0,0,0,0,0,0,2,5,5,8280,3637,821,6840,1
29,591,2,2,2,0,0,0,2,0,0,0,0,0,0,0,0,0,0,0,0,2,5,5,8280,3637,821,6840,1
29,591,14,8,8,0,0,6,14,0,0,0,0,0,0,0,0,0,0,0,0,2,5,5,8280,3637,821,6841,1
29,591,6,4,4,0,0,2,6,0,0,0,0,0,0,0,0,0,0,0,0,2,5,5,8280,3637,821,6842,1
29,591,6,4,4,0,0,2,6,1,2,1,2,3,3,2,4,0,2,0,0,2,5,5,8280,3637,821,6843,1
29,591,6,4,4,0,0,2,6,0,0,0,0,0,0,0,0,0,0,0,0,2,5,5,8280,3637,821,6844,1
29,591,7,5,5,0,0,2,7,0,0,0,0,0,0,0,0,0,0,0,0,2,5,5,8280,3637,821,6845,1
29,591,6,4,4,0,0,2,6,0,0,0,0,0,0,0,0,0,0,0,0,2,5,5,8280,3637,821,6846,1
29,591,10,6,6,0,0,4,10,0,0,0,0,0,0,0,0,0,0,0,0,2,5,5,8280,3637,821,6847,1
29,591,1,1,1,0,0,0,1,0,0,0,0,0,0,0,0,0,0,0,0,2,5,5,8280,3637,821,6847,1
29,591,14,10,10,0,0,4,14,1,1,1,1,2,2,0,2,0,1,0,0,2,5,5,8280,3637,821,6848,1
29,591,46,26,30,3,0,12,49,3,6,3,6,9,9,20,28,1,42,2,0,2,5,5,8290,3637,821,6849,1
18,389,2,2,2,0,0,0,2,0,0,0,0,0,0,0,0,0,0,0,0,2,12,12,8290,3637,821,6849,1
18,389,99,48,90,1,3,5,100,0,0,0,0,0,0,0,0,0,0,0,0,2,12,12,8290,3638,821,6850,1
18,389,8,5,5,2,0,1,10,0,0,0,0,0,0,0,0,0,0,0,0,2,12,12,8290,3638,821,6851,1
18,389,1217,716,841,84,126,174,1301,14,185,118,215,199,333,1446,2542,8,20687,1149,0,2,12,12,8300,3640,821,6852,1
18,389,160,89,115,0,13,31,160,7,15,11,17,22,28,78,124,3,495,27,0,2,12,12,8300,3640,821,6853,1
18,389,10,10,9,9,0,0,19,0,0,0,0,0,0,0,0,0,0,0,0,2,12,12,8300,3640,822,6854,1
18,389,173,84,99,8,29,36,181,5,12,7,13,17,20,54,81,2,221,12,0,2,12,12,8300,3641,822,6855,1
18,389,3,1,1,3,0,0,6,0,0,0,0,0,0,0,0,0,0,0,0,2,12,12,8300,3641,822,6856,1
36,512,282,196,195,3,0,86,285,8,130,71,141,138,212,936,1507,4,6538,363,0,2,3,3,8300,3641,823,6857,1
1,9,2,2,2,0,0,0,2,0,0,0,0,0,0,0,0,0,0,0,0,2,1,1,8300,3641,823,6857,1
1,83,13,10,10,0,0,3,13,1,2,1,2,3,3,2,4,0,2,0,0,2,1,1,8300,3641,823,6858,1
3,67,127,75,83,2,11,30,129,4,14,7,14,18,21,61,87,2,175,9,0,2,2,2,8300,3641,823,6859,1
3,67,652,304,544,16,6,88,668,6,89,51,101,95,152,591,998,3,3399,188,0,2,2,2,8300,3642,823,6860,1
3,67,2,2,2,0,0,0,2,0,0,0,0,0,0,0,0,0,0,0,0,2,2,2,8300,3642,823,6860,1
3,67,8,5,5,0,0,3,8,0,0,0,0,0,0,0,0,0,0,0,0,2,2,2,8300,3642,823,6861,1
3,67,2,2,2,0,0,0,2,0,0,0,0,0,0,0,0,0,0,0,0,2,2,2,8300,3642,823,6861,1
3,67,14,8,8,0,0,6,14,0,0,0,0,0,0,0,0,0,0,0,0,2,2,2,8300,3642,823,6862,1
3,67,6,4,4,0,0,2,6,0,0,0,0,0,0,0,0,0,0,0,0,2,2,2,8300,3642,823,6863,1
3,67,6,4,4,0,0,2,6,1,2,1,2,3,3,2,4,0,2,0,0,2,2,2,8300,3642,823,6864,1
3,67,6,4,4,0,0,2,6,0,0,0,0,0,0,0,0,0,0,0,0,2,2,2,8300,3642,823,6865,1
3,67,7,5,5,0,0,2,7,0,0,0,0,0,0,0,0,0,0,0,0,2,2,2,8300,3642,823,6866,1
3,67,6,4,4,0,0,2,6,0,0,0,0,0,0,0,0,0,0,0,0,2,2,2,8300,3642,823,6867,1
3,67,10,6,6,0,0,4,10,0,0,0,0,0,0,0,0,0,0,0,0,2,2,2,8300,3642,823,6868,1
3,67,1,1,1,0,0,0,1,0,0,0,0,0,0,0,0,0,0,0,0,2,2,2,8300,3642,823,6868,1
3,67,14,10,10,0,0,4,14,1,1,1,1,2,2,0,2,0,1,0,0,2,2,2,8300,3642,823,6869,1
3,67,46,26,30,3,0,12,49,3,6,3,6,9,9,20,28,1,42,2,0,2,2,2,8310,3642,823,6870,1
6,106,127,75,83,2,11,30,129,4,14,7,14,18,21,61,87,2,175,9,0,2,3,3,8330,3650,825,6885,1
6,106,652,304,544,16,6,88,668,6,89,51,101,95,152,591,998,3,3399,188,0,2,3,3,8330,3651,825,6886,1
6,106,2,2,2,0,0,0,2,0,0,0,0,0,0,0,0,0,0,0,0,2,3,3,8330,3651,825,6886,1
6,106,8,5,5,0,0,3,8,0,0,0,0,0,0,0,0,0,0,0,0,2,3,3,8330,3651,825,6887,1
6,106,2,2,2,0,0,0,2,0,0,0,0,0,0,0,0,0,0,0,0,2,3,3,8330,3651,825,6887,1
6,106,14,8,8,0,0,6,14,0,0,0,0,0,0,0,0,0,0,0,0,2,3,3,8330,3651,825,6888,1
6,106,6,4,4,0,0,2,6,0,0,0,0,0,0,0,0,0,0,0,0,2,3,3,8330,3651,825,6889,1
6,106,6,4,4,0,0,2,6,1,2,1,2,3,3,2,4,0,2,0,0,2,3,3,8330,3651,825,6890,1
6,106,6,4,4,0,0,2,6,0,0,0,0,0,0,0,0,0,0,0,0,2,3,3,8330,3651,825,6891,1
6,106,7,5,5,0,0,2,7,0,0,0,0,0,0,0,0,0,0,0,0,2,3,3,8330,3651,825,6892,1
6,106,6,4,4,0,0,2,6,0,0,0,0,0,0,0,0,0,0,0,0,2,3,3,8330,3651,825,6893,1
6,106,10,6,6,0,0,4,10,0,0,0,0,0,0,0,0,0,0,0,0,2,3,3,8330,3651,825,6894,1
6,106,1,1,1,0,0,0,1,0,0,0,0,0,0,0,0,0,0,0,0,2,3,3,8330,3651,825,6894,1
6,106,14,10,10,0,0,4,14,1,1,1,1,2,2,0,2,0,1,0,0,2,3,3,8330,3651,825,6895,1
6,106,46,26,30,3,0,12,49,3,6,3,6,9,9,20,28,1,42,2,0,2,3,3,8340,3651,825,6896,1
3,65,127,75,83,2,11,30,129,4,14,7,14,18,21,61,87,2,175,9,0,2,8,8,8340,3651,825,6897,1
3,65,652,304,544,16,6,88,668,6,89,51,101,95,152,591,998,3,3399,188,0,2,8,8,8340,3652,825,6898,1
3,65,2,2,2,0,0,0,2,0,0,0,0,0,0,0,0,0,0,0,0,2,8,8,8340,3652,825,6898,1
3,65,8,5,5,0,0,3,8,0,0,0,0,0,0,0,0,0,0,0,0,2,8,8,8340,3652,825,6899,1
3,65,2,2,2,0,0,0,2,0,0,0,0,0,0,0,0,0,0,0,0,2,8,8,8340,3652,825,6899,1
3,65,14,8,8,0,0,6,14,0,0,0,0,0,0,0,0,0,0,0,0,2,8,8,8340,3652,825,6900,1
3,65,6,4,4,0,0,2,6,0,0,0,0,0,0,0,0,0,0,0,0,2,8,8,8340,3652,825,6901,1
3,65,6,4,4,0,0,2,6,1,2,1,2,3,3,2,4,0,2,0,0,2,8,8,8340,3652,825,6902,1
3,65,6,4,4,0,0,2,6,0,0,0,0,0,0,0,0,0,0,0,0,2,8,8,8340,3652,825,6903,1
3,65,7,5,5,0,0,2,7,0,0,0,0,0,0,0,0,0,0,0,0,2,8,8,8340,3652,825,6904,1
3,65,6,4,4,0,0,2,6,0,0,0,0,0,0,0,0,0,0,0,0,2,8,8,8340,3652,825,6905,1
3,65,10,6,6,0,0,4,10,0,0,0,0,0,0,0,0,0,0,0,0,2,8,8,8340,3652,825,6906,1
3,65,1,1,1,0,0,0,1,0,0,0,0,0,0,0,0,0,0,0,0,2,8,8,8340,3652,825,6906,1
3,65,14,10,10,0,0,4,14,1,1,1,1,2,2,0,2,0,1,0,0,2,8,8,8340,3652,825,6907,1
3,65,46,26,30,3,0,12,49,3,6,3,6,9,9,20,28,1,42,2,0,2,8,8,8350,3652,825,6908,1
15,451,1450,624,1228,12,26,181,1462,14,306,186,354,320,540,2580,4493,8,36391,2021,1,2,1,1,8360,3658,827,6916,1
175,3745,182,127,129,0,0,53,182,5,39,21,42,44,63,217,343,2,926,51,0,2,100,100,8360,3658,828,6917,1
175,3745,1165,710,800,67,119,181,1232,18,243,153,282,261,435,2000,3492,10,36473,2026,1,2,100,100,8370,3658,829,6918,1
75,1712,773,419,590,28,0,166,801,10,204,113,217,214,330,1598,2554,5,13587,754,0,2,31,31,8370,3658,830,6919,1
75,1712,421,273,302,44,34,57,465,17,81,59,107,98,166,583,1098,11,12329,684,0,2,31,31,8370,3658,831,6920,1
12,386,15,9,9,0,0,6,15,0,0,0,0,0,0,0,0,0,0,0,0,2,14,14,8370,3658,831,6921,1
95,1806,1513,682,1277,25,13,200,1538,11,199,116,219,210,335,1557,2584,6,15641,868,0,2,61,61,8370,3660,831,6922,1
95,1806,819,519,539,24,98,155,843,15,96,57,106,111,163,690,1107,8,9171,509,0,2,61,61,8380,3662,831,6923,1
9,270,149,95,105,2,0,41,151,8,54,28,55,62,83,334,494,4,2013,111,0,2,6,6,8380,3662,831,6924,1
9,270,82,56,54,0,13,15,82,4,13,8,16,17,24,56,98,2,241,13,0,2,6,6,8390,3662,831,6925,1
44,869,215,129,180,6,0,29,221,8,65,43,72,73,115,415,711,4,3153,175,0,2,47,47,8390,3662,831,6926,1
44,869,97,69,77,3,3,16,100,6,22,13,23,28,36,113,173,3,542,30,0,2,47,47,8390,3663,831,6927,1
37,343,647,139,84,35,284,233,682,0,0,0,0,0,0,0,0,0,0,0,0,2,21,21,8390,3663,831,6928,1
130,2241,1338,495,1086,10,64,173,1348,11,122,82,157,133,239,883,1686,7,11934,663,0,2,68,68,8390,3665,831,6929,1
72,1691,1457,730,1242,11,6,188,1468,10,292,166,329,302,495,2424,4078,5,22973,1276,1,2,48,48,8390,3667,831,6930,1
72,1691,74,35,59,1,0,14,75,3,14,7,14,17,21,58,85,1,128,7,0,2,48,48,8390,3668,831,6931,1
72,1691,245,125,200,5,7,34,250,7,30,17,34,37,51,166,265,3,1053,58,0,2,48,48,8400,3669,831,6932,1
32,621,334,251,279,10,4,40,344,5,127,74,143,132,217,899,1528,2,4303,239,0,2,13,13,8400,3670,831,6933,1
102,2071,384,251,317,7,8,52,391,11,70,44,84,81,128,467,811,6,5355,297,0,2,37,37,8400,3670,831,6934,1
36,702,373,158,315,8,0,51,381,5,76,44,79,81,123,486,779,2,2026,112,0,2,23,23,8400,3670,831,6935,1
7,338,42,7,35,4,0,5,46,1,2,1,2,3,3,2,4,0,2,0,0,2,3,3,8400,3670,831,6936,1
7,338,11,6,10,0,0,1,11,2,4,2,4,6,6,10,15,1,15,0,0,2,3,3,8400,3670,831,6937,1
12,564,1289,550,1043,56,32,155,1345,10,167,93,185,177,278,1266,2075,5,11498,638,0,2,5,5,8400,3672,832,6938,1
50,1037,1450,624,1228,12,26,181,1462,14,306,186,354,320,540,2580,4493,8,36391,2021,1,2,10,10,8410,3678,834,6946,1
20,590,182,127,129,0,0,53,182,5,39,21,42,44,63,217,343,2,926,51,0,2,8,8,8410,3678,835,6947,1
98,3995,1392,870,1177,35,17,170,1427,14,494,280,531,508,811,4473,7289,7,54850,3047,2,2,64,64,8410,3681,836,6948,1
59,2043,773,419,590,28,0,166,801,10,204,113,217,214,330,1598,2554,5,13587,754,0,2,30,30,8410,3681,837,6949,1
67,2671,1513,682,1277,25,13,200,1538,11,199,116,219,210,335,1557,2584,6,15641,868,0,2,63,63,8410,3683,837,6950,1
21,588,149,95,105,2,0,41,151,8,54,28,55,62,83,334,494,4,2013,111,0,2,7,7,8410,3683,837,6951,1
11,542,127,75,83,2,11,30,129,4,14,7,14,18,21,61,87,2,175,9,0,2,6,6,8410,3683,837,6952,1
11,542,652,304,544,16,6,88,668,6,89,51,101,95,152,591,998,3,3399,188,0,2,6,6,8410,3684,837,6953,1
11,542,2,2,2,0,0,0,2,0,0,0,0,0,0,0,0,0,0,0,0,2,6,6,8410,3684,837,6953,1
11,542,8,5,5,0,0,3,8,0,0,0,0,0,0,0,0,0,0,0,0,2,6,6,8410,3684,837,6954,1
11,542,2,2,2,0,0,0,2,0,0,0,0,0,0,0,0,0,0,0,0,2,6,6,8410,3684,837,6954,1
11,542,14,8,8,0,0,6,14,0,0,0,0,0,0,0,0,0,0,0,0,2,6,6,8410,3684,837,6955,1
11,542,6,4,4,0,0,2,6,0,0,0,0,0,0,0,0,0,0,0,0,2,6,6,8410,3684,837,6956,1
11,542,6,4,4,0,0,2,6,1,2,1,2,3,3,2,4,0,2,0,0,2,6,6,8410,3684,837,6957,1
11,542,6,4,4,0,0,2,6,0,0,0,0,0,0,0,0,0,0,0,0,2,6,6,8410,3684,837,6958,1
11,542,7,5,5,0,0,2,7,0,0,0,0,0,0,0,0,0,0,0,0,2,6,6,8410,3684,837,6959,1
11,542,6,4,4,0,0,2,6,0,0,0,0,0,0,0,0,0,0,0,0,2,6,6,8410,3684,837,6960,1
11,542,10,6,6,0,0,4,10,0,0,0,0,0,0,0,0,0,0,0,0,2,6,6,8410,3684,837,6961,1
11,542,1,1,1,0,0,0,1,0,0,0,0,0,0,0,0,0,0,0,0,2,6,6,8410,3684,837,6961,1
11,542,14,10,10,0,0,4,14,1,1,1,1,2,2,0,2,0,1,0,0,2,6,6,8410,3684,837,6962,1
11,542,46,26,30,3,0,12,49,3,6,3,6,9,9,20,28,1,42,2,0,2,6,6,8420,3684,837,6963,1
7,168,127,75,83,2,11,30,129,4,14,7,14,18,21,61,87,2,175,9,0,2,5,5,8420,3684,837,6964,1
7,168,652,304,544,16,6,88,668,6,89,51,101,95,152,591,998,3,3399,188,0,2,5,5,8420,3685,837,6965,1
7,168,2,2,2,0,0,0,2,0,0,0,0,0,0,0,0,0,0,0,0,2,5,5,8420,3685,837,6965,1
7,168,8,5,5,0,0,3,8,0,0,0,0,0,0,0,0,0,0,0,0,2,5,5,8420,3685,837,6966,1
7,168,2,2,2,0,0,0,2,0,0,0,0,0,0,0,0,0,0,0,0,2,5,5,8420,3685,837,6966,1
7,168,14,8,8,0,0,6,14,0,0,0,0,0,0,0,0,0,0,0,0,2,5,5,8420,3685,837,6967,1
7,168,6,4,4,0,0,2,6,0,0,0,0,0,0,0,0,0,0,0,0,2,5,5,8420,3685,837,6968,1
7,168,6,4,4,0,0,2,6,1,2,1,2,3,3,2,4,0,2,0,0,2,5,5,8420,3685,837,6969,1
7,168,6,4,4,0,0,2,6,0,0,0,0,0,0,0,0,0,0,0,0,2,5,5,8420,3685,837,6970,1
7,168,7,5,5,0,0,2,7,0,0,0,0,0,0,0,0,0,0,0,0,2,5,5,8420,3685,837,6971,1
7,168,6,4,4,0,0,2,6,0,0,0,0,0,0,0,0,0,0,0,0,2,5,5,8420,3685,837,6972,1
7,168,10,6,6,0,0,4,10,0,0,0,0,0,0,0,0,0,0,0,0,2,5,5,8420,3685,837,6973,1
7,168,1,1,1,0,0,0,1,0,0,0,0,0,0,0,0,0,0,0,0,2,5,5,8420,3685,837,6973,1
7,168,14,10,10,0,0,4,14,1,1,1,1,2,2,0,2,0,1,0,0,2,5,5,8420,3685,837,6974,1
7,168,46,26,30,3,0,12,49,3,6,3,6,9,9,20,28,1,42,2,0,2,5,5,8430,3685,837,6975,1
44,2723,1457,730,1242,11,6,188,1468,10,292,166,329,302,495,2424,4078,5,22973,1276,1,2,40,40,8430,3687,837,6976,1
61,2680,384,251,317,7,8,52,391,11,70,44,84,81,128,467,811,6,5355,297,0,2,32,32,8430,3687,837,6977,1
20,856,373,158,315,8,0,51,381,5,76,44,79,81,123,486,779,2,2026,112,0,2,29,29,8430,3687,837,6978,1
75,1712,773,419,590,28,0,166,801,10,204,113,217,214,330,1598,2554,5,13587,754,0,2,6,9,8430,3687,838,6979,0
75,1712,421,273,302,44,34,57,465,17,81,59,107,98,166,583,1098,11,12329,684,0,2,6,9,8430,3687,839,6980,0
60,2071,773,419,590,28,0,166,801,10,204,113,217,214,330,1598,2554,5,13587,754,0,2,7,0,8430,3687,840,6981,0
7,338,42,7,35,4,0,5,46,1,2,1,2,3,3,2,4,0,2,0,0,2,1,1,8440,3691,841,6989,0
7,338,11,6,10,0,0,1,11,2,4,2,4,6,6,10,15,1,15,0,0,2,1,1,8440,3691,841,6990,0
13,638,1289,550,1043,56,32,155,1345,10,167,93,185,177,278,1266,2075,5,11498,638,0,2,16,0,8440,3693,842,6991,1
7,338,42,7,35,4,0,5,46,1,2,1,2,3,3,2,4,0,2,0,0,2,1,1,8450,3697,843,6999,1
7,338,11,6,10,0,0,1,11,2,4,2,4,6,6,10,15,1,15,0,0,2,1,1,8450,3697,843,7000,1
17,491,1450,624,1228,12,26,181,1462,14,306,186,354,320,540,2580,4493,8,36391,2021,1,2,15,4,8450,3699,844,7001,0
38,354,647,139,84,35,284,233,682,0,0,0,0,0,0,0,0,0,0,0,0,2,13,0,8450,3699,844,7002,0
104,2098,384,251,317,7,8,52,391,11,70,44,84,81,128,467,811,6,5355,297,0,2,2,0,8450,3699,844,7003,0
62,2707,384,251,317,7,8,52,391,11,70,44,84,81,128,467,811,6,5355,297,0,2,4,0,8450,3699,844,7004,0
104,2098,384,251,317,7,8,52,391,11,70,44,84,81,128,467,811,6,5355,297,0,2,2,0,8450,3699,844,7005,0
62,2707,384,251,317,7,8,52,391,11,70,44,84,81,128,467,811,6,5355,297,0,2,4,0,8450,3699,844,7006,0
175,3780,182,127,129,0,0,53,182,5,39,21,42,44,63,217,343,2,926,51,0,2,9,1,8450,3699,845,7007,1
175,3780,1165,710,800,67,119,181,1232,18,243,153,282,261,435,2000,3492,10,36473,2026,1,2,9,1,8460,3699,846,7008,1
99,4033,1392,870,1177,35,17,170,1427,14,494,280,531,508,811,4473,7289,7,54850,3047,2,2,9,0,8460,3702,847,7009,1
100,4061,1392,870,1177,35,17,170,1427,14,494,280,531,508,811,4473,7289,7,54850,3047,2,2,5,1,8460,3705,848,7010,0
7,338,42,7,35,4,0,5,46,1,2,1,2,3,3,2,4,0,2,0,0,2,2,2,8470,3709,849,7018,1
7,338,11,6,10,0,0,1,11,2,4,2,4,6,6,10,15,1,15,0,0,2,2,2,8470,3709,849,7019,1
15,451,1450,624,1228,12,26,181,1462,14,306,186,354,320,540,2580,4493,8,36391,2021,1,2,1,1,8480,3715,851,7027,1
175,3780,182,127,129,0,0,53,182,5,39,21,42,44,63,217,343,2,926,51,0,2,1,1,8480,3715,852,7028,1
175,3780,1165,710,800,67,119,181,1232,18,243,153,282,261,435,2000,3492,10,36473,2026,1,2,1,1,8490,3715,853,7029,1
75,1712,773,419,590,28,0,166,801,10,204,113,217,214,330,1598,2554,5,13587,754,0,2,1,1,8490,3715,854,7030,1
75,1712,421,273,302,44,34,57,465,17,81,59,107,98,166,583,1098,11,12329,684,0,2,1,1,8490,3715,855,7031,1
9,265,149,95,105,2,0,41,151,8,54,28,55,62,83,334,494,4,2013,111,0,2,1,3,8490,3715,855,7032,1
9,265,82,56,54,0,13,15,82,4,13,8,16,17,24,56,98,2,241,13,0,2,1,3,8500,3715,855,7033,1
130,2241,1338,495,1086,10,64,173,1348,11,122,82,157,133,239,883,1686,7,11934,663,0,2,1,1,8500,3717,855,7034,1
7,338,42,7,35,4,0,5,46,1,2,1,2,3,3,2,4,0,2,0,0,2,5,1,8500,3717,855,7035,1
7,338,11,6,10,0,0,1,11,2,4,2,4,6,6,10,15,1,15,0,0,2,5,1,8500,3717,855,7036,1
42,383,647,139,84,35,284,233,682,0,0,0,0,0,0,0,0,0,0,0,0,2,20,4,8510,3721,856,7044,1
86,1559,1338,495,1086,10,64,173,1348,11,122,82,157,133,239,883,1686,7,11934,663,0,2,8,135,8510,3723,856,7045,1
46,1093,1457,730,1242,11,6,188,1468,10,292,166,329,302,495,2424,4078,5,22973,1276,1,2,3,96,8510,3725,856,7046,1
46,1093,74,35,59,1,0,14,75,3,14,7,14,17,21,58,85,1,128,7,0,2,3,96,8510,3726,856,7047,1
46,1093,245,125,200,5,7,34,250,7,30,17,34,37,51,166,265,3,1053,58,0,2,3,96,8520,3727,856,7048,1
104,2098,384,251,317,7,8,52,391,11,70,44,84,81,128,467,811,6,5355,297,0,2,1,1,8520,3727,856,7049,1
75,1481,373,158,315,8,0,51,381,5,76,44,79,81,123,486,779,2,2026,112,0,2,187,60,8520,3727,856,7050,1
7,338,42,7,35,4,0,5,46,1,2,1,2,3,3,2,4,0,2,0,0,2,1,1,8520,3727,856,7051,1
7,338,11,6,10,0,0,1,11,2,4,2,4,6,6,10,15,1,15,0,0,2,1,1,8520,3727,856,7052,1
16,756,1289,550,1043,56,32,155,1345,10,167,93,185,177,278,1266,2075,5,11498,638,0,2,30,2,8520,3729,857,7053,1
28,2004,1296,573,1062,40,33,157,1336,8,201,118,231,209,349,1561,2689,4,12365,686,0,0,314,0,8520,3729,857,7054,1
17,1070,1457,730,1242,11,6,188,1468,10,292,166,329,302,495,2424,4078,5,22973,1276,1,2,0,230,8520,3731,857,7055,1
19,830,373,158,315,8,0,51,381,5,76,44,79,81,123,486,779,2,2026,112,0,2,5,10,8520,3731,857,7056,1
42,626,282,196,195,3,0,86,285,8,130,71,141,138,212,936,1507,4,6538,363,0,2,20,0,8520,3731,858,7057,0
38,354,647,139,84,35,284,233,682,0,0,0,0,0,0,0,0,0,0,0,0,2,6,5,8520,3731,858,7058,0
17,491,1450,624,1228,12,26,181,1462,14,306,186,354,320,540,2580,4493,8,36391,2021,1,2,1,1,8530,3737,860,7066,0
175,3780,182,127,129,0,0,53,182,5,39,21,42,44,63,217,343,2,926,51,0,2,10,2,8530,3737,861,7067,0
175,3780,1165,710,800,67,119,181,1232,18,243,153,282,261,435,2000,3492,10,36473,2026,1,2,10,2,8540,3737,862,7068,0
75,1712,773,419,590,28,0,166,801,10,204,113,217,214,330,1598,2554,5,13587,754,0,2,1,1,8540,3737,863,7069,0
75,1712,421,273,302,44,34,57,465,17,81,59,107,98,166,583,1098,11,12329,684,0,2,1,1,8540,3737,864,7070,0
9,265,149,95,105,2,0,41,151,8,54,28,55,62,83,334,494,4,2013,111,0,2,1,3,8540,3737,864,7071,0
9,265,82,56,54,0,13,15,82,4,13,8,16,17,24,56,98,2,241,13,0,2,1,3,8550,3737,864,7072,0
130,2241,1338,495,1086,10,64,173,1348,11,122,82,157,133,239,883,1686,7,11934,663,0,2,1,1,8550,3739,864,7073,0
7,338,42,7,35,4,0,5,46,1,2,1,2,3,3,2,4,0,2,0,0,2,7,3,8550,3739,864,7074,0
7,338,11,6,10,0,0,1,11,2,4,2,4,6,6,10,15,1,15,0,0,2,7,3,8550,3739,864,7075,0
100,4061,1392,870,1177,35,17,170,1427,14,494,280,531,508,811,4473,7289,7,54850,3047,2,2,13,0,8550,3742,865,7076,0
104,2098,384,251,317,7,8,52,391,11,70,44,84,81,128,467,811,6,5355,297,0,2,1,1,8560,3746,866,7084,1
43,402,647,139,84,35,284,233,682,0,0,0,0,0,0,0,0,0,0,0,0,2,9,3,8560,3746,866,7085,1
105,2126,384,251,317,7,8,52,391,11,70,44,84,81,128,467,811,6,5355,297,0,2,7,4,8560,3746,866,7086,1
68,1433,373,158,315,8,0,51,381,5,76,44,79,81,123,486,779,2,2026,112,0,2,65,86,8560,3746,866,7087,1
28,2004,1296,573,1062,40,33,157,1336,8,201,118,231,209,349,1561,2689,4,12365,686,0,2,1,1,8560,3746,866,7088,1
63,2799,384,251,317,7,8,52,391,11,70,44,84,81,128,467,811,6,5355,297,0,2,13,0,8560,3746,866,7089,1
43,402,647,139,84,35,284,233,682,0,0,0,0,0,0,0,0,0,0,0,0,2,4,2,8560,3746,866,7090,1
86,1556,1338,495,1086,10,64,173,1348,11,122,82,157,133,239,883,1686,7,11934,663,0,2,0,1,8560,3748,866,7091,1
105,2126,384,251,317,7,8,52,391,11,70,44,84,81,128,467,811,6,5355,297,0,2,3,3,8560,3748,866,7092,1
69,1442,373,158,315,8,0,51,381,5,76,44,79,81,123,486,779,2,2026,112,0,2,3,0,8560,3748,866,7093,1
28,2012,1296,573,1062,40,33,157,1336,8,201,118,231,209,349,1561,2689,4,12365,686,0,2,8,8,8560,3748,866,7094,1
19,836,373,158,315,8,0,51,381,5,76,44,79,81,123,486,779,2,2026,112,0,2,3,3,8560,3748,866,7095,1
44,411,647,139,84,35,284,233,682,0,0,0,0,0,0,0,0,0,0,0,0,2,5,3,8560,3748,866,7096,1
44,415,647,139,84,35,284,233,682,0,0,0,0,0,0,0,0,0,0,0,0,2,2,2,8560,3748,866,7097,1
68,1426,373,158,315,8,0,51,381,5,76,44,79,81,123,486,779,2,2026,112,0,2,12,18,8560,3748,866,7098,1
69,1471,373,158,315,8,0,51,381,5,76,44,79,81,123,486,779,2,2026,112,0,2,37,28,8560,3748,866,7099,1
17,803,1289,550,1043,56,32,155,1345,10,167,93,185,177,278,1266,2075,5,11498,638,0,2,20,0,8560,3750,867,7100,1
71,1474,373,158,315,8,0,51,381,5,76,44,79,81,123,486,779,2,2026,112,0,2,1,1,8560,3750,867,7101,0
60,2071,773,419,590,28,0,166,801,10,204,113,217,214,330,1598,2554,5,13587,754,0,2,1,1,8560,3750,868,7102,1
46,754,282,196,195,3,0,86,285,8,130,71,141,138,212,936,1507,4,6538,363,0,2,18,0,8560,3750,869,7103,0
46,754,282,196,195,3,0,86,285,8,130,71,141,138,212,936,1507,4,6538,363,0,2,38,0,8560,3750,870,7104,0
17,491,1450,624,1228,12,26,181,1462,14,306,186,354,320,540,2580,4493,8,36391,2021,1,2,15,4,8560,3752,871,7105,0
45,426,647,139,84,35,284,233,682,0,0,0,0,0,0,0,0,0,0,0,0,2,14,0,8560,3752,871,7106,0
17,494,1450,624,1228,12,26,181,1462,14,306,186,354,320,540,2580,4493,8,36391,2021,1,2,1,1,8570,3758,873,7114,1
45,428,647,139,84,35,284,233,682,0,0,0,0,0,0,0,0,0,0,0,0,2,1,1,8570,3758,873,7115,1
52,1094,1450,624,1228,12,26,181,1462,14,306,186,354,320,540,2580,4493,8,36391,2021,1,2,10,0,8570,3760,874,7116,1
17,494,1450,624,1228,12,26,181,1462,14,306,186,354,320,540,2580,4493,8,36391,2021,1,2,1,1,8580,3766,876,7124,1
45,428,647,139,84,35,284,233,682,0,0,0,0,0,0,0,0,0,0,0,0,2,7,8,8580,3766,876,7125,1
52,1094,1450,624,1228,12,26,181,1462,14,306,186,354,320,540,2580,4493,8,36391,2021,1,2,2,2,8580,3768,877,7126,1
46,754,282,196,195,3,0,86,285,8,130,71,141,138,212,936,1507,4,6538,363,0,2,38,0,8580,3768,878,7127,0
17,494,1450,624,1228,12,26,181,1462,14,306,186,354,320,540,2580,4493,8,36391,2021,1,2,17,6,8590,3774,880,7135,0
175,3780,182,127,129,0,0,53,182,5,39,21,42,44,63,217,343,2,926,51,0,2,10,2,8590,3774,881,7136,0
175,3780,1165,710,800,67,119,181,1232,18,243,153,282,261,435,2000,3492,10,36473,2026,1,2,10,2,8600,3774,882,7137,0
75,1712,773,419,590,28,0,166,801,10,204,113,217,214,330,1598,2554,5,13587,754,0,2,1,1,8600,3774,883,7138,0
75,1712,421,273,302,44,34,57,465,17,81,59,107,98,166,583,1098,11,12329,684,0,2,1,1,8600,3774,884,7139,0
9,265,149,95,105,2,0,41,151,8,54,28,55,62,83,334,494,4,2013,111,0,2,1,3,8600,3774,884,7140,0
9,265,82,56,54,0,13,15,82,4,13,8,16,17,24,56,98,2,241,13,0,2,1,3,8610,3774,884,7141,0
45,428,647,139,84,35,284,233,682,0,0,0,0,0,0,0,0,0,0,0,0,2,46,7,8610,3774,884,7142,0
86,1556,1338,495,1086,10,64,173,1348,11,122,82,157,133,239,883,1686,7,11934,663,0,2,9,137,8610,3776,884,7143,0
46,1093,1457,730,1242,11,6,188,1468,10,292,166,329,302,495,2424,4078,5,22973,1276,1,2,3,96,8610,3778,884,7144,0
46,1093,74,35,59,1,0,14,75,3,14,7,14,17,21,58,85,1,128,7,0,2,3,96,8610,3779,884,7145,0
46,1093,245,125,200,5,7,34,250,7,30,17,34,37,51,166,265,3,1053,58,0,2,3,96,8620,3780,884,7146,0
105,2126,384,251,317,7,8,52,391,11,70,44,84,81,128,467,811,6,5355,297,0,2,12,7,8620,3780,884,7147,0
71,1474,373,158,315,8,0,51,381,5,76,44,79,81,123,486,779,2,2026,112,0,2,201,89,8620,3780,884,7148,0
7,338,42,7,35,4,0,5,46,1,2,1,2,3,3,2,4,0,2,0,0,2,7,3,8620,3780,884,7149,0
7,338,11,6,10,0,0,1,11,2,4,2,4,6,6,10,15,1,15,0,0,2,7,3,8620,3780,884,7150,0
17,803,1289,550,1043,56,32,155,1345,10,167,93,185,177,278,1266,2075,5,11498,638,0,2,50,2,8620,3782,885,7151,0
52,1094,1450,624,1228,12,26,181,1462,14,306,186,354,320,540,2580,4493,8,36391,2021,1,2,10,0,8620,3784,886,7152,0
100,4061,1392,870,1177,35,17,170,1427,14,494,280,531,508,811,4473,7289,7,54850,3047,2,2,13,0,8620,3787,887,7153,0
60,2071,773,419,590,28,0,166,801,10,204,113,217,214,330,1598,2554,5,13587,754,0,2,1,1,8620,3787,888,7154,0
28,2012,1296,573,1062,40,33,157,1336,8,201,118,231,209,349,1561,2689,4,12365,686,0,0,314,0,8620,3787,888,7155,0
17,1070,1457,730,1242,11,6,188,1468,10,292,166,329,302,495,2424,4078,5,22973,1276,1,2,0,230,8620,3789,888,7156,0
63,2799,384,251,317,7,8,52,391,11,70,44,84,81,128,467,811,6,5355,297,0,2,17,0,8620,3789,888,7157,0
19,836,373,158,315,8,0,51,381,5,76,44,79,81,123,486,779,2,2026,112,0,2,8,13,8620,3789,888,7158,0
16,817,1289,550,1043,56,32,155,1345,10,167,93,185,177,278,1266,2075,5,11498,638,0,2,25,28,8620,3791,889,7159,1
68,1428,373,158,315,8,0,51,381,5,76,44,79,81,123,486,779,2,2026,112,0,2,0,7,8620,3791,889,7160,1
28,1989,1296,573,1062,40,33,157,1336,8,201,118,231,209,349,1561,2689,4,12365,686,0,2,15,18,8620,3791,889,7161,1
47,774,282,196,195,3,0,86,285,8,130,71,141,138,212,936,1507,4,6538,363,0,2,3,0,8620,3791,890,7162,1
1,83,13,10,10,0,0,3,13,1,2,1,2,3,3,2,4,0,2,0,0,2,1,1,8620,3791,890,7163,1
107,2170,384,251,317,7,8,52,391,11,70,44,84,81,128,467,811,6,5355,297,0,2,6,1,8630,3795,891,7171,0
65,2882,384,251,317,7,8,52,391,11,70,44,84,81,128,467,811,6,5355,297,0,2,15,0,8630,3795,891,7172,0
17,899,1289,550,1043,56,32,155,1345,10,167,93,185,177,278,1266,2075,5,11498,638,0,2,8,0,8660,3804,894,7192,1
18,929,1289,550,1043,56,32,155,1345,10,167,93,185,177,278,1266,2075,5,11498,638,0,2,7,3,8660,3806,895,7193,0
52,895,282,196,195,3,0,86,285,8,130,71,141,138,212,936,1507,4,6538,363,0,2,30,0,8660,3806,896,7194,0
1,83,13,10,10,0,0,3,13,1,2,1,2,3,3,2,4,0,2,0,0,2,1,1,8660,3806,896,7195,0
56,1187,1450,624,1228,12,26,181,1462,14,306,186,354,320,540,2580,4493,8,36391,2021,1,2,21,0,8660,3808,897,7196,0
56,1209,1450,624,1228,12,26,181,1462,14,306,186,354,320,540,2580,4493,8,36391,2021,1,2,3,0,8660,3810,898,7197,0
175,3785,182,127,129,0,0,53,182,5,39,21,42,44,63,217,343,2,926,51,0,2,2,1,8660,3810,899,7198,0
175,3785,1165,710,800,67,119,181,1232,18,243,153,282,261,435,2000,3492,10,36473,2026,1,2,2,1,8670,3810,900,7199,0
83,1749,1457,730,1242,11,6,188,1468,10,292,166,329,302,495,2424,4078,5,22973,1276,1,2,121,1,8670,3812,900,7200,0
83,1749,74,35,59,1,0,14,75,3,14,7,14,17,21,58,85,1,128,7,0,2,121,1,8670,3813,900,7201,0
83,1749,245,125,200,5,7,34,250,7,30,17,34,37,51,166,265,3,1053,58,0,2,121,1,8680,3814,900,7202,0
24,1258,652,304,544,16,6,88,668,6,89,51,101,95,152,591,998,3,3399,188,0,3,1,1,8680,3815,900,7203,0
115,2359,1457,730,1242,11,6,188,1468,10,292,166,329,302,495,2424,4078,5,22973,1276,1,2,96,2,8680,3817,900,7204,0
115,2359,74,35,59,1,0,14,75,3,14,7,14,17,21,58,85,1,128,7,0,2,96,2,8680,3818,900,7205,0
115,2359,245,125,200,5,7,34,250,7,30,17,34,37,51,166,265,3,1053,58,0,2,96,2,8690,3819,900,7206,0
18,814,334,251,279,10,4,40,344,5,127,74,143,132,217,899,1528,2,4303,239,0,2,1,1,8690,3821,900,7208,0
1,34,2,2,2,0,0,0,2,0,0,0,0,0,0,0,0,0,0,0,0,0,15,0,8860,3876,917,7321,1
1,34,99,48,90,1,3,5,100,0,0,0,0,0,0,0,0,0,0,0,0,0,15,0,8860,3877,917,7322,1
1,34,8,5,5,2,0,1,10,0,0,0,0,0,0,0,0,0,0,0,0,0,15,0,8860,3877,917,7323,1
1,34,1217,716,841,84,126,174,1301,14,185,118,215,199,333,1446,2542,8,20687,1149,0,0,15,0,8870,3879,917,7324,1
1,34,160,89,115,0,13,31,160,7,15,11,17,22,28,78,124,3,495,27,0,0,15,0,8870,3879,917,7325,1
1,34,10,10,9,9,0,0,19,0,0,0,0,0,0,0,0,0,0,0,0,0,15,0,8870,3879,918,7326,1
1,34,173,84,99,8,29,36,181,5,12,7,13,17,20,54,81,2,221,12,0,0,15,0,8870,3880,918,7327,1
1,34,3,1,1,3,0,0,6,0,0,0,0,0,0,0,0,0,0,0,0,0,15,0,8870,3880,918,7328,1
115,2357,1457,730,1242,11,6,188,1468,10,292,166,329,302,495,2424,4078,5,22973,1276,1,3,1,1,8870,3884,918,7330,1
115,2357,74,35,59,1,0,14,75,3,14,7,14,17,21,58,85,1,128,7,0,3,1,1,8870,3885,918,7331,1
115,2357,245,125,200,5,7,34,250,7,30,17,34,37,51,166,265,3,1053,58,0,3,1,1,8880,3886,918,7332,1
110,2181,384,251,317,7,8,52,391,11,70,44,84,81,128,467,811,6,5355,297,0,3,19,8,8890,3890,919,7341,1
68,1413,373,158,315,8,0,51,381,5,76,44,79,81,123,486,779,2,2026,112,0,3,5,5,8890,3890,919,7342,1
6,277,42,7,35,4,0,5,46,1,2,1,2,3,3,2,4,0,2,0,0,2,9,29,8890,3890,919,7343,1
6,277,11,6,10,0,0,1,11,2,4,2,4,6,6,10,15,1,15,0,0,2,9,29,8890,3890,919,7344,1
17,333,127,75,83,2,11,30,129,4,14,7,14,18,21,61,87,2,175,9,0,2,57,1,8910,3903,925,7363,1
17,333,652,304,544,16,6,88,668,6,89,51,101,95,152,591,998,3,3399,188,0,2,57,1,8910,3904,925,7364,1
17,333,2,2,2,0,0,0,2,0,0,0,0,0,0,0,0,0,0,0,0,2,57,1,8910,3904,925,7364,1
17,333,8,5,5,0,0,3,8,0,0,0,0,0,0,0,0,0,0,0,0,2,57,1,8910,3904,925,7365,1
17,333,2,2,2,0,0,0,2,0,0,0,0,0,0,0,0,0,0,0,0,2,57,1,8910,3904,925,7365,1
17,333,14,8,8,0,0,6,14,0,0,0,0,0,0,0,0,0,0,0,0,2,57,1,8910,3904,925,7366,1
17,333,6,4,4,0,0,2,6,0,0,0,0,0,0,0,0,0,0,0,0,2,57,1,8910,3904,925,7367,1
17,333,6,4,4,0,0,2,6,1,2,1,2,3,3,2,4,0,2,0,0,2,57,1,8910,3904,925,7368,1
17,333,6,4,4,0,0,2,6,0,0,0,0,0,0,0,0,0,0,0,0,2,57,1,8910,3904,925,7369,1
17,333,7,5,5,0,0,2,7,0,0,0,0,0,0,0,0,0,0,0,0,2,57,1,8910,3904,925,7370,1
17,333,6,4,4,0,0,2,6,0,0,0,0,0,0,0,0,0,0,0,0,2,57,1,8910,3904,925,7371,1
17,333,10,6,6,0,0,4,10,0,0,0,0,0,0,0,0,0,0,0,0,2,57,1,8910,3904,925,7372,1
17,333,1,1,1,0,0,0,1,0,0,0,0,0,0,0,0,0,0,0,0,2,57,1,8910,3904,925,7372,1
17,333,14,10,10,0,0,4,14,1,1,1,1,2,2,0,2,0,1,0,0,2,57,1,8910,3904,925,7373,1
17,333,46,26,30,3,0,12,49,3,6,3,6,9,9,20,28,1,42,2,0,2,57,1,8920,3904,925,7374,1
7,166,127,75,83,2,11,30,129,4,14,7,14,18,21,61,87,2,175,9,0,2,3,3,8950,3915,927,7403,1
7,166,652,304,544,16,6,88,668,6,89,51,101,95,152,591,998,3,3399,188,0,2,3,3,8950,3916,927,7404,1
7,166,2,2,2,0,0,0,2,0,0,0,0,0,0,0,0,0,0,0,0,2,3,3,8950,3916,927,7404,1
7,166,8,5,5,0,0,3,8,0,0,0,0,0,0,0,0,0,0,0,0,2,3,3,8950,3916,927,7405,1
7,166,2,2,2,0,0,0,2,0,0,0,0,0,0,0,0,0,0,0,0,2,3,3,8950,3916,927,7405,1
7,166,14,8,8,0,0,6,14,0,0,0,0,0,0,0,0,0,0,0,0,2,3,3,8950,3916,927,7406,1
7,166,6,4,4,0,0,2,6,0,0,0,0,0,0,0,0,0,0,0,0,2,3,3,8950,3916,927,7407,1
7,166,6,4,4,0,0,2,6,1,2,1,2,3,3,2,4,0,2,0,0,2,3,3,8950,3916,927,7408,1
7,166,6,4,4,0,0,2,6,0,0,0,0,0,0,0,0,0,0,0,0,2,3,3,8950,3916,927,7409,1
7,166,7,5,5,0,0,2,7,0,0,0,0,0,0,0,0,0,0,0,0,2,3,3,8950,3916,927,7410,1
7,166,6,4,4,0,0,2,6,0,0,0,0,0,0,0,0,0,0,0,0,2,3,3,8950,3916,927,7411,1
7,166,10,6,6,0,0,4,10,0,0,0,0,0,0,0,0,0,0,0,0,2,3,3,8950,3916,927,7412,1
7,166,1,1,1,0,0,0,1,0,0,0,0,0,0,0,0,0,0,0,0,2,3,3,8950,3916,927,7412,1
7,166,14,10,10,0,0,4,14,1,1,1,1,2,2,0,2,0,1,0,0,2,3,3,8950,3916,927,7413,1
7,166,46,26,30,3,0,12,49,3,6,3,6,9,9,20,28,1,42,2,0,2,3,3,8960,3916,927,7414,1
28,1987,1296,573,1062,40,33,157,1336,8,201,118,231,209,349,1561,2689,4,12365,686,0,2,1,1,8980,3924,929,7429,1
24,1256,652,304,544,16,6,88,668,6,89,51,101,95,152,591,998,3,3399,188,0,2,1,1,8980,3925,929,7430,1
18,812,334,251,279,10,4,40,344,5,127,74,143,132,217,899,1528,2,4303,239,0,2,1,1,8980,3926,929,7431,1
65,2872,384,251,317,7,8,52,391,11,70,44,84,81,128,467,811,6,5355,297,0,2,5,5,8980,3926,929,7432,1
4,122,2,2,2,0,0,0,2,0,0,0,0,0,0,0,0,0,0,0,0,2,18,7,8980,3926,929,7432,1
4,122,99,48,90,1,3,5,100,0,0,0,0,0,0,0,0,0,0,0,0,2,18,7,8980,3927,929,7433,1
4,122,8,5,5,2,0,1,10,0,0,0,0,0,0,0,0,0,0,0,0,2,18,7,8980,3927,929,7434,1
4,122,1217,716,841,84,126,174,1301,14,185,118,215,199,333,1446,2542,8,20687,1149,0,2,18,7,8990,3929,929,7435,1
4,122,160,89,115,0,13,31,160,7,15,11,17,22,28,78,124,3,495,27,0,2,18,7,8990,3929,929,7436,1
4,122,10,10,9,9,0,0,19,0,0,0,0,0,0,0,0,0,0,0,0,2,18,7,8990,3929,930,7437,1
4,122,173,84,99,8,29,36,181,5,12,7,13,17,20,54,81,2,221,12,0,2,18,7,8990,3930,930,7438,1
4,122,3,1,1,3,0,0,6,0,0,0,0,0,0,0,0,0,0,0,0,2,18,7,8990,3930,930,7439,1
3,108,77,34,69,0,0,8,77,3,24,16,29,27,45,114,213,1,387,21,0,0,18,0,8990,3930,930,7440,1
3,108,712,438,573,51,9,84,763,14,102,71,128,116,199,733,1364,8,11988,666,0,0,18,0,9000,3931,930,7441,1
110,2181,384,251,317,7,8,52,391,11,70,44,84,81,128,467,811,6,5355,297,0,2,3,3,9000,3931,930,7442,1
6,277,42,7,35,4,0,5,46,1,2,1,2,3,3,2,4,0,2,0,0,2,1,1,9000,3931,930,7443,1
6,277,11,6,10,0,0,1,11,2,4,2,4,6,6,10,15,1,15,0,0,2,1,1,9000,3931,930,7444,1
28,1989,1296,573,1062,40,33,157,1336,8,201,118,231,209,349,1561,2689,4,12365,686,0,2,1,1,9000,3931,930,7445,1
25,1318,652,304,544,16,6,88,668,6,89,51,101,95,152,591,998,3,3399,188,0,2,10,0,9000,3932,930,7446,1
4,135,2,2,2,0,0,0,2,0,0,0,0,0,0,0,0,0,0,0,0,2,4,2,9000,3932,930,7446,1
4,135,99,48,90,1,3,5,100,0,0,0,0,0,0,0,0,0,0,0,0,2,4,2,9000,3933,930,7447,1
4,135,8,5,5,2,0,1,10,0,0,0,0,0,0,0,0,0,0,0,0,2,4,2,9000,3933,930,7448,1
4,135,1217,716,841,84,126,174,1301,14,185,118,215,199,333,1446,2542,8,20687,1149,0,2,4,2,9010,3935,930,7449,1
4,135,160,89,115,0,13,31,160,7,15,11,17,22,28,78,124,3,495,27,0,2,4,2,9010,3935,930,7450,1
4,135,10,10,9,9,0,0,19,0,0,0,0,0,0,0,0,0,0,0,0,2,4,2,9010,3935,931,7451,1
4,135,173,84,99,8,29,36,181,5,12,7,13,17,20,54,81,2,221,12,0,2,4,2,9010,3936,931,7452,1
4,135,3,1,1,3,0,0,6,0,0,0,0,0,0,0,0,0,0,0,0,2,4,2,9010,3936,931,7453,1
114,2331,1457,730,1242,11,6,188,1468,10,292,166,329,302,495,2424,4078,5,22973,1276,1,3,0,10,9010,3938,931,7454,1
111,2222,384,251,317,7,8,52,391,11,70,44,84,81,128,467,811,6,5355,297,0,2,3,3,9010,3938,931,7455,1
16,1031,1457,730,1242,11,6,188,1468,10,292,166,329,302,495,2424,4078,5,22973,1276,1,2,0,7,9010,3940,931,7456,1
25,1318,652,304,544,16,6,88,668,6,89,51,101,95,152,591,998,3,3399,188,0,2,1,1,9010,3941,931,7457,1
18,812,334,251,279,10,4,40,344,5,127,74,143,132,217,899,1528,2,4303,239,0,2,1,1,9010,3942,931,7458,1
65,2872,384,251,317,7,8,52,391,11,70,44,84,81,128,467,811,6,5355,297,0,2,3,3,9010,3942,931,7459,1
1,50,2,2,2,0,0,0,2,0,0,0,0,0,0,0,0,0,0,0,0,2,6,19,9010,3942,931,7459,1
1,50,99,48,90,1,3,5,100,0,0,0,0,0,0,0,0,0,0,0,0,2,6,19,9010,3943,931,7460,1
1,50,8,5,5,2,0,1,10,0,0,0,0,0,0,0,0,0,0,0,0,2,6,19,9010,3943,931,7461,1
1,50,1217,716,841,84,126,174,1301,14,185,118,215,199,333,1446,2542,8,20687,1149,0,2,6,19,9020,3945,931,7462,1
1,50,160,89,115,0,13,31,160,7,15,11,17,22,28,78,124,3,495,27,0,2,6,19,9020,3945,931,7463,1
1,50,10,10,9,9,0,0,19,0,0,0,0,0,0,0,0,0,0,0,0,2,6,19,9020,3945,932,7464,1
1,50,173,84,99,8,29,36,181,5,12,7,13,17,20,54,81,2,221,12,0,2,6,19,9020,3946,932,7465,1
1,50,3,1,1,3,0,0,6,0,0,0,0,0,0,0,0,0,0,0,0,2,6,19,9020,3946,932,7466,1
114,2326,1457,730,1242,11,6,188,1468,10,292,166,329,302,495,2424,4078,5,22973,1276,1,2,0,2,9020,3948,932,7467,1
86,1567,1338,495,1086,10,64,173,1348,11,122,82,157,133,239,883,1686,7,11934,663,0,2,2,0,9020,3950,932,7468,1
110,2212,384,251,317,7,8,52,391,11,70,44,84,81,128,467,811,6,5355,297,0,2,3,5,9020,3950,932,7469,1
6,283,42,7,35,4,0,5,46,1,2,1,2,3,3,2,4,0,2,0,0,2,1,0,9020,3950,932,7470,1
6,283,11,6,10,0,0,1,11,2,4,2,4,6,6,10,15,1,15,0,0,2,1,0,9020,3950,932,7471,1
6,283,42,7,35,4,0,5,46,1,2,1,2,3,3,2,4,0,2,0,0,2,1,1,9020,3950,932,7472,0
6,283,11,6,10,0,0,1,11,2,4,2,4,6,6,10,15,1,15,0,0,2,1,1,9020,3950,932,7473,0
45,428,647,139,84,35,284,233,682,0,0,0,0,0,0,0,0,0,0,0,0,3,17,10,9130,3974,938,7591,1
110,2210,384,251,317,7,8,52,391,11,70,44,84,81,128,467,811,6,5355,297,0,2,1,1,9130,3974,938,7592,1
17,570,1455,414,1257,16,76,112,1471,5,41,23,46,46,69,231,381,2,1069,59,0,3,2,23,9140,3981,939,7596,0
17,570,669,365,481,22,61,110,691,15,103,63,122,118,185,747,1273,8,11311,628,0,3,2,23,9150,3981,940,7597,0
137,3233,722,423,573,19,0,135,741,12,172,101,199,184,300,1320,2257,6,15668,870,0,3,1,1,9180,3999,942,7611,0
137,3233,1508,847,911,44,250,301,1552,14,148,88,169,162,257,1120,1886,7,15077,837,0,3,1,1,9180,4000,943,7612,0
194,4278,72,33,56,0,4,12,72,1,1,1,1,2,2,0,2,0,1,0,0,3,1,1,9180,4000,943,7613,0
194,4278,1454,835,1044,76,110,219,1530,17,275,158,296,292,454,2297,3718,9,34017,1889,1,3,1,1,9190,4001,943,7614,0
111,2230,384,251,317,7,8,52,391,11,70,44,84,81,128,467,811,6,5355,297,0,2,6,4,9220,4017,944,7630,0
26,920,1450,624,1228,12,26,181,1462,14,306,186,354,320,540,2580,4493,8,36391,2021,1,3,1,1,9220,4019,945,7631,0
34,1380,1513,682,1277,25,13,200,1538,11,199,116,219,210,335,1557,2584,6,15641,868,0,3,1,1,9220,4021,945,7632,0
10,403,1455,414,1257,16,76,112,1471,5,41,23,46,46,69,231,381,2,1069,59,0,3,1,1,9220,4022,945,7633,0
7,226,74,35,59,1,0,14,75,3,14,7,14,17,21,58,85,1,128,7,0,3,1,1,9220,4023,945,7634,0
15,734,1020,354,843,12,15,144,1032,8,134,77,144,142,221,970,1580,4,6792,377,0,3,1,1,9230,4025,945,7636,0
12,820,447,308,343,6,5,95,453,7,96,59,111,103,170,651,1136,4,4600,255,0,3,1,1,9230,4028,945,7637,0
5,333,722,423,573,19,0,135,741,12,172,101,199,184,300,1320,2257,6,15668,870,0,3,1,1,9240,4034,945,7642,0
12,418,386,256,301,16,9,68,402,4,59,35,69,63,104,355,621,2,1453,80,0,3,1,1,9240,4034,945,7643,0
13,1146,215,129,180,6,0,29,221,8,65,43,72,73,115,415,711,4,3153,175,0,3,2,2,9240,4034,945,7644,0
44,1644,1043,504,840,53,9,147,1096,9,180,112,198,189,310,1377,2344,4,11604,644,0,3,1,1,9240,4036,945,7645,0
24,1010,373,158,315,8,0,51,381,5,76,44,79,81,123,486,779,2,2026,112,0,3,1,1,9240,4036,945,7646,0
28,1387,1178,367,1042,6,15,115,1184,9,94,51,95,103,146,644,976,4,4439,246,0,3,3,4,9240,4036,945,7647,0
50,2500,1943,715,1694,26,18,214,1969,12,185,120,237,197,357,1436,2721,7,20915,1161,0,3,2,2,9240,4038,945,7648,0
2,103,442,244,305,14,16,103,456,11,68,45,75,79,120,452,756,6,4588,254,0,3,2,2,9240,4040,945,7649,0
28,1989,1296,573,1062,40,33,157,1336,8,201,118,231,209,349,1561,2689,4,12365,686,0,2,1,1,9250,4042,945,7651,0
86,1567,1338,495,1086,10,64,173,1348,11,122,82,157,133,239,883,1686,7,11934,663,0,2,24,19,9250,4046,945,7653,1
45,428,647,139,84,35,284,233,682,0,0,0,0,0,0,0,0,0,0,0,0,2,19,10,9250,4046,945,7654,1
100,2397,1043,504,840,53,9,147,1096,9,180,112,198,189,310,1377,2344,4,11604,644,0,2,24,0,9250,4048,945,7655,1
100,2397,383,288,292,26,6,62,409,11,65,38,67,76,105,429,656,5,3719,206,0,2,24,0,9250,4049,945,7656,1
114,2321,1457,730,1242,11,6,188,1468,10,292,166,329,302,495,2424,4078,5,22973,1276,1,2,10,10,9250,4051,945,7657,1
86,1567,1338,495,1086,10,64,173,1348,11,122,82,157,133,239,883,1686,7,11934,663,0,2,2,0,9250,4053,945,7658,1
18,379,1098,241,925,5,10,155,1103,7,46,25,49,53,74,273,423,3,1580,87,0,2,0,11,9260,4055,945,7659,1
18,379,282,202,222,14,2,44,296,8,42,24,43,50,67,250,378,4,1548,86,0,2,0,11,9260,4056,945,7660,1
17,587,1455,414,1257,16,76,112,1471,5,41,23,46,46,69,231,381,2,1069,59,0,2,6,7,9260,4057,945,7661,1
17,587,669,365,481,22,61,110,691,15,103,63,122,118,185,747,1273,8,11311,628,0,2,6,7,9270,4057,946,7662,1
1,46,2,2,2,0,0,0,2,0,0,0,0,0,0,0,0,0,0,0,0,2,0,1,9270,4057,946,7662,1
1,46,99,48,90,1,3,5,100,0,0,0,0,0,0,0,0,0,0,0,0,2,0,1,9270,4058,946,7663,1
1,46,8,5,5,2,0,1,10,0,0,0,0,0,0,0,0,0,0,0,0,2,0,1,9270,4058,946,7664,1
1,46,1217,716,841,84,126,174,1301,14,185,118,215,199,333,1446,2542,8,20687,1149,0,2,0,1,9280,4060,946,7665,1
1,46,160,89,115,0,13,31,160,7,15,11,17,22,28,78,124,3,495,27,0,2,0,1,9280,4060,946,7666,1
1,46,10,10,9,9,0,0,19,0,0,0,0,0,0,0,0,0,0,0,0,2,0,1,9280,4060,947,7667,1
1,46,173,84,99,8,29,36,181,5,12,7,13,17,20,54,81,2,221,12,0,2,0,1,9280,4061,947,7668,1
1,46,3,1,1,3,0,0,6,0,0,0,0,0,0,0,0,0,0,0,0,2,0,1,9280,4061,947,7669,1
194,4280,72,33,56,0,4,12,72,1,1,1,1,2,2,0,2,0,1,0,0,2,1,1,9280,4063,947,7671,1
194,4280,1454,835,1044,76,110,219,1530,17,275,158,296,292,454,2297,3718,9,34017,1889,1,2,1,1,9290,4064,947,7672,1
171,3359,373,158,315,8,0,51,381,5,76,44,79,81,123,486,779,2,2026,112,0,2,303,2,9290,4064,947,7673,1
112,2286,384,251,317,7,8,52,391,11,70,44,84,81,128,467,811,6,5355,297,0,2,8,1,9290,4064,947,7674,1
66,2902,384,251,317,7,8,52,391,11,70,44,84,81,128,467,811,6,5355,297,0,2,9,0,9290,4064,947,7675,1
1,42,2,2,2,0,0,0,2,0,0,0,0,0,0,0,0,0,0,0,0,2,7,4,9290,4064,947,7675,1
1,42,99,48,90,1,3,5,100,0,0,0,0,0,0,0,0,0,0,0,0,2,7,4,9290,4065,947,7676,1
1,42,8,5,5,2,0,1,10,0,0,0,0,0,0,0,0,0,0,0,0,2,7,4,9290,4065,947,7677,1
1,42,1217,716,841,84,126,174,1301,14,185,118,215,199,333,1446,2542,8,20687,1149,0,2,7,4,9300,4067,947,7678,1
1,42,160,89,115,0,13,31,160,7,15,11,17,22,28,78,124,3,495,27,0,2,7,4,9300,4067,947,7679,1
1,42,10,10,9,9,0,0,19,0,0,0,0,0,0,0,0,0,0,0,0,2,7,4,9300,4067,948,7680,1
1,42,173,84,99,8,29,36,181,5,12,7,13,17,20,54,81,2,221,12,0,2,7,4,9300,4068,948,7681,1
1,42,3,1,1,3,0,0,6,0,0,0,0,0,0,0,0,0,0,0,0,2,7,4,9300,4068,948,7682,1
45,428,647,139,84,35,284,233,682,0,0,0,0,0,0,0,0,0,0,0,0,2,1,3,9300,4068,948,7683,1
137,3229,722,423,573,19,0,135,741,12,172,101,199,184,300,1320,2257,6,15668,870,0,2,1,2,9310,4071,948,7687,1
137,3229,1508,847,911,44,250,301,1552,14,148,88,169,162,257,1120,1886,7,15077,837,0,2,1,2,9310,4072,949,7688,1
7,166,127,75,83,2,11,30,129,4,14,7,14,18,21,61,87,2,175,9,0,2,1,1,9310,4072,949,7690,1
7,166,652,304,544,16,6,88,668,6,89,51,101,95,152,591,998,3,3399,188,0,2,1,1,9310,4073,949,7691,1
7,166,2,2,2,0,0,0,2,0,0,0,0,0,0,0,0,0,0,0,0,2,1,1,9310,4073,949,7691,1
7,166,8,5,5,0,0,3,8,0,0,0,0,0,0,0,0,0,0,0,0,2,1,1,9310,4073,949,7692,1
7,166,2,2,2,0,0,0,2,0,0,0,0,0,0,0,0,0,0,0,0,2,1,1,9310,4073,949,7692,1
7,166,14,8,8,0,0,6,14,0,0,0,0,0,0,0,0,0,0,0,0,2,1,1,9310,4073,949,7693,1
7,166,6,4,4,0,0,2,6,0,0,0,0,0,0,0,0,0,0,0,0,2,1,1,9310,4073,949,7694,1
7,166,6,4,4,0,0,2,6,1,2,1,2,3,3,2,4,0,2,0,0,2,1,1,9310,4073,949,7695,1
7,166,6,4,4,0,0,2,6,0,0,0,0,0,0,0,0,0,0,0,0,2,1,1,9310,4073,949,7696,1
7,166,7,5,5,0,0,2,7,0,0,0,0,0,0,0,0,0,0,0,0,2,1,1,9310,4073,949,7697,1
7,166,6,4,4,0,0,2,6,0,0,0,0,0,0,0,0,0,0,0,0,2,1,1,9310,4073,949,7698,1
7,166,10,6,6,0,0,4,10,0,0,0,0,0,0,0,0,0,0,0,0,2,1,1,9310,4073,949,7699,1
7,166,1,1,1,0,0,0,1,0,0,0,0,0,0,0,0,0,0,0,0,2,1,1,9310,4073,949,7699,1
7,166,14,10,10,0,0,4,14,1,1,1,1,2,2,0,2,0,1,0,0,2,1,1,9310,4073,949,7700,1
7,166,46,26,30,3,0,12,49,3,6,3,6,9,9,20,28,1,42,2,0,2,1,1,9320,4073,949,7701,1
13,1148,215,129,180,6,0,29,221,8,65,43,72,73,115,415,711,4,3153,175,0,2,1,1,9320,4073,949,7702,1
25,1318,652,304,544,16,6,88,668,6,89,51,101,95,152,591,998,3,3399,188,0,2,1,1,9320,4074,949,7703,1
18,814,334,251,279,10,4,40,344,5,127,74,143,132,217,899,1528,2,4303,239,0,2,2,2,9320,4075,949,7704,1
66,2890,384,251,317,7,8,52,391,11,70,44,84,81,128,467,811,6,5355,297,0,2,5,8,9320,4075,949,7705,1
54,886,1020,354,843,12,15,144,1032,8,134,77,144,142,221,970,1580,4,6792,377,0,2,65,0,9320,4075,949,7706,1
28,1384,1020,354,843,12,15,144,1032,8,134,77,144,142,221,970,1580,4,6792,377,0,2,127,0,9320,4075,949,7707,1
169,3958,722,423,573,19,0,135,741,12,172,101,199,184,300,1320,2257,6,15668,870,0,2,120,1,9320,4077,949,7709,1
169,3958,1508,847,911,44,250,301,1552,14,148,88,169,162,257,1120,1886,7,15077,837,0,2,120,1,9320,4078,950,7710,1
10,500,722,423,573,19,0,135,741,12,172,101,199,184,300,1320,2257,6,15668,870,0,2,44,1,9320,4080,950,7712,1
1,31,2,2,2,0,0,0,2,0,0,0,0,0,0,0,0,0,0,0,0,2,0,2,9320,4080,950,7712,1
1,31,99,48,90,1,3,5,100,0,0,0,0,0,0,0,0,0,0,0,0,2,0,2,9320,4081,950,7713,1
1,31,8,5,5,2,0,1,10,0,0,0,0,0,0,0,0,0,0,0,0,2,0,2,9320,4081,950,7714,1
1,31,1217,716,841,84,126,174,1301,14,185,118,215,199,333,1446,2542,8,20687,1149,0,2,0,2,9330,4083,950,7715,1
1,31,160,89,115,0,13,31,160,7,15,11,17,22,28,78,124,3,495,27,0,2,0,2,9330,4083,950,7716,1
1,31,10,10,9,9,0,0,19,0,0,0,0,0,0,0,0,0,0,0,0,2,0,2,9330,4083,951,7717,1
1,31,173,84,99,8,29,36,181,5,12,7,13,17,20,54,81,2,221,12,0,2,0,2,9330,4084,951,7718,1
1,31,3,1,1,3,0,0,6,0,0,0,0,0,0,0,0,0,0,0,0,2,0,2,9330,4084,951,7719,1
46,442,647,139,84,35,284,233,682,0,0,0,0,0,0,0,0,0,0,0,0,2,8,3,9330,4084,951,7720,1
115,2361,1457,730,1242,11,6,188,1468,10,292,166,329,302,495,2424,4078,5,22973,1276,1,0,395,0,9330,4086,951,7721,1
115,2361,74,35,59,1,0,14,75,3,14,7,14,17,21,58,85,1,128,7,0,0,395,0,9330,4087,951,7722,1
115,2361,245,125,200,5,7,34,250,7,30,17,34,37,51,166,265,3,1053,58,0,0,395,0,9340,4088,951,7723,1
168,3956,722,423,573,19,0,135,741,12,172,101,199,184,300,1320,2257,6,15668,870,0,2,4,7,9340,4090,951,7725,1
168,3956,1508,847,911,44,250,301,1552,14,148,88,169,162,257,1120,1886,7,15077,837,0,2,4,7,9340,4091,952,7726,1
171,3366,373,158,315,8,0,51,381,5,76,44,79,81,123,486,779,2,2026,112,0,2,1,1,9340,4091,952,7727,1
25,1320,652,304,544,16,6,88,668,6,89,51,101,95,152,591,998,3,3399,188,0,2,1,1,9340,4092,952,7728,1
18,816,334,251,279,10,4,40,344,5,127,74,143,132,217,899,1528,2,4303,239,0,2,1,1,9340,4093,952,7729,1
115,2364,1457,730,1242,11,6,188,1468,10,292,166,329,302,495,2424,4078,5,22973,1276,1,2,1,1,9340,4095,952,7730,1
115,2364,74,35,59,1,0,14,75,3,14,7,14,17,21,58,85,1,128,7,0,2,1,1,9340,4096,952,7731,1
115,2364,245,125,200,5,7,34,250,7,30,17,34,37,51,166,265,3,1053,58,0,2,1,1,9350,4097,952,7732,1
168,3956,722,423,573,19,0,135,741,12,172,101,199,184,300,1320,2257,6,15668,870,0,2,9,9,9350,4099,952,7734,1
168,3956,1508,847,911,44,250,301,1552,14,148,88,169,162,257,1120,1886,7,15077,837,0,2,9,9,9350,4100,953,7735,1
10,500,722,423,573,19,0,135,741,12,172,101,199,184,300,1320,2257,6,15668,870,0,2,6,6,9350,4102,953,7737,1
68,2956,384,251,317,7,8,52,391,11,70,44,84,81,128,467,811,6,5355,297,0,2,53,50,9350,4102,953,7738,1
54,886,1020,354,843,12,15,144,1032,8,134,77,144,142,221,970,1580,4,6792,377,0,2,1,83,9350,4102,953,7739,1
194,4305,72,33,56,0,4,12,72,1,1,1,1,2,2,0,2,0,1,0,0,2,4,3,9350,4102,953,7740,1
194,4305,1454,835,1044,76,110,219,1530,17,275,158,296,292,454,2297,3718,9,34017,1889,1,2,4,3,9360,4103,953,7741,1
19,975,1289,550,1043,56,32,155,1345,10,167,93,185,177,278,1266,2075,5,11498,638,0,2,16,0,9360,4105,954,7742,1
109,2197,1457,730,1242,11,6,188,1468,10,292,166,329,302,495,2424,4078,5,22973,1276,1,2,0,28,9360,4107,954,7743,1
109,2197,74,35,59,1,0,14,75,3,14,7,14,17,21,58,85,1,128,7,0,2,0,28,9360,4108,954,7744,1
109,2197,245,125,200,5,7,34,250,7,30,17,34,37,51,166,265,3,1053,58,0,2,0,28,9370,4109,954,7745,1
16,579,1455,414,1257,16,76,112,1471,5,41,23,46,46,69,231,381,2,1069,59,0,2,3,4,9370,4110,954,7746,1
16,579,669,365,481,22,61,110,691,15,103,63,122,118,185,747,1273,8,11311,628,0,2,3,4,9380,4110,955,7747,1
51,842,1020,354,843,12,15,144,1032,8,134,77,144,142,221,970,1580,4,6792,377,0,2,0,6,9380,4110,955,7748,1
186,4076,72,33,56,0,4,12,72,1,1,1,1,2,2,0,2,0,1,0,0,2,7,38,9380,4110,955,7749,1
186,4076,1454,835,1044,76,110,219,1530,17,275,158,296,292,454,2297,3718,9,34017,1889,1,2,7,38,9390,4111,955,7750,1
99,2389,1043,504,840,53,9,147,1096,9,180,112,198,189,310,1377,2344,4,11604,644,0,2,1,2,9390,4113,955,7751,1
99,2389,383,288,292,26,6,62,409,11,65,38,67,76,105,429,656,5,3719,206,0,2,1,2,9390,4114,955,7752,1
150,3028,373,158,315,8,0,51,381,5,76,44,79,81,123,486,779,2,2026,112,0,2,2,77,9390,4114,955,7753,1
27,1358,1020,354,843,12,15,144,1032,8,134,77,144,142,221,970,1580,4,6792,377,0,2,11,16,9390,4114,955,7754,1
25,1029,373,158,315,8,0,51,381,5,76,44,79,81,123,486,779,2,2026,112,0,2,7,5,9390,4114,955,7755,1
50,2502,1943,715,1694,26,18,214,1969,12,185,120,237,197,357,1436,2721,7,20915,1161,0,2,1,1,9390,4116,955,7756,1
17,771,334,251,279,10,4,40,344,5,127,74,143,132,217,899,1528,2,4303,239,0,2,2,9,9390,4117,955,7757,1
111,2192,1457,730,1242,11,6,188,1468,10,292,166,329,302,495,2424,4078,5,22973,1276,1,2,10,9,9390,4119,955,7758,1
111,2192,74,35,59,1,0,14,75,3,14,7,14,17,21,58,85,1,128,7,0,2,10,9,9390,4120,955,7759,1
111,2192,245,125,200,5,7,34,250,7,30,17,34,37,51,166,265,3,1053,58,0,2,10,9,9400,4121,955,7760,1
26,1354,652,304,544,16,6,88,668,6,89,51,101,95,152,591,998,3,3399,188,0,2,21,0,9400,4122,955,7761,1
51,843,1020,354,843,12,15,144,1032,8,134,77,144,142,221,970,1580,4,6792,377,0,2,30,5,9400,4123,956,7763,1
186,4076,72,33,56,0,4,12,72,1,1,1,1,2,2,0,2,0,1,0,0,2,5,7,9400,4123,956,7764,1
186,4076,1454,835,1044,76,110,219,1530,17,275,158,296,292,454,2297,3718,9,34017,1889,1,2,5,7,9410,4124,956,7765,1
6,283,42,7,35,4,0,5,46,1,2,1,2,3,3,2,4,0,2,0,0,2,5,9,9410,4124,956,7766,1
6,283,11,6,10,0,0,1,11,2,4,2,4,6,6,10,15,1,15,0,0,2,5,9,9410,4124,956,7767,1
186,4083,72,33,56,0,4,12,72,1,1,1,1,2,2,0,2,0,1,0,0,2,1,0,9410,4124,956,7769,0
186,4083,1454,835,1044,76,110,219,1530,17,275,158,296,292,454,2297,3718,9,34017,1889,1,2,1,0,9420,4125,956,7770,0
192,4137,72,33,56,0,4,12,72,1,1,1,1,2,2,0,2,0,1,0,0,2,41,9,9420,4125,956,7771,0
192,4137,1454,835,1044,76,110,219,1530,17,275,158,296,292,454,2297,3718,9,34017,1889,1,2,41,9,9430,4126,956,7772,0
3,70,442,244,305,14,16,103,456,11,68,45,75,79,120,452,756,6,4588,254,0,2,1,1,9430,4128,956,7773,1
3,70,182,102,99,11,40,35,193,3,11,6,11,14,17,42,64,1,97,5,0,2,1,1,9430,4129,956,7774,1
2,105,442,244,305,14,16,103,456,11,68,45,75,79,120,452,756,6,4588,254,0,2,7,2,9430,4131,956,7775,1
168,3913,722,423,573,19,0,135,741,12,172,101,199,184,300,1320,2257,6,15668,870,0,2,1,6,9430,4133,956,7777,1
168,3913,1508,847,911,44,250,301,1552,14,148,88,169,162,257,1120,1886,7,15077,837,0,2,1,6,9430,4134,957,7778,1
1,31,2,2,2,0,0,0,2,0,0,0,0,0,0,0,0,0,0,0,0,2,1,1,9430,4134,957,7778,0
1,31,99,48,90,1,3,5,100,0,0,0,0,0,0,0,0,0,0,0,0,2,1,1,9430,4135,957,7779,0
1,31,8,5,5,2,0,1,10,0,0,0,0,0,0,0,0,0,0,0,0,2,1,1,9430,4135,957,7780,0
1,31,1217,716,841,84,126,174,1301,14,185,118,215,199,333,1446,2542,8,20687,1149,0,2,1,1,9440,4137,957,7781,0
1,31,160,89,115,0,13,31,160,7,15,11,17,22,28,78,124,3,495,27,0,2,1,1,9440,4137,957,7782,0
1,31,10,10,9,9,0,0,19,0,0,0,0,0,0,0,0,0,0,0,0,2,1,1,9440,4137,958,7783,0
1,31,173,84,99,8,29,36,181,5,12,7,13,17,20,54,81,2,221,12,0,2,1,1,9440,4138,958,7784,0
1,31,3,1,1,3,0,0,6,0,0,0,0,0,0,0,0,0,0,0,0,2,1,1,9440,4138,958,7785,0
6,283,42,7,35,4,0,5,46,1,2,1,2,3,3,2,4,0,2,0,0,2,1,1,9440,4138,958,7786,0
6,283,11,6,10,0,0,1,11,2,4,2,4,6,6,10,15,1,15,0,0,2,1,1,9440,4138,958,7787,0
3,88,442,244,305,14,16,103,456,11,68,45,75,79,120,452,756,6,4588,254,0,2,2,1,9440,4140,958,7788,1
3,88,182,102,99,11,40,35,193,3,11,6,11,14,17,42,64,1,97,5,0,2,2,1,9440,4141,958,7789,1
2,139,442,244,305,14,16,103,456,11,68,45,75,79,120,452,756,6,4588,254,0,2,6,1,9440,4143,958,7790,1
1,31,2,2,2,0,0,0,2,0,0,0,0,0,0,0,0,0,0,0,0,2,1,1,9440,4144,959,7791,1
1,31,99,48,90,1,3,5,100,0,0,0,0,0,0,0,0,0,0,0,0,2,1,1,9440,4145,959,7792,1
1,31,8,5,5,2,0,1,10,0,0,0,0,0,0,0,0,0,0,0,0,2,1,1,9440,4145,959,7793,1
1,31,1217,716,841,84,126,174,1301,14,185,118,215,199,333,1446,2542,8,20687,1149,0,2,1,1,9450,4147,959,7794,1
1,31,160,89,115,0,13,31,160,7,15,11,17,22,28,78,124,3,495,27,0,2,1,1,9450,4147,959,7795,1
1,31,10,10,9,9,0,0,19,0,0,0,0,0,0,0,0,0,0,0,0,2,1,1,9450,4147,960,7796,1
1,31,173,84,99,8,29,36,181,5,12,7,13,17,20,54,81,2,221,12,0,2,1,1,9450,4148,960,7797,1
1,31,3,1,1,3,0,0,6,0,0,0,0,0,0,0,0,0,0,0,0,2,1,1,9450,4148,960,7798,1
151,3035,373,158,315,8,0,51,381,5,76,44,79,81,123,486,779,2,2026,112,0,2,1,1,9450,4148,960,7799,1
6,283,42,7,35,4,0,5,46,1,2,1,2,3,3,2,4,0,2,0,0,2,1,1,9450,4148,960,7800,1
6,283,11,6,10,0,0,1,11,2,4,2,4,6,6,10,15,1,15,0,0,2,1,1,9450,4148,960,7801,1
28,1387,1178,367,1042,6,15,115,1184,9,94,51,95,103,146,644,976,4,4439,246,0,2,1,1,9450,4148,960,7802,1
151,3041,373,158,315,8,0,51,381,5,76,44,79,81,123,486,779,2,2026,112,0,2,1,1,9450,4148,960,7803,1
1,31,2,2,2,0,0,0,2,0,0,0,0,0,0,0,0,0,0,0,0,2,2,2,9450,4148,960,7803,1
1,31,99,48,90,1,3,5,100,0,0,0,0,0,0,0,0,0,0,0,0,2,2,2,9450,4149,960,7804,1
1,31,8,5,5,2,0,1,10,0,0,0,0,0,0,0,0,0,0,0,0,2,2,2,9450,4149,960,7805,1
1,31,1217,716,841,84,126,174,1301,14,185,118,215,199,333,1446,2542,8,20687,1149,0,2,2,2,9460,4151,960,7806,1
1,31,160,89,115,0,13,31,160,7,15,11,17,22,28,78,124,3,495,27,0,2,2,2,9460,4151,960,7807,1
1,31,10,10,9,9,0,0,19,0,0,0,0,0,0,0,0,0,0,0,0,2,2,2,9460,4151,961,7808,1
1,31,173,84,99,8,29,36,181,5,12,7,13,17,20,54,81,2,221,12,0,2,2,2,9460,4152,961,7809,1
1,31,3,1,1,3,0,0,6,0,0,0,0,0,0,0,0,0,0,0,0,2,2,2,9460,4152,961,7810,1
6,283,42,7,35,4,0,5,46,1,2,1,2,3,3,2,4,0,2,0,0,2,2,3,9460,4152,961,7811,1
6,283,11,6,10,0,0,1,11,2,4,2,4,6,6,10,15,1,15,0,0,2,2,3,9460,4152,961,7812,1
1,31,2,2,2,0,0,0,2,0,0,0,0,0,0,0,0,0,0,0,0,2,1,1,9460,4152,961,7812,1
1,31,99,48,90,1,3,5,100,0,0,0,0,0,0,0,0,0,0,0,0,2,1,1,9460,4153,961,7813,1
1,31,8,5,5,2,0,1,10,0,0,0,0,0,0,0,0,0,0,0,0,2,1,1,9460,4153,961,7814,1
1,31,1217,716,841,84,126,174,1301,14,185,118,215,199,333,1446,2542,8,20687,1149,0,2,1,1,9470,4155,961,7815,1
1,31,160,89,115,0,13,31,160,7,15,11,17,22,28,78,124,3,495,27,0,2,1,1,9470,4155,961,7816,1
1,31,10,10,9,9,0,0,19,0,0,0,0,0,0,0,0,0,0,0,0,2,1,1,9470,4155,962,7817,1
1,31,173,84,99,8,29,36,181,5,12,7,13,17,20,54,81,2,221,12,0,2,1,1,9470,4156,962,7818,1
1,31,3,1,1,3,0,0,6,0,0,0,0,0,0,0,0,0,0,0,0,2,1,1,9470,4156,962,7819,1
116,2264,1457,730,1242,11,6,188,1468,10,292,166,329,302,495,2424,4078,5,22973,1276,1,2,16,1,9470,4158,962,7820,1
116,2264,74,35,59,1,0,14,75,3,14,7,14,17,21,58,85,1,128,7,0,2,16,1,9470,4159,962,7821,1
116,2264,245,125,200,5,7,34,250,7,30,17,34,37,51,166,265,3,1053,58,0,2,16,1,9480,4160,962,7822,1
6,283,42,7,35,4,0,5,46,1,2,1,2,3,3,2,4,0,2,0,0,2,1,1,9480,4160,962,7823,1
6,283,11,6,10,0,0,1,11,2,4,2,4,6,6,10,15,1,15,0,0,2,1,1,9480,4160,962,7824,1
20,1004,1289,550,1043,56,32,155,1345,10,167,93,185,177,278,1266,2075,5,11498,638,0,2,10,2,9480,4162,963,7825,1
1,31,2,2,2,0,0,0,2,0,0,0,0,0,0,0,0,0,0,0,0,2,1,1,9480,4162,963,7825,0
1,31,99,48,90,1,3,5,100,0,0,0,0,0,0,0,0,0,0,0,0,2,1,1,9480,4163,963,7826,0
1,31,8,5,5,2,0,1,10,0,0,0,0,0,0,0,0,0,0,0,0,2,1,1,9480,4163,963,7827,0
1,31,1217,716,841,84,126,174,1301,14,185,118,215,199,333,1446,2542,8,20687,1149,0,2,1,1,9490,4165,963,7828,0
1,31,160,89,115,0,13,31,160,7,15,11,17,22,28,78,124,3,495,27,0,2,1,1,9490,4165,963,7829,0
1,31,10,10,9,9,0,0,19,0,0,0,0,0,0,0,0,0,0,0,0,2,1,1,9490,4165,964,7830,0
1,31,173,84,99,8,29,36,181,5,12,7,13,17,20,54,81,2,221,12,0,2,1,1,9490,4166,964,7831,0
1,31,3,1,1,3,0,0,6,0,0,0,0,0,0,0,0,0,0,0,0,2,1,1,9490,4166,964,7832,0
6,283,42,7,35,4,0,5,46,1,2,1,2,3,3,2,4,0,2,0,0,2,1,1,9490,4166,964,7833,0
6,283,11,6,10,0,0,1,11,2,4,2,4,6,6,10,15,1,15,0,0,2,1,1,9490,4166,964,7834,0
20,1015,1289,550,1043,56,32,155,1345,10,167,93,185,177,278,1266,2075,5,11498,638,0,2,3,0,9490,4168,965,7835,0
169,3918,722,423,573,19,0,135,741,12,172,101,199,184,300,1320,2257,6,15668,870,0,2,2,1,9490,4170,965,7837,1
169,3918,1508,847,911,44,250,301,1552,14,148,88,169,162,257,1120,1886,7,15077,837,0,2,2,1,9490,4171,966,7838,1
156,3046,373,158,315,8,0,51,381,5,76,44,79,81,123,486,779,2,2026,112,0,2,39,39,9490,4171,966,7839,1
18,346,127,75,83,2,11,30,129,4,14,7,14,18,21,61,87,2,175,9,0,2,3,0,9490,4171,966,7840,1
18,346,652,304,544,16,6,88,668,6,89,51,101,95,152,591,998,3,3399,188,0,2,3,0,9490,4172,966,7841,1
18,346,2,2,2,0,0,0,2,0,0,0,0,0,0,0,0,0,0,0,0,2,3,0,9490,4172,966,7841,1
18,346,8,5,5,0,0,3,8,0,0,0,0,0,0,0,0,0,0,0,0,2,3,0,9490,4172,966,7842,1
18,346,2,2,2,0,0,0,2,0,0,0,0,0,0,0,0,0,0,0,0,2,3,0,9490,4172,966,7842,1
18,346,14,8,8,0,0,6,14,0,0,0,0,0,0,0,0,0,0,0,0,2,3,0,9490,4172,966,7843,1
18,346,6,4,4,0,0,2,6,0,0,0,0,0,0,0,0,0,0,0,0,2,3,0,9490,4172,966,7844,1
18,346,6,4,4,0,0,2,6,1,2,1,2,3,3,2,4,0,2,0,0,2,3,0,9490,4172,966,7845,1
18,346,6,4,4,0,0,2,6,0,0,0,0,0,0,0,0,0,0,0,0,2,3,0,9490,4172,966,7846,1
18,346,7,5,5,0,0,2,7,0,0,0,0,0,0,0,0,0,0,0,0,2,3,0,9490,4172,966,7847,1
18,346,6,4,4,0,0,2,6,0,0,0,0,0,0,0,0,0,0,0,0,2,3,0,9490,4172,966,7848,1
18,346,10,6,6,0,0,4,10,0,0,0,0,0,0,0,0,0,0,0,0,2,3,0,9490,4172,966,7849,1
18,346,1,1,1,0,0,0,1,0,0,0,0,0,0,0,0,0,0,0,0,2,3,0,9490,4172,966,7849,1
18,346,14,10,10,0,0,4,14,1,1,1,1,2,2,0,2,0,1,0,0,2,3,0,9490,4172,966,7850,1
18,346,46,26,30,3,0,12,49,3,6,3,6,9,9,20,28,1,42,2,0,2,3,0,9500,4172,966,7851,1
1,31,2,2,2,0,0,0,2,0,0,0,0,0,0,0,0,0,0,0,0,2,1,1,9500,4172,966,7851,1
1,31,99,48,90,1,3,5,100,0,0,0,0,0,0,0,0,0,0,0,0,2,1,1,9500,4173,966,7852,1
1,31,8,5,5,2,0,1,10,0,0,0,0,0,0,0,0,0,0,0,0,2,1,1,9500,4173,966,7853,1
1,31,1217,716,841,84,126,174,1301,14,185,118,215,199,333,1446,2542,8,20687,1149,0,2,1,1,9510,4175,966,7854,1
1,31,160,89,115,0,13,31,160,7,15,11,17,22,28,78,124,3,495,27,0,2,1,1,9510,4175,966,7855,1
1,31,10,10,9,9,0,0,19,0,0,0,0,0,0,0,0,0,0,0,0,2,1,1,9510,4175,967,7856,1
1,31,173,84,99,8,29,36,181,5,12,7,13,17,20,54,81,2,221,12,0,2,1,1,9510,4176,967,7857,1
1,31,3,1,1,3,0,0,6,0,0,0,0,0,0,0,0,0,0,0,0,2,1,1,9510,4176,967,7858,1
44,777,1020,354,843,12,15,144,1032,8,134,77,144,142,221,970,1580,4,6792,377,0,2,41,40,9510,4176,967,7859,1
169,3902,722,423,573,19,0,135,741,12,172,101,199,184,300,1320,2257,6,15668,870,0,2,2,5,9510,4178,967,7861,1
169,3902,1508,847,911,44,250,301,1552,14,148,88,169,162,257,1120,1886,7,15077,837,0,2,2,5,9510,4179,968,7862,1
191,4128,72,33,56,0,4,12,72,1,1,1,1,2,2,0,2,0,1,0,0,2,2,3,9510,4179,968,7863,1
191,4128,1454,835,1044,76,110,219,1530,17,275,158,296,292,454,2297,3718,9,34017,1889,1,2,2,3,9520,4180,968,7864,1
100,2392,1043,504,840,53,9,147,1096,9,180,112,198,189,310,1377,2344,4,11604,644,0,2,1,1,9520,4182,968,7865,1
100,2392,383,288,292,26,6,62,409,11,65,38,67,76,105,429,656,5,3719,206,0,2,1,1,9520,4183,968,7866,1
152,3008,373,158,315,8,0,51,381,5,76,44,79,81,123,486,779,2,2026,112,0,2,3,9,9520,4183,968,7867,1
6,283,42,7,35,4,0,5,46,1,2,1,2,3,3,2,4,0,2,0,0,2,1,1,9520,4183,968,7868,1
6,283,11,6,10,0,0,1,11,2,4,2,4,6,6,10,15,1,15,0,0,2,1,1,9520,4183,968,7869,1
31,1247,1020,354,843,12,15,144,1032,8,134,77,144,142,221,970,1580,4,6792,377,0,2,23,25,9520,4183,968,7870,1
6,219,1098,241,925,5,10,155,1103,7,46,25,49,53,74,273,423,3,1580,87,0,2,11,0,9530,4185,968,7871,1
1,31,2,2,2,0,0,0,2,0,0,0,0,0,0,0,0,0,0,0,0,2,1,1,9530,4185,968,7871,1
1,31,99,48,90,1,3,5,100,0,0,0,0,0,0,0,0,0,0,0,0,2,1,1,9530,4186,968,7872,1
1,31,8,5,5,2,0,1,10,0,0,0,0,0,0,0,0,0,0,0,0,2,1,1,9530,4186,968,7873,1
1,31,1217,716,841,84,126,174,1301,14,185,118,215,199,333,1446,2542,8,20687,1149,0,2,1,1,9540,4188,968,7874,1
1,31,160,89,115,0,13,31,160,7,15,11,17,22,28,78,124,3,495,27,0,2,1,1,9540,4188,968,7875,1
1,31,10,10,9,9,0,0,19,0,0,0,0,0,0,0,0,0,0,0,0,2,1,1,9540,4188,969,7876,1
1,31,173,84,99,8,29,36,181,5,12,7,13,17,20,54,81,2,221,12,0,2,1,1,9540,4189,969,7877,1
1,31,3,1,1,3,0,0,6,0,0,0,0,0,0,0,0,0,0,0,0,2,1,1,9540,4189,969,7878,1
154,3077,373,158,315,8,0,51,381,5,76,44,79,81,123,486,779,2,2026,112,0,2,14,0,9540,4189,969,7879,1
6,283,42,7,35,4,0,5,46,1,2,1,2,3,3,2,4,0,2,0,0,2,1,1,9540,4189,969,7880,1
6,283,11,6,10,0,0,1,11,2,4,2,4,6,6,10,15,1,15,0,0,2,1,1,9540,4189,969,7881,1
64,1168,1513,682,1277,25,13,200,1538,11,199,116,219,210,335,1557,2584,6,15641,868,0,2,9,0,9540,4191,969,7882,1
64,1168,819,519,539,24,98,155,843,15,96,57,106,111,163,690,1107,8,9171,509,0,2,9,0,9550,4193,969,7883,1
169,3919,722,423,573,19,0,135,741,12,172,101,199,184,300,1320,2257,6,15668,870,0,2,2,0,9550,4195,969,7885,1
169,3919,1508,847,911,44,250,301,1552,14,148,88,169,162,257,1120,1886,7,15077,837,0,2,2,0,9550,4196,970,7886,1
133,2578,1943,715,1694,26,18,214,1969,12,185,120,237,197,357,1436,2721,7,20915,1161,0,2,18,10,9550,4198,970,7887,1
133,2578,1168,838,957,57,25,144,1225,19,348,224,416,367,640,3018,5452,11,61921,3440,1,2,18,10,9560,4200,970,7888,1
1,31,2,2,2,0,0,0,2,0,0,0,0,0,0,0,0,0,0,0,0,2,1,1,9560,4200,970,7888,1
1,31,99,48,90,1,3,5,100,0,0,0,0,0,0,0,0,0,0,0,0,2,1,1,9560,4201,970,7889,1
1,31,8,5,5,2,0,1,10,0,0,0,0,0,0,0,0,0,0,0,0,2,1,1,9560,4201,970,7890,1
1,31,1217,716,841,84,126,174,1301,14,185,118,215,199,333,1446,2542,8,20687,1149,0,2,1,1,9570,4203,970,7891,1
1,31,160,89,115,0,13,31,160,7,15,11,17,22,28,78,124,3,495,27,0,2,1,1,9570,4203,970,7892,1
1,31,10,10,9,9,0,0,19,0,0,0,0,0,0,0,0,0,0,0,0,2,1,1,9570,4203,971,7893,1
1,31,173,84,99,8,29,36,181,5,12,7,13,17,20,54,81,2,221,12,0,2,1,1,9570,4204,971,7894,1
1,31,3,1,1,3,0,0,6,0,0,0,0,0,0,0,0,0,0,0,0,2,1,1,9570,4204,971,7895,1
6,283,42,7,35,4,0,5,46,1,2,1,2,3,3,2,4,0,2,0,0,2,1,1,9570,4204,971,7896,1
6,283,11,6,10,0,0,1,11,2,4,2,4,6,6,10,15,1,15,0,0,2,1,1,9570,4204,971,7897,1
30,524,127,75,83,2,11,30,129,4,14,7,14,18,21,61,87,2,175,9,0,2,32,2,9570,4204,971,7898,1
30,524,652,304,544,16,6,88,668,6,89,51,101,95,152,591,998,3,3399,188,0,2,32,2,9570,4205,971,7899,1
30,524,2,2,2,0,0,0,2,0,0,0,0,0,0,0,0,0,0,0,0,2,32,2,9570,4205,971,7899,1
30,524,8,5,5,0,0,3,8,0,0,0,0,0,0,0,0,0,0,0,0,2,32,2,9570,4205,971,7900,1
30,524,2,2,2,0,0,0,2,0,0,0,0,0,0,0,0,0,0,0,0,2,32,2,9570,4205,971,7900,1
30,524,14,8,8,0,0,6,14,0,0,0,0,0,0,0,0,0,0,0,0,2,32,2,9570,4205,971,7901,1
30,524,6,4,4,0,0,2,6,0,0,0,0,0,0,0,0,0,0,0,0,2,32,2,9570,4205,971,7902,1
30,524,6,4,4,0,0,2,6,1,2,1,2,3,3,2,4,0,2,0,0,2,32,2,9570,4205,971,7903,1
30,524,6,4,4,0,0,2,6,0,0,0,0,0,0,0,0,0,0,0,0,2,32,2,9570,4205,971,7904,1
30,524,7,5,5,0,0,2,7,0,0,0,0,0,0,0,0,0,0,0,0,2,32,2,9570,4205,971,7905,1
30,524,6,4,4,0,0,2,6,0,0,0,0,0,0,0,0,0,0,0,0,2,32,2,9570,4205,971,7906,1
30,524,10,6,6,0,0,4,10,0,0,0,0,0,0,0,0,0,0,0,0,2,32,2,9570,4205,971,7907,1
30,524,1,1,1,0,0,0,1,0,0,0,0,0,0,0,0,0,0,0,0,2,32,2,9570,4205,971,7907,1
30,524,14,10,10,0,0,4,14,1,1,1,1,2,2,0,2,0,1,0,0,2,32,2,9570,4205,971,7908,1
30,524,46,26,30,3,0,12,49,3,6,3,6,9,9,20,28,1,42,2,0,2,32,2,9580,4205,971,7909,1
12,228,127,75,83,2,11,30,129,4,14,7,14,18,21,61,87,2,175,9,0,0,40,0,9580,4205,971,7910,1
12,228,652,304,544,16,6,88,668,6,89,51,101,95,152,591,998,3,3399,188,0,0,40,0,9580,4206,971,7911,1
12,228,2,2,2,0,0,0,2,0,0,0,0,0,0,0,0,0,0,0,0,0,40,0,9580,4206,971,7911,1
12,228,8,5,5,0,0,3,8,0,0,0,0,0,0,0,0,0,0,0,0,0,40,0,9580,4206,971,7912,1
12,228,2,2,2,0,0,0,2,0,0,0,0,0,0,0,0,0,0,0,0,0,40,0,9580,4206,971,7912,1
12,228,14,8,8,0,0,6,14,0,0,0,0,0,0,0,0,0,0,0,0,0,40,0,9580,4206,971,7913,1
12,228,6,4,4,0,0,2,6,0,0,0,0,0,0,0,0,0,0,0,0,0,40,0,9580,4206,971,7914,1
12,228,6,4,4,0,0,2,6,1,2,1,2,3,3,2,4,0,2,0,0,0,40,0,9580,4206,971,7915,1
12,228,6,4,4,0,0,2,6,0,0,0,0,0,0,0,0,0,0,0,0,0,40,0,9580,4206,971,7916,1
12,228,7,5,5,0,0,2,7,0,0,0,0,0,0,0,0,0,0,0,0,0,40,0,9580,4206,971,7917,1
12,228,6,4,4,0,0,2,6,0,0,0,0,0,0,0,0,0,0,0,0,0,40,0,9580,4206,971,7918,1
12,228,10,6,6,0,0,4,10,0,0,0,0,0,0,0,0,0,0,0,0,0,40,0,9580,4206,971,7919,1
12,228,1,1,1,0,0,0,1,0,0,0,0,0,0,0,0,0,0,0,0,0,40,0,9580,4206,971,7919,1
12,228,14,10,10,0,0,4,14,1,1,1,1,2,2,0,2,0,1,0,0,0,40,0,9580,4206,971,7920,1
12,228,46,26,30,3,0,12,49,3,6,3,6,9,9,20,28,1,42,2,0,0,40,0,9590,4206,971,7921,1
1,149,382,65,130,157,2,92,539,4,10,5,10,14,15,41,57,2,114,6,0,2,6,0,9590,4207,972,7922,1
1,36,2,2,2,0,0,0,2,0,0,0,0,0,0,0,0,0,0,0,0,2,2,1,9590,4207,972,7922,1
1,36,99,48,90,1,3,5,100,0,0,0,0,0,0,0,0,0,0,0,0,2,2,1,9590,4208,972,7923,1
1,36,8,5,5,2,0,1,10,0,0,0,0,0,0,0,0,0,0,0,0,2,2,1,9590,4208,972,7924,1
1,36,1217,716,841,84,126,174,1301,14,185,118,215,199,333,1446,2542,8,20687,1149,0,2,2,1,9600,4210,972,7925,1
1,36,160,89,115,0,13,31,160,7,15,11,17,22,28,78,124,3,495,27,0,2,2,1,9600,4210,972,7926,1
1,36,10,10,9,9,0,0,19,0,0,0,0,0,0,0,0,0,0,0,0,2,2,1,9600,4210,973,7927,1
1,36,173,84,99,8,29,36,181,5,12,7,13,17,20,54,81,2,221,12,0,2,2,1,9600,4211,973,7928,1
1,36,3,1,1,3,0,0,6,0,0,0,0,0,0,0,0,0,0,0,0,2,2,1,9600,4211,973,7929,1
132,2527,1457,730,1242,11,6,188,1468,10,292,166,329,302,495,2424,4078,5,22973,1276,1,2,45,5,9600,4213,973,7930,1
132,2527,74,35,59,1,0,14,75,3,14,7,14,17,21,58,85,1,128,7,0,2,45,5,9600,4214,973,7931,1
132,2527,245,125,200,5,7,34,250,7,30,17,34,37,51,166,265,3,1053,58,0,2,45,5,9610,4215,973,7932,1
154,3069,373,158,315,8,0,51,381,5,76,44,79,81,123,486,779,2,2026,112,0,2,4,4,9610,4215,973,7933,1
20,1015,1289,550,1043,56,32,155,1345,10,167,93,185,177,278,1266,2075,5,11498,638,0,2,2,1,9610,4217,974,7934,1
32,554,127,75,83,2,11,30,129,4,14,7,14,18,21,61,87,2,175,9,0,2,6,0,9610,4217,974,7935,1
32,554,652,304,544,16,6,88,668,6,89,51,101,95,152,591,998,3,3399,188,0,2,6,0,9610,4218,974,7936,1
32,554,2,2,2,0,0,0,2,0,0,0,0,0,0,0,0,0,0,0,0,2,6,0,9610,4218,974,7936,1
32,554,8,5,5,0,0,3,8,0,0,0,0,0,0,0,0,0,0,0,0,2,6,0,9610,4218,974,7937,1
32,554,2,2,2,0,0,0,2,0,0,0,0,0,0,0,0,0,0,0,0,2,6,0,9610,4218,974,7937,1
32,554,14,8,8,0,0,6,14,0,0,0,0,0,0,0,0,0,0,0,0,2,6,0,9610,4218,974,7938,1
32,554,6,4,4,0,0,2,6,0,0,0,0,0,0,0,0,0,0,0,0,2,6,0,9610,4218,974,7939,1
32,554,6,4,4,0,0,2,6,1,2,1,2,3,3,2,4,0,2,0,0,2,6,0,9610,4218,974,7940,1
32,554,6,4,4,0,0,2,6,0,0,0,0,0,0,0,0,0,0,0,0,2,6,0,9610,4218,974,7941,1
32,554,7,5,5,0,0,2,7,0,0,0,0,0,0,0,0,0,0,0,0,2,6,0,9610,4218,974,7942,1
32,554,6,4,4,0,0,2,6,0,0,0,0,0,0,0,0,0,0,0,0,2,6,0,9610,4218,974,7943,1
32,554,10,6,6,0,0,4,10,0,0,0,0,0,0,0,0,0,0,0,0,2,6,0,9610,4218,974,7944,1
32,554,1,1,1,0,0,0,1,0,0,0,0,0,0,0,0,0,0,0,0,2,6,0,9610,4218,974,7944,1
32,554,14,10,10,0,0,4,14,1,1,1,1,2,2,0,2,0,1,0,0,2,6,0,9610,4218,974,7945,1
32,554,46,26,30,3,0,12,49,3,6,3,6,9,9,20,28,1,42,2,0,2,6,0,9620,4218,974,7946,1
20,1267,1457,730,1242,11,6,188,1468,10,292,166,329,302,495,2424,4078,5,22973,1276,1,2,46,0,9620,4220,974,7947,1
124,2402,1457,730,1242,11,6,188,1468,10,292,166,329,302,495,2424,4078,5,22973,1276,1,2,14,32,9620,4222,974,7948,1
124,2402,74,35,59,1,0,14,75,3,14,7,14,17,21,58,85,1,128,7,0,2,14,32,9620,4223,974,7949,1
124,2402,245,125,200,5,7,34,250,7,30,17,34,37,51,166,265,3,1053,58,0,2,14,32,9630,4224,974,7950,1
33,864,74,35,59,1,0,14,75,3,14,7,14,17,21,58,85,1,128,7,0,2,36,41,9630,4225,974,7951,1
33,864,245,125,200,5,7,34,250,7,30,17,34,37,51,166,265,3,1053,58,0,2,36,41,9640,4226,974,7952,1
170,3938,722,423,573,19,0,135,741,12,172,101,199,184,300,1320,2257,6,15668,870,0,2,3,0,9640,4228,974,7954,1
170,3938,1508,847,911,44,250,301,1552,14,148,88,169,162,257,1120,1886,7,15077,837,0,2,3,0,9640,4229,975,7955,1
7,230,74,35,59,1,0,14,75,3,14,7,14,17,21,58,85,1,128,7,0,2,5,3,9640,4230,975,7956,1
50,2502,1943,715,1694,26,18,214,1969,12,185,120,237,197,357,1436,2721,7,20915,1161,0,2,2,2,9640,4232,975,7957,1
17,1016,1457,730,1242,11,6,188,1468,10,292,166,329,302,495,2424,4078,5,22973,1276,1,2,1,36,9640,4234,975,7958,1
17,771,334,251,279,10,4,40,344,5,127,74,143,132,217,899,1528,2,4303,239,0,2,2,2,9640,4235,975,7959,1
128,2500,1457,730,1242,11,6,188,1468,10,292,166,329,302,495,2424,4078,5,22973,1276,1,2,21,2,9640,4237,975,7960,1
128,2500,74,35,59,1,0,14,75,3,14,7,14,17,21,58,85,1,128,7,0,2,21,2,9640,4238,975,7961,1
128,2500,245,125,200,5,7,34,250,7,30,17,34,37,51,166,265,3,1053,58,0,2,21,2,9650,4239,975,7962,1
33,859,74,35,59,1,0,14,75,3,14,7,14,17,21,58,85,1,128,7,0,2,3,7,9650,4240,975,7963,1
33,859,245,125,200,5,7,34,250,7,30,17,34,37,51,166,265,3,1053,58,0,2,3,7,9660,4241,975,7964,1
7,230,74,35,59,1,0,14,75,3,14,7,14,17,21,58,85,1,128,7,0,2,1,1,9660,4242,975,7965,1
18,834,334,251,279,10,4,40,344,5,127,74,143,132,217,899,1528,2,4303,239,0,2,13,0,9660,4243,975,7966,1
1,80,13,10,10,0,0,3,13,1,2,1,2,3,3,2,4,0,2,0,0,2,0,2,9660,4243,975,7967,1
133,2609,1457,730,1242,11,6,188,1468,10,292,166,329,302,495,2424,4078,5,22973,1276,1,2,38,26,9660,4245,975,7968,1
133,2609,74,35,59,1,0,14,75,3,14,7,14,17,21,58,85,1,128,7,0,2,38,26,9660,4246,975,7969,1
133,2609,245,125,200,5,7,34,250,7,30,17,34,37,51,166,265,3,1053,58,0,2,38,26,9670,4247,975,7970,1
33,844,74,35,59,1,0,14,75,3,14,7,14,17,21,58,85,1,128,7,0,2,11,12,9670,4248,975,7971,1
33,844,245,125,200,5,7,34,250,7,30,17,34,37,51,166,265,3,1053,58,0,2,11,12,9680,4249,975,7972,1
172,3985,722,423,573,19,0,135,741,12,172,101,199,184,300,1320,2257,6,15668,870,0,2,7,0,9680,4251,975,7974,1
172,3985,1508,847,911,44,250,301,1552,14,148,88,169,162,257,1120,1886,7,15077,837,0,2,7,0,9680,4252,976,7975,1
154,3068,373,158,315,8,0,51,381,5,76,44,79,81,123,486,779,2,2026,112,0,2,3,2,9680,4252,976,7976,1
32,536,127,75,83,2,11,30,129,4,14,7,14,18,21,61,87,2,175,9,0,2,0,3,9680,4252,976,7977,1
32,536,652,304,544,16,6,88,668,6,89,51,101,95,152,591,998,3,3399,188,0,2,0,3,9680,4253,976,7978,1
32,536,2,2,2,0,0,0,2,0,0,0,0,0,0,0,0,0,0,0,0,2,0,3,9680,4253,976,7978,1
32,536,8,5,5,0,0,3,8,0,0,0,0,0,0,0,0,0,0,0,0,2,0,3,9680,4253,976,7979,1
32,536,2,2,2,0,0,0,2,0,0,0,0,0,0,0,0,0,0,0,0,2,0,3,9680,4253,976,7979,1
32,536,14,8,8,0,0,6,14,0,0,0,0,0,0,0,0,0,0,0,0,2,0,3,9680,4253,976,7980,1
32,536,6,4,4,0,0,2,6,0,0,0,0,0,0,0,0,0,0,0,0,2,0,3,9680,4253,976,7981,1
32,536,6,4,4,0,0,2,6,1,2,1,2,3,3,2,4,0,2,0,0,2,0,3,9680,4253,976,7982,1
32,536,6,4,4,0,0,2,6,0,0,0,0,0,0,0,0,0,0,0,0,2,0,3,9680,4253,976,7983,1
32,536,7,5,5,0,0,2,7,0,0,0,0,0,0,0,0,0,0,0,0,2,0,3,9680,4253,976,7984,1
32,536,6,4,4,0,0,2,6,0,0,0,0,0,0,0,0,0,0,0,0,2,0,3,9680,4253,976,7985,1
32,536,10,6,6,0,0,4,10,0,0,0,0,0,0,0,0,0,0,0,0,2,0,3,9680,4253,976,7986,1
32,536,1,1,1,0,0,0,1,0,0,0,0,0,0,0,0,0,0,0,0,2,0,3,9680,4253,976,7986,1
32,536,14,10,10,0,0,4,14,1,1,1,1,2,2,0,2,0,1,0,0,2,0,3,9680,4253,976,7987,1
32,536,46,26,30,3,0,12,49,3,6,3,6,9,9,20,28,1,42,2,0,2,0,3,9690,4253,976,7988,1
7,163,127,75,83,2,11,30,129,4,14,7,14,18,21,61,87,2,175,9,0,2,0,1,9690,4253,976,7989,1
7,163,652,304,544,16,6,88,668,6,89,51,101,95,152,591,998,3,3399,188,0,2,0,1,9690,4254,976,7990,1
7,163,2,2,2,0,0,0,2,0,0,0,0,0,0,0,0,0,0,0,0,2,0,1,9690,4254,976,7990,1
7,163,8,5,5,0,0,3,8,0,0,0,0,0,0,0,0,0,0,0,0,2,0,1,9690,4254,976,7991,1
7,163,2,2,2,0,0,0,2,0,0,0,0,0,0,0,0,0,0,0,0,2,0,1,9690,4254,976,7991,1
7,163,14,8,8,0,0,6,14,0,0,0,0,0,0,0,0,0,0,0,0,2,0,1,9690,4254,976,7992,1
7,163,6,4,4,0,0,2,6,0,0,0,0,0,0,0,0,0,0,0,0,2,0,1,9690,4254,976,7993,1
7,163,6,4,4,0,0,2,6,1,2,1,2,3,3,2,4,0,2,0,0,2,0,1,9690,4254,976,7994,1
7,163,6,4,4,0,0,2,6,0,0,0,0,0,0,0,0,0,0,0,0,2,0,1,9690,4254,976,7995,1
7,163,7,5,5,0,0,2,7,0,0,0,0,0,0,0,0,0,0,0,0,2,0,1,9690,4254,976,7996,1
7,163,6,4,4,0,0,2,6,0,0,0,0,0,0,0,0,0,0,0,0,2,0,1,9690,4254,976,7997,1
7,163,10,6,6,0,0,4,10,0,0,0,0,0,0,0,0,0,0,0,0,2,0,1,9690,4254,976,7998,1
7,163,1,1,1,0,0,0,1,0,0,0,0,0,0,0,0,0,0,0,0,2,0,1,9690,4254,976,7998,1
7,163,14,10,10,0,0,4,14,1,1,1,1,2,2,0,2,0,1,0,0,2,0,1,9690,4254,976,7999,1
7,163,46,26,30,3,0,12,49,3,6,3,6,9,9,20,28,1,42,2,0,2,0,1,9700,4254,976,8000,1
7,230,74,35,59,1,0,14,75,3,14,7,14,17,21,58,85,1,128,7,0,2,2,2,9700,4255,976,8001,1
19,1151,1457,730,1242,11,6,188,1468,10,292,166,329,302,495,2424,4078,5,22973,1276,1,2,33,3,9700,4257,976,8002,1
17,775,334,251,279,10,4,40,344,5,127,74,143,132,217,899,1528,2,4303,239,0,2,0,11,9700,4258,976,8003,1
133,2600,1457,730,1242,11,6,188,1468,10,292,166,329,302,495,2424,4078,5,22973,1276,1,2,7,5,9700,4260,976,8004,1
133,2600,74,35,59,1,0,14,75,3,14,7,14,17,21,58,85,1,128,7,0,2,7,5,9700,4261,976,8005,1
133,2600,245,125,200,5,7,34,250,7,30,17,34,37,51,166,265,3,1053,58,0,2,7,5,9710,4262,976,8006,1
175,4013,722,423,573,19,0,135,741,12,172,101,199,184,300,1320,2257,6,15668,870,0,2,5,0,9710,4264,976,8008,1
175,4013,1508,847,911,44,250,301,1552,14,148,88,169,162,257,1120,1886,7,15077,837,0,2,5,0,9710,4265,977,8009,1
151,3042,373,158,315,8,0,51,381,5,76,44,79,81,123,486,779,2,2026,112,0,2,2,8,9710,4265,977,8010,1
1,36,2,2,2,0,0,0,2,0,0,0,0,0,0,0,0,0,0,0,0,2,2,2,9710,4265,977,8010,0
1,36,99,48,90,1,3,5,100,0,0,0,0,0,0,0,0,0,0,0,0,2,2,2,9710,4266,977,8011,0
1,36,8,5,5,2,0,1,10,0,0,0,0,0,0,0,0,0,0,0,0,2,2,2,9710,4266,977,8012,0
1,36,1217,716,841,84,126,174,1301,14,185,118,215,199,333,1446,2542,8,20687,1149,0,2,2,2,9720,4268,977,8013,0
1,36,160,89,115,0,13,31,160,7,15,11,17,22,28,78,124,3,495,27,0,2,2,2,9720,4268,977,8014,0
1,36,10,10,9,9,0,0,19,0,0,0,0,0,0,0,0,0,0,0,0,2,2,2,9720,4268,978,8015,0
1,36,173,84,99,8,29,36,181,5,12,7,13,17,20,54,81,2,221,12,0,2,2,2,9720,4269,978,8016,0
1,36,3,1,1,3,0,0,6,0,0,0,0,0,0,0,0,0,0,0,0,2,2,2,9720,4269,978,8017,0
6,283,42,7,35,4,0,5,46,1,2,1,2,3,3,2,4,0,2,0,0,2,1,1,9720,4269,978,8018,0
6,283,11,6,10,0,0,1,11,2,4,2,4,6,6,10,15,1,15,0,0,2,1,1,9720,4269,978,8019,0
1,149,382,65,130,157,2,92,539,4,10,5,10,14,15,41,57,2,114,6,0,2,6,0,9720,4270,979,8020,0
12,228,127,75,83,2,11,30,129,4,14,7,14,18,21,61,87,2,175,9,0,0,40,0,9720,4270,979,8021,0
12,228,652,304,544,16,6,88,668,6,89,51,101,95,152,591,998,3,3399,188,0,0,40,0,9720,4271,979,8022,0
12,228,2,2,2,0,0,0,2,0,0,0,0,0,0,0,0,0,0,0,0,0,40,0,9720,4271,979,8022,0
12,228,8,5,5,0,0,3,8,0,0,0,0,0,0,0,0,0,0,0,0,0,40,0,9720,4271,979,8023,0
12,228,2,2,2,0,0,0,2,0,0,0,0,0,0,0,0,0,0,0,0,0,40,0,9720,4271,979,8023,0
12,228,14,8,8,0,0,6,14,0,0,0,0,0,0,0,0,0,0,0,0,0,40,0,9720,4271,979,8024,0
12,228,6,4,4,0,0,2,6,0,0,0,0,0,0,0,0,0,0,0,0,0,40,0,9720,4271,979,8025,0
12,228,6,4,4,0,0,2,6,1,2,1,2,3,3,2,4,0,2,0,0,0,40,0,9720,4271,979,8026,0
12,228,6,4,4,0,0,2,6,0,0,0,0,0,0,0,0,0,0,0,0,0,40,0,9720,4271,979,8027,0
12,228,7,5,5,0,0,2,7,0,0,0,0,0,0,0,0,0,0,0,0,0,40,0,9720,4271,979,8028,0
12,228,6,4,4,0,0,2,6,0,0,0,0,0,0,0,0,0,0,0,0,0,40,0,9720,4271,979,8029,0
12,228,10,6,6,0,0,4,10,0,0,0,0,0,0,0,0,0,0,0,0,0,40,0,9720,4271,979,8030,0
12,228,1,1,1,0,0,0,1,0,0,0,0,0,0,0,0,0,0,0,0,0,40,0,9720,4271,979,8030,0
12,228,14,10,10,0,0,4,14,1,1,1,1,2,2,0,2,0,1,0,0,0,40,0,9720,4271,979,8031,0
12,228,46,26,30,3,0,12,49,3,6,3,6,9,9,20,28,1,42,2,0,0,40,0,9730,4271,979,8032,0
1,80,13,10,10,0,0,3,13,1,2,1,2,3,3,2,4,0,2,0,0,2,0,2,9730,4271,979,8033,0
1,36,2,2,2,0,0,0,2,0,0,0,0,0,0,0,0,0,0,0,0,2,2,1,9730,4271,979,8033,0
1,36,99,48,90,1,3,5,100,0,0,0,0,0,0,0,0,0,0,0,0,2,2,1,9730,4272,979,8034,0
1,36,8,5,5,2,0,1,10,0,0,0,0,0,0,0,0,0,0,0,0,2,2,1,9730,4272,979,8035,0
1,36,1217,716,841,84,126,174,1301,14,185,118,215,199,333,1446,2542,8,20687,1149,0,2,2,1,9740,4274,979,8036,0
1,36,160,89,115,0,13,31,160,7,15,11,17,22,28,78,124,3,495,27,0,2,2,1,9740,4274,979,8037,0
1,36,10,10,9,9,0,0,19,0,0,0,0,0,0,0,0,0,0,0,0,2,2,1,9740,4274,980,8038,0
1,36,173,84,99,8,29,36,181,5,12,7,13,17,20,54,81,2,221,12,0,2,2,1,9740,4275,980,8039,0
1,36,3,1,1,3,0,0,6,0,0,0,0,0,0,0,0,0,0,0,0,2,2,1,9740,4275,980,8040,0
133,2600,1457,730,1242,11,6,188,1468,10,292,166,329,302,495,2424,4078,5,22973,1276,1,2,103,48,9740,4277,980,8041,0
133,2600,74,35,59,1,0,14,75,3,14,7,14,17,21,58,85,1,128,7,0,2,103,48,9740,4278,980,8042,0
133,2600,245,125,200,5,7,34,250,7,30,17,34,37,51,166,265,3,1053,58,0,2,103,48,9750,4279,980,8043,0
33,844,74,35,59,1,0,14,75,3,14,7,14,17,21,58,85,1,128,7,0,2,37,47,9750,4280,980,8044,0
33,844,245,125,200,5,7,34,250,7,30,17,34,37,51,166,265,3,1053,58,0,2,37,47,9760,4281,980,8045,0
175,4013,722,423,573,19,0,135,741,12,172,101,199,184,300,1320,2257,6,15668,870,0,2,15,0,9760,4283,980,8047,0
175,4013,1508,847,911,44,250,301,1552,14,148,88,169,162,257,1120,1886,7,15077,837,0,2,15,0,9760,4284,981,8048,0
151,3042,373,158,315,8,0,51,381,5,76,44,79,81,123,486,779,2,2026,112,0,2,9,14,9760,4284,981,8049,0
6,283,42,7,35,4,0,5,46,1,2,1,2,3,3,2,4,0,2,0,0,2,1,1,9760,4284,981,8050,0
6,283,11,6,10,0,0,1,11,2,4,2,4,6,6,10,15,1,15,0,0,2,1,1,9760,4284,981,8051,0
20,1015,1289,550,1043,56,32,155,1345,10,167,93,185,177,278,1266,2075,5,11498,638,0,2,2,1,9760,4286,982,8052,0
32,536,127,75,83,2,11,30,129,4,14,7,14,18,21,61,87,2,175,9,0,2,6,3,9760,4286,982,8053,0
32,536,652,304,544,16,6,88,668,6,89,51,101,95,152,591,998,3,3399,188,0,2,6,3,9760,4287,982,8054,0
32,536,2,2,2,0,0,0,2,0,0,0,0,0,0,0,0,0,0,0,0,2,6,3,9760,4287,982,8054,0
32,536,8,5,5,0,0,3,8,0,0,0,0,0,0,0,0,0,0,0,0,2,6,3,9760,4287,982,8055,0
32,536,2,2,2,0,0,0,2,0,0,0,0,0,0,0,0,0,0,0,0,2,6,3,9760,4287,982,8055,0
32,536,14,8,8,0,0,6,14,0,0,0,0,0,0,0,0,0,0,0,0,2,6,3,9760,4287,982,8056,0
32,536,6,4,4,0,0,2,6,0,0,0,0,0,0,0,0,0,0,0,0,2,6,3,9760,4287,982,8057,0
32,536,6,4,4,0,0,2,6,1,2,1,2,3,3,2,4,0,2,0,0,2,6,3,9760,4287,982,8058,0
32,536,6,4,4,0,0,2,6,0,0,0,0,0,0,0,0,0,0,0,0,2,6,3,9760,4287,982,8059,0
32,536,7,5,5,0,0,2,7,0,0,0,0,0,0,0,0,0,0,0,0,2,6,3,9760,4287,982,8060,0
32,536,6,4,4,0,0,2,6,0,0,0,0,0,0,0,0,0,0,0,0,2,6,3,9760,4287,982,8061,0
32,536,10,6,6,0,0,4,10,0,0,0,0,0,0,0,0,0,0,0,0,2,6,3,9760,4287,982,8062,0
32,536,1,1,1,0,0,0,1,0,0,0,0,0,0,0,0,0,0,0,0,2,6,3,9760,4287,982,8062,0
32,536,14,10,10,0,0,4,14,1,1,1,1,2,2,0,2,0,1,0,0,2,6,3,9760,4287,982,8063,0
32,536,46,26,30,3,0,12,49,3,6,3,6,9,9,20,28,1,42,2,0,2,6,3,9770,4287,982,8064,0
7,163,127,75,83,2,11,30,129,4,14,7,14,18,21,61,87,2,175,9,0,2,0,1,9770,4287,982,8065,0
7,163,652,304,544,16,6,88,668,6,89,51,101,95,152,591,998,3,3399,188,0,2,0,1,9770,4288,982,8066,0
7,163,2,2,2,0,0,0,2,0,0,0,0,0,0,0,0,0,0,0,0,2,0,1,9770,4288,982,8066,0
7,163,8,5,5,0,0,3,8,0,0,0,0,0,0,0,0,0,0,0,0,2,0,1,9770,4288,982,8067,0
7,163,2,2,2,0,0,0,2,0,0,0,0,0,0,0,0,0,0,0,0,2,0,1,9770,4288,982,8067,0
7,163,14,8,8,0,0,6,14,0,0,0,0,0,0,0,0,0,0,0,0,2,0,1,9770,4288,982,8068,0
7,163,6,4,4,0,0,2,6,0,0,0,0,0,0,0,0,0,0,0,0,2,0,1,9770,4288,982,8069,0
7,163,6,4,4,0,0,2,6,1,2,1,2,3,3,2,4,0,2,0,0,2,0,1,9770,4288,982,8070,0
7,163,6,4,4,0,0,2,6,0,0,0,0,0,0,0,0,0,0,0,0,2,0,1,9770,4288,982,8071,0
7,163,7,5,5,0,0,2,7,0,0,0,0,0,0,0,0,0,0,0,0,2,0,1,9770,4288,982,8072,0
7,163,6,4,4,0,0,2,6,0,0,0,0,0,0,0,0,0,0,0,0,2,0,1,9770,4288,982,8073,0
7,163,10,6,6,0,0,4,10,0,0,0,0,0,0,0,0,0,0,0,0,2,0,1,9770,4288,982,8074,0
7,163,1,1,1,0,0,0,1,0,0,0,0,0,0,0,0,0,0,0,0,2,0,1,9770,4288,982,8074,0
7,163,14,10,10,0,0,4,14,1,1,1,1,2,2,0,2,0,1,0,0,2,0,1,9770,4288,982,8075,0
7,163,46,26,30,3,0,12,49,3,6,3,6,9,9,20,28,1,42,2,0,2,0,1,9780,4288,982,8076,0
7,230,74,35,59,1,0,14,75,3,14,7,14,17,21,58,85,1,128,7,0,2,5,3,9780,4289,982,8077,0
50,2502,1943,715,1694,26,18,214,1969,12,185,120,237,197,357,1436,2721,7,20915,1161,0,2,2,2,9780,4291,982,8078,0
19,1151,1457,730,1242,11,6,188,1468,10,292,166,329,302,495,2424,4078,5,22973,1276,1,2,68,27,9780,4293,982,8079,0
17,775,334,251,279,10,4,40,344,5,127,74,143,132,217,899,1528,2,4303,239,0,2,4,2,9780,4294,982,8080,0
6,283,42,7,35,4,0,5,46,1,2,1,2,3,3,2,4,0,2,0,0,2,2,2,9780,4294,982,8081,1
6,283,11,6,10,0,0,1,11,2,4,2,4,6,6,10,15,1,15,0,0,2,2,2,9780,4294,982,8082,1
67,2915,384,251,317,7,8,52,391,11,70,44,84,81,128,467,811,6,5355,297,0,2,0,5,9780,4294,982,8083,0
33,844,74,35,59,1,0,14,75,3,14,7,14,17,21,58,85,1,128,7,0,2,1,1,9780,4295,982,8084,1
33,844,245,125,200,5,7,34,250,7,30,17,34,37,51,166,265,3,1053,58,0,2,1,1,9790,4296,982,8085,1
7,224,74,35,59,1,0,14,75,3,14,7,14,17,21,58,85,1,128,7,0,2,2,3,9790,4297,982,8086,1
68,2994,384,251,317,7,8,52,391,11,70,44,84,81,128,467,811,6,5355,297,0,2,12,0,9790,4297,982,8087,1
33,848,74,35,59,1,0,14,75,3,14,7,14,17,21,58,85,1,128,7,0,2,1,1,9790,4298,982,8088,0
33,848,245,125,200,5,7,34,250,7,30,17,34,37,51,166,265,3,1053,58,0,2,1,1,9800,4299,982,8089,0
138,2686,1943,715,1694,26,18,214,1969,12,185,120,237,197,357,1436,2721,7,20915,1161,0,2,23,7,9800,4301,982,8091,1
138,2686,1168,838,957,57,25,144,1225,19,348,224,416,367,640,3018,5452,11,61921,3440,1,2,23,7,9810,4303,982,8092,1
51,2576,1943,715,1694,26,18,214,1969,12,185,120,237,197,357,1436,2721,7,20915,1161,0,2,10,0,9810,4305,982,8093,1
1,36,2,2,2,0,0,0,2,0,0,0,0,0,0,0,0,0,0,0,0,2,1,1,9810,4305,982,8093,0
1,36,99,48,90,1,3,5,100,0,0,0,0,0,0,0,0,0,0,0,0,2,1,1,9810,4306,982,8094,0
1,36,8,5,5,2,0,1,10,0,0,0,0,0,0,0,0,0,0,0,0,2,1,1,9810,4306,982,8095,0
1,36,1217,716,841,84,126,174,1301,14,185,118,215,199,333,1446,2542,8,20687,1149,0,2,1,1,9820,4308,982,8096,0
1,36,160,89,115,0,13,31,160,7,15,11,17,22,28,78,124,3,495,27,0,2,1,1,9820,4308,982,8097,0
1,36,10,10,9,9,0,0,19,0,0,0,0,0,0,0,0,0,0,0,0,2,1,1,9820,4308,983,8098,0
1,36,173,84,99,8,29,36,181,5,12,7,13,17,20,54,81,2,221,12,0,2,1,1,9820,4309,983,8099,0
1,36,3,1,1,3,0,0,6,0,0,0,0,0,0,0,0,0,0,0,0,2,1,1,9820,4309,983,8100,0
6,283,42,7,35,4,0,5,46,1,2,1,2,3,3,2,4,0,2,0,0,2,2,2,9820,4309,983,8101,0
6,283,11,6,10,0,0,1,11,2,4,2,4,6,6,10,15,1,15,0,0,2,2,2,9820,4309,983,8102,0
46,442,647,139,84,35,284,233,682,0,0,0,0,0,0,0,0,0,0,0,0,2,17,16,9830,4310,983,8115,1
44,777,1020,354,843,12,15,144,1032,8,134,77,144,142,221,970,1580,4,6792,377,0,2,1,1,9830,4310,983,8116,1
191,4124,72,33,56,0,4,12,72,1,1,1,1,2,2,0,2,0,1,0,0,2,1,3,9830,4310,983,8117,1
191,4124,1454,835,1044,76,110,219,1530,17,275,158,296,292,454,2297,3718,9,34017,1889,1,2,1,3,9840,4311,983,8118,1
151,3042,373,158,315,8,0,51,381,5,76,44,79,81,123,486,779,2,2026,112,0,2,4,4,9840,4311,983,8119,1
69,1131,1178,367,1042,6,15,115,1184,9,94,51,95,103,146,644,976,4,4439,246,0,2,1,1,9840,4311,983,8120,1
69,1131,177,108,140,8,0,27,185,6,30,16,32,36,48,162,248,3,794,44,0,2,1,1,9840,4313,983,8121,1
138,2682,1943,715,1694,26,18,214,1969,12,185,120,237,197,357,1436,2721,7,20915,1161,0,2,7,7,9840,4315,983,8122,1
138,2682,1168,838,957,57,25,144,1225,19,348,224,416,367,640,3018,5452,11,61921,3440,1,2,7,7,9850,4317,983,8123,1
25,1029,373,158,315,8,0,51,381,5,76,44,79,81,123,486,779,2,2026,112,0,2,2,2,9850,4317,983,8124,1
50,2539,1943,715,1694,26,18,214,1969,12,185,120,237,197,357,1436,2721,7,20915,1161,0,2,10,11,9850,4319,983,8125,1
46,442,647,139,84,35,284,233,682,0,0,0,0,0,0,0,0,0,0,0,0,2,4,4,9850,4319,983,8126,1
150,3013,373,158,315,8,0,51,381,5,76,44,79,81,123,486,779,2,2026,112,0,2,37,44,9850,4319,983,8127,1
149,3000,373,158,315,8,0,51,381,5,76,44,79,81,123,486,779,2,2026,112,0,2,0,2,9850,4319,983,8128,0
68,2994,384,251,317,7,8,52,391,11,70,44,84,81,128,467,811,6,5355,297,0,2,4,4,9850,4319,983,8129,0
1,36,2,2,2,0,0,0,2,0,0,0,0,0,0,0,0,0,0,0,0,2,1,1,9850,4319,983,8129,1
1,36,99,48,90,1,3,5,100,0,0,0,0,0,0,0,0,0,0,0,0,2,1,1,9850,4320,983,8130,1
1,36,8,5,5,2,0,1,10,0,0,0,0,0,0,0,0,0,0,0,0,2,1,1,9850,4320,983,8131,1
1,36,1217,716,841,84,126,174,1301,14,185,118,215,199,333,1446,2542,8,20687,1149,0,2,1,1,9860,4322,983,8132,1
1,36,160,89,115,0,13,31,160,7,15,11,17,22,28,78,124,3,495,27,0,2,1,1,9860,4322,983,8133,1
1,36,10,10,9,9,0,0,19,0,0,0,0,0,0,0,0,0,0,0,0,2,1,1,9860,4322,984,8134,1
1,36,173,84,99,8,29,36,181,5,12,7,13,17,20,54,81,2,221,12,0,2,1,1,9860,4323,984,8135,1
1,36,3,1,1,3,0,0,6,0,0,0,0,0,0,0,0,0,0,0,0,2,1,1,9860,4323,984,8136,1
175,4016,722,423,573,19,0,135,741,12,172,101,199,184,300,1320,2257,6,15668,870,0,2,1,0,9860,4325,984,8138,1
175,4016,1508,847,911,44,250,301,1552,14,148,88,169,162,257,1120,1886,7,15077,837,0,2,1,0,9860,4326,985,8139,1
149,2995,373,158,315,8,0,51,381,5,76,44,79,81,123,486,779,2,2026,112,0,2,1,1,9860,4326,985,8140,1
6,283,42,7,35,4,0,5,46,1,2,1,2,3,3,2,4,0,2,0,0,2,1,1,9860,4326,985,8141,1
6,283,11,6,10,0,0,1,11,2,4,2,4,6,6,10,15,1,15,0,0,2,1,1,9860,4326,985,8142,1
1,36,2,2,2,0,0,0,2,0,0,0,0,0,0,0,0,0,0,0,0,2,1,1,9860,4326,985,8142,0
1,36,99,48,90,1,3,5,100,0,0,0,0,0,0,0,0,0,0,0,0,2,1,1,9860,4327,985,8143,0
1,36,8,5,5,2,0,1,10,0,0,0,0,0,0,0,0,0,0,0,0,2,1,1,9860,4327,985,8144,0
1,36,1217,716,841,84,126,174,1301,14,185,118,215,199,333,1446,2542,8,20687,1149,0,2,1,1,9870,4329,985,8145,0
1,36,160,89,115,0,13,31,160,7,15,11,17,22,28,78,124,3,495,27,0,2,1,1,9870,4329,985,8146,0
1,36,10,10,9,9,0,0,19,0,0,0,0,0,0,0,0,0,0,0,0,2,1,1,9870,4329,986,8147,0
1,36,173,84,99,8,29,36,181,5,12,7,13,17,20,54,81,2,221,12,0,2,1,1,9870,4330,986,8148,0
1,36,3,1,1,3,0,0,6,0,0,0,0,0,0,0,0,0,0,0,0,2,1,1,9870,4330,986,8149,0
135,2619,1457,730,1242,11,6,188,1468,10,292,166,329,302,495,2424,4078,5,22973,1276,1,2,2,1,9870,4332,986,8150,0
135,2619,74,35,59,1,0,14,75,3,14,7,14,17,21,58,85,1,128,7,0,2,2,1,9870,4333,986,8151,0
135,2619,245,125,200,5,7,34,250,7,30,17,34,37,51,166,265,3,1053,58,0,2,2,1,9880,4334,986,8152,0
6,283,42,7,35,4,0,5,46,1,2,1,2,3,3,2,4,0,2,0,0,2,1,1,9880,4334,986,8153,0
6,283,11,6,10,0,0,1,11,2,4,2,4,6,6,10,15,1,15,0,0,2,1,1,9880,4334,986,8154,0
21,1047,1289,550,1043,56,32,155,1345,10,167,93,185,177,278,1266,2075,5,11498,638,0,2,5,0,9880,4336,987,8155,0
20,1175,1457,730,1242,11,6,188,1468,10,292,166,329,302,495,2424,4078,5,22973,1276,1,2,3,0,9880,4338,987,8156,0
1,36,2,2,2,0,0,0,2,0,0,0,0,0,0,0,0,0,0,0,0,2,1,1,9880,4338,987,8156,1
1,36,99,48,90,1,3,5,100,0,0,0,0,0,0,0,0,0,0,0,0,2,1,1,9880,4339,987,8157,1
1,36,8,5,5,2,0,1,10,0,0,0,0,0,0,0,0,0,0,0,0,2,1,1,9880,4339,987,8158,1
1,36,1217,716,841,84,126,174,1301,14,185,118,215,199,333,1446,2542,8,20687,1149,0,2,1,1,9890,4341,987,8159,1
1,36,160,89,115,0,13,31,160,7,15,11,17,22,28,78,124,3,495,27,0,2,1,1,9890,4341,987,8160,1
1,36,10,10,9,9,0,0,19,0,0,0,0,0,0,0,0,0,0,0,0,2,1,1,9890,4341,988,8161,1
1,36,173,84,99,8,29,36,181,5,12,7,13,17,20,54,81,2,221,12,0,2,1,1,9890,4342,988,8162,1
1,36,3,1,1,3,0,0,6,0,0,0,0,0,0,0,0,0,0,0,0,2,1,1,9890,4342,988,8163,1
136,2631,1457,730,1242,11,6,188,1468,10,292,166,329,302,495,2424,4078,5,22973,1276,1,2,5,4,9890,4344,988,8164,1
136,2631,74,35,59,1,0,14,75,3,14,7,14,17,21,58,85,1,128,7,0,2,5,4,9890,4345,988,8165,1
136,2631,245,125,200,5,7,34,250,7,30,17,34,37,51,166,265,3,1053,58,0,2,5,4,9900,4346,988,8166,1
6,283,42,7,35,4,0,5,46,1,2,1,2,3,3,2,4,0,2,0,0,2,1,1,9900,4346,988,8167,1
6,283,11,6,10,0,0,1,11,2,4,2,4,6,6,10,15,1,15,0,0,2,1,1,9900,4346,988,8168,1
50,2539,1943,715,1694,26,18,214,1969,12,185,120,237,197,357,1436,2721,7,20915,1161,0,2,2,2,9900,4348,988,8169,1
20,1203,1457,730,1242,11,6,188,1468,10,292,166,329,302,495,2424,4078,5,22973,1276,1,2,5,1,9900,4350,988,8170,1
1,36,2,2,2,0,0,0,2,0,0,0,0,0,0,0,0,0,0,0,0,2,1,1,9900,4350,988,8170,0
1,36,99,48,90,1,3,5,100,0,0,0,0,0,0,0,0,0,0,0,0,2,1,1,9900,4351,988,8171,0
1,36,8,5,5,2,0,1,10,0,0,0,0,0,0,0,0,0,0,0,0,2,1,1,9900,4351,988,8172,0
1,36,1217,716,841,84,126,174,1301,14,185,118,215,199,333,1446,2542,8,20687,1149,0,2,1,1,9910,4353,988,8173,0
1,36,160,89,115,0,13,31,160,7,15,11,17,22,28,78,124,3,495,27,0,2,1,1,9910,4353,988,8174,0
1,36,10,10,9,9,0,0,19,0,0,0,0,0,0,0,0,0,0,0,0,2,1,1,9910,4353,989,8175,0
1,36,173,84,99,8,29,36,181,5,12,7,13,17,20,54,81,2,221,12,0,2,1,1,9910,4354,989,8176,0
1,36,3,1,1,3,0,0,6,0,0,0,0,0,0,0,0,0,0,0,0,2,1,1,9910,4354,989,8177,0
6,283,42,7,35,4,0,5,46,1,2,1,2,3,3,2,4,0,2,0,0,2,1,1,9910,4354,989,8178,0
6,283,11,6,10,0,0,1,11,2,4,2,4,6,6,10,15,1,15,0,0,2,1,1,9910,4354,989,8179,0
68,2996,384,251,317,7,8,52,391,11,70,44,84,81,128,467,811,6,5355,297,0,2,1,1,9910,4354,989,8180,0
1,36,2,2,2,0,0,0,2,0,0,0,0,0,0,0,0,0,0,0,0,2,1,1,9910,4354,989,8180,1
1,36,99,48,90,1,3,5,100,0,0,0,0,0,0,0,0,0,0,0,0,2,1,1,9910,4355,989,8181,1
1,36,8,5,5,2,0,1,10,0,0,0,0,0,0,0,0,0,0,0,0,2,1,1,9910,4355,989,8182,1
1,36,1217,716,841,84,126,174,1301,14,185,118,215,199,333,1446,2542,8,20687,1149,0,2,1,1,9920,4357,989,8183,1
1,36,160,89,115,0,13,31,160,7,15,11,17,22,28,78,124,3,495,27,0,2,1,1,9920,4357,989,8184,1
1,36,10,10,9,9,0,0,19,0,0,0,0,0,0,0,0,0,0,0,0,2,1,1,9920,4357,990,8185,1
1,36,173,84,99,8,29,36,181,5,12,7,13,17,20,54,81,2,221,12,0,2,1,1,9920,4358,990,8186,1
1,36,3,1,1,3,0,0,6,0,0,0,0,0,0,0,0,0,0,0,0,2,1,1,9920,4358,990,8187,1
191,4126,72,33,56,0,4,12,72,1,1,1,1,2,2,0,2,0,1,0,0,2,2,1,9920,4358,990,8188,1
191,4126,1454,835,1044,76,110,219,1530,17,275,158,296,292,454,2297,3718,9,34017,1889,1,2,2,1,9930,4359,990,8189,1
17,267,1098,241,925,5,10,155,1103,7,46,25,49,53,74,273,423,3,1580,87,0,2,22,42,9940,4361,990,8190,1
17,267,282,202,222,14,2,44,296,8,42,24,43,50,67,250,378,4,1548,86,0,2,22,42,9940,4362,990,8191,1
6,283,42,7,35,4,0,5,46,1,2,1,2,3,3,2,4,0,2,0,0,2,1,1,9940,4362,990,8192,1
6,283,11,6,10,0,0,1,11,2,4,2,4,6,6,10,15,1,15,0,0,2,1,1,9940,4362,990,8193,1
7,249,1098,241,925,5,10,155,1103,7,46,25,49,53,74,273,423,3,1580,87,0,2,22,0,9950,4364,990,8194,1
1,151,382,65,130,157,2,92,539,4,10,5,10,14,15,41,57,2,114,6,0,2,2,1,9950,4365,991,8195,1
136,2631,1457,730,1242,11,6,188,1468,10,292,166,329,302,495,2424,4078,5,22973,1276,1,2,3,2,9950,4367,991,8196,1
136,2631,74,35,59,1,0,14,75,3,14,7,14,17,21,58,85,1,128,7,0,2,3,2,9950,4368,991,8197,1
136,2631,245,125,200,5,7,34,250,7,30,17,34,37,51,166,265,3,1053,58,0,2,3,2,9960,4369,991,8198,1
50,2531,1943,715,1694,26,18,214,1969,12,185,120,237,197,357,1436,2721,7,20915,1161,0,2,0,1,9960,4371,991,8199,0
45,430,647,139,84,35,284,233,682,0,0,0,0,0,0,0,0,0,0,0,0,2,1,9,9960,4371,991,8200,1
17,295,424,94,331,4,0,89,428,1,5,5,5,6,10,11,25,0,12,0,0,2,0,13,9960,4372,991,8201,1
17,295,38,23,23,6,0,8,44,3,11,7,11,14,18,42,68,1,102,5,0,2,0,13,9960,4372,991,8202,1
193,4179,72,33,56,0,4,12,72,1,1,1,1,2,2,0,2,0,1,0,0,2,18,7,9960,4372,991,8203,1
193,4179,1454,835,1044,76,110,219,1530,17,275,158,296,292,454,2297,3718,9,34017,1889,1,2,18,7,9970,4373,991,8204,1
100,2387,1043,504,840,53,9,147,1096,9,180,112,198,189,310,1377,2344,4,11604,644,0,2,1,1,9970,4375,991,8205,1
100,2387,383,288,292,26,6,62,409,11,65,38,67,76,105,429,656,5,3719,206,0,2,1,1,9970,4376,991,8206,1
148,2983,373,158,315,8,0,51,381,5,76,44,79,81,123,486,779,2,2026,112,0,2,0,3,9970,4376,991,8207,1
23,990,373,158,315,8,0,51,381,5,76,44,79,81,123,486,779,2,2026,112,0,2,0,10,9970,4376,991,8208,1
50,2526,1943,715,1694,26,18,214,1969,12,185,120,237,197,357,1436,2721,7,20915,1161,0,2,1,1,9970,4378,991,8209,1
136,2682,1457,730,1242,11,6,188,1468,10,292,166,329,302,495,2424,4078,5,22973,1276,1,2,18,14,9970,4380,991,8210,1
136,2682,74,35,59,1,0,14,75,3,14,7,14,17,21,58,85,1,128,7,0,2,18,14,9970,4381,991,8211,1
136,2682,245,125,200,5,7,34,250,7,30,17,34,37,51,166,265,3,1053,58,0,2,18,14,9980,4382,991,8212,1
34,867,74,35,59,1,0,14,75,3,14,7,14,17,21,58,85,1,128,7,0,2,6,3,9980,4383,991,8213,1
34,867,245,125,200,5,7,34,250,7,30,17,34,37,51,166,265,3,1053,58,0,2,6,3,9990,4384,991,8214,1
148,2991,373,158,315,8,0,51,381,5,76,44,79,81,123,486,779,2,2026,112,0,2,11,12,9990,4384,991,8215,1
21,1272,1457,730,1242,11,6,188,1468,10,292,166,329,302,495,2424,4078,5,22973,1276,1,2,17,0,9990,4386,991,8216,1
1,148,382,65,130,157,2,92,539,4,10,5,10,14,15,41,57,2,114,6,0,2,1,1,9990,4387,992,8217,1
12,230,127,75,83,2,11,30,129,4,14,7,14,18,21,61,87,2,175,9,0,2,6,6,9990,4387,992,8218,1
12,230,652,304,544,16,6,88,668,6,89,51,101,95,152,591,998,3,3399,188,0,2,6,6,9990,4388,992,8219,1
12,230,2,2,2,0,0,0,2,0,0,0,0,0,0,0,0,0,0,0,0,2,6,6,9990,4388,992,8219,1
12,230,8,5,5,0,0,3,8,0,0,0,0,0,0,0,0,0,0,0,0,2,6,6,9990,4388,992,8220,1
12,230,2,2,2,0,0,0,2,0,0,0,0,0,0,0,0,0,0,0,0,2,6,6,9990,4388,992,8220,1
12,230,14,8,8,0,0,6,14,0,0,0,0,0,0,0,0,0,0,0,0,2,6,6,9990,4388,992,8221,1
12,230,6,4,4,0,0,2,6,0,0,0,0,0,0,0,0,0,0,0,0,2,6,6,9990,4388,992,8222,1
12,230,6,4,4,0,0,2,6,1,2,1,2,3,3,2,4,0,2,0,0,2,6,6,9990,4388,992,8223,1
12,230,6,4,4,0,0,2,6,0,0,0,0,0,0,0,0,0,0,0,0,2,6,6,9990,4388,992,8224,1
12,230,7,5,5,0,0,2,7,0,0,0,0,0,0,0,0,0,0,0,0,2,6,6,9990,4388,992,8225,1
12,230,6,4,4,0,0,2,6,0,0,0,0,0,0,0,0,0,0,0,0,2,6,6,9990,4388,992,8226,1
12,230,10,6,6,0,0,4,10,0,0,0,0,0,0,0,0,0,0,0,0,2,6,6,9990,4388,992,8227,1
12,230,1,1,1,0,0,0,1,0,0,0,0,0,0,0,0,0,0,0,0,2,6,6,9990,4388,992,8227,1
12,230,14,10,10,0,0,4,14,1,1,1,1,2,2,0,2,0,1,0,0,2,6,6,9990,4388,992,8228,1
12,230,46,26,30,3,0,12,49,3,6,3,6,9,9,20,28,1,42,2,0,2,6,6,10000,4388,992,8229,1
1,36,2,2,2,0,0,0,2,0,0,0,0,0,0,0,0,0,0,0,0,2,2,2,10000,4388,992,8229,1
1,36,99,48,90,1,3,5,100,0,0,0,0,0,0,0,0,0,0,0,0,2,2,2,10000,4389,992,8230,1
1,36,8,5,5,2,0,1,10,0,0,0,0,0,0,0,0,0,0,0,0,2,2,2,10000,4389,992,8231,1
1,36,1217,716,841,84,126,174,1301,14,185,118,215,199,333,1446,2542,8,20687,1149,0,2,2,2,10010,4391,992,8232,1
1,36,160,89,115,0,13,31,160,7,15,11,17,22,28,78,124,3,495,27,0,2,2,2,10010,4391,992,8233,1
1,36,10,10,9,9,0,0,19,0,0,0,0,0,0,0,0,0,0,0,0,2,2,2,10010,4391,993,8234,1
1,36,173,84,99,8,29,36,181,5,12,7,13,17,20,54,81,2,221,12,0,2,2,2,10010,4392,993,8235,1
1,36,3,1,1,3,0,0,6,0,0,0,0,0,0,0,0,0,0,0,0,2,2,2,10010,4392,993,8236,1
204,4492,72,33,56,0,4,12,72,1,1,1,1,2,2,0,2,0,1,0,0,2,79,7,10010,4392,993,8237,1
204,4492,1454,835,1044,76,110,219,1530,17,275,158,296,292,454,2297,3718,9,34017,1889,1,2,79,7,10020,4393,993,8238,1
87,1972,1043,504,840,53,9,147,1096,9,180,112,198,189,310,1377,2344,4,11604,644,0,2,5,104,10020,4395,993,8239,1
87,1972,383,288,292,26,6,62,409,11,65,38,67,76,105,429,656,5,3719,206,0,2,5,104,10020,4396,993,8240,1
148,3003,373,158,315,8,0,51,381,5,76,44,79,81,123,486,779,2,2026,112,0,2,8,7,10020,4396,993,8241,1
71,1178,1178,367,1042,6,15,115,1184,9,94,51,95,103,146,644,976,4,4439,246,0,2,14,142,10020,4396,993,8242,1
71,1178,177,108,140,8,0,27,185,6,30,16,32,36,48,162,248,3,794,44,0,2,14,142,10020,4398,993,8243,1
13,1148,215,129,180,6,0,29,221,8,65,43,72,73,115,415,711,4,3153,175,0,2,1,1,10020,4398,993,8244,1
36,1462,1043,504,840,53,9,147,1096,9,180,112,198,189,310,1377,2344,4,11604,644,0,2,0,55,10020,4400,993,8245,1
28,1387,1178,367,1042,6,15,115,1184,9,94,51,95,103,146,644,976,4,4439,246,0,2,1,1,10020,4400,993,8246,1
50,2526,1943,715,1694,26,18,214,1969,12,185,120,237,197,357,1436,2721,7,20915,1161,0,2,1,1,10020,4402,993,8247,1
138,2702,1457,730,1242,11,6,188,1468,10,292,166,329,302,495,2424,4078,5,22973,1276,1,2,6,2,10020,4404,993,8248,1
138,2702,74,35,59,1,0,14,75,3,14,7,14,17,21,58,85,1,128,7,0,2,6,2,10020,4405,993,8249,1
138,2702,245,125,200,5,7,34,250,7,30,17,34,37,51,166,265,3,1053,58,0,2,6,2,10030,4406,993,8250,1
22,1337,1457,730,1242,11,6,188,1468,10,292,166,329,302,495,2424,4078,5,22973,1276,1,2,18,0,10030,4408,993,8251,1
138,2713,1457,730,1242,11,6,188,1468,10,292,166,329,302,495,2424,4078,5,22973,1276,1,2,3,3,10030,4410,993,8252,0
138,2713,74,35,59,1,0,14,75,3,14,7,14,17,21,58,85,1,128,7,0,2,3,3,10030,4411,993,8253,0
138,2713,245,125,200,5,7,34,250,7,30,17,34,37,51,166,265,3,1053,58,0,2,3,3,10040,4412,993,8254,0
137,2714,1457,730,1242,11,6,188,1468,10,292,166,329,302,495,2424,4078,5,22973,1276,1,2,3,4,10040,4414,993,8255,1
137,2714,74,35,59,1,0,14,75,3,14,7,14,17,21,58,85,1,128,7,0,2,3,4,10040,4415,993,8256,1
137,2714,245,125,200,5,7,34,250,7,30,17,34,37,51,166,265,3,1053,58,0,2,3,4,10050,4416,993,8257,1
137,2686,1943,715,1694,26,18,214,1969,12,185,120,237,197,357,1436,2721,7,20915,1161,0,2,6,6,10050,4418,993,8258,1
137,2686,1168,838,957,57,25,144,1225,19,348,224,416,367,640,3018,5452,11,61921,3440,1,2,6,6,10060,4420,993,8259,1
51,2570,1943,715,1694,26,18,214,1969,12,185,120,237,197,357,1436,2721,7,20915,1161,0,2,13,5,10060,4422,993,8260,1
23,1388,1457,730,1242,11,6,188,1468,10,292,166,329,302,495,2424,4078,5,22973,1276,1,2,8,0,10060,4424,993,8261,1
72,3397,384,251,317,7,8,52,391,11,70,44,84,81,128,467,811,6,5355,297,0,2,66,1,10060,4424,993,8262,1
45,430,647,139,84,35,284,233,682,0,0,0,0,0,0,0,0,0,0,0,0,2,1,1,10070,4428,994,8271,1
125,2558,77,34,69,0,0,8,77,3,24,16,29,27,45,114,213,1,387,21,0,3,22,7,10070,4428,994,8272,1
125,2558,712,438,573,51,9,84,763,14,102,71,128,116,199,733,1364,8,11988,666,0,3,22,7,10080,4429,994,8273,1
137,2714,1457,730,1242,11,6,188,1468,10,292,166,329,302,495,2424,4078,5,22973,1276,1,2,1,1,10080,4431,994,8274,1
137,2714,74,35,59,1,0,14,75,3,14,7,14,17,21,58,85,1,128,7,0,2,1,1,10080,4432,994,8275,1
137,2714,245,125,200,5,7,34,250,7,30,17,34,37,51,166,265,3,1053,58,0,2,1,1,10090,4433,994,8276,1
177,4051,722,423,573,19,0,135,741,12,172,101,199,184,300,1320,2257,6,15668,870,0,2,6,2,10090,4435,994,8278,1
177,4051,1508,847,911,44,250,301,1552,14,148,88,169,162,257,1120,1886,7,15077,837,0,2,6,2,10090,4436,995,8279,1
204,4492,72,33,56,0,4,12,72,1,1,1,1,2,2,0,2,0,1,0,0,2,1,1,10090,4436,995,8280,1
204,4492,1454,835,1044,76,110,219,1530,17,275,158,296,292,454,2297,3718,9,34017,1889,1,2,1,1,10100,4437,995,8281,1
6,283,42,7,35,4,0,5,46,1,2,1,2,3,3,2,4,0,2,0,0,2,2,2,10100,4437,995,8282,1
6,283,11,6,10,0,0,1,11,2,4,2,4,6,6,10,15,1,15,0,0,2,2,2,10100,4437,995,8283,1
28,1309,1289,550,1043,56,32,155,1345,10,167,93,185,177,278,1266,2075,5,11498,638,0,2,81,44,10100,4439,996,8284,1
7,163,127,75,83,2,11,30,129,4,14,7,14,18,21,61,87,2,175,9,0,2,1,1,10100,4439,996,8285,1
7,163,652,304,544,16,6,88,668,6,89,51,101,95,152,591,998,3,3399,188,0,2,1,1,10100,4440,996,8286,1
7,163,2,2,2,0,0,0,2,0,0,0,0,0,0,0,0,0,0,0,0,2,1,1,10100,4440,996,8286,1
7,163,8,5,5,0,0,3,8,0,0,0,0,0,0,0,0,0,0,0,0,2,1,1,10100,4440,996,8287,1
7,163,2,2,2,0,0,0,2,0,0,0,0,0,0,0,0,0,0,0,0,2,1,1,10100,4440,996,8287,1
7,163,14,8,8,0,0,6,14,0,0,0,0,0,0,0,0,0,0,0,0,2,1,1,10100,4440,996,8288,1
7,163,6,4,4,0,0,2,6,0,0,0,0,0,0,0,0,0,0,0,0,2,1,1,10100,4440,996,8289,1
7,163,6,4,4,0,0,2,6,1,2,1,2,3,3,2,4,0,2,0,0,2,1,1,10100,4440,996,8290,1
7,163,6,4,4,0,0,2,6,0,0,0,0,0,0,0,0,0,0,0,0,2,1,1,10100,4440,996,8291,1
7,163,7,5,5,0,0,2,7,0,0,0,0,0,0,0,0,0,0,0,0,2,1,1,10100,4440,996,8292,1
7,163,6,4,4,0,0,2,6,0,0,0,0,0,0,0,0,0,0,0,0,2,1,1,10100,4440,996,8293,1
7,163,10,6,6,0,0,4,10,0,0,0,0,0,0,0,0,0,0,0,0,2,1,1,10100,4440,996,8294,1
7,163,1,1,1,0,0,0,1,0,0,0,0,0,0,0,0,0,0,0,0,2,1,1,10100,4440,996,8294,1
7,163,14,10,10,0,0,4,14,1,1,1,1,2,2,0,2,0,1,0,0,2,1,1,10100,4440,996,8295,1
7,163,46,26,30,3,0,12,49,3,6,3,6,9,9,20,28,1,42,2,0,2,1,1,10110,4440,996,8296,1
10,500,722,423,573,19,0,135,741,12,172,101,199,184,300,1320,2257,6,15668,870,0,2,2,2,10110,4442,996,8298,1
72,3397,77,34,69,0,0,8,77,3,24,16,29,27,45,114,213,1,387,21,0,3,5,5,10110,4442,996,8299,1
126,2604,77,34,69,0,0,8,77,3,24,16,29,27,45,114,213,1,387,21,0,2,10,5,10110,4442,996,8300,1
126,2604,712,438,573,51,9,84,763,14,102,71,128,116,199,733,1364,8,11988,666,0,2,10,5,10120,4443,996,8301,1
74,3546,77,34,69,0,0,8,77,3,24,16,29,27,45,114,213,1,387,21,0,2,25,3,10120,4443,996,8302,1
45,428,647,139,84,35,284,233,682,0,0,0,0,0,0,0,0,0,0,0,0,2,1,1,10130,4447,997,8310,1
128,2662,77,34,69,0,0,8,77,3,24,16,29,27,45,114,213,1,387,21,0,2,12,3,10130,4447,997,8311,1
128,2662,712,438,573,51,9,84,763,14,102,71,128,116,199,733,1364,8,11988,666,0,2,12,3,10140,4448,997,8312,1
65,1174,1513,682,1277,25,13,200,1538,11,199,116,219,210,335,1557,2584,6,15641,868,0,2,5,1,10140,4450,997,8313,1
65,1174,819,519,539,24,98,155,843,15,96,57,106,111,163,690,1107,8,9171,509,0,2,5,1,10150,4452,997,8314,1
137,2716,1457,730,1242,11,6,188,1468,10,292,166,329,302,495,2424,4078,5,22973,1276,1,2,1,1,10150,4454,997,8315,1
137,2716,74,35,59,1,0,14,75,3,14,7,14,17,21,58,85,1,128,7,0,2,1,1,10150,4455,997,8316,1
137,2716,245,125,200,5,7,34,250,7,30,17,34,37,51,166,265,3,1053,58,0,2,1,1,10160,4456,997,8317,1
16,578,1455,414,1257,16,76,112,1471,5,41,23,46,46,69,231,381,2,1069,59,0,2,1,1,10160,4457,997,8318,1
16,578,669,365,481,22,61,110,691,15,103,63,122,118,185,747,1273,8,11311,628,0,2,1,1,10170,4457,998,8319,1
37,1041,1523,757,1297,19,12,193,1542,12,193,117,230,205,347,1508,2664,7,19053,1058,0,2,4,1,10180,4459,998,8320,1
37,1041,701,378,504,33,58,109,734,13,110,68,126,123,194,794,1346,7,10027,557,0,2,4,1,10180,4460,999,8321,1
177,4149,722,423,573,19,0,135,741,12,172,101,199,184,300,1320,2257,6,15668,870,0,2,30,17,10180,4462,999,8323,1
177,4149,1508,847,911,44,250,301,1552,14,148,88,169,162,257,1120,1886,7,15077,837,0,2,30,17,10180,4463,1000,8324,1
205,4488,72,33,56,0,4,12,72,1,1,1,1,2,2,0,2,0,1,0,0,2,9,8,10180,4463,1000,8325,1
205,4488,1454,835,1044,76,110,219,1530,17,275,158,296,292,454,2297,3718,9,34017,1889,1,2,9,8,10190,4464,1000,8326,1
84,1800,1043,504,840,53,9,147,1096,9,180,112,198,189,310,1377,2344,4,11604,644,0,2,19,53,10190,4466,1000,8327,1
84,1800,383,288,292,26,6,62,409,11,65,38,67,76,105,429,656,5,3719,206,0,2,19,53,10190,4467,1000,8328,1
125,2880,373,158,315,8,0,51,381,5,76,44,79,81,123,486,779,2,2026,112,0,2,191,214,10190,4467,1000,8329,1
137,2668,1943,715,1694,26,18,214,1969,12,185,120,237,197,357,1436,2721,7,20915,1161,0,2,6,5,10190,4469,1000,8330,1
137,2668,1168,838,957,57,25,144,1225,19,348,224,416,367,640,3018,5452,11,61921,3440,1,2,6,5,10200,4471,1000,8331,1
6,283,42,7,35,4,0,5,46,1,2,1,2,3,3,2,4,0,2,0,0,2,2,2,10200,4471,1000,8332,1
6,283,11,6,10,0,0,1,11,2,4,2,4,6,6,10,15,1,15,0,0,2,2,2,10200,4471,1000,8333,1
30,1389,1289,550,1043,56,32,155,1345,10,167,93,185,177,278,1266,2075,5,11498,638,0,2,24,5,10200,4473,1001,8334,1
19,1390,1523,757,1297,19,12,193,1542,12,193,117,230,205,347,1508,2664,7,19053,1058,0,2,24,10,10210,4475,1001,8335,1
36,1466,1043,504,840,53,9,147,1096,9,180,112,198,189,310,1377,2344,4,11604,644,0,2,2,2,10210,4477,1001,8336,1
23,996,373,158,315,8,0,51,381,5,76,44,79,81,123,486,779,2,2026,112,0,2,6,5,10210,4477,1001,8337,1
51,2570,1943,715,1694,26,18,214,1969,12,185,120,237,197,357,1436,2721,7,20915,1161,0,2,3,8,10210,4479,1001,8338,1
40,2822,1296,573,1062,40,33,157,1336,8,201,118,231,209,349,1561,2689,4,12365,686,0,2,345,114,10210,4479,1001,8339,1
23,1388,1457,730,1242,11,6,188,1468,10,292,166,329,302,495,2424,4078,5,22973,1276,1,2,1,1,10210,4481,1001,8340,1
1,149,382,65,130,157,2,92,539,4,10,5,10,14,15,41,57,2,114,6,0,2,2,2,10210,4482,1002,8341,1
44,888,1450,624,1228,12,26,181,1462,14,306,186,354,320,540,2580,4493,8,36391,2021,1,2,3,0,10210,4484,1003,8342,1
65,1174,1513,682,1277,25,13,200,1538,11,199,116,219,210,335,1557,2584,6,15641,868,0,2,1,3,10210,4486,1003,8343,1
65,1174,819,519,539,24,98,155,843,15,96,57,106,111,163,690,1107,8,9171,509,0,2,1,3,10220,4488,1003,8344,1
137,2717,1457,730,1242,11,6,188,1468,10,292,166,329,302,495,2424,4078,5,22973,1276,1,2,1,1,10220,4490,1003,8345,1
137,2717,74,35,59,1,0,14,75,3,14,7,14,17,21,58,85,1,128,7,0,2,1,1,10220,4491,1003,8346,1
137,2717,245,125,200,5,7,34,250,7,30,17,34,37,51,166,265,3,1053,58,0,2,1,1,10230,4492,1003,8347,1
16,578,1455,414,1257,16,76,112,1471,5,41,23,46,46,69,231,381,2,1069,59,0,2,1,1,10230,4493,1003,8348,1
16,578,669,365,481,22,61,110,691,15,103,63,122,118,185,747,1273,8,11311,628,0,2,1,1,10240,4493,1004,8349,1
34,867,74,35,59,1,0,14,75,3,14,7,14,17,21,58,85,1,128,7,0,2,1,2,10240,4494,1004,8350,1
34,867,245,125,200,5,7,34,250,7,30,17,34,37,51,166,265,3,1053,58,0,2,1,2,10250,4495,1004,8351,1
37,1041,1523,757,1297,19,12,193,1542,12,193,117,230,205,347,1508,2664,7,19053,1058,0,2,3,2,10260,4497,1004,8352,1
37,1041,701,378,504,33,58,109,734,13,110,68,126,123,194,794,1346,7,10027,557,0,2,3,2,10260,4498,1005,8353,1
44,777,1020,354,843,12,15,144,1032,8,134,77,144,142,221,970,1580,4,6792,377,0,2,3,3,10260,4498,1005,8354,1
24,514,447,308,343,6,5,95,453,7,96,59,111,103,170,651,1136,4,4600,255,0,2,1,1,10260,4501,1005,8355,1
24,514,322,174,179,16,74,51,338,10,41,26,46,51,72,252,408,5,2291,127,0,2,1,1,10260,4504,1006,8356,1
17,295,424,94,331,4,0,89,428,1,5,5,5,6,10,11,25,0,12,0,0,2,1,35,10260,4505,1006,8357,1
17,295,38,23,23,6,0,8,44,3,11,7,11,14,18,42,68,1,102,5,0,2,1,35,10260,4505,1006,8358,1
20,483,1293,570,1093,25,15,163,1318,10,195,123,241,205,364,1516,2795,6,17273,959,0,2,2,3,10270,4507,1006,8359,1
177,4149,722,423,573,19,0,135,741,12,172,101,199,184,300,1320,2257,6,15668,870,0,2,1,3,10270,4509,1006,8361,1
177,4149,1508,847,911,44,250,301,1552,14,148,88,169,162,257,1120,1886,7,15077,837,0,2,1,3,10270,4510,1007,8362,1
205,4488,72,33,56,0,4,12,72,1,1,1,1,2,2,0,2,0,1,0,0,2,1,3,10270,4510,1007,8363,1
205,4488,1454,835,1044,76,110,219,1530,17,275,158,296,292,454,2297,3718,9,34017,1889,1,2,1,3,10280,4511,1007,8364,1
18,462,386,256,301,16,9,68,402,4,59,35,69,63,104,355,621,2,1453,80,0,2,1,1,10280,4511,1007,8365,1
18,462,264,131,164,11,41,46,275,6,38,22,40,44,62,214,338,3,1068,59,0,2,1,1,10290,4511,1008,8366,1
26,554,215,129,180,6,0,29,221,8,65,43,72,73,115,415,711,4,3153,175,0,2,1,1,10290,4511,1008,8367,1
26,554,97,69,77,3,3,16,100,6,22,13,23,28,36,113,173,3,542,30,0,2,1,1,10290,4512,1008,8368,1
84,1800,1043,504,840,53,9,147,1096,9,180,112,198,189,310,1377,2344,4,11604,644,0,2,4,5,10290,4514,1008,8369,1
84,1800,383,288,292,26,6,62,409,11,65,38,67,76,105,429,656,5,3719,206,0,2,4,5,10290,4515,1008,8370,1
125,2880,373,158,315,8,0,51,381,5,76,44,79,81,123,486,779,2,2026,112,0,2,3,7,10290,4515,1008,8371,1
71,1178,1178,367,1042,6,15,115,1184,9,94,51,95,103,146,644,976,4,4439,246,0,2,1,3,10290,4515,1008,8372,1
71,1178,177,108,140,8,0,27,185,6,30,16,32,36,48,162,248,3,794,44,0,2,1,3,10290,4517,1008,8373,1
137,2668,1943,715,1694,26,18,214,1969,12,185,120,237,197,357,1436,2721,7,20915,1161,0,2,1,2,10290,4519,1008,8374,1
137,2668,1168,838,957,57,25,144,1225,19,348,224,416,367,640,3018,5452,11,61921,3440,1,2,1,2,10300,4521,1008,8375,1
3,88,442,244,305,14,16,103,456,11,68,45,75,79,120,452,756,6,4588,254,0,2,1,10,10300,4523,1008,8376,1
3,88,182,102,99,11,40,35,193,3,11,6,11,14,17,42,64,1,97,5,0,2,1,10,10300,4524,1008,8377,1
17,267,1098,241,925,5,10,155,1103,7,46,25,49,53,74,273,423,3,1580,87,0,2,1,3,10310,4526,1008,8378,1
17,267,282,202,222,14,2,44,296,8,42,24,43,50,67,250,378,4,1548,86,0,2,1,3,10310,4527,1008,8379,1
129,2662,77,34,69,0,0,8,77,3,24,16,29,27,45,114,213,1,387,21,0,2,5,4,10310,4527,1008,8380,0
129,2662,712,438,573,51,9,84,763,14,102,71,128,116,199,733,1364,8,11988,666,0,2,5,4,10320,4528,1008,8381,0
130,2666,77,34,69,0,0,8,77,3,24,16,29,27,45,114,213,1,387,21,0,2,6,4,10320,4528,1008,8382,0
130,2666,712,438,573,51,9,84,763,14,102,71,128,116,199,733,1364,8,11988,666,0,2,6,4,10330,4529,1008,8383,0
75,3605,77,34,69,0,0,8,77,3,24,16,29,27,45,114,213,1,387,21,0,2,13,5,10330,4529,1008,8384,0
130,2674,77,34,69,0,0,8,77,3,24,16,29,27,45,114,213,1,387,21,0,2,1,1,10330,4529,1008,8385,0
130,2674,712,438,573,51,9,84,763,14,102,71,128,116,199,733,1364,8,11988,666,0,2,1,1,10340,4530,1008,8386,0
205,4488,72,33,56,0,4,12,72,1,1,1,1,2,2,0,2,0,1,0,0,2,2,2,10350,4534,1009,8394,1
205,4488,1454,835,1044,76,110,219,1530,17,275,158,296,292,454,2297,3718,9,34017,1889,1,2,2,2,10360,4535,1009,8395,1
130,2988,373,158,315,8,0,51,381,5,76,44,79,81,123,486,779,2,2026,112,0,2,20,1,10360,4535,1009,8396,1
6,283,42,7,35,4,0,5,46,1,2,1,2,3,3,2,4,0,2,0,0,2,1,1,10360,4535,1009,8397,1
6,283,11,6,10,0,0,1,11,2,4,2,4,6,6,10,15,1,15,0,0,2,1,1,10360,4535,1009,8398,1
32,1512,1289,550,1043,56,32,155,1345,10,167,93,185,177,278,1266,2075,5,11498,638,0,2,21,0,10360,4537,1010,8399,1
132,2708,77,34,69,0,0,8,77,3,24,16,29,27,45,114,213,1,387,21,0,2,5,1,10360,4537,1010,8400,1
132,2708,712,438,573,51,9,84,763,14,102,71,128,116,199,733,1364,8,11988,666,0,2,5,1,10370,4538,1010,8401,1
43,866,1450,624,1228,12,26,181,1462,14,306,186,354,320,540,2580,4493,8,36391,2021,1,2,6,9,10370,4540,1011,8402,1
206,4499,72,33,56,0,4,12,72,1,1,1,1,2,2,0,2,0,1,0,0,2,3,0,10370,4540,1011,8403,1
206,4499,1454,835,1044,76,110,219,1530,17,275,158,296,292,454,2297,3718,9,34017,1889,1,2,3,0,10380,4541,1011,8404,1
17,270,1098,241,925,5,10,155,1103,7,46,25,49,53,74,273,423,3,1580,87,0,2,5,4,10390,4543,1011,8405,1
17,270,282,202,222,14,2,44,296,8,42,24,43,50,67,250,378,4,1548,86,0,2,5,4,10390,4544,1011,8406,1
33,1559,1289,550,1043,56,32,155,1345,10,167,93,185,177,278,1266,2075,5,11498,638,0,2,16,0,10390,4546,1012,8407,1
27,949,1450,624,1228,12,26,181,1462,14,306,186,354,320,540,2580,4493,8,36391,2021,1,2,9,0,10390,4548,1013,8408,1
131,3030,373,158,315,8,0,51,381,5,76,44,79,81,123,486,779,2,2026,112,0,2,11,6,10390,4548,1013,8409,1
33,1567,1289,550,1043,56,32,155,1345,10,167,93,185,177,278,1266,2075,5,11498,638,0,2,2,1,10390,4550,1014,8410,1
26,920,1450,624,1228,12,26,181,1462,14,306,186,354,320,540,2580,4493,8,36391,2021,1,2,0,9,10390,4552,1015,8411,1
41,2892,1296,573,1062,40,33,157,1336,8,201,118,231,209,349,1561,2689,4,12365,686,0,2,13,0,10390,4552,1015,8412,1
139,2720,1457,730,1242,11,6,188,1468,10,292,166,329,302,495,2424,4078,5,22973,1276,1,2,1,1,10390,4554,1015,8413,0
139,2720,74,35,59,1,0,14,75,3,14,7,14,17,21,58,85,1,128,7,0,2,1,1,10390,4555,1015,8414,0
139,2720,245,125,200,5,7,34,250,7,30,17,34,37,51,166,265,3,1053,58,0,2,1,1,10400,4556,1015,8415,0
33,1569,1289,550,1043,56,32,155,1345,10,167,93,185,177,278,1266,2075,5,11498,638,0,2,1,1,10400,4558,1016,8416,0
132,2720,77,34,69,0,0,8,77,3,24,16,29,27,45,114,213,1,387,21,0,2,5,2,10400,4558,1016,8417,0
132,2720,712,438,573,51,9,84,763,14,102,71,128,116,199,733,1364,8,11988,666,0,2,5,2,10410,4559,1016,8418,0
131,3034,373,158,315,8,0,51,381,5,76,44,79,81,123,486,779,2,2026,112,0,2,1,1,10410,4559,1016,8419,0
19,284,1098,241,925,5,10,155,1103,7,46,25,49,53,74,273,423,3,1580,87,0,2,4,0,10420,4561,1016,8420,0
19,284,282,202,222,14,2,44,296,8,42,24,43,50,67,250,378,4,1548,86,0,2,4,0,10420,4562,1016,8421,0
33,1595,1289,550,1043,56,32,155,1345,10,167,93,185,177,278,1266,2075,5,11498,638,0,2,6,1,10420,4564,1017,8422,0
41,2882,1296,573,1062,40,33,157,1336,8,201,118,231,209,349,1561,2689,4,12365,686,0,2,0,2,10420,4564,1017,8423,0
24,1442,1457,730,1242,11,6,188,1468,10,292,166,329,302,495,2424,4078,5,22973,1276,1,2,11,0,10420,4566,1017,8424,0
131,3031,373,158,315,8,0,51,381,5,76,44,79,81,123,486,779,2,2026,112,0,2,1,1,10420,4566,1017,8425,1
6,283,42,7,35,4,0,5,46,1,2,1,2,3,3,2,4,0,2,0,0,2,1,1,10430,4570,1018,8433,0
6,283,11,6,10,0,0,1,11,2,4,2,4,6,6,10,15,1,15,0,0,2,1,1,10430,4570,1018,8434,0
33,1606,1289,550,1043,56,32,155,1345,10,167,93,185,177,278,1266,2075,5,11498,638,0,2,1,0,10430,4572,1019,8435,0
6,283,42,7,35,4,0,5,46,1,2,1,2,3,3,2,4,0,2,0,0,2,1,1,10440,4576,1020,8443,0
6,283,11,6,10,0,0,1,11,2,4,2,4,6,6,10,15,1,15,0,0,2,1,1,10440,4576,1020,8444,0
45,430,647,139,84,35,284,233,682,0,0,0,0,0,0,0,0,0,0,0,0,2,5,5,10450,4580,1021,8452,1
177,4149,722,423,573,19,0,135,741,12,172,101,199,184,300,1320,2257,6,15668,870,0,2,13,13,10450,4582,1021,8454,1
177,4149,1508,847,911,44,250,301,1552,14,148,88,169,162,257,1120,1886,7,15077,837,0,2,13,13,10450,4583,1022,8455,1
206,4499,72,33,56,0,4,12,72,1,1,1,1,2,2,0,2,0,1,0,0,2,9,9,10450,4583,1022,8456,1
206,4499,1454,835,1044,76,110,219,1530,17,275,158,296,292,454,2297,3718,9,34017,1889,1,2,9,9,10460,4584,1022,8457,1
138,3144,373,158,315,8,0,51,381,5,76,44,79,81,123,486,779,2,2026,112,0,2,40,22,10460,4584,1022,8458,1
138,2675,1943,715,1694,26,18,214,1969,12,185,120,237,197,357,1436,2721,7,20915,1161,0,2,3,2,10460,4586,1022,8459,1
138,2675,1168,838,957,57,25,144,1225,19,348,224,416,367,640,3018,5452,11,61921,3440,1,2,3,2,10470,4588,1022,8460,1
6,283,42,7,35,4,0,5,46,1,2,1,2,3,3,2,4,0,2,0,0,2,1,1,10470,4588,1022,8461,1
6,283,11,6,10,0,0,1,11,2,4,2,4,6,6,10,15,1,15,0,0,2,1,1,10470,4588,1022,8462,1
13,1148,215,129,180,6,0,29,221,8,65,43,72,73,115,415,711,4,3153,175,0,2,4,4,10470,4588,1022,8463,1
36,1466,1043,504,840,53,9,147,1096,9,180,112,198,189,310,1377,2344,4,11604,644,0,2,1,1,10470,4590,1022,8464,1
51,2570,1943,715,1694,26,18,214,1969,12,185,120,237,197,357,1436,2721,7,20915,1161,0,2,1,1,10470,4592,1022,8465,1
41,2894,1296,573,1062,40,33,157,1336,8,201,118,231,209,349,1561,2689,4,12365,686,0,2,14,13,10470,4592,1022,8466,1
37,1039,1523,757,1297,19,12,193,1542,12,193,117,230,205,347,1508,2664,7,19053,1058,0,2,1,1,10480,4594,1022,8467,1
37,1039,701,378,504,33,58,109,734,13,110,68,126,123,194,794,1346,7,10027,557,0,2,1,1,10480,4595,1023,8468,1
206,4499,72,33,56,0,4,12,72,1,1,1,1,2,2,0,2,0,1,0,0,2,1,0,10480,4595,1023,8469,1
206,4499,1454,835,1044,76,110,219,1530,17,275,158,296,292,454,2297,3718,9,34017,1889,1,2,1,0,10490,4596,1023,8470,1
130,3030,373,158,315,8,0,51,381,5,76,44,79,81,123,486,779,2,2026,112,0,2,11,30,10490,4596,1023,8471,1
133,2756,77,34,69,0,0,8,77,3,24,16,29,27,45,114,213,1,387,21,0,2,5,0,10490,4596,1023,8472,1
133,2756,712,438,573,51,9,84,763,14,102,71,128,116,199,733,1364,8,11988,666,0,2,5,0,10500,4597,1023,8473,1
141,2754,1457,730,1242,11,6,188,1468,10,292,166,329,302,495,2424,4078,5,22973,1276,1,2,16,11,10500,4599,1023,8474,1
141,2754,74,35,59,1,0,14,75,3,14,7,14,17,21,58,85,1,128,7,0,2,16,11,10500,4600,1023,8475,1
141,2754,245,125,200,5,7,34,250,7,30,17,34,37,51,166,265,3,1053,58,0,2,16,11,10510,4601,1023,8476,1
34,866,74,35,59,1,0,14,75,3,14,7,14,17,21,58,85,1,128,7,0,2,2,1,10510,4602,1023,8477,1
34,866,245,125,200,5,7,34,250,7,30,17,34,37,51,166,265,3,1053,58,0,2,2,1,10520,4603,1023,8478,1
51,2564,1943,715,1694,26,18,214,1969,12,185,120,237,197,357,1436,2721,7,20915,1161,0,2,0,1,10520,4605,1023,8479,1
26,1597,1457,730,1242,11,6,188,1468,10,292,166,329,302,495,2424,4078,5,22973,1276,1,2,24,0,10520,4607,1023,8480,1
6,283,42,7,35,4,0,5,46,1,2,1,2,3,3,2,4,0,2,0,0,2,1,1,10530,4611,1024,8488,0
6,283,11,6,10,0,0,1,11,2,4,2,4,6,6,10,15,1,15,0,0,2,1,1,10530,4611,1024,8489,0
133,2758,77,34,69,0,0,8,77,3,24,16,29,27,45,114,213,1,387,21,0,2,2,2,10530,4611,1024,8490,0
133,2758,712,438,573,51,9,84,763,14,102,71,128,116,199,733,1364,8,11988,666,0,2,2,2,10540,4612,1024,8491,0
19,1390,1523,757,1297,19,12,193,1542,12,193,117,230,205,347,1508,2664,7,19053,1058,0,2,1,0,10550,4614,1024,8492,0
177,4157,722,423,573,19,0,135,741,12,172,101,199,184,300,1320,2257,6,15668,870,0,2,1,1,10550,4616,1024,8494,0
177,4157,1508,847,911,44,250,301,1552,14,148,88,169,162,257,1120,1886,7,15077,837,0,2,1,1,10550,4617,1025,8495,0
12,222,127,75,83,2,11,30,129,4,14,7,14,18,21,61,87,2,175,9,0,2,2,2,10550,4617,1025,8496,1
12,222,652,304,544,16,6,88,668,6,89,51,101,95,152,591,998,3,3399,188,0,2,2,2,10550,4618,1025,8497,1
12,222,2,2,2,0,0,0,2,0,0,0,0,0,0,0,0,0,0,0,0,2,2,2,10550,4618,1025,8497,1
12,222,8,5,5,0,0,3,8,0,0,0,0,0,0,0,0,0,0,0,0,2,2,2,10550,4618,1025,8498,1
12,222,2,2,2,0,0,0,2,0,0,0,0,0,0,0,0,0,0,0,0,2,2,2,10550,4618,1025,8498,1
12,222,14,8,8,0,0,6,14,0,0,0,0,0,0,0,0,0,0,0,0,2,2,2,10550,4618,1025,8499,1
12,222,6,4,4,0,0,2,6,0,0,0,0,0,0,0,0,0,0,0,0,2,2,2,10550,4618,1025,8500,1
12,222,6,4,4,0,0,2,6,1,2,1,2,3,3,2,4,0,2,0,0,2,2,2,10550,4618,1025,8501,1
12,222,6,4,4,0,0,2,6,0,0,0,0,0,0,0,0,0,0,0,0,2,2,2,10550,4618,1025,8502,1
12,222,7,5,5,0,0,2,7,0,0,0,0,0,0,0,0,0,0,0,0,2,2,2,10550,4618,1025,8503,1
12,222,6,4,4,0,0,2,6,0,0,0,0,0,0,0,0,0,0,0,0,2,2,2,10550,4618,1025,8504,1
12,222,10,6,6,0,0,4,10,0,0,0,0,0,0,0,0,0,0,0,0,2,2,2,10550,4618,1025,8505,1
12,222,1,1,1,0,0,0,1,0,0,0,0,0,0,0,0,0,0,0,0,2,2,2,10550,4618,1025,8505,1
12,222,14,10,10,0,0,4,14,1,1,1,1,2,2,0,2,0,1,0,0,2,2,2,10550,4618,1025,8506,1
12,222,46,26,30,3,0,12,49,3,6,3,6,9,9,20,28,1,42,2,0,2,2,2,10560,4618,1025,8507,1
4,76,127,75,83,2,11,30,129,4,14,7,14,18,21,61,87,2,175,9,0,2,2,2,10560,4618,1025,8508,1
4,76,652,304,544,16,6,88,668,6,89,51,101,95,152,591,998,3,3399,188,0,2,2,2,10560,4619,1025,8509,1
4,76,2,2,2,0,0,0,2,0,0,0,0,0,0,0,0,0,0,0,0,2,2,2,10560,4619,1025,8509,1
4,76,8,5,5,0,0,3,8,0,0,0,0,0,0,0,0,0,0,0,0,2,2,2,10560,4619,1025,8510,1
4,76,2,2,2,0,0,0,2,0,0,0,0,0,0,0,0,0,0,0,0,2,2,2,10560,4619,1025,8510,1
4,76,14,8,8,0,0,6,14,0,0,0,0,0,0,0,0,0,0,0,0,2,2,2,10560,4619,1025,8511,1
4,76,6,4,4,0,0,2,6,0,0,0,0,0,0,0,0,0,0,0,0,2,2,2,10560,4619,1025,8512,1
4,76,6,4,4,0,0,2,6,1,2,1,2,3,3,2,4,0,2,0,0,2,2,2,10560,4619,1025,8513,1
4,76,6,4,4,0,0,2,6,0,0,0,0,0,0,0,0,0,0,0,0,2,2,2,10560,4619,1025,8514,1
4,76,7,5,5,0,0,2,7,0,0,0,0,0,0,0,0,0,0,0,0,2,2,2,10560,4619,1025,8515,1
4,76,6,4,4,0,0,2,6,0,0,0,0,0,0,0,0,0,0,0,0,2,2,2,10560,4619,1025,8516,1
4,76,10,6,6,0,0,4,10,0,0,0,0,0,0,0,0,0,0,0,0,2,2,2,10560,4619,1025,8517,1
4,76,1,1,1,0,0,0,1,0,0,0,0,0,0,0,0,0,0,0,0,2,2,2,10560,4619,1025,8517,1
4,76,14,10,10,0,0,4,14,1,1,1,1,2,2,0,2,0,1,0,0,2,2,2,10560,4619,1025,8518,1
4,76,46,26,30,3,0,12,49,3,6,3,6,9,9,20,28,1,42,2,0,2,2,2,10570,4619,1025,8519,1
45,430,647,139,84,35,284,233,682,0,0,0,0,0,0,0,0,0,0,0,0,2,1,1,10580,4623,1026,8527,1
133,2760,77,34,69,0,0,8,77,3,24,16,29,27,45,114,213,1,387,21,0,2,13,4,10580,4623,1026,8528,1
133,2760,712,438,573,51,9,84,763,14,102,71,128,116,199,733,1364,8,11988,666,0,2,13,4,10590,4624,1026,8529,1
16,576,1455,414,1257,16,76,112,1471,5,41,23,46,46,69,231,381,2,1069,59,0,2,2,2,10590,4625,1026,8530,1
16,576,669,365,481,22,61,110,691,15,103,63,122,118,185,747,1273,8,11311,628,0,2,2,2,10600,4625,1027,8531,1
44,767,1020,354,843,12,15,144,1032,8,134,77,144,142,221,970,1580,4,6792,377,0,2,3,3,10600,4625,1027,8532,1
17,277,424,94,331,4,0,89,428,1,5,5,5,6,10,11,25,0,12,0,0,2,6,6,10600,4626,1027,8533,1
17,277,38,23,23,6,0,8,44,3,11,7,11,14,18,42,68,1,102,5,0,2,6,6,10600,4626,1027,8534,1
206,4475,72,33,56,0,4,12,72,1,1,1,1,2,2,0,2,0,1,0,0,2,11,11,10600,4626,1027,8535,1
206,4475,1454,835,1044,76,110,219,1530,17,275,158,296,292,454,2297,3718,9,34017,1889,1,2,11,11,10610,4627,1027,8536,1
130,3020,373,158,315,8,0,51,381,5,76,44,79,81,123,486,779,2,2026,112,0,2,7,7,10610,4627,1027,8537,1
71,1170,1178,367,1042,6,15,115,1184,9,94,51,95,103,146,644,976,4,4439,246,0,2,2,2,10610,4627,1027,8538,1
71,1170,177,108,140,8,0,27,185,6,30,16,32,36,48,162,248,3,794,44,0,2,2,2,10610,4629,1027,8539,1
19,278,1098,241,925,5,10,155,1103,7,46,25,49,53,74,273,423,3,1580,87,0,2,3,3,10620,4631,1027,8540,1
19,278,282,202,222,14,2,44,296,8,42,24,43,50,67,250,378,4,1548,86,0,2,3,3,10620,4632,1027,8541,1
6,283,42,7,35,4,0,5,46,1,2,1,2,3,3,2,4,0,2,0,0,2,1,1,10620,4632,1027,8542,1
6,283,11,6,10,0,0,1,11,2,4,2,4,6,6,10,15,1,15,0,0,2,1,1,10620,4632,1027,8543,1
35,1670,1289,550,1043,56,32,155,1345,10,167,93,185,177,278,1266,2075,5,11498,638,0,2,33,22,10620,4634,1028,8544,1
19,1390,1523,757,1297,19,12,193,1542,12,193,117,230,205,347,1508,2664,7,19053,1058,0,2,2,2,10630,4636,1028,8545,1
36,1466,1043,504,840,53,9,147,1096,9,180,112,198,189,310,1377,2344,4,11604,644,0,2,8,9,10630,4638,1028,8546,1
23,994,373,158,315,8,0,51,381,5,76,44,79,81,123,486,779,2,2026,112,0,2,4,4,10630,4638,1028,8547,1
41,2834,1296,573,1062,40,33,157,1336,8,201,118,231,209,349,1561,2689,4,12365,686,0,2,32,32,10630,4638,1028,8548,1
26,1354,652,304,544,16,6,88,668,6,89,51,101,95,152,591,998,3,3399,188,0,2,1,1,10630,4639,1028,8549,1
75,3605,77,34,69,0,0,8,77,3,24,16,29,27,45,114,213,1,387,21,0,2,2,2,10630,4639,1028,8550,1
43,864,1450,624,1228,12,26,181,1462,14,306,186,354,320,540,2580,4493,8,36391,2021,1,3,1,1,10640,4645,1030,8558,1
141,2754,1457,730,1242,11,6,188,1468,10,292,166,329,302,495,2424,4078,5,22973,1276,1,3,1,1,10650,4651,1030,8561,1
141,2754,74,35,59,1,0,14,75,3,14,7,14,17,21,58,85,1,128,7,0,3,1,1,10650,4652,1030,8562,1
141,2754,245,125,200,5,7,34,250,7,30,17,34,37,51,166,265,3,1053,58,0,3,1,1,10660,4653,1030,8563,1
34,862,74,35,59,1,0,14,75,3,14,7,14,17,21,58,85,1,128,7,0,3,1,1,10670,4655,1031,8566,1
34,862,245,125,200,5,7,34,250,7,30,17,34,37,51,166,265,3,1053,58,0,3,1,1,10680,4656,1031,8567,1
45,430,647,139,84,35,284,233,682,0,0,0,0,0,0,0,0,0,0,0,0,3,3,3,10680,4656,1031,8568,1
177,4162,722,423,573,19,0,135,741,12,172,101,199,184,300,1320,2257,6,15668,870,0,3,3,3,10700,4672,1033,8580,1
177,4162,1508,847,911,44,250,301,1552,14,148,88,169,162,257,1120,1886,7,15077,837,0,3,3,3,10700,4673,1034,8581,1
206,4475,72,33,56,0,4,12,72,1,1,1,1,2,2,0,2,0,1,0,0,3,4,4,10700,4673,1034,8582,1
206,4475,1454,835,1044,76,110,219,1530,17,275,158,296,292,454,2297,3718,9,34017,1889,1,3,4,4,10710,4674,1034,8583,1
130,3034,373,158,315,8,0,51,381,5,76,44,79,81,123,486,779,2,2026,112,0,3,4,3,10720,4678,1035,8590,1
12,222,127,75,83,2,11,30,129,4,14,7,14,18,21,61,87,2,175,9,0,2,1,1,10740,4690,1035,8599,1
12,222,652,304,544,16,6,88,668,6,89,51,101,95,152,591,998,3,3399,188,0,2,1,1,10740,4691,1035,8600,1
12,222,2,2,2,0,0,0,2,0,0,0,0,0,0,0,0,0,0,0,0,2,1,1,10740,4691,1035,8600,1
12,222,8,5,5,0,0,3,8,0,0,0,0,0,0,0,0,0,0,0,0,2,1,1,10740,4691,1035,8601,1
12,222,2,2,2,0,0,0,2,0,0,0,0,0,0,0,0,0,0,0,0,2,1,1,10740,4691,1035,8601,1
12,222,14,8,8,0,0,6,14,0,0,0,0,0,0,0,0,0,0,0,0,2,1,1,10740,4691,1035,8602,1
12,222,6,4,4,0,0,2,6,0,0,0,0,0,0,0,0,0,0,0,0,2,1,1,10740,4691,1035,8603,1
12,222,6,4,4,0,0,2,6,1,2,1,2,3,3,2,4,0,2,0,0,2,1,1,10740,4691,1035,8604,1
12,222,6,4,4,0,0,2,6,0,0,0,0,0,0,0,0,0,0,0,0,2,1,1,10740,4691,1035,8605,1
12,222,7,5,5,0,0,2,7,0,0,0,0,0,0,0,0,0,0,0,0,2,1,1,10740,4691,1035,8606,1
12,222,6,4,4,0,0,2,6,0,0,0,0,0,0,0,0,0,0,0,0,2,1,1,10740,4691,1035,8607,1
12,222,10,6,6,0,0,4,10,0,0,0,0,0,0,0,0,0,0,0,0,2,1,1,10740,4691,1035,8608,1
12,222,1,1,1,0,0,0,1,0,0,0,0,0,0,0,0,0,0,0,0,2,1,1,10740,4691,1035,8608,1
12,222,14,10,10,0,0,4,14,1,1,1,1,2,2,0,2,0,1,0,0,2,1,1,10740,4691,1035,8609,1
12,222,46,26,30,3,0,12,49,3,6,3,6,9,9,20,28,1,42,2,0,2,1,1,10750,4691,1035,8610,1
6,287,42,7,35,4,0,5,46,1,2,1,2,3,3,2,4,0,2,0,0,2,3,2,10760,4695,1036,8619,1
6,287,11,6,10,0,0,1,11,2,4,2,4,6,6,10,15,1,15,0,0,2,3,2,10760,4695,1036,8620,1
35,1615,1289,550,1043,56,32,155,1345,10,167,93,185,177,278,1266,2075,5,11498,638,0,2,20,13,10760,4697,1037,8621,1
7,159,127,75,83,2,11,30,129,4,14,7,14,18,21,61,87,2,175,9,0,2,3,3,10760,4697,1037,8622,1
7,159,652,304,544,16,6,88,668,6,89,51,101,95,152,591,998,3,3399,188,0,2,3,3,10760,4698,1037,8623,1
7,159,2,2,2,0,0,0,2,0,0,0,0,0,0,0,0,0,0,0,0,2,3,3,10760,4698,1037,8623,1
7,159,8,5,5,0,0,3,8,0,0,0,0,0,0,0,0,0,0,0,0,2,3,3,10760,4698,1037,8624,1
7,159,2,2,2,0,0,0,2,0,0,0,0,0,0,0,0,0,0,0,0,2,3,3,10760,4698,1037,8624,1
7,159,14,8,8,0,0,6,14,0,0,0,0,0,0,0,0,0,0,0,0,2,3,3,10760,4698,1037,8625,1
7,159,6,4,4,0,0,2,6,0,0,0,0,0,0,0,0,0,0,0,0,2,3,3,10760,4698,1037,8626,1
7,159,6,4,4,0,0,2,6,1,2,1,2,3,3,2,4,0,2,0,0,2,3,3,10760,4698,1037,8627,1
7,159,6,4,4,0,0,2,6,0,0,0,0,0,0,0,0,0,0,0,0,2,3,3,10760,4698,1037,8628,1
7,159,7,5,5,0,0,2,7,0,0,0,0,0,0,0,0,0,0,0,0,2,3,3,10760,4698,1037,8629,1
7,159,6,4,4,0,0,2,6,0,0,0,0,0,0,0,0,0,0,0,0,2,3,3,10760,4698,1037,8630,1
7,159,10,6,6,0,0,4,10,0,0,0,0,0,0,0,0,0,0,0,0,2,3,3,10760,4698,1037,8631,1
7,159,1,1,1,0,0,0,1,0,0,0,0,0,0,0,0,0,0,0,0,2,3,3,10760,4698,1037,8631,1
7,159,14,10,10,0,0,4,14,1,1,1,1,2,2,0,2,0,1,0,0,2,3,3,10760,4698,1037,8632,1
7,159,46,26,30,3,0,12,49,3,6,3,6,9,9,20,28,1,42,2,0,2,3,3,10770,4698,1037,8633,1
26,918,1450,624,1228,12,26,181,1462,14,306,186,354,320,540,2580,4493,8,36391,2021,1,2,1,1,10770,4700,1038,8634,1
34,1378,1513,682,1277,25,13,200,1538,11,199,116,219,210,335,1557,2584,6,15641,868,0,2,1,1,10770,4702,1038,8635,1
10,401,1455,414,1257,16,76,112,1471,5,41,23,46,46,69,231,381,2,1069,59,0,2,1,1,10770,4703,1038,8636,1
7,222,74,35,59,1,0,14,75,3,14,7,14,17,21,58,85,1,128,7,0,2,1,1,10770,4704,1038,8637,1
31,1245,1020,354,843,12,15,144,1032,8,134,77,144,142,221,970,1580,4,6792,377,0,2,1,1,10770,4704,1038,8638,1
12,818,447,308,343,6,5,95,453,7,96,59,111,103,170,651,1136,4,4600,255,0,2,1,1,10770,4707,1038,8639,1
10,498,722,423,573,19,0,135,741,12,172,101,199,184,300,1320,2257,6,15668,870,0,2,3,3,10770,4709,1038,8641,1
12,416,386,256,301,16,9,68,402,4,59,35,69,63,104,355,621,2,1453,80,0,2,1,1,10770,4709,1038,8642,1
13,1142,215,129,180,6,0,29,221,8,65,43,72,73,115,415,711,4,3153,175,0,2,3,3,10770,4709,1038,8643,1
36,1464,1043,504,840,53,9,147,1096,9,180,112,198,189,310,1377,2344,4,11604,644,0,2,1,1,10770,4711,1038,8644,1
28,1381,1178,367,1042,6,15,115,1184,9,94,51,95,103,146,644,976,4,4439,246,0,2,3,3,10770,4711,1038,8645,1
51,2560,1943,715,1694,26,18,214,1969,12,185,120,237,197,357,1436,2721,7,20915,1161,0,2,2,2,10770,4713,1038,8646,1
2,135,442,244,305,14,16,103,456,11,68,45,75,79,120,452,756,6,4588,254,0,2,2,2,10770,4715,1038,8647,1
41,2832,1296,573,1062,40,33,157,1336,8,201,118,231,209,349,1561,2689,4,12365,686,0,2,1,1,10770,4715,1038,8648,1
26,1595,1457,730,1242,11,6,188,1468,10,292,166,329,302,495,2424,4078,5,22973,1276,1,2,1,1,10770,4717,1038,8649,1
26,1352,652,304,544,16,6,88,668,6,89,51,101,95,152,591,998,3,3399,188,0,2,2,2,10770,4718,1038,8650,1
17,773,334,251,279,10,4,40,344,5,127,74,143,132,217,899,1528,2,4303,239,0,2,1,1,10770,4719,1038,8651,1
177,4154,722,423,573,19,0,135,741,12,172,101,199,184,300,1320,2257,6,15668,870,0,2,4,1,10820,4753,1040,8693,1
177,4154,1508,847,911,44,250,301,1552,14,148,88,169,162,257,1120,1886,7,15077,837,0,2,4,1,10820,4754,1041,8694,1
176,4145,722,423,573,19,0,135,741,12,172,101,199,184,300,1320,2257,6,15668,870,0,2,4,5,10820,4756,1041,8696,1
176,4145,1508,847,911,44,250,301,1552,14,148,88,169,162,257,1120,1886,7,15077,837,0,2,4,5,10820,4757,1042,8697,1
6,287,42,7,35,4,0,5,46,1,2,1,2,3,3,2,4,0,2,0,0,2,1,1,10820,4757,1042,8698,1
6,287,11,6,10,0,0,1,11,2,4,2,4,6,6,10,15,1,15,0,0,2,1,1,10820,4757,1042,8699,1
26,560,215,129,180,6,0,29,221,8,65,43,72,73,115,415,711,4,3153,175,0,2,3,2,10820,4757,1042,8700,1
26,560,97,69,77,3,3,16,100,6,22,13,23,28,36,113,173,3,542,30,0,2,3,2,10820,4758,1042,8701,1
87,1903,1043,504,840,53,9,147,1096,9,180,112,198,189,310,1377,2344,4,11604,644,0,2,20,7,10820,4760,1042,8702,1
87,1903,383,288,292,26,6,62,409,11,65,38,67,76,105,429,656,5,3719,206,0,2,20,7,10820,4761,1042,8703,1
71,1168,1178,367,1042,6,15,115,1184,9,94,51,95,103,146,644,976,4,4439,246,0,2,2,2,10820,4761,1042,8704,1
71,1168,177,108,140,8,0,27,185,6,30,16,32,36,48,162,248,3,794,44,0,2,2,2,10820,4763,1042,8705,1
138,2676,1943,715,1694,26,18,214,1969,12,185,120,237,197,357,1436,2721,7,20915,1161,0,2,1,1,10820,4765,1042,8706,1
138,2676,1168,838,957,57,25,144,1225,19,348,224,416,367,640,3018,5452,11,61921,3440,1,2,1,1,10830,4767,1042,8707,1
6,287,42,7,35,4,0,5,46,1,2,1,2,3,3,2,4,0,2,0,0,2,1,1,10830,4767,1042,8708,1
6,287,11,6,10,0,0,1,11,2,4,2,4,6,6,10,15,1,15,0,0,2,1,1,10830,4767,1042,8709,1
37,1499,1043,504,840,53,9,147,1096,9,180,112,198,189,310,1377,2344,4,11604,644,0,2,7,2,10830,4769,1042,8710,1
28,1372,1178,367,1042,6,15,115,1184,9,94,51,95,103,146,644,976,4,4439,246,0,2,7,8,10830,4769,1042,8711,1
130,3043,373,158,315,8,0,51,381,5,76,44,79,81,123,486,779,2,2026,112,0,2,2,1,10830,4769,1042,8712,1
137,2628,1943,715,1694,26,18,214,1969,12,185,120,237,197,357,1436,2721,7,20915,1161,0,2,1,5,10830,4771,1042,8713,1
137,2628,1168,838,957,57,25,144,1225,19,348,224,416,367,640,3018,5452,11,61921,3440,1,2,1,5,10840,4773,1042,8714,1
34,862,74,35,59,1,0,14,75,3,14,7,14,17,21,58,85,1,128,7,0,2,2,2,10840,4774,1042,8715,0
34,862,245,125,200,5,7,34,250,7,30,17,34,37,51,166,265,3,1053,58,0,2,2,2,10850,4775,1042,8716,0
4,78,127,75,83,2,11,30,129,4,14,7,14,18,21,61,87,2,175,9,0,2,1,1,10850,4775,1042,8717,0
4,78,652,304,544,16,6,88,668,6,89,51,101,95,152,591,998,3,3399,188,0,2,1,1,10850,4776,1042,8718,0
4,78,2,2,2,0,0,0,2,0,0,0,0,0,0,0,0,0,0,0,0,2,1,1,10850,4776,1042,8718,0
4,78,8,5,5,0,0,3,8,0,0,0,0,0,0,0,0,0,0,0,0,2,1,1,10850,4776,1042,8719,0
4,78,2,2,2,0,0,0,2,0,0,0,0,0,0,0,0,0,0,0,0,2,1,1,10850,4776,1042,8719,0
4,78,14,8,8,0,0,6,14,0,0,0,0,0,0,0,0,0,0,0,0,2,1,1,10850,4776,1042,8720,0
4,78,6,4,4,0,0,2,6,0,0,0,0,0,0,0,0,0,0,0,0,2,1,1,10850,4776,1042,8721,0
4,78,6,4,4,0,0,2,6,1,2,1,2,3,3,2,4,0,2,0,0,2,1,1,10850,4776,1042,8722,0
4,78,6,4,4,0,0,2,6,0,0,0,0,0,0,0,0,0,0,0,0,2,1,1,10850,4776,1042,8723,0
4,78,7,5,5,0,0,2,7,0,0,0,0,0,0,0,0,0,0,0,0,2,1,1,10850,4776,1042,8724,0
4,78,6,4,4,0,0,2,6,0,0,0,0,0,0,0,0,0,0,0,0,2,1,1,10850,4776,1042,8725,0
4,78,10,6,6,0,0,4,10,0,0,0,0,0,0,0,0,0,0,0,0,2,1,1,10850,4776,1042,8726,0
4,78,1,1,1,0,0,0,1,0,0,0,0,0,0,0,0,0,0,0,0,2,1,1,10850,4776,1042,8726,0
4,78,14,10,10,0,0,4,14,1,1,1,1,2,2,0,2,0,1,0,0,2,1,1,10850,4776,1042,8727,0
4,78,46,26,30,3,0,12,49,3,6,3,6,9,9,20,28,1,42,2,0,2,1,1,10860,4776,1042,8728,0
205,4464,72,33,56,0,4,12,72,1,1,1,1,2,2,0,2,0,1,0,0,2,2,2,10860,4776,1042,8729,0
205,4464,1454,835,1044,76,110,219,1530,17,275,158,296,292,454,2297,3718,9,34017,1889,1,2,2,2,10870,4777,1042,8730,0
6,287,42,7,35,4,0,5,46,1,2,1,2,3,3,2,4,0,2,0,0,2,1,1,10870,4777,1042,8731,0
6,287,11,6,10,0,0,1,11,2,4,2,4,6,6,10,15,1,15,0,0,2,1,1,10870,4777,1042,8732,0
35,1628,1289,550,1043,56,32,155,1345,10,167,93,185,177,278,1266,2075,5,11498,638,0,2,1,0,10870,4779,1043,8733,0
18,598,1455,414,1257,16,76,112,1471,5,41,23,46,46,69,231,381,2,1069,59,0,2,2,1,10870,4780,1043,8734,1
18,598,669,365,481,22,61,110,691,15,103,63,122,118,185,747,1273,8,11311,628,0,2,2,1,10880,4780,1044,8735,1
10,415,1455,414,1257,16,76,112,1471,5,41,23,46,46,69,231,381,2,1069,59,0,2,3,3,10880,4781,1044,8736,1
17,561,1455,414,1257,16,76,112,1471,5,41,23,46,46,69,231,381,2,1069,59,0,2,2,7,10880,4782,1044,8737,1
17,561,669,365,481,22,61,110,691,15,103,63,122,118,185,747,1273,8,11311,628,0,2,2,7,10890,4782,1045,8738,1
131,3044,373,158,315,8,0,51,381,5,76,44,79,81,123,486,779,2,2026,112,0,2,2,3,10890,4782,1045,8739,1
38,1713,1289,550,1043,56,32,155,1345,10,167,93,185,177,278,1266,2075,5,11498,638,0,2,19,0,10890,4784,1046,8740,1
41,2867,1296,573,1062,40,33,157,1336,8,201,118,231,209,349,1561,2689,4,12365,686,0,2,40,4,10890,4784,1046,8741,1
6,287,42,7,35,4,0,5,46,1,2,1,2,3,3,2,4,0,2,0,0,2,1,1,10890,4784,1046,8742,0
6,287,11,6,10,0,0,1,11,2,4,2,4,6,6,10,15,1,15,0,0,2,1,1,10890,4784,1046,8743,0
38,1703,1289,550,1043,56,32,155,1345,10,167,93,185,177,278,1266,2075,5,11498,638,0,2,6,6,10890,4786,1047,8744,1
32,534,127,75,83,2,11,30,129,4,14,7,14,18,21,61,87,2,175,9,0,2,2,2,10890,4786,1047,8745,1
32,534,652,304,544,16,6,88,668,6,89,51,101,95,152,591,998,3,3399,188,0,2,2,2,10890,4787,1047,8746,1
32,534,2,2,2,0,0,0,2,0,0,0,0,0,0,0,0,0,0,0,0,2,2,2,10890,4787,1047,8746,1
32,534,8,5,5,0,0,3,8,0,0,0,0,0,0,0,0,0,0,0,0,2,2,2,10890,4787,1047,8747,1
32,534,2,2,2,0,0,0,2,0,0,0,0,0,0,0,0,0,0,0,0,2,2,2,10890,4787,1047,8747,1
32,534,14,8,8,0,0,6,14,0,0,0,0,0,0,0,0,0,0,0,0,2,2,2,10890,4787,1047,8748,1
32,534,6,4,4,0,0,2,6,0,0,0,0,0,0,0,0,0,0,0,0,2,2,2,10890,4787,1047,8749,1
32,534,6,4,4,0,0,2,6,1,2,1,2,3,3,2,4,0,2,0,0,2,2,2,10890,4787,1047,8750,1
32,534,6,4,4,0,0,2,6,0,0,0,0,0,0,0,0,0,0,0,0,2,2,2,10890,4787,1047,8751,1
32,534,7,5,5,0,0,2,7,0,0,0,0,0,0,0,0,0,0,0,0,2,2,2,10890,4787,1047,8752,1
32,534,6,4,4,0,0,2,6,0,0,0,0,0,0,0,0,0,0,0,0,2,2,2,10890,4787,1047,8753,1
32,534,10,6,6,0,0,4,10,0,0,0,0,0,0,0,0,0,0,0,0,2,2,2,10890,4787,1047,8754,1
32,534,1,1,1,0,0,0,1,0,0,0,0,0,0,0,0,0,0,0,0,2,2,2,10890,4787,1047,8754,1
32,534,14,10,10,0,0,4,14,1,1,1,1,2,2,0,2,0,1,0,0,2,2,2,10890,4787,1047,8755,1
32,534,46,26,30,3,0,12,49,3,6,3,6,9,9,20,28,1,42,2,0,2,2,2,10900,4787,1047,8756,1
26,918,1450,624,1228,12,26,181,1462,14,306,186,354,320,540,2580,4493,8,36391,2021,1,2,2,2,10900,4789,1048,8757,1
34,1366,1513,682,1277,25,13,200,1538,11,199,116,219,210,335,1557,2584,6,15641,868,0,2,9,9,10900,4791,1048,8758,1
41,2863,1296,573,1062,40,33,157,1336,8,201,118,231,209,349,1561,2689,4,12365,686,0,2,2,2,10900,4791,1048,8759,1
26,1575,1457,730,1242,11,6,188,1468,10,292,166,329,302,495,2424,4078,5,22973,1276,1,2,10,10,10900,4793,1048,8760,1
26,1350,652,304,544,16,6,88,668,6,89,51,101,95,152,591,998,3,3399,188,0,2,6,6,10900,4794,1048,8761,1
10,417,1455,414,1257,16,76,112,1471,5,41,23,46,46,69,231,381,2,1069,59,0,2,2,2,10900,4795,1048,8762,1
7,222,74,35,59,1,0,14,75,3,14,7,14,17,21,58,85,1,128,7,0,2,2,2,10900,4796,1048,8763,1
19,1390,1523,757,1297,19,12,193,1542,12,193,117,230,205,347,1508,2664,7,19053,1058,0,2,9,9,10910,4798,1048,8764,1
31,1237,1020,354,843,12,15,144,1032,8,134,77,144,142,221,970,1580,4,6792,377,0,2,26,27,10910,4798,1048,8765,1
12,810,447,308,343,6,5,95,453,7,96,59,111,103,170,651,1136,4,4600,255,0,2,5,5,10910,4801,1048,8766,1
9,312,424,94,331,4,0,89,428,1,5,5,5,6,10,11,25,0,12,0,0,2,1,1,10910,4802,1048,8767,1
17,769,334,251,279,10,4,40,344,5,127,74,143,132,217,899,1528,2,4303,239,0,2,4,4,10910,4803,1048,8768,1
5,238,184,100,137,2,15,30,186,6,38,20,39,44,59,214,322,3,991,55,0,2,4,4,10910,4804,1048,8769,1
15,596,1293,570,1093,25,15,163,1318,10,195,123,241,205,364,1516,2795,6,17273,959,0,2,16,16,10920,4806,1048,8770,1
10,494,722,423,573,19,0,135,741,12,172,101,199,184,300,1320,2257,6,15668,870,0,2,6,5,10920,4808,1048,8772,1
12,412,386,256,301,16,9,68,402,4,59,35,69,63,104,355,621,2,1453,80,0,2,4,4,10920,4808,1048,8773,1
13,1144,215,129,180,6,0,29,221,8,65,43,72,73,115,415,711,4,3153,175,0,2,11,10,10920,4808,1048,8774,1
37,1475,1043,504,840,53,9,147,1096,9,180,112,198,189,310,1377,2344,4,11604,644,0,2,19,19,10920,4810,1048,8775,1
10,333,295,56,236,0,4,54,295,2,9,5,10,11,15,30,51,1,57,3,0,2,4,4,10920,4812,1048,8776,1
23,990,373,158,315,8,0,51,381,5,76,44,79,81,123,486,779,2,2026,112,0,2,9,9,10920,4812,1048,8777,1
28,1368,1178,367,1042,6,15,115,1184,9,94,51,95,103,146,644,976,4,4439,246,0,2,60,60,10920,4812,1048,8778,1
51,2556,1943,715,1694,26,18,214,1969,12,185,120,237,197,357,1436,2721,7,20915,1161,0,2,13,13,10920,4814,1048,8779,1
2,137,442,244,305,14,16,103,456,11,68,45,75,79,120,452,756,6,4588,254,0,2,1,1,10920,4816,1048,8780,1
7,249,1098,241,925,5,10,155,1103,7,46,25,49,53,74,273,423,3,1580,87,0,2,4,4,10930,4818,1048,8781,1
17,579,1455,414,1257,16,76,112,1471,5,41,23,46,46,69,231,381,2,1069,59,0,2,7,3,10930,4819,1048,8782,1
17,579,669,365,481,22,61,110,691,15,103,63,122,118,185,747,1273,8,11311,628,0,2,7,3,10940,4819,1049,8783,1
17,277,424,94,331,4,0,89,428,1,5,5,5,6,10,11,25,0,12,0,0,2,1,1,10940,4820,1049,8784,1
17,277,38,23,23,6,0,8,44,3,11,7,11,14,18,42,68,1,102,5,0,2,1,1,10940,4820,1049,8785,1
205,4464,72,33,56,0,4,12,72,1,1,1,1,2,2,0,2,0,1,0,0,2,22,13,10940,4820,1049,8786,1
205,4464,1454,835,1044,76,110,219,1530,17,275,158,296,292,454,2297,3718,9,34017,1889,1,2,22,13,10950,4821,1049,8787,1
18,462,386,256,301,16,9,68,402,4,59,35,69,63,104,355,621,2,1453,80,0,2,2,2,10950,4821,1049,8788,1
18,462,264,131,164,11,41,46,275,6,38,22,40,44,62,214,338,3,1068,59,0,2,2,2,10960,4821,1050,8789,1
131,3070,373,158,315,8,0,51,381,5,76,44,79,81,123,486,779,2,2026,112,0,2,4,2,10960,4821,1050,8790,1
38,1703,1289,550,1043,56,32,155,1345,10,167,93,185,177,278,1266,2075,5,11498,638,0,2,3,4,10970,4827,1052,8798,1
41,2878,1296,573,1062,40,33,157,1336,8,201,118,231,209,349,1561,2689,4,12365,686,0,2,4,4,10970,4827,1052,8799,1
32,1257,1020,354,843,12,15,144,1032,8,134,77,144,142,221,970,1580,4,6792,377,0,2,4,0,10970,4827,1052,8800,1
18,604,1455,414,1257,16,76,112,1471,5,41,23,46,46,69,231,381,2,1069,59,0,2,4,1,10970,4828,1052,8802,0
18,604,669,365,481,22,61,110,691,15,103,63,122,118,185,747,1273,8,11311,628,0,2,4,1,10980,4828,1053,8803,0
1,185,382,65,130,157,2,92,539,4,10,5,10,14,15,41,57,2,114,6,0,2,3,1,10980,4829,1054,8804,0
207,4492,72,33,56,0,4,12,72,1,1,1,1,2,2,0,2,0,1,0,0,2,9,4,10980,4829,1054,8805,1
207,4492,1454,835,1044,76,110,219,1530,17,275,158,296,292,454,2297,3718,9,34017,1889,1,2,9,4,10990,4830,1054,8806,1
6,287,42,7,35,4,0,5,46,1,2,1,2,3,3,2,4,0,2,0,0,2,1,1,10990,4830,1054,8807,1
6,287,11,6,10,0,0,1,11,2,4,2,4,6,6,10,15,1,15,0,0,2,1,1,10990,4830,1054,8808,1
46,795,1020,354,843,12,15,144,1032,8,134,77,144,142,221,970,1580,4,6792,377,0,2,8,8,10990,4830,1054,8809,1
35,1360,1020,354,843,12,15,144,1032,8,134,77,144,142,221,970,1580,4,6792,377,0,2,16,1,10990,4830,1054,8810,1
1,84,13,10,10,0,0,3,13,1,2,1,2,3,3,2,4,0,2,0,0,3,1,0,11000,4831,1055,8824,1
3,71,127,75,83,2,11,30,129,4,14,7,14,18,21,61,87,2,175,9,0,3,1,0,11000,4831,1055,8826,1
3,71,652,304,544,16,6,88,668,6,89,51,101,95,152,591,998,3,3399,188,0,3,1,0,11000,4832,1055,8827,1
3,71,2,2,2,0,0,0,2,0,0,0,0,0,0,0,0,0,0,0,0,3,1,0,11000,4832,1055,8827,1
3,71,8,5,5,0,0,3,8,0,0,0,0,0,0,0,0,0,0,0,0,3,1,0,11000,4832,1055,8828,1
3,71,2,2,2,0,0,0,2,0,0,0,0,0,0,0,0,0,0,0,0,3,1,0,11000,4832,1055,8828,1
3,71,14,8,8,0,0,6,14,0,0,0,0,0,0,0,0,0,0,0,0,3,1,0,11000,4832,1055,8829,1
3,71,6,4,4,0,0,2,6,0,0,0,0,0,0,0,0,0,0,0,0,3,1,0,11000,4832,1055,8830,1
3,71,6,4,4,0,0,2,6,1,2,1,2,3,3,2,4,0,2,0,0,3,1,0,11000,4832,1055,8831,1
3,71,6,4,4,0,0,2,6,0,0,0,0,0,0,0,0,0,0,0,0,3,1,0,11000,4832,1055,8832,1
3,71,7,5,5,0,0,2,7,0,0,0,0,0,0,0,0,0,0,0,0,3,1,0,11000,4832,1055,8833,1
3,71,6,4,4,0,0,2,6,0,0,0,0,0,0,0,0,0,0,0,0,3,1,0,11000,4832,1055,8834,1
3,71,10,6,6,0,0,4,10,0,0,0,0,0,0,0,0,0,0,0,0,3,1,0,11000,4832,1055,8835,1
3,71,1,1,1,0,0,0,1,0,0,0,0,0,0,0,0,0,0,0,0,3,1,0,11000,4832,1055,8835,1
3,71,14,10,10,0,0,4,14,1,1,1,1,2,2,0,2,0,1,0,0,3,1,0,11000,4832,1055,8836,1
3,71,46,26,30,3,0,12,49,3,6,3,6,9,9,20,28,1,42,2,0,3,1,0,11010,4832,1055,8837,1
13,380,72,33,56,0,4,12,72,1,1,1,1,2,2,0,2,0,1,0,0,3,1,3,11030,4840,1057,8852,1
5,69,38,23,23,0,0,15,38,0,0,0,0,0,0,0,0,0,0,0,0,0,21,0,11030,4840,1057,8853,1
134,2593,1457,730,1242,11,6,188,1468,10,292,166,329,302,495,2424,4078,5,22973,1276,1,2,1,26,11090,4854,1059,8917,1
134,2593,74,35,59,1,0,14,75,3,14,7,14,17,21,58,85,1,128,7,0,2,1,26,11090,4855,1059,8918,1
134,2593,245,125,200,5,7,34,250,7,30,17,34,37,51,166,265,3,1053,58,0,2,1,26,11100,4856,1059,8919,1
178,4184,722,423,573,19,0,135,741,12,172,101,199,184,300,1320,2257,6,15668,870,0,2,9,3,11100,4858,1059,8921,1
178,4184,1508,847,911,44,250,301,1552,14,148,88,169,162,257,1120,1886,7,15077,837,0,2,9,3,11100,4859,1060,8922,1
12,359,442,244,305,14,16,103,456,11,68,45,75,79,120,452,756,6,4588,254,0,2,53,8,11100,4861,1060,8923,1
12,359,182,102,99,11,40,35,193,3,11,6,11,14,17,42,64,1,97,5,0,2,53,8,11100,4862,1060,8924,1
37,1648,1289,550,1043,56,32,155,1345,10,167,93,185,177,278,1266,2075,5,11498,638,0,2,0,10,11100,4864,1061,8925,1
22,1351,1457,730,1242,11,6,188,1468,10,292,166,329,302,495,2424,4078,5,22973,1276,1,2,0,27,11100,4866,1061,8926,1
7,476,442,244,305,14,16,103,456,11,68,45,75,79,120,452,756,6,4588,254,0,2,49,1,11100,4868,1061,8927,1
65,1200,1513,682,1277,25,13,200,1538,11,199,116,219,210,335,1557,2584,6,15641,868,0,2,5,1,11100,4870,1061,8928,1
65,1200,819,519,539,24,98,155,843,15,96,57,106,111,163,690,1107,8,9171,509,0,2,5,1,11110,4872,1061,8929,1
20,489,1293,570,1093,25,15,163,1318,10,195,123,241,205,364,1516,2795,6,17273,959,0,2,4,2,11120,4874,1061,8930,1
207,4492,72,33,56,0,4,12,72,1,1,1,1,2,2,0,2,0,1,0,0,2,2,2,11120,4874,1061,8931,1
207,4492,1454,835,1044,76,110,219,1530,17,275,158,296,292,454,2297,3718,9,34017,1889,1,2,2,2,11130,4875,1061,8932,1
6,287,42,7,35,4,0,5,46,1,2,1,2,3,3,2,4,0,2,0,0,2,1,1,11130,4875,1061,8933,1
6,287,11,6,10,0,0,1,11,2,4,2,4,6,6,10,15,1,15,0,0,2,1,1,11130,4875,1061,8934,1
35,1408,1513,682,1277,25,13,200,1538,11,199,116,219,210,335,1557,2584,6,15641,868,0,2,10,0,11130,4877,1061,8935,1
133,2586,1457,730,1242,11,6,188,1468,10,292,166,329,302,495,2424,4078,5,22973,1276,1,2,7,8,11130,4879,1061,8936,1
133,2586,74,35,59,1,0,14,75,3,14,7,14,17,21,58,85,1,128,7,0,2,7,8,11130,4880,1061,8937,1
133,2586,245,125,200,5,7,34,250,7,30,17,34,37,51,166,265,3,1053,58,0,2,7,8,11140,4881,1061,8938,1
44,421,647,139,84,35,284,233,682,0,0,0,0,0,0,0,0,0,0,0,0,2,0,3,11140,4881,1061,8939,1
148,2800,1943,715,1694,26,18,214,1969,12,185,120,237,197,357,1436,2721,7,20915,1161,0,2,44,10,11140,4883,1061,8940,1
148,2800,1168,838,957,57,25,144,1225,19,348,224,416,367,640,3018,5452,11,61921,3440,1,2,44,10,11150,4885,1061,8941,1
4,77,127,75,83,2,11,30,129,4,14,7,14,18,21,61,87,2,175,9,0,2,1,1,11150,4885,1061,8942,1
4,77,652,304,544,16,6,88,668,6,89,51,101,95,152,591,998,3,3399,188,0,2,1,1,11150,4886,1061,8943,1
4,77,2,2,2,0,0,0,2,0,0,0,0,0,0,0,0,0,0,0,0,2,1,1,11150,4886,1061,8943,1
4,77,8,5,5,0,0,3,8,0,0,0,0,0,0,0,0,0,0,0,0,2,1,1,11150,4886,1061,8944,1
4,77,2,2,2,0,0,0,2,0,0,0,0,0,0,0,0,0,0,0,0,2,1,1,11150,4886,1061,8944,1
4,77,14,8,8,0,0,6,14,0,0,0,0,0,0,0,0,0,0,0,0,2,1,1,11150,4886,1061,8945,1
4,77,6,4,4,0,0,2,6,0,0,0,0,0,0,0,0,0,0,0,0,2,1,1,11150,4886,1061,8946,1
4,77,6,4,4,0,0,2,6,1,2,1,2,3,3,2,4,0,2,0,0,2,1,1,11150,4886,1061,8947,1
4,77,6,4,4,0,0,2,6,0,0,0,0,0,0,0,0,0,0,0,0,2,1,1,11150,4886,1061,8948,1
4,77,7,5,5,0,0,2,7,0,0,0,0,0,0,0,0,0,0,0,0,2,1,1,11150,4886,1061,8949,1
4,77,6,4,4,0,0,2,6,0,0,0,0,0,0,0,0,0,0,0,0,2,1,1,11150,4886,1061,8950,1
4,77,10,6,6,0,0,4,10,0,0,0,0,0,0,0,0,0,0,0,0,2,1,1,11150,4886,1061,8951,1
4,77,1,1,1,0,0,0,1,0,0,0,0,0,0,0,0,0,0,0,0,2,1,1,11150,4886,1061,8951,1
4,77,14,10,10,0,0,4,14,1,1,1,1,2,2,0,2,0,1,0,0,2,1,1,11150,4886,1061,8952,1
4,77,46,26,30,3,0,12,49,3,6,3,6,9,9,20,28,1,42,2,0,2,1,1,11160,4886,1061,8953,1
28,1364,1178,367,1042,6,15,115,1184,9,94,51,95,103,146,644,976,4,4439,246,0,2,0,2,11160,4886,1061,8954,1
51,2554,1943,715,1694,26,18,214,1969,12,185,120,237,197,357,1436,2721,7,20915,1161,0,2,0,1,11160,4888,1061,8955,1
178,4184,722,423,573,19,0,135,741,12,172,101,199,184,300,1320,2257,6,15668,870,0,2,1,1,11160,4890,1061,8957,0
178,4184,1508,847,911,44,250,301,1552,14,148,88,169,162,257,1120,1886,7,15077,837,0,2,1,1,11160,4891,1062,8958,0
179,4219,722,423,573,19,0,135,741,12,172,101,199,184,300,1320,2257,6,15668,870,0,2,4,1,11160,4893,1062,8960,1
179,4219,1508,847,911,44,250,301,1552,14,148,88,169,162,257,1120,1886,7,15077,837,0,2,4,1,11160,4894,1063,8961,1
10,498,722,423,573,19,0,135,741,12,172,101,199,184,300,1320,2257,6,15668,870,0,2,1,1,11160,4896,1063,8963,1
209,4519,72,33,56,0,4,12,72,1,1,1,1,2,2,0,2,0,1,0,0,2,3,0,11160,4896,1063,8964,1
209,4519,1454,835,1044,76,110,219,1530,17,275,158,296,292,454,2297,3718,9,34017,1889,1,2,3,0,11170,4897,1063,8965,1
87,1925,1043,504,840,53,9,147,1096,9,180,112,198,189,310,1377,2344,4,11604,644,0,2,5,3,11170,4899,1063,8966,1
87,1925,383,288,292,26,6,62,409,11,65,38,67,76,105,429,656,5,3719,206,0,2,5,3,11170,4900,1063,8967,1
28,438,1098,241,925,5,10,155,1103,7,46,25,49,53,74,273,423,3,1580,87,0,2,34,2,11180,4902,1063,8968,1
28,438,282,202,222,14,2,44,296,8,42,24,43,50,67,250,378,4,1548,86,0,2,34,2,11180,4903,1063,8969,1
38,1504,1043,504,840,53,9,147,1096,9,180,112,198,189,310,1377,2344,4,11604,644,0,2,11,0,11180,4905,1063,8970,1
10,396,1098,241,925,5,10,155,1103,7,46,25,49,53,74,273,423,3,1580,87,0,2,62,0,11190,4907,1063,8971,1
19,477,1293,570,1093,25,15,163,1318,10,195,123,241,205,364,1516,2795,6,17273,959,0,2,1,4,11200,4909,1063,8972,1
87,1925,1043,504,840,53,9,147,1096,9,180,112,198,189,310,1377,2344,4,11604,644,0,2,3,1,11200,4911,1063,8973,1
87,1925,383,288,292,26,6,62,409,11,65,38,67,76,105,429,656,5,3719,206,0,2,3,1,11200,4912,1063,8974,1
151,2856,1943,715,1694,26,18,214,1969,12,185,120,237,197,357,1436,2721,7,20915,1161,0,2,16,5,11200,4914,1063,8975,1
151,2856,1168,838,957,57,25,144,1225,19,348,224,416,367,640,3018,5452,11,61921,3440,1,2,16,5,11210,4916,1063,8976,1
6,287,42,7,35,4,0,5,46,1,2,1,2,3,3,2,4,0,2,0,0,2,1,1,11210,4916,1063,8977,1
6,287,11,6,10,0,0,1,11,2,4,2,4,6,6,10,15,1,15,0,0,2,1,1,11210,4916,1063,8978,1
16,635,1293,570,1093,25,15,163,1318,10,195,123,241,205,364,1516,2795,6,17273,959,0,2,8,0,11220,4918,1063,8979,1
6,287,42,7,35,4,0,5,46,1,2,1,2,3,3,2,4,0,2,0,0,2,3,3,11220,4918,1063,8980,1
6,287,11,6,10,0,0,1,11,2,4,2,4,6,6,10,15,1,15,0,0,2,3,3,11220,4918,1063,8981,1
6,287,42,7,35,4,0,5,46,1,2,1,2,3,3,2,4,0,2,0,0,2,2,2,11220,4918,1063,8982,1
6,287,11,6,10,0,0,1,11,2,4,2,4,6,6,10,15,1,15,0,0,2,2,2,11220,4918,1063,8983,1
1,192,382,65,130,157,2,92,539,4,10,5,10,14,15,41,57,2,114,6,0,2,1,0,11220,4919,1064,8984,1
28,458,1098,241,925,5,10,155,1103,7,46,25,49,53,74,273,423,3,1580,87,0,2,2,0,11230,4921,1064,8985,1
28,458,282,202,222,14,2,44,296,8,42,24,43,50,67,250,378,4,1548,86,0,2,2,0,11230,4922,1064,8986,1
6,287,42,7,35,4,0,5,46,1,2,1,2,3,3,2,4,0,2,0,0,2,1,1,11230,4922,1064,8987,1
6,287,11,6,10,0,0,1,11,2,4,2,4,6,6,10,15,1,15,0,0,2,1,1,11230,4922,1064,8988,1
11,426,1098,241,925,5,10,155,1103,7,46,25,49,53,74,273,423,3,1580,87,0,2,21,1,11240,4924,1064,8989,1
37,1034,1523,757,1297,19,12,193,1542,12,193,117,230,205,347,1508,2664,7,19053,1058,0,2,1,2,11250,4926,1064,8990,1
37,1034,701,378,504,33,58,109,734,13,110,68,126,123,194,794,1346,7,10027,557,0,2,1,2,11250,4927,1065,8991,1
181,4234,722,423,573,19,0,135,741,12,172,101,199,184,300,1320,2257,6,15668,870,0,2,10,4,11250,4929,1065,8993,1
181,4234,1508,847,911,44,250,301,1552,14,148,88,169,162,257,1120,1886,7,15077,837,0,2,10,4,11250,4930,1066,8994,1
19,478,1293,570,1093,25,15,163,1318,10,195,123,241,205,364,1516,2795,6,17273,959,0,2,2,2,11260,4932,1066,8996,1
36,627,1098,241,925,5,10,155,1103,7,46,25,49,53,74,273,423,3,1580,87,0,2,31,4,11270,4934,1066,8997,1
36,627,282,202,222,14,2,44,296,8,42,24,43,50,67,250,378,4,1548,86,0,2,31,4,11270,4935,1066,8998,1
6,287,42,7,35,4,0,5,46,1,2,1,2,3,3,2,4,0,2,0,0,2,1,1,11270,4935,1066,8999,1
6,287,11,6,10,0,0,1,11,2,4,2,4,6,6,10,15,1,15,0,0,2,1,1,11270,4935,1066,9000,1
15,570,1098,241,925,5,10,155,1103,7,46,25,49,53,74,273,423,3,1580,87,0,2,104,0,11280,4937,1066,9001,1
37,640,1098,241,925,5,10,155,1103,7,46,25,49,53,74,273,423,3,1580,87,0,2,4,2,11290,4939,1066,9002,1
37,640,282,202,222,14,2,44,296,8,42,24,43,50,67,250,378,4,1548,86,0,2,4,2,11290,4940,1066,9003,1
16,591,1098,241,925,5,10,155,1103,7,46,25,49,53,74,273,423,3,1580,87,0,2,32,0,11300,4942,1066,9004,1
16,591,1098,241,925,5,10,155,1103,7,46,25,49,53,74,273,423,3,1580,87,0,2,11,5,11310,4944,1066,9005,0
38,659,1098,241,925,5,10,155,1103,7,46,25,49,53,74,273,423,3,1580,87,0,2,5,5,11320,4946,1066,9006,1
38,659,282,202,222,14,2,44,296,8,42,24,43,50,67,250,378,4,1548,86,0,2,5,5,11320,4947,1066,9007,1
18,710,1098,241,925,5,10,155,1103,7,46,25,49,53,74,273,423,3,1580,87,0,2,43,3,11330,4949,1066,9008,1
183,4253,722,423,573,19,0,135,741,12,172,101,199,184,300,1320,2257,6,15668,870,0,2,3,1,11330,4951,1066,9010,1
183,4253,1508,847,911,44,250,301,1552,14,148,88,169,162,257,1120,1886,7,15077,837,0,2,3,1,11330,4952,1067,9011,1
39,708,1098,241,925,5,10,155,1103,7,46,25,49,53,74,273,423,3,1580,87,0,2,11,5,11340,4954,1067,9012,1
39,708,282,202,222,14,2,44,296,8,42,24,43,50,67,250,378,4,1548,86,0,2,11,5,11340,4955,1067,9013,1
6,287,42,7,35,4,0,5,46,1,2,1,2,3,3,2,4,0,2,0,0,2,1,1,11340,4955,1067,9014,1
6,287,11,6,10,0,0,1,11,2,4,2,4,6,6,10,15,1,15,0,0,2,1,1,11340,4955,1067,9015,1
19,732,1098,241,925,5,10,155,1103,7,46,25,49,53,74,273,423,3,1580,87,0,2,60,54,11350,4957,1067,9016,1
209,4519,72,33,56,0,4,12,72,1,1,1,1,2,2,0,2,0,1,0,0,2,3,3,11350,4957,1067,9017,1
209,4519,1454,835,1044,76,110,219,1530,17,275,158,296,292,454,2297,3718,9,34017,1889,1,2,3,3,11360,4958,1067,9018,1
38,1518,1043,504,840,53,9,147,1096,9,180,112,198,189,310,1377,2344,4,11604,644,0,2,5,1,11360,4960,1067,9019,1
135,2629,1457,730,1242,11,6,188,1468,10,292,166,329,302,495,2424,4078,5,22973,1276,1,2,8,0,11360,4962,1067,9020,1
135,2629,74,35,59,1,0,14,75,3,14,7,14,17,21,58,85,1,128,7,0,2,8,0,11360,4963,1067,9021,1
135,2629,245,125,200,5,7,34,250,7,30,17,34,37,51,166,265,3,1053,58,0,2,8,0,11370,4964,1067,9022,1
213,4623,72,33,56,0,4,12,72,1,1,1,1,2,2,0,2,0,1,0,0,2,21,4,11370,4964,1067,9023,1
213,4623,1454,835,1044,76,110,219,1530,17,275,158,296,292,454,2297,3718,9,34017,1889,1,2,21,4,11380,4965,1067,9024,1
210,4583,72,33,56,0,4,12,72,1,1,1,1,2,2,0,2,0,1,0,0,2,8,15,11380,4965,1067,9025,1
210,4583,1454,835,1044,76,110,219,1530,17,275,158,296,292,454,2297,3718,9,34017,1889,1,2,8,15,11390,4966,1067,9026,1
132,3087,373,158,315,8,0,51,381,5,76,44,79,81,123,486,779,2,2026,112,0,2,3,0,11390,4966,1067,9027,1
212,4586,72,33,56,0,4,12,72,1,1,1,1,2,2,0,2,0,1,0,0,2,1,1,11390,4966,1067,9028,0
212,4586,1454,835,1044,76,110,219,1530,17,275,158,296,292,454,2297,3718,9,34017,1889,1,2,1,1,11400,4967,1067,9029,0
34,863,74,35,59,1,0,14,75,3,14,7,14,17,21,58,85,1,128,7,0,2,2,1,11410,4969,1067,9042,1
34,863,245,125,200,5,7,34,250,7,30,17,34,37,51,166,265,3,1053,58,0,2,2,1,11420,4970,1067,9043,1
212,4586,72,33,56,0,4,12,72,1,1,1,1,2,2,0,2,0,1,0,0,2,22,21,11420,4970,1067,9044,1
212,4586,1454,835,1044,76,110,219,1530,17,275,158,296,292,454,2297,3718,9,34017,1889,1,2,22,21,11430,4971,1067,9045,1
1,192,382,65,130,157,2,92,539,4,10,5,10,14,15,41,57,2,114,6,0,2,2,0,11430,4972,1068,9046,1
52,901,282,196,195,3,0,86,285,8,130,71,141,138,212,936,1507,4,6538,363,0,2,85,81,11430,4972,1069,9047,1
6,287,42,7,35,4,0,5,46,1,2,1,2,3,3,2,4,0,2,0,0,2,1,1,11430,4972,1069,9048,1
6,287,11,6,10,0,0,1,11,2,4,2,4,6,6,10,15,1,15,0,0,2,1,1,11430,4972,1069,9049,1
46,860,1098,241,925,5,10,155,1103,7,46,25,49,53,74,273,423,3,1580,87,0,2,18,0,11440,4974,1069,9050,1
46,860,282,202,222,14,2,44,296,8,42,24,43,50,67,250,378,4,1548,86,0,2,18,0,11440,4975,1069,9051,1
19,752,1098,241,925,5,10,155,1103,7,46,25,49,53,74,273,423,3,1580,87,0,2,26,3,11450,4977,1069,9052,1
6,287,42,7,35,4,0,5,46,1,2,1,2,3,3,2,4,0,2,0,0,2,1,1,11450,4977,1069,9053,0
6,287,11,6,10,0,0,1,11,2,4,2,4,6,6,10,15,1,15,0,0,2,1,1,11450,4977,1069,9054,0
152,2888,1943,715,1694,26,18,214,1969,12,185,120,237,197,357,1436,2721,7,20915,1161,0,2,3,0,11450,4979,1069,9055,1
152,2888,1168,838,957,57,25,144,1225,19,348,224,416,367,640,3018,5452,11,61921,3440,1,2,3,0,11460,4981,1069,9056,1
6,287,42,7,35,4,0,5,46,1,2,1,2,3,3,2,4,0,2,0,0,2,1,1,11460,4981,1069,9057,1
6,287,11,6,10,0,0,1,11,2,4,2,4,6,6,10,15,1,15,0,0,2,1,1,11460,4981,1069,9058,1
35,1417,1513,682,1277,25,13,200,1538,11,199,116,219,210,335,1557,2584,6,15641,868,0,2,1,0,11460,4983,1069,9059,1
6,287,42,7,35,4,0,5,46,1,2,1,2,3,3,2,4,0,2,0,0,2,2,2,11460,4983,1069,9060,0
6,287,11,6,10,0,0,1,11,2,4,2,4,6,6,10,15,1,15,0,0,2,2,2,11460,4983,1069,9061,0
153,2910,1943,715,1694,26,18,214,1969,12,185,120,237,197,357,1436,2721,7,20915,1161,0,2,4,1,11460,4985,1069,9062,1
153,2910,1168,838,957,57,25,144,1225,19,348,224,416,367,640,3018,5452,11,61921,3440,1,2,4,1,11470,4987,1069,9063,1
1,192,382,65,130,157,2,92,539,4,10,5,10,14,15,41,57,2,114,6,0,2,1,1,11470,4988,1070,9064,1
6,287,42,7,35,4,0,5,46,1,2,1,2,3,3,2,4,0,2,0,0,2,3,3,11470,4988,1070,9065,1
6,287,11,6,10,0,0,1,11,2,4,2,4,6,6,10,15,1,15,0,0,2,3,3,11470,4988,1070,9066,1
185,4279,722,423,573,19,0,135,741,12,172,101,199,184,300,1320,2257,6,15668,870,0,2,2,0,11470,4990,1070,9068,0
185,4279,1508,847,911,44,250,301,1552,14,148,88,169,162,257,1120,1886,7,15077,837,0,2,2,0,11470,4991,1071,9069,0
135,2629,1457,730,1242,11,6,188,1468,10,292,166,329,302,495,2424,4078,5,22973,1276,1,2,1,1,11470,4993,1071,9070,1
135,2629,74,35,59,1,0,14,75,3,14,7,14,17,21,58,85,1,128,7,0,2,1,1,11470,4994,1071,9071,1
135,2629,245,125,200,5,7,34,250,7,30,17,34,37,51,166,265,3,1053,58,0,2,1,1,11480,4995,1071,9072,1
35,881,74,35,59,1,0,14,75,3,14,7,14,17,21,58,85,1,128,7,0,2,5,1,11480,4996,1071,9073,1
35,881,245,125,200,5,7,34,250,7,30,17,34,37,51,166,265,3,1053,58,0,2,5,1,11490,4997,1071,9074,1
132,3088,77,34,69,0,0,8,77,3,24,16,29,27,45,114,213,1,387,21,0,3,2,2,11490,4997,1071,9075,1
132,3088,712,438,573,51,9,84,763,14,102,71,128,116,199,733,1364,8,11988,666,0,3,2,2,11500,4998,1071,9076,1
185,4279,722,423,573,19,0,135,741,12,172,101,199,184,300,1320,2257,6,15668,870,0,2,1,1,11500,5000,1071,9078,1
185,4279,1508,847,911,44,250,301,1552,14,148,88,169,162,257,1120,1886,7,15077,837,0,2,1,1,11500,5001,1072,9079,1
212,4586,72,33,56,0,4,12,72,1,1,1,1,2,2,0,2,0,1,0,0,2,1,1,11500,5001,1072,9080,1
212,4586,1454,835,1044,76,110,219,1530,17,275,158,296,292,454,2297,3718,9,34017,1889,1,2,1,1,11510,5002,1072,9081,1
26,562,215,129,180,6,0,29,221,8,65,43,72,73,115,415,711,4,3153,175,0,2,6,6,11510,5002,1072,9082,1
26,562,97,69,77,3,3,16,100,6,22,13,23,28,36,113,173,3,542,30,0,2,6,6,11510,5003,1072,9083,1
37,1648,1289,550,1043,56,32,155,1345,10,167,93,185,177,278,1266,2075,5,11498,638,0,2,1,1,11510,5005,1073,9084,1
41,2878,1296,573,1062,40,33,157,1336,8,201,118,231,209,349,1561,2689,4,12365,686,0,2,1,1,11510,5005,1073,9085,1
25,1439,1457,730,1242,11,6,188,1468,10,292,166,329,302,495,2424,4078,5,22973,1276,1,2,14,1,11510,5007,1073,9086,1
13,1144,215,129,180,6,0,29,221,8,65,43,72,73,115,415,711,4,3153,175,0,2,2,2,11510,5007,1073,9087,1
23,990,373,158,315,8,0,51,381,5,76,44,79,81,123,486,779,2,2026,112,0,2,2,2,11510,5007,1073,9088,1
65,1200,1513,682,1277,25,13,200,1538,11,199,116,219,210,335,1557,2584,6,15641,868,0,2,3,1,11510,5009,1073,9089,1
65,1200,819,519,539,24,98,155,843,15,96,57,106,111,163,690,1107,8,9171,509,0,2,3,1,11520,5011,1073,9090,1
36,1475,1513,682,1277,25,13,200,1538,11,199,116,219,210,335,1557,2584,6,15641,868,0,2,20,0,11520,5013,1073,9091,1
71,1174,1178,367,1042,6,15,115,1184,9,94,51,95,103,146,644,976,4,4439,246,0,2,12,12,11520,5013,1073,9092,1
71,1174,177,108,140,8,0,27,185,6,30,16,32,36,48,162,248,3,794,44,0,2,12,12,11520,5015,1073,9093,1
30,1431,1178,367,1042,6,15,115,1184,9,94,51,95,103,146,644,976,4,4439,246,0,2,31,0,11520,5015,1073,9094,1
18,611,1455,414,1257,16,76,112,1471,5,41,23,46,46,69,231,381,2,1069,59,0,2,11,6,11520,5016,1073,9095,1
18,611,669,365,481,22,61,110,691,15,103,63,122,118,185,747,1273,8,11311,628,0,2,11,6,11530,5016,1074,9096,1
10,414,1455,414,1257,16,76,112,1471,5,41,23,46,46,69,231,381,2,1069,59,0,2,8,11,11530,5017,1074,9097,1
6,287,42,7,35,4,0,5,46,1,2,1,2,3,3,2,4,0,2,0,0,2,1,1,11530,5017,1074,9098,0
6,287,11,6,10,0,0,1,11,2,4,2,4,6,6,10,15,1,15,0,0,2,1,1,11530,5017,1074,9099,0
136,2646,1457,730,1242,11,6,188,1468,10,292,166,329,302,495,2424,4078,5,22973,1276,1,2,2,0,11530,5019,1074,9100,1
136,2646,74,35,59,1,0,14,75,3,14,7,14,17,21,58,85,1,128,7,0,2,2,0,11530,5020,1074,9101,1
136,2646,245,125,200,5,7,34,250,7,30,17,34,37,51,166,265,3,1053,58,0,2,2,0,11540,5021,1074,9102,1
45,430,647,139,84,35,284,233,682,0,0,0,0,0,0,0,0,0,0,0,0,2,3,1,11540,5021,1074,9103,1
26,1471,1457,730,1242,11,6,188,1468,10,292,166,329,302,495,2424,4078,5,22973,1276,1,2,11,1,11540,5023,1074,9104,1
136,2649,1457,730,1242,11,6,188,1468,10,292,166,329,302,495,2424,4078,5,22973,1276,1,2,3,1,11540,5025,1074,9105,0
136,2649,74,35,59,1,0,14,75,3,14,7,14,17,21,58,85,1,128,7,0,2,3,1,11540,5026,1074,9106,0
136,2649,245,125,200,5,7,34,250,7,30,17,34,37,51,166,265,3,1053,58,0,2,3,1,11550,5027,1074,9107,0
6,287,42,7,35,4,0,5,46,1,2,1,2,3,3,2,4,0,2,0,0,2,1,1,11550,5027,1074,9108,0
6,287,11,6,10,0,0,1,11,2,4,2,4,6,6,10,15,1,15,0,0,2,1,1,11550,5027,1074,9109,0
28,1508,1457,730,1242,11,6,188,1468,10,292,166,329,302,495,2424,4078,5,22973,1276,1,2,9,2,11550,5029,1074,9110,0
136,2649,1457,730,1242,11,6,188,1468,10,292,166,329,302,495,2424,4078,5,22973,1276,1,2,1,1,11550,5031,1074,9111,1
136,2649,74,35,59,1,0,14,75,3,14,7,14,17,21,58,85,1,128,7,0,2,1,1,11550,5032,1074,9112,1
136,2649,245,125,200,5,7,34,250,7,30,17,34,37,51,166,265,3,1053,58,0,2,1,1,11560,5033,1074,9113,1
45,430,647,139,84,35,284,233,682,0,0,0,0,0,0,0,0,0,0,0,0,2,1,1,11560,5033,1074,9114,1
6,287,42,7,35,4,0,5,46,1,2,1,2,3,3,2,4,0,2,0,0,2,1,1,11560,5033,1074,9115,1
6,287,11,6,10,0,0,1,11,2,4,2,4,6,6,10,15,1,15,0,0,2,1,1,11560,5033,1074,9116,1
28,1508,1457,730,1242,11,6,188,1468,10,292,166,329,302,495,2424,4078,5,22973,1276,1,2,1,1,11560,5035,1074,9117,1
43,862,1450,624,1228,12,26,181,1462,14,306,186,354,320,540,2580,4493,8,36391,2021,1,2,3,4,11560,5037,1075,9118,1
40,1688,1289,550,1043,56,32,155,1345,10,167,93,185,177,278,1266,2075,5,11498,638,0,2,6,0,11560,5039,1076,9119,1
27,999,1450,624,1228,12,26,181,1462,14,306,186,354,320,540,2580,4493,8,36391,2021,1,2,11,0,11560,5041,1077,9120,1
47,952,1450,624,1228,12,26,181,1462,14,306,186,354,320,540,2580,4493,8,36391,2021,1,2,14,2,11560,5043,1078,9121,1
56,977,282,196,195,3,0,86,285,8,130,71,141,138,212,936,1507,4,6538,363,0,2,16,0,11560,5043,1079,9122,1
28,1028,1450,624,1228,12,26,181,1462,14,306,186,354,320,540,2580,4493,8,36391,2021,1,2,5,0,11560,5045,1080,9123,1
1,84,13,10,10,0,0,3,13,1,2,1,2,3,3,2,4,0,2,0,0,2,1,1,11560,5045,1080,9124,1
135,2612,1457,730,1242,11,6,188,1468,10,292,166,329,302,495,2424,4078,5,22973,1276,1,2,1,9,11560,5047,1080,9125,1
135,2612,74,35,59,1,0,14,75,3,14,7,14,17,21,58,85,1,128,7,0,2,1,9,11560,5048,1080,9126,1
135,2612,245,125,200,5,7,34,250,7,30,17,34,37,51,166,265,3,1053,58,0,2,1,9,11570,5049,1080,9127,1
25,1227,652,304,544,16,6,88,668,6,89,51,101,95,152,591,998,3,3399,188,0,2,0,15,11570,5050,1080,9128,1
6,287,42,7,35,4,0,5,46,1,2,1,2,3,3,2,4,0,2,0,0,2,1,1,11570,5050,1080,9129,1
6,287,11,6,10,0,0,1,11,2,4,2,4,6,6,10,15,1,15,0,0,2,1,1,11570,5050,1080,9130,1
9,312,424,94,331,4,0,89,428,1,5,5,5,6,10,11,25,0,12,0,0,2,21,18,11570,5051,1080,9131,1
6,287,42,7,35,4,0,5,46,1,2,1,2,3,3,2,4,0,2,0,0,2,2,2,11570,5051,1080,9132,1
6,287,11,6,10,0,0,1,11,2,4,2,4,6,6,10,15,1,15,0,0,2,2,2,11570,5051,1080,9133,1
28,1028,1450,624,1228,12,26,181,1462,14,306,186,354,320,540,2580,4493,8,36391,2021,1,2,1,1,11570,5053,1081,9134,0
41,991,74,35,59,1,0,14,75,3,14,7,14,17,21,58,85,1,128,7,0,2,19,0,11570,5054,1081,9135,1
41,991,245,125,200,5,7,34,250,7,30,17,34,37,51,166,265,3,1053,58,0,2,19,0,11580,5055,1081,9136,1
6,287,42,7,35,4,0,5,46,1,2,1,2,3,3,2,4,0,2,0,0,2,1,1,11580,5055,1081,9137,1
6,287,11,6,10,0,0,1,11,2,4,2,4,6,6,10,15,1,15,0,0,2,1,1,11580,5055,1081,9138,1
28,1512,1457,730,1242,11,6,188,1468,10,292,166,329,302,495,2424,4078,5,22973,1276,1,2,2,0,11580,5057,1081,9139,1
9,271,74,35,59,1,0,14,75,3,14,7,14,17,21,58,85,1,128,7,0,2,12,1,11580,5058,1081,9140,1
213,4608,72,33,56,0,4,12,72,1,1,1,1,2,2,0,2,0,1,0,0,2,5,2,11580,5058,1081,9141,1
213,4608,1454,835,1044,76,110,219,1530,17,275,158,296,292,454,2297,3718,9,34017,1889,1,2,5,2,11590,5059,1081,9142,1
132,3094,77,34,69,0,0,8,77,3,24,16,29,27,45,114,213,1,387,21,0,2,1,0,11590,5059,1081,9143,1
132,3094,712,438,573,51,9,84,763,14,102,71,128,116,199,733,1364,8,11988,666,0,2,1,0,11600,5060,1081,9144,1
213,4618,72,33,56,0,4,12,72,1,1,1,1,2,2,0,2,0,1,0,0,2,14,13,11600,5060,1081,9145,1
213,4618,1454,835,1044,76,110,219,1530,17,275,158,296,292,454,2297,3718,9,34017,1889,1,2,14,13,11610,5061,1081,9146,1
69,1220,1513,682,1277,25,13,200,1538,11,199,116,219,210,335,1557,2584,6,15641,868,0,2,9,3,11610,5063,1081,9147,1
69,1220,819,519,539,24,98,155,843,15,96,57,106,111,163,690,1107,8,9171,509,0,2,9,3,11620,5065,1081,9148,1
133,2620,1457,730,1242,11,6,188,1468,10,292,166,329,302,495,2424,4078,5,22973,1276,1,2,8,5,11620,5067,1081,9149,1
133,2620,74,35,59,1,0,14,75,3,14,7,14,17,21,58,85,1,128,7,0,2,8,5,11620,5068,1081,9150,1
133,2620,245,125,200,5,7,34,250,7,30,17,34,37,51,166,265,3,1053,58,0,2,8,5,11630,5069,1081,9151,1
6,287,42,7,35,4,0,5,46,1,2,1,2,3,3,2,4,0,2,0,0,2,2,2,11630,5069,1081,9152,1
6,287,11,6,10,0,0,1,11,2,4,2,4,6,6,10,15,1,15,0,0,2,2,2,11630,5069,1081,9153,1
38,1602,1513,682,1277,25,13,200,1538,11,199,116,219,210,335,1557,2584,6,15641,868,0,2,34,0,11630,5071,1081,9154,1
51,1024,1450,624,1228,12,26,181,1462,14,306,186,354,320,540,2580,4493,8,36391,2021,1,2,12,1,11630,5073,1082,9155,0
28,1030,1450,624,1228,12,26,181,1462,14,306,186,354,320,540,2580,4493,8,36391,2021,1,2,1,2,11630,5075,1083,9156,0
132,3097,77,34,69,0,0,8,77,3,24,16,29,27,45,114,213,1,387,21,0,2,1,1,11630,5075,1083,9157,1
132,3097,712,438,573,51,9,84,763,14,102,71,128,116,199,733,1364,8,11988,666,0,2,1,1,11640,5076,1083,9158,1
6,287,42,7,35,4,0,5,46,1,2,1,2,3,3,2,4,0,2,0,0,2,2,2,11640,5076,1083,9159,1
6,287,11,6,10,0,0,1,11,2,4,2,4,6,6,10,15,1,15,0,0,2,2,2,11640,5076,1083,9160,1
40,1725,1289,550,1043,56,32,155,1345,10,167,93,185,177,278,1266,2075,5,11498,638,0,2,6,0,11640,5078,1084,9161,1
6,287,42,7,35,4,0,5,46,1,2,1,2,3,3,2,4,0,2,0,0,2,2,2,11640,5078,1084,9162,1
6,287,11,6,10,0,0,1,11,2,4,2,4,6,6,10,15,1,15,0,0,2,2,2,11640,5078,1084,9163,1
40,1725,1289,550,1043,56,32,155,1345,10,167,93,185,177,278,1266,2075,5,11498,638,0,2,1,1,11640,5080,1085,9164,1
40,1725,1289,550,1043,56,32,155,1345,10,167,93,185,177,278,1266,2075,5,11498,638,0,2,1,1,11640,5082,1086,9165,0
135,3145,77,34,69,0,0,8,77,3,24,16,29,27,45,114,213,1,387,21,0,2,6,0,11640,5082,1086,9166,1
135,3145,712,438,573,51,9,84,763,14,102,71,128,116,199,733,1364,8,11988,666,0,2,6,0,11650,5083,1086,9167,1
42,2947,1296,573,1062,40,33,157,1336,8,201,118,231,209,349,1561,2689,4,12365,686,0,2,15,0,11650,5083,1086,9168,1
6,287,42,7,35,4,0,5,46,1,2,1,2,3,3,2,4,0,2,0,0,2,2,2,11650,5083,1086,9169,1
6,287,11,6,10,0,0,1,11,2,4,2,4,6,6,10,15,1,15,0,0,2,2,2,11650,5083,1086,9170,1
46,795,1020,354,843,12,15,144,1032,8,134,77,144,142,221,970,1580,4,6792,377,0,2,2,2,11650,5083,1086,9171,1
213,4618,72,33,56,0,4,12,72,1,1,1,1,2,2,0,2,0,1,0,0,2,11,7,11650,5083,1086,9172,1
213,4618,1454,835,1044,76,110,219,1530,17,275,158,296,292,454,2297,3718,9,34017,1889,1,2,11,7,11660,5084,1086,9173,1
1,192,382,65,130,157,2,92,539,4,10,5,10,14,15,41,57,2,114,6,0,2,6,6,11660,5085,1087,9174,1
51,1027,1450,624,1228,12,26,181,1462,14,306,186,354,320,540,2580,4493,8,36391,2021,1,2,2,2,11660,5087,1088,9175,1
29,1054,1450,624,1228,12,26,181,1462,14,306,186,354,320,540,2580,4493,8,36391,2021,1,2,4,0,11660,5089,1089,9176,1
153,2910,1943,715,1694,26,18,214,1969,12,185,120,237,197,357,1436,2721,7,20915,1161,0,2,1,1,11660,5091,1089,9177,0
153,2910,1168,838,957,57,25,144,1225,19,348,224,416,367,640,3018,5452,11,61921,3440,1,2,1,1,11670,5093,1089,9178,0
213,4618,72,33,56,0,4,12,72,1,1,1,1,2,2,0,2,0,1,0,0,2,4,5,11670,5093,1089,9179,1
213,4618,1454,835,1044,76,110,219,1530,17,275,158,296,292,454,2297,3718,9,34017,1889,1,2,4,5,11680,5094,1089,9180,1
6,287,42,7,35,4,0,5,46,1,2,1,2,3,3,2,4,0,2,0,0,2,1,1,11680,5094,1089,9181,1
6,287,11,6,10,0,0,1,11,2,4,2,4,6,6,10,15,1,15,0,0,2,1,1,11680,5094,1089,9182,1
77,1330,1178,367,1042,6,15,115,1184,9,94,51,95,103,146,644,976,4,4439,246,0,2,35,11,11680,5094,1089,9183,1
77,1330,177,108,140,8,0,27,185,6,30,16,32,36,48,162,248,3,794,44,0,2,35,11,11680,5096,1089,9184,1
6,287,42,7,35,4,0,5,46,1,2,1,2,3,3,2,4,0,2,0,0,2,2,2,11680,5096,1089,9185,1
6,287,11,6,10,0,0,1,11,2,4,2,4,6,6,10,15,1,15,0,0,2,2,2,11680,5096,1089,9186,1
31,1477,1178,367,1042,6,15,115,1184,9,94,51,95,103,146,644,976,4,4439,246,0,2,28,0,11680,5096,1089,9187,1
79,1379,1178,367,1042,6,15,115,1184,9,94,51,95,103,146,644,976,4,4439,246,0,2,12,3,11680,5096,1089,9188,1
79,1379,177,108,140,8,0,27,185,6,30,16,32,36,48,162,248,3,794,44,0,2,12,3,11680,5098,1089,9189,1
6,81,38,23,23,0,0,15,38,0,0,0,0,0,0,0,0,0,0,0,0,2,4,0,11680,5098,1089,9190,1
6,287,42,7,35,4,0,5,46,1,2,1,2,3,3,2,4,0,2,0,0,2,2,2,11680,5098,1089,9191,1
6,287,11,6,10,0,0,1,11,2,4,2,4,6,6,10,15,1,15,0,0,2,2,2,11680,5098,1089,9192,1
33,1542,1178,367,1042,6,15,115,1184,9,94,51,95,103,146,644,976,4,4439,246,0,2,30,0,11680,5098,1089,9193,1
69,1220,1513,682,1277,25,13,200,1538,11,199,116,219,210,335,1557,2584,6,15641,868,0,2,6,8,11680,5100,1089,9194,1
69,1220,819,519,539,24,98,155,843,15,96,57,106,111,163,690,1107,8,9171,509,0,2,6,8,11690,5102,1089,9195,1
24,514,447,308,343,6,5,95,453,7,96,59,111,103,170,651,1136,4,4600,255,0,2,2,2,11690,5105,1089,9196,1
24,514,322,174,179,16,74,51,338,10,41,26,46,51,72,252,408,5,2291,127,0,2,2,2,11690,5108,1090,9197,1
18,462,386,256,301,16,9,68,402,4,59,35,69,63,104,355,621,2,1453,80,0,2,3,0,11690,5108,1090,9198,1
18,462,264,131,164,11,41,46,275,6,38,22,40,44,62,214,338,3,1068,59,0,2,3,0,11700,5108,1091,9199,1
12,359,442,244,305,14,16,103,456,11,68,45,75,79,120,452,756,6,4588,254,0,2,1,1,11700,5110,1091,9200,1
12,359,182,102,99,11,40,35,193,3,11,6,11,14,17,42,64,1,97,5,0,2,1,1,11700,5111,1091,9201,1
217,4664,72,33,56,0,4,12,72,1,1,1,1,2,2,0,2,0,1,0,0,2,15,6,11700,5111,1091,9202,1
217,4664,1454,835,1044,76,110,219,1530,17,275,158,296,292,454,2297,3718,9,34017,1889,1,2,15,6,11710,5112,1091,9203,1
6,287,42,7,35,4,0,5,46,1,2,1,2,3,3,2,4,0,2,0,0,2,1,1,11710,5112,1091,9204,1
6,287,11,6,10,0,0,1,11,2,4,2,4,6,6,10,15,1,15,0,0,2,1,1,11710,5112,1091,9205,1
137,3174,77,34,69,0,0,8,77,3,24,16,29,27,45,114,213,1,387,21,0,2,8,3,11710,5112,1091,9206,1
137,3174,712,438,573,51,9,84,763,14,102,71,128,116,199,733,1364,8,11988,666,0,2,8,3,11720,5113,1091,9207,1
217,4677,72,33,56,0,4,12,72,1,1,1,1,2,2,0,2,0,1,0,0,2,7,4,11720,5113,1091,9208,1
217,4677,1454,835,1044,76,110,219,1530,17,275,158,296,292,454,2297,3718,9,34017,1889,1,2,7,4,11730,5114,1091,9209,1
42,2917,1296,573,1062,40,33,157,1336,8,201,118,231,209,349,1561,2689,4,12365,686,0,2,0,5,11730,5114,1091,9210,1
217,4674,72,33,56,0,4,12,72,1,1,1,1,2,2,0,2,0,1,0,0,2,1,1,11730,5114,1091,9211,0
217,4674,1454,835,1044,76,110,219,1530,17,275,158,296,292,454,2297,3718,9,34017,1889,1,2,1,1,11740,5115,1091,9212,0
33,1551,1178,367,1042,6,15,115,1184,9,94,51,95,103,146,644,976,4,4439,246,0,2,1,0,11740,5115,1091,9213,1
47,903,1098,241,925,5,10,155,1103,7,46,25,49,53,74,273,423,3,1580,87,0,2,4,0,11750,5117,1091,9214,1
47,903,282,202,222,14,2,44,296,8,42,24,43,50,67,250,378,4,1548,86,0,2,4,0,11750,5118,1091,9215,1
20,782,1098,241,925,5,10,155,1103,7,46,25,49,53,74,273,423,3,1580,87,0,2,12,0,11760,5120,1091,9216,1
6,287,42,7,35,4,0,5,46,1,2,1,2,3,3,2,4,0,2,0,0,2,1,1,11760,5120,1091,9217,1
6,287,11,6,10,0,0,1,11,2,4,2,4,6,6,10,15,1,15,0,0,2,1,1,11760,5120,1091,9218,1
217,4677,72,33,56,0,4,12,72,1,1,1,1,2,2,0,2,0,1,0,0,2,1,1,11760,5120,1091,9219,1
217,4677,1454,835,1044,76,110,219,1530,17,275,158,296,292,454,2297,3718,9,34017,1889,1,2,1,1,11770,5121,1091,9220,1
146,2815,1943,715,1694,26,18,214,1969,12,185,120,237,197,357,1436,2721,7,20915,1161,0,2,47,63,11770,5123,1091,9221,1
146,2815,1168,838,957,57,25,144,1225,19,348,224,416,367,640,3018,5452,11,61921,3440,1,2,47,63,11780,5125,1091,9222,1
6,287,42,7,35,4,0,5,46,1,2,1,2,3,3,2,4,0,2,0,0,2,1,1,11780,5125,1091,9223,1
6,287,11,6,10,0,0,1,11,2,4,2,4,6,6,10,15,1,15,0,0,2,1,1,11780,5125,1091,9224,1
40,1725,1289,550,1043,56,32,155,1345,10,167,93,185,177,278,1266,2075,5,11498,638,0,2,3,1,11780,5127,1092,9225,1
43,2933,1296,573,1062,40,33,157,1336,8,201,118,231,209,349,1561,2689,4,12365,686,0,2,2,0,11780,5127,1092,9226,1
51,2363,1943,715,1694,26,18,214,1969,12,185,120,237,197,357,1436,2721,7,20915,1161,0,2,28,47,11780,5129,1092,9227,1
19,483,1293,570,1093,25,15,163,1318,10,195,123,241,205,364,1516,2795,6,17273,959,0,2,4,1,11790,5131,1092,9228,0
6,287,42,7,35,4,0,5,46,1,2,1,2,3,3,2,4,0,2,0,0,2,1,1,11790,5131,1092,9229,0
6,287,11,6,10,0,0,1,11,2,4,2,4,6,6,10,15,1,15,0,0,2,1,1,11790,5131,1092,9230,0
38,958,74,35,59,1,0,14,75,3,14,7,14,17,21,58,85,1,128,7,0,2,3,8,11790,5132,1092,9231,1
38,958,245,125,200,5,7,34,250,7,30,17,34,37,51,166,265,3,1053,58,0,2,3,8,11800,5133,1092,9232,1
138,3212,77,34,69,0,0,8,77,3,24,16,29,27,45,114,213,1,387,21,0,2,7,1,11800,5133,1092,9233,1
138,3212,712,438,573,51,9,84,763,14,102,71,128,116,199,733,1364,8,11988,666,0,2,7,1,11810,5134,1092,9234,1
6,287,42,7,35,4,0,5,46,1,2,1,2,3,3,2,4,0,2,0,0,2,1,1,11810,5134,1092,9235,1
6,287,11,6,10,0,0,1,11,2,4,2,4,6,6,10,15,1,15,0,0,2,1,1,11810,5134,1092,9236,1
146,2822,1943,715,1694,26,18,214,1969,12,185,120,237,197,357,1436,2721,7,20915,1161,0,2,2,2,11810,5136,1092,9237,1
146,2822,1168,838,957,57,25,144,1225,19,348,224,416,367,640,3018,5452,11,61921,3440,1,2,2,2,11820,5138,1092,9238,1
52,2433,1943,715,1694,26,18,214,1969,12,185,120,237,197,357,1436,2721,7,20915,1161,0,2,16,1,11820,5140,1092,9239,1
141,2820,1943,715,1694,26,18,214,1969,12,185,120,237,197,357,1436,2721,7,20915,1161,0,2,10,10,11820,5142,1092,9240,1
141,2820,1168,838,957,57,25,144,1225,19,348,224,416,367,640,3018,5452,11,61921,3440,1,2,10,10,11830,5144,1092,9241,1
6,287,42,7,35,4,0,5,46,1,2,1,2,3,3,2,4,0,2,0,0,2,1,1,11830,5144,1092,9242,1
6,287,11,6,10,0,0,1,11,2,4,2,4,6,6,10,15,1,15,0,0,2,1,1,11830,5144,1092,9243,1
87,1920,1043,504,840,53,9,147,1096,9,180,112,198,189,310,1377,2344,4,11604,644,0,2,1,1,11830,5146,1092,9244,0
87,1920,383,288,292,26,6,62,409,11,65,38,67,76,105,429,656,5,3719,206,0,2,1,1,11830,5147,1092,9245,0
6,287,42,7,35,4,0,5,46,1,2,1,2,3,3,2,4,0,2,0,0,2,2,2,11830,5147,1092,9246,0
6,287,11,6,10,0,0,1,11,2,4,2,4,6,6,10,15,1,15,0,0,2,2,2,11830,5147,1092,9247,0
6,287,42,7,35,4,0,5,46,1,2,1,2,3,3,2,4,0,2,0,0,2,2,2,11830,5147,1092,9248,1
6,287,11,6,10,0,0,1,11,2,4,2,4,6,6,10,15,1,15,0,0,2,2,2,11830,5147,1092,9249,1
215,4654,72,33,56,0,4,12,72,1,1,1,1,2,2,0,2,0,1,0,0,2,5,11,11830,5147,1092,9250,1
215,4654,1454,835,1044,76,110,219,1530,17,275,158,296,292,454,2297,3718,9,34017,1889,1,2,5,11,11840,5148,1092,9251,1
6,287,42,7,35,4,0,5,46,1,2,1,2,3,3,2,4,0,2,0,0,2,1,1,11840,5148,1092,9252,1
6,287,11,6,10,0,0,1,11,2,4,2,4,6,6,10,15,1,15,0,0,2,1,1,11840,5148,1092,9253,1
135,2677,1457,730,1242,11,6,188,1468,10,292,166,329,302,495,2424,4078,5,22973,1276,1,2,10,0,11840,5150,1092,9254,1
135,2677,74,35,59,1,0,14,75,3,14,7,14,17,21,58,85,1,128,7,0,2,10,0,11840,5151,1092,9255,1
135,2677,245,125,200,5,7,34,250,7,30,17,34,37,51,166,265,3,1053,58,0,2,10,0,11850,5152,1092,9256,1
38,1068,1523,757,1297,19,12,193,1542,12,193,117,230,205,347,1508,2664,7,19053,1058,0,2,7,1,11860,5154,1092,9257,1
38,1068,701,378,504,33,58,109,734,13,110,68,126,123,194,794,1346,7,10027,557,0,2,7,1,11860,5155,1093,9258,1
6,287,42,7,35,4,0,5,46,1,2,1,2,3,3,2,4,0,2,0,0,2,1,1,11860,5155,1093,9259,1
6,287,11,6,10,0,0,1,11,2,4,2,4,6,6,10,15,1,15,0,0,2,1,1,11860,5155,1093,9260,1
20,1484,1523,757,1297,19,12,193,1542,12,193,117,230,205,347,1508,2664,7,19053,1058,0,2,20,0,11870,5157,1093,9261,1
185,4301,722,423,573,19,0,135,741,12,172,101,199,184,300,1320,2257,6,15668,870,0,2,3,2,11880,5163,1094,9270,1
185,4301,1508,847,911,44,250,301,1552,14,148,88,169,162,257,1120,1886,7,15077,837,0,2,3,2,11880,5164,1095,9271,1
12,529,722,423,573,19,0,135,741,12,172,101,199,184,300,1320,2257,6,15668,870,0,2,10,0,11880,5166,1095,9273,1
40,1244,1523,757,1297,19,12,193,1542,12,193,117,230,205,347,1508,2664,7,19053,1058,0,2,43,1,11890,5168,1095,9274,1
40,1244,701,378,504,33,58,109,734,13,110,68,126,123,194,794,1346,7,10027,557,0,2,43,1,11890,5169,1096,9275,1
28,1749,1523,757,1297,19,12,193,1542,12,193,117,230,205,347,1508,2664,7,19053,1058,0,2,68,0,11900,5171,1096,9276,1
138,3216,77,34,69,0,0,8,77,3,24,16,29,27,45,114,213,1,387,21,0,2,1,1,11900,5171,1096,9277,1
138,3216,712,438,573,51,9,84,763,14,102,71,128,116,199,733,1364,8,11988,666,0,2,1,1,11910,5172,1096,9278,1
41,1799,1289,550,1043,56,32,155,1345,10,167,93,185,177,278,1266,2075,5,11498,638,0,2,20,0,11910,5174,1097,9279,1
50,1020,1450,624,1228,12,26,181,1462,14,306,186,354,320,540,2580,4493,8,36391,2021,1,2,2,4,11920,5180,1099,9287,1
137,2699,1457,730,1242,11,6,188,1468,10,292,166,329,302,495,2424,4078,5,22973,1276,1,2,6,1,11920,5182,1099,9288,1
137,2699,74,35,59,1,0,14,75,3,14,7,14,17,21,58,85,1,128,7,0,2,6,1,11920,5183,1099,9289,1
137,2699,245,125,200,5,7,34,250,7,30,17,34,37,51,166,265,3,1053,58,0,2,6,1,11930,5184,1099,9290,1
11,351,442,244,305,14,16,103,456,11,68,45,75,79,120,452,756,6,4588,254,0,2,2,5,11930,5186,1099,9291,1
11,351,182,102,99,11,40,35,193,3,11,6,11,14,17,42,64,1,97,5,0,2,2,5,11930,5187,1099,9292,1
6,287,42,7,35,4,0,5,46,1,2,1,2,3,3,2,4,0,2,0,0,2,1,1,11930,5187,1099,9293,1
6,287,11,6,10,0,0,1,11,2,4,2,4,6,6,10,15,1,15,0,0,2,1,1,11930,5187,1099,9294,1
42,1842,1289,550,1043,56,32,155,1345,10,167,93,185,177,278,1266,2075,5,11498,638,0,2,13,0,11930,5189,1100,9295,1
29,1058,1450,624,1228,12,26,181,1462,14,306,186,354,320,540,2580,4493,8,36391,2021,1,2,2,1,11930,5191,1101,9296,1
6,287,42,7,35,4,0,5,46,1,2,1,2,3,3,2,4,0,2,0,0,2,1,1,11940,5195,1102,9304,0
6,287,11,6,10,0,0,1,11,2,4,2,4,6,6,10,15,1,15,0,0,2,1,1,11940,5195,1102,9305,0
1,162,382,65,130,157,2,92,539,4,10,5,10,14,15,41,57,2,114,6,0,2,1,1,11950,5200,1104,9313,0
6,287,42,7,35,4,0,5,46,1,2,1,2,3,3,2,4,0,2,0,0,2,1,1,11950,5200,1104,9314,0
6,287,11,6,10,0,0,1,11,2,4,2,4,6,6,10,15,1,15,0,0,2,1,1,11950,5200,1104,9315,0
1,179,382,65,130,157,2,92,539,4,10,5,10,14,15,41,57,2,114,6,0,2,2,1,11960,5205,1106,9323,0
6,287,42,7,35,4,0,5,46,1,2,1,2,3,3,2,4,0,2,0,0,2,1,1,11960,5205,1106,9324,0
6,287,11,6,10,0,0,1,11,2,4,2,4,6,6,10,15,1,15,0,0,2,1,1,11960,5205,1106,9325,0
46,437,647,139,84,35,284,233,682,0,0,0,0,0,0,0,0,0,0,0,0,2,3,0,11960,5205,1106,9326,0
216,4677,72,33,56,0,4,12,72,1,1,1,1,2,2,0,2,0,1,0,0,2,13,8,11960,5205,1106,9327,0
216,4677,1454,835,1044,76,110,219,1530,17,275,158,296,292,454,2297,3718,9,34017,1889,1,2,13,8,11970,5206,1106,9328,0
6,287,42,7,35,4,0,5,46,1,2,1,2,3,3,2,4,0,2,0,0,2,1,1,11980,5210,1107,9336,1
6,287,11,6,10,0,0,1,11,2,4,2,4,6,6,10,15,1,15,0,0,2,1,1,11980,5210,1107,9337,1
57,2323,1660,832,1314,41,38,274,1701,20,312,209,395,332,604,2671,5058,12,64042,3557,1,0,295,0,11980,5212,1108,9339,1
57,999,1660,832,1314,41,38,274,1701,20,312,209,395,332,604,2671,5058,12,64042,3557,1,0,195,0,11980,5214,1109,9341,1
63,2372,1660,832,1314,41,38,274,1701,20,312,209,395,332,604,2671,5058,12,64042,3557,1,2,11,3,11980,5216,1110,9343,1
62,1194,1660,832,1314,41,38,274,1701,20,312,209,395,332,604,2671,5058,12,64042,3557,1,2,26,2,11980,5218,1111,9345,1
64,2382,1660,832,1314,41,38,274,1701,20,312,209,395,332,604,2671,5058,12,64042,3557,1,2,8,4,11980,5220,1112,9347,0
63,2389,1660,832,1314,41,38,274,1701,20,312,209,395,332,604,2671,5058,12,64042,3557,1,2,8,5,11980,5222,1113,9349,0
63,1225,1660,832,1314,41,38,274,1701,20,312,209,395,332,604,2671,5058,12,64042,3557,1,2,5,0,11980,5224,1114,9351,0
63,2373,1660,832,1314,41,38,274,1701,20,312,209,395,332,604,2671,5058,12,64042,3557,1,2,0,2,11980,5226,1115,9353,0
48,451,647,139,84,35,284,233,682,0,0,0,0,0,0,0,0,0,0,0,0,2,6,0,11980,5226,1115,9354,0
217,4699,72,33,56,0,4,12,72,1,1,1,1,2,2,0,2,0,1,0,0,2,3,0,11980,5226,1115,9355,0
217,4699,1454,835,1044,76,110,219,1530,17,275,158,296,292,454,2297,3718,9,34017,1889,1,2,3,0,11990,5227,1115,9356,0
68,2438,1660,832,1314,41,38,274,1701,20,312,209,395,332,604,2671,5058,12,64042,3557,1,2,14,3,11990,5229,1116,9358,0
60,1255,1450,624,1228,12,26,181,1462,14,306,186,354,320,540,2580,4493,8,36391,2021,1,2,56,0,11990,5231,1117,9359,0
68,2414,1660,832,1314,41,38,274,1701,20,312,209,395,332,604,2671,5058,12,64042,3557,1,2,1,2,11990,5233,1118,9361,0
69,2432,1660,832,1314,41,38,274,1701,20,312,209,395,332,604,2671,5058,12,64042,3557,1,2,4,1,11990,5235,1119,9363,0
63,1270,1660,832,1314,41,38,274,1701,20,312,209,395,332,604,2671,5058,12,64042,3557,1,2,9,6,11990,5237,1120,9365,0
69,2456,1660,832,1314,41,38,274,1701,20,312,209,395,332,604,2671,5058,12,64042,3557,1,2,5,2,11990,5239,1121,9367,1
63,1306,1660,832,1314,41,38,274,1701,20,312,209,395,332,604,2671,5058,12,64042,3557,1,2,6,0,11990,5241,1122,9369,1
69,2456,1660,832,1314,41,38,274,1701,20,312,209,395,332,604,2671,5058,12,64042,3557,1,2,2,2,11990,5243,1123,9371,0
70,2461,1660,832,1314,41,38,274,1701,20,312,209,395,332,604,2671,5058,12,64042,3557,1,2,5,1,11990,5245,1124,9373,1
64,1371,1660,832,1314,41,38,274,1701,20,312,209,395,332,604,2671,5058,12,64042,3557,1,2,8,0,11990,5247,1125,9375,1
61,1266,1450,624,1228,12,26,181,1462,14,306,186,354,320,540,2580,4493,8,36391,2021,1,2,18,15,11990,5249,1126,9376,1
30,1106,1450,624,1228,12,26,181,1462,14,306,186,354,320,540,2580,4493,8,36391,2021,1,2,7,0,11990,5251,1127,9377,0
71,2472,1660,832,1314,41,38,274,1701,20,312,209,395,332,604,2671,5058,12,64042,3557,1,2,5,1,11990,5253,1128,9379,0
70,1443,1660,832,1314,41,38,274,1701,20,312,209,395,332,604,2671,5058,12,64042,3557,1,2,14,0,11990,5255,1129,9381,0
70,1449,1660,832,1314,41,38,274,1701,20,312,209,395,332,604,2671,5058,12,64042,3557,1,2,1,1,11990,5257,1130,9383,1
71,2475,1660,832,1314,41,38,274,1701,20,312,209,395,332,604,2671,5058,12,64042,3557,1,2,1,1,11990,5259,1131,9385,0
70,1452,1660,832,1314,41,38,274,1701,20,312,209,395,332,604,2671,5058,12,64042,3557,1,2,1,1,11990,5261,1132,9387,1
217,4701,72,33,56,0,4,12,72,1,1,1,1,2,2,0,2,0,1,0,0,2,4,3,11990,5261,1132,9388,0
217,4701,1454,835,1044,76,110,219,1530,17,275,158,296,292,454,2297,3718,9,34017,1889,1,2,4,3,12000,5262,1132,9389,0
61,1268,2,2,2,0,0,0,2,0,0,0,0,0,0,0,0,0,0,0,0,3,1,1,12000,5262,1132,9389,0
61,1268,99,48,90,1,3,5,100,0,0,0,0,0,0,0,0,0,0,0,0,3,1,1,12000,5263,1132,9390,0
61,1268,8,5,5,2,0,1,10,0,0,0,0,0,0,0,0,0,0,0,0,3,1,1,12000,5263,1132,9391,0
61,1268,1217,716,841,84,126,174,1301,14,185,118,215,199,333,1446,2542,8,20687,1149,0,3,1,1,12010,5265,1132,9392,0
61,1268,160,89,115,0,13,31,160,7,15,11,17,22,28,78,124,3,495,27,0,3,1,1,12010,5265,1132,9393,0
61,1268,10,10,9,9,0,0,19,0,0,0,0,0,0,0,0,0,0,0,0,3,1,1,12010,5265,1133,9394,0
61,1268,173,84,99,8,29,36,181,5,12,7,13,17,20,54,81,2,221,12,0,3,1,1,12010,5266,1133,9395,0
61,1268,3,1,1,3,0,0,6,0,0,0,0,0,0,0,0,0,0,0,0,3,1,1,12010,5266,1133,9396,0
71,2475,1660,832,1314,41,38,274,1701,20,312,209,395,332,604,2671,5058,12,64042,3557,1,3,1,1,12010,5268,1134,9398,0
71,2475,1057,646,719,113,100,145,1170,18,215,134,248,233,382,1740,3004,10,31186,1732,1,3,1,1,12020,5269,1135,9399,0
70,1454,1660,832,1314,41,38,274,1701,20,312,209,395,332,604,2671,5058,12,64042,3557,1,2,1,1,12020,5271,1136,9401,0
71,1528,2,2,2,0,0,0,2,0,0,0,0,0,0,0,0,0,0,0,0,2,51,3,12020,5271,1136,9401,1
71,1528,99,48,90,1,3,5,100,0,0,0,0,0,0,0,0,0,0,0,0,2,51,3,12020,5272,1136,9402,1
71,1528,8,5,5,2,0,1,10,0,0,0,0,0,0,0,0,0,0,0,0,2,51,3,12020,5272,1136,9403,1
71,1528,1217,716,841,84,126,174,1301,14,185,118,215,199,333,1446,2542,8,20687,1149,0,2,51,3,12030,5274,1136,9404,1
71,1528,160,89,115,0,13,31,160,7,15,11,17,22,28,78,124,3,495,27,0,2,51,3,12030,5274,1136,9405,1
71,1528,10,10,9,9,0,0,19,0,0,0,0,0,0,0,0,0,0,0,0,2,51,3,12030,5274,1137,9406,1
71,1528,173,84,99,8,29,36,181,5,12,7,13,17,20,54,81,2,221,12,0,2,51,3,12030,5275,1137,9407,1
71,1528,3,1,1,3,0,0,6,0,0,0,0,0,0,0,0,0,0,0,0,2,51,3,12030,5275,1137,9408,1
71,2478,1660,832,1314,41,38,274,1701,20,312,209,395,332,604,2671,5058,12,64042,3557,1,2,11,10,12030,5277,1138,9410,1
71,2478,1057,646,719,113,100,145,1170,18,215,134,248,233,382,1740,3004,10,31186,1732,1,2,11,10,12040,5278,1139,9411,1
30,1102,1450,624,1228,12,26,181,1462,14,306,186,354,320,540,2580,4493,8,36391,2021,1,2,6,5,12040,5280,1140,9412,1
70,1450,1660,832,1314,41,38,274,1701,20,312,209,395,332,604,2671,5058,12,64042,3557,1,2,5,4,12040,5282,1141,9414,1
20,449,2,2,2,0,0,0,2,0,0,0,0,0,0,0,0,0,0,0,0,2,3,185,12040,5282,1141,9414,1
20,449,99,48,90,1,3,5,100,0,0,0,0,0,0,0,0,0,0,0,0,2,3,185,12040,5283,1141,9415,1
20,449,8,5,5,2,0,1,10,0,0,0,0,0,0,0,0,0,0,0,0,2,3,185,12040,5283,1141,9416,1
20,449,1217,716,841,84,126,174,1301,14,185,118,215,199,333,1446,2542,8,20687,1149,0,2,3,185,12050,5285,1141,9417,1
20,449,160,89,115,0,13,31,160,7,15,11,17,22,28,78,124,3,495,27,0,2,3,185,12050,5285,1141,9418,1
20,449,10,10,9,9,0,0,19,0,0,0,0,0,0,0,0,0,0,0,0,2,3,185,12050,5285,1142,9419,1
20,449,173,84,99,8,29,36,181,5,12,7,13,17,20,54,81,2,221,12,0,2,3,185,12050,5286,1142,9420,1
20,449,3,1,1,3,0,0,6,0,0,0,0,0,0,0,0,0,0,0,0,2,3,185,12050,5286,1142,9421,1
71,2471,1660,832,1314,41,38,274,1701,20,312,209,395,332,604,2671,5058,12,64042,3557,1,2,10,10,12050,5288,1143,9423,1
71,2471,1057,646,719,113,100,145,1170,18,215,134,248,233,382,1740,3004,10,31186,1732,1,2,10,10,12060,5289,1144,9424,1
30,1104,1450,624,1228,12,26,181,1462,14,306,186,354,320,540,2580,4493,8,36391,2021,1,2,5,5,12060,5291,1145,9425,1
70,1452,1660,832,1314,41,38,274,1701,20,312,209,395,332,604,2671,5058,12,64042,3557,1,2,11,11,12060,5293,1146,9427,1
20,449,2,2,2,0,0,0,2,0,0,0,0,0,0,0,0,0,0,0,0,2,1,1,12060,5293,1146,9427,0
20,449,99,48,90,1,3,5,100,0,0,0,0,0,0,0,0,0,0,0,0,2,1,1,12060,5294,1146,9428,0
20,449,8,5,5,2,0,1,10,0,0,0,0,0,0,0,0,0,0,0,0,2,1,1,12060,5294,1146,9429,0
20,449,1217,716,841,84,126,174,1301,14,185,118,215,199,333,1446,2542,8,20687,1149,0,2,1,1,12070,5296,1146,9430,0
20,449,160,89,115,0,13,31,160,7,15,11,17,22,28,78,124,3,495,27,0,2,1,1,12070,5296,1146,9431,0
20,449,10,10,9,9,0,0,19,0,0,0,0,0,0,0,0,0,0,0,0,2,1,1,12070,5296,1147,9432,0
20,449,173,84,99,8,29,36,181,5,12,7,13,17,20,54,81,2,221,12,0,2,1,1,12070,5297,1147,9433,0
20,449,3,1,1,3,0,0,6,0,0,0,0,0,0,0,0,0,0,0,0,2,1,1,12070,5297,1147,9434,0
20,449,2,2,2,0,0,0,2,0,0,0,0,0,0,0,0,0,0,0,0,2,1,1,12070,5297,1147,9434,0
20,449,99,48,90,1,3,5,100,0,0,0,0,0,0,0,0,0,0,0,0,2,1,1,12070,5298,1147,9435,0
20,449,8,5,5,2,0,1,10,0,0,0,0,0,0,0,0,0,0,0,0,2,1,1,12070,5298,1147,9436,0
20,449,1217,716,841,84,126,174,1301,14,185,118,215,199,333,1446,2542,8,20687,1149,0,2,1,1,12080,5300,1147,9437,0
20,449,160,89,115,0,13,31,160,7,15,11,17,22,28,78,124,3,495,27,0,2,1,1,12080,5300,1147,9438,0
20,449,10,10,9,9,0,0,19,0,0,0,0,0,0,0,0,0,0,0,0,2,1,1,12080,5300,1148,9439,0
20,449,173,84,99,8,29,36,181,5,12,7,13,17,20,54,81,2,221,12,0,2,1,1,12080,5301,1148,9440,0
20,449,3,1,1,3,0,0,6,0,0,0,0,0,0,0,0,0,0,0,0,2,1,1,12080,5301,1148,9441,0
51,1084,477,336,357,30,23,73,507,16,194,134,250,210,384,1538,2962,10,30538,1696,0,0,191,0,12090,5302,1148,9442,1
20,449,2,2,2,0,0,0,2,0,0,0,0,0,0,0,0,0,0,0,0,2,0,4,12090,5302,1148,9442,0
20,449,99,48,90,1,3,5,100,0,0,0,0,0,0,0,0,0,0,0,0,2,0,4,12090,5303,1148,9443,0
20,449,8,5,5,2,0,1,10,0,0,0,0,0,0,0,0,0,0,0,0,2,0,4,12090,5303,1148,9444,0
20,449,1217,716,841,84,126,174,1301,14,185,118,215,199,333,1446,2542,8,20687,1149,0,2,0,4,12100,5305,1148,9445,0
20,449,160,89,115,0,13,31,160,7,15,11,17,22,28,78,124,3,495,27,0,2,0,4,12100,5305,1148,9446,0
20,449,10,10,9,9,0,0,19,0,0,0,0,0,0,0,0,0,0,0,0,2,0,4,12100,5305,1149,9447,0
20,449,173,84,99,8,29,36,181,5,12,7,13,17,20,54,81,2,221,12,0,2,0,4,12100,5306,1149,9448,0
20,449,3,1,1,3,0,0,6,0,0,0,0,0,0,0,0,0,0,0,0,2,0,4,12100,5306,1149,9449,0
24,552,2,2,2,0,0,0,2,0,0,0,0,0,0,0,0,0,0,0,0,2,21,6,12100,5306,1149,9449,1
24,552,99,48,90,1,3,5,100,0,0,0,0,0,0,0,0,0,0,0,0,2,21,6,12100,5307,1149,9450,1
24,552,8,5,5,2,0,1,10,0,0,0,0,0,0,0,0,0,0,0,0,2,21,6,12100,5307,1149,9451,1
24,552,1217,716,841,84,126,174,1301,14,185,118,215,199,333,1446,2542,8,20687,1149,0,2,21,6,12110,5309,1149,9452,1
24,552,160,89,115,0,13,31,160,7,15,11,17,22,28,78,124,3,495,27,0,2,21,6,12110,5309,1149,9453,1
24,552,10,10,9,9,0,0,19,0,0,0,0,0,0,0,0,0,0,0,0,2,21,6,12110,5309,1150,9454,1
24,552,173,84,99,8,29,36,181,5,12,7,13,17,20,54,81,2,221,12,0,2,21,6,12110,5310,1150,9455,1
24,552,3,1,1,3,0,0,6,0,0,0,0,0,0,0,0,0,0,0,0,2,21,6,12110,5310,1150,9456,1
38,936,74,35,59,1,0,14,75,3,14,7,14,17,21,58,85,1,128,7,0,2,0,3,12110,5311,1150,9457,1
38,936,245,125,200,5,7,34,250,7,30,17,34,37,51,166,265,3,1053,58,0,2,0,3,12120,5312,1150,9458,1
34,1230,1450,624,1228,12,26,181,1462,14,306,186,354,320,540,2580,4493,8,36391,2021,1,2,25,3,12120,5314,1151,9459,1
25,694,2,2,2,0,0,0,2,0,0,0,0,0,0,0,0,0,0,0,0,2,14,1,12120,5314,1151,9459,0
25,694,99,48,90,1,3,5,100,0,0,0,0,0,0,0,0,0,0,0,0,2,14,1,12120,5315,1151,9460,0
25,694,8,5,5,2,0,1,10,0,0,0,0,0,0,0,0,0,0,0,0,2,14,1,12120,5315,1151,9461,0
25,694,1217,716,841,84,126,174,1301,14,185,118,215,199,333,1446,2542,8,20687,1149,0,2,14,1,12130,5317,1151,9462,0
25,694,160,89,115,0,13,31,160,7,15,11,17,22,28,78,124,3,495,27,0,2,14,1,12130,5317,1151,9463,0
25,694,10,10,9,9,0,0,19,0,0,0,0,0,0,0,0,0,0,0,0,2,14,1,12130,5317,1152,9464,0
25,694,173,84,99,8,29,36,181,5,12,7,13,17,20,54,81,2,221,12,0,2,14,1,12130,5318,1152,9465,0
25,694,3,1,1,3,0,0,6,0,0,0,0,0,0,0,0,0,0,0,0,2,14,1,12130,5318,1152,9466,0
25,694,2,2,2,0,0,0,2,0,0,0,0,0,0,0,0,0,0,0,0,2,2,2,12130,5318,1152,9466,0
25,694,99,48,90,1,3,5,100,0,0,0,0,0,0,0,0,0,0,0,0,2,2,2,12130,5319,1152,9467,0
25,694,8,5,5,2,0,1,10,0,0,0,0,0,0,0,0,0,0,0,0,2,2,2,12130,5319,1152,9468,0
25,694,1217,716,841,84,126,174,1301,14,185,118,215,199,333,1446,2542,8,20687,1149,0,2,2,2,12140,5321,1152,9469,0
25,694,160,89,115,0,13,31,160,7,15,11,17,22,28,78,124,3,495,27,0,2,2,2,12140,5321,1152,9470,0
25,694,10,10,9,9,0,0,19,0,0,0,0,0,0,0,0,0,0,0,0,2,2,2,12140,5321,1153,9471,0
25,694,173,84,99,8,29,36,181,5,12,7,13,17,20,54,81,2,221,12,0,2,2,2,12140,5322,1153,9472,0
25,694,3,1,1,3,0,0,6,0,0,0,0,0,0,0,0,0,0,0,0,2,2,2,12140,5322,1153,9473,0
43,2933,1296,573,1062,40,33,157,1336,8,201,118,231,209,349,1561,2689,4,12365,686,0,2,7,7,12140,5322,1153,9474,0
185,4381,722,423,573,19,0,135,741,12,172,101,199,184,300,1320,2257,6,15668,870,0,2,11,3,12140,5324,1153,9476,1
185,4381,1508,847,911,44,250,301,1552,14,148,88,169,162,257,1120,1886,7,15077,837,0,2,11,3,12140,5325,1154,9477,1
217,4703,72,33,56,0,4,12,72,1,1,1,1,2,2,0,2,0,1,0,0,2,2,2,12140,5325,1154,9478,1
217,4703,1454,835,1044,76,110,219,1530,17,275,158,296,292,454,2297,3718,9,34017,1889,1,2,2,2,12150,5326,1154,9479,1
86,1908,1043,504,840,53,9,147,1096,9,180,112,198,189,310,1377,2344,4,11604,644,0,2,10,12,12150,5328,1154,9480,1
86,1908,383,288,292,26,6,62,409,11,65,38,67,76,105,429,656,5,3719,206,0,2,10,12,12150,5329,1154,9481,1
26,708,2,2,2,0,0,0,2,0,0,0,0,0,0,0,0,0,0,0,0,2,4,5,12150,5329,1154,9481,0
26,708,99,48,90,1,3,5,100,0,0,0,0,0,0,0,0,0,0,0,0,2,4,5,12150,5330,1154,9482,0
26,708,8,5,5,2,0,1,10,0,0,0,0,0,0,0,0,0,0,0,0,2,4,5,12150,5330,1154,9483,0
26,708,1217,716,841,84,126,174,1301,14,185,118,215,199,333,1446,2542,8,20687,1149,0,2,4,5,12160,5332,1154,9484,0
26,708,160,89,115,0,13,31,160,7,15,11,17,22,28,78,124,3,495,27,0,2,4,5,12160,5332,1154,9485,0
26,708,10,10,9,9,0,0,19,0,0,0,0,0,0,0,0,0,0,0,0,2,4,5,12160,5332,1155,9486,0
26,708,173,84,99,8,29,36,181,5,12,7,13,17,20,54,81,2,221,12,0,2,4,5,12160,5333,1155,9487,0
26,708,3,1,1,3,0,0,6,0,0,0,0,0,0,0,0,0,0,0,0,2,4,5,12160,5333,1155,9488,0
43,2933,1296,573,1062,40,33,157,1336,8,201,118,231,209,349,1561,2689,4,12365,686,0,2,1,1,12160,5333,1155,9489,0
185,4406,722,423,573,19,0,135,741,12,172,101,199,184,300,1320,2257,6,15668,870,0,2,2,0,12160,5335,1155,9491,0
185,4406,1508,847,911,44,250,301,1552,14,148,88,169,162,257,1120,1886,7,15077,837,0,2,2,0,12160,5336,1156,9492,0
185,4406,722,423,573,19,0,135,741,12,172,101,199,184,300,1320,2257,6,15668,870,0,2,1,1,12160,5338,1156,9494,0
185,4406,1508,847,911,44,250,301,1552,14,148,88,169,162,257,1120,1886,7,15077,837,0,2,1,1,12160,5339,1157,9495,0
49,458,647,139,84,35,284,233,682,0,0,0,0,0,0,0,0,0,0,0,0,2,3,0,12160,5339,1157,9496,0
218,4722,72,33,56,0,4,12,72,1,1,1,1,2,2,0,2,0,1,0,0,2,4,1,12160,5339,1157,9497,0
218,4722,1454,835,1044,76,110,219,1530,17,275,158,296,292,454,2297,3718,9,34017,1889,1,2,4,1,12170,5340,1157,9498,0
50,465,647,139,84,35,284,233,682,0,0,0,0,0,0,0,0,0,0,0,0,2,3,0,12170,5340,1157,9499,0
139,3230,77,34,69,0,0,8,77,3,24,16,29,27,45,114,213,1,387,21,0,2,4,1,12170,5340,1157,9500,0
139,3230,712,438,573,51,9,84,763,14,102,71,128,116,199,733,1364,8,11988,666,0,2,4,1,12180,5341,1157,9501,0
139,3237,77,34,69,0,0,8,77,3,24,16,29,27,45,114,213,1,387,21,0,2,2,1,12180,5341,1157,9502,1
139,3237,712,438,573,51,9,84,763,14,102,71,128,116,199,733,1364,8,11988,666,0,2,2,1,12190,5342,1157,9503,1
141,3267,77,34,69,0,0,8,77,3,24,16,29,27,45,114,213,1,387,21,0,2,12,5,12190,5342,1157,9504,1
141,3267,712,438,573,51,9,84,763,14,102,71,128,116,199,733,1364,8,11988,666,0,2,12,5,12200,5343,1157,9505,1
219,4731,72,33,56,0,4,12,72,1,1,1,1,2,2,0,2,0,1,0,0,2,4,2,12200,5343,1157,9506,1
219,4731,1454,835,1044,76,110,219,1530,17,275,158,296,292,454,2297,3718,9,34017,1889,1,2,4,2,12210,5344,1157,9507,1
49,458,647,139,84,35,284,233,682,0,0,0,0,0,0,0,0,0,0,0,0,2,0,3,12210,5344,1157,9508,1
140,3253,77,34,69,0,0,8,77,3,24,16,29,27,45,114,213,1,387,21,0,2,1,4,12210,5344,1157,9509,1
140,3253,712,438,573,51,9,84,763,14,102,71,128,116,199,733,1364,8,11988,666,0,2,1,4,12220,5345,1157,9510,1
142,3276,77,34,69,0,0,8,77,3,24,16,29,27,45,114,213,1,387,21,0,2,11,6,12220,5345,1157,9511,1
142,3276,712,438,573,51,9,84,763,14,102,71,128,116,199,733,1364,8,11988,666,0,2,11,6,12230,5346,1157,9512,1
29,742,2,2,2,0,0,0,2,0,0,0,0,0,0,0,0,0,0,0,0,2,25,16,12230,5346,1157,9512,0
29,742,99,48,90,1,3,5,100,0,0,0,0,0,0,0,0,0,0,0,0,2,25,16,12230,5347,1157,9513,0
29,742,8,5,5,2,0,1,10,0,0,0,0,0,0,0,0,0,0,0,0,2,25,16,12230,5347,1157,9514,0
29,742,1217,716,841,84,126,174,1301,14,185,118,215,199,333,1446,2542,8,20687,1149,0,2,25,16,12240,5349,1157,9515,0
29,742,160,89,115,0,13,31,160,7,15,11,17,22,28,78,124,3,495,27,0,2,25,16,12240,5349,1157,9516,0
29,742,10,10,9,9,0,0,19,0,0,0,0,0,0,0,0,0,0,0,0,2,25,16,12240,5349,1158,9517,0
29,742,173,84,99,8,29,36,181,5,12,7,13,17,20,54,81,2,221,12,0,2,25,16,12240,5350,1158,9518,0
29,742,3,1,1,3,0,0,6,0,0,0,0,0,0,0,0,0,0,0,0,2,25,16,12240,5350,1158,9519,0
47,444,647,139,84,35,284,233,682,0,0,0,0,0,0,0,0,0,0,0,0,2,0,6,12240,5350,1158,9520,0
218,4707,72,33,56,0,4,12,72,1,1,1,1,2,2,0,2,0,1,0,0,2,1,5,12240,5350,1158,9521,0
218,4707,1454,835,1044,76,110,219,1530,17,275,158,296,292,454,2297,3718,9,34017,1889,1,2,1,5,12250,5351,1158,9522,0
35,1250,1450,624,1228,12,26,181,1462,14,306,186,354,320,540,2580,4493,8,36391,2021,1,2,4,0,12250,5353,1159,9523,0
29,742,2,2,2,0,0,0,2,0,0,0,0,0,0,0,0,0,0,0,0,2,5,1,12250,5353,1159,9523,1
29,742,99,48,90,1,3,5,100,0,0,0,0,0,0,0,0,0,0,0,0,2,5,1,12250,5354,1159,9524,1
29,742,8,5,5,2,0,1,10,0,0,0,0,0,0,0,0,0,0,0,0,2,5,1,12250,5354,1159,9525,1
29,742,1217,716,841,84,126,174,1301,14,185,118,215,199,333,1446,2542,8,20687,1149,0,2,5,1,12260,5356,1159,9526,1
29,742,160,89,115,0,13,31,160,7,15,11,17,22,28,78,124,3,495,27,0,2,5,1,12260,5356,1159,9527,1
29,742,10,10,9,9,0,0,19,0,0,0,0,0,0,0,0,0,0,0,0,2,5,1,12260,5356,1160,9528,1
29,742,173,84,99,8,29,36,181,5,12,7,13,17,20,54,81,2,221,12,0,2,5,1,12260,5357,1160,9529,1
29,742,3,1,1,3,0,0,6,0,0,0,0,0,0,0,0,0,0,0,0,2,5,1,12260,5357,1160,9530,1
29,742,2,2,2,0,0,0,2,0,0,0,0,0,0,0,0,0,0,0,0,2,2,2,12260,5357,1160,9530,0
29,742,99,48,90,1,3,5,100,0,0,0,0,0,0,0,0,0,0,0,0,2,2,2,12260,5358,1160,9531,0
29,742,8,5,5,2,0,1,10,0,0,0,0,0,0,0,0,0,0,0,0,2,2,2,12260,5358,1160,9532,0
29,742,1217,716,841,84,126,174,1301,14,185,118,215,199,333,1446,2542,8,20687,1149,0,2,2,2,12270,5360,1160,9533,0
29,742,160,89,115,0,13,31,160,7,15,11,17,22,28,78,124,3,495,27,0,2,2,2,12270,5360,1160,9534,0
29,742,10,10,9,9,0,0,19,0,0,0,0,0,0,0,0,0,0,0,0,2,2,2,12270,5360,1161,9535,0
29,742,173,84,99,8,29,36,181,5,12,7,13,17,20,54,81,2,221,12,0,2,2,2,12270,5361,1161,9536,0
29,742,3,1,1,3,0,0,6,0,0,0,0,0,0,0,0,0,0,0,0,2,2,2,12270,5361,1161,9537,0
72,2533,1660,832,1314,41,38,274,1701,20,312,209,395,332,604,2671,5058,12,64042,3557,1,2,8,1,12270,5363,1162,9539,1
72,2533,1057,646,719,113,100,145,1170,18,215,134,248,233,382,1740,3004,10,31186,1732,1,2,8,1,12280,5364,1163,9540,1
29,742,2,2,2,0,0,0,2,0,0,0,0,0,0,0,0,0,0,0,0,2,7,8,12280,5364,1163,9540,1
29,742,99,48,90,1,3,5,100,0,0,0,0,0,0,0,0,0,0,0,0,2,7,8,12280,5365,1163,9541,1
29,742,8,5,5,2,0,1,10,0,0,0,0,0,0,0,0,0,0,0,0,2,7,8,12280,5365,1163,9542,1
29,742,1217,716,841,84,126,174,1301,14,185,118,215,199,333,1446,2542,8,20687,1149,0,2,7,8,12290,5367,1163,9543,1
29,742,160,89,115,0,13,31,160,7,15,11,17,22,28,78,124,3,495,27,0,2,7,8,12290,5367,1163,9544,1
29,742,10,10,9,9,0,0,19,0,0,0,0,0,0,0,0,0,0,0,0,2,7,8,12290,5367,1164,9545,1
29,742,173,84,99,8,29,36,181,5,12,7,13,17,20,54,81,2,221,12,0,2,7,8,12290,5368,1164,9546,1
29,742,3,1,1,3,0,0,6,0,0,0,0,0,0,0,0,0,0,0,0,2,7,8,12290,5368,1164,9547,1
40,1258,1523,757,1297,19,12,193,1542,12,193,117,230,205,347,1508,2664,7,19053,1058,0,2,1,1,12300,5370,1164,9548,1
40,1258,701,378,504,33,58,109,734,13,110,68,126,123,194,794,1346,7,10027,557,0,2,1,1,12300,5371,1165,9549,1
29,1824,1523,757,1297,19,12,193,1542,12,193,117,230,205,347,1508,2664,7,19053,1058,0,2,14,1,12310,5373,1165,9550,1
40,1252,1523,757,1297,19,12,193,1542,12,193,117,230,205,347,1508,2664,7,19053,1058,0,2,2,3,12330,5379,1166,9558,1
40,1252,701,378,504,33,58,109,734,13,110,68,126,123,194,794,1346,7,10027,557,0,2,2,3,12330,5380,1167,9559,1
6,287,42,7,35,4,0,5,46,1,2,1,2,3,3,2,4,0,2,0,0,2,1,1,12330,5380,1167,9560,1
6,287,11,6,10,0,0,1,11,2,4,2,4,6,6,10,15,1,15,0,0,2,1,1,12330,5380,1167,9561,1
30,1887,1523,757,1297,19,12,193,1542,12,193,117,230,205,347,1508,2664,7,19053,1058,0,2,12,0,12340,5382,1167,9562,1
18,628,1455,414,1257,16,76,112,1471,5,41,23,46,46,69,231,381,2,1069,59,0,2,1,1,12340,5383,1167,9563,1
18,628,669,365,481,22,61,110,691,15,103,63,122,118,185,747,1273,8,11311,628,0,2,1,1,12350,5383,1168,9564,1
11,473,1455,414,1257,16,76,112,1471,5,41,23,46,46,69,231,381,2,1069,59,0,2,15,0,12350,5384,1168,9565,1
40,1262,1523,757,1297,19,12,193,1542,12,193,117,230,205,347,1508,2664,7,19053,1058,0,2,2,1,12360,5386,1168,9566,1
40,1262,701,378,504,33,58,109,734,13,110,68,126,123,194,794,1346,7,10027,557,0,2,2,1,12360,5387,1169,9567,1
30,1873,1523,757,1297,19,12,193,1542,12,193,117,230,205,347,1508,2664,7,19053,1058,0,2,2,2,12370,5389,1169,9568,1
6,287,42,7,35,4,0,5,46,1,2,1,2,3,3,2,4,0,2,0,0,2,2,2,12370,5389,1169,9569,0
6,287,11,6,10,0,0,1,11,2,4,2,4,6,6,10,15,1,15,0,0,2,2,2,12370,5389,1169,9570,0
30,1880,1523,757,1297,19,12,193,1542,12,193,117,230,205,347,1508,2664,7,19053,1058,0,2,1,1,12380,5391,1169,9571,0
30,1887,1523,757,1297,19,12,193,1542,12,193,117,230,205,347,1508,2664,7,19053,1058,0,2,1,1,12390,5393,1169,9572,0
30,1887,1523,757,1297,19,12,193,1542,12,193,117,230,205,347,1508,2664,7,19053,1058,0,2,1,1,12400,5395,1169,9573,0
25,697,2,2,2,0,0,0,2,0,0,0,0,0,0,0,0,0,0,0,0,2,16,25,12400,5395,1169,9573,1
25,697,99,48,90,1,3,5,100,0,0,0,0,0,0,0,0,0,0,0,0,2,16,25,12400,5396,1169,9574,1
25,697,8,5,5,2,0,1,10,0,0,0,0,0,0,0,0,0,0,0,0,2,16,25,12400,5396,1169,9575,1
25,697,1217,716,841,84,126,174,1301,14,185,118,215,199,333,1446,2542,8,20687,1149,0,2,16,25,12410,5398,1169,9576,1
25,697,160,89,115,0,13,31,160,7,15,11,17,22,28,78,124,3,495,27,0,2,16,25,12410,5398,1169,9577,1
25,697,10,10,9,9,0,0,19,0,0,0,0,0,0,0,0,0,0,0,0,2,16,25,12410,5398,1170,9578,1
25,697,173,84,99,8,29,36,181,5,12,7,13,17,20,54,81,2,221,12,0,2,16,25,12410,5399,1170,9579,1
25,697,3,1,1,3,0,0,6,0,0,0,0,0,0,0,0,0,0,0,0,2,16,25,12410,5399,1170,9580,1
46,437,647,139,84,35,284,233,682,0,0,0,0,0,0,0,0,0,0,0,0,2,0,3,12410,5399,1170,9581,1
218,4708,72,33,56,0,4,12,72,1,1,1,1,2,2,0,2,0,1,0,0,2,7,5,12410,5399,1170,9582,1
218,4708,1454,835,1044,76,110,219,1530,17,275,158,296,292,454,2297,3718,9,34017,1889,1,2,7,5,12420,5400,1170,9583,1
11,475,1455,414,1257,16,76,112,1471,5,41,23,46,46,69,231,381,2,1069,59,0,2,1,1,12420,5401,1170,9584,0
25,697,2,2,2,0,0,0,2,0,0,0,0,0,0,0,0,0,0,0,0,0,128,0,12430,5405,1171,9591,1
25,697,99,48,90,1,3,5,100,0,0,0,0,0,0,0,0,0,0,0,0,0,128,0,12430,5406,1171,9592,1
25,697,8,5,5,2,0,1,10,0,0,0,0,0,0,0,0,0,0,0,0,0,128,0,12430,5406,1171,9593,1
25,697,1217,716,841,84,126,174,1301,14,185,118,215,199,333,1446,2542,8,20687,1149,0,0,128,0,12440,5408,1171,9594,1
25,697,160,89,115,0,13,31,160,7,15,11,17,22,28,78,124,3,495,27,0,0,128,0,12440,5408,1171,9595,1
25,697,10,10,9,9,0,0,19,0,0,0,0,0,0,0,0,0,0,0,0,0,128,0,12440,5408,1172,9596,1
25,697,173,84,99,8,29,36,181,5,12,7,13,17,20,54,81,2,221,12,0,0,128,0,12440,5409,1172,9597,1
25,697,3,1,1,3,0,0,6,0,0,0,0,0,0,0,0,0,0,0,0,0,128,0,12440,5409,1172,9598,1
72,2533,1660,832,1314,41,38,274,1701,20,312,209,395,332,604,2671,5058,12,64042,3557,1,0,340,0,12440,5411,1173,9600,1
72,2533,1057,646,719,113,100,145,1170,18,215,134,248,233,382,1740,3004,10,31186,1732,1,0,340,0,12450,5412,1174,9601,1
51,1084,477,336,357,30,23,73,507,16,194,134,250,210,384,1538,2962,10,30538,1696,0,3,54,40,12460,5413,1174,9602,1
38,936,74,35,59,1,0,14,75,3,14,7,14,17,21,58,85,1,128,7,0,2,0,3,12460,5414,1174,9603,1
38,936,245,125,200,5,7,34,250,7,30,17,34,37,51,166,265,3,1053,58,0,2,0,3,12470,5415,1174,9604,1
142,3276,77,34,69,0,0,8,77,3,24,16,29,27,45,114,213,1,387,21,0,2,25,12,12470,5415,1174,9605,1
142,3276,712,438,573,51,9,84,763,14,102,71,128,116,199,733,1364,8,11988,666,0,2,25,12,12480,5416,1174,9606,1
185,4406,722,423,573,19,0,135,741,12,172,101,199,184,300,1320,2257,6,15668,870,0,2,14,4,12480,5418,1174,9608,1
185,4406,1508,847,911,44,250,301,1552,14,148,88,169,162,257,1120,1886,7,15077,837,0,2,14,4,12480,5419,1175,9609,1
218,4708,72,33,56,0,4,12,72,1,1,1,1,2,2,0,2,0,1,0,0,2,12,5,12480,5419,1175,9610,1
218,4708,1454,835,1044,76,110,219,1530,17,275,158,296,292,454,2297,3718,9,34017,1889,1,2,12,5,12490,5420,1175,9611,1
86,1908,1043,504,840,53,9,147,1096,9,180,112,198,189,310,1377,2344,4,11604,644,0,2,10,12,12490,5422,1175,9612,1
86,1908,383,288,292,26,6,62,409,11,65,38,67,76,105,429,656,5,3719,206,0,2,10,12,12490,5423,1175,9613,1
6,287,42,7,35,4,0,5,46,1,2,1,2,3,3,2,4,0,2,0,0,2,2,2,12490,5423,1175,9614,1
6,287,11,6,10,0,0,1,11,2,4,2,4,6,6,10,15,1,15,0,0,2,2,2,12490,5423,1175,9615,1
35,1250,1450,624,1228,12,26,181,1462,14,306,186,354,320,540,2580,4493,8,36391,2021,1,2,42,8,12490,5425,1176,9616,1
70,1452,1660,832,1314,41,38,274,1701,20,312,209,395,332,604,2671,5058,12,64042,3557,1,0,256,0,12490,5427,1177,9618,1
43,2933,1296,573,1062,40,33,157,1336,8,201,118,231,209,349,1561,2689,4,12365,686,0,2,8,8,12490,5427,1177,9619,1
218,4708,72,33,56,0,4,12,72,1,1,1,1,2,2,0,2,0,1,0,0,2,1,1,12500,5431,1178,9627,0
218,4708,1454,835,1044,76,110,219,1530,17,275,158,296,292,454,2297,3718,9,34017,1889,1,2,1,1,12510,5432,1178,9628,0
6,288,42,7,35,4,0,5,46,1,2,1,2,3,3,2,4,0,2,0,0,2,2,2,12510,5432,1178,9629,0
6,288,11,6,10,0,0,1,11,2,4,2,4,6,6,10,15,1,15,0,0,2,2,2,12510,5432,1178,9630,0
6,288,42,7,35,4,0,5,46,1,2,1,2,3,3,2,4,0,2,0,0,2,4,4,12510,5432,1178,9631,1
6,288,11,6,10,0,0,1,11,2,4,2,4,6,6,10,15,1,15,0,0,2,4,4,12510,5432,1178,9632,1
46,795,1020,354,843,12,15,144,1032,8,134,77,144,142,221,970,1580,4,6792,377,0,2,1,1,12510,5432,1178,9633,1
36,1391,1020,354,843,12,15,144,1032,8,134,77,144,142,221,970,1580,4,6792,377,0,2,5,0,12510,5432,1178,9634,1
144,3295,77,34,69,0,0,8,77,3,24,16,29,27,45,114,213,1,387,21,0,2,8,3,12510,5432,1178,9635,1
144,3295,712,438,573,51,9,84,763,14,102,71,128,116,199,733,1364,8,11988,666,0,2,8,3,12520,5433,1178,9636,1
43,1893,1289,550,1043,56,32,155,1345,10,167,93,185,177,278,1266,2075,5,11498,638,0,2,13,0,12520,5435,1179,9637,1
45,430,647,139,84,35,284,233,682,0,0,0,0,0,0,0,0,0,0,0,0,2,0,3,12530,5439,1180,9645,1
217,4685,72,33,56,0,4,12,72,1,1,1,1,2,2,0,2,0,1,0,0,2,8,13,12530,5439,1180,9646,1
217,4685,1454,835,1044,76,110,219,1530,17,275,158,296,292,454,2297,3718,9,34017,1889,1,2,8,13,12540,5440,1180,9647,1
6,288,42,7,35,4,0,5,46,1,2,1,2,3,3,2,4,0,2,0,0,2,2,2,12540,5440,1180,9648,1
6,288,11,6,10,0,0,1,11,2,4,2,4,6,6,10,15,1,15,0,0,2,2,2,12540,5440,1180,9649,1
25,697,2,2,2,0,0,0,2,0,0,0,0,0,0,0,0,0,0,0,0,2,2,2,12540,5440,1180,9649,0
25,697,99,48,90,1,3,5,100,0,0,0,0,0,0,0,0,0,0,0,0,2,2,2,12540,5441,1180,9650,0
25,697,8,5,5,2,0,1,10,0,0,0,0,0,0,0,0,0,0,0,0,2,2,2,12540,5441,1180,9651,0
25,697,1217,716,841,84,126,174,1301,14,185,118,215,199,333,1446,2542,8,20687,1149,0,2,2,2,12550,5443,1180,9652,0
25,697,160,89,115,0,13,31,160,7,15,11,17,22,28,78,124,3,495,27,0,2,2,2,12550,5443,1180,9653,0
25,697,10,10,9,9,0,0,19,0,0,0,0,0,0,0,0,0,0,0,0,2,2,2,12550,5443,1181,9654,0
25,697,173,84,99,8,29,36,181,5,12,7,13,17,20,54,81,2,221,12,0,2,2,2,12550,5444,1181,9655,0
25,697,3,1,1,3,0,0,6,0,0,0,0,0,0,0,0,0,0,0,0,2,2,2,12550,5444,1181,9656,0
43,1893,1289,550,1043,56,32,155,1345,10,167,93,185,177,278,1266,2075,5,11498,638,0,2,1,1,12550,5446,1182,9657,1
52,2433,1943,715,1694,26,18,214,1969,12,185,120,237,197,357,1436,2721,7,20915,1161,0,2,1,1,12550,5448,1182,9658,1
58,1208,477,336,357,30,23,73,507,16,194,134,250,210,384,1538,2962,10,30538,1696,0,2,22,0,12560,5449,1182,9659,1
70,1452,1660,832,1314,41,38,274,1701,20,312,209,395,332,604,2671,5058,12,64042,3557,1,2,6,12,12560,5451,1183,9661,1
72,2533,1660,832,1314,41,38,274,1701,20,312,209,395,332,604,2671,5058,12,64042,3557,1,2,2,2,12560,5453,1184,9663,1
72,2533,1057,646,719,113,100,145,1170,18,215,134,248,233,382,1740,3004,10,31186,1732,1,2,2,2,12570,5454,1185,9664,1
71,1508,1660,832,1314,41,38,274,1701,20,312,209,395,332,604,2671,5058,12,64042,3557,1,2,7,0,12570,5456,1186,9666,1
75,2768,1660,832,1314,41,38,274,1701,20,312,209,395,332,604,2671,5058,12,64042,3557,1,2,52,27,12570,5458,1187,9668,1
75,2768,1057,646,719,113,100,145,1170,18,215,134,248,233,382,1740,3004,10,31186,1732,1,2,52,27,12580,5459,1188,9669,1
75,1550,1660,832,1314,41,38,274,1701,20,312,209,395,332,604,2671,5058,12,64042,3557,1,2,8,1,12580,5461,1189,9671,1
75,2763,1660,832,1314,41,38,274,1701,20,312,209,395,332,604,2671,5058,12,64042,3557,1,2,2,2,12580,5463,1190,9673,0
75,2763,1057,646,719,113,100,145,1170,18,215,134,248,233,382,1740,3004,10,31186,1732,1,2,2,2,12590,5464,1191,9674,0
27,581,2,2,2,0,0,0,2,0,0,0,0,0,0,0,0,0,0,0,0,2,45,64,12590,5464,1191,9674,1
27,581,99,48,90,1,3,5,100,0,0,0,0,0,0,0,0,0,0,0,0,2,45,64,12590,5465,1191,9675,1
27,581,8,5,5,2,0,1,10,0,0,0,0,0,0,0,0,0,0,0,0,2,45,64,12590,5465,1191,9676,1
27,581,1217,716,841,84,126,174,1301,14,185,118,215,199,333,1446,2542,8,20687,1149,0,2,45,64,12600,5467,1191,9677,1
27,581,160,89,115,0,13,31,160,7,15,11,17,22,28,78,124,3,495,27,0,2,45,64,12600,5467,1191,9678,1
27,581,10,10,9,9,0,0,19,0,0,0,0,0,0,0,0,0,0,0,0,2,45,64,12600,5467,1192,9679,1
27,581,173,84,99,8,29,36,181,5,12,7,13,17,20,54,81,2,221,12,0,2,45,64,12600,5468,1192,9680,1
27,581,3,1,1,3,0,0,6,0,0,0,0,0,0,0,0,0,0,0,0,2,45,64,12600,5468,1192,9681,1
111,3586,1660,832,1314,41,38,274,1701,20,312,209,395,332,604,2671,5058,12,64042,3557,1,2,161,0,12600,5470,1193,9683,1
111,3586,1057,646,719,113,100,145,1170,18,215,134,248,233,382,1740,3004,10,31186,1732,1,2,161,0,12610,5471,1194,9684,1
216,4665,72,33,56,0,4,12,72,1,1,1,1,2,2,0,2,0,1,0,0,2,1,6,12610,5471,1194,9685,1
216,4665,1454,835,1044,76,110,219,1530,17,275,158,296,292,454,2297,3718,9,34017,1889,1,2,1,6,12620,5472,1194,9686,1
35,1267,1450,624,1228,12,26,181,1462,14,306,186,354,320,540,2580,4493,8,36391,2021,1,2,3,2,12620,5474,1195,9687,1
27,581,2,2,2,0,0,0,2,0,0,0,0,0,0,0,0,0,0,0,0,2,12,12,12620,5474,1195,9687,1
27,581,99,48,90,1,3,5,100,0,0,0,0,0,0,0,0,0,0,0,0,2,12,12,12620,5475,1195,9688,1
27,581,8,5,5,2,0,1,10,0,0,0,0,0,0,0,0,0,0,0,0,2,12,12,12620,5475,1195,9689,1
27,581,1217,716,841,84,126,174,1301,14,185,118,215,199,333,1446,2542,8,20687,1149,0,2,12,12,12630,5477,1195,9690,1
27,581,160,89,115,0,13,31,160,7,15,11,17,22,28,78,124,3,495,27,0,2,12,12,12630,5477,1195,9691,1
27,581,10,10,9,9,0,0,19,0,0,0,0,0,0,0,0,0,0,0,0,2,12,12,12630,5477,1196,9692,1
27,581,173,84,99,8,29,36,181,5,12,7,13,17,20,54,81,2,221,12,0,2,12,12,12630,5478,1196,9693,1
27,581,3,1,1,3,0,0,6,0,0,0,0,0,0,0,0,0,0,0,0,2,12,12,12630,5478,1196,9694,1
35,1267,1450,624,1228,12,26,181,1462,14,306,186,354,320,540,2580,4493,8,36391,2021,1,2,2,2,12630,5480,1197,9695,1
111,3593,1660,832,1314,41,38,274,1701,20,312,209,395,332,604,2671,5058,12,64042,3557,1,2,1,0,12630,5482,1198,9697,0
111,3593,1057,646,719,113,100,145,1170,18,215,134,248,233,382,1740,3004,10,31186,1732,1,2,1,0,12640,5483,1199,9698,0
35,1267,1450,624,1228,12,26,181,1462,14,306,186,354,320,540,2580,4493,8,36391,2021,1,2,1,1,12640,5485,1200,9699,0
111,3596,1660,832,1314,41,38,274,1701,20,312,209,395,332,604,2671,5058,12,64042,3557,1,2,1,1,12640,5487,1201,9701,0
111,3596,1057,646,719,113,100,145,1170,18,215,134,248,233,382,1740,3004,10,31186,1732,1,2,1,1,12650,5488,1202,9702,0
110,3591,1660,832,1314,41,38,274,1701,20,312,209,395,332,604,2671,5058,12,64042,3557,1,2,4,7,12650,5490,1203,9704,0
110,3591,1057,646,719,113,100,145,1170,18,215,134,248,233,382,1740,3004,10,31186,1732,1,2,4,7,12660,5491,1204,9705,0
35,1269,1450,624,1228,12,26,181,1462,14,306,186,354,320,540,2580,4493,8,36391,2021,1,2,6,3,12660,5493,1205,9706,0
27,578,2,2,2,0,0,0,2,0,0,0,0,0,0,0,0,0,0,0,0,2,5,4,12670,5497,1206,9713,1
27,578,99,48,90,1,3,5,100,0,0,0,0,0,0,0,0,0,0,0,0,2,5,4,12670,5498,1206,9714,1
27,578,8,5,5,2,0,1,10,0,0,0,0,0,0,0,0,0,0,0,0,2,5,4,12670,5498,1206,9715,1
27,578,1217,716,841,84,126,174,1301,14,185,118,215,199,333,1446,2542,8,20687,1149,0,2,5,4,12680,5500,1206,9716,1
27,578,160,89,115,0,13,31,160,7,15,11,17,22,28,78,124,3,495,27,0,2,5,4,12680,5500,1206,9717,1
27,578,10,10,9,9,0,0,19,0,0,0,0,0,0,0,0,0,0,0,0,2,5,4,12680,5500,1207,9718,1
27,578,173,84,99,8,29,36,181,5,12,7,13,17,20,54,81,2,221,12,0,2,5,4,12680,5501,1207,9719,1
27,578,3,1,1,3,0,0,6,0,0,0,0,0,0,0,0,0,0,0,0,2,5,4,12680,5501,1207,9720,1
6,288,42,7,35,4,0,5,46,1,2,1,2,3,3,2,4,0,2,0,0,2,1,1,12680,5501,1207,9721,1
6,288,11,6,10,0,0,1,11,2,4,2,4,6,6,10,15,1,15,0,0,2,1,1,12680,5501,1207,9722,1
35,1271,1450,624,1228,12,26,181,1462,14,306,186,354,320,540,2580,4493,8,36391,2021,1,2,1,0,12680,5503,1208,9723,1
25,553,2,2,2,0,0,0,2,0,0,0,0,0,0,0,0,0,0,0,0,2,13,16,12690,5507,1209,9730,1
25,553,99,48,90,1,3,5,100,0,0,0,0,0,0,0,0,0,0,0,0,2,13,16,12690,5508,1209,9731,1
25,553,8,5,5,2,0,1,10,0,0,0,0,0,0,0,0,0,0,0,0,2,13,16,12690,5508,1209,9732,1
25,553,1217,716,841,84,126,174,1301,14,185,118,215,199,333,1446,2542,8,20687,1149,0,2,13,16,12700,5510,1209,9733,1
25,553,160,89,115,0,13,31,160,7,15,11,17,22,28,78,124,3,495,27,0,2,13,16,12700,5510,1209,9734,1
25,553,10,10,9,9,0,0,19,0,0,0,0,0,0,0,0,0,0,0,0,2,13,16,12700,5510,1210,9735,1
25,553,173,84,99,8,29,36,181,5,12,7,13,17,20,54,81,2,221,12,0,2,13,16,12700,5511,1210,9736,1
25,553,3,1,1,3,0,0,6,0,0,0,0,0,0,0,0,0,0,0,0,2,13,16,12700,5511,1210,9737,1
6,288,42,7,35,4,0,5,46,1,2,1,2,3,3,2,4,0,2,0,0,2,1,1,12700,5511,1210,9738,1
6,288,11,6,10,0,0,1,11,2,4,2,4,6,6,10,15,1,15,0,0,2,1,1,12700,5511,1210,9739,1
33,1221,1450,624,1228,12,26,181,1462,14,306,186,354,320,540,2580,4493,8,36391,2021,1,2,7,13,12700,5513,1211,9740,1
25,553,2,2,2,0,0,0,2,0,0,0,0,0,0,0,0,0,0,0,0,2,4,1,12710,5517,1212,9747,0
25,553,99,48,90,1,3,5,100,0,0,0,0,0,0,0,0,0,0,0,0,2,4,1,12710,5518,1212,9748,0
25,553,8,5,5,2,0,1,10,0,0,0,0,0,0,0,0,0,0,0,0,2,4,1,12710,5518,1212,9749,0
25,553,1217,716,841,84,126,174,1301,14,185,118,215,199,333,1446,2542,8,20687,1149,0,2,4,1,12720,5520,1212,9750,0
25,553,160,89,115,0,13,31,160,7,15,11,17,22,28,78,124,3,495,27,0,2,4,1,12720,5520,1212,9751,0
25,553,10,10,9,9,0,0,19,0,0,0,0,0,0,0,0,0,0,0,0,2,4,1,12720,5520,1213,9752,0
25,553,173,84,99,8,29,36,181,5,12,7,13,17,20,54,81,2,221,12,0,2,4,1,12720,5521,1213,9753,0
25,553,3,1,1,3,0,0,6,0,0,0,0,0,0,0,0,0,0,0,0,2,4,1,12720,5521,1213,9754,0
6,288,42,7,35,4,0,5,46,1,2,1,2,3,3,2,4,0,2,0,0,2,1,1,12720,5521,1213,9755,0
6,288,11,6,10,0,0,1,11,2,4,2,4,6,6,10,15,1,15,0,0,2,1,1,12720,5521,1213,9756,0
111,3633,1660,832,1314,41,38,274,1701,20,312,209,395,332,604,2671,5058,12,64042,3557,1,2,8,2,12720,5523,1214,9758,0
111,3633,1057,646,719,113,100,145,1170,18,215,134,248,233,382,1740,3004,10,31186,1732,1,2,8,2,12730,5524,1215,9759,0
6,288,42,7,35,4,0,5,46,1,2,1,2,3,3,2,4,0,2,0,0,2,2,2,12740,5528,1216,9767,1
6,288,11,6,10,0,0,1,11,2,4,2,4,6,6,10,15,1,15,0,0,2,2,2,12740,5528,1216,9768,1
17,283,424,94,331,4,0,89,428,1,5,5,5,6,10,11,25,0,12,0,0,2,1,0,12750,5533,1217,9776,1
17,283,38,23,23,6,0,8,44,3,11,7,11,14,18,42,68,1,102,5,0,2,1,0,12750,5533,1217,9777,1
6,288,42,7,35,4,0,5,46,1,2,1,2,3,3,2,4,0,2,0,0,2,1,1,12750,5533,1217,9778,1
6,288,11,6,10,0,0,1,11,2,4,2,4,6,6,10,15,1,15,0,0,2,1,1,12750,5533,1217,9779,1
10,342,424,94,331,4,0,89,428,1,5,5,5,6,10,11,25,0,12,0,0,2,16,0,12750,5534,1217,9780,1
141,2829,1943,715,1694,26,18,214,1969,12,185,120,237,197,357,1436,2721,7,20915,1161,0,2,1,1,12760,5540,1218,9788,0
141,2829,1168,838,957,57,25,144,1225,19,348,224,416,367,640,3018,5452,11,61921,3440,1,2,1,1,12770,5542,1218,9789,0
6,288,42,7,35,4,0,5,46,1,2,1,2,3,3,2,4,0,2,0,0,2,1,1,12770,5542,1218,9790,0
6,288,11,6,10,0,0,1,11,2,4,2,4,6,6,10,15,1,15,0,0,2,1,1,12770,5542,1218,9791,0
1,189,382,65,130,157,2,92,539,4,10,5,10,14,15,41,57,2,114,6,0,2,6,6,12770,5543,1219,9792,0
1,187,382,65,130,157,2,92,539,4,10,5,10,14,15,41,57,2,114,6,0,2,1,2,12770,5544,1220,9793,0
6,288,42,7,35,4,0,5,46,1,2,1,2,3,3,2,4,0,2,0,0,2,4,2,12770,5544,1220,9794,0
6,288,11,6,10,0,0,1,11,2,4,2,4,6,6,10,15,1,15,0,0,2,4,2,12770,5544,1220,9795,0
1,187,382,65,130,157,2,92,539,4,10,5,10,14,15,41,57,2,114,6,0,2,2,2,12770,5545,1221,9796,1
23,509,2,2,2,0,0,0,2,0,0,0,0,0,0,0,0,0,0,0,0,2,0,5,12770,5545,1221,9796,1
23,509,99,48,90,1,3,5,100,0,0,0,0,0,0,0,0,0,0,0,0,2,0,5,12770,5546,1221,9797,1
23,509,8,5,5,2,0,1,10,0,0,0,0,0,0,0,0,0,0,0,0,2,0,5,12770,5546,1221,9798,1
23,509,1217,716,841,84,126,174,1301,14,185,118,215,199,333,1446,2542,8,20687,1149,0,2,0,5,12780,5548,1221,9799,1
23,509,160,89,115,0,13,31,160,7,15,11,17,22,28,78,124,3,495,27,0,2,0,5,12780,5548,1221,9800,1
23,509,10,10,9,9,0,0,19,0,0,0,0,0,0,0,0,0,0,0,0,2,0,5,12780,5548,1222,9801,1
23,509,173,84,99,8,29,36,181,5,12,7,13,17,20,54,81,2,221,12,0,2,0,5,12780,5549,1222,9802,1
23,509,3,1,1,3,0,0,6,0,0,0,0,0,0,0,0,0,0,0,0,2,0,5,12780,5549,1222,9803,1
109,3599,1660,832,1314,41,38,274,1701,20,312,209,395,332,604,2671,5058,12,64042,3557,1,2,81,66,12780,5551,1223,9805,1
109,3599,1057,646,719,113,100,145,1170,18,215,134,248,233,382,1740,3004,10,31186,1732,1,2,81,66,12790,5552,1224,9806,1
32,1156,1450,624,1228,12,26,181,1462,14,306,186,354,320,540,2580,4493,8,36391,2021,1,2,0,8,12790,5554,1225,9807,1
1,187,382,65,130,157,2,92,539,4,10,5,10,14,15,41,57,2,114,6,0,2,2,2,12790,5555,1226,9808,0
6,288,42,7,35,4,0,5,46,1,2,1,2,3,3,2,4,0,2,0,0,2,4,2,12790,5555,1226,9809,0
6,288,11,6,10,0,0,1,11,2,4,2,4,6,6,10,15,1,15,0,0,2,4,2,12790,5555,1226,9810,0
109,3605,1660,832,1314,41,38,274,1701,20,312,209,395,332,604,2671,5058,12,64042,3557,1,2,1,1,12790,5557,1227,9812,1
109,3605,1057,646,719,113,100,145,1170,18,215,134,248,233,382,1740,3004,10,31186,1732,1,2,1,1,12800,5558,1228,9813,1
10,333,295,56,236,0,4,54,295,2,9,5,10,11,15,30,51,1,57,3,0,2,1,1,12800,5560,1228,9814,0
143,2852,1943,715,1694,26,18,214,1969,12,185,120,237,197,357,1436,2721,7,20915,1161,0,2,5,0,12800,5562,1228,9815,1
143,2852,1168,838,957,57,25,144,1225,19,348,224,416,367,640,3018,5452,11,61921,3440,1,2,5,0,12810,5564,1228,9816,1
53,2478,1943,715,1694,26,18,214,1969,12,185,120,237,197,357,1436,2721,7,20915,1161,0,2,13,0,12810,5566,1228,9817,1
6,288,42,7,35,4,0,5,46,1,2,1,2,3,3,2,4,0,2,0,0,2,2,2,12820,5570,1229,9825,1
6,288,11,6,10,0,0,1,11,2,4,2,4,6,6,10,15,1,15,0,0,2,2,2,12820,5570,1229,9826,1
1,184,382,65,130,157,2,92,539,4,10,5,10,14,15,41,57,2,114,6,0,2,3,4,12830,5575,1231,9834,0
6,288,42,7,35,4,0,5,46,1,2,1,2,3,3,2,4,0,2,0,0,2,1,1,12830,5575,1231,9835,0
6,288,11,6,10,0,0,1,11,2,4,2,4,6,6,10,15,1,15,0,0,2,1,1,12830,5575,1231,9836,0
6,288,42,7,35,4,0,5,46,1,2,1,2,3,3,2,4,0,2,0,0,2,2,3,12840,5579,1232,9844,1
6,288,11,6,10,0,0,1,11,2,4,2,4,6,6,10,15,1,15,0,0,2,2,3,12840,5579,1232,9845,1
110,3625,1660,832,1314,41,38,274,1701,20,312,209,395,332,604,2671,5058,12,64042,3557,1,2,10,5,12840,5581,1233,9847,1
110,3625,1057,646,719,113,100,145,1170,18,215,134,248,233,382,1740,3004,10,31186,1732,1,2,10,5,12850,5582,1234,9848,1
110,3649,1660,832,1314,41,38,274,1701,20,312,209,395,332,604,2671,5058,12,64042,3557,1,2,8,2,12850,5584,1235,9850,0
110,3649,1057,646,719,113,100,145,1170,18,215,134,248,233,382,1740,3004,10,31186,1732,1,2,8,2,12860,5585,1236,9851,0
6,298,42,7,35,4,0,5,46,1,2,1,2,3,3,2,4,0,2,0,0,2,7,3,12860,5585,1236,9852,1
6,298,11,6,10,0,0,1,11,2,4,2,4,6,6,10,15,1,15,0,0,2,7,3,12860,5585,1236,9853,1
6,286,42,7,35,4,0,5,46,1,2,1,2,3,3,2,4,0,2,0,0,2,0,2,12860,5585,1236,9854,0
6,286,11,6,10,0,0,1,11,2,4,2,4,6,6,10,15,1,15,0,0,2,0,2,12860,5585,1236,9855,0
110,3652,1660,832,1314,41,38,274,1701,20,312,209,395,332,604,2671,5058,12,64042,3557,1,2,1,1,12860,5587,1237,9857,0
110,3652,1057,646,719,113,100,145,1170,18,215,134,248,233,382,1740,3004,10,31186,1732,1,2,1,1,12870,5588,1238,9858,0
79,1590,1660,832,1314,41,38,274,1701,20,312,209,395,332,604,2671,5058,12,64042,3557,1,2,6,0,12870,5590,1239,9860,0
78,1584,1660,832,1314,41,38,274,1701,20,312,209,395,332,604,2671,5058,12,64042,3557,1,2,0,2,12870,5592,1240,9862,0
6,286,42,7,35,4,0,5,46,1,2,1,2,3,3,2,4,0,2,0,0,2,2,2,12880,5596,1241,9870,1
6,286,11,6,10,0,0,1,11,2,4,2,4,6,6,10,15,1,15,0,0,2,2,2,12880,5596,1241,9871,1
110,3652,1660,832,1314,41,38,274,1701,20,312,209,395,332,604,2671,5058,12,64042,3557,1,2,1,1,12890,5602,1243,9880,0
110,3652,1057,646,719,113,100,145,1170,18,215,134,248,233,382,1740,3004,10,31186,1732,1,2,1,1,12900,5603,1244,9881,0
6,286,42,7,35,4,0,5,46,1,2,1,2,3,3,2,4,0,2,0,0,2,2,2,12900,5603,1244,9882,0
6,286,11,6,10,0,0,1,11,2,4,2,4,6,6,10,15,1,15,0,0,2,2,2,12900,5603,1244,9883,0
78,1584,1660,832,1314,41,38,274,1701,20,312,209,395,332,604,2671,5058,12,64042,3557,1,2,4,0,12900,5605,1245,9885,0
68,1200,1513,682,1277,25,13,200,1538,11,199,116,219,210,335,1557,2584,6,15641,868,0,2,1,4,12910,5611,1246,9893,1
68,1200,819,519,539,24,98,155,843,15,96,57,106,111,163,690,1107,8,9171,509,0,2,1,4,12920,5613,1246,9894,1
42,1319,1523,757,1297,19,12,193,1542,12,193,117,230,205,347,1508,2664,7,19053,1058,0,2,10,2,12930,5615,1246,9895,1
42,1319,701,378,504,33,58,109,734,13,110,68,126,123,194,794,1346,7,10027,557,0,2,10,2,12930,5616,1247,9896,1
86,1940,1043,504,840,53,9,147,1096,9,180,112,198,189,310,1377,2344,4,11604,644,0,2,8,2,12930,5618,1247,9897,1
86,1940,383,288,292,26,6,62,409,11,65,38,67,76,105,429,656,5,3719,206,0,2,8,2,12930,5619,1247,9898,1
146,2909,1943,715,1694,26,18,214,1969,12,185,120,237,197,357,1436,2721,7,20915,1161,0,2,10,2,12930,5621,1247,9899,1
146,2909,1168,838,957,57,25,144,1225,19,348,224,416,367,640,3018,5452,11,61921,3440,1,2,10,2,12940,5623,1247,9900,1
6,286,42,7,35,4,0,5,46,1,2,1,2,3,3,2,4,0,2,0,0,2,2,2,12940,5623,1247,9901,1
6,286,11,6,10,0,0,1,11,2,4,2,4,6,6,10,15,1,15,0,0,2,2,2,12940,5623,1247,9902,1
30,1925,1523,757,1297,19,12,193,1542,12,193,117,230,205,347,1508,2664,7,19053,1058,0,2,12,1,12950,5625,1247,9903,1
54,2487,1943,715,1694,26,18,214,1969,12,185,120,237,197,357,1436,2721,7,20915,1161,0,2,7,4,12950,5627,1247,9904,1
113,3706,1660,832,1314,41,38,274,1701,20,312,209,395,332,604,2671,5058,12,64042,3557,1,2,19,9,12950,5629,1248,9906,1
113,3706,1057,646,719,113,100,145,1170,18,215,134,248,233,382,1740,3004,10,31186,1732,1,2,19,9,12960,5630,1249,9907,1
79,1630,1660,832,1314,41,38,274,1701,20,312,209,395,332,604,2671,5058,12,64042,3557,1,2,11,0,12960,5632,1250,9909,1
42,1306,1523,757,1297,19,12,193,1542,12,193,117,230,205,347,1508,2664,7,19053,1058,0,2,4,6,12980,5638,1251,9917,1
42,1306,701,378,504,33,58,109,734,13,110,68,126,123,194,794,1346,7,10027,557,0,2,4,6,12980,5639,1252,9918,1
6,286,42,7,35,4,0,5,46,1,2,1,2,3,3,2,4,0,2,0,0,2,1,1,12980,5639,1252,9919,1
6,286,11,6,10,0,0,1,11,2,4,2,4,6,6,10,15,1,15,0,0,2,1,1,12980,5639,1252,9920,1
30,1925,1523,757,1297,19,12,193,1542,12,193,117,230,205,347,1508,2664,7,19053,1058,0,2,4,2,12990,5641,1252,9921,1
114,3710,1660,832,1314,41,38,274,1701,20,312,209,395,332,604,2671,5058,12,64042,3557,1,2,7,7,12990,5643,1253,9923,1
114,3710,1057,646,719,113,100,145,1170,18,215,134,248,233,382,1740,3004,10,31186,1732,1,2,7,7,13000,5644,1254,9924,1
80,1664,1660,832,1314,41,38,274,1701,20,312,209,395,332,604,2671,5058,12,64042,3557,1,2,10,0,13000,5646,1255,9926,1
42,1306,1523,757,1297,19,12,193,1542,12,193,117,230,205,347,1508,2664,7,19053,1058,0,2,4,6,13020,5652,1256,9934,0
42,1306,701,378,504,33,58,109,734,13,110,68,126,123,194,794,1346,7,10027,557,0,2,4,6,13020,5653,1257,9935,0
6,286,42,7,35,4,0,5,46,1,2,1,2,3,3,2,4,0,2,0,0,2,1,1,13020,5653,1257,9936,0
6,286,11,6,10,0,0,1,11,2,4,2,4,6,6,10,15,1,15,0,0,2,1,1,13020,5653,1257,9937,0
30,1925,1523,757,1297,19,12,193,1542,12,193,117,230,205,347,1508,2664,7,19053,1058,0,2,4,2,13030,5655,1257,9938,0
114,3710,1660,832,1314,41,38,274,1701,20,312,209,395,332,604,2671,5058,12,64042,3557,1,2,1,1,13030,5657,1258,9940,1
114,3710,1057,646,719,113,100,145,1170,18,215,134,248,233,382,1740,3004,10,31186,1732,1,2,1,1,13040,5658,1259,9941,1
81,1691,1660,832,1314,41,38,274,1701,20,312,209,395,332,604,2671,5058,12,64042,3557,1,2,4,0,13040,5660,1260,9943,1
82,1720,1660,832,1314,41,38,274,1701,20,312,209,395,332,604,2671,5058,12,64042,3557,1,2,4,0,13040,5662,1261,9945,0
136,2683,1457,730,1242,11,6,188,1468,10,292,166,329,302,495,2424,4078,5,22973,1276,1,2,1,2,13040,5664,1261,9946,1
136,2683,74,35,59,1,0,14,75,3,14,7,14,17,21,58,85,1,128,7,0,2,1,2,13040,5665,1261,9947,1
136,2683,245,125,200,5,7,34,250,7,30,17,34,37,51,166,265,3,1053,58,0,2,1,2,13050,5666,1261,9948,1
42,1096,74,35,59,1,0,14,75,3,14,7,14,17,21,58,85,1,128,7,0,2,24,2,13050,5667,1261,9949,1
42,1096,245,125,200,5,7,34,250,7,30,17,34,37,51,166,265,3,1053,58,0,2,24,2,13060,5668,1261,9950,1
28,1512,1457,730,1242,11,6,188,1468,10,292,166,329,302,495,2424,4078,5,22973,1276,1,2,1,1,13060,5670,1261,9951,1
11,350,74,35,59,1,0,14,75,3,14,7,14,17,21,58,85,1,128,7,0,2,14,0,13060,5671,1261,9952,1
52,2415,1943,715,1694,26,18,214,1969,12,185,120,237,197,357,1436,2721,7,20915,1161,0,2,0,15,13060,5673,1261,9953,1
115,3763,1660,832,1314,41,38,274,1701,20,312,209,395,332,604,2671,5058,12,64042,3557,1,2,9,0,13070,5679,1263,9962,1
115,3763,1057,646,719,113,100,145,1170,18,215,134,248,233,382,1740,3004,10,31186,1732,1,2,9,0,13080,5680,1264,9963,1
6,286,42,7,35,4,0,5,46,1,2,1,2,3,3,2,4,0,2,0,0,2,1,1,13080,5680,1264,9964,1
6,286,11,6,10,0,0,1,11,2,4,2,4,6,6,10,15,1,15,0,0,2,1,1,13080,5680,1264,9965,1
1,191,382,65,130,157,2,92,539,4,10,5,10,14,15,41,57,2,114,6,0,2,9,7,13080,5681,1265,9966,0
24,527,2,2,2,0,0,0,2,0,0,0,0,0,0,0,0,0,0,0,0,2,7,1,13080,5681,1265,9966,1
24,527,99,48,90,1,3,5,100,0,0,0,0,0,0,0,0,0,0,0,0,2,7,1,13080,5682,1265,9967,1
24,527,8,5,5,2,0,1,10,0,0,0,0,0,0,0,0,0,0,0,0,2,7,1,13080,5682,1265,9968,1
24,527,1217,716,841,84,126,174,1301,14,185,118,215,199,333,1446,2542,8,20687,1149,0,2,7,1,13090,5684,1265,9969,1
24,527,160,89,115,0,13,31,160,7,15,11,17,22,28,78,124,3,495,27,0,2,7,1,13090,5684,1265,9970,1
24,527,10,10,9,9,0,0,19,0,0,0,0,0,0,0,0,0,0,0,0,2,7,1,13090,5684,1266,9971,1
24,527,173,84,99,8,29,36,181,5,12,7,13,17,20,54,81,2,221,12,0,2,7,1,13090,5685,1266,9972,1
24,527,3,1,1,3,0,0,6,0,0,0,0,0,0,0,0,0,0,0,0,2,7,1,13090,5685,1266,9973,1
84,1745,1660,832,1314,41,38,274,1701,20,312,209,395,332,604,2671,5058,12,64042,3557,1,2,5,0,13090,5687,1267,9975,1
84,1745,1660,832,1314,41,38,274,1701,20,312,209,395,332,604,2671,5058,12,64042,3557,1,2,2,1,13090,5689,1268,9977,0
84,1747,1660,832,1314,41,38,274,1701,20,312,209,395,332,604,2671,5058,12,64042,3557,1,2,1,1,13090,5691,1269,9979,0
84,1759,1660,832,1314,41,38,274,1701,20,312,209,395,332,604,2671,5058,12,64042,3557,1,2,3,2,13090,5693,1270,9981,1
120,3799,1660,832,1314,41,38,274,1701,20,312,209,395,332,604,2671,5058,12,64042,3557,1,2,29,12,13090,5695,1271,9983,1
120,3799,1057,646,719,113,100,145,1170,18,215,134,248,233,382,1740,3004,10,31186,1732,1,2,29,12,13100,5696,1272,9984,1
87,1884,1660,832,1314,41,38,274,1701,20,312,209,395,332,604,2671,5058,12,64042,3557,1,2,24,0,13100,5698,1273,9986,1
120,3797,1660,832,1314,41,38,274,1701,20,312,209,395,332,604,2671,5058,12,64042,3557,1,2,0,1,13100,5700,1274,9988,0
120,3797,1057,646,719,113,100,145,1170,18,215,134,248,233,382,1740,3004,10,31186,1732,1,2,0,1,13110,5701,1275,9989,0
22,519,1293,570,1093,25,15,163,1318,10,195,123,241,205,364,1516,2795,6,17273,959,0,2,11,1,13120,5703,1275,9990,0
17,678,1293,570,1093,25,15,163,1318,10,195,123,241,205,364,1516,2795,6,17273,959,0,2,13,0,13130,5705,1275,9991,0
122,3814,1660,832,1314,41,38,274,1701,20,312,209,395,332,604,2671,5058,12,64042,3557,1,2,3,1,13130,5707,1276,9993,1
122,3814,1057,646,719,113,100,145,1170,18,215,134,248,233,382,1740,3004,10,31186,1732,1,2,3,1,13140,5708,1277,9994,1
124,3828,1660,832,1314,41,38,274,1701,20,312,209,395,332,604,2671,5058,12,64042,3557,1,2,2,1,13140,5710,1278,9996,0
124,3828,1057,646,719,113,100,145,1170,18,215,134,248,233,382,1740,3004,10,31186,1732,1,2,2,1,13150,5711,1279,9997,0
43,1893,1289,550,1043,56,32,155,1345,10,167,93,185,177,278,1266,2075,5,11498,638,0,2,1,1,13150,5713,1280,9998,0
120,3818,1660,832,1314,41,38,274,1701,20,312,209,395,332,604,2671,5058,12,64042,3557,1,2,8,4,13150,5715,1281,10000,1
120,3818,1057,646,719,113,100,145,1170,18,215,134,248,233,382,1740,3004,10,31186,1732,1,2,8,4,13160,5716,1282,10001,1
6,286,42,7,35,4,0,5,46,1,2,1,2,3,3,2,4,0,2,0,0,2,1,1,13170,5720,1283,10009,0
6,286,11,6,10,0,0,1,11,2,4,2,4,6,6,10,15,1,15,0,0,2,1,1,13170,5720,1283,10010,0
120,3818,1660,832,1314,41,38,274,1701,20,312,209,395,332,604,2671,5058,12,64042,3557,1,2,8,4,13170,5722,1284,10012,0
120,3818,1057,646,719,113,100,145,1170,18,215,134,248,233,382,1740,3004,10,31186,1732,1,2,8,4,13180,5723,1285,10013,0
33,542,127,75,83,2,11,30,129,4,14,7,14,18,21,61,87,2,175,9,0,2,4,2,13180,5723,1285,10014,1
33,542,652,304,544,16,6,88,668,6,89,51,101,95,152,591,998,3,3399,188,0,2,4,2,13180,5724,1285,10015,1
33,542,2,2,2,0,0,0,2,0,0,0,0,0,0,0,0,0,0,0,0,2,4,2,13180,5724,1285,10015,1
33,542,8,5,5,0,0,3,8,0,0,0,0,0,0,0,0,0,0,0,0,2,4,2,13180,5724,1285,10016,1
33,542,2,2,2,0,0,0,2,0,0,0,0,0,0,0,0,0,0,0,0,2,4,2,13180,5724,1285,10016,1
33,542,14,8,8,0,0,6,14,0,0,0,0,0,0,0,0,0,0,0,0,2,4,2,13180,5724,1285,10017,1
33,542,6,4,4,0,0,2,6,0,0,0,0,0,0,0,0,0,0,0,0,2,4,2,13180,5724,1285,10018,1
33,542,6,4,4,0,0,2,6,1,2,1,2,3,3,2,4,0,2,0,0,2,4,2,13180,5724,1285,10019,1
33,542,6,4,4,0,0,2,6,0,0,0,0,0,0,0,0,0,0,0,0,2,4,2,13180,5724,1285,10020,1
33,542,7,5,5,0,0,2,7,0,0,0,0,0,0,0,0,0,0,0,0,2,4,2,13180,5724,1285,10021,1
33,542,6,4,4,0,0,2,6,0,0,0,0,0,0,0,0,0,0,0,0,2,4,2,13180,5724,1285,10022,1
33,542,10,6,6,0,0,4,10,0,0,0,0,0,0,0,0,0,0,0,0,2,4,2,13180,5724,1285,10023,1
33,542,1,1,1,0,0,0,1,0,0,0,0,0,0,0,0,0,0,0,0,2,4,2,13180,5724,1285,10023,1
33,542,14,10,10,0,0,4,14,1,1,1,1,2,2,0,2,0,1,0,0,2,4,2,13180,5724,1285,10024,1
33,542,46,26,30,3,0,12,49,3,6,3,6,9,9,20,28,1,42,2,0,2,4,2,13190,5724,1285,10025,1
6,286,42,7,35,4,0,5,46,1,2,1,2,3,3,2,4,0,2,0,0,2,3,3,13200,5728,1286,10033,1
6,286,11,6,10,0,0,1,11,2,4,2,4,6,6,10,15,1,15,0,0,2,3,3,13200,5728,1286,10034,1
120,3830,1660,832,1314,41,38,274,1701,20,312,209,395,332,604,2671,5058,12,64042,3557,1,2,4,1,13200,5730,1287,10036,1
120,3830,1057,646,719,113,100,145,1170,18,215,134,248,233,382,1740,3004,10,31186,1732,1,2,4,1,13210,5731,1288,10037,1
88,1968,1660,832,1314,41,38,274,1701,20,312,209,395,332,604,2671,5058,12,64042,3557,1,2,14,0,13210,5733,1289,10039,1
120,3838,1660,832,1314,41,38,274,1701,20,312,209,395,332,604,2671,5058,12,64042,3557,1,2,1,1,13210,5735,1290,10041,0
120,3838,1057,646,719,113,100,145,1170,18,215,134,248,233,382,1740,3004,10,31186,1732,1,2,1,1,13220,5736,1291,10042,0
89,2022,1660,832,1314,41,38,274,1701,20,312,209,395,332,604,2671,5058,12,64042,3557,1,2,9,0,13220,5738,1292,10044,0
118,3763,1660,832,1314,41,38,274,1701,20,312,209,395,332,604,2671,5058,12,64042,3557,1,2,7,18,13220,5740,1293,10046,1
118,3763,1057,646,719,113,100,145,1170,18,215,134,248,233,382,1740,3004,10,31186,1732,1,2,7,18,13230,5741,1294,10047,1
117,3766,1660,832,1314,41,38,274,1701,20,312,209,395,332,604,2671,5058,12,64042,3557,1,2,12,13,13230,5743,1295,10049,1
117,3766,1057,646,719,113,100,145,1170,18,215,134,248,233,382,1740,3004,10,31186,1732,1,2,12,13,13240,5744,1296,10050,1
94,2079,1660,832,1314,41,38,274,1701,20,312,209,395,332,604,2671,5058,12,64042,3557,1,2,8,0,13240,5746,1297,10052,1
146,3319,77,34,69,0,0,8,77,3,24,16,29,27,45,114,213,1,387,21,0,2,17,11,13240,5746,1297,10053,1
146,3319,712,438,573,51,9,84,763,14,102,71,128,116,199,733,1364,8,11988,666,0,2,17,11,13250,5747,1297,10054,1
44,1956,1289,550,1043,56,32,155,1345,10,167,93,185,177,278,1266,2075,5,11498,638,0,2,11,0,13250,5749,1298,10055,1
44,1956,1289,550,1043,56,32,155,1345,10,167,93,185,177,278,1266,2075,5,11498,638,0,2,2,0,13250,5751,1299,10056,0
146,3319,77,34,69,0,0,8,77,3,24,16,29,27,45,114,213,1,387,21,0,2,17,11,13260,5755,1300,10064,0
146,3319,712,438,573,51,9,84,763,14,102,71,128,116,199,733,1364,8,11988,666,0,2,17,11,13270,5756,1300,10065,0
6,286,42,7,35,4,0,5,46,1,2,1,2,3,3,2,4,0,2,0,0,2,1,1,13270,5756,1300,10066,0
6,286,11,6,10,0,0,1,11,2,4,2,4,6,6,10,15,1,15,0,0,2,1,1,13270,5756,1300,10067,0
44,1956,1289,550,1043,56,32,155,1345,10,167,93,185,177,278,1266,2075,5,11498,638,0,2,15,2,13270,5758,1301,10068,0
118,3822,1660,832,1314,41,38,274,1701,20,312,209,395,332,604,2671,5058,12,64042,3557,1,2,9,0,13270,5760,1302,10070,1
118,3822,1057,646,719,113,100,145,1170,18,215,134,248,233,382,1740,3004,10,31186,1732,1,2,9,0,13280,5761,1303,10071,1
95,2123,1660,832,1314,41,38,274,1701,20,312,209,395,332,604,2671,5058,12,64042,3557,1,2,6,0,13280,5763,1304,10073,1
44,1956,1289,550,1043,56,32,155,1345,10,167,93,185,177,278,1266,2075,5,11498,638,0,2,1,1,13280,5765,1305,10074,1
25,542,2,2,2,0,0,0,2,0,0,0,0,0,0,0,0,0,0,0,0,2,3,0,13290,5769,1306,10081,1
25,542,99,48,90,1,3,5,100,0,0,0,0,0,0,0,0,0,0,0,0,2,3,0,13290,5770,1306,10082,1
25,542,8,5,5,2,0,1,10,0,0,0,0,0,0,0,0,0,0,0,0,2,3,0,13290,5770,1306,10083,1
25,542,1217,716,841,84,126,174,1301,14,185,118,215,199,333,1446,2542,8,20687,1149,0,2,3,0,13300,5772,1306,10084,1
25,542,160,89,115,0,13,31,160,7,15,11,17,22,28,78,124,3,495,27,0,2,3,0,13300,5772,1306,10085,1
25,542,10,10,9,9,0,0,19,0,0,0,0,0,0,0,0,0,0,0,0,2,3,0,13300,5772,1307,10086,1
25,542,173,84,99,8,29,36,181,5,12,7,13,17,20,54,81,2,221,12,0,2,3,0,13300,5773,1307,10087,1
25,542,3,1,1,3,0,0,6,0,0,0,0,0,0,0,0,0,0,0,0,2,3,0,13300,5773,1307,10088,1
6,286,42,7,35,4,0,5,46,1,2,1,2,3,3,2,4,0,2,0,0,2,1,1,13300,5773,1307,10089,1
6,286,11,6,10,0,0,1,11,2,4,2,4,6,6,10,15,1,15,0,0,2,1,1,13300,5773,1307,10090,1
44,1965,1289,550,1043,56,32,155,1345,10,167,93,185,177,278,1266,2075,5,11498,638,0,2,1,0,13300,5775,1308,10091,1
32,1156,1450,624,1228,12,26,181,1462,14,306,186,354,320,540,2580,4493,8,36391,2021,1,2,1,1,13300,5777,1309,10092,1
95,2139,1660,832,1314,41,38,274,1701,20,312,209,395,332,604,2671,5058,12,64042,3557,1,2,3,0,13300,5779,1310,10094,1
25,1230,652,304,544,16,6,88,668,6,89,51,101,95,152,591,998,3,3399,188,0,2,1,1,13300,5780,1310,10095,1
6,286,42,7,35,4,0,5,46,1,2,1,2,3,3,2,4,0,2,0,0,2,1,1,13310,5784,1311,10103,0
6,286,11,6,10,0,0,1,11,2,4,2,4,6,6,10,15,1,15,0,0,2,1,1,13310,5784,1311,10104,0
40,1253,1523,757,1297,19,12,193,1542,12,193,117,230,205,347,1508,2664,7,19053,1058,0,2,1,9,13320,5786,1311,10105,1
40,1253,701,378,504,33,58,109,734,13,110,68,126,123,194,794,1346,7,10027,557,0,2,1,9,13320,5787,1312,10106,1
87,1986,1043,504,840,53,9,147,1096,9,180,112,198,189,310,1377,2344,4,11604,644,0,2,17,8,13320,5789,1312,10107,1
87,1986,383,288,292,26,6,62,409,11,65,38,67,76,105,429,656,5,3719,206,0,2,17,8,13320,5790,1312,10108,1
6,286,42,7,35,4,0,5,46,1,2,1,2,3,3,2,4,0,2,0,0,2,1,1,13330,5794,1313,10116,0
6,286,11,6,10,0,0,1,11,2,4,2,4,6,6,10,15,1,15,0,0,2,1,1,13330,5794,1313,10117,0
40,1253,1523,757,1297,19,12,193,1542,12,193,117,230,205,347,1508,2664,7,19053,1058,0,2,1,9,13340,5796,1313,10118,0
40,1253,701,378,504,33,58,109,734,13,110,68,126,123,194,794,1346,7,10027,557,0,2,1,9,13340,5797,1314,10119,0
87,1986,1043,504,840,53,9,147,1096,9,180,112,198,189,310,1377,2344,4,11604,644,0,2,17,8,13340,5799,1314,10120,0
87,1986,383,288,292,26,6,62,409,11,65,38,67,76,105,429,656,5,3719,206,0,2,17,8,13340,5800,1314,10121,0
185,4416,722,423,573,19,0,135,741,12,172,101,199,184,300,1320,2257,6,15668,870,0,2,1,0,13340,5802,1314,10123,0
185,4416,1508,847,911,44,250,301,1552,14,148,88,169,162,257,1120,1886,7,15077,837,0,2,1,0,13340,5803,1315,10124,0
34,1575,1178,367,1042,6,15,115,1184,9,94,51,95,103,146,644,976,4,4439,246,0,2,6,1,13340,5803,1315,10125,0
136,2684,1457,730,1242,11,6,188,1468,10,292,166,329,302,495,2424,4078,5,22973,1276,1,2,1,1,13340,5805,1315,10126,1
136,2684,74,35,59,1,0,14,75,3,14,7,14,17,21,58,85,1,128,7,0,2,1,1,13340,5806,1315,10127,1
136,2684,245,125,200,5,7,34,250,7,30,17,34,37,51,166,265,3,1053,58,0,2,1,1,13350,5807,1315,10128,1
29,1532,1457,730,1242,11,6,188,1468,10,292,166,329,302,495,2424,4078,5,22973,1276,1,2,3,0,13350,5809,1315,10129,1
80,1402,1178,367,1042,6,15,115,1184,9,94,51,95,103,146,644,976,4,4439,246,0,2,6,4,13350,5809,1315,10130,1
80,1402,177,108,140,8,0,27,185,6,30,16,32,36,48,162,248,3,794,44,0,2,6,4,13350,5811,1315,10131,1
146,2909,1943,715,1694,26,18,214,1969,12,185,120,237,197,357,1436,2721,7,20915,1161,0,2,1,1,13350,5813,1315,10132,1
146,2909,1168,838,957,57,25,144,1225,19,348,224,416,367,640,3018,5452,11,61921,3440,1,2,1,1,13360,5815,1315,10133,1
35,1612,1178,367,1042,6,15,115,1184,9,94,51,95,103,146,644,976,4,4439,246,0,2,15,0,13360,5815,1315,10134,1
118,3822,1660,832,1314,41,38,274,1701,20,312,209,395,332,604,2671,5058,12,64042,3557,1,2,3,3,13360,5817,1316,10136,1
118,3822,1057,646,719,113,100,145,1170,18,215,134,248,233,382,1740,3004,10,31186,1732,1,2,3,3,13370,5818,1317,10137,1
99,2192,1660,832,1314,41,38,274,1701,20,312,209,395,332,604,2671,5058,12,64042,3557,1,2,8,0,13370,5820,1318,10139,1
118,3825,1660,832,1314,41,38,274,1701,20,312,209,395,332,604,2671,5058,12,64042,3557,1,2,1,1,13370,5822,1319,10141,0
118,3825,1057,646,719,113,100,145,1170,18,215,134,248,233,382,1740,3004,10,31186,1732,1,2,1,1,13380,5823,1320,10142,0
27,563,2,2,2,0,0,0,2,0,0,0,0,0,0,0,0,0,0,0,0,2,18,13,13380,5823,1320,10142,1
27,563,99,48,90,1,3,5,100,0,0,0,0,0,0,0,0,0,0,0,0,2,18,13,13380,5824,1320,10143,1
27,563,8,5,5,2,0,1,10,0,0,0,0,0,0,0,0,0,0,0,0,2,18,13,13380,5824,1320,10144,1
27,563,1217,716,841,84,126,174,1301,14,185,118,215,199,333,1446,2542,8,20687,1149,0,2,18,13,13390,5826,1320,10145,1
27,563,160,89,115,0,13,31,160,7,15,11,17,22,28,78,124,3,495,27,0,2,18,13,13390,5826,1320,10146,1
27,563,10,10,9,9,0,0,19,0,0,0,0,0,0,0,0,0,0,0,0,2,18,13,13390,5826,1321,10147,1
27,563,173,84,99,8,29,36,181,5,12,7,13,17,20,54,81,2,221,12,0,2,18,13,13390,5827,1321,10148,1
27,563,3,1,1,3,0,0,6,0,0,0,0,0,0,0,0,0,0,0,0,2,18,13,13390,5827,1321,10149,1
32,1222,1450,624,1228,12,26,181,1462,14,306,186,354,320,540,2580,4493,8,36391,2021,1,2,22,9,13390,5829,1322,10150,1
6,286,42,7,35,4,0,5,46,1,2,1,2,3,3,2,4,0,2,0,0,2,1,1,13400,5833,1323,10158,1
6,286,11,6,10,0,0,1,11,2,4,2,4,6,6,10,15,1,15,0,0,2,1,1,13400,5833,1323,10159,1
147,3343,77,34,69,0,0,8,77,3,24,16,29,27,45,114,213,1,387,21,0,2,9,0,13400,5833,1323,10160,1
147,3343,712,438,573,51,9,84,763,14,102,71,128,116,199,733,1364,8,11988,666,0,2,9,0,13410,5834,1323,10161,1
44,1999,1289,550,1043,56,32,155,1345,10,167,93,185,177,278,1266,2075,5,11498,638,0,2,8,0,13410,5836,1324,10162,1
44,1989,1289,550,1043,56,32,155,1345,10,167,93,185,177,278,1266,2075,5,11498,638,0,2,2,5,13410,5838,1325,10163,0
147,3343,77,34,69,0,0,8,77,3,24,16,29,27,45,114,213,1,387,21,0,2,3,3,13410,5838,1325,10164,0
147,3343,712,438,573,51,9,84,763,14,102,71,128,116,199,733,1364,8,11988,666,0,2,3,3,13420,5839,1325,10165,0
187,4460,722,423,573,19,0,135,741,12,172,101,199,184,300,1320,2257,6,15668,870,0,2,9,0,13430,5845,1326,10174,0
187,4460,1508,847,911,44,250,301,1552,14,148,88,169,162,257,1120,1886,7,15077,837,0,2,9,0,13430,5846,1327,10175,0
6,286,42,7,35,4,0,5,46,1,2,1,2,3,3,2,4,0,2,0,0,2,1,1,13430,5846,1327,10176,0
6,286,11,6,10,0,0,1,11,2,4,2,4,6,6,10,15,1,15,0,0,2,1,1,13430,5846,1327,10177,0
33,542,127,75,83,2,11,30,129,4,14,7,14,18,21,61,87,2,175,9,0,2,1,1,13430,5846,1327,10178,0
33,542,652,304,544,16,6,88,668,6,89,51,101,95,152,591,998,3,3399,188,0,2,1,1,13430,5847,1327,10179,0
33,542,2,2,2,0,0,0,2,0,0,0,0,0,0,0,0,0,0,0,0,2,1,1,13430,5847,1327,10179,0
33,542,8,5,5,0,0,3,8,0,0,0,0,0,0,0,0,0,0,0,0,2,1,1,13430,5847,1327,10180,0
33,542,2,2,2,0,0,0,2,0,0,0,0,0,0,0,0,0,0,0,0,2,1,1,13430,5847,1327,10180,0
33,542,14,8,8,0,0,6,14,0,0,0,0,0,0,0,0,0,0,0,0,2,1,1,13430,5847,1327,10181,0
33,542,6,4,4,0,0,2,6,0,0,0,0,0,0,0,0,0,0,0,0,2,1,1,13430,5847,1327,10182,0
33,542,6,4,4,0,0,2,6,1,2,1,2,3,3,2,4,0,2,0,0,2,1,1,13430,5847,1327,10183,0
33,542,6,4,4,0,0,2,6,0,0,0,0,0,0,0,0,0,0,0,0,2,1,1,13430,5847,1327,10184,0
33,542,7,5,5,0,0,2,7,0,0,0,0,0,0,0,0,0,0,0,0,2,1,1,13430,5847,1327,10185,0
33,542,6,4,4,0,0,2,6,0,0,0,0,0,0,0,0,0,0,0,0,2,1,1,13430,5847,1327,10186,0
33,542,10,6,6,0,0,4,10,0,0,0,0,0,0,0,0,0,0,0,0,2,1,1,13430,5847,1327,10187,0
33,542,1,1,1,0,0,0,1,0,0,0,0,0,0,0,0,0,0,0,0,2,1,1,13430,5847,1327,10187,0
33,542,14,10,10,0,0,4,14,1,1,1,1,2,2,0,2,0,1,0,0,2,1,1,13430,5847,1327,10188,0
33,542,46,26,30,3,0,12,49,3,6,3,6,9,9,20,28,1,42,2,0,2,1,1,13440,5847,1327,10189,0
11,347,442,244,305,14,16,103,456,11,68,45,75,79,120,452,756,6,4588,254,0,2,2,2,13450,5853,1328,10197,1
11,347,182,102,99,11,40,35,193,3,11,6,11,14,17,42,64,1,97,5,0,2,2,2,13450,5854,1328,10198,1
6,286,42,7,35,4,0,5,46,1,2,1,2,3,3,2,4,0,2,0,0,2,1,1,13450,5854,1328,10199,1
6,286,11,6,10,0,0,1,11,2,4,2,4,6,6,10,15,1,15,0,0,2,1,1,13450,5854,1328,10200,1
8,544,442,244,305,14,16,103,456,11,68,45,75,79,120,452,756,6,4588,254,0,2,13,0,13450,5856,1328,10201,1
69,1231,1513,682,1277,25,13,200,1538,11,199,116,219,210,335,1557,2584,6,15641,868,0,2,21,19,13460,5862,1329,10209,1
69,1231,819,519,539,24,98,155,843,15,96,57,106,111,163,690,1107,8,9171,509,0,2,21,19,13470,5864,1329,10210,1
137,2694,1457,730,1242,11,6,188,1468,10,292,166,329,302,495,2424,4078,5,22973,1276,1,2,14,8,13470,5866,1329,10211,1
137,2694,74,35,59,1,0,14,75,3,14,7,14,17,21,58,85,1,128,7,0,2,14,8,13470,5867,1329,10212,1
137,2694,245,125,200,5,7,34,250,7,30,17,34,37,51,166,265,3,1053,58,0,2,14,8,13480,5868,1329,10213,1
42,1104,74,35,59,1,0,14,75,3,14,7,14,17,21,58,85,1,128,7,0,2,2,1,13480,5869,1329,10214,1
42,1104,245,125,200,5,7,34,250,7,30,17,34,37,51,166,265,3,1053,58,0,2,2,1,13490,5870,1329,10215,1
147,3343,77,34,69,0,0,8,77,3,24,16,29,27,45,114,213,1,387,21,0,2,6,6,13490,5870,1329,10216,1
147,3343,712,438,573,51,9,84,763,14,102,71,128,116,199,733,1364,8,11988,666,0,2,6,6,13500,5871,1329,10217,1
179,4314,722,423,573,19,0,135,741,12,172,101,199,184,300,1320,2257,6,15668,870,0,2,42,68,13500,5873,1329,10219,1
179,4314,1508,847,911,44,250,301,1552,14,148,88,169,162,257,1120,1886,7,15077,837,0,2,42,68,13500,5874,1330,10220,1
144,2897,1943,715,1694,26,18,214,1969,12,185,120,237,197,357,1436,2721,7,20915,1161,0,2,2,6,13500,5876,1330,10221,1
144,2897,1168,838,957,57,25,144,1225,19,348,224,416,367,640,3018,5452,11,61921,3440,1,2,2,6,13510,5878,1330,10222,1
6,286,42,7,35,4,0,5,46,1,2,1,2,3,3,2,4,0,2,0,0,2,1,1,13510,5878,1330,10223,1
6,286,11,6,10,0,0,1,11,2,4,2,4,6,6,10,15,1,15,0,0,2,1,1,13510,5878,1330,10224,1
45,2034,1289,550,1043,56,32,155,1345,10,167,93,185,177,278,1266,2075,5,11498,638,0,2,11,5,13510,5880,1331,10225,1
35,613,127,75,83,2,11,30,129,4,14,7,14,18,21,61,87,2,175,9,0,2,19,11,13510,5880,1331,10226,1
35,613,652,304,544,16,6,88,668,6,89,51,101,95,152,591,998,3,3399,188,0,2,19,11,13510,5881,1331,10227,1
35,613,2,2,2,0,0,0,2,0,0,0,0,0,0,0,0,0,0,0,0,2,19,11,13510,5881,1331,10227,1
35,613,8,5,5,0,0,3,8,0,0,0,0,0,0,0,0,0,0,0,0,2,19,11,13510,5881,1331,10228,1
35,613,2,2,2,0,0,0,2,0,0,0,0,0,0,0,0,0,0,0,0,2,19,11,13510,5881,1331,10228,1
35,613,14,8,8,0,0,6,14,0,0,0,0,0,0,0,0,0,0,0,0,2,19,11,13510,5881,1331,10229,1
35,613,6,4,4,0,0,2,6,0,0,0,0,0,0,0,0,0,0,0,0,2,19,11,13510,5881,1331,10230,1
35,613,6,4,4,0,0,2,6,1,2,1,2,3,3,2,4,0,2,0,0,2,19,11,13510,5881,1331,10231,1
35,613,6,4,4,0,0,2,6,0,0,0,0,0,0,0,0,0,0,0,0,2,19,11,13510,5881,1331,10232,1
35,613,7,5,5,0,0,2,7,0,0,0,0,0,0,0,0,0,0,0,0,2,19,11,13510,5881,1331,10233,1
35,613,6,4,4,0,0,2,6,0,0,0,0,0,0,0,0,0,0,0,0,2,19,11,13510,5881,1331,10234,1
35,613,10,6,6,0,0,4,10,0,0,0,0,0,0,0,0,0,0,0,0,2,19,11,13510,5881,1331,10235,1
35,613,1,1,1,0,0,0,1,0,0,0,0,0,0,0,0,0,0,0,0,2,19,11,13510,5881,1331,10235,1
35,613,14,10,10,0,0,4,14,1,1,1,1,2,2,0,2,0,1,0,0,2,19,11,13510,5881,1331,10236,1
35,613,46,26,30,3,0,12,49,3,6,3,6,9,9,20,28,1,42,2,0,2,19,11,13520,5881,1331,10237,1
39,1597,1513,682,1277,25,13,200,1538,11,199,116,219,210,335,1557,2584,6,15641,868,0,2,17,14,13520,5883,1331,10238,1
42,2708,1296,573,1062,40,33,157,1336,8,201,118,231,209,349,1561,2689,4,12365,686,0,2,17,50,13520,5883,1331,10239,1
29,1472,1457,730,1242,11,6,188,1468,10,292,166,329,302,495,2424,4078,5,22973,1276,1,2,17,21,13520,5885,1331,10240,1
30,1144,1020,354,843,12,15,144,1032,8,134,77,144,142,221,970,1580,4,6792,377,0,2,0,52,13520,5885,1331,10241,1
6,462,442,244,305,14,16,103,456,11,68,45,75,79,120,452,756,6,4588,254,0,2,0,11,13520,5887,1331,10242,1
180,4318,722,423,573,19,0,135,741,12,172,101,199,184,300,1320,2257,6,15668,870,0,2,1,1,13520,5889,1331,10244,0
180,4318,1508,847,911,44,250,301,1552,14,148,88,169,162,257,1120,1886,7,15077,837,0,2,1,1,13520,5890,1332,10245,0
6,472,442,244,305,14,16,103,456,11,68,45,75,79,120,452,756,6,4588,254,0,2,2,1,13520,5892,1332,10246,1
6,464,442,244,305,14,16,103,456,11,68,45,75,79,120,452,756,6,4588,254,0,2,2,2,13520,5894,1332,10247,1
184,4339,722,423,573,19,0,135,741,12,172,101,199,184,300,1320,2257,6,15668,870,0,2,8,1,13530,5900,1333,10256,1
184,4339,1508,847,911,44,250,301,1552,14,148,88,169,162,257,1120,1886,7,15077,837,0,2,8,1,13530,5901,1334,10257,1
96,2185,1043,504,840,53,9,147,1096,9,180,112,198,189,310,1377,2344,4,11604,644,0,2,34,2,13530,5903,1334,10258,1
96,2185,383,288,292,26,6,62,409,11,65,38,67,76,105,429,656,5,3719,206,0,2,34,2,13530,5904,1334,10259,1
6,286,42,7,35,4,0,5,46,1,2,1,2,3,3,2,4,0,2,0,0,2,1,1,13530,5904,1334,10260,1
6,286,11,6,10,0,0,1,11,2,4,2,4,6,6,10,15,1,15,0,0,2,1,1,13530,5904,1334,10261,1
51,2211,1289,550,1043,56,32,155,1345,10,167,93,185,177,278,1266,2075,5,11498,638,0,2,45,0,13530,5906,1335,10262,1
45,430,647,139,84,35,284,233,682,0,0,0,0,0,0,0,0,0,0,0,0,2,2,1,13540,5910,1336,10270,1
41,1260,1523,757,1297,19,12,193,1542,12,193,117,230,205,347,1508,2664,7,19053,1058,0,2,2,1,13550,5912,1336,10271,1
41,1260,701,378,504,33,58,109,734,13,110,68,126,123,194,794,1346,7,10027,557,0,2,2,1,13550,5913,1337,10272,1
184,4339,722,423,573,19,0,135,741,12,172,101,199,184,300,1320,2257,6,15668,870,0,2,2,2,13550,5915,1337,10274,1
184,4339,1508,847,911,44,250,301,1552,14,148,88,169,162,257,1120,1886,7,15077,837,0,2,2,2,13550,5916,1338,10275,1
28,574,215,129,180,6,0,29,221,8,65,43,72,73,115,415,711,4,3153,175,0,2,2,0,13550,5916,1338,10276,1
28,574,97,69,77,3,3,16,100,6,22,13,23,28,36,113,173,3,542,30,0,2,2,0,13550,5917,1338,10277,1
95,2257,1043,504,840,53,9,147,1096,9,180,112,198,189,310,1377,2344,4,11604,644,0,2,14,3,13550,5919,1338,10278,1
95,2257,383,288,292,26,6,62,409,11,65,38,67,76,105,429,656,5,3719,206,0,2,14,3,13550,5920,1338,10279,1
145,2900,1943,715,1694,26,18,214,1969,12,185,120,237,197,357,1436,2721,7,20915,1161,0,2,4,3,13550,5922,1338,10280,1
145,2900,1168,838,957,57,25,144,1225,19,348,224,416,367,640,3018,5452,11,61921,3440,1,2,4,3,13560,5924,1338,10281,1
6,286,42,7,35,4,0,5,46,1,2,1,2,3,3,2,4,0,2,0,0,2,1,1,13560,5924,1338,10282,1
6,286,11,6,10,0,0,1,11,2,4,2,4,6,6,10,15,1,15,0,0,2,1,1,13560,5924,1338,10283,1
52,2269,1289,550,1043,56,32,155,1345,10,167,93,185,177,278,1266,2075,5,11498,638,0,2,25,0,13560,5926,1339,10284,1
30,1144,1020,354,843,12,15,144,1032,8,134,77,144,142,221,970,1580,4,6792,377,0,2,1,1,13560,5926,1339,10285,1
55,2337,1289,550,1043,56,32,155,1345,10,167,93,185,177,278,1266,2075,5,11498,638,0,2,66,52,13560,5928,1340,10286,1
95,2262,1043,504,840,53,9,147,1096,9,180,112,198,189,310,1377,2344,4,11604,644,0,2,2,1,13570,5934,1341,10294,1
95,2262,383,288,292,26,6,62,409,11,65,38,67,76,105,429,656,5,3719,206,0,2,2,1,13570,5935,1341,10295,1
6,286,42,7,35,4,0,5,46,1,2,1,2,3,3,2,4,0,2,0,0,2,1,1,13570,5935,1341,10296,1
6,286,11,6,10,0,0,1,11,2,4,2,4,6,6,10,15,1,15,0,0,2,1,1,13570,5935,1341,10297,1
95,2264,1043,504,840,53,9,147,1096,9,180,112,198,189,310,1377,2344,4,11604,644,0,2,3,4,13580,5941,1342,10305,1
95,2264,383,288,292,26,6,62,409,11,65,38,67,76,105,429,656,5,3719,206,0,2,3,4,13580,5942,1342,10306,1
6,286,42,7,35,4,0,5,46,1,2,1,2,3,3,2,4,0,2,0,0,2,1,1,13580,5942,1342,10307,1
6,286,11,6,10,0,0,1,11,2,4,2,4,6,6,10,15,1,15,0,0,2,1,1,13580,5942,1342,10308,1
56,2390,1289,550,1043,56,32,155,1345,10,167,93,185,177,278,1266,2075,5,11498,638,0,2,10,0,13580,5944,1343,10309,1
94,2179,1043,504,840,53,9,147,1096,9,180,112,198,189,310,1377,2344,4,11604,644,0,2,8,12,13590,5950,1344,10317,1
94,2179,383,288,292,26,6,62,409,11,65,38,67,76,105,429,656,5,3719,206,0,2,8,12,13590,5951,1344,10318,1
6,286,42,7,35,4,0,5,46,1,2,1,2,3,3,2,4,0,2,0,0,2,1,1,13590,5951,1344,10319,1
6,286,11,6,10,0,0,1,11,2,4,2,4,6,6,10,15,1,15,0,0,2,1,1,13590,5951,1344,10320,1
56,2377,1289,550,1043,56,32,155,1345,10,167,93,185,177,278,1266,2075,5,11498,638,0,2,0,2,13590,5953,1345,10321,1
56,2375,1289,550,1043,56,32,155,1345,10,167,93,185,177,278,1266,2075,5,11498,638,0,2,0,2,13590,5955,1346,10322,0
56,2373,1289,550,1043,56,32,155,1345,10,167,93,185,177,278,1266,2075,5,11498,638,0,2,3,4,13590,5957,1347,10323,1
94,2175,1043,504,840,53,9,147,1096,9,180,112,198,189,310,1377,2344,4,11604,644,0,2,1,8,13590,5959,1347,10324,0
94,2175,383,288,292,26,6,62,409,11,65,38,67,76,105,429,656,5,3719,206,0,2,1,8,13590,5960,1347,10325,0
185,4352,722,423,573,19,0,135,741,12,172,101,199,184,300,1320,2257,6,15668,870,0,2,2,0,13590,5962,1347,10327,0
185,4352,1508,847,911,44,250,301,1552,14,148,88,169,162,257,1120,1886,7,15077,837,0,2,2,0,13590,5963,1348,10328,0
138,2726,1457,730,1242,11,6,188,1468,10,292,166,329,302,495,2424,4078,5,22973,1276,1,2,9,0,13590,5965,1348,10329,1
138,2726,74,35,59,1,0,14,75,3,14,7,14,17,21,58,85,1,128,7,0,2,9,0,13590,5966,1348,10330,1
138,2726,245,125,200,5,7,34,250,7,30,17,34,37,51,166,265,3,1053,58,0,2,9,0,13600,5967,1348,10331,1
31,1642,1457,730,1242,11,6,188,1468,10,292,166,329,302,495,2424,4078,5,22973,1276,1,2,34,0,13600,5969,1348,10332,1
147,3357,77,34,69,0,0,8,77,3,24,16,29,27,45,114,213,1,387,21,0,2,3,0,13610,5973,1349,10340,1
147,3357,712,438,573,51,9,84,763,14,102,71,128,116,199,733,1364,8,11988,666,0,2,3,0,13620,5974,1349,10341,1
57,1036,1020,354,843,12,15,144,1032,8,134,77,144,142,221,970,1580,4,6792,377,0,2,40,2,13620,5974,1349,10342,1
81,1431,1178,367,1042,6,15,115,1184,9,94,51,95,103,146,644,976,4,4439,246,0,2,15,0,13620,5974,1349,10343,1
81,1431,177,108,140,8,0,27,185,6,30,16,32,36,48,162,248,3,794,44,0,2,15,0,13620,5976,1349,10344,1
6,286,42,7,35,4,0,5,46,1,2,1,2,3,3,2,4,0,2,0,0,2,1,1,13620,5976,1349,10345,1
6,286,11,6,10,0,0,1,11,2,4,2,4,6,6,10,15,1,15,0,0,2,1,1,13620,5976,1349,10346,1
35,622,127,75,83,2,11,30,129,4,14,7,14,18,21,61,87,2,175,9,0,2,4,0,13620,5976,1349,10347,1
35,622,652,304,544,16,6,88,668,6,89,51,101,95,152,591,998,3,3399,188,0,2,4,0,13620,5977,1349,10348,1
35,622,2,2,2,0,0,0,2,0,0,0,0,0,0,0,0,0,0,0,0,2,4,0,13620,5977,1349,10348,1
35,622,8,5,5,0,0,3,8,0,0,0,0,0,0,0,0,0,0,0,0,2,4,0,13620,5977,1349,10349,1
35,622,2,2,2,0,0,0,2,0,0,0,0,0,0,0,0,0,0,0,0,2,4,0,13620,5977,1349,10349,1
35,622,14,8,8,0,0,6,14,0,0,0,0,0,0,0,0,0,0,0,0,2,4,0,13620,5977,1349,10350,1
35,622,6,4,4,0,0,2,6,0,0,0,0,0,0,0,0,0,0,0,0,2,4,0,13620,5977,1349,10351,1
35,622,6,4,4,0,0,2,6,1,2,1,2,3,3,2,4,0,2,0,0,2,4,0,13620,5977,1349,10352,1
35,622,6,4,4,0,0,2,6,0,0,0,0,0,0,0,0,0,0,0,0,2,4,0,13620,5977,1349,10353,1
35,622,7,5,5,0,0,2,7,0,0,0,0,0,0,0,0,0,0,0,0,2,4,0,13620,5977,1349,10354,1
35,622,6,4,4,0,0,2,6,0,0,0,0,0,0,0,0,0,0,0,0,2,4,0,13620,5977,1349,10355,1
35,622,10,6,6,0,0,4,10,0,0,0,0,0,0,0,0,0,0,0,0,2,4,0,13620,5977,1349,10356,1
35,622,1,1,1,0,0,0,1,0,0,0,0,0,0,0,0,0,0,0,0,2,4,0,13620,5977,1349,10356,1
35,622,14,10,10,0,0,4,14,1,1,1,1,2,2,0,2,0,1,0,0,2,4,0,13620,5977,1349,10357,1
35,622,46,26,30,3,0,12,49,3,6,3,6,9,9,20,28,1,42,2,0,2,4,0,13630,5977,1349,10358,1
33,1248,1020,354,843,12,15,144,1032,8,134,77,144,142,221,970,1580,4,6792,377,0,2,47,0,13630,5977,1349,10359,1
36,1639,1178,367,1042,6,15,115,1184,9,94,51,95,103,146,644,976,4,4439,246,0,2,7,0,13630,5977,1349,10360,1
63,1149,1020,354,843,12,15,144,1032,8,134,77,144,142,221,970,1580,4,6792,377,0,2,23,3,13640,5981,1350,10368,1
147,2943,1943,715,1694,26,18,214,1969,12,185,120,237,197,357,1436,2721,7,20915,1161,0,2,8,1,13640,5983,1350,10369,1
147,2943,1168,838,957,57,25,144,1225,19,348,224,416,367,640,3018,5452,11,61921,3440,1,2,8,1,13650,5985,1350,10370,1
6,286,42,7,35,4,0,5,46,1,2,1,2,3,3,2,4,0,2,0,0,2,1,1,13650,5985,1350,10371,1
6,286,11,6,10,0,0,1,11,2,4,2,4,6,6,10,15,1,15,0,0,2,1,1,13650,5985,1350,10372,1
35,1375,1020,354,843,12,15,144,1032,8,134,77,144,142,221,970,1580,4,6792,377,0,2,24,0,13650,5985,1350,10373,1
52,2415,1943,715,1694,26,18,214,1969,12,185,120,237,197,357,1436,2721,7,20915,1161,0,2,1,1,13650,5987,1350,10374,1
14,457,184,100,137,2,15,30,186,6,38,20,39,44,59,214,322,3,991,55,0,2,5,1,13650,5988,1350,10375,1
14,457,103,65,74,8,5,16,111,7,17,9,17,24,26,89,119,3,417,23,0,2,5,1,13650,5989,1350,10376,1
7,293,184,100,137,2,15,30,186,6,38,20,39,44,59,214,322,3,991,55,0,2,12,0,13650,5990,1350,10377,1
23,554,1293,570,1093,25,15,163,1318,10,195,123,241,205,364,1516,2795,6,17273,959,0,2,7,1,13660,5992,1350,10378,1
19,756,1293,570,1093,25,15,163,1318,10,195,123,241,205,364,1516,2795,6,17273,959,0,2,20,0,13670,5994,1350,10379,1
14,457,184,100,137,2,15,30,186,6,38,20,39,44,59,214,322,3,991,55,0,2,5,1,13670,5995,1350,10380,0
14,457,103,65,74,8,5,16,111,7,17,9,17,24,26,89,119,3,417,23,0,2,5,1,13670,5996,1350,10381,0
7,293,184,100,137,2,15,30,186,6,38,20,39,44,59,214,322,3,991,55,0,2,12,0,13670,5997,1350,10382,0
247,5301,72,33,56,0,4,12,72,1,1,1,1,2,2,0,2,0,1,0,0,2,146,23,13680,6001,1351,10390,1
247,5301,1454,835,1044,76,110,219,1530,17,275,158,296,292,454,2297,3718,9,34017,1889,1,2,146,23,13690,6002,1351,10391,1
11,347,72,33,56,0,4,12,72,1,1,1,1,2,2,0,2,0,1,0,0,2,7,12,13690,6002,1351,10392,1
6,286,42,7,35,4,0,5,46,1,2,1,2,3,3,2,4,0,2,0,0,2,1,1,13690,6002,1351,10393,1
6,286,11,6,10,0,0,1,11,2,4,2,4,6,6,10,15,1,15,0,0,2,1,1,13690,6002,1351,10394,1
94,2175,1043,504,840,53,9,147,1096,9,180,112,198,189,310,1377,2344,4,11604,644,0,2,1,1,13690,6004,1351,10395,0
94,2175,383,288,292,26,6,62,409,11,65,38,67,76,105,429,656,5,3719,206,0,2,1,1,13690,6005,1351,10396,0
66,1174,1513,682,1277,25,13,200,1538,11,199,116,219,210,335,1557,2584,6,15641,868,0,2,0,11,13700,6011,1352,10404,1
66,1174,819,519,539,24,98,155,843,15,96,57,106,111,163,690,1107,8,9171,509,0,2,0,11,13710,6013,1352,10405,1
149,3363,77,34,69,0,0,8,77,3,24,16,29,27,45,114,213,1,387,21,0,2,4,4,13710,6013,1352,10406,1
149,3363,712,438,573,51,9,84,763,14,102,71,128,116,199,733,1364,8,11988,666,0,2,4,4,13720,6014,1352,10407,1
185,4362,722,423,573,19,0,135,741,12,172,101,199,184,300,1320,2257,6,15668,870,0,2,4,2,13720,6016,1352,10409,1
185,4362,1508,847,911,44,250,301,1552,14,148,88,169,162,257,1120,1886,7,15077,837,0,2,4,2,13720,6017,1353,10410,1
247,5301,72,33,56,0,4,12,72,1,1,1,1,2,2,0,2,0,1,0,0,2,1,0,13720,6017,1353,10411,1
247,5301,1454,835,1044,76,110,219,1530,17,275,158,296,292,454,2297,3718,9,34017,1889,1,2,1,0,13730,6018,1353,10412,1
98,2209,1043,504,840,53,9,147,1096,9,180,112,198,189,310,1377,2344,4,11604,644,0,2,40,16,13730,6020,1353,10413,1
98,2209,383,288,292,26,6,62,409,11,65,38,67,76,105,429,656,5,3719,206,0,2,40,16,13730,6021,1353,10414,1
6,286,42,7,35,4,0,5,46,1,2,1,2,3,3,2,4,0,2,0,0,2,1,1,13730,6021,1353,10415,1
6,286,11,6,10,0,0,1,11,2,4,2,4,6,6,10,15,1,15,0,0,2,1,1,13730,6021,1353,10416,1
42,1675,1043,504,840,53,9,147,1096,9,180,112,198,189,310,1377,2344,4,11604,644,0,2,39,0,13730,6023,1353,10417,1
48,926,1098,241,925,5,10,155,1103,7,46,25,49,53,74,273,423,3,1580,87,0,2,7,2,13740,6025,1353,10418,0
48,926,282,202,222,14,2,44,296,8,42,24,43,50,67,250,378,4,1548,86,0,2,7,2,13740,6026,1353,10419,0
149,3366,77,34,69,0,0,8,77,3,24,16,29,27,45,114,213,1,387,21,0,2,2,0,13750,6030,1354,10427,1
149,3366,712,438,573,51,9,84,763,14,102,71,128,116,199,733,1364,8,11988,666,0,2,2,0,13760,6031,1354,10428,1
97,2199,1043,504,840,53,9,147,1096,9,180,112,198,189,310,1377,2344,4,11604,644,0,2,1,7,13760,6033,1354,10429,1
97,2199,383,288,292,26,6,62,409,11,65,38,67,76,105,429,656,5,3719,206,0,2,1,7,13760,6034,1354,10430,1
6,286,42,7,35,4,0,5,46,1,2,1,2,3,3,2,4,0,2,0,0,2,1,1,13760,6034,1354,10431,1
6,286,11,6,10,0,0,1,11,2,4,2,4,6,6,10,15,1,15,0,0,2,1,1,13760,6034,1354,10432,1
97,2191,1043,504,840,53,9,147,1096,9,180,112,198,189,310,1377,2344,4,11604,644,0,2,8,9,13770,6040,1355,10440,1
97,2191,383,288,292,26,6,62,409,11,65,38,67,76,105,429,656,5,3719,206,0,2,8,9,13770,6041,1355,10441,1
6,286,42,7,35,4,0,5,46,1,2,1,2,3,3,2,4,0,2,0,0,2,1,1,13770,6041,1355,10442,1
6,286,11,6,10,0,0,1,11,2,4,2,4,6,6,10,15,1,15,0,0,2,1,1,13770,6041,1355,10443,1
97,2193,1043,504,840,53,9,147,1096,9,180,112,198,189,310,1377,2344,4,11604,644,0,2,4,4,13770,6043,1355,10444,1
97,2193,383,288,292,26,6,62,409,11,65,38,67,76,105,429,656,5,3719,206,0,2,4,4,13770,6044,1355,10445,1
63,1148,1020,354,843,12,15,144,1032,8,134,77,144,142,221,970,1580,4,6792,377,0,2,3,3,13780,6048,1356,10453,1
247,5301,72,33,56,0,4,12,72,1,1,1,1,2,2,0,2,0,1,0,0,2,1,1,13780,6048,1356,10454,1
247,5301,1454,835,1044,76,110,219,1530,17,275,158,296,292,454,2297,3718,9,34017,1889,1,2,1,1,13790,6049,1356,10455,1
10,326,72,33,56,0,4,12,72,1,1,1,1,2,2,0,2,0,1,0,0,2,7,5,13790,6049,1356,10456,1
6,286,42,7,35,4,0,5,46,1,2,1,2,3,3,2,4,0,2,0,0,2,1,1,13790,6049,1356,10457,1
6,286,11,6,10,0,0,1,11,2,4,2,4,6,6,10,15,1,15,0,0,2,1,1,13790,6049,1356,10458,1
247,5301,72,33,56,0,4,12,72,1,1,1,1,2,2,0,2,0,1,0,0,2,10,9,13790,6049,1356,10459,1
247,5301,1454,835,1044,76,110,219,1530,17,275,158,296,292,454,2297,3718,9,34017,1889,1,2,10,9,13800,6050,1356,10460,1
6,286,42,7,35,4,0,5,46,1,2,1,2,3,3,2,4,0,2,0,0,2,2,2,13800,6050,1356,10461,1
6,286,11,6,10,0,0,1,11,2,4,2,4,6,6,10,15,1,15,0,0,2,2,2,13800,6050,1356,10462,1
148,3361,77,34,69,0,0,8,77,3,24,16,29,27,45,114,213,1,387,21,0,2,7,7,13800,6050,1356,10463,1
148,3361,712,438,573,51,9,84,763,14,102,71,128,116,199,733,1364,8,11988,666,0,2,7,7,13810,6051,1356,10464,1
39,1240,1523,757,1297,19,12,193,1542,12,193,117,230,205,347,1508,2664,7,19053,1058,0,2,60,66,13820,6053,1356,10465,1
39,1240,701,378,504,33,58,109,734,13,110,68,126,123,194,794,1346,7,10027,557,0,2,60,66,13820,6054,1357,10466,1
50,966,1098,241,925,5,10,155,1103,7,46,25,49,53,74,273,423,3,1580,87,0,2,4,0,13830,6056,1357,10467,1
50,966,282,202,222,14,2,44,296,8,42,24,43,50,67,250,378,4,1548,86,0,2,4,0,13830,6057,1357,10468,1
22,846,1098,241,925,5,10,155,1103,7,46,25,49,53,74,273,423,3,1580,87,0,2,23,0,13840,6059,1357,10469,1
45,434,647,139,84,35,284,233,682,0,0,0,0,0,0,0,0,0,0,0,0,2,19,6,13850,6063,1358,10477,1
149,3388,77,34,69,0,0,8,77,3,24,16,29,27,45,114,213,1,387,21,0,2,6,2,13850,6063,1358,10478,1
149,3388,712,438,573,51,9,84,763,14,102,71,128,116,199,733,1364,8,11988,666,0,2,6,2,13860,6064,1358,10479,1
93,2136,1043,504,840,53,9,147,1096,9,180,112,198,189,310,1377,2344,4,11604,644,0,2,13,36,13860,6066,1358,10480,1
93,2136,383,288,292,26,6,62,409,11,65,38,67,76,105,429,656,5,3719,206,0,2,13,36,13860,6067,1358,10481,1
6,286,42,7,35,4,0,5,46,1,2,1,2,3,3,2,4,0,2,0,0,2,2,2,13860,6067,1358,10482,1
6,286,11,6,10,0,0,1,11,2,4,2,4,6,6,10,15,1,15,0,0,2,2,2,13860,6067,1358,10483,1
42,1681,1043,504,840,53,9,147,1096,9,180,112,198,189,310,1377,2344,4,11604,644,0,2,3,3,13860,6069,1358,10484,1
43,413,647,139,84,35,284,233,682,0,0,0,0,0,0,0,0,0,0,0,0,2,0,8,13870,6073,1359,10492,1
91,2091,1043,504,840,53,9,147,1096,9,180,112,198,189,310,1377,2344,4,11604,644,0,2,0,7,13870,6075,1359,10493,1
91,2091,383,288,292,26,6,62,409,11,65,38,67,76,105,429,656,5,3719,206,0,2,0,7,13870,6076,1359,10494,1
146,2919,1943,715,1694,26,18,214,1969,12,185,120,237,197,357,1436,2721,7,20915,1161,0,2,0,3,13870,6078,1359,10495,1
146,2919,1168,838,957,57,25,144,1225,19,348,224,416,367,640,3018,5452,11,61921,3440,1,2,0,3,13880,6080,1359,10496,1
6,286,42,7,35,4,0,5,46,1,2,1,2,3,3,2,4,0,2,0,0,2,1,1,13880,6080,1359,10497,1
6,286,11,6,10,0,0,1,11,2,4,2,4,6,6,10,15,1,15,0,0,2,1,1,13880,6080,1359,10498,1
39,1597,1513,682,1277,25,13,200,1538,11,199,116,219,210,335,1557,2584,6,15641,868,0,2,1,1,13880,6082,1359,10499,1
247,5301,72,33,56,0,4,12,72,1,1,1,1,2,2,0,2,0,1,0,0,2,16,18,13880,6082,1359,10500,1
247,5301,1454,835,1044,76,110,219,1530,17,275,158,296,292,454,2297,3718,9,34017,1889,1,2,16,18,13890,6083,1359,10501,1
29,603,215,129,180,6,0,29,221,8,65,43,72,73,115,415,711,4,3153,175,0,2,4,1,13900,6087,1360,10509,1
29,603,97,69,77,3,3,16,100,6,22,13,23,28,36,113,173,3,542,30,0,2,4,1,13900,6088,1360,10510,1
6,286,42,7,35,4,0,5,46,1,2,1,2,3,3,2,4,0,2,0,0,2,3,3,13900,6088,1360,10511,1
6,286,11,6,10,0,0,1,11,2,4,2,4,6,6,10,15,1,15,0,0,2,3,3,13900,6088,1360,10512,1
14,1171,215,129,180,6,0,29,221,8,65,43,72,73,115,415,711,4,3153,175,0,2,7,4,13900,6088,1360,10513,1
6,286,42,7,35,4,0,5,46,1,2,1,2,3,3,2,4,0,2,0,0,2,2,2,13910,6092,1361,10521,1
6,286,11,6,10,0,0,1,11,2,4,2,4,6,6,10,15,1,15,0,0,2,2,2,13910,6092,1361,10522,1
247,5322,72,33,56,0,4,12,72,1,1,1,1,2,2,0,2,0,1,0,0,2,2,0,13920,6096,1362,10530,1
247,5322,1454,835,1044,76,110,219,1530,17,275,158,296,292,454,2297,3718,9,34017,1889,1,2,2,0,13930,6097,1362,10531,1
6,286,42,7,35,4,0,5,46,1,2,1,2,3,3,2,4,0,2,0,0,2,3,3,13930,6097,1362,10532,1
6,286,11,6,10,0,0,1,11,2,4,2,4,6,6,10,15,1,15,0,0,2,3,3,13930,6097,1362,10533,1
23,882,1098,241,925,5,10,155,1103,7,46,25,49,53,74,273,423,3,1580,87,0,2,18,1,13940,6099,1362,10534,1
6,286,42,7,35,4,0,5,46,1,2,1,2,3,3,2,4,0,2,0,0,2,3,3,13950,6103,1363,10542,1
6,286,11,6,10,0,0,1,11,2,4,2,4,6,6,10,15,1,15,0,0,2,3,3,13950,6103,1363,10543,1
24,517,447,308,343,6,5,95,453,7,96,59,111,103,170,651,1136,4,4600,255,0,2,1,1,13960,6110,1364,10551,1
24,517,322,174,179,16,74,51,338,10,41,26,46,51,72,252,408,5,2291,127,0,2,1,1,13960,6113,1365,10552,1
6,286,42,7,35,4,0,5,46,1,2,1,2,3,3,2,4,0,2,0,0,2,2,2,13960,6113,1365,10553,1
6,286,11,6,10,0,0,1,11,2,4,2,4,6,6,10,15,1,15,0,0,2,2,2,13960,6113,1365,10554,1
14,877,447,308,343,6,5,95,453,7,96,59,111,103,170,651,1136,4,4600,255,0,2,14,0,13960,6116,1365,10555,1
14,884,447,308,343,6,5,95,453,7,96,59,111,103,170,651,1136,4,4600,255,0,2,1,0,13960,6119,1365,10556,0
51,972,1098,241,925,5,10,155,1103,7,46,25,49,53,74,273,423,3,1580,87,0,2,4,1,13980,6125,1366,10564,1
51,972,282,202,222,14,2,44,296,8,42,24,43,50,67,250,378,4,1548,86,0,2,4,1,13980,6126,1366,10565,1
6,286,42,7,35,4,0,5,46,1,2,1,2,3,3,2,4,0,2,0,0,2,1,1,13980,6126,1366,10566,1
6,286,11,6,10,0,0,1,11,2,4,2,4,6,6,10,15,1,15,0,0,2,1,1,13980,6126,1366,10567,1
24,917,1098,241,925,5,10,155,1103,7,46,25,49,53,74,273,423,3,1580,87,0,2,11,0,13990,6128,1366,10568,1
58,2413,1289,550,1043,56,32,155,1345,10,167,93,185,177,278,1266,2075,5,11498,638,0,2,7,2,13990,6130,1367,10569,1
247,5323,72,33,56,0,4,12,72,1,1,1,1,2,2,0,2,0,1,0,0,2,2,1,14000,6134,1368,10577,0
247,5323,1454,835,1044,76,110,219,1530,17,275,158,296,292,454,2297,3718,9,34017,1889,1,2,2,1,14010,6135,1368,10578,0
6,286,42,7,35,4,0,5,46,1,2,1,2,3,3,2,4,0,2,0,0,2,3,3,14010,6135,1368,10579,0
6,286,11,6,10,0,0,1,11,2,4,2,4,6,6,10,15,1,15,0,0,2,3,3,14010,6135,1368,10580,0
42,1673,1043,504,840,53,9,147,1096,9,180,112,198,189,310,1377,2344,4,11604,644,0,2,4,6,14010,6137,1368,10581,1
66,1221,1020,354,843,12,15,144,1032,8,134,77,144,142,221,970,1580,4,6792,377,0,2,13,2,14010,6137,1368,10582,1
36,1508,1020,354,843,12,15,144,1032,8,134,77,144,142,221,970,1580,4,6792,377,0,2,25,0,14010,6137,1368,10583,1
58,1088,1020,354,843,12,15,144,1032,8,134,77,144,142,221,970,1580,4,6792,377,0,2,0,19,14010,6137,1368,10584,1
253,5394,72,33,56,0,4,12,72,1,1,1,1,2,2,0,2,0,1,0,0,2,18,2,14010,6137,1368,10585,1
253,5394,1454,835,1044,76,110,219,1530,17,275,158,296,292,454,2297,3718,9,34017,1889,1,2,18,2,14020,6138,1368,10586,1
36,1526,1020,354,843,12,15,144,1032,8,134,77,144,142,221,970,1580,4,6792,377,0,2,7,7,14020,6138,1368,10587,1
25,520,447,308,343,6,5,95,453,7,96,59,111,103,170,651,1136,4,4600,255,0,2,4,1,14020,6141,1368,10588,1
25,520,322,174,179,16,74,51,338,10,41,26,46,51,72,252,408,5,2291,127,0,2,4,1,14020,6144,1369,10589,1
16,935,447,308,343,6,5,95,453,7,96,59,111,103,170,651,1136,4,4600,255,0,2,12,4,14020,6147,1369,10590,1
42,1668,1043,504,840,53,9,147,1096,9,180,112,198,189,310,1377,2344,4,11604,644,0,2,1,2,14020,6149,1369,10591,1
6,286,42,7,35,4,0,5,46,1,2,1,2,3,3,2,4,0,2,0,0,2,2,2,14030,6153,1370,10599,1
6,286,11,6,10,0,0,1,11,2,4,2,4,6,6,10,15,1,15,0,0,2,2,2,14030,6153,1370,10600,1
253,5394,72,33,56,0,4,12,72,1,1,1,1,2,2,0,2,0,1,0,0,2,5,6,14040,6157,1371,10608,1
253,5394,1454,835,1044,76,110,219,1530,17,275,158,296,292,454,2297,3718,9,34017,1889,1,2,5,6,14050,6158,1371,10609,1
51,1023,1098,241,925,5,10,155,1103,7,46,25,49,53,74,273,423,3,1580,87,0,2,8,0,14060,6160,1371,10610,1
51,1023,282,202,222,14,2,44,296,8,42,24,43,50,67,250,378,4,1548,86,0,2,8,0,14060,6161,1371,10611,1
6,286,42,7,35,4,0,5,46,1,2,1,2,3,3,2,4,0,2,0,0,2,1,1,14060,6161,1371,10612,1
6,286,11,6,10,0,0,1,11,2,4,2,4,6,6,10,15,1,15,0,0,2,1,1,14060,6161,1371,10613,1
50,983,1098,241,925,5,10,155,1103,7,46,25,49,53,74,273,423,3,1580,87,0,2,2,6,14070,6163,1371,10614,1
50,983,282,202,222,14,2,44,296,8,42,24,43,50,67,250,378,4,1548,86,0,2,2,6,14070,6164,1371,10615,1
18,1009,447,308,343,6,5,95,453,7,96,59,111,103,170,651,1136,4,4600,255,0,2,27,15,14070,6167,1371,10616,1
25,524,447,308,343,6,5,95,453,7,96,59,111,103,170,651,1136,4,4600,255,0,2,1,0,14070,6170,1371,10617,0
25,524,322,174,179,16,74,51,338,10,41,26,46,51,72,252,408,5,2291,127,0,2,1,0,14070,6173,1372,10618,0
29,595,447,308,343,6,5,95,453,7,96,59,111,103,170,651,1136,4,4600,255,0,2,13,0,14070,6176,1372,10619,0
29,595,322,174,179,16,74,51,338,10,41,26,46,51,72,252,408,5,2291,127,0,2,13,0,14070,6179,1373,10620,0
22,1134,447,308,343,6,5,95,453,7,96,59,111,103,170,651,1136,4,4600,255,0,2,21,0,14070,6182,1373,10621,0
29,596,447,308,343,6,5,95,453,7,96,59,111,103,170,651,1136,4,4600,255,0,2,4,0,14070,6185,1373,10622,0
29,596,322,174,179,16,74,51,338,10,41,26,46,51,72,252,408,5,2291,127,0,2,4,0,14070,6188,1374,10623,0
6,286,42,7,35,4,0,5,46,1,2,1,2,3,3,2,4,0,2,0,0,2,1,1,14080,6192,1375,10631,1
6,286,11,6,10,0,0,1,11,2,4,2,4,6,6,10,15,1,15,0,0,2,1,1,14080,6192,1375,10632,1
92,2141,1043,504,840,53,9,147,1096,9,180,112,198,189,310,1377,2344,4,11604,644,0,2,11,3,14080,6194,1375,10633,1
92,2141,383,288,292,26,6,62,409,11,65,38,67,76,105,429,656,5,3719,206,0,2,11,3,14080,6195,1375,10634,1
43,1766,1043,504,840,53,9,147,1096,9,180,112,198,189,310,1377,2344,4,11604,644,0,2,15,0,14080,6197,1375,10635,1
93,2154,1043,504,840,53,9,147,1096,9,180,112,198,189,310,1377,2344,4,11604,644,0,2,2,0,14090,6203,1376,10643,1
93,2154,383,288,292,26,6,62,409,11,65,38,67,76,105,429,656,5,3719,206,0,2,2,0,14090,6204,1376,10644,1
6,286,42,7,35,4,0,5,46,1,2,1,2,3,3,2,4,0,2,0,0,2,2,2,14090,6204,1376,10645,1
6,286,11,6,10,0,0,1,11,2,4,2,4,6,6,10,15,1,15,0,0,2,2,2,14090,6204,1376,10646,1
149,3388,77,34,69,0,0,8,77,3,24,16,29,27,45,114,213,1,387,21,0,2,1,1,14090,6204,1376,10647,1
149,3388,712,438,573,51,9,84,763,14,102,71,128,116,199,733,1364,8,11988,666,0,2,1,1,14100,6205,1376,10648,1
53,2451,1943,715,1694,26,18,214,1969,12,185,120,237,197,357,1436,2721,7,20915,1161,0,2,11,0,14100,6207,1376,10649,1
149,3000,1943,715,1694,26,18,214,1969,12,185,120,237,197,357,1436,2721,7,20915,1161,0,2,12,4,14100,6209,1376,10650,1
149,3000,1168,838,957,57,25,144,1225,19,348,224,416,367,640,3018,5452,11,61921,3440,1,2,12,4,14110,6211,1376,10651,1
55,2523,1943,715,1694,26,18,214,1969,12,185,120,237,197,357,1436,2721,7,20915,1161,0,2,14,0,14110,6213,1376,10652,1
254,5398,72,33,56,0,4,12,72,1,1,1,1,2,2,0,2,0,1,0,0,2,5,3,14110,6213,1376,10653,1
254,5398,1454,835,1044,76,110,219,1530,17,275,158,296,292,454,2297,3718,9,34017,1889,1,2,5,3,14120,6214,1376,10654,1
6,286,42,7,35,4,0,5,46,1,2,1,2,3,3,2,4,0,2,0,0,2,1,1,14130,6218,1377,10662,1
6,286,11,6,10,0,0,1,11,2,4,2,4,6,6,10,15,1,15,0,0,2,1,1,14130,6218,1377,10663,1
6,286,42,7,35,4,0,5,46,1,2,1,2,3,3,2,4,0,2,0,0,2,1,1,14140,6222,1378,10671,1
6,286,11,6,10,0,0,1,11,2,4,2,4,6,6,10,15,1,15,0,0,2,1,1,14140,6222,1378,10672,1
39,1254,1523,757,1297,19,12,193,1542,12,193,117,230,205,347,1508,2664,7,19053,1058,0,2,14,8,14150,6224,1378,10673,1
39,1254,701,378,504,33,58,109,734,13,110,68,126,123,194,794,1346,7,10027,557,0,2,14,8,14150,6225,1379,10674,1
29,1871,1523,757,1297,19,12,193,1542,12,193,117,230,205,347,1508,2664,7,19053,1058,0,2,13,17,14160,6227,1379,10675,1
6,286,42,7,35,4,0,5,46,1,2,1,2,3,3,2,4,0,2,0,0,2,1,1,14170,6231,1380,10683,0
6,286,11,6,10,0,0,1,11,2,4,2,4,6,6,10,15,1,15,0,0,2,1,1,14170,6231,1380,10684,0
118,3823,1660,832,1314,41,38,274,1701,20,312,209,395,332,604,2671,5058,12,64042,3557,1,2,0,1,14170,6233,1381,10686,0
118,3823,1057,646,719,113,100,145,1170,18,215,134,248,233,382,1740,3004,10,31186,1732,1,2,0,1,14180,6234,1382,10687,0
83,1472,1178,367,1042,6,15,115,1184,9,94,51,95,103,146,644,976,4,4439,246,0,2,8,0,14190,6238,1383,10695,1
83,1472,177,108,140,8,0,27,185,6,30,16,32,36,48,162,248,3,794,44,0,2,8,0,14190,6240,1383,10696,1
50,991,1098,241,925,5,10,155,1103,7,46,25,49,53,74,273,423,3,1580,87,0,2,9,3,14200,6242,1383,10697,1
50,991,282,202,222,14,2,44,296,8,42,24,43,50,67,250,378,4,1548,86,0,2,9,3,14200,6243,1383,10698,1
6,286,42,7,35,4,0,5,46,1,2,1,2,3,3,2,4,0,2,0,0,2,1,1,14200,6243,1383,10699,1
6,286,11,6,10,0,0,1,11,2,4,2,4,6,6,10,15,1,15,0,0,2,1,1,14200,6243,1383,10700,1
25,961,1098,241,925,5,10,155,1103,7,46,25,49,53,74,273,423,3,1580,87,0,2,21,0,14210,6245,1383,10701,1
118,3823,1660,832,1314,41,38,274,1701,20,312,209,395,332,604,2671,5058,12,64042,3557,1,2,0,1,14210,6247,1384,10703,0
118,3823,1057,646,719,113,100,145,1170,18,215,134,248,233,382,1740,3004,10,31186,1732,1,2,0,1,14220,6248,1385,10704,0
58,1217,477,336,357,30,23,73,507,16,194,134,250,210,384,1538,2962,10,30538,1696,0,2,1,0,14230,6249,1385,10705,1
29,1871,1523,757,1297,19,12,193,1542,12,193,117,230,205,347,1508,2664,7,19053,1058,0,2,1,1,14240,6251,1385,10706,1
93,2152,1043,504,840,53,9,147,1096,9,180,112,198,189,310,1377,2344,4,11604,644,0,2,2,1,14240,6253,1385,10707,1
93,2152,383,288,292,26,6,62,409,11,65,38,67,76,105,429,656,5,3719,206,0,2,2,1,14240,6254,1385,10708,1
118,3823,1660,832,1314,41,38,274,1701,20,312,209,395,332,604,2671,5058,12,64042,3557,1,2,1,1,14240,6256,1386,10710,1
118,3823,1057,646,719,113,100,145,1170,18,215,134,248,233,382,1740,3004,10,31186,1732,1,2,1,1,14250,6257,1387,10711,1
100,2215,1660,832,1314,41,38,274,1701,20,312,209,395,332,604,2671,5058,12,64042,3557,1,2,4,0,14250,6259,1388,10713,1
27,565,2,2,2,0,0,0,2,0,0,0,0,0,0,0,0,0,0,0,0,2,1,1,14250,6259,1388,10713,1
27,565,99,48,90,1,3,5,100,0,0,0,0,0,0,0,0,0,0,0,0,2,1,1,14250,6260,1388,10714,1
27,565,8,5,5,2,0,1,10,0,0,0,0,0,0,0,0,0,0,0,0,2,1,1,14250,6260,1388,10715,1
27,565,1217,716,841,84,126,174,1301,14,185,118,215,199,333,1446,2542,8,20687,1149,0,2,1,1,14260,6262,1388,10716,1
27,565,160,89,115,0,13,31,160,7,15,11,17,22,28,78,124,3,495,27,0,2,1,1,14260,6262,1388,10717,1
27,565,10,10,9,9,0,0,19,0,0,0,0,0,0,0,0,0,0,0,0,2,1,1,14260,6262,1389,10718,1
27,565,173,84,99,8,29,36,181,5,12,7,13,17,20,54,81,2,221,12,0,2,1,1,14260,6263,1389,10719,1
27,565,3,1,1,3,0,0,6,0,0,0,0,0,0,0,0,0,0,0,0,2,1,1,14260,6263,1389,10720,1
254,5418,72,33,56,0,4,12,72,1,1,1,1,2,2,0,2,0,1,0,0,2,2,0,14260,6263,1389,10721,1
254,5418,1454,835,1044,76,110,219,1530,17,275,158,296,292,454,2297,3718,9,34017,1889,1,2,2,0,14270,6264,1389,10722,1
14,457,184,100,137,2,15,30,186,6,38,20,39,44,59,214,322,3,991,55,0,2,1,1,14270,6265,1389,10723,1
14,457,103,65,74,8,5,16,111,7,17,9,17,24,26,89,119,3,417,23,0,2,1,1,14270,6266,1389,10724,1
6,286,42,7,35,4,0,5,46,1,2,1,2,3,3,2,4,0,2,0,0,2,1,1,14280,6270,1390,10732,0
6,286,11,6,10,0,0,1,11,2,4,2,4,6,6,10,15,1,15,0,0,2,1,1,14280,6270,1390,10733,0
83,1475,1178,367,1042,6,15,115,1184,9,94,51,95,103,146,644,976,4,4439,246,0,2,1,1,14280,6270,1390,10734,1
83,1475,177,108,140,8,0,27,185,6,30,16,32,36,48,162,248,3,794,44,0,2,1,1,14280,6272,1390,10735,1
6,286,42,7,35,4,0,5,46,1,2,1,2,3,3,2,4,0,2,0,0,2,1,1,14290,6276,1391,10743,1
6,286,11,6,10,0,0,1,11,2,4,2,4,6,6,10,15,1,15,0,0,2,1,1,14290,6276,1391,10744,1
6,286,42,7,35,4,0,5,46,1,2,1,2,3,3,2,4,0,2,0,0,2,2,2,14290,6276,1391,10745,1
6,286,11,6,10,0,0,1,11,2,4,2,4,6,6,10,15,1,15,0,0,2,2,2,14290,6276,1391,10746,1
6,286,42,7,35,4,0,5,46,1,2,1,2,3,3,2,4,0,2,0,0,2,2,2,14300,6280,1392,10754,1
6,286,11,6,10,0,0,1,11,2,4,2,4,6,6,10,15,1,15,0,0,2,2,2,14300,6280,1392,10755,1
150,3427,77,34,69,0,0,8,77,3,24,16,29,27,45,114,213,1,387,21,0,2,29,24,14300,6280,1392,10756,1
150,3427,712,438,573,51,9,84,763,14,102,71,128,116,199,733,1364,8,11988,666,0,2,29,24,14310,6281,1392,10757,1
59,2468,1289,550,1043,56,32,155,1345,10,167,93,185,177,278,1266,2075,5,11498,638,0,2,16,0,14310,6283,1393,10758,1
55,2523,1943,715,1694,26,18,214,1969,12,185,120,237,197,357,1436,2721,7,20915,1161,0,2,1,1,14310,6285,1393,10759,1
59,2468,1289,550,1043,56,32,155,1345,10,167,93,185,177,278,1266,2075,5,11498,638,0,2,2,2,14310,6287,1394,10760,0
14,457,184,100,137,2,15,30,186,6,38,20,39,44,59,214,322,3,991,55,0,2,1,1,14310,6288,1394,10761,1
14,457,103,65,74,8,5,16,111,7,17,9,17,24,26,89,119,3,417,23,0,2,1,1,14310,6289,1394,10762,1
100,2224,1660,832,1314,41,38,274,1701,20,312,209,395,332,604,2671,5058,12,64042,3557,1,2,1,0,14310,6291,1395,10764,0
40,1265,1523,757,1297,19,12,193,1542,12,193,117,230,205,347,1508,2664,7,19053,1058,0,2,6,3,14320,6293,1395,10765,1
40,1265,701,378,504,33,58,109,734,13,110,68,126,123,194,794,1346,7,10027,557,0,2,6,3,14320,6294,1396,10766,1
30,1909,1523,757,1297,19,12,193,1542,12,193,117,230,205,347,1508,2664,7,19053,1058,0,2,7,0,14330,6296,1396,10767,1
6,71,127,75,83,2,11,30,129,4,14,7,14,18,21,61,87,2,175,9,0,0,16,0,14330,6296,1396,10768,1
6,71,652,304,544,16,6,88,668,6,89,51,101,95,152,591,998,3,3399,188,0,0,16,0,14330,6297,1396,10769,1
6,71,2,2,2,0,0,0,2,0,0,0,0,0,0,0,0,0,0,0,0,0,16,0,14330,6297,1396,10769,1
6,71,8,5,5,0,0,3,8,0,0,0,0,0,0,0,0,0,0,0,0,0,16,0,14330,6297,1396,10770,1
6,71,2,2,2,0,0,0,2,0,0,0,0,0,0,0,0,0,0,0,0,0,16,0,14330,6297,1396,10770,1
6,71,14,8,8,0,0,6,14,0,0,0,0,0,0,0,0,0,0,0,0,0,16,0,14330,6297,1396,10771,1
6,71,6,4,4,0,0,2,6,0,0,0,0,0,0,0,0,0,0,0,0,0,16,0,14330,6297,1396,10772,1
6,71,6,4,4,0,0,2,6,1,2,1,2,3,3,2,4,0,2,0,0,0,16,0,14330,6297,1396,10773,1
6,71,6,4,4,0,0,2,6,0,0,0,0,0,0,0,0,0,0,0,0,0,16,0,14330,6297,1396,10774,1
6,71,7,5,5,0,0,2,7,0,0,0,0,0,0,0,0,0,0,0,0,0,16,0,14330,6297,1396,10775,1
6,71,6,4,4,0,0,2,6,0,0,0,0,0,0,0,0,0,0,0,0,0,16,0,14330,6297,1396,10776,1
6,71,10,6,6,0,0,4,10,0,0,0,0,0,0,0,0,0,0,0,0,0,16,0,14330,6297,1396,10777,1
6,71,1,1,1,0,0,0,1,0,0,0,0,0,0,0,0,0,0,0,0,0,16,0,14330,6297,1396,10777,1
6,71,14,10,10,0,0,4,14,1,1,1,1,2,2,0,2,0,1,0,0,0,16,0,14330,6297,1396,10778,1
6,71,46,26,30,3,0,12,49,3,6,3,6,9,9,20,28,1,42,2,0,0,16,0,14340,6297,1396,10779,1
69,1238,1513,682,1277,25,13,200,1538,11,199,116,219,210,335,1557,2584,6,15641,868,0,2,24,13,14350,6303,1397,10787,1
69,1238,819,519,539,24,98,155,843,15,96,57,106,111,163,690,1107,8,9171,509,0,2,24,13,14360,6305,1397,10788,1
6,286,42,7,35,4,0,5,46,1,2,1,2,3,3,2,4,0,2,0,0,2,1,1,14360,6305,1397,10789,1
6,286,11,6,10,0,0,1,11,2,4,2,4,6,6,10,15,1,15,0,0,2,1,1,14360,6305,1397,10790,1
41,1693,1513,682,1277,25,13,200,1538,11,199,116,219,210,335,1557,2584,6,15641,868,0,2,27,0,14360,6307,1397,10791,1
68,1218,1513,682,1277,25,13,200,1538,11,199,116,219,210,335,1557,2584,6,15641,868,0,2,6,10,14360,6309,1397,10792,0
68,1218,819,519,539,24,98,155,843,15,96,57,106,111,163,690,1107,8,9171,509,0,2,6,10,14370,6311,1397,10793,0
1,194,382,65,130,157,2,92,539,4,10,5,10,14,15,41,57,2,114,6,0,0,273,0,14460,6331,1403,10893,1
56,977,282,196,195,3,0,86,285,8,130,71,141,138,212,936,1507,4,6538,363,0,0,213,0,14470,6332,1404,10906,1
4,77,127,75,83,2,11,30,129,4,14,7,14,18,21,61,87,2,175,9,0,0,10,0,14470,6332,1404,10907,1
4,77,652,304,544,16,6,88,668,6,89,51,101,95,152,591,998,3,3399,188,0,0,10,0,14470,6333,1404,10908,1
4,77,2,2,2,0,0,0,2,0,0,0,0,0,0,0,0,0,0,0,0,0,10,0,14470,6333,1404,10908,1
4,77,8,5,5,0,0,3,8,0,0,0,0,0,0,0,0,0,0,0,0,0,10,0,14470,6333,1404,10909,1
4,77,2,2,2,0,0,0,2,0,0,0,0,0,0,0,0,0,0,0,0,0,10,0,14470,6333,1404,10909,1
4,77,14,8,8,0,0,6,14,0,0,0,0,0,0,0,0,0,0,0,0,0,10,0,14470,6333,1404,10910,1
4,77,6,4,4,0,0,2,6,0,0,0,0,0,0,0,0,0,0,0,0,0,10,0,14470,6333,1404,10911,1
4,77,6,4,4,0,0,2,6,1,2,1,2,3,3,2,4,0,2,0,0,0,10,0,14470,6333,1404,10912,1
4,77,6,4,4,0,0,2,6,0,0,0,0,0,0,0,0,0,0,0,0,0,10,0,14470,6333,1404,10913,1
4,77,7,5,5,0,0,2,7,0,0,0,0,0,0,0,0,0,0,0,0,0,10,0,14470,6333,1404,10914,1
4,77,6,4,4,0,0,2,6,0,0,0,0,0,0,0,0,0,0,0,0,0,10,0,14470,6333,1404,10915,1
4,77,10,6,6,0,0,4,10,0,0,0,0,0,0,0,0,0,0,0,0,0,10,0,14470,6333,1404,10916,1
4,77,1,1,1,0,0,0,1,0,0,0,0,0,0,0,0,0,0,0,0,0,10,0,14470,6333,1404,10916,1
4,77,14,10,10,0,0,4,14,1,1,1,1,2,2,0,2,0,1,0,0,0,10,0,14470,6333,1404,10917,1
4,77,46,26,30,3,0,12,49,3,6,3,6,9,9,20,28,1,42,2,0,0,10,0,14480,6333,1404,10918,1
1,9,2,2,2,0,0,0,2,0,0,0,0,0,0,0,0,0,0,0,0,0,5,0,14480,6333,1404,10918,1
1,84,13,10,10,0,0,3,13,1,2,1,2,3,3,2,4,0,2,0,0,0,14,0,14480,6333,1404,10919,1
7,111,44,19,17,0,16,11,44,3,14,7,14,17,21,58,85,1,128,7,0,0,42,0,14480,6333,1404,10920,1
3,71,127,75,83,2,11,30,129,4,14,7,14,18,21,61,87,2,175,9,0,0,17,0,14490,6334,1404,10933,1
3,71,652,304,544,16,6,88,668,6,89,51,101,95,152,591,998,3,3399,188,0,0,17,0,14490,6335,1404,10934,1
3,71,2,2,2,0,0,0,2,0,0,0,0,0,0,0,0,0,0,0,0,0,17,0,14490,6335,1404,10934,1
3,71,8,5,5,0,0,3,8,0,0,0,0,0,0,0,0,0,0,0,0,0,17,0,14490,6335,1404,10935,1
3,71,2,2,2,0,0,0,2,0,0,0,0,0,0,0,0,0,0,0,0,0,17,0,14490,6335,1404,10935,1
3,71,14,8,8,0,0,6,14,0,0,0,0,0,0,0,0,0,0,0,0,0,17,0,14490,6335,1404,10936,1
3,71,6,4,4,0,0,2,6,0,0,0,0,0,0,0,0,0,0,0,0,0,17,0,14490,6335,1404,10937,1
3,71,6,4,4,0,0,2,6,1,2,1,2,3,3,2,4,0,2,0,0,0,17,0,14490,6335,1404,10938,1
3,71,6,4,4,0,0,2,6,0,0,0,0,0,0,0,0,0,0,0,0,0,17,0,14490,6335,1404,10939,1
3,71,7,5,5,0,0,2,7,0,0,0,0,0,0,0,0,0,0,0,0,0,17,0,14490,6335,1404,10940,1
3,71,6,4,4,0,0,2,6,0,0,0,0,0,0,0,0,0,0,0,0,0,17,0,14490,6335,1404,10941,1
3,71,10,6,6,0,0,4,10,0,0,0,0,0,0,0,0,0,0,0,0,0,17,0,14490,6335,1404,10942,1
3,71,1,1,1,0,0,0,1,0,0,0,0,0,0,0,0,0,0,0,0,0,17,0,14490,6335,1404,10942,1
3,71,14,10,10,0,0,4,14,1,1,1,1,2,2,0,2,0,1,0,0,0,17,0,14490,6335,1404,10943,1
3,71,46,26,30,3,0,12,49,3,6,3,6,9,9,20,28,1,42,2,0,0,17,0,14500,6335,1404,10944,1
10,326,72,33,56,0,4,12,72,1,1,1,1,2,2,0,2,0,1,0,0,0,60,0,14520,6343,1406,10959,1
12,222,127,75,83,2,11,30,129,4,14,7,14,18,21,61,87,2,175,9,0,0,40,0,14530,6347,1407,10967,1
12,222,652,304,544,16,6,88,668,6,89,51,101,95,152,591,998,3,3399,188,0,0,40,0,14530,6348,1407,10968,1
12,222,2,2,2,0,0,0,2,0,0,0,0,0,0,0,0,0,0,0,0,0,40,0,14530,6348,1407,10968,1
12,222,8,5,5,0,0,3,8,0,0,0,0,0,0,0,0,0,0,0,0,0,40,0,14530,6348,1407,10969,1
12,222,2,2,2,0,0,0,2,0,0,0,0,0,0,0,0,0,0,0,0,0,40,0,14530,6348,1407,10969,1
12,222,14,8,8,0,0,6,14,0,0,0,0,0,0,0,0,0,0,0,0,0,40,0,14530,6348,1407,10970,1
12,222,6,4,4,0,0,2,6,0,0,0,0,0,0,0,0,0,0,0,0,0,40,0,14530,6348,1407,10971,1
12,222,6,4,4,0,0,2,6,1,2,1,2,3,3,2,4,0,2,0,0,0,40,0,14530,6348,1407,10972,1
12,222,6,4,4,0,0,2,6,0,0,0,0,0,0,0,0,0,0,0,0,0,40,0,14530,6348,1407,10973,1
12,222,7,5,5,0,0,2,7,0,0,0,0,0,0,0,0,0,0,0,0,0,40,0,14530,6348,1407,10974,1
12,222,6,4,4,0,0,2,6,0,0,0,0,0,0,0,0,0,0,0,0,0,40,0,14530,6348,1407,10975,1
12,222,10,6,6,0,0,4,10,0,0,0,0,0,0,0,0,0,0,0,0,0,40,0,14530,6348,1407,10976,1
12,222,1,1,1,0,0,0,1,0,0,0,0,0,0,0,0,0,0,0,0,0,40,0,14530,6348,1407,10976,1
12,222,14,10,10,0,0,4,14,1,1,1,1,2,2,0,2,0,1,0,0,0,40,0,14530,6348,1407,10977,1
12,222,46,26,30,3,0,12,49,3,6,3,6,9,9,20,28,1,42,2,0,0,40,0,14540,6348,1407,10978,1
6,71,127,75,83,2,11,30,129,4,14,7,14,18,21,61,87,2,175,9,0,0,16,0,14540,6348,1407,10979,1
6,71,652,304,544,16,6,88,668,6,89,51,101,95,152,591,998,3,3399,188,0,0,16,0,14540,6349,1407,10980,1
6,71,2,2,2,0,0,0,2,0,0,0,0,0,0,0,0,0,0,0,0,0,16,0,14540,6349,1407,10980,1
6,71,8,5,5,0,0,3,8,0,0,0,0,0,0,0,0,0,0,0,0,0,16,0,14540,6349,1407,10981,1
6,71,2,2,2,0,0,0,2,0,0,0,0,0,0,0,0,0,0,0,0,0,16,0,14540,6349,1407,10981,1
6,71,14,8,8,0,0,6,14,0,0,0,0,0,0,0,0,0,0,0,0,0,16,0,14540,6349,1407,10982,1
6,71,6,4,4,0,0,2,6,0,0,0,0,0,0,0,0,0,0,0,0,0,16,0,14540,6349,1407,10983,1
6,71,6,4,4,0,0,2,6,1,2,1,2,3,3,2,4,0,2,0,0,0,16,0,14540,6349,1407,10984,1
6,71,6,4,4,0,0,2,6,0,0,0,0,0,0,0,0,0,0,0,0,0,16,0,14540,6349,1407,10985,1
6,71,7,5,5,0,0,2,7,0,0,0,0,0,0,0,0,0,0,0,0,0,16,0,14540,6349,1407,10986,1
6,71,6,4,4,0,0,2,6,0,0,0,0,0,0,0,0,0,0,0,0,0,16,0,14540,6349,1407,10987,1
6,71,10,6,6,0,0,4,10,0,0,0,0,0,0,0,0,0,0,0,0,0,16,0,14540,6349,1407,10988,1
6,71,1,1,1,0,0,0,1,0,0,0,0,0,0,0,0,0,0,0,0,0,16,0,14540,6349,1407,10988,1
6,71,14,10,10,0,0,4,14,1,1,1,1,2,2,0,2,0,1,0,0,0,16,0,14540,6349,1407,10989,1
6,71,46,26,30,3,0,12,49,3,6,3,6,9,9,20,28,1,42,2,0,0,16,0,14550,6349,1407,10990,1
3,23,14,7,7,2,0,5,16,0,0,0,0,0,0,0,0,0,0,0,0,0,11,0,14550,6349,1407,10990,1
6,81,38,23,23,0,0,15,38,0,0,0,0,0,0,0,0,0,0,0,0,0,25,0,14550,6349,1407,10991,1
1,170,382,65,130,157,2,92,539,4,10,5,10,14,15,41,57,2,114,6,0,2,1,3,14550,6350,1408,10992,0
1,173,382,65,130,157,2,92,539,4,10,5,10,14,15,41,57,2,114,6,0,2,1,3,14550,6351,1409,10993,0
1,172,382,65,130,157,2,92,539,4,10,5,10,14,15,41,57,2,114,6,0,2,1,1,14550,6352,1410,10994,1
1,175,382,65,130,157,2,92,539,4,10,5,10,14,15,41,57,2,114,6,0,2,1,1,14550,6353,1411,10995,1
1,172,382,65,130,157,2,92,539,4,10,5,10,14,15,41,57,2,114,6,0,2,8,7,14550,6354,1412,10996,1
118,3823,1660,832,1314,41,38,274,1701,20,312,209,395,332,604,2671,5058,12,64042,3557,1,2,1,1,14550,6356,1413,10998,0
118,3823,1057,646,719,113,100,145,1170,18,215,134,248,233,382,1740,3004,10,31186,1732,1,2,1,1,14560,6357,1414,10999,0
6,286,42,7,35,4,0,5,46,1,2,1,2,3,3,2,4,0,2,0,0,2,1,1,14570,6361,1415,11007,1
6,286,11,6,10,0,0,1,11,2,4,2,4,6,6,10,15,1,15,0,0,2,1,1,14570,6361,1415,11008,1
1,172,382,65,130,157,2,92,539,4,10,5,10,14,15,41,57,2,114,6,0,2,1,1,14570,6362,1416,11009,1
83,1481,1178,367,1042,6,15,115,1184,9,94,51,95,103,146,644,976,4,4439,246,0,2,1,0,14570,6362,1416,11010,1
83,1481,177,108,140,8,0,27,185,6,30,16,32,36,48,162,248,3,794,44,0,2,1,0,14570,6364,1416,11011,1
37,1694,1178,367,1042,6,15,115,1184,9,94,51,95,103,146,644,976,4,4439,246,0,2,16,0,14570,6364,1416,11012,1
153,3064,1943,715,1694,26,18,214,1969,12,185,120,237,197,357,1436,2721,7,20915,1161,0,2,11,0,14570,6366,1416,11013,1
153,3064,1168,838,957,57,25,144,1225,19,348,224,416,367,640,3018,5452,11,61921,3440,1,2,11,0,14580,6368,1416,11014,1
56,2543,1943,715,1694,26,18,214,1969,12,185,120,237,197,357,1436,2721,7,20915,1161,0,2,4,0,14580,6370,1416,11015,1
43,415,647,139,84,35,284,233,682,0,0,0,0,0,0,0,0,0,0,0,0,2,1,1,14590,6374,1417,11023,1
150,3427,77,34,69,0,0,8,77,3,24,16,29,27,45,114,213,1,387,21,0,2,0,1,14590,6374,1417,11024,1
150,3427,712,438,573,51,9,84,763,14,102,71,128,116,199,733,1364,8,11988,666,0,2,0,1,14600,6375,1417,11025,1
154,3083,1943,715,1694,26,18,214,1969,12,185,120,237,197,357,1436,2721,7,20915,1161,0,2,11,7,14600,6377,1417,11026,1
154,3083,1168,838,957,57,25,144,1225,19,348,224,416,367,640,3018,5452,11,61921,3440,1,2,11,7,14610,6379,1417,11027,1
6,286,42,7,35,4,0,5,46,1,2,1,2,3,3,2,4,0,2,0,0,2,1,1,14610,6379,1417,11028,1
6,286,11,6,10,0,0,1,11,2,4,2,4,6,6,10,15,1,15,0,0,2,1,1,14610,6379,1417,11029,1
56,2548,1943,715,1694,26,18,214,1969,12,185,120,237,197,357,1436,2721,7,20915,1161,0,2,8,5,14610,6381,1417,11030,1
118,3820,1660,832,1314,41,38,274,1701,20,312,209,395,332,604,2671,5058,12,64042,3557,1,2,43,40,14610,6383,1418,11032,1
118,3820,1057,646,719,113,100,145,1170,18,215,134,248,233,382,1740,3004,10,31186,1732,1,2,43,40,14620,6384,1419,11033,1
58,1217,477,336,357,30,23,73,507,16,194,134,250,210,384,1538,2962,10,30538,1696,0,2,1,3,14630,6385,1419,11034,1
150,3428,77,34,69,0,0,8,77,3,24,16,29,27,45,114,213,1,387,21,0,2,13,8,14630,6385,1419,11035,1
150,3428,712,438,573,51,9,84,763,14,102,71,128,116,199,733,1364,8,11988,666,0,2,13,8,14640,6386,1419,11036,1
35,628,127,75,83,2,11,30,129,4,14,7,14,18,21,61,87,2,175,9,0,2,1,0,14640,6386,1419,11037,0
35,628,652,304,544,16,6,88,668,6,89,51,101,95,152,591,998,3,3399,188,0,2,1,0,14640,6387,1419,11038,0
35,628,2,2,2,0,0,0,2,0,0,0,0,0,0,0,0,0,0,0,0,2,1,0,14640,6387,1419,11038,0
35,628,8,5,5,0,0,3,8,0,0,0,0,0,0,0,0,0,0,0,0,2,1,0,14640,6387,1419,11039,0
35,628,2,2,2,0,0,0,2,0,0,0,0,0,0,0,0,0,0,0,0,2,1,0,14640,6387,1419,11039,0
35,628,14,8,8,0,0,6,14,0,0,0,0,0,0,0,0,0,0,0,0,2,1,0,14640,6387,1419,11040,0
35,628,6,4,4,0,0,2,6,0,0,0,0,0,0,0,0,0,0,0,0,2,1,0,14640,6387,1419,11041,0
35,628,6,4,4,0,0,2,6,1,2,1,2,3,3,2,4,0,2,0,0,2,1,0,14640,6387,1419,11042,0
35,628,6,4,4,0,0,2,6,0,0,0,0,0,0,0,0,0,0,0,0,2,1,0,14640,6387,1419,11043,0
35,628,7,5,5,0,0,2,7,0,0,0,0,0,0,0,0,0,0,0,0,2,1,0,14640,6387,1419,11044,0
35,628,6,4,4,0,0,2,6,0,0,0,0,0,0,0,0,0,0,0,0,2,1,0,14640,6387,1419,11045,0
35,628,10,6,6,0,0,4,10,0,0,0,0,0,0,0,0,0,0,0,0,2,1,0,14640,6387,1419,11046,0
35,628,1,1,1,0,0,0,1,0,0,0,0,0,0,0,0,0,0,0,0,2,1,0,14640,6387,1419,11046,0
35,628,14,10,10,0,0,4,14,1,1,1,1,2,2,0,2,0,1,0,0,2,1,0,14640,6387,1419,11047,0
35,628,46,26,30,3,0,12,49,3,6,3,6,9,9,20,28,1,42,2,0,2,1,0,14650,6387,1419,11048,0
40,1264,1523,757,1297,19,12,193,1542,12,193,117,230,205,347,1508,2664,7,19053,1058,0,2,3,3,14670,6393,1420,11056,1
40,1264,701,378,504,33,58,109,734,13,110,68,126,123,194,794,1346,7,10027,557,0,2,3,3,14670,6394,1421,11057,1
150,3423,77,34,69,0,0,8,77,3,24,16,29,27,45,114,213,1,387,21,0,2,1,1,14670,6394,1421,11058,1
150,3423,712,438,573,51,9,84,763,14,102,71,128,116,199,733,1364,8,11988,666,0,2,1,1,14680,6395,1421,11059,1
23,555,1293,570,1093,25,15,163,1318,10,195,123,241,205,364,1516,2795,6,17273,959,0,2,2,2,14690,6397,1421,11060,1
83,1451,1178,367,1042,6,15,115,1184,9,94,51,95,103,146,644,976,4,4439,246,0,2,16,16,14690,6397,1421,11061,1
83,1451,177,108,140,8,0,27,185,6,30,16,32,36,48,162,248,3,794,44,0,2,16,16,14690,6399,1421,11062,1
6,286,42,7,35,4,0,5,46,1,2,1,2,3,3,2,4,0,2,0,0,2,1,1,14690,6399,1421,11063,1
6,286,11,6,10,0,0,1,11,2,4,2,4,6,6,10,15,1,15,0,0,2,1,1,14690,6399,1421,11064,1
30,1909,1523,757,1297,19,12,193,1542,12,193,117,230,205,347,1508,2664,7,19053,1058,0,2,2,2,14700,6401,1421,11065,1
38,1723,1178,367,1042,6,15,115,1184,9,94,51,95,103,146,644,976,4,4439,246,0,2,29,5,14700,6401,1421,11066,1
94,2157,1043,504,840,53,9,147,1096,9,180,112,198,189,310,1377,2344,4,11604,644,0,2,5,2,14700,6403,1421,11067,1
94,2157,383,288,292,26,6,62,409,11,65,38,67,76,105,429,656,5,3719,206,0,2,5,2,14700,6404,1421,11068,1
154,3088,1943,715,1694,26,18,214,1969,12,185,120,237,197,357,1436,2721,7,20915,1161,0,2,5,4,14700,6406,1421,11069,1
154,3088,1168,838,957,57,25,144,1225,19,348,224,416,367,640,3018,5452,11,61921,3440,1,2,5,4,14710,6408,1421,11070,1
44,1808,1043,504,840,53,9,147,1096,9,180,112,198,189,310,1377,2344,4,11604,644,0,2,18,0,14710,6410,1421,11071,1
68,1215,1513,682,1277,25,13,200,1538,11,199,116,219,210,335,1557,2584,6,15641,868,0,2,3,3,14720,6416,1422,11079,1
68,1215,819,519,539,24,98,155,843,15,96,57,106,111,163,690,1107,8,9171,509,0,2,3,3,14730,6418,1422,11080,1
181,4153,77,34,69,0,0,8,77,3,24,16,29,27,45,114,213,1,387,21,0,2,168,9,14730,6418,1422,11081,1
181,4153,712,438,573,51,9,84,763,14,102,71,128,116,199,733,1364,8,11988,666,0,2,168,9,14740,6419,1422,11082,1
185,4355,722,423,573,19,0,135,741,12,172,101,199,184,300,1320,2257,6,15668,870,0,2,1,1,14740,6421,1422,11084,1
185,4355,1508,847,911,44,250,301,1552,14,148,88,169,162,257,1120,1886,7,15077,837,0,2,1,1,14740,6422,1423,11085,1
233,4981,72,33,56,0,4,12,72,1,1,1,1,2,2,0,2,0,1,0,0,2,178,271,14740,6422,1423,11086,1
233,4981,1454,835,1044,76,110,219,1530,17,275,158,296,292,454,2297,3718,9,34017,1889,1,2,178,271,14750,6423,1423,11087,1
29,603,215,129,180,6,0,29,221,8,65,43,72,73,115,415,711,4,3153,175,0,2,3,1,14750,6423,1423,11088,1
29,603,97,69,77,3,3,16,100,6,22,13,23,28,36,113,173,3,542,30,0,2,3,1,14750,6424,1423,11089,1
11,345,442,244,305,14,16,103,456,11,68,45,75,79,120,452,756,6,4588,254,0,2,3,3,14750,6426,1423,11090,1
11,345,182,102,99,11,40,35,193,3,11,6,11,14,17,42,64,1,97,5,0,2,3,3,14750,6427,1423,11091,1
1,178,382,65,130,157,2,92,539,4,10,5,10,14,15,41,57,2,114,6,0,2,7,2,14750,6428,1424,11092,1
6,286,42,7,35,4,0,5,46,1,2,1,2,3,3,2,4,0,2,0,0,2,1,1,14750,6428,1424,11093,1
6,286,11,6,10,0,0,1,11,2,4,2,4,6,6,10,15,1,15,0,0,2,1,1,14750,6428,1424,11094,1
28,1113,1450,624,1228,12,26,181,1462,14,306,186,354,320,540,2580,4493,8,36391,2021,1,2,19,27,14750,6430,1425,11095,1
6,452,442,244,305,14,16,103,456,11,68,45,75,79,120,452,756,6,4588,254,0,2,2,3,14750,6432,1425,11096,1
233,4981,72,33,56,0,4,12,72,1,1,1,1,2,2,0,2,0,1,0,0,2,3,3,14750,6432,1425,11097,0
233,4981,1454,835,1044,76,110,219,1530,17,275,158,296,292,454,2297,3718,9,34017,1889,1,2,3,3,14760,6433,1425,11098,0
137,2710,1457,730,1242,11,6,188,1468,10,292,166,329,302,495,2424,4078,5,22973,1276,1,2,0,3,14760,6435,1425,11099,0
137,2710,74,35,59,1,0,14,75,3,14,7,14,17,21,58,85,1,128,7,0,2,0,3,14760,6436,1425,11100,0
137,2710,245,125,200,5,7,34,250,7,30,17,34,37,51,166,265,3,1053,58,0,2,0,3,14770,6437,1425,11101,0
139,2729,1457,730,1242,11,6,188,1468,10,292,166,329,302,495,2424,4078,5,22973,1276,1,2,14,10,14780,6443,1426,11109,1
139,2729,74,35,59,1,0,14,75,3,14,7,14,17,21,58,85,1,128,7,0,2,14,10,14780,6444,1426,11110,1
139,2729,245,125,200,5,7,34,250,7,30,17,34,37,51,166,265,3,1053,58,0,2,14,10,14790,6445,1426,11111,1
6,286,42,7,35,4,0,5,46,1,2,1,2,3,3,2,4,0,2,0,0,2,1,1,14790,6445,1426,11112,1
6,286,11,6,10,0,0,1,11,2,4,2,4,6,6,10,15,1,15,0,0,2,1,1,14790,6445,1426,11113,1
27,1295,652,304,544,16,6,88,668,6,89,51,101,95,152,591,998,3,3399,188,0,2,13,1,14790,6446,1426,11114,1
29,603,2,2,2,0,0,0,2,0,0,0,0,0,0,0,0,0,0,0,0,2,4,0,14790,6446,1426,11114,1
29,603,99,48,90,1,3,5,100,0,0,0,0,0,0,0,0,0,0,0,0,2,4,0,14790,6447,1426,11115,1
29,603,8,5,5,2,0,1,10,0,0,0,0,0,0,0,0,0,0,0,0,2,4,0,14790,6447,1426,11116,1
29,603,1217,716,841,84,126,174,1301,14,185,118,215,199,333,1446,2542,8,20687,1149,0,2,4,0,14800,6449,1426,11117,1
29,603,160,89,115,0,13,31,160,7,15,11,17,22,28,78,124,3,495,27,0,2,4,0,14800,6449,1426,11118,1
29,603,10,10,9,9,0,0,19,0,0,0,0,0,0,0,0,0,0,0,0,2,4,0,14800,6449,1427,11119,1
29,603,173,84,99,8,29,36,181,5,12,7,13,17,20,54,81,2,221,12,0,2,4,0,14800,6450,1427,11120,1
29,603,3,1,1,3,0,0,6,0,0,0,0,0,0,0,0,0,0,0,0,2,4,0,14800,6450,1427,11121,1
57,1197,477,336,357,30,23,73,507,16,194,134,250,210,384,1538,2962,10,30538,1696,0,2,0,3,14810,6451,1427,11122,1
29,1163,1450,624,1228,12,26,181,1462,14,306,186,354,320,540,2580,4493,8,36391,2021,1,2,23,0,14810,6453,1428,11123,1
118,3822,1660,832,1314,41,38,274,1701,20,312,209,395,332,604,2671,5058,12,64042,3557,1,2,1,1,14810,6455,1429,11125,0
118,3822,1057,646,719,113,100,145,1170,18,215,134,248,233,382,1740,3004,10,31186,1732,1,2,1,1,14820,6456,1430,11126,0
100,2272,1660,832,1314,41,38,274,1701,20,312,209,395,332,604,2671,5058,12,64042,3557,1,2,6,0,14820,6458,1431,11128,0
100,2255,1660,832,1314,41,38,274,1701,20,312,209,395,332,604,2671,5058,12,64042,3557,1,2,4,6,14820,6460,1432,11130,1
154,3088,1943,715,1694,26,18,214,1969,12,185,120,237,197,357,1436,2721,7,20915,1161,0,2,1,1,14820,6462,1432,11131,1
154,3088,1168,838,957,57,25,144,1225,19,348,224,416,367,640,3018,5452,11,61921,3440,1,2,1,1,14830,6464,1432,11132,1
68,1224,1513,682,1277,25,13,200,1538,11,199,116,219,210,335,1557,2584,6,15641,868,0,2,3,2,14830,6466,1432,11133,1
68,1224,819,519,539,24,98,155,843,15,96,57,106,111,163,690,1107,8,9171,509,0,2,3,2,14840,6468,1432,11134,1
153,3459,77,34,69,0,0,8,77,3,24,16,29,27,45,114,213,1,387,21,0,2,10,143,14840,6468,1432,11135,1
153,3459,712,438,573,51,9,84,763,14,102,71,128,116,199,733,1364,8,11988,666,0,2,10,143,14850,6469,1432,11136,1
261,5627,72,33,56,0,4,12,72,1,1,1,1,2,2,0,2,0,1,0,0,2,144,12,14850,6469,1432,11137,1
261,5627,1454,835,1044,76,110,219,1530,17,275,158,296,292,454,2297,3718,9,34017,1889,1,2,144,12,14860,6470,1432,11138,1
154,3478,77,34,69,0,0,8,77,3,24,16,29,27,45,114,213,1,387,21,0,2,26,0,14860,6470,1432,11139,0
154,3478,712,438,573,51,9,84,763,14,102,71,128,116,199,733,1364,8,11988,666,0,2,26,0,14870,6471,1432,11140,0
1,178,382,65,130,157,2,92,539,4,10,5,10,14,15,41,57,2,114,6,0,2,1,1,14870,6472,1433,11141,1
154,3478,77,34,69,0,0,8,77,3,24,16,29,27,45,114,213,1,387,21,0,2,1,1,14870,6472,1433,11142,1
154,3478,712,438,573,51,9,84,763,14,102,71,128,116,199,733,1364,8,11988,666,0,2,1,1,14880,6473,1433,11143,1
1,181,382,65,130,157,2,92,539,4,10,5,10,14,15,41,57,2,114,6,0,2,1,0,14880,6474,1434,11144,1
68,1224,1513,682,1277,25,13,200,1538,11,199,116,219,210,335,1557,2584,6,15641,868,0,2,2,2,14880,6476,1434,11145,1
68,1224,819,519,539,24,98,155,843,15,96,57,106,111,163,690,1107,8,9171,509,0,2,2,2,14890,6478,1434,11146,1
153,3466,77,34,69,0,0,8,77,3,24,16,29,27,45,114,213,1,387,21,0,2,4,4,14890,6478,1434,11147,1
153,3466,712,438,573,51,9,84,763,14,102,71,128,116,199,733,1364,8,11988,666,0,2,4,4,14900,6479,1434,11148,1
277,5802,72,33,56,0,4,12,72,1,1,1,1,2,2,0,2,0,1,0,0,2,221,172,14900,6479,1434,11149,1
277,5802,1454,835,1044,76,110,219,1530,17,275,158,296,292,454,2297,3718,9,34017,1889,1,2,221,172,14910,6480,1434,11150,1
11,347,442,244,305,14,16,103,456,11,68,45,75,79,120,452,756,6,4588,254,0,2,3,3,14910,6482,1434,11151,1
11,347,182,102,99,11,40,35,193,3,11,6,11,14,17,42,64,1,97,5,0,2,3,3,14910,6483,1434,11152,1
68,1223,1513,682,1277,25,13,200,1538,11,199,116,219,210,335,1557,2584,6,15641,868,0,2,2,2,14910,6485,1434,11153,1
68,1223,819,519,539,24,98,155,843,15,96,57,106,111,163,690,1107,8,9171,509,0,2,2,2,14920,6487,1434,11154,1
175,4097,77,34,69,0,0,8,77,3,24,16,29,27,45,114,213,1,387,21,0,2,97,0,14920,6487,1434,11155,1
175,4097,712,438,573,51,9,84,763,14,102,71,128,116,199,733,1364,8,11988,666,0,2,97,0,14930,6488,1434,11156,1
258,5343,72,33,56,0,4,12,72,1,1,1,1,2,2,0,2,0,1,0,0,2,26,91,14930,6488,1434,11157,1
258,5343,1454,835,1044,76,110,219,1530,17,275,158,296,292,454,2297,3718,9,34017,1889,1,2,26,91,14940,6489,1434,11158,1
36,1526,1020,354,843,12,15,144,1032,8,134,77,144,142,221,970,1580,4,6792,377,0,2,1,1,14940,6489,1434,11159,1
23,970,373,158,315,8,0,51,381,5,76,44,79,81,123,486,779,2,2026,112,0,2,9,9,14940,6489,1434,11160,1
182,4179,77,34,69,0,0,8,77,3,24,16,29,27,45,114,213,1,387,21,0,2,72,55,14940,6489,1434,11161,1
182,4179,712,438,573,51,9,84,763,14,102,71,128,116,199,733,1364,8,11988,666,0,2,72,55,14950,6490,1434,11162,1
185,4360,722,423,573,19,0,135,741,12,172,101,199,184,300,1320,2257,6,15668,870,0,2,4,2,14950,6492,1434,11164,1
185,4360,1508,847,911,44,250,301,1552,14,148,88,169,162,257,1120,1886,7,15077,837,0,2,4,2,14950,6493,1435,11165,1
260,5490,72,33,56,0,4,12,72,1,1,1,1,2,2,0,2,0,1,0,0,2,47,27,14950,6493,1435,11166,1
260,5490,1454,835,1044,76,110,219,1530,17,275,158,296,292,454,2297,3718,9,34017,1889,1,2,47,27,14960,6494,1435,11167,1
23,946,373,158,315,8,0,51,381,5,76,44,79,81,123,486,779,2,2026,112,0,2,6,5,14960,6494,1435,11168,1
6,484,442,244,305,14,16,103,456,11,68,45,75,79,120,452,756,6,4588,254,0,2,8,2,14960,6496,1435,11169,1
189,4278,77,34,69,0,0,8,77,3,24,16,29,27,45,114,213,1,387,21,0,2,18,3,14960,6496,1435,11170,1
189,4278,712,438,573,51,9,84,763,14,102,71,128,116,199,733,1364,8,11988,666,0,2,18,3,14970,6497,1435,11171,1
257,5478,72,33,56,0,4,12,72,1,1,1,1,2,2,0,2,0,1,0,0,2,4,7,14970,6497,1435,11172,1
257,5478,1454,835,1044,76,110,219,1530,17,275,158,296,292,454,2297,3718,9,34017,1889,1,2,4,7,14980,6498,1435,11173,1
260,5629,72,33,56,0,4,12,72,1,1,1,1,2,2,0,2,0,1,0,0,2,35,7,14980,6498,1435,11174,1
260,5629,1454,835,1044,76,110,219,1530,17,275,158,296,292,454,2297,3718,9,34017,1889,1,2,35,7,14990,6499,1435,11175,1
191,4316,77,34,69,0,0,8,77,3,24,16,29,27,45,114,213,1,387,21,0,2,14,5,14990,6499,1435,11176,0
191,4316,712,438,573,51,9,84,763,14,102,71,128,116,199,733,1364,8,11988,666,0,2,14,5,15000,6500,1435,11177,0
261,5650,72,33,56,0,4,12,72,1,1,1,1,2,2,0,2,0,1,0,0,2,4,1,15010,6504,1436,11185,1
261,5650,1454,835,1044,76,110,219,1530,17,275,158,296,292,454,2297,3718,9,34017,1889,1,2,4,1,15020,6505,1436,11186,1
1,181,382,65,130,157,2,92,539,4,10,5,10,14,15,41,57,2,114,6,0,2,1,1,15020,6506,1437,11187,1
6,286,42,7,35,4,0,5,46,1,2,1,2,3,3,2,4,0,2,0,0,2,1,1,15020,6506,1437,11188,1
6,286,11,6,10,0,0,1,11,2,4,2,4,6,6,10,15,1,15,0,0,2,1,1,15020,6506,1437,11189,1
198,4459,77,34,69,0,0,8,77,3,24,16,29,27,45,114,213,1,387,21,0,2,23,2,15020,6506,1437,11190,1
198,4459,712,438,573,51,9,84,763,14,102,71,128,116,199,733,1364,8,11988,666,0,2,23,2,15030,6507,1437,11191,1
263,5769,72,33,56,0,4,12,72,1,1,1,1,2,2,0,2,0,1,0,0,2,50,24,15030,6507,1437,11192,1
263,5769,1454,835,1044,76,110,219,1530,17,275,158,296,292,454,2297,3718,9,34017,1889,1,2,50,24,15040,6508,1437,11193,1
203,4578,77,34,69,0,0,8,77,3,24,16,29,27,45,114,213,1,387,21,0,2,28,4,15050,6512,1438,11201,1
203,4578,712,438,573,51,9,84,763,14,102,71,128,116,199,733,1364,8,11988,666,0,2,28,4,15060,6513,1438,11202,1
270,5894,72,33,56,0,4,12,72,1,1,1,1,2,2,0,2,0,1,0,0,2,24,4,15060,6513,1438,11203,1
270,5894,1454,835,1044,76,110,219,1530,17,275,158,296,292,454,2297,3718,9,34017,1889,1,2,24,4,15070,6514,1438,11204,1
6,286,42,7,35,4,0,5,46,1,2,1,2,3,3,2,4,0,2,0,0,2,1,1,15070,6514,1438,11205,1
6,286,11,6,10,0,0,1,11,2,4,2,4,6,6,10,15,1,15,0,0,2,1,1,15070,6514,1438,11206,1
215,4791,77,34,69,0,0,8,77,3,24,16,29,27,45,114,213,1,387,21,0,2,37,2,15080,6518,1439,11214,1
215,4791,712,438,573,51,9,84,763,14,102,71,128,116,199,733,1364,8,11988,666,0,2,37,2,15090,6519,1439,11215,1
273,5991,72,33,56,0,4,12,72,1,1,1,1,2,2,0,2,0,1,0,0,2,27,9,15090,6519,1439,11216,1
273,5991,1454,835,1044,76,110,219,1530,17,275,158,296,292,454,2297,3718,9,34017,1889,1,2,27,9,15100,6520,1439,11217,1
96,2180,1043,504,840,53,9,147,1096,9,180,112,198,189,310,1377,2344,4,11604,644,0,2,7,3,15100,6522,1439,11218,1
96,2180,383,288,292,26,6,62,409,11,65,38,67,76,105,429,656,5,3719,206,0,2,7,3,15100,6523,1439,11219,1
6,286,42,7,35,4,0,5,46,1,2,1,2,3,3,2,4,0,2,0,0,2,1,1,15100,6523,1439,11220,1
6,286,11,6,10,0,0,1,11,2,4,2,4,6,6,10,15,1,15,0,0,2,1,1,15100,6523,1439,11221,1
220,4925,77,34,69,0,0,8,77,3,24,16,29,27,45,114,213,1,387,21,0,2,40,8,15100,6523,1439,11222,1
220,4925,712,438,573,51,9,84,763,14,102,71,128,116,199,733,1364,8,11988,666,0,2,40,8,15110,6524,1439,11223,1
271,5960,72,33,56,0,4,12,72,1,1,1,1,2,2,0,2,0,1,0,0,2,8,12,15110,6524,1439,11224,1
271,5960,1454,835,1044,76,110,219,1530,17,275,158,296,292,454,2297,3718,9,34017,1889,1,2,8,12,15120,6525,1439,11225,1
223,5008,77,34,69,0,0,8,77,3,24,16,29,27,45,114,213,1,387,21,0,2,34,20,15120,6525,1439,11226,1
223,5008,712,438,573,51,9,84,763,14,102,71,128,116,199,733,1364,8,11988,666,0,2,34,20,15130,6526,1439,11227,1
272,5978,72,33,56,0,4,12,72,1,1,1,1,2,2,0,2,0,1,0,0,2,20,18,15130,6526,1439,11228,1
272,5978,1454,835,1044,76,110,219,1530,17,275,158,296,292,454,2297,3718,9,34017,1889,1,2,20,18,15140,6527,1439,11229,1
259,5695,77,34,69,0,0,8,77,3,24,16,29,27,45,114,213,1,387,21,0,2,154,39,15150,6531,1440,11237,1
259,5695,712,438,573,51,9,84,763,14,102,71,128,116,199,733,1364,8,11988,666,0,2,154,39,15160,6532,1440,11238,1
267,5870,72,33,56,0,4,12,72,1,1,1,1,2,2,0,2,0,1,0,0,2,1,20,15160,6532,1440,11239,1
267,5870,1454,835,1044,76,110,219,1530,17,275,158,296,292,454,2297,3718,9,34017,1889,1,2,1,20,15170,6533,1440,11240,1
6,286,42,7,35,4,0,5,46,1,2,1,2,3,3,2,4,0,2,0,0,2,1,1,15170,6533,1440,11241,1
6,286,11,6,10,0,0,1,11,2,4,2,4,6,6,10,15,1,15,0,0,2,1,1,15170,6533,1440,11242,1
29,1172,1450,624,1228,12,26,181,1462,14,306,186,354,320,540,2580,4493,8,36391,2021,1,2,1,0,15170,6535,1441,11243,0
158,3594,77,34,69,0,0,8,77,3,24,16,29,27,45,114,213,1,387,21,0,2,3,385,15170,6535,1441,11244,1
158,3594,712,438,573,51,9,84,763,14,102,71,128,116,199,733,1364,8,11988,666,0,2,3,385,15180,6536,1441,11245,1
366,7926,72,33,56,0,4,12,72,1,1,1,1,2,2,0,2,0,1,0,0,2,357,1,15180,6536,1441,11246,1
366,7926,1454,835,1044,76,110,219,1530,17,275,158,296,292,454,2297,3718,9,34017,1889,1,2,357,1,15190,6537,1441,11247,1
379,8210,72,33,56,0,4,12,72,1,1,1,1,2,2,0,2,0,1,0,0,2,77,23,15190,6537,1441,11248,1
379,8210,1454,835,1044,76,110,219,1530,17,275,158,296,292,454,2297,3718,9,34017,1889,1,2,77,23,15200,6538,1441,11249,1
379,8214,72,33,56,0,4,12,72,1,1,1,1,2,2,0,2,0,1,0,0,2,5,2,15210,6542,1442,11257,1
379,8214,1454,835,1044,76,110,219,1530,17,275,158,296,292,454,2297,3718,9,34017,1889,1,2,5,2,15220,6543,1442,11258,1
1,181,382,65,130,157,2,92,539,4,10,5,10,14,15,41,57,2,114,6,0,2,1,1,15220,6544,1443,11259,1
6,286,42,7,35,4,0,5,46,1,2,1,2,3,3,2,4,0,2,0,0,2,1,1,15220,6544,1443,11260,1
6,286,11,6,10,0,0,1,11,2,4,2,4,6,6,10,15,1,15,0,0,2,1,1,15220,6544,1443,11261,1
383,8290,72,33,56,0,4,12,72,1,1,1,1,2,2,0,2,0,1,0,0,2,44,8,15230,6548,1444,11269,1
383,8290,1454,835,1044,76,110,219,1530,17,275,158,296,292,454,2297,3718,9,34017,1889,1,2,44,8,15240,6549,1444,11270,1
1,181,382,65,130,157,2,92,539,4,10,5,10,14,15,41,57,2,114,6,0,2,1,1,15240,6550,1445,11271,1
6,286,42,7,35,4,0,5,46,1,2,1,2,3,3,2,4,0,2,0,0,2,1,1,15240,6550,1445,11272,1
6,286,11,6,10,0,0,1,11,2,4,2,4,6,6,10,15,1,15,0,0,2,1,1,15240,6550,1445,11273,1
383,8290,72,33,56,0,4,12,72,1,1,1,1,2,2,0,2,0,1,0,0,2,5,2,15240,6550,1445,11274,1
383,8290,1454,835,1044,76,110,219,1530,17,275,158,296,292,454,2297,3718,9,34017,1889,1,2,5,2,15250,6551,1445,11275,1
1,181,382,65,130,157,2,92,539,4,10,5,10,14,15,41,57,2,114,6,0,2,1,1,15250,6552,1446,11276,1
40,1271,1523,757,1297,19,12,193,1542,12,193,117,230,205,347,1508,2664,7,19053,1058,0,2,1,1,15270,6558,1447,11284,1
40,1271,701,378,504,33,58,109,734,13,110,68,126,123,194,794,1346,7,10027,557,0,2,1,1,15270,6559,1448,11285,1
6,286,42,7,35,4,0,5,46,1,2,1,2,3,3,2,4,0,2,0,0,2,1,1,15270,6559,1448,11286,1
6,286,11,6,10,0,0,1,11,2,4,2,4,6,6,10,15,1,15,0,0,2,1,1,15270,6559,1448,11287,1
31,1956,1523,757,1297,19,12,193,1542,12,193,117,230,205,347,1508,2664,7,19053,1058,0,2,12,0,15280,6561,1448,11288,1
158,3603,77,34,69,0,0,8,77,3,24,16,29,27,45,114,213,1,387,21,0,2,2,1,15290,6565,1449,11296,1
158,3603,712,438,573,51,9,84,763,14,102,71,128,116,199,733,1364,8,11988,666,0,2,2,1,15300,6566,1449,11297,1
388,8375,72,33,56,0,4,12,72,1,1,1,1,2,2,0,2,0,1,0,0,2,34,18,15300,6566,1449,11298,1
388,8375,1454,835,1044,76,110,219,1530,17,275,158,296,292,454,2297,3718,9,34017,1889,1,2,34,18,15310,6567,1449,11299,1
6,286,42,7,35,4,0,5,46,1,2,1,2,3,3,2,4,0,2,0,0,2,1,1,15310,6567,1449,11300,1
6,286,11,6,10,0,0,1,11,2,4,2,4,6,6,10,15,1,15,0,0,2,1,1,15310,6567,1449,11301,1
390,8417,72,33,56,0,4,12,72,1,1,1,1,2,2,0,2,0,1,0,0,2,23,19,15310,6567,1449,11302,1
390,8417,1454,835,1044,76,110,219,1530,17,275,158,296,292,454,2297,3718,9,34017,1889,1,2,23,19,15320,6568,1449,11303,1
3,66,127,75,83,2,11,30,129,4,14,7,14,18,21,61,87,2,175,9,0,2,7,6,15320,6568,1449,11304,1
3,66,652,304,544,16,6,88,668,6,89,51,101,95,152,591,998,3,3399,188,0,2,7,6,15320,6569,1449,11305,1
3,66,2,2,2,0,0,0,2,0,0,0,0,0,0,0,0,0,0,0,0,2,7,6,15320,6569,1449,11305,1
3,66,8,5,5,0,0,3,8,0,0,0,0,0,0,0,0,0,0,0,0,2,7,6,15320,6569,1449,11306,1
3,66,2,2,2,0,0,0,2,0,0,0,0,0,0,0,0,0,0,0,0,2,7,6,15320,6569,1449,11306,1
3,66,14,8,8,0,0,6,14,0,0,0,0,0,0,0,0,0,0,0,0,2,7,6,15320,6569,1449,11307,1
3,66,6,4,4,0,0,2,6,0,0,0,0,0,0,0,0,0,0,0,0,2,7,6,15320,6569,1449,11308,1
3,66,6,4,4,0,0,2,6,1,2,1,2,3,3,2,4,0,2,0,0,2,7,6,15320,6569,1449,11309,1
3,66,6,4,4,0,0,2,6,0,0,0,0,0,0,0,0,0,0,0,0,2,7,6,15320,6569,1449,11310,1
3,66,7,5,5,0,0,2,7,0,0,0,0,0,0,0,0,0,0,0,0,2,7,6,15320,6569,1449,11311,1
3,66,6,4,4,0,0,2,6,0,0,0,0,0,0,0,0,0,0,0,0,2,7,6,15320,6569,1449,11312,1
3,66,10,6,6,0,0,4,10,0,0,0,0,0,0,0,0,0,0,0,0,2,7,6,15320,6569,1449,11313,1
3,66,1,1,1,0,0,0,1,0,0,0,0,0,0,0,0,0,0,0,0,2,7,6,15320,6569,1449,11313,1
3,66,14,10,10,0,0,4,14,1,1,1,1,2,2,0,2,0,1,0,0,2,7,6,15320,6569,1449,11314,1
3,66,46,26,30,3,0,12,49,3,6,3,6,9,9,20,28,1,42,2,0,2,7,6,15330,6569,1449,11315,1
7,298,72,33,56,0,4,12,72,1,1,1,1,2,2,0,2,0,1,0,0,2,11,21,15330,6569,1449,11316,1
393,8455,72,33,56,0,4,12,72,1,1,1,1,2,2,0,2,0,1,0,0,2,22,12,15330,6569,1449,11317,1
393,8455,1454,835,1044,76,110,219,1530,17,275,158,296,292,454,2297,3718,9,34017,1889,1,2,22,12,15340,6570,1449,11318,1
40,1278,1523,757,1297,19,12,193,1542,12,193,117,230,205,347,1508,2664,7,19053,1058,0,2,1,1,15350,6572,1449,11319,1
40,1278,701,378,504,33,58,109,734,13,110,68,126,123,194,794,1346,7,10027,557,0,2,1,1,15350,6573,1450,11320,1
32,1972,1523,757,1297,19,12,193,1542,12,193,117,230,205,347,1508,2664,7,19053,1058,0,2,15,12,15360,6575,1450,11321,1
393,8467,72,33,56,0,4,12,72,1,1,1,1,2,2,0,2,0,1,0,0,2,6,2,15360,6575,1450,11322,1
393,8467,1454,835,1044,76,110,219,1530,17,275,158,296,292,454,2297,3718,9,34017,1889,1,2,6,2,15370,6576,1450,11323,1
394,8478,72,33,56,0,4,12,72,1,1,1,1,2,2,0,2,0,1,0,0,2,5,0,15370,6576,1450,11324,1
394,8478,1454,835,1044,76,110,219,1530,17,275,158,296,292,454,2297,3718,9,34017,1889,1,2,5,0,15380,6577,1450,11325,1
394,8468,72,33,56,0,4,12,72,1,1,1,1,2,2,0,2,0,1,0,0,2,4,6,15380,6577,1450,11326,1
394,8468,1454,835,1044,76,110,219,1530,17,275,158,296,292,454,2297,3718,9,34017,1889,1,2,4,6,15390,6578,1450,11327,1
394,8492,72,33,56,0,4,12,72,1,1,1,1,2,2,0,2,0,1,0,0,2,8,2,15390,6578,1450,11328,1
394,8492,1454,835,1044,76,110,219,1530,17,275,158,296,292,454,2297,3718,9,34017,1889,1,2,8,2,15400,6579,1450,11329,1
394,8496,72,33,56,0,4,12,72,1,1,1,1,2,2,0,2,0,1,0,0,2,1,1,15400,6579,1450,11330,1
394,8496,1454,835,1044,76,110,219,1530,17,275,158,296,292,454,2297,3718,9,34017,1889,1,2,1,1,15410,6580,1450,11331,1
32,1972,1523,757,1297,19,12,193,1542,12,193,117,230,205,347,1508,2664,7,19053,1058,0,2,1,1,15420,6582,1450,11332,0
394,8496,72,33,56,0,4,12,72,1,1,1,1,2,2,0,2,0,1,0,0,2,13,9,15420,6582,1450,11333,0
394,8496,1454,835,1044,76,110,219,1530,17,275,158,296,292,454,2297,3718,9,34017,1889,1,2,13,9,15430,6583,1450,11334,0
32,1972,1523,757,1297,19,12,193,1542,12,193,117,230,205,347,1508,2664,7,19053,1058,0,2,1,1,15440,6585,1450,11335,0
96,2178,1043,504,840,53,9,147,1096,9,180,112,198,189,310,1377,2344,4,11604,644,0,2,4,3,15450,6591,1451,11343,1
96,2178,383,288,292,26,6,62,409,11,65,38,67,76,105,429,656,5,3719,206,0,2,4,3,15450,6592,1451,11344,1
6,286,42,7,35,4,0,5,46,1,2,1,2,3,3,2,4,0,2,0,0,2,1,1,15450,6592,1451,11345,1
6,286,11,6,10,0,0,1,11,2,4,2,4,6,6,10,15,1,15,0,0,2,1,1,15450,6592,1451,11346,1
23,1161,447,308,343,6,5,95,453,7,96,59,111,103,170,651,1136,4,4600,255,0,2,13,0,15450,6595,1451,11347,1
32,1976,1523,757,1297,19,12,193,1542,12,193,117,230,205,347,1508,2664,7,19053,1058,0,2,2,2,15460,6597,1451,11348,0
185,4356,722,423,573,19,0,135,741,12,172,101,199,184,300,1320,2257,6,15668,870,0,2,1,1,15460,6599,1451,11350,0
185,4356,1508,847,911,44,250,301,1552,14,148,88,169,162,257,1120,1886,7,15077,837,0,2,1,1,15460,6600,1452,11351,0
14,577,722,423,573,19,0,135,741,12,172,101,199,184,300,1320,2257,6,15668,870,0,2,10,0,15460,6602,1452,11353,0
395,8517,72,33,56,0,4,12,72,1,1,1,1,2,2,0,2,0,1,0,0,2,8,4,15460,6602,1452,11354,1
395,8517,1454,835,1044,76,110,219,1530,17,275,158,296,292,454,2297,3718,9,34017,1889,1,2,8,4,15470,6603,1452,11355,1
159,3613,77,34,69,0,0,8,77,3,24,16,29,27,45,114,213,1,387,21,0,2,10,3,15470,6603,1452,11356,0
159,3613,712,438,573,51,9,84,763,14,102,71,128,116,199,733,1364,8,11988,666,0,2,10,3,15480,6604,1452,11357,0
44,1808,1043,504,840,53,9,147,1096,9,180,112,198,189,310,1377,2344,4,11604,644,0,2,6,1,15480,6606,1452,11358,0
159,3613,77,34,69,0,0,8,77,3,24,16,29,27,45,114,213,1,387,21,0,2,10,3,15480,6606,1452,11359,0
159,3613,712,438,573,51,9,84,763,14,102,71,128,116,199,733,1364,8,11988,666,0,2,10,3,15490,6607,1452,11360,0
44,1808,1043,504,840,53,9,147,1096,9,180,112,198,189,310,1377,2344,4,11604,644,0,2,6,1,15490,6609,1452,11361,0
384,8296,72,33,56,0,4,12,72,1,1,1,1,2,2,0,2,0,1,0,0,2,108,146,15490,6609,1452,11362,1
384,8296,1454,835,1044,76,110,219,1530,17,275,158,296,292,454,2297,3718,9,34017,1889,1,2,108,146,15500,6610,1452,11363,1
3,66,127,75,83,2,11,30,129,4,14,7,14,18,21,61,87,2,175,9,0,2,2,2,15500,6610,1452,11364,1
3,66,652,304,544,16,6,88,668,6,89,51,101,95,152,591,998,3,3399,188,0,2,2,2,15500,6611,1452,11365,1
3,66,2,2,2,0,0,0,2,0,0,0,0,0,0,0,0,0,0,0,0,2,2,2,15500,6611,1452,11365,1
3,66,8,5,5,0,0,3,8,0,0,0,0,0,0,0,0,0,0,0,0,2,2,2,15500,6611,1452,11366,1
3,66,2,2,2,0,0,0,2,0,0,0,0,0,0,0,0,0,0,0,0,2,2,2,15500,6611,1452,11366,1
3,66,14,8,8,0,0,6,14,0,0,0,0,0,0,0,0,0,0,0,0,2,2,2,15500,6611,1452,11367,1
3,66,6,4,4,0,0,2,6,0,0,0,0,0,0,0,0,0,0,0,0,2,2,2,15500,6611,1452,11368,1
3,66,6,4,4,0,0,2,6,1,2,1,2,3,3,2,4,0,2,0,0,2,2,2,15500,6611,1452,11369,1
3,66,6,4,4,0,0,2,6,0,0,0,0,0,0,0,0,0,0,0,0,2,2,2,15500,6611,1452,11370,1
3,66,7,5,5,0,0,2,7,0,0,0,0,0,0,0,0,0,0,0,0,2,2,2,15500,6611,1452,11371,1
3,66,6,4,4,0,0,2,6,0,0,0,0,0,0,0,0,0,0,0,0,2,2,2,15500,6611,1452,11372,1
3,66,10,6,6,0,0,4,10,0,0,0,0,0,0,0,0,0,0,0,0,2,2,2,15500,6611,1452,11373,1
3,66,1,1,1,0,0,0,1,0,0,0,0,0,0,0,0,0,0,0,0,2,2,2,15500,6611,1452,11373,1
3,66,14,10,10,0,0,4,14,1,1,1,1,2,2,0,2,0,1,0,0,2,2,2,15500,6611,1452,11374,1
3,66,46,26,30,3,0,12,49,3,6,3,6,9,9,20,28,1,42,2,0,2,2,2,15510,6611,1452,11375,1
7,298,72,33,56,0,4,12,72,1,1,1,1,2,2,0,2,0,1,0,0,2,4,4,15510,6611,1452,11376,1
162,3649,77,34,69,0,0,8,77,3,24,16,29,27,45,114,213,1,387,21,0,2,10,3,15520,6615,1453,11384,1
162,3649,712,438,573,51,9,84,763,14,102,71,128,116,199,733,1364,8,11988,666,0,2,10,3,15530,6616,1453,11385,1
385,8343,72,33,56,0,4,12,72,1,1,1,1,2,2,0,2,0,1,0,0,2,11,6,15530,6616,1453,11386,1
385,8343,1454,835,1044,76,110,219,1530,17,275,158,296,292,454,2297,3718,9,34017,1889,1,2,11,6,15540,6617,1453,11387,1
6,286,42,7,35,4,0,5,46,1,2,1,2,3,3,2,4,0,2,0,0,2,1,1,15540,6617,1453,11388,1
6,286,11,6,10,0,0,1,11,2,4,2,4,6,6,10,15,1,15,0,0,2,1,1,15540,6617,1453,11389,1
36,1526,1020,354,843,12,15,144,1032,8,134,77,144,142,221,970,1580,4,6792,377,0,2,1,1,15540,6617,1453,11390,1
385,8344,72,33,56,0,4,12,72,1,1,1,1,2,2,0,2,0,1,0,0,2,5,5,15540,6617,1453,11391,1
385,8344,1454,835,1044,76,110,219,1530,17,275,158,296,292,454,2297,3718,9,34017,1889,1,2,5,5,15550,6618,1453,11392,1
385,8329,72,33,56,0,4,12,72,1,1,1,1,2,2,0,2,0,1,0,0,2,2,7,15550,6618,1453,11393,1
385,8329,1454,835,1044,76,110,219,1530,17,275,158,296,292,454,2297,3718,9,34017,1889,1,2,2,7,15560,6619,1453,11394,1
387,8382,72,33,56,0,4,12,72,1,1,1,1,2,2,0,2,0,1,0,0,2,19,10,15570,6623,1454,11402,1
387,8382,1454,835,1044,76,110,219,1530,17,275,158,296,292,454,2297,3718,9,34017,1889,1,2,19,10,15580,6624,1454,11403,1
51,1026,1098,241,925,5,10,155,1103,7,46,25,49,53,74,273,423,3,1580,87,0,2,4,0,15590,6626,1454,11404,1
51,1026,282,202,222,14,2,44,296,8,42,24,43,50,67,250,378,4,1548,86,0,2,4,0,15590,6627,1454,11405,1
6,286,42,7,35,4,0,5,46,1,2,1,2,3,3,2,4,0,2,0,0,2,1,1,15590,6627,1454,11406,1
6,286,11,6,10,0,0,1,11,2,4,2,4,6,6,10,15,1,15,0,0,2,1,1,15590,6627,1454,11407,1
26,988,1098,241,925,5,10,155,1103,7,46,25,49,53,74,273,423,3,1580,87,0,2,25,0,15600,6629,1454,11408,1
389,8386,72,33,56,0,4,12,72,1,1,1,1,2,2,0,2,0,1,0,0,2,2,1,15600,6629,1454,11409,1
389,8386,1454,835,1044,76,110,219,1530,17,275,158,296,292,454,2297,3718,9,34017,1889,1,2,2,1,15610,6630,1454,11410,1
390,8394,72,33,56,0,4,12,72,1,1,1,1,2,2,0,2,0,1,0,0,2,6,3,15610,6630,1454,11411,1
390,8394,1454,835,1044,76,110,219,1530,17,275,158,296,292,454,2297,3718,9,34017,1889,1,2,6,3,15620,6631,1454,11412,1
187,4423,722,423,573,19,0,135,741,12,172,101,199,184,300,1320,2257,6,15668,870,0,2,32,22,15630,6637,1455,11421,1
187,4423,1508,847,911,44,250,301,1552,14,148,88,169,162,257,1120,1886,7,15077,837,0,2,32,22,15630,6638,1456,11422,1
6,286,42,7,35,4,0,5,46,1,2,1,2,3,3,2,4,0,2,0,0,2,1,1,15630,6638,1456,11423,1
6,286,11,6,10,0,0,1,11,2,4,2,4,6,6,10,15,1,15,0,0,2,1,1,15630,6638,1456,11424,1
391,8407,72,33,56,0,4,12,72,1,1,1,1,2,2,0,2,0,1,0,0,2,4,0,15640,6642,1457,11432,1
391,8407,1454,835,1044,76,110,219,1530,17,275,158,296,292,454,2297,3718,9,34017,1889,1,2,4,0,15650,6643,1457,11433,1
6,286,42,7,35,4,0,5,46,1,2,1,2,3,3,2,4,0,2,0,0,2,1,1,15650,6643,1457,11434,1
6,286,11,6,10,0,0,1,11,2,4,2,4,6,6,10,15,1,15,0,0,2,1,1,15650,6643,1457,11435,1
18,294,424,94,331,4,0,89,428,1,5,5,5,6,10,11,25,0,12,0,0,2,1,1,15660,6648,1458,11443,1
18,294,38,23,23,6,0,8,44,3,11,7,11,14,18,42,68,1,102,5,0,2,1,1,15660,6648,1458,11444,1
6,286,42,7,35,4,0,5,46,1,2,1,2,3,3,2,4,0,2,0,0,2,1,1,15660,6648,1458,11445,1
6,286,11,6,10,0,0,1,11,2,4,2,4,6,6,10,15,1,15,0,0,2,1,1,15660,6648,1458,11446,1
12,389,424,94,331,4,0,89,428,1,5,5,5,6,10,11,25,0,12,0,0,2,11,0,15660,6649,1458,11447,1
42,1116,74,35,59,1,0,14,75,3,14,7,14,17,21,58,85,1,128,7,0,2,2,0,15660,6650,1458,11448,1
42,1116,245,125,200,5,7,34,250,7,30,17,34,37,51,166,265,3,1053,58,0,2,2,0,15670,6651,1458,11449,1
11,343,74,35,59,1,0,14,75,3,14,7,14,17,21,58,85,1,128,7,0,2,7,5,15670,6652,1458,11450,1
52,1050,1098,241,925,5,10,155,1103,7,46,25,49,53,74,273,423,3,1580,87,0,2,3,0,15680,6654,1458,11451,1
52,1050,282,202,222,14,2,44,296,8,42,24,43,50,67,250,378,4,1548,86,0,2,3,0,15680,6655,1458,11452,1
27,1019,1098,241,925,5,10,155,1103,7,46,25,49,53,74,273,423,3,1580,87,0,2,11,0,15690,6657,1458,11453,1
52,1050,1098,241,925,5,10,155,1103,7,46,25,49,53,74,273,423,3,1580,87,0,2,3,0,15700,6659,1458,11454,0
52,1050,282,202,222,14,2,44,296,8,42,24,43,50,67,250,378,4,1548,86,0,2,3,0,15700,6660,1458,11455,0
27,1019,1098,241,925,5,10,155,1103,7,46,25,49,53,74,273,423,3,1580,87,0,2,11,0,15710,6662,1458,11456,0
391,8407,72,33,56,0,4,12,72,1,1,1,1,2,2,0,2,0,1,0,0,2,1,1,15710,6662,1458,11457,1
391,8407,1454,835,1044,76,110,219,1530,17,275,158,296,292,454,2297,3718,9,34017,1889,1,2,1,1,15720,6663,1458,11458,1
156,3510,77,34,69,0,0,8,77,3,24,16,29,27,45,114,213,1,387,21,0,2,0,22,15720,6663,1458,11459,0
156,3510,712,438,573,51,9,84,763,14,102,71,128,116,199,733,1364,8,11988,666,0,2,0,22,15730,6664,1458,11460,0
392,8417,72,33,56,0,4,12,72,1,1,1,1,2,2,0,2,0,1,0,0,2,5,1,15730,6664,1458,11461,0
392,8417,1454,835,1044,76,110,219,1530,17,275,158,296,292,454,2297,3718,9,34017,1889,1,2,5,1,15740,6665,1458,11462,0
96,2185,1043,504,840,53,9,147,1096,9,180,112,198,189,310,1377,2344,4,11604,644,0,2,1,1,15740,6667,1458,11463,0
96,2185,383,288,292,26,6,62,409,11,65,38,67,76,105,429,656,5,3719,206,0,2,1,1,15740,6668,1458,11464,0
162,3649,77,34,69,0,0,8,77,3,24,16,29,27,45,114,213,1,387,21,0,2,22,0,15740,6668,1458,11465,1
162,3649,712,438,573,51,9,84,763,14,102,71,128,116,199,733,1364,8,11988,666,0,2,22,0,15750,6669,1458,11466,1
391,8407,72,33,56,0,4,12,72,1,1,1,1,2,2,0,2,0,1,0,0,2,1,5,15750,6669,1458,11467,1
391,8407,1454,835,1044,76,110,219,1530,17,275,158,296,292,454,2297,3718,9,34017,1889,1,2,1,5,15760,6670,1458,11468,1
96,2178,1043,504,840,53,9,147,1096,9,180,112,198,189,310,1377,2344,4,11604,644,0,2,1,1,15760,6672,1458,11469,1
96,2178,383,288,292,26,6,62,409,11,65,38,67,76,105,429,656,5,3719,206,0,2,1,1,15760,6673,1458,11470,1
398,8516,72,33,56,0,4,12,72,1,1,1,1,2,2,0,2,0,1,0,0,2,68,38,15760,6673,1458,11471,1
398,8516,1454,835,1044,76,110,219,1530,17,275,158,296,292,454,2297,3718,9,34017,1889,1,2,68,38,15770,6674,1458,11472,1
398,8529,72,33,56,0,4,12,72,1,1,1,1,2,2,0,2,0,1,0,0,2,8,3,15770,6674,1458,11473,1
398,8529,1454,835,1044,76,110,219,1530,17,275,158,296,292,454,2297,3718,9,34017,1889,1,2,8,3,15780,6675,1458,11474,1
398,8516,72,33,56,0,4,12,72,1,1,1,1,2,2,0,2,0,1,0,0,2,3,8,15780,6675,1458,11475,1
398,8516,1454,835,1044,76,110,219,1530,17,275,158,296,292,454,2297,3718,9,34017,1889,1,2,3,8,15790,6676,1458,11476,1
30,618,447,308,343,6,5,95,453,7,96,59,111,103,170,651,1136,4,4600,255,0,2,5,1,15790,6679,1458,11477,1
30,618,322,174,179,16,74,51,338,10,41,26,46,51,72,252,408,5,2291,127,0,2,5,1,15790,6682,1459,11478,1
26,1272,447,308,343,6,5,95,453,7,96,59,111,103,170,651,1136,4,4600,255,0,2,35,0,15790,6685,1459,11479,1
399,8544,72,33,56,0,4,12,72,1,1,1,1,2,2,0,2,0,1,0,0,2,3,0,15800,6689,1460,11487,1
399,8544,1454,835,1044,76,110,219,1530,17,275,158,296,292,454,2297,3718,9,34017,1889,1,2,3,0,15810,6690,1460,11488,1
6,286,42,7,35,4,0,5,46,1,2,1,2,3,3,2,4,0,2,0,0,2,1,1,15810,6690,1460,11489,1
6,286,11,6,10,0,0,1,11,2,4,2,4,6,6,10,15,1,15,0,0,2,1,1,15810,6690,1460,11490,1
162,3651,77,34,69,0,0,8,77,3,24,16,29,27,45,114,213,1,387,21,0,2,12,13,15810,6690,1460,11491,0
162,3651,712,438,573,51,9,84,763,14,102,71,128,116,199,733,1364,8,11988,666,0,2,12,13,15820,6691,1460,11492,0
398,8516,72,33,56,0,4,12,72,1,1,1,1,2,2,0,2,0,1,0,0,2,1,3,15820,6691,1460,11493,0
398,8516,1454,835,1044,76,110,219,1530,17,275,158,296,292,454,2297,3718,9,34017,1889,1,2,1,3,15830,6692,1460,11494,0
397,8484,72,33,56,0,4,12,72,1,1,1,1,2,2,0,2,0,1,0,0,2,12,23,15830,6692,1460,11495,1
397,8484,1454,835,1044,76,110,219,1530,17,275,158,296,292,454,2297,3718,9,34017,1889,1,2,12,23,15840,6693,1460,11496,1
399,8494,72,33,56,0,4,12,72,1,1,1,1,2,2,0,2,0,1,0,0,2,5,4,15840,6693,1460,11497,1
399,8494,1454,835,1044,76,110,219,1530,17,275,158,296,292,454,2297,3718,9,34017,1889,1,2,5,4,15850,6694,1460,11498,1
154,3088,1943,715,1694,26,18,214,1969,12,185,120,237,197,357,1436,2721,7,20915,1161,0,2,1,1,15850,6696,1460,11499,1
154,3088,1168,838,957,57,25,144,1225,19,348,224,416,367,640,3018,5452,11,61921,3440,1,2,1,1,15860,6698,1460,11500,1
59,2468,1289,550,1043,56,32,155,1345,10,167,93,185,177,278,1266,2075,5,11498,638,0,2,3,3,15860,6700,1461,11501,1
6,286,42,7,35,4,0,5,46,1,2,1,2,3,3,2,4,0,2,0,0,2,2,2,15860,6700,1461,11502,1
6,286,11,6,10,0,0,1,11,2,4,2,4,6,6,10,15,1,15,0,0,2,2,2,15860,6700,1461,11503,1
40,1699,1513,682,1277,25,13,200,1538,11,199,116,219,210,335,1557,2584,6,15641,868,0,2,8,8,15860,6702,1461,11504,0
1,197,382,65,130,157,2,92,539,4,10,5,10,14,15,41,57,2,114,6,0,2,5,1,15860,6703,1462,11505,1
399,8494,72,33,56,0,4,12,72,1,1,1,1,2,2,0,2,0,1,0,0,2,25,11,15860,6703,1462,11506,1
399,8494,1454,835,1044,76,110,219,1530,17,275,158,296,292,454,2297,3718,9,34017,1889,1,2,25,11,15870,6704,1462,11507,1
3,66,127,75,83,2,11,30,129,4,14,7,14,18,21,61,87,2,175,9,0,2,1,1,15870,6704,1462,11508,1
3,66,652,304,544,16,6,88,668,6,89,51,101,95,152,591,998,3,3399,188,0,2,1,1,15870,6705,1462,11509,1
3,66,2,2,2,0,0,0,2,0,0,0,0,0,0,0,0,0,0,0,0,2,1,1,15870,6705,1462,11509,1
3,66,8,5,5,0,0,3,8,0,0,0,0,0,0,0,0,0,0,0,0,2,1,1,15870,6705,1462,11510,1
3,66,2,2,2,0,0,0,2,0,0,0,0,0,0,0,0,0,0,0,0,2,1,1,15870,6705,1462,11510,1
3,66,14,8,8,0,0,6,14,0,0,0,0,0,0,0,0,0,0,0,0,2,1,1,15870,6705,1462,11511,1
3,66,6,4,4,0,0,2,6,0,0,0,0,0,0,0,0,0,0,0,0,2,1,1,15870,6705,1462,11512,1
3,66,6,4,4,0,0,2,6,1,2,1,2,3,3,2,4,0,2,0,0,2,1,1,15870,6705,1462,11513,1
3,66,6,4,4,0,0,2,6,0,0,0,0,0,0,0,0,0,0,0,0,2,1,1,15870,6705,1462,11514,1
3,66,7,5,5,0,0,2,7,0,0,0,0,0,0,0,0,0,0,0,0,2,1,1,15870,6705,1462,11515,1
3,66,6,4,4,0,0,2,6,0,0,0,0,0,0,0,0,0,0,0,0,2,1,1,15870,6705,1462,11516,1
3,66,10,6,6,0,0,4,10,0,0,0,0,0,0,0,0,0,0,0,0,2,1,1,15870,6705,1462,11517,1
3,66,1,1,1,0,0,0,1,0,0,0,0,0,0,0,0,0,0,0,0,2,1,1,15870,6705,1462,11517,1
3,66,14,10,10,0,0,4,14,1,1,1,1,2,2,0,2,0,1,0,0,2,1,1,15870,6705,1462,11518,1
3,66,46,26,30,3,0,12,49,3,6,3,6,9,9,20,28,1,42,2,0,2,1,1,15880,6705,1462,11519,1
7,298,72,33,56,0,4,12,72,1,1,1,1,2,2,0,2,0,1,0,0,2,2,2,15880,6705,1462,11520,1
18,294,424,94,331,4,0,89,428,1,5,5,5,6,10,11,25,0,12,0,0,2,1,1,15880,6706,1462,11521,1
18,294,38,23,23,6,0,8,44,3,11,7,11,14,18,42,68,1,102,5,0,2,1,1,15880,6706,1462,11522,1
386,8241,72,33,56,0,4,12,72,1,1,1,1,2,2,0,2,0,1,0,0,2,103,146,15880,6706,1462,11523,1
386,8241,1454,835,1044,76,110,219,1530,17,275,158,296,292,454,2297,3718,9,34017,1889,1,2,103,146,15890,6707,1462,11524,1
53,1067,1098,241,925,5,10,155,1103,7,46,25,49,53,74,273,423,3,1580,87,0,2,4,1,15900,6709,1462,11525,1
53,1067,282,202,222,14,2,44,296,8,42,24,43,50,67,250,378,4,1548,86,0,2,4,1,15900,6710,1462,11526,1
68,1223,1513,682,1277,25,13,200,1538,11,199,116,219,210,335,1557,2584,6,15641,868,0,2,3,3,15900,6712,1462,11527,1
68,1223,819,519,539,24,98,155,843,15,96,57,106,111,163,690,1107,8,9171,509,0,2,3,3,15910,6714,1462,11528,1
42,1116,74,35,59,1,0,14,75,3,14,7,14,17,21,58,85,1,128,7,0,2,1,1,15910,6715,1462,11529,1
42,1116,245,125,200,5,7,34,250,7,30,17,34,37,51,166,265,3,1053,58,0,2,1,1,15920,6716,1462,11530,1
162,3651,77,34,69,0,0,8,77,3,24,16,29,27,45,114,213,1,387,21,0,2,3,3,15920,6716,1462,11531,1
162,3651,712,438,573,51,9,84,763,14,102,71,128,116,199,733,1364,8,11988,666,0,2,3,3,15930,6717,1462,11532,1
387,8271,72,33,56,0,4,12,72,1,1,1,1,2,2,0,2,0,1,0,0,2,162,159,15930,6717,1462,11533,1
387,8271,1454,835,1044,76,110,219,1530,17,275,158,296,292,454,2297,3718,9,34017,1889,1,2,162,159,15940,6718,1462,11534,1
53,1067,1098,241,925,5,10,155,1103,7,46,25,49,53,74,273,423,3,1580,87,0,2,4,4,15950,6720,1462,11535,1
53,1067,282,202,222,14,2,44,296,8,42,24,43,50,67,250,378,4,1548,86,0,2,4,4,15950,6721,1462,11536,1
56,977,282,196,195,3,0,86,285,8,130,71,141,138,212,936,1507,4,6538,363,0,2,1,1,15950,6721,1463,11537,1
56,977,282,196,195,3,0,86,285,8,130,71,141,138,212,936,1507,4,6538,363,0,2,1,1,15950,6721,1464,11538,1
10,326,72,33,56,0,4,12,72,1,1,1,1,2,2,0,2,0,1,0,0,2,1,1,15950,6721,1464,11539,1
35,628,127,75,83,2,11,30,129,4,14,7,14,18,21,61,87,2,175,9,0,2,1,1,15950,6721,1464,11540,1
35,628,652,304,544,16,6,88,668,6,89,51,101,95,152,591,998,3,3399,188,0,2,1,1,15950,6722,1464,11541,1
35,628,2,2,2,0,0,0,2,0,0,0,0,0,0,0,0,0,0,0,0,2,1,1,15950,6722,1464,11541,1
35,628,8,5,5,0,0,3,8,0,0,0,0,0,0,0,0,0,0,0,0,2,1,1,15950,6722,1464,11542,1
35,628,2,2,2,0,0,0,2,0,0,0,0,0,0,0,0,0,0,0,0,2,1,1,15950,6722,1464,11542,1
35,628,14,8,8,0,0,6,14,0,0,0,0,0,0,0,0,0,0,0,0,2,1,1,15950,6722,1464,11543,1
35,628,6,4,4,0,0,2,6,0,0,0,0,0,0,0,0,0,0,0,0,2,1,1,15950,6722,1464,11544,1
35,628,6,4,4,0,0,2,6,1,2,1,2,3,3,2,4,0,2,0,0,2,1,1,15950,6722,1464,11545,1
35,628,6,4,4,0,0,2,6,0,0,0,0,0,0,0,0,0,0,0,0,2,1,1,15950,6722,1464,11546,1
35,628,7,5,5,0,0,2,7,0,0,0,0,0,0,0,0,0,0,0,0,2,1,1,15950,6722,1464,11547,1
35,628,6,4,4,0,0,2,6,0,0,0,0,0,0,0,0,0,0,0,0,2,1,1,15950,6722,1464,11548,1
35,628,10,6,6,0,0,4,10,0,0,0,0,0,0,0,0,0,0,0,0,2,1,1,15950,6722,1464,11549,1
35,628,1,1,1,0,0,0,1,0,0,0,0,0,0,0,0,0,0,0,0,2,1,1,15950,6722,1464,11549,1
35,628,14,10,10,0,0,4,14,1,1,1,1,2,2,0,2,0,1,0,0,2,1,1,15950,6722,1464,11550,1
35,628,46,26,30,3,0,12,49,3,6,3,6,9,9,20,28,1,42,2,0,2,1,1,15960,6722,1464,11551,1
40,1699,1513,682,1277,25,13,200,1538,11,199,116,219,210,335,1557,2584,6,15641,868,0,2,1,1,15960,6724,1464,11552,1
27,1295,652,304,544,16,6,88,668,6,89,51,101,95,152,591,998,3,3399,188,0,2,1,1,15960,6725,1464,11553,1
11,343,74,35,59,1,0,14,75,3,14,7,14,17,21,58,85,1,128,7,0,2,1,1,15960,6726,1464,11554,1
56,2548,1943,715,1694,26,18,214,1969,12,185,120,237,197,357,1436,2721,7,20915,1161,0,2,1,1,15960,6728,1464,11555,1
159,3571,77,34,69,0,0,8,77,3,24,16,29,27,45,114,213,1,387,21,0,2,1,10,15960,6728,1464,11556,1
159,3571,712,438,573,51,9,84,763,14,102,71,128,116,199,733,1364,8,11988,666,0,2,1,10,15970,6729,1464,11557,1
387,8323,72,33,56,0,4,12,72,1,1,1,1,2,2,0,2,0,1,0,0,2,46,41,15970,6729,1464,11558,1
387,8323,1454,835,1044,76,110,219,1530,17,275,158,296,292,454,2297,3718,9,34017,1889,1,2,46,41,15980,6730,1464,11559,1
6,286,42,7,35,4,0,5,46,1,2,1,2,3,3,2,4,0,2,0,0,2,1,1,15990,6734,1465,11567,1
6,286,11,6,10,0,0,1,11,2,4,2,4,6,6,10,15,1,15,0,0,2,1,1,15990,6734,1465,11568,1
390,8430,72,33,56,0,4,12,72,1,1,1,1,2,2,0,2,0,1,0,0,2,30,9,15990,6734,1465,11569,1
390,8430,1454,835,1044,76,110,219,1530,17,275,158,296,292,454,2297,3718,9,34017,1889,1,2,30,9,16000,6735,1465,11570,1
53,1059,1098,241,925,5,10,155,1103,7,46,25,49,53,74,273,423,3,1580,87,0,2,1,1,16010,6737,1465,11571,1
53,1059,282,202,222,14,2,44,296,8,42,24,43,50,67,250,378,4,1548,86,0,2,1,1,16010,6738,1465,11572,1
1,197,382,65,130,157,2,92,539,4,10,5,10,14,15,41,57,2,114,6,0,2,1,1,16010,6739,1466,11573,1
393,8487,72,33,56,0,4,12,72,1,1,1,1,2,2,0,2,0,1,0,0,2,28,14,16010,6739,1466,11574,1
393,8487,1454,835,1044,76,110,219,1530,17,275,158,296,292,454,2297,3718,9,34017,1889,1,2,28,14,16020,6740,1466,11575,1
395,8521,72,33,56,0,4,12,72,1,1,1,1,2,2,0,2,0,1,0,0,2,25,12,16020,6740,1466,11576,1
395,8521,1454,835,1044,76,110,219,1530,17,275,158,296,292,454,2297,3718,9,34017,1889,1,2,25,12,16030,6741,1466,11577,1
398,8551,72,33,56,0,4,12,72,1,1,1,1,2,2,0,2,0,1,0,0,2,14,6,16040,6745,1467,11585,1
398,8551,1454,835,1044,76,110,219,1530,17,275,158,296,292,454,2297,3718,9,34017,1889,1,2,14,6,16050,6746,1467,11586,1
6,286,42,7,35,4,0,5,46,1,2,1,2,3,3,2,4,0,2,0,0,2,1,1,16050,6746,1467,11587,1
6,286,11,6,10,0,0,1,11,2,4,2,4,6,6,10,15,1,15,0,0,2,1,1,16050,6746,1467,11588,1
398,8551,72,33,56,0,4,12,72,1,1,1,1,2,2,0,2,0,1,0,0,2,16,14,16050,6746,1467,11589,1
398,8551,1454,835,1044,76,110,219,1530,17,275,158,296,292,454,2297,3718,9,34017,1889,1,2,16,14,16060,6747,1467,11590,1
156,3098,1943,715,1694,26,18,214,1969,12,185,120,237,197,357,1436,2721,7,20915,1161,0,2,6,3,16060,6749,1467,11591,1
156,3098,1168,838,957,57,25,144,1225,19,348,224,416,367,640,3018,5452,11,61921,3440,1,2,6,3,16070,6751,1467,11592,1
1,191,382,65,130,157,2,92,539,4,10,5,10,14,15,41,57,2,114,6,0,2,3,2,16070,6752,1468,11593,1
397,8525,72,33,56,0,4,12,72,1,1,1,1,2,2,0,2,0,1,0,0,2,3,9,16080,6756,1469,11601,1
397,8525,1454,835,1044,76,110,219,1530,17,275,158,296,292,454,2297,3718,9,34017,1889,1,2,3,9,16090,6757,1469,11602,1
6,286,42,7,35,4,0,5,46,1,2,1,2,3,3,2,4,0,2,0,0,2,1,1,16090,6757,1469,11603,1
6,286,11,6,10,0,0,1,11,2,4,2,4,6,6,10,15,1,15,0,0,2,1,1,16090,6757,1469,11604,1
12,392,424,94,331,4,0,89,428,1,5,5,5,6,10,11,25,0,12,0,0,2,1,1,16090,6758,1469,11605,1
27,1019,1098,241,925,5,10,155,1103,7,46,25,49,53,74,273,423,3,1580,87,0,2,2,2,16100,6760,1469,11606,1
397,8524,72,33,56,0,4,12,72,1,1,1,1,2,2,0,2,0,1,0,0,2,5,5,16100,6760,1469,11607,1
397,8524,1454,835,1044,76,110,219,1530,17,275,158,296,292,454,2297,3718,9,34017,1889,1,2,5,5,16110,6761,1469,11608,1
32,1987,1523,757,1297,19,12,193,1542,12,193,117,230,205,347,1508,2664,7,19053,1058,0,2,5,3,16120,6763,1469,11609,0
397,8526,72,33,56,0,4,12,72,1,1,1,1,2,2,0,2,0,1,0,0,2,28,33,16120,6763,1469,11610,1
397,8526,1454,835,1044,76,110,219,1530,17,275,158,296,292,454,2297,3718,9,34017,1889,1,2,28,33,16130,6764,1469,11611,1
96,2178,1043,504,840,53,9,147,1096,9,180,112,198,189,310,1377,2344,4,11604,644,0,2,3,1,16130,6766,1469,11612,1
96,2178,383,288,292,26,6,62,409,11,65,38,67,76,105,429,656,5,3719,206,0,2,3,1,16130,6767,1469,11613,1
1,199,382,65,130,157,2,92,539,4,10,5,10,14,15,41,57,2,114,6,0,2,6,2,16130,6768,1470,11614,1
394,8574,72,33,56,0,4,12,72,1,1,1,1,2,2,0,2,0,1,0,0,2,35,27,16140,6772,1471,11622,1
394,8574,1454,835,1044,76,110,219,1530,17,275,158,296,292,454,2297,3718,9,34017,1889,1,2,35,27,16150,6773,1471,11623,1
6,286,42,7,35,4,0,5,46,1,2,1,2,3,3,2,4,0,2,0,0,2,1,1,16150,6773,1471,11624,1
6,286,11,6,10,0,0,1,11,2,4,2,4,6,6,10,15,1,15,0,0,2,1,1,16150,6773,1471,11625,1
11,351,442,244,305,14,16,103,456,11,68,45,75,79,120,452,756,6,4588,254,0,2,1,1,16160,6779,1472,11633,1
11,351,182,102,99,11,40,35,193,3,11,6,11,14,17,42,64,1,97,5,0,2,1,1,16160,6780,1472,11634,1
6,286,42,7,35,4,0,5,46,1,2,1,2,3,3,2,4,0,2,0,0,2,1,1,16160,6780,1472,11635,1
6,286,11,6,10,0,0,1,11,2,4,2,4,6,6,10,15,1,15,0,0,2,1,1,16160,6780,1472,11636,1
6,484,442,244,305,14,16,103,456,11,68,45,75,79,120,452,756,6,4588,254,0,2,9,2,16160,6782,1472,11637,1
19,299,424,94,331,4,0,89,428,1,5,5,5,6,10,11,25,0,12,0,0,2,1,1,16160,6783,1472,11638,1
19,299,38,23,23,6,0,8,44,3,11,7,11,14,18,42,68,1,102,5,0,2,1,1,16160,6783,1472,11639,1
394,8574,72,33,56,0,4,12,72,1,1,1,1,2,2,0,2,0,1,0,0,2,8,8,16170,6787,1473,11647,1
394,8574,1454,835,1044,76,110,219,1530,17,275,158,296,292,454,2297,3718,9,34017,1889,1,2,8,8,16180,6788,1473,11648,1
1,199,382,65,130,157,2,92,539,4,10,5,10,14,15,41,57,2,114,6,0,2,1,1,16180,6789,1474,11649,1
6,286,42,7,35,4,0,5,46,1,2,1,2,3,3,2,4,0,2,0,0,2,1,1,16180,6789,1474,11650,1
6,286,11,6,10,0,0,1,11,2,4,2,4,6,6,10,15,1,15,0,0,2,1,1,16180,6789,1474,11651,1
12,392,424,94,331,4,0,89,428,1,5,5,5,6,10,11,25,0,12,0,0,2,1,1,16180,6790,1474,11652,1
27,1019,1098,241,925,5,10,155,1103,7,46,25,49,53,74,273,423,3,1580,87,0,2,2,2,16190,6792,1474,11653,1
395,8545,72,33,56,0,4,12,72,1,1,1,1,2,2,0,2,0,1,0,0,2,7,10,16190,6792,1474,11654,1
395,8545,1454,835,1044,76,110,219,1530,17,275,158,296,292,454,2297,3718,9,34017,1889,1,2,7,10,16200,6793,1474,11655,1
400,8685,72,33,56,0,4,12,72,1,1,1,1,2,2,0,2,0,1,0,0,2,43,20,16200,6793,1474,11656,1
400,8685,1454,835,1044,76,110,219,1530,17,275,158,296,292,454,2297,3718,9,34017,1889,1,2,43,20,16210,6794,1474,11657,1
53,1059,1098,241,925,5,10,155,1103,7,46,25,49,53,74,273,423,3,1580,87,0,2,1,1,16220,6796,1474,11658,1
53,1059,282,202,222,14,2,44,296,8,42,24,43,50,67,250,378,4,1548,86,0,2,1,1,16220,6797,1474,11659,1
404,8730,72,33,56,0,4,12,72,1,1,1,1,2,2,0,2,0,1,0,0,2,22,14,16220,6797,1474,11660,1
404,8730,1454,835,1044,76,110,219,1530,17,275,158,296,292,454,2297,3718,9,34017,1889,1,2,22,14,16230,6798,1474,11661,1
52,1050,1098,241,925,5,10,155,1103,7,46,25,49,53,74,273,423,3,1580,87,0,2,1,3,16240,6800,1474,11662,1
52,1050,282,202,222,14,2,44,296,8,42,24,43,50,67,250,378,4,1548,86,0,2,1,3,16240,6801,1474,11663,1
407,8793,72,33,56,0,4,12,72,1,1,1,1,2,2,0,2,0,1,0,0,2,28,17,16240,6801,1474,11664,1
407,8793,1454,835,1044,76,110,219,1530,17,275,158,296,292,454,2297,3718,9,34017,1889,1,2,28,17,16250,6802,1474,11665,1
405,8783,72,33,56,0,4,12,72,1,1,1,1,2,2,0,2,0,1,0,0,2,43,48,16250,6802,1474,11666,1
405,8783,1454,835,1044,76,110,219,1530,17,275,158,296,292,454,2297,3718,9,34017,1889,1,2,43,48,16260,6803,1474,11667,1
400,8717,72,33,56,0,4,12,72,1,1,1,1,2,2,0,2,0,1,0,0,2,12,25,16260,6803,1474,11668,1
400,8717,1454,835,1044,76,110,219,1530,17,275,158,296,292,454,2297,3718,9,34017,1889,1,2,12,25,16270,6804,1474,11669,1
405,8765,72,33,56,0,4,12,72,1,1,1,1,2,2,0,2,0,1,0,0,2,36,30,16280,6808,1475,11677,1
405,8765,1454,835,1044,76,110,219,1530,17,275,158,296,292,454,2297,3718,9,34017,1889,1,2,36,30,16290,6809,1475,11678,1
52,1044,1098,241,925,5,10,155,1103,7,46,25,49,53,74,273,423,3,1580,87,0,2,1,2,16300,6811,1475,11679,1
52,1044,282,202,222,14,2,44,296,8,42,24,43,50,67,250,378,4,1548,86,0,2,1,2,16300,6812,1475,11680,1
6,286,42,7,35,4,0,5,46,1,2,1,2,3,3,2,4,0,2,0,0,2,1,1,16300,6812,1475,11681,1
6,286,11,6,10,0,0,1,11,2,4,2,4,6,6,10,15,1,15,0,0,2,1,1,16300,6812,1475,11682,1
405,8766,72,33,56,0,4,12,72,1,1,1,1,2,2,0,2,0,1,0,0,2,32,0,16300,6812,1475,11683,1
405,8766,1454,835,1044,76,110,219,1530,17,275,158,296,292,454,2297,3718,9,34017,1889,1,2,32,0,16310,6813,1475,11684,1
405,8764,72,33,56,0,4,12,72,1,1,1,1,2,2,0,2,0,1,0,0,2,3,3,16310,6813,1475,11685,1
405,8764,1454,835,1044,76,110,219,1530,17,275,158,296,292,454,2297,3718,9,34017,1889,1,2,3,3,16320,6814,1475,11686,1
12,392,424,94,331,4,0,89,428,1,5,5,5,6,10,11,25,0,12,0,0,2,1,1,16320,6815,1475,11687,1
401,8727,72,33,56,0,4,12,72,1,1,1,1,2,2,0,2,0,1,0,0,2,78,78,16330,6819,1476,11695,1
401,8727,1454,835,1044,76,110,219,1530,17,275,158,296,292,454,2297,3718,9,34017,1889,1,2,78,78,16340,6820,1476,11696,1
52,1047,1098,241,925,5,10,155,1103,7,46,25,49,53,74,273,423,3,1580,87,0,2,2,0,16350,6822,1476,11697,1
52,1047,282,202,222,14,2,44,296,8,42,24,43,50,67,250,378,4,1548,86,0,2,2,0,16350,6823,1476,11698,1
6,286,42,7,35,4,0,5,46,1,2,1,2,3,3,2,4,0,2,0,0,2,1,1,16350,6823,1476,11699,1
6,286,11,6,10,0,0,1,11,2,4,2,4,6,6,10,15,1,15,0,0,2,1,1,16350,6823,1476,11700,1
397,8658,72,33,56,0,4,12,72,1,1,1,1,2,2,0,2,0,1,0,0,2,0,15,16350,6823,1476,11701,0
397,8658,1454,835,1044,76,110,219,1530,17,275,158,296,292,454,2297,3718,9,34017,1889,1,2,0,15,16360,6824,1476,11702,0
401,8717,72,33,56,0,4,12,72,1,1,1,1,2,2,0,2,0,1,0,0,2,13,4,16370,6828,1477,11710,1
401,8717,1454,835,1044,76,110,219,1530,17,275,158,296,292,454,2297,3718,9,34017,1889,1,2,13,4,16380,6829,1477,11711,1
6,286,42,7,35,4,0,5,46,1,2,1,2,3,3,2,4,0,2,0,0,2,1,1,16380,6829,1477,11712,1
6,286,11,6,10,0,0,1,11,2,4,2,4,6,6,10,15,1,15,0,0,2,1,1,16380,6829,1477,11713,1
401,8717,72,33,56,0,4,12,72,1,1,1,1,2,2,0,2,0,1,0,0,2,1,1,16380,6829,1477,11714,1
401,8717,1454,835,1044,76,110,219,1530,17,275,158,296,292,454,2297,3718,9,34017,1889,1,2,1,1,16390,6830,1477,11715,1
402,8746,72,33,56,0,4,12,72,1,1,1,1,2,2,0,2,0,1,0,0,2,3,0,16400,6834,1478,11723,1
402,8746,1454,835,1044,76,110,219,1530,17,275,158,296,292,454,2297,3718,9,34017,1889,1,2,3,0,16410,6835,1478,11724,1
6,286,42,7,35,4,0,5,46,1,2,1,2,3,3,2,4,0,2,0,0,2,1,1,16410,6835,1478,11725,1
6,286,11,6,10,0,0,1,11,2,4,2,4,6,6,10,15,1,15,0,0,2,1,1,16410,6835,1478,11726,1
402,8748,72,33,56,0,4,12,72,1,1,1,1,2,2,0,2,0,1,0,0,2,1,1,16410,6835,1478,11727,1
402,8748,1454,835,1044,76,110,219,1530,17,275,158,296,292,454,2297,3718,9,34017,1889,1,2,1,1,16420,6836,1478,11728,1
1,199,382,65,130,157,2,92,539,4,10,5,10,14,15,41,57,2,114,6,0,2,1,1,16420,6837,1479,11729,1
164,3666,77,34,69,0,0,8,77,3,24,16,29,27,45,114,213,1,387,21,0,2,32,21,16430,6841,1480,11737,1
164,3666,712,438,573,51,9,84,763,14,102,71,128,116,199,733,1364,8,11988,666,0,2,32,21,16440,6842,1480,11738,1
56,1056,1020,354,843,12,15,144,1032,8,134,77,144,142,221,970,1580,4,6792,377,0,2,1,9,16440,6842,1480,11739,1
403,8758,72,33,56,0,4,12,72,1,1,1,1,2,2,0,2,0,1,0,0,2,7,4,16440,6842,1480,11740,1
403,8758,1454,835,1044,76,110,219,1530,17,275,158,296,292,454,2297,3718,9,34017,1889,1,2,7,4,16450,6843,1480,11741,1
1,199,382,65,130,157,2,92,539,4,10,5,10,14,15,41,57,2,114,6,0,2,1,1,16450,6844,1481,11742,1
6,286,42,7,35,4,0,5,46,1,2,1,2,3,3,2,4,0,2,0,0,2,1,1,16450,6844,1481,11743,1
6,286,11,6,10,0,0,1,11,2,4,2,4,6,6,10,15,1,15,0,0,2,1,1,16450,6844,1481,11744,1
35,1533,1020,354,843,12,15,144,1032,8,134,77,144,142,221,970,1580,4,6792,377,0,2,13,12,16450,6844,1481,11745,1
403,8760,72,33,56,0,4,12,72,1,1,1,1,2,2,0,2,0,1,0,0,2,2,2,16460,6848,1482,11753,1
403,8760,1454,835,1044,76,110,219,1530,17,275,158,296,292,454,2297,3718,9,34017,1889,1,2,2,2,16470,6849,1482,11754,1
6,286,42,7,35,4,0,5,46,1,2,1,2,3,3,2,4,0,2,0,0,2,1,1,16470,6849,1482,11755,1
6,286,11,6,10,0,0,1,11,2,4,2,4,6,6,10,15,1,15,0,0,2,1,1,16470,6849,1482,11756,1
36,1564,1020,354,843,12,15,144,1032,8,134,77,144,142,221,970,1580,4,6792,377,0,2,19,0,16470,6849,1482,11757,1
403,8762,72,33,56,0,4,12,72,1,1,1,1,2,2,0,2,0,1,0,0,2,1,1,16480,6853,1483,11765,1
403,8762,1454,835,1044,76,110,219,1530,17,275,158,296,292,454,2297,3718,9,34017,1889,1,2,1,1,16490,6854,1483,11766,1
6,286,42,7,35,4,0,5,46,1,2,1,2,3,3,2,4,0,2,0,0,2,1,1,16490,6854,1483,11767,1
6,286,11,6,10,0,0,1,11,2,4,2,4,6,6,10,15,1,15,0,0,2,1,1,16490,6854,1483,11768,1
27,1019,1098,241,925,5,10,155,1103,7,46,25,49,53,74,273,423,3,1580,87,0,2,1,1,16500,6856,1483,11769,1
403,8761,72,33,56,0,4,12,72,1,1,1,1,2,2,0,2,0,1,0,0,2,4,2,16510,6860,1484,11777,1
403,8761,1454,835,1044,76,110,219,1530,17,275,158,296,292,454,2297,3718,9,34017,1889,1,2,4,2,16520,6861,1484,11778,1
1,199,382,65,130,157,2,92,539,4,10,5,10,14,15,41,57,2,114,6,0,2,1,1,16520,6862,1485,11779,1
6,286,42,7,35,4,0,5,46,1,2,1,2,3,3,2,4,0,2,0,0,2,1,1,16520,6862,1485,11780,1
6,286,11,6,10,0,0,1,11,2,4,2,4,6,6,10,15,1,15,0,0,2,1,1,16520,6862,1485,11781,1
403,8767,72,33,56,0,4,12,72,1,1,1,1,2,2,0,2,0,1,0,0,2,12,14,16530,6866,1486,11789,1
403,8767,1454,835,1044,76,110,219,1530,17,275,158,296,292,454,2297,3718,9,34017,1889,1,2,12,14,16540,6867,1486,11790,1
6,286,42,7,35,4,0,5,46,1,2,1,2,3,3,2,4,0,2,0,0,2,1,1,16540,6867,1486,11791,1
6,286,11,6,10,0,0,1,11,2,4,2,4,6,6,10,15,1,15,0,0,2,1,1,16540,6867,1486,11792,1
403,8776,72,33,56,0,4,12,72,1,1,1,1,2,2,0,2,0,1,0,0,2,4,0,16550,6871,1487,11800,1
403,8776,1454,835,1044,76,110,219,1530,17,275,158,296,292,454,2297,3718,9,34017,1889,1,2,4,0,16560,6872,1487,11801,1
6,286,42,7,35,4,0,5,46,1,2,1,2,3,3,2,4,0,2,0,0,2,1,1,16560,6872,1487,11802,1
6,286,11,6,10,0,0,1,11,2,4,2,4,6,6,10,15,1,15,0,0,2,1,1,16560,6872,1487,11803,1
6,286,42,7,35,4,0,5,46,1,2,1,2,3,3,2,4,0,2,0,0,2,2,2,16570,6876,1488,11811,1
6,286,11,6,10,0,0,1,11,2,4,2,4,6,6,10,15,1,15,0,0,2,2,2,16570,6876,1488,11812,1
32,1987,1523,757,1297,19,12,193,1542,12,193,117,230,205,347,1508,2664,7,19053,1058,0,2,2,2,16580,6878,1488,11813,1
1,199,382,65,130,157,2,92,539,4,10,5,10,14,15,41,57,2,114,6,0,2,1,1,16580,6879,1489,11814,1
188,4439,722,423,573,19,0,135,741,12,172,101,199,184,300,1320,2257,6,15668,870,0,2,2,0,16590,6885,1490,11823,0
188,4439,1508,847,911,44,250,301,1552,14,148,88,169,162,257,1120,1886,7,15077,837,0,2,2,0,16590,6886,1491,11824,0
6,286,42,7,35,4,0,5,46,1,2,1,2,3,3,2,4,0,2,0,0,2,1,1,16590,6886,1491,11825,0
6,286,11,6,10,0,0,1,11,2,4,2,4,6,6,10,15,1,15,0,0,2,1,1,16590,6886,1491,11826,0
6,286,42,7,35,4,0,5,46,1,2,1,2,3,3,2,4,0,2,0,0,2,1,1,16600,6890,1492,11834,1
6,286,11,6,10,0,0,1,11,2,4,2,4,6,6,10,15,1,15,0,0,2,1,1,16600,6890,1492,11835,1
1,199,382,65,130,157,2,92,539,4,10,5,10,14,15,41,57,2,114,6,0,2,1,1,16600,6891,1493,11836,1
409,8844,72,33,56,0,4,12,72,1,1,1,1,2,2,0,2,0,1,0,0,2,23,1,16610,6895,1494,11844,1
409,8844,1454,835,1044,76,110,219,1530,17,275,158,296,292,454,2297,3718,9,34017,1889,1,2,23,1,16620,6896,1494,11845,1
6,286,42,7,35,4,0,5,46,1,2,1,2,3,3,2,4,0,2,0,0,2,1,1,16620,6896,1494,11846,1
6,286,11,6,10,0,0,1,11,2,4,2,4,6,6,10,15,1,15,0,0,2,1,1,16620,6896,1494,11847,1
409,8846,72,33,56,0,4,12,72,1,1,1,1,2,2,0,2,0,1,0,0,2,3,1,16620,6896,1494,11848,1
409,8846,1454,835,1044,76,110,219,1530,17,275,158,296,292,454,2297,3718,9,34017,1889,1,2,3,1,16630,6897,1494,11849,1
83,1453,1178,367,1042,6,15,115,1184,9,94,51,95,103,146,644,976,4,4439,246,0,2,3,1,16630,6897,1494,11850,1
83,1453,177,108,140,8,0,27,185,6,30,16,32,36,48,162,248,3,794,44,0,2,3,1,16630,6899,1494,11851,1
83,1452,1178,367,1042,6,15,115,1184,9,94,51,95,103,146,644,976,4,4439,246,0,2,7,8,16640,6903,1495,11859,1
83,1452,177,108,140,8,0,27,185,6,30,16,32,36,48,162,248,3,794,44,0,2,7,8,16640,6905,1495,11860,1
1,199,382,65,130,157,2,92,539,4,10,5,10,14,15,41,57,2,114,6,0,2,1,1,16640,6906,1496,11861,1
6,286,42,7,35,4,0,5,46,1,2,1,2,3,3,2,4,0,2,0,0,2,1,1,16640,6906,1496,11862,1
6,286,11,6,10,0,0,1,11,2,4,2,4,6,6,10,15,1,15,0,0,2,1,1,16640,6906,1496,11863,1
38,1723,1178,367,1042,6,15,115,1184,9,94,51,95,103,146,644,976,4,4439,246,0,2,2,2,16640,6906,1496,11864,1
6,286,42,7,35,4,0,5,46,1,2,1,2,3,3,2,4,0,2,0,0,2,1,1,16650,6910,1497,11872,1
6,286,11,6,10,0,0,1,11,2,4,2,4,6,6,10,15,1,15,0,0,2,1,1,16650,6910,1497,11873,1
9,372,42,7,35,4,0,5,46,1,2,1,2,3,3,2,4,0,2,0,0,2,17,3,16660,6914,1498,11881,1
9,372,11,6,10,0,0,1,11,2,4,2,4,6,6,10,15,1,15,0,0,2,17,3,16660,6914,1498,11882,1
11,401,42,7,35,4,0,5,46,1,2,1,2,3,3,2,4,0,2,0,0,2,4,2,16670,6918,1499,11890,1
11,401,11,6,10,0,0,1,11,2,4,2,4,6,6,10,15,1,15,0,0,2,4,2,16670,6918,1499,11891,1
409,8854,72,33,56,0,4,12,72,1,1,1,1,2,2,0,2,0,1,0,0,2,2,2,16680,6922,1500,11899,1
409,8854,1454,835,1044,76,110,219,1530,17,275,158,296,292,454,2297,3718,9,34017,1889,1,2,2,2,16690,6923,1500,11900,1
11,401,42,7,35,4,0,5,46,1,2,1,2,3,3,2,4,0,2,0,0,2,1,1,16690,6923,1500,11901,1
11,401,11,6,10,0,0,1,11,2,4,2,4,6,6,10,15,1,15,0,0,2,1,1,16690,6923,1500,11902,1
12,392,424,94,331,4,0,89,428,1,5,5,5,6,10,11,25,0,12,0,0,2,1,1,16690,6924,1500,11903,1
11,401,42,7,35,4,0,5,46,1,2,1,2,3,3,2,4,0,2,0,0,2,1,1,16700,6928,1501,11911,1
11,401,11,6,10,0,0,1,11,2,4,2,4,6,6,10,15,1,15,0,0,2,1,1,16700,6928,1501,11912,1
100,2275,1660,832,1314,41,38,274,1701,20,312,209,395,332,604,2671,5058,12,64042,3557,1,2,7,4,16700,6930,1502,11914,1
409,8857,72,33,56,0,4,12,72,1,1,1,1,2,2,0,2,0,1,0,0,2,1,1,16710,6934,1503,11922,1
409,8857,1454,835,1044,76,110,219,1530,17,275,158,296,292,454,2297,3718,9,34017,1889,1,2,1,1,16720,6935,1503,11923,1
11,401,42,7,35,4,0,5,46,1,2,1,2,3,3,2,4,0,2,0,0,2,1,1,16720,6935,1503,11924,1
11,401,11,6,10,0,0,1,11,2,4,2,4,6,6,10,15,1,15,0,0,2,1,1,16720,6935,1503,11925,1
165,3672,77,34,69,0,0,8,77,3,24,16,29,27,45,114,213,1,387,21,0,2,5,3,16730,6939,1504,11933,1
165,3672,712,438,573,51,9,84,763,14,102,71,128,116,199,733,1364,8,11988,666,0,2,5,3,16740,6940,1504,11934,1
409,8857,72,33,56,0,4,12,72,1,1,1,1,2,2,0,2,0,1,0,0,2,1,0,16740,6940,1504,11935,1
409,8857,1454,835,1044,76,110,219,1530,17,275,158,296,292,454,2297,3718,9,34017,1889,1,2,1,0,16750,6941,1504,11936,1
11,401,42,7,35,4,0,5,46,1,2,1,2,3,3,2,4,0,2,0,0,2,1,1,16750,6941,1504,11937,1
11,401,11,6,10,0,0,1,11,2,4,2,4,6,6,10,15,1,15,0,0,2,1,1,16750,6941,1504,11938,1
53,1057,1098,241,925,5,10,155,1103,7,46,25,49,53,74,273,423,3,1580,87,0,2,5,2,16770,6947,1505,11946,1
53,1057,282,202,222,14,2,44,296,8,42,24,43,50,67,250,378,4,1548,86,0,2,5,2,16770,6948,1505,11947,1
11,401,42,7,35,4,0,5,46,1,2,1,2,3,3,2,4,0,2,0,0,2,1,1,16770,6948,1505,11948,1
11,401,11,6,10,0,0,1,11,2,4,2,4,6,6,10,15,1,15,0,0,2,1,1,16770,6948,1505,11949,1
27,1018,1098,241,925,5,10,155,1103,7,46,25,49,53,74,273,423,3,1580,87,0,2,12,3,16780,6950,1505,11950,1
55,1085,1098,241,925,5,10,155,1103,7,46,25,49,53,74,273,423,3,1580,87,0,2,5,2,16800,6956,1506,11958,1
55,1085,282,202,222,14,2,44,296,8,42,24,43,50,67,250,378,4,1548,86,0,2,5,2,16800,6957,1506,11959,1
11,401,42,7,35,4,0,5,46,1,2,1,2,3,3,2,4,0,2,0,0,2,1,1,16800,6957,1506,11960,1
11,401,11,6,10,0,0,1,11,2,4,2,4,6,6,10,15,1,15,0,0,2,1,1,16800,6957,1506,11961,1
28,1072,1098,241,925,5,10,155,1103,7,46,25,49,53,74,273,423,3,1580,87,0,2,22,2,16810,6959,1506,11962,1
139,2729,1457,730,1242,11,6,188,1468,10,292,166,329,302,495,2424,4078,5,22973,1276,1,2,32,6,16810,6961,1506,11963,1
139,2729,74,35,59,1,0,14,75,3,14,7,14,17,21,58,85,1,128,7,0,2,32,6,16810,6962,1506,11964,1
139,2729,245,125,200,5,7,34,250,7,30,17,34,37,51,166,265,3,1053,58,0,2,32,6,16820,6963,1506,11965,1
43,415,647,139,84,35,284,233,682,0,0,0,0,0,0,0,0,0,0,0,0,2,4,2,16820,6963,1506,11966,1
1,199,382,65,130,157,2,92,539,4,10,5,10,14,15,41,57,2,114,6,0,2,1,1,16820,6964,1507,11967,1
11,401,42,7,35,4,0,5,46,1,2,1,2,3,3,2,4,0,2,0,0,2,1,1,16820,6964,1507,11968,1
11,401,11,6,10,0,0,1,11,2,4,2,4,6,6,10,15,1,15,0,0,2,1,1,16820,6964,1507,11969,1
1,199,382,65,130,157,2,92,539,4,10,5,10,14,15,41,57,2,114,6,0,2,4,4,16830,6969,1509,11977,1
11,401,42,7,35,4,0,5,46,1,2,1,2,3,3,2,4,0,2,0,0,2,2,2,16830,6969,1509,11978,1
11,401,11,6,10,0,0,1,11,2,4,2,4,6,6,10,15,1,15,0,0,2,2,2,16830,6969,1509,11979,1
135,2675,1457,730,1242,11,6,188,1468,10,292,166,329,302,495,2424,4078,5,22973,1276,1,2,0,11,16830,6971,1509,11980,0
135,2675,74,35,59,1,0,14,75,3,14,7,14,17,21,58,85,1,128,7,0,2,0,11,16830,6972,1509,11981,0
135,2675,245,125,200,5,7,34,250,7,30,17,34,37,51,166,265,3,1053,58,0,2,0,11,16840,6973,1509,11982,0
1,199,382,65,130,157,2,92,539,4,10,5,10,14,15,41,57,2,114,6,0,2,1,1,16840,6974,1510,11983,0
409,8857,72,33,56,0,4,12,72,1,1,1,1,2,2,0,2,0,1,0,0,2,1,1,16840,6974,1510,11984,1
409,8857,1454,835,1044,76,110,219,1530,17,275,158,296,292,454,2297,3718,9,34017,1889,1,2,1,1,16850,6975,1510,11985,1
410,8865,72,33,56,0,4,12,72,1,1,1,1,2,2,0,2,0,1,0,0,2,9,1,16850,6975,1510,11986,1
410,8865,1454,835,1044,76,110,219,1530,17,275,158,296,292,454,2297,3718,9,34017,1889,1,2,9,1,16860,6976,1510,11987,1
410,8865,72,33,56,0,4,12,72,1,1,1,1,2,2,0,2,0,1,0,0,2,9,1,16860,6976,1510,11988,0
410,8865,1454,835,1044,76,110,219,1530,17,275,158,296,292,454,2297,3718,9,34017,1889,1,2,9,1,16870,6977,1510,11989,0
411,8864,72,33,56,0,4,12,72,1,1,1,1,2,2,0,2,0,1,0,0,2,6,6,16880,6981,1511,11997,1
411,8864,1454,835,1044,76,110,219,1530,17,275,158,296,292,454,2297,3718,9,34017,1889,1,2,6,6,16890,6982,1511,11998,1
12,222,127,75,83,2,11,30,129,4,14,7,14,18,21,61,87,2,175,9,0,2,3,3,16890,6982,1511,11999,1
12,222,652,304,544,16,6,88,668,6,89,51,101,95,152,591,998,3,3399,188,0,2,3,3,16890,6983,1511,12000,1
12,222,2,2,2,0,0,0,2,0,0,0,0,0,0,0,0,0,0,0,0,2,3,3,16890,6983,1511,12000,1
12,222,8,5,5,0,0,3,8,0,0,0,0,0,0,0,0,0,0,0,0,2,3,3,16890,6983,1511,12001,1
12,222,2,2,2,0,0,0,2,0,0,0,0,0,0,0,0,0,0,0,0,2,3,3,16890,6983,1511,12001,1
12,222,14,8,8,0,0,6,14,0,0,0,0,0,0,0,0,0,0,0,0,2,3,3,16890,6983,1511,12002,1
12,222,6,4,4,0,0,2,6,0,0,0,0,0,0,0,0,0,0,0,0,2,3,3,16890,6983,1511,12003,1
12,222,6,4,4,0,0,2,6,1,2,1,2,3,3,2,4,0,2,0,0,2,3,3,16890,6983,1511,12004,1
12,222,6,4,4,0,0,2,6,0,0,0,0,0,0,0,0,0,0,0,0,2,3,3,16890,6983,1511,12005,1
12,222,7,5,5,0,0,2,7,0,0,0,0,0,0,0,0,0,0,0,0,2,3,3,16890,6983,1511,12006,1
12,222,6,4,4,0,0,2,6,0,0,0,0,0,0,0,0,0,0,0,0,2,3,3,16890,6983,1511,12007,1
12,222,10,6,6,0,0,4,10,0,0,0,0,0,0,0,0,0,0,0,0,2,3,3,16890,6983,1511,12008,1
12,222,1,1,1,0,0,0,1,0,0,0,0,0,0,0,0,0,0,0,0,2,3,3,16890,6983,1511,12008,1
12,222,14,10,10,0,0,4,14,1,1,1,1,2,2,0,2,0,1,0,0,2,3,3,16890,6983,1511,12009,1
12,222,46,26,30,3,0,12,49,3,6,3,6,9,9,20,28,1,42,2,0,2,3,3,16900,6983,1511,12010,1
11,401,42,7,35,4,0,5,46,1,2,1,2,3,3,2,4,0,2,0,0,2,1,1,16900,6983,1511,12011,1
11,401,11,6,10,0,0,1,11,2,4,2,4,6,6,10,15,1,15,0,0,2,1,1,16900,6983,1511,12012,1
409,8836,72,33,56,0,4,12,72,1,1,1,1,2,2,0,2,0,1,0,0,2,0,6,16900,6983,1511,12013,0
409,8836,1454,835,1044,76,110,219,1530,17,275,158,296,292,454,2297,3718,9,34017,1889,1,2,0,6,16910,6984,1511,12014,0
51,2762,1338,495,1086,10,64,173,1348,11,122,82,157,133,239,883,1686,7,11934,663,0,0,721,0,16910,6986,1511,12015,1
97,4106,139,89,101,2,0,35,141,7,54,34,62,61,96,330,569,4,2287,127,0,3,248,1616,16910,6986,1511,12016,1
97,4106,7,5,5,0,0,2,7,1,2,1,2,3,3,2,4,0,2,0,0,3,248,1616,16910,6986,1511,12017,1
39,2430,1782,648,1425,9,47,279,1791,8,171,97,189,179,286,1292,2140,4,9462,525,0,0,575,0,16910,6987,1512,12018,1
9,192,256,139,192,9,7,47,265,4,23,12,24,27,36,112,171,2,357,19,0,0,64,0,16910,6988,1512,12019,1
57,1111,1098,241,925,5,10,155,1103,7,46,25,49,53,74,273,423,3,1580,87,0,2,4,0,16920,6990,1512,12020,1
57,1111,282,202,222,14,2,44,296,8,42,24,43,50,67,250,378,4,1548,86,0,2,4,0,16920,6991,1512,12021,1
29,1111,1098,241,925,5,10,155,1103,7,46,25,49,53,74,273,423,3,1580,87,0,2,19,0,16930,6993,1512,12022,1
11,401,42,7,35,4,0,5,46,1,2,1,2,3,3,2,4,0,2,0,0,2,1,1,16930,6993,1512,12023,0
11,401,11,6,10,0,0,1,11,2,4,2,4,6,6,10,15,1,15,0,0,2,1,1,16930,6993,1512,12024,0
13,417,424,94,331,4,0,89,428,1,5,5,5,6,10,11,25,0,12,0,0,2,6,0,16930,6994,1512,12025,1
19,299,424,94,331,4,0,89,428,1,5,5,5,6,10,11,25,0,12,0,0,2,1,1,16930,6995,1512,12026,0
19,299,38,23,23,6,0,8,44,3,11,7,11,14,18,42,68,1,102,5,0,2,1,1,16930,6995,1512,12027,0
13,417,424,94,331,4,0,89,428,1,5,5,5,6,10,11,25,0,12,0,0,2,6,0,16930,6996,1512,12028,0
38,1618,1020,354,843,12,15,144,1032,8,134,77,144,142,221,970,1580,4,6792,377,0,2,19,0,16930,6996,1512,12029,1
118,3822,1660,832,1314,41,38,274,1701,20,312,209,395,332,604,2671,5058,12,64042,3557,1,2,1,1,16940,7002,1514,12038,0
118,3822,1057,646,719,113,100,145,1170,18,215,134,248,233,382,1740,3004,10,31186,1732,1,2,1,1,16950,7003,1515,12039,0
11,401,42,7,35,4,0,5,46,1,2,1,2,3,3,2,4,0,2,0,0,2,1,1,16950,7003,1515,12040,0
11,401,11,6,10,0,0,1,11,2,4,2,4,6,6,10,15,1,15,0,0,2,1,1,16950,7003,1515,12041,0
12,417,42,7,35,4,0,5,46,1,2,1,2,3,3,2,4,0,2,0,0,2,4,2,16950,7003,1515,12042,0
12,417,11,6,10,0,0,1,11,2,4,2,4,6,6,10,15,1,15,0,0,2,4,2,16950,7003,1515,12043,0
12,417,42,7,35,4,0,5,46,1,2,1,2,3,3,2,4,0,2,0,0,2,2,2,16960,7007,1516,12051,1
12,417,11,6,10,0,0,1,11,2,4,2,4,6,6,10,15,1,15,0,0,2,2,2,16960,7007,1516,12052,1
411,8874,72,33,56,0,4,12,72,1,1,1,1,2,2,0,2,0,1,0,0,2,6,0,16970,7011,1517,12060,1
411,8874,1454,835,1044,76,110,219,1530,17,275,158,296,292,454,2297,3718,9,34017,1889,1,2,6,0,16980,7012,1517,12061,1
12,417,42,7,35,4,0,5,46,1,2,1,2,3,3,2,4,0,2,0,0,2,1,1,16980,7012,1517,12062,1
12,417,11,6,10,0,0,1,11,2,4,2,4,6,6,10,15,1,15,0,0,2,1,1,16980,7012,1517,12063,1
95,3966,139,89,101,2,0,35,141,7,54,34,62,61,96,330,569,4,2287,127,0,2,0,53,16980,7012,1517,12064,1
95,3966,7,5,5,0,0,2,7,1,2,1,2,3,3,2,4,0,2,0,0,2,0,53,16980,7012,1517,12065,1
12,339,465,148,393,5,8,60,470,4,31,20,31,35,51,161,261,2,523,29,0,0,119,0,16980,7013,1517,12066,1
12,339,16,12,9,0,0,6,16,1,2,1,2,3,3,2,4,0,2,0,0,0,119,0,16980,7013,1517,12067,1
38,1620,1020,354,843,12,15,144,1032,8,134,77,144,142,221,970,1580,4,6792,377,0,2,1,1,16980,7013,1517,12068,1
13,410,424,94,331,4,0,89,428,1,5,5,5,6,10,11,25,0,12,0,0,2,3,11,16980,7014,1517,12069,1
138,2747,1457,730,1242,11,6,188,1468,10,292,166,329,302,495,2424,4078,5,22973,1276,1,2,24,6,16990,7020,1518,12077,1
138,2747,74,35,59,1,0,14,75,3,14,7,14,17,21,58,85,1,128,7,0,2,24,6,16990,7021,1518,12078,1
138,2747,245,125,200,5,7,34,250,7,30,17,34,37,51,166,265,3,1053,58,0,2,24,6,17000,7022,1518,12079,1
43,415,647,139,84,35,284,233,682,0,0,0,0,0,0,0,0,0,0,0,0,2,23,5,17000,7022,1518,12080,1
12,417,42,7,35,4,0,5,46,1,2,1,2,3,3,2,4,0,2,0,0,2,1,1,17000,7022,1518,12081,1
12,417,11,6,10,0,0,1,11,2,4,2,4,6,6,10,15,1,15,0,0,2,1,1,17000,7022,1518,12082,1
33,1692,1457,730,1242,11,6,188,1468,10,292,166,329,302,495,2424,4078,5,22973,1276,1,2,11,0,17000,7024,1518,12083,1
1,199,382,65,130,157,2,92,539,4,10,5,10,14,15,41,57,2,114,6,0,2,1,1,17010,7029,1520,12091,1
12,417,42,7,35,4,0,5,46,1,2,1,2,3,3,2,4,0,2,0,0,2,2,2,17010,7029,1520,12092,1
12,417,11,6,10,0,0,1,11,2,4,2,4,6,6,10,15,1,15,0,0,2,2,2,17010,7029,1520,12093,1
19,303,424,94,331,4,0,89,428,1,5,5,5,6,10,11,25,0,12,0,0,2,1,1,17010,7030,1520,12094,1
19,303,38,23,23,6,0,8,44,3,11,7,11,14,18,42,68,1,102,5,0,2,1,1,17010,7030,1520,12095,1
12,417,42,7,35,4,0,5,46,1,2,1,2,3,3,2,4,0,2,0,0,2,29,5,17010,7030,1520,12096,1
12,417,11,6,10,0,0,1,11,2,4,2,4,6,6,10,15,1,15,0,0,2,29,5,17010,7030,1520,12097,1
12,417,42,7,35,4,0,5,46,1,2,1,2,3,3,2,4,0,2,0,0,2,1,1,17010,7030,1520,12098,0
12,417,11,6,10,0,0,1,11,2,4,2,4,6,6,10,15,1,15,0,0,2,1,1,17010,7030,1520,12099,0
12,417,42,7,35,4,0,5,46,1,2,1,2,3,3,2,4,0,2,0,0,2,1,1,17020,7034,1521,12107,0
12,417,11,6,10,0,0,1,11,2,4,2,4,6,6,10,15,1,15,0,0,2,1,1,17020,7034,1521,12108,0
1,199,382,65,130,157,2,92,539,4,10,5,10,14,15,41,57,2,114,6,0,2,1,1,17020,7035,1522,12109,1
1,199,382,65,130,157,2,92,539,4,10,5,10,14,15,41,57,2,114,6,0,2,1,1,17020,7036,1523,12110,0
1,199,382,65,130,157,2,92,539,4,10,5,10,14,15,41,57,2,114,6,0,2,1,1,17020,7037,1524,12111,1
56,1054,1020,354,843,12,15,144,1032,8,134,77,144,142,221,970,1580,4,6792,377,0,2,1,1,17030,7041,1525,12119,1
12,417,42,7,35,4,0,5,46,1,2,1,2,3,3,2,4,0,2,0,0,2,1,1,17030,7041,1525,12120,1
12,417,11,6,10,0,0,1,11,2,4,2,4,6,6,10,15,1,15,0,0,2,1,1,17030,7041,1525,12121,1
40,1736,1020,354,843,12,15,144,1032,8,134,77,144,142,221,970,1580,4,6792,377,0,2,24,1,17030,7041,1525,12122,1
52,1026,1020,354,843,12,15,144,1032,8,134,77,144,142,221,970,1580,4,6792,377,0,2,14,25,17040,7045,1526,12130,1
12,417,42,7,35,4,0,5,46,1,2,1,2,3,3,2,4,0,2,0,0,2,1,1,17040,7045,1526,12131,1
12,417,11,6,10,0,0,1,11,2,4,2,4,6,6,10,15,1,15,0,0,2,1,1,17040,7045,1526,12132,1
42,1846,1020,354,843,12,15,144,1032,8,134,77,144,142,221,970,1580,4,6792,377,0,2,21,3,17040,7045,1526,12133,1
140,2768,1457,730,1242,11,6,188,1468,10,292,166,329,302,495,2424,4078,5,22973,1276,1,2,7,2,17050,7051,1527,12141,1
140,2768,74,35,59,1,0,14,75,3,14,7,14,17,21,58,85,1,128,7,0,2,7,2,17050,7052,1527,12142,1
140,2768,245,125,200,5,7,34,250,7,30,17,34,37,51,166,265,3,1053,58,0,2,7,2,17060,7053,1527,12143,1
12,417,42,7,35,4,0,5,46,1,2,1,2,3,3,2,4,0,2,0,0,2,1,1,17060,7053,1527,12144,1
12,417,11,6,10,0,0,1,11,2,4,2,4,6,6,10,15,1,15,0,0,2,1,1,17060,7053,1527,12145,1
34,1716,1457,730,1242,11,6,188,1468,10,292,166,329,302,495,2424,4078,5,22973,1276,1,2,4,0,17060,7055,1527,12146,1
411,8874,72,33,56,0,4,12,72,1,1,1,1,2,2,0,2,0,1,0,0,2,2,2,17060,7055,1527,12147,1
411,8874,1454,835,1044,76,110,219,1530,17,275,158,296,292,454,2297,3718,9,34017,1889,1,2,2,2,17070,7056,1527,12148,1
411,8876,72,33,56,0,4,12,72,1,1,1,1,2,2,0,2,0,1,0,0,2,10,4,17080,7060,1528,12156,1
411,8876,1454,835,1044,76,110,219,1530,17,275,158,296,292,454,2297,3718,9,34017,1889,1,2,10,4,17090,7061,1528,12157,1
12,417,42,7,35,4,0,5,46,1,2,1,2,3,3,2,4,0,2,0,0,2,1,1,17090,7061,1528,12158,1
12,417,11,6,10,0,0,1,11,2,4,2,4,6,6,10,15,1,15,0,0,2,1,1,17090,7061,1528,12159,1
96,4040,139,89,101,2,0,35,141,7,54,34,62,61,96,330,569,4,2287,127,0,2,25,1,17090,7061,1528,12160,1
96,4040,7,5,5,0,0,2,7,1,2,1,2,3,3,2,4,0,2,0,0,2,25,1,17090,7061,1528,12161,1
412,8880,72,33,56,0,4,12,72,1,1,1,1,2,2,0,2,0,1,0,0,2,9,6,17090,7061,1528,12162,1
412,8880,1454,835,1044,76,110,219,1530,17,275,158,296,292,454,2297,3718,9,34017,1889,1,2,9,6,17100,7062,1528,12163,1
11,355,442,244,305,14,16,103,456,11,68,45,75,79,120,452,756,6,4588,254,0,2,3,3,17100,7064,1528,12164,1
11,355,182,102,99,11,40,35,193,3,11,6,11,14,17,42,64,1,97,5,0,2,3,3,17100,7065,1528,12165,1
6,488,442,244,305,14,16,103,456,11,68,45,75,79,120,452,756,6,4588,254,0,2,3,3,17100,7067,1528,12166,1
412,8878,72,33,56,0,4,12,72,1,1,1,1,2,2,0,2,0,1,0,0,2,1,1,17110,7071,1529,12174,1
412,8878,1454,835,1044,76,110,219,1530,17,275,158,296,292,454,2297,3718,9,34017,1889,1,2,1,1,17120,7072,1529,12175,1
12,417,42,7,35,4,0,5,46,1,2,1,2,3,3,2,4,0,2,0,0,2,1,1,17120,7072,1529,12176,1
12,417,11,6,10,0,0,1,11,2,4,2,4,6,6,10,15,1,15,0,0,2,1,1,17120,7072,1529,12177,1
97,4113,139,89,101,2,0,35,141,7,54,34,62,61,96,330,569,4,2287,127,0,2,19,0,17120,7072,1529,12178,1
97,4113,7,5,5,0,0,2,7,1,2,1,2,3,3,2,4,0,2,0,0,2,19,0,17120,7072,1529,12179,1
414,8900,72,33,56,0,4,12,72,1,1,1,1,2,2,0,2,0,1,0,0,2,10,8,17120,7072,1529,12180,1
414,8900,1454,835,1044,76,110,219,1530,17,275,158,296,292,454,2297,3718,9,34017,1889,1,2,10,8,17130,7073,1529,12181,1
98,4142,139,89,101,2,0,35,141,7,54,34,62,61,96,330,569,4,2287,127,0,2,18,0,17130,7073,1529,12182,1
98,4142,7,5,5,0,0,2,7,1,2,1,2,3,3,2,4,0,2,0,0,2,18,0,17130,7073,1529,12183,1
34,1725,1457,730,1242,11,6,188,1468,10,292,166,329,302,495,2424,4078,5,22973,1276,1,2,1,0,17130,7075,1529,12184,0
1,199,382,65,130,157,2,92,539,4,10,5,10,14,15,41,57,2,114,6,0,2,1,1,17140,7080,1531,12192,1
12,417,42,7,35,4,0,5,46,1,2,1,2,3,3,2,4,0,2,0,0,2,1,1,17140,7080,1531,12193,1
12,417,11,6,10,0,0,1,11,2,4,2,4,6,6,10,15,1,15,0,0,2,1,1,17140,7080,1531,12194,1
12,417,42,7,35,4,0,5,46,1,2,1,2,3,3,2,4,0,2,0,0,2,1,1,17150,7084,1532,12202,1
12,417,11,6,10,0,0,1,11,2,4,2,4,6,6,10,15,1,15,0,0,2,1,1,17150,7084,1532,12203,1
52,1027,1020,354,843,12,15,144,1032,8,134,77,144,142,221,970,1580,4,6792,377,0,2,6,5,17160,7088,1533,12211,1
12,417,42,7,35,4,0,5,46,1,2,1,2,3,3,2,4,0,2,0,0,2,1,1,17160,7088,1533,12212,1
12,417,11,6,10,0,0,1,11,2,4,2,4,6,6,10,15,1,15,0,0,2,1,1,17160,7088,1533,12213,1
12,424,42,7,35,4,0,5,46,1,2,1,2,3,3,2,4,0,2,0,0,2,1,37,17160,7088,1533,12214,0
12,424,11,6,10,0,0,1,11,2,4,2,4,6,6,10,15,1,15,0,0,2,1,37,17160,7088,1533,12215,0
12,424,42,7,35,4,0,5,46,1,2,1,2,3,3,2,4,0,2,0,0,2,1,1,17160,7088,1533,12216,1
12,424,11,6,10,0,0,1,11,2,4,2,4,6,6,10,15,1,15,0,0,2,1,1,17160,7088,1533,12217,1
414,8900,72,33,56,0,4,12,72,1,1,1,1,2,2,0,2,0,1,0,0,2,5,2,17160,7088,1533,12218,1
414,8900,1454,835,1044,76,110,219,1530,17,275,158,296,292,454,2297,3718,9,34017,1889,1,2,5,2,17170,7089,1533,12219,1
69,1236,1513,682,1277,25,13,200,1538,11,199,116,219,210,335,1557,2584,6,15641,868,0,2,5,2,17180,7095,1534,12227,1
69,1236,819,519,539,24,98,155,843,15,96,57,106,111,163,690,1107,8,9171,509,0,2,5,2,17190,7097,1534,12228,1
12,424,42,7,35,4,0,5,46,1,2,1,2,3,3,2,4,0,2,0,0,2,1,1,17190,7097,1534,12229,1
12,424,11,6,10,0,0,1,11,2,4,2,4,6,6,10,15,1,15,0,0,2,1,1,17190,7097,1534,12230,1
21,825,1293,570,1093,25,15,163,1318,10,195,123,241,205,364,1516,2795,6,17273,959,0,2,16,0,17200,7099,1534,12231,1
413,8892,72,33,56,0,4,12,72,1,1,1,1,2,2,0,2,0,1,0,0,2,6,7,17200,7099,1534,12232,1
413,8892,1454,835,1044,76,110,219,1530,17,275,158,296,292,454,2297,3718,9,34017,1889,1,2,6,7,17210,7100,1534,12233,1
52,2827,1338,495,1086,10,64,173,1348,11,122,82,157,133,239,883,1686,7,11934,663,0,2,22,0,17210,7102,1534,12234,1
12,424,42,7,35,4,0,5,46,1,2,1,2,3,3,2,4,0,2,0,0,2,1,1,17220,7106,1535,12242,1
12,424,11,6,10,0,0,1,11,2,4,2,4,6,6,10,15,1,15,0,0,2,1,1,17220,7106,1535,12243,1
29,603,2,2,2,0,0,0,2,0,0,0,0,0,0,0,0,0,0,0,0,2,1,1,17220,7106,1535,12243,1
29,603,99,48,90,1,3,5,100,0,0,0,0,0,0,0,0,0,0,0,0,2,1,1,17220,7107,1535,12244,1
29,603,8,5,5,2,0,1,10,0,0,0,0,0,0,0,0,0,0,0,0,2,1,1,17220,7107,1535,12245,1
29,603,1217,716,841,84,126,174,1301,14,185,118,215,199,333,1446,2542,8,20687,1149,0,2,1,1,17230,7109,1535,12246,1
29,603,160,89,115,0,13,31,160,7,15,11,17,22,28,78,124,3,495,27,0,2,1,1,17230,7109,1535,12247,1
29,603,10,10,9,9,0,0,19,0,0,0,0,0,0,0,0,0,0,0,0,2,1,1,17230,7109,1536,12248,1
29,603,173,84,99,8,29,36,181,5,12,7,13,17,20,54,81,2,221,12,0,2,1,1,17230,7110,1536,12249,1
29,603,3,1,1,3,0,0,6,0,0,0,0,0,0,0,0,0,0,0,0,2,1,1,17230,7110,1536,12250,1
29,1172,1450,624,1228,12,26,181,1462,14,306,186,354,320,540,2580,4493,8,36391,2021,1,2,1,1,17230,7112,1537,12251,1
11,345,74,35,59,1,0,14,75,3,14,7,14,17,21,58,85,1,128,7,0,2,2,1,17230,7113,1537,12252,0
12,424,42,7,35,4,0,5,46,1,2,1,2,3,3,2,4,0,2,0,0,2,1,1,17240,7117,1538,12260,1
12,424,11,6,10,0,0,1,11,2,4,2,4,6,6,10,15,1,15,0,0,2,1,1,17240,7117,1538,12261,1
120,3840,1660,832,1314,41,38,274,1701,20,312,209,395,332,604,2671,5058,12,64042,3557,1,2,8,4,17240,7119,1539,12263,1
120,3840,1057,646,719,113,100,145,1170,18,215,134,248,233,382,1740,3004,10,31186,1732,1,2,8,4,17250,7120,1540,12264,1
102,2320,1660,832,1314,41,38,274,1701,20,312,209,395,332,604,2671,5058,12,64042,3557,1,2,10,2,17250,7122,1541,12266,1
1,199,382,65,130,157,2,92,539,4,10,5,10,14,15,41,57,2,114,6,0,2,1,1,17250,7123,1542,12267,0
96,2189,1043,504,840,53,9,147,1096,9,180,112,198,189,310,1377,2344,4,11604,644,0,2,1,0,17250,7125,1542,12268,1
96,2189,383,288,292,26,6,62,409,11,65,38,67,76,105,429,656,5,3719,206,0,2,1,0,17250,7126,1542,12269,1
45,1829,1043,504,840,53,9,147,1096,9,180,112,198,189,310,1377,2344,4,11604,644,0,2,4,0,17250,7128,1542,12270,1
1,199,382,65,130,157,2,92,539,4,10,5,10,14,15,41,57,2,114,6,0,2,1,1,17250,7129,1543,12271,0
18,678,1455,414,1257,16,76,112,1471,5,41,23,46,46,69,231,381,2,1069,59,0,2,7,0,17250,7130,1543,12272,1
18,678,669,365,481,22,61,110,691,15,103,63,122,118,185,747,1273,8,11311,628,0,2,7,0,17260,7130,1544,12273,1
188,4434,722,423,573,19,0,135,741,12,172,101,199,184,300,1320,2257,6,15668,870,0,2,3,5,17260,7132,1544,12275,1
188,4434,1508,847,911,44,250,301,1552,14,148,88,169,162,257,1120,1886,7,15077,837,0,2,3,5,17260,7133,1545,12276,1
45,1832,1043,504,840,53,9,147,1096,9,180,112,198,189,310,1377,2344,4,11604,644,0,2,1,1,17260,7135,1545,12277,1
98,4158,139,89,101,2,0,35,141,7,54,34,62,61,96,330,569,4,2287,127,0,2,2,2,17260,7135,1545,12278,1
98,4158,7,5,5,0,0,2,7,1,2,1,2,3,3,2,4,0,2,0,0,2,2,2,17260,7135,1545,12279,1
19,306,424,94,331,4,0,89,428,1,5,5,5,6,10,11,25,0,12,0,0,2,2,1,17260,7136,1545,12280,1
19,306,38,23,23,6,0,8,44,3,11,7,11,14,18,42,68,1,102,5,0,2,2,1,17260,7136,1545,12281,1
21,326,424,94,331,4,0,89,428,1,5,5,5,6,10,11,25,0,12,0,0,2,12,2,17260,7137,1545,12282,1
21,326,38,23,23,6,0,8,44,3,11,7,11,14,18,42,68,1,102,5,0,2,12,2,17260,7137,1545,12283,1
14,437,424,94,331,4,0,89,428,1,5,5,5,6,10,11,25,0,12,0,0,2,25,0,17260,7138,1545,12284,1
21,326,424,94,331,4,0,89,428,1,5,5,5,6,10,11,25,0,12,0,0,2,14,3,17260,7139,1545,12285,0
21,326,38,23,23,6,0,8,44,3,11,7,11,14,18,42,68,1,102,5,0,2,14,3,17260,7139,1545,12286,0
14,437,424,94,331,4,0,89,428,1,5,5,5,6,10,11,25,0,12,0,0,2,25,0,17260,7140,1545,12287,0
12,424,42,7,35,4,0,5,46,1,2,1,2,3,3,2,4,0,2,0,0,2,2,2,17270,7144,1546,12295,1
12,424,11,6,10,0,0,1,11,2,4,2,4,6,6,10,15,1,15,0,0,2,2,2,17270,7144,1546,12296,1
30,1205,1450,624,1228,12,26,181,1462,14,306,186,354,320,540,2580,4493,8,36391,2021,1,2,13,0,17270,7146,1547,12297,1
35,630,127,75,83,2,11,30,129,4,14,7,14,18,21,61,87,2,175,9,0,2,2,1,17270,7146,1547,12298,0
35,630,652,304,544,16,6,88,668,6,89,51,101,95,152,591,998,3,3399,188,0,2,2,1,17270,7147,1547,12299,0
35,630,2,2,2,0,0,0,2,0,0,0,0,0,0,0,0,0,0,0,0,2,2,1,17270,7147,1547,12299,0
35,630,8,5,5,0,0,3,8,0,0,0,0,0,0,0,0,0,0,0,0,2,2,1,17270,7147,1547,12300,0
35,630,2,2,2,0,0,0,2,0,0,0,0,0,0,0,0,0,0,0,0,2,2,1,17270,7147,1547,12300,0
35,630,14,8,8,0,0,6,14,0,0,0,0,0,0,0,0,0,0,0,0,2,2,1,17270,7147,1547,12301,0
35,630,6,4,4,0,0,2,6,0,0,0,0,0,0,0,0,0,0,0,0,2,2,1,17270,7147,1547,12302,0
35,630,6,4,4,0,0,2,6,1,2,1,2,3,3,2,4,0,2,0,0,2,2,1,17270,7147,1547,12303,0
35,630,6,4,4,0,0,2,6,0,0,0,0,0,0,0,0,0,0,0,0,2,2,1,17270,7147,1547,12304,0
35,630,7,5,5,0,0,2,7,0,0,0,0,0,0,0,0,0,0,0,0,2,2,1,17270,7147,1547,12305,0
35,630,6,4,4,0,0,2,6,0,0,0,0,0,0,0,0,0,0,0,0,2,2,1,17270,7147,1547,12306,0
35,630,10,6,6,0,0,4,10,0,0,0,0,0,0,0,0,0,0,0,0,2,2,1,17270,7147,1547,12307,0
35,630,1,1,1,0,0,0,1,0,0,0,0,0,0,0,0,0,0,0,0,2,2,1,17270,7147,1547,12307,0
35,630,14,10,10,0,0,4,14,1,1,1,1,2,2,0,2,0,1,0,0,2,2,1,17270,7147,1547,12308,0
35,630,46,26,30,3,0,12,49,3,6,3,6,9,9,20,28,1,42,2,0,2,2,1,17280,7147,1547,12309,0
413,8895,72,33,56,0,4,12,72,1,1,1,1,2,2,0,2,0,1,0,0,2,1,1,17280,7147,1547,12310,1
413,8895,1454,835,1044,76,110,219,1530,17,275,158,296,292,454,2297,3718,9,34017,1889,1,2,1,1,17290,7148,1547,12311,1
39,2462,1782,648,1425,9,47,279,1791,8,171,97,189,179,286,1292,2140,4,9462,525,0,2,5,0,17290,7149,1548,12312,1
12,424,42,7,35,4,0,5,46,1,2,1,2,3,3,2,4,0,2,0,0,2,1,1,17290,7149,1548,12313,0
12,424,11,6,10,0,0,1,11,2,4,2,4,6,6,10,15,1,15,0,0,2,1,1,17290,7149,1548,12314,0
39,2468,1782,648,1425,9,47,279,1791,8,171,97,189,179,286,1292,2140,4,9462,525,0,2,1,1,17290,7150,1549,12315,0
162,3661,77,34,69,0,0,8,77,3,24,16,29,27,45,114,213,1,387,21,0,2,6,4,17290,7150,1549,12316,0
162,3661,712,438,573,51,9,84,763,14,102,71,128,116,199,733,1364,8,11988,666,0,2,6,4,17300,7151,1549,12317,0
156,3100,1943,715,1694,26,18,214,1969,12,185,120,237,197,357,1436,2721,7,20915,1161,0,2,1,1,17300,7153,1549,12318,1
156,3100,1168,838,957,57,25,144,1225,19,348,224,416,367,640,3018,5452,11,61921,3440,1,2,1,1,17310,7155,1549,12319,1
61,2541,1289,550,1043,56,32,155,1345,10,167,93,185,177,278,1266,2075,5,11498,638,0,2,15,0,17310,7157,1550,12320,1
413,8917,72,33,56,0,4,12,72,1,1,1,1,2,2,0,2,0,1,0,0,2,7,3,17310,7157,1550,12321,0
413,8917,1454,835,1044,76,110,219,1530,17,275,158,296,292,454,2297,3718,9,34017,1889,1,2,7,3,17320,7158,1550,12322,0
53,2846,1338,495,1086,10,64,173,1348,11,122,82,157,133,239,883,1686,7,11934,663,0,2,5,2,17320,7160,1550,12323,0
83,1463,1178,367,1042,6,15,115,1184,9,94,51,95,103,146,644,976,4,4439,246,0,2,7,1,17320,7160,1550,12324,0
83,1463,177,108,140,8,0,27,185,6,30,16,32,36,48,162,248,3,794,44,0,2,7,1,17320,7162,1550,12325,0
39,1775,1178,367,1042,6,15,115,1184,9,94,51,95,103,146,644,976,4,4439,246,0,2,14,0,17320,7162,1550,12326,0
83,1456,1178,367,1042,6,15,115,1184,9,94,51,95,103,146,644,976,4,4439,246,0,2,1,7,17320,7162,1550,12327,0
83,1456,177,108,140,8,0,27,185,6,30,16,32,36,48,162,248,3,794,44,0,2,1,7,17320,7164,1550,12328,0
125,3938,1660,832,1314,41,38,274,1701,20,312,209,395,332,604,2671,5058,12,64042,3557,1,2,27,0,17320,7166,1551,12330,1
125,3938,1057,646,719,113,100,145,1170,18,215,134,248,233,382,1740,3004,10,31186,1732,1,2,27,0,17330,7167,1552,12331,1
103,2378,1660,832,1314,41,38,274,1701,20,312,209,395,332,604,2671,5058,12,64042,3557,1,2,8,0,17330,7169,1553,12333,1
1,224,382,65,130,157,2,92,539,4,10,5,10,14,15,41,57,2,114,6,0,2,13,0,17330,7170,1554,12334,1
1,200,382,65,130,157,2,92,539,4,10,5,10,14,15,41,57,2,114,6,0,2,13,0,17330,7171,1555,12335,1
165,3711,77,34,69,0,0,8,77,3,24,16,29,27,45,114,213,1,387,21,0,2,12,0,17330,7171,1555,12336,0
165,3711,712,438,573,51,9,84,763,14,102,71,128,116,199,733,1364,8,11988,666,0,2,12,0,17340,7172,1555,12337,0
21,343,424,94,331,4,0,89,428,1,5,5,5,6,10,11,25,0,12,0,0,2,2,0,17340,7173,1555,12338,0
21,343,38,23,23,6,0,8,44,3,11,7,11,14,18,42,68,1,102,5,0,2,2,0,17340,7173,1555,12339,0
96,2185,1043,504,840,53,9,147,1096,9,180,112,198,189,310,1377,2344,4,11604,644,0,2,1,1,17340,7175,1555,12340,0
96,2185,383,288,292,26,6,62,409,11,65,38,67,76,105,429,656,5,3719,206,0,2,1,1,17340,7176,1555,12341,0
15,464,424,94,331,4,0,89,428,1,5,5,5,6,10,11,25,0,12,0,0,2,9,0,17340,7177,1555,12342,0
162,3675,77,34,69,0,0,8,77,3,24,16,29,27,45,114,213,1,387,21,0,2,4,10,17340,7177,1555,12343,1
162,3675,712,438,573,51,9,84,763,14,102,71,128,116,199,733,1364,8,11988,666,0,2,4,10,17350,7178,1555,12344,1
96,2186,1043,504,840,53,9,147,1096,9,180,112,198,189,310,1377,2344,4,11604,644,0,2,1,1,17350,7180,1555,12345,1
96,2186,383,288,292,26,6,62,409,11,65,38,67,76,105,429,656,5,3719,206,0,2,1,1,17350,7181,1555,12346,1
18,674,1455,414,1257,16,76,112,1471,5,41,23,46,46,69,231,381,2,1069,59,0,2,1,2,17350,7182,1555,12347,1
18,674,669,365,481,22,61,110,691,15,103,63,122,118,185,747,1273,8,11311,628,0,2,1,2,17360,7182,1556,12348,1
12,510,1455,414,1257,16,76,112,1471,5,41,23,46,46,69,231,381,2,1069,59,0,2,9,0,17360,7183,1556,12349,1
18,712,1455,414,1257,16,76,112,1471,5,41,23,46,46,69,231,381,2,1069,59,0,2,5,0,17360,7184,1556,12350,1
18,712,669,365,481,22,61,110,691,15,103,63,122,118,185,747,1273,8,11311,628,0,2,5,0,17370,7184,1557,12351,1
13,546,1455,414,1257,16,76,112,1471,5,41,23,46,46,69,231,381,2,1069,59,0,2,11,0,17370,7185,1557,12352,1
13,542,1455,414,1257,16,76,112,1471,5,41,23,46,46,69,231,381,2,1069,59,0,2,2,2,17370,7186,1557,12353,0
18,712,1455,414,1257,16,76,112,1471,5,41,23,46,46,69,231,381,2,1069,59,0,2,2,2,17370,7187,1557,12354,1
18,712,669,365,481,22,61,110,691,15,103,63,122,118,185,747,1273,8,11311,628,0,2,2,2,17380,7187,1558,12355,1
13,542,1455,414,1257,16,76,112,1471,5,41,23,46,46,69,231,381,2,1069,59,0,2,2,2,17380,7188,1558,12356,1
18,712,1455,414,1257,16,76,112,1471,5,41,23,46,46,69,231,381,2,1069,59,0,2,11,0,17380,7189,1558,12357,0
18,712,669,365,481,22,61,110,691,15,103,63,122,118,185,747,1273,8,11311,628,0,2,11,0,17390,7189,1559,12358,0
13,542,1455,414,1257,16,76,112,1471,5,41,23,46,46,69,231,381,2,1069,59,0,2,20,0,17390,7190,1559,12359,0
30,621,2,2,2,0,0,0,2,0,0,0,0,0,0,0,0,0,0,0,0,2,4,1,17390,7190,1559,12359,1
30,621,99,48,90,1,3,5,100,0,0,0,0,0,0,0,0,0,0,0,0,2,4,1,17390,7191,1559,12360,1
30,621,8,5,5,2,0,1,10,0,0,0,0,0,0,0,0,0,0,0,0,2,4,1,17390,7191,1559,12361,1
30,621,1217,716,841,84,126,174,1301,14,185,118,215,199,333,1446,2542,8,20687,1149,0,2,4,1,17400,7193,1559,12362,1
30,621,160,89,115,0,13,31,160,7,15,11,17,22,28,78,124,3,495,27,0,2,4,1,17400,7193,1559,12363,1
30,621,10,10,9,9,0,0,19,0,0,0,0,0,0,0,0,0,0,0,0,2,4,1,17400,7193,1560,12364,1
30,621,173,84,99,8,29,36,181,5,12,7,13,17,20,54,81,2,221,12,0,2,4,1,17400,7194,1560,12365,1
30,621,3,1,1,3,0,0,6,0,0,0,0,0,0,0,0,0,0,0,0,2,4,1,17400,7194,1560,12366,1
21,767,1455,414,1257,16,76,112,1471,5,41,23,46,46,69,231,381,2,1069,59,0,2,15,5,17400,7195,1560,12367,1
21,767,669,365,481,22,61,110,691,15,103,63,122,118,185,747,1273,8,11311,628,0,2,15,5,17410,7195,1561,12368,1
14,597,1455,414,1257,16,76,112,1471,5,41,23,46,46,69,231,381,2,1069,59,0,2,20,0,17410,7196,1561,12369,1
41,1286,1523,757,1297,19,12,193,1542,12,193,117,230,205,347,1508,2664,7,19053,1058,0,2,2,1,17420,7198,1561,12370,1
41,1286,701,378,504,33,58,109,734,13,110,68,126,123,194,794,1346,7,10027,557,0,2,2,1,17420,7199,1562,12371,1
34,2075,1523,757,1297,19,12,193,1542,12,193,117,230,205,347,1508,2664,7,19053,1058,0,2,19,0,17430,7201,1562,12372,1
41,1749,1513,682,1277,25,13,200,1538,11,199,116,219,210,335,1557,2584,6,15641,868,0,2,12,0,17430,7203,1562,12373,1
21,345,424,94,331,4,0,89,428,1,5,5,5,6,10,11,25,0,12,0,0,2,3,1,17430,7204,1562,12374,1
21,345,38,23,23,6,0,8,44,3,11,7,11,14,18,42,68,1,102,5,0,2,3,1,17430,7204,1562,12375,1
15,464,424,94,331,4,0,89,428,1,5,5,5,6,10,11,25,0,12,0,0,2,23,0,17430,7205,1562,12376,1
72,1496,477,336,357,30,23,73,507,16,194,134,250,210,384,1538,2962,10,30538,1696,0,2,63,34,17440,7206,1562,12377,1
56,985,282,196,195,3,0,86,285,8,130,71,141,138,212,936,1507,4,6538,363,0,2,1,1,17440,7206,1563,12378,1
36,1357,1450,624,1228,12,26,181,1462,14,306,186,354,320,540,2580,4493,8,36391,2021,1,2,31,4,17440,7208,1564,12379,1
12,424,42,7,35,4,0,5,46,1,2,1,2,3,3,2,4,0,2,0,0,2,1,1,17450,7212,1565,12387,1
12,424,11,6,10,0,0,1,11,2,4,2,4,6,6,10,15,1,15,0,0,2,1,1,17450,7212,1565,12388,1
61,2541,1289,550,1043,56,32,155,1345,10,167,93,185,177,278,1266,2075,5,11498,638,0,2,2,0,17450,7214,1566,12389,1
68,1230,1513,682,1277,25,13,200,1538,11,199,116,219,210,335,1557,2584,6,15641,868,0,2,1,2,17450,7216,1566,12390,1
68,1230,819,519,539,24,98,155,843,15,96,57,106,111,163,690,1107,8,9171,509,0,2,1,2,17460,7218,1566,12391,1
42,1312,1523,757,1297,19,12,193,1542,12,193,117,230,205,347,1508,2664,7,19053,1058,0,2,11,6,17470,7220,1566,12392,1
42,1312,701,378,504,33,58,109,734,13,110,68,126,123,194,794,1346,7,10027,557,0,2,11,6,17470,7221,1567,12393,1
36,2201,1523,757,1297,19,12,193,1542,12,193,117,230,205,347,1508,2664,7,19053,1058,0,2,23,1,17480,7223,1567,12394,1
24,565,1293,570,1093,25,15,163,1318,10,195,123,241,205,364,1516,2795,6,17273,959,0,2,11,6,17490,7225,1567,12395,0
68,1230,1513,682,1277,25,13,200,1538,11,199,116,219,210,335,1557,2584,6,15641,868,0,2,1,2,17490,7227,1567,12396,0
68,1230,819,519,539,24,98,155,843,15,96,57,106,111,163,690,1107,8,9171,509,0,2,1,2,17500,7229,1567,12397,0
42,1312,1523,757,1297,19,12,193,1542,12,193,117,230,205,347,1508,2664,7,19053,1058,0,2,11,6,17510,7231,1567,12398,0
42,1312,701,378,504,33,58,109,734,13,110,68,126,123,194,794,1346,7,10027,557,0,2,11,6,17510,7232,1568,12399,0
36,2201,1523,757,1297,19,12,193,1542,12,193,117,230,205,347,1508,2664,7,19053,1058,0,2,23,1,17520,7234,1568,12400,0
52,1027,1020,354,843,12,15,144,1032,8,134,77,144,142,221,970,1580,4,6792,377,0,2,2,2,17520,7234,1568,12401,1
15,473,424,94,331,4,0,89,428,1,5,5,5,6,10,11,25,0,12,0,0,2,4,2,17520,7235,1568,12402,1
68,1230,1513,682,1277,25,13,200,1538,11,199,116,219,210,335,1557,2584,6,15641,868,0,2,1,2,17520,7237,1568,12403,0
68,1230,819,519,539,24,98,155,843,15,96,57,106,111,163,690,1107,8,9171,509,0,2,1,2,17530,7239,1568,12404,0
42,1312,1523,757,1297,19,12,193,1542,12,193,117,230,205,347,1508,2664,7,19053,1058,0,2,11,6,17540,7241,1568,12405,0
42,1312,701,378,504,33,58,109,734,13,110,68,126,123,194,794,1346,7,10027,557,0,2,11,6,17540,7242,1569,12406,0
24,565,1293,570,1093,25,15,163,1318,10,195,123,241,205,364,1516,2795,6,17273,959,0,2,11,6,17550,7244,1569,12407,0
36,2201,1523,757,1297,19,12,193,1542,12,193,117,230,205,347,1508,2664,7,19053,1058,0,2,23,1,17560,7246,1569,12408,0
24,561,1293,570,1093,25,15,163,1318,10,195,123,241,205,364,1516,2795,6,17273,959,0,2,10,9,17570,7248,1569,12409,0
25,575,1293,570,1093,25,15,163,1318,10,195,123,241,205,364,1516,2795,6,17273,959,0,2,8,3,17580,7250,1569,12410,0
26,594,1293,570,1093,25,15,163,1318,10,195,123,241,205,364,1516,2795,6,17273,959,0,2,20,14,17590,7252,1569,12411,1
139,2741,1457,730,1242,11,6,188,1468,10,292,166,329,302,495,2424,4078,5,22973,1276,1,2,8,15,17590,7254,1569,12412,1
139,2741,74,35,59,1,0,14,75,3,14,7,14,17,21,58,85,1,128,7,0,2,8,15,17590,7255,1569,12413,1
139,2741,245,125,200,5,7,34,250,7,30,17,34,37,51,166,265,3,1053,58,0,2,8,15,17600,7256,1569,12414,1
101,4362,139,89,101,2,0,35,141,7,54,34,62,61,96,330,569,4,2287,127,0,2,71,0,17600,7256,1569,12415,1
101,4362,7,5,5,0,0,2,7,1,2,1,2,3,3,2,4,0,2,0,0,2,71,0,17600,7256,1569,12416,1
29,1371,652,304,544,16,6,88,668,6,89,51,101,95,152,591,998,3,3399,188,0,2,12,0,17600,7257,1569,12417,1
56,2548,1943,715,1694,26,18,214,1969,12,185,120,237,197,357,1436,2721,7,20915,1161,0,2,1,1,17600,7259,1569,12418,1
417,8949,72,33,56,0,4,12,72,1,1,1,1,2,2,0,2,0,1,0,0,2,11,6,17610,7263,1570,12426,1
417,8949,1454,835,1044,76,110,219,1530,17,275,158,296,292,454,2297,3718,9,34017,1889,1,2,11,6,17620,7264,1570,12427,1
99,2220,1043,504,840,53,9,147,1096,9,180,112,198,189,310,1377,2344,4,11604,644,0,2,8,0,17620,7266,1570,12428,1
99,2220,383,288,292,26,6,62,409,11,65,38,67,76,105,429,656,5,3719,206,0,2,8,0,17620,7267,1570,12429,1
12,424,42,7,35,4,0,5,46,1,2,1,2,3,3,2,4,0,2,0,0,2,1,1,17620,7267,1570,12430,1
12,424,11,6,10,0,0,1,11,2,4,2,4,6,6,10,15,1,15,0,0,2,1,1,17620,7267,1570,12431,1
13,386,465,148,393,5,8,60,470,4,31,20,31,35,51,161,261,2,523,29,0,2,32,0,17620,7268,1570,12432,1
13,386,16,12,9,0,0,6,16,1,2,1,2,3,3,2,4,0,2,0,0,2,32,0,17620,7268,1570,12433,1
6,493,442,244,305,14,16,103,456,11,68,45,75,79,120,452,756,6,4588,254,0,2,1,0,17620,7270,1570,12434,1
72,1494,477,336,357,30,23,73,507,16,194,134,250,210,384,1538,2962,10,30538,1696,0,2,16,13,17630,7271,1570,12435,1
72,1498,477,336,357,30,23,73,507,16,194,134,250,210,384,1538,2962,10,30538,1696,0,2,1,1,17640,7272,1570,12436,1
37,1394,1450,624,1228,12,26,181,1462,14,306,186,354,320,540,2580,4493,8,36391,2021,1,2,5,0,17640,7274,1571,12437,1
418,8966,72,33,56,0,4,12,72,1,1,1,1,2,2,0,2,0,1,0,0,2,18,13,17640,7274,1571,12438,1
418,8966,1454,835,1044,76,110,219,1530,17,275,158,296,292,454,2297,3718,9,34017,1889,1,2,18,13,17650,7275,1571,12439,1
99,4187,139,89,101,2,0,35,141,7,54,34,62,61,96,330,569,4,2287,127,0,2,14,0,17650,7275,1571,12440,1
99,4187,7,5,5,0,0,2,7,1,2,1,2,3,3,2,4,0,2,0,0,2,14,0,17650,7275,1571,12441,1
37,1396,1450,624,1228,12,26,181,1462,14,306,186,354,320,540,2580,4493,8,36391,2021,1,2,1,1,17650,7277,1572,12442,1
127,3961,1660,832,1314,41,38,274,1701,20,312,209,395,332,604,2671,5058,12,64042,3557,1,2,10,4,17650,7279,1573,12444,0
127,3961,1057,646,719,113,100,145,1170,18,215,134,248,233,382,1740,3004,10,31186,1732,1,2,10,4,17660,7280,1574,12445,0
38,1430,1450,624,1228,12,26,181,1462,14,306,186,354,320,540,2580,4493,8,36391,2021,1,2,14,0,17660,7282,1575,12446,0
12,424,42,7,35,4,0,5,46,1,2,1,2,3,3,2,4,0,2,0,0,2,1,1,17670,7286,1576,12454,1
12,424,11,6,10,0,0,1,11,2,4,2,4,6,6,10,15,1,15,0,0,2,1,1,17670,7286,1576,12455,1
1,224,382,65,130,157,2,92,539,4,10,5,10,14,15,41,57,2,114,6,0,2,1,1,17670,7287,1577,12456,0
12,424,42,7,35,4,0,5,46,1,2,1,2,3,3,2,4,0,2,0,0,2,1,1,17680,7291,1578,12464,1
12,424,11,6,10,0,0,1,11,2,4,2,4,6,6,10,15,1,15,0,0,2,1,1,17680,7291,1578,12465,1
423,9090,72,33,56,0,4,12,72,1,1,1,1,2,2,0,2,0,1,0,0,2,24,1,17690,7295,1579,12473,1
423,9090,1454,835,1044,76,110,219,1530,17,275,158,296,292,454,2297,3718,9,34017,1889,1,2,24,1,17700,7296,1579,12474,1
12,424,42,7,35,4,0,5,46,1,2,1,2,3,3,2,4,0,2,0,0,2,1,1,17700,7296,1579,12475,1
12,424,11,6,10,0,0,1,11,2,4,2,4,6,6,10,15,1,15,0,0,2,1,1,17700,7296,1579,12476,1
104,4340,139,89,101,2,0,35,141,7,54,34,62,61,96,330,569,4,2287,127,0,2,98,0,17700,7296,1579,12477,1
104,4340,7,5,5,0,0,2,7,1,2,1,2,3,3,2,4,0,2,0,0,2,98,0,17700,7296,1579,12478,1
99,2230,1043,504,840,53,9,147,1096,9,180,112,198,189,310,1377,2344,4,11604,644,0,2,1,1,17700,7298,1579,12479,0
99,2230,383,288,292,26,6,62,409,11,65,38,67,76,105,429,656,5,3719,206,0,2,1,1,17700,7299,1579,12480,0
12,424,42,7,35,4,0,5,46,1,2,1,2,3,3,2,4,0,2,0,0,2,1,1,17700,7299,1579,12481,0
12,424,11,6,10,0,0,1,11,2,4,2,4,6,6,10,15,1,15,0,0,2,1,1,17700,7299,1579,12482,0
12,424,42,7,35,4,0,5,46,1,2,1,2,3,3,2,4,0,2,0,0,2,1,1,17710,7303,1580,12490,0
12,424,11,6,10,0,0,1,11,2,4,2,4,6,6,10,15,1,15,0,0,2,1,1,17710,7303,1580,12491,0
84,1473,1178,367,1042,6,15,115,1184,9,94,51,95,103,146,644,976,4,4439,246,0,2,5,1,17720,7307,1581,12499,1
84,1473,177,108,140,8,0,27,185,6,30,16,32,36,48,162,248,3,794,44,0,2,5,1,17720,7309,1581,12500,1
12,424,42,7,35,4,0,5,46,1,2,1,2,3,3,2,4,0,2,0,0,2,1,1,17720,7309,1581,12501,1
12,424,11,6,10,0,0,1,11,2,4,2,4,6,6,10,15,1,15,0,0,2,1,1,17720,7309,1581,12502,1
42,1867,1178,367,1042,6,15,115,1184,9,94,51,95,103,146,644,976,4,4439,246,0,2,41,1,17720,7309,1581,12503,1
12,424,42,7,35,4,0,5,46,1,2,1,2,3,3,2,4,0,2,0,0,2,1,1,17730,7313,1582,12511,0
12,424,11,6,10,0,0,1,11,2,4,2,4,6,6,10,15,1,15,0,0,2,1,1,17730,7313,1582,12512,0
42,1321,1523,757,1297,19,12,193,1542,12,193,117,230,205,347,1508,2664,7,19053,1058,0,2,3,2,17740,7315,1582,12513,1
42,1321,701,378,504,33,58,109,734,13,110,68,126,123,194,794,1346,7,10027,557,0,2,3,2,17740,7316,1583,12514,1
99,2230,1043,504,840,53,9,147,1096,9,180,112,198,189,310,1377,2344,4,11604,644,0,2,2,1,17740,7318,1583,12515,1
99,2230,383,288,292,26,6,62,409,11,65,38,67,76,105,429,656,5,3719,206,0,2,2,1,17740,7319,1583,12516,1
57,2580,1943,715,1694,26,18,214,1969,12,185,120,237,197,357,1436,2721,7,20915,1161,0,2,16,0,17740,7321,1583,12517,1
99,2230,1043,504,840,53,9,147,1096,9,180,112,198,189,310,1377,2344,4,11604,644,0,2,2,1,17740,7323,1583,12518,0
99,2230,383,288,292,26,6,62,409,11,65,38,67,76,105,429,656,5,3719,206,0,2,2,1,17740,7324,1583,12519,0
57,2580,1943,715,1694,26,18,214,1969,12,185,120,237,197,357,1436,2721,7,20915,1161,0,2,16,0,17740,7326,1583,12520,0
37,2246,1523,757,1297,19,12,193,1542,12,193,117,230,205,347,1508,2664,7,19053,1058,0,2,13,0,17750,7328,1583,12521,1
42,1321,1523,757,1297,19,12,193,1542,12,193,117,230,205,347,1508,2664,7,19053,1058,0,2,3,2,17760,7330,1583,12522,0
42,1321,701,378,504,33,58,109,734,13,110,68,126,123,194,794,1346,7,10027,557,0,2,3,2,17760,7331,1584,12523,0
37,2246,1523,757,1297,19,12,193,1542,12,193,117,230,205,347,1508,2664,7,19053,1058,0,2,13,0,17770,7333,1584,12524,0
42,1321,1523,757,1297,19,12,193,1542,12,193,117,230,205,347,1508,2664,7,19053,1058,0,2,3,2,17780,7335,1584,12525,0
42,1321,701,378,504,33,58,109,734,13,110,68,126,123,194,794,1346,7,10027,557,0,2,3,2,17780,7336,1585,12526,0
37,2246,1523,757,1297,19,12,193,1542,12,193,117,230,205,347,1508,2664,7,19053,1058,0,2,13,0,17790,7338,1585,12527,0
12,222,127,75,83,2,11,30,129,4,14,7,14,18,21,61,87,2,175,9,0,2,1,1,17790,7338,1585,12528,0
12,222,652,304,544,16,6,88,668,6,89,51,101,95,152,591,998,3,3399,188,0,2,1,1,17790,7339,1585,12529,0
12,222,2,2,2,0,0,0,2,0,0,0,0,0,0,0,0,0,0,0,0,2,1,1,17790,7339,1585,12529,0
12,222,8,5,5,0,0,3,8,0,0,0,0,0,0,0,0,0,0,0,0,2,1,1,17790,7339,1585,12530,0
12,222,2,2,2,0,0,0,2,0,0,0,0,0,0,0,0,0,0,0,0,2,1,1,17790,7339,1585,12530,0
12,222,14,8,8,0,0,6,14,0,0,0,0,0,0,0,0,0,0,0,0,2,1,1,17790,7339,1585,12531,0
12,222,6,4,4,0,0,2,6,0,0,0,0,0,0,0,0,0,0,0,0,2,1,1,17790,7339,1585,12532,0
12,222,6,4,4,0,0,2,6,1,2,1,2,3,3,2,4,0,2,0,0,2,1,1,17790,7339,1585,12533,0
12,222,6,4,4,0,0,2,6,0,0,0,0,0,0,0,0,0,0,0,0,2,1,1,17790,7339,1585,12534,0
12,222,7,5,5,0,0,2,7,0,0,0,0,0,0,0,0,0,0,0,0,2,1,1,17790,7339,1585,12535,0
12,222,6,4,4,0,0,2,6,0,0,0,0,0,0,0,0,0,0,0,0,2,1,1,17790,7339,1585,12536,0
12,222,10,6,6,0,0,4,10,0,0,0,0,0,0,0,0,0,0,0,0,2,1,1,17790,7339,1585,12537,0
12,222,1,1,1,0,0,0,1,0,0,0,0,0,0,0,0,0,0,0,0,2,1,1,17790,7339,1585,12537,0
12,222,14,10,10,0,0,4,14,1,1,1,1,2,2,0,2,0,1,0,0,2,1,1,17790,7339,1585,12538,0
12,222,46,26,30,3,0,12,49,3,6,3,6,9,9,20,28,1,42,2,0,2,1,1,17800,7339,1585,12539,0
427,9239,72,33,56,0,4,12,72,1,1,1,1,2,2,0,2,0,1,0,0,2,21,2,17800,7339,1585,12540,1
427,9239,1454,835,1044,76,110,219,1530,17,275,158,296,292,454,2297,3718,9,34017,1889,1,2,21,2,17810,7340,1585,12541,1
51,2975,1782,648,1425,9,47,279,1791,8,171,97,189,179,286,1292,2140,4,9462,525,0,2,171,0,17810,7341,1586,12542,1
12,222,127,75,83,2,11,30,129,4,14,7,14,18,21,61,87,2,175,9,0,2,1,1,17810,7341,1586,12543,0
12,222,652,304,544,16,6,88,668,6,89,51,101,95,152,591,998,3,3399,188,0,2,1,1,17810,7342,1586,12544,0
12,222,2,2,2,0,0,0,2,0,0,0,0,0,0,0,0,0,0,0,0,2,1,1,17810,7342,1586,12544,0
12,222,8,5,5,0,0,3,8,0,0,0,0,0,0,0,0,0,0,0,0,2,1,1,17810,7342,1586,12545,0
12,222,2,2,2,0,0,0,2,0,0,0,0,0,0,0,0,0,0,0,0,2,1,1,17810,7342,1586,12545,0
12,222,14,8,8,0,0,6,14,0,0,0,0,0,0,0,0,0,0,0,0,2,1,1,17810,7342,1586,12546,0
12,222,6,4,4,0,0,2,6,0,0,0,0,0,0,0,0,0,0,0,0,2,1,1,17810,7342,1586,12547,0
12,222,6,4,4,0,0,2,6,1,2,1,2,3,3,2,4,0,2,0,0,2,1,1,17810,7342,1586,12548,0
12,222,6,4,4,0,0,2,6,0,0,0,0,0,0,0,0,0,0,0,0,2,1,1,17810,7342,1586,12549,0
12,222,7,5,5,0,0,2,7,0,0,0,0,0,0,0,0,0,0,0,0,2,1,1,17810,7342,1586,12550,0
12,222,6,4,4,0,0,2,6,0,0,0,0,0,0,0,0,0,0,0,0,2,1,1,17810,7342,1586,12551,0
12,222,10,6,6,0,0,4,10,0,0,0,0,0,0,0,0,0,0,0,0,2,1,1,17810,7342,1586,12552,0
12,222,1,1,1,0,0,0,1,0,0,0,0,0,0,0,0,0,0,0,0,2,1,1,17810,7342,1586,12552,0
12,222,14,10,10,0,0,4,14,1,1,1,1,2,2,0,2,0,1,0,0,2,1,1,17810,7342,1586,12553,0
12,222,46,26,30,3,0,12,49,3,6,3,6,9,9,20,28,1,42,2,0,2,1,1,17820,7342,1586,12554,0
25,860,1455,414,1257,16,76,112,1471,5,41,23,46,46,69,231,381,2,1069,59,0,2,19,7,17820,7343,1586,12555,1
25,860,669,365,481,22,61,110,691,15,103,63,122,118,185,747,1273,8,11311,628,0,2,19,7,17830,7343,1587,12556,1
22,919,1455,414,1257,16,76,112,1471,5,41,23,46,46,69,231,381,2,1069,59,0,2,95,3,17830,7344,1587,12557,1
425,9242,72,33,56,0,4,12,72,1,1,1,1,2,2,0,2,0,1,0,0,2,13,10,17830,7344,1587,12558,1
425,9242,1454,835,1044,76,110,219,1530,17,275,158,296,292,454,2297,3718,9,34017,1889,1,2,13,10,17840,7345,1587,12559,1
51,2929,1782,648,1425,9,47,279,1791,8,171,97,189,179,286,1292,2140,4,9462,525,0,2,72,60,17840,7346,1588,12560,1
12,222,127,75,83,2,11,30,129,4,14,7,14,18,21,61,87,2,175,9,0,2,1,1,17840,7346,1588,12561,0
12,222,652,304,544,16,6,88,668,6,89,51,101,95,152,591,998,3,3399,188,0,2,1,1,17840,7347,1588,12562,0
12,222,2,2,2,0,0,0,2,0,0,0,0,0,0,0,0,0,0,0,0,2,1,1,17840,7347,1588,12562,0
12,222,8,5,5,0,0,3,8,0,0,0,0,0,0,0,0,0,0,0,0,2,1,1,17840,7347,1588,12563,0
12,222,2,2,2,0,0,0,2,0,0,0,0,0,0,0,0,0,0,0,0,2,1,1,17840,7347,1588,12563,0
12,222,14,8,8,0,0,6,14,0,0,0,0,0,0,0,0,0,0,0,0,2,1,1,17840,7347,1588,12564,0
12,222,6,4,4,0,0,2,6,0,0,0,0,0,0,0,0,0,0,0,0,2,1,1,17840,7347,1588,12565,0
12,222,6,4,4,0,0,2,6,1,2,1,2,3,3,2,4,0,2,0,0,2,1,1,17840,7347,1588,12566,0
12,222,6,4,4,0,0,2,6,0,0,0,0,0,0,0,0,0,0,0,0,2,1,1,17840,7347,1588,12567,0
12,222,7,5,5,0,0,2,7,0,0,0,0,0,0,0,0,0,0,0,0,2,1,1,17840,7347,1588,12568,0
12,222,6,4,4,0,0,2,6,0,0,0,0,0,0,0,0,0,0,0,0,2,1,1,17840,7347,1588,12569,0
12,222,10,6,6,0,0,4,10,0,0,0,0,0,0,0,0,0,0,0,0,2,1,1,17840,7347,1588,12570,0
12,222,1,1,1,0,0,0,1,0,0,0,0,0,0,0,0,0,0,0,0,2,1,1,17840,7347,1588,12570,0
12,222,14,10,10,0,0,4,14,1,1,1,1,2,2,0,2,0,1,0,0,2,1,1,17840,7347,1588,12571,0
12,222,46,26,30,3,0,12,49,3,6,3,6,9,9,20,28,1,42,2,0,2,1,1,17850,7347,1588,12572,0
164,3702,77,34,69,0,0,8,77,3,24,16,29,27,45,114,213,1,387,21,0,2,12,0,17850,7347,1588,12573,1
164,3702,712,438,573,51,9,84,763,14,102,71,128,116,199,733,1364,8,11988,666,0,2,12,0,17860,7348,1588,12574,1
60,1138,1020,354,843,12,15,144,1032,8,134,77,144,142,221,970,1580,4,6792,377,0,2,92,32,17860,7348,1588,12575,1
42,1846,1020,354,843,12,15,144,1032,8,134,77,144,142,221,970,1580,4,6792,377,0,2,1,2,17860,7348,1588,12576,1
25,860,1455,414,1257,16,76,112,1471,5,41,23,46,46,69,231,381,2,1069,59,0,2,19,7,17860,7349,1588,12577,0
25,860,669,365,481,22,61,110,691,15,103,63,122,118,185,747,1273,8,11311,628,0,2,19,7,17870,7349,1589,12578,0
22,919,1455,414,1257,16,76,112,1471,5,41,23,46,46,69,231,381,2,1069,59,0,2,95,3,17870,7350,1589,12579,0
60,1138,1020,354,843,12,15,144,1032,8,134,77,144,142,221,970,1580,4,6792,377,0,2,1,1,17870,7350,1589,12580,1
425,9242,72,33,56,0,4,12,72,1,1,1,1,2,2,0,2,0,1,0,0,2,24,2,17870,7350,1589,12581,0
425,9242,1454,835,1044,76,110,219,1530,17,275,158,296,292,454,2297,3718,9,34017,1889,1,2,24,2,17880,7351,1589,12582,0
51,2929,1782,648,1425,9,47,279,1791,8,171,97,189,179,286,1292,2140,4,9462,525,0,2,183,0,17880,7352,1590,12583,0
425,9235,72,33,56,0,4,12,72,1,1,1,1,2,2,0,2,0,1,0,0,2,17,16,17880,7352,1590,12584,1
425,9235,1454,835,1044,76,110,219,1530,17,275,158,296,292,454,2297,3718,9,34017,1889,1,2,17,16,17890,7353,1590,12585,1
51,2930,1782,648,1425,9,47,279,1791,8,171,97,189,179,286,1292,2140,4,9462,525,0,2,3,3,17890,7354,1591,12586,1
44,1923,1020,354,843,12,15,144,1032,8,134,77,144,142,221,970,1580,4,6792,377,0,2,18,0,17890,7354,1591,12587,0
45,2010,1020,354,843,12,15,144,1032,8,134,77,144,142,221,970,1580,4,6792,377,0,2,20,1,17890,7354,1591,12588,0
59,1130,1020,354,843,12,15,144,1032,8,134,77,144,142,221,970,1580,4,6792,377,0,2,1,1,17890,7354,1591,12589,1
164,3702,77,34,69,0,0,8,77,3,24,16,29,27,45,114,213,1,387,21,0,2,5,6,17890,7354,1591,12590,1
164,3702,712,438,573,51,9,84,763,14,102,71,128,116,199,733,1364,8,11988,666,0,2,5,6,17900,7355,1591,12591,1
59,1132,1020,354,843,12,15,144,1032,8,134,77,144,142,221,970,1580,4,6792,377,0,2,8,8,17900,7355,1591,12592,1
45,2010,1020,354,843,12,15,144,1032,8,134,77,144,142,221,970,1580,4,6792,377,0,2,1,1,17900,7355,1591,12593,1
164,3702,77,34,69,0,0,8,77,3,24,16,29,27,45,114,213,1,387,21,0,2,11,0,17900,7355,1591,12594,0
164,3702,712,438,573,51,9,84,763,14,102,71,128,116,199,733,1364,8,11988,666,0,2,11,0,17910,7356,1591,12595,0
59,1132,1020,354,843,12,15,144,1032,8,134,77,144,142,221,970,1580,4,6792,377,0,2,91,31,17910,7356,1591,12596,0
45,2010,1020,354,843,12,15,144,1032,8,134,77,144,142,221,970,1580,4,6792,377,0,2,38,2,17910,7356,1591,12597,0
59,1132,1020,354,843,12,15,144,1032,8,134,77,144,142,221,970,1580,4,6792,377,0,2,1,1,17910,7356,1591,12598,0
428,9261,72,33,56,0,4,12,72,1,1,1,1,2,2,0,2,0,1,0,0,2,4,2,17920,7360,1592,12606,1
428,9261,1454,835,1044,76,110,219,1530,17,275,158,296,292,454,2297,3718,9,34017,1889,1,2,4,2,17930,7361,1592,12607,1
12,424,42,7,35,4,0,5,46,1,2,1,2,3,3,2,4,0,2,0,0,2,1,1,17930,7361,1592,12608,1
12,424,11,6,10,0,0,1,11,2,4,2,4,6,6,10,15,1,15,0,0,2,1,1,17930,7361,1592,12609,1
52,2959,1782,648,1425,9,47,279,1791,8,171,97,189,179,286,1292,2140,4,9462,525,0,2,10,0,17930,7362,1593,12610,1
128,3970,1660,832,1314,41,38,274,1701,20,312,209,395,332,604,2671,5058,12,64042,3557,1,2,4,0,17930,7364,1594,12612,1
128,3970,1057,646,719,113,100,145,1170,18,215,134,248,233,382,1740,3004,10,31186,1732,1,2,4,0,17940,7365,1595,12613,1
106,2462,1660,832,1314,41,38,274,1701,20,312,209,395,332,604,2671,5058,12,64042,3557,1,2,18,1,17940,7367,1596,12615,1
430,9299,72,33,56,0,4,12,72,1,1,1,1,2,2,0,2,0,1,0,0,2,5,1,17940,7367,1596,12616,1
430,9299,1454,835,1044,76,110,219,1530,17,275,158,296,292,454,2297,3718,9,34017,1889,1,2,5,1,17950,7368,1596,12617,1
55,3168,1782,648,1425,9,47,279,1791,8,171,97,189,179,286,1292,2140,4,9462,525,0,2,30,2,17950,7369,1597,12618,1
106,2462,1660,832,1314,41,38,274,1701,20,312,209,395,332,604,2671,5058,12,64042,3557,1,2,13,13,17950,7371,1598,12620,0
128,3970,1660,832,1314,41,38,274,1701,20,312,209,395,332,604,2671,5058,12,64042,3557,1,2,4,0,17950,7373,1599,12622,0
128,3970,1057,646,719,113,100,145,1170,18,215,134,248,233,382,1740,3004,10,31186,1732,1,2,4,0,17960,7374,1600,12623,0
106,2462,1660,832,1314,41,38,274,1701,20,312,209,395,332,604,2671,5058,12,64042,3557,1,2,29,12,17960,7376,1601,12625,0
164,3720,77,34,69,0,0,8,77,3,24,16,29,27,45,114,213,1,387,21,0,2,2,0,17960,7376,1601,12626,1
164,3720,712,438,573,51,9,84,763,14,102,71,128,116,199,733,1364,8,11988,666,0,2,2,0,17970,7377,1601,12627,1
24,972,373,158,315,8,0,51,381,5,76,44,79,81,123,486,779,2,2026,112,0,2,14,0,17970,7377,1601,12628,1
430,9291,72,33,56,0,4,12,72,1,1,1,1,2,2,0,2,0,1,0,0,2,6,2,17970,7377,1601,12629,1
430,9291,1454,835,1044,76,110,219,1530,17,275,158,296,292,454,2297,3718,9,34017,1889,1,2,6,2,17980,7378,1601,12630,1
30,1144,1098,241,925,5,10,155,1103,7,46,25,49,53,74,273,423,3,1580,87,0,2,22,0,17990,7380,1601,12631,1
30,1144,1098,241,925,5,10,155,1103,7,46,25,49,53,74,273,423,3,1580,87,0,2,2,2,18000,7382,1601,12632,0
12,424,42,7,35,4,0,5,46,1,2,1,2,3,3,2,4,0,2,0,0,2,1,1,18010,7386,1602,12640,1
12,424,11,6,10,0,0,1,11,2,4,2,4,6,6,10,15,1,15,0,0,2,1,1,18010,7386,1602,12641,1
430,9291,72,33,56,0,4,12,72,1,1,1,1,2,2,0,2,0,1,0,0,2,15,13,18010,7386,1602,12642,1
430,9291,1454,835,1044,76,110,219,1530,17,275,158,296,292,454,2297,3718,9,34017,1889,1,2,15,13,18020,7387,1602,12643,1
430,9303,72,33,56,0,4,12,72,1,1,1,1,2,2,0,2,0,1,0,0,2,9,1,18030,7391,1603,12651,1
430,9303,1454,835,1044,76,110,219,1530,17,275,158,296,292,454,2297,3718,9,34017,1889,1,2,9,1,18040,7392,1603,12652,1
12,424,42,7,35,4,0,5,46,1,2,1,2,3,3,2,4,0,2,0,0,2,1,1,18040,7392,1603,12653,1
12,424,11,6,10,0,0,1,11,2,4,2,4,6,6,10,15,1,15,0,0,2,1,1,18040,7392,1603,12654,1
53,2989,1782,648,1425,9,47,279,1791,8,171,97,189,179,286,1292,2140,4,9462,525,0,2,14,0,18040,7393,1604,12655,1
157,3128,1943,715,1694,26,18,214,1969,12,185,120,237,197,357,1436,2721,7,20915,1161,0,2,6,2,18040,7395,1604,12656,0
157,3128,1168,838,957,57,25,144,1225,19,348,224,416,367,640,3018,5452,11,61921,3440,1,2,6,2,18050,7397,1604,12657,0
128,3970,1660,832,1314,41,38,274,1701,20,312,209,395,332,604,2671,5058,12,64042,3557,1,2,14,4,18060,7403,1606,12666,0
128,3970,1057,646,719,113,100,145,1170,18,215,134,248,233,382,1740,3004,10,31186,1732,1,2,14,4,18070,7404,1607,12667,0
72,1498,477,336,357,30,23,73,507,16,194,134,250,210,384,1538,2962,10,30538,1696,0,2,17,14,18080,7405,1607,12668,0
25,860,1455,414,1257,16,76,112,1471,5,41,23,46,46,69,231,381,2,1069,59,0,2,19,7,18080,7406,1607,12669,0
25,860,669,365,481,22,61,110,691,15,103,63,122,118,185,747,1273,8,11311,628,0,2,19,7,18090,7406,1608,12670,0
42,1321,1523,757,1297,19,12,193,1542,12,193,117,230,205,347,1508,2664,7,19053,1058,0,2,3,2,18100,7408,1608,12671,0
42,1321,701,378,504,33,58,109,734,13,110,68,126,123,194,794,1346,7,10027,557,0,2,3,2,18100,7409,1609,12672,0
164,3720,77,34,69,0,0,8,77,3,24,16,29,27,45,114,213,1,387,21,0,2,13,0,18100,7409,1609,12673,0
164,3720,712,438,573,51,9,84,763,14,102,71,128,116,199,733,1364,8,11988,666,0,2,13,0,18110,7410,1609,12674,0
59,1132,1020,354,843,12,15,144,1032,8,134,77,144,142,221,970,1580,4,6792,377,0,2,91,31,18110,7410,1609,12675,0
430,9303,72,33,56,0,4,12,72,1,1,1,1,2,2,0,2,0,1,0,0,2,116,44,18110,7410,1609,12676,0
430,9303,1454,835,1044,76,110,219,1530,17,275,158,296,292,454,2297,3718,9,34017,1889,1,2,116,44,18120,7411,1609,12677,0
99,2230,1043,504,840,53,9,147,1096,9,180,112,198,189,310,1377,2344,4,11604,644,0,2,10,1,18120,7413,1609,12678,0
99,2230,383,288,292,26,6,62,409,11,65,38,67,76,105,429,656,5,3719,206,0,2,10,1,18120,7414,1609,12679,0
84,1473,1178,367,1042,6,15,115,1184,9,94,51,95,103,146,644,976,4,4439,246,0,2,5,1,18120,7414,1609,12680,0
84,1473,177,108,140,8,0,27,185,6,30,16,32,36,48,162,248,3,794,44,0,2,5,1,18120,7416,1609,12681,0
157,3128,1943,715,1694,26,18,214,1969,12,185,120,237,197,357,1436,2721,7,20915,1161,0,2,6,2,18120,7418,1609,12682,0
157,3128,1168,838,957,57,25,144,1225,19,348,224,416,367,640,3018,5452,11,61921,3440,1,2,6,2,18130,7420,1609,12683,0
1,224,382,65,130,157,2,92,539,4,10,5,10,14,15,41,57,2,114,6,0,2,1,1,18130,7421,1610,12684,0
12,222,127,75,83,2,11,30,129,4,14,7,14,18,21,61,87,2,175,9,0,2,1,1,18130,7421,1610,12685,0
12,222,652,304,544,16,6,88,668,6,89,51,101,95,152,591,998,3,3399,188,0,2,1,1,18130,7422,1610,12686,0
12,222,2,2,2,0,0,0,2,0,0,0,0,0,0,0,0,0,0,0,0,2,1,1,18130,7422,1610,12686,0
12,222,8,5,5,0,0,3,8,0,0,0,0,0,0,0,0,0,0,0,0,2,1,1,18130,7422,1610,12687,0
12,222,2,2,2,0,0,0,2,0,0,0,0,0,0,0,0,0,0,0,0,2,1,1,18130,7422,1610,12687,0
12,222,14,8,8,0,0,6,14,0,0,0,0,0,0,0,0,0,0,0,0,2,1,1,18130,7422,1610,12688,0
12,222,6,4,4,0,0,2,6,0,0,0,0,0,0,0,0,0,0,0,0,2,1,1,18130,7422,1610,12689,0
12,222,6,4,4,0,0,2,6,1,2,1,2,3,3,2,4,0,2,0,0,2,1,1,18130,7422,1610,12690,0
12,222,6,4,4,0,0,2,6,0,0,0,0,0,0,0,0,0,0,0,0,2,1,1,18130,7422,1610,12691,0
12,222,7,5,5,0,0,2,7,0,0,0,0,0,0,0,0,0,0,0,0,2,1,1,18130,7422,1610,12692,0
12,222,6,4,4,0,0,2,6,0,0,0,0,0,0,0,0,0,0,0,0,2,1,1,18130,7422,1610,12693,0
12,222,10,6,6,0,0,4,10,0,0,0,0,0,0,0,0,0,0,0,0,2,1,1,18130,7422,1610,12694,0
12,222,1,1,1,0,0,0,1,0,0,0,0,0,0,0,0,0,0,0,0,2,1,1,18130,7422,1610,12694,0
12,222,14,10,10,0,0,4,14,1,1,1,1,2,2,0,2,0,1,0,0,2,1,1,18130,7422,1610,12695,0
12,222,46,26,30,3,0,12,49,3,6,3,6,9,9,20,28,1,42,2,0,2,1,1,18140,7422,1610,12696,0
12,424,42,7,35,4,0,5,46,1,2,1,2,3,3,2,4,0,2,0,0,2,2,2,18140,7422,1610,12697,0
12,424,11,6,10,0,0,1,11,2,4,2,4,6,6,10,15,1,15,0,0,2,2,2,18140,7422,1610,12698,0
107,4544,139,89,101,2,0,35,141,7,54,34,62,61,96,330,569,4,2287,127,0,2,112,0,18140,7422,1610,12699,0
107,4544,7,5,5,0,0,2,7,1,2,1,2,3,3,2,4,0,2,0,0,2,112,0,18140,7422,1610,12700,0
13,386,465,148,393,5,8,60,470,4,31,20,31,35,51,161,261,2,523,29,0,2,32,0,18140,7423,1610,12701,0
13,386,16,12,9,0,0,6,16,1,2,1,2,3,3,2,4,0,2,0,0,2,32,0,18140,7423,1610,12702,0
53,2989,1782,648,1425,9,47,279,1791,8,171,97,189,179,286,1292,2140,4,9462,525,0,2,207,0,18140,7424,1611,12703,0
38,1430,1450,624,1228,12,26,181,1462,14,306,186,354,320,540,2580,4493,8,36391,2021,1,2,19,0,18140,7426,1612,12704,0
106,2462,1660,832,1314,41,38,274,1701,20,312,209,395,332,604,2671,5058,12,64042,3557,1,2,29,12,18140,7428,1613,12706,0
22,919,1455,414,1257,16,76,112,1471,5,41,23,46,46,69,231,381,2,1069,59,0,2,95,3,18140,7429,1613,12707,0
37,2246,1523,757,1297,19,12,193,1542,12,193,117,230,205,347,1508,2664,7,19053,1058,0,2,13,0,18150,7431,1613,12708,0
45,2010,1020,354,843,12,15,144,1032,8,134,77,144,142,221,970,1580,4,6792,377,0,2,38,2,18150,7431,1613,12709,0
24,972,373,158,315,8,0,51,381,5,76,44,79,81,123,486,779,2,2026,112,0,2,14,0,18150,7431,1613,12710,0
42,1867,1178,367,1042,6,15,115,1184,9,94,51,95,103,146,644,976,4,4439,246,0,2,41,1,18150,7431,1613,12711,0
57,2580,1943,715,1694,26,18,214,1969,12,185,120,237,197,357,1436,2721,7,20915,1161,0,2,16,0,18150,7433,1613,12712,0
6,493,442,244,305,14,16,103,456,11,68,45,75,79,120,452,756,6,4588,254,0,2,1,0,18150,7435,1613,12713,0
30,1144,1098,241,925,5,10,155,1103,7,46,25,49,53,74,273,423,3,1580,87,0,2,22,0,18160,7437,1613,12714,0
29,1369,652,304,544,16,6,88,668,6,89,51,101,95,152,591,998,3,3399,188,0,2,0,1,18160,7438,1613,12715,0
1,224,382,65,130,157,2,92,539,4,10,5,10,14,15,41,57,2,114,6,0,2,1,1,18160,7439,1614,12716,0
159,3155,1943,715,1694,26,18,214,1969,12,185,120,237,197,357,1436,2721,7,20915,1161,0,2,13,9,18160,7441,1614,12717,1
159,3155,1168,838,957,57,25,144,1225,19,348,224,416,367,640,3018,5452,11,61921,3440,1,2,13,9,18170,7443,1614,12718,1
58,2641,1943,715,1694,26,18,214,1969,12,185,120,237,197,357,1436,2721,7,20915,1161,0,2,16,5,18170,7445,1614,12719,1
139,2741,1457,730,1242,11,6,188,1468,10,292,166,329,302,495,2424,4078,5,22973,1276,1,2,8,15,18170,7447,1614,12720,0
139,2741,74,35,59,1,0,14,75,3,14,7,14,17,21,58,85,1,128,7,0,2,8,15,18170,7448,1614,12721,0
139,2741,245,125,200,5,7,34,250,7,30,17,34,37,51,166,265,3,1053,58,0,2,8,15,18180,7449,1614,12722,0
107,4544,139,89,101,2,0,35,141,7,54,34,62,61,96,330,569,4,2287,127,0,2,71,0,18180,7449,1614,12723,0
107,4544,7,5,5,0,0,2,7,1,2,1,2,3,3,2,4,0,2,0,0,2,71,0,18180,7449,1614,12724,0
29,1369,652,304,544,16,6,88,668,6,89,51,101,95,152,591,998,3,3399,188,0,2,11,0,18180,7450,1614,12725,0
58,2641,1943,715,1694,26,18,214,1969,12,185,120,237,197,357,1436,2721,7,20915,1161,0,2,1,1,18180,7452,1614,12726,0
159,3155,1943,715,1694,26,18,214,1969,12,185,120,237,197,357,1436,2721,7,20915,1161,0,2,13,9,18180,7454,1614,12727,0
159,3155,1168,838,957,57,25,144,1225,19,348,224,416,367,640,3018,5452,11,61921,3440,1,2,13,9,18190,7456,1614,12728,0
58,2641,1943,715,1694,26,18,214,1969,12,185,120,237,197,357,1436,2721,7,20915,1161,0,2,16,5,18190,7458,1614,12729,0
159,3155,1943,715,1694,26,18,214,1969,12,185,120,237,197,357,1436,2721,7,20915,1161,0,2,13,9,18190,7460,1614,12730,0
159,3155,1168,838,957,57,25,144,1225,19,348,224,416,367,640,3018,5452,11,61921,3440,1,2,13,9,18200,7462,1614,12731,0
58,2641,1943,715,1694,26,18,214,1969,12,185,120,237,197,357,1436,2721,7,20915,1161,0,2,16,5,18200,7464,1614,12732,0
432,9349,72,33,56,0,4,12,72,1,1,1,1,2,2,0,2,0,1,0,0,2,16,7,18200,7464,1614,12733,1
432,9349,1454,835,1044,76,110,219,1530,17,275,158,296,292,454,2297,3718,9,34017,1889,1,2,16,7,18210,7465,1614,12734,1
108,4591,139,89,101,2,0,35,141,7,54,34,62,61,96,330,569,4,2287,127,0,2,25,0,18210,7465,1614,12735,1
108,4591,7,5,5,0,0,2,7,1,2,1,2,3,3,2,4,0,2,0,0,2,25,0,18210,7465,1614,12736,1
128,3964,1660,832,1314,41,38,274,1701,20,312,209,395,332,604,2671,5058,12,64042,3557,1,2,2,8,18210,7467,1615,12738,1
128,3964,1057,646,719,113,100,145,1170,18,215,134,248,233,382,1740,3004,10,31186,1732,1,2,2,8,18220,7468,1616,12739,1
43,1919,1178,367,1042,6,15,115,1184,9,94,51,95,103,146,644,976,4,4439,246,0,2,12,0,18220,7468,1616,12740,1
43,1919,1178,367,1042,6,15,115,1184,9,94,51,95,103,146,644,976,4,4439,246,0,2,12,0,18220,7468,1616,12741,0
432,9350,72,33,56,0,4,12,72,1,1,1,1,2,2,0,2,0,1,0,0,2,2,1,18220,7468,1616,12742,1
432,9350,1454,835,1044,76,110,219,1530,17,275,158,296,292,454,2297,3718,9,34017,1889,1,2,2,1,18230,7469,1616,12743,1
108,4591,139,89,101,2,0,35,141,7,54,34,62,61,96,330,569,4,2287,127,0,2,3,3,18230,7469,1616,12744,1
108,4591,7,5,5,0,0,2,7,1,2,1,2,3,3,2,4,0,2,0,0,2,3,3,18230,7469,1616,12745,1
432,9350,72,33,56,0,4,12,72,1,1,1,1,2,2,0,2,0,1,0,0,2,2,1,18230,7469,1616,12746,0
432,9350,1454,835,1044,76,110,219,1530,17,275,158,296,292,454,2297,3718,9,34017,1889,1,2,2,1,18240,7470,1616,12747,0
108,4591,139,89,101,2,0,35,141,7,54,34,62,61,96,330,569,4,2287,127,0,2,3,3,18240,7470,1616,12748,0
108,4591,7,5,5,0,0,2,7,1,2,1,2,3,3,2,4,0,2,0,0,2,3,3,18240,7470,1616,12749,0
43,1913,1178,367,1042,6,15,115,1184,9,94,51,95,103,146,644,976,4,4439,246,0,2,1,2,18240,7470,1616,12750,1
43,1913,1178,367,1042,6,15,115,1184,9,94,51,95,103,146,644,976,4,4439,246,0,2,1,2,18240,7470,1616,12751,0
434,9388,72,33,56,0,4,12,72,1,1,1,1,2,2,0,2,0,1,0,0,2,5,1,18240,7470,1616,12752,0
434,9388,1454,835,1044,76,110,219,1530,17,275,158,296,292,454,2297,3718,9,34017,1889,1,2,5,1,18250,7471,1616,12753,0
56,3198,1782,648,1425,9,47,279,1791,8,171,97,189,179,286,1292,2140,4,9462,525,0,2,30,2,18250,7472,1617,12754,0
434,9388,72,33,56,0,4,12,72,1,1,1,1,2,2,0,2,0,1,0,0,2,5,1,18250,7472,1617,12755,0
434,9388,1454,835,1044,76,110,219,1530,17,275,158,296,292,454,2297,3718,9,34017,1889,1,2,5,1,18260,7473,1617,12756,0
56,3198,1782,648,1425,9,47,279,1791,8,171,97,189,179,286,1292,2140,4,9462,525,0,2,30,2,18260,7474,1618,12757,0
434,9390,72,33,56,0,4,12,72,1,1,1,1,2,2,0,2,0,1,0,0,2,2,1,18270,7478,1619,12765,1
434,9390,1454,835,1044,76,110,219,1530,17,275,158,296,292,454,2297,3718,9,34017,1889,1,2,2,1,18280,7479,1619,12766,1
12,424,42,7,35,4,0,5,46,1,2,1,2,3,3,2,4,0,2,0,0,2,1,1,18280,7479,1619,12767,1
12,424,11,6,10,0,0,1,11,2,4,2,4,6,6,10,15,1,15,0,0,2,1,1,18280,7479,1619,12768,1
56,3203,1782,648,1425,9,47,279,1791,8,171,97,189,179,286,1292,2140,4,9462,525,0,2,5,5,18280,7480,1620,12769,1
160,3161,1943,715,1694,26,18,214,1969,12,185,120,237,197,357,1436,2721,7,20915,1161,0,2,1,1,18280,7482,1620,12770,0
160,3161,1168,838,957,57,25,144,1225,19,348,224,416,367,640,3018,5452,11,61921,3440,1,2,1,1,18290,7484,1620,12771,0
435,9394,72,33,56,0,4,12,72,1,1,1,1,2,2,0,2,0,1,0,0,2,15,9,18300,7488,1621,12779,1
435,9394,1454,835,1044,76,110,219,1530,17,275,158,296,292,454,2297,3718,9,34017,1889,1,2,15,9,18310,7489,1621,12780,1
12,424,42,7,35,4,0,5,46,1,2,1,2,3,3,2,4,0,2,0,0,2,1,1,18310,7489,1621,12781,1
12,424,11,6,10,0,0,1,11,2,4,2,4,6,6,10,15,1,15,0,0,2,1,1,18310,7489,1621,12782,1
110,4667,139,89,101,2,0,35,141,7,54,34,62,61,96,330,569,4,2287,127,0,2,33,0,18310,7489,1621,12783,1
110,4667,7,5,5,0,0,2,7,1,2,1,2,3,3,2,4,0,2,0,0,2,33,0,18310,7489,1621,12784,1
12,424,42,7,35,4,0,5,46,1,2,1,2,3,3,2,4,0,2,0,0,2,1,1,18320,7493,1622,12792,1
12,424,11,6,10,0,0,1,11,2,4,2,4,6,6,10,15,1,15,0,0,2,1,1,18320,7493,1622,12793,1
68,1226,1513,682,1277,25,13,200,1538,11,199,116,219,210,335,1557,2584,6,15641,868,0,2,1,1,18320,7495,1622,12794,1
68,1226,819,519,539,24,98,155,843,15,96,57,106,111,163,690,1107,8,9171,509,0,2,1,1,18330,7497,1622,12795,1
172,3366,1457,730,1242,11,6,188,1468,10,292,166,329,302,495,2424,4078,5,22973,1276,1,2,144,11,18330,7499,1622,12796,1
172,3366,74,35,59,1,0,14,75,3,14,7,14,17,21,58,85,1,128,7,0,2,144,11,18330,7500,1622,12797,1
172,3366,245,125,200,5,7,34,250,7,30,17,34,37,51,166,265,3,1053,58,0,2,144,11,18340,7501,1622,12798,1
42,1131,74,35,59,1,0,14,75,3,14,7,14,17,21,58,85,1,128,7,0,2,1,0,18340,7502,1622,12799,1
42,1131,245,125,200,5,7,34,250,7,30,17,34,37,51,166,265,3,1053,58,0,2,1,0,18350,7503,1622,12800,1
43,415,647,139,84,35,284,233,682,0,0,0,0,0,0,0,0,0,0,0,0,2,1,1,18350,7503,1622,12801,1
164,3720,77,34,69,0,0,8,77,3,24,16,29,27,45,114,213,1,387,21,0,2,1,1,18350,7503,1622,12802,1
164,3720,712,438,573,51,9,84,763,14,102,71,128,116,199,733,1364,8,11988,666,0,2,1,1,18360,7504,1622,12803,1
14,453,184,100,137,2,15,30,186,6,38,20,39,44,59,214,322,3,991,55,0,2,1,1,18360,7505,1622,12804,1
14,453,103,65,74,8,5,16,111,7,17,9,17,24,26,89,119,3,417,23,0,2,1,1,18360,7506,1622,12805,1
99,2230,1043,504,840,53,9,147,1096,9,180,112,198,189,310,1377,2344,4,11604,644,0,2,1,1,18360,7508,1622,12806,1
99,2230,383,288,292,26,6,62,409,11,65,38,67,76,105,429,656,5,3719,206,0,2,1,1,18360,7509,1622,12807,1
160,3157,1943,715,1694,26,18,214,1969,12,185,120,237,197,357,1436,2721,7,20915,1161,0,2,1,1,18360,7511,1622,12808,1
160,3157,1168,838,957,57,25,144,1225,19,348,224,416,367,640,3018,5452,11,61921,3440,1,2,1,1,18370,7513,1622,12809,1
46,2032,1020,354,843,12,15,144,1032,8,134,77,144,142,221,970,1580,4,6792,377,0,2,13,3,18370,7513,1622,12810,1
22,1115,334,251,279,10,4,40,344,5,127,74,143,132,217,899,1528,2,4303,239,0,2,59,14,18370,7514,1622,12811,1
178,3490,1457,730,1242,11,6,188,1468,10,292,166,329,302,495,2424,4078,5,22973,1276,1,2,38,1,18370,7516,1622,12812,1
178,3490,74,35,59,1,0,14,75,3,14,7,14,17,21,58,85,1,128,7,0,2,38,1,18370,7517,1622,12813,1
178,3490,245,125,200,5,7,34,250,7,30,17,34,37,51,166,265,3,1053,58,0,2,38,1,18380,7518,1622,12814,1
68,1226,1513,682,1277,25,13,200,1538,11,199,116,219,210,335,1557,2584,6,15641,868,0,2,1,1,18380,7520,1622,12815,0
68,1226,819,519,539,24,98,155,843,15,96,57,106,111,163,690,1107,8,9171,509,0,2,1,1,18390,7522,1622,12816,0
178,3490,1457,730,1242,11,6,188,1468,10,292,166,329,302,495,2424,4078,5,22973,1276,1,2,181,11,18390,7524,1622,12817,0
178,3490,74,35,59,1,0,14,75,3,14,7,14,17,21,58,85,1,128,7,0,2,181,11,18390,7525,1622,12818,0
178,3490,245,125,200,5,7,34,250,7,30,17,34,37,51,166,265,3,1053,58,0,2,181,11,18400,7526,1622,12819,0
42,1131,74,35,59,1,0,14,75,3,14,7,14,17,21,58,85,1,128,7,0,2,1,0,18400,7527,1622,12820,0
42,1131,245,125,200,5,7,34,250,7,30,17,34,37,51,166,265,3,1053,58,0,2,1,0,18410,7528,1622,12821,0
43,415,647,139,84,35,284,233,682,0,0,0,0,0,0,0,0,0,0,0,0,2,1,1,18410,7528,1622,12822,0
164,3720,77,34,69,0,0,8,77,3,24,16,29,27,45,114,213,1,387,21,0,2,1,1,18410,7528,1622,12823,0
164,3720,712,438,573,51,9,84,763,14,102,71,128,116,199,733,1364,8,11988,666,0,2,1,1,18420,7529,1622,12824,0
14,453,184,100,137,2,15,30,186,6,38,20,39,44,59,214,322,3,991,55,0,2,1,1,18420,7530,1622,12825,0
14,453,103,65,74,8,5,16,111,7,17,9,17,24,26,89,119,3,417,23,0,2,1,1,18420,7531,1622,12826,0
99,2230,1043,504,840,53,9,147,1096,9,180,112,198,189,310,1377,2344,4,11604,644,0,2,1,1,18420,7533,1622,12827,0
99,2230,383,288,292,26,6,62,409,11,65,38,67,76,105,429,656,5,3719,206,0,2,1,1,18420,7534,1622,12828,0
160,3157,1943,715,1694,26,18,214,1969,12,185,120,237,197,357,1436,2721,7,20915,1161,0,2,1,1,18420,7536,1622,12829,0
160,3157,1168,838,957,57,25,144,1225,19,348,224,416,367,640,3018,5452,11,61921,3440,1,2,1,1,18430,7538,1622,12830,0
46,2032,1020,354,843,12,15,144,1032,8,134,77,144,142,221,970,1580,4,6792,377,0,2,13,3,18430,7538,1622,12831,0
22,1115,334,251,279,10,4,40,344,5,127,74,143,132,217,899,1528,2,4303,239,0,2,59,14,18430,7539,1622,12832,0
13,444,42,7,35,4,0,5,46,1,2,1,2,3,3,2,4,0,2,0,0,2,5,1,18430,7539,1622,12833,1
13,444,11,6,10,0,0,1,11,2,4,2,4,6,6,10,15,1,15,0,0,2,5,1,18430,7539,1622,12834,1
35,645,127,75,83,2,11,30,129,4,14,7,14,18,21,61,87,2,175,9,0,2,3,0,18430,7539,1622,12835,1
35,645,652,304,544,16,6,88,668,6,89,51,101,95,152,591,998,3,3399,188,0,2,3,0,18430,7540,1622,12836,1
35,645,2,2,2,0,0,0,2,0,0,0,0,0,0,0,0,0,0,0,0,2,3,0,18430,7540,1622,12836,1
35,645,8,5,5,0,0,3,8,0,0,0,0,0,0,0,0,0,0,0,0,2,3,0,18430,7540,1622,12837,1
35,645,2,2,2,0,0,0,2,0,0,0,0,0,0,0,0,0,0,0,0,2,3,0,18430,7540,1622,12837,1
35,645,14,8,8,0,0,6,14,0,0,0,0,0,0,0,0,0,0,0,0,2,3,0,18430,7540,1622,12838,1
35,645,6,4,4,0,0,2,6,0,0,0,0,0,0,0,0,0,0,0,0,2,3,0,18430,7540,1622,12839,1
35,645,6,4,4,0,0,2,6,1,2,1,2,3,3,2,4,0,2,0,0,2,3,0,18430,7540,1622,12840,1
35,645,6,4,4,0,0,2,6,0,0,0,0,0,0,0,0,0,0,0,0,2,3,0,18430,7540,1622,12841,1
35,645,7,5,5,0,0,2,7,0,0,0,0,0,0,0,0,0,0,0,0,2,3,0,18430,7540,1622,12842,1
35,645,6,4,4,0,0,2,6,0,0,0,0,0,0,0,0,0,0,0,0,2,3,0,18430,7540,1622,12843,1
35,645,10,6,6,0,0,4,10,0,0,0,0,0,0,0,0,0,0,0,0,2,3,0,18430,7540,1622,12844,1
35,645,1,1,1,0,0,0,1,0,0,0,0,0,0,0,0,0,0,0,0,2,3,0,18430,7540,1622,12844,1
35,645,14,10,10,0,0,4,14,1,1,1,1,2,2,0,2,0,1,0,0,2,3,0,18430,7540,1622,12845,1
35,645,46,26,30,3,0,12,49,3,6,3,6,9,9,20,28,1,42,2,0,2,3,0,18440,7540,1622,12846,1
22,1119,334,251,279,10,4,40,344,5,127,74,143,132,217,899,1528,2,4303,239,0,2,3,2,18440,7541,1622,12847,1
35,645,127,75,83,2,11,30,129,4,14,7,14,18,21,61,87,2,175,9,0,2,1,1,18440,7541,1622,12848,0
35,645,652,304,544,16,6,88,668,6,89,51,101,95,152,591,998,3,3399,188,0,2,1,1,18440,7542,1622,12849,0
35,645,2,2,2,0,0,0,2,0,0,0,0,0,0,0,0,0,0,0,0,2,1,1,18440,7542,1622,12849,0
35,645,8,5,5,0,0,3,8,0,0,0,0,0,0,0,0,0,0,0,0,2,1,1,18440,7542,1622,12850,0
35,645,2,2,2,0,0,0,2,0,0,0,0,0,0,0,0,0,0,0,0,2,1,1,18440,7542,1622,12850,0
35,645,14,8,8,0,0,6,14,0,0,0,0,0,0,0,0,0,0,0,0,2,1,1,18440,7542,1622,12851,0
35,645,6,4,4,0,0,2,6,0,0,0,0,0,0,0,0,0,0,0,0,2,1,1,18440,7542,1622,12852,0
35,645,6,4,4,0,0,2,6,1,2,1,2,3,3,2,4,0,2,0,0,2,1,1,18440,7542,1622,12853,0
35,645,6,4,4,0,0,2,6,0,0,0,0,0,0,0,0,0,0,0,0,2,1,1,18440,7542,1622,12854,0
35,645,7,5,5,0,0,2,7,0,0,0,0,0,0,0,0,0,0,0,0,2,1,1,18440,7542,1622,12855,0
35,645,6,4,4,0,0,2,6,0,0,0,0,0,0,0,0,0,0,0,0,2,1,1,18440,7542,1622,12856,0
35,645,10,6,6,0,0,4,10,0,0,0,0,0,0,0,0,0,0,0,0,2,1,1,18440,7542,1622,12857,0
35,645,1,1,1,0,0,0,1,0,0,0,0,0,0,0,0,0,0,0,0,2,1,1,18440,7542,1622,12857,0
35,645,14,10,10,0,0,4,14,1,1,1,1,2,2,0,2,0,1,0,0,2,1,1,18440,7542,1622,12858,0
35,645,46,26,30,3,0,12,49,3,6,3,6,9,9,20,28,1,42,2,0,2,1,1,18450,7542,1622,12859,0
1,87,19,8,11,5,0,4,24,2,5,3,6,7,9,13,25,1,30,1,0,0,68,0,18450,7542,1622,12860,1
1,87,102,59,69,5,3,24,107,6,22,15,28,28,43,113,206,3,789,43,0,0,68,0,18450,7542,1622,12861,1
1,87,106,40,36,3,49,17,109,8,17,13,23,25,36,93,167,5,904,50,0,0,68,0,18450,7542,1622,12862,1
181,3563,1457,730,1242,11,6,188,1468,10,292,166,329,302,495,2424,4078,5,22973,1276,1,2,17,8,18450,7544,1622,12863,1
181,3563,74,35,59,1,0,14,75,3,14,7,14,17,21,58,85,1,128,7,0,2,17,8,18450,7545,1622,12864,1
181,3563,245,125,200,5,7,34,250,7,30,17,34,37,51,166,265,3,1053,58,0,2,17,8,18460,7546,1622,12865,1
25,1433,334,251,279,10,4,40,344,5,127,74,143,132,217,899,1528,2,4303,239,0,2,40,0,18460,7547,1622,12866,1
1,85,19,8,11,5,0,4,24,2,5,3,6,7,9,13,25,1,30,1,0,2,0,1,18460,7547,1622,12867,1
1,85,102,59,69,5,3,24,107,6,22,15,28,28,43,113,206,3,789,43,0,2,0,1,18460,7547,1622,12868,1
1,85,106,40,36,3,49,17,109,8,17,13,23,25,36,93,167,5,904,50,0,2,0,1,18460,7547,1622,12869,1
26,1521,334,251,279,10,4,40,344,5,127,74,143,132,217,899,1528,2,4303,239,0,2,15,7,18460,7548,1622,12870,1
1,85,19,8,11,5,0,4,24,2,5,3,6,7,9,13,25,1,30,1,0,0,67,0,18460,7548,1622,12871,0
1,85,102,59,69,5,3,24,107,6,22,15,28,28,43,113,206,3,789,43,0,0,67,0,18460,7548,1622,12872,0
1,85,106,40,36,3,49,17,109,8,17,13,23,25,36,93,167,5,904,50,0,0,67,0,18460,7548,1622,12873,0
181,3563,1457,730,1242,11,6,188,1468,10,292,166,329,302,495,2424,4078,5,22973,1276,1,2,17,8,18460,7550,1622,12874,0
181,3563,74,35,59,1,0,14,75,3,14,7,14,17,21,58,85,1,128,7,0,2,17,8,18460,7551,1622,12875,0
181,3563,245,125,200,5,7,34,250,7,30,17,34,37,51,166,265,3,1053,58,0,2,17,8,18470,7552,1622,12876,0
26,1521,334,251,279,10,4,40,344,5,127,74,143,132,217,899,1528,2,4303,239,0,2,48,0,18470,7553,1622,12877,0
26,1539,334,251,279,10,4,40,344,5,127,74,143,132,217,899,1528,2,4303,239,0,2,7,1,18470,7554,1622,12878,0
26,1517,334,251,279,10,4,40,344,5,127,74,143,132,217,899,1528,2,4303,239,0,2,8,10,18470,7555,1622,12879,1
13,426,42,7,35,4,0,5,46,1,2,1,2,3,3,2,4,0,2,0,0,2,1,6,18470,7555,1622,12880,0
13,426,11,6,10,0,0,1,11,2,4,2,4,6,6,10,15,1,15,0,0,2,1,6,18470,7555,1622,12881,0
26,1517,334,251,279,10,4,40,344,5,127,74,143,132,217,899,1528,2,4303,239,0,2,13,9,18470,7556,1622,12882,0
26,1517,334,251,279,10,4,40,344,5,127,74,143,132,217,899,1528,2,4303,239,0,2,13,9,18470,7557,1622,12883,0
435,9394,72,33,56,0,4,12,72,1,1,1,1,2,2,0,2,0,1,0,0,2,2,0,18470,7557,1622,12884,0
435,9394,1454,835,1044,76,110,219,1530,17,275,158,296,292,454,2297,3718,9,34017,1889,1,2,2,0,18480,7558,1622,12885,0
26,1517,334,251,279,10,4,40,344,5,127,74,143,132,217,899,1528,2,4303,239,0,2,13,9,18480,7559,1622,12886,0
181,3565,1457,730,1242,11,6,188,1468,10,292,166,329,302,495,2424,4078,5,22973,1276,1,2,8,8,18480,7561,1622,12887,0
181,3565,74,35,59,1,0,14,75,3,14,7,14,17,21,58,85,1,128,7,0,2,8,8,18480,7562,1622,12888,0
181,3565,245,125,200,5,7,34,250,7,30,17,34,37,51,166,265,3,1053,58,0,2,8,8,18490,7563,1622,12889,0
26,1508,334,251,279,10,4,40,344,5,127,74,143,132,217,899,1528,2,4303,239,0,2,1,1,18490,7564,1622,12890,0
181,3565,1457,730,1242,11,6,188,1468,10,292,166,329,302,495,2424,4078,5,22973,1276,1,2,8,8,18490,7566,1622,12891,0
181,3565,74,35,59,1,0,14,75,3,14,7,14,17,21,58,85,1,128,7,0,2,8,8,18490,7567,1622,12892,0
181,3565,245,125,200,5,7,34,250,7,30,17,34,37,51,166,265,3,1053,58,0,2,8,8,18500,7568,1622,12893,0
26,1508,334,251,279,10,4,40,344,5,127,74,143,132,217,899,1528,2,4303,239,0,2,1,1,18500,7569,1622,12894,0
73,1525,477,336,357,30,23,73,507,16,194,134,250,210,384,1538,2962,10,30538,1696,0,2,7,2,18510,7570,1622,12895,1
48,1675,1450,624,1228,12,26,181,1462,14,306,186,354,320,540,2580,4493,8,36391,2021,1,2,41,1,18510,7572,1623,12896,1
73,1533,477,336,357,30,23,73,507,16,194,134,250,210,384,1538,2962,10,30538,1696,0,2,5,1,18520,7573,1623,12897,1
35,643,127,75,83,2,11,30,129,4,14,7,14,18,21,61,87,2,175,9,0,2,1,1,18520,7573,1623,12898,1
35,643,652,304,544,16,6,88,668,6,89,51,101,95,152,591,998,3,3399,188,0,2,1,1,18520,7574,1623,12899,1
35,643,2,2,2,0,0,0,2,0,0,0,0,0,0,0,0,0,0,0,0,2,1,1,18520,7574,1623,12899,1
35,643,8,5,5,0,0,3,8,0,0,0,0,0,0,0,0,0,0,0,0,2,1,1,18520,7574,1623,12900,1
35,643,2,2,2,0,0,0,2,0,0,0,0,0,0,0,0,0,0,0,0,2,1,1,18520,7574,1623,12900,1
35,643,14,8,8,0,0,6,14,0,0,0,0,0,0,0,0,0,0,0,0,2,1,1,18520,7574,1623,12901,1
35,643,6,4,4,0,0,2,6,0,0,0,0,0,0,0,0,0,0,0,0,2,1,1,18520,7574,1623,12902,1
35,643,6,4,4,0,0,2,6,1,2,1,2,3,3,2,4,0,2,0,0,2,1,1,18520,7574,1623,12903,1
35,643,6,4,4,0,0,2,6,0,0,0,0,0,0,0,0,0,0,0,0,2,1,1,18520,7574,1623,12904,1
35,643,7,5,5,0,0,2,7,0,0,0,0,0,0,0,0,0,0,0,0,2,1,1,18520,7574,1623,12905,1
35,643,6,4,4,0,0,2,6,0,0,0,0,0,0,0,0,0,0,0,0,2,1,1,18520,7574,1623,12906,1
35,643,10,6,6,0,0,4,10,0,0,0,0,0,0,0,0,0,0,0,0,2,1,1,18520,7574,1623,12907,1
35,643,1,1,1,0,0,0,1,0,0,0,0,0,0,0,0,0,0,0,0,2,1,1,18520,7574,1623,12907,1
35,643,14,10,10,0,0,4,14,1,1,1,1,2,2,0,2,0,1,0,0,2,1,1,18520,7574,1623,12908,1
35,643,46,26,30,3,0,12,49,3,6,3,6,9,9,20,28,1,42,2,0,2,1,1,18530,7574,1623,12909,1
49,1694,1450,624,1228,12,26,181,1462,14,306,186,354,320,540,2580,4493,8,36391,2021,1,2,8,6,18530,7576,1624,12910,1
126,3959,1660,832,1314,41,38,274,1701,20,312,209,395,332,604,2671,5058,12,64042,3557,1,2,8,12,18530,7578,1625,12912,1
126,3959,1057,646,719,113,100,145,1170,18,215,134,248,233,382,1740,3004,10,31186,1732,1,2,8,12,18540,7579,1626,12913,1
109,2592,1660,832,1314,41,38,274,1701,20,312,209,395,332,604,2671,5058,12,64042,3557,1,2,20,0,18540,7581,1627,12915,1
200,3870,1457,730,1242,11,6,188,1468,10,292,166,329,302,495,2424,4078,5,22973,1276,1,2,69,2,18540,7583,1627,12916,1
200,3870,74,35,59,1,0,14,75,3,14,7,14,17,21,58,85,1,128,7,0,2,69,2,18540,7584,1627,12917,1
200,3870,245,125,200,5,7,34,250,7,30,17,34,37,51,166,265,3,1053,58,0,2,69,2,18550,7585,1627,12918,1
35,2151,334,251,279,10,4,40,344,5,127,74,143,132,217,899,1528,2,4303,239,0,2,101,29,18550,7586,1627,12919,1
35,2147,334,251,279,10,4,40,344,5,127,74,143,132,217,899,1528,2,4303,239,0,2,2,2,18550,7587,1627,12920,0
200,3870,1457,730,1242,11,6,188,1468,10,292,166,329,302,495,2424,4078,5,22973,1276,1,2,69,2,18550,7589,1627,12921,0
200,3870,74,35,59,1,0,14,75,3,14,7,14,17,21,58,85,1,128,7,0,2,69,2,18550,7590,1627,12922,0
200,3870,245,125,200,5,7,34,250,7,30,17,34,37,51,166,265,3,1053,58,0,2,69,2,18560,7591,1627,12923,0
35,2147,334,251,279,10,4,40,344,5,127,74,143,132,217,899,1528,2,4303,239,0,2,99,27,18560,7592,1627,12924,0
30,619,2,2,2,0,0,0,2,0,0,0,0,0,0,0,0,0,0,0,0,2,2,2,18560,7592,1627,12924,1
30,619,99,48,90,1,3,5,100,0,0,0,0,0,0,0,0,0,0,0,0,2,2,2,18560,7593,1627,12925,1
30,619,8,5,5,2,0,1,10,0,0,0,0,0,0,0,0,0,0,0,0,2,2,2,18560,7593,1627,12926,1
30,619,1217,716,841,84,126,174,1301,14,185,118,215,199,333,1446,2542,8,20687,1149,0,2,2,2,18570,7595,1627,12927,1
30,619,160,89,115,0,13,31,160,7,15,11,17,22,28,78,124,3,495,27,0,2,2,2,18570,7595,1627,12928,1
30,619,10,10,9,9,0,0,19,0,0,0,0,0,0,0,0,0,0,0,0,2,2,2,18570,7595,1628,12929,1
30,619,173,84,99,8,29,36,181,5,12,7,13,17,20,54,81,2,221,12,0,2,2,2,18570,7596,1628,12930,1
30,619,3,1,1,3,0,0,6,0,0,0,0,0,0,0,0,0,0,0,0,2,2,2,18570,7596,1628,12931,1
42,1129,74,35,59,1,0,14,75,3,14,7,14,17,21,58,85,1,128,7,0,2,2,2,18570,7597,1628,12932,1
42,1129,245,125,200,5,7,34,250,7,30,17,34,37,51,166,265,3,1053,58,0,2,2,2,18580,7598,1628,12933,1
42,1321,1523,757,1297,19,12,193,1542,12,193,117,230,205,347,1508,2664,7,19053,1058,0,2,3,3,18590,7600,1628,12934,1
42,1321,701,378,504,33,58,109,734,13,110,68,126,123,194,794,1346,7,10027,557,0,2,3,3,18590,7601,1629,12935,1
164,3718,77,34,69,0,0,8,77,3,24,16,29,27,45,114,213,1,387,21,0,2,3,2,18590,7601,1629,12936,1
164,3718,712,438,573,51,9,84,763,14,102,71,128,116,199,733,1364,8,11988,666,0,2,3,2,18600,7602,1629,12937,1
29,601,215,129,180,6,0,29,221,8,65,43,72,73,115,415,711,4,3153,175,0,2,1,1,18600,7602,1629,12938,1
29,601,97,69,77,3,3,16,100,6,22,13,23,28,36,113,173,3,542,30,0,2,1,1,18600,7603,1629,12939,1
160,3155,1943,715,1694,26,18,214,1969,12,185,120,237,197,357,1436,2721,7,20915,1161,0,2,2,2,18600,7605,1629,12940,1
160,3155,1168,838,957,57,25,144,1225,19,348,224,416,367,640,3018,5452,11,61921,3440,1,2,2,2,18610,7607,1629,12941,1
35,2147,334,251,279,10,4,40,344,5,127,74,143,132,217,899,1528,2,4303,239,0,2,0,1,18610,7608,1629,12942,1
30,619,2,2,2,0,0,0,2,0,0,0,0,0,0,0,0,0,0,0,0,2,2,2,18610,7608,1629,12942,0
30,619,99,48,90,1,3,5,100,0,0,0,0,0,0,0,0,0,0,0,0,2,2,2,18610,7609,1629,12943,0
30,619,8,5,5,2,0,1,10,0,0,0,0,0,0,0,0,0,0,0,0,2,2,2,18610,7609,1629,12944,0
30,619,1217,716,841,84,126,174,1301,14,185,118,215,199,333,1446,2542,8,20687,1149,0,2,2,2,18620,7611,1629,12945,0
30,619,160,89,115,0,13,31,160,7,15,11,17,22,28,78,124,3,495,27,0,2,2,2,18620,7611,1629,12946,0
30,619,10,10,9,9,0,0,19,0,0,0,0,0,0,0,0,0,0,0,0,2,2,2,18620,7611,1630,12947,0
30,619,173,84,99,8,29,36,181,5,12,7,13,17,20,54,81,2,221,12,0,2,2,2,18620,7612,1630,12948,0
30,619,3,1,1,3,0,0,6,0,0,0,0,0,0,0,0,0,0,0,0,2,2,2,18620,7612,1630,12949,0
42,1129,74,35,59,1,0,14,75,3,14,7,14,17,21,58,85,1,128,7,0,2,2,2,18620,7613,1630,12950,0
42,1129,245,125,200,5,7,34,250,7,30,17,34,37,51,166,265,3,1053,58,0,2,2,2,18630,7614,1630,12951,0
42,1321,1523,757,1297,19,12,193,1542,12,193,117,230,205,347,1508,2664,7,19053,1058,0,2,3,3,18640,7616,1630,12952,0
42,1321,701,378,504,33,58,109,734,13,110,68,126,123,194,794,1346,7,10027,557,0,2,3,3,18640,7617,1631,12953,0
164,3718,77,34,69,0,0,8,77,3,24,16,29,27,45,114,213,1,387,21,0,2,3,2,18640,7617,1631,12954,0
164,3718,712,438,573,51,9,84,763,14,102,71,128,116,199,733,1364,8,11988,666,0,2,3,2,18650,7618,1631,12955,0
29,601,215,129,180,6,0,29,221,8,65,43,72,73,115,415,711,4,3153,175,0,2,1,1,18650,7618,1631,12956,0
29,601,97,69,77,3,3,16,100,6,22,13,23,28,36,113,173,3,542,30,0,2,1,1,18650,7619,1631,12957,0
160,3155,1943,715,1694,26,18,214,1969,12,185,120,237,197,357,1436,2721,7,20915,1161,0,2,2,2,18650,7621,1631,12958,0
160,3155,1168,838,957,57,25,144,1225,19,348,224,416,367,640,3018,5452,11,61921,3440,1,2,2,2,18660,7623,1631,12959,0
35,2147,334,251,279,10,4,40,344,5,127,74,143,132,217,899,1528,2,4303,239,0,2,0,1,18660,7624,1631,12960,0
3,23,14,7,7,2,0,5,16,0,0,0,0,0,0,0,0,0,0,0,0,2,1,1,18660,7624,1631,12960,1
61,2541,1289,550,1043,56,32,155,1345,10,167,93,185,177,278,1266,2075,5,11498,638,0,2,1,1,18660,7626,1632,12961,1
53,2846,1338,495,1086,10,64,173,1348,11,122,82,157,133,239,883,1686,7,11934,663,0,2,5,5,18660,7628,1632,12962,1
110,4667,139,89,101,2,0,35,141,7,54,34,62,61,96,330,569,4,2287,127,0,2,1,1,18660,7628,1632,12963,1
110,4667,7,5,5,0,0,2,7,1,2,1,2,3,3,2,4,0,2,0,0,2,1,1,18660,7628,1632,12964,1
56,3203,1782,648,1425,9,47,279,1791,8,171,97,189,179,286,1292,2140,4,9462,525,0,2,1,1,18660,7629,1633,12965,1
49,1694,1450,624,1228,12,26,181,1462,14,306,186,354,320,540,2580,4493,8,36391,2021,1,2,1,1,18660,7631,1634,12966,1
42,2708,1296,573,1062,40,33,157,1336,8,201,118,231,209,349,1561,2689,4,12365,686,0,2,3,3,18660,7631,1634,12967,1
24,972,373,158,315,8,0,51,381,5,76,44,79,81,123,486,779,2,2026,112,0,2,2,2,18660,7631,1634,12968,1
58,2641,1943,715,1694,26,18,214,1969,12,185,120,237,197,357,1436,2721,7,20915,1161,0,2,9,9,18660,7633,1634,12969,1
438,9405,72,33,56,0,4,12,72,1,1,1,1,2,2,0,2,0,1,0,0,2,6,6,18660,7633,1634,12970,1
438,9405,1454,835,1044,76,110,219,1530,17,275,158,296,292,454,2297,3718,9,34017,1889,1,2,6,6,18670,7634,1634,12971,1
112,4755,139,89,101,2,0,35,141,7,54,34,62,61,96,330,569,4,2287,127,0,2,47,1,18670,7634,1634,12972,1
112,4755,7,5,5,0,0,2,7,1,2,1,2,3,3,2,4,0,2,0,0,2,47,1,18670,7634,1634,12973,1
129,4014,1660,832,1314,41,38,274,1701,20,312,209,395,332,604,2671,5058,12,64042,3557,1,2,13,0,18670,7636,1635,12975,1
129,4014,1057,646,719,113,100,145,1170,18,215,134,248,233,382,1740,3004,10,31186,1732,1,2,13,0,18680,7637,1636,12976,1
111,2674,1660,832,1314,41,38,274,1701,20,312,209,395,332,604,2671,5058,12,64042,3557,1,2,30,0,18680,7639,1637,12978,1
438,9405,72,33,56,0,4,12,72,1,1,1,1,2,2,0,2,0,1,0,0,2,6,6,18680,7639,1637,12979,0
438,9405,1454,835,1044,76,110,219,1530,17,275,158,296,292,454,2297,3718,9,34017,1889,1,2,6,6,18690,7640,1637,12980,0
112,4755,139,89,101,2,0,35,141,7,54,34,62,61,96,330,569,4,2287,127,0,2,47,1,18690,7640,1637,12981,0
112,4755,7,5,5,0,0,2,7,1,2,1,2,3,3,2,4,0,2,0,0,2,47,1,18690,7640,1637,12982,0
191,4456,722,423,573,19,0,135,741,12,172,101,199,184,300,1320,2257,6,15668,870,0,2,6,0,18690,7642,1637,12984,1
191,4456,1508,847,911,44,250,301,1552,14,148,88,169,162,257,1120,1886,7,15077,837,0,2,6,0,18690,7643,1638,12985,1
56,1100,1098,241,925,5,10,155,1103,7,46,25,49,53,74,273,423,3,1580,87,0,2,27,22,18700,7645,1638,12986,1
56,1100,282,202,222,14,2,44,296,8,42,24,43,50,67,250,378,4,1548,86,0,2,27,22,18700,7646,1638,12987,1
112,4779,139,89,101,2,0,35,141,7,54,34,62,61,96,330,569,4,2287,127,0,2,10,4,18700,7646,1638,12988,1
112,4779,7,5,5,0,0,2,7,1,2,1,2,3,3,2,4,0,2,0,0,2,10,4,18700,7646,1638,12989,1
32,1208,1098,241,925,5,10,155,1103,7,46,25,49,53,74,273,423,3,1580,87,0,2,51,1,18710,7648,1638,12990,1
57,1106,1098,241,925,5,10,155,1103,7,46,25,49,53,74,273,423,3,1580,87,0,2,2,1,18720,7650,1638,12991,1
57,1106,282,202,222,14,2,44,296,8,42,24,43,50,67,250,378,4,1548,86,0,2,2,1,18720,7651,1638,12992,1
165,3739,77,34,69,0,0,8,77,3,24,16,29,27,45,114,213,1,387,21,0,2,9,1,18730,7655,1639,13000,1
165,3739,712,438,573,51,9,84,763,14,102,71,128,116,199,733,1364,8,11988,666,0,2,9,1,18740,7656,1639,13001,1
434,9399,72,33,56,0,4,12,72,1,1,1,1,2,2,0,2,0,1,0,0,2,22,29,18740,7656,1639,13002,1
434,9399,1454,835,1044,76,110,219,1530,17,275,158,296,292,454,2297,3718,9,34017,1889,1,2,22,29,18750,7657,1639,13003,1
56,1091,1098,241,925,5,10,155,1103,7,46,25,49,53,74,273,423,3,1580,87,0,2,12,15,18760,7659,1639,13004,1
56,1091,282,202,222,14,2,44,296,8,42,24,43,50,67,250,378,4,1548,86,0,2,12,15,18760,7660,1639,13005,1
13,426,42,7,35,4,0,5,46,1,2,1,2,3,3,2,4,0,2,0,0,2,1,1,18760,7660,1639,13006,1
13,426,11,6,10,0,0,1,11,2,4,2,4,6,6,10,15,1,15,0,0,2,1,1,18760,7660,1639,13007,1
112,4767,139,89,101,2,0,35,141,7,54,34,62,61,96,330,569,4,2287,127,0,2,0,2,18760,7660,1639,13008,1
112,4767,7,5,5,0,0,2,7,1,2,1,2,3,3,2,4,0,2,0,0,2,0,2,18760,7660,1639,13009,1
13,413,295,56,236,0,4,54,295,2,9,5,10,11,15,30,51,1,57,3,0,2,74,34,18760,7662,1639,13010,1
33,1262,1098,241,925,5,10,155,1103,7,46,25,49,53,74,273,423,3,1580,87,0,2,19,1,18770,7664,1639,13011,1
159,3154,1943,715,1694,26,18,214,1969,12,185,120,237,197,357,1436,2721,7,20915,1161,0,2,8,10,18770,7666,1639,13012,0
159,3154,1168,838,957,57,25,144,1225,19,348,224,416,367,640,3018,5452,11,61921,3440,1,2,8,10,18780,7668,1639,13013,0
8,207,19,8,11,5,0,4,24,2,5,3,6,7,9,13,25,1,30,1,0,2,36,2,18780,7668,1639,13014,1
8,207,102,59,69,5,3,24,107,6,22,15,28,28,43,113,206,3,789,43,0,2,36,2,18780,7668,1639,13015,1
8,207,106,40,36,3,49,17,109,8,17,13,23,25,36,93,167,5,904,50,0,2,36,2,18780,7668,1639,13016,1
23,594,102,59,69,5,3,24,107,6,22,15,28,28,43,113,206,3,789,43,0,0,92,0,18780,7668,1639,13018,1
159,3154,1943,715,1694,26,18,214,1969,12,185,120,237,197,357,1436,2721,7,20915,1161,0,2,8,10,18780,7670,1639,13019,0
159,3154,1168,838,957,57,25,144,1225,19,348,224,416,367,640,3018,5452,11,61921,3440,1,2,8,10,18790,7672,1639,13020,0
8,207,19,8,11,5,0,4,24,2,5,3,6,7,9,13,25,1,30,1,0,2,36,2,18790,7672,1639,13021,0
8,207,102,59,69,5,3,24,107,6,22,15,28,28,43,113,206,3,789,43,0,2,36,2,18790,7672,1639,13022,0
8,207,106,40,36,3,49,17,109,8,17,13,23,25,36,93,167,5,904,50,0,2,36,2,18790,7672,1639,13023,0
23,594,102,59,69,5,3,24,107,6,22,15,28,28,43,113,206,3,789,43,0,0,92,0,18790,7672,1639,13025,0
43,912,447,308,343,6,5,95,453,7,96,59,111,103,170,651,1136,4,4600,255,0,2,61,1,18790,7675,1639,13026,0
43,912,322,174,179,16,74,51,338,10,41,26,46,51,72,252,408,5,2291,127,0,2,61,1,18790,7678,1640,13027,0
33,1460,447,308,343,6,5,95,453,7,96,59,111,103,170,651,1136,4,4600,255,0,2,32,0,18790,7681,1640,13028,0
38,787,447,308,343,6,5,95,453,7,96,59,111,103,170,651,1136,4,4600,255,0,2,39,56,18790,7684,1640,13029,1
38,787,322,174,179,16,74,51,338,10,41,26,46,51,72,252,408,5,2291,127,0,2,39,56,18790,7687,1641,13030,1
31,1414,447,308,343,6,5,95,453,7,96,59,111,103,170,651,1136,4,4600,255,0,2,12,23,18790,7690,1641,13031,1
13,426,42,7,35,4,0,5,46,1,2,1,2,3,3,2,4,0,2,0,0,2,1,1,18800,7694,1642,13039,1
13,426,11,6,10,0,0,1,11,2,4,2,4,6,6,10,15,1,15,0,0,2,1,1,18800,7694,1642,13040,1
165,3753,77,34,69,0,0,8,77,3,24,16,29,27,45,114,213,1,387,21,0,2,6,0,18800,7694,1642,13041,1
165,3753,712,438,573,51,9,84,763,14,102,71,128,116,199,733,1364,8,11988,666,0,2,6,0,18810,7695,1642,13042,1
22,372,424,94,331,4,0,89,428,1,5,5,5,6,10,11,25,0,12,0,0,2,3,0,18810,7696,1642,13043,1
22,372,38,23,23,6,0,8,44,3,11,7,11,14,18,42,68,1,102,5,0,2,3,0,18810,7696,1642,13044,1
191,4461,722,423,573,19,0,135,741,12,172,101,199,184,300,1320,2257,6,15668,870,0,2,3,2,18810,7698,1642,13046,1
191,4461,1508,847,911,44,250,301,1552,14,148,88,169,162,257,1120,1886,7,15077,837,0,2,3,2,18810,7699,1643,13047,1
99,2226,1043,504,840,53,9,147,1096,9,180,112,198,189,310,1377,2344,4,11604,644,0,2,1,1,18810,7701,1643,13048,1
99,2226,383,288,292,26,6,62,409,11,65,38,67,76,105,429,656,5,3719,206,0,2,1,1,18810,7702,1643,13049,1
16,504,424,94,331,4,0,89,428,1,5,5,5,6,10,11,25,0,12,0,0,2,11,2,18810,7703,1643,13050,1
57,3243,1782,648,1425,9,47,279,1791,8,171,97,189,179,286,1292,2140,4,9462,525,0,2,17,0,18810,7704,1644,13051,1
46,1863,1043,504,840,53,9,147,1096,9,180,112,198,189,310,1377,2344,4,11604,644,0,2,11,0,18810,7706,1644,13052,1
46,1863,1043,504,840,53,9,147,1096,9,180,112,198,189,310,1377,2344,4,11604,644,0,2,4,1,18810,7708,1644,13053,0
36,2163,334,251,279,10,4,40,344,5,127,74,143,132,217,899,1528,2,4303,239,0,2,2,0,18810,7709,1644,13054,1
165,3753,77,34,69,0,0,8,77,3,24,16,29,27,45,114,213,1,387,21,0,2,1,1,18810,7709,1644,13055,1
165,3753,712,438,573,51,9,84,763,14,102,71,128,116,199,733,1364,8,11988,666,0,2,1,1,18820,7710,1644,13056,1
22,950,1455,414,1257,16,76,112,1471,5,41,23,46,46,69,231,381,2,1069,59,0,2,11,0,18820,7711,1644,13057,1
44,428,647,139,84,35,284,233,682,0,0,0,0,0,0,0,0,0,0,0,0,2,11,1,18830,7715,1645,13065,1
165,3705,77,34,69,0,0,8,77,3,24,16,29,27,45,114,213,1,387,21,0,2,5,8,18830,7715,1645,13066,1
165,3705,712,438,573,51,9,84,763,14,102,71,128,116,199,733,1364,8,11988,666,0,2,5,8,18840,7716,1645,13067,1
24,583,1293,570,1093,25,15,163,1318,10,195,123,241,205,364,1516,2795,6,17273,959,0,2,10,15,18850,7718,1645,13068,1
107,2375,1043,504,840,53,9,147,1096,9,180,112,198,189,310,1377,2344,4,11604,644,0,2,22,1,18850,7720,1645,13069,1
107,2375,383,288,292,26,6,62,409,11,65,38,67,76,105,429,656,5,3719,206,0,2,22,1,18850,7721,1645,13070,1
13,426,42,7,35,4,0,5,46,1,2,1,2,3,3,2,4,0,2,0,0,2,1,1,18850,7721,1645,13071,1
13,426,11,6,10,0,0,1,11,2,4,2,4,6,6,10,15,1,15,0,0,2,1,1,18850,7721,1645,13072,1
13,384,465,148,393,5,8,60,470,4,31,20,31,35,51,161,261,2,523,29,0,2,3,2,18850,7722,1645,13073,1
13,384,16,12,9,0,0,6,16,1,2,1,2,3,3,2,4,0,2,0,0,2,3,2,18850,7722,1645,13074,1
25,941,1293,570,1093,25,15,163,1318,10,195,123,241,205,364,1516,2795,6,17273,959,0,2,29,0,18860,7724,1645,13075,1
46,1865,1043,504,840,53,9,147,1096,9,180,112,198,189,310,1377,2344,4,11604,644,0,2,3,3,18860,7726,1645,13076,1
23,383,424,94,331,4,0,89,428,1,5,5,5,6,10,11,25,0,12,0,0,2,3,2,18860,7727,1645,13077,0
23,383,38,23,23,6,0,8,44,3,11,7,11,14,18,42,68,1,102,5,0,2,3,2,18860,7727,1645,13078,0
23,409,424,94,331,4,0,89,428,1,5,5,5,6,10,11,25,0,12,0,0,2,8,6,18860,7728,1645,13079,0
23,409,38,23,23,6,0,8,44,3,11,7,11,14,18,42,68,1,102,5,0,2,8,6,18860,7728,1645,13080,0
25,625,1293,570,1093,25,15,163,1318,10,195,123,241,205,364,1516,2795,6,17273,959,0,2,6,0,18870,7730,1645,13081,1
27,1013,1293,570,1093,25,15,163,1318,10,195,123,241,205,364,1516,2795,6,17273,959,0,2,16,0,18880,7732,1645,13082,1
54,2876,1338,495,1086,10,64,173,1348,11,122,82,157,133,239,883,1686,7,11934,663,0,2,18,0,18880,7734,1645,13083,0
54,2876,1338,495,1086,10,64,173,1348,11,122,82,157,133,239,883,1686,7,11934,663,0,2,18,0,18880,7736,1645,13084,0
166,3708,77,34,69,0,0,8,77,3,24,16,29,27,45,114,213,1,387,21,0,2,8,5,18880,7736,1645,13085,1
166,3708,712,438,573,51,9,84,763,14,102,71,128,116,199,733,1364,8,11988,666,0,2,8,5,18890,7737,1645,13086,1
62,2584,1289,550,1043,56,32,155,1345,10,167,93,185,177,278,1266,2075,5,11498,638,0,2,8,0,18890,7739,1646,13087,1
57,1097,1098,241,925,5,10,155,1103,7,46,25,49,53,74,273,423,3,1580,87,0,2,4,1,18900,7741,1646,13088,1
57,1097,282,202,222,14,2,44,296,8,42,24,43,50,67,250,378,4,1548,86,0,2,4,1,18900,7742,1646,13089,1
34,1295,1098,241,925,5,10,155,1103,7,46,25,49,53,74,273,423,3,1580,87,0,2,18,0,18910,7744,1646,13090,1
23,612,102,59,69,5,3,24,107,6,22,15,28,28,43,113,206,3,789,43,0,2,2,0,18910,7744,1646,13091,0
42,1321,1523,757,1297,19,12,193,1542,12,193,117,230,205,347,1508,2664,7,19053,1058,0,2,3,3,18920,7746,1646,13092,1
42,1321,701,378,504,33,58,109,734,13,110,68,126,123,194,794,1346,7,10027,557,0,2,3,3,18920,7747,1647,13093,1
37,2250,1523,757,1297,19,12,193,1542,12,193,117,230,205,347,1508,2664,7,19053,1058,0,2,1,1,18930,7749,1647,13094,1
436,9474,72,33,56,0,4,12,72,1,1,1,1,2,2,0,2,0,1,0,0,2,31,14,18930,7749,1647,13095,1
436,9474,1454,835,1044,76,110,219,1530,17,275,158,296,292,454,2297,3718,9,34017,1889,1,2,31,14,18940,7750,1647,13096,1
113,4797,139,89,101,2,0,35,141,7,54,34,62,61,96,330,569,4,2287,127,0,2,22,6,18940,7750,1647,13097,1
113,4797,7,5,5,0,0,2,7,1,2,1,2,3,3,2,4,0,2,0,0,2,22,6,18940,7750,1647,13098,1
160,3165,1943,715,1694,26,18,214,1969,12,185,120,237,197,357,1436,2721,7,20915,1161,0,2,3,2,18940,7752,1647,13099,1
160,3165,1168,838,957,57,25,144,1225,19,348,224,416,367,640,3018,5452,11,61921,3440,1,2,3,2,18950,7754,1647,13100,1
59,2688,1943,715,1694,26,18,214,1969,12,185,120,237,197,357,1436,2721,7,20915,1161,0,2,8,1,18950,7756,1647,13101,1
436,9476,72,33,56,0,4,12,72,1,1,1,1,2,2,0,2,0,1,0,0,2,1,1,18950,7756,1647,13102,1
436,9476,1454,835,1044,76,110,219,1530,17,275,158,296,292,454,2297,3718,9,34017,1889,1,2,1,1,18960,7757,1647,13103,1
113,4797,139,89,101,2,0,35,141,7,54,34,62,61,96,330,569,4,2287,127,0,2,10,10,18960,7757,1647,13104,1
113,4797,7,5,5,0,0,2,7,1,2,1,2,3,3,2,4,0,2,0,0,2,10,10,18960,7757,1647,13105,1
59,2687,1943,715,1694,26,18,214,1969,12,185,120,237,197,357,1436,2721,7,20915,1161,0,2,1,1,18960,7759,1647,13106,1
42,846,447,308,343,6,5,95,453,7,96,59,111,103,170,651,1136,4,4600,255,0,2,85,56,18960,7762,1647,13107,1
42,846,322,174,179,16,74,51,338,10,41,26,46,51,72,252,408,5,2291,127,0,2,85,56,18960,7765,1648,13108,1
32,1449,447,308,343,6,5,95,453,7,96,59,111,103,170,651,1136,4,4600,255,0,2,14,6,18960,7768,1648,13109,1
13,426,42,7,35,4,0,5,46,1,2,1,2,3,3,2,4,0,2,0,0,2,1,1,18970,7772,1649,13117,1
13,426,11,6,10,0,0,1,11,2,4,2,4,6,6,10,15,1,15,0,0,2,1,1,18970,7772,1649,13118,1
44,428,647,139,84,35,284,233,682,0,0,0,0,0,0,0,0,0,0,0,0,2,1,1,18970,7772,1649,13119,1
162,3224,1943,715,1694,26,18,214,1969,12,185,120,237,197,357,1436,2721,7,20915,1161,0,2,8,1,18970,7774,1649,13120,1
162,3224,1168,838,957,57,25,144,1225,19,348,224,416,367,640,3018,5452,11,61921,3440,1,2,8,1,18980,7776,1649,13121,1
46,2032,1020,354,843,12,15,144,1032,8,134,77,144,142,221,970,1580,4,6792,377,0,2,1,1,18980,7776,1649,13122,1
60,2714,1943,715,1694,26,18,214,1969,12,185,120,237,197,357,1436,2721,7,20915,1161,0,2,13,0,18980,7778,1649,13123,1
200,3862,1457,730,1242,11,6,188,1468,10,292,166,329,302,495,2424,4078,5,22973,1276,1,2,5,18,18980,7780,1649,13124,1
200,3862,74,35,59,1,0,14,75,3,14,7,14,17,21,58,85,1,128,7,0,2,5,18,18980,7781,1649,13125,1
200,3862,245,125,200,5,7,34,250,7,30,17,34,37,51,166,265,3,1053,58,0,2,5,18,18990,7782,1649,13126,1
36,2153,334,251,279,10,4,40,344,5,127,74,143,132,217,899,1528,2,4303,239,0,2,5,5,18990,7783,1649,13127,1
199,3859,1457,730,1242,11,6,188,1468,10,292,166,329,302,495,2424,4078,5,22973,1276,1,2,3,3,18990,7785,1649,13128,1
199,3859,74,35,59,1,0,14,75,3,14,7,14,17,21,58,85,1,128,7,0,2,3,3,18990,7786,1649,13129,1
199,3859,245,125,200,5,7,34,250,7,30,17,34,37,51,166,265,3,1053,58,0,2,3,3,19000,7787,1649,13130,1
34,1725,1457,730,1242,11,6,188,1468,10,292,166,329,302,495,2424,4078,5,22973,1276,1,2,1,1,19000,7789,1649,13131,1
6,493,442,244,305,14,16,103,456,11,68,45,75,79,120,452,756,6,4588,254,0,2,1,1,19000,7791,1649,13132,1
199,3865,1457,730,1242,11,6,188,1468,10,292,166,329,302,495,2424,4078,5,22973,1276,1,2,3,1,19000,7793,1649,13133,0
199,3865,74,35,59,1,0,14,75,3,14,7,14,17,21,58,85,1,128,7,0,2,3,1,19000,7794,1649,13134,0
199,3865,245,125,200,5,7,34,250,7,30,17,34,37,51,166,265,3,1053,58,0,2,3,1,19010,7795,1649,13135,0
43,421,647,139,84,35,284,233,682,0,0,0,0,0,0,0,0,0,0,0,0,2,1,4,19010,7795,1649,13136,0
70,1248,1513,682,1277,25,13,200,1538,11,199,116,219,210,335,1557,2584,6,15641,868,0,2,8,0,19010,7797,1649,13137,1
70,1248,819,519,539,24,98,155,843,15,96,57,106,111,163,690,1107,8,9171,509,0,2,8,0,19020,7799,1649,13138,1
165,3712,77,34,69,0,0,8,77,3,24,16,29,27,45,114,213,1,387,21,0,2,1,0,19020,7799,1649,13139,1
165,3712,712,438,573,51,9,84,763,14,102,71,128,116,199,733,1364,8,11988,666,0,2,1,0,19030,7800,1649,13140,1
192,4394,722,423,573,19,0,135,741,12,172,101,199,184,300,1320,2257,6,15668,870,0,2,12,21,19030,7802,1649,13142,1
192,4394,1508,847,911,44,250,301,1552,14,148,88,169,162,257,1120,1886,7,15077,837,0,2,12,21,19030,7803,1650,13143,1
61,2537,1289,550,1043,56,32,155,1345,10,167,93,185,177,278,1266,2075,5,11498,638,0,2,5,5,19030,7805,1651,13144,1
42,2708,1296,573,1062,40,33,157,1336,8,201,118,231,209,349,1561,2689,4,12365,686,0,2,2,2,19030,7805,1651,13145,1
22,954,1455,414,1257,16,76,112,1471,5,41,23,46,46,69,231,381,2,1069,59,0,2,1,1,19030,7806,1651,13146,1
36,2150,334,251,279,10,4,40,344,5,127,74,143,132,217,899,1528,2,4303,239,0,2,1,1,19030,7807,1651,13147,0
199,3872,1457,730,1242,11,6,188,1468,10,292,166,329,302,495,2424,4078,5,22973,1276,1,2,9,14,19030,7809,1651,13148,1
199,3872,74,35,59,1,0,14,75,3,14,7,14,17,21,58,85,1,128,7,0,2,9,14,19030,7810,1651,13149,1
199,3872,245,125,200,5,7,34,250,7,30,17,34,37,51,166,265,3,1053,58,0,2,9,14,19040,7811,1651,13150,1
208,4134,1457,730,1242,11,6,188,1468,10,292,166,329,302,495,2424,4078,5,22973,1276,1,2,55,16,19040,7813,1651,13151,1
208,4134,74,35,59,1,0,14,75,3,14,7,14,17,21,58,85,1,128,7,0,2,55,16,19040,7814,1651,13152,1
208,4134,245,125,200,5,7,34,250,7,30,17,34,37,51,166,265,3,1053,58,0,2,55,16,19050,7815,1651,13153,1
42,1123,74,35,59,1,0,14,75,3,14,7,14,17,21,58,85,1,128,7,0,2,2,2,19050,7816,1651,13154,1
42,1123,245,125,200,5,7,34,250,7,30,17,34,37,51,166,265,3,1053,58,0,2,2,2,19060,7817,1651,13155,1
165,3706,77,34,69,0,0,8,77,3,24,16,29,27,45,114,213,1,387,21,0,2,2,2,19060,7817,1651,13156,1
165,3706,712,438,573,51,9,84,763,14,102,71,128,116,199,733,1364,8,11988,666,0,2,2,2,19070,7818,1651,13157,1
59,1128,1020,354,843,12,15,144,1032,8,134,77,144,142,221,970,1580,4,6792,377,0,2,5,3,19070,7818,1651,13158,1
192,4388,722,423,573,19,0,135,741,12,172,101,199,184,300,1320,2257,6,15668,870,0,2,2,2,19070,7820,1651,13160,1
192,4388,1508,847,911,44,250,301,1552,14,148,88,169,162,257,1120,1886,7,15077,837,0,2,2,2,19070,7821,1652,13161,1
24,974,373,158,315,8,0,51,381,5,76,44,79,81,123,486,779,2,2026,112,0,2,3,2,19070,7821,1652,13162,1
229,4659,1457,730,1242,11,6,188,1468,10,292,166,329,302,495,2424,4078,5,22973,1276,1,2,104,2,19070,7823,1652,13163,1
229,4659,74,35,59,1,0,14,75,3,14,7,14,17,21,58,85,1,128,7,0,2,104,2,19070,7824,1652,13164,1
229,4659,245,125,200,5,7,34,250,7,30,17,34,37,51,166,265,3,1053,58,0,2,104,2,19080,7825,1652,13165,1
165,3704,77,34,69,0,0,8,77,3,24,16,29,27,45,114,213,1,387,21,0,2,1,1,19080,7825,1652,13166,1
165,3704,712,438,573,51,9,84,763,14,102,71,128,116,199,733,1364,8,11988,666,0,2,1,1,19090,7826,1652,13167,1
192,4388,722,423,573,19,0,135,741,12,172,101,199,184,300,1320,2257,6,15668,870,0,2,2,2,19090,7828,1652,13169,1
192,4388,1508,847,911,44,250,301,1552,14,148,88,169,162,257,1120,1886,7,15077,837,0,2,2,2,19090,7829,1653,13170,1
165,3265,1943,715,1694,26,18,214,1969,12,185,120,237,197,357,1436,2721,7,20915,1161,0,2,6,0,19090,7831,1653,13171,1
165,3265,1168,838,957,57,25,144,1225,19,348,224,416,367,640,3018,5452,11,61921,3440,1,2,6,0,19100,7833,1653,13172,1
36,1810,1457,730,1242,11,6,188,1468,10,292,166,329,302,495,2424,4078,5,22973,1276,1,2,15,0,19100,7835,1653,13173,1
14,577,722,423,573,19,0,135,741,12,172,101,199,184,300,1320,2257,6,15668,870,0,2,1,1,19100,7837,1653,13175,1
71,1306,1513,682,1277,25,13,200,1538,11,199,116,219,210,335,1557,2584,6,15641,868,0,2,20,9,19100,7839,1653,13176,1
71,1306,819,519,539,24,98,155,843,15,96,57,106,111,163,690,1107,8,9171,509,0,2,20,9,19110,7841,1653,13177,1
229,4666,1457,730,1242,11,6,188,1468,10,292,166,329,302,495,2424,4078,5,22973,1276,1,2,21,25,19110,7843,1653,13178,1
229,4666,74,35,59,1,0,14,75,3,14,7,14,17,21,58,85,1,128,7,0,2,21,25,19110,7844,1653,13179,1
229,4666,245,125,200,5,7,34,250,7,30,17,34,37,51,166,265,3,1053,58,0,2,21,25,19120,7845,1653,13180,1
44,432,647,139,84,35,284,233,682,0,0,0,0,0,0,0,0,0,0,0,0,2,5,1,19120,7845,1653,13181,1
42,1791,1513,682,1277,25,13,200,1538,11,199,116,219,210,335,1557,2584,6,15641,868,0,2,10,0,19120,7847,1653,13182,1
38,1886,1457,730,1242,11,6,188,1468,10,292,166,329,302,495,2424,4078,5,22973,1276,1,2,15,0,19120,7849,1653,13183,1
37,2204,334,251,279,10,4,40,344,5,127,74,143,132,217,899,1528,2,4303,239,0,2,6,0,19120,7850,1653,13184,1
440,9534,72,33,56,0,4,12,72,1,1,1,1,2,2,0,2,0,1,0,0,2,22,8,19120,7850,1653,13185,1
440,9534,1454,835,1044,76,110,219,1530,17,275,158,296,292,454,2297,3718,9,34017,1889,1,2,22,8,19130,7851,1653,13186,1
113,4797,139,89,101,2,0,35,141,7,54,34,62,61,96,330,569,4,2287,127,0,2,8,9,19130,7851,1653,13187,1
113,4797,7,5,5,0,0,2,7,1,2,1,2,3,3,2,4,0,2,0,0,2,8,9,19130,7851,1653,13188,1
441,9550,72,33,56,0,4,12,72,1,1,1,1,2,2,0,2,0,1,0,0,2,5,0,19130,7851,1653,13189,1
441,9550,1454,835,1044,76,110,219,1530,17,275,158,296,292,454,2297,3718,9,34017,1889,1,2,5,0,19140,7852,1653,13190,1
114,4827,139,89,101,2,0,35,141,7,54,34,62,61,96,330,569,4,2287,127,0,2,15,0,19140,7852,1653,13191,1
114,4827,7,5,5,0,0,2,7,1,2,1,2,3,3,2,4,0,2,0,0,2,15,0,19140,7852,1653,13192,1
73,1336,1513,682,1277,25,13,200,1538,11,199,116,219,210,335,1557,2584,6,15641,868,0,2,5,0,19150,7858,1654,13200,1
73,1336,819,519,539,24,98,155,843,15,96,57,106,111,163,690,1107,8,9171,509,0,2,5,0,19160,7860,1654,13201,1
13,426,42,7,35,4,0,5,46,1,2,1,2,3,3,2,4,0,2,0,0,2,1,1,19160,7860,1654,13202,1
13,426,11,6,10,0,0,1,11,2,4,2,4,6,6,10,15,1,15,0,0,2,1,1,19160,7860,1654,13203,1
61,2530,1289,550,1043,56,32,155,1345,10,167,93,185,177,278,1266,2075,5,11498,638,0,2,5,5,19160,7862,1655,13204,1
42,1782,1513,682,1277,25,13,200,1538,11,199,116,219,210,335,1557,2584,6,15641,868,0,2,0,1,19160,7864,1655,13205,1
13,426,42,7,35,4,0,5,46,1,2,1,2,3,3,2,4,0,2,0,0,2,2,2,19170,7868,1656,13213,1
13,426,11,6,10,0,0,1,11,2,4,2,4,6,6,10,15,1,15,0,0,2,2,2,19170,7868,1656,13214,1
196,4437,722,423,573,19,0,135,741,12,172,101,199,184,300,1320,2257,6,15668,870,0,2,6,0,19170,7870,1656,13216,1
196,4437,1508,847,911,44,250,301,1552,14,148,88,169,162,257,1120,1886,7,15077,837,0,2,6,0,19170,7871,1657,13217,1
1,224,382,65,130,157,2,92,539,4,10,5,10,14,15,41,57,2,114,6,0,2,1,1,19170,7872,1658,13218,1
61,2521,1289,550,1043,56,32,155,1345,10,167,93,185,177,278,1266,2075,5,11498,638,0,2,5,9,19170,7874,1659,13219,1
37,2265,1523,757,1297,19,12,193,1542,12,193,117,230,205,347,1508,2664,7,19053,1058,0,2,4,4,19180,7876,1659,13220,1
13,426,42,7,35,4,0,5,46,1,2,1,2,3,3,2,4,0,2,0,0,2,1,1,19190,7880,1660,13228,0
13,426,11,6,10,0,0,1,11,2,4,2,4,6,6,10,15,1,15,0,0,2,1,1,19190,7880,1660,13229,0
229,4670,1457,730,1242,11,6,188,1468,10,292,166,329,302,495,2424,4078,5,22973,1276,1,2,1,1,19190,7882,1660,13230,1
229,4670,74,35,59,1,0,14,75,3,14,7,14,17,21,58,85,1,128,7,0,2,1,1,19190,7883,1660,13231,1
229,4670,245,125,200,5,7,34,250,7,30,17,34,37,51,166,265,3,1053,58,0,2,1,1,19200,7884,1660,13232,1
39,1926,1457,730,1242,11,6,188,1468,10,292,166,329,302,495,2424,4078,5,22973,1276,1,2,11,0,19200,7886,1660,13233,1
9,241,19,8,11,5,0,4,24,2,5,3,6,7,9,13,25,1,30,1,0,2,5,1,19200,7886,1660,13234,1
9,241,102,59,69,5,3,24,107,6,22,15,28,28,43,113,206,3,789,43,0,2,5,1,19200,7886,1660,13235,1
9,241,106,40,36,3,49,17,109,8,17,13,23,25,36,93,167,5,904,50,0,2,5,1,19200,7886,1660,13236,1
9,241,19,8,11,5,0,4,24,2,5,3,6,7,9,13,25,1,30,1,0,2,5,1,19200,7886,1660,13237,0
9,241,102,59,69,5,3,24,107,6,22,15,28,28,43,113,206,3,789,43,0,2,5,1,19200,7886,1660,13238,0
9,241,106,40,36,3,49,17,109,8,17,13,23,25,36,93,167,5,904,50,0,2,5,1,19200,7886,1660,13239,0
441,9550,72,33,56,0,4,12,72,1,1,1,1,2,2,0,2,0,1,0,0,2,2,2,19200,7886,1660,13240,1
441,9550,1454,835,1044,76,110,219,1530,17,275,158,296,292,454,2297,3718,9,34017,1889,1,2,2,2,19210,7887,1660,13241,1
55,2905,1338,495,1086,10,64,173,1348,11,122,82,157,133,239,883,1686,7,11934,663,0,2,10,0,19210,7889,1660,13242,1
1,225,382,65,130,157,2,92,539,4,10,5,10,14,15,41,57,2,114,6,0,2,2,1,19220,7894,1662,13250,1
13,426,42,7,35,4,0,5,46,1,2,1,2,3,3,2,4,0,2,0,0,2,1,1,19220,7894,1662,13251,1
13,426,11,6,10,0,0,1,11,2,4,2,4,6,6,10,15,1,15,0,0,2,1,1,19220,7894,1662,13252,1
73,1336,1513,682,1277,25,13,200,1538,11,199,116,219,210,335,1557,2584,6,15641,868,0,2,1,1,19230,7900,1663,13260,1
73,1336,819,519,539,24,98,155,843,15,96,57,106,111,163,690,1107,8,9171,509,0,2,1,1,19240,7902,1663,13261,1
164,3237,1943,715,1694,26,18,214,1969,12,185,120,237,197,357,1436,2721,7,20915,1161,0,2,8,5,19240,7904,1663,13262,1
164,3237,1168,838,957,57,25,144,1225,19,348,224,416,367,640,3018,5452,11,61921,3440,1,2,8,5,19250,7906,1663,13263,1
13,426,42,7,35,4,0,5,46,1,2,1,2,3,3,2,4,0,2,0,0,2,1,1,19250,7906,1663,13264,1
13,426,11,6,10,0,0,1,11,2,4,2,4,6,6,10,15,1,15,0,0,2,1,1,19250,7906,1663,13265,1
30,617,2,2,2,0,0,0,2,0,0,0,0,0,0,0,0,0,0,0,0,2,1,2,19250,7906,1663,13265,1
30,617,99,48,90,1,3,5,100,0,0,0,0,0,0,0,0,0,0,0,0,2,1,2,19250,7907,1663,13266,1
30,617,8,5,5,2,0,1,10,0,0,0,0,0,0,0,0,0,0,0,0,2,1,2,19250,7907,1663,13267,1
30,617,1217,716,841,84,126,174,1301,14,185,118,215,199,333,1446,2542,8,20687,1149,0,2,1,2,19260,7909,1663,13268,1
30,617,160,89,115,0,13,31,160,7,15,11,17,22,28,78,124,3,495,27,0,2,1,2,19260,7909,1663,13269,1
30,617,10,10,9,9,0,0,19,0,0,0,0,0,0,0,0,0,0,0,0,2,1,2,19260,7909,1664,13270,1
30,617,173,84,99,8,29,36,181,5,12,7,13,17,20,54,81,2,221,12,0,2,1,2,19260,7910,1664,13271,1
30,617,3,1,1,3,0,0,6,0,0,0,0,0,0,0,0,0,0,0,0,2,1,2,19260,7910,1664,13272,1
165,3696,77,34,69,0,0,8,77,3,24,16,29,27,45,114,213,1,387,21,0,2,0,2,19260,7910,1664,13273,1
165,3696,712,438,573,51,9,84,763,14,102,71,128,116,199,733,1364,8,11988,666,0,2,0,2,19270,7911,1664,13274,1
23,407,424,94,331,4,0,89,428,1,5,5,5,6,10,11,25,0,12,0,0,2,0,1,19270,7912,1664,13275,1
23,407,38,23,23,6,0,8,44,3,11,7,11,14,18,42,68,1,102,5,0,2,0,1,19270,7912,1664,13276,1
196,4435,722,423,573,19,0,135,741,12,172,101,199,184,300,1320,2257,6,15668,870,0,2,0,1,19270,7914,1664,13278,1
196,4435,1508,847,911,44,250,301,1552,14,148,88,169,162,257,1120,1886,7,15077,837,0,2,0,1,19270,7915,1665,13279,1
18,460,386,256,301,16,9,68,402,4,59,35,69,63,104,355,621,2,1453,80,0,2,2,2,19270,7915,1665,13280,1
18,460,264,131,164,11,41,46,275,6,38,22,40,44,62,214,338,3,1068,59,0,2,2,2,19280,7915,1666,13281,1
57,1095,1098,241,925,5,10,155,1103,7,46,25,49,53,74,273,423,3,1580,87,0,2,1,1,19290,7917,1666,13282,1
57,1095,282,202,222,14,2,44,296,8,42,24,43,50,67,250,378,4,1548,86,0,2,1,1,19290,7918,1666,13283,1
60,1136,1020,354,843,12,15,144,1032,8,134,77,144,142,221,970,1580,4,6792,377,0,2,3,2,19290,7918,1666,13284,1
166,3721,77,34,69,0,0,8,77,3,24,16,29,27,45,114,213,1,387,21,0,2,20,11,19290,7918,1666,13285,1
166,3721,712,438,573,51,9,84,763,14,102,71,128,116,199,733,1364,8,11988,666,0,2,20,11,19300,7919,1666,13286,1
45,2799,1296,573,1062,40,33,157,1336,8,201,118,231,209,349,1561,2689,4,12365,686,0,2,22,1,19300,7919,1666,13288,1
12,373,442,244,305,14,16,103,456,11,68,45,75,79,120,452,756,6,4588,254,0,2,3,0,19300,7921,1666,13289,0
12,373,182,102,99,11,40,35,193,3,11,6,11,14,17,42,64,1,97,5,0,2,3,0,19300,7922,1666,13290,0
7,520,442,244,305,14,16,103,456,11,68,45,75,79,120,452,756,6,4588,254,0,2,9,0,19300,7924,1666,13291,0
172,3827,77,34,69,0,0,8,77,3,24,16,29,27,45,114,213,1,387,21,0,2,21,0,19300,7924,1666,13292,1
172,3827,712,438,573,51,9,84,763,14,102,71,128,116,199,733,1364,8,11988,666,0,2,21,0,19310,7925,1666,13293,1
61,1148,1020,354,843,12,15,144,1032,8,134,77,144,142,221,970,1580,4,6792,377,0,2,14,13,19310,7925,1666,13294,1
47,2070,1020,354,843,12,15,144,1032,8,134,77,144,142,221,970,1580,4,6792,377,0,2,25,1,19310,7925,1666,13295,1
163,3229,1943,715,1694,26,18,214,1969,12,185,120,237,197,357,1436,2721,7,20915,1161,0,2,1,1,19310,7927,1666,13296,1
163,3229,1168,838,957,57,25,144,1225,19,348,224,416,367,640,3018,5452,11,61921,3440,1,2,1,1,19320,7929,1666,13297,1
60,2704,1943,715,1694,26,18,214,1969,12,185,120,237,197,357,1436,2721,7,20915,1161,0,2,11,8,19320,7931,1666,13298,1
14,439,42,7,35,4,0,5,46,1,2,1,2,3,3,2,4,0,2,0,0,2,4,2,19330,7935,1667,13306,0
14,439,11,6,10,0,0,1,11,2,4,2,4,6,6,10,15,1,15,0,0,2,4,2,19330,7935,1667,13307,0
38,2239,334,251,279,10,4,40,344,5,127,74,143,132,217,899,1528,2,4303,239,0,2,7,3,19330,7936,1667,13308,1
42,846,447,308,343,6,5,95,453,7,96,59,111,103,170,651,1136,4,4600,255,0,2,3,2,19330,7939,1667,13309,1
42,846,322,174,179,16,74,51,338,10,41,26,46,51,72,252,408,5,2291,127,0,2,3,2,19330,7942,1668,13310,1
164,3240,1943,715,1694,26,18,214,1969,12,185,120,237,197,357,1436,2721,7,20915,1161,0,2,2,2,19330,7944,1668,13311,1
164,3240,1168,838,957,57,25,144,1225,19,348,224,416,367,640,3018,5452,11,61921,3440,1,2,2,2,19340,7946,1668,13312,1
161,3179,1943,715,1694,26,18,214,1969,12,185,120,237,197,357,1436,2721,7,20915,1161,0,2,1,19,19340,7948,1668,13313,0
161,3179,1168,838,957,57,25,144,1225,19,348,224,416,367,640,3018,5452,11,61921,3440,1,2,1,19,19350,7950,1668,13314,0
59,2667,1943,715,1694,26,18,214,1969,12,185,120,237,197,357,1436,2721,7,20915,1161,0,2,0,11,19350,7952,1668,13315,0
14,439,42,7,35,4,0,5,46,1,2,1,2,3,3,2,4,0,2,0,0,2,1,1,19350,7952,1668,13316,1
14,439,11,6,10,0,0,1,11,2,4,2,4,6,6,10,15,1,15,0,0,2,1,1,19350,7952,1668,13317,1
1,225,382,65,130,157,2,92,539,4,10,5,10,14,15,41,57,2,114,6,0,2,2,2,19350,7953,1669,13318,1
129,4015,1660,832,1314,41,38,274,1701,20,312,209,395,332,604,2671,5058,12,64042,3557,1,2,3,3,19350,7955,1670,13320,1
129,4015,1057,646,719,113,100,145,1170,18,215,134,248,233,382,1740,3004,10,31186,1732,1,2,3,3,19360,7956,1671,13321,1
112,2716,1660,832,1314,41,38,274,1701,20,312,209,395,332,604,2671,5058,12,64042,3557,1,2,7,1,19360,7958,1672,13323,1
129,4017,1660,832,1314,41,38,274,1701,20,312,209,395,332,604,2671,5058,12,64042,3557,1,2,1,1,19360,7960,1673,13325,1
129,4017,1057,646,719,113,100,145,1170,18,215,134,248,233,382,1740,3004,10,31186,1732,1,2,1,1,19370,7961,1674,13326,1
113,2758,1660,832,1314,41,38,274,1701,20,312,209,395,332,604,2671,5058,12,64042,3557,1,2,10,1,19370,7963,1675,13328,1
114,2807,1660,832,1314,41,38,274,1701,20,312,209,395,332,604,2671,5058,12,64042,3557,1,2,9,0,19370,7965,1676,13330,0
14,439,42,7,35,4,0,5,46,1,2,1,2,3,3,2,4,0,2,0,0,2,1,1,19380,7969,1677,13338,1
14,439,11,6,10,0,0,1,11,2,4,2,4,6,6,10,15,1,15,0,0,2,1,1,19380,7969,1677,13339,1
86,1526,1178,367,1042,6,15,115,1184,9,94,51,95,103,146,644,976,4,4439,246,0,2,8,0,19380,7969,1677,13340,1
86,1526,177,108,140,8,0,27,185,6,30,16,32,36,48,162,248,3,794,44,0,2,8,0,19380,7971,1677,13341,1
13,442,42,7,35,4,0,5,46,1,2,1,2,3,3,2,4,0,2,0,0,2,15,13,19380,7971,1677,13342,1
13,442,11,6,10,0,0,1,11,2,4,2,4,6,6,10,15,1,15,0,0,2,15,13,19380,7971,1677,13343,1
43,1897,1178,367,1042,6,15,115,1184,9,94,51,95,103,146,644,976,4,4439,246,0,2,8,10,19380,7971,1677,13344,1
115,2872,1660,832,1314,41,38,274,1701,20,312,209,395,332,604,2671,5058,12,64042,3557,1,2,31,0,19380,7973,1678,13346,0
131,4056,1660,832,1314,41,38,274,1701,20,312,209,395,332,604,2671,5058,12,64042,3557,1,2,18,0,19380,7975,1679,13348,0
131,4056,1057,646,719,113,100,145,1170,18,215,134,248,233,382,1740,3004,10,31186,1732,1,2,18,0,19390,7976,1680,13349,0
131,4052,1660,832,1314,41,38,274,1701,20,312,209,395,332,604,2671,5058,12,64042,3557,1,2,3,2,19390,7978,1681,13351,0
131,4052,1057,646,719,113,100,145,1170,18,215,134,248,233,382,1740,3004,10,31186,1732,1,2,3,2,19400,7979,1682,13352,0
115,2872,1660,832,1314,41,38,274,1701,20,312,209,395,332,604,2671,5058,12,64042,3557,1,2,1,0,19400,7981,1683,13354,0
131,4052,1660,832,1314,41,38,274,1701,20,312,209,395,332,604,2671,5058,12,64042,3557,1,2,19,0,19400,7983,1684,13356,0
131,4052,1057,646,719,113,100,145,1170,18,215,134,248,233,382,1740,3004,10,31186,1732,1,2,19,0,19410,7984,1685,13357,0
115,2872,1660,832,1314,41,38,274,1701,20,312,209,395,332,604,2671,5058,12,64042,3557,1,2,32,0,19410,7986,1686,13359,0
63,1172,1020,354,843,12,15,144,1032,8,134,77,144,142,221,970,1580,4,6792,377,0,2,5,2,19410,7986,1686,13360,1
48,2097,1020,354,843,12,15,144,1032,8,134,77,144,142,221,970,1580,4,6792,377,0,2,11,0,19410,7986,1686,13361,1
30,617,2,2,2,0,0,0,2,0,0,0,0,0,0,0,0,0,0,0,0,2,5,5,19410,7986,1686,13361,1
30,617,99,48,90,1,3,5,100,0,0,0,0,0,0,0,0,0,0,0,0,2,5,5,19410,7987,1686,13362,1
30,617,8,5,5,2,0,1,10,0,0,0,0,0,0,0,0,0,0,0,0,2,5,5,19410,7987,1686,13363,1
30,617,1217,716,841,84,126,174,1301,14,185,118,215,199,333,1446,2542,8,20687,1149,0,2,5,5,19420,7989,1686,13364,1
30,617,160,89,115,0,13,31,160,7,15,11,17,22,28,78,124,3,495,27,0,2,5,5,19420,7989,1686,13365,1
30,617,10,10,9,9,0,0,19,0,0,0,0,0,0,0,0,0,0,0,0,2,5,5,19420,7989,1687,13366,1
30,617,173,84,99,8,29,36,181,5,12,7,13,17,20,54,81,2,221,12,0,2,5,5,19420,7990,1687,13367,1
30,617,3,1,1,3,0,0,6,0,0,0,0,0,0,0,0,0,0,0,0,2,5,5,19420,7990,1687,13368,1
131,4052,1660,832,1314,41,38,274,1701,20,312,209,395,332,604,2671,5058,12,64042,3557,1,2,3,2,19420,7992,1688,13370,1
131,4052,1057,646,719,113,100,145,1170,18,215,134,248,233,382,1740,3004,10,31186,1732,1,2,3,2,19430,7993,1689,13371,1
229,4668,1457,730,1242,11,6,188,1468,10,292,166,329,302,495,2424,4078,5,22973,1276,1,2,1,1,19430,7995,1689,13372,1
229,4668,74,35,59,1,0,14,75,3,14,7,14,17,21,58,85,1,128,7,0,2,1,1,19430,7996,1689,13373,1
229,4668,245,125,200,5,7,34,250,7,30,17,34,37,51,166,265,3,1053,58,0,2,1,1,19440,7997,1689,13374,1
42,1119,74,35,59,1,0,14,75,3,14,7,14,17,21,58,85,1,128,7,0,2,0,1,19440,7998,1689,13375,1
42,1119,245,125,200,5,7,34,250,7,30,17,34,37,51,166,265,3,1053,58,0,2,0,1,19450,7999,1689,13376,1
172,3822,77,34,69,0,0,8,77,3,24,16,29,27,45,114,213,1,387,21,0,2,0,1,19450,7999,1689,13377,1
172,3822,712,438,573,51,9,84,763,14,102,71,128,116,199,733,1364,8,11988,666,0,2,0,1,19460,8000,1689,13378,1
195,4408,722,423,573,19,0,135,741,12,172,101,199,184,300,1320,2257,6,15668,870,0,2,1,6,19460,8002,1689,13380,1
195,4408,1508,847,911,44,250,301,1552,14,148,88,169,162,257,1120,1886,7,15077,837,0,2,1,6,19460,8003,1690,13381,1
439,9488,72,33,56,0,4,12,72,1,1,1,1,2,2,0,2,0,1,0,0,2,4,9,19460,8003,1690,13382,1
439,9488,1454,835,1044,76,110,219,1530,17,275,158,296,292,454,2297,3718,9,34017,1889,1,2,4,9,19470,8004,1690,13383,1
86,1521,1178,367,1042,6,15,115,1184,9,94,51,95,103,146,644,976,4,4439,246,0,2,0,1,19470,8004,1690,13384,1
86,1521,177,108,140,8,0,27,185,6,30,16,32,36,48,162,248,3,794,44,0,2,0,1,19470,8006,1690,13385,1
161,3177,1943,715,1694,26,18,214,1969,12,185,120,237,197,357,1436,2721,7,20915,1161,0,2,0,1,19470,8008,1690,13386,1
161,3177,1168,838,957,57,25,144,1225,19,348,224,416,367,640,3018,5452,11,61921,3440,1,2,0,1,19480,8010,1690,13387,1
61,2511,1289,550,1043,56,32,155,1345,10,167,93,185,177,278,1266,2075,5,11498,638,0,2,3,4,19480,8012,1691,13388,1
55,2891,1338,495,1086,10,64,173,1348,11,122,82,157,133,239,883,1686,7,11934,663,0,2,4,6,19480,8014,1691,13389,1
114,4817,139,89,101,2,0,35,141,7,54,34,62,61,96,330,569,4,2287,127,0,2,6,6,19480,8014,1691,13390,1
114,4817,7,5,5,0,0,2,7,1,2,1,2,3,3,2,4,0,2,0,0,2,6,6,19480,8014,1691,13391,1
13,380,465,148,393,5,8,60,470,4,31,20,31,35,51,161,261,2,523,29,0,2,1,1,19480,8015,1691,13392,1
13,380,16,12,9,0,0,6,16,1,2,1,2,3,3,2,4,0,2,0,0,2,1,1,19480,8015,1691,13393,1
57,3235,1782,648,1425,9,47,279,1791,8,171,97,189,179,286,1292,2140,4,9462,525,0,2,1,2,19480,8016,1692,13394,1
9,192,256,139,192,9,7,47,265,4,23,12,24,27,36,112,171,2,357,19,0,2,1,1,19480,8017,1692,13395,1
49,1690,1450,624,1228,12,26,181,1462,14,306,186,354,320,540,2580,4493,8,36391,2021,1,2,2,2,19480,8019,1693,13396,1
115,2864,1660,832,1314,41,38,274,1701,20,312,209,395,332,604,2671,5058,12,64042,3557,1,2,7,8,19480,8021,1694,13398,1
45,2786,1296,573,1062,40,33,157,1336,8,201,118,231,209,349,1561,2689,4,12365,686,0,2,6,6,19480,8021,1694,13399,1
39,1924,1457,730,1242,11,6,188,1468,10,292,166,329,302,495,2424,4078,5,22973,1276,1,2,6,6,19480,8023,1694,13400,1
29,1370,652,304,544,16,6,88,668,6,89,51,101,95,152,591,998,3,3399,188,0,2,4,4,19480,8024,1694,13401,1
22,950,1455,414,1257,16,76,112,1471,5,41,23,46,46,69,231,381,2,1069,59,0,2,2,2,19480,8025,1694,13402,1
11,343,74,35,59,1,0,14,75,3,14,7,14,17,21,58,85,1,128,7,0,2,1,1,19480,8026,1694,13403,1
37,2252,1523,757,1297,19,12,193,1542,12,193,117,230,205,347,1508,2664,7,19053,1058,0,2,2,4,19490,8028,1694,13404,1
48,2093,1020,354,843,12,15,144,1032,8,134,77,144,142,221,970,1580,4,6792,377,0,2,3,3,19490,8028,1694,13405,1
16,502,424,94,331,4,0,89,428,1,5,5,5,6,10,11,25,0,12,0,0,2,1,1,19490,8029,1694,13406,1
38,2232,334,251,279,10,4,40,344,5,127,74,143,132,217,899,1528,2,4303,239,0,2,7,8,19490,8030,1694,13407,1
7,291,184,100,137,2,15,30,186,6,38,20,39,44,59,214,322,3,991,55,0,2,1,2,19490,8031,1694,13408,1
27,1009,1293,570,1093,25,15,163,1318,10,195,123,241,205,364,1516,2795,6,17273,959,0,2,2,2,19500,8033,1694,13409,1
14,569,722,423,573,19,0,135,741,12,172,101,199,184,300,1320,2257,6,15668,870,0,2,2,3,19500,8035,1694,13411,1
46,1867,1043,504,840,53,9,147,1096,9,180,112,198,189,310,1377,2344,4,11604,644,0,2,6,6,19500,8037,1694,13412,1
24,972,373,158,315,8,0,51,381,5,76,44,79,81,123,486,779,2,2026,112,0,2,1,1,19500,8037,1694,13413,1
43,1898,1178,367,1042,6,15,115,1184,9,94,51,95,103,146,644,976,4,4439,246,0,2,6,6,19500,8037,1694,13414,1
59,2593,1943,715,1694,26,18,214,1969,12,185,120,237,197,357,1436,2721,7,20915,1161,0,2,20,23,19500,8039,1694,13415,1
7,518,442,244,305,14,16,103,456,11,68,45,75,79,120,452,756,6,4588,254,0,2,0,1,19500,8041,1694,13416,1
34,1293,1098,241,925,5,10,155,1103,7,46,25,49,53,74,273,423,3,1580,87,0,2,1,1,19510,8043,1694,13417,1
439,9491,72,33,56,0,4,12,72,1,1,1,1,2,2,0,2,0,1,0,0,2,3,3,19510,8043,1694,13418,1
439,9491,1454,835,1044,76,110,219,1530,17,275,158,296,292,454,2297,3718,9,34017,1889,1,2,3,3,19520,8044,1694,13419,1
14,399,465,148,393,5,8,60,470,4,31,20,31,35,51,161,261,2,523,29,0,2,4,0,19520,8045,1694,13420,1
14,399,16,12,9,0,0,6,16,1,2,1,2,3,3,2,4,0,2,0,0,2,4,0,19520,8045,1694,13421,1
42,852,447,308,343,6,5,95,453,7,96,59,111,103,170,651,1136,4,4600,255,0,2,4,3,19520,8048,1694,13422,1
42,852,322,174,179,16,74,51,338,10,41,26,46,51,72,252,408,5,2291,127,0,2,4,3,19520,8051,1695,13423,1
33,1483,447,308,343,6,5,95,453,7,96,59,111,103,170,651,1136,4,4600,255,0,2,6,0,19520,8054,1695,13424,1
42,1313,1523,757,1297,19,12,193,1542,12,193,117,230,205,347,1508,2664,7,19053,1058,0,2,7,8,19540,8060,1696,13432,1
42,1313,701,378,504,33,58,109,734,13,110,68,126,123,194,794,1346,7,10027,557,0,2,7,8,19540,8061,1697,13433,1
13,442,42,7,35,4,0,5,46,1,2,1,2,3,3,2,4,0,2,0,0,2,1,1,19540,8061,1697,13434,1
13,442,11,6,10,0,0,1,11,2,4,2,4,6,6,10,15,1,15,0,0,2,1,1,19540,8061,1697,13435,1
38,2361,1523,757,1297,19,12,193,1542,12,193,117,230,205,347,1508,2664,7,19053,1058,0,2,25,2,19550,8063,1697,13436,1
42,852,447,308,343,6,5,95,453,7,96,59,111,103,170,651,1136,4,4600,255,0,2,2,2,19550,8066,1697,13437,1
42,852,322,174,179,16,74,51,338,10,41,26,46,51,72,252,408,5,2291,127,0,2,2,2,19550,8069,1698,13438,1
38,2370,1523,757,1297,19,12,193,1542,12,193,117,230,205,347,1508,2664,7,19053,1058,0,2,4,3,19560,8071,1698,13439,1
13,442,42,7,35,4,0,5,46,1,2,1,2,3,3,2,4,0,2,0,0,2,1,1,19560,8071,1698,13440,0
13,442,11,6,10,0,0,1,11,2,4,2,4,6,6,10,15,1,15,0,0,2,1,1,19560,8071,1698,13441,0
439,9498,72,33,56,0,4,12,72,1,1,1,1,2,2,0,2,0,1,0,0,2,5,4,19560,8071,1698,13442,1
439,9498,1454,835,1044,76,110,219,1530,17,275,158,296,292,454,2297,3718,9,34017,1889,1,2,5,4,19570,8072,1698,13443,1
61,2962,1338,495,1086,10,64,173,1348,11,122,82,157,133,239,883,1686,7,11934,663,0,2,15,0,19570,8074,1698,13444,1
439,9498,72,33,56,0,4,12,72,1,1,1,1,2,2,0,2,0,1,0,0,2,5,4,19570,8074,1698,13445,0
439,9498,1454,835,1044,76,110,219,1530,17,275,158,296,292,454,2297,3718,9,34017,1889,1,2,5,4,19580,8075,1698,13446,0
61,2962,1338,495,1086,10,64,173,1348,11,122,82,157,133,239,883,1686,7,11934,663,0,2,15,0,19580,8077,1698,13447,0
439,9498,72,33,56,0,4,12,72,1,1,1,1,2,2,0,2,0,1,0,0,2,5,4,19580,8077,1698,13448,0
439,9498,1454,835,1044,76,110,219,1530,17,275,158,296,292,454,2297,3718,9,34017,1889,1,2,5,4,19590,8078,1698,13449,0
61,2962,1338,495,1086,10,64,173,1348,11,122,82,157,133,239,883,1686,7,11934,663,0,2,15,0,19590,8080,1698,13450,0
132,4066,1660,832,1314,41,38,274,1701,20,312,209,395,332,604,2671,5058,12,64042,3557,1,2,6,1,19590,8082,1699,13452,1
132,4066,1057,646,719,113,100,145,1170,18,215,134,248,233,382,1740,3004,10,31186,1732,1,2,6,1,19600,8083,1700,13453,1
438,9497,72,33,56,0,4,12,72,1,1,1,1,2,2,0,2,0,1,0,0,2,1,2,19600,8083,1700,13454,1
438,9497,1454,835,1044,76,110,219,1530,17,275,158,296,292,454,2297,3718,9,34017,1889,1,2,1,2,19610,8084,1700,13455,1
30,1496,652,304,544,16,6,88,668,6,89,51,101,95,152,591,998,3,3399,188,0,2,37,0,19610,8085,1700,13456,1
33,1481,447,308,343,6,5,95,453,7,96,59,111,103,170,651,1136,4,4600,255,0,2,2,2,19610,8088,1700,13457,0
23,612,102,59,69,5,3,24,107,6,22,15,28,28,43,113,206,3,789,43,0,2,2,2,19610,8088,1700,13458,0
33,1481,447,308,343,6,5,95,453,7,96,59,111,103,170,651,1136,4,4600,255,0,2,2,2,19610,8091,1700,13459,0
438,9497,72,33,56,0,4,12,72,1,1,1,1,2,2,0,2,0,1,0,0,2,1,2,19610,8091,1700,13460,0
438,9497,1454,835,1044,76,110,219,1530,17,275,158,296,292,454,2297,3718,9,34017,1889,1,2,1,2,19620,8092,1700,13461,0
30,1496,652,304,544,16,6,88,668,6,89,51,101,95,152,591,998,3,3399,188,0,2,37,0,19620,8093,1700,13462,0
23,612,102,59,69,5,3,24,107,6,22,15,28,28,43,113,206,3,789,43,0,2,2,2,19620,8093,1700,13463,0
438,9494,72,33,56,0,4,12,72,1,1,1,1,2,2,0,2,0,1,0,0,2,1,1,19620,8093,1700,13464,1
438,9494,1454,835,1044,76,110,219,1530,17,275,158,296,292,454,2297,3718,9,34017,1889,1,2,1,1,19630,8094,1700,13465,1
438,9494,72,33,56,0,4,12,72,1,1,1,1,2,2,0,2,0,1,0,0,2,1,1,19630,8094,1700,13466,0
438,9494,1454,835,1044,76,110,219,1530,17,275,158,296,292,454,2297,3718,9,34017,1889,1,2,1,1,19640,8095,1700,13467,0
131,4059,1660,832,1314,41,38,274,1701,20,312,209,395,332,604,2671,5058,12,64042,3557,1,2,5,6,19640,8097,1701,13469,0
131,4059,1057,646,719,113,100,145,1170,18,215,134,248,233,382,1740,3004,10,31186,1732,1,2,5,6,19650,8098,1702,13470,0
62,2549,1289,550,1043,56,32,155,1345,10,167,93,185,177,278,1266,2075,5,11498,638,0,2,18,0,19650,8100,1703,13471,0
131,4059,1660,832,1314,41,38,274,1701,20,312,209,395,332,604,2671,5058,12,64042,3557,1,2,6,2,19650,8102,1704,13473,0
131,4059,1057,646,719,113,100,145,1170,18,215,134,248,233,382,1740,3004,10,31186,1732,1,2,6,2,19660,8103,1705,13474,0
62,2549,1289,550,1043,56,32,155,1345,10,167,93,185,177,278,1266,2075,5,11498,638,0,2,18,0,19660,8105,1706,13475,0
11,366,85,59,61,8,0,16,93,5,18,10,18,23,28,86,126,2,316,17,0,0,73,0,19660,8105,1706,13476,1
11,366,85,59,61,8,0,16,93,5,18,10,18,23,28,86,126,2,316,17,0,2,1,1,19660,8105,1706,13477,0
195,4418,722,423,573,19,0,135,741,12,172,101,199,184,300,1320,2257,6,15668,870,0,2,4,3,19660,8107,1706,13479,0
195,4418,1508,847,911,44,250,301,1552,14,148,88,169,162,257,1120,1886,7,15077,837,0,2,4,3,19660,8108,1707,13480,0
27,1034,1293,570,1093,25,15,163,1318,10,195,123,241,205,364,1516,2795,6,17273,959,0,2,7,5,19670,8110,1707,13481,0
54,1029,1098,241,925,5,10,155,1103,7,46,25,49,53,74,273,423,3,1580,87,0,2,0,6,19680,8112,1707,13482,1
54,1029,282,202,222,14,2,44,296,8,42,24,43,50,67,250,378,4,1548,86,0,2,0,6,19680,8113,1707,13483,1
36,1369,1098,241,925,5,10,155,1103,7,46,25,49,53,74,273,423,3,1580,87,0,2,33,4,19690,8115,1707,13484,1
115,2873,1660,832,1314,41,38,274,1701,20,312,209,395,332,604,2671,5058,12,64042,3557,1,2,2,1,19690,8117,1708,13486,0
36,1381,1098,241,925,5,10,155,1103,7,46,25,49,53,74,273,423,3,1580,87,0,2,2,2,19700,8119,1708,13487,1
29,599,215,129,180,6,0,29,221,8,65,43,72,73,115,415,711,4,3153,175,0,2,2,2,19700,8119,1708,13488,0
29,599,97,69,77,3,3,16,100,6,22,13,23,28,36,113,173,3,542,30,0,2,2,2,19700,8120,1708,13489,0
15,1203,215,129,180,6,0,29,221,8,65,43,72,73,115,415,711,4,3153,175,0,2,20,0,19700,8120,1708,13490,0
110,2409,1043,504,840,53,9,147,1096,9,180,112,198,189,310,1377,2344,4,11604,644,0,2,9,1,19700,8122,1708,13491,1
110,2409,383,288,292,26,6,62,409,11,65,38,67,76,105,429,656,5,3719,206,0,2,9,1,19700,8123,1708,13492,1
48,1985,1043,504,840,53,9,147,1096,9,180,112,198,189,310,1377,2344,4,11604,644,0,2,15,0,19700,8125,1708,13493,1
170,3779,77,34,69,0,0,8,77,3,24,16,29,27,45,114,213,1,387,21,0,2,0,7,19700,8125,1708,13494,1
170,3779,712,438,573,51,9,84,763,14,102,71,128,116,199,733,1364,8,11988,666,0,2,0,7,19710,8126,1708,13495,1
441,9544,72,33,56,0,4,12,72,1,1,1,1,2,2,0,2,0,1,0,0,2,10,1,19710,8126,1708,13496,1
441,9544,1454,835,1044,76,110,219,1530,17,275,158,296,292,454,2297,3718,9,34017,1889,1,2,10,1,19720,8127,1708,13497,1
22,555,465,148,393,5,8,60,470,4,31,20,31,35,51,161,261,2,523,29,0,2,37,0,19720,8128,1708,13498,1
22,555,16,12,9,0,0,6,16,1,2,1,2,3,3,2,4,0,2,0,0,2,37,0,19720,8128,1708,13499,1
11,370,85,59,61,8,0,16,93,5,18,10,18,23,28,86,126,2,316,17,0,2,2,1,19720,8128,1708,13500,0
110,2406,1043,504,840,53,9,147,1096,9,180,112,198,189,310,1377,2344,4,11604,644,0,2,5,4,19720,8130,1708,13501,1
110,2406,383,288,292,26,6,62,409,11,65,38,67,76,105,429,656,5,3719,206,0,2,5,4,19720,8131,1708,13502,1
50,2071,1043,504,840,53,9,147,1096,9,180,112,198,189,310,1377,2344,4,11604,644,0,2,13,0,19720,8133,1708,13503,1
170,3779,77,34,69,0,0,8,77,3,24,16,29,27,45,114,213,1,387,21,0,2,0,7,19720,8133,1708,13504,0
170,3779,712,438,573,51,9,84,763,14,102,71,128,116,199,733,1364,8,11988,666,0,2,0,7,19730,8134,1708,13505,0
441,9544,72,33,56,0,4,12,72,1,1,1,1,2,2,0,2,0,1,0,0,2,10,1,19730,8134,1708,13506,0
441,9544,1454,835,1044,76,110,219,1530,17,275,158,296,292,454,2297,3718,9,34017,1889,1,2,10,1,19740,8135,1708,13507,0
11,370,85,59,61,8,0,16,93,5,18,10,18,23,28,86,126,2,316,17,0,2,2,1,19740,8135,1708,13508,0
22,555,465,148,393,5,8,60,470,4,31,20,31,35,51,161,261,2,523,29,0,2,37,0,19740,8136,1708,13509,0
22,555,16,12,9,0,0,6,16,1,2,1,2,3,3,2,4,0,2,0,0,2,37,0,19740,8136,1708,13510,0
118,4924,139,89,101,2,0,35,141,7,54,34,62,61,96,330,569,4,2287,127,0,2,55,1,19740,8136,1708,13511,1
118,4924,7,5,5,0,0,2,7,1,2,1,2,3,3,2,4,0,2,0,0,2,55,1,19740,8136,1708,13512,1
119,5017,139,89,101,2,0,35,141,7,54,34,62,61,96,330,569,4,2287,127,0,2,33,1,19740,8136,1708,13513,1
119,5017,7,5,5,0,0,2,7,1,2,1,2,3,3,2,4,0,2,0,0,2,33,1,19740,8136,1708,13514,1
444,9618,72,33,56,0,4,12,72,1,1,1,1,2,2,0,2,0,1,0,0,2,44,36,19740,8136,1708,13515,1
444,9618,1454,835,1044,76,110,219,1530,17,275,158,296,292,454,2297,3718,9,34017,1889,1,2,44,36,19750,8137,1708,13516,1
120,5065,139,89,101,2,0,35,141,7,54,34,62,61,96,330,569,4,2287,127,0,2,15,1,19750,8137,1708,13517,1
120,5065,7,5,5,0,0,2,7,1,2,1,2,3,3,2,4,0,2,0,0,2,15,1,19750,8137,1708,13518,1
50,2075,1043,504,840,53,9,147,1096,9,180,112,198,189,310,1377,2344,4,11604,644,0,2,2,0,19750,8139,1708,13519,1
444,9616,72,33,56,0,4,12,72,1,1,1,1,2,2,0,2,0,1,0,0,2,4,5,19750,8139,1708,13520,1
444,9616,1454,835,1044,76,110,219,1530,17,275,158,296,292,454,2297,3718,9,34017,1889,1,2,4,5,19760,8140,1708,13521,1
446,9627,72,33,56,0,4,12,72,1,1,1,1,2,2,0,2,0,1,0,0,2,31,24,19760,8140,1708,13522,1
446,9627,1454,835,1044,76,110,219,1530,17,275,158,296,292,454,2297,3718,9,34017,1889,1,2,31,24,19770,8141,1708,13523,1
111,2398,1043,504,840,53,9,147,1096,9,180,112,198,189,310,1377,2344,4,11604,644,0,2,12,12,19770,8143,1708,13524,1
111,2398,383,288,292,26,6,62,409,11,65,38,67,76,105,429,656,5,3719,206,0,2,12,12,19770,8144,1708,13525,1
50,2070,1043,504,840,53,9,147,1096,9,180,112,198,189,310,1377,2344,4,11604,644,0,2,2,2,19770,8146,1708,13526,1
446,9641,72,33,56,0,4,12,72,1,1,1,1,2,2,0,2,0,1,0,0,2,4,0,19770,8146,1708,13527,1
446,9641,1454,835,1044,76,110,219,1530,17,275,158,296,292,454,2297,3718,9,34017,1889,1,2,4,0,19780,8147,1708,13528,1
120,5027,139,89,101,2,0,35,141,7,54,34,62,61,96,330,569,4,2287,127,0,2,8,11,19780,8147,1708,13529,1
120,5027,7,5,5,0,0,2,7,1,2,1,2,3,3,2,4,0,2,0,0,2,8,11,19780,8147,1708,13530,1
29,556,127,75,83,2,11,30,129,4,14,7,14,18,21,61,87,2,175,9,0,2,4,18,19780,8147,1708,13531,0
29,556,652,304,544,16,6,88,668,6,89,51,101,95,152,591,998,3,3399,188,0,2,4,18,19780,8148,1708,13532,0
29,556,2,2,2,0,0,0,2,0,0,0,0,0,0,0,0,0,0,0,0,2,4,18,19780,8148,1708,13532,0
29,556,8,5,5,0,0,3,8,0,0,0,0,0,0,0,0,0,0,0,0,2,4,18,19780,8148,1708,13533,0
29,556,2,2,2,0,0,0,2,0,0,0,0,0,0,0,0,0,0,0,0,2,4,18,19780,8148,1708,13533,0
29,556,14,8,8,0,0,6,14,0,0,0,0,0,0,0,0,0,0,0,0,2,4,18,19780,8148,1708,13534,0
29,556,6,4,4,0,0,2,6,0,0,0,0,0,0,0,0,0,0,0,0,2,4,18,19780,8148,1708,13535,0
29,556,6,4,4,0,0,2,6,1,2,1,2,3,3,2,4,0,2,0,0,2,4,18,19780,8148,1708,13536,0
29,556,6,4,4,0,0,2,6,0,0,0,0,0,0,0,0,0,0,0,0,2,4,18,19780,8148,1708,13537,0
29,556,7,5,5,0,0,2,7,0,0,0,0,0,0,0,0,0,0,0,0,2,4,18,19780,8148,1708,13538,0
29,556,6,4,4,0,0,2,6,0,0,0,0,0,0,0,0,0,0,0,0,2,4,18,19780,8148,1708,13539,0
29,556,10,6,6,0,0,4,10,0,0,0,0,0,0,0,0,0,0,0,0,2,4,18,19780,8148,1708,13540,0
29,556,1,1,1,0,0,0,1,0,0,0,0,0,0,0,0,0,0,0,0,2,4,18,19780,8148,1708,13540,0
29,556,14,10,10,0,0,4,14,1,1,1,1,2,2,0,2,0,1,0,0,2,4,18,19780,8148,1708,13541,0
29,556,46,26,30,3,0,12,49,3,6,3,6,9,9,20,28,1,42,2,0,2,4,18,19790,8148,1708,13542,0
42,1782,1513,682,1277,25,13,200,1538,11,199,116,219,210,335,1557,2584,6,15641,868,0,2,3,3,19790,8150,1708,13543,0
39,1924,1457,730,1242,11,6,188,1468,10,292,166,329,302,495,2424,4078,5,22973,1276,1,2,1,1,19790,8152,1708,13544,0
30,1496,652,304,544,16,6,88,668,6,89,51,101,95,152,591,998,3,3399,188,0,2,1,1,19790,8153,1708,13545,0
48,2093,1020,354,843,12,15,144,1032,8,134,77,144,142,221,970,1580,4,6792,377,0,2,3,3,19790,8153,1708,13546,0
36,1381,1098,241,925,5,10,155,1103,7,46,25,49,53,74,273,423,3,1580,87,0,2,2,2,19800,8155,1708,13547,0
28,546,127,75,83,2,11,30,129,4,14,7,14,18,21,61,87,2,175,9,0,2,2,5,19800,8155,1708,13548,0
28,546,652,304,544,16,6,88,668,6,89,51,101,95,152,591,998,3,3399,188,0,2,2,5,19800,8156,1708,13549,0
28,546,2,2,2,0,0,0,2,0,0,0,0,0,0,0,0,0,0,0,0,2,2,5,19800,8156,1708,13549,0
28,546,8,5,5,0,0,3,8,0,0,0,0,0,0,0,0,0,0,0,0,2,2,5,19800,8156,1708,13550,0
28,546,2,2,2,0,0,0,2,0,0,0,0,0,0,0,0,0,0,0,0,2,2,5,19800,8156,1708,13550,0
28,546,14,8,8,0,0,6,14,0,0,0,0,0,0,0,0,0,0,0,0,2,2,5,19800,8156,1708,13551,0
28,546,6,4,4,0,0,2,6,0,0,0,0,0,0,0,0,0,0,0,0,2,2,5,19800,8156,1708,13552,0
28,546,6,4,4,0,0,2,6,1,2,1,2,3,3,2,4,0,2,0,0,2,2,5,19800,8156,1708,13553,0
28,546,6,4,4,0,0,2,6,0,0,0,0,0,0,0,0,0,0,0,0,2,2,5,19800,8156,1708,13554,0
28,546,7,5,5,0,0,2,7,0,0,0,0,0,0,0,0,0,0,0,0,2,2,5,19800,8156,1708,13555,0
28,546,6,4,4,0,0,2,6,0,0,0,0,0,0,0,0,0,0,0,0,2,2,5,19800,8156,1708,13556,0
28,546,10,6,6,0,0,4,10,0,0,0,0,0,0,0,0,0,0,0,0,2,2,5,19800,8156,1708,13557,0
28,546,1,1,1,0,0,0,1,0,0,0,0,0,0,0,0,0,0,0,0,2,2,5,19800,8156,1708,13557,0
28,546,14,10,10,0,0,4,14,1,1,1,1,2,2,0,2,0,1,0,0,2,2,5,19800,8156,1708,13558,0
28,546,46,26,30,3,0,12,49,3,6,3,6,9,9,20,28,1,42,2,0,2,2,5,19810,8156,1708,13559,0
66,1213,1020,354,843,12,15,144,1032,8,134,77,144,142,221,970,1580,4,6792,377,0,2,7,1,19810,8156,1708,13560,1
50,2222,1020,354,843,12,15,144,1032,8,134,77,144,142,221,970,1580,4,6792,377,0,2,23,1,19810,8156,1708,13561,1
131,4059,1660,832,1314,41,38,274,1701,20,312,209,395,332,604,2671,5058,12,64042,3557,1,2,1,1,19810,8158,1709,13563,0
131,4059,1057,646,719,113,100,145,1170,18,215,134,248,233,382,1740,3004,10,31186,1732,1,2,1,1,19820,8159,1710,13564,0
30,640,2,2,2,0,0,0,2,0,0,0,0,0,0,0,0,0,0,0,0,2,7,4,19820,8159,1710,13564,1
30,640,99,48,90,1,3,5,100,0,0,0,0,0,0,0,0,0,0,0,0,2,7,4,19820,8160,1710,13565,1
30,640,8,5,5,2,0,1,10,0,0,0,0,0,0,0,0,0,0,0,0,2,7,4,19820,8160,1710,13566,1
30,640,1217,716,841,84,126,174,1301,14,185,118,215,199,333,1446,2542,8,20687,1149,0,2,7,4,19830,8162,1710,13567,1
30,640,160,89,115,0,13,31,160,7,15,11,17,22,28,78,124,3,495,27,0,2,7,4,19830,8162,1710,13568,1
30,640,10,10,9,9,0,0,19,0,0,0,0,0,0,0,0,0,0,0,0,2,7,4,19830,8162,1711,13569,1
30,640,173,84,99,8,29,36,181,5,12,7,13,17,20,54,81,2,221,12,0,2,7,4,19830,8163,1711,13570,1
30,640,3,1,1,3,0,0,6,0,0,0,0,0,0,0,0,0,0,0,0,2,7,4,19830,8163,1711,13571,1
75,1656,477,336,357,30,23,73,507,16,194,134,250,210,384,1538,2962,10,30538,1696,0,2,67,37,19840,8164,1711,13572,1
30,619,2,2,2,0,0,0,2,0,0,0,0,0,0,0,0,0,0,0,0,2,4,2,19840,8164,1711,13572,0
30,619,99,48,90,1,3,5,100,0,0,0,0,0,0,0,0,0,0,0,0,2,4,2,19840,8165,1711,13573,0
30,619,8,5,5,2,0,1,10,0,0,0,0,0,0,0,0,0,0,0,0,2,4,2,19840,8165,1711,13574,0
30,619,1217,716,841,84,126,174,1301,14,185,118,215,199,333,1446,2542,8,20687,1149,0,2,4,2,19850,8167,1711,13575,0
30,619,160,89,115,0,13,31,160,7,15,11,17,22,28,78,124,3,495,27,0,2,4,2,19850,8167,1711,13576,0
30,619,10,10,9,9,0,0,19,0,0,0,0,0,0,0,0,0,0,0,0,2,4,2,19850,8167,1712,13577,0
30,619,173,84,99,8,29,36,181,5,12,7,13,17,20,54,81,2,221,12,0,2,4,2,19850,8168,1712,13578,0
30,619,3,1,1,3,0,0,6,0,0,0,0,0,0,0,0,0,0,0,0,2,4,2,19850,8168,1712,13579,0
74,1566,477,336,357,30,23,73,507,16,194,134,250,210,384,1538,2962,10,30538,1696,0,2,10,7,19860,8169,1712,13580,0
30,617,2,2,2,0,0,0,2,0,0,0,0,0,0,0,0,0,0,0,0,2,2,4,19860,8169,1712,13580,1
30,617,99,48,90,1,3,5,100,0,0,0,0,0,0,0,0,0,0,0,0,2,2,4,19860,8170,1712,13581,1
30,617,8,5,5,2,0,1,10,0,0,0,0,0,0,0,0,0,0,0,0,2,2,4,19860,8170,1712,13582,1
30,617,1217,716,841,84,126,174,1301,14,185,118,215,199,333,1446,2542,8,20687,1149,0,2,2,4,19870,8172,1712,13583,1
30,617,160,89,115,0,13,31,160,7,15,11,17,22,28,78,124,3,495,27,0,2,2,4,19870,8172,1712,13584,1
30,617,10,10,9,9,0,0,19,0,0,0,0,0,0,0,0,0,0,0,0,2,2,4,19870,8172,1713,13585,1
30,617,173,84,99,8,29,36,181,5,12,7,13,17,20,54,81,2,221,12,0,2,2,4,19870,8173,1713,13586,1
30,617,3,1,1,3,0,0,6,0,0,0,0,0,0,0,0,0,0,0,0,2,2,4,19870,8173,1713,13587,1
73,1533,477,336,357,30,23,73,507,16,194,134,250,210,384,1538,2962,10,30538,1696,0,2,7,10,19880,8174,1713,13588,1
26,887,1455,414,1257,16,76,112,1471,5,41,23,46,46,69,231,381,2,1069,59,0,2,6,1,19880,8175,1713,13589,1
26,887,669,365,481,22,61,110,691,15,103,63,122,118,185,747,1273,8,11311,628,0,2,6,1,19890,8175,1714,13590,1
23,997,1455,414,1257,16,76,112,1471,5,41,23,46,46,69,231,381,2,1069,59,0,2,20,0,19890,8176,1714,13591,1
75,1656,477,336,357,30,23,73,507,16,194,134,250,210,384,1538,2962,10,30538,1696,0,2,1,1,19900,8177,1714,13592,1
50,1776,1450,624,1228,12,26,181,1462,14,306,186,354,320,540,2580,4493,8,36391,2021,1,2,10,0,19900,8179,1715,13593,1
50,2082,1043,504,840,53,9,147,1096,9,180,112,198,189,310,1377,2344,4,11604,644,0,2,3,1,19900,8181,1715,13594,1
446,9636,72,33,56,0,4,12,72,1,1,1,1,2,2,0,2,0,1,0,0,2,1,2,19900,8181,1715,13595,1
446,9636,1454,835,1044,76,110,219,1530,17,275,158,296,292,454,2297,3718,9,34017,1889,1,2,1,2,19910,8182,1715,13596,1
24,595,465,148,393,5,8,60,470,4,31,20,31,35,51,161,261,2,523,29,0,2,4,0,19910,8183,1715,13597,1
24,595,16,12,9,0,0,6,16,1,2,1,2,3,3,2,4,0,2,0,0,2,4,0,19910,8183,1715,13598,1
443,9662,72,33,56,0,4,12,72,1,1,1,1,2,2,0,2,0,1,0,0,2,15,10,19910,8183,1715,13599,1
443,9662,1454,835,1044,76,110,219,1530,17,275,158,296,292,454,2297,3718,9,34017,1889,1,2,15,10,19920,8184,1715,13600,1
62,2992,1338,495,1086,10,64,173,1348,11,122,82,157,133,239,883,1686,7,11934,663,0,2,29,0,19920,8186,1715,13601,1
443,9662,72,33,56,0,4,12,72,1,1,1,1,2,2,0,2,0,1,0,0,2,15,10,19920,8186,1715,13602,0
443,9662,1454,835,1044,76,110,219,1530,17,275,158,296,292,454,2297,3718,9,34017,1889,1,2,15,10,19930,8187,1715,13603,0
62,2992,1338,495,1086,10,64,173,1348,11,122,82,157,133,239,883,1686,7,11934,663,0,2,29,0,19930,8189,1715,13604,0
444,9672,72,33,56,0,4,12,72,1,1,1,1,2,2,0,2,0,1,0,0,2,3,2,19930,8189,1715,13605,1
444,9672,1454,835,1044,76,110,219,1530,17,275,158,296,292,454,2297,3718,9,34017,1889,1,2,3,2,19940,8190,1715,13606,1
25,622,465,148,393,5,8,60,470,4,31,20,31,35,51,161,261,2,523,29,0,2,13,0,19940,8191,1715,13607,1
25,622,16,12,9,0,0,6,16,1,2,1,2,3,3,2,4,0,2,0,0,2,13,0,19940,8191,1715,13608,1
120,5034,139,89,101,2,0,35,141,7,54,34,62,61,96,330,569,4,2287,127,0,2,6,2,19940,8191,1715,13609,1
120,5034,7,5,5,0,0,2,7,1,2,1,2,3,3,2,4,0,2,0,0,2,6,2,19940,8191,1715,13610,1
440,9611,72,33,56,0,4,12,72,1,1,1,1,2,2,0,2,0,1,0,0,2,67,75,19940,8191,1715,13611,1
440,9611,1454,835,1044,76,110,219,1530,17,275,158,296,292,454,2297,3718,9,34017,1889,1,2,67,75,19950,8192,1715,13612,1
439,9596,72,33,56,0,4,12,72,1,1,1,1,2,2,0,2,0,1,0,0,2,0,2,19950,8192,1715,13613,0
439,9596,1454,835,1044,76,110,219,1530,17,275,158,296,292,454,2297,3718,9,34017,1889,1,2,0,2,19960,8193,1715,13614,0
163,3249,1943,715,1694,26,18,214,1969,12,185,120,237,197,357,1436,2721,7,20915,1161,0,2,8,0,19960,8195,1715,13615,1
163,3249,1168,838,957,57,25,144,1225,19,348,224,416,367,640,3018,5452,11,61921,3440,1,2,8,0,19970,8197,1715,13616,1
61,2682,1943,715,1694,26,18,214,1969,12,185,120,237,197,357,1436,2721,7,20915,1161,0,2,13,0,19970,8199,1715,13617,1
61,2680,1943,715,1694,26,18,214,1969,12,185,120,237,197,357,1436,2721,7,20915,1161,0,2,2,2,19970,8201,1715,13618,0
170,3786,77,34,69,0,0,8,77,3,24,16,29,27,45,114,213,1,387,21,0,2,4,0,19970,8201,1715,13619,1
170,3786,712,438,573,51,9,84,763,14,102,71,128,116,199,733,1364,8,11988,666,0,2,4,0,19980,8202,1715,13620,1
439,9723,72,33,56,0,4,12,72,1,1,1,1,2,2,0,2,0,1,0,0,2,180,149,19980,8202,1715,13621,1
439,9723,1454,835,1044,76,110,219,1530,17,275,158,296,292,454,2297,3718,9,34017,1889,1,2,180,149,19990,8203,1715,13622,1
62,2993,1338,495,1086,10,64,173,1348,11,122,82,157,133,239,883,1686,7,11934,663,0,2,1,1,19990,8205,1715,13623,1
120,5138,139,89,101,2,0,35,141,7,54,34,62,61,96,330,569,4,2287,127,0,2,15,16,19990,8205,1715,13624,1
120,5138,7,5,5,0,0,2,7,1,2,1,2,3,3,2,4,0,2,0,0,2,15,16,19990,8205,1715,13625,1
57,3235,1782,648,1425,9,47,279,1791,8,171,97,189,179,286,1292,2140,4,9462,525,0,2,2,2,19990,8206,1716,13626,1
165,3722,77,34,69,0,0,8,77,3,24,16,29,27,45,114,213,1,387,21,0,2,1,11,19990,8206,1716,13627,1
165,3722,712,438,573,51,9,84,763,14,102,71,128,116,199,733,1364,8,11988,666,0,2,1,11,20000,8207,1716,13628,1
431,9623,72,33,56,0,4,12,72,1,1,1,1,2,2,0,2,0,1,0,0,2,0,18,20000,8207,1716,13629,1
431,9623,1454,835,1044,76,110,219,1530,17,275,158,296,292,454,2297,3718,9,34017,1889,1,2,0,18,20010,8208,1716,13630,1
62,2899,1338,495,1086,10,64,173,1348,11,122,82,157,133,239,883,1686,7,11934,663,0,2,2,14,20010,8210,1716,13631,1
111,2393,1043,504,840,53,9,147,1096,9,180,112,198,189,310,1377,2344,4,11604,644,0,2,0,1,20010,8212,1716,13632,0
111,2393,383,288,292,26,6,62,409,11,65,38,67,76,105,429,656,5,3719,206,0,2,0,1,20010,8213,1716,13633,0
2,34,9,6,6,0,0,3,9,0,0,0,0,0,0,0,0,0,0,0,0,0,10,0,20010,8213,1716,13635,0
2,34,13,9,8,0,0,4,13,0,0,0,0,0,0,0,0,0,0,0,0,0,10,0,20010,8213,1716,13636,0
57,3230,1782,648,1425,9,47,279,1791,8,171,97,189,179,286,1292,2140,4,9462,525,0,2,1,1,20010,8214,1717,13637,0
433,9667,72,33,56,0,4,12,72,1,1,1,1,2,2,0,2,0,1,0,0,2,29,24,20010,8214,1717,13638,1
433,9667,1454,835,1044,76,110,219,1530,17,275,158,296,292,454,2297,3718,9,34017,1889,1,2,29,24,20020,8215,1717,13639,1
121,5214,139,89,101,2,0,35,141,7,54,34,62,61,96,330,569,4,2287,127,0,2,28,0,20020,8215,1717,13640,1
121,5214,7,5,5,0,0,2,7,1,2,1,2,3,3,2,4,0,2,0,0,2,28,0,20020,8215,1717,13641,1
57,3230,1782,648,1425,9,47,279,1791,8,171,97,189,179,286,1292,2140,4,9462,525,0,2,2,0,20020,8216,1718,13642,1
432,9610,72,33,56,0,4,12,72,1,1,1,1,2,2,0,2,0,1,0,0,2,7,14,20020,8216,1718,13643,0
432,9610,1454,835,1044,76,110,219,1530,17,275,158,296,292,454,2297,3718,9,34017,1889,1,2,7,14,20030,8217,1718,13644,0
61,2678,1943,715,1694,26,18,214,1969,12,185,120,237,197,357,1436,2721,7,20915,1161,0,2,1,1,20030,8219,1718,13645,0
163,3249,1943,715,1694,26,18,214,1969,12,185,120,237,197,357,1436,2721,7,20915,1161,0,2,8,0,20030,8221,1718,13646,0
163,3249,1168,838,957,57,25,144,1225,19,348,224,416,367,640,3018,5452,11,61921,3440,1,2,8,0,20040,8223,1718,13647,0
61,2678,1943,715,1694,26,18,214,1969,12,185,120,237,197,357,1436,2721,7,20915,1161,0,2,13,0,20040,8225,1718,13648,0
163,3249,1943,715,1694,26,18,214,1969,12,185,120,237,197,357,1436,2721,7,20915,1161,0,2,1,1,20040,8227,1718,13649,1
163,3249,1168,838,957,57,25,144,1225,19,348,224,416,367,640,3018,5452,11,61921,3440,1,2,1,1,20050,8229,1718,13650,1
61,2676,1943,715,1694,26,18,214,1969,12,185,120,237,197,357,1436,2721,7,20915,1161,0,2,2,2,20050,8231,1718,13651,0
61,2676,1943,715,1694,26,18,214,1969,12,185,120,237,197,357,1436,2721,7,20915,1161,0,2,2,2,20050,8233,1718,13652,0
431,9600,72,33,56,0,4,12,72,1,1,1,1,2,2,0,2,0,1,0,0,2,2,3,20050,8233,1718,13653,1
431,9600,1454,835,1044,76,110,219,1530,17,275,158,296,292,454,2297,3718,9,34017,1889,1,2,2,3,20060,8234,1718,13654,1
24,595,465,148,393,5,8,60,470,4,31,20,31,35,51,161,261,2,523,29,0,2,0,13,20060,8235,1718,13655,1
24,595,16,12,9,0,0,6,16,1,2,1,2,3,3,2,4,0,2,0,0,2,0,13,20060,8235,1718,13656,1
3,42,14,8,8,0,0,6,14,0,0,0,0,0,0,0,0,0,0,0,0,0,12,0,20060,8235,1718,13658,0
437,9678,72,33,56,0,4,12,72,1,1,1,1,2,2,0,2,0,1,0,0,2,61,46,20060,8235,1718,13659,1
437,9678,1454,835,1044,76,110,219,1530,17,275,158,296,292,454,2297,3718,9,34017,1889,1,2,61,46,20070,8236,1718,13660,1
229,4665,1457,730,1242,11,6,188,1468,10,292,166,329,302,495,2424,4078,5,22973,1276,1,2,1,2,20070,8238,1718,13661,1
229,4665,74,35,59,1,0,14,75,3,14,7,14,17,21,58,85,1,128,7,0,2,1,2,20070,8239,1718,13662,1
229,4665,245,125,200,5,7,34,250,7,30,17,34,37,51,166,265,3,1053,58,0,2,1,2,20080,8240,1718,13663,1
437,9677,72,33,56,0,4,12,72,1,1,1,1,2,2,0,2,0,1,0,0,2,5,5,20080,8240,1718,13664,1
437,9677,1454,835,1044,76,110,219,1530,17,275,158,296,292,454,2297,3718,9,34017,1889,1,2,5,5,20090,8241,1718,13665,1
439,9699,72,33,56,0,4,12,72,1,1,1,1,2,2,0,2,0,1,0,0,2,3,2,20090,8241,1718,13666,1
439,9699,1454,835,1044,76,110,219,1530,17,275,158,296,292,454,2297,3718,9,34017,1889,1,2,3,2,20100,8242,1718,13667,1
122,5273,139,89,101,2,0,35,141,7,54,34,62,61,96,330,569,4,2287,127,0,2,28,0,20100,8242,1718,13668,1
122,5273,7,5,5,0,0,2,7,1,2,1,2,3,3,2,4,0,2,0,0,2,28,0,20100,8242,1718,13669,1
439,9701,72,33,56,0,4,12,72,1,1,1,1,2,2,0,2,0,1,0,0,2,6,4,20100,8242,1718,13670,1
439,9701,1454,835,1044,76,110,219,1530,17,275,158,296,292,454,2297,3718,9,34017,1889,1,2,6,4,20110,8243,1718,13671,1
439,9685,72,33,56,0,4,12,72,1,1,1,1,2,2,0,2,0,1,0,0,2,0,2,20110,8243,1718,13672,1
439,9685,1454,835,1044,76,110,219,1530,17,275,158,296,292,454,2297,3718,9,34017,1889,1,2,0,2,20120,8244,1718,13673,1
63,2929,1338,495,1086,10,64,173,1348,11,122,82,157,133,239,883,1686,7,11934,663,0,2,18,0,20120,8246,1718,13674,1
439,9685,72,33,56,0,4,12,72,1,1,1,1,2,2,0,2,0,1,0,0,2,0,2,20120,8246,1718,13675,0
439,9685,1454,835,1044,76,110,219,1530,17,275,158,296,292,454,2297,3718,9,34017,1889,1,2,0,2,20130,8247,1718,13676,0
63,2929,1338,495,1086,10,64,173,1348,11,122,82,157,133,239,883,1686,7,11934,663,0,2,18,0,20130,8249,1718,13677,0
30,640,2,2,2,0,0,0,2,0,0,0,0,0,0,0,0,0,0,0,0,2,7,4,20140,8253,1719,13684,1
30,640,99,48,90,1,3,5,100,0,0,0,0,0,0,0,0,0,0,0,0,2,7,4,20140,8254,1719,13685,1
30,640,8,5,5,2,0,1,10,0,0,0,0,0,0,0,0,0,0,0,0,2,7,4,20140,8254,1719,13686,1
30,640,1217,716,841,84,126,174,1301,14,185,118,215,199,333,1446,2542,8,20687,1149,0,2,7,4,20150,8256,1719,13687,1
30,640,160,89,115,0,13,31,160,7,15,11,17,22,28,78,124,3,495,27,0,2,7,4,20150,8256,1719,13688,1
30,640,10,10,9,9,0,0,19,0,0,0,0,0,0,0,0,0,0,0,0,2,7,4,20150,8256,1720,13689,1
30,640,173,84,99,8,29,36,181,5,12,7,13,17,20,54,81,2,221,12,0,2,7,4,20150,8257,1720,13690,1
30,640,3,1,1,3,0,0,6,0,0,0,0,0,0,0,0,0,0,0,0,2,7,4,20150,8257,1720,13691,1
131,4059,1660,832,1314,41,38,274,1701,20,312,209,395,332,604,2671,5058,12,64042,3557,1,2,1,1,20150,8259,1721,13693,1
131,4059,1057,646,719,113,100,145,1170,18,215,134,248,233,382,1740,3004,10,31186,1732,1,2,1,1,20160,8260,1722,13694,1
75,1656,477,336,357,30,23,73,507,16,194,134,250,210,384,1538,2962,10,30538,1696,0,2,66,36,20170,8261,1722,13695,1
13,442,42,7,35,4,0,5,46,1,2,1,2,3,3,2,4,0,2,0,0,2,2,2,20170,8261,1722,13696,1
13,442,11,6,10,0,0,1,11,2,4,2,4,6,6,10,15,1,15,0,0,2,2,2,20170,8261,1722,13697,1
50,1776,1450,624,1228,12,26,181,1462,14,306,186,354,320,540,2580,4493,8,36391,2021,1,2,10,0,20170,8263,1723,13698,1
13,442,42,7,35,4,0,5,46,1,2,1,2,3,3,2,4,0,2,0,0,2,1,1,20180,8267,1724,13706,1
13,442,11,6,10,0,0,1,11,2,4,2,4,6,6,10,15,1,15,0,0,2,1,1,20180,8267,1724,13707,1
51,1803,1450,624,1228,12,26,181,1462,14,306,186,354,320,540,2580,4493,8,36391,2021,1,2,13,0,20180,8269,1725,13708,1
61,2674,1943,715,1694,26,18,214,1969,12,185,120,237,197,357,1436,2721,7,20915,1161,0,2,0,1,20180,8271,1725,13709,0
13,442,42,7,35,4,0,5,46,1,2,1,2,3,3,2,4,0,2,0,0,2,1,1,20180,8271,1725,13710,0
13,442,11,6,10,0,0,1,11,2,4,2,4,6,6,10,15,1,15,0,0,2,1,1,20180,8271,1725,13711,0
1,225,382,65,130,157,2,92,539,4,10,5,10,14,15,41,57,2,114,6,0,2,2,2,20180,8272,1726,13712,0
1,245,382,65,130,157,2,92,539,4,10,5,10,14,15,41,57,2,114,6,0,2,4,1,20180,8273,1727,13714,0
1,270,382,65,130,157,2,92,539,4,10,5,10,14,15,41,57,2,114,6,0,2,14,0,20180,8274,1728,13715,0
1,272,382,65,130,157,2,92,539,4,10,5,10,14,15,41,57,2,114,6,0,2,1,0,20180,8275,1729,13716,0
1,274,382,65,130,157,2,92,539,4,10,5,10,14,15,41,57,2,114,6,0,2,1,0,20180,8276,1730,13717,0
1,276,382,65,130,157,2,92,539,4,10,5,10,14,15,41,57,2,114,6,0,2,2,1,20180,8277,1731,13718,1
1,279,382,65,130,157,2,92,539,4,10,5,10,14,15,41,57,2,114,6,0,2,3,1,20180,8278,1732,13719,0
42,1312,1523,757,1297,19,12,193,1542,12,193,117,230,205,347,1508,2664,7,19053,1058,0,2,7,7,20190,8280,1732,13720,1
42,1312,701,378,504,33,58,109,734,13,110,68,126,123,194,794,1346,7,10027,557,0,2,7,7,20190,8281,1733,13721,1
39,2399,1523,757,1297,19,12,193,1542,12,193,117,230,205,347,1508,2664,7,19053,1058,0,2,13,1,20200,8283,1733,13722,1
439,9687,72,33,56,0,4,12,72,1,1,1,1,2,2,0,2,0,1,0,0,2,1,0,20200,8283,1733,13723,1
439,9687,1454,835,1044,76,110,219,1530,17,275,158,296,292,454,2297,3718,9,34017,1889,1,2,1,0,20210,8284,1733,13724,1
39,2393,1523,757,1297,19,12,193,1542,12,193,117,230,205,347,1508,2664,7,19053,1058,0,2,1,1,20220,8286,1733,13725,0
435,9731,72,33,56,0,4,12,72,1,1,1,1,2,2,0,2,0,1,0,0,2,17,8,20220,8286,1733,13726,1
435,9731,1454,835,1044,76,110,219,1530,17,275,158,296,292,454,2297,3718,9,34017,1889,1,2,17,8,20230,8287,1733,13727,1
124,5341,139,89,101,2,0,35,141,7,54,34,62,61,96,330,569,4,2287,127,0,2,34,0,20230,8287,1733,13728,1
124,5341,7,5,5,0,0,2,7,1,2,1,2,3,3,2,4,0,2,0,0,2,34,0,20230,8287,1733,13729,1
42,1312,1523,757,1297,19,12,193,1542,12,193,117,230,205,347,1508,2664,7,19053,1058,0,2,7,7,20240,8289,1733,13730,0
42,1312,701,378,504,33,58,109,734,13,110,68,126,123,194,794,1346,7,10027,557,0,2,7,7,20240,8290,1734,13731,0
435,9733,72,33,56,0,4,12,72,1,1,1,1,2,2,0,2,0,1,0,0,2,17,8,20240,8290,1734,13732,0
435,9733,1454,835,1044,76,110,219,1530,17,275,158,296,292,454,2297,3718,9,34017,1889,1,2,17,8,20250,8291,1734,13733,0
124,5341,139,89,101,2,0,35,141,7,54,34,62,61,96,330,569,4,2287,127,0,2,34,0,20250,8291,1734,13734,0
124,5341,7,5,5,0,0,2,7,1,2,1,2,3,3,2,4,0,2,0,0,2,34,0,20250,8291,1734,13735,0
39,2393,1523,757,1297,19,12,193,1542,12,193,117,230,205,347,1508,2664,7,19053,1058,0,2,13,1,20260,8293,1734,13736,0
435,9731,72,33,56,0,4,12,72,1,1,1,1,2,2,0,2,0,1,0,0,2,0,1,20260,8293,1734,13737,0
435,9731,1454,835,1044,76,110,219,1530,17,275,158,296,292,454,2297,3718,9,34017,1889,1,2,0,1,20270,8294,1734,13738,0
435,9729,72,33,56,0,4,12,72,1,1,1,1,2,2,0,2,0,1,0,0,2,2,1,20270,8294,1734,13739,1
435,9729,1454,835,1044,76,110,219,1530,17,275,158,296,292,454,2297,3718,9,34017,1889,1,2,2,1,20280,8295,1734,13740,1
58,3261,1782,648,1425,9,47,279,1791,8,171,97,189,179,286,1292,2140,4,9462,525,0,2,16,0,20280,8296,1735,13741,1
39,2401,1523,757,1297,19,12,193,1542,12,193,117,230,205,347,1508,2664,7,19053,1058,0,2,1,1,20290,8298,1735,13742,0
435,9729,72,33,56,0,4,12,72,1,1,1,1,2,2,0,2,0,1,0,0,2,2,2,20290,8298,1735,13743,1
435,9729,1454,835,1044,76,110,219,1530,17,275,158,296,292,454,2297,3718,9,34017,1889,1,2,2,2,20300,8299,1735,13744,1
58,3259,1782,648,1425,9,47,279,1791,8,171,97,189,179,286,1292,2140,4,9462,525,0,2,1,1,20300,8300,1736,13745,0
229,4665,1457,730,1242,11,6,188,1468,10,292,166,329,302,495,2424,4078,5,22973,1276,1,2,2,2,20310,8306,1737,13753,1
229,4665,74,35,59,1,0,14,75,3,14,7,14,17,21,58,85,1,128,7,0,2,2,2,20310,8307,1737,13754,1
229,4665,245,125,200,5,7,34,250,7,30,17,34,37,51,166,265,3,1053,58,0,2,2,2,20320,8308,1737,13755,1
13,442,42,7,35,4,0,5,46,1,2,1,2,3,3,2,4,0,2,0,0,2,1,1,20320,8308,1737,13756,1
13,442,11,6,10,0,0,1,11,2,4,2,4,6,6,10,15,1,15,0,0,2,1,1,20320,8308,1737,13757,1
1,279,382,65,130,157,2,92,539,4,10,5,10,14,15,41,57,2,114,6,0,2,24,2,20320,8309,1738,13759,0
1,279,382,65,130,157,2,92,539,4,10,5,10,14,15,41,57,2,114,6,0,2,2,2,20320,8310,1739,13760,0
1,279,382,65,130,157,2,92,539,4,10,5,10,14,15,41,57,2,114,6,0,2,3,3,20320,8311,1740,13761,0
75,1645,477,336,357,30,23,73,507,16,194,134,250,210,384,1538,2962,10,30538,1696,0,2,2,6,20340,8316,1741,13769,1
13,442,42,7,35,4,0,5,46,1,2,1,2,3,3,2,4,0,2,0,0,2,1,1,20340,8316,1741,13770,1
13,442,11,6,10,0,0,1,11,2,4,2,4,6,6,10,15,1,15,0,0,2,1,1,20340,8316,1741,13771,1
66,1213,1020,354,843,12,15,144,1032,8,134,77,144,142,221,970,1580,4,6792,377,0,2,1,1,20340,8316,1741,13772,1
51,2245,1020,354,843,12,15,144,1032,8,134,77,144,142,221,970,1580,4,6792,377,0,2,4,0,20340,8316,1741,13773,1
66,1213,1020,354,843,12,15,144,1032,8,134,77,144,142,221,970,1580,4,6792,377,0,2,1,1,20340,8316,1741,13774,0
51,2245,1020,354,843,12,15,144,1032,8,134,77,144,142,221,970,1580,4,6792,377,0,2,4,0,20340,8316,1741,13775,0
62,2549,1289,550,1043,56,32,155,1345,10,167,93,185,177,278,1266,2075,5,11498,638,0,2,2,2,20340,8318,1742,13776,0
131,4059,1660,832,1314,41,38,274,1701,20,312,209,395,332,604,2671,5058,12,64042,3557,1,2,3,3,20340,8320,1743,13778,1
131,4059,1057,646,719,113,100,145,1170,18,215,134,248,233,382,1740,3004,10,31186,1732,1,2,3,3,20350,8321,1744,13779,1
229,4665,1457,730,1242,11,6,188,1468,10,292,166,329,302,495,2424,4078,5,22973,1276,1,2,6,5,20350,8323,1744,13780,1
229,4665,74,35,59,1,0,14,75,3,14,7,14,17,21,58,85,1,128,7,0,2,6,5,20350,8324,1744,13781,1
229,4665,245,125,200,5,7,34,250,7,30,17,34,37,51,166,265,3,1053,58,0,2,6,5,20360,8325,1744,13782,1
42,1119,74,35,59,1,0,14,75,3,14,7,14,17,21,58,85,1,128,7,0,2,1,1,20360,8326,1744,13783,1
42,1119,245,125,200,5,7,34,250,7,30,17,34,37,51,166,265,3,1053,58,0,2,1,1,20370,8327,1744,13784,1
44,432,647,139,84,35,284,233,682,0,0,0,0,0,0,0,0,0,0,0,0,2,2,2,20370,8327,1744,13785,1
165,3720,77,34,69,0,0,8,77,3,24,16,29,27,45,114,213,1,387,21,0,2,1,1,20370,8327,1744,13786,1
165,3720,712,438,573,51,9,84,763,14,102,71,128,116,199,733,1364,8,11988,666,0,2,1,1,20380,8328,1744,13787,1
66,1213,1020,354,843,12,15,144,1032,8,134,77,144,142,221,970,1580,4,6792,377,0,2,4,4,20380,8328,1744,13788,1
23,407,424,94,331,4,0,89,428,1,5,5,5,6,10,11,25,0,12,0,0,2,1,1,20380,8329,1744,13789,1
23,407,38,23,23,6,0,8,44,3,11,7,11,14,18,42,68,1,102,5,0,2,1,1,20380,8329,1744,13790,1
195,4406,722,423,573,19,0,135,741,12,172,101,199,184,300,1320,2257,6,15668,870,0,2,7,7,20380,8331,1744,13792,1
195,4406,1508,847,911,44,250,301,1552,14,148,88,169,162,257,1120,1886,7,15077,837,0,2,7,7,20380,8332,1745,13793,1
435,9729,72,33,56,0,4,12,72,1,1,1,1,2,2,0,2,0,1,0,0,2,3,3,20380,8332,1745,13794,1
435,9729,1454,835,1044,76,110,219,1530,17,275,158,296,292,454,2297,3718,9,34017,1889,1,2,3,3,20390,8333,1745,13795,1
111,2393,1043,504,840,53,9,147,1096,9,180,112,198,189,310,1377,2344,4,11604,644,0,2,6,4,20390,8335,1745,13796,1
111,2393,383,288,292,26,6,62,409,11,65,38,67,76,105,429,656,5,3719,206,0,2,6,4,20390,8336,1745,13797,1
86,1513,1178,367,1042,6,15,115,1184,9,94,51,95,103,146,644,976,4,4439,246,0,2,6,6,20390,8336,1745,13798,1
86,1513,177,108,140,8,0,27,185,6,30,16,32,36,48,162,248,3,794,44,0,2,6,6,20390,8338,1745,13799,1
163,3247,1943,715,1694,26,18,214,1969,12,185,120,237,197,357,1436,2721,7,20915,1161,0,2,1,1,20390,8340,1745,13800,1
163,3247,1168,838,957,57,25,144,1225,19,348,224,416,367,640,3018,5452,11,61921,3440,1,2,1,1,20400,8342,1745,13801,1
56,983,282,196,195,3,0,86,285,8,130,71,141,138,212,936,1507,4,6538,363,0,2,1,1,20400,8342,1746,13803,1
7,296,72,33,56,0,4,12,72,1,1,1,1,2,2,0,2,0,1,0,0,2,3,2,20400,8342,1746,13804,1
13,442,42,7,35,4,0,5,46,1,2,1,2,3,3,2,4,0,2,0,0,2,1,1,20400,8342,1746,13805,1
13,442,11,6,10,0,0,1,11,2,4,2,4,6,6,10,15,1,15,0,0,2,1,1,20400,8342,1746,13806,1
39,1920,1457,730,1242,11,6,188,1468,10,292,166,329,302,495,2424,4078,5,22973,1276,1,2,2,2,20400,8344,1746,13807,1
11,343,74,35,59,1,0,14,75,3,14,7,14,17,21,58,85,1,128,7,0,2,1,1,20400,8345,1746,13808,1
16,498,424,94,331,4,0,89,428,1,5,5,5,6,10,11,25,0,12,0,0,2,2,2,20400,8346,1746,13809,1
14,567,722,423,573,19,0,135,741,12,172,101,199,184,300,1320,2257,6,15668,870,0,2,1,1,20400,8348,1746,13811,1
12,404,386,256,301,16,9,68,402,4,59,35,69,63,104,355,621,2,1453,80,0,2,7,7,20400,8348,1746,13812,1
50,2058,1043,504,840,53,9,147,1096,9,180,112,198,189,310,1377,2344,4,11604,644,0,2,18,18,20400,8350,1746,13813,1
24,968,373,158,315,8,0,51,381,5,76,44,79,81,123,486,779,2,2026,112,0,2,2,2,20400,8350,1746,13814,1
7,514,442,244,305,14,16,103,456,11,68,45,75,79,120,452,756,6,4588,254,0,2,3,3,20400,8352,1746,13815,1
195,4406,722,423,573,19,0,135,741,12,172,101,199,184,300,1320,2257,6,15668,870,0,2,2,2,20400,8354,1746,13817,0
195,4406,1508,847,911,44,250,301,1552,14,148,88,169,162,257,1120,1886,7,15077,837,0,2,2,2,20400,8355,1747,13818,0
435,9729,72,33,56,0,4,12,72,1,1,1,1,2,2,0,2,0,1,0,0,2,1,1,20400,8355,1747,13819,0
435,9729,1454,835,1044,76,110,219,1530,17,275,158,296,292,454,2297,3718,9,34017,1889,1,2,1,1,20410,8356,1747,13820,0
39,1920,1457,730,1242,11,6,188,1468,10,292,166,329,302,495,2424,4078,5,22973,1276,1,2,1,1,20410,8358,1747,13821,0
42,1121,74,35,59,1,0,14,75,3,14,7,14,17,21,58,85,1,128,7,0,2,3,1,20410,8359,1747,13822,1
42,1121,245,125,200,5,7,34,250,7,30,17,34,37,51,166,265,3,1053,58,0,2,3,1,20420,8360,1747,13823,1
67,1216,1020,354,843,12,15,144,1032,8,134,77,144,142,221,970,1580,4,6792,377,0,2,19,1,20420,8360,1747,13824,0
54,2310,1020,354,843,12,15,144,1032,8,134,77,144,142,221,970,1580,4,6792,377,0,2,11,0,20420,8360,1747,13825,0
42,1121,74,35,59,1,0,14,75,3,14,7,14,17,21,58,85,1,128,7,0,2,3,1,20420,8361,1747,13826,0
42,1121,245,125,200,5,7,34,250,7,30,17,34,37,51,166,265,3,1053,58,0,2,3,1,20430,8362,1747,13827,0
42,1128,74,35,59,1,0,14,75,3,14,7,14,17,21,58,85,1,128,7,0,2,2,0,20430,8363,1747,13828,1
42,1128,245,125,200,5,7,34,250,7,30,17,34,37,51,166,265,3,1053,58,0,2,2,0,20440,8364,1747,13829,1
229,4667,1457,730,1242,11,6,188,1468,10,292,166,329,302,495,2424,4078,5,22973,1276,1,2,3,2,20440,8366,1747,13830,0
229,4667,74,35,59,1,0,14,75,3,14,7,14,17,21,58,85,1,128,7,0,2,3,2,20440,8367,1747,13831,0
229,4667,245,125,200,5,7,34,250,7,30,17,34,37,51,166,265,3,1053,58,0,2,3,2,20450,8368,1747,13832,0
163,3251,1943,715,1694,26,18,214,1969,12,185,120,237,197,357,1436,2721,7,20915,1161,0,2,1,1,20450,8370,1747,13833,1
163,3251,1168,838,957,57,25,144,1225,19,348,224,416,367,640,3018,5452,11,61921,3440,1,2,1,1,20460,8372,1747,13834,1
61,2682,1943,715,1694,26,18,214,1969,12,185,120,237,197,357,1436,2721,7,20915,1161,0,2,3,2,20460,8374,1747,13835,1
229,4665,1457,730,1242,11,6,188,1468,10,292,166,329,302,495,2424,4078,5,22973,1276,1,2,0,1,20460,8376,1747,13836,0
229,4665,74,35,59,1,0,14,75,3,14,7,14,17,21,58,85,1,128,7,0,2,0,1,20460,8377,1747,13837,0
229,4665,245,125,200,5,7,34,250,7,30,17,34,37,51,166,265,3,1053,58,0,2,0,1,20470,8378,1747,13838,0
55,2354,1020,354,843,12,15,144,1032,8,134,77,144,142,221,970,1580,4,6792,377,0,2,22,0,20470,8378,1747,13839,0
116,2937,1660,832,1314,41,38,274,1701,20,312,209,395,332,604,2671,5058,12,64042,3557,1,2,7,0,20470,8380,1748,13841,1
116,2937,1660,832,1314,41,38,274,1701,20,312,209,395,332,604,2671,5058,12,64042,3557,1,2,7,0,20470,8382,1749,13843,0
13,442,42,7,35,4,0,5,46,1,2,1,2,3,3,2,4,0,2,0,0,2,1,1,20470,8382,1749,13844,0
13,442,11,6,10,0,0,1,11,2,4,2,4,6,6,10,15,1,15,0,0,2,1,1,20470,8382,1749,13845,0
43,1834,1513,682,1277,25,13,200,1538,11,199,116,219,210,335,1557,2584,6,15641,868,0,2,23,0,20470,8384,1749,13846,0
171,3239,1513,682,1277,25,13,200,1538,11,199,116,219,210,335,1557,2584,6,15641,868,0,2,383,5,20470,8386,1749,13847,0
171,3239,819,519,539,24,98,155,843,15,96,57,106,111,163,690,1107,8,9171,509,0,2,383,5,20480,8388,1749,13848,0
118,4709,1513,682,1277,25,13,200,1538,11,199,116,219,210,335,1557,2584,6,15641,868,0,2,507,2,20480,8390,1749,13849,0
118,4607,1513,682,1277,25,13,200,1538,11,199,116,219,210,335,1557,2584,6,15641,868,0,2,100,68,20480,8392,1749,13850,0
170,3212,1513,682,1277,25,13,200,1538,11,199,116,219,210,335,1557,2584,6,15641,868,0,2,59,30,20480,8394,1749,13851,0
170,3212,819,519,539,24,98,155,843,15,96,57,106,111,163,690,1107,8,9171,509,0,2,59,30,20490,8396,1749,13852,0
169,3198,1513,682,1277,25,13,200,1538,11,199,116,219,210,335,1557,2584,6,15641,868,0,2,8,9,20490,8398,1749,13853,0
169,3198,819,519,539,24,98,155,843,15,96,57,106,111,163,690,1107,8,9171,509,0,2,8,9,20500,8400,1749,13854,0
169,3198,1513,682,1277,25,13,200,1538,11,199,116,219,210,335,1557,2584,6,15641,868,0,2,29,29,20500,8402,1749,13855,0
169,3198,819,519,539,24,98,155,843,15,96,57,106,111,163,690,1107,8,9171,509,0,2,29,29,20510,8404,1749,13856,0
168,3181,1513,682,1277,25,13,200,1538,11,199,116,219,210,335,1557,2584,6,15641,868,0,2,0,4,20510,8406,1749,13857,0
168,3181,819,519,539,24,98,155,843,15,96,57,106,111,163,690,1107,8,9171,509,0,2,0,4,20520,8408,1749,13858,0
168,3179,1513,682,1277,25,13,200,1538,11,199,116,219,210,335,1557,2584,6,15641,868,0,2,1,1,20520,8410,1749,13859,0
168,3179,819,519,539,24,98,155,843,15,96,57,106,111,163,690,1107,8,9171,509,0,2,1,1,20530,8412,1749,13860,0
168,3156,1513,682,1277,25,13,200,1538,11,199,116,219,210,335,1557,2584,6,15641,868,0,2,1,10,20530,8414,1749,13861,0
168,3156,819,519,539,24,98,155,843,15,96,57,106,111,163,690,1107,8,9171,509,0,2,1,10,20540,8416,1749,13862,0
118,4597,1513,682,1277,25,13,200,1538,11,199,116,219,210,335,1557,2584,6,15641,868,0,2,40,44,20540,8418,1749,13863,0
168,3156,1513,682,1277,25,13,200,1538,11,199,116,219,210,335,1557,2584,6,15641,868,0,2,2,0,20540,8420,1749,13864,0
168,3156,819,519,539,24,98,155,843,15,96,57,106,111,163,690,1107,8,9171,509,0,2,2,0,20550,8422,1749,13865,0
118,4597,1513,682,1277,25,13,200,1538,11,199,116,219,210,335,1557,2584,6,15641,868,0,2,2,0,20550,8424,1749,13866,0
168,3156,1513,682,1277,25,13,200,1538,11,199,116,219,210,335,1557,2584,6,15641,868,0,2,5,5,20550,8426,1749,13867,0
168,3156,819,519,539,24,98,155,843,15,96,57,106,111,163,690,1107,8,9171,509,0,2,5,5,20560,8428,1749,13868,0
73,1336,1513,682,1277,25,13,200,1538,11,199,116,219,210,335,1557,2584,6,15641,868,0,2,24,419,20560,8430,1749,13869,0
73,1336,819,519,539,24,98,155,843,15,96,57,106,111,163,690,1107,8,9171,509,0,2,24,419,20570,8432,1749,13870,0
43,1834,1513,682,1277,25,13,200,1538,11,199,116,219,210,335,1557,2584,6,15641,868,0,2,10,545,20570,8434,1749,13871,0
43,1824,1513,682,1277,25,13,200,1538,11,199,116,219,210,335,1557,2584,6,15641,868,0,2,2,2,20570,8436,1749,13872,0
435,9729,72,33,56,0,4,12,72,1,1,1,1,2,2,0,2,0,1,0,0,2,6,0,20570,8436,1749,13873,0
435,9729,1454,835,1044,76,110,219,1530,17,275,158,296,292,454,2297,3718,9,34017,1889,1,2,6,0,20580,8437,1749,13874,0
435,9729,72,33,56,0,4,12,72,1,1,1,1,2,2,0,2,0,1,0,0,2,16,6,20580,8437,1749,13875,0
435,9729,1454,835,1044,76,110,219,1530,17,275,158,296,292,454,2297,3718,9,34017,1889,1,2,16,6,20590,8438,1749,13876,0
435,9729,72,33,56,0,4,12,72,1,1,1,1,2,2,0,2,0,1,0,0,2,16,0,20590,8438,1749,13877,0
435,9729,1454,835,1044,76,110,219,1530,17,275,158,296,292,454,2297,3718,9,34017,1889,1,2,16,0,20600,8439,1749,13878,0
435,9729,72,33,56,0,4,12,72,1,1,1,1,2,2,0,2,0,1,0,0,2,16,0,20600,8439,1749,13879,1
435,9729,1454,835,1044,76,110,219,1530,17,275,158,296,292,454,2297,3718,9,34017,1889,1,2,16,0,20610,8440,1749,13880,1
168,3156,1513,682,1277,25,13,200,1538,11,199,116,219,210,335,1557,2584,6,15641,868,0,2,420,25,20610,8442,1749,13881,1
168,3156,819,519,539,24,98,155,843,15,96,57,106,111,163,690,1107,8,9171,509,0,2,420,25,20620,8444,1749,13882,1
121,4624,1513,682,1277,25,13,200,1538,11,199,116,219,210,335,1557,2584,6,15641,868,0,2,554,10,20620,8446,1749,13883,1
9,241,19,8,11,5,0,4,24,2,5,3,6,7,9,13,25,1,30,1,0,2,5,1,20630,8450,1750,13891,0
9,241,102,59,69,5,3,24,107,6,22,15,28,28,43,113,206,3,789,43,0,2,5,1,20630,8450,1750,13892,0
9,241,106,40,36,3,49,17,109,8,17,13,23,25,36,93,167,5,904,50,0,2,5,1,20630,8450,1750,13893,0
30,640,2,2,2,0,0,0,2,0,0,0,0,0,0,0,0,0,0,0,0,2,13,11,20630,8450,1750,13893,0
30,640,99,48,90,1,3,5,100,0,0,0,0,0,0,0,0,0,0,0,0,2,13,11,20630,8451,1750,13894,0
30,640,8,5,5,2,0,1,10,0,0,0,0,0,0,0,0,0,0,0,0,2,13,11,20630,8451,1750,13895,0
30,640,1217,716,841,84,126,174,1301,14,185,118,215,199,333,1446,2542,8,20687,1149,0,2,13,11,20640,8453,1750,13896,0
30,640,160,89,115,0,13,31,160,7,15,11,17,22,28,78,124,3,495,27,0,2,13,11,20640,8453,1750,13897,0
30,640,10,10,9,9,0,0,19,0,0,0,0,0,0,0,0,0,0,0,0,2,13,11,20640,8453,1751,13898,0
30,640,173,84,99,8,29,36,181,5,12,7,13,17,20,54,81,2,221,12,0,2,13,11,20640,8454,1751,13899,0
30,640,3,1,1,3,0,0,6,0,0,0,0,0,0,0,0,0,0,0,0,2,13,11,20640,8454,1751,13900,0
131,4059,1660,832,1314,41,38,274,1701,20,312,209,395,332,604,2671,5058,12,64042,3557,1,2,35,11,20640,8456,1752,13902,0
131,4059,1057,646,719,113,100,145,1170,18,215,134,248,233,382,1740,3004,10,31186,1732,1,2,35,11,20650,8457,1753,13903,0
75,1645,477,336,357,30,23,73,507,16,194,134,250,210,384,1538,2962,10,30538,1696,0,2,68,42,20660,8458,1753,13904,0
168,3156,1513,682,1277,25,13,200,1538,11,199,116,219,210,335,1557,2584,6,15641,868,0,2,451,32,20660,8460,1753,13905,0
168,3156,819,519,539,24,98,155,843,15,96,57,106,111,163,690,1107,8,9171,509,0,2,451,32,20670,8462,1753,13906,0
229,4665,1457,730,1242,11,6,188,1468,10,292,166,329,302,495,2424,4078,5,22973,1276,1,2,196,75,20670,8464,1753,13907,0
229,4665,74,35,59,1,0,14,75,3,14,7,14,17,21,58,85,1,128,7,0,2,196,75,20670,8465,1753,13908,0
229,4665,245,125,200,5,7,34,250,7,30,17,34,37,51,166,265,3,1053,58,0,2,196,75,20680,8466,1753,13909,0
26,887,1455,414,1257,16,76,112,1471,5,41,23,46,46,69,231,381,2,1069,59,0,2,6,1,20680,8467,1753,13910,0
26,887,669,365,481,22,61,110,691,15,103,63,122,118,185,747,1273,8,11311,628,0,2,6,1,20690,8467,1754,13911,0
42,1128,74,35,59,1,0,14,75,3,14,7,14,17,21,58,85,1,128,7,0,2,8,5,20690,8468,1754,13912,0
42,1128,245,125,200,5,7,34,250,7,30,17,34,37,51,166,265,3,1053,58,0,2,8,5,20700,8469,1754,13913,0
44,432,647,139,84,35,284,233,682,0,0,0,0,0,0,0,0,0,0,0,0,2,9,8,20700,8469,1754,13914,0
42,1312,1523,757,1297,19,12,193,1542,12,193,117,230,205,347,1508,2664,7,19053,1058,0,2,12,13,20710,8471,1754,13915,0
42,1312,701,378,504,33,58,109,734,13,110,68,126,123,194,794,1346,7,10027,557,0,2,12,13,20710,8472,1755,13916,0
166,3723,77,34,69,0,0,8,77,3,24,16,29,27,45,114,213,1,387,21,0,2,51,36,20710,8472,1755,13917,0
166,3723,712,438,573,51,9,84,763,14,102,71,128,116,199,733,1364,8,11988,666,0,2,51,36,20720,8473,1755,13918,0
67,1216,1020,354,843,12,15,144,1032,8,134,77,144,142,221,970,1580,4,6792,377,0,2,58,27,20720,8473,1755,13919,0
42,852,447,308,343,6,5,95,453,7,96,59,111,103,170,651,1136,4,4600,255,0,2,89,58,20720,8476,1755,13920,0
42,852,322,174,179,16,74,51,338,10,41,26,46,51,72,252,408,5,2291,127,0,2,89,58,20720,8479,1756,13921,0
23,407,424,94,331,4,0,89,428,1,5,5,5,6,10,11,25,0,12,0,0,2,1,2,20720,8480,1756,13922,0
23,407,38,23,23,6,0,8,44,3,11,7,11,14,18,42,68,1,102,5,0,2,1,2,20720,8480,1756,13923,0
195,4406,722,423,573,19,0,135,741,12,172,101,199,184,300,1320,2257,6,15668,870,0,2,34,42,20720,8482,1756,13925,0
195,4406,1508,847,911,44,250,301,1552,14,148,88,169,162,257,1120,1886,7,15077,837,0,2,34,42,20720,8483,1757,13926,0
435,9729,72,33,56,0,4,12,72,1,1,1,1,2,2,0,2,0,1,0,0,2,441,336,20720,8483,1757,13927,0
435,9729,1454,835,1044,76,110,219,1530,17,275,158,296,292,454,2297,3718,9,34017,1889,1,2,441,336,20730,8484,1757,13928,0
18,460,386,256,301,16,9,68,402,4,59,35,69,63,104,355,621,2,1453,80,0,2,2,2,20730,8484,1757,13929,0
18,460,264,131,164,11,41,46,275,6,38,22,40,44,62,214,338,3,1068,59,0,2,2,2,20740,8484,1758,13930,0
29,599,215,129,180,6,0,29,221,8,65,43,72,73,115,415,711,4,3153,175,0,2,2,2,20740,8484,1758,13931,0
29,599,97,69,77,3,3,16,100,6,22,13,23,28,36,113,173,3,542,30,0,2,2,2,20740,8485,1758,13932,0
111,2393,1043,504,840,53,9,147,1096,9,180,112,198,189,310,1377,2344,4,11604,644,0,2,27,17,20740,8487,1758,13933,0
111,2393,383,288,292,26,6,62,409,11,65,38,67,76,105,429,656,5,3719,206,0,2,27,17,20740,8488,1758,13934,0
86,1513,1178,367,1042,6,15,115,1184,9,94,51,95,103,146,644,976,4,4439,246,0,2,14,7,20740,8488,1758,13935,0
86,1513,177,108,140,8,0,27,185,6,30,16,32,36,48,162,248,3,794,44,0,2,14,7,20740,8490,1758,13936,0
163,3251,1943,715,1694,26,18,214,1969,12,185,120,237,197,357,1436,2721,7,20915,1161,0,2,24,18,20740,8492,1758,13937,0
163,3251,1168,838,957,57,25,144,1225,19,348,224,416,367,640,3018,5452,11,61921,3440,1,2,24,18,20750,8494,1758,13938,0
12,373,442,244,305,14,16,103,456,11,68,45,75,79,120,452,756,6,4588,254,0,2,3,0,20750,8496,1758,13939,0
12,373,182,102,99,11,40,35,193,3,11,6,11,14,17,42,64,1,97,5,0,2,3,0,20750,8497,1758,13940,0
54,1029,1098,241,925,5,10,155,1103,7,46,25,49,53,74,273,423,3,1580,87,0,2,5,8,20760,8499,1758,13941,0
54,1029,282,202,222,14,2,44,296,8,42,24,43,50,67,250,378,4,1548,86,0,2,5,8,20760,8500,1758,13942,0
3,42,14,8,8,0,0,6,14,0,0,0,0,0,0,0,0,0,0,0,0,0,12,0,20760,8500,1758,13944,0
2,34,9,6,6,0,0,3,9,0,0,0,0,0,0,0,0,0,0,0,0,0,10,0,20760,8500,1758,13945,0
2,34,13,9,8,0,0,4,13,0,0,0,0,0,0,0,0,0,0,0,0,0,10,0,20760,8500,1758,13946,0
1,279,382,65,130,157,2,92,539,4,10,5,10,14,15,41,57,2,114,6,0,2,29,6,20760,8501,1759,13948,0
56,983,282,196,195,3,0,86,285,8,130,71,141,138,212,936,1507,4,6538,363,0,2,1,1,20760,8501,1760,13949,0
7,296,72,33,56,0,4,12,72,1,1,1,1,2,2,0,2,0,1,0,0,2,3,2,20760,8501,1760,13950,0
11,370,85,59,61,8,0,16,93,5,18,10,18,23,28,86,126,2,316,17,0,0,74,0,20760,8501,1760,13951,0
13,442,42,7,35,4,0,5,46,1,2,1,2,3,3,2,4,0,2,0,0,2,20,16,20760,8501,1760,13952,0
13,442,11,6,10,0,0,1,11,2,4,2,4,6,6,10,15,1,15,0,0,2,20,16,20760,8501,1760,13953,0
63,2592,1289,550,1043,56,32,155,1345,10,167,93,185,177,278,1266,2075,5,11498,638,0,2,36,23,20760,8503,1761,13954,0
28,546,127,75,83,2,11,30,129,4,14,7,14,18,21,61,87,2,175,9,0,2,6,23,20760,8503,1761,13955,0
28,546,652,304,544,16,6,88,668,6,89,51,101,95,152,591,998,3,3399,188,0,2,6,23,20760,8504,1761,13956,0
28,546,2,2,2,0,0,0,2,0,0,0,0,0,0,0,0,0,0,0,0,2,6,23,20760,8504,1761,13956,0
28,546,8,5,5,0,0,3,8,0,0,0,0,0,0,0,0,0,0,0,0,2,6,23,20760,8504,1761,13957,0
28,546,2,2,2,0,0,0,2,0,0,0,0,0,0,0,0,0,0,0,0,2,6,23,20760,8504,1761,13957,0
28,546,14,8,8,0,0,6,14,0,0,0,0,0,0,0,0,0,0,0,0,2,6,23,20760,8504,1761,13958,0
28,546,6,4,4,0,0,2,6,0,0,0,0,0,0,0,0,0,0,0,0,2,6,23,20760,8504,1761,13959,0
28,546,6,4,4,0,0,2,6,1,2,1,2,3,3,2,4,0,2,0,0,2,6,23,20760,8504,1761,13960,0
28,546,6,4,4,0,0,2,6,0,0,0,0,0,0,0,0,0,0,0,0,2,6,23,20760,8504,1761,13961,0
28,546,7,5,5,0,0,2,7,0,0,0,0,0,0,0,0,0,0,0,0,2,6,23,20760,8504,1761,13962,0
28,546,6,4,4,0,0,2,6,0,0,0,0,0,0,0,0,0,0,0,0,2,6,23,20760,8504,1761,13963,0
28,546,10,6,6,0,0,4,10,0,0,0,0,0,0,0,0,0,0,0,0,2,6,23,20760,8504,1761,13964,0
28,546,1,1,1,0,0,0,1,0,0,0,0,0,0,0,0,0,0,0,0,2,6,23,20760,8504,1761,13964,0
28,546,14,10,10,0,0,4,14,1,1,1,1,2,2,0,2,0,1,0,0,2,6,23,20760,8504,1761,13965,0
28,546,46,26,30,3,0,12,49,3,6,3,6,9,9,20,28,1,42,2,0,2,6,23,20770,8504,1761,13966,0
63,2929,1338,495,1086,10,64,173,1348,11,122,82,157,133,239,883,1686,7,11934,663,0,2,79,21,20770,8506,1761,13967,0
124,5341,139,89,101,2,0,35,141,7,54,34,62,61,96,330,569,4,2287,127,0,2,266,46,20770,8506,1761,13968,0
124,5341,7,5,5,0,0,2,7,1,2,1,2,3,3,2,4,0,2,0,0,2,266,46,20770,8506,1761,13969,0
24,595,465,148,393,5,8,60,470,4,31,20,31,35,51,161,261,2,523,29,0,2,46,1,20770,8507,1761,13970,0
24,595,16,12,9,0,0,6,16,1,2,1,2,3,3,2,4,0,2,0,0,2,46,1,20770,8507,1761,13971,0
58,3259,1782,648,1425,9,47,279,1791,8,171,97,189,179,286,1292,2140,4,9462,525,0,2,22,5,20770,8508,1762,13972,0
9,192,256,139,192,9,7,47,265,4,23,12,24,27,36,112,171,2,357,19,0,2,1,1,20770,8509,1762,13973,0
23,612,102,59,69,5,3,24,107,6,22,15,28,28,43,113,206,3,789,43,0,2,2,0,20770,8509,1762,13974,0
51,1803,1450,624,1228,12,26,181,1462,14,306,186,354,320,540,2580,4493,8,36391,2021,1,2,25,2,20770,8511,1763,13975,0
116,2937,1660,832,1314,41,38,274,1701,20,312,209,395,332,604,2671,5058,12,64042,3557,1,2,73,10,20770,8513,1764,13977,0
121,4624,1513,682,1277,25,13,200,1538,11,199,116,219,210,335,1557,2584,6,15641,868,0,2,588,12,20770,8515,1764,13978,0
45,2786,1296,573,1062,40,33,157,1336,8,201,118,231,209,349,1561,2689,4,12365,686,0,2,30,9,20770,8515,1764,13979,0
39,1920,1457,730,1242,11,6,188,1468,10,292,166,329,302,495,2424,4078,5,22973,1276,1,2,51,10,20770,8517,1764,13980,0
30,1496,652,304,544,16,6,88,668,6,89,51,101,95,152,591,998,3,3399,188,0,2,42,5,20770,8518,1764,13981,0
23,997,1455,414,1257,16,76,112,1471,5,41,23,46,46,69,231,381,2,1069,59,0,2,23,3,20770,8519,1764,13982,0
11,343,74,35,59,1,0,14,75,3,14,7,14,17,21,58,85,1,128,7,0,2,2,2,20770,8520,1764,13983,0
39,2401,1523,757,1297,19,12,193,1542,12,193,117,230,205,347,1508,2664,7,19053,1058,0,2,44,10,20780,8522,1764,13984,0
55,2354,1020,354,843,12,15,144,1032,8,134,77,144,142,221,970,1580,4,6792,377,0,2,103,9,20780,8522,1764,13985,0
33,1481,447,308,343,6,5,95,453,7,96,59,111,103,170,651,1136,4,4600,255,0,2,20,6,20780,8525,1764,13986,0
16,498,424,94,331,4,0,89,428,1,5,5,5,6,10,11,25,0,12,0,0,2,3,3,20780,8526,1764,13987,0
38,2232,334,251,279,10,4,40,344,5,127,74,143,132,217,899,1528,2,4303,239,0,2,25,16,20780,8527,1764,13988,0
7,291,184,100,137,2,15,30,186,6,38,20,39,44,59,214,322,3,991,55,0,2,1,2,20780,8528,1764,13989,0
27,1034,1293,570,1093,25,15,163,1318,10,195,123,241,205,364,1516,2795,6,17273,959,0,2,9,7,20790,8530,1764,13990,0
14,567,722,423,573,19,0,135,741,12,172,101,199,184,300,1320,2257,6,15668,870,0,2,4,5,20790,8532,1764,13992,0
12,404,386,256,301,16,9,68,402,4,59,35,69,63,104,355,621,2,1453,80,0,2,7,7,20790,8532,1764,13993,0
15,1203,215,129,180,6,0,29,221,8,65,43,72,73,115,415,711,4,3153,175,0,2,20,0,20790,8532,1764,13994,0
50,2058,1043,504,840,53,9,147,1096,9,180,112,198,189,310,1377,2344,4,11604,644,0,2,57,25,20790,8534,1764,13995,0
24,968,373,158,315,8,0,51,381,5,76,44,79,81,123,486,779,2,2026,112,0,2,6,5,20790,8534,1764,13996,0
43,1898,1178,367,1042,6,15,115,1184,9,94,51,95,103,146,644,976,4,4439,246,0,2,14,16,20790,8534,1764,13997,0
61,2682,1943,715,1694,26,18,214,1969,12,185,120,237,197,357,1436,2721,7,20915,1161,0,2,50,28,20790,8536,1764,13998,0
7,514,442,244,305,14,16,103,456,11,68,45,75,79,120,452,756,6,4588,254,0,2,13,5,20790,8538,1764,13999,0
36,1381,1098,241,925,5,10,155,1103,7,46,25,49,53,74,273,423,3,1580,87,0,2,54,7,20800,8540,1764,14000,0
166,3723,77,34,69,0,0,8,77,3,24,16,29,27,45,114,213,1,387,21,0,2,8,5,20800,8540,1764,14001,0
166,3723,712,438,573,51,9,84,763,14,102,71,128,116,199,733,1364,8,11988,666,0,2,8,5,20810,8541,1764,14002,0
63,2592,1289,550,1043,56,32,155,1345,10,167,93,185,177,278,1266,2075,5,11498,638,0,2,8,0,20810,8543,1765,14003,0
166,3098,1513,682,1277,25,13,200,1538,11,199,116,219,210,335,1557,2584,6,15641,868,0,2,8,16,20810,8545,1765,14004,1
166,3098,819,519,539,24,98,155,843,15,96,57,106,111,163,690,1107,8,9171,509,0,2,8,16,20820,8547,1765,14005,1
118,4513,1513,682,1277,25,13,200,1538,11,199,116,219,210,335,1557,2584,6,15641,868,0,2,17,34,20820,8549,1765,14006,1
164,3038,1513,682,1277,25,13,200,1538,11,199,116,219,210,335,1557,2584,6,15641,868,0,2,0,16,20820,8551,1765,14007,0
164,3038,819,519,539,24,98,155,843,15,96,57,106,111,163,690,1107,8,9171,509,0,2,0,16,20830,8553,1765,14008,0
113,4338,1513,682,1277,25,13,200,1538,11,199,116,219,210,335,1557,2584,6,15641,868,0,2,0,31,20830,8555,1765,14009,0
161,3000,1513,682,1277,25,13,200,1538,11,199,116,219,210,335,1557,2584,6,15641,868,0,2,4,11,20830,8557,1765,14010,0
161,3000,819,519,539,24,98,155,843,15,96,57,106,111,163,690,1107,8,9171,509,0,2,4,11,20840,8559,1765,14011,0
112,4278,1513,682,1277,25,13,200,1538,11,199,116,219,210,335,1557,2584,6,15641,868,0,2,0,9,20840,8561,1765,14012,0
161,3000,1513,682,1277,25,13,200,1538,11,199,116,219,210,335,1557,2584,6,15641,868,0,2,9,40,20840,8563,1765,14013,0
161,3000,819,519,539,24,98,155,843,15,96,57,106,111,163,690,1107,8,9171,509,0,2,9,40,20850,8565,1765,14014,0
112,4278,1513,682,1277,25,13,200,1538,11,199,116,219,210,335,1557,2584,6,15641,868,0,2,16,73,20850,8567,1765,14015,0
112,2401,1043,504,840,53,9,147,1096,9,180,112,198,189,310,1377,2344,4,11604,644,0,2,3,4,20850,8569,1765,14016,1
112,2401,383,288,292,26,6,62,409,11,65,38,67,76,105,429,656,5,3719,206,0,2,3,4,20850,8570,1765,14017,1
49,1988,1043,504,840,53,9,147,1096,9,180,112,198,189,310,1377,2344,4,11604,644,0,2,0,14,20850,8572,1765,14018,1
434,9721,72,33,56,0,4,12,72,1,1,1,1,2,2,0,2,0,1,0,0,2,9,9,20850,8572,1765,14019,1
434,9721,1454,835,1044,76,110,219,1530,17,275,158,296,292,454,2297,3718,9,34017,1889,1,2,9,9,20860,8573,1765,14020,1
124,5341,139,89,101,2,0,35,141,7,54,34,62,61,96,330,569,4,2287,127,0,2,1,0,20860,8573,1765,14021,1
124,5341,7,5,5,0,0,2,7,1,2,1,2,3,3,2,4,0,2,0,0,2,1,0,20860,8573,1765,14022,1
31,635,2,2,2,0,0,0,2,0,0,0,0,0,0,0,0,0,0,0,0,2,2,2,20860,8573,1765,14022,1
31,635,99,48,90,1,3,5,100,0,0,0,0,0,0,0,0,0,0,0,0,2,2,2,20860,8574,1765,14023,1
31,635,8,5,5,2,0,1,10,0,0,0,0,0,0,0,0,0,0,0,0,2,2,2,20860,8574,1765,14024,1
31,635,1217,716,841,84,126,174,1301,14,185,118,215,199,333,1446,2542,8,20687,1149,0,2,2,2,20870,8576,1765,14025,1
31,635,160,89,115,0,13,31,160,7,15,11,17,22,28,78,124,3,495,27,0,2,2,2,20870,8576,1765,14026,1
31,635,10,10,9,9,0,0,19,0,0,0,0,0,0,0,0,0,0,0,0,2,2,2,20870,8576,1766,14027,1
31,635,173,84,99,8,29,36,181,5,12,7,13,17,20,54,81,2,221,12,0,2,2,2,20870,8577,1766,14028,1
31,635,3,1,1,3,0,0,6,0,0,0,0,0,0,0,0,0,0,0,0,2,2,2,20870,8577,1766,14029,1
77,1715,477,336,357,30,23,73,507,16,194,134,250,210,384,1538,2962,10,30538,1696,0,2,7,1,20880,8578,1766,14030,1
54,1893,1450,624,1228,12,26,181,1462,14,306,186,354,320,540,2580,4493,8,36391,2021,1,2,13,0,20880,8580,1767,14031,1
116,2935,1660,832,1314,41,38,274,1701,20,312,209,395,332,604,2671,5058,12,64042,3557,1,2,1,1,20880,8582,1768,14033,0
16,496,424,94,331,4,0,89,428,1,5,5,5,6,10,11,25,0,12,0,0,2,1,1,20880,8583,1768,14034,0
14,565,722,423,573,19,0,135,741,12,172,101,199,184,300,1320,2257,6,15668,870,0,2,0,1,20880,8585,1768,14036,0
24,966,373,158,315,8,0,51,381,5,76,44,79,81,123,486,779,2,2026,112,0,2,1,1,20880,8585,1768,14037,0
7,512,442,244,305,14,16,103,456,11,68,45,75,79,120,452,756,6,4588,254,0,2,1,1,20880,8587,1768,14038,0
114,4316,1513,682,1277,25,13,200,1538,11,199,116,219,210,335,1557,2584,6,15641,868,0,2,18,13,20880,8589,1768,14039,1
63,2606,1289,550,1043,56,32,155,1345,10,167,93,185,177,278,1266,2075,5,11498,638,0,2,2,1,20880,8591,1769,14040,1
7,528,442,244,305,14,16,103,456,11,68,45,75,79,120,452,756,6,4588,254,0,2,3,1,20880,8593,1769,14041,1
13,442,42,7,35,4,0,5,46,1,2,1,2,3,3,2,4,0,2,0,0,2,1,1,20880,8593,1769,14042,1
13,442,11,6,10,0,0,1,11,2,4,2,4,6,6,10,15,1,15,0,0,2,1,1,20880,8593,1769,14043,1
116,2936,1660,832,1314,41,38,274,1701,20,312,209,395,332,604,2671,5058,12,64042,3557,1,2,2,2,20880,8595,1770,14045,1
1,279,382,65,130,157,2,92,539,4,10,5,10,14,15,41,57,2,114,6,0,2,2,2,20890,8600,1772,14053,1
13,442,42,7,35,4,0,5,46,1,2,1,2,3,3,2,4,0,2,0,0,2,1,1,20890,8600,1772,14054,1
13,442,11,6,10,0,0,1,11,2,4,2,4,6,6,10,15,1,15,0,0,2,1,1,20890,8600,1772,14055,1
114,4337,1513,682,1277,25,13,200,1538,11,199,116,219,210,335,1557,2584,6,15641,868,0,2,1,0,20890,8602,1772,14056,1
114,4342,1513,682,1277,25,13,200,1538,11,199,116,219,210,335,1557,2584,6,15641,868,0,2,1,1,20890,8604,1772,14057,0
438,9758,72,33,56,0,4,12,72,1,1,1,1,2,2,0,2,0,1,0,0,2,7,1,20890,8604,1772,14058,1
438,9758,1454,835,1044,76,110,219,1530,17,275,158,296,292,454,2297,3718,9,34017,1889,1,2,7,1,20900,8605,1772,14059,1
24,595,465,148,393,5,8,60,470,4,31,20,31,35,51,161,261,2,523,29,0,2,3,0,20900,8606,1772,14060,1
24,595,16,12,9,0,0,6,16,1,2,1,2,3,3,2,4,0,2,0,0,2,3,0,20900,8606,1772,14061,1
230,4698,1457,730,1242,11,6,188,1468,10,292,166,329,302,495,2424,4078,5,22973,1276,1,2,5,0,20900,8608,1772,14062,1
230,4698,74,35,59,1,0,14,75,3,14,7,14,17,21,58,85,1,128,7,0,2,5,0,20900,8609,1772,14063,1
230,4698,245,125,200,5,7,34,250,7,30,17,34,37,51,166,265,3,1053,58,0,2,5,0,20910,8610,1772,14064,1
45,445,647,139,84,35,284,233,682,0,0,0,0,0,0,0,0,0,0,0,0,2,5,0,20910,8610,1772,14065,1
168,3801,77,34,69,0,0,8,77,3,24,16,29,27,45,114,213,1,387,21,0,2,14,0,20910,8610,1772,14066,1
168,3801,712,438,573,51,9,84,763,14,102,71,128,116,199,733,1364,8,11988,666,0,2,14,0,20920,8611,1772,14067,1
169,3417,1943,715,1694,26,18,214,1969,12,185,120,237,197,357,1436,2721,7,20915,1161,0,2,27,1,20920,8613,1772,14068,1
169,3417,1168,838,957,57,25,144,1225,19,348,224,416,367,640,3018,5452,11,61921,3440,1,2,27,1,20930,8615,1772,14069,1
41,2014,1457,730,1242,11,6,188,1468,10,292,166,329,302,495,2424,4078,5,22973,1276,1,2,39,0,20930,8617,1772,14070,1
435,9747,72,33,56,0,4,12,72,1,1,1,1,2,2,0,2,0,1,0,0,2,13,8,20930,8617,1772,14071,1
435,9747,1454,835,1044,76,110,219,1530,17,275,158,296,292,454,2297,3718,9,34017,1889,1,2,13,8,20940,8618,1772,14072,1
169,3417,1943,715,1694,26,18,214,1969,12,185,120,237,197,357,1436,2721,7,20915,1161,0,2,1,1,20940,8620,1772,14073,1
169,3417,1168,838,957,57,25,144,1225,19,348,224,416,367,640,3018,5452,11,61921,3440,1,2,1,1,20950,8622,1772,14074,1
63,2938,1338,495,1086,10,64,173,1348,11,122,82,157,133,239,883,1686,7,11934,663,0,2,18,7,20950,8624,1772,14075,1
228,4658,1457,730,1242,11,6,188,1468,10,292,166,329,302,495,2424,4078,5,22973,1276,1,2,3,10,20950,8626,1772,14076,1
228,4658,74,35,59,1,0,14,75,3,14,7,14,17,21,58,85,1,128,7,0,2,3,10,20950,8627,1772,14077,1
228,4658,245,125,200,5,7,34,250,7,30,17,34,37,51,166,265,3,1053,58,0,2,3,10,20960,8628,1772,14078,1
43,1133,74,35,59,1,0,14,75,3,14,7,14,17,21,58,85,1,128,7,0,2,2,1,20960,8629,1772,14079,1
43,1133,245,125,200,5,7,34,250,7,30,17,34,37,51,166,265,3,1053,58,0,2,2,1,20970,8630,1772,14080,1
166,3376,1943,715,1694,26,18,214,1969,12,185,120,237,197,357,1436,2721,7,20915,1161,0,2,0,6,20970,8632,1772,14081,1
166,3376,1168,838,957,57,25,144,1225,19,348,224,416,367,640,3018,5452,11,61921,3440,1,2,0,6,20980,8634,1772,14082,1
37,2191,334,251,279,10,4,40,344,5,127,74,143,132,217,899,1528,2,4303,239,0,2,0,10,20980,8635,1772,14083,1
13,442,42,7,35,4,0,5,46,1,2,1,2,3,3,2,4,0,2,0,0,2,1,1,20990,8639,1773,14091,0
13,442,11,6,10,0,0,1,11,2,4,2,4,6,6,10,15,1,15,0,0,2,1,1,20990,8639,1773,14092,0
160,2985,1513,682,1277,25,13,200,1538,11,199,116,219,210,335,1557,2584,6,15641,868,0,2,1,7,20990,8641,1773,14093,0
160,2985,819,519,539,24,98,155,843,15,96,57,106,111,163,690,1107,8,9171,509,0,2,1,7,21000,8643,1773,14094,0
155,2896,1513,682,1277,25,13,200,1538,11,199,116,219,210,335,1557,2584,6,15641,868,0,2,8,20,21000,8645,1773,14095,1
155,2896,819,519,539,24,98,155,843,15,96,57,106,111,163,690,1107,8,9171,509,0,2,8,20,21010,8647,1773,14096,1
43,1314,1523,757,1297,19,12,193,1542,12,193,117,230,205,347,1508,2664,7,19053,1058,0,2,8,6,21020,8649,1773,14097,1
43,1314,701,378,504,33,58,109,734,13,110,68,126,123,194,794,1346,7,10027,557,0,2,8,6,21020,8650,1774,14098,1
171,3873,77,34,69,0,0,8,77,3,24,16,29,27,45,114,213,1,387,21,0,2,9,0,21020,8650,1774,14099,1
171,3873,712,438,573,51,9,84,763,14,102,71,128,116,199,733,1364,8,11988,666,0,2,9,0,21030,8651,1774,14100,1
24,594,1293,570,1093,25,15,163,1318,10,195,123,241,205,364,1516,2795,6,17273,959,0,2,2,2,21040,8653,1774,14101,1
116,2461,1043,504,840,53,9,147,1096,9,180,112,198,189,310,1377,2344,4,11604,644,0,2,11,3,21040,8655,1774,14102,1
116,2461,383,288,292,26,6,62,409,11,65,38,67,76,105,429,656,5,3719,206,0,2,11,3,21040,8656,1774,14103,1
114,4342,1513,682,1277,25,13,200,1538,11,199,116,219,210,335,1557,2584,6,15641,868,0,2,2,2,21040,8658,1774,14104,1
39,2415,1523,757,1297,19,12,193,1542,12,193,117,230,205,347,1508,2664,7,19053,1058,0,2,3,1,21050,8660,1774,14105,1
161,3047,1513,682,1277,25,13,200,1538,11,199,116,219,210,335,1557,2584,6,15641,868,0,2,105,68,21050,8662,1774,14106,1
161,3047,819,519,539,24,98,155,843,15,96,57,106,111,163,690,1107,8,9171,509,0,2,105,68,21060,8664,1774,14107,1
230,4686,1457,730,1242,11,6,188,1468,10,292,166,329,302,495,2424,4078,5,22973,1276,1,2,12,5,21060,8666,1774,14108,1
230,4686,74,35,59,1,0,14,75,3,14,7,14,17,21,58,85,1,128,7,0,2,12,5,21060,8667,1774,14109,1
230,4686,245,125,200,5,7,34,250,7,30,17,34,37,51,166,265,3,1053,58,0,2,12,5,21070,8668,1774,14110,1
43,1146,74,35,59,1,0,14,75,3,14,7,14,17,21,58,85,1,128,7,0,2,3,1,21070,8669,1774,14111,1
43,1146,245,125,200,5,7,34,250,7,30,17,34,37,51,166,265,3,1053,58,0,2,3,1,21080,8670,1774,14112,1
67,1214,1020,354,843,12,15,144,1032,8,134,77,144,142,221,970,1580,4,6792,377,0,2,1,1,21080,8670,1774,14113,1
25,602,1293,570,1093,25,15,163,1318,10,195,123,241,205,364,1516,2795,6,17273,959,0,2,11,11,21090,8672,1774,14114,1
435,9745,72,33,56,0,4,12,72,1,1,1,1,2,2,0,2,0,1,0,0,2,1,1,21090,8672,1774,14115,1
435,9745,1454,835,1044,76,110,219,1530,17,275,158,296,292,454,2297,3718,9,34017,1889,1,2,1,1,21100,8673,1774,14116,1
114,2464,1043,504,840,53,9,147,1096,9,180,112,198,189,310,1377,2344,4,11604,644,0,2,8,8,21100,8675,1774,14117,1
114,2464,383,288,292,26,6,62,409,11,65,38,67,76,105,429,656,5,3719,206,0,2,8,8,21100,8676,1774,14118,1
167,3404,1943,715,1694,26,18,214,1969,12,185,120,237,197,357,1436,2721,7,20915,1161,0,2,9,1,21100,8678,1774,14119,1
167,3404,1168,838,957,57,25,144,1225,19,348,224,416,367,640,3018,5452,11,61921,3440,1,2,9,1,21110,8680,1774,14120,1
114,4350,1513,682,1277,25,13,200,1538,11,199,116,219,210,335,1557,2584,6,15641,868,0,2,27,23,21110,8682,1774,14122,1
21,559,1293,570,1093,25,15,163,1318,10,195,123,241,205,364,1516,2795,6,17273,959,0,2,8,21,21120,8684,1774,14123,1
168,3795,77,34,69,0,0,8,77,3,24,16,29,27,45,114,213,1,387,21,0,2,0,4,21120,8684,1774,14124,1
168,3795,712,438,573,51,9,84,763,14,102,71,128,116,199,733,1364,8,11988,666,0,2,0,4,21130,8685,1774,14125,1
24,382,424,94,331,4,0,89,428,1,5,5,5,6,10,11,25,0,12,0,0,2,20,10,21130,8686,1774,14126,1
24,382,38,23,23,6,0,8,44,3,11,7,11,14,18,42,68,1,102,5,0,2,20,10,21130,8686,1774,14127,1
112,2415,1043,504,840,53,9,147,1096,9,180,112,198,189,310,1377,2344,4,11604,644,0,2,3,1,21130,8688,1774,14128,1
112,2415,383,288,292,26,6,62,409,11,65,38,67,76,105,429,656,5,3719,206,0,2,3,1,21130,8689,1774,14129,1
17,540,424,94,331,4,0,89,428,1,5,5,5,6,10,11,25,0,12,0,0,2,15,1,21130,8690,1774,14130,1
168,3793,77,34,69,0,0,8,77,3,24,16,29,27,45,114,213,1,387,21,0,2,1,1,21130,8690,1774,14131,1
168,3793,712,438,573,51,9,84,763,14,102,71,128,116,199,733,1364,8,11988,666,0,2,1,1,21140,8691,1774,14132,1
63,2936,1338,495,1086,10,64,173,1348,11,122,82,157,133,239,883,1686,7,11934,663,0,2,1,1,21140,8693,1774,14133,1
23,373,424,94,331,4,0,89,428,1,5,5,5,6,10,11,25,0,12,0,0,2,5,10,21140,8694,1774,14134,1
23,373,38,23,23,6,0,8,44,3,11,7,11,14,18,42,68,1,102,5,0,2,5,10,21140,8694,1774,14135,1
168,3793,77,34,69,0,0,8,77,3,24,16,29,27,45,114,213,1,387,21,0,2,1,5,21140,8694,1774,14136,0
168,3793,712,438,573,51,9,84,763,14,102,71,128,116,199,733,1364,8,11988,666,0,2,1,5,21150,8695,1774,14137,0
23,373,424,94,331,4,0,89,428,1,5,5,5,6,10,11,25,0,12,0,0,2,19,14,21150,8696,1774,14138,0
23,373,38,23,23,6,0,8,44,3,11,7,11,14,18,42,68,1,102,5,0,2,19,14,21150,8696,1774,14139,0
112,2415,1043,504,840,53,9,147,1096,9,180,112,198,189,310,1377,2344,4,11604,644,0,2,3,1,21150,8698,1774,14140,0
112,2415,383,288,292,26,6,62,409,11,65,38,67,76,105,429,656,5,3719,206,0,2,3,1,21150,8699,1774,14141,0
63,2936,1338,495,1086,10,64,173,1348,11,122,82,157,133,239,883,1686,7,11934,663,0,2,1,1,21150,8701,1774,14142,0
17,540,424,94,331,4,0,89,428,1,5,5,5,6,10,11,25,0,12,0,0,2,15,1,21150,8702,1774,14143,0
161,3043,1513,682,1277,25,13,200,1538,11,199,116,219,210,335,1557,2584,6,15641,868,0,2,5,6,21150,8704,1774,14144,1
161,3043,819,519,539,24,98,155,843,15,96,57,106,111,163,690,1107,8,9171,509,0,2,5,6,21160,8706,1774,14145,1
45,445,647,139,84,35,284,233,682,0,0,0,0,0,0,0,0,0,0,0,0,2,2,2,21160,8706,1774,14146,1
438,9764,72,33,56,0,4,12,72,1,1,1,1,2,2,0,2,0,1,0,0,2,3,3,21160,8706,1774,14147,1
438,9764,1454,835,1044,76,110,219,1530,17,275,158,296,292,454,2297,3718,9,34017,1889,1,2,3,3,21170,8707,1774,14148,1
438,9769,72,33,56,0,4,12,72,1,1,1,1,2,2,0,2,0,1,0,0,2,3,3,21170,8707,1774,14149,1
438,9769,1454,835,1044,76,110,219,1530,17,275,158,296,292,454,2297,3718,9,34017,1889,1,2,3,3,21180,8708,1774,14150,1
228,4665,1457,730,1242,11,6,188,1468,10,292,166,329,302,495,2424,4078,5,22973,1276,1,2,1,1,21180,8710,1774,14151,1
228,4665,74,35,59,1,0,14,75,3,14,7,14,17,21,58,85,1,128,7,0,2,1,1,21180,8711,1774,14152,1
228,4665,245,125,200,5,7,34,250,7,30,17,34,37,51,166,265,3,1053,58,0,2,1,1,21190,8712,1774,14153,1
228,4665,1457,730,1242,11,6,188,1468,10,292,166,329,302,495,2424,4078,5,22973,1276,1,2,1,1,21190,8714,1774,14154,0
228,4665,74,35,59,1,0,14,75,3,14,7,14,17,21,58,85,1,128,7,0,2,1,1,21190,8715,1774,14155,0
228,4665,245,125,200,5,7,34,250,7,30,17,34,37,51,166,265,3,1053,58,0,2,1,1,21200,8716,1774,14156,0
439,9795,72,33,56,0,4,12,72,1,1,1,1,2,2,0,2,0,1,0,0,2,7,1,21200,8716,1774,14157,0
439,9795,1454,835,1044,76,110,219,1530,17,275,158,296,292,454,2297,3718,9,34017,1889,1,2,7,1,21210,8717,1774,14158,0
24,595,465,148,393,5,8,60,470,4,31,20,31,35,51,161,261,2,523,29,0,2,3,0,21210,8718,1774,14159,0
24,595,16,12,9,0,0,6,16,1,2,1,2,3,3,2,4,0,2,0,0,2,3,0,21210,8718,1774,14160,0
24,595,465,148,393,5,8,60,470,4,31,20,31,35,51,161,261,2,523,29,0,2,2,1,21210,8719,1774,14161,0
24,595,16,12,9,0,0,6,16,1,2,1,2,3,3,2,4,0,2,0,0,2,2,1,21210,8719,1774,14162,0
115,4390,1513,682,1277,25,13,200,1538,11,199,116,219,210,335,1557,2584,6,15641,868,0,2,18,0,21210,8721,1774,14163,0
230,4693,1457,730,1242,11,6,188,1468,10,292,166,329,302,495,2424,4078,5,22973,1276,1,2,1,1,21210,8723,1774,14164,0
230,4693,74,35,59,1,0,14,75,3,14,7,14,17,21,58,85,1,128,7,0,2,1,1,21210,8724,1774,14165,0
230,4693,245,125,200,5,7,34,250,7,30,17,34,37,51,166,265,3,1053,58,0,2,1,1,21220,8725,1774,14166,0
45,445,647,139,84,35,284,233,682,0,0,0,0,0,0,0,0,0,0,0,0,2,2,2,21220,8725,1774,14167,0
171,3865,77,34,69,0,0,8,77,3,24,16,29,27,45,114,213,1,387,21,0,2,1,5,21220,8725,1774,14168,0
171,3865,712,438,573,51,9,84,763,14,102,71,128,116,199,733,1364,8,11988,666,0,2,1,5,21230,8726,1774,14169,0
23,373,424,94,331,4,0,89,428,1,5,5,5,6,10,11,25,0,12,0,0,2,19,14,21230,8727,1774,14170,0
23,373,38,23,23,6,0,8,44,3,11,7,11,14,18,42,68,1,102,5,0,2,19,14,21230,8727,1774,14171,0
439,9793,72,33,56,0,4,12,72,1,1,1,1,2,2,0,2,0,1,0,0,2,7,1,21230,8727,1774,14172,0
439,9793,1454,835,1044,76,110,219,1530,17,275,158,296,292,454,2297,3718,9,34017,1889,1,2,7,1,21240,8728,1774,14173,0
114,2478,1043,504,840,53,9,147,1096,9,180,112,198,189,310,1377,2344,4,11604,644,0,2,3,1,21240,8730,1774,14174,0
114,2478,383,288,292,26,6,62,409,11,65,38,67,76,105,429,656,5,3719,206,0,2,3,1,21240,8731,1774,14175,0
63,2936,1338,495,1086,10,64,173,1348,11,122,82,157,133,239,883,1686,7,11934,663,0,2,1,1,21240,8733,1774,14176,0
24,595,465,148,393,5,8,60,470,4,31,20,31,35,51,161,261,2,523,29,0,2,4,0,21240,8734,1774,14177,0
24,595,16,12,9,0,0,6,16,1,2,1,2,3,3,2,4,0,2,0,0,2,4,0,21240,8734,1774,14178,0
115,4398,1513,682,1277,25,13,200,1538,11,199,116,219,210,335,1557,2584,6,15641,868,0,2,18,0,21240,8736,1774,14179,0
17,540,424,94,331,4,0,89,428,1,5,5,5,6,10,11,25,0,12,0,0,2,15,1,21240,8737,1774,14180,0
115,4399,1513,682,1277,25,13,200,1538,11,199,116,219,210,335,1557,2584,6,15641,868,0,2,1,1,21240,8739,1774,14181,0
54,1027,1098,241,925,5,10,155,1103,7,46,25,49,53,74,273,423,3,1580,87,0,2,1,1,21250,8741,1774,14182,0
54,1027,282,202,222,14,2,44,296,8,42,24,43,50,67,250,378,4,1548,86,0,2,1,1,21250,8742,1774,14183,0
159,2935,1513,682,1277,25,13,200,1538,11,199,116,219,210,335,1557,2584,6,15641,868,0,2,6,29,21250,8744,1774,14184,1
159,2935,819,519,539,24,98,155,843,15,96,57,106,111,163,690,1107,8,9171,509,0,2,6,29,21260,8746,1774,14185,1
112,4283,1513,682,1277,25,13,200,1538,11,199,116,219,210,335,1557,2584,6,15641,868,0,2,3,25,21260,8748,1774,14186,1
133,2539,1513,682,1277,25,13,200,1538,11,199,116,219,210,335,1557,2584,6,15641,868,0,2,105,195,21260,8750,1774,14187,1
133,2539,819,519,539,24,98,155,843,15,96,57,106,111,163,690,1107,8,9171,509,0,2,105,195,21270,8752,1774,14188,1
111,4191,1513,682,1277,25,13,200,1538,11,199,116,219,210,335,1557,2584,6,15641,868,0,2,24,35,21270,8754,1774,14189,1
127,2479,1513,682,1277,25,13,200,1538,11,199,116,219,210,335,1557,2584,6,15641,868,0,2,49,59,21270,8756,1774,14190,1
127,2479,819,519,539,24,98,155,843,15,96,57,106,111,163,690,1107,8,9171,509,0,2,49,59,21280,8758,1774,14191,1
112,4213,1513,682,1277,25,13,200,1538,11,199,116,219,210,335,1557,2584,6,15641,868,0,2,54,39,21280,8760,1774,14192,1
122,2423,1513,682,1277,25,13,200,1538,11,199,116,219,210,335,1557,2584,6,15641,868,0,2,23,39,21280,8762,1774,14193,1
122,2423,819,519,539,24,98,155,843,15,96,57,106,111,163,690,1107,8,9171,509,0,2,23,39,21290,8764,1774,14194,1
110,4169,1513,682,1277,25,13,200,1538,11,199,116,219,210,335,1557,2584,6,15641,868,0,2,62,79,21290,8766,1774,14195,1
32,641,2,2,2,0,0,0,2,0,0,0,0,0,0,0,0,0,0,0,0,2,1,1,21290,8766,1774,14195,0
32,641,99,48,90,1,3,5,100,0,0,0,0,0,0,0,0,0,0,0,0,2,1,1,21290,8767,1774,14196,0
32,641,8,5,5,2,0,1,10,0,0,0,0,0,0,0,0,0,0,0,0,2,1,1,21290,8767,1774,14197,0
32,641,1217,716,841,84,126,174,1301,14,185,118,215,199,333,1446,2542,8,20687,1149,0,2,1,1,21300,8769,1774,14198,0
32,641,160,89,115,0,13,31,160,7,15,11,17,22,28,78,124,3,495,27,0,2,1,1,21300,8769,1774,14199,0
32,641,10,10,9,9,0,0,19,0,0,0,0,0,0,0,0,0,0,0,0,2,1,1,21300,8769,1775,14200,0
32,641,173,84,99,8,29,36,181,5,12,7,13,17,20,54,81,2,221,12,0,2,1,1,21300,8770,1775,14201,0
32,641,3,1,1,3,0,0,6,0,0,0,0,0,0,0,0,0,0,0,0,2,1,1,21300,8770,1775,14202,0
117,2976,1660,832,1314,41,38,274,1701,20,312,209,395,332,604,2671,5058,12,64042,3557,1,2,16,0,21300,8772,1776,14204,0
117,2960,1660,832,1314,41,38,274,1701,20,312,209,395,332,604,2671,5058,12,64042,3557,1,2,3,13,21300,8774,1777,14206,0
32,641,2,2,2,0,0,0,2,0,0,0,0,0,0,0,0,0,0,0,0,2,1,1,21300,8774,1777,14206,0
32,641,99,48,90,1,3,5,100,0,0,0,0,0,0,0,0,0,0,0,0,2,1,1,21300,8775,1777,14207,0
32,641,8,5,5,2,0,1,10,0,0,0,0,0,0,0,0,0,0,0,0,2,1,1,21300,8775,1777,14208,0
32,641,1217,716,841,84,126,174,1301,14,185,118,215,199,333,1446,2542,8,20687,1149,0,2,1,1,21310,8777,1777,14209,0
32,641,160,89,115,0,13,31,160,7,15,11,17,22,28,78,124,3,495,27,0,2,1,1,21310,8777,1777,14210,0
32,641,10,10,9,9,0,0,19,0,0,0,0,0,0,0,0,0,0,0,0,2,1,1,21310,8777,1778,14211,0
32,641,173,84,99,8,29,36,181,5,12,7,13,17,20,54,81,2,221,12,0,2,1,1,21310,8778,1778,14212,0
32,641,3,1,1,3,0,0,6,0,0,0,0,0,0,0,0,0,0,0,0,2,1,1,21310,8778,1778,14213,0
117,2960,1660,832,1314,41,38,274,1701,20,312,209,395,332,604,2671,5058,12,64042,3557,1,2,6,0,21310,8780,1779,14215,0
122,2423,1513,682,1277,25,13,200,1538,11,199,116,219,210,335,1557,2584,6,15641,868,0,2,209,330,21310,8782,1779,14216,0
122,2423,819,519,539,24,98,155,843,15,96,57,106,111,163,690,1107,8,9171,509,0,2,209,330,21320,8784,1779,14217,0
230,4693,1457,730,1242,11,6,188,1468,10,292,166,329,302,495,2424,4078,5,22973,1276,1,2,12,5,21320,8786,1779,14218,0
230,4693,74,35,59,1,0,14,75,3,14,7,14,17,21,58,85,1,128,7,0,2,12,5,21320,8787,1779,14219,0
230,4693,245,125,200,5,7,34,250,7,30,17,34,37,51,166,265,3,1053,58,0,2,12,5,21330,8788,1779,14220,0
43,1146,74,35,59,1,0,14,75,3,14,7,14,17,21,58,85,1,128,7,0,2,3,1,21330,8789,1779,14221,0
43,1146,245,125,200,5,7,34,250,7,30,17,34,37,51,166,265,3,1053,58,0,2,3,1,21340,8790,1779,14222,0
43,1314,1523,757,1297,19,12,193,1542,12,193,117,230,205,347,1508,2664,7,19053,1058,0,2,8,6,21350,8792,1779,14223,0
43,1314,701,378,504,33,58,109,734,13,110,68,126,123,194,794,1346,7,10027,557,0,2,8,6,21350,8793,1780,14224,0
171,3865,77,34,69,0,0,8,77,3,24,16,29,27,45,114,213,1,387,21,0,2,9,0,21350,8793,1780,14225,0
171,3865,712,438,573,51,9,84,763,14,102,71,128,116,199,733,1364,8,11988,666,0,2,9,0,21360,8794,1780,14226,0
67,1214,1020,354,843,12,15,144,1032,8,134,77,144,142,221,970,1580,4,6792,377,0,2,1,1,21360,8794,1780,14227,0
21,559,1293,570,1093,25,15,163,1318,10,195,123,241,205,364,1516,2795,6,17273,959,0,2,12,25,21370,8796,1780,14228,0
439,9793,72,33,56,0,4,12,72,1,1,1,1,2,2,0,2,0,1,0,0,2,1,1,21370,8796,1780,14229,0
439,9793,1454,835,1044,76,110,219,1530,17,275,158,296,292,454,2297,3718,9,34017,1889,1,2,1,1,21380,8797,1780,14230,0
114,2478,1043,504,840,53,9,147,1096,9,180,112,198,189,310,1377,2344,4,11604,644,0,2,19,11,21380,8799,1780,14231,0
114,2478,383,288,292,26,6,62,409,11,65,38,67,76,105,429,656,5,3719,206,0,2,19,11,21380,8800,1780,14232,0
167,3404,1943,715,1694,26,18,214,1969,12,185,120,237,197,357,1436,2721,7,20915,1161,0,2,9,1,21380,8802,1780,14233,0
167,3404,1168,838,957,57,25,144,1225,19,348,224,416,367,640,3018,5452,11,61921,3440,1,2,9,1,21390,8804,1780,14234,0
110,4178,1513,682,1277,25,13,200,1538,11,199,116,219,210,335,1557,2584,6,15641,868,0,2,134,165,21390,8806,1780,14236,0
39,2415,1523,757,1297,19,12,193,1542,12,193,117,230,205,347,1508,2664,7,19053,1058,0,2,3,1,21400,8808,1780,14237,0
118,2308,1513,682,1277,25,13,200,1538,11,199,116,219,210,335,1557,2584,6,15641,868,0,2,5,26,21400,8810,1780,14238,1
118,2308,819,519,539,24,98,155,843,15,96,57,106,111,163,690,1107,8,9171,509,0,2,5,26,21410,8812,1780,14239,1
110,4160,1513,682,1277,25,13,200,1538,11,199,116,219,210,335,1557,2584,6,15641,868,0,2,9,8,21410,8814,1780,14240,1
116,2252,1513,682,1277,25,13,200,1538,11,199,116,219,210,335,1557,2584,6,15641,868,0,2,23,42,21410,8816,1780,14241,1
116,2252,819,519,539,24,98,155,843,15,96,57,106,111,163,690,1107,8,9171,509,0,2,23,42,21420,8818,1780,14242,1
168,3427,1943,715,1694,26,18,214,1969,12,185,120,237,197,357,1436,2721,7,20915,1161,0,2,4,2,21420,8820,1780,14243,1
168,3427,1168,838,957,57,25,144,1225,19,348,224,416,367,640,3018,5452,11,61921,3440,1,2,4,2,21430,8822,1780,14244,1
110,4131,1513,682,1277,25,13,200,1538,11,199,116,219,210,335,1557,2584,6,15641,868,0,2,12,17,21430,8824,1780,14245,1
54,1027,1098,241,925,5,10,155,1103,7,46,25,49,53,74,273,423,3,1580,87,0,2,1,1,21440,8826,1780,14246,0
54,1027,282,202,222,14,2,44,296,8,42,24,43,50,67,250,378,4,1548,86,0,2,1,1,21440,8827,1780,14247,0
198,4464,722,423,573,19,0,135,741,12,172,101,199,184,300,1320,2257,6,15668,870,0,2,8,2,21440,8829,1780,14249,1
198,4464,1508,847,911,44,250,301,1552,14,148,88,169,162,257,1120,1886,7,15077,837,0,2,8,2,21440,8830,1781,14250,1
117,2950,1660,832,1314,41,38,274,1701,20,312,209,395,332,604,2671,5058,12,64042,3557,1,2,15,14,21440,8832,1782,14252,1
117,2932,1660,832,1314,41,38,274,1701,20,312,209,395,332,604,2671,5058,12,64042,3557,1,2,6,6,21440,8834,1783,14254,0
115,4404,1513,682,1277,25,13,200,1538,11,199,116,219,210,335,1557,2584,6,15641,868,0,2,3,2,21440,8836,1783,14255,0
116,2252,1513,682,1277,25,13,200,1538,11,199,116,219,210,335,1557,2584,6,15641,868,0,2,5,5,21440,8838,1783,14256,0
116,2252,819,519,539,24,98,155,843,15,96,57,106,111,163,690,1107,8,9171,509,0,2,5,5,21450,8840,1783,14257,0
111,4160,1513,682,1277,25,13,200,1538,11,199,116,219,210,335,1557,2584,6,15641,868,0,2,23,4,21450,8842,1783,14258,0
118,2356,1513,682,1277,25,13,200,1538,11,199,116,219,210,335,1557,2584,6,15641,868,0,2,46,25,21450,8844,1783,14259,1
118,2356,819,519,539,24,98,155,843,15,96,57,106,111,163,690,1107,8,9171,509,0,2,46,25,21460,8846,1783,14260,1
114,4320,1513,682,1277,25,13,200,1538,11,199,116,219,210,335,1557,2584,6,15641,868,0,2,32,6,21460,8848,1783,14261,1
122,2415,1513,682,1277,25,13,200,1538,11,199,116,219,210,335,1557,2584,6,15641,868,0,2,19,11,21460,8850,1783,14262,0
122,2415,819,519,539,24,98,155,843,15,96,57,106,111,163,690,1107,8,9171,509,0,2,19,11,21470,8852,1783,14263,0
64,2630,1289,550,1043,56,32,155,1345,10,167,93,185,177,278,1266,2075,5,11498,638,0,2,6,0,21470,8854,1784,14264,0
114,2276,1513,682,1277,25,13,200,1538,11,199,116,219,210,335,1557,2584,6,15641,868,0,2,49,79,21470,8856,1784,14265,1
114,2276,819,519,539,24,98,155,843,15,96,57,106,111,163,690,1107,8,9171,509,0,2,49,79,21480,8858,1784,14266,1
21,564,1293,570,1093,25,15,163,1318,10,195,123,241,205,364,1516,2795,6,17273,959,0,2,3,3,21490,8860,1784,14267,1
109,4150,1513,682,1277,25,13,200,1538,11,199,116,219,210,335,1557,2584,6,15641,868,0,2,26,51,21490,8862,1784,14268,1
29,1113,1293,570,1093,25,15,163,1318,10,195,123,241,205,364,1516,2795,6,17273,959,0,2,20,0,21500,8864,1784,14269,1
114,2255,1513,682,1277,25,13,200,1538,11,199,116,219,210,335,1557,2584,6,15641,868,0,2,15,20,21500,8866,1784,14270,1
114,2255,819,519,539,24,98,155,843,15,96,57,106,111,163,690,1107,8,9171,509,0,2,15,20,21510,8868,1784,14271,1
43,1133,74,35,59,1,0,14,75,3,14,7,14,17,21,58,85,1,128,7,0,2,1,3,21510,8869,1784,14272,1
43,1133,245,125,200,5,7,34,250,7,30,17,34,37,51,166,265,3,1053,58,0,2,1,3,21520,8870,1784,14273,1
67,1216,1020,354,843,12,15,144,1032,8,134,77,144,142,221,970,1580,4,6792,377,0,2,1,1,21520,8870,1784,14274,1
439,9795,72,33,56,0,4,12,72,1,1,1,1,2,2,0,2,0,1,0,0,2,1,1,21520,8870,1784,14275,1
439,9795,1454,835,1044,76,110,219,1530,17,275,158,296,292,454,2297,3718,9,34017,1889,1,2,1,1,21530,8871,1784,14276,1
167,3399,1943,715,1694,26,18,214,1969,12,185,120,237,197,357,1436,2721,7,20915,1161,0,2,1,10,21530,8873,1784,14277,1
167,3399,1168,838,957,57,25,144,1225,19,348,224,416,367,640,3018,5452,11,61921,3440,1,2,1,10,21540,8875,1784,14278,1
54,1027,1098,241,925,5,10,155,1103,7,46,25,49,53,74,273,423,3,1580,87,0,2,1,1,21550,8877,1784,14279,0
54,1027,282,202,222,14,2,44,296,8,42,24,43,50,67,250,378,4,1548,86,0,2,1,1,21550,8878,1784,14280,0
38,647,127,75,83,2,11,30,129,4,14,7,14,18,21,61,87,2,175,9,0,2,21,5,21550,8878,1784,14281,0
38,647,652,304,544,16,6,88,668,6,89,51,101,95,152,591,998,3,3399,188,0,2,21,5,21550,8879,1784,14282,0
38,647,2,2,2,0,0,0,2,0,0,0,0,0,0,0,0,0,0,0,0,2,21,5,21550,8879,1784,14282,0
38,647,8,5,5,0,0,3,8,0,0,0,0,0,0,0,0,0,0,0,0,2,21,5,21550,8879,1784,14283,0
38,647,2,2,2,0,0,0,2,0,0,0,0,0,0,0,0,0,0,0,0,2,21,5,21550,8879,1784,14283,0
38,647,14,8,8,0,0,6,14,0,0,0,0,0,0,0,0,0,0,0,0,2,21,5,21550,8879,1784,14284,0
38,647,6,4,4,0,0,2,6,0,0,0,0,0,0,0,0,0,0,0,0,2,21,5,21550,8879,1784,14285,0
38,647,6,4,4,0,0,2,6,1,2,1,2,3,3,2,4,0,2,0,0,2,21,5,21550,8879,1784,14286,0
38,647,6,4,4,0,0,2,6,0,0,0,0,0,0,0,0,0,0,0,0,2,21,5,21550,8879,1784,14287,0
38,647,7,5,5,0,0,2,7,0,0,0,0,0,0,0,0,0,0,0,0,2,21,5,21550,8879,1784,14288,0
38,647,6,4,4,0,0,2,6,0,0,0,0,0,0,0,0,0,0,0,0,2,21,5,21550,8879,1784,14289,0
38,647,10,6,6,0,0,4,10,0,0,0,0,0,0,0,0,0,0,0,0,2,21,5,21550,8879,1784,14290,0
38,647,1,1,1,0,0,0,1,0,0,0,0,0,0,0,0,0,0,0,0,2,21,5,21550,8879,1784,14290,0
38,647,14,10,10,0,0,4,14,1,1,1,1,2,2,0,2,0,1,0,0,2,21,5,21550,8879,1784,14291,0
38,647,46,26,30,3,0,12,49,3,6,3,6,9,9,20,28,1,42,2,0,2,21,5,21560,8879,1784,14292,0
46,790,127,75,83,2,11,30,129,4,14,7,14,18,21,61,87,2,175,9,0,2,24,8,21560,8879,1784,14293,0
46,790,652,304,544,16,6,88,668,6,89,51,101,95,152,591,998,3,3399,188,0,2,24,8,21560,8880,1784,14294,0
46,790,2,2,2,0,0,0,2,0,0,0,0,0,0,0,0,0,0,0,0,2,24,8,21560,8880,1784,14294,0
46,790,8,5,5,0,0,3,8,0,0,0,0,0,0,0,0,0,0,0,0,2,24,8,21560,8880,1784,14295,0
46,790,2,2,2,0,0,0,2,0,0,0,0,0,0,0,0,0,0,0,0,2,24,8,21560,8880,1784,14295,0
46,790,14,8,8,0,0,6,14,0,0,0,0,0,0,0,0,0,0,0,0,2,24,8,21560,8880,1784,14296,0
46,790,6,4,4,0,0,2,6,0,0,0,0,0,0,0,0,0,0,0,0,2,24,8,21560,8880,1784,14297,0
46,790,6,4,4,0,0,2,6,1,2,1,2,3,3,2,4,0,2,0,0,2,24,8,21560,8880,1784,14298,0
46,790,6,4,4,0,0,2,6,0,0,0,0,0,0,0,0,0,0,0,0,2,24,8,21560,8880,1784,14299,0
46,790,7,5,5,0,0,2,7,0,0,0,0,0,0,0,0,0,0,0,0,2,24,8,21560,8880,1784,14300,0
46,790,6,4,4,0,0,2,6,0,0,0,0,0,0,0,0,0,0,0,0,2,24,8,21560,8880,1784,14301,0
46,790,10,6,6,0,0,4,10,0,0,0,0,0,0,0,0,0,0,0,0,2,24,8,21560,8880,1784,14302,0
46,790,1,1,1,0,0,0,1,0,0,0,0,0,0,0,0,0,0,0,0,2,24,8,21560,8880,1784,14302,0
46,790,14,10,10,0,0,4,14,1,1,1,1,2,2,0,2,0,1,0,0,2,24,8,21560,8880,1784,14303,0
46,790,46,26,30,3,0,12,49,3,6,3,6,9,9,20,28,1,42,2,0,2,24,8,21570,8880,1784,14304,0
38,718,127,75,83,2,11,30,129,4,14,7,14,18,21,61,87,2,175,9,0,2,3,12,21570,8880,1784,14305,0
38,718,652,304,544,16,6,88,668,6,89,51,101,95,152,591,998,3,3399,188,0,2,3,12,21570,8881,1784,14306,0
38,718,2,2,2,0,0,0,2,0,0,0,0,0,0,0,0,0,0,0,0,2,3,12,21570,8881,1784,14306,0
38,718,8,5,5,0,0,3,8,0,0,0,0,0,0,0,0,0,0,0,0,2,3,12,21570,8881,1784,14307,0
38,718,2,2,2,0,0,0,2,0,0,0,0,0,0,0,0,0,0,0,0,2,3,12,21570,8881,1784,14307,0
38,718,14,8,8,0,0,6,14,0,0,0,0,0,0,0,0,0,0,0,0,2,3,12,21570,8881,1784,14308,0
38,718,6,4,4,0,0,2,6,0,0,0,0,0,0,0,0,0,0,0,0,2,3,12,21570,8881,1784,14309,0
38,718,6,4,4,0,0,2,6,1,2,1,2,3,3,2,4,0,2,0,0,2,3,12,21570,8881,1784,14310,0
38,718,6,4,4,0,0,2,6,0,0,0,0,0,0,0,0,0,0,0,0,2,3,12,21570,8881,1784,14311,0
38,718,7,5,5,0,0,2,7,0,0,0,0,0,0,0,0,0,0,0,0,2,3,12,21570,8881,1784,14312,0
38,718,6,4,4,0,0,2,6,0,0,0,0,0,0,0,0,0,0,0,0,2,3,12,21570,8881,1784,14313,0
38,718,10,6,6,0,0,4,10,0,0,0,0,0,0,0,0,0,0,0,0,2,3,12,21570,8881,1784,14314,0
38,718,1,1,1,0,0,0,1,0,0,0,0,0,0,0,0,0,0,0,0,2,3,12,21570,8881,1784,14314,0
38,718,14,10,10,0,0,4,14,1,1,1,1,2,2,0,2,0,1,0,0,2,3,12,21570,8881,1784,14315,0
38,718,46,26,30,3,0,12,49,3,6,3,6,9,9,20,28,1,42,2,0,2,3,12,21580,8881,1784,14316,0
38,712,127,75,83,2,11,30,129,4,14,7,14,18,21,61,87,2,175,9,0,2,2,2,21580,8881,1784,14317,0
38,712,652,304,544,16,6,88,668,6,89,51,101,95,152,591,998,3,3399,188,0,2,2,2,21580,8882,1784,14318,0
38,712,2,2,2,0,0,0,2,0,0,0,0,0,0,0,0,0,0,0,0,2,2,2,21580,8882,1784,14318,0
38,712,8,5,5,0,0,3,8,0,0,0,0,0,0,0,0,0,0,0,0,2,2,2,21580,8882,1784,14319,0
38,712,2,2,2,0,0,0,2,0,0,0,0,0,0,0,0,0,0,0,0,2,2,2,21580,8882,1784,14319,0
38,712,14,8,8,0,0,6,14,0,0,0,0,0,0,0,0,0,0,0,0,2,2,2,21580,8882,1784,14320,0
38,712,6,4,4,0,0,2,6,0,0,0,0,0,0,0,0,0,0,0,0,2,2,2,21580,8882,1784,14321,0
38,712,6,4,4,0,0,2,6,1,2,1,2,3,3,2,4,0,2,0,0,2,2,2,21580,8882,1784,14322,0
38,712,6,4,4,0,0,2,6,0,0,0,0,0,0,0,0,0,0,0,0,2,2,2,21580,8882,1784,14323,0
38,712,7,5,5,0,0,2,7,0,0,0,0,0,0,0,0,0,0,0,0,2,2,2,21580,8882,1784,14324,0
38,712,6,4,4,0,0,2,6,0,0,0,0,0,0,0,0,0,0,0,0,2,2,2,21580,8882,1784,14325,0
38,712,10,6,6,0,0,4,10,0,0,0,0,0,0,0,0,0,0,0,0,2,2,2,21580,8882,1784,14326,0
38,712,1,1,1,0,0,0,1,0,0,0,0,0,0,0,0,0,0,0,0,2,2,2,21580,8882,1784,14326,0
38,712,14,10,10,0,0,4,14,1,1,1,1,2,2,0,2,0,1,0,0,2,2,2,21580,8882,1784,14327,0
38,712,46,26,30,3,0,12,49,3,6,3,6,9,9,20,28,1,42,2,0,2,2,2,21590,8882,1784,14328,0
38,712,127,75,83,2,11,30,129,4,14,7,14,18,21,61,87,2,175,9,0,2,43,20,21590,8882,1784,14329,0
38,712,652,304,544,16,6,88,668,6,89,51,101,95,152,591,998,3,3399,188,0,2,43,20,21590,8883,1784,14330,0
38,712,2,2,2,0,0,0,2,0,0,0,0,0,0,0,0,0,0,0,0,2,43,20,21590,8883,1784,14330,0
38,712,8,5,5,0,0,3,8,0,0,0,0,0,0,0,0,0,0,0,0,2,43,20,21590,8883,1784,14331,0
38,712,2,2,2,0,0,0,2,0,0,0,0,0,0,0,0,0,0,0,0,2,43,20,21590,8883,1784,14331,0
38,712,14,8,8,0,0,6,14,0,0,0,0,0,0,0,0,0,0,0,0,2,43,20,21590,8883,1784,14332,0
38,712,6,4,4,0,0,2,6,0,0,0,0,0,0,0,0,0,0,0,0,2,43,20,21590,8883,1784,14333,0
38,712,6,4,4,0,0,2,6,1,2,1,2,3,3,2,4,0,2,0,0,2,43,20,21590,8883,1784,14334,0
38,712,6,4,4,0,0,2,6,0,0,0,0,0,0,0,0,0,0,0,0,2,43,20,21590,8883,1784,14335,0
38,712,7,5,5,0,0,2,7,0,0,0,0,0,0,0,0,0,0,0,0,2,43,20,21590,8883,1784,14336,0
38,712,6,4,4,0,0,2,6,0,0,0,0,0,0,0,0,0,0,0,0,2,43,20,21590,8883,1784,14337,0
38,712,10,6,6,0,0,4,10,0,0,0,0,0,0,0,0,0,0,0,0,2,43,20,21590,8883,1784,14338,0
38,712,1,1,1,0,0,0,1,0,0,0,0,0,0,0,0,0,0,0,0,2,43,20,21590,8883,1784,14338,0
38,712,14,10,10,0,0,4,14,1,1,1,1,2,2,0,2,0,1,0,0,2,43,20,21590,8883,1784,14339,0
38,712,46,26,30,3,0,12,49,3,6,3,6,9,9,20,28,1,42,2,0,2,43,20,21600,8883,1784,14340,0
109,4155,1513,682,1277,25,13,200,1538,11,199,116,219,210,335,1557,2584,6,15641,868,0,2,3,2,21600,8885,1784,14341,0
38,712,127,75,83,2,11,30,129,4,14,7,14,18,21,61,87,2,175,9,0,2,1,1,21600,8885,1784,14342,0
38,712,652,304,544,16,6,88,668,6,89,51,101,95,152,591,998,3,3399,188,0,2,1,1,21600,8886,1784,14343,0
38,712,2,2,2,0,0,0,2,0,0,0,0,0,0,0,0,0,0,0,0,2,1,1,21600,8886,1784,14343,0
38,712,8,5,5,0,0,3,8,0,0,0,0,0,0,0,0,0,0,0,0,2,1,1,21600,8886,1784,14344,0
38,712,2,2,2,0,0,0,2,0,0,0,0,0,0,0,0,0,0,0,0,2,1,1,21600,8886,1784,14344,0
38,712,14,8,8,0,0,6,14,0,0,0,0,0,0,0,0,0,0,0,0,2,1,1,21600,8886,1784,14345,0
38,712,6,4,4,0,0,2,6,0,0,0,0,0,0,0,0,0,0,0,0,2,1,1,21600,8886,1784,14346,0
38,712,6,4,4,0,0,2,6,1,2,1,2,3,3,2,4,0,2,0,0,2,1,1,21600,8886,1784,14347,0
38,712,6,4,4,0,0,2,6,0,0,0,0,0,0,0,0,0,0,0,0,2,1,1,21600,8886,1784,14348,0
38,712,7,5,5,0,0,2,7,0,0,0,0,0,0,0,0,0,0,0,0,2,1,1,21600,8886,1784,14349,0
38,712,6,4,4,0,0,2,6,0,0,0,0,0,0,0,0,0,0,0,0,2,1,1,21600,8886,1784,14350,0
38,712,10,6,6,0,0,4,10,0,0,0,0,0,0,0,0,0,0,0,0,2,1,1,21600,8886,1784,14351,0
38,712,1,1,1,0,0,0,1,0,0,0,0,0,0,0,0,0,0,0,0,2,1,1,21600,8886,1784,14351,0
38,712,14,10,10,0,0,4,14,1,1,1,1,2,2,0,2,0,1,0,0,2,1,1,21600,8886,1784,14352,0
38,712,46,26,30,3,0,12,49,3,6,3,6,9,9,20,28,1,42,2,0,2,1,1,21610,8886,1784,14353,0
114,2252,1513,682,1277,25,13,200,1538,11,199,116,219,210,335,1557,2584,6,15641,868,0,2,1,1,21610,8888,1784,14354,1
114,2252,819,519,539,24,98,155,843,15,96,57,106,111,163,690,1107,8,9171,509,0,2,1,1,21620,8890,1784,14355,1
224,4615,1457,730,1242,11,6,188,1468,10,292,166,329,302,495,2424,4078,5,22973,1276,1,2,18,29,21620,8892,1784,14356,1
224,4615,74,35,59,1,0,14,75,3,14,7,14,17,21,58,85,1,128,7,0,2,18,29,21620,8893,1784,14357,1
224,4615,245,125,200,5,7,34,250,7,30,17,34,37,51,166,265,3,1053,58,0,2,18,29,21630,8894,1784,14358,1
41,2012,1457,730,1242,11,6,188,1468,10,292,166,329,302,495,2424,4078,5,22973,1276,1,2,1,1,21630,8896,1784,14359,1
32,1557,652,304,544,16,6,88,668,6,89,51,101,95,152,591,998,3,3399,188,0,2,39,28,21630,8897,1784,14360,1
108,4151,1513,682,1277,25,13,200,1538,11,199,116,219,210,335,1557,2584,6,15641,868,0,2,5,7,21630,8899,1784,14361,0
13,444,42,7,35,4,0,5,46,1,2,1,2,3,3,2,4,0,2,0,0,2,1,1,21630,8899,1784,14362,0
13,444,11,6,10,0,0,1,11,2,4,2,4,6,6,10,15,1,15,0,0,2,1,1,21630,8899,1784,14363,0
77,1712,477,336,357,30,23,73,507,16,194,134,250,210,384,1538,2962,10,30538,1696,0,2,1,2,21640,8900,1784,14364,0
171,3868,77,34,69,0,0,8,77,3,24,16,29,27,45,114,213,1,387,21,0,2,1,0,21640,8900,1784,14365,0
171,3868,712,438,573,51,9,84,763,14,102,71,128,116,199,733,1364,8,11988,666,0,2,1,0,21650,8901,1784,14366,0
439,9792,72,33,56,0,4,12,72,1,1,1,1,2,2,0,2,0,1,0,0,2,2,2,21650,8901,1784,14367,0
439,9792,1454,835,1044,76,110,219,1530,17,275,158,296,292,454,2297,3718,9,34017,1889,1,2,2,2,21660,8902,1784,14368,0
108,4149,1513,682,1277,25,13,200,1538,11,199,116,219,210,335,1557,2584,6,15641,868,0,2,0,1,21660,8904,1784,14369,0
32,641,2,2,2,0,0,0,2,0,0,0,0,0,0,0,0,0,0,0,0,2,37,17,21660,8904,1784,14369,1
32,641,99,48,90,1,3,5,100,0,0,0,0,0,0,0,0,0,0,0,0,2,37,17,21660,8905,1784,14370,1
32,641,8,5,5,2,0,1,10,0,0,0,0,0,0,0,0,0,0,0,0,2,37,17,21660,8905,1784,14371,1
32,641,1217,716,841,84,126,174,1301,14,185,118,215,199,333,1446,2542,8,20687,1149,0,2,37,17,21670,8907,1784,14372,1
32,641,160,89,115,0,13,31,160,7,15,11,17,22,28,78,124,3,495,27,0,2,37,17,21670,8907,1784,14373,1
32,641,10,10,9,9,0,0,19,0,0,0,0,0,0,0,0,0,0,0,0,2,37,17,21670,8907,1785,14374,1
32,641,173,84,99,8,29,36,181,5,12,7,13,17,20,54,81,2,221,12,0,2,37,17,21670,8908,1785,14375,1
32,641,3,1,1,3,0,0,6,0,0,0,0,0,0,0,0,0,0,0,0,2,37,17,21670,8908,1785,14376,1
33,659,2,2,2,0,0,0,2,0,0,0,0,0,0,0,0,0,0,0,0,2,22,5,21670,8908,1785,14376,1
33,659,99,48,90,1,3,5,100,0,0,0,0,0,0,0,0,0,0,0,0,2,22,5,21670,8909,1785,14377,1
33,659,8,5,5,2,0,1,10,0,0,0,0,0,0,0,0,0,0,0,0,2,22,5,21670,8909,1785,14378,1
33,659,1217,716,841,84,126,174,1301,14,185,118,215,199,333,1446,2542,8,20687,1149,0,2,22,5,21680,8911,1785,14379,1
33,659,160,89,115,0,13,31,160,7,15,11,17,22,28,78,124,3,495,27,0,2,22,5,21680,8911,1785,14380,1
33,659,10,10,9,9,0,0,19,0,0,0,0,0,0,0,0,0,0,0,0,2,22,5,21680,8911,1786,14381,1
33,659,173,84,99,8,29,36,181,5,12,7,13,17,20,54,81,2,221,12,0,2,22,5,21680,8912,1786,14382,1
33,659,3,1,1,3,0,0,6,0,0,0,0,0,0,0,0,0,0,0,0,2,22,5,21680,8912,1786,14383,1
55,1940,1450,624,1228,12,26,181,1462,14,306,186,354,320,540,2580,4493,8,36391,2021,1,2,16,0,21680,8914,1787,14384,1
108,4145,1513,682,1277,25,13,200,1538,11,199,116,219,210,335,1557,2584,6,15641,868,0,2,2,2,21680,8916,1787,14385,0
108,4145,1513,682,1277,25,13,200,1538,11,199,116,219,210,335,1557,2584,6,15641,868,0,2,2,3,21680,8918,1787,14386,0
109,4172,1513,682,1277,25,13,200,1538,11,199,116,219,210,335,1557,2584,6,15641,868,0,2,18,0,21680,8920,1787,14387,1
231,4784,1457,730,1242,11,6,188,1468,10,292,166,329,302,495,2424,4078,5,22973,1276,1,2,39,9,21680,8922,1787,14388,1
231,4784,74,35,59,1,0,14,75,3,14,7,14,17,21,58,85,1,128,7,0,2,39,9,21680,8923,1787,14389,1
231,4784,245,125,200,5,7,34,250,7,30,17,34,37,51,166,265,3,1053,58,0,2,39,9,21690,8924,1787,14390,1
42,1077,74,35,59,1,0,14,75,3,14,7,14,17,21,58,85,1,128,7,0,2,1,9,21690,8925,1787,14391,1
42,1077,245,125,200,5,7,34,250,7,30,17,34,37,51,166,265,3,1053,58,0,2,1,9,21700,8926,1787,14392,1
65,2681,1289,550,1043,56,32,155,1345,10,167,93,185,177,278,1266,2075,5,11498,638,0,2,12,0,21700,8928,1788,14393,1
109,4172,1513,682,1277,25,13,200,1538,11,199,116,219,210,335,1557,2584,6,15641,868,0,2,1,1,21700,8930,1788,14394,1
218,4490,1457,730,1242,11,6,188,1468,10,292,166,329,302,495,2424,4078,5,22973,1276,1,2,20,46,21700,8932,1788,14395,1
218,4490,74,35,59,1,0,14,75,3,14,7,14,17,21,58,85,1,128,7,0,2,20,46,21700,8933,1788,14396,1
218,4490,245,125,200,5,7,34,250,7,30,17,34,37,51,166,265,3,1053,58,0,2,20,46,21710,8934,1788,14397,1
171,3865,77,34,69,0,0,8,77,3,24,16,29,27,45,114,213,1,387,21,0,2,1,1,21710,8934,1788,14398,1
171,3865,712,438,573,51,9,84,763,14,102,71,128,116,199,733,1364,8,11988,666,0,2,1,1,21720,8935,1788,14399,1
38,1794,1457,730,1242,11,6,188,1468,10,292,166,329,302,495,2424,4078,5,22973,1276,1,2,8,36,21720,8937,1788,14400,1
26,1455,652,304,544,16,6,88,668,6,89,51,101,95,152,591,998,3,3399,188,0,2,22,48,21720,8938,1788,14401,1
231,4784,1457,730,1242,11,6,188,1468,10,292,166,329,302,495,2424,4078,5,22973,1276,1,2,39,9,21720,8940,1788,14402,0
231,4784,74,35,59,1,0,14,75,3,14,7,14,17,21,58,85,1,128,7,0,2,39,9,21720,8941,1788,14403,0
231,4784,245,125,200,5,7,34,250,7,30,17,34,37,51,166,265,3,1053,58,0,2,39,9,21730,8942,1788,14404,0
42,1077,74,35,59,1,0,14,75,3,14,7,14,17,21,58,85,1,128,7,0,2,1,9,21730,8943,1788,14405,0
42,1077,245,125,200,5,7,34,250,7,30,17,34,37,51,166,265,3,1053,58,0,2,1,9,21740,8944,1788,14406,0
65,2681,1289,550,1043,56,32,155,1345,10,167,93,185,177,278,1266,2075,5,11498,638,0,2,12,0,21740,8946,1789,14407,0
225,4659,1457,730,1242,11,6,188,1468,10,292,166,329,302,495,2424,4078,5,22973,1276,1,2,20,46,21740,8948,1789,14408,0
225,4659,74,35,59,1,0,14,75,3,14,7,14,17,21,58,85,1,128,7,0,2,20,46,21740,8949,1789,14409,0
225,4659,245,125,200,5,7,34,250,7,30,17,34,37,51,166,265,3,1053,58,0,2,20,46,21750,8950,1789,14410,0
171,3865,77,34,69,0,0,8,77,3,24,16,29,27,45,114,213,1,387,21,0,2,1,1,21750,8950,1789,14411,0
171,3865,712,438,573,51,9,84,763,14,102,71,128,116,199,733,1364,8,11988,666,0,2,1,1,21760,8951,1789,14412,0
38,1794,1457,730,1242,11,6,188,1468,10,292,166,329,302,495,2424,4078,5,22973,1276,1,2,8,36,21760,8953,1789,14413,0
26,1455,652,304,544,16,6,88,668,6,89,51,101,95,152,591,998,3,3399,188,0,2,22,48,21760,8954,1789,14414,0
77,1712,477,336,357,30,23,73,507,16,194,134,250,210,384,1538,2962,10,30538,1696,0,2,1,2,21770,8955,1789,14415,0
171,3868,77,34,69,0,0,8,77,3,24,16,29,27,45,114,213,1,387,21,0,2,1,0,21770,8955,1789,14416,0
171,3868,712,438,573,51,9,84,763,14,102,71,128,116,199,733,1364,8,11988,666,0,2,1,0,21780,8956,1789,14417,0
439,9792,72,33,56,0,4,12,72,1,1,1,1,2,2,0,2,0,1,0,0,2,2,2,21780,8956,1789,14418,0
439,9792,1454,835,1044,76,110,219,1530,17,275,158,296,292,454,2297,3718,9,34017,1889,1,2,2,2,21790,8957,1789,14419,0
114,2252,1513,682,1277,25,13,200,1538,11,199,116,219,210,335,1557,2584,6,15641,868,0,2,1,1,21790,8959,1789,14420,1
114,2252,819,519,539,24,98,155,843,15,96,57,106,111,163,690,1107,8,9171,509,0,2,1,1,21800,8961,1789,14421,1
198,4464,722,423,573,19,0,135,741,12,172,101,199,184,300,1320,2257,6,15668,870,0,2,8,2,21800,8963,1789,14423,0
198,4464,1508,847,911,44,250,301,1552,14,148,88,169,162,257,1120,1886,7,15077,837,0,2,8,2,21800,8964,1790,14424,0
117,2932,1660,832,1314,41,38,274,1701,20,312,209,395,332,604,2671,5058,12,64042,3557,1,2,15,14,21800,8966,1791,14426,0
114,2252,1513,682,1277,25,13,200,1538,11,199,116,219,210,335,1557,2584,6,15641,868,0,2,1,1,21800,8968,1791,14427,0
114,2252,819,519,539,24,98,155,843,15,96,57,106,111,163,690,1107,8,9171,509,0,2,1,1,21810,8970,1791,14428,0
13,444,42,7,35,4,0,5,46,1,2,1,2,3,3,2,4,0,2,0,0,2,1,1,21820,8974,1792,14436,1
13,444,11,6,10,0,0,1,11,2,4,2,4,6,6,10,15,1,15,0,0,2,1,1,21820,8974,1792,14437,1
440,9798,72,33,56,0,4,12,72,1,1,1,1,2,2,0,2,0,1,0,0,2,8,6,21820,8974,1792,14438,1
440,9798,1454,835,1044,76,110,219,1530,17,275,158,296,292,454,2297,3718,9,34017,1889,1,2,8,6,21830,8975,1792,14439,1
125,5370,139,89,101,2,0,35,141,7,54,34,62,61,96,330,569,4,2287,127,0,2,29,0,21830,8975,1792,14440,1
125,5370,7,5,5,0,0,2,7,1,2,1,2,3,3,2,4,0,2,0,0,2,29,0,21830,8975,1792,14441,1
440,9798,72,33,56,0,4,12,72,1,1,1,1,2,2,0,2,0,1,0,0,2,8,6,21830,8975,1792,14442,0
440,9798,1454,835,1044,76,110,219,1530,17,275,158,296,292,454,2297,3718,9,34017,1889,1,2,8,6,21840,8976,1792,14443,0
125,5370,139,89,101,2,0,35,141,7,54,34,62,61,96,330,569,4,2287,127,0,2,29,0,21840,8976,1792,14444,0
125,5370,7,5,5,0,0,2,7,1,2,1,2,3,3,2,4,0,2,0,0,2,29,0,21840,8976,1792,14445,0
440,9808,72,33,56,0,4,12,72,1,1,1,1,2,2,0,2,0,1,0,0,2,2,0,21840,8976,1792,14446,1
440,9808,1454,835,1044,76,110,219,1530,17,275,158,296,292,454,2297,3718,9,34017,1889,1,2,2,0,21850,8977,1792,14447,1
25,624,465,148,393,5,8,60,470,4,31,20,31,35,51,161,261,2,523,29,0,2,15,0,21850,8978,1792,14448,1
25,624,16,12,9,0,0,6,16,1,2,1,2,3,3,2,4,0,2,0,0,2,15,0,21850,8978,1792,14449,1
440,9808,72,33,56,0,4,12,72,1,1,1,1,2,2,0,2,0,1,0,0,2,2,0,21850,8978,1792,14450,0
440,9808,1454,835,1044,76,110,219,1530,17,275,158,296,292,454,2297,3718,9,34017,1889,1,2,2,0,21860,8979,1792,14451,0
25,624,465,148,393,5,8,60,470,4,31,20,31,35,51,161,261,2,523,29,0,2,15,0,21860,8980,1792,14452,0
25,624,16,12,9,0,0,6,16,1,2,1,2,3,3,2,4,0,2,0,0,2,15,0,21860,8980,1792,14453,0
441,9824,72,33,56,0,4,12,72,1,1,1,1,2,2,0,2,0,1,0,0,2,3,0,21860,8980,1792,14454,1
441,9824,1454,835,1044,76,110,219,1530,17,275,158,296,292,454,2297,3718,9,34017,1889,1,2,3,0,21870,8981,1792,14455,1
55,1039,1098,241,925,5,10,155,1103,7,46,25,49,53,74,273,423,3,1580,87,0,2,3,1,21880,8983,1792,14456,1
55,1039,282,202,222,14,2,44,296,8,42,24,43,50,67,250,378,4,1548,86,0,2,3,1,21880,8984,1792,14457,1
28,753,465,148,393,5,8,60,470,4,31,20,31,35,51,161,261,2,523,29,0,2,51,4,21880,8985,1792,14458,1
28,753,16,12,9,0,0,6,16,1,2,1,2,3,3,2,4,0,2,0,0,2,51,4,21880,8985,1792,14459,1
28,753,465,148,393,5,8,60,470,4,31,20,31,35,51,161,261,2,523,29,0,2,2,2,21880,8986,1792,14460,0
28,753,16,12,9,0,0,6,16,1,2,1,2,3,3,2,4,0,2,0,0,2,2,2,21880,8986,1792,14461,0
442,9834,72,33,56,0,4,12,72,1,1,1,1,2,2,0,2,0,1,0,0,2,5,4,21880,8986,1792,14462,1
442,9834,1454,835,1044,76,110,219,1530,17,275,158,296,292,454,2297,3718,9,34017,1889,1,2,5,4,21890,8987,1792,14463,1
28,774,465,148,393,5,8,60,470,4,31,20,31,35,51,161,261,2,523,29,0,2,4,1,21890,8988,1792,14464,1
28,774,16,12,9,0,0,6,16,1,2,1,2,3,3,2,4,0,2,0,0,2,4,1,21890,8988,1792,14465,1
442,9834,72,33,56,0,4,12,72,1,1,1,1,2,2,0,2,0,1,0,0,2,8,4,21890,8988,1792,14466,0
442,9834,1454,835,1044,76,110,219,1530,17,275,158,296,292,454,2297,3718,9,34017,1889,1,2,8,4,21900,8989,1792,14467,0
55,1039,1098,241,925,5,10,155,1103,7,46,25,49,53,74,273,423,3,1580,87,0,2,3,1,21910,8991,1792,14468,0
55,1039,282,202,222,14,2,44,296,8,42,24,43,50,67,250,378,4,1548,86,0,2,3,1,21910,8992,1792,14469,0
28,774,465,148,393,5,8,60,470,4,31,20,31,35,51,161,261,2,523,29,0,2,52,2,21910,8993,1792,14470,0
28,774,16,12,9,0,0,6,16,1,2,1,2,3,3,2,4,0,2,0,0,2,52,2,21910,8993,1792,14471,0
86,1521,1178,367,1042,6,15,115,1184,9,94,51,95,103,146,644,976,4,4439,246,0,2,1,1,21910,8993,1792,14472,0
86,1521,177,108,140,8,0,27,185,6,30,16,32,36,48,162,248,3,794,44,0,2,1,1,21910,8995,1792,14473,0
226,4706,1457,730,1242,11,6,188,1468,10,292,166,329,302,495,2424,4078,5,22973,1276,1,2,9,2,21910,8997,1792,14474,1
226,4706,74,35,59,1,0,14,75,3,14,7,14,17,21,58,85,1,128,7,0,2,9,2,21910,8998,1792,14475,1
226,4706,245,125,200,5,7,34,250,7,30,17,34,37,51,166,265,3,1053,58,0,2,9,2,21920,8999,1792,14476,1
167,3428,1943,715,1694,26,18,214,1969,12,185,120,237,197,357,1436,2721,7,20915,1161,0,2,4,2,21920,9001,1792,14477,1
167,3428,1168,838,957,57,25,144,1225,19,348,224,416,367,640,3018,5452,11,61921,3440,1,2,4,2,21930,9003,1792,14478,1
125,5370,139,89,101,2,0,35,141,7,54,34,62,61,96,330,569,4,2287,127,0,2,30,30,21930,9003,1792,14479,1
125,5370,7,5,5,0,0,2,7,1,2,1,2,3,3,2,4,0,2,0,0,2,30,30,21930,9003,1792,14480,1
38,2226,334,251,279,10,4,40,344,5,127,74,143,132,217,899,1528,2,4303,239,0,2,4,0,21930,9004,1792,14481,1
61,2682,1943,715,1694,26,18,214,1969,12,185,120,237,197,357,1436,2721,7,20915,1161,0,2,9,9,21930,9006,1792,14482,1
36,1381,1098,241,925,5,10,155,1103,7,46,25,49,53,74,273,423,3,1580,87,0,2,2,2,21940,9008,1792,14483,1
446,9892,72,33,56,0,4,12,72,1,1,1,1,2,2,0,2,0,1,0,0,2,20,10,21940,9008,1792,14484,1
446,9892,1454,835,1044,76,110,219,1530,17,275,158,296,292,454,2297,3718,9,34017,1889,1,2,20,10,21950,9009,1792,14485,1
11,239,256,139,192,9,7,47,265,4,23,12,24,27,36,112,171,2,357,19,0,2,7,0,21950,9010,1792,14486,1
226,4706,1457,730,1242,11,6,188,1468,10,292,166,329,302,495,2424,4078,5,22973,1276,1,2,9,2,21950,9012,1792,14487,0
226,4706,74,35,59,1,0,14,75,3,14,7,14,17,21,58,85,1,128,7,0,2,9,2,21950,9013,1792,14488,0
226,4706,245,125,200,5,7,34,250,7,30,17,34,37,51,166,265,3,1053,58,0,2,9,2,21960,9014,1792,14489,0
167,3428,1943,715,1694,26,18,214,1969,12,185,120,237,197,357,1436,2721,7,20915,1161,0,2,4,2,21960,9016,1792,14490,0
167,3428,1168,838,957,57,25,144,1225,19,348,224,416,367,640,3018,5452,11,61921,3440,1,2,4,2,21970,9018,1792,14491,0
125,5370,139,89,101,2,0,35,141,7,54,34,62,61,96,330,569,4,2287,127,0,2,30,30,21970,9018,1792,14492,0
125,5370,7,5,5,0,0,2,7,1,2,1,2,3,3,2,4,0,2,0,0,2,30,30,21970,9018,1792,14493,0
38,2226,334,251,279,10,4,40,344,5,127,74,143,132,217,899,1528,2,4303,239,0,2,4,0,21970,9019,1792,14494,0
61,2682,1943,715,1694,26,18,214,1969,12,185,120,237,197,357,1436,2721,7,20915,1161,0,2,9,9,21970,9021,1792,14495,0
36,1381,1098,241,925,5,10,155,1103,7,46,25,49,53,74,273,423,3,1580,87,0,2,2,2,21980,9023,1792,14496,0
448,9938,72,33,56,0,4,12,72,1,1,1,1,2,2,0,2,0,1,0,0,2,14,11,21980,9023,1792,14497,1
448,9938,1454,835,1044,76,110,219,1530,17,275,158,296,292,454,2297,3718,9,34017,1889,1,2,14,11,21990,9024,1792,14498,1
126,5403,139,89,101,2,0,35,141,7,54,34,62,61,96,330,569,4,2287,127,0,2,19,0,21990,9024,1792,14499,1
126,5403,7,5,5,0,0,2,7,1,2,1,2,3,3,2,4,0,2,0,0,2,19,0,21990,9024,1792,14500,1
454,9994,72,33,56,0,4,12,72,1,1,1,1,2,2,0,2,0,1,0,0,2,38,15,21990,9024,1792,14501,1
454,9994,1454,835,1044,76,110,219,1530,17,275,158,296,292,454,2297,3718,9,34017,1889,1,2,38,15,22000,9025,1792,14502,1
65,3525,1782,648,1425,9,47,279,1791,8,171,97,189,179,286,1292,2140,4,9462,525,0,2,46,0,22000,9026,1793,14503,1
43,1323,1523,757,1297,19,12,193,1542,12,193,117,230,205,347,1508,2664,7,19053,1058,0,2,1,0,22010,9028,1793,14504,0
43,1323,701,378,504,33,58,109,734,13,110,68,126,123,194,794,1346,7,10027,557,0,2,1,0,22010,9029,1794,14505,0
43,1318,1523,757,1297,19,12,193,1542,12,193,117,230,205,347,1508,2664,7,19053,1058,0,2,1,2,22020,9031,1794,14506,0
43,1318,701,378,504,33,58,109,734,13,110,68,126,123,194,794,1346,7,10027,557,0,2,1,2,22020,9032,1795,14507,0
39,2430,1523,757,1297,19,12,193,1542,12,193,117,230,205,347,1508,2664,7,19053,1058,0,2,2,0,22030,9034,1795,14508,1
15,465,42,7,35,4,0,5,46,1,2,1,2,3,3,2,4,0,2,0,0,2,2,1,22030,9034,1795,14509,0
15,465,11,6,10,0,0,1,11,2,4,2,4,6,6,10,15,1,15,0,0,2,2,1,22030,9034,1795,14510,0
43,863,447,308,343,6,5,95,453,7,96,59,111,103,170,651,1136,4,4600,255,0,2,5,1,22030,9037,1795,14511,1
43,863,322,174,179,16,74,51,338,10,41,26,46,51,72,252,408,5,2291,127,0,2,5,1,22030,9040,1796,14512,1
15,465,42,7,35,4,0,5,46,1,2,1,2,3,3,2,4,0,2,0,0,2,2,1,22030,9040,1796,14513,0
15,465,11,6,10,0,0,1,11,2,4,2,4,6,6,10,15,1,15,0,0,2,2,1,22030,9040,1796,14514,0
14,452,42,7,35,4,0,5,46,1,2,1,2,3,3,2,4,0,2,0,0,2,31,29,22030,9040,1796,14515,1
14,452,11,6,10,0,0,1,11,2,4,2,4,6,6,10,15,1,15,0,0,2,31,29,22030,9040,1796,14516,1
14,452,42,7,35,4,0,5,46,1,2,1,2,3,3,2,4,0,2,0,0,2,1,1,22030,9040,1796,14517,0
14,452,11,6,10,0,0,1,11,2,4,2,4,6,6,10,15,1,15,0,0,2,1,1,22030,9040,1796,14518,0
114,2482,1043,504,840,53,9,147,1096,9,180,112,198,189,310,1377,2344,4,11604,644,0,2,1,1,22030,9042,1796,14519,1
114,2482,383,288,292,26,6,62,409,11,65,38,67,76,105,429,656,5,3719,206,0,2,1,1,22030,9043,1796,14520,1
114,2482,1043,504,840,53,9,147,1096,9,180,112,198,189,310,1377,2344,4,11604,644,0,2,1,1,22030,9045,1796,14521,0
114,2482,383,288,292,26,6,62,409,11,65,38,67,76,105,429,656,5,3719,206,0,2,1,1,22030,9046,1796,14522,0
229,4732,1457,730,1242,11,6,188,1468,10,292,166,329,302,495,2424,4078,5,22973,1276,1,2,11,3,22030,9048,1796,14523,1
229,4732,74,35,59,1,0,14,75,3,14,7,14,17,21,58,85,1,128,7,0,2,11,3,22030,9049,1796,14524,1
229,4732,245,125,200,5,7,34,250,7,30,17,34,37,51,166,265,3,1053,58,0,2,11,3,22040,9050,1796,14525,1
39,1827,1457,730,1242,11,6,188,1468,10,292,166,329,302,495,2424,4078,5,22973,1276,1,2,9,0,22040,9052,1796,14526,1
14,452,42,7,35,4,0,5,46,1,2,1,2,3,3,2,4,0,2,0,0,2,31,29,22040,9052,1796,14527,0
14,452,11,6,10,0,0,1,11,2,4,2,4,6,6,10,15,1,15,0,0,2,31,29,22040,9052,1796,14528,0
55,1940,1450,624,1228,12,26,181,1462,14,306,186,354,320,540,2580,4493,8,36391,2021,1,2,1,1,22040,9054,1797,14529,0
1,282,382,65,130,157,2,92,539,4,10,5,10,14,15,41,57,2,114,6,0,2,1,1,22040,9055,1798,14530,0
1,285,382,65,130,157,2,92,539,4,10,5,10,14,15,41,57,2,114,6,0,2,1,1,22040,9056,1799,14531,0
45,445,647,139,84,35,284,233,682,0,0,0,0,0,0,0,0,0,0,0,0,2,1,1,22040,9056,1799,14532,0
45,445,647,139,84,35,284,233,682,0,0,0,0,0,0,0,0,0,0,0,0,2,6,6,22040,9056,1799,14533,0
45,445,647,139,84,35,284,233,682,0,0,0,0,0,0,0,0,0,0,0,0,2,6,6,22040,9056,1799,14534,0
127,5436,139,89,101,2,0,35,141,7,54,34,62,61,96,330,569,4,2287,127,0,2,24,0,22040,9056,1799,14535,1
127,5436,7,5,5,0,0,2,7,1,2,1,2,3,3,2,4,0,2,0,0,2,24,0,22040,9056,1799,14536,1
55,1934,1450,624,1228,12,26,181,1462,14,306,186,354,320,540,2580,4493,8,36391,2021,1,2,0,1,22040,9058,1800,14537,0
108,4145,1513,682,1277,25,13,200,1538,11,199,116,219,210,335,1557,2584,6,15641,868,0,2,2,19,22040,9060,1800,14538,0
39,1833,1457,730,1242,11,6,188,1468,10,292,166,329,302,495,2424,4078,5,22973,1276,1,2,2,2,22040,9062,1800,14539,0
234,4805,1457,730,1242,11,6,188,1468,10,292,166,329,302,495,2424,4078,5,22973,1276,1,2,8,0,22040,9064,1800,14540,1
234,4805,74,35,59,1,0,14,75,3,14,7,14,17,21,58,85,1,128,7,0,2,8,0,22040,9065,1800,14541,1
234,4805,245,125,200,5,7,34,250,7,30,17,34,37,51,166,265,3,1053,58,0,2,8,0,22050,9066,1800,14542,1
171,3890,77,34,69,0,0,8,77,3,24,16,29,27,45,114,213,1,387,21,0,2,3,0,22050,9066,1800,14543,1
171,3890,712,438,573,51,9,84,763,14,102,71,128,116,199,733,1364,8,11988,666,0,2,3,0,22060,9067,1800,14544,1
40,1882,1457,730,1242,11,6,188,1468,10,292,166,329,302,495,2424,4078,5,22973,1276,1,2,15,0,22060,9069,1800,14545,1
231,4784,1457,730,1242,11,6,188,1468,10,292,166,329,302,495,2424,4078,5,22973,1276,1,2,9,9,22060,9071,1800,14546,1
231,4784,74,35,59,1,0,14,75,3,14,7,14,17,21,58,85,1,128,7,0,2,9,9,22060,9072,1800,14547,1
231,4784,245,125,200,5,7,34,250,7,30,17,34,37,51,166,265,3,1053,58,0,2,9,9,22070,9073,1800,14548,1
171,3890,77,34,69,0,0,8,77,3,24,16,29,27,45,114,213,1,387,21,0,2,1,2,22070,9073,1800,14549,1
171,3890,712,438,573,51,9,84,763,14,102,71,128,116,199,733,1364,8,11988,666,0,2,1,2,22080,9074,1800,14550,1
231,4784,1457,730,1242,11,6,188,1468,10,292,166,329,302,495,2424,4078,5,22973,1276,1,2,9,1,22080,9076,1800,14551,0
231,4784,74,35,59,1,0,14,75,3,14,7,14,17,21,58,85,1,128,7,0,2,9,1,22080,9077,1800,14552,0
231,4784,245,125,200,5,7,34,250,7,30,17,34,37,51,166,265,3,1053,58,0,2,9,1,22090,9078,1800,14553,0
171,3890,77,34,69,0,0,8,77,3,24,16,29,27,45,114,213,1,387,21,0,2,2,0,22090,9078,1800,14554,0
171,3890,712,438,573,51,9,84,763,14,102,71,128,116,199,733,1364,8,11988,666,0,2,2,0,22100,9079,1800,14555,0
40,1882,1457,730,1242,11,6,188,1468,10,292,166,329,302,495,2424,4078,5,22973,1276,1,2,15,0,22100,9081,1800,14556,0
172,3908,77,34,69,0,0,8,77,3,24,16,29,27,45,114,213,1,387,21,0,2,7,3,22110,9085,1801,14564,1
172,3908,712,438,573,51,9,84,763,14,102,71,128,116,199,733,1364,8,11988,666,0,2,7,3,22120,9086,1801,14565,1
450,9943,72,33,56,0,4,12,72,1,1,1,1,2,2,0,2,0,1,0,0,2,10,2,22120,9086,1801,14566,1
450,9943,1454,835,1044,76,110,219,1530,17,275,158,296,292,454,2297,3718,9,34017,1889,1,2,10,2,22130,9087,1801,14567,1
167,3430,1943,715,1694,26,18,214,1969,12,185,120,237,197,357,1436,2721,7,20915,1161,0,2,2,2,22130,9089,1801,14568,1
167,3430,1168,838,957,57,25,144,1225,19,348,224,416,367,640,3018,5452,11,61921,3440,1,2,2,2,22140,9091,1801,14569,1
14,452,42,7,35,4,0,5,46,1,2,1,2,3,3,2,4,0,2,0,0,2,2,2,22140,9091,1801,14570,1
14,452,11,6,10,0,0,1,11,2,4,2,4,6,6,10,15,1,15,0,0,2,2,2,22140,9091,1801,14571,1
63,2936,1338,495,1086,10,64,173,1348,11,122,82,157,133,239,883,1686,7,11934,663,0,2,1,1,22140,9093,1801,14572,1
55,1982,1450,624,1228,12,26,181,1462,14,306,186,354,320,540,2580,4493,8,36391,2021,1,2,20,1,22140,9095,1802,14573,1
61,2682,1943,715,1694,26,18,214,1969,12,185,120,237,197,357,1436,2721,7,20915,1161,0,2,3,3,22140,9097,1802,14574,1
231,4784,1457,730,1242,11,6,188,1468,10,292,166,329,302,495,2424,4078,5,22973,1276,1,2,2,1,22140,9099,1802,14575,1
231,4784,74,35,59,1,0,14,75,3,14,7,14,17,21,58,85,1,128,7,0,2,2,1,22140,9100,1802,14576,1
231,4784,245,125,200,5,7,34,250,7,30,17,34,37,51,166,265,3,1053,58,0,2,2,1,22150,9101,1802,14577,1
171,3870,77,34,69,0,0,8,77,3,24,16,29,27,45,114,213,1,387,21,0,2,1,1,22150,9101,1802,14578,1
171,3870,712,438,573,51,9,84,763,14,102,71,128,116,199,733,1364,8,11988,666,0,2,1,1,22160,9102,1802,14579,1
172,3910,77,34,69,0,0,8,77,3,24,16,29,27,45,114,213,1,387,21,0,2,1,1,22160,9102,1802,14580,0
172,3910,712,438,573,51,9,84,763,14,102,71,128,116,199,733,1364,8,11988,666,0,2,1,1,22170,9103,1802,14581,0
23,1010,1455,414,1257,16,76,112,1471,5,41,23,46,46,69,231,381,2,1069,59,0,2,2,0,22170,9104,1802,14582,0
43,1318,1523,757,1297,19,12,193,1542,12,193,117,230,205,347,1508,2664,7,19053,1058,0,2,1,1,22180,9106,1802,14583,0
43,1318,701,378,504,33,58,109,734,13,110,68,126,123,194,794,1346,7,10027,557,0,2,1,1,22180,9107,1803,14584,0
39,2430,1523,757,1297,19,12,193,1542,12,193,117,230,205,347,1508,2664,7,19053,1058,0,2,2,0,22190,9109,1803,14585,0
14,452,42,7,35,4,0,5,46,1,2,1,2,3,3,2,4,0,2,0,0,2,2,2,22200,9113,1804,14593,1
14,452,11,6,10,0,0,1,11,2,4,2,4,6,6,10,15,1,15,0,0,2,2,2,22200,9113,1804,14594,1
14,452,42,7,35,4,0,5,46,1,2,1,2,3,3,2,4,0,2,0,0,2,1,1,22210,9117,1805,14602,0
14,452,11,6,10,0,0,1,11,2,4,2,4,6,6,10,15,1,15,0,0,2,1,1,22210,9117,1805,14603,0
1,285,382,65,130,157,2,92,539,4,10,5,10,14,15,41,57,2,114,6,0,2,1,1,22210,9118,1806,14604,1
1,285,382,65,130,157,2,92,539,4,10,5,10,14,15,41,57,2,114,6,0,2,2,2,22210,9119,1807,14605,1
128,5483,139,89,101,2,0,35,141,7,54,34,62,61,96,330,569,4,2287,127,0,2,29,0,22210,9119,1807,14606,0
128,5483,7,5,5,0,0,2,7,1,2,1,2,3,3,2,4,0,2,0,0,2,29,0,22210,9119,1807,14607,0
231,4784,1457,730,1242,11,6,188,1468,10,292,166,329,302,495,2424,4078,5,22973,1276,1,2,11,2,22220,9125,1808,14615,0
231,4784,74,35,59,1,0,14,75,3,14,7,14,17,21,58,85,1,128,7,0,2,11,2,22220,9126,1808,14616,0
231,4784,245,125,200,5,7,34,250,7,30,17,34,37,51,166,265,3,1053,58,0,2,11,2,22230,9127,1808,14617,0
43,1318,1523,757,1297,19,12,193,1542,12,193,117,230,205,347,1508,2664,7,19053,1058,0,2,1,1,22240,9129,1808,14618,0
43,1318,701,378,504,33,58,109,734,13,110,68,126,123,194,794,1346,7,10027,557,0,2,1,1,22240,9130,1809,14619,0
172,3910,77,34,69,0,0,8,77,3,24,16,29,27,45,114,213,1,387,21,0,2,10,4,22240,9130,1809,14620,0
172,3910,712,438,573,51,9,84,763,14,102,71,128,116,199,733,1364,8,11988,666,0,2,10,4,22250,9131,1809,14621,0
452,9989,72,33,56,0,4,12,72,1,1,1,1,2,2,0,2,0,1,0,0,2,10,2,22250,9131,1809,14622,0
452,9989,1454,835,1044,76,110,219,1530,17,275,158,296,292,454,2297,3718,9,34017,1889,1,2,10,2,22260,9132,1809,14623,0
167,3430,1943,715,1694,26,18,214,1969,12,185,120,237,197,357,1436,2721,7,20915,1161,0,2,2,2,22260,9134,1809,14624,0
167,3430,1168,838,957,57,25,144,1225,19,348,224,416,367,640,3018,5452,11,61921,3440,1,2,2,2,22270,9136,1809,14625,0
1,285,382,65,130,157,2,92,539,4,10,5,10,14,15,41,57,2,114,6,0,2,1,1,22270,9137,1810,14626,0
14,452,42,7,35,4,0,5,46,1,2,1,2,3,3,2,4,0,2,0,0,2,2,2,22270,9137,1810,14627,0
14,452,11,6,10,0,0,1,11,2,4,2,4,6,6,10,15,1,15,0,0,2,2,2,22270,9137,1810,14628,0
63,2936,1338,495,1086,10,64,173,1348,11,122,82,157,133,239,883,1686,7,11934,663,0,2,1,1,22270,9139,1810,14629,0
55,1982,1450,624,1228,12,26,181,1462,14,306,186,354,320,540,2580,4493,8,36391,2021,1,2,20,2,22270,9141,1811,14630,0
108,4145,1513,682,1277,25,13,200,1538,11,199,116,219,210,335,1557,2584,6,15641,868,0,2,2,19,22270,9143,1811,14631,0
40,1882,1457,730,1242,11,6,188,1468,10,292,166,329,302,495,2424,4078,5,22973,1276,1,2,17,2,22270,9145,1811,14632,0
23,1010,1455,414,1257,16,76,112,1471,5,41,23,46,46,69,231,381,2,1069,59,0,2,2,0,22270,9146,1811,14633,0
39,2430,1523,757,1297,19,12,193,1542,12,193,117,230,205,347,1508,2664,7,19053,1058,0,2,2,0,22280,9148,1811,14634,0
61,2682,1943,715,1694,26,18,214,1969,12,185,120,237,197,357,1436,2721,7,20915,1161,0,2,3,3,22280,9150,1811,14635,0
1,285,382,65,130,157,2,92,539,4,10,5,10,14,15,41,57,2,114,6,0,2,2,2,22280,9151,1812,14636,0
90,1584,1178,367,1042,6,15,115,1184,9,94,51,95,103,146,644,976,4,4439,246,0,2,19,4,22280,9151,1812,14637,1
90,1584,177,108,140,8,0,27,185,6,30,16,32,36,48,162,248,3,794,44,0,2,19,4,22280,9153,1812,14638,1
47,2038,1178,367,1042,6,15,115,1184,9,94,51,95,103,146,644,976,4,4439,246,0,2,48,2,22280,9153,1812,14639,1
29,809,465,148,393,5,8,60,470,4,31,20,31,35,51,161,261,2,523,29,0,2,20,0,22280,9154,1812,14640,0
29,809,16,12,9,0,0,6,16,1,2,1,2,3,3,2,4,0,2,0,0,2,20,0,22280,9154,1812,14641,0
89,1573,1178,367,1042,6,15,115,1184,9,94,51,95,103,146,644,976,4,4439,246,0,2,3,6,22280,9154,1812,14642,1
89,1573,177,108,140,8,0,27,185,6,30,16,32,36,48,162,248,3,794,44,0,2,3,6,22280,9156,1812,14643,1
44,1992,1178,367,1042,6,15,115,1184,9,94,51,95,103,146,644,976,4,4439,246,0,2,13,38,22280,9156,1812,14644,1
7,103,38,23,23,0,0,15,38,0,0,0,0,0,0,0,0,0,0,0,0,2,5,0,22280,9156,1812,14645,0
44,1989,1178,367,1042,6,15,115,1184,9,94,51,95,103,146,644,976,4,4439,246,0,2,7,9,22280,9156,1812,14646,0
7,102,38,23,23,0,0,15,38,0,0,0,0,0,0,0,0,0,0,0,0,2,1,1,22280,9156,1812,14647,0
454,10020,72,33,56,0,4,12,72,1,1,1,1,2,2,0,2,0,1,0,0,2,22,7,22280,9156,1812,14648,1
454,10020,1454,835,1044,76,110,219,1530,17,275,158,296,292,454,2297,3718,9,34017,1889,1,2,22,7,22290,9157,1812,14649,1
454,10020,72,33,56,0,4,12,72,1,1,1,1,2,2,0,2,0,1,0,0,2,4,2,22290,9157,1812,14650,1
454,10020,1454,835,1044,76,110,219,1530,17,275,158,296,292,454,2297,3718,9,34017,1889,1,2,4,2,22300,9158,1812,14651,1
89,1573,1178,367,1042,6,15,115,1184,9,94,51,95,103,146,644,976,4,4439,246,0,2,16,4,22300,9158,1812,14652,0
89,1573,177,108,140,8,0,27,185,6,30,16,32,36,48,162,248,3,794,44,0,2,16,4,22300,9160,1812,14653,0
7,102,38,23,23,0,0,15,38,0,0,0,0,0,0,0,0,0,0,0,0,2,5,0,22300,9160,1812,14654,0
44,1989,1178,367,1042,6,15,115,1184,9,94,51,95,103,146,644,976,4,4439,246,0,2,21,2,22300,9160,1812,14655,0
14,452,42,7,35,4,0,5,46,1,2,1,2,3,3,2,4,0,2,0,0,2,1,1,22310,9164,1813,14663,0
14,452,11,6,10,0,0,1,11,2,4,2,4,6,6,10,15,1,15,0,0,2,1,1,22310,9164,1813,14664,0
454,10020,72,33,56,0,4,12,72,1,1,1,1,2,2,0,2,0,1,0,0,2,24,7,22310,9164,1813,14665,0
454,10020,1454,835,1044,76,110,219,1530,17,275,158,296,292,454,2297,3718,9,34017,1889,1,2,24,7,22320,9165,1813,14666,0
29,809,465,148,393,5,8,60,470,4,31,20,31,35,51,161,261,2,523,29,0,2,20,0,22320,9166,1813,14667,0
29,809,16,12,9,0,0,6,16,1,2,1,2,3,3,2,4,0,2,0,0,2,20,0,22320,9166,1813,14668,0
454,10012,72,33,56,0,4,12,72,1,1,1,1,2,2,0,2,0,1,0,0,2,12,23,22320,9166,1813,14669,1
454,10012,1454,835,1044,76,110,219,1530,17,275,158,296,292,454,2297,3718,9,34017,1889,1,2,12,23,22330,9167,1813,14670,1
232,4811,1457,730,1242,11,6,188,1468,10,292,166,329,302,495,2424,4078,5,22973,1276,1,2,5,0,22330,9169,1813,14671,1
232,4811,74,35,59,1,0,14,75,3,14,7,14,17,21,58,85,1,128,7,0,2,5,0,22330,9170,1813,14672,1
232,4811,245,125,200,5,7,34,250,7,30,17,34,37,51,166,265,3,1053,58,0,2,5,0,22340,9171,1813,14673,1
27,1535,652,304,544,16,6,88,668,6,89,51,101,95,152,591,998,3,3399,188,0,2,18,0,22340,9172,1813,14674,1
234,4833,1457,730,1242,11,6,188,1468,10,292,166,329,302,495,2424,4078,5,22973,1276,1,2,7,3,22340,9174,1813,14675,1
234,4833,74,35,59,1,0,14,75,3,14,7,14,17,21,58,85,1,128,7,0,2,7,3,22340,9175,1813,14676,1
234,4833,245,125,200,5,7,34,250,7,30,17,34,37,51,166,265,3,1053,58,0,2,7,3,22350,9176,1813,14677,1
38,2236,334,251,279,10,4,40,344,5,127,74,143,132,217,899,1528,2,4303,239,0,2,11,2,22350,9177,1813,14678,1
113,2244,1513,682,1277,25,13,200,1538,11,199,116,219,210,335,1557,2584,6,15641,868,0,2,1,3,22350,9179,1813,14679,0
113,2244,819,519,539,24,98,155,843,15,96,57,106,111,163,690,1107,8,9171,509,0,2,1,3,22360,9181,1813,14680,0
108,4168,1513,682,1277,25,13,200,1538,11,199,116,219,210,335,1557,2584,6,15641,868,0,2,3,2,22360,9183,1813,14681,0
233,4817,1457,730,1242,11,6,188,1468,10,292,166,329,302,495,2424,4078,5,22973,1276,1,2,4,7,22360,9185,1813,14682,0
233,4817,74,35,59,1,0,14,75,3,14,7,14,17,21,58,85,1,128,7,0,2,4,7,22360,9186,1813,14683,0
233,4817,245,125,200,5,7,34,250,7,30,17,34,37,51,166,265,3,1053,58,0,2,4,7,22370,9187,1813,14684,0
38,2236,334,251,279,10,4,40,344,5,127,74,143,132,217,899,1528,2,4303,239,0,2,6,4,22370,9188,1813,14685,0
233,4817,1457,730,1242,11,6,188,1468,10,292,166,329,302,495,2424,4078,5,22973,1276,1,2,9,3,22370,9190,1813,14686,0
233,4817,74,35,59,1,0,14,75,3,14,7,14,17,21,58,85,1,128,7,0,2,9,3,22370,9191,1813,14687,0
233,4817,245,125,200,5,7,34,250,7,30,17,34,37,51,166,265,3,1053,58,0,2,9,3,22380,9192,1813,14688,0
27,1535,652,304,544,16,6,88,668,6,89,51,101,95,152,591,998,3,3399,188,0,2,18,0,22380,9193,1813,14689,0
38,2236,334,251,279,10,4,40,344,5,127,74,143,132,217,899,1528,2,4303,239,0,2,13,2,22380,9194,1813,14690,0
2,26,6,4,4,0,0,2,6,1,4,2,4,5,6,8,13,0,6,0,0,0,6,0,22380,9194,1813,14692,1
77,1700,477,336,357,30,23,73,507,16,194,134,250,210,384,1538,2962,10,30538,1696,0,2,9,7,22390,9195,1813,14697,1
233,4771,1457,730,1242,11,6,188,1468,10,292,166,329,302,495,2424,4078,5,22973,1276,1,2,20,15,22390,9197,1813,14698,1
233,4771,74,35,59,1,0,14,75,3,14,7,14,17,21,58,85,1,128,7,0,2,20,15,22390,9198,1813,14699,1
233,4771,245,125,200,5,7,34,250,7,30,17,34,37,51,166,265,3,1053,58,0,2,20,15,22400,9199,1813,14700,1
26,866,1455,414,1257,16,76,112,1471,5,41,23,46,46,69,231,381,2,1069,59,0,2,8,7,22400,9200,1813,14701,1
26,866,669,365,481,22,61,110,691,15,103,63,122,118,185,747,1273,8,11311,628,0,2,8,7,22410,9200,1814,14702,1
43,1312,1523,757,1297,19,12,193,1542,12,193,117,230,205,347,1508,2664,7,19053,1058,0,2,3,2,22420,9202,1814,14703,1
43,1312,701,378,504,33,58,109,734,13,110,68,126,123,194,794,1346,7,10027,557,0,2,3,2,22420,9203,1815,14704,1
172,3904,77,34,69,0,0,8,77,3,24,16,29,27,45,114,213,1,387,21,0,2,3,2,22420,9203,1815,14705,1
172,3904,712,438,573,51,9,84,763,14,102,71,128,116,199,733,1364,8,11988,666,0,2,3,2,22430,9204,1815,14706,1
21,545,1293,570,1093,25,15,163,1318,10,195,123,241,205,364,1516,2795,6,17273,959,0,2,12,8,22440,9206,1815,14707,1
198,4430,722,423,573,19,0,135,741,12,172,101,199,184,300,1320,2257,6,15668,870,0,2,22,17,22440,9208,1815,14709,1
198,4430,1508,847,911,44,250,301,1552,14,148,88,169,162,257,1120,1886,7,15077,837,0,2,22,17,22440,9209,1816,14710,1
18,440,386,256,301,16,9,68,402,4,59,35,69,63,104,355,621,2,1453,80,0,2,11,15,22440,9209,1816,14711,1
18,440,264,131,164,11,41,46,275,6,38,22,40,44,62,214,338,3,1068,59,0,2,11,15,22450,9209,1817,14712,1
114,2480,1043,504,840,53,9,147,1096,9,180,112,198,189,310,1377,2344,4,11604,644,0,2,4,3,22450,9211,1817,14713,1
114,2480,383,288,292,26,6,62,409,11,65,38,67,76,105,429,656,5,3719,206,0,2,4,3,22450,9212,1817,14714,1
89,1565,1178,367,1042,6,15,115,1184,9,94,51,95,103,146,644,976,4,4439,246,0,2,7,4,22450,9212,1817,14715,1
89,1565,177,108,140,8,0,27,185,6,30,16,32,36,48,162,248,3,794,44,0,2,7,4,22450,9214,1817,14716,1
167,3416,1943,715,1694,26,18,214,1969,12,185,120,237,197,357,1436,2721,7,20915,1161,0,2,6,4,22450,9216,1817,14717,1
167,3416,1168,838,957,57,25,144,1225,19,348,224,416,367,640,3018,5452,11,61921,3440,1,2,6,4,22460,9218,1817,14718,1
12,371,442,244,305,14,16,103,456,11,68,45,75,79,120,452,756,6,4588,254,0,2,6,2,22460,9220,1817,14719,1
12,371,182,102,99,11,40,35,193,3,11,6,11,14,17,42,64,1,97,5,0,2,6,2,22460,9221,1817,14720,1
55,1039,1098,241,925,5,10,155,1103,7,46,25,49,53,74,273,423,3,1580,87,0,2,9,3,22470,9223,1817,14721,1
55,1039,282,202,222,14,2,44,296,8,42,24,43,50,67,250,378,4,1548,86,0,2,9,3,22470,9224,1817,14722,1
108,4168,1513,682,1277,25,13,200,1538,11,199,116,219,210,335,1557,2584,6,15641,868,0,2,0,2,22470,9226,1817,14723,0
231,4764,1457,730,1242,11,6,188,1468,10,292,166,329,302,495,2424,4078,5,22973,1276,1,2,1,10,22470,9228,1817,14724,1
231,4764,74,35,59,1,0,14,75,3,14,7,14,17,21,58,85,1,128,7,0,2,1,10,22470,9229,1817,14725,1
231,4764,245,125,200,5,7,34,250,7,30,17,34,37,51,166,265,3,1053,58,0,2,1,10,22480,9230,1817,14726,1
166,3413,1943,715,1694,26,18,214,1969,12,185,120,237,197,357,1436,2721,7,20915,1161,0,2,0,3,22480,9232,1817,14727,1
166,3413,1168,838,957,57,25,144,1225,19,348,224,416,367,640,3018,5452,11,61921,3440,1,2,0,3,22490,9234,1817,14728,1
128,5483,139,89,101,2,0,35,141,7,54,34,62,61,96,330,569,4,2287,127,0,2,28,28,22490,9234,1817,14729,1
128,5483,7,5,5,0,0,2,7,1,2,1,2,3,3,2,4,0,2,0,0,2,28,28,22490,9234,1817,14730,1
27,1535,652,304,544,16,6,88,668,6,89,51,101,95,152,591,998,3,3399,188,0,2,1,1,22490,9235,1817,14731,1
37,2191,334,251,279,10,4,40,344,5,127,74,143,132,217,899,1528,2,4303,239,0,2,0,15,22490,9236,1817,14732,1
61,2682,1943,715,1694,26,18,214,1969,12,185,120,237,197,357,1436,2721,7,20915,1161,0,2,9,9,22490,9238,1817,14733,1
108,4168,1513,682,1277,25,13,200,1538,11,199,116,219,210,335,1557,2584,6,15641,868,0,2,2,0,22490,9240,1817,14734,0
42,1271,1523,757,1297,19,12,193,1542,12,193,117,230,205,347,1508,2664,7,19053,1058,0,2,4,17,22510,9246,1818,14742,1
42,1271,701,378,504,33,58,109,734,13,110,68,126,123,194,794,1346,7,10027,557,0,2,4,17,22510,9247,1819,14743,1
52,1014,1098,241,925,5,10,155,1103,7,46,25,49,53,74,273,423,3,1580,87,0,2,10,17,22520,9249,1819,14744,1
52,1014,282,202,222,14,2,44,296,8,42,24,43,50,67,250,378,4,1548,86,0,2,10,17,22520,9250,1819,14745,1
14,452,42,7,35,4,0,5,46,1,2,1,2,3,3,2,4,0,2,0,0,2,1,1,22520,9250,1819,14746,1
14,452,11,6,10,0,0,1,11,2,4,2,4,6,6,10,15,1,15,0,0,2,1,1,22520,9250,1819,14747,1
77,1700,477,336,357,30,23,73,507,16,194,134,250,210,384,1538,2962,10,30538,1696,0,2,9,7,22540,9255,1820,14755,0
231,4718,1457,730,1242,11,6,188,1468,10,292,166,329,302,495,2424,4078,5,22973,1276,1,2,20,15,22540,9257,1820,14756,0
231,4718,74,35,59,1,0,14,75,3,14,7,14,17,21,58,85,1,128,7,0,2,20,15,22540,9258,1820,14757,0
231,4718,245,125,200,5,7,34,250,7,30,17,34,37,51,166,265,3,1053,58,0,2,20,15,22550,9259,1820,14758,0
26,866,1455,414,1257,16,76,112,1471,5,41,23,46,46,69,231,381,2,1069,59,0,2,8,7,22550,9260,1820,14759,0
26,866,669,365,481,22,61,110,691,15,103,63,122,118,185,747,1273,8,11311,628,0,2,8,7,22560,9260,1821,14760,0
42,1271,1523,757,1297,19,12,193,1542,12,193,117,230,205,347,1508,2664,7,19053,1058,0,2,4,16,22570,9262,1821,14761,0
42,1271,701,378,504,33,58,109,734,13,110,68,126,123,194,794,1346,7,10027,557,0,2,4,16,22570,9263,1822,14762,0
172,3904,77,34,69,0,0,8,77,3,24,16,29,27,45,114,213,1,387,21,0,2,3,2,22570,9263,1822,14763,0
172,3904,712,438,573,51,9,84,763,14,102,71,128,116,199,733,1364,8,11988,666,0,2,3,2,22580,9264,1822,14764,0
21,545,1293,570,1093,25,15,163,1318,10,195,123,241,205,364,1516,2795,6,17273,959,0,2,12,8,22590,9266,1822,14765,0
198,4430,722,423,573,19,0,135,741,12,172,101,199,184,300,1320,2257,6,15668,870,0,2,22,17,22590,9268,1822,14767,0
198,4430,1508,847,911,44,250,301,1552,14,148,88,169,162,257,1120,1886,7,15077,837,0,2,22,17,22590,9269,1823,14768,0
18,440,386,256,301,16,9,68,402,4,59,35,69,63,104,355,621,2,1453,80,0,2,11,15,22590,9269,1823,14769,0
18,440,264,131,164,11,41,46,275,6,38,22,40,44,62,214,338,3,1068,59,0,2,11,15,22600,9269,1824,14770,0
114,2480,1043,504,840,53,9,147,1096,9,180,112,198,189,310,1377,2344,4,11604,644,0,2,4,3,22600,9271,1824,14771,0
114,2480,383,288,292,26,6,62,409,11,65,38,67,76,105,429,656,5,3719,206,0,2,4,3,22600,9272,1824,14772,0
89,1565,1178,367,1042,6,15,115,1184,9,94,51,95,103,146,644,976,4,4439,246,0,2,7,4,22600,9272,1824,14773,0
89,1565,177,108,140,8,0,27,185,6,30,16,32,36,48,162,248,3,794,44,0,2,7,4,22600,9274,1824,14774,0
166,3399,1943,715,1694,26,18,214,1969,12,185,120,237,197,357,1436,2721,7,20915,1161,0,2,6,4,22600,9276,1824,14775,0
166,3399,1168,838,957,57,25,144,1225,19,348,224,416,367,640,3018,5452,11,61921,3440,1,2,6,4,22610,9278,1824,14776,0
12,371,442,244,305,14,16,103,456,11,68,45,75,79,120,452,756,6,4588,254,0,2,6,2,22610,9280,1824,14777,0
12,371,182,102,99,11,40,35,193,3,11,6,11,14,17,42,64,1,97,5,0,2,6,2,22610,9281,1824,14778,0
52,1014,1098,241,925,5,10,155,1103,7,46,25,49,53,74,273,423,3,1580,87,0,2,17,18,22620,9283,1824,14779,0
52,1014,282,202,222,14,2,44,296,8,42,24,43,50,67,250,378,4,1548,86,0,2,17,18,22620,9284,1824,14780,0
14,452,42,7,35,4,0,5,46,1,2,1,2,3,3,2,4,0,2,0,0,2,1,1,22620,9284,1824,14781,0
14,452,11,6,10,0,0,1,11,2,4,2,4,6,6,10,15,1,15,0,0,2,1,1,22620,9284,1824,14782,0
132,4072,1660,832,1314,41,38,274,1701,20,312,209,395,332,604,2671,5058,12,64042,3557,1,2,4,1,22620,9286,1825,14784,1
132,4072,1057,646,719,113,100,145,1170,18,215,134,248,233,382,1740,3004,10,31186,1732,1,2,4,1,22630,9287,1826,14785,1
118,3030,1660,832,1314,41,38,274,1701,20,312,209,395,332,604,2671,5058,12,64042,3557,1,2,22,0,22630,9289,1827,14787,1
133,4121,1660,832,1314,41,38,274,1701,20,312,209,395,332,604,2671,5058,12,64042,3557,1,2,10,5,22630,9291,1828,14789,0
133,4121,1057,646,719,113,100,145,1170,18,215,134,248,233,382,1740,3004,10,31186,1732,1,2,10,5,22640,9292,1829,14790,0
131,4107,1660,832,1314,41,38,274,1701,20,312,209,395,332,604,2671,5058,12,64042,3557,1,2,12,8,22640,9294,1830,14792,0
131,4107,1057,646,719,113,100,145,1170,18,215,134,248,233,382,1740,3004,10,31186,1732,1,2,12,8,22650,9295,1831,14793,0
118,3030,1660,832,1314,41,38,274,1701,20,312,209,395,332,604,2671,5058,12,64042,3557,1,2,22,0,22650,9297,1832,14795,0
113,2247,1513,682,1277,25,13,200,1538,11,199,116,219,210,335,1557,2584,6,15641,868,0,2,1,0,22660,9303,1833,14803,0
113,2247,819,519,539,24,98,155,843,15,96,57,106,111,163,690,1107,8,9171,509,0,2,1,0,22670,9305,1833,14804,0
14,452,42,7,35,4,0,5,46,1,2,1,2,3,3,2,4,0,2,0,0,2,1,1,22670,9305,1833,14805,0
14,452,11,6,10,0,0,1,11,2,4,2,4,6,6,10,15,1,15,0,0,2,1,1,22670,9305,1833,14806,0
109,4195,1513,682,1277,25,13,200,1538,11,199,116,219,210,335,1557,2584,6,15641,868,0,2,10,0,22670,9307,1833,14807,0
114,2252,1513,682,1277,25,13,200,1538,11,199,116,219,210,335,1557,2584,6,15641,868,0,2,2,1,22670,9309,1833,14808,1
114,2252,819,519,539,24,98,155,843,15,96,57,106,111,163,690,1107,8,9171,509,0,2,2,1,22680,9311,1833,14809,1
114,2261,1513,682,1277,25,13,200,1538,11,199,116,219,210,335,1557,2584,6,15641,868,0,2,6,2,22680,9313,1833,14810,1
114,2261,819,519,539,24,98,155,843,15,96,57,106,111,163,690,1107,8,9171,509,0,2,6,2,22690,9315,1833,14811,1
114,2261,1513,682,1277,25,13,200,1538,11,199,116,219,210,335,1557,2584,6,15641,868,0,2,3,3,22690,9317,1833,14812,1
114,2261,819,519,539,24,98,155,843,15,96,57,106,111,163,690,1107,8,9171,509,0,2,3,3,22700,9319,1833,14813,1
7,103,38,23,23,0,0,15,38,0,0,0,0,0,0,0,0,0,0,0,0,2,1,1,22710,9323,1834,14821,1
14,452,42,7,35,4,0,5,46,1,2,1,2,3,3,2,4,0,2,0,0,2,1,1,22710,9323,1834,14822,1
14,452,11,6,10,0,0,1,11,2,4,2,4,6,6,10,15,1,15,0,0,2,1,1,22710,9323,1834,14823,1
1,288,382,65,130,157,2,92,539,4,10,5,10,14,15,41,57,2,114,6,0,2,2,2,22710,9324,1835,14824,0
14,452,42,7,35,4,0,5,46,1,2,1,2,3,3,2,4,0,2,0,0,2,1,1,22720,9328,1836,14832,0
14,452,11,6,10,0,0,1,11,2,4,2,4,6,6,10,15,1,15,0,0,2,1,1,22720,9328,1836,14833,0
114,2255,1513,682,1277,25,13,200,1538,11,199,116,219,210,335,1557,2584,6,15641,868,0,2,2,6,22720,9330,1836,14834,0
114,2255,819,519,539,24,98,155,843,15,96,57,106,111,163,690,1107,8,9171,509,0,2,2,6,22730,9332,1836,14835,0
114,2264,1513,682,1277,25,13,200,1538,11,199,116,219,210,335,1557,2584,6,15641,868,0,2,2,0,22730,9334,1836,14836,0
114,2264,819,519,539,24,98,155,843,15,96,57,106,111,163,690,1107,8,9171,509,0,2,2,0,22740,9336,1836,14837,0
173,3920,77,34,69,0,0,8,77,3,24,16,29,27,45,114,213,1,387,21,0,2,2,0,22740,9336,1836,14838,0
173,3920,712,438,573,51,9,84,763,14,102,71,128,116,199,733,1364,8,11988,666,0,2,2,0,22750,9337,1836,14839,0
131,4107,1660,832,1314,41,38,274,1701,20,312,209,395,332,604,2671,5058,12,64042,3557,1,2,12,8,22760,9343,1838,14848,0
131,4107,1057,646,719,113,100,145,1170,18,215,134,248,233,382,1740,3004,10,31186,1732,1,2,12,8,22770,9344,1839,14849,0
77,1700,477,336,357,30,23,73,507,16,194,134,250,210,384,1538,2962,10,30538,1696,0,2,9,7,22780,9345,1839,14850,0
113,2247,1513,682,1277,25,13,200,1538,11,199,116,219,210,335,1557,2584,6,15641,868,0,2,1,0,22780,9347,1839,14851,0
113,2247,819,519,539,24,98,155,843,15,96,57,106,111,163,690,1107,8,9171,509,0,2,1,0,22790,9349,1839,14852,0
231,4718,1457,730,1242,11,6,188,1468,10,292,166,329,302,495,2424,4078,5,22973,1276,1,2,21,25,22790,9351,1839,14853,0
231,4718,74,35,59,1,0,14,75,3,14,7,14,17,21,58,85,1,128,7,0,2,21,25,22790,9352,1839,14854,0
231,4718,245,125,200,5,7,34,250,7,30,17,34,37,51,166,265,3,1053,58,0,2,21,25,22800,9353,1839,14855,0
26,866,1455,414,1257,16,76,112,1471,5,41,23,46,46,69,231,381,2,1069,59,0,2,8,7,22800,9354,1839,14856,0
26,866,669,365,481,22,61,110,691,15,103,63,122,118,185,747,1273,8,11311,628,0,2,8,7,22810,9354,1840,14857,0
42,1271,1523,757,1297,19,12,193,1542,12,193,117,230,205,347,1508,2664,7,19053,1058,0,2,4,16,22820,9356,1840,14858,0
42,1271,701,378,504,33,58,109,734,13,110,68,126,123,194,794,1346,7,10027,557,0,2,4,16,22820,9357,1841,14859,0
172,3904,77,34,69,0,0,8,77,3,24,16,29,27,45,114,213,1,387,21,0,2,3,2,22820,9357,1841,14860,0
172,3904,712,438,573,51,9,84,763,14,102,71,128,116,199,733,1364,8,11988,666,0,2,3,2,22830,9358,1841,14861,0
21,545,1293,570,1093,25,15,163,1318,10,195,123,241,205,364,1516,2795,6,17273,959,0,2,12,8,22840,9360,1841,14862,0
198,4430,722,423,573,19,0,135,741,12,172,101,199,184,300,1320,2257,6,15668,870,0,2,22,17,22840,9362,1841,14864,0
198,4430,1508,847,911,44,250,301,1552,14,148,88,169,162,257,1120,1886,7,15077,837,0,2,22,17,22840,9363,1842,14865,0
18,440,386,256,301,16,9,68,402,4,59,35,69,63,104,355,621,2,1453,80,0,2,11,15,22840,9363,1842,14866,0
18,440,264,131,164,11,41,46,275,6,38,22,40,44,62,214,338,3,1068,59,0,2,11,15,22850,9363,1843,14867,0
114,2480,1043,504,840,53,9,147,1096,9,180,112,198,189,310,1377,2344,4,11604,644,0,2,4,3,22850,9365,1843,14868,0
114,2480,383,288,292,26,6,62,409,11,65,38,67,76,105,429,656,5,3719,206,0,2,4,3,22850,9366,1843,14869,0
89,1565,1178,367,1042,6,15,115,1184,9,94,51,95,103,146,644,976,4,4439,246,0,2,7,4,22850,9366,1843,14870,0
89,1565,177,108,140,8,0,27,185,6,30,16,32,36,48,162,248,3,794,44,0,2,7,4,22850,9368,1843,14871,0
166,3399,1943,715,1694,26,18,214,1969,12,185,120,237,197,357,1436,2721,7,20915,1161,0,2,6,7,22850,9370,1843,14872,0
166,3399,1168,838,957,57,25,144,1225,19,348,224,416,367,640,3018,5452,11,61921,3440,1,2,6,7,22860,9372,1843,14873,0
12,371,442,244,305,14,16,103,456,11,68,45,75,79,120,452,756,6,4588,254,0,2,6,2,22860,9374,1843,14874,0
12,371,182,102,99,11,40,35,193,3,11,6,11,14,17,42,64,1,97,5,0,2,6,2,22860,9375,1843,14875,0
52,1014,1098,241,925,5,10,155,1103,7,46,25,49,53,74,273,423,3,1580,87,0,2,17,18,22870,9377,1843,14876,0
52,1014,282,202,222,14,2,44,296,8,42,24,43,50,67,250,378,4,1548,86,0,2,17,18,22870,9378,1843,14877,0
1,288,382,65,130,157,2,92,539,4,10,5,10,14,15,41,57,2,114,6,0,2,2,2,22870,9379,1844,14878,0
7,103,38,23,23,0,0,15,38,0,0,0,0,0,0,0,0,0,0,0,0,2,1,1,22870,9379,1844,14879,0
14,452,42,7,35,4,0,5,46,1,2,1,2,3,3,2,4,0,2,0,0,2,1,1,22870,9379,1844,14880,0
14,452,11,6,10,0,0,1,11,2,4,2,4,6,6,10,15,1,15,0,0,2,1,1,22870,9379,1844,14881,0
128,5483,139,89,101,2,0,35,141,7,54,34,62,61,96,330,569,4,2287,127,0,2,28,28,22870,9379,1844,14882,0
128,5483,7,5,5,0,0,2,7,1,2,1,2,3,3,2,4,0,2,0,0,2,28,28,22870,9379,1844,14883,0
118,3030,1660,832,1314,41,38,274,1701,20,312,209,395,332,604,2671,5058,12,64042,3557,1,2,22,0,22870,9381,1845,14885,0
109,4195,1513,682,1277,25,13,200,1538,11,199,116,219,210,335,1557,2584,6,15641,868,0,2,10,0,22870,9383,1845,14886,0
27,1535,652,304,544,16,6,88,668,6,89,51,101,95,152,591,998,3,3399,188,0,2,1,1,22870,9384,1845,14887,0
37,2191,334,251,279,10,4,40,344,5,127,74,143,132,217,899,1528,2,4303,239,0,2,0,15,22870,9385,1845,14888,0
61,2682,1943,715,1694,26,18,214,1969,12,185,120,237,197,357,1436,2721,7,20915,1161,0,2,9,9,22870,9387,1845,14889,0
14,452,42,7,35,4,0,5,46,1,2,1,2,3,3,2,4,0,2,0,0,2,1,1,22870,9387,1845,14890,1
14,452,11,6,10,0,0,1,11,2,4,2,4,6,6,10,15,1,15,0,0,2,1,1,22870,9387,1845,14891,1
50,2018,1043,504,840,53,9,147,1096,9,180,112,198,189,310,1377,2344,4,11604,644,0,2,10,1,22870,9389,1845,14892,1
133,4157,1660,832,1314,41,38,274,1701,20,312,209,395,332,604,2671,5058,12,64042,3557,1,2,9,1,22870,9391,1846,14894,1
133,4157,1057,646,719,113,100,145,1170,18,215,134,248,233,382,1740,3004,10,31186,1732,1,2,9,1,22880,9392,1847,14895,1
121,3087,1660,832,1314,41,38,274,1701,20,312,209,395,332,604,2671,5058,12,64042,3557,1,2,11,0,22880,9394,1848,14897,1
110,4226,1513,682,1277,25,13,200,1538,11,199,116,219,210,335,1557,2584,6,15641,868,0,2,10,0,22880,9396,1848,14898,1
133,4158,1660,832,1314,41,38,274,1701,20,312,209,395,332,604,2671,5058,12,64042,3557,1,2,7,0,22880,9398,1849,14900,0
133,4158,1057,646,719,113,100,145,1170,18,215,134,248,233,382,1740,3004,10,31186,1732,1,2,7,0,22890,9399,1850,14901,0
133,4158,1660,832,1314,41,38,274,1701,20,312,209,395,332,604,2671,5058,12,64042,3557,1,2,6,3,22890,9401,1851,14903,0
133,4158,1057,646,719,113,100,145,1170,18,215,134,248,233,382,1740,3004,10,31186,1732,1,2,6,3,22900,9402,1852,14904,0
136,4252,1660,832,1314,41,38,274,1701,20,312,209,395,332,604,2671,5058,12,64042,3557,1,2,118,6,22900,9404,1853,14906,1
136,4252,1057,646,719,113,100,145,1170,18,215,134,248,233,382,1740,3004,10,31186,1732,1,2,118,6,22910,9405,1854,14907,1
77,1717,477,336,357,30,23,73,507,16,194,134,250,210,384,1538,2962,10,30538,1696,0,2,5,4,22920,9406,1854,14908,1
60,1070,282,196,195,3,0,86,285,8,130,71,141,138,212,936,1507,4,6538,363,0,2,24,0,22920,9406,1855,14909,1
63,2320,1450,624,1228,12,26,181,1462,14,306,186,354,320,540,2580,4493,8,36391,2021,1,2,79,1,22920,9408,1856,14910,1
122,3201,1660,832,1314,41,38,274,1701,20,312,209,395,332,604,2671,5058,12,64042,3557,1,2,50,1,22920,9410,1857,14912,1
1,84,13,10,10,0,0,3,13,1,2,1,2,3,3,2,4,0,2,0,0,2,1,1,22920,9410,1857,14913,0
133,4158,1660,832,1314,41,38,274,1701,20,312,209,395,332,604,2671,5058,12,64042,3557,1,2,19,1,22920,9412,1858,14915,0
133,4158,1057,646,719,113,100,145,1170,18,215,134,248,233,382,1740,3004,10,31186,1732,1,2,19,1,22930,9413,1859,14916,0
121,3087,1660,832,1314,41,38,274,1701,20,312,209,395,332,604,2671,5058,12,64042,3557,1,2,11,0,22930,9415,1860,14918,0
50,2028,1043,504,840,53,9,147,1096,9,180,112,198,189,310,1377,2344,4,11604,644,0,2,1,0,22930,9417,1860,14919,0
133,4206,1660,832,1314,41,38,274,1701,20,312,209,395,332,604,2671,5058,12,64042,3557,1,2,22,17,22930,9419,1861,14921,1
133,4206,1057,646,719,113,100,145,1170,18,215,134,248,233,382,1740,3004,10,31186,1732,1,2,22,17,22940,9420,1862,14922,1
121,3095,1660,832,1314,41,38,274,1701,20,312,209,395,332,604,2671,5058,12,64042,3557,1,2,2,2,22940,9422,1863,14924,1
133,4194,1660,832,1314,41,38,274,1701,20,312,209,395,332,604,2671,5058,12,64042,3557,1,2,0,1,22940,9424,1864,14926,0
133,4194,1057,646,719,113,100,145,1170,18,215,134,248,233,382,1740,3004,10,31186,1732,1,2,0,1,22950,9425,1865,14927,0
14,452,42,7,35,4,0,5,46,1,2,1,2,3,3,2,4,0,2,0,0,2,1,1,22950,9425,1865,14928,0
14,452,11,6,10,0,0,1,11,2,4,2,4,6,6,10,15,1,15,0,0,2,1,1,22950,9425,1865,14929,0
50,2028,1043,504,840,53,9,147,1096,9,180,112,198,189,310,1377,2344,4,11604,644,0,2,11,1,22950,9427,1865,14930,0
2,26,6,4,4,0,0,2,6,1,4,2,4,5,6,8,13,0,6,0,0,0,6,0,22950,9427,1865,14931,0
7,292,72,33,56,0,4,12,72,1,1,1,1,2,2,0,2,0,1,0,0,2,1,1,22950,9427,1865,14933,1
38,707,127,75,83,2,11,30,129,4,14,7,14,18,21,61,87,2,175,9,0,2,3,5,22950,9427,1865,14934,1
38,707,652,304,544,16,6,88,668,6,89,51,101,95,152,591,998,3,3399,188,0,2,3,5,22950,9428,1865,14935,1
38,707,2,2,2,0,0,0,2,0,0,0,0,0,0,0,0,0,0,0,0,2,3,5,22950,9428,1865,14935,1
38,707,8,5,5,0,0,3,8,0,0,0,0,0,0,0,0,0,0,0,0,2,3,5,22950,9428,1865,14936,1
38,707,2,2,2,0,0,0,2,0,0,0,0,0,0,0,0,0,0,0,0,2,3,5,22950,9428,1865,14936,1
38,707,14,8,8,0,0,6,14,0,0,0,0,0,0,0,0,0,0,0,0,2,3,5,22950,9428,1865,14937,1
38,707,6,4,4,0,0,2,6,0,0,0,0,0,0,0,0,0,0,0,0,2,3,5,22950,9428,1865,14938,1
38,707,6,4,4,0,0,2,6,1,2,1,2,3,3,2,4,0,2,0,0,2,3,5,22950,9428,1865,14939,1
38,707,6,4,4,0,0,2,6,0,0,0,0,0,0,0,0,0,0,0,0,2,3,5,22950,9428,1865,14940,1
38,707,7,5,5,0,0,2,7,0,0,0,0,0,0,0,0,0,0,0,0,2,3,5,22950,9428,1865,14941,1
38,707,6,4,4,0,0,2,6,0,0,0,0,0,0,0,0,0,0,0,0,2,3,5,22950,9428,1865,14942,1
38,707,10,6,6,0,0,4,10,0,0,0,0,0,0,0,0,0,0,0,0,2,3,5,22950,9428,1865,14943,1
38,707,1,1,1,0,0,0,1,0,0,0,0,0,0,0,0,0,0,0,0,2,3,5,22950,9428,1865,14943,1
38,707,14,10,10,0,0,4,14,1,1,1,1,2,2,0,2,0,1,0,0,2,3,5,22950,9428,1865,14944,1
38,707,46,26,30,3,0,12,49,3,6,3,6,9,9,20,28,1,42,2,0,2,3,5,22960,9428,1865,14945,1
1,288,382,65,130,157,2,92,539,4,10,5,10,14,15,41,57,2,114,6,0,2,1,1,22970,9433,1867,14953,1
14,452,42,7,35,4,0,5,46,1,2,1,2,3,3,2,4,0,2,0,0,2,2,2,22970,9433,1867,14954,1
14,452,11,6,10,0,0,1,11,2,4,2,4,6,6,10,15,1,15,0,0,2,2,2,22970,9433,1867,14955,1
14,452,42,7,35,4,0,5,46,1,2,1,2,3,3,2,4,0,2,0,0,2,1,1,22980,9437,1868,14963,1
14,452,11,6,10,0,0,1,11,2,4,2,4,6,6,10,15,1,15,0,0,2,1,1,22980,9437,1868,14964,1
113,2252,1513,682,1277,25,13,200,1538,11,199,116,219,210,335,1557,2584,6,15641,868,0,2,1,4,22980,9439,1868,14965,0
113,2252,819,519,539,24,98,155,843,15,96,57,106,111,163,690,1107,8,9171,509,0,2,1,4,22990,9441,1868,14966,0
172,3915,77,34,69,0,0,8,77,3,24,16,29,27,45,114,213,1,387,21,0,2,3,4,22990,9441,1868,14967,0
172,3915,712,438,573,51,9,84,763,14,102,71,128,116,199,733,1364,8,11988,666,0,2,3,4,23000,9442,1868,14968,0
110,4226,1513,682,1277,25,13,200,1538,11,199,116,219,210,335,1557,2584,6,15641,868,0,2,6,6,23000,9444,1868,14969,0
113,2252,1513,682,1277,25,13,200,1538,11,199,116,219,210,335,1557,2584,6,15641,868,0,2,1,1,23000,9446,1868,14970,0
113,2252,819,519,539,24,98,155,843,15,96,57,106,111,163,690,1107,8,9171,509,0,2,1,1,23010,9448,1868,14971,0
172,3915,77,34,69,0,0,8,77,3,24,16,29,27,45,114,213,1,387,21,0,2,3,2,23010,9448,1868,14972,0
172,3915,712,438,573,51,9,84,763,14,102,71,128,116,199,733,1364,8,11988,666,0,2,3,2,23020,9449,1868,14973,0
110,4226,1513,682,1277,25,13,200,1538,11,199,116,219,210,335,1557,2584,6,15641,868,0,2,10,0,23020,9451,1868,14974,0
38,705,127,75,83,2,11,30,129,4,14,7,14,18,21,61,87,2,175,9,0,2,1,1,23020,9451,1868,14975,0
38,705,652,304,544,16,6,88,668,6,89,51,101,95,152,591,998,3,3399,188,0,2,1,1,23020,9452,1868,14976,0
38,705,2,2,2,0,0,0,2,0,0,0,0,0,0,0,0,0,0,0,0,2,1,1,23020,9452,1868,14976,0
38,705,8,5,5,0,0,3,8,0,0,0,0,0,0,0,0,0,0,0,0,2,1,1,23020,9452,1868,14977,0
38,705,2,2,2,0,0,0,2,0,0,0,0,0,0,0,0,0,0,0,0,2,1,1,23020,9452,1868,14977,0
38,705,14,8,8,0,0,6,14,0,0,0,0,0,0,0,0,0,0,0,0,2,1,1,23020,9452,1868,14978,0
38,705,6,4,4,0,0,2,6,0,0,0,0,0,0,0,0,0,0,0,0,2,1,1,23020,9452,1868,14979,0
38,705,6,4,4,0,0,2,6,1,2,1,2,3,3,2,4,0,2,0,0,2,1,1,23020,9452,1868,14980,0
38,705,6,4,4,0,0,2,6,0,0,0,0,0,0,0,0,0,0,0,0,2,1,1,23020,9452,1868,14981,0
38,705,7,5,5,0,0,2,7,0,0,0,0,0,0,0,0,0,0,0,0,2,1,1,23020,9452,1868,14982,0
38,705,6,4,4,0,0,2,6,0,0,0,0,0,0,0,0,0,0,0,0,2,1,1,23020,9452,1868,14983,0
38,705,10,6,6,0,0,4,10,0,0,0,0,0,0,0,0,0,0,0,0,2,1,1,23020,9452,1868,14984,0
38,705,1,1,1,0,0,0,1,0,0,0,0,0,0,0,0,0,0,0,0,2,1,1,23020,9452,1868,14984,0
38,705,14,10,10,0,0,4,14,1,1,1,1,2,2,0,2,0,1,0,0,2,1,1,23020,9452,1868,14985,0
38,705,46,26,30,3,0,12,49,3,6,3,6,9,9,20,28,1,42,2,0,2,1,1,23030,9452,1868,14986,0
14,452,42,7,35,4,0,5,46,1,2,1,2,3,3,2,4,0,2,0,0,2,1,1,23030,9452,1868,14987,1
14,452,11,6,10,0,0,1,11,2,4,2,4,6,6,10,15,1,15,0,0,2,1,1,23030,9452,1868,14988,1
455,10020,72,33,56,0,4,12,72,1,1,1,1,2,2,0,2,0,1,0,0,2,6,1,23040,9456,1869,14996,1
455,10020,1454,835,1044,76,110,219,1530,17,275,158,296,292,454,2297,3718,9,34017,1889,1,2,6,1,23050,9457,1869,14997,1
14,452,42,7,35,4,0,5,46,1,2,1,2,3,3,2,4,0,2,0,0,2,1,1,23050,9457,1869,14998,1
14,452,11,6,10,0,0,1,11,2,4,2,4,6,6,10,15,1,15,0,0,2,1,1,23050,9457,1869,14999,1
129,5619,139,89,101,2,0,35,141,7,54,34,62,61,96,330,569,4,2287,127,0,2,34,0,23050,9457,1869,15000,1
129,5619,7,5,5,0,0,2,7,1,2,1,2,3,3,2,4,0,2,0,0,2,34,0,23050,9457,1869,15001,1
455,10020,72,33,56,0,4,12,72,1,1,1,1,2,2,0,2,0,1,0,0,2,6,1,23060,9461,1870,15009,0
455,10020,1454,835,1044,76,110,219,1530,17,275,158,296,292,454,2297,3718,9,34017,1889,1,2,6,1,23070,9462,1870,15010,0
14,452,42,7,35,4,0,5,46,1,2,1,2,3,3,2,4,0,2,0,0,2,1,1,23070,9462,1870,15011,0
14,452,11,6,10,0,0,1,11,2,4,2,4,6,6,10,15,1,15,0,0,2,1,1,23070,9462,1870,15012,0
129,5619,139,89,101,2,0,35,141,7,54,34,62,61,96,330,569,4,2287,127,0,2,34,0,23070,9462,1870,15013,0
129,5619,7,5,5,0,0,2,7,1,2,1,2,3,3,2,4,0,2,0,0,2,34,0,23070,9462,1870,15014,0
42,1271,1523,757,1297,19,12,193,1542,12,193,117,230,205,347,1508,2664,7,19053,1058,0,2,4,4,23080,9464,1870,15015,1
42,1271,701,378,504,33,58,109,734,13,110,68,126,123,194,794,1346,7,10027,557,0,2,4,4,23080,9465,1871,15016,1
39,2430,1523,757,1297,19,12,193,1542,12,193,117,230,205,347,1508,2664,7,19053,1058,0,2,2,2,23090,9467,1871,15017,1
46,451,647,139,84,35,284,233,682,0,0,0,0,0,0,0,0,0,0,0,0,2,2,0,23090,9467,1871,15018,1
21,554,1293,570,1093,25,15,163,1318,10,195,123,241,205,364,1516,2795,6,17273,959,0,2,1,0,23100,9469,1871,15019,1
31,1175,1293,570,1093,25,15,163,1318,10,195,123,241,205,364,1516,2795,6,17273,959,0,2,18,0,23110,9471,1871,15020,1
113,2255,1513,682,1277,25,13,200,1538,11,199,116,219,210,335,1557,2584,6,15641,868,0,2,3,0,23110,9473,1871,15021,0
113,2255,819,519,539,24,98,155,843,15,96,57,106,111,163,690,1107,8,9171,509,0,2,3,0,23120,9475,1871,15022,0
111,4253,1513,682,1277,25,13,200,1538,11,199,116,219,210,335,1557,2584,6,15641,868,0,2,12,0,23120,9477,1871,15023,0
113,2255,1513,682,1277,25,13,200,1538,11,199,116,219,210,335,1557,2584,6,15641,868,0,2,3,0,23120,9479,1871,15024,0
113,2255,819,519,539,24,98,155,843,15,96,57,106,111,163,690,1107,8,9171,509,0,2,3,0,23130,9481,1871,15025,0
111,4253,1513,682,1277,25,13,200,1538,11,199,116,219,210,335,1557,2584,6,15641,868,0,2,12,0,23130,9483,1871,15026,0
111,4259,1513,682,1277,25,13,200,1538,11,199,116,219,210,335,1557,2584,6,15641,868,0,2,2,0,23130,9485,1871,15027,0
111,4259,1513,682,1277,25,13,200,1538,11,199,116,219,210,335,1557,2584,6,15641,868,0,2,2,0,23130,9487,1871,15028,0
138,4339,1660,832,1314,41,38,274,1701,20,312,209,395,332,604,2671,5058,12,64042,3557,1,2,118,6,23130,9489,1872,15030,0
138,4339,1057,646,719,113,100,145,1170,18,215,134,248,233,382,1740,3004,10,31186,1732,1,2,118,6,23140,9490,1873,15031,0
77,1717,477,336,357,30,23,73,507,16,194,134,250,210,384,1538,2962,10,30538,1696,0,2,5,4,23150,9491,1873,15032,0
60,1070,282,196,195,3,0,86,285,8,130,71,141,138,212,936,1507,4,6538,363,0,2,24,0,23150,9491,1874,15033,0
1,84,13,10,10,0,0,3,13,1,2,1,2,3,3,2,4,0,2,0,0,2,1,1,23150,9491,1874,15034,0
63,2320,1450,624,1228,12,26,181,1462,14,306,186,354,320,540,2580,4493,8,36391,2021,1,2,79,1,23150,9493,1875,15035,0
125,3266,1660,832,1314,41,38,274,1701,20,312,209,395,332,604,2671,5058,12,64042,3557,1,2,50,1,23150,9495,1876,15037,0
42,1271,1523,757,1297,19,12,193,1542,12,193,117,230,205,347,1508,2664,7,19053,1058,0,2,4,4,23160,9497,1876,15038,0
42,1271,701,378,504,33,58,109,734,13,110,68,126,123,194,794,1346,7,10027,557,0,2,4,4,23160,9498,1877,15039,0
39,2430,1523,757,1297,19,12,193,1542,12,193,117,230,205,347,1508,2664,7,19053,1058,0,2,2,2,23170,9500,1877,15040,0
46,451,647,139,84,35,284,233,682,0,0,0,0,0,0,0,0,0,0,0,0,2,2,0,23170,9500,1877,15041,0
21,554,1293,570,1093,25,15,163,1318,10,195,123,241,205,364,1516,2795,6,17273,959,0,2,1,0,23180,9502,1877,15042,0
31,1175,1293,570,1093,25,15,163,1318,10,195,123,241,205,364,1516,2795,6,17273,959,0,2,18,0,23190,9504,1877,15043,0
87,1541,1178,367,1042,6,15,115,1184,9,94,51,95,103,146,644,976,4,4439,246,0,2,1,4,23190,9504,1877,15044,0
87,1541,177,108,140,8,0,27,185,6,30,16,32,36,48,162,248,3,794,44,0,2,1,4,23190,9506,1877,15045,0
47,2040,1178,367,1042,6,15,115,1184,9,94,51,95,103,146,644,976,4,4439,246,0,2,20,0,23190,9506,1877,15046,0
14,452,42,7,35,4,0,5,46,1,2,1,2,3,3,2,4,0,2,0,0,2,2,2,23200,9510,1878,15054,1
14,452,11,6,10,0,0,1,11,2,4,2,4,6,6,10,15,1,15,0,0,2,2,2,23200,9510,1878,15055,1
1,288,382,65,130,157,2,92,539,4,10,5,10,14,15,41,57,2,114,6,0,2,1,1,23200,9511,1879,15056,0
14,452,42,7,35,4,0,5,46,1,2,1,2,3,3,2,4,0,2,0,0,2,1,1,23210,9515,1880,15064,0
14,452,11,6,10,0,0,1,11,2,4,2,4,6,6,10,15,1,15,0,0,2,1,1,23210,9515,1880,15065,0
85,1860,477,336,357,30,23,73,507,16,194,134,250,210,384,1538,2962,10,30538,1696,0,2,33,6,23220,9516,1880,15066,0
64,2475,1450,624,1228,12,26,181,1462,14,306,186,354,320,540,2580,4493,8,36391,2021,1,2,45,0,23220,9518,1881,15067,0
85,1860,477,336,357,30,23,73,507,16,194,134,250,210,384,1538,2962,10,30538,1696,0,2,33,6,23230,9519,1881,15068,1
64,2475,1450,624,1228,12,26,181,1462,14,306,186,354,320,540,2580,4493,8,36391,2021,1,2,45,0,23230,9521,1882,15069,1
85,1860,477,336,357,30,23,73,507,16,194,134,250,210,384,1538,2962,10,30538,1696,0,2,33,6,23240,9522,1882,15070,0
64,2475,1450,624,1228,12,26,181,1462,14,306,186,354,320,540,2580,4493,8,36391,2021,1,2,45,0,23240,9524,1883,15071,0
85,1860,477,336,357,30,23,73,507,16,194,134,250,210,384,1538,2962,10,30538,1696,0,2,33,6,23250,9525,1883,15072,0
64,2475,1450,624,1228,12,26,181,1462,14,306,186,354,320,540,2580,4493,8,36391,2021,1,2,45,0,23250,9527,1884,15073,0
229,4691,1457,730,1242,11,6,188,1468,10,292,166,329,302,495,2424,4078,5,22973,1276,1,2,2,5,23430,9567,1894,15272,0
229,4691,74,35,59,1,0,14,75,3,14,7,14,17,21,58,85,1,128,7,0,2,2,5,23430,9568,1894,15273,0
229,4691,245,125,200,5,7,34,250,7,30,17,34,37,51,166,265,3,1053,58,0,2,2,5,23440,9569,1894,15274,0
176,4053,77,34,69,0,0,8,77,3,24,16,29,27,45,114,213,1,387,21,0,2,34,9,23440,9569,1894,15275,0
176,4053,712,438,573,51,9,84,763,14,102,71,128,116,199,733,1364,8,11988,666,0,2,34,9,23450,9570,1894,15276,0
456,10021,72,33,56,0,4,12,72,1,1,1,1,2,2,0,2,0,1,0,0,2,8,6,23450,9570,1894,15277,0
456,10021,1454,835,1044,76,110,219,1530,17,275,158,296,292,454,2297,3718,9,34017,1889,1,2,8,6,23460,9571,1894,15278,0
229,4691,1457,730,1242,11,6,188,1468,10,292,166,329,302,495,2424,4078,5,22973,1276,1,2,2,5,23460,9573,1894,15279,1
229,4691,74,35,59,1,0,14,75,3,14,7,14,17,21,58,85,1,128,7,0,2,2,5,23460,9574,1894,15280,1
229,4691,245,125,200,5,7,34,250,7,30,17,34,37,51,166,265,3,1053,58,0,2,2,5,23470,9575,1894,15281,1
176,4053,77,34,69,0,0,8,77,3,24,16,29,27,45,114,213,1,387,21,0,2,34,9,23470,9575,1894,15282,1
176,4053,712,438,573,51,9,84,763,14,102,71,128,116,199,733,1364,8,11988,666,0,2,34,9,23480,9576,1894,15283,1
456,10021,72,33,56,0,4,12,72,1,1,1,1,2,2,0,2,0,1,0,0,2,8,6,23480,9576,1894,15284,1
456,10021,1454,835,1044,76,110,219,1530,17,275,158,296,292,454,2297,3718,9,34017,1889,1,2,8,6,23490,9577,1894,15285,1
24,753,74,35,59,1,0,14,75,3,14,7,14,17,21,58,85,1,128,7,0,2,0,67,23490,9578,1894,15286,0
24,753,245,125,200,5,7,34,250,7,30,17,34,37,51,166,265,3,1053,58,0,2,0,67,23500,9579,1894,15287,0
172,3928,77,34,69,0,0,8,77,3,24,16,29,27,45,114,213,1,387,21,0,2,0,22,23500,9579,1894,15288,0
172,3928,712,438,573,51,9,84,763,14,102,71,128,116,199,733,1364,8,11988,666,0,2,0,22,23510,9580,1894,15289,0
196,4405,722,423,573,19,0,135,741,12,172,101,199,184,300,1320,2257,6,15668,870,0,2,1,4,23510,9582,1894,15291,0
196,4405,1508,847,911,44,250,301,1552,14,148,88,169,162,257,1120,1886,7,15077,837,0,2,1,4,23510,9583,1895,15292,0
11,343,74,35,59,1,0,14,75,3,14,7,14,17,21,58,85,1,128,7,0,2,1,1,23510,9584,1895,15293,0
16,595,722,423,573,19,0,135,741,12,172,101,199,184,300,1320,2257,6,15668,870,0,2,27,16,23510,9586,1895,15295,0
24,753,74,35,59,1,0,14,75,3,14,7,14,17,21,58,85,1,128,7,0,2,0,67,23510,9587,1895,15296,1
24,753,245,125,200,5,7,34,250,7,30,17,34,37,51,166,265,3,1053,58,0,2,0,67,23520,9588,1895,15297,1
172,3928,77,34,69,0,0,8,77,3,24,16,29,27,45,114,213,1,387,21,0,2,0,22,23520,9588,1895,15298,1
172,3928,712,438,573,51,9,84,763,14,102,71,128,116,199,733,1364,8,11988,666,0,2,0,22,23530,9589,1895,15299,1
196,4405,722,423,573,19,0,135,741,12,172,101,199,184,300,1320,2257,6,15668,870,0,2,1,4,23530,9591,1895,15301,1
196,4405,1508,847,911,44,250,301,1552,14,148,88,169,162,257,1120,1886,7,15077,837,0,2,1,4,23530,9592,1896,15302,1
11,343,74,35,59,1,0,14,75,3,14,7,14,17,21,58,85,1,128,7,0,2,1,1,23530,9593,1896,15303,1
16,595,722,423,573,19,0,135,741,12,172,101,199,184,300,1320,2257,6,15668,870,0,2,27,16,23530,9595,1896,15305,1
46,449,647,139,84,35,284,233,682,0,0,0,0,0,0,0,0,0,0,0,0,2,1,1,23530,9595,1896,15306,0
46,449,647,139,84,35,284,233,682,0,0,0,0,0,0,0,0,0,0,0,0,2,1,1,23530,9595,1896,15307,0
229,4687,1457,730,1242,11,6,188,1468,10,292,166,329,302,495,2424,4078,5,22973,1276,1,2,1,1,23530,9597,1896,15308,0
229,4687,74,35,59,1,0,14,75,3,14,7,14,17,21,58,85,1,128,7,0,2,1,1,23530,9598,1896,15309,0
229,4687,245,125,200,5,7,34,250,7,30,17,34,37,51,166,265,3,1053,58,0,2,1,1,23540,9599,1896,15310,0
24,743,74,35,59,1,0,14,75,3,14,7,14,17,21,58,85,1,128,7,0,2,2,3,23540,9600,1896,15311,0
24,743,245,125,200,5,7,34,250,7,30,17,34,37,51,166,265,3,1053,58,0,2,2,3,23550,9601,1896,15312,0
8,257,74,35,59,1,0,14,75,3,14,7,14,17,21,58,85,1,128,7,0,2,1,14,23550,9602,1896,15313,0
229,4687,1457,730,1242,11,6,188,1468,10,292,166,329,302,495,2424,4078,5,22973,1276,1,2,1,1,23550,9604,1896,15314,1
229,4687,74,35,59,1,0,14,75,3,14,7,14,17,21,58,85,1,128,7,0,2,1,1,23550,9605,1896,15315,1
229,4687,245,125,200,5,7,34,250,7,30,17,34,37,51,166,265,3,1053,58,0,2,1,1,23560,9606,1896,15316,1
24,743,74,35,59,1,0,14,75,3,14,7,14,17,21,58,85,1,128,7,0,2,2,3,23560,9607,1896,15317,1
24,743,245,125,200,5,7,34,250,7,30,17,34,37,51,166,265,3,1053,58,0,2,2,3,23570,9608,1896,15318,1
8,257,74,35,59,1,0,14,75,3,14,7,14,17,21,58,85,1,128,7,0,2,1,14,23570,9609,1896,15319,1
172,3915,77,34,69,0,0,8,77,3,24,16,29,27,45,114,213,1,387,21,0,2,1,1,23570,9609,1896,15320,0
172,3915,712,438,573,51,9,84,763,14,102,71,128,116,199,733,1364,8,11988,666,0,2,1,1,23580,9610,1896,15321,0
172,3915,77,34,69,0,0,8,77,3,24,16,29,27,45,114,213,1,387,21,0,2,1,1,23580,9610,1896,15322,0
172,3915,712,438,573,51,9,84,763,14,102,71,128,116,199,733,1364,8,11988,666,0,2,1,1,23590,9611,1896,15323,0
455,10020,72,33,56,0,4,12,72,1,1,1,1,2,2,0,2,0,1,0,0,2,3,3,23590,9611,1896,15324,0
455,10020,1454,835,1044,76,110,219,1530,17,275,158,296,292,454,2297,3718,9,34017,1889,1,2,3,3,23600,9612,1896,15325,0
455,10020,72,33,56,0,4,12,72,1,1,1,1,2,2,0,2,0,1,0,0,2,3,3,23600,9612,1896,15326,1
455,10020,1454,835,1044,76,110,219,1530,17,275,158,296,292,454,2297,3718,9,34017,1889,1,2,3,3,23610,9613,1896,15327,1
172,3915,77,34,69,0,0,8,77,3,24,16,29,27,45,114,213,1,387,21,0,2,1,1,23610,9613,1896,15328,0
172,3915,712,438,573,51,9,84,763,14,102,71,128,116,199,733,1364,8,11988,666,0,2,1,1,23620,9614,1896,15329,0
455,10020,72,33,56,0,4,12,72,1,1,1,1,2,2,0,2,0,1,0,0,2,3,3,23620,9614,1896,15330,0
455,10020,1454,835,1044,76,110,219,1530,17,275,158,296,292,454,2297,3718,9,34017,1889,1,2,3,3,23630,9615,1896,15331,0
172,3915,77,34,69,0,0,8,77,3,24,16,29,27,45,114,213,1,387,21,0,2,1,1,23630,9615,1896,15332,0
172,3915,712,438,573,51,9,84,763,14,102,71,128,116,199,733,1364,8,11988,666,0,2,1,1,23640,9616,1896,15333,0
455,10020,72,33,56,0,4,12,72,1,1,1,1,2,2,0,2,0,1,0,0,2,3,3,23640,9616,1896,15334,0
455,10020,1454,835,1044,76,110,219,1530,17,275,158,296,292,454,2297,3718,9,34017,1889,1,2,3,3,23650,9617,1896,15335,0
186,4159,722,423,573,19,0,135,741,12,172,101,199,184,300,1320,2257,6,15668,870,0,2,12,55,23650,9619,1896,15337,0
186,4159,1508,847,911,44,250,301,1552,14,148,88,169,162,257,1120,1886,7,15077,837,0,2,12,55,23650,9620,1897,15338,0
16,595,722,423,573,19,0,135,741,12,172,101,199,184,300,1320,2257,6,15668,870,0,2,3,3,23650,9622,1897,15340,0
186,4159,722,423,573,19,0,135,741,12,172,101,199,184,300,1320,2257,6,15668,870,0,2,12,55,23650,9624,1897,15342,0
186,4159,1508,847,911,44,250,301,1552,14,148,88,169,162,257,1120,1886,7,15077,837,0,2,12,55,23650,9625,1898,15343,0
16,595,722,423,573,19,0,135,741,12,172,101,199,184,300,1320,2257,6,15668,870,0,2,3,3,23650,9627,1898,15345,0
68,1223,1020,354,843,12,15,144,1032,8,134,77,144,142,221,970,1580,4,6792,377,0,2,5,1,23650,9627,1898,15346,0
55,2363,1020,354,843,12,15,144,1032,8,134,77,144,142,221,970,1580,4,6792,377,0,2,4,3,23650,9627,1898,15347,0
68,1223,1020,354,843,12,15,144,1032,8,134,77,144,142,221,970,1580,4,6792,377,0,2,5,1,23650,9627,1898,15348,1
55,2363,1020,354,843,12,15,144,1032,8,134,77,144,142,221,970,1580,4,6792,377,0,2,4,3,23650,9627,1898,15349,1
173,3969,722,423,573,19,0,135,741,12,172,101,199,184,300,1320,2257,6,15668,870,0,2,82,118,23650,9629,1898,15351,1
173,3969,1508,847,911,44,250,301,1552,14,148,88,169,162,257,1120,1886,7,15077,837,0,2,82,118,23650,9630,1899,15352,1
45,2770,1296,573,1062,40,33,157,1336,8,201,118,231,209,349,1561,2689,4,12365,686,0,2,8,8,23650,9630,1899,15354,1
15,573,722,423,573,19,0,135,741,12,172,101,199,184,300,1320,2257,6,15668,870,0,2,2,23,23650,9632,1899,15356,1
173,3969,722,423,573,19,0,135,741,12,172,101,199,184,300,1320,2257,6,15668,870,0,2,82,118,23650,9634,1899,15358,1
173,3969,1508,847,911,44,250,301,1552,14,148,88,169,162,257,1120,1886,7,15077,837,0,2,82,118,23650,9635,1900,15359,1
45,2770,1296,573,1062,40,33,157,1336,8,201,118,231,209,349,1561,2689,4,12365,686,0,2,8,8,23650,9635,1900,15361,1
15,573,722,423,573,19,0,135,741,12,172,101,199,184,300,1320,2257,6,15668,870,0,2,2,23,23650,9637,1900,15363,1
68,1223,1020,354,843,12,15,144,1032,8,134,77,144,142,221,970,1580,4,6792,377,0,2,5,1,23650,9637,1900,15364,0
55,2363,1020,354,843,12,15,144,1032,8,134,77,144,142,221,970,1580,4,6792,377,0,2,4,3,23650,9637,1900,15365,0
68,1223,1020,354,843,12,15,144,1032,8,134,77,144,142,221,970,1580,4,6792,377,0,2,5,1,23650,9637,1900,15366,0
55,2363,1020,354,843,12,15,144,1032,8,134,77,144,142,221,970,1580,4,6792,377,0,2,4,3,23650,9637,1900,15367,0
455,9950,72,33,56,0,4,12,72,1,1,1,1,2,2,0,2,0,1,0,0,2,16,26,23650,9637,1900,15368,0
455,9950,1454,835,1044,76,110,219,1530,17,275,158,296,292,454,2297,3718,9,34017,1889,1,2,16,26,23660,9638,1900,15369,0
455,9950,72,33,56,0,4,12,72,1,1,1,1,2,2,0,2,0,1,0,0,2,16,26,23660,9638,1900,15370,1
455,9950,1454,835,1044,76,110,219,1530,17,275,158,296,292,454,2297,3718,9,34017,1889,1,2,16,26,23670,9639,1900,15371,1
172,3928,77,34,69,0,0,8,77,3,24,16,29,27,45,114,213,1,387,21,0,2,1,1,23670,9639,1900,15372,0
172,3928,712,438,573,51,9,84,763,14,102,71,128,116,199,733,1364,8,11988,666,0,2,1,1,23680,9640,1900,15373,0
68,1223,1020,354,843,12,15,144,1032,8,134,77,144,142,221,970,1580,4,6792,377,0,2,5,1,23680,9640,1900,15374,0
455,9950,72,33,56,0,4,12,72,1,1,1,1,2,2,0,2,0,1,0,0,2,3,3,23680,9640,1900,15375,0
455,9950,1454,835,1044,76,110,219,1530,17,275,158,296,292,454,2297,3718,9,34017,1889,1,2,3,3,23690,9641,1900,15376,0
55,2363,1020,354,843,12,15,144,1032,8,134,77,144,142,221,970,1580,4,6792,377,0,2,4,3,23690,9641,1900,15377,0
172,3928,77,34,69,0,0,8,77,3,24,16,29,27,45,114,213,1,387,21,0,2,1,1,23690,9641,1900,15378,0
172,3928,712,438,573,51,9,84,763,14,102,71,128,116,199,733,1364,8,11988,666,0,2,1,1,23700,9642,1900,15379,0
68,1223,1020,354,843,12,15,144,1032,8,134,77,144,142,221,970,1580,4,6792,377,0,2,5,1,23700,9642,1900,15380,0
455,9950,72,33,56,0,4,12,72,1,1,1,1,2,2,0,2,0,1,0,0,2,3,3,23700,9642,1900,15381,0
455,9950,1454,835,1044,76,110,219,1530,17,275,158,296,292,454,2297,3718,9,34017,1889,1,2,3,3,23710,9643,1900,15382,0
55,2363,1020,354,843,12,15,144,1032,8,134,77,144,142,221,970,1580,4,6792,377,0,2,4,3,23710,9643,1900,15383,0
138,4352,1660,832,1314,41,38,274,1701,20,312,209,395,332,604,2671,5058,12,64042,3557,1,2,1,1,23710,9645,1901,15385,1
138,4352,1057,646,719,113,100,145,1170,18,215,134,248,233,382,1740,3004,10,31186,1732,1,2,1,1,23720,9646,1902,15386,1
126,3306,1660,832,1314,41,38,274,1701,20,312,209,395,332,604,2671,5058,12,64042,3557,1,2,12,0,23720,9648,1903,15388,1
138,4352,1660,832,1314,41,38,274,1701,20,312,209,395,332,604,2671,5058,12,64042,3557,1,2,1,1,23720,9650,1904,15390,0
138,4352,1057,646,719,113,100,145,1170,18,215,134,248,233,382,1740,3004,10,31186,1732,1,2,1,1,23730,9651,1905,15391,0
126,3306,1660,832,1314,41,38,274,1701,20,312,209,395,332,604,2671,5058,12,64042,3557,1,2,12,0,23730,9653,1906,15393,0
172,3915,77,34,69,0,0,8,77,3,24,16,29,27,45,114,213,1,387,21,0,2,1,1,23730,9653,1906,15394,0
172,3915,712,438,573,51,9,84,763,14,102,71,128,116,199,733,1364,8,11988,666,0,2,1,1,23740,9654,1906,15395,0
68,1223,1020,354,843,12,15,144,1032,8,134,77,144,142,221,970,1580,4,6792,377,0,2,5,1,23740,9654,1906,15396,0
455,10020,72,33,56,0,4,12,72,1,1,1,1,2,2,0,2,0,1,0,0,2,3,3,23740,9654,1906,15397,0
455,10020,1454,835,1044,76,110,219,1530,17,275,158,296,292,454,2297,3718,9,34017,1889,1,2,3,3,23750,9655,1906,15398,0
55,2363,1020,354,843,12,15,144,1032,8,134,77,144,142,221,970,1580,4,6792,377,0,2,4,3,23750,9655,1906,15399,0
172,3915,77,34,69,0,0,8,77,3,24,16,29,27,45,114,213,1,387,21,0,2,1,1,23750,9655,1906,15400,0
172,3915,712,438,573,51,9,84,763,14,102,71,128,116,199,733,1364,8,11988,666,0,2,1,1,23760,9656,1906,15401,0
68,1223,1020,354,843,12,15,144,1032,8,134,77,144,142,221,970,1580,4,6792,377,0,2,5,1,23760,9656,1906,15402,0
455,10020,72,33,56,0,4,12,72,1,1,1,1,2,2,0,2,0,1,0,0,2,3,3,23760,9656,1906,15403,0
455,10020,1454,835,1044,76,110,219,1530,17,275,158,296,292,454,2297,3718,9,34017,1889,1,2,3,3,23770,9657,1906,15404,0
55,2363,1020,354,843,12,15,144,1032,8,134,77,144,142,221,970,1580,4,6792,377,0,2,4,3,23770,9657,1906,15405,0
138,4352,1660,832,1314,41,38,274,1701,20,312,209,395,332,604,2671,5058,12,64042,3557,1,2,1,1,23770,9659,1907,15407,0
138,4352,1057,646,719,113,100,145,1170,18,215,134,248,233,382,1740,3004,10,31186,1732,1,2,1,1,23780,9660,1908,15408,0
126,3306,1660,832,1314,41,38,274,1701,20,312,209,395,332,604,2671,5058,12,64042,3557,1,2,12,0,23780,9662,1909,15410,0
138,4352,1660,832,1314,41,38,274,1701,20,312,209,395,332,604,2671,5058,12,64042,3557,1,2,1,1,23780,9664,1910,15412,0
138,4352,1057,646,719,113,100,145,1170,18,215,134,248,233,382,1740,3004,10,31186,1732,1,2,1,1,23790,9665,1911,15413,0
126,3306,1660,832,1314,41,38,274,1701,20,312,209,395,332,604,2671,5058,12,64042,3557,1,2,12,0,23790,9667,1912,15415,0
14,452,42,7,35,4,0,5,46,1,2,1,2,3,3,2,4,0,2,0,0,2,1,1,23800,9671,1913,15423,1
14,452,11,6,10,0,0,1,11,2,4,2,4,6,6,10,15,1,15,0,0,2,1,1,23800,9671,1913,15424,1
229,4687,1457,730,1242,11,6,188,1468,10,292,166,329,302,495,2424,4078,5,22973,1276,1,2,3,6,23800,9673,1913,15425,0
229,4687,74,35,59,1,0,14,75,3,14,7,14,17,21,58,85,1,128,7,0,2,3,6,23800,9674,1913,15426,0
229,4687,245,125,200,5,7,34,250,7,30,17,34,37,51,166,265,3,1053,58,0,2,3,6,23810,9675,1913,15427,0
24,743,74,35,59,1,0,14,75,3,14,7,14,17,21,58,85,1,128,7,0,2,2,70,23810,9676,1913,15428,0
24,743,245,125,200,5,7,34,250,7,30,17,34,37,51,166,265,3,1053,58,0,2,2,70,23820,9677,1913,15429,0
46,449,647,139,84,35,284,233,682,0,0,0,0,0,0,0,0,0,0,0,0,2,1,1,23820,9677,1913,15430,0
172,3928,77,34,69,0,0,8,77,3,24,16,29,27,45,114,213,1,387,21,0,2,11,8,23820,9677,1913,15431,0
172,3928,712,438,573,51,9,84,763,14,102,71,128,116,199,733,1364,8,11988,666,0,2,11,8,23830,9678,1913,15432,0
173,3969,722,423,573,19,0,135,741,12,172,101,199,184,300,1320,2257,6,15668,870,0,2,89,171,23830,9680,1913,15434,0
173,3969,1508,847,911,44,250,301,1552,14,148,88,169,162,257,1120,1886,7,15077,837,0,2,89,171,23830,9681,1914,15435,0
455,9950,72,33,56,0,4,12,72,1,1,1,1,2,2,0,2,0,1,0,0,2,24,32,23830,9681,1914,15436,0
455,9950,1454,835,1044,76,110,219,1530,17,275,158,296,292,454,2297,3718,9,34017,1889,1,2,24,32,23840,9682,1914,15437,0
45,2770,1296,573,1062,40,33,157,1336,8,201,118,231,209,349,1561,2689,4,12365,686,0,2,8,8,23840,9682,1914,15439,0
8,257,74,35,59,1,0,14,75,3,14,7,14,17,21,58,85,1,128,7,0,2,1,14,23840,9683,1914,15440,0
15,573,722,423,573,19,0,135,741,12,172,101,199,184,300,1320,2257,6,15668,870,0,2,25,35,23840,9685,1914,15442,0
229,4687,1457,730,1242,11,6,188,1468,10,292,166,329,302,495,2424,4078,5,22973,1276,1,2,3,6,23840,9687,1914,15443,0
229,4687,74,35,59,1,0,14,75,3,14,7,14,17,21,58,85,1,128,7,0,2,3,6,23840,9688,1914,15444,0
229,4687,245,125,200,5,7,34,250,7,30,17,34,37,51,166,265,3,1053,58,0,2,3,6,23850,9689,1914,15445,0
24,743,74,35,59,1,0,14,75,3,14,7,14,17,21,58,85,1,128,7,0,2,2,70,23850,9690,1914,15446,0
24,743,245,125,200,5,7,34,250,7,30,17,34,37,51,166,265,3,1053,58,0,2,2,70,23860,9691,1914,15447,0
46,449,647,139,84,35,284,233,682,0,0,0,0,0,0,0,0,0,0,0,0,2,1,1,23860,9691,1914,15448,0
172,3928,77,34,69,0,0,8,77,3,24,16,29,27,45,114,213,1,387,21,0,2,11,8,23860,9691,1914,15449,0
172,3928,712,438,573,51,9,84,763,14,102,71,128,116,199,733,1364,8,11988,666,0,2,11,8,23870,9692,1914,15450,0
173,3969,722,423,573,19,0,135,741,12,172,101,199,184,300,1320,2257,6,15668,870,0,2,89,171,23870,9694,1914,15452,0
173,3969,1508,847,911,44,250,301,1552,14,148,88,169,162,257,1120,1886,7,15077,837,0,2,89,171,23870,9695,1915,15453,0
455,9950,72,33,56,0,4,12,72,1,1,1,1,2,2,0,2,0,1,0,0,2,24,32,23870,9695,1915,15454,0
455,9950,1454,835,1044,76,110,219,1530,17,275,158,296,292,454,2297,3718,9,34017,1889,1,2,24,32,23880,9696,1915,15455,0
45,2770,1296,573,1062,40,33,157,1336,8,201,118,231,209,349,1561,2689,4,12365,686,0,2,8,8,23880,9696,1915,15457,0
8,257,74,35,59,1,0,14,75,3,14,7,14,17,21,58,85,1,128,7,0,2,1,14,23880,9697,1915,15458,0
15,573,722,423,573,19,0,135,741,12,172,101,199,184,300,1320,2257,6,15668,870,0,2,25,35,23880,9699,1915,15460,0
30,853,465,148,393,5,8,60,470,4,31,20,31,35,51,161,261,2,523,29,0,2,54,1,23880,9700,1915,15461,1
30,853,16,12,9,0,0,6,16,1,2,1,2,3,3,2,4,0,2,0,0,2,54,1,23880,9700,1915,15462,1
173,3969,722,423,573,19,0,135,741,12,172,101,199,184,300,1320,2257,6,15668,870,0,2,2,2,23880,9702,1915,15464,0
173,3969,1508,847,911,44,250,301,1552,14,148,88,169,162,257,1120,1886,7,15077,837,0,2,2,2,23880,9703,1916,15465,0
173,3969,722,423,573,19,0,135,741,12,172,101,199,184,300,1320,2257,6,15668,870,0,2,2,2,23880,9705,1916,15467,1
173,3969,1508,847,911,44,250,301,1552,14,148,88,169,162,257,1120,1886,7,15077,837,0,2,2,2,23880,9706,1917,15468,1
30,982,1455,414,1257,16,76,112,1471,5,41,23,46,46,69,231,381,2,1069,59,0,2,26,2,23880,9707,1917,15469,0
30,982,669,365,481,22,61,110,691,15,103,63,122,118,185,747,1273,8,11311,628,0,2,26,2,23890,9707,1918,15470,0
25,1094,1455,414,1257,16,76,112,1471,5,41,23,46,46,69,231,381,2,1069,59,0,2,34,0,23890,9708,1918,15471,0
30,982,1455,414,1257,16,76,112,1471,5,41,23,46,46,69,231,381,2,1069,59,0,2,26,2,23890,9709,1918,15472,1
30,982,669,365,481,22,61,110,691,15,103,63,122,118,185,747,1273,8,11311,628,0,2,26,2,23900,9709,1919,15473,1
25,1094,1455,414,1257,16,76,112,1471,5,41,23,46,46,69,231,381,2,1069,59,0,2,34,0,23900,9710,1919,15474,1
29,974,1455,414,1257,16,76,112,1471,5,41,23,46,46,69,231,381,2,1069,59,0,2,0,3,23900,9711,1919,15475,0
29,974,669,365,481,22,61,110,691,15,103,63,122,118,185,747,1273,8,11311,628,0,2,0,3,23910,9711,1920,15476,0
29,974,1455,414,1257,16,76,112,1471,5,41,23,46,46,69,231,381,2,1069,59,0,2,0,3,23910,9712,1920,15477,1
29,974,669,365,481,22,61,110,691,15,103,63,122,118,185,747,1273,8,11311,628,0,2,0,3,23920,9712,1921,15478,1
27,1182,1455,414,1257,16,76,112,1471,5,41,23,46,46,69,231,381,2,1069,59,0,2,26,0,23920,9713,1921,15479,0
27,1182,1455,414,1257,16,76,112,1471,5,41,23,46,46,69,231,381,2,1069,59,0,2,26,0,23920,9714,1921,15480,0
111,2245,1513,682,1277,25,13,200,1538,11,199,116,219,210,335,1557,2584,6,15641,868,0,2,17,22,23920,9716,1921,15481,0
111,2245,819,519,539,24,98,155,843,15,96,57,106,111,163,690,1107,8,9171,509,0,2,17,22,23930,9718,1921,15482,0
24,750,74,35,59,1,0,14,75,3,14,7,14,17,21,58,85,1,128,7,0,2,8,5,23930,9719,1921,15483,0
24,750,245,125,200,5,7,34,250,7,30,17,34,37,51,166,265,3,1053,58,0,2,8,5,23940,9720,1921,15484,0
23,371,424,94,331,4,0,89,428,1,5,5,5,6,10,11,25,0,12,0,0,2,1,1,23940,9721,1921,15485,0
23,371,38,23,23,6,0,8,44,3,11,7,11,14,18,42,68,1,102,5,0,2,1,1,23940,9721,1921,15486,0
14,454,184,100,137,2,15,30,186,6,38,20,39,44,59,214,322,3,991,55,0,2,4,3,23940,9722,1921,15487,0
14,454,103,65,74,8,5,16,111,7,17,9,17,24,26,89,119,3,417,23,0,2,4,3,23940,9723,1921,15488,0
454,9966,72,33,56,0,4,12,72,1,1,1,1,2,2,0,2,0,1,0,0,2,24,22,23940,9723,1921,15489,0
454,9966,1454,835,1044,76,110,219,1530,17,275,158,296,292,454,2297,3718,9,34017,1889,1,2,24,22,23950,9724,1921,15490,0
83,1483,1178,367,1042,6,15,115,1184,9,94,51,95,103,146,644,976,4,4439,246,0,2,26,40,23950,9724,1921,15491,0
83,1483,177,108,140,8,0,27,185,6,30,16,32,36,48,162,248,3,794,44,0,2,26,40,23950,9726,1921,15492,0
166,3406,1943,715,1694,26,18,214,1969,12,185,120,237,197,357,1436,2721,7,20915,1161,0,2,4,2,23950,9728,1921,15493,0
166,3406,1168,838,957,57,25,144,1225,19,348,224,416,367,640,3018,5452,11,61921,3440,1,2,4,2,23960,9730,1921,15494,0
51,1012,1098,241,925,5,10,155,1103,7,46,25,49,53,74,273,423,3,1580,87,0,2,26,23,23970,9732,1921,15495,0
51,1012,282,202,222,14,2,44,296,8,42,24,43,50,67,250,378,4,1548,86,0,2,26,23,23970,9733,1921,15496,0
63,2936,1338,495,1086,10,64,173,1348,11,122,82,157,133,239,883,1686,7,11934,663,0,2,9,6,23970,9735,1921,15497,0
55,2363,1020,354,843,12,15,144,1032,8,134,77,144,142,221,970,1580,4,6792,377,0,2,5,3,23970,9735,1921,15498,0
111,2245,1513,682,1277,25,13,200,1538,11,199,116,219,210,335,1557,2584,6,15641,868,0,2,17,22,23970,9737,1921,15499,1
111,2245,819,519,539,24,98,155,843,15,96,57,106,111,163,690,1107,8,9171,509,0,2,17,22,23980,9739,1921,15500,1
24,750,74,35,59,1,0,14,75,3,14,7,14,17,21,58,85,1,128,7,0,2,8,5,23980,9740,1921,15501,1
24,750,245,125,200,5,7,34,250,7,30,17,34,37,51,166,265,3,1053,58,0,2,8,5,23990,9741,1921,15502,1
23,371,424,94,331,4,0,89,428,1,5,5,5,6,10,11,25,0,12,0,0,2,1,1,23990,9742,1921,15503,1
23,371,38,23,23,6,0,8,44,3,11,7,11,14,18,42,68,1,102,5,0,2,1,1,23990,9742,1921,15504,1
14,454,184,100,137,2,15,30,186,6,38,20,39,44,59,214,322,3,991,55,0,2,4,3,23990,9743,1921,15505,1
14,454,103,65,74,8,5,16,111,7,17,9,17,24,26,89,119,3,417,23,0,2,4,3,23990,9744,1921,15506,1
454,9966,72,33,56,0,4,12,72,1,1,1,1,2,2,0,2,0,1,0,0,2,24,22,23990,9744,1921,15507,1
454,9966,1454,835,1044,76,110,219,1530,17,275,158,296,292,454,2297,3718,9,34017,1889,1,2,24,22,24000,9745,1921,15508,1
83,1483,1178,367,1042,6,15,115,1184,9,94,51,95,103,146,644,976,4,4439,246,0,2,26,40,24000,9745,1921,15509,1
83,1483,177,108,140,8,0,27,185,6,30,16,32,36,48,162,248,3,794,44,0,2,26,40,24000,9747,1921,15510,1
166,3406,1943,715,1694,26,18,214,1969,12,185,120,237,197,357,1436,2721,7,20915,1161,0,2,4,2,24000,9749,1921,15511,1
166,3406,1168,838,957,57,25,144,1225,19,348,224,416,367,640,3018,5452,11,61921,3440,1,2,4,2,24010,9751,1921,15512,1
51,1012,1098,241,925,5,10,155,1103,7,46,25,49,53,74,273,423,3,1580,87,0,2,26,23,24020,9753,1921,15513,1
51,1012,282,202,222,14,2,44,296,8,42,24,43,50,67,250,378,4,1548,86,0,2,26,23,24020,9754,1921,15514,1
63,2936,1338,495,1086,10,64,173,1348,11,122,82,157,133,239,883,1686,7,11934,663,0,2,9,6,24020,9756,1921,15515,1
55,2363,1020,354,843,12,15,144,1032,8,134,77,144,142,221,970,1580,4,6792,377,0,2,5,3,24020,9756,1921,15516,1
29,974,1455,414,1257,16,76,112,1471,5,41,23,46,46,69,231,381,2,1069,59,0,2,23,2,24020,9757,1921,15517,0
29,974,669,365,481,22,61,110,691,15,103,63,122,118,185,747,1273,8,11311,628,0,2,23,2,24030,9757,1922,15518,0
27,1182,1455,414,1257,16,76,112,1471,5,41,23,46,46,69,231,381,2,1069,59,0,2,60,0,24030,9758,1922,15519,0
29,974,1455,414,1257,16,76,112,1471,5,41,23,46,46,69,231,381,2,1069,59,0,2,23,2,24030,9759,1922,15520,0
29,974,669,365,481,22,61,110,691,15,103,63,122,118,185,747,1273,8,11311,628,0,2,23,2,24040,9759,1923,15521,0
27,1182,1455,414,1257,16,76,112,1471,5,41,23,46,46,69,231,381,2,1069,59,0,2,60,0,24040,9760,1923,15522,0
29,972,1455,414,1257,16,76,112,1471,5,41,23,46,46,69,231,381,2,1069,59,0,2,0,1,24040,9761,1923,15523,0
29,972,669,365,481,22,61,110,691,15,103,63,122,118,185,747,1273,8,11311,628,0,2,0,1,24050,9761,1924,15524,0
29,972,1455,414,1257,16,76,112,1471,5,41,23,46,46,69,231,381,2,1069,59,0,2,0,1,24050,9762,1924,15525,0
29,972,669,365,481,22,61,110,691,15,103,63,122,118,185,747,1273,8,11311,628,0,2,0,1,24060,9762,1925,15526,0
166,3406,1943,715,1694,26,18,214,1969,12,185,120,237,197,357,1436,2721,7,20915,1161,0,2,1,1,24060,9764,1925,15527,0
166,3406,1168,838,957,57,25,144,1225,19,348,224,416,367,640,3018,5452,11,61921,3440,1,2,1,1,24070,9766,1925,15528,0
166,3406,1943,715,1694,26,18,214,1969,12,185,120,237,197,357,1436,2721,7,20915,1161,0,2,1,1,24070,9768,1925,15529,1
166,3406,1168,838,957,57,25,144,1225,19,348,224,416,367,640,3018,5452,11,61921,3440,1,2,1,1,24080,9770,1925,15530,1
131,3359,1660,832,1314,41,38,274,1701,20,312,209,395,332,604,2671,5058,12,64042,3557,1,2,10,0,24080,9772,1926,15532,1
138,4352,1660,832,1314,41,38,274,1701,20,312,209,395,332,604,2671,5058,12,64042,3557,1,2,1,1,24080,9774,1927,15534,1
138,4352,1057,646,719,113,100,145,1170,18,215,134,248,233,382,1740,3004,10,31186,1732,1,2,1,1,24090,9775,1928,15535,1
138,4352,1660,832,1314,41,38,274,1701,20,312,209,395,332,604,2671,5058,12,64042,3557,1,2,1,1,24090,9777,1929,15537,0
138,4352,1057,646,719,113,100,145,1170,18,215,134,248,233,382,1740,3004,10,31186,1732,1,2,1,1,24100,9778,1930,15538,0
131,3359,1660,832,1314,41,38,274,1701,20,312,209,395,332,604,2671,5058,12,64042,3557,1,2,10,0,24100,9780,1931,15540,0
454,9990,72,33,56,0,4,12,72,1,1,1,1,2,2,0,2,0,1,0,0,2,17,7,24100,9780,1931,15541,1
454,9990,1454,835,1044,76,110,219,1530,17,275,158,296,292,454,2297,3718,9,34017,1889,1,2,17,7,24110,9781,1931,15542,1
47,2824,1296,573,1062,40,33,157,1336,8,201,118,231,209,349,1561,2689,4,12365,686,0,2,24,0,24110,9781,1931,15543,1
138,4358,1660,832,1314,41,38,274,1701,20,312,209,395,332,604,2671,5058,12,64042,3557,1,2,1,1,24110,9783,1932,15545,0
138,4358,1057,646,719,113,100,145,1170,18,215,134,248,233,382,1740,3004,10,31186,1732,1,2,1,1,24120,9784,1933,15546,0
457,10005,72,33,56,0,4,12,72,1,1,1,1,2,2,0,2,0,1,0,0,2,5,1,24120,9784,1933,15547,0
457,10005,1454,835,1044,76,110,219,1530,17,275,158,296,292,454,2297,3718,9,34017,1889,1,2,5,1,24130,9785,1933,15548,0
457,10005,72,33,56,0,4,12,72,1,1,1,1,2,2,0,2,0,1,0,0,2,21,7,24130,9785,1933,15549,0
457,10005,1454,835,1044,76,110,219,1530,17,275,158,296,292,454,2297,3718,9,34017,1889,1,2,21,7,24140,9786,1933,15550,0
47,2824,1296,573,1062,40,33,157,1336,8,201,118,231,209,349,1561,2689,4,12365,686,0,2,24,0,24140,9786,1933,15551,0
465,10107,72,33,56,0,4,12,72,1,1,1,1,2,2,0,2,0,1,0,0,2,38,15,24140,9786,1933,15552,0
465,10107,1454,835,1044,76,110,219,1530,17,275,158,296,292,454,2297,3718,9,34017,1889,1,2,38,15,24150,9787,1933,15553,0
31,888,465,148,393,5,8,60,470,4,31,20,31,35,51,161,261,2,523,29,0,2,54,1,24150,9788,1933,15554,0
31,888,16,12,9,0,0,6,16,1,2,1,2,3,3,2,4,0,2,0,0,2,54,1,24150,9788,1933,15555,0
65,3525,1782,648,1425,9,47,279,1791,8,171,97,189,179,286,1292,2140,4,9462,525,0,2,46,0,24150,9789,1934,15556,0
15,468,184,100,137,2,15,30,186,6,38,20,39,44,59,214,322,3,991,55,0,2,31,16,24150,9790,1934,15557,1
15,468,103,65,74,8,5,16,111,7,17,9,17,24,26,89,119,3,417,23,0,2,31,16,24150,9791,1934,15558,1
11,374,184,100,137,2,15,30,186,6,38,20,39,44,59,214,322,3,991,55,0,2,48,19,24150,9792,1934,15559,1
15,468,184,100,137,2,15,30,186,6,38,20,39,44,59,214,322,3,991,55,0,2,31,16,24150,9793,1934,15560,0
15,468,103,65,74,8,5,16,111,7,17,9,17,24,26,89,119,3,417,23,0,2,31,16,24150,9794,1934,15561,0
11,374,184,100,137,2,15,30,186,6,38,20,39,44,59,214,322,3,991,55,0,2,48,19,24150,9795,1934,15562,0
1,288,382,65,130,157,2,92,539,4,10,5,10,14,15,41,57,2,114,6,0,2,1,1,24160,9800,1936,15570,1
14,452,42,7,35,4,0,5,46,1,2,1,2,3,3,2,4,0,2,0,0,2,1,1,24160,9800,1936,15571,1
14,452,11,6,10,0,0,1,11,2,4,2,4,6,6,10,15,1,15,0,0,2,1,1,24160,9800,1936,15572,1
15,467,184,100,137,2,15,30,186,6,38,20,39,44,59,214,322,3,991,55,0,2,31,16,24160,9801,1936,15573,0
15,467,103,65,74,8,5,16,111,7,17,9,17,24,26,89,119,3,417,23,0,2,31,16,24160,9802,1936,15574,0
11,374,184,100,137,2,15,30,186,6,38,20,39,44,59,214,322,3,991,55,0,2,48,19,24160,9803,1936,15575,0
14,452,42,7,35,4,0,5,46,1,2,1,2,3,3,2,4,0,2,0,0,2,1,1,24170,9807,1937,15583,1
14,452,11,6,10,0,0,1,11,2,4,2,4,6,6,10,15,1,15,0,0,2,1,1,24170,9807,1937,15584,1
139,4400,1660,832,1314,41,38,274,1701,20,312,209,395,332,604,2671,5058,12,64042,3557,1,2,6,1,24170,9809,1938,15586,1
139,4400,1057,646,719,113,100,145,1170,18,215,134,248,233,382,1740,3004,10,31186,1732,1,2,6,1,24180,9810,1939,15587,1
131,3348,1660,832,1314,41,38,274,1701,20,312,209,395,332,604,2671,5058,12,64042,3557,1,2,5,7,24180,9812,1940,15589,1
465,10105,72,33,56,0,4,12,72,1,1,1,1,2,2,0,2,0,1,0,0,2,2,2,24180,9812,1940,15590,0
465,10105,1454,835,1044,76,110,219,1530,17,275,158,296,292,454,2297,3718,9,34017,1889,1,2,2,2,24190,9813,1940,15591,0
139,4400,1660,832,1314,41,38,274,1701,20,312,209,395,332,604,2671,5058,12,64042,3557,1,2,6,1,24190,9815,1941,15593,0
139,4400,1057,646,719,113,100,145,1170,18,215,134,248,233,382,1740,3004,10,31186,1732,1,2,6,1,24200,9816,1942,15594,0
131,3348,1660,832,1314,41,38,274,1701,20,312,209,395,332,604,2671,5058,12,64042,3557,1,2,5,7,24200,9818,1943,15596,0
43,863,447,308,343,6,5,95,453,7,96,59,111,103,170,651,1136,4,4600,255,0,2,23,14,24200,9821,1943,15599,1
43,863,322,174,179,16,74,51,338,10,41,26,46,51,72,252,408,5,2291,127,0,2,23,14,24200,9824,1944,15600,1
465,10120,72,33,56,0,4,12,72,1,1,1,1,2,2,0,2,0,1,0,0,2,11,4,24200,9824,1944,15601,1
465,10120,1454,835,1044,76,110,219,1530,17,275,158,296,292,454,2297,3718,9,34017,1889,1,2,11,4,24210,9825,1944,15602,1
130,5646,139,89,101,2,0,35,141,7,54,34,62,61,96,330,569,4,2287,127,0,2,23,0,24210,9825,1944,15603,1
130,5646,7,5,5,0,0,2,7,1,2,1,2,3,3,2,4,0,2,0,0,2,23,0,24210,9825,1944,15604,1
16,474,184,100,137,2,15,30,186,6,38,20,39,44,59,214,322,3,991,55,0,2,10,6,24210,9826,1944,15605,1
16,474,103,65,74,8,5,16,111,7,17,9,17,24,26,89,119,3,417,23,0,2,10,6,24210,9827,1944,15606,1
16,474,184,100,137,2,15,30,186,6,38,20,39,44,59,214,322,3,991,55,0,2,10,6,24210,9828,1944,15607,0
16,474,103,65,74,8,5,16,111,7,17,9,17,24,26,89,119,3,417,23,0,2,10,6,24210,9829,1944,15608,0
43,1307,1523,757,1297,19,12,193,1542,12,193,117,230,205,347,1508,2664,7,19053,1058,0,2,6,1,24220,9831,1944,15609,1
43,1307,701,378,504,33,58,109,734,13,110,68,126,123,194,794,1346,7,10027,557,0,2,6,1,24220,9832,1945,15610,1
40,2493,1523,757,1297,19,12,193,1542,12,193,117,230,205,347,1508,2664,7,19053,1058,0,2,15,2,24230,9834,1945,15611,1
229,4718,1457,730,1242,11,6,188,1468,10,292,166,329,302,495,2424,4078,5,22973,1276,1,2,2,0,24230,9836,1945,15612,0
229,4718,74,35,59,1,0,14,75,3,14,7,14,17,21,58,85,1,128,7,0,2,2,0,24230,9837,1945,15613,0
229,4718,245,125,200,5,7,34,250,7,30,17,34,37,51,166,265,3,1053,58,0,2,2,0,24240,9838,1945,15614,0
40,1923,1457,730,1242,11,6,188,1468,10,292,166,329,302,495,2424,4078,5,22973,1276,1,2,7,0,24240,9840,1945,15615,0
229,4709,1457,730,1242,11,6,188,1468,10,292,166,329,302,495,2424,4078,5,22973,1276,1,2,1,2,24240,9842,1945,15616,0
229,4709,74,35,59,1,0,14,75,3,14,7,14,17,21,58,85,1,128,7,0,2,1,2,24240,9843,1945,15617,0
229,4709,245,125,200,5,7,34,250,7,30,17,34,37,51,166,265,3,1053,58,0,2,1,2,24250,9844,1945,15618,0
40,1916,1457,730,1242,11,6,188,1468,10,292,166,329,302,495,2424,4078,5,22973,1276,1,2,2,5,24250,9846,1945,15619,0
31,1022,1455,414,1257,16,76,112,1471,5,41,23,46,46,69,231,381,2,1069,59,0,2,13,3,24250,9847,1945,15620,1
31,1022,669,365,481,22,61,110,691,15,103,63,122,118,185,747,1273,8,11311,628,0,2,13,3,24260,9847,1946,15621,1
229,4709,1457,730,1242,11,6,188,1468,10,292,166,329,302,495,2424,4078,5,22973,1276,1,2,1,0,24260,9849,1946,15622,0
229,4709,74,35,59,1,0,14,75,3,14,7,14,17,21,58,85,1,128,7,0,2,1,0,24260,9850,1946,15623,0
229,4709,245,125,200,5,7,34,250,7,30,17,34,37,51,166,265,3,1053,58,0,2,1,0,24270,9851,1946,15624,0
40,1916,1457,730,1242,11,6,188,1468,10,292,166,329,302,495,2424,4078,5,22973,1276,1,2,5,1,24270,9853,1946,15625,0
27,1147,1455,414,1257,16,76,112,1471,5,41,23,46,46,69,231,381,2,1069,59,0,2,0,8,24270,9854,1946,15626,0
31,1169,1293,570,1093,25,15,163,1318,10,195,123,241,205,364,1516,2795,6,17273,959,0,2,0,2,24280,9856,1946,15627,0
27,1147,1455,414,1257,16,76,112,1471,5,41,23,46,46,69,231,381,2,1069,59,0,2,0,8,24280,9857,1946,15628,0
31,1169,1293,570,1093,25,15,163,1318,10,195,123,241,205,364,1516,2795,6,17273,959,0,2,0,2,24290,9859,1946,15629,0
1,288,382,65,130,157,2,92,539,4,10,5,10,14,15,41,57,2,114,6,0,2,1,1,24290,9860,1947,15630,0
27,1147,1455,414,1257,16,76,112,1471,5,41,23,46,46,69,231,381,2,1069,59,0,2,0,8,24290,9861,1947,15631,0
31,1169,1293,570,1093,25,15,163,1318,10,195,123,241,205,364,1516,2795,6,17273,959,0,2,0,2,24300,9863,1947,15632,0
43,1307,1523,757,1297,19,12,193,1542,12,193,117,230,205,347,1508,2664,7,19053,1058,0,2,6,1,24310,9865,1947,15633,0
43,1307,701,378,504,33,58,109,734,13,110,68,126,123,194,794,1346,7,10027,557,0,2,6,1,24310,9866,1948,15634,0
40,2493,1523,757,1297,19,12,193,1542,12,193,117,230,205,347,1508,2664,7,19053,1058,0,2,15,2,24320,9868,1948,15635,0
28,1226,1455,414,1257,16,76,112,1471,5,41,23,46,46,69,231,381,2,1069,59,0,2,16,0,24320,9869,1948,15636,0
247,4978,1457,730,1242,11,6,188,1468,10,292,166,329,302,495,2424,4078,5,22973,1276,1,2,61,10,24320,9871,1948,15637,1
247,4978,74,35,59,1,0,14,75,3,14,7,14,17,21,58,85,1,128,7,0,2,61,10,24320,9872,1948,15638,1
247,4978,245,125,200,5,7,34,250,7,30,17,34,37,51,166,265,3,1053,58,0,2,61,10,24330,9873,1948,15639,1
172,3925,77,34,69,0,0,8,77,3,24,16,29,27,45,114,213,1,387,21,0,2,6,5,24330,9873,1948,15640,1
172,3925,712,438,573,51,9,84,763,14,102,71,128,116,199,733,1364,8,11988,666,0,2,6,5,24340,9874,1948,15641,1
173,3958,722,423,573,19,0,135,741,12,172,101,199,184,300,1320,2257,6,15668,870,0,2,2,4,24340,9876,1948,15643,1
173,3958,1508,847,911,44,250,301,1552,14,148,88,169,162,257,1120,1886,7,15077,837,0,2,2,4,24340,9877,1949,15644,1
464,10112,72,33,56,0,4,12,72,1,1,1,1,2,2,0,2,0,1,0,0,2,1,3,24340,9877,1949,15645,1
464,10112,1454,835,1044,76,110,219,1530,17,275,158,296,292,454,2297,3718,9,34017,1889,1,2,1,3,24350,9878,1949,15646,1
83,1504,1178,367,1042,6,15,115,1184,9,94,51,95,103,146,644,976,4,4439,246,0,2,4,4,24350,9878,1949,15647,1
83,1504,177,108,140,8,0,27,185,6,30,16,32,36,48,162,248,3,794,44,0,2,4,4,24350,9880,1949,15648,1
168,3515,1943,715,1694,26,18,214,1969,12,185,120,237,197,357,1436,2721,7,20915,1161,0,2,31,21,24350,9882,1949,15649,1
168,3515,1168,838,957,57,25,144,1225,19,348,224,416,367,640,3018,5452,11,61921,3440,1,2,31,21,24360,9884,1949,15650,1
47,2824,1296,573,1062,40,33,157,1336,8,201,118,231,209,349,1561,2689,4,12365,686,0,2,2,2,24360,9884,1949,15651,1
47,2300,1457,730,1242,11,6,188,1468,10,292,166,329,302,495,2424,4078,5,22973,1276,1,2,54,2,24360,9886,1949,15652,1
30,1941,652,304,544,16,6,88,668,6,89,51,101,95,152,591,998,3,3399,188,0,2,89,0,24360,9887,1949,15653,1
27,1145,1455,414,1257,16,76,112,1471,5,41,23,46,46,69,231,381,2,1069,59,0,2,0,3,24360,9888,1949,15654,1
61,2681,1943,715,1694,26,18,214,1969,12,185,120,237,197,357,1436,2721,7,20915,1161,0,2,3,3,24360,9890,1949,15655,1
31,1022,1455,414,1257,16,76,112,1471,5,41,23,46,46,69,231,381,2,1069,59,0,2,13,3,24360,9891,1949,15656,0
31,1022,669,365,481,22,61,110,691,15,103,63,122,118,185,747,1273,8,11311,628,0,2,13,3,24370,9891,1950,15657,0
28,1191,1455,414,1257,16,76,112,1471,5,41,23,46,46,69,231,381,2,1069,59,0,2,16,0,24370,9892,1950,15658,0
30,1950,652,304,544,16,6,88,668,6,89,51,101,95,152,591,998,3,3399,188,0,2,84,85,24370,9893,1950,15659,1
465,10120,72,33,56,0,4,12,72,1,1,1,1,2,2,0,2,0,1,0,0,2,1,1,24370,9893,1950,15660,1
465,10120,1454,835,1044,76,110,219,1530,17,275,158,296,292,454,2297,3718,9,34017,1889,1,2,1,1,24380,9894,1950,15661,1
11,370,85,59,61,8,0,16,93,5,18,10,18,23,28,86,126,2,316,17,0,2,2,2,24380,9894,1950,15662,1
111,4259,1513,682,1277,25,13,200,1538,11,199,116,219,210,335,1557,2584,6,15641,868,0,2,1,1,24380,9896,1950,15663,1
465,10120,72,33,56,0,4,12,72,1,1,1,1,2,2,0,2,0,1,0,0,2,1,1,24380,9896,1950,15664,0
465,10120,1454,835,1044,76,110,219,1530,17,275,158,296,292,454,2297,3718,9,34017,1889,1,2,1,1,24390,9897,1950,15665,0
11,370,85,59,61,8,0,16,93,5,18,10,18,23,28,86,126,2,316,17,0,2,2,2,24390,9897,1950,15666,0
111,4259,1513,682,1277,25,13,200,1538,11,199,116,219,210,335,1557,2584,6,15641,868,0,2,1,1,24390,9899,1950,15667,0
11,370,85,59,61,8,0,16,93,5,18,10,18,23,28,86,126,2,316,17,0,2,1,1,24390,9899,1950,15668,0
11,370,85,59,61,8,0,16,93,5,18,10,18,23,28,86,126,2,316,17,0,2,1,1,24390,9899,1950,15669,0
247,4978,1457,730,1242,11,6,188,1468,10,292,166,329,302,495,2424,4078,5,22973,1276,1,2,61,10,24390,9901,1950,15670,0
247,4978,74,35,59,1,0,14,75,3,14,7,14,17,21,58,85,1,128,7,0,2,61,10,24390,9902,1950,15671,0
247,4978,245,125,200,5,7,34,250,7,30,17,34,37,51,166,265,3,1053,58,0,2,61,10,24400,9903,1950,15672,0
172,3925,77,34,69,0,0,8,77,3,24,16,29,27,45,114,213,1,387,21,0,2,6,5,24400,9903,1950,15673,0
172,3925,712,438,573,51,9,84,763,14,102,71,128,116,199,733,1364,8,11988,666,0,2,6,5,24410,9904,1950,15674,0
173,3958,722,423,573,19,0,135,741,12,172,101,199,184,300,1320,2257,6,15668,870,0,2,2,4,24410,9906,1950,15676,0
173,3958,1508,847,911,44,250,301,1552,14,148,88,169,162,257,1120,1886,7,15077,837,0,2,2,4,24410,9907,1951,15677,0
464,10112,72,33,56,0,4,12,72,1,1,1,1,2,2,0,2,0,1,0,0,2,1,3,24410,9907,1951,15678,0
464,10112,1454,835,1044,76,110,219,1530,17,275,158,296,292,454,2297,3718,9,34017,1889,1,2,1,3,24420,9908,1951,15679,0
83,1504,1178,367,1042,6,15,115,1184,9,94,51,95,103,146,644,976,4,4439,246,0,2,4,4,24420,9908,1951,15680,0
83,1504,177,108,140,8,0,27,185,6,30,16,32,36,48,162,248,3,794,44,0,2,4,4,24420,9910,1951,15681,0
168,3515,1943,715,1694,26,18,214,1969,12,185,120,237,197,357,1436,2721,7,20915,1161,0,2,31,21,24420,9912,1951,15682,0
168,3515,1168,838,957,57,25,144,1225,19,348,224,416,367,640,3018,5452,11,61921,3440,1,2,31,21,24430,9914,1951,15683,0
47,2824,1296,573,1062,40,33,157,1336,8,201,118,231,209,349,1561,2689,4,12365,686,0,2,2,2,24430,9914,1951,15684,0
47,2300,1457,730,1242,11,6,188,1468,10,292,166,329,302,495,2424,4078,5,22973,1276,1,2,54,2,24430,9916,1951,15685,0
30,1950,652,304,544,16,6,88,668,6,89,51,101,95,152,591,998,3,3399,188,0,2,88,0,24430,9917,1951,15686,0
28,1189,1455,414,1257,16,76,112,1471,5,41,23,46,46,69,231,381,2,1069,59,0,2,0,3,24430,9918,1951,15687,0
61,2681,1943,715,1694,26,18,214,1969,12,185,120,237,197,357,1436,2721,7,20915,1161,0,2,3,3,24430,9920,1951,15688,0
464,10117,72,33,56,0,4,12,72,1,1,1,1,2,2,0,2,0,1,0,0,2,1,1,24430,9920,1951,15689,1
464,10117,1454,835,1044,76,110,219,1530,17,275,158,296,292,454,2297,3718,9,34017,1889,1,2,1,1,24440,9921,1951,15690,1
14,457,42,7,35,4,0,5,46,1,2,1,2,3,3,2,4,0,2,0,0,2,2,1,24440,9921,1951,15691,1
14,457,11,6,10,0,0,1,11,2,4,2,4,6,6,10,15,1,15,0,0,2,2,1,24440,9921,1951,15692,1
134,5956,139,89,101,2,0,35,141,7,54,34,62,61,96,330,569,4,2287,127,0,2,108,0,24440,9921,1951,15693,1
134,5956,7,5,5,0,0,2,7,1,2,1,2,3,3,2,4,0,2,0,0,2,108,0,24440,9921,1951,15694,1
466,10154,72,33,56,0,4,12,72,1,1,1,1,2,2,0,2,0,1,0,0,2,6,3,24440,9921,1951,15695,1
466,10154,1454,835,1044,76,110,219,1530,17,275,158,296,292,454,2297,3718,9,34017,1889,1,2,6,3,24450,9922,1951,15696,1
64,2966,1338,495,1086,10,64,173,1348,11,122,82,157,133,239,883,1686,7,11934,663,0,2,17,0,24450,9924,1951,15697,1
30,1950,652,304,544,16,6,88,668,6,89,51,101,95,152,591,998,3,3399,188,0,2,4,0,24450,9925,1951,15698,0
465,10151,72,33,56,0,4,12,72,1,1,1,1,2,2,0,2,0,1,0,0,2,4,3,24450,9925,1951,15699,1
465,10151,1454,835,1044,76,110,219,1530,17,275,158,296,292,454,2297,3718,9,34017,1889,1,2,4,3,24460,9926,1951,15700,1
30,1950,652,304,544,16,6,88,668,6,89,51,101,95,152,591,998,3,3399,188,0,2,4,0,24460,9927,1951,15701,0
64,2966,1338,495,1086,10,64,173,1348,11,122,82,157,133,239,883,1686,7,11934,663,0,2,6,6,24460,9929,1951,15702,0
465,10151,72,33,56,0,4,12,72,1,1,1,1,2,2,0,2,0,1,0,0,2,4,3,24460,9929,1951,15703,0
465,10151,1454,835,1044,76,110,219,1530,17,275,158,296,292,454,2297,3718,9,34017,1889,1,2,4,3,24470,9930,1951,15704,0
140,4414,1660,832,1314,41,38,274,1701,20,312,209,395,332,604,2671,5058,12,64042,3557,1,2,6,0,24470,9932,1952,15706,1
140,4414,1057,646,719,113,100,145,1170,18,215,134,248,233,382,1740,3004,10,31186,1732,1,2,6,0,24480,9933,1953,15707,1
132,3417,1660,832,1314,41,38,274,1701,20,312,209,395,332,604,2671,5058,12,64042,3557,1,2,24,0,24480,9935,1954,15709,1
464,10116,72,33,56,0,4,12,72,1,1,1,1,2,2,0,2,0,1,0,0,2,1,1,24480,9935,1954,15710,1
464,10116,1454,835,1044,76,110,219,1530,17,275,158,296,292,454,2297,3718,9,34017,1889,1,2,1,1,24490,9936,1954,15711,1
131,5688,139,89,101,2,0,35,141,7,54,34,62,61,96,330,569,4,2287,127,0,2,31,1,24490,9936,1954,15712,1
131,5688,7,5,5,0,0,2,7,1,2,1,2,3,3,2,4,0,2,0,0,2,31,1,24490,9936,1954,15713,1
464,10116,72,33,56,0,4,12,72,1,1,1,1,2,2,0,2,0,1,0,0,2,1,1,24490,9936,1954,15714,0
464,10116,1454,835,1044,76,110,219,1530,17,275,158,296,292,454,2297,3718,9,34017,1889,1,2,1,1,24500,9937,1954,15715,0
131,5688,139,89,101,2,0,35,141,7,54,34,62,61,96,330,569,4,2287,127,0,2,31,1,24500,9937,1954,15716,0
131,5688,7,5,5,0,0,2,7,1,2,1,2,3,3,2,4,0,2,0,0,2,31,1,24500,9937,1954,15717,0
465,10155,72,33,56,0,4,12,72,1,1,1,1,2,2,0,2,0,1,0,0,2,10,6,24500,9937,1954,15718,0
465,10155,1454,835,1044,76,110,219,1530,17,275,158,296,292,454,2297,3718,9,34017,1889,1,2,10,6,24510,9938,1954,15719,0
14,457,42,7,35,4,0,5,46,1,2,1,2,3,3,2,4,0,2,0,0,2,2,1,24510,9938,1954,15720,0
14,457,11,6,10,0,0,1,11,2,4,2,4,6,6,10,15,1,15,0,0,2,2,1,24510,9938,1954,15721,0
64,2966,1338,495,1086,10,64,173,1348,11,122,82,157,133,239,883,1686,7,11934,663,0,2,20,3,24510,9940,1954,15722,0
135,5998,139,89,101,2,0,35,141,7,54,34,62,61,96,330,569,4,2287,127,0,2,108,0,24510,9940,1954,15723,0
135,5998,7,5,5,0,0,2,7,1,2,1,2,3,3,2,4,0,2,0,0,2,108,0,24510,9940,1954,15724,0
115,2519,1043,504,840,53,9,147,1096,9,180,112,198,189,310,1377,2344,4,11604,644,0,2,11,1,24510,9942,1954,15725,0
115,2519,383,288,292,26,6,62,409,11,65,38,67,76,105,429,656,5,3719,206,0,2,11,1,24510,9943,1954,15726,0
53,2083,1043,504,840,53,9,147,1096,9,180,112,198,189,310,1377,2344,4,11604,644,0,2,15,0,24510,9945,1954,15727,1
53,2083,1043,504,840,53,9,147,1096,9,180,112,198,189,310,1377,2344,4,11604,644,0,2,4,1,24510,9947,1954,15728,1
466,10185,72,33,56,0,4,12,72,1,1,1,1,2,2,0,2,0,1,0,0,2,7,0,24510,9947,1954,15729,0
466,10185,1454,835,1044,76,110,219,1530,17,275,158,296,292,454,2297,3718,9,34017,1889,1,2,7,0,24520,9948,1954,15730,0
66,3583,1782,648,1425,9,47,279,1791,8,171,97,189,179,286,1292,2140,4,9462,525,0,2,15,0,24520,9949,1955,15731,0
466,10182,72,33,56,0,4,12,72,1,1,1,1,2,2,0,2,0,1,0,0,2,2,5,24520,9949,1955,15732,0
466,10182,1454,835,1044,76,110,219,1530,17,275,158,296,292,454,2297,3718,9,34017,1889,1,2,2,5,24530,9950,1955,15733,0
466,10182,72,33,56,0,4,12,72,1,1,1,1,2,2,0,2,0,1,0,0,2,1,1,24530,9950,1955,15734,0
466,10182,1454,835,1044,76,110,219,1530,17,275,158,296,292,454,2297,3718,9,34017,1889,1,2,1,1,24540,9951,1955,15735,0
140,4414,1660,832,1314,41,38,274,1701,20,312,209,395,332,604,2671,5058,12,64042,3557,1,2,6,0,24540,9953,1956,15737,0
140,4414,1057,646,719,113,100,145,1170,18,215,134,248,233,382,1740,3004,10,31186,1732,1,2,6,0,24550,9954,1957,15738,0
132,3417,1660,832,1314,41,38,274,1701,20,312,209,395,332,604,2671,5058,12,64042,3557,1,2,24,0,24550,9956,1958,15740,0
465,10150,72,33,56,0,4,12,72,1,1,1,1,2,2,0,2,0,1,0,0,2,0,1,24550,9956,1958,15741,0
465,10150,1454,835,1044,76,110,219,1530,17,275,158,296,292,454,2297,3718,9,34017,1889,1,2,0,1,24560,9957,1958,15742,0
68,1230,1020,354,843,12,15,144,1032,8,134,77,144,142,221,970,1580,4,6792,377,0,2,3,0,24560,9957,1958,15743,1
466,10184,72,33,56,0,4,12,72,1,1,1,1,2,2,0,2,0,1,0,0,2,3,3,24560,9957,1958,15744,1
466,10184,1454,835,1044,76,110,219,1530,17,275,158,296,292,454,2297,3718,9,34017,1889,1,2,3,3,24570,9958,1958,15745,1
66,3583,1782,648,1425,9,47,279,1791,8,171,97,189,179,286,1292,2140,4,9462,525,0,2,1,1,24570,9959,1959,15746,1
68,1230,1020,354,843,12,15,144,1032,8,134,77,144,142,221,970,1580,4,6792,377,0,2,3,1,24570,9959,1959,15747,1
140,4414,1660,832,1314,41,38,274,1701,20,312,209,395,332,604,2671,5058,12,64042,3557,1,2,6,0,24570,9961,1960,15749,0
140,4414,1057,646,719,113,100,145,1170,18,215,134,248,233,382,1740,3004,10,31186,1732,1,2,6,0,24580,9962,1961,15750,0
466,10179,72,33,56,0,4,12,72,1,1,1,1,2,2,0,2,0,1,0,0,2,0,1,24580,9962,1961,15751,0
466,10179,1454,835,1044,76,110,219,1530,17,275,158,296,292,454,2297,3718,9,34017,1889,1,2,0,1,24590,9963,1961,15752,0
132,3417,1660,832,1314,41,38,274,1701,20,312,209,395,332,604,2671,5058,12,64042,3557,1,2,24,0,24590,9965,1962,15754,0
68,1230,1020,354,843,12,15,144,1032,8,134,77,144,142,221,970,1580,4,6792,377,0,2,5,0,24590,9965,1962,15755,0
466,10179,72,33,56,0,4,12,72,1,1,1,1,2,2,0,2,0,1,0,0,2,5,1,24590,9965,1962,15756,0
466,10179,1454,835,1044,76,110,219,1530,17,275,158,296,292,454,2297,3718,9,34017,1889,1,2,5,1,24600,9966,1962,15757,0
66,3583,1782,648,1425,9,47,279,1791,8,171,97,189,179,286,1292,2140,4,9462,525,0,2,15,0,24600,9967,1963,15758,0
115,2519,1043,504,840,53,9,147,1096,9,180,112,198,189,310,1377,2344,4,11604,644,0,2,11,1,24600,9969,1963,15759,0
115,2519,383,288,292,26,6,62,409,11,65,38,67,76,105,429,656,5,3719,206,0,2,11,1,24600,9970,1963,15760,0
53,2083,1043,504,840,53,9,147,1096,9,180,112,198,189,310,1377,2344,4,11604,644,0,2,18,0,24600,9972,1963,15761,0
68,1230,1020,354,843,12,15,144,1032,8,134,77,144,142,221,970,1580,4,6792,377,0,2,3,3,24600,9972,1963,15762,0
1,288,382,65,130,157,2,92,539,4,10,5,10,14,15,41,57,2,114,6,0,2,2,2,24610,9977,1965,15770,1
7,292,72,33,56,0,4,12,72,1,1,1,1,2,2,0,2,0,1,0,0,2,2,2,24610,9977,1965,15771,1
14,457,42,7,35,4,0,5,46,1,2,1,2,3,3,2,4,0,2,0,0,2,1,1,24610,9977,1965,15772,1
14,457,11,6,10,0,0,1,11,2,4,2,4,6,6,10,15,1,15,0,0,2,1,1,24610,9977,1965,15773,1
135,5990,139,89,101,2,0,35,141,7,54,34,62,61,96,330,569,4,2287,127,0,2,3,4,24610,9977,1965,15774,1
135,5990,7,5,5,0,0,2,7,1,2,1,2,3,3,2,4,0,2,0,0,2,3,4,24610,9977,1965,15775,1
1,288,382,65,130,157,2,92,539,4,10,5,10,14,15,41,57,2,114,6,0,2,1,1,24620,9982,1967,15783,0
14,457,42,7,35,4,0,5,46,1,2,1,2,3,3,2,4,0,2,0,0,2,1,1,24620,9982,1967,15784,0
14,457,11,6,10,0,0,1,11,2,4,2,4,6,6,10,15,1,15,0,0,2,1,1,24620,9982,1967,15785,0
466,10197,72,33,56,0,4,12,72,1,1,1,1,2,2,0,2,0,1,0,0,2,17,16,24620,9982,1967,15786,1
466,10197,1454,835,1044,76,110,219,1530,17,275,158,296,292,454,2297,3718,9,34017,1889,1,2,17,16,24630,9983,1967,15787,1
136,6025,139,89,101,2,0,35,141,7,54,34,62,61,96,330,569,4,2287,127,0,2,21,0,24630,9983,1967,15788,1
136,6025,7,5,5,0,0,2,7,1,2,1,2,3,3,2,4,0,2,0,0,2,21,0,24630,9983,1967,15789,1
1,315,382,65,130,157,2,92,539,4,10,5,10,14,15,41,57,2,114,6,0,2,7,4,24640,9988,1969,15797,1
17,539,42,7,35,4,0,5,46,1,2,1,2,3,3,2,4,0,2,0,0,2,10,1,24640,9988,1969,15798,1
17,539,11,6,10,0,0,1,11,2,4,2,4,6,6,10,15,1,15,0,0,2,10,1,24640,9988,1969,15799,1
1,315,382,65,130,157,2,92,539,4,10,5,10,14,15,41,57,2,114,6,0,2,7,4,24650,9993,1971,15807,0
17,539,42,7,35,4,0,5,46,1,2,1,2,3,3,2,4,0,2,0,0,2,10,1,24650,9993,1971,15808,0
17,539,11,6,10,0,0,1,11,2,4,2,4,6,6,10,15,1,15,0,0,2,10,1,24650,9993,1971,15809,0
1,315,382,65,130,157,2,92,539,4,10,5,10,14,15,41,57,2,114,6,0,2,7,4,24670,10002,1974,15824,0
17,539,42,7,35,4,0,5,46,1,2,1,2,3,3,2,4,0,2,0,0,2,10,1,24670,10002,1974,15825,0
17,539,11,6,10,0,0,1,11,2,4,2,4,6,6,10,15,1,15,0,0,2,10,1,24670,10002,1974,15826,0
21,612,42,7,35,4,0,5,46,1,2,1,2,3,3,2,4,0,2,0,0,2,18,4,24670,10002,1974,15827,1
21,612,11,6,10,0,0,1,11,2,4,2,4,6,6,10,15,1,15,0,0,2,18,4,24670,10002,1974,15828,1
20,614,42,7,35,4,0,5,46,1,2,1,2,3,3,2,4,0,2,0,0,2,4,2,24670,10002,1974,15829,0
20,614,11,6,10,0,0,1,11,2,4,2,4,6,6,10,15,1,15,0,0,2,4,2,24670,10002,1974,15830,0
20,614,42,7,35,4,0,5,46,1,2,1,2,3,3,2,4,0,2,0,0,2,1,1,24670,10002,1974,15831,1
20,614,11,6,10,0,0,1,11,2,4,2,4,6,6,10,15,1,15,0,0,2,1,1,24670,10002,1974,15832,1
20,614,42,7,35,4,0,5,46,1,2,1,2,3,3,2,4,0,2,0,0,2,1,1,24670,10002,1974,15833,0
20,614,11,6,10,0,0,1,11,2,4,2,4,6,6,10,15,1,15,0,0,2,1,1,24670,10002,1974,15834,0
20,615,42,7,35,4,0,5,46,1,2,1,2,3,3,2,4,0,2,0,0,2,13,2,24670,10002,1974,15835,1
20,615,11,6,10,0,0,1,11,2,4,2,4,6,6,10,15,1,15,0,0,2,13,2,24670,10002,1974,15836,1
173,4001,722,423,573,19,0,135,741,12,172,101,199,184,300,1320,2257,6,15668,870,0,2,322,1,24670,10004,1974,15838,1
173,4001,1508,847,911,44,250,301,1552,14,148,88,169,162,257,1120,1886,7,15077,837,0,2,322,1,24670,10005,1975,15839,1
20,615,42,7,35,4,0,5,46,1,2,1,2,3,3,2,4,0,2,0,0,2,2,2,24670,10005,1975,15840,0
20,615,11,6,10,0,0,1,11,2,4,2,4,6,6,10,15,1,15,0,0,2,2,2,24670,10005,1975,15841,0
20,615,42,7,35,4,0,5,46,1,2,1,2,3,3,2,4,0,2,0,0,2,31,4,24670,10005,1975,15842,0
20,615,11,6,10,0,0,1,11,2,4,2,4,6,6,10,15,1,15,0,0,2,31,4,24670,10005,1975,15843,0
466,10197,72,33,56,0,4,12,72,1,1,1,1,2,2,0,2,0,1,0,0,2,17,16,24670,10005,1975,15844,0
466,10197,1454,835,1044,76,110,219,1530,17,275,158,296,292,454,2297,3718,9,34017,1889,1,2,17,16,24680,10006,1975,15845,0
136,6025,139,89,101,2,0,35,141,7,54,34,62,61,96,330,569,4,2287,127,0,2,21,0,24680,10006,1975,15846,0
136,6025,7,5,5,0,0,2,7,1,2,1,2,3,3,2,4,0,2,0,0,2,21,0,24680,10006,1975,15847,0
466,10197,72,33,56,0,4,12,72,1,1,1,1,2,2,0,2,0,1,0,0,2,17,16,24680,10006,1975,15848,0
466,10197,1454,835,1044,76,110,219,1530,17,275,158,296,292,454,2297,3718,9,34017,1889,1,2,17,16,24690,10007,1975,15849,0
136,6025,139,89,101,2,0,35,141,7,54,34,62,61,96,330,569,4,2287,127,0,2,21,0,24690,10007,1975,15850,0
136,6025,7,5,5,0,0,2,7,1,2,1,2,3,3,2,4,0,2,0,0,2,21,0,24690,10007,1975,15851,0
466,10197,72,33,56,0,4,12,72,1,1,1,1,2,2,0,2,0,1,0,0,2,1,1,24690,10007,1975,15852,0
466,10197,1454,835,1044,76,110,219,1530,17,275,158,296,292,454,2297,3718,9,34017,1889,1,2,1,1,24700,10008,1975,15853,0
467,10219,72,33,56,0,4,12,72,1,1,1,1,2,2,0,2,0,1,0,0,2,12,7,24700,10008,1975,15854,1
467,10219,1454,835,1044,76,110,219,1530,17,275,158,296,292,454,2297,3718,9,34017,1889,1,2,12,7,24710,10009,1975,15855,1
66,2718,1289,550,1043,56,32,155,1345,10,167,93,185,177,278,1266,2075,5,11498,638,0,2,17,0,24710,10011,1976,15856,1
466,10197,72,33,56,0,4,12,72,1,1,1,1,2,2,0,2,0,1,0,0,2,1,1,24710,10011,1976,15857,1
466,10197,1454,835,1044,76,110,219,1530,17,275,158,296,292,454,2297,3718,9,34017,1889,1,2,1,1,24720,10012,1976,15858,1
172,3989,722,423,573,19,0,135,741,12,172,101,199,184,300,1320,2257,6,15668,870,0,2,2,4,24730,10018,1977,15867,1
172,3989,1508,847,911,44,250,301,1552,14,148,88,169,162,257,1120,1886,7,15077,837,0,2,2,4,24730,10019,1978,15868,1
466,10197,72,33,56,0,4,12,72,1,1,1,1,2,2,0,2,0,1,0,0,2,2,1,24730,10019,1978,15869,1
466,10197,1454,835,1044,76,110,219,1530,17,275,158,296,292,454,2297,3718,9,34017,1889,1,2,2,1,24740,10020,1978,15870,1
20,615,42,7,35,4,0,5,46,1,2,1,2,3,3,2,4,0,2,0,0,2,5,5,24740,10020,1978,15871,1
20,615,11,6,10,0,0,1,11,2,4,2,4,6,6,10,15,1,15,0,0,2,5,5,24740,10020,1978,15872,1
65,3083,1338,495,1086,10,64,173,1348,11,122,82,157,133,239,883,1686,7,11934,663,0,2,20,0,24740,10022,1978,15873,1
31,888,465,148,393,5,8,60,470,4,31,20,31,35,51,161,261,2,523,29,0,2,2,2,24740,10023,1978,15874,1
31,888,16,12,9,0,0,6,16,1,2,1,2,3,3,2,4,0,2,0,0,2,2,2,24740,10023,1978,15875,1
467,10219,72,33,56,0,4,12,72,1,1,1,1,2,2,0,2,0,1,0,0,2,12,7,24740,10023,1978,15876,0
467,10219,1454,835,1044,76,110,219,1530,17,275,158,296,292,454,2297,3718,9,34017,1889,1,2,12,7,24750,10024,1978,15877,0
66,2718,1289,550,1043,56,32,155,1345,10,167,93,185,177,278,1266,2075,5,11498,638,0,2,17,0,24750,10026,1979,15878,0
467,10219,72,33,56,0,4,12,72,1,1,1,1,2,2,0,2,0,1,0,0,2,12,7,24750,10026,1979,15879,0
467,10219,1454,835,1044,76,110,219,1530,17,275,158,296,292,454,2297,3718,9,34017,1889,1,2,12,7,24760,10027,1979,15880,0
66,2718,1289,550,1043,56,32,155,1345,10,167,93,185,177,278,1266,2075,5,11498,638,0,2,17,0,24760,10029,1980,15881,0
174,4018,722,423,573,19,0,135,741,12,172,101,199,184,300,1320,2257,6,15668,870,0,2,11,2,24760,10031,1980,15883,1
174,4018,1508,847,911,44,250,301,1552,14,148,88,169,162,257,1120,1886,7,15077,837,0,2,11,2,24760,10032,1981,15884,1
16,635,722,423,573,19,0,135,741,12,172,101,199,184,300,1320,2257,6,15668,870,0,2,11,0,24760,10034,1981,15886,1
172,3989,722,423,573,19,0,135,741,12,172,101,199,184,300,1320,2257,6,15668,870,0,2,2,4,24770,10040,1982,15895,0
172,3989,1508,847,911,44,250,301,1552,14,148,88,169,162,257,1120,1886,7,15077,837,0,2,2,4,24770,10041,1983,15896,0
467,10219,72,33,56,0,4,12,72,1,1,1,1,2,2,0,2,0,1,0,0,2,2,1,24770,10041,1983,15897,0
467,10219,1454,835,1044,76,110,219,1530,17,275,158,296,292,454,2297,3718,9,34017,1889,1,2,2,1,24780,10042,1983,15898,0
20,615,42,7,35,4,0,5,46,1,2,1,2,3,3,2,4,0,2,0,0,2,5,5,24780,10042,1983,15899,0
20,615,11,6,10,0,0,1,11,2,4,2,4,6,6,10,15,1,15,0,0,2,5,5,24780,10042,1983,15900,0
65,3083,1338,495,1086,10,64,173,1348,11,122,82,157,133,239,883,1686,7,11934,663,0,2,20,0,24780,10044,1983,15901,0
31,888,465,148,393,5,8,60,470,4,31,20,31,35,51,161,261,2,523,29,0,2,2,2,24780,10045,1983,15902,0
31,888,16,12,9,0,0,6,16,1,2,1,2,3,3,2,4,0,2,0,0,2,2,2,24780,10045,1983,15903,0
173,4006,722,423,573,19,0,135,741,12,172,101,199,184,300,1320,2257,6,15668,870,0,2,11,2,24780,10047,1983,15905,0
173,4006,1508,847,911,44,250,301,1552,14,148,88,169,162,257,1120,1886,7,15077,837,0,2,11,2,24780,10048,1984,15906,0
16,635,722,423,573,19,0,135,741,12,172,101,199,184,300,1320,2257,6,15668,870,0,2,11,0,24780,10050,1984,15908,0
287,5589,1457,730,1242,11,6,188,1468,10,292,166,329,302,495,2424,4078,5,22973,1276,1,2,113,2,24780,10052,1984,15909,1
287,5589,74,35,59,1,0,14,75,3,14,7,14,17,21,58,85,1,128,7,0,2,113,2,24780,10053,1984,15910,1
287,5589,245,125,200,5,7,34,250,7,30,17,34,37,51,166,265,3,1053,58,0,2,113,2,24790,10054,1984,15911,1
46,449,647,139,84,35,284,233,682,0,0,0,0,0,0,0,0,0,0,0,0,2,1,1,24790,10054,1984,15912,1
172,3925,77,34,69,0,0,8,77,3,24,16,29,27,45,114,213,1,387,21,0,2,1,1,24790,10054,1984,15913,1
172,3925,712,438,573,51,9,84,763,14,102,71,128,116,199,733,1364,8,11988,666,0,2,1,1,24800,10055,1984,15914,1
16,631,722,423,573,19,0,135,741,12,172,101,199,184,300,1320,2257,6,15668,870,0,2,3,3,24800,10057,1984,15916,1
62,2690,1943,715,1694,26,18,214,1969,12,185,120,237,197,357,1436,2721,7,20915,1161,0,2,3,1,24800,10059,1984,15917,1
172,3933,77,34,69,0,0,8,77,3,24,16,29,27,45,114,213,1,387,21,0,2,3,1,24800,10059,1984,15918,0
172,3933,712,438,573,51,9,84,763,14,102,71,128,116,199,733,1364,8,11988,666,0,2,3,1,24810,10060,1984,15919,0
292,5675,1457,730,1242,11,6,188,1468,10,292,166,329,302,495,2424,4078,5,22973,1276,1,2,15,1,24810,10062,1984,15920,1
292,5675,74,35,59,1,0,14,75,3,14,7,14,17,21,58,85,1,128,7,0,2,15,1,24810,10063,1984,15921,1
292,5675,245,125,200,5,7,34,250,7,30,17,34,37,51,166,265,3,1053,58,0,2,15,1,24820,10064,1984,15922,1
291,5664,1457,730,1242,11,6,188,1468,10,292,166,329,302,495,2424,4078,5,22973,1276,1,2,1,4,24820,10066,1984,15923,1
291,5664,74,35,59,1,0,14,75,3,14,7,14,17,21,58,85,1,128,7,0,2,1,4,24820,10067,1984,15924,1
291,5664,245,125,200,5,7,34,250,7,30,17,34,37,51,166,265,3,1053,58,0,2,1,4,24830,10068,1984,15925,1
290,5645,1457,730,1242,11,6,188,1468,10,292,166,329,302,495,2424,4078,5,22973,1276,1,2,0,2,24830,10070,1984,15926,0
290,5645,74,35,59,1,0,14,75,3,14,7,14,17,21,58,85,1,128,7,0,2,0,2,24830,10071,1984,15927,0
290,5645,245,125,200,5,7,34,250,7,30,17,34,37,51,166,265,3,1053,58,0,2,0,2,24840,10072,1984,15928,0
16,631,722,423,573,19,0,135,741,12,172,101,199,184,300,1320,2257,6,15668,870,0,2,1,1,24840,10074,1984,15930,0
12,404,386,256,301,16,9,68,402,4,59,35,69,63,104,355,621,2,1453,80,0,2,0,1,24840,10074,1984,15931,0
36,1381,1098,241,925,5,10,155,1103,7,46,25,49,53,74,273,423,3,1580,87,0,2,0,2,24850,10076,1984,15932,0
287,5589,1457,730,1242,11,6,188,1468,10,292,166,329,302,495,2424,4078,5,22973,1276,1,2,92,98,24850,10078,1984,15933,1
287,5589,74,35,59,1,0,14,75,3,14,7,14,17,21,58,85,1,128,7,0,2,92,98,24850,10079,1984,15934,1
287,5589,245,125,200,5,7,34,250,7,30,17,34,37,51,166,265,3,1053,58,0,2,92,98,24860,10080,1984,15935,1
31,1022,1455,414,1257,16,76,112,1471,5,41,23,46,46,69,231,381,2,1069,59,0,2,1,1,24860,10081,1984,15936,1
31,1022,669,365,481,22,61,110,691,15,103,63,122,118,185,747,1273,8,11311,628,0,2,1,1,24870,10081,1985,15937,1
136,6025,139,89,101,2,0,35,141,7,54,34,62,61,96,330,569,4,2287,127,0,2,1,1,24870,10081,1985,15938,1
136,6025,7,5,5,0,0,2,7,1,2,1,2,3,3,2,4,0,2,0,0,2,1,1,24870,10081,1985,15939,1
29,1861,652,304,544,16,6,88,668,6,89,51,101,95,152,591,998,3,3399,188,0,2,32,43,24870,10082,1985,15940,1
289,5621,1457,730,1242,11,6,188,1468,10,292,166,329,302,495,2424,4078,5,22973,1276,1,2,6,1,24870,10084,1985,15941,0
289,5621,74,35,59,1,0,14,75,3,14,7,14,17,21,58,85,1,128,7,0,2,6,1,24870,10085,1985,15942,0
289,5621,245,125,200,5,7,34,250,7,30,17,34,37,51,166,265,3,1053,58,0,2,6,1,24880,10086,1985,15943,0
33,664,2,2,2,0,0,0,2,0,0,0,0,0,0,0,0,0,0,0,0,2,5,6,24880,10086,1985,15943,1
33,664,99,48,90,1,3,5,100,0,0,0,0,0,0,0,0,0,0,0,0,2,5,6,24880,10087,1985,15944,1
33,664,8,5,5,2,0,1,10,0,0,0,0,0,0,0,0,0,0,0,0,2,5,6,24880,10087,1985,15945,1
33,664,1217,716,841,84,126,174,1301,14,185,118,215,199,333,1446,2542,8,20687,1149,0,2,5,6,24890,10089,1985,15946,1
33,664,160,89,115,0,13,31,160,7,15,11,17,22,28,78,124,3,495,27,0,2,5,6,24890,10089,1985,15947,1
33,664,10,10,9,9,0,0,19,0,0,0,0,0,0,0,0,0,0,0,0,2,5,6,24890,10089,1986,15948,1
33,664,173,84,99,8,29,36,181,5,12,7,13,17,20,54,81,2,221,12,0,2,5,6,24890,10090,1986,15949,1
33,664,3,1,1,3,0,0,6,0,0,0,0,0,0,0,0,0,0,0,0,2,5,6,24890,10090,1986,15950,1
111,2245,1513,682,1277,25,13,200,1538,11,199,116,219,210,335,1557,2584,6,15641,868,0,2,2,2,24890,10092,1986,15951,1
111,2245,819,519,539,24,98,155,843,15,96,57,106,111,163,690,1107,8,9171,509,0,2,2,2,24900,10094,1986,15952,1
289,5615,1457,730,1242,11,6,188,1468,10,292,166,329,302,495,2424,4078,5,22973,1276,1,2,19,20,24900,10096,1986,15953,1
289,5615,74,35,59,1,0,14,75,3,14,7,14,17,21,58,85,1,128,7,0,2,19,20,24900,10097,1986,15954,1
289,5615,245,125,200,5,7,34,250,7,30,17,34,37,51,166,265,3,1053,58,0,2,19,20,24910,10098,1986,15955,1
23,732,74,35,59,1,0,14,75,3,14,7,14,17,21,58,85,1,128,7,0,2,11,15,24910,10099,1986,15956,1
23,732,245,125,200,5,7,34,250,7,30,17,34,37,51,166,265,3,1053,58,0,2,11,15,24920,10100,1986,15957,1
171,3921,77,34,69,0,0,8,77,3,24,16,29,27,45,114,213,1,387,21,0,2,2,4,24920,10100,1986,15958,1
171,3921,712,438,573,51,9,84,763,14,102,71,128,116,199,733,1364,8,11988,666,0,2,2,4,24930,10101,1986,15959,1
68,1230,1020,354,843,12,15,144,1032,8,134,77,144,142,221,970,1580,4,6792,377,0,2,2,2,24930,10101,1986,15960,1
171,3970,722,423,573,19,0,135,741,12,172,101,199,184,300,1320,2257,6,15668,870,0,2,5,9,24930,10103,1986,15962,1
171,3970,1508,847,911,44,250,301,1552,14,148,88,169,162,257,1120,1886,7,15077,837,0,2,5,9,24930,10104,1987,15963,1
38,711,127,75,83,2,11,30,129,4,14,7,14,18,21,61,87,2,175,9,0,2,1,0,24930,10104,1987,15964,1
38,711,652,304,544,16,6,88,668,6,89,51,101,95,152,591,998,3,3399,188,0,2,1,0,24930,10105,1987,15965,1
38,711,2,2,2,0,0,0,2,0,0,0,0,0,0,0,0,0,0,0,0,2,1,0,24930,10105,1987,15965,1
38,711,8,5,5,0,0,3,8,0,0,0,0,0,0,0,0,0,0,0,0,2,1,0,24930,10105,1987,15966,1
38,711,2,2,2,0,0,0,2,0,0,0,0,0,0,0,0,0,0,0,0,2,1,0,24930,10105,1987,15966,1
38,711,14,8,8,0,0,6,14,0,0,0,0,0,0,0,0,0,0,0,0,2,1,0,24930,10105,1987,15967,1
38,711,6,4,4,0,0,2,6,0,0,0,0,0,0,0,0,0,0,0,0,2,1,0,24930,10105,1987,15968,1
38,711,6,4,4,0,0,2,6,1,2,1,2,3,3,2,4,0,2,0,0,2,1,0,24930,10105,1987,15969,1
38,711,6,4,4,0,0,2,6,0,0,0,0,0,0,0,0,0,0,0,0,2,1,0,24930,10105,1987,15970,1
38,711,7,5,5,0,0,2,7,0,0,0,0,0,0,0,0,0,0,0,0,2,1,0,24930,10105,1987,15971,1
38,711,6,4,4,0,0,2,6,0,0,0,0,0,0,0,0,0,0,0,0,2,1,0,24930,10105,1987,15972,1
38,711,10,6,6,0,0,4,10,0,0,0,0,0,0,0,0,0,0,0,0,2,1,0,24930,10105,1987,15973,1
38,711,1,1,1,0,0,0,1,0,0,0,0,0,0,0,0,0,0,0,0,2,1,0,24930,10105,1987,15973,1
38,711,14,10,10,0,0,4,14,1,1,1,1,2,2,0,2,0,1,0,0,2,1,0,24930,10105,1987,15974,1
38,711,46,26,30,3,0,12,49,3,6,3,6,9,9,20,28,1,42,2,0,2,1,0,24940,10105,1987,15975,1
24,966,373,158,315,8,0,51,381,5,76,44,79,81,123,486,779,2,2026,112,0,2,2,2,24940,10105,1987,15976,1
176,4013,722,423,573,19,0,135,741,12,172,101,199,184,300,1320,2257,6,15668,870,0,2,13,0,24940,10107,1987,15978,1
176,4013,1508,847,911,44,250,301,1552,14,148,88,169,162,257,1120,1886,7,15077,837,0,2,13,0,24940,10108,1988,15979,1
176,4018,722,423,573,19,0,135,741,12,172,101,199,184,300,1320,2257,6,15668,870,0,2,6,1,24940,10110,1988,15981,1
176,4018,1508,847,911,44,250,301,1552,14,148,88,169,162,257,1120,1886,7,15077,837,0,2,6,1,24940,10111,1989,15982,1
176,4018,722,423,573,19,0,135,741,12,172,101,199,184,300,1320,2257,6,15668,870,0,2,18,0,24940,10113,1989,15984,0
176,4018,1508,847,911,44,250,301,1552,14,148,88,169,162,257,1120,1886,7,15077,837,0,2,18,0,24940,10114,1990,15985,0
176,4066,722,423,573,19,0,135,741,12,172,101,199,184,300,1320,2257,6,15668,870,0,2,18,0,24940,10116,1990,15987,0
176,4066,1508,847,911,44,250,301,1552,14,148,88,169,162,257,1120,1886,7,15077,837,0,2,18,0,24940,10117,1991,15988,0
174,4030,722,423,573,19,0,135,741,12,172,101,199,184,300,1320,2257,6,15668,870,0,2,18,0,24940,10119,1991,15990,0
174,4030,1508,847,911,44,250,301,1552,14,148,88,169,162,257,1120,1886,7,15077,837,0,2,18,0,24940,10120,1992,15991,0
285,5557,1457,730,1242,11,6,188,1468,10,292,166,329,302,495,2424,4078,5,22973,1276,1,2,14,20,24940,10122,1992,15992,0
285,5557,74,35,59,1,0,14,75,3,14,7,14,17,21,58,85,1,128,7,0,2,14,20,24940,10123,1992,15993,0
285,5557,245,125,200,5,7,34,250,7,30,17,34,37,51,166,265,3,1053,58,0,2,14,20,24950,10124,1992,15994,0
283,5525,1457,730,1242,11,6,188,1468,10,292,166,329,302,495,2424,4078,5,22973,1276,1,2,11,15,24950,10126,1992,15995,1
283,5525,74,35,59,1,0,14,75,3,14,7,14,17,21,58,85,1,128,7,0,2,11,15,24950,10127,1992,15996,1
283,5525,245,125,200,5,7,34,250,7,30,17,34,37,51,166,265,3,1053,58,0,2,11,15,24960,10128,1992,15997,1
33,664,2,2,2,0,0,0,2,0,0,0,0,0,0,0,0,0,0,0,0,2,5,6,24960,10128,1992,15997,0
33,664,99,48,90,1,3,5,100,0,0,0,0,0,0,0,0,0,0,0,0,2,5,6,24960,10129,1992,15998,0
33,664,8,5,5,2,0,1,10,0,0,0,0,0,0,0,0,0,0,0,0,2,5,6,24960,10129,1992,15999,0
33,664,1217,716,841,84,126,174,1301,14,185,118,215,199,333,1446,2542,8,20687,1149,0,2,5,6,24970,10131,1992,16000,0
33,664,160,89,115,0,13,31,160,7,15,11,17,22,28,78,124,3,495,27,0,2,5,6,24970,10131,1992,16001,0
33,664,10,10,9,9,0,0,19,0,0,0,0,0,0,0,0,0,0,0,0,2,5,6,24970,10131,1993,16002,0
33,664,173,84,99,8,29,36,181,5,12,7,13,17,20,54,81,2,221,12,0,2,5,6,24970,10132,1993,16003,0
33,664,3,1,1,3,0,0,6,0,0,0,0,0,0,0,0,0,0,0,0,2,5,6,24970,10132,1993,16004,0
111,2245,1513,682,1277,25,13,200,1538,11,199,116,219,210,335,1557,2584,6,15641,868,0,2,2,2,24970,10134,1993,16005,0
111,2245,819,519,539,24,98,155,843,15,96,57,106,111,163,690,1107,8,9171,509,0,2,2,2,24980,10136,1993,16006,0
283,5525,1457,730,1242,11,6,188,1468,10,292,166,329,302,495,2424,4078,5,22973,1276,1,2,230,122,24980,10138,1993,16007,0
283,5525,74,35,59,1,0,14,75,3,14,7,14,17,21,58,85,1,128,7,0,2,230,122,24980,10139,1993,16008,0
283,5525,245,125,200,5,7,34,250,7,30,17,34,37,51,166,265,3,1053,58,0,2,230,122,24990,10140,1993,16009,0
31,1022,1455,414,1257,16,76,112,1471,5,41,23,46,46,69,231,381,2,1069,59,0,2,1,1,24990,10141,1993,16010,0
31,1022,669,365,481,22,61,110,691,15,103,63,122,118,185,747,1273,8,11311,628,0,2,1,1,25000,10141,1994,16011,0
23,732,74,35,59,1,0,14,75,3,14,7,14,17,21,58,85,1,128,7,0,2,11,15,25000,10142,1994,16012,0
23,732,245,125,200,5,7,34,250,7,30,17,34,37,51,166,265,3,1053,58,0,2,11,15,25010,10143,1994,16013,0
46,449,647,139,84,35,284,233,682,0,0,0,0,0,0,0,0,0,0,0,0,2,1,1,25010,10143,1994,16014,0
171,3921,77,34,69,0,0,8,77,3,24,16,29,27,45,114,213,1,387,21,0,2,6,6,25010,10143,1994,16015,0
171,3921,712,438,573,51,9,84,763,14,102,71,128,116,199,733,1364,8,11988,666,0,2,6,6,25020,10144,1994,16016,0
68,1230,1020,354,843,12,15,144,1032,8,134,77,144,142,221,970,1580,4,6792,377,0,2,2,2,25020,10144,1994,16017,0
174,4030,722,423,573,19,0,135,741,12,172,101,199,184,300,1320,2257,6,15668,870,0,2,5,9,25020,10146,1994,16019,0
174,4030,1508,847,911,44,250,301,1552,14,148,88,169,162,257,1120,1886,7,15077,837,0,2,5,9,25020,10147,1995,16020,0
38,711,127,75,83,2,11,30,129,4,14,7,14,18,21,61,87,2,175,9,0,2,1,0,25020,10147,1995,16021,0
38,711,652,304,544,16,6,88,668,6,89,51,101,95,152,591,998,3,3399,188,0,2,1,0,25020,10148,1995,16022,0
38,711,2,2,2,0,0,0,2,0,0,0,0,0,0,0,0,0,0,0,0,2,1,0,25020,10148,1995,16022,0
38,711,8,5,5,0,0,3,8,0,0,0,0,0,0,0,0,0,0,0,0,2,1,0,25020,10148,1995,16023,0
38,711,2,2,2,0,0,0,2,0,0,0,0,0,0,0,0,0,0,0,0,2,1,0,25020,10148,1995,16023,0
38,711,14,8,8,0,0,6,14,0,0,0,0,0,0,0,0,0,0,0,0,2,1,0,25020,10148,1995,16024,0
38,711,6,4,4,0,0,2,6,0,0,0,0,0,0,0,0,0,0,0,0,2,1,0,25020,10148,1995,16025,0
38,711,6,4,4,0,0,2,6,1,2,1,2,3,3,2,4,0,2,0,0,2,1,0,25020,10148,1995,16026,0
38,711,6,4,4,0,0,2,6,0,0,0,0,0,0,0,0,0,0,0,0,2,1,0,25020,10148,1995,16027,0
38,711,7,5,5,0,0,2,7,0,0,0,0,0,0,0,0,0,0,0,0,2,1,0,25020,10148,1995,16028,0
38,711,6,4,4,0,0,2,6,0,0,0,0,0,0,0,0,0,0,0,0,2,1,0,25020,10148,1995,16029,0
38,711,10,6,6,0,0,4,10,0,0,0,0,0,0,0,0,0,0,0,0,2,1,0,25020,10148,1995,16030,0
38,711,1,1,1,0,0,0,1,0,0,0,0,0,0,0,0,0,0,0,0,2,1,0,25020,10148,1995,16030,0
38,711,14,10,10,0,0,4,14,1,1,1,1,2,2,0,2,0,1,0,0,2,1,0,25020,10148,1995,16031,0
38,711,46,26,30,3,0,12,49,3,6,3,6,9,9,20,28,1,42,2,0,2,1,0,25030,10148,1995,16032,0
136,6025,139,89,101,2,0,35,141,7,54,34,62,61,96,330,569,4,2287,127,0,2,1,1,25030,10148,1995,16033,0
136,6025,7,5,5,0,0,2,7,1,2,1,2,3,3,2,4,0,2,0,0,2,1,1,25030,10148,1995,16034,0
29,1861,652,304,544,16,6,88,668,6,89,51,101,95,152,591,998,3,3399,188,0,2,32,43,25030,10149,1995,16035,0
16,631,722,423,573,19,0,135,741,12,172,101,199,184,300,1320,2257,6,15668,870,0,2,4,4,25030,10151,1995,16037,0
12,404,386,256,301,16,9,68,402,4,59,35,69,63,104,355,621,2,1453,80,0,2,0,1,25030,10151,1995,16038,0
24,966,373,158,315,8,0,51,381,5,76,44,79,81,123,486,779,2,2026,112,0,2,2,2,25030,10151,1995,16039,0
62,2690,1943,715,1694,26,18,214,1969,12,185,120,237,197,357,1436,2721,7,20915,1161,0,2,3,1,25030,10153,1995,16040,0
36,1381,1098,241,925,5,10,155,1103,7,46,25,49,53,74,273,423,3,1580,87,0,2,0,2,25040,10155,1995,16041,0
283,5532,1457,730,1242,11,6,188,1468,10,292,166,329,302,495,2424,4078,5,22973,1276,1,2,1,0,25040,10157,1995,16042,1
283,5532,74,35,59,1,0,14,75,3,14,7,14,17,21,58,85,1,128,7,0,2,1,0,25040,10158,1995,16043,1
283,5532,245,125,200,5,7,34,250,7,30,17,34,37,51,166,265,3,1053,58,0,2,1,0,25050,10159,1995,16044,1
47,2308,1457,730,1242,11,6,188,1468,10,292,166,329,302,495,2424,4078,5,22973,1276,1,2,2,1,25050,10161,1995,16045,0
282,5509,1457,730,1242,11,6,188,1468,10,292,166,329,302,495,2424,4078,5,22973,1276,1,2,6,10,25050,10163,1995,16046,0
282,5509,74,35,59,1,0,14,75,3,14,7,14,17,21,58,85,1,128,7,0,2,6,10,25050,10164,1995,16047,0
282,5509,245,125,200,5,7,34,250,7,30,17,34,37,51,166,265,3,1053,58,0,2,6,10,25060,10165,1995,16048,0
111,2266,1513,682,1277,25,13,200,1538,11,199,116,219,210,335,1557,2584,6,15641,868,0,2,7,7,25060,10167,1995,16049,0
111,2266,819,519,539,24,98,155,843,15,96,57,106,111,163,690,1107,8,9171,509,0,2,7,7,25070,10169,1995,16050,0
23,735,74,35,59,1,0,14,75,3,14,7,14,17,21,58,85,1,128,7,0,2,1,1,25070,10170,1995,16051,0
23,735,245,125,200,5,7,34,250,7,30,17,34,37,51,166,265,3,1053,58,0,2,1,1,25080,10171,1995,16052,0
46,483,647,139,84,35,284,233,682,0,0,0,0,0,0,0,0,0,0,0,0,2,16,14,25080,10171,1995,16053,0
171,3927,77,34,69,0,0,8,77,3,24,16,29,27,45,114,213,1,387,21,0,2,2,2,25080,10171,1995,16054,0
171,3927,712,438,573,51,9,84,763,14,102,71,128,116,199,733,1364,8,11988,666,0,2,2,2,25090,10172,1995,16055,0
23,374,424,94,331,4,0,89,428,1,5,5,5,6,10,11,25,0,12,0,0,2,1,1,25090,10173,1995,16056,0
23,374,38,23,23,6,0,8,44,3,11,7,11,14,18,42,68,1,102,5,0,2,1,1,25090,10173,1995,16057,0
16,477,184,100,137,2,15,30,186,6,38,20,39,44,59,214,322,3,991,55,0,2,1,1,25090,10174,1995,16058,0
16,477,103,65,74,8,5,16,111,7,17,9,17,24,26,89,119,3,417,23,0,2,1,1,25090,10175,1995,16059,0
467,10231,72,33,56,0,4,12,72,1,1,1,1,2,2,0,2,0,1,0,0,2,4,4,25090,10175,1995,16060,0
467,10231,1454,835,1044,76,110,219,1530,17,275,158,296,292,454,2297,3718,9,34017,1889,1,2,4,4,25100,10176,1995,16061,0
83,1510,1178,367,1042,6,15,115,1184,9,94,51,95,103,146,644,976,4,4439,246,0,2,2,2,25100,10176,1995,16062,0
83,1510,177,108,140,8,0,27,185,6,30,16,32,36,48,162,248,3,794,44,0,2,2,2,25100,10178,1995,16063,0
168,3521,1943,715,1694,26,18,214,1969,12,185,120,237,197,357,1436,2721,7,20915,1161,0,2,2,2,25100,10180,1995,16064,0
168,3521,1168,838,957,57,25,144,1225,19,348,224,416,367,640,3018,5452,11,61921,3440,1,2,2,2,25110,10182,1995,16065,0
51,1018,1098,241,925,5,10,155,1103,7,46,25,49,53,74,273,423,3,1580,87,0,2,2,2,25120,10184,1995,16066,0
51,1018,282,202,222,14,2,44,296,8,42,24,43,50,67,250,378,4,1548,86,0,2,2,2,25120,10185,1995,16067,0
38,714,127,75,83,2,11,30,129,4,14,7,14,18,21,61,87,2,175,9,0,2,1,1,25120,10185,1995,16068,0
38,714,652,304,544,16,6,88,668,6,89,51,101,95,152,591,998,3,3399,188,0,2,1,1,25120,10186,1995,16069,0
38,714,2,2,2,0,0,0,2,0,0,0,0,0,0,0,0,0,0,0,0,2,1,1,25120,10186,1995,16069,0
38,714,8,5,5,0,0,3,8,0,0,0,0,0,0,0,0,0,0,0,0,2,1,1,25120,10186,1995,16070,0
38,714,2,2,2,0,0,0,2,0,0,0,0,0,0,0,0,0,0,0,0,2,1,1,25120,10186,1995,16070,0
38,714,14,8,8,0,0,6,14,0,0,0,0,0,0,0,0,0,0,0,0,2,1,1,25120,10186,1995,16071,0
38,714,6,4,4,0,0,2,6,0,0,0,0,0,0,0,0,0,0,0,0,2,1,1,25120,10186,1995,16072,0
38,714,6,4,4,0,0,2,6,1,2,1,2,3,3,2,4,0,2,0,0,2,1,1,25120,10186,1995,16073,0
38,714,6,4,4,0,0,2,6,0,0,0,0,0,0,0,0,0,0,0,0,2,1,1,25120,10186,1995,16074,0
38,714,7,5,5,0,0,2,7,0,0,0,0,0,0,0,0,0,0,0,0,2,1,1,25120,10186,1995,16075,0
38,714,6,4,4,0,0,2,6,0,0,0,0,0,0,0,0,0,0,0,0,2,1,1,25120,10186,1995,16076,0
38,714,10,6,6,0,0,4,10,0,0,0,0,0,0,0,0,0,0,0,0,2,1,1,25120,10186,1995,16077,0
38,714,1,1,1,0,0,0,1,0,0,0,0,0,0,0,0,0,0,0,0,2,1,1,25120,10186,1995,16077,0
38,714,14,10,10,0,0,4,14,1,1,1,1,2,2,0,2,0,1,0,0,2,1,1,25120,10186,1995,16078,0
38,714,46,26,30,3,0,12,49,3,6,3,6,9,9,20,28,1,42,2,0,2,1,1,25130,10186,1995,16079,0
65,3083,1338,495,1086,10,64,173,1348,11,122,82,157,133,239,883,1686,7,11934,663,0,2,1,1,25130,10188,1995,16080,0
8,257,74,35,59,1,0,14,75,3,14,7,14,17,21,58,85,1,128,7,0,2,1,1,25130,10189,1995,16081,0
55,2363,1020,354,843,12,15,144,1032,8,134,77,144,142,221,970,1580,4,6792,377,0,2,1,1,25130,10189,1995,16082,0
278,5480,1457,730,1242,11,6,188,1468,10,292,166,329,302,495,2424,4078,5,22973,1276,1,2,8,14,25130,10191,1995,16083,1
278,5480,74,35,59,1,0,14,75,3,14,7,14,17,21,58,85,1,128,7,0,2,8,14,25130,10192,1995,16084,1
278,5480,245,125,200,5,7,34,250,7,30,17,34,37,51,166,265,3,1053,58,0,2,8,14,25140,10193,1995,16085,1
46,511,647,139,84,35,284,233,682,0,0,0,0,0,0,0,0,0,0,0,0,2,36,23,25140,10193,1995,16086,1
468,10250,72,33,56,0,4,12,72,1,1,1,1,2,2,0,2,0,1,0,0,2,7,5,25140,10193,1995,16087,1
468,10250,1454,835,1044,76,110,219,1530,17,275,158,296,292,454,2297,3718,9,34017,1889,1,2,7,5,25150,10194,1995,16088,1
47,2308,1457,730,1242,11,6,188,1468,10,292,166,329,302,495,2424,4078,5,22973,1276,1,2,1,1,25150,10196,1995,16089,1
278,5491,1457,730,1242,11,6,188,1468,10,292,166,329,302,495,2424,4078,5,22973,1276,1,2,7,6,25150,10198,1995,16090,1
278,5491,74,35,59,1,0,14,75,3,14,7,14,17,21,58,85,1,128,7,0,2,7,6,25150,10199,1995,16091,1
278,5491,245,125,200,5,7,34,250,7,30,17,34,37,51,166,265,3,1053,58,0,2,7,6,25160,10200,1995,16092,1
46,518,647,139,84,35,284,233,682,0,0,0,0,0,0,0,0,0,0,0,0,2,5,3,25160,10200,1995,16093,1
465,10193,72,33,56,0,4,12,72,1,1,1,1,2,2,0,2,0,1,0,0,2,2,13,25160,10200,1995,16094,1
465,10193,1454,835,1044,76,110,219,1530,17,275,158,296,292,454,2297,3718,9,34017,1889,1,2,2,13,25170,10201,1995,16095,1
278,5472,1457,730,1242,11,6,188,1468,10,292,166,329,302,495,2424,4078,5,22973,1276,1,2,7,8,25170,10203,1995,16096,1
278,5472,74,35,59,1,0,14,75,3,14,7,14,17,21,58,85,1,128,7,0,2,7,8,25170,10204,1995,16097,1
278,5472,245,125,200,5,7,34,250,7,30,17,34,37,51,166,265,3,1053,58,0,2,7,8,25180,10205,1995,16098,1
47,2310,1457,730,1242,11,6,188,1468,10,292,166,329,302,495,2424,4078,5,22973,1276,1,2,2,2,25180,10207,1995,16099,1
278,5481,1457,730,1242,11,6,188,1468,10,292,166,329,302,495,2424,4078,5,22973,1276,1,2,2,1,25180,10209,1995,16100,0
278,5481,74,35,59,1,0,14,75,3,14,7,14,17,21,58,85,1,128,7,0,2,2,1,25180,10210,1995,16101,0
278,5481,245,125,200,5,7,34,250,7,30,17,34,37,51,166,265,3,1053,58,0,2,2,1,25190,10211,1995,16102,0
23,749,74,35,59,1,0,14,75,3,14,7,14,17,21,58,85,1,128,7,0,2,3,1,25190,10212,1995,16103,0
23,749,245,125,200,5,7,34,250,7,30,17,34,37,51,166,265,3,1053,58,0,2,3,1,25200,10213,1995,16104,0
175,4049,722,423,573,19,0,135,741,12,172,101,199,184,300,1320,2257,6,15668,870,0,2,7,7,25200,10215,1995,16106,0
175,4049,1508,847,911,44,250,301,1552,14,148,88,169,162,257,1120,1886,7,15077,837,0,2,7,7,25200,10216,1996,16107,0
276,5455,1457,730,1242,11,6,188,1468,10,292,166,329,302,495,2424,4078,5,22973,1276,1,2,12,16,25200,10218,1996,16108,1
276,5455,74,35,59,1,0,14,75,3,14,7,14,17,21,58,85,1,128,7,0,2,12,16,25200,10219,1996,16109,1
276,5455,245,125,200,5,7,34,250,7,30,17,34,37,51,166,265,3,1053,58,0,2,12,16,25210,10220,1996,16110,1
175,4047,722,423,573,19,0,135,741,12,172,101,199,184,300,1320,2257,6,15668,870,0,2,1,1,25210,10222,1996,16112,1
175,4047,1508,847,911,44,250,301,1552,14,148,88,169,162,257,1120,1886,7,15077,837,0,2,1,1,25210,10223,1997,16113,1
47,2309,1457,730,1242,11,6,188,1468,10,292,166,329,302,495,2424,4078,5,22973,1276,1,2,1,1,25210,10225,1997,16114,1
62,2690,1943,715,1694,26,18,214,1969,12,185,120,237,197,357,1436,2721,7,20915,1161,0,2,1,1,25210,10227,1997,16115,1
276,5455,1457,730,1242,11,6,188,1468,10,292,166,329,302,495,2424,4078,5,22973,1276,1,2,2,0,25210,10229,1997,16116,0
276,5455,74,35,59,1,0,14,75,3,14,7,14,17,21,58,85,1,128,7,0,2,2,0,25210,10230,1997,16117,0
276,5455,245,125,200,5,7,34,250,7,30,17,34,37,51,166,265,3,1053,58,0,2,2,0,25220,10231,1997,16118,0
170,3910,77,34,69,0,0,8,77,3,24,16,29,27,45,114,213,1,387,21,0,2,0,3,25220,10231,1997,16119,0
170,3910,712,438,573,51,9,84,763,14,102,71,128,116,199,733,1364,8,11988,666,0,2,0,3,25230,10232,1997,16120,0
273,5403,1457,730,1242,11,6,188,1468,10,292,166,329,302,495,2424,4078,5,22973,1276,1,2,17,23,25230,10234,1997,16121,1
273,5403,74,35,59,1,0,14,75,3,14,7,14,17,21,58,85,1,128,7,0,2,17,23,25230,10235,1997,16122,1
273,5403,245,125,200,5,7,34,250,7,30,17,34,37,51,166,265,3,1053,58,0,2,17,23,25240,10236,1997,16123,1
171,3942,77,34,69,0,0,8,77,3,24,16,29,27,45,114,213,1,387,21,0,2,19,8,25240,10236,1997,16124,1
171,3942,712,438,573,51,9,84,763,14,102,71,128,116,199,733,1364,8,11988,666,0,2,19,8,25250,10237,1997,16125,1
273,5395,1457,730,1242,11,6,188,1468,10,292,166,329,302,495,2424,4078,5,22973,1276,1,2,2,3,25250,10239,1997,16126,1
273,5395,74,35,59,1,0,14,75,3,14,7,14,17,21,58,85,1,128,7,0,2,2,3,25250,10240,1997,16127,1
273,5395,245,125,200,5,7,34,250,7,30,17,34,37,51,166,265,3,1053,58,0,2,2,3,25260,10241,1997,16128,1
267,5292,1457,730,1242,11,6,188,1468,10,292,166,329,302,495,2424,4078,5,22973,1276,1,2,5,26,25260,10243,1997,16129,0
267,5292,74,35,59,1,0,14,75,3,14,7,14,17,21,58,85,1,128,7,0,2,5,26,25260,10244,1997,16130,0
267,5292,245,125,200,5,7,34,250,7,30,17,34,37,51,166,265,3,1053,58,0,2,5,26,25270,10245,1997,16131,0
267,5310,1457,730,1242,11,6,188,1468,10,292,166,329,302,495,2424,4078,5,22973,1276,1,2,8,0,25270,10247,1997,16132,1
267,5310,74,35,59,1,0,14,75,3,14,7,14,17,21,58,85,1,128,7,0,2,8,0,25270,10248,1997,16133,1
267,5310,245,125,200,5,7,34,250,7,30,17,34,37,51,166,265,3,1053,58,0,2,8,0,25280,10249,1997,16134,1
270,5415,1457,730,1242,11,6,188,1468,10,292,166,329,302,495,2424,4078,5,22973,1276,1,2,19,4,25280,10251,1997,16135,1
270,5415,74,35,59,1,0,14,75,3,14,7,14,17,21,58,85,1,128,7,0,2,19,4,25280,10252,1997,16136,1
270,5415,245,125,200,5,7,34,250,7,30,17,34,37,51,166,265,3,1053,58,0,2,19,4,25290,10253,1997,16137,1
169,3534,1943,715,1694,26,18,214,1969,12,185,120,237,197,357,1436,2721,7,20915,1161,0,2,2,0,25290,10255,1997,16138,1
169,3534,1168,838,957,57,25,144,1225,19,348,224,416,367,640,3018,5452,11,61921,3440,1,2,2,0,25300,10257,1997,16139,1
38,708,127,75,83,2,11,30,129,4,14,7,14,18,21,61,87,2,175,9,0,2,3,4,25300,10257,1997,16140,1
38,708,652,304,544,16,6,88,668,6,89,51,101,95,152,591,998,3,3399,188,0,2,3,4,25300,10258,1997,16141,1
38,708,2,2,2,0,0,0,2,0,0,0,0,0,0,0,0,0,0,0,0,2,3,4,25300,10258,1997,16141,1
38,708,8,5,5,0,0,3,8,0,0,0,0,0,0,0,0,0,0,0,0,2,3,4,25300,10258,1997,16142,1
38,708,2,2,2,0,0,0,2,0,0,0,0,0,0,0,0,0,0,0,0,2,3,4,25300,10258,1997,16142,1
38,708,14,8,8,0,0,6,14,0,0,0,0,0,0,0,0,0,0,0,0,2,3,4,25300,10258,1997,16143,1
38,708,6,4,4,0,0,2,6,0,0,0,0,0,0,0,0,0,0,0,0,2,3,4,25300,10258,1997,16144,1
38,708,6,4,4,0,0,2,6,1,2,1,2,3,3,2,4,0,2,0,0,2,3,4,25300,10258,1997,16145,1
38,708,6,4,4,0,0,2,6,0,0,0,0,0,0,0,0,0,0,0,0,2,3,4,25300,10258,1997,16146,1
38,708,7,5,5,0,0,2,7,0,0,0,0,0,0,0,0,0,0,0,0,2,3,4,25300,10258,1997,16147,1
38,708,6,4,4,0,0,2,6,0,0,0,0,0,0,0,0,0,0,0,0,2,3,4,25300,10258,1997,16148,1
38,708,10,6,6,0,0,4,10,0,0,0,0,0,0,0,0,0,0,0,0,2,3,4,25300,10258,1997,16149,1
38,708,1,1,1,0,0,0,1,0,0,0,0,0,0,0,0,0,0,0,0,2,3,4,25300,10258,1997,16149,1
38,708,14,10,10,0,0,4,14,1,1,1,1,2,2,0,2,0,1,0,0,2,3,4,25300,10258,1997,16150,1
38,708,46,26,30,3,0,12,49,3,6,3,6,9,9,20,28,1,42,2,0,2,3,4,25310,10258,1997,16151,1
271,5435,1457,730,1242,11,6,188,1468,10,292,166,329,302,495,2424,4078,5,22973,1276,1,2,4,1,25310,10260,1997,16152,0
271,5435,74,35,59,1,0,14,75,3,14,7,14,17,21,58,85,1,128,7,0,2,4,1,25310,10261,1997,16153,0
271,5435,245,125,200,5,7,34,250,7,30,17,34,37,51,166,265,3,1053,58,0,2,4,1,25320,10262,1997,16154,0
111,2266,1513,682,1277,25,13,200,1538,11,199,116,219,210,335,1557,2584,6,15641,868,0,2,7,7,25320,10264,1997,16155,0
111,2266,819,519,539,24,98,155,843,15,96,57,106,111,163,690,1107,8,9171,509,0,2,7,7,25330,10266,1997,16156,0
271,5435,1457,730,1242,11,6,188,1468,10,292,166,329,302,495,2424,4078,5,22973,1276,1,2,75,87,25330,10268,1997,16157,0
271,5435,74,35,59,1,0,14,75,3,14,7,14,17,21,58,85,1,128,7,0,2,75,87,25330,10269,1997,16158,0
271,5435,245,125,200,5,7,34,250,7,30,17,34,37,51,166,265,3,1053,58,0,2,75,87,25340,10270,1997,16159,0
23,749,74,35,59,1,0,14,75,3,14,7,14,17,21,58,85,1,128,7,0,2,4,2,25340,10271,1997,16160,0
23,749,245,125,200,5,7,34,250,7,30,17,34,37,51,166,265,3,1053,58,0,2,4,2,25350,10272,1997,16161,0
46,518,647,139,84,35,284,233,682,0,0,0,0,0,0,0,0,0,0,0,0,2,53,36,25350,10272,1997,16162,0
171,3942,77,34,69,0,0,8,77,3,24,16,29,27,45,114,213,1,387,21,0,2,21,13,25350,10272,1997,16163,0
171,3942,712,438,573,51,9,84,763,14,102,71,128,116,199,733,1364,8,11988,666,0,2,21,13,25360,10273,1997,16164,0
23,374,424,94,331,4,0,89,428,1,5,5,5,6,10,11,25,0,12,0,0,2,1,1,25360,10274,1997,16165,0
23,374,38,23,23,6,0,8,44,3,11,7,11,14,18,42,68,1,102,5,0,2,1,1,25360,10274,1997,16166,0
16,477,184,100,137,2,15,30,186,6,38,20,39,44,59,214,322,3,991,55,0,2,1,1,25360,10275,1997,16167,0
16,477,103,65,74,8,5,16,111,7,17,9,17,24,26,89,119,3,417,23,0,2,1,1,25360,10276,1997,16168,0
175,4047,722,423,573,19,0,135,741,12,172,101,199,184,300,1320,2257,6,15668,870,0,2,7,7,25360,10278,1997,16170,0
175,4047,1508,847,911,44,250,301,1552,14,148,88,169,162,257,1120,1886,7,15077,837,0,2,7,7,25360,10279,1998,16171,0
465,10193,72,33,56,0,4,12,72,1,1,1,1,2,2,0,2,0,1,0,0,2,11,20,25360,10279,1998,16172,0
465,10193,1454,835,1044,76,110,219,1530,17,275,158,296,292,454,2297,3718,9,34017,1889,1,2,11,20,25370,10280,1998,16173,0
83,1510,1178,367,1042,6,15,115,1184,9,94,51,95,103,146,644,976,4,4439,246,0,2,2,2,25370,10280,1998,16174,0
83,1510,177,108,140,8,0,27,185,6,30,16,32,36,48,162,248,3,794,44,0,2,2,2,25370,10282,1998,16175,0
169,3534,1943,715,1694,26,18,214,1969,12,185,120,237,197,357,1436,2721,7,20915,1161,0,2,4,2,25370,10284,1998,16176,0
169,3534,1168,838,957,57,25,144,1225,19,348,224,416,367,640,3018,5452,11,61921,3440,1,2,4,2,25380,10286,1998,16177,0
51,1018,1098,241,925,5,10,155,1103,7,46,25,49,53,74,273,423,3,1580,87,0,2,2,2,25390,10288,1998,16178,0
51,1018,282,202,222,14,2,44,296,8,42,24,43,50,67,250,378,4,1548,86,0,2,2,2,25390,10289,1998,16179,0
38,708,127,75,83,2,11,30,129,4,14,7,14,18,21,61,87,2,175,9,0,2,3,4,25390,10289,1998,16180,0
38,708,652,304,544,16,6,88,668,6,89,51,101,95,152,591,998,3,3399,188,0,2,3,4,25390,10290,1998,16181,0
38,708,2,2,2,0,0,0,2,0,0,0,0,0,0,0,0,0,0,0,0,2,3,4,25390,10290,1998,16181,0
38,708,8,5,5,0,0,3,8,0,0,0,0,0,0,0,0,0,0,0,0,2,3,4,25390,10290,1998,16182,0
38,708,2,2,2,0,0,0,2,0,0,0,0,0,0,0,0,0,0,0,0,2,3,4,25390,10290,1998,16182,0
38,708,14,8,8,0,0,6,14,0,0,0,0,0,0,0,0,0,0,0,0,2,3,4,25390,10290,1998,16183,0
38,708,6,4,4,0,0,2,6,0,0,0,0,0,0,0,0,0,0,0,0,2,3,4,25390,10290,1998,16184,0
38,708,6,4,4,0,0,2,6,1,2,1,2,3,3,2,4,0,2,0,0,2,3,4,25390,10290,1998,16185,0
38,708,6,4,4,0,0,2,6,0,0,0,0,0,0,0,0,0,0,0,0,2,3,4,25390,10290,1998,16186,0
38,708,7,5,5,0,0,2,7,0,0,0,0,0,0,0,0,0,0,0,0,2,3,4,25390,10290,1998,16187,0
38,708,6,4,4,0,0,2,6,0,0,0,0,0,0,0,0,0,0,0,0,2,3,4,25390,10290,1998,16188,0
38,708,10,6,6,0,0,4,10,0,0,0,0,0,0,0,0,0,0,0,0,2,3,4,25390,10290,1998,16189,0
38,708,1,1,1,0,0,0,1,0,0,0,0,0,0,0,0,0,0,0,0,2,3,4,25390,10290,1998,16189,0
38,708,14,10,10,0,0,4,14,1,1,1,1,2,2,0,2,0,1,0,0,2,3,4,25390,10290,1998,16190,0
38,708,46,26,30,3,0,12,49,3,6,3,6,9,9,20,28,1,42,2,0,2,3,4,25400,10290,1998,16191,0
65,3083,1338,495,1086,10,64,173,1348,11,122,82,157,133,239,883,1686,7,11934,663,0,2,1,1,25400,10292,1998,16192,0
47,2309,1457,730,1242,11,6,188,1468,10,292,166,329,302,495,2424,4078,5,22973,1276,1,2,5,4,25400,10294,1998,16193,0
8,257,74,35,59,1,0,14,75,3,14,7,14,17,21,58,85,1,128,7,0,2,1,1,25400,10295,1998,16194,0
55,2363,1020,354,843,12,15,144,1032,8,134,77,144,142,221,970,1580,4,6792,377,0,2,1,1,25400,10295,1998,16195,0
62,2690,1943,715,1694,26,18,214,1969,12,185,120,237,197,357,1436,2721,7,20915,1161,0,2,1,1,25400,10297,1998,16196,0
176,4105,722,423,573,19,0,135,741,12,172,101,199,184,300,1320,2257,6,15668,870,0,2,8,0,25400,10299,1998,16198,1
176,4105,1508,847,911,44,250,301,1552,14,148,88,169,162,257,1120,1886,7,15077,837,0,2,8,0,25400,10300,1999,16199,1
65,3083,1338,495,1086,10,64,173,1348,11,122,82,157,133,239,883,1686,7,11934,663,0,2,1,5,25400,10302,1999,16200,1
66,3580,1782,648,1425,9,47,279,1791,8,171,97,189,179,286,1292,2140,4,9462,525,0,2,1,3,25400,10303,2000,16201,1
47,2312,1457,730,1242,11,6,188,1468,10,292,166,329,302,495,2424,4078,5,22973,1276,1,2,4,7,25400,10305,2000,16202,1
17,526,424,94,331,4,0,89,428,1,5,5,5,6,10,11,25,0,12,0,0,2,1,3,25400,10306,2000,16203,1
62,2690,1943,715,1694,26,18,214,1969,12,185,120,237,197,357,1436,2721,7,20915,1161,0,2,1,1,25400,10308,2000,16204,1
176,4105,722,423,573,19,0,135,741,12,172,101,199,184,300,1320,2257,6,15668,870,0,2,8,0,25400,10310,2000,16206,0
176,4105,1508,847,911,44,250,301,1552,14,148,88,169,162,257,1120,1886,7,15077,837,0,2,8,0,25400,10311,2001,16207,0
65,3083,1338,495,1086,10,64,173,1348,11,122,82,157,133,239,883,1686,7,11934,663,0,2,1,5,25400,10313,2001,16208,0
66,3580,1782,648,1425,9,47,279,1791,8,171,97,189,179,286,1292,2140,4,9462,525,0,2,1,3,25400,10314,2002,16209,0
47,2312,1457,730,1242,11,6,188,1468,10,292,166,329,302,495,2424,4078,5,22973,1276,1,2,4,7,25400,10316,2002,16210,0
17,526,424,94,331,4,0,89,428,1,5,5,5,6,10,11,25,0,12,0,0,2,1,3,25400,10317,2002,16211,0
62,2690,1943,715,1694,26,18,214,1969,12,185,120,237,197,357,1436,2721,7,20915,1161,0,2,1,1,25400,10319,2002,16212,0
273,5456,1457,730,1242,11,6,188,1468,10,292,166,329,302,495,2424,4078,5,22973,1276,1,2,14,10,25400,10321,2002,16213,1
273,5456,74,35,59,1,0,14,75,3,14,7,14,17,21,58,85,1,128,7,0,2,14,10,25400,10322,2002,16214,1
273,5456,245,125,200,5,7,34,250,7,30,17,34,37,51,166,265,3,1053,58,0,2,14,10,25410,10323,2002,16215,1
170,3908,77,34,69,0,0,8,77,3,24,16,29,27,45,114,213,1,387,21,0,2,1,4,25410,10323,2002,16216,1
170,3908,712,438,573,51,9,84,763,14,102,71,128,116,199,733,1364,8,11988,666,0,2,1,4,25420,10324,2002,16217,1
180,4204,722,423,573,19,0,135,741,12,172,101,199,184,300,1320,2257,6,15668,870,0,2,31,4,25420,10326,2002,16219,1
180,4204,1508,847,911,44,250,301,1552,14,148,88,169,162,257,1120,1886,7,15077,837,0,2,31,4,25420,10327,2003,16220,1
65,3083,1338,495,1086,10,64,173,1348,11,122,82,157,133,239,883,1686,7,11934,663,0,2,18,18,25420,10329,2003,16221,1
136,6025,139,89,101,2,0,35,141,7,54,34,62,61,96,330,569,4,2287,127,0,2,57,57,25420,10329,2003,16222,1
136,6025,7,5,5,0,0,2,7,1,2,1,2,3,3,2,4,0,2,0,0,2,57,57,25420,10329,2003,16223,1
66,3569,1782,648,1425,9,47,279,1791,8,171,97,189,179,286,1292,2140,4,9462,525,0,2,26,34,25420,10330,2004,16224,1
64,2475,1450,624,1228,12,26,181,1462,14,306,186,354,320,540,2580,4493,8,36391,2021,1,2,1,1,25420,10332,2005,16225,1
47,2312,1457,730,1242,11,6,188,1468,10,292,166,329,302,495,2424,4078,5,22973,1276,1,2,5,5,25420,10334,2005,16226,1
17,522,424,94,331,4,0,89,428,1,5,5,5,6,10,11,25,0,12,0,0,2,16,20,25420,10335,2005,16227,1
276,5499,1457,730,1242,11,6,188,1468,10,292,166,329,302,495,2424,4078,5,22973,1276,1,2,21,9,25420,10337,2005,16228,1
276,5499,74,35,59,1,0,14,75,3,14,7,14,17,21,58,85,1,128,7,0,2,21,9,25420,10338,2005,16229,1
276,5499,245,125,200,5,7,34,250,7,30,17,34,37,51,166,265,3,1053,58,0,2,21,9,25430,10339,2005,16230,1
181,4293,722,423,573,19,0,135,741,12,172,101,199,184,300,1320,2257,6,15668,870,0,2,29,13,25430,10341,2005,16232,1
181,4293,1508,847,911,44,250,301,1552,14,148,88,169,162,257,1120,1886,7,15077,837,0,2,29,13,25430,10342,2006,16233,1
1,88,13,10,10,0,0,3,13,1,2,1,2,3,3,2,4,0,2,0,0,2,1,1,25430,10342,2006,16234,1
66,2732,1289,550,1043,56,32,155,1345,10,167,93,185,177,278,1266,2075,5,11498,638,0,2,3,2,25430,10344,2007,16235,1
39,715,127,75,83,2,11,30,129,4,14,7,14,18,21,61,87,2,175,9,0,2,39,35,25430,10344,2007,16236,1
39,715,652,304,544,16,6,88,668,6,89,51,101,95,152,591,998,3,3399,188,0,2,39,35,25430,10345,2007,16237,1
39,715,2,2,2,0,0,0,2,0,0,0,0,0,0,0,0,0,0,0,0,2,39,35,25430,10345,2007,16237,1
39,715,8,5,5,0,0,3,8,0,0,0,0,0,0,0,0,0,0,0,0,2,39,35,25430,10345,2007,16238,1
39,715,2,2,2,0,0,0,2,0,0,0,0,0,0,0,0,0,0,0,0,2,39,35,25430,10345,2007,16238,1
39,715,14,8,8,0,0,6,14,0,0,0,0,0,0,0,0,0,0,0,0,2,39,35,25430,10345,2007,16239,1
39,715,6,4,4,0,0,2,6,0,0,0,0,0,0,0,0,0,0,0,0,2,39,35,25430,10345,2007,16240,1
39,715,6,4,4,0,0,2,6,1,2,1,2,3,3,2,4,0,2,0,0,2,39,35,25430,10345,2007,16241,1
39,715,6,4,4,0,0,2,6,0,0,0,0,0,0,0,0,0,0,0,0,2,39,35,25430,10345,2007,16242,1
39,715,7,5,5,0,0,2,7,0,0,0,0,0,0,0,0,0,0,0,0,2,39,35,25430,10345,2007,16243,1
39,715,6,4,4,0,0,2,6,0,0,0,0,0,0,0,0,0,0,0,0,2,39,35,25430,10345,2007,16244,1
39,715,10,6,6,0,0,4,10,0,0,0,0,0,0,0,0,0,0,0,0,2,39,35,25430,10345,2007,16245,1
39,715,1,1,1,0,0,0,1,0,0,0,0,0,0,0,0,0,0,0,0,2,39,35,25430,10345,2007,16245,1
39,715,14,10,10,0,0,4,14,1,1,1,1,2,2,0,2,0,1,0,0,2,39,35,25430,10345,2007,16246,1
39,715,46,26,30,3,0,12,49,3,6,3,6,9,9,20,28,1,42,2,0,2,39,35,25440,10345,2007,16247,1
65,3081,1338,495,1086,10,64,173,1348,11,122,82,157,133,239,883,1686,7,11934,663,0,2,2,4,25440,10347,2007,16248,1
136,6023,139,89,101,2,0,35,141,7,54,34,62,61,96,330,569,4,2287,127,0,2,2,4,25440,10347,2007,16249,1
136,6023,7,5,5,0,0,2,7,1,2,1,2,3,3,2,4,0,2,0,0,2,2,4,25440,10347,2007,16250,1
66,3569,1782,648,1425,9,47,279,1791,8,171,97,189,179,286,1292,2140,4,9462,525,0,2,1,1,25440,10348,2008,16251,1
64,2475,1450,624,1228,12,26,181,1462,14,306,186,354,320,540,2580,4493,8,36391,2021,1,2,3,3,25440,10350,2009,16252,1
132,3414,1660,832,1314,41,38,274,1701,20,312,209,395,332,604,2671,5058,12,64042,3557,1,2,3,5,25440,10352,2010,16254,1
111,4259,1513,682,1277,25,13,200,1538,11,199,116,219,210,335,1557,2584,6,15641,868,0,2,29,29,25440,10354,2010,16255,1
47,2814,1296,573,1062,40,33,157,1336,8,201,118,231,209,349,1561,2689,4,12365,686,0,2,0,2,25440,10354,2010,16256,1
28,1176,1455,414,1257,16,76,112,1471,5,41,23,46,46,69,231,381,2,1069,59,0,2,0,2,25440,10355,2010,16257,1
8,257,74,35,59,1,0,14,75,3,14,7,14,17,21,58,85,1,128,7,0,2,2,2,25440,10356,2010,16258,1
31,1169,1293,570,1093,25,15,163,1318,10,195,123,241,205,364,1516,2795,6,17273,959,0,2,1,1,25450,10358,2010,16259,1
24,961,373,158,315,8,0,51,381,5,76,44,79,81,123,486,779,2,2026,112,0,2,0,1,25450,10358,2010,16260,1
211,4765,722,423,573,19,0,135,741,12,172,101,199,184,300,1320,2257,6,15668,870,0,2,158,96,25450,10360,2010,16262,1
211,4765,1508,847,911,44,250,301,1552,14,148,88,169,162,257,1120,1886,7,15077,837,0,2,158,96,25450,10361,2011,16263,1
66,2728,1289,550,1043,56,32,155,1345,10,167,93,185,177,278,1266,2075,5,11498,638,0,2,1,1,25450,10363,2012,16264,1
65,3081,1338,495,1086,10,64,173,1348,11,122,82,157,133,239,883,1686,7,11934,663,0,2,17,17,25460,10366,2012,16277,1
136,6023,139,89,101,2,0,35,141,7,54,34,62,61,96,330,569,4,2287,127,0,2,56,56,25460,10366,2012,16278,1
136,6023,7,5,5,0,0,2,7,1,2,1,2,3,3,2,4,0,2,0,0,2,56,56,25460,10366,2012,16279,1
66,3569,1782,648,1425,9,47,279,1791,8,171,97,189,179,286,1292,2140,4,9462,525,0,2,18,18,25460,10367,2013,16280,1
132,3410,1660,832,1314,41,38,274,1701,20,312,209,395,332,604,2671,5058,12,64042,3557,1,2,2,2,25460,10369,2014,16282,1
111,4256,1513,682,1277,25,13,200,1538,11,199,116,219,210,335,1557,2584,6,15641,868,0,2,18,20,25460,10371,2014,16283,1
47,2814,1296,573,1062,40,33,157,1336,8,201,118,231,209,349,1561,2689,4,12365,686,0,2,1,1,25460,10371,2014,16284,1
47,2312,1457,730,1242,11,6,188,1468,10,292,166,329,302,495,2424,4078,5,22973,1276,1,2,4,4,25460,10373,2014,16285,1
28,1174,1455,414,1257,16,76,112,1471,5,41,23,46,46,69,231,381,2,1069,59,0,2,1,1,25460,10374,2014,16286,1
17,522,424,94,331,4,0,89,428,1,5,5,5,6,10,11,25,0,12,0,0,2,11,11,25460,10375,2014,16287,1
32,1211,1293,570,1093,25,15,163,1318,10,195,123,241,205,364,1516,2795,6,17273,959,0,2,11,4,25470,10377,2014,16288,1
14,581,722,423,573,19,0,135,741,12,172,101,199,184,300,1320,2257,6,15668,870,0,2,1,13,25470,10379,2014,16290,1
65,3081,1338,495,1086,10,64,173,1348,11,122,82,157,133,239,883,1686,7,11934,663,0,2,17,17,25470,10381,2014,16291,1
136,6023,139,89,101,2,0,35,141,7,54,34,62,61,96,330,569,4,2287,127,0,2,56,56,25470,10381,2014,16292,1
136,6023,7,5,5,0,0,2,7,1,2,1,2,3,3,2,4,0,2,0,0,2,56,56,25470,10381,2014,16293,1
66,3569,1782,648,1425,9,47,279,1791,8,171,97,189,179,286,1292,2140,4,9462,525,0,2,18,18,25470,10382,2015,16294,1
47,2312,1457,730,1242,11,6,188,1468,10,292,166,329,302,495,2424,4078,5,22973,1276,1,2,4,4,25470,10384,2015,16295,1
17,522,424,94,331,4,0,89,428,1,5,5,5,6,10,11,25,0,12,0,0,2,11,11,25470,10385,2015,16296,1
276,5499,1457,730,1242,11,6,188,1468,10,292,166,329,302,495,2424,4078,5,22973,1276,1,2,33,17,25470,10387,2015,16297,0
276,5499,74,35,59,1,0,14,75,3,14,7,14,17,21,58,85,1,128,7,0,2,33,17,25470,10388,2015,16298,0
276,5499,245,125,200,5,7,34,250,7,30,17,34,37,51,166,265,3,1053,58,0,2,33,17,25480,10389,2015,16299,0
170,3908,77,34,69,0,0,8,77,3,24,16,29,27,45,114,213,1,387,21,0,2,1,4,25480,10389,2015,16300,0
170,3908,712,438,573,51,9,84,763,14,102,71,128,116,199,733,1364,8,11988,666,0,2,1,4,25490,10390,2015,16301,0
211,4765,722,423,573,19,0,135,741,12,172,101,199,184,300,1320,2257,6,15668,870,0,2,211,106,25490,10392,2015,16303,0
211,4765,1508,847,911,44,250,301,1552,14,148,88,169,162,257,1120,1886,7,15077,837,0,2,211,106,25490,10393,2016,16304,0
1,88,13,10,10,0,0,3,13,1,2,1,2,3,3,2,4,0,2,0,0,2,1,1,25490,10393,2016,16305,0
66,2728,1289,550,1043,56,32,155,1345,10,167,93,185,177,278,1266,2075,5,11498,638,0,2,4,3,25490,10395,2017,16306,0
65,3081,1338,495,1086,10,64,173,1348,11,122,82,157,133,239,883,1686,7,11934,663,0,2,1,3,25500,10398,2017,16319,0
136,6023,139,89,101,2,0,35,141,7,54,34,62,61,96,330,569,4,2287,127,0,2,1,3,25500,10398,2017,16320,0
136,6023,7,5,5,0,0,2,7,1,2,1,2,3,3,2,4,0,2,0,0,2,1,3,25500,10398,2017,16321,0
66,3569,1782,648,1425,9,47,279,1791,8,171,97,189,179,286,1292,2140,4,9462,525,0,2,9,17,25500,10399,2018,16322,0
64,2475,1450,624,1228,12,26,181,1462,14,306,186,354,320,540,2580,4493,8,36391,2021,1,2,2,2,25500,10401,2019,16323,0
132,3410,1660,832,1314,41,38,274,1701,20,312,209,395,332,604,2671,5058,12,64042,3557,1,2,5,7,25500,10403,2020,16325,0
111,4256,1513,682,1277,25,13,200,1538,11,199,116,219,210,335,1557,2584,6,15641,868,0,2,13,15,25500,10405,2020,16326,0
47,2814,1296,573,1062,40,33,157,1336,8,201,118,231,209,349,1561,2689,4,12365,686,0,2,1,3,25500,10405,2020,16327,0
47,2312,1457,730,1242,11,6,188,1468,10,292,166,329,302,495,2424,4078,5,22973,1276,1,2,1,1,25500,10407,2020,16328,0
28,1174,1455,414,1257,16,76,112,1471,5,41,23,46,46,69,231,381,2,1069,59,0,2,1,3,25500,10408,2020,16329,0
8,257,74,35,59,1,0,14,75,3,14,7,14,17,21,58,85,1,128,7,0,2,2,2,25500,10409,2020,16330,0
17,522,424,94,331,4,0,89,428,1,5,5,5,6,10,11,25,0,12,0,0,2,6,10,25500,10410,2020,16331,0
32,1211,1293,570,1093,25,15,163,1318,10,195,123,241,205,364,1516,2795,6,17273,959,0,2,12,5,25510,10412,2020,16332,0
14,581,722,423,573,19,0,135,741,12,172,101,199,184,300,1320,2257,6,15668,870,0,2,1,13,25510,10414,2020,16334,0
24,961,373,158,315,8,0,51,381,5,76,44,79,81,123,486,779,2,2026,112,0,2,0,1,25510,10414,2020,16335,0
276,5497,1457,730,1242,11,6,188,1468,10,292,166,329,302,495,2424,4078,5,22973,1276,1,2,1,1,25510,10416,2020,16336,1
276,5497,74,35,59,1,0,14,75,3,14,7,14,17,21,58,85,1,128,7,0,2,1,1,25510,10417,2020,16337,1
276,5497,245,125,200,5,7,34,250,7,30,17,34,37,51,166,265,3,1053,58,0,2,1,1,25520,10418,2020,16338,1
46,516,647,139,84,35,284,233,682,0,0,0,0,0,0,0,0,0,0,0,0,2,1,1,25520,10418,2020,16339,1
211,4763,722,423,573,19,0,135,741,12,172,101,199,184,300,1320,2257,6,15668,870,0,2,2,2,25520,10420,2020,16341,1
211,4763,1508,847,911,44,250,301,1552,14,148,88,169,162,257,1120,1886,7,15077,837,0,2,2,2,25520,10421,2021,16342,1
468,10239,72,33,56,0,4,12,72,1,1,1,1,2,2,0,2,0,1,0,0,2,15,2,25520,10421,2021,16343,1
468,10239,1454,835,1044,76,110,219,1530,17,275,158,296,292,454,2297,3718,9,34017,1889,1,2,15,2,25530,10422,2021,16344,1
20,617,42,7,35,4,0,5,46,1,2,1,2,3,3,2,4,0,2,0,0,2,1,1,25530,10422,2021,16345,1
20,617,11,6,10,0,0,1,11,2,4,2,4,6,6,10,15,1,15,0,0,2,1,1,25530,10422,2021,16346,1
31,1709,384,251,317,7,8,52,391,11,70,44,84,81,128,467,811,6,5355,297,0,0,311,0,25530,10422,2021,16347,1
283,5665,1457,730,1242,11,6,188,1468,10,292,166,329,302,495,2424,4078,5,22973,1276,1,2,31,9,25530,10424,2021,16348,1
283,5665,74,35,59,1,0,14,75,3,14,7,14,17,21,58,85,1,128,7,0,2,31,9,25530,10425,2021,16349,1
283,5665,245,125,200,5,7,34,250,7,30,17,34,37,51,166,265,3,1053,58,0,2,31,9,25540,10426,2021,16350,1
46,522,647,139,84,35,284,233,682,0,0,0,0,0,0,0,0,0,0,0,0,2,3,1,25540,10426,2021,16351,1
170,3908,77,34,69,0,0,8,77,3,24,16,29,27,45,114,213,1,387,21,0,2,2,2,25540,10426,2021,16352,1
170,3908,712,438,573,51,9,84,763,14,102,71,128,116,199,733,1364,8,11988,666,0,2,2,2,25550,10427,2021,16353,1
47,2318,1457,730,1242,11,6,188,1468,10,292,166,329,302,495,2424,4078,5,22973,1276,1,2,3,3,25550,10429,2021,16354,1
85,1873,477,336,357,30,23,73,507,16,194,134,250,210,384,1538,2962,10,30538,1696,0,2,4,2,25560,10430,2021,16355,0
134,3458,1660,832,1314,41,38,274,1701,20,312,209,395,332,604,2671,5058,12,64042,3557,1,2,21,0,25560,10432,2022,16357,0
85,1873,477,336,357,30,23,73,507,16,194,134,250,210,384,1538,2962,10,30538,1696,0,2,4,2,25570,10433,2022,16358,0
134,3451,1660,832,1314,41,38,274,1701,20,312,209,395,332,604,2671,5058,12,64042,3557,1,2,21,0,25570,10435,2023,16360,0
43,863,447,308,343,6,5,95,453,7,96,59,111,103,170,651,1136,4,4600,255,0,2,2,2,25570,10438,2023,16361,0
43,863,322,174,179,16,74,51,338,10,41,26,46,51,72,252,408,5,2291,127,0,2,2,2,25570,10441,2024,16362,0
44,1315,1523,757,1297,19,12,193,1542,12,193,117,230,205,347,1508,2664,7,19053,1058,0,2,4,4,25580,10443,2024,16363,0
44,1315,701,378,504,33,58,109,734,13,110,68,126,123,194,794,1346,7,10027,557,0,2,4,4,25580,10444,2025,16364,0
40,2493,1523,757,1297,19,12,193,1542,12,193,117,230,205,347,1508,2664,7,19053,1058,0,2,5,1,25590,10446,2025,16365,0
43,863,447,308,343,6,5,95,453,7,96,59,111,103,170,651,1136,4,4600,255,0,2,2,2,25590,10449,2025,16366,0
43,863,322,174,179,16,74,51,338,10,41,26,46,51,72,252,408,5,2291,127,0,2,2,2,25590,10452,2026,16367,0
284,5669,1457,730,1242,11,6,188,1468,10,292,166,329,302,495,2424,4078,5,22973,1276,1,2,12,11,25590,10454,2026,16368,0
284,5669,74,35,59,1,0,14,75,3,14,7,14,17,21,58,85,1,128,7,0,2,12,11,25590,10455,2026,16369,0
284,5669,245,125,200,5,7,34,250,7,30,17,34,37,51,166,265,3,1053,58,0,2,12,11,25600,10456,2026,16370,0
85,1873,477,336,357,30,23,73,507,16,194,134,250,210,384,1538,2962,10,30538,1696,0,2,4,2,25610,10457,2026,16371,0
43,863,447,308,343,6,5,95,453,7,96,59,111,103,170,651,1136,4,4600,255,0,2,2,2,25610,10460,2026,16372,0
43,863,322,174,179,16,74,51,338,10,41,26,46,51,72,252,408,5,2291,127,0,2,2,2,25610,10463,2027,16373,0
134,3451,1660,832,1314,41,38,274,1701,20,312,209,395,332,604,2671,5058,12,64042,3557,1,2,21,0,25610,10465,2028,16375,0
284,5694,1457,730,1242,11,6,188,1468,10,292,166,329,302,495,2424,4078,5,22973,1276,1,2,27,20,25610,10467,2028,16376,1
284,5694,74,35,59,1,0,14,75,3,14,7,14,17,21,58,85,1,128,7,0,2,27,20,25610,10468,2028,16377,1
284,5694,245,125,200,5,7,34,250,7,30,17,34,37,51,166,265,3,1053,58,0,2,27,20,25620,10469,2028,16378,1
23,749,74,35,59,1,0,14,75,3,14,7,14,17,21,58,85,1,128,7,0,2,3,3,25620,10470,2028,16379,1
23,749,245,125,200,5,7,34,250,7,30,17,34,37,51,166,265,3,1053,58,0,2,3,3,25630,10471,2028,16380,1
46,522,647,139,84,35,284,233,682,0,0,0,0,0,0,0,0,0,0,0,0,2,2,2,25630,10471,2028,16381,1
169,3542,1943,715,1694,26,18,214,1969,12,185,120,237,197,357,1436,2721,7,20915,1161,0,2,6,3,25630,10473,2028,16382,1
169,3542,1168,838,957,57,25,144,1225,19,348,224,416,367,640,3018,5452,11,61921,3440,1,2,6,3,25640,10475,2028,16383,1
20,617,42,7,35,4,0,5,46,1,2,1,2,3,3,2,4,0,2,0,0,2,1,1,25640,10475,2028,16384,1
20,617,11,6,10,0,0,1,11,2,4,2,4,6,6,10,15,1,15,0,0,2,1,1,25640,10475,2028,16385,1
8,259,74,35,59,1,0,14,75,3,14,7,14,17,21,58,85,1,128,7,0,2,1,1,25640,10476,2028,16386,1
62,2698,1943,715,1694,26,18,214,1969,12,185,120,237,197,357,1436,2721,7,20915,1161,0,2,6,4,25640,10478,2028,16387,1
111,2266,1513,682,1277,25,13,200,1538,11,199,116,219,210,335,1557,2584,6,15641,868,0,2,7,7,25640,10480,2028,16388,1
111,2266,819,519,539,24,98,155,843,15,96,57,106,111,163,690,1107,8,9171,509,0,2,7,7,25650,10482,2028,16389,1
284,5696,1457,730,1242,11,6,188,1468,10,292,166,329,302,495,2424,4078,5,22973,1276,1,2,7,7,25650,10484,2028,16390,1
284,5696,74,35,59,1,0,14,75,3,14,7,14,17,21,58,85,1,128,7,0,2,7,7,25650,10485,2028,16391,1
284,5696,245,125,200,5,7,34,250,7,30,17,34,37,51,166,265,3,1053,58,0,2,7,7,25660,10486,2028,16392,1
23,749,74,35,59,1,0,14,75,3,14,7,14,17,21,58,85,1,128,7,0,2,1,1,25660,10487,2028,16393,1
23,749,245,125,200,5,7,34,250,7,30,17,34,37,51,166,265,3,1053,58,0,2,1,1,25670,10488,2028,16394,1
46,522,647,139,84,35,284,233,682,0,0,0,0,0,0,0,0,0,0,0,0,2,22,22,25670,10488,2028,16395,1
170,3908,77,34,69,0,0,8,77,3,24,16,29,27,45,114,213,1,387,21,0,2,2,2,25670,10488,2028,16396,1
170,3908,712,438,573,51,9,84,763,14,102,71,128,116,199,733,1364,8,11988,666,0,2,2,2,25680,10489,2028,16397,1
23,374,424,94,331,4,0,89,428,1,5,5,5,6,10,11,25,0,12,0,0,2,1,1,25680,10490,2028,16398,1
23,374,38,23,23,6,0,8,44,3,11,7,11,14,18,42,68,1,102,5,0,2,1,1,25680,10490,2028,16399,1
16,477,184,100,137,2,15,30,186,6,38,20,39,44,59,214,322,3,991,55,0,2,1,1,25680,10491,2028,16400,1
16,477,103,65,74,8,5,16,111,7,17,9,17,24,26,89,119,3,417,23,0,2,1,1,25680,10492,2028,16401,1
211,4763,722,423,573,19,0,135,741,12,172,101,199,184,300,1320,2257,6,15668,870,0,2,1,1,25680,10494,2028,16403,1
211,4763,1508,847,911,44,250,301,1552,14,148,88,169,162,257,1120,1886,7,15077,837,0,2,1,1,25680,10495,2029,16404,1
468,10239,72,33,56,0,4,12,72,1,1,1,1,2,2,0,2,0,1,0,0,2,3,3,25680,10495,2029,16405,1
468,10239,1454,835,1044,76,110,219,1530,17,275,158,296,292,454,2297,3718,9,34017,1889,1,2,3,3,25690,10496,2029,16406,1
83,1510,1178,367,1042,6,15,115,1184,9,94,51,95,103,146,644,976,4,4439,246,0,2,2,2,25690,10496,2029,16407,1
83,1510,177,108,140,8,0,27,185,6,30,16,32,36,48,162,248,3,794,44,0,2,2,2,25690,10498,2029,16408,1
169,3542,1943,715,1694,26,18,214,1969,12,185,120,237,197,357,1436,2721,7,20915,1161,0,2,2,2,25690,10500,2029,16409,1
169,3542,1168,838,957,57,25,144,1225,19,348,224,416,367,640,3018,5452,11,61921,3440,1,2,2,2,25700,10502,2029,16410,1
51,1018,1098,241,925,5,10,155,1103,7,46,25,49,53,74,273,423,3,1580,87,0,2,2,2,25710,10504,2029,16411,1
51,1018,282,202,222,14,2,44,296,8,42,24,43,50,67,250,378,4,1548,86,0,2,2,2,25710,10505,2029,16412,1
65,3081,1338,495,1086,10,64,173,1348,11,122,82,157,133,239,883,1686,7,11934,663,0,2,1,1,25710,10507,2029,16413,1
8,259,74,35,59,1,0,14,75,3,14,7,14,17,21,58,85,1,128,7,0,2,1,1,25710,10508,2029,16414,1
55,2363,1020,354,843,12,15,144,1032,8,134,77,144,142,221,970,1580,4,6792,377,0,2,1,1,25710,10508,2029,16415,1
212,4789,722,423,573,19,0,135,741,12,172,101,199,184,300,1320,2257,6,15668,870,0,2,14,6,25720,10514,2030,16424,1
212,4789,1508,847,911,44,250,301,1552,14,148,88,169,162,257,1120,1886,7,15077,837,0,2,14,6,25720,10515,2031,16425,1
20,617,42,7,35,4,0,5,46,1,2,1,2,3,3,2,4,0,2,0,0,2,1,1,25720,10515,2031,16426,1
20,617,11,6,10,0,0,1,11,2,4,2,4,6,6,10,15,1,15,0,0,2,1,1,25720,10515,2031,16427,1
111,2266,1513,682,1277,25,13,200,1538,11,199,116,219,210,335,1557,2584,6,15641,868,0,2,7,7,25730,10521,2032,16435,0
111,2266,819,519,539,24,98,155,843,15,96,57,106,111,163,690,1107,8,9171,509,0,2,7,7,25740,10523,2032,16436,0
284,5696,1457,730,1242,11,6,188,1468,10,292,166,329,302,495,2424,4078,5,22973,1276,1,2,42,12,25740,10525,2032,16437,0
284,5696,74,35,59,1,0,14,75,3,14,7,14,17,21,58,85,1,128,7,0,2,42,12,25740,10526,2032,16438,0
284,5696,245,125,200,5,7,34,250,7,30,17,34,37,51,166,265,3,1053,58,0,2,42,12,25750,10527,2032,16439,0
23,749,74,35,59,1,0,14,75,3,14,7,14,17,21,58,85,1,128,7,0,2,4,4,25750,10528,2032,16440,0
23,749,245,125,200,5,7,34,250,7,30,17,34,37,51,166,265,3,1053,58,0,2,4,4,25760,10529,2032,16441,0
46,522,647,139,84,35,284,233,682,0,0,0,0,0,0,0,0,0,0,0,0,2,23,21,25760,10529,2032,16442,0
170,3908,77,34,69,0,0,8,77,3,24,16,29,27,45,114,213,1,387,21,0,2,4,4,25760,10529,2032,16443,0
170,3908,712,438,573,51,9,84,763,14,102,71,128,116,199,733,1364,8,11988,666,0,2,4,4,25770,10530,2032,16444,0
23,374,424,94,331,4,0,89,428,1,5,5,5,6,10,11,25,0,12,0,0,2,1,1,25770,10531,2032,16445,0
23,374,38,23,23,6,0,8,44,3,11,7,11,14,18,42,68,1,102,5,0,2,1,1,25770,10531,2032,16446,0
16,477,184,100,137,2,15,30,186,6,38,20,39,44,59,214,322,3,991,55,0,2,1,1,25770,10532,2032,16447,0
16,477,103,65,74,8,5,16,111,7,17,9,17,24,26,89,119,3,417,23,0,2,1,1,25770,10533,2032,16448,0
212,4789,722,423,573,19,0,135,741,12,172,101,199,184,300,1320,2257,6,15668,870,0,2,17,9,25770,10535,2032,16450,0
212,4789,1508,847,911,44,250,301,1552,14,148,88,169,162,257,1120,1886,7,15077,837,0,2,17,9,25770,10536,2033,16451,0
468,10239,72,33,56,0,4,12,72,1,1,1,1,2,2,0,2,0,1,0,0,2,18,5,25770,10536,2033,16452,0
468,10239,1454,835,1044,76,110,219,1530,17,275,158,296,292,454,2297,3718,9,34017,1889,1,2,18,5,25780,10537,2033,16453,0
83,1510,1178,367,1042,6,15,115,1184,9,94,51,95,103,146,644,976,4,4439,246,0,2,2,2,25780,10537,2033,16454,0
83,1510,177,108,140,8,0,27,185,6,30,16,32,36,48,162,248,3,794,44,0,2,2,2,25780,10539,2033,16455,0
169,3542,1943,715,1694,26,18,214,1969,12,185,120,237,197,357,1436,2721,7,20915,1161,0,2,8,5,25780,10541,2033,16456,0
169,3542,1168,838,957,57,25,144,1225,19,348,224,416,367,640,3018,5452,11,61921,3440,1,2,8,5,25790,10543,2033,16457,0
51,1018,1098,241,925,5,10,155,1103,7,46,25,49,53,74,273,423,3,1580,87,0,2,2,2,25800,10545,2033,16458,0
51,1018,282,202,222,14,2,44,296,8,42,24,43,50,67,250,378,4,1548,86,0,2,2,2,25800,10546,2033,16459,0
20,617,42,7,35,4,0,5,46,1,2,1,2,3,3,2,4,0,2,0,0,2,1,1,25800,10546,2033,16460,0
20,617,11,6,10,0,0,1,11,2,4,2,4,6,6,10,15,1,15,0,0,2,1,1,25800,10546,2033,16461,0
65,3081,1338,495,1086,10,64,173,1348,11,122,82,157,133,239,883,1686,7,11934,663,0,2,1,1,25800,10548,2033,16462,0
47,2318,1457,730,1242,11,6,188,1468,10,292,166,329,302,495,2424,4078,5,22973,1276,1,2,3,3,25800,10550,2033,16463,0
8,259,74,35,59,1,0,14,75,3,14,7,14,17,21,58,85,1,128,7,0,2,2,2,25800,10551,2033,16464,0
55,2363,1020,354,843,12,15,144,1032,8,134,77,144,142,221,970,1580,4,6792,377,0,2,1,1,25800,10551,2033,16465,0
31,1709,384,251,317,7,8,52,391,11,70,44,84,81,128,467,811,6,5355,297,0,0,311,0,25800,10551,2033,16466,0
62,2698,1943,715,1694,26,18,214,1969,12,185,120,237,197,357,1436,2721,7,20915,1161,0,2,6,4,25800,10553,2033,16467,0
216,4821,722,423,573,19,0,135,741,12,172,101,199,184,300,1320,2257,6,15668,870,0,2,15,7,25810,10559,2034,16476,1
216,4821,1508,847,911,44,250,301,1552,14,148,88,169,162,257,1120,1886,7,15077,837,0,2,15,7,25810,10560,2035,16477,1
20,617,42,7,35,4,0,5,46,1,2,1,2,3,3,2,4,0,2,0,0,2,1,1,25810,10560,2035,16478,1
20,617,11,6,10,0,0,1,11,2,4,2,4,6,6,10,15,1,15,0,0,2,1,1,25810,10560,2035,16479,1
62,2705,1943,715,1694,26,18,214,1969,12,185,120,237,197,357,1436,2721,7,20915,1161,0,2,5,5,25810,10562,2035,16480,1
216,4821,722,423,573,19,0,135,741,12,172,101,199,184,300,1320,2257,6,15668,870,0,2,15,7,25820,10568,2036,16489,0
216,4821,1508,847,911,44,250,301,1552,14,148,88,169,162,257,1120,1886,7,15077,837,0,2,15,7,25820,10569,2037,16490,0
20,617,42,7,35,4,0,5,46,1,2,1,2,3,3,2,4,0,2,0,0,2,1,1,25820,10569,2037,16491,0
20,617,11,6,10,0,0,1,11,2,4,2,4,6,6,10,15,1,15,0,0,2,1,1,25820,10569,2037,16492,0
62,2705,1943,715,1694,26,18,214,1969,12,185,120,237,197,357,1436,2721,7,20915,1161,0,2,5,5,25820,10571,2037,16493,0
20,617,42,7,35,4,0,5,46,1,2,1,2,3,3,2,4,0,2,0,0,2,1,1,25820,10571,2037,16494,0
20,617,11,6,10,0,0,1,11,2,4,2,4,6,6,10,15,1,15,0,0,2,1,1,25820,10571,2037,16495,0
216,4831,722,423,573,19,0,135,741,12,172,101,199,184,300,1320,2257,6,15668,870,0,2,2,1,25820,10573,2037,16497,1
216,4831,1508,847,911,44,250,301,1552,14,148,88,169,162,257,1120,1886,7,15077,837,0,2,2,1,25820,10574,2038,16498,1
44,872,447,308,343,6,5,95,453,7,96,59,111,103,170,651,1136,4,4600,255,0,2,5,4,25830,10581,2039,16506,1
44,872,322,174,179,16,74,51,338,10,41,26,46,51,72,252,408,5,2291,127,0,2,5,4,25830,10584,2040,16507,1
34,1509,447,308,343,6,5,95,453,7,96,59,111,103,170,651,1136,4,4600,255,0,2,5,0,25830,10587,2040,16508,1
169,3532,1943,715,1694,26,18,214,1969,12,185,120,237,197,357,1436,2721,7,20915,1161,0,2,2,1,25830,10589,2040,16509,1
169,3532,1168,838,957,57,25,144,1225,19,348,224,416,367,640,3018,5452,11,61921,3440,1,2,2,1,25840,10591,2040,16510,1
44,872,447,308,343,6,5,95,453,7,96,59,111,103,170,651,1136,4,4600,255,0,2,5,4,25840,10594,2040,16511,0
44,872,322,174,179,16,74,51,338,10,41,26,46,51,72,252,408,5,2291,127,0,2,5,4,25840,10597,2041,16512,0
34,1509,447,308,343,6,5,95,453,7,96,59,111,103,170,651,1136,4,4600,255,0,2,5,0,25840,10600,2041,16513,0
216,4831,722,423,573,19,0,135,741,12,172,101,199,184,300,1320,2257,6,15668,870,0,2,2,1,25840,10602,2041,16515,0
216,4831,1508,847,911,44,250,301,1552,14,148,88,169,162,257,1120,1886,7,15077,837,0,2,2,1,25840,10603,2042,16516,0
141,4443,1660,832,1314,41,38,274,1701,20,312,209,395,332,604,2671,5058,12,64042,3557,1,2,8,1,25840,10605,2043,16518,0
141,4443,1057,646,719,113,100,145,1170,18,215,134,248,233,382,1740,3004,10,31186,1732,1,2,8,1,25850,10606,2044,16519,0
141,4443,1660,832,1314,41,38,274,1701,20,312,209,395,332,604,2671,5058,12,64042,3557,1,2,8,1,25850,10608,2045,16521,0
141,4443,1057,646,719,113,100,145,1170,18,215,134,248,233,382,1740,3004,10,31186,1732,1,2,8,1,25860,10609,2046,16522,0
141,4443,1660,832,1314,41,38,274,1701,20,312,209,395,332,604,2671,5058,12,64042,3557,1,2,8,1,25860,10611,2047,16524,0
141,4443,1057,646,719,113,100,145,1170,18,215,134,248,233,382,1740,3004,10,31186,1732,1,2,8,1,25870,10612,2048,16525,0
44,1315,1523,757,1297,19,12,193,1542,12,193,117,230,205,347,1508,2664,7,19053,1058,0,2,4,4,25880,10614,2048,16526,0
44,1315,701,378,504,33,58,109,734,13,110,68,126,123,194,794,1346,7,10027,557,0,2,4,4,25880,10615,2049,16527,0
40,2493,1523,757,1297,19,12,193,1542,12,193,117,230,205,347,1508,2664,7,19053,1058,0,2,5,1,25890,10617,2049,16528,0
468,10239,72,33,56,0,4,12,72,1,1,1,1,2,2,0,2,0,1,0,0,2,1,1,25890,10617,2049,16529,1
468,10239,1454,835,1044,76,110,219,1530,17,275,158,296,292,454,2297,3718,9,34017,1889,1,2,1,1,25900,10618,2049,16530,1
34,1509,447,308,343,6,5,95,453,7,96,59,111,103,170,651,1136,4,4600,255,0,2,1,1,25900,10621,2049,16531,1
45,1333,1523,757,1297,19,12,193,1542,12,193,117,230,205,347,1508,2664,7,19053,1058,0,2,4,2,25910,10623,2049,16532,0
45,1333,701,378,504,33,58,109,734,13,110,68,126,123,194,794,1346,7,10027,557,0,2,4,2,25910,10624,2050,16533,0
29,1210,1455,414,1257,16,76,112,1471,5,41,23,46,46,69,231,381,2,1069,59,0,2,13,0,25910,10625,2050,16534,0
29,1211,1455,414,1257,16,76,112,1471,5,41,23,46,46,69,231,381,2,1069,59,0,2,3,0,25910,10626,2050,16535,0
44,1325,1523,757,1297,19,12,193,1542,12,193,117,230,205,347,1508,2664,7,19053,1058,0,2,4,2,25920,10628,2050,16536,0
44,1325,701,378,504,33,58,109,734,13,110,68,126,123,194,794,1346,7,10027,557,0,2,4,2,25920,10629,2051,16537,0
29,1226,1455,414,1257,16,76,112,1471,5,41,23,46,46,69,231,381,2,1069,59,0,2,16,0,25920,10630,2051,16538,0
44,1343,1523,757,1297,19,12,193,1542,12,193,117,230,205,347,1508,2664,7,19053,1058,0,2,3,0,25930,10632,2051,16539,0
44,1343,701,378,504,33,58,109,734,13,110,68,126,123,194,794,1346,7,10027,557,0,2,3,0,25930,10633,2052,16540,0
30,635,215,129,180,6,0,29,221,8,65,43,72,73,115,415,711,4,3153,175,0,2,4,0,25930,10633,2052,16541,0
30,635,97,69,77,3,3,16,100,6,22,13,23,28,36,113,173,3,542,30,0,2,4,0,25930,10634,2052,16542,0
41,2532,1523,757,1297,19,12,193,1542,12,193,117,230,205,347,1508,2664,7,19053,1058,0,2,9,0,25940,10636,2052,16543,0
16,1260,215,129,180,6,0,29,221,8,65,43,72,73,115,415,711,4,3153,175,0,2,14,0,25940,10636,2052,16544,0
45,1361,1523,757,1297,19,12,193,1542,12,193,117,230,205,347,1508,2664,7,19053,1058,0,2,3,0,25950,10638,2052,16545,0
45,1361,701,378,504,33,58,109,734,13,110,68,126,123,194,794,1346,7,10027,557,0,2,3,0,25950,10639,2053,16546,0
30,635,215,129,180,6,0,29,221,8,65,43,72,73,115,415,711,4,3153,175,0,2,4,0,25950,10639,2053,16547,0
30,635,97,69,77,3,3,16,100,6,22,13,23,28,36,113,173,3,542,30,0,2,4,0,25950,10640,2053,16548,0
41,2532,1523,757,1297,19,12,193,1542,12,193,117,230,205,347,1508,2664,7,19053,1058,0,2,9,0,25960,10642,2053,16549,0
16,1260,215,129,180,6,0,29,221,8,65,43,72,73,115,415,711,4,3153,175,0,2,14,0,25960,10642,2053,16550,0
41,2533,1523,757,1297,19,12,193,1542,12,193,117,230,205,347,1508,2664,7,19053,1058,0,2,1,0,25970,10644,2053,16551,0
16,1261,215,129,180,6,0,29,221,8,65,43,72,73,115,415,711,4,3153,175,0,2,1,0,25970,10644,2053,16552,0
45,1361,1523,757,1297,19,12,193,1542,12,193,117,230,205,347,1508,2664,7,19053,1058,0,2,1,1,25980,10646,2053,16553,0
45,1361,701,378,504,33,58,109,734,13,110,68,126,123,194,794,1346,7,10027,557,0,2,1,1,25980,10647,2054,16554,0
30,635,215,129,180,6,0,29,221,8,65,43,72,73,115,415,711,4,3153,175,0,2,1,1,25980,10647,2054,16555,0
30,635,97,69,77,3,3,16,100,6,22,13,23,28,36,113,173,3,542,30,0,2,1,1,25980,10648,2054,16556,0
45,1361,1523,757,1297,19,12,193,1542,12,193,117,230,205,347,1508,2664,7,19053,1058,0,2,3,0,25990,10650,2054,16557,0
45,1361,701,378,504,33,58,109,734,13,110,68,126,123,194,794,1346,7,10027,557,0,2,3,0,25990,10651,2055,16558,0
30,635,215,129,180,6,0,29,221,8,65,43,72,73,115,415,711,4,3153,175,0,2,4,0,25990,10651,2055,16559,0
30,635,97,69,77,3,3,16,100,6,22,13,23,28,36,113,173,3,542,30,0,2,4,0,25990,10652,2055,16560,0
41,2533,1523,757,1297,19,12,193,1542,12,193,117,230,205,347,1508,2664,7,19053,1058,0,2,10,0,26000,10654,2055,16561,0
16,1261,215,129,180,6,0,29,221,8,65,43,72,73,115,415,711,4,3153,175,0,2,15,0,26000,10654,2055,16562,0
46,1369,1523,757,1297,19,12,193,1542,12,193,117,230,205,347,1508,2664,7,19053,1058,0,2,3,0,26010,10656,2055,16563,0
46,1369,701,378,504,33,58,109,734,13,110,68,126,123,194,794,1346,7,10027,557,0,2,3,0,26010,10657,2056,16564,0
30,635,215,129,180,6,0,29,221,8,65,43,72,73,115,415,711,4,3153,175,0,2,4,0,26010,10657,2056,16565,0
30,635,97,69,77,3,3,16,100,6,22,13,23,28,36,113,173,3,542,30,0,2,4,0,26010,10658,2056,16566,0
41,2533,1523,757,1297,19,12,193,1542,12,193,117,230,205,347,1508,2664,7,19053,1058,0,2,10,0,26020,10660,2056,16567,0
16,1261,215,129,180,6,0,29,221,8,65,43,72,73,115,415,711,4,3153,175,0,2,15,0,26020,10660,2056,16568,0
86,1567,1178,367,1042,6,15,115,1184,9,94,51,95,103,146,644,976,4,4439,246,0,2,9,0,26020,10660,2056,16569,1
86,1567,177,108,140,8,0,27,185,6,30,16,32,36,48,162,248,3,794,44,0,2,9,0,26020,10662,2056,16570,1
47,2042,1178,367,1042,6,15,115,1184,9,94,51,95,103,146,644,976,4,4439,246,0,2,2,2,26020,10662,2056,16571,1
51,1035,1098,241,925,5,10,155,1103,7,46,25,49,53,74,273,423,3,1580,87,0,2,3,0,26030,10664,2056,16572,1
51,1035,282,202,222,14,2,44,296,8,42,24,43,50,67,250,378,4,1548,86,0,2,3,0,26030,10665,2056,16573,1
37,1422,1098,241,925,5,10,155,1103,7,46,25,49,53,74,273,423,3,1580,87,0,2,13,0,26040,10667,2056,16574,1
86,1567,1178,367,1042,6,15,115,1184,9,94,51,95,103,146,644,976,4,4439,246,0,2,9,0,26040,10667,2056,16575,0
86,1567,177,108,140,8,0,27,185,6,30,16,32,36,48,162,248,3,794,44,0,2,9,0,26040,10669,2056,16576,0
51,1035,1098,241,925,5,10,155,1103,7,46,25,49,53,74,273,423,3,1580,87,0,2,3,0,26050,10671,2056,16577,0
51,1035,282,202,222,14,2,44,296,8,42,24,43,50,67,250,378,4,1548,86,0,2,3,0,26050,10672,2056,16578,0
47,2042,1178,367,1042,6,15,115,1184,9,94,51,95,103,146,644,976,4,4439,246,0,2,2,2,26050,10672,2056,16579,0
37,1422,1098,241,925,5,10,155,1103,7,46,25,49,53,74,273,423,3,1580,87,0,2,13,0,26060,10674,2056,16580,0
86,1573,1178,367,1042,6,15,115,1184,9,94,51,95,103,146,644,976,4,4439,246,0,2,9,0,26060,10674,2056,16581,0
86,1573,177,108,140,8,0,27,185,6,30,16,32,36,48,162,248,3,794,44,0,2,9,0,26060,10676,2056,16582,0
51,1041,1098,241,925,5,10,155,1103,7,46,25,49,53,74,273,423,3,1580,87,0,2,3,0,26070,10678,2056,16583,0
51,1041,282,202,222,14,2,44,296,8,42,24,43,50,67,250,378,4,1548,86,0,2,3,0,26070,10679,2056,16584,0
47,2042,1178,367,1042,6,15,115,1184,9,94,51,95,103,146,644,976,4,4439,246,0,2,2,2,26070,10679,2056,16585,0
37,1422,1098,241,925,5,10,155,1103,7,46,25,49,53,74,273,423,3,1580,87,0,2,13,0,26080,10681,2056,16586,0
469,10259,72,33,56,0,4,12,72,1,1,1,1,2,2,0,2,0,1,0,0,2,7,0,26080,10681,2056,16587,1
469,10259,1454,835,1044,76,110,219,1530,17,275,158,296,292,454,2297,3718,9,34017,1889,1,2,7,0,26090,10682,2056,16588,1
11,239,256,139,192,9,7,47,265,4,23,12,24,27,36,112,171,2,357,19,0,2,1,0,26090,10683,2056,16589,1
88,1912,477,336,357,30,23,73,507,16,194,134,250,210,384,1538,2962,10,30538,1696,0,2,12,4,26100,10684,2056,16590,1
72,2650,1450,624,1228,12,26,181,1462,14,306,186,354,320,540,2580,4493,8,36391,2021,1,2,36,0,26100,10686,2057,16591,1
88,1912,477,336,357,30,23,73,507,16,194,134,250,210,384,1538,2962,10,30538,1696,0,2,12,4,26110,10687,2057,16592,0
72,2650,1450,624,1228,12,26,181,1462,14,306,186,354,320,540,2580,4493,8,36391,2021,1,2,36,0,26110,10689,2058,16593,0
469,10259,72,33,56,0,4,12,72,1,1,1,1,2,2,0,2,0,1,0,0,2,7,0,26110,10689,2058,16594,0
469,10259,1454,835,1044,76,110,219,1530,17,275,158,296,292,454,2297,3718,9,34017,1889,1,2,7,0,26120,10690,2058,16595,0
11,239,256,139,192,9,7,47,265,4,23,12,24,27,36,112,171,2,357,19,0,2,1,0,26120,10691,2058,16596,0
20,615,42,7,35,4,0,5,46,1,2,1,2,3,3,2,4,0,2,0,0,2,5,5,26130,10695,2059,16604,1
20,615,11,6,10,0,0,1,11,2,4,2,4,6,6,10,15,1,15,0,0,2,5,5,26130,10695,2059,16605,1
285,5722,1457,730,1242,11,6,188,1468,10,292,166,329,302,495,2424,4078,5,22973,1276,1,2,4,0,26130,10697,2059,16606,1
285,5722,74,35,59,1,0,14,75,3,14,7,14,17,21,58,85,1,128,7,0,2,4,0,26130,10698,2059,16607,1
285,5722,245,125,200,5,7,34,250,7,30,17,34,37,51,166,265,3,1053,58,0,2,4,0,26140,10699,2059,16608,1
170,3930,77,34,69,0,0,8,77,3,24,16,29,27,45,114,213,1,387,21,0,2,3,0,26140,10699,2059,16609,1
170,3930,712,438,573,51,9,84,763,14,102,71,128,116,199,733,1364,8,11988,666,0,2,3,0,26150,10700,2059,16610,1
30,1892,652,304,544,16,6,88,668,6,89,51,101,95,152,591,998,3,3399,188,0,2,6,0,26150,10701,2059,16611,1
30,1961,652,304,544,16,6,88,668,6,89,51,101,95,152,591,998,3,3399,188,0,2,1,0,26150,10702,2059,16612,0
30,1961,652,304,544,16,6,88,668,6,89,51,101,95,152,591,998,3,3399,188,0,2,1,0,26150,10703,2059,16613,0
285,5716,1457,730,1242,11,6,188,1468,10,292,166,329,302,495,2424,4078,5,22973,1276,1,2,1,1,26150,10705,2059,16614,0
285,5716,74,35,59,1,0,14,75,3,14,7,14,17,21,58,85,1,128,7,0,2,1,1,26150,10706,2059,16615,0
285,5716,245,125,200,5,7,34,250,7,30,17,34,37,51,166,265,3,1053,58,0,2,1,1,26160,10707,2059,16616,0
38,712,127,75,83,2,11,30,129,4,14,7,14,18,21,61,87,2,175,9,0,2,4,2,26160,10707,2059,16617,1
38,712,652,304,544,16,6,88,668,6,89,51,101,95,152,591,998,3,3399,188,0,2,4,2,26160,10708,2059,16618,1
38,712,2,2,2,0,0,0,2,0,0,0,0,0,0,0,0,0,0,0,0,2,4,2,26160,10708,2059,16618,1
38,712,8,5,5,0,0,3,8,0,0,0,0,0,0,0,0,0,0,0,0,2,4,2,26160,10708,2059,16619,1
38,712,2,2,2,0,0,0,2,0,0,0,0,0,0,0,0,0,0,0,0,2,4,2,26160,10708,2059,16619,1
38,712,14,8,8,0,0,6,14,0,0,0,0,0,0,0,0,0,0,0,0,2,4,2,26160,10708,2059,16620,1
38,712,6,4,4,0,0,2,6,0,0,0,0,0,0,0,0,0,0,0,0,2,4,2,26160,10708,2059,16621,1
38,712,6,4,4,0,0,2,6,1,2,1,2,3,3,2,4,0,2,0,0,2,4,2,26160,10708,2059,16622,1
38,712,6,4,4,0,0,2,6,0,0,0,0,0,0,0,0,0,0,0,0,2,4,2,26160,10708,2059,16623,1
38,712,7,5,5,0,0,2,7,0,0,0,0,0,0,0,0,0,0,0,0,2,4,2,26160,10708,2059,16624,1
38,712,6,4,4,0,0,2,6,0,0,0,0,0,0,0,0,0,0,0,0,2,4,2,26160,10708,2059,16625,1
38,712,10,6,6,0,0,4,10,0,0,0,0,0,0,0,0,0,0,0,0,2,4,2,26160,10708,2059,16626,1
38,712,1,1,1,0,0,0,1,0,0,0,0,0,0,0,0,0,0,0,0,2,4,2,26160,10708,2059,16626,1
38,712,14,10,10,0,0,4,14,1,1,1,1,2,2,0,2,0,1,0,0,2,4,2,26160,10708,2059,16627,1
38,712,46,26,30,3,0,12,49,3,6,3,6,9,9,20,28,1,42,2,0,2,4,2,26170,10708,2059,16628,1
88,1912,477,336,357,30,23,73,507,16,194,134,250,210,384,1538,2962,10,30538,1696,0,2,12,4,26180,10709,2059,16629,0
470,10279,72,33,56,0,4,12,72,1,1,1,1,2,2,0,2,0,1,0,0,2,7,0,26180,10709,2059,16630,0
470,10279,1454,835,1044,76,110,219,1530,17,275,158,296,292,454,2297,3718,9,34017,1889,1,2,7,0,26190,10710,2059,16631,0
20,617,42,7,35,4,0,5,46,1,2,1,2,3,3,2,4,0,2,0,0,2,1,1,26190,10710,2059,16632,0
20,617,11,6,10,0,0,1,11,2,4,2,4,6,6,10,15,1,15,0,0,2,1,1,26190,10710,2059,16633,0
11,239,256,139,192,9,7,47,265,4,23,12,24,27,36,112,171,2,357,19,0,2,1,0,26190,10711,2059,16634,0
72,2650,1450,624,1228,12,26,181,1462,14,306,186,354,320,540,2580,4493,8,36391,2021,1,2,36,0,26190,10713,2060,16635,0
29,1872,652,304,544,16,6,88,668,6,89,51,101,95,152,591,998,3,3399,188,0,2,1,0,26190,10714,2060,16636,0
285,5716,1457,730,1242,11,6,188,1468,10,292,166,329,302,495,2424,4078,5,22973,1276,1,2,4,0,26190,10716,2060,16637,0
285,5716,74,35,59,1,0,14,75,3,14,7,14,17,21,58,85,1,128,7,0,2,4,0,26190,10717,2060,16638,0
285,5716,245,125,200,5,7,34,250,7,30,17,34,37,51,166,265,3,1053,58,0,2,4,0,26200,10718,2060,16639,0
170,3930,77,34,69,0,0,8,77,3,24,16,29,27,45,114,213,1,387,21,0,2,3,0,26200,10718,2060,16640,0
170,3930,712,438,573,51,9,84,763,14,102,71,128,116,199,733,1364,8,11988,666,0,2,3,0,26210,10719,2060,16641,0
30,1903,652,304,544,16,6,88,668,6,89,51,101,95,152,591,998,3,3399,188,0,2,6,0,26210,10720,2060,16642,0
286,5730,1457,730,1242,11,6,188,1468,10,292,166,329,302,495,2424,4078,5,22973,1276,1,2,24,0,26210,10722,2060,16643,1
286,5730,74,35,59,1,0,14,75,3,14,7,14,17,21,58,85,1,128,7,0,2,24,0,26210,10723,2060,16644,1
286,5730,245,125,200,5,7,34,250,7,30,17,34,37,51,166,265,3,1053,58,0,2,24,0,26220,10724,2060,16645,1
67,2756,1289,550,1043,56,32,155,1345,10,167,93,185,177,278,1266,2075,5,11498,638,0,2,6,0,26220,10726,2061,16646,1
18,440,386,256,301,16,9,68,402,4,59,35,69,63,104,355,621,2,1453,80,0,2,2,2,26220,10726,2061,16647,0
18,440,264,131,164,11,41,46,275,6,38,22,40,44,62,214,338,3,1068,59,0,2,2,2,26230,10726,2062,16648,0
12,397,386,256,301,16,9,68,402,4,59,35,69,63,104,355,621,2,1453,80,0,2,4,4,26230,10726,2062,16649,0
12,442,386,256,301,16,9,68,402,4,59,35,69,63,104,355,621,2,1453,80,0,2,6,2,26230,10726,2062,16650,0
170,3536,1943,715,1694,26,18,214,1969,12,185,120,237,197,357,1436,2721,7,20915,1161,0,2,22,19,26230,10728,2062,16651,1
170,3536,1168,838,957,57,25,144,1225,19,348,224,416,367,640,3018,5452,11,61921,3440,1,2,22,19,26240,10730,2062,16652,1
63,3152,1943,715,1694,26,18,214,1969,12,185,120,237,197,357,1436,2721,7,20915,1161,0,2,53,0,26240,10732,2062,16653,1
63,3178,1943,715,1694,26,18,214,1969,12,185,120,237,197,357,1436,2721,7,20915,1161,0,2,3,0,26240,10734,2062,16654,0
63,3215,1943,715,1694,26,18,214,1969,12,185,120,237,197,357,1436,2721,7,20915,1161,0,2,4,0,26240,10736,2062,16655,0
170,3536,1943,715,1694,26,18,214,1969,12,185,120,237,197,357,1436,2721,7,20915,1161,0,2,5,5,26240,10738,2062,16656,1
170,3536,1168,838,957,57,25,144,1225,19,348,224,416,367,640,3018,5452,11,61921,3440,1,2,5,5,26250,10740,2062,16657,1
170,3536,1943,715,1694,26,18,214,1969,12,185,120,237,197,357,1436,2721,7,20915,1161,0,2,1,1,26250,10742,2062,16658,1
170,3536,1168,838,957,57,25,144,1225,19,348,224,416,367,640,3018,5452,11,61921,3440,1,2,1,1,26260,10744,2062,16659,1
172,3552,1943,715,1694,26,18,214,1969,12,185,120,237,197,357,1436,2721,7,20915,1161,0,2,4,0,26260,10746,2062,16660,0
172,3552,1168,838,957,57,25,144,1225,19,348,224,416,367,640,3018,5452,11,61921,3440,1,2,4,0,26270,10748,2062,16661,0
63,3215,1943,715,1694,26,18,214,1969,12,185,120,237,197,357,1436,2721,7,20915,1161,0,2,4,4,26270,10750,2062,16662,0
173,3560,1943,715,1694,26,18,214,1969,12,185,120,237,197,357,1436,2721,7,20915,1161,0,2,3,1,26270,10752,2062,16663,0
173,3560,1168,838,957,57,25,144,1225,19,348,224,416,367,640,3018,5452,11,61921,3440,1,2,3,1,26280,10754,2062,16664,0
63,3215,1943,715,1694,26,18,214,1969,12,185,120,237,197,357,1436,2721,7,20915,1161,0,2,13,7,26280,10756,2062,16665,0
63,3215,1943,715,1694,26,18,214,1969,12,185,120,237,197,357,1436,2721,7,20915,1161,0,2,25,25,26280,10758,2062,16666,1
47,1407,1523,757,1297,19,12,193,1542,12,193,117,230,205,347,1508,2664,7,19053,1058,0,2,11,5,26290,10760,2062,16667,1
47,1407,701,378,504,33,58,109,734,13,110,68,126,123,194,794,1346,7,10027,557,0,2,11,5,26290,10761,2063,16668,1
41,2655,1523,757,1297,19,12,193,1542,12,193,117,230,205,347,1508,2664,7,19053,1058,0,2,25,0,26300,10763,2063,16669,1
47,1407,1523,757,1297,19,12,193,1542,12,193,117,230,205,347,1508,2664,7,19053,1058,0,2,11,5,26310,10765,2063,16670,0
47,1407,701,378,504,33,58,109,734,13,110,68,126,123,194,794,1346,7,10027,557,0,2,11,5,26310,10766,2064,16671,0
41,2655,1523,757,1297,19,12,193,1542,12,193,117,230,205,347,1508,2664,7,19053,1058,0,2,25,0,26320,10768,2064,16672,0
173,3560,1943,715,1694,26,18,214,1969,12,185,120,237,197,357,1436,2721,7,20915,1161,0,2,28,19,26320,10770,2064,16673,0
173,3560,1168,838,957,57,25,144,1225,19,348,224,416,367,640,3018,5452,11,61921,3440,1,2,28,19,26330,10772,2064,16674,0
63,3215,1943,715,1694,26,18,214,1969,12,185,120,237,197,357,1436,2721,7,20915,1161,0,2,66,0,26330,10774,2064,16675,0
41,2660,1523,757,1297,19,12,193,1542,12,193,117,230,205,347,1508,2664,7,19053,1058,0,2,1,1,26340,10776,2064,16676,0
286,5730,1457,730,1242,11,6,188,1468,10,292,166,329,302,495,2424,4078,5,22973,1276,1,2,24,0,26340,10778,2064,16677,0
286,5730,74,35,59,1,0,14,75,3,14,7,14,17,21,58,85,1,128,7,0,2,24,0,26340,10779,2064,16678,0
286,5730,245,125,200,5,7,34,250,7,30,17,34,37,51,166,265,3,1053,58,0,2,24,0,26350,10780,2064,16679,0
67,2756,1289,550,1043,56,32,155,1345,10,167,93,185,177,278,1266,2075,5,11498,638,0,2,6,0,26350,10782,2065,16680,0
470,10280,72,33,56,0,4,12,72,1,1,1,1,2,2,0,2,0,1,0,0,2,21,0,26350,10782,2065,16681,1
470,10280,1454,835,1044,76,110,219,1530,17,275,158,296,292,454,2297,3718,9,34017,1889,1,2,21,0,26360,10783,2065,16682,1
470,10280,72,33,56,0,4,12,72,1,1,1,1,2,2,0,2,0,1,0,0,2,21,0,26360,10783,2065,16683,0
470,10280,1454,835,1044,76,110,219,1530,17,275,158,296,292,454,2297,3718,9,34017,1889,1,2,21,0,26370,10784,2065,16684,0
288,5751,1457,730,1242,11,6,188,1468,10,292,166,329,302,495,2424,4078,5,22973,1276,1,2,5,1,26370,10786,2065,16685,1
288,5751,74,35,59,1,0,14,75,3,14,7,14,17,21,58,85,1,128,7,0,2,5,1,26370,10787,2065,16686,1
288,5751,245,125,200,5,7,34,250,7,30,17,34,37,51,166,265,3,1053,58,0,2,5,1,26380,10788,2065,16687,1
170,3947,77,34,69,0,0,8,77,3,24,16,29,27,45,114,213,1,387,21,0,2,2,0,26380,10788,2065,16688,1
170,3947,712,438,573,51,9,84,763,14,102,71,128,116,199,733,1364,8,11988,666,0,2,2,0,26390,10789,2065,16689,1
53,2991,1296,573,1062,40,33,157,1336,8,201,118,231,209,349,1561,2689,4,12365,686,0,2,29,0,26390,10789,2065,16690,1
288,5813,1457,730,1242,11,6,188,1468,10,292,166,329,302,495,2424,4078,5,22973,1276,1,2,19,5,26390,10791,2065,16691,0
288,5813,74,35,59,1,0,14,75,3,14,7,14,17,21,58,85,1,128,7,0,2,19,5,26390,10792,2065,16692,0
288,5813,245,125,200,5,7,34,250,7,30,17,34,37,51,166,265,3,1053,58,0,2,19,5,26400,10793,2065,16693,0
48,2366,1457,730,1242,11,6,188,1468,10,292,166,329,302,495,2424,4078,5,22973,1276,1,2,13,0,26400,10795,2065,16694,0
288,5751,1457,730,1242,11,6,188,1468,10,292,166,329,302,495,2424,4078,5,22973,1276,1,2,5,1,26400,10797,2065,16695,0
288,5751,74,35,59,1,0,14,75,3,14,7,14,17,21,58,85,1,128,7,0,2,5,1,26400,10798,2065,16696,0
288,5751,245,125,200,5,7,34,250,7,30,17,34,37,51,166,265,3,1053,58,0,2,5,1,26410,10799,2065,16697,0
170,3947,77,34,69,0,0,8,77,3,24,16,29,27,45,114,213,1,387,21,0,2,2,0,26410,10799,2065,16698,0
170,3947,712,438,573,51,9,84,763,14,102,71,128,116,199,733,1364,8,11988,666,0,2,2,0,26420,10800,2065,16699,0
53,2991,1296,573,1062,40,33,157,1336,8,201,118,231,209,349,1561,2689,4,12365,686,0,2,29,0,26420,10800,2065,16700,0
290,5834,1457,730,1242,11,6,188,1468,10,292,166,329,302,495,2424,4078,5,22973,1276,1,2,19,5,26420,10802,2065,16701,0
290,5834,74,35,59,1,0,14,75,3,14,7,14,17,21,58,85,1,128,7,0,2,19,5,26420,10803,2065,16702,0
290,5834,245,125,200,5,7,34,250,7,30,17,34,37,51,166,265,3,1053,58,0,2,19,5,26430,10804,2065,16703,0
48,2366,1457,730,1242,11,6,188,1468,10,292,166,329,302,495,2424,4078,5,22973,1276,1,2,13,0,26430,10806,2065,16704,0
142,4468,1660,832,1314,41,38,274,1701,20,312,209,395,332,604,2671,5058,12,64042,3557,1,2,6,0,26430,10808,2066,16706,1
142,4468,1057,646,719,113,100,145,1170,18,215,134,248,233,382,1740,3004,10,31186,1732,1,2,6,0,26440,10809,2067,16707,1
135,3512,1660,832,1314,41,38,274,1701,20,312,209,395,332,604,2671,5058,12,64042,3557,1,2,15,0,26440,10811,2068,16709,1
468,10189,72,33,56,0,4,12,72,1,1,1,1,2,2,0,2,0,1,0,0,2,1,9,26440,10811,2068,16710,0
468,10189,1454,835,1044,76,110,219,1530,17,275,158,296,292,454,2297,3718,9,34017,1889,1,2,1,9,26450,10812,2068,16711,0
137,6066,139,89,101,2,0,35,141,7,54,34,62,61,96,330,569,4,2287,127,0,2,38,0,26450,10812,2068,16712,0
137,6066,7,5,5,0,0,2,7,1,2,1,2,3,3,2,4,0,2,0,0,2,38,0,26450,10812,2068,16713,0
142,4468,1660,832,1314,41,38,274,1701,20,312,209,395,332,604,2671,5058,12,64042,3557,1,2,6,0,26450,10814,2069,16715,0
142,4468,1057,646,719,113,100,145,1170,18,215,134,248,233,382,1740,3004,10,31186,1732,1,2,6,0,26460,10815,2070,16716,0
135,3512,1660,832,1314,41,38,274,1701,20,312,209,395,332,604,2671,5058,12,64042,3557,1,2,15,0,26460,10817,2071,16718,0
32,1014,1455,414,1257,16,76,112,1471,5,41,23,46,46,69,231,381,2,1069,59,0,2,20,14,26460,10818,2071,16719,1
32,1014,669,365,481,22,61,110,691,15,103,63,122,118,185,747,1273,8,11311,628,0,2,20,14,26470,10818,2072,16720,1
30,1250,1455,414,1257,16,76,112,1471,5,41,23,46,46,69,231,381,2,1069,59,0,2,33,0,26470,10819,2072,16721,1
468,10189,72,33,56,0,4,12,72,1,1,1,1,2,2,0,2,0,1,0,0,2,1,9,26470,10819,2072,16722,0
468,10189,1454,835,1044,76,110,219,1530,17,275,158,296,292,454,2297,3718,9,34017,1889,1,2,1,9,26480,10820,2072,16723,0
137,6066,139,89,101,2,0,35,141,7,54,34,62,61,96,330,569,4,2287,127,0,2,38,0,26480,10820,2072,16724,0
137,6066,7,5,5,0,0,2,7,1,2,1,2,3,3,2,4,0,2,0,0,2,38,0,26480,10820,2072,16725,0
32,1014,1455,414,1257,16,76,112,1471,5,41,23,46,46,69,231,381,2,1069,59,0,2,20,14,26480,10821,2072,16726,0
32,1014,669,365,481,22,61,110,691,15,103,63,122,118,185,747,1273,8,11311,628,0,2,20,14,26490,10821,2073,16727,0
30,1250,1455,414,1257,16,76,112,1471,5,41,23,46,46,69,231,381,2,1069,59,0,2,33,0,26490,10822,2073,16728,0
147,4753,1660,832,1314,41,38,274,1701,20,312,209,395,332,604,2671,5058,12,64042,3557,1,2,57,5,26490,10824,2074,16730,1
147,4753,1057,646,719,113,100,145,1170,18,215,134,248,233,382,1740,3004,10,31186,1732,1,2,57,5,26500,10825,2075,16731,1
147,4710,1660,832,1314,41,38,274,1701,20,312,209,395,332,604,2671,5058,12,64042,3557,1,2,4,8,26500,10827,2076,16733,0
147,4710,1057,646,719,113,100,145,1170,18,215,134,248,233,382,1740,3004,10,31186,1732,1,2,4,8,26510,10828,2077,16734,0
170,3950,77,34,69,0,0,8,77,3,24,16,29,27,45,114,213,1,387,21,0,2,5,3,26510,10828,2077,16735,1
170,3950,712,438,573,51,9,84,763,14,102,71,128,116,199,733,1364,8,11988,666,0,2,5,3,26520,10829,2077,16736,1
147,4716,1660,832,1314,41,38,274,1701,20,312,209,395,332,604,2671,5058,12,64042,3557,1,2,6,4,26520,10831,2078,16738,0
147,4716,1057,646,719,113,100,145,1170,18,215,134,248,233,382,1740,3004,10,31186,1732,1,2,6,4,26530,10832,2079,16739,0
216,4838,722,423,573,19,0,135,741,12,172,101,199,184,300,1320,2257,6,15668,870,0,2,8,6,26530,10834,2079,16741,1
216,4838,1508,847,911,44,250,301,1552,14,148,88,169,162,257,1120,1886,7,15077,837,0,2,8,6,26530,10835,2080,16742,1
13,397,442,244,305,14,16,103,456,11,68,45,75,79,120,452,756,6,4588,254,0,2,31,4,26530,10837,2080,16743,1
13,397,182,102,99,11,40,35,193,3,11,6,11,14,17,42,64,1,97,5,0,2,31,4,26530,10838,2080,16744,1
136,6023,139,89,101,2,0,35,141,7,54,34,62,61,96,330,569,4,2287,127,0,2,2,1,26530,10838,2080,16745,1
136,6023,7,5,5,0,0,2,7,1,2,1,2,3,3,2,4,0,2,0,0,2,2,1,26530,10838,2080,16746,1
30,1907,652,304,544,16,6,88,668,6,89,51,101,95,152,591,998,3,3399,188,0,2,2,2,26530,10839,2080,16747,1
7,514,442,244,305,14,16,103,456,11,68,45,75,79,120,452,756,6,4588,254,0,2,18,17,26530,10841,2080,16748,1
7,524,442,244,305,14,16,103,456,11,68,45,75,79,120,452,756,6,4588,254,0,2,3,1,26530,10843,2080,16749,1
147,4716,1660,832,1314,41,38,274,1701,20,312,209,395,332,604,2671,5058,12,64042,3557,1,2,2,2,26530,10845,2081,16751,1
147,4716,1057,646,719,113,100,145,1170,18,215,134,248,233,382,1740,3004,10,31186,1732,1,2,2,2,26540,10846,2082,16752,1
68,1230,1020,354,843,12,15,144,1032,8,134,77,144,142,221,970,1580,4,6792,377,0,2,11,8,26540,10846,2082,16753,1
62,2551,1020,354,843,12,15,144,1032,8,134,77,144,142,221,970,1580,4,6792,377,0,2,55,0,26540,10846,2082,16754,1
12,410,442,244,305,14,16,103,456,11,68,45,75,79,120,452,756,6,4588,254,0,2,8,1,26540,10848,2082,16755,0
12,410,182,102,99,11,40,35,193,3,11,6,11,14,17,42,64,1,97,5,0,2,8,1,26540,10849,2082,16756,0
216,4838,722,423,573,19,0,135,741,12,172,101,199,184,300,1320,2257,6,15668,870,0,2,8,6,26540,10851,2082,16758,0
216,4838,1508,847,911,44,250,301,1552,14,148,88,169,162,257,1120,1886,7,15077,837,0,2,8,6,26540,10852,2083,16759,0
13,397,442,244,305,14,16,103,456,11,68,45,75,79,120,452,756,6,4588,254,0,2,31,4,26540,10854,2083,16760,0
13,397,182,102,99,11,40,35,193,3,11,6,11,14,17,42,64,1,97,5,0,2,31,4,26540,10855,2083,16761,0
136,6023,139,89,101,2,0,35,141,7,54,34,62,61,96,330,569,4,2287,127,0,2,2,1,26540,10855,2083,16762,0
136,6023,7,5,5,0,0,2,7,1,2,1,2,3,3,2,4,0,2,0,0,2,2,1,26540,10855,2083,16763,0
30,1907,652,304,544,16,6,88,668,6,89,51,101,95,152,591,998,3,3399,188,0,2,2,2,26540,10856,2083,16764,0
7,524,442,244,305,14,16,103,456,11,68,45,75,79,120,452,756,6,4588,254,0,2,20,17,26540,10858,2083,16765,0
474,10327,72,33,56,0,4,12,72,1,1,1,1,2,2,0,2,0,1,0,0,2,25,5,26540,10858,2083,16766,1
474,10327,1454,835,1044,76,110,219,1530,17,275,158,296,292,454,2297,3718,9,34017,1889,1,2,25,5,26550,10859,2083,16767,1
65,2998,1338,495,1086,10,64,173,1348,11,122,82,157,133,239,883,1686,7,11934,663,0,2,44,0,26550,10861,2083,16768,1
473,10292,72,33,56,0,4,12,72,1,1,1,1,2,2,0,2,0,1,0,0,2,4,6,26550,10861,2083,16769,1
473,10292,1454,835,1044,76,110,219,1530,17,275,158,296,292,454,2297,3718,9,34017,1889,1,2,4,6,26560,10862,2083,16770,1
147,4716,1660,832,1314,41,38,274,1701,20,312,209,395,332,604,2671,5058,12,64042,3557,1,2,55,5,26560,10864,2084,16772,0
147,4716,1057,646,719,113,100,145,1170,18,215,134,248,233,382,1740,3004,10,31186,1732,1,2,55,5,26570,10865,2085,16773,0
170,3950,77,34,69,0,0,8,77,3,24,16,29,27,45,114,213,1,387,21,0,2,5,3,26570,10865,2085,16774,0
170,3950,712,438,573,51,9,84,763,14,102,71,128,116,199,733,1364,8,11988,666,0,2,5,3,26580,10866,2085,16775,0
146,4728,1660,832,1314,41,38,274,1701,20,312,209,395,332,604,2671,5058,12,64042,3557,1,2,57,5,26580,10868,2086,16777,1
146,4728,1057,646,719,113,100,145,1170,18,215,134,248,233,382,1740,3004,10,31186,1732,1,2,57,5,26590,10869,2087,16778,1
146,4685,1660,832,1314,41,38,274,1701,20,312,209,395,332,604,2671,5058,12,64042,3557,1,2,4,8,26590,10871,2088,16780,0
146,4685,1057,646,719,113,100,145,1170,18,215,134,248,233,382,1740,3004,10,31186,1732,1,2,4,8,26600,10872,2089,16781,0
172,3928,77,34,69,0,0,8,77,3,24,16,29,27,45,114,213,1,387,21,0,2,5,3,26600,10872,2089,16782,0
172,3928,712,438,573,51,9,84,763,14,102,71,128,116,199,733,1364,8,11988,666,0,2,5,3,26610,10873,2089,16783,0
146,4691,1660,832,1314,41,38,274,1701,20,312,209,395,332,604,2671,5058,12,64042,3557,1,2,6,4,26610,10875,2090,16785,0
146,4691,1057,646,719,113,100,145,1170,18,215,134,248,233,382,1740,3004,10,31186,1732,1,2,6,4,26620,10876,2091,16786,0
146,4691,1660,832,1314,41,38,274,1701,20,312,209,395,332,604,2671,5058,12,64042,3557,1,2,2,2,26620,10878,2092,16788,0
146,4691,1057,646,719,113,100,145,1170,18,215,134,248,233,382,1740,3004,10,31186,1732,1,2,2,2,26630,10879,2093,16789,0
146,4691,1660,832,1314,41,38,274,1701,20,312,209,395,332,604,2671,5058,12,64042,3557,1,2,55,5,26630,10881,2094,16791,0
146,4691,1057,646,719,113,100,145,1170,18,215,134,248,233,382,1740,3004,10,31186,1732,1,2,55,5,26640,10882,2095,16792,0
172,3928,77,34,69,0,0,8,77,3,24,16,29,27,45,114,213,1,387,21,0,2,5,3,26640,10882,2095,16793,0
172,3928,712,438,573,51,9,84,763,14,102,71,128,116,199,733,1364,8,11988,666,0,2,5,3,26650,10883,2095,16794,0
250,5035,1457,730,1242,11,6,188,1468,10,292,166,329,302,495,2424,4078,5,22973,1276,1,2,13,0,26650,10885,2095,16795,1
250,5035,74,35,59,1,0,14,75,3,14,7,14,17,21,58,85,1,128,7,0,2,13,0,26650,10886,2095,16796,1
250,5035,245,125,200,5,7,34,250,7,30,17,34,37,51,166,265,3,1053,58,0,2,13,0,26660,10887,2095,16797,1
24,755,74,35,59,1,0,14,75,3,14,7,14,17,21,58,85,1,128,7,0,2,2,1,26660,10888,2095,16798,1
24,755,245,125,200,5,7,34,250,7,30,17,34,37,51,166,265,3,1053,58,0,2,2,1,26670,10889,2095,16799,1
68,1235,1020,354,843,12,15,144,1032,8,134,77,144,142,221,970,1580,4,6792,377,0,2,2,1,26670,10889,2095,16800,1
21,574,1293,570,1093,25,15,163,1318,10,195,123,241,205,364,1516,2795,6,17273,959,0,2,5,1,26680,10891,2095,16801,1
473,10297,72,33,56,0,4,12,72,1,1,1,1,2,2,0,2,0,1,0,0,2,2,1,26680,10891,2095,16802,1
473,10297,1454,835,1044,76,110,219,1530,17,275,158,296,292,454,2297,3718,9,34017,1889,1,2,2,1,26690,10892,2095,16803,1
166,3485,1943,715,1694,26,18,214,1969,12,185,120,237,197,357,1436,2721,7,20915,1161,0,2,3,5,26690,10894,2095,16804,1
166,3485,1168,838,957,57,25,144,1225,19,348,224,416,367,640,3018,5452,11,61921,3440,1,2,3,5,26700,10896,2095,16805,1
138,6100,139,89,101,2,0,35,141,7,54,34,62,61,96,330,569,4,2287,127,0,2,5,0,26700,10896,2095,16806,1
138,6100,7,5,5,0,0,2,7,1,2,1,2,3,3,2,4,0,2,0,0,2,5,0,26700,10896,2095,16807,1
90,1642,1178,367,1042,6,15,115,1184,9,94,51,95,103,146,644,976,4,4439,246,0,2,26,14,26700,10896,2095,16808,1
90,1642,177,108,140,8,0,27,185,6,30,16,32,36,48,162,248,3,794,44,0,2,26,14,26700,10898,2095,16809,1
48,2142,1178,367,1042,6,15,115,1184,9,94,51,95,103,146,644,976,4,4439,246,0,2,20,0,26700,10898,2095,16810,1
68,1233,1020,354,843,12,15,144,1032,8,134,77,144,142,221,970,1580,4,6792,377,0,2,0,1,26700,10898,2095,16811,0
21,572,1293,570,1093,25,15,163,1318,10,195,123,241,205,364,1516,2795,6,17273,959,0,2,0,1,26710,10900,2095,16812,0
90,1642,1178,367,1042,6,15,115,1184,9,94,51,95,103,146,644,976,4,4439,246,0,2,26,14,26710,10900,2095,16813,0
90,1642,177,108,140,8,0,27,185,6,30,16,32,36,48,162,248,3,794,44,0,2,26,14,26710,10902,2095,16814,0
48,2142,1178,367,1042,6,15,115,1184,9,94,51,95,103,146,644,976,4,4439,246,0,2,20,0,26710,10902,2095,16815,0
68,1230,1020,354,843,12,15,144,1032,8,134,77,144,142,221,970,1580,4,6792,377,0,2,11,8,26710,10902,2095,16816,1
474,10313,72,33,56,0,4,12,72,1,1,1,1,2,2,0,2,0,1,0,0,2,24,15,26710,10902,2095,16817,1
474,10313,1454,835,1044,76,110,219,1530,17,275,158,296,292,454,2297,3718,9,34017,1889,1,2,24,15,26720,10903,2095,16818,1
18,440,386,256,301,16,9,68,402,4,59,35,69,63,104,355,621,2,1453,80,0,2,2,2,26720,10903,2095,16819,1
18,440,264,131,164,11,41,46,275,6,38,22,40,44,62,214,338,3,1068,59,0,2,2,2,26730,10903,2096,16820,1
90,1648,1178,367,1042,6,15,115,1184,9,94,51,95,103,146,644,976,4,4439,246,0,2,26,14,26730,10903,2096,16821,1
90,1648,177,108,140,8,0,27,185,6,30,16,32,36,48,162,248,3,794,44,0,2,26,14,26730,10905,2096,16822,1
13,436,442,244,305,14,16,103,456,11,68,45,75,79,120,452,756,6,4588,254,0,2,8,1,26730,10907,2096,16823,1
13,436,182,102,99,11,40,35,193,3,11,6,11,14,17,42,64,1,97,5,0,2,8,1,26730,10908,2096,16824,1
66,3113,1338,495,1086,10,64,173,1348,11,122,82,157,133,239,883,1686,7,11934,663,0,2,44,0,26730,10910,2096,16825,1
137,6064,139,89,101,2,0,35,141,7,54,34,62,61,96,330,569,4,2287,127,0,2,38,0,26730,10910,2096,16826,1
137,6064,7,5,5,0,0,2,7,1,2,1,2,3,3,2,4,0,2,0,0,2,38,0,26730,10910,2096,16827,1
62,2551,1020,354,843,12,15,144,1032,8,134,77,144,142,221,970,1580,4,6792,377,0,2,55,0,26730,10910,2096,16828,1
12,442,386,256,301,16,9,68,402,4,59,35,69,63,104,355,621,2,1453,80,0,2,8,4,26730,10910,2096,16829,1
48,2142,1178,367,1042,6,15,115,1184,9,94,51,95,103,146,644,976,4,4439,246,0,2,20,0,26730,10910,2096,16830,1
474,10299,72,33,56,0,4,12,72,1,1,1,1,2,2,0,2,0,1,0,0,2,12,8,26730,10910,2096,16831,1
474,10299,1454,835,1044,76,110,219,1530,17,275,158,296,292,454,2297,3718,9,34017,1889,1,2,12,8,26740,10911,2096,16832,1
37,1461,1098,241,925,5,10,155,1103,7,46,25,49,53,74,273,423,3,1580,87,0,2,10,5,26750,10913,2096,16833,1
16,482,184,100,137,2,15,30,186,6,38,20,39,44,59,214,322,3,991,55,0,2,2,1,26750,10914,2096,16834,0
16,482,103,65,74,8,5,16,111,7,17,9,17,24,26,89,119,3,417,23,0,2,2,1,26750,10915,2096,16835,0
16,480,184,100,137,2,15,30,186,6,38,20,39,44,59,214,322,3,991,55,0,2,1,1,26750,10916,2096,16836,0
16,480,103,65,74,8,5,16,111,7,17,9,17,24,26,89,119,3,417,23,0,2,1,1,26750,10917,2096,16837,0
474,10299,72,33,56,0,4,12,72,1,1,1,1,2,2,0,2,0,1,0,0,2,12,8,26750,10917,2096,16838,0
474,10299,1454,835,1044,76,110,219,1530,17,275,158,296,292,454,2297,3718,9,34017,1889,1,2,12,8,26760,10918,2096,16839,0
37,1461,1098,241,925,5,10,155,1103,7,46,25,49,53,74,273,423,3,1580,87,0,2,10,5,26770,10920,2096,16840,0
250,5035,1457,730,1242,11,6,188,1468,10,292,166,329,302,495,2424,4078,5,22973,1276,1,2,13,0,26770,10922,2096,16841,0
250,5035,74,35,59,1,0,14,75,3,14,7,14,17,21,58,85,1,128,7,0,2,13,0,26770,10923,2096,16842,0
250,5035,245,125,200,5,7,34,250,7,30,17,34,37,51,166,265,3,1053,58,0,2,13,0,26780,10924,2096,16843,0
24,755,74,35,59,1,0,14,75,3,14,7,14,17,21,58,85,1,128,7,0,2,2,1,26780,10925,2096,16844,0
24,755,245,125,200,5,7,34,250,7,30,17,34,37,51,166,265,3,1053,58,0,2,2,1,26790,10926,2096,16845,0
68,1233,1020,354,843,12,15,144,1032,8,134,77,144,142,221,970,1580,4,6792,377,0,2,2,2,26790,10926,2096,16846,0
16,480,184,100,137,2,15,30,186,6,38,20,39,44,59,214,322,3,991,55,0,2,3,2,26790,10927,2096,16847,0
16,480,103,65,74,8,5,16,111,7,17,9,17,24,26,89,119,3,417,23,0,2,3,2,26790,10928,2096,16848,0
21,572,1293,570,1093,25,15,163,1318,10,195,123,241,205,364,1516,2795,6,17273,959,0,2,5,2,26800,10930,2096,16849,0
474,10304,72,33,56,0,4,12,72,1,1,1,1,2,2,0,2,0,1,0,0,2,2,1,26800,10930,2096,16850,0
474,10304,1454,835,1044,76,110,219,1530,17,275,158,296,292,454,2297,3718,9,34017,1889,1,2,2,1,26810,10931,2096,16851,0
166,3485,1943,715,1694,26,18,214,1969,12,185,120,237,197,357,1436,2721,7,20915,1161,0,2,3,5,26810,10933,2096,16852,0
166,3485,1168,838,957,57,25,144,1225,19,348,224,416,367,640,3018,5452,11,61921,3440,1,2,3,5,26820,10935,2096,16853,0
138,6100,139,89,101,2,0,35,141,7,54,34,62,61,96,330,569,4,2287,127,0,2,5,0,26820,10935,2096,16854,0
138,6100,7,5,5,0,0,2,7,1,2,1,2,3,3,2,4,0,2,0,0,2,5,0,26820,10935,2096,16855,0
293,5891,1457,730,1242,11,6,188,1468,10,292,166,329,302,495,2424,4078,5,22973,1276,1,2,12,0,26820,10937,2096,16856,0
293,5891,74,35,59,1,0,14,75,3,14,7,14,17,21,58,85,1,128,7,0,2,12,0,26820,10938,2096,16857,0
293,5891,245,125,200,5,7,34,250,7,30,17,34,37,51,166,265,3,1053,58,0,2,12,0,26830,10939,2096,16858,0
23,754,74,35,59,1,0,14,75,3,14,7,14,17,21,58,85,1,128,7,0,2,2,1,26830,10940,2096,16859,0
23,754,245,125,200,5,7,34,250,7,30,17,34,37,51,166,265,3,1053,58,0,2,2,1,26840,10941,2096,16860,0
68,1233,1020,354,843,12,15,144,1032,8,134,77,144,142,221,970,1580,4,6792,377,0,2,2,2,26840,10941,2096,16861,0
16,483,184,100,137,2,15,30,186,6,38,20,39,44,59,214,322,3,991,55,0,2,3,2,26840,10942,2096,16862,0
16,483,103,65,74,8,5,16,111,7,17,9,17,24,26,89,119,3,417,23,0,2,3,2,26840,10943,2096,16863,0
21,572,1293,570,1093,25,15,163,1318,10,195,123,241,205,364,1516,2795,6,17273,959,0,2,5,2,26850,10945,2096,16864,0
475,10325,72,33,56,0,4,12,72,1,1,1,1,2,2,0,2,0,1,0,0,2,14,9,26850,10945,2096,16865,0
475,10325,1454,835,1044,76,110,219,1530,17,275,158,296,292,454,2297,3718,9,34017,1889,1,2,14,9,26860,10946,2096,16866,0
171,3530,1943,715,1694,26,18,214,1969,12,185,120,237,197,357,1436,2721,7,20915,1161,0,2,3,5,26860,10948,2096,16867,0
171,3530,1168,838,957,57,25,144,1225,19,348,224,416,367,640,3018,5452,11,61921,3440,1,2,3,5,26870,10950,2096,16868,0
138,6098,139,89,101,2,0,35,141,7,54,34,62,61,96,330,569,4,2287,127,0,2,5,0,26870,10950,2096,16869,0
138,6098,7,5,5,0,0,2,7,1,2,1,2,3,3,2,4,0,2,0,0,2,5,0,26870,10950,2096,16870,0
37,1461,1098,241,925,5,10,155,1103,7,46,25,49,53,74,273,423,3,1580,87,0,2,10,5,26880,10952,2096,16871,0
295,5925,1457,730,1242,11,6,188,1468,10,292,166,329,302,495,2424,4078,5,22973,1276,1,2,3,0,26880,10954,2096,16872,1
295,5925,74,35,59,1,0,14,75,3,14,7,14,17,21,58,85,1,128,7,0,2,3,0,26880,10955,2096,16873,1
295,5925,245,125,200,5,7,34,250,7,30,17,34,37,51,166,265,3,1053,58,0,2,3,0,26890,10956,2096,16874,1
34,2100,652,304,544,16,6,88,668,6,89,51,101,95,152,591,998,3,3399,188,0,2,41,0,26890,10957,2096,16875,1
251,5055,1457,730,1242,11,6,188,1468,10,292,166,329,302,495,2424,4078,5,22973,1276,1,2,4,1,26890,10959,2096,16876,1
251,5055,74,35,59,1,0,14,75,3,14,7,14,17,21,58,85,1,128,7,0,2,4,1,26890,10960,2096,16877,1
251,5055,245,125,200,5,7,34,250,7,30,17,34,37,51,166,265,3,1053,58,0,2,4,1,26900,10961,2096,16878,1
67,2827,1289,550,1043,56,32,155,1345,10,167,93,185,177,278,1266,2075,5,11498,638,0,2,16,0,26900,10963,2097,16879,1
113,2501,1043,504,840,53,9,147,1096,9,180,112,198,189,310,1377,2344,4,11604,644,0,2,3,5,26900,10965,2097,16880,1
113,2501,383,288,292,26,6,62,409,11,65,38,67,76,105,429,656,5,3719,206,0,2,3,5,26900,10966,2097,16881,1
55,2166,1043,504,840,53,9,147,1096,9,180,112,198,189,310,1377,2344,4,11604,644,0,2,13,0,26900,10968,2097,16882,1
55,2176,1043,504,840,53,9,147,1096,9,180,112,198,189,310,1377,2344,4,11604,644,0,2,4,4,26900,10970,2097,16883,1
113,2501,1043,504,840,53,9,147,1096,9,180,112,198,189,310,1377,2344,4,11604,644,0,2,3,5,26900,10972,2097,16884,0
113,2501,383,288,292,26,6,62,409,11,65,38,67,76,105,429,656,5,3719,206,0,2,3,5,26900,10973,2097,16885,0
55,2176,1043,504,840,53,9,147,1096,9,180,112,198,189,310,1377,2344,4,11604,644,0,2,15,2,26900,10975,2097,16886,0
39,719,127,75,83,2,11,30,129,4,14,7,14,18,21,61,87,2,175,9,0,2,7,1,26900,10975,2097,16887,0
39,719,652,304,544,16,6,88,668,6,89,51,101,95,152,591,998,3,3399,188,0,2,7,1,26900,10976,2097,16888,0
39,719,2,2,2,0,0,0,2,0,0,0,0,0,0,0,0,0,0,0,0,2,7,1,26900,10976,2097,16888,0
39,719,8,5,5,0,0,3,8,0,0,0,0,0,0,0,0,0,0,0,0,2,7,1,26900,10976,2097,16889,0
39,719,2,2,2,0,0,0,2,0,0,0,0,0,0,0,0,0,0,0,0,2,7,1,26900,10976,2097,16889,0
39,719,14,8,8,0,0,6,14,0,0,0,0,0,0,0,0,0,0,0,0,2,7,1,26900,10976,2097,16890,0
39,719,6,4,4,0,0,2,6,0,0,0,0,0,0,0,0,0,0,0,0,2,7,1,26900,10976,2097,16891,0
39,719,6,4,4,0,0,2,6,1,2,1,2,3,3,2,4,0,2,0,0,2,7,1,26900,10976,2097,16892,0
39,719,6,4,4,0,0,2,6,0,0,0,0,0,0,0,0,0,0,0,0,2,7,1,26900,10976,2097,16893,0
39,719,7,5,5,0,0,2,7,0,0,0,0,0,0,0,0,0,0,0,0,2,7,1,26900,10976,2097,16894,0
39,719,6,4,4,0,0,2,6,0,0,0,0,0,0,0,0,0,0,0,0,2,7,1,26900,10976,2097,16895,0
39,719,10,6,6,0,0,4,10,0,0,0,0,0,0,0,0,0,0,0,0,2,7,1,26900,10976,2097,16896,0
39,719,1,1,1,0,0,0,1,0,0,0,0,0,0,0,0,0,0,0,0,2,7,1,26900,10976,2097,16896,0
39,719,14,10,10,0,0,4,14,1,1,1,1,2,2,0,2,0,1,0,0,2,7,1,26900,10976,2097,16897,0
39,719,46,26,30,3,0,12,49,3,6,3,6,9,9,20,28,1,42,2,0,2,7,1,26910,10976,2097,16898,0
111,4263,1513,682,1277,25,13,200,1538,11,199,116,219,210,335,1557,2584,6,15641,868,0,2,2,1,26910,10978,2097,16899,0
251,5055,1457,730,1242,11,6,188,1468,10,292,166,329,302,495,2424,4078,5,22973,1276,1,2,4,1,26910,10980,2097,16900,0
251,5055,74,35,59,1,0,14,75,3,14,7,14,17,21,58,85,1,128,7,0,2,4,1,26910,10981,2097,16901,0
251,5055,245,125,200,5,7,34,250,7,30,17,34,37,51,166,265,3,1053,58,0,2,4,1,26920,10982,2097,16902,0
67,2827,1289,550,1043,56,32,155,1345,10,167,93,185,177,278,1266,2075,5,11498,638,0,2,16,0,26920,10984,2098,16903,0
294,5911,1457,730,1242,11,6,188,1468,10,292,166,329,302,495,2424,4078,5,22973,1276,1,2,4,1,26920,10986,2098,16904,0
294,5911,74,35,59,1,0,14,75,3,14,7,14,17,21,58,85,1,128,7,0,2,4,1,26920,10987,2098,16905,0
294,5911,245,125,200,5,7,34,250,7,30,17,34,37,51,166,265,3,1053,58,0,2,4,1,26930,10988,2098,16906,0
113,2501,1043,504,840,53,9,147,1096,9,180,112,198,189,310,1377,2344,4,11604,644,0,2,3,5,26930,10990,2098,16907,0
113,2501,383,288,292,26,6,62,409,11,65,38,67,76,105,429,656,5,3719,206,0,2,3,5,26930,10991,2098,16908,0
68,2865,1289,550,1043,56,32,155,1345,10,167,93,185,177,278,1266,2075,5,11498,638,0,2,16,0,26930,10993,2099,16909,0
111,4260,1513,682,1277,25,13,200,1538,11,199,116,219,210,335,1557,2584,6,15641,868,0,2,2,1,26930,10995,2099,16910,0
55,2176,1043,504,840,53,9,147,1096,9,180,112,198,189,310,1377,2344,4,11604,644,0,2,15,2,26930,10997,2099,16911,0
216,4842,722,423,573,19,0,135,741,12,172,101,199,184,300,1320,2257,6,15668,870,0,2,4,1,26930,10999,2099,16913,0
216,4842,1508,847,911,44,250,301,1552,14,148,88,169,162,257,1120,1886,7,15077,837,0,2,4,1,26930,11000,2100,16914,0
111,4260,1513,682,1277,25,13,200,1538,11,199,116,219,210,335,1557,2584,6,15641,868,0,2,1,1,26930,11002,2100,16915,0
20,625,42,7,35,4,0,5,46,1,2,1,2,3,3,2,4,0,2,0,0,2,2,1,26940,11006,2101,16923,0
20,625,11,6,10,0,0,1,11,2,4,2,4,6,6,10,15,1,15,0,0,2,2,1,26940,11006,2101,16924,0
296,5945,1457,730,1242,11,6,188,1468,10,292,166,329,302,495,2424,4078,5,22973,1276,1,2,3,0,26940,11008,2101,16925,0
296,5945,74,35,59,1,0,14,75,3,14,7,14,17,21,58,85,1,128,7,0,2,3,0,26940,11009,2101,16926,0
296,5945,245,125,200,5,7,34,250,7,30,17,34,37,51,166,265,3,1053,58,0,2,3,0,26950,11010,2101,16927,0
34,2100,652,304,544,16,6,88,668,6,89,51,101,95,152,591,998,3,3399,188,0,2,41,0,26950,11011,2101,16928,0
67,3186,1338,495,1086,10,64,173,1348,11,122,82,157,133,239,883,1686,7,11934,663,0,2,18,0,26950,11013,2101,16929,0
68,1237,1020,354,843,12,15,144,1032,8,134,77,144,142,221,970,1580,4,6792,377,0,2,1,1,26950,11013,2101,16930,1
68,1237,1020,354,843,12,15,144,1032,8,134,77,144,142,221,970,1580,4,6792,377,0,2,1,1,26950,11013,2101,16931,0
67,3186,1338,495,1086,10,64,173,1348,11,122,82,157,133,239,883,1686,7,11934,663,0,2,18,0,26950,11015,2101,16932,0
68,1237,1020,354,843,12,15,144,1032,8,134,77,144,142,221,970,1580,4,6792,377,0,2,1,1,26950,11015,2101,16933,0
67,3186,1338,495,1086,10,64,173,1348,11,122,82,157,133,239,883,1686,7,11934,663,0,2,18,0,26950,11017,2101,16934,0
112,2270,1513,682,1277,25,13,200,1538,11,199,116,219,210,335,1557,2584,6,15641,868,0,2,4,2,26950,11019,2101,16935,1
112,2270,819,519,539,24,98,155,843,15,96,57,106,111,163,690,1107,8,9171,509,0,2,4,2,26960,11021,2101,16936,1
112,4302,1513,682,1277,25,13,200,1538,11,199,116,219,210,335,1557,2584,6,15641,868,0,2,18,0,26960,11023,2101,16937,1
112,4302,1513,682,1277,25,13,200,1538,11,199,116,219,210,335,1557,2584,6,15641,868,0,2,1,0,26960,11025,2101,16938,0
112,2270,1513,682,1277,25,13,200,1538,11,199,116,219,210,335,1557,2584,6,15641,868,0,2,4,2,26960,11027,2101,16939,0
112,2270,819,519,539,24,98,155,843,15,96,57,106,111,163,690,1107,8,9171,509,0,2,4,2,26970,11029,2101,16940,0
112,4306,1513,682,1277,25,13,200,1538,11,199,116,219,210,335,1557,2584,6,15641,868,0,2,19,0,26970,11031,2101,16941,0
112,2270,1513,682,1277,25,13,200,1538,11,199,116,219,210,335,1557,2584,6,15641,868,0,2,4,2,26970,11033,2101,16942,0
112,2270,819,519,539,24,98,155,843,15,96,57,106,111,163,690,1107,8,9171,509,0,2,4,2,26980,11035,2101,16943,0
112,4306,1513,682,1277,25,13,200,1538,11,199,116,219,210,335,1557,2584,6,15641,868,0,2,19,0,26980,11037,2101,16944,0
480,10385,72,33,56,0,4,12,72,1,1,1,1,2,2,0,2,0,1,0,0,2,17,2,26980,11037,2101,16945,1
480,10385,1454,835,1044,76,110,219,1530,17,275,158,296,292,454,2297,3718,9,34017,1889,1,2,17,2,26990,11038,2101,16946,1
63,2600,1020,354,843,12,15,144,1032,8,134,77,144,142,221,970,1580,4,6792,377,0,2,18,0,26990,11038,2101,16947,1
68,3245,1338,495,1086,10,64,173,1348,11,122,82,157,133,239,883,1686,7,11934,663,0,2,14,0,26990,11040,2101,16948,1
68,3245,1338,495,1086,10,64,173,1348,11,122,82,157,133,239,883,1686,7,11934,663,0,2,14,0,26990,11042,2101,16949,0
13,436,442,244,305,14,16,103,456,11,68,45,75,79,120,452,756,6,4588,254,0,2,1,1,26990,11044,2101,16950,1
13,436,182,102,99,11,40,35,193,3,11,6,11,14,17,42,64,1,97,5,0,2,1,1,26990,11045,2101,16951,1
8,551,442,244,305,14,16,103,456,11,68,45,75,79,120,452,756,6,4588,254,0,2,14,0,26990,11047,2101,16952,1
13,436,442,244,305,14,16,103,456,11,68,45,75,79,120,452,756,6,4588,254,0,2,1,1,26990,11049,2101,16953,0
13,436,182,102,99,11,40,35,193,3,11,6,11,14,17,42,64,1,97,5,0,2,1,1,26990,11050,2101,16954,0
8,551,442,244,305,14,16,103,456,11,68,45,75,79,120,452,756,6,4588,254,0,2,14,0,26990,11052,2101,16955,0
480,10385,72,33,56,0,4,12,72,1,1,1,1,2,2,0,2,0,1,0,0,2,14,15,26990,11052,2101,16956,1
480,10385,1454,835,1044,76,110,219,1530,17,275,158,296,292,454,2297,3718,9,34017,1889,1,2,14,15,27000,11053,2101,16957,1
36,810,386,256,301,16,9,68,402,4,59,35,69,63,104,355,621,2,1453,80,0,2,147,57,27000,11053,2101,16958,1
36,810,264,131,164,11,41,46,275,6,38,22,40,44,62,214,338,3,1068,59,0,2,147,57,27010,11053,2102,16959,1
11,230,256,139,192,9,7,47,265,4,23,12,24,27,36,112,171,2,357,19,0,2,0,1,27010,11054,2102,16960,1
20,938,386,256,301,16,9,68,402,4,59,35,69,63,104,355,621,2,1453,80,0,2,136,52,27010,11054,2102,16961,1
478,10389,72,33,56,0,4,12,72,1,1,1,1,2,2,0,2,0,1,0,0,2,17,5,27010,11054,2102,16962,1
478,10389,1454,835,1044,76,110,219,1530,17,275,158,296,292,454,2297,3718,9,34017,1889,1,2,17,5,27020,11055,2102,16963,1
70,3830,1782,648,1425,9,47,279,1791,8,171,97,189,179,286,1292,2140,4,9462,525,0,2,40,0,27020,11056,2103,16964,1
476,10387,72,33,56,0,4,12,72,1,1,1,1,2,2,0,2,0,1,0,0,2,2,2,27020,11056,2103,16965,0
476,10387,1454,835,1044,76,110,219,1530,17,275,158,296,292,454,2297,3718,9,34017,1889,1,2,2,2,27030,11057,2103,16966,0
70,3830,1782,648,1425,9,47,279,1791,8,171,97,189,179,286,1292,2140,4,9462,525,0,2,6,5,27030,11058,2104,16967,0
71,3863,1782,648,1425,9,47,279,1791,8,171,97,189,179,286,1292,2140,4,9462,525,0,2,19,0,27030,11059,2105,16968,0
72,3886,1782,648,1425,9,47,279,1791,8,171,97,189,179,286,1292,2140,4,9462,525,0,2,5,18,27030,11060,2106,16969,1
477,10406,72,33,56,0,4,12,72,1,1,1,1,2,2,0,2,0,1,0,0,2,12,11,27030,11060,2106,16970,0
477,10406,1454,835,1044,76,110,219,1530,17,275,158,296,292,454,2297,3718,9,34017,1889,1,2,12,11,27040,11061,2106,16971,0
72,3922,1782,648,1425,9,47,279,1791,8,171,97,189,179,286,1292,2140,4,9462,525,0,2,15,2,27040,11062,2107,16972,0
477,10406,72,33,56,0,4,12,72,1,1,1,1,2,2,0,2,0,1,0,0,2,1,1,27040,11062,2107,16973,1
477,10406,1454,835,1044,76,110,219,1530,17,275,158,296,292,454,2297,3718,9,34017,1889,1,2,1,1,27050,11063,2107,16974,1
480,10385,72,33,56,0,4,12,72,1,1,1,1,2,2,0,2,0,1,0,0,2,14,15,27050,11063,2107,16975,0
480,10385,1454,835,1044,76,110,219,1530,17,275,158,296,292,454,2297,3718,9,34017,1889,1,2,14,15,27060,11064,2107,16976,0
36,810,386,256,301,16,9,68,402,4,59,35,69,63,104,355,621,2,1453,80,0,2,147,57,27060,11064,2107,16977,0
36,810,264,131,164,11,41,46,275,6,38,22,40,44,62,214,338,3,1068,59,0,2,147,57,27070,11064,2108,16978,0
11,230,256,139,192,9,7,47,265,4,23,12,24,27,36,112,171,2,357,19,0,2,0,1,27070,11065,2108,16979,0
20,938,386,256,301,16,9,68,402,4,59,35,69,63,104,355,621,2,1453,80,0,2,136,52,27070,11065,2108,16980,0
1,315,382,65,130,157,2,92,539,4,10,5,10,14,15,41,57,2,114,6,0,2,5,5,27070,11066,2109,16981,0
20,942,386,256,301,16,9,68,402,4,59,35,69,63,104,355,621,2,1453,80,0,2,2,1,27070,11066,2109,16982,0
1,315,382,65,130,157,2,92,539,4,10,5,10,14,15,41,57,2,114,6,0,2,5,5,27070,11067,2110,16983,0
36,822,386,256,301,16,9,68,402,4,59,35,69,63,104,355,621,2,1453,80,0,2,6,2,27070,11067,2110,16984,1
36,822,264,131,164,11,41,46,275,6,38,22,40,44,62,214,338,3,1068,59,0,2,6,2,27080,11067,2111,16985,1
21,982,386,256,301,16,9,68,402,4,59,35,69,63,104,355,621,2,1453,80,0,2,6,0,27080,11067,2111,16986,1
21,974,386,256,301,16,9,68,402,4,59,35,69,63,104,355,621,2,1453,80,0,2,13,4,27080,11067,2111,16987,1
1,315,382,65,130,157,2,92,539,4,10,5,10,14,15,41,57,2,114,6,0,2,5,5,27080,11068,2112,16988,0
486,10456,72,33,56,0,4,12,72,1,1,1,1,2,2,0,2,0,1,0,0,2,15,0,27080,11068,2112,16989,1
486,10456,1454,835,1044,76,110,219,1530,17,275,158,296,292,454,2297,3718,9,34017,1889,1,2,15,0,27090,11069,2112,16990,1
67,3655,1782,648,1425,9,47,279,1791,8,171,97,189,179,286,1292,2140,4,9462,525,0,2,15,3,27090,11070,2113,16991,1
481,10401,72,33,56,0,4,12,72,1,1,1,1,2,2,0,2,0,1,0,0,2,7,4,27090,11070,2113,16992,1
481,10401,1454,835,1044,76,110,219,1530,17,275,158,296,292,454,2297,3718,9,34017,1889,1,2,7,4,27100,11071,2113,16993,1
66,3598,1782,648,1425,9,47,279,1791,8,171,97,189,179,286,1292,2140,4,9462,525,0,2,6,4,27100,11072,2114,16994,1
481,10401,72,33,56,0,4,12,72,1,1,1,1,2,2,0,2,0,1,0,0,2,7,4,27100,11072,2114,16995,0
481,10401,1454,835,1044,76,110,219,1530,17,275,158,296,292,454,2297,3718,9,34017,1889,1,2,7,4,27110,11073,2114,16996,0
66,3598,1782,648,1425,9,47,279,1791,8,171,97,189,179,286,1292,2140,4,9462,525,0,2,6,4,27110,11074,2115,16997,0
486,10459,72,33,56,0,4,12,72,1,1,1,1,2,2,0,2,0,1,0,0,2,4,3,27110,11074,2115,16998,0
486,10459,1454,835,1044,76,110,219,1530,17,275,158,296,292,454,2297,3718,9,34017,1889,1,2,4,3,27120,11075,2115,16999,0
486,10457,72,33,56,0,4,12,72,1,1,1,1,2,2,0,2,0,1,0,0,2,4,4,27120,11075,2115,17000,1
486,10457,1454,835,1044,76,110,219,1530,17,275,158,296,292,454,2297,3718,9,34017,1889,1,2,4,4,27130,11076,2115,17001,1
485,10457,72,33,56,0,4,12,72,1,1,1,1,2,2,0,2,0,1,0,0,2,6,6,27130,11076,2115,17002,1
485,10457,1454,835,1044,76,110,219,1530,17,275,158,296,292,454,2297,3718,9,34017,1889,1,2,6,6,27140,11077,2115,17003,1
483,10482,72,33,56,0,4,12,72,1,1,1,1,2,2,0,2,0,1,0,0,2,20,7,27140,11077,2115,17004,0
483,10482,1454,835,1044,76,110,219,1530,17,275,158,296,292,454,2297,3718,9,34017,1889,1,2,20,7,27150,11078,2115,17005,0
72,3951,1782,648,1425,9,47,279,1791,8,171,97,189,179,286,1292,2140,4,9462,525,0,2,60,0,27150,11079,2116,17006,0
75,4081,1782,648,1425,9,47,279,1791,8,171,97,189,179,286,1292,2140,4,9462,525,0,2,61,1,27150,11080,2117,17007,0
486,10473,72,33,56,0,4,12,72,1,1,1,1,2,2,0,2,0,1,0,0,2,16,0,27150,11080,2117,17008,0
486,10473,1454,835,1044,76,110,219,1530,17,275,158,296,292,454,2297,3718,9,34017,1889,1,2,16,0,27160,11081,2117,17009,0
67,3684,1782,648,1425,9,47,279,1791,8,171,97,189,179,286,1292,2140,4,9462,525,0,2,15,3,27160,11082,2118,17010,0
21,656,424,94,331,4,0,89,428,1,5,5,5,6,10,11,25,0,12,0,0,2,46,0,27160,11083,2118,17011,1
493,10575,72,33,56,0,4,12,72,1,1,1,1,2,2,0,2,0,1,0,0,2,31,6,27160,11083,2118,17012,1
493,10575,1454,835,1044,76,110,219,1530,17,275,158,296,292,454,2297,3718,9,34017,1889,1,2,31,6,27170,11084,2118,17013,1
493,10571,72,33,56,0,4,12,72,1,1,1,1,2,2,0,2,0,1,0,0,2,2,2,27170,11084,2118,17014,1
493,10571,1454,835,1044,76,110,219,1530,17,275,158,296,292,454,2297,3718,9,34017,1889,1,2,2,2,27180,11085,2118,17015,1
493,10571,72,33,56,0,4,12,72,1,1,1,1,2,2,0,2,0,1,0,0,2,33,8,27180,11085,2118,17016,0
493,10571,1454,835,1044,76,110,219,1530,17,275,158,296,292,454,2297,3718,9,34017,1889,1,2,33,8,27190,11086,2118,17017,0
21,656,424,94,331,4,0,89,428,1,5,5,5,6,10,11,25,0,12,0,0,2,46,0,27190,11087,2118,17018,0
297,5964,1457,730,1242,11,6,188,1468,10,292,166,329,302,495,2424,4078,5,22973,1276,1,2,4,0,27190,11089,2118,17019,0
297,5964,74,35,59,1,0,14,75,3,14,7,14,17,21,58,85,1,128,7,0,2,4,0,27190,11090,2118,17020,0
297,5964,245,125,200,5,7,34,250,7,30,17,34,37,51,166,265,3,1053,58,0,2,4,0,27200,11091,2118,17021,0
69,2885,1289,550,1043,56,32,155,1345,10,167,93,185,177,278,1266,2075,5,11498,638,0,2,5,0,27200,11093,2119,17022,0
297,5964,1457,730,1242,11,6,188,1468,10,292,166,329,302,495,2424,4078,5,22973,1276,1,2,4,0,27200,11095,2119,17023,0
297,5964,74,35,59,1,0,14,75,3,14,7,14,17,21,58,85,1,128,7,0,2,4,0,27200,11096,2119,17024,0
297,5964,245,125,200,5,7,34,250,7,30,17,34,37,51,166,265,3,1053,58,0,2,4,0,27210,11097,2119,17025,0
69,2885,1289,550,1043,56,32,155,1345,10,167,93,185,177,278,1266,2075,5,11498,638,0,2,5,0,27210,11099,2120,17026,0
492,10563,72,33,56,0,4,12,72,1,1,1,1,2,2,0,2,0,1,0,0,2,1,1,27210,11099,2120,17027,1
492,10563,1454,835,1044,76,110,219,1530,17,275,158,296,292,454,2297,3718,9,34017,1889,1,2,1,1,27220,11100,2120,17028,1
68,3245,1338,495,1086,10,64,173,1348,11,122,82,157,133,239,883,1686,7,11934,663,0,2,11,1,27220,11102,2120,17029,1
139,6127,139,89,101,2,0,35,141,7,54,34,62,61,96,330,569,4,2287,127,0,2,16,0,27220,11102,2120,17030,1
139,6127,7,5,5,0,0,2,7,1,2,1,2,3,3,2,4,0,2,0,0,2,16,0,27220,11102,2120,17031,1
492,10563,72,33,56,0,4,12,72,1,1,1,1,2,2,0,2,0,1,0,0,2,1,1,27220,11102,2120,17032,0
492,10563,1454,835,1044,76,110,219,1530,17,275,158,296,292,454,2297,3718,9,34017,1889,1,2,1,1,27230,11103,2120,17033,0
68,3245,1338,495,1086,10,64,173,1348,11,122,82,157,133,239,883,1686,7,11934,663,0,2,11,1,27230,11105,2120,17034,0
139,6127,139,89,101,2,0,35,141,7,54,34,62,61,96,330,569,4,2287,127,0,2,16,0,27230,11105,2120,17035,0
139,6127,7,5,5,0,0,2,7,1,2,1,2,3,3,2,4,0,2,0,0,2,16,0,27230,11105,2120,17036,0
40,1253,1455,414,1257,16,76,112,1471,5,41,23,46,46,69,231,381,2,1069,59,0,2,76,8,27230,11106,2120,17037,1
40,1253,669,365,481,22,61,110,691,15,103,63,122,118,185,747,1273,8,11311,628,0,2,76,8,27240,11106,2121,17038,1
33,1397,1455,414,1257,16,76,112,1471,5,41,23,46,46,69,231,381,2,1069,59,0,2,44,0,27240,11107,2121,17039,1
40,1249,1455,414,1257,16,76,112,1471,5,41,23,46,46,69,231,381,2,1069,59,0,2,13,8,27240,11108,2121,17040,0
40,1249,669,365,481,22,61,110,691,15,103,63,122,118,185,747,1273,8,11311,628,0,2,13,8,27250,11108,2122,17041,0
33,1398,1455,414,1257,16,76,112,1471,5,41,23,46,46,69,231,381,2,1069,59,0,2,6,5,27250,11109,2122,17042,0
20,625,42,7,35,4,0,5,46,1,2,1,2,3,3,2,4,0,2,0,0,2,2,1,27260,11113,2123,17050,0
20,625,11,6,10,0,0,1,11,2,4,2,4,6,6,10,15,1,15,0,0,2,2,1,27260,11113,2123,17051,0
40,1249,1455,414,1257,16,76,112,1471,5,41,23,46,46,69,231,381,2,1069,59,0,2,81,8,27260,11114,2123,17052,0
40,1249,669,365,481,22,61,110,691,15,103,63,122,118,185,747,1273,8,11311,628,0,2,81,8,27270,11114,2124,17053,0
33,1398,1455,414,1257,16,76,112,1471,5,41,23,46,46,69,231,381,2,1069,59,0,2,45,0,27270,11115,2124,17054,0
172,3537,1943,715,1694,26,18,214,1969,12,185,120,237,197,357,1436,2721,7,20915,1161,0,2,7,2,27270,11117,2124,17055,0
172,3537,1168,838,957,57,25,144,1225,19,348,224,416,367,640,3018,5452,11,61921,3440,1,2,7,2,27280,11119,2124,17056,0
172,3541,1943,715,1694,26,18,214,1969,12,185,120,237,197,357,1436,2721,7,20915,1161,0,2,1,1,27280,11121,2124,17057,0
172,3541,1168,838,957,57,25,144,1225,19,348,224,416,367,640,3018,5452,11,61921,3440,1,2,1,1,27290,11123,2124,17058,0
173,3552,1943,715,1694,26,18,214,1969,12,185,120,237,197,357,1436,2721,7,20915,1161,0,2,18,12,27290,11125,2124,17059,1
173,3552,1168,838,957,57,25,144,1225,19,348,224,416,367,640,3018,5452,11,61921,3440,1,2,18,12,27300,11127,2124,17060,1
65,3354,1943,715,1694,26,18,214,1969,12,185,120,237,197,357,1436,2721,7,20915,1161,0,2,20,2,27300,11129,2124,17061,1
171,3978,77,34,69,0,0,8,77,3,24,16,29,27,45,114,213,1,387,21,0,2,5,0,27300,11129,2124,17062,1
171,3978,712,438,573,51,9,84,763,14,102,71,128,116,199,733,1364,8,11988,666,0,2,5,0,27310,11130,2124,17063,1
171,3550,1943,715,1694,26,18,214,1969,12,185,120,237,197,357,1436,2721,7,20915,1161,0,2,7,2,27310,11132,2124,17064,1
171,3550,1168,838,957,57,25,144,1225,19,348,224,416,367,640,3018,5452,11,61921,3440,1,2,7,2,27320,11134,2124,17065,1
69,2894,1289,550,1043,56,32,155,1345,10,167,93,185,177,278,1266,2075,5,11498,638,0,2,9,7,27320,11136,2125,17066,1
68,3251,1338,495,1086,10,64,173,1348,11,122,82,157,133,239,883,1686,7,11934,663,0,2,3,1,27320,11138,2125,17067,1
135,3518,1660,832,1314,41,38,274,1701,20,312,209,395,332,604,2671,5058,12,64042,3557,1,2,3,2,27320,11140,2126,17069,1
112,4312,1513,682,1277,25,13,200,1538,11,199,116,219,210,335,1557,2584,6,15641,868,0,2,2,1,27320,11142,2126,17070,1
53,2988,1296,573,1062,40,33,157,1336,8,201,118,231,209,349,1561,2689,4,12365,686,0,2,5,5,27320,11142,2126,17071,1
48,2372,1457,730,1242,11,6,188,1468,10,292,166,329,302,495,2424,4078,5,22973,1276,1,2,2,1,27320,11144,2126,17072,1
34,2121,652,304,544,16,6,88,668,6,89,51,101,95,152,591,998,3,3399,188,0,2,5,1,27320,11145,2126,17073,1
8,265,74,35,59,1,0,14,75,3,14,7,14,17,21,58,85,1,128,7,0,2,4,3,27320,11146,2126,17074,1
41,2667,1523,757,1297,19,12,193,1542,12,193,117,230,205,347,1508,2664,7,19053,1058,0,2,2,1,27330,11148,2126,17075,1
31,1715,384,251,317,7,8,52,391,11,70,44,84,81,128,467,811,6,5355,297,0,2,2,1,27330,11148,2126,17076,1
56,2276,1043,504,840,53,9,147,1096,9,180,112,198,189,310,1377,2344,4,11604,644,0,2,21,0,27330,11150,2126,17077,1
24,967,373,158,315,8,0,51,381,5,76,44,79,81,123,486,779,2,2026,112,0,2,3,1,27330,11150,2126,17078,1
63,3221,1943,715,1694,26,18,214,1969,12,185,120,237,197,357,1436,2721,7,20915,1161,0,2,2,1,27330,11152,2126,17079,1
37,1467,1098,241,925,5,10,155,1103,7,46,25,49,53,74,273,423,3,1580,87,0,2,3,2,27340,11154,2126,17080,1
171,3978,77,34,69,0,0,8,77,3,24,16,29,27,45,114,213,1,387,21,0,2,8,8,27340,11154,2126,17081,0
171,3978,712,438,573,51,9,84,763,14,102,71,128,116,199,733,1364,8,11988,666,0,2,8,8,27350,11155,2126,17082,0
53,1539,1523,757,1297,19,12,193,1542,12,193,117,230,205,347,1508,2664,7,19053,1058,0,2,21,0,27360,11157,2126,17083,1
53,1539,701,378,504,33,58,109,734,13,110,68,126,123,194,794,1346,7,10027,557,0,2,21,0,27360,11158,2127,17084,1
42,2710,1523,757,1297,19,12,193,1542,12,193,117,230,205,347,1508,2664,7,19053,1058,0,2,10,1,27370,11160,2127,17085,1
56,2276,1043,504,840,53,9,147,1096,9,180,112,198,189,310,1377,2344,4,11604,644,0,2,2,2,27370,11162,2127,17086,0
173,3552,1943,715,1694,26,18,214,1969,12,185,120,237,197,357,1436,2721,7,20915,1161,0,2,18,7,27370,11164,2127,17087,0
173,3552,1168,838,957,57,25,144,1225,19,348,224,416,367,640,3018,5452,11,61921,3440,1,2,18,7,27380,11166,2127,17088,0
65,3354,1943,715,1694,26,18,214,1969,12,185,120,237,197,357,1436,2721,7,20915,1161,0,2,20,2,27380,11168,2127,17089,0
171,3978,77,34,69,0,0,8,77,3,24,16,29,27,45,114,213,1,387,21,0,2,10,5,27380,11168,2127,17090,0
171,3978,712,438,573,51,9,84,763,14,102,71,128,116,199,733,1364,8,11988,666,0,2,10,5,27390,11169,2127,17091,0
173,3572,1943,715,1694,26,18,214,1969,12,185,120,237,197,357,1436,2721,7,20915,1161,0,2,7,2,27390,11171,2127,17092,0
173,3572,1168,838,957,57,25,144,1225,19,348,224,416,367,640,3018,5452,11,61921,3440,1,2,7,2,27400,11173,2127,17093,0
69,2894,1289,550,1043,56,32,155,1345,10,167,93,185,177,278,1266,2075,5,11498,638,0,2,9,7,27400,11175,2128,17094,0
68,3251,1338,495,1086,10,64,173,1348,11,122,82,157,133,239,883,1686,7,11934,663,0,2,3,1,27400,11177,2128,17095,0
135,3518,1660,832,1314,41,38,274,1701,20,312,209,395,332,604,2671,5058,12,64042,3557,1,2,3,2,27400,11179,2129,17097,0
112,4312,1513,682,1277,25,13,200,1538,11,199,116,219,210,335,1557,2584,6,15641,868,0,2,2,1,27400,11181,2129,17098,0
53,2988,1296,573,1062,40,33,157,1336,8,201,118,231,209,349,1561,2689,4,12365,686,0,2,5,5,27400,11181,2129,17099,0
48,2372,1457,730,1242,11,6,188,1468,10,292,166,329,302,495,2424,4078,5,22973,1276,1,2,2,1,27400,11183,2129,17100,0
34,2121,652,304,544,16,6,88,668,6,89,51,101,95,152,591,998,3,3399,188,0,2,5,1,27400,11184,2129,17101,0
8,265,74,35,59,1,0,14,75,3,14,7,14,17,21,58,85,1,128,7,0,2,4,3,27400,11185,2129,17102,0
41,2667,1523,757,1297,19,12,193,1542,12,193,117,230,205,347,1508,2664,7,19053,1058,0,2,2,1,27410,11187,2129,17103,0
31,1715,384,251,317,7,8,52,391,11,70,44,84,81,128,467,811,6,5355,297,0,2,2,1,27410,11187,2129,17104,0
56,2276,1043,504,840,53,9,147,1096,9,180,112,198,189,310,1377,2344,4,11604,644,0,2,23,2,27410,11189,2129,17105,0
24,967,373,158,315,8,0,51,381,5,76,44,79,81,123,486,779,2,2026,112,0,2,3,1,27410,11189,2129,17106,0
65,3360,1943,715,1694,26,18,214,1969,12,185,120,237,197,357,1436,2721,7,20915,1161,0,2,2,1,27410,11191,2129,17107,0
37,1467,1098,241,925,5,10,155,1103,7,46,25,49,53,74,273,423,3,1580,87,0,2,3,2,27420,11193,2129,17108,0
52,1519,1523,757,1297,19,12,193,1542,12,193,117,230,205,347,1508,2664,7,19053,1058,0,2,8,12,27430,11195,2129,17109,1
52,1519,701,378,504,33,58,109,734,13,110,68,126,123,194,794,1346,7,10027,557,0,2,8,12,27430,11196,2130,17110,1
42,2710,1523,757,1297,19,12,193,1542,12,193,117,230,205,347,1508,2664,7,19053,1058,0,2,2,3,27440,11198,2130,17111,1
477,10406,72,33,56,0,4,12,72,1,1,1,1,2,2,0,2,0,1,0,0,2,4,5,27440,11198,2130,17112,1
477,10406,1454,835,1044,76,110,219,1530,17,275,158,296,292,454,2297,3718,9,34017,1889,1,2,4,5,27450,11199,2130,17113,1
72,3900,1782,648,1425,9,47,279,1791,8,171,97,189,179,286,1292,2140,4,9462,525,0,2,2,3,27450,11200,2131,17114,1
52,1550,1523,757,1297,19,12,193,1542,12,193,117,230,205,347,1508,2664,7,19053,1058,0,2,12,6,27460,11202,2131,17115,1
52,1550,701,378,504,33,58,109,734,13,110,68,126,123,194,794,1346,7,10027,557,0,2,12,6,27460,11203,2132,17116,1
42,2720,1523,757,1297,19,12,193,1542,12,193,117,230,205,347,1508,2664,7,19053,1058,0,2,2,1,27470,11205,2132,17117,1
52,1550,1523,757,1297,19,12,193,1542,12,193,117,230,205,347,1508,2664,7,19053,1058,0,2,24,1,27480,11207,2132,17118,0
52,1550,701,378,504,33,58,109,734,13,110,68,126,123,194,794,1346,7,10027,557,0,2,24,1,27480,11208,2133,17119,0
42,2727,1523,757,1297,19,12,193,1542,12,193,117,230,205,347,1508,2664,7,19053,1058,0,2,10,1,27490,11210,2133,17120,0
112,2270,1513,682,1277,25,13,200,1538,11,199,116,219,210,335,1557,2584,6,15641,868,0,2,4,2,27500,11216,2134,17128,0
112,2270,819,519,539,24,98,155,843,15,96,57,106,111,163,690,1107,8,9171,509,0,2,4,2,27510,11218,2134,17129,0
297,5964,1457,730,1242,11,6,188,1468,10,292,166,329,302,495,2424,4078,5,22973,1276,1,2,7,0,27510,11220,2134,17130,0
297,5964,74,35,59,1,0,14,75,3,14,7,14,17,21,58,85,1,128,7,0,2,7,0,27510,11221,2134,17131,0
297,5964,245,125,200,5,7,34,250,7,30,17,34,37,51,166,265,3,1053,58,0,2,7,0,27520,11222,2134,17132,0
40,1249,1455,414,1257,16,76,112,1471,5,41,23,46,46,69,231,381,2,1069,59,0,2,81,8,27520,11223,2134,17133,0
40,1249,669,365,481,22,61,110,691,15,103,63,122,118,185,747,1273,8,11311,628,0,2,81,8,27530,11223,2135,17134,0
52,1550,1523,757,1297,19,12,193,1542,12,193,117,230,205,347,1508,2664,7,19053,1058,0,2,24,1,27540,11225,2135,17135,0
52,1550,701,378,504,33,58,109,734,13,110,68,126,123,194,794,1346,7,10027,557,0,2,24,1,27540,11226,2136,17136,0
171,3978,77,34,69,0,0,8,77,3,24,16,29,27,45,114,213,1,387,21,0,2,10,5,27540,11226,2136,17137,0
171,3978,712,438,573,51,9,84,763,14,102,71,128,116,199,733,1364,8,11988,666,0,2,10,5,27550,11227,2136,17138,0
68,1237,1020,354,843,12,15,144,1032,8,134,77,144,142,221,970,1580,4,6792,377,0,2,1,1,27550,11227,2136,17139,0
494,10644,72,33,56,0,4,12,72,1,1,1,1,2,2,0,2,0,1,0,0,2,86,28,27550,11227,2136,17140,0
494,10644,1454,835,1044,76,110,219,1530,17,275,158,296,292,454,2297,3718,9,34017,1889,1,2,86,28,27560,11228,2136,17141,0
36,822,386,256,301,16,9,68,402,4,59,35,69,63,104,355,621,2,1453,80,0,2,151,57,27560,11228,2136,17142,0
36,822,264,131,164,11,41,46,275,6,38,22,40,44,62,214,338,3,1068,59,0,2,151,57,27570,11228,2137,17143,0
173,3572,1943,715,1694,26,18,214,1969,12,185,120,237,197,357,1436,2721,7,20915,1161,0,2,25,9,27570,11230,2137,17144,0
173,3572,1168,838,957,57,25,144,1225,19,348,224,416,367,640,3018,5452,11,61921,3440,1,2,25,9,27580,11232,2137,17145,0
13,436,442,244,305,14,16,103,456,11,68,45,75,79,120,452,756,6,4588,254,0,2,1,1,27580,11234,2137,17146,0
13,436,182,102,99,11,40,35,193,3,11,6,11,14,17,42,64,1,97,5,0,2,1,1,27580,11235,2137,17147,0
1,315,382,65,130,157,2,92,539,4,10,5,10,14,15,41,57,2,114,6,0,2,5,5,27580,11236,2138,17148,0
20,625,42,7,35,4,0,5,46,1,2,1,2,3,3,2,4,0,2,0,0,2,2,1,27580,11236,2138,17149,0
20,625,11,6,10,0,0,1,11,2,4,2,4,6,6,10,15,1,15,0,0,2,2,1,27580,11236,2138,17150,0
69,2894,1289,550,1043,56,32,155,1345,10,167,93,185,177,278,1266,2075,5,11498,638,0,2,14,7,27580,11238,2139,17151,0
68,3251,1338,495,1086,10,64,173,1348,11,122,82,157,133,239,883,1686,7,11934,663,0,2,46,2,27580,11240,2139,17152,0
139,6127,139,89,101,2,0,35,141,7,54,34,62,61,96,330,569,4,2287,127,0,2,16,0,27580,11240,2139,17153,0
139,6127,7,5,5,0,0,2,7,1,2,1,2,3,3,2,4,0,2,0,0,2,16,0,27580,11240,2139,17154,0
73,4015,1782,648,1425,9,47,279,1791,8,171,97,189,179,286,1292,2140,4,9462,525,0,2,21,7,27580,11241,2140,17155,0
11,230,256,139,192,9,7,47,265,4,23,12,24,27,36,112,171,2,357,19,0,2,0,1,27580,11242,2140,17156,0
135,3518,1660,832,1314,41,38,274,1701,20,312,209,395,332,604,2671,5058,12,64042,3557,1,2,3,2,27580,11244,2141,17158,0
112,4312,1513,682,1277,25,13,200,1538,11,199,116,219,210,335,1557,2584,6,15641,868,0,2,21,1,27580,11246,2141,17159,0
53,2988,1296,573,1062,40,33,157,1336,8,201,118,231,209,349,1561,2689,4,12365,686,0,2,5,5,27580,11246,2141,17160,0
48,2372,1457,730,1242,11,6,188,1468,10,292,166,329,302,495,2424,4078,5,22973,1276,1,2,2,1,27580,11248,2141,17161,0
34,2121,652,304,544,16,6,88,668,6,89,51,101,95,152,591,998,3,3399,188,0,2,46,1,27580,11249,2141,17162,0
33,1398,1455,414,1257,16,76,112,1471,5,41,23,46,46,69,231,381,2,1069,59,0,2,45,0,27580,11250,2141,17163,0
8,265,74,35,59,1,0,14,75,3,14,7,14,17,21,58,85,1,128,7,0,2,4,3,27580,11251,2141,17164,0
42,2727,1523,757,1297,19,12,193,1542,12,193,117,230,205,347,1508,2664,7,19053,1058,0,2,12,2,27590,11253,2141,17165,0
63,2600,1020,354,843,12,15,144,1032,8,134,77,144,142,221,970,1580,4,6792,377,0,2,18,0,27590,11253,2141,17166,0
21,656,424,94,331,4,0,89,428,1,5,5,5,6,10,11,25,0,12,0,0,2,46,0,27590,11254,2141,17167,0
31,1715,384,251,317,7,8,52,391,11,70,44,84,81,128,467,811,6,5355,297,0,2,2,1,27590,11254,2141,17168,0
21,974,386,256,301,16,9,68,402,4,59,35,69,63,104,355,621,2,1453,80,0,2,150,50,27590,11254,2141,17169,0
56,2276,1043,504,840,53,9,147,1096,9,180,112,198,189,310,1377,2344,4,11604,644,0,2,23,2,27590,11256,2141,17170,0
24,967,373,158,315,8,0,51,381,5,76,44,79,81,123,486,779,2,2026,112,0,2,3,1,27590,11256,2141,17171,0
65,3360,1943,715,1694,26,18,214,1969,12,185,120,237,197,357,1436,2721,7,20915,1161,0,2,22,3,27590,11258,2141,17172,0
8,551,442,244,305,14,16,103,456,11,68,45,75,79,120,452,756,6,4588,254,0,2,14,0,27590,11260,2141,17173,0
37,1467,1098,241,925,5,10,155,1103,7,46,25,49,53,74,273,423,3,1580,87,0,2,3,2,27600,11262,2141,17174,0
297,5968,1457,730,1242,11,6,188,1468,10,292,166,329,302,495,2424,4078,5,22973,1276,1,2,6,4,27600,11264,2141,17175,1
297,5968,74,35,59,1,0,14,75,3,14,7,14,17,21,58,85,1,128,7,0,2,6,4,27600,11265,2141,17176,1
297,5968,245,125,200,5,7,34,250,7,30,17,34,37,51,166,265,3,1053,58,0,2,6,4,27610,11266,2141,17177,1
52,2502,1457,730,1242,11,6,188,1468,10,292,166,329,302,495,2424,4078,5,22973,1276,1,2,25,0,27610,11268,2141,17178,1
37,2209,334,251,279,10,4,40,344,5,127,74,143,132,217,899,1528,2,4303,239,0,2,3,1,27610,11269,2141,17179,1
297,5968,1457,730,1242,11,6,188,1468,10,292,166,329,302,495,2424,4078,5,22973,1276,1,2,6,4,27610,11271,2141,17180,0
297,5968,74,35,59,1,0,14,75,3,14,7,14,17,21,58,85,1,128,7,0,2,6,4,27610,11272,2141,17181,0
297,5968,245,125,200,5,7,34,250,7,30,17,34,37,51,166,265,3,1053,58,0,2,6,4,27620,11273,2141,17182,0
52,2502,1457,730,1242,11,6,188,1468,10,292,166,329,302,495,2424,4078,5,22973,1276,1,2,25,0,27620,11275,2141,17183,0
37,2209,334,251,279,10,4,40,344,5,127,74,143,132,217,899,1528,2,4303,239,0,2,3,1,27620,11276,2141,17184,0
46,522,647,139,84,35,284,233,682,0,0,0,0,0,0,0,0,0,0,0,0,2,9,2,27620,11276,2141,17185,1
298,5985,1457,730,1242,11,6,188,1468,10,292,166,329,302,495,2424,4078,5,22973,1276,1,2,12,5,27620,11278,2141,17186,1
298,5985,74,35,59,1,0,14,75,3,14,7,14,17,21,58,85,1,128,7,0,2,12,5,27620,11279,2141,17187,1
298,5985,245,125,200,5,7,34,250,7,30,17,34,37,51,166,265,3,1053,58,0,2,12,5,27630,11280,2141,17188,1
38,2255,334,251,279,10,4,40,344,5,127,74,143,132,217,899,1528,2,4303,239,0,2,9,2,27630,11281,2141,17189,1
216,4842,722,423,573,19,0,135,741,12,172,101,199,184,300,1320,2257,6,15668,870,0,2,1,1,27630,11283,2141,17191,1
216,4842,1508,847,911,44,250,301,1552,14,148,88,169,162,257,1120,1886,7,15077,837,0,2,1,1,27630,11284,2142,17192,1
173,3589,1943,715,1694,26,18,214,1969,12,185,120,237,197,357,1436,2721,7,20915,1161,0,2,4,2,27630,11286,2142,17193,1
173,3589,1168,838,957,57,25,144,1225,19,348,224,416,367,640,3018,5452,11,61921,3440,1,2,4,2,27640,11288,2142,17194,1
52,2502,1457,730,1242,11,6,188,1468,10,292,166,329,302,495,2424,4078,5,22973,1276,1,2,2,2,27640,11290,2142,17195,1
65,3360,1943,715,1694,26,18,214,1969,12,185,120,237,197,357,1436,2721,7,20915,1161,0,2,3,2,27640,11292,2142,17196,1
297,5964,1457,730,1242,11,6,188,1468,10,292,166,329,302,495,2424,4078,5,22973,1276,1,2,4,0,27650,11298,2143,17204,0
297,5964,74,35,59,1,0,14,75,3,14,7,14,17,21,58,85,1,128,7,0,2,4,0,27650,11299,2143,17205,0
297,5964,245,125,200,5,7,34,250,7,30,17,34,37,51,166,265,3,1053,58,0,2,4,0,27660,11300,2143,17206,0
40,1249,1455,414,1257,16,76,112,1471,5,41,23,46,46,69,231,381,2,1069,59,0,2,81,8,27660,11301,2143,17207,0
40,1249,669,365,481,22,61,110,691,15,103,63,122,118,185,747,1273,8,11311,628,0,2,81,8,27670,11301,2144,17208,0
52,1550,1523,757,1297,19,12,193,1542,12,193,117,230,205,347,1508,2664,7,19053,1058,0,2,24,1,27680,11303,2144,17209,0
52,1550,701,378,504,33,58,109,734,13,110,68,126,123,194,794,1346,7,10027,557,0,2,24,1,27680,11304,2145,17210,0
171,3978,77,34,69,0,0,8,77,3,24,16,29,27,45,114,213,1,387,21,0,2,10,5,27680,11304,2145,17211,0
171,3978,712,438,573,51,9,84,763,14,102,71,128,116,199,733,1364,8,11988,666,0,2,10,5,27690,11305,2145,17212,0
494,10644,72,33,56,0,4,12,72,1,1,1,1,2,2,0,2,0,1,0,0,2,54,14,27690,11305,2145,17213,0
494,10644,1454,835,1044,76,110,219,1530,17,275,158,296,292,454,2297,3718,9,34017,1889,1,2,54,14,27700,11306,2145,17214,0
173,3572,1943,715,1694,26,18,214,1969,12,185,120,237,197,357,1436,2721,7,20915,1161,0,2,25,9,27700,11308,2145,17215,0
173,3572,1168,838,957,57,25,144,1225,19,348,224,416,367,640,3018,5452,11,61921,3440,1,2,25,9,27710,11310,2145,17216,0
20,625,42,7,35,4,0,5,46,1,2,1,2,3,3,2,4,0,2,0,0,2,2,1,27710,11310,2145,17217,0
20,625,11,6,10,0,0,1,11,2,4,2,4,6,6,10,15,1,15,0,0,2,2,1,27710,11310,2145,17218,0
69,2894,1289,550,1043,56,32,155,1345,10,167,93,185,177,278,1266,2075,5,11498,638,0,2,14,7,27710,11312,2146,17219,0
68,3251,1338,495,1086,10,64,173,1348,11,122,82,157,133,239,883,1686,7,11934,663,0,2,14,2,27710,11314,2146,17220,0
139,6127,139,89,101,2,0,35,141,7,54,34,62,61,96,330,569,4,2287,127,0,2,16,0,27710,11314,2146,17221,0
139,6127,7,5,5,0,0,2,7,1,2,1,2,3,3,2,4,0,2,0,0,2,16,0,27710,11314,2146,17222,0
76,4145,1782,648,1425,9,47,279,1791,8,171,97,189,179,286,1292,2140,4,9462,525,0,2,17,6,27710,11315,2147,17223,0
135,3518,1660,832,1314,41,38,274,1701,20,312,209,395,332,604,2671,5058,12,64042,3557,1,2,3,2,27710,11317,2148,17225,0
112,4312,1513,682,1277,25,13,200,1538,11,199,116,219,210,335,1557,2584,6,15641,868,0,2,2,1,27710,11319,2148,17226,0
53,2988,1296,573,1062,40,33,157,1336,8,201,118,231,209,349,1561,2689,4,12365,686,0,2,5,5,27710,11319,2148,17227,0
48,2372,1457,730,1242,11,6,188,1468,10,292,166,329,302,495,2424,4078,5,22973,1276,1,2,2,1,27710,11321,2148,17228,0
34,2121,652,304,544,16,6,88,668,6,89,51,101,95,152,591,998,3,3399,188,0,2,5,1,27710,11322,2148,17229,0
33,1398,1455,414,1257,16,76,112,1471,5,41,23,46,46,69,231,381,2,1069,59,0,2,45,0,27710,11323,2148,17230,0
8,265,74,35,59,1,0,14,75,3,14,7,14,17,21,58,85,1,128,7,0,2,4,3,27710,11324,2148,17231,0
42,2727,1523,757,1297,19,12,193,1542,12,193,117,230,205,347,1508,2664,7,19053,1058,0,2,12,2,27720,11326,2148,17232,0
21,656,424,94,331,4,0,89,428,1,5,5,5,6,10,11,25,0,12,0,0,2,46,0,27720,11327,2148,17233,0
31,1715,384,251,317,7,8,52,391,11,70,44,84,81,128,467,811,6,5355,297,0,2,2,1,27720,11327,2148,17234,0
56,2276,1043,504,840,53,9,147,1096,9,180,112,198,189,310,1377,2344,4,11604,644,0,2,23,2,27720,11329,2148,17235,0
24,967,373,158,315,8,0,51,381,5,76,44,79,81,123,486,779,2,2026,112,0,2,3,1,27720,11329,2148,17236,0
65,3360,1943,715,1694,26,18,214,1969,12,185,120,237,197,357,1436,2721,7,20915,1161,0,2,22,3,27720,11331,2148,17237,0
37,1467,1098,241,925,5,10,155,1103,7,46,25,49,53,74,273,423,3,1580,87,0,2,3,2,27730,11333,2148,17238,0
33,678,2,2,2,0,0,0,2,0,0,0,0,0,0,0,0,0,0,0,0,2,5,2,27730,11333,2148,17238,1
33,678,99,48,90,1,3,5,100,0,0,0,0,0,0,0,0,0,0,0,0,2,5,2,27730,11334,2148,17239,1
33,678,8,5,5,2,0,1,10,0,0,0,0,0,0,0,0,0,0,0,0,2,5,2,27730,11334,2148,17240,1
33,678,1217,716,841,84,126,174,1301,14,185,118,215,199,333,1446,2542,8,20687,1149,0,2,5,2,27740,11336,2148,17241,1
33,678,160,89,115,0,13,31,160,7,15,11,17,22,28,78,124,3,495,27,0,2,5,2,27740,11336,2148,17242,1
33,678,10,10,9,9,0,0,19,0,0,0,0,0,0,0,0,0,0,0,0,2,5,2,27740,11336,2149,17243,1
33,678,173,84,99,8,29,36,181,5,12,7,13,17,20,54,81,2,221,12,0,2,5,2,27740,11337,2149,17244,1
33,678,3,1,1,3,0,0,6,0,0,0,0,0,0,0,0,0,0,0,0,2,5,2,27740,11337,2149,17245,1
72,2658,1450,624,1228,12,26,181,1462,14,306,186,354,320,540,2580,4493,8,36391,2021,1,2,6,1,27740,11339,2150,17246,1
33,678,2,2,2,0,0,0,2,0,0,0,0,0,0,0,0,0,0,0,0,2,5,2,27740,11339,2150,17246,0
33,678,99,48,90,1,3,5,100,0,0,0,0,0,0,0,0,0,0,0,0,2,5,2,27740,11340,2150,17247,0
33,678,8,5,5,2,0,1,10,0,0,0,0,0,0,0,0,0,0,0,0,2,5,2,27740,11340,2150,17248,0
33,678,1217,716,841,84,126,174,1301,14,185,118,215,199,333,1446,2542,8,20687,1149,0,2,5,2,27750,11342,2150,17249,0
33,678,160,89,115,0,13,31,160,7,15,11,17,22,28,78,124,3,495,27,0,2,5,2,27750,11342,2150,17250,0
33,678,10,10,9,9,0,0,19,0,0,0,0,0,0,0,0,0,0,0,0,2,5,2,27750,11342,2151,17251,0
33,678,173,84,99,8,29,36,181,5,12,7,13,17,20,54,81,2,221,12,0,2,5,2,27750,11343,2151,17252,0
33,678,3,1,1,3,0,0,6,0,0,0,0,0,0,0,0,0,0,0,0,2,5,2,27750,11343,2151,17253,0
72,2658,1450,624,1228,12,26,181,1462,14,306,186,354,320,540,2580,4493,8,36391,2021,1,2,6,1,27750,11345,2152,17254,0
494,10644,72,33,56,0,4,12,72,1,1,1,1,2,2,0,2,0,1,0,0,2,23,11,27750,11345,2152,17255,0
494,10644,1454,835,1044,76,110,219,1530,17,275,158,296,292,454,2297,3718,9,34017,1889,1,2,23,11,27760,11346,2152,17256,0
76,4145,1782,648,1425,9,47,279,1791,8,171,97,189,179,286,1292,2140,4,9462,525,0,2,122,3,27760,11347,2153,17257,0
298,5985,1457,730,1242,11,6,188,1468,10,292,166,329,302,495,2424,4078,5,22973,1276,1,2,12,5,27760,11349,2153,17258,0
298,5985,74,35,59,1,0,14,75,3,14,7,14,17,21,58,85,1,128,7,0,2,12,5,27760,11350,2153,17259,0
298,5985,245,125,200,5,7,34,250,7,30,17,34,37,51,166,265,3,1053,58,0,2,12,5,27770,11351,2153,17260,0
38,2255,334,251,279,10,4,40,344,5,127,74,143,132,217,899,1528,2,4303,239,0,2,9,2,27770,11352,2153,17261,0
44,872,447,308,343,6,5,95,453,7,96,59,111,103,170,651,1136,4,4600,255,0,2,11,1,27770,11355,2153,17262,1
44,872,322,174,179,16,74,51,338,10,41,26,46,51,72,252,408,5,2291,127,0,2,11,1,27770,11358,2154,17263,1
44,872,447,308,343,6,5,95,453,7,96,59,111,103,170,651,1136,4,4600,255,0,2,1,1,27770,11361,2154,17264,0
44,872,322,174,179,16,74,51,338,10,41,26,46,51,72,252,408,5,2291,127,0,2,1,1,27770,11364,2155,17265,0
498,10692,72,33,56,0,4,12,72,1,1,1,1,2,2,0,2,0,1,0,0,2,4,1,27770,11364,2155,17266,1
498,10692,1454,835,1044,76,110,219,1530,17,275,158,296,292,454,2297,3718,9,34017,1889,1,2,4,1,27780,11365,2155,17267,1
140,6179,139,89,101,2,0,35,141,7,54,34,62,61,96,330,569,4,2287,127,0,2,16,0,27780,11365,2155,17268,1
140,6179,7,5,5,0,0,2,7,1,2,1,2,3,3,2,4,0,2,0,0,2,16,0,27780,11365,2155,17269,1
140,6180,139,89,101,2,0,35,141,7,54,34,62,61,96,330,569,4,2287,127,0,2,4,0,27780,11365,2155,17270,0
140,6180,7,5,5,0,0,2,7,1,2,1,2,3,3,2,4,0,2,0,0,2,4,0,27780,11365,2155,17271,0
498,10692,72,33,56,0,4,12,72,1,1,1,1,2,2,0,2,0,1,0,0,2,4,1,27780,11365,2155,17272,0
498,10692,1454,835,1044,76,110,219,1530,17,275,158,296,292,454,2297,3718,9,34017,1889,1,2,4,1,27790,11366,2155,17273,0
140,6180,139,89,101,2,0,35,141,7,54,34,62,61,96,330,569,4,2287,127,0,2,20,0,27790,11366,2155,17274,0
140,6180,7,5,5,0,0,2,7,1,2,1,2,3,3,2,4,0,2,0,0,2,20,0,27790,11366,2155,17275,0
301,6070,1457,730,1242,11,6,188,1468,10,292,166,329,302,495,2424,4078,5,22973,1276,1,2,32,10,27790,11368,2155,17276,1
301,6070,74,35,59,1,0,14,75,3,14,7,14,17,21,58,85,1,128,7,0,2,32,10,27790,11369,2155,17277,1
301,6070,245,125,200,5,7,34,250,7,30,17,34,37,51,166,265,3,1053,58,0,2,32,10,27800,11370,2155,17278,1
23,771,74,35,59,1,0,14,75,3,14,7,14,17,21,58,85,1,128,7,0,2,5,6,27800,11371,2155,17279,1
23,771,245,125,200,5,7,34,250,7,30,17,34,37,51,166,265,3,1053,58,0,2,5,6,27810,11372,2155,17280,1
44,872,447,308,343,6,5,95,453,7,96,59,111,103,170,651,1136,4,4600,255,0,2,11,1,27810,11375,2155,17281,0
44,872,322,174,179,16,74,51,338,10,41,26,46,51,72,252,408,5,2291,127,0,2,11,1,27810,11378,2156,17282,0
43,1300,1455,414,1257,16,76,112,1471,5,41,23,46,46,69,231,381,2,1069,59,0,2,12,0,27810,11379,2156,17283,1
43,1300,669,365,481,22,61,110,691,15,103,63,122,118,185,747,1273,8,11311,628,0,2,12,0,27820,11379,2157,17284,1
39,1553,1455,414,1257,16,76,112,1471,5,41,23,46,46,69,231,381,2,1069,59,0,2,47,0,27820,11380,2157,17285,1
216,4842,722,423,573,19,0,135,741,12,172,101,199,184,300,1320,2257,6,15668,870,0,2,1,1,27820,11382,2157,17287,0
216,4842,1508,847,911,44,250,301,1552,14,148,88,169,162,257,1120,1886,7,15077,837,0,2,1,1,27820,11383,2158,17288,0
173,3589,1943,715,1694,26,18,214,1969,12,185,120,237,197,357,1436,2721,7,20915,1161,0,2,4,2,27820,11385,2158,17289,0
173,3589,1168,838,957,57,25,144,1225,19,348,224,416,367,640,3018,5452,11,61921,3440,1,2,4,2,27830,11387,2158,17290,0
52,2502,1457,730,1242,11,6,188,1468,10,292,166,329,302,495,2424,4078,5,22973,1276,1,2,2,2,27830,11389,2158,17291,0
65,3360,1943,715,1694,26,18,214,1969,12,185,120,237,197,357,1436,2721,7,20915,1161,0,2,3,2,27830,11391,2158,17292,0
43,1300,1455,414,1257,16,76,112,1471,5,41,23,46,46,69,231,381,2,1069,59,0,2,12,0,27830,11392,2158,17293,0
43,1300,669,365,481,22,61,110,691,15,103,63,122,118,185,747,1273,8,11311,628,0,2,12,0,27840,11392,2159,17294,0
39,1553,1455,414,1257,16,76,112,1471,5,41,23,46,46,69,231,381,2,1069,59,0,2,47,0,27840,11393,2159,17295,0
297,5985,1457,730,1242,11,6,188,1468,10,292,166,329,302,495,2424,4078,5,22973,1276,1,2,13,27,27840,11395,2159,17296,1
297,5985,74,35,59,1,0,14,75,3,14,7,14,17,21,58,85,1,128,7,0,2,13,27,27840,11396,2159,17297,1
297,5985,245,125,200,5,7,34,250,7,30,17,34,37,51,166,265,3,1053,58,0,2,13,27,27850,11397,2159,17298,1
46,529,647,139,84,35,284,233,682,0,0,0,0,0,0,0,0,0,0,0,0,2,2,0,27850,11397,2159,17299,1
171,3985,77,34,69,0,0,8,77,3,24,16,29,27,45,114,213,1,387,21,0,2,3,5,27850,11397,2159,17300,1
171,3985,712,438,573,51,9,84,763,14,102,71,128,116,199,733,1364,8,11988,666,0,2,3,5,27860,11398,2159,17301,1
32,1735,384,251,317,7,8,52,391,11,70,44,84,81,128,467,811,6,5355,297,0,2,10,3,27860,11398,2159,17302,1
298,6002,1457,730,1242,11,6,188,1468,10,292,166,329,302,495,2424,4078,5,22973,1276,1,2,21,13,27860,11400,2159,17303,0
298,6002,74,35,59,1,0,14,75,3,14,7,14,17,21,58,85,1,128,7,0,2,21,13,27860,11401,2159,17304,0
298,6002,245,125,200,5,7,34,250,7,30,17,34,37,51,166,265,3,1053,58,0,2,21,13,27870,11402,2159,17305,0
23,771,74,35,59,1,0,14,75,3,14,7,14,17,21,58,85,1,128,7,0,2,5,6,27870,11403,2159,17306,0
23,771,245,125,200,5,7,34,250,7,30,17,34,37,51,166,265,3,1053,58,0,2,5,6,27880,11404,2159,17307,0
46,529,647,139,84,35,284,233,682,0,0,0,0,0,0,0,0,0,0,0,0,2,2,0,27880,11404,2159,17308,0
171,3985,77,34,69,0,0,8,77,3,24,16,29,27,45,114,213,1,387,21,0,2,3,5,27880,11404,2159,17309,0
171,3985,712,438,573,51,9,84,763,14,102,71,128,116,199,733,1364,8,11988,666,0,2,3,5,27890,11405,2159,17310,0
32,1735,384,251,317,7,8,52,391,11,70,44,84,81,128,467,811,6,5355,297,0,2,10,3,27890,11405,2159,17311,0
298,6004,1457,730,1242,11,6,188,1468,10,292,166,329,302,495,2424,4078,5,22973,1276,1,2,1,1,27890,11407,2159,17312,1
298,6004,74,35,59,1,0,14,75,3,14,7,14,17,21,58,85,1,128,7,0,2,1,1,27890,11408,2159,17313,1
298,6004,245,125,200,5,7,34,250,7,30,17,34,37,51,166,265,3,1053,58,0,2,1,1,27900,11409,2159,17314,1
46,531,647,139,84,35,284,233,682,0,0,0,0,0,0,0,0,0,0,0,0,2,1,1,27900,11409,2159,17315,1
498,10696,72,33,56,0,4,12,72,1,1,1,1,2,2,0,2,0,1,0,0,2,1,1,27900,11409,2159,17316,1
498,10696,1454,835,1044,76,110,219,1530,17,275,158,296,292,454,2297,3718,9,34017,1889,1,2,1,1,27910,11410,2159,17317,1
173,3593,1943,715,1694,26,18,214,1969,12,185,120,237,197,357,1436,2721,7,20915,1161,0,2,2,1,27910,11412,2159,17318,1
173,3593,1168,838,957,57,25,144,1225,19,348,224,416,367,640,3018,5452,11,61921,3440,1,2,2,1,27920,11414,2159,17319,1
20,625,42,7,35,4,0,5,46,1,2,1,2,3,3,2,4,0,2,0,0,2,2,2,27930,11418,2160,17327,1
20,625,11,6,10,0,0,1,11,2,4,2,4,6,6,10,15,1,15,0,0,2,2,2,27930,11418,2160,17328,1
65,3364,1943,715,1694,26,18,214,1969,12,185,120,237,197,357,1436,2721,7,20915,1161,0,2,1,1,27930,11420,2160,17329,1
173,3542,1943,715,1694,26,18,214,1969,12,185,120,237,197,357,1436,2721,7,20915,1161,0,2,3,1,27930,11422,2160,17330,0
173,3542,1168,838,957,57,25,144,1225,19,348,224,416,367,640,3018,5452,11,61921,3440,1,2,3,1,27940,11424,2160,17331,0
173,3542,1943,715,1694,26,18,214,1969,12,185,120,237,197,357,1436,2721,7,20915,1161,0,2,1,1,27940,11426,2160,17332,1
173,3542,1168,838,957,57,25,144,1225,19,348,224,416,367,640,3018,5452,11,61921,3440,1,2,1,1,27950,11428,2160,17333,1
50,2216,1178,367,1042,6,15,115,1184,9,94,51,95,103,146,644,976,4,4439,246,0,2,37,0,27950,11428,2160,17334,1
175,3601,1943,715,1694,26,18,214,1969,12,185,120,237,197,357,1436,2721,7,20915,1161,0,2,4,2,27950,11430,2160,17335,0
175,3601,1168,838,957,57,25,144,1225,19,348,224,416,367,640,3018,5452,11,61921,3440,1,2,4,2,27960,11432,2160,17336,0
50,2216,1178,367,1042,6,15,115,1184,9,94,51,95,103,146,644,976,4,4439,246,0,2,37,0,27960,11432,2160,17337,0
54,1131,996,429,845,24,10,117,1020,7,76,50,88,83,138,494,879,4,3565,198,0,0,214,0,27960,11434,2160,17338,1
54,1131,456,277,329,12,42,72,468,13,85,50,97,98,147,592,972,7,7212,400,0,0,214,0,27960,11434,2160,17339,1
298,6002,1457,730,1242,11,6,188,1468,10,292,166,329,302,495,2424,4078,5,22973,1276,1,2,1,1,27960,11436,2160,17340,1
298,6002,74,35,59,1,0,14,75,3,14,7,14,17,21,58,85,1,128,7,0,2,1,1,27960,11437,2160,17341,1
298,6002,245,125,200,5,7,34,250,7,30,17,34,37,51,166,265,3,1053,58,0,2,1,1,27970,11438,2160,17342,1
54,1134,996,429,845,24,10,117,1020,7,76,50,88,83,138,494,879,4,3565,198,0,2,2,2,27970,11440,2160,17343,0
54,1134,456,277,329,12,42,72,468,13,85,50,97,98,147,592,972,7,7212,400,0,2,2,2,27970,11440,2160,17344,0
55,1150,996,429,845,24,10,117,1020,7,76,50,88,83,138,494,879,4,3565,198,0,2,4,0,27970,11442,2160,17345,1
55,1150,456,277,329,12,42,72,468,13,85,50,97,98,147,592,972,7,7212,400,0,2,4,0,27970,11442,2160,17346,1
55,1150,996,429,845,24,10,117,1020,7,76,50,88,83,138,494,879,4,3565,198,0,2,1,0,27970,11444,2160,17347,1
55,1150,456,277,329,12,42,72,468,13,85,50,97,98,147,592,972,7,7212,400,0,2,1,0,27970,11444,2160,17348,1
172,3983,77,34,69,0,0,8,77,3,24,16,29,27,45,114,213,1,387,21,0,2,7,6,27970,11444,2160,17349,1
172,3983,712,438,573,51,9,84,763,14,102,71,128,116,199,733,1364,8,11988,666,0,2,7,6,27980,11445,2160,17350,1
68,3251,1338,495,1086,10,64,173,1348,11,122,82,157,133,239,883,1686,7,11934,663,0,2,1,1,27980,11447,2160,17351,0
65,3360,1943,715,1694,26,18,214,1969,12,185,120,237,197,357,1436,2721,7,20915,1161,0,2,0,1,27980,11449,2160,17352,0
44,872,447,308,343,6,5,95,453,7,96,59,111,103,170,651,1136,4,4600,255,0,2,2,2,27980,11452,2160,17353,0
44,872,322,174,179,16,74,51,338,10,41,26,46,51,72,252,408,5,2291,127,0,2,2,2,27980,11455,2161,17354,0
44,876,447,308,343,6,5,95,453,7,96,59,111,103,170,651,1136,4,4600,255,0,2,4,3,27980,11458,2161,17355,0
44,876,322,174,179,16,74,51,338,10,41,26,46,51,72,252,408,5,2291,127,0,2,4,3,27980,11461,2162,17356,0
44,876,447,308,343,6,5,95,453,7,96,59,111,103,170,651,1136,4,4600,255,0,2,4,3,27980,11464,2162,17357,0
44,876,322,174,179,16,74,51,338,10,41,26,46,51,72,252,408,5,2291,127,0,2,4,3,27980,11467,2163,17358,0
44,876,447,308,343,6,5,95,453,7,96,59,111,103,170,651,1136,4,4600,255,0,2,4,3,27980,11470,2163,17359,0
44,876,322,174,179,16,74,51,338,10,41,26,46,51,72,252,408,5,2291,127,0,2,4,3,27980,11473,2164,17360,0
175,3605,1943,715,1694,26,18,214,1969,12,185,120,237,197,357,1436,2721,7,20915,1161,0,2,4,2,27980,11475,2164,17361,0
175,3605,1168,838,957,57,25,144,1225,19,348,224,416,367,640,3018,5452,11,61921,3440,1,2,4,2,27990,11477,2164,17362,0
50,2216,1178,367,1042,6,15,115,1184,9,94,51,95,103,146,644,976,4,4439,246,0,2,37,0,27990,11477,2164,17363,0
172,3983,77,34,69,0,0,8,77,3,24,16,29,27,45,114,213,1,387,21,0,2,7,6,27990,11477,2164,17364,0
172,3983,712,438,573,51,9,84,763,14,102,71,128,116,199,733,1364,8,11988,666,0,2,7,6,28000,11478,2164,17365,0
298,6004,1457,730,1242,11,6,188,1468,10,292,166,329,302,495,2424,4078,5,22973,1276,1,2,1,1,28000,11480,2164,17366,0
298,6004,74,35,59,1,0,14,75,3,14,7,14,17,21,58,85,1,128,7,0,2,1,1,28000,11481,2164,17367,0
298,6004,245,125,200,5,7,34,250,7,30,17,34,37,51,166,265,3,1053,58,0,2,1,1,28010,11482,2164,17368,0
46,531,647,139,84,35,284,233,682,0,0,0,0,0,0,0,0,0,0,0,0,2,1,1,28010,11482,2164,17369,0
498,10696,72,33,56,0,4,12,72,1,1,1,1,2,2,0,2,0,1,0,0,2,1,1,28010,11482,2164,17370,0
498,10696,1454,835,1044,76,110,219,1530,17,275,158,296,292,454,2297,3718,9,34017,1889,1,2,1,1,28020,11483,2164,17371,0
175,3605,1943,715,1694,26,18,214,1969,12,185,120,237,197,357,1436,2721,7,20915,1161,0,2,2,1,28020,11485,2164,17372,0
175,3605,1168,838,957,57,25,144,1225,19,348,224,416,367,640,3018,5452,11,61921,3440,1,2,2,1,28030,11487,2164,17373,0
20,625,42,7,35,4,0,5,46,1,2,1,2,3,3,2,4,0,2,0,0,2,2,2,28040,11491,2165,17381,0
20,625,11,6,10,0,0,1,11,2,4,2,4,6,6,10,15,1,15,0,0,2,2,2,28040,11491,2165,17382,0
65,3364,1943,715,1694,26,18,214,1969,12,185,120,237,197,357,1436,2721,7,20915,1161,0,2,1,1,28040,11493,2165,17383,0
172,3983,77,34,69,0,0,8,77,3,24,16,29,27,45,114,213,1,387,21,0,2,7,6,28040,11493,2165,17384,0
172,3983,712,438,573,51,9,84,763,14,102,71,128,116,199,733,1364,8,11988,666,0,2,7,6,28050,11494,2165,17385,0
115,2526,1043,504,840,53,9,147,1096,9,180,112,198,189,310,1377,2344,4,11604,644,0,2,11,5,28060,11500,2166,17393,1
115,2526,383,288,292,26,6,62,409,11,65,38,67,76,105,429,656,5,3719,206,0,2,11,5,28060,11501,2166,17394,1
55,2176,1043,504,840,53,9,147,1096,9,180,112,198,189,310,1377,2344,4,11604,644,0,2,1,1,28060,11503,2166,17395,1
115,2524,1043,504,840,53,9,147,1096,9,180,112,198,189,310,1377,2344,4,11604,644,0,2,0,1,28060,11505,2166,17396,0
115,2524,383,288,292,26,6,62,409,11,65,38,67,76,105,429,656,5,3719,206,0,2,0,1,28060,11506,2166,17397,0
115,2524,1043,504,840,53,9,147,1096,9,180,112,198,189,310,1377,2344,4,11604,644,0,2,10,5,28070,11512,2167,17405,0
115,2524,383,288,292,26,6,62,409,11,65,38,67,76,105,429,656,5,3719,206,0,2,10,5,28070,11513,2167,17406,0
55,2176,1043,504,840,53,9,147,1096,9,180,112,198,189,310,1377,2344,4,11604,644,0,2,1,1,28070,11515,2167,17407,0
115,2524,1043,504,840,53,9,147,1096,9,180,112,198,189,310,1377,2344,4,11604,644,0,2,10,5,28080,11521,2168,17415,0
115,2524,383,288,292,26,6,62,409,11,65,38,67,76,105,429,656,5,3719,206,0,2,10,5,28080,11522,2168,17416,0
503,10795,72,33,56,0,4,12,72,1,1,1,1,2,2,0,2,0,1,0,0,2,23,3,28080,11522,2168,17417,1
503,10795,1454,835,1044,76,110,219,1530,17,275,158,296,292,454,2297,3718,9,34017,1889,1,2,23,3,28090,11523,2168,17418,1
57,2317,1043,504,840,53,9,147,1096,9,180,112,198,189,310,1377,2344,4,11604,644,0,2,4,1,28090,11525,2168,17419,1
503,10792,72,33,56,0,4,12,72,1,1,1,1,2,2,0,2,0,1,0,0,2,1,1,28090,11525,2168,17420,0
503,10792,1454,835,1044,76,110,219,1530,17,275,158,296,292,454,2297,3718,9,34017,1889,1,2,1,1,28100,11526,2168,17421,0
503,10791,72,33,56,0,4,12,72,1,1,1,1,2,2,0,2,0,1,0,0,2,1,1,28100,11526,2168,17422,0
503,10791,1454,835,1044,76,110,219,1530,17,275,158,296,292,454,2297,3718,9,34017,1889,1,2,1,1,28110,11527,2168,17423,0
115,2524,1043,504,840,53,9,147,1096,9,180,112,198,189,310,1377,2344,4,11604,644,0,2,10,5,28120,11533,2169,17431,0
115,2524,383,288,292,26,6,62,409,11,65,38,67,76,105,429,656,5,3719,206,0,2,10,5,28120,11534,2169,17432,0
503,10797,72,33,56,0,4,12,72,1,1,1,1,2,2,0,2,0,1,0,0,2,2,1,28120,11534,2169,17433,0
503,10797,1454,835,1044,76,110,219,1530,17,275,158,296,292,454,2297,3718,9,34017,1889,1,2,2,1,28130,11535,2169,17434,0
76,4181,1782,648,1425,9,47,279,1791,8,171,97,189,179,286,1292,2140,4,9462,525,0,2,4,0,28130,11536,2170,17435,0
501,10735,72,33,56,0,4,12,72,1,1,1,1,2,2,0,2,0,1,0,0,2,4,12,28130,11536,2170,17436,1
501,10735,1454,835,1044,76,110,219,1530,17,275,158,296,292,454,2297,3718,9,34017,1889,1,2,4,12,28140,11537,2170,17437,1
14,449,442,244,305,14,16,103,456,11,68,45,75,79,120,452,756,6,4588,254,0,2,5,1,28140,11539,2170,17438,0
14,449,182,102,99,11,40,35,193,3,11,6,11,14,17,42,64,1,97,5,0,2,5,1,28140,11540,2170,17439,0
9,601,442,244,305,14,16,103,456,11,68,45,75,79,120,452,756,6,4588,254,0,2,16,1,28140,11542,2170,17440,0
15,453,442,244,305,14,16,103,456,11,68,45,75,79,120,452,756,6,4588,254,0,2,13,6,28140,11544,2170,17441,1
15,453,182,102,99,11,40,35,193,3,11,6,11,14,17,42,64,1,97,5,0,2,13,6,28140,11545,2170,17442,1
10,640,442,244,305,14,16,103,456,11,68,45,75,79,120,452,756,6,4588,254,0,2,10,0,28140,11547,2170,17443,1
10,663,442,244,305,14,16,103,456,11,68,45,75,79,120,452,756,6,4588,254,0,2,4,1,28140,11549,2170,17444,0
55,1150,996,429,845,24,10,117,1020,7,76,50,88,83,138,494,879,4,3565,198,0,2,7,7,28140,11551,2170,17445,1
55,1150,456,277,329,12,42,72,468,13,85,50,97,98,147,592,972,7,7212,400,0,2,7,7,28140,11551,2170,17446,1
16,464,442,244,305,14,16,103,456,11,68,45,75,79,120,452,756,6,4588,254,0,2,10,7,28140,11553,2170,17447,0
16,464,182,102,99,11,40,35,193,3,11,6,11,14,17,42,64,1,97,5,0,2,10,7,28140,11554,2170,17448,0
10,663,442,244,305,14,16,103,456,11,68,45,75,79,120,452,756,6,4588,254,0,2,1,1,28140,11556,2170,17449,0
55,1150,996,429,845,24,10,117,1020,7,76,50,88,83,138,494,879,4,3565,198,0,0,219,0,28140,11558,2170,17450,0
55,1150,456,277,329,12,42,72,468,13,85,50,97,98,147,592,972,7,7212,400,0,0,219,0,28140,11558,2170,17451,0
298,6004,1457,730,1242,11,6,188,1468,10,292,166,329,302,495,2424,4078,5,22973,1276,1,2,1,1,28140,11560,2170,17452,0
298,6004,74,35,59,1,0,14,75,3,14,7,14,17,21,58,85,1,128,7,0,2,1,1,28140,11561,2170,17453,0
298,6004,245,125,200,5,7,34,250,7,30,17,34,37,51,166,265,3,1053,58,0,2,1,1,28150,11562,2170,17454,0
44,876,447,308,343,6,5,95,453,7,96,59,111,103,170,651,1136,4,4600,255,0,2,2,2,28150,11565,2170,17455,0
44,876,322,174,179,16,74,51,338,10,41,26,46,51,72,252,408,5,2291,127,0,2,2,2,28150,11568,2171,17456,0
68,3251,1338,495,1086,10,64,173,1348,11,122,82,157,133,239,883,1686,7,11934,663,0,2,1,1,28150,11570,2171,17457,0
65,3364,1943,715,1694,26,18,214,1969,12,185,120,237,197,357,1436,2721,7,20915,1161,0,2,0,1,28150,11572,2171,17458,0
16,464,442,244,305,14,16,103,456,11,68,45,75,79,120,452,756,6,4588,254,0,2,18,4,28150,11574,2171,17459,0
16,464,182,102,99,11,40,35,193,3,11,6,11,14,17,42,64,1,97,5,0,2,18,4,28150,11575,2171,17460,0
10,663,442,244,305,14,16,103,456,11,68,45,75,79,120,452,756,6,4588,254,0,2,29,1,28150,11577,2171,17461,0
498,10733,72,33,56,0,4,12,72,1,1,1,1,2,2,0,2,0,1,0,0,2,8,1,28160,11581,2172,17469,1
498,10733,1454,835,1044,76,110,219,1530,17,275,158,296,292,454,2297,3718,9,34017,1889,1,2,8,1,28170,11582,2172,17470,1
68,3269,1338,495,1086,10,64,173,1348,11,122,82,157,133,239,883,1686,7,11934,663,0,2,6,4,28170,11584,2172,17471,1
77,4224,1782,648,1425,9,47,279,1791,8,171,97,189,179,286,1292,2140,4,9462,525,0,2,14,4,28170,11585,2173,17472,1
498,10733,72,33,56,0,4,12,72,1,1,1,1,2,2,0,2,0,1,0,0,2,8,1,28190,11593,2175,17487,0
498,10733,1454,835,1044,76,110,219,1530,17,275,158,296,292,454,2297,3718,9,34017,1889,1,2,8,1,28200,11594,2175,17488,0
68,3269,1338,495,1086,10,64,173,1348,11,122,82,157,133,239,883,1686,7,11934,663,0,2,6,4,28200,11596,2175,17489,0
20,617,42,7,35,4,0,5,46,1,2,1,2,3,3,2,4,0,2,0,0,2,1,2,28210,11600,2176,17497,1
20,617,11,6,10,0,0,1,11,2,4,2,4,6,6,10,15,1,15,0,0,2,1,2,28210,11600,2176,17498,1
20,617,42,7,35,4,0,5,46,1,2,1,2,3,3,2,4,0,2,0,0,2,1,2,28220,11604,2177,17506,0
20,617,11,6,10,0,0,1,11,2,4,2,4,6,6,10,15,1,15,0,0,2,1,2,28220,11604,2177,17507,0
20,617,42,7,35,4,0,5,46,1,2,1,2,3,3,2,4,0,2,0,0,2,1,1,28220,11604,2177,17508,0
20,617,11,6,10,0,0,1,11,2,4,2,4,6,6,10,15,1,15,0,0,2,1,1,28220,11604,2177,17509,0
501,10772,72,33,56,0,4,12,72,1,1,1,1,2,2,0,2,0,1,0,0,2,16,3,28220,11604,2177,17510,0
501,10772,1454,835,1044,76,110,219,1530,17,275,158,296,292,454,2297,3718,9,34017,1889,1,2,16,3,28230,11605,2177,17511,0
77,4224,1782,648,1425,9,47,279,1791,8,171,97,189,179,286,1292,2140,4,9462,525,0,2,14,0,28230,11606,2178,17512,0
57,2317,1043,504,840,53,9,147,1096,9,180,112,198,189,310,1377,2344,4,11604,644,0,2,4,1,28230,11608,2178,17513,0
20,617,42,7,35,4,0,5,46,1,2,1,2,3,3,2,4,0,2,0,0,2,1,1,28240,11612,2179,17521,1
20,617,11,6,10,0,0,1,11,2,4,2,4,6,6,10,15,1,15,0,0,2,1,1,28240,11612,2179,17522,1
20,617,42,7,35,4,0,5,46,1,2,1,2,3,3,2,4,0,2,0,0,2,1,1,28240,11612,2179,17523,0
20,617,11,6,10,0,0,1,11,2,4,2,4,6,6,10,15,1,15,0,0,2,1,1,28240,11612,2179,17524,0
54,1579,1523,757,1297,19,12,193,1542,12,193,117,230,205,347,1508,2664,7,19053,1058,0,2,9,1,28250,11614,2179,17525,1
54,1579,701,378,504,33,58,109,734,13,110,68,126,123,194,794,1346,7,10027,557,0,2,9,1,28250,11615,2180,17526,1
42,2753,1523,757,1297,19,12,193,1542,12,193,117,230,205,347,1508,2664,7,19053,1058,0,2,3,1,28260,11617,2180,17527,1
54,1579,1523,757,1297,19,12,193,1542,12,193,117,230,205,347,1508,2664,7,19053,1058,0,2,9,1,28270,11619,2180,17528,0
54,1579,701,378,504,33,58,109,734,13,110,68,126,123,194,794,1346,7,10027,557,0,2,9,1,28270,11620,2181,17529,0
42,2753,1523,757,1297,19,12,193,1542,12,193,117,230,205,347,1508,2664,7,19053,1058,0,2,3,1,28280,11622,2181,17530,0
88,1927,477,336,357,30,23,73,507,16,194,134,250,210,384,1538,2962,10,30538,1696,0,2,8,1,28300,11627,2182,17538,0
74,2691,1450,624,1228,12,26,181,1462,14,306,186,354,320,540,2580,4493,8,36391,2021,1,2,11,0,28300,11629,2183,17539,0
90,1940,477,336,357,30,23,73,507,16,194,134,250,210,384,1538,2962,10,30538,1696,0,2,9,7,28310,11630,2183,17540,1
16,468,442,244,305,14,16,103,456,11,68,45,75,79,120,452,756,6,4588,254,0,2,1,1,28310,11632,2183,17541,1
16,468,182,102,99,11,40,35,193,3,11,6,11,14,17,42,64,1,97,5,0,2,1,1,28310,11633,2183,17542,1
12,822,442,244,305,14,16,103,456,11,68,45,75,79,120,452,756,6,4588,254,0,2,34,0,28310,11635,2183,17543,1
16,468,442,244,305,14,16,103,456,11,68,45,75,79,120,452,756,6,4588,254,0,2,1,1,28310,11637,2183,17544,0
16,468,182,102,99,11,40,35,193,3,11,6,11,14,17,42,64,1,97,5,0,2,1,1,28310,11638,2183,17545,0
12,822,442,244,305,14,16,103,456,11,68,45,75,79,120,452,756,6,4588,254,0,2,34,0,28310,11640,2183,17546,0
46,531,647,139,84,35,284,233,682,0,0,0,0,0,0,0,0,0,0,0,0,2,9,2,28310,11640,2183,17547,0
37,841,386,256,301,16,9,68,402,4,59,35,69,63,104,355,621,2,1453,80,0,2,10,1,28310,11640,2183,17548,1
37,841,264,131,164,11,41,46,275,6,38,22,40,44,62,214,338,3,1068,59,0,2,10,1,28320,11640,2184,17549,1
23,1031,386,256,301,16,9,68,402,4,59,35,69,63,104,355,621,2,1453,80,0,2,11,0,28320,11640,2184,17550,1
37,831,386,256,301,16,9,68,402,4,59,35,69,63,104,355,621,2,1453,80,0,2,1,2,28320,11640,2184,17551,1
37,831,264,131,164,11,41,46,275,6,38,22,40,44,62,214,338,3,1068,59,0,2,1,2,28330,11640,2185,17552,1
90,1940,477,336,357,30,23,73,507,16,194,134,250,210,384,1538,2962,10,30538,1696,0,2,10,1,28360,11649,2187,17567,0
74,2691,1450,624,1228,12,26,181,1462,14,306,186,354,320,540,2580,4493,8,36391,2021,1,2,11,0,28360,11651,2188,17568,0
90,1940,477,336,357,30,23,73,507,16,194,134,250,210,384,1538,2962,10,30538,1696,0,2,10,1,28370,11652,2188,17569,0
74,2691,1450,624,1228,12,26,181,1462,14,306,186,354,320,540,2580,4493,8,36391,2021,1,2,11,0,28370,11654,2189,17570,0
37,831,386,256,301,16,9,68,402,4,59,35,69,63,104,355,621,2,1453,80,0,2,10,2,28370,11654,2189,17571,0
37,831,264,131,164,11,41,46,275,6,38,22,40,44,62,214,338,3,1068,59,0,2,10,2,28380,11654,2190,17572,0
23,1031,386,256,301,16,9,68,402,4,59,35,69,63,104,355,621,2,1453,80,0,2,11,0,28380,11654,2190,17573,0
57,1218,996,429,845,24,10,117,1020,7,76,50,88,83,138,494,879,4,3565,198,0,2,16,4,28380,11656,2190,17574,1
57,1218,456,277,329,12,42,72,468,13,85,50,97,98,147,592,972,7,7212,400,0,2,16,4,28380,11656,2190,17575,1
480,10385,72,33,56,0,4,12,72,1,1,1,1,2,2,0,2,0,1,0,0,2,1,1,28380,11656,2190,17576,0
480,10385,1454,835,1044,76,110,219,1530,17,275,158,296,292,454,2297,3718,9,34017,1889,1,2,1,1,28390,11657,2190,17577,0
501,10772,72,33,56,0,4,12,72,1,1,1,1,2,2,0,2,0,1,0,0,2,1,1,28390,11657,2190,17578,0
501,10772,1454,835,1044,76,110,219,1530,17,275,158,296,292,454,2297,3718,9,34017,1889,1,2,1,1,28400,11658,2190,17579,0
57,1218,996,429,845,24,10,117,1020,7,76,50,88,83,138,494,879,4,3565,198,0,2,1,1,28400,11660,2190,17580,1
57,1218,456,277,329,12,42,72,468,13,85,50,97,98,147,592,972,7,7212,400,0,2,1,1,28400,11660,2190,17581,1
112,2270,1513,682,1277,25,13,200,1538,11,199,116,219,210,335,1557,2584,6,15641,868,0,2,2,2,28400,11662,2190,17582,1
112,2270,819,519,539,24,98,155,843,15,96,57,106,111,163,690,1107,8,9171,509,0,2,2,2,28410,11664,2190,17583,1
115,2524,1043,504,840,53,9,147,1096,9,180,112,198,189,310,1377,2344,4,11604,644,0,2,1,1,28410,11666,2190,17584,1
115,2524,383,288,292,26,6,62,409,11,65,38,67,76,105,429,656,5,3719,206,0,2,1,1,28410,11667,2190,17585,1
57,1218,996,429,845,24,10,117,1020,7,76,50,88,83,138,494,879,4,3565,198,0,2,16,4,28410,11669,2190,17586,0
57,1218,456,277,329,12,42,72,468,13,85,50,97,98,147,592,972,7,7212,400,0,2,16,4,28410,11669,2190,17587,0
508,10878,72,33,56,0,4,12,72,1,1,1,1,2,2,0,2,0,1,0,0,2,43,1,28410,11669,2190,17588,1
508,10878,1454,835,1044,76,110,219,1530,17,275,158,296,292,454,2297,3718,9,34017,1889,1,2,43,1,28420,11670,2190,17589,1
77,4244,1782,648,1425,9,47,279,1791,8,171,97,189,179,286,1292,2140,4,9462,525,0,2,10,6,28420,11671,2191,17590,1
57,1219,996,429,845,24,10,117,1020,7,76,50,88,83,138,494,879,4,3565,198,0,2,12,0,28420,11673,2191,17591,1
57,1219,456,277,329,12,42,72,468,13,85,50,97,98,147,592,972,7,7212,400,0,2,12,0,28420,11673,2191,17592,1
175,3605,1943,715,1694,26,18,214,1969,12,185,120,237,197,357,1436,2721,7,20915,1161,0,2,1,1,28420,11675,2191,17593,0
175,3605,1168,838,957,57,25,144,1225,19,348,224,416,367,640,3018,5452,11,61921,3440,1,2,1,1,28430,11677,2191,17594,0
175,3605,1943,715,1694,26,18,214,1969,12,185,120,237,197,357,1436,2721,7,20915,1161,0,2,1,1,28430,11679,2191,17595,0
175,3605,1168,838,957,57,25,144,1225,19,348,224,416,367,640,3018,5452,11,61921,3440,1,2,1,1,28440,11681,2191,17596,0
57,1219,996,429,845,24,10,117,1020,7,76,50,88,83,138,494,879,4,3565,198,0,2,12,0,28440,11683,2191,17597,0
57,1219,456,277,329,12,42,72,468,13,85,50,97,98,147,592,972,7,7212,400,0,2,12,0,28440,11683,2191,17598,0
508,10878,72,33,56,0,4,12,72,1,1,1,1,2,2,0,2,0,1,0,0,2,43,1,28440,11683,2191,17599,0
508,10878,1454,835,1044,76,110,219,1530,17,275,158,296,292,454,2297,3718,9,34017,1889,1,2,43,1,28450,11684,2191,17600,0
77,4244,1782,648,1425,9,47,279,1791,8,171,97,189,179,286,1292,2140,4,9462,525,0,2,10,6,28450,11685,2192,17601,0
57,1219,996,429,845,24,10,117,1020,7,76,50,88,83,138,494,879,4,3565,198,0,2,28,4,28450,11687,2192,17602,0
57,1219,456,277,329,12,42,72,468,13,85,50,97,98,147,592,972,7,7212,400,0,2,28,4,28450,11687,2192,17603,0
508,10878,72,33,56,0,4,12,72,1,1,1,1,2,2,0,2,0,1,0,0,2,44,2,28450,11687,2192,17604,0
508,10878,1454,835,1044,76,110,219,1530,17,275,158,296,292,454,2297,3718,9,34017,1889,1,2,44,2,28460,11688,2192,17605,0
175,3605,1943,715,1694,26,18,214,1969,12,185,120,237,197,357,1436,2721,7,20915,1161,0,2,1,1,28460,11690,2192,17606,0
175,3605,1168,838,957,57,25,144,1225,19,348,224,416,367,640,3018,5452,11,61921,3440,1,2,1,1,28470,11692,2192,17607,0
77,4244,1782,648,1425,9,47,279,1791,8,171,97,189,179,286,1292,2140,4,9462,525,0,2,10,6,28470,11693,2193,17608,0
56,1686,1523,757,1297,19,12,193,1542,12,193,117,230,205,347,1508,2664,7,19053,1058,0,2,60,16,28480,11695,2193,17609,1
56,1686,701,378,504,33,58,109,734,13,110,68,126,123,194,794,1346,7,10027,557,0,2,60,16,28480,11696,2194,17610,1
45,2836,1523,757,1297,19,12,193,1542,12,193,117,230,205,347,1508,2664,7,19053,1058,0,2,25,0,28490,11698,2194,17611,1
56,1686,1523,757,1297,19,12,193,1542,12,193,117,230,205,347,1508,2664,7,19053,1058,0,2,60,16,28500,11700,2194,17612,0
56,1686,701,378,504,33,58,109,734,13,110,68,126,123,194,794,1346,7,10027,557,0,2,60,16,28500,11701,2195,17613,0
45,2836,1523,757,1297,19,12,193,1542,12,193,117,230,205,347,1508,2664,7,19053,1058,0,2,25,0,28510,11703,2195,17614,0
56,1686,1523,757,1297,19,12,193,1542,12,193,117,230,205,347,1508,2664,7,19053,1058,0,2,60,16,28520,11705,2195,17615,0
56,1686,701,378,504,33,58,109,734,13,110,68,126,123,194,794,1346,7,10027,557,0,2,60,16,28520,11706,2196,17616,0
45,2836,1523,757,1297,19,12,193,1542,12,193,117,230,205,347,1508,2664,7,19053,1058,0,2,25,0,28530,11708,2196,17617,0
299,6014,1457,730,1242,11,6,188,1468,10,292,166,329,302,495,2424,4078,5,22973,1276,1,2,6,0,28530,11710,2196,17618,1
299,6014,74,35,59,1,0,14,75,3,14,7,14,17,21,58,85,1,128,7,0,2,6,0,28530,11711,2196,17619,1
299,6014,245,125,200,5,7,34,250,7,30,17,34,37,51,166,265,3,1053,58,0,2,6,0,28540,11712,2196,17620,1
35,2152,652,304,544,16,6,88,668,6,89,51,101,95,152,591,998,3,3399,188,0,2,16,0,28540,11713,2196,17621,1
508,10878,72,33,56,0,4,12,72,1,1,1,1,2,2,0,2,0,1,0,0,2,2,2,28540,11713,2196,17622,1
508,10878,1454,835,1044,76,110,219,1530,17,275,158,296,292,454,2297,3718,9,34017,1889,1,2,2,2,28550,11714,2196,17623,1
297,5993,1457,730,1242,11,6,188,1468,10,292,166,329,302,495,2424,4078,5,22973,1276,1,2,3,9,28550,11716,2196,17624,1
297,5993,74,35,59,1,0,14,75,3,14,7,14,17,21,58,85,1,128,7,0,2,3,9,28550,11717,2196,17625,1
297,5993,245,125,200,5,7,34,250,7,30,17,34,37,51,166,265,3,1053,58,0,2,3,9,28560,11718,2196,17626,1
297,5993,1457,730,1242,11,6,188,1468,10,292,166,329,302,495,2424,4078,5,22973,1276,1,2,8,8,28560,11720,2196,17627,0
297,5993,74,35,59,1,0,14,75,3,14,7,14,17,21,58,85,1,128,7,0,2,8,8,28560,11721,2196,17628,0
297,5993,245,125,200,5,7,34,250,7,30,17,34,37,51,166,265,3,1053,58,0,2,8,8,28570,11722,2196,17629,0
508,10878,72,33,56,0,4,12,72,1,1,1,1,2,2,0,2,0,1,0,0,2,2,2,28570,11722,2196,17630,0
508,10878,1454,835,1044,76,110,219,1530,17,275,158,296,292,454,2297,3718,9,34017,1889,1,2,2,2,28580,11723,2196,17631,0
35,2152,652,304,544,16,6,88,668,6,89,51,101,95,152,591,998,3,3399,188,0,2,16,0,28580,11724,2196,17632,0
36,829,386,256,301,16,9,68,402,4,59,35,69,63,104,355,621,2,1453,80,0,2,2,1,28580,11724,2196,17633,1
36,829,264,131,164,11,41,46,275,6,38,22,40,44,62,214,338,3,1068,59,0,2,2,1,28590,11724,2197,17634,1
22,1003,386,256,301,16,9,68,402,4,59,35,69,63,104,355,621,2,1453,80,0,2,6,3,28590,11724,2197,17635,1
24,1062,386,256,301,16,9,68,402,4,59,35,69,63,104,355,621,2,1453,80,0,2,8,0,28590,11724,2197,17636,1
36,829,386,256,301,16,9,68,402,4,59,35,69,63,104,355,621,2,1453,80,0,2,2,1,28590,11724,2197,17637,0
36,829,264,131,164,11,41,46,275,6,38,22,40,44,62,214,338,3,1068,59,0,2,2,1,28600,11724,2198,17638,0
24,1062,386,256,301,16,9,68,402,4,59,35,69,63,104,355,621,2,1453,80,0,2,14,3,28600,11724,2198,17639,0
23,760,74,35,59,1,0,14,75,3,14,7,14,17,21,58,85,1,128,7,0,2,1,1,28600,11725,2198,17640,0
23,760,245,125,200,5,7,34,250,7,30,17,34,37,51,166,265,3,1053,58,0,2,1,1,28610,11726,2198,17641,0
24,810,74,35,59,1,0,14,75,3,14,7,14,17,21,58,85,1,128,7,0,2,12,2,28610,11727,2198,17642,0
24,810,245,125,200,5,7,34,250,7,30,17,34,37,51,166,265,3,1053,58,0,2,12,2,28620,11728,2198,17643,0
297,5997,1457,730,1242,11,6,188,1468,10,292,166,329,302,495,2424,4078,5,22973,1276,1,2,1,0,28620,11730,2198,17644,1
297,5997,74,35,59,1,0,14,75,3,14,7,14,17,21,58,85,1,128,7,0,2,1,0,28620,11731,2198,17645,1
297,5997,245,125,200,5,7,34,250,7,30,17,34,37,51,166,265,3,1053,58,0,2,1,0,28630,11732,2198,17646,1
35,1821,384,251,317,7,8,52,391,11,70,44,84,81,128,467,811,6,5355,297,0,2,17,0,28630,11732,2198,17647,1
297,5997,1457,730,1242,11,6,188,1468,10,292,166,329,302,495,2424,4078,5,22973,1276,1,2,1,0,28630,11734,2198,17648,0
297,5997,74,35,59,1,0,14,75,3,14,7,14,17,21,58,85,1,128,7,0,2,1,0,28630,11735,2198,17649,0
297,5997,245,125,200,5,7,34,250,7,30,17,34,37,51,166,265,3,1053,58,0,2,1,0,28640,11736,2198,17650,0
35,1821,384,251,317,7,8,52,391,11,70,44,84,81,128,467,811,6,5355,297,0,2,17,0,28640,11736,2198,17651,0
112,2270,1513,682,1277,25,13,200,1538,11,199,116,219,210,335,1557,2584,6,15641,868,0,2,2,2,28640,11738,2198,17652,0
112,2270,819,519,539,24,98,155,843,15,96,57,106,111,163,690,1107,8,9171,509,0,2,2,2,28650,11740,2198,17653,0
115,2524,1043,504,840,53,9,147,1096,9,180,112,198,189,310,1377,2344,4,11604,644,0,2,1,1,28650,11742,2198,17654,0
115,2524,383,288,292,26,6,62,409,11,65,38,67,76,105,429,656,5,3719,206,0,2,1,1,28650,11743,2198,17655,0
219,4876,722,423,573,19,0,135,741,12,172,101,199,184,300,1320,2257,6,15668,870,0,2,14,0,28660,11749,2199,17664,1
219,4876,1508,847,911,44,250,301,1552,14,148,88,169,162,257,1120,1886,7,15077,837,0,2,14,0,28660,11750,2200,17665,1
219,4876,722,423,573,19,0,135,741,12,172,101,199,184,300,1320,2257,6,15668,870,0,2,14,0,28670,11756,2201,17674,0
219,4876,1508,847,911,44,250,301,1552,14,148,88,169,162,257,1120,1886,7,15077,837,0,2,14,0,28670,11757,2202,17675,0
112,2270,1513,682,1277,25,13,200,1538,11,199,116,219,210,335,1557,2584,6,15641,868,0,2,2,2,28680,11763,2203,17683,0
112,2270,819,519,539,24,98,155,843,15,96,57,106,111,163,690,1107,8,9171,509,0,2,2,2,28690,11765,2203,17684,0
297,5997,1457,730,1242,11,6,188,1468,10,292,166,329,302,495,2424,4078,5,22973,1276,1,2,9,8,28690,11767,2203,17685,0
297,5997,74,35,59,1,0,14,75,3,14,7,14,17,21,58,85,1,128,7,0,2,9,8,28690,11768,2203,17686,0
297,5997,245,125,200,5,7,34,250,7,30,17,34,37,51,166,265,3,1053,58,0,2,9,8,28700,11769,2203,17687,0
219,4876,722,423,573,19,0,135,741,12,172,101,199,184,300,1320,2257,6,15668,870,0,2,14,0,28700,11771,2203,17689,0
219,4876,1508,847,911,44,250,301,1552,14,148,88,169,162,257,1120,1886,7,15077,837,0,2,14,0,28700,11772,2204,17690,0
508,10878,72,33,56,0,4,12,72,1,1,1,1,2,2,0,2,0,1,0,0,2,2,2,28700,11772,2204,17691,0
508,10878,1454,835,1044,76,110,219,1530,17,275,158,296,292,454,2297,3718,9,34017,1889,1,2,2,2,28710,11773,2204,17692,0
37,838,386,256,301,16,9,68,402,4,59,35,69,63,104,355,621,2,1453,80,0,2,2,1,28710,11773,2204,17693,0
37,838,264,131,164,11,41,46,275,6,38,22,40,44,62,214,338,3,1068,59,0,2,2,1,28720,11773,2205,17694,0
115,2524,1043,504,840,53,9,147,1096,9,180,112,198,189,310,1377,2344,4,11604,644,0,2,1,1,28720,11775,2205,17695,0
115,2524,383,288,292,26,6,62,409,11,65,38,67,76,105,429,656,5,3719,206,0,2,1,1,28720,11776,2205,17696,0
35,2152,652,304,544,16,6,88,668,6,89,51,101,95,152,591,998,3,3399,188,0,2,16,0,28720,11777,2205,17697,0
35,1821,384,251,317,7,8,52,391,11,70,44,84,81,128,467,811,6,5355,297,0,2,17,0,28720,11777,2205,17698,0
26,1119,386,256,301,16,9,68,402,4,59,35,69,63,104,355,621,2,1453,80,0,2,14,3,28720,11777,2205,17699,0
14,811,442,244,305,14,16,103,456,11,68,45,75,79,120,452,756,6,4588,254,0,2,12,11,28720,11779,2205,17700,0
14,811,442,244,305,14,16,103,456,11,68,45,75,79,120,452,756,6,4588,254,0,2,12,11,28720,11781,2205,17701,0
508,10878,72,33,56,0,4,12,72,1,1,1,1,2,2,0,2,0,1,0,0,2,1,1,28720,11781,2205,17702,1
508,10878,1454,835,1044,76,110,219,1530,17,275,158,296,292,454,2297,3718,9,34017,1889,1,2,1,1,28730,11782,2205,17703,1
79,4325,1782,648,1425,9,47,279,1791,8,171,97,189,179,286,1292,2140,4,9462,525,0,2,19,0,28730,11783,2206,17704,1
509,10885,72,33,56,0,4,12,72,1,1,1,1,2,2,0,2,0,1,0,0,2,9,5,28730,11783,2206,17705,1
509,10885,1454,835,1044,76,110,219,1530,17,275,158,296,292,454,2297,3718,9,34017,1889,1,2,9,5,28740,11784,2206,17706,1
81,4395,1782,648,1425,9,47,279,1791,8,171,97,189,179,286,1292,2140,4,9462,525,0,2,17,0,28740,11785,2207,17707,1
508,10886,72,33,56,0,4,12,72,1,1,1,1,2,2,0,2,0,1,0,0,2,4,1,28740,11785,2207,17708,0
508,10886,1454,835,1044,76,110,219,1530,17,275,158,296,292,454,2297,3718,9,34017,1889,1,2,4,1,28750,11786,2207,17709,0
71,3403,1338,495,1086,10,64,173,1348,11,122,82,157,133,239,883,1686,7,11934,663,0,2,48,0,28750,11788,2207,17710,0
57,1219,996,429,845,24,10,117,1020,7,76,50,88,83,138,494,879,4,3565,198,0,2,2,2,28750,11790,2207,17711,0
57,1219,456,277,329,12,42,72,468,13,85,50,97,98,147,592,972,7,7212,400,0,2,2,2,28750,11790,2207,17712,0
57,1219,996,429,845,24,10,117,1020,7,76,50,88,83,138,494,879,4,3565,198,0,2,2,2,28750,11792,2207,17713,0
57,1219,456,277,329,12,42,72,468,13,85,50,97,98,147,592,972,7,7212,400,0,2,2,2,28750,11792,2207,17714,0
509,10885,72,33,56,0,4,12,72,1,1,1,1,2,2,0,2,0,1,0,0,2,3,2,28750,11792,2207,17715,1
509,10885,1454,835,1044,76,110,219,1530,17,275,158,296,292,454,2297,3718,9,34017,1889,1,2,3,2,28760,11793,2207,17716,1
510,10903,72,33,56,0,4,12,72,1,1,1,1,2,2,0,2,0,1,0,0,2,7,3,28760,11793,2207,17717,0
510,10903,1454,835,1044,76,110,219,1530,17,275,158,296,292,454,2297,3718,9,34017,1889,1,2,7,3,28770,11794,2207,17718,0
71,3404,1338,495,1086,10,64,173,1348,11,122,82,157,133,239,883,1686,7,11934,663,0,2,1,1,28770,11796,2207,17719,0
510,10903,72,33,56,0,4,12,72,1,1,1,1,2,2,0,2,0,1,0,0,2,7,0,28770,11796,2207,17720,0
510,10903,1454,835,1044,76,110,219,1530,17,275,158,296,292,454,2297,3718,9,34017,1889,1,2,7,0,28780,11797,2207,17721,0
71,3404,1338,495,1086,10,64,173,1348,11,122,82,157,133,239,883,1686,7,11934,663,0,2,48,0,28780,11799,2207,17722,0
57,1219,996,429,845,24,10,117,1020,7,76,50,88,83,138,494,879,4,3565,198,0,2,2,2,28780,11801,2207,17723,0
57,1219,456,277,329,12,42,72,468,13,85,50,97,98,147,592,972,7,7212,400,0,2,2,2,28780,11801,2207,17724,0
511,10910,72,33,56,0,4,12,72,1,1,1,1,2,2,0,2,0,1,0,0,2,7,0,28780,11801,2207,17725,0
511,10910,1454,835,1044,76,110,219,1530,17,275,158,296,292,454,2297,3718,9,34017,1889,1,2,7,0,28790,11802,2207,17726,0
71,3404,1338,495,1086,10,64,173,1348,11,122,82,157,133,239,883,1686,7,11934,663,0,2,48,0,28790,11804,2207,17727,0
24,810,74,35,59,1,0,14,75,3,14,7,14,17,21,58,85,1,128,7,0,2,13,3,28790,11805,2207,17728,0
24,810,245,125,200,5,7,34,250,7,30,17,34,37,51,166,265,3,1053,58,0,2,13,3,28800,11806,2207,17729,0
511,10910,72,33,56,0,4,12,72,1,1,1,1,2,2,0,2,0,1,0,0,2,12,7,28800,11806,2207,17730,0
511,10910,1454,835,1044,76,110,219,1530,17,275,158,296,292,454,2297,3718,9,34017,1889,1,2,12,7,28810,11807,2207,17731,0
81,4395,1782,648,1425,9,47,279,1791,8,171,97,189,179,286,1292,2140,4,9462,525,0,2,36,0,28810,11808,2208,17732,0
511,10910,72,33,56,0,4,12,72,1,1,1,1,2,2,0,2,0,1,0,0,2,22,0,28810,11808,2208,17733,1
511,10910,1454,835,1044,76,110,219,1530,17,275,158,296,292,454,2297,3718,9,34017,1889,1,2,22,0,28820,11809,2208,17734,1
511,10910,72,33,56,0,4,12,72,1,1,1,1,2,2,0,2,0,1,0,0,2,1,1,28820,11809,2208,17735,1
511,10910,1454,835,1044,76,110,219,1530,17,275,158,296,292,454,2297,3718,9,34017,1889,1,2,1,1,28830,11810,2208,17736,1
511,10910,72,33,56,0,4,12,72,1,1,1,1,2,2,0,2,0,1,0,0,2,19,19,28830,11810,2208,17737,1
511,10910,1454,835,1044,76,110,219,1530,17,275,158,296,292,454,2297,3718,9,34017,1889,1,2,19,19,28840,11811,2208,17738,1
91,1678,1178,367,1042,6,15,115,1184,9,94,51,95,103,146,644,976,4,4439,246,0,2,10,4,28840,11811,2208,17739,0
91,1678,177,108,140,8,0,27,185,6,30,16,32,36,48,162,248,3,794,44,0,2,10,4,28840,11813,2208,17740,0
112,4312,1513,682,1277,25,13,200,1538,11,199,116,219,210,335,1557,2584,6,15641,868,0,2,0,1,28840,11815,2208,17741,0
53,2322,1178,367,1042,6,15,115,1184,9,94,51,95,103,146,644,976,4,4439,246,0,2,42,1,28840,11815,2208,17742,0
92,1699,1178,367,1042,6,15,115,1184,9,94,51,95,103,146,644,976,4,4439,246,0,2,6,4,28840,11815,2208,17743,0
92,1699,177,108,140,8,0,27,185,6,30,16,32,36,48,162,248,3,794,44,0,2,6,4,28840,11817,2208,17744,0
54,2355,1178,367,1042,6,15,115,1184,9,94,51,95,103,146,644,976,4,4439,246,0,2,16,0,28840,11817,2208,17745,0
55,2386,1178,367,1042,6,15,115,1184,9,94,51,95,103,146,644,976,4,4439,246,0,2,19,4,28840,11817,2208,17746,0
92,1702,1178,367,1042,6,15,115,1184,9,94,51,95,103,146,644,976,4,4439,246,0,2,1,1,28840,11817,2208,17747,0
92,1702,177,108,140,8,0,27,185,6,30,16,32,36,48,162,248,3,794,44,0,2,1,1,28840,11819,2208,17748,0
55,2395,1178,367,1042,6,15,115,1184,9,94,51,95,103,146,644,976,4,4439,246,0,2,3,3,28840,11819,2208,17749,0
91,1695,1178,367,1042,6,15,115,1184,9,94,51,95,103,146,644,976,4,4439,246,0,2,2,3,28840,11819,2208,17750,0
91,1695,177,108,140,8,0,27,185,6,30,16,32,36,48,162,248,3,794,44,0,2,2,3,28840,11821,2208,17751,0
55,2401,1178,367,1042,6,15,115,1184,9,94,51,95,103,146,644,976,4,4439,246,0,2,5,2,28840,11821,2208,17752,0
94,1739,1178,367,1042,6,15,115,1184,9,94,51,95,103,146,644,976,4,4439,246,0,2,18,9,28840,11821,2208,17753,1
94,1739,177,108,140,8,0,27,185,6,30,16,32,36,48,162,248,3,794,44,0,2,18,9,28840,11823,2208,17754,1
56,2436,1178,367,1042,6,15,115,1184,9,94,51,95,103,146,644,976,4,4439,246,0,2,13,0,28840,11823,2208,17755,1
94,1739,1178,367,1042,6,15,115,1184,9,94,51,95,103,146,644,976,4,4439,246,0,2,6,0,28840,11823,2208,17756,0
94,1739,177,108,140,8,0,27,185,6,30,16,32,36,48,162,248,3,794,44,0,2,6,0,28840,11825,2208,17757,0
56,2436,1178,367,1042,6,15,115,1184,9,94,51,95,103,146,644,976,4,4439,246,0,2,1,0,28840,11825,2208,17758,0
94,1736,1178,367,1042,6,15,115,1184,9,94,51,95,103,146,644,976,4,4439,246,0,2,1,1,28840,11825,2208,17759,1
94,1736,177,108,140,8,0,27,185,6,30,16,32,36,48,162,248,3,794,44,0,2,1,1,28840,11827,2208,17760,1
56,2424,1178,367,1042,6,15,115,1184,9,94,51,95,103,146,644,976,4,4439,246,0,2,4,4,28840,11827,2208,17761,1
56,2424,1178,367,1042,6,15,115,1184,9,94,51,95,103,146,644,976,4,4439,246,0,2,0,4,28840,11827,2208,17762,0
56,2424,1178,367,1042,6,15,115,1184,9,94,51,95,103,146,644,976,4,4439,246,0,2,1,1,28840,11827,2208,17763,0
56,2424,1178,367,1042,6,15,115,1184,9,94,51,95,103,146,644,976,4,4439,246,0,2,2,2,28840,11827,2208,17764,0
94,1737,1178,367,1042,6,15,115,1184,9,94,51,95,103,146,644,976,4,4439,246,0,2,1,1,28840,11827,2208,17765,1
94,1737,177,108,140,8,0,27,185,6,30,16,32,36,48,162,248,3,794,44,0,2,1,1,28840,11829,2208,17766,1
56,2421,1178,367,1042,6,15,115,1184,9,94,51,95,103,146,644,976,4,4439,246,0,2,1,1,28840,11829,2208,17767,1
45,1334,1455,414,1257,16,76,112,1471,5,41,23,46,46,69,231,381,2,1069,59,0,2,21,8,28840,11830,2208,17768,1
45,1334,669,365,481,22,61,110,691,15,103,63,122,118,185,747,1273,8,11311,628,0,2,21,8,28850,11830,2209,17769,1
44,1867,1455,414,1257,16,76,112,1471,5,41,23,46,46,69,231,381,2,1069,59,0,2,120,33,28850,11831,2209,17770,1
511,10910,72,33,56,0,4,12,72,1,1,1,1,2,2,0,2,0,1,0,0,2,21,21,28850,11831,2209,17771,1
511,10910,1454,835,1044,76,110,219,1530,17,275,158,296,292,454,2297,3718,9,34017,1889,1,2,21,21,28860,11832,2209,17772,1
511,10910,72,33,56,0,4,12,72,1,1,1,1,2,2,0,2,0,1,0,0,2,21,21,28860,11832,2209,17773,0
511,10910,1454,835,1044,76,110,219,1530,17,275,158,296,292,454,2297,3718,9,34017,1889,1,2,21,21,28870,11833,2209,17774,0
72,3434,1338,495,1086,10,64,173,1348,11,122,82,157,133,239,883,1686,7,11934,663,0,2,10,0,28900,11847,2212,17796,0
55,2732,1457,730,1242,11,6,188,1468,10,292,166,329,302,495,2424,4078,5,22973,1276,1,2,45,0,28900,11849,2212,17797,1
297,6005,1457,730,1242,11,6,188,1468,10,292,166,329,302,495,2424,4078,5,22973,1276,1,2,3,3,28900,11851,2212,17798,0
297,6005,74,35,59,1,0,14,75,3,14,7,14,17,21,58,85,1,128,7,0,2,3,3,28900,11852,2212,17799,0
297,6005,245,125,200,5,7,34,250,7,30,17,34,37,51,166,265,3,1053,58,0,2,3,3,28910,11853,2212,17800,0
55,2710,1457,730,1242,11,6,188,1468,10,292,166,329,302,495,2424,4078,5,22973,1276,1,2,0,2,28910,11855,2212,17801,0
298,6078,1457,730,1242,11,6,188,1468,10,292,166,329,302,495,2424,4078,5,22973,1276,1,2,16,14,28910,11857,2212,17802,1
298,6078,74,35,59,1,0,14,75,3,14,7,14,17,21,58,85,1,128,7,0,2,16,14,28910,11858,2212,17803,1
298,6078,245,125,200,5,7,34,250,7,30,17,34,37,51,166,265,3,1053,58,0,2,16,14,28920,11859,2212,17804,1
55,2794,1457,730,1242,11,6,188,1468,10,292,166,329,302,495,2424,4078,5,22973,1276,1,2,23,9,28920,11861,2212,17805,1
55,2827,1457,730,1242,11,6,188,1468,10,292,166,329,302,495,2424,4078,5,22973,1276,1,2,6,0,28920,11863,2212,17806,1
298,6078,1457,730,1242,11,6,188,1468,10,292,166,329,302,495,2424,4078,5,22973,1276,1,2,18,16,28920,11865,2212,17807,0
298,6078,74,35,59,1,0,14,75,3,14,7,14,17,21,58,85,1,128,7,0,2,18,16,28920,11866,2212,17808,0
298,6078,245,125,200,5,7,34,250,7,30,17,34,37,51,166,265,3,1053,58,0,2,18,16,28930,11867,2212,17809,0
55,2827,1457,730,1242,11,6,188,1468,10,292,166,329,302,495,2424,4078,5,22973,1276,1,2,63,0,28930,11869,2212,17810,0
512,10947,72,33,56,0,4,12,72,1,1,1,1,2,2,0,2,0,1,0,0,2,10,1,28930,11869,2212,17811,1
512,10947,1454,835,1044,76,110,219,1530,17,275,158,296,292,454,2297,3718,9,34017,1889,1,2,10,1,28940,11870,2212,17812,1
512,10947,72,33,56,0,4,12,72,1,1,1,1,2,2,0,2,0,1,0,0,2,10,1,28940,11870,2212,17813,0
512,10947,1454,835,1044,76,110,219,1530,17,275,158,296,292,454,2297,3718,9,34017,1889,1,2,10,1,28950,11871,2212,17814,0
72,3434,1338,495,1086,10,64,173,1348,11,122,82,157,133,239,883,1686,7,11934,663,0,2,10,0,28950,11873,2212,17815,0
45,1334,1455,414,1257,16,76,112,1471,5,41,23,46,46,69,231,381,2,1069,59,0,2,21,8,28950,11874,2212,17816,0
45,1334,669,365,481,22,61,110,691,15,103,63,122,118,185,747,1273,8,11311,628,0,2,21,8,28960,11874,2213,17817,0
44,1867,1455,414,1257,16,76,112,1471,5,41,23,46,46,69,231,381,2,1069,59,0,2,120,33,28960,11875,2213,17818,0
513,10957,72,33,56,0,4,12,72,1,1,1,1,2,2,0,2,0,1,0,0,2,5,2,28960,11875,2213,17819,1
513,10957,1454,835,1044,76,110,219,1530,17,275,158,296,292,454,2297,3718,9,34017,1889,1,2,5,2,28970,11876,2213,17820,1
73,3470,1338,495,1086,10,64,173,1348,11,122,82,157,133,239,883,1686,7,11934,663,0,2,24,0,28970,11878,2213,17821,1
513,10957,72,33,56,0,4,12,72,1,1,1,1,2,2,0,2,0,1,0,0,2,5,2,28970,11878,2213,17822,0
513,10957,1454,835,1044,76,110,219,1530,17,275,158,296,292,454,2297,3718,9,34017,1889,1,2,5,2,28980,11879,2213,17823,0
73,3470,1338,495,1086,10,64,173,1348,11,122,82,157,133,239,883,1686,7,11934,663,0,2,24,0,28980,11881,2213,17824,0
513,10965,72,33,56,0,4,12,72,1,1,1,1,2,2,0,2,0,1,0,0,2,5,2,28980,11881,2213,17825,1
513,10965,1454,835,1044,76,110,219,1530,17,275,158,296,292,454,2297,3718,9,34017,1889,1,2,5,2,28990,11882,2213,17826,1
75,3563,1338,495,1086,10,64,173,1348,11,122,82,157,133,239,883,1686,7,11934,663,0,2,30,6,28990,11884,2213,17827,1
513,10965,72,33,56,0,4,12,72,1,1,1,1,2,2,0,2,0,1,0,0,2,5,2,28990,11884,2213,17828,0
513,10965,1454,835,1044,76,110,219,1530,17,275,158,296,292,454,2297,3718,9,34017,1889,1,2,5,2,29000,11885,2213,17829,0
75,3563,1338,495,1086,10,64,173,1348,11,122,82,157,133,239,883,1686,7,11934,663,0,2,30,6,29000,11887,2213,17830,0
147,4720,1660,832,1314,41,38,274,1701,20,312,209,395,332,604,2671,5058,12,64042,3557,1,2,1,1,29000,11889,2214,17832,0
147,4720,1057,646,719,113,100,145,1170,18,215,134,248,233,382,1740,3004,10,31186,1732,1,2,1,1,29010,11890,2215,17833,0
172,3983,77,34,69,0,0,8,77,3,24,16,29,27,45,114,213,1,387,21,0,2,0,6,29010,11890,2215,17834,0
172,3983,712,438,573,51,9,84,763,14,102,71,128,116,199,733,1364,8,11988,666,0,2,0,6,29020,11891,2215,17835,0
172,3983,77,34,69,0,0,8,77,3,24,16,29,27,45,114,213,1,387,21,0,2,0,6,29020,11891,2215,17836,0
172,3983,712,438,573,51,9,84,763,14,102,71,128,116,199,733,1364,8,11988,666,0,2,0,6,29030,11892,2215,17837,0
175,3619,1943,715,1694,26,18,214,1969,12,185,120,237,197,357,1436,2721,7,20915,1161,0,2,2,1,29030,11894,2215,17838,0
175,3619,1168,838,957,57,25,144,1225,19,348,224,416,367,640,3018,5452,11,61921,3440,1,2,2,1,29040,11896,2215,17839,0
175,3619,1943,715,1694,26,18,214,1969,12,185,120,237,197,357,1436,2721,7,20915,1161,0,2,2,1,29040,11898,2215,17840,0
175,3619,1168,838,957,57,25,144,1225,19,348,224,416,367,640,3018,5452,11,61921,3440,1,2,2,1,29050,11900,2215,17841,0
147,4720,1660,832,1314,41,38,274,1701,20,312,209,395,332,604,2671,5058,12,64042,3557,1,2,1,1,29050,11902,2216,17843,0
147,4720,1057,646,719,113,100,145,1170,18,215,134,248,233,382,1740,3004,10,31186,1732,1,2,1,1,29060,11903,2217,17844,0
51,1053,1098,241,925,5,10,155,1103,7,46,25,49,53,74,273,423,3,1580,87,0,2,1,0,29070,11905,2217,17845,1
51,1053,282,202,222,14,2,44,296,8,42,24,43,50,67,250,378,4,1548,86,0,2,1,0,29070,11906,2217,17846,1
38,1499,1098,241,925,5,10,155,1103,7,46,25,49,53,74,273,423,3,1580,87,0,2,13,0,29080,11908,2217,17847,1
51,1053,1098,241,925,5,10,155,1103,7,46,25,49,53,74,273,423,3,1580,87,0,2,10,1,29090,11910,2217,17848,1
51,1053,282,202,222,14,2,44,296,8,42,24,43,50,67,250,378,4,1548,86,0,2,10,1,29090,11911,2217,17849,1
38,1508,1098,241,925,5,10,155,1103,7,46,25,49,53,74,273,423,3,1580,87,0,2,1,0,29100,11913,2217,17850,1
53,1075,1098,241,925,5,10,155,1103,7,46,25,49,53,74,273,423,3,1580,87,0,2,14,10,29110,11915,2217,17851,0
53,1075,282,202,222,14,2,44,296,8,42,24,43,50,67,250,378,4,1548,86,0,2,14,10,29110,11916,2217,17852,0
38,1508,1098,241,925,5,10,155,1103,7,46,25,49,53,74,273,423,3,1580,87,0,2,7,5,29120,11918,2217,17853,0
53,1075,1098,241,925,5,10,155,1103,7,46,25,49,53,74,273,423,3,1580,87,0,2,14,0,29130,11920,2217,17854,0
53,1075,282,202,222,14,2,44,296,8,42,24,43,50,67,250,378,4,1548,86,0,2,14,0,29130,11921,2217,17855,0
38,1508,1098,241,925,5,10,155,1103,7,46,25,49,53,74,273,423,3,1580,87,0,2,16,0,29140,11923,2217,17856,0
46,531,647,139,84,35,284,233,682,0,0,0,0,0,0,0,0,0,0,0,0,2,3,1,29160,11931,2219,17871,0
46,532,647,139,84,35,284,233,682,0,0,0,0,0,0,0,0,0,0,0,0,2,4,1,29160,11931,2219,17872,1
21,574,1293,570,1093,25,15,163,1318,10,195,123,241,205,364,1516,2795,6,17273,959,0,2,1,2,29170,11933,2219,17873,1
32,1211,1293,570,1093,25,15,163,1318,10,195,123,241,205,364,1516,2795,6,17273,959,0,2,5,1,29180,11935,2219,17874,1
46,532,647,139,84,35,284,233,682,0,0,0,0,0,0,0,0,0,0,0,0,2,7,2,29180,11935,2219,17875,0
21,574,1293,570,1093,25,15,163,1318,10,195,123,241,205,364,1516,2795,6,17273,959,0,2,1,2,29190,11937,2219,17876,0
32,1211,1293,570,1093,25,15,163,1318,10,195,123,241,205,364,1516,2795,6,17273,959,0,2,5,1,29200,11939,2219,17877,0
46,531,647,139,84,35,284,233,682,0,0,0,0,0,0,0,0,0,0,0,0,2,3,1,29200,11939,2219,17878,1
38,889,386,256,301,16,9,68,402,4,59,35,69,63,104,355,621,2,1453,80,0,2,20,9,29200,11939,2219,17879,1
38,889,264,131,164,11,41,46,275,6,38,22,40,44,62,214,338,3,1068,59,0,2,20,9,29210,11939,2220,17880,1
40,935,386,256,301,16,9,68,402,4,59,35,69,63,104,355,621,2,1453,80,0,2,25,15,29210,11939,2220,17881,1
40,935,264,131,164,11,41,46,275,6,38,22,40,44,62,214,338,3,1068,59,0,2,25,15,29220,11939,2221,17882,1
27,1123,386,256,301,16,9,68,402,4,59,35,69,63,104,355,621,2,1453,80,0,2,44,23,29220,11939,2221,17883,1
40,935,386,256,301,16,9,68,402,4,59,35,69,63,104,355,621,2,1453,80,0,2,29,8,29220,11939,2221,17884,0
40,935,264,131,164,11,41,46,275,6,38,22,40,44,62,214,338,3,1068,59,0,2,29,8,29230,11939,2222,17885,0
27,1123,386,256,301,16,9,68,402,4,59,35,69,63,104,355,621,2,1453,80,0,2,44,23,29230,11939,2222,17886,0
16,491,184,100,137,2,15,30,186,6,38,20,39,44,59,214,322,3,991,55,0,2,1,1,29230,11940,2222,17887,1
16,491,103,65,74,8,5,16,111,7,17,9,17,24,26,89,119,3,417,23,0,2,1,1,29230,11941,2222,17888,1
16,487,184,100,137,2,15,30,186,6,38,20,39,44,59,214,322,3,991,55,0,2,1,1,29230,11942,2222,17889,0
16,487,103,65,74,8,5,16,111,7,17,9,17,24,26,89,119,3,417,23,0,2,1,1,29230,11943,2222,17890,0
11,386,184,100,137,2,15,30,186,6,38,20,39,44,59,214,322,3,991,55,0,2,3,3,29230,11944,2222,17891,0
513,10973,72,33,56,0,4,12,72,1,1,1,1,2,2,0,2,0,1,0,0,2,3,2,29230,11944,2222,17892,1
513,10973,1454,835,1044,76,110,219,1530,17,275,158,296,292,454,2297,3718,9,34017,1889,1,2,3,2,29240,11945,2222,17893,1
76,3610,1338,495,1086,10,64,173,1348,11,122,82,157,133,239,883,1686,7,11934,663,0,2,15,0,29240,11947,2222,17894,1
513,10967,72,33,56,0,4,12,72,1,1,1,1,2,2,0,2,0,1,0,0,2,4,1,29240,11947,2222,17895,0
513,10967,1454,835,1044,76,110,219,1530,17,275,158,296,292,454,2297,3718,9,34017,1889,1,2,4,1,29250,11948,2222,17896,0
32,933,465,148,393,5,8,60,470,4,31,20,31,35,51,161,261,2,523,29,0,2,29,0,29250,11949,2222,17897,0
32,933,16,12,9,0,0,6,16,1,2,1,2,3,3,2,4,0,2,0,0,2,29,0,29250,11949,2222,17898,0
513,10973,72,33,56,0,4,12,72,1,1,1,1,2,2,0,2,0,1,0,0,2,3,2,29250,11949,2222,17899,0
513,10973,1454,835,1044,76,110,219,1530,17,275,158,296,292,454,2297,3718,9,34017,1889,1,2,3,2,29260,11950,2222,17900,0
76,3610,1338,495,1086,10,64,173,1348,11,122,82,157,133,239,883,1686,7,11934,663,0,2,15,0,29260,11952,2222,17901,0
513,10975,72,33,56,0,4,12,72,1,1,1,1,2,2,0,2,0,1,0,0,2,4,1,29260,11952,2222,17902,0
513,10975,1454,835,1044,76,110,219,1530,17,275,158,296,292,454,2297,3718,9,34017,1889,1,2,4,1,29270,11953,2222,17903,0
32,933,465,148,393,5,8,60,470,4,31,20,31,35,51,161,261,2,523,29,0,2,29,0,29270,11954,2222,17904,0
32,933,16,12,9,0,0,6,16,1,2,1,2,3,3,2,4,0,2,0,0,2,29,0,29270,11954,2222,17905,0
176,3627,1943,715,1694,26,18,214,1969,12,185,120,237,197,357,1436,2721,7,20915,1161,0,2,5,1,29270,11956,2222,17906,0
176,3627,1168,838,957,57,25,144,1225,19,348,224,416,367,640,3018,5452,11,61921,3440,1,2,5,1,29280,11958,2222,17907,0
65,3364,1943,715,1694,26,18,214,1969,12,185,120,237,197,357,1436,2721,7,20915,1161,0,2,2,2,29280,11960,2222,17908,0
176,3627,1943,715,1694,26,18,214,1969,12,185,120,237,197,357,1436,2721,7,20915,1161,0,2,5,1,29280,11962,2222,17909,0
176,3627,1168,838,957,57,25,144,1225,19,348,224,416,367,640,3018,5452,11,61921,3440,1,2,5,1,29290,11964,2222,17910,0
65,3364,1943,715,1694,26,18,214,1969,12,185,120,237,197,357,1436,2721,7,20915,1161,0,2,2,2,29290,11966,2222,17911,0
176,3627,1943,715,1694,26,18,214,1969,12,185,120,237,197,357,1436,2721,7,20915,1161,0,2,1,1,29290,11968,2222,17912,0
176,3627,1168,838,957,57,25,144,1225,19,348,224,416,367,640,3018,5452,11,61921,3440,1,2,1,1,29300,11970,2222,17913,0
65,3364,1943,715,1694,26,18,214,1969,12,185,120,237,197,357,1436,2721,7,20915,1161,0,2,2,2,29300,11972,2222,17914,0
176,3627,1943,715,1694,26,18,214,1969,12,185,120,237,197,357,1436,2721,7,20915,1161,0,2,1,1,29300,11974,2222,17915,0
176,3627,1168,838,957,57,25,144,1225,19,348,224,416,367,640,3018,5452,11,61921,3440,1,2,1,1,29310,11976,2222,17916,0
65,3364,1943,715,1694,26,18,214,1969,12,185,120,237,197,357,1436,2721,7,20915,1161,0,2,2,2,29310,11978,2222,17917,0
115,2524,1043,504,840,53,9,147,1096,9,180,112,198,189,310,1377,2344,4,11604,644,0,2,1,1,29310,11980,2222,17918,0
115,2524,383,288,292,26,6,62,409,11,65,38,67,76,105,429,656,5,3719,206,0,2,1,1,29310,11981,2222,17919,0
115,2524,1043,504,840,53,9,147,1096,9,180,112,198,189,310,1377,2344,4,11604,644,0,2,1,1,29310,11983,2222,17920,0
115,2524,383,288,292,26,6,62,409,11,65,38,67,76,105,429,656,5,3719,206,0,2,1,1,29310,11984,2222,17921,0
16,491,184,100,137,2,15,30,186,6,38,20,39,44,59,214,322,3,991,55,0,2,1,1,29310,11985,2222,17922,1
16,491,103,65,74,8,5,16,111,7,17,9,17,24,26,89,119,3,417,23,0,2,1,1,29310,11986,2222,17923,1
11,394,184,100,137,2,15,30,186,6,38,20,39,44,59,214,322,3,991,55,0,2,3,2,29310,11987,2222,17924,1
513,10975,72,33,56,0,4,12,72,1,1,1,1,2,2,0,2,0,1,0,0,2,7,3,29310,11987,2222,17925,0
513,10975,1454,835,1044,76,110,219,1530,17,275,158,296,292,454,2297,3718,9,34017,1889,1,2,7,3,29320,11988,2222,17926,0
115,2524,1043,504,840,53,9,147,1096,9,180,112,198,189,310,1377,2344,4,11604,644,0,2,1,1,29320,11990,2222,17927,0
115,2524,383,288,292,26,6,62,409,11,65,38,67,76,105,429,656,5,3719,206,0,2,1,1,29320,11991,2222,17928,0
176,3627,1943,715,1694,26,18,214,1969,12,185,120,237,197,357,1436,2721,7,20915,1161,0,2,5,1,29320,11993,2222,17929,0
176,3627,1168,838,957,57,25,144,1225,19,348,224,416,367,640,3018,5452,11,61921,3440,1,2,5,1,29330,11995,2222,17930,0
76,3610,1338,495,1086,10,64,173,1348,11,122,82,157,133,239,883,1686,7,11934,663,0,2,15,0,29330,11997,2222,17931,0
32,933,465,148,393,5,8,60,470,4,31,20,31,35,51,161,261,2,523,29,0,2,29,0,29330,11998,2222,17932,0
32,933,16,12,9,0,0,6,16,1,2,1,2,3,3,2,4,0,2,0,0,2,29,0,29330,11998,2222,17933,0
65,3364,1943,715,1694,26,18,214,1969,12,185,120,237,197,357,1436,2721,7,20915,1161,0,2,2,2,29330,12000,2222,17934,0
16,491,184,100,137,2,15,30,186,6,38,20,39,44,59,214,322,3,991,55,0,2,2,2,29330,12001,2222,17935,0
16,491,103,65,74,8,5,16,111,7,17,9,17,24,26,89,119,3,417,23,0,2,2,2,29330,12002,2222,17936,0
11,394,184,100,137,2,15,30,186,6,38,20,39,44,59,214,322,3,991,55,0,2,6,5,29330,12003,2222,17937,0
17,510,184,100,137,2,15,30,186,6,38,20,39,44,59,214,322,3,991,55,0,2,9,5,29330,12004,2222,17938,1
17,510,103,65,74,8,5,16,111,7,17,9,17,24,26,89,119,3,417,23,0,2,9,5,29330,12005,2222,17939,1
12,475,184,100,137,2,15,30,186,6,38,20,39,44,59,214,322,3,991,55,0,2,31,4,29330,12006,2222,17940,1
17,510,184,100,137,2,15,30,186,6,38,20,39,44,59,214,322,3,991,55,0,2,9,5,29330,12007,2222,17941,0
17,510,103,65,74,8,5,16,111,7,17,9,17,24,26,89,119,3,417,23,0,2,9,5,29330,12008,2222,17942,0
12,475,184,100,137,2,15,30,186,6,38,20,39,44,59,214,322,3,991,55,0,2,31,4,29330,12009,2222,17943,0
56,1686,1523,757,1297,19,12,193,1542,12,193,117,230,205,347,1508,2664,7,19053,1058,0,2,54,35,29370,12023,2225,17965,0
56,1686,701,378,504,33,58,109,734,13,110,68,126,123,194,794,1346,7,10027,557,0,2,54,35,29370,12024,2226,17966,0
56,1686,1523,757,1297,19,12,193,1542,12,193,117,230,205,347,1508,2664,7,19053,1058,0,2,3,3,29380,12026,2226,17967,0
56,1686,701,378,504,33,58,109,734,13,110,68,126,123,194,794,1346,7,10027,557,0,2,3,3,29380,12027,2227,17968,0
45,2836,1523,757,1297,19,12,193,1542,12,193,117,230,205,347,1508,2664,7,19053,1058,0,2,87,71,29390,12029,2227,17969,0
58,2876,1523,757,1297,19,12,193,1542,12,193,117,230,205,347,1508,2664,7,19053,1058,0,2,204,166,29400,12031,2227,17970,1
58,2876,1523,757,1297,19,12,193,1542,12,193,117,230,205,347,1508,2664,7,19053,1058,0,2,6,1,29410,12033,2227,17971,1
61,1745,1523,757,1297,19,12,193,1542,12,193,117,230,205,347,1508,2664,7,19053,1058,0,2,42,32,29420,12035,2227,17972,0
61,1745,701,378,504,33,58,109,734,13,110,68,126,123,194,794,1346,7,10027,557,0,2,42,32,29420,12036,2228,17973,0
60,2900,1523,757,1297,19,12,193,1542,12,193,117,230,205,347,1508,2664,7,19053,1058,0,2,6,1,29430,12038,2228,17974,0
61,1734,1523,757,1297,19,12,193,1542,12,193,117,230,205,347,1508,2664,7,19053,1058,0,2,0,1,29440,12040,2228,17975,0
61,1734,701,378,504,33,58,109,734,13,110,68,126,123,194,794,1346,7,10027,557,0,2,0,1,29440,12041,2229,17976,0
64,1801,1523,757,1297,19,12,193,1542,12,193,117,230,205,347,1508,2664,7,19053,1058,0,2,52,34,29450,12043,2229,17977,1
64,1801,701,378,504,33,58,109,734,13,110,68,126,123,194,794,1346,7,10027,557,0,2,52,34,29450,12044,2230,17978,1
64,1790,1523,757,1297,19,12,193,1542,12,193,117,230,205,347,1508,2664,7,19053,1058,0,2,2,2,29460,12046,2230,17979,0
64,1790,701,378,504,33,58,109,734,13,110,68,126,123,194,794,1346,7,10027,557,0,2,2,2,29460,12047,2231,17980,0
65,1814,1523,757,1297,19,12,193,1542,12,193,117,230,205,347,1508,2664,7,19053,1058,0,2,7,3,29470,12049,2231,17981,0
65,1814,701,378,504,33,58,109,734,13,110,68,126,123,194,794,1346,7,10027,557,0,2,7,3,29470,12050,2232,17982,0
61,2932,1523,757,1297,19,12,193,1542,12,193,117,230,205,347,1508,2664,7,19053,1058,0,2,6,2,29480,12052,2232,17983,0
65,1825,1523,757,1297,19,12,193,1542,12,193,117,230,205,347,1508,2664,7,19053,1058,0,2,120,118,29490,12054,2232,17984,1
65,1825,701,378,504,33,58,109,734,13,110,68,126,123,194,794,1346,7,10027,557,0,2,120,118,29490,12055,2233,17985,1
61,2942,1523,757,1297,19,12,193,1542,12,193,117,230,205,347,1508,2664,7,19053,1058,0,2,13,12,29500,12057,2233,17986,1
65,1835,1523,757,1297,19,12,193,1542,12,193,117,230,205,347,1508,2664,7,19053,1058,0,2,3,3,29510,12059,2233,17987,0
65,1835,701,378,504,33,58,109,734,13,110,68,126,123,194,794,1346,7,10027,557,0,2,3,3,29510,12060,2234,17988,0
61,2937,1523,757,1297,19,12,193,1542,12,193,117,230,205,347,1508,2664,7,19053,1058,0,2,1,1,29520,12062,2234,17989,0
67,1895,1523,757,1297,19,12,193,1542,12,193,117,230,205,347,1508,2664,7,19053,1058,0,2,8,0,29530,12064,2234,17990,0
67,1895,701,378,504,33,58,109,734,13,110,68,126,123,194,794,1346,7,10027,557,0,2,8,0,29530,12065,2235,17991,0
62,2941,1523,757,1297,19,12,193,1542,12,193,117,230,205,347,1508,2664,7,19053,1058,0,2,1,1,29540,12067,2235,17992,0
67,1895,1523,757,1297,19,12,193,1542,12,193,117,230,205,347,1508,2664,7,19053,1058,0,2,14,14,29550,12069,2235,17993,1
67,1895,701,378,504,33,58,109,734,13,110,68,126,123,194,794,1346,7,10027,557,0,2,14,14,29550,12070,2236,17994,1
67,1895,1523,757,1297,19,12,193,1542,12,193,117,230,205,347,1508,2664,7,19053,1058,0,2,1,2,29560,12072,2236,17995,0
67,1895,701,378,504,33,58,109,734,13,110,68,126,123,194,794,1346,7,10027,557,0,2,1,2,29560,12073,2237,17996,0
67,1895,1523,757,1297,19,12,193,1542,12,193,117,230,205,347,1508,2664,7,19053,1058,0,2,7,7,29570,12075,2237,17997,0
67,1895,701,378,504,33,58,109,734,13,110,68,126,123,194,794,1346,7,10027,557,0,2,7,7,29570,12076,2238,17998,0
63,2994,1523,757,1297,19,12,193,1542,12,193,117,230,205,347,1508,2664,7,19053,1058,0,2,11,0,29580,12078,2238,17999,1
67,1914,1523,757,1297,19,12,193,1542,12,193,117,230,205,347,1508,2664,7,19053,1058,0,2,13,7,29590,12080,2238,18000,1
67,1914,701,378,504,33,58,109,734,13,110,68,126,123,194,794,1346,7,10027,557,0,2,13,7,29590,12081,2239,18001,1
64,3043,1523,757,1297,19,12,193,1542,12,193,117,230,205,347,1508,2664,7,19053,1058,0,2,14,2,29600,12083,2239,18002,1
67,1914,1523,757,1297,19,12,193,1542,12,193,117,230,205,347,1508,2664,7,19053,1058,0,2,213,148,29610,12085,2239,18003,0
67,1914,701,378,504,33,58,109,734,13,110,68,126,123,194,794,1346,7,10027,557,0,2,213,148,29610,12086,2240,18004,0
64,3043,1523,757,1297,19,12,193,1542,12,193,117,230,205,347,1508,2664,7,19053,1058,0,2,239,147,29620,12088,2240,18005,0
116,2530,1043,504,840,53,9,147,1096,9,180,112,198,189,310,1377,2344,4,11604,644,0,2,5,1,29620,12090,2240,18006,1
116,2530,383,288,292,26,6,62,409,11,65,38,67,76,105,429,656,5,3719,206,0,2,5,1,29620,12091,2240,18007,1
95,1752,1178,367,1042,6,15,115,1184,9,94,51,95,103,146,644,976,4,4439,246,0,2,3,0,29620,12091,2240,18008,1
95,1752,177,108,140,8,0,27,185,6,30,16,32,36,48,162,248,3,794,44,0,2,3,0,29620,12093,2240,18009,1
180,3684,1943,715,1694,26,18,214,1969,12,185,120,237,197,357,1436,2721,7,20915,1161,0,2,16,1,29620,12095,2240,18010,1
180,3684,1168,838,957,57,25,144,1225,19,348,224,416,367,640,3018,5452,11,61921,3440,1,2,16,1,29630,12097,2240,18011,1
147,4720,1660,832,1314,41,38,274,1701,20,312,209,395,332,604,2671,5058,12,64042,3557,1,2,1,1,29630,12099,2241,18013,0
147,4720,1057,646,719,113,100,145,1170,18,215,134,248,233,382,1740,3004,10,31186,1732,1,2,1,1,29640,12100,2242,18014,0
57,1219,996,429,845,24,10,117,1020,7,76,50,88,83,138,494,879,4,3565,198,0,2,2,2,29640,12102,2242,18015,0
57,1219,456,277,329,12,42,72,468,13,85,50,97,98,147,592,972,7,7212,400,0,2,2,2,29640,12102,2242,18016,0
45,1334,1455,414,1257,16,76,112,1471,5,41,23,46,46,69,231,381,2,1069,59,0,2,21,8,29640,12103,2242,18017,0
45,1334,669,365,481,22,61,110,691,15,103,63,122,118,185,747,1273,8,11311,628,0,2,21,8,29650,12103,2243,18018,0
24,810,74,35,59,1,0,14,75,3,14,7,14,17,21,58,85,1,128,7,0,2,13,3,29650,12104,2243,18019,0
24,810,245,125,200,5,7,34,250,7,30,17,34,37,51,166,265,3,1053,58,0,2,13,3,29660,12105,2243,18020,0
67,1914,1523,757,1297,19,12,193,1542,12,193,117,230,205,347,1508,2664,7,19053,1058,0,2,213,148,29670,12107,2243,18021,0
67,1914,701,378,504,33,58,109,734,13,110,68,126,123,194,794,1346,7,10027,557,0,2,213,148,29670,12108,2244,18022,0
172,3983,77,34,69,0,0,8,77,3,24,16,29,27,45,114,213,1,387,21,0,2,0,6,29670,12108,2244,18023,0
172,3983,712,438,573,51,9,84,763,14,102,71,128,116,199,733,1364,8,11988,666,0,2,0,6,29680,12109,2244,18024,0
17,510,184,100,137,2,15,30,186,6,38,20,39,44,59,214,322,3,991,55,0,2,9,5,29680,12110,2244,18025,0
17,510,103,65,74,8,5,16,111,7,17,9,17,24,26,89,119,3,417,23,0,2,9,5,29680,12111,2244,18026,0
513,10975,72,33,56,0,4,12,72,1,1,1,1,2,2,0,2,0,1,0,0,2,67,14,29680,12111,2244,18027,0
513,10975,1454,835,1044,76,110,219,1530,17,275,158,296,292,454,2297,3718,9,34017,1889,1,2,67,14,29690,12112,2244,18028,0
41,944,386,256,301,16,9,68,402,4,59,35,69,63,104,355,621,2,1453,80,0,2,29,8,29690,12112,2244,18029,0
41,944,264,131,164,11,41,46,275,6,38,22,40,44,62,214,338,3,1068,59,0,2,29,8,29700,12112,2245,18030,0
115,2524,1043,504,840,53,9,147,1096,9,180,112,198,189,310,1377,2344,4,11604,644,0,2,1,1,29700,12114,2245,18031,0
115,2524,383,288,292,26,6,62,409,11,65,38,67,76,105,429,656,5,3719,206,0,2,1,1,29700,12115,2245,18032,0
176,3627,1943,715,1694,26,18,214,1969,12,185,120,237,197,357,1436,2721,7,20915,1161,0,2,7,2,29700,12117,2245,18033,0
176,3627,1168,838,957,57,25,144,1225,19,348,224,416,367,640,3018,5452,11,61921,3440,1,2,7,2,29710,12119,2245,18034,0
53,1075,1098,241,925,5,10,155,1103,7,46,25,49,53,74,273,423,3,1580,87,0,2,14,0,29720,12121,2245,18035,0
53,1075,282,202,222,14,2,44,296,8,42,24,43,50,67,250,378,4,1548,86,0,2,14,0,29720,12122,2245,18036,0
76,3610,1338,495,1086,10,64,173,1348,11,122,82,157,133,239,883,1686,7,11934,663,0,2,121,0,29720,12124,2245,18037,0
32,933,465,148,393,5,8,60,470,4,31,20,31,35,51,161,261,2,523,29,0,2,29,0,29720,12125,2245,18038,0
32,933,16,12,9,0,0,6,16,1,2,1,2,3,3,2,4,0,2,0,0,2,29,0,29720,12125,2245,18039,0
81,4395,1782,648,1425,9,47,279,1791,8,171,97,189,179,286,1292,2140,4,9462,525,0,2,36,0,29720,12126,2246,18040,0
44,1867,1455,414,1257,16,76,112,1471,5,41,23,46,46,69,231,381,2,1069,59,0,2,120,33,29720,12127,2246,18041,0
64,3043,1523,757,1297,19,12,193,1542,12,193,117,230,205,347,1508,2664,7,19053,1058,0,2,239,147,29730,12129,2246,18042,0
12,475,184,100,137,2,15,30,186,6,38,20,39,44,59,214,322,3,991,55,0,2,37,9,29730,12130,2246,18043,0
29,1180,386,256,301,16,9,68,402,4,59,35,69,63,104,355,621,2,1453,80,0,2,43,23,29730,12130,2246,18044,0
65,3364,1943,715,1694,26,18,214,1969,12,185,120,237,197,357,1436,2721,7,20915,1161,0,2,2,2,29730,12132,2246,18045,0
14,811,442,244,305,14,16,103,456,11,68,45,75,79,120,452,756,6,4588,254,0,2,12,11,29730,12134,2246,18046,0
38,1508,1098,241,925,5,10,155,1103,7,46,25,49,53,74,273,423,3,1580,87,0,2,16,0,29740,12136,2246,18047,0
29,1184,386,256,301,16,9,68,402,4,59,35,69,63,104,355,621,2,1453,80,0,2,2,2,29740,12136,2246,18048,1
40,938,386,256,301,16,9,68,402,4,59,35,69,63,104,355,621,2,1453,80,0,2,1,1,29740,12136,2246,18049,1
40,938,264,131,164,11,41,46,275,6,38,22,40,44,62,214,338,3,1068,59,0,2,1,1,29750,12136,2247,18050,1
27,1135,386,256,301,16,9,68,402,4,59,35,69,63,104,355,621,2,1453,80,0,2,5,4,29750,12136,2247,18051,1
68,3477,1943,715,1694,26,18,214,1969,12,185,120,237,197,357,1436,2721,7,20915,1161,0,2,25,0,29750,12138,2247,18052,0
68,3495,1943,715,1694,26,18,214,1969,12,185,120,237,197,357,1436,2721,7,20915,1161,0,2,2,0,29750,12140,2247,18053,0
40,938,386,256,301,16,9,68,402,4,59,35,69,63,104,355,621,2,1453,80,0,2,1,1,29750,12140,2247,18054,0
40,938,264,131,164,11,41,46,275,6,38,22,40,44,62,214,338,3,1068,59,0,2,1,1,29760,12140,2248,18055,0
27,1135,386,256,301,16,9,68,402,4,59,35,69,63,104,355,621,2,1453,80,0,2,5,4,29760,12140,2248,18056,0
116,2530,1043,504,840,53,9,147,1096,9,180,112,198,189,310,1377,2344,4,11604,644,0,2,5,1,29760,12142,2248,18057,0
116,2530,383,288,292,26,6,62,409,11,65,38,67,76,105,429,656,5,3719,206,0,2,5,1,29760,12143,2248,18058,0
95,1752,1178,367,1042,6,15,115,1184,9,94,51,95,103,146,644,976,4,4439,246,0,2,3,0,29760,12143,2248,18059,0
95,1752,177,108,140,8,0,27,185,6,30,16,32,36,48,162,248,3,794,44,0,2,3,0,29760,12145,2248,18060,0
180,3684,1943,715,1694,26,18,214,1969,12,185,120,237,197,357,1436,2721,7,20915,1161,0,2,16,1,29760,12147,2248,18061,0
180,3684,1168,838,957,57,25,144,1225,19,348,224,416,367,640,3018,5452,11,61921,3440,1,2,16,1,29770,12149,2248,18062,0
68,3495,1943,715,1694,26,18,214,1969,12,185,120,237,197,357,1436,2721,7,20915,1161,0,2,27,0,29770,12151,2248,18063,0
513,10978,72,33,56,0,4,12,72,1,1,1,1,2,2,0,2,0,1,0,0,2,1,1,29770,12151,2248,18064,0
513,10978,1454,835,1044,76,110,219,1530,17,275,158,296,292,454,2297,3718,9,34017,1889,1,2,1,1,29780,12152,2248,18065,0
147,4720,1660,832,1314,41,38,274,1701,20,312,209,395,332,604,2671,5058,12,64042,3557,1,2,1,1,29780,12154,2249,18067,0
147,4720,1057,646,719,113,100,145,1170,18,215,134,248,233,382,1740,3004,10,31186,1732,1,2,1,1,29790,12155,2250,18068,0
57,1219,996,429,845,24,10,117,1020,7,76,50,88,83,138,494,879,4,3565,198,0,2,2,2,29790,12157,2250,18069,0
57,1219,456,277,329,12,42,72,468,13,85,50,97,98,147,592,972,7,7212,400,0,2,2,2,29790,12157,2250,18070,0
45,1334,1455,414,1257,16,76,112,1471,5,41,23,46,46,69,231,381,2,1069,59,0,2,21,8,29790,12158,2250,18071,0
45,1334,669,365,481,22,61,110,691,15,103,63,122,118,185,747,1273,8,11311,628,0,2,21,8,29800,12158,2251,18072,0
24,810,74,35,59,1,0,14,75,3,14,7,14,17,21,58,85,1,128,7,0,2,13,3,29800,12159,2251,18073,0
24,810,245,125,200,5,7,34,250,7,30,17,34,37,51,166,265,3,1053,58,0,2,13,3,29810,12160,2251,18074,0
67,1914,1523,757,1297,19,12,193,1542,12,193,117,230,205,347,1508,2664,7,19053,1058,0,2,213,148,29820,12162,2251,18075,0
67,1914,701,378,504,33,58,109,734,13,110,68,126,123,194,794,1346,7,10027,557,0,2,213,148,29820,12163,2252,18076,0
172,3983,77,34,69,0,0,8,77,3,24,16,29,27,45,114,213,1,387,21,0,2,0,6,29820,12163,2252,18077,0
172,3983,712,438,573,51,9,84,763,14,102,71,128,116,199,733,1364,8,11988,666,0,2,0,6,29830,12164,2252,18078,0
17,510,184,100,137,2,15,30,186,6,38,20,39,44,59,214,322,3,991,55,0,2,9,5,29830,12165,2252,18079,0
17,510,103,65,74,8,5,16,111,7,17,9,17,24,26,89,119,3,417,23,0,2,9,5,29830,12166,2252,18080,0
513,10975,72,33,56,0,4,12,72,1,1,1,1,2,2,0,2,0,1,0,0,2,67,14,29830,12166,2252,18081,0
513,10975,1454,835,1044,76,110,219,1530,17,275,158,296,292,454,2297,3718,9,34017,1889,1,2,67,14,29840,12167,2252,18082,0
41,944,386,256,301,16,9,68,402,4,59,35,69,63,104,355,621,2,1453,80,0,2,29,8,29840,12167,2252,18083,0
41,944,264,131,164,11,41,46,275,6,38,22,40,44,62,214,338,3,1068,59,0,2,29,8,29850,12167,2253,18084,0
116,2530,1043,504,840,53,9,147,1096,9,180,112,198,189,310,1377,2344,4,11604,644,0,2,1,1,29850,12169,2253,18085,0
116,2530,383,288,292,26,6,62,409,11,65,38,67,76,105,429,656,5,3719,206,0,2,1,1,29850,12170,2253,18086,0
181,3706,1943,715,1694,26,18,214,1969,12,185,120,237,197,357,1436,2721,7,20915,1161,0,2,7,2,29850,12172,2253,18087,0
181,3706,1168,838,957,57,25,144,1225,19,348,224,416,367,640,3018,5452,11,61921,3440,1,2,7,2,29860,12174,2253,18088,0
53,1075,1098,241,925,5,10,155,1103,7,46,25,49,53,74,273,423,3,1580,87,0,2,14,0,29870,12176,2253,18089,0
53,1075,282,202,222,14,2,44,296,8,42,24,43,50,67,250,378,4,1548,86,0,2,14,0,29870,12177,2253,18090,0
76,3610,1338,495,1086,10,64,173,1348,11,122,82,157,133,239,883,1686,7,11934,663,0,2,121,0,29870,12179,2253,18091,0
32,933,465,148,393,5,8,60,470,4,31,20,31,35,51,161,261,2,523,29,0,2,29,0,29870,12180,2253,18092,0
32,933,16,12,9,0,0,6,16,1,2,1,2,3,3,2,4,0,2,0,0,2,29,0,29870,12180,2253,18093,0
81,4395,1782,648,1425,9,47,279,1791,8,171,97,189,179,286,1292,2140,4,9462,525,0,2,36,0,29870,12181,2254,18094,0
44,1867,1455,414,1257,16,76,112,1471,5,41,23,46,46,69,231,381,2,1069,59,0,2,120,33,29870,12182,2254,18095,0
64,3043,1523,757,1297,19,12,193,1542,12,193,117,230,205,347,1508,2664,7,19053,1058,0,2,239,147,29880,12184,2254,18096,0
12,475,184,100,137,2,15,30,186,6,38,20,39,44,59,214,322,3,991,55,0,2,37,9,29880,12185,2254,18097,0
29,1184,386,256,301,16,9,68,402,4,59,35,69,63,104,355,621,2,1453,80,0,2,45,25,29880,12185,2254,18098,0
68,3495,1943,715,1694,26,18,214,1969,12,185,120,237,197,357,1436,2721,7,20915,1161,0,2,2,2,29880,12187,2254,18099,0
14,811,442,244,305,14,16,103,456,11,68,45,75,79,120,452,756,6,4588,254,0,2,12,11,29880,12189,2254,18100,0
38,1508,1098,241,925,5,10,155,1103,7,46,25,49,53,74,273,423,3,1580,87,0,2,16,0,29890,12191,2254,18101,0
41,947,386,256,301,16,9,68,402,4,59,35,69,63,104,355,621,2,1453,80,0,2,1,1,29890,12191,2254,18102,0
41,947,264,131,164,11,41,46,275,6,38,22,40,44,62,214,338,3,1068,59,0,2,1,1,29900,12191,2255,18103,0
29,1196,386,256,301,16,9,68,402,4,59,35,69,63,104,355,621,2,1453,80,0,2,5,4,29900,12191,2255,18104,0
77,3648,1338,495,1086,10,64,173,1348,11,122,82,157,133,239,883,1686,7,11934,663,0,2,16,0,29900,12193,2255,18105,1
77,3648,1338,495,1086,10,64,173,1348,11,122,82,157,133,239,883,1686,7,11934,663,0,2,1,1,29900,12195,2255,18106,0
147,4720,1660,832,1314,41,38,274,1701,20,312,209,395,332,604,2671,5058,12,64042,3557,1,2,1,1,29900,12197,2256,18108,0
147,4720,1057,646,719,113,100,145,1170,18,215,134,248,233,382,1740,3004,10,31186,1732,1,2,1,1,29910,12198,2257,18109,0
57,1219,996,429,845,24,10,117,1020,7,76,50,88,83,138,494,879,4,3565,198,0,2,2,2,29910,12200,2257,18110,0
57,1219,456,277,329,12,42,72,468,13,85,50,97,98,147,592,972,7,7212,400,0,2,2,2,29910,12200,2257,18111,0
45,1334,1455,414,1257,16,76,112,1471,5,41,23,46,46,69,231,381,2,1069,59,0,2,21,8,29910,12201,2257,18112,0
45,1334,669,365,481,22,61,110,691,15,103,63,122,118,185,747,1273,8,11311,628,0,2,21,8,29920,12201,2258,18113,0
24,810,74,35,59,1,0,14,75,3,14,7,14,17,21,58,85,1,128,7,0,2,13,3,29920,12202,2258,18114,0
24,810,245,125,200,5,7,34,250,7,30,17,34,37,51,166,265,3,1053,58,0,2,13,3,29930,12203,2258,18115,0
67,1914,1523,757,1297,19,12,193,1542,12,193,117,230,205,347,1508,2664,7,19053,1058,0,2,213,148,29940,12205,2258,18116,0
67,1914,701,378,504,33,58,109,734,13,110,68,126,123,194,794,1346,7,10027,557,0,2,213,148,29940,12206,2259,18117,0
172,3983,77,34,69,0,0,8,77,3,24,16,29,27,45,114,213,1,387,21,0,2,0,6,29940,12206,2259,18118,0
172,3983,712,438,573,51,9,84,763,14,102,71,128,116,199,733,1364,8,11988,666,0,2,0,6,29950,12207,2259,18119,0
17,510,184,100,137,2,15,30,186,6,38,20,39,44,59,214,322,3,991,55,0,2,9,5,29950,12208,2259,18120,0
17,510,103,65,74,8,5,16,111,7,17,9,17,24,26,89,119,3,417,23,0,2,9,5,29950,12209,2259,18121,0
513,10975,72,33,56,0,4,12,72,1,1,1,1,2,2,0,2,0,1,0,0,2,67,14,29950,12209,2259,18122,0
513,10975,1454,835,1044,76,110,219,1530,17,275,158,296,292,454,2297,3718,9,34017,1889,1,2,67,14,29960,12210,2259,18123,0
41,947,386,256,301,16,9,68,402,4,59,35,69,63,104,355,621,2,1453,80,0,2,29,8,29960,12210,2259,18124,0
41,947,264,131,164,11,41,46,275,6,38,22,40,44,62,214,338,3,1068,59,0,2,29,8,29970,12210,2260,18125,0
116,2530,1043,504,840,53,9,147,1096,9,180,112,198,189,310,1377,2344,4,11604,644,0,2,1,1,29970,12212,2260,18126,0
116,2530,383,288,292,26,6,62,409,11,65,38,67,76,105,429,656,5,3719,206,0,2,1,1,29970,12213,2260,18127,0
181,3706,1943,715,1694,26,18,214,1969,12,185,120,237,197,357,1436,2721,7,20915,1161,0,2,7,2,29970,12215,2260,18128,0
181,3706,1168,838,957,57,25,144,1225,19,348,224,416,367,640,3018,5452,11,61921,3440,1,2,7,2,29980,12217,2260,18129,0
53,1075,1098,241,925,5,10,155,1103,7,46,25,49,53,74,273,423,3,1580,87,0,2,14,0,29990,12219,2260,18130,0
53,1075,282,202,222,14,2,44,296,8,42,24,43,50,67,250,378,4,1548,86,0,2,14,0,29990,12220,2260,18131,0
76,3610,1338,495,1086,10,64,173,1348,11,122,82,157,133,239,883,1686,7,11934,663,0,2,121,0,29990,12222,2260,18132,0
32,933,465,148,393,5,8,60,470,4,31,20,31,35,51,161,261,2,523,29,0,2,29,0,29990,12223,2260,18133,0
32,933,16,12,9,0,0,6,16,1,2,1,2,3,3,2,4,0,2,0,0,2,29,0,29990,12223,2260,18134,0
81,4395,1782,648,1425,9,47,279,1791,8,171,97,189,179,286,1292,2140,4,9462,525,0,2,36,0,29990,12224,2261,18135,0
44,1867,1455,414,1257,16,76,112,1471,5,41,23,46,46,69,231,381,2,1069,59,0,2,120,33,29990,12225,2261,18136,0
64,3043,1523,757,1297,19,12,193,1542,12,193,117,230,205,347,1508,2664,7,19053,1058,0,2,239,147,30000,12227,2261,18137,0
12,475,184,100,137,2,15,30,186,6,38,20,39,44,59,214,322,3,991,55,0,2,37,9,30000,12228,2261,18138,0
29,1196,386,256,301,16,9,68,402,4,59,35,69,63,104,355,621,2,1453,80,0,2,46,25,30000,12228,2261,18139,0
68,3495,1943,715,1694,26,18,214,1969,12,185,120,237,197,357,1436,2721,7,20915,1161,0,2,2,2,30000,12230,2261,18140,0
14,811,442,244,305,14,16,103,456,11,68,45,75,79,120,452,756,6,4588,254,0,2,12,11,30000,12232,2261,18141,0
38,1508,1098,241,925,5,10,155,1103,7,46,25,49,53,74,273,423,3,1580,87,0,2,16,0,30010,12234,2261,18142,0
77,3658,1338,495,1086,10,64,173,1348,11,122,82,157,133,239,883,1686,7,11934,663,0,2,1,0,30010,12236,2261,18143,0
77,3658,1338,495,1086,10,64,173,1348,11,122,82,157,133,239,883,1686,7,11934,663,0,2,1,1,30010,12238,2261,18144,0
77,3659,1338,495,1086,10,64,173,1348,11,122,82,157,133,239,883,1686,7,11934,663,0,2,6,0,30010,12240,2261,18145,0
513,10978,72,33,56,0,4,12,72,1,1,1,1,2,2,0,2,0,1,0,0,2,1,1,30010,12240,2261,18146,0
513,10978,1454,835,1044,76,110,219,1530,17,275,158,296,292,454,2297,3718,9,34017,1889,1,2,1,1,30020,12241,2261,18147,0
77,3659,1338,495,1086,10,64,173,1348,11,122,82,157,133,239,883,1686,7,11934,663,0,2,23,0,30020,12243,2261,18148,0
513,10978,72,33,56,0,4,12,72,1,1,1,1,2,2,0,2,0,1,0,0,2,1,1,30040,12251,2263,18163,0
513,10978,1454,835,1044,76,110,219,1530,17,275,158,296,292,454,2297,3718,9,34017,1889,1,2,1,1,30050,12252,2263,18164,0
77,3659,1338,495,1086,10,64,173,1348,11,122,82,157,133,239,883,1686,7,11934,663,0,2,23,0,30050,12254,2263,18165,0
513,10978,72,33,56,0,4,12,72,1,1,1,1,2,2,0,2,0,1,0,0,2,1,1,30050,12254,2263,18166,0
513,10978,1454,835,1044,76,110,219,1530,17,275,158,296,292,454,2297,3718,9,34017,1889,1,2,1,1,30060,12255,2263,18167,0
77,3659,1338,495,1086,10,64,173,1348,11,122,82,157,133,239,883,1686,7,11934,663,0,2,23,0,30060,12257,2263,18168,0
46,531,647,139,84,35,284,233,682,0,0,0,0,0,0,0,0,0,0,0,0,2,2,3,30060,12257,2263,18169,0
46,531,647,139,84,35,284,233,682,0,0,0,0,0,0,0,0,0,0,0,0,2,2,3,30060,12257,2263,18170,0
69,1963,1523,757,1297,19,12,193,1542,12,193,117,230,205,347,1508,2664,7,19053,1058,0,2,10,6,30070,12259,2263,18171,0
69,1963,701,378,504,33,58,109,734,13,110,68,126,123,194,794,1346,7,10027,557,0,2,10,6,30070,12260,2264,18172,0
65,3107,1523,757,1297,19,12,193,1542,12,193,117,230,205,347,1508,2664,7,19053,1058,0,2,41,4,30080,12262,2264,18173,0
9,220,19,8,11,5,0,4,24,2,5,3,6,7,9,13,25,1,30,1,0,2,0,3,30080,12262,2264,18174,1
9,220,102,59,69,5,3,24,107,6,22,15,28,28,43,113,206,3,789,43,0,2,0,3,30080,12262,2264,18175,1
9,220,106,40,36,3,49,17,109,8,17,13,23,25,36,93,167,5,904,50,0,2,0,3,30080,12262,2264,18176,1
69,2867,1289,550,1043,56,32,155,1345,10,167,93,185,177,278,1266,2075,5,11498,638,0,2,0,3,30080,12264,2265,18177,1
23,594,102,59,69,5,3,24,107,6,22,15,28,28,43,113,206,3,789,43,0,2,0,4,30080,12264,2265,18178,1
74,2661,1450,624,1228,12,26,181,1462,14,306,186,354,320,540,2580,4493,8,36391,2021,1,2,1,8,30080,12266,2266,18179,1
63,2582,1020,354,843,12,15,144,1032,8,134,77,144,142,221,970,1580,4,6792,377,0,2,0,2,30080,12266,2266,18180,1
21,647,424,94,331,4,0,89,428,1,5,5,5,6,10,11,25,0,12,0,0,2,0,1,30080,12267,2266,18181,1
38,2201,334,251,279,10,4,40,344,5,127,74,143,132,217,899,1528,2,4303,239,0,2,0,6,30080,12268,2266,18182,1
9,220,19,8,11,5,0,4,24,2,5,3,6,7,9,13,25,1,30,1,0,2,0,3,30080,12268,2266,18183,0
9,220,102,59,69,5,3,24,107,6,22,15,28,28,43,113,206,3,789,43,0,2,0,3,30080,12268,2266,18184,0
9,220,106,40,36,3,49,17,109,8,17,13,23,25,36,93,167,5,904,50,0,2,0,3,30080,12268,2266,18185,0
69,2867,1289,550,1043,56,32,155,1345,10,167,93,185,177,278,1266,2075,5,11498,638,0,2,0,3,30080,12270,2267,18186,0
23,594,102,59,69,5,3,24,107,6,22,15,28,28,43,113,206,3,789,43,0,2,0,4,30080,12270,2267,18187,0
74,2661,1450,624,1228,12,26,181,1462,14,306,186,354,320,540,2580,4493,8,36391,2021,1,2,1,8,30080,12272,2268,18188,0
63,2582,1020,354,843,12,15,144,1032,8,134,77,144,142,221,970,1580,4,6792,377,0,2,0,2,30080,12272,2268,18189,0
21,647,424,94,331,4,0,89,428,1,5,5,5,6,10,11,25,0,12,0,0,2,0,1,30080,12273,2268,18190,0
38,2201,334,251,279,10,4,40,344,5,127,74,143,132,217,899,1528,2,4303,239,0,2,0,6,30080,12274,2268,18191,0
68,3173,1523,757,1297,19,12,193,1542,12,193,117,230,205,347,1508,2664,7,19053,1058,0,2,27,10,30090,12276,2268,18192,0
68,3179,1523,757,1297,19,12,193,1542,12,193,117,230,205,347,1508,2664,7,19053,1058,0,2,3,0,30100,12278,2268,18193,0
114,2289,1513,682,1277,25,13,200,1538,11,199,116,219,210,335,1557,2584,6,15641,868,0,2,8,0,30100,12280,2268,18194,0
114,2289,819,519,539,24,98,155,843,15,96,57,106,111,163,690,1107,8,9171,509,0,2,8,0,30110,12282,2268,18195,0
114,2287,1513,682,1277,25,13,200,1538,11,199,116,219,210,335,1557,2584,6,15641,868,0,2,26,8,30110,12284,2268,18196,1
114,2287,819,519,539,24,98,155,843,15,96,57,106,111,163,690,1107,8,9171,509,0,2,26,8,30120,12286,2268,18197,1
115,2299,1513,682,1277,25,13,200,1538,11,199,116,219,210,335,1557,2584,6,15641,868,0,2,5,3,30120,12288,2268,18198,1
115,2299,819,519,539,24,98,155,843,15,96,57,106,111,163,690,1107,8,9171,509,0,2,5,3,30130,12290,2268,18199,1
115,2299,1513,682,1277,25,13,200,1538,11,199,116,219,210,335,1557,2584,6,15641,868,0,2,1,1,30130,12292,2268,18200,0
115,2299,819,519,539,24,98,155,843,15,96,57,106,111,163,690,1107,8,9171,509,0,2,1,1,30140,12294,2268,18201,0
115,2299,1513,682,1277,25,13,200,1538,11,199,116,219,210,335,1557,2584,6,15641,868,0,2,28,0,30140,12296,2268,18202,0
115,2299,819,519,539,24,98,155,843,15,96,57,106,111,163,690,1107,8,9171,509,0,2,28,0,30150,12298,2268,18203,0
48,975,447,308,343,6,5,95,453,7,96,59,111,103,170,651,1136,4,4600,255,0,2,21,1,30150,12301,2268,18204,1
48,975,322,174,179,16,74,51,338,10,41,26,46,51,72,252,408,5,2291,127,0,2,21,1,30150,12304,2269,18205,1
36,1591,447,308,343,6,5,95,453,7,96,59,111,103,170,651,1136,4,4600,255,0,2,17,0,30150,12307,2269,18206,1
48,975,447,308,343,6,5,95,453,7,96,59,111,103,170,651,1136,4,4600,255,0,2,21,1,30150,12310,2269,18207,0
48,975,322,174,179,16,74,51,338,10,41,26,46,51,72,252,408,5,2291,127,0,2,21,1,30150,12313,2270,18208,0
36,1591,447,308,343,6,5,95,453,7,96,59,111,103,170,651,1136,4,4600,255,0,2,17,0,30150,12316,2270,18209,0
49,1414,1455,414,1257,16,76,112,1471,5,41,23,46,46,69,231,381,2,1069,59,0,2,39,21,30150,12317,2270,18210,1
49,1414,669,365,481,22,61,110,691,15,103,63,122,118,185,747,1273,8,11311,628,0,2,39,21,30160,12317,2271,18211,1
47,2014,1455,414,1257,16,76,112,1471,5,41,23,46,46,69,231,381,2,1069,59,0,2,46,1,30160,12318,2271,18212,1
48,973,447,308,343,6,5,95,453,7,96,59,111,103,170,651,1136,4,4600,255,0,2,6,7,30160,12321,2271,18213,1
48,973,322,174,179,16,74,51,338,10,41,26,46,51,72,252,408,5,2291,127,0,2,6,7,30160,12324,2272,18214,1
48,1368,1455,414,1257,16,76,112,1471,5,41,23,46,46,69,231,381,2,1069,59,0,2,12,3,30160,12325,2272,18215,0
48,1368,669,365,481,22,61,110,691,15,103,63,122,118,185,747,1273,8,11311,628,0,2,12,3,30170,12325,2273,18216,0
49,1371,1455,414,1257,16,76,112,1471,5,41,23,46,46,69,231,381,2,1069,59,0,2,2,2,30170,12326,2273,18217,1
49,1371,669,365,481,22,61,110,691,15,103,63,122,118,185,747,1273,8,11311,628,0,2,2,2,30180,12326,2274,18218,1
46,1984,1455,414,1257,16,76,112,1471,5,41,23,46,46,69,231,381,2,1069,59,0,2,32,2,30180,12327,2274,18219,1
49,1371,1455,414,1257,16,76,112,1471,5,41,23,46,46,69,231,381,2,1069,59,0,2,12,3,30180,12328,2274,18220,0
49,1371,669,365,481,22,61,110,691,15,103,63,122,118,185,747,1273,8,11311,628,0,2,12,3,30190,12328,2275,18221,0
46,1984,1455,414,1257,16,76,112,1471,5,41,23,46,46,69,231,381,2,1069,59,0,2,32,2,30190,12329,2275,18222,0
48,973,447,308,343,6,5,95,453,7,96,59,111,103,170,651,1136,4,4600,255,0,2,6,7,30190,12332,2275,18223,0
48,973,322,174,179,16,74,51,338,10,41,26,46,51,72,252,408,5,2291,127,0,2,6,7,30190,12335,2276,18224,0
53,1451,1455,414,1257,16,76,112,1471,5,41,23,46,46,69,231,381,2,1069,59,0,2,39,21,30190,12336,2276,18225,0
53,1451,669,365,481,22,61,110,691,15,103,63,122,118,185,747,1273,8,11311,628,0,2,39,21,30200,12336,2277,18226,0
49,2131,1455,414,1257,16,76,112,1471,5,41,23,46,46,69,231,381,2,1069,59,0,2,45,0,30200,12337,2277,18227,0
115,2299,1513,682,1277,25,13,200,1538,11,199,116,219,210,335,1557,2584,6,15641,868,0,2,28,0,30200,12339,2277,18228,0
115,2299,819,519,539,24,98,155,843,15,96,57,106,111,163,690,1107,8,9171,509,0,2,28,0,30210,12341,2277,18229,0
46,532,647,139,84,35,284,233,682,0,0,0,0,0,0,0,0,0,0,0,0,2,2,3,30210,12341,2277,18230,0
69,1963,1523,757,1297,19,12,193,1542,12,193,117,230,205,347,1508,2664,7,19053,1058,0,2,10,6,30220,12343,2277,18231,0
69,1963,701,378,504,33,58,109,734,13,110,68,126,123,194,794,1346,7,10027,557,0,2,10,6,30220,12344,2278,18232,0
48,973,447,308,343,6,5,95,453,7,96,59,111,103,170,651,1136,4,4600,255,0,2,27,8,30220,12347,2278,18233,0
48,973,322,174,179,16,74,51,338,10,41,26,46,51,72,252,408,5,2291,127,0,2,27,8,30220,12350,2279,18234,0
68,3179,1523,757,1297,19,12,193,1542,12,193,117,230,205,347,1508,2664,7,19053,1058,0,2,63,6,30230,12352,2279,18235,0
36,1591,447,308,343,6,5,95,453,7,96,59,111,103,170,651,1136,4,4600,255,0,2,17,0,30230,12355,2279,18236,0
176,3627,1943,715,1694,26,18,214,1969,12,185,120,237,197,357,1436,2721,7,20915,1161,0,2,1,1,30230,12357,2279,18237,1
176,3627,1168,838,957,57,25,144,1225,19,348,224,416,367,640,3018,5452,11,61921,3440,1,2,1,1,30240,12359,2279,18238,1
66,3398,1943,715,1694,26,18,214,1969,12,185,120,237,197,357,1436,2721,7,20915,1161,0,2,17,0,30240,12361,2279,18239,1
176,3627,1943,715,1694,26,18,214,1969,12,185,120,237,197,357,1436,2721,7,20915,1161,0,2,1,1,30240,12363,2279,18240,0
176,3627,1168,838,957,57,25,144,1225,19,348,224,416,367,640,3018,5452,11,61921,3440,1,2,1,1,30250,12365,2279,18241,0
66,3398,1943,715,1694,26,18,214,1969,12,185,120,237,197,357,1436,2721,7,20915,1161,0,2,17,0,30250,12367,2279,18242,0
181,3706,1943,715,1694,26,18,214,1969,12,185,120,237,197,357,1436,2721,7,20915,1161,0,2,1,2,30250,12369,2279,18243,0
181,3706,1168,838,957,57,25,144,1225,19,348,224,416,367,640,3018,5452,11,61921,3440,1,2,1,2,30260,12371,2279,18244,0
69,3529,1943,715,1694,26,18,214,1969,12,185,120,237,197,357,1436,2721,7,20915,1161,0,2,17,0,30260,12373,2279,18245,0
45,1324,1455,414,1257,16,76,112,1471,5,41,23,46,46,69,231,381,2,1069,59,0,2,7,7,30260,12374,2279,18246,1
45,1324,669,365,481,22,61,110,691,15,103,63,122,118,185,747,1273,8,11311,628,0,2,7,7,30270,12374,2280,18247,1
46,1976,1455,414,1257,16,76,112,1471,5,41,23,46,46,69,231,381,2,1069,59,0,2,59,1,30270,12375,2280,18248,1
21,592,1293,570,1093,25,15,163,1318,10,195,123,241,205,364,1516,2795,6,17273,959,0,2,3,1,30280,12377,2280,18249,1
34,1287,1293,570,1093,25,15,163,1318,10,195,123,241,205,364,1516,2795,6,17273,959,0,2,16,0,30290,12379,2280,18250,1
21,592,1293,570,1093,25,15,163,1318,10,195,123,241,205,364,1516,2795,6,17273,959,0,2,3,1,30300,12381,2280,18251,0
34,1287,1293,570,1093,25,15,163,1318,10,195,123,241,205,364,1516,2795,6,17273,959,0,2,16,0,30310,12383,2280,18252,0
45,1324,1455,414,1257,16,76,112,1471,5,41,23,46,46,69,231,381,2,1069,59,0,2,7,7,30310,12384,2280,18253,0
45,1324,669,365,481,22,61,110,691,15,103,63,122,118,185,747,1273,8,11311,628,0,2,7,7,30320,12384,2281,18254,0
46,1976,1455,414,1257,16,76,112,1471,5,41,23,46,46,69,231,381,2,1069,59,0,2,59,1,30320,12385,2281,18255,0
36,711,2,2,2,0,0,0,2,0,0,0,0,0,0,0,0,0,0,0,0,2,11,2,30320,12385,2281,18255,1
36,711,99,48,90,1,3,5,100,0,0,0,0,0,0,0,0,0,0,0,0,2,11,2,30320,12386,2281,18256,1
36,711,8,5,5,2,0,1,10,0,0,0,0,0,0,0,0,0,0,0,0,2,11,2,30320,12386,2281,18257,1
36,711,1217,716,841,84,126,174,1301,14,185,118,215,199,333,1446,2542,8,20687,1149,0,2,11,2,30330,12388,2281,18258,1
36,711,160,89,115,0,13,31,160,7,15,11,17,22,28,78,124,3,495,27,0,2,11,2,30330,12388,2281,18259,1
36,711,10,10,9,9,0,0,19,0,0,0,0,0,0,0,0,0,0,0,0,2,11,2,30330,12388,2282,18260,1
36,711,173,84,99,8,29,36,181,5,12,7,13,17,20,54,81,2,221,12,0,2,11,2,30330,12389,2282,18261,1
36,711,3,1,1,3,0,0,6,0,0,0,0,0,0,0,0,0,0,0,0,2,11,2,30330,12389,2282,18262,1
74,2699,1450,624,1228,12,26,181,1462,14,306,186,354,320,540,2580,4493,8,36391,2021,1,2,8,1,30330,12391,2283,18263,1
36,711,2,2,2,0,0,0,2,0,0,0,0,0,0,0,0,0,0,0,0,2,11,2,30330,12391,2283,18263,0
36,711,99,48,90,1,3,5,100,0,0,0,0,0,0,0,0,0,0,0,0,2,11,2,30330,12392,2283,18264,0
36,711,8,5,5,2,0,1,10,0,0,0,0,0,0,0,0,0,0,0,0,2,11,2,30330,12392,2283,18265,0
36,711,1217,716,841,84,126,174,1301,14,185,118,215,199,333,1446,2542,8,20687,1149,0,2,11,2,30340,12394,2283,18266,0
36,711,160,89,115,0,13,31,160,7,15,11,17,22,28,78,124,3,495,27,0,2,11,2,30340,12394,2283,18267,0
36,711,10,10,9,9,0,0,19,0,0,0,0,0,0,0,0,0,0,0,0,2,11,2,30340,12394,2284,18268,0
36,711,173,84,99,8,29,36,181,5,12,7,13,17,20,54,81,2,221,12,0,2,11,2,30340,12395,2284,18269,0
36,711,3,1,1,3,0,0,6,0,0,0,0,0,0,0,0,0,0,0,0,2,11,2,30340,12395,2284,18270,0
74,2699,1450,624,1228,12,26,181,1462,14,306,186,354,320,540,2580,4493,8,36391,2021,1,2,8,1,30340,12397,2285,18271,0
33,678,2,2,2,0,0,0,2,0,0,0,0,0,0,0,0,0,0,0,0,2,2,2,30340,12397,2285,18271,1
33,678,99,48,90,1,3,5,100,0,0,0,0,0,0,0,0,0,0,0,0,2,2,2,30340,12398,2285,18272,1
33,678,8,5,5,2,0,1,10,0,0,0,0,0,0,0,0,0,0,0,0,2,2,2,30340,12398,2285,18273,1
33,678,1217,716,841,84,126,174,1301,14,185,118,215,199,333,1446,2542,8,20687,1149,0,2,2,2,30350,12400,2285,18274,1
33,678,160,89,115,0,13,31,160,7,15,11,17,22,28,78,124,3,495,27,0,2,2,2,30350,12400,2285,18275,1
33,678,10,10,9,9,0,0,19,0,0,0,0,0,0,0,0,0,0,0,0,2,2,2,30350,12400,2286,18276,1
33,678,173,84,99,8,29,36,181,5,12,7,13,17,20,54,81,2,221,12,0,2,2,2,30350,12401,2286,18277,1
33,678,3,1,1,3,0,0,6,0,0,0,0,0,0,0,0,0,0,0,0,2,2,2,30350,12401,2286,18278,1
90,1940,477,336,357,30,23,73,507,16,194,134,250,210,384,1538,2962,10,30538,1696,0,2,3,4,30360,12402,2286,18279,1
513,10978,72,33,56,0,4,12,72,1,1,1,1,2,2,0,2,0,1,0,0,2,6,4,30360,12402,2286,18280,1
513,10978,1454,835,1044,76,110,219,1530,17,275,158,296,292,454,2297,3718,9,34017,1889,1,2,6,4,30370,12403,2286,18281,1
53,1075,1098,241,925,5,10,155,1103,7,46,25,49,53,74,273,423,3,1580,87,0,2,4,3,30380,12405,2286,18282,1
53,1075,282,202,222,14,2,44,296,8,42,24,43,50,67,250,378,4,1548,86,0,2,4,3,30380,12406,2286,18283,1
33,678,2,2,2,0,0,0,2,0,0,0,0,0,0,0,0,0,0,0,0,2,2,2,30380,12406,2286,18283,0
33,678,99,48,90,1,3,5,100,0,0,0,0,0,0,0,0,0,0,0,0,2,2,2,30380,12407,2286,18284,0
33,678,8,5,5,2,0,1,10,0,0,0,0,0,0,0,0,0,0,0,0,2,2,2,30380,12407,2286,18285,0
33,678,1217,716,841,84,126,174,1301,14,185,118,215,199,333,1446,2542,8,20687,1149,0,2,2,2,30390,12409,2286,18286,0
33,678,160,89,115,0,13,31,160,7,15,11,17,22,28,78,124,3,495,27,0,2,2,2,30390,12409,2286,18287,0
33,678,10,10,9,9,0,0,19,0,0,0,0,0,0,0,0,0,0,0,0,2,2,2,30390,12409,2287,18288,0
33,678,173,84,99,8,29,36,181,5,12,7,13,17,20,54,81,2,221,12,0,2,2,2,30390,12410,2287,18289,0
33,678,3,1,1,3,0,0,6,0,0,0,0,0,0,0,0,0,0,0,0,2,2,2,30390,12410,2287,18290,0
90,1940,477,336,357,30,23,73,507,16,194,134,250,210,384,1538,2962,10,30538,1696,0,2,3,4,30400,12411,2287,18291,0
513,10978,72,33,56,0,4,12,72,1,1,1,1,2,2,0,2,0,1,0,0,2,6,4,30400,12411,2287,18292,0
513,10978,1454,835,1044,76,110,219,1530,17,275,158,296,292,454,2297,3718,9,34017,1889,1,2,6,4,30410,12412,2287,18293,0
53,1075,1098,241,925,5,10,155,1103,7,46,25,49,53,74,273,423,3,1580,87,0,2,4,3,30420,12414,2287,18294,0
53,1075,282,202,222,14,2,44,296,8,42,24,43,50,67,250,378,4,1548,86,0,2,4,3,30420,12415,2287,18295,0
69,1969,1523,757,1297,19,12,193,1542,12,193,117,230,205,347,1508,2664,7,19053,1058,0,2,1,0,30430,12417,2287,18296,1
69,1969,701,378,504,33,58,109,734,13,110,68,126,123,194,794,1346,7,10027,557,0,2,1,0,30430,12418,2288,18297,1
70,3287,1523,757,1297,19,12,193,1542,12,193,117,230,205,347,1508,2664,7,19053,1058,0,2,29,0,30440,12420,2288,18298,1
69,1969,1523,757,1297,19,12,193,1542,12,193,117,230,205,347,1508,2664,7,19053,1058,0,2,1,0,30450,12422,2288,18299,0
69,1969,701,378,504,33,58,109,734,13,110,68,126,123,194,794,1346,7,10027,557,0,2,1,0,30450,12423,2289,18300,0
70,3287,1523,757,1297,19,12,193,1542,12,193,117,230,205,347,1508,2664,7,19053,1058,0,2,29,0,30460,12425,2289,18301,0
36,711,2,2,2,0,0,0,2,0,0,0,0,0,0,0,0,0,0,0,0,2,3,3,30490,12437,2292,18322,1
36,711,99,48,90,1,3,5,100,0,0,0,0,0,0,0,0,0,0,0,0,2,3,3,30490,12438,2292,18323,1
36,711,8,5,5,2,0,1,10,0,0,0,0,0,0,0,0,0,0,0,0,2,3,3,30490,12438,2292,18324,1
36,711,1217,716,841,84,126,174,1301,14,185,118,215,199,333,1446,2542,8,20687,1149,0,2,3,3,30500,12440,2292,18325,1
36,711,160,89,115,0,13,31,160,7,15,11,17,22,28,78,124,3,495,27,0,2,3,3,30500,12440,2292,18326,1
36,711,10,10,9,9,0,0,19,0,0,0,0,0,0,0,0,0,0,0,0,2,3,3,30500,12440,2293,18327,1
36,711,173,84,99,8,29,36,181,5,12,7,13,17,20,54,81,2,221,12,0,2,3,3,30500,12441,2293,18328,1
36,711,3,1,1,3,0,0,6,0,0,0,0,0,0,0,0,0,0,0,0,2,3,3,30500,12441,2293,18329,1
90,1940,477,336,357,30,23,73,507,16,194,134,250,210,384,1538,2962,10,30538,1696,0,2,3,4,30510,12442,2293,18330,1
53,1441,1455,414,1257,16,76,112,1471,5,41,23,46,46,69,231,381,2,1069,59,0,2,7,7,30510,12443,2293,18331,1
53,1441,669,365,481,22,61,110,691,15,103,63,122,118,185,747,1273,8,11311,628,0,2,7,7,30520,12443,2294,18332,1
69,1969,1523,757,1297,19,12,193,1542,12,193,117,230,205,347,1508,2664,7,19053,1058,0,2,1,0,30530,12445,2294,18333,1
69,1969,701,378,504,33,58,109,734,13,110,68,126,123,194,794,1346,7,10027,557,0,2,1,0,30530,12446,2295,18334,1
21,594,1293,570,1093,25,15,163,1318,10,195,123,241,205,364,1516,2795,6,17273,959,0,2,3,1,30540,12448,2295,18335,1
513,10978,72,33,56,0,4,12,72,1,1,1,1,2,2,0,2,0,1,0,0,2,6,4,30540,12448,2295,18336,1
513,10978,1454,835,1044,76,110,219,1530,17,275,158,296,292,454,2297,3718,9,34017,1889,1,2,6,4,30550,12449,2295,18337,1
53,1075,1098,241,925,5,10,155,1103,7,46,25,49,53,74,273,423,3,1580,87,0,2,4,3,30560,12451,2295,18338,1
53,1075,282,202,222,14,2,44,296,8,42,24,43,50,67,250,378,4,1548,86,0,2,4,3,30560,12452,2295,18339,1
51,2240,1455,414,1257,16,76,112,1471,5,41,23,46,46,69,231,381,2,1069,59,0,2,58,0,30560,12453,2295,18340,1
70,3287,1523,757,1297,19,12,193,1542,12,193,117,230,205,347,1508,2664,7,19053,1058,0,2,29,0,30570,12455,2295,18341,1
34,1287,1293,570,1093,25,15,163,1318,10,195,123,241,205,364,1516,2795,6,17273,959,0,2,16,0,30580,12457,2295,18342,1
36,711,2,2,2,0,0,0,2,0,0,0,0,0,0,0,0,0,0,0,0,2,3,3,30580,12457,2295,18342,0
36,711,99,48,90,1,3,5,100,0,0,0,0,0,0,0,0,0,0,0,0,2,3,3,30580,12458,2295,18343,0
36,711,8,5,5,2,0,1,10,0,0,0,0,0,0,0,0,0,0,0,0,2,3,3,30580,12458,2295,18344,0
36,711,1217,716,841,84,126,174,1301,14,185,118,215,199,333,1446,2542,8,20687,1149,0,2,3,3,30590,12460,2295,18345,0
36,711,160,89,115,0,13,31,160,7,15,11,17,22,28,78,124,3,495,27,0,2,3,3,30590,12460,2295,18346,0
36,711,10,10,9,9,0,0,19,0,0,0,0,0,0,0,0,0,0,0,0,2,3,3,30590,12460,2296,18347,0
36,711,173,84,99,8,29,36,181,5,12,7,13,17,20,54,81,2,221,12,0,2,3,3,30590,12461,2296,18348,0
36,711,3,1,1,3,0,0,6,0,0,0,0,0,0,0,0,0,0,0,0,2,3,3,30590,12461,2296,18349,0
90,1940,477,336,357,30,23,73,507,16,194,134,250,210,384,1538,2962,10,30538,1696,0,2,3,4,30600,12462,2296,18350,0
53,1441,1455,414,1257,16,76,112,1471,5,41,23,46,46,69,231,381,2,1069,59,0,2,7,7,30600,12463,2296,18351,0
53,1441,669,365,481,22,61,110,691,15,103,63,122,118,185,747,1273,8,11311,628,0,2,7,7,30610,12463,2297,18352,0
69,1969,1523,757,1297,19,12,193,1542,12,193,117,230,205,347,1508,2664,7,19053,1058,0,2,1,0,30620,12465,2297,18353,0
69,1969,701,378,504,33,58,109,734,13,110,68,126,123,194,794,1346,7,10027,557,0,2,1,0,30620,12466,2298,18354,0
21,594,1293,570,1093,25,15,163,1318,10,195,123,241,205,364,1516,2795,6,17273,959,0,2,3,1,30630,12468,2298,18355,0
513,10978,72,33,56,0,4,12,72,1,1,1,1,2,2,0,2,0,1,0,0,2,6,4,30630,12468,2298,18356,0
513,10978,1454,835,1044,76,110,219,1530,17,275,158,296,292,454,2297,3718,9,34017,1889,1,2,6,4,30640,12469,2298,18357,0
53,1075,1098,241,925,5,10,155,1103,7,46,25,49,53,74,273,423,3,1580,87,0,2,4,3,30650,12471,2298,18358,0
53,1075,282,202,222,14,2,44,296,8,42,24,43,50,67,250,378,4,1548,86,0,2,4,3,30650,12472,2298,18359,0
51,2240,1455,414,1257,16,76,112,1471,5,41,23,46,46,69,231,381,2,1069,59,0,2,58,0,30650,12473,2298,18360,0
70,3287,1523,757,1297,19,12,193,1542,12,193,117,230,205,347,1508,2664,7,19053,1058,0,2,29,0,30660,12475,2298,18361,0
34,1287,1293,570,1093,25,15,163,1318,10,195,123,241,205,364,1516,2795,6,17273,959,0,2,16,0,30670,12477,2298,18362,0
48,973,447,308,343,6,5,95,453,7,96,59,111,103,170,651,1136,4,4600,255,0,2,7,7,30670,12480,2298,18363,0
48,973,322,174,179,16,74,51,338,10,41,26,46,51,72,252,408,5,2291,127,0,2,7,7,30670,12483,2299,18364,0
36,1591,447,308,343,6,5,95,453,7,96,59,111,103,170,651,1136,4,4600,255,0,2,27,5,30670,12486,2299,18365,0
45,912,447,308,343,6,5,95,453,7,96,59,111,103,170,651,1136,4,4600,255,0,2,37,40,30670,12489,2299,18366,1
45,912,322,174,179,16,74,51,338,10,41,26,46,51,72,252,408,5,2291,127,0,2,37,40,30670,12492,2300,18367,1
38,1622,447,308,343,6,5,95,453,7,96,59,111,103,170,651,1136,4,4600,255,0,2,8,0,30670,12495,2300,18368,1
46,940,447,308,343,6,5,95,453,7,96,59,111,103,170,651,1136,4,4600,255,0,2,15,9,30670,12498,2300,18369,1
46,940,322,174,179,16,74,51,338,10,41,26,46,51,72,252,408,5,2291,127,0,2,15,9,30670,12501,2301,18370,1
38,1614,447,308,343,6,5,95,453,7,96,59,111,103,170,651,1136,4,4600,255,0,2,3,3,30670,12504,2301,18371,1
46,938,447,308,343,6,5,95,453,7,96,59,111,103,170,651,1136,4,4600,255,0,2,0,1,30670,12507,2301,18372,0
46,938,322,174,179,16,74,51,338,10,41,26,46,51,72,252,408,5,2291,127,0,2,0,1,30670,12510,2302,18373,0
46,939,447,308,343,6,5,95,453,7,96,59,111,103,170,651,1136,4,4600,255,0,2,2,1,30670,12513,2302,18374,0
46,939,322,174,179,16,74,51,338,10,41,26,46,51,72,252,408,5,2291,127,0,2,2,1,30670,12516,2303,18375,0
46,943,447,308,343,6,5,95,453,7,96,59,111,103,170,651,1136,4,4600,255,0,2,17,12,30670,12519,2303,18376,0
46,943,322,174,179,16,74,51,338,10,41,26,46,51,72,252,408,5,2291,127,0,2,17,12,30670,12522,2304,18377,0
46,943,447,308,343,6,5,95,453,7,96,59,111,103,170,651,1136,4,4600,255,0,2,54,46,30670,12525,2304,18378,0
46,943,322,174,179,16,74,51,338,10,41,26,46,51,72,252,408,5,2291,127,0,2,54,46,30670,12528,2305,18379,0
38,1614,447,308,343,6,5,95,453,7,96,59,111,103,170,651,1136,4,4600,255,0,2,37,7,30670,12531,2305,18380,0
19,527,1450,624,1228,12,26,181,1462,14,306,186,354,320,540,2580,4493,8,36391,2021,1,0,96,0,30710,12549,2310,18409,1
199,4191,182,127,129,0,0,53,182,5,39,21,42,44,63,217,343,2,926,51,0,0,795,0,30710,12549,2311,18410,1
199,4191,1165,710,800,67,119,181,1232,18,243,153,282,261,435,2000,3492,10,36473,2026,1,0,795,0,30720,12549,2312,18411,1
100,2140,773,419,590,28,0,166,801,10,204,113,217,214,330,1598,2554,5,13587,754,0,0,421,0,30720,12549,2313,18412,1
100,2140,421,273,302,44,34,57,465,17,81,59,107,98,166,583,1098,11,12329,684,0,0,421,0,30720,12549,2314,18413,1
90,1944,477,336,357,30,23,73,507,16,194,134,250,210,384,1538,2962,10,30538,1696,0,2,2,1,30730,12550,2314,18414,1
298,6082,1457,730,1242,11,6,188,1468,10,292,166,329,302,495,2424,4078,5,22973,1276,1,2,3,2,30730,12552,2314,18415,1
298,6082,74,35,59,1,0,14,75,3,14,7,14,17,21,58,85,1,128,7,0,2,3,2,30730,12553,2314,18416,1
298,6082,245,125,200,5,7,34,250,7,30,17,34,37,51,166,265,3,1053,58,0,2,3,2,30740,12554,2314,18417,1
53,1439,1455,414,1257,16,76,112,1471,5,41,23,46,46,69,231,381,2,1069,59,0,2,7,3,30740,12555,2314,18418,1
53,1439,669,365,481,22,61,110,691,15,103,63,122,118,185,747,1273,8,11311,628,0,2,7,3,30750,12555,2315,18419,1
172,3987,77,34,69,0,0,8,77,3,24,16,29,27,45,114,213,1,387,21,0,2,8,4,30750,12555,2315,18420,1
172,3987,712,438,573,51,9,84,763,14,102,71,128,116,199,733,1364,8,11988,666,0,2,8,4,30760,12556,2315,18421,1
219,4866,722,423,573,19,0,135,741,12,172,101,199,184,300,1320,2257,6,15668,870,0,2,12,11,30760,12558,2315,18423,1
219,4866,1508,847,911,44,250,301,1552,14,148,88,169,162,257,1120,1886,7,15077,837,0,2,12,11,30760,12559,2316,18424,1
513,10978,72,33,56,0,4,12,72,1,1,1,1,2,2,0,2,0,1,0,0,2,36,34,30760,12559,2316,18425,1
513,10978,1454,835,1044,76,110,219,1530,17,275,158,296,292,454,2297,3718,9,34017,1889,1,2,36,34,30770,12560,2316,18426,1
41,951,386,256,301,16,9,68,402,4,59,35,69,63,104,355,621,2,1453,80,0,2,3,1,30770,12560,2316,18427,1
41,951,264,131,164,11,41,46,275,6,38,22,40,44,62,214,338,3,1068,59,0,2,3,1,30780,12560,2317,18428,1
116,2524,1043,504,840,53,9,147,1096,9,180,112,198,189,310,1377,2344,4,11604,644,0,2,4,3,30780,12562,2317,18429,1
116,2524,383,288,292,26,6,62,409,11,65,38,67,76,105,429,656,5,3719,206,0,2,4,3,30780,12563,2317,18430,1
95,1756,1178,367,1042,6,15,115,1184,9,94,51,95,103,146,644,976,4,4439,246,0,2,2,3,30780,12563,2317,18431,1
95,1756,177,108,140,8,0,27,185,6,30,16,32,36,48,162,248,3,794,44,0,2,2,3,30780,12565,2317,18432,1
53,1077,1098,241,925,5,10,155,1103,7,46,25,49,53,74,273,423,3,1580,87,0,2,5,6,30790,12567,2317,18433,1
53,1077,282,202,222,14,2,44,296,8,42,24,43,50,67,250,378,4,1548,86,0,2,5,6,30790,12568,2317,18434,1
60,1074,282,196,195,3,0,86,285,8,130,71,141,138,212,936,1507,4,6538,363,0,2,2,1,30790,12568,2318,18435,1
7,296,72,33,56,0,4,12,72,1,1,1,1,2,2,0,2,0,1,0,0,2,3,2,30790,12568,2318,18436,1
20,619,42,7,35,4,0,5,46,1,2,1,2,3,3,2,4,0,2,0,0,2,1,1,30790,12568,2318,18437,1
20,619,11,6,10,0,0,1,11,2,4,2,4,6,6,10,15,1,15,0,0,2,1,1,30790,12568,2318,18438,1
69,2871,1289,550,1043,56,32,155,1345,10,167,93,185,177,278,1266,2075,5,11498,638,0,2,5,2,30790,12570,2319,18439,1
33,992,182,127,129,0,0,53,182,5,39,21,42,44,63,217,343,2,926,51,0,0,163,0,30790,12570,2320,18440,1
118,5254,1392,870,1177,35,17,170,1427,14,494,280,531,508,811,4473,7289,7,54850,3047,2,0,911,0,30790,12573,2321,18441,1
92,2943,773,419,590,28,0,166,801,10,204,113,217,214,330,1598,2554,5,13587,754,0,0,657,0,30790,12573,2322,18442,1
77,3663,1338,495,1086,10,64,173,1348,11,122,82,157,133,239,883,1686,7,11934,663,0,2,12,9,30790,12575,2322,18443,1
140,6182,139,89,101,2,0,35,141,7,54,34,62,61,96,330,569,4,2287,127,0,2,18,14,30790,12575,2322,18444,1
140,6182,7,5,5,0,0,2,7,1,2,1,2,3,3,2,4,0,2,0,0,2,18,14,30790,12575,2322,18445,1
32,933,465,148,393,5,8,60,470,4,31,20,31,35,51,161,261,2,523,29,0,2,2,1,30790,12576,2322,18446,1
32,933,16,12,9,0,0,6,16,1,2,1,2,3,3,2,4,0,2,0,0,2,2,1,30790,12576,2322,18447,1
81,4399,1782,648,1425,9,47,279,1791,8,171,97,189,179,286,1292,2140,4,9462,525,0,2,5,3,30790,12577,2323,18448,1
11,230,256,139,192,9,7,47,265,4,23,12,24,27,36,112,171,2,357,19,0,2,2,1,30790,12578,2323,18449,1
74,2703,1450,624,1228,12,26,181,1462,14,306,186,354,320,540,2580,4493,8,36391,2021,1,2,4,2,30790,12580,2324,18450,1
135,3522,1660,832,1314,41,38,274,1701,20,312,209,395,332,604,2671,5058,12,64042,3557,1,2,4,3,30790,12582,2325,18452,1
112,4316,1513,682,1277,25,13,200,1538,11,199,116,219,210,335,1557,2584,6,15641,868,0,2,3,1,30790,12584,2325,18453,1
55,2831,1457,730,1242,11,6,188,1468,10,292,166,329,302,495,2424,4078,5,22973,1276,1,2,5,4,30790,12586,2325,18454,1
35,2156,652,304,544,16,6,88,668,6,89,51,101,95,152,591,998,3,3399,188,0,2,10,7,30790,12587,2325,18455,1
51,2242,1455,414,1257,16,76,112,1471,5,41,23,46,46,69,231,381,2,1069,59,0,2,4,4,30790,12588,2325,18456,1
34,1289,1293,570,1093,25,15,163,1318,10,195,123,241,205,364,1516,2795,6,17273,959,0,2,4,3,30800,12590,2325,18457,1
16,1265,215,129,180,6,0,29,221,8,65,43,72,73,115,415,711,4,3153,175,0,2,7,3,30800,12590,2325,18458,1
57,2321,1043,504,840,53,9,147,1096,9,180,112,198,189,310,1377,2344,4,11604,644,0,2,10,6,30800,12592,2325,18459,1
69,3533,1943,715,1694,26,18,214,1969,12,185,120,237,197,357,1436,2721,7,20915,1161,0,2,8,6,30800,12594,2325,18460,1
38,1508,1098,241,925,5,10,155,1103,7,46,25,49,53,74,273,423,3,1580,87,0,2,2,1,30810,12596,2325,18461,1
199,4197,182,127,129,0,0,53,182,5,39,21,42,44,63,217,343,2,926,51,0,2,6,6,30820,12602,2328,18470,1
199,4197,1165,710,800,67,119,181,1232,18,243,153,282,261,435,2000,3492,10,36473,2026,1,2,6,6,30830,12602,2329,18471,1
92,2961,773,419,590,28,0,166,801,10,204,113,217,214,330,1598,2554,5,13587,754,0,2,2,0,30830,12602,2330,18472,0
53,1437,1455,414,1257,16,76,112,1471,5,41,23,46,46,69,231,381,2,1069,59,0,2,0,1,30830,12603,2330,18473,0
53,1437,669,365,481,22,61,110,691,15,103,63,122,118,185,747,1273,8,11311,628,0,2,0,1,30840,12603,2331,18474,0
199,4197,182,127,129,0,0,53,182,5,39,21,42,44,63,217,343,2,926,51,0,0,795,0,30850,12607,2333,18482,0
199,4197,1165,710,800,67,119,181,1232,18,243,153,282,261,435,2000,3492,10,36473,2026,1,0,795,0,30860,12607,2334,18483,0
100,2140,773,419,590,28,0,166,801,10,204,113,217,214,330,1598,2554,5,13587,754,0,0,421,0,30860,12607,2335,18484,0
100,2140,421,273,302,44,34,57,465,17,81,59,107,98,166,583,1098,11,12329,684,0,0,421,0,30860,12607,2336,18485,0
90,1944,477,336,357,30,23,73,507,16,194,134,250,210,384,1538,2962,10,30538,1696,0,2,2,1,30870,12608,2336,18486,0
298,6082,1457,730,1242,11,6,188,1468,10,292,166,329,302,495,2424,4078,5,22973,1276,1,2,3,2,30870,12610,2336,18487,0
298,6082,74,35,59,1,0,14,75,3,14,7,14,17,21,58,85,1,128,7,0,2,3,2,30870,12611,2336,18488,0
298,6082,245,125,200,5,7,34,250,7,30,17,34,37,51,166,265,3,1053,58,0,2,3,2,30880,12612,2336,18489,0
53,1437,1455,414,1257,16,76,112,1471,5,41,23,46,46,69,231,381,2,1069,59,0,2,6,3,30880,12613,2336,18490,0
53,1437,669,365,481,22,61,110,691,15,103,63,122,118,185,747,1273,8,11311,628,0,2,6,3,30890,12613,2337,18491,0
172,3987,77,34,69,0,0,8,77,3,24,16,29,27,45,114,213,1,387,21,0,2,8,4,30890,12613,2337,18492,0
172,3987,712,438,573,51,9,84,763,14,102,71,128,116,199,733,1364,8,11988,666,0,2,8,4,30900,12614,2337,18493,0
219,4866,722,423,573,19,0,135,741,12,172,101,199,184,300,1320,2257,6,15668,870,0,2,12,11,30900,12616,2337,18495,0
219,4866,1508,847,911,44,250,301,1552,14,148,88,169,162,257,1120,1886,7,15077,837,0,2,12,11,30900,12617,2338,18496,0
513,10978,72,33,56,0,4,12,72,1,1,1,1,2,2,0,2,0,1,0,0,2,36,34,30900,12617,2338,18497,0
513,10978,1454,835,1044,76,110,219,1530,17,275,158,296,292,454,2297,3718,9,34017,1889,1,2,36,34,30910,12618,2338,18498,0
41,951,386,256,301,16,9,68,402,4,59,35,69,63,104,355,621,2,1453,80,0,2,3,1,30910,12618,2338,18499,0
41,951,264,131,164,11,41,46,275,6,38,22,40,44,62,214,338,3,1068,59,0,2,3,1,30920,12618,2339,18500,0
116,2524,1043,504,840,53,9,147,1096,9,180,112,198,189,310,1377,2344,4,11604,644,0,2,4,3,30920,12620,2339,18501,0
116,2524,383,288,292,26,6,62,409,11,65,38,67,76,105,429,656,5,3719,206,0,2,4,3,30920,12621,2339,18502,0
95,1756,1178,367,1042,6,15,115,1184,9,94,51,95,103,146,644,976,4,4439,246,0,2,2,3,30920,12621,2339,18503,0
95,1756,177,108,140,8,0,27,185,6,30,16,32,36,48,162,248,3,794,44,0,2,2,3,30920,12623,2339,18504,0
53,1077,1098,241,925,5,10,155,1103,7,46,25,49,53,74,273,423,3,1580,87,0,2,5,6,30930,12625,2339,18505,0
53,1077,282,202,222,14,2,44,296,8,42,24,43,50,67,250,378,4,1548,86,0,2,5,6,30930,12626,2339,18506,0
60,1074,282,196,195,3,0,86,285,8,130,71,141,138,212,936,1507,4,6538,363,0,2,2,1,30930,12626,2340,18507,0
7,296,72,33,56,0,4,12,72,1,1,1,1,2,2,0,2,0,1,0,0,2,3,2,30930,12626,2340,18508,0
20,619,42,7,35,4,0,5,46,1,2,1,2,3,3,2,4,0,2,0,0,2,1,1,30930,12626,2340,18509,0
20,619,11,6,10,0,0,1,11,2,4,2,4,6,6,10,15,1,15,0,0,2,1,1,30930,12626,2340,18510,0
69,2871,1289,550,1043,56,32,155,1345,10,167,93,185,177,278,1266,2075,5,11498,638,0,2,5,2,30930,12628,2341,18511,0
33,992,182,127,129,0,0,53,182,5,39,21,42,44,63,217,343,2,926,51,0,0,163,0,30930,12628,2342,18512,0
118,5254,1392,870,1177,35,17,170,1427,14,494,280,531,508,811,4473,7289,7,54850,3047,2,0,911,0,30930,12631,2343,18513,0
92,2961,773,419,590,28,0,166,801,10,204,113,217,214,330,1598,2554,5,13587,754,0,0,659,0,30930,12631,2344,18514,0
77,3663,1338,495,1086,10,64,173,1348,11,122,82,157,133,239,883,1686,7,11934,663,0,2,12,9,30930,12633,2344,18515,0
140,6182,139,89,101,2,0,35,141,7,54,34,62,61,96,330,569,4,2287,127,0,2,18,14,30930,12633,2344,18516,0
140,6182,7,5,5,0,0,2,7,1,2,1,2,3,3,2,4,0,2,0,0,2,18,14,30930,12633,2344,18517,0
32,933,465,148,393,5,8,60,470,4,31,20,31,35,51,161,261,2,523,29,0,2,2,1,30930,12634,2344,18518,0
32,933,16,12,9,0,0,6,16,1,2,1,2,3,3,2,4,0,2,0,0,2,2,1,30930,12634,2344,18519,0
81,4399,1782,648,1425,9,47,279,1791,8,171,97,189,179,286,1292,2140,4,9462,525,0,2,5,3,30930,12635,2345,18520,0
11,230,256,139,192,9,7,47,265,4,23,12,24,27,36,112,171,2,357,19,0,2,2,1,30930,12636,2345,18521,0
74,2703,1450,624,1228,12,26,181,1462,14,306,186,354,320,540,2580,4493,8,36391,2021,1,2,4,2,30930,12638,2346,18522,0
135,3522,1660,832,1314,41,38,274,1701,20,312,209,395,332,604,2671,5058,12,64042,3557,1,2,4,3,30930,12640,2347,18524,0
112,4316,1513,682,1277,25,13,200,1538,11,199,116,219,210,335,1557,2584,6,15641,868,0,2,3,1,30930,12642,2347,18525,0
55,2831,1457,730,1242,11,6,188,1468,10,292,166,329,302,495,2424,4078,5,22973,1276,1,2,5,4,30930,12644,2347,18526,0
35,2156,652,304,544,16,6,88,668,6,89,51,101,95,152,591,998,3,3399,188,0,2,10,7,30930,12645,2347,18527,0
51,2242,1455,414,1257,16,76,112,1471,5,41,23,46,46,69,231,381,2,1069,59,0,2,4,4,30930,12646,2347,18528,0
34,1289,1293,570,1093,25,15,163,1318,10,195,123,241,205,364,1516,2795,6,17273,959,0,2,4,3,30940,12648,2347,18529,0
16,1265,215,129,180,6,0,29,221,8,65,43,72,73,115,415,711,4,3153,175,0,2,7,3,30940,12648,2347,18530,0
57,2321,1043,504,840,53,9,147,1096,9,180,112,198,189,310,1377,2344,4,11604,644,0,2,10,6,30940,12650,2347,18531,0
69,3533,1943,715,1694,26,18,214,1969,12,185,120,237,197,357,1436,2721,7,20915,1161,0,2,8,6,30940,12652,2347,18532,0
38,1508,1098,241,925,5,10,155,1103,7,46,25,49,53,74,273,423,3,1580,87,0,2,2,1,30950,12654,2347,18533,0
57,1223,996,429,845,24,10,117,1020,7,76,50,88,83,138,494,879,4,3565,198,0,2,2,2,30950,12656,2347,18534,0
57,1223,456,277,329,12,42,72,468,13,85,50,97,98,147,592,972,7,7212,400,0,2,2,2,30950,12656,2347,18535,0
57,1223,996,429,845,24,10,117,1020,7,76,50,88,83,138,494,879,4,3565,198,0,2,2,2,30950,12658,2347,18536,0
57,1223,456,277,329,12,42,72,468,13,85,50,97,98,147,592,972,7,7212,400,0,2,2,2,30950,12658,2347,18537,0
513,10983,72,33,56,0,4,12,72,1,1,1,1,2,2,0,2,0,1,0,0,2,1,2,30950,12658,2347,18538,0
513,10983,1454,835,1044,76,110,219,1530,17,275,158,296,292,454,2297,3718,9,34017,1889,1,2,1,2,30960,12659,2347,18539,0
13,271,256,139,192,9,7,47,265,4,23,12,24,27,36,112,171,2,357,19,0,2,6,0,30960,12660,2347,18540,0
513,10983,72,33,56,0,4,12,72,1,1,1,1,2,2,0,2,0,1,0,0,2,1,2,30960,12660,2347,18541,0
513,10983,1454,835,1044,76,110,219,1530,17,275,158,296,292,454,2297,3718,9,34017,1889,1,2,1,2,30970,12661,2347,18542,0
13,271,256,139,192,9,7,47,265,4,23,12,24,27,36,112,171,2,357,19,0,2,6,0,30970,12662,2347,18543,0
46,943,447,308,343,6,5,95,453,7,96,59,111,103,170,651,1136,4,4600,255,0,2,54,46,30970,12665,2347,18544,0
46,943,322,174,179,16,74,51,338,10,41,26,46,51,72,252,408,5,2291,127,0,2,54,46,30970,12668,2348,18545,0
38,1614,447,308,343,6,5,95,453,7,96,59,111,103,170,651,1136,4,4600,255,0,2,37,7,30970,12671,2348,18546,0
147,4734,1660,832,1314,41,38,274,1701,20,312,209,395,332,604,2671,5058,12,64042,3557,1,2,5,0,30970,12673,2349,18548,1
147,4734,1057,646,719,113,100,145,1170,18,215,134,248,233,382,1740,3004,10,31186,1732,1,2,5,0,30980,12674,2350,18549,1
136,3553,1660,832,1314,41,38,274,1701,20,312,209,395,332,604,2671,5058,12,64042,3557,1,2,13,0,30980,12676,2351,18551,1
9,220,19,8,11,5,0,4,24,2,5,3,6,7,9,13,25,1,30,1,0,2,0,3,30990,12680,2352,18559,0
9,220,102,59,69,5,3,24,107,6,22,15,28,28,43,113,206,3,789,43,0,2,0,3,30990,12680,2352,18560,0
9,220,106,40,36,3,49,17,109,8,17,13,23,25,36,93,167,5,904,50,0,2,0,3,30990,12680,2352,18561,0
199,4197,182,127,129,0,0,53,182,5,39,21,42,44,63,217,343,2,926,51,0,0,795,0,31000,12684,2354,18569,0
199,4197,1165,710,800,67,119,181,1232,18,243,153,282,261,435,2000,3492,10,36473,2026,1,0,795,0,31010,12684,2355,18570,0
100,2140,773,419,590,28,0,166,801,10,204,113,217,214,330,1598,2554,5,13587,754,0,0,421,0,31010,12684,2356,18571,0
100,2140,421,273,302,44,34,57,465,17,81,59,107,98,166,583,1098,11,12329,684,0,0,421,0,31010,12684,2357,18572,0
36,711,2,2,2,0,0,0,2,0,0,0,0,0,0,0,0,0,0,0,0,2,11,2,31010,12684,2357,18572,0
36,711,99,48,90,1,3,5,100,0,0,0,0,0,0,0,0,0,0,0,0,2,11,2,31010,12685,2357,18573,0
36,711,8,5,5,2,0,1,10,0,0,0,0,0,0,0,0,0,0,0,0,2,11,2,31010,12685,2357,18574,0
36,711,1217,716,841,84,126,174,1301,14,185,118,215,199,333,1446,2542,8,20687,1149,0,2,11,2,31020,12687,2357,18575,0
36,711,160,89,115,0,13,31,160,7,15,11,17,22,28,78,124,3,495,27,0,2,11,2,31020,12687,2357,18576,0
36,711,10,10,9,9,0,0,19,0,0,0,0,0,0,0,0,0,0,0,0,2,11,2,31020,12687,2358,18577,0
36,711,173,84,99,8,29,36,181,5,12,7,13,17,20,54,81,2,221,12,0,2,11,2,31020,12688,2358,18578,0
36,711,3,1,1,3,0,0,6,0,0,0,0,0,0,0,0,0,0,0,0,2,11,2,31020,12688,2358,18579,0
90,1944,477,336,357,30,23,73,507,16,194,134,250,210,384,1538,2962,10,30538,1696,0,2,2,1,31030,12689,2358,18580,0
57,1223,996,429,845,24,10,117,1020,7,76,50,88,83,138,494,879,4,3565,198,0,2,2,2,31030,12691,2358,18581,0
57,1223,456,277,329,12,42,72,468,13,85,50,97,98,147,592,972,7,7212,400,0,2,2,2,31030,12691,2358,18582,0
298,6082,1457,730,1242,11,6,188,1468,10,292,166,329,302,495,2424,4078,5,22973,1276,1,2,21,18,31030,12693,2358,18583,0
298,6082,74,35,59,1,0,14,75,3,14,7,14,17,21,58,85,1,128,7,0,2,21,18,31030,12694,2358,18584,0
298,6082,245,125,200,5,7,34,250,7,30,17,34,37,51,166,265,3,1053,58,0,2,21,18,31040,12695,2358,18585,0
53,1437,1455,414,1257,16,76,112,1471,5,41,23,46,46,69,231,381,2,1069,59,0,2,57,27,31040,12696,2358,18586,0
53,1437,669,365,481,22,61,110,691,15,103,63,122,118,185,747,1273,8,11311,628,0,2,57,27,31050,12696,2359,18587,0
46,532,647,139,84,35,284,233,682,0,0,0,0,0,0,0,0,0,0,0,0,2,4,1,31050,12696,2359,18588,0
172,3987,77,34,69,0,0,8,77,3,24,16,29,27,45,114,213,1,387,21,0,2,8,4,31050,12696,2359,18589,0
172,3987,712,438,573,51,9,84,763,14,102,71,128,116,199,733,1364,8,11988,666,0,2,8,4,31060,12697,2359,18590,0
21,594,1293,570,1093,25,15,163,1318,10,195,123,241,205,364,1516,2795,6,17273,959,0,2,1,2,31070,12699,2359,18591,0
219,4866,722,423,573,19,0,135,741,12,172,101,199,184,300,1320,2257,6,15668,870,0,2,12,11,31070,12701,2359,18593,0
219,4866,1508,847,911,44,250,301,1552,14,148,88,169,162,257,1120,1886,7,15077,837,0,2,12,11,31070,12702,2360,18594,0
513,10983,72,33,56,0,4,12,72,1,1,1,1,2,2,0,2,0,1,0,0,2,37,36,31070,12702,2360,18595,0
513,10983,1454,835,1044,76,110,219,1530,17,275,158,296,292,454,2297,3718,9,34017,1889,1,2,37,36,31080,12703,2360,18596,0
41,951,386,256,301,16,9,68,402,4,59,35,69,63,104,355,621,2,1453,80,0,2,13,3,31080,12703,2360,18597,0
41,951,264,131,164,11,41,46,275,6,38,22,40,44,62,214,338,3,1068,59,0,2,13,3,31090,12703,2361,18598,0
116,2524,1043,504,840,53,9,147,1096,9,180,112,198,189,310,1377,2344,4,11604,644,0,2,9,4,31090,12705,2361,18599,0
116,2524,383,288,292,26,6,62,409,11,65,38,67,76,105,429,656,5,3719,206,0,2,9,4,31090,12706,2361,18600,0
95,1756,1178,367,1042,6,15,115,1184,9,94,51,95,103,146,644,976,4,4439,246,0,2,31,7,31090,12706,2361,18601,0
95,1756,177,108,140,8,0,27,185,6,30,16,32,36,48,162,248,3,794,44,0,2,31,7,31090,12708,2361,18602,0
181,3706,1943,715,1694,26,18,214,1969,12,185,120,237,197,357,1436,2721,7,20915,1161,0,2,15,1,31090,12710,2361,18603,0
181,3706,1168,838,957,57,25,144,1225,19,348,224,416,367,640,3018,5452,11,61921,3440,1,2,15,1,31100,12712,2361,18604,0
53,1077,1098,241,925,5,10,155,1103,7,46,25,49,53,74,273,423,3,1580,87,0,2,5,6,31110,12714,2361,18605,0
53,1077,282,202,222,14,2,44,296,8,42,24,43,50,67,250,378,4,1548,86,0,2,5,6,31110,12715,2361,18606,0
60,1074,282,196,195,3,0,86,285,8,130,71,141,138,212,936,1507,4,6538,363,0,2,2,1,31110,12715,2362,18607,0
7,296,72,33,56,0,4,12,72,1,1,1,1,2,2,0,2,0,1,0,0,2,3,2,31110,12715,2362,18608,0
20,619,42,7,35,4,0,5,46,1,2,1,2,3,3,2,4,0,2,0,0,2,1,1,31110,12715,2362,18609,0
20,619,11,6,10,0,0,1,11,2,4,2,4,6,6,10,15,1,15,0,0,2,1,1,31110,12715,2362,18610,0
69,2871,1289,550,1043,56,32,155,1345,10,167,93,185,177,278,1266,2075,5,11498,638,0,2,5,5,31110,12717,2363,18611,0
33,992,182,127,129,0,0,53,182,5,39,21,42,44,63,217,343,2,926,51,0,0,163,0,31110,12717,2364,18612,0
118,5254,1392,870,1177,35,17,170,1427,14,494,280,531,508,811,4473,7289,7,54850,3047,2,0,911,0,31110,12720,2365,18613,0
92,2961,773,419,590,28,0,166,801,10,204,113,217,214,330,1598,2554,5,13587,754,0,0,659,0,31110,12720,2366,18614,0
77,3663,1338,495,1086,10,64,173,1348,11,122,82,157,133,239,883,1686,7,11934,663,0,2,12,9,31110,12722,2366,18615,0
140,6182,139,89,101,2,0,35,141,7,54,34,62,61,96,330,569,4,2287,127,0,2,18,14,31110,12722,2366,18616,0
140,6182,7,5,5,0,0,2,7,1,2,1,2,3,3,2,4,0,2,0,0,2,18,14,31110,12722,2366,18617,0
32,933,465,148,393,5,8,60,470,4,31,20,31,35,51,161,261,2,523,29,0,2,2,1,31110,12723,2366,18618,0
32,933,16,12,9,0,0,6,16,1,2,1,2,3,3,2,4,0,2,0,0,2,2,1,31110,12723,2366,18619,0
81,4399,1782,648,1425,9,47,279,1791,8,171,97,189,179,286,1292,2140,4,9462,525,0,2,5,3,31110,12724,2367,18620,0
13,271,256,139,192,9,7,47,265,4,23,12,24,27,36,112,171,2,357,19,0,2,8,1,31110,12725,2367,18621,0
23,594,102,59,69,5,3,24,107,6,22,15,28,28,43,113,206,3,789,43,0,2,0,4,31110,12725,2367,18622,0
74,2703,1450,624,1228,12,26,181,1462,14,306,186,354,320,540,2580,4493,8,36391,2021,1,2,13,11,31110,12727,2368,18623,0
135,3522,1660,832,1314,41,38,274,1701,20,312,209,395,332,604,2671,5058,12,64042,3557,1,2,4,3,31110,12729,2369,18625,0
112,4316,1513,682,1277,25,13,200,1538,11,199,116,219,210,335,1557,2584,6,15641,868,0,2,3,2,31110,12731,2369,18626,0
55,2831,1457,730,1242,11,6,188,1468,10,292,166,329,302,495,2424,4078,5,22973,1276,1,2,66,2,31110,12733,2369,18627,0
35,2156,652,304,544,16,6,88,668,6,89,51,101,95,152,591,998,3,3399,188,0,2,10,7,31110,12734,2369,18628,0
51,2242,1455,414,1257,16,76,112,1471,5,41,23,46,46,69,231,381,2,1069,59,0,2,80,5,31110,12735,2369,18629,0
63,2582,1020,354,843,12,15,144,1032,8,134,77,144,142,221,970,1580,4,6792,377,0,2,0,2,31110,12735,2369,18630,0
21,647,424,94,331,4,0,89,428,1,5,5,5,6,10,11,25,0,12,0,0,2,0,1,31110,12736,2369,18631,0
38,2201,334,251,279,10,4,40,344,5,127,74,143,132,217,899,1528,2,4303,239,0,2,0,6,31110,12737,2369,18632,0
34,1289,1293,570,1093,25,15,163,1318,10,195,123,241,205,364,1516,2795,6,17273,959,0,2,9,4,31120,12739,2369,18633,0
29,1196,386,256,301,16,9,68,402,4,59,35,69,63,104,355,621,2,1453,80,0,2,10,0,31120,12739,2369,18634,0
16,1265,215,129,180,6,0,29,221,8,65,43,72,73,115,415,711,4,3153,175,0,2,7,3,31120,12739,2369,18635,0
57,2321,1043,504,840,53,9,147,1096,9,180,112,198,189,310,1377,2344,4,11604,644,0,2,10,6,31120,12741,2369,18636,0
56,2421,1178,367,1042,6,15,115,1184,9,94,51,95,103,146,644,976,4,4439,246,0,2,85,0,31120,12741,2369,18637,0
69,3533,1943,715,1694,26,18,214,1969,12,185,120,237,197,357,1436,2721,7,20915,1161,0,2,35,6,31120,12743,2369,18638,0
38,1508,1098,241,925,5,10,155,1103,7,46,25,49,53,74,273,423,3,1580,87,0,2,2,1,31130,12745,2369,18639,0
9,220,19,8,11,5,0,4,24,2,5,3,6,7,9,13,25,1,30,1,0,2,0,3,31140,12749,2370,18647,0
9,220,102,59,69,5,3,24,107,6,22,15,28,28,43,113,206,3,789,43,0,2,0,3,31140,12749,2370,18648,0
9,220,106,40,36,3,49,17,109,8,17,13,23,25,36,93,167,5,904,50,0,2,0,3,31140,12749,2370,18649,0
199,4197,182,127,129,0,0,53,182,5,39,21,42,44,63,217,343,2,926,51,0,0,795,0,31150,12753,2372,18657,0
199,4197,1165,710,800,67,119,181,1232,18,243,153,282,261,435,2000,3492,10,36473,2026,1,0,795,0,31160,12753,2373,18658,0
100,2140,773,419,590,28,0,166,801,10,204,113,217,214,330,1598,2554,5,13587,754,0,0,421,0,31160,12753,2374,18659,0
100,2140,421,273,302,44,34,57,465,17,81,59,107,98,166,583,1098,11,12329,684,0,0,421,0,31160,12753,2375,18660,0
36,711,2,2,2,0,0,0,2,0,0,0,0,0,0,0,0,0,0,0,0,2,11,2,31160,12753,2375,18660,0
36,711,99,48,90,1,3,5,100,0,0,0,0,0,0,0,0,0,0,0,0,2,11,2,31160,12754,2375,18661,0
36,711,8,5,5,2,0,1,10,0,0,0,0,0,0,0,0,0,0,0,0,2,11,2,31160,12754,2375,18662,0
36,711,1217,716,841,84,126,174,1301,14,185,118,215,199,333,1446,2542,8,20687,1149,0,2,11,2,31170,12756,2375,18663,0
36,711,160,89,115,0,13,31,160,7,15,11,17,22,28,78,124,3,495,27,0,2,11,2,31170,12756,2375,18664,0
36,711,10,10,9,9,0,0,19,0,0,0,0,0,0,0,0,0,0,0,0,2,11,2,31170,12756,2376,18665,0
36,711,173,84,99,8,29,36,181,5,12,7,13,17,20,54,81,2,221,12,0,2,11,2,31170,12757,2376,18666,0
36,711,3,1,1,3,0,0,6,0,0,0,0,0,0,0,0,0,0,0,0,2,11,2,31170,12757,2376,18667,0
90,1944,477,336,357,30,23,73,507,16,194,134,250,210,384,1538,2962,10,30538,1696,0,2,2,1,31180,12758,2376,18668,0
57,1223,996,429,845,24,10,117,1020,7,76,50,88,83,138,494,879,4,3565,198,0,2,2,2,31180,12760,2376,18669,0
57,1223,456,277,329,12,42,72,468,13,85,50,97,98,147,592,972,7,7212,400,0,2,2,2,31180,12760,2376,18670,0
298,6082,1457,730,1242,11,6,188,1468,10,292,166,329,302,495,2424,4078,5,22973,1276,1,2,21,18,31180,12762,2376,18671,0
298,6082,74,35,59,1,0,14,75,3,14,7,14,17,21,58,85,1,128,7,0,2,21,18,31180,12763,2376,18672,0
298,6082,245,125,200,5,7,34,250,7,30,17,34,37,51,166,265,3,1053,58,0,2,21,18,31190,12764,2376,18673,0
53,1437,1455,414,1257,16,76,112,1471,5,41,23,46,46,69,231,381,2,1069,59,0,2,57,27,31190,12765,2376,18674,0
53,1437,669,365,481,22,61,110,691,15,103,63,122,118,185,747,1273,8,11311,628,0,2,57,27,31200,12765,2377,18675,0
46,532,647,139,84,35,284,233,682,0,0,0,0,0,0,0,0,0,0,0,0,2,4,1,31200,12765,2377,18676,0
172,3987,77,34,69,0,0,8,77,3,24,16,29,27,45,114,213,1,387,21,0,2,8,4,31200,12765,2377,18677,0
172,3987,712,438,573,51,9,84,763,14,102,71,128,116,199,733,1364,8,11988,666,0,2,8,4,31210,12766,2377,18678,0
21,594,1293,570,1093,25,15,163,1318,10,195,123,241,205,364,1516,2795,6,17273,959,0,2,1,2,31220,12768,2377,18679,0
219,4866,722,423,573,19,0,135,741,12,172,101,199,184,300,1320,2257,6,15668,870,0,2,12,11,31220,12770,2377,18681,0
219,4866,1508,847,911,44,250,301,1552,14,148,88,169,162,257,1120,1886,7,15077,837,0,2,12,11,31220,12771,2378,18682,0
513,10983,72,33,56,0,4,12,72,1,1,1,1,2,2,0,2,0,1,0,0,2,37,36,31220,12771,2378,18683,0
513,10983,1454,835,1044,76,110,219,1530,17,275,158,296,292,454,2297,3718,9,34017,1889,1,2,37,36,31230,12772,2378,18684,0
41,951,386,256,301,16,9,68,402,4,59,35,69,63,104,355,621,2,1453,80,0,2,13,3,31230,12772,2378,18685,0
41,951,264,131,164,11,41,46,275,6,38,22,40,44,62,214,338,3,1068,59,0,2,13,3,31240,12772,2379,18686,0
116,2524,1043,504,840,53,9,147,1096,9,180,112,198,189,310,1377,2344,4,11604,644,0,2,9,4,31240,12774,2379,18687,0
116,2524,383,288,292,26,6,62,409,11,65,38,67,76,105,429,656,5,3719,206,0,2,9,4,31240,12775,2379,18688,0
95,1756,1178,367,1042,6,15,115,1184,9,94,51,95,103,146,644,976,4,4439,246,0,2,31,7,31240,12775,2379,18689,0
95,1756,177,108,140,8,0,27,185,6,30,16,32,36,48,162,248,3,794,44,0,2,31,7,31240,12777,2379,18690,0
181,3706,1943,715,1694,26,18,214,1969,12,185,120,237,197,357,1436,2721,7,20915,1161,0,2,15,1,31240,12779,2379,18691,0
181,3706,1168,838,957,57,25,144,1225,19,348,224,416,367,640,3018,5452,11,61921,3440,1,2,15,1,31250,12781,2379,18692,0
53,1077,1098,241,925,5,10,155,1103,7,46,25,49,53,74,273,423,3,1580,87,0,2,5,6,31260,12783,2379,18693,0
53,1077,282,202,222,14,2,44,296,8,42,24,43,50,67,250,378,4,1548,86,0,2,5,6,31260,12784,2379,18694,0
60,1074,282,196,195,3,0,86,285,8,130,71,141,138,212,936,1507,4,6538,363,0,2,2,1,31260,12784,2380,18695,0
7,296,72,33,56,0,4,12,72,1,1,1,1,2,2,0,2,0,1,0,0,2,3,2,31260,12784,2380,18696,0
20,619,42,7,35,4,0,5,46,1,2,1,2,3,3,2,4,0,2,0,0,2,1,1,31260,12784,2380,18697,0
20,619,11,6,10,0,0,1,11,2,4,2,4,6,6,10,15,1,15,0,0,2,1,1,31260,12784,2380,18698,0
69,2871,1289,550,1043,56,32,155,1345,10,167,93,185,177,278,1266,2075,5,11498,638,0,2,5,5,31260,12786,2381,18699,0
33,992,182,127,129,0,0,53,182,5,39,21,42,44,63,217,343,2,926,51,0,0,163,0,31260,12786,2382,18700,0
118,5254,1392,870,1177,35,17,170,1427,14,494,280,531,508,811,4473,7289,7,54850,3047,2,0,911,0,31260,12789,2383,18701,0
92,2961,773,419,590,28,0,166,801,10,204,113,217,214,330,1598,2554,5,13587,754,0,0,659,0,31260,12789,2384,18702,0
77,3663,1338,495,1086,10,64,173,1348,11,122,82,157,133,239,883,1686,7,11934,663,0,2,12,9,31260,12791,2384,18703,0
140,6182,139,89,101,2,0,35,141,7,54,34,62,61,96,330,569,4,2287,127,0,2,18,14,31260,12791,2384,18704,0
140,6182,7,5,5,0,0,2,7,1,2,1,2,3,3,2,4,0,2,0,0,2,18,14,31260,12791,2384,18705,0
32,933,465,148,393,5,8,60,470,4,31,20,31,35,51,161,261,2,523,29,0,2,2,1,31260,12792,2384,18706,0
32,933,16,12,9,0,0,6,16,1,2,1,2,3,3,2,4,0,2,0,0,2,2,1,31260,12792,2384,18707,0
81,4399,1782,648,1425,9,47,279,1791,8,171,97,189,179,286,1292,2140,4,9462,525,0,2,5,3,31260,12793,2385,18708,0
13,271,256,139,192,9,7,47,265,4,23,12,24,27,36,112,171,2,357,19,0,2,8,1,31260,12794,2385,18709,0
23,594,102,59,69,5,3,24,107,6,22,15,28,28,43,113,206,3,789,43,0,2,0,4,31260,12794,2385,18710,0
74,2703,1450,624,1228,12,26,181,1462,14,306,186,354,320,540,2580,4493,8,36391,2021,1,2,13,11,31260,12796,2386,18711,0
136,3557,1660,832,1314,41,38,274,1701,20,312,209,395,332,604,2671,5058,12,64042,3557,1,2,4,3,31260,12798,2387,18713,0
112,4316,1513,682,1277,25,13,200,1538,11,199,116,219,210,335,1557,2584,6,15641,868,0,2,3,2,31260,12800,2387,18714,0
55,2831,1457,730,1242,11,6,188,1468,10,292,166,329,302,495,2424,4078,5,22973,1276,1,2,66,2,31260,12802,2387,18715,0
35,2156,652,304,544,16,6,88,668,6,89,51,101,95,152,591,998,3,3399,188,0,2,10,7,31260,12803,2387,18716,0
51,2242,1455,414,1257,16,76,112,1471,5,41,23,46,46,69,231,381,2,1069,59,0,2,80,5,31260,12804,2387,18717,0
63,2582,1020,354,843,12,15,144,1032,8,134,77,144,142,221,970,1580,4,6792,377,0,2,0,2,31260,12804,2387,18718,0
21,647,424,94,331,4,0,89,428,1,5,5,5,6,10,11,25,0,12,0,0,2,0,1,31260,12805,2387,18719,0
38,2201,334,251,279,10,4,40,344,5,127,74,143,132,217,899,1528,2,4303,239,0,2,0,6,31260,12806,2387,18720,0
34,1289,1293,570,1093,25,15,163,1318,10,195,123,241,205,364,1516,2795,6,17273,959,0,2,9,4,31270,12808,2387,18721,0
29,1196,386,256,301,16,9,68,402,4,59,35,69,63,104,355,621,2,1453,80,0,2,10,0,31270,12808,2387,18722,0
16,1265,215,129,180,6,0,29,221,8,65,43,72,73,115,415,711,4,3153,175,0,2,7,3,31270,12808,2387,18723,0
57,2321,1043,504,840,53,9,147,1096,9,180,112,198,189,310,1377,2344,4,11604,644,0,2,10,6,31270,12810,2387,18724,0
56,2421,1178,367,1042,6,15,115,1184,9,94,51,95,103,146,644,976,4,4439,246,0,2,85,0,31270,12810,2387,18725,0
69,3533,1943,715,1694,26,18,214,1969,12,185,120,237,197,357,1436,2721,7,20915,1161,0,2,35,6,31270,12812,2387,18726,0
38,1508,1098,241,925,5,10,155,1103,7,46,25,49,53,74,273,423,3,1580,87,0,2,2,1,31280,12814,2387,18727,0
147,4734,1660,832,1314,41,38,274,1701,20,312,209,395,332,604,2671,5058,12,64042,3557,1,2,5,0,31280,12816,2388,18729,0
147,4734,1057,646,719,113,100,145,1170,18,215,134,248,233,382,1740,3004,10,31186,1732,1,2,5,0,31290,12817,2389,18730,0
136,3557,1660,832,1314,41,38,274,1701,20,312,209,395,332,604,2671,5058,12,64042,3557,1,2,13,0,31290,12819,2390,18732,0
181,3718,1943,715,1694,26,18,214,1969,12,185,120,237,197,357,1436,2721,7,20915,1161,0,2,1,0,31290,12821,2390,18733,1
181,3718,1168,838,957,57,25,144,1225,19,348,224,416,367,640,3018,5452,11,61921,3440,1,2,1,0,31300,12823,2390,18734,1
69,3545,1943,715,1694,26,18,214,1969,12,185,120,237,197,357,1436,2721,7,20915,1161,0,2,4,0,31300,12825,2390,18735,1
181,3718,1943,715,1694,26,18,214,1969,12,185,120,237,197,357,1436,2721,7,20915,1161,0,2,1,0,31300,12827,2390,18736,0
181,3718,1168,838,957,57,25,144,1225,19,348,224,416,367,640,3018,5452,11,61921,3440,1,2,1,0,31310,12829,2390,18737,0
69,3545,1943,715,1694,26,18,214,1969,12,185,120,237,197,357,1436,2721,7,20915,1161,0,2,4,0,31310,12831,2390,18738,0
90,1950,477,336,357,30,23,73,507,16,194,134,250,210,384,1538,2962,10,30538,1696,0,2,10,8,31320,12832,2390,18739,1
75,2716,1450,624,1228,12,26,181,1462,14,306,186,354,320,540,2580,4493,8,36391,2021,1,2,3,0,31320,12834,2391,18740,1
90,1950,477,336,357,30,23,73,507,16,194,134,250,210,384,1538,2962,10,30538,1696,0,2,10,8,31330,12835,2391,18741,0
75,2716,1450,624,1228,12,26,181,1462,14,306,186,354,320,540,2580,4493,8,36391,2021,1,2,3,0,31330,12837,2392,18742,0
9,220,19,8,11,5,0,4,24,2,5,3,6,7,9,13,25,1,30,1,0,2,0,3,31340,12841,2393,18750,0
9,220,102,59,69,5,3,24,107,6,22,15,28,28,43,113,206,3,789,43,0,2,0,3,31340,12841,2393,18751,0
9,220,106,40,36,3,49,17,109,8,17,13,23,25,36,93,167,5,904,50,0,2,0,3,31340,12841,2393,18752,0
199,4197,182,127,129,0,0,53,182,5,39,21,42,44,63,217,343,2,926,51,0,0,795,0,31350,12845,2395,18760,0
199,4197,1165,710,800,67,119,181,1232,18,243,153,282,261,435,2000,3492,10,36473,2026,1,0,795,0,31360,12845,2396,18761,0
100,2140,773,419,590,28,0,166,801,10,204,113,217,214,330,1598,2554,5,13587,754,0,0,421,0,31360,12845,2397,18762,0
100,2140,421,273,302,44,34,57,465,17,81,59,107,98,166,583,1098,11,12329,684,0,0,421,0,31360,12845,2398,18763,0
36,711,2,2,2,0,0,0,2,0,0,0,0,0,0,0,0,0,0,0,0,2,11,2,31360,12845,2398,18763,0
36,711,99,48,90,1,3,5,100,0,0,0,0,0,0,0,0,0,0,0,0,2,11,2,31360,12846,2398,18764,0
36,711,8,5,5,2,0,1,10,0,0,0,0,0,0,0,0,0,0,0,0,2,11,2,31360,12846,2398,18765,0
36,711,1217,716,841,84,126,174,1301,14,185,118,215,199,333,1446,2542,8,20687,1149,0,2,11,2,31370,12848,2398,18766,0
36,711,160,89,115,0,13,31,160,7,15,11,17,22,28,78,124,3,495,27,0,2,11,2,31370,12848,2398,18767,0
36,711,10,10,9,9,0,0,19,0,0,0,0,0,0,0,0,0,0,0,0,2,11,2,31370,12848,2399,18768,0
36,711,173,84,99,8,29,36,181,5,12,7,13,17,20,54,81,2,221,12,0,2,11,2,31370,12849,2399,18769,0
36,711,3,1,1,3,0,0,6,0,0,0,0,0,0,0,0,0,0,0,0,2,11,2,31370,12849,2399,18770,0
147,4734,1660,832,1314,41,38,274,1701,20,312,209,395,332,604,2671,5058,12,64042,3557,1,2,5,0,31370,12851,2400,18772,0
147,4734,1057,646,719,113,100,145,1170,18,215,134,248,233,382,1740,3004,10,31186,1732,1,2,5,0,31380,12852,2401,18773,0
90,1950,477,336,357,30,23,73,507,16,194,134,250,210,384,1538,2962,10,30538,1696,0,2,12,9,31390,12853,2401,18774,0
57,1223,996,429,845,24,10,117,1020,7,76,50,88,83,138,494,879,4,3565,198,0,2,2,2,31390,12855,2401,18775,0
57,1223,456,277,329,12,42,72,468,13,85,50,97,98,147,592,972,7,7212,400,0,2,2,2,31390,12855,2401,18776,0
298,6082,1457,730,1242,11,6,188,1468,10,292,166,329,302,495,2424,4078,5,22973,1276,1,2,21,18,31390,12857,2401,18777,0
298,6082,74,35,59,1,0,14,75,3,14,7,14,17,21,58,85,1,128,7,0,2,21,18,31390,12858,2401,18778,0
298,6082,245,125,200,5,7,34,250,7,30,17,34,37,51,166,265,3,1053,58,0,2,21,18,31400,12859,2401,18779,0
53,1437,1455,414,1257,16,76,112,1471,5,41,23,46,46,69,231,381,2,1069,59,0,2,57,27,31400,12860,2401,18780,0
53,1437,669,365,481,22,61,110,691,15,103,63,122,118,185,747,1273,8,11311,628,0,2,57,27,31410,12860,2402,18781,0
46,532,647,139,84,35,284,233,682,0,0,0,0,0,0,0,0,0,0,0,0,2,4,1,31410,12860,2402,18782,0
172,3987,77,34,69,0,0,8,77,3,24,16,29,27,45,114,213,1,387,21,0,2,8,4,31410,12860,2402,18783,0
172,3987,712,438,573,51,9,84,763,14,102,71,128,116,199,733,1364,8,11988,666,0,2,8,4,31420,12861,2402,18784,0
21,594,1293,570,1093,25,15,163,1318,10,195,123,241,205,364,1516,2795,6,17273,959,0,2,1,2,31430,12863,2402,18785,0
219,4866,722,423,573,19,0,135,741,12,172,101,199,184,300,1320,2257,6,15668,870,0,2,12,11,31430,12865,2402,18787,0
219,4866,1508,847,911,44,250,301,1552,14,148,88,169,162,257,1120,1886,7,15077,837,0,2,12,11,31430,12866,2403,18788,0
513,10983,72,33,56,0,4,12,72,1,1,1,1,2,2,0,2,0,1,0,0,2,37,36,31430,12866,2403,18789,0
513,10983,1454,835,1044,76,110,219,1530,17,275,158,296,292,454,2297,3718,9,34017,1889,1,2,37,36,31440,12867,2403,18790,0
41,951,386,256,301,16,9,68,402,4,59,35,69,63,104,355,621,2,1453,80,0,2,13,3,31440,12867,2403,18791,0
41,951,264,131,164,11,41,46,275,6,38,22,40,44,62,214,338,3,1068,59,0,2,13,3,31450,12867,2404,18792,0
116,2524,1043,504,840,53,9,147,1096,9,180,112,198,189,310,1377,2344,4,11604,644,0,2,9,4,31450,12869,2404,18793,0
116,2524,383,288,292,26,6,62,409,11,65,38,67,76,105,429,656,5,3719,206,0,2,9,4,31450,12870,2404,18794,0
95,1756,1178,367,1042,6,15,115,1184,9,94,51,95,103,146,644,976,4,4439,246,0,2,31,7,31450,12870,2404,18795,0
95,1756,177,108,140,8,0,27,185,6,30,16,32,36,48,162,248,3,794,44,0,2,31,7,31450,12872,2404,18796,0
181,3718,1943,715,1694,26,18,214,1969,12,185,120,237,197,357,1436,2721,7,20915,1161,0,2,16,1,31450,12874,2404,18797,0
181,3718,1168,838,957,57,25,144,1225,19,348,224,416,367,640,3018,5452,11,61921,3440,1,2,16,1,31460,12876,2404,18798,0
53,1077,1098,241,925,5,10,155,1103,7,46,25,49,53,74,273,423,3,1580,87,0,2,5,6,31470,12878,2404,18799,0
53,1077,282,202,222,14,2,44,296,8,42,24,43,50,67,250,378,4,1548,86,0,2,5,6,31470,12879,2404,18800,0
60,1074,282,196,195,3,0,86,285,8,130,71,141,138,212,936,1507,4,6538,363,0,2,2,1,31470,12879,2405,18801,0
7,296,72,33,56,0,4,12,72,1,1,1,1,2,2,0,2,0,1,0,0,2,3,2,31470,12879,2405,18802,0
20,619,42,7,35,4,0,5,46,1,2,1,2,3,3,2,4,0,2,0,0,2,1,1,31470,12879,2405,18803,0
20,619,11,6,10,0,0,1,11,2,4,2,4,6,6,10,15,1,15,0,0,2,1,1,31470,12879,2405,18804,0
69,2871,1289,550,1043,56,32,155,1345,10,167,93,185,177,278,1266,2075,5,11498,638,0,2,5,5,31470,12881,2406,18805,0
33,992,182,127,129,0,0,53,182,5,39,21,42,44,63,217,343,2,926,51,0,0,163,0,31470,12881,2407,18806,0
118,5254,1392,870,1177,35,17,170,1427,14,494,280,531,508,811,4473,7289,7,54850,3047,2,0,911,0,31470,12884,2408,18807,0
92,2961,773,419,590,28,0,166,801,10,204,113,217,214,330,1598,2554,5,13587,754,0,0,659,0,31470,12884,2409,18808,0
77,3663,1338,495,1086,10,64,173,1348,11,122,82,157,133,239,883,1686,7,11934,663,0,2,12,9,31470,12886,2409,18809,0
140,6182,139,89,101,2,0,35,141,7,54,34,62,61,96,330,569,4,2287,127,0,2,18,14,31470,12886,2409,18810,0
140,6182,7,5,5,0,0,2,7,1,2,1,2,3,3,2,4,0,2,0,0,2,18,14,31470,12886,2409,18811,0
32,933,465,148,393,5,8,60,470,4,31,20,31,35,51,161,261,2,523,29,0,2,2,1,31470,12887,2409,18812,0
32,933,16,12,9,0,0,6,16,1,2,1,2,3,3,2,4,0,2,0,0,2,2,1,31470,12887,2409,18813,0
81,4399,1782,648,1425,9,47,279,1791,8,171,97,189,179,286,1292,2140,4,9462,525,0,2,5,3,31470,12888,2410,18814,0
13,271,256,139,192,9,7,47,265,4,23,12,24,27,36,112,171,2,357,19,0,2,8,1,31470,12889,2410,18815,0
23,594,102,59,69,5,3,24,107,6,22,15,28,28,43,113,206,3,789,43,0,2,0,4,31470,12889,2410,18816,0
75,2716,1450,624,1228,12,26,181,1462,14,306,186,354,320,540,2580,4493,8,36391,2021,1,2,16,11,31470,12891,2411,18817,0
136,3557,1660,832,1314,41,38,274,1701,20,312,209,395,332,604,2671,5058,12,64042,3557,1,2,17,3,31470,12893,2412,18819,0
112,4316,1513,682,1277,25,13,200,1538,11,199,116,219,210,335,1557,2584,6,15641,868,0,2,3,2,31470,12895,2412,18820,0
55,2831,1457,730,1242,11,6,188,1468,10,292,166,329,302,495,2424,4078,5,22973,1276,1,2,66,2,31470,12897,2412,18821,0
35,2156,652,304,544,16,6,88,668,6,89,51,101,95,152,591,998,3,3399,188,0,2,10,7,31470,12898,2412,18822,0
51,2242,1455,414,1257,16,76,112,1471,5,41,23,46,46,69,231,381,2,1069,59,0,2,80,5,31470,12899,2412,18823,0
63,2582,1020,354,843,12,15,144,1032,8,134,77,144,142,221,970,1580,4,6792,377,0,2,0,2,31470,12899,2412,18824,0
21,647,424,94,331,4,0,89,428,1,5,5,5,6,10,11,25,0,12,0,0,2,0,1,31470,12900,2412,18825,0
38,2201,334,251,279,10,4,40,344,5,127,74,143,132,217,899,1528,2,4303,239,0,2,0,6,31470,12901,2412,18826,0
34,1289,1293,570,1093,25,15,163,1318,10,195,123,241,205,364,1516,2795,6,17273,959,0,2,9,4,31480,12903,2412,18827,0
29,1196,386,256,301,16,9,68,402,4,59,35,69,63,104,355,621,2,1453,80,0,2,10,0,31480,12903,2412,18828,0
16,1265,215,129,180,6,0,29,221,8,65,43,72,73,115,415,711,4,3153,175,0,2,7,3,31480,12903,2412,18829,0
57,2321,1043,504,840,53,9,147,1096,9,180,112,198,189,310,1377,2344,4,11604,644,0,2,10,6,31480,12905,2412,18830,0
56,2421,1178,367,1042,6,15,115,1184,9,94,51,95,103,146,644,976,4,4439,246,0,2,85,0,31480,12905,2412,18831,0
69,3545,1943,715,1694,26,18,214,1969,12,185,120,237,197,357,1436,2721,7,20915,1161,0,2,39,6,31480,12907,2412,18832,0
38,1508,1098,241,925,5,10,155,1103,7,46,25,49,53,74,273,423,3,1580,87,0,2,2,1,31490,12909,2412,18833,0
302,6165,1457,730,1242,11,6,188,1468,10,292,166,329,302,495,2424,4078,5,22973,1276,1,2,23,2,31490,12911,2412,18834,0
302,6165,74,35,59,1,0,14,75,3,14,7,14,17,21,58,85,1,128,7,0,2,23,2,31490,12912,2412,18835,0
302,6165,245,125,200,5,7,34,250,7,30,17,34,37,51,166,265,3,1053,58,0,2,23,2,31500,12913,2412,18836,0
57,2907,1457,730,1242,11,6,188,1468,10,292,166,329,302,495,2424,4078,5,22973,1276,1,2,15,0,31500,12915,2412,18837,0
98,1843,1178,367,1042,6,15,115,1184,9,94,51,95,103,146,644,976,4,4439,246,0,2,18,0,31500,12915,2412,18838,1
98,1843,177,108,140,8,0,27,185,6,30,16,32,36,48,162,248,3,794,44,0,2,18,0,31500,12917,2412,18839,1
63,2648,1178,367,1042,6,15,115,1184,9,94,51,95,103,146,644,976,4,4439,246,0,2,52,0,31500,12917,2412,18840,1
302,6165,1457,730,1242,11,6,188,1468,10,292,166,329,302,495,2424,4078,5,22973,1276,1,2,23,2,31500,12919,2412,18841,0
302,6165,74,35,59,1,0,14,75,3,14,7,14,17,21,58,85,1,128,7,0,2,23,2,31500,12920,2412,18842,0
302,6165,245,125,200,5,7,34,250,7,30,17,34,37,51,166,265,3,1053,58,0,2,23,2,31510,12921,2412,18843,0
98,1843,1178,367,1042,6,15,115,1184,9,94,51,95,103,146,644,976,4,4439,246,0,2,18,0,31510,12921,2412,18844,0
98,1843,177,108,140,8,0,27,185,6,30,16,32,36,48,162,248,3,794,44,0,2,18,0,31510,12923,2412,18845,0
57,2907,1457,730,1242,11,6,188,1468,10,292,166,329,302,495,2424,4078,5,22973,1276,1,2,15,0,31510,12925,2412,18846,0
63,2648,1178,367,1042,6,15,115,1184,9,94,51,95,103,146,644,976,4,4439,246,0,2,52,0,31510,12925,2412,18847,0
98,1850,1178,367,1042,6,15,115,1184,9,94,51,95,103,146,644,976,4,4439,246,0,2,3,0,31510,12925,2412,18848,1
98,1850,177,108,140,8,0,27,185,6,30,16,32,36,48,162,248,3,794,44,0,2,3,0,31510,12927,2412,18849,1
77,3673,1338,495,1086,10,64,173,1348,11,122,82,157,133,239,883,1686,7,11934,663,0,2,1,0,31510,12929,2412,18850,1
63,2661,1178,367,1042,6,15,115,1184,9,94,51,95,103,146,644,976,4,4439,246,0,2,2,1,31510,12929,2412,18851,1
99,1863,1178,367,1042,6,15,115,1184,9,94,51,95,103,146,644,976,4,4439,246,0,2,18,12,31510,12929,2412,18852,1
99,1863,177,108,140,8,0,27,185,6,30,16,32,36,48,162,248,3,794,44,0,2,18,12,31510,12931,2412,18853,1
64,2726,1178,367,1042,6,15,115,1184,9,94,51,95,103,146,644,976,4,4439,246,0,2,22,3,31510,12931,2412,18854,1
60,1251,996,429,845,24,10,117,1020,7,76,50,88,83,138,494,879,4,3565,198,0,2,3,1,31510,12933,2412,18855,1
60,1251,456,277,329,12,42,72,468,13,85,50,97,98,147,592,972,7,7212,400,0,2,3,1,31510,12933,2412,18856,1
99,1863,1178,367,1042,6,15,115,1184,9,94,51,95,103,146,644,976,4,4439,246,0,2,20,11,31510,12933,2412,18857,0
99,1863,177,108,140,8,0,27,185,6,30,16,32,36,48,162,248,3,794,44,0,2,20,11,31510,12935,2412,18858,0
77,3673,1338,495,1086,10,64,173,1348,11,122,82,157,133,239,883,1686,7,11934,663,0,2,1,0,31510,12937,2412,18859,0
64,2726,1178,367,1042,6,15,115,1184,9,94,51,95,103,146,644,976,4,4439,246,0,2,24,4,31510,12937,2412,18860,0
181,3727,1943,715,1694,26,18,214,1969,12,185,120,237,197,357,1436,2721,7,20915,1161,0,2,4,3,31510,12939,2412,18861,0
181,3727,1168,838,957,57,25,144,1225,19,348,224,416,367,640,3018,5452,11,61921,3440,1,2,4,3,31520,12941,2412,18862,0
72,3652,1943,715,1694,26,18,214,1969,12,185,120,237,197,357,1436,2721,7,20915,1161,0,2,25,0,31520,12943,2412,18863,0
181,3727,1943,715,1694,26,18,214,1969,12,185,120,237,197,357,1436,2721,7,20915,1161,0,2,4,3,31520,12945,2412,18864,0
181,3727,1168,838,957,57,25,144,1225,19,348,224,416,367,640,3018,5452,11,61921,3440,1,2,4,3,31530,12947,2412,18865,0
72,3652,1943,715,1694,26,18,214,1969,12,185,120,237,197,357,1436,2721,7,20915,1161,0,2,25,0,31530,12949,2412,18866,0
99,1873,1178,367,1042,6,15,115,1184,9,94,51,95,103,146,644,976,4,4439,246,0,2,3,3,31530,12949,2412,18867,1
99,1873,177,108,140,8,0,27,185,6,30,16,32,36,48,162,248,3,794,44,0,2,3,3,31530,12951,2412,18868,1
83,3847,1338,495,1086,10,64,173,1348,11,122,82,157,133,239,883,1686,7,11934,663,0,2,78,0,31530,12953,2412,18869,1
64,2751,1178,367,1042,6,15,115,1184,9,94,51,95,103,146,644,976,4,4439,246,0,2,7,4,31530,12953,2412,18870,0
513,10987,72,33,56,0,4,12,72,1,1,1,1,2,2,0,2,0,1,0,0,2,1,1,31530,12953,2412,18871,1
513,10987,1454,835,1044,76,110,219,1530,17,275,158,296,292,454,2297,3718,9,34017,1889,1,2,1,1,31540,12954,2412,18872,1
58,2427,1043,504,840,53,9,147,1096,9,180,112,198,189,310,1377,2344,4,11604,644,0,2,43,0,31540,12956,2412,18873,1
60,2418,1043,504,840,53,9,147,1096,9,180,112,198,189,310,1377,2344,4,11604,644,0,2,20,37,31540,12958,2412,18874,1
99,1873,1178,367,1042,6,15,115,1184,9,94,51,95,103,146,644,976,4,4439,246,0,2,3,3,31540,12958,2412,18875,0
99,1873,177,108,140,8,0,27,185,6,30,16,32,36,48,162,248,3,794,44,0,2,3,3,31540,12960,2412,18876,0
83,3847,1338,495,1086,10,64,173,1348,11,122,82,157,133,239,883,1686,7,11934,663,0,2,78,0,31540,12962,2412,18877,0
64,2751,1178,367,1042,6,15,115,1184,9,94,51,95,103,146,644,976,4,4439,246,0,2,7,4,31540,12962,2412,18878,0
513,10987,72,33,56,0,4,12,72,1,1,1,1,2,2,0,2,0,1,0,0,2,1,1,31540,12962,2412,18879,0
513,10987,1454,835,1044,76,110,219,1530,17,275,158,296,292,454,2297,3718,9,34017,1889,1,2,1,1,31550,12963,2412,18880,0
60,2418,1043,504,840,53,9,147,1096,9,180,112,198,189,310,1377,2344,4,11604,644,0,2,26,0,31550,12965,2412,18881,0
68,1237,1020,354,843,12,15,144,1032,8,134,77,144,142,221,970,1580,4,6792,377,0,2,1,1,31550,12965,2412,18882,1
68,1237,1020,354,843,12,15,144,1032,8,134,77,144,142,221,970,1580,4,6792,377,0,2,1,1,31550,12965,2412,18883,0
68,1945,1523,757,1297,19,12,193,1542,12,193,117,230,205,347,1508,2664,7,19053,1058,0,2,4,8,31560,12967,2412,18884,1
68,1945,701,378,504,33,58,109,734,13,110,68,126,123,194,794,1346,7,10027,557,0,2,4,8,31560,12968,2413,18885,1
71,3371,1523,757,1297,19,12,193,1542,12,193,117,230,205,347,1508,2664,7,19053,1058,0,2,15,0,31570,12970,2413,18886,1
68,1945,1523,757,1297,19,12,193,1542,12,193,117,230,205,347,1508,2664,7,19053,1058,0,2,4,8,31580,12972,2413,18887,0
68,1945,701,378,504,33,58,109,734,13,110,68,126,123,194,794,1346,7,10027,557,0,2,4,8,31580,12973,2414,18888,0
71,3371,1523,757,1297,19,12,193,1542,12,193,117,230,205,347,1508,2664,7,19053,1058,0,2,15,0,31590,12975,2414,18889,0
56,1502,1455,414,1257,16,76,112,1471,5,41,23,46,46,69,231,381,2,1069,59,0,2,13,0,31630,12992,2418,18918,1
56,1502,669,365,481,22,61,110,691,15,103,63,122,118,185,747,1273,8,11311,628,0,2,13,0,31640,12992,2419,18919,1
53,2376,1455,414,1257,16,76,112,1471,5,41,23,46,46,69,231,381,2,1069,59,0,2,50,0,31640,12993,2419,18920,1
67,1986,1523,757,1297,19,12,193,1542,12,193,117,230,205,347,1508,2664,7,19053,1058,0,2,14,3,31650,12995,2419,18921,0
67,1986,701,378,504,33,58,109,734,13,110,68,126,123,194,794,1346,7,10027,557,0,2,14,3,31650,12996,2420,18922,0
72,3430,1523,757,1297,19,12,193,1542,12,193,117,230,205,347,1508,2664,7,19053,1058,0,2,20,5,31660,12998,2420,18923,0
56,1502,1455,414,1257,16,76,112,1471,5,41,23,46,46,69,231,381,2,1069,59,0,2,13,0,31660,12999,2420,18924,0
56,1502,669,365,481,22,61,110,691,15,103,63,122,118,185,747,1273,8,11311,628,0,2,13,0,31670,12999,2421,18925,0
53,2376,1455,414,1257,16,76,112,1471,5,41,23,46,46,69,231,381,2,1069,59,0,2,50,0,31670,13000,2421,18926,0
67,1986,1523,757,1297,19,12,193,1542,12,193,117,230,205,347,1508,2664,7,19053,1058,0,2,14,3,31680,13002,2421,18927,0
67,1986,701,378,504,33,58,109,734,13,110,68,126,123,194,794,1346,7,10027,557,0,2,14,3,31680,13003,2422,18928,0
72,3430,1523,757,1297,19,12,193,1542,12,193,117,230,205,347,1508,2664,7,19053,1058,0,2,20,5,31690,13005,2422,18929,0
73,3480,1523,757,1297,19,12,193,1542,12,193,117,230,205,347,1508,2664,7,19053,1058,0,2,18,2,31700,13007,2422,18930,1
73,3480,1523,757,1297,19,12,193,1542,12,193,117,230,205,347,1508,2664,7,19053,1058,0,2,18,2,31710,13009,2422,18931,0
46,532,647,139,84,35,284,233,682,0,0,0,0,0,0,0,0,0,0,0,0,2,6,9,31710,13009,2422,18932,0
46,532,647,139,84,35,284,233,682,0,0,0,0,0,0,0,0,0,0,0,0,2,6,9,31710,13009,2422,18933,0
513,10991,72,33,56,0,4,12,72,1,1,1,1,2,2,0,2,0,1,0,0,2,1,1,31710,13009,2422,18934,1
513,10991,1454,835,1044,76,110,219,1530,17,275,158,296,292,454,2297,3718,9,34017,1889,1,2,1,1,31720,13010,2422,18935,1
116,2528,1043,504,840,53,9,147,1096,9,180,112,198,189,310,1377,2344,4,11604,644,0,2,1,1,31720,13012,2422,18936,1
116,2528,383,288,292,26,6,62,409,11,65,38,67,76,105,429,656,5,3719,206,0,2,1,1,31720,13013,2422,18937,1
62,2486,1043,504,840,53,9,147,1096,9,180,112,198,189,310,1377,2344,4,11604,644,0,2,19,0,31720,13015,2422,18938,1
36,1082,182,127,129,0,0,53,182,5,39,21,42,44,63,217,343,2,926,51,0,2,11,0,31720,13015,2423,18939,0
84,3883,1338,495,1086,10,64,173,1348,11,122,82,157,133,239,883,1686,7,11934,663,0,2,17,0,31720,13017,2423,18940,0
36,1082,182,127,129,0,0,53,182,5,39,21,42,44,63,217,343,2,926,51,0,2,11,0,31720,13017,2424,18941,0
84,3883,1338,495,1086,10,64,173,1348,11,122,82,157,133,239,883,1686,7,11934,663,0,2,17,0,31720,13019,2424,18942,0
117,2546,1043,504,840,53,9,147,1096,9,180,112,198,189,310,1377,2344,4,11604,644,0,2,4,1,31720,13021,2424,18943,1
117,2546,383,288,292,26,6,62,409,11,65,38,67,76,105,429,656,5,3719,206,0,2,4,1,31720,13022,2424,18944,1
62,2505,1043,504,840,53,9,147,1096,9,180,112,198,189,310,1377,2344,4,11604,644,0,2,6,3,31720,13024,2424,18945,1
514,11003,72,33,56,0,4,12,72,1,1,1,1,2,2,0,2,0,1,0,0,2,1,1,31720,13024,2424,18946,1
514,11003,1454,835,1044,76,110,219,1530,17,275,158,296,292,454,2297,3718,9,34017,1889,1,2,1,1,31730,13025,2424,18947,1
70,2905,1289,550,1043,56,32,155,1345,10,167,93,185,177,278,1266,2075,5,11498,638,0,2,14,0,31730,13027,2425,18948,1
82,4441,1782,648,1425,9,47,279,1791,8,171,97,189,179,286,1292,2140,4,9462,525,0,2,5,0,31730,13028,2426,18949,1
513,10991,72,33,56,0,4,12,72,1,1,1,1,2,2,0,2,0,1,0,0,2,1,1,31730,13028,2426,18950,0
513,10991,1454,835,1044,76,110,219,1530,17,275,158,296,292,454,2297,3718,9,34017,1889,1,2,1,1,31740,13029,2426,18951,0
117,2546,1043,504,840,53,9,147,1096,9,180,112,198,189,310,1377,2344,4,11604,644,0,2,4,1,31740,13031,2426,18952,0
117,2546,383,288,292,26,6,62,409,11,65,38,67,76,105,429,656,5,3719,206,0,2,4,1,31740,13032,2426,18953,0
62,2505,1043,504,840,53,9,147,1096,9,180,112,198,189,310,1377,2344,4,11604,644,0,2,22,0,31740,13034,2426,18954,0
514,11007,72,33,56,0,4,12,72,1,1,1,1,2,2,0,2,0,1,0,0,2,1,1,31740,13034,2426,18955,0
514,11007,1454,835,1044,76,110,219,1530,17,275,158,296,292,454,2297,3718,9,34017,1889,1,2,1,1,31750,13035,2426,18956,0
70,2905,1289,550,1043,56,32,155,1345,10,167,93,185,177,278,1266,2075,5,11498,638,0,2,14,0,31750,13037,2427,18957,0
82,4441,1782,648,1425,9,47,279,1791,8,171,97,189,179,286,1292,2140,4,9462,525,0,2,5,0,31750,13038,2428,18958,0
526,11221,72,33,56,0,4,12,72,1,1,1,1,2,2,0,2,0,1,0,0,2,101,1,31750,13038,2428,18959,1
526,11221,1454,835,1044,76,110,219,1530,17,275,158,296,292,454,2297,3718,9,34017,1889,1,2,101,1,31760,13039,2428,18960,1
3,128,520,294,400,33,13,81,553,10,261,204,367,271,571,2128,4614,7,32445,1802,1,0,27,0,31760,13040,2428,18961,1
526,11222,72,33,56,0,4,12,72,1,1,1,1,2,2,0,2,0,1,0,0,2,8,7,31760,13040,2428,18962,1
526,11222,1454,835,1044,76,110,219,1530,17,275,158,296,292,454,2297,3718,9,34017,1889,1,2,8,7,31770,13041,2428,18963,1
4,159,520,294,400,33,13,81,553,10,261,204,367,271,571,2128,4614,7,32445,1802,1,2,6,1,31770,13042,2428,18964,1
527,11252,72,33,56,0,4,12,72,1,1,1,1,2,2,0,2,0,1,0,0,2,4,3,31770,13042,2428,18965,1
527,11252,1454,835,1044,76,110,219,1530,17,275,158,296,292,454,2297,3718,9,34017,1889,1,2,4,3,31780,13043,2428,18966,1
4,166,520,294,400,33,13,81,553,10,261,204,367,271,571,2128,4614,7,32445,1802,1,2,2,1,31780,13044,2428,18967,1
527,11252,72,33,56,0,4,12,72,1,1,1,1,2,2,0,2,0,1,0,0,2,8,5,31780,13044,2428,18968,1
527,11252,1454,835,1044,76,110,219,1530,17,275,158,296,292,454,2297,3718,9,34017,1889,1,2,8,5,31790,13045,2428,18969,1
527,11252,72,33,56,0,4,12,72,1,1,1,1,2,2,0,2,0,1,0,0,2,12,8,31790,13045,2428,18970,1
527,11252,1454,835,1044,76,110,219,1530,17,275,158,296,292,454,2297,3718,9,34017,1889,1,2,12,8,31800,13046,2428,18971,1
527,11252,72,33,56,0,4,12,72,1,1,1,1,2,2,0,2,0,1,0,0,2,1,1,31800,13046,2428,18972,0
527,11252,1454,835,1044,76,110,219,1530,17,275,158,296,292,454,2297,3718,9,34017,1889,1,2,1,1,31810,13047,2428,18973,0
527,11252,72,33,56,0,4,12,72,1,1,1,1,2,2,0,2,0,1,0,0,2,2,2,31810,13047,2428,18974,0
527,11252,1454,835,1044,76,110,219,1530,17,275,158,296,292,454,2297,3718,9,34017,1889,1,2,2,2,31820,13048,2428,18975,0
527,11253,72,33,56,0,4,12,72,1,1,1,1,2,2,0,2,0,1,0,0,2,1,1,31820,13048,2428,18976,0
527,11253,1454,835,1044,76,110,219,1530,17,275,158,296,292,454,2297,3718,9,34017,1889,1,2,1,1,31830,13049,2428,18977,0
302,6177,1457,730,1242,11,6,188,1468,10,292,166,329,302,495,2424,4078,5,22973,1276,1,2,2,2,31830,13051,2428,18978,1
302,6177,74,35,59,1,0,14,75,3,14,7,14,17,21,58,85,1,128,7,0,2,2,2,31830,13052,2428,18979,1
302,6177,245,125,200,5,7,34,250,7,30,17,34,37,51,166,265,3,1053,58,0,2,2,2,31840,13053,2428,18980,1
35,1824,384,251,317,7,8,52,391,11,70,44,84,81,128,467,811,6,5355,297,0,2,6,2,31840,13053,2428,18981,1
514,11018,72,33,56,0,4,12,72,1,1,1,1,2,2,0,2,0,1,0,0,2,14,4,31840,13053,2428,18982,1
514,11018,1454,835,1044,76,110,219,1530,17,275,158,296,292,454,2297,3718,9,34017,1889,1,2,14,4,31850,13054,2428,18983,1
141,6212,139,89,101,2,0,35,141,7,54,34,62,61,96,330,569,4,2287,127,0,2,11,0,31850,13054,2428,18984,1
141,6212,7,5,5,0,0,2,7,1,2,1,2,3,3,2,4,0,2,0,0,2,11,0,31850,13054,2428,18985,1
304,6210,1457,730,1242,11,6,188,1468,10,292,166,329,302,495,2424,4078,5,22973,1276,1,2,6,1,31850,13056,2428,18986,1
304,6210,74,35,59,1,0,14,75,3,14,7,14,17,21,58,85,1,128,7,0,2,6,1,31850,13057,2428,18987,1
304,6210,245,125,200,5,7,34,250,7,30,17,34,37,51,166,265,3,1053,58,0,2,6,1,31860,13058,2428,18988,1
304,6210,1457,730,1242,11,6,188,1468,10,292,166,329,302,495,2424,4078,5,22973,1276,1,2,7,2,31860,13060,2428,18989,0
304,6210,74,35,59,1,0,14,75,3,14,7,14,17,21,58,85,1,128,7,0,2,7,2,31860,13061,2428,18990,0
304,6210,245,125,200,5,7,34,250,7,30,17,34,37,51,166,265,3,1053,58,0,2,7,2,31870,13062,2428,18991,0
35,1824,384,251,317,7,8,52,391,11,70,44,84,81,128,467,811,6,5355,297,0,2,6,2,31870,13062,2428,18992,0
60,1251,996,429,845,24,10,117,1020,7,76,50,88,83,138,494,879,4,3565,198,0,2,1,1,31870,13064,2428,18993,1
60,1251,456,277,329,12,42,72,468,13,85,50,97,98,147,592,972,7,7212,400,0,2,1,1,31870,13064,2428,18994,1
60,1251,996,429,845,24,10,117,1020,7,76,50,88,83,138,494,879,4,3565,198,0,2,3,1,31870,13066,2428,18995,0
60,1251,456,277,329,12,42,72,468,13,85,50,97,98,147,592,972,7,7212,400,0,2,3,1,31870,13066,2428,18996,0
540,11486,72,33,56,0,4,12,72,1,1,1,1,2,2,0,2,0,1,0,0,2,104,20,31870,13066,2428,18997,1
540,11486,1454,835,1044,76,110,219,1530,17,275,158,296,292,454,2297,3718,9,34017,1889,1,2,104,20,31880,13067,2428,18998,1
43,2254,520,294,400,33,13,81,553,10,261,204,367,271,571,2128,4614,7,32445,1802,1,2,259,9,31880,13068,2428,18999,1
540,11486,72,33,56,0,4,12,72,1,1,1,1,2,2,0,2,0,1,0,0,2,102,50,31880,13068,2428,19000,1
540,11486,1454,835,1044,76,110,219,1530,17,275,158,296,292,454,2297,3718,9,34017,1889,1,2,102,50,31890,13069,2428,19001,1
542,11516,72,33,56,0,4,12,72,1,1,1,1,2,2,0,2,0,1,0,0,2,6,0,31890,13069,2428,19002,1
542,11516,1454,835,1044,76,110,219,1530,17,275,158,296,292,454,2297,3718,9,34017,1889,1,2,6,0,31900,13070,2428,19003,1
43,2308,520,294,400,33,13,81,553,10,261,204,367,271,571,2128,4614,7,32445,1802,1,2,6,3,31900,13071,2428,19004,1
46,532,647,139,84,35,284,233,682,0,0,0,0,0,0,0,0,0,0,0,0,2,1,1,31900,13071,2428,19005,0
173,4001,77,34,69,0,0,8,77,3,24,16,29,27,45,114,213,1,387,21,0,2,1,1,31900,13071,2428,19006,0
173,4001,712,438,573,51,9,84,763,14,102,71,128,116,199,733,1364,8,11988,666,0,2,1,1,31910,13072,2428,19007,0
64,2629,1020,354,843,12,15,144,1032,8,134,77,144,142,221,970,1580,4,6792,377,0,2,16,0,31910,13072,2428,19008,0
514,11018,72,33,56,0,4,12,72,1,1,1,1,2,2,0,2,0,1,0,0,2,14,4,31910,13072,2428,19009,0
514,11018,1454,835,1044,76,110,219,1530,17,275,158,296,292,454,2297,3718,9,34017,1889,1,2,14,4,31920,13073,2428,19010,0
141,6212,139,89,101,2,0,35,141,7,54,34,62,61,96,330,569,4,2287,127,0,2,11,0,31920,13073,2428,19011,0
141,6212,7,5,5,0,0,2,7,1,2,1,2,3,3,2,4,0,2,0,0,2,11,0,31920,13073,2428,19012,0
46,532,647,139,84,35,284,233,682,0,0,0,0,0,0,0,0,0,0,0,0,2,1,1,31920,13073,2428,19013,0
542,11516,72,33,56,0,4,12,72,1,1,1,1,2,2,0,2,0,1,0,0,2,9,7,31920,13073,2428,19014,1
542,11516,1454,835,1044,76,110,219,1530,17,275,158,296,292,454,2297,3718,9,34017,1889,1,2,9,7,31930,13074,2428,19015,1
542,11516,72,33,56,0,4,12,72,1,1,1,1,2,2,0,2,0,1,0,0,2,3,3,31930,13074,2428,19016,1
542,11516,1454,835,1044,76,110,219,1530,17,275,158,296,292,454,2297,3718,9,34017,1889,1,2,3,3,31940,13075,2428,19017,1
543,11547,72,33,56,0,4,12,72,1,1,1,1,2,2,0,2,0,1,0,0,2,14,4,31940,13075,2428,19018,0
543,11547,1454,835,1044,76,110,219,1530,17,275,158,296,292,454,2297,3718,9,34017,1889,1,2,14,4,31950,13076,2428,19019,0
141,6212,139,89,101,2,0,35,141,7,54,34,62,61,96,330,569,4,2287,127,0,2,11,0,31950,13076,2428,19020,0
141,6212,7,5,5,0,0,2,7,1,2,1,2,3,3,2,4,0,2,0,0,2,11,0,31950,13076,2428,19021,0
543,11547,72,33,56,0,4,12,72,1,1,1,1,2,2,0,2,0,1,0,0,2,255,2,31950,13076,2428,19022,0
543,11547,1454,835,1044,76,110,219,1530,17,275,158,296,292,454,2297,3718,9,34017,1889,1,2,255,2,31960,13077,2428,19023,0
43,2308,520,294,400,33,13,81,553,10,261,204,367,271,571,2128,4614,7,32445,1802,1,0,286,0,31960,13078,2428,19024,0
173,4001,77,34,69,0,0,8,77,3,24,16,29,27,45,114,213,1,387,21,0,2,1,0,31960,13078,2428,19025,0
173,4001,712,438,573,51,9,84,763,14,102,71,128,116,199,733,1364,8,11988,666,0,2,1,0,31970,13079,2428,19026,0
173,4001,77,34,69,0,0,8,77,3,24,16,29,27,45,114,213,1,387,21,0,2,2,1,31970,13079,2428,19027,0
173,4001,712,438,573,51,9,84,763,14,102,71,128,116,199,733,1364,8,11988,666,0,2,2,1,31980,13080,2428,19028,0
64,2629,1020,354,843,12,15,144,1032,8,134,77,144,142,221,970,1580,4,6792,377,0,2,16,0,31980,13080,2428,19029,0
72,2027,1523,757,1297,19,12,193,1542,12,193,117,230,205,347,1508,2664,7,19053,1058,0,2,21,0,31990,13082,2428,19030,1
72,2027,701,378,504,33,58,109,734,13,110,68,126,123,194,794,1346,7,10027,557,0,2,21,0,31990,13083,2429,19031,1
73,3542,1523,757,1297,19,12,193,1542,12,193,117,230,205,347,1508,2664,7,19053,1058,0,2,35,0,32000,13085,2429,19032,1
72,2027,1523,757,1297,19,12,193,1542,12,193,117,230,205,347,1508,2664,7,19053,1058,0,2,21,0,32010,13087,2429,19033,0
72,2027,701,378,504,33,58,109,734,13,110,68,126,123,194,794,1346,7,10027,557,0,2,21,0,32010,13088,2430,19034,0
73,3542,1523,757,1297,19,12,193,1542,12,193,117,230,205,347,1508,2664,7,19053,1058,0,2,35,0,32020,13090,2430,19035,0
60,1251,996,429,845,24,10,117,1020,7,76,50,88,83,138,494,879,4,3565,198,0,2,3,1,32060,13108,2434,19064,0
60,1251,456,277,329,12,42,72,468,13,85,50,97,98,147,592,972,7,7212,400,0,2,3,1,32060,13108,2434,19065,0
304,6210,1457,730,1242,11,6,188,1468,10,292,166,329,302,495,2424,4078,5,22973,1276,1,2,7,2,32060,13110,2434,19066,0
304,6210,74,35,59,1,0,14,75,3,14,7,14,17,21,58,85,1,128,7,0,2,7,2,32060,13111,2434,19067,0
304,6210,245,125,200,5,7,34,250,7,30,17,34,37,51,166,265,3,1053,58,0,2,7,2,32070,13112,2434,19068,0
46,532,647,139,84,35,284,233,682,0,0,0,0,0,0,0,0,0,0,0,0,2,7,10,32070,13112,2434,19069,0
71,2068,1523,757,1297,19,12,193,1542,12,193,117,230,205,347,1508,2664,7,19053,1058,0,2,14,3,32080,13114,2434,19070,0
71,2068,701,378,504,33,58,109,734,13,110,68,126,123,194,794,1346,7,10027,557,0,2,14,3,32080,13115,2435,19071,0
173,4001,77,34,69,0,0,8,77,3,24,16,29,27,45,114,213,1,387,21,0,2,2,1,32080,13115,2435,19072,0
173,4001,712,438,573,51,9,84,763,14,102,71,128,116,199,733,1364,8,11988,666,0,2,2,1,32090,13116,2435,19073,0
544,11567,72,33,56,0,4,12,72,1,1,1,1,2,2,0,2,0,1,0,0,2,2,2,32090,13116,2435,19074,0
544,11567,1454,835,1044,76,110,219,1530,17,275,158,296,292,454,2297,3718,9,34017,1889,1,2,2,2,32100,13117,2435,19075,0
117,2546,1043,504,840,53,9,147,1096,9,180,112,198,189,310,1377,2344,4,11604,644,0,2,4,1,32100,13119,2435,19076,0
117,2546,383,288,292,26,6,62,409,11,65,38,67,76,105,429,656,5,3719,206,0,2,4,1,32100,13120,2435,19077,0
70,2905,1289,550,1043,56,32,155,1345,10,167,93,185,177,278,1266,2075,5,11498,638,0,2,14,0,32100,13122,2436,19078,0
36,1082,182,127,129,0,0,53,182,5,39,21,42,44,63,217,343,2,926,51,0,2,11,0,32100,13122,2437,19079,0
84,3883,1338,495,1086,10,64,173,1348,11,122,82,157,133,239,883,1686,7,11934,663,0,2,17,0,32100,13124,2437,19080,0
82,4441,1782,648,1425,9,47,279,1791,8,171,97,189,179,286,1292,2140,4,9462,525,0,2,5,0,32100,13125,2438,19081,0
75,3651,1523,757,1297,19,12,193,1542,12,193,117,230,205,347,1508,2664,7,19053,1058,0,2,36,5,32110,13127,2438,19082,0
64,2629,1020,354,843,12,15,144,1032,8,134,77,144,142,221,970,1580,4,6792,377,0,2,16,0,32110,13127,2438,19083,0
35,1824,384,251,317,7,8,52,391,11,70,44,84,81,128,467,811,6,5355,297,0,2,6,2,32110,13127,2438,19084,0
62,2505,1043,504,840,53,9,147,1096,9,180,112,198,189,310,1377,2344,4,11604,644,0,2,22,0,32110,13129,2438,19085,0
60,1251,996,429,845,24,10,117,1020,7,76,50,88,83,138,494,879,4,3565,198,0,2,3,1,32120,13135,2439,19093,0
60,1251,456,277,329,12,42,72,468,13,85,50,97,98,147,592,972,7,7212,400,0,2,3,1,32120,13135,2439,19094,0
304,6210,1457,730,1242,11,6,188,1468,10,292,166,329,302,495,2424,4078,5,22973,1276,1,2,7,2,32120,13137,2439,19095,0
304,6210,74,35,59,1,0,14,75,3,14,7,14,17,21,58,85,1,128,7,0,2,7,2,32120,13138,2439,19096,0
304,6210,245,125,200,5,7,34,250,7,30,17,34,37,51,166,265,3,1053,58,0,2,7,2,32130,13139,2439,19097,0
46,532,647,139,84,35,284,233,682,0,0,0,0,0,0,0,0,0,0,0,0,2,7,10,32130,13139,2439,19098,0
71,2068,1523,757,1297,19,12,193,1542,12,193,117,230,205,347,1508,2664,7,19053,1058,0,2,14,3,32140,13141,2439,19099,0
71,2068,701,378,504,33,58,109,734,13,110,68,126,123,194,794,1346,7,10027,557,0,2,14,3,32140,13142,2440,19100,0
173,4001,77,34,69,0,0,8,77,3,24,16,29,27,45,114,213,1,387,21,0,2,2,1,32140,13142,2440,19101,0
173,4001,712,438,573,51,9,84,763,14,102,71,128,116,199,733,1364,8,11988,666,0,2,2,1,32150,13143,2440,19102,0
544,11567,72,33,56,0,4,12,72,1,1,1,1,2,2,0,2,0,1,0,0,2,2,2,32150,13143,2440,19103,0
544,11567,1454,835,1044,76,110,219,1530,17,275,158,296,292,454,2297,3718,9,34017,1889,1,2,2,2,32160,13144,2440,19104,0
117,2546,1043,504,840,53,9,147,1096,9,180,112,198,189,310,1377,2344,4,11604,644,0,2,4,1,32160,13146,2440,19105,0
117,2546,383,288,292,26,6,62,409,11,65,38,67,76,105,429,656,5,3719,206,0,2,4,1,32160,13147,2440,19106,0
70,2905,1289,550,1043,56,32,155,1345,10,167,93,185,177,278,1266,2075,5,11498,638,0,2,14,0,32160,13149,2441,19107,0
36,1082,182,127,129,0,0,53,182,5,39,21,42,44,63,217,343,2,926,51,0,2,11,0,32160,13149,2442,19108,0
84,3883,1338,495,1086,10,64,173,1348,11,122,82,157,133,239,883,1686,7,11934,663,0,2,17,0,32160,13151,2442,19109,0
82,4441,1782,648,1425,9,47,279,1791,8,171,97,189,179,286,1292,2140,4,9462,525,0,2,5,0,32160,13152,2443,19110,0
75,3651,1523,757,1297,19,12,193,1542,12,193,117,230,205,347,1508,2664,7,19053,1058,0,2,36,5,32170,13154,2443,19111,0
64,2629,1020,354,843,12,15,144,1032,8,134,77,144,142,221,970,1580,4,6792,377,0,2,16,0,32170,13154,2443,19112,0
35,1824,384,251,317,7,8,52,391,11,70,44,84,81,128,467,811,6,5355,297,0,2,6,2,32170,13154,2443,19113,0
62,2505,1043,504,840,53,9,147,1096,9,180,112,198,189,310,1377,2344,4,11604,644,0,2,22,0,32170,13156,2443,19114,0
515,11032,72,33,56,0,4,12,72,1,1,1,1,2,2,0,2,0,1,0,0,2,10,8,32170,13156,2443,19115,1
515,11032,1454,835,1044,76,110,219,1530,17,275,158,296,292,454,2297,3718,9,34017,1889,1,2,10,8,32180,13157,2443,19116,1
83,4493,1782,648,1425,9,47,279,1791,8,171,97,189,179,286,1292,2140,4,9462,525,0,2,7,0,32180,13158,2444,19117,1
84,4536,1782,648,1425,9,47,279,1791,8,171,97,189,179,286,1292,2140,4,9462,525,0,2,18,0,32180,13159,2445,19118,1
86,4628,1782,648,1425,9,47,279,1791,8,171,97,189,179,286,1292,2140,4,9462,525,0,2,25,1,32180,13160,2446,19119,0
209,4494,182,127,129,0,0,53,182,5,39,21,42,44,63,217,343,2,926,51,0,2,59,9,32180,13160,2447,19120,1
209,4494,1165,710,800,67,119,181,1232,18,243,153,282,261,435,2000,3492,10,36473,2026,1,2,59,9,32190,13160,2448,19121,1
117,2533,1043,504,840,53,9,147,1096,9,180,112,198,189,310,1377,2344,4,11604,644,0,2,3,0,32190,13162,2448,19122,1
117,2533,383,288,292,26,6,62,409,11,65,38,67,76,105,429,656,5,3719,206,0,2,3,0,32190,13163,2448,19123,1
128,5981,1392,870,1177,35,17,170,1427,14,494,280,531,508,811,4473,7289,7,54850,3047,2,2,88,2,32190,13166,2449,19124,1
60,1251,996,429,845,24,10,117,1020,7,76,50,88,83,138,494,879,4,3565,198,0,2,3,1,32200,13172,2450,19132,0
60,1251,456,277,329,12,42,72,468,13,85,50,97,98,147,592,972,7,7212,400,0,2,3,1,32200,13172,2450,19133,0
304,6210,1457,730,1242,11,6,188,1468,10,292,166,329,302,495,2424,4078,5,22973,1276,1,2,7,2,32200,13174,2450,19134,0
304,6210,74,35,59,1,0,14,75,3,14,7,14,17,21,58,85,1,128,7,0,2,7,2,32200,13175,2450,19135,0
304,6210,245,125,200,5,7,34,250,7,30,17,34,37,51,166,265,3,1053,58,0,2,7,2,32210,13176,2450,19136,0
46,532,647,139,84,35,284,233,682,0,0,0,0,0,0,0,0,0,0,0,0,2,1,1,32210,13176,2450,19137,0
173,4001,77,34,69,0,0,8,77,3,24,16,29,27,45,114,213,1,387,21,0,2,2,1,32210,13176,2450,19138,0
173,4001,712,438,573,51,9,84,763,14,102,71,128,116,199,733,1364,8,11988,666,0,2,2,1,32220,13177,2450,19139,0
514,11007,72,33,56,0,4,12,72,1,1,1,1,2,2,0,2,0,1,0,0,2,2,2,32220,13177,2450,19140,0
514,11007,1454,835,1044,76,110,219,1530,17,275,158,296,292,454,2297,3718,9,34017,1889,1,2,2,2,32230,13178,2450,19141,0
118,2555,1043,504,840,53,9,147,1096,9,180,112,198,189,310,1377,2344,4,11604,644,0,2,4,1,32230,13180,2450,19142,0
118,2555,383,288,292,26,6,62,409,11,65,38,67,76,105,429,656,5,3719,206,0,2,4,1,32230,13181,2450,19143,0
70,2905,1289,550,1043,56,32,155,1345,10,167,93,185,177,278,1266,2075,5,11498,638,0,2,14,0,32230,13183,2451,19144,0
36,1082,182,127,129,0,0,53,182,5,39,21,42,44,63,217,343,2,926,51,0,2,11,0,32230,13183,2452,19145,0
84,3883,1338,495,1086,10,64,173,1348,11,122,82,157,133,239,883,1686,7,11934,663,0,2,17,0,32230,13185,2452,19146,0
82,4441,1782,648,1425,9,47,279,1791,8,171,97,189,179,286,1292,2140,4,9462,525,0,2,5,0,32230,13186,2453,19147,0
64,2629,1020,354,843,12,15,144,1032,8,134,77,144,142,221,970,1580,4,6792,377,0,2,16,0,32230,13186,2453,19148,0
35,1824,384,251,317,7,8,52,391,11,70,44,84,81,128,467,811,6,5355,297,0,2,6,2,32230,13186,2453,19149,0
62,2505,1043,504,840,53,9,147,1096,9,180,112,198,189,310,1377,2344,4,11604,644,0,2,22,0,32230,13188,2453,19150,0
515,11032,72,33,56,0,4,12,72,1,1,1,1,2,2,0,2,0,1,0,0,2,2,1,32230,13188,2453,19151,0
515,11032,1454,835,1044,76,110,219,1530,17,275,158,296,292,454,2297,3718,9,34017,1889,1,2,2,1,32240,13189,2453,19152,0
56,1502,1455,414,1257,16,76,112,1471,5,41,23,46,46,69,231,381,2,1069,59,0,2,13,0,32250,13194,2454,19160,0
56,1502,669,365,481,22,61,110,691,15,103,63,122,118,185,747,1273,8,11311,628,0,2,13,0,32260,13194,2455,19161,0
71,2068,1523,757,1297,19,12,193,1542,12,193,117,230,205,347,1508,2664,7,19053,1058,0,2,21,0,32270,13196,2455,19162,0
71,2068,701,378,504,33,58,109,734,13,110,68,126,123,194,794,1346,7,10027,557,0,2,21,0,32270,13197,2456,19163,0
545,11592,72,33,56,0,4,12,72,1,1,1,1,2,2,0,2,0,1,0,0,2,269,6,32270,13197,2456,19164,0
545,11592,1454,835,1044,76,110,219,1530,17,275,158,296,292,454,2297,3718,9,34017,1889,1,2,269,6,32280,13198,2456,19165,0
43,2308,520,294,400,33,13,81,553,10,261,204,367,271,571,2128,4614,7,32445,1802,1,0,286,0,32280,13199,2456,19166,0
141,6212,139,89,101,2,0,35,141,7,54,34,62,61,96,330,569,4,2287,127,0,2,11,0,32280,13199,2456,19167,0
141,6212,7,5,5,0,0,2,7,1,2,1,2,3,3,2,4,0,2,0,0,2,11,0,32280,13199,2456,19168,0
53,2376,1455,414,1257,16,76,112,1471,5,41,23,46,46,69,231,381,2,1069,59,0,2,50,0,32280,13200,2456,19169,0
75,3651,1523,757,1297,19,12,193,1542,12,193,117,230,205,347,1508,2664,7,19053,1058,0,2,35,0,32290,13202,2456,19170,0
545,11592,72,33,56,0,4,12,72,1,1,1,1,2,2,0,2,0,1,0,0,2,12,9,32290,13202,2456,19171,0
545,11592,1454,835,1044,76,110,219,1530,17,275,158,296,292,454,2297,3718,9,34017,1889,1,2,12,9,32300,13203,2456,19172,0
86,4628,1782,648,1425,9,47,279,1791,8,171,97,189,179,286,1292,2140,4,9462,525,0,2,49,0,32300,13204,2457,19173,0
545,11597,72,33,56,0,4,12,72,1,1,1,1,2,2,0,2,0,1,0,0,2,46,34,32300,13204,2457,19174,1
545,11597,1454,835,1044,76,110,219,1530,17,275,158,296,292,454,2297,3718,9,34017,1889,1,2,46,34,32310,13205,2457,19175,1
99,1883,1178,367,1042,6,15,115,1184,9,94,51,95,103,146,644,976,4,4439,246,0,2,5,0,32310,13205,2457,19176,1
99,1883,177,108,140,8,0,27,185,6,30,16,32,36,48,162,248,3,794,44,0,2,5,0,32310,13207,2457,19177,1
65,2786,1178,367,1042,6,15,115,1184,9,94,51,95,103,146,644,976,4,4439,246,0,2,13,0,32310,13207,2457,19178,1
99,1883,1178,367,1042,6,15,115,1184,9,94,51,95,103,146,644,976,4,4439,246,0,2,7,7,32310,13207,2457,19179,1
99,1883,177,108,140,8,0,27,185,6,30,16,32,36,48,162,248,3,794,44,0,2,7,7,32310,13209,2457,19180,1
65,2786,1178,367,1042,6,15,115,1184,9,94,51,95,103,146,644,976,4,4439,246,0,2,1,1,32310,13209,2457,19181,1
99,1883,1178,367,1042,6,15,115,1184,9,94,51,95,103,146,644,976,4,4439,246,0,2,12,7,32310,13209,2457,19182,0
99,1883,177,108,140,8,0,27,185,6,30,16,32,36,48,162,248,3,794,44,0,2,12,7,32310,13211,2457,19183,0
65,2786,1178,367,1042,6,15,115,1184,9,94,51,95,103,146,644,976,4,4439,246,0,2,14,1,32310,13211,2457,19184,0
60,1251,996,429,845,24,10,117,1020,7,76,50,88,83,138,494,879,4,3565,198,0,2,3,1,32320,13217,2458,19192,1
60,1251,456,277,329,12,42,72,468,13,85,50,97,98,147,592,972,7,7212,400,0,2,3,1,32320,13217,2458,19193,1
304,6210,1457,730,1242,11,6,188,1468,10,292,166,329,302,495,2424,4078,5,22973,1276,1,2,7,2,32320,13219,2458,19194,1
304,6210,74,35,59,1,0,14,75,3,14,7,14,17,21,58,85,1,128,7,0,2,7,2,32320,13220,2458,19195,1
304,6210,245,125,200,5,7,34,250,7,30,17,34,37,51,166,265,3,1053,58,0,2,7,2,32330,13221,2458,19196,1
46,532,647,139,84,35,284,233,682,0,0,0,0,0,0,0,0,0,0,0,0,2,7,10,32330,13221,2458,19197,1
71,2068,1523,757,1297,19,12,193,1542,12,193,117,230,205,347,1508,2664,7,19053,1058,0,2,14,3,32340,13223,2458,19198,1
71,2068,701,378,504,33,58,109,734,13,110,68,126,123,194,794,1346,7,10027,557,0,2,14,3,32340,13224,2459,19199,1
173,4001,77,34,69,0,0,8,77,3,24,16,29,27,45,114,213,1,387,21,0,2,2,1,32340,13224,2459,19200,1
173,4001,712,438,573,51,9,84,763,14,102,71,128,116,199,733,1364,8,11988,666,0,2,2,1,32350,13225,2459,19201,1
545,11614,72,33,56,0,4,12,72,1,1,1,1,2,2,0,2,0,1,0,0,2,16,16,32350,13225,2459,19202,1
545,11614,1454,835,1044,76,110,219,1530,17,275,158,296,292,454,2297,3718,9,34017,1889,1,2,16,16,32360,13226,2459,19203,1
117,2546,1043,504,840,53,9,147,1096,9,180,112,198,189,310,1377,2344,4,11604,644,0,2,4,1,32360,13228,2459,19204,1
117,2546,383,288,292,26,6,62,409,11,65,38,67,76,105,429,656,5,3719,206,0,2,4,1,32360,13229,2459,19205,1
70,2905,1289,550,1043,56,32,155,1345,10,167,93,185,177,278,1266,2075,5,11498,638,0,2,14,0,32360,13231,2460,19206,1
36,1082,182,127,129,0,0,53,182,5,39,21,42,44,63,217,343,2,926,51,0,2,11,0,32360,13231,2461,19207,1
84,3883,1338,495,1086,10,64,173,1348,11,122,82,157,133,239,883,1686,7,11934,663,0,2,17,0,32360,13233,2461,19208,1
86,4628,1782,648,1425,9,47,279,1791,8,171,97,189,179,286,1292,2140,4,9462,525,0,2,54,0,32360,13234,2462,19209,1
75,3651,1523,757,1297,19,12,193,1542,12,193,117,230,205,347,1508,2664,7,19053,1058,0,2,36,5,32370,13236,2462,19210,1
64,2629,1020,354,843,12,15,144,1032,8,134,77,144,142,221,970,1580,4,6792,377,0,2,16,0,32370,13236,2462,19211,1
35,1824,384,251,317,7,8,52,391,11,70,44,84,81,128,467,811,6,5355,297,0,2,6,2,32370,13236,2462,19212,1
62,2505,1043,504,840,53,9,147,1096,9,180,112,198,189,310,1377,2344,4,11604,644,0,2,22,0,32370,13238,2462,19213,1
548,11627,72,33,56,0,4,12,72,1,1,1,1,2,2,0,2,0,1,0,0,2,9,3,32370,13238,2462,19214,1
548,11627,1454,835,1044,76,110,219,1530,17,275,158,296,292,454,2297,3718,9,34017,1889,1,2,9,3,32380,13239,2462,19215,1
86,4636,1782,648,1425,9,47,279,1791,8,171,97,189,179,286,1292,2140,4,9462,525,0,2,8,9,32380,13240,2463,19216,1
548,11638,72,33,56,0,4,12,72,1,1,1,1,2,2,0,2,0,1,0,0,2,2,2,32380,13240,2463,19217,0
548,11638,1454,835,1044,76,110,219,1530,17,275,158,296,292,454,2297,3718,9,34017,1889,1,2,2,2,32390,13241,2463,19218,0
548,11638,72,33,56,0,4,12,72,1,1,1,1,2,2,0,2,0,1,0,0,2,9,3,32390,13241,2463,19219,0
548,11638,1454,835,1044,76,110,219,1530,17,275,158,296,292,454,2297,3718,9,34017,1889,1,2,9,3,32400,13242,2463,19220,0
86,4636,1782,648,1425,9,47,279,1791,8,171,97,189,179,286,1292,2140,4,9462,525,0,2,8,9,32400,13243,2464,19221,0
118,2555,1043,504,840,53,9,147,1096,9,180,112,198,189,310,1377,2344,4,11604,644,0,2,1,0,32400,13245,2464,19222,0
118,2555,383,288,292,26,6,62,409,11,65,38,67,76,105,429,656,5,3719,206,0,2,1,0,32400,13246,2464,19223,0
17,386,85,59,61,8,0,16,93,5,18,10,18,23,28,86,126,2,316,17,0,2,40,30,32400,13246,2464,19224,0
17,386,85,59,61,8,0,16,93,5,18,10,18,23,28,86,126,2,316,17,0,2,40,30,32400,13246,2464,19225,0
545,11616,72,33,56,0,4,12,72,1,1,1,1,2,2,0,2,0,1,0,0,2,2,2,32400,13246,2464,19226,1
545,11616,1454,835,1044,76,110,219,1530,17,275,158,296,292,454,2297,3718,9,34017,1889,1,2,2,2,32410,13247,2464,19227,1
86,4619,1782,648,1425,9,47,279,1791,8,171,97,189,179,286,1292,2140,4,9462,525,0,2,8,9,32410,13248,2465,19228,1
68,1241,1020,354,843,12,15,144,1032,8,134,77,144,142,221,970,1580,4,6792,377,0,2,1,1,32410,13248,2465,19229,1
71,2935,1289,550,1043,56,32,155,1345,10,167,93,185,177,278,1266,2075,5,11498,638,0,2,5,0,32410,13250,2466,19230,1
68,1241,1020,354,843,12,15,144,1032,8,134,77,144,142,221,970,1580,4,6792,377,0,2,1,1,32410,13250,2466,19231,0
71,2935,1289,550,1043,56,32,155,1345,10,167,93,185,177,278,1266,2075,5,11498,638,0,2,5,0,32410,13252,2467,19232,0
75,3651,1523,757,1297,19,12,193,1542,12,193,117,230,205,347,1508,2664,7,19053,1058,0,2,1,1,32420,13254,2467,19233,0
545,11616,72,33,56,0,4,12,72,1,1,1,1,2,2,0,2,0,1,0,0,2,1,1,32420,13254,2467,19234,1
545,11616,1454,835,1044,76,110,219,1530,17,275,158,296,292,454,2297,3718,9,34017,1889,1,2,1,1,32430,13255,2467,19235,1
88,4705,1782,648,1425,9,47,279,1791,8,171,97,189,179,286,1292,2140,4,9462,525,0,2,17,0,32430,13256,2468,19236,1
75,3651,1523,757,1297,19,12,193,1542,12,193,117,230,205,347,1508,2664,7,19053,1058,0,2,1,1,32440,13258,2468,19237,1
548,11662,72,33,56,0,4,12,72,1,1,1,1,2,2,0,2,0,1,0,0,2,9,3,32440,13258,2468,19238,1
548,11662,1454,835,1044,76,110,219,1530,17,275,158,296,292,454,2297,3718,9,34017,1889,1,2,9,3,32450,13259,2468,19239,1
88,4713,1782,648,1425,9,47,279,1791,8,171,97,189,179,286,1292,2140,4,9462,525,0,2,8,9,32450,13260,2469,19240,1
201,4242,182,127,129,0,0,53,182,5,39,21,42,44,63,217,343,2,926,51,0,2,14,0,32450,13260,2470,19241,1
201,4242,1165,710,800,67,119,181,1232,18,243,153,282,261,435,2000,3492,10,36473,2026,1,2,14,0,32460,13260,2471,19242,1
120,5315,1392,870,1177,35,17,170,1427,14,494,280,531,508,811,4473,7289,7,54850,3047,2,2,19,0,32460,13263,2472,19243,1
201,4242,182,127,129,0,0,53,182,5,39,21,42,44,63,217,343,2,926,51,0,2,14,0,32460,13263,2473,19244,0
201,4242,1165,710,800,67,119,181,1232,18,243,153,282,261,435,2000,3492,10,36473,2026,1,2,14,0,32470,13263,2474,19245,0
120,5315,1392,870,1177,35,17,170,1427,14,494,280,531,508,811,4473,7289,7,54850,3047,2,2,19,0,32470,13266,2475,19246,0
548,11662,72,33,56,0,4,12,72,1,1,1,1,2,2,0,2,0,1,0,0,2,42,33,32470,13266,2475,19247,0
548,11662,1454,835,1044,76,110,219,1530,17,275,158,296,292,454,2297,3718,9,34017,1889,1,2,42,33,32480,13267,2475,19248,0
88,4713,1782,648,1425,9,47,279,1791,8,171,97,189,179,286,1292,2140,4,9462,525,0,2,25,9,32480,13268,2476,19249,0
75,3651,1523,757,1297,19,12,193,1542,12,193,117,230,205,347,1508,2664,7,19053,1058,0,2,2,2,32490,13270,2476,19250,0
211,4539,182,127,129,0,0,53,182,5,39,21,42,44,63,217,343,2,926,51,0,2,59,9,32490,13270,2477,19251,0
211,4539,1165,710,800,67,119,181,1232,18,243,153,282,261,435,2000,3492,10,36473,2026,1,2,59,9,32500,13270,2478,19252,0
118,2555,1043,504,840,53,9,147,1096,9,180,112,198,189,310,1377,2344,4,11604,644,0,2,4,0,32500,13272,2478,19253,0
118,2555,383,288,292,26,6,62,409,11,65,38,67,76,105,429,656,5,3719,206,0,2,4,0,32500,13273,2478,19254,0
130,6042,1392,870,1177,35,17,170,1427,14,494,280,531,508,811,4473,7289,7,54850,3047,2,2,88,2,32500,13276,2479,19255,0
202,4248,182,127,129,0,0,53,182,5,39,21,42,44,63,217,343,2,926,51,0,2,13,3,32500,13276,2480,19256,1
202,4248,1165,710,800,67,119,181,1232,18,243,153,282,261,435,2000,3492,10,36473,2026,1,2,13,3,32510,13276,2481,19257,1
121,5350,1392,870,1177,35,17,170,1427,14,494,280,531,508,811,4473,7289,7,54850,3047,2,2,17,1,32510,13279,2482,19258,1
202,4248,182,127,129,0,0,53,182,5,39,21,42,44,63,217,343,2,926,51,0,2,13,3,32510,13279,2483,19259,0
202,4248,1165,710,800,67,119,181,1232,18,243,153,282,261,435,2000,3492,10,36473,2026,1,2,13,3,32520,13279,2484,19260,0
121,5350,1392,870,1177,35,17,170,1427,14,494,280,531,508,811,4473,7289,7,54850,3047,2,2,17,1,32520,13282,2485,19261,0
305,6231,1457,730,1242,11,6,188,1468,10,292,166,329,302,495,2424,4078,5,22973,1276,1,2,4,1,32520,13284,2485,19262,0
305,6231,74,35,59,1,0,14,75,3,14,7,14,17,21,58,85,1,128,7,0,2,4,1,32520,13285,2485,19263,0
305,6231,245,125,200,5,7,34,250,7,30,17,34,37,51,166,265,3,1053,58,0,2,4,1,32530,13286,2485,19264,0
101,1905,1178,367,1042,6,15,115,1184,9,94,51,95,103,146,644,976,4,4439,246,0,2,3,1,32530,13286,2485,19265,1
101,1905,177,108,140,8,0,27,185,6,30,16,32,36,48,162,248,3,794,44,0,2,3,1,32530,13288,2485,19266,1
66,2845,1178,367,1042,6,15,115,1184,9,94,51,95,103,146,644,976,4,4439,246,0,2,13,0,32530,13288,2485,19267,1
304,6218,1457,730,1242,11,6,188,1468,10,292,166,329,302,495,2424,4078,5,22973,1276,1,2,1,4,32530,13290,2485,19268,1
304,6218,74,35,59,1,0,14,75,3,14,7,14,17,21,58,85,1,128,7,0,2,1,4,32530,13291,2485,19269,1
304,6218,245,125,200,5,7,34,250,7,30,17,34,37,51,166,265,3,1053,58,0,2,1,4,32540,13292,2485,19270,1
58,2960,1457,730,1242,11,6,188,1468,10,292,166,329,302,495,2424,4078,5,22973,1276,1,2,11,1,32540,13294,2485,19271,1
202,4248,182,127,129,0,0,53,182,5,39,21,42,44,63,217,343,2,926,51,0,2,3,3,32540,13294,2486,19272,0
202,4248,1165,710,800,67,119,181,1232,18,243,153,282,261,435,2000,3492,10,36473,2026,1,2,3,3,32550,13294,2487,19273,0
202,4248,182,127,129,0,0,53,182,5,39,21,42,44,63,217,343,2,926,51,0,2,3,3,32550,13294,2488,19274,0
202,4248,1165,710,800,67,119,181,1232,18,243,153,282,261,435,2000,3492,10,36473,2026,1,2,3,3,32560,13294,2489,19275,0
217,4674,182,127,129,0,0,53,182,5,39,21,42,44,63,217,343,2,926,51,0,2,28,9,32560,13294,2490,19276,0
217,4674,1165,710,800,67,119,181,1232,18,243,153,282,261,435,2000,3492,10,36473,2026,1,2,28,9,32570,13294,2491,19277,0
135,6195,1392,870,1177,35,17,170,1427,14,494,280,531,508,811,4473,7289,7,54850,3047,2,2,34,1,32570,13297,2492,19278,0
135,6195,1392,870,1177,35,17,170,1427,14,494,280,531,508,811,4473,7289,7,54850,3047,2,2,2,2,32570,13300,2493,19279,0
212,4592,182,127,129,0,0,53,182,5,39,21,42,44,63,217,343,2,926,51,0,2,13,22,32570,13300,2494,19280,1
212,4592,1165,710,800,67,119,181,1232,18,243,153,282,261,435,2000,3492,10,36473,2026,1,2,13,22,32580,13300,2495,19281,1
135,6209,1392,870,1177,35,17,170,1427,14,494,280,531,508,811,4473,7289,7,54850,3047,2,2,6,5,32580,13303,2496,19282,1
212,4596,182,127,129,0,0,53,182,5,39,21,42,44,63,217,343,2,926,51,0,2,1,1,32580,13303,2497,19283,1
212,4596,1165,710,800,67,119,181,1232,18,243,153,282,261,435,2000,3492,10,36473,2026,1,2,1,1,32590,13303,2498,19284,1
212,4596,182,127,129,0,0,53,182,5,39,21,42,44,63,217,343,2,926,51,0,2,19,9,32590,13303,2499,19285,0
212,4596,1165,710,800,67,119,181,1232,18,243,153,282,261,435,2000,3492,10,36473,2026,1,2,19,9,32600,13303,2500,19286,0
135,6209,1392,870,1177,35,17,170,1427,14,494,280,531,508,811,4473,7289,7,54850,3047,2,2,35,1,32600,13306,2501,19287,0
304,6218,1457,730,1242,11,6,188,1468,10,292,166,329,302,495,2424,4078,5,22973,1276,1,2,1,1,32600,13308,2501,19288,0
304,6218,74,35,59,1,0,14,75,3,14,7,14,17,21,58,85,1,128,7,0,2,1,1,32600,13309,2501,19289,0
304,6218,245,125,200,5,7,34,250,7,30,17,34,37,51,166,265,3,1053,58,0,2,1,1,32610,13310,2501,19290,0
58,2960,1457,730,1242,11,6,188,1468,10,292,166,329,302,495,2424,4078,5,22973,1276,1,2,11,1,32610,13312,2501,19291,0
550,11695,72,33,56,0,4,12,72,1,1,1,1,2,2,0,2,0,1,0,0,2,8,0,32610,13312,2501,19292,1
550,11695,1454,835,1044,76,110,219,1530,17,275,158,296,292,454,2297,3718,9,34017,1889,1,2,8,0,32620,13313,2501,19293,1
70,2907,1289,550,1043,56,32,155,1345,10,167,93,185,177,278,1266,2075,5,11498,638,0,2,2,1,32620,13315,2502,19294,1
85,3922,1338,495,1086,10,64,173,1348,11,122,82,157,133,239,883,1686,7,11934,663,0,2,15,3,32620,13317,2502,19295,1
53,2991,1296,573,1062,40,33,157,1336,8,201,118,231,209,349,1561,2689,4,12365,686,0,2,2,1,32620,13317,2502,19296,1
24,966,373,158,315,8,0,51,381,5,76,44,79,81,123,486,779,2,2026,112,0,2,1,1,32620,13317,2502,19297,1
72,3652,1943,715,1694,26,18,214,1969,12,185,120,237,197,357,1436,2721,7,20915,1161,0,2,3,3,32620,13319,2502,19298,1
47,546,647,139,84,35,284,233,682,0,0,0,0,0,0,0,0,0,0,0,0,2,6,0,32620,13319,2502,19299,1
551,11706,72,33,56,0,4,12,72,1,1,1,1,2,2,0,2,0,1,0,0,2,14,6,32620,13319,2502,19300,1
551,11706,1454,835,1044,76,110,219,1530,17,275,158,296,292,454,2297,3718,9,34017,1889,1,2,14,6,32630,13320,2502,19301,1
551,11710,72,33,56,0,4,12,72,1,1,1,1,2,2,0,2,0,1,0,0,2,2,2,32630,13320,2502,19302,1
551,11710,1454,835,1044,76,110,219,1530,17,275,158,296,292,454,2297,3718,9,34017,1889,1,2,2,2,32640,13321,2502,19303,1
89,4754,1782,648,1425,9,47,279,1791,8,171,97,189,179,286,1292,2140,4,9462,525,0,2,18,0,32640,13322,2503,19304,1
47,546,647,139,84,35,284,233,682,0,0,0,0,0,0,0,0,0,0,0,0,2,6,6,32640,13322,2503,19305,1
550,11695,72,33,56,0,4,12,72,1,1,1,1,2,2,0,2,0,1,0,0,2,8,0,32640,13322,2503,19306,0
550,11695,1454,835,1044,76,110,219,1530,17,275,158,296,292,454,2297,3718,9,34017,1889,1,2,8,0,32650,13323,2503,19307,0
70,2907,1289,550,1043,56,32,155,1345,10,167,93,185,177,278,1266,2075,5,11498,638,0,2,2,1,32650,13325,2504,19308,0
85,3922,1338,495,1086,10,64,173,1348,11,122,82,157,133,239,883,1686,7,11934,663,0,2,15,3,32650,13327,2504,19309,0
53,2991,1296,573,1062,40,33,157,1336,8,201,118,231,209,349,1561,2689,4,12365,686,0,2,2,1,32650,13327,2504,19310,0
24,966,373,158,315,8,0,51,381,5,76,44,79,81,123,486,779,2,2026,112,0,2,1,1,32650,13327,2504,19311,0
72,3652,1943,715,1694,26,18,214,1969,12,185,120,237,197,357,1436,2721,7,20915,1161,0,2,3,3,32650,13329,2504,19312,0
47,548,647,139,84,35,284,233,682,0,0,0,0,0,0,0,0,0,0,0,0,2,1,1,32650,13329,2504,19313,1
551,11716,72,33,56,0,4,12,72,1,1,1,1,2,2,0,2,0,1,0,0,2,2,2,32650,13329,2504,19314,1
551,11716,1454,835,1044,76,110,219,1530,17,275,158,296,292,454,2297,3718,9,34017,1889,1,2,2,2,32660,13330,2504,19315,1
89,4754,1782,648,1425,9,47,279,1791,8,171,97,189,179,286,1292,2140,4,9462,525,0,2,1,1,32660,13331,2505,19316,1
47,548,647,139,84,35,284,233,682,0,0,0,0,0,0,0,0,0,0,0,0,2,6,0,32660,13331,2505,19317,0
553,11749,72,33,56,0,4,12,72,1,1,1,1,2,2,0,2,0,1,0,0,2,14,6,32660,13331,2505,19318,0
553,11749,1454,835,1044,76,110,219,1530,17,275,158,296,292,454,2297,3718,9,34017,1889,1,2,14,6,32670,13332,2505,19319,0
89,4754,1782,648,1425,9,47,279,1791,8,171,97,189,179,286,1292,2140,4,9462,525,0,2,18,0,32670,13333,2506,19320,0
514,11007,72,33,56,0,4,12,72,1,1,1,1,2,2,0,2,0,1,0,0,2,1,1,32670,13333,2506,19321,0
514,11007,1454,835,1044,76,110,219,1530,17,275,158,296,292,454,2297,3718,9,34017,1889,1,2,1,1,32680,13334,2506,19322,0
514,11007,72,33,56,0,4,12,72,1,1,1,1,2,2,0,2,0,1,0,0,2,1,1,32680,13334,2506,19323,0
514,11007,1454,835,1044,76,110,219,1530,17,275,158,296,292,454,2297,3718,9,34017,1889,1,2,1,1,32690,13335,2506,19324,0
65,2670,1020,354,843,12,15,144,1032,8,134,77,144,142,221,970,1580,4,6792,377,0,2,23,1,32690,13335,2506,19325,0
65,2675,1020,354,843,12,15,144,1032,8,134,77,144,142,221,970,1580,4,6792,377,0,2,1,1,32690,13335,2506,19326,1
67,1993,1523,757,1297,19,12,193,1542,12,193,117,230,205,347,1508,2664,7,19053,1058,0,2,1,1,32700,13337,2506,19327,1
67,1993,701,378,504,33,58,109,734,13,110,68,126,123,194,794,1346,7,10027,557,0,2,1,1,32700,13338,2507,19328,1
73,3480,1523,757,1297,19,12,193,1542,12,193,117,230,205,347,1508,2664,7,19053,1058,0,2,4,4,32710,13340,2507,19329,1
67,1993,1523,757,1297,19,12,193,1542,12,193,117,230,205,347,1508,2664,7,19053,1058,0,2,1,1,32720,13342,2507,19330,0
67,1993,701,378,504,33,58,109,734,13,110,68,126,123,194,794,1346,7,10027,557,0,2,1,1,32720,13343,2508,19331,0
73,3480,1523,757,1297,19,12,193,1542,12,193,117,230,205,347,1508,2664,7,19053,1058,0,2,4,4,32730,13345,2508,19332,0
99,1883,1178,367,1042,6,15,115,1184,9,94,51,95,103,146,644,976,4,4439,246,0,2,12,7,32730,13345,2508,19333,0
99,1883,177,108,140,8,0,27,185,6,30,16,32,36,48,162,248,3,794,44,0,2,12,7,32730,13347,2508,19334,0
17,386,85,59,61,8,0,16,93,5,18,10,18,23,28,86,126,2,316,17,0,2,40,30,32730,13347,2508,19335,0
65,2786,1178,367,1042,6,15,115,1184,9,94,51,95,103,146,644,976,4,4439,246,0,2,14,1,32730,13347,2508,19336,0
215,4647,182,127,129,0,0,53,182,5,39,21,42,44,63,217,343,2,926,51,0,2,13,3,32730,13347,2509,19337,0
215,4647,1165,710,800,67,119,181,1232,18,243,153,282,261,435,2000,3492,10,36473,2026,1,2,13,3,32740,13347,2510,19338,0
68,1241,1020,354,843,12,15,144,1032,8,134,77,144,142,221,970,1580,4,6792,377,0,2,1,1,32740,13347,2510,19339,0
71,2937,1289,550,1043,56,32,155,1345,10,167,93,185,177,278,1266,2075,5,11498,638,0,2,5,0,32740,13349,2511,19340,0
138,6305,1392,870,1177,35,17,170,1427,14,494,280,531,508,811,4473,7289,7,54850,3047,2,2,20,2,32740,13352,2512,19341,0
215,4647,182,127,129,0,0,53,182,5,39,21,42,44,63,217,343,2,926,51,0,2,3,3,32740,13352,2513,19342,0
215,4647,1165,710,800,67,119,181,1232,18,243,153,282,261,435,2000,3492,10,36473,2026,1,2,3,3,32750,13352,2514,19343,0
304,6218,1457,730,1242,11,6,188,1468,10,292,166,329,302,495,2424,4078,5,22973,1276,1,2,1,1,32750,13354,2514,19344,0
304,6218,74,35,59,1,0,14,75,3,14,7,14,17,21,58,85,1,128,7,0,2,1,1,32750,13355,2514,19345,0
304,6218,245,125,200,5,7,34,250,7,30,17,34,37,51,166,265,3,1053,58,0,2,1,1,32760,13356,2514,19346,0
71,2075,1523,757,1297,19,12,193,1542,12,193,117,230,205,347,1508,2664,7,19053,1058,0,2,1,1,32770,13358,2514,19347,0
71,2075,701,378,504,33,58,109,734,13,110,68,126,123,194,794,1346,7,10027,557,0,2,1,1,32770,13359,2515,19348,0
553,11749,72,33,56,0,4,12,72,1,1,1,1,2,2,0,2,0,1,0,0,2,1,1,32770,13359,2515,19349,0
553,11749,1454,835,1044,76,110,219,1530,17,275,158,296,292,454,2297,3718,9,34017,1889,1,2,1,1,32780,13360,2515,19350,0
58,2960,1457,730,1242,11,6,188,1468,10,292,166,329,302,495,2424,4078,5,22973,1276,1,2,11,1,32780,13362,2515,19351,0
75,3651,1523,757,1297,19,12,193,1542,12,193,117,230,205,347,1508,2664,7,19053,1058,0,2,4,4,32790,13364,2515,19352,0
20,619,42,7,35,4,0,5,46,1,2,1,2,3,3,2,4,0,2,0,0,2,1,1,32790,13364,2515,19353,1
20,619,11,6,10,0,0,1,11,2,4,2,4,6,6,10,15,1,15,0,0,2,1,1,32790,13364,2515,19354,1
20,619,42,7,35,4,0,5,46,1,2,1,2,3,3,2,4,0,2,0,0,2,1,1,32790,13364,2515,19355,0
20,619,11,6,10,0,0,1,11,2,4,2,4,6,6,10,15,1,15,0,0,2,1,1,32790,13364,2515,19356,0
65,2675,1020,354,843,12,15,144,1032,8,134,77,144,142,221,970,1580,4,6792,377,0,2,1,1,32790,13364,2515,19357,1
54,1089,1098,241,925,5,10,155,1103,7,46,25,49,53,74,273,423,3,1580,87,0,2,2,0,32800,13366,2515,19358,1
54,1089,282,202,222,14,2,44,296,8,42,24,43,50,67,250,378,4,1548,86,0,2,2,0,32800,13367,2515,19359,1
39,1537,1098,241,925,5,10,155,1103,7,46,25,49,53,74,273,423,3,1580,87,0,2,14,0,32810,13369,2515,19360,1
65,2675,1020,354,843,12,15,144,1032,8,134,77,144,142,221,970,1580,4,6792,377,0,2,23,1,32810,13369,2515,19361,0
54,1089,1098,241,925,5,10,155,1103,7,46,25,49,53,74,273,423,3,1580,87,0,2,2,0,32820,13371,2515,19362,0
54,1089,282,202,222,14,2,44,296,8,42,24,43,50,67,250,378,4,1548,86,0,2,2,0,32820,13372,2515,19363,0
39,1537,1098,241,925,5,10,155,1103,7,46,25,49,53,74,273,423,3,1580,87,0,2,14,0,32830,13374,2515,19364,0
173,4005,77,34,69,0,0,8,77,3,24,16,29,27,45,114,213,1,387,21,0,2,1,1,32830,13374,2515,19365,1
173,4005,712,438,573,51,9,84,763,14,102,71,128,116,199,733,1364,8,11988,666,0,2,1,1,32840,13375,2515,19366,1
53,3004,1296,573,1062,40,33,157,1336,8,201,118,231,209,349,1561,2689,4,12365,686,0,2,2,0,32840,13375,2515,19367,1
20,619,42,7,35,4,0,5,46,1,2,1,2,3,3,2,4,0,2,0,0,2,1,1,32840,13375,2515,19368,0
20,619,11,6,10,0,0,1,11,2,4,2,4,6,6,10,15,1,15,0,0,2,1,1,32840,13375,2515,19369,0
173,4005,77,34,69,0,0,8,77,3,24,16,29,27,45,114,213,1,387,21,0,2,1,1,32840,13375,2515,19370,0
173,4005,712,438,573,51,9,84,763,14,102,71,128,116,199,733,1364,8,11988,666,0,2,1,1,32850,13376,2515,19371,0
53,3007,1296,573,1062,40,33,157,1336,8,201,118,231,209,349,1561,2689,4,12365,686,0,2,2,0,32850,13376,2515,19372,0
304,6218,1457,730,1242,11,6,188,1468,10,292,166,329,302,495,2424,4078,5,22973,1276,1,2,1,1,32850,13378,2515,19373,0
304,6218,74,35,59,1,0,14,75,3,14,7,14,17,21,58,85,1,128,7,0,2,1,1,32850,13379,2515,19374,0
304,6218,245,125,200,5,7,34,250,7,30,17,34,37,51,166,265,3,1053,58,0,2,1,1,32860,13380,2515,19375,0
304,6218,1457,730,1242,11,6,188,1468,10,292,166,329,302,495,2424,4078,5,22973,1276,1,2,1,1,32860,13382,2515,19376,0
304,6218,74,35,59,1,0,14,75,3,14,7,14,17,21,58,85,1,128,7,0,2,1,1,32860,13383,2515,19377,0
304,6218,245,125,200,5,7,34,250,7,30,17,34,37,51,166,265,3,1053,58,0,2,1,1,32870,13384,2515,19378,0
304,6218,1457,730,1242,11,6,188,1468,10,292,166,329,302,495,2424,4078,5,22973,1276,1,2,1,1,32870,13386,2515,19379,0
304,6218,74,35,59,1,0,14,75,3,14,7,14,17,21,58,85,1,128,7,0,2,1,1,32870,13387,2515,19380,0
304,6218,245,125,200,5,7,34,250,7,30,17,34,37,51,166,265,3,1053,58,0,2,1,1,32880,13388,2515,19381,0
215,4647,182,127,129,0,0,53,182,5,39,21,42,44,63,217,343,2,926,51,0,2,16,6,32880,13388,2516,19382,0
215,4647,1165,710,800,67,119,181,1232,18,243,153,282,261,435,2000,3492,10,36473,2026,1,2,16,6,32890,13388,2517,19383,0
304,6218,1457,730,1242,11,6,188,1468,10,292,166,329,302,495,2424,4078,5,22973,1276,1,2,1,1,32890,13390,2517,19384,0
304,6218,74,35,59,1,0,14,75,3,14,7,14,17,21,58,85,1,128,7,0,2,1,1,32890,13391,2517,19385,0
304,6218,245,125,200,5,7,34,250,7,30,17,34,37,51,166,265,3,1053,58,0,2,1,1,32900,13392,2517,19386,0
71,2075,1523,757,1297,19,12,193,1542,12,193,117,230,205,347,1508,2664,7,19053,1058,0,2,1,1,32910,13394,2517,19387,0
71,2075,701,378,504,33,58,109,734,13,110,68,126,123,194,794,1346,7,10027,557,0,2,1,1,32910,13395,2518,19388,0
68,1241,1020,354,843,12,15,144,1032,8,134,77,144,142,221,970,1580,4,6792,377,0,2,1,1,32910,13395,2518,19389,0
553,11749,72,33,56,0,4,12,72,1,1,1,1,2,2,0,2,0,1,0,0,2,1,1,32910,13395,2518,19390,0
553,11749,1454,835,1044,76,110,219,1530,17,275,158,296,292,454,2297,3718,9,34017,1889,1,2,1,1,32920,13396,2518,19391,0
99,1883,1178,367,1042,6,15,115,1184,9,94,51,95,103,146,644,976,4,4439,246,0,2,12,7,32920,13396,2518,19392,0
99,1883,177,108,140,8,0,27,185,6,30,16,32,36,48,162,248,3,794,44,0,2,12,7,32920,13398,2518,19393,0
17,386,85,59,61,8,0,16,93,5,18,10,18,23,28,86,126,2,316,17,0,2,40,30,32920,13398,2518,19394,0
20,619,42,7,35,4,0,5,46,1,2,1,2,3,3,2,4,0,2,0,0,2,1,1,32920,13398,2518,19395,0
20,619,11,6,10,0,0,1,11,2,4,2,4,6,6,10,15,1,15,0,0,2,1,1,32920,13398,2518,19396,0
71,2937,1289,550,1043,56,32,155,1345,10,167,93,185,177,278,1266,2075,5,11498,638,0,2,5,0,32920,13400,2519,19397,0
138,6305,1392,870,1177,35,17,170,1427,14,494,280,531,508,811,4473,7289,7,54850,3047,2,2,20,2,32920,13403,2520,19398,0
58,2960,1457,730,1242,11,6,188,1468,10,292,166,329,302,495,2424,4078,5,22973,1276,1,2,11,1,32920,13405,2520,19399,0
75,3651,1523,757,1297,19,12,193,1542,12,193,117,230,205,347,1508,2664,7,19053,1058,0,2,4,4,32930,13407,2520,19400,0
65,2786,1178,367,1042,6,15,115,1184,9,94,51,95,103,146,644,976,4,4439,246,0,2,14,1,32930,13407,2520,19401,0
514,11040,72,33,56,0,4,12,72,1,1,1,1,2,2,0,2,0,1,0,0,2,7,0,32930,13407,2520,19402,1
514,11040,1454,835,1044,76,110,219,1530,17,275,158,296,292,454,2297,3718,9,34017,1889,1,2,7,0,32940,13408,2520,19403,1
83,4488,1782,648,1425,9,47,279,1791,8,171,97,189,179,286,1292,2140,4,9462,525,0,2,7,0,32940,13409,2521,19404,1
513,11010,72,33,56,0,4,12,72,1,1,1,1,2,2,0,2,0,1,0,0,2,3,12,32940,13409,2521,19405,1
513,11010,1454,835,1044,76,110,219,1530,17,275,158,296,292,454,2297,3718,9,34017,1889,1,2,3,12,32950,13410,2521,19406,1
513,11012,72,33,56,0,4,12,72,1,1,1,1,2,2,0,2,0,1,0,0,2,2,2,32950,13410,2521,19407,1
513,11012,1454,835,1044,76,110,219,1530,17,275,158,296,292,454,2297,3718,9,34017,1889,1,2,2,2,32960,13411,2521,19408,1
513,11012,72,33,56,0,4,12,72,1,1,1,1,2,2,0,2,0,1,0,0,2,9,11,32960,13411,2521,19409,0
513,11012,1454,835,1044,76,110,219,1530,17,275,158,296,292,454,2297,3718,9,34017,1889,1,2,9,11,32970,13412,2521,19410,0
83,4488,1782,648,1425,9,47,279,1791,8,171,97,189,179,286,1292,2140,4,9462,525,0,2,7,0,32970,13413,2522,19411,0
101,1905,1178,367,1042,6,15,115,1184,9,94,51,95,103,146,644,976,4,4439,246,0,2,3,1,32970,13413,2522,19412,0
101,1905,177,108,140,8,0,27,185,6,30,16,32,36,48,162,248,3,794,44,0,2,3,1,32970,13415,2522,19413,0
66,2845,1178,367,1042,6,15,115,1184,9,94,51,95,103,146,644,976,4,4439,246,0,2,13,0,32970,13415,2522,19414,0
101,1905,1178,367,1042,6,15,115,1184,9,94,51,95,103,146,644,976,4,4439,246,0,2,3,1,32970,13415,2522,19415,0
101,1905,177,108,140,8,0,27,185,6,30,16,32,36,48,162,248,3,794,44,0,2,3,1,32970,13417,2522,19416,0
66,2845,1178,367,1042,6,15,115,1184,9,94,51,95,103,146,644,976,4,4439,246,0,2,13,0,32970,13417,2522,19417,0
514,11010,72,33,56,0,4,12,72,1,1,1,1,2,2,0,2,0,1,0,0,2,6,6,32970,13417,2522,19418,1
514,11010,1454,835,1044,76,110,219,1530,17,275,158,296,292,454,2297,3718,9,34017,1889,1,2,6,6,32980,13418,2522,19419,1
141,6224,139,89,101,2,0,35,141,7,54,34,62,61,96,330,569,4,2287,127,0,2,32,0,32980,13418,2522,19420,0
141,6224,7,5,5,0,0,2,7,1,2,1,2,3,3,2,4,0,2,0,0,2,32,0,32980,13418,2522,19421,0
514,11010,72,33,56,0,4,12,72,1,1,1,1,2,2,0,2,0,1,0,0,2,6,6,32980,13418,2522,19422,0
514,11010,1454,835,1044,76,110,219,1530,17,275,158,296,292,454,2297,3718,9,34017,1889,1,2,6,6,32990,13419,2522,19423,0
141,6224,139,89,101,2,0,35,141,7,54,34,62,61,96,330,569,4,2287,127,0,2,32,0,32990,13419,2522,19424,0
141,6224,7,5,5,0,0,2,7,1,2,1,2,3,3,2,4,0,2,0,0,2,32,0,32990,13419,2522,19425,0
553,11752,72,33,56,0,4,12,72,1,1,1,1,2,2,0,2,0,1,0,0,2,15,17,33000,13423,2523,19433,0
553,11752,1454,835,1044,76,110,219,1530,17,275,158,296,292,454,2297,3718,9,34017,1889,1,2,15,17,33010,13424,2523,19434,0
101,1905,1178,367,1042,6,15,115,1184,9,94,51,95,103,146,644,976,4,4439,246,0,2,3,1,33010,13424,2523,19435,0
101,1905,177,108,140,8,0,27,185,6,30,16,32,36,48,162,248,3,794,44,0,2,3,1,33010,13426,2523,19436,0
142,6254,139,89,101,2,0,35,141,7,54,34,62,61,96,330,569,4,2287,127,0,2,32,0,33010,13426,2523,19437,0
142,6254,7,5,5,0,0,2,7,1,2,1,2,3,3,2,4,0,2,0,0,2,32,0,33010,13426,2523,19438,0
90,4801,1782,648,1425,9,47,279,1791,8,171,97,189,179,286,1292,2140,4,9462,525,0,2,7,0,33010,13427,2524,19439,0
66,2845,1178,367,1042,6,15,115,1184,9,94,51,95,103,146,644,976,4,4439,246,0,2,13,0,33010,13427,2524,19440,0
53,1425,1455,414,1257,16,76,112,1471,5,41,23,46,46,69,231,381,2,1069,59,0,2,6,8,33020,13432,2525,19448,0
53,1425,669,365,481,22,61,110,691,15,103,63,122,118,185,747,1273,8,11311,628,0,2,6,8,33030,13432,2526,19449,0
52,2288,1455,414,1257,16,76,112,1471,5,41,23,46,46,69,231,381,2,1069,59,0,2,10,2,33030,13433,2526,19450,0
53,1425,1455,414,1257,16,76,112,1471,5,41,23,46,46,69,231,381,2,1069,59,0,2,6,8,33030,13434,2526,19451,0
53,1425,669,365,481,22,61,110,691,15,103,63,122,118,185,747,1273,8,11311,628,0,2,6,8,33040,13434,2527,19452,0
52,2288,1455,414,1257,16,76,112,1471,5,41,23,46,46,69,231,381,2,1069,59,0,2,10,2,33040,13435,2527,19453,0
203,4258,182,127,129,0,0,53,182,5,39,21,42,44,63,217,343,2,926,51,0,2,7,4,33040,13435,2528,19454,1
203,4258,1165,710,800,67,119,181,1232,18,243,153,282,261,435,2000,3492,10,36473,2026,1,2,7,4,33050,13435,2529,19455,1
174,4021,77,34,69,0,0,8,77,3,24,16,29,27,45,114,213,1,387,21,0,2,7,1,33050,13435,2529,19456,1
174,4021,712,438,573,51,9,84,763,14,102,71,128,116,199,733,1364,8,11988,666,0,2,7,1,33060,13436,2529,19457,1
122,5398,1392,870,1177,35,17,170,1427,14,494,280,531,508,811,4473,7289,7,54850,3047,2,2,11,0,33060,13439,2530,19458,1
553,11758,72,33,56,0,4,12,72,1,1,1,1,2,2,0,2,0,1,0,0,2,1,0,33060,13439,2530,19459,1
553,11758,1454,835,1044,76,110,219,1530,17,275,158,296,292,454,2297,3718,9,34017,1889,1,2,1,0,33070,13440,2530,19460,1
140,6252,139,89,101,2,0,35,141,7,54,34,62,61,96,330,569,4,2287,127,0,2,29,58,33070,13440,2530,19461,1
140,6252,7,5,5,0,0,2,7,1,2,1,2,3,3,2,4,0,2,0,0,2,29,58,33070,13440,2530,19462,1
553,11773,72,33,56,0,4,12,72,1,1,1,1,2,2,0,2,0,1,0,0,2,4,4,33070,13440,2530,19463,1
553,11773,1454,835,1044,76,110,219,1530,17,275,158,296,292,454,2297,3718,9,34017,1889,1,2,4,4,33080,13441,2530,19464,1
140,6263,139,89,101,2,0,35,141,7,54,34,62,61,96,330,569,4,2287,127,0,2,11,12,33080,13441,2530,19465,1
140,6263,7,5,5,0,0,2,7,1,2,1,2,3,3,2,4,0,2,0,0,2,11,12,33080,13441,2530,19466,1
553,11737,72,33,56,0,4,12,72,1,1,1,1,2,2,0,2,0,1,0,0,2,14,18,33080,13441,2530,19467,1
553,11737,1454,835,1044,76,110,219,1530,17,275,158,296,292,454,2297,3718,9,34017,1889,1,2,14,18,33090,13442,2530,19468,1
3,63,127,75,83,2,11,30,129,4,14,7,14,18,21,61,87,2,175,9,0,2,2,2,33090,13442,2530,19469,1
3,63,652,304,544,16,6,88,668,6,89,51,101,95,152,591,998,3,3399,188,0,2,2,2,33090,13443,2530,19470,1
3,63,2,2,2,0,0,0,2,0,0,0,0,0,0,0,0,0,0,0,0,2,2,2,33090,13443,2530,19470,1
3,63,8,5,5,0,0,3,8,0,0,0,0,0,0,0,0,0,0,0,0,2,2,2,33090,13443,2530,19471,1
3,63,2,2,2,0,0,0,2,0,0,0,0,0,0,0,0,0,0,0,0,2,2,2,33090,13443,2530,19471,1
3,63,14,8,8,0,0,6,14,0,0,0,0,0,0,0,0,0,0,0,0,2,2,2,33090,13443,2530,19472,1
3,63,6,4,4,0,0,2,6,0,0,0,0,0,0,0,0,0,0,0,0,2,2,2,33090,13443,2530,19473,1
3,63,6,4,4,0,0,2,6,1,2,1,2,3,3,2,4,0,2,0,0,2,2,2,33090,13443,2530,19474,1
3,63,6,4,4,0,0,2,6,0,0,0,0,0,0,0,0,0,0,0,0,2,2,2,33090,13443,2530,19475,1
3,63,7,5,5,0,0,2,7,0,0,0,0,0,0,0,0,0,0,0,0,2,2,2,33090,13443,2530,19476,1
3,63,6,4,4,0,0,2,6,0,0,0,0,0,0,0,0,0,0,0,0,2,2,2,33090,13443,2530,19477,1
3,63,10,6,6,0,0,4,10,0,0,0,0,0,0,0,0,0,0,0,0,2,2,2,33090,13443,2530,19478,1
3,63,1,1,1,0,0,0,1,0,0,0,0,0,0,0,0,0,0,0,0,2,2,2,33090,13443,2530,19478,1
3,63,14,10,10,0,0,4,14,1,1,1,1,2,2,0,2,0,1,0,0,2,2,2,33090,13443,2530,19479,1
3,63,46,26,30,3,0,12,49,3,6,3,6,9,9,20,28,1,42,2,0,2,2,2,33100,13443,2530,19480,1
550,11685,72,33,56,0,4,12,72,1,1,1,1,2,2,0,2,0,1,0,0,2,5,14,33100,13443,2530,19481,1
550,11685,1454,835,1044,76,110,219,1530,17,275,158,296,292,454,2297,3718,9,34017,1889,1,2,5,14,33110,13444,2530,19482,1
203,4258,182,127,129,0,0,53,182,5,39,21,42,44,63,217,343,2,926,51,0,2,7,4,33110,13444,2531,19483,0
203,4258,1165,710,800,67,119,181,1232,18,243,153,282,261,435,2000,3492,10,36473,2026,1,2,7,4,33120,13444,2532,19484,0
174,4021,77,34,69,0,0,8,77,3,24,16,29,27,45,114,213,1,387,21,0,2,7,1,33120,13444,2532,19485,0
174,4021,712,438,573,51,9,84,763,14,102,71,128,116,199,733,1364,8,11988,666,0,2,7,1,33130,13445,2532,19486,0
122,5398,1392,870,1177,35,17,170,1427,14,494,280,531,508,811,4473,7289,7,54850,3047,2,2,11,0,33130,13448,2533,19487,0
5,280,180,34,164,0,0,16,180,1,12,6,12,13,18,43,66,0,33,1,0,0,137,0,33130,13448,2533,19488,0
568,12095,72,33,56,0,4,12,72,1,1,1,1,2,2,0,2,0,1,0,0,2,71,0,33130,13448,2533,19489,1
568,12095,1454,835,1044,76,110,219,1530,17,275,158,296,292,454,2297,3718,9,34017,1889,1,2,71,0,33140,13449,2533,19490,1
568,12095,72,33,56,0,4,12,72,1,1,1,1,2,2,0,2,0,1,0,0,2,4,4,33140,13449,2533,19491,1
568,12095,1454,835,1044,76,110,219,1530,17,275,158,296,292,454,2297,3718,9,34017,1889,1,2,4,4,33150,13450,2533,19492,1
175,4054,77,34,69,0,0,8,77,3,24,16,29,27,45,114,213,1,387,21,0,2,3,0,33150,13450,2533,19493,1
175,4054,712,438,573,51,9,84,763,14,102,71,128,116,199,733,1364,8,11988,666,0,2,3,0,33160,13451,2533,19494,1
63,2641,1043,504,840,53,9,147,1096,9,180,112,198,189,310,1377,2344,4,11604,644,0,2,33,0,33160,13453,2533,19495,1
175,4054,77,34,69,0,0,8,77,3,24,16,29,27,45,114,213,1,387,21,0,2,3,0,33160,13453,2533,19496,0
175,4054,712,438,573,51,9,84,763,14,102,71,128,116,199,733,1364,8,11988,666,0,2,3,0,33170,13454,2533,19497,0
63,2641,1043,504,840,53,9,147,1096,9,180,112,198,189,310,1377,2344,4,11604,644,0,2,33,0,33170,13456,2533,19498,0
568,12095,72,33,56,0,4,12,72,1,1,1,1,2,2,0,2,0,1,0,0,2,1,1,33170,13456,2533,19499,1
568,12095,1454,835,1044,76,110,219,1530,17,275,158,296,292,454,2297,3718,9,34017,1889,1,2,1,1,33180,13457,2533,19500,1
5,280,180,34,164,0,0,16,180,1,12,6,12,13,18,43,66,0,33,1,0,2,5,5,33180,13457,2533,19501,1
174,4005,77,34,69,0,0,8,77,3,24,16,29,27,45,114,213,1,387,21,0,2,18,29,33180,13457,2533,19502,1
174,4005,712,438,573,51,9,84,763,14,102,71,128,116,199,733,1364,8,11988,666,0,2,18,29,33190,13458,2533,19503,1
78,3195,1289,550,1043,56,32,155,1345,10,167,93,185,177,278,1266,2075,5,11498,638,0,2,77,6,33190,13460,2534,19504,1
174,4006,77,34,69,0,0,8,77,3,24,16,29,27,45,114,213,1,387,21,0,2,4,1,33190,13460,2534,19505,1
174,4006,712,438,573,51,9,84,763,14,102,71,128,116,199,733,1364,8,11988,666,0,2,4,1,33200,13461,2534,19506,1
77,3168,1289,550,1043,56,32,155,1345,10,167,93,185,177,278,1266,2075,5,11498,638,0,2,9,19,33200,13463,2535,19507,1
550,11685,72,33,56,0,4,12,72,1,1,1,1,2,2,0,2,0,1,0,0,2,22,34,33200,13463,2535,19508,0
550,11685,1454,835,1044,76,110,219,1530,17,275,158,296,292,454,2297,3718,9,34017,1889,1,2,22,34,33210,13464,2535,19509,0
3,63,127,75,83,2,11,30,129,4,14,7,14,18,21,61,87,2,175,9,0,2,2,2,33210,13464,2535,19510,0
3,63,652,304,544,16,6,88,668,6,89,51,101,95,152,591,998,3,3399,188,0,2,2,2,33210,13465,2535,19511,0
3,63,2,2,2,0,0,0,2,0,0,0,0,0,0,0,0,0,0,0,0,2,2,2,33210,13465,2535,19511,0
3,63,8,5,5,0,0,3,8,0,0,0,0,0,0,0,0,0,0,0,0,2,2,2,33210,13465,2535,19512,0
3,63,2,2,2,0,0,0,2,0,0,0,0,0,0,0,0,0,0,0,0,2,2,2,33210,13465,2535,19512,0
3,63,14,8,8,0,0,6,14,0,0,0,0,0,0,0,0,0,0,0,0,2,2,2,33210,13465,2535,19513,0
3,63,6,4,4,0,0,2,6,0,0,0,0,0,0,0,0,0,0,0,0,2,2,2,33210,13465,2535,19514,0
3,63,6,4,4,0,0,2,6,1,2,1,2,3,3,2,4,0,2,0,0,2,2,2,33210,13465,2535,19515,0
3,63,6,4,4,0,0,2,6,0,0,0,0,0,0,0,0,0,0,0,0,2,2,2,33210,13465,2535,19516,0
3,63,7,5,5,0,0,2,7,0,0,0,0,0,0,0,0,0,0,0,0,2,2,2,33210,13465,2535,19517,0
3,63,6,4,4,0,0,2,6,0,0,0,0,0,0,0,0,0,0,0,0,2,2,2,33210,13465,2535,19518,0
3,63,10,6,6,0,0,4,10,0,0,0,0,0,0,0,0,0,0,0,0,2,2,2,33210,13465,2535,19519,0
3,63,1,1,1,0,0,0,1,0,0,0,0,0,0,0,0,0,0,0,0,2,2,2,33210,13465,2535,19519,0
3,63,14,10,10,0,0,4,14,1,1,1,1,2,2,0,2,0,1,0,0,2,2,2,33210,13465,2535,19520,0
3,63,46,26,30,3,0,12,49,3,6,3,6,9,9,20,28,1,42,2,0,2,2,2,33220,13465,2535,19521,0
140,6263,139,89,101,2,0,35,141,7,54,34,62,61,96,330,569,4,2287,127,0,2,20,50,33220,13465,2535,19522,0
140,6263,7,5,5,0,0,2,7,1,2,1,2,3,3,2,4,0,2,0,0,2,20,50,33220,13465,2535,19523,0
565,12028,72,33,56,0,4,12,72,1,1,1,1,2,2,0,2,0,1,0,0,2,71,0,33220,13465,2535,19524,0
565,12028,1454,835,1044,76,110,219,1530,17,275,158,296,292,454,2297,3718,9,34017,1889,1,2,71,0,33230,13466,2535,19525,0
5,280,180,34,164,0,0,16,180,1,12,6,12,13,18,43,66,0,33,1,0,0,137,0,33230,13466,2535,19526,0
71,3617,1943,715,1694,26,18,214,1969,12,185,120,237,197,357,1436,2721,7,20915,1161,0,2,0,5,33230,13468,2535,19527,0
174,4049,77,34,69,0,0,8,77,3,24,16,29,27,45,114,213,1,387,21,0,2,1,10,33230,13468,2535,19528,1
174,4049,712,438,573,51,9,84,763,14,102,71,128,116,199,733,1364,8,11988,666,0,2,1,10,33240,13469,2535,19529,1
174,4049,77,34,69,0,0,8,77,3,24,16,29,27,45,114,213,1,387,21,0,2,1,10,33240,13469,2535,19530,0
174,4049,712,438,573,51,9,84,763,14,102,71,128,116,199,733,1364,8,11988,666,0,2,1,10,33250,13470,2535,19531,0
71,3617,1943,715,1694,26,18,214,1969,12,185,120,237,197,357,1436,2721,7,20915,1161,0,2,0,5,33250,13472,2535,19532,0
566,12057,72,33,56,0,4,12,72,1,1,1,1,2,2,0,2,0,1,0,0,2,10,4,33250,13472,2535,19533,1
566,12057,1454,835,1044,76,110,219,1530,17,275,158,296,292,454,2297,3718,9,34017,1889,1,2,10,4,33260,13473,2535,19534,1
17,373,256,139,192,9,7,47,265,4,23,12,24,27,36,112,171,2,357,19,0,2,17,0,33260,13474,2535,19535,1
17,375,256,139,192,9,7,47,265,4,23,12,24,27,36,112,171,2,357,19,0,2,2,2,33260,13475,2535,19536,0
117,2369,1513,682,1277,25,13,200,1538,11,199,116,219,210,335,1557,2584,6,15641,868,0,2,17,6,33260,13477,2535,19537,1
117,2369,819,519,539,24,98,155,843,15,96,57,106,111,163,690,1107,8,9171,509,0,2,17,6,33270,13479,2535,19538,1
113,4391,1513,682,1277,25,13,200,1538,11,199,116,219,210,335,1557,2584,6,15641,868,0,2,16,0,33270,13481,2535,19539,1
173,4001,77,34,69,0,0,8,77,3,24,16,29,27,45,114,213,1,387,21,0,2,21,29,33270,13481,2535,19540,0
173,4001,712,438,573,51,9,84,763,14,102,71,128,116,199,733,1364,8,11988,666,0,2,21,29,33280,13482,2535,19541,0
77,3168,1289,550,1043,56,32,155,1345,10,167,93,185,177,278,1266,2075,5,11498,638,0,2,70,9,33280,13484,2536,19542,0
566,12055,72,33,56,0,4,12,72,1,1,1,1,2,2,0,2,0,1,0,0,2,3,4,33280,13484,2536,19543,1
566,12055,1454,835,1044,76,110,219,1530,17,275,158,296,292,454,2297,3718,9,34017,1889,1,2,3,4,33290,13485,2536,19544,1
16,362,256,139,192,9,7,47,265,4,23,12,24,27,36,112,171,2,357,19,0,2,7,4,33290,13486,2536,19545,1
566,12055,72,33,56,0,4,12,72,1,1,1,1,2,2,0,2,0,1,0,0,2,8,0,33290,13486,2536,19546,1
566,12055,1454,835,1044,76,110,219,1530,17,275,158,296,292,454,2297,3718,9,34017,1889,1,2,8,0,33300,13487,2536,19547,1
566,12055,72,33,56,0,4,12,72,1,1,1,1,2,2,0,2,0,1,0,0,2,2,0,33300,13487,2536,19548,1
566,12055,1454,835,1044,76,110,219,1530,17,275,158,296,292,454,2297,3718,9,34017,1889,1,2,2,0,33310,13488,2536,19549,1
117,2369,1513,682,1277,25,13,200,1538,11,199,116,219,210,335,1557,2584,6,15641,868,0,2,17,6,33310,13490,2536,19550,0
117,2369,819,519,539,24,98,155,843,15,96,57,106,111,163,690,1107,8,9171,509,0,2,17,6,33320,13492,2536,19551,0
113,4391,1513,682,1277,25,13,200,1538,11,199,116,219,210,335,1557,2584,6,15641,868,0,2,16,0,33320,13494,2536,19552,0
566,12055,72,33,56,0,4,12,72,1,1,1,1,2,2,0,2,0,1,0,0,2,19,4,33320,13494,2536,19553,0
566,12055,1454,835,1044,76,110,219,1530,17,275,158,296,292,454,2297,3718,9,34017,1889,1,2,19,4,33330,13495,2536,19554,0
16,362,256,139,192,9,7,47,265,4,23,12,24,27,36,112,171,2,357,19,0,2,20,0,33330,13496,2536,19555,0
16,362,256,139,192,9,7,47,265,4,23,12,24,27,36,112,171,2,357,19,0,2,1,1,33330,13497,2536,19556,0
54,2999,1296,573,1062,40,33,157,1336,8,201,118,231,209,349,1561,2689,4,12365,686,0,2,3,1,33330,13497,2536,19557,0
37,793,2,2,2,0,0,0,2,0,0,0,0,0,0,0,0,0,0,0,0,2,35,15,33330,13497,2536,19557,1
37,793,99,48,90,1,3,5,100,0,0,0,0,0,0,0,0,0,0,0,0,2,35,15,33330,13498,2536,19558,1
37,793,8,5,5,2,0,1,10,0,0,0,0,0,0,0,0,0,0,0,0,2,35,15,33330,13498,2536,19559,1
37,793,1217,716,841,84,126,174,1301,14,185,118,215,199,333,1446,2542,8,20687,1149,0,2,35,15,33340,13500,2536,19560,1
37,793,160,89,115,0,13,31,160,7,15,11,17,22,28,78,124,3,495,27,0,2,35,15,33340,13500,2536,19561,1
37,793,10,10,9,9,0,0,19,0,0,0,0,0,0,0,0,0,0,0,0,2,35,15,33340,13500,2537,19562,1
37,793,173,84,99,8,29,36,181,5,12,7,13,17,20,54,81,2,221,12,0,2,35,15,33340,13501,2537,19563,1
37,793,3,1,1,3,0,0,6,0,0,0,0,0,0,0,0,0,0,0,0,2,35,15,33340,13501,2537,19564,1
151,4796,1660,832,1314,41,38,274,1701,20,312,209,395,332,604,2671,5058,12,64042,3557,1,2,35,22,33340,13503,2538,19566,1
151,4796,1057,646,719,113,100,145,1170,18,215,134,248,233,382,1740,3004,10,31186,1732,1,2,35,22,33350,13504,2539,19567,1
141,3690,1660,832,1314,41,38,274,1701,20,312,209,395,332,604,2671,5058,12,64042,3557,1,2,34,0,33350,13506,2540,19569,1
59,2950,1457,730,1242,11,6,188,1468,10,292,166,329,302,495,2424,4078,5,22973,1276,1,2,8,3,33350,13508,2540,19570,1
220,4876,722,423,573,19,0,135,741,12,172,101,199,184,300,1320,2257,6,15668,870,0,2,7,4,33350,13510,2540,19572,1
220,4876,1508,847,911,44,250,301,1552,14,148,88,169,162,257,1120,1886,7,15077,837,0,2,7,4,33350,13511,2541,19573,1
37,788,2,2,2,0,0,0,2,0,0,0,0,0,0,0,0,0,0,0,0,2,1,2,33350,13511,2541,19573,1
37,788,99,48,90,1,3,5,100,0,0,0,0,0,0,0,0,0,0,0,0,2,1,2,33350,13512,2541,19574,1
37,788,8,5,5,2,0,1,10,0,0,0,0,0,0,0,0,0,0,0,0,2,1,2,33350,13512,2541,19575,1
37,788,1217,716,841,84,126,174,1301,14,185,118,215,199,333,1446,2542,8,20687,1149,0,2,1,2,33360,13514,2541,19576,1
37,788,160,89,115,0,13,31,160,7,15,11,17,22,28,78,124,3,495,27,0,2,1,2,33360,13514,2541,19577,1
37,788,10,10,9,9,0,0,19,0,0,0,0,0,0,0,0,0,0,0,0,2,1,2,33360,13514,2542,19578,1
37,788,173,84,99,8,29,36,181,5,12,7,13,17,20,54,81,2,221,12,0,2,1,2,33360,13515,2542,19579,1
37,788,3,1,1,3,0,0,6,0,0,0,0,0,0,0,0,0,0,0,0,2,1,2,33360,13515,2542,19580,1
150,4790,1660,832,1314,41,38,274,1701,20,312,209,395,332,604,2671,5058,12,64042,3557,1,2,3,5,33360,13517,2543,19582,1
150,4790,1057,646,719,113,100,145,1170,18,215,134,248,233,382,1740,3004,10,31186,1732,1,2,3,5,33370,13518,2544,19583,1
516,11121,72,33,56,0,4,12,72,1,1,1,1,2,2,0,2,0,1,0,0,2,19,0,33370,13518,2544,19584,1
516,11121,1454,835,1044,76,110,219,1530,17,275,158,296,292,454,2297,3718,9,34017,1889,1,2,19,0,33380,13519,2544,19585,1
145,6464,139,89,101,2,0,35,141,7,54,34,62,61,96,330,569,4,2287,127,0,2,105,0,33380,13519,2544,19586,1
145,6464,7,5,5,0,0,2,7,1,2,1,2,3,3,2,4,0,2,0,0,2,105,0,33380,13519,2544,19587,1
37,784,2,2,2,0,0,0,2,0,0,0,0,0,0,0,0,0,0,0,0,2,0,1,33380,13519,2544,19587,0
37,784,99,48,90,1,3,5,100,0,0,0,0,0,0,0,0,0,0,0,0,2,0,1,33380,13520,2544,19588,0
37,784,8,5,5,2,0,1,10,0,0,0,0,0,0,0,0,0,0,0,0,2,0,1,33380,13520,2544,19589,0
37,784,1217,716,841,84,126,174,1301,14,185,118,215,199,333,1446,2542,8,20687,1149,0,2,0,1,33390,13522,2544,19590,0
37,784,160,89,115,0,13,31,160,7,15,11,17,22,28,78,124,3,495,27,0,2,0,1,33390,13522,2544,19591,0
37,784,10,10,9,9,0,0,19,0,0,0,0,0,0,0,0,0,0,0,0,2,0,1,33390,13522,2545,19592,0
37,784,173,84,99,8,29,36,181,5,12,7,13,17,20,54,81,2,221,12,0,2,0,1,33390,13523,2545,19593,0
37,784,3,1,1,3,0,0,6,0,0,0,0,0,0,0,0,0,0,0,0,2,0,1,33390,13523,2545,19594,0
150,4791,1660,832,1314,41,38,274,1701,20,312,209,395,332,604,2671,5058,12,64042,3557,1,2,1,1,33390,13525,2546,19596,0
150,4791,1057,646,719,113,100,145,1170,18,215,134,248,233,382,1740,3004,10,31186,1732,1,2,1,1,33400,13526,2547,19597,0
175,4054,77,34,69,0,0,8,77,3,24,16,29,27,45,114,213,1,387,21,0,2,8,0,33400,13526,2547,19598,1
175,4054,712,438,573,51,9,84,763,14,102,71,128,116,199,733,1364,8,11988,666,0,2,8,0,33410,13527,2547,19599,1
71,2946,1289,550,1043,56,32,155,1345,10,167,93,185,177,278,1266,2075,5,11498,638,0,2,6,4,33410,13529,2548,19600,1
58,3261,1296,573,1062,40,33,157,1336,8,201,118,231,209,349,1561,2689,4,12365,686,0,2,111,0,33410,13529,2548,19601,1
54,2412,1455,414,1257,16,76,112,1471,5,41,23,46,46,69,231,381,2,1069,59,0,2,17,4,33410,13530,2548,19602,1
16,1265,215,129,180,6,0,29,221,8,65,43,72,73,115,415,711,4,3153,175,0,2,1,1,33410,13530,2548,19603,1
72,3652,1943,715,1694,26,18,214,1969,12,185,120,237,197,357,1436,2721,7,20915,1161,0,2,1,1,33410,13532,2548,19604,1
514,11012,72,33,56,0,4,12,72,1,1,1,1,2,2,0,2,0,1,0,0,2,1,1,33410,13532,2548,19605,1
514,11012,1454,835,1044,76,110,219,1530,17,275,158,296,292,454,2297,3718,9,34017,1889,1,2,1,1,33420,13533,2548,19606,1
117,2369,1513,682,1277,25,13,200,1538,11,199,116,219,210,335,1557,2584,6,15641,868,0,2,1,1,33420,13535,2548,19607,1
117,2369,819,519,539,24,98,155,843,15,96,57,106,111,163,690,1107,8,9171,509,0,2,1,1,33430,13537,2548,19608,1
24,810,74,35,59,1,0,14,75,3,14,7,14,17,21,58,85,1,128,7,0,2,2,2,33430,13538,2548,19609,1
24,810,245,125,200,5,7,34,250,7,30,17,34,37,51,166,265,3,1053,58,0,2,2,2,33440,13539,2548,19610,1
47,548,647,139,84,35,284,233,682,0,0,0,0,0,0,0,0,0,0,0,0,2,1,1,33440,13539,2548,19611,1
219,4866,722,423,573,19,0,135,741,12,172,101,199,184,300,1320,2257,6,15668,870,0,2,15,15,33440,13541,2548,19613,1
219,4866,1508,847,911,44,250,301,1552,14,148,88,169,162,257,1120,1886,7,15077,837,0,2,15,15,33440,13542,2549,19614,1
566,12055,72,33,56,0,4,12,72,1,1,1,1,2,2,0,2,0,1,0,0,2,1,1,33440,13542,2549,19615,1
566,12055,1454,835,1044,76,110,219,1530,17,275,158,296,292,454,2297,3718,9,34017,1889,1,2,1,1,33450,13543,2549,19616,1
3,23,14,7,7,2,0,5,16,0,0,0,0,0,0,0,0,0,0,0,0,2,1,1,33450,13543,2549,19616,1
20,625,42,7,35,4,0,5,46,1,2,1,2,3,3,2,4,0,2,0,0,2,1,0,33450,13543,2549,19617,1
20,625,11,6,10,0,0,1,11,2,4,2,4,6,6,10,15,1,15,0,0,2,1,0,33450,13543,2549,19618,1
58,2960,1457,730,1242,11,6,188,1468,10,292,166,329,302,495,2424,4078,5,22973,1276,1,2,1,1,33450,13545,2549,19620,1
8,265,74,35,59,1,0,14,75,3,14,7,14,17,21,58,85,1,128,7,0,2,2,2,33450,13546,2549,19621,1
75,3651,1523,757,1297,19,12,193,1542,12,193,117,230,205,347,1508,2664,7,19053,1058,0,2,1,1,33460,13548,2549,19622,1
38,2201,334,251,279,10,4,40,344,5,127,74,143,132,217,899,1528,2,4303,239,0,2,6,7,33460,13549,2549,19623,1
220,4876,722,423,573,19,0,135,741,12,172,101,199,184,300,1320,2257,6,15668,870,0,2,7,4,33460,13551,2549,19625,0
220,4876,1508,847,911,44,250,301,1552,14,148,88,169,162,257,1120,1886,7,15077,837,0,2,7,4,33460,13552,2550,19626,0
175,4054,77,34,69,0,0,8,77,3,24,16,29,27,45,114,213,1,387,21,0,2,8,0,33460,13552,2550,19627,0
175,4054,712,438,573,51,9,84,763,14,102,71,128,116,199,733,1364,8,11988,666,0,2,8,0,33470,13553,2550,19628,0
71,2946,1289,550,1043,56,32,155,1345,10,167,93,185,177,278,1266,2075,5,11498,638,0,2,6,4,33470,13555,2551,19629,0
58,3261,1296,573,1062,40,33,157,1336,8,201,118,231,209,349,1561,2689,4,12365,686,0,2,111,0,33470,13555,2551,19630,0
54,2412,1455,414,1257,16,76,112,1471,5,41,23,46,46,69,231,381,2,1069,59,0,2,17,4,33470,13556,2551,19631,0
16,1265,215,129,180,6,0,29,221,8,65,43,72,73,115,415,711,4,3153,175,0,2,1,1,33470,13556,2551,19632,0
72,3652,1943,715,1694,26,18,214,1969,12,185,120,237,197,357,1436,2721,7,20915,1161,0,2,1,1,33470,13558,2551,19633,0
175,4054,77,34,69,0,0,8,77,3,24,16,29,27,45,114,213,1,387,21,0,2,8,0,33470,13558,2551,19634,0
175,4054,712,438,573,51,9,84,763,14,102,71,128,116,199,733,1364,8,11988,666,0,2,8,0,33480,13559,2551,19635,0
71,2946,1289,550,1043,56,32,155,1345,10,167,93,185,177,278,1266,2075,5,11498,638,0,2,6,4,33480,13561,2552,19636,0
58,3261,1296,573,1062,40,33,157,1336,8,201,118,231,209,349,1561,2689,4,12365,686,0,2,111,0,33480,13561,2552,19637,0
54,2412,1455,414,1257,16,76,112,1471,5,41,23,46,46,69,231,381,2,1069,59,0,2,17,4,33480,13562,2552,19638,0
16,1265,215,129,180,6,0,29,221,8,65,43,72,73,115,415,711,4,3153,175,0,2,1,1,33480,13562,2552,19639,0
72,3652,1943,715,1694,26,18,214,1969,12,185,120,237,197,357,1436,2721,7,20915,1161,0,2,1,1,33480,13564,2552,19640,0
37,784,2,2,2,0,0,0,2,0,0,0,0,0,0,0,0,0,0,0,0,2,34,16,33480,13564,2552,19640,0
37,784,99,48,90,1,3,5,100,0,0,0,0,0,0,0,0,0,0,0,0,2,34,16,33480,13565,2552,19641,0
37,784,8,5,5,2,0,1,10,0,0,0,0,0,0,0,0,0,0,0,0,2,34,16,33480,13565,2552,19642,0
37,784,1217,716,841,84,126,174,1301,14,185,118,215,199,333,1446,2542,8,20687,1149,0,2,34,16,33490,13567,2552,19643,0
37,784,160,89,115,0,13,31,160,7,15,11,17,22,28,78,124,3,495,27,0,2,34,16,33490,13567,2552,19644,0
37,784,10,10,9,9,0,0,19,0,0,0,0,0,0,0,0,0,0,0,0,2,34,16,33490,13567,2553,19645,0
37,784,173,84,99,8,29,36,181,5,12,7,13,17,20,54,81,2,221,12,0,2,34,16,33490,13568,2553,19646,0
37,784,3,1,1,3,0,0,6,0,0,0,0,0,0,0,0,0,0,0,0,2,34,16,33490,13568,2553,19647,0
150,4791,1660,832,1314,41,38,274,1701,20,312,209,395,332,604,2671,5058,12,64042,3557,1,2,34,23,33490,13570,2554,19649,0
150,4791,1057,646,719,113,100,145,1170,18,215,134,248,233,382,1740,3004,10,31186,1732,1,2,34,23,33500,13571,2555,19650,0
141,3690,1660,832,1314,41,38,274,1701,20,312,209,395,332,604,2671,5058,12,64042,3557,1,2,34,0,33500,13573,2556,19652,0
59,2950,1457,730,1242,11,6,188,1468,10,292,166,329,302,495,2424,4078,5,22973,1276,1,2,8,3,33500,13575,2556,19653,0
54,2999,1296,573,1062,40,33,157,1336,8,201,118,231,209,349,1561,2689,4,12365,686,0,2,3,1,33500,13575,2556,19654,0
514,11012,72,33,56,0,4,12,72,1,1,1,1,2,2,0,2,0,1,0,0,2,1,1,33500,13575,2556,19655,0
514,11012,1454,835,1044,76,110,219,1530,17,275,158,296,292,454,2297,3718,9,34017,1889,1,2,1,1,33510,13576,2556,19656,0
117,2369,1513,682,1277,25,13,200,1538,11,199,116,219,210,335,1557,2584,6,15641,868,0,2,1,1,33510,13578,2556,19657,0
117,2369,819,519,539,24,98,155,843,15,96,57,106,111,163,690,1107,8,9171,509,0,2,1,1,33520,13580,2556,19658,0
24,810,74,35,59,1,0,14,75,3,14,7,14,17,21,58,85,1,128,7,0,2,2,2,33520,13581,2556,19659,0
24,810,245,125,200,5,7,34,250,7,30,17,34,37,51,166,265,3,1053,58,0,2,2,2,33530,13582,2556,19660,0
47,548,647,139,84,35,284,233,682,0,0,0,0,0,0,0,0,0,0,0,0,2,1,1,33530,13582,2556,19661,0
219,4866,722,423,573,19,0,135,741,12,172,101,199,184,300,1320,2257,6,15668,870,0,2,15,15,33530,13584,2556,19663,0
219,4866,1508,847,911,44,250,301,1552,14,148,88,169,162,257,1120,1886,7,15077,837,0,2,15,15,33530,13585,2557,19664,0
566,12055,72,33,56,0,4,12,72,1,1,1,1,2,2,0,2,0,1,0,0,2,1,1,33530,13585,2557,19665,0
566,12055,1454,835,1044,76,110,219,1530,17,275,158,296,292,454,2297,3718,9,34017,1889,1,2,1,1,33540,13586,2557,19666,0
3,23,14,7,7,2,0,5,16,0,0,0,0,0,0,0,0,0,0,0,0,2,1,1,33540,13586,2557,19666,0
20,625,42,7,35,4,0,5,46,1,2,1,2,3,3,2,4,0,2,0,0,2,1,0,33540,13586,2557,19667,0
20,625,11,6,10,0,0,1,11,2,4,2,4,6,6,10,15,1,15,0,0,2,1,0,33540,13586,2557,19668,0
59,2950,1457,730,1242,11,6,188,1468,10,292,166,329,302,495,2424,4078,5,22973,1276,1,2,1,1,33540,13588,2557,19670,0
8,265,74,35,59,1,0,14,75,3,14,7,14,17,21,58,85,1,128,7,0,2,2,2,33540,13589,2557,19671,0
75,3651,1523,757,1297,19,12,193,1542,12,193,117,230,205,347,1508,2664,7,19053,1058,0,2,1,1,33550,13591,2557,19672,0
38,2201,334,251,279,10,4,40,344,5,127,74,143,132,217,899,1528,2,4303,239,0,2,6,7,33550,13592,2557,19673,0
516,11123,72,33,56,0,4,12,72,1,1,1,1,2,2,0,2,0,1,0,0,2,19,0,33550,13592,2557,19674,0
516,11123,1454,835,1044,76,110,219,1530,17,275,158,296,292,454,2297,3718,9,34017,1889,1,2,19,0,33560,13593,2557,19675,0
145,6464,139,89,101,2,0,35,141,7,54,34,62,61,96,330,569,4,2287,127,0,2,105,0,33560,13593,2557,19676,0
145,6464,7,5,5,0,0,2,7,1,2,1,2,3,3,2,4,0,2,0,0,2,105,0,33560,13593,2557,19677,0
173,4021,77,34,69,0,0,8,77,3,24,16,29,27,45,114,213,1,387,21,0,2,2,0,33560,13593,2557,19678,1
173,4021,712,438,573,51,9,84,763,14,102,71,128,116,199,733,1364,8,11988,666,0,2,2,0,33570,13594,2557,19679,1
569,12221,72,33,56,0,4,12,72,1,1,1,1,2,2,0,2,0,1,0,0,2,15,0,33570,13594,2557,19680,1
569,12221,1454,835,1044,76,110,219,1530,17,275,158,296,292,454,2297,3718,9,34017,1889,1,2,15,0,33580,13595,2557,19681,1
120,2635,1043,504,840,53,9,147,1096,9,180,112,198,189,310,1377,2344,4,11604,644,0,2,11,1,33580,13597,2557,19682,1
120,2635,383,288,292,26,6,62,409,11,65,38,67,76,105,429,656,5,3719,206,0,2,11,1,33580,13598,2557,19683,1
90,1955,477,336,357,30,23,73,507,16,194,134,250,210,384,1538,2962,10,30538,1696,0,2,3,2,33590,13599,2557,19684,1
76,2747,1450,624,1228,12,26,181,1462,14,306,186,354,320,540,2580,4493,8,36391,2021,1,2,15,1,33590,13601,2558,19685,1
121,2646,1043,504,840,53,9,147,1096,9,180,112,198,189,310,1377,2344,4,11604,644,0,2,12,8,33590,13603,2558,19686,1
121,2646,383,288,292,26,6,62,409,11,65,38,67,76,105,429,656,5,3719,206,0,2,12,8,33590,13604,2558,19687,1
146,6501,139,89,101,2,0,35,141,7,54,34,62,61,96,330,569,4,2287,127,0,2,14,0,33590,13604,2558,19688,1
146,6501,7,5,5,0,0,2,7,1,2,1,2,3,3,2,4,0,2,0,0,2,14,0,33590,13604,2558,19689,1
573,12239,72,33,56,0,4,12,72,1,1,1,1,2,2,0,2,0,1,0,0,2,22,12,33590,13604,2558,19690,1
573,12239,1454,835,1044,76,110,219,1530,17,275,158,296,292,454,2297,3718,9,34017,1889,1,2,22,12,33600,13605,2558,19691,1
121,2646,1043,504,840,53,9,147,1096,9,180,112,198,189,310,1377,2344,4,11604,644,0,2,12,8,33600,13607,2558,19692,0
121,2646,383,288,292,26,6,62,409,11,65,38,67,76,105,429,656,5,3719,206,0,2,12,8,33600,13608,2558,19693,0
575,12268,72,33,56,0,4,12,72,1,1,1,1,2,2,0,2,0,1,0,0,2,9,1,33600,13608,2558,19694,0
575,12268,1454,835,1044,76,110,219,1530,17,275,158,296,292,454,2297,3718,9,34017,1889,1,2,9,1,33610,13609,2558,19695,0
3,147,601,196,481,2,23,85,603,8,63,36,72,71,108,400,664,4,3036,168,0,0,27,0,33610,13609,2558,19698,1
579,12308,72,33,56,0,4,12,72,1,1,1,1,2,2,0,2,0,1,0,0,2,6,0,33610,13609,2558,19699,0
579,12308,1454,835,1044,76,110,219,1530,17,275,158,296,292,454,2297,3718,9,34017,1889,1,2,6,0,33620,13610,2558,19700,0
121,2645,1043,504,840,53,9,147,1096,9,180,112,198,189,310,1377,2344,4,11604,644,0,2,2,3,33620,13612,2558,19701,0
121,2645,383,288,292,26,6,62,409,11,65,38,67,76,105,429,656,5,3719,206,0,2,2,3,33620,13613,2558,19702,0
579,12308,72,33,56,0,4,12,72,1,1,1,1,2,2,0,2,0,1,0,0,2,6,0,33620,13613,2558,19703,0
579,12308,1454,835,1044,76,110,219,1530,17,275,158,296,292,454,2297,3718,9,34017,1889,1,2,6,0,33630,13614,2558,19704,0
121,2645,1043,504,840,53,9,147,1096,9,180,112,198,189,310,1377,2344,4,11604,644,0,2,2,3,33630,13616,2558,19705,0
121,2645,383,288,292,26,6,62,409,11,65,38,67,76,105,429,656,5,3719,206,0,2,2,3,33630,13617,2558,19706,0
90,1955,477,336,357,30,23,73,507,16,194,134,250,210,384,1538,2962,10,30538,1696,0,2,3,2,33640,13618,2558,19707,0
76,2747,1450,624,1228,12,26,181,1462,14,306,186,354,320,540,2580,4493,8,36391,2021,1,2,15,1,33640,13620,2559,19708,0
2,67,7,6,5,0,0,2,7,1,1,1,2,2,3,0,3,1,3,0,0,0,13,0,33640,13620,2559,19709,0
216,4657,182,127,129,0,0,53,182,5,39,21,42,44,63,217,343,2,926,51,0,2,7,4,33650,13624,2561,19717,1
216,4657,1165,710,800,67,119,181,1232,18,243,153,282,261,435,2000,3492,10,36473,2026,1,2,7,4,33660,13624,2562,19718,1
55,1468,1455,414,1257,16,76,112,1471,5,41,23,46,46,69,231,381,2,1069,59,0,2,6,10,33660,13625,2562,19719,1
55,1468,669,365,481,22,61,110,691,15,103,63,122,118,185,747,1273,8,11311,628,0,2,6,10,33670,13625,2563,19720,1
175,4054,77,34,69,0,0,8,77,3,24,16,29,27,45,114,213,1,387,21,0,2,32,40,33670,13625,2563,19721,1
175,4054,712,438,573,51,9,84,763,14,102,71,128,116,199,733,1364,8,11988,666,0,2,32,40,33680,13626,2563,19722,1
220,4876,722,423,573,19,0,135,741,12,172,101,199,184,300,1320,2257,6,15668,870,0,2,7,4,33680,13628,2563,19724,1
220,4876,1508,847,911,44,250,301,1552,14,148,88,169,162,257,1120,1886,7,15077,837,0,2,7,4,33680,13629,2564,19725,1
568,12168,72,33,56,0,4,12,72,1,1,1,1,2,2,0,2,0,1,0,0,2,20,1,33680,13629,2564,19726,1
568,12168,1454,835,1044,76,110,219,1530,17,275,158,296,292,454,2297,3718,9,34017,1889,1,2,20,1,33690,13630,2564,19727,1
77,3179,1289,550,1043,56,32,155,1345,10,167,93,185,177,278,1266,2075,5,11498,638,0,2,70,9,33690,13632,2565,19728,1
139,6353,1392,870,1177,35,17,170,1427,14,494,280,531,508,811,4473,7289,7,54850,3047,2,2,12,0,33690,13635,2566,19729,1
144,6503,139,89,101,2,0,35,141,7,54,34,62,61,96,330,569,4,2287,127,0,2,105,0,33690,13635,2566,19730,1
144,6503,7,5,5,0,0,2,7,1,2,1,2,3,3,2,4,0,2,0,0,2,105,0,33690,13635,2566,19731,1
59,3272,1296,573,1062,40,33,157,1336,8,201,118,231,209,349,1561,2689,4,12365,686,0,2,3,1,33690,13635,2566,19732,1
55,2458,1455,414,1257,16,76,112,1471,5,41,23,46,46,69,231,381,2,1069,59,0,2,10,2,33690,13636,2566,19733,1
63,2641,1043,504,840,53,9,147,1096,9,180,112,198,189,310,1377,2344,4,11604,644,0,2,33,0,33690,13638,2566,19734,1
71,3617,1943,715,1694,26,18,214,1969,12,185,120,237,197,357,1436,2721,7,20915,1161,0,2,0,5,33690,13640,2566,19735,1
579,12308,72,33,56,0,4,12,72,1,1,1,1,2,2,0,2,0,1,0,0,2,2,2,33690,13640,2566,19736,0
579,12308,1454,835,1044,76,110,219,1530,17,275,158,296,292,454,2297,3718,9,34017,1889,1,2,2,2,33700,13641,2566,19737,0
121,2645,1043,504,840,53,9,147,1096,9,180,112,198,189,310,1377,2344,4,11604,644,0,2,2,2,33700,13643,2566,19738,0
121,2645,383,288,292,26,6,62,409,11,65,38,67,76,105,429,656,5,3719,206,0,2,2,2,33700,13644,2566,19739,0
2,67,7,6,5,0,0,2,7,1,1,1,2,2,3,0,3,1,3,0,0,0,13,0,33700,13644,2566,19740,0
146,6501,139,89,101,2,0,35,141,7,54,34,62,61,96,330,569,4,2287,127,0,2,14,0,33700,13644,2566,19741,0
146,6501,7,5,5,0,0,2,7,1,2,1,2,3,3,2,4,0,2,0,0,2,14,0,33700,13644,2566,19742,0
2,67,7,6,5,0,0,2,7,1,1,1,2,2,3,0,3,1,3,0,0,0,13,0,33700,13644,2566,19743,0
90,1955,477,336,357,30,23,73,507,16,194,134,250,210,384,1538,2962,10,30538,1696,0,2,3,2,33710,13645,2566,19744,0
145,6540,139,89,101,2,0,35,141,7,54,34,62,61,96,330,569,4,2287,127,0,2,14,0,33710,13645,2566,19745,0
145,6540,7,5,5,0,0,2,7,1,2,1,2,3,3,2,4,0,2,0,0,2,14,0,33710,13645,2566,19746,0
76,2747,1450,624,1228,12,26,181,1462,14,306,186,354,320,540,2580,4493,8,36391,2021,1,2,15,1,33710,13647,2567,19747,0
579,12308,72,33,56,0,4,12,72,1,1,1,1,2,2,0,2,0,1,0,0,2,2,2,33710,13647,2567,19748,0
579,12308,1454,835,1044,76,110,219,1530,17,275,158,296,292,454,2297,3718,9,34017,1889,1,2,2,2,33720,13648,2567,19749,0
121,2645,1043,504,840,53,9,147,1096,9,180,112,198,189,310,1377,2344,4,11604,644,0,2,2,2,33720,13650,2567,19750,0
121,2645,383,288,292,26,6,62,409,11,65,38,67,76,105,429,656,5,3719,206,0,2,2,2,33720,13651,2567,19751,0
173,4038,77,34,69,0,0,8,77,3,24,16,29,27,45,114,213,1,387,21,0,2,3,0,33720,13651,2567,19752,1
173,4038,712,438,573,51,9,84,763,14,102,71,128,116,199,733,1364,8,11988,666,0,2,3,0,33730,13652,2567,19753,1
582,12336,72,33,56,0,4,12,72,1,1,1,1,2,2,0,2,0,1,0,0,2,10,5,33730,13652,2567,19754,1
582,12336,1454,835,1044,76,110,219,1530,17,275,158,296,292,454,2297,3718,9,34017,1889,1,2,10,5,33740,13653,2567,19755,1
122,2653,1043,504,840,53,9,147,1096,9,180,112,198,189,310,1377,2344,4,11604,644,0,2,1,1,33740,13655,2567,19756,1
122,2653,383,288,292,26,6,62,409,11,65,38,67,76,105,429,656,5,3719,206,0,2,1,1,33740,13656,2567,19757,1
216,4657,182,127,129,0,0,53,182,5,39,21,42,44,63,217,343,2,926,51,0,2,7,4,33750,13660,2569,19765,0
216,4657,1165,710,800,67,119,181,1232,18,243,153,282,261,435,2000,3492,10,36473,2026,1,2,7,4,33760,13660,2570,19766,0
90,1955,477,336,357,30,23,73,507,16,194,134,250,210,384,1538,2962,10,30538,1696,0,2,3,2,33770,13661,2570,19767,0
55,1468,1455,414,1257,16,76,112,1471,5,41,23,46,46,69,231,381,2,1069,59,0,2,6,10,33770,13662,2570,19768,0
55,1468,669,365,481,22,61,110,691,15,103,63,122,118,185,747,1273,8,11311,628,0,2,6,10,33780,13662,2571,19769,0
175,4054,77,34,69,0,0,8,77,3,24,16,29,27,45,114,213,1,387,21,0,2,32,40,33780,13662,2571,19770,0
175,4054,712,438,573,51,9,84,763,14,102,71,128,116,199,733,1364,8,11988,666,0,2,32,40,33790,13663,2571,19771,0
220,4876,722,423,573,19,0,135,741,12,172,101,199,184,300,1320,2257,6,15668,870,0,2,7,4,33790,13665,2571,19773,0
220,4876,1508,847,911,44,250,301,1552,14,148,88,169,162,257,1120,1886,7,15077,837,0,2,7,4,33790,13666,2572,19774,0
568,12168,72,33,56,0,4,12,72,1,1,1,1,2,2,0,2,0,1,0,0,2,20,1,33790,13666,2572,19775,0
568,12168,1454,835,1044,76,110,219,1530,17,275,158,296,292,454,2297,3718,9,34017,1889,1,2,20,1,33800,13667,2572,19776,0
77,3179,1289,550,1043,56,32,155,1345,10,167,93,185,177,278,1266,2075,5,11498,638,0,2,70,9,33800,13669,2573,19777,0
139,6353,1392,870,1177,35,17,170,1427,14,494,280,531,508,811,4473,7289,7,54850,3047,2,2,12,0,33800,13672,2574,19778,0
145,6540,139,89,101,2,0,35,141,7,54,34,62,61,96,330,569,4,2287,127,0,2,119,0,33800,13672,2574,19779,0
145,6540,7,5,5,0,0,2,7,1,2,1,2,3,3,2,4,0,2,0,0,2,119,0,33800,13672,2574,19780,0
76,2747,1450,624,1228,12,26,181,1462,14,306,186,354,320,540,2580,4493,8,36391,2021,1,2,15,1,33800,13674,2575,19781,0
59,3272,1296,573,1062,40,33,157,1336,8,201,118,231,209,349,1561,2689,4,12365,686,0,2,3,1,33800,13674,2575,19782,0
55,2458,1455,414,1257,16,76,112,1471,5,41,23,46,46,69,231,381,2,1069,59,0,2,10,2,33800,13675,2575,19783,0
63,2641,1043,504,840,53,9,147,1096,9,180,112,198,189,310,1377,2344,4,11604,644,0,2,33,0,33800,13677,2575,19784,0
71,3617,1943,715,1694,26,18,214,1969,12,185,120,237,197,357,1436,2721,7,20915,1161,0,2,0,5,33800,13679,2575,19785,0
216,4657,182,127,129,0,0,53,182,5,39,21,42,44,63,217,343,2,926,51,0,2,7,4,33810,13683,2577,19793,0
216,4657,1165,710,800,67,119,181,1232,18,243,153,282,261,435,2000,3492,10,36473,2026,1,2,7,4,33820,13683,2578,19794,0
37,784,2,2,2,0,0,0,2,0,0,0,0,0,0,0,0,0,0,0,0,2,34,16,33820,13683,2578,19794,0
37,784,99,48,90,1,3,5,100,0,0,0,0,0,0,0,0,0,0,0,0,2,34,16,33820,13684,2578,19795,0
37,784,8,5,5,2,0,1,10,0,0,0,0,0,0,0,0,0,0,0,0,2,34,16,33820,13684,2578,19796,0
37,784,1217,716,841,84,126,174,1301,14,185,118,215,199,333,1446,2542,8,20687,1149,0,2,34,16,33830,13686,2578,19797,0
37,784,160,89,115,0,13,31,160,7,15,11,17,22,28,78,124,3,495,27,0,2,34,16,33830,13686,2578,19798,0
37,784,10,10,9,9,0,0,19,0,0,0,0,0,0,0,0,0,0,0,0,2,34,16,33830,13686,2579,19799,0
37,784,173,84,99,8,29,36,181,5,12,7,13,17,20,54,81,2,221,12,0,2,34,16,33830,13687,2579,19800,0
37,784,3,1,1,3,0,0,6,0,0,0,0,0,0,0,0,0,0,0,0,2,34,16,33830,13687,2579,19801,0
150,4791,1660,832,1314,41,38,274,1701,20,312,209,395,332,604,2671,5058,12,64042,3557,1,2,34,23,33830,13689,2580,19803,0
150,4791,1057,646,719,113,100,145,1170,18,215,134,248,233,382,1740,3004,10,31186,1732,1,2,34,23,33840,13690,2581,19804,0
90,1955,477,336,357,30,23,73,507,16,194,134,250,210,384,1538,2962,10,30538,1696,0,2,3,2,33850,13691,2581,19805,0
117,2369,1513,682,1277,25,13,200,1538,11,199,116,219,210,335,1557,2584,6,15641,868,0,2,1,1,33850,13693,2581,19806,0
117,2369,819,519,539,24,98,155,843,15,96,57,106,111,163,690,1107,8,9171,509,0,2,1,1,33860,13695,2581,19807,0
55,1468,1455,414,1257,16,76,112,1471,5,41,23,46,46,69,231,381,2,1069,59,0,2,6,10,33860,13696,2581,19808,0
55,1468,669,365,481,22,61,110,691,15,103,63,122,118,185,747,1273,8,11311,628,0,2,6,10,33870,13696,2582,19809,0
24,810,74,35,59,1,0,14,75,3,14,7,14,17,21,58,85,1,128,7,0,2,2,2,33870,13697,2582,19810,0
24,810,245,125,200,5,7,34,250,7,30,17,34,37,51,166,265,3,1053,58,0,2,2,2,33880,13698,2582,19811,0
47,548,647,139,84,35,284,233,682,0,0,0,0,0,0,0,0,0,0,0,0,2,1,1,33880,13698,2582,19812,0
175,4087,77,34,69,0,0,8,77,3,24,16,29,27,45,114,213,1,387,21,0,2,40,40,33880,13698,2582,19813,0
175,4087,712,438,573,51,9,84,763,14,102,71,128,116,199,733,1364,8,11988,666,0,2,40,40,33890,13699,2582,19814,0
220,4876,722,423,573,19,0,135,741,12,172,101,199,184,300,1320,2257,6,15668,870,0,2,22,19,33890,13701,2582,19816,0
220,4876,1508,847,911,44,250,301,1552,14,148,88,169,162,257,1120,1886,7,15077,837,0,2,22,19,33890,13702,2583,19817,0
584,12449,72,33,56,0,4,12,72,1,1,1,1,2,2,0,2,0,1,0,0,2,21,2,33890,13702,2583,19818,0
584,12449,1454,835,1044,76,110,219,1530,17,275,158,296,292,454,2297,3718,9,34017,1889,1,2,21,2,33900,13703,2583,19819,0
3,23,14,7,7,2,0,5,16,0,0,0,0,0,0,0,0,0,0,0,0,2,1,1,33900,13703,2583,19819,0
20,625,42,7,35,4,0,5,46,1,2,1,2,3,3,2,4,0,2,0,0,2,1,0,33900,13703,2583,19820,0
20,625,11,6,10,0,0,1,11,2,4,2,4,6,6,10,15,1,15,0,0,2,1,0,33900,13703,2583,19821,0
77,3179,1289,550,1043,56,32,155,1345,10,167,93,185,177,278,1266,2075,5,11498,638,0,2,76,13,33900,13705,2584,19822,0
139,6353,1392,870,1177,35,17,170,1427,14,494,280,531,508,811,4473,7289,7,54850,3047,2,2,12,0,33900,13708,2585,19823,0
145,6540,139,89,101,2,0,35,141,7,54,34,62,61,96,330,569,4,2287,127,0,2,119,0,33900,13708,2585,19825,0
145,6540,7,5,5,0,0,2,7,1,2,1,2,3,3,2,4,0,2,0,0,2,119,0,33900,13708,2585,19826,0
76,2747,1450,624,1228,12,26,181,1462,14,306,186,354,320,540,2580,4493,8,36391,2021,1,2,15,1,33900,13710,2586,19827,0
141,3690,1660,832,1314,41,38,274,1701,20,312,209,395,332,604,2671,5058,12,64042,3557,1,2,34,0,33900,13712,2587,19829,0
59,3272,1296,573,1062,40,33,157,1336,8,201,118,231,209,349,1561,2689,4,12365,686,0,2,114,1,33900,13712,2587,19830,0
59,2950,1457,730,1242,11,6,188,1468,10,292,166,329,302,495,2424,4078,5,22973,1276,1,2,9,4,33900,13714,2587,19831,0
55,2458,1455,414,1257,16,76,112,1471,5,41,23,46,46,69,231,381,2,1069,59,0,2,27,6,33900,13715,2587,19832,0
2,67,7,6,5,0,0,2,7,1,1,1,2,2,3,0,3,1,3,0,0,0,13,0,33900,13715,2587,19833,0
8,265,74,35,59,1,0,14,75,3,14,7,14,17,21,58,85,1,128,7,0,2,2,2,33900,13716,2587,19834,0
75,3651,1523,757,1297,19,12,193,1542,12,193,117,230,205,347,1508,2664,7,19053,1058,0,2,1,1,33910,13718,2587,19835,0
38,2201,334,251,279,10,4,40,344,5,127,74,143,132,217,899,1528,2,4303,239,0,2,6,7,33910,13719,2587,19836,0
16,1265,215,129,180,6,0,29,221,8,65,43,72,73,115,415,711,4,3153,175,0,2,1,1,33910,13719,2587,19837,0
63,2641,1043,504,840,53,9,147,1096,9,180,112,198,189,310,1377,2344,4,11604,644,0,2,33,0,33910,13721,2587,19838,0
71,3617,1943,715,1694,26,18,214,1969,12,185,120,237,197,357,1436,2721,7,20915,1161,0,2,1,6,33910,13723,2587,19839,0
307,6253,1457,730,1242,11,6,188,1468,10,292,166,329,302,495,2424,4078,5,22973,1276,1,2,4,0,33910,13725,2587,19840,0
307,6253,74,35,59,1,0,14,75,3,14,7,14,17,21,58,85,1,128,7,0,2,4,0,33910,13726,2587,19841,0
307,6253,245,125,200,5,7,34,250,7,30,17,34,37,51,166,265,3,1053,58,0,2,4,0,33920,13727,2587,19842,0
39,2266,334,251,279,10,4,40,344,5,127,74,143,132,217,899,1528,2,4303,239,0,2,7,0,33920,13728,2587,19843,0
307,6253,1457,730,1242,11,6,188,1468,10,292,166,329,302,495,2424,4078,5,22973,1276,1,2,4,0,33920,13730,2587,19844,0
307,6253,74,35,59,1,0,14,75,3,14,7,14,17,21,58,85,1,128,7,0,2,4,0,33920,13731,2587,19845,0
307,6253,245,125,200,5,7,34,250,7,30,17,34,37,51,166,265,3,1053,58,0,2,4,0,33930,13732,2587,19846,0
39,2266,334,251,279,10,4,40,344,5,127,74,143,132,217,899,1528,2,4303,239,0,2,7,0,33930,13733,2587,19847,0
584,12469,72,33,56,0,4,12,72,1,1,1,1,2,2,0,2,0,1,0,0,2,3,1,33930,13733,2587,19848,0
584,12469,1454,835,1044,76,110,219,1530,17,275,158,296,292,454,2297,3718,9,34017,1889,1,2,3,1,33940,13734,2587,19849,0
122,2648,1043,504,840,53,9,147,1096,9,180,112,198,189,310,1377,2344,4,11604,644,0,2,1,1,33940,13736,2587,19850,0
122,2648,383,288,292,26,6,62,409,11,65,38,67,76,105,429,656,5,3719,206,0,2,1,1,33940,13737,2587,19851,0
585,12481,72,33,56,0,4,12,72,1,1,1,1,2,2,0,2,0,1,0,0,2,9,7,33940,13737,2587,19852,0
585,12481,1454,835,1044,76,110,219,1530,17,275,158,296,292,454,2297,3718,9,34017,1889,1,2,9,7,33950,13738,2587,19853,0
53,1425,1455,414,1257,16,76,112,1471,5,41,23,46,46,69,231,381,2,1069,59,0,2,1,1,33950,13739,2587,19854,1
53,1425,669,365,481,22,61,110,691,15,103,63,122,118,185,747,1273,8,11311,628,0,2,1,1,33960,13739,2588,19855,1
517,11149,72,33,56,0,4,12,72,1,1,1,1,2,2,0,2,0,1,0,0,2,17,10,33960,13739,2588,19856,1
517,11149,1454,835,1044,76,110,219,1530,17,275,158,296,292,454,2297,3718,9,34017,1889,1,2,17,10,33970,13740,2588,19857,1
122,5398,1392,870,1177,35,17,170,1427,14,494,280,531,508,811,4473,7289,7,54850,3047,2,2,1,1,33970,13743,2589,19858,1
147,6532,139,89,101,2,0,35,141,7,54,34,62,61,96,330,569,4,2287,127,0,2,27,19,33970,13743,2589,19859,1
147,6532,7,5,5,0,0,2,7,1,2,1,2,3,3,2,4,0,2,0,0,2,27,19,33970,13743,2589,19860,1
83,4488,1782,648,1425,9,47,279,1791,8,171,97,189,179,286,1292,2140,4,9462,525,0,2,2,2,33970,13744,2590,19861,1
34,1289,1293,570,1093,25,15,163,1318,10,195,123,241,205,364,1516,2795,6,17273,959,0,2,1,1,33980,13746,2590,19862,1
53,1425,1455,414,1257,16,76,112,1471,5,41,23,46,46,69,231,381,2,1069,59,0,2,1,1,33980,13747,2590,19863,0
53,1425,669,365,481,22,61,110,691,15,103,63,122,118,185,747,1273,8,11311,628,0,2,1,1,33990,13747,2591,19864,0
517,11149,72,33,56,0,4,12,72,1,1,1,1,2,2,0,2,0,1,0,0,2,17,10,33990,13747,2591,19865,0
517,11149,1454,835,1044,76,110,219,1530,17,275,158,296,292,454,2297,3718,9,34017,1889,1,2,17,10,34000,13748,2591,19866,0
122,5398,1392,870,1177,35,17,170,1427,14,494,280,531,508,811,4473,7289,7,54850,3047,2,2,1,1,34000,13751,2592,19867,0
147,6532,139,89,101,2,0,35,141,7,54,34,62,61,96,330,569,4,2287,127,0,2,27,19,34000,13751,2592,19868,0
147,6532,7,5,5,0,0,2,7,1,2,1,2,3,3,2,4,0,2,0,0,2,27,19,34000,13751,2592,19869,0
83,4488,1782,648,1425,9,47,279,1791,8,171,97,189,179,286,1292,2140,4,9462,525,0,2,2,2,34000,13752,2593,19870,0
34,1289,1293,570,1093,25,15,163,1318,10,195,123,241,205,364,1516,2795,6,17273,959,0,2,1,1,34010,13754,2593,19871,0
82,1803,477,336,357,30,23,73,507,16,194,134,250,210,384,1538,2962,10,30538,1696,0,2,0,33,34020,13755,2593,19872,1
135,3546,1660,832,1314,41,38,274,1701,20,312,209,395,332,604,2671,5058,12,64042,3557,1,2,20,14,34020,13757,2594,19874,1
82,1803,477,336,357,30,23,73,507,16,194,134,250,210,384,1538,2962,10,30538,1696,0,2,0,33,34030,13758,2594,19875,0
135,3546,1660,832,1314,41,38,274,1701,20,312,209,395,332,604,2671,5058,12,64042,3557,1,2,20,14,34030,13760,2595,19877,0
569,12184,72,33,56,0,4,12,72,1,1,1,1,2,2,0,2,0,1,0,0,2,6,0,34030,13760,2595,19878,1
569,12184,1454,835,1044,76,110,219,1530,17,275,158,296,292,454,2297,3718,9,34017,1889,1,2,6,0,34040,13761,2595,19879,1
76,3740,1523,757,1297,19,12,193,1542,12,193,117,230,205,347,1508,2664,7,19053,1058,0,2,41,18,34050,13763,2595,19880,1
16,1198,215,129,180,6,0,29,221,8,65,43,72,73,115,415,711,4,3153,175,0,2,0,9,34050,13763,2595,19881,1
62,2603,1043,504,840,53,9,147,1096,9,180,112,198,189,310,1377,2344,4,11604,644,0,2,0,12,34050,13765,2595,19882,1
22,942,373,158,315,8,0,51,381,5,76,44,79,81,123,486,779,2,2026,112,0,2,1,7,34050,13765,2595,19883,1
67,2869,1178,367,1042,6,15,115,1184,9,94,51,95,103,146,644,976,4,4439,246,0,2,17,5,34050,13765,2595,19884,1
71,3615,1943,715,1694,26,18,214,1969,12,185,120,237,197,357,1436,2721,7,20915,1161,0,2,1,2,34050,13767,2595,19885,1
303,6208,1457,730,1242,11,6,188,1468,10,292,166,329,302,495,2424,4078,5,22973,1276,1,2,7,10,34050,13769,2595,19886,0
303,6208,74,35,59,1,0,14,75,3,14,7,14,17,21,58,85,1,128,7,0,2,7,10,34050,13770,2595,19887,0
303,6208,245,125,200,5,7,34,250,7,30,17,34,37,51,166,265,3,1053,58,0,2,7,10,34060,13771,2595,19888,0
38,2210,334,251,279,10,4,40,344,5,127,74,143,132,217,899,1528,2,4303,239,0,2,3,0,34060,13772,2595,19889,0
303,6198,1457,730,1242,11,6,188,1468,10,292,166,329,302,495,2424,4078,5,22973,1276,1,2,1,4,34060,13774,2595,19890,1
303,6198,74,35,59,1,0,14,75,3,14,7,14,17,21,58,85,1,128,7,0,2,1,4,34060,13775,2595,19891,1
303,6198,245,125,200,5,7,34,250,7,30,17,34,37,51,166,265,3,1053,58,0,2,1,4,34070,13776,2595,19892,1
61,3038,1457,730,1242,11,6,188,1468,10,292,166,329,302,495,2424,4078,5,22973,1276,1,2,17,0,34070,13778,2595,19893,1
304,6218,1457,730,1242,11,6,188,1468,10,292,166,329,302,495,2424,4078,5,22973,1276,1,2,1,1,34080,13780,2595,19895,1
304,6218,74,35,59,1,0,14,75,3,14,7,14,17,21,58,85,1,128,7,0,2,1,1,34080,13781,2595,19896,1
304,6218,245,125,200,5,7,34,250,7,30,17,34,37,51,166,265,3,1053,58,0,2,1,1,34090,13782,2595,19897,1
49,571,647,139,84,35,284,233,682,0,0,0,0,0,0,0,0,0,0,0,0,2,13,0,34090,13782,2595,19898,1
570,12235,72,33,56,0,4,12,72,1,1,1,1,2,2,0,2,0,1,0,0,2,35,74,34090,13782,2595,19899,1
570,12235,1454,835,1044,76,110,219,1530,17,275,158,296,292,454,2297,3718,9,34017,1889,1,2,35,74,34100,13783,2595,19900,1
17,325,294,64,250,0,0,43,294,1,20,10,20,21,30,86,131,0,65,3,0,0,54,0,34100,13783,2595,19901,1
17,325,78,46,62,3,0,14,81,3,8,4,8,11,12,28,41,1,62,3,0,0,54,0,34100,13784,2595,19902,1
4,72,110,30,77,3,13,16,113,4,21,15,30,25,45,100,208,2,597,33,0,0,14,0,34100,13784,2595,19903,1
4,72,28,15,21,1,0,6,29,0,0,0,0,0,0,0,0,0,0,0,0,0,14,0,34100,13784,2595,19904,1
175,4054,77,34,69,0,0,8,77,3,24,16,29,27,45,114,213,1,387,21,0,2,0,5,34100,13784,2595,19905,0
175,4054,712,438,573,51,9,84,763,14,102,71,128,116,199,733,1364,8,11988,666,0,2,0,5,34110,13785,2595,19906,0
18,355,294,64,250,0,0,43,294,1,20,10,20,21,30,86,131,0,65,3,0,2,5,0,34110,13785,2595,19907,0
18,355,78,46,62,3,0,14,81,3,8,4,8,11,12,28,41,1,62,3,0,2,5,0,34110,13786,2595,19908,0
5,103,110,30,77,3,13,16,113,4,21,15,30,25,45,100,208,2,597,33,0,2,5,0,34110,13786,2595,19909,0
5,103,28,15,21,1,0,6,29,0,0,0,0,0,0,0,0,0,0,0,0,2,5,0,34110,13786,2595,19910,0
15,485,42,7,35,4,0,5,46,1,2,1,2,3,3,2,4,0,2,0,0,2,2,24,34110,13786,2595,19911,1
15,485,11,6,10,0,0,1,11,2,4,2,4,6,6,10,15,1,15,0,0,2,2,24,34110,13786,2595,19912,1
304,6218,1457,730,1242,11,6,188,1468,10,292,166,329,302,495,2424,4078,5,22973,1276,1,2,1,1,34110,13788,2595,19913,1
304,6218,74,35,59,1,0,14,75,3,14,7,14,17,21,58,85,1,128,7,0,2,1,1,34110,13789,2595,19914,1
304,6218,245,125,200,5,7,34,250,7,30,17,34,37,51,166,265,3,1053,58,0,2,1,1,34120,13790,2595,19915,1
34,1289,1293,570,1093,25,15,163,1318,10,195,123,241,205,364,1516,2795,6,17273,959,0,2,1,1,34130,13792,2595,19916,1
303,6198,1457,730,1242,11,6,188,1468,10,292,166,329,302,495,2424,4078,5,22973,1276,1,2,1,4,34130,13794,2595,19917,0
303,6198,74,35,59,1,0,14,75,3,14,7,14,17,21,58,85,1,128,7,0,2,1,4,34130,13795,2595,19918,0
303,6198,245,125,200,5,7,34,250,7,30,17,34,37,51,166,265,3,1053,58,0,2,1,4,34140,13796,2595,19919,0
61,3038,1457,730,1242,11,6,188,1468,10,292,166,329,302,495,2424,4078,5,22973,1276,1,2,17,0,34140,13798,2595,19920,0
302,6188,1457,730,1242,11,6,188,1468,10,292,166,329,302,495,2424,4078,5,22973,1276,1,2,7,10,34140,13800,2595,19921,0
302,6188,74,35,59,1,0,14,75,3,14,7,14,17,21,58,85,1,128,7,0,2,7,10,34140,13801,2595,19922,0
302,6188,245,125,200,5,7,34,250,7,30,17,34,37,51,166,265,3,1053,58,0,2,7,10,34150,13802,2595,19923,0
38,2210,334,251,279,10,4,40,344,5,127,74,143,132,217,899,1528,2,4303,239,0,2,3,0,34150,13803,2595,19924,0
302,6188,1457,730,1242,11,6,188,1468,10,292,166,329,302,495,2424,4078,5,22973,1276,1,2,1,1,34150,13805,2595,19925,0
302,6188,74,35,59,1,0,14,75,3,14,7,14,17,21,58,85,1,128,7,0,2,1,1,34150,13806,2595,19926,0
302,6188,245,125,200,5,7,34,250,7,30,17,34,37,51,166,265,3,1053,58,0,2,1,1,34160,13807,2595,19927,0
34,1289,1293,570,1093,25,15,163,1318,10,195,123,241,205,364,1516,2795,6,17273,959,0,2,1,1,34180,13809,2595,19929,0
569,12184,72,33,56,0,4,12,72,1,1,1,1,2,2,0,2,0,1,0,0,2,6,0,34180,13809,2595,19930,0
569,12184,1454,835,1044,76,110,219,1530,17,275,158,296,292,454,2297,3718,9,34017,1889,1,2,6,0,34190,13810,2595,19931,0
76,3740,1523,757,1297,19,12,193,1542,12,193,117,230,205,347,1508,2664,7,19053,1058,0,2,41,18,34200,13812,2595,19932,0
16,1198,215,129,180,6,0,29,221,8,65,43,72,73,115,415,711,4,3153,175,0,2,0,9,34200,13812,2595,19933,0
62,2603,1043,504,840,53,9,147,1096,9,180,112,198,189,310,1377,2344,4,11604,644,0,2,0,12,34200,13814,2595,19934,0
22,942,373,158,315,8,0,51,381,5,76,44,79,81,123,486,779,2,2026,112,0,2,1,7,34200,13814,2595,19935,0
67,2869,1178,367,1042,6,15,115,1184,9,94,51,95,103,146,644,976,4,4439,246,0,2,17,5,34200,13814,2595,19936,0
71,3615,1943,715,1694,26,18,214,1969,12,185,120,237,197,357,1436,2721,7,20915,1161,0,2,1,2,34200,13816,2595,19937,0
66,2745,1020,354,843,12,15,144,1032,8,134,77,144,142,221,970,1580,4,6792,377,0,2,26,0,34200,13816,2595,19938,1
307,6253,1457,730,1242,11,6,188,1468,10,292,166,329,302,495,2424,4078,5,22973,1276,1,2,1,1,34200,13818,2595,19939,0
307,6253,74,35,59,1,0,14,75,3,14,7,14,17,21,58,85,1,128,7,0,2,1,1,34200,13819,2595,19940,0
307,6253,245,125,200,5,7,34,250,7,30,17,34,37,51,166,265,3,1053,58,0,2,1,1,34210,13820,2595,19941,0
49,571,647,139,84,35,284,233,682,0,0,0,0,0,0,0,0,0,0,0,0,2,13,0,34210,13820,2595,19942,0
571,12251,72,33,56,0,4,12,72,1,1,1,1,2,2,0,2,0,1,0,0,2,35,26,34210,13820,2595,19943,0
571,12251,1454,835,1044,76,110,219,1530,17,275,158,296,292,454,2297,3718,9,34017,1889,1,2,35,26,34220,13821,2595,19944,0
122,2648,1043,504,840,53,9,147,1096,9,180,112,198,189,310,1377,2344,4,11604,644,0,2,14,1,34220,13823,2595,19945,0
122,2648,383,288,292,26,6,62,409,11,65,38,67,76,105,429,656,5,3719,206,0,2,14,1,34220,13824,2595,19946,0
18,355,294,64,250,0,0,43,294,1,20,10,20,21,30,86,131,0,65,3,0,0,59,0,34220,13824,2595,19947,0
18,355,78,46,62,3,0,14,81,3,8,4,8,11,12,28,41,1,62,3,0,0,59,0,34220,13825,2595,19948,0
5,103,110,30,77,3,13,16,113,4,21,15,30,25,45,100,208,2,597,33,0,0,19,0,34220,13825,2595,19949,0
5,103,28,15,21,1,0,6,29,0,0,0,0,0,0,0,0,0,0,0,0,0,19,0,34220,13825,2595,19950,0
313,6325,1457,730,1242,11,6,188,1468,10,292,166,329,302,495,2424,4078,5,22973,1276,1,2,24,8,34220,13827,2595,19951,1
313,6325,74,35,59,1,0,14,75,3,14,7,14,17,21,58,85,1,128,7,0,2,24,8,34220,13828,2595,19952,1
313,6325,245,125,200,5,7,34,250,7,30,17,34,37,51,166,265,3,1053,58,0,2,24,8,34230,13829,2595,19953,1
24,834,74,35,59,1,0,14,75,3,14,7,14,17,21,58,85,1,128,7,0,2,4,0,34230,13830,2595,19954,1
24,834,245,125,200,5,7,34,250,7,30,17,34,37,51,166,265,3,1053,58,0,2,4,0,34240,13831,2595,19955,1
62,3185,1457,730,1242,11,6,188,1468,10,292,166,329,302,495,2424,4078,5,22973,1276,1,2,89,0,34240,13833,2595,19956,1
313,6325,1457,730,1242,11,6,188,1468,10,292,166,329,302,495,2424,4078,5,22973,1276,1,2,24,8,34240,13835,2595,19957,0
313,6325,74,35,59,1,0,14,75,3,14,7,14,17,21,58,85,1,128,7,0,2,24,8,34240,13836,2595,19958,0
313,6325,245,125,200,5,7,34,250,7,30,17,34,37,51,166,265,3,1053,58,0,2,24,8,34250,13837,2595,19959,0
24,834,74,35,59,1,0,14,75,3,14,7,14,17,21,58,85,1,128,7,0,2,4,0,34250,13838,2595,19960,0
24,834,245,125,200,5,7,34,250,7,30,17,34,37,51,166,265,3,1053,58,0,2,4,0,34260,13839,2595,19961,0
62,3185,1457,730,1242,11,6,188,1468,10,292,166,329,302,495,2424,4078,5,22973,1276,1,2,89,0,34260,13841,2595,19962,0
149,4786,1660,832,1314,41,38,274,1701,20,312,209,395,332,604,2671,5058,12,64042,3557,1,2,7,0,34260,13843,2596,19964,1
149,4786,1057,646,719,113,100,145,1170,18,215,134,248,233,382,1740,3004,10,31186,1732,1,2,7,0,34270,13844,2597,19965,1
138,3638,1660,832,1314,41,38,274,1701,20,312,209,395,332,604,2671,5058,12,64042,3557,1,2,27,0,34270,13846,2598,19967,1
185,3788,1943,715,1694,26,18,214,1969,12,185,120,237,197,357,1436,2721,7,20915,1161,0,2,11,2,34270,13848,2598,19968,1
185,3788,1168,838,957,57,25,144,1225,19,348,224,416,367,640,3018,5452,11,61921,3440,1,2,11,2,34280,13850,2598,19969,1
58,2959,1457,730,1242,11,6,188,1468,10,292,166,329,302,495,2424,4078,5,22973,1276,1,2,1,1,34280,13852,2598,19970,1
71,3662,1943,715,1694,26,18,214,1969,12,185,120,237,197,357,1436,2721,7,20915,1161,0,2,12,2,34280,13854,2598,19971,1
153,4888,1660,832,1314,41,38,274,1701,20,312,209,395,332,604,2671,5058,12,64042,3557,1,2,15,5,34280,13856,2599,19973,1
153,4888,1057,646,719,113,100,145,1170,18,215,134,248,233,382,1740,3004,10,31186,1732,1,2,15,5,34290,13857,2600,19974,1
77,2775,1450,624,1228,12,26,181,1462,14,306,186,354,320,540,2580,4493,8,36391,2021,1,2,8,0,34290,13859,2601,19975,1
78,2812,1450,624,1228,12,26,181,1462,14,306,186,354,320,540,2580,4493,8,36391,2021,1,2,10,0,34290,13861,2602,19976,0
185,3788,1943,715,1694,26,18,214,1969,12,185,120,237,197,357,1436,2721,7,20915,1161,0,2,1,1,34290,13863,2602,19977,1
185,3788,1168,838,957,57,25,144,1225,19,348,224,416,367,640,3018,5452,11,61921,3440,1,2,1,1,34300,13865,2602,19978,1
71,3662,1943,715,1694,26,18,214,1969,12,185,120,237,197,357,1436,2721,7,20915,1161,0,2,1,1,34300,13867,2602,19979,1
35,724,2,2,2,0,0,0,2,0,0,0,0,0,0,0,0,0,0,0,0,2,0,13,34300,13867,2602,19979,1
35,724,99,48,90,1,3,5,100,0,0,0,0,0,0,0,0,0,0,0,0,2,0,13,34300,13868,2602,19980,1
35,724,8,5,5,2,0,1,10,0,0,0,0,0,0,0,0,0,0,0,0,2,0,13,34300,13868,2602,19981,1
35,724,1217,716,841,84,126,174,1301,14,185,118,215,199,333,1446,2542,8,20687,1149,0,2,0,13,34310,13870,2602,19982,1
35,724,160,89,115,0,13,31,160,7,15,11,17,22,28,78,124,3,495,27,0,2,0,13,34310,13870,2602,19983,1
35,724,10,10,9,9,0,0,19,0,0,0,0,0,0,0,0,0,0,0,0,2,0,13,34310,13870,2603,19984,1
35,724,173,84,99,8,29,36,181,5,12,7,13,17,20,54,81,2,221,12,0,2,0,13,34310,13871,2603,19985,1
35,724,3,1,1,3,0,0,6,0,0,0,0,0,0,0,0,0,0,0,0,2,0,13,34310,13871,2603,19986,1
313,6325,1457,730,1242,11,6,188,1468,10,292,166,329,302,495,2424,4078,5,22973,1276,1,2,1,1,34310,13873,2603,19987,1
313,6325,74,35,59,1,0,14,75,3,14,7,14,17,21,58,85,1,128,7,0,2,1,1,34310,13874,2603,19988,1
313,6325,245,125,200,5,7,34,250,7,30,17,34,37,51,166,265,3,1053,58,0,2,1,1,34320,13875,2603,19989,1
176,3641,1943,715,1694,26,18,214,1969,12,185,120,237,197,357,1436,2721,7,20915,1161,0,2,0,14,34320,13877,2603,19990,1
176,3641,1168,838,957,57,25,144,1225,19,348,224,416,367,640,3018,5452,11,61921,3440,1,2,0,14,34330,13879,2603,19991,1
75,2695,1450,624,1228,12,26,181,1462,14,306,186,354,320,540,2580,4493,8,36391,2021,1,2,3,11,34330,13881,2604,19992,1
62,3181,1457,730,1242,11,6,188,1468,10,292,166,329,302,495,2424,4078,5,22973,1276,1,2,1,1,34330,13883,2604,19993,1
67,2869,1178,367,1042,6,15,115,1184,9,94,51,95,103,146,644,976,4,4439,246,0,2,3,3,34330,13883,2604,19994,1
71,3566,1943,715,1694,26,18,214,1969,12,185,120,237,197,357,1436,2721,7,20915,1161,0,2,0,9,34330,13885,2604,19995,1
313,6326,1457,730,1242,11,6,188,1468,10,292,166,329,302,495,2424,4078,5,22973,1276,1,2,2,1,34330,13887,2604,19996,1
313,6326,74,35,59,1,0,14,75,3,14,7,14,17,21,58,85,1,128,7,0,2,2,1,34330,13888,2604,19997,1
313,6326,245,125,200,5,7,34,250,7,30,17,34,37,51,166,265,3,1053,58,0,2,2,1,34340,13889,2604,19998,1
7,139,44,22,19,0,19,6,44,2,10,6,12,12,18,35,64,1,77,4,0,0,45,0,34340,13889,2604,19999,1
15,485,42,7,35,4,0,5,46,1,2,1,2,3,3,2,4,0,2,0,0,2,2,24,34340,13889,2604,20000,0
15,485,11,6,10,0,0,1,11,2,4,2,4,6,6,10,15,1,15,0,0,2,2,24,34340,13889,2604,20001,0
35,724,2,2,2,0,0,0,2,0,0,0,0,0,0,0,0,0,0,0,0,2,0,13,34340,13889,2604,20001,0
35,724,99,48,90,1,3,5,100,0,0,0,0,0,0,0,0,0,0,0,0,2,0,13,34340,13890,2604,20002,0
35,724,8,5,5,2,0,1,10,0,0,0,0,0,0,0,0,0,0,0,0,2,0,13,34340,13890,2604,20003,0
35,724,1217,716,841,84,126,174,1301,14,185,118,215,199,333,1446,2542,8,20687,1149,0,2,0,13,34350,13892,2604,20004,0
35,724,160,89,115,0,13,31,160,7,15,11,17,22,28,78,124,3,495,27,0,2,0,13,34350,13892,2604,20005,0
35,724,10,10,9,9,0,0,19,0,0,0,0,0,0,0,0,0,0,0,0,2,0,13,34350,13892,2605,20006,0
35,724,173,84,99,8,29,36,181,5,12,7,13,17,20,54,81,2,221,12,0,2,0,13,34350,13893,2605,20007,0
35,724,3,1,1,3,0,0,6,0,0,0,0,0,0,0,0,0,0,0,0,2,0,13,34350,13893,2605,20008,0
313,6326,1457,730,1242,11,6,188,1468,10,292,166,329,302,495,2424,4078,5,22973,1276,1,2,3,2,34350,13895,2605,20009,0
313,6326,74,35,59,1,0,14,75,3,14,7,14,17,21,58,85,1,128,7,0,2,3,2,34350,13896,2605,20010,0
313,6326,245,125,200,5,7,34,250,7,30,17,34,37,51,166,265,3,1053,58,0,2,3,2,34360,13897,2605,20011,0
7,139,44,22,19,0,19,6,44,2,10,6,12,12,18,35,64,1,77,4,0,0,45,0,34360,13897,2605,20012,0
176,3641,1943,715,1694,26,18,214,1969,12,185,120,237,197,357,1436,2721,7,20915,1161,0,2,0,14,34360,13899,2605,20013,0
176,3641,1168,838,957,57,25,144,1225,19,348,224,416,367,640,3018,5452,11,61921,3440,1,2,0,14,34370,13901,2605,20014,0
75,2695,1450,624,1228,12,26,181,1462,14,306,186,354,320,540,2580,4493,8,36391,2021,1,2,3,11,34370,13903,2606,20015,0
62,3181,1457,730,1242,11,6,188,1468,10,292,166,329,302,495,2424,4078,5,22973,1276,1,2,1,1,34370,13905,2606,20016,0
67,2869,1178,367,1042,6,15,115,1184,9,94,51,95,103,146,644,976,4,4439,246,0,2,3,3,34370,13905,2606,20017,0
71,3566,1943,715,1694,26,18,214,1969,12,185,120,237,197,357,1436,2721,7,20915,1161,0,2,0,9,34370,13907,2606,20018,0
15,485,42,7,35,4,0,5,46,1,2,1,2,3,3,2,4,0,2,0,0,2,2,24,34370,13907,2606,20019,0
15,485,11,6,10,0,0,1,11,2,4,2,4,6,6,10,15,1,15,0,0,2,2,24,34370,13907,2606,20020,0
153,4888,1660,832,1314,41,38,274,1701,20,312,209,395,332,604,2671,5058,12,64042,3557,1,2,15,5,34370,13909,2607,20022,0
153,4888,1057,646,719,113,100,145,1170,18,215,134,248,233,382,1740,3004,10,31186,1732,1,2,15,5,34380,13910,2608,20023,0
77,2760,1450,624,1228,12,26,181,1462,14,306,186,354,320,540,2580,4493,8,36391,2021,1,2,18,0,34380,13912,2609,20024,0
149,4786,1660,832,1314,41,38,274,1701,20,312,209,395,332,604,2671,5058,12,64042,3557,1,2,0,2,34380,13914,2610,20026,0
149,4786,1057,646,719,113,100,145,1170,18,215,134,248,233,382,1740,3004,10,31186,1732,1,2,0,2,34390,13915,2611,20027,0
149,4786,1660,832,1314,41,38,274,1701,20,312,209,395,332,604,2671,5058,12,64042,3557,1,2,5,0,34390,13917,2612,20029,0
149,4786,1057,646,719,113,100,145,1170,18,215,134,248,233,382,1740,3004,10,31186,1732,1,2,5,0,34400,13918,2613,20030,0
138,3638,1660,832,1314,41,38,274,1701,20,312,209,395,332,604,2671,5058,12,64042,3557,1,2,27,0,34400,13920,2614,20032,0
66,2745,1020,354,843,12,15,144,1032,8,134,77,144,142,221,970,1580,4,6792,377,0,2,2,2,34400,13920,2614,20033,0
66,2745,1020,354,843,12,15,144,1032,8,134,77,144,142,221,970,1580,4,6792,377,0,2,26,0,34400,13920,2614,20034,0
14,470,42,7,35,4,0,5,46,1,2,1,2,3,3,2,4,0,2,0,0,2,3,3,34400,13920,2614,20035,1
14,470,11,6,10,0,0,1,11,2,4,2,4,6,6,10,15,1,15,0,0,2,3,3,34400,13920,2614,20036,1
92,2960,773,419,590,28,0,166,801,10,204,113,217,214,330,1598,2554,5,13587,754,0,2,1,3,34400,13920,2615,20037,1
14,470,42,7,35,4,0,5,46,1,2,1,2,3,3,2,4,0,2,0,0,2,3,3,34400,13920,2615,20038,0
14,470,11,6,10,0,0,1,11,2,4,2,4,6,6,10,15,1,15,0,0,2,3,3,34400,13920,2615,20039,0
92,2960,773,419,590,28,0,166,801,10,204,113,217,214,330,1598,2554,5,13587,754,0,2,1,3,34400,13920,2616,20040,0
35,724,2,2,2,0,0,0,2,0,0,0,0,0,0,0,0,0,0,0,0,2,0,13,34400,13920,2616,20040,0
35,724,99,48,90,1,3,5,100,0,0,0,0,0,0,0,0,0,0,0,0,2,0,13,34400,13921,2616,20041,0
35,724,8,5,5,2,0,1,10,0,0,0,0,0,0,0,0,0,0,0,0,2,0,13,34400,13921,2616,20042,0
35,724,1217,716,841,84,126,174,1301,14,185,118,215,199,333,1446,2542,8,20687,1149,0,2,0,13,34410,13923,2616,20043,0
35,724,160,89,115,0,13,31,160,7,15,11,17,22,28,78,124,3,495,27,0,2,0,13,34410,13923,2616,20044,0
35,724,10,10,9,9,0,0,19,0,0,0,0,0,0,0,0,0,0,0,0,2,0,13,34410,13923,2617,20045,0
35,724,173,84,99,8,29,36,181,5,12,7,13,17,20,54,81,2,221,12,0,2,0,13,34410,13924,2617,20046,0
35,724,3,1,1,3,0,0,6,0,0,0,0,0,0,0,0,0,0,0,0,2,0,13,34410,13924,2617,20047,0
153,4888,1660,832,1314,41,38,274,1701,20,312,209,395,332,604,2671,5058,12,64042,3557,1,2,15,5,34410,13926,2618,20049,0
153,4888,1057,646,719,113,100,145,1170,18,215,134,248,233,382,1740,3004,10,31186,1732,1,2,15,5,34420,13927,2619,20050,0
313,6326,1457,730,1242,11,6,188,1468,10,292,166,329,302,495,2424,4078,5,22973,1276,1,2,31,10,34420,13929,2619,20051,0
313,6326,74,35,59,1,0,14,75,3,14,7,14,17,21,58,85,1,128,7,0,2,31,10,34420,13930,2619,20052,0
313,6326,245,125,200,5,7,34,250,7,30,17,34,37,51,166,265,3,1053,58,0,2,31,10,34430,13931,2619,20053,0
7,139,44,22,19,0,19,6,44,2,10,6,12,12,18,35,64,1,77,4,0,0,45,0,34430,13931,2619,20054,0
24,834,74,35,59,1,0,14,75,3,14,7,14,17,21,58,85,1,128,7,0,2,4,0,34430,13932,2619,20055,0
24,834,245,125,200,5,7,34,250,7,30,17,34,37,51,166,265,3,1053,58,0,2,4,0,34440,13933,2619,20056,0
571,12251,72,33,56,0,4,12,72,1,1,1,1,2,2,0,2,0,1,0,0,2,6,0,34440,13933,2619,20057,0
571,12251,1454,835,1044,76,110,219,1530,17,275,158,296,292,454,2297,3718,9,34017,1889,1,2,6,0,34450,13934,2619,20058,0
176,3641,1943,715,1694,26,18,214,1969,12,185,120,237,197,357,1436,2721,7,20915,1161,0,2,0,14,34450,13936,2619,20059,0
176,3641,1168,838,957,57,25,144,1225,19,348,224,416,367,640,3018,5452,11,61921,3440,1,2,0,14,34460,13938,2619,20060,0
14,470,42,7,35,4,0,5,46,1,2,1,2,3,3,2,4,0,2,0,0,2,5,27,34460,13938,2619,20061,0
14,470,11,6,10,0,0,1,11,2,4,2,4,6,6,10,15,1,15,0,0,2,5,27,34460,13938,2619,20062,0
92,2960,773,419,590,28,0,166,801,10,204,113,217,214,330,1598,2554,5,13587,754,0,2,1,3,34460,13938,2620,20063,0
77,2760,1450,624,1228,12,26,181,1462,14,306,186,354,320,540,2580,4493,8,36391,2021,1,2,21,11,34460,13940,2621,20064,0
62,3181,1457,730,1242,11,6,188,1468,10,292,166,329,302,495,2424,4078,5,22973,1276,1,2,90,1,34460,13942,2621,20065,0
76,3740,1523,757,1297,19,12,193,1542,12,193,117,230,205,347,1508,2664,7,19053,1058,0,2,41,18,34470,13944,2621,20066,0
66,2745,1020,354,843,12,15,144,1032,8,134,77,144,142,221,970,1580,4,6792,377,0,2,26,0,34470,13944,2621,20067,0
39,2266,334,251,279,10,4,40,344,5,127,74,143,132,217,899,1528,2,4303,239,0,2,7,0,34470,13945,2621,20068,0
16,1198,215,129,180,6,0,29,221,8,65,43,72,73,115,415,711,4,3153,175,0,2,0,9,34470,13945,2621,20069,0
62,2603,1043,504,840,53,9,147,1096,9,180,112,198,189,310,1377,2344,4,11604,644,0,2,0,12,34470,13947,2621,20070,0
22,942,373,158,315,8,0,51,381,5,76,44,79,81,123,486,779,2,2026,112,0,2,1,7,34470,13947,2621,20071,0
67,2869,1178,367,1042,6,15,115,1184,9,94,51,95,103,146,644,976,4,4439,246,0,2,20,8,34470,13947,2621,20072,0
71,3566,1943,715,1694,26,18,214,1969,12,185,120,237,197,357,1436,2721,7,20915,1161,0,2,1,11,34470,13949,2621,20073,0
122,2648,1043,504,840,53,9,147,1096,9,180,112,198,189,310,1377,2344,4,11604,644,0,2,2,2,34470,13951,2621,20074,1
122,2648,383,288,292,26,6,62,409,11,65,38,67,76,105,429,656,5,3719,206,0,2,2,2,34470,13952,2621,20075,1
20,400,294,64,250,0,0,43,294,1,20,10,20,21,30,86,131,0,65,3,0,2,9,2,34470,13952,2621,20076,1
20,400,78,46,62,3,0,14,81,3,8,4,8,11,12,28,41,1,62,3,0,2,9,2,34470,13953,2621,20077,1
5,110,110,30,77,3,13,16,113,4,21,15,30,25,45,100,208,2,597,33,0,2,1,0,34470,13953,2621,20078,1
5,110,28,15,21,1,0,6,29,0,0,0,0,0,0,0,0,0,0,0,0,2,1,0,34470,13953,2621,20079,1
20,400,294,64,250,0,0,43,294,1,20,10,20,21,30,86,131,0,65,3,0,2,9,3,34470,13953,2621,20080,1
20,400,78,46,62,3,0,14,81,3,8,4,8,11,12,28,41,1,62,3,0,2,9,3,34470,13954,2621,20081,1
5,110,110,30,77,3,13,16,113,4,21,15,30,25,45,100,208,2,597,33,0,2,5,2,34470,13954,2621,20082,1
5,110,28,15,21,1,0,6,29,0,0,0,0,0,0,0,0,0,0,0,0,2,5,2,34470,13954,2621,20083,1
314,6367,1457,730,1242,11,6,188,1468,10,292,166,329,302,495,2424,4078,5,22973,1276,1,2,6,0,34470,13956,2621,20084,0
314,6367,74,35,59,1,0,14,75,3,14,7,14,17,21,58,85,1,128,7,0,2,6,0,34470,13957,2621,20085,0
314,6367,245,125,200,5,7,34,250,7,30,17,34,37,51,166,265,3,1053,58,0,2,6,0,34480,13958,2621,20086,0
37,2203,652,304,544,16,6,88,668,6,89,51,101,95,152,591,998,3,3399,188,0,2,13,0,34480,13959,2621,20087,0
185,3788,1943,715,1694,26,18,214,1969,12,185,120,237,197,357,1436,2721,7,20915,1161,0,2,1,1,34480,13961,2621,20088,1
185,3788,1168,838,957,57,25,144,1225,19,348,224,416,367,640,3018,5452,11,61921,3440,1,2,1,1,34490,13963,2621,20089,1
58,2960,1457,730,1242,11,6,188,1468,10,292,166,329,302,495,2424,4078,5,22973,1276,1,2,3,3,34490,13965,2621,20090,1
122,2648,1043,504,840,53,9,147,1096,9,180,112,198,189,310,1377,2344,4,11604,644,0,2,2,2,34490,13967,2621,20091,0
122,2648,383,288,292,26,6,62,409,11,65,38,67,76,105,429,656,5,3719,206,0,2,2,2,34490,13968,2621,20092,0
20,400,294,64,250,0,0,43,294,1,20,10,20,21,30,86,131,0,65,3,0,2,17,4,34490,13968,2621,20093,0
20,400,78,46,62,3,0,14,81,3,8,4,8,11,12,28,41,1,62,3,0,2,17,4,34490,13969,2621,20094,0
5,110,110,30,77,3,13,16,113,4,21,15,30,25,45,100,208,2,597,33,0,2,6,2,34490,13969,2621,20095,0
5,110,28,15,21,1,0,6,29,0,0,0,0,0,0,0,0,0,0,0,0,2,6,2,34490,13969,2621,20096,0
155,4940,1660,832,1314,41,38,274,1701,20,312,209,395,332,604,2671,5058,12,64042,3557,1,2,5,0,34490,13971,2622,20098,1
155,4940,1057,646,719,113,100,145,1170,18,215,134,248,233,382,1740,3004,10,31186,1732,1,2,5,0,34500,13972,2623,20099,1
82,1803,477,336,357,30,23,73,507,16,194,134,250,210,384,1538,2962,10,30538,1696,0,2,0,33,34510,13973,2623,20100,1
311,6296,1457,730,1242,11,6,188,1468,10,292,166,329,302,495,2424,4078,5,22973,1276,1,2,9,15,34510,13975,2623,20101,1
311,6296,74,35,59,1,0,14,75,3,14,7,14,17,21,58,85,1,128,7,0,2,9,15,34510,13976,2623,20102,1
311,6296,245,125,200,5,7,34,250,7,30,17,34,37,51,166,265,3,1053,58,0,2,9,15,34520,13977,2623,20103,1
55,1468,1455,414,1257,16,76,112,1471,5,41,23,46,46,69,231,381,2,1069,59,0,2,1,1,34530,13978,2623,20105,1
55,1468,669,365,481,22,61,110,691,15,103,63,122,118,185,747,1273,8,11311,628,0,2,1,1,34540,13978,2624,20106,1
572,12277,72,33,56,0,4,12,72,1,1,1,1,2,2,0,2,0,1,0,0,2,18,11,34540,13978,2624,20107,1
572,12277,1454,835,1044,76,110,219,1530,17,275,158,296,292,454,2297,3718,9,34017,1889,1,2,18,11,34550,13979,2624,20108,1
139,6353,1392,870,1177,35,17,170,1427,14,494,280,531,508,811,4473,7289,7,54850,3047,2,2,1,1,34550,13982,2625,20109,1
146,6571,139,89,101,2,0,35,141,7,54,34,62,61,96,330,569,4,2287,127,0,2,27,19,34550,13982,2625,20110,1
146,6571,7,5,5,0,0,2,7,1,2,1,2,3,3,2,4,0,2,0,0,2,27,19,34550,13982,2625,20111,1
90,4801,1782,648,1425,9,47,279,1791,8,171,97,189,179,286,1292,2140,4,9462,525,0,2,2,2,34550,13983,2626,20112,1
143,3771,1660,832,1314,41,38,274,1701,20,312,209,395,332,604,2671,5058,12,64042,3557,1,2,45,12,34550,13985,2627,20114,1
65,3259,1457,730,1242,11,6,188,1468,10,292,166,329,302,495,2424,4078,5,22973,1276,1,2,17,0,34550,13987,2627,20115,1
39,2275,334,251,279,10,4,40,344,5,127,74,143,132,217,899,1528,2,4303,239,0,2,3,0,34550,13988,2627,20116,1
34,1289,1293,570,1093,25,15,163,1318,10,195,123,241,205,364,1516,2795,6,17273,959,0,2,2,2,34560,13990,2627,20117,1
155,4940,1660,832,1314,41,38,274,1701,20,312,209,395,332,604,2671,5058,12,64042,3557,1,2,5,0,34560,13992,2628,20119,0
155,4940,1057,646,719,113,100,145,1170,18,215,134,248,233,382,1740,3004,10,31186,1732,1,2,5,0,34570,13993,2629,20120,0
82,1803,477,336,357,30,23,73,507,16,194,134,250,210,384,1538,2962,10,30538,1696,0,2,0,33,34580,13994,2629,20121,0
311,6296,1457,730,1242,11,6,188,1468,10,292,166,329,302,495,2424,4078,5,22973,1276,1,2,9,15,34580,13996,2629,20122,0
311,6296,74,35,59,1,0,14,75,3,14,7,14,17,21,58,85,1,128,7,0,2,9,15,34580,13997,2629,20123,0
311,6296,245,125,200,5,7,34,250,7,30,17,34,37,51,166,265,3,1053,58,0,2,9,15,34590,13998,2629,20124,0
55,1468,1455,414,1257,16,76,112,1471,5,41,23,46,46,69,231,381,2,1069,59,0,2,1,1,34600,13999,2629,20126,0
55,1468,669,365,481,22,61,110,691,15,103,63,122,118,185,747,1273,8,11311,628,0,2,1,1,34610,13999,2630,20127,0
572,12277,72,33,56,0,4,12,72,1,1,1,1,2,2,0,2,0,1,0,0,2,18,11,34610,13999,2630,20128,0
572,12277,1454,835,1044,76,110,219,1530,17,275,158,296,292,454,2297,3718,9,34017,1889,1,2,18,11,34620,14000,2630,20129,0
139,6353,1392,870,1177,35,17,170,1427,14,494,280,531,508,811,4473,7289,7,54850,3047,2,2,1,1,34620,14003,2631,20130,0
146,6571,139,89,101,2,0,35,141,7,54,34,62,61,96,330,569,4,2287,127,0,2,27,19,34620,14003,2631,20131,0
146,6571,7,5,5,0,0,2,7,1,2,1,2,3,3,2,4,0,2,0,0,2,27,19,34620,14003,2631,20132,0
90,4801,1782,648,1425,9,47,279,1791,8,171,97,189,179,286,1292,2140,4,9462,525,0,2,2,2,34620,14004,2632,20133,0
143,3771,1660,832,1314,41,38,274,1701,20,312,209,395,332,604,2671,5058,12,64042,3557,1,2,45,12,34620,14006,2633,20135,0
65,3259,1457,730,1242,11,6,188,1468,10,292,166,329,302,495,2424,4078,5,22973,1276,1,2,17,0,34620,14008,2633,20136,0
39,2275,334,251,279,10,4,40,344,5,127,74,143,132,217,899,1528,2,4303,239,0,2,3,0,34620,14009,2633,20137,0
34,1289,1293,570,1093,25,15,163,1318,10,195,123,241,205,364,1516,2795,6,17273,959,0,2,2,2,34630,14011,2633,20138,0
40,775,207,111,150,11,0,50,218,5,26,19,36,31,55,133,272,3,943,52,0,0,203,0,34630,14011,2633,20139,1
40,775,410,198,237,31,55,97,441,11,63,38,72,74,110,414,683,6,4293,238,0,0,203,0,34640,14012,2634,20140,1
311,6296,1457,730,1242,11,6,188,1468,10,292,166,329,302,495,2424,4078,5,22973,1276,1,2,1,1,34640,14014,2634,20141,1
311,6296,74,35,59,1,0,14,75,3,14,7,14,17,21,58,85,1,128,7,0,2,1,1,34640,14015,2634,20142,1
311,6296,245,125,200,5,7,34,250,7,30,17,34,37,51,166,265,3,1053,58,0,2,1,1,34650,14016,2634,20143,1
55,1468,1455,414,1257,16,76,112,1471,5,41,23,46,46,69,231,381,2,1069,59,0,2,1,1,34650,14017,2634,20144,1
55,1468,669,365,481,22,61,110,691,15,103,63,122,118,185,747,1273,8,11311,628,0,2,1,1,34660,14017,2635,20145,1
222,4933,4293,999,3693,19,54,507,4312,9,155,88,170,164,258,1156,1898,4,9368,520,0,0,1083,0,34660,14019,2635,20146,1
222,4933,1482,859,1002,125,135,219,1607,16,219,134,251,235,385,1766,3032,9,27804,1544,1,0,1083,0,34670,14020,2635,20147,1
309,6680,72,33,56,0,4,12,72,1,1,1,1,2,2,0,2,0,1,0,0,2,33,1241,34670,14020,2635,20148,1
309,6680,1454,835,1044,76,110,219,1530,17,275,158,296,292,454,2297,3718,9,34017,1889,1,2,33,1241,34680,14021,2635,20149,1
85,3922,1338,495,1086,10,64,173,1348,11,122,82,157,133,239,883,1686,7,11934,663,0,2,1,1,34680,14023,2635,20150,1
146,6569,139,89,101,2,0,35,141,7,54,34,62,61,96,330,569,4,2287,127,0,2,16,17,34680,14023,2635,20151,1
146,6569,7,5,5,0,0,2,7,1,2,1,2,3,3,2,4,0,2,0,0,2,16,17,34680,14023,2635,20152,1
32,933,465,148,393,5,8,60,470,4,31,20,31,35,51,161,261,2,523,29,0,2,3,3,34680,14024,2635,20153,1
32,933,16,12,9,0,0,6,16,1,2,1,2,3,3,2,4,0,2,0,0,2,3,3,34680,14024,2635,20154,1
90,4801,1782,648,1425,9,47,279,1791,8,171,97,189,179,286,1292,2140,4,9462,525,0,2,7,7,34680,14025,2636,20155,1
117,2369,1513,682,1277,25,13,200,1538,11,199,116,219,210,335,1557,2584,6,15641,868,0,2,2,2,34680,14027,2636,20156,1
117,2369,819,519,539,24,98,155,843,15,96,57,106,111,163,690,1107,8,9171,509,0,2,2,2,34690,14029,2636,20157,1
587,12550,72,33,56,0,4,12,72,1,1,1,1,2,2,0,2,0,1,0,0,2,80,37,34690,14029,2636,20158,1
587,12550,1454,835,1044,76,110,219,1530,17,275,158,296,292,454,2297,3718,9,34017,1889,1,2,80,37,34700,14030,2636,20159,1
23,679,339,213,244,17,9,65,356,10,42,26,48,52,74,259,421,5,2410,133,0,2,18,6,34710,14030,2636,20160,1
40,775,207,111,150,11,0,50,218,5,26,19,36,31,55,133,272,3,943,52,0,0,203,0,34710,14030,2636,20161,0
40,775,410,198,237,31,55,97,441,11,63,38,72,74,110,414,683,6,4293,238,0,0,203,0,34720,14031,2637,20162,0
311,6296,1457,730,1242,11,6,188,1468,10,292,166,329,302,495,2424,4078,5,22973,1276,1,2,1,1,34720,14033,2637,20163,0
311,6296,74,35,59,1,0,14,75,3,14,7,14,17,21,58,85,1,128,7,0,2,1,1,34720,14034,2637,20164,0
311,6296,245,125,200,5,7,34,250,7,30,17,34,37,51,166,265,3,1053,58,0,2,1,1,34730,14035,2637,20165,0
55,1468,1455,414,1257,16,76,112,1471,5,41,23,46,46,69,231,381,2,1069,59,0,2,1,1,34730,14036,2637,20166,0
55,1468,669,365,481,22,61,110,691,15,103,63,122,118,185,747,1273,8,11311,628,0,2,1,1,34740,14036,2638,20167,0
222,4933,4293,999,3693,19,54,507,4312,9,155,88,170,164,258,1156,1898,4,9368,520,0,0,1083,0,34740,14038,2638,20168,0
222,4933,1482,859,1002,125,135,219,1607,16,219,134,251,235,385,1766,3032,9,27804,1544,1,0,1083,0,34750,14039,2638,20169,0
309,6680,72,33,56,0,4,12,72,1,1,1,1,2,2,0,2,0,1,0,0,2,33,1241,34750,14039,2638,20170,0
309,6680,1454,835,1044,76,110,219,1530,17,275,158,296,292,454,2297,3718,9,34017,1889,1,2,33,1241,34760,14040,2638,20171,0
85,3922,1338,495,1086,10,64,173,1348,11,122,82,157,133,239,883,1686,7,11934,663,0,2,1,1,34760,14042,2638,20172,0
146,6569,139,89,101,2,0,35,141,7,54,34,62,61,96,330,569,4,2287,127,0,2,16,17,34760,14042,2638,20173,0
146,6569,7,5,5,0,0,2,7,1,2,1,2,3,3,2,4,0,2,0,0,2,16,17,34760,14042,2638,20174,0
32,933,465,148,393,5,8,60,470,4,31,20,31,35,51,161,261,2,523,29,0,2,3,3,34760,14043,2638,20175,0
32,933,16,12,9,0,0,6,16,1,2,1,2,3,3,2,4,0,2,0,0,2,3,3,34760,14043,2638,20176,0
90,4801,1782,648,1425,9,47,279,1791,8,171,97,189,179,286,1292,2140,4,9462,525,0,2,7,7,34760,14044,2639,20177,0
40,775,207,111,150,11,0,50,218,5,26,19,36,31,55,133,272,3,943,52,0,0,203,0,34760,14044,2639,20178,1
40,775,410,198,237,31,55,97,441,11,63,38,72,74,110,414,683,6,4293,238,0,0,203,0,34770,14045,2640,20179,1
311,6296,1457,730,1242,11,6,188,1468,10,292,166,329,302,495,2424,4078,5,22973,1276,1,2,1,1,34770,14047,2640,20180,1
311,6296,74,35,59,1,0,14,75,3,14,7,14,17,21,58,85,1,128,7,0,2,1,1,34770,14048,2640,20181,1
311,6296,245,125,200,5,7,34,250,7,30,17,34,37,51,166,265,3,1053,58,0,2,1,1,34780,14049,2640,20182,1
55,1468,1455,414,1257,16,76,112,1471,5,41,23,46,46,69,231,381,2,1069,59,0,2,1,1,34780,14050,2640,20183,1
55,1468,669,365,481,22,61,110,691,15,103,63,122,118,185,747,1273,8,11311,628,0,2,1,1,34790,14050,2641,20184,1
237,5206,4293,999,3693,19,54,507,4312,9,155,88,170,164,258,1156,1898,4,9368,520,0,0,1126,0,34790,14052,2641,20185,1
237,5206,1482,859,1002,125,135,219,1607,16,219,134,251,235,385,1766,3032,9,27804,1544,1,0,1126,0,34800,14053,2641,20186,1
309,6680,72,33,56,0,4,12,72,1,1,1,1,2,2,0,2,0,1,0,0,2,33,1288,34800,14053,2641,20187,1
309,6680,1454,835,1044,76,110,219,1530,17,275,158,296,292,454,2297,3718,9,34017,1889,1,2,33,1288,34810,14054,2641,20188,1
85,3922,1338,495,1086,10,64,173,1348,11,122,82,157,133,239,883,1686,7,11934,663,0,2,1,1,34810,14056,2641,20189,1
146,6569,139,89,101,2,0,35,141,7,54,34,62,61,96,330,569,4,2287,127,0,2,16,17,34810,14056,2641,20190,1
146,6569,7,5,5,0,0,2,7,1,2,1,2,3,3,2,4,0,2,0,0,2,16,17,34810,14056,2641,20191,1
32,933,465,148,393,5,8,60,470,4,31,20,31,35,51,161,261,2,523,29,0,2,3,3,34810,14057,2641,20192,1
32,933,16,12,9,0,0,6,16,1,2,1,2,3,3,2,4,0,2,0,0,2,3,3,34810,14057,2641,20193,1
90,4801,1782,648,1425,9,47,279,1791,8,171,97,189,179,286,1292,2140,4,9462,525,0,2,7,7,34810,14058,2642,20194,1
237,5209,4293,999,3693,19,54,507,4312,9,155,88,170,164,258,1156,1898,4,9368,520,0,2,19,0,34810,14060,2642,20195,1
237,5209,1482,859,1002,125,135,219,1607,16,219,134,251,235,385,1766,3032,9,27804,1544,1,2,19,0,34820,14061,2642,20196,1
114,4432,1513,682,1277,25,13,200,1538,11,199,116,219,210,335,1557,2584,6,15641,868,0,2,19,0,34820,14063,2642,20197,1
309,6699,72,33,56,0,4,12,72,1,1,1,1,2,2,0,2,0,1,0,0,2,2,2,34820,14063,2642,20198,1
309,6699,1454,835,1044,76,110,219,1530,17,275,158,296,292,454,2297,3718,9,34017,1889,1,2,2,2,34830,14064,2642,20199,1
78,3212,1289,550,1043,56,32,155,1345,10,167,93,185,177,278,1266,2075,5,11498,638,0,2,15,0,34830,14066,2643,20200,1
91,2970,773,419,590,28,0,166,801,10,204,113,217,214,330,1598,2554,5,13587,754,0,2,5,5,34830,14066,2644,20201,1
222,4950,4293,999,3693,19,54,507,4312,9,155,88,170,164,258,1156,1898,4,9368,520,0,2,5,0,34830,14068,2644,20202,1
222,4950,1482,859,1002,125,135,219,1607,16,219,134,251,235,385,1766,3032,9,27804,1544,1,2,5,0,34840,14069,2644,20203,1
79,3247,1289,550,1043,56,32,155,1345,10,167,93,185,177,278,1266,2075,5,11498,638,0,2,16,0,34840,14071,2645,20204,1
35,724,2,2,2,0,0,0,2,0,0,0,0,0,0,0,0,0,0,0,0,2,2,2,34840,14071,2645,20204,1
35,724,99,48,90,1,3,5,100,0,0,0,0,0,0,0,0,0,0,0,0,2,2,2,34840,14072,2645,20205,1
35,724,8,5,5,2,0,1,10,0,0,0,0,0,0,0,0,0,0,0,0,2,2,2,34840,14072,2645,20206,1
35,724,1217,716,841,84,126,174,1301,14,185,118,215,199,333,1446,2542,8,20687,1149,0,2,2,2,34850,14074,2645,20207,1
35,724,160,89,115,0,13,31,160,7,15,11,17,22,28,78,124,3,495,27,0,2,2,2,34850,14074,2645,20208,1
35,724,10,10,9,9,0,0,19,0,0,0,0,0,0,0,0,0,0,0,0,2,2,2,34850,14074,2646,20209,1
35,724,173,84,99,8,29,36,181,5,12,7,13,17,20,54,81,2,221,12,0,2,2,2,34850,14075,2646,20210,1
35,724,3,1,1,3,0,0,6,0,0,0,0,0,0,0,0,0,0,0,0,2,2,2,34850,14075,2646,20211,1
222,4964,4293,999,3693,19,54,507,4312,9,155,88,170,164,258,1156,1898,4,9368,520,0,2,5,3,34850,14077,2646,20212,1
222,4964,1482,859,1002,125,135,219,1607,16,219,134,251,235,385,1766,3032,9,27804,1544,1,2,5,3,34860,14078,2646,20213,1
46,949,447,308,343,6,5,95,453,7,96,59,111,103,170,651,1136,4,4600,255,0,2,7,4,34860,14081,2646,20214,1
46,949,322,174,179,16,74,51,338,10,41,26,46,51,72,252,408,5,2291,127,0,2,7,4,34860,14084,2647,20215,1
220,4885,722,423,573,19,0,135,741,12,172,101,199,184,300,1320,2257,6,15668,870,0,2,2,1,34860,14086,2647,20217,1
220,4885,1508,847,911,44,250,301,1552,14,148,88,169,162,257,1120,1886,7,15077,837,0,2,2,1,34860,14087,2648,20218,1
16,468,442,244,305,14,16,103,456,11,68,45,75,79,120,452,756,6,4588,254,0,2,2,2,34860,14089,2648,20219,1
16,468,182,102,99,11,40,35,193,3,11,6,11,14,17,42,64,1,97,5,0,2,2,2,34860,14090,2648,20220,1
139,6357,1392,870,1177,35,17,170,1427,14,494,280,531,508,811,4473,7289,7,54850,3047,2,2,3,1,34860,14093,2649,20221,1
85,3904,1338,495,1086,10,64,173,1348,11,122,82,157,133,239,883,1686,7,11934,663,0,2,7,4,34860,14095,2649,20222,1
146,6582,139,89,101,2,0,35,141,7,54,34,62,61,96,330,569,4,2287,127,0,2,128,48,34860,14095,2649,20223,1
146,6582,7,5,5,0,0,2,7,1,2,1,2,3,3,2,4,0,2,0,0,2,128,48,34860,14095,2649,20224,1
32,933,465,148,393,5,8,60,470,4,31,20,31,35,51,161,261,2,523,29,0,2,5,2,34860,14096,2649,20225,1
32,933,16,12,9,0,0,6,16,1,2,1,2,3,3,2,4,0,2,0,0,2,5,2,34860,14096,2649,20226,1
90,4801,1782,648,1425,9,47,279,1791,8,171,97,189,179,286,1292,2140,4,9462,525,0,2,25,12,34860,14097,2650,20227,1
77,2760,1450,624,1228,12,26,181,1462,14,306,186,354,320,540,2580,4493,8,36391,2021,1,2,6,3,34860,14099,2651,20228,1
76,3740,1523,757,1297,19,12,193,1542,12,193,117,230,205,347,1508,2664,7,19053,1058,0,2,13,4,34870,14101,2651,20229,1
66,2745,1020,354,843,12,15,144,1032,8,134,77,144,142,221,970,1580,4,6792,377,0,2,2,1,34870,14101,2651,20230,1
38,1616,447,308,343,6,5,95,453,7,96,59,111,103,170,651,1136,4,4600,255,0,2,4,3,34870,14104,2651,20231,1
34,1295,1293,570,1093,25,15,163,1318,10,195,123,241,205,364,1516,2795,6,17273,959,0,2,4,1,34880,14106,2651,20232,1
62,2603,1043,504,840,53,9,147,1096,9,180,112,198,189,310,1377,2344,4,11604,644,0,2,3,1,34880,14108,2651,20233,1
13,413,295,56,236,0,4,54,295,2,9,5,10,11,15,30,51,1,57,3,0,2,2,1,34880,14110,2651,20234,1
67,2869,1178,367,1042,6,15,115,1184,9,94,51,95,103,146,644,976,4,4439,246,0,2,4,2,34880,14110,2651,20235,1
71,3566,1943,715,1694,26,18,214,1969,12,185,120,237,197,357,1436,2721,7,20915,1161,0,2,9,3,34880,14112,2651,20236,1
39,1537,1098,241,925,5,10,155,1103,7,46,25,49,53,74,273,423,3,1580,87,0,2,2,2,34890,14114,2651,20237,1
23,680,339,213,244,17,9,65,356,10,42,26,48,52,74,259,421,5,2410,133,0,2,2,1,34900,14114,2651,20238,1
38,1395,1293,570,1093,25,15,163,1318,10,195,123,241,205,364,1516,2795,6,17273,959,0,2,25,0,34910,14116,2651,20239,1
35,724,2,2,2,0,0,0,2,0,0,0,0,0,0,0,0,0,0,0,0,2,2,2,34910,14116,2651,20239,0
35,724,99,48,90,1,3,5,100,0,0,0,0,0,0,0,0,0,0,0,0,2,2,2,34910,14117,2651,20240,0
35,724,8,5,5,2,0,1,10,0,0,0,0,0,0,0,0,0,0,0,0,2,2,2,34910,14117,2651,20241,0
35,724,1217,716,841,84,126,174,1301,14,185,118,215,199,333,1446,2542,8,20687,1149,0,2,2,2,34920,14119,2651,20242,0
35,724,160,89,115,0,13,31,160,7,15,11,17,22,28,78,124,3,495,27,0,2,2,2,34920,14119,2651,20243,0
35,724,10,10,9,9,0,0,19,0,0,0,0,0,0,0,0,0,0,0,0,2,2,2,34920,14119,2652,20244,0
35,724,173,84,99,8,29,36,181,5,12,7,13,17,20,54,81,2,221,12,0,2,2,2,34920,14120,2652,20245,0
35,724,3,1,1,3,0,0,6,0,0,0,0,0,0,0,0,0,0,0,0,2,2,2,34920,14120,2652,20246,0
222,4964,4293,999,3693,19,54,507,4312,9,155,88,170,164,258,1156,1898,4,9368,520,0,2,8,1,34920,14122,2652,20247,0
222,4964,1482,859,1002,125,135,219,1607,16,219,134,251,235,385,1766,3032,9,27804,1544,1,2,8,1,34930,14123,2652,20248,0
46,949,447,308,343,6,5,95,453,7,96,59,111,103,170,651,1136,4,4600,255,0,2,7,4,34930,14126,2652,20249,0
46,949,322,174,179,16,74,51,338,10,41,26,46,51,72,252,408,5,2291,127,0,2,7,4,34930,14129,2653,20250,0
220,4885,722,423,573,19,0,135,741,12,172,101,199,184,300,1320,2257,6,15668,870,0,2,2,1,34930,14131,2653,20252,0
220,4885,1508,847,911,44,250,301,1552,14,148,88,169,162,257,1120,1886,7,15077,837,0,2,2,1,34930,14132,2654,20253,0
309,6699,72,33,56,0,4,12,72,1,1,1,1,2,2,0,2,0,1,0,0,2,2,2,34930,14132,2654,20254,0
309,6699,1454,835,1044,76,110,219,1530,17,275,158,296,292,454,2297,3718,9,34017,1889,1,2,2,2,34940,14133,2654,20255,0
16,468,442,244,305,14,16,103,456,11,68,45,75,79,120,452,756,6,4588,254,0,2,2,2,34940,14135,2654,20256,0
16,468,182,102,99,11,40,35,193,3,11,6,11,14,17,42,64,1,97,5,0,2,2,2,34940,14136,2654,20257,0
79,3247,1289,550,1043,56,32,155,1345,10,167,93,185,177,278,1266,2075,5,11498,638,0,2,31,0,34940,14138,2655,20258,0
139,6357,1392,870,1177,35,17,170,1427,14,494,280,531,508,811,4473,7289,7,54850,3047,2,2,3,1,34940,14141,2656,20259,0
91,2970,773,419,590,28,0,166,801,10,204,113,217,214,330,1598,2554,5,13587,754,0,2,5,5,34940,14141,2657,20260,0
85,3904,1338,495,1086,10,64,173,1348,11,122,82,157,133,239,883,1686,7,11934,663,0,2,7,4,34940,14143,2657,20261,0
146,6582,139,89,101,2,0,35,141,7,54,34,62,61,96,330,569,4,2287,127,0,2,128,48,34940,14143,2657,20262,0
146,6582,7,5,5,0,0,2,7,1,2,1,2,3,3,2,4,0,2,0,0,2,128,48,34940,14143,2657,20263,0
32,933,465,148,393,5,8,60,470,4,31,20,31,35,51,161,261,2,523,29,0,2,5,2,34940,14144,2657,20264,0
32,933,16,12,9,0,0,6,16,1,2,1,2,3,3,2,4,0,2,0,0,2,5,2,34940,14144,2657,20265,0
90,4801,1782,648,1425,9,47,279,1791,8,171,97,189,179,286,1292,2140,4,9462,525,0,2,25,12,34940,14145,2658,20266,0
77,2760,1450,624,1228,12,26,181,1462,14,306,186,354,320,540,2580,4493,8,36391,2021,1,2,6,3,34940,14147,2659,20267,0
76,3740,1523,757,1297,19,12,193,1542,12,193,117,230,205,347,1508,2664,7,19053,1058,0,2,13,4,34950,14149,2659,20268,0
66,2745,1020,354,843,12,15,144,1032,8,134,77,144,142,221,970,1580,4,6792,377,0,2,2,1,34950,14149,2659,20269,0
38,1616,447,308,343,6,5,95,453,7,96,59,111,103,170,651,1136,4,4600,255,0,2,4,3,34950,14152,2659,20270,0
34,1295,1293,570,1093,25,15,163,1318,10,195,123,241,205,364,1516,2795,6,17273,959,0,2,4,1,34960,14154,2659,20271,0
62,2603,1043,504,840,53,9,147,1096,9,180,112,198,189,310,1377,2344,4,11604,644,0,2,3,1,34960,14156,2659,20272,0
13,413,295,56,236,0,4,54,295,2,9,5,10,11,15,30,51,1,57,3,0,2,2,1,34960,14158,2659,20273,0
67,2869,1178,367,1042,6,15,115,1184,9,94,51,95,103,146,644,976,4,4439,246,0,2,4,2,34960,14158,2659,20274,0
71,3566,1943,715,1694,26,18,214,1969,12,185,120,237,197,357,1436,2721,7,20915,1161,0,2,9,3,34960,14160,2659,20275,0
39,1537,1098,241,925,5,10,155,1103,7,46,25,49,53,74,273,423,3,1580,87,0,2,2,2,34970,14162,2659,20276,0
23,680,339,213,244,17,9,65,356,10,42,26,48,52,74,259,421,5,2410,133,0,2,19,6,34980,14162,2659,20277,0
38,1401,1293,570,1093,25,15,163,1318,10,195,123,241,205,364,1516,2795,6,17273,959,0,2,25,0,34990,14164,2659,20278,0
222,4964,4293,999,3693,19,54,507,4312,9,155,88,170,164,258,1156,1898,4,9368,520,0,2,5,6,34990,14166,2659,20279,1
222,4964,1482,859,1002,125,135,219,1607,16,219,134,251,235,385,1766,3032,9,27804,1544,1,2,5,6,35000,14167,2659,20280,1
222,4964,4293,999,3693,19,54,507,4312,9,155,88,170,164,258,1156,1898,4,9368,520,0,2,5,6,35000,14169,2659,20281,0
222,4964,1482,859,1002,125,135,219,1607,16,219,134,251,235,385,1766,3032,9,27804,1544,1,2,5,6,35010,14170,2659,20282,0
32,614,2,2,2,0,0,0,2,0,0,0,0,0,0,0,0,0,0,0,0,2,22,51,35010,14170,2659,20282,1
32,614,99,48,90,1,3,5,100,0,0,0,0,0,0,0,0,0,0,0,0,2,22,51,35010,14171,2659,20283,1
32,614,8,5,5,2,0,1,10,0,0,0,0,0,0,0,0,0,0,0,0,2,22,51,35010,14171,2659,20284,1
32,614,1217,716,841,84,126,174,1301,14,185,118,215,199,333,1446,2542,8,20687,1149,0,2,22,51,35020,14173,2659,20285,1
32,614,160,89,115,0,13,31,160,7,15,11,17,22,28,78,124,3,495,27,0,2,22,51,35020,14173,2659,20286,1
32,614,10,10,9,9,0,0,19,0,0,0,0,0,0,0,0,0,0,0,0,2,22,51,35020,14173,2660,20287,1
32,614,173,84,99,8,29,36,181,5,12,7,13,17,20,54,81,2,221,12,0,2,22,51,35020,14174,2660,20288,1
32,614,3,1,1,3,0,0,6,0,0,0,0,0,0,0,0,0,0,0,0,2,22,51,35020,14174,2660,20289,1
160,5038,1660,832,1314,41,38,274,1701,20,312,209,395,332,604,2671,5058,12,64042,3557,1,2,24,2,35020,14176,2661,20291,1
160,5038,1057,646,719,113,100,145,1170,18,215,134,248,233,382,1740,3004,10,31186,1732,1,2,24,2,35030,14177,2662,20292,1
326,6554,1457,730,1242,11,6,188,1468,10,292,166,329,302,495,2424,4078,5,22973,1276,1,2,51,1,35030,14179,2662,20293,1
326,6554,74,35,59,1,0,14,75,3,14,7,14,17,21,58,85,1,128,7,0,2,51,1,35030,14180,2662,20294,1
326,6554,245,125,200,5,7,34,250,7,30,17,34,37,51,166,265,3,1053,58,0,2,51,1,35040,14181,2662,20295,1
86,3024,1450,624,1228,12,26,181,1462,14,306,186,354,320,540,2580,4493,8,36391,2021,1,2,110,0,35040,14183,2663,20296,1
140,3706,1660,832,1314,41,38,274,1701,20,312,209,395,332,604,2671,5058,12,64042,3557,1,2,11,35,35040,14185,2664,20298,1
67,3305,1457,730,1242,11,6,188,1468,10,292,166,329,302,495,2424,4078,5,22973,1276,1,2,12,3,35040,14187,2664,20299,1
159,5043,1660,832,1314,41,38,274,1701,20,312,209,395,332,604,2671,5058,12,64042,3557,1,2,3,3,35040,14189,2665,20301,1
159,5043,1057,646,719,113,100,145,1170,18,215,134,248,233,382,1740,3004,10,31186,1732,1,2,3,3,35050,14190,2666,20302,1
221,4925,722,423,573,19,0,135,741,12,172,101,199,184,300,1320,2257,6,15668,870,0,2,11,1,35050,14192,2666,20304,1
221,4925,1508,847,911,44,250,301,1552,14,148,88,169,162,257,1120,1886,7,15077,837,0,2,11,1,35050,14193,2667,20305,1
37,691,2,2,2,0,0,0,2,0,0,0,0,0,0,0,0,0,0,0,0,2,29,0,35050,14193,2667,20305,1
37,691,99,48,90,1,3,5,100,0,0,0,0,0,0,0,0,0,0,0,0,2,29,0,35050,14194,2667,20306,1
37,691,8,5,5,2,0,1,10,0,0,0,0,0,0,0,0,0,0,0,0,2,29,0,35050,14194,2667,20307,1
37,691,1217,716,841,84,126,174,1301,14,185,118,215,199,333,1446,2542,8,20687,1149,0,2,29,0,35060,14196,2667,20308,1
37,691,160,89,115,0,13,31,160,7,15,11,17,22,28,78,124,3,495,27,0,2,29,0,35060,14196,2667,20309,1
37,691,10,10,9,9,0,0,19,0,0,0,0,0,0,0,0,0,0,0,0,2,29,0,35060,14196,2668,20310,1
37,691,173,84,99,8,29,36,181,5,12,7,13,17,20,54,81,2,221,12,0,2,29,0,35060,14197,2668,20311,1
37,691,3,1,1,3,0,0,6,0,0,0,0,0,0,0,0,0,0,0,0,2,29,0,35060,14197,2668,20312,1
160,5038,1660,832,1314,41,38,274,1701,20,312,209,395,332,604,2671,5058,12,64042,3557,1,2,3,3,35060,14199,2669,20314,1
160,5038,1057,646,719,113,100,145,1170,18,215,134,248,233,382,1740,3004,10,31186,1732,1,2,3,3,35070,14200,2670,20315,1
324,6573,1457,730,1242,11,6,188,1468,10,292,166,329,302,495,2424,4078,5,22973,1276,1,2,8,4,35070,14202,2670,20316,1
324,6573,74,35,59,1,0,14,75,3,14,7,14,17,21,58,85,1,128,7,0,2,8,4,35070,14203,2670,20317,1
324,6573,245,125,200,5,7,34,250,7,30,17,34,37,51,166,265,3,1053,58,0,2,8,4,35080,14204,2670,20318,1
91,3201,1450,624,1228,12,26,181,1462,14,306,186,354,320,540,2580,4493,8,36391,2021,1,2,87,14,35080,14206,2671,20319,1
222,4964,4293,999,3693,19,54,507,4312,9,155,88,170,164,258,1156,1898,4,9368,520,0,2,1,1,35080,14208,2671,20320,0
222,4964,1482,859,1002,125,135,219,1607,16,219,134,251,235,385,1766,3032,9,27804,1544,1,2,1,1,35090,14209,2671,20321,0
79,3250,1289,550,1043,56,32,155,1345,10,167,93,185,177,278,1266,2075,5,11498,638,0,2,4,2,35090,14211,2672,20322,0
222,4964,4293,999,3693,19,54,507,4312,9,155,88,170,164,258,1156,1898,4,9368,520,0,2,1,1,35090,14213,2672,20323,0
222,4964,1482,859,1002,125,135,219,1607,16,219,134,251,235,385,1766,3032,9,27804,1544,1,2,1,1,35100,14214,2672,20324,0
79,3250,1289,550,1043,56,32,155,1345,10,167,93,185,177,278,1266,2075,5,11498,638,0,2,4,2,35100,14216,2673,20325,0
216,4657,182,127,129,0,0,53,182,5,39,21,42,44,63,217,343,2,926,51,0,2,92,18,35110,14220,2675,20333,0
216,4657,1165,710,800,67,119,181,1232,18,243,153,282,261,435,2000,3492,10,36473,2026,1,2,92,18,35120,14220,2676,20334,0
35,724,2,2,2,0,0,0,2,0,0,0,0,0,0,0,0,0,0,0,0,2,33,28,35120,14220,2676,20334,0
35,724,99,48,90,1,3,5,100,0,0,0,0,0,0,0,0,0,0,0,0,2,33,28,35120,14221,2676,20335,0
35,724,8,5,5,2,0,1,10,0,0,0,0,0,0,0,0,0,0,0,0,2,33,28,35120,14221,2676,20336,0
35,724,1217,716,841,84,126,174,1301,14,185,118,215,199,333,1446,2542,8,20687,1149,0,2,33,28,35130,14223,2676,20337,0
35,724,160,89,115,0,13,31,160,7,15,11,17,22,28,78,124,3,495,27,0,2,33,28,35130,14223,2676,20338,0
35,724,10,10,9,9,0,0,19,0,0,0,0,0,0,0,0,0,0,0,0,2,33,28,35130,14223,2677,20339,0
35,724,173,84,99,8,29,36,181,5,12,7,13,17,20,54,81,2,221,12,0,2,33,28,35130,14224,2677,20340,0
35,724,3,1,1,3,0,0,6,0,0,0,0,0,0,0,0,0,0,0,0,2,33,28,35130,14224,2677,20341,0
155,4940,1660,832,1314,41,38,274,1701,20,312,209,395,332,604,2671,5058,12,64042,3557,1,2,54,28,35130,14226,2678,20343,0
155,4940,1057,646,719,113,100,145,1170,18,215,134,248,233,382,1740,3004,10,31186,1732,1,2,54,28,35140,14227,2679,20344,0
117,2369,1513,682,1277,25,13,200,1538,11,199,116,219,210,335,1557,2584,6,15641,868,0,2,18,7,35140,14229,2679,20345,0
117,2369,819,519,539,24,98,155,843,15,96,57,106,111,163,690,1107,8,9171,509,0,2,18,7,35150,14231,2679,20346,0
40,775,207,111,150,11,0,50,218,5,26,19,36,31,55,133,272,3,943,52,0,0,203,0,35150,14231,2679,20347,0
40,775,410,198,237,31,55,97,441,11,63,38,72,74,110,414,683,6,4293,238,0,0,203,0,35160,14232,2680,20348,0
311,6296,1457,730,1242,11,6,188,1468,10,292,166,329,302,495,2424,4078,5,22973,1276,1,2,40,25,35160,14234,2680,20349,0
311,6296,74,35,59,1,0,14,75,3,14,7,14,17,21,58,85,1,128,7,0,2,40,25,35160,14235,2680,20350,0
311,6296,245,125,200,5,7,34,250,7,30,17,34,37,51,166,265,3,1053,58,0,2,40,25,35170,14236,2680,20351,0
23,680,339,213,244,17,9,65,356,10,42,26,48,52,74,259,421,5,2410,133,0,2,19,6,35180,14236,2680,20352,0
55,1468,1455,414,1257,16,76,112,1471,5,41,23,46,46,69,231,381,2,1069,59,0,2,12,1,35180,14237,2680,20353,0
55,1468,669,365,481,22,61,110,691,15,103,63,122,118,185,747,1273,8,11311,628,0,2,12,1,35190,14237,2681,20354,0
222,4964,4293,999,3693,19,54,507,4312,9,155,88,170,164,258,1156,1898,4,9368,520,0,0,1089,0,35190,14239,2681,20355,0
222,4964,1482,859,1002,125,135,219,1607,16,219,134,251,235,385,1766,3032,9,27804,1544,1,0,1089,0,35200,14240,2681,20356,0
7,139,44,22,19,0,19,6,44,2,10,6,12,12,18,35,64,1,77,4,0,0,45,0,35200,14240,2681,20357,0
24,834,74,35,59,1,0,14,75,3,14,7,14,17,21,58,85,1,128,7,0,2,6,2,35200,14241,2681,20358,0
24,834,245,125,200,5,7,34,250,7,30,17,34,37,51,166,265,3,1053,58,0,2,6,2,35210,14242,2681,20359,0
49,571,647,139,84,35,284,233,682,0,0,0,0,0,0,0,0,0,0,0,0,2,20,1,35210,14242,2681,20360,0
71,2075,1523,757,1297,19,12,193,1542,12,193,117,230,205,347,1508,2664,7,19053,1058,0,2,21,0,35220,14244,2681,20361,0
71,2075,701,378,504,33,58,109,734,13,110,68,126,123,194,794,1346,7,10027,557,0,2,21,0,35220,14245,2682,20362,0
175,4054,77,34,69,0,0,8,77,3,24,16,29,27,45,114,213,1,387,21,0,2,9,1,35220,14245,2682,20363,0
175,4054,712,438,573,51,9,84,763,14,102,71,128,116,199,733,1364,8,11988,666,0,2,9,1,35230,14246,2682,20364,0
46,949,447,308,343,6,5,95,453,7,96,59,111,103,170,651,1136,4,4600,255,0,2,7,4,35230,14249,2682,20365,0
46,949,322,174,179,16,74,51,338,10,41,26,46,51,72,252,408,5,2291,127,0,2,7,4,35230,14252,2683,20366,0
220,4885,722,423,573,19,0,135,741,12,172,101,199,184,300,1320,2257,6,15668,870,0,2,17,16,35230,14254,2683,20368,0
220,4885,1508,847,911,44,250,301,1552,14,148,88,169,162,257,1120,1886,7,15077,837,0,2,17,16,35230,14255,2684,20369,0
309,6699,72,33,56,0,4,12,72,1,1,1,1,2,2,0,2,0,1,0,0,2,428,1250,35230,14255,2684,20370,0
309,6699,1454,835,1044,76,110,219,1530,17,275,158,296,292,454,2297,3718,9,34017,1889,1,2,428,1250,35240,14256,2684,20371,0
122,2648,1043,504,840,53,9,147,1096,9,180,112,198,189,310,1377,2344,4,11604,644,0,2,18,1,35240,14258,2684,20372,0
122,2648,383,288,292,26,6,62,409,11,65,38,67,76,105,429,656,5,3719,206,0,2,18,1,35240,14259,2684,20373,0
20,400,294,64,250,0,0,43,294,1,20,10,20,21,30,86,131,0,65,3,0,0,72,0,35240,14259,2684,20374,0
20,400,78,46,62,3,0,14,81,3,8,4,8,11,12,28,41,1,62,3,0,0,72,0,35240,14260,2684,20375,0
5,110,110,30,77,3,13,16,113,4,21,15,30,25,45,100,208,2,597,33,0,0,23,0,35240,14260,2684,20376,0
5,110,28,15,21,1,0,6,29,0,0,0,0,0,0,0,0,0,0,0,0,0,23,0,35240,14260,2684,20377,0
180,3702,1943,715,1694,26,18,214,1969,12,185,120,237,197,357,1436,2721,7,20915,1161,0,2,0,14,35240,14262,2684,20378,0
180,3702,1168,838,957,57,25,144,1225,19,348,224,416,367,640,3018,5452,11,61921,3440,1,2,0,14,35250,14264,2684,20379,0
16,468,442,244,305,14,16,103,456,11,68,45,75,79,120,452,756,6,4588,254,0,2,2,2,35250,14266,2684,20380,0
16,468,182,102,99,11,40,35,193,3,11,6,11,14,17,42,64,1,97,5,0,2,2,2,35250,14267,2684,20381,0
54,1089,1098,241,925,5,10,155,1103,7,46,25,49,53,74,273,423,3,1580,87,0,2,2,0,35260,14269,2684,20382,0
54,1089,282,202,222,14,2,44,296,8,42,24,43,50,67,250,378,4,1548,86,0,2,2,0,35260,14270,2684,20383,0
3,63,127,75,83,2,11,30,129,4,14,7,14,18,21,61,87,2,175,9,0,2,2,2,35260,14270,2684,20384,0
3,63,652,304,544,16,6,88,668,6,89,51,101,95,152,591,998,3,3399,188,0,2,2,2,35260,14271,2684,20385,0
3,63,2,2,2,0,0,0,2,0,0,0,0,0,0,0,0,0,0,0,0,2,2,2,35260,14271,2684,20385,0
3,63,8,5,5,0,0,3,8,0,0,0,0,0,0,0,0,0,0,0,0,2,2,2,35260,14271,2684,20386,0
3,63,2,2,2,0,0,0,2,0,0,0,0,0,0,0,0,0,0,0,0,2,2,2,35260,14271,2684,20386,0
3,63,14,8,8,0,0,6,14,0,0,0,0,0,0,0,0,0,0,0,0,2,2,2,35260,14271,2684,20387,0
3,63,6,4,4,0,0,2,6,0,0,0,0,0,0,0,0,0,0,0,0,2,2,2,35260,14271,2684,20388,0
3,63,6,4,4,0,0,2,6,1,2,1,2,3,3,2,4,0,2,0,0,2,2,2,35260,14271,2684,20389,0
3,63,6,4,4,0,0,2,6,0,0,0,0,0,0,0,0,0,0,0,0,2,2,2,35260,14271,2684,20390,0
3,63,7,5,5,0,0,2,7,0,0,0,0,0,0,0,0,0,0,0,0,2,2,2,35260,14271,2684,20391,0
3,63,6,4,4,0,0,2,6,0,0,0,0,0,0,0,0,0,0,0,0,2,2,2,35260,14271,2684,20392,0
3,63,10,6,6,0,0,4,10,0,0,0,0,0,0,0,0,0,0,0,0,2,2,2,35260,14271,2684,20393,0
3,63,1,1,1,0,0,0,1,0,0,0,0,0,0,0,0,0,0,0,0,2,2,2,35260,14271,2684,20393,0
3,63,14,10,10,0,0,4,14,1,1,1,1,2,2,0,2,0,1,0,0,2,2,2,35260,14271,2684,20394,0
3,63,46,26,30,3,0,12,49,3,6,3,6,9,9,20,28,1,42,2,0,2,2,2,35270,14271,2684,20395,0
3,23,14,7,7,2,0,5,16,0,0,0,0,0,0,0,0,0,0,0,0,2,1,1,35270,14271,2684,20395,0
14,470,42,7,35,4,0,5,46,1,2,1,2,3,3,2,4,0,2,0,0,2,5,26,35270,14271,2684,20396,0
14,470,11,6,10,0,0,1,11,2,4,2,4,6,6,10,15,1,15,0,0,2,5,26,35270,14271,2684,20397,0
79,3250,1289,550,1043,56,32,155,1345,10,167,93,185,177,278,1266,2075,5,11498,638,0,2,41,5,35270,14273,2685,20398,0
139,6357,1392,870,1177,35,17,170,1427,14,494,280,531,508,811,4473,7289,7,54850,3047,2,2,149,5,35270,14276,2686,20399,0
91,2970,773,419,590,28,0,166,801,10,204,113,217,214,330,1598,2554,5,13587,754,0,2,6,8,35270,14276,2687,20400,0
43,2308,520,294,400,33,13,81,553,10,261,204,367,271,571,2128,4614,7,32445,1802,1,0,286,0,35270,14277,2687,20402,0
85,3904,1338,495,1086,10,64,173,1348,11,122,82,157,133,239,883,1686,7,11934,663,0,2,23,8,35270,14279,2687,20403,0
146,6582,139,89,101,2,0,35,141,7,54,34,62,61,96,330,569,4,2287,127,0,2,168,108,35270,14279,2687,20404,0
146,6582,7,5,5,0,0,2,7,1,2,1,2,3,3,2,4,0,2,0,0,2,168,108,35270,14279,2687,20405,0
32,933,465,148,393,5,8,60,470,4,31,20,31,35,51,161,261,2,523,29,0,2,8,5,35270,14280,2687,20406,0
32,933,16,12,9,0,0,6,16,1,2,1,2,3,3,2,4,0,2,0,0,2,8,5,35270,14280,2687,20407,0
90,4801,1782,648,1425,9,47,279,1791,8,171,97,189,179,286,1292,2140,4,9462,525,0,2,126,31,35270,14281,2688,20408,0
16,362,256,139,192,9,7,47,265,4,23,12,24,27,36,112,171,2,357,19,0,2,20,0,35270,14282,2688,20409,0
5,280,180,34,164,0,0,16,180,1,12,6,12,13,18,43,66,0,33,1,0,0,137,0,35270,14282,2688,20410,0
77,2760,1450,624,1228,12,26,181,1462,14,306,186,354,320,540,2580,4493,8,36391,2021,1,2,27,14,35270,14284,2689,20411,0
143,3771,1660,832,1314,41,38,274,1701,20,312,209,395,332,604,2671,5058,12,64042,3557,1,2,61,0,35270,14286,2690,20413,0
113,4391,1513,682,1277,25,13,200,1538,11,199,116,219,210,335,1557,2584,6,15641,868,0,2,16,0,35270,14288,2690,20414,0
59,3272,1296,573,1062,40,33,157,1336,8,201,118,231,209,349,1561,2689,4,12365,686,0,2,115,1,35270,14288,2690,20415,0
65,3259,1457,730,1242,11,6,188,1468,10,292,166,329,302,495,2424,4078,5,22973,1276,1,2,116,5,35270,14290,2690,20416,0
55,2458,1455,414,1257,16,76,112,1471,5,41,23,46,46,69,231,381,2,1069,59,0,2,67,4,35270,14291,2690,20417,0
2,67,7,6,5,0,0,2,7,1,1,1,2,2,3,0,3,1,3,0,0,0,13,0,35270,14291,2690,20418,0
8,265,74,35,59,1,0,14,75,3,14,7,14,17,21,58,85,1,128,7,0,2,2,2,35270,14292,2690,20419,0
76,3740,1523,757,1297,19,12,193,1542,12,193,117,230,205,347,1508,2664,7,19053,1058,0,2,91,24,35280,14294,2690,20420,0
66,2745,1020,354,843,12,15,144,1032,8,134,77,144,142,221,970,1580,4,6792,377,0,2,51,2,35280,14294,2690,20421,0
38,1616,447,308,343,6,5,95,453,7,96,59,111,103,170,651,1136,4,4600,255,0,2,4,3,35280,14297,2690,20422,0
39,2275,334,251,279,10,4,40,344,5,127,74,143,132,217,899,1528,2,4303,239,0,2,16,7,35280,14298,2690,20423,0
38,1401,1293,570,1093,25,15,163,1318,10,195,123,241,205,364,1516,2795,6,17273,959,0,2,29,1,35290,14300,2690,20424,0
16,1198,215,129,180,6,0,29,221,8,65,43,72,73,115,415,711,4,3153,175,0,2,1,10,35290,14300,2690,20425,0
62,2603,1043,504,840,53,9,147,1096,9,180,112,198,189,310,1377,2344,4,11604,644,0,2,3,13,35290,14302,2690,20426,0
13,413,295,56,236,0,4,54,295,2,9,5,10,11,15,30,51,1,57,3,0,2,2,1,35290,14304,2690,20427,0
22,942,373,158,315,8,0,51,381,5,76,44,79,81,123,486,779,2,2026,112,0,2,2,8,35290,14304,2690,20428,0
67,2869,1178,367,1042,6,15,115,1184,9,94,51,95,103,146,644,976,4,4439,246,0,2,24,10,35290,14304,2690,20429,0
71,3611,1943,715,1694,26,18,214,1969,12,185,120,237,197,357,1436,2721,7,20915,1161,0,2,15,19,35290,14306,2690,20430,0
39,1537,1098,241,925,5,10,155,1103,7,46,25,49,53,74,273,423,3,1580,87,0,2,16,2,35300,14308,2690,20431,0
180,3702,1943,715,1694,26,18,214,1969,12,185,120,237,197,357,1436,2721,7,20915,1161,0,2,12,3,35300,14310,2690,20432,0
180,3702,1168,838,957,57,25,144,1225,19,348,224,416,367,640,3018,5452,11,61921,3440,1,2,12,3,35310,14312,2690,20433,0
65,3259,1457,730,1242,11,6,188,1468,10,292,166,329,302,495,2424,4078,5,22973,1276,1,2,2,2,35310,14314,2690,20434,0
71,3611,1943,715,1694,26,18,214,1969,12,185,120,237,197,357,1436,2721,7,20915,1161,0,2,11,1,35310,14316,2690,20435,0
312,6316,1457,730,1242,11,6,188,1468,10,292,166,329,302,495,2424,4078,5,22973,1276,1,2,7,0,35310,14318,2690,20436,1
312,6316,74,35,59,1,0,14,75,3,14,7,14,17,21,58,85,1,128,7,0,2,7,0,35310,14319,2690,20437,1
312,6316,245,125,200,5,7,34,250,7,30,17,34,37,51,166,265,3,1053,58,0,2,7,0,35320,14320,2690,20438,1
81,3313,1289,550,1043,56,32,155,1345,10,167,93,185,177,278,1266,2075,5,11498,638,0,2,14,0,35320,14322,2691,20439,1
37,691,2,2,2,0,0,0,2,0,0,0,0,0,0,0,0,0,0,0,0,2,2,2,35320,14322,2691,20439,1
37,691,99,48,90,1,3,5,100,0,0,0,0,0,0,0,0,0,0,0,0,2,2,2,35320,14323,2691,20440,1
37,691,8,5,5,2,0,1,10,0,0,0,0,0,0,0,0,0,0,0,0,2,2,2,35320,14323,2691,20441,1
37,691,1217,716,841,84,126,174,1301,14,185,118,215,199,333,1446,2542,8,20687,1149,0,2,2,2,35330,14325,2691,20442,1
37,691,160,89,115,0,13,31,160,7,15,11,17,22,28,78,124,3,495,27,0,2,2,2,35330,14325,2691,20443,1
37,691,10,10,9,9,0,0,19,0,0,0,0,0,0,0,0,0,0,0,0,2,2,2,35330,14325,2692,20444,1
37,691,173,84,99,8,29,36,181,5,12,7,13,17,20,54,81,2,221,12,0,2,2,2,35330,14326,2692,20445,1
37,691,3,1,1,3,0,0,6,0,0,0,0,0,0,0,0,0,0,0,0,2,2,2,35330,14326,2692,20446,1
323,6553,1457,730,1242,11,6,188,1468,10,292,166,329,302,495,2424,4078,5,22973,1276,1,2,1,4,35330,14328,2692,20447,1
323,6553,74,35,59,1,0,14,75,3,14,7,14,17,21,58,85,1,128,7,0,2,1,4,35330,14329,2692,20448,1
323,6553,245,125,200,5,7,34,250,7,30,17,34,37,51,166,265,3,1053,58,0,2,1,4,35340,14330,2692,20449,1
68,3328,1457,730,1242,11,6,188,1468,10,292,166,329,302,495,2424,4078,5,22973,1276,1,2,7,2,35340,14332,2692,20450,1
312,6316,1457,730,1242,11,6,188,1468,10,292,166,329,302,495,2424,4078,5,22973,1276,1,2,7,0,35340,14334,2692,20451,0
312,6316,74,35,59,1,0,14,75,3,14,7,14,17,21,58,85,1,128,7,0,2,7,0,35340,14335,2692,20452,0
312,6316,245,125,200,5,7,34,250,7,30,17,34,37,51,166,265,3,1053,58,0,2,7,0,35350,14336,2692,20453,0
81,3313,1289,550,1043,56,32,155,1345,10,167,93,185,177,278,1266,2075,5,11498,638,0,2,14,0,35350,14338,2693,20454,0
146,6594,139,89,101,2,0,35,141,7,54,34,62,61,96,330,569,4,2287,127,0,2,2,1,35350,14338,2693,20455,1
146,6594,7,5,5,0,0,2,7,1,2,1,2,3,3,2,4,0,2,0,0,2,2,1,35350,14338,2693,20456,1
35,2163,652,304,544,16,6,88,668,6,89,51,101,95,152,591,998,3,3399,188,0,2,1,0,35350,14339,2693,20457,1
37,691,2,2,2,0,0,0,2,0,0,0,0,0,0,0,0,0,0,0,0,2,51,51,35350,14339,2693,20457,0
37,691,99,48,90,1,3,5,100,0,0,0,0,0,0,0,0,0,0,0,0,2,51,51,35350,14340,2693,20458,0
37,691,8,5,5,2,0,1,10,0,0,0,0,0,0,0,0,0,0,0,0,2,51,51,35350,14340,2693,20459,0
37,691,1217,716,841,84,126,174,1301,14,185,118,215,199,333,1446,2542,8,20687,1149,0,2,51,51,35360,14342,2693,20460,0
37,691,160,89,115,0,13,31,160,7,15,11,17,22,28,78,124,3,495,27,0,2,51,51,35360,14342,2693,20461,0
37,691,10,10,9,9,0,0,19,0,0,0,0,0,0,0,0,0,0,0,0,2,51,51,35360,14342,2694,20462,0
37,691,173,84,99,8,29,36,181,5,12,7,13,17,20,54,81,2,221,12,0,2,51,51,35360,14343,2694,20463,0
37,691,3,1,1,3,0,0,6,0,0,0,0,0,0,0,0,0,0,0,0,2,51,51,35360,14343,2694,20464,0
160,5038,1660,832,1314,41,38,274,1701,20,312,209,395,332,604,2671,5058,12,64042,3557,1,2,24,2,35360,14345,2695,20466,0
160,5038,1057,646,719,113,100,145,1170,18,215,134,248,233,382,1740,3004,10,31186,1732,1,2,24,2,35370,14346,2696,20467,0
324,6573,1457,730,1242,11,6,188,1468,10,292,166,329,302,495,2424,4078,5,22973,1276,1,2,53,2,35370,14348,2696,20468,0
324,6573,74,35,59,1,0,14,75,3,14,7,14,17,21,58,85,1,128,7,0,2,53,2,35370,14349,2696,20469,0
324,6573,245,125,200,5,7,34,250,7,30,17,34,37,51,166,265,3,1053,58,0,2,53,2,35380,14350,2696,20470,0
221,4925,722,423,573,19,0,135,741,12,172,101,199,184,300,1320,2257,6,15668,870,0,2,11,1,35380,14352,2696,20472,0
221,4925,1508,847,911,44,250,301,1552,14,148,88,169,162,257,1120,1886,7,15077,837,0,2,11,1,35380,14353,2697,20473,0
91,3201,1450,624,1228,12,26,181,1462,14,306,186,354,320,540,2580,4493,8,36391,2021,1,2,183,0,35380,14355,2698,20474,0
140,3706,1660,832,1314,41,38,274,1701,20,312,209,395,332,604,2671,5058,12,64042,3557,1,2,11,35,35380,14357,2699,20476,0
68,3328,1457,730,1242,11,6,188,1468,10,292,166,329,302,495,2424,4078,5,22973,1276,1,2,19,5,35380,14359,2699,20477,0
146,6594,139,89,101,2,0,35,141,7,54,34,62,61,96,330,569,4,2287,127,0,2,2,1,35380,14359,2699,20478,0
146,6594,7,5,5,0,0,2,7,1,2,1,2,3,3,2,4,0,2,0,0,2,2,1,35380,14359,2699,20479,0
35,2163,652,304,544,16,6,88,668,6,89,51,101,95,152,591,998,3,3399,188,0,2,1,0,35380,14360,2699,20480,0
81,3317,1289,550,1043,56,32,155,1345,10,167,93,185,177,278,1266,2075,5,11498,638,0,2,3,1,35380,14362,2700,20481,0
81,3317,1289,550,1043,56,32,155,1345,10,167,93,185,177,278,1266,2075,5,11498,638,0,2,3,1,35380,14364,2701,20482,0
207,4421,182,127,129,0,0,53,182,5,39,21,42,44,63,217,343,2,926,51,0,2,0,35,35390,14368,2703,20490,1
207,4421,1165,710,800,67,119,181,1232,18,243,153,282,261,435,2000,3492,10,36473,2026,1,2,0,35,35400,14368,2704,20491,1
32,595,2,2,2,0,0,0,2,0,0,0,0,0,0,0,0,0,0,0,0,2,19,45,35400,14368,2704,20491,1
32,595,99,48,90,1,3,5,100,0,0,0,0,0,0,0,0,0,0,0,0,2,19,45,35400,14369,2704,20492,1
32,595,8,5,5,2,0,1,10,0,0,0,0,0,0,0,0,0,0,0,0,2,19,45,35400,14369,2704,20493,1
32,595,1217,716,841,84,126,174,1301,14,185,118,215,199,333,1446,2542,8,20687,1149,0,2,19,45,35410,14371,2704,20494,1
32,595,160,89,115,0,13,31,160,7,15,11,17,22,28,78,124,3,495,27,0,2,19,45,35410,14371,2704,20495,1
32,595,10,10,9,9,0,0,19,0,0,0,0,0,0,0,0,0,0,0,0,2,19,45,35410,14371,2705,20496,1
32,595,173,84,99,8,29,36,181,5,12,7,13,17,20,54,81,2,221,12,0,2,19,45,35410,14372,2705,20497,1
32,595,3,1,1,3,0,0,6,0,0,0,0,0,0,0,0,0,0,0,0,2,19,45,35410,14372,2705,20498,1
324,6577,1457,730,1242,11,6,188,1468,10,292,166,329,302,495,2424,4078,5,22973,1276,1,2,16,12,35410,14374,2705,20499,1
324,6577,74,35,59,1,0,14,75,3,14,7,14,17,21,58,85,1,128,7,0,2,16,12,35410,14375,2705,20500,1
324,6577,245,125,200,5,7,34,250,7,30,17,34,37,51,166,265,3,1053,58,0,2,16,12,35420,14376,2705,20501,1
34,980,182,127,129,0,0,53,182,5,39,21,42,44,63,217,343,2,926,51,0,2,0,18,35420,14376,2706,20502,1
133,6161,1392,870,1177,35,17,170,1427,14,494,280,531,508,811,4473,7289,7,54850,3047,2,2,2,46,35420,14379,2707,20503,1
86,3108,1450,624,1228,12,26,181,1462,14,306,186,354,320,540,2580,4493,8,36391,2021,1,2,4,24,35420,14381,2708,20504,1
311,6718,72,33,56,0,4,12,72,1,1,1,1,2,2,0,2,0,1,0,0,2,45,40,35420,14381,2708,20505,1
311,6718,1454,835,1044,76,110,219,1530,17,275,158,296,292,454,2297,3718,9,34017,1889,1,2,45,40,35430,14382,2708,20506,1
62,2604,1043,504,840,53,9,147,1096,9,180,112,198,189,310,1377,2344,4,11604,644,0,2,4,3,35430,14384,2708,20507,1
14,520,295,56,236,0,4,54,295,2,9,5,10,11,15,30,51,1,57,3,0,2,52,0,35430,14386,2708,20508,1
207,4421,182,127,129,0,0,53,182,5,39,21,42,44,63,217,343,2,926,51,0,2,0,35,35440,14390,2710,20516,0
207,4421,1165,710,800,67,119,181,1232,18,243,153,282,261,435,2000,3492,10,36473,2026,1,2,0,35,35450,14390,2711,20517,0
32,595,2,2,2,0,0,0,2,0,0,0,0,0,0,0,0,0,0,0,0,2,19,45,35450,14390,2711,20517,0
32,595,99,48,90,1,3,5,100,0,0,0,0,0,0,0,0,0,0,0,0,2,19,45,35450,14391,2711,20518,0
32,595,8,5,5,2,0,1,10,0,0,0,0,0,0,0,0,0,0,0,0,2,19,45,35450,14391,2711,20519,0
32,595,1217,716,841,84,126,174,1301,14,185,118,215,199,333,1446,2542,8,20687,1149,0,2,19,45,35460,14393,2711,20520,0
32,595,160,89,115,0,13,31,160,7,15,11,17,22,28,78,124,3,495,27,0,2,19,45,35460,14393,2711,20521,0
32,595,10,10,9,9,0,0,19,0,0,0,0,0,0,0,0,0,0,0,0,2,19,45,35460,14393,2712,20522,0
32,595,173,84,99,8,29,36,181,5,12,7,13,17,20,54,81,2,221,12,0,2,19,45,35460,14394,2712,20523,0
32,595,3,1,1,3,0,0,6,0,0,0,0,0,0,0,0,0,0,0,0,2,19,45,35460,14394,2712,20524,0
324,6577,1457,730,1242,11,6,188,1468,10,292,166,329,302,495,2424,4078,5,22973,1276,1,2,16,12,35460,14396,2712,20525,0
324,6577,74,35,59,1,0,14,75,3,14,7,14,17,21,58,85,1,128,7,0,2,16,12,35460,14397,2712,20526,0
324,6577,245,125,200,5,7,34,250,7,30,17,34,37,51,166,265,3,1053,58,0,2,16,12,35470,14398,2712,20527,0
34,980,182,127,129,0,0,53,182,5,39,21,42,44,63,217,343,2,926,51,0,2,0,18,35470,14398,2713,20528,0
133,6161,1392,870,1177,35,17,170,1427,14,494,280,531,508,811,4473,7289,7,54850,3047,2,2,2,46,35470,14401,2714,20529,0
86,3108,1450,624,1228,12,26,181,1462,14,306,186,354,320,540,2580,4493,8,36391,2021,1,2,4,24,35470,14403,2715,20530,0
311,6718,72,33,56,0,4,12,72,1,1,1,1,2,2,0,2,0,1,0,0,2,45,40,35470,14403,2715,20531,0
311,6718,1454,835,1044,76,110,219,1530,17,275,158,296,292,454,2297,3718,9,34017,1889,1,2,45,40,35480,14404,2715,20532,0
62,2604,1043,504,840,53,9,147,1096,9,180,112,198,189,310,1377,2344,4,11604,644,0,2,4,3,35480,14406,2715,20533,0
14,520,295,56,236,0,4,54,295,2,9,5,10,11,15,30,51,1,57,3,0,2,52,0,35480,14408,2715,20534,0
324,6585,1457,730,1242,11,6,188,1468,10,292,166,329,302,495,2424,4078,5,22973,1276,1,2,9,2,35480,14410,2715,20535,0
324,6585,74,35,59,1,0,14,75,3,14,7,14,17,21,58,85,1,128,7,0,2,9,2,35480,14411,2715,20536,0
324,6585,245,125,200,5,7,34,250,7,30,17,34,37,51,166,265,3,1053,58,0,2,9,2,35490,14412,2715,20537,0
321,6564,1457,730,1242,11,6,188,1468,10,292,166,329,302,495,2424,4078,5,22973,1276,1,2,19,28,35490,14414,2715,20538,1
321,6564,74,35,59,1,0,14,75,3,14,7,14,17,21,58,85,1,128,7,0,2,19,28,35490,14415,2715,20539,1
321,6564,245,125,200,5,7,34,250,7,30,17,34,37,51,166,265,3,1053,58,0,2,19,28,35500,14416,2715,20540,1
321,6564,1457,730,1242,11,6,188,1468,10,292,166,329,302,495,2424,4078,5,22973,1276,1,2,28,30,35500,14418,2715,20541,0
321,6564,74,35,59,1,0,14,75,3,14,7,14,17,21,58,85,1,128,7,0,2,28,30,35500,14419,2715,20542,0
321,6564,245,125,200,5,7,34,250,7,30,17,34,37,51,166,265,3,1053,58,0,2,28,30,35510,14420,2715,20543,0
174,4040,77,34,69,0,0,8,77,3,24,16,29,27,45,114,213,1,387,21,0,2,4,4,35510,14420,2715,20544,1
174,4040,712,438,573,51,9,84,763,14,102,71,128,116,199,733,1364,8,11988,666,0,2,4,4,35520,14421,2715,20545,1
25,1016,373,158,315,8,0,51,381,5,76,44,79,81,123,486,779,2,2026,112,0,2,8,0,35520,14421,2715,20546,1
100,1889,1178,367,1042,6,15,115,1184,9,94,51,95,103,146,644,976,4,4439,246,0,2,1,5,35520,14421,2715,20547,1
100,1889,177,108,140,8,0,27,185,6,30,16,32,36,48,162,248,3,794,44,0,2,1,5,35520,14423,2715,20548,1
100,1889,1178,367,1042,6,15,115,1184,9,94,51,95,103,146,644,976,4,4439,246,0,2,1,5,35520,14423,2715,20549,0
100,1889,177,108,140,8,0,27,185,6,30,16,32,36,48,162,248,3,794,44,0,2,1,5,35520,14425,2715,20550,0
174,4040,77,34,69,0,0,8,77,3,24,16,29,27,45,114,213,1,387,21,0,2,4,4,35520,14425,2715,20551,0
174,4040,712,438,573,51,9,84,763,14,102,71,128,116,199,733,1364,8,11988,666,0,2,4,4,35530,14426,2715,20552,0
25,1016,373,158,315,8,0,51,381,5,76,44,79,81,123,486,779,2,2026,112,0,2,8,0,35530,14426,2715,20553,0
207,4421,182,127,129,0,0,53,182,5,39,21,42,44,63,217,343,2,926,51,0,2,0,35,35540,14430,2717,20561,0
207,4421,1165,710,800,67,119,181,1232,18,243,153,282,261,435,2000,3492,10,36473,2026,1,2,0,35,35550,14430,2718,20562,0
32,595,2,2,2,0,0,0,2,0,0,0,0,0,0,0,0,0,0,0,0,2,59,85,35550,14430,2718,20562,0
32,595,99,48,90,1,3,5,100,0,0,0,0,0,0,0,0,0,0,0,0,2,59,85,35550,14431,2718,20563,0
32,595,8,5,5,2,0,1,10,0,0,0,0,0,0,0,0,0,0,0,0,2,59,85,35550,14431,2718,20564,0
32,595,1217,716,841,84,126,174,1301,14,185,118,215,199,333,1446,2542,8,20687,1149,0,2,59,85,35560,14433,2718,20565,0
32,595,160,89,115,0,13,31,160,7,15,11,17,22,28,78,124,3,495,27,0,2,59,85,35560,14433,2718,20566,0
32,595,10,10,9,9,0,0,19,0,0,0,0,0,0,0,0,0,0,0,0,2,59,85,35560,14433,2719,20567,0
32,595,173,84,99,8,29,36,181,5,12,7,13,17,20,54,81,2,221,12,0,2,59,85,35560,14434,2719,20568,0
32,595,3,1,1,3,0,0,6,0,0,0,0,0,0,0,0,0,0,0,0,2,59,85,35560,14434,2719,20569,0
160,5038,1660,832,1314,41,38,274,1701,20,312,209,395,332,604,2671,5058,12,64042,3557,1,2,29,2,35560,14436,2720,20571,0
160,5038,1057,646,719,113,100,145,1170,18,215,134,248,233,382,1740,3004,10,31186,1732,1,2,29,2,35570,14437,2721,20572,0
82,1803,477,336,357,30,23,73,507,16,194,134,250,210,384,1538,2962,10,30538,1696,0,2,0,33,35580,14438,2721,20573,0
40,775,207,111,150,11,0,50,218,5,26,19,36,31,55,133,272,3,943,52,0,0,203,0,35580,14438,2721,20574,0
40,775,410,198,237,31,55,97,441,11,63,38,72,74,110,414,683,6,4293,238,0,0,203,0,35590,14439,2722,20575,0
322,6605,1457,730,1242,11,6,188,1468,10,292,166,329,302,495,2424,4078,5,22973,1276,1,2,100,46,35590,14441,2722,20576,0
322,6605,74,35,59,1,0,14,75,3,14,7,14,17,21,58,85,1,128,7,0,2,100,46,35590,14442,2722,20577,0
322,6605,245,125,200,5,7,34,250,7,30,17,34,37,51,166,265,3,1053,58,0,2,100,46,35600,14443,2722,20578,0
23,680,339,213,244,17,9,65,356,10,42,26,48,52,74,259,421,5,2410,133,0,3,19,6,35610,14443,2722,20579,0
55,1468,1455,414,1257,16,76,112,1471,5,41,23,46,46,69,231,381,2,1069,59,0,2,2,2,35610,14444,2722,20580,0
55,1468,669,365,481,22,61,110,691,15,103,63,122,118,185,747,1273,8,11311,628,0,2,2,2,35620,14444,2723,20581,0
222,4964,4293,999,3693,19,54,507,4312,9,155,88,170,164,258,1156,1898,4,9368,520,0,0,1089,0,35620,14446,2723,20582,0
222,4964,1482,859,1002,125,135,219,1607,16,219,134,251,235,385,1766,3032,9,27804,1544,1,0,1089,0,35630,14447,2723,20583,0
174,4040,77,34,69,0,0,8,77,3,24,16,29,27,45,114,213,1,387,21,0,2,4,4,35630,14447,2723,20584,0
174,4040,712,438,573,51,9,84,763,14,102,71,128,116,199,733,1364,8,11988,666,0,2,4,4,35640,14448,2723,20585,0
46,949,447,308,343,6,5,95,453,7,96,59,111,103,170,651,1136,4,4600,255,0,2,7,4,35640,14451,2723,20586,0
46,949,322,174,179,16,74,51,338,10,41,26,46,51,72,252,408,5,2291,127,0,2,7,4,35640,14454,2724,20587,0
221,4925,722,423,573,19,0,135,741,12,172,101,199,184,300,1320,2257,6,15668,870,0,2,13,2,35640,14456,2724,20589,0
221,4925,1508,847,911,44,250,301,1552,14,148,88,169,162,257,1120,1886,7,15077,837,0,2,13,2,35640,14457,2725,20590,0
311,6718,72,33,56,0,4,12,72,1,1,1,1,2,2,0,2,0,1,0,0,2,80,1276,35640,14457,2725,20591,0
311,6718,1454,835,1044,76,110,219,1530,17,275,158,296,292,454,2297,3718,9,34017,1889,1,2,80,1276,35650,14458,2725,20592,0
122,2648,1043,504,840,53,9,147,1096,9,180,112,198,189,310,1377,2344,4,11604,644,0,2,2,2,35650,14460,2725,20593,0
122,2648,383,288,292,26,6,62,409,11,65,38,67,76,105,429,656,5,3719,206,0,2,2,2,35650,14461,2725,20594,0
20,400,294,64,250,0,0,43,294,1,20,10,20,21,30,86,131,0,65,3,0,2,17,4,35650,14461,2725,20595,0
20,400,78,46,62,3,0,14,81,3,8,4,8,11,12,28,41,1,62,3,0,2,17,4,35650,14462,2725,20596,0
5,110,110,30,77,3,13,16,113,4,21,15,30,25,45,100,208,2,597,33,0,2,6,2,35650,14462,2725,20597,0
5,110,28,15,21,1,0,6,29,0,0,0,0,0,0,0,0,0,0,0,0,2,6,2,35650,14462,2725,20598,0
100,1889,1178,367,1042,6,15,115,1184,9,94,51,95,103,146,644,976,4,4439,246,0,2,1,5,35650,14462,2725,20599,0
100,1889,177,108,140,8,0,27,185,6,30,16,32,36,48,162,248,3,794,44,0,2,1,5,35650,14464,2725,20600,0
180,3702,1943,715,1694,26,18,214,1969,12,185,120,237,197,357,1436,2721,7,20915,1161,0,2,12,3,35650,14466,2725,20601,0
180,3702,1168,838,957,57,25,144,1225,19,348,224,416,367,640,3018,5452,11,61921,3440,1,2,12,3,35660,14468,2725,20602,0
16,468,442,244,305,14,16,103,456,11,68,45,75,79,120,452,756,6,4588,254,0,2,2,2,35660,14470,2725,20603,0
16,468,182,102,99,11,40,35,193,3,11,6,11,14,17,42,64,1,97,5,0,2,2,2,35660,14471,2725,20604,0
81,3317,1289,550,1043,56,32,155,1345,10,167,93,185,177,278,1266,2075,5,11498,638,0,2,49,0,35660,14473,2726,20605,0
34,980,182,127,129,0,0,53,182,5,39,21,42,44,63,217,343,2,926,51,0,2,0,18,35660,14473,2727,20606,0
133,6161,1392,870,1177,35,17,170,1427,14,494,280,531,508,811,4473,7289,7,54850,3047,2,2,6,48,35660,14476,2728,20607,0
91,2970,773,419,590,28,0,166,801,10,204,113,217,214,330,1598,2554,5,13587,754,0,2,5,5,35660,14476,2729,20608,0
85,3904,1338,495,1086,10,64,173,1348,11,122,82,157,133,239,883,1686,7,11934,663,0,2,8,5,35660,14478,2729,20609,0
146,6594,139,89,101,2,0,35,141,7,54,34,62,61,96,330,569,4,2287,127,0,2,173,85,35660,14478,2729,20610,0
146,6594,7,5,5,0,0,2,7,1,2,1,2,3,3,2,4,0,2,0,0,2,173,85,35660,14478,2729,20611,0
32,933,465,148,393,5,8,60,470,4,31,20,31,35,51,161,261,2,523,29,0,2,8,5,35660,14479,2729,20612,0
32,933,16,12,9,0,0,6,16,1,2,1,2,3,3,2,4,0,2,0,0,2,8,5,35660,14479,2729,20613,0
90,4801,1782,648,1425,9,47,279,1791,8,171,97,189,179,286,1292,2140,4,9462,525,0,2,34,21,35660,14480,2730,20614,0
86,3108,1450,624,1228,12,26,181,1462,14,306,186,354,320,540,2580,4493,8,36391,2021,1,2,181,15,35660,14482,2731,20615,0
140,3706,1660,832,1314,41,38,274,1701,20,312,209,395,332,604,2671,5058,12,64042,3557,1,2,56,47,35660,14484,2732,20617,0
68,3328,1457,730,1242,11,6,188,1468,10,292,166,329,302,495,2424,4078,5,22973,1276,1,2,37,6,35660,14486,2732,20618,0
37,2210,652,304,544,16,6,88,668,6,89,51,101,95,152,591,998,3,3399,188,0,2,1,0,35660,14487,2732,20619,0
76,3740,1523,757,1297,19,12,193,1542,12,193,117,230,205,347,1508,2664,7,19053,1058,0,2,13,4,35670,14489,2732,20620,0
66,2745,1020,354,843,12,15,144,1032,8,134,77,144,142,221,970,1580,4,6792,377,0,2,2,1,35670,14489,2732,20621,0
38,1616,447,308,343,6,5,95,453,7,96,59,111,103,170,651,1136,4,4600,255,0,2,4,3,35670,14492,2732,20622,0
39,2275,334,251,279,10,4,40,344,5,127,74,143,132,217,899,1528,2,4303,239,0,2,3,0,35670,14493,2732,20623,0
38,1401,1293,570,1093,25,15,163,1318,10,195,123,241,205,364,1516,2795,6,17273,959,0,2,31,3,35680,14495,2732,20624,0
62,2604,1043,504,840,53,9,147,1096,9,180,112,198,189,310,1377,2344,4,11604,644,0,2,7,4,35680,14497,2732,20625,0
14,520,295,56,236,0,4,54,295,2,9,5,10,11,15,30,51,1,57,3,0,2,54,1,35680,14499,2732,20626,0
25,1016,373,158,315,8,0,51,381,5,76,44,79,81,123,486,779,2,2026,112,0,2,8,0,35680,14499,2732,20627,0
67,2869,1178,367,1042,6,15,115,1184,9,94,51,95,103,146,644,976,4,4439,246,0,2,4,2,35680,14499,2732,20628,0
71,3611,1943,715,1694,26,18,214,1969,12,185,120,237,197,357,1436,2721,7,20915,1161,0,2,20,4,35680,14501,2732,20629,0
39,1537,1098,241,925,5,10,155,1103,7,46,25,49,53,74,273,423,3,1580,87,0,2,2,2,35690,14503,2732,20630,0
237,5209,4293,999,3693,19,54,507,4312,9,155,88,170,164,258,1156,1898,4,9368,520,0,2,2,4,35690,14505,2732,20631,1
237,5209,1482,859,1002,125,135,219,1607,16,219,134,251,235,385,1766,3032,9,27804,1544,1,2,2,4,35700,14506,2732,20632,1
322,6605,1457,730,1242,11,6,188,1468,10,292,166,329,302,495,2424,4078,5,22973,1276,1,2,6,0,35700,14508,2732,20633,0
322,6605,74,35,59,1,0,14,75,3,14,7,14,17,21,58,85,1,128,7,0,2,6,0,35700,14509,2732,20634,0
322,6605,245,125,200,5,7,34,250,7,30,17,34,37,51,166,265,3,1053,58,0,2,6,0,35710,14510,2732,20635,0
37,2210,652,304,544,16,6,88,668,6,89,51,101,95,152,591,998,3,3399,188,0,2,13,0,35710,14511,2732,20636,0
207,4421,182,127,129,0,0,53,182,5,39,21,42,44,63,217,343,2,926,51,0,2,0,35,35720,14515,2734,20644,0
207,4421,1165,710,800,67,119,181,1232,18,243,153,282,261,435,2000,3492,10,36473,2026,1,2,0,35,35730,14515,2735,20645,0
32,595,2,2,2,0,0,0,2,0,0,0,0,0,0,0,0,0,0,0,0,2,59,85,35730,14515,2735,20645,0
32,595,99,48,90,1,3,5,100,0,0,0,0,0,0,0,0,0,0,0,0,2,59,85,35730,14516,2735,20646,0
32,595,8,5,5,2,0,1,10,0,0,0,0,0,0,0,0,0,0,0,0,2,59,85,35730,14516,2735,20647,0
32,595,1217,716,841,84,126,174,1301,14,185,118,215,199,333,1446,2542,8,20687,1149,0,2,59,85,35740,14518,2735,20648,0
32,595,160,89,115,0,13,31,160,7,15,11,17,22,28,78,124,3,495,27,0,2,59,85,35740,14518,2735,20649,0
32,595,10,10,9,9,0,0,19,0,0,0,0,0,0,0,0,0,0,0,0,2,59,85,35740,14518,2736,20650,0
32,595,173,84,99,8,29,36,181,5,12,7,13,17,20,54,81,2,221,12,0,2,59,85,35740,14519,2736,20651,0
32,595,3,1,1,3,0,0,6,0,0,0,0,0,0,0,0,0,0,0,0,2,59,85,35740,14519,2736,20652,0
160,5038,1660,832,1314,41,38,274,1701,20,312,209,395,332,604,2671,5058,12,64042,3557,1,2,24,2,35740,14521,2737,20654,0
160,5038,1057,646,719,113,100,145,1170,18,215,134,248,233,382,1740,3004,10,31186,1732,1,2,24,2,35750,14522,2738,20655,0
322,6605,1457,730,1242,11,6,188,1468,10,292,166,329,302,495,2424,4078,5,22973,1276,1,2,98,32,35750,14524,2738,20656,0
322,6605,74,35,59,1,0,14,75,3,14,7,14,17,21,58,85,1,128,7,0,2,98,32,35750,14525,2738,20657,0
322,6605,245,125,200,5,7,34,250,7,30,17,34,37,51,166,265,3,1053,58,0,2,98,32,35760,14526,2738,20658,0
23,680,339,213,244,17,9,65,356,10,42,26,48,52,74,259,421,5,2410,133,0,2,19,6,35770,14526,2738,20659,0
237,5240,4293,999,3693,19,54,507,4312,9,155,88,170,164,258,1156,1898,4,9368,520,0,2,9,3,35770,14528,2738,20660,0
237,5240,1482,859,1002,125,135,219,1607,16,219,134,251,235,385,1766,3032,9,27804,1544,1,2,9,3,35780,14529,2738,20661,0
174,4040,77,34,69,0,0,8,77,3,24,16,29,27,45,114,213,1,387,21,0,2,4,4,35780,14529,2738,20662,0
174,4040,712,438,573,51,9,84,763,14,102,71,128,116,199,733,1364,8,11988,666,0,2,4,4,35790,14530,2738,20663,0
46,949,447,308,343,6,5,95,453,7,96,59,111,103,170,651,1136,4,4600,255,0,2,7,4,35790,14533,2738,20664,0
46,949,322,174,179,16,74,51,338,10,41,26,46,51,72,252,408,5,2291,127,0,2,7,4,35790,14536,2739,20665,0
221,4925,722,423,573,19,0,135,741,12,172,101,199,184,300,1320,2257,6,15668,870,0,2,13,2,35790,14538,2739,20667,0
221,4925,1508,847,911,44,250,301,1552,14,148,88,169,162,257,1120,1886,7,15077,837,0,2,13,2,35790,14539,2740,20668,0
311,6718,72,33,56,0,4,12,72,1,1,1,1,2,2,0,2,0,1,0,0,2,47,39,35790,14539,2740,20669,0
311,6718,1454,835,1044,76,110,219,1530,17,275,158,296,292,454,2297,3718,9,34017,1889,1,2,47,39,35800,14540,2740,20670,0
100,1889,1178,367,1042,6,15,115,1184,9,94,51,95,103,146,644,976,4,4439,246,0,2,1,5,35800,14540,2740,20671,0
100,1889,177,108,140,8,0,27,185,6,30,16,32,36,48,162,248,3,794,44,0,2,1,5,35800,14542,2740,20672,0
180,3702,1943,715,1694,26,18,214,1969,12,185,120,237,197,357,1436,2721,7,20915,1161,0,2,12,3,35800,14544,2740,20673,0
180,3702,1168,838,957,57,25,144,1225,19,348,224,416,367,640,3018,5452,11,61921,3440,1,2,12,3,35810,14546,2740,20674,0
16,468,442,244,305,14,16,103,456,11,68,45,75,79,120,452,756,6,4588,254,0,2,2,2,35810,14548,2740,20675,0
16,468,182,102,99,11,40,35,193,3,11,6,11,14,17,42,64,1,97,5,0,2,2,2,35810,14549,2740,20676,0
81,3317,1289,550,1043,56,32,155,1345,10,167,93,185,177,278,1266,2075,5,11498,638,0,2,49,0,35810,14551,2741,20677,0
34,980,182,127,129,0,0,53,182,5,39,21,42,44,63,217,343,2,926,51,0,2,0,18,35810,14551,2742,20678,0
133,6161,1392,870,1177,35,17,170,1427,14,494,280,531,508,811,4473,7289,7,54850,3047,2,2,5,47,35810,14554,2743,20679,0
91,2970,773,419,590,28,0,166,801,10,204,113,217,214,330,1598,2554,5,13587,754,0,2,5,5,35810,14554,2744,20680,0
85,3904,1338,495,1086,10,64,173,1348,11,122,82,157,133,239,883,1686,7,11934,663,0,2,7,4,35810,14556,2744,20681,0
146,6594,139,89,101,2,0,35,141,7,54,34,62,61,96,330,569,4,2287,127,0,2,130,49,35810,14556,2744,20682,0
146,6594,7,5,5,0,0,2,7,1,2,1,2,3,3,2,4,0,2,0,0,2,130,49,35810,14556,2744,20683,0
32,933,465,148,393,5,8,60,470,4,31,20,31,35,51,161,261,2,523,29,0,2,5,2,35810,14557,2744,20684,0
32,933,16,12,9,0,0,6,16,1,2,1,2,3,3,2,4,0,2,0,0,2,5,2,35810,14557,2744,20685,0
90,4801,1782,648,1425,9,47,279,1791,8,171,97,189,179,286,1292,2140,4,9462,525,0,2,25,12,35810,14558,2745,20686,0
86,3108,1450,624,1228,12,26,181,1462,14,306,186,354,320,540,2580,4493,8,36391,2021,1,2,181,15,35810,14560,2746,20687,0
140,3706,1660,832,1314,41,38,274,1701,20,312,209,395,332,604,2671,5058,12,64042,3557,1,2,11,35,35810,14562,2747,20689,0
68,3328,1457,730,1242,11,6,188,1468,10,292,166,329,302,495,2424,4078,5,22973,1276,1,2,21,7,35810,14564,2747,20690,0
37,2210,652,304,544,16,6,88,668,6,89,51,101,95,152,591,998,3,3399,188,0,2,14,0,35810,14565,2747,20691,0
76,3740,1523,757,1297,19,12,193,1542,12,193,117,230,205,347,1508,2664,7,19053,1058,0,2,13,4,35820,14567,2747,20692,0
66,2745,1020,354,843,12,15,144,1032,8,134,77,144,142,221,970,1580,4,6792,377,0,2,2,1,35820,14567,2747,20693,0
38,1616,447,308,343,6,5,95,453,7,96,59,111,103,170,651,1136,4,4600,255,0,2,4,3,35820,14570,2747,20694,0
38,1401,1293,570,1093,25,15,163,1318,10,195,123,241,205,364,1516,2795,6,17273,959,0,2,29,1,35830,14572,2747,20695,0
62,2604,1043,504,840,53,9,147,1096,9,180,112,198,189,310,1377,2344,4,11604,644,0,2,7,4,35830,14574,2747,20696,0
14,520,295,56,236,0,4,54,295,2,9,5,10,11,15,30,51,1,57,3,0,2,54,1,35830,14576,2747,20697,0
25,1016,373,158,315,8,0,51,381,5,76,44,79,81,123,486,779,2,2026,112,0,2,8,0,35830,14576,2747,20698,0
67,2869,1178,367,1042,6,15,115,1184,9,94,51,95,103,146,644,976,4,4439,246,0,2,4,2,35830,14576,2747,20699,0
71,3611,1943,715,1694,26,18,214,1969,12,185,120,237,197,357,1436,2721,7,20915,1161,0,2,20,4,35830,14578,2747,20700,0
39,1537,1098,241,925,5,10,155,1103,7,46,25,49,53,74,273,423,3,1580,87,0,2,2,2,35840,14580,2747,20701,0
46,954,447,308,343,6,5,95,453,7,96,59,111,103,170,651,1136,4,4600,255,0,2,6,3,35840,14583,2747,20702,1
46,954,322,174,179,16,74,51,338,10,41,26,46,51,72,252,408,5,2291,127,0,2,6,3,35840,14586,2748,20703,1
39,1661,447,308,343,6,5,95,453,7,96,59,111,103,170,651,1136,4,4600,255,0,2,33,1,35840,14589,2748,20704,1
223,4983,722,423,573,19,0,135,741,12,172,101,199,184,300,1320,2257,6,15668,870,0,2,18,10,35840,14591,2748,20706,1
223,4983,1508,847,911,44,250,301,1552,14,148,88,169,162,257,1120,1886,7,15077,837,0,2,18,10,35840,14592,2749,20707,1
223,4983,722,423,573,19,0,135,741,12,172,101,199,184,300,1320,2257,6,15668,870,0,2,18,10,35840,14594,2749,20709,0
223,4983,1508,847,911,44,250,301,1552,14,148,88,169,162,257,1120,1886,7,15077,837,0,2,18,10,35840,14595,2750,20710,0
117,2369,1513,682,1277,25,13,200,1538,11,199,116,219,210,335,1557,2584,6,15641,868,0,2,2,2,35840,14597,2750,20711,0
117,2369,819,519,539,24,98,155,843,15,96,57,106,111,163,690,1107,8,9171,509,0,2,2,2,35850,14599,2750,20712,0
237,5240,4293,999,3693,19,54,507,4312,9,155,88,170,164,258,1156,1898,4,9368,520,0,2,99,39,35850,14601,2750,20713,0
237,5240,1482,859,1002,125,135,219,1607,16,219,134,251,235,385,1766,3032,9,27804,1544,1,2,99,39,35860,14602,2750,20714,0
46,954,447,308,343,6,5,95,453,7,96,59,111,103,170,651,1136,4,4600,255,0,2,6,3,35860,14605,2750,20715,0
46,954,322,174,179,16,74,51,338,10,41,26,46,51,72,252,408,5,2291,127,0,2,6,3,35860,14608,2751,20716,0
311,6718,72,33,56,0,4,12,72,1,1,1,1,2,2,0,2,0,1,0,0,2,0,1,35860,14608,2751,20717,0
311,6718,1454,835,1044,76,110,219,1530,17,275,158,296,292,454,2297,3718,9,34017,1889,1,2,0,1,35870,14609,2751,20718,0
114,4432,1513,682,1277,25,13,200,1538,11,199,116,219,210,335,1557,2584,6,15641,868,0,2,19,0,35870,14611,2751,20719,0
39,1661,447,308,343,6,5,95,453,7,96,59,111,103,170,651,1136,4,4600,255,0,2,33,1,35870,14614,2751,20720,0
115,2299,1513,682,1277,25,13,200,1538,11,199,116,219,210,335,1557,2584,6,15641,868,0,2,2,2,35870,14616,2751,20721,1
115,2299,819,519,539,24,98,155,843,15,96,57,106,111,163,690,1107,8,9171,509,0,2,2,2,35880,14618,2751,20722,1
67,1993,1523,757,1297,19,12,193,1542,12,193,117,230,205,347,1508,2664,7,19053,1058,0,2,2,2,35890,14620,2751,20723,1
67,1993,701,378,504,33,58,109,734,13,110,68,126,123,194,794,1346,7,10027,557,0,2,2,2,35890,14621,2752,20724,1
46,943,447,308,343,6,5,95,453,7,96,59,111,103,170,651,1136,4,4600,255,0,2,3,3,35890,14624,2752,20725,1
46,943,322,174,179,16,74,51,338,10,41,26,46,51,72,252,408,5,2291,127,0,2,3,3,35890,14627,2753,20726,1
517,11149,72,33,56,0,4,12,72,1,1,1,1,2,2,0,2,0,1,0,0,2,1,1,35890,14627,2753,20727,1
517,11149,1454,835,1044,76,110,219,1530,17,275,158,296,292,454,2297,3718,9,34017,1889,1,2,1,1,35900,14628,2753,20728,1
16,468,442,244,305,14,16,103,456,11,68,45,75,79,120,452,756,6,4588,254,0,2,1,1,35900,14630,2753,20729,1
16,468,182,102,99,11,40,35,193,3,11,6,11,14,17,42,64,1,97,5,0,2,1,1,35900,14631,2753,20730,1
115,2299,1513,682,1277,25,13,200,1538,11,199,116,219,210,335,1557,2584,6,15641,868,0,2,2,2,35900,14633,2753,20731,0
115,2299,819,519,539,24,98,155,843,15,96,57,106,111,163,690,1107,8,9171,509,0,2,2,2,35910,14635,2753,20732,0
67,1993,1523,757,1297,19,12,193,1542,12,193,117,230,205,347,1508,2664,7,19053,1058,0,2,2,2,35920,14637,2753,20733,0
67,1993,701,378,504,33,58,109,734,13,110,68,126,123,194,794,1346,7,10027,557,0,2,2,2,35920,14638,2754,20734,0
46,943,447,308,343,6,5,95,453,7,96,59,111,103,170,651,1136,4,4600,255,0,2,3,3,35920,14641,2754,20735,0
46,943,322,174,179,16,74,51,338,10,41,26,46,51,72,252,408,5,2291,127,0,2,3,3,35920,14644,2755,20736,0
517,11149,72,33,56,0,4,12,72,1,1,1,1,2,2,0,2,0,1,0,0,2,1,1,35920,14644,2755,20737,0
517,11149,1454,835,1044,76,110,219,1530,17,275,158,296,292,454,2297,3718,9,34017,1889,1,2,1,1,35930,14645,2755,20738,0
16,468,442,244,305,14,16,103,456,11,68,45,75,79,120,452,756,6,4588,254,0,2,1,1,35930,14647,2755,20739,0
16,468,182,102,99,11,40,35,193,3,11,6,11,14,17,42,64,1,97,5,0,2,1,1,35930,14648,2755,20740,0
56,1547,1455,414,1257,16,76,112,1471,5,41,23,46,46,69,231,381,2,1069,59,0,2,15,1,35930,14649,2755,20741,1
56,1547,669,365,481,22,61,110,691,15,103,63,122,118,185,747,1273,8,11311,628,0,2,15,1,35940,14649,2756,20742,1
56,1556,1455,414,1257,16,76,112,1471,5,41,23,46,46,69,231,381,2,1069,59,0,2,8,7,35940,14650,2756,20743,1
56,1556,669,365,481,22,61,110,691,15,103,63,122,118,185,747,1273,8,11311,628,0,2,8,7,35950,14650,2757,20744,1
64,2717,1455,414,1257,16,76,112,1471,5,41,23,46,46,69,231,381,2,1069,59,0,2,79,0,35950,14651,2757,20745,1
57,1569,1455,414,1257,16,76,112,1471,5,41,23,46,46,69,231,381,2,1069,59,0,2,8,7,35950,14652,2757,20746,0
57,1569,669,365,481,22,61,110,691,15,103,63,122,118,185,747,1273,8,11311,628,0,2,8,7,35960,14652,2758,20747,0
64,2720,1455,414,1257,16,76,112,1471,5,41,23,46,46,69,231,381,2,1069,59,0,2,81,79,35960,14653,2758,20748,1
57,1571,1455,414,1257,16,76,112,1471,5,41,23,46,46,69,231,381,2,1069,59,0,2,11,3,35960,14654,2758,20749,0
57,1571,669,365,481,22,61,110,691,15,103,63,122,118,185,747,1273,8,11311,628,0,2,11,3,35970,14654,2759,20750,0
62,2710,1455,414,1257,16,76,112,1471,5,41,23,46,46,69,231,381,2,1069,59,0,2,2,5,35970,14655,2759,20751,0
61,2720,1455,414,1257,16,76,112,1471,5,41,23,46,46,69,231,381,2,1069,59,0,2,15,15,35970,14656,2759,20752,0
56,1576,1455,414,1257,16,76,112,1471,5,41,23,46,46,69,231,381,2,1069,59,0,2,26,18,35970,14657,2759,20753,1
56,1576,669,365,481,22,61,110,691,15,103,63,122,118,185,747,1273,8,11311,628,0,2,26,18,35980,14657,2760,20754,1
56,1576,1455,414,1257,16,76,112,1471,5,41,23,46,46,69,231,381,2,1069,59,0,2,2,2,35980,14658,2760,20755,1
56,1576,669,365,481,22,61,110,691,15,103,63,122,118,185,747,1273,8,11311,628,0,2,2,2,35990,14658,2761,20756,1
314,6752,72,33,56,0,4,12,72,1,1,1,1,2,2,0,2,0,1,0,0,2,8,2,35990,14658,2761,20757,1
314,6752,1454,835,1044,76,110,219,1530,17,275,158,296,292,454,2297,3718,9,34017,1889,1,2,8,2,36000,14659,2761,20758,1
91,4840,1782,648,1425,9,47,279,1791,8,171,97,189,179,286,1292,2140,4,9462,525,0,2,19,2,36000,14660,2762,20759,1
148,6629,139,89,101,2,0,35,141,7,54,34,62,61,96,330,569,4,2287,127,0,2,32,0,36000,14660,2762,20760,1
148,6629,7,5,5,0,0,2,7,1,2,1,2,3,3,2,4,0,2,0,0,2,32,0,36000,14660,2762,20761,1
56,1576,1455,414,1257,16,76,112,1471,5,41,23,46,46,69,231,381,2,1069,59,0,2,36,4,36000,14661,2762,20762,0
56,1576,669,365,481,22,61,110,691,15,103,63,122,118,185,747,1273,8,11311,628,0,2,36,4,36010,14661,2763,20763,0
61,2720,1455,414,1257,16,76,112,1471,5,41,23,46,46,69,231,381,2,1069,59,0,2,78,0,36010,14662,2763,20764,0
148,6629,139,89,101,2,0,35,141,7,54,34,62,61,96,330,569,4,2287,127,0,2,32,0,36010,14662,2763,20765,0
148,6629,7,5,5,0,0,2,7,1,2,1,2,3,3,2,4,0,2,0,0,2,32,0,36010,14662,2763,20766,0
518,11168,72,33,56,0,4,12,72,1,1,1,1,2,2,0,2,0,1,0,0,2,7,2,36010,14662,2763,20767,1
518,11168,1454,835,1044,76,110,219,1530,17,275,158,296,292,454,2297,3718,9,34017,1889,1,2,7,2,36020,14663,2763,20768,1
77,3168,1289,550,1043,56,32,155,1345,10,167,93,185,177,278,1266,2075,5,11498,638,0,2,1,1,36020,14665,2764,20769,1
112,4316,1513,682,1277,25,13,200,1538,11,199,116,219,210,335,1557,2584,6,15641,868,0,2,2,2,36020,14667,2764,20770,1
24,834,74,35,59,1,0,14,75,3,14,7,14,17,21,58,85,1,128,7,0,2,4,4,36020,14668,2764,20771,1
24,834,245,125,200,5,7,34,250,7,30,17,34,37,51,166,265,3,1053,58,0,2,4,4,36030,14669,2764,20772,1
146,6594,139,89,101,2,0,35,141,7,54,34,62,61,96,330,569,4,2287,127,0,2,1,1,36030,14669,2764,20773,1
146,6594,7,5,5,0,0,2,7,1,2,1,2,3,3,2,4,0,2,0,0,2,1,1,36030,14669,2764,20774,1
68,3327,1457,730,1242,11,6,188,1468,10,292,166,329,302,495,2424,4078,5,22973,1276,1,2,42,60,36030,14671,2764,20775,1
314,6750,72,33,56,0,4,12,72,1,1,1,1,2,2,0,2,0,1,0,0,2,1,1,36030,14671,2764,20776,0
314,6750,1454,835,1044,76,110,219,1530,17,275,158,296,292,454,2297,3718,9,34017,1889,1,2,1,1,36040,14672,2764,20777,0
92,4879,1782,648,1425,9,47,279,1791,8,171,97,189,179,286,1292,2140,4,9462,525,0,2,17,0,36040,14673,2765,20778,0
56,1576,1455,414,1257,16,76,112,1471,5,41,23,46,46,69,231,381,2,1069,59,0,2,36,4,36040,14674,2765,20779,0
56,1576,669,365,481,22,61,110,691,15,103,63,122,118,185,747,1273,8,11311,628,0,2,36,4,36050,14674,2766,20780,0
61,2720,1455,414,1257,16,76,112,1471,5,41,23,46,46,69,231,381,2,1069,59,0,2,78,0,36050,14675,2766,20781,0
175,4054,77,34,69,0,0,8,77,3,24,16,29,27,45,114,213,1,387,21,0,2,5,0,36050,14675,2766,20782,1
175,4054,712,438,573,51,9,84,763,14,102,71,128,116,199,733,1364,8,11988,666,0,2,5,0,36060,14676,2766,20783,1
64,2671,1043,504,840,53,9,147,1096,9,180,112,198,189,310,1377,2344,4,11604,644,0,2,12,0,36060,14678,2766,20784,1
24,834,74,35,59,1,0,14,75,3,14,7,14,17,21,58,85,1,128,7,0,2,4,4,36060,14679,2766,20785,0
24,834,245,125,200,5,7,34,250,7,30,17,34,37,51,166,265,3,1053,58,0,2,4,4,36070,14680,2766,20786,0
146,6594,139,89,101,2,0,35,141,7,54,34,62,61,96,330,569,4,2287,127,0,2,1,1,36070,14680,2766,20787,0
146,6594,7,5,5,0,0,2,7,1,2,1,2,3,3,2,4,0,2,0,0,2,1,1,36070,14680,2766,20788,0
68,3327,1457,730,1242,11,6,188,1468,10,292,166,329,302,495,2424,4078,5,22973,1276,1,2,42,60,36070,14682,2766,20789,0
314,6750,72,33,56,0,4,12,72,1,1,1,1,2,2,0,2,0,1,0,0,2,8,2,36070,14682,2766,20790,0
314,6750,1454,835,1044,76,110,219,1530,17,275,158,296,292,454,2297,3718,9,34017,1889,1,2,8,2,36080,14683,2766,20791,0
92,4879,1782,648,1425,9,47,279,1791,8,171,97,189,179,286,1292,2140,4,9462,525,0,2,36,2,36080,14684,2767,20792,0
175,4054,77,34,69,0,0,8,77,3,24,16,29,27,45,114,213,1,387,21,0,2,5,0,36080,14684,2767,20793,0
175,4054,712,438,573,51,9,84,763,14,102,71,128,116,199,733,1364,8,11988,666,0,2,5,0,36090,14685,2767,20794,0
64,2671,1043,504,840,53,9,147,1096,9,180,112,198,189,310,1377,2344,4,11604,644,0,2,12,0,36090,14687,2767,20795,0
175,4040,77,34,69,0,0,8,77,3,24,16,29,27,45,114,213,1,387,21,0,2,1,2,36090,14687,2767,20796,0
175,4040,712,438,573,51,9,84,763,14,102,71,128,116,199,733,1364,8,11988,666,0,2,1,2,36100,14688,2767,20797,0
175,4040,77,34,69,0,0,8,77,3,24,16,29,27,45,114,213,1,387,21,0,2,1,2,36100,14688,2767,20798,0
175,4040,712,438,573,51,9,84,763,14,102,71,128,116,199,733,1364,8,11988,666,0,2,1,2,36110,14689,2767,20799,0
519,11194,72,33,56,0,4,12,72,1,1,1,1,2,2,0,2,0,1,0,0,2,11,4,36110,14689,2767,20800,0
519,11194,1454,835,1044,76,110,219,1530,17,275,158,296,292,454,2297,3718,9,34017,1889,1,2,11,4,36120,14690,2767,20801,0
85,3914,1338,495,1086,10,64,173,1348,11,122,82,157,133,239,883,1686,7,11934,663,0,2,12,0,36120,14692,2767,20802,0
519,11194,72,33,56,0,4,12,72,1,1,1,1,2,2,0,2,0,1,0,0,2,11,4,36120,14692,2767,20803,0
519,11194,1454,835,1044,76,110,219,1530,17,275,158,296,292,454,2297,3718,9,34017,1889,1,2,11,4,36130,14693,2767,20804,0
85,3914,1338,495,1086,10,64,173,1348,11,122,82,157,133,239,883,1686,7,11934,663,0,2,12,0,36130,14695,2767,20805,0
322,6612,1457,730,1242,11,6,188,1468,10,292,166,329,302,495,2424,4078,5,22973,1276,1,2,1,0,36130,14697,2767,20806,1
322,6612,74,35,59,1,0,14,75,3,14,7,14,17,21,58,85,1,128,7,0,2,1,0,36130,14698,2767,20807,1
322,6612,245,125,200,5,7,34,250,7,30,17,34,37,51,166,265,3,1053,58,0,2,1,0,36140,14699,2767,20808,1
177,4103,77,34,69,0,0,8,77,3,24,16,29,27,45,114,213,1,387,21,0,2,22,1,36140,14699,2767,20809,1
177,4103,712,438,573,51,9,84,763,14,102,71,128,116,199,733,1364,8,11988,666,0,2,22,1,36150,14700,2767,20810,1
87,4028,1338,495,1086,10,64,173,1348,11,122,82,157,133,239,883,1686,7,11934,663,0,2,37,0,36150,14702,2767,20811,1
92,4881,1782,648,1425,9,47,279,1791,8,171,97,189,179,286,1292,2140,4,9462,525,0,2,1,1,36150,14703,2768,20812,1
523,11235,72,33,56,0,4,12,72,1,1,1,1,2,2,0,2,0,1,0,0,2,8,2,36150,14703,2768,20813,0
523,11235,1454,835,1044,76,110,219,1530,17,275,158,296,292,454,2297,3718,9,34017,1889,1,2,8,2,36160,14704,2768,20814,0
84,4537,1782,648,1425,9,47,279,1791,8,171,97,189,179,286,1292,2140,4,9462,525,0,2,37,0,36160,14705,2769,20815,0
322,6608,1457,730,1242,11,6,188,1468,10,292,166,329,302,495,2424,4078,5,22973,1276,1,2,2,4,36160,14707,2769,20816,1
322,6608,74,35,59,1,0,14,75,3,14,7,14,17,21,58,85,1,128,7,0,2,2,4,36160,14708,2769,20817,1
322,6608,245,125,200,5,7,34,250,7,30,17,34,37,51,166,265,3,1053,58,0,2,2,4,36170,14709,2769,20818,1
237,5245,4293,999,3693,19,54,507,4312,9,155,88,170,164,258,1156,1898,4,9368,520,0,2,4,6,36170,14711,2769,20820,1
237,5245,1482,859,1002,125,135,219,1607,16,219,134,251,235,385,1766,3032,9,27804,1544,1,2,4,6,36180,14712,2769,20821,1
311,6721,72,33,56,0,4,12,72,1,1,1,1,2,2,0,2,0,1,0,0,2,2,2,36180,14712,2769,20822,1
311,6721,1454,835,1044,76,110,219,1530,17,275,158,296,292,454,2297,3718,9,34017,1889,1,2,2,2,36190,14713,2769,20823,1
77,3179,1289,550,1043,56,32,155,1345,10,167,93,185,177,278,1266,2075,5,11498,638,0,2,0,48,36190,14715,2770,20824,1
5,162,75,38,59,1,3,12,76,2,4,2,4,6,6,10,15,1,15,0,0,0,55,0,36190,14715,2770,20825,1
145,6578,139,89,101,2,0,35,141,7,54,34,62,61,96,330,569,4,2287,127,0,2,1,2,36190,14715,2770,20826,1
145,6578,7,5,5,0,0,2,7,1,2,1,2,3,3,2,4,0,2,0,0,2,1,2,36190,14715,2770,20827,1
14,811,442,244,305,14,16,103,456,11,68,45,75,79,120,452,756,6,4588,254,0,2,0,1,36190,14717,2770,20828,1
520,11213,72,33,56,0,4,12,72,1,1,1,1,2,2,0,2,0,1,0,0,2,7,2,36190,14717,2770,20829,0
520,11213,1454,835,1044,76,110,219,1530,17,275,158,296,292,454,2297,3718,9,34017,1889,1,2,7,2,36200,14718,2770,20830,0
77,3168,1289,550,1043,56,32,155,1345,10,167,93,185,177,278,1266,2075,5,11498,638,0,2,1,1,36200,14720,2771,20831,0
112,4316,1513,682,1277,25,13,200,1538,11,199,116,219,210,335,1557,2584,6,15641,868,0,2,2,2,36200,14722,2771,20832,0
524,11254,72,33,56,0,4,12,72,1,1,1,1,2,2,0,2,0,1,0,0,2,8,2,36200,14722,2771,20833,0
524,11254,1454,835,1044,76,110,219,1530,17,275,158,296,292,454,2297,3718,9,34017,1889,1,2,8,2,36210,14723,2771,20834,0
84,4537,1782,648,1425,9,47,279,1791,8,171,97,189,179,286,1292,2140,4,9462,525,0,2,37,0,36210,14724,2772,20835,0
322,6612,1457,730,1242,11,6,188,1468,10,292,166,329,302,495,2424,4078,5,22973,1276,1,2,1,0,36210,14726,2772,20836,0
322,6612,74,35,59,1,0,14,75,3,14,7,14,17,21,58,85,1,128,7,0,2,1,0,36210,14727,2772,20837,0
322,6612,245,125,200,5,7,34,250,7,30,17,34,37,51,166,265,3,1053,58,0,2,1,0,36220,14728,2772,20838,0
177,4103,77,34,69,0,0,8,77,3,24,16,29,27,45,114,213,1,387,21,0,2,22,1,36220,14728,2772,20839,0
177,4103,712,438,573,51,9,84,763,14,102,71,128,116,199,733,1364,8,11988,666,0,2,22,1,36230,14729,2772,20840,0
87,4028,1338,495,1086,10,64,173,1348,11,122,82,157,133,239,883,1686,7,11934,663,0,2,37,0,36230,14731,2772,20841,0
92,4881,1782,648,1425,9,47,279,1791,8,171,97,189,179,286,1292,2140,4,9462,525,0,2,1,1,36230,14732,2773,20842,0
177,4103,77,34,69,0,0,8,77,3,24,16,29,27,45,114,213,1,387,21,0,2,0,4,36230,14732,2773,20843,0
177,4103,712,438,573,51,9,84,763,14,102,71,128,116,199,733,1364,8,11988,666,0,2,0,4,36240,14733,2773,20844,0
117,2369,1513,682,1277,25,13,200,1538,11,199,116,219,210,335,1557,2584,6,15641,868,0,2,2,2,36240,14735,2773,20845,0
117,2369,819,519,539,24,98,155,843,15,96,57,106,111,163,690,1107,8,9171,509,0,2,2,2,36250,14737,2773,20846,0
238,5259,4293,999,3693,19,54,507,4312,9,155,88,170,164,258,1156,1898,4,9368,520,0,2,7,2,36250,14739,2773,20847,0
238,5259,1482,859,1002,125,135,219,1607,16,219,134,251,235,385,1766,3032,9,27804,1544,1,2,7,2,36260,14740,2773,20848,0
71,2075,1523,757,1297,19,12,193,1542,12,193,117,230,205,347,1508,2664,7,19053,1058,0,2,2,2,36270,14742,2773,20849,0
71,2075,701,378,504,33,58,109,734,13,110,68,126,123,194,794,1346,7,10027,557,0,2,2,2,36270,14743,2774,20850,0
179,4142,77,34,69,0,0,8,77,3,24,16,29,27,45,114,213,1,387,21,0,2,4,0,36270,14743,2774,20851,0
179,4142,712,438,573,51,9,84,763,14,102,71,128,116,199,733,1364,8,11988,666,0,2,4,0,36280,14744,2774,20852,0
46,954,447,308,343,6,5,95,453,7,96,59,111,103,170,651,1136,4,4600,255,0,2,2,2,36280,14747,2774,20853,0
46,954,322,174,179,16,74,51,338,10,41,26,46,51,72,252,408,5,2291,127,0,2,2,2,36280,14750,2775,20854,0
320,6840,72,33,56,0,4,12,72,1,1,1,1,2,2,0,2,0,1,0,0,2,22,8,36280,14750,2775,20855,0
320,6840,1454,835,1044,76,110,219,1530,17,275,158,296,292,454,2297,3718,9,34017,1889,1,2,22,8,36290,14751,2775,20856,0
16,468,442,244,305,14,16,103,456,11,68,45,75,79,120,452,756,6,4588,254,0,2,1,1,36290,14753,2775,20857,0
16,468,182,102,99,11,40,35,193,3,11,6,11,14,17,42,64,1,97,5,0,2,1,1,36290,14754,2775,20858,0
81,3317,1289,550,1043,56,32,155,1345,10,167,93,185,177,278,1266,2075,5,11498,638,0,2,1,1,36290,14756,2776,20859,0
88,4059,1338,495,1086,10,64,173,1348,11,122,82,157,133,239,883,1686,7,11934,663,0,2,12,0,36290,14758,2776,20860,0
147,6691,139,89,101,2,0,35,141,7,54,34,62,61,96,330,569,4,2287,127,0,2,32,0,36290,14758,2776,20861,0
147,6691,7,5,5,0,0,2,7,1,2,1,2,3,3,2,4,0,2,0,0,2,32,0,36290,14758,2776,20862,0
93,4930,1782,648,1425,9,47,279,1791,8,171,97,189,179,286,1292,2140,4,9462,525,0,2,37,0,36290,14759,2777,20863,0
114,4432,1513,682,1277,25,13,200,1538,11,199,116,219,210,335,1557,2584,6,15641,868,0,2,2,2,36290,14761,2777,20864,0
63,2634,1043,504,840,53,9,147,1096,9,180,112,198,189,310,1377,2344,4,11604,644,0,2,12,0,36290,14763,2777,20865,0
117,2369,1513,682,1277,25,13,200,1538,11,199,116,219,210,335,1557,2584,6,15641,868,0,2,2,2,36290,14765,2777,20866,0
117,2369,819,519,539,24,98,155,843,15,96,57,106,111,163,690,1107,8,9171,509,0,2,2,2,36300,14767,2777,20867,0
238,5259,4293,999,3693,19,54,507,4312,9,155,88,170,164,258,1156,1898,4,9368,520,0,2,7,2,36300,14769,2777,20868,0
238,5259,1482,859,1002,125,135,219,1607,16,219,134,251,235,385,1766,3032,9,27804,1544,1,2,7,2,36310,14770,2777,20869,0
71,2075,1523,757,1297,19,12,193,1542,12,193,117,230,205,347,1508,2664,7,19053,1058,0,2,2,2,36320,14772,2777,20870,0
71,2075,701,378,504,33,58,109,734,13,110,68,126,123,194,794,1346,7,10027,557,0,2,2,2,36320,14773,2778,20871,0
179,4142,77,34,69,0,0,8,77,3,24,16,29,27,45,114,213,1,387,21,0,2,4,0,36320,14773,2778,20872,0
179,4142,712,438,573,51,9,84,763,14,102,71,128,116,199,733,1364,8,11988,666,0,2,4,0,36330,14774,2778,20873,0
46,954,447,308,343,6,5,95,453,7,96,59,111,103,170,651,1136,4,4600,255,0,2,2,2,36330,14777,2778,20874,0
46,954,322,174,179,16,74,51,338,10,41,26,46,51,72,252,408,5,2291,127,0,2,2,2,36330,14780,2779,20875,0
320,6840,72,33,56,0,4,12,72,1,1,1,1,2,2,0,2,0,1,0,0,2,22,8,36330,14780,2779,20876,0
320,6840,1454,835,1044,76,110,219,1530,17,275,158,296,292,454,2297,3718,9,34017,1889,1,2,22,8,36340,14781,2779,20877,0
16,468,442,244,305,14,16,103,456,11,68,45,75,79,120,452,756,6,4588,254,0,2,1,1,36340,14783,2779,20878,0
16,468,182,102,99,11,40,35,193,3,11,6,11,14,17,42,64,1,97,5,0,2,1,1,36340,14784,2779,20879,0
81,3317,1289,550,1043,56,32,155,1345,10,167,93,185,177,278,1266,2075,5,11498,638,0,2,1,1,36340,14786,2780,20880,0
88,4059,1338,495,1086,10,64,173,1348,11,122,82,157,133,239,883,1686,7,11934,663,0,2,12,0,36340,14788,2780,20881,0
147,6691,139,89,101,2,0,35,141,7,54,34,62,61,96,330,569,4,2287,127,0,2,32,0,36340,14788,2780,20882,0
147,6691,7,5,5,0,0,2,7,1,2,1,2,3,3,2,4,0,2,0,0,2,32,0,36340,14788,2780,20883,0
93,4930,1782,648,1425,9,47,279,1791,8,171,97,189,179,286,1292,2140,4,9462,525,0,2,37,0,36340,14789,2781,20884,0
114,4432,1513,682,1277,25,13,200,1538,11,199,116,219,210,335,1557,2584,6,15641,868,0,2,2,2,36340,14791,2781,20885,0
63,2634,1043,504,840,53,9,147,1096,9,180,112,198,189,310,1377,2344,4,11604,644,0,2,12,0,36340,14793,2781,20886,0
179,4142,77,34,69,0,0,8,77,3,24,16,29,27,45,114,213,1,387,21,0,2,1,1,36340,14793,2781,20887,1
179,4142,712,438,573,51,9,84,763,14,102,71,128,116,199,733,1364,8,11988,666,0,2,1,1,36350,14794,2781,20888,1
179,4142,77,34,69,0,0,8,77,3,24,16,29,27,45,114,213,1,387,21,0,2,1,1,36350,14794,2781,20889,0
179,4142,712,438,573,51,9,84,763,14,102,71,128,116,199,733,1364,8,11988,666,0,2,1,1,36360,14795,2781,20890,0
2,26,6,4,4,0,0,2,6,1,4,2,4,5,6,8,13,0,6,0,0,3,5,5,36360,14795,2781,20893,1
2,26,6,4,4,0,0,2,6,1,4,2,4,5,6,8,13,0,6,0,0,3,5,5,36360,14795,2781,20897,0
322,6615,1457,730,1242,11,6,188,1468,10,292,166,329,302,495,2424,4078,5,22973,1276,1,2,2,4,36360,14797,2781,20899,0
322,6615,74,35,59,1,0,14,75,3,14,7,14,17,21,58,85,1,128,7,0,2,2,4,36360,14798,2781,20900,0
322,6615,245,125,200,5,7,34,250,7,30,17,34,37,51,166,265,3,1053,58,0,2,2,4,36370,14799,2781,20901,0
238,5264,4293,999,3693,19,54,507,4312,9,155,88,170,164,258,1156,1898,4,9368,520,0,2,4,6,36370,14801,2781,20903,0
238,5264,1482,859,1002,125,135,219,1607,16,219,134,251,235,385,1766,3032,9,27804,1544,1,2,4,6,36380,14802,2781,20904,0
320,6843,72,33,56,0,4,12,72,1,1,1,1,2,2,0,2,0,1,0,0,2,2,2,36380,14802,2781,20905,0
320,6843,1454,835,1044,76,110,219,1530,17,275,158,296,292,454,2297,3718,9,34017,1889,1,2,2,2,36390,14803,2781,20906,0
77,3179,1289,550,1043,56,32,155,1345,10,167,93,185,177,278,1266,2075,5,11498,638,0,2,0,48,36390,14805,2782,20907,0
5,162,75,38,59,1,3,12,76,2,4,2,4,6,6,10,15,1,15,0,0,0,55,0,36390,14805,2782,20908,0
146,6675,139,89,101,2,0,35,141,7,54,34,62,61,96,330,569,4,2287,127,0,2,1,2,36390,14805,2782,20909,0
146,6675,7,5,5,0,0,2,7,1,2,1,2,3,3,2,4,0,2,0,0,2,1,2,36390,14805,2782,20910,0
14,811,442,244,305,14,16,103,456,11,68,45,75,79,120,452,756,6,4588,254,0,2,0,1,36390,14807,2782,20911,0
238,5264,4293,999,3693,19,54,507,4312,9,155,88,170,164,258,1156,1898,4,9368,520,0,2,1,1,36410,14817,2784,20926,0
238,5264,1482,859,1002,125,135,219,1607,16,219,134,251,235,385,1766,3032,9,27804,1544,1,2,1,1,36420,14818,2784,20927,0
238,5264,4293,999,3693,19,54,507,4312,9,155,88,170,164,258,1156,1898,4,9368,520,0,2,1,1,36420,14820,2784,20928,1
238,5264,1482,859,1002,125,135,219,1607,16,219,134,251,235,385,1766,3032,9,27804,1544,1,2,1,1,36430,14821,2784,20929,1
177,3648,1943,715,1694,26,18,214,1969,12,185,120,237,197,357,1436,2721,7,20915,1161,0,2,2,10,36430,14823,2784,20930,1
177,3648,1168,838,957,57,25,144,1225,19,348,224,416,367,640,3018,5452,11,61921,3440,1,2,2,10,36440,14825,2784,20931,1
207,4433,182,127,129,0,0,53,182,5,39,21,42,44,63,217,343,2,926,51,0,2,2,1,36440,14825,2785,20932,1
207,4433,1165,710,800,67,119,181,1232,18,243,153,282,261,435,2000,3492,10,36473,2026,1,2,2,1,36450,14825,2786,20933,1
135,6349,1392,870,1177,35,17,170,1427,14,494,280,531,508,811,4473,7289,7,54850,3047,2,2,68,38,36450,14828,2787,20934,1
135,6409,1392,870,1177,35,17,170,1427,14,494,280,531,508,811,4473,7289,7,54850,3047,2,2,44,34,36450,14831,2788,20935,1
322,6887,72,33,56,0,4,12,72,1,1,1,1,2,2,0,2,0,1,0,0,2,11,1,36450,14831,2788,20936,1
322,6887,1454,835,1044,76,110,219,1530,17,275,158,296,292,454,2297,3718,9,34017,1889,1,2,11,1,36460,14832,2788,20937,1
147,6711,139,89,101,2,0,35,141,7,54,34,62,61,96,330,569,4,2287,127,0,2,7,0,36460,14832,2788,20938,1
147,6711,7,5,5,0,0,2,7,1,2,1,2,3,3,2,4,0,2,0,0,2,7,0,36460,14832,2788,20939,1
207,4433,182,127,129,0,0,53,182,5,39,21,42,44,63,217,343,2,926,51,0,2,2,1,36460,14832,2789,20940,0
207,4433,1165,710,800,67,119,181,1232,18,243,153,282,261,435,2000,3492,10,36473,2026,1,2,2,1,36470,14832,2790,20941,0
135,6409,1392,870,1177,35,17,170,1427,14,494,280,531,508,811,4473,7289,7,54850,3047,2,2,112,72,36470,14835,2791,20942,0
322,6887,72,33,56,0,4,12,72,1,1,1,1,2,2,0,2,0,1,0,0,2,11,1,36470,14835,2791,20943,0
322,6887,1454,835,1044,76,110,219,1530,17,275,158,296,292,454,2297,3718,9,34017,1889,1,2,11,1,36480,14836,2791,20944,0
147,6711,139,89,101,2,0,35,141,7,54,34,62,61,96,330,569,4,2287,127,0,2,7,0,36480,14836,2791,20945,0
147,6711,7,5,5,0,0,2,7,1,2,1,2,3,3,2,4,0,2,0,0,2,7,0,36480,14836,2791,20946,0
240,5292,4293,999,3693,19,54,507,4312,9,155,88,170,164,258,1156,1898,4,9368,520,0,2,12,1,36480,14838,2791,20947,1
240,5292,1482,859,1002,125,135,219,1607,16,219,134,251,235,385,1766,3032,9,27804,1544,1,2,12,1,36490,14839,2791,20948,1
321,6880,72,33,56,0,4,12,72,1,1,1,1,2,2,0,2,0,1,0,0,2,2,3,36490,14839,2791,20949,1
321,6880,1454,835,1044,76,110,219,1530,17,275,158,296,292,454,2297,3718,9,34017,1889,1,2,2,3,36500,14840,2791,20950,1
147,6722,139,89,101,2,0,35,141,7,54,34,62,61,96,330,569,4,2287,127,0,2,1,0,36500,14840,2791,20951,1
147,6722,7,5,5,0,0,2,7,1,2,1,2,3,3,2,4,0,2,0,0,2,1,0,36500,14840,2791,20952,1
240,5292,4293,999,3693,19,54,507,4312,9,155,88,170,164,258,1156,1898,4,9368,520,0,2,12,1,36500,14842,2791,20953,0
240,5292,1482,859,1002,125,135,219,1607,16,219,134,251,235,385,1766,3032,9,27804,1544,1,2,12,1,36510,14843,2791,20954,0
321,6880,72,33,56,0,4,12,72,1,1,1,1,2,2,0,2,0,1,0,0,2,2,3,36510,14843,2791,20955,0
321,6880,1454,835,1044,76,110,219,1530,17,275,158,296,292,454,2297,3718,9,34017,1889,1,2,2,3,36520,14844,2791,20956,0
147,6722,139,89,101,2,0,35,141,7,54,34,62,61,96,330,569,4,2287,127,0,2,1,0,36520,14844,2791,20957,0
147,6722,7,5,5,0,0,2,7,1,2,1,2,3,3,2,4,0,2,0,0,2,1,0,36520,14844,2791,20958,0
12,228,127,75,83,2,11,30,129,4,14,7,14,18,21,61,87,2,175,9,0,2,2,2,36520,14844,2791,20959,0
12,228,652,304,544,16,6,88,668,6,89,51,101,95,152,591,998,3,3399,188,0,2,2,2,36520,14845,2791,20960,0
12,228,2,2,2,0,0,0,2,0,0,0,0,0,0,0,0,0,0,0,0,2,2,2,36520,14845,2791,20960,0
12,228,8,5,5,0,0,3,8,0,0,0,0,0,0,0,0,0,0,0,0,2,2,2,36520,14845,2791,20961,0
12,228,2,2,2,0,0,0,2,0,0,0,0,0,0,0,0,0,0,0,0,2,2,2,36520,14845,2791,20961,0
12,228,14,8,8,0,0,6,14,0,0,0,0,0,0,0,0,0,0,0,0,2,2,2,36520,14845,2791,20962,0
12,228,6,4,4,0,0,2,6,0,0,0,0,0,0,0,0,0,0,0,0,2,2,2,36520,14845,2791,20963,0
12,228,6,4,4,0,0,2,6,1,2,1,2,3,3,2,4,0,2,0,0,2,2,2,36520,14845,2791,20964,0
12,228,6,4,4,0,0,2,6,0,0,0,0,0,0,0,0,0,0,0,0,2,2,2,36520,14845,2791,20965,0
12,228,7,5,5,0,0,2,7,0,0,0,0,0,0,0,0,0,0,0,0,2,2,2,36520,14845,2791,20966,0
12,228,6,4,4,0,0,2,6,0,0,0,0,0,0,0,0,0,0,0,0,2,2,2,36520,14845,2791,20967,0
12,228,10,6,6,0,0,4,10,0,0,0,0,0,0,0,0,0,0,0,0,2,2,2,36520,14845,2791,20968,0
12,228,1,1,1,0,0,0,1,0,0,0,0,0,0,0,0,0,0,0,0,2,2,2,36520,14845,2791,20968,0
12,228,14,10,10,0,0,4,14,1,1,1,1,2,2,0,2,0,1,0,0,2,2,2,36520,14845,2791,20969,0
12,228,46,26,30,3,0,12,49,3,6,3,6,9,9,20,28,1,42,2,0,2,2,2,36530,14845,2791,20970,0
71,3611,1943,715,1694,26,18,214,1969,12,185,120,237,197,357,1436,2721,7,20915,1161,0,2,1,1,36530,14847,2791,20971,1
12,228,127,75,83,2,11,30,129,4,14,7,14,18,21,61,87,2,175,9,0,2,2,2,36530,14847,2791,20972,0
12,228,652,304,544,16,6,88,668,6,89,51,101,95,152,591,998,3,3399,188,0,2,2,2,36530,14848,2791,20973,0
12,228,2,2,2,0,0,0,2,0,0,0,0,0,0,0,0,0,0,0,0,2,2,2,36530,14848,2791,20973,0
12,228,8,5,5,0,0,3,8,0,0,0,0,0,0,0,0,0,0,0,0,2,2,2,36530,14848,2791,20974,0
12,228,2,2,2,0,0,0,2,0,0,0,0,0,0,0,0,0,0,0,0,2,2,2,36530,14848,2791,20974,0
12,228,14,8,8,0,0,6,14,0,0,0,0,0,0,0,0,0,0,0,0,2,2,2,36530,14848,2791,20975,0
12,228,6,4,4,0,0,2,6,0,0,0,0,0,0,0,0,0,0,0,0,2,2,2,36530,14848,2791,20976,0
12,228,6,4,4,0,0,2,6,1,2,1,2,3,3,2,4,0,2,0,0,2,2,2,36530,14848,2791,20977,0
12,228,6,4,4,0,0,2,6,0,0,0,0,0,0,0,0,0,0,0,0,2,2,2,36530,14848,2791,20978,0
12,228,7,5,5,0,0,2,7,0,0,0,0,0,0,0,0,0,0,0,0,2,2,2,36530,14848,2791,20979,0
12,228,6,4,4,0,0,2,6,0,0,0,0,0,0,0,0,0,0,0,0,2,2,2,36530,14848,2791,20980,0
12,228,10,6,6,0,0,4,10,0,0,0,0,0,0,0,0,0,0,0,0,2,2,2,36530,14848,2791,20981,0
12,228,1,1,1,0,0,0,1,0,0,0,0,0,0,0,0,0,0,0,0,2,2,2,36530,14848,2791,20981,0
12,228,14,10,10,0,0,4,14,1,1,1,1,2,2,0,2,0,1,0,0,2,2,2,36530,14848,2791,20982,0
12,228,46,26,30,3,0,12,49,3,6,3,6,9,9,20,28,1,42,2,0,2,2,2,36540,14848,2791,20983,0
177,3648,1943,715,1694,26,18,214,1969,12,185,120,237,197,357,1436,2721,7,20915,1161,0,2,2,10,36540,14850,2791,20984,0
177,3648,1168,838,957,57,25,144,1225,19,348,224,416,367,640,3018,5452,11,61921,3440,1,2,2,10,36550,14852,2791,20985,0
71,3611,1943,715,1694,26,18,214,1969,12,185,120,237,197,357,1436,2721,7,20915,1161,0,2,1,1,36550,14854,2791,20986,0
240,5295,4293,999,3693,19,54,507,4312,9,155,88,170,164,258,1156,1898,4,9368,520,0,2,1,1,36550,14856,2791,20987,1
240,5295,1482,859,1002,125,135,219,1607,16,219,134,251,235,385,1766,3032,9,27804,1544,1,2,1,1,36560,14857,2791,20988,1
147,6728,139,89,101,2,0,35,141,7,54,34,62,61,96,330,569,4,2287,127,0,2,18,1,36560,14857,2791,20989,1
147,6728,7,5,5,0,0,2,7,1,2,1,2,3,3,2,4,0,2,0,0,2,18,1,36560,14857,2791,20990,1
240,5295,4293,999,3693,19,54,507,4312,9,155,88,170,164,258,1156,1898,4,9368,520,0,2,1,1,36560,14859,2791,20991,0
240,5295,1482,859,1002,125,135,219,1607,16,219,134,251,235,385,1766,3032,9,27804,1544,1,2,1,1,36570,14860,2791,20992,0
147,6728,139,89,101,2,0,35,141,7,54,34,62,61,96,330,569,4,2287,127,0,2,18,1,36570,14860,2791,20993,0
147,6728,7,5,5,0,0,2,7,1,2,1,2,3,3,2,4,0,2,0,0,2,18,1,36570,14860,2791,20994,0
32,595,2,2,2,0,0,0,2,0,0,0,0,0,0,0,0,0,0,0,0,2,5,4,36570,14860,2791,20994,1
32,595,99,48,90,1,3,5,100,0,0,0,0,0,0,0,0,0,0,0,0,2,5,4,36570,14861,2791,20995,1
32,595,8,5,5,2,0,1,10,0,0,0,0,0,0,0,0,0,0,0,0,2,5,4,36570,14861,2791,20996,1
32,595,1217,716,841,84,126,174,1301,14,185,118,215,199,333,1446,2542,8,20687,1149,0,2,5,4,36580,14863,2791,20997,1
32,595,160,89,115,0,13,31,160,7,15,11,17,22,28,78,124,3,495,27,0,2,5,4,36580,14863,2791,20998,1
32,595,10,10,9,9,0,0,19,0,0,0,0,0,0,0,0,0,0,0,0,2,5,4,36580,14863,2792,20999,1
32,595,173,84,99,8,29,36,181,5,12,7,13,17,20,54,81,2,221,12,0,2,5,4,36580,14864,2792,21000,1
32,595,3,1,1,3,0,0,6,0,0,0,0,0,0,0,0,0,0,0,0,2,5,4,36580,14864,2792,21001,1
159,5031,1660,832,1314,41,38,274,1701,20,312,209,395,332,604,2671,5058,12,64042,3557,1,2,20,18,36580,14866,2793,21003,1
159,5031,1057,646,719,113,100,145,1170,18,215,134,248,233,382,1740,3004,10,31186,1732,1,2,20,18,36590,14867,2794,21004,1
141,3738,1660,832,1314,41,38,274,1701,20,312,209,395,332,604,2671,5058,12,64042,3557,1,2,10,0,36590,14869,2795,21006,1
32,595,2,2,2,0,0,0,2,0,0,0,0,0,0,0,0,0,0,0,0,2,5,4,36590,14869,2795,21006,0
32,595,99,48,90,1,3,5,100,0,0,0,0,0,0,0,0,0,0,0,0,2,5,4,36590,14870,2795,21007,0
32,595,8,5,5,2,0,1,10,0,0,0,0,0,0,0,0,0,0,0,0,2,5,4,36590,14870,2795,21008,0
32,595,1217,716,841,84,126,174,1301,14,185,118,215,199,333,1446,2542,8,20687,1149,0,2,5,4,36600,14872,2795,21009,0
32,595,160,89,115,0,13,31,160,7,15,11,17,22,28,78,124,3,495,27,0,2,5,4,36600,14872,2795,21010,0
32,595,10,10,9,9,0,0,19,0,0,0,0,0,0,0,0,0,0,0,0,2,5,4,36600,14872,2796,21011,0
32,595,173,84,99,8,29,36,181,5,12,7,13,17,20,54,81,2,221,12,0,2,5,4,36600,14873,2796,21012,0
32,595,3,1,1,3,0,0,6,0,0,0,0,0,0,0,0,0,0,0,0,2,5,4,36600,14873,2796,21013,0
159,5031,1660,832,1314,41,38,274,1701,20,312,209,395,332,604,2671,5058,12,64042,3557,1,2,20,18,36600,14875,2797,21015,0
159,5031,1057,646,719,113,100,145,1170,18,215,134,248,233,382,1740,3004,10,31186,1732,1,2,20,18,36610,14876,2798,21016,0
141,3738,1660,832,1314,41,38,274,1701,20,312,209,395,332,604,2671,5058,12,64042,3557,1,2,10,0,36610,14878,2799,21018,0
7,298,72,33,56,0,4,12,72,1,1,1,1,2,2,0,2,0,1,0,0,2,1,1,36610,14878,2799,21019,1
7,298,72,33,56,0,4,12,72,1,1,1,1,2,2,0,2,0,1,0,0,2,1,1,36610,14878,2799,21020,0
123,2695,1043,504,840,53,9,147,1096,9,180,112,198,189,310,1377,2344,4,11604,644,0,2,14,0,36610,14880,2799,21021,1
123,2695,383,288,292,26,6,62,409,11,65,38,67,76,105,429,656,5,3719,206,0,2,14,0,36610,14881,2799,21022,1
66,2714,1043,504,840,53,9,147,1096,9,180,112,198,189,310,1377,2344,4,11604,644,0,2,26,0,36610,14883,2799,21023,1
70,2065,1523,757,1297,19,12,193,1542,12,193,117,230,205,347,1508,2664,7,19053,1058,0,2,3,6,36620,14885,2799,21024,1
70,2065,701,378,504,33,58,109,734,13,110,68,126,123,194,794,1346,7,10027,557,0,2,3,6,36620,14886,2800,21025,1
127,2753,1043,504,840,53,9,147,1096,9,180,112,198,189,310,1377,2344,4,11604,644,0,2,16,0,36620,14888,2800,21026,1
127,2753,383,288,292,26,6,62,409,11,65,38,67,76,105,429,656,5,3719,206,0,2,16,0,36620,14889,2800,21027,1
68,2807,1043,504,840,53,9,147,1096,9,180,112,198,189,310,1377,2344,4,11604,644,0,2,44,5,36620,14891,2800,21028,1
127,2753,1043,504,840,53,9,147,1096,9,180,112,198,189,310,1377,2344,4,11604,644,0,2,4,2,36620,14893,2800,21029,0
127,2753,383,288,292,26,6,62,409,11,65,38,67,76,105,429,656,5,3719,206,0,2,4,2,36620,14894,2800,21030,0
321,6894,72,33,56,0,4,12,72,1,1,1,1,2,2,0,2,0,1,0,0,2,11,3,36620,14894,2800,21031,1
321,6894,1454,835,1044,76,110,219,1530,17,275,158,296,292,454,2297,3718,9,34017,1889,1,2,11,3,36630,14895,2800,21032,1
90,4091,1338,495,1086,10,64,173,1348,11,122,82,157,133,239,883,1686,7,11934,663,0,2,9,0,36630,14897,2800,21033,1
102,1935,1178,367,1042,6,15,115,1184,9,94,51,95,103,146,644,976,4,4439,246,0,2,9,3,36630,14897,2800,21034,0
102,1935,177,108,140,8,0,27,185,6,30,16,32,36,48,162,248,3,794,44,0,2,9,3,36630,14899,2800,21035,0
310,6308,1457,730,1242,11,6,188,1468,10,292,166,329,302,495,2424,4078,5,22973,1276,1,2,19,4,36630,14901,2800,21036,1
310,6308,74,35,59,1,0,14,75,3,14,7,14,17,21,58,85,1,128,7,0,2,19,4,36630,14902,2800,21037,1
310,6308,245,125,200,5,7,34,250,7,30,17,34,37,51,166,265,3,1053,58,0,2,19,4,36640,14903,2800,21038,1
54,3013,1296,573,1062,40,33,157,1336,8,201,118,231,209,349,1561,2689,4,12365,686,0,2,4,2,36640,14903,2800,21039,1
65,3295,1457,730,1242,11,6,188,1468,10,292,166,329,302,495,2424,4078,5,22973,1276,1,2,39,3,36640,14905,2800,21040,1
310,6308,1457,730,1242,11,6,188,1468,10,292,166,329,302,495,2424,4078,5,22973,1276,1,2,19,4,36640,14907,2800,21041,0
310,6308,74,35,59,1,0,14,75,3,14,7,14,17,21,58,85,1,128,7,0,2,19,4,36640,14908,2800,21042,0
310,6308,245,125,200,5,7,34,250,7,30,17,34,37,51,166,265,3,1053,58,0,2,19,4,36650,14909,2800,21043,0
54,3013,1296,573,1062,40,33,157,1336,8,201,118,231,209,349,1561,2689,4,12365,686,0,2,4,2,36650,14909,2800,21044,0
65,3295,1457,730,1242,11,6,188,1468,10,292,166,329,302,495,2424,4078,5,22973,1276,1,2,39,3,36650,14911,2800,21045,0
330,6735,1457,730,1242,11,6,188,1468,10,292,166,329,302,495,2424,4078,5,22973,1276,1,2,19,4,36650,14913,2800,21046,1
330,6735,74,35,59,1,0,14,75,3,14,7,14,17,21,58,85,1,128,7,0,2,19,4,36650,14914,2800,21047,1
330,6735,245,125,200,5,7,34,250,7,30,17,34,37,51,166,265,3,1053,58,0,2,19,4,36660,14915,2800,21048,1
2,26,6,4,4,0,0,2,6,1,4,2,4,5,6,8,13,0,6,0,0,3,5,5,36660,14915,2800,21051,1
59,3286,1296,573,1062,40,33,157,1336,8,201,118,231,209,349,1561,2689,4,12365,686,0,2,4,2,36660,14915,2800,21053,1
72,3606,1457,730,1242,11,6,188,1468,10,292,166,329,302,495,2424,4078,5,22973,1276,1,2,43,4,36660,14917,2800,21054,1
330,6735,1457,730,1242,11,6,188,1468,10,292,166,329,302,495,2424,4078,5,22973,1276,1,2,19,4,36660,14919,2800,21055,0
330,6735,74,35,59,1,0,14,75,3,14,7,14,17,21,58,85,1,128,7,0,2,19,4,36660,14920,2800,21056,0
330,6735,245,125,200,5,7,34,250,7,30,17,34,37,51,166,265,3,1053,58,0,2,19,4,36670,14921,2800,21057,0
2,26,6,4,4,0,0,2,6,1,4,2,4,5,6,8,13,0,6,0,0,3,5,5,36670,14921,2800,21060,0
59,3286,1296,573,1062,40,33,157,1336,8,201,118,231,209,349,1561,2689,4,12365,686,0,2,4,2,36670,14921,2800,21062,0
72,3606,1457,730,1242,11,6,188,1468,10,292,166,329,302,495,2424,4078,5,22973,1276,1,2,43,4,36670,14923,2800,21063,0
70,2065,1523,757,1297,19,12,193,1542,12,193,117,230,205,347,1508,2664,7,19053,1058,0,2,3,6,36680,14925,2800,21064,0
70,2065,701,378,504,33,58,109,734,13,110,68,126,123,194,794,1346,7,10027,557,0,2,3,6,36680,14926,2801,21065,0
321,6894,72,33,56,0,4,12,72,1,1,1,1,2,2,0,2,0,1,0,0,2,11,3,36680,14926,2801,21066,0
321,6894,1454,835,1044,76,110,219,1530,17,275,158,296,292,454,2297,3718,9,34017,1889,1,2,11,3,36690,14927,2801,21067,0
127,2753,1043,504,840,53,9,147,1096,9,180,112,198,189,310,1377,2344,4,11604,644,0,2,34,2,36690,14929,2801,21068,0
127,2753,383,288,292,26,6,62,409,11,65,38,67,76,105,429,656,5,3719,206,0,2,34,2,36690,14930,2801,21069,0
90,4091,1338,495,1086,10,64,173,1348,11,122,82,157,133,239,883,1686,7,11934,663,0,2,9,0,36690,14932,2801,21070,0
68,2807,1043,504,840,53,9,147,1096,9,180,112,198,189,310,1377,2344,4,11604,644,0,2,65,0,36690,14934,2801,21071,0
67,2000,1523,757,1297,19,12,193,1542,12,193,117,230,205,347,1508,2664,7,19053,1058,0,2,1,1,36700,14936,2801,21072,1
67,2000,701,378,504,33,58,109,734,13,110,68,126,123,194,794,1346,7,10027,557,0,2,1,1,36700,14937,2802,21073,1
74,3538,1523,757,1297,19,12,193,1542,12,193,117,230,205,347,1508,2664,7,19053,1058,0,2,24,3,36710,14939,2802,21074,1
67,2000,1523,757,1297,19,12,193,1542,12,193,117,230,205,347,1508,2664,7,19053,1058,0,2,1,1,36720,14941,2802,21075,0
67,2000,701,378,504,33,58,109,734,13,110,68,126,123,194,794,1346,7,10027,557,0,2,1,1,36720,14942,2803,21076,0
74,3538,1523,757,1297,19,12,193,1542,12,193,117,230,205,347,1508,2664,7,19053,1058,0,2,24,3,36730,14944,2803,21077,0
39,1562,1098,241,925,5,10,155,1103,7,46,25,49,53,74,273,423,3,1580,87,0,2,22,8,36740,14946,2803,21078,1
103,1947,1178,367,1042,6,15,115,1184,9,94,51,95,103,146,644,976,4,4439,246,0,2,7,4,36740,14946,2803,21079,0
103,1947,177,108,140,8,0,27,185,6,30,16,32,36,48,162,248,3,794,44,0,2,7,4,36740,14948,2803,21080,0
39,1564,1098,241,925,5,10,155,1103,7,46,25,49,53,74,273,423,3,1580,87,0,2,1,0,36750,14950,2803,21081,0
103,1960,1178,367,1042,6,15,115,1184,9,94,51,95,103,146,644,976,4,4439,246,0,2,3,1,36750,14950,2803,21082,0
103,1960,177,108,140,8,0,27,185,6,30,16,32,36,48,162,248,3,794,44,0,2,3,1,36750,14952,2803,21083,0
49,573,647,139,84,35,284,233,682,0,0,0,0,0,0,0,0,0,0,0,0,2,1,1,36750,14952,2803,21084,0
177,3652,1943,715,1694,26,18,214,1969,12,185,120,237,197,357,1436,2721,7,20915,1161,0,2,2,1,36750,14954,2803,21085,0
177,3652,1168,838,957,57,25,144,1225,19,348,224,416,367,640,3018,5452,11,61921,3440,1,2,2,1,36760,14956,2803,21086,0
71,3611,1943,715,1694,26,18,214,1969,12,185,120,237,197,357,1436,2721,7,20915,1161,0,2,3,1,36760,14958,2803,21087,0
175,4048,77,34,69,0,0,8,77,3,24,16,29,27,45,114,213,1,387,21,0,2,1,1,36760,14958,2803,21088,1
175,4048,712,438,573,51,9,84,763,14,102,71,128,116,199,733,1364,8,11988,666,0,2,1,1,36770,14959,2803,21089,1
65,3297,1457,730,1242,11,6,188,1468,10,292,166,329,302,495,2424,4078,5,22973,1276,1,2,3,2,36770,14961,2803,21090,1
524,11280,72,33,56,0,4,12,72,1,1,1,1,2,2,0,2,0,1,0,0,2,10,8,36770,14961,2803,21091,0
524,11280,1454,835,1044,76,110,219,1530,17,275,158,296,292,454,2297,3718,9,34017,1889,1,2,10,8,36780,14962,2803,21092,0
148,6631,139,89,101,2,0,35,141,7,54,34,62,61,96,330,569,4,2287,127,0,2,5,4,36780,14962,2803,21093,0
148,6631,7,5,5,0,0,2,7,1,2,1,2,3,3,2,4,0,2,0,0,2,5,4,36780,14962,2803,21094,0
49,573,647,139,84,35,284,233,682,0,0,0,0,0,0,0,0,0,0,0,0,2,1,1,36780,14962,2803,21095,0
177,3652,1943,715,1694,26,18,214,1969,12,185,120,237,197,357,1436,2721,7,20915,1161,0,2,2,1,36780,14964,2803,21096,0
177,3652,1168,838,957,57,25,144,1225,19,348,224,416,367,640,3018,5452,11,61921,3440,1,2,2,1,36790,14966,2803,21097,0
71,3611,1943,715,1694,26,18,214,1969,12,185,120,237,197,357,1436,2721,7,20915,1161,0,2,3,1,36790,14968,2803,21098,0
524,11280,72,33,56,0,4,12,72,1,1,1,1,2,2,0,2,0,1,0,0,2,10,8,36790,14968,2803,21099,0
524,11280,1454,835,1044,76,110,219,1530,17,275,158,296,292,454,2297,3718,9,34017,1889,1,2,10,8,36800,14969,2803,21100,0
148,6631,139,89,101,2,0,35,141,7,54,34,62,61,96,330,569,4,2287,127,0,2,5,4,36800,14969,2803,21101,0
148,6631,7,5,5,0,0,2,7,1,2,1,2,3,3,2,4,0,2,0,0,2,5,4,36800,14969,2803,21102,0
175,4048,77,34,69,0,0,8,77,3,24,16,29,27,45,114,213,1,387,21,0,2,1,1,36800,14969,2803,21103,0
175,4048,712,438,573,51,9,84,763,14,102,71,128,116,199,733,1364,8,11988,666,0,2,1,1,36810,14970,2803,21104,0
65,3297,1457,730,1242,11,6,188,1468,10,292,166,329,302,495,2424,4078,5,22973,1276,1,2,3,2,36810,14972,2803,21105,0
73,3480,1523,757,1297,19,12,193,1542,12,193,117,230,205,347,1508,2664,7,19053,1058,0,2,1,1,36820,14974,2803,21106,0
30,649,215,129,180,6,0,29,221,8,65,43,72,73,115,415,711,4,3153,175,0,2,4,1,36820,14974,2803,21108,1
30,649,97,69,77,3,3,16,100,6,22,13,23,28,36,113,173,3,542,30,0,2,4,1,36820,14975,2803,21109,1
6,219,75,38,59,1,3,12,76,2,4,2,4,6,6,10,15,1,15,0,0,2,12,0,36820,14975,2803,21110,1
30,649,215,129,180,6,0,29,221,8,65,43,72,73,115,415,711,4,3153,175,0,2,4,1,36820,14975,2803,21112,0
30,649,97,69,77,3,3,16,100,6,22,13,23,28,36,113,173,3,542,30,0,2,4,1,36820,14976,2803,21113,0
6,219,75,38,59,1,3,12,76,2,4,2,4,6,6,10,15,1,15,0,0,2,12,0,36820,14976,2803,21114,0
225,5008,4293,999,3693,19,54,507,4312,9,155,88,170,164,258,1156,1898,4,9368,520,0,2,26,83,36820,14978,2803,21115,1
225,5008,1482,859,1002,125,135,219,1607,16,219,134,251,235,385,1766,3032,9,27804,1544,1,2,26,83,36830,14979,2803,21116,1
46,949,447,308,343,6,5,95,453,7,96,59,111,103,170,651,1136,4,4600,255,0,2,1,3,36830,14982,2803,21117,1
46,949,322,174,179,16,74,51,338,10,41,26,46,51,72,252,408,5,2291,127,0,2,1,3,36830,14985,2804,21118,1
321,6872,72,33,56,0,4,12,72,1,1,1,1,2,2,0,2,0,1,0,0,2,3,7,36830,14985,2804,21119,1
321,6872,1454,835,1044,76,110,219,1530,17,275,158,296,292,454,2297,3718,9,34017,1889,1,2,3,7,36840,14986,2804,21120,1
146,6681,139,89,101,2,0,35,141,7,54,34,62,61,96,330,569,4,2287,127,0,2,1,9,36840,14986,2804,21121,1
146,6681,7,5,5,0,0,2,7,1,2,1,2,3,3,2,4,0,2,0,0,2,1,9,36840,14986,2804,21122,1
38,1616,447,308,343,6,5,95,453,7,96,59,111,103,170,651,1136,4,4600,255,0,2,0,30,36840,14989,2804,21123,1
334,6788,1457,730,1242,11,6,188,1468,10,292,166,329,302,495,2424,4078,5,22973,1276,1,2,20,7,36840,14991,2804,21124,1
334,6788,74,35,59,1,0,14,75,3,14,7,14,17,21,58,85,1,128,7,0,2,20,7,36840,14992,2804,21125,1
334,6788,245,125,200,5,7,34,250,7,30,17,34,37,51,166,265,3,1053,58,0,2,20,7,36850,14993,2804,21126,1
24,834,74,35,59,1,0,14,75,3,14,7,14,17,21,58,85,1,128,7,0,2,0,1,36850,14994,2804,21128,1
24,834,245,125,200,5,7,34,250,7,30,17,34,37,51,166,265,3,1053,58,0,2,0,1,36860,14995,2804,21129,1
6,195,75,38,59,1,3,12,76,2,4,2,4,6,6,10,15,1,15,0,0,2,9,0,36860,14995,2804,21130,1
72,3655,1457,730,1242,11,6,188,1468,10,292,166,329,302,495,2424,4078,5,22973,1276,1,2,20,16,36860,14997,2804,21131,1
225,5008,4293,999,3693,19,54,507,4312,9,155,88,170,164,258,1156,1898,4,9368,520,0,2,26,83,36860,14999,2804,21132,0
225,5008,1482,859,1002,125,135,219,1607,16,219,134,251,235,385,1766,3032,9,27804,1544,1,2,26,83,36870,15000,2804,21133,0
46,949,447,308,343,6,5,95,453,7,96,59,111,103,170,651,1136,4,4600,255,0,2,1,3,36870,15003,2804,21134,0
46,949,322,174,179,16,74,51,338,10,41,26,46,51,72,252,408,5,2291,127,0,2,1,3,36870,15006,2805,21135,0
321,6886,72,33,56,0,4,12,72,1,1,1,1,2,2,0,2,0,1,0,0,2,3,7,36870,15006,2805,21136,0
321,6886,1454,835,1044,76,110,219,1530,17,275,158,296,292,454,2297,3718,9,34017,1889,1,2,3,7,36880,15007,2805,21137,0
146,6681,139,89,101,2,0,35,141,7,54,34,62,61,96,330,569,4,2287,127,0,2,1,9,36880,15007,2805,21138,0
146,6681,7,5,5,0,0,2,7,1,2,1,2,3,3,2,4,0,2,0,0,2,1,9,36880,15007,2805,21139,0
38,1616,447,308,343,6,5,95,453,7,96,59,111,103,170,651,1136,4,4600,255,0,2,0,30,36880,15010,2805,21140,0
334,6788,1457,730,1242,11,6,188,1468,10,292,166,329,302,495,2424,4078,5,22973,1276,1,2,20,7,36880,15012,2805,21141,0
334,6788,74,35,59,1,0,14,75,3,14,7,14,17,21,58,85,1,128,7,0,2,20,7,36880,15013,2805,21142,0
334,6788,245,125,200,5,7,34,250,7,30,17,34,37,51,166,265,3,1053,58,0,2,20,7,36890,15014,2805,21143,0
24,834,74,35,59,1,0,14,75,3,14,7,14,17,21,58,85,1,128,7,0,2,0,1,36890,15015,2805,21145,0
24,834,245,125,200,5,7,34,250,7,30,17,34,37,51,166,265,3,1053,58,0,2,0,1,36900,15016,2805,21146,0
7,252,75,38,59,1,3,12,76,2,4,2,4,6,6,10,15,1,15,0,0,2,9,0,36900,15016,2805,21147,0
72,3655,1457,730,1242,11,6,188,1468,10,292,166,329,302,495,2424,4078,5,22973,1276,1,2,20,16,36900,15018,2805,21148,0
74,3550,1523,757,1297,19,12,193,1542,12,193,117,230,205,347,1508,2664,7,19053,1058,0,2,21,4,36910,15020,2805,21149,0
67,2902,1178,367,1042,6,15,115,1184,9,94,51,95,103,146,644,976,4,4439,246,0,2,16,2,36910,15020,2805,21150,0
310,6308,1457,730,1242,11,6,188,1468,10,292,166,329,302,495,2424,4078,5,22973,1276,1,2,19,4,36910,15022,2805,21151,0
310,6308,74,35,59,1,0,14,75,3,14,7,14,17,21,58,85,1,128,7,0,2,19,4,36910,15023,2805,21152,0
310,6308,245,125,200,5,7,34,250,7,30,17,34,37,51,166,265,3,1053,58,0,2,19,4,36920,15024,2805,21153,0
67,2000,1523,757,1297,19,12,193,1542,12,193,117,230,205,347,1508,2664,7,19053,1058,0,2,1,1,36930,15026,2805,21154,0
67,2000,701,378,504,33,58,109,734,13,110,68,126,123,194,794,1346,7,10027,557,0,2,1,1,36930,15027,2806,21155,0
175,4048,77,34,69,0,0,8,77,3,24,16,29,27,45,114,213,1,387,21,0,2,1,1,36930,15027,2806,21156,0
175,4048,712,438,573,51,9,84,763,14,102,71,128,116,199,733,1364,8,11988,666,0,2,1,1,36940,15028,2806,21157,0
524,11280,72,33,56,0,4,12,72,1,1,1,1,2,2,0,2,0,1,0,0,2,10,8,36940,15028,2806,21158,0
524,11280,1454,835,1044,76,110,219,1530,17,275,158,296,292,454,2297,3718,9,34017,1889,1,2,10,8,36950,15029,2806,21159,0
148,6631,139,89,101,2,0,35,141,7,54,34,62,61,96,330,569,4,2287,127,0,2,5,4,36950,15029,2806,21160,0
148,6631,7,5,5,0,0,2,7,1,2,1,2,3,3,2,4,0,2,0,0,2,5,4,36950,15029,2806,21161,0
54,3013,1296,573,1062,40,33,157,1336,8,201,118,231,209,349,1561,2689,4,12365,686,0,2,4,2,36950,15029,2806,21162,0
65,3297,1457,730,1242,11,6,188,1468,10,292,166,329,302,495,2424,4078,5,22973,1276,1,2,42,5,36950,15031,2806,21163,0
75,3608,1523,757,1297,19,12,193,1542,12,193,117,230,205,347,1508,2664,7,19053,1058,0,2,24,3,36960,15033,2806,21164,0
67,2902,1178,367,1042,6,15,115,1184,9,94,51,95,103,146,644,976,4,4439,246,0,2,2,2,36960,15033,2806,21165,0
75,3608,1523,757,1297,19,12,193,1542,12,193,117,230,205,347,1508,2664,7,19053,1058,0,2,5,2,36970,15035,2806,21166,0
85,4578,1782,648,1425,9,47,279,1791,8,171,97,189,179,286,1292,2140,4,9462,525,0,2,6,5,36970,15036,2807,21167,0
85,4578,1782,648,1425,9,47,279,1791,8,171,97,189,179,286,1292,2140,4,9462,525,0,2,1,1,36970,15037,2808,21168,0
105,1995,1178,367,1042,6,15,115,1184,9,94,51,95,103,146,644,976,4,4439,246,0,2,17,3,36970,15037,2808,21169,0
105,1995,177,108,140,8,0,27,185,6,30,16,32,36,48,162,248,3,794,44,0,2,17,3,36970,15039,2808,21170,0
45,1696,1098,241,925,5,10,155,1103,7,46,25,49,53,74,273,423,3,1580,87,0,2,44,19,36980,15041,2808,21171,0
65,3307,1457,730,1242,11,6,188,1468,10,292,166,329,302,495,2424,4078,5,22973,1276,1,2,2,0,36980,15043,2808,21172,0
105,1995,1178,367,1042,6,15,115,1184,9,94,51,95,103,146,644,976,4,4439,246,0,2,31,6,36980,15043,2808,21173,0
105,1995,177,108,140,8,0,27,185,6,30,16,32,36,48,162,248,3,794,44,0,2,31,6,36980,15045,2808,21174,0
85,4578,1782,648,1425,9,47,279,1791,8,171,97,189,179,286,1292,2140,4,9462,525,0,2,6,5,36980,15046,2809,21175,0
65,3307,1457,730,1242,11,6,188,1468,10,292,166,329,302,495,2424,4078,5,22973,1276,1,2,2,0,36980,15048,2809,21176,0
75,3608,1523,757,1297,19,12,193,1542,12,193,117,230,205,347,1508,2664,7,19053,1058,0,2,27,7,36990,15050,2809,21177,0
67,2902,1178,367,1042,6,15,115,1184,9,94,51,95,103,146,644,976,4,4439,246,0,2,16,2,36990,15050,2809,21178,0
45,1696,1098,241,925,5,10,155,1103,7,46,25,49,53,74,273,423,3,1580,87,0,2,54,14,37000,15052,2809,21179,0
225,5040,4293,999,3693,19,54,507,4312,9,155,88,170,164,258,1156,1898,4,9368,520,0,2,11,7,37000,15054,2809,21180,1
225,5040,1482,859,1002,125,135,219,1607,16,219,134,251,235,385,1766,3032,9,27804,1544,1,2,11,7,37010,15055,2809,21181,1
70,2072,1523,757,1297,19,12,193,1542,12,193,117,230,205,347,1508,2664,7,19053,1058,0,2,1,1,37020,15057,2809,21182,1
70,2072,701,378,504,33,58,109,734,13,110,68,126,123,194,794,1346,7,10027,557,0,2,1,1,37020,15058,2810,21183,1
179,4150,77,34,69,0,0,8,77,3,24,16,29,27,45,114,213,1,387,21,0,2,1,1,37020,15058,2810,21184,1
179,4150,712,438,573,51,9,84,763,14,102,71,128,116,199,733,1364,8,11988,666,0,2,1,1,37030,15059,2810,21185,1
321,6886,72,33,56,0,4,12,72,1,1,1,1,2,2,0,2,0,1,0,0,2,0,1,37030,15059,2810,21186,1
321,6886,1454,835,1044,76,110,219,1530,17,275,158,296,292,454,2297,3718,9,34017,1889,1,2,0,1,37040,15060,2810,21187,1
104,1979,1178,367,1042,6,15,115,1184,9,94,51,95,103,146,644,976,4,4439,246,0,2,31,6,37040,15060,2810,21188,1
104,1979,177,108,140,8,0,27,185,6,30,16,32,36,48,162,248,3,794,44,0,2,31,6,37040,15062,2810,21189,1
146,6683,139,89,101,2,0,35,141,7,54,34,62,61,96,330,569,4,2287,127,0,2,5,5,37040,15062,2810,21190,1
146,6683,7,5,5,0,0,2,7,1,2,1,2,3,3,2,4,0,2,0,0,2,5,5,37040,15062,2810,21191,1
94,4971,1782,648,1425,9,47,279,1791,8,171,97,189,179,286,1292,2140,4,9462,525,0,2,6,5,37040,15063,2811,21192,1
72,3657,1457,730,1242,11,6,188,1468,10,292,166,329,302,495,2424,4078,5,22973,1276,1,2,4,2,37040,15065,2811,21193,1
78,3868,1523,757,1297,19,12,193,1542,12,193,117,230,205,347,1508,2664,7,19053,1058,0,2,49,8,37050,15067,2811,21194,1
68,2926,1178,367,1042,6,15,115,1184,9,94,51,95,103,146,644,976,4,4439,246,0,2,16,2,37050,15067,2811,21195,1
46,1725,1098,241,925,5,10,155,1103,7,46,25,49,53,74,273,423,3,1580,87,0,2,54,14,37060,15069,2811,21196,1
41,791,207,111,150,11,0,50,218,5,26,19,36,31,55,133,272,3,943,52,0,2,15,0,37060,15069,2811,21197,1
41,791,410,198,237,31,55,97,441,11,63,38,72,74,110,414,683,6,4293,238,0,2,15,0,37070,15070,2812,21198,1
103,1969,1178,367,1042,6,15,115,1184,9,94,51,95,103,146,644,976,4,4439,246,0,2,1,12,37070,15070,2812,21199,1
103,1969,177,108,140,8,0,27,185,6,30,16,32,36,48,162,248,3,794,44,0,2,1,12,37070,15072,2812,21200,1
46,1725,1098,241,925,5,10,155,1103,7,46,25,49,53,74,273,423,3,1580,87,0,2,2,2,37080,15074,2812,21201,1
41,791,207,111,150,11,0,50,218,5,26,19,36,31,55,133,272,3,943,52,0,2,0,2,37080,15074,2812,21202,0
41,791,410,198,237,31,55,97,441,11,63,38,72,74,110,414,683,6,4293,238,0,2,0,2,37090,15075,2813,21203,0
41,791,207,111,150,11,0,50,218,5,26,19,36,31,55,133,272,3,943,52,0,2,13,0,37090,15075,2813,21204,0
41,791,410,198,237,31,55,97,441,11,63,38,72,74,110,414,683,6,4293,238,0,2,13,0,37100,15076,2814,21205,0
225,5040,4293,999,3693,19,54,507,4312,9,155,88,170,164,258,1156,1898,4,9368,520,0,2,11,7,37100,15078,2814,21206,0
225,5040,1482,859,1002,125,135,219,1607,16,219,134,251,235,385,1766,3032,9,27804,1544,1,2,11,7,37110,15079,2814,21207,0
70,2072,1523,757,1297,19,12,193,1542,12,193,117,230,205,347,1508,2664,7,19053,1058,0,2,1,1,37120,15081,2814,21208,0
70,2072,701,378,504,33,58,109,734,13,110,68,126,123,194,794,1346,7,10027,557,0,2,1,1,37120,15082,2815,21209,0
179,4150,77,34,69,0,0,8,77,3,24,16,29,27,45,114,213,1,387,21,0,2,1,1,37120,15082,2815,21210,0
179,4150,712,438,573,51,9,84,763,14,102,71,128,116,199,733,1364,8,11988,666,0,2,1,1,37130,15083,2815,21211,0
321,6886,72,33,56,0,4,12,72,1,1,1,1,2,2,0,2,0,1,0,0,2,0,1,37130,15083,2815,21212,0
321,6886,1454,835,1044,76,110,219,1530,17,275,158,296,292,454,2297,3718,9,34017,1889,1,2,0,1,37140,15084,2815,21213,0
103,1969,1178,367,1042,6,15,115,1184,9,94,51,95,103,146,644,976,4,4439,246,0,2,20,6,37140,15084,2815,21214,0
103,1969,177,108,140,8,0,27,185,6,30,16,32,36,48,162,248,3,794,44,0,2,20,6,37140,15086,2815,21215,0
146,6683,139,89,101,2,0,35,141,7,54,34,62,61,96,330,569,4,2287,127,0,2,5,5,37140,15086,2815,21216,0
146,6683,7,5,5,0,0,2,7,1,2,1,2,3,3,2,4,0,2,0,0,2,5,5,37140,15086,2815,21217,0
94,4971,1782,648,1425,9,47,279,1791,8,171,97,189,179,286,1292,2140,4,9462,525,0,2,6,5,37140,15087,2816,21218,0
72,3657,1457,730,1242,11,6,188,1468,10,292,166,329,302,495,2424,4078,5,22973,1276,1,2,4,2,37140,15089,2816,21219,0
78,3868,1523,757,1297,19,12,193,1542,12,193,117,230,205,347,1508,2664,7,19053,1058,0,2,49,8,37150,15091,2816,21220,0
68,2926,1178,367,1042,6,15,115,1184,9,94,51,95,103,146,644,976,4,4439,246,0,2,16,2,37150,15091,2816,21221,0
46,1725,1098,241,925,5,10,155,1103,7,46,25,49,53,74,273,423,3,1580,87,0,2,54,14,37160,15093,2816,21222,0
322,6894,72,33,56,0,4,12,72,1,1,1,1,2,2,0,2,0,1,0,0,2,3,1,37200,15109,2820,21251,1
322,6894,1454,835,1044,76,110,219,1530,17,275,158,296,292,454,2297,3718,9,34017,1889,1,2,3,1,37210,15110,2820,21252,1
128,2805,1043,504,840,53,9,147,1096,9,180,112,198,189,310,1377,2344,4,11604,644,0,2,12,5,37210,15112,2820,21253,1
128,2805,383,288,292,26,6,62,409,11,65,38,67,76,105,429,656,5,3719,206,0,2,12,5,37210,15113,2820,21254,1
69,2837,1043,504,840,53,9,147,1096,9,180,112,198,189,310,1377,2344,4,11604,644,0,2,13,0,37210,15115,2820,21255,1
322,6894,72,33,56,0,4,12,72,1,1,1,1,2,2,0,2,0,1,0,0,2,3,1,37210,15115,2820,21256,0
322,6894,1454,835,1044,76,110,219,1530,17,275,158,296,292,454,2297,3718,9,34017,1889,1,2,3,1,37220,15116,2820,21257,0
128,2805,1043,504,840,53,9,147,1096,9,180,112,198,189,310,1377,2344,4,11604,644,0,2,12,5,37220,15118,2820,21258,0
128,2805,383,288,292,26,6,62,409,11,65,38,67,76,105,429,656,5,3719,206,0,2,12,5,37220,15119,2820,21259,0
69,2837,1043,504,840,53,9,147,1096,9,180,112,198,189,310,1377,2344,4,11604,644,0,2,13,0,37220,15121,2820,21260,0
321,6886,72,33,56,0,4,12,72,1,1,1,1,2,2,0,2,0,1,0,0,2,2,2,37220,15121,2820,21261,0
321,6886,1454,835,1044,76,110,219,1530,17,275,158,296,292,454,2297,3718,9,34017,1889,1,2,2,2,37230,15122,2820,21262,0
68,2926,1178,367,1042,6,15,115,1184,9,94,51,95,103,146,644,976,4,4439,246,0,2,1,1,37230,15122,2820,21263,0
128,2805,1043,504,840,53,9,147,1096,9,180,112,198,189,310,1377,2344,4,11604,644,0,2,1,1,37230,15124,2820,21264,1
128,2805,383,288,292,26,6,62,409,11,65,38,67,76,105,429,656,5,3719,206,0,2,1,1,37230,15125,2820,21265,1
128,2805,1043,504,840,53,9,147,1096,9,180,112,198,189,310,1377,2344,4,11604,644,0,2,1,1,37230,15127,2820,21266,0
128,2805,383,288,292,26,6,62,409,11,65,38,67,76,105,429,656,5,3719,206,0,2,1,1,37230,15128,2820,21267,0
322,6894,72,33,56,0,4,12,72,1,1,1,1,2,2,0,2,0,1,0,0,2,2,2,37230,15128,2820,21268,0
322,6894,1454,835,1044,76,110,219,1530,17,275,158,296,292,454,2297,3718,9,34017,1889,1,2,2,2,37240,15129,2820,21269,0
68,2926,1178,367,1042,6,15,115,1184,9,94,51,95,103,146,644,976,4,4439,246,0,2,1,1,37240,15129,2820,21270,0
70,1304,1020,354,843,12,15,144,1032,8,134,77,144,142,221,970,1580,4,6792,377,0,2,15,0,37240,15129,2820,21271,1
321,6850,72,33,56,0,4,12,72,1,1,1,1,2,2,0,2,0,1,0,0,2,13,18,37240,15129,2820,21272,1
321,6850,1454,835,1044,76,110,219,1530,17,275,158,296,292,454,2297,3718,9,34017,1889,1,2,13,18,37250,15130,2820,21273,1
179,4151,77,34,69,0,0,8,77,3,24,16,29,27,45,114,213,1,387,21,0,2,1,1,37250,15130,2820,21274,1
179,4151,712,438,573,51,9,84,763,14,102,71,128,116,199,733,1364,8,11988,666,0,2,1,1,37260,15131,2820,21275,1
70,1304,1020,354,843,12,15,144,1032,8,134,77,144,142,221,970,1580,4,6792,377,0,2,15,0,37260,15131,2820,21276,0
321,6850,72,33,56,0,4,12,72,1,1,1,1,2,2,0,2,0,1,0,0,2,13,18,37260,15131,2820,21277,0
321,6850,1454,835,1044,76,110,219,1530,17,275,158,296,292,454,2297,3718,9,34017,1889,1,2,13,18,37270,15132,2820,21278,0
78,3291,1289,550,1043,56,32,155,1345,10,167,93,185,177,278,1266,2075,5,11498,638,0,2,18,0,37270,15134,2821,21279,0
179,4151,77,34,69,0,0,8,77,3,24,16,29,27,45,114,213,1,387,21,0,2,1,1,37270,15134,2821,21280,0
179,4151,712,438,573,51,9,84,763,14,102,71,128,116,199,733,1364,8,11988,666,0,2,1,1,37280,15135,2821,21281,0
78,3291,1289,550,1043,56,32,155,1345,10,167,93,185,177,278,1266,2075,5,11498,638,0,2,18,0,37280,15137,2822,21282,0
326,6911,72,33,56,0,4,12,72,1,1,1,1,2,2,0,2,0,1,0,0,2,26,8,37280,15137,2822,21283,1
326,6911,1454,835,1044,76,110,219,1530,17,275,158,296,292,454,2297,3718,9,34017,1889,1,2,26,8,37290,15138,2822,21284,1
98,5099,1782,648,1425,9,47,279,1791,8,171,97,189,179,286,1292,2140,4,9462,525,0,2,119,37,37290,15139,2823,21285,1
334,6788,1457,730,1242,11,6,188,1468,10,292,166,329,302,495,2424,4078,5,22973,1276,1,2,1,1,37290,15141,2823,21286,0
334,6788,74,35,59,1,0,14,75,3,14,7,14,17,21,58,85,1,128,7,0,2,1,1,37290,15142,2823,21287,0
334,6788,245,125,200,5,7,34,250,7,30,17,34,37,51,166,265,3,1053,58,0,2,1,1,37300,15143,2823,21288,0
326,6911,72,33,56,0,4,12,72,1,1,1,1,2,2,0,2,0,1,0,0,2,26,8,37300,15143,2823,21289,0
326,6911,1454,835,1044,76,110,219,1530,17,275,158,296,292,454,2297,3718,9,34017,1889,1,2,26,8,37310,15144,2823,21290,0
98,5099,1782,648,1425,9,47,279,1791,8,171,97,189,179,286,1292,2140,4,9462,525,0,2,119,37,37310,15145,2824,21291,0
327,6920,72,33,56,0,4,12,72,1,1,1,1,2,2,0,2,0,1,0,0,2,1,1,37310,15145,2824,21292,0
327,6920,1454,835,1044,76,110,219,1530,17,275,158,296,292,454,2297,3718,9,34017,1889,1,2,1,1,37320,15146,2824,21293,0
100,5163,1782,648,1425,9,47,279,1791,8,171,97,189,179,286,1292,2140,4,9462,525,0,2,27,0,37320,15147,2825,21294,0
327,6920,72,33,56,0,4,12,72,1,1,1,1,2,2,0,2,0,1,0,0,2,1,1,37320,15147,2825,21295,0
327,6920,1454,835,1044,76,110,219,1530,17,275,158,296,292,454,2297,3718,9,34017,1889,1,2,1,1,37330,15148,2825,21296,0
100,5163,1782,648,1425,9,47,279,1791,8,171,97,189,179,286,1292,2140,4,9462,525,0,2,27,0,37330,15149,2826,21297,0
179,4151,77,34,69,0,0,8,77,3,24,16,29,27,45,114,213,1,387,21,0,2,1,1,37360,15161,2829,21319,0
179,4151,712,438,573,51,9,84,763,14,102,71,128,116,199,733,1364,8,11988,666,0,2,1,1,37370,15162,2829,21320,0
70,1304,1020,354,843,12,15,144,1032,8,134,77,144,142,221,970,1580,4,6792,377,0,2,15,0,37370,15162,2829,21321,0
327,6920,72,33,56,0,4,12,72,1,1,1,1,2,2,0,2,0,1,0,0,2,45,30,37370,15162,2829,21322,0
327,6920,1454,835,1044,76,110,219,1530,17,275,158,296,292,454,2297,3718,9,34017,1889,1,2,45,30,37380,15163,2829,21323,0
128,2805,1043,504,840,53,9,147,1096,9,180,112,198,189,310,1377,2344,4,11604,644,0,2,12,5,37380,15165,2829,21324,0
128,2805,383,288,292,26,6,62,409,11,65,38,67,76,105,429,656,5,3719,206,0,2,12,5,37380,15166,2829,21325,0
78,3291,1289,550,1043,56,32,155,1345,10,167,93,185,177,278,1266,2075,5,11498,638,0,2,18,0,37380,15168,2830,21326,0
100,5163,1782,648,1425,9,47,279,1791,8,171,97,189,179,286,1292,2140,4,9462,525,0,2,146,37,37380,15169,2831,21327,0
69,2837,1043,504,840,53,9,147,1096,9,180,112,198,189,310,1377,2344,4,11604,644,0,2,13,0,37380,15171,2831,21328,0
68,2926,1178,367,1042,6,15,115,1184,9,94,51,95,103,146,644,976,4,4439,246,0,2,1,1,37380,15171,2831,21329,0
330,6968,72,33,56,0,4,12,72,1,1,1,1,2,2,0,2,0,1,0,0,2,9,3,37380,15171,2831,21330,1
330,6968,1454,835,1044,76,110,219,1530,17,275,158,296,292,454,2297,3718,9,34017,1889,1,2,9,3,37390,15172,2831,21331,1
101,5195,1782,648,1425,9,47,279,1791,8,171,97,189,179,286,1292,2140,4,9462,525,0,2,12,0,37390,15173,2832,21332,1
179,4151,77,34,69,0,0,8,77,3,24,16,29,27,45,114,213,1,387,21,0,2,1,1,37390,15173,2832,21333,0
179,4151,712,438,573,51,9,84,763,14,102,71,128,116,199,733,1364,8,11988,666,0,2,1,1,37400,15174,2832,21334,0
70,1304,1020,354,843,12,15,144,1032,8,134,77,144,142,221,970,1580,4,6792,377,0,2,15,0,37400,15174,2832,21335,0
327,6920,72,33,56,0,4,12,72,1,1,1,1,2,2,0,2,0,1,0,0,2,45,30,37400,15174,2832,21336,0
327,6920,1454,835,1044,76,110,219,1530,17,275,158,296,292,454,2297,3718,9,34017,1889,1,2,45,30,37410,15175,2832,21337,0
128,2805,1043,504,840,53,9,147,1096,9,180,112,198,189,310,1377,2344,4,11604,644,0,2,12,5,37410,15177,2832,21338,0
128,2805,383,288,292,26,6,62,409,11,65,38,67,76,105,429,656,5,3719,206,0,2,12,5,37410,15178,2832,21339,0
78,3291,1289,550,1043,56,32,155,1345,10,167,93,185,177,278,1266,2075,5,11498,638,0,2,18,0,37410,15180,2833,21340,0
100,5163,1782,648,1425,9,47,279,1791,8,171,97,189,179,286,1292,2140,4,9462,525,0,2,146,37,37410,15181,2834,21341,0
69,2837,1043,504,840,53,9,147,1096,9,180,112,198,189,310,1377,2344,4,11604,644,0,2,13,0,37410,15183,2834,21342,0
68,2926,1178,367,1042,6,15,115,1184,9,94,51,95,103,146,644,976,4,4439,246,0,2,1,1,37410,15183,2834,21343,0
330,6968,72,33,56,0,4,12,72,1,1,1,1,2,2,0,2,0,1,0,0,2,9,3,37410,15183,2834,21344,0
330,6968,1454,835,1044,76,110,219,1530,17,275,158,296,292,454,2297,3718,9,34017,1889,1,2,9,3,37420,15184,2834,21345,0
101,5195,1782,648,1425,9,47,279,1791,8,171,97,189,179,286,1292,2140,4,9462,525,0,2,12,0,37420,15185,2835,21346,0
334,6788,1457,730,1242,11,6,188,1468,10,292,166,329,302,495,2424,4078,5,22973,1276,1,2,1,1,37420,15187,2835,21347,1
334,6788,74,35,59,1,0,14,75,3,14,7,14,17,21,58,85,1,128,7,0,2,1,1,37420,15188,2835,21348,1
334,6788,245,125,200,5,7,34,250,7,30,17,34,37,51,166,265,3,1053,58,0,2,1,1,37430,15189,2835,21349,1
119,2397,1513,682,1277,25,13,200,1538,11,199,116,219,210,335,1557,2584,6,15641,868,0,2,7,0,37430,15191,2835,21350,1
119,2397,819,519,539,24,98,155,843,15,96,57,106,111,163,690,1107,8,9171,509,0,2,7,0,37440,15193,2835,21351,1
116,4563,1513,682,1277,25,13,200,1538,11,199,116,219,210,335,1557,2584,6,15641,868,0,2,22,0,37440,15195,2835,21352,1
119,2397,1513,682,1277,25,13,200,1538,11,199,116,219,210,335,1557,2584,6,15641,868,0,2,7,0,37440,15197,2835,21353,0
119,2397,819,519,539,24,98,155,843,15,96,57,106,111,163,690,1107,8,9171,509,0,2,7,0,37450,15199,2835,21354,0
116,4563,1513,682,1277,25,13,200,1538,11,199,116,219,210,335,1557,2584,6,15641,868,0,2,22,0,37450,15201,2835,21355,0
71,2088,1523,757,1297,19,12,193,1542,12,193,117,230,205,347,1508,2664,7,19053,1058,0,2,2,0,37460,15203,2835,21356,0
71,2088,701,378,504,33,58,109,734,13,110,68,126,123,194,794,1346,7,10027,557,0,2,2,0,37460,15204,2836,21357,0
79,3991,1523,757,1297,19,12,193,1542,12,193,117,230,205,347,1508,2664,7,19053,1058,0,2,25,0,37470,15206,2836,21358,0
207,4437,182,127,129,0,0,53,182,5,39,21,42,44,63,217,343,2,926,51,0,2,1,1,37470,15206,2837,21359,1
207,4437,1165,710,800,67,119,181,1232,18,243,153,282,261,435,2000,3492,10,36473,2026,1,2,1,1,37480,15206,2838,21360,1
87,3140,1450,624,1228,12,26,181,1462,14,306,186,354,320,540,2580,4493,8,36391,2021,1,2,9,0,37480,15208,2839,21361,1
207,4437,182,127,129,0,0,53,182,5,39,21,42,44,63,217,343,2,926,51,0,2,1,1,37480,15208,2840,21362,0
207,4437,1165,710,800,67,119,181,1232,18,243,153,282,261,435,2000,3492,10,36473,2026,1,2,1,1,37490,15208,2841,21363,0
87,3140,1450,624,1228,12,26,181,1462,14,306,186,354,320,540,2580,4493,8,36391,2021,1,2,9,0,37490,15210,2842,21364,0
330,6968,72,33,56,0,4,12,72,1,1,1,1,2,2,0,2,0,1,0,0,2,11,16,37490,15210,2842,21365,1
330,6968,1454,835,1044,76,110,219,1530,17,275,158,296,292,454,2297,3718,9,34017,1889,1,2,11,16,37500,15211,2842,21366,1
1,310,382,65,130,157,2,92,539,4,10,5,10,14,15,41,57,2,114,6,0,2,2,2,37500,15212,2843,21367,1
330,6968,72,33,56,0,4,12,72,1,1,1,1,2,2,0,2,0,1,0,0,2,11,16,37500,15212,2843,21368,0
330,6968,1454,835,1044,76,110,219,1530,17,275,158,296,292,454,2297,3718,9,34017,1889,1,2,11,16,37510,15213,2843,21369,0
1,310,382,65,130,157,2,92,539,4,10,5,10,14,15,41,57,2,114,6,0,2,2,2,37510,15214,2844,21370,0
23,680,339,213,244,17,9,65,356,10,42,26,48,52,74,259,421,5,2410,133,0,2,1,1,37520,15214,2844,21371,0
23,680,339,213,244,17,9,65,356,10,42,26,48,52,74,259,421,5,2410,133,0,2,1,1,37530,15214,2844,21372,0
55,1112,1098,241,925,5,10,155,1103,7,46,25,49,53,74,273,423,3,1580,87,0,2,6,1,37540,15216,2844,21373,0
55,1112,282,202,222,14,2,44,296,8,42,24,43,50,67,250,378,4,1548,86,0,2,6,1,37540,15217,2844,21374,0
207,4437,182,127,129,0,0,53,182,5,39,21,42,44,63,217,343,2,926,51,0,2,1,1,37540,15217,2845,21375,0
207,4437,1165,710,800,67,119,181,1232,18,243,153,282,261,435,2000,3492,10,36473,2026,1,2,1,1,37550,15217,2846,21376,0
119,2397,1513,682,1277,25,13,200,1538,11,199,116,219,210,335,1557,2584,6,15641,868,0,2,7,0,37550,15219,2846,21377,0
119,2397,819,519,539,24,98,155,843,15,96,57,106,111,163,690,1107,8,9171,509,0,2,7,0,37560,15221,2846,21378,0
23,680,339,213,244,17,9,65,356,10,42,26,48,52,74,259,421,5,2410,133,0,2,1,1,37570,15221,2846,21379,0
330,6968,72,33,56,0,4,12,72,1,1,1,1,2,2,0,2,0,1,0,0,2,20,19,37570,15221,2846,21380,0
330,6968,1454,835,1044,76,110,219,1530,17,275,158,296,292,454,2297,3718,9,34017,1889,1,2,20,19,37580,15222,2846,21381,0
1,310,382,65,130,157,2,92,539,4,10,5,10,14,15,41,57,2,114,6,0,2,2,2,37580,15223,2847,21382,0
101,5195,1782,648,1425,9,47,279,1791,8,171,97,189,179,286,1292,2140,4,9462,525,0,2,12,0,37580,15224,2848,21383,0
87,3140,1450,624,1228,12,26,181,1462,14,306,186,354,320,540,2580,4493,8,36391,2021,1,2,9,0,37580,15226,2849,21384,0
116,4563,1513,682,1277,25,13,200,1538,11,199,116,219,210,335,1557,2584,6,15641,868,0,2,22,0,37580,15228,2849,21385,0
34,625,2,2,2,0,0,0,2,0,0,0,0,0,0,0,0,0,0,0,0,2,6,0,37580,15228,2849,21385,1
34,625,99,48,90,1,3,5,100,0,0,0,0,0,0,0,0,0,0,0,0,2,6,0,37580,15229,2849,21386,1
34,625,8,5,5,2,0,1,10,0,0,0,0,0,0,0,0,0,0,0,0,2,6,0,37580,15229,2849,21387,1
34,625,1217,716,841,84,126,174,1301,14,185,118,215,199,333,1446,2542,8,20687,1149,0,2,6,0,37590,15231,2849,21388,1
34,625,160,89,115,0,13,31,160,7,15,11,17,22,28,78,124,3,495,27,0,2,6,0,37590,15231,2849,21389,1
34,625,10,10,9,9,0,0,19,0,0,0,0,0,0,0,0,0,0,0,0,2,6,0,37590,15231,2850,21390,1
34,625,173,84,99,8,29,36,181,5,12,7,13,17,20,54,81,2,221,12,0,2,6,0,37590,15232,2850,21391,1
34,625,3,1,1,3,0,0,6,0,0,0,0,0,0,0,0,0,0,0,0,2,6,0,37590,15232,2850,21392,1
335,6801,1457,730,1242,11,6,188,1468,10,292,166,329,302,495,2424,4078,5,22973,1276,1,2,2,0,37590,15234,2850,21393,1
335,6801,74,35,59,1,0,14,75,3,14,7,14,17,21,58,85,1,128,7,0,2,2,0,37590,15235,2850,21394,1
335,6801,245,125,200,5,7,34,250,7,30,17,34,37,51,166,265,3,1053,58,0,2,2,0,37600,15236,2850,21395,1
90,3249,1450,624,1228,12,26,181,1462,14,306,186,354,320,540,2580,4493,8,36391,2021,1,2,29,0,37600,15238,2851,21396,1
34,625,2,2,2,0,0,0,2,0,0,0,0,0,0,0,0,0,0,0,0,2,6,0,37600,15238,2851,21396,0
34,625,99,48,90,1,3,5,100,0,0,0,0,0,0,0,0,0,0,0,0,2,6,0,37600,15239,2851,21397,0
34,625,8,5,5,2,0,1,10,0,0,0,0,0,0,0,0,0,0,0,0,2,6,0,37600,15239,2851,21398,0
34,625,1217,716,841,84,126,174,1301,14,185,118,215,199,333,1446,2542,8,20687,1149,0,2,6,0,37610,15241,2851,21399,0
34,625,160,89,115,0,13,31,160,7,15,11,17,22,28,78,124,3,495,27,0,2,6,0,37610,15241,2851,21400,0
34,625,10,10,9,9,0,0,19,0,0,0,0,0,0,0,0,0,0,0,0,2,6,0,37610,15241,2852,21401,0
34,625,173,84,99,8,29,36,181,5,12,7,13,17,20,54,81,2,221,12,0,2,6,0,37610,15242,2852,21402,0
34,625,3,1,1,3,0,0,6,0,0,0,0,0,0,0,0,0,0,0,0,2,6,0,37610,15242,2852,21403,0
335,6801,1457,730,1242,11,6,188,1468,10,292,166,329,302,495,2424,4078,5,22973,1276,1,2,2,0,37610,15244,2852,21404,0
335,6801,74,35,59,1,0,14,75,3,14,7,14,17,21,58,85,1,128,7,0,2,2,0,37610,15245,2852,21405,0
335,6801,245,125,200,5,7,34,250,7,30,17,34,37,51,166,265,3,1053,58,0,2,2,0,37620,15246,2852,21406,0
90,3249,1450,624,1228,12,26,181,1462,14,306,186,354,320,540,2580,4493,8,36391,2021,1,2,29,0,37620,15248,2853,21407,0
40,1472,1293,570,1093,25,15,163,1318,10,195,123,241,205,364,1516,2795,6,17273,959,0,2,19,0,37630,15250,2853,21408,0
34,625,2,2,2,0,0,0,2,0,0,0,0,0,0,0,0,0,0,0,0,2,6,0,37630,15250,2853,21408,0
34,625,99,48,90,1,3,5,100,0,0,0,0,0,0,0,0,0,0,0,0,2,6,0,37630,15251,2853,21409,0
34,625,8,5,5,2,0,1,10,0,0,0,0,0,0,0,0,0,0,0,0,2,6,0,37630,15251,2853,21410,0
34,625,1217,716,841,84,126,174,1301,14,185,118,215,199,333,1446,2542,8,20687,1149,0,2,6,0,37640,15253,2853,21411,0
34,625,160,89,115,0,13,31,160,7,15,11,17,22,28,78,124,3,495,27,0,2,6,0,37640,15253,2853,21412,0
34,625,10,10,9,9,0,0,19,0,0,0,0,0,0,0,0,0,0,0,0,2,6,0,37640,15253,2854,21413,0
34,625,173,84,99,8,29,36,181,5,12,7,13,17,20,54,81,2,221,12,0,2,6,0,37640,15254,2854,21414,0
34,625,3,1,1,3,0,0,6,0,0,0,0,0,0,0,0,0,0,0,0,2,6,0,37640,15254,2854,21415,0
335,6801,1457,730,1242,11,6,188,1468,10,292,166,329,302,495,2424,4078,5,22973,1276,1,2,2,0,37640,15256,2854,21416,0
335,6801,74,35,59,1,0,14,75,3,14,7,14,17,21,58,85,1,128,7,0,2,2,0,37640,15257,2854,21417,0
335,6801,245,125,200,5,7,34,250,7,30,17,34,37,51,166,265,3,1053,58,0,2,2,0,37650,15258,2854,21418,0
90,3249,1450,624,1228,12,26,181,1462,14,306,186,354,320,540,2580,4493,8,36391,2021,1,2,29,0,37650,15260,2855,21419,0
55,1112,1098,241,925,5,10,155,1103,7,46,25,49,53,74,273,423,3,1580,87,0,2,1,1,37660,15262,2855,21420,1
55,1112,282,202,222,14,2,44,296,8,42,24,43,50,67,250,378,4,1548,86,0,2,1,1,37660,15263,2855,21421,1
40,1472,1293,570,1093,25,15,163,1318,10,195,123,241,205,364,1516,2795,6,17273,959,0,2,2,2,37670,15265,2855,21422,1
55,1112,1098,241,925,5,10,155,1103,7,46,25,49,53,74,273,423,3,1580,87,0,2,6,1,37680,15267,2855,21423,0
55,1112,282,202,222,14,2,44,296,8,42,24,43,50,67,250,378,4,1548,86,0,2,6,1,37680,15268,2855,21424,0
40,1472,1293,570,1093,25,15,163,1318,10,195,123,241,205,364,1516,2795,6,17273,959,0,2,19,0,37690,15270,2855,21425,0
56,1576,1455,414,1257,16,76,112,1471,5,41,23,46,46,69,231,381,2,1069,59,0,2,1,1,37700,15275,2856,21433,0
56,1576,669,365,481,22,61,110,691,15,103,63,122,118,185,747,1273,8,11311,628,0,2,1,1,37710,15275,2857,21434,0
56,1576,1455,414,1257,16,76,112,1471,5,41,23,46,46,69,231,381,2,1069,59,0,2,1,1,37720,15280,2858,21442,0
56,1576,669,365,481,22,61,110,691,15,103,63,122,118,185,747,1273,8,11311,628,0,2,1,1,37730,15280,2859,21443,0
34,625,2,2,2,0,0,0,2,0,0,0,0,0,0,0,0,0,0,0,0,2,6,0,37760,15292,2862,21464,1
34,625,99,48,90,1,3,5,100,0,0,0,0,0,0,0,0,0,0,0,0,2,6,0,37760,15293,2862,21465,1
34,625,8,5,5,2,0,1,10,0,0,0,0,0,0,0,0,0,0,0,0,2,6,0,37760,15293,2862,21466,1
34,625,1217,716,841,84,126,174,1301,14,185,118,215,199,333,1446,2542,8,20687,1149,0,2,6,0,37770,15295,2862,21467,1
34,625,160,89,115,0,13,31,160,7,15,11,17,22,28,78,124,3,495,27,0,2,6,0,37770,15295,2862,21468,1
34,625,10,10,9,9,0,0,19,0,0,0,0,0,0,0,0,0,0,0,0,2,6,0,37770,15295,2863,21469,1
34,625,173,84,99,8,29,36,181,5,12,7,13,17,20,54,81,2,221,12,0,2,6,0,37770,15296,2863,21470,1
34,625,3,1,1,3,0,0,6,0,0,0,0,0,0,0,0,0,0,0,0,2,6,0,37770,15296,2863,21471,1
335,6801,1457,730,1242,11,6,188,1468,10,292,166,329,302,495,2424,4078,5,22973,1276,1,2,2,0,37770,15298,2863,21472,1
335,6801,74,35,59,1,0,14,75,3,14,7,14,17,21,58,85,1,128,7,0,2,2,0,37770,15299,2863,21473,1
335,6801,245,125,200,5,7,34,250,7,30,17,34,37,51,166,265,3,1053,58,0,2,2,0,37780,15300,2863,21474,1
56,1576,1455,414,1257,16,76,112,1471,5,41,23,46,46,69,231,381,2,1069,59,0,2,1,1,37780,15301,2863,21475,1
56,1576,669,365,481,22,61,110,691,15,103,63,122,118,185,747,1273,8,11311,628,0,2,1,1,37790,15301,2864,21476,1
55,1112,1098,241,925,5,10,155,1103,7,46,25,49,53,74,273,423,3,1580,87,0,2,6,1,37800,15303,2864,21477,1
55,1112,282,202,222,14,2,44,296,8,42,24,43,50,67,250,378,4,1548,86,0,2,6,1,37800,15304,2864,21478,1
90,3249,1450,624,1228,12,26,181,1462,14,306,186,354,320,540,2580,4493,8,36391,2021,1,2,29,0,37800,15306,2865,21479,1
40,1472,1293,570,1093,25,15,163,1318,10,195,123,241,205,364,1516,2795,6,17273,959,0,2,19,0,37810,15308,2865,21480,1
34,625,2,2,2,0,0,0,2,0,0,0,0,0,0,0,0,0,0,0,0,2,6,0,37820,15312,2866,21487,0
34,625,99,48,90,1,3,5,100,0,0,0,0,0,0,0,0,0,0,0,0,2,6,0,37820,15313,2866,21488,0
34,625,8,5,5,2,0,1,10,0,0,0,0,0,0,0,0,0,0,0,0,2,6,0,37820,15313,2866,21489,0
34,625,1217,716,841,84,126,174,1301,14,185,118,215,199,333,1446,2542,8,20687,1149,0,2,6,0,37830,15315,2866,21490,0
34,625,160,89,115,0,13,31,160,7,15,11,17,22,28,78,124,3,495,27,0,2,6,0,37830,15315,2866,21491,0
34,625,10,10,9,9,0,0,19,0,0,0,0,0,0,0,0,0,0,0,0,2,6,0,37830,15315,2867,21492,0
34,625,173,84,99,8,29,36,181,5,12,7,13,17,20,54,81,2,221,12,0,2,6,0,37830,15316,2867,21493,0
34,625,3,1,1,3,0,0,6,0,0,0,0,0,0,0,0,0,0,0,0,2,6,0,37830,15316,2867,21494,0
335,6801,1457,730,1242,11,6,188,1468,10,292,166,329,302,495,2424,4078,5,22973,1276,1,2,2,0,37830,15318,2867,21495,0
335,6801,74,35,59,1,0,14,75,3,14,7,14,17,21,58,85,1,128,7,0,2,2,0,37830,15319,2867,21496,0
335,6801,245,125,200,5,7,34,250,7,30,17,34,37,51,166,265,3,1053,58,0,2,2,0,37840,15320,2867,21497,0
56,1576,1455,414,1257,16,76,112,1471,5,41,23,46,46,69,231,381,2,1069,59,0,2,1,1,37840,15321,2867,21498,0
56,1576,669,365,481,22,61,110,691,15,103,63,122,118,185,747,1273,8,11311,628,0,2,1,1,37850,15321,2868,21499,0
55,1112,1098,241,925,5,10,155,1103,7,46,25,49,53,74,273,423,3,1580,87,0,2,6,1,37860,15323,2868,21500,0
55,1112,282,202,222,14,2,44,296,8,42,24,43,50,67,250,378,4,1548,86,0,2,6,1,37860,15324,2868,21501,0
90,3249,1450,624,1228,12,26,181,1462,14,306,186,354,320,540,2580,4493,8,36391,2021,1,2,29,0,37860,15326,2869,21502,0
40,1472,1293,570,1093,25,15,163,1318,10,195,123,241,205,364,1516,2795,6,17273,959,0,2,19,0,37870,15328,2869,21503,0
330,6972,72,33,56,0,4,12,72,1,1,1,1,2,2,0,2,0,1,0,0,2,1,1,37870,15328,2869,21504,1
330,6972,1454,835,1044,76,110,219,1530,17,275,158,296,292,454,2297,3718,9,34017,1889,1,2,1,1,37880,15329,2869,21505,1
103,5262,1782,648,1425,9,47,279,1791,8,171,97,189,179,286,1292,2140,4,9462,525,0,2,8,0,37880,15330,2870,21506,1
70,1304,1020,354,843,12,15,144,1032,8,134,77,144,142,221,970,1580,4,6792,377,0,2,1,1,37880,15330,2870,21507,1
70,1304,1020,354,843,12,15,144,1032,8,134,77,144,142,221,970,1580,4,6792,377,0,2,1,1,37880,15330,2870,21508,0
330,6963,72,33,56,0,4,12,72,1,1,1,1,2,2,0,2,0,1,0,0,2,2,1,37880,15330,2870,21509,0
330,6963,1454,835,1044,76,110,219,1530,17,275,158,296,292,454,2297,3718,9,34017,1889,1,2,2,1,37890,15331,2870,21510,0
178,4126,77,34,69,0,0,8,77,3,24,16,29,27,45,114,213,1,387,21,0,2,0,4,37890,15331,2870,21511,1
178,4126,712,438,573,51,9,84,763,14,102,71,128,116,199,733,1364,8,11988,666,0,2,0,4,37900,15332,2870,21512,1
224,5018,722,423,573,19,0,135,741,12,172,101,199,184,300,1320,2257,6,15668,870,0,2,7,1,37900,15334,2870,21514,1
224,5018,1508,847,911,44,250,301,1552,14,148,88,169,162,257,1120,1886,7,15077,837,0,2,7,1,37900,15335,2871,21515,1
128,2812,1043,504,840,53,9,147,1096,9,180,112,198,189,310,1377,2344,4,11604,644,0,2,3,2,37900,15337,2871,21516,1
128,2812,383,288,292,26,6,62,409,11,65,38,67,76,105,429,656,5,3719,206,0,2,3,2,37900,15338,2871,21517,1
330,6972,72,33,56,0,4,12,72,1,1,1,1,2,2,0,2,0,1,0,0,2,1,1,37900,15338,2871,21518,0
330,6972,1454,835,1044,76,110,219,1530,17,275,158,296,292,454,2297,3718,9,34017,1889,1,2,1,1,37910,15339,2871,21519,0
103,5262,1782,648,1425,9,47,279,1791,8,171,97,189,179,286,1292,2140,4,9462,525,0,2,8,0,37910,15340,2872,21520,0
82,1794,477,336,357,30,23,73,507,16,194,134,250,210,384,1538,2962,10,30538,1696,0,2,1,1,37920,15341,2872,21521,0
320,6878,72,33,56,0,4,12,72,1,1,1,1,2,2,0,2,0,1,0,0,2,0,6,37920,15341,2872,21522,0
320,6878,1454,835,1044,76,110,219,1530,17,275,158,296,292,454,2297,3718,9,34017,1889,1,2,0,6,37930,15342,2872,21523,0
15,340,256,139,192,9,7,47,265,4,23,12,24,27,36,112,171,2,357,19,0,2,0,8,37930,15343,2872,21524,0
1,300,382,65,130,157,2,92,539,4,10,5,10,14,15,41,57,2,114,6,0,2,2,5,37930,15344,2873,21525,0
82,1794,477,336,357,30,23,73,507,16,194,134,250,210,384,1538,2962,10,30538,1696,0,2,1,1,37940,15345,2873,21526,0
329,6952,72,33,56,0,4,12,72,1,1,1,1,2,2,0,2,0,1,0,0,2,0,6,37940,15345,2873,21527,0
329,6952,1454,835,1044,76,110,219,1530,17,275,158,296,292,454,2297,3718,9,34017,1889,1,2,0,6,37950,15346,2873,21528,0
15,340,256,139,192,9,7,47,265,4,23,12,24,27,36,112,171,2,357,19,0,2,0,8,37950,15347,2873,21529,0
1,300,382,65,130,157,2,92,539,4,10,5,10,14,15,41,57,2,114,6,0,2,2,5,37950,15348,2874,21530,0
179,4155,77,34,69,0,0,8,77,3,24,16,29,27,45,114,213,1,387,21,0,2,1,1,37950,15348,2874,21531,1
179,4155,712,438,573,51,9,84,763,14,102,71,128,116,199,733,1364,8,11988,666,0,2,1,1,37960,15349,2874,21532,1
69,1346,1020,354,843,12,15,144,1032,8,134,77,144,142,221,970,1580,4,6792,377,0,2,46,37,37960,15349,2874,21533,1
103,1956,1178,367,1042,6,15,115,1184,9,94,51,95,103,146,644,976,4,4439,246,0,2,3,5,37960,15349,2874,21534,1
103,1956,177,108,140,8,0,27,185,6,30,16,32,36,48,162,248,3,794,44,0,2,3,5,37960,15351,2874,21535,1
66,2750,1020,354,843,12,15,144,1032,8,134,77,144,142,221,970,1580,4,6792,377,0,2,2,2,37960,15351,2874,21536,1
41,798,207,111,150,11,0,50,218,5,26,19,36,31,55,133,272,3,943,52,0,2,4,2,37960,15351,2874,21537,1
41,798,410,198,237,31,55,97,441,11,63,38,72,74,110,414,683,6,4293,238,0,2,4,2,37970,15352,2875,21538,1
69,1347,1020,354,843,12,15,144,1032,8,134,77,144,142,221,970,1580,4,6792,377,0,2,1,1,37970,15352,2875,21539,1
41,798,207,111,150,11,0,50,218,5,26,19,36,31,55,133,272,3,943,52,0,2,1,1,37970,15352,2875,21540,1
41,798,410,198,237,31,55,97,441,11,63,38,72,74,110,414,683,6,4293,238,0,2,1,1,37980,15353,2876,21541,1
336,6810,1457,730,1242,11,6,188,1468,10,292,166,329,302,495,2424,4078,5,22973,1276,1,2,15,10,37980,15355,2876,21542,1
336,6810,74,35,59,1,0,14,75,3,14,7,14,17,21,58,85,1,128,7,0,2,15,10,37980,15356,2876,21543,1
336,6810,245,125,200,5,7,34,250,7,30,17,34,37,51,166,265,3,1053,58,0,2,15,10,37990,15357,2876,21544,1
90,3273,1450,624,1228,12,26,181,1462,14,306,186,354,320,540,2580,4493,8,36391,2021,1,2,14,4,37990,15359,2877,21545,1
336,6810,1457,730,1242,11,6,188,1468,10,292,166,329,302,495,2424,4078,5,22973,1276,1,2,15,10,37990,15361,2877,21546,0
336,6810,74,35,59,1,0,14,75,3,14,7,14,17,21,58,85,1,128,7,0,2,15,10,37990,15362,2877,21547,0
336,6810,245,125,200,5,7,34,250,7,30,17,34,37,51,166,265,3,1053,58,0,2,15,10,38000,15363,2877,21548,0
90,3273,1450,624,1228,12,26,181,1462,14,306,186,354,320,540,2580,4493,8,36391,2021,1,2,14,4,38000,15365,2878,21549,0
336,6810,1457,730,1242,11,6,188,1468,10,292,166,329,302,495,2424,4078,5,22973,1276,1,2,1,1,38000,15367,2878,21550,0
336,6810,74,35,59,1,0,14,75,3,14,7,14,17,21,58,85,1,128,7,0,2,1,1,38000,15368,2878,21551,0
336,6810,245,125,200,5,7,34,250,7,30,17,34,37,51,166,265,3,1053,58,0,2,1,1,38010,15369,2878,21552,0
178,4126,77,34,69,0,0,8,77,3,24,16,29,27,45,114,213,1,387,21,0,2,0,4,38010,15369,2878,21553,0
178,4126,712,438,573,51,9,84,763,14,102,71,128,116,199,733,1364,8,11988,666,0,2,0,4,38020,15370,2878,21554,0
224,5018,722,423,573,19,0,135,741,12,172,101,199,184,300,1320,2257,6,15668,870,0,2,7,1,38020,15372,2878,21556,0
224,5018,1508,847,911,44,250,301,1552,14,148,88,169,162,257,1120,1886,7,15077,837,0,2,7,1,38020,15373,2879,21557,0
329,6947,72,33,56,0,4,12,72,1,1,1,1,2,2,0,2,0,1,0,0,2,2,1,38020,15373,2879,21558,0
329,6947,1454,835,1044,76,110,219,1530,17,275,158,296,292,454,2297,3718,9,34017,1889,1,2,2,1,38030,15374,2879,21559,0
128,2812,1043,504,840,53,9,147,1096,9,180,112,198,189,310,1377,2344,4,11604,644,0,2,3,2,38030,15376,2879,21560,0
128,2812,383,288,292,26,6,62,409,11,65,38,67,76,105,429,656,5,3719,206,0,2,3,2,38030,15377,2879,21561,0
71,2088,1523,757,1297,19,12,193,1542,12,193,117,230,205,347,1508,2664,7,19053,1058,0,2,2,0,38040,15379,2879,21562,0
71,2088,701,378,504,33,58,109,734,13,110,68,126,123,194,794,1346,7,10027,557,0,2,2,0,38040,15380,2880,21563,0
79,3991,1523,757,1297,19,12,193,1542,12,193,117,230,205,347,1508,2664,7,19053,1058,0,2,25,0,38050,15382,2880,21564,0
82,1795,477,336,357,30,23,73,507,16,194,134,250,210,384,1538,2962,10,30538,1696,0,2,2,2,38060,15383,2880,21565,0
91,3316,1450,624,1228,12,26,181,1462,14,306,186,354,320,540,2580,4493,8,36391,2021,1,2,10,2,38060,15385,2881,21566,0
34,643,2,2,2,0,0,0,2,0,0,0,0,0,0,0,0,0,0,0,0,2,11,4,38060,15385,2881,21566,0
34,643,99,48,90,1,3,5,100,0,0,0,0,0,0,0,0,0,0,0,0,2,11,4,38060,15386,2881,21567,0
34,643,8,5,5,2,0,1,10,0,0,0,0,0,0,0,0,0,0,0,0,2,11,4,38060,15386,2881,21568,0
34,643,1217,716,841,84,126,174,1301,14,185,118,215,199,333,1446,2542,8,20687,1149,0,2,11,4,38070,15388,2881,21569,0
34,643,160,89,115,0,13,31,160,7,15,11,17,22,28,78,124,3,495,27,0,2,11,4,38070,15388,2881,21570,0
34,643,10,10,9,9,0,0,19,0,0,0,0,0,0,0,0,0,0,0,0,2,11,4,38070,15388,2882,21571,0
34,643,173,84,99,8,29,36,181,5,12,7,13,17,20,54,81,2,221,12,0,2,11,4,38070,15389,2882,21572,0
34,643,3,1,1,3,0,0,6,0,0,0,0,0,0,0,0,0,0,0,0,2,11,4,38070,15389,2882,21573,0
41,798,207,111,150,11,0,50,218,5,26,19,36,31,55,133,272,3,943,52,0,2,4,2,38070,15389,2882,21574,0
41,798,410,198,237,31,55,97,441,11,63,38,72,74,110,414,683,6,4293,238,0,2,4,2,38080,15390,2883,21575,0
178,4130,77,34,69,0,0,8,77,3,24,16,29,27,45,114,213,1,387,21,0,2,1,1,38080,15390,2883,21576,0
178,4130,712,438,573,51,9,84,763,14,102,71,128,116,199,733,1364,8,11988,666,0,2,1,1,38090,15391,2883,21577,0
69,1347,1020,354,843,12,15,144,1032,8,134,77,144,142,221,970,1580,4,6792,377,0,2,46,37,38090,15391,2883,21578,0
103,1956,1178,367,1042,6,15,115,1184,9,94,51,95,103,146,644,976,4,4439,246,0,2,3,5,38090,15391,2883,21579,0
103,1956,177,108,140,8,0,27,185,6,30,16,32,36,48,162,248,3,794,44,0,2,3,5,38090,15393,2883,21580,0
66,2750,1020,354,843,12,15,144,1032,8,134,77,144,142,221,970,1580,4,6792,377,0,2,2,2,38090,15393,2883,21581,0
34,643,2,2,2,0,0,0,2,0,0,0,0,0,0,0,0,0,0,0,0,2,11,4,38090,15393,2883,21581,0
34,643,99,48,90,1,3,5,100,0,0,0,0,0,0,0,0,0,0,0,0,2,11,4,38090,15394,2883,21582,0
34,643,8,5,5,2,0,1,10,0,0,0,0,0,0,0,0,0,0,0,0,2,11,4,38090,15394,2883,21583,0
34,643,1217,716,841,84,126,174,1301,14,185,118,215,199,333,1446,2542,8,20687,1149,0,2,11,4,38100,15396,2883,21584,0
34,643,160,89,115,0,13,31,160,7,15,11,17,22,28,78,124,3,495,27,0,2,11,4,38100,15396,2883,21585,0
34,643,10,10,9,9,0,0,19,0,0,0,0,0,0,0,0,0,0,0,0,2,11,4,38100,15396,2884,21586,0
34,643,173,84,99,8,29,36,181,5,12,7,13,17,20,54,81,2,221,12,0,2,11,4,38100,15397,2884,21587,0
34,643,3,1,1,3,0,0,6,0,0,0,0,0,0,0,0,0,0,0,0,2,11,4,38100,15397,2884,21588,0
82,1795,477,336,357,30,23,73,507,16,194,134,250,210,384,1538,2962,10,30538,1696,0,2,2,2,38110,15398,2884,21589,0
91,3316,1450,624,1228,12,26,181,1462,14,306,186,354,320,540,2580,4493,8,36391,2021,1,2,10,2,38110,15400,2885,21590,0
330,6978,72,33,56,0,4,12,72,1,1,1,1,2,2,0,2,0,1,0,0,2,3,4,38110,15400,2885,21591,0
330,6978,1454,835,1044,76,110,219,1530,17,275,158,296,292,454,2297,3718,9,34017,1889,1,2,3,4,38120,15401,2885,21592,0
91,3313,1450,624,1228,12,26,181,1462,14,306,186,354,320,540,2580,4493,8,36391,2021,1,2,12,0,38120,15403,2886,21593,0
330,6978,72,33,56,0,4,12,72,1,1,1,1,2,2,0,2,0,1,0,0,2,3,4,38120,15403,2886,21594,0
330,6978,1454,835,1044,76,110,219,1530,17,275,158,296,292,454,2297,3718,9,34017,1889,1,2,3,4,38130,15404,2886,21595,0
91,3313,1450,624,1228,12,26,181,1462,14,306,186,354,320,540,2580,4493,8,36391,2021,1,2,12,0,38130,15406,2887,21596,0
22,673,339,213,244,17,9,65,356,10,42,26,48,52,74,259,421,5,2410,133,0,2,9,8,38140,15406,2887,21597,0
42,1533,1293,570,1093,25,15,163,1318,10,195,123,241,205,364,1516,2795,6,17273,959,0,2,31,15,38150,15408,2887,21598,0
44,1603,1293,570,1093,25,15,163,1318,10,195,123,241,205,364,1516,2795,6,17273,959,0,2,19,0,38160,15410,2887,21599,1
228,5101,4293,999,3693,19,54,507,4312,9,155,88,170,164,258,1156,1898,4,9368,520,0,2,23,1,38160,15412,2887,21600,1
228,5101,1482,859,1002,125,135,219,1607,16,219,134,251,235,385,1766,3032,9,27804,1544,1,2,23,1,38170,15413,2887,21601,1
330,6987,72,33,56,0,4,12,72,1,1,1,1,2,2,0,2,0,1,0,0,2,3,2,38170,15413,2887,21602,1
330,6987,1454,835,1044,76,110,219,1530,17,275,158,296,292,454,2297,3718,9,34017,1889,1,2,3,2,38180,15414,2887,21603,1
147,6715,139,89,101,2,0,35,141,7,54,34,62,61,96,330,569,4,2287,127,0,2,16,0,38180,15414,2887,21604,1
147,6715,7,5,5,0,0,2,7,1,2,1,2,3,3,2,4,0,2,0,0,2,16,0,38180,15414,2887,21605,1
106,5313,1782,648,1425,9,47,279,1791,8,171,97,189,179,286,1292,2140,4,9462,525,0,2,8,0,38180,15415,2888,21606,1
228,5101,4293,999,3693,19,54,507,4312,9,155,88,170,164,258,1156,1898,4,9368,520,0,2,23,1,38180,15417,2888,21607,0
228,5101,1482,859,1002,125,135,219,1607,16,219,134,251,235,385,1766,3032,9,27804,1544,1,2,23,1,38190,15418,2888,21608,0
330,6987,72,33,56,0,4,12,72,1,1,1,1,2,2,0,2,0,1,0,0,2,3,2,38190,15418,2888,21609,0
330,6987,1454,835,1044,76,110,219,1530,17,275,158,296,292,454,2297,3718,9,34017,1889,1,2,3,2,38200,15419,2888,21610,0
147,6715,139,89,101,2,0,35,141,7,54,34,62,61,96,330,569,4,2287,127,0,2,16,0,38200,15419,2888,21611,0
147,6715,7,5,5,0,0,2,7,1,2,1,2,3,3,2,4,0,2,0,0,2,16,0,38200,15419,2888,21612,0
106,5313,1782,648,1425,9,47,279,1791,8,171,97,189,179,286,1292,2140,4,9462,525,0,2,8,0,38200,15420,2889,21613,0
208,4450,182,127,129,0,0,53,182,5,39,21,42,44,63,217,343,2,926,51,0,2,4,0,38200,15420,2890,21614,1
208,4450,1165,710,800,67,119,181,1232,18,243,153,282,261,435,2000,3492,10,36473,2026,1,2,4,0,38210,15420,2891,21615,1
101,2153,773,419,590,28,0,166,801,10,204,113,217,214,330,1598,2554,5,13587,754,0,2,3,0,38210,15420,2892,21616,1
101,2153,421,273,302,44,34,57,465,17,81,59,107,98,166,583,1098,11,12329,684,0,2,3,0,38210,15420,2893,21617,1
82,1800,477,336,357,30,23,73,507,16,194,134,250,210,384,1538,2962,10,30538,1696,0,2,1,1,38220,15421,2893,21618,1
332,7010,72,33,56,0,4,12,72,1,1,1,1,2,2,0,2,0,1,0,0,2,6,0,38220,15421,2893,21619,1
332,7010,1454,835,1044,76,110,219,1530,17,275,158,296,292,454,2297,3718,9,34017,1889,1,2,6,0,38230,15422,2893,21620,1
207,4440,182,127,129,0,0,53,182,5,39,21,42,44,63,217,343,2,926,51,0,2,1,2,38230,15422,2894,21621,1
207,4440,1165,710,800,67,119,181,1232,18,243,153,282,261,435,2000,3492,10,36473,2026,1,2,1,2,38240,15422,2895,21622,1
100,2143,773,419,590,28,0,166,801,10,204,113,217,214,330,1598,2554,5,13587,754,0,2,1,2,38240,15422,2896,21623,1
100,2143,421,273,302,44,34,57,465,17,81,59,107,98,166,583,1098,11,12329,684,0,2,1,2,38240,15422,2897,21624,1
330,6984,72,33,56,0,4,12,72,1,1,1,1,2,2,0,2,0,1,0,0,2,2,4,38240,15422,2897,21625,1
330,6984,1454,835,1044,76,110,219,1530,17,275,158,296,292,454,2297,3718,9,34017,1889,1,2,2,4,38250,15423,2897,21626,1
207,4440,182,127,129,0,0,53,182,5,39,21,42,44,63,217,343,2,926,51,0,2,3,0,38250,15423,2898,21627,0
207,4440,1165,710,800,67,119,181,1232,18,243,153,282,261,435,2000,3492,10,36473,2026,1,2,3,0,38260,15423,2899,21628,0
100,2143,773,419,590,28,0,166,801,10,204,113,217,214,330,1598,2554,5,13587,754,0,2,2,0,38260,15423,2900,21629,0
100,2143,421,273,302,44,34,57,465,17,81,59,107,98,166,583,1098,11,12329,684,0,2,2,0,38260,15423,2901,21630,0
82,1800,477,336,357,30,23,73,507,16,194,134,250,210,384,1538,2962,10,30538,1696,0,2,1,1,38270,15424,2901,21631,0
330,6993,72,33,56,0,4,12,72,1,1,1,1,2,2,0,2,0,1,0,0,2,4,0,38270,15424,2901,21632,0
330,6993,1454,835,1044,76,110,219,1530,17,275,158,296,292,454,2297,3718,9,34017,1889,1,2,4,0,38280,15425,2901,21633,0
99,2124,773,419,590,28,0,166,801,10,204,113,217,214,330,1598,2554,5,13587,754,0,2,3,6,38280,15425,2902,21634,0
99,2124,421,273,302,44,34,57,465,17,81,59,107,98,166,583,1098,11,12329,684,0,2,3,6,38280,15425,2903,21635,0
99,2124,773,419,590,28,0,166,801,10,204,113,217,214,330,1598,2554,5,13587,754,0,2,3,6,38280,15425,2904,21636,0
99,2124,421,273,302,44,34,57,465,17,81,59,107,98,166,583,1098,11,12329,684,0,2,3,6,38280,15425,2905,21637,0
22,673,339,213,244,17,9,65,356,10,42,26,48,52,74,259,421,5,2410,133,0,2,9,8,38290,15425,2905,21638,0
44,1603,1293,570,1093,25,15,163,1318,10,195,123,241,205,364,1516,2795,6,17273,959,0,2,50,15,38300,15427,2905,21639,0
119,2401,1513,682,1277,25,13,200,1538,11,199,116,219,210,335,1557,2584,6,15641,868,0,2,2,1,38300,15429,2905,21640,0
119,2401,819,519,539,24,98,155,843,15,96,57,106,111,163,690,1107,8,9171,509,0,2,2,1,38310,15431,2905,21641,0
119,2402,1513,682,1277,25,13,200,1538,11,199,116,219,210,335,1557,2584,6,15641,868,0,2,2,1,38310,15433,2905,21642,0
119,2402,819,519,539,24,98,155,843,15,96,57,106,111,163,690,1107,8,9171,509,0,2,2,1,38320,15435,2905,21643,0
207,4440,182,127,129,0,0,53,182,5,39,21,42,44,63,217,343,2,926,51,0,2,3,0,38320,15435,2906,21644,0
207,4440,1165,710,800,67,119,181,1232,18,243,153,282,261,435,2000,3492,10,36473,2026,1,2,3,0,38330,15435,2907,21645,0
99,2124,773,419,590,28,0,166,801,10,204,113,217,214,330,1598,2554,5,13587,754,0,2,5,6,38330,15435,2908,21646,0
99,2124,421,273,302,44,34,57,465,17,81,59,107,98,166,583,1098,11,12329,684,0,2,5,6,38330,15435,2909,21647,0
82,1792,477,336,357,30,23,73,507,16,194,134,250,210,384,1538,2962,10,30538,1696,0,2,1,1,38340,15436,2909,21648,0
336,6810,1457,730,1242,11,6,188,1468,10,292,166,329,302,495,2424,4078,5,22973,1276,1,2,16,11,38340,15438,2909,21649,0
336,6810,74,35,59,1,0,14,75,3,14,7,14,17,21,58,85,1,128,7,0,2,16,11,38340,15439,2909,21650,0
336,6810,245,125,200,5,7,34,250,7,30,17,34,37,51,166,265,3,1053,58,0,2,16,11,38350,15440,2909,21651,0
228,5101,4293,999,3693,19,54,507,4312,9,155,88,170,164,258,1156,1898,4,9368,520,0,2,23,1,38350,15442,2909,21652,0
228,5101,1482,859,1002,125,135,219,1607,16,219,134,251,235,385,1766,3032,9,27804,1544,1,2,23,1,38360,15443,2909,21653,0
69,1347,1020,354,843,12,15,144,1032,8,134,77,144,142,221,970,1580,4,6792,377,0,2,1,1,38360,15443,2909,21654,0
329,6972,72,33,56,0,4,12,72,1,1,1,1,2,2,0,2,0,1,0,0,2,11,7,38360,15443,2909,21655,0
329,6972,1454,835,1044,76,110,219,1530,17,275,158,296,292,454,2297,3718,9,34017,1889,1,2,11,7,38370,15444,2909,21656,0
1,300,382,65,130,157,2,92,539,4,10,5,10,14,15,41,57,2,114,6,0,2,2,5,38370,15445,2910,21657,0
147,6715,139,89,101,2,0,35,141,7,54,34,62,61,96,330,569,4,2287,127,0,2,16,0,38370,15445,2910,21658,0
147,6715,7,5,5,0,0,2,7,1,2,1,2,3,3,2,4,0,2,0,0,2,16,0,38370,15445,2910,21659,0
106,5313,1782,648,1425,9,47,279,1791,8,171,97,189,179,286,1292,2140,4,9462,525,0,2,16,0,38370,15446,2911,21660,0
92,3380,1450,624,1228,12,26,181,1462,14,306,186,354,320,540,2580,4493,8,36391,2021,1,2,26,4,38370,15448,2912,21661,0
330,6993,72,33,56,0,4,12,72,1,1,1,1,2,2,0,2,0,1,0,0,2,3,3,38400,15460,2915,21683,1
330,6993,1454,835,1044,76,110,219,1530,17,275,158,296,292,454,2297,3718,9,34017,1889,1,2,3,3,38410,15461,2915,21684,1
68,2926,1178,367,1042,6,15,115,1184,9,94,51,95,103,146,644,976,4,4439,246,0,2,1,1,38410,15461,2915,21685,0
330,6993,72,33,56,0,4,12,72,1,1,1,1,2,2,0,2,0,1,0,0,2,3,3,38410,15461,2915,21686,0
330,6993,1454,835,1044,76,110,219,1530,17,275,158,296,292,454,2297,3718,9,34017,1889,1,2,3,3,38420,15462,2915,21687,0
68,2926,1178,367,1042,6,15,115,1184,9,94,51,95,103,146,644,976,4,4439,246,0,2,1,1,38420,15462,2915,21688,0
329,7012,72,33,56,0,4,12,72,1,1,1,1,2,2,0,2,0,1,0,0,2,8,5,38420,15462,2915,21689,0
329,7012,1454,835,1044,76,110,219,1530,17,275,158,296,292,454,2297,3718,9,34017,1889,1,2,8,5,38430,15463,2915,21690,0
78,3291,1289,550,1043,56,32,155,1345,10,167,93,185,177,278,1266,2075,5,11498,638,0,2,1,1,38430,15465,2916,21691,0
91,4149,1338,495,1086,10,64,173,1348,11,122,82,157,133,239,883,1686,7,11934,663,0,2,21,1,38430,15467,2916,21692,0
58,3234,1296,573,1062,40,33,157,1336,8,201,118,231,209,349,1561,2689,4,12365,686,0,2,0,11,38430,15467,2916,21693,0
71,3611,1943,715,1694,26,18,214,1969,12,185,120,237,197,357,1436,2721,7,20915,1161,0,2,1,1,38430,15469,2916,21694,0
332,7078,72,33,56,0,4,12,72,1,1,1,1,2,2,0,2,0,1,0,0,2,14,7,38430,15469,2916,21695,1
332,7078,1454,835,1044,76,110,219,1530,17,275,158,296,292,454,2297,3718,9,34017,1889,1,2,14,7,38440,15470,2916,21696,1
93,4223,1338,495,1086,10,64,173,1348,11,122,82,157,133,239,883,1686,7,11934,663,0,2,17,4,38440,15472,2916,21697,1
24,834,74,35,59,1,0,14,75,3,14,7,14,17,21,58,85,1,128,7,0,2,2,2,38440,15473,2916,21698,0
24,834,245,125,200,5,7,34,250,7,30,17,34,37,51,166,265,3,1053,58,0,2,2,2,38450,15474,2916,21699,0
24,834,74,35,59,1,0,14,75,3,14,7,14,17,21,58,85,1,128,7,0,2,2,2,38450,15475,2916,21700,0
24,834,245,125,200,5,7,34,250,7,30,17,34,37,51,166,265,3,1053,58,0,2,2,2,38460,15476,2916,21701,0
332,7078,72,33,56,0,4,12,72,1,1,1,1,2,2,0,2,0,1,0,0,2,17,7,38460,15476,2916,21702,0
332,7078,1454,835,1044,76,110,219,1530,17,275,158,296,292,454,2297,3718,9,34017,1889,1,2,17,7,38470,15477,2916,21703,0
78,3291,1289,550,1043,56,32,155,1345,10,167,93,185,177,278,1266,2075,5,11498,638,0,2,1,1,38470,15479,2917,21704,0
93,4223,1338,495,1086,10,64,173,1348,11,122,82,157,133,239,883,1686,7,11934,663,0,2,34,1,38470,15481,2917,21705,0
58,3234,1296,573,1062,40,33,157,1336,8,201,118,231,209,349,1561,2689,4,12365,686,0,2,0,11,38470,15481,2917,21706,0
71,3611,1943,715,1694,26,18,214,1969,12,185,120,237,197,357,1436,2721,7,20915,1161,0,2,1,1,38470,15483,2917,21707,0
28,547,2,2,2,0,0,0,2,0,0,0,0,0,0,0,0,0,0,0,0,2,4,23,38470,15483,2917,21707,1
28,547,99,48,90,1,3,5,100,0,0,0,0,0,0,0,0,0,0,0,0,2,4,23,38470,15484,2917,21708,1
28,547,8,5,5,2,0,1,10,0,0,0,0,0,0,0,0,0,0,0,0,2,4,23,38470,15484,2917,21709,1
28,547,1217,716,841,84,126,174,1301,14,185,118,215,199,333,1446,2542,8,20687,1149,0,2,4,23,38480,15486,2917,21710,1
28,547,160,89,115,0,13,31,160,7,15,11,17,22,28,78,124,3,495,27,0,2,4,23,38480,15486,2917,21711,1
28,547,10,10,9,9,0,0,19,0,0,0,0,0,0,0,0,0,0,0,0,2,4,23,38480,15486,2918,21712,1
28,547,173,84,99,8,29,36,181,5,12,7,13,17,20,54,81,2,221,12,0,2,4,23,38480,15487,2918,21713,1
28,547,3,1,1,3,0,0,6,0,0,0,0,0,0,0,0,0,0,0,0,2,4,23,38480,15487,2918,21714,1
17,341,95,58,50,9,16,20,104,12,33,24,45,45,69,209,378,8,3100,172,0,0,102,0,38480,15487,2918,21715,1
105,3912,1450,624,1228,12,26,181,1462,14,306,186,354,320,540,2580,4493,8,36391,2021,1,2,106,35,38480,15489,2919,21716,1
28,545,2,2,2,0,0,0,2,0,0,0,0,0,0,0,0,0,0,0,0,2,0,1,38480,15489,2919,21716,0
28,545,99,48,90,1,3,5,100,0,0,0,0,0,0,0,0,0,0,0,0,2,0,1,38480,15490,2919,21717,0
28,545,8,5,5,2,0,1,10,0,0,0,0,0,0,0,0,0,0,0,0,2,0,1,38480,15490,2919,21718,0
28,545,1217,716,841,84,126,174,1301,14,185,118,215,199,333,1446,2542,8,20687,1149,0,2,0,1,38490,15492,2919,21719,0
28,545,160,89,115,0,13,31,160,7,15,11,17,22,28,78,124,3,495,27,0,2,0,1,38490,15492,2919,21720,0
28,545,10,10,9,9,0,0,19,0,0,0,0,0,0,0,0,0,0,0,0,2,0,1,38490,15492,2920,21721,0
28,545,173,84,99,8,29,36,181,5,12,7,13,17,20,54,81,2,221,12,0,2,0,1,38490,15493,2920,21722,0
28,545,3,1,1,3,0,0,6,0,0,0,0,0,0,0,0,0,0,0,0,2,0,1,38490,15493,2920,21723,0
105,3912,1450,624,1228,12,26,181,1462,14,306,186,354,320,540,2580,4493,8,36391,2021,1,2,1,1,38490,15495,2921,21724,0
44,837,207,111,150,11,0,50,218,5,26,19,36,31,55,133,272,3,943,52,0,2,15,1,38490,15495,2921,21725,1
44,837,410,198,237,31,55,97,441,11,63,38,72,74,110,414,683,6,4293,238,0,2,15,1,38500,15496,2922,21726,1
336,6824,1457,730,1242,11,6,188,1468,10,292,166,329,302,495,2424,4078,5,22973,1276,1,2,2,1,38500,15498,2922,21727,1
336,6824,74,35,59,1,0,14,75,3,14,7,14,17,21,58,85,1,128,7,0,2,2,1,38500,15499,2922,21728,1
336,6824,245,125,200,5,7,34,250,7,30,17,34,37,51,166,265,3,1053,58,0,2,2,1,38510,15500,2922,21729,1
35,1824,384,251,317,7,8,52,391,11,70,44,84,81,128,467,811,6,5355,297,0,2,9,3,38510,15500,2922,21730,1
105,3908,1450,624,1228,12,26,181,1462,14,306,186,354,320,540,2580,4493,8,36391,2021,1,2,2,2,38510,15502,2923,21731,0
44,837,207,111,150,11,0,50,218,5,26,19,36,31,55,133,272,3,943,52,0,2,15,1,38510,15502,2923,21732,0
44,837,410,198,237,31,55,97,441,11,63,38,72,74,110,414,683,6,4293,238,0,2,15,1,38520,15503,2924,21733,0
336,6824,1457,730,1242,11,6,188,1468,10,292,166,329,302,495,2424,4078,5,22973,1276,1,2,2,1,38520,15505,2924,21734,0
336,6824,74,35,59,1,0,14,75,3,14,7,14,17,21,58,85,1,128,7,0,2,2,1,38520,15506,2924,21735,0
336,6824,245,125,200,5,7,34,250,7,30,17,34,37,51,166,265,3,1053,58,0,2,2,1,38530,15507,2924,21736,0
35,1824,384,251,317,7,8,52,391,11,70,44,84,81,128,467,811,6,5355,297,0,2,9,3,38530,15507,2924,21737,0
336,6826,1457,730,1242,11,6,188,1468,10,292,166,329,302,495,2424,4078,5,22973,1276,1,2,1,1,38530,15509,2924,21738,1
336,6826,74,35,59,1,0,14,75,3,14,7,14,17,21,58,85,1,128,7,0,2,1,1,38530,15510,2924,21739,1
336,6826,245,125,200,5,7,34,250,7,30,17,34,37,51,166,265,3,1053,58,0,2,1,1,38540,15511,2924,21740,1
40,2349,334,251,279,10,4,40,344,5,127,74,143,132,217,899,1528,2,4303,239,0,2,13,1,38540,15512,2924,21741,1
336,6826,1457,730,1242,11,6,188,1468,10,292,166,329,302,495,2424,4078,5,22973,1276,1,2,1,1,38540,15514,2924,21742,0
336,6826,74,35,59,1,0,14,75,3,14,7,14,17,21,58,85,1,128,7,0,2,1,1,38540,15515,2924,21743,0
336,6826,245,125,200,5,7,34,250,7,30,17,34,37,51,166,265,3,1053,58,0,2,1,1,38550,15516,2924,21744,0
40,2349,334,251,279,10,4,40,344,5,127,74,143,132,217,899,1528,2,4303,239,0,2,13,1,38550,15517,2924,21745,0
161,5059,1660,832,1314,41,38,274,1701,20,312,209,395,332,604,2671,5058,12,64042,3557,1,2,6,1,38550,15519,2925,21747,1
161,5059,1057,646,719,113,100,145,1170,18,215,134,248,233,382,1740,3004,10,31186,1732,1,2,6,1,38560,15520,2926,21748,1
142,3828,1660,832,1314,41,38,274,1701,20,312,209,395,332,604,2671,5058,12,64042,3557,1,2,16,0,38560,15522,2927,21750,1
44,844,207,111,150,11,0,50,218,5,26,19,36,31,55,133,272,3,943,52,0,2,14,0,38560,15522,2927,21751,0
44,844,410,198,237,31,55,97,441,11,63,38,72,74,110,414,683,6,4293,238,0,2,14,0,38570,15523,2928,21752,0
336,6826,1457,730,1242,11,6,188,1468,10,292,166,329,302,495,2424,4078,5,22973,1276,1,2,3,2,38570,15525,2928,21753,0
336,6826,74,35,59,1,0,14,75,3,14,7,14,17,21,58,85,1,128,7,0,2,3,2,38570,15526,2928,21754,0
336,6826,245,125,200,5,7,34,250,7,30,17,34,37,51,166,265,3,1053,58,0,2,3,2,38580,15527,2928,21755,0
24,834,74,35,59,1,0,14,75,3,14,7,14,17,21,58,85,1,128,7,0,2,2,2,38580,15528,2928,21756,0
24,834,245,125,200,5,7,34,250,7,30,17,34,37,51,166,265,3,1053,58,0,2,2,2,38590,15529,2928,21757,0
331,7057,72,33,56,0,4,12,72,1,1,1,1,2,2,0,2,0,1,0,0,2,20,10,38590,15529,2928,21758,0
331,7057,1454,835,1044,76,110,219,1530,17,275,158,296,292,454,2297,3718,9,34017,1889,1,2,20,10,38600,15530,2928,21759,0
78,3291,1289,550,1043,56,32,155,1345,10,167,93,185,177,278,1266,2075,5,11498,638,0,2,1,1,38600,15532,2929,21760,0
93,4223,1338,495,1086,10,64,173,1348,11,122,82,157,133,239,883,1686,7,11934,663,0,2,34,1,38600,15534,2929,21761,0
58,3234,1296,573,1062,40,33,157,1336,8,201,118,231,209,349,1561,2689,4,12365,686,0,2,0,11,38600,15534,2929,21762,0
40,2349,334,251,279,10,4,40,344,5,127,74,143,132,217,899,1528,2,4303,239,0,2,13,1,38600,15535,2929,21763,0
35,1824,384,251,317,7,8,52,391,11,70,44,84,81,128,467,811,6,5355,297,0,2,9,3,38600,15535,2929,21764,0
68,2926,1178,367,1042,6,15,115,1184,9,94,51,95,103,146,644,976,4,4439,246,0,2,1,1,38600,15535,2929,21765,0
71,3611,1943,715,1694,26,18,214,1969,12,185,120,237,197,357,1436,2721,7,20915,1161,0,2,1,1,38600,15537,2929,21766,0
332,7078,72,33,56,0,4,12,72,1,1,1,1,2,2,0,2,0,1,0,0,2,13,9,38600,15537,2929,21767,1
332,7078,1454,835,1044,76,110,219,1530,17,275,158,296,292,454,2297,3718,9,34017,1889,1,2,13,9,38610,15538,2929,21768,1
41,951,386,256,301,16,9,68,402,4,59,35,69,63,104,355,621,2,1453,80,0,2,6,1,38610,15538,2929,21769,1
41,951,264,131,164,11,41,46,275,6,38,22,40,44,62,214,338,3,1068,59,0,2,6,1,38620,15538,2930,21770,1
29,1414,1293,570,1093,25,15,163,1318,10,195,123,241,205,364,1516,2795,6,17273,959,0,2,16,24,38630,15540,2930,21771,0
29,1416,1293,570,1093,25,15,163,1318,10,195,123,241,205,364,1516,2795,6,17273,959,0,2,2,2,38640,15542,2930,21772,0
222,4970,722,423,573,19,0,135,741,12,172,101,199,184,300,1320,2257,6,15668,870,0,2,0,2,38640,15544,2930,21774,1
222,4970,1508,847,911,44,250,301,1552,14,148,88,169,162,257,1120,1886,7,15077,837,0,2,0,2,38640,15545,2931,21775,1
30,1428,1293,570,1093,25,15,163,1318,10,195,123,241,205,364,1516,2795,6,17273,959,0,2,3,0,38650,15547,2931,21776,1
222,4970,722,423,573,19,0,135,741,12,172,101,199,184,300,1320,2257,6,15668,870,0,2,0,2,38650,15549,2931,21778,0
222,4970,1508,847,911,44,250,301,1552,14,148,88,169,162,257,1120,1886,7,15077,837,0,2,0,2,38650,15550,2932,21779,0
30,1428,1293,570,1093,25,15,163,1318,10,195,123,241,205,364,1516,2795,6,17273,959,0,2,21,26,38660,15552,2932,21780,0
9,360,601,196,481,2,23,85,603,8,63,36,72,71,108,400,664,4,3036,168,0,2,68,0,38660,15552,2932,21781,1
9,360,601,196,481,2,23,85,603,8,63,36,72,71,108,400,664,4,3036,168,0,2,68,0,38660,15552,2932,21782,0
332,7078,72,33,56,0,4,12,72,1,1,1,1,2,2,0,2,0,1,0,0,2,13,9,38670,15556,2933,21795,0
332,7078,1454,835,1044,76,110,219,1530,17,275,158,296,292,454,2297,3718,9,34017,1889,1,2,13,9,38680,15557,2933,21796,0
41,951,386,256,301,16,9,68,402,4,59,35,69,63,104,355,621,2,1453,80,0,2,6,1,38680,15557,2933,21797,0
41,951,264,131,164,11,41,46,275,6,38,22,40,44,62,214,338,3,1068,59,0,2,6,1,38690,15557,2934,21798,0
161,5059,1660,832,1314,41,38,274,1701,20,312,209,395,332,604,2671,5058,12,64042,3557,1,2,6,1,38690,15559,2935,21800,0
161,5059,1057,646,719,113,100,145,1170,18,215,134,248,233,382,1740,3004,10,31186,1732,1,2,6,1,38700,15560,2936,21801,0
142,3828,1660,832,1314,41,38,274,1701,20,312,209,395,332,604,2671,5058,12,64042,3557,1,2,16,0,38700,15562,2937,21803,0
119,2402,1513,682,1277,25,13,200,1538,11,199,116,219,210,335,1557,2584,6,15641,868,0,2,3,1,38700,15564,2937,21804,0
119,2402,819,519,539,24,98,155,843,15,96,57,106,111,163,690,1107,8,9171,509,0,2,3,1,38710,15566,2937,21805,0
40,922,386,256,301,16,9,68,402,4,59,35,69,63,104,355,621,2,1453,80,0,2,5,10,38710,15566,2937,21806,0
40,922,264,131,164,11,41,46,275,6,38,22,40,44,62,214,338,3,1068,59,0,2,5,10,38720,15566,2938,21807,0
29,1224,386,256,301,16,9,68,402,4,59,35,69,63,104,355,621,2,1453,80,0,2,3,0,38720,15566,2938,21808,0
184,3741,1943,715,1694,26,18,214,1969,12,185,120,237,197,357,1436,2721,7,20915,1161,0,2,12,0,38720,15568,2938,21809,1
184,3741,1168,838,957,57,25,144,1225,19,348,224,416,367,640,3018,5452,11,61921,3440,1,2,12,0,38730,15570,2938,21810,1
72,3658,1943,715,1694,26,18,214,1969,12,185,120,237,197,357,1436,2721,7,20915,1161,0,2,25,0,38730,15572,2938,21811,1
184,3741,1943,715,1694,26,18,214,1969,12,185,120,237,197,357,1436,2721,7,20915,1161,0,2,12,0,38730,15574,2938,21812,0
184,3741,1168,838,957,57,25,144,1225,19,348,224,416,367,640,3018,5452,11,61921,3440,1,2,12,0,38740,15576,2938,21813,0
72,3658,1943,715,1694,26,18,214,1969,12,185,120,237,197,357,1436,2721,7,20915,1161,0,2,25,0,38740,15578,2938,21814,0
40,922,386,256,301,16,9,68,402,4,59,35,69,63,104,355,621,2,1453,80,0,2,5,10,38740,15578,2938,21815,0
40,922,264,131,164,11,41,46,275,6,38,22,40,44,62,214,338,3,1068,59,0,2,5,10,38750,15578,2939,21816,0
29,1224,386,256,301,16,9,68,402,4,59,35,69,63,104,355,621,2,1453,80,0,2,3,0,38750,15578,2939,21817,0
71,2092,1523,757,1297,19,12,193,1542,12,193,117,230,205,347,1508,2664,7,19053,1058,0,2,5,1,38760,15580,2939,21818,1
71,2092,701,378,504,33,58,109,734,13,110,68,126,123,194,794,1346,7,10027,557,0,2,5,1,38760,15581,2940,21819,1
79,3954,1523,757,1297,19,12,193,1542,12,193,117,230,205,347,1508,2664,7,19053,1058,0,2,24,0,38770,15583,2940,21820,1
71,2092,1523,757,1297,19,12,193,1542,12,193,117,230,205,347,1508,2664,7,19053,1058,0,2,5,1,38780,15585,2940,21821,0
71,2092,701,378,504,33,58,109,734,13,110,68,126,123,194,794,1346,7,10027,557,0,2,5,1,38780,15586,2941,21822,0
79,3954,1523,757,1297,19,12,193,1542,12,193,117,230,205,347,1508,2664,7,19053,1058,0,2,24,0,38790,15588,2941,21823,0
210,4482,182,127,129,0,0,53,182,5,39,21,42,44,63,217,343,2,926,51,0,2,11,4,38790,15588,2942,21824,1
210,4482,1165,710,800,67,119,181,1232,18,243,153,282,261,435,2000,3492,10,36473,2026,1,2,11,4,38800,15588,2943,21825,1
137,6580,1392,870,1177,35,17,170,1427,14,494,280,531,508,811,4473,7289,7,54850,3047,2,2,44,0,38800,15591,2944,21826,1
92,3384,1450,624,1228,12,26,181,1462,14,306,186,354,320,540,2580,4493,8,36391,2021,1,2,31,0,38800,15593,2945,21827,1
210,4482,182,127,129,0,0,53,182,5,39,21,42,44,63,217,343,2,926,51,0,2,11,4,38800,15593,2946,21828,0
210,4482,1165,710,800,67,119,181,1232,18,243,153,282,261,435,2000,3492,10,36473,2026,1,2,11,4,38810,15593,2947,21829,0
137,6580,1392,870,1177,35,17,170,1427,14,494,280,531,508,811,4473,7289,7,54850,3047,2,2,44,0,38810,15596,2948,21830,0
92,3384,1450,624,1228,12,26,181,1462,14,306,186,354,320,540,2580,4493,8,36391,2021,1,2,31,0,38810,15598,2949,21831,0
55,1122,1098,241,925,5,10,155,1103,7,46,25,49,53,74,273,423,3,1580,87,0,2,3,0,38840,15608,2951,21846,1
55,1122,282,202,222,14,2,44,296,8,42,24,43,50,67,250,378,4,1548,86,0,2,3,0,38840,15609,2951,21847,1
48,1773,1098,241,925,5,10,155,1103,7,46,25,49,53,74,273,423,3,1580,87,0,2,23,0,38850,15611,2951,21848,1
55,1122,1098,241,925,5,10,155,1103,7,46,25,49,53,74,273,423,3,1580,87,0,2,3,0,38860,15613,2951,21849,0
55,1122,282,202,222,14,2,44,296,8,42,24,43,50,67,250,378,4,1548,86,0,2,3,0,38860,15614,2951,21850,0
48,1773,1098,241,925,5,10,155,1103,7,46,25,49,53,74,273,423,3,1580,87,0,2,23,0,38870,15616,2951,21851,0
211,4499,182,127,129,0,0,53,182,5,39,21,42,44,63,217,343,2,926,51,0,2,3,2,38870,15616,2952,21852,1
211,4499,1165,710,800,67,119,181,1232,18,243,153,282,261,435,2000,3492,10,36473,2026,1,2,3,2,38880,15616,2953,21853,1
19,443,256,139,192,9,7,47,265,4,23,12,24,27,36,112,171,2,357,19,0,2,18,0,38880,15617,2953,21854,0
334,7098,72,33,56,0,4,12,72,1,1,1,1,2,2,0,2,0,1,0,0,2,5,1,38880,15617,2953,21855,1
334,7098,1454,835,1044,76,110,219,1530,17,275,158,296,292,454,2297,3718,9,34017,1889,1,2,5,1,38890,15618,2953,21856,1
20,468,256,139,192,9,7,47,265,4,23,12,24,27,36,112,171,2,357,19,0,2,17,5,38890,15619,2953,21857,1
211,4499,182,127,129,0,0,53,182,5,39,21,42,44,63,217,343,2,926,51,0,2,3,2,38890,15619,2954,21858,0
211,4499,1165,710,800,67,119,181,1232,18,243,153,282,261,435,2000,3492,10,36473,2026,1,2,3,2,38900,15619,2955,21859,0
334,7098,72,33,56,0,4,12,72,1,1,1,1,2,2,0,2,0,1,0,0,2,5,1,38900,15619,2955,21860,0
334,7098,1454,835,1044,76,110,219,1530,17,275,158,296,292,454,2297,3718,9,34017,1889,1,2,5,1,38910,15620,2955,21861,0
20,468,256,139,192,9,7,47,265,4,23,12,24,27,36,112,171,2,357,19,0,2,30,0,38910,15621,2955,21862,0
14,474,42,7,35,4,0,5,46,1,2,1,2,3,3,2,4,0,2,0,0,2,1,0,38920,15625,2956,21870,0
14,474,11,6,10,0,0,1,11,2,4,2,4,6,6,10,15,1,15,0,0,2,1,0,38920,15625,2956,21871,0
14,474,42,7,35,4,0,5,46,1,2,1,2,3,3,2,4,0,2,0,0,2,1,0,38920,15625,2956,21872,0
14,474,11,6,10,0,0,1,11,2,4,2,4,6,6,10,15,1,15,0,0,2,1,0,38920,15625,2956,21873,0
211,4499,182,127,129,0,0,53,182,5,39,21,42,44,63,217,343,2,926,51,0,2,14,6,38940,15633,2959,21888,0
211,4499,1165,710,800,67,119,181,1232,18,243,153,282,261,435,2000,3492,10,36473,2026,1,2,14,6,38950,15633,2960,21889,0
161,5059,1660,832,1314,41,38,274,1701,20,312,209,395,332,604,2671,5058,12,64042,3557,1,2,6,1,38950,15635,2961,21891,0
161,5059,1057,646,719,113,100,145,1170,18,215,134,248,233,382,1740,3004,10,31186,1732,1,2,6,1,38960,15636,2962,21892,0
72,2108,1523,757,1297,19,12,193,1542,12,193,117,230,205,347,1508,2664,7,19053,1058,0,2,5,1,38970,15638,2962,21893,0
72,2108,701,378,504,33,58,109,734,13,110,68,126,123,194,794,1346,7,10027,557,0,2,5,1,38970,15639,2963,21894,0
223,5005,722,423,573,19,0,135,741,12,172,101,199,184,300,1320,2257,6,15668,870,0,2,0,2,38970,15641,2963,21896,0
223,5005,1508,847,911,44,250,301,1552,14,148,88,169,162,257,1120,1886,7,15077,837,0,2,0,2,38970,15642,2964,21897,0
333,7077,72,33,56,0,4,12,72,1,1,1,1,2,2,0,2,0,1,0,0,2,18,10,38970,15642,2964,21898,0
333,7077,1454,835,1044,76,110,219,1530,17,275,158,296,292,454,2297,3718,9,34017,1889,1,2,18,10,38980,15643,2964,21899,0
40,922,386,256,301,16,9,68,402,4,59,35,69,63,104,355,621,2,1453,80,0,2,6,1,38980,15643,2964,21900,0
40,922,264,131,164,11,41,46,275,6,38,22,40,44,62,214,338,3,1068,59,0,2,6,1,38990,15643,2965,21901,0
184,3741,1943,715,1694,26,18,214,1969,12,185,120,237,197,357,1436,2721,7,20915,1161,0,2,12,0,38990,15645,2965,21902,0
184,3741,1168,838,957,57,25,144,1225,19,348,224,416,367,640,3018,5452,11,61921,3440,1,2,12,0,39000,15647,2965,21903,0
55,1122,1098,241,925,5,10,155,1103,7,46,25,49,53,74,273,423,3,1580,87,0,2,3,0,39010,15649,2965,21904,0
55,1122,282,202,222,14,2,44,296,8,42,24,43,50,67,250,378,4,1548,86,0,2,3,0,39010,15650,2965,21905,0
14,474,42,7,35,4,0,5,46,1,2,1,2,3,3,2,4,0,2,0,0,2,1,0,39010,15650,2965,21906,0
14,474,11,6,10,0,0,1,11,2,4,2,4,6,6,10,15,1,15,0,0,2,1,0,39010,15650,2965,21907,0
137,6580,1392,870,1177,35,17,170,1427,14,494,280,531,508,811,4473,7289,7,54850,3047,2,2,44,0,39010,15653,2966,21908,0
19,446,256,139,192,9,7,47,265,4,23,12,24,27,36,112,171,2,357,19,0,2,30,0,39010,15654,2966,21909,0
93,3451,1450,624,1228,12,26,181,1462,14,306,186,354,320,540,2580,4493,8,36391,2021,1,2,31,0,39010,15656,2967,21910,0
142,3828,1660,832,1314,41,38,274,1701,20,312,209,395,332,604,2671,5058,12,64042,3557,1,2,16,0,39010,15658,2968,21912,0
80,4077,1523,757,1297,19,12,193,1542,12,193,117,230,205,347,1508,2664,7,19053,1058,0,2,24,0,39020,15660,2968,21913,0
34,1559,1293,570,1093,25,15,163,1318,10,195,123,241,205,364,1516,2795,6,17273,959,0,2,21,26,39030,15662,2968,21914,0
72,3658,1943,715,1694,26,18,214,1969,12,185,120,237,197,357,1436,2721,7,20915,1161,0,2,25,0,39030,15664,2968,21915,0
48,1773,1098,241,925,5,10,155,1103,7,46,25,49,53,74,273,423,3,1580,87,0,2,23,0,39040,15666,2968,21916,0
211,4499,182,127,129,0,0,53,182,5,39,21,42,44,63,217,343,2,926,51,0,2,14,6,39040,15666,2969,21917,0
211,4499,1165,710,800,67,119,181,1232,18,243,153,282,261,435,2000,3492,10,36473,2026,1,2,14,6,39050,15666,2970,21918,0
161,5059,1660,832,1314,41,38,274,1701,20,312,209,395,332,604,2671,5058,12,64042,3557,1,2,6,1,39050,15668,2971,21920,0
161,5059,1057,646,719,113,100,145,1170,18,215,134,248,233,382,1740,3004,10,31186,1732,1,2,6,1,39060,15669,2972,21921,0
72,2108,1523,757,1297,19,12,193,1542,12,193,117,230,205,347,1508,2664,7,19053,1058,0,2,5,1,39070,15671,2972,21922,0
72,2108,701,378,504,33,58,109,734,13,110,68,126,123,194,794,1346,7,10027,557,0,2,5,1,39070,15672,2973,21923,0
223,5005,722,423,573,19,0,135,741,12,172,101,199,184,300,1320,2257,6,15668,870,0,2,0,2,39070,15674,2973,21925,0
223,5005,1508,847,911,44,250,301,1552,14,148,88,169,162,257,1120,1886,7,15077,837,0,2,0,2,39070,15675,2974,21926,0
333,7077,72,33,56,0,4,12,72,1,1,1,1,2,2,0,2,0,1,0,0,2,18,10,39070,15675,2974,21927,0
333,7077,1454,835,1044,76,110,219,1530,17,275,158,296,292,454,2297,3718,9,34017,1889,1,2,18,10,39080,15676,2974,21928,0
40,922,386,256,301,16,9,68,402,4,59,35,69,63,104,355,621,2,1453,80,0,2,6,1,39080,15676,2974,21929,0
40,922,264,131,164,11,41,46,275,6,38,22,40,44,62,214,338,3,1068,59,0,2,6,1,39090,15676,2975,21930,0
184,3741,1943,715,1694,26,18,214,1969,12,185,120,237,197,357,1436,2721,7,20915,1161,0,2,12,0,39090,15678,2975,21931,0
184,3741,1168,838,957,57,25,144,1225,19,348,224,416,367,640,3018,5452,11,61921,3440,1,2,12,0,39100,15680,2975,21932,0
55,1122,1098,241,925,5,10,155,1103,7,46,25,49,53,74,273,423,3,1580,87,0,2,3,0,39110,15682,2975,21933,0
55,1122,282,202,222,14,2,44,296,8,42,24,43,50,67,250,378,4,1548,86,0,2,3,0,39110,15683,2975,21934,0
14,474,42,7,35,4,0,5,46,1,2,1,2,3,3,2,4,0,2,0,0,2,1,0,39110,15683,2975,21935,0
14,474,11,6,10,0,0,1,11,2,4,2,4,6,6,10,15,1,15,0,0,2,1,0,39110,15683,2975,21936,0
137,6580,1392,870,1177,35,17,170,1427,14,494,280,531,508,811,4473,7289,7,54850,3047,2,2,44,0,39110,15686,2976,21937,0
19,446,256,139,192,9,7,47,265,4,23,12,24,27,36,112,171,2,357,19,0,2,30,0,39110,15687,2976,21938,0
93,3451,1450,624,1228,12,26,181,1462,14,306,186,354,320,540,2580,4493,8,36391,2021,1,2,31,0,39110,15689,2977,21939,0
142,3828,1660,832,1314,41,38,274,1701,20,312,209,395,332,604,2671,5058,12,64042,3557,1,2,16,0,39110,15691,2978,21941,0
80,4077,1523,757,1297,19,12,193,1542,12,193,117,230,205,347,1508,2664,7,19053,1058,0,2,24,0,39120,15693,2978,21942,0
34,1559,1293,570,1093,25,15,163,1318,10,195,123,241,205,364,1516,2795,6,17273,959,0,2,21,26,39130,15695,2978,21943,0
72,3658,1943,715,1694,26,18,214,1969,12,185,120,237,197,357,1436,2721,7,20915,1161,0,2,25,0,39130,15697,2978,21944,0
48,1773,1098,241,925,5,10,155,1103,7,46,25,49,53,74,273,423,3,1580,87,0,2,23,0,39140,15699,2978,21945,0
28,545,2,2,2,0,0,0,2,0,0,0,0,0,0,0,0,0,0,0,0,2,4,24,39140,15699,2978,21945,0
28,545,99,48,90,1,3,5,100,0,0,0,0,0,0,0,0,0,0,0,0,2,4,24,39140,15700,2978,21946,0
28,545,8,5,5,2,0,1,10,0,0,0,0,0,0,0,0,0,0,0,0,2,4,24,39140,15700,2978,21947,0
28,545,1217,716,841,84,126,174,1301,14,185,118,215,199,333,1446,2542,8,20687,1149,0,2,4,24,39150,15702,2978,21948,0
28,545,160,89,115,0,13,31,160,7,15,11,17,22,28,78,124,3,495,27,0,2,4,24,39150,15702,2978,21949,0
28,545,10,10,9,9,0,0,19,0,0,0,0,0,0,0,0,0,0,0,0,2,4,24,39150,15702,2979,21950,0
28,545,173,84,99,8,29,36,181,5,12,7,13,17,20,54,81,2,221,12,0,2,4,24,39150,15703,2979,21951,0
28,545,3,1,1,3,0,0,6,0,0,0,0,0,0,0,0,0,0,0,0,2,4,24,39150,15703,2979,21952,0
17,341,95,58,50,9,16,20,104,12,33,24,45,45,69,209,378,8,3100,172,0,0,102,0,39150,15703,2979,21953,0
106,3979,1450,624,1228,12,26,181,1462,14,306,186,354,320,540,2580,4493,8,36391,2021,1,2,106,35,39150,15705,2980,21954,0
162,5072,1660,832,1314,41,38,274,1701,20,312,209,395,332,604,2671,5058,12,64042,3557,1,2,6,1,39150,15707,2981,21956,0
162,5072,1057,646,719,113,100,145,1170,18,215,134,248,233,382,1740,3004,10,31186,1732,1,2,6,1,39160,15708,2982,21957,0
146,3937,1660,832,1314,41,38,274,1701,20,312,209,395,332,604,2671,5058,12,64042,3557,1,2,28,0,39160,15710,2983,21959,0
9,220,19,8,11,5,0,4,24,2,5,3,6,7,9,13,25,1,30,1,0,2,1,0,39160,15710,2983,21960,1
9,220,102,59,69,5,3,24,107,6,22,15,28,28,43,113,206,3,789,43,0,2,1,0,39160,15710,2983,21961,1
9,220,106,40,36,3,49,17,109,8,17,13,23,25,36,93,167,5,904,50,0,2,1,0,39160,15710,2983,21962,1
211,4499,182,127,129,0,0,53,182,5,39,21,42,44,63,217,343,2,926,51,0,2,2,0,39160,15710,2984,21963,1
211,4499,1165,710,800,67,119,181,1232,18,243,153,282,261,435,2000,3492,10,36473,2026,1,2,2,0,39170,15710,2985,21964,1
99,2124,773,419,590,28,0,166,801,10,204,113,217,214,330,1598,2554,5,13587,754,0,2,3,0,39170,15710,2986,21965,1
99,2124,421,273,302,44,34,57,465,17,81,59,107,98,166,583,1098,11,12329,684,0,2,3,0,39170,15710,2987,21966,1
34,625,2,2,2,0,0,0,2,0,0,0,0,0,0,0,0,0,0,0,0,2,2,0,39170,15710,2987,21966,1
34,625,99,48,90,1,3,5,100,0,0,0,0,0,0,0,0,0,0,0,0,2,2,0,39170,15711,2987,21967,1
34,625,8,5,5,2,0,1,10,0,0,0,0,0,0,0,0,0,0,0,0,2,2,0,39170,15711,2987,21968,1
34,625,1217,716,841,84,126,174,1301,14,185,118,215,199,333,1446,2542,8,20687,1149,0,2,2,0,39180,15713,2987,21969,1
34,625,160,89,115,0,13,31,160,7,15,11,17,22,28,78,124,3,495,27,0,2,2,0,39180,15713,2987,21970,1
34,625,10,10,9,9,0,0,19,0,0,0,0,0,0,0,0,0,0,0,0,2,2,0,39180,15713,2988,21971,1
34,625,173,84,99,8,29,36,181,5,12,7,13,17,20,54,81,2,221,12,0,2,2,0,39180,15714,2988,21972,1
34,625,3,1,1,3,0,0,6,0,0,0,0,0,0,0,0,0,0,0,0,2,2,0,39180,15714,2988,21973,1
161,5059,1660,832,1314,41,38,274,1701,20,312,209,395,332,604,2671,5058,12,64042,3557,1,2,1,0,39180,15716,2989,21975,1
161,5059,1057,646,719,113,100,145,1170,18,215,134,248,233,382,1740,3004,10,31186,1732,1,2,1,0,39190,15717,2990,21976,1
119,2397,1513,682,1277,25,13,200,1538,11,199,116,219,210,335,1557,2584,6,15641,868,0,2,1,0,39190,15719,2990,21977,1
119,2397,819,519,539,24,98,155,843,15,96,57,106,111,163,690,1107,8,9171,509,0,2,1,0,39200,15721,2990,21978,1
336,6826,1457,730,1242,11,6,188,1468,10,292,166,329,302,495,2424,4078,5,22973,1276,1,2,6,0,39200,15723,2990,21979,1
336,6826,74,35,59,1,0,14,75,3,14,7,14,17,21,58,85,1,128,7,0,2,6,0,39200,15724,2990,21980,1
336,6826,245,125,200,5,7,34,250,7,30,17,34,37,51,166,265,3,1053,58,0,2,6,0,39210,15725,2990,21981,1
23,680,339,213,244,17,9,65,356,10,42,26,48,52,74,259,421,5,2410,133,0,2,2,0,39220,15725,2990,21982,1
228,5101,4293,999,3693,19,54,507,4312,9,155,88,170,164,258,1156,1898,4,9368,520,0,2,2,0,39220,15727,2990,21983,1
228,5101,1482,859,1002,125,135,219,1607,16,219,134,251,235,385,1766,3032,9,27804,1544,1,2,2,0,39230,15728,2990,21984,1
24,834,74,35,59,1,0,14,75,3,14,7,14,17,21,58,85,1,128,7,0,2,2,0,39230,15729,2990,21985,1
24,834,245,125,200,5,7,34,250,7,30,17,34,37,51,166,265,3,1053,58,0,2,2,0,39240,15730,2990,21986,1
71,2092,1523,757,1297,19,12,193,1542,12,193,117,230,205,347,1508,2664,7,19053,1058,0,2,1,0,39250,15732,2990,21987,1
71,2092,701,378,504,33,58,109,734,13,110,68,126,123,194,794,1346,7,10027,557,0,2,1,0,39250,15733,2991,21988,1
70,1304,1020,354,843,12,15,144,1032,8,134,77,144,142,221,970,1580,4,6792,377,0,2,2,0,39250,15733,2991,21989,1
17,510,184,100,137,2,15,30,186,6,38,20,39,44,59,214,322,3,991,55,0,2,6,0,39250,15734,2991,21990,1
17,510,103,65,74,8,5,16,111,7,17,9,17,24,26,89,119,3,417,23,0,2,6,0,39250,15735,2991,21991,1
222,4970,722,423,573,19,0,135,741,12,172,101,199,184,300,1320,2257,6,15668,870,0,2,8,0,39250,15737,2991,21993,1
222,4970,1508,847,911,44,250,301,1552,14,148,88,169,162,257,1120,1886,7,15077,837,0,2,8,0,39250,15738,2992,21994,1
334,7098,72,33,56,0,4,12,72,1,1,1,1,2,2,0,2,0,1,0,0,2,3,0,39250,15738,2992,21995,1
334,7098,1454,835,1044,76,110,219,1530,17,275,158,296,292,454,2297,3718,9,34017,1889,1,2,3,0,39260,15739,2992,21996,1
128,2805,1043,504,840,53,9,147,1096,9,180,112,198,189,310,1377,2344,4,11604,644,0,2,7,0,39260,15741,2992,21997,1
128,2805,383,288,292,26,6,62,409,11,65,38,67,76,105,429,656,5,3719,206,0,2,7,0,39260,15742,2992,21998,1
103,1969,1178,367,1042,6,15,115,1184,9,94,51,95,103,146,644,976,4,4439,246,0,2,4,0,39260,15742,2992,21999,1
103,1969,177,108,140,8,0,27,185,6,30,16,32,36,48,162,248,3,794,44,0,2,4,0,39260,15744,2992,22000,1
16,468,442,244,305,14,16,103,456,11,68,45,75,79,120,452,756,6,4588,254,0,2,1,0,39260,15746,2992,22001,1
16,468,182,102,99,11,40,35,193,3,11,6,11,14,17,42,64,1,97,5,0,2,1,0,39260,15747,2992,22002,1
55,1122,1098,241,925,5,10,155,1103,7,46,25,49,53,74,273,423,3,1580,87,0,2,2,0,39270,15749,2992,22003,1
55,1122,282,202,222,14,2,44,296,8,42,24,43,50,67,250,378,4,1548,86,0,2,2,0,39270,15750,2992,22004,1
34,980,182,127,129,0,0,53,182,5,39,21,42,44,63,217,343,2,926,51,0,2,5,0,39270,15750,2993,22005,1
137,6580,1392,870,1177,35,17,170,1427,14,494,280,531,508,811,4473,7289,7,54850,3047,2,2,21,2,39270,15753,2994,22006,1
93,4223,1338,495,1086,10,64,173,1348,11,122,82,157,133,239,883,1686,7,11934,663,0,2,6,0,39270,15755,2994,22007,1
147,6715,139,89,101,2,0,35,141,7,54,34,62,61,96,330,569,4,2287,127,0,2,10,0,39270,15755,2994,22008,1
147,6715,7,5,5,0,0,2,7,1,2,1,2,3,3,2,4,0,2,0,0,2,10,0,39270,15755,2994,22009,1
32,933,465,148,393,5,8,60,470,4,31,20,31,35,51,161,261,2,523,29,0,2,10,0,39270,15756,2994,22010,1
32,933,16,12,9,0,0,6,16,1,2,1,2,3,3,2,4,0,2,0,0,2,10,0,39270,15756,2994,22011,1
106,5313,1782,648,1425,9,47,279,1791,8,171,97,189,179,286,1292,2140,4,9462,525,0,2,12,0,39270,15757,2995,22012,1
92,3384,1450,624,1228,12,26,181,1462,14,306,186,354,320,540,2580,4493,8,36391,2021,1,2,3,0,39270,15759,2996,22013,1
142,3828,1660,832,1314,41,38,274,1701,20,312,209,395,332,604,2671,5058,12,64042,3557,1,2,97,0,39270,15761,2997,22015,1
58,3234,1296,573,1062,40,33,157,1336,8,201,118,231,209,349,1561,2689,4,12365,686,0,2,5,0,39270,15761,2997,22016,1
72,3657,1457,730,1242,11,6,188,1468,10,292,166,329,302,495,2424,4078,5,22973,1276,1,2,25,0,39270,15763,2997,22017,1
37,2210,652,304,544,16,6,88,668,6,89,51,101,95,152,591,998,3,3399,188,0,2,2,0,39270,15764,2997,22018,1
66,2745,1020,354,843,12,15,144,1032,8,134,77,144,142,221,970,1580,4,6792,377,0,2,20,1,39270,15764,2997,22019,1
21,647,424,94,331,4,0,89,428,1,5,5,5,6,10,11,25,0,12,0,0,2,4,0,39270,15765,2997,22020,1
40,2349,334,251,279,10,4,40,344,5,127,74,143,132,217,899,1528,2,4303,239,0,2,4,1,39270,15766,2997,22021,1
12,475,184,100,137,2,15,30,186,6,38,20,39,44,59,214,322,3,991,55,0,2,2,0,39270,15767,2997,22022,1
30,1428,1293,570,1093,25,15,163,1318,10,195,123,241,205,364,1516,2795,6,17273,959,0,2,2,0,39280,15769,2997,22023,1
35,1824,384,251,317,7,8,52,391,11,70,44,84,81,128,467,811,6,5355,297,0,2,4,0,39280,15769,2997,22024,1
14,581,722,423,573,19,0,135,741,12,172,101,199,184,300,1320,2257,6,15668,870,0,2,4,0,39280,15771,2997,22026,1
69,2837,1043,504,840,53,9,147,1096,9,180,112,198,189,310,1377,2344,4,11604,644,0,2,10,0,39280,15773,2997,22027,1
137,6580,1392,870,1177,35,17,170,1427,14,494,280,531,508,811,4473,7289,7,54850,3047,2,2,1,1,39280,15776,2998,22028,0
16,476,2,2,2,0,0,0,2,0,0,0,0,0,0,0,0,0,0,0,0,0,83,0,39290,15780,2999,22038,0
16,476,99,48,90,1,3,5,100,0,0,0,0,0,0,0,0,0,0,0,0,0,83,0,39290,15781,2999,22039,0
16,476,8,5,5,2,0,1,10,0,0,0,0,0,0,0,0,0,0,0,0,0,83,0,39290,15781,2999,22040,0
16,476,1217,716,841,84,126,174,1301,14,185,118,215,199,333,1446,2542,8,20687,1149,0,0,83,0,39300,15783,2999,22041,0
16,476,160,89,115,0,13,31,160,7,15,11,17,22,28,78,124,3,495,27,0,0,83,0,39300,15783,2999,22042,0
16,476,10,10,9,9,0,0,19,0,0,0,0,0,0,0,0,0,0,0,0,0,83,0,39300,15783,3000,22043,0
16,476,173,84,99,8,29,36,181,5,12,7,13,17,20,54,81,2,221,12,0,0,83,0,39300,15784,3000,22044,0
16,476,3,1,1,3,0,0,6,0,0,0,0,0,0,0,0,0,0,0,0,0,83,0,39300,15784,3000,22045,0
9,360,601,196,481,2,23,85,603,8,63,36,72,71,108,400,664,4,3036,168,0,0,95,0,39300,15784,3000,22048,0
336,6826,1457,730,1242,11,6,188,1468,10,292,166,329,302,495,2424,4078,5,22973,1276,1,2,1,1,39300,15786,3000,22054,1
336,6826,74,35,59,1,0,14,75,3,14,7,14,17,21,58,85,1,128,7,0,2,1,1,39300,15787,3000,22055,1
336,6826,245,125,200,5,7,34,250,7,30,17,34,37,51,166,265,3,1053,58,0,2,1,1,39310,15788,3000,22056,1
8,213,601,196,481,2,23,85,603,8,63,36,72,71,108,400,664,4,3036,168,0,0,60,0,39310,15788,3000,22057,1
336,6826,1457,730,1242,11,6,188,1468,10,292,166,329,302,495,2424,4078,5,22973,1276,1,2,1,1,39310,15790,3000,22058,0
336,6826,74,35,59,1,0,14,75,3,14,7,14,17,21,58,85,1,128,7,0,2,1,1,39310,15791,3000,22059,0
336,6826,245,125,200,5,7,34,250,7,30,17,34,37,51,166,265,3,1053,58,0,2,1,1,39320,15792,3000,22060,0
336,6826,1457,730,1242,11,6,188,1468,10,292,166,329,302,495,2424,4078,5,22973,1276,1,2,1,1,39320,15794,3000,22061,0
336,6826,74,35,59,1,0,14,75,3,14,7,14,17,21,58,85,1,128,7,0,2,1,1,39320,15795,3000,22062,0
336,6826,245,125,200,5,7,34,250,7,30,17,34,37,51,166,265,3,1053,58,0,2,1,1,39330,15796,3000,22063,0
9,220,19,8,11,5,0,4,24,2,5,3,6,7,9,13,25,1,30,1,0,2,1,0,39330,15796,3000,22064,0
9,220,102,59,69,5,3,24,107,6,22,15,28,28,43,113,206,3,789,43,0,2,1,0,39330,15796,3000,22065,0
9,220,106,40,36,3,49,17,109,8,17,13,23,25,36,93,167,5,904,50,0,2,1,0,39330,15796,3000,22066,0
211,4499,182,127,129,0,0,53,182,5,39,21,42,44,63,217,343,2,926,51,0,2,2,0,39330,15796,3001,22067,0
211,4499,1165,710,800,67,119,181,1232,18,243,153,282,261,435,2000,3492,10,36473,2026,1,2,2,0,39340,15796,3002,22068,0
99,2124,773,419,590,28,0,166,801,10,204,113,217,214,330,1598,2554,5,13587,754,0,2,3,0,39340,15796,3003,22069,0
99,2124,421,273,302,44,34,57,465,17,81,59,107,98,166,583,1098,11,12329,684,0,2,3,0,39340,15796,3004,22070,0
34,625,2,2,2,0,0,0,2,0,0,0,0,0,0,0,0,0,0,0,0,2,2,0,39340,15796,3004,22070,0
34,625,99,48,90,1,3,5,100,0,0,0,0,0,0,0,0,0,0,0,0,2,2,0,39340,15797,3004,22071,0
34,625,8,5,5,2,0,1,10,0,0,0,0,0,0,0,0,0,0,0,0,2,2,0,39340,15797,3004,22072,0
34,625,1217,716,841,84,126,174,1301,14,185,118,215,199,333,1446,2542,8,20687,1149,0,2,2,0,39350,15799,3004,22073,0
34,625,160,89,115,0,13,31,160,7,15,11,17,22,28,78,124,3,495,27,0,2,2,0,39350,15799,3004,22074,0
34,625,10,10,9,9,0,0,19,0,0,0,0,0,0,0,0,0,0,0,0,2,2,0,39350,15799,3005,22075,0
34,625,173,84,99,8,29,36,181,5,12,7,13,17,20,54,81,2,221,12,0,2,2,0,39350,15800,3005,22076,0
34,625,3,1,1,3,0,0,6,0,0,0,0,0,0,0,0,0,0,0,0,2,2,0,39350,15800,3005,22077,0
161,5059,1660,832,1314,41,38,274,1701,20,312,209,395,332,604,2671,5058,12,64042,3557,1,2,1,0,39350,15802,3006,22079,0
161,5059,1057,646,719,113,100,145,1170,18,215,134,248,233,382,1740,3004,10,31186,1732,1,2,1,0,39360,15803,3007,22080,0
119,2397,1513,682,1277,25,13,200,1538,11,199,116,219,210,335,1557,2584,6,15641,868,0,2,1,0,39360,15805,3007,22081,0
119,2397,819,519,539,24,98,155,843,15,96,57,106,111,163,690,1107,8,9171,509,0,2,1,0,39370,15807,3007,22082,0
336,6826,1457,730,1242,11,6,188,1468,10,292,166,329,302,495,2424,4078,5,22973,1276,1,2,6,0,39370,15809,3007,22083,0
336,6826,74,35,59,1,0,14,75,3,14,7,14,17,21,58,85,1,128,7,0,2,6,0,39370,15810,3007,22084,0
336,6826,245,125,200,5,7,34,250,7,30,17,34,37,51,166,265,3,1053,58,0,2,6,0,39380,15811,3007,22085,0
23,680,339,213,244,17,9,65,356,10,42,26,48,52,74,259,421,5,2410,133,0,2,2,0,39390,15811,3007,22086,0
228,5101,4293,999,3693,19,54,507,4312,9,155,88,170,164,258,1156,1898,4,9368,520,0,2,2,0,39390,15813,3007,22087,0
228,5101,1482,859,1002,125,135,219,1607,16,219,134,251,235,385,1766,3032,9,27804,1544,1,2,2,0,39400,15814,3007,22088,0
24,834,74,35,59,1,0,14,75,3,14,7,14,17,21,58,85,1,128,7,0,2,2,0,39400,15815,3007,22089,0
24,834,245,125,200,5,7,34,250,7,30,17,34,37,51,166,265,3,1053,58,0,2,2,0,39410,15816,3007,22090,0
71,2092,1523,757,1297,19,12,193,1542,12,193,117,230,205,347,1508,2664,7,19053,1058,0,2,1,0,39420,15818,3007,22091,0
71,2092,701,378,504,33,58,109,734,13,110,68,126,123,194,794,1346,7,10027,557,0,2,1,0,39420,15819,3008,22092,0
70,1304,1020,354,843,12,15,144,1032,8,134,77,144,142,221,970,1580,4,6792,377,0,2,2,0,39420,15819,3008,22093,0
17,510,184,100,137,2,15,30,186,6,38,20,39,44,59,214,322,3,991,55,0,2,6,0,39420,15820,3008,22094,0
17,510,103,65,74,8,5,16,111,7,17,9,17,24,26,89,119,3,417,23,0,2,6,0,39420,15821,3008,22095,0
222,4970,722,423,573,19,0,135,741,12,172,101,199,184,300,1320,2257,6,15668,870,0,2,8,0,39420,15823,3008,22097,0
222,4970,1508,847,911,44,250,301,1552,14,148,88,169,162,257,1120,1886,7,15077,837,0,2,8,0,39420,15824,3009,22098,0
334,7098,72,33,56,0,4,12,72,1,1,1,1,2,2,0,2,0,1,0,0,2,3,0,39420,15824,3009,22099,0
334,7098,1454,835,1044,76,110,219,1530,17,275,158,296,292,454,2297,3718,9,34017,1889,1,2,3,0,39430,15825,3009,22100,0
128,2805,1043,504,840,53,9,147,1096,9,180,112,198,189,310,1377,2344,4,11604,644,0,2,7,0,39430,15827,3009,22101,0
128,2805,383,288,292,26,6,62,409,11,65,38,67,76,105,429,656,5,3719,206,0,2,7,0,39430,15828,3009,22102,0
103,1969,1178,367,1042,6,15,115,1184,9,94,51,95,103,146,644,976,4,4439,246,0,2,4,0,39430,15828,3009,22103,0
103,1969,177,108,140,8,0,27,185,6,30,16,32,36,48,162,248,3,794,44,0,2,4,0,39430,15830,3009,22104,0
16,468,442,244,305,14,16,103,456,11,68,45,75,79,120,452,756,6,4588,254,0,2,1,0,39430,15832,3009,22105,0
16,468,182,102,99,11,40,35,193,3,11,6,11,14,17,42,64,1,97,5,0,2,1,0,39430,15833,3009,22106,0
55,1122,1098,241,925,5,10,155,1103,7,46,25,49,53,74,273,423,3,1580,87,0,2,2,0,39440,15835,3009,22107,0
55,1122,282,202,222,14,2,44,296,8,42,24,43,50,67,250,378,4,1548,86,0,2,2,0,39440,15836,3009,22108,0
34,980,182,127,129,0,0,53,182,5,39,21,42,44,63,217,343,2,926,51,0,2,5,0,39440,15836,3010,22109,0
137,6580,1392,870,1177,35,17,170,1427,14,494,280,531,508,811,4473,7289,7,54850,3047,2,2,22,3,39440,15839,3011,22110,0
93,4223,1338,495,1086,10,64,173,1348,11,122,82,157,133,239,883,1686,7,11934,663,0,2,6,0,39440,15841,3011,22111,0
147,6715,139,89,101,2,0,35,141,7,54,34,62,61,96,330,569,4,2287,127,0,2,10,0,39440,15841,3011,22112,0
147,6715,7,5,5,0,0,2,7,1,2,1,2,3,3,2,4,0,2,0,0,2,10,0,39440,15841,3011,22113,0
32,933,465,148,393,5,8,60,470,4,31,20,31,35,51,161,261,2,523,29,0,2,10,0,39440,15842,3011,22114,0
32,933,16,12,9,0,0,6,16,1,2,1,2,3,3,2,4,0,2,0,0,2,10,0,39440,15842,3011,22115,0
106,5313,1782,648,1425,9,47,279,1791,8,171,97,189,179,286,1292,2140,4,9462,525,0,2,12,0,39440,15843,3012,22116,0
92,3384,1450,624,1228,12,26,181,1462,14,306,186,354,320,540,2580,4493,8,36391,2021,1,2,3,0,39440,15845,3013,22117,0
142,3828,1660,832,1314,41,38,274,1701,20,312,209,395,332,604,2671,5058,12,64042,3557,1,2,97,0,39440,15847,3014,22119,0
58,3234,1296,573,1062,40,33,157,1336,8,201,118,231,209,349,1561,2689,4,12365,686,0,2,5,0,39440,15847,3014,22120,0
72,3657,1457,730,1242,11,6,188,1468,10,292,166,329,302,495,2424,4078,5,22973,1276,1,2,25,0,39440,15849,3014,22121,0
37,2210,652,304,544,16,6,88,668,6,89,51,101,95,152,591,998,3,3399,188,0,2,2,0,39440,15850,3014,22122,0
66,2745,1020,354,843,12,15,144,1032,8,134,77,144,142,221,970,1580,4,6792,377,0,2,20,1,39440,15850,3014,22123,0
21,647,424,94,331,4,0,89,428,1,5,5,5,6,10,11,25,0,12,0,0,2,4,0,39440,15851,3014,22124,0
40,2349,334,251,279,10,4,40,344,5,127,74,143,132,217,899,1528,2,4303,239,0,2,4,1,39440,15852,3014,22125,0
12,475,184,100,137,2,15,30,186,6,38,20,39,44,59,214,322,3,991,55,0,2,2,0,39440,15853,3014,22126,0
30,1428,1293,570,1093,25,15,163,1318,10,195,123,241,205,364,1516,2795,6,17273,959,0,2,2,0,39450,15855,3014,22127,0
35,1824,384,251,317,7,8,52,391,11,70,44,84,81,128,467,811,6,5355,297,0,2,4,0,39450,15855,3014,22128,0
14,581,722,423,573,19,0,135,741,12,172,101,199,184,300,1320,2257,6,15668,870,0,2,4,0,39450,15857,3014,22130,0
69,2837,1043,504,840,53,9,147,1096,9,180,112,198,189,310,1377,2344,4,11604,644,0,2,10,0,39450,15859,3014,22131,0
9,220,19,8,11,5,0,4,24,2,5,3,6,7,9,13,25,1,30,1,0,2,1,0,39450,15859,3014,22132,0
9,220,102,59,69,5,3,24,107,6,22,15,28,28,43,113,206,3,789,43,0,2,1,0,39450,15859,3014,22133,0
9,220,106,40,36,3,49,17,109,8,17,13,23,25,36,93,167,5,904,50,0,2,1,0,39450,15859,3014,22134,0
211,4499,182,127,129,0,0,53,182,5,39,21,42,44,63,217,343,2,926,51,0,2,2,0,39450,15859,3015,22135,0
211,4499,1165,710,800,67,119,181,1232,18,243,153,282,261,435,2000,3492,10,36473,2026,1,2,2,0,39460,15859,3016,22136,0
99,2124,773,419,590,28,0,166,801,10,204,113,217,214,330,1598,2554,5,13587,754,0,2,3,0,39460,15859,3017,22137,0
99,2124,421,273,302,44,34,57,465,17,81,59,107,98,166,583,1098,11,12329,684,0,2,3,0,39460,15859,3018,22138,0
28,545,2,2,2,0,0,0,2,0,0,0,0,0,0,0,0,0,0,0,0,2,2,0,39460,15859,3018,22138,0
28,545,99,48,90,1,3,5,100,0,0,0,0,0,0,0,0,0,0,0,0,2,2,0,39460,15860,3018,22139,0
28,545,8,5,5,2,0,1,10,0,0,0,0,0,0,0,0,0,0,0,0,2,2,0,39460,15860,3018,22140,0
28,545,1217,716,841,84,126,174,1301,14,185,118,215,199,333,1446,2542,8,20687,1149,0,2,2,0,39470,15862,3018,22141,0
28,545,160,89,115,0,13,31,160,7,15,11,17,22,28,78,124,3,495,27,0,2,2,0,39470,15862,3018,22142,0
28,545,10,10,9,9,0,0,19,0,0,0,0,0,0,0,0,0,0,0,0,2,2,0,39470,15862,3019,22143,0
28,545,173,84,99,8,29,36,181,5,12,7,13,17,20,54,81,2,221,12,0,2,2,0,39470,15863,3019,22144,0
28,545,3,1,1,3,0,0,6,0,0,0,0,0,0,0,0,0,0,0,0,2,2,0,39470,15863,3019,22145,0
161,5059,1660,832,1314,41,38,274,1701,20,312,209,395,332,604,2671,5058,12,64042,3557,1,2,1,0,39470,15865,3020,22147,0
161,5059,1057,646,719,113,100,145,1170,18,215,134,248,233,382,1740,3004,10,31186,1732,1,2,1,0,39480,15866,3021,22148,0
119,2402,1513,682,1277,25,13,200,1538,11,199,116,219,210,335,1557,2584,6,15641,868,0,2,1,0,39480,15868,3021,22149,0
119,2402,819,519,539,24,98,155,843,15,96,57,106,111,163,690,1107,8,9171,509,0,2,1,0,39490,15870,3021,22150,0
336,6826,1457,730,1242,11,6,188,1468,10,292,166,329,302,495,2424,4078,5,22973,1276,1,2,7,1,39490,15872,3021,22151,0
336,6826,74,35,59,1,0,14,75,3,14,7,14,17,21,58,85,1,128,7,0,2,7,1,39490,15873,3021,22152,0
336,6826,245,125,200,5,7,34,250,7,30,17,34,37,51,166,265,3,1053,58,0,2,7,1,39500,15874,3021,22153,0
22,673,339,213,244,17,9,65,356,10,42,26,48,52,74,259,421,5,2410,133,0,2,2,0,39510,15874,3021,22154,0
228,5101,4293,999,3693,19,54,507,4312,9,155,88,170,164,258,1156,1898,4,9368,520,0,2,2,0,39510,15876,3021,22155,0
228,5101,1482,859,1002,125,135,219,1607,16,219,134,251,235,385,1766,3032,9,27804,1544,1,2,2,0,39520,15877,3021,22156,0
24,834,74,35,59,1,0,14,75,3,14,7,14,17,21,58,85,1,128,7,0,2,2,0,39520,15878,3021,22157,0
24,834,245,125,200,5,7,34,250,7,30,17,34,37,51,166,265,3,1053,58,0,2,2,0,39530,15879,3021,22158,0
72,2108,1523,757,1297,19,12,193,1542,12,193,117,230,205,347,1508,2664,7,19053,1058,0,2,1,0,39540,15881,3021,22159,0
72,2108,701,378,504,33,58,109,734,13,110,68,126,123,194,794,1346,7,10027,557,0,2,1,0,39540,15882,3022,22160,0
69,1347,1020,354,843,12,15,144,1032,8,134,77,144,142,221,970,1580,4,6792,377,0,2,2,0,39540,15882,3022,22161,0
17,510,184,100,137,2,15,30,186,6,38,20,39,44,59,214,322,3,991,55,0,2,6,0,39540,15883,3022,22162,0
17,510,103,65,74,8,5,16,111,7,17,9,17,24,26,89,119,3,417,23,0,2,6,0,39540,15884,3022,22163,0
223,5005,722,423,573,19,0,135,741,12,172,101,199,184,300,1320,2257,6,15668,870,0,2,8,0,39540,15886,3022,22165,0
223,5005,1508,847,911,44,250,301,1552,14,148,88,169,162,257,1120,1886,7,15077,837,0,2,8,0,39540,15887,3023,22166,0
333,7077,72,33,56,0,4,12,72,1,1,1,1,2,2,0,2,0,1,0,0,2,3,0,39540,15887,3023,22167,0
333,7077,1454,835,1044,76,110,219,1530,17,275,158,296,292,454,2297,3718,9,34017,1889,1,2,3,0,39550,15888,3023,22168,0
128,2812,1043,504,840,53,9,147,1096,9,180,112,198,189,310,1377,2344,4,11604,644,0,2,7,0,39550,15890,3023,22169,0
128,2812,383,288,292,26,6,62,409,11,65,38,67,76,105,429,656,5,3719,206,0,2,7,0,39550,15891,3023,22170,0
103,1956,1178,367,1042,6,15,115,1184,9,94,51,95,103,146,644,976,4,4439,246,0,2,4,0,39550,15891,3023,22171,0
103,1956,177,108,140,8,0,27,185,6,30,16,32,36,48,162,248,3,794,44,0,2,4,0,39550,15893,3023,22172,0
16,468,442,244,305,14,16,103,456,11,68,45,75,79,120,452,756,6,4588,254,0,2,1,0,39550,15895,3023,22173,0
16,468,182,102,99,11,40,35,193,3,11,6,11,14,17,42,64,1,97,5,0,2,1,0,39550,15896,3023,22174,0
55,1122,1098,241,925,5,10,155,1103,7,46,25,49,53,74,273,423,3,1580,87,0,2,2,0,39560,15898,3023,22175,0
55,1122,282,202,222,14,2,44,296,8,42,24,43,50,67,250,378,4,1548,86,0,2,2,0,39560,15899,3023,22176,0
34,980,182,127,129,0,0,53,182,5,39,21,42,44,63,217,343,2,926,51,0,2,5,0,39560,15899,3024,22177,0
137,6580,1392,870,1177,35,17,170,1427,14,494,280,531,508,811,4473,7289,7,54850,3047,2,2,22,3,39560,15902,3025,22178,0
93,4223,1338,495,1086,10,64,173,1348,11,122,82,157,133,239,883,1686,7,11934,663,0,2,6,0,39560,15904,3025,22179,0
147,6715,139,89,101,2,0,35,141,7,54,34,62,61,96,330,569,4,2287,127,0,2,10,0,39560,15904,3025,22180,0
147,6715,7,5,5,0,0,2,7,1,2,1,2,3,3,2,4,0,2,0,0,2,10,0,39560,15904,3025,22181,0
32,933,465,148,393,5,8,60,470,4,31,20,31,35,51,161,261,2,523,29,0,2,10,0,39560,15905,3025,22182,0
32,933,16,12,9,0,0,6,16,1,2,1,2,3,3,2,4,0,2,0,0,2,10,0,39560,15905,3025,22183,0
106,5313,1782,648,1425,9,47,279,1791,8,171,97,189,179,286,1292,2140,4,9462,525,0,2,12,0,39560,15906,3026,22184,0
106,3979,1450,624,1228,12,26,181,1462,14,306,186,354,320,540,2580,4493,8,36391,2021,1,2,3,0,39560,15908,3027,22185,0
142,3828,1660,832,1314,41,38,274,1701,20,312,209,395,332,604,2671,5058,12,64042,3557,1,2,97,0,39560,15910,3028,22187,0
58,3234,1296,573,1062,40,33,157,1336,8,201,118,231,209,349,1561,2689,4,12365,686,0,2,5,0,39560,15910,3028,22188,0
72,3657,1457,730,1242,11,6,188,1468,10,292,166,329,302,495,2424,4078,5,22973,1276,1,2,25,0,39560,15912,3028,22189,0
37,2210,652,304,544,16,6,88,668,6,89,51,101,95,152,591,998,3,3399,188,0,2,2,0,39560,15913,3028,22190,0
66,2750,1020,354,843,12,15,144,1032,8,134,77,144,142,221,970,1580,4,6792,377,0,2,20,1,39560,15913,3028,22191,0
21,647,424,94,331,4,0,89,428,1,5,5,5,6,10,11,25,0,12,0,0,2,4,0,39560,15914,3028,22192,0
40,2349,334,251,279,10,4,40,344,5,127,74,143,132,217,899,1528,2,4303,239,0,2,4,1,39560,15915,3028,22193,0
12,475,184,100,137,2,15,30,186,6,38,20,39,44,59,214,322,3,991,55,0,2,2,0,39560,15916,3028,22194,0
34,1559,1293,570,1093,25,15,163,1318,10,195,123,241,205,364,1516,2795,6,17273,959,0,2,2,0,39570,15918,3028,22195,0
35,1824,384,251,317,7,8,52,391,11,70,44,84,81,128,467,811,6,5355,297,0,2,4,0,39570,15918,3028,22196,0
14,581,722,423,573,19,0,135,741,12,172,101,199,184,300,1320,2257,6,15668,870,0,2,4,0,39570,15920,3028,22198,0
69,2837,1043,504,840,53,9,147,1096,9,180,112,198,189,310,1377,2344,4,11604,644,0,2,10,0,39570,15922,3028,22199,0
9,220,19,8,11,5,0,4,24,2,5,3,6,7,9,13,25,1,30,1,0,2,1,0,39570,15922,3028,22200,0
9,220,102,59,69,5,3,24,107,6,22,15,28,28,43,113,206,3,789,43,0,2,1,0,39570,15922,3028,22201,0
9,220,106,40,36,3,49,17,109,8,17,13,23,25,36,93,167,5,904,50,0,2,1,0,39570,15922,3028,22202,0
211,4499,182,127,129,0,0,53,182,5,39,21,42,44,63,217,343,2,926,51,0,2,2,0,39570,15922,3029,22203,0
211,4499,1165,710,800,67,119,181,1232,18,243,153,282,261,435,2000,3492,10,36473,2026,1,2,2,0,39580,15922,3030,22204,0
99,2124,773,419,590,28,0,166,801,10,204,113,217,214,330,1598,2554,5,13587,754,0,2,3,0,39580,15922,3031,22205,0
99,2124,421,273,302,44,34,57,465,17,81,59,107,98,166,583,1098,11,12329,684,0,2,3,0,39580,15922,3032,22206,0
28,545,2,2,2,0,0,0,2,0,0,0,0,0,0,0,0,0,0,0,0,2,2,0,39580,15922,3032,22206,0
28,545,99,48,90,1,3,5,100,0,0,0,0,0,0,0,0,0,0,0,0,2,2,0,39580,15923,3032,22207,0
28,545,8,5,5,2,0,1,10,0,0,0,0,0,0,0,0,0,0,0,0,2,2,0,39580,15923,3032,22208,0
28,545,1217,716,841,84,126,174,1301,14,185,118,215,199,333,1446,2542,8,20687,1149,0,2,2,0,39590,15925,3032,22209,0
28,545,160,89,115,0,13,31,160,7,15,11,17,22,28,78,124,3,495,27,0,2,2,0,39590,15925,3032,22210,0
28,545,10,10,9,9,0,0,19,0,0,0,0,0,0,0,0,0,0,0,0,2,2,0,39590,15925,3033,22211,0
28,545,173,84,99,8,29,36,181,5,12,7,13,17,20,54,81,2,221,12,0,2,2,0,39590,15926,3033,22212,0
28,545,3,1,1,3,0,0,6,0,0,0,0,0,0,0,0,0,0,0,0,2,2,0,39590,15926,3033,22213,0
161,5059,1660,832,1314,41,38,274,1701,20,312,209,395,332,604,2671,5058,12,64042,3557,1,2,1,0,39590,15928,3034,22215,0
161,5059,1057,646,719,113,100,145,1170,18,215,134,248,233,382,1740,3004,10,31186,1732,1,2,1,0,39600,15929,3035,22216,0
119,2402,1513,682,1277,25,13,200,1538,11,199,116,219,210,335,1557,2584,6,15641,868,0,2,1,0,39600,15931,3035,22217,0
119,2402,819,519,539,24,98,155,843,15,96,57,106,111,163,690,1107,8,9171,509,0,2,1,0,39610,15933,3035,22218,0
336,6826,1457,730,1242,11,6,188,1468,10,292,166,329,302,495,2424,4078,5,22973,1276,1,2,7,1,39610,15935,3035,22219,0
336,6826,74,35,59,1,0,14,75,3,14,7,14,17,21,58,85,1,128,7,0,2,7,1,39610,15936,3035,22220,0
336,6826,245,125,200,5,7,34,250,7,30,17,34,37,51,166,265,3,1053,58,0,2,7,1,39620,15937,3035,22221,0
22,673,339,213,244,17,9,65,356,10,42,26,48,52,74,259,421,5,2410,133,0,2,2,0,39630,15937,3035,22222,0
228,5101,4293,999,3693,19,54,507,4312,9,155,88,170,164,258,1156,1898,4,9368,520,0,2,2,0,39630,15939,3035,22223,0
228,5101,1482,859,1002,125,135,219,1607,16,219,134,251,235,385,1766,3032,9,27804,1544,1,2,2,0,39640,15940,3035,22224,0
24,834,74,35,59,1,0,14,75,3,14,7,14,17,21,58,85,1,128,7,0,2,2,0,39640,15941,3035,22225,0
24,834,245,125,200,5,7,34,250,7,30,17,34,37,51,166,265,3,1053,58,0,2,2,0,39650,15942,3035,22226,0
72,2108,1523,757,1297,19,12,193,1542,12,193,117,230,205,347,1508,2664,7,19053,1058,0,2,1,0,39660,15944,3035,22227,0
72,2108,701,378,504,33,58,109,734,13,110,68,126,123,194,794,1346,7,10027,557,0,2,1,0,39660,15945,3036,22228,0
69,1347,1020,354,843,12,15,144,1032,8,134,77,144,142,221,970,1580,4,6792,377,0,2,2,0,39660,15945,3036,22229,0
17,510,184,100,137,2,15,30,186,6,38,20,39,44,59,214,322,3,991,55,0,2,6,0,39660,15946,3036,22230,0
17,510,103,65,74,8,5,16,111,7,17,9,17,24,26,89,119,3,417,23,0,2,6,0,39660,15947,3036,22231,0
223,5005,722,423,573,19,0,135,741,12,172,101,199,184,300,1320,2257,6,15668,870,0,2,8,0,39660,15949,3036,22233,0
223,5005,1508,847,911,44,250,301,1552,14,148,88,169,162,257,1120,1886,7,15077,837,0,2,8,0,39660,15950,3037,22234,0
333,7077,72,33,56,0,4,12,72,1,1,1,1,2,2,0,2,0,1,0,0,2,3,0,39660,15950,3037,22235,0
333,7077,1454,835,1044,76,110,219,1530,17,275,158,296,292,454,2297,3718,9,34017,1889,1,2,3,0,39670,15951,3037,22236,0
128,2812,1043,504,840,53,9,147,1096,9,180,112,198,189,310,1377,2344,4,11604,644,0,2,7,0,39670,15953,3037,22237,0
128,2812,383,288,292,26,6,62,409,11,65,38,67,76,105,429,656,5,3719,206,0,2,7,0,39670,15954,3037,22238,0
103,1956,1178,367,1042,6,15,115,1184,9,94,51,95,103,146,644,976,4,4439,246,0,2,4,0,39670,15954,3037,22239,0
103,1956,177,108,140,8,0,27,185,6,30,16,32,36,48,162,248,3,794,44,0,2,4,0,39670,15956,3037,22240,0
16,468,442,244,305,14,16,103,456,11,68,45,75,79,120,452,756,6,4588,254,0,2,1,0,39670,15958,3037,22241,0
16,468,182,102,99,11,40,35,193,3,11,6,11,14,17,42,64,1,97,5,0,2,1,0,39670,15959,3037,22242,0
55,1122,1098,241,925,5,10,155,1103,7,46,25,49,53,74,273,423,3,1580,87,0,2,2,0,39680,15961,3037,22243,0
55,1122,282,202,222,14,2,44,296,8,42,24,43,50,67,250,378,4,1548,86,0,2,2,0,39680,15962,3037,22244,0
34,980,182,127,129,0,0,53,182,5,39,21,42,44,63,217,343,2,926,51,0,2,5,0,39680,15962,3038,22245,0
137,6580,1392,870,1177,35,17,170,1427,14,494,280,531,508,811,4473,7289,7,54850,3047,2,2,22,3,39680,15965,3039,22246,0
93,4223,1338,495,1086,10,64,173,1348,11,122,82,157,133,239,883,1686,7,11934,663,0,2,6,0,39680,15967,3039,22247,0
147,6715,139,89,101,2,0,35,141,7,54,34,62,61,96,330,569,4,2287,127,0,2,10,0,39680,15967,3039,22248,0
147,6715,7,5,5,0,0,2,7,1,2,1,2,3,3,2,4,0,2,0,0,2,10,0,39680,15967,3039,22249,0
32,933,465,148,393,5,8,60,470,4,31,20,31,35,51,161,261,2,523,29,0,2,10,0,39680,15968,3039,22250,0
32,933,16,12,9,0,0,6,16,1,2,1,2,3,3,2,4,0,2,0,0,2,10,0,39680,15968,3039,22251,0
106,5313,1782,648,1425,9,47,279,1791,8,171,97,189,179,286,1292,2140,4,9462,525,0,2,12,0,39680,15969,3040,22252,0
106,3979,1450,624,1228,12,26,181,1462,14,306,186,354,320,540,2580,4493,8,36391,2021,1,2,3,0,39680,15971,3041,22253,0
142,3828,1660,832,1314,41,38,274,1701,20,312,209,395,332,604,2671,5058,12,64042,3557,1,2,97,0,39680,15973,3042,22255,0
58,3234,1296,573,1062,40,33,157,1336,8,201,118,231,209,349,1561,2689,4,12365,686,0,2,5,0,39680,15973,3042,22256,0
72,3657,1457,730,1242,11,6,188,1468,10,292,166,329,302,495,2424,4078,5,22973,1276,1,2,25,0,39680,15975,3042,22257,0
37,2210,652,304,544,16,6,88,668,6,89,51,101,95,152,591,998,3,3399,188,0,2,2,0,39680,15976,3042,22258,0
66,2750,1020,354,843,12,15,144,1032,8,134,77,144,142,221,970,1580,4,6792,377,0,2,20,1,39680,15976,3042,22259,0
21,647,424,94,331,4,0,89,428,1,5,5,5,6,10,11,25,0,12,0,0,2,4,0,39680,15977,3042,22260,0
40,2349,334,251,279,10,4,40,344,5,127,74,143,132,217,899,1528,2,4303,239,0,2,4,1,39680,15978,3042,22261,0
12,475,184,100,137,2,15,30,186,6,38,20,39,44,59,214,322,3,991,55,0,2,2,0,39680,15979,3042,22262,0
34,1559,1293,570,1093,25,15,163,1318,10,195,123,241,205,364,1516,2795,6,17273,959,0,2,2,0,39690,15981,3042,22263,0
35,1824,384,251,317,7,8,52,391,11,70,44,84,81,128,467,811,6,5355,297,0,2,4,0,39690,15981,3042,22264,0
14,581,722,423,573,19,0,135,741,12,172,101,199,184,300,1320,2257,6,15668,870,0,2,4,0,39690,15983,3042,22266,0
69,2837,1043,504,840,53,9,147,1096,9,180,112,198,189,310,1377,2344,4,11604,644,0,2,10,0,39690,15985,3042,22267,0
162,5072,1660,832,1314,41,38,274,1701,20,312,209,395,332,604,2671,5058,12,64042,3557,1,2,6,1,39690,15987,3043,22269,0
162,5072,1057,646,719,113,100,145,1170,18,215,134,248,233,382,1740,3004,10,31186,1732,1,2,6,1,39700,15988,3044,22270,0
146,3937,1660,832,1314,41,38,274,1701,20,312,209,395,332,604,2671,5058,12,64042,3557,1,2,28,0,39700,15990,3045,22272,0
338,6856,1457,730,1242,11,6,188,1468,10,292,166,329,302,495,2424,4078,5,22973,1276,1,2,5,1,39700,15992,3045,22273,1
338,6856,74,35,59,1,0,14,75,3,14,7,14,17,21,58,85,1,128,7,0,2,5,1,39700,15993,3045,22274,1
338,6856,245,125,200,5,7,34,250,7,30,17,34,37,51,166,265,3,1053,58,0,2,5,1,39710,15994,3045,22275,1
73,3766,1457,730,1242,11,6,188,1468,10,292,166,329,302,495,2424,4078,5,22973,1276,1,2,9,0,39710,15996,3045,22276,1
338,6856,1457,730,1242,11,6,188,1468,10,292,166,329,302,495,2424,4078,5,22973,1276,1,2,5,1,39710,15998,3045,22277,0
338,6856,74,35,59,1,0,14,75,3,14,7,14,17,21,58,85,1,128,7,0,2,5,1,39710,15999,3045,22278,0
338,6856,245,125,200,5,7,34,250,7,30,17,34,37,51,166,265,3,1053,58,0,2,5,1,39720,16000,3045,22279,0
73,3766,1457,730,1242,11,6,188,1468,10,292,166,329,302,495,2424,4078,5,22973,1276,1,2,9,0,39720,16002,3045,22280,0
335,7115,72,33,56,0,4,12,72,1,1,1,1,2,2,0,2,0,1,0,0,2,3,0,39720,16002,3045,22281,1
335,7115,1454,835,1044,76,110,219,1530,17,275,158,296,292,454,2297,3718,9,34017,1889,1,2,3,0,39730,16003,3045,22282,1
43,2321,520,294,400,33,13,81,553,10,261,204,367,271,571,2128,4614,7,32445,1802,1,2,1,0,39730,16004,3045,22283,1
335,7115,72,33,56,0,4,12,72,1,1,1,1,2,2,0,2,0,1,0,0,2,3,0,39730,16004,3045,22284,0
335,7115,1454,835,1044,76,110,219,1530,17,275,158,296,292,454,2297,3718,9,34017,1889,1,2,3,0,39740,16005,3045,22285,0
43,2321,520,294,400,33,13,81,553,10,261,204,367,271,571,2128,4614,7,32445,1802,1,2,1,0,39740,16006,3045,22286,0
179,4156,77,34,69,0,0,8,77,3,24,16,29,27,45,114,213,1,387,21,0,2,2,3,39740,16006,3045,22287,1
179,4156,712,438,573,51,9,84,763,14,102,71,128,116,199,733,1364,8,11988,666,0,2,2,3,39750,16007,3045,22288,1
179,4156,77,34,69,0,0,8,77,3,24,16,29,27,45,114,213,1,387,21,0,2,2,3,39750,16007,3045,22289,0
179,4156,712,438,573,51,9,84,763,14,102,71,128,116,199,733,1364,8,11988,666,0,2,2,3,39760,16008,3045,22290,0
80,3999,1523,757,1297,19,12,193,1542,12,193,117,230,205,347,1508,2664,7,19053,1058,0,2,12,0,39770,16010,3045,22291,0
80,3999,1523,757,1297,19,12,193,1542,12,193,117,230,205,347,1508,2664,7,19053,1058,0,2,12,0,39780,16012,3045,22292,0
179,4170,77,34,69,0,0,8,77,3,24,16,29,27,45,114,213,1,387,21,0,2,3,1,39780,16012,3045,22293,1
179,4170,712,438,573,51,9,84,763,14,102,71,128,116,199,733,1364,8,11988,666,0,2,3,1,39790,16013,3045,22294,1
179,4175,77,34,69,0,0,8,77,3,24,16,29,27,45,114,213,1,387,21,0,2,1,1,39790,16013,3045,22295,1
179,4175,712,438,573,51,9,84,763,14,102,71,128,116,199,733,1364,8,11988,666,0,2,1,1,39800,16014,3045,22296,1
179,4175,77,34,69,0,0,8,77,3,24,16,29,27,45,114,213,1,387,21,0,2,3,1,39800,16014,3045,22297,0
179,4175,712,438,573,51,9,84,763,14,102,71,128,116,199,733,1364,8,11988,666,0,2,3,1,39810,16015,3045,22298,0
162,5072,1660,832,1314,41,38,274,1701,20,312,209,395,332,604,2671,5058,12,64042,3557,1,2,6,1,39810,16017,3046,22300,0
162,5072,1057,646,719,113,100,145,1170,18,215,134,248,233,382,1740,3004,10,31186,1732,1,2,6,1,39820,16018,3047,22301,0
338,6856,1457,730,1242,11,6,188,1468,10,292,166,329,302,495,2424,4078,5,22973,1276,1,2,5,1,39820,16020,3047,22302,0
338,6856,74,35,59,1,0,14,75,3,14,7,14,17,21,58,85,1,128,7,0,2,5,1,39820,16021,3047,22303,0
338,6856,245,125,200,5,7,34,250,7,30,17,34,37,51,166,265,3,1053,58,0,2,5,1,39830,16022,3047,22304,0
178,4154,77,34,69,0,0,8,77,3,24,16,29,27,45,114,213,1,387,21,0,2,5,4,39830,16022,3047,22305,0
178,4154,712,438,573,51,9,84,763,14,102,71,128,116,199,733,1364,8,11988,666,0,2,5,4,39840,16023,3047,22306,0
334,7094,72,33,56,0,4,12,72,1,1,1,1,2,2,0,2,0,1,0,0,2,3,0,39840,16023,3047,22307,0
334,7094,1454,835,1044,76,110,219,1530,17,275,158,296,292,454,2297,3718,9,34017,1889,1,2,3,0,39850,16024,3047,22308,0
43,2321,520,294,400,33,13,81,553,10,261,204,367,271,571,2128,4614,7,32445,1802,1,2,1,0,39850,16025,3047,22309,0
146,3937,1660,832,1314,41,38,274,1701,20,312,209,395,332,604,2671,5058,12,64042,3557,1,2,28,0,39850,16027,3048,22311,0
73,3766,1457,730,1242,11,6,188,1468,10,292,166,329,302,495,2424,4078,5,22973,1276,1,2,9,0,39850,16029,3048,22312,0
81,4122,1523,757,1297,19,12,193,1542,12,193,117,230,205,347,1508,2664,7,19053,1058,0,2,12,0,39860,16031,3048,22313,0
162,5072,1660,832,1314,41,38,274,1701,20,312,209,395,332,604,2671,5058,12,64042,3557,1,2,6,1,39860,16033,3049,22315,0
162,5072,1057,646,719,113,100,145,1170,18,215,134,248,233,382,1740,3004,10,31186,1732,1,2,6,1,39870,16034,3050,22316,0
338,6856,1457,730,1242,11,6,188,1468,10,292,166,329,302,495,2424,4078,5,22973,1276,1,2,5,1,39870,16036,3050,22317,0
338,6856,74,35,59,1,0,14,75,3,14,7,14,17,21,58,85,1,128,7,0,2,5,1,39870,16037,3050,22318,0
338,6856,245,125,200,5,7,34,250,7,30,17,34,37,51,166,265,3,1053,58,0,2,5,1,39880,16038,3050,22319,0
178,4154,77,34,69,0,0,8,77,3,24,16,29,27,45,114,213,1,387,21,0,2,5,4,39880,16038,3050,22320,0
178,4154,712,438,573,51,9,84,763,14,102,71,128,116,199,733,1364,8,11988,666,0,2,5,4,39890,16039,3050,22321,0
334,7094,72,33,56,0,4,12,72,1,1,1,1,2,2,0,2,0,1,0,0,2,3,0,39890,16039,3050,22322,0
334,7094,1454,835,1044,76,110,219,1530,17,275,158,296,292,454,2297,3718,9,34017,1889,1,2,3,0,39900,16040,3050,22323,0
43,2321,520,294,400,33,13,81,553,10,261,204,367,271,571,2128,4614,7,32445,1802,1,2,1,0,39900,16041,3050,22324,0
146,3937,1660,832,1314,41,38,274,1701,20,312,209,395,332,604,2671,5058,12,64042,3557,1,2,28,0,39900,16043,3051,22326,0
73,3766,1457,730,1242,11,6,188,1468,10,292,166,329,302,495,2424,4078,5,22973,1276,1,2,9,0,39900,16045,3051,22327,0
81,4122,1523,757,1297,19,12,193,1542,12,193,117,230,205,347,1508,2664,7,19053,1058,0,2,12,0,39910,16047,3051,22328,0
340,6900,1457,730,1242,11,6,188,1468,10,292,166,329,302,495,2424,4078,5,22973,1276,1,2,23,4,39910,16049,3051,22329,1
340,6900,74,35,59,1,0,14,75,3,14,7,14,17,21,58,85,1,128,7,0,2,23,4,39910,16050,3051,22330,1
340,6900,245,125,200,5,7,34,250,7,30,17,34,37,51,166,265,3,1053,58,0,2,23,4,39920,16051,3051,22331,1
71,2113,1523,757,1297,19,12,193,1542,12,193,117,230,205,347,1508,2664,7,19053,1058,0,2,3,0,39930,16053,3051,22332,1
71,2113,701,378,504,33,58,109,734,13,110,68,126,123,194,794,1346,7,10027,557,0,2,3,0,39930,16054,3052,22333,1
179,4196,77,34,69,0,0,8,77,3,24,16,29,27,45,114,213,1,387,21,0,2,3,1,39930,16054,3052,22334,1
179,4196,712,438,573,51,9,84,763,14,102,71,128,116,199,733,1364,8,11988,666,0,2,3,1,39940,16055,3052,22335,1
81,4024,1523,757,1297,19,12,193,1542,12,193,117,230,205,347,1508,2664,7,19053,1058,0,2,4,0,39950,16057,3052,22336,1
20,400,294,64,250,0,0,43,294,1,20,10,20,21,30,86,131,0,65,3,0,2,2,2,39950,16057,3052,22337,0
20,400,78,46,62,3,0,14,81,3,8,4,8,11,12,28,41,1,62,3,0,2,2,2,39950,16058,3052,22338,0
340,6900,1457,730,1242,11,6,188,1468,10,292,166,329,302,495,2424,4078,5,22973,1276,1,2,23,4,39950,16060,3052,22339,0
340,6900,74,35,59,1,0,14,75,3,14,7,14,17,21,58,85,1,128,7,0,2,23,4,39950,16061,3052,22340,0
340,6900,245,125,200,5,7,34,250,7,30,17,34,37,51,166,265,3,1053,58,0,2,23,4,39960,16062,3052,22341,0
71,2113,1523,757,1297,19,12,193,1542,12,193,117,230,205,347,1508,2664,7,19053,1058,0,2,3,0,39970,16064,3052,22342,0
71,2113,701,378,504,33,58,109,734,13,110,68,126,123,194,794,1346,7,10027,557,0,2,3,0,39970,16065,3053,22343,0
179,4196,77,34,69,0,0,8,77,3,24,16,29,27,45,114,213,1,387,21,0,2,3,1,39970,16065,3053,22344,0
179,4196,712,438,573,51,9,84,763,14,102,71,128,116,199,733,1364,8,11988,666,0,2,3,1,39980,16066,3053,22345,0
81,4024,1523,757,1297,19,12,193,1542,12,193,117,230,205,347,1508,2664,7,19053,1058,0,2,4,0,39990,16068,3053,22346,0
20,400,294,64,250,0,0,43,294,1,20,10,20,21,30,86,131,0,65,3,0,2,2,2,39990,16068,3053,22347,0
20,400,78,46,62,3,0,14,81,3,8,4,8,11,12,28,41,1,62,3,0,2,2,2,39990,16069,3053,22348,0
56,1608,1455,414,1257,16,76,112,1471,5,41,23,46,46,69,231,381,2,1069,59,0,2,5,1,39990,16070,3053,22349,0
56,1608,669,365,481,22,61,110,691,15,103,63,122,118,185,747,1273,8,11311,628,0,2,5,1,40000,16070,3054,22350,0
223,5009,722,423,573,19,0,135,741,12,172,101,199,184,300,1320,2257,6,15668,870,0,2,2,2,40000,16072,3054,22352,1
223,5009,1508,847,911,44,250,301,1552,14,148,88,169,162,257,1120,1886,7,15077,837,0,2,2,2,40000,16073,3055,22353,1
64,2862,1455,414,1257,16,76,112,1471,5,41,23,46,46,69,231,381,2,1069,59,0,2,46,0,40000,16074,3055,22354,1
64,2864,1455,414,1257,16,76,112,1471,5,41,23,46,46,69,231,381,2,1069,59,0,2,6,6,40000,16075,3055,22355,0
56,1599,1455,414,1257,16,76,112,1471,5,41,23,46,46,69,231,381,2,1069,59,0,2,3,6,40000,16076,3055,22356,1
56,1599,669,365,481,22,61,110,691,15,103,63,122,118,185,747,1273,8,11311,628,0,2,3,6,40010,16076,3056,22357,1
62,2825,1455,414,1257,16,76,112,1471,5,41,23,46,46,69,231,381,2,1069,59,0,2,19,38,40010,16077,3056,22358,1
62,2825,1455,414,1257,16,76,112,1471,5,41,23,46,46,69,231,381,2,1069,59,0,2,2,2,40010,16078,3056,22359,0
44,844,207,111,150,11,0,50,218,5,26,19,36,31,55,133,272,3,943,52,0,2,1,1,40010,16078,3056,22360,0
44,844,410,198,237,31,55,97,441,11,63,38,72,74,110,414,683,6,4293,238,0,2,1,1,40020,16079,3057,22361,0
335,7110,72,33,56,0,4,12,72,1,1,1,1,2,2,0,2,0,1,0,0,2,2,0,40020,16079,3057,22362,0
335,7110,1454,835,1044,76,110,219,1530,17,275,158,296,292,454,2297,3718,9,34017,1889,1,2,2,0,40030,16080,3057,22363,0
59,3269,1296,573,1062,40,33,157,1336,8,201,118,231,209,349,1561,2689,4,12365,686,0,2,16,0,40030,16080,3057,22364,0
44,844,207,111,150,11,0,50,218,5,26,19,36,31,55,133,272,3,943,52,0,2,1,1,40030,16080,3057,22365,0
44,844,410,198,237,31,55,97,441,11,63,38,72,74,110,414,683,6,4293,238,0,2,1,1,40040,16081,3058,22366,0
335,7110,72,33,56,0,4,12,72,1,1,1,1,2,2,0,2,0,1,0,0,2,2,0,40040,16081,3058,22367,0
335,7110,1454,835,1044,76,110,219,1530,17,275,158,296,292,454,2297,3718,9,34017,1889,1,2,2,0,40050,16082,3058,22368,0
59,3269,1296,573,1062,40,33,157,1336,8,201,118,231,209,349,1561,2689,4,12365,686,0,2,16,0,40050,16082,3058,22369,0
56,1599,1455,414,1257,16,76,112,1471,5,41,23,46,46,69,231,381,2,1069,59,0,2,3,2,40050,16083,3058,22370,0
56,1599,669,365,481,22,61,110,691,15,103,63,122,118,185,747,1273,8,11311,628,0,2,3,2,40060,16083,3059,22371,0
223,5009,722,423,573,19,0,135,741,12,172,101,199,184,300,1320,2257,6,15668,870,0,2,2,2,40060,16085,3059,22373,0
223,5009,1508,847,911,44,250,301,1552,14,148,88,169,162,257,1120,1886,7,15077,837,0,2,2,2,40060,16086,3060,22374,0
62,2825,1455,414,1257,16,76,112,1471,5,41,23,46,46,69,231,381,2,1069,59,0,2,27,0,40060,16087,3060,22375,0
99,2079,773,419,590,28,0,166,801,10,204,113,217,214,330,1598,2554,5,13587,754,0,2,0,8,40060,16087,3061,22376,0
99,2079,421,273,302,44,34,57,465,17,81,59,107,98,166,583,1098,11,12329,684,0,2,0,8,40060,16087,3062,22377,0
99,2075,773,419,590,28,0,166,801,10,204,113,217,214,330,1598,2554,5,13587,754,0,2,0,1,40060,16087,3063,22378,0
99,2075,421,273,302,44,34,57,465,17,81,59,107,98,166,583,1098,11,12329,684,0,2,0,1,40060,16087,3064,22379,0
99,2075,773,419,590,28,0,166,801,10,204,113,217,214,330,1598,2554,5,13587,754,0,2,0,9,40060,16087,3065,22380,0
99,2075,421,273,302,44,34,57,465,17,81,59,107,98,166,583,1098,11,12329,684,0,2,0,9,40060,16087,3066,22381,0
341,6910,1457,730,1242,11,6,188,1468,10,292,166,329,302,495,2424,4078,5,22973,1276,1,2,4,1,40060,16089,3066,22382,1
341,6910,74,35,59,1,0,14,75,3,14,7,14,17,21,58,85,1,128,7,0,2,4,1,40060,16090,3066,22383,1
341,6910,245,125,200,5,7,34,250,7,30,17,34,37,51,166,265,3,1053,58,0,2,4,1,40070,16091,3066,22384,1
24,834,74,35,59,1,0,14,75,3,14,7,14,17,21,58,85,1,128,7,0,2,1,1,40070,16092,3066,22385,1
24,834,245,125,200,5,7,34,250,7,30,17,34,37,51,166,265,3,1053,58,0,2,1,1,40080,16093,3066,22386,1
74,3802,1457,730,1242,11,6,188,1468,10,292,166,329,302,495,2424,4078,5,22973,1276,1,2,9,1,40080,16095,3066,22387,1
341,6910,1457,730,1242,11,6,188,1468,10,292,166,329,302,495,2424,4078,5,22973,1276,1,2,4,1,40080,16097,3066,22388,0
341,6910,74,35,59,1,0,14,75,3,14,7,14,17,21,58,85,1,128,7,0,2,4,1,40080,16098,3066,22389,0
341,6910,245,125,200,5,7,34,250,7,30,17,34,37,51,166,265,3,1053,58,0,2,4,1,40090,16099,3066,22390,0
24,834,74,35,59,1,0,14,75,3,14,7,14,17,21,58,85,1,128,7,0,2,1,1,40090,16100,3066,22391,0
24,834,245,125,200,5,7,34,250,7,30,17,34,37,51,166,265,3,1053,58,0,2,1,1,40100,16101,3066,22392,0
74,3802,1457,730,1242,11,6,188,1468,10,292,166,329,302,495,2424,4078,5,22973,1276,1,2,9,1,40100,16103,3066,22393,0
162,5067,1660,832,1314,41,38,274,1701,20,312,209,395,332,604,2671,5058,12,64042,3557,1,2,4,5,40100,16105,3067,22395,1
162,5067,1057,646,719,113,100,145,1170,18,215,134,248,233,382,1740,3004,10,31186,1732,1,2,4,5,40110,16106,3068,22396,1
147,4008,1660,832,1314,41,38,274,1701,20,312,209,395,332,604,2671,5058,12,64042,3557,1,2,13,0,40110,16108,3069,22398,1
162,5067,1660,832,1314,41,38,274,1701,20,312,209,395,332,604,2671,5058,12,64042,3557,1,2,4,5,40110,16110,3070,22400,0
162,5067,1057,646,719,113,100,145,1170,18,215,134,248,233,382,1740,3004,10,31186,1732,1,2,4,5,40120,16111,3071,22401,0
147,4008,1660,832,1314,41,38,274,1701,20,312,209,395,332,604,2671,5058,12,64042,3557,1,2,13,0,40120,16113,3072,22403,0
178,4170,77,34,69,0,0,8,77,3,24,16,29,27,45,114,213,1,387,21,0,2,12,18,40120,16113,3072,22404,0
178,4170,712,438,573,51,9,84,763,14,102,71,128,116,199,733,1364,8,11988,666,0,2,12,18,40130,16114,3072,22405,0
222,4979,722,423,573,19,0,135,741,12,172,101,199,184,300,1320,2257,6,15668,870,0,2,1,0,40130,16116,3072,22407,0
222,4979,1508,847,911,44,250,301,1552,14,148,88,169,162,257,1120,1886,7,15077,837,0,2,1,0,40130,16117,3073,22408,0
38,2269,652,304,544,16,6,88,668,6,89,51,101,95,152,591,998,3,3399,188,0,2,25,0,40130,16118,3073,22409,0
36,1940,384,251,317,7,8,52,391,11,70,44,84,81,128,467,811,6,5355,297,0,2,21,1,40130,16118,3073,22410,0
178,4170,77,34,69,0,0,8,77,3,24,16,29,27,45,114,213,1,387,21,0,2,12,18,40130,16118,3073,22411,0
178,4170,712,438,573,51,9,84,763,14,102,71,128,116,199,733,1364,8,11988,666,0,2,12,18,40140,16119,3073,22412,0
222,4979,722,423,573,19,0,135,741,12,172,101,199,184,300,1320,2257,6,15668,870,0,2,1,0,40140,16121,3073,22414,0
222,4979,1508,847,911,44,250,301,1552,14,148,88,169,162,257,1120,1886,7,15077,837,0,2,1,0,40140,16122,3074,22415,0
38,2269,652,304,544,16,6,88,668,6,89,51,101,95,152,591,998,3,3399,188,0,2,25,0,40140,16123,3074,22416,0
36,1940,384,251,317,7,8,52,391,11,70,44,84,81,128,467,811,6,5355,297,0,2,21,1,40140,16123,3074,22417,0
34,625,2,2,2,0,0,0,2,0,0,0,0,0,0,0,0,0,0,0,0,2,1,1,40140,16123,3074,22417,0
34,625,99,48,90,1,3,5,100,0,0,0,0,0,0,0,0,0,0,0,0,2,1,1,40140,16124,3074,22418,0
34,625,8,5,5,2,0,1,10,0,0,0,0,0,0,0,0,0,0,0,0,2,1,1,40140,16124,3074,22419,0
34,625,1217,716,841,84,126,174,1301,14,185,118,215,199,333,1446,2542,8,20687,1149,0,2,1,1,40150,16126,3074,22420,0
34,625,160,89,115,0,13,31,160,7,15,11,17,22,28,78,124,3,495,27,0,2,1,1,40150,16126,3074,22421,0
34,625,10,10,9,9,0,0,19,0,0,0,0,0,0,0,0,0,0,0,0,2,1,1,40150,16126,3075,22422,0
34,625,173,84,99,8,29,36,181,5,12,7,13,17,20,54,81,2,221,12,0,2,1,1,40150,16127,3075,22423,0
34,625,3,1,1,3,0,0,6,0,0,0,0,0,0,0,0,0,0,0,0,2,1,1,40150,16127,3075,22424,0
335,7116,72,33,56,0,4,12,72,1,1,1,1,2,2,0,2,0,1,0,0,2,2,8,40150,16127,3075,22425,1
335,7116,1454,835,1044,76,110,219,1530,17,275,158,296,292,454,2297,3718,9,34017,1889,1,2,2,8,40160,16128,3075,22426,1
47,2495,520,294,400,33,13,81,553,10,261,204,367,271,571,2128,4614,7,32445,1802,1,2,33,8,40160,16129,3075,22427,1
335,7116,72,33,56,0,4,12,72,1,1,1,1,2,2,0,2,0,1,0,0,2,2,8,40160,16129,3075,22428,0
335,7116,1454,835,1044,76,110,219,1530,17,275,158,296,292,454,2297,3718,9,34017,1889,1,2,2,8,40170,16130,3075,22429,0
47,2495,520,294,400,33,13,81,553,10,261,204,367,271,571,2128,4614,7,32445,1802,1,2,33,8,40170,16131,3075,22430,0
179,4222,77,34,69,0,0,8,77,3,24,16,29,27,45,114,213,1,387,21,0,2,30,17,40200,16143,3078,22452,1
179,4222,712,438,573,51,9,84,763,14,102,71,128,116,199,733,1364,8,11988,666,0,2,30,17,40210,16144,3078,22453,1
228,5105,4293,999,3693,19,54,507,4312,9,155,88,170,164,258,1156,1898,4,9368,520,0,2,4,4,40210,16146,3078,22454,1
228,5105,1482,859,1002,125,135,219,1607,16,219,134,251,235,385,1766,3032,9,27804,1544,1,2,4,4,40220,16147,3078,22455,1
149,6801,139,89,101,2,0,35,141,7,54,34,62,61,96,330,569,4,2287,127,0,2,45,0,40220,16147,3078,22456,1
149,6801,7,5,5,0,0,2,7,1,2,1,2,3,3,2,4,0,2,0,0,2,45,0,40220,16147,3078,22457,1
45,853,207,111,150,11,0,50,218,5,26,19,36,31,55,133,272,3,943,52,0,2,10,5,40220,16147,3078,22458,1
45,853,410,198,237,31,55,97,441,11,63,38,72,74,110,414,683,6,4293,238,0,2,10,5,40230,16148,3079,22459,1
3,34,207,111,150,11,0,50,218,5,26,19,36,31,55,133,272,3,943,52,0,0,12,0,40240,16149,3079,22472,1
5,123,207,111,150,11,0,50,218,5,26,19,36,31,55,133,272,3,943,52,0,2,37,0,40250,16150,3079,22485,1
47,867,207,111,150,11,0,50,218,5,26,19,36,31,55,133,272,3,943,52,0,2,11,8,40250,16150,3079,22486,1
47,867,410,198,237,31,55,97,441,11,63,38,72,74,110,414,683,6,4293,238,0,2,11,8,40260,16151,3080,22487,1
5,138,207,111,150,11,0,50,218,5,26,19,36,31,55,133,272,3,943,52,0,2,3,2,40260,16151,3080,22488,1
14,476,42,7,35,4,0,5,46,1,2,1,2,3,3,2,4,0,2,0,0,2,1,1,40260,16151,3080,22489,1
14,476,11,6,10,0,0,1,11,2,4,2,4,6,6,10,15,1,15,0,0,2,1,1,40260,16151,3080,22490,1
228,5110,4293,999,3693,19,54,507,4312,9,155,88,170,164,258,1156,1898,4,9368,520,0,2,3,1,40260,16153,3080,22491,1
228,5110,1482,859,1002,125,135,219,1607,16,219,134,251,235,385,1766,3032,9,27804,1544,1,2,3,1,40270,16154,3080,22492,1
42,969,386,256,301,16,9,68,402,4,59,35,69,63,104,355,621,2,1453,80,0,2,4,1,40270,16154,3080,22493,1
42,969,264,131,164,11,41,46,275,6,38,22,40,44,62,214,338,3,1068,59,0,2,4,1,40280,16154,3081,22494,1
30,1334,386,256,301,16,9,68,402,4,59,35,69,63,104,355,621,2,1453,80,0,2,28,5,40280,16154,3081,22495,1
42,969,386,256,301,16,9,68,402,4,59,35,69,63,104,355,621,2,1453,80,0,2,4,1,40280,16154,3081,22496,0
42,969,264,131,164,11,41,46,275,6,38,22,40,44,62,214,338,3,1068,59,0,2,4,1,40290,16154,3082,22497,0
30,1334,386,256,301,16,9,68,402,4,59,35,69,63,104,355,621,2,1453,80,0,2,28,5,40290,16154,3082,22498,0
344,6953,1457,730,1242,11,6,188,1468,10,292,166,329,302,495,2424,4078,5,22973,1276,1,2,31,16,40290,16156,3082,22499,0
344,6953,74,35,59,1,0,14,75,3,14,7,14,17,21,58,85,1,128,7,0,2,31,16,40290,16157,3082,22500,0
344,6953,245,125,200,5,7,34,250,7,30,17,34,37,51,166,265,3,1053,58,0,2,31,16,40300,16158,3082,22501,0
75,3862,1457,730,1242,11,6,188,1468,10,292,166,329,302,495,2424,4078,5,22973,1276,1,2,23,0,40300,16160,3082,22502,0
61,2763,1455,414,1257,16,76,112,1471,5,41,23,46,46,69,231,381,2,1069,59,0,2,7,3,40300,16161,3082,22503,0
344,6953,1457,730,1242,11,6,188,1468,10,292,166,329,302,495,2424,4078,5,22973,1276,1,2,31,16,40300,16163,3082,22504,0
344,6953,74,35,59,1,0,14,75,3,14,7,14,17,21,58,85,1,128,7,0,2,31,16,40300,16164,3082,22505,0
344,6953,245,125,200,5,7,34,250,7,30,17,34,37,51,166,265,3,1053,58,0,2,31,16,40310,16165,3082,22506,0
75,3862,1457,730,1242,11,6,188,1468,10,292,166,329,302,495,2424,4078,5,22973,1276,1,2,23,0,40310,16167,3082,22507,0
44,859,207,111,150,11,0,50,218,5,26,19,36,31,55,133,272,3,943,52,0,2,3,0,40310,16167,3082,22508,0
44,859,410,198,237,31,55,97,441,11,63,38,72,74,110,414,683,6,4293,238,0,2,3,0,40320,16168,3083,22509,0
61,2747,1455,414,1257,16,76,112,1471,5,41,23,46,46,69,231,381,2,1069,59,0,2,1,3,40320,16169,3083,22510,0
14,476,42,7,35,4,0,5,46,1,2,1,2,3,3,2,4,0,2,0,0,2,1,1,40320,16169,3083,22511,0
14,476,11,6,10,0,0,1,11,2,4,2,4,6,6,10,15,1,15,0,0,2,1,1,40320,16169,3083,22512,0
47,867,207,111,150,11,0,50,218,5,26,19,36,31,55,133,272,3,943,52,0,2,13,5,40320,16169,3083,22513,0
47,867,410,198,237,31,55,97,441,11,63,38,72,74,110,414,683,6,4293,238,0,2,13,5,40330,16170,3084,22514,0
5,138,207,111,150,11,0,50,218,5,26,19,36,31,55,133,272,3,943,52,0,0,50,0,40330,16170,3084,22515,0
47,889,207,111,150,11,0,50,218,5,26,19,36,31,55,133,272,3,943,52,0,2,3,0,40330,16170,3084,22516,0
47,889,410,198,237,31,55,97,441,11,63,38,72,74,110,414,683,6,4293,238,0,2,3,0,40340,16171,3085,22517,0
61,2747,1455,414,1257,16,76,112,1471,5,41,23,46,46,69,231,381,2,1069,59,0,2,5,3,40340,16172,3085,22518,0
99,2075,773,419,590,28,0,166,801,10,204,113,217,214,330,1598,2554,5,13587,754,0,2,0,9,40340,16172,3086,22519,0
99,2075,421,273,302,44,34,57,465,17,81,59,107,98,166,583,1098,11,12329,684,0,2,0,9,40340,16172,3087,22520,0
28,545,2,2,2,0,0,0,2,0,0,0,0,0,0,0,0,0,0,0,0,2,1,1,40340,16172,3087,22520,0
28,545,99,48,90,1,3,5,100,0,0,0,0,0,0,0,0,0,0,0,0,2,1,1,40340,16173,3087,22521,0
28,545,8,5,5,2,0,1,10,0,0,0,0,0,0,0,0,0,0,0,0,2,1,1,40340,16173,3087,22522,0
28,545,1217,716,841,84,126,174,1301,14,185,118,215,199,333,1446,2542,8,20687,1149,0,2,1,1,40350,16175,3087,22523,0
28,545,160,89,115,0,13,31,160,7,15,11,17,22,28,78,124,3,495,27,0,2,1,1,40350,16175,3087,22524,0
28,545,10,10,9,9,0,0,19,0,0,0,0,0,0,0,0,0,0,0,0,2,1,1,40350,16175,3088,22525,0
28,545,173,84,99,8,29,36,181,5,12,7,13,17,20,54,81,2,221,12,0,2,1,1,40350,16176,3088,22526,0
28,545,3,1,1,3,0,0,6,0,0,0,0,0,0,0,0,0,0,0,0,2,1,1,40350,16176,3088,22527,0
162,5067,1660,832,1314,41,38,274,1701,20,312,209,395,332,604,2671,5058,12,64042,3557,1,2,4,5,40350,16178,3089,22529,0
162,5067,1057,646,719,113,100,145,1170,18,215,134,248,233,382,1740,3004,10,31186,1732,1,2,4,5,40360,16179,3090,22530,0
47,896,207,111,150,11,0,50,218,5,26,19,36,31,55,133,272,3,943,52,0,2,16,5,40360,16179,3090,22531,0
47,896,410,198,237,31,55,97,441,11,63,38,72,74,110,414,683,6,4293,238,0,2,16,5,40370,16180,3091,22532,0
344,6953,1457,730,1242,11,6,188,1468,10,292,166,329,302,495,2424,4078,5,22973,1276,1,2,58,21,40370,16182,3091,22533,0
344,6953,74,35,59,1,0,14,75,3,14,7,14,17,21,58,85,1,128,7,0,2,58,21,40370,16183,3091,22534,0
344,6953,245,125,200,5,7,34,250,7,30,17,34,37,51,166,265,3,1053,58,0,2,58,21,40380,16184,3091,22535,0
24,834,74,35,59,1,0,14,75,3,14,7,14,17,21,58,85,1,128,7,0,2,1,1,40380,16185,3091,22536,0
24,834,245,125,200,5,7,34,250,7,30,17,34,37,51,166,265,3,1053,58,0,2,1,1,40390,16186,3091,22537,0
72,2129,1523,757,1297,19,12,193,1542,12,193,117,230,205,347,1508,2664,7,19053,1058,0,2,3,0,40400,16188,3091,22538,0
72,2129,701,378,504,33,58,109,734,13,110,68,126,123,194,794,1346,7,10027,557,0,2,3,0,40400,16189,3092,22539,0
177,4149,77,34,69,0,0,8,77,3,24,16,29,27,45,114,213,1,387,21,0,2,15,19,40400,16189,3092,22540,0
177,4149,712,438,573,51,9,84,763,14,102,71,128,116,199,733,1364,8,11988,666,0,2,15,19,40410,16190,3092,22541,0
223,5018,722,423,573,19,0,135,741,12,172,101,199,184,300,1320,2257,6,15668,870,0,2,1,0,40410,16192,3092,22543,0
223,5018,1508,847,911,44,250,301,1552,14,148,88,169,162,257,1120,1886,7,15077,837,0,2,1,0,40410,16193,3093,22544,0
335,7111,72,33,56,0,4,12,72,1,1,1,1,2,2,0,2,0,1,0,0,2,2,8,40410,16193,3093,22545,0
335,7111,1454,835,1044,76,110,219,1530,17,275,158,296,292,454,2297,3718,9,34017,1889,1,2,2,8,40420,16194,3093,22546,0
41,940,386,256,301,16,9,68,402,4,59,35,69,63,104,355,621,2,1453,80,0,2,4,1,40420,16194,3093,22547,0
41,940,264,131,164,11,41,46,275,6,38,22,40,44,62,214,338,3,1068,59,0,2,4,1,40430,16194,3094,22548,0
20,400,294,64,250,0,0,43,294,1,20,10,20,21,30,86,131,0,65,3,0,2,2,2,40430,16194,3094,22549,0
20,400,78,46,62,3,0,14,81,3,8,4,8,11,12,28,41,1,62,3,0,2,2,2,40430,16195,3094,22550,0
14,476,42,7,35,4,0,5,46,1,2,1,2,3,3,2,4,0,2,0,0,2,1,1,40430,16195,3094,22551,0
14,476,11,6,10,0,0,1,11,2,4,2,4,6,6,10,15,1,15,0,0,2,1,1,40430,16195,3094,22552,0
47,2495,520,294,400,33,13,81,553,10,261,204,367,271,571,2128,4614,7,32445,1802,1,2,33,8,40430,16196,3094,22553,0
147,4008,1660,832,1314,41,38,274,1701,20,312,209,395,332,604,2671,5058,12,64042,3557,1,2,13,0,40430,16198,3095,22555,0
5,138,207,111,150,11,0,50,218,5,26,19,36,31,55,133,272,3,943,52,0,0,50,0,40430,16198,3095,22556,0
75,3862,1457,730,1242,11,6,188,1468,10,292,166,329,302,495,2424,4078,5,22973,1276,1,2,32,1,40430,16200,3095,22557,0
38,2269,652,304,544,16,6,88,668,6,89,51,101,95,152,591,998,3,3399,188,0,2,25,0,40430,16201,3095,22558,0
62,2852,1455,414,1257,16,76,112,1471,5,41,23,46,46,69,231,381,2,1069,59,0,2,5,3,40430,16202,3095,22559,0
82,4147,1523,757,1297,19,12,193,1542,12,193,117,230,205,347,1508,2664,7,19053,1058,0,2,4,0,40440,16204,3095,22560,0
36,1940,384,251,317,7,8,52,391,11,70,44,84,81,128,467,811,6,5355,297,0,2,21,1,40440,16204,3095,22561,0
30,1362,386,256,301,16,9,68,402,4,59,35,69,63,104,355,621,2,1453,80,0,2,28,5,40440,16204,3095,22562,0
99,2075,773,419,590,28,0,166,801,10,204,113,217,214,330,1598,2554,5,13587,754,0,2,0,9,40440,16204,3096,22563,0
99,2075,421,273,302,44,34,57,465,17,81,59,107,98,166,583,1098,11,12329,684,0,2,0,9,40440,16204,3097,22564,0
28,545,2,2,2,0,0,0,2,0,0,0,0,0,0,0,0,0,0,0,0,2,1,1,40440,16204,3097,22564,0
28,545,99,48,90,1,3,5,100,0,0,0,0,0,0,0,0,0,0,0,0,2,1,1,40440,16205,3097,22565,0
28,545,8,5,5,2,0,1,10,0,0,0,0,0,0,0,0,0,0,0,0,2,1,1,40440,16205,3097,22566,0
28,545,1217,716,841,84,126,174,1301,14,185,118,215,199,333,1446,2542,8,20687,1149,0,2,1,1,40450,16207,3097,22567,0
28,545,160,89,115,0,13,31,160,7,15,11,17,22,28,78,124,3,495,27,0,2,1,1,40450,16207,3097,22568,0
28,545,10,10,9,9,0,0,19,0,0,0,0,0,0,0,0,0,0,0,0,2,1,1,40450,16207,3098,22569,0
28,545,173,84,99,8,29,36,181,5,12,7,13,17,20,54,81,2,221,12,0,2,1,1,40450,16208,3098,22570,0
28,545,3,1,1,3,0,0,6,0,0,0,0,0,0,0,0,0,0,0,0,2,1,1,40450,16208,3098,22571,0
162,5067,1660,832,1314,41,38,274,1701,20,312,209,395,332,604,2671,5058,12,64042,3557,1,2,4,5,40450,16210,3099,22573,0
162,5067,1057,646,719,113,100,145,1170,18,215,134,248,233,382,1740,3004,10,31186,1732,1,2,4,5,40460,16211,3100,22574,0
47,896,207,111,150,11,0,50,218,5,26,19,36,31,55,133,272,3,943,52,0,2,16,5,40460,16211,3100,22575,0
47,896,410,198,237,31,55,97,441,11,63,38,72,74,110,414,683,6,4293,238,0,2,16,5,40470,16212,3101,22576,0
344,6953,1457,730,1242,11,6,188,1468,10,292,166,329,302,495,2424,4078,5,22973,1276,1,2,58,21,40470,16214,3101,22577,0
344,6953,74,35,59,1,0,14,75,3,14,7,14,17,21,58,85,1,128,7,0,2,58,21,40470,16215,3101,22578,0
344,6953,245,125,200,5,7,34,250,7,30,17,34,37,51,166,265,3,1053,58,0,2,58,21,40480,16216,3101,22579,0
24,834,74,35,59,1,0,14,75,3,14,7,14,17,21,58,85,1,128,7,0,2,1,1,40480,16217,3101,22580,0
24,834,245,125,200,5,7,34,250,7,30,17,34,37,51,166,265,3,1053,58,0,2,1,1,40490,16218,3101,22581,0
72,2129,1523,757,1297,19,12,193,1542,12,193,117,230,205,347,1508,2664,7,19053,1058,0,2,3,0,40500,16220,3101,22582,0
72,2129,701,378,504,33,58,109,734,13,110,68,126,123,194,794,1346,7,10027,557,0,2,3,0,40500,16221,3102,22583,0
177,4149,77,34,69,0,0,8,77,3,24,16,29,27,45,114,213,1,387,21,0,2,15,19,40500,16221,3102,22584,0
177,4149,712,438,573,51,9,84,763,14,102,71,128,116,199,733,1364,8,11988,666,0,2,15,19,40510,16222,3102,22585,0
223,5018,722,423,573,19,0,135,741,12,172,101,199,184,300,1320,2257,6,15668,870,0,2,1,0,40510,16224,3102,22587,0
223,5018,1508,847,911,44,250,301,1552,14,148,88,169,162,257,1120,1886,7,15077,837,0,2,1,0,40510,16225,3103,22588,0
335,7111,72,33,56,0,4,12,72,1,1,1,1,2,2,0,2,0,1,0,0,2,2,8,40510,16225,3103,22589,0
335,7111,1454,835,1044,76,110,219,1530,17,275,158,296,292,454,2297,3718,9,34017,1889,1,2,2,8,40520,16226,3103,22590,0
41,940,386,256,301,16,9,68,402,4,59,35,69,63,104,355,621,2,1453,80,0,2,4,1,40520,16226,3103,22591,0
41,940,264,131,164,11,41,46,275,6,38,22,40,44,62,214,338,3,1068,59,0,2,4,1,40530,16226,3104,22592,0
20,400,294,64,250,0,0,43,294,1,20,10,20,21,30,86,131,0,65,3,0,2,2,2,40530,16226,3104,22593,0
20,400,78,46,62,3,0,14,81,3,8,4,8,11,12,28,41,1,62,3,0,2,2,2,40530,16227,3104,22594,0
14,476,42,7,35,4,0,5,46,1,2,1,2,3,3,2,4,0,2,0,0,2,1,1,40530,16227,3104,22595,0
14,476,11,6,10,0,0,1,11,2,4,2,4,6,6,10,15,1,15,0,0,2,1,1,40530,16227,3104,22596,0
47,2495,520,294,400,33,13,81,553,10,261,204,367,271,571,2128,4614,7,32445,1802,1,2,33,8,40530,16228,3104,22597,0
147,4008,1660,832,1314,41,38,274,1701,20,312,209,395,332,604,2671,5058,12,64042,3557,1,2,13,0,40530,16230,3105,22599,0
5,138,207,111,150,11,0,50,218,5,26,19,36,31,55,133,272,3,943,52,0,0,50,0,40530,16230,3105,22600,0
75,3862,1457,730,1242,11,6,188,1468,10,292,166,329,302,495,2424,4078,5,22973,1276,1,2,32,1,40530,16232,3105,22601,0
38,2269,652,304,544,16,6,88,668,6,89,51,101,95,152,591,998,3,3399,188,0,2,25,0,40530,16233,3105,22602,0
62,2852,1455,414,1257,16,76,112,1471,5,41,23,46,46,69,231,381,2,1069,59,0,2,5,3,40530,16234,3105,22603,0
82,4147,1523,757,1297,19,12,193,1542,12,193,117,230,205,347,1508,2664,7,19053,1058,0,2,4,0,40540,16236,3105,22604,0
36,1940,384,251,317,7,8,52,391,11,70,44,84,81,128,467,811,6,5355,297,0,2,21,1,40540,16236,3105,22605,0
30,1362,386,256,301,16,9,68,402,4,59,35,69,63,104,355,621,2,1453,80,0,2,28,5,40540,16236,3105,22606,0
1,300,382,65,130,157,2,92,539,4,10,5,10,14,15,41,57,2,114,6,0,2,1,1,40540,16237,3106,22607,1
1,300,382,65,130,157,2,92,539,4,10,5,10,14,15,41,57,2,114,6,0,2,1,1,40540,16238,3107,22608,0
335,7133,72,33,56,0,4,12,72,1,1,1,1,2,2,0,2,0,1,0,0,2,8,3,40540,16238,3107,22609,1
335,7133,1454,835,1044,76,110,219,1530,17,275,158,296,292,454,2297,3718,9,34017,1889,1,2,8,3,40550,16239,3107,22610,1
108,5395,1782,648,1425,9,47,279,1791,8,171,97,189,179,286,1292,2140,4,9462,525,0,2,49,9,40550,16240,3108,22611,1
103,1969,1178,367,1042,6,15,115,1184,9,94,51,95,103,146,644,976,4,4439,246,0,2,1,1,40550,16240,3108,22612,1
103,1969,177,108,140,8,0,27,185,6,30,16,32,36,48,162,248,3,794,44,0,2,1,1,40550,16242,3108,22613,1
335,7133,72,33,56,0,4,12,72,1,1,1,1,2,2,0,2,0,1,0,0,2,8,3,40550,16242,3108,22614,0
335,7133,1454,835,1044,76,110,219,1530,17,275,158,296,292,454,2297,3718,9,34017,1889,1,2,8,3,40560,16243,3108,22615,0
108,5395,1782,648,1425,9,47,279,1791,8,171,97,189,179,286,1292,2140,4,9462,525,0,2,49,9,40560,16244,3109,22616,0
42,947,386,256,301,16,9,68,402,4,59,35,69,63,104,355,621,2,1453,80,0,2,2,1,40560,16244,3109,22617,1
42,947,264,131,164,11,41,46,275,6,38,22,40,44,62,214,338,3,1068,59,0,2,2,1,40570,16244,3110,22618,1
31,1425,386,256,301,16,9,68,402,4,59,35,69,63,104,355,621,2,1453,80,0,2,10,0,40570,16244,3110,22619,1
31,1500,386,256,301,16,9,68,402,4,59,35,69,63,104,355,621,2,1453,80,0,2,11,0,40570,16244,3110,22620,1
31,1500,386,256,301,16,9,68,402,4,59,35,69,63,104,355,621,2,1453,80,0,2,1,0,40570,16244,3110,22621,0
41,943,386,256,301,16,9,68,402,4,59,35,69,63,104,355,621,2,1453,80,0,2,2,2,40570,16244,3110,22622,0
41,943,264,131,164,11,41,46,275,6,38,22,40,44,62,214,338,3,1068,59,0,2,2,2,40580,16244,3111,22623,0
46,945,447,308,343,6,5,95,453,7,96,59,111,103,170,651,1136,4,4600,255,0,2,3,3,40580,16247,3111,22624,0
46,945,322,174,179,16,74,51,338,10,41,26,46,51,72,252,408,5,2291,127,0,2,3,3,40580,16250,3112,22625,0
37,1604,447,308,343,6,5,95,453,7,96,59,111,103,170,651,1136,4,4600,255,0,2,4,10,40580,16253,3112,22626,0
46,945,447,308,343,6,5,95,453,7,96,59,111,103,170,651,1136,4,4600,255,0,2,3,3,40580,16256,3112,22627,0
46,945,322,174,179,16,74,51,338,10,41,26,46,51,72,252,408,5,2291,127,0,2,3,3,40580,16259,3113,22628,0
37,1604,447,308,343,6,5,95,453,7,96,59,111,103,170,651,1136,4,4600,255,0,2,4,10,40580,16262,3113,22629,0
9,223,19,8,11,5,0,4,24,2,5,3,6,7,9,13,25,1,30,1,0,2,1,1,40580,16262,3113,22630,1
9,223,102,59,69,5,3,24,107,6,22,15,28,28,43,113,206,3,789,43,0,2,1,1,40580,16262,3113,22631,1
9,223,106,40,36,3,49,17,109,8,17,13,23,25,36,93,167,5,904,50,0,2,1,1,40580,16262,3113,22632,1
28,548,2,2,2,0,0,0,2,0,0,0,0,0,0,0,0,0,0,0,0,2,1,1,40580,16262,3113,22632,1
28,548,99,48,90,1,3,5,100,0,0,0,0,0,0,0,0,0,0,0,0,2,1,1,40580,16263,3113,22633,1
28,548,8,5,5,2,0,1,10,0,0,0,0,0,0,0,0,0,0,0,0,2,1,1,40580,16263,3113,22634,1
28,548,1217,716,841,84,126,174,1301,14,185,118,215,199,333,1446,2542,8,20687,1149,0,2,1,1,40590,16265,3113,22635,1
28,548,160,89,115,0,13,31,160,7,15,11,17,22,28,78,124,3,495,27,0,2,1,1,40590,16265,3113,22636,1
28,548,10,10,9,9,0,0,19,0,0,0,0,0,0,0,0,0,0,0,0,2,1,1,40590,16265,3114,22637,1
28,548,173,84,99,8,29,36,181,5,12,7,13,17,20,54,81,2,221,12,0,2,1,1,40590,16266,3114,22638,1
28,548,3,1,1,3,0,0,6,0,0,0,0,0,0,0,0,0,0,0,0,2,1,1,40590,16266,3114,22639,1
60,1254,996,429,845,24,10,117,1020,7,76,50,88,83,138,494,879,4,3565,198,0,2,1,1,40590,16268,3114,22640,1
60,1254,456,277,329,12,42,72,468,13,85,50,97,98,147,592,972,7,7212,400,0,2,1,1,40590,16268,3114,22641,1
119,2420,1513,682,1277,25,13,200,1538,11,199,116,219,210,335,1557,2584,6,15641,868,0,2,6,6,40590,16270,3114,22642,1
119,2420,819,519,539,24,98,155,843,15,96,57,106,111,163,690,1107,8,9171,509,0,2,6,6,40600,16272,3114,22643,1
344,6968,1457,730,1242,11,6,188,1468,10,292,166,329,302,495,2424,4078,5,22973,1276,1,2,5,5,40600,16274,3114,22644,1
344,6968,74,35,59,1,0,14,75,3,14,7,14,17,21,58,85,1,128,7,0,2,5,5,40600,16275,3114,22645,1
344,6968,245,125,200,5,7,34,250,7,30,17,34,37,51,166,265,3,1053,58,0,2,5,5,40610,16276,3114,22646,1
22,679,339,213,244,17,9,65,356,10,42,26,48,52,74,259,421,5,2410,133,0,2,2,2,40620,16276,3114,22647,1
228,5119,4293,999,3693,19,54,507,4312,9,155,88,170,164,258,1156,1898,4,9368,520,0,2,6,6,40620,16278,3114,22648,1
228,5119,1482,859,1002,125,135,219,1607,16,219,134,251,235,385,1766,3032,9,27804,1544,1,2,6,6,40630,16279,3114,22649,1
177,4152,77,34,69,0,0,8,77,3,24,16,29,27,45,114,213,1,387,21,0,2,1,1,40630,16279,3114,22650,1
177,4152,712,438,573,51,9,84,763,14,102,71,128,116,199,733,1364,8,11988,666,0,2,1,1,40640,16280,3114,22651,1
69,1359,1020,354,843,12,15,144,1032,8,134,77,144,142,221,970,1580,4,6792,377,0,2,4,4,40640,16280,3114,22652,1
46,955,447,308,343,6,5,95,453,7,96,59,111,103,170,651,1136,4,4600,255,0,2,2,2,40640,16283,3114,22653,1
46,955,322,174,179,16,74,51,338,10,41,26,46,51,72,252,408,5,2291,127,0,2,2,2,40640,16286,3115,22654,1
223,5051,722,423,573,19,0,135,741,12,172,101,199,184,300,1320,2257,6,15668,870,0,2,11,11,40640,16288,3115,22656,1
223,5051,1508,847,911,44,250,301,1552,14,148,88,169,162,257,1120,1886,7,15077,837,0,2,11,11,40640,16289,3116,22657,1
128,2818,1043,504,840,53,9,147,1096,9,180,112,198,189,310,1377,2344,4,11604,644,0,2,2,2,40640,16291,3116,22658,1
128,2818,383,288,292,26,6,62,409,11,65,38,67,76,105,429,656,5,3719,206,0,2,2,2,40640,16292,3116,22659,1
103,1959,1178,367,1042,6,15,115,1184,9,94,51,95,103,146,644,976,4,4439,246,0,2,1,1,40640,16292,3116,22660,1
103,1959,177,108,140,8,0,27,185,6,30,16,32,36,48,162,248,3,794,44,0,2,1,1,40640,16294,3116,22661,1
184,3747,1943,715,1694,26,18,214,1969,12,185,120,237,197,357,1436,2721,7,20915,1161,0,2,2,2,40640,16296,3116,22662,1
184,3747,1168,838,957,57,25,144,1225,19,348,224,416,367,640,3018,5452,11,61921,3440,1,2,2,2,40650,16298,3116,22663,1
16,471,442,244,305,14,16,103,456,11,68,45,75,79,120,452,756,6,4588,254,0,2,1,1,40650,16300,3116,22664,1
16,471,182,102,99,11,40,35,193,3,11,6,11,14,17,42,64,1,97,5,0,2,1,1,40650,16301,3116,22665,1
9,223,19,8,11,5,0,4,24,2,5,3,6,7,9,13,25,1,30,1,0,2,1,1,40650,16301,3116,22666,0
9,223,102,59,69,5,3,24,107,6,22,15,28,28,43,113,206,3,789,43,0,2,1,1,40650,16301,3116,22667,0
9,223,106,40,36,3,49,17,109,8,17,13,23,25,36,93,167,5,904,50,0,2,1,1,40650,16301,3116,22668,0
28,548,2,2,2,0,0,0,2,0,0,0,0,0,0,0,0,0,0,0,0,2,1,1,40650,16301,3116,22668,0
28,548,99,48,90,1,3,5,100,0,0,0,0,0,0,0,0,0,0,0,0,2,1,1,40650,16302,3116,22669,0
28,548,8,5,5,2,0,1,10,0,0,0,0,0,0,0,0,0,0,0,0,2,1,1,40650,16302,3116,22670,0
28,548,1217,716,841,84,126,174,1301,14,185,118,215,199,333,1446,2542,8,20687,1149,0,2,1,1,40660,16304,3116,22671,0
28,548,160,89,115,0,13,31,160,7,15,11,17,22,28,78,124,3,495,27,0,2,1,1,40660,16304,3116,22672,0
28,548,10,10,9,9,0,0,19,0,0,0,0,0,0,0,0,0,0,0,0,2,1,1,40660,16304,3117,22673,0
28,548,173,84,99,8,29,36,181,5,12,7,13,17,20,54,81,2,221,12,0,2,1,1,40660,16305,3117,22674,0
28,548,3,1,1,3,0,0,6,0,0,0,0,0,0,0,0,0,0,0,0,2,1,1,40660,16305,3117,22675,0
60,1254,996,429,845,24,10,117,1020,7,76,50,88,83,138,494,879,4,3565,198,0,2,1,1,40660,16307,3117,22676,0
60,1254,456,277,329,12,42,72,468,13,85,50,97,98,147,592,972,7,7212,400,0,2,1,1,40660,16307,3117,22677,0
119,2420,1513,682,1277,25,13,200,1538,11,199,116,219,210,335,1557,2584,6,15641,868,0,2,6,6,40660,16309,3117,22678,0
119,2420,819,519,539,24,98,155,843,15,96,57,106,111,163,690,1107,8,9171,509,0,2,6,6,40670,16311,3117,22679,0
344,6968,1457,730,1242,11,6,188,1468,10,292,166,329,302,495,2424,4078,5,22973,1276,1,2,5,5,40670,16313,3117,22680,0
344,6968,74,35,59,1,0,14,75,3,14,7,14,17,21,58,85,1,128,7,0,2,5,5,40670,16314,3117,22681,0
344,6968,245,125,200,5,7,34,250,7,30,17,34,37,51,166,265,3,1053,58,0,2,5,5,40680,16315,3117,22682,0
22,679,339,213,244,17,9,65,356,10,42,26,48,52,74,259,421,5,2410,133,0,2,2,2,40690,16315,3117,22683,0
228,5119,4293,999,3693,19,54,507,4312,9,155,88,170,164,258,1156,1898,4,9368,520,0,2,6,6,40690,16317,3117,22684,0
228,5119,1482,859,1002,125,135,219,1607,16,219,134,251,235,385,1766,3032,9,27804,1544,1,2,6,6,40700,16318,3117,22685,0
177,4152,77,34,69,0,0,8,77,3,24,16,29,27,45,114,213,1,387,21,0,2,1,1,40700,16318,3117,22686,0
177,4152,712,438,573,51,9,84,763,14,102,71,128,116,199,733,1364,8,11988,666,0,2,1,1,40710,16319,3117,22687,0
69,1359,1020,354,843,12,15,144,1032,8,134,77,144,142,221,970,1580,4,6792,377,0,2,4,4,40710,16319,3117,22688,0
46,955,447,308,343,6,5,95,453,7,96,59,111,103,170,651,1136,4,4600,255,0,2,2,2,40710,16322,3117,22689,0
46,955,322,174,179,16,74,51,338,10,41,26,46,51,72,252,408,5,2291,127,0,2,2,2,40710,16325,3118,22690,0
223,5051,722,423,573,19,0,135,741,12,172,101,199,184,300,1320,2257,6,15668,870,0,2,11,11,40710,16327,3118,22692,0
223,5051,1508,847,911,44,250,301,1552,14,148,88,169,162,257,1120,1886,7,15077,837,0,2,11,11,40710,16328,3119,22693,0
128,2818,1043,504,840,53,9,147,1096,9,180,112,198,189,310,1377,2344,4,11604,644,0,2,2,2,40710,16330,3119,22694,0
128,2818,383,288,292,26,6,62,409,11,65,38,67,76,105,429,656,5,3719,206,0,2,2,2,40710,16331,3119,22695,0
103,1959,1178,367,1042,6,15,115,1184,9,94,51,95,103,146,644,976,4,4439,246,0,2,1,1,40710,16331,3119,22696,0
103,1959,177,108,140,8,0,27,185,6,30,16,32,36,48,162,248,3,794,44,0,2,1,1,40710,16333,3119,22697,0
184,3747,1943,715,1694,26,18,214,1969,12,185,120,237,197,357,1436,2721,7,20915,1161,0,2,2,2,40710,16335,3119,22698,0
184,3747,1168,838,957,57,25,144,1225,19,348,224,416,367,640,3018,5452,11,61921,3440,1,2,2,2,40720,16337,3119,22699,0
16,471,442,244,305,14,16,103,456,11,68,45,75,79,120,452,756,6,4588,254,0,2,1,1,40720,16339,3119,22700,0
16,471,182,102,99,11,40,35,193,3,11,6,11,14,17,42,64,1,97,5,0,2,1,1,40720,16340,3119,22701,0
222,4984,722,423,573,19,0,135,741,12,172,101,199,184,300,1320,2257,6,15668,870,0,2,1,0,40720,16342,3119,22703,1
222,4984,1508,847,911,44,250,301,1552,14,148,88,169,162,257,1120,1886,7,15077,837,0,2,1,0,40720,16343,3120,22704,1
15,621,722,423,573,19,0,135,741,12,172,101,199,184,300,1320,2257,6,15668,870,0,2,7,0,40720,16345,3120,22706,1
345,6966,1457,730,1242,11,6,188,1468,10,292,166,329,302,495,2424,4078,5,22973,1276,1,2,5,2,40720,16347,3120,22707,1
345,6966,74,35,59,1,0,14,75,3,14,7,14,17,21,58,85,1,128,7,0,2,5,2,40720,16348,3120,22708,1
345,6966,245,125,200,5,7,34,250,7,30,17,34,37,51,166,265,3,1053,58,0,2,5,2,40730,16349,3120,22709,1
148,4073,1660,832,1314,41,38,274,1701,20,312,209,395,332,604,2671,5058,12,64042,3557,1,2,17,1,40730,16351,3121,22711,1
346,6990,1457,730,1242,11,6,188,1468,10,292,166,329,302,495,2424,4078,5,22973,1276,1,2,24,14,40730,16353,3121,22712,0
346,6990,74,35,59,1,0,14,75,3,14,7,14,17,21,58,85,1,128,7,0,2,24,14,40730,16354,3121,22713,0
346,6990,245,125,200,5,7,34,250,7,30,17,34,37,51,166,265,3,1053,58,0,2,24,14,40740,16355,3121,22714,0
76,3974,1457,730,1242,11,6,188,1468,10,292,166,329,302,495,2424,4078,5,22973,1276,1,2,15,0,40740,16357,3121,22715,0
346,6990,1457,730,1242,11,6,188,1468,10,292,166,329,302,495,2424,4078,5,22973,1276,1,2,24,11,40740,16359,3121,22716,0
346,6990,74,35,59,1,0,14,75,3,14,7,14,17,21,58,85,1,128,7,0,2,24,11,40740,16360,3121,22717,0
346,6990,245,125,200,5,7,34,250,7,30,17,34,37,51,166,265,3,1053,58,0,2,24,11,40750,16361,3121,22718,0
148,4073,1660,832,1314,41,38,274,1701,20,312,209,395,332,604,2671,5058,12,64042,3557,1,2,17,1,40750,16363,3122,22720,0
76,3974,1457,730,1242,11,6,188,1468,10,292,166,329,302,495,2424,4078,5,22973,1276,1,2,15,0,40750,16365,3122,22721,0
48,934,207,111,150,11,0,50,218,5,26,19,36,31,55,133,272,3,943,52,0,2,10,2,40750,16365,3122,22722,1
48,934,410,198,237,31,55,97,441,11,63,38,72,74,110,414,683,6,4293,238,0,2,10,2,40760,16366,3123,22723,1
10,228,207,111,150,11,0,50,218,5,26,19,36,31,55,133,272,3,943,52,0,2,29,4,40760,16366,3123,22724,1
48,948,207,111,150,11,0,50,218,5,26,19,36,31,55,133,272,3,943,52,0,2,3,1,40760,16366,3123,22725,0
48,948,410,198,237,31,55,97,441,11,63,38,72,74,110,414,683,6,4293,238,0,2,3,1,40770,16367,3124,22726,0
222,4983,722,423,573,19,0,135,741,12,172,101,199,184,300,1320,2257,6,15668,870,0,2,3,3,40770,16369,3124,22728,0
222,4983,1508,847,911,44,250,301,1552,14,148,88,169,162,257,1120,1886,7,15077,837,0,2,3,3,40770,16370,3125,22729,0
346,6990,1457,730,1242,11,6,188,1468,10,292,166,329,302,495,2424,4078,5,22973,1276,1,2,1,1,40770,16372,3125,22730,0
346,6990,74,35,59,1,0,14,75,3,14,7,14,17,21,58,85,1,128,7,0,2,1,1,40770,16373,3125,22731,0
346,6990,245,125,200,5,7,34,250,7,30,17,34,37,51,166,265,3,1053,58,0,2,1,1,40780,16374,3125,22732,0
93,3417,1450,624,1228,12,26,181,1462,14,306,186,354,320,540,2580,4493,8,36391,2021,1,2,17,0,40780,16376,3126,22733,0
48,948,207,111,150,11,0,50,218,5,26,19,36,31,55,133,272,3,943,52,0,2,12,2,40780,16376,3126,22734,0
48,948,410,198,237,31,55,97,441,11,63,38,72,74,110,414,683,6,4293,238,0,2,12,2,40790,16377,3127,22735,0
10,228,207,111,150,11,0,50,218,5,26,19,36,31,55,133,272,3,943,52,0,2,29,4,40790,16377,3127,22736,0
222,4984,722,423,573,19,0,135,741,12,172,101,199,184,300,1320,2257,6,15668,870,0,2,1,0,40790,16379,3127,22738,0
222,4984,1508,847,911,44,250,301,1552,14,148,88,169,162,257,1120,1886,7,15077,837,0,2,1,0,40790,16380,3128,22739,0
15,621,722,423,573,19,0,135,741,12,172,101,199,184,300,1320,2257,6,15668,870,0,2,7,0,40790,16382,3128,22741,0
346,6990,1457,730,1242,11,6,188,1468,10,292,166,329,302,495,2424,4078,5,22973,1276,1,2,1,1,40790,16384,3128,22742,0
346,6990,74,35,59,1,0,14,75,3,14,7,14,17,21,58,85,1,128,7,0,2,1,1,40790,16385,3128,22743,0
346,6990,245,125,200,5,7,34,250,7,30,17,34,37,51,166,265,3,1053,58,0,2,1,1,40800,16386,3128,22744,0
93,3417,1450,624,1228,12,26,181,1462,14,306,186,354,320,540,2580,4493,8,36391,2021,1,2,17,0,40800,16388,3129,22745,0
179,4178,77,34,69,0,0,8,77,3,24,16,29,27,45,114,213,1,387,21,0,2,9,8,40800,16388,3129,22746,0
179,4178,712,438,573,51,9,84,763,14,102,71,128,116,199,733,1364,8,11988,666,0,2,9,8,40810,16389,3129,22747,0
346,6990,1457,730,1242,11,6,188,1468,10,292,166,329,302,495,2424,4078,5,22973,1276,1,2,1,1,40810,16391,3129,22748,0
346,6990,74,35,59,1,0,14,75,3,14,7,14,17,21,58,85,1,128,7,0,2,1,1,40810,16392,3129,22749,0
346,6990,245,125,200,5,7,34,250,7,30,17,34,37,51,166,265,3,1053,58,0,2,1,1,40820,16393,3129,22750,0
222,4988,722,423,573,19,0,135,741,12,172,101,199,184,300,1320,2257,6,15668,870,0,2,1,0,40820,16395,3129,22752,0
222,4988,1508,847,911,44,250,301,1552,14,148,88,169,162,257,1120,1886,7,15077,837,0,2,1,0,40820,16396,3130,22753,0
93,3417,1450,624,1228,12,26,181,1462,14,306,186,354,320,540,2580,4493,8,36391,2021,1,2,17,0,40820,16398,3131,22754,0
15,621,722,423,573,19,0,135,741,12,172,101,199,184,300,1320,2257,6,15668,870,0,2,7,0,40820,16400,3131,22756,0
222,4988,722,423,573,19,0,135,741,12,172,101,199,184,300,1320,2257,6,15668,870,0,2,3,3,40820,16402,3131,22758,0
222,4988,1508,847,911,44,250,301,1552,14,148,88,169,162,257,1120,1886,7,15077,837,0,2,3,3,40820,16403,3132,22759,0
179,4176,77,34,69,0,0,8,77,3,24,16,29,27,45,114,213,1,387,21,0,2,0,2,40820,16403,3132,22760,0
179,4176,712,438,573,51,9,84,763,14,102,71,128,116,199,733,1364,8,11988,666,0,2,0,2,40830,16404,3132,22761,0
179,4176,77,34,69,0,0,8,77,3,24,16,29,27,45,114,213,1,387,21,0,2,30,18,40830,16404,3132,22762,0
179,4176,712,438,573,51,9,84,763,14,102,71,128,116,199,733,1364,8,11988,666,0,2,30,18,40840,16405,3132,22763,0
49,577,647,139,84,35,284,233,682,0,0,0,0,0,0,0,0,0,0,0,0,2,2,1,40840,16405,3132,22764,0
335,7141,72,33,56,0,4,12,72,1,1,1,1,2,2,0,2,0,1,0,0,2,3,2,40840,16405,3132,22765,0
335,7141,1454,835,1044,76,110,219,1530,17,275,158,296,292,454,2297,3718,9,34017,1889,1,2,3,2,40850,16406,3132,22766,0
109,5438,1782,648,1425,9,47,279,1791,8,171,97,189,179,286,1292,2140,4,9462,525,0,2,23,0,40850,16407,3133,22767,0
49,575,647,139,84,35,284,233,682,0,0,0,0,0,0,0,0,0,0,0,0,2,1,1,40850,16407,3133,22768,0
109,5438,1782,648,1425,9,47,279,1791,8,171,97,189,179,286,1292,2140,4,9462,525,0,2,5,5,40850,16408,3134,22769,0
103,1969,1178,367,1042,6,15,115,1184,9,94,51,95,103,146,644,976,4,4439,246,0,2,1,1,40860,16412,3135,22777,1
103,1969,177,108,140,8,0,27,185,6,30,16,32,36,48,162,248,3,794,44,0,2,1,1,40860,16414,3135,22778,1
14,472,42,7,35,4,0,5,46,1,2,1,2,3,3,2,4,0,2,0,0,2,0,1,40860,16414,3135,22779,0
14,472,11,6,10,0,0,1,11,2,4,2,4,6,6,10,15,1,15,0,0,2,0,1,40860,16414,3135,22780,0
103,1969,1178,367,1042,6,15,115,1184,9,94,51,95,103,146,644,976,4,4439,246,0,2,1,1,40880,16422,3137,22795,0
103,1969,177,108,140,8,0,27,185,6,30,16,32,36,48,162,248,3,794,44,0,2,1,1,40880,16424,3137,22796,0
14,472,42,7,35,4,0,5,46,1,2,1,2,3,3,2,4,0,2,0,0,2,0,1,40880,16424,3137,22797,0
14,472,11,6,10,0,0,1,11,2,4,2,4,6,6,10,15,1,15,0,0,2,0,1,40880,16424,3137,22798,0
14,472,42,7,35,4,0,5,46,1,2,1,2,3,3,2,4,0,2,0,0,2,1,1,40880,16424,3137,22799,0
14,472,11,6,10,0,0,1,11,2,4,2,4,6,6,10,15,1,15,0,0,2,1,1,40880,16424,3137,22800,0
14,472,42,7,35,4,0,5,46,1,2,1,2,3,3,2,4,0,2,0,0,2,1,1,40880,16424,3137,22801,0
14,472,11,6,10,0,0,1,11,2,4,2,4,6,6,10,15,1,15,0,0,2,1,1,40880,16424,3137,22802,0
49,575,647,139,84,35,284,233,682,0,0,0,0,0,0,0,0,0,0,0,0,2,2,1,40880,16424,3137,22803,0
335,7141,72,33,56,0,4,12,72,1,1,1,1,2,2,0,2,0,1,0,0,2,3,2,40880,16424,3137,22804,0
335,7141,1454,835,1044,76,110,219,1530,17,275,158,296,292,454,2297,3718,9,34017,1889,1,2,3,2,40890,16425,3137,22805,0
109,5438,1782,648,1425,9,47,279,1791,8,171,97,189,179,286,1292,2140,4,9462,525,0,2,23,0,40890,16426,3138,22806,0
346,7005,1457,730,1242,11,6,188,1468,10,292,166,329,302,495,2424,4078,5,22973,1276,1,2,24,11,40890,16428,3138,22807,0
346,7005,74,35,59,1,0,14,75,3,14,7,14,17,21,58,85,1,128,7,0,2,24,11,40890,16429,3138,22808,0
346,7005,245,125,200,5,7,34,250,7,30,17,34,37,51,166,265,3,1053,58,0,2,24,11,40900,16430,3138,22809,0
178,4158,77,34,69,0,0,8,77,3,24,16,29,27,45,114,213,1,387,21,0,2,30,18,40900,16430,3138,22810,0
178,4158,712,438,573,51,9,84,763,14,102,71,128,116,199,733,1364,8,11988,666,0,2,30,18,40910,16431,3138,22811,0
46,951,447,308,343,6,5,95,453,7,96,59,111,103,170,651,1136,4,4600,255,0,2,3,3,40910,16434,3138,22812,0
46,951,322,174,179,16,74,51,338,10,41,26,46,51,72,252,408,5,2291,127,0,2,3,3,40910,16437,3139,22813,0
223,5060,722,423,573,19,0,135,741,12,172,101,199,184,300,1320,2257,6,15668,870,0,2,4,3,40910,16439,3139,22815,0
223,5060,1508,847,911,44,250,301,1552,14,148,88,169,162,257,1120,1886,7,15077,837,0,2,4,3,40910,16440,3140,22816,0
103,1959,1178,367,1042,6,15,115,1184,9,94,51,95,103,146,644,976,4,4439,246,0,2,1,1,40910,16440,3140,22817,0
103,1959,177,108,140,8,0,27,185,6,30,16,32,36,48,162,248,3,794,44,0,2,1,1,40910,16442,3140,22818,0
1,300,382,65,130,157,2,92,539,4,10,5,10,14,15,41,57,2,114,6,0,2,1,1,40910,16443,3141,22819,0
14,472,42,7,35,4,0,5,46,1,2,1,2,3,3,2,4,0,2,0,0,2,1,2,40910,16443,3141,22820,0
14,472,11,6,10,0,0,1,11,2,4,2,4,6,6,10,15,1,15,0,0,2,1,2,40910,16443,3141,22821,0
107,4012,1450,624,1228,12,26,181,1462,14,306,186,354,320,540,2580,4493,8,36391,2021,1,2,17,0,40910,16445,3142,22822,0
148,4073,1660,832,1314,41,38,274,1701,20,312,209,395,332,604,2671,5058,12,64042,3557,1,2,17,1,40910,16447,3143,22824,0
76,3974,1457,730,1242,11,6,188,1468,10,292,166,329,302,495,2424,4078,5,22973,1276,1,2,15,0,40910,16449,3143,22825,0
37,1604,447,308,343,6,5,95,453,7,96,59,111,103,170,651,1136,4,4600,255,0,2,4,10,40910,16452,3143,22826,0
15,621,722,423,573,19,0,135,741,12,172,101,199,184,300,1320,2257,6,15668,870,0,2,7,0,40910,16454,3143,22828,0
346,7005,1457,730,1242,11,6,188,1468,10,292,166,329,302,495,2424,4078,5,22973,1276,1,2,24,11,40910,16456,3143,22829,0
346,7005,74,35,59,1,0,14,75,3,14,7,14,17,21,58,85,1,128,7,0,2,24,11,40910,16457,3143,22830,0
346,7005,245,125,200,5,7,34,250,7,30,17,34,37,51,166,265,3,1053,58,0,2,24,11,40920,16458,3143,22831,0
178,4158,77,34,69,0,0,8,77,3,24,16,29,27,45,114,213,1,387,21,0,2,30,18,40920,16458,3143,22832,0
178,4158,712,438,573,51,9,84,763,14,102,71,128,116,199,733,1364,8,11988,666,0,2,30,18,40930,16459,3143,22833,0
46,951,447,308,343,6,5,95,453,7,96,59,111,103,170,651,1136,4,4600,255,0,2,3,3,40930,16462,3143,22834,0
46,951,322,174,179,16,74,51,338,10,41,26,46,51,72,252,408,5,2291,127,0,2,3,3,40930,16465,3144,22835,0
223,5060,722,423,573,19,0,135,741,12,172,101,199,184,300,1320,2257,6,15668,870,0,2,4,3,40930,16467,3144,22837,0
223,5060,1508,847,911,44,250,301,1552,14,148,88,169,162,257,1120,1886,7,15077,837,0,2,4,3,40930,16468,3145,22838,0
103,1959,1178,367,1042,6,15,115,1184,9,94,51,95,103,146,644,976,4,4439,246,0,2,1,1,40930,16468,3145,22839,0
103,1959,177,108,140,8,0,27,185,6,30,16,32,36,48,162,248,3,794,44,0,2,1,1,40930,16470,3145,22840,0
1,300,382,65,130,157,2,92,539,4,10,5,10,14,15,41,57,2,114,6,0,2,1,1,40930,16471,3146,22841,0
14,472,42,7,35,4,0,5,46,1,2,1,2,3,3,2,4,0,2,0,0,2,1,2,40930,16471,3146,22842,0
14,472,11,6,10,0,0,1,11,2,4,2,4,6,6,10,15,1,15,0,0,2,1,2,40930,16471,3146,22843,0
107,4012,1450,624,1228,12,26,181,1462,14,306,186,354,320,540,2580,4493,8,36391,2021,1,2,17,0,40930,16473,3147,22844,0
148,4073,1660,832,1314,41,38,274,1701,20,312,209,395,332,604,2671,5058,12,64042,3557,1,2,17,1,40930,16475,3148,22846,0
76,3974,1457,730,1242,11,6,188,1468,10,292,166,329,302,495,2424,4078,5,22973,1276,1,2,15,0,40930,16477,3148,22847,0
37,1604,447,308,343,6,5,95,453,7,96,59,111,103,170,651,1136,4,4600,255,0,2,4,10,40930,16480,3148,22848,0
15,621,722,423,573,19,0,135,741,12,172,101,199,184,300,1320,2257,6,15668,870,0,2,7,0,40930,16482,3148,22850,0
59,1216,1098,241,925,5,10,155,1103,7,46,25,49,53,74,273,423,3,1580,87,0,2,12,2,40940,16484,3148,22851,1
59,1216,282,202,222,14,2,44,296,8,42,24,43,50,67,250,378,4,1548,86,0,2,12,2,40940,16485,3148,22852,1
31,1477,1293,570,1093,25,15,163,1318,10,195,123,241,205,364,1516,2795,6,17273,959,0,2,14,0,40950,16487,3148,22853,1
59,1216,1098,241,925,5,10,155,1103,7,46,25,49,53,74,273,423,3,1580,87,0,2,2,2,40960,16489,3148,22854,0
59,1216,282,202,222,14,2,44,296,8,42,24,43,50,67,250,378,4,1548,86,0,2,2,2,40960,16490,3148,22855,0
335,7115,72,33,56,0,4,12,72,1,1,1,1,2,2,0,2,0,1,0,0,2,1,1,40960,16490,3148,22856,0
335,7115,1454,835,1044,76,110,219,1530,17,275,158,296,292,454,2297,3718,9,34017,1889,1,2,1,1,40970,16491,3148,22857,0
335,7115,72,33,56,0,4,12,72,1,1,1,1,2,2,0,2,0,1,0,0,2,1,1,40970,16491,3148,22858,0
335,7115,1454,835,1044,76,110,219,1530,17,275,158,296,292,454,2297,3718,9,34017,1889,1,2,1,1,40980,16492,3148,22859,0
335,7115,72,33,56,0,4,12,72,1,1,1,1,2,2,0,2,0,1,0,0,2,1,1,40980,16492,3148,22860,0
335,7115,1454,835,1044,76,110,219,1530,17,275,158,296,292,454,2297,3718,9,34017,1889,1,2,1,1,40990,16493,3148,22861,0
62,1244,1098,241,925,5,10,155,1103,7,46,25,49,53,74,273,423,3,1580,87,0,2,19,11,41000,16495,3148,22862,1
62,1244,282,202,222,14,2,44,296,8,42,24,43,50,67,250,378,4,1548,86,0,2,19,11,41000,16496,3148,22863,1
31,1478,1293,570,1093,25,15,163,1318,10,195,123,241,205,364,1516,2795,6,17273,959,0,2,1,0,41010,16498,3148,22864,1
337,7189,72,33,56,0,4,12,72,1,1,1,1,2,2,0,2,0,1,0,0,2,20,4,41010,16498,3148,22865,0
337,7189,1454,835,1044,76,110,219,1530,17,275,158,296,292,454,2297,3718,9,34017,1889,1,2,20,4,41020,16499,3148,22866,0
20,535,256,139,192,9,7,47,265,4,23,12,24,27,36,112,171,2,357,19,0,2,15,0,41020,16500,3148,22867,0
31,1490,386,256,301,16,9,68,402,4,59,35,69,63,104,355,621,2,1453,80,0,2,1,2,41020,16500,3148,22868,0
20,535,256,139,192,9,7,47,265,4,23,12,24,27,36,112,171,2,357,19,0,2,1,1,41020,16501,3148,22869,0
337,7189,72,33,56,0,4,12,72,1,1,1,1,2,2,0,2,0,1,0,0,2,20,4,41020,16501,3148,22870,0
337,7189,1454,835,1044,76,110,219,1530,17,275,158,296,292,454,2297,3718,9,34017,1889,1,2,20,4,41030,16502,3148,22871,0
20,535,256,139,192,9,7,47,265,4,23,12,24,27,36,112,171,2,357,19,0,2,15,0,41030,16503,3148,22872,0
31,1490,386,256,301,16,9,68,402,4,59,35,69,63,104,355,621,2,1453,80,0,2,1,2,41030,16503,3148,22873,0
104,1979,1178,367,1042,6,15,115,1184,9,94,51,95,103,146,644,976,4,4439,246,0,2,2,1,41030,16503,3148,22874,1
104,1979,177,108,140,8,0,27,185,6,30,16,32,36,48,162,248,3,794,44,0,2,2,1,41030,16505,3148,22875,1
71,2977,1178,367,1042,6,15,115,1184,9,94,51,95,103,146,644,976,4,4439,246,0,2,23,0,41030,16505,3148,22876,0
103,1969,1178,367,1042,6,15,115,1184,9,94,51,95,103,146,644,976,4,4439,246,0,2,1,1,41030,16505,3148,22877,0
103,1969,177,108,140,8,0,27,185,6,30,16,32,36,48,162,248,3,794,44,0,2,1,1,41030,16507,3148,22878,0
104,1979,1178,367,1042,6,15,115,1184,9,94,51,95,103,146,644,976,4,4439,246,0,2,2,1,41030,16507,3148,22879,0
104,1979,177,108,140,8,0,27,185,6,30,16,32,36,48,162,248,3,794,44,0,2,2,1,41030,16509,3148,22880,0
71,2977,1178,367,1042,6,15,115,1184,9,94,51,95,103,146,644,976,4,4439,246,0,2,23,0,41030,16509,3148,22881,0
227,5097,4293,999,3693,19,54,507,4312,9,155,88,170,164,258,1156,1898,4,9368,520,0,2,0,2,41030,16511,3148,22882,0
227,5097,1482,859,1002,125,135,219,1607,16,219,134,251,235,385,1766,3032,9,27804,1544,1,2,0,2,41040,16512,3148,22883,0
227,5099,4293,999,3693,19,54,507,4312,9,155,88,170,164,258,1156,1898,4,9368,520,0,2,4,1,41040,16514,3148,22884,0
227,5099,1482,859,1002,125,135,219,1607,16,219,134,251,235,385,1766,3032,9,27804,1544,1,2,4,1,41050,16515,3148,22885,0
94,4250,1338,495,1086,10,64,173,1348,11,122,82,157,133,239,883,1686,7,11934,663,0,2,10,0,41050,16517,3148,22886,0
227,5099,4293,999,3693,19,54,507,4312,9,155,88,170,164,258,1156,1898,4,9368,520,0,2,4,3,41050,16519,3148,22887,0
227,5099,1482,859,1002,125,135,219,1607,16,219,134,251,235,385,1766,3032,9,27804,1544,1,2,4,3,41060,16520,3148,22888,0
94,4250,1338,495,1086,10,64,173,1348,11,122,82,157,133,239,883,1686,7,11934,663,0,2,10,0,41060,16522,3148,22889,0
227,5099,4293,999,3693,19,54,507,4312,9,155,88,170,164,258,1156,1898,4,9368,520,0,2,4,3,41060,16524,3148,22890,0
227,5099,1482,859,1002,125,135,219,1607,16,219,134,251,235,385,1766,3032,9,27804,1544,1,2,4,3,41070,16525,3148,22891,0
104,1979,1178,367,1042,6,15,115,1184,9,94,51,95,103,146,644,976,4,4439,246,0,2,3,2,41070,16525,3148,22892,0
104,1979,177,108,140,8,0,27,185,6,30,16,32,36,48,162,248,3,794,44,0,2,3,2,41070,16527,3148,22893,0
94,4250,1338,495,1086,10,64,173,1348,11,122,82,157,133,239,883,1686,7,11934,663,0,2,10,0,41070,16529,3148,22894,0
71,2977,1178,367,1042,6,15,115,1184,9,94,51,95,103,146,644,976,4,4439,246,0,2,23,0,41070,16529,3148,22895,0
62,1244,1098,241,925,5,10,155,1103,7,46,25,49,53,74,273,423,3,1580,87,0,2,20,2,41080,16531,3148,22896,0
62,1244,282,202,222,14,2,44,296,8,42,24,43,50,67,250,378,4,1548,86,0,2,20,2,41080,16532,3148,22897,0
31,1478,1293,570,1093,25,15,163,1318,10,195,123,241,205,364,1516,2795,6,17273,959,0,2,15,0,41090,16534,3148,22898,0
346,6994,1457,730,1242,11,6,188,1468,10,292,166,329,302,495,2424,4078,5,22973,1276,1,2,10,9,41090,16536,3148,22899,1
346,6994,74,35,59,1,0,14,75,3,14,7,14,17,21,58,85,1,128,7,0,2,10,9,41090,16537,3148,22900,1
346,6994,245,125,200,5,7,34,250,7,30,17,34,37,51,166,265,3,1053,58,0,2,10,9,41100,16538,3148,22901,1
78,4037,1457,730,1242,11,6,188,1468,10,292,166,329,302,495,2424,4078,5,22973,1276,1,2,15,0,41100,16540,3148,22902,1
163,5074,1660,832,1314,41,38,274,1701,20,312,209,395,332,604,2671,5058,12,64042,3557,1,2,2,1,41100,16542,3149,22904,0
163,5074,1057,646,719,113,100,145,1170,18,215,134,248,233,382,1740,3004,10,31186,1732,1,2,2,1,41110,16543,3150,22905,0
178,4160,77,34,69,0,0,8,77,3,24,16,29,27,45,114,213,1,387,21,0,2,1,1,41110,16543,3150,22906,1
178,4160,712,438,573,51,9,84,763,14,102,71,128,116,199,733,1364,8,11988,666,0,2,1,1,41120,16544,3150,22907,1
222,4989,722,423,573,19,0,135,741,12,172,101,199,184,300,1320,2257,6,15668,870,0,2,1,1,41120,16546,3150,22909,0
222,4989,1508,847,911,44,250,301,1552,14,148,88,169,162,257,1120,1886,7,15077,837,0,2,1,1,41120,16547,3151,22910,0
16,469,442,244,305,14,16,103,456,11,68,45,75,79,120,452,756,6,4588,254,0,2,1,1,41120,16549,3151,22911,0
16,469,182,102,99,11,40,35,193,3,11,6,11,14,17,42,64,1,97,5,0,2,1,1,41120,16550,3151,22912,0
60,1251,996,429,845,24,10,117,1020,7,76,50,88,83,138,494,879,4,3565,198,0,2,1,1,41120,16552,3151,22913,1
60,1251,456,277,329,12,42,72,468,13,85,50,97,98,147,592,972,7,7212,400,0,2,1,1,41120,16552,3151,22914,1
49,573,647,139,84,35,284,233,682,0,0,0,0,0,0,0,0,0,0,0,0,2,1,1,41120,16552,3151,22915,1
179,4176,77,34,69,0,0,8,77,3,24,16,29,27,45,114,213,1,387,21,0,2,1,1,41120,16552,3151,22916,1
179,4176,712,438,573,51,9,84,763,14,102,71,128,116,199,733,1364,8,11988,666,0,2,1,1,41130,16553,3151,22917,1
70,1304,1020,354,843,12,15,144,1032,8,134,77,144,142,221,970,1580,4,6792,377,0,2,1,1,41130,16553,3151,22918,1
222,4988,722,423,573,19,0,135,741,12,172,101,199,184,300,1320,2257,6,15668,870,0,2,3,3,41130,16555,3151,22920,1
222,4988,1508,847,911,44,250,301,1552,14,148,88,169,162,257,1120,1886,7,15077,837,0,2,3,3,41130,16556,3152,22921,1
335,7115,72,33,56,0,4,12,72,1,1,1,1,2,2,0,2,0,1,0,0,2,1,1,41130,16556,3152,22922,1
335,7115,1454,835,1044,76,110,219,1530,17,275,158,296,292,454,2297,3718,9,34017,1889,1,2,1,1,41140,16557,3152,22923,1
62,1244,1098,241,925,5,10,155,1103,7,46,25,49,53,74,273,423,3,1580,87,0,2,1,1,41150,16559,3152,22924,1
62,1244,282,202,222,14,2,44,296,8,42,24,43,50,67,250,378,4,1548,86,0,2,1,1,41150,16560,3152,22925,1
93,3417,1450,624,1228,12,26,181,1462,14,306,186,354,320,540,2580,4493,8,36391,2021,1,2,1,1,41150,16562,3153,22926,1
148,4073,1660,832,1314,41,38,274,1701,20,312,209,395,332,604,2671,5058,12,64042,3557,1,2,1,1,41150,16564,3154,22928,1
116,4563,1513,682,1277,25,13,200,1538,11,199,116,219,210,335,1557,2584,6,15641,868,0,2,1,1,41150,16566,3154,22929,1
25,1016,373,158,315,8,0,51,381,5,76,44,79,81,123,486,779,2,2026,112,0,2,1,1,41150,16566,3154,22930,1
178,4160,77,34,69,0,0,8,77,3,24,16,29,27,45,114,213,1,387,21,0,2,1,1,41150,16566,3154,22931,0
178,4160,712,438,573,51,9,84,763,14,102,71,128,116,199,733,1364,8,11988,666,0,2,1,1,41160,16567,3154,22932,0
346,6994,1457,730,1242,11,6,188,1468,10,292,166,329,302,495,2424,4078,5,22973,1276,1,2,10,9,41160,16569,3154,22933,0
346,6994,74,35,59,1,0,14,75,3,14,7,14,17,21,58,85,1,128,7,0,2,10,9,41160,16570,3154,22934,0
346,6994,245,125,200,5,7,34,250,7,30,17,34,37,51,166,265,3,1053,58,0,2,10,9,41170,16571,3154,22935,0
78,4037,1457,730,1242,11,6,188,1468,10,292,166,329,302,495,2424,4078,5,22973,1276,1,2,15,0,41170,16573,3154,22936,0
222,4989,722,423,573,19,0,135,741,12,172,101,199,184,300,1320,2257,6,15668,870,0,2,1,1,41170,16575,3154,22938,0
222,4989,1508,847,911,44,250,301,1552,14,148,88,169,162,257,1120,1886,7,15077,837,0,2,1,1,41170,16576,3155,22939,0
16,469,442,244,305,14,16,103,456,11,68,45,75,79,120,452,756,6,4588,254,0,2,1,1,41170,16578,3155,22940,0
16,469,182,102,99,11,40,35,193,3,11,6,11,14,17,42,64,1,97,5,0,2,1,1,41170,16579,3155,22941,0
60,1251,996,429,845,24,10,117,1020,7,76,50,88,83,138,494,879,4,3565,198,0,2,1,1,41170,16581,3155,22942,0
60,1251,456,277,329,12,42,72,468,13,85,50,97,98,147,592,972,7,7212,400,0,2,1,1,41170,16581,3155,22943,0
49,573,647,139,84,35,284,233,682,0,0,0,0,0,0,0,0,0,0,0,0,2,1,1,41170,16581,3155,22944,0
179,4176,77,34,69,0,0,8,77,3,24,16,29,27,45,114,213,1,387,21,0,2,1,1,41170,16581,3155,22945,0
179,4176,712,438,573,51,9,84,763,14,102,71,128,116,199,733,1364,8,11988,666,0,2,1,1,41180,16582,3155,22946,0
70,1304,1020,354,843,12,15,144,1032,8,134,77,144,142,221,970,1580,4,6792,377,0,2,1,1,41180,16582,3155,22947,0
222,4989,722,423,573,19,0,135,741,12,172,101,199,184,300,1320,2257,6,15668,870,0,2,3,3,41180,16584,3155,22949,0
222,4989,1508,847,911,44,250,301,1552,14,148,88,169,162,257,1120,1886,7,15077,837,0,2,3,3,41180,16585,3156,22950,0
335,7115,72,33,56,0,4,12,72,1,1,1,1,2,2,0,2,0,1,0,0,2,1,1,41180,16585,3156,22951,0
335,7115,1454,835,1044,76,110,219,1530,17,275,158,296,292,454,2297,3718,9,34017,1889,1,2,1,1,41190,16586,3156,22952,0
62,1244,1098,241,925,5,10,155,1103,7,46,25,49,53,74,273,423,3,1580,87,0,2,1,1,41200,16588,3156,22953,0
62,1244,282,202,222,14,2,44,296,8,42,24,43,50,67,250,378,4,1548,86,0,2,1,1,41200,16589,3156,22954,0
93,3417,1450,624,1228,12,26,181,1462,14,306,186,354,320,540,2580,4493,8,36391,2021,1,2,1,1,41200,16591,3157,22955,0
148,4073,1660,832,1314,41,38,274,1701,20,312,209,395,332,604,2671,5058,12,64042,3557,1,2,1,1,41200,16593,3158,22957,0
116,4563,1513,682,1277,25,13,200,1538,11,199,116,219,210,335,1557,2584,6,15641,868,0,2,1,1,41200,16595,3158,22958,0
25,1016,373,158,315,8,0,51,381,5,76,44,79,81,123,486,779,2,2026,112,0,2,1,1,41200,16595,3158,22959,0
60,1092,282,196,195,3,0,86,285,8,130,71,141,138,212,936,1507,4,6538,363,0,2,6,6,41200,16595,3159,22960,1
7,114,44,19,17,0,16,11,44,3,14,7,14,17,21,58,85,1,128,7,0,2,1,1,41200,16595,3159,22961,1
3,66,127,75,83,2,11,30,129,4,14,7,14,18,21,61,87,2,175,9,0,2,1,1,41200,16595,3159,22962,1
3,66,652,304,544,16,6,88,668,6,89,51,101,95,152,591,998,3,3399,188,0,2,1,1,41200,16596,3159,22963,1
3,66,2,2,2,0,0,0,2,0,0,0,0,0,0,0,0,0,0,0,0,2,1,1,41200,16596,3159,22963,1
3,66,8,5,5,0,0,3,8,0,0,0,0,0,0,0,0,0,0,0,0,2,1,1,41200,16596,3159,22964,1
3,66,2,2,2,0,0,0,2,0,0,0,0,0,0,0,0,0,0,0,0,2,1,1,41200,16596,3159,22964,1
3,66,14,8,8,0,0,6,14,0,0,0,0,0,0,0,0,0,0,0,0,2,1,1,41200,16596,3159,22965,1
3,66,6,4,4,0,0,2,6,0,0,0,0,0,0,0,0,0,0,0,0,2,1,1,41200,16596,3159,22966,1
3,66,6,4,4,0,0,2,6,1,2,1,2,3,3,2,4,0,2,0,0,2,1,1,41200,16596,3159,22967,1
3,66,6,4,4,0,0,2,6,0,0,0,0,0,0,0,0,0,0,0,0,2,1,1,41200,16596,3159,22968,1
3,66,7,5,5,0,0,2,7,0,0,0,0,0,0,0,0,0,0,0,0,2,1,1,41200,16596,3159,22969,1
3,66,6,4,4,0,0,2,6,0,0,0,0,0,0,0,0,0,0,0,0,2,1,1,41200,16596,3159,22970,1
3,66,10,6,6,0,0,4,10,0,0,0,0,0,0,0,0,0,0,0,0,2,1,1,41200,16596,3159,22971,1
3,66,1,1,1,0,0,0,1,0,0,0,0,0,0,0,0,0,0,0,0,2,1,1,41200,16596,3159,22971,1
3,66,14,10,10,0,0,4,14,1,1,1,1,2,2,0,2,0,1,0,0,2,1,1,41200,16596,3159,22972,1
3,66,46,26,30,3,0,12,49,3,6,3,6,9,9,20,28,1,42,2,0,2,1,1,41210,16596,3159,22973,1
7,301,72,33,56,0,4,12,72,1,1,1,1,2,2,0,2,0,1,0,0,2,1,1,41210,16596,3159,22974,1
3,26,14,7,7,2,0,5,16,0,0,0,0,0,0,0,0,0,0,0,0,2,1,1,41210,16596,3159,22974,1
78,3306,1289,550,1043,56,32,155,1345,10,167,93,185,177,278,1266,2075,5,11498,638,0,2,5,5,41210,16598,3160,22975,1
34,989,182,127,129,0,0,53,182,5,39,21,42,44,63,217,343,2,926,51,0,2,3,3,41210,16598,3161,22976,1
137,6592,1392,870,1177,35,17,170,1427,14,494,280,531,508,811,4473,7289,7,54850,3047,2,2,4,4,41210,16601,3162,22977,1
91,3003,773,419,590,28,0,166,801,10,204,113,217,214,330,1598,2554,5,13587,754,0,2,11,11,41210,16601,3163,22978,1
7,255,75,38,59,1,3,12,76,2,4,2,4,6,6,10,15,1,15,0,0,2,1,1,41210,16601,3163,22979,1
47,2498,520,294,400,33,13,81,553,10,261,204,367,271,571,2128,4614,7,32445,1802,1,2,1,1,41210,16602,3163,22980,1
93,4253,1338,495,1086,10,64,173,1348,11,122,82,157,133,239,883,1686,7,11934,663,0,2,24,24,41210,16604,3163,22981,1
147,6760,139,89,101,2,0,35,141,7,54,34,62,61,96,330,569,4,2287,127,0,2,49,49,41210,16604,3163,22982,1
147,6760,7,5,5,0,0,2,7,1,2,1,2,3,3,2,4,0,2,0,0,2,49,49,41210,16604,3163,22983,1
32,948,465,148,393,5,8,60,470,4,31,20,31,35,51,161,261,2,523,29,0,2,9,9,41210,16605,3163,22984,1
32,948,16,12,9,0,0,6,16,1,2,1,2,3,3,2,4,0,2,0,0,2,9,9,41210,16605,3163,22985,1
109,5462,1782,648,1425,9,47,279,1791,8,171,97,189,179,286,1292,2140,4,9462,525,0,2,16,16,41210,16606,3164,22986,1
20,541,256,139,192,9,7,47,265,4,23,12,24,27,36,112,171,2,357,19,0,2,2,2,41210,16607,3164,22987,1
23,597,102,59,69,5,3,24,107,6,22,15,28,28,43,113,206,3,789,43,0,2,1,1,41210,16607,3164,22988,1
107,4030,1450,624,1228,12,26,181,1462,14,306,186,354,320,540,2580,4493,8,36391,2021,1,2,8,8,41210,16609,3165,22989,1
148,4080,1660,832,1314,41,38,274,1701,20,312,209,395,332,604,2671,5058,12,64042,3557,1,2,5,5,41210,16611,3166,22991,1
116,4587,1513,682,1277,25,13,200,1538,11,199,116,219,210,335,1557,2584,6,15641,868,0,2,8,8,41210,16613,3166,22992,1
59,3302,1296,573,1062,40,33,157,1336,8,201,118,231,209,349,1561,2689,4,12365,686,0,2,19,19,41210,16613,3166,22993,1
76,4022,1457,730,1242,11,6,188,1468,10,292,166,329,302,495,2424,4078,5,22973,1276,1,2,16,16,41210,16615,3166,22994,1
38,2278,652,304,544,16,6,88,668,6,89,51,101,95,152,591,998,3,3399,188,0,2,4,4,41210,16616,3166,22995,1
62,2870,1455,414,1257,16,76,112,1471,5,41,23,46,46,69,231,381,2,1069,59,0,2,9,9,41210,16617,3166,22996,1
82,4156,1523,757,1297,19,12,193,1542,12,193,117,230,205,347,1508,2664,7,19053,1058,0,2,6,6,41220,16619,3166,22997,1
66,2759,1020,354,843,12,15,144,1032,8,134,77,144,142,221,970,1580,4,6792,377,0,2,15,15,41220,16619,3166,22998,1
37,1616,447,308,343,6,5,95,453,7,96,59,111,103,170,651,1136,4,4600,255,0,2,4,4,41220,16622,3166,22999,1
21,653,424,94,331,4,0,89,428,1,5,5,5,6,10,11,25,0,12,0,0,2,5,5,41220,16623,3166,23000,1
40,2355,334,251,279,10,4,40,344,5,127,74,143,132,217,899,1528,2,4303,239,0,2,2,2,41220,16624,3166,23001,1
12,484,184,100,137,2,15,30,186,6,38,20,39,44,59,214,322,3,991,55,0,2,3,3,41220,16625,3166,23002,1
34,1565,1293,570,1093,25,15,163,1318,10,195,123,241,205,364,1516,2795,6,17273,959,0,2,3,3,41230,16627,3166,23003,1
36,1970,384,251,317,7,8,52,391,11,70,44,84,81,128,467,811,6,5355,297,0,2,10,10,41230,16627,3166,23004,1
15,630,722,423,573,19,0,135,741,12,172,101,199,184,300,1320,2257,6,15668,870,0,2,3,3,41230,16629,3166,23006,1
16,1201,215,129,180,6,0,29,221,8,65,43,72,73,115,415,711,4,3153,175,0,2,1,1,41230,16629,3166,23007,1
69,2852,1043,504,840,53,9,147,1096,9,180,112,198,189,310,1377,2344,4,11604,644,0,2,9,9,41230,16631,3166,23008,1
14,520,295,56,236,0,4,54,295,2,9,5,10,11,15,30,51,1,57,3,0,2,8,8,41230,16633,3166,23009,1
25,1019,373,158,315,8,0,51,381,5,76,44,79,81,123,486,779,2,2026,112,0,2,6,6,41230,16633,3166,23010,1
68,2947,1178,367,1042,6,15,115,1184,9,94,51,95,103,146,644,976,4,4439,246,0,2,10,10,41230,16633,3166,23011,1
72,3682,1943,715,1694,26,18,214,1969,12,185,120,237,197,357,1436,2721,7,20915,1161,0,2,13,13,41230,16635,3166,23012,1
14,817,442,244,305,14,16,103,456,11,68,45,75,79,120,452,756,6,4588,254,0,2,2,2,41230,16637,3166,23013,1
48,1776,1098,241,925,5,10,155,1103,7,46,25,49,53,74,273,423,3,1580,87,0,2,2,2,41240,16639,3166,23014,1
60,1092,282,196,195,3,0,86,285,8,130,71,141,138,212,936,1507,4,6538,363,0,2,6,6,41240,16639,3167,23015,0
7,114,44,19,17,0,16,11,44,3,14,7,14,17,21,58,85,1,128,7,0,2,1,1,41240,16639,3167,23016,0
3,66,127,75,83,2,11,30,129,4,14,7,14,18,21,61,87,2,175,9,0,2,1,1,41240,16639,3167,23017,0
3,66,652,304,544,16,6,88,668,6,89,51,101,95,152,591,998,3,3399,188,0,2,1,1,41240,16640,3167,23018,0
3,66,2,2,2,0,0,0,2,0,0,0,0,0,0,0,0,0,0,0,0,2,1,1,41240,16640,3167,23018,0
3,66,8,5,5,0,0,3,8,0,0,0,0,0,0,0,0,0,0,0,0,2,1,1,41240,16640,3167,23019,0
3,66,2,2,2,0,0,0,2,0,0,0,0,0,0,0,0,0,0,0,0,2,1,1,41240,16640,3167,23019,0
3,66,14,8,8,0,0,6,14,0,0,0,0,0,0,0,0,0,0,0,0,2,1,1,41240,16640,3167,23020,0
3,66,6,4,4,0,0,2,6,0,0,0,0,0,0,0,0,0,0,0,0,2,1,1,41240,16640,3167,23021,0
3,66,6,4,4,0,0,2,6,1,2,1,2,3,3,2,4,0,2,0,0,2,1,1,41240,16640,3167,23022,0
3,66,6,4,4,0,0,2,6,0,0,0,0,0,0,0,0,0,0,0,0,2,1,1,41240,16640,3167,23023,0
3,66,7,5,5,0,0,2,7,0,0,0,0,0,0,0,0,0,0,0,0,2,1,1,41240,16640,3167,23024,0
3,66,6,4,4,0,0,2,6,0,0,0,0,0,0,0,0,0,0,0,0,2,1,1,41240,16640,3167,23025,0
3,66,10,6,6,0,0,4,10,0,0,0,0,0,0,0,0,0,0,0,0,2,1,1,41240,16640,3167,23026,0
3,66,1,1,1,0,0,0,1,0,0,0,0,0,0,0,0,0,0,0,0,2,1,1,41240,16640,3167,23026,0
3,66,14,10,10,0,0,4,14,1,1,1,1,2,2,0,2,0,1,0,0,2,1,1,41240,16640,3167,23027,0
3,66,46,26,30,3,0,12,49,3,6,3,6,9,9,20,28,1,42,2,0,2,1,1,41250,16640,3167,23028,0
7,301,72,33,56,0,4,12,72,1,1,1,1,2,2,0,2,0,1,0,0,2,1,1,41250,16640,3167,23029,0
3,26,14,7,7,2,0,5,16,0,0,0,0,0,0,0,0,0,0,0,0,2,1,1,41250,16640,3167,23029,0
78,3306,1289,550,1043,56,32,155,1345,10,167,93,185,177,278,1266,2075,5,11498,638,0,2,5,5,41250,16642,3168,23030,0
34,989,182,127,129,0,0,53,182,5,39,21,42,44,63,217,343,2,926,51,0,2,3,3,41250,16642,3169,23031,0
137,6592,1392,870,1177,35,17,170,1427,14,494,280,531,508,811,4473,7289,7,54850,3047,2,2,4,4,41250,16645,3170,23032,0
91,3003,773,419,590,28,0,166,801,10,204,113,217,214,330,1598,2554,5,13587,754,0,2,11,11,41250,16645,3171,23033,0
7,255,75,38,59,1,3,12,76,2,4,2,4,6,6,10,15,1,15,0,0,2,1,1,41250,16645,3171,23034,0
47,2498,520,294,400,33,13,81,553,10,261,204,367,271,571,2128,4614,7,32445,1802,1,2,1,1,41250,16646,3171,23035,0
93,4253,1338,495,1086,10,64,173,1348,11,122,82,157,133,239,883,1686,7,11934,663,0,2,24,24,41250,16648,3171,23036,0
147,6760,139,89,101,2,0,35,141,7,54,34,62,61,96,330,569,4,2287,127,0,2,49,49,41250,16648,3171,23037,0
147,6760,7,5,5,0,0,2,7,1,2,1,2,3,3,2,4,0,2,0,0,2,49,49,41250,16648,3171,23038,0
32,948,465,148,393,5,8,60,470,4,31,20,31,35,51,161,261,2,523,29,0,2,9,9,41250,16649,3171,23039,0
32,948,16,12,9,0,0,6,16,1,2,1,2,3,3,2,4,0,2,0,0,2,9,9,41250,16649,3171,23040,0
109,5462,1782,648,1425,9,47,279,1791,8,171,97,189,179,286,1292,2140,4,9462,525,0,2,16,16,41250,16650,3172,23041,0
20,541,256,139,192,9,7,47,265,4,23,12,24,27,36,112,171,2,357,19,0,2,2,2,41250,16651,3172,23042,0
23,597,102,59,69,5,3,24,107,6,22,15,28,28,43,113,206,3,789,43,0,2,1,1,41250,16651,3172,23043,0
107,4030,1450,624,1228,12,26,181,1462,14,306,186,354,320,540,2580,4493,8,36391,2021,1,2,8,8,41250,16653,3173,23044,0
148,4080,1660,832,1314,41,38,274,1701,20,312,209,395,332,604,2671,5058,12,64042,3557,1,2,5,5,41250,16655,3174,23046,0
116,4587,1513,682,1277,25,13,200,1538,11,199,116,219,210,335,1557,2584,6,15641,868,0,2,8,8,41250,16657,3174,23047,0
59,3302,1296,573,1062,40,33,157,1336,8,201,118,231,209,349,1561,2689,4,12365,686,0,2,19,19,41250,16657,3174,23048,0
76,4022,1457,730,1242,11,6,188,1468,10,292,166,329,302,495,2424,4078,5,22973,1276,1,2,16,16,41250,16659,3174,23049,0
38,2278,652,304,544,16,6,88,668,6,89,51,101,95,152,591,998,3,3399,188,0,2,4,4,41250,16660,3174,23050,0
62,2870,1455,414,1257,16,76,112,1471,5,41,23,46,46,69,231,381,2,1069,59,0,2,9,9,41250,16661,3174,23051,0
82,4156,1523,757,1297,19,12,193,1542,12,193,117,230,205,347,1508,2664,7,19053,1058,0,2,6,6,41260,16663,3174,23052,0
66,2759,1020,354,843,12,15,144,1032,8,134,77,144,142,221,970,1580,4,6792,377,0,2,15,15,41260,16663,3174,23053,0
37,1616,447,308,343,6,5,95,453,7,96,59,111,103,170,651,1136,4,4600,255,0,2,4,4,41260,16666,3174,23054,0
21,653,424,94,331,4,0,89,428,1,5,5,5,6,10,11,25,0,12,0,0,2,5,5,41260,16667,3174,23055,0
40,2355,334,251,279,10,4,40,344,5,127,74,143,132,217,899,1528,2,4303,239,0,2,2,2,41260,16668,3174,23056,0
12,484,184,100,137,2,15,30,186,6,38,20,39,44,59,214,322,3,991,55,0,2,3,3,41260,16669,3174,23057,0
34,1565,1293,570,1093,25,15,163,1318,10,195,123,241,205,364,1516,2795,6,17273,959,0,2,3,3,41270,16671,3174,23058,0
36,1970,384,251,317,7,8,52,391,11,70,44,84,81,128,467,811,6,5355,297,0,2,10,10,41270,16671,3174,23059,0
15,630,722,423,573,19,0,135,741,12,172,101,199,184,300,1320,2257,6,15668,870,0,2,3,3,41270,16673,3174,23061,0
16,1201,215,129,180,6,0,29,221,8,65,43,72,73,115,415,711,4,3153,175,0,2,1,1,41270,16673,3174,23062,0
69,2852,1043,504,840,53,9,147,1096,9,180,112,198,189,310,1377,2344,4,11604,644,0,2,9,9,41270,16675,3174,23063,0
14,520,295,56,236,0,4,54,295,2,9,5,10,11,15,30,51,1,57,3,0,2,8,8,41270,16677,3174,23064,0
25,1019,373,158,315,8,0,51,381,5,76,44,79,81,123,486,779,2,2026,112,0,2,6,6,41270,16677,3174,23065,0
68,2947,1178,367,1042,6,15,115,1184,9,94,51,95,103,146,644,976,4,4439,246,0,2,10,10,41270,16677,3174,23066,0
72,3682,1943,715,1694,26,18,214,1969,12,185,120,237,197,357,1436,2721,7,20915,1161,0,2,13,13,41270,16679,3174,23067,0
14,817,442,244,305,14,16,103,456,11,68,45,75,79,120,452,756,6,4588,254,0,2,2,2,41270,16681,3174,23068,0
48,1776,1098,241,925,5,10,155,1103,7,46,25,49,53,74,273,423,3,1580,87,0,2,2,2,41280,16683,3174,23069,0
49,573,647,139,84,35,284,233,682,0,0,0,0,0,0,0,0,0,0,0,0,2,1,1,41280,16683,3174,23070,0
49,573,647,139,84,35,284,233,682,0,0,0,0,0,0,0,0,0,0,0,0,2,8,1,41280,16683,3174,23071,0
49,573,647,139,84,35,284,233,682,0,0,0,0,0,0,0,0,0,0,0,0,2,9,2,41280,16683,3174,23072,0
9,223,19,8,11,5,0,4,24,2,5,3,6,7,9,13,25,1,30,1,0,2,1,1,41280,16683,3174,23073,0
9,223,102,59,69,5,3,24,107,6,22,15,28,28,43,113,206,3,789,43,0,2,1,1,41280,16683,3174,23074,0
9,223,106,40,36,3,49,17,109,8,17,13,23,25,36,93,167,5,904,50,0,2,1,1,41280,16683,3174,23075,0
99,2075,773,419,590,28,0,166,801,10,204,113,217,214,330,1598,2554,5,13587,754,0,2,0,9,41280,16683,3175,23076,0
99,2075,421,273,302,44,34,57,465,17,81,59,107,98,166,583,1098,11,12329,684,0,2,0,9,41280,16683,3176,23077,0
28,548,2,2,2,0,0,0,2,0,0,0,0,0,0,0,0,0,0,0,0,2,2,2,41280,16683,3176,23077,0
28,548,99,48,90,1,3,5,100,0,0,0,0,0,0,0,0,0,0,0,0,2,2,2,41280,16684,3176,23078,0
28,548,8,5,5,2,0,1,10,0,0,0,0,0,0,0,0,0,0,0,0,2,2,2,41280,16684,3176,23079,0
28,548,1217,716,841,84,126,174,1301,14,185,118,215,199,333,1446,2542,8,20687,1149,0,2,2,2,41290,16686,3176,23080,0
28,548,160,89,115,0,13,31,160,7,15,11,17,22,28,78,124,3,495,27,0,2,2,2,41290,16686,3176,23081,0
28,548,10,10,9,9,0,0,19,0,0,0,0,0,0,0,0,0,0,0,0,2,2,2,41290,16686,3177,23082,0
28,548,173,84,99,8,29,36,181,5,12,7,13,17,20,54,81,2,221,12,0,2,2,2,41290,16687,3177,23083,0
28,548,3,1,1,3,0,0,6,0,0,0,0,0,0,0,0,0,0,0,0,2,2,2,41290,16687,3177,23084,0
162,5067,1660,832,1314,41,38,274,1701,20,312,209,395,332,604,2671,5058,12,64042,3557,1,2,10,6,41290,16689,3178,23086,0
162,5067,1057,646,719,113,100,145,1170,18,215,134,248,233,382,1740,3004,10,31186,1732,1,2,10,6,41300,16690,3179,23087,0
60,1254,996,429,845,24,10,117,1020,7,76,50,88,83,138,494,879,4,3565,198,0,2,1,1,41300,16692,3179,23088,0
60,1254,456,277,329,12,42,72,468,13,85,50,97,98,147,592,972,7,7212,400,0,2,1,1,41300,16692,3179,23089,0
119,2420,1513,682,1277,25,13,200,1538,11,199,116,219,210,335,1557,2584,6,15641,868,0,2,6,6,41300,16694,3179,23090,0
119,2420,819,519,539,24,98,155,843,15,96,57,106,111,163,690,1107,8,9171,509,0,2,6,6,41310,16696,3179,23091,0
48,948,207,111,150,11,0,50,218,5,26,19,36,31,55,133,272,3,943,52,0,2,29,8,41310,16696,3179,23092,0
48,948,410,198,237,31,55,97,441,11,63,38,72,74,110,414,683,6,4293,238,0,2,29,8,41320,16697,3180,23093,0
346,7005,1457,730,1242,11,6,188,1468,10,292,166,329,302,495,2424,4078,5,22973,1276,1,2,87,33,41320,16699,3180,23094,0
346,7005,74,35,59,1,0,14,75,3,14,7,14,17,21,58,85,1,128,7,0,2,87,33,41320,16700,3180,23095,0
346,7005,245,125,200,5,7,34,250,7,30,17,34,37,51,166,265,3,1053,58,0,2,87,33,41330,16701,3180,23096,0
22,679,339,213,244,17,9,65,356,10,42,26,48,52,74,259,421,5,2410,133,0,2,2,2,41340,16701,3180,23097,0
56,1599,1455,414,1257,16,76,112,1471,5,41,23,46,46,69,231,381,2,1069,59,0,2,3,2,41340,16702,3180,23098,0
56,1599,669,365,481,22,61,110,691,15,103,63,122,118,185,747,1273,8,11311,628,0,2,3,2,41350,16702,3181,23099,0
228,5119,4293,999,3693,19,54,507,4312,9,155,88,170,164,258,1156,1898,4,9368,520,0,2,6,6,41350,16704,3181,23100,0
228,5119,1482,859,1002,125,135,219,1607,16,219,134,251,235,385,1766,3032,9,27804,1544,1,2,6,6,41360,16705,3181,23101,0
24,834,74,35,59,1,0,14,75,3,14,7,14,17,21,58,85,1,128,7,0,2,1,1,41360,16706,3181,23102,0
24,834,245,125,200,5,7,34,250,7,30,17,34,37,51,166,265,3,1053,58,0,2,1,1,41370,16707,3181,23103,0
49,575,647,139,84,35,284,233,682,0,0,0,0,0,0,0,0,0,0,0,0,2,2,1,41370,16707,3181,23104,0
72,2129,1523,757,1297,19,12,193,1542,12,193,117,230,205,347,1508,2664,7,19053,1058,0,2,3,0,41380,16709,3181,23105,0
72,2129,701,378,504,33,58,109,734,13,110,68,126,123,194,794,1346,7,10027,557,0,2,3,0,41380,16710,3182,23106,0
178,4160,77,34,69,0,0,8,77,3,24,16,29,27,45,114,213,1,387,21,0,2,49,40,41380,16710,3182,23107,0
178,4160,712,438,573,51,9,84,763,14,102,71,128,116,199,733,1364,8,11988,666,0,2,49,40,41390,16711,3182,23108,0
69,1359,1020,354,843,12,15,144,1032,8,134,77,144,142,221,970,1580,4,6792,377,0,2,4,4,41390,16711,3182,23109,0
46,951,447,308,343,6,5,95,453,7,96,59,111,103,170,651,1136,4,4600,255,0,2,5,5,41390,16714,3182,23110,0
46,951,322,174,179,16,74,51,338,10,41,26,46,51,72,252,408,5,2291,127,0,2,5,5,41390,16717,3183,23111,0
223,5060,722,423,573,19,0,135,741,12,172,101,199,184,300,1320,2257,6,15668,870,0,2,18,16,41390,16719,3183,23113,0
223,5060,1508,847,911,44,250,301,1552,14,148,88,169,162,257,1120,1886,7,15077,837,0,2,18,16,41390,16720,3184,23114,0
337,7189,72,33,56,0,4,12,72,1,1,1,1,2,2,0,2,0,1,0,0,2,38,17,41390,16720,3184,23115,0
337,7189,1454,835,1044,76,110,219,1530,17,275,158,296,292,454,2297,3718,9,34017,1889,1,2,38,17,41400,16721,3184,23116,0
41,943,386,256,301,16,9,68,402,4,59,35,69,63,104,355,621,2,1453,80,0,2,6,2,41400,16721,3184,23117,0
41,943,264,131,164,11,41,46,275,6,38,22,40,44,62,214,338,3,1068,59,0,2,6,2,41410,16721,3185,23118,0
128,2818,1043,504,840,53,9,147,1096,9,180,112,198,189,310,1377,2344,4,11604,644,0,2,2,2,41410,16723,3185,23119,0
128,2818,383,288,292,26,6,62,409,11,65,38,67,76,105,429,656,5,3719,206,0,2,2,2,41410,16724,3185,23120,0
20,400,294,64,250,0,0,43,294,1,20,10,20,21,30,86,131,0,65,3,0,2,2,2,41410,16724,3185,23121,0
20,400,78,46,62,3,0,14,81,3,8,4,8,11,12,28,41,1,62,3,0,2,2,2,41410,16725,3185,23122,0
103,1959,1178,367,1042,6,15,115,1184,9,94,51,95,103,146,644,976,4,4439,246,0,2,2,2,41410,16725,3185,23123,0
103,1959,177,108,140,8,0,27,185,6,30,16,32,36,48,162,248,3,794,44,0,2,2,2,41410,16727,3185,23124,0
184,3747,1943,715,1694,26,18,214,1969,12,185,120,237,197,357,1436,2721,7,20915,1161,0,2,2,2,41410,16729,3185,23125,0
184,3747,1168,838,957,57,25,144,1225,19,348,224,416,367,640,3018,5452,11,61921,3440,1,2,2,2,41420,16731,3185,23126,0
16,471,442,244,305,14,16,103,456,11,68,45,75,79,120,452,756,6,4588,254,0,2,1,1,41420,16733,3185,23127,0
16,471,182,102,99,11,40,35,193,3,11,6,11,14,17,42,64,1,97,5,0,2,1,1,41420,16734,3185,23128,0
1,300,382,65,130,157,2,92,539,4,10,5,10,14,15,41,57,2,114,6,0,2,1,1,41420,16735,3186,23129,0
60,1092,282,196,195,3,0,86,285,8,130,71,141,138,212,936,1507,4,6538,363,0,2,6,6,41420,16735,3187,23130,0
7,114,44,19,17,0,16,11,44,3,14,7,14,17,21,58,85,1,128,7,0,2,1,1,41420,16735,3187,23131,0
3,66,127,75,83,2,11,30,129,4,14,7,14,18,21,61,87,2,175,9,0,2,1,1,41420,16735,3187,23132,0
3,66,652,304,544,16,6,88,668,6,89,51,101,95,152,591,998,3,3399,188,0,2,1,1,41420,16736,3187,23133,0
3,66,2,2,2,0,0,0,2,0,0,0,0,0,0,0,0,0,0,0,0,2,1,1,41420,16736,3187,23133,0
3,66,8,5,5,0,0,3,8,0,0,0,0,0,0,0,0,0,0,0,0,2,1,1,41420,16736,3187,23134,0
3,66,2,2,2,0,0,0,2,0,0,0,0,0,0,0,0,0,0,0,0,2,1,1,41420,16736,3187,23134,0
3,66,14,8,8,0,0,6,14,0,0,0,0,0,0,0,0,0,0,0,0,2,1,1,41420,16736,3187,23135,0
3,66,6,4,4,0,0,2,6,0,0,0,0,0,0,0,0,0,0,0,0,2,1,1,41420,16736,3187,23136,0
3,66,6,4,4,0,0,2,6,1,2,1,2,3,3,2,4,0,2,0,0,2,1,1,41420,16736,3187,23137,0
3,66,6,4,4,0,0,2,6,0,0,0,0,0,0,0,0,0,0,0,0,2,1,1,41420,16736,3187,23138,0
3,66,7,5,5,0,0,2,7,0,0,0,0,0,0,0,0,0,0,0,0,2,1,1,41420,16736,3187,23139,0
3,66,6,4,4,0,0,2,6,0,0,0,0,0,0,0,0,0,0,0,0,2,1,1,41420,16736,3187,23140,0
3,66,10,6,6,0,0,4,10,0,0,0,0,0,0,0,0,0,0,0,0,2,1,1,41420,16736,3187,23141,0
3,66,1,1,1,0,0,0,1,0,0,0,0,0,0,0,0,0,0,0,0,2,1,1,41420,16736,3187,23141,0
3,66,14,10,10,0,0,4,14,1,1,1,1,2,2,0,2,0,1,0,0,2,1,1,41420,16736,3187,23142,0
3,66,46,26,30,3,0,12,49,3,6,3,6,9,9,20,28,1,42,2,0,2,1,1,41430,16736,3187,23143,0
7,301,72,33,56,0,4,12,72,1,1,1,1,2,2,0,2,0,1,0,0,2,1,1,41430,16736,3187,23144,0
3,26,14,7,7,2,0,5,16,0,0,0,0,0,0,0,0,0,0,0,0,2,1,1,41430,16736,3187,23144,0
14,472,42,7,35,4,0,5,46,1,2,1,2,3,3,2,4,0,2,0,0,2,2,3,41430,16736,3187,23145,0
14,472,11,6,10,0,0,1,11,2,4,2,4,6,6,10,15,1,15,0,0,2,2,3,41430,16736,3187,23146,0
78,3306,1289,550,1043,56,32,155,1345,10,167,93,185,177,278,1266,2075,5,11498,638,0,2,5,5,41430,16738,3188,23147,0
34,989,182,127,129,0,0,53,182,5,39,21,42,44,63,217,343,2,926,51,0,2,3,3,41430,16738,3189,23148,0
137,6592,1392,870,1177,35,17,170,1427,14,494,280,531,508,811,4473,7289,7,54850,3047,2,2,4,4,41430,16741,3190,23149,0
91,3003,773,419,590,28,0,166,801,10,204,113,217,214,330,1598,2554,5,13587,754,0,2,11,11,41430,16741,3191,23150,0
7,255,75,38,59,1,3,12,76,2,4,2,4,6,6,10,15,1,15,0,0,2,1,1,41430,16741,3191,23151,0
47,2498,520,294,400,33,13,81,553,10,261,204,367,271,571,2128,4614,7,32445,1802,1,2,34,8,41430,16742,3191,23152,0
93,4253,1338,495,1086,10,64,173,1348,11,122,82,157,133,239,883,1686,7,11934,663,0,2,24,24,41430,16744,3191,23153,0
147,6760,139,89,101,2,0,35,141,7,54,34,62,61,96,330,569,4,2287,127,0,2,49,49,41430,16744,3191,23154,0
147,6760,7,5,5,0,0,2,7,1,2,1,2,3,3,2,4,0,2,0,0,2,49,49,41430,16744,3191,23155,0
32,948,465,148,393,5,8,60,470,4,31,20,31,35,51,161,261,2,523,29,0,2,9,9,41430,16745,3191,23156,0
32,948,16,12,9,0,0,6,16,1,2,1,2,3,3,2,4,0,2,0,0,2,9,9,41430,16745,3191,23157,0
109,5462,1782,648,1425,9,47,279,1791,8,171,97,189,179,286,1292,2140,4,9462,525,0,2,88,25,41430,16746,3192,23158,0
20,541,256,139,192,9,7,47,265,4,23,12,24,27,36,112,171,2,357,19,0,2,17,2,41430,16747,3192,23159,0
23,597,102,59,69,5,3,24,107,6,22,15,28,28,43,113,206,3,789,43,0,2,1,1,41430,16747,3192,23160,0
107,4030,1450,624,1228,12,26,181,1462,14,306,186,354,320,540,2580,4493,8,36391,2021,1,2,25,8,41430,16749,3193,23161,0
148,4080,1660,832,1314,41,38,274,1701,20,312,209,395,332,604,2671,5058,12,64042,3557,1,2,62,5,41430,16751,3194,23163,0
116,4587,1513,682,1277,25,13,200,1538,11,199,116,219,210,335,1557,2584,6,15641,868,0,2,8,8,41430,16753,3194,23164,0
59,3302,1296,573,1062,40,33,157,1336,8,201,118,231,209,349,1561,2689,4,12365,686,0,2,34,18,41430,16753,3194,23165,0
10,228,207,111,150,11,0,50,218,5,26,19,36,31,55,133,272,3,943,52,0,0,75,0,41430,16753,3194,23166,0
76,4022,1457,730,1242,11,6,188,1468,10,292,166,329,302,495,2424,4078,5,22973,1276,1,2,72,17,41430,16755,3194,23167,0
38,2278,652,304,544,16,6,88,668,6,89,51,101,95,152,591,998,3,3399,188,0,2,29,4,41430,16756,3194,23168,0
62,2870,1455,414,1257,16,76,112,1471,5,41,23,46,46,69,231,381,2,1069,59,0,2,41,12,41430,16757,3194,23169,0
82,4156,1523,757,1297,19,12,193,1542,12,193,117,230,205,347,1508,2664,7,19053,1058,0,2,22,6,41440,16759,3194,23170,0
66,2759,1020,354,843,12,15,144,1032,8,134,77,144,142,221,970,1580,4,6792,377,0,2,15,15,41440,16759,3194,23171,0
37,1616,447,308,343,6,5,95,453,7,96,59,111,103,170,651,1136,4,4600,255,0,2,8,14,41440,16762,3194,23172,0
21,653,424,94,331,4,0,89,428,1,5,5,5,6,10,11,25,0,12,0,0,2,5,5,41440,16763,3194,23173,0
40,2355,334,251,279,10,4,40,344,5,127,74,143,132,217,899,1528,2,4303,239,0,2,2,2,41440,16764,3194,23174,0
12,484,184,100,137,2,15,30,186,6,38,20,39,44,59,214,322,3,991,55,0,2,3,3,41440,16765,3194,23175,0
34,1565,1293,570,1093,25,15,163,1318,10,195,123,241,205,364,1516,2795,6,17273,959,0,2,3,3,41450,16767,3194,23176,0
36,1970,384,251,317,7,8,52,391,11,70,44,84,81,128,467,811,6,5355,297,0,2,31,11,41450,16767,3194,23177,0
15,630,722,423,573,19,0,135,741,12,172,101,199,184,300,1320,2257,6,15668,870,0,2,10,3,41450,16769,3194,23179,0
31,1490,386,256,301,16,9,68,402,4,59,35,69,63,104,355,621,2,1453,80,0,2,50,6,41450,16769,3194,23180,0
16,1201,215,129,180,6,0,29,221,8,65,43,72,73,115,415,711,4,3153,175,0,2,1,1,41450,16769,3194,23181,0
69,2852,1043,504,840,53,9,147,1096,9,180,112,198,189,310,1377,2344,4,11604,644,0,2,9,9,41450,16771,3194,23182,0
14,520,295,56,236,0,4,54,295,2,9,5,10,11,15,30,51,1,57,3,0,2,8,8,41450,16773,3194,23183,0
25,1019,373,158,315,8,0,51,381,5,76,44,79,81,123,486,779,2,2026,112,0,2,6,6,41450,16773,3194,23184,0
68,2947,1178,367,1042,6,15,115,1184,9,94,51,95,103,146,644,976,4,4439,246,0,2,10,10,41450,16773,3194,23185,0
72,3682,1943,715,1694,26,18,214,1969,12,185,120,237,197,357,1436,2721,7,20915,1161,0,2,13,13,41450,16775,3194,23186,0
14,817,442,244,305,14,16,103,456,11,68,45,75,79,120,452,756,6,4588,254,0,2,2,2,41450,16777,3194,23187,0
48,1776,1098,241,925,5,10,155,1103,7,46,25,49,53,74,273,423,3,1580,87,0,2,2,2,41460,16779,3194,23188,0
14,367,601,196,481,2,23,85,603,8,63,36,72,71,108,400,664,4,3036,168,0,2,5,23,41460,16779,3194,23189,1
14,367,156,79,106,5,16,28,161,5,14,8,15,19,23,64,97,2,261,14,0,2,5,23,41460,16779,3194,23190,1
8,213,601,196,481,2,23,85,603,8,63,36,72,71,108,400,664,4,3036,168,0,2,3,3,41460,16779,3194,23191,1
71,2109,1523,757,1297,19,12,193,1542,12,193,117,230,205,347,1508,2664,7,19053,1058,0,2,4,5,41470,16781,3194,23192,0
71,2109,701,378,504,33,58,109,734,13,110,68,126,123,194,794,1346,7,10027,557,0,2,4,5,41470,16782,3195,23193,0
82,4086,1523,757,1297,19,12,193,1542,12,193,117,230,205,347,1508,2664,7,19053,1058,0,2,19,0,41480,16784,3195,23194,0
71,2109,1523,757,1297,19,12,193,1542,12,193,117,230,205,347,1508,2664,7,19053,1058,0,2,4,5,41490,16786,3195,23195,0
71,2109,701,378,504,33,58,109,734,13,110,68,126,123,194,794,1346,7,10027,557,0,2,4,5,41490,16787,3196,23196,0
82,4086,1523,757,1297,19,12,193,1542,12,193,117,230,205,347,1508,2664,7,19053,1058,0,2,19,0,41500,16789,3196,23197,0
119,2420,1513,682,1277,25,13,200,1538,11,199,116,219,210,335,1557,2584,6,15641,868,0,2,2,2,41500,16791,3196,23198,1
119,2420,819,519,539,24,98,155,843,15,96,57,106,111,163,690,1107,8,9171,509,0,2,2,2,41510,16793,3196,23199,1
50,1024,207,111,150,11,0,50,218,5,26,19,36,31,55,133,272,3,943,52,0,2,16,0,41510,16793,3196,23200,1
50,1024,410,198,237,31,55,97,441,11,63,38,72,74,110,414,683,6,4293,238,0,2,16,0,41520,16794,3197,23201,1
117,4639,1513,682,1277,25,13,200,1538,11,199,116,219,210,335,1557,2584,6,15641,868,0,2,18,6,41520,16796,3197,23202,1
223,5077,722,423,573,19,0,135,741,12,172,101,199,184,300,1320,2257,6,15668,870,0,2,5,2,41520,16798,3197,23204,0
223,5077,1508,847,911,44,250,301,1552,14,148,88,169,162,257,1120,1886,7,15077,837,0,2,5,2,41520,16799,3198,23205,0
119,2420,1513,682,1277,25,13,200,1538,11,199,116,219,210,335,1557,2584,6,15641,868,0,2,2,2,41520,16801,3198,23206,0
119,2420,819,519,539,24,98,155,843,15,96,57,106,111,163,690,1107,8,9171,509,0,2,2,2,41530,16803,3198,23207,0
50,1024,207,111,150,11,0,50,218,5,26,19,36,31,55,133,272,3,943,52,0,2,16,0,41530,16803,3198,23208,0
50,1024,410,198,237,31,55,97,441,11,63,38,72,74,110,414,683,6,4293,238,0,2,16,0,41540,16804,3199,23209,0
223,5077,722,423,573,19,0,135,741,12,172,101,199,184,300,1320,2257,6,15668,870,0,2,5,2,41540,16806,3199,23211,0
223,5077,1508,847,911,44,250,301,1552,14,148,88,169,162,257,1120,1886,7,15077,837,0,2,5,2,41540,16807,3200,23212,0
117,4639,1513,682,1277,25,13,200,1538,11,199,116,219,210,335,1557,2584,6,15641,868,0,2,18,6,41540,16809,3200,23213,0
60,1251,996,429,845,24,10,117,1020,7,76,50,88,83,138,494,879,4,3565,198,0,2,1,1,41540,16811,3200,23214,0
60,1251,456,277,329,12,42,72,468,13,85,50,97,98,147,592,972,7,7212,400,0,2,1,1,41540,16811,3200,23215,0
346,6994,1457,730,1242,11,6,188,1468,10,292,166,329,302,495,2424,4078,5,22973,1276,1,2,10,9,41540,16813,3200,23216,0
346,6994,74,35,59,1,0,14,75,3,14,7,14,17,21,58,85,1,128,7,0,2,10,9,41540,16814,3200,23217,0
346,6994,245,125,200,5,7,34,250,7,30,17,34,37,51,166,265,3,1053,58,0,2,10,9,41550,16815,3200,23218,0
49,573,647,139,84,35,284,233,682,0,0,0,0,0,0,0,0,0,0,0,0,2,10,3,41550,16815,3200,23219,0
71,2109,1523,757,1297,19,12,193,1542,12,193,117,230,205,347,1508,2664,7,19053,1058,0,2,4,5,41560,16817,3200,23220,0
71,2109,701,378,504,33,58,109,734,13,110,68,126,123,194,794,1346,7,10027,557,0,2,4,5,41560,16818,3201,23221,0
179,4176,77,34,69,0,0,8,77,3,24,16,29,27,45,114,213,1,387,21,0,2,1,1,41560,16818,3201,23222,0
179,4176,712,438,573,51,9,84,763,14,102,71,128,116,199,733,1364,8,11988,666,0,2,1,1,41570,16819,3201,23223,0
70,1304,1020,354,843,12,15,144,1032,8,134,77,144,142,221,970,1580,4,6792,377,0,2,1,1,41570,16819,3201,23224,0
222,4989,722,423,573,19,0,135,741,12,172,101,199,184,300,1320,2257,6,15668,870,0,2,4,4,41570,16821,3201,23226,0
222,4989,1508,847,911,44,250,301,1552,14,148,88,169,162,257,1120,1886,7,15077,837,0,2,4,4,41570,16822,3202,23227,0
335,7115,72,33,56,0,4,12,72,1,1,1,1,2,2,0,2,0,1,0,0,2,1,1,41570,16822,3202,23228,0
335,7115,1454,835,1044,76,110,219,1530,17,275,158,296,292,454,2297,3718,9,34017,1889,1,2,1,1,41580,16823,3202,23229,0
16,469,442,244,305,14,16,103,456,11,68,45,75,79,120,452,756,6,4588,254,0,2,1,1,41580,16825,3202,23230,0
16,469,182,102,99,11,40,35,193,3,11,6,11,14,17,42,64,1,97,5,0,2,1,1,41580,16826,3202,23231,0
62,1244,1098,241,925,5,10,155,1103,7,46,25,49,53,74,273,423,3,1580,87,0,2,1,1,41590,16828,3202,23232,0
62,1244,282,202,222,14,2,44,296,8,42,24,43,50,67,250,378,4,1548,86,0,2,1,1,41590,16829,3202,23233,0
93,3417,1450,624,1228,12,26,181,1462,14,306,186,354,320,540,2580,4493,8,36391,2021,1,2,1,1,41590,16831,3203,23234,0
148,4073,1660,832,1314,41,38,274,1701,20,312,209,395,332,604,2671,5058,12,64042,3557,1,2,1,1,41590,16833,3204,23236,0
116,4563,1513,682,1277,25,13,200,1538,11,199,116,219,210,335,1557,2584,6,15641,868,0,2,1,1,41590,16835,3204,23237,0
78,4037,1457,730,1242,11,6,188,1468,10,292,166,329,302,495,2424,4078,5,22973,1276,1,2,15,0,41590,16837,3204,23238,0
82,4086,1523,757,1297,19,12,193,1542,12,193,117,230,205,347,1508,2664,7,19053,1058,0,2,19,0,41600,16839,3204,23239,0
25,1016,373,158,315,8,0,51,381,5,76,44,79,81,123,486,779,2,2026,112,0,2,1,1,41600,16839,3204,23240,0
163,5074,1660,832,1314,41,38,274,1701,20,312,209,395,332,604,2671,5058,12,64042,3557,1,2,2,1,41600,16841,3205,23242,0
163,5074,1057,646,719,113,100,145,1170,18,215,134,248,233,382,1740,3004,10,31186,1732,1,2,2,1,41610,16842,3206,23243,0
83,2325,1523,757,1297,19,12,193,1542,12,193,117,230,205,347,1508,2664,7,19053,1058,0,2,36,2,41620,16844,3206,23244,1
83,2325,701,378,504,33,58,109,734,13,110,68,126,123,194,794,1346,7,10027,557,0,2,36,2,41620,16845,3207,23245,1
86,4261,1523,757,1297,19,12,193,1542,12,193,117,230,205,347,1508,2664,7,19053,1058,0,2,23,0,41630,16847,3207,23246,1
83,2325,1523,757,1297,19,12,193,1542,12,193,117,230,205,347,1508,2664,7,19053,1058,0,2,36,2,41640,16849,3207,23247,0
83,2325,701,378,504,33,58,109,734,13,110,68,126,123,194,794,1346,7,10027,557,0,2,36,2,41640,16850,3208,23248,0
86,4261,1523,757,1297,19,12,193,1542,12,193,117,230,205,347,1508,2664,7,19053,1058,0,2,23,0,41650,16852,3208,23249,0
211,4515,182,127,129,0,0,53,182,5,39,21,42,44,63,217,343,2,926,51,0,2,4,2,41650,16852,3209,23250,1
211,4515,1165,710,800,67,119,181,1232,18,243,153,282,261,435,2000,3492,10,36473,2026,1,2,4,2,41660,16852,3210,23251,1
95,3480,1450,624,1228,12,26,181,1462,14,306,186,354,320,540,2580,4493,8,36391,2021,1,2,19,0,41660,16854,3211,23252,1
211,4515,182,127,129,0,0,53,182,5,39,21,42,44,63,217,343,2,926,51,0,2,4,2,41660,16854,3212,23253,0
211,4515,1165,710,800,67,119,181,1232,18,243,153,282,261,435,2000,3492,10,36473,2026,1,2,4,2,41670,16854,3213,23254,0
95,3480,1450,624,1228,12,26,181,1462,14,306,186,354,320,540,2580,4493,8,36391,2021,1,2,19,0,41670,16856,3214,23255,0
185,3749,1943,715,1694,26,18,214,1969,12,185,120,237,197,357,1436,2721,7,20915,1161,0,2,12,10,41670,16858,3214,23256,1
185,3749,1168,838,957,57,25,144,1225,19,348,224,416,367,640,3018,5452,11,61921,3440,1,2,12,10,41680,16860,3214,23257,1
13,319,601,196,481,2,23,85,603,8,63,36,72,71,108,400,664,4,3036,168,0,2,2,8,41680,16860,3214,23258,1
13,319,156,79,106,5,16,28,161,5,14,8,15,19,23,64,97,2,261,14,0,2,2,8,41680,16860,3214,23259,1
8,214,601,196,481,2,23,85,603,8,63,36,72,71,108,400,664,4,3036,168,0,2,7,7,41680,16860,3214,23260,1
16,383,601,196,481,2,23,85,603,8,63,36,72,71,108,400,664,4,3036,168,0,2,29,3,41680,16860,3214,23261,1
16,383,156,79,106,5,16,28,161,5,14,8,15,19,23,64,97,2,261,14,0,2,29,3,41680,16860,3214,23262,1
9,258,601,196,481,2,23,85,603,8,63,36,72,71,108,400,664,4,3036,168,0,2,28,0,41680,16860,3214,23263,1
185,3749,1943,715,1694,26,18,214,1969,12,185,120,237,197,357,1436,2721,7,20915,1161,0,2,3,3,41680,16862,3214,23264,0
185,3749,1168,838,957,57,25,144,1225,19,348,224,416,367,640,3018,5452,11,61921,3440,1,2,3,3,41690,16864,3214,23265,0
185,3775,1943,715,1694,26,18,214,1969,12,185,120,237,197,357,1436,2721,7,20915,1161,0,2,12,10,41690,16866,3214,23266,1
185,3775,1168,838,957,57,25,144,1225,19,348,224,416,367,640,3018,5452,11,61921,3440,1,2,12,10,41700,16868,3214,23267,1
16,377,601,196,481,2,23,85,603,8,63,36,72,71,108,400,664,4,3036,168,0,2,1,1,41700,16868,3214,23268,1
16,377,156,79,106,5,16,28,161,5,14,8,15,19,23,64,97,2,261,14,0,2,1,1,41700,16868,3214,23269,1
9,317,601,196,481,2,23,85,603,8,63,36,72,71,108,400,664,4,3036,168,0,2,31,10,41700,16868,3214,23270,1
184,3743,1943,715,1694,26,18,214,1969,12,185,120,237,197,357,1436,2721,7,20915,1161,0,2,2,2,41700,16870,3214,23271,0
184,3743,1168,838,957,57,25,144,1225,19,348,224,416,367,640,3018,5452,11,61921,3440,1,2,2,2,41710,16872,3214,23272,0
78,4037,1457,730,1242,11,6,188,1468,10,292,166,329,302,495,2424,4078,5,22973,1276,1,2,1,1,41710,16874,3214,23273,0
73,3706,1943,715,1694,26,18,214,1969,12,185,120,237,197,357,1436,2721,7,20915,1161,0,2,9,0,41710,16876,3214,23274,0
184,3743,1943,715,1694,26,18,214,1969,12,185,120,237,197,357,1436,2721,7,20915,1161,0,2,2,2,41710,16878,3214,23275,0
184,3743,1168,838,957,57,25,144,1225,19,348,224,416,367,640,3018,5452,11,61921,3440,1,2,2,2,41720,16880,3214,23276,0
78,4037,1457,730,1242,11,6,188,1468,10,292,166,329,302,495,2424,4078,5,22973,1276,1,2,1,1,41720,16882,3214,23277,0
73,3706,1943,715,1694,26,18,214,1969,12,185,120,237,197,357,1436,2721,7,20915,1161,0,2,9,0,41720,16884,3214,23278,0
211,4515,182,127,129,0,0,53,182,5,39,21,42,44,63,217,343,2,926,51,0,2,4,2,41720,16884,3215,23279,0
211,4515,1165,710,800,67,119,181,1232,18,243,153,282,261,435,2000,3492,10,36473,2026,1,2,4,2,41730,16884,3216,23280,0
163,5074,1660,832,1314,41,38,274,1701,20,312,209,395,332,604,2671,5058,12,64042,3557,1,2,2,1,41730,16886,3217,23282,0
163,5074,1057,646,719,113,100,145,1170,18,215,134,248,233,382,1740,3004,10,31186,1732,1,2,2,1,41740,16887,3218,23283,0
60,1254,996,429,845,24,10,117,1020,7,76,50,88,83,138,494,879,4,3565,198,0,2,1,1,41740,16889,3218,23284,0
60,1254,456,277,329,12,42,72,468,13,85,50,97,98,147,592,972,7,7212,400,0,2,1,1,41740,16889,3218,23285,0
346,7009,1457,730,1242,11,6,188,1468,10,292,166,329,302,495,2424,4078,5,22973,1276,1,2,10,9,41740,16891,3218,23286,0
346,7009,74,35,59,1,0,14,75,3,14,7,14,17,21,58,85,1,128,7,0,2,10,9,41740,16892,3218,23287,0
346,7009,245,125,200,5,7,34,250,7,30,17,34,37,51,166,265,3,1053,58,0,2,10,9,41750,16893,3218,23288,0
227,5117,4293,999,3693,19,54,507,4312,9,155,88,170,164,258,1156,1898,4,9368,520,0,2,4,3,41750,16895,3218,23289,0
227,5117,1482,859,1002,125,135,219,1607,16,219,134,251,235,385,1766,3032,9,27804,1544,1,2,4,3,41760,16896,3218,23290,0
49,575,647,139,84,35,284,233,682,0,0,0,0,0,0,0,0,0,0,0,0,2,10,3,41760,16896,3218,23291,0
83,2321,1523,757,1297,19,12,193,1542,12,193,117,230,205,347,1508,2664,7,19053,1058,0,2,4,5,41770,16898,3218,23292,0
83,2321,701,378,504,33,58,109,734,13,110,68,126,123,194,794,1346,7,10027,557,0,2,4,5,41770,16899,3219,23293,0
178,4160,77,34,69,0,0,8,77,3,24,16,29,27,45,114,213,1,387,21,0,2,1,1,41770,16899,3219,23294,0
178,4160,712,438,573,51,9,84,763,14,102,71,128,116,199,733,1364,8,11988,666,0,2,1,1,41780,16900,3219,23295,0
69,1359,1020,354,843,12,15,144,1032,8,134,77,144,142,221,970,1580,4,6792,377,0,2,1,1,41780,16900,3219,23296,0
223,5078,722,423,573,19,0,135,741,12,172,101,199,184,300,1320,2257,6,15668,870,0,2,4,4,41780,16902,3219,23298,0
223,5078,1508,847,911,44,250,301,1552,14,148,88,169,162,257,1120,1886,7,15077,837,0,2,4,4,41780,16903,3220,23299,0
337,7188,72,33,56,0,4,12,72,1,1,1,1,2,2,0,2,0,1,0,0,2,2,2,41780,16903,3220,23300,0
337,7188,1454,835,1044,76,110,219,1530,17,275,158,296,292,454,2297,3718,9,34017,1889,1,2,2,2,41790,16904,3220,23301,0
104,1969,1178,367,1042,6,15,115,1184,9,94,51,95,103,146,644,976,4,4439,246,0,2,3,2,41790,16904,3220,23302,0
104,1969,177,108,140,8,0,27,185,6,30,16,32,36,48,162,248,3,794,44,0,2,3,2,41790,16906,3220,23303,0
184,3749,1943,715,1694,26,18,214,1969,12,185,120,237,197,357,1436,2721,7,20915,1161,0,2,2,2,41790,16908,3220,23304,0
184,3749,1168,838,957,57,25,144,1225,19,348,224,416,367,640,3018,5452,11,61921,3440,1,2,2,2,41800,16910,3220,23305,0
16,472,442,244,305,14,16,103,456,11,68,45,75,79,120,452,756,6,4588,254,0,2,1,1,41800,16912,3220,23306,0
16,472,182,102,99,11,40,35,193,3,11,6,11,14,17,42,64,1,97,5,0,2,1,1,41800,16913,3220,23307,0
62,1244,1098,241,925,5,10,155,1103,7,46,25,49,53,74,273,423,3,1580,87,0,2,21,3,41810,16915,3220,23308,0
62,1244,282,202,222,14,2,44,296,8,42,24,43,50,67,250,378,4,1548,86,0,2,21,3,41810,16916,3220,23309,0
94,4280,1338,495,1086,10,64,173,1348,11,122,82,157,133,239,883,1686,7,11934,663,0,2,10,0,41810,16918,3220,23310,0
109,4093,1450,624,1228,12,26,181,1462,14,306,186,354,320,540,2580,4493,8,36391,2021,1,2,20,1,41810,16920,3221,23311,0
148,4080,1660,832,1314,41,38,274,1701,20,312,209,395,332,604,2671,5058,12,64042,3557,1,2,1,1,41810,16922,3222,23313,0
117,4639,1513,682,1277,25,13,200,1538,11,199,116,219,210,335,1557,2584,6,15641,868,0,2,1,1,41810,16924,3222,23314,0
78,4085,1457,730,1242,11,6,188,1468,10,292,166,329,302,495,2424,4078,5,22973,1276,1,2,16,1,41810,16926,3222,23315,0
87,4323,1523,757,1297,19,12,193,1542,12,193,117,230,205,347,1508,2664,7,19053,1058,0,2,19,0,41820,16928,3222,23316,0
35,1615,1293,570,1093,25,15,163,1318,10,195,123,241,205,364,1516,2795,6,17273,959,0,2,15,0,41830,16930,3222,23317,0
25,1019,373,158,315,8,0,51,381,5,76,44,79,81,123,486,779,2,2026,112,0,2,1,1,41830,16930,3222,23318,0
71,2998,1178,367,1042,6,15,115,1184,9,94,51,95,103,146,644,976,4,4439,246,0,2,23,0,41830,16930,3222,23319,0
73,3730,1943,715,1694,26,18,214,1969,12,185,120,237,197,357,1436,2721,7,20915,1161,0,2,9,0,41830,16932,3222,23320,0
211,4515,182,127,129,0,0,53,182,5,39,21,42,44,63,217,343,2,926,51,0,2,4,2,41830,16932,3223,23321,0
211,4515,1165,710,800,67,119,181,1232,18,243,153,282,261,435,2000,3492,10,36473,2026,1,2,4,2,41840,16932,3224,23322,0
163,5074,1660,832,1314,41,38,274,1701,20,312,209,395,332,604,2671,5058,12,64042,3557,1,2,2,1,41840,16934,3225,23324,0
163,5074,1057,646,719,113,100,145,1170,18,215,134,248,233,382,1740,3004,10,31186,1732,1,2,2,1,41850,16935,3226,23325,0
60,1254,996,429,845,24,10,117,1020,7,76,50,88,83,138,494,879,4,3565,198,0,2,1,1,41850,16937,3226,23326,0
60,1254,456,277,329,12,42,72,468,13,85,50,97,98,147,592,972,7,7212,400,0,2,1,1,41850,16937,3226,23327,0
346,7009,1457,730,1242,11,6,188,1468,10,292,166,329,302,495,2424,4078,5,22973,1276,1,2,10,9,41850,16939,3226,23328,0
346,7009,74,35,59,1,0,14,75,3,14,7,14,17,21,58,85,1,128,7,0,2,10,9,41850,16940,3226,23329,0
346,7009,245,125,200,5,7,34,250,7,30,17,34,37,51,166,265,3,1053,58,0,2,10,9,41860,16941,3226,23330,0
227,5117,4293,999,3693,19,54,507,4312,9,155,88,170,164,258,1156,1898,4,9368,520,0,2,4,3,41860,16943,3226,23331,0
227,5117,1482,859,1002,125,135,219,1607,16,219,134,251,235,385,1766,3032,9,27804,1544,1,2,4,3,41870,16944,3226,23332,0
49,575,647,139,84,35,284,233,682,0,0,0,0,0,0,0,0,0,0,0,0,2,10,3,41870,16944,3226,23333,0
83,2321,1523,757,1297,19,12,193,1542,12,193,117,230,205,347,1508,2664,7,19053,1058,0,2,4,5,41880,16946,3226,23334,0
83,2321,701,378,504,33,58,109,734,13,110,68,126,123,194,794,1346,7,10027,557,0,2,4,5,41880,16947,3227,23335,0
178,4160,77,34,69,0,0,8,77,3,24,16,29,27,45,114,213,1,387,21,0,2,1,1,41880,16947,3227,23336,0
178,4160,712,438,573,51,9,84,763,14,102,71,128,116,199,733,1364,8,11988,666,0,2,1,1,41890,16948,3227,23337,0
69,1359,1020,354,843,12,15,144,1032,8,134,77,144,142,221,970,1580,4,6792,377,0,2,1,1,41890,16948,3227,23338,0
223,5078,722,423,573,19,0,135,741,12,172,101,199,184,300,1320,2257,6,15668,870,0,2,4,4,41890,16950,3227,23340,0
223,5078,1508,847,911,44,250,301,1552,14,148,88,169,162,257,1120,1886,7,15077,837,0,2,4,4,41890,16951,3228,23341,0
337,7188,72,33,56,0,4,12,72,1,1,1,1,2,2,0,2,0,1,0,0,2,2,2,41890,16951,3228,23342,0
337,7188,1454,835,1044,76,110,219,1530,17,275,158,296,292,454,2297,3718,9,34017,1889,1,2,2,2,41900,16952,3228,23343,0
104,1969,1178,367,1042,6,15,115,1184,9,94,51,95,103,146,644,976,4,4439,246,0,2,3,2,41900,16952,3228,23344,0
104,1969,177,108,140,8,0,27,185,6,30,16,32,36,48,162,248,3,794,44,0,2,3,2,41900,16954,3228,23345,0
184,3749,1943,715,1694,26,18,214,1969,12,185,120,237,197,357,1436,2721,7,20915,1161,0,2,2,2,41900,16956,3228,23346,0
184,3749,1168,838,957,57,25,144,1225,19,348,224,416,367,640,3018,5452,11,61921,3440,1,2,2,2,41910,16958,3228,23347,0
16,472,442,244,305,14,16,103,456,11,68,45,75,79,120,452,756,6,4588,254,0,2,1,1,41910,16960,3228,23348,0
16,472,182,102,99,11,40,35,193,3,11,6,11,14,17,42,64,1,97,5,0,2,1,1,41910,16961,3228,23349,0
62,1244,1098,241,925,5,10,155,1103,7,46,25,49,53,74,273,423,3,1580,87,0,2,21,3,41920,16963,3228,23350,0
62,1244,282,202,222,14,2,44,296,8,42,24,43,50,67,250,378,4,1548,86,0,2,21,3,41920,16964,3228,23351,0
94,4280,1338,495,1086,10,64,173,1348,11,122,82,157,133,239,883,1686,7,11934,663,0,2,10,0,41920,16966,3228,23352,0
109,4093,1450,624,1228,12,26,181,1462,14,306,186,354,320,540,2580,4493,8,36391,2021,1,2,20,1,41920,16968,3229,23353,0
148,4080,1660,832,1314,41,38,274,1701,20,312,209,395,332,604,2671,5058,12,64042,3557,1,2,1,1,41920,16970,3230,23355,0
117,4639,1513,682,1277,25,13,200,1538,11,199,116,219,210,335,1557,2584,6,15641,868,0,2,1,1,41920,16972,3230,23356,0
78,4085,1457,730,1242,11,6,188,1468,10,292,166,329,302,495,2424,4078,5,22973,1276,1,2,16,1,41920,16974,3230,23357,0
87,4323,1523,757,1297,19,12,193,1542,12,193,117,230,205,347,1508,2664,7,19053,1058,0,2,19,0,41930,16976,3230,23358,0
35,1615,1293,570,1093,25,15,163,1318,10,195,123,241,205,364,1516,2795,6,17273,959,0,2,15,0,41940,16978,3230,23359,0
25,1019,373,158,315,8,0,51,381,5,76,44,79,81,123,486,779,2,2026,112,0,2,1,1,41940,16978,3230,23360,0
71,2998,1178,367,1042,6,15,115,1184,9,94,51,95,103,146,644,976,4,4439,246,0,2,23,0,41940,16978,3230,23361,0
73,3730,1943,715,1694,26,18,214,1969,12,185,120,237,197,357,1436,2721,7,20915,1161,0,2,9,0,41940,16980,3230,23362,0
39,808,386,256,301,16,9,68,402,4,59,35,69,63,104,355,621,2,1453,80,0,2,9,33,41940,16980,3230,23363,1
39,808,264,131,164,11,41,46,275,6,38,22,40,44,62,214,338,3,1068,59,0,2,9,33,41950,16980,3231,23364,1
31,1462,386,256,301,16,9,68,402,4,59,35,69,63,104,355,621,2,1453,80,0,2,0,4,41950,16980,3231,23365,1
31,1431,386,256,301,16,9,68,402,4,59,35,69,63,104,355,621,2,1453,80,0,2,2,10,41960,16984,3232,23373,1
119,2401,1513,682,1277,25,13,200,1538,11,199,116,219,210,335,1557,2584,6,15641,868,0,2,2,1,41980,16994,3234,23388,0
119,2401,819,519,539,24,98,155,843,15,96,57,106,111,163,690,1107,8,9171,509,0,2,2,1,41990,16996,3234,23389,0
116,4567,1513,682,1277,25,13,200,1538,11,199,116,219,210,335,1557,2584,6,15641,868,0,2,2,1,41990,16998,3234,23390,0
119,2401,1513,682,1277,25,13,200,1538,11,199,116,219,210,335,1557,2584,6,15641,868,0,2,2,1,41990,17000,3234,23391,0
119,2401,819,519,539,24,98,155,843,15,96,57,106,111,163,690,1107,8,9171,509,0,2,2,1,42000,17002,3234,23392,0
116,4567,1513,682,1277,25,13,200,1538,11,199,116,219,210,335,1557,2584,6,15641,868,0,2,2,1,42000,17004,3234,23393,0
39,808,386,256,301,16,9,68,402,4,59,35,69,63,104,355,621,2,1453,80,0,2,9,33,42000,17004,3234,23394,0
39,808,264,131,164,11,41,46,275,6,38,22,40,44,62,214,338,3,1068,59,0,2,9,33,42010,17004,3235,23395,0
31,1431,386,256,301,16,9,68,402,4,59,35,69,63,104,355,621,2,1453,80,0,2,2,14,42010,17004,3235,23396,0
7,255,75,38,59,1,3,12,76,2,4,2,4,6,6,10,15,1,15,0,0,2,1,1,42010,17004,3235,23397,1
107,4030,1450,624,1228,12,26,181,1462,14,306,186,354,320,540,2580,4493,8,36391,2021,1,2,1,1,42010,17006,3236,23398,1
76,4022,1457,730,1242,11,6,188,1468,10,292,166,329,302,495,2424,4078,5,22973,1276,1,2,4,3,42010,17008,3236,23399,1
82,4161,1523,757,1297,19,12,193,1542,12,193,117,230,205,347,1508,2664,7,19053,1058,0,2,5,2,42020,17010,3236,23400,1
36,1970,384,251,317,7,8,52,391,11,70,44,84,81,128,467,811,6,5355,297,0,2,2,2,42020,17010,3236,23401,1
72,3682,1943,715,1694,26,18,214,1969,12,185,120,237,197,357,1436,2721,7,20915,1161,0,2,8,8,42020,17012,3236,23402,1
9,317,601,196,481,2,23,85,603,8,63,36,72,71,108,400,664,4,3036,168,0,2,0,1,42020,17012,3236,23403,1
211,4515,182,127,129,0,0,53,182,5,39,21,42,44,63,217,343,2,926,51,0,2,4,2,42020,17012,3237,23404,0
211,4515,1165,710,800,67,119,181,1232,18,243,153,282,261,435,2000,3492,10,36473,2026,1,2,4,2,42030,17012,3238,23405,0
163,5074,1660,832,1314,41,38,274,1701,20,312,209,395,332,604,2671,5058,12,64042,3557,1,2,2,1,42030,17014,3239,23407,0
163,5074,1057,646,719,113,100,145,1170,18,215,134,248,233,382,1740,3004,10,31186,1732,1,2,2,1,42040,17015,3240,23408,0
60,1254,996,429,845,24,10,117,1020,7,76,50,88,83,138,494,879,4,3565,198,0,2,1,1,42040,17017,3240,23409,0
60,1254,456,277,329,12,42,72,468,13,85,50,97,98,147,592,972,7,7212,400,0,2,1,1,42040,17017,3240,23410,0
119,2420,1513,682,1277,25,13,200,1538,11,199,116,219,210,335,1557,2584,6,15641,868,0,2,2,2,42040,17019,3240,23411,0
119,2420,819,519,539,24,98,155,843,15,96,57,106,111,163,690,1107,8,9171,509,0,2,2,2,42050,17021,3240,23412,0
50,1024,207,111,150,11,0,50,218,5,26,19,36,31,55,133,272,3,943,52,0,2,16,0,42050,17021,3240,23413,0
50,1024,410,198,237,31,55,97,441,11,63,38,72,74,110,414,683,6,4293,238,0,2,16,0,42060,17022,3241,23414,0
346,7009,1457,730,1242,11,6,188,1468,10,292,166,329,302,495,2424,4078,5,22973,1276,1,2,10,9,42060,17024,3241,23415,0
346,7009,74,35,59,1,0,14,75,3,14,7,14,17,21,58,85,1,128,7,0,2,10,9,42060,17025,3241,23416,0
346,7009,245,125,200,5,7,34,250,7,30,17,34,37,51,166,265,3,1053,58,0,2,10,9,42070,17026,3241,23417,0
227,5117,4293,999,3693,19,54,507,4312,9,155,88,170,164,258,1156,1898,4,9368,520,0,2,4,3,42070,17028,3241,23418,0
227,5117,1482,859,1002,125,135,219,1607,16,219,134,251,235,385,1766,3032,9,27804,1544,1,2,4,3,42080,17029,3241,23419,0
49,575,647,139,84,35,284,233,682,0,0,0,0,0,0,0,0,0,0,0,0,2,10,3,42080,17029,3241,23420,0
83,2321,1523,757,1297,19,12,193,1542,12,193,117,230,205,347,1508,2664,7,19053,1058,0,2,40,7,42090,17031,3241,23421,0
83,2321,701,378,504,33,58,109,734,13,110,68,126,123,194,794,1346,7,10027,557,0,2,40,7,42090,17032,3242,23422,0
178,4160,77,34,69,0,0,8,77,3,24,16,29,27,45,114,213,1,387,21,0,2,1,1,42090,17032,3242,23423,0
178,4160,712,438,573,51,9,84,763,14,102,71,128,116,199,733,1364,8,11988,666,0,2,1,1,42100,17033,3242,23424,0
69,1359,1020,354,843,12,15,144,1032,8,134,77,144,142,221,970,1580,4,6792,377,0,2,1,1,42100,17033,3242,23425,0
223,5078,722,423,573,19,0,135,741,12,172,101,199,184,300,1320,2257,6,15668,870,0,2,9,6,42100,17035,3242,23427,0
223,5078,1508,847,911,44,250,301,1552,14,148,88,169,162,257,1120,1886,7,15077,837,0,2,9,6,42100,17036,3243,23428,0
337,7188,72,33,56,0,4,12,72,1,1,1,1,2,2,0,2,0,1,0,0,2,2,2,42100,17036,3243,23429,0
337,7188,1454,835,1044,76,110,219,1530,17,275,158,296,292,454,2297,3718,9,34017,1889,1,2,2,2,42110,17037,3243,23430,0
39,808,386,256,301,16,9,68,402,4,59,35,69,63,104,355,621,2,1453,80,0,2,9,33,42110,17037,3243,23431,0
39,808,264,131,164,11,41,46,275,6,38,22,40,44,62,214,338,3,1068,59,0,2,9,33,42120,17037,3244,23432,0
104,1969,1178,367,1042,6,15,115,1184,9,94,51,95,103,146,644,976,4,4439,246,0,2,3,2,42120,17037,3244,23433,0
104,1969,177,108,140,8,0,27,185,6,30,16,32,36,48,162,248,3,794,44,0,2,3,2,42120,17039,3244,23434,0
185,3777,1943,715,1694,26,18,214,1969,12,185,120,237,197,357,1436,2721,7,20915,1161,0,2,2,2,42120,17041,3244,23435,0
185,3777,1168,838,957,57,25,144,1225,19,348,224,416,367,640,3018,5452,11,61921,3440,1,2,2,2,42130,17043,3244,23436,0
16,472,442,244,305,14,16,103,456,11,68,45,75,79,120,452,756,6,4588,254,0,2,1,1,42130,17045,3244,23437,0
16,472,182,102,99,11,40,35,193,3,11,6,11,14,17,42,64,1,97,5,0,2,1,1,42130,17046,3244,23438,0
62,1244,1098,241,925,5,10,155,1103,7,46,25,49,53,74,273,423,3,1580,87,0,2,21,3,42140,17048,3244,23439,0
62,1244,282,202,222,14,2,44,296,8,42,24,43,50,67,250,378,4,1548,86,0,2,21,3,42140,17049,3244,23440,0
94,4280,1338,495,1086,10,64,173,1348,11,122,82,157,133,239,883,1686,7,11934,663,0,2,10,0,42140,17051,3244,23441,0
109,4093,1450,624,1228,12,26,181,1462,14,306,186,354,320,540,2580,4493,8,36391,2021,1,2,20,1,42140,17053,3245,23442,0
148,4080,1660,832,1314,41,38,274,1701,20,312,209,395,332,604,2671,5058,12,64042,3557,1,2,1,1,42140,17055,3246,23444,0
117,4639,1513,682,1277,25,13,200,1538,11,199,116,219,210,335,1557,2584,6,15641,868,0,2,19,7,42140,17057,3246,23445,0
78,4085,1457,730,1242,11,6,188,1468,10,292,166,329,302,495,2424,4078,5,22973,1276,1,2,16,1,42140,17059,3246,23446,0
87,4328,1523,757,1297,19,12,193,1542,12,193,117,230,205,347,1508,2664,7,19053,1058,0,2,42,0,42150,17061,3246,23447,0
35,1615,1293,570,1093,25,15,163,1318,10,195,123,241,205,364,1516,2795,6,17273,959,0,2,15,0,42160,17063,3246,23448,0
31,1431,386,256,301,16,9,68,402,4,59,35,69,63,104,355,621,2,1453,80,0,2,2,14,42160,17063,3246,23449,0
25,1019,373,158,315,8,0,51,381,5,76,44,79,81,123,486,779,2,2026,112,0,2,1,1,42160,17063,3246,23450,0
71,2998,1178,367,1042,6,15,115,1184,9,94,51,95,103,146,644,976,4,4439,246,0,2,23,0,42160,17063,3246,23451,0
73,3730,1943,715,1694,26,18,214,1969,12,185,120,237,197,357,1436,2721,7,20915,1161,0,2,9,0,42160,17065,3246,23452,0
39,784,386,256,301,16,9,68,402,4,59,35,69,63,104,355,621,2,1453,80,0,2,0,2,42160,17065,3246,23453,0
39,784,264,131,164,11,41,46,275,6,38,22,40,44,62,214,338,3,1068,59,0,2,0,2,42170,17065,3247,23454,0
14,331,601,196,481,2,23,85,603,8,63,36,72,71,108,400,664,4,3036,168,0,2,7,21,42170,17065,3247,23455,0
14,331,156,79,106,5,16,28,161,5,14,8,15,19,23,64,97,2,261,14,0,2,7,21,42170,17065,3247,23456,0
31,1431,386,256,301,16,9,68,402,4,59,35,69,63,104,355,621,2,1453,80,0,2,3,1,42170,17065,3247,23457,0
346,7013,1457,730,1242,11,6,188,1468,10,292,166,329,302,495,2424,4078,5,22973,1276,1,2,2,2,42170,17067,3247,23458,1
346,7013,74,35,59,1,0,14,75,3,14,7,14,17,21,58,85,1,128,7,0,2,2,2,42170,17068,3247,23459,1
346,7013,245,125,200,5,7,34,250,7,30,17,34,37,51,166,265,3,1053,58,0,2,2,2,42180,17069,3247,23460,1
227,5121,4293,999,3693,19,54,507,4312,9,155,88,170,164,258,1156,1898,4,9368,520,0,2,1,1,42180,17071,3247,23461,1
227,5121,1482,859,1002,125,135,219,1607,16,219,134,251,235,385,1766,3032,9,27804,1544,1,2,1,1,42190,17072,3247,23462,1
191,3884,1943,715,1694,26,18,214,1969,12,185,120,237,197,357,1436,2721,7,20915,1161,0,2,36,7,42190,17074,3247,23463,1
191,3884,1168,838,957,57,25,144,1225,19,348,224,416,367,640,3018,5452,11,61921,3440,1,2,36,7,42200,17076,3247,23464,1
7,255,75,38,59,1,3,12,76,2,4,2,4,6,6,10,15,1,15,0,0,2,1,1,42200,17076,3247,23465,1
94,4283,1338,495,1086,10,64,173,1348,11,122,82,157,133,239,883,1686,7,11934,663,0,2,5,5,42200,17078,3247,23466,1
109,4098,1450,624,1228,12,26,181,1462,14,306,186,354,320,540,2580,4493,8,36391,2021,1,2,4,1,42200,17080,3248,23467,1
78,4085,1457,730,1242,11,6,188,1468,10,292,166,329,302,495,2424,4078,5,22973,1276,1,2,1,1,42200,17082,3248,23468,1
87,4328,1523,757,1297,19,12,193,1542,12,193,117,230,205,347,1508,2664,7,19053,1058,0,2,1,1,42210,17084,3248,23469,1
9,317,601,196,481,2,23,85,603,8,63,36,72,71,108,400,664,4,3036,168,0,2,4,4,42210,17084,3248,23470,1
9,231,19,8,11,5,0,4,24,2,5,3,6,7,9,13,25,1,30,1,0,2,1,1,42210,17084,3248,23471,1
9,231,102,59,69,5,3,24,107,6,22,15,28,28,43,113,206,3,789,43,0,2,1,1,42210,17084,3248,23472,1
9,231,106,40,36,3,49,17,109,8,17,13,23,25,36,93,167,5,904,50,0,2,1,1,42210,17084,3248,23473,1
211,4523,182,127,129,0,0,53,182,5,39,21,42,44,63,217,343,2,926,51,0,2,1,0,42220,17088,3250,23481,1
211,4523,1165,710,800,67,119,181,1232,18,243,153,282,261,435,2000,3492,10,36473,2026,1,2,1,0,42230,17088,3251,23482,1
99,2081,773,419,590,28,0,166,801,10,204,113,217,214,330,1598,2554,5,13587,754,0,2,1,1,42230,17088,3252,23483,1
99,2081,421,273,302,44,34,57,465,17,81,59,107,98,166,583,1098,11,12329,684,0,2,1,1,42230,17088,3253,23484,1
28,556,2,2,2,0,0,0,2,0,0,0,0,0,0,0,0,0,0,0,0,2,1,0,42230,17088,3253,23484,1
28,556,99,48,90,1,3,5,100,0,0,0,0,0,0,0,0,0,0,0,0,2,1,0,42230,17089,3253,23485,1
28,556,8,5,5,2,0,1,10,0,0,0,0,0,0,0,0,0,0,0,0,2,1,0,42230,17089,3253,23486,1
28,556,1217,716,841,84,126,174,1301,14,185,118,215,199,333,1446,2542,8,20687,1149,0,2,1,0,42240,17091,3253,23487,1
28,556,160,89,115,0,13,31,160,7,15,11,17,22,28,78,124,3,495,27,0,2,1,0,42240,17091,3253,23488,1
28,556,10,10,9,9,0,0,19,0,0,0,0,0,0,0,0,0,0,0,0,2,1,0,42240,17091,3254,23489,1
28,556,173,84,99,8,29,36,181,5,12,7,13,17,20,54,81,2,221,12,0,2,1,0,42240,17092,3254,23490,1
28,556,3,1,1,3,0,0,6,0,0,0,0,0,0,0,0,0,0,0,0,2,1,0,42240,17092,3254,23491,1
163,5082,1660,832,1314,41,38,274,1701,20,312,209,395,332,604,2671,5058,12,64042,3557,1,2,1,1,42240,17094,3255,23493,1
163,5082,1057,646,719,113,100,145,1170,18,215,134,248,233,382,1740,3004,10,31186,1732,1,2,1,1,42250,17095,3256,23494,1
17,349,95,58,50,9,16,20,104,12,33,24,45,45,69,209,378,8,3100,172,0,2,1,1,42250,17095,3256,23495,1
82,1800,477,336,357,30,23,73,507,16,194,134,250,210,384,1538,2962,10,30538,1696,0,2,1,0,42260,17096,3256,23496,1
60,1262,996,429,845,24,10,117,1020,7,76,50,88,83,138,494,879,4,3565,198,0,2,1,1,42260,17098,3256,23497,1
60,1262,456,277,329,12,42,72,468,13,85,50,97,98,147,592,972,7,7212,400,0,2,1,1,42260,17098,3256,23498,1
119,2424,1513,682,1277,25,13,200,1538,11,199,116,219,210,335,1557,2584,6,15641,868,0,2,1,1,42260,17100,3256,23499,1
119,2424,819,519,539,24,98,155,843,15,96,57,106,111,163,690,1107,8,9171,509,0,2,1,1,42270,17102,3256,23500,1
50,1032,207,111,150,11,0,50,218,5,26,19,36,31,55,133,272,3,943,52,0,2,1,0,42270,17102,3256,23501,1
50,1032,410,198,237,31,55,97,441,11,63,38,72,74,110,414,683,6,4293,238,0,2,1,0,42280,17103,3257,23502,1
346,7017,1457,730,1242,11,6,188,1468,10,292,166,329,302,495,2424,4078,5,22973,1276,1,2,1,0,42280,17105,3257,23503,1
346,7017,74,35,59,1,0,14,75,3,14,7,14,17,21,58,85,1,128,7,0,2,1,0,42280,17106,3257,23504,1
346,7017,245,125,200,5,7,34,250,7,30,17,34,37,51,166,265,3,1053,58,0,2,1,0,42290,17107,3257,23505,1
22,683,339,213,244,17,9,65,356,10,42,26,48,52,74,259,421,5,2410,133,0,2,1,1,42300,17107,3257,23506,1
56,1603,1455,414,1257,16,76,112,1471,5,41,23,46,46,69,231,381,2,1069,59,0,2,1,1,42300,17108,3257,23508,1
56,1603,669,365,481,22,61,110,691,15,103,63,122,118,185,747,1273,8,11311,628,0,2,1,1,42310,17108,3258,23509,1
227,5125,4293,999,3693,19,54,507,4312,9,155,88,170,164,258,1156,1898,4,9368,520,0,2,1,0,42310,17110,3258,23510,1
227,5125,1482,859,1002,125,135,219,1607,16,219,134,251,235,385,1766,3032,9,27804,1544,1,2,1,0,42320,17111,3258,23511,1
7,147,44,22,19,0,19,6,44,2,10,6,12,12,18,35,64,1,77,4,0,2,3,1,42320,17111,3258,23512,1
24,842,74,35,59,1,0,14,75,3,14,7,14,17,21,58,85,1,128,7,0,2,2,0,42320,17112,3258,23513,1
24,842,245,125,200,5,7,34,250,7,30,17,34,37,51,166,265,3,1053,58,0,2,2,0,42330,17113,3258,23514,1
83,2329,1523,757,1297,19,12,193,1542,12,193,117,230,205,347,1508,2664,7,19053,1058,0,2,4,2,42340,17115,3258,23515,1
83,2329,701,378,504,33,58,109,734,13,110,68,126,123,194,794,1346,7,10027,557,0,2,4,2,42340,17116,3259,23516,1
178,4168,77,34,69,0,0,8,77,3,24,16,29,27,45,114,213,1,387,21,0,2,2,0,42340,17116,3259,23517,1
178,4168,712,438,573,51,9,84,763,14,102,71,128,116,199,733,1364,8,11988,666,0,2,2,0,42350,17117,3259,23518,1
69,1367,1020,354,843,12,15,144,1032,8,134,77,144,142,221,970,1580,4,6792,377,0,2,2,0,42350,17117,3259,23519,1
46,959,447,308,343,6,5,95,453,7,96,59,111,103,170,651,1136,4,4600,255,0,2,1,0,42350,17120,3259,23520,1
46,959,322,174,179,16,74,51,338,10,41,26,46,51,72,252,408,5,2291,127,0,2,1,0,42350,17123,3260,23521,1
23,382,424,94,331,4,0,89,428,1,5,5,5,6,10,11,25,0,12,0,0,2,1,0,42350,17124,3260,23522,1
23,382,38,23,23,6,0,8,44,3,11,7,11,14,18,42,68,1,102,5,0,2,1,0,42350,17124,3260,23523,1
17,518,184,100,137,2,15,30,186,6,38,20,39,44,59,214,322,3,991,55,0,2,2,0,42350,17125,3260,23524,1
17,518,103,65,74,8,5,16,111,7,17,9,17,24,26,89,119,3,417,23,0,2,2,0,42350,17126,3260,23525,1
223,5086,722,423,573,19,0,135,741,12,172,101,199,184,300,1320,2257,6,15668,870,0,2,2,0,42350,17128,3260,23527,1
223,5086,1508,847,911,44,250,301,1552,14,148,88,169,162,257,1120,1886,7,15077,837,0,2,2,0,42350,17129,3261,23528,1
337,7196,72,33,56,0,4,12,72,1,1,1,1,2,2,0,2,0,1,0,0,2,1,0,42350,17129,3261,23529,1
337,7196,1454,835,1044,76,110,219,1530,17,275,158,296,292,454,2297,3718,9,34017,1889,1,2,1,0,42360,17130,3261,23530,1
39,816,386,256,301,16,9,68,402,4,59,35,69,63,104,355,621,2,1453,80,0,2,2,0,42360,17130,3261,23531,1
39,816,264,131,164,11,41,46,275,6,38,22,40,44,62,214,338,3,1068,59,0,2,2,0,42370,17130,3262,23532,1
30,657,215,129,180,6,0,29,221,8,65,43,72,73,115,415,711,4,3153,175,0,2,1,0,42370,17130,3262,23533,1
30,657,97,69,77,3,3,16,100,6,22,13,23,28,36,113,173,3,542,30,0,2,1,0,42370,17131,3262,23534,1
128,2826,1043,504,840,53,9,147,1096,9,180,112,198,189,310,1377,2344,4,11604,644,0,2,2,0,42370,17133,3262,23535,1
128,2826,383,288,292,26,6,62,409,11,65,38,67,76,105,429,656,5,3719,206,0,2,2,0,42370,17134,3262,23536,1
20,408,294,64,250,0,0,43,294,1,20,10,20,21,30,86,131,0,65,3,0,2,2,0,42370,17134,3262,23537,1
20,408,78,46,62,3,0,14,81,3,8,4,8,11,12,28,41,1,62,3,0,2,2,0,42370,17135,3262,23538,1
5,118,110,30,77,3,13,16,113,4,21,15,30,25,45,100,208,2,597,33,0,2,2,0,42370,17135,3262,23539,1
5,118,28,15,21,1,0,6,29,0,0,0,0,0,0,0,0,0,0,0,0,2,2,0,42370,17135,3262,23540,1
104,1977,1178,367,1042,6,15,115,1184,9,94,51,95,103,146,644,976,4,4439,246,0,2,2,0,42370,17135,3262,23541,1
104,1977,177,108,140,8,0,27,185,6,30,16,32,36,48,162,248,3,794,44,0,2,2,0,42370,17137,3262,23542,1
184,3757,1943,715,1694,26,18,214,1969,12,185,120,237,197,357,1436,2721,7,20915,1161,0,2,2,0,42370,17139,3262,23543,1
184,3757,1168,838,957,57,25,144,1225,19,348,224,416,367,640,3018,5452,11,61921,3440,1,2,2,0,42380,17141,3262,23544,1
16,480,442,244,305,14,16,103,456,11,68,45,75,79,120,452,756,6,4588,254,0,2,2,0,42380,17143,3262,23545,1
16,480,182,102,99,11,40,35,193,3,11,6,11,14,17,42,64,1,97,5,0,2,2,0,42380,17144,3262,23546,1
62,1248,1098,241,925,5,10,155,1103,7,46,25,49,53,74,273,423,3,1580,87,0,2,1,1,42390,17146,3262,23547,1
62,1248,282,202,222,14,2,44,296,8,42,24,43,50,67,250,378,4,1548,86,0,2,1,1,42390,17147,3262,23548,1
78,3314,1289,550,1043,56,32,155,1345,10,167,93,185,177,278,1266,2075,5,11498,638,0,2,1,0,42390,17149,3263,23549,1
34,997,182,127,129,0,0,53,182,5,39,21,42,44,63,217,343,2,926,51,0,2,1,0,42390,17149,3264,23550,1
137,6600,1392,870,1177,35,17,170,1427,14,494,280,531,508,811,4473,7289,7,54850,3047,2,2,1,0,42390,17152,3265,23551,1
91,3011,773,419,590,28,0,166,801,10,204,113,217,214,330,1598,2554,5,13587,754,0,2,1,0,42390,17152,3266,23552,1
7,263,75,38,59,1,3,12,76,2,4,2,4,6,6,10,15,1,15,0,0,2,1,0,42390,17152,3266,23553,1
23,601,102,59,69,5,3,24,107,6,22,15,28,28,43,113,206,3,789,43,0,2,1,1,42390,17152,3266,23554,1
109,4101,1450,624,1228,12,26,181,1462,14,306,186,354,320,540,2580,4493,8,36391,2021,1,2,1,0,42390,17154,3267,23555,1
148,4088,1660,832,1314,41,38,274,1701,20,312,209,395,332,604,2671,5058,12,64042,3557,1,2,1,0,42390,17156,3268,23557,1
117,4647,1513,682,1277,25,13,200,1538,11,199,116,219,210,335,1557,2584,6,15641,868,0,2,1,0,42390,17158,3268,23558,1
59,3310,1296,573,1062,40,33,157,1336,8,201,118,231,209,349,1561,2689,4,12365,686,0,2,1,0,42390,17158,3268,23559,1
10,236,207,111,150,11,0,50,218,5,26,19,36,31,55,133,272,3,943,52,0,2,1,0,42390,17158,3268,23560,1
78,4093,1457,730,1242,11,6,188,1468,10,292,166,329,302,495,2424,4078,5,22973,1276,1,2,1,0,42390,17160,3268,23561,1
38,2286,652,304,544,16,6,88,668,6,89,51,101,95,152,591,998,3,3399,188,0,2,1,0,42390,17161,3268,23562,1
62,2878,1455,414,1257,16,76,112,1471,5,41,23,46,46,69,231,381,2,1069,59,0,2,1,0,42390,17162,3268,23563,1
2,75,7,6,5,0,0,2,7,1,1,1,2,2,3,0,3,1,3,0,0,2,1,0,42390,17162,3268,23564,1
8,273,74,35,59,1,0,14,75,3,14,7,14,17,21,58,85,1,128,7,0,2,1,0,42390,17163,3268,23565,1
87,4331,1523,757,1297,19,12,193,1542,12,193,117,230,205,347,1508,2664,7,19053,1058,0,2,2,2,42400,17165,3268,23566,1
66,2767,1020,354,843,12,15,144,1032,8,134,77,144,142,221,970,1580,4,6792,377,0,2,1,0,42400,17165,3268,23567,1
37,1624,447,308,343,6,5,95,453,7,96,59,111,103,170,651,1136,4,4600,255,0,2,1,0,42400,17168,3268,23568,1
21,661,424,94,331,4,0,89,428,1,5,5,5,6,10,11,25,0,12,0,0,2,1,0,42400,17169,3268,23569,1
40,2359,334,251,279,10,4,40,344,5,127,74,143,132,217,899,1528,2,4303,239,0,2,1,1,42400,17170,3268,23570,1
12,492,184,100,137,2,15,30,186,6,38,20,39,44,59,214,322,3,991,55,0,2,1,0,42400,17171,3268,23571,1
35,1623,1293,570,1093,25,15,163,1318,10,195,123,241,205,364,1516,2795,6,17273,959,0,2,1,0,42410,17173,3268,23572,1
36,1978,384,251,317,7,8,52,391,11,70,44,84,81,128,467,811,6,5355,297,0,2,1,0,42410,17173,3268,23573,1
15,638,722,423,573,19,0,135,741,12,172,101,199,184,300,1320,2257,6,15668,870,0,2,1,0,42410,17175,3268,23575,1
31,1439,386,256,301,16,9,68,402,4,59,35,69,63,104,355,621,2,1453,80,0,2,1,0,42410,17175,3268,23576,1
16,1209,215,129,180,6,0,29,221,8,65,43,72,73,115,415,711,4,3153,175,0,2,1,0,42410,17175,3268,23577,1
69,2856,1043,504,840,53,9,147,1096,9,180,112,198,189,310,1377,2344,4,11604,644,0,2,1,1,42410,17177,3268,23578,1
14,529,295,56,236,0,4,54,295,2,9,5,10,11,15,30,51,1,57,3,0,2,5,3,42410,17179,3268,23579,1
25,1027,373,158,315,8,0,51,381,5,76,44,79,81,123,486,779,2,2026,112,0,2,1,0,42410,17179,3268,23580,1
71,3006,1178,367,1042,6,15,115,1184,9,94,51,95,103,146,644,976,4,4439,246,0,2,1,0,42410,17179,3268,23581,1
73,3738,1943,715,1694,26,18,214,1969,12,185,120,237,197,357,1436,2721,7,20915,1161,0,2,1,0,42410,17181,3268,23582,1
14,825,442,244,305,14,16,103,456,11,68,45,75,79,120,452,756,6,4588,254,0,2,1,0,42410,17183,3268,23583,1
48,1784,1098,241,925,5,10,155,1103,7,46,25,49,53,74,273,423,3,1580,87,0,2,1,0,42420,17185,3268,23584,1
223,5076,722,423,573,19,0,135,741,12,172,101,199,184,300,1320,2257,6,15668,870,0,2,7,9,42420,17187,3268,23586,1
223,5076,1508,847,911,44,250,301,1552,14,148,88,169,162,257,1120,1886,7,15077,837,0,2,7,9,42420,17188,3269,23587,1
30,649,215,129,180,6,0,29,221,8,65,43,72,73,115,415,711,4,3153,175,0,2,2,2,42420,17188,3269,23588,1
30,649,97,69,77,3,3,16,100,6,22,13,23,28,36,113,173,3,542,30,0,2,2,2,42420,17189,3269,23589,1
94,4280,1338,495,1086,10,64,173,1348,11,122,82,157,133,239,883,1686,7,11934,663,0,2,6,4,42420,17191,3269,23590,1
117,4641,1513,682,1277,25,13,200,1538,11,199,116,219,210,335,1557,2584,6,15641,868,0,2,3,3,42420,17193,3269,23591,1
66,2763,1020,354,843,12,15,144,1032,8,134,77,144,142,221,970,1580,4,6792,377,0,2,1,1,42420,17193,3269,23592,1
137,6599,1392,870,1177,35,17,170,1427,14,494,280,531,508,811,4473,7289,7,54850,3047,2,2,1,1,42420,17196,3270,23593,0
9,231,19,8,11,5,0,4,24,2,5,3,6,7,9,13,25,1,30,1,0,2,1,1,42420,17196,3270,23594,0
9,231,102,59,69,5,3,24,107,6,22,15,28,28,43,113,206,3,789,43,0,2,1,1,42420,17196,3270,23595,0
9,231,106,40,36,3,49,17,109,8,17,13,23,25,36,93,167,5,904,50,0,2,1,1,42420,17196,3270,23596,0
211,4523,182,127,129,0,0,53,182,5,39,21,42,44,63,217,343,2,926,51,0,2,1,0,42430,17200,3272,23604,0
211,4523,1165,710,800,67,119,181,1232,18,243,153,282,261,435,2000,3492,10,36473,2026,1,2,1,0,42440,17200,3273,23605,0
99,2081,773,419,590,28,0,166,801,10,204,113,217,214,330,1598,2554,5,13587,754,0,2,1,1,42440,17200,3274,23606,0
99,2081,421,273,302,44,34,57,465,17,81,59,107,98,166,583,1098,11,12329,684,0,2,1,1,42440,17200,3275,23607,0
28,556,2,2,2,0,0,0,2,0,0,0,0,0,0,0,0,0,0,0,0,2,1,0,42440,17200,3275,23607,0
28,556,99,48,90,1,3,5,100,0,0,0,0,0,0,0,0,0,0,0,0,2,1,0,42440,17201,3275,23608,0
28,556,8,5,5,2,0,1,10,0,0,0,0,0,0,0,0,0,0,0,0,2,1,0,42440,17201,3275,23609,0
28,556,1217,716,841,84,126,174,1301,14,185,118,215,199,333,1446,2542,8,20687,1149,0,2,1,0,42450,17203,3275,23610,0
28,556,160,89,115,0,13,31,160,7,15,11,17,22,28,78,124,3,495,27,0,2,1,0,42450,17203,3275,23611,0
28,556,10,10,9,9,0,0,19,0,0,0,0,0,0,0,0,0,0,0,0,2,1,0,42450,17203,3276,23612,0
28,556,173,84,99,8,29,36,181,5,12,7,13,17,20,54,81,2,221,12,0,2,1,0,42450,17204,3276,23613,0
28,556,3,1,1,3,0,0,6,0,0,0,0,0,0,0,0,0,0,0,0,2,1,0,42450,17204,3276,23614,0
163,5082,1660,832,1314,41,38,274,1701,20,312,209,395,332,604,2671,5058,12,64042,3557,1,2,1,1,42450,17206,3277,23616,0
163,5082,1057,646,719,113,100,145,1170,18,215,134,248,233,382,1740,3004,10,31186,1732,1,2,1,1,42460,17207,3278,23617,0
17,349,95,58,50,9,16,20,104,12,33,24,45,45,69,209,378,8,3100,172,0,2,1,1,42460,17207,3278,23618,0
82,1800,477,336,357,30,23,73,507,16,194,134,250,210,384,1538,2962,10,30538,1696,0,2,1,0,42470,17208,3278,23619,0
60,1262,996,429,845,24,10,117,1020,7,76,50,88,83,138,494,879,4,3565,198,0,2,1,1,42470,17210,3278,23620,0
60,1262,456,277,329,12,42,72,468,13,85,50,97,98,147,592,972,7,7212,400,0,2,1,1,42470,17210,3278,23621,0
119,2424,1513,682,1277,25,13,200,1538,11,199,116,219,210,335,1557,2584,6,15641,868,0,2,1,1,42470,17212,3278,23622,0
119,2424,819,519,539,24,98,155,843,15,96,57,106,111,163,690,1107,8,9171,509,0,2,1,1,42480,17214,3278,23623,0
50,1032,207,111,150,11,0,50,218,5,26,19,36,31,55,133,272,3,943,52,0,2,1,0,42480,17214,3278,23624,0
50,1032,410,198,237,31,55,97,441,11,63,38,72,74,110,414,683,6,4293,238,0,2,1,0,42490,17215,3279,23625,0
346,7017,1457,730,1242,11,6,188,1468,10,292,166,329,302,495,2424,4078,5,22973,1276,1,2,1,0,42490,17217,3279,23626,0
346,7017,74,35,59,1,0,14,75,3,14,7,14,17,21,58,85,1,128,7,0,2,1,0,42490,17218,3279,23627,0
346,7017,245,125,200,5,7,34,250,7,30,17,34,37,51,166,265,3,1053,58,0,2,1,0,42500,17219,3279,23628,0
22,683,339,213,244,17,9,65,356,10,42,26,48,52,74,259,421,5,2410,133,0,2,1,1,42510,17219,3279,23629,0
56,1603,1455,414,1257,16,76,112,1471,5,41,23,46,46,69,231,381,2,1069,59,0,2,1,1,42510,17220,3279,23631,0
56,1603,669,365,481,22,61,110,691,15,103,63,122,118,185,747,1273,8,11311,628,0,2,1,1,42520,17220,3280,23632,0
227,5125,4293,999,3693,19,54,507,4312,9,155,88,170,164,258,1156,1898,4,9368,520,0,2,1,0,42520,17222,3280,23633,0
227,5125,1482,859,1002,125,135,219,1607,16,219,134,251,235,385,1766,3032,9,27804,1544,1,2,1,0,42530,17223,3280,23634,0
7,147,44,22,19,0,19,6,44,2,10,6,12,12,18,35,64,1,77,4,0,2,3,1,42530,17223,3280,23635,0
24,842,74,35,59,1,0,14,75,3,14,7,14,17,21,58,85,1,128,7,0,2,2,0,42530,17224,3280,23636,0
24,842,245,125,200,5,7,34,250,7,30,17,34,37,51,166,265,3,1053,58,0,2,2,0,42540,17225,3280,23637,0
83,2329,1523,757,1297,19,12,193,1542,12,193,117,230,205,347,1508,2664,7,19053,1058,0,2,4,2,42550,17227,3280,23638,0
83,2329,701,378,504,33,58,109,734,13,110,68,126,123,194,794,1346,7,10027,557,0,2,4,2,42550,17228,3281,23639,0
178,4168,77,34,69,0,0,8,77,3,24,16,29,27,45,114,213,1,387,21,0,2,2,0,42550,17228,3281,23640,0
178,4168,712,438,573,51,9,84,763,14,102,71,128,116,199,733,1364,8,11988,666,0,2,2,0,42560,17229,3281,23641,0
69,1367,1020,354,843,12,15,144,1032,8,134,77,144,142,221,970,1580,4,6792,377,0,2,2,0,42560,17229,3281,23642,0
46,959,447,308,343,6,5,95,453,7,96,59,111,103,170,651,1136,4,4600,255,0,2,1,0,42560,17232,3281,23643,0
46,959,322,174,179,16,74,51,338,10,41,26,46,51,72,252,408,5,2291,127,0,2,1,0,42560,17235,3282,23644,0
23,382,424,94,331,4,0,89,428,1,5,5,5,6,10,11,25,0,12,0,0,2,1,0,42560,17236,3282,23645,0
23,382,38,23,23,6,0,8,44,3,11,7,11,14,18,42,68,1,102,5,0,2,1,0,42560,17236,3282,23646,0
17,518,184,100,137,2,15,30,186,6,38,20,39,44,59,214,322,3,991,55,0,2,2,0,42560,17237,3282,23647,0
17,518,103,65,74,8,5,16,111,7,17,9,17,24,26,89,119,3,417,23,0,2,2,0,42560,17238,3282,23648,0
223,5076,722,423,573,19,0,135,741,12,172,101,199,184,300,1320,2257,6,15668,870,0,2,9,9,42560,17240,3282,23650,0
223,5076,1508,847,911,44,250,301,1552,14,148,88,169,162,257,1120,1886,7,15077,837,0,2,9,9,42560,17241,3283,23651,0
337,7196,72,33,56,0,4,12,72,1,1,1,1,2,2,0,2,0,1,0,0,2,1,0,42560,17241,3283,23652,0
337,7196,1454,835,1044,76,110,219,1530,17,275,158,296,292,454,2297,3718,9,34017,1889,1,2,1,0,42570,17242,3283,23653,0
39,816,386,256,301,16,9,68,402,4,59,35,69,63,104,355,621,2,1453,80,0,2,2,0,42570,17242,3283,23654,0
39,816,264,131,164,11,41,46,275,6,38,22,40,44,62,214,338,3,1068,59,0,2,2,0,42580,17242,3284,23655,0
30,649,215,129,180,6,0,29,221,8,65,43,72,73,115,415,711,4,3153,175,0,2,3,2,42580,17242,3284,23656,0
30,649,97,69,77,3,3,16,100,6,22,13,23,28,36,113,173,3,542,30,0,2,3,2,42580,17243,3284,23657,0
128,2826,1043,504,840,53,9,147,1096,9,180,112,198,189,310,1377,2344,4,11604,644,0,2,2,0,42580,17245,3284,23658,0
128,2826,383,288,292,26,6,62,409,11,65,38,67,76,105,429,656,5,3719,206,0,2,2,0,42580,17246,3284,23659,0
20,408,294,64,250,0,0,43,294,1,20,10,20,21,30,86,131,0,65,3,0,2,2,0,42580,17246,3284,23660,0
20,408,78,46,62,3,0,14,81,3,8,4,8,11,12,28,41,1,62,3,0,2,2,0,42580,17247,3284,23661,0
5,118,110,30,77,3,13,16,113,4,21,15,30,25,45,100,208,2,597,33,0,2,2,0,42580,17247,3284,23662,0
5,118,28,15,21,1,0,6,29,0,0,0,0,0,0,0,0,0,0,0,0,2,2,0,42580,17247,3284,23663,0
104,1977,1178,367,1042,6,15,115,1184,9,94,51,95,103,146,644,976,4,4439,246,0,2,2,0,42580,17247,3284,23664,0
104,1977,177,108,140,8,0,27,185,6,30,16,32,36,48,162,248,3,794,44,0,2,2,0,42580,17249,3284,23665,0
184,3757,1943,715,1694,26,18,214,1969,12,185,120,237,197,357,1436,2721,7,20915,1161,0,2,2,0,42580,17251,3284,23666,0
184,3757,1168,838,957,57,25,144,1225,19,348,224,416,367,640,3018,5452,11,61921,3440,1,2,2,0,42590,17253,3284,23667,0
16,480,442,244,305,14,16,103,456,11,68,45,75,79,120,452,756,6,4588,254,0,2,2,0,42590,17255,3284,23668,0
16,480,182,102,99,11,40,35,193,3,11,6,11,14,17,42,64,1,97,5,0,2,2,0,42590,17256,3284,23669,0
62,1248,1098,241,925,5,10,155,1103,7,46,25,49,53,74,273,423,3,1580,87,0,2,1,1,42600,17258,3284,23670,0
62,1248,282,202,222,14,2,44,296,8,42,24,43,50,67,250,378,4,1548,86,0,2,1,1,42600,17259,3284,23671,0
78,3314,1289,550,1043,56,32,155,1345,10,167,93,185,177,278,1266,2075,5,11498,638,0,2,1,0,42600,17261,3285,23672,0
34,997,182,127,129,0,0,53,182,5,39,21,42,44,63,217,343,2,926,51,0,2,1,0,42600,17261,3286,23673,0
137,6599,1392,870,1177,35,17,170,1427,14,494,280,531,508,811,4473,7289,7,54850,3047,2,2,2,1,42600,17264,3287,23674,0
91,3011,773,419,590,28,0,166,801,10,204,113,217,214,330,1598,2554,5,13587,754,0,2,1,0,42600,17264,3288,23675,0
7,263,75,38,59,1,3,12,76,2,4,2,4,6,6,10,15,1,15,0,0,2,1,0,42600,17264,3288,23676,0
94,4280,1338,495,1086,10,64,173,1348,11,122,82,157,133,239,883,1686,7,11934,663,0,2,6,4,42600,17266,3288,23677,0
23,601,102,59,69,5,3,24,107,6,22,15,28,28,43,113,206,3,789,43,0,2,1,1,42600,17266,3288,23678,0
109,4101,1450,624,1228,12,26,181,1462,14,306,186,354,320,540,2580,4493,8,36391,2021,1,2,1,0,42600,17268,3289,23679,0
148,4088,1660,832,1314,41,38,274,1701,20,312,209,395,332,604,2671,5058,12,64042,3557,1,2,1,0,42600,17270,3290,23681,0
117,4641,1513,682,1277,25,13,200,1538,11,199,116,219,210,335,1557,2584,6,15641,868,0,2,4,3,42600,17272,3290,23682,0
59,3310,1296,573,1062,40,33,157,1336,8,201,118,231,209,349,1561,2689,4,12365,686,0,2,1,0,42600,17272,3290,23683,0
10,236,207,111,150,11,0,50,218,5,26,19,36,31,55,133,272,3,943,52,0,2,1,0,42600,17272,3290,23684,0
78,4093,1457,730,1242,11,6,188,1468,10,292,166,329,302,495,2424,4078,5,22973,1276,1,2,1,0,42600,17274,3290,23685,0
38,2286,652,304,544,16,6,88,668,6,89,51,101,95,152,591,998,3,3399,188,0,2,1,0,42600,17275,3290,23686,0
62,2878,1455,414,1257,16,76,112,1471,5,41,23,46,46,69,231,381,2,1069,59,0,2,1,0,42600,17276,3290,23687,0
2,75,7,6,5,0,0,2,7,1,1,1,2,2,3,0,3,1,3,0,0,2,1,0,42600,17276,3290,23688,0
8,273,74,35,59,1,0,14,75,3,14,7,14,17,21,58,85,1,128,7,0,2,1,0,42600,17277,3290,23689,0
87,4331,1523,757,1297,19,12,193,1542,12,193,117,230,205,347,1508,2664,7,19053,1058,0,2,2,2,42610,17279,3290,23690,0
66,2763,1020,354,843,12,15,144,1032,8,134,77,144,142,221,970,1580,4,6792,377,0,2,2,1,42610,17279,3290,23691,0
37,1624,447,308,343,6,5,95,453,7,96,59,111,103,170,651,1136,4,4600,255,0,2,1,0,42610,17282,3290,23692,0
21,661,424,94,331,4,0,89,428,1,5,5,5,6,10,11,25,0,12,0,0,2,1,0,42610,17283,3290,23693,0
40,2359,334,251,279,10,4,40,344,5,127,74,143,132,217,899,1528,2,4303,239,0,2,1,1,42610,17284,3290,23694,0
12,492,184,100,137,2,15,30,186,6,38,20,39,44,59,214,322,3,991,55,0,2,1,0,42610,17285,3290,23695,0
35,1623,1293,570,1093,25,15,163,1318,10,195,123,241,205,364,1516,2795,6,17273,959,0,2,1,0,42620,17287,3290,23696,0
36,1978,384,251,317,7,8,52,391,11,70,44,84,81,128,467,811,6,5355,297,0,2,1,0,42620,17287,3290,23697,0
15,638,722,423,573,19,0,135,741,12,172,101,199,184,300,1320,2257,6,15668,870,0,2,1,0,42620,17289,3290,23699,0
31,1439,386,256,301,16,9,68,402,4,59,35,69,63,104,355,621,2,1453,80,0,2,1,0,42620,17289,3290,23700,0
16,1209,215,129,180,6,0,29,221,8,65,43,72,73,115,415,711,4,3153,175,0,2,1,0,42620,17289,3290,23701,0
69,2856,1043,504,840,53,9,147,1096,9,180,112,198,189,310,1377,2344,4,11604,644,0,2,1,1,42620,17291,3290,23702,0
14,529,295,56,236,0,4,54,295,2,9,5,10,11,15,30,51,1,57,3,0,2,5,3,42620,17293,3290,23703,0
25,1027,373,158,315,8,0,51,381,5,76,44,79,81,123,486,779,2,2026,112,0,2,1,0,42620,17293,3290,23704,0
71,3006,1178,367,1042,6,15,115,1184,9,94,51,95,103,146,644,976,4,4439,246,0,2,1,0,42620,17293,3290,23705,0
73,3738,1943,715,1694,26,18,214,1969,12,185,120,237,197,357,1436,2721,7,20915,1161,0,2,1,0,42620,17295,3290,23706,0
14,825,442,244,305,14,16,103,456,11,68,45,75,79,120,452,756,6,4588,254,0,2,1,0,42620,17297,3290,23707,0
48,1784,1098,241,925,5,10,155,1103,7,46,25,49,53,74,273,423,3,1580,87,0,2,1,0,42630,17299,3290,23708,0
79,1563,1020,354,843,12,15,144,1032,8,134,77,144,142,221,970,1580,4,6792,377,0,2,62,15,42630,17299,3290,23709,1
336,7198,72,33,56,0,4,12,72,1,1,1,1,2,2,0,2,0,1,0,0,2,36,35,42630,17299,3290,23710,1
336,7198,1454,835,1044,76,110,219,1530,17,275,158,296,292,454,2297,3718,9,34017,1889,1,2,36,35,42640,17300,3290,23711,1
112,5702,1782,648,1425,9,47,279,1791,8,171,97,189,179,286,1292,2140,4,9462,525,0,2,68,31,42640,17301,3291,23712,1
67,2928,1020,354,843,12,15,144,1032,8,134,77,144,142,221,970,1580,4,6792,377,0,2,22,6,42640,17301,3291,23713,1
79,1563,1020,354,843,12,15,144,1032,8,134,77,144,142,221,970,1580,4,6792,377,0,2,62,15,42640,17301,3291,23714,0
336,7198,72,33,56,0,4,12,72,1,1,1,1,2,2,0,2,0,1,0,0,2,36,35,42640,17301,3291,23715,0
336,7198,1454,835,1044,76,110,219,1530,17,275,158,296,292,454,2297,3718,9,34017,1889,1,2,36,35,42650,17302,3291,23716,0
112,5702,1782,648,1425,9,47,279,1791,8,171,97,189,179,286,1292,2140,4,9462,525,0,2,68,31,42650,17303,3292,23717,0
67,2928,1020,354,843,12,15,144,1032,8,134,77,144,142,221,970,1580,4,6792,377,0,2,22,6,42650,17303,3292,23718,0
9,231,19,8,11,5,0,4,24,2,5,3,6,7,9,13,25,1,30,1,0,2,1,1,42650,17303,3292,23719,0
9,231,102,59,69,5,3,24,107,6,22,15,28,28,43,113,206,3,789,43,0,2,1,1,42650,17303,3292,23720,0
9,231,106,40,36,3,49,17,109,8,17,13,23,25,36,93,167,5,904,50,0,2,1,1,42650,17303,3292,23721,0
211,4523,182,127,129,0,0,53,182,5,39,21,42,44,63,217,343,2,926,51,0,2,1,0,42660,17307,3294,23729,0
211,4523,1165,710,800,67,119,181,1232,18,243,153,282,261,435,2000,3492,10,36473,2026,1,2,1,0,42670,17307,3295,23730,0
99,2081,773,419,590,28,0,166,801,10,204,113,217,214,330,1598,2554,5,13587,754,0,2,1,1,42670,17307,3296,23731,0
99,2081,421,273,302,44,34,57,465,17,81,59,107,98,166,583,1098,11,12329,684,0,2,1,1,42670,17307,3297,23732,0
28,556,2,2,2,0,0,0,2,0,0,0,0,0,0,0,0,0,0,0,0,2,1,0,42670,17307,3297,23732,0
28,556,99,48,90,1,3,5,100,0,0,0,0,0,0,0,0,0,0,0,0,2,1,0,42670,17308,3297,23733,0
28,556,8,5,5,2,0,1,10,0,0,0,0,0,0,0,0,0,0,0,0,2,1,0,42670,17308,3297,23734,0
28,556,1217,716,841,84,126,174,1301,14,185,118,215,199,333,1446,2542,8,20687,1149,0,2,1,0,42680,17310,3297,23735,0
28,556,160,89,115,0,13,31,160,7,15,11,17,22,28,78,124,3,495,27,0,2,1,0,42680,17310,3297,23736,0
28,556,10,10,9,9,0,0,19,0,0,0,0,0,0,0,0,0,0,0,0,2,1,0,42680,17310,3298,23737,0
28,556,173,84,99,8,29,36,181,5,12,7,13,17,20,54,81,2,221,12,0,2,1,0,42680,17311,3298,23738,0
28,556,3,1,1,3,0,0,6,0,0,0,0,0,0,0,0,0,0,0,0,2,1,0,42680,17311,3298,23739,0
163,5082,1660,832,1314,41,38,274,1701,20,312,209,395,332,604,2671,5058,12,64042,3557,1,2,1,1,42680,17313,3299,23741,0
163,5082,1057,646,719,113,100,145,1170,18,215,134,248,233,382,1740,3004,10,31186,1732,1,2,1,1,42690,17314,3300,23742,0
17,349,95,58,50,9,16,20,104,12,33,24,45,45,69,209,378,8,3100,172,0,2,1,1,42690,17314,3300,23743,0
82,1800,477,336,357,30,23,73,507,16,194,134,250,210,384,1538,2962,10,30538,1696,0,2,1,0,42700,17315,3300,23744,0
60,1262,996,429,845,24,10,117,1020,7,76,50,88,83,138,494,879,4,3565,198,0,2,1,1,42700,17317,3300,23745,0
60,1262,456,277,329,12,42,72,468,13,85,50,97,98,147,592,972,7,7212,400,0,2,1,1,42700,17317,3300,23746,0
119,2424,1513,682,1277,25,13,200,1538,11,199,116,219,210,335,1557,2584,6,15641,868,0,2,1,1,42700,17319,3300,23747,0
119,2424,819,519,539,24,98,155,843,15,96,57,106,111,163,690,1107,8,9171,509,0,2,1,1,42710,17321,3300,23748,0
50,1032,207,111,150,11,0,50,218,5,26,19,36,31,55,133,272,3,943,52,0,2,1,0,42710,17321,3300,23749,0
50,1032,410,198,237,31,55,97,441,11,63,38,72,74,110,414,683,6,4293,238,0,2,1,0,42720,17322,3301,23750,0
346,7021,1457,730,1242,11,6,188,1468,10,292,166,329,302,495,2424,4078,5,22973,1276,1,2,1,0,42720,17324,3301,23751,0
346,7021,74,35,59,1,0,14,75,3,14,7,14,17,21,58,85,1,128,7,0,2,1,0,42720,17325,3301,23752,0
346,7021,245,125,200,5,7,34,250,7,30,17,34,37,51,166,265,3,1053,58,0,2,1,0,42730,17326,3301,23753,0
22,683,339,213,244,17,9,65,356,10,42,26,48,52,74,259,421,5,2410,133,0,2,1,1,42740,17326,3301,23754,0
56,1603,1455,414,1257,16,76,112,1471,5,41,23,46,46,69,231,381,2,1069,59,0,2,1,1,42740,17327,3301,23756,0
56,1603,669,365,481,22,61,110,691,15,103,63,122,118,185,747,1273,8,11311,628,0,2,1,1,42750,17327,3302,23757,0
227,5129,4293,999,3693,19,54,507,4312,9,155,88,170,164,258,1156,1898,4,9368,520,0,2,1,0,42750,17329,3302,23758,0
227,5129,1482,859,1002,125,135,219,1607,16,219,134,251,235,385,1766,3032,9,27804,1544,1,2,1,0,42760,17330,3302,23759,0
7,147,44,22,19,0,19,6,44,2,10,6,12,12,18,35,64,1,77,4,0,2,3,1,42760,17330,3302,23760,0
24,842,74,35,59,1,0,14,75,3,14,7,14,17,21,58,85,1,128,7,0,2,2,0,42760,17331,3302,23761,0
24,842,245,125,200,5,7,34,250,7,30,17,34,37,51,166,265,3,1053,58,0,2,2,0,42770,17332,3302,23762,0
83,2329,1523,757,1297,19,12,193,1542,12,193,117,230,205,347,1508,2664,7,19053,1058,0,2,4,2,42780,17334,3302,23763,0
83,2329,701,378,504,33,58,109,734,13,110,68,126,123,194,794,1346,7,10027,557,0,2,4,2,42780,17335,3303,23764,0
178,4168,77,34,69,0,0,8,77,3,24,16,29,27,45,114,213,1,387,21,0,2,2,0,42780,17335,3303,23765,0
178,4168,712,438,573,51,9,84,763,14,102,71,128,116,199,733,1364,8,11988,666,0,2,2,0,42790,17336,3303,23766,0
79,1563,1020,354,843,12,15,144,1032,8,134,77,144,142,221,970,1580,4,6792,377,0,2,64,15,42790,17336,3303,23767,0
46,959,447,308,343,6,5,95,453,7,96,59,111,103,170,651,1136,4,4600,255,0,2,1,0,42790,17339,3303,23768,0
46,959,322,174,179,16,74,51,338,10,41,26,46,51,72,252,408,5,2291,127,0,2,1,0,42790,17342,3304,23769,0
23,382,424,94,331,4,0,89,428,1,5,5,5,6,10,11,25,0,12,0,0,2,1,0,42790,17343,3304,23770,0
23,382,38,23,23,6,0,8,44,3,11,7,11,14,18,42,68,1,102,5,0,2,1,0,42790,17343,3304,23771,0
17,518,184,100,137,2,15,30,186,6,38,20,39,44,59,214,322,3,991,55,0,2,2,0,42790,17344,3304,23772,0
17,518,103,65,74,8,5,16,111,7,17,9,17,24,26,89,119,3,417,23,0,2,2,0,42790,17345,3304,23773,0
223,5076,722,423,573,19,0,135,741,12,172,101,199,184,300,1320,2257,6,15668,870,0,2,9,9,42790,17347,3304,23775,0
223,5076,1508,847,911,44,250,301,1552,14,148,88,169,162,257,1120,1886,7,15077,837,0,2,9,9,42790,17348,3305,23776,0
336,7198,72,33,56,0,4,12,72,1,1,1,1,2,2,0,2,0,1,0,0,2,37,35,42790,17348,3305,23777,0
336,7198,1454,835,1044,76,110,219,1530,17,275,158,296,292,454,2297,3718,9,34017,1889,1,2,37,35,42800,17349,3305,23778,0
39,792,386,256,301,16,9,68,402,4,59,35,69,63,104,355,621,2,1453,80,0,2,2,0,42800,17349,3305,23779,0
39,792,264,131,164,11,41,46,275,6,38,22,40,44,62,214,338,3,1068,59,0,2,2,0,42810,17349,3306,23780,0
30,649,215,129,180,6,0,29,221,8,65,43,72,73,115,415,711,4,3153,175,0,2,3,2,42810,17349,3306,23781,0
30,649,97,69,77,3,3,16,100,6,22,13,23,28,36,113,173,3,542,30,0,2,3,2,42810,17350,3306,23782,0
128,2826,1043,504,840,53,9,147,1096,9,180,112,198,189,310,1377,2344,4,11604,644,0,2,2,0,42810,17352,3306,23783,0
128,2826,383,288,292,26,6,62,409,11,65,38,67,76,105,429,656,5,3719,206,0,2,2,0,42810,17353,3306,23784,0
20,408,294,64,250,0,0,43,294,1,20,10,20,21,30,86,131,0,65,3,0,2,2,0,42810,17353,3306,23785,0
20,408,78,46,62,3,0,14,81,3,8,4,8,11,12,28,41,1,62,3,0,2,2,0,42810,17354,3306,23786,0
5,118,110,30,77,3,13,16,113,4,21,15,30,25,45,100,208,2,597,33,0,2,2,0,42810,17354,3306,23787,0
5,118,28,15,21,1,0,6,29,0,0,0,0,0,0,0,0,0,0,0,0,2,2,0,42810,17354,3306,23788,0
104,1977,1178,367,1042,6,15,115,1184,9,94,51,95,103,146,644,976,4,4439,246,0,2,2,0,42810,17354,3306,23789,0
104,1977,177,108,140,8,0,27,185,6,30,16,32,36,48,162,248,3,794,44,0,2,2,0,42810,17356,3306,23790,0
191,3892,1943,715,1694,26,18,214,1969,12,185,120,237,197,357,1436,2721,7,20915,1161,0,2,2,1,42810,17358,3306,23791,0
191,3892,1168,838,957,57,25,144,1225,19,348,224,416,367,640,3018,5452,11,61921,3440,1,2,2,1,42820,17360,3306,23792,0
16,480,442,244,305,14,16,103,456,11,68,45,75,79,120,452,756,6,4588,254,0,2,2,0,42820,17362,3306,23793,0
16,480,182,102,99,11,40,35,193,3,11,6,11,14,17,42,64,1,97,5,0,2,2,0,42820,17363,3306,23794,0
62,1248,1098,241,925,5,10,155,1103,7,46,25,49,53,74,273,423,3,1580,87,0,2,1,1,42830,17365,3306,23795,0
62,1248,282,202,222,14,2,44,296,8,42,24,43,50,67,250,378,4,1548,86,0,2,1,1,42830,17366,3306,23796,0
78,3314,1289,550,1043,56,32,155,1345,10,167,93,185,177,278,1266,2075,5,11498,638,0,2,1,0,42830,17368,3307,23797,0
34,997,182,127,129,0,0,53,182,5,39,21,42,44,63,217,343,2,926,51,0,2,1,0,42830,17368,3308,23798,0
137,6599,1392,870,1177,35,17,170,1427,14,494,280,531,508,811,4473,7289,7,54850,3047,2,2,2,1,42830,17371,3309,23799,0
91,3011,773,419,590,28,0,166,801,10,204,113,217,214,330,1598,2554,5,13587,754,0,2,1,0,42830,17371,3310,23800,0
7,263,75,38,59,1,3,12,76,2,4,2,4,6,6,10,15,1,15,0,0,2,1,0,42830,17371,3310,23801,0
94,4283,1338,495,1086,10,64,173,1348,11,122,82,157,133,239,883,1686,7,11934,663,0,2,6,4,42830,17373,3310,23802,0
112,5702,1782,648,1425,9,47,279,1791,8,171,97,189,179,286,1292,2140,4,9462,525,0,2,68,31,42830,17374,3311,23803,0
23,601,102,59,69,5,3,24,107,6,22,15,28,28,43,113,206,3,789,43,0,2,1,1,42830,17374,3311,23804,0
109,4106,1450,624,1228,12,26,181,1462,14,306,186,354,320,540,2580,4493,8,36391,2021,1,2,1,0,42830,17376,3312,23805,0
148,4088,1660,832,1314,41,38,274,1701,20,312,209,395,332,604,2671,5058,12,64042,3557,1,2,1,0,42830,17378,3313,23807,0
117,4641,1513,682,1277,25,13,200,1538,11,199,116,219,210,335,1557,2584,6,15641,868,0,2,4,3,42830,17380,3313,23808,0
59,3310,1296,573,1062,40,33,157,1336,8,201,118,231,209,349,1561,2689,4,12365,686,0,2,1,0,42830,17380,3313,23809,0
10,236,207,111,150,11,0,50,218,5,26,19,36,31,55,133,272,3,943,52,0,2,1,0,42830,17380,3313,23810,0
78,4093,1457,730,1242,11,6,188,1468,10,292,166,329,302,495,2424,4078,5,22973,1276,1,2,1,0,42830,17382,3313,23811,0
38,2286,652,304,544,16,6,88,668,6,89,51,101,95,152,591,998,3,3399,188,0,2,1,0,42830,17383,3313,23812,0
62,2878,1455,414,1257,16,76,112,1471,5,41,23,46,46,69,231,381,2,1069,59,0,2,1,0,42830,17384,3313,23813,0
2,75,7,6,5,0,0,2,7,1,1,1,2,2,3,0,3,1,3,0,0,2,1,0,42830,17384,3313,23814,0
8,273,74,35,59,1,0,14,75,3,14,7,14,17,21,58,85,1,128,7,0,2,1,0,42830,17385,3313,23815,0
87,4336,1523,757,1297,19,12,193,1542,12,193,117,230,205,347,1508,2664,7,19053,1058,0,2,1,1,42840,17387,3313,23816,0
67,2928,1020,354,843,12,15,144,1032,8,134,77,144,142,221,970,1580,4,6792,377,0,2,24,7,42840,17387,3313,23817,0
37,1624,447,308,343,6,5,95,453,7,96,59,111,103,170,651,1136,4,4600,255,0,2,1,0,42840,17390,3313,23818,0
21,661,424,94,331,4,0,89,428,1,5,5,5,6,10,11,25,0,12,0,0,2,1,0,42840,17391,3313,23819,0
40,2359,334,251,279,10,4,40,344,5,127,74,143,132,217,899,1528,2,4303,239,0,2,1,1,42840,17392,3313,23820,0
12,492,184,100,137,2,15,30,186,6,38,20,39,44,59,214,322,3,991,55,0,2,1,0,42840,17393,3313,23821,0
35,1623,1293,570,1093,25,15,163,1318,10,195,123,241,205,364,1516,2795,6,17273,959,0,2,1,0,42850,17395,3313,23822,0
36,1978,384,251,317,7,8,52,391,11,70,44,84,81,128,467,811,6,5355,297,0,2,1,0,42850,17395,3313,23823,0
15,638,722,423,573,19,0,135,741,12,172,101,199,184,300,1320,2257,6,15668,870,0,2,1,0,42850,17397,3313,23825,0
31,1439,386,256,301,16,9,68,402,4,59,35,69,63,104,355,621,2,1453,80,0,2,1,0,42850,17397,3313,23826,0
16,1209,215,129,180,6,0,29,221,8,65,43,72,73,115,415,711,4,3153,175,0,2,1,0,42850,17397,3313,23827,0
69,2856,1043,504,840,53,9,147,1096,9,180,112,198,189,310,1377,2344,4,11604,644,0,2,1,1,42850,17399,3313,23828,0
14,529,295,56,236,0,4,54,295,2,9,5,10,11,15,30,51,1,57,3,0,2,5,3,42850,17401,3313,23829,0
25,1027,373,158,315,8,0,51,381,5,76,44,79,81,123,486,779,2,2026,112,0,2,1,0,42850,17401,3313,23830,0
71,3006,1178,367,1042,6,15,115,1184,9,94,51,95,103,146,644,976,4,4439,246,0,2,1,0,42850,17401,3313,23831,0
73,3738,1943,715,1694,26,18,214,1969,12,185,120,237,197,357,1436,2721,7,20915,1161,0,2,1,0,42850,17403,3313,23832,0
14,825,442,244,305,14,16,103,456,11,68,45,75,79,120,452,756,6,4588,254,0,2,1,0,42850,17405,3313,23833,0
48,1784,1098,241,925,5,10,155,1103,7,46,25,49,53,74,273,423,3,1580,87,0,2,1,0,42860,17407,3313,23834,0
14,339,601,196,481,2,23,85,603,8,63,36,72,71,108,400,664,4,3036,168,0,2,3,1,42860,17407,3313,23835,0
14,339,156,79,106,5,16,28,161,5,14,8,15,19,23,64,97,2,261,14,0,2,3,1,42860,17407,3313,23836,0
14,339,601,196,481,2,23,85,603,8,63,36,72,71,108,400,664,4,3036,168,0,2,1,1,42860,17407,3313,23837,0
14,339,156,79,106,5,16,28,161,5,14,8,15,19,23,64,97,2,261,14,0,2,1,1,42860,17407,3313,23838,0
336,7200,72,33,56,0,4,12,72,1,1,1,1,2,2,0,2,0,1,0,0,2,1,1,42860,17407,3313,23839,1
336,7200,1454,835,1044,76,110,219,1530,17,275,158,296,292,454,2297,3718,9,34017,1889,1,2,1,1,42870,17408,3313,23840,1
78,3324,1289,550,1043,56,32,155,1345,10,167,93,185,177,278,1266,2075,5,11498,638,0,2,9,3,42870,17410,3314,23841,1
147,6797,139,89,101,2,0,35,141,7,54,34,62,61,96,330,569,4,2287,127,0,2,26,15,42870,17410,3314,23842,1
147,6797,7,5,5,0,0,2,7,1,2,1,2,3,3,2,4,0,2,0,0,2,26,15,42870,17410,3314,23843,1
112,5710,1782,648,1425,9,47,279,1791,8,171,97,189,179,286,1292,2140,4,9462,525,0,2,2,1,42870,17411,3315,23844,1
78,4093,1457,730,1242,11,6,188,1468,10,292,166,329,302,495,2424,4078,5,22973,1276,1,2,1,1,42870,17413,3315,23845,1
40,2367,334,251,279,10,4,40,344,5,127,74,143,132,217,899,1528,2,4303,239,0,2,8,7,42870,17414,3315,23846,1
223,5076,722,423,573,19,0,135,741,12,172,101,199,184,300,1320,2257,6,15668,870,0,2,1,1,42870,17416,3315,23848,1
223,5076,1508,847,911,44,250,301,1552,14,148,88,169,162,257,1120,1886,7,15077,837,0,2,1,1,42870,17417,3316,23849,1
128,2841,1043,504,840,53,9,147,1096,9,180,112,198,189,310,1377,2344,4,11604,644,0,2,12,5,42870,17419,3316,23850,1
128,2841,383,288,292,26,6,62,409,11,65,38,67,76,105,429,656,5,3719,206,0,2,12,5,42870,17420,3316,23851,1
78,3341,1289,550,1043,56,32,155,1345,10,167,93,185,177,278,1266,2075,5,11498,638,0,2,6,1,42870,17422,3317,23852,0
346,7021,1457,730,1242,11,6,188,1468,10,292,166,329,302,495,2424,4078,5,22973,1276,1,2,3,3,42870,17424,3317,23853,0
346,7021,74,35,59,1,0,14,75,3,14,7,14,17,21,58,85,1,128,7,0,2,3,3,42870,17425,3317,23854,0
346,7021,245,125,200,5,7,34,250,7,30,17,34,37,51,166,265,3,1053,58,0,2,3,3,42880,17426,3317,23855,0
227,5129,4293,999,3693,19,54,507,4312,9,155,88,170,164,258,1156,1898,4,9368,520,0,2,1,1,42880,17428,3317,23856,0
227,5129,1482,859,1002,125,135,219,1607,16,219,134,251,235,385,1766,3032,9,27804,1544,1,2,1,1,42890,17429,3317,23857,0
223,5076,722,423,573,19,0,135,741,12,172,101,199,184,300,1320,2257,6,15668,870,0,2,1,1,42890,17431,3317,23859,0
223,5076,1508,847,911,44,250,301,1552,14,148,88,169,162,257,1120,1886,7,15077,837,0,2,1,1,42890,17432,3318,23860,0
336,7200,72,33,56,0,4,12,72,1,1,1,1,2,2,0,2,0,1,0,0,2,1,1,42890,17432,3318,23861,0
336,7200,1454,835,1044,76,110,219,1530,17,275,158,296,292,454,2297,3718,9,34017,1889,1,2,1,1,42900,17433,3318,23862,0
39,792,386,256,301,16,9,68,402,4,59,35,69,63,104,355,621,2,1453,80,0,2,0,2,42900,17433,3318,23863,0
39,792,264,131,164,11,41,46,275,6,38,22,40,44,62,214,338,3,1068,59,0,2,0,2,42910,17433,3319,23864,0
128,2841,1043,504,840,53,9,147,1096,9,180,112,198,189,310,1377,2344,4,11604,644,0,2,12,5,42910,17435,3319,23865,0
128,2841,383,288,292,26,6,62,409,11,65,38,67,76,105,429,656,5,3719,206,0,2,12,5,42910,17436,3319,23866,0
191,3892,1943,715,1694,26,18,214,1969,12,185,120,237,197,357,1436,2721,7,20915,1161,0,2,51,19,42910,17438,3319,23867,0
191,3892,1168,838,957,57,25,144,1225,19,348,224,416,367,640,3018,5452,11,61921,3440,1,2,51,19,42920,17440,3319,23868,0
14,339,601,196,481,2,23,85,603,8,63,36,72,71,108,400,664,4,3036,168,0,0,73,0,42920,17440,3319,23869,0
14,339,156,79,106,5,16,28,161,5,14,8,15,19,23,64,97,2,261,14,0,0,73,0,42920,17440,3319,23870,0
78,3341,1289,550,1043,56,32,155,1345,10,167,93,185,177,278,1266,2075,5,11498,638,0,2,15,4,42920,17442,3320,23871,0
7,263,75,38,59,1,3,12,76,2,4,2,4,6,6,10,15,1,15,0,0,2,1,1,42920,17442,3320,23872,0
94,4283,1338,495,1086,10,64,173,1348,11,122,82,157,133,239,883,1686,7,11934,663,0,2,5,5,42920,17444,3320,23873,0
147,6797,139,89,101,2,0,35,141,7,54,34,62,61,96,330,569,4,2287,127,0,2,26,15,42920,17444,3320,23874,0
147,6797,7,5,5,0,0,2,7,1,2,1,2,3,3,2,4,0,2,0,0,2,26,15,42920,17444,3320,23875,0
112,5710,1782,648,1425,9,47,279,1791,8,171,97,189,179,286,1292,2140,4,9462,525,0,2,2,1,42920,17445,3321,23876,0
109,4106,1450,624,1228,12,26,181,1462,14,306,186,354,320,540,2580,4493,8,36391,2021,1,2,4,1,42920,17447,3322,23877,0
78,4093,1457,730,1242,11,6,188,1468,10,292,166,329,302,495,2424,4078,5,22973,1276,1,2,5,4,42920,17449,3322,23878,0
87,4336,1523,757,1297,19,12,193,1542,12,193,117,230,205,347,1508,2664,7,19053,1058,0,2,4,1,42930,17451,3322,23879,0
40,2367,334,251,279,10,4,40,344,5,127,74,143,132,217,899,1528,2,4303,239,0,2,8,7,42930,17452,3322,23880,0
36,1978,384,251,317,7,8,52,391,11,70,44,84,81,128,467,811,6,5355,297,0,2,2,2,42930,17452,3322,23881,0
31,1439,386,256,301,16,9,68,402,4,59,35,69,63,104,355,621,2,1453,80,0,2,3,1,42930,17452,3322,23882,0
73,3738,1943,715,1694,26,18,214,1969,12,185,120,237,197,357,1436,2721,7,20915,1161,0,2,8,8,42930,17454,3322,23883,0
9,317,601,196,481,2,23,85,603,8,63,36,72,71,108,400,664,4,3036,168,0,0,108,0,42930,17454,3322,23884,0
27,545,2,2,2,0,0,0,2,0,0,0,0,0,0,0,0,0,0,0,0,2,0,3,42930,17454,3322,23884,1
27,545,99,48,90,1,3,5,100,0,0,0,0,0,0,0,0,0,0,0,0,2,0,3,42930,17455,3322,23885,1
27,545,8,5,5,2,0,1,10,0,0,0,0,0,0,0,0,0,0,0,0,2,0,3,42930,17455,3322,23886,1
27,545,1217,716,841,84,126,174,1301,14,185,118,215,199,333,1446,2542,8,20687,1149,0,2,0,3,42940,17457,3322,23887,1
27,545,160,89,115,0,13,31,160,7,15,11,17,22,28,78,124,3,495,27,0,2,0,3,42940,17457,3322,23888,1
27,545,10,10,9,9,0,0,19,0,0,0,0,0,0,0,0,0,0,0,0,2,0,3,42940,17457,3323,23889,1
27,545,173,84,99,8,29,36,181,5,12,7,13,17,20,54,81,2,221,12,0,2,0,3,42940,17458,3323,23890,1
27,545,3,1,1,3,0,0,6,0,0,0,0,0,0,0,0,0,0,0,0,2,0,3,42940,17458,3323,23891,1
346,7021,1457,730,1242,11,6,188,1468,10,292,166,329,302,495,2424,4078,5,22973,1276,1,2,1,0,42940,17460,3323,23892,1
346,7021,74,35,59,1,0,14,75,3,14,7,14,17,21,58,85,1,128,7,0,2,1,0,42940,17461,3323,23893,1
346,7021,245,125,200,5,7,34,250,7,30,17,34,37,51,166,265,3,1053,58,0,2,1,0,42950,17462,3323,23894,1
6,136,44,22,19,0,19,6,44,2,10,6,12,12,18,35,64,1,77,4,0,2,0,3,42950,17462,3323,23895,1
21,670,339,213,244,17,9,65,356,10,42,26,48,52,74,259,421,5,2410,133,0,2,8,8,42960,17462,3323,23896,1
227,5121,4293,999,3693,19,54,507,4312,9,155,88,170,164,258,1156,1898,4,9368,520,0,2,0,2,42960,17464,3323,23897,1
227,5121,1482,859,1002,125,135,219,1607,16,219,134,251,235,385,1766,3032,9,27804,1544,1,2,0,2,42970,17465,3323,23898,1
38,777,386,256,301,16,9,68,402,4,59,35,69,63,104,355,621,2,1453,80,0,2,0,5,42970,17465,3323,23899,1
38,777,264,131,164,11,41,46,275,6,38,22,40,44,62,214,338,3,1068,59,0,2,0,5,42980,17465,3324,23900,1
127,2817,1043,504,840,53,9,147,1096,9,180,112,198,189,310,1377,2344,4,11604,644,0,2,0,7,42980,17467,3324,23901,1
127,2817,383,288,292,26,6,62,409,11,65,38,67,76,105,429,656,5,3719,206,0,2,0,7,42980,17468,3324,23902,1
80,1581,1020,354,843,12,15,144,1032,8,134,77,144,142,221,970,1580,4,6792,377,0,2,13,5,42980,17468,3324,23903,1
103,1965,1178,367,1042,6,15,115,1184,9,94,51,95,103,146,644,976,4,4439,246,0,2,0,4,42980,17468,3324,23904,1
103,1965,177,108,140,8,0,27,185,6,30,16,32,36,48,162,248,3,794,44,0,2,0,4,42980,17470,3324,23905,1
49,575,647,139,84,35,284,233,682,0,0,0,0,0,0,0,0,0,0,0,0,2,3,1,42980,17470,3324,23906,1
80,1586,1020,354,843,12,15,144,1032,8,134,77,144,142,221,970,1580,4,6792,377,0,2,1,1,42980,17470,3324,23907,1
52,1103,207,111,150,11,0,50,218,5,26,19,36,31,55,133,272,3,943,52,0,2,23,0,42980,17470,3324,23908,1
52,1103,410,198,237,31,55,97,441,11,63,38,72,74,110,414,683,6,4293,238,0,2,23,0,42990,17471,3325,23909,1
227,5114,4293,999,3693,19,54,507,4312,9,155,88,170,164,258,1156,1898,4,9368,520,0,2,1,3,42990,17473,3325,23910,1
227,5114,1482,859,1002,125,135,219,1607,16,219,134,251,235,385,1766,3032,9,27804,1544,1,2,1,3,43000,17474,3325,23911,1
177,4136,77,34,69,0,0,8,77,3,24,16,29,27,45,114,213,1,387,21,0,2,0,5,43000,17474,3325,23912,1
177,4136,712,438,573,51,9,84,763,14,102,71,128,116,199,733,1364,8,11988,666,0,2,0,5,43010,17475,3325,23913,1
335,7153,72,33,56,0,4,12,72,1,1,1,1,2,2,0,2,0,1,0,0,2,6,16,43010,17475,3325,23914,1
335,7153,1454,835,1044,76,110,219,1530,17,275,158,296,292,454,2297,3718,9,34017,1889,1,2,6,16,43020,17476,3325,23915,1
226,5106,4293,999,3693,19,54,507,4312,9,155,88,170,164,258,1156,1898,4,9368,520,0,2,5,9,43020,17478,3325,23916,1
226,5106,1482,859,1002,125,135,219,1607,16,219,134,251,235,385,1766,3032,9,27804,1544,1,2,5,9,43030,17479,3325,23917,1
53,1123,207,111,150,11,0,50,218,5,26,19,36,31,55,133,272,3,943,52,0,2,9,0,43030,17479,3325,23918,1
53,1123,410,198,237,31,55,97,441,11,63,38,72,74,110,414,683,6,4293,238,0,2,9,0,43040,17480,3326,23919,1
21,668,339,213,244,17,9,65,356,10,42,26,48,52,74,259,421,5,2410,133,0,2,2,3,43050,17480,3326,23920,1
225,5104,4293,999,3693,19,54,507,4312,9,155,88,170,164,258,1156,1898,4,9368,520,0,2,15,24,43050,17482,3326,23921,1
225,5104,1482,859,1002,125,135,219,1607,16,219,134,251,235,385,1766,3032,9,27804,1544,1,2,15,24,43060,17483,3326,23922,1
177,4124,77,34,69,0,0,8,77,3,24,16,29,27,45,114,213,1,387,21,0,2,28,22,43060,17483,3326,23923,1
177,4124,712,438,573,51,9,84,763,14,102,71,128,116,199,733,1364,8,11988,666,0,2,28,22,43070,17484,3326,23924,1
46,961,447,308,343,6,5,95,453,7,96,59,111,103,170,651,1136,4,4600,255,0,2,4,4,43070,17487,3326,23925,1
46,961,322,174,179,16,74,51,338,10,41,26,46,51,72,252,408,5,2291,127,0,2,4,4,43070,17490,3327,23926,1
335,7158,72,33,56,0,4,12,72,1,1,1,1,2,2,0,2,0,1,0,0,2,11,10,43070,17490,3327,23927,1
335,7158,1454,835,1044,76,110,219,1530,17,275,158,296,292,454,2297,3718,9,34017,1889,1,2,11,10,43080,17491,3327,23928,1
38,783,386,256,301,16,9,68,402,4,59,35,69,63,104,355,621,2,1453,80,0,2,8,6,43080,17491,3327,23929,1
38,783,264,131,164,11,41,46,275,6,38,22,40,44,62,214,338,3,1068,59,0,2,8,6,43090,17491,3328,23930,1
127,2813,1043,504,840,53,9,147,1096,9,180,112,198,189,310,1377,2344,4,11604,644,0,2,1,2,43090,17493,3328,23931,1
127,2813,383,288,292,26,6,62,409,11,65,38,67,76,105,429,656,5,3719,206,0,2,1,2,43090,17494,3328,23932,1
103,1960,1178,367,1042,6,15,115,1184,9,94,51,95,103,146,644,976,4,4439,246,0,2,20,18,43090,17494,3328,23933,1
103,1960,177,108,140,8,0,27,185,6,30,16,32,36,48,162,248,3,794,44,0,2,20,18,43090,17496,3328,23934,1
225,5102,4293,999,3693,19,54,507,4312,9,155,88,170,164,258,1156,1898,4,9368,520,0,2,3,2,43090,17498,3328,23935,1
225,5102,1482,859,1002,125,135,219,1607,16,219,134,251,235,385,1766,3032,9,27804,1544,1,2,3,2,43100,17499,3328,23936,1
335,7158,72,33,56,0,4,12,72,1,1,1,1,2,2,0,2,0,1,0,0,2,1,1,43100,17499,3328,23937,1
335,7158,1454,835,1044,76,110,219,1530,17,275,158,296,292,454,2297,3718,9,34017,1889,1,2,1,1,43110,17500,3328,23938,1
38,783,386,256,301,16,9,68,402,4,59,35,69,63,104,355,621,2,1453,80,0,2,0,1,43110,17500,3328,23939,1
38,783,264,131,164,11,41,46,275,6,38,22,40,44,62,214,338,3,1068,59,0,2,0,1,43120,17500,3329,23940,1
103,1956,1178,367,1042,6,15,115,1184,9,94,51,95,103,146,644,976,4,4439,246,0,2,11,5,43120,17500,3329,23941,1
103,1956,177,108,140,8,0,27,185,6,30,16,32,36,48,162,248,3,794,44,0,2,11,5,43120,17502,3329,23942,1
177,4127,77,34,69,0,0,8,77,3,24,16,29,27,45,114,213,1,387,21,0,2,1,1,43120,17502,3329,23943,1
177,4127,712,438,573,51,9,84,763,14,102,71,128,116,199,733,1364,8,11988,666,0,2,1,1,43130,17503,3329,23944,1
225,5106,4293,999,3693,19,54,507,4312,9,155,88,170,164,258,1156,1898,4,9368,520,0,2,3,3,43130,17505,3329,23945,0
225,5106,1482,859,1002,125,135,219,1607,16,219,134,251,235,385,1766,3032,9,27804,1544,1,2,3,3,43140,17506,3329,23946,0
23,388,424,94,331,4,0,89,428,1,5,5,5,6,10,11,25,0,12,0,0,2,9,9,43140,17507,3329,23947,1
23,388,38,23,23,6,0,8,44,3,11,7,11,14,18,42,68,1,102,5,0,2,9,9,43140,17507,3329,23948,1
62,1240,1098,241,925,5,10,155,1103,7,46,25,49,53,74,273,423,3,1580,87,0,2,25,21,43150,17509,3329,23949,1
62,1240,282,202,222,14,2,44,296,8,42,24,43,50,67,250,378,4,1548,86,0,2,25,21,43150,17510,3329,23950,1
335,7154,72,33,56,0,4,12,72,1,1,1,1,2,2,0,2,0,1,0,0,2,8,5,43150,17510,3329,23951,1
335,7154,1454,835,1044,76,110,219,1530,17,275,158,296,292,454,2297,3718,9,34017,1889,1,2,8,5,43160,17511,3329,23952,1
80,1593,1020,354,843,12,15,144,1032,8,134,77,144,142,221,970,1580,4,6792,377,0,2,2,4,43160,17511,3329,23953,1
178,4136,77,34,69,0,0,8,77,3,24,16,29,27,45,114,213,1,387,21,0,2,10,0,43160,17511,3329,23954,1
178,4136,712,438,573,51,9,84,763,14,102,71,128,116,199,733,1364,8,11988,666,0,2,10,0,43170,17512,3329,23955,1
48,904,207,111,150,11,0,50,218,5,26,19,36,31,55,133,272,3,943,52,0,2,2,0,43170,17512,3329,23956,0
48,904,410,198,237,31,55,97,441,11,63,38,72,74,110,414,683,6,4293,238,0,2,2,0,43180,17513,3330,23957,0
335,7113,72,33,56,0,4,12,72,1,1,1,1,2,2,0,2,0,1,0,0,2,2,2,43180,17513,3330,23958,0
335,7113,1454,835,1044,76,110,219,1530,17,275,158,296,292,454,2297,3718,9,34017,1889,1,2,2,2,43190,17514,3330,23959,0
95,4294,1338,495,1086,10,64,173,1348,11,122,82,157,133,239,883,1686,7,11934,663,0,2,17,0,43190,17516,3330,23960,0
48,904,207,111,150,11,0,50,218,5,26,19,36,31,55,133,272,3,943,52,0,2,1,1,43190,17516,3330,23961,0
48,904,410,198,237,31,55,97,441,11,63,38,72,74,110,414,683,6,4293,238,0,2,1,1,43200,17517,3331,23962,0
48,904,207,111,150,11,0,50,218,5,26,19,36,31,55,133,272,3,943,52,0,2,3,1,43200,17517,3331,23963,0
48,904,410,198,237,31,55,97,441,11,63,38,72,74,110,414,683,6,4293,238,0,2,3,1,43210,17518,3332,23964,0
335,7113,72,33,56,0,4,12,72,1,1,1,1,2,2,0,2,0,1,0,0,2,2,2,43210,17518,3332,23965,0
335,7113,1454,835,1044,76,110,219,1530,17,275,158,296,292,454,2297,3718,9,34017,1889,1,2,2,2,43220,17519,3332,23966,0
95,4294,1338,495,1086,10,64,173,1348,11,122,82,157,133,239,883,1686,7,11934,663,0,2,17,0,43220,17521,3332,23967,0
346,7035,1457,730,1242,11,6,188,1468,10,292,166,329,302,495,2424,4078,5,22973,1276,1,2,2,1,43220,17523,3332,23968,1
346,7035,74,35,59,1,0,14,75,3,14,7,14,17,21,58,85,1,128,7,0,2,2,1,43220,17524,3332,23969,1
346,7035,245,125,200,5,7,34,250,7,30,17,34,37,51,166,265,3,1053,58,0,2,2,1,43230,17525,3332,23970,1
79,3381,1289,550,1043,56,32,155,1345,10,167,93,185,177,278,1266,2075,5,11498,638,0,2,14,0,43230,17527,3333,23971,1
346,7035,1457,730,1242,11,6,188,1468,10,292,166,329,302,495,2424,4078,5,22973,1276,1,2,2,1,43230,17529,3333,23972,0
346,7035,74,35,59,1,0,14,75,3,14,7,14,17,21,58,85,1,128,7,0,2,2,1,43230,17530,3333,23973,0
346,7035,245,125,200,5,7,34,250,7,30,17,34,37,51,166,265,3,1053,58,0,2,2,1,43240,17531,3333,23974,0
79,3381,1289,550,1043,56,32,155,1345,10,167,93,185,177,278,1266,2075,5,11498,638,0,2,14,0,43240,17533,3334,23975,0
163,5086,1660,832,1314,41,38,274,1701,20,312,209,395,332,604,2671,5058,12,64042,3557,1,2,1,1,43240,17535,3335,23977,0
163,5086,1057,646,719,113,100,145,1170,18,215,134,248,233,382,1740,3004,10,31186,1732,1,2,1,1,43250,17536,3336,23978,0
149,4136,1660,832,1314,41,38,274,1701,20,312,209,395,332,604,2671,5058,12,64042,3557,1,2,18,0,43250,17538,3337,23980,0
9,220,19,8,11,5,0,4,24,2,5,3,6,7,9,13,25,1,30,1,0,2,1,0,43260,17542,3338,23988,1
9,220,102,59,69,5,3,24,107,6,22,15,28,28,43,113,206,3,789,43,0,2,1,0,43260,17542,3338,23989,1
9,220,106,40,36,3,49,17,109,8,17,13,23,25,36,93,167,5,904,50,0,2,1,0,43260,17542,3338,23990,1
211,4515,182,127,129,0,0,53,182,5,39,21,42,44,63,217,343,2,926,51,0,2,23,8,43260,17542,3339,23991,1
211,4515,1165,710,800,67,119,181,1232,18,243,153,282,261,435,2000,3492,10,36473,2026,1,2,23,8,43270,17542,3340,23992,1
99,2075,773,419,590,28,0,166,801,10,204,113,217,214,330,1598,2554,5,13587,754,0,2,8,15,43270,17542,3341,23993,1
99,2075,421,273,302,44,34,57,465,17,81,59,107,98,166,583,1098,11,12329,684,0,2,8,15,43270,17542,3342,23994,1
34,625,2,2,2,0,0,0,2,0,0,0,0,0,0,0,0,0,0,0,0,2,3,1,43270,17542,3342,23994,1
34,625,99,48,90,1,3,5,100,0,0,0,0,0,0,0,0,0,0,0,0,2,3,1,43270,17543,3342,23995,1
34,625,8,5,5,2,0,1,10,0,0,0,0,0,0,0,0,0,0,0,0,2,3,1,43270,17543,3342,23996,1
34,625,1217,716,841,84,126,174,1301,14,185,118,215,199,333,1446,2542,8,20687,1149,0,2,3,1,43280,17545,3342,23997,1
34,625,160,89,115,0,13,31,160,7,15,11,17,22,28,78,124,3,495,27,0,2,3,1,43280,17545,3342,23998,1
34,625,10,10,9,9,0,0,19,0,0,0,0,0,0,0,0,0,0,0,0,2,3,1,43280,17545,3343,23999,1
34,625,173,84,99,8,29,36,181,5,12,7,13,17,20,54,81,2,221,12,0,2,3,1,43280,17546,3343,24000,1
34,625,3,1,1,3,0,0,6,0,0,0,0,0,0,0,0,0,0,0,0,2,3,1,43280,17546,3343,24001,1
163,5074,1660,832,1314,41,38,274,1701,20,312,209,395,332,604,2671,5058,12,64042,3557,1,2,17,6,43280,17548,3344,24003,1
163,5074,1057,646,719,113,100,145,1170,18,215,134,248,233,382,1740,3004,10,31186,1732,1,2,17,6,43290,17549,3345,24004,1
82,1800,477,336,357,30,23,73,507,16,194,134,250,210,384,1538,2962,10,30538,1696,0,2,1,1,43300,17550,3345,24005,1
60,1251,996,429,845,24,10,117,1020,7,76,50,88,83,138,494,879,4,3565,198,0,2,1,1,43300,17552,3345,24006,1
60,1251,456,277,329,12,42,72,468,13,85,50,97,98,147,592,972,7,7212,400,0,2,1,1,43300,17552,3345,24007,1
119,2401,1513,682,1277,25,13,200,1538,11,199,116,219,210,335,1557,2584,6,15641,868,0,2,3,1,43300,17554,3345,24008,1
119,2401,819,519,539,24,98,155,843,15,96,57,106,111,163,690,1107,8,9171,509,0,2,3,1,43310,17556,3345,24009,1
48,904,207,111,150,11,0,50,218,5,26,19,36,31,55,133,272,3,943,52,0,2,33,6,43310,17556,3345,24010,1
48,904,410,198,237,31,55,97,441,11,63,38,72,74,110,414,683,6,4293,238,0,2,33,6,43320,17557,3346,24011,1
346,6994,1457,730,1242,11,6,188,1468,10,292,166,329,302,495,2424,4078,5,22973,1276,1,2,98,36,43320,17559,3346,24012,1
346,6994,74,35,59,1,0,14,75,3,14,7,14,17,21,58,85,1,128,7,0,2,98,36,43320,17560,3346,24013,1
346,6994,245,125,200,5,7,34,250,7,30,17,34,37,51,166,265,3,1053,58,0,2,98,36,43330,17561,3346,24014,1
23,680,339,213,244,17,9,65,356,10,42,26,48,52,74,259,421,5,2410,133,0,2,2,0,43340,17561,3346,24015,1
227,5099,4293,999,3693,19,54,507,4312,9,155,88,170,164,258,1156,1898,4,9368,520,0,2,29,4,43340,17563,3346,24016,1
227,5099,1482,859,1002,125,135,219,1607,16,219,134,251,235,385,1766,3032,9,27804,1544,1,2,29,4,43350,17564,3346,24017,1
24,834,74,35,59,1,0,14,75,3,14,7,14,17,21,58,85,1,128,7,0,2,5,3,43350,17565,3346,24018,1
24,834,245,125,200,5,7,34,250,7,30,17,34,37,51,166,265,3,1053,58,0,2,5,3,43360,17566,3346,24019,1
49,573,647,139,84,35,284,233,682,0,0,0,0,0,0,0,0,0,0,0,0,2,10,3,43360,17566,3346,24020,1
71,2109,1523,757,1297,19,12,193,1542,12,193,117,230,205,347,1508,2664,7,19053,1058,0,2,13,6,43370,17568,3346,24021,1
71,2109,701,378,504,33,58,109,734,13,110,68,126,123,194,794,1346,7,10027,557,0,2,13,6,43370,17569,3347,24022,1
179,4176,77,34,69,0,0,8,77,3,24,16,29,27,45,114,213,1,387,21,0,2,48,39,43370,17569,3347,24023,1
179,4176,712,438,573,51,9,84,763,14,102,71,128,116,199,733,1364,8,11988,666,0,2,48,39,43380,17570,3347,24024,1
70,1304,1020,354,843,12,15,144,1032,8,134,77,144,142,221,970,1580,4,6792,377,0,2,3,1,43380,17570,3347,24025,1
46,945,447,308,343,6,5,95,453,7,96,59,111,103,170,651,1136,4,4600,255,0,2,3,3,43380,17573,3347,24026,1
46,945,322,174,179,16,74,51,338,10,41,26,46,51,72,252,408,5,2291,127,0,2,3,3,43380,17576,3348,24027,1
17,510,184,100,137,2,15,30,186,6,38,20,39,44,59,214,322,3,991,55,0,2,6,0,43380,17577,3348,24028,1
17,510,103,65,74,8,5,16,111,7,17,9,17,24,26,89,119,3,417,23,0,2,6,0,43380,17578,3348,24029,1
222,4989,722,423,573,19,0,135,741,12,172,101,199,184,300,1320,2257,6,15668,870,0,2,17,9,43380,17580,3348,24031,1
222,4989,1508,847,911,44,250,301,1552,14,148,88,169,162,257,1120,1886,7,15077,837,0,2,17,9,43380,17581,3349,24032,1
335,7113,72,33,56,0,4,12,72,1,1,1,1,2,2,0,2,0,1,0,0,2,59,37,43380,17581,3349,24033,1
335,7113,1454,835,1044,76,110,219,1530,17,275,158,296,292,454,2297,3718,9,34017,1889,1,2,59,37,43390,17582,3349,24034,1
42,969,386,256,301,16,9,68,402,4,59,35,69,63,104,355,621,2,1453,80,0,2,10,2,43390,17582,3349,24035,1
42,969,264,131,164,11,41,46,275,6,38,22,40,44,62,214,338,3,1068,59,0,2,10,2,43400,17582,3350,24036,1
128,2805,1043,504,840,53,9,147,1096,9,180,112,198,189,310,1377,2344,4,11604,644,0,2,7,0,43400,17584,3350,24037,1
128,2805,383,288,292,26,6,62,409,11,65,38,67,76,105,429,656,5,3719,206,0,2,7,0,43400,17585,3350,24038,1
20,400,294,64,250,0,0,43,294,1,20,10,20,21,30,86,131,0,65,3,0,2,2,2,43400,17585,3350,24039,1
20,400,78,46,62,3,0,14,81,3,8,4,8,11,12,28,41,1,62,3,0,2,2,2,43400,17586,3350,24040,1
104,1979,1178,367,1042,6,15,115,1184,9,94,51,95,103,146,644,976,4,4439,246,0,2,8,3,43400,17586,3350,24041,1
104,1979,177,108,140,8,0,27,185,6,30,16,32,36,48,162,248,3,794,44,0,2,8,3,43400,17588,3350,24042,1
184,3743,1943,715,1694,26,18,214,1969,12,185,120,237,197,357,1436,2721,7,20915,1161,0,2,14,2,43400,17590,3350,24043,1
184,3743,1168,838,957,57,25,144,1225,19,348,224,416,367,640,3018,5452,11,61921,3440,1,2,14,2,43410,17592,3350,24044,1
16,469,442,244,305,14,16,103,456,11,68,45,75,79,120,452,756,6,4588,254,0,2,2,1,43410,17594,3350,24045,1
16,469,182,102,99,11,40,35,193,3,11,6,11,14,17,42,64,1,97,5,0,2,2,1,43410,17595,3350,24046,1
62,1244,1098,241,925,5,10,155,1103,7,46,25,49,53,74,273,423,3,1580,87,0,2,26,3,43420,17597,3350,24047,1
62,1244,282,202,222,14,2,44,296,8,42,24,43,50,67,250,378,4,1548,86,0,2,26,3,43420,17598,3350,24048,1
1,300,382,65,130,157,2,92,539,4,10,5,10,14,15,41,57,2,114,6,0,2,1,1,43420,17599,3351,24049,1
14,472,42,7,35,4,0,5,46,1,2,1,2,3,3,2,4,0,2,0,0,2,3,3,43420,17599,3351,24050,1
14,472,11,6,10,0,0,1,11,2,4,2,4,6,6,10,15,1,15,0,0,2,3,3,43420,17599,3351,24051,1
78,3291,1289,550,1043,56,32,155,1345,10,167,93,185,177,278,1266,2075,5,11498,638,0,2,1,1,43420,17601,3352,24052,1
34,980,182,127,129,0,0,53,182,5,39,21,42,44,63,217,343,2,926,51,0,2,5,0,43420,17601,3353,24053,1
137,6580,1392,870,1177,35,17,170,1427,14,494,280,531,508,811,4473,7289,7,54850,3047,2,2,66,3,43420,17604,3354,24054,1
47,2495,520,294,400,33,13,81,553,10,261,204,367,271,571,2128,4614,7,32445,1802,1,2,33,7,43420,17605,3354,24055,1
95,4294,1338,495,1086,10,64,173,1348,11,122,82,157,133,239,883,1686,7,11934,663,0,2,67,1,43420,17607,3354,24056,1
147,6715,139,89,101,2,0,35,141,7,54,34,62,61,96,330,569,4,2287,127,0,2,26,0,43420,17607,3354,24057,1
147,6715,7,5,5,0,0,2,7,1,2,1,2,3,3,2,4,0,2,0,0,2,26,0,43420,17607,3354,24058,1
32,933,465,148,393,5,8,60,470,4,31,20,31,35,51,161,261,2,523,29,0,2,10,0,43420,17608,3354,24059,1
32,933,16,12,9,0,0,6,16,1,2,1,2,3,3,2,4,0,2,0,0,2,10,0,43420,17608,3354,24060,1
106,5313,1782,648,1425,9,47,279,1791,8,171,97,189,179,286,1292,2140,4,9462,525,0,2,20,0,43420,17609,3355,24061,1
20,468,256,139,192,9,7,47,265,4,23,12,24,27,36,112,171,2,357,19,0,2,30,0,43420,17610,3355,24062,1
95,3480,1450,624,1228,12,26,181,1462,14,306,186,354,320,540,2580,4493,8,36391,2021,1,2,83,1,43420,17612,3356,24063,1
148,4073,1660,832,1314,41,38,274,1701,20,312,209,395,332,604,2671,5058,12,64042,3557,1,2,171,1,43420,17614,3357,24065,1
116,4567,1513,682,1277,25,13,200,1538,11,199,116,219,210,335,1557,2584,6,15641,868,0,2,3,2,43420,17616,3357,24066,1
58,3234,1296,573,1062,40,33,157,1336,8,201,118,231,209,349,1561,2689,4,12365,686,0,2,5,11,43420,17616,3357,24067,1
5,138,207,111,150,11,0,50,218,5,26,19,36,31,55,133,272,3,943,52,0,0,50,0,43420,17616,3357,24068,1
78,4037,1457,730,1242,11,6,188,1468,10,292,166,329,302,495,2424,4078,5,22973,1276,1,2,97,2,43420,17618,3357,24069,1
38,2269,652,304,544,16,6,88,668,6,89,51,101,95,152,591,998,3,3399,188,0,2,27,0,43420,17619,3357,24070,1
61,2747,1455,414,1257,16,76,112,1471,5,41,23,46,46,69,231,381,2,1069,59,0,2,5,3,43420,17620,3357,24071,1
82,4086,1523,757,1297,19,12,193,1542,12,193,117,230,205,347,1508,2664,7,19053,1058,0,2,59,0,43430,17622,3357,24072,1
66,2745,1020,354,843,12,15,144,1032,8,134,77,144,142,221,970,1580,4,6792,377,0,2,20,1,43430,17622,3357,24073,1
37,1604,447,308,343,6,5,95,453,7,96,59,111,103,170,651,1136,4,4600,255,0,2,4,10,43430,17625,3357,24074,1
21,647,424,94,331,4,0,89,428,1,5,5,5,6,10,11,25,0,12,0,0,2,4,0,43430,17626,3357,24075,1
40,2349,334,251,279,10,4,40,344,5,127,74,143,132,217,899,1528,2,4303,239,0,2,17,2,43430,17627,3357,24076,1
12,475,184,100,137,2,15,30,186,6,38,20,39,44,59,214,322,3,991,55,0,2,2,0,43430,17628,3357,24077,1
31,1478,1293,570,1093,25,15,163,1318,10,195,123,241,205,364,1516,2795,6,17273,959,0,2,38,26,43440,17630,3357,24078,1
36,1940,384,251,317,7,8,52,391,11,70,44,84,81,128,467,811,6,5355,297,0,2,34,4,43440,17630,3357,24079,1
15,621,722,423,573,19,0,135,741,12,172,101,199,184,300,1320,2257,6,15668,870,0,2,11,0,43440,17632,3357,24081,1
30,1334,386,256,301,16,9,68,402,4,59,35,69,63,104,355,621,2,1453,80,0,2,28,5,43440,17632,3357,24082,1
69,2837,1043,504,840,53,9,147,1096,9,180,112,198,189,310,1377,2344,4,11604,644,0,2,10,0,43440,17634,3357,24083,1
25,1016,373,158,315,8,0,51,381,5,76,44,79,81,123,486,779,2,2026,112,0,2,1,1,43440,17634,3357,24084,1
71,2977,1178,367,1042,6,15,115,1184,9,94,51,95,103,146,644,976,4,4439,246,0,2,24,1,43440,17634,3357,24085,1
73,3706,1943,715,1694,26,18,214,1969,12,185,120,237,197,357,1436,2721,7,20915,1161,0,2,35,1,43440,17636,3357,24086,1
48,1773,1098,241,925,5,10,155,1103,7,46,25,49,53,74,273,423,3,1580,87,0,2,23,0,43450,17638,3357,24087,1
227,5099,4293,999,3693,19,54,507,4312,9,155,88,170,164,258,1156,1898,4,9368,520,0,2,10,10,43450,17640,3357,24088,1
227,5099,1482,859,1002,125,135,219,1607,16,219,134,251,235,385,1766,3032,9,27804,1544,1,2,10,10,43460,17641,3357,24089,1
227,5099,4293,999,3693,19,54,507,4312,9,155,88,170,164,258,1156,1898,4,9368,520,0,2,10,10,43460,17643,3357,24090,0
227,5099,1482,859,1002,125,135,219,1607,16,219,134,251,235,385,1766,3032,9,27804,1544,1,2,10,10,43470,17644,3357,24091,0
60,1262,996,429,845,24,10,117,1020,7,76,50,88,83,138,494,879,4,3565,198,0,2,3,3,43470,17646,3357,24092,1
60,1262,456,277,329,12,42,72,468,13,85,50,97,98,147,592,972,7,7212,400,0,2,3,3,43470,17646,3357,24093,1
60,1262,996,429,845,24,10,117,1020,7,76,50,88,83,138,494,879,4,3565,198,0,2,3,3,43470,17648,3357,24094,0
60,1262,456,277,329,12,42,72,468,13,85,50,97,98,147,592,972,7,7212,400,0,2,3,3,43470,17648,3357,24095,0
163,5086,1660,832,1314,41,38,274,1701,20,312,209,395,332,604,2671,5058,12,64042,3557,1,2,1,1,43470,17650,3358,24097,0
163,5086,1057,646,719,113,100,145,1170,18,215,134,248,233,382,1740,3004,10,31186,1732,1,2,1,1,43480,17651,3359,24098,0
149,4136,1660,832,1314,41,38,274,1701,20,312,209,395,332,604,2671,5058,12,64042,3557,1,2,18,0,43480,17653,3360,24100,0
346,7028,1457,730,1242,11,6,188,1468,10,292,166,329,302,495,2424,4078,5,22973,1276,1,2,0,1,43480,17655,3360,24101,1
346,7028,74,35,59,1,0,14,75,3,14,7,14,17,21,58,85,1,128,7,0,2,0,1,43480,17656,3360,24102,1
346,7028,245,125,200,5,7,34,250,7,30,17,34,37,51,166,265,3,1053,58,0,2,0,1,43490,17657,3360,24103,1
178,4177,77,34,69,0,0,8,77,3,24,16,29,27,45,114,213,1,387,21,0,2,1,0,43490,17657,3360,24104,1
178,4177,712,438,573,51,9,84,763,14,102,71,128,116,199,733,1364,8,11988,666,0,2,1,0,43500,17658,3360,24105,1
80,3429,1289,550,1043,56,32,155,1345,10,167,93,185,177,278,1266,2075,5,11498,638,0,2,28,0,43500,17660,3361,24106,1
8,273,74,35,59,1,0,14,75,3,14,7,14,17,21,58,85,1,128,7,0,2,1,1,43500,17661,3361,24107,0
223,5076,722,423,573,19,0,135,741,12,172,101,199,184,300,1320,2257,6,15668,870,0,2,1,1,43500,17663,3361,24109,0
223,5076,1508,847,911,44,250,301,1552,14,148,88,169,162,257,1120,1886,7,15077,837,0,2,1,1,43500,17664,3362,24110,0
211,4485,182,127,129,0,0,53,182,5,39,21,42,44,63,217,343,2,926,51,0,2,6,5,43500,17664,3363,24111,1
211,4485,1165,710,800,67,119,181,1232,18,243,153,282,261,435,2000,3492,10,36473,2026,1,2,6,5,43510,17664,3364,24112,1
48,919,207,111,150,11,0,50,218,5,26,19,36,31,55,133,272,3,943,52,0,2,1,0,43510,17664,3364,24113,1
48,919,410,198,237,31,55,97,441,11,63,38,72,74,110,414,683,6,4293,238,0,2,1,0,43520,17665,3365,24114,1
211,4485,182,127,129,0,0,53,182,5,39,21,42,44,63,217,343,2,926,51,0,2,6,5,43520,17665,3366,24115,0
211,4485,1165,710,800,67,119,181,1232,18,243,153,282,261,435,2000,3492,10,36473,2026,1,2,6,5,43530,17665,3367,24116,0
48,919,207,111,150,11,0,50,218,5,26,19,36,31,55,133,272,3,943,52,0,2,1,0,43530,17665,3367,24117,0
48,919,410,198,237,31,55,97,441,11,63,38,72,74,110,414,683,6,4293,238,0,2,1,0,43540,17666,3368,24118,0
223,5080,722,423,573,19,0,135,741,12,172,101,199,184,300,1320,2257,6,15668,870,0,2,2,1,43540,17668,3368,24120,0
223,5080,1508,847,911,44,250,301,1552,14,148,88,169,162,257,1120,1886,7,15077,837,0,2,2,1,43540,17669,3369,24121,0
178,4158,77,34,69,0,0,8,77,3,24,16,29,27,45,114,213,1,387,21,0,2,0,3,43540,17669,3369,24122,0
178,4158,712,438,573,51,9,84,763,14,102,71,128,116,199,733,1364,8,11988,666,0,2,0,3,43550,17670,3369,24123,0
191,3896,1943,715,1694,26,18,214,1969,12,185,120,237,197,357,1436,2721,7,20915,1161,0,2,3,3,43550,17672,3369,24124,0
191,3896,1168,838,957,57,25,144,1225,19,348,224,416,367,640,3018,5452,11,61921,3440,1,2,3,3,43560,17674,3369,24125,0
346,7028,1457,730,1242,11,6,188,1468,10,292,166,329,302,495,2424,4078,5,22973,1276,1,2,0,1,43560,17676,3369,24126,0
346,7028,74,35,59,1,0,14,75,3,14,7,14,17,21,58,85,1,128,7,0,2,0,1,43560,17677,3369,24127,0
346,7028,245,125,200,5,7,34,250,7,30,17,34,37,51,166,265,3,1053,58,0,2,0,1,43570,17678,3369,24128,0
178,4158,77,34,69,0,0,8,77,3,24,16,29,27,45,114,213,1,387,21,0,2,1,3,43570,17678,3369,24129,0
178,4158,712,438,573,51,9,84,763,14,102,71,128,116,199,733,1364,8,11988,666,0,2,1,3,43580,17679,3369,24130,0
223,5080,722,423,573,19,0,135,741,12,172,101,199,184,300,1320,2257,6,15668,870,0,2,3,2,43580,17681,3369,24132,0
223,5080,1508,847,911,44,250,301,1552,14,148,88,169,162,257,1120,1886,7,15077,837,0,2,3,2,43580,17682,3370,24133,0
191,3896,1943,715,1694,26,18,214,1969,12,185,120,237,197,357,1436,2721,7,20915,1161,0,2,3,3,43580,17684,3370,24134,0
191,3896,1168,838,957,57,25,144,1225,19,348,224,416,367,640,3018,5452,11,61921,3440,1,2,3,3,43590,17686,3370,24135,0
80,3429,1289,550,1043,56,32,155,1345,10,167,93,185,177,278,1266,2075,5,11498,638,0,2,28,0,43590,17688,3371,24136,0
8,273,74,35,59,1,0,14,75,3,14,7,14,17,21,58,85,1,128,7,0,2,1,1,43590,17689,3371,24137,0
11,401,42,7,35,4,0,5,46,1,2,1,2,3,3,2,4,0,2,0,0,2,4,10,43600,17693,3372,24145,0
11,401,11,6,10,0,0,1,11,2,4,2,4,6,6,10,15,1,15,0,0,2,4,10,43600,17693,3372,24146,0
11,396,42,7,35,4,0,5,46,1,2,1,2,3,3,2,4,0,2,0,0,2,1,3,43610,17697,3373,24154,1
11,396,11,6,10,0,0,1,11,2,4,2,4,6,6,10,15,1,15,0,0,2,1,3,43610,17697,3373,24155,1
335,7113,72,33,56,0,4,12,72,1,1,1,1,2,2,0,2,0,1,0,0,2,2,2,43610,17697,3373,24156,1
335,7113,1454,835,1044,76,110,219,1530,17,275,158,296,292,454,2297,3718,9,34017,1889,1,2,2,2,43620,17698,3373,24157,1
96,4332,1338,495,1086,10,64,173,1348,11,122,82,157,133,239,883,1686,7,11934,663,0,2,28,0,43620,17700,3373,24158,1
335,7113,72,33,56,0,4,12,72,1,1,1,1,2,2,0,2,0,1,0,0,2,2,2,43630,17704,3374,24166,0
335,7113,1454,835,1044,76,110,219,1530,17,275,158,296,292,454,2297,3718,9,34017,1889,1,2,2,2,43640,17705,3374,24167,0
96,4332,1338,495,1086,10,64,173,1348,11,122,82,157,133,239,883,1686,7,11934,663,0,2,28,0,43640,17707,3374,24168,0
27,545,2,2,2,0,0,0,2,0,0,0,0,0,0,0,0,0,0,0,0,2,0,3,43640,17707,3374,24168,0
27,545,99,48,90,1,3,5,100,0,0,0,0,0,0,0,0,0,0,0,0,2,0,3,43640,17708,3374,24169,0
27,545,8,5,5,2,0,1,10,0,0,0,0,0,0,0,0,0,0,0,0,2,0,3,43640,17708,3374,24170,0
27,545,1217,716,841,84,126,174,1301,14,185,118,215,199,333,1446,2542,8,20687,1149,0,2,0,3,43650,17710,3374,24171,0
27,545,160,89,115,0,13,31,160,7,15,11,17,22,28,78,124,3,495,27,0,2,0,3,43650,17710,3374,24172,0
27,545,10,10,9,9,0,0,19,0,0,0,0,0,0,0,0,0,0,0,0,2,0,3,43650,17710,3375,24173,0
27,545,173,84,99,8,29,36,181,5,12,7,13,17,20,54,81,2,221,12,0,2,0,3,43650,17711,3375,24174,0
27,545,3,1,1,3,0,0,6,0,0,0,0,0,0,0,0,0,0,0,0,2,0,3,43650,17711,3375,24175,0
53,1123,207,111,150,11,0,50,218,5,26,19,36,31,55,133,272,3,943,52,0,2,32,0,43650,17711,3375,24176,0
53,1123,410,198,237,31,55,97,441,11,63,38,72,74,110,414,683,6,4293,238,0,2,32,0,43660,17712,3376,24177,0
346,7028,1457,730,1242,11,6,188,1468,10,292,166,329,302,495,2424,4078,5,22973,1276,1,2,1,0,43660,17714,3376,24178,0
346,7028,74,35,59,1,0,14,75,3,14,7,14,17,21,58,85,1,128,7,0,2,1,0,43660,17715,3376,24179,0
346,7028,245,125,200,5,7,34,250,7,30,17,34,37,51,166,265,3,1053,58,0,2,1,0,43670,17716,3376,24180,0
21,668,339,213,244,17,9,65,356,10,42,26,48,52,74,259,421,5,2410,133,0,2,10,11,43680,17716,3376,24181,0
225,5106,4293,999,3693,19,54,507,4312,9,155,88,170,164,258,1156,1898,4,9368,520,0,2,20,36,43680,17718,3376,24182,0
225,5106,1482,859,1002,125,135,219,1607,16,219,134,251,235,385,1766,3032,9,27804,1544,1,2,20,36,43690,17719,3376,24183,0
6,136,44,22,19,0,19,6,44,2,10,6,12,12,18,35,64,1,77,4,0,2,0,3,43690,17719,3376,24184,0
49,575,647,139,84,35,284,233,682,0,0,0,0,0,0,0,0,0,0,0,0,2,3,1,43690,17719,3376,24185,0
178,4126,77,34,69,0,0,8,77,3,24,16,29,27,45,114,213,1,387,21,0,2,35,24,43690,17719,3376,24186,0
178,4126,712,438,573,51,9,84,763,14,102,71,128,116,199,733,1364,8,11988,666,0,2,35,24,43700,17720,3376,24187,0
80,1593,1020,354,843,12,15,144,1032,8,134,77,144,142,221,970,1580,4,6792,377,0,2,15,9,43700,17720,3376,24188,0
46,961,447,308,343,6,5,95,453,7,96,59,111,103,170,651,1136,4,4600,255,0,2,4,4,43700,17723,3376,24189,0
46,961,322,174,179,16,74,51,338,10,41,26,46,51,72,252,408,5,2291,127,0,2,4,4,43700,17726,3377,24190,0
23,388,424,94,331,4,0,89,428,1,5,5,5,6,10,11,25,0,12,0,0,2,9,9,43700,17727,3377,24191,0
23,388,38,23,23,6,0,8,44,3,11,7,11,14,18,42,68,1,102,5,0,2,9,9,43700,17727,3377,24192,0
335,7154,72,33,56,0,4,12,72,1,1,1,1,2,2,0,2,0,1,0,0,2,25,31,43700,17727,3377,24193,0
335,7154,1454,835,1044,76,110,219,1530,17,275,158,296,292,454,2297,3718,9,34017,1889,1,2,25,31,43710,17728,3377,24194,0
38,783,386,256,301,16,9,68,402,4,59,35,69,63,104,355,621,2,1453,80,0,2,7,11,43710,17728,3377,24195,0
38,783,264,131,164,11,41,46,275,6,38,22,40,44,62,214,338,3,1068,59,0,2,7,11,43720,17728,3378,24196,0
127,2813,1043,504,840,53,9,147,1096,9,180,112,198,189,310,1377,2344,4,11604,644,0,2,1,9,43720,17730,3378,24197,0
127,2813,383,288,292,26,6,62,409,11,65,38,67,76,105,429,656,5,3719,206,0,2,1,9,43720,17731,3378,24198,0
103,1956,1178,367,1042,6,15,115,1184,9,94,51,95,103,146,644,976,4,4439,246,0,2,31,27,43720,17731,3378,24199,0
103,1956,177,108,140,8,0,27,185,6,30,16,32,36,48,162,248,3,794,44,0,2,31,27,43720,17733,3378,24200,0
62,1240,1098,241,925,5,10,155,1103,7,46,25,49,53,74,273,423,3,1580,87,0,2,25,21,43730,17735,3378,24201,0
62,1240,282,202,222,14,2,44,296,8,42,24,43,50,67,250,378,4,1548,86,0,2,25,21,43730,17736,3378,24202,0
11,402,42,7,35,4,0,5,46,1,2,1,2,3,3,2,4,0,2,0,0,2,19,13,43740,17740,3379,24210,1
11,402,11,6,10,0,0,1,11,2,4,2,4,6,6,10,15,1,15,0,0,2,19,13,43740,17740,3379,24211,1
11,402,42,7,35,4,0,5,46,1,2,1,2,3,3,2,4,0,2,0,0,2,20,22,43760,17748,3381,24226,0
11,402,11,6,10,0,0,1,11,2,4,2,4,6,6,10,15,1,15,0,0,2,20,22,43760,17748,3381,24227,0
336,7127,72,33,56,0,4,12,72,1,1,1,1,2,2,0,2,0,1,0,0,2,5,1,43760,17748,3381,24228,0
336,7127,1454,835,1044,76,110,219,1530,17,275,158,296,292,454,2297,3718,9,34017,1889,1,2,5,1,43770,17749,3381,24229,0
67,2779,1020,354,843,12,15,144,1032,8,134,77,144,142,221,970,1580,4,6792,377,0,2,17,0,43770,17749,3381,24230,0
336,7127,72,33,56,0,4,12,72,1,1,1,1,2,2,0,2,0,1,0,0,2,5,1,43770,17749,3381,24231,0
336,7127,1454,835,1044,76,110,219,1530,17,275,158,296,292,454,2297,3718,9,34017,1889,1,2,5,1,43780,17750,3381,24232,0
67,2779,1020,354,843,12,15,144,1032,8,134,77,144,142,221,970,1580,4,6792,377,0,2,17,0,43780,17750,3381,24233,0
222,4989,722,423,573,19,0,135,741,12,172,101,199,184,300,1320,2257,6,15668,870,0,2,4,3,43780,17752,3381,24235,1
222,4989,1508,847,911,44,250,301,1552,14,148,88,169,162,257,1120,1886,7,15077,837,0,2,4,3,43780,17753,3382,24236,1
222,4989,722,423,573,19,0,135,741,12,172,101,199,184,300,1320,2257,6,15668,870,0,2,4,3,43780,17755,3382,24238,0
222,4989,1508,847,911,44,250,301,1552,14,148,88,169,162,257,1120,1886,7,15077,837,0,2,4,3,43780,17756,3383,24239,0
211,4493,182,127,129,0,0,53,182,5,39,21,42,44,63,217,343,2,926,51,0,2,6,5,43780,17756,3384,24240,0
211,4493,1165,710,800,67,119,181,1232,18,243,153,282,261,435,2000,3492,10,36473,2026,1,2,6,5,43790,17756,3385,24241,0
54,1153,207,111,150,11,0,50,218,5,26,19,36,31,55,133,272,3,943,52,0,2,4,1,43790,17756,3385,24242,0
54,1153,410,198,237,31,55,97,441,11,63,38,72,74,110,414,683,6,4293,238,0,2,4,1,43800,17757,3386,24243,0
225,5106,4293,999,3693,19,54,507,4312,9,155,88,170,164,258,1156,1898,4,9368,520,0,2,10,10,43800,17759,3386,24244,0
225,5106,1482,859,1002,125,135,219,1607,16,219,134,251,235,385,1766,3032,9,27804,1544,1,2,10,10,43810,17760,3386,24245,0
223,5080,722,423,573,19,0,135,741,12,172,101,199,184,300,1320,2257,6,15668,870,0,2,4,3,43810,17762,3386,24247,0
223,5080,1508,847,911,44,250,301,1552,14,148,88,169,162,257,1120,1886,7,15077,837,0,2,4,3,43810,17763,3387,24248,0
336,7168,72,33,56,0,4,12,72,1,1,1,1,2,2,0,2,0,1,0,0,2,9,5,43810,17763,3387,24249,0
336,7168,1454,835,1044,76,110,219,1530,17,275,158,296,292,454,2297,3718,9,34017,1889,1,2,9,5,43820,17764,3387,24250,0
96,4365,1338,495,1086,10,64,173,1348,11,122,82,157,133,239,883,1686,7,11934,663,0,2,44,0,43820,17766,3387,24251,0
117,4645,1513,682,1277,25,13,200,1538,11,199,116,219,210,335,1557,2584,6,15641,868,0,2,2,1,43820,17768,3387,24252,0
68,2962,1020,354,843,12,15,144,1032,8,134,77,144,142,221,970,1580,4,6792,377,0,2,17,0,43820,17768,3387,24253,0
211,4493,182,127,129,0,0,53,182,5,39,21,42,44,63,217,343,2,926,51,0,2,6,5,43820,17768,3388,24254,0
211,4493,1165,710,800,67,119,181,1232,18,243,153,282,261,435,2000,3492,10,36473,2026,1,2,6,5,43830,17768,3389,24255,0
54,1153,207,111,150,11,0,50,218,5,26,19,36,31,55,133,272,3,943,52,0,2,4,1,43830,17768,3389,24256,0
54,1153,410,198,237,31,55,97,441,11,63,38,72,74,110,414,683,6,4293,238,0,2,4,1,43840,17769,3390,24257,0
225,5106,4293,999,3693,19,54,507,4312,9,155,88,170,164,258,1156,1898,4,9368,520,0,2,10,10,43840,17771,3390,24258,0
225,5106,1482,859,1002,125,135,219,1607,16,219,134,251,235,385,1766,3032,9,27804,1544,1,2,10,10,43850,17772,3390,24259,0
223,5080,722,423,573,19,0,135,741,12,172,101,199,184,300,1320,2257,6,15668,870,0,2,4,3,43850,17774,3390,24261,0
223,5080,1508,847,911,44,250,301,1552,14,148,88,169,162,257,1120,1886,7,15077,837,0,2,4,3,43850,17775,3391,24262,0
336,7168,72,33,56,0,4,12,72,1,1,1,1,2,2,0,2,0,1,0,0,2,9,5,43850,17775,3391,24263,0
336,7168,1454,835,1044,76,110,219,1530,17,275,158,296,292,454,2297,3718,9,34017,1889,1,2,9,5,43860,17776,3391,24264,0
96,4365,1338,495,1086,10,64,173,1348,11,122,82,157,133,239,883,1686,7,11934,663,0,2,44,0,43860,17778,3391,24265,0
117,4645,1513,682,1277,25,13,200,1538,11,199,116,219,210,335,1557,2584,6,15641,868,0,2,2,1,43860,17780,3391,24266,0
68,2962,1020,354,843,12,15,144,1032,8,134,77,144,142,221,970,1580,4,6792,377,0,2,17,0,43860,17780,3391,24267,0
346,7030,1457,730,1242,11,6,188,1468,10,292,166,329,302,495,2424,4078,5,22973,1276,1,2,6,4,43860,17782,3391,24268,0
346,7030,74,35,59,1,0,14,75,3,14,7,14,17,21,58,85,1,128,7,0,2,6,4,43860,17783,3391,24269,0
346,7030,245,125,200,5,7,34,250,7,30,17,34,37,51,166,265,3,1053,58,0,2,6,4,43870,17784,3391,24270,0
83,2370,1523,757,1297,19,12,193,1542,12,193,117,230,205,347,1508,2664,7,19053,1058,0,2,10,3,43900,17794,3393,24285,1
83,2370,701,378,504,33,58,109,734,13,110,68,126,123,194,794,1346,7,10027,557,0,2,10,3,43900,17795,3394,24286,1
89,4427,1523,757,1297,19,12,193,1542,12,193,117,230,205,347,1508,2664,7,19053,1058,0,2,27,0,43910,17797,3394,24287,1
83,2359,1523,757,1297,19,12,193,1542,12,193,117,230,205,347,1508,2664,7,19053,1058,0,2,2,7,43920,17799,3394,24288,1
83,2359,701,378,504,33,58,109,734,13,110,68,126,123,194,794,1346,7,10027,557,0,2,2,7,43920,17800,3395,24289,1
89,4432,1523,757,1297,19,12,193,1542,12,193,117,230,205,347,1508,2664,7,19053,1058,0,2,3,2,43930,17802,3395,24290,1
90,4427,1523,757,1297,19,12,193,1542,12,193,117,230,205,347,1508,2664,7,19053,1058,0,2,14,16,43940,17804,3395,24291,0
346,7030,1457,730,1242,11,6,188,1468,10,292,166,329,302,495,2424,4078,5,22973,1276,1,2,6,4,43940,17806,3395,24292,0
346,7030,74,35,59,1,0,14,75,3,14,7,14,17,21,58,85,1,128,7,0,2,6,4,43940,17807,3395,24293,0
346,7030,245,125,200,5,7,34,250,7,30,17,34,37,51,166,265,3,1053,58,0,2,6,4,43950,17808,3395,24294,0
83,2359,1523,757,1297,19,12,193,1542,12,193,117,230,205,347,1508,2664,7,19053,1058,0,2,5,3,43960,17810,3395,24295,0
83,2359,701,378,504,33,58,109,734,13,110,68,126,123,194,794,1346,7,10027,557,0,2,5,3,43960,17811,3396,24296,0
90,4427,1523,757,1297,19,12,193,1542,12,193,117,230,205,347,1508,2664,7,19053,1058,0,2,26,0,43970,17813,3396,24297,0
346,7030,1457,730,1242,11,6,188,1468,10,292,166,329,302,495,2424,4078,5,22973,1276,1,2,6,4,43970,17815,3396,24298,0
346,7030,74,35,59,1,0,14,75,3,14,7,14,17,21,58,85,1,128,7,0,2,6,4,43970,17816,3396,24299,0
346,7030,245,125,200,5,7,34,250,7,30,17,34,37,51,166,265,3,1053,58,0,2,6,4,43980,17817,3396,24300,0
83,2359,1523,757,1297,19,12,193,1542,12,193,117,230,205,347,1508,2664,7,19053,1058,0,2,5,3,43990,17819,3396,24301,0
83,2359,701,378,504,33,58,109,734,13,110,68,126,123,194,794,1346,7,10027,557,0,2,5,3,43990,17820,3397,24302,0
90,4427,1523,757,1297,19,12,193,1542,12,193,117,230,205,347,1508,2664,7,19053,1058,0,2,26,0,44000,17822,3397,24303,0
9,228,19,8,11,5,0,4,24,2,5,3,6,7,9,13,25,1,30,1,0,2,1,1,44000,17822,3397,24304,1
9,228,102,59,69,5,3,24,107,6,22,15,28,28,43,113,206,3,789,43,0,2,1,1,44000,17822,3397,24305,1
9,228,106,40,36,3,49,17,109,8,17,13,23,25,36,93,167,5,904,50,0,2,1,1,44000,17822,3397,24306,1
27,542,2,2,2,0,0,0,2,0,0,0,0,0,0,0,0,0,0,0,0,2,1,1,44000,17822,3397,24306,1
27,542,99,48,90,1,3,5,100,0,0,0,0,0,0,0,0,0,0,0,0,2,1,1,44000,17823,3397,24307,1
27,542,8,5,5,2,0,1,10,0,0,0,0,0,0,0,0,0,0,0,0,2,1,1,44000,17823,3397,24308,1
27,542,1217,716,841,84,126,174,1301,14,185,118,215,199,333,1446,2542,8,20687,1149,0,2,1,1,44010,17825,3397,24309,1
27,542,160,89,115,0,13,31,160,7,15,11,17,22,28,78,124,3,495,27,0,2,1,1,44010,17825,3397,24310,1
27,542,10,10,9,9,0,0,19,0,0,0,0,0,0,0,0,0,0,0,0,2,1,1,44010,17825,3398,24311,1
27,542,173,84,99,8,29,36,181,5,12,7,13,17,20,54,81,2,221,12,0,2,1,1,44010,17826,3398,24312,1
27,542,3,1,1,3,0,0,6,0,0,0,0,0,0,0,0,0,0,0,0,2,1,1,44010,17826,3398,24313,1
60,1259,996,429,845,24,10,117,1020,7,76,50,88,83,138,494,879,4,3565,198,0,2,1,1,44010,17828,3398,24314,1
60,1259,456,277,329,12,42,72,468,13,85,50,97,98,147,592,972,7,7212,400,0,2,1,1,44010,17828,3398,24315,1
119,2406,1513,682,1277,25,13,200,1538,11,199,116,219,210,335,1557,2584,6,15641,868,0,2,6,6,44010,17830,3398,24316,1
119,2406,819,519,539,24,98,155,843,15,96,57,106,111,163,690,1107,8,9171,509,0,2,6,6,44020,17832,3398,24317,1
346,7015,1457,730,1242,11,6,188,1468,10,292,166,329,302,495,2424,4078,5,22973,1276,1,2,5,5,44020,17834,3398,24318,1
346,7015,74,35,59,1,0,14,75,3,14,7,14,17,21,58,85,1,128,7,0,2,5,5,44020,17835,3398,24319,1
346,7015,245,125,200,5,7,34,250,7,30,17,34,37,51,166,265,3,1053,58,0,2,5,5,44030,17836,3398,24320,1
21,662,339,213,244,17,9,65,356,10,42,26,48,52,74,259,421,5,2410,133,0,2,2,3,44040,17836,3398,24321,1
225,5091,4293,999,3693,19,54,507,4312,9,155,88,170,164,258,1156,1898,4,9368,520,0,2,5,5,44040,17838,3398,24322,1
225,5091,1482,859,1002,125,135,219,1607,16,219,134,251,235,385,1766,3032,9,27804,1544,1,2,5,5,44050,17839,3398,24323,1
178,4123,77,34,69,0,0,8,77,3,24,16,29,27,45,114,213,1,387,21,0,2,1,1,44050,17839,3398,24324,1
178,4123,712,438,573,51,9,84,763,14,102,71,128,116,199,733,1364,8,11988,666,0,2,1,1,44060,17840,3398,24325,1
80,1581,1020,354,843,12,15,144,1032,8,134,77,144,142,221,970,1580,4,6792,377,0,2,4,5,44060,17840,3398,24326,1
46,955,447,308,343,6,5,95,453,7,96,59,111,103,170,651,1136,4,4600,255,0,2,2,2,44060,17843,3398,24327,1
46,955,322,174,179,16,74,51,338,10,41,26,46,51,72,252,408,5,2291,127,0,2,2,2,44060,17846,3399,24328,1
223,5047,722,423,573,19,0,135,741,12,172,101,199,184,300,1320,2257,6,15668,870,0,2,11,11,44060,17848,3399,24330,1
223,5047,1508,847,911,44,250,301,1552,14,148,88,169,162,257,1120,1886,7,15077,837,0,2,11,11,44060,17849,3400,24331,1
127,2807,1043,504,840,53,9,147,1096,9,180,112,198,189,310,1377,2344,4,11604,644,0,2,2,2,44060,17851,3400,24332,1
127,2807,383,288,292,26,6,62,409,11,65,38,67,76,105,429,656,5,3719,206,0,2,2,2,44060,17852,3400,24333,1
103,1953,1178,367,1042,6,15,115,1184,9,94,51,95,103,146,644,976,4,4439,246,0,2,1,1,44060,17852,3400,24334,1
103,1953,177,108,140,8,0,27,185,6,30,16,32,36,48,162,248,3,794,44,0,2,1,1,44060,17854,3400,24335,1
191,3890,1943,715,1694,26,18,214,1969,12,185,120,237,197,357,1436,2721,7,20915,1161,0,2,2,2,44060,17856,3400,24336,1
191,3890,1168,838,957,57,25,144,1225,19,348,224,416,367,640,3018,5452,11,61921,3440,1,2,2,2,44070,17858,3400,24337,1
16,477,442,244,305,14,16,103,456,11,68,45,75,79,120,452,756,6,4588,254,0,2,1,1,44070,17860,3400,24338,1
16,477,182,102,99,11,40,35,193,3,11,6,11,14,17,42,64,1,97,5,0,2,1,1,44070,17861,3400,24339,1
9,228,19,8,11,5,0,4,24,2,5,3,6,7,9,13,25,1,30,1,0,2,1,1,44070,17861,3400,24340,0
9,228,102,59,69,5,3,24,107,6,22,15,28,28,43,113,206,3,789,43,0,2,1,1,44070,17861,3400,24341,0
9,228,106,40,36,3,49,17,109,8,17,13,23,25,36,93,167,5,904,50,0,2,1,1,44070,17861,3400,24342,0
27,542,2,2,2,0,0,0,2,0,0,0,0,0,0,0,0,0,0,0,0,2,1,1,44070,17861,3400,24342,0
27,542,99,48,90,1,3,5,100,0,0,0,0,0,0,0,0,0,0,0,0,2,1,1,44070,17862,3400,24343,0
27,542,8,5,5,2,0,1,10,0,0,0,0,0,0,0,0,0,0,0,0,2,1,1,44070,17862,3400,24344,0
27,542,1217,716,841,84,126,174,1301,14,185,118,215,199,333,1446,2542,8,20687,1149,0,2,1,1,44080,17864,3400,24345,0
27,542,160,89,115,0,13,31,160,7,15,11,17,22,28,78,124,3,495,27,0,2,1,1,44080,17864,3400,24346,0
27,542,10,10,9,9,0,0,19,0,0,0,0,0,0,0,0,0,0,0,0,2,1,1,44080,17864,3401,24347,0
27,542,173,84,99,8,29,36,181,5,12,7,13,17,20,54,81,2,221,12,0,2,1,1,44080,17865,3401,24348,0
27,542,3,1,1,3,0,0,6,0,0,0,0,0,0,0,0,0,0,0,0,2,1,1,44080,17865,3401,24349,0
60,1259,996,429,845,24,10,117,1020,7,76,50,88,83,138,494,879,4,3565,198,0,2,1,1,44080,17867,3401,24350,0
60,1259,456,277,329,12,42,72,468,13,85,50,97,98,147,592,972,7,7212,400,0,2,1,1,44080,17867,3401,24351,0
119,2406,1513,682,1277,25,13,200,1538,11,199,116,219,210,335,1557,2584,6,15641,868,0,2,6,6,44080,17869,3401,24352,0
119,2406,819,519,539,24,98,155,843,15,96,57,106,111,163,690,1107,8,9171,509,0,2,6,6,44090,17871,3401,24353,0
346,7015,1457,730,1242,11,6,188,1468,10,292,166,329,302,495,2424,4078,5,22973,1276,1,2,5,5,44090,17873,3401,24354,0
346,7015,74,35,59,1,0,14,75,3,14,7,14,17,21,58,85,1,128,7,0,2,5,5,44090,17874,3401,24355,0
346,7015,245,125,200,5,7,34,250,7,30,17,34,37,51,166,265,3,1053,58,0,2,5,5,44100,17875,3401,24356,0
21,662,339,213,244,17,9,65,356,10,42,26,48,52,74,259,421,5,2410,133,0,2,2,3,44110,17875,3401,24357,0
225,5091,4293,999,3693,19,54,507,4312,9,155,88,170,164,258,1156,1898,4,9368,520,0,2,5,5,44110,17877,3401,24358,0
225,5091,1482,859,1002,125,135,219,1607,16,219,134,251,235,385,1766,3032,9,27804,1544,1,2,5,5,44120,17878,3401,24359,0
178,4123,77,34,69,0,0,8,77,3,24,16,29,27,45,114,213,1,387,21,0,2,1,1,44120,17878,3401,24360,0
178,4123,712,438,573,51,9,84,763,14,102,71,128,116,199,733,1364,8,11988,666,0,2,1,1,44130,17879,3401,24361,0
80,1581,1020,354,843,12,15,144,1032,8,134,77,144,142,221,970,1580,4,6792,377,0,2,4,5,44130,17879,3401,24362,0
46,955,447,308,343,6,5,95,453,7,96,59,111,103,170,651,1136,4,4600,255,0,2,2,2,44130,17882,3401,24363,0
46,955,322,174,179,16,74,51,338,10,41,26,46,51,72,252,408,5,2291,127,0,2,2,2,44130,17885,3402,24364,0
223,5047,722,423,573,19,0,135,741,12,172,101,199,184,300,1320,2257,6,15668,870,0,2,11,11,44130,17887,3402,24366,0
223,5047,1508,847,911,44,250,301,1552,14,148,88,169,162,257,1120,1886,7,15077,837,0,2,11,11,44130,17888,3403,24367,0
127,2807,1043,504,840,53,9,147,1096,9,180,112,198,189,310,1377,2344,4,11604,644,0,2,2,2,44130,17890,3403,24368,0
127,2807,383,288,292,26,6,62,409,11,65,38,67,76,105,429,656,5,3719,206,0,2,2,2,44130,17891,3403,24369,0
103,1953,1178,367,1042,6,15,115,1184,9,94,51,95,103,146,644,976,4,4439,246,0,2,1,1,44130,17891,3403,24370,0
103,1953,177,108,140,8,0,27,185,6,30,16,32,36,48,162,248,3,794,44,0,2,1,1,44130,17893,3403,24371,0
191,3890,1943,715,1694,26,18,214,1969,12,185,120,237,197,357,1436,2721,7,20915,1161,0,2,2,2,44130,17895,3403,24372,0
191,3890,1168,838,957,57,25,144,1225,19,348,224,416,367,640,3018,5452,11,61921,3440,1,2,2,2,44140,17897,3403,24373,0
16,477,442,244,305,14,16,103,456,11,68,45,75,79,120,452,756,6,4588,254,0,2,1,1,44140,17899,3403,24374,0
16,477,182,102,99,11,40,35,193,3,11,6,11,14,17,42,64,1,97,5,0,2,1,1,44140,17900,3403,24375,0
347,7008,1457,730,1242,11,6,188,1468,10,292,166,329,302,495,2424,4078,5,22973,1276,1,2,4,1,44140,17902,3403,24376,1
347,7008,74,35,59,1,0,14,75,3,14,7,14,17,21,58,85,1,128,7,0,2,4,1,44140,17903,3403,24377,1
347,7008,245,125,200,5,7,34,250,7,30,17,34,37,51,166,265,3,1053,58,0,2,4,1,44150,17904,3403,24378,1
347,7009,1457,730,1242,11,6,188,1468,10,292,166,329,302,495,2424,4078,5,22973,1276,1,2,23,18,44150,17906,3403,24379,0
347,7009,74,35,59,1,0,14,75,3,14,7,14,17,21,58,85,1,128,7,0,2,23,18,44150,17907,3403,24380,0
347,7009,245,125,200,5,7,34,250,7,30,17,34,37,51,166,265,3,1053,58,0,2,23,18,44160,17908,3403,24381,0
348,7017,1457,730,1242,11,6,188,1468,10,292,166,329,302,495,2424,4078,5,22973,1276,1,2,15,7,44160,17910,3403,24382,0
348,7017,74,35,59,1,0,14,75,3,14,7,14,17,21,58,85,1,128,7,0,2,15,7,44160,17911,3403,24383,0
348,7017,245,125,200,5,7,34,250,7,30,17,34,37,51,166,265,3,1053,58,0,2,15,7,44170,17912,3403,24384,0
348,7017,1457,730,1242,11,6,188,1468,10,292,166,329,302,495,2424,4078,5,22973,1276,1,2,9,9,44170,17914,3403,24385,1
348,7017,74,35,59,1,0,14,75,3,14,7,14,17,21,58,85,1,128,7,0,2,9,9,44170,17915,3403,24386,1
348,7017,245,125,200,5,7,34,250,7,30,17,34,37,51,166,265,3,1053,58,0,2,9,9,44180,17916,3403,24387,1
348,7014,1457,730,1242,11,6,188,1468,10,292,166,329,302,495,2424,4078,5,22973,1276,1,2,3,4,44180,17918,3403,24388,1
348,7014,74,35,59,1,0,14,75,3,14,7,14,17,21,58,85,1,128,7,0,2,3,4,44180,17919,3403,24389,1
348,7014,245,125,200,5,7,34,250,7,30,17,34,37,51,166,265,3,1053,58,0,2,3,4,44190,17920,3403,24390,1
348,7007,1457,730,1242,11,6,188,1468,10,292,166,329,302,495,2424,4078,5,22973,1276,1,2,3,4,44190,17922,3403,24391,0
348,7007,74,35,59,1,0,14,75,3,14,7,14,17,21,58,85,1,128,7,0,2,3,4,44190,17923,3403,24392,0
348,7007,245,125,200,5,7,34,250,7,30,17,34,37,51,166,265,3,1053,58,0,2,3,4,44200,17924,3403,24393,0
348,7007,1457,730,1242,11,6,188,1468,10,292,166,329,302,495,2424,4078,5,22973,1276,1,2,36,22,44200,17926,3403,24394,0
348,7007,74,35,59,1,0,14,75,3,14,7,14,17,21,58,85,1,128,7,0,2,36,22,44200,17927,3403,24395,0
348,7007,245,125,200,5,7,34,250,7,30,17,34,37,51,166,265,3,1053,58,0,2,36,22,44210,17928,3403,24396,0
9,228,19,8,11,5,0,4,24,2,5,3,6,7,9,13,25,1,30,1,0,2,1,1,44220,17932,3404,24404,0
9,228,102,59,69,5,3,24,107,6,22,15,28,28,43,113,206,3,789,43,0,2,1,1,44220,17932,3404,24405,0
9,228,106,40,36,3,49,17,109,8,17,13,23,25,36,93,167,5,904,50,0,2,1,1,44220,17932,3404,24406,0
211,4493,182,127,129,0,0,53,182,5,39,21,42,44,63,217,343,2,926,51,0,2,1,0,44230,17936,3406,24414,0
211,4493,1165,710,800,67,119,181,1232,18,243,153,282,261,435,2000,3492,10,36473,2026,1,2,1,0,44240,17936,3407,24415,0
99,2081,773,419,590,28,0,166,801,10,204,113,217,214,330,1598,2554,5,13587,754,0,2,1,1,44240,17936,3408,24416,0
99,2081,421,273,302,44,34,57,465,17,81,59,107,98,166,583,1098,11,12329,684,0,2,1,1,44240,17936,3409,24417,0
27,542,2,2,2,0,0,0,2,0,0,0,0,0,0,0,0,0,0,0,0,2,5,20,44240,17936,3409,24417,0
27,542,99,48,90,1,3,5,100,0,0,0,0,0,0,0,0,0,0,0,0,2,5,20,44240,17937,3409,24418,0
27,542,8,5,5,2,0,1,10,0,0,0,0,0,0,0,0,0,0,0,0,2,5,20,44240,17937,3409,24419,0
27,542,1217,716,841,84,126,174,1301,14,185,118,215,199,333,1446,2542,8,20687,1149,0,2,5,20,44250,17939,3409,24420,0
27,542,160,89,115,0,13,31,160,7,15,11,17,22,28,78,124,3,495,27,0,2,5,20,44250,17939,3409,24421,0
27,542,10,10,9,9,0,0,19,0,0,0,0,0,0,0,0,0,0,0,0,2,5,20,44250,17939,3410,24422,0
27,542,173,84,99,8,29,36,181,5,12,7,13,17,20,54,81,2,221,12,0,2,5,20,44250,17940,3410,24423,0
27,542,3,1,1,3,0,0,6,0,0,0,0,0,0,0,0,0,0,0,0,2,5,20,44250,17940,3410,24424,0
163,5086,1660,832,1314,41,38,274,1701,20,312,209,395,332,604,2671,5058,12,64042,3557,1,2,2,2,44250,17942,3411,24426,0
163,5086,1057,646,719,113,100,145,1170,18,215,134,248,233,382,1740,3004,10,31186,1732,1,2,2,2,44260,17943,3412,24427,0
17,349,95,58,50,9,16,20,104,12,33,24,45,45,69,209,378,8,3100,172,0,0,102,0,44260,17943,3412,24428,0
82,1800,477,336,357,30,23,73,507,16,194,134,250,210,384,1538,2962,10,30538,1696,0,2,4,3,44270,17944,3412,24429,0
60,1259,996,429,845,24,10,117,1020,7,76,50,88,83,138,494,879,4,3565,198,0,2,4,4,44270,17946,3412,24430,0
60,1259,456,277,329,12,42,72,468,13,85,50,97,98,147,592,972,7,7212,400,0,2,4,4,44270,17946,3412,24431,0
119,2406,1513,682,1277,25,13,200,1538,11,199,116,219,210,335,1557,2584,6,15641,868,0,2,6,5,44270,17948,3412,24432,0
119,2406,819,519,539,24,98,155,843,15,96,57,106,111,163,690,1107,8,9171,509,0,2,6,5,44280,17950,3412,24433,0
54,1153,207,111,150,11,0,50,218,5,26,19,36,31,55,133,272,3,943,52,0,2,65,4,44280,17950,3412,24434,0
54,1153,410,198,237,31,55,97,441,11,63,38,72,74,110,414,683,6,4293,238,0,2,65,4,44290,17951,3413,24435,0
348,7028,1457,730,1242,11,6,188,1468,10,292,166,329,302,495,2424,4078,5,22973,1276,1,2,13,9,44290,17953,3413,24436,0
348,7028,74,35,59,1,0,14,75,3,14,7,14,17,21,58,85,1,128,7,0,2,13,9,44290,17954,3413,24437,0
348,7028,245,125,200,5,7,34,250,7,30,17,34,37,51,166,265,3,1053,58,0,2,13,9,44300,17955,3413,24438,0
21,662,339,213,244,17,9,65,356,10,42,26,48,52,74,259,421,5,2410,133,0,2,19,20,44310,17955,3413,24439,0
56,1603,1455,414,1257,16,76,112,1471,5,41,23,46,46,69,231,381,2,1069,59,0,2,4,3,44310,17956,3413,24441,0
56,1603,669,365,481,22,61,110,691,15,103,63,122,118,185,747,1273,8,11311,628,0,2,4,3,44320,17956,3414,24442,0
225,5091,4293,999,3693,19,54,507,4312,9,155,88,170,164,258,1156,1898,4,9368,520,0,2,22,37,44320,17958,3414,24443,0
225,5091,1482,859,1002,125,135,219,1607,16,219,134,251,235,385,1766,3032,9,27804,1544,1,2,22,37,44330,17959,3414,24444,0
6,136,44,22,19,0,19,6,44,2,10,6,12,12,18,35,64,1,77,4,0,2,2,3,44330,17959,3414,24445,0
24,842,74,35,59,1,0,14,75,3,14,7,14,17,21,58,85,1,128,7,0,2,2,0,44330,17960,3414,24446,0
24,842,245,125,200,5,7,34,250,7,30,17,34,37,51,166,265,3,1053,58,0,2,2,0,44340,17961,3414,24447,0
49,575,647,139,84,35,284,233,682,0,0,0,0,0,0,0,0,0,0,0,0,2,5,2,44340,17961,3414,24448,0
83,2359,1523,757,1297,19,12,193,1542,12,193,117,230,205,347,1508,2664,7,19053,1058,0,2,47,7,44350,17963,3414,24449,0
83,2359,701,378,504,33,58,109,734,13,110,68,126,123,194,794,1346,7,10027,557,0,2,47,7,44350,17964,3415,24450,0
178,4123,77,34,69,0,0,8,77,3,24,16,29,27,45,114,213,1,387,21,0,2,39,32,44350,17964,3415,24451,0
178,4123,712,438,573,51,9,84,763,14,102,71,128,116,199,733,1364,8,11988,666,0,2,39,32,44360,17965,3415,24452,0
80,1581,1020,354,843,12,15,144,1032,8,134,77,144,142,221,970,1580,4,6792,377,0,2,119,56,44360,17965,3415,24453,0
46,955,447,308,343,6,5,95,453,7,96,59,111,103,170,651,1136,4,4600,255,0,2,5,4,44360,17968,3415,24454,0
46,955,322,174,179,16,74,51,338,10,41,26,46,51,72,252,408,5,2291,127,0,2,5,4,44360,17971,3416,24455,0
23,388,424,94,331,4,0,89,428,1,5,5,5,6,10,11,25,0,12,0,0,2,10,9,44360,17972,3416,24456,0
23,388,38,23,23,6,0,8,44,3,11,7,11,14,18,42,68,1,102,5,0,2,10,9,44360,17972,3416,24457,0
17,518,184,100,137,2,15,30,186,6,38,20,39,44,59,214,322,3,991,55,0,2,2,0,44360,17973,3416,24458,0
17,518,103,65,74,8,5,16,111,7,17,9,17,24,26,89,119,3,417,23,0,2,2,0,44360,17974,3416,24459,0
223,5047,722,423,573,19,0,135,741,12,172,101,199,184,300,1320,2257,6,15668,870,0,2,26,16,44360,17976,3416,24461,0
223,5047,1508,847,911,44,250,301,1552,14,148,88,169,162,257,1120,1886,7,15077,837,0,2,26,16,44360,17977,3417,24462,0
336,7168,72,33,56,0,4,12,72,1,1,1,1,2,2,0,2,0,1,0,0,2,95,80,44360,17977,3417,24463,0
336,7168,1454,835,1044,76,110,219,1530,17,275,158,296,292,454,2297,3718,9,34017,1889,1,2,95,80,44370,17978,3417,24464,0
38,783,386,256,301,16,9,68,402,4,59,35,69,63,104,355,621,2,1453,80,0,2,19,51,44370,17978,3417,24465,0
38,783,264,131,164,11,41,46,275,6,38,22,40,44,62,214,338,3,1068,59,0,2,19,51,44380,17978,3418,24466,0
30,649,215,129,180,6,0,29,221,8,65,43,72,73,115,415,711,4,3153,175,0,2,3,2,44380,17978,3418,24467,0
30,649,97,69,77,3,3,16,100,6,22,13,23,28,36,113,173,3,542,30,0,2,3,2,44380,17979,3418,24468,0
127,2807,1043,504,840,53,9,147,1096,9,180,112,198,189,310,1377,2344,4,11604,644,0,2,18,16,44380,17981,3418,24469,0
127,2807,383,288,292,26,6,62,409,11,65,38,67,76,105,429,656,5,3719,206,0,2,18,16,44380,17982,3418,24470,0
20,408,294,64,250,0,0,43,294,1,20,10,20,21,30,86,131,0,65,3,0,2,2,0,44380,17982,3418,24471,0
20,408,78,46,62,3,0,14,81,3,8,4,8,11,12,28,41,1,62,3,0,2,2,0,44380,17983,3418,24472,0
5,118,110,30,77,3,13,16,113,4,21,15,30,25,45,100,208,2,597,33,0,2,2,0,44380,17983,3418,24473,0
5,118,28,15,21,1,0,6,29,0,0,0,0,0,0,0,0,0,0,0,0,2,2,0,44380,17983,3418,24474,0
103,1953,1178,367,1042,6,15,115,1184,9,94,51,95,103,146,644,976,4,4439,246,0,2,36,32,44380,17983,3418,24475,0
103,1953,177,108,140,8,0,27,185,6,30,16,32,36,48,162,248,3,794,44,0,2,36,32,44380,17985,3418,24476,0
191,3890,1943,715,1694,26,18,214,1969,12,185,120,237,197,357,1436,2721,7,20915,1161,0,2,53,19,44380,17987,3418,24477,0
191,3890,1168,838,957,57,25,144,1225,19,348,224,416,367,640,3018,5452,11,61921,3440,1,2,53,19,44390,17989,3418,24478,0
16,477,442,244,305,14,16,103,456,11,68,45,75,79,120,452,756,6,4588,254,0,2,2,0,44390,17991,3418,24479,0
16,477,182,102,99,11,40,35,193,3,11,6,11,14,17,42,64,1,97,5,0,2,2,0,44390,17992,3418,24480,0
62,1240,1098,241,925,5,10,155,1103,7,46,25,49,53,74,273,423,3,1580,87,0,2,26,22,44400,17994,3418,24481,0
62,1240,282,202,222,14,2,44,296,8,42,24,43,50,67,250,378,4,1548,86,0,2,26,22,44400,17995,3418,24482,0
14,339,601,196,481,2,23,85,603,8,63,36,72,71,108,400,664,4,3036,168,0,0,73,0,44400,17995,3418,24483,0
14,339,156,79,106,5,16,28,161,5,14,8,15,19,23,64,97,2,261,14,0,0,73,0,44400,17995,3418,24484,0
60,1092,282,196,195,3,0,86,285,8,130,71,141,138,212,936,1507,4,6538,363,0,2,6,6,44400,17995,3419,24485,0
7,114,44,19,17,0,16,11,44,3,14,7,14,17,21,58,85,1,128,7,0,2,1,1,44400,17995,3419,24486,0
3,66,127,75,83,2,11,30,129,4,14,7,14,18,21,61,87,2,175,9,0,2,1,1,44400,17995,3419,24487,0
3,66,652,304,544,16,6,88,668,6,89,51,101,95,152,591,998,3,3399,188,0,2,1,1,44400,17996,3419,24488,0
3,66,2,2,2,0,0,0,2,0,0,0,0,0,0,0,0,0,0,0,0,2,1,1,44400,17996,3419,24488,0
3,66,8,5,5,0,0,3,8,0,0,0,0,0,0,0,0,0,0,0,0,2,1,1,44400,17996,3419,24489,0
3,66,2,2,2,0,0,0,2,0,0,0,0,0,0,0,0,0,0,0,0,2,1,1,44400,17996,3419,24489,0
3,66,14,8,8,0,0,6,14,0,0,0,0,0,0,0,0,0,0,0,0,2,1,1,44400,17996,3419,24490,0
3,66,6,4,4,0,0,2,6,0,0,0,0,0,0,0,0,0,0,0,0,2,1,1,44400,17996,3419,24491,0
3,66,6,4,4,0,0,2,6,1,2,1,2,3,3,2,4,0,2,0,0,2,1,1,44400,17996,3419,24492,0
3,66,6,4,4,0,0,2,6,0,0,0,0,0,0,0,0,0,0,0,0,2,1,1,44400,17996,3419,24493,0
3,66,7,5,5,0,0,2,7,0,0,0,0,0,0,0,0,0,0,0,0,2,1,1,44400,17996,3419,24494,0
3,66,6,4,4,0,0,2,6,0,0,0,0,0,0,0,0,0,0,0,0,2,1,1,44400,17996,3419,24495,0
3,66,10,6,6,0,0,4,10,0,0,0,0,0,0,0,0,0,0,0,0,2,1,1,44400,17996,3419,24496,0
3,66,1,1,1,0,0,0,1,0,0,0,0,0,0,0,0,0,0,0,0,2,1,1,44400,17996,3419,24496,0
3,66,14,10,10,0,0,4,14,1,1,1,1,2,2,0,2,0,1,0,0,2,1,1,44400,17996,3419,24497,0
3,66,46,26,30,3,0,12,49,3,6,3,6,9,9,20,28,1,42,2,0,2,1,1,44410,17996,3419,24498,0
7,301,72,33,56,0,4,12,72,1,1,1,1,2,2,0,2,0,1,0,0,2,1,1,44410,17996,3419,24499,0
3,26,14,7,7,2,0,5,16,0,0,0,0,0,0,0,0,0,0,0,0,2,1,1,44410,17996,3419,24499,0
11,402,42,7,35,4,0,5,46,1,2,1,2,3,3,2,4,0,2,0,0,2,20,22,44410,17996,3419,24500,0
11,402,11,6,10,0,0,1,11,2,4,2,4,6,6,10,15,1,15,0,0,2,20,22,44410,17996,3419,24501,0
80,3429,1289,550,1043,56,32,155,1345,10,167,93,185,177,278,1266,2075,5,11498,638,0,2,63,9,44420,18002,3421,24509,0
34,997,182,127,129,0,0,53,182,5,39,21,42,44,63,217,343,2,926,51,0,2,4,3,44420,18002,3422,24510,0
137,6599,1392,870,1177,35,17,170,1427,14,494,280,531,508,811,4473,7289,7,54850,3047,2,2,6,5,44420,18005,3423,24511,0
91,3011,773,419,590,28,0,166,801,10,204,113,217,214,330,1598,2554,5,13587,754,0,2,12,11,44420,18005,3424,24512,0
7,263,75,38,59,1,3,12,76,2,4,2,4,6,6,10,15,1,15,0,0,2,3,2,44420,18005,3424,24513,0
47,2498,520,294,400,33,13,81,553,10,261,204,367,271,571,2128,4614,7,32445,1802,1,2,1,1,44420,18006,3424,24514,0
96,4365,1338,495,1086,10,64,173,1348,11,122,82,157,133,239,883,1686,7,11934,663,0,2,35,34,44420,18008,3424,24515,0
147,6797,139,89,101,2,0,35,141,7,54,34,62,61,96,330,569,4,2287,127,0,2,75,64,44420,18008,3424,24516,0
147,6797,7,5,5,0,0,2,7,1,2,1,2,3,3,2,4,0,2,0,0,2,75,64,44420,18008,3424,24517,0
32,948,465,148,393,5,8,60,470,4,31,20,31,35,51,161,261,2,523,29,0,2,9,9,44420,18009,3424,24518,0
32,948,16,12,9,0,0,6,16,1,2,1,2,3,3,2,4,0,2,0,0,2,9,9,44420,18009,3424,24519,0
112,5710,1782,648,1425,9,47,279,1791,8,171,97,189,179,286,1292,2140,4,9462,525,0,2,154,53,44420,18010,3425,24520,0
20,541,256,139,192,9,7,47,265,4,23,12,24,27,36,112,171,2,357,19,0,2,17,10,44420,18011,3425,24521,0
23,601,102,59,69,5,3,24,107,6,22,15,28,28,43,113,206,3,789,43,0,2,2,2,44420,18011,3425,24522,0
109,4106,1450,624,1228,12,26,181,1462,14,306,186,354,320,540,2580,4493,8,36391,2021,1,2,128,45,44420,18013,3426,24523,0
149,4136,1660,832,1314,41,38,274,1701,20,312,209,395,332,604,2671,5058,12,64042,3557,1,2,24,5,44420,18015,3427,24525,0
117,4645,1513,682,1277,25,13,200,1538,11,199,116,219,210,335,1557,2584,6,15641,868,0,2,29,16,44420,18017,3427,24526,0
59,3310,1296,573,1062,40,33,157,1336,8,201,118,231,209,349,1561,2689,4,12365,686,0,2,35,18,44420,18017,3427,24527,0
10,236,207,111,150,11,0,50,218,5,26,19,36,31,55,133,272,3,943,52,0,2,30,4,44420,18017,3427,24528,0
78,4093,1457,730,1242,11,6,188,1468,10,292,166,329,302,495,2424,4078,5,22973,1276,1,2,22,20,44420,18019,3427,24529,0
38,2286,652,304,544,16,6,88,668,6,89,51,101,95,152,591,998,3,3399,188,0,2,5,4,44420,18020,3427,24530,0
62,2878,1455,414,1257,16,76,112,1471,5,41,23,46,46,69,231,381,2,1069,59,0,2,37,9,44420,18021,3427,24531,0
2,75,7,6,5,0,0,2,7,1,1,1,2,2,3,0,3,1,3,0,0,2,1,0,44420,18021,3427,24532,0
8,273,74,35,59,1,0,14,75,3,14,7,14,17,21,58,85,1,128,7,0,2,2,1,44420,18022,3427,24533,0
90,4427,1523,757,1297,19,12,193,1542,12,193,117,230,205,347,1508,2664,7,19053,1058,0,2,85,8,44430,18024,3427,24534,0
68,2962,1020,354,843,12,15,144,1032,8,134,77,144,142,221,970,1580,4,6792,377,0,2,41,24,44430,18024,3427,24535,0
37,1624,447,308,343,6,5,95,453,7,96,59,111,103,170,651,1136,4,4600,255,0,2,5,4,44430,18027,3427,24536,0
21,661,424,94,331,4,0,89,428,1,5,5,5,6,10,11,25,0,12,0,0,2,6,5,44430,18028,3427,24537,0
40,2367,334,251,279,10,4,40,344,5,127,74,143,132,217,899,1528,2,4303,239,0,2,11,10,44430,18029,3427,24538,0
12,492,184,100,137,2,15,30,186,6,38,20,39,44,59,214,322,3,991,55,0,2,4,3,44430,18030,3427,24539,0
35,1623,1293,570,1093,25,15,163,1318,10,195,123,241,205,364,1516,2795,6,17273,959,0,2,52,16,44440,18032,3427,24540,0
36,1978,384,251,317,7,8,52,391,11,70,44,84,81,128,467,811,6,5355,297,0,2,13,12,44440,18032,3427,24541,0
15,638,722,423,573,19,0,135,741,12,172,101,199,184,300,1320,2257,6,15668,870,0,2,4,3,44440,18034,3427,24543,0
31,1439,386,256,301,16,9,68,402,4,59,35,69,63,104,355,621,2,1453,80,0,2,29,14,44440,18034,3427,24544,0
16,1209,215,129,180,6,0,29,221,8,65,43,72,73,115,415,711,4,3153,175,0,2,2,1,44440,18034,3427,24545,0
69,2856,1043,504,840,53,9,147,1096,9,180,112,198,189,310,1377,2344,4,11604,644,0,2,10,10,44440,18036,3427,24546,0
14,529,295,56,236,0,4,54,295,2,9,5,10,11,15,30,51,1,57,3,0,2,13,11,44440,18038,3427,24547,0
25,1027,373,158,315,8,0,51,381,5,76,44,79,81,123,486,779,2,2026,112,0,2,7,6,44440,18038,3427,24548,0
71,3006,1178,367,1042,6,15,115,1184,9,94,51,95,103,146,644,976,4,4439,246,0,2,11,10,44440,18038,3427,24549,0
73,3738,1943,715,1694,26,18,214,1969,12,185,120,237,197,357,1436,2721,7,20915,1161,0,2,22,21,44440,18040,3427,24550,0
14,825,442,244,305,14,16,103,456,11,68,45,75,79,120,452,756,6,4588,254,0,2,3,2,44440,18042,3427,24551,0
48,1784,1098,241,925,5,10,155,1103,7,46,25,49,53,74,273,423,3,1580,87,0,2,3,2,44450,18044,3427,24552,0
9,317,601,196,481,2,23,85,603,8,63,36,72,71,108,400,664,4,3036,168,0,0,108,0,44450,18044,3427,24553,0
60,1265,996,429,845,24,10,117,1020,7,76,50,88,83,138,494,879,4,3565,198,0,2,2,2,44450,18046,3427,24554,0
60,1265,456,277,329,12,42,72,468,13,85,50,97,98,147,592,972,7,7212,400,0,2,2,2,44450,18046,3427,24555,0
60,1265,996,429,845,24,10,117,1020,7,76,50,88,83,138,494,879,4,3565,198,0,2,2,2,44450,18048,3427,24556,0
60,1265,456,277,329,12,42,72,468,13,85,50,97,98,147,592,972,7,7212,400,0,2,2,2,44450,18048,3427,24557,0
14,348,601,196,481,2,23,85,603,8,63,36,72,71,108,400,664,4,3036,168,0,2,3,1,44450,18048,3427,24558,1
14,348,156,79,106,5,16,28,161,5,14,8,15,19,23,64,97,2,261,14,0,2,3,1,44450,18048,3427,24559,1
10,361,601,196,481,2,23,85,603,8,63,36,72,71,108,400,664,4,3036,168,0,2,29,0,44450,18048,3427,24560,1
54,1161,207,111,150,11,0,50,218,5,26,19,36,31,55,133,272,3,943,52,0,2,2,0,44450,18048,3427,24561,1
54,1161,410,198,237,31,55,97,441,11,63,38,72,74,110,414,683,6,4293,238,0,2,2,0,44460,18049,3428,24562,1
19,407,601,196,481,2,23,85,603,8,63,36,72,71,108,400,664,4,3036,168,0,2,14,1,44460,18049,3428,24563,1
19,407,156,79,106,5,16,28,161,5,14,8,15,19,23,64,97,2,261,14,0,2,14,1,44460,18049,3428,24564,1
11,447,601,196,481,2,23,85,603,8,63,36,72,71,108,400,664,4,3036,168,0,2,31,0,44460,18049,3428,24565,1
54,1161,207,111,150,11,0,50,218,5,26,19,36,31,55,133,272,3,943,52,0,2,2,0,44460,18049,3428,24566,0
54,1161,410,198,237,31,55,97,441,11,63,38,72,74,110,414,683,6,4293,238,0,2,2,0,44470,18050,3429,24567,0
19,407,601,196,481,2,23,85,603,8,63,36,72,71,108,400,664,4,3036,168,0,2,16,1,44470,18050,3429,24568,0
19,407,156,79,106,5,16,28,161,5,14,8,15,19,23,64,97,2,261,14,0,2,16,1,44470,18050,3429,24569,0
11,447,601,196,481,2,23,85,603,8,63,36,72,71,108,400,664,4,3036,168,0,2,60,0,44470,18050,3429,24570,0
60,1689,1455,414,1257,16,76,112,1471,5,41,23,46,46,69,231,381,2,1069,59,0,2,29,0,44470,18051,3429,24571,1
60,1689,669,365,481,22,61,110,691,15,103,63,122,118,185,747,1273,8,11311,628,0,2,29,0,44480,18051,3430,24572,1
63,2918,1455,414,1257,16,76,112,1471,5,41,23,46,46,69,231,381,2,1069,59,0,2,22,0,44480,18052,3430,24573,1
60,1689,1455,414,1257,16,76,112,1471,5,41,23,46,46,69,231,381,2,1069,59,0,2,29,0,44480,18053,3430,24574,0
60,1689,669,365,481,22,61,110,691,15,103,63,122,118,185,747,1273,8,11311,628,0,2,29,0,44490,18053,3431,24575,0
63,2918,1455,414,1257,16,76,112,1471,5,41,23,46,46,69,231,381,2,1069,59,0,2,22,0,44490,18054,3431,24576,0
60,1265,996,429,845,24,10,117,1020,7,76,50,88,83,138,494,879,4,3565,198,0,2,2,2,44490,18056,3431,24577,0
60,1265,456,277,329,12,42,72,468,13,85,50,97,98,147,592,972,7,7212,400,0,2,2,2,44490,18056,3431,24578,0
54,1161,207,111,150,11,0,50,218,5,26,19,36,31,55,133,272,3,943,52,0,2,2,0,44490,18056,3431,24579,0
54,1161,410,198,237,31,55,97,441,11,63,38,72,74,110,414,683,6,4293,238,0,2,2,0,44500,18057,3432,24580,0
60,1689,1455,414,1257,16,76,112,1471,5,41,23,46,46,69,231,381,2,1069,59,0,2,29,0,44500,18058,3432,24581,0
60,1689,669,365,481,22,61,110,691,15,103,63,122,118,185,747,1273,8,11311,628,0,2,29,0,44510,18058,3433,24582,0
19,407,601,196,481,2,23,85,603,8,63,36,72,71,108,400,664,4,3036,168,0,2,16,1,44510,18058,3433,24583,0
19,407,156,79,106,5,16,28,161,5,14,8,15,19,23,64,97,2,261,14,0,2,16,1,44510,18058,3433,24584,0
63,2918,1455,414,1257,16,76,112,1471,5,41,23,46,46,69,231,381,2,1069,59,0,2,22,0,44510,18059,3433,24585,0
11,447,601,196,481,2,23,85,603,8,63,36,72,71,108,400,664,4,3036,168,0,2,60,0,44510,18059,3433,24586,0
38,787,386,256,301,16,9,68,402,4,59,35,69,63,104,355,621,2,1453,80,0,2,1,1,44510,18059,3433,24587,0
38,787,264,131,164,11,41,46,275,6,38,22,40,44,62,214,338,3,1068,59,0,2,1,1,44520,18059,3434,24588,0
31,1467,386,256,301,16,9,68,402,4,59,35,69,63,104,355,621,2,1453,80,0,2,10,7,44520,18059,3434,24589,0
38,787,386,256,301,16,9,68,402,4,59,35,69,63,104,355,621,2,1453,80,0,2,1,1,44520,18059,3434,24590,0
38,787,264,131,164,11,41,46,275,6,38,22,40,44,62,214,338,3,1068,59,0,2,1,1,44530,18059,3435,24591,0
31,1467,386,256,301,16,9,68,402,4,59,35,69,63,104,355,621,2,1453,80,0,2,10,7,44530,18059,3435,24592,0
19,401,601,196,481,2,23,85,603,8,63,36,72,71,108,400,664,4,3036,168,0,2,0,1,44530,18059,3435,24593,1
19,401,156,79,106,5,16,28,161,5,14,8,15,19,23,64,97,2,261,14,0,2,0,1,44530,18059,3435,24594,1
32,1464,386,256,301,16,9,68,402,4,59,35,69,63,104,355,621,2,1453,80,0,2,8,3,44530,18059,3435,24595,1
12,476,601,196,481,2,23,85,603,8,63,36,72,71,108,400,664,4,3036,168,0,2,34,12,44530,18059,3435,24596,1
19,401,601,196,481,2,23,85,603,8,63,36,72,71,108,400,664,4,3036,168,0,2,0,1,44530,18059,3435,24597,0
19,401,156,79,106,5,16,28,161,5,14,8,15,19,23,64,97,2,261,14,0,2,0,1,44530,18059,3435,24598,0
32,1492,386,256,301,16,9,68,402,4,59,35,69,63,104,355,621,2,1453,80,0,2,8,3,44530,18059,3435,24599,0
12,476,601,196,481,2,23,85,603,8,63,36,72,71,108,400,664,4,3036,168,0,2,34,12,44530,18059,3435,24600,0
150,4203,1660,832,1314,41,38,274,1701,20,312,209,395,332,604,2671,5058,12,64042,3557,1,2,14,0,44530,18061,3436,24602,1
163,5080,1660,832,1314,41,38,274,1701,20,312,209,395,332,604,2671,5058,12,64042,3557,1,2,1,2,44530,18063,3437,24604,0
163,5080,1057,646,719,113,100,145,1170,18,215,134,248,233,382,1740,3004,10,31186,1732,1,2,1,2,44540,18064,3438,24605,0
11,402,42,7,35,4,0,5,46,1,2,1,2,3,3,2,4,0,2,0,0,2,1,1,44540,18064,3438,24606,1
11,402,11,6,10,0,0,1,11,2,4,2,4,6,6,10,15,1,15,0,0,2,1,1,44540,18064,3438,24607,1
38,787,386,256,301,16,9,68,402,4,59,35,69,63,104,355,621,2,1453,80,0,2,1,1,44540,18064,3438,24608,0
38,787,264,131,164,11,41,46,275,6,38,22,40,44,62,214,338,3,1068,59,0,2,1,1,44550,18064,3439,24609,0
19,401,601,196,481,2,23,85,603,8,63,36,72,71,108,400,664,4,3036,168,0,2,0,1,44550,18064,3439,24610,0
19,401,156,79,106,5,16,28,161,5,14,8,15,19,23,64,97,2,261,14,0,2,0,1,44550,18064,3439,24611,0
32,1492,386,256,301,16,9,68,402,4,59,35,69,63,104,355,621,2,1453,80,0,2,18,10,44550,18064,3439,24612,0
12,476,601,196,481,2,23,85,603,8,63,36,72,71,108,400,664,4,3036,168,0,2,34,12,44550,18064,3439,24613,0
163,5080,1660,832,1314,41,38,274,1701,20,312,209,395,332,604,2671,5058,12,64042,3557,1,2,1,2,44550,18066,3440,24615,0
163,5080,1057,646,719,113,100,145,1170,18,215,134,248,233,382,1740,3004,10,31186,1732,1,2,1,2,44560,18067,3441,24616,0
11,402,42,7,35,4,0,5,46,1,2,1,2,3,3,2,4,0,2,0,0,2,1,1,44560,18067,3441,24617,0
11,402,11,6,10,0,0,1,11,2,4,2,4,6,6,10,15,1,15,0,0,2,1,1,44560,18067,3441,24618,0
150,4203,1660,832,1314,41,38,274,1701,20,312,209,395,332,604,2671,5058,12,64042,3557,1,2,14,0,44560,18069,3442,24620,0
349,7049,1457,730,1242,11,6,188,1468,10,292,166,329,302,495,2424,4078,5,22973,1276,1,2,17,7,44560,18071,3442,24621,1
349,7049,74,35,59,1,0,14,75,3,14,7,14,17,21,58,85,1,128,7,0,2,17,7,44560,18072,3442,24622,1
349,7049,245,125,200,5,7,34,250,7,30,17,34,37,51,166,265,3,1053,58,0,2,17,7,44570,18073,3442,24623,1
27,953,74,35,59,1,0,14,75,3,14,7,14,17,21,58,85,1,128,7,0,2,26,1,44570,18074,3442,24624,1
27,953,245,125,200,5,7,34,250,7,30,17,34,37,51,166,265,3,1053,58,0,2,26,1,44580,18075,3442,24625,1
39,2355,652,304,544,16,6,88,668,6,89,51,101,95,152,591,998,3,3399,188,0,2,12,0,44580,18076,3442,24626,1
27,954,74,35,59,1,0,14,75,3,14,7,14,17,21,58,85,1,128,7,0,2,8,0,44580,18077,3442,24627,0
27,954,245,125,200,5,7,34,250,7,30,17,34,37,51,166,265,3,1053,58,0,2,8,0,44590,18078,3442,24628,0
349,7049,1457,730,1242,11,6,188,1468,10,292,166,329,302,495,2424,4078,5,22973,1276,1,2,17,7,44590,18080,3442,24629,0
349,7049,74,35,59,1,0,14,75,3,14,7,14,17,21,58,85,1,128,7,0,2,17,7,44590,18081,3442,24630,0
349,7049,245,125,200,5,7,34,250,7,30,17,34,37,51,166,265,3,1053,58,0,2,17,7,44600,18082,3442,24631,0
27,954,74,35,59,1,0,14,75,3,14,7,14,17,21,58,85,1,128,7,0,2,34,1,44600,18083,3442,24632,0
27,954,245,125,200,5,7,34,250,7,30,17,34,37,51,166,265,3,1053,58,0,2,34,1,44610,18084,3442,24633,0
39,2355,652,304,544,16,6,88,668,6,89,51,101,95,152,591,998,3,3399,188,0,2,12,0,44610,18085,3442,24634,0
128,2606,1513,682,1277,25,13,200,1538,11,199,116,219,210,335,1557,2584,6,15641,868,0,2,50,1,44610,18087,3442,24635,1
128,2606,819,519,539,24,98,155,843,15,96,57,106,111,163,690,1107,8,9171,509,0,2,50,1,44620,18089,3442,24636,1
128,2606,1513,682,1277,25,13,200,1538,11,199,116,219,210,335,1557,2584,6,15641,868,0,2,1,1,44620,18091,3442,24637,0
128,2606,819,519,539,24,98,155,843,15,96,57,106,111,163,690,1107,8,9171,509,0,2,1,1,44630,18093,3442,24638,0
128,2606,1513,682,1277,25,13,200,1538,11,199,116,219,210,335,1557,2584,6,15641,868,0,2,50,1,44630,18095,3442,24639,0
128,2606,819,519,539,24,98,155,843,15,96,57,106,111,163,690,1107,8,9171,509,0,2,50,1,44640,18097,3442,24640,0
178,4125,77,34,69,0,0,8,77,3,24,16,29,27,45,114,213,1,387,21,0,2,5,1,44640,18097,3442,24641,1
178,4125,712,438,573,51,9,84,763,14,102,71,128,116,199,733,1364,8,11988,666,0,2,5,1,44650,18098,3442,24642,1
80,3427,1289,550,1043,56,32,155,1345,10,167,93,185,177,278,1266,2075,5,11498,638,0,2,2,2,44650,18100,3443,24643,1
66,3414,1296,573,1062,40,33,157,1336,8,201,118,231,209,349,1561,2689,4,12365,686,0,2,14,5,44650,18100,3443,24644,1
192,3902,1943,715,1694,26,18,214,1969,12,185,120,237,197,357,1436,2721,7,20915,1161,0,2,1,1,44650,18102,3443,24645,0
192,3902,1168,838,957,57,25,144,1225,19,348,224,416,367,640,3018,5452,11,61921,3440,1,2,1,1,44660,18104,3443,24646,0
69,2856,1043,504,840,53,9,147,1096,9,180,112,198,189,310,1377,2344,4,11604,644,0,2,2,2,44660,18106,3443,24647,0
74,3770,1943,715,1694,26,18,214,1969,12,185,120,237,197,357,1436,2721,7,20915,1161,0,2,9,0,44660,18108,3443,24648,0
19,408,601,196,481,2,23,85,603,8,63,36,72,71,108,400,664,4,3036,168,0,2,5,4,44660,18108,3443,24649,1
19,408,156,79,106,5,16,28,161,5,14,8,15,19,23,64,97,2,261,14,0,2,5,4,44660,18108,3443,24650,1
12,476,601,196,481,2,23,85,603,8,63,36,72,71,108,400,664,4,3036,168,0,2,1,1,44660,18108,3443,24651,1
349,7049,1457,730,1242,11,6,188,1468,10,292,166,329,302,495,2424,4078,5,22973,1276,1,2,3,3,44660,18110,3443,24652,1
349,7049,74,35,59,1,0,14,75,3,14,7,14,17,21,58,85,1,128,7,0,2,3,3,44660,18111,3443,24653,1
349,7049,245,125,200,5,7,34,250,7,30,17,34,37,51,166,265,3,1053,58,0,2,3,3,44670,18112,3443,24654,1
49,575,647,139,84,35,284,233,682,0,0,0,0,0,0,0,0,0,0,0,0,2,1,1,44670,18112,3443,24655,1
349,7049,1457,730,1242,11,6,188,1468,10,292,166,329,302,495,2424,4078,5,22973,1276,1,2,3,3,44670,18114,3443,24656,0
349,7049,74,35,59,1,0,14,75,3,14,7,14,17,21,58,85,1,128,7,0,2,3,3,44670,18115,3443,24657,0
349,7049,245,125,200,5,7,34,250,7,30,17,34,37,51,166,265,3,1053,58,0,2,3,3,44680,18116,3443,24658,0
49,575,647,139,84,35,284,233,682,0,0,0,0,0,0,0,0,0,0,0,0,2,1,1,44680,18116,3443,24659,0
163,5080,1660,832,1314,41,38,274,1701,20,312,209,395,332,604,2671,5058,12,64042,3557,1,2,1,2,44680,18118,3444,24661,0
163,5080,1057,646,719,113,100,145,1170,18,215,134,248,233,382,1740,3004,10,31186,1732,1,2,1,2,44690,18119,3445,24662,0
128,2606,1513,682,1277,25,13,200,1538,11,199,116,219,210,335,1557,2584,6,15641,868,0,2,50,1,44690,18121,3445,24663,0
128,2606,819,519,539,24,98,155,843,15,96,57,106,111,163,690,1107,8,9171,509,0,2,50,1,44700,18123,3445,24664,0
349,7049,1457,730,1242,11,6,188,1468,10,292,166,329,302,495,2424,4078,5,22973,1276,1,2,20,10,44700,18125,3445,24665,0
349,7049,74,35,59,1,0,14,75,3,14,7,14,17,21,58,85,1,128,7,0,2,20,10,44700,18126,3445,24666,0
349,7049,245,125,200,5,7,34,250,7,30,17,34,37,51,166,265,3,1053,58,0,2,20,10,44710,18127,3445,24667,0
27,954,74,35,59,1,0,14,75,3,14,7,14,17,21,58,85,1,128,7,0,2,34,1,44710,18128,3445,24668,0
27,954,245,125,200,5,7,34,250,7,30,17,34,37,51,166,265,3,1053,58,0,2,34,1,44720,18129,3445,24669,0
49,575,647,139,84,35,284,233,682,0,0,0,0,0,0,0,0,0,0,0,0,2,1,1,44720,18129,3445,24670,0
11,402,42,7,35,4,0,5,46,1,2,1,2,3,3,2,4,0,2,0,0,2,1,1,44720,18129,3445,24671,0
11,402,11,6,10,0,0,1,11,2,4,2,4,6,6,10,15,1,15,0,0,2,1,1,44720,18129,3445,24672,0
150,4203,1660,832,1314,41,38,274,1701,20,312,209,395,332,604,2671,5058,12,64042,3557,1,2,14,0,44720,18131,3446,24674,0
39,2355,652,304,544,16,6,88,668,6,89,51,101,95,152,591,998,3,3399,188,0,2,12,0,44720,18132,3446,24675,0
40,834,386,256,301,16,9,68,402,4,59,35,69,63,104,355,621,2,1453,80,0,2,35,29,44720,18132,3446,24676,1
40,834,264,131,164,11,41,46,275,6,38,22,40,44,62,214,338,3,1068,59,0,2,35,29,44730,18132,3447,24677,1
38,1637,386,256,301,16,9,68,402,4,59,35,69,63,104,355,621,2,1453,80,0,2,48,10,44730,18132,3447,24678,1
19,408,601,196,481,2,23,85,603,8,63,36,72,71,108,400,664,4,3036,168,0,2,5,4,44730,18132,3447,24679,0
19,408,156,79,106,5,16,28,161,5,14,8,15,19,23,64,97,2,261,14,0,2,5,4,44730,18132,3447,24680,0
12,476,601,196,481,2,23,85,603,8,63,36,72,71,108,400,664,4,3036,168,0,2,1,1,44730,18132,3447,24681,0
212,4584,182,127,129,0,0,53,182,5,39,21,42,44,63,217,343,2,926,51,0,2,34,7,44730,18132,3448,24682,1
212,4584,1165,710,800,67,119,181,1232,18,243,153,282,261,435,2000,3492,10,36473,2026,1,2,34,7,44740,18132,3449,24683,1
143,6718,1392,870,1177,35,17,170,1427,14,494,280,531,508,811,4473,7289,7,54850,3047,2,2,33,0,44740,18135,3450,24684,1
212,4584,182,127,129,0,0,53,182,5,39,21,42,44,63,217,343,2,926,51,0,2,34,7,44740,18135,3451,24685,0
212,4584,1165,710,800,67,119,181,1232,18,243,153,282,261,435,2000,3492,10,36473,2026,1,2,34,7,44750,18135,3452,24686,0
143,6718,1392,870,1177,35,17,170,1427,14,494,280,531,508,811,4473,7289,7,54850,3047,2,2,33,0,44750,18138,3453,24687,0
212,4584,182,127,129,0,0,53,182,5,39,21,42,44,63,217,343,2,926,51,0,2,34,7,44750,18138,3454,24688,0
212,4584,1165,710,800,67,119,181,1232,18,243,153,282,261,435,2000,3492,10,36473,2026,1,2,34,7,44760,18138,3455,24689,0
19,408,601,196,481,2,23,85,603,8,63,36,72,71,108,400,664,4,3036,168,0,2,5,4,44760,18138,3455,24690,0
19,408,156,79,106,5,16,28,161,5,14,8,15,19,23,64,97,2,261,14,0,2,5,4,44760,18138,3455,24691,0
143,6718,1392,870,1177,35,17,170,1427,14,494,280,531,508,811,4473,7289,7,54850,3047,2,2,33,0,44760,18141,3456,24692,0
12,476,601,196,481,2,23,85,603,8,63,36,72,71,108,400,664,4,3036,168,0,2,1,1,44760,18141,3456,24693,0
213,4595,182,127,129,0,0,53,182,5,39,21,42,44,63,217,343,2,926,51,0,2,5,2,44760,18141,3457,24694,1
213,4595,1165,710,800,67,119,181,1232,18,243,153,282,261,435,2000,3492,10,36473,2026,1,2,5,2,44770,18141,3458,24695,1
147,6814,1392,870,1177,35,17,170,1427,14,494,280,531,508,811,4473,7289,7,54850,3047,2,2,23,0,44770,18144,3459,24696,1
306,6621,72,33,56,0,4,12,72,1,1,1,1,2,2,0,2,0,1,0,0,2,0,250,44770,18144,3459,24697,0
306,6621,1454,835,1044,76,110,219,1530,17,275,158,296,292,454,2297,3718,9,34017,1889,1,2,0,250,44780,18145,3459,24698,0
286,6178,72,33,56,0,4,12,72,1,1,1,1,2,2,0,2,0,1,0,0,2,0,174,44780,18145,3459,24699,1
286,6178,1454,835,1044,76,110,219,1530,17,275,158,296,292,454,2297,3718,9,34017,1889,1,2,0,174,44790,18146,3459,24700,1
50,1010,757,253,292,73,244,162,830,13,61,38,67,74,105,409,651,7,4654,258,0,0,430,0,44790,18147,3459,24701,1
286,6178,72,33,56,0,4,12,72,1,1,1,1,2,2,0,2,0,1,0,0,2,0,424,44790,18147,3459,24702,0
286,6178,1454,835,1044,76,110,219,1530,17,275,158,296,292,454,2297,3718,9,34017,1889,1,2,0,424,44800,18148,3459,24703,0
50,1010,757,253,292,73,244,162,830,13,61,38,67,74,105,409,651,7,4654,258,0,0,430,0,44800,18149,3459,24704,0
361,7632,72,33,56,0,4,12,72,1,1,1,1,2,2,0,2,0,1,0,0,2,295,137,44800,18149,3459,24705,1
361,7632,1454,835,1044,76,110,219,1530,17,275,158,296,292,454,2297,3718,9,34017,1889,1,2,295,137,44810,18150,3459,24706,1
56,3288,520,294,400,33,13,81,553,10,261,204,367,271,571,2128,4614,7,32445,1802,1,2,105,26,44810,18151,3459,24707,1
286,6178,72,33,56,0,4,12,72,1,1,1,1,2,2,0,2,0,1,0,0,2,0,582,44810,18151,3459,24708,1
286,6178,1454,835,1044,76,110,219,1530,17,275,158,296,292,454,2297,3718,9,34017,1889,1,2,0,582,44820,18152,3459,24709,1
75,1474,757,253,292,73,244,162,830,13,61,38,67,74,105,409,651,7,4654,258,0,0,588,0,44820,18153,3459,24710,1
227,5124,4293,999,3693,19,54,507,4312,9,155,88,170,164,258,1156,1898,4,9368,520,0,2,8,2,44820,18155,3459,24711,1
227,5124,1482,859,1002,125,135,219,1607,16,219,134,251,235,385,1766,3032,9,27804,1544,1,2,8,2,44830,18156,3459,24712,1
148,6830,139,89,101,2,0,35,141,7,54,34,62,61,96,330,569,4,2287,127,0,2,26,0,44830,18156,3459,24713,1
148,6830,7,5,5,0,0,2,7,1,2,1,2,3,3,2,4,0,2,0,0,2,26,0,44830,18156,3459,24714,1
49,575,647,139,84,35,284,233,682,0,0,0,0,0,0,0,0,0,0,0,0,2,44,15,44830,18156,3459,24715,1
49,575,647,139,84,35,284,233,682,0,0,0,0,0,0,0,0,0,0,0,0,2,44,15,44830,18156,3459,24716,0
60,1673,1455,414,1257,16,76,112,1471,5,41,23,46,46,69,231,381,2,1069,59,0,2,4,5,44830,18157,3459,24717,1
60,1673,669,365,481,22,61,110,691,15,103,63,122,118,185,747,1273,8,11311,628,0,2,4,5,44840,18157,3460,24718,1
64,2957,1455,414,1257,16,76,112,1471,5,41,23,46,46,69,231,381,2,1069,59,0,2,19,0,44840,18158,3460,24719,1
227,5129,4293,999,3693,19,54,507,4312,9,155,88,170,164,258,1156,1898,4,9368,520,0,2,4,1,44840,18160,3460,24720,1
227,5129,1482,859,1002,125,135,219,1607,16,219,134,251,235,385,1766,3032,9,27804,1544,1,2,4,1,44850,18161,3460,24721,1
148,6832,139,89,101,2,0,35,141,7,54,34,62,61,96,330,569,4,2287,127,0,2,13,6,44850,18161,3460,24722,1
148,6832,7,5,5,0,0,2,7,1,2,1,2,3,3,2,4,0,2,0,0,2,13,6,44850,18161,3460,24723,1
227,5129,4293,999,3693,19,54,507,4312,9,155,88,170,164,258,1156,1898,4,9368,520,0,2,11,2,44850,18163,3460,24724,0
227,5129,1482,859,1002,125,135,219,1607,16,219,134,251,235,385,1766,3032,9,27804,1544,1,2,11,2,44860,18164,3460,24725,0
148,6832,139,89,101,2,0,35,141,7,54,34,62,61,96,330,569,4,2287,127,0,2,33,0,44860,18164,3460,24726,0
148,6832,7,5,5,0,0,2,7,1,2,1,2,3,3,2,4,0,2,0,0,2,33,0,44860,18164,3460,24727,0
163,5080,1660,832,1314,41,38,274,1701,20,312,209,395,332,604,2671,5058,12,64042,3557,1,2,0,4,44860,18166,3461,24729,0
163,5080,1057,646,719,113,100,145,1170,18,215,134,248,233,382,1740,3004,10,31186,1732,1,2,0,4,44870,18167,3462,24730,0
60,1673,1455,414,1257,16,76,112,1471,5,41,23,46,46,69,231,381,2,1069,59,0,2,4,5,44870,18168,3462,24731,0
60,1673,669,365,481,22,61,110,691,15,103,63,122,118,185,747,1273,8,11311,628,0,2,4,5,44880,18168,3463,24732,0
64,2957,1455,414,1257,16,76,112,1471,5,41,23,46,46,69,231,381,2,1069,59,0,2,19,0,44880,18169,3463,24733,0
178,4125,77,34,69,0,0,8,77,3,24,16,29,27,45,114,213,1,387,21,0,2,5,1,44880,18169,3463,24734,0
178,4125,712,438,573,51,9,84,763,14,102,71,128,116,199,733,1364,8,11988,666,0,2,5,1,44890,18170,3463,24735,0
192,3902,1943,715,1694,26,18,214,1969,12,185,120,237,197,357,1436,2721,7,20915,1161,0,2,1,1,44890,18172,3463,24736,0
192,3902,1168,838,957,57,25,144,1225,19,348,224,416,367,640,3018,5452,11,61921,3440,1,2,1,1,44900,18174,3463,24737,0
80,3427,1289,550,1043,56,32,155,1345,10,167,93,185,177,278,1266,2075,5,11498,638,0,2,2,2,44900,18176,3464,24738,0
66,3414,1296,573,1062,40,33,157,1336,8,201,118,231,209,349,1561,2689,4,12365,686,0,2,14,5,44900,18176,3464,24739,0
69,2856,1043,504,840,53,9,147,1096,9,180,112,198,189,310,1377,2344,4,11604,644,0,2,2,2,44900,18178,3464,24740,0
74,3770,1943,715,1694,26,18,214,1969,12,185,120,237,197,357,1436,2721,7,20915,1161,0,2,9,0,44900,18180,3464,24741,0
54,1166,207,111,150,11,0,50,218,5,26,19,36,31,55,133,272,3,943,52,0,2,2,1,44900,18180,3464,24742,1
54,1166,410,198,237,31,55,97,441,11,63,38,72,74,110,414,683,6,4293,238,0,2,2,1,44910,18181,3465,24743,1
74,1464,757,253,292,73,244,162,830,13,61,38,67,74,105,409,651,7,4654,258,0,2,149,121,44910,18182,3465,24744,1
53,3332,520,294,400,33,13,81,553,10,261,204,367,271,571,2128,4614,7,32445,1802,1,2,23,31,44910,18183,3465,24745,1
74,1464,757,253,292,73,244,162,830,13,61,38,67,74,105,409,651,7,4654,258,0,2,2,1,44910,18184,3465,24746,1
53,3320,520,294,400,33,13,81,553,10,261,204,367,271,571,2128,4614,7,32445,1802,1,2,1,2,44910,18185,3465,24747,1
74,1467,757,253,292,73,244,162,830,13,61,38,67,74,105,409,651,7,4654,258,0,2,3,3,44910,18186,3465,24748,1
74,1473,757,253,292,73,244,162,830,13,61,38,67,74,105,409,651,7,4654,258,0,2,1,1,44910,18187,3465,24749,0
90,1694,1020,354,843,12,15,144,1032,8,134,77,144,142,221,970,1580,4,6792,377,0,2,29,0,44910,18187,3465,24750,1
276,6071,72,33,56,0,4,12,72,1,1,1,1,2,2,0,2,0,1,0,0,2,1,30,44910,18187,3465,24751,1
276,6071,1454,835,1044,76,110,219,1530,17,275,158,296,292,454,2297,3718,9,34017,1889,1,2,1,30,44920,18188,3465,24752,1
90,1746,1020,354,843,12,15,144,1032,8,134,77,144,142,221,970,1580,4,6792,377,0,2,40,30,44920,18188,3465,24753,1
90,1754,1020,354,843,12,15,144,1032,8,134,77,144,142,221,970,1580,4,6792,377,0,2,1,0,44920,18188,3465,24754,1
70,3035,1020,354,843,12,15,144,1032,8,134,77,144,142,221,970,1580,4,6792,377,0,2,23,1,44920,18188,3465,24755,1
213,4595,182,127,129,0,0,53,182,5,39,21,42,44,63,217,343,2,926,51,0,2,5,2,44920,18188,3466,24756,0
213,4595,1165,710,800,67,119,181,1232,18,243,153,282,261,435,2000,3492,10,36473,2026,1,2,5,2,44930,18188,3467,24757,0
147,6814,1392,870,1177,35,17,170,1427,14,494,280,531,508,811,4473,7289,7,54850,3047,2,2,23,0,44930,18191,3468,24758,0
40,837,386,256,301,16,9,68,402,4,59,35,69,63,104,355,621,2,1453,80,0,2,2,1,44930,18191,3468,24759,0
40,837,264,131,164,11,41,46,275,6,38,22,40,44,62,214,338,3,1068,59,0,2,2,1,44940,18191,3469,24760,0
92,1807,1020,354,843,12,15,144,1032,8,134,77,144,142,221,970,1580,4,6792,377,0,2,12,6,44940,18191,3469,24762,1
40,837,386,256,301,16,9,68,402,4,59,35,69,63,104,355,621,2,1453,80,0,2,36,29,44940,18191,3469,24763,0
40,837,264,131,164,11,41,46,275,6,38,22,40,44,62,214,338,3,1068,59,0,2,36,29,44950,18191,3470,24764,0
38,1637,386,256,301,16,9,68,402,4,59,35,69,63,104,355,621,2,1453,80,0,2,48,10,44950,18191,3470,24765,0
93,1798,1020,354,843,12,15,144,1032,8,134,77,144,142,221,970,1580,4,6792,377,0,2,31,23,44950,18191,3470,24767,1
276,6071,72,33,56,0,4,12,72,1,1,1,1,2,2,0,2,0,1,0,0,2,1,0,44950,18191,3470,24768,0
276,6071,1454,835,1044,76,110,219,1530,17,275,158,296,292,454,2297,3718,9,34017,1889,1,2,1,0,44960,18192,3470,24769,0
93,1798,1020,354,843,12,15,144,1032,8,134,77,144,142,221,970,1580,4,6792,377,0,2,75,21,44960,18192,3470,24771,0
276,6071,72,33,56,0,4,12,72,1,1,1,1,2,2,0,2,0,1,0,0,2,1,29,44960,18192,3470,24772,0
276,6071,1454,835,1044,76,110,219,1530,17,275,158,296,292,454,2297,3718,9,34017,1889,1,2,1,29,44970,18193,3470,24773,0
70,3035,1020,354,843,12,15,144,1032,8,134,77,144,142,221,970,1580,4,6792,377,0,2,23,1,44970,18193,3470,24774,0
94,1809,1020,354,843,12,15,144,1032,8,134,77,144,142,221,970,1580,4,6792,377,0,2,4,1,44990,18201,3472,24790,1
94,1809,1020,354,843,12,15,144,1032,8,134,77,144,142,221,970,1580,4,6792,377,0,2,4,1,44990,18201,3472,24792,0
213,4595,182,127,129,0,0,53,182,5,39,21,42,44,63,217,343,2,926,51,0,2,5,2,44990,18201,3473,24793,0
213,4595,1165,710,800,67,119,181,1232,18,243,153,282,261,435,2000,3492,10,36473,2026,1,2,5,2,45000,18201,3474,24794,0
163,5080,1660,832,1314,41,38,274,1701,20,312,209,395,332,604,2671,5058,12,64042,3557,1,2,0,4,45000,18203,3475,24796,0
163,5080,1057,646,719,113,100,145,1170,18,215,134,248,233,382,1740,3004,10,31186,1732,1,2,0,4,45010,18204,3476,24797,0
60,1673,1455,414,1257,16,76,112,1471,5,41,23,46,46,69,231,381,2,1069,59,0,2,4,5,45010,18205,3476,24798,0
60,1673,669,365,481,22,61,110,691,15,103,63,122,118,185,747,1273,8,11311,628,0,2,4,5,45020,18205,3477,24799,0
227,5129,4293,999,3693,19,54,507,4312,9,155,88,170,164,258,1156,1898,4,9368,520,0,2,11,2,45020,18207,3477,24800,0
227,5129,1482,859,1002,125,135,219,1607,16,219,134,251,235,385,1766,3032,9,27804,1544,1,2,11,2,45030,18208,3477,24801,0
49,575,647,139,84,35,284,233,682,0,0,0,0,0,0,0,0,0,0,0,0,2,44,15,45030,18208,3477,24802,0
178,4125,77,34,69,0,0,8,77,3,24,16,29,27,45,114,213,1,387,21,0,2,5,1,45030,18208,3477,24803,0
178,4125,712,438,573,51,9,84,763,14,102,71,128,116,199,733,1364,8,11988,666,0,2,5,1,45040,18209,3477,24804,0
40,837,386,256,301,16,9,68,402,4,59,35,69,63,104,355,621,2,1453,80,0,2,36,29,45040,18209,3477,24805,0
40,837,264,131,164,11,41,46,275,6,38,22,40,44,62,214,338,3,1068,59,0,2,36,29,45050,18209,3478,24806,0
192,3902,1943,715,1694,26,18,214,1969,12,185,120,237,197,357,1436,2721,7,20915,1161,0,2,1,1,45050,18211,3478,24807,0
192,3902,1168,838,957,57,25,144,1225,19,348,224,416,367,640,3018,5452,11,61921,3440,1,2,1,1,45060,18213,3478,24808,0
80,3427,1289,550,1043,56,32,155,1345,10,167,93,185,177,278,1266,2075,5,11498,638,0,2,2,2,45070,18219,3480,24816,0
147,6814,1392,870,1177,35,17,170,1427,14,494,280,531,508,811,4473,7289,7,54850,3047,2,2,23,0,45070,18222,3481,24817,0
148,6832,139,89,101,2,0,35,141,7,54,34,62,61,96,330,569,4,2287,127,0,2,33,0,45070,18222,3481,24818,0
148,6832,7,5,5,0,0,2,7,1,2,1,2,3,3,2,4,0,2,0,0,2,33,0,45070,18222,3481,24819,0
66,3414,1296,573,1062,40,33,157,1336,8,201,118,231,209,349,1561,2689,4,12365,686,0,2,14,5,45070,18222,3481,24820,0
64,2957,1455,414,1257,16,76,112,1471,5,41,23,46,46,69,231,381,2,1069,59,0,2,19,0,45070,18223,3481,24821,0
38,1637,386,256,301,16,9,68,402,4,59,35,69,63,104,355,621,2,1453,80,0,2,48,10,45070,18223,3481,24822,0
69,2856,1043,504,840,53,9,147,1096,9,180,112,198,189,310,1377,2344,4,11604,644,0,2,2,2,45070,18225,3481,24823,0
74,3770,1943,715,1694,26,18,214,1969,12,185,120,237,197,357,1436,2721,7,20915,1161,0,2,9,0,45070,18227,3481,24824,0
178,4127,77,34,69,0,0,8,77,3,24,16,29,27,45,114,213,1,387,21,0,2,2,3,45070,18227,3481,24825,0
178,4127,712,438,573,51,9,84,763,14,102,71,128,116,199,733,1364,8,11988,666,0,2,2,3,45080,18228,3481,24826,0
213,4595,182,127,129,0,0,53,182,5,39,21,42,44,63,217,343,2,926,51,0,2,5,2,45080,18228,3482,24827,0
213,4595,1165,710,800,67,119,181,1232,18,243,153,282,261,435,2000,3492,10,36473,2026,1,2,5,2,45090,18228,3483,24828,0
163,5080,1660,832,1314,41,38,274,1701,20,312,209,395,332,604,2671,5058,12,64042,3557,1,2,0,4,45090,18230,3484,24830,0
163,5080,1057,646,719,113,100,145,1170,18,215,134,248,233,382,1740,3004,10,31186,1732,1,2,0,4,45100,18231,3485,24831,0
60,1673,1455,414,1257,16,76,112,1471,5,41,23,46,46,69,231,381,2,1069,59,0,2,4,5,45100,18232,3485,24832,0
60,1673,669,365,481,22,61,110,691,15,103,63,122,118,185,747,1273,8,11311,628,0,2,4,5,45110,18232,3486,24833,0
227,5129,4293,999,3693,19,54,507,4312,9,155,88,170,164,258,1156,1898,4,9368,520,0,2,11,2,45110,18234,3486,24834,0
227,5129,1482,859,1002,125,135,219,1607,16,219,134,251,235,385,1766,3032,9,27804,1544,1,2,11,2,45120,18235,3486,24835,0
49,575,647,139,84,35,284,233,682,0,0,0,0,0,0,0,0,0,0,0,0,2,44,15,45120,18235,3486,24836,0
178,4125,77,34,69,0,0,8,77,3,24,16,29,27,45,114,213,1,387,21,0,2,5,1,45120,18235,3486,24837,0
178,4125,712,438,573,51,9,84,763,14,102,71,128,116,199,733,1364,8,11988,666,0,2,5,1,45130,18236,3486,24838,0
40,837,386,256,301,16,9,68,402,4,59,35,69,63,104,355,621,2,1453,80,0,2,36,29,45130,18236,3486,24839,0
40,837,264,131,164,11,41,46,275,6,38,22,40,44,62,214,338,3,1068,59,0,2,36,29,45140,18236,3487,24840,0
192,3902,1943,715,1694,26,18,214,1969,12,185,120,237,197,357,1436,2721,7,20915,1161,0,2,1,1,45140,18238,3487,24841,0
192,3902,1168,838,957,57,25,144,1225,19,348,224,416,367,640,3018,5452,11,61921,3440,1,2,1,1,45150,18240,3487,24842,0
80,3427,1289,550,1043,56,32,155,1345,10,167,93,185,177,278,1266,2075,5,11498,638,0,2,2,2,45160,18246,3489,24850,0
147,6814,1392,870,1177,35,17,170,1427,14,494,280,531,508,811,4473,7289,7,54850,3047,2,2,23,0,45160,18249,3490,24851,0
148,6832,139,89,101,2,0,35,141,7,54,34,62,61,96,330,569,4,2287,127,0,2,33,0,45160,18249,3490,24852,0
148,6832,7,5,5,0,0,2,7,1,2,1,2,3,3,2,4,0,2,0,0,2,33,0,45160,18249,3490,24853,0
66,3414,1296,573,1062,40,33,157,1336,8,201,118,231,209,349,1561,2689,4,12365,686,0,2,14,5,45160,18249,3490,24854,0
64,2957,1455,414,1257,16,76,112,1471,5,41,23,46,46,69,231,381,2,1069,59,0,2,19,0,45160,18250,3490,24855,0
38,1637,386,256,301,16,9,68,402,4,59,35,69,63,104,355,621,2,1453,80,0,2,48,10,45160,18250,3490,24856,0
69,2856,1043,504,840,53,9,147,1096,9,180,112,198,189,310,1377,2344,4,11604,644,0,2,2,2,45160,18252,3490,24857,0
74,3770,1943,715,1694,26,18,214,1969,12,185,120,237,197,357,1436,2721,7,20915,1161,0,2,9,0,45160,18254,3490,24858,0
278,6113,72,33,56,0,4,12,72,1,1,1,1,2,2,0,2,0,1,0,0,2,13,4,45160,18254,3490,24859,1
278,6113,1454,835,1044,76,110,219,1530,17,275,158,296,292,454,2297,3718,9,34017,1889,1,2,13,4,45170,18255,3490,24860,1
98,4425,1338,495,1086,10,64,173,1348,11,122,82,157,133,239,883,1686,7,11934,663,0,2,20,0,45170,18257,3490,24861,1
278,6113,72,33,56,0,4,12,72,1,1,1,1,2,2,0,2,0,1,0,0,2,13,4,45170,18257,3490,24862,0
278,6113,1454,835,1044,76,110,219,1530,17,275,158,296,292,454,2297,3718,9,34017,1889,1,2,13,4,45180,18258,3490,24863,0
98,4425,1338,495,1086,10,64,173,1348,11,122,82,157,133,239,883,1686,7,11934,663,0,2,20,0,45180,18260,3490,24864,0
178,4129,77,34,69,0,0,8,77,3,24,16,29,27,45,114,213,1,387,21,0,2,2,3,45180,18260,3490,24865,0
178,4129,712,438,573,51,9,84,763,14,102,71,128,116,199,733,1364,8,11988,666,0,2,2,3,45190,18261,3490,24866,0
74,1479,757,253,292,73,244,162,830,13,61,38,67,74,105,409,651,7,4654,258,0,2,3,3,45190,18262,3490,24867,1
53,3320,520,294,400,33,13,81,553,10,261,204,367,271,571,2128,4614,7,32445,1802,1,2,4,4,45190,18263,3490,24868,1
76,1520,757,253,292,73,244,162,830,13,61,38,67,74,105,409,651,7,4654,258,0,2,16,9,45190,18264,3490,24869,0
178,4129,77,34,69,0,0,8,77,3,24,16,29,27,45,114,213,1,387,21,0,2,2,3,45190,18264,3490,24870,0
178,4129,712,438,573,51,9,84,763,14,102,71,128,116,199,733,1364,8,11988,666,0,2,2,3,45200,18265,3490,24871,0
76,1520,757,253,292,73,244,162,830,13,61,38,67,74,105,409,651,7,4654,258,0,2,1,1,45200,18266,3490,24872,0
178,4129,77,34,69,0,0,8,77,3,24,16,29,27,45,114,213,1,387,21,0,2,1,1,45200,18266,3490,24873,1
178,4129,712,438,573,51,9,84,763,14,102,71,128,116,199,733,1364,8,11988,666,0,2,1,1,45210,18267,3490,24874,1
71,3006,1178,367,1042,6,15,115,1184,9,94,51,95,103,146,644,976,4,4439,246,0,2,1,1,45210,18267,3490,24875,1
178,4129,77,34,69,0,0,8,77,3,24,16,29,27,45,114,213,1,387,21,0,2,1,1,45210,18267,3490,24876,0
178,4129,712,438,573,51,9,84,763,14,102,71,128,116,199,733,1364,8,11988,666,0,2,1,1,45220,18268,3490,24877,0
71,3006,1178,367,1042,6,15,115,1184,9,94,51,95,103,146,644,976,4,4439,246,0,2,1,1,45220,18268,3490,24878,0
49,575,647,139,84,35,284,233,682,0,0,0,0,0,0,0,0,0,0,0,0,2,11,3,45220,18268,3490,24879,0
49,575,647,139,84,35,284,233,682,0,0,0,0,0,0,0,0,0,0,0,0,2,11,3,45220,18268,3490,24880,0
54,1166,207,111,150,11,0,50,218,5,26,19,36,31,55,133,272,3,943,52,0,2,2,1,45220,18268,3490,24881,0
54,1166,410,198,237,31,55,97,441,11,63,38,72,74,110,414,683,6,4293,238,0,2,2,1,45230,18269,3491,24882,0
76,1520,757,253,292,73,244,162,830,13,61,38,67,74,105,409,651,7,4654,258,0,2,328,134,45230,18270,3491,24883,0
53,3320,520,294,400,33,13,81,553,10,261,204,367,271,571,2128,4614,7,32445,1802,1,2,109,39,45230,18271,3491,24884,0
62,1345,996,429,845,24,10,117,1020,7,76,50,88,83,138,494,879,4,3565,198,0,2,15,1,45230,18273,3491,24885,0
62,1345,456,277,329,12,42,72,468,13,85,50,97,98,147,592,972,7,7212,400,0,2,15,1,45230,18273,3491,24886,0
54,1161,207,111,150,11,0,50,218,5,26,19,36,31,55,133,272,3,943,52,0,2,2,2,45230,18273,3491,24887,1
54,1161,410,198,237,31,55,97,441,11,63,38,72,74,110,414,683,6,4293,238,0,2,2,2,45240,18274,3492,24888,1
336,7168,72,33,56,0,4,12,72,1,1,1,1,2,2,0,2,0,1,0,0,2,5,5,45240,18274,3492,24889,1
336,7168,1454,835,1044,76,110,219,1530,17,275,158,296,292,454,2297,3718,9,34017,1889,1,2,5,5,45250,18275,3492,24890,1
336,7160,72,33,56,0,4,12,72,1,1,1,1,2,2,0,2,0,1,0,0,2,1,1,45250,18275,3492,24891,1
336,7160,1454,835,1044,76,110,219,1530,17,275,158,296,292,454,2297,3718,9,34017,1889,1,2,1,1,45260,18276,3492,24892,1
7,278,75,38,59,1,3,12,76,2,4,2,4,6,6,10,15,1,15,0,0,2,4,0,45260,18276,3492,24893,1
62,1345,996,429,845,24,10,117,1020,7,76,50,88,83,138,494,879,4,3565,198,0,2,15,1,45260,18278,3492,24894,0
62,1345,456,277,329,12,42,72,468,13,85,50,97,98,147,592,972,7,7212,400,0,2,15,1,45260,18278,3492,24895,0
54,1161,207,111,150,11,0,50,218,5,26,19,36,31,55,133,272,3,943,52,0,2,2,2,45260,18278,3492,24896,0
54,1161,410,198,237,31,55,97,441,11,63,38,72,74,110,414,683,6,4293,238,0,2,2,2,45270,18279,3493,24897,0
336,7168,72,33,56,0,4,12,72,1,1,1,1,2,2,0,2,0,1,0,0,2,5,5,45270,18279,3493,24898,0
336,7168,1454,835,1044,76,110,219,1530,17,275,158,296,292,454,2297,3718,9,34017,1889,1,2,5,5,45280,18280,3493,24899,0
54,1166,207,111,150,11,0,50,218,5,26,19,36,31,55,133,272,3,943,52,0,2,2,2,45280,18280,3493,24900,0
54,1166,410,198,237,31,55,97,441,11,63,38,72,74,110,414,683,6,4293,238,0,2,2,2,45290,18281,3494,24901,0
49,575,647,139,84,35,284,233,682,0,0,0,0,0,0,0,0,0,0,0,0,2,11,3,45290,18281,3494,24902,0
178,4129,77,34,69,0,0,8,77,3,24,16,29,27,45,114,213,1,387,21,0,2,1,1,45290,18281,3494,24903,0
178,4129,712,438,573,51,9,84,763,14,102,71,128,116,199,733,1364,8,11988,666,0,2,1,1,45300,18282,3494,24904,0
278,6113,72,33,56,0,4,12,72,1,1,1,1,2,2,0,2,0,1,0,0,2,5,5,45300,18282,3494,24905,0
278,6113,1454,835,1044,76,110,219,1530,17,275,158,296,292,454,2297,3718,9,34017,1889,1,2,5,5,45310,18283,3494,24906,0
71,3006,1178,367,1042,6,15,115,1184,9,94,51,95,103,146,644,976,4,4439,246,0,2,1,1,45310,18283,3494,24907,0
180,4191,77,34,69,0,0,8,77,3,24,16,29,27,45,114,213,1,387,21,0,2,12,0,45310,18283,3494,24908,1
180,4191,712,438,573,51,9,84,763,14,102,71,128,116,199,733,1364,8,11988,666,0,2,12,0,45320,18284,3494,24909,1
180,4191,77,34,69,0,0,8,77,3,24,16,29,27,45,114,213,1,387,21,0,2,1,1,45320,18284,3494,24910,1
180,4191,712,438,573,51,9,84,763,14,102,71,128,116,199,733,1364,8,11988,666,0,2,1,1,45330,18285,3494,24911,1
184,4250,77,34,69,0,0,8,77,3,24,16,29,27,45,114,213,1,387,21,0,2,14,4,45330,18285,3494,24912,0
184,4250,712,438,573,51,9,84,763,14,102,71,128,116,199,733,1364,8,11988,666,0,2,14,4,45340,18286,3494,24913,0
178,4130,77,34,69,0,0,8,77,3,24,16,29,27,45,114,213,1,387,21,0,2,15,0,45340,18286,3494,24914,0
178,4130,712,438,573,51,9,84,763,14,102,71,128,116,199,733,1364,8,11988,666,0,2,15,0,45350,18287,3494,24915,0
184,4240,77,34,69,0,0,8,77,3,24,16,29,27,45,114,213,1,387,21,0,2,2,6,45350,18287,3494,24916,1
184,4240,712,438,573,51,9,84,763,14,102,71,128,116,199,733,1364,8,11988,666,0,2,2,6,45360,18288,3494,24917,1
72,3755,1296,573,1062,40,33,157,1336,8,201,118,231,209,349,1561,2689,4,12365,686,0,2,48,1,45360,18288,3494,24918,1
184,4240,77,34,69,0,0,8,77,3,24,16,29,27,45,114,213,1,387,21,0,2,18,0,45360,18288,3494,24919,0
184,4240,712,438,573,51,9,84,763,14,102,71,128,116,199,733,1364,8,11988,666,0,2,18,0,45370,18289,3494,24920,0
72,3755,1296,573,1062,40,33,157,1336,8,201,118,231,209,349,1561,2689,4,12365,686,0,2,48,1,45370,18289,3494,24921,0
336,7160,72,33,56,0,4,12,72,1,1,1,1,2,2,0,2,0,1,0,0,2,1,1,45370,18289,3494,24922,0
336,7160,1454,835,1044,76,110,219,1530,17,275,158,296,292,454,2297,3718,9,34017,1889,1,2,1,1,45380,18290,3494,24923,0
7,278,75,38,59,1,3,12,76,2,4,2,4,6,6,10,15,1,15,0,0,2,4,0,45380,18290,3494,24924,0
178,4130,77,34,69,0,0,8,77,3,24,16,29,27,45,114,213,1,387,21,0,2,15,0,45380,18290,3494,24925,0
178,4130,712,438,573,51,9,84,763,14,102,71,128,116,199,733,1364,8,11988,666,0,2,15,0,45390,18291,3494,24926,0
192,3908,1943,715,1694,26,18,214,1969,12,185,120,237,197,357,1436,2721,7,20915,1161,0,2,3,0,45390,18293,3494,24927,0
192,3908,1168,838,957,57,25,144,1225,19,348,224,416,367,640,3018,5452,11,61921,3440,1,2,3,0,45400,18295,3494,24928,0
192,3908,1943,715,1694,26,18,214,1969,12,185,120,237,197,357,1436,2721,7,20915,1161,0,2,3,0,45400,18297,3494,24929,0
192,3908,1168,838,957,57,25,144,1225,19,348,224,416,367,640,3018,5452,11,61921,3440,1,2,3,0,45410,18299,3494,24930,0
339,7202,72,33,56,0,4,12,72,1,1,1,1,2,2,0,2,0,1,0,0,2,20,6,45410,18299,3494,24931,1
339,7202,1454,835,1044,76,110,219,1530,17,275,158,296,292,454,2297,3718,9,34017,1889,1,2,20,6,45420,18300,3494,24932,1
151,6958,139,89,101,2,0,35,141,7,54,34,62,61,96,330,569,4,2287,127,0,2,61,4,45420,18300,3494,24933,1
151,6958,7,5,5,0,0,2,7,1,2,1,2,3,3,2,4,0,2,0,0,2,61,4,45420,18300,3494,24934,1
55,1182,207,111,150,11,0,50,218,5,26,19,36,31,55,133,272,3,943,52,0,2,10,1,45420,18300,3494,24935,1
55,1182,410,198,237,31,55,97,441,11,63,38,72,74,110,414,683,6,4293,238,0,2,10,1,45430,18301,3495,24936,1
118,4686,1513,682,1277,25,13,200,1538,11,199,116,219,210,335,1557,2584,6,15641,868,0,2,9,0,45430,18303,3495,24937,1
213,4595,182,127,129,0,0,53,182,5,39,21,42,44,63,217,343,2,926,51,0,2,1,1,45430,18303,3496,24938,1
213,4595,1165,710,800,67,119,181,1232,18,243,153,282,261,435,2000,3492,10,36473,2026,1,2,1,1,45440,18303,3497,24939,1
99,2081,773,419,590,28,0,166,801,10,204,113,217,214,330,1598,2554,5,13587,754,0,2,0,2,45440,18303,3498,24940,1
99,2081,421,273,302,44,34,57,465,17,81,59,107,98,166,583,1098,11,12329,684,0,2,0,2,45440,18303,3499,24941,1
227,5129,4293,999,3693,19,54,507,4312,9,155,88,170,164,258,1156,1898,4,9368,520,0,2,0,1,45440,18305,3499,24942,1
227,5129,1482,859,1002,125,135,219,1607,16,219,134,251,235,385,1766,3032,9,27804,1544,1,2,0,1,45450,18306,3499,24943,1
91,3010,773,419,590,28,0,166,801,10,204,113,217,214,330,1598,2554,5,13587,754,0,2,4,1,45450,18306,3500,24944,1
2,26,6,4,4,0,0,2,6,1,4,2,4,5,6,8,13,0,6,0,0,2,1,1,45450,18306,3500,24946,1
47,2498,520,294,400,33,13,81,553,10,261,204,367,271,571,2128,4614,7,32445,1802,1,2,0,1,45450,18307,3500,24948,1
148,6832,139,89,101,2,0,35,141,7,54,34,62,61,96,330,569,4,2287,127,0,2,0,3,45450,18307,3500,24949,1
148,6832,7,5,5,0,0,2,7,1,2,1,2,3,3,2,4,0,2,0,0,2,0,3,45450,18307,3500,24950,1
78,4093,1457,730,1242,11,6,188,1468,10,292,166,329,302,495,2424,4078,5,22973,1276,1,2,0,1,45450,18309,3500,24951,1
64,2957,1455,414,1257,16,76,112,1471,5,41,23,46,46,69,231,381,2,1069,59,0,2,0,1,45450,18310,3500,24952,1
90,4427,1523,757,1297,19,12,193,1542,12,193,117,230,205,347,1508,2664,7,19053,1058,0,2,0,1,45460,18312,3500,24953,1
12,492,184,100,137,2,15,30,186,6,38,20,39,44,59,214,322,3,991,55,0,2,0,2,45460,18313,3500,24954,1
16,1209,215,129,180,6,0,29,221,8,65,43,72,73,115,415,711,4,3153,175,0,2,0,2,45460,18313,3500,24955,1
69,2856,1043,504,840,53,9,147,1096,9,180,112,198,189,310,1377,2344,4,11604,644,0,2,0,2,45460,18315,3500,24956,1
60,1673,1455,414,1257,16,76,112,1471,5,41,23,46,46,69,231,381,2,1069,59,0,2,1,1,45460,18316,3500,24957,0
60,1673,669,365,481,22,61,110,691,15,103,63,122,118,185,747,1273,8,11311,628,0,2,1,1,45470,18316,3501,24958,0
223,5047,722,423,573,19,0,135,741,12,172,101,199,184,300,1320,2257,6,15668,870,0,2,5,5,45470,18318,3501,24960,0
223,5047,1508,847,911,44,250,301,1552,14,148,88,169,162,257,1120,1886,7,15077,837,0,2,5,5,45470,18319,3502,24961,0
336,7160,72,33,56,0,4,12,72,1,1,1,1,2,2,0,2,0,1,0,0,2,1,1,45470,18319,3502,24962,0
336,7160,1454,835,1044,76,110,219,1530,17,275,158,296,292,454,2297,3718,9,34017,1889,1,2,1,1,45480,18320,3502,24963,0
39,2355,652,304,544,16,6,88,668,6,89,51,101,95,152,591,998,3,3399,188,0,2,4,4,45480,18321,3502,24964,0
64,2957,1455,414,1257,16,76,112,1471,5,41,23,46,46,69,231,381,2,1069,59,0,2,1,1,45480,18322,3502,24965,0
37,1624,447,308,343,6,5,95,453,7,96,59,111,103,170,651,1136,4,4600,255,0,2,1,1,45480,18325,3502,24966,0
48,1784,1098,241,925,5,10,155,1103,7,46,25,49,53,74,273,423,3,1580,87,0,2,1,1,45490,18327,3502,24967,0
12,476,601,196,481,2,23,85,603,8,63,36,72,71,108,400,664,4,3036,168,0,2,2,2,45490,18327,3502,24968,0
227,5129,4293,999,3693,19,54,507,4312,9,155,88,170,164,258,1156,1898,4,9368,520,0,2,1,1,45490,18329,3502,24969,0
227,5129,1482,859,1002,125,135,219,1607,16,219,134,251,235,385,1766,3032,9,27804,1544,1,2,1,1,45500,18330,3502,24970,0
40,837,386,256,301,16,9,68,402,4,59,35,69,63,104,355,621,2,1453,80,0,2,1,1,45500,18330,3502,24971,0
40,837,264,131,164,11,41,46,275,6,38,22,40,44,62,214,338,3,1068,59,0,2,1,1,45510,18330,3503,24972,0
127,2807,1043,504,840,53,9,147,1096,9,180,112,198,189,310,1377,2344,4,11604,644,0,2,1,1,45510,18332,3503,24973,0
127,2807,383,288,292,26,6,62,409,11,65,38,67,76,105,429,656,5,3719,206,0,2,1,1,45510,18333,3503,24974,0
47,2498,520,294,400,33,13,81,553,10,261,204,367,271,571,2128,4614,7,32445,1802,1,2,9,9,45510,18334,3503,24975,0
148,6832,139,89,101,2,0,35,141,7,54,34,62,61,96,330,569,4,2287,127,0,2,6,8,45510,18334,3503,24976,0
148,6832,7,5,5,0,0,2,7,1,2,1,2,3,3,2,4,0,2,0,0,2,6,8,45510,18334,3503,24977,0
74,3770,1943,715,1694,26,18,214,1969,12,185,120,237,197,357,1436,2721,7,20915,1161,0,2,3,3,45510,18336,3503,24978,0
349,7049,1457,730,1242,11,6,188,1468,10,292,166,329,302,495,2424,4078,5,22973,1276,1,2,2,2,45510,18338,3503,24979,0
349,7049,74,35,59,1,0,14,75,3,14,7,14,17,21,58,85,1,128,7,0,2,2,2,45510,18339,3503,24980,0
349,7049,245,125,200,5,7,34,250,7,30,17,34,37,51,166,265,3,1053,58,0,2,2,2,45520,18340,3503,24981,0
27,954,74,35,59,1,0,14,75,3,14,7,14,17,21,58,85,1,128,7,0,2,3,3,45520,18341,3503,24982,0
27,954,245,125,200,5,7,34,250,7,30,17,34,37,51,166,265,3,1053,58,0,2,3,3,45530,18342,3503,24983,0
148,6832,139,89,101,2,0,35,141,7,54,34,62,61,96,330,569,4,2287,127,0,2,1,1,45530,18342,3503,24984,0
148,6832,7,5,5,0,0,2,7,1,2,1,2,3,3,2,4,0,2,0,0,2,1,1,45530,18342,3503,24985,0
150,4203,1660,832,1314,41,38,274,1701,20,312,209,395,332,604,2671,5058,12,64042,3557,1,2,1,1,45530,18344,3504,24987,0
74,3770,1943,715,1694,26,18,214,1969,12,185,120,237,197,357,1436,2721,7,20915,1161,0,2,2,2,45530,18346,3504,24988,0
148,6832,139,89,101,2,0,35,141,7,54,34,62,61,96,330,569,4,2287,127,0,2,1,1,45530,18346,3504,24989,0
148,6832,7,5,5,0,0,2,7,1,2,1,2,3,3,2,4,0,2,0,0,2,1,1,45530,18346,3504,24990,0
69,2856,1043,504,840,53,9,147,1096,9,180,112,198,189,310,1377,2344,4,11604,644,0,2,5,5,45530,18348,3504,24991,0
74,3770,1943,715,1694,26,18,214,1969,12,185,120,237,197,357,1436,2721,7,20915,1161,0,2,5,5,45530,18350,3504,24992,0
336,7160,72,33,56,0,4,12,72,1,1,1,1,2,2,0,2,0,1,0,0,2,2,2,45530,18350,3504,24993,0
336,7160,1454,835,1044,76,110,219,1530,17,275,158,296,292,454,2297,3718,9,34017,1889,1,2,2,2,45540,18351,3504,24994,0
103,1953,1178,367,1042,6,15,115,1184,9,94,51,95,103,146,644,976,4,4439,246,0,2,3,3,45540,18351,3504,24995,0
103,1953,177,108,140,8,0,27,185,6,30,16,32,36,48,162,248,3,794,44,0,2,3,3,45540,18353,3504,24996,0
80,3427,1289,550,1043,56,32,155,1345,10,167,93,185,177,278,1266,2075,5,11498,638,0,2,1,1,45540,18355,3505,24997,0
147,6814,1392,870,1177,35,17,170,1427,14,494,280,531,508,811,4473,7289,7,54850,3047,2,2,1,1,45540,18358,3506,24998,0
112,5710,1782,648,1425,9,47,279,1791,8,171,97,189,179,286,1292,2140,4,9462,525,0,2,3,3,45540,18359,3507,24999,0
150,4203,1660,832,1314,41,38,274,1701,20,312,209,395,332,604,2671,5058,12,64042,3557,1,2,1,1,45540,18361,3508,25001,0
74,3770,1943,715,1694,26,18,214,1969,12,185,120,237,197,357,1436,2721,7,20915,1161,0,2,1,1,45540,18363,3508,25002,0
213,4595,182,127,129,0,0,53,182,5,39,21,42,44,63,217,343,2,926,51,0,2,2,2,45540,18363,3509,25003,1
213,4595,1165,710,800,67,119,181,1232,18,243,153,282,261,435,2000,3492,10,36473,2026,1,2,2,2,45550,18363,3510,25004,1
227,5129,4293,999,3693,19,54,507,4312,9,155,88,170,164,258,1156,1898,4,9368,520,0,2,1,1,45550,18365,3510,25005,1
227,5129,1482,859,1002,125,135,219,1607,16,219,134,251,235,385,1766,3032,9,27804,1544,1,2,1,1,45560,18366,3510,25006,1
212,5047,722,423,573,19,0,135,741,12,172,101,199,184,300,1320,2257,6,15668,870,0,2,2,2,45560,18368,3510,25008,1
212,5047,1508,847,911,44,250,301,1552,14,148,88,169,162,257,1120,1886,7,15077,837,0,2,2,2,45560,18369,3511,25009,1
310,7160,72,33,56,0,4,12,72,1,1,1,1,2,2,0,2,0,1,0,0,2,1,1,45560,18369,3511,25010,1
310,7160,1454,835,1044,76,110,219,1530,17,275,158,296,292,454,2297,3718,9,34017,1889,1,2,1,1,45570,18370,3511,25011,1
103,1953,1178,367,1042,6,15,115,1184,9,94,51,95,103,146,644,976,4,4439,246,0,2,1,1,45570,18370,3511,25012,1
103,1953,177,108,140,8,0,27,185,6,30,16,32,36,48,162,248,3,794,44,0,2,1,1,45570,18372,3511,25013,1
62,1240,1098,241,925,5,10,155,1103,7,46,25,49,53,74,273,423,3,1580,87,0,2,1,1,45580,18374,3511,25014,1
62,1240,282,202,222,14,2,44,296,8,42,24,43,50,67,250,378,4,1548,86,0,2,1,1,45580,18375,3511,25015,1
349,7049,1457,730,1242,11,6,188,1468,10,292,166,329,302,495,2424,4078,5,22973,1276,1,2,6,6,45580,18377,3511,25016,1
349,7049,74,35,59,1,0,14,75,3,14,7,14,17,21,58,85,1,128,7,0,2,6,6,45580,18378,3511,25017,1
349,7049,245,125,200,5,7,34,250,7,30,17,34,37,51,166,265,3,1053,58,0,2,6,6,45590,18379,3511,25018,1
227,5129,4293,999,3693,19,54,507,4312,9,155,88,170,164,258,1156,1898,4,9368,520,0,2,5,5,45590,18381,3511,25020,1
227,5129,1482,859,1002,125,135,219,1607,16,219,134,251,235,385,1766,3032,9,27804,1544,1,2,5,5,45600,18382,3511,25021,1
83,2359,1523,757,1297,19,12,193,1542,12,193,117,230,205,347,1508,2664,7,19053,1058,0,2,4,4,45610,18384,3511,25022,1
83,2359,701,378,504,33,58,109,734,13,110,68,126,123,194,794,1346,7,10027,557,0,2,4,4,45610,18385,3512,25023,1
46,955,447,308,343,6,5,95,453,7,96,59,111,103,170,651,1136,4,4600,255,0,2,3,3,45610,18388,3512,25024,1
46,955,322,174,179,16,74,51,338,10,41,26,46,51,72,252,408,5,2291,127,0,2,3,3,45610,18391,3513,25025,1
212,5047,722,423,573,19,0,135,741,12,172,101,199,184,300,1320,2257,6,15668,870,0,2,2,2,45610,18393,3513,25027,1
212,5047,1508,847,911,44,250,301,1552,14,148,88,169,162,257,1120,1886,7,15077,837,0,2,2,2,45610,18394,3514,25028,1
310,7160,72,33,56,0,4,12,72,1,1,1,1,2,2,0,2,0,1,0,0,2,2,2,45610,18394,3514,25029,1
310,7160,1454,835,1044,76,110,219,1530,17,275,158,296,292,454,2297,3718,9,34017,1889,1,2,2,2,45620,18395,3514,25030,1
127,2807,1043,504,840,53,9,147,1096,9,180,112,198,189,310,1377,2344,4,11604,644,0,2,4,4,45620,18397,3514,25031,1
127,2807,383,288,292,26,6,62,409,11,65,38,67,76,105,429,656,5,3719,206,0,2,4,4,45620,18398,3514,25032,1
91,3010,773,419,590,28,0,166,801,10,204,113,217,214,330,1598,2554,5,13587,754,0,2,1,1,45620,18398,3515,25033,1
47,2498,520,294,400,33,13,81,553,10,261,204,367,271,571,2128,4614,7,32445,1802,1,2,28,28,45620,18399,3515,25034,1
109,4106,1450,624,1228,12,26,181,1462,14,306,186,354,320,540,2580,4493,8,36391,2021,1,2,1,1,45620,18401,3516,25035,1
68,2962,1020,354,843,12,15,144,1032,8,134,77,144,142,221,970,1580,4,6792,377,0,2,4,4,45620,18401,3516,25036,1
36,1978,384,251,317,7,8,52,391,11,70,44,84,81,128,467,811,6,5355,297,0,2,1,1,45620,18401,3516,25037,1
16,1209,215,129,180,6,0,29,221,8,65,43,72,73,115,415,711,4,3153,175,0,2,1,1,45620,18401,3516,25038,1
163,5080,1660,832,1314,41,38,274,1701,20,312,209,395,332,604,2671,5058,12,64042,3557,1,2,1,1,45620,18403,3517,25040,1
163,5080,1057,646,719,113,100,145,1170,18,215,134,248,233,382,1740,3004,10,31186,1732,1,2,1,1,45630,18404,3518,25041,1
54,1161,207,111,150,11,0,50,218,5,26,19,36,31,55,133,272,3,943,52,0,2,1,1,45630,18404,3518,25042,1
54,1161,410,198,237,31,55,97,441,11,63,38,72,74,110,414,683,6,4293,238,0,2,1,1,45640,18405,3519,25043,1
349,7049,1457,730,1242,11,6,188,1468,10,292,166,329,302,495,2424,4078,5,22973,1276,1,2,1,1,45640,18407,3519,25044,1
349,7049,74,35,59,1,0,14,75,3,14,7,14,17,21,58,85,1,128,7,0,2,1,1,45640,18408,3519,25045,1
349,7049,245,125,200,5,7,34,250,7,30,17,34,37,51,166,265,3,1053,58,0,2,1,1,45650,18409,3519,25046,1
60,1673,1455,414,1257,16,76,112,1471,5,41,23,46,46,69,231,381,2,1069,59,0,2,1,1,45650,18410,3519,25047,1
60,1673,669,365,481,22,61,110,691,15,103,63,122,118,185,747,1273,8,11311,628,0,2,1,1,45660,18410,3520,25048,1
83,2359,1523,757,1297,19,12,193,1542,12,193,117,230,205,347,1508,2664,7,19053,1058,0,2,2,2,45670,18412,3520,25049,1
83,2359,701,378,504,33,58,109,734,13,110,68,126,123,194,794,1346,7,10027,557,0,2,2,2,45670,18413,3521,25050,1
212,5047,722,423,573,19,0,135,741,12,172,101,199,184,300,1320,2257,6,15668,870,0,2,1,1,45670,18415,3521,25052,1
212,5047,1508,847,911,44,250,301,1552,14,148,88,169,162,257,1120,1886,7,15077,837,0,2,1,1,45670,18416,3522,25053,1
310,7160,72,33,56,0,4,12,72,1,1,1,1,2,2,0,2,0,1,0,0,2,1,1,45670,18416,3522,25054,1
310,7160,1454,835,1044,76,110,219,1530,17,275,158,296,292,454,2297,3718,9,34017,1889,1,2,1,1,45680,18417,3522,25055,1
147,6814,1392,870,1177,35,17,170,1427,14,494,280,531,508,811,4473,7289,7,54850,3047,2,2,1,1,45680,18420,3523,25056,1
32,948,465,148,393,5,8,60,470,4,31,20,31,35,51,161,261,2,523,29,0,2,1,1,45680,18421,3523,25057,1
32,948,16,12,9,0,0,6,16,1,2,1,2,3,3,2,4,0,2,0,0,2,1,1,45680,18421,3523,25058,1
66,3414,1296,573,1062,40,33,157,1336,8,201,118,231,209,349,1561,2689,4,12365,686,0,2,1,1,45680,18421,3523,25059,1
40,2367,334,251,279,10,4,40,344,5,127,74,143,132,217,899,1528,2,4303,239,0,2,1,1,45680,18422,3523,25060,1
213,4595,182,127,129,0,0,53,182,5,39,21,42,44,63,217,343,2,926,51,0,2,4,4,45680,18422,3524,25061,1
213,4595,1165,710,800,67,119,181,1232,18,243,153,282,261,435,2000,3492,10,36473,2026,1,2,4,4,45690,18422,3525,25062,1
99,2081,773,419,590,28,0,166,801,10,204,113,217,214,330,1598,2554,5,13587,754,0,2,1,1,45690,18422,3526,25063,1
99,2081,421,273,302,44,34,57,465,17,81,59,107,98,166,583,1098,11,12329,684,0,2,1,1,45690,18422,3527,25064,1
60,1265,996,429,845,24,10,117,1020,7,76,50,88,83,138,494,879,4,3565,198,0,2,1,1,45690,18424,3527,25065,1
60,1265,456,277,329,12,42,72,468,13,85,50,97,98,147,592,972,7,7212,400,0,2,1,1,45690,18424,3527,25066,1
54,1161,207,111,150,11,0,50,218,5,26,19,36,31,55,133,272,3,943,52,0,2,1,1,45690,18424,3527,25067,1
54,1161,410,198,237,31,55,97,441,11,63,38,72,74,110,414,683,6,4293,238,0,2,1,1,45700,18425,3528,25068,1
349,7049,1457,730,1242,11,6,188,1468,10,292,166,329,302,495,2424,4078,5,22973,1276,1,2,9,9,45700,18427,3528,25069,1
349,7049,74,35,59,1,0,14,75,3,14,7,14,17,21,58,85,1,128,7,0,2,9,9,45700,18428,3528,25070,1
349,7049,245,125,200,5,7,34,250,7,30,17,34,37,51,166,265,3,1053,58,0,2,9,9,45710,18429,3528,25071,1
60,1673,1455,414,1257,16,76,112,1471,5,41,23,46,46,69,231,381,2,1069,59,0,2,15,15,45710,18430,3528,25072,1
60,1673,669,365,481,22,61,110,691,15,103,63,122,118,185,747,1273,8,11311,628,0,2,15,15,45720,18430,3529,25073,1
227,5129,4293,999,3693,19,54,507,4312,9,155,88,170,164,258,1156,1898,4,9368,520,0,2,5,5,45720,18432,3529,25074,1
227,5129,1482,859,1002,125,135,219,1607,16,219,134,251,235,385,1766,3032,9,27804,1544,1,2,5,5,45730,18433,3529,25075,1
27,954,74,35,59,1,0,14,75,3,14,7,14,17,21,58,85,1,128,7,0,2,16,16,45730,18434,3529,25076,1
27,954,245,125,200,5,7,34,250,7,30,17,34,37,51,166,265,3,1053,58,0,2,16,16,45740,18435,3529,25077,1
178,4130,77,34,69,0,0,8,77,3,24,16,29,27,45,114,213,1,387,21,0,2,22,22,45740,18435,3529,25078,1
178,4130,712,438,573,51,9,84,763,14,102,71,128,116,199,733,1364,8,11988,666,0,2,22,22,45750,18436,3529,25079,1
17,518,184,100,137,2,15,30,186,6,38,20,39,44,59,214,322,3,991,55,0,2,3,3,45750,18437,3529,25080,1
17,518,103,65,74,8,5,16,111,7,17,9,17,24,26,89,119,3,417,23,0,2,3,3,45750,18438,3529,25081,1
212,5047,722,423,573,19,0,135,741,12,172,101,199,184,300,1320,2257,6,15668,870,0,2,10,10,45750,18440,3529,25083,1
212,5047,1508,847,911,44,250,301,1552,14,148,88,169,162,257,1120,1886,7,15077,837,0,2,10,10,45750,18441,3530,25084,1
310,7160,72,33,56,0,4,12,72,1,1,1,1,2,2,0,2,0,1,0,0,2,27,27,45750,18441,3530,25085,1
310,7160,1454,835,1044,76,110,219,1530,17,275,158,296,292,454,2297,3718,9,34017,1889,1,2,27,27,45760,18442,3530,25086,1
30,649,215,129,180,6,0,29,221,8,65,43,72,73,115,415,711,4,3153,175,0,2,2,2,45760,18442,3530,25087,1
30,649,97,69,77,3,3,16,100,6,22,13,23,28,36,113,173,3,542,30,0,2,2,2,45760,18443,3530,25088,1
127,2807,1043,504,840,53,9,147,1096,9,180,112,198,189,310,1377,2344,4,11604,644,0,2,6,6,45760,18445,3530,25089,1
127,2807,383,288,292,26,6,62,409,11,65,38,67,76,105,429,656,5,3719,206,0,2,6,6,45760,18446,3530,25090,1
103,1953,1178,367,1042,6,15,115,1184,9,94,51,95,103,146,644,976,4,4439,246,0,2,17,17,45760,18446,3530,25091,1
103,1953,177,108,140,8,0,27,185,6,30,16,32,36,48,162,248,3,794,44,0,2,17,17,45760,18448,3530,25092,1
192,3908,1943,715,1694,26,18,214,1969,12,185,120,237,197,357,1436,2721,7,20915,1161,0,2,18,18,45760,18450,3530,25093,1
192,3908,1168,838,957,57,25,144,1225,19,348,224,416,367,640,3018,5452,11,61921,3440,1,2,18,18,45770,18452,3530,25094,1
16,477,442,244,305,14,16,103,456,11,68,45,75,79,120,452,756,6,4588,254,0,2,1,1,45770,18454,3530,25095,1
16,477,182,102,99,11,40,35,193,3,11,6,11,14,17,42,64,1,97,5,0,2,1,1,45770,18455,3530,25096,1
62,1240,1098,241,925,5,10,155,1103,7,46,25,49,53,74,273,423,3,1580,87,0,2,2,2,45780,18457,3530,25097,1
62,1240,282,202,222,14,2,44,296,8,42,24,43,50,67,250,378,4,1548,86,0,2,2,2,45780,18458,3530,25098,1
147,6814,1392,870,1177,35,17,170,1427,14,494,280,531,508,811,4473,7289,7,54850,3047,2,2,1,1,45780,18461,3531,25099,1
96,4365,1338,495,1086,10,64,173,1348,11,122,82,157,133,239,883,1686,7,11934,663,0,2,3,3,45780,18463,3531,25100,1
112,5710,1782,648,1425,9,47,279,1791,8,171,97,189,179,286,1292,2140,4,9462,525,0,2,4,4,45780,18464,3532,25101,1
23,601,102,59,69,5,3,24,107,6,22,15,28,28,43,113,206,3,789,43,0,2,4,4,45780,18464,3532,25102,1
150,4203,1660,832,1314,41,38,274,1701,20,312,209,395,332,604,2671,5058,12,64042,3557,1,2,1,1,45780,18466,3533,25104,1
117,4645,1513,682,1277,25,13,200,1538,11,199,116,219,210,335,1557,2584,6,15641,868,0,2,1,1,45780,18468,3533,25105,1
78,4093,1457,730,1242,11,6,188,1468,10,292,166,329,302,495,2424,4078,5,22973,1276,1,2,1,1,45780,18470,3533,25106,1
64,2957,1455,414,1257,16,76,112,1471,5,41,23,46,46,69,231,381,2,1069,59,0,2,4,4,45780,18471,3533,25107,1
40,2367,334,251,279,10,4,40,344,5,127,74,143,132,217,899,1528,2,4303,239,0,2,1,1,45780,18472,3533,25108,1
36,1978,384,251,317,7,8,52,391,11,70,44,84,81,128,467,811,6,5355,297,0,2,1,1,45780,18472,3533,25109,1
74,3770,1943,715,1694,26,18,214,1969,12,185,120,237,197,357,1436,2721,7,20915,1161,0,2,4,4,45780,18474,3533,25110,1
213,4595,182,127,129,0,0,53,182,5,39,21,42,44,63,217,343,2,926,51,0,2,1,1,45780,18474,3534,25111,0
213,4595,1165,710,800,67,119,181,1232,18,243,153,282,261,435,2000,3492,10,36473,2026,1,2,1,1,45790,18474,3535,25112,0
163,5080,1660,832,1314,41,38,274,1701,20,312,209,395,332,604,2671,5058,12,64042,3557,1,2,1,1,45790,18476,3536,25114,0
163,5080,1057,646,719,113,100,145,1170,18,215,134,248,233,382,1740,3004,10,31186,1732,1,2,1,1,45800,18477,3537,25115,0
62,1240,1098,241,925,5,10,155,1103,7,46,25,49,53,74,273,423,3,1580,87,0,2,1,1,45810,18479,3537,25116,0
62,1240,282,202,222,14,2,44,296,8,42,24,43,50,67,250,378,4,1548,86,0,2,1,1,45810,18480,3537,25117,0
349,7049,1457,730,1242,11,6,188,1468,10,292,166,329,302,495,2424,4078,5,22973,1276,1,2,3,3,45810,18482,3537,25118,1
349,7049,74,35,59,1,0,14,75,3,14,7,14,17,21,58,85,1,128,7,0,2,3,3,45810,18483,3537,25119,1
349,7049,245,125,200,5,7,34,250,7,30,17,34,37,51,166,265,3,1053,58,0,2,3,3,45820,18484,3537,25120,1
310,7160,72,33,56,0,4,12,72,1,1,1,1,2,2,0,2,0,1,0,0,2,1,1,45820,18484,3537,25121,1
310,7160,1454,835,1044,76,110,219,1530,17,275,158,296,292,454,2297,3718,9,34017,1889,1,2,1,1,45830,18485,3537,25122,1
40,837,386,256,301,16,9,68,402,4,59,35,69,63,104,355,621,2,1453,80,0,2,1,1,45830,18485,3537,25123,1
40,837,264,131,164,11,41,46,275,6,38,22,40,44,62,214,338,3,1068,59,0,2,1,1,45840,18485,3538,25124,1
147,6814,1392,870,1177,35,17,170,1427,14,494,280,531,508,811,4473,7289,7,54850,3047,2,2,3,3,45840,18488,3539,25125,1
47,2498,520,294,400,33,13,81,553,10,261,204,367,271,571,2128,4614,7,32445,1802,1,2,40,40,45840,18489,3539,25126,1
109,4106,1450,624,1228,12,26,181,1462,14,306,186,354,320,540,2580,4493,8,36391,2021,1,2,5,5,45840,18491,3540,25127,1
68,2962,1020,354,843,12,15,144,1032,8,134,77,144,142,221,970,1580,4,6792,377,0,2,9,9,45840,18491,3540,25128,1
71,3006,1178,367,1042,6,15,115,1184,9,94,51,95,103,146,644,976,4,4439,246,0,2,1,1,45840,18491,3540,25129,1
74,3770,1943,715,1694,26,18,214,1969,12,185,120,237,197,357,1436,2721,7,20915,1161,0,2,1,1,45840,18493,3540,25130,1
99,2081,773,419,590,28,0,166,801,10,204,113,217,214,330,1598,2554,5,13587,754,0,2,1,1,45840,18493,3541,25131,0
99,2081,421,273,302,44,34,57,465,17,81,59,107,98,166,583,1098,11,12329,684,0,2,1,1,45840,18493,3542,25132,0
47,2498,520,294,400,33,13,81,553,10,261,204,367,271,571,2128,4614,7,32445,1802,1,2,1,1,45840,18494,3542,25133,0
112,5710,1782,648,1425,9,47,279,1791,8,171,97,189,179,286,1292,2140,4,9462,525,0,2,1,1,45840,18495,3543,25134,0
23,601,102,59,69,5,3,24,107,6,22,15,28,28,43,113,206,3,789,43,0,2,2,2,45840,18495,3543,25135,0
213,4595,182,127,129,0,0,53,182,5,39,21,42,44,63,217,343,2,926,51,0,2,1,1,45840,18495,3544,25136,1
213,4595,1165,710,800,67,119,181,1232,18,243,153,282,261,435,2000,3492,10,36473,2026,1,2,1,1,45850,18495,3545,25137,1
147,6814,1392,870,1177,35,17,170,1427,14,494,280,531,508,811,4473,7289,7,54850,3047,2,2,1,1,45850,18498,3546,25138,1
109,4106,1450,624,1228,12,26,181,1462,14,306,186,354,320,540,2580,4493,8,36391,2021,1,2,1,1,45850,18500,3547,25139,1
150,4203,1660,832,1314,41,38,274,1701,20,312,209,395,332,604,2671,5058,12,64042,3557,1,2,9,9,45850,18502,3548,25141,0
227,5129,4293,999,3693,19,54,507,4312,9,155,88,170,164,258,1156,1898,4,9368,520,0,2,1,1,45850,18504,3548,25142,1
227,5129,1482,859,1002,125,135,219,1607,16,219,134,251,235,385,1766,3032,9,27804,1544,1,2,1,1,45860,18505,3548,25143,1
212,5047,722,423,573,19,0,135,741,12,172,101,199,184,300,1320,2257,6,15668,870,0,2,1,1,45860,18507,3548,25145,1
212,5047,1508,847,911,44,250,301,1552,14,148,88,169,162,257,1120,1886,7,15077,837,0,2,1,1,45860,18508,3549,25146,1
19,408,601,196,481,2,23,85,603,8,63,36,72,71,108,400,664,4,3036,168,0,2,1,1,45860,18508,3549,25147,1
19,408,156,79,106,5,16,28,161,5,14,8,15,19,23,64,97,2,261,14,0,2,1,1,45860,18508,3549,25148,1
147,6814,1392,870,1177,35,17,170,1427,14,494,280,531,508,811,4473,7289,7,54850,3047,2,2,10,10,45860,18511,3550,25149,1
213,4595,182,127,129,0,0,53,182,5,39,21,42,44,63,217,343,2,926,51,0,2,2,2,45860,18511,3551,25150,0
213,4595,1165,710,800,67,119,181,1232,18,243,153,282,261,435,2000,3492,10,36473,2026,1,2,2,2,45870,18511,3552,25151,0
99,2081,773,419,590,28,0,166,801,10,204,113,217,214,330,1598,2554,5,13587,754,0,2,1,1,45870,18511,3553,25152,0
99,2081,421,273,302,44,34,57,465,17,81,59,107,98,166,583,1098,11,12329,684,0,2,1,1,45870,18511,3554,25153,0
349,7049,1457,730,1242,11,6,188,1468,10,292,166,329,302,495,2424,4078,5,22973,1276,1,2,1,1,45870,18513,3554,25154,0
349,7049,74,35,59,1,0,14,75,3,14,7,14,17,21,58,85,1,128,7,0,2,1,1,45870,18514,3554,25155,0
349,7049,245,125,200,5,7,34,250,7,30,17,34,37,51,166,265,3,1053,58,0,2,1,1,45880,18515,3554,25156,0
227,5129,4293,999,3693,19,54,507,4312,9,155,88,170,164,258,1156,1898,4,9368,520,0,2,4,4,45880,18517,3554,25157,0
227,5129,1482,859,1002,125,135,219,1607,16,219,134,251,235,385,1766,3032,9,27804,1544,1,2,4,4,45890,18518,3554,25158,0
66,3414,1296,573,1062,40,33,157,1336,8,201,118,231,209,349,1561,2689,4,12365,686,0,2,3,3,45890,18518,3554,25159,0
213,4595,182,127,129,0,0,53,182,5,39,21,42,44,63,217,343,2,926,51,0,2,7,7,45890,18518,3555,25160,1
213,4595,1165,710,800,67,119,181,1232,18,243,153,282,261,435,2000,3492,10,36473,2026,1,2,7,7,45900,18518,3556,25161,1
163,5080,1660,832,1314,41,38,274,1701,20,312,209,395,332,604,2671,5058,12,64042,3557,1,2,1,1,45900,18520,3557,25163,1
163,5080,1057,646,719,113,100,145,1170,18,215,134,248,233,382,1740,3004,10,31186,1732,1,2,1,1,45910,18521,3558,25164,1
54,1161,207,111,150,11,0,50,218,5,26,19,36,31,55,133,272,3,943,52,0,2,1,1,45910,18521,3558,25165,1
54,1161,410,198,237,31,55,97,441,11,63,38,72,74,110,414,683,6,4293,238,0,2,1,1,45920,18522,3559,25166,1
349,7049,1457,730,1242,11,6,188,1468,10,292,166,329,302,495,2424,4078,5,22973,1276,1,2,9,9,45920,18524,3559,25167,1
349,7049,74,35,59,1,0,14,75,3,14,7,14,17,21,58,85,1,128,7,0,2,9,9,45920,18525,3559,25168,1
349,7049,245,125,200,5,7,34,250,7,30,17,34,37,51,166,265,3,1053,58,0,2,9,9,45930,18526,3559,25169,1
227,5129,4293,999,3693,19,54,507,4312,9,155,88,170,164,258,1156,1898,4,9368,520,0,2,2,2,45930,18528,3559,25170,1
227,5129,1482,859,1002,125,135,219,1607,16,219,134,251,235,385,1766,3032,9,27804,1544,1,2,2,2,45940,18529,3559,25171,1
27,954,74,35,59,1,0,14,75,3,14,7,14,17,21,58,85,1,128,7,0,2,3,3,45940,18530,3559,25172,1
27,954,245,125,200,5,7,34,250,7,30,17,34,37,51,166,265,3,1053,58,0,2,3,3,45950,18531,3559,25173,1
178,4130,77,34,69,0,0,8,77,3,24,16,29,27,45,114,213,1,387,21,0,2,3,3,45950,18531,3559,25174,1
178,4130,712,438,573,51,9,84,763,14,102,71,128,116,199,733,1364,8,11988,666,0,2,3,3,45960,18532,3559,25175,1
17,518,184,100,137,2,15,30,186,6,38,20,39,44,59,214,322,3,991,55,0,2,1,1,45960,18533,3559,25176,1
17,518,103,65,74,8,5,16,111,7,17,9,17,24,26,89,119,3,417,23,0,2,1,1,45960,18534,3559,25177,1
212,5047,722,423,573,19,0,135,741,12,172,101,199,184,300,1320,2257,6,15668,870,0,2,3,3,45960,18536,3559,25179,1
212,5047,1508,847,911,44,250,301,1552,14,148,88,169,162,257,1120,1886,7,15077,837,0,2,3,3,45960,18537,3560,25180,1
310,7160,72,33,56,0,4,12,72,1,1,1,1,2,2,0,2,0,1,0,0,2,6,6,45960,18537,3560,25181,1
310,7160,1454,835,1044,76,110,219,1530,17,275,158,296,292,454,2297,3718,9,34017,1889,1,2,6,6,45970,18538,3560,25182,1
127,2807,1043,504,840,53,9,147,1096,9,180,112,198,189,310,1377,2344,4,11604,644,0,2,4,4,45970,18540,3560,25183,1
127,2807,383,288,292,26,6,62,409,11,65,38,67,76,105,429,656,5,3719,206,0,2,4,4,45970,18541,3560,25184,1
80,3427,1289,550,1043,56,32,155,1345,10,167,93,185,177,278,1266,2075,5,11498,638,0,2,1,1,45970,18543,3561,25185,1
91,3010,773,419,590,28,0,166,801,10,204,113,217,214,330,1598,2554,5,13587,754,0,2,2,2,45970,18543,3562,25186,1
148,6832,139,89,101,2,0,35,141,7,54,34,62,61,96,330,569,4,2287,127,0,2,2,2,45970,18543,3562,25187,1
148,6832,7,5,5,0,0,2,7,1,2,1,2,3,3,2,4,0,2,0,0,2,2,2,45970,18543,3562,25188,1
109,4106,1450,624,1228,12,26,181,1462,14,306,186,354,320,540,2580,4493,8,36391,2021,1,2,5,5,45970,18545,3563,25189,1
39,2355,652,304,544,16,6,88,668,6,89,51,101,95,152,591,998,3,3399,188,0,2,3,3,45970,18546,3563,25190,1
40,2367,334,251,279,10,4,40,344,5,127,74,143,132,217,899,1528,2,4303,239,0,2,1,1,45970,18547,3563,25191,1
35,1623,1293,570,1093,25,15,163,1318,10,195,123,241,205,364,1516,2795,6,17273,959,0,2,1,1,45980,18549,3563,25192,1
71,3006,1178,367,1042,6,15,115,1184,9,94,51,95,103,146,644,976,4,4439,246,0,2,1,1,45980,18549,3563,25193,1
213,4595,182,127,129,0,0,53,182,5,39,21,42,44,63,217,343,2,926,51,0,2,8,8,45980,18549,3564,25194,1
213,4595,1165,710,800,67,119,181,1232,18,243,153,282,261,435,2000,3492,10,36473,2026,1,2,8,8,45990,18549,3565,25195,1
99,2081,773,419,590,28,0,166,801,10,204,113,217,214,330,1598,2554,5,13587,754,0,2,7,7,45990,18549,3566,25196,1
99,2081,421,273,302,44,34,57,465,17,81,59,107,98,166,583,1098,11,12329,684,0,2,7,7,45990,18549,3567,25197,1
82,1800,477,336,357,30,23,73,507,16,194,134,250,210,384,1538,2962,10,30538,1696,0,2,5,5,46000,18550,3567,25198,1
54,1161,207,111,150,11,0,50,218,5,26,19,36,31,55,133,272,3,943,52,0,2,1,1,46000,18550,3567,25199,1
54,1161,410,198,237,31,55,97,441,11,63,38,72,74,110,414,683,6,4293,238,0,2,1,1,46010,18551,3568,25200,1
349,7049,1457,730,1242,11,6,188,1468,10,292,166,329,302,495,2424,4078,5,22973,1276,1,2,1,1,46010,18553,3568,25201,1
349,7049,74,35,59,1,0,14,75,3,14,7,14,17,21,58,85,1,128,7,0,2,1,1,46010,18554,3568,25202,1
349,7049,245,125,200,5,7,34,250,7,30,17,34,37,51,166,265,3,1053,58,0,2,1,1,46020,18555,3568,25203,1
227,5129,4293,999,3693,19,54,507,4312,9,155,88,170,164,258,1156,1898,4,9368,520,0,2,6,6,46020,18557,3568,25204,1
227,5129,1482,859,1002,125,135,219,1607,16,219,134,251,235,385,1766,3032,9,27804,1544,1,2,6,6,46030,18558,3568,25205,1
178,4130,77,34,69,0,0,8,77,3,24,16,29,27,45,114,213,1,387,21,0,2,1,1,46030,18558,3568,25206,1
178,4130,712,438,573,51,9,84,763,14,102,71,128,116,199,733,1364,8,11988,666,0,2,1,1,46040,18559,3568,25207,1
212,5047,722,423,573,19,0,135,741,12,172,101,199,184,300,1320,2257,6,15668,870,0,2,3,3,46040,18561,3568,25209,1
212,5047,1508,847,911,44,250,301,1552,14,148,88,169,162,257,1120,1886,7,15077,837,0,2,3,3,46040,18562,3569,25210,1
310,7160,72,33,56,0,4,12,72,1,1,1,1,2,2,0,2,0,1,0,0,2,1,1,46040,18562,3569,25211,1
310,7160,1454,835,1044,76,110,219,1530,17,275,158,296,292,454,2297,3718,9,34017,1889,1,2,1,1,46050,18563,3569,25212,1
127,2807,1043,504,840,53,9,147,1096,9,180,112,198,189,310,1377,2344,4,11604,644,0,2,1,1,46050,18565,3569,25213,1
127,2807,383,288,292,26,6,62,409,11,65,38,67,76,105,429,656,5,3719,206,0,2,1,1,46050,18566,3569,25214,1
80,3427,1289,550,1043,56,32,155,1345,10,167,93,185,177,278,1266,2075,5,11498,638,0,2,1,1,46050,18568,3570,25215,1
147,6814,1392,870,1177,35,17,170,1427,14,494,280,531,508,811,4473,7289,7,54850,3047,2,2,5,5,46050,18571,3571,25216,1
91,3010,773,419,590,28,0,166,801,10,204,113,217,214,330,1598,2554,5,13587,754,0,2,2,2,46050,18571,3572,25217,1
109,4106,1450,624,1228,12,26,181,1462,14,306,186,354,320,540,2580,4493,8,36391,2021,1,2,8,8,46050,18573,3573,25218,1
16,1209,215,129,180,6,0,29,221,8,65,43,72,73,115,415,711,4,3153,175,0,2,1,1,46050,18573,3573,25219,1
69,2856,1043,504,840,53,9,147,1096,9,180,112,198,189,310,1377,2344,4,11604,644,0,2,1,1,46050,18575,3573,25220,1
14,529,295,56,236,0,4,54,295,2,9,5,10,11,15,30,51,1,57,3,0,2,1,1,46050,18577,3573,25221,1
71,3006,1178,367,1042,6,15,115,1184,9,94,51,95,103,146,644,976,4,4439,246,0,2,1,1,46050,18577,3573,25222,1
99,2081,773,419,590,28,0,166,801,10,204,113,217,214,330,1598,2554,5,13587,754,0,2,2,2,46050,18577,3574,25223,1
99,2081,421,273,302,44,34,57,465,17,81,59,107,98,166,583,1098,11,12329,684,0,2,2,2,46050,18577,3575,25224,1
163,5080,1660,832,1314,41,38,274,1701,20,312,209,395,332,604,2671,5058,12,64042,3557,1,2,2,2,46050,18579,3576,25226,1
163,5080,1057,646,719,113,100,145,1170,18,215,134,248,233,382,1740,3004,10,31186,1732,1,2,2,2,46060,18580,3577,25227,1
128,2606,1513,682,1277,25,13,200,1538,11,199,116,219,210,335,1557,2584,6,15641,868,0,2,1,1,46060,18582,3577,25228,1
128,2606,819,519,539,24,98,155,843,15,96,57,106,111,163,690,1107,8,9171,509,0,2,1,1,46070,18584,3577,25229,1
349,7049,1457,730,1242,11,6,188,1468,10,292,166,329,302,495,2424,4078,5,22973,1276,1,2,1,1,46070,18586,3577,25230,1
349,7049,74,35,59,1,0,14,75,3,14,7,14,17,21,58,85,1,128,7,0,2,1,1,46070,18587,3577,25231,1
349,7049,245,125,200,5,7,34,250,7,30,17,34,37,51,166,265,3,1053,58,0,2,1,1,46080,18588,3577,25232,1
227,5129,4293,999,3693,19,54,507,4312,9,155,88,170,164,258,1156,1898,4,9368,520,0,2,1,1,46080,18590,3577,25233,1
227,5129,1482,859,1002,125,135,219,1607,16,219,134,251,235,385,1766,3032,9,27804,1544,1,2,1,1,46090,18591,3577,25234,1
27,954,74,35,59,1,0,14,75,3,14,7,14,17,21,58,85,1,128,7,0,2,1,1,46090,18592,3577,25235,1
27,954,245,125,200,5,7,34,250,7,30,17,34,37,51,166,265,3,1053,58,0,2,1,1,46100,18593,3577,25236,1
310,7160,72,33,56,0,4,12,72,1,1,1,1,2,2,0,2,0,1,0,0,2,4,4,46100,18593,3577,25237,1
310,7160,1454,835,1044,76,110,219,1530,17,275,158,296,292,454,2297,3718,9,34017,1889,1,2,4,4,46110,18594,3577,25238,1
127,2807,1043,504,840,53,9,147,1096,9,180,112,198,189,310,1377,2344,4,11604,644,0,2,1,1,46110,18596,3577,25239,1
127,2807,383,288,292,26,6,62,409,11,65,38,67,76,105,429,656,5,3719,206,0,2,1,1,46110,18597,3577,25240,1
192,3908,1943,715,1694,26,18,214,1969,12,185,120,237,197,357,1436,2721,7,20915,1161,0,2,3,3,46110,18599,3577,25241,1
192,3908,1168,838,957,57,25,144,1225,19,348,224,416,367,640,3018,5452,11,61921,3440,1,2,3,3,46120,18601,3577,25242,1
80,3427,1289,550,1043,56,32,155,1345,10,167,93,185,177,278,1266,2075,5,11498,638,0,2,2,2,46120,18603,3578,25243,1
147,6814,1392,870,1177,35,17,170,1427,14,494,280,531,508,811,4473,7289,7,54850,3047,2,2,1,1,46120,18606,3579,25244,1
91,3010,773,419,590,28,0,166,801,10,204,113,217,214,330,1598,2554,5,13587,754,0,2,5,5,46120,18606,3580,25245,1
47,2498,520,294,400,33,13,81,553,10,261,204,367,271,571,2128,4614,7,32445,1802,1,2,1,1,46120,18607,3580,25246,1
96,4365,1338,495,1086,10,64,173,1348,11,122,82,157,133,239,883,1686,7,11934,663,0,2,4,4,46120,18609,3580,25247,1
148,6832,139,89,101,2,0,35,141,7,54,34,62,61,96,330,569,4,2287,127,0,2,9,9,46120,18609,3580,25248,1
148,6832,7,5,5,0,0,2,7,1,2,1,2,3,3,2,4,0,2,0,0,2,9,9,46120,18609,3580,25249,1
112,5710,1782,648,1425,9,47,279,1791,8,171,97,189,179,286,1292,2140,4,9462,525,0,2,22,22,46120,18610,3581,25250,1
23,601,102,59,69,5,3,24,107,6,22,15,28,28,43,113,206,3,789,43,0,2,5,5,46120,18610,3581,25251,1
109,4106,1450,624,1228,12,26,181,1462,14,306,186,354,320,540,2580,4493,8,36391,2021,1,2,2,2,46120,18612,3582,25252,1
150,4203,1660,832,1314,41,38,274,1701,20,312,209,395,332,604,2671,5058,12,64042,3557,1,2,1,1,46120,18614,3583,25254,1
117,4645,1513,682,1277,25,13,200,1538,11,199,116,219,210,335,1557,2584,6,15641,868,0,2,1,1,46120,18616,3583,25255,1
66,3414,1296,573,1062,40,33,157,1336,8,201,118,231,209,349,1561,2689,4,12365,686,0,2,3,3,46120,18616,3583,25256,1
78,4093,1457,730,1242,11,6,188,1468,10,292,166,329,302,495,2424,4078,5,22973,1276,1,2,1,1,46120,18618,3583,25257,1
39,2355,652,304,544,16,6,88,668,6,89,51,101,95,152,591,998,3,3399,188,0,2,1,1,46120,18619,3583,25258,1
68,2962,1020,354,843,12,15,144,1032,8,134,77,144,142,221,970,1580,4,6792,377,0,2,1,1,46120,18619,3583,25259,1
40,2367,334,251,279,10,4,40,344,5,127,74,143,132,217,899,1528,2,4303,239,0,2,3,3,46120,18620,3583,25260,1
12,492,184,100,137,2,15,30,186,6,38,20,39,44,59,214,322,3,991,55,0,2,2,2,46120,18621,3583,25261,1
69,2856,1043,504,840,53,9,147,1096,9,180,112,198,189,310,1377,2344,4,11604,644,0,2,1,1,46120,18623,3583,25262,1
74,3770,1943,715,1694,26,18,214,1969,12,185,120,237,197,357,1436,2721,7,20915,1161,0,2,5,5,46120,18625,3583,25263,1
212,5047,722,423,573,19,0,135,741,12,172,101,199,184,300,1320,2257,6,15668,870,0,2,4,4,46120,18627,3583,25265,0
212,5047,1508,847,911,44,250,301,1552,14,148,88,169,162,257,1120,1886,7,15077,837,0,2,4,4,46120,18628,3584,25266,0
39,2355,652,304,544,16,6,88,668,6,89,51,101,95,152,591,998,3,3399,188,0,2,16,16,46120,18629,3584,25267,0
64,2957,1455,414,1257,16,76,112,1471,5,41,23,46,46,69,231,381,2,1069,59,0,2,3,3,46120,18630,3584,25268,0
101,2081,773,419,590,28,0,166,801,10,204,113,217,214,330,1598,2554,5,13587,754,0,2,1,2,46120,18630,3585,25269,0
101,2081,421,273,302,44,34,57,465,17,81,59,107,98,166,583,1098,11,12329,684,0,2,1,2,46120,18630,3586,25270,0
27,954,74,35,59,1,0,14,75,3,14,7,14,17,21,58,85,1,128,7,0,2,1,1,46120,18631,3586,25271,0
27,954,245,125,200,5,7,34,250,7,30,17,34,37,51,166,265,3,1053,58,0,2,1,1,46130,18632,3586,25272,0
212,5047,722,423,573,19,0,135,741,12,172,101,199,184,300,1320,2257,6,15668,870,0,2,1,1,46130,18634,3586,25274,0
212,5047,1508,847,911,44,250,301,1552,14,148,88,169,162,257,1120,1886,7,15077,837,0,2,1,1,46130,18635,3587,25275,0
310,7160,72,33,56,0,4,12,72,1,1,1,1,2,2,0,2,0,1,0,0,2,1,2,46130,18635,3587,25276,0
310,7160,1454,835,1044,76,110,219,1530,17,275,158,296,292,454,2297,3718,9,34017,1889,1,2,1,2,46140,18636,3587,25277,0
78,4093,1457,730,1242,11,6,188,1468,10,292,166,329,302,495,2424,4078,5,22973,1276,1,2,1,1,46140,18638,3587,25278,0
40,2367,334,251,279,10,4,40,344,5,127,74,143,132,217,899,1528,2,4303,239,0,2,1,1,46140,18639,3587,25279,0
16,1209,215,129,180,6,0,29,221,8,65,43,72,73,115,415,711,4,3153,175,0,2,4,4,46140,18639,3587,25280,0
71,3006,1178,367,1042,6,15,115,1184,9,94,51,95,103,146,644,976,4,4439,246,0,2,1,1,46140,18639,3587,25281,0
74,3770,1943,715,1694,26,18,214,1969,12,185,120,237,197,357,1436,2721,7,20915,1161,0,2,1,1,46140,18641,3587,25282,0
9,228,19,8,11,5,0,4,24,2,5,3,6,7,9,13,25,1,30,1,0,2,1,1,46140,18641,3587,25283,1
9,228,102,59,69,5,3,24,107,6,22,15,28,28,43,113,206,3,789,43,0,2,1,1,46140,18641,3587,25284,1
9,228,106,40,36,3,49,17,109,8,17,13,23,25,36,93,167,5,904,50,0,2,1,1,46140,18641,3587,25285,1
101,2081,773,419,590,28,0,166,801,10,204,113,217,214,330,1598,2554,5,13587,754,0,2,4,4,46140,18641,3588,25286,1
101,2081,421,273,302,44,34,57,465,17,81,59,107,98,166,583,1098,11,12329,684,0,2,4,4,46140,18641,3589,25287,1
163,5080,1660,832,1314,41,38,274,1701,20,312,209,395,332,604,2671,5058,12,64042,3557,1,2,4,4,46140,18643,3590,25289,1
163,5080,1057,646,719,113,100,145,1170,18,215,134,248,233,382,1740,3004,10,31186,1732,1,2,4,4,46150,18644,3591,25290,1
128,2606,1513,682,1277,25,13,200,1538,11,199,116,219,210,335,1557,2584,6,15641,868,0,2,1,1,46150,18646,3591,25291,1
128,2606,819,519,539,24,98,155,843,15,96,57,106,111,163,690,1107,8,9171,509,0,2,1,1,46160,18648,3591,25292,1
349,7049,1457,730,1242,11,6,188,1468,10,292,166,329,302,495,2424,4078,5,22973,1276,1,2,4,4,46160,18650,3591,25293,1
349,7049,74,35,59,1,0,14,75,3,14,7,14,17,21,58,85,1,128,7,0,2,4,4,46160,18651,3591,25294,1
349,7049,245,125,200,5,7,34,250,7,30,17,34,37,51,166,265,3,1053,58,0,2,4,4,46170,18652,3591,25295,1
227,5129,4293,999,3693,19,54,507,4312,9,155,88,170,164,258,1156,1898,4,9368,520,0,2,2,2,46170,18654,3591,25296,1
227,5129,1482,859,1002,125,135,219,1607,16,219,134,251,235,385,1766,3032,9,27804,1544,1,2,2,2,46180,18655,3591,25297,1
178,4130,77,34,69,0,0,8,77,3,24,16,29,27,45,114,213,1,387,21,0,2,3,3,46180,18655,3591,25298,1
178,4130,712,438,573,51,9,84,763,14,102,71,128,116,199,733,1364,8,11988,666,0,2,3,3,46190,18656,3591,25299,1
80,1581,1020,354,843,12,15,144,1032,8,134,77,144,142,221,970,1580,4,6792,377,0,2,1,1,46190,18656,3591,25300,1
212,5047,722,423,573,19,0,135,741,12,172,101,199,184,300,1320,2257,6,15668,870,0,2,4,4,46190,18658,3591,25302,1
212,5047,1508,847,911,44,250,301,1552,14,148,88,169,162,257,1120,1886,7,15077,837,0,2,4,4,46190,18659,3592,25303,1
310,7160,72,33,56,0,4,12,72,1,1,1,1,2,2,0,2,0,1,0,0,2,1,1,46190,18659,3592,25304,1
310,7160,1454,835,1044,76,110,219,1530,17,275,158,296,292,454,2297,3718,9,34017,1889,1,2,1,1,46200,18660,3592,25305,1
30,649,215,129,180,6,0,29,221,8,65,43,72,73,115,415,711,4,3153,175,0,2,2,2,46200,18660,3592,25306,1
30,649,97,69,77,3,3,16,100,6,22,13,23,28,36,113,173,3,542,30,0,2,2,2,46200,18661,3592,25307,1
127,2807,1043,504,840,53,9,147,1096,9,180,112,198,189,310,1377,2344,4,11604,644,0,2,2,2,46200,18663,3592,25308,1
127,2807,383,288,292,26,6,62,409,11,65,38,67,76,105,429,656,5,3719,206,0,2,2,2,46200,18664,3592,25309,1
192,3908,1943,715,1694,26,18,214,1969,12,185,120,237,197,357,1436,2721,7,20915,1161,0,2,3,3,46200,18666,3592,25310,1
192,3908,1168,838,957,57,25,144,1225,19,348,224,416,367,640,3018,5452,11,61921,3440,1,2,3,3,46210,18668,3592,25311,1
80,3427,1289,550,1043,56,32,155,1345,10,167,93,185,177,278,1266,2075,5,11498,638,0,2,3,3,46210,18670,3593,25312,1
147,6814,1392,870,1177,35,17,170,1427,14,494,280,531,508,811,4473,7289,7,54850,3047,2,2,6,6,46210,18673,3594,25313,1
91,3010,773,419,590,28,0,166,801,10,204,113,217,214,330,1598,2554,5,13587,754,0,2,2,2,46210,18673,3595,25314,1
96,4365,1338,495,1086,10,64,173,1348,11,122,82,157,133,239,883,1686,7,11934,663,0,2,2,2,46210,18675,3595,25315,1
148,6832,139,89,101,2,0,35,141,7,54,34,62,61,96,330,569,4,2287,127,0,2,1,1,46210,18675,3595,25316,1
148,6832,7,5,5,0,0,2,7,1,2,1,2,3,3,2,4,0,2,0,0,2,1,1,46210,18675,3595,25317,1
32,948,465,148,393,5,8,60,470,4,31,20,31,35,51,161,261,2,523,29,0,2,2,2,46210,18676,3595,25318,1
32,948,16,12,9,0,0,6,16,1,2,1,2,3,3,2,4,0,2,0,0,2,2,2,46210,18676,3595,25319,1
109,4106,1450,624,1228,12,26,181,1462,14,306,186,354,320,540,2580,4493,8,36391,2021,1,2,1,1,46210,18678,3596,25320,1
150,4203,1660,832,1314,41,38,274,1701,20,312,209,395,332,604,2671,5058,12,64042,3557,1,2,1,1,46210,18680,3597,25322,1
35,1623,1293,570,1093,25,15,163,1318,10,195,123,241,205,364,1516,2795,6,17273,959,0,2,4,4,46220,18682,3597,25323,1
16,1209,215,129,180,6,0,29,221,8,65,43,72,73,115,415,711,4,3153,175,0,2,1,1,46220,18682,3597,25324,1
69,2856,1043,504,840,53,9,147,1096,9,180,112,198,189,310,1377,2344,4,11604,644,0,2,2,2,46220,18684,3597,25325,1
25,1027,373,158,315,8,0,51,381,5,76,44,79,81,123,486,779,2,2026,112,0,2,2,2,46220,18684,3597,25326,1
71,3006,1178,367,1042,6,15,115,1184,9,94,51,95,103,146,644,976,4,4439,246,0,2,1,1,46220,18684,3597,25327,1
74,3770,1943,715,1694,26,18,214,1969,12,185,120,237,197,357,1436,2721,7,20915,1161,0,2,1,1,46220,18686,3597,25328,1
213,4595,182,127,129,0,0,53,182,5,39,21,42,44,63,217,343,2,926,51,0,2,6,6,46220,18686,3598,25329,0
213,4595,1165,710,800,67,119,181,1232,18,243,153,282,261,435,2000,3492,10,36473,2026,1,2,6,6,46230,18686,3599,25330,0
101,2081,773,419,590,28,0,166,801,10,204,113,217,214,330,1598,2554,5,13587,754,0,2,1,1,46230,18686,3600,25331,0
101,2081,421,273,302,44,34,57,465,17,81,59,107,98,166,583,1098,11,12329,684,0,2,1,1,46230,18686,3601,25332,0
60,1265,996,429,845,24,10,117,1020,7,76,50,88,83,138,494,879,4,3565,198,0,2,1,1,46230,18688,3601,25333,0
60,1265,456,277,329,12,42,72,468,13,85,50,97,98,147,592,972,7,7212,400,0,2,1,1,46230,18688,3601,25334,0
128,2606,1513,682,1277,25,13,200,1538,11,199,116,219,210,335,1557,2584,6,15641,868,0,2,1,1,46230,18690,3601,25335,0
128,2606,819,519,539,24,98,155,843,15,96,57,106,111,163,690,1107,8,9171,509,0,2,1,1,46240,18692,3601,25336,0
54,1161,207,111,150,11,0,50,218,5,26,19,36,31,55,133,272,3,943,52,0,2,1,1,46240,18692,3601,25337,0
54,1161,410,198,237,31,55,97,441,11,63,38,72,74,110,414,683,6,4293,238,0,2,1,1,46250,18693,3602,25338,0
349,7049,1457,730,1242,11,6,188,1468,10,292,166,329,302,495,2424,4078,5,22973,1276,1,2,2,2,46250,18695,3602,25339,0
349,7049,74,35,59,1,0,14,75,3,14,7,14,17,21,58,85,1,128,7,0,2,2,2,46250,18696,3602,25340,0
349,7049,245,125,200,5,7,34,250,7,30,17,34,37,51,166,265,3,1053,58,0,2,2,2,46260,18697,3602,25341,0
178,4130,77,34,69,0,0,8,77,3,24,16,29,27,45,114,213,1,387,21,0,2,2,2,46260,18697,3602,25342,0
178,4130,712,438,573,51,9,84,763,14,102,71,128,116,199,733,1364,8,11988,666,0,2,2,2,46270,18698,3602,25343,0
23,388,424,94,331,4,0,89,428,1,5,5,5,6,10,11,25,0,12,0,0,2,2,2,46270,18699,3602,25344,0
23,388,38,23,23,6,0,8,44,3,11,7,11,14,18,42,68,1,102,5,0,2,2,2,46270,18699,3602,25345,0
212,5047,722,423,573,19,0,135,741,12,172,101,199,184,300,1320,2257,6,15668,870,0,2,5,5,46270,18701,3602,25347,0
212,5047,1508,847,911,44,250,301,1552,14,148,88,169,162,257,1120,1886,7,15077,837,0,2,5,5,46270,18702,3603,25348,0
310,7160,72,33,56,0,4,12,72,1,1,1,1,2,2,0,2,0,1,0,0,2,3,3,46270,18702,3603,25349,0
310,7160,1454,835,1044,76,110,219,1530,17,275,158,296,292,454,2297,3718,9,34017,1889,1,2,3,3,46280,18703,3603,25350,0
127,2807,1043,504,840,53,9,147,1096,9,180,112,198,189,310,1377,2344,4,11604,644,0,2,1,1,46280,18705,3603,25351,0
127,2807,383,288,292,26,6,62,409,11,65,38,67,76,105,429,656,5,3719,206,0,2,1,1,46280,18706,3603,25352,0
103,1953,1178,367,1042,6,15,115,1184,9,94,51,95,103,146,644,976,4,4439,246,0,2,3,3,46280,18706,3603,25353,0
103,1953,177,108,140,8,0,27,185,6,30,16,32,36,48,162,248,3,794,44,0,2,3,3,46280,18708,3603,25354,0
192,3908,1943,715,1694,26,18,214,1969,12,185,120,237,197,357,1436,2721,7,20915,1161,0,2,4,4,46280,18710,3603,25355,0
192,3908,1168,838,957,57,25,144,1225,19,348,224,416,367,640,3018,5452,11,61921,3440,1,2,4,4,46290,18712,3603,25356,0
16,477,442,244,305,14,16,103,456,11,68,45,75,79,120,452,756,6,4588,254,0,2,1,1,46290,18714,3603,25357,0
16,477,182,102,99,11,40,35,193,3,11,6,11,14,17,42,64,1,97,5,0,2,1,1,46290,18715,3603,25358,0
80,3427,1289,550,1043,56,32,155,1345,10,167,93,185,177,278,1266,2075,5,11498,638,0,2,3,3,46290,18717,3604,25359,0
147,6814,1392,870,1177,35,17,170,1427,14,494,280,531,508,811,4473,7289,7,54850,3047,2,2,5,5,46290,18720,3605,25360,0
91,3010,773,419,590,28,0,166,801,10,204,113,217,214,330,1598,2554,5,13587,754,0,2,7,7,46290,18720,3606,25361,0
148,6832,139,89,101,2,0,35,141,7,54,34,62,61,96,330,569,4,2287,127,0,2,1,1,46290,18720,3606,25362,0
148,6832,7,5,5,0,0,2,7,1,2,1,2,3,3,2,4,0,2,0,0,2,1,1,46290,18720,3606,25363,0
109,4106,1450,624,1228,12,26,181,1462,14,306,186,354,320,540,2580,4493,8,36391,2021,1,2,1,1,46290,18722,3607,25364,0
117,4645,1513,682,1277,25,13,200,1538,11,199,116,219,210,335,1557,2584,6,15641,868,0,2,1,1,46290,18724,3607,25365,0
66,3414,1296,573,1062,40,33,157,1336,8,201,118,231,209,349,1561,2689,4,12365,686,0,2,3,3,46290,18724,3607,25366,0
39,2355,652,304,544,16,6,88,668,6,89,51,101,95,152,591,998,3,3399,188,0,2,1,1,46290,18725,3607,25367,0
64,2957,1455,414,1257,16,76,112,1471,5,41,23,46,46,69,231,381,2,1069,59,0,2,1,1,46290,18726,3607,25368,0
8,273,74,35,59,1,0,14,75,3,14,7,14,17,21,58,85,1,128,7,0,2,1,1,46290,18727,3607,25369,0
35,1623,1293,570,1093,25,15,163,1318,10,195,123,241,205,364,1516,2795,6,17273,959,0,2,2,2,46300,18729,3607,25370,0
36,1978,384,251,317,7,8,52,391,11,70,44,84,81,128,467,811,6,5355,297,0,2,3,3,46300,18729,3607,25371,0
16,1209,215,129,180,6,0,29,221,8,65,43,72,73,115,415,711,4,3153,175,0,2,1,1,46300,18729,3607,25372,0
69,2856,1043,504,840,53,9,147,1096,9,180,112,198,189,310,1377,2344,4,11604,644,0,2,22,22,46300,18731,3607,25373,0
25,1027,373,158,315,8,0,51,381,5,76,44,79,81,123,486,779,2,2026,112,0,2,5,5,46300,18731,3607,25374,0
71,3006,1178,367,1042,6,15,115,1184,9,94,51,95,103,146,644,976,4,4439,246,0,2,3,3,46300,18731,3607,25375,0
74,3770,1943,715,1694,26,18,214,1969,12,185,120,237,197,357,1436,2721,7,20915,1161,0,2,3,3,46300,18733,3607,25376,0
54,1161,207,111,150,11,0,50,218,5,26,19,36,31,55,133,272,3,943,52,0,2,2,2,46300,18733,3607,25377,1
54,1161,410,198,237,31,55,97,441,11,63,38,72,74,110,414,683,6,4293,238,0,2,2,2,46310,18734,3608,25378,1
39,2355,652,304,544,16,6,88,668,6,89,51,101,95,152,591,998,3,3399,188,0,2,3,3,46310,18735,3608,25379,1
40,2367,334,251,279,10,4,40,344,5,127,74,143,132,217,899,1528,2,4303,239,0,2,1,1,46310,18736,3608,25380,1
78,4093,1457,730,1242,11,6,188,1468,10,292,166,329,302,495,2424,4078,5,22973,1276,1,2,1,1,46310,18738,3608,25381,0
9,228,19,8,11,5,0,4,24,2,5,3,6,7,9,13,25,1,30,1,0,2,1,0,46310,18738,3608,25382,0
9,228,102,59,69,5,3,24,107,6,22,15,28,28,43,113,206,3,789,43,0,2,1,0,46310,18738,3608,25383,0
9,228,106,40,36,3,49,17,109,8,17,13,23,25,36,93,167,5,904,50,0,2,1,0,46310,18738,3608,25384,0
213,4595,182,127,129,0,0,53,182,5,39,21,42,44,63,217,343,2,926,51,0,2,2,0,46310,18738,3609,25385,0
213,4595,1165,710,800,67,119,181,1232,18,243,153,282,261,435,2000,3492,10,36473,2026,1,2,2,0,46320,18738,3610,25386,0
101,2081,773,419,590,28,0,166,801,10,204,113,217,214,330,1598,2554,5,13587,754,0,2,1,0,46320,18738,3611,25387,0
101,2081,421,273,302,44,34,57,465,17,81,59,107,98,166,583,1098,11,12329,684,0,2,1,0,46320,18738,3612,25388,0
60,1265,996,429,845,24,10,117,1020,7,76,50,88,83,138,494,879,4,3565,198,0,2,1,0,46320,18740,3612,25389,0
60,1265,456,277,329,12,42,72,468,13,85,50,97,98,147,592,972,7,7212,400,0,2,1,0,46320,18740,3612,25390,0
128,2606,1513,682,1277,25,13,200,1538,11,199,116,219,210,335,1557,2584,6,15641,868,0,2,1,0,46320,18742,3612,25391,0
128,2606,819,519,539,24,98,155,843,15,96,57,106,111,163,690,1107,8,9171,509,0,2,1,0,46330,18744,3612,25392,0
349,7049,1457,730,1242,11,6,188,1468,10,292,166,329,302,495,2424,4078,5,22973,1276,1,2,5,0,46330,18746,3612,25393,0
349,7049,74,35,59,1,0,14,75,3,14,7,14,17,21,58,85,1,128,7,0,2,5,0,46330,18747,3612,25394,0
349,7049,245,125,200,5,7,34,250,7,30,17,34,37,51,166,265,3,1053,58,0,2,5,0,46340,18748,3612,25395,0
227,5129,4293,999,3693,19,54,507,4312,9,155,88,170,164,258,1156,1898,4,9368,520,0,2,3,0,46340,18750,3612,25396,0
227,5129,1482,859,1002,125,135,219,1607,16,219,134,251,235,385,1766,3032,9,27804,1544,1,2,3,0,46350,18751,3612,25397,0
80,1581,1020,354,843,12,15,144,1032,8,134,77,144,142,221,970,1580,4,6792,377,0,2,4,0,46350,18751,3612,25398,0
212,5047,722,423,573,19,0,135,741,12,172,101,199,184,300,1320,2257,6,15668,870,0,2,2,0,46350,18753,3612,25400,0
212,5047,1508,847,911,44,250,301,1552,14,148,88,169,162,257,1120,1886,7,15077,837,0,2,2,0,46350,18754,3613,25401,0
310,7160,72,33,56,0,4,12,72,1,1,1,1,2,2,0,2,0,1,0,0,2,3,0,46350,18754,3613,25402,0
310,7160,1454,835,1044,76,110,219,1530,17,275,158,296,292,454,2297,3718,9,34017,1889,1,2,3,0,46360,18755,3613,25403,0
127,2807,1043,504,840,53,9,147,1096,9,180,112,198,189,310,1377,2344,4,11604,644,0,2,7,0,46360,18757,3613,25404,0
127,2807,383,288,292,26,6,62,409,11,65,38,67,76,105,429,656,5,3719,206,0,2,7,0,46360,18758,3613,25405,0
192,3908,1943,715,1694,26,18,214,1969,12,185,120,237,197,357,1436,2721,7,20915,1161,0,2,1,0,46360,18760,3613,25406,0
192,3908,1168,838,957,57,25,144,1225,19,348,224,416,367,640,3018,5452,11,61921,3440,1,2,1,0,46370,18762,3613,25407,0
80,3427,1289,550,1043,56,32,155,1345,10,167,93,185,177,278,1266,2075,5,11498,638,0,2,1,0,46370,18764,3614,25408,0
147,6814,1392,870,1177,35,17,170,1427,14,494,280,531,508,811,4473,7289,7,54850,3047,2,2,5,0,46370,18767,3615,25409,0
91,3010,773,419,590,28,0,166,801,10,204,113,217,214,330,1598,2554,5,13587,754,0,2,1,0,46370,18767,3616,25410,0
112,5710,1782,648,1425,9,47,279,1791,8,171,97,189,179,286,1292,2140,4,9462,525,0,2,1,0,46370,18768,3617,25411,0
23,601,102,59,69,5,3,24,107,6,22,15,28,28,43,113,206,3,789,43,0,2,1,0,46370,18768,3617,25412,0
15,638,722,423,573,19,0,135,741,12,172,101,199,184,300,1320,2257,6,15668,870,0,2,1,0,46370,18770,3617,25414,0
74,3770,1943,715,1694,26,18,214,1969,12,185,120,237,197,357,1436,2721,7,20915,1161,0,2,1,0,46370,18772,3617,25415,0
9,228,19,8,11,5,0,4,24,2,5,3,6,7,9,13,25,1,30,1,0,2,1,0,46370,18772,3617,25416,0
9,228,102,59,69,5,3,24,107,6,22,15,28,28,43,113,206,3,789,43,0,2,1,0,46370,18772,3617,25417,0
9,228,106,40,36,3,49,17,109,8,17,13,23,25,36,93,167,5,904,50,0,2,1,0,46370,18772,3617,25418,0
213,4595,182,127,129,0,0,53,182,5,39,21,42,44,63,217,343,2,926,51,0,2,11,0,46370,18772,3618,25419,0
213,4595,1165,710,800,67,119,181,1232,18,243,153,282,261,435,2000,3492,10,36473,2026,1,2,11,0,46380,18772,3619,25420,0
101,2081,773,419,590,28,0,166,801,10,204,113,217,214,330,1598,2554,5,13587,754,0,2,2,0,46380,18772,3620,25421,0
101,2081,421,273,302,44,34,57,465,17,81,59,107,98,166,583,1098,11,12329,684,0,2,2,0,46380,18772,3621,25422,0
163,5080,1660,832,1314,41,38,274,1701,20,312,209,395,332,604,2671,5058,12,64042,3557,1,2,7,0,46380,18774,3622,25424,0
163,5080,1057,646,719,113,100,145,1170,18,215,134,248,233,382,1740,3004,10,31186,1732,1,2,7,0,46390,18775,3623,25425,0
128,2606,1513,682,1277,25,13,200,1538,11,199,116,219,210,335,1557,2584,6,15641,868,0,2,3,0,46390,18777,3623,25426,0
128,2606,819,519,539,24,98,155,843,15,96,57,106,111,163,690,1107,8,9171,509,0,2,3,0,46400,18779,3623,25427,0
54,1161,207,111,150,11,0,50,218,5,26,19,36,31,55,133,272,3,943,52,0,2,1,0,46400,18779,3623,25428,0
54,1161,410,198,237,31,55,97,441,11,63,38,72,74,110,414,683,6,4293,238,0,2,1,0,46410,18780,3624,25429,0
349,7049,1457,730,1242,11,6,188,1468,10,292,166,329,302,495,2424,4078,5,22973,1276,1,2,8,0,46410,18782,3624,25430,0
349,7049,74,35,59,1,0,14,75,3,14,7,14,17,21,58,85,1,128,7,0,2,8,0,46410,18783,3624,25431,0
349,7049,245,125,200,5,7,34,250,7,30,17,34,37,51,166,265,3,1053,58,0,2,8,0,46420,18784,3624,25432,0
21,662,339,213,244,17,9,65,356,10,42,26,48,52,74,259,421,5,2410,133,0,2,1,0,46430,18784,3624,25433,0
60,1673,1455,414,1257,16,76,112,1471,5,41,23,46,46,69,231,381,2,1069,59,0,2,2,0,46430,18785,3624,25434,0
60,1673,669,365,481,22,61,110,691,15,103,63,122,118,185,747,1273,8,11311,628,0,2,2,0,46440,18785,3625,25435,0
227,5129,4293,999,3693,19,54,507,4312,9,155,88,170,164,258,1156,1898,4,9368,520,0,2,5,0,46440,18787,3625,25436,0
227,5129,1482,859,1002,125,135,219,1607,16,219,134,251,235,385,1766,3032,9,27804,1544,1,2,5,0,46450,18788,3625,25437,0
27,954,74,35,59,1,0,14,75,3,14,7,14,17,21,58,85,1,128,7,0,2,4,0,46450,18789,3625,25438,0
27,954,245,125,200,5,7,34,250,7,30,17,34,37,51,166,265,3,1053,58,0,2,4,0,46460,18790,3625,25439,0
49,575,647,139,84,35,284,233,682,0,0,0,0,0,0,0,0,0,0,0,0,2,45,0,46460,18790,3625,25440,0
178,4130,77,34,69,0,0,8,77,3,24,16,29,27,45,114,213,1,387,21,0,2,8,0,46460,18790,3625,25441,0
178,4130,712,438,573,51,9,84,763,14,102,71,128,116,199,733,1364,8,11988,666,0,2,8,0,46470,18791,3625,25442,0
80,1581,1020,354,843,12,15,144,1032,8,134,77,144,142,221,970,1580,4,6792,377,0,2,1,0,46470,18791,3625,25443,0
23,388,424,94,331,4,0,89,428,1,5,5,5,6,10,11,25,0,12,0,0,2,1,0,46470,18792,3625,25444,0
23,388,38,23,23,6,0,8,44,3,11,7,11,14,18,42,68,1,102,5,0,2,1,0,46470,18792,3625,25445,0
212,5047,722,423,573,19,0,135,741,12,172,101,199,184,300,1320,2257,6,15668,870,0,2,8,0,46470,18794,3625,25447,0
212,5047,1508,847,911,44,250,301,1552,14,148,88,169,162,257,1120,1886,7,15077,837,0,2,8,0,46470,18795,3626,25448,0
310,7160,72,33,56,0,4,12,72,1,1,1,1,2,2,0,2,0,1,0,0,2,8,0,46470,18795,3626,25449,0
310,7160,1454,835,1044,76,110,219,1530,17,275,158,296,292,454,2297,3718,9,34017,1889,1,2,8,0,46480,18796,3626,25450,0
30,649,215,129,180,6,0,29,221,8,65,43,72,73,115,415,711,4,3153,175,0,2,5,0,46480,18796,3626,25451,0
30,649,97,69,77,3,3,16,100,6,22,13,23,28,36,113,173,3,542,30,0,2,5,0,46480,18797,3626,25452,0
127,2807,1043,504,840,53,9,147,1096,9,180,112,198,189,310,1377,2344,4,11604,644,0,2,26,1,46480,18799,3626,25453,0
127,2807,383,288,292,26,6,62,409,11,65,38,67,76,105,429,656,5,3719,206,0,2,26,1,46480,18800,3626,25454,0
103,1953,1178,367,1042,6,15,115,1184,9,94,51,95,103,146,644,976,4,4439,246,0,2,5,0,46480,18800,3626,25455,0
103,1953,177,108,140,8,0,27,185,6,30,16,32,36,48,162,248,3,794,44,0,2,5,0,46480,18802,3626,25456,0
192,3908,1943,715,1694,26,18,214,1969,12,185,120,237,197,357,1436,2721,7,20915,1161,0,2,6,0,46480,18804,3626,25457,0
192,3908,1168,838,957,57,25,144,1225,19,348,224,416,367,640,3018,5452,11,61921,3440,1,2,6,0,46490,18806,3626,25458,0
34,997,182,127,129,0,0,53,182,5,39,21,42,44,63,217,343,2,926,51,0,2,8,0,46490,18806,3627,25459,0
147,6814,1392,870,1177,35,17,170,1427,14,494,280,531,508,811,4473,7289,7,54850,3047,2,2,20,0,46490,18809,3628,25460,0
91,3010,773,419,590,28,0,166,801,10,204,113,217,214,330,1598,2554,5,13587,754,0,2,37,0,46490,18809,3629,25461,0
2,26,6,4,4,0,0,2,6,1,4,2,4,5,6,8,13,0,6,0,0,2,1,0,46490,18809,3629,25461,0
96,4365,1338,495,1086,10,64,173,1348,11,122,82,157,133,239,883,1686,7,11934,663,0,2,3,0,46490,18811,3629,25462,0
148,6832,139,89,101,2,0,35,141,7,54,34,62,61,96,330,569,4,2287,127,0,2,8,0,46490,18811,3629,25463,0
148,6832,7,5,5,0,0,2,7,1,2,1,2,3,3,2,4,0,2,0,0,2,8,0,46490,18811,3629,25464,0
32,948,465,148,393,5,8,60,470,4,31,20,31,35,51,161,261,2,523,29,0,2,2,0,46490,18812,3629,25465,0
32,948,16,12,9,0,0,6,16,1,2,1,2,3,3,2,4,0,2,0,0,2,2,0,46490,18812,3629,25466,0
23,601,102,59,69,5,3,24,107,6,22,15,28,28,43,113,206,3,789,43,0,2,5,0,46490,18812,3629,25467,0
109,4106,1450,624,1228,12,26,181,1462,14,306,186,354,320,540,2580,4493,8,36391,2021,1,2,17,0,46490,18814,3630,25468,0
150,4203,1660,832,1314,41,38,274,1701,20,312,209,395,332,604,2671,5058,12,64042,3557,1,2,2,0,46490,18816,3631,25470,0
117,4645,1513,682,1277,25,13,200,1538,11,199,116,219,210,335,1557,2584,6,15641,868,0,2,5,0,46490,18818,3631,25471,0
66,3414,1296,573,1062,40,33,157,1336,8,201,118,231,209,349,1561,2689,4,12365,686,0,2,6,0,46490,18818,3631,25472,0
78,4093,1457,730,1242,11,6,188,1468,10,292,166,329,302,495,2424,4078,5,22973,1276,1,2,7,0,46490,18820,3631,25473,0
39,2355,652,304,544,16,6,88,668,6,89,51,101,95,152,591,998,3,3399,188,0,2,15,0,46490,18821,3631,25474,0
8,273,74,35,59,1,0,14,75,3,14,7,14,17,21,58,85,1,128,7,0,2,7,0,46490,18822,3631,25475,0
90,4427,1523,757,1297,19,12,193,1542,12,193,117,230,205,347,1508,2664,7,19053,1058,0,2,3,0,46500,18824,3631,25476,0
68,2962,1020,354,843,12,15,144,1032,8,134,77,144,142,221,970,1580,4,6792,377,0,2,7,0,46500,18824,3631,25477,0
37,1624,447,308,343,6,5,95,453,7,96,59,111,103,170,651,1136,4,4600,255,0,2,1,0,46500,18827,3631,25478,0
21,661,424,94,331,4,0,89,428,1,5,5,5,6,10,11,25,0,12,0,0,2,10,0,46500,18828,3631,25479,0
40,2367,334,251,279,10,4,40,344,5,127,74,143,132,217,899,1528,2,4303,239,0,2,2,0,46500,18829,3631,25480,0
12,492,184,100,137,2,15,30,186,6,38,20,39,44,59,214,322,3,991,55,0,2,1,0,46500,18830,3631,25481,0
36,1978,384,251,317,7,8,52,391,11,70,44,84,81,128,467,811,6,5355,297,0,2,2,0,46500,18830,3631,25482,0
15,638,722,423,573,19,0,135,741,12,172,101,199,184,300,1320,2257,6,15668,870,0,2,3,0,46500,18832,3631,25484,0
16,1209,215,129,180,6,0,29,221,8,65,43,72,73,115,415,711,4,3153,175,0,2,2,0,46500,18832,3631,25485,0
69,2856,1043,504,840,53,9,147,1096,9,180,112,198,189,310,1377,2344,4,11604,644,0,2,15,0,46500,18834,3631,25486,0
14,529,295,56,236,0,4,54,295,2,9,5,10,11,15,30,51,1,57,3,0,2,12,0,46500,18836,3631,25487,0
25,1027,373,158,315,8,0,51,381,5,76,44,79,81,123,486,779,2,2026,112,0,2,5,0,46500,18836,3631,25488,0
71,3006,1178,367,1042,6,15,115,1184,9,94,51,95,103,146,644,976,4,4439,246,0,2,12,0,46500,18836,3631,25489,0
74,3770,1943,715,1694,26,18,214,1969,12,185,120,237,197,357,1436,2721,7,20915,1161,0,2,13,0,46500,18838,3631,25490,0
14,825,442,244,305,14,16,103,456,11,68,45,75,79,120,452,756,6,4588,254,0,2,5,0,46500,18840,3631,25491,0
48,1784,1098,241,925,5,10,155,1103,7,46,25,49,53,74,273,423,3,1580,87,0,2,23,0,46510,18842,3631,25492,0
12,476,601,196,481,2,23,85,603,8,63,36,72,71,108,400,664,4,3036,168,0,2,1,0,46510,18842,3631,25493,0
27,542,2,2,2,0,0,0,2,0,0,0,0,0,0,0,0,0,0,0,0,2,0,1,46510,18842,3631,25493,0
27,542,99,48,90,1,3,5,100,0,0,0,0,0,0,0,0,0,0,0,0,2,0,1,46510,18843,3631,25494,0
27,542,8,5,5,2,0,1,10,0,0,0,0,0,0,0,0,0,0,0,0,2,0,1,46510,18843,3631,25495,0
27,542,1217,716,841,84,126,174,1301,14,185,118,215,199,333,1446,2542,8,20687,1149,0,2,0,1,46520,18845,3631,25496,0
27,542,160,89,115,0,13,31,160,7,15,11,17,22,28,78,124,3,495,27,0,2,0,1,46520,18845,3631,25497,0
27,542,10,10,9,9,0,0,19,0,0,0,0,0,0,0,0,0,0,0,0,2,0,1,46520,18845,3632,25498,0
27,542,173,84,99,8,29,36,181,5,12,7,13,17,20,54,81,2,221,12,0,2,0,1,46520,18846,3632,25499,0
27,542,3,1,1,3,0,0,6,0,0,0,0,0,0,0,0,0,0,0,0,2,0,1,46520,18846,3632,25500,0
163,5080,1660,832,1314,41,38,274,1701,20,312,209,395,332,604,2671,5058,12,64042,3557,1,2,0,3,46520,18848,3633,25502,0
163,5080,1057,646,719,113,100,145,1170,18,215,134,248,233,382,1740,3004,10,31186,1732,1,2,0,3,46530,18849,3634,25503,0
60,1265,996,429,845,24,10,117,1020,7,76,50,88,83,138,494,879,4,3565,198,0,2,0,1,46530,18851,3634,25504,0
60,1265,456,277,329,12,42,72,468,13,85,50,97,98,147,592,972,7,7212,400,0,2,0,1,46530,18851,3634,25505,0
54,1161,207,111,150,11,0,50,218,5,26,19,36,31,55,133,272,3,943,52,0,2,0,2,46530,18851,3634,25506,0
54,1161,410,198,237,31,55,97,441,11,63,38,72,74,110,414,683,6,4293,238,0,2,0,2,46540,18852,3635,25507,0
349,7049,1457,730,1242,11,6,188,1468,10,292,166,329,302,495,2424,4078,5,22973,1276,1,2,0,1,46540,18854,3635,25508,0
349,7049,74,35,59,1,0,14,75,3,14,7,14,17,21,58,85,1,128,7,0,2,0,1,46540,18855,3635,25509,0
349,7049,245,125,200,5,7,34,250,7,30,17,34,37,51,166,265,3,1053,58,0,2,0,1,46550,18856,3635,25510,0
21,662,339,213,244,17,9,65,356,10,42,26,48,52,74,259,421,5,2410,133,0,2,0,1,46560,18856,3635,25511,0
227,5129,4293,999,3693,19,54,507,4312,9,155,88,170,164,258,1156,1898,4,9368,520,0,2,0,7,46560,18858,3635,25512,0
227,5129,1482,859,1002,125,135,219,1607,16,219,134,251,235,385,1766,3032,9,27804,1544,1,2,0,7,46570,18859,3635,25513,0
6,136,44,22,19,0,19,6,44,2,10,6,12,12,18,35,64,1,77,4,0,2,0,1,46570,18859,3635,25514,0
178,4130,77,34,69,0,0,8,77,3,24,16,29,27,45,114,213,1,387,21,0,2,0,2,46570,18859,3635,25515,0
178,4130,712,438,573,51,9,84,763,14,102,71,128,116,199,733,1364,8,11988,666,0,2,0,2,46580,18860,3635,25516,0
80,1581,1020,354,843,12,15,144,1032,8,134,77,144,142,221,970,1580,4,6792,377,0,2,0,4,46580,18860,3635,25517,0
212,5047,722,423,573,19,0,135,741,12,172,101,199,184,300,1320,2257,6,15668,870,0,2,0,1,46580,18862,3635,25519,0
212,5047,1508,847,911,44,250,301,1552,14,148,88,169,162,257,1120,1886,7,15077,837,0,2,0,1,46580,18863,3636,25520,0
310,7160,72,33,56,0,4,12,72,1,1,1,1,2,2,0,2,0,1,0,0,2,0,2,46580,18863,3636,25521,0
310,7160,1454,835,1044,76,110,219,1530,17,275,158,296,292,454,2297,3718,9,34017,1889,1,2,0,2,46590,18864,3636,25522,0
192,3908,1943,715,1694,26,18,214,1969,12,185,120,237,197,357,1436,2721,7,20915,1161,0,2,0,1,46590,18866,3636,25523,0
192,3908,1168,838,957,57,25,144,1225,19,348,224,416,367,640,3018,5452,11,61921,3440,1,2,0,1,46600,18868,3636,25524,0
80,3427,1289,550,1043,56,32,155,1345,10,167,93,185,177,278,1266,2075,5,11498,638,0,2,0,3,46600,18870,3637,25525,0
147,6814,1392,870,1177,35,17,170,1427,14,494,280,531,508,811,4473,7289,7,54850,3047,2,2,0,3,46600,18873,3638,25526,0
91,3010,773,419,590,28,0,166,801,10,204,113,217,214,330,1598,2554,5,13587,754,0,2,0,1,46600,18873,3639,25527,0
96,4365,1338,495,1086,10,64,173,1348,11,122,82,157,133,239,883,1686,7,11934,663,0,2,0,4,46600,18875,3639,25528,0
148,6832,139,89,101,2,0,35,141,7,54,34,62,61,96,330,569,4,2287,127,0,2,0,8,46600,18875,3639,25529,0
148,6832,7,5,5,0,0,2,7,1,2,1,2,3,3,2,4,0,2,0,0,2,0,8,46600,18875,3639,25530,0
112,5710,1782,648,1425,9,47,279,1791,8,171,97,189,179,286,1292,2140,4,9462,525,0,2,0,5,46600,18876,3640,25531,0
20,541,256,139,192,9,7,47,265,4,23,12,24,27,36,112,171,2,357,19,0,2,0,1,46600,18877,3640,25532,0
117,4645,1513,682,1277,25,13,200,1538,11,199,116,219,210,335,1557,2584,6,15641,868,0,2,0,2,46600,18879,3640,25533,0
66,3414,1296,573,1062,40,33,157,1336,8,201,118,231,209,349,1561,2689,4,12365,686,0,2,0,1,46600,18879,3640,25534,0
78,4093,1457,730,1242,11,6,188,1468,10,292,166,329,302,495,2424,4078,5,22973,1276,1,2,0,1,46600,18881,3640,25535,0
64,2957,1455,414,1257,16,76,112,1471,5,41,23,46,46,69,231,381,2,1069,59,0,2,0,1,46600,18882,3640,25536,0
68,2962,1020,354,843,12,15,144,1032,8,134,77,144,142,221,970,1580,4,6792,377,0,2,0,2,46600,18882,3640,25537,0
35,1623,1293,570,1093,25,15,163,1318,10,195,123,241,205,364,1516,2795,6,17273,959,0,2,0,2,46610,18884,3640,25538,0
38,1637,386,256,301,16,9,68,402,4,59,35,69,63,104,355,621,2,1453,80,0,2,0,1,46610,18884,3640,25539,0
71,3006,1178,367,1042,6,15,115,1184,9,94,51,95,103,146,644,976,4,4439,246,0,2,0,1,46610,18884,3640,25540,0
74,3770,1943,715,1694,26,18,214,1969,12,185,120,237,197,357,1436,2721,7,20915,1161,0,2,0,1,46610,18886,3640,25541,0
12,476,601,196,481,2,23,85,603,8,63,36,72,71,108,400,664,4,3036,168,0,2,0,1,46610,18886,3640,25542,0
101,2081,773,419,590,28,0,166,801,10,204,113,217,214,330,1598,2554,5,13587,754,0,2,2,1,46610,18886,3641,25543,0
101,2081,421,273,302,44,34,57,465,17,81,59,107,98,166,583,1098,11,12329,684,0,2,2,1,46610,18886,3642,25544,0
27,954,74,35,59,1,0,14,75,3,14,7,14,17,21,58,85,1,128,7,0,2,2,1,46610,18887,3642,25545,0
27,954,245,125,200,5,7,34,250,7,30,17,34,37,51,166,265,3,1053,58,0,2,2,1,46620,18888,3642,25546,0
23,601,102,59,69,5,3,24,107,6,22,15,28,28,43,113,206,3,789,43,0,2,2,1,46620,18888,3642,25547,0
66,3414,1296,573,1062,40,33,157,1336,8,201,118,231,209,349,1561,2689,4,12365,686,0,2,2,1,46620,18888,3642,25548,0
78,4093,1457,730,1242,11,6,188,1468,10,292,166,329,302,495,2424,4078,5,22973,1276,1,2,2,1,46620,18890,3642,25549,0
40,2367,334,251,279,10,4,40,344,5,127,74,143,132,217,899,1528,2,4303,239,0,2,2,1,46620,18891,3642,25550,0
147,6812,1392,870,1177,35,17,170,1427,14,494,280,531,508,811,4473,7289,7,54850,3047,2,2,4,4,46620,18894,3643,25551,0
150,4203,1660,832,1314,41,38,274,1701,20,312,209,395,332,604,2671,5058,12,64042,3557,1,2,6,6,46620,18896,3644,25553,0
349,7049,1457,730,1242,11,6,188,1468,10,292,166,329,302,495,2424,4078,5,22973,1276,1,2,2,1,46620,18898,3644,25554,1
349,7049,74,35,59,1,0,14,75,3,14,7,14,17,21,58,85,1,128,7,0,2,2,1,46620,18899,3644,25555,1
349,7049,245,125,200,5,7,34,250,7,30,17,34,37,51,166,265,3,1053,58,0,2,2,1,46630,18900,3644,25556,1
178,4132,77,34,69,0,0,8,77,3,24,16,29,27,45,114,213,1,387,21,0,2,4,2,46630,18900,3644,25557,1
178,4132,712,438,573,51,9,84,763,14,102,71,128,116,199,733,1364,8,11988,666,0,2,4,2,46640,18901,3644,25558,1
47,2498,520,294,400,33,13,81,553,10,261,204,367,271,571,2128,4614,7,32445,1802,1,2,2,1,46640,18902,3644,25559,1
112,5711,1782,648,1425,9,47,279,1791,8,171,97,189,179,286,1292,2140,4,9462,525,0,2,21,5,46640,18903,3645,25560,1
34,997,182,127,129,0,0,53,182,5,39,21,42,44,63,217,343,2,926,51,0,2,10,6,46640,18903,3646,25561,1
147,6812,1392,870,1177,35,17,170,1427,14,494,280,531,508,811,4473,7289,7,54850,3047,2,2,4,2,46640,18906,3647,25562,1
114,5711,1782,648,1425,9,47,279,1791,8,171,97,189,179,286,1292,2140,4,9462,525,0,2,4,2,46640,18907,3648,25563,1
38,1637,386,256,301,16,9,68,402,4,59,35,69,63,104,355,621,2,1453,80,0,2,4,2,46640,18907,3648,25564,1
10,228,19,8,11,5,0,4,24,2,5,3,6,7,9,13,25,1,30,1,0,2,2,1,46640,18907,3648,25565,1
10,228,102,59,69,5,3,24,107,6,22,15,28,28,43,113,206,3,789,43,0,2,2,1,46640,18907,3648,25566,1
10,228,106,40,36,3,49,17,109,8,17,13,23,25,36,93,167,5,904,50,0,2,2,1,46640,18907,3648,25567,1
153,6832,139,89,101,2,0,35,141,7,54,34,62,61,96,330,569,4,2287,127,0,2,10,5,46640,18907,3648,25568,1
153,6832,7,5,5,0,0,2,7,1,2,1,2,3,3,2,4,0,2,0,0,2,10,5,46640,18907,3648,25569,1
132,5711,1782,648,1425,9,47,279,1791,8,171,97,189,179,286,1292,2140,4,9462,525,0,2,48,24,46640,18908,3649,25570,1
72,2856,1043,504,840,53,9,147,1096,9,180,112,198,189,310,1377,2344,4,11604,644,0,2,10,5,46640,18910,3649,25571,1
227,5129,4293,999,3693,19,54,507,4312,9,155,88,170,164,258,1156,1898,4,9368,520,0,2,1,1,46640,18912,3649,25572,0
227,5129,1482,859,1002,125,135,219,1607,16,219,134,251,235,385,1766,3032,9,27804,1544,1,2,1,1,46650,18913,3649,25573,0
40,2367,334,251,279,10,4,40,344,5,127,74,143,132,217,899,1528,2,4303,239,0,2,4,4,46650,18914,3649,25574,0
102,2083,773,419,590,28,0,166,801,10,204,113,217,214,330,1598,2554,5,13587,754,0,2,2,1,46650,18914,3650,25575,0
102,2083,421,273,302,44,34,57,465,17,81,59,107,98,166,583,1098,11,12329,684,0,2,2,1,46650,18914,3651,25576,0
164,5082,1660,832,1314,41,38,274,1701,20,312,209,395,332,604,2671,5058,12,64042,3557,1,2,2,1,46650,18916,3652,25578,0
164,5082,1057,646,719,113,100,145,1170,18,215,134,248,233,382,1740,3004,10,31186,1732,1,2,2,1,46660,18917,3653,25579,0
86,1808,477,336,357,30,23,73,507,16,194,134,250,210,384,1538,2962,10,30538,1696,0,2,11,5,46670,18918,3653,25580,0
312,7164,72,33,56,0,4,12,72,1,1,1,1,2,2,0,2,0,1,0,0,2,6,2,46670,18918,3653,25581,0
312,7164,1454,835,1044,76,110,219,1530,17,275,158,296,292,454,2297,3718,9,34017,1889,1,2,6,2,46680,18919,3653,25582,0
26,1029,373,158,315,8,0,51,381,5,76,44,79,81,123,486,779,2,2026,112,0,2,4,1,46680,18919,3653,25583,0
339,7202,72,33,56,0,4,12,72,1,1,1,1,2,2,0,2,0,1,0,0,2,20,6,46680,18919,3653,25584,0
339,7202,1454,835,1044,76,110,219,1530,17,275,158,296,292,454,2297,3718,9,34017,1889,1,2,20,6,46690,18920,3653,25585,0
151,6958,139,89,101,2,0,35,141,7,54,34,62,61,96,330,569,4,2287,127,0,2,61,4,46690,18920,3653,25586,0
151,6958,7,5,5,0,0,2,7,1,2,1,2,3,3,2,4,0,2,0,0,2,61,4,46690,18920,3653,25587,0
10,228,19,8,11,5,0,4,24,2,5,3,6,7,9,13,25,1,30,1,0,2,5,2,46690,18920,3653,25588,0
10,228,102,59,69,5,3,24,107,6,22,15,28,28,43,113,206,3,789,43,0,2,5,2,46690,18920,3653,25589,0
10,228,106,40,36,3,49,17,109,8,17,13,23,25,36,93,167,5,904,50,0,2,5,2,46690,18920,3653,25590,0
213,4595,182,127,129,0,0,53,182,5,39,21,42,44,63,217,343,2,926,51,0,2,41,28,46690,18920,3654,25591,0
213,4595,1165,710,800,67,119,181,1232,18,243,153,282,261,435,2000,3492,10,36473,2026,1,2,41,28,46700,18920,3655,25592,0
102,2083,773,419,590,28,0,166,801,10,204,113,217,214,330,1598,2554,5,13587,754,0,2,24,22,46700,18920,3656,25593,0
102,2083,421,273,302,44,34,57,465,17,81,59,107,98,166,583,1098,11,12329,684,0,2,24,22,46700,18920,3657,25594,0
27,542,2,2,2,0,0,0,2,0,0,0,0,0,0,0,0,0,0,0,0,2,0,1,46700,18920,3657,25594,0
27,542,99,48,90,1,3,5,100,0,0,0,0,0,0,0,0,0,0,0,0,2,0,1,46700,18921,3657,25595,0
27,542,8,5,5,2,0,1,10,0,0,0,0,0,0,0,0,0,0,0,0,2,0,1,46700,18921,3657,25596,0
27,542,1217,716,841,84,126,174,1301,14,185,118,215,199,333,1446,2542,8,20687,1149,0,2,0,1,46710,18923,3657,25597,0
27,542,160,89,115,0,13,31,160,7,15,11,17,22,28,78,124,3,495,27,0,2,0,1,46710,18923,3657,25598,0
27,542,10,10,9,9,0,0,19,0,0,0,0,0,0,0,0,0,0,0,0,2,0,1,46710,18923,3658,25599,0
27,542,173,84,99,8,29,36,181,5,12,7,13,17,20,54,81,2,221,12,0,2,0,1,46710,18924,3658,25600,0
27,542,3,1,1,3,0,0,6,0,0,0,0,0,0,0,0,0,0,0,0,2,0,1,46710,18924,3658,25601,0
164,5082,1660,832,1314,41,38,274,1701,20,312,209,395,332,604,2671,5058,12,64042,3557,1,2,17,12,46710,18926,3659,25603,0
164,5082,1057,646,719,113,100,145,1170,18,215,134,248,233,382,1740,3004,10,31186,1732,1,2,17,12,46720,18927,3660,25604,0
86,1808,477,336,357,30,23,73,507,16,194,134,250,210,384,1538,2962,10,30538,1696,0,2,16,10,46730,18928,3660,25605,0
62,1345,996,429,845,24,10,117,1020,7,76,50,88,83,138,494,879,4,3565,198,0,2,3,3,46730,18930,3660,25606,0
62,1345,456,277,329,12,42,72,468,13,85,50,97,98,147,592,972,7,7212,400,0,2,3,3,46730,18930,3660,25607,0
128,2606,1513,682,1277,25,13,200,1538,11,199,116,219,210,335,1557,2584,6,15641,868,0,2,7,3,46730,18932,3660,25608,0
128,2606,819,519,539,24,98,155,843,15,96,57,106,111,163,690,1107,8,9171,509,0,2,7,3,46740,18934,3660,25609,0
54,1166,207,111,150,11,0,50,218,5,26,19,36,31,55,133,272,3,943,52,0,2,7,8,46740,18934,3660,25610,0
54,1166,410,198,237,31,55,97,441,11,63,38,72,74,110,414,683,6,4293,238,0,2,7,8,46750,18935,3661,25611,0
349,7049,1457,730,1242,11,6,188,1468,10,292,166,329,302,495,2424,4078,5,22973,1276,1,2,54,41,46750,18937,3661,25612,0
349,7049,74,35,59,1,0,14,75,3,14,7,14,17,21,58,85,1,128,7,0,2,54,41,46750,18938,3661,25613,0
349,7049,245,125,200,5,7,34,250,7,30,17,34,37,51,166,265,3,1053,58,0,2,54,41,46760,18939,3661,25614,0
21,662,339,213,244,17,9,65,356,10,42,26,48,52,74,259,421,5,2410,133,0,2,1,1,46770,18939,3661,25615,0
60,1673,1455,414,1257,16,76,112,1471,5,41,23,46,46,69,231,381,2,1069,59,0,2,19,17,46770,18940,3661,25617,0
60,1673,669,365,481,22,61,110,691,15,103,63,122,118,185,747,1273,8,11311,628,0,2,19,17,46780,18940,3662,25618,0
227,5129,4293,999,3693,19,54,507,4312,9,155,88,170,164,258,1156,1898,4,9368,520,0,2,32,32,46780,18942,3662,25619,0
227,5129,1482,859,1002,125,135,219,1607,16,219,134,251,235,385,1766,3032,9,27804,1544,1,2,32,32,46790,18943,3662,25620,0
6,136,44,22,19,0,19,6,44,2,10,6,12,12,18,35,64,1,77,4,0,2,0,1,46790,18943,3662,25621,0
27,954,74,35,59,1,0,14,75,3,14,7,14,17,21,58,85,1,128,7,0,2,25,20,46790,18944,3662,25622,0
27,954,245,125,200,5,7,34,250,7,30,17,34,37,51,166,265,3,1053,58,0,2,25,20,46800,18945,3662,25623,0
49,575,647,139,84,35,284,233,682,0,0,0,0,0,0,0,0,0,0,0,0,2,45,0,46800,18945,3662,25624,0
83,2359,1523,757,1297,19,12,193,1542,12,193,117,230,205,347,1508,2664,7,19053,1058,0,2,6,6,46810,18947,3662,25625,0
83,2359,701,378,504,33,58,109,734,13,110,68,126,123,194,794,1346,7,10027,557,0,2,6,6,46810,18948,3663,25626,0
178,4132,77,34,69,0,0,8,77,3,24,16,29,27,45,114,213,1,387,21,0,2,57,34,46810,18948,3663,25627,0
178,4132,712,438,573,51,9,84,763,14,102,71,128,116,199,733,1364,8,11988,666,0,2,57,34,46820,18949,3663,25628,0
94,1809,1020,354,843,12,15,144,1032,8,134,77,144,142,221,970,1580,4,6792,377,0,2,6,2,46820,18949,3663,25629,0
46,955,447,308,343,6,5,95,453,7,96,59,111,103,170,651,1136,4,4600,255,0,2,3,3,46820,18952,3663,25630,0
46,955,322,174,179,16,74,51,338,10,41,26,46,51,72,252,408,5,2291,127,0,2,3,3,46820,18955,3664,25631,0
23,388,424,94,331,4,0,89,428,1,5,5,5,6,10,11,25,0,12,0,0,2,3,2,46820,18956,3664,25632,0
23,388,38,23,23,6,0,8,44,3,11,7,11,14,18,42,68,1,102,5,0,2,3,2,46820,18956,3664,25633,0
17,518,184,100,137,2,15,30,186,6,38,20,39,44,59,214,322,3,991,55,0,2,4,4,46820,18957,3664,25634,0
17,518,103,65,74,8,5,16,111,7,17,9,17,24,26,89,119,3,417,23,0,2,4,4,46820,18958,3664,25635,0
212,5047,722,423,573,19,0,135,741,12,172,101,199,184,300,1320,2257,6,15668,870,0,2,47,38,46820,18960,3664,25637,0
212,5047,1508,847,911,44,250,301,1552,14,148,88,169,162,257,1120,1886,7,15077,837,0,2,47,38,46820,18961,3665,25638,0
304,7099,72,33,56,0,4,12,72,1,1,1,1,2,2,0,2,0,1,0,0,2,487,52,46820,18961,3665,25639,0
304,7099,1454,835,1044,76,110,219,1530,17,275,158,296,292,454,2297,3718,9,34017,1889,1,2,487,52,46830,18962,3665,25640,0
40,837,386,256,301,16,9,68,402,4,59,35,69,63,104,355,621,2,1453,80,0,2,2,2,46830,18962,3665,25641,0
40,837,264,131,164,11,41,46,275,6,38,22,40,44,62,214,338,3,1068,59,0,2,2,2,46840,18962,3666,25642,0
30,649,215,129,180,6,0,29,221,8,65,43,72,73,115,415,711,4,3153,175,0,2,9,4,46840,18962,3666,25643,0
30,649,97,69,77,3,3,16,100,6,22,13,23,28,36,113,173,3,542,30,0,2,9,4,46840,18963,3666,25644,0
127,2807,1043,504,840,53,9,147,1096,9,180,112,198,189,310,1377,2344,4,11604,644,0,2,53,21,46840,18965,3666,25645,0
127,2807,383,288,292,26,6,62,409,11,65,38,67,76,105,429,656,5,3719,206,0,2,53,21,46840,18966,3666,25646,0
103,1953,1178,367,1042,6,15,115,1184,9,94,51,95,103,146,644,976,4,4439,246,0,2,29,24,46840,18966,3666,25647,0
103,1953,177,108,140,8,0,27,185,6,30,16,32,36,48,162,248,3,794,44,0,2,29,24,46840,18968,3666,25648,0
192,3908,1943,715,1694,26,18,214,1969,12,185,120,237,197,357,1436,2721,7,20915,1161,0,2,38,29,46840,18970,3666,25649,0
192,3908,1168,838,957,57,25,144,1225,19,348,224,416,367,640,3018,5452,11,61921,3440,1,2,38,29,46850,18972,3666,25650,0
16,477,442,244,305,14,16,103,456,11,68,45,75,79,120,452,756,6,4588,254,0,2,2,2,46850,18974,3666,25651,0
16,477,182,102,99,11,40,35,193,3,11,6,11,14,17,42,64,1,97,5,0,2,2,2,46850,18975,3666,25652,0
62,1240,1098,241,925,5,10,155,1103,7,46,25,49,53,74,273,423,3,1580,87,0,2,3,3,46860,18977,3666,25653,0
62,1240,282,202,222,14,2,44,296,8,42,24,43,50,67,250,378,4,1548,86,0,2,3,3,46860,18978,3666,25654,0
19,408,601,196,481,2,23,85,603,8,63,36,72,71,108,400,664,4,3036,168,0,2,1,1,46860,18978,3666,25655,0
19,408,156,79,106,5,16,28,161,5,14,8,15,19,23,64,97,2,261,14,0,2,1,1,46860,18978,3666,25656,0
80,3427,1289,550,1043,56,32,155,1345,10,167,93,185,177,278,1266,2075,5,11498,638,0,2,11,13,46860,18980,3667,25657,0
34,997,182,127,129,0,0,53,182,5,39,21,42,44,63,217,343,2,926,51,0,2,18,6,46860,18980,3668,25658,0
147,6812,1392,870,1177,35,17,170,1427,14,494,280,531,508,811,4473,7289,7,54850,3047,2,2,67,43,46860,18983,3669,25659,0
91,3010,773,419,590,28,0,166,801,10,204,113,217,214,330,1598,2554,5,13587,754,0,2,59,19,46860,18983,3670,25660,0
7,278,75,38,59,1,3,12,76,2,4,2,4,6,6,10,15,1,15,0,0,2,4,0,46860,18983,3670,25661,0
2,26,6,4,4,0,0,2,6,1,4,2,4,5,6,8,13,0,6,0,0,2,2,1,46860,18983,3670,25663,0
53,3287,520,294,400,33,13,81,553,10,261,204,367,271,571,2128,4614,7,32445,1802,1,2,67,68,46860,18984,3670,25665,0
98,4425,1338,495,1086,10,64,173,1348,11,122,82,157,133,239,883,1686,7,11934,663,0,2,12,13,46860,18986,3670,25666,0
153,6832,139,89,101,2,0,35,141,7,54,34,62,61,96,330,569,4,2287,127,0,2,39,39,46860,18986,3670,25667,0
153,6832,7,5,5,0,0,2,7,1,2,1,2,3,3,2,4,0,2,0,0,2,39,39,46860,18986,3670,25668,0
32,948,465,148,393,5,8,60,470,4,31,20,31,35,51,161,261,2,523,29,0,2,5,3,46860,18987,3670,25669,0
32,948,16,12,9,0,0,6,16,1,2,1,2,3,3,2,4,0,2,0,0,2,5,3,46860,18987,3670,25670,0
132,5711,1782,648,1425,9,47,279,1791,8,171,97,189,179,286,1292,2140,4,9462,525,0,2,100,62,46860,18988,3671,25671,0
20,541,256,139,192,9,7,47,265,4,23,12,24,27,36,112,171,2,357,19,0,2,0,1,46860,18989,3671,25672,0
23,601,102,59,69,5,3,24,107,6,22,15,28,28,43,113,206,3,789,43,0,2,18,11,46860,18989,3671,25673,0
109,4106,1450,624,1228,12,26,181,1462,14,306,186,354,320,540,2580,4493,8,36391,2021,1,2,41,24,46860,18991,3672,25674,0
150,4203,1660,832,1314,41,38,274,1701,20,312,209,395,332,604,2671,5058,12,64042,3557,1,2,22,20,46860,18993,3673,25676,0
117,4645,1513,682,1277,25,13,200,1538,11,199,116,219,210,335,1557,2584,6,15641,868,0,2,8,5,46860,18995,3673,25677,0
66,3414,1296,573,1062,40,33,157,1336,8,201,118,231,209,349,1561,2689,4,12365,686,0,2,18,12,46860,18995,3673,25678,0
78,4093,1457,730,1242,11,6,188,1468,10,292,166,329,302,495,2424,4078,5,22973,1276,1,2,13,7,46860,18997,3673,25679,0
39,2355,652,304,544,16,6,88,668,6,89,51,101,95,152,591,998,3,3399,188,0,2,46,31,46860,18998,3673,25680,0
64,2957,1455,414,1257,16,76,112,1471,5,41,23,46,46,69,231,381,2,1069,59,0,2,9,11,46860,18999,3673,25681,0
8,273,74,35,59,1,0,14,75,3,14,7,14,17,21,58,85,1,128,7,0,2,8,1,46860,19000,3673,25682,0
90,4427,1523,757,1297,19,12,193,1542,12,193,117,230,205,347,1508,2664,7,19053,1058,0,2,3,1,46870,19002,3673,25683,0
70,3035,1020,354,843,12,15,144,1032,8,134,77,144,142,221,970,1580,4,6792,377,0,2,21,16,46870,19002,3673,25684,0
37,1624,447,308,343,6,5,95,453,7,96,59,111,103,170,651,1136,4,4600,255,0,2,2,1,46870,19005,3673,25685,0
21,661,424,94,331,4,0,89,428,1,5,5,5,6,10,11,25,0,12,0,0,2,10,0,46870,19006,3673,25686,0
40,2367,334,251,279,10,4,40,344,5,127,74,143,132,217,899,1528,2,4303,239,0,2,16,13,46870,19007,3673,25687,0
12,492,184,100,137,2,15,30,186,6,38,20,39,44,59,214,322,3,991,55,0,2,3,4,46870,19008,3673,25688,0
35,1623,1293,570,1093,25,15,163,1318,10,195,123,241,205,364,1516,2795,6,17273,959,0,2,7,9,46880,19010,3673,25689,0
36,1978,384,251,317,7,8,52,391,11,70,44,84,81,128,467,811,6,5355,297,0,2,7,5,46880,19010,3673,25690,0
15,638,722,423,573,19,0,135,741,12,172,101,199,184,300,1320,2257,6,15668,870,0,2,4,0,46880,19012,3673,25692,0
38,1637,386,256,301,16,9,68,402,4,59,35,69,63,104,355,621,2,1453,80,0,2,4,3,46880,19012,3673,25693,0
16,1209,215,129,180,6,0,29,221,8,65,43,72,73,115,415,711,4,3153,175,0,2,10,10,46880,19012,3673,25694,0
72,2856,1043,504,840,53,9,147,1096,9,180,112,198,189,310,1377,2344,4,11604,644,0,2,56,38,46880,19014,3673,25695,0
14,529,295,56,236,0,4,54,295,2,9,5,10,11,15,30,51,1,57,3,0,2,13,1,46880,19016,3673,25696,0
26,1029,373,158,315,8,0,51,381,5,76,44,79,81,123,486,779,2,2026,112,0,2,16,8,46880,19016,3673,25697,0
71,3006,1178,367,1042,6,15,115,1184,9,94,51,95,103,146,644,976,4,4439,246,0,2,18,7,46880,19016,3673,25698,0
74,3770,1943,715,1694,26,18,214,1969,12,185,120,237,197,357,1436,2721,7,20915,1161,0,2,34,21,46880,19018,3673,25699,0
14,825,442,244,305,14,16,103,456,11,68,45,75,79,120,452,756,6,4588,254,0,2,5,0,46880,19020,3673,25700,0
48,1784,1098,241,925,5,10,155,1103,7,46,25,49,53,74,273,423,3,1580,87,0,2,24,1,46890,19022,3673,25701,0
12,476,601,196,481,2,23,85,603,8,63,36,72,71,108,400,664,4,3036,168,0,2,3,3,46890,19022,3673,25702,0
94,1809,1020,354,843,12,15,144,1032,8,134,77,144,142,221,970,1580,4,6792,377,0,2,2,0,46890,19022,3673,25704,1
304,7104,72,33,56,0,4,12,72,1,1,1,1,2,2,0,2,0,1,0,0,2,5,1,46890,19022,3673,25705,1
304,7104,1454,835,1044,76,110,219,1530,17,275,158,296,292,454,2297,3718,9,34017,1889,1,2,5,1,46900,19023,3673,25706,1
77,1522,757,253,292,73,244,162,830,13,61,38,67,74,105,409,651,7,4654,258,0,2,7,6,46900,19024,3673,25707,1
147,6812,1392,870,1177,35,17,170,1427,14,494,280,531,508,811,4473,7289,7,54850,3047,2,2,8,8,46900,19027,3674,25708,1
91,3010,773,419,590,28,0,166,801,10,204,113,217,214,330,1598,2554,5,13587,754,0,2,3,4,46900,19027,3675,25709,1
53,3287,520,294,400,33,13,81,553,10,261,204,367,271,571,2128,4614,7,32445,1802,1,2,15,14,46900,19028,3675,25710,1
98,4425,1338,495,1086,10,64,173,1348,11,122,82,157,133,239,883,1686,7,11934,663,0,2,1,1,46900,19030,3675,25711,1
117,4645,1513,682,1277,25,13,200,1538,11,199,116,219,210,335,1557,2584,6,15641,868,0,2,13,13,46900,19032,3675,25712,1
39,2355,652,304,544,16,6,88,668,6,89,51,101,95,152,591,998,3,3399,188,0,2,2,2,46900,19033,3675,25713,1
70,3035,1020,354,843,12,15,144,1032,8,134,77,144,142,221,970,1580,4,6792,377,0,2,1,2,46900,19033,3675,25714,1
72,2856,1043,504,840,53,9,147,1096,9,180,112,198,189,310,1377,2344,4,11604,644,0,2,2,2,46900,19035,3675,25715,1
94,1795,1020,354,843,12,15,144,1032,8,134,77,144,142,221,970,1580,4,6792,377,0,2,4,4,46900,19035,3675,25716,0
94,1795,1020,354,843,12,15,144,1032,8,134,77,144,142,221,970,1580,4,6792,377,0,2,4,4,46900,19035,3675,25717,0
129,2875,1043,504,840,53,9,147,1096,9,180,112,198,189,310,1377,2344,4,11604,644,0,2,19,0,46900,19037,3675,25718,1
129,2875,383,288,292,26,6,62,409,11,65,38,67,76,105,429,656,5,3719,206,0,2,19,0,46900,19038,3675,25719,1
70,2942,1043,504,840,53,9,147,1096,9,180,112,198,189,310,1377,2344,4,11604,644,0,2,27,0,46900,19040,3675,25720,1
129,2875,1043,504,840,53,9,147,1096,9,180,112,198,189,310,1377,2344,4,11604,644,0,2,19,0,46900,19042,3675,25721,0
129,2875,383,288,292,26,6,62,409,11,65,38,67,76,105,429,656,5,3719,206,0,2,19,0,46900,19043,3675,25722,0
70,2942,1043,504,840,53,9,147,1096,9,180,112,198,189,310,1377,2344,4,11604,644,0,2,27,0,46900,19045,3675,25723,0
10,228,19,8,11,5,0,4,24,2,5,3,6,7,9,13,25,1,30,1,0,2,5,2,46900,19045,3675,25724,0
10,228,102,59,69,5,3,24,107,6,22,15,28,28,43,113,206,3,789,43,0,2,5,2,46900,19045,3675,25725,0
10,228,106,40,36,3,49,17,109,8,17,13,23,25,36,93,167,5,904,50,0,2,5,2,46900,19045,3675,25726,0
213,4595,182,127,129,0,0,53,182,5,39,21,42,44,63,217,343,2,926,51,0,2,41,28,46900,19045,3676,25727,0
213,4595,1165,710,800,67,119,181,1232,18,243,153,282,261,435,2000,3492,10,36473,2026,1,2,41,28,46910,19045,3677,25728,0
102,2083,773,419,590,28,0,166,801,10,204,113,217,214,330,1598,2554,5,13587,754,0,2,24,22,46910,19045,3678,25729,0
102,2083,421,273,302,44,34,57,465,17,81,59,107,98,166,583,1098,11,12329,684,0,2,24,22,46910,19045,3679,25730,0
27,542,2,2,2,0,0,0,2,0,0,0,0,0,0,0,0,0,0,0,0,2,0,1,46910,19045,3679,25730,0
27,542,99,48,90,1,3,5,100,0,0,0,0,0,0,0,0,0,0,0,0,2,0,1,46910,19046,3679,25731,0
27,542,8,5,5,2,0,1,10,0,0,0,0,0,0,0,0,0,0,0,0,2,0,1,46910,19046,3679,25732,0
27,542,1217,716,841,84,126,174,1301,14,185,118,215,199,333,1446,2542,8,20687,1149,0,2,0,1,46920,19048,3679,25733,0
27,542,160,89,115,0,13,31,160,7,15,11,17,22,28,78,124,3,495,27,0,2,0,1,46920,19048,3679,25734,0
27,542,10,10,9,9,0,0,19,0,0,0,0,0,0,0,0,0,0,0,0,2,0,1,46920,19048,3680,25735,0
27,542,173,84,99,8,29,36,181,5,12,7,13,17,20,54,81,2,221,12,0,2,0,1,46920,19049,3680,25736,0
27,542,3,1,1,3,0,0,6,0,0,0,0,0,0,0,0,0,0,0,0,2,0,1,46920,19049,3680,25737,0
164,5082,1660,832,1314,41,38,274,1701,20,312,209,395,332,604,2671,5058,12,64042,3557,1,2,17,12,46920,19051,3681,25739,0
164,5082,1057,646,719,113,100,145,1170,18,215,134,248,233,382,1740,3004,10,31186,1732,1,2,17,12,46930,19052,3682,25740,0
86,1808,477,336,357,30,23,73,507,16,194,134,250,210,384,1538,2962,10,30538,1696,0,2,16,10,46940,19053,3682,25741,0
60,1265,996,429,845,24,10,117,1020,7,76,50,88,83,138,494,879,4,3565,198,0,2,3,3,46940,19055,3682,25742,0
60,1265,456,277,329,12,42,72,468,13,85,50,97,98,147,592,972,7,7212,400,0,2,3,3,46940,19055,3682,25743,0
128,2606,1513,682,1277,25,13,200,1538,11,199,116,219,210,335,1557,2584,6,15641,868,0,2,7,3,46940,19057,3682,25744,0
128,2606,819,519,539,24,98,155,843,15,96,57,106,111,163,690,1107,8,9171,509,0,2,7,3,46950,19059,3682,25745,0
54,1161,207,111,150,11,0,50,218,5,26,19,36,31,55,133,272,3,943,52,0,2,7,8,46950,19059,3682,25746,0
54,1161,410,198,237,31,55,97,441,11,63,38,72,74,110,414,683,6,4293,238,0,2,7,8,46960,19060,3683,25747,0
349,7049,1457,730,1242,11,6,188,1468,10,292,166,329,302,495,2424,4078,5,22973,1276,1,2,54,41,46960,19062,3683,25748,0
349,7049,74,35,59,1,0,14,75,3,14,7,14,17,21,58,85,1,128,7,0,2,54,41,46960,19063,3683,25749,0
349,7049,245,125,200,5,7,34,250,7,30,17,34,37,51,166,265,3,1053,58,0,2,54,41,46970,19064,3683,25750,0
21,662,339,213,244,17,9,65,356,10,42,26,48,52,74,259,421,5,2410,133,0,2,1,1,46980,19064,3683,25751,0
60,1673,1455,414,1257,16,76,112,1471,5,41,23,46,46,69,231,381,2,1069,59,0,2,19,17,46980,19065,3683,25753,0
60,1673,669,365,481,22,61,110,691,15,103,63,122,118,185,747,1273,8,11311,628,0,2,19,17,46990,19065,3684,25754,0
227,5129,4293,999,3693,19,54,507,4312,9,155,88,170,164,258,1156,1898,4,9368,520,0,2,32,32,46990,19067,3684,25755,0
227,5129,1482,859,1002,125,135,219,1607,16,219,134,251,235,385,1766,3032,9,27804,1544,1,2,32,32,47000,19068,3684,25756,0
6,136,44,22,19,0,19,6,44,2,10,6,12,12,18,35,64,1,77,4,0,2,0,1,47000,19068,3684,25757,0
27,954,74,35,59,1,0,14,75,3,14,7,14,17,21,58,85,1,128,7,0,2,25,20,47000,19069,3684,25758,0
27,954,245,125,200,5,7,34,250,7,30,17,34,37,51,166,265,3,1053,58,0,2,25,20,47010,19070,3684,25759,0
49,575,647,139,84,35,284,233,682,0,0,0,0,0,0,0,0,0,0,0,0,2,45,0,47010,19070,3684,25760,0
83,2359,1523,757,1297,19,12,193,1542,12,193,117,230,205,347,1508,2664,7,19053,1058,0,2,6,6,47020,19072,3684,25761,0
83,2359,701,378,504,33,58,109,734,13,110,68,126,123,194,794,1346,7,10027,557,0,2,6,6,47020,19073,3685,25762,0
178,4132,77,34,69,0,0,8,77,3,24,16,29,27,45,114,213,1,387,21,0,2,42,34,47020,19073,3685,25763,0
178,4132,712,438,573,51,9,84,763,14,102,71,128,116,199,733,1364,8,11988,666,0,2,42,34,47030,19074,3685,25764,0
80,1581,1020,354,843,12,15,144,1032,8,134,77,144,142,221,970,1580,4,6792,377,0,2,6,5,47030,19074,3685,25765,0
46,955,447,308,343,6,5,95,453,7,96,59,111,103,170,651,1136,4,4600,255,0,2,3,3,47030,19077,3685,25766,0
46,955,322,174,179,16,74,51,338,10,41,26,46,51,72,252,408,5,2291,127,0,2,3,3,47030,19080,3686,25767,0
23,388,424,94,331,4,0,89,428,1,5,5,5,6,10,11,25,0,12,0,0,2,3,2,47030,19081,3686,25768,0
23,388,38,23,23,6,0,8,44,3,11,7,11,14,18,42,68,1,102,5,0,2,3,2,47030,19081,3686,25769,0
17,518,184,100,137,2,15,30,186,6,38,20,39,44,59,214,322,3,991,55,0,2,4,4,47030,19082,3686,25770,0
17,518,103,65,74,8,5,16,111,7,17,9,17,24,26,89,119,3,417,23,0,2,4,4,47030,19083,3686,25771,0
212,5047,722,423,573,19,0,135,741,12,172,101,199,184,300,1320,2257,6,15668,870,0,2,47,38,47030,19085,3686,25773,0
212,5047,1508,847,911,44,250,301,1552,14,148,88,169,162,257,1120,1886,7,15077,837,0,2,47,38,47030,19086,3687,25774,0
315,7206,72,33,56,0,4,12,72,1,1,1,1,2,2,0,2,0,1,0,0,2,66,54,47030,19086,3687,25775,0
315,7206,1454,835,1044,76,110,219,1530,17,275,158,296,292,454,2297,3718,9,34017,1889,1,2,66,54,47040,19087,3687,25776,0
40,837,386,256,301,16,9,68,402,4,59,35,69,63,104,355,621,2,1453,80,0,2,2,2,47040,19087,3687,25777,0
40,837,264,131,164,11,41,46,275,6,38,22,40,44,62,214,338,3,1068,59,0,2,2,2,47050,19087,3688,25778,0
30,649,215,129,180,6,0,29,221,8,65,43,72,73,115,415,711,4,3153,175,0,2,9,4,47050,19087,3688,25779,0
30,649,97,69,77,3,3,16,100,6,22,13,23,28,36,113,173,3,542,30,0,2,9,4,47050,19088,3688,25780,0
127,2807,1043,504,840,53,9,147,1096,9,180,112,198,189,310,1377,2344,4,11604,644,0,2,53,21,47050,19090,3688,25781,0
127,2807,383,288,292,26,6,62,409,11,65,38,67,76,105,429,656,5,3719,206,0,2,53,21,47050,19091,3688,25782,0
103,1953,1178,367,1042,6,15,115,1184,9,94,51,95,103,146,644,976,4,4439,246,0,2,29,24,47050,19091,3688,25783,0
103,1953,177,108,140,8,0,27,185,6,30,16,32,36,48,162,248,3,794,44,0,2,29,24,47050,19093,3688,25784,0
192,3908,1943,715,1694,26,18,214,1969,12,185,120,237,197,357,1436,2721,7,20915,1161,0,2,35,29,47050,19095,3688,25785,0
192,3908,1168,838,957,57,25,144,1225,19,348,224,416,367,640,3018,5452,11,61921,3440,1,2,35,29,47060,19097,3688,25786,0
16,477,442,244,305,14,16,103,456,11,68,45,75,79,120,452,756,6,4588,254,0,2,2,2,47060,19099,3688,25787,0
16,477,182,102,99,11,40,35,193,3,11,6,11,14,17,42,64,1,97,5,0,2,2,2,47060,19100,3688,25788,0
62,1240,1098,241,925,5,10,155,1103,7,46,25,49,53,74,273,423,3,1580,87,0,2,3,3,47070,19102,3688,25789,0
62,1240,282,202,222,14,2,44,296,8,42,24,43,50,67,250,378,4,1548,86,0,2,3,3,47070,19103,3688,25790,0
19,408,601,196,481,2,23,85,603,8,63,36,72,71,108,400,664,4,3036,168,0,2,1,1,47070,19103,3688,25791,0
19,408,156,79,106,5,16,28,161,5,14,8,15,19,23,64,97,2,261,14,0,2,1,1,47070,19103,3688,25792,0
80,3427,1289,550,1043,56,32,155,1345,10,167,93,185,177,278,1266,2075,5,11498,638,0,2,11,13,47070,19105,3689,25793,0
34,997,182,127,129,0,0,53,182,5,39,21,42,44,63,217,343,2,926,51,0,2,18,6,47070,19105,3690,25794,0
147,6812,1392,870,1177,35,17,170,1427,14,494,280,531,508,811,4473,7289,7,54850,3047,2,2,67,43,47070,19108,3691,25795,0
91,3010,773,419,590,28,0,166,801,10,204,113,217,214,330,1598,2554,5,13587,754,0,2,59,19,47070,19108,3692,25796,0
2,26,6,4,4,0,0,2,6,1,4,2,4,5,6,8,13,0,6,0,0,2,2,1,47070,19108,3692,25798,0
47,2498,520,294,400,33,13,81,553,10,261,204,367,271,571,2128,4614,7,32445,1802,1,2,80,80,47070,19109,3692,25800,0
96,4365,1338,495,1086,10,64,173,1348,11,122,82,157,133,239,883,1686,7,11934,663,0,2,12,13,47070,19111,3692,25801,0
156,6958,139,89,101,2,0,35,141,7,54,34,62,61,96,330,569,4,2287,127,0,2,39,39,47070,19111,3692,25802,0
156,6958,7,5,5,0,0,2,7,1,2,1,2,3,3,2,4,0,2,0,0,2,39,39,47070,19111,3692,25803,0
32,948,465,148,393,5,8,60,470,4,31,20,31,35,51,161,261,2,523,29,0,2,5,3,47070,19112,3692,25804,0
32,948,16,12,9,0,0,6,16,1,2,1,2,3,3,2,4,0,2,0,0,2,5,3,47070,19112,3692,25805,0
132,5711,1782,648,1425,9,47,279,1791,8,171,97,189,179,286,1292,2140,4,9462,525,0,2,100,62,47070,19113,3693,25806,0
20,541,256,139,192,9,7,47,265,4,23,12,24,27,36,112,171,2,357,19,0,2,0,1,47070,19114,3693,25807,0
23,601,102,59,69,5,3,24,107,6,22,15,28,28,43,113,206,3,789,43,0,2,18,11,47070,19114,3693,25808,0
109,4106,1450,624,1228,12,26,181,1462,14,306,186,354,320,540,2580,4493,8,36391,2021,1,2,41,24,47070,19116,3694,25809,0
150,4203,1660,832,1314,41,38,274,1701,20,312,209,395,332,604,2671,5058,12,64042,3557,1,2,22,20,47070,19118,3695,25811,0
117,4645,1513,682,1277,25,13,200,1538,11,199,116,219,210,335,1557,2584,6,15641,868,0,2,8,5,47070,19120,3695,25812,0
66,3414,1296,573,1062,40,33,157,1336,8,201,118,231,209,349,1561,2689,4,12365,686,0,2,18,12,47070,19120,3695,25813,0
78,4093,1457,730,1242,11,6,188,1468,10,292,166,329,302,495,2424,4078,5,22973,1276,1,2,13,7,47070,19122,3695,25814,0
39,2355,652,304,544,16,6,88,668,6,89,51,101,95,152,591,998,3,3399,188,0,2,46,31,47070,19123,3695,25815,0
64,2957,1455,414,1257,16,76,112,1471,5,41,23,46,46,69,231,381,2,1069,59,0,2,9,11,47070,19124,3695,25816,0
8,273,74,35,59,1,0,14,75,3,14,7,14,17,21,58,85,1,128,7,0,2,8,1,47070,19125,3695,25817,0
90,4427,1523,757,1297,19,12,193,1542,12,193,117,230,205,347,1508,2664,7,19053,1058,0,2,3,1,47080,19127,3695,25818,0
68,2962,1020,354,843,12,15,144,1032,8,134,77,144,142,221,970,1580,4,6792,377,0,2,21,16,47080,19127,3695,25819,0
37,1624,447,308,343,6,5,95,453,7,96,59,111,103,170,651,1136,4,4600,255,0,2,2,1,47080,19130,3695,25820,0
21,661,424,94,331,4,0,89,428,1,5,5,5,6,10,11,25,0,12,0,0,2,10,0,47080,19131,3695,25821,0
40,2367,334,251,279,10,4,40,344,5,127,74,143,132,217,899,1528,2,4303,239,0,2,16,13,47080,19132,3695,25822,0
12,492,184,100,137,2,15,30,186,6,38,20,39,44,59,214,322,3,991,55,0,2,3,4,47080,19133,3695,25823,0
35,1623,1293,570,1093,25,15,163,1318,10,195,123,241,205,364,1516,2795,6,17273,959,0,2,7,9,47090,19135,3695,25824,0
36,1978,384,251,317,7,8,52,391,11,70,44,84,81,128,467,811,6,5355,297,0,2,7,5,47090,19135,3695,25825,0
15,638,722,423,573,19,0,135,741,12,172,101,199,184,300,1320,2257,6,15668,870,0,2,4,0,47090,19137,3695,25827,0
38,1637,386,256,301,16,9,68,402,4,59,35,69,63,104,355,621,2,1453,80,0,2,4,3,47090,19137,3695,25828,0
16,1209,215,129,180,6,0,29,221,8,65,43,72,73,115,415,711,4,3153,175,0,2,10,10,47090,19137,3695,25829,0
72,2856,1043,504,840,53,9,147,1096,9,180,112,198,189,310,1377,2344,4,11604,644,0,2,56,38,47090,19139,3695,25830,0
14,529,295,56,236,0,4,54,295,2,9,5,10,11,15,30,51,1,57,3,0,2,13,1,47090,19141,3695,25831,0
26,1029,373,158,315,8,0,51,381,5,76,44,79,81,123,486,779,2,2026,112,0,2,16,8,47090,19141,3695,25832,0
71,3006,1178,367,1042,6,15,115,1184,9,94,51,95,103,146,644,976,4,4439,246,0,2,18,7,47090,19141,3695,25833,0
74,3770,1943,715,1694,26,18,214,1969,12,185,120,237,197,357,1436,2721,7,20915,1161,0,2,34,21,47090,19143,3695,25834,0
14,825,442,244,305,14,16,103,456,11,68,45,75,79,120,452,756,6,4588,254,0,2,5,0,47090,19145,3695,25835,0
48,1784,1098,241,925,5,10,155,1103,7,46,25,49,53,74,273,423,3,1580,87,0,2,24,1,47100,19147,3695,25836,0
12,476,601,196,481,2,23,85,603,8,63,36,72,71,108,400,664,4,3036,168,0,2,3,3,47100,19147,3695,25837,0
184,4243,77,34,69,0,0,8,77,3,24,16,29,27,45,114,213,1,387,21,0,2,18,0,47100,19147,3695,25838,0
184,4243,712,438,573,51,9,84,763,14,102,71,128,116,199,733,1364,8,11988,666,0,2,18,0,47110,19148,3695,25839,0
94,1795,1020,354,843,12,15,144,1032,8,134,77,144,142,221,970,1580,4,6792,377,0,2,4,4,47110,19148,3695,25840,0
129,2875,1043,504,840,53,9,147,1096,9,180,112,198,189,310,1377,2344,4,11604,644,0,2,18,0,47110,19150,3695,25841,0
129,2875,383,288,292,26,6,62,409,11,65,38,67,76,105,429,656,5,3719,206,0,2,18,0,47110,19151,3695,25842,0
72,3755,1296,573,1062,40,33,157,1336,8,201,118,231,209,349,1561,2689,4,12365,686,0,2,48,1,47110,19151,3695,25843,0
73,2942,1043,504,840,53,9,147,1096,9,180,112,198,189,310,1377,2344,4,11604,644,0,2,27,0,47110,19153,3695,25844,0
91,3010,773,419,590,28,0,166,801,10,204,113,217,214,330,1598,2554,5,13587,754,0,2,2,1,47110,19153,3696,25845,0
53,3320,520,294,400,33,13,81,553,10,261,204,367,271,571,2128,4614,7,32445,1802,1,2,3,1,47110,19154,3696,25846,0
307,7146,72,33,56,0,4,12,72,1,1,1,1,2,2,0,2,0,1,0,0,2,20,6,47110,19154,3696,25847,0
307,7146,1454,835,1044,76,110,219,1530,17,275,158,296,292,454,2297,3718,9,34017,1889,1,2,20,6,47120,19155,3696,25848,0
156,6958,139,89,101,2,0,35,141,7,54,34,62,61,96,330,569,4,2287,127,0,2,61,4,47120,19155,3696,25849,0
156,6958,7,5,5,0,0,2,7,1,2,1,2,3,3,2,4,0,2,0,0,2,61,4,47120,19155,3696,25850,0
55,1182,207,111,150,11,0,50,218,5,26,19,36,31,55,133,272,3,943,52,0,2,10,1,47120,19155,3696,25851,0
55,1182,410,198,237,31,55,97,441,11,63,38,72,74,110,414,683,6,4293,238,0,2,10,1,47130,19156,3697,25852,0
118,4686,1513,682,1277,25,13,200,1538,11,199,116,219,210,335,1557,2584,6,15641,868,0,2,9,0,47130,19158,3697,25853,0
10,228,19,8,11,5,0,4,24,2,5,3,6,7,9,13,25,1,30,1,0,2,5,2,47130,19158,3697,25854,0
10,228,102,59,69,5,3,24,107,6,22,15,28,28,43,113,206,3,789,43,0,2,5,2,47130,19158,3697,25855,0
10,228,106,40,36,3,49,17,109,8,17,13,23,25,36,93,167,5,904,50,0,2,5,2,47130,19158,3697,25856,0
213,4595,182,127,129,0,0,53,182,5,39,21,42,44,63,217,343,2,926,51,0,2,41,28,47130,19158,3698,25857,0
213,4595,1165,710,800,67,119,181,1232,18,243,153,282,261,435,2000,3492,10,36473,2026,1,2,41,28,47140,19158,3699,25858,0
102,2083,773,419,590,28,0,166,801,10,204,113,217,214,330,1598,2554,5,13587,754,0,2,24,22,47140,19158,3700,25859,0
102,2083,421,273,302,44,34,57,465,17,81,59,107,98,166,583,1098,11,12329,684,0,2,24,22,47140,19158,3701,25860,0
27,542,2,2,2,0,0,0,2,0,0,0,0,0,0,0,0,0,0,0,0,2,0,1,47140,19158,3701,25860,0
27,542,99,48,90,1,3,5,100,0,0,0,0,0,0,0,0,0,0,0,0,2,0,1,47140,19159,3701,25861,0
27,542,8,5,5,2,0,1,10,0,0,0,0,0,0,0,0,0,0,0,0,2,0,1,47140,19159,3701,25862,0
27,542,1217,716,841,84,126,174,1301,14,185,118,215,199,333,1446,2542,8,20687,1149,0,2,0,1,47150,19161,3701,25863,0
27,542,160,89,115,0,13,31,160,7,15,11,17,22,28,78,124,3,495,27,0,2,0,1,47150,19161,3701,25864,0
27,542,10,10,9,9,0,0,19,0,0,0,0,0,0,0,0,0,0,0,0,2,0,1,47150,19161,3702,25865,0
27,542,173,84,99,8,29,36,181,5,12,7,13,17,20,54,81,2,221,12,0,2,0,1,47150,19162,3702,25866,0
27,542,3,1,1,3,0,0,6,0,0,0,0,0,0,0,0,0,0,0,0,2,0,1,47150,19162,3702,25867,0
164,5082,1660,832,1314,41,38,274,1701,20,312,209,395,332,604,2671,5058,12,64042,3557,1,2,17,12,47150,19164,3703,25869,0
164,5082,1057,646,719,113,100,145,1170,18,215,134,248,233,382,1740,3004,10,31186,1732,1,2,17,12,47160,19165,3704,25870,0
86,1808,477,336,357,30,23,73,507,16,194,134,250,210,384,1538,2962,10,30538,1696,0,2,16,10,47170,19166,3704,25871,0
62,1345,996,429,845,24,10,117,1020,7,76,50,88,83,138,494,879,4,3565,198,0,2,3,3,47170,19168,3704,25872,0
62,1345,456,277,329,12,42,72,468,13,85,50,97,98,147,592,972,7,7212,400,0,2,3,3,47170,19168,3704,25873,0
128,2606,1513,682,1277,25,13,200,1538,11,199,116,219,210,335,1557,2584,6,15641,868,0,2,7,3,47170,19170,3704,25874,0
128,2606,819,519,539,24,98,155,843,15,96,57,106,111,163,690,1107,8,9171,509,0,2,7,3,47180,19172,3704,25875,0
54,1166,207,111,150,11,0,50,218,5,26,19,36,31,55,133,272,3,943,52,0,2,7,8,47180,19172,3704,25876,0
54,1166,410,198,237,31,55,97,441,11,63,38,72,74,110,414,683,6,4293,238,0,2,7,8,47190,19173,3705,25877,0
349,7049,1457,730,1242,11,6,188,1468,10,292,166,329,302,495,2424,4078,5,22973,1276,1,2,54,41,47190,19175,3705,25878,0
349,7049,74,35,59,1,0,14,75,3,14,7,14,17,21,58,85,1,128,7,0,2,54,41,47190,19176,3705,25879,0
349,7049,245,125,200,5,7,34,250,7,30,17,34,37,51,166,265,3,1053,58,0,2,54,41,47200,19177,3705,25880,0
21,662,339,213,244,17,9,65,356,10,42,26,48,52,74,259,421,5,2410,133,0,2,1,1,47210,19177,3705,25881,0
60,1673,1455,414,1257,16,76,112,1471,5,41,23,46,46,69,231,381,2,1069,59,0,2,19,17,47210,19178,3705,25883,0
60,1673,669,365,481,22,61,110,691,15,103,63,122,118,185,747,1273,8,11311,628,0,2,19,17,47220,19178,3706,25884,0
227,5129,4293,999,3693,19,54,507,4312,9,155,88,170,164,258,1156,1898,4,9368,520,0,2,32,32,47220,19180,3706,25885,0
227,5129,1482,859,1002,125,135,219,1607,16,219,134,251,235,385,1766,3032,9,27804,1544,1,2,32,32,47230,19181,3706,25886,0
6,136,44,22,19,0,19,6,44,2,10,6,12,12,18,35,64,1,77,4,0,2,0,1,47230,19181,3706,25887,0
27,954,74,35,59,1,0,14,75,3,14,7,14,17,21,58,85,1,128,7,0,2,25,20,47230,19182,3706,25888,0
27,954,245,125,200,5,7,34,250,7,30,17,34,37,51,166,265,3,1053,58,0,2,25,20,47240,19183,3706,25889,0
49,575,647,139,84,35,284,233,682,0,0,0,0,0,0,0,0,0,0,0,0,2,45,0,47240,19183,3706,25890,0
83,2359,1523,757,1297,19,12,193,1542,12,193,117,230,205,347,1508,2664,7,19053,1058,0,2,6,6,47250,19185,3706,25891,0
83,2359,701,378,504,33,58,109,734,13,110,68,126,123,194,794,1346,7,10027,557,0,2,6,6,47250,19186,3707,25892,0
184,4243,77,34,69,0,0,8,77,3,24,16,29,27,45,114,213,1,387,21,0,2,59,36,47250,19186,3707,25893,0
184,4243,712,438,573,51,9,84,763,14,102,71,128,116,199,733,1364,8,11988,666,0,2,59,36,47260,19187,3707,25894,0
94,1795,1020,354,843,12,15,144,1032,8,134,77,144,142,221,970,1580,4,6792,377,0,2,8,2,47260,19187,3707,25895,0
46,955,447,308,343,6,5,95,453,7,96,59,111,103,170,651,1136,4,4600,255,0,2,3,3,47260,19190,3707,25896,0
46,955,322,174,179,16,74,51,338,10,41,26,46,51,72,252,408,5,2291,127,0,2,3,3,47260,19193,3708,25897,0
23,388,424,94,331,4,0,89,428,1,5,5,5,6,10,11,25,0,12,0,0,2,3,2,47260,19194,3708,25898,0
23,388,38,23,23,6,0,8,44,3,11,7,11,14,18,42,68,1,102,5,0,2,3,2,47260,19194,3708,25899,0
17,518,184,100,137,2,15,30,186,6,38,20,39,44,59,214,322,3,991,55,0,2,4,4,47260,19195,3708,25900,0
17,518,103,65,74,8,5,16,111,7,17,9,17,24,26,89,119,3,417,23,0,2,4,4,47260,19196,3708,25901,0
212,5047,722,423,573,19,0,135,741,12,172,101,199,184,300,1320,2257,6,15668,870,0,2,47,38,47260,19198,3708,25903,0
212,5047,1508,847,911,44,250,301,1552,14,148,88,169,162,257,1120,1886,7,15077,837,0,2,47,38,47260,19199,3709,25904,0
307,7146,72,33,56,0,4,12,72,1,1,1,1,2,2,0,2,0,1,0,0,2,512,59,47260,19199,3709,25905,0
307,7146,1454,835,1044,76,110,219,1530,17,275,158,296,292,454,2297,3718,9,34017,1889,1,2,512,59,47270,19200,3709,25906,0
77,1522,757,253,292,73,244,162,830,13,61,38,67,74,105,409,651,7,4654,258,0,2,7,6,47270,19201,3709,25907,0
40,837,386,256,301,16,9,68,402,4,59,35,69,63,104,355,621,2,1453,80,0,2,2,2,47270,19201,3709,25908,0
40,837,264,131,164,11,41,46,275,6,38,22,40,44,62,214,338,3,1068,59,0,2,2,2,47280,19201,3710,25909,0
30,649,215,129,180,6,0,29,221,8,65,43,72,73,115,415,711,4,3153,175,0,2,9,4,47280,19201,3710,25910,0
30,649,97,69,77,3,3,16,100,6,22,13,23,28,36,113,173,3,542,30,0,2,9,4,47280,19202,3710,25911,0
129,2875,1043,504,840,53,9,147,1096,9,180,112,198,189,310,1377,2344,4,11604,644,0,2,52,21,47280,19204,3710,25912,0
129,2875,383,288,292,26,6,62,409,11,65,38,67,76,105,429,656,5,3719,206,0,2,52,21,47280,19205,3710,25913,0
103,1953,1178,367,1042,6,15,115,1184,9,94,51,95,103,146,644,976,4,4439,246,0,2,29,24,47280,19205,3710,25914,0
103,1953,177,108,140,8,0,27,185,6,30,16,32,36,48,162,248,3,794,44,0,2,29,24,47280,19207,3710,25915,0
192,3908,1943,715,1694,26,18,214,1969,12,185,120,237,197,357,1436,2721,7,20915,1161,0,2,38,29,47280,19209,3710,25916,0
192,3908,1168,838,957,57,25,144,1225,19,348,224,416,367,640,3018,5452,11,61921,3440,1,2,38,29,47290,19211,3710,25917,0
16,477,442,244,305,14,16,103,456,11,68,45,75,79,120,452,756,6,4588,254,0,2,2,2,47290,19213,3710,25918,0
16,477,182,102,99,11,40,35,193,3,11,6,11,14,17,42,64,1,97,5,0,2,2,2,47290,19214,3710,25919,0
62,1240,1098,241,925,5,10,155,1103,7,46,25,49,53,74,273,423,3,1580,87,0,2,3,3,47300,19216,3710,25920,0
62,1240,282,202,222,14,2,44,296,8,42,24,43,50,67,250,378,4,1548,86,0,2,3,3,47300,19217,3710,25921,0
19,408,601,196,481,2,23,85,603,8,63,36,72,71,108,400,664,4,3036,168,0,2,1,1,47300,19217,3710,25922,0
19,408,156,79,106,5,16,28,161,5,14,8,15,19,23,64,97,2,261,14,0,2,1,1,47300,19217,3710,25923,0
80,3427,1289,550,1043,56,32,155,1345,10,167,93,185,177,278,1266,2075,5,11498,638,0,2,11,13,47300,19219,3711,25924,0
34,997,182,127,129,0,0,53,182,5,39,21,42,44,63,217,343,2,926,51,0,2,18,6,47300,19219,3712,25925,0
147,6812,1392,870,1177,35,17,170,1427,14,494,280,531,508,811,4473,7289,7,54850,3047,2,2,73,49,47300,19222,3713,25926,0
91,3010,773,419,590,28,0,166,801,10,204,113,217,214,330,1598,2554,5,13587,754,0,2,61,21,47300,19222,3714,25927,0
7,278,75,38,59,1,3,12,76,2,4,2,4,6,6,10,15,1,15,0,0,2,4,0,47300,19222,3714,25928,0
2,26,6,4,4,0,0,2,6,1,4,2,4,5,6,8,13,0,6,0,0,2,2,1,47300,19222,3714,25930,0
53,3320,520,294,400,33,13,81,553,10,261,204,367,271,571,2128,4614,7,32445,1802,1,2,84,82,47300,19223,3714,25932,0
98,4425,1338,495,1086,10,64,173,1348,11,122,82,157,133,239,883,1686,7,11934,663,0,2,13,14,47300,19225,3714,25933,0
156,6958,139,89,101,2,0,35,141,7,54,34,62,61,96,330,569,4,2287,127,0,2,99,42,47300,19225,3714,25934,0
156,6958,7,5,5,0,0,2,7,1,2,1,2,3,3,2,4,0,2,0,0,2,99,42,47300,19225,3714,25935,0
32,948,465,148,393,5,8,60,470,4,31,20,31,35,51,161,261,2,523,29,0,2,5,3,47300,19226,3714,25936,0
32,948,16,12,9,0,0,6,16,1,2,1,2,3,3,2,4,0,2,0,0,2,5,3,47300,19226,3714,25937,0
132,5711,1782,648,1425,9,47,279,1791,8,171,97,189,179,286,1292,2140,4,9462,525,0,2,100,62,47300,19227,3715,25938,0
20,541,256,139,192,9,7,47,265,4,23,12,24,27,36,112,171,2,357,19,0,2,0,1,47300,19228,3715,25939,0
23,601,102,59,69,5,3,24,107,6,22,15,28,28,43,113,206,3,789,43,0,2,18,11,47300,19228,3715,25940,0
109,4106,1450,624,1228,12,26,181,1462,14,306,186,354,320,540,2580,4493,8,36391,2021,1,2,41,24,47300,19230,3716,25941,0
150,4203,1660,832,1314,41,38,274,1701,20,312,209,395,332,604,2671,5058,12,64042,3557,1,2,22,20,47300,19232,3717,25943,0
117,4645,1513,682,1277,25,13,200,1538,11,199,116,219,210,335,1557,2584,6,15641,868,0,2,21,18,47300,19234,3717,25944,0
72,3755,1296,573,1062,40,33,157,1336,8,201,118,231,209,349,1561,2689,4,12365,686,0,2,18,12,47300,19234,3717,25945,0
78,4093,1457,730,1242,11,6,188,1468,10,292,166,329,302,495,2424,4078,5,22973,1276,1,2,13,7,47300,19236,3717,25946,0
39,2355,652,304,544,16,6,88,668,6,89,51,101,95,152,591,998,3,3399,188,0,2,48,33,47300,19237,3717,25947,0
64,2957,1455,414,1257,16,76,112,1471,5,41,23,46,46,69,231,381,2,1069,59,0,2,9,11,47300,19238,3717,25948,0
8,273,74,35,59,1,0,14,75,3,14,7,14,17,21,58,85,1,128,7,0,2,8,1,47300,19239,3717,25949,0
90,4427,1523,757,1297,19,12,193,1542,12,193,117,230,205,347,1508,2664,7,19053,1058,0,2,3,1,47310,19241,3717,25950,0
70,3035,1020,354,843,12,15,144,1032,8,134,77,144,142,221,970,1580,4,6792,377,0,2,22,18,47310,19241,3717,25951,0
37,1624,447,308,343,6,5,95,453,7,96,59,111,103,170,651,1136,4,4600,255,0,2,2,1,47310,19244,3717,25952,0
21,661,424,94,331,4,0,89,428,1,5,5,5,6,10,11,25,0,12,0,0,2,10,0,47310,19245,3717,25953,0
40,2367,334,251,279,10,4,40,344,5,127,74,143,132,217,899,1528,2,4303,239,0,2,16,13,47310,19246,3717,25954,0
12,492,184,100,137,2,15,30,186,6,38,20,39,44,59,214,322,3,991,55,0,2,3,4,47310,19247,3717,25955,0
35,1623,1293,570,1093,25,15,163,1318,10,195,123,241,205,364,1516,2795,6,17273,959,0,2,7,9,47320,19249,3717,25956,0
36,1978,384,251,317,7,8,52,391,11,70,44,84,81,128,467,811,6,5355,297,0,2,7,5,47320,19249,3717,25957,0
15,638,722,423,573,19,0,135,741,12,172,101,199,184,300,1320,2257,6,15668,870,0,2,4,0,47320,19251,3717,25959,0
38,1637,386,256,301,16,9,68,402,4,59,35,69,63,104,355,621,2,1453,80,0,2,4,3,47320,19251,3717,25960,0
16,1209,215,129,180,6,0,29,221,8,65,43,72,73,115,415,711,4,3153,175,0,2,10,10,47320,19251,3717,25961,0
73,2942,1043,504,840,53,9,147,1096,9,180,112,198,189,310,1377,2344,4,11604,644,0,2,59,41,47320,19253,3717,25962,0
14,529,295,56,236,0,4,54,295,2,9,5,10,11,15,30,51,1,57,3,0,2,13,1,47320,19255,3717,25963,0
26,1029,373,158,315,8,0,51,381,5,76,44,79,81,123,486,779,2,2026,112,0,2,16,8,47320,19255,3717,25964,0
71,3006,1178,367,1042,6,15,115,1184,9,94,51,95,103,146,644,976,4,4439,246,0,2,18,7,47320,19255,3717,25965,0
74,3770,1943,715,1694,26,18,214,1969,12,185,120,237,197,357,1436,2721,7,20915,1161,0,2,34,21,47320,19257,3717,25966,0
14,825,442,244,305,14,16,103,456,11,68,45,75,79,120,452,756,6,4588,254,0,2,5,0,47320,19259,3717,25967,0
48,1784,1098,241,925,5,10,155,1103,7,46,25,49,53,74,273,423,3,1580,87,0,2,24,1,47330,19261,3717,25968,0
12,476,601,196,481,2,23,85,603,8,63,36,72,71,108,400,664,4,3036,168,0,2,3,3,47330,19261,3717,25969,0
55,1182,207,111,150,11,0,50,218,5,26,19,36,31,55,133,272,3,943,52,0,2,0,1,47330,19261,3717,25970,1
55,1182,410,198,237,31,55,97,441,11,63,38,72,74,110,414,683,6,4293,238,0,2,0,1,47340,19262,3718,25971,1
118,4694,1513,682,1277,25,13,200,1538,11,199,116,219,210,335,1557,2584,6,15641,868,0,2,1,1,47340,19264,3718,25972,1
55,1187,207,111,150,11,0,50,218,5,26,19,36,31,55,133,272,3,943,52,0,2,9,1,47340,19264,3718,25973,0
55,1187,410,198,237,31,55,97,441,11,63,38,72,74,110,414,683,6,4293,238,0,2,9,1,47350,19265,3719,25974,0
118,4694,1513,682,1277,25,13,200,1538,11,199,116,219,210,335,1557,2584,6,15641,868,0,2,10,1,47350,19267,3719,25975,0
147,6812,1392,870,1177,35,17,170,1427,14,494,280,531,508,811,4473,7289,7,54850,3047,2,2,8,8,47350,19270,3720,25976,1
87,2932,773,419,590,28,0,166,801,10,204,113,217,214,330,1598,2554,5,13587,754,0,2,2,17,47350,19270,3721,25977,1
118,4695,1513,682,1277,25,13,200,1538,11,199,116,219,210,335,1557,2584,6,15641,868,0,2,14,14,47350,19272,3721,25978,1
39,2355,652,304,544,16,6,88,668,6,89,51,101,95,152,591,998,3,3399,188,0,2,2,2,47350,19273,3721,25979,1
72,2856,1043,504,840,53,9,147,1096,9,180,112,198,189,310,1377,2344,4,11604,644,0,2,2,2,47350,19275,3721,25980,1
21,432,601,196,481,2,23,85,603,8,63,36,72,71,108,400,664,4,3036,168,0,2,5,0,47350,19275,3721,25981,1
21,432,156,79,106,5,16,28,161,5,14,8,15,19,23,64,97,2,261,14,0,2,5,0,47350,19275,3721,25982,1
15,541,601,196,481,2,23,85,603,8,63,36,72,71,108,400,664,4,3036,168,0,2,29,0,47350,19275,3721,25983,1
21,432,601,196,481,2,23,85,603,8,63,36,72,71,108,400,664,4,3036,168,0,2,5,0,47350,19275,3721,25984,0
21,432,156,79,106,5,16,28,161,5,14,8,15,19,23,64,97,2,261,14,0,2,5,0,47350,19275,3721,25985,0
15,541,601,196,481,2,23,85,603,8,63,36,72,71,108,400,664,4,3036,168,0,2,29,0,47350,19275,3721,25986,0
147,6812,1392,870,1177,35,17,170,1427,14,494,280,531,508,811,4473,7289,7,54850,3047,2,2,8,8,47350,19278,3722,25987,0
87,2932,773,419,590,28,0,166,801,10,204,113,217,214,330,1598,2554,5,13587,754,0,2,2,17,47350,19278,3723,25988,0
118,4695,1513,682,1277,25,13,200,1538,11,199,116,219,210,335,1557,2584,6,15641,868,0,2,14,14,47350,19280,3723,25989,0
39,2355,652,304,544,16,6,88,668,6,89,51,101,95,152,591,998,3,3399,188,0,2,2,2,47350,19281,3723,25990,0
72,2856,1043,504,840,53,9,147,1096,9,180,112,198,189,310,1377,2344,4,11604,644,0,2,2,2,47350,19283,3723,25991,0
349,7042,1457,730,1242,11,6,188,1468,10,292,166,329,302,495,2424,4078,5,22973,1276,1,2,0,1,47350,19285,3723,25992,1
349,7042,74,35,59,1,0,14,75,3,14,7,14,17,21,58,85,1,128,7,0,2,0,1,47350,19286,3723,25993,1
349,7042,245,125,200,5,7,34,250,7,30,17,34,37,51,166,265,3,1053,58,0,2,0,1,47360,19287,3723,25994,1
95,1819,1020,354,843,12,15,144,1032,8,134,77,144,142,221,970,1580,4,6792,377,0,2,12,3,47360,19287,3723,25995,0
72,3105,1020,354,843,12,15,144,1032,8,134,77,144,142,221,970,1580,4,6792,377,0,2,13,0,47360,19287,3723,25996,0
19,409,601,196,481,2,23,85,603,8,63,36,72,71,108,400,664,4,3036,168,0,2,3,2,47360,19287,3723,25997,0
19,409,156,79,106,5,16,28,161,5,14,8,15,19,23,64,97,2,261,14,0,2,3,2,47360,19287,3723,25998,0
19,409,601,196,481,2,23,85,603,8,63,36,72,71,108,400,664,4,3036,168,0,2,3,2,47360,19287,3723,25999,0
19,409,156,79,106,5,16,28,161,5,14,8,15,19,23,64,97,2,261,14,0,2,3,2,47360,19287,3723,26000,0
95,1819,1020,354,843,12,15,144,1032,8,134,77,144,142,221,970,1580,4,6792,377,0,2,12,3,47360,19287,3723,26001,0
72,3105,1020,354,843,12,15,144,1032,8,134,77,144,142,221,970,1580,4,6792,377,0,2,13,0,47360,19287,3723,26002,0
212,5063,722,423,573,19,0,135,741,12,172,101,199,184,300,1320,2257,6,15668,870,0,2,5,2,47360,19289,3723,26004,0
212,5063,1508,847,911,44,250,301,1552,14,148,88,169,162,257,1120,1886,7,15077,837,0,2,5,2,47360,19290,3724,26005,0
74,1418,757,253,292,73,244,162,830,13,61,38,67,74,105,409,651,7,4654,258,0,2,8,54,47360,19291,3724,26006,1
255,6154,72,33,56,0,4,12,72,1,1,1,1,2,2,0,2,0,1,0,0,2,0,432,47360,19291,3724,26007,0
255,6154,1454,835,1044,76,110,219,1530,17,275,158,296,292,454,2297,3718,9,34017,1889,1,2,0,432,47370,19292,3724,26008,0
74,1418,757,253,292,73,244,162,830,13,61,38,67,74,105,409,651,7,4654,258,0,2,1,1,47370,19293,3724,26009,0
255,6152,72,33,56,0,4,12,72,1,1,1,1,2,2,0,2,0,1,0,0,2,0,1,47370,19293,3724,26010,0
255,6152,1454,835,1044,76,110,219,1530,17,275,158,296,292,454,2297,3718,9,34017,1889,1,2,0,1,47380,19294,3724,26011,0
255,6152,72,33,56,0,4,12,72,1,1,1,1,2,2,0,2,0,1,0,0,2,0,433,47380,19294,3724,26012,0
255,6152,1454,835,1044,76,110,219,1530,17,275,158,296,292,454,2297,3718,9,34017,1889,1,2,0,433,47390,19295,3724,26013,0
74,1418,757,253,292,73,244,162,830,13,61,38,67,74,105,409,651,7,4654,258,0,2,8,54,47390,19296,3724,26014,0
98,4449,1338,495,1086,10,64,173,1348,11,122,82,157,133,239,883,1686,7,11934,663,0,2,11,1,47390,19298,3724,26015,1
132,5719,1782,648,1425,9,47,279,1791,8,171,97,189,179,286,1292,2140,4,9462,525,0,2,2,1,47390,19299,3725,26016,1
72,3114,1020,354,843,12,15,144,1032,8,134,77,144,142,221,970,1580,4,6792,377,0,2,1,0,47390,19299,3725,26017,1
36,1591,386,256,301,16,9,68,402,4,59,35,69,63,104,355,621,2,1453,80,0,2,1,27,47390,19299,3725,26018,1
48,1784,1098,241,925,5,10,155,1103,7,46,25,49,53,74,273,423,3,1580,87,0,2,7,7,47400,19301,3725,26019,1
15,568,601,196,481,2,23,85,603,8,63,36,72,71,108,400,664,4,3036,168,0,2,4,0,47400,19301,3725,26020,1
48,1795,1098,241,925,5,10,155,1103,7,46,25,49,53,74,273,423,3,1580,87,0,2,50,55,47410,19303,3725,26021,0
98,4449,1338,495,1086,10,64,173,1348,11,122,82,157,133,239,883,1686,7,11934,663,0,2,11,1,47410,19305,3725,26022,0
132,5719,1782,648,1425,9,47,279,1791,8,171,97,189,179,286,1292,2140,4,9462,525,0,2,2,1,47410,19306,3726,26023,0
72,3114,1020,354,843,12,15,144,1032,8,134,77,144,142,221,970,1580,4,6792,377,0,2,1,0,47410,19306,3726,26024,0
36,1591,386,256,301,16,9,68,402,4,59,35,69,63,104,355,621,2,1453,80,0,2,1,27,47410,19306,3726,26025,0
48,1795,1098,241,925,5,10,155,1103,7,46,25,49,53,74,273,423,3,1580,87,0,2,57,62,47420,19308,3726,26026,0
15,568,601,196,481,2,23,85,603,8,63,36,72,71,108,400,664,4,3036,168,0,2,4,0,47420,19308,3726,26027,0
60,1677,1455,414,1257,16,76,112,1471,5,41,23,46,46,69,231,381,2,1069,59,0,2,1,1,47420,19309,3726,26028,0
60,1677,669,365,481,22,61,110,691,15,103,63,122,118,185,747,1273,8,11311,628,0,2,1,1,47430,19309,3727,26029,0
131,2635,1513,682,1277,25,13,200,1538,11,199,116,219,210,335,1557,2584,6,15641,868,0,2,19,0,47430,19311,3727,26030,1
131,2635,819,519,539,24,98,155,843,15,96,57,106,111,163,690,1107,8,9171,509,0,2,19,0,47440,19313,3727,26031,1
349,7042,1457,730,1242,11,6,188,1468,10,292,166,329,302,495,2424,4078,5,22973,1276,1,2,0,1,47440,19315,3727,26032,0
349,7042,74,35,59,1,0,14,75,3,14,7,14,17,21,58,85,1,128,7,0,2,0,1,47440,19316,3727,26033,0
349,7042,245,125,200,5,7,34,250,7,30,17,34,37,51,166,265,3,1053,58,0,2,0,1,47450,19317,3727,26034,0
131,2635,1513,682,1277,25,13,200,1538,11,199,116,219,210,335,1557,2584,6,15641,868,0,2,1,1,47450,19319,3727,26035,0
131,2635,819,519,539,24,98,155,843,15,96,57,106,111,163,690,1107,8,9171,509,0,2,1,1,47460,19321,3727,26036,0
349,7042,1457,730,1242,11,6,188,1468,10,292,166,329,302,495,2424,4078,5,22973,1276,1,2,0,1,47460,19323,3727,26037,0
349,7042,74,35,59,1,0,14,75,3,14,7,14,17,21,58,85,1,128,7,0,2,0,1,47460,19324,3727,26038,0
349,7042,245,125,200,5,7,34,250,7,30,17,34,37,51,166,265,3,1053,58,0,2,0,1,47470,19325,3727,26039,0
131,2635,1513,682,1277,25,13,200,1538,11,199,116,219,210,335,1557,2584,6,15641,868,0,2,19,0,47470,19327,3727,26040,0
131,2635,819,519,539,24,98,155,843,15,96,57,106,111,163,690,1107,8,9171,509,0,2,19,0,47480,19329,3727,26041,0
65,3005,1455,414,1257,16,76,112,1471,5,41,23,46,46,69,231,381,2,1069,59,0,2,16,0,47480,19330,3727,26042,0
60,1677,1455,414,1257,16,76,112,1471,5,41,23,46,46,69,231,381,2,1069,59,0,2,1,1,47480,19331,3727,26043,0
60,1677,669,365,481,22,61,110,691,15,103,63,122,118,185,747,1273,8,11311,628,0,2,1,1,47490,19331,3728,26044,0
65,3005,1455,414,1257,16,76,112,1471,5,41,23,46,46,69,231,381,2,1069,59,0,2,16,0,47490,19332,3728,26045,0
131,2635,1513,682,1277,25,13,200,1538,11,199,116,219,210,335,1557,2584,6,15641,868,0,2,19,0,47490,19334,3728,26046,0
131,2635,819,519,539,24,98,155,843,15,96,57,106,111,163,690,1107,8,9171,509,0,2,19,0,47500,19336,3728,26047,0
349,7042,1457,730,1242,11,6,188,1468,10,292,166,329,302,495,2424,4078,5,22973,1276,1,2,0,1,47500,19338,3728,26048,0
349,7042,74,35,59,1,0,14,75,3,14,7,14,17,21,58,85,1,128,7,0,2,0,1,47500,19339,3728,26049,0
349,7042,245,125,200,5,7,34,250,7,30,17,34,37,51,166,265,3,1053,58,0,2,0,1,47510,19340,3728,26050,0
60,1677,1455,414,1257,16,76,112,1471,5,41,23,46,46,69,231,381,2,1069,59,0,2,1,1,47510,19341,3728,26051,0
60,1677,669,365,481,22,61,110,691,15,103,63,122,118,185,747,1273,8,11311,628,0,2,1,1,47520,19341,3729,26052,0
21,433,601,196,481,2,23,85,603,8,63,36,72,71,108,400,664,4,3036,168,0,2,3,2,47520,19341,3729,26053,0
21,433,156,79,106,5,16,28,161,5,14,8,15,19,23,64,97,2,261,14,0,2,3,2,47520,19341,3729,26054,0
87,2932,773,419,590,28,0,166,801,10,204,113,217,214,330,1598,2554,5,13587,754,0,2,0,15,47520,19341,3730,26055,0
118,4695,1513,682,1277,25,13,200,1538,11,199,116,219,210,335,1557,2584,6,15641,868,0,2,1,1,47520,19343,3730,26056,0
65,3005,1455,414,1257,16,76,112,1471,5,41,23,46,46,69,231,381,2,1069,59,0,2,16,0,47520,19344,3730,26057,0
315,7207,72,33,56,0,4,12,72,1,1,1,1,2,2,0,2,0,1,0,0,2,4,3,47520,19344,3730,26058,0
315,7207,1454,835,1044,76,110,219,1530,17,275,158,296,292,454,2297,3718,9,34017,1889,1,2,4,3,47530,19345,3730,26059,0
103,1955,1178,367,1042,6,15,115,1184,9,94,51,95,103,146,644,976,4,4439,246,0,2,1,1,47530,19345,3730,26060,1
103,1955,177,108,140,8,0,27,185,6,30,16,32,36,48,162,248,3,794,44,0,2,1,1,47530,19347,3730,26061,1
71,3006,1178,367,1042,6,15,115,1184,9,94,51,95,103,146,644,976,4,4439,246,0,2,1,1,47530,19347,3730,26062,1
315,7207,72,33,56,0,4,12,72,1,1,1,1,2,2,0,2,0,1,0,0,2,4,3,47530,19347,3730,26063,0
315,7207,1454,835,1044,76,110,219,1530,17,275,158,296,292,454,2297,3718,9,34017,1889,1,2,4,3,47540,19348,3730,26064,0
103,1955,1178,367,1042,6,15,115,1184,9,94,51,95,103,146,644,976,4,4439,246,0,2,1,1,47540,19348,3730,26065,0
103,1955,177,108,140,8,0,27,185,6,30,16,32,36,48,162,248,3,794,44,0,2,1,1,47540,19350,3730,26066,0
71,3006,1178,367,1042,6,15,115,1184,9,94,51,95,103,146,644,976,4,4439,246,0,2,1,1,47540,19350,3730,26067,0
132,2651,1513,682,1277,25,13,200,1538,11,199,116,219,210,335,1557,2584,6,15641,868,0,2,5,0,47540,19352,3730,26068,0
132,2651,819,519,539,24,98,155,843,15,96,57,106,111,163,690,1107,8,9171,509,0,2,5,0,47550,19354,3730,26069,0
118,4765,1513,682,1277,25,13,200,1538,11,199,116,219,210,335,1557,2584,6,15641,868,0,2,10,0,47550,19356,3730,26070,0
78,1458,757,253,292,73,244,162,830,13,61,38,67,74,105,409,651,7,4654,258,0,2,28,1,47550,19357,3730,26071,0
78,1458,757,253,292,73,244,162,830,13,61,38,67,74,105,409,651,7,4654,258,0,2,2,2,47550,19358,3730,26072,0
78,1458,757,253,292,73,244,162,830,13,61,38,67,74,105,409,651,7,4654,258,0,2,1,0,47550,19359,3730,26073,0
75,1461,757,253,292,73,244,162,830,13,61,38,67,74,105,409,651,7,4654,258,0,2,24,15,47550,19360,3730,26074,0
54,3424,520,294,400,33,13,81,553,10,261,204,367,271,571,2128,4614,7,32445,1802,1,2,14,0,47550,19361,3730,26075,0
212,5063,722,423,573,19,0,135,741,12,172,101,199,184,300,1320,2257,6,15668,870,0,2,5,2,47550,19363,3730,26077,0
212,5063,1508,847,911,44,250,301,1552,14,148,88,169,162,257,1120,1886,7,15077,837,0,2,5,2,47550,19364,3731,26078,0
161,7070,139,89,101,2,0,35,141,7,54,34,62,61,96,330,569,4,2287,127,0,2,34,0,47550,19364,3731,26079,1
161,7070,7,5,5,0,0,2,7,1,2,1,2,3,3,2,4,0,2,0,0,2,34,0,47550,19364,3731,26080,1
132,2651,1513,682,1277,25,13,200,1538,11,199,116,219,210,335,1557,2584,6,15641,868,0,2,5,0,47550,19366,3731,26081,0
132,2651,819,519,539,24,98,155,843,15,96,57,106,111,163,690,1107,8,9171,509,0,2,5,0,47560,19368,3731,26082,0
118,4765,1513,682,1277,25,13,200,1538,11,199,116,219,210,335,1557,2584,6,15641,868,0,2,10,0,47560,19370,3731,26083,0
229,5170,4293,999,3693,19,54,507,4312,9,155,88,170,164,258,1156,1898,4,9368,520,0,2,13,8,47560,19372,3731,26084,1
229,5170,1482,859,1002,125,135,219,1607,16,219,134,251,235,385,1766,3032,9,27804,1544,1,2,13,8,47570,19373,3731,26085,1
161,7059,139,89,101,2,0,35,141,7,54,34,62,61,96,330,569,4,2287,127,0,2,0,1,47570,19373,3731,26086,1
161,7059,7,5,5,0,0,2,7,1,2,1,2,3,3,2,4,0,2,0,0,2,0,1,47570,19373,3731,26087,1
11,410,42,7,35,4,0,5,46,1,2,1,2,3,3,2,4,0,2,0,0,2,2,1,47570,19373,3731,26088,1
11,410,11,6,10,0,0,1,11,2,4,2,4,6,6,10,15,1,15,0,0,2,2,1,47570,19373,3731,26089,1
132,2651,1513,682,1277,25,13,200,1538,11,199,116,219,210,335,1557,2584,6,15641,868,0,2,5,0,47570,19375,3731,26090,0
132,2651,819,519,539,24,98,155,843,15,96,57,106,111,163,690,1107,8,9171,509,0,2,5,0,47580,19377,3731,26091,0
212,5063,722,423,573,19,0,135,741,12,172,101,199,184,300,1320,2257,6,15668,870,0,2,5,2,47580,19379,3731,26093,0
212,5063,1508,847,911,44,250,301,1552,14,148,88,169,162,257,1120,1886,7,15077,837,0,2,5,2,47580,19380,3732,26094,0
255,6153,72,33,56,0,4,12,72,1,1,1,1,2,2,0,2,0,1,0,0,2,4,3,47580,19380,3732,26095,0
255,6153,1454,835,1044,76,110,219,1530,17,275,158,296,292,454,2297,3718,9,34017,1889,1,2,4,3,47590,19381,3732,26096,0
103,1955,1178,367,1042,6,15,115,1184,9,94,51,95,103,146,644,976,4,4439,246,0,2,1,1,47590,19381,3732,26097,0
103,1955,177,108,140,8,0,27,185,6,30,16,32,36,48,162,248,3,794,44,0,2,1,1,47590,19383,3732,26098,0
118,4765,1513,682,1277,25,13,200,1538,11,199,116,219,210,335,1557,2584,6,15641,868,0,2,10,0,47590,19385,3732,26099,0
71,3006,1178,367,1042,6,15,115,1184,9,94,51,95,103,146,644,976,4,4439,246,0,2,1,1,47590,19385,3732,26100,0
132,2651,1513,682,1277,25,13,200,1538,11,199,116,219,210,335,1557,2584,6,15641,868,0,2,24,0,47590,19387,3732,26101,0
132,2651,819,519,539,24,98,155,843,15,96,57,106,111,163,690,1107,8,9171,509,0,2,24,0,47600,19389,3732,26102,0
349,7042,1457,730,1242,11,6,188,1468,10,292,166,329,302,495,2424,4078,5,22973,1276,1,2,0,1,47600,19391,3732,26103,0
349,7042,74,35,59,1,0,14,75,3,14,7,14,17,21,58,85,1,128,7,0,2,0,1,47600,19392,3732,26104,0
349,7042,245,125,200,5,7,34,250,7,30,17,34,37,51,166,265,3,1053,58,0,2,0,1,47610,19393,3732,26105,0
60,1677,1455,414,1257,16,76,112,1471,5,41,23,46,46,69,231,381,2,1069,59,0,2,1,1,47610,19394,3732,26106,0
60,1677,669,365,481,22,61,110,691,15,103,63,122,118,185,747,1273,8,11311,628,0,2,1,1,47620,19394,3733,26107,0
212,5063,722,423,573,19,0,135,741,12,172,101,199,184,300,1320,2257,6,15668,870,0,2,5,2,47620,19396,3733,26109,0
212,5063,1508,847,911,44,250,301,1552,14,148,88,169,162,257,1120,1886,7,15077,837,0,2,5,2,47620,19397,3734,26110,0
255,6153,72,33,56,0,4,12,72,1,1,1,1,2,2,0,2,0,1,0,0,2,4,3,47620,19397,3734,26111,0
255,6153,1454,835,1044,76,110,219,1530,17,275,158,296,292,454,2297,3718,9,34017,1889,1,2,4,3,47630,19398,3734,26112,0
103,1955,1178,367,1042,6,15,115,1184,9,94,51,95,103,146,644,976,4,4439,246,0,2,1,1,47630,19398,3734,26113,0
103,1955,177,108,140,8,0,27,185,6,30,16,32,36,48,162,248,3,794,44,0,2,1,1,47630,19400,3734,26114,0
21,433,601,196,481,2,23,85,603,8,63,36,72,71,108,400,664,4,3036,168,0,2,3,2,47630,19400,3734,26115,0
21,433,156,79,106,5,16,28,161,5,14,8,15,19,23,64,97,2,261,14,0,2,3,2,47630,19400,3734,26116,0
87,2932,773,419,590,28,0,166,801,10,204,113,217,214,330,1598,2554,5,13587,754,0,2,0,15,47630,19400,3735,26117,0
118,4765,1513,682,1277,25,13,200,1538,11,199,116,219,210,335,1557,2584,6,15641,868,0,2,11,1,47630,19402,3735,26118,0
65,3005,1455,414,1257,16,76,112,1471,5,41,23,46,46,69,231,381,2,1069,59,0,2,16,0,47630,19403,3735,26119,0
71,3006,1178,367,1042,6,15,115,1184,9,94,51,95,103,146,644,976,4,4439,246,0,2,1,1,47630,19403,3735,26120,0
50,586,647,139,84,35,284,233,682,0,0,0,0,0,0,0,0,0,0,0,0,2,15,1,47630,19403,3735,26121,0
192,3949,1943,715,1694,26,18,214,1969,12,185,120,237,197,357,1436,2721,7,20915,1161,0,2,6,4,47630,19405,3735,26122,0
192,3949,1168,838,957,57,25,144,1225,19,348,224,416,367,640,3018,5452,11,61921,3440,1,2,6,4,47640,19407,3735,26123,0
75,3810,1943,715,1694,26,18,214,1969,12,185,120,237,197,357,1436,2721,7,20915,1161,0,2,17,0,47640,19409,3735,26124,0
50,586,647,139,84,35,284,233,682,0,0,0,0,0,0,0,0,0,0,0,0,2,15,1,47640,19409,3735,26125,0
192,3949,1943,715,1694,26,18,214,1969,12,185,120,237,197,357,1436,2721,7,20915,1161,0,2,6,4,47640,19411,3735,26126,0
192,3949,1168,838,957,57,25,144,1225,19,348,224,416,367,640,3018,5452,11,61921,3440,1,2,6,4,47650,19413,3735,26127,0
75,3810,1943,715,1694,26,18,214,1969,12,185,120,237,197,357,1436,2721,7,20915,1161,0,2,17,0,47650,19415,3735,26128,0
57,1306,996,429,845,24,10,117,1020,7,76,50,88,83,138,494,879,4,3565,198,0,2,11,15,47650,19417,3735,26129,0
57,1306,456,277,329,12,42,72,468,13,85,50,97,98,147,592,972,7,7212,400,0,2,11,15,47650,19417,3735,26130,0
58,1312,996,429,845,24,10,117,1020,7,76,50,88,83,138,494,879,4,3565,198,0,2,1,1,47650,19419,3735,26131,0
58,1312,456,277,329,12,42,72,468,13,85,50,97,98,147,592,972,7,7212,400,0,2,1,1,47650,19419,3735,26132,0
58,1312,996,429,845,24,10,117,1020,7,76,50,88,83,138,494,879,4,3565,198,0,2,11,15,47650,19421,3735,26133,0
58,1312,456,277,329,12,42,72,468,13,85,50,97,98,147,592,972,7,7212,400,0,2,11,15,47650,19421,3735,26134,0
59,1352,996,429,845,24,10,117,1020,7,76,50,88,83,138,494,879,4,3565,198,0,2,9,4,47650,19423,3735,26135,0
59,1352,456,277,329,12,42,72,468,13,85,50,97,98,147,592,972,7,7212,400,0,2,9,4,47650,19423,3735,26136,0
50,586,647,139,84,35,284,233,682,0,0,0,0,0,0,0,0,0,0,0,0,2,4,1,47650,19423,3735,26137,0
50,586,647,139,84,35,284,233,682,0,0,0,0,0,0,0,0,0,0,0,0,2,1,1,47650,19423,3735,26138,0
227,5131,4293,999,3693,19,54,507,4312,9,155,88,170,164,258,1156,1898,4,9368,520,0,2,3,3,47650,19425,3735,26139,1
227,5131,1482,859,1002,125,135,219,1607,16,219,134,251,235,385,1766,3032,9,27804,1544,1,2,3,3,47660,19426,3735,26140,1
184,4247,77,34,69,0,0,8,77,3,24,16,29,27,45,114,213,1,387,21,0,2,2,1,47660,19426,3735,26141,1
184,4247,712,438,573,51,9,84,763,14,102,71,128,116,199,733,1364,8,11988,666,0,2,2,1,47670,19427,3735,26142,1
18,466,205,80,86,16,53,53,221,7,18,10,19,25,29,94,134,3,497,27,0,0,141,0,47680,19427,3736,26143,1
255,6153,72,33,56,0,4,12,72,1,1,1,1,2,2,0,2,0,1,0,0,2,1,1,47680,19427,3736,26144,1
255,6153,1454,835,1044,76,110,219,1530,17,275,158,296,292,454,2297,3718,9,34017,1889,1,2,1,1,47690,19428,3736,26145,1
74,1418,757,253,292,73,244,162,830,13,61,38,67,74,105,409,651,7,4654,258,0,2,1,1,47690,19429,3736,26146,1
40,837,386,256,301,16,9,68,402,4,59,35,69,63,104,355,621,2,1453,80,0,2,2,2,47690,19429,3736,26147,1
40,837,264,131,164,11,41,46,275,6,38,22,40,44,62,214,338,3,1068,59,0,2,2,2,47700,19429,3737,26148,1
112,2470,1043,504,840,53,9,147,1096,9,180,112,198,189,310,1377,2344,4,11604,644,0,2,3,122,47700,19431,3737,26149,1
112,2470,383,288,292,26,6,62,409,11,65,38,67,76,105,429,656,5,3719,206,0,2,3,122,47700,19432,3737,26150,1
102,1930,1178,367,1042,6,15,115,1184,9,94,51,95,103,146,644,976,4,4439,246,0,2,3,15,47700,19432,3737,26151,1
102,1930,177,108,140,8,0,27,185,6,30,16,32,36,48,162,248,3,794,44,0,2,3,15,47700,19434,3737,26152,1
62,1240,1098,241,925,5,10,155,1103,7,46,25,49,53,74,273,423,3,1580,87,0,2,2,2,47710,19436,3737,26153,1
62,1240,282,202,222,14,2,44,296,8,42,24,43,50,67,250,378,4,1548,86,0,2,2,2,47710,19437,3737,26154,1
75,2972,1043,504,840,53,9,147,1096,9,180,112,198,189,310,1377,2344,4,11604,644,0,2,11,2,47710,19439,3737,26155,1
18,466,205,80,86,16,53,53,221,7,18,10,19,25,29,94,134,3,497,27,0,2,5,6,47720,19439,3738,26156,0
40,837,386,256,301,16,9,68,402,4,59,35,69,63,104,355,621,2,1453,80,0,2,1,0,47720,19439,3738,26157,0
40,837,264,131,164,11,41,46,275,6,38,22,40,44,62,214,338,3,1068,59,0,2,1,0,47730,19439,3739,26158,0
112,2470,1043,504,840,53,9,147,1096,9,180,112,198,189,310,1377,2344,4,11604,644,0,2,1,4,47730,19441,3739,26159,0
112,2470,383,288,292,26,6,62,409,11,65,38,67,76,105,429,656,5,3719,206,0,2,1,4,47730,19442,3739,26160,0
102,1930,1178,367,1042,6,15,115,1184,9,94,51,95,103,146,644,976,4,4439,246,0,2,0,1,47730,19442,3739,26161,0
102,1930,177,108,140,8,0,27,185,6,30,16,32,36,48,162,248,3,794,44,0,2,0,1,47730,19444,3739,26162,0
75,2972,1043,504,840,53,9,147,1096,9,180,112,198,189,310,1377,2344,4,11604,644,0,2,0,1,47730,19446,3739,26163,0
59,1352,996,429,845,24,10,117,1020,7,76,50,88,83,138,494,879,4,3565,198,0,2,9,4,47730,19448,3739,26164,0
59,1352,456,277,329,12,42,72,468,13,85,50,97,98,147,592,972,7,7212,400,0,2,9,4,47730,19448,3739,26165,0
50,586,647,139,84,35,284,233,682,0,0,0,0,0,0,0,0,0,0,0,0,2,4,1,47730,19448,3739,26166,0
214,4602,182,127,129,0,0,53,182,5,39,21,42,44,63,217,343,2,926,51,0,2,1,1,47730,19448,3740,26167,1
214,4602,1165,710,800,67,119,181,1232,18,243,153,282,261,435,2000,3492,10,36473,2026,1,2,1,1,47740,19448,3741,26168,1
149,6984,1392,870,1177,35,17,170,1427,14,494,280,531,508,811,4473,7289,7,54850,3047,2,2,30,0,47740,19451,3742,26169,1
229,5170,4293,999,3693,19,54,507,4312,9,155,88,170,164,258,1156,1898,4,9368,520,0,2,13,8,47740,19453,3742,26170,0
229,5170,1482,859,1002,125,135,219,1607,16,219,134,251,235,385,1766,3032,9,27804,1544,1,2,13,8,47750,19454,3742,26171,0
11,410,42,7,35,4,0,5,46,1,2,1,2,3,3,2,4,0,2,0,0,2,2,1,47750,19454,3742,26172,0
11,410,11,6,10,0,0,1,11,2,4,2,4,6,6,10,15,1,15,0,0,2,2,1,47750,19454,3742,26173,0
161,7059,139,89,101,2,0,35,141,7,54,34,62,61,96,330,569,4,2287,127,0,2,33,0,47750,19454,3742,26174,0
161,7059,7,5,5,0,0,2,7,1,2,1,2,3,3,2,4,0,2,0,0,2,33,0,47750,19454,3742,26175,0
214,4602,182,127,129,0,0,53,182,5,39,21,42,44,63,217,343,2,926,51,0,2,1,1,47750,19454,3743,26176,0
214,4602,1165,710,800,67,119,181,1232,18,243,153,282,261,435,2000,3492,10,36473,2026,1,2,1,1,47760,19454,3744,26177,0
149,6984,1392,870,1177,35,17,170,1427,14,494,280,531,508,811,4473,7289,7,54850,3047,2,2,30,0,47760,19457,3745,26178,0
229,5172,4293,999,3693,19,54,507,4312,9,155,88,170,164,258,1156,1898,4,9368,520,0,2,3,3,47760,19459,3745,26179,0
229,5172,1482,859,1002,125,135,219,1607,16,219,134,251,235,385,1766,3032,9,27804,1544,1,2,3,3,47770,19460,3745,26180,0
184,4247,77,34,69,0,0,8,77,3,24,16,29,27,45,114,213,1,387,21,0,2,2,1,47770,19460,3745,26181,0
184,4247,712,438,573,51,9,84,763,14,102,71,128,116,199,733,1364,8,11988,666,0,2,2,1,47780,19461,3745,26182,0
18,466,205,80,86,16,53,53,221,7,18,10,19,25,29,94,134,3,497,27,0,0,140,0,47790,19461,3746,26183,0
255,6153,72,33,56,0,4,12,72,1,1,1,1,2,2,0,2,0,1,0,0,2,1,1,47790,19461,3746,26184,0
255,6153,1454,835,1044,76,110,219,1530,17,275,158,296,292,454,2297,3718,9,34017,1889,1,2,1,1,47800,19462,3746,26185,0
74,1418,757,253,292,73,244,162,830,13,61,38,67,74,105,409,651,7,4654,258,0,2,1,1,47800,19463,3746,26186,0
40,837,386,256,301,16,9,68,402,4,59,35,69,63,104,355,621,2,1453,80,0,2,2,1,47800,19463,3746,26187,0
40,837,264,131,164,11,41,46,275,6,38,22,40,44,62,214,338,3,1068,59,0,2,2,1,47810,19463,3747,26188,0
112,2470,1043,504,840,53,9,147,1096,9,180,112,198,189,310,1377,2344,4,11604,644,0,2,4,126,47810,19465,3747,26189,0
112,2470,383,288,292,26,6,62,409,11,65,38,67,76,105,429,656,5,3719,206,0,2,4,126,47810,19466,3747,26190,0
102,1930,1178,367,1042,6,15,115,1184,9,94,51,95,103,146,644,976,4,4439,246,0,2,3,16,47810,19466,3747,26191,0
102,1930,177,108,140,8,0,27,185,6,30,16,32,36,48,162,248,3,794,44,0,2,3,16,47810,19468,3747,26192,0
62,1240,1098,241,925,5,10,155,1103,7,46,25,49,53,74,273,423,3,1580,87,0,2,2,2,47820,19470,3747,26193,0
62,1240,282,202,222,14,2,44,296,8,42,24,43,50,67,250,378,4,1548,86,0,2,2,2,47820,19471,3747,26194,0
75,2972,1043,504,840,53,9,147,1096,9,180,112,198,189,310,1377,2344,4,11604,644,0,2,10,2,47820,19473,3747,26195,0
75,1461,757,253,292,73,244,162,830,13,61,38,67,74,105,409,651,7,4654,258,0,2,37,0,47820,19474,3747,26196,0
54,3424,520,294,400,33,13,81,553,10,261,204,367,271,571,2128,4614,7,32445,1802,1,2,14,0,47820,19475,3747,26197,0
347,7012,1457,730,1242,11,6,188,1468,10,292,166,329,302,495,2424,4078,5,22973,1276,1,2,0,9,47820,19477,3747,26198,0
347,7012,74,35,59,1,0,14,75,3,14,7,14,17,21,58,85,1,128,7,0,2,0,9,47820,19478,3747,26199,0
347,7012,245,125,200,5,7,34,250,7,30,17,34,37,51,166,265,3,1053,58,0,2,0,9,47830,19479,3747,26200,0
183,4238,77,34,69,0,0,8,77,3,24,16,29,27,45,114,213,1,387,21,0,2,0,9,47830,19479,3747,26201,0
183,4238,712,438,573,51,9,84,763,14,102,71,128,116,199,733,1364,8,11988,666,0,2,0,9,47840,19480,3747,26202,0
179,4137,77,34,69,0,0,8,77,3,24,16,29,27,45,114,213,1,387,21,0,2,0,18,47840,19480,3747,26203,0
179,4137,712,438,573,51,9,84,763,14,102,71,128,116,199,733,1364,8,11988,666,0,2,0,18,47850,19481,3747,26204,0
211,5051,722,423,573,19,0,135,741,12,172,101,199,184,300,1320,2257,6,15668,870,0,2,7,9,47850,19483,3747,26206,0
211,5051,1508,847,911,44,250,301,1552,14,148,88,169,162,257,1120,1886,7,15077,837,0,2,7,9,47850,19484,3748,26207,0
211,5051,722,423,573,19,0,135,741,12,172,101,199,184,300,1320,2257,6,15668,870,0,2,0,1,47850,19486,3748,26209,0
211,5051,1508,847,911,44,250,301,1552,14,148,88,169,162,257,1120,1886,7,15077,837,0,2,0,1,47850,19487,3749,26210,0
179,4137,77,34,69,0,0,8,77,3,24,16,29,27,45,114,213,1,387,21,0,2,0,18,47850,19487,3749,26211,0
179,4137,712,438,573,51,9,84,763,14,102,71,128,116,199,733,1364,8,11988,666,0,2,0,18,47860,19488,3749,26212,0
211,5051,722,423,573,19,0,135,741,12,172,101,199,184,300,1320,2257,6,15668,870,0,2,6,9,47860,19490,3749,26214,0
211,5051,1508,847,911,44,250,301,1552,14,148,88,169,162,257,1120,1886,7,15077,837,0,2,6,9,47860,19491,3750,26215,0
347,7012,1457,730,1242,11,6,188,1468,10,292,166,329,302,495,2424,4078,5,22973,1276,1,2,0,9,47860,19493,3750,26216,0
347,7012,74,35,59,1,0,14,75,3,14,7,14,17,21,58,85,1,128,7,0,2,0,9,47860,19494,3750,26217,0
347,7012,245,125,200,5,7,34,250,7,30,17,34,37,51,166,265,3,1053,58,0,2,0,9,47870,19495,3750,26218,0
178,4128,77,34,69,0,0,8,77,3,24,16,29,27,45,114,213,1,387,21,0,2,0,9,47870,19495,3750,26219,0
178,4128,712,438,573,51,9,84,763,14,102,71,128,116,199,733,1364,8,11988,666,0,2,0,9,47880,19496,3750,26220,0
214,4602,182,127,129,0,0,53,182,5,39,21,42,44,63,217,343,2,926,51,0,2,1,1,47880,19496,3751,26221,0
214,4602,1165,710,800,67,119,181,1232,18,243,153,282,261,435,2000,3492,10,36473,2026,1,2,1,1,47890,19496,3752,26222,0
59,1352,996,429,845,24,10,117,1020,7,76,50,88,83,138,494,879,4,3565,198,0,2,34,19,47890,19498,3752,26223,0
59,1352,456,277,329,12,42,72,468,13,85,50,97,98,147,592,972,7,7212,400,0,2,34,19,47890,19498,3752,26224,0
55,1187,207,111,150,11,0,50,218,5,26,19,36,31,55,133,272,3,943,52,0,2,2,1,47890,19498,3752,26225,0
55,1187,410,198,237,31,55,97,441,11,63,38,72,74,110,414,683,6,4293,238,0,2,2,1,47900,19499,3753,26226,0
229,5172,4293,999,3693,19,54,507,4312,9,155,88,170,164,258,1156,1898,4,9368,520,0,2,16,11,47900,19501,3753,26228,0
229,5172,1482,859,1002,125,135,219,1607,16,219,134,251,235,385,1766,3032,9,27804,1544,1,2,16,11,47910,19502,3753,26229,0
50,586,647,139,84,35,284,233,682,0,0,0,0,0,0,0,0,0,0,0,0,2,18,1,47910,19502,3753,26230,0
184,4247,77,34,69,0,0,8,77,3,24,16,29,27,45,114,213,1,387,21,0,2,20,1,47910,19502,3753,26231,0
184,4247,712,438,573,51,9,84,763,14,102,71,128,116,199,733,1364,8,11988,666,0,2,20,1,47920,19503,3753,26232,0
95,1819,1020,354,843,12,15,144,1032,8,134,77,144,142,221,970,1580,4,6792,377,0,2,91,20,47920,19503,3753,26233,0
18,466,205,80,86,16,53,53,221,7,18,10,19,25,29,94,134,3,497,27,0,0,140,0,47930,19503,3754,26234,0
255,6153,72,33,56,0,4,12,72,1,1,1,1,2,2,0,2,0,1,0,0,2,18,467,47930,19503,3754,26235,0
255,6153,1454,835,1044,76,110,219,1530,17,275,158,296,292,454,2297,3718,9,34017,1889,1,2,18,467,47940,19504,3754,26236,0
75,1461,757,253,292,73,244,162,830,13,61,38,67,74,105,409,651,7,4654,258,0,0,616,0,47940,19505,3754,26237,0
40,837,386,256,301,16,9,68,402,4,59,35,69,63,104,355,621,2,1453,80,0,2,2,1,47940,19505,3754,26238,0
40,837,264,131,164,11,41,46,275,6,38,22,40,44,62,214,338,3,1068,59,0,2,2,1,47950,19505,3755,26239,0
112,2470,1043,504,840,53,9,147,1096,9,180,112,198,189,310,1377,2344,4,11604,644,0,2,22,126,47950,19507,3755,26240,0
112,2470,383,288,292,26,6,62,409,11,65,38,67,76,105,429,656,5,3719,206,0,2,22,126,47950,19508,3755,26241,0
102,1930,1178,367,1042,6,15,115,1184,9,94,51,95,103,146,644,976,4,4439,246,0,2,3,16,47950,19508,3755,26242,0
102,1930,177,108,140,8,0,27,185,6,30,16,32,36,48,162,248,3,794,44,0,2,3,16,47950,19510,3755,26243,0
192,3949,1943,715,1694,26,18,214,1969,12,185,120,237,197,357,1436,2721,7,20915,1161,0,2,6,4,47950,19512,3755,26244,0
192,3949,1168,838,957,57,25,144,1225,19,348,224,416,367,640,3018,5452,11,61921,3440,1,2,6,4,47960,19514,3755,26245,0
62,1240,1098,241,925,5,10,155,1103,7,46,25,49,53,74,273,423,3,1580,87,0,2,2,2,47970,19516,3755,26246,0
62,1240,282,202,222,14,2,44,296,8,42,24,43,50,67,250,378,4,1548,86,0,2,2,2,47970,19517,3755,26247,0
21,433,601,196,481,2,23,85,603,8,63,36,72,71,108,400,664,4,3036,168,0,2,5,0,47970,19517,3755,26248,0
21,433,156,79,106,5,16,28,161,5,14,8,15,19,23,64,97,2,261,14,0,2,5,0,47970,19517,3755,26249,0
11,410,42,7,35,4,0,5,46,1,2,1,2,3,3,2,4,0,2,0,0,2,2,1,47970,19517,3755,26250,0
11,410,11,6,10,0,0,1,11,2,4,2,4,6,6,10,15,1,15,0,0,2,2,1,47970,19517,3755,26251,0
149,6984,1392,870,1177,35,17,170,1427,14,494,280,531,508,811,4473,7289,7,54850,3047,2,2,30,0,47970,19520,3756,26252,0
54,3424,520,294,400,33,13,81,553,10,261,204,367,271,571,2128,4614,7,32445,1802,1,2,124,38,47970,19521,3756,26253,0
98,4449,1338,495,1086,10,64,173,1348,11,122,82,157,133,239,883,1686,7,11934,663,0,2,31,1,47970,19523,3756,26254,0
161,7059,139,89,101,2,0,35,141,7,54,34,62,61,96,330,569,4,2287,127,0,2,33,0,47970,19523,3756,26255,0
161,7059,7,5,5,0,0,2,7,1,2,1,2,3,3,2,4,0,2,0,0,2,33,0,47970,19523,3756,26256,0
132,5719,1782,648,1425,9,47,279,1791,8,171,97,189,179,286,1292,2140,4,9462,525,0,2,2,1,47970,19524,3757,26257,0
72,3755,1296,573,1062,40,33,157,1336,8,201,118,231,209,349,1561,2689,4,12365,686,0,2,48,1,47970,19524,3757,26258,0
72,3114,1020,354,843,12,15,144,1032,8,134,77,144,142,221,970,1580,4,6792,377,0,2,36,1,47970,19524,3757,26259,0
36,1591,386,256,301,16,9,68,402,4,59,35,69,63,104,355,621,2,1453,80,0,2,1,27,47970,19524,3757,26260,0
75,2972,1043,504,840,53,9,147,1096,9,180,112,198,189,310,1377,2344,4,11604,644,0,2,37,2,47970,19526,3757,26261,0
75,3810,1943,715,1694,26,18,214,1969,12,185,120,237,197,357,1436,2721,7,20915,1161,0,2,17,0,47970,19528,3757,26262,0
48,1795,1098,241,925,5,10,155,1103,7,46,25,49,53,74,273,423,3,1580,87,0,2,57,62,47980,19530,3757,26263,0
15,568,601,196,481,2,23,85,603,8,63,36,72,71,108,400,664,4,3036,168,0,2,33,0,47980,19530,3757,26264,0
212,5103,722,423,573,19,0,135,741,12,172,101,199,184,300,1320,2257,6,15668,870,0,2,8,4,47980,19532,3757,26266,0
212,5103,1508,847,911,44,250,301,1552,14,148,88,169,162,257,1120,1886,7,15077,837,0,2,8,4,47980,19533,3758,26267,0
113,2497,1043,504,840,53,9,147,1096,9,180,112,198,189,310,1377,2344,4,11604,644,0,2,6,1,47980,19535,3758,26268,0
113,2497,383,288,292,26,6,62,409,11,65,38,67,76,105,429,656,5,3719,206,0,2,6,1,47980,19536,3758,26269,0
81,3461,1289,550,1043,56,32,155,1345,10,167,93,185,177,278,1266,2075,5,11498,638,0,2,14,1,47980,19538,3759,26270,0
113,2492,1043,504,840,53,9,147,1096,9,180,112,198,189,310,1377,2344,4,11604,644,0,2,2,2,47980,19540,3759,26271,0
113,2492,383,288,292,26,6,62,409,11,65,38,67,76,105,429,656,5,3719,206,0,2,2,2,47980,19541,3759,26272,0
212,5103,722,423,573,19,0,135,741,12,172,101,199,184,300,1320,2257,6,15668,870,0,2,8,4,47980,19543,3759,26274,0
212,5103,1508,847,911,44,250,301,1552,14,148,88,169,162,257,1120,1886,7,15077,837,0,2,8,4,47980,19544,3760,26275,0
113,2492,1043,504,840,53,9,147,1096,9,180,112,198,189,310,1377,2344,4,11604,644,0,2,6,1,47980,19546,3760,26276,0
113,2492,383,288,292,26,6,62,409,11,65,38,67,76,105,429,656,5,3719,206,0,2,6,1,47980,19547,3760,26277,0
81,3461,1289,550,1043,56,32,155,1345,10,167,93,185,177,278,1266,2075,5,11498,638,0,2,14,1,47980,19549,3761,26278,0
193,3988,1943,715,1694,26,18,214,1969,12,185,120,237,197,357,1436,2721,7,20915,1161,0,2,17,6,47980,19551,3761,26279,1
193,3988,1168,838,957,57,25,144,1225,19,348,224,416,367,640,3018,5452,11,61921,3440,1,2,17,6,47990,19553,3761,26280,1
76,3899,1943,715,1694,26,18,214,1969,12,185,120,237,197,357,1436,2721,7,20915,1161,0,2,10,0,47990,19555,3761,26281,1
213,4579,182,127,129,0,0,53,182,5,39,21,42,44,63,217,343,2,926,51,0,2,1,3,47990,19555,3762,26282,1
213,4579,1165,710,800,67,119,181,1232,18,243,153,282,261,435,2000,3492,10,36473,2026,1,2,1,3,48000,19555,3763,26283,1
102,2083,773,419,590,28,0,166,801,10,204,113,217,214,330,1598,2554,5,13587,754,0,2,2,1,48000,19555,3764,26284,1
102,2083,421,273,302,44,34,57,465,17,81,59,107,98,166,583,1098,11,12329,684,0,2,2,1,48000,19555,3765,26285,1
27,540,2,2,2,0,0,0,2,0,0,0,0,0,0,0,0,0,0,0,0,2,2,2,48000,19555,3765,26285,1
27,540,99,48,90,1,3,5,100,0,0,0,0,0,0,0,0,0,0,0,0,2,2,2,48000,19556,3765,26286,1
27,540,8,5,5,2,0,1,10,0,0,0,0,0,0,0,0,0,0,0,0,2,2,2,48000,19556,3765,26287,1
27,540,1217,716,841,84,126,174,1301,14,185,118,215,199,333,1446,2542,8,20687,1149,0,2,2,2,48010,19558,3765,26288,1
27,540,160,89,115,0,13,31,160,7,15,11,17,22,28,78,124,3,495,27,0,2,2,2,48010,19558,3765,26289,1
27,540,10,10,9,9,0,0,19,0,0,0,0,0,0,0,0,0,0,0,0,2,2,2,48010,19558,3766,26290,1
27,540,173,84,99,8,29,36,181,5,12,7,13,17,20,54,81,2,221,12,0,2,2,2,48010,19559,3766,26291,1
27,540,3,1,1,3,0,0,6,0,0,0,0,0,0,0,0,0,0,0,0,2,2,2,48010,19559,3766,26292,1
164,5068,1660,832,1314,41,38,274,1701,20,312,209,395,332,604,2671,5058,12,64042,3557,1,2,12,11,48010,19561,3767,26294,1
164,5068,1057,646,719,113,100,145,1170,18,215,134,248,233,382,1740,3004,10,31186,1732,1,2,12,11,48020,19562,3768,26295,1
17,345,95,58,50,9,16,20,104,12,33,24,45,45,69,209,378,8,3100,172,0,2,3,3,48020,19562,3768,26296,1
86,1804,477,336,357,30,23,73,507,16,194,134,250,210,384,1538,2962,10,30538,1696,0,2,4,3,48030,19563,3768,26297,1
132,2644,1513,682,1277,25,13,200,1538,11,199,116,219,210,335,1557,2584,6,15641,868,0,2,4,5,48030,19565,3768,26298,1
132,2644,819,519,539,24,98,155,843,15,96,57,106,111,163,690,1107,8,9171,509,0,2,4,5,48040,19567,3768,26299,1
349,7034,1457,730,1242,11,6,188,1468,10,292,166,329,302,495,2424,4078,5,22973,1276,1,2,5,4,48040,19569,3768,26300,1
349,7034,74,35,59,1,0,14,75,3,14,7,14,17,21,58,85,1,128,7,0,2,5,4,48040,19570,3768,26301,1
349,7034,245,125,200,5,7,34,250,7,30,17,34,37,51,166,265,3,1053,58,0,2,5,4,48050,19571,3768,26302,1
184,4243,77,34,69,0,0,8,77,3,24,16,29,27,45,114,213,1,387,21,0,2,2,1,48050,19571,3768,26303,1
184,4243,712,438,573,51,9,84,763,14,102,71,128,116,199,733,1364,8,11988,666,0,2,2,1,48060,19572,3768,26304,1
46,957,447,308,343,6,5,95,453,7,96,59,111,103,170,651,1136,4,4600,255,0,2,4,5,48060,19575,3768,26305,1
46,957,322,174,179,16,74,51,338,10,41,26,46,51,72,252,408,5,2291,127,0,2,4,5,48060,19578,3769,26306,1
23,382,424,94,331,4,0,89,428,1,5,5,5,6,10,11,25,0,12,0,0,2,1,2,48060,19579,3769,26307,1
23,382,38,23,23,6,0,8,44,3,11,7,11,14,18,42,68,1,102,5,0,2,1,2,48060,19579,3769,26308,1
17,518,184,100,137,2,15,30,186,6,38,20,39,44,59,214,322,3,991,55,0,2,2,2,48060,19580,3769,26309,1
17,518,103,65,74,8,5,16,111,7,17,9,17,24,26,89,119,3,417,23,0,2,2,2,48060,19581,3769,26310,1
212,5055,722,423,573,19,0,135,741,12,172,101,199,184,300,1320,2257,6,15668,870,0,2,6,5,48060,19583,3769,26312,1
212,5055,1508,847,911,44,250,301,1552,14,148,88,169,162,257,1120,1886,7,15077,837,0,2,6,5,48060,19584,3770,26313,1
255,6147,72,33,56,0,4,12,72,1,1,1,1,2,2,0,2,0,1,0,0,2,4,3,48060,19584,3770,26314,1
255,6147,1454,835,1044,76,110,219,1530,17,275,158,296,292,454,2297,3718,9,34017,1889,1,2,4,3,48070,19585,3770,26315,1
129,2871,1043,504,840,53,9,147,1096,9,180,112,198,189,310,1377,2344,4,11604,644,0,2,1,1,48070,19587,3770,26316,1
129,2871,383,288,292,26,6,62,409,11,65,38,67,76,105,429,656,5,3719,206,0,2,1,1,48070,19588,3770,26317,1
103,1953,1178,367,1042,6,15,115,1184,9,94,51,95,103,146,644,976,4,4439,246,0,2,2,2,48070,19588,3770,26318,1
103,1953,177,108,140,8,0,27,185,6,30,16,32,36,48,162,248,3,794,44,0,2,2,2,48070,19590,3770,26319,1
192,3947,1943,715,1694,26,18,214,1969,12,185,120,237,197,357,1436,2721,7,20915,1161,0,2,4,3,48070,19592,3770,26320,1
192,3947,1168,838,957,57,25,144,1225,19,348,224,416,367,640,3018,5452,11,61921,3440,1,2,4,3,48080,19594,3770,26321,1
11,404,42,7,35,4,0,5,46,1,2,1,2,3,3,2,4,0,2,0,0,2,1,1,48080,19594,3770,26322,1
11,404,11,6,10,0,0,1,11,2,4,2,4,6,6,10,15,1,15,0,0,2,1,1,48080,19594,3770,26323,1
214,4586,182,127,129,0,0,53,182,5,39,21,42,44,63,217,343,2,926,51,0,2,1,3,48080,19594,3771,26324,0
214,4586,1165,710,800,67,119,181,1232,18,243,153,282,261,435,2000,3492,10,36473,2026,1,2,1,3,48090,19594,3772,26325,0
102,2083,773,419,590,28,0,166,801,10,204,113,217,214,330,1598,2554,5,13587,754,0,2,2,1,48090,19594,3773,26326,0
102,2083,421,273,302,44,34,57,465,17,81,59,107,98,166,583,1098,11,12329,684,0,2,2,1,48090,19594,3774,26327,0
27,540,2,2,2,0,0,0,2,0,0,0,0,0,0,0,0,0,0,0,0,2,2,2,48090,19594,3774,26327,0
27,540,99,48,90,1,3,5,100,0,0,0,0,0,0,0,0,0,0,0,0,2,2,2,48090,19595,3774,26328,0
27,540,8,5,5,2,0,1,10,0,0,0,0,0,0,0,0,0,0,0,0,2,2,2,48090,19595,3774,26329,0
27,540,1217,716,841,84,126,174,1301,14,185,118,215,199,333,1446,2542,8,20687,1149,0,2,2,2,48100,19597,3774,26330,0
27,540,160,89,115,0,13,31,160,7,15,11,17,22,28,78,124,3,495,27,0,2,2,2,48100,19597,3774,26331,0
27,540,10,10,9,9,0,0,19,0,0,0,0,0,0,0,0,0,0,0,0,2,2,2,48100,19597,3775,26332,0
27,540,173,84,99,8,29,36,181,5,12,7,13,17,20,54,81,2,221,12,0,2,2,2,48100,19598,3775,26333,0
27,540,3,1,1,3,0,0,6,0,0,0,0,0,0,0,0,0,0,0,0,2,2,2,48100,19598,3775,26334,0
164,5068,1660,832,1314,41,38,274,1701,20,312,209,395,332,604,2671,5058,12,64042,3557,1,2,12,11,48100,19600,3776,26336,0
164,5068,1057,646,719,113,100,145,1170,18,215,134,248,233,382,1740,3004,10,31186,1732,1,2,12,11,48110,19601,3777,26337,0
17,345,95,58,50,9,16,20,104,12,33,24,45,45,69,209,378,8,3100,172,0,2,3,3,48110,19601,3777,26338,0
86,1804,477,336,357,30,23,73,507,16,194,134,250,210,384,1538,2962,10,30538,1696,0,2,4,3,48120,19602,3777,26339,0
132,2644,1513,682,1277,25,13,200,1538,11,199,116,219,210,335,1557,2584,6,15641,868,0,2,4,5,48120,19604,3777,26340,0
132,2644,819,519,539,24,98,155,843,15,96,57,106,111,163,690,1107,8,9171,509,0,2,4,5,48130,19606,3777,26341,0
347,7004,1457,730,1242,11,6,188,1468,10,292,166,329,302,495,2424,4078,5,22973,1276,1,2,5,4,48130,19608,3777,26342,0
347,7004,74,35,59,1,0,14,75,3,14,7,14,17,21,58,85,1,128,7,0,2,5,4,48130,19609,3777,26343,0
347,7004,245,125,200,5,7,34,250,7,30,17,34,37,51,166,265,3,1053,58,0,2,5,4,48140,19610,3777,26344,0
178,4128,77,34,69,0,0,8,77,3,24,16,29,27,45,114,213,1,387,21,0,2,2,1,48140,19610,3777,26345,0
178,4128,712,438,573,51,9,84,763,14,102,71,128,116,199,733,1364,8,11988,666,0,2,2,1,48150,19611,3777,26346,0
46,957,447,308,343,6,5,95,453,7,96,59,111,103,170,651,1136,4,4600,255,0,2,4,5,48150,19614,3777,26347,0
46,957,322,174,179,16,74,51,338,10,41,26,46,51,72,252,408,5,2291,127,0,2,4,5,48150,19617,3778,26348,0
23,382,424,94,331,4,0,89,428,1,5,5,5,6,10,11,25,0,12,0,0,2,1,2,48150,19618,3778,26349,0
23,382,38,23,23,6,0,8,44,3,11,7,11,14,18,42,68,1,102,5,0,2,1,2,48150,19618,3778,26350,0
17,518,184,100,137,2,15,30,186,6,38,20,39,44,59,214,322,3,991,55,0,2,2,2,48150,19619,3778,26351,0
17,518,103,65,74,8,5,16,111,7,17,9,17,24,26,89,119,3,417,23,0,2,2,2,48150,19620,3778,26352,0
211,5043,722,423,573,19,0,135,741,12,172,101,199,184,300,1320,2257,6,15668,870,0,2,6,5,48150,19622,3778,26354,0
211,5043,1508,847,911,44,250,301,1552,14,148,88,169,162,257,1120,1886,7,15077,837,0,2,6,5,48150,19623,3779,26355,0
255,6147,72,33,56,0,4,12,72,1,1,1,1,2,2,0,2,0,1,0,0,2,4,3,48150,19623,3779,26356,0
255,6147,1454,835,1044,76,110,219,1530,17,275,158,296,292,454,2297,3718,9,34017,1889,1,2,4,3,48160,19624,3779,26357,0
112,2466,1043,504,840,53,9,147,1096,9,180,112,198,189,310,1377,2344,4,11604,644,0,2,1,1,48160,19626,3779,26358,0
112,2466,383,288,292,26,6,62,409,11,65,38,67,76,105,429,656,5,3719,206,0,2,1,1,48160,19627,3779,26359,0
102,1928,1178,367,1042,6,15,115,1184,9,94,51,95,103,146,644,976,4,4439,246,0,2,2,2,48160,19627,3779,26360,0
102,1928,177,108,140,8,0,27,185,6,30,16,32,36,48,162,248,3,794,44,0,2,2,2,48160,19629,3779,26361,0
192,3947,1943,715,1694,26,18,214,1969,12,185,120,237,197,357,1436,2721,7,20915,1161,0,2,4,3,48160,19631,3779,26362,0
192,3947,1168,838,957,57,25,144,1225,19,348,224,416,367,640,3018,5452,11,61921,3440,1,2,4,3,48170,19633,3779,26363,0
11,412,42,7,35,4,0,5,46,1,2,1,2,3,3,2,4,0,2,0,0,2,1,1,48170,19633,3779,26364,0
11,412,11,6,10,0,0,1,11,2,4,2,4,6,6,10,15,1,15,0,0,2,1,1,48170,19633,3779,26365,0
193,3988,1943,715,1694,26,18,214,1969,12,185,120,237,197,357,1436,2721,7,20915,1161,0,2,17,6,48170,19635,3779,26366,0
193,3988,1168,838,957,57,25,144,1225,19,348,224,416,367,640,3018,5452,11,61921,3440,1,2,17,6,48180,19637,3779,26367,0
76,3899,1943,715,1694,26,18,214,1969,12,185,120,237,197,357,1436,2721,7,20915,1161,0,2,10,0,48180,19639,3779,26368,0
351,7048,1457,730,1242,11,6,188,1468,10,292,166,329,302,495,2424,4078,5,22973,1276,1,2,15,10,48180,19641,3779,26369,0
351,7048,74,35,59,1,0,14,75,3,14,7,14,17,21,58,85,1,128,7,0,2,15,10,48180,19642,3779,26370,0
351,7048,245,125,200,5,7,34,250,7,30,17,34,37,51,166,265,3,1053,58,0,2,15,10,48190,19643,3779,26371,0
79,4191,1457,730,1242,11,6,188,1468,10,292,166,329,302,495,2424,4078,5,22973,1276,1,2,11,1,48190,19645,3779,26372,0
351,7048,1457,730,1242,11,6,188,1468,10,292,166,329,302,495,2424,4078,5,22973,1276,1,2,15,10,48190,19647,3779,26373,0
351,7048,74,35,59,1,0,14,75,3,14,7,14,17,21,58,85,1,128,7,0,2,15,10,48190,19648,3779,26374,0
351,7048,245,125,200,5,7,34,250,7,30,17,34,37,51,166,265,3,1053,58,0,2,15,10,48200,19649,3779,26375,0
79,4191,1457,730,1242,11,6,188,1468,10,292,166,329,302,495,2424,4078,5,22973,1276,1,2,11,1,48200,19651,3779,26376,0
133,2659,1513,682,1277,25,13,200,1538,11,199,116,219,210,335,1557,2584,6,15641,868,0,2,11,4,48200,19653,3779,26377,0
133,2659,819,519,539,24,98,155,843,15,96,57,106,111,163,690,1107,8,9171,509,0,2,11,4,48210,19655,3779,26378,0
120,4833,1513,682,1277,25,13,200,1538,11,199,116,219,210,335,1557,2584,6,15641,868,0,2,17,0,48210,19657,3779,26379,0
133,2659,1513,682,1277,25,13,200,1538,11,199,116,219,210,335,1557,2584,6,15641,868,0,2,11,4,48210,19659,3779,26380,0
133,2659,819,519,539,24,98,155,843,15,96,57,106,111,163,690,1107,8,9171,509,0,2,11,4,48220,19661,3779,26381,0
120,4833,1513,682,1277,25,13,200,1538,11,199,116,219,210,335,1557,2584,6,15641,868,0,2,17,0,48220,19663,3779,26382,0
93,1794,1020,354,843,12,15,144,1032,8,134,77,144,142,221,970,1580,4,6792,377,0,2,0,4,48220,19663,3779,26383,1
255,6154,72,33,56,0,4,12,72,1,1,1,1,2,2,0,2,0,1,0,0,2,14,8,48220,19663,3779,26384,1
255,6154,1454,835,1044,76,110,219,1530,17,275,158,296,292,454,2297,3718,9,34017,1889,1,2,14,8,48230,19664,3779,26385,1
132,5724,1782,648,1425,9,47,279,1791,8,171,97,189,179,286,1292,2140,4,9462,525,0,2,1,1,48230,19665,3780,26386,1
229,5176,4293,999,3693,19,54,507,4312,9,155,88,170,164,258,1156,1898,4,9368,520,0,2,2,1,48230,19667,3780,26387,0
229,5176,1482,859,1002,125,135,219,1607,16,219,134,251,235,385,1766,3032,9,27804,1544,1,2,2,1,48240,19668,3780,26388,0
229,5176,4293,999,3693,19,54,507,4312,9,155,88,170,164,258,1156,1898,4,9368,520,0,2,2,1,48240,19670,3780,26389,0
229,5176,1482,859,1002,125,135,219,1607,16,219,134,251,235,385,1766,3032,9,27804,1544,1,2,2,1,48250,19671,3780,26390,0
106,1993,1178,367,1042,6,15,115,1184,9,94,51,95,103,146,644,976,4,4439,246,0,2,14,3,48250,19671,3780,26391,0
106,1993,177,108,140,8,0,27,185,6,30,16,32,36,48,162,248,3,794,44,0,2,14,3,48250,19673,3780,26392,0
72,3050,1178,367,1042,6,15,115,1184,9,94,51,95,103,146,644,976,4,4439,246,0,2,22,0,48250,19673,3780,26393,0
93,1794,1020,354,843,12,15,144,1032,8,134,77,144,142,221,970,1580,4,6792,377,0,2,0,4,48250,19673,3780,26394,0
255,6154,72,33,56,0,4,12,72,1,1,1,1,2,2,0,2,0,1,0,0,2,14,8,48250,19673,3780,26395,0
255,6154,1454,835,1044,76,110,219,1530,17,275,158,296,292,454,2297,3718,9,34017,1889,1,2,14,8,48260,19674,3780,26396,0
132,5724,1782,648,1425,9,47,279,1791,8,171,97,189,179,286,1292,2140,4,9462,525,0,2,1,1,48260,19675,3781,26397,0
106,1993,1178,367,1042,6,15,115,1184,9,94,51,95,103,146,644,976,4,4439,246,0,2,14,3,48260,19675,3781,26398,0
106,1993,177,108,140,8,0,27,185,6,30,16,32,36,48,162,248,3,794,44,0,2,14,3,48260,19677,3781,26399,0
72,3050,1178,367,1042,6,15,115,1184,9,94,51,95,103,146,644,976,4,4439,246,0,2,22,0,48260,19677,3781,26400,0
75,1461,757,253,292,73,244,162,830,13,61,38,67,74,105,409,651,7,4654,258,0,2,12,3,48260,19678,3781,26401,0
75,1461,757,253,292,73,244,162,830,13,61,38,67,74,105,409,651,7,4654,258,0,2,12,3,48260,19679,3781,26402,0
58,1227,207,111,150,11,0,50,218,5,26,19,36,31,55,133,272,3,943,52,0,2,4,1,48260,19679,3781,26403,1
58,1227,410,198,237,31,55,97,441,11,63,38,72,74,110,414,683,6,4293,238,0,2,4,1,48270,19680,3782,26404,1
228,5164,4293,999,3693,19,54,507,4312,9,155,88,170,164,258,1156,1898,4,9368,520,0,2,1,5,48270,19682,3782,26405,1
228,5164,1482,859,1002,125,135,219,1607,16,219,134,251,235,385,1766,3032,9,27804,1544,1,2,1,5,48280,19683,3782,26406,1
98,4450,1338,495,1086,10,64,173,1348,11,122,82,157,133,239,883,1686,7,11934,663,0,2,12,2,48280,19685,3782,26407,1
162,7089,139,89,101,2,0,35,141,7,54,34,62,61,96,330,569,4,2287,127,0,2,6,0,48280,19685,3782,26408,1
162,7089,7,5,5,0,0,2,7,1,2,1,2,3,3,2,4,0,2,0,0,2,6,0,48280,19685,3782,26409,1
55,1193,207,111,150,11,0,50,218,5,26,19,36,31,55,133,272,3,943,52,0,2,5,2,48280,19685,3782,26410,1
55,1193,410,198,237,31,55,97,441,11,63,38,72,74,110,414,683,6,4293,238,0,2,5,2,48290,19686,3783,26411,1
14,341,207,111,150,11,0,50,218,5,26,19,36,31,55,133,272,3,943,52,0,2,26,1,48290,19686,3783,26412,1
11,414,42,7,35,4,0,5,46,1,2,1,2,3,3,2,4,0,2,0,0,2,1,1,48300,19690,3784,26420,0
11,414,11,6,10,0,0,1,11,2,4,2,4,6,6,10,15,1,15,0,0,2,1,1,48300,19690,3784,26421,0
11,412,42,7,35,4,0,5,46,1,2,1,2,3,3,2,4,0,2,0,0,2,1,1,48300,19690,3784,26422,0
11,412,11,6,10,0,0,1,11,2,4,2,4,6,6,10,15,1,15,0,0,2,1,1,48300,19690,3784,26423,0
347,7004,1457,730,1242,11,6,188,1468,10,292,166,329,302,495,2424,4078,5,22973,1276,1,2,2,2,48300,19692,3784,26424,0
347,7004,74,35,59,1,0,14,75,3,14,7,14,17,21,58,85,1,128,7,0,2,2,2,48300,19693,3784,26425,0
347,7004,245,125,200,5,7,34,250,7,30,17,34,37,51,166,265,3,1053,58,0,2,2,2,48310,19694,3784,26426,0
347,7002,1457,730,1242,11,6,188,1468,10,292,166,329,302,495,2424,4078,5,22973,1276,1,2,3,3,48310,19696,3784,26427,0
347,7002,74,35,59,1,0,14,75,3,14,7,14,17,21,58,85,1,128,7,0,2,3,3,48310,19697,3784,26428,0
347,7002,245,125,200,5,7,34,250,7,30,17,34,37,51,166,265,3,1053,58,0,2,3,3,48320,19698,3784,26429,0
50,584,647,139,84,35,284,233,682,0,0,0,0,0,0,0,0,0,0,0,0,2,1,1,48320,19698,3784,26430,0
255,6150,72,33,56,0,4,12,72,1,1,1,1,2,2,0,2,0,1,0,0,2,1,1,48320,19698,3784,26431,0
255,6150,1454,835,1044,76,110,219,1530,17,275,158,296,292,454,2297,3718,9,34017,1889,1,2,1,1,48330,19699,3784,26432,0
192,3943,1943,715,1694,26,18,214,1969,12,185,120,237,197,357,1436,2721,7,20915,1161,0,2,1,2,48330,19701,3784,26433,0
192,3943,1168,838,957,57,25,144,1225,19,348,224,416,367,640,3018,5452,11,61921,3440,1,2,1,2,48340,19703,3784,26434,0
75,3806,1943,715,1694,26,18,214,1969,12,185,120,237,197,357,1436,2721,7,20915,1161,0,2,1,1,48340,19705,3784,26435,0
11,412,42,7,35,4,0,5,46,1,2,1,2,3,3,2,4,0,2,0,0,2,1,1,48340,19705,3784,26436,0
11,412,11,6,10,0,0,1,11,2,4,2,4,6,6,10,15,1,15,0,0,2,1,1,48340,19705,3784,26437,0
347,7002,1457,730,1242,11,6,188,1468,10,292,166,329,302,495,2424,4078,5,22973,1276,1,2,3,3,48340,19707,3784,26438,0
347,7002,74,35,59,1,0,14,75,3,14,7,14,17,21,58,85,1,128,7,0,2,3,3,48340,19708,3784,26439,0
347,7002,245,125,200,5,7,34,250,7,30,17,34,37,51,166,265,3,1053,58,0,2,3,3,48350,19709,3784,26440,0
50,584,647,139,84,35,284,233,682,0,0,0,0,0,0,0,0,0,0,0,0,2,1,1,48350,19709,3784,26441,0
255,6150,72,33,56,0,4,12,72,1,1,1,1,2,2,0,2,0,1,0,0,2,1,1,48350,19709,3784,26442,0
255,6150,1454,835,1044,76,110,219,1530,17,275,158,296,292,454,2297,3718,9,34017,1889,1,2,1,1,48360,19710,3784,26443,0
192,3943,1943,715,1694,26,18,214,1969,12,185,120,237,197,357,1436,2721,7,20915,1161,0,2,1,2,48360,19712,3784,26444,0
192,3943,1168,838,957,57,25,144,1225,19,348,224,416,367,640,3018,5452,11,61921,3440,1,2,1,2,48370,19714,3784,26445,0
11,412,42,7,35,4,0,5,46,1,2,1,2,3,3,2,4,0,2,0,0,2,2,2,48380,19718,3785,26453,0
11,412,11,6,10,0,0,1,11,2,4,2,4,6,6,10,15,1,15,0,0,2,2,2,48380,19718,3785,26454,0
75,3806,1943,715,1694,26,18,214,1969,12,185,120,237,197,357,1436,2721,7,20915,1161,0,2,1,1,48380,19720,3785,26455,0
54,1170,207,111,150,11,0,50,218,5,26,19,36,31,55,133,272,3,943,52,0,2,1,8,48380,19720,3785,26456,0
54,1170,410,198,237,31,55,97,441,11,63,38,72,74,110,414,683,6,4293,238,0,2,1,8,48390,19721,3786,26457,0
214,4608,182,127,129,0,0,53,182,5,39,21,42,44,63,217,343,2,926,51,0,2,1,1,48390,19721,3787,26458,1
214,4608,1165,710,800,67,119,181,1232,18,243,153,282,261,435,2000,3492,10,36473,2026,1,2,1,1,48400,19721,3788,26459,1
36,1085,182,127,129,0,0,53,182,5,39,21,42,44,63,217,343,2,926,51,0,2,22,0,48400,19721,3789,26460,1
55,1193,207,111,150,11,0,50,218,5,26,19,36,31,55,133,272,3,943,52,0,2,5,2,48400,19721,3789,26461,0
55,1193,410,198,237,31,55,97,441,11,63,38,72,74,110,414,683,6,4293,238,0,2,5,2,48410,19722,3790,26462,0
14,341,207,111,150,11,0,50,218,5,26,19,36,31,55,133,272,3,943,52,0,2,26,1,48410,19722,3790,26463,0
214,4608,182,127,129,0,0,53,182,5,39,21,42,44,63,217,343,2,926,51,0,2,1,1,48410,19722,3791,26464,0
214,4608,1165,710,800,67,119,181,1232,18,243,153,282,261,435,2000,3492,10,36473,2026,1,2,1,1,48420,19722,3792,26465,0
36,1085,182,127,129,0,0,53,182,5,39,21,42,44,63,217,343,2,926,51,0,2,22,0,48420,19722,3793,26466,0
212,5013,722,423,573,19,0,135,741,12,172,101,199,184,300,1320,2257,6,15668,870,0,2,11,16,48420,19724,3793,26468,1
212,5013,1508,847,911,44,250,301,1552,14,148,88,169,162,257,1120,1886,7,15077,837,0,2,11,16,48420,19725,3794,26469,1
16,677,722,423,573,19,0,135,741,12,172,101,199,184,300,1320,2257,6,15668,870,0,2,11,0,48420,19727,3794,26471,1
7,281,75,38,59,1,3,12,76,2,4,2,4,6,6,10,15,1,15,0,0,2,4,1,48420,19727,3794,26473,0
7,281,75,38,59,1,3,12,76,2,4,2,4,6,6,10,15,1,15,0,0,2,4,1,48420,19727,3794,26475,0
212,5013,722,423,573,19,0,135,741,12,172,101,199,184,300,1320,2257,6,15668,870,0,2,11,16,48420,19729,3794,26477,0
212,5013,1508,847,911,44,250,301,1552,14,148,88,169,162,257,1120,1886,7,15077,837,0,2,11,16,48420,19730,3795,26478,0
16,677,722,423,573,19,0,135,741,12,172,101,199,184,300,1320,2257,6,15668,870,0,2,11,0,48420,19732,3795,26480,0
12,424,42,7,35,4,0,5,46,1,2,1,2,3,3,2,4,0,2,0,0,2,5,1,48420,19732,3795,26481,0
12,424,11,6,10,0,0,1,11,2,4,2,4,6,6,10,15,1,15,0,0,2,5,1,48420,19732,3795,26482,0
345,6927,1457,730,1242,11,6,188,1468,10,292,166,329,302,495,2424,4078,5,22973,1276,1,2,0,11,48420,19734,3795,26483,1
345,6927,74,35,59,1,0,14,75,3,14,7,14,17,21,58,85,1,128,7,0,2,0,11,48420,19735,3795,26484,1
345,6927,245,125,200,5,7,34,250,7,30,17,34,37,51,166,265,3,1053,58,0,2,0,11,48430,19736,3795,26485,1
98,4449,1338,495,1086,10,64,173,1348,11,122,82,157,133,239,883,1686,7,11934,663,0,2,5,3,48430,19738,3795,26486,1
72,3755,1296,573,1062,40,33,157,1336,8,201,118,231,209,349,1561,2689,4,12365,686,0,2,5,3,48430,19738,3795,26487,1
33,1889,384,251,317,7,8,52,391,11,70,44,84,81,128,467,811,6,5355,297,0,2,0,17,48430,19738,3795,26488,1
75,2972,1043,504,840,53,9,147,1096,9,180,112,198,189,310,1377,2344,4,11604,644,0,2,7,5,48430,19740,3795,26489,1
48,1795,1098,241,925,5,10,155,1103,7,46,25,49,53,74,273,423,3,1580,87,0,2,4,2,48440,19742,3795,26490,1
39,1758,386,256,301,16,9,68,402,4,59,35,69,63,104,355,621,2,1453,80,0,2,22,0,48440,19742,3795,26491,1
57,1218,207,111,150,11,0,50,218,5,26,19,36,31,55,133,272,3,943,52,0,2,15,1,48440,19742,3795,26492,0
57,1218,410,198,237,31,55,97,441,11,63,38,72,74,110,414,683,6,4293,238,0,2,15,1,48450,19743,3796,26493,0
210,4982,722,423,573,19,0,135,741,12,172,101,199,184,300,1320,2257,6,15668,870,0,2,1,9,48450,19745,3796,26495,0
210,4982,1508,847,911,44,250,301,1552,14,148,88,169,162,257,1120,1886,7,15077,837,0,2,1,9,48450,19746,3797,26496,0
72,3743,1296,573,1062,40,33,157,1336,8,201,118,231,209,349,1561,2689,4,12365,686,0,2,0,1,48450,19746,3797,26497,0
210,4982,722,423,573,19,0,135,741,12,172,101,199,184,300,1320,2257,6,15668,870,0,2,1,9,48450,19748,3797,26499,0
210,4982,1508,847,911,44,250,301,1552,14,148,88,169,162,257,1120,1886,7,15077,837,0,2,1,9,48450,19749,3798,26500,0
72,3743,1296,573,1062,40,33,157,1336,8,201,118,231,209,349,1561,2689,4,12365,686,0,2,0,1,48450,19749,3798,26501,0
72,3755,1296,573,1062,40,33,157,1336,8,201,118,231,209,349,1561,2689,4,12365,686,0,2,1,1,48450,19749,3798,26502,0
58,1228,207,111,150,11,0,50,218,5,26,19,36,31,55,133,272,3,943,52,0,2,5,0,48450,19749,3798,26503,1
58,1228,410,198,237,31,55,97,441,11,63,38,72,74,110,414,683,6,4293,238,0,2,5,0,48460,19750,3799,26504,1
214,4592,182,127,129,0,0,53,182,5,39,21,42,44,63,217,343,2,926,51,0,2,1,1,48460,19750,3800,26505,0
214,4592,1165,710,800,67,119,181,1232,18,243,153,282,261,435,2000,3492,10,36473,2026,1,2,1,1,48470,19750,3801,26506,0
133,2652,1513,682,1277,25,13,200,1538,11,199,116,219,210,335,1557,2584,6,15641,868,0,2,11,4,48470,19752,3801,26507,0
133,2652,819,519,539,24,98,155,843,15,96,57,106,111,163,690,1107,8,9171,509,0,2,11,4,48480,19754,3801,26508,0
55,1193,207,111,150,11,0,50,218,5,26,19,36,31,55,133,272,3,943,52,0,2,5,2,48480,19754,3801,26509,0
55,1193,410,198,237,31,55,97,441,11,63,38,72,74,110,414,683,6,4293,238,0,2,5,2,48490,19755,3802,26510,0
349,7008,1457,730,1242,11,6,188,1468,10,292,166,329,302,495,2424,4078,5,22973,1276,1,2,15,10,48490,19757,3802,26511,0
349,7008,74,35,59,1,0,14,75,3,14,7,14,17,21,58,85,1,128,7,0,2,15,10,48490,19758,3802,26512,0
349,7008,245,125,200,5,7,34,250,7,30,17,34,37,51,166,265,3,1053,58,0,2,15,10,48500,19759,3802,26513,0
229,5176,4293,999,3693,19,54,507,4312,9,155,88,170,164,258,1156,1898,4,9368,520,0,2,2,1,48500,19761,3802,26515,0
229,5176,1482,859,1002,125,135,219,1607,16,219,134,251,235,385,1766,3032,9,27804,1544,1,2,2,1,48510,19762,3802,26516,0
210,5022,722,423,573,19,0,135,741,12,172,101,199,184,300,1320,2257,6,15668,870,0,2,8,4,48510,19764,3802,26518,0
210,5022,1508,847,911,44,250,301,1552,14,148,88,169,162,257,1120,1886,7,15077,837,0,2,8,4,48510,19765,3803,26519,0
75,1461,757,253,292,73,244,162,830,13,61,38,67,74,105,409,651,7,4654,258,0,2,12,3,48510,19766,3803,26520,0
113,2488,1043,504,840,53,9,147,1096,9,180,112,198,189,310,1377,2344,4,11604,644,0,2,6,1,48510,19768,3803,26521,0
113,2488,383,288,292,26,6,62,409,11,65,38,67,76,105,429,656,5,3719,206,0,2,6,1,48510,19769,3803,26522,0
193,3982,1943,715,1694,26,18,214,1969,12,185,120,237,197,357,1436,2721,7,20915,1161,0,2,17,6,48510,19771,3803,26523,0
193,3982,1168,838,957,57,25,144,1225,19,348,224,416,367,640,3018,5452,11,61921,3440,1,2,17,6,48520,19773,3803,26524,0
81,3461,1289,550,1043,56,32,155,1345,10,167,93,185,177,278,1266,2075,5,11498,638,0,2,14,1,48520,19775,3804,26525,0
36,1085,182,127,129,0,0,53,182,5,39,21,42,44,63,217,343,2,926,51,0,2,22,0,48520,19775,3805,26526,0
7,281,75,38,59,1,3,12,76,2,4,2,4,6,6,10,15,1,15,0,0,2,4,1,48520,19775,3805,26527,0
120,4833,1513,682,1277,25,13,200,1538,11,199,116,219,210,335,1557,2584,6,15641,868,0,2,17,0,48520,19777,3805,26528,0
14,341,207,111,150,11,0,50,218,5,26,19,36,31,55,133,272,3,943,52,0,2,26,1,48520,19777,3805,26529,0
79,4191,1457,730,1242,11,6,188,1468,10,292,166,329,302,495,2424,4078,5,22973,1276,1,2,11,1,48520,19779,3805,26530,0
76,3895,1943,715,1694,26,18,214,1969,12,185,120,237,197,357,1436,2721,7,20915,1161,0,2,10,0,48520,19781,3805,26531,0
57,1224,207,111,150,11,0,50,218,5,26,19,36,31,55,133,272,3,943,52,0,2,15,8,48520,19781,3805,26532,0
57,1224,410,198,237,31,55,97,441,11,63,38,72,74,110,414,683,6,4293,238,0,2,15,8,48530,19782,3806,26533,0
58,1234,207,111,150,11,0,50,218,5,26,19,36,31,55,133,272,3,943,52,0,2,9,1,48530,19782,3806,26534,0
58,1234,410,198,237,31,55,97,441,11,63,38,72,74,110,414,683,6,4293,238,0,2,9,1,48540,19783,3807,26535,0
228,5164,4293,999,3693,19,54,507,4312,9,155,88,170,164,258,1156,1898,4,9368,520,0,2,1,5,48540,19785,3807,26536,0
228,5164,1482,859,1002,125,135,219,1607,16,219,134,251,235,385,1766,3032,9,27804,1544,1,2,1,5,48550,19786,3807,26537,0
98,4450,1338,495,1086,10,64,173,1348,11,122,82,157,133,239,883,1686,7,11934,663,0,2,12,2,48550,19788,3807,26538,0
162,7089,139,89,101,2,0,35,141,7,54,34,62,61,96,330,569,4,2287,127,0,2,6,0,48550,19788,3807,26539,0
162,7089,7,5,5,0,0,2,7,1,2,1,2,3,3,2,4,0,2,0,0,2,6,0,48550,19788,3807,26540,0
214,4592,182,127,129,0,0,53,182,5,39,21,42,44,63,217,343,2,926,51,0,2,1,1,48550,19788,3808,26541,0
214,4592,1165,710,800,67,119,181,1232,18,243,153,282,261,435,2000,3492,10,36473,2026,1,2,1,1,48560,19788,3809,26542,0
133,2652,1513,682,1277,25,13,200,1538,11,199,116,219,210,335,1557,2584,6,15641,868,0,2,11,4,48560,19790,3809,26543,0
133,2652,819,519,539,24,98,155,843,15,96,57,106,111,163,690,1107,8,9171,509,0,2,11,4,48570,19792,3809,26544,0
57,1224,207,111,150,11,0,50,218,5,26,19,36,31,55,133,272,3,943,52,0,2,20,10,48570,19792,3809,26545,0
57,1224,410,198,237,31,55,97,441,11,63,38,72,74,110,414,683,6,4293,238,0,2,20,10,48580,19793,3810,26546,0
347,6933,1457,730,1242,11,6,188,1468,10,292,166,329,302,495,2424,4078,5,22973,1276,1,2,15,10,48580,19795,3810,26547,0
347,6933,74,35,59,1,0,14,75,3,14,7,14,17,21,58,85,1,128,7,0,2,15,10,48580,19796,3810,26548,0
347,6933,245,125,200,5,7,34,250,7,30,17,34,37,51,166,265,3,1053,58,0,2,15,10,48590,19797,3810,26549,0
229,5176,4293,999,3693,19,54,507,4312,9,155,88,170,164,258,1156,1898,4,9368,520,0,2,2,1,48590,19799,3810,26551,0
229,5176,1482,859,1002,125,135,219,1607,16,219,134,251,235,385,1766,3032,9,27804,1544,1,2,2,1,48600,19800,3810,26552,0
210,5022,722,423,573,19,0,135,741,12,172,101,199,184,300,1320,2257,6,15668,870,0,2,9,13,48600,19802,3810,26554,0
210,5022,1508,847,911,44,250,301,1552,14,148,88,169,162,257,1120,1886,7,15077,837,0,2,9,13,48600,19803,3811,26555,0
75,1461,757,253,292,73,244,162,830,13,61,38,67,74,105,409,651,7,4654,258,0,2,12,3,48600,19804,3811,26556,0
113,2488,1043,504,840,53,9,147,1096,9,180,112,198,189,310,1377,2344,4,11604,644,0,2,6,1,48600,19806,3811,26557,0
113,2488,383,288,292,26,6,62,409,11,65,38,67,76,105,429,656,5,3719,206,0,2,6,1,48600,19807,3811,26558,0
193,3982,1943,715,1694,26,18,214,1969,12,185,120,237,197,357,1436,2721,7,20915,1161,0,2,17,6,48600,19809,3811,26559,0
193,3982,1168,838,957,57,25,144,1225,19,348,224,416,367,640,3018,5452,11,61921,3440,1,2,17,6,48610,19811,3811,26560,0
81,3461,1289,550,1043,56,32,155,1345,10,167,93,185,177,278,1266,2075,5,11498,638,0,2,14,1,48610,19813,3812,26561,0
36,1085,182,127,129,0,0,53,182,5,39,21,42,44,63,217,343,2,926,51,0,2,22,0,48610,19813,3813,26562,0
7,281,75,38,59,1,3,12,76,2,4,2,4,6,6,10,15,1,15,0,0,2,4,1,48610,19813,3813,26563,0
120,4833,1513,682,1277,25,13,200,1538,11,199,116,219,210,335,1557,2584,6,15641,868,0,2,17,0,48610,19815,3813,26564,0
72,3743,1296,573,1062,40,33,157,1336,8,201,118,231,209,349,1561,2689,4,12365,686,0,2,0,1,48610,19815,3813,26565,0
14,341,207,111,150,11,0,50,218,5,26,19,36,31,55,133,272,3,943,52,0,2,26,1,48610,19815,3813,26566,0
79,4191,1457,730,1242,11,6,188,1468,10,292,166,329,302,495,2424,4078,5,22973,1276,1,2,11,1,48610,19817,3813,26567,0
76,3895,1943,715,1694,26,18,214,1969,12,185,120,237,197,357,1436,2721,7,20915,1161,0,2,10,0,48610,19819,3813,26568,0
347,6933,1457,730,1242,11,6,188,1468,10,292,166,329,302,495,2424,4078,5,22973,1276,1,2,0,11,48610,19821,3813,26569,0
347,6933,74,35,59,1,0,14,75,3,14,7,14,17,21,58,85,1,128,7,0,2,0,11,48610,19822,3813,26570,0
347,6933,245,125,200,5,7,34,250,7,30,17,34,37,51,166,265,3,1053,58,0,2,0,11,48620,19823,3813,26571,0
12,424,42,7,35,4,0,5,46,1,2,1,2,3,3,2,4,0,2,0,0,2,5,1,48620,19823,3813,26572,0
12,424,11,6,10,0,0,1,11,2,4,2,4,6,6,10,15,1,15,0,0,2,5,1,48620,19823,3813,26573,0
98,4449,1338,495,1086,10,64,173,1348,11,122,82,157,133,239,883,1686,7,11934,663,0,2,5,3,48620,19825,3813,26574,0
72,3743,1296,573,1062,40,33,157,1336,8,201,118,231,209,349,1561,2689,4,12365,686,0,2,5,3,48620,19825,3813,26575,0
33,1889,384,251,317,7,8,52,391,11,70,44,84,81,128,467,811,6,5355,297,0,2,0,17,48620,19825,3813,26576,0
75,2972,1043,504,840,53,9,147,1096,9,180,112,198,189,310,1377,2344,4,11604,644,0,2,7,5,48620,19827,3813,26577,0
48,1795,1098,241,925,5,10,155,1103,7,46,25,49,53,74,273,423,3,1580,87,0,2,4,2,48630,19829,3813,26578,0
46,954,386,256,301,16,9,68,402,4,59,35,69,63,104,355,621,2,1453,80,0,2,22,5,48630,19829,3813,26579,1
46,954,264,131,164,11,41,46,275,6,38,22,40,44,62,214,338,3,1068,59,0,2,22,5,48640,19829,3814,26580,1
39,1774,386,256,301,16,9,68,402,4,59,35,69,63,104,355,621,2,1453,80,0,2,10,8,48640,19829,3814,26581,1
46,954,386,256,301,16,9,68,402,4,59,35,69,63,104,355,621,2,1453,80,0,2,16,0,48640,19829,3814,26582,0
46,954,264,131,164,11,41,46,275,6,38,22,40,44,62,214,338,3,1068,59,0,2,16,0,48650,19829,3815,26583,0
46,954,386,256,301,16,9,68,402,4,59,35,69,63,104,355,621,2,1453,80,0,2,38,5,48650,19829,3815,26584,0
46,954,264,131,164,11,41,46,275,6,38,22,40,44,62,214,338,3,1068,59,0,2,38,5,48660,19829,3816,26585,0
39,1774,386,256,301,16,9,68,402,4,59,35,69,63,104,355,621,2,1453,80,0,2,24,0,48660,19829,3816,26586,0
11,235,19,8,11,5,0,4,24,2,5,3,6,7,9,13,25,1,30,1,0,2,3,2,48660,19829,3816,26587,0
11,235,102,59,69,5,3,24,107,6,22,15,28,28,43,113,206,3,789,43,0,2,3,2,48660,19829,3816,26588,0
11,235,106,40,36,3,49,17,109,8,17,13,23,25,36,93,167,5,904,50,0,2,3,2,48660,19829,3816,26589,0
23,607,102,59,69,5,3,24,107,6,22,15,28,28,43,113,206,3,789,43,0,2,1,1,48660,19829,3816,26590,0
60,1265,207,111,150,11,0,50,218,5,26,19,36,31,55,133,272,3,943,52,0,2,9,1,48660,19829,3816,26591,0
60,1265,410,198,237,31,55,97,441,11,63,38,72,74,110,414,683,6,4293,238,0,2,9,1,48670,19830,3817,26592,0
228,5164,4293,999,3693,19,54,507,4312,9,155,88,170,164,258,1156,1898,4,9368,520,0,2,1,5,48670,19832,3817,26593,0
228,5164,1482,859,1002,125,135,219,1607,16,219,134,251,235,385,1766,3032,9,27804,1544,1,2,1,5,48680,19833,3817,26594,0
98,4450,1338,495,1086,10,64,173,1348,11,122,82,157,133,239,883,1686,7,11934,663,0,2,12,2,48680,19835,3817,26595,0
162,7089,139,89,101,2,0,35,141,7,54,34,62,61,96,330,569,4,2287,127,0,2,6,0,48680,19835,3817,26596,0
162,7089,7,5,5,0,0,2,7,1,2,1,2,3,3,2,4,0,2,0,0,2,6,0,48680,19835,3817,26597,0
96,1828,1020,354,843,12,15,144,1032,8,134,77,144,142,221,970,1580,4,6792,377,0,2,1,1,48680,19835,3817,26598,1
73,3219,1020,354,843,12,15,144,1032,8,134,77,144,142,221,970,1580,4,6792,377,0,2,12,0,48680,19835,3817,26599,1
96,1828,1020,354,843,12,15,144,1032,8,134,77,144,142,221,970,1580,4,6792,377,0,2,1,1,48680,19835,3817,26600,0
73,3219,1020,354,843,12,15,144,1032,8,134,77,144,142,221,970,1580,4,6792,377,0,2,12,0,48680,19835,3817,26601,0
87,2923,773,419,590,28,0,166,801,10,204,113,217,214,330,1598,2554,5,13587,754,0,2,0,1,48680,19835,3818,26602,0
87,2923,773,419,590,28,0,166,801,10,204,113,217,214,330,1598,2554,5,13587,754,0,2,0,1,48680,19835,3819,26603,0
189,4316,77,34,69,0,0,8,77,3,24,16,29,27,45,114,213,1,387,21,0,2,10,0,48680,19835,3819,26604,0
189,4316,712,438,573,51,9,84,763,14,102,71,128,116,199,733,1364,8,11988,666,0,2,10,0,48690,19836,3819,26605,0
81,3472,1289,550,1043,56,32,155,1345,10,167,93,185,177,278,1266,2075,5,11498,638,0,2,3,1,48690,19838,3820,26606,0
11,235,19,8,11,5,0,4,24,2,5,3,6,7,9,13,25,1,30,1,0,2,3,2,48690,19838,3820,26607,0
11,235,102,59,69,5,3,24,107,6,22,15,28,28,43,113,206,3,789,43,0,2,3,2,48690,19838,3820,26608,0
11,235,106,40,36,3,49,17,109,8,17,13,23,25,36,93,167,5,904,50,0,2,3,2,48690,19838,3820,26609,0
23,607,102,59,69,5,3,24,107,6,22,15,28,28,43,113,206,3,789,43,0,2,1,1,48690,19838,3820,26610,0
11,235,19,8,11,5,0,4,24,2,5,3,6,7,9,13,25,1,30,1,0,2,3,2,48690,19838,3820,26611,0
11,235,102,59,69,5,3,24,107,6,22,15,28,28,43,113,206,3,789,43,0,2,3,2,48690,19838,3820,26612,0
11,235,106,40,36,3,49,17,109,8,17,13,23,25,36,93,167,5,904,50,0,2,3,2,48690,19838,3820,26613,0
94,1803,1020,354,843,12,15,144,1032,8,134,77,144,142,221,970,1580,4,6792,377,0,2,1,1,48690,19838,3820,26614,0
87,2923,773,419,590,28,0,166,801,10,204,113,217,214,330,1598,2554,5,13587,754,0,2,0,1,48690,19838,3821,26615,0
23,607,102,59,69,5,3,24,107,6,22,15,28,28,43,113,206,3,789,43,0,2,1,1,48690,19838,3821,26616,0
73,3219,1020,354,843,12,15,144,1032,8,134,77,144,142,221,970,1580,4,6792,377,0,2,12,0,48690,19838,3821,26617,0
98,4450,1338,495,1086,10,64,173,1348,11,122,82,157,133,239,883,1686,7,11934,663,0,2,1,1,48690,19840,3821,26618,1
256,6158,72,33,56,0,4,12,72,1,1,1,1,2,2,0,2,0,1,0,0,2,18,20,48690,19840,3821,26619,0
256,6158,1454,835,1044,76,110,219,1530,17,275,158,296,292,454,2297,3718,9,34017,1889,1,2,18,20,48700,19841,3821,26620,0
6,329,180,34,164,0,0,16,180,1,12,6,12,13,18,43,66,0,33,1,0,2,21,0,48700,19841,3821,26621,0
345,6924,1457,730,1242,11,6,188,1468,10,292,166,329,302,495,2424,4078,5,22973,1276,1,2,6,6,48700,19843,3821,26622,0
345,6924,74,35,59,1,0,14,75,3,14,7,14,17,21,58,85,1,128,7,0,2,6,6,48700,19844,3821,26623,0
345,6924,245,125,200,5,7,34,250,7,30,17,34,37,51,166,265,3,1053,58,0,2,6,6,48710,19845,3821,26624,0
33,1914,384,251,317,7,8,52,391,11,70,44,84,81,128,467,811,6,5355,297,0,2,8,3,48710,19845,3821,26625,1
256,6158,72,33,56,0,4,12,72,1,1,1,1,2,2,0,2,0,1,0,0,2,18,20,48710,19845,3821,26626,0
256,6158,1454,835,1044,76,110,219,1530,17,275,158,296,292,454,2297,3718,9,34017,1889,1,2,18,20,48720,19846,3821,26627,0
6,329,180,34,164,0,0,16,180,1,12,6,12,13,18,43,66,0,33,1,0,2,21,0,48720,19846,3821,26628,0
11,235,19,8,11,5,0,4,24,2,5,3,6,7,9,13,25,1,30,1,0,2,3,2,48720,19846,3821,26629,0
11,235,102,59,69,5,3,24,107,6,22,15,28,28,43,113,206,3,789,43,0,2,3,2,48720,19846,3821,26630,0
11,235,106,40,36,3,49,17,109,8,17,13,23,25,36,93,167,5,904,50,0,2,3,2,48720,19846,3821,26631,0
94,1803,1020,354,843,12,15,144,1032,8,134,77,144,142,221,970,1580,4,6792,377,0,2,1,1,48720,19846,3821,26632,0
87,2923,773,419,590,28,0,166,801,10,204,113,217,214,330,1598,2554,5,13587,754,0,2,0,1,48720,19846,3822,26633,0
98,4450,1338,495,1086,10,64,173,1348,11,122,82,157,133,239,883,1686,7,11934,663,0,2,1,1,48720,19848,3822,26634,0
23,607,102,59,69,5,3,24,107,6,22,15,28,28,43,113,206,3,789,43,0,2,1,1,48720,19848,3822,26635,0
73,3219,1020,354,843,12,15,144,1032,8,134,77,144,142,221,970,1580,4,6792,377,0,2,12,0,48720,19848,3822,26636,0
347,6933,1457,730,1242,11,6,188,1468,10,292,166,329,302,495,2424,4078,5,22973,1276,1,2,1,1,48720,19850,3822,26637,1
347,6933,74,35,59,1,0,14,75,3,14,7,14,17,21,58,85,1,128,7,0,2,1,1,48720,19851,3822,26638,1
347,6933,245,125,200,5,7,34,250,7,30,17,34,37,51,166,265,3,1053,58,0,2,1,1,48730,19852,3822,26639,1
67,1798,773,422,505,30,103,129,803,14,77,46,83,91,129,535,839,7,6334,351,0,0,459,0,48740,19853,3823,26640,1
67,1800,773,422,505,30,103,129,803,14,77,46,83,91,129,535,839,7,6334,351,0,2,1,1,48750,19854,3824,26641,0
1,142,127,75,83,2,11,30,129,4,14,7,14,18,21,61,87,2,175,9,0,0,33,0,48750,19854,3824,26642,0
1,142,652,304,544,16,6,88,668,6,89,51,101,95,152,591,998,3,3399,188,0,0,33,0,48750,19855,3824,26643,0
1,142,2,2,2,0,0,0,2,0,0,0,0,0,0,0,0,0,0,0,0,0,33,0,48750,19855,3824,26643,0
1,142,8,5,5,0,0,3,8,0,0,0,0,0,0,0,0,0,0,0,0,0,33,0,48750,19855,3824,26644,0
1,142,2,2,2,0,0,0,2,0,0,0,0,0,0,0,0,0,0,0,0,0,33,0,48750,19855,3824,26644,0
1,142,14,8,8,0,0,6,14,0,0,0,0,0,0,0,0,0,0,0,0,0,33,0,48750,19855,3824,26645,0
1,142,6,4,4,0,0,2,6,0,0,0,0,0,0,0,0,0,0,0,0,0,33,0,48750,19855,3824,26646,0
1,142,6,4,4,0,0,2,6,1,2,1,2,3,3,2,4,0,2,0,0,0,33,0,48750,19855,3824,26647,0
1,142,6,4,4,0,0,2,6,0,0,0,0,0,0,0,0,0,0,0,0,0,33,0,48750,19855,3824,26648,0
1,142,7,5,5,0,0,2,7,0,0,0,0,0,0,0,0,0,0,0,0,0,33,0,48750,19855,3824,26649,0
1,142,6,4,4,0,0,2,6,0,0,0,0,0,0,0,0,0,0,0,0,0,33,0,48750,19855,3824,26650,0
1,142,10,6,6,0,0,4,10,0,0,0,0,0,0,0,0,0,0,0,0,0,33,0,48750,19855,3824,26651,0
1,142,1,1,1,0,0,0,1,0,0,0,0,0,0,0,0,0,0,0,0,0,33,0,48750,19855,3824,26651,0
1,142,14,10,10,0,0,4,14,1,1,1,1,2,2,0,2,0,1,0,0,0,33,0,48750,19855,3824,26652,0
1,142,46,26,30,3,0,12,49,3,6,3,6,9,9,20,28,1,42,2,0,0,33,0,48760,19855,3824,26653,0
3,143,207,111,150,11,0,50,218,5,26,19,36,31,55,133,272,3,943,52,0,0,80,0,48760,19855,3824,26654,0
9,464,139,89,101,2,0,35,141,7,54,34,62,61,96,330,569,4,2287,127,0,0,99,0,48760,19855,3824,26655,0
21,1023,1157,318,931,29,22,177,1186,6,104,63,125,110,188,712,1274,3,4596,255,0,0,398,0,48760,19855,3824,26656,0
12,424,42,7,35,4,0,5,46,1,2,1,2,3,3,2,4,0,2,0,0,2,1,1,48770,19856,3824,26669,0
12,424,11,6,10,0,0,1,11,2,4,2,4,6,6,10,15,1,15,0,0,2,1,1,48770,19856,3824,26670,0
120,4833,1513,682,1277,25,13,200,1538,11,199,116,219,210,335,1557,2584,6,15641,868,0,2,0,2,48770,19858,3824,26671,0
67,1769,773,422,505,30,103,129,803,14,77,46,83,91,129,535,839,7,6334,351,0,2,21,40,48780,19859,3825,26672,0
67,1769,773,422,505,30,103,129,803,14,77,46,83,91,129,535,839,7,6334,351,0,2,2,2,48790,19860,3826,26673,0
120,4833,1513,682,1277,25,13,200,1538,11,199,116,219,210,335,1557,2584,6,15641,868,0,2,0,1,48790,19862,3826,26674,0
64,1733,773,422,505,30,103,129,803,14,77,46,83,91,129,535,839,7,6334,351,0,2,4,9,48800,19863,3827,26675,0
63,1708,773,422,505,30,103,129,803,14,77,46,83,91,129,535,839,7,6334,351,0,2,16,23,48810,19864,3828,26676,0
63,1707,773,422,505,30,103,129,803,14,77,46,83,91,129,535,839,7,6334,351,0,2,0,3,48820,19865,3829,26677,0
62,1696,773,422,505,30,103,129,803,14,77,46,83,91,129,535,839,7,6334,351,0,2,20,18,48830,19866,3830,26678,1
62,1696,773,422,505,30,103,129,803,14,77,46,83,91,129,535,839,7,6334,351,0,2,4,4,48840,19867,3831,26679,0
62,1692,773,422,505,30,103,129,803,14,77,46,83,91,129,535,839,7,6334,351,0,2,4,4,48850,19868,3832,26680,0
62,1704,773,422,505,30,103,129,803,14,77,46,83,91,129,535,839,7,6334,351,0,2,4,4,48860,19869,3833,26681,0
62,1710,773,422,505,30,103,129,803,14,77,46,83,91,129,535,839,7,6334,351,0,2,7,4,48870,19870,3834,26682,0
62,1694,773,422,505,30,103,129,803,14,77,46,83,91,129,535,839,7,6334,351,0,2,1,3,48880,19871,3835,26683,0
62,1696,773,422,505,30,103,129,803,14,77,46,83,91,129,535,839,7,6334,351,0,2,7,8,48890,19872,3836,26684,1
60,1687,773,422,505,30,103,129,803,14,77,46,83,91,129,535,839,7,6334,351,0,2,16,16,48900,19873,3837,26685,0
60,1685,773,422,505,30,103,129,803,14,77,46,83,91,129,535,839,7,6334,351,0,2,1,1,48910,19874,3838,26686,0
48,1364,773,422,505,30,103,129,803,14,77,46,83,91,129,535,839,7,6334,351,0,2,6,75,48920,19875,3839,26687,0
7,392,139,89,101,2,0,35,141,7,54,34,62,61,96,330,569,4,2287,127,0,2,0,26,48920,19875,3839,26688,0
135,2719,1513,682,1277,25,13,200,1538,11,199,116,219,210,335,1557,2584,6,15641,868,0,2,60,19,48920,19877,3839,26689,1
135,2719,819,519,539,24,98,155,843,15,96,57,106,111,163,690,1107,8,9171,509,0,2,60,19,48930,19879,3839,26690,1
121,4909,1513,682,1277,25,13,200,1538,11,199,116,219,210,335,1557,2584,6,15641,868,0,2,34,0,48930,19881,3839,26691,1
135,2721,1513,682,1277,25,13,200,1538,11,199,116,219,210,335,1557,2584,6,15641,868,0,2,31,30,48930,19883,3839,26692,1
135,2721,819,519,539,24,98,155,843,15,96,57,106,111,163,690,1107,8,9171,509,0,2,31,30,48940,19885,3839,26693,1
21,662,339,213,244,17,9,65,356,10,42,26,48,52,74,259,421,5,2410,133,0,2,2,2,48950,19885,3839,26694,1
20,408,294,64,250,0,0,43,294,1,20,10,20,21,30,86,131,0,65,3,0,2,2,2,48950,19885,3839,26695,1
20,408,78,46,62,3,0,14,81,3,8,4,8,11,12,28,41,1,62,3,0,2,2,2,48950,19886,3839,26696,1
121,4909,1513,682,1277,25,13,200,1538,11,199,116,219,210,335,1557,2584,6,15641,868,0,2,10,10,48950,19888,3839,26697,1
347,6933,1457,730,1242,11,6,188,1468,10,292,166,329,302,495,2424,4078,5,22973,1276,1,2,1,1,48950,19890,3839,26698,0
347,6933,74,35,59,1,0,14,75,3,14,7,14,17,21,58,85,1,128,7,0,2,1,1,48950,19891,3839,26699,0
347,6933,245,125,200,5,7,34,250,7,30,17,34,37,51,166,265,3,1053,58,0,2,1,1,48960,19892,3839,26700,0
21,662,339,213,244,17,9,65,356,10,42,26,48,52,74,259,421,5,2410,133,0,2,1,1,48970,19892,3839,26701,0
27,954,74,35,59,1,0,14,75,3,14,7,14,17,21,58,85,1,128,7,0,2,1,1,48970,19893,3839,26702,0
27,954,245,125,200,5,7,34,250,7,30,17,34,37,51,166,265,3,1053,58,0,2,1,1,48980,19894,3839,26703,0
17,518,184,100,137,2,15,30,186,6,38,20,39,44,59,214,322,3,991,55,0,2,3,3,48980,19895,3839,26704,0
17,518,103,65,74,8,5,16,111,7,17,9,17,24,26,89,119,3,417,23,0,2,3,3,48980,19896,3839,26705,0
106,1993,1178,367,1042,6,15,115,1184,9,94,51,95,103,146,644,976,4,4439,246,0,2,2,2,48980,19896,3839,26706,0
106,1993,177,108,140,8,0,27,185,6,30,16,32,36,48,162,248,3,794,44,0,2,2,2,48980,19898,3839,26707,0
195,4023,1943,715,1694,26,18,214,1969,12,185,120,237,197,357,1436,2721,7,20915,1161,0,2,62,48,48980,19900,3839,26708,0
195,4023,1168,838,957,57,25,144,1225,19,348,224,416,367,640,3018,5452,11,61921,3440,1,2,62,48,48990,19902,3839,26709,0
347,6933,1457,730,1242,11,6,188,1468,10,292,166,329,302,495,2424,4078,5,22973,1276,1,2,1,1,48990,19904,3839,26710,0
347,6933,74,35,59,1,0,14,75,3,14,7,14,17,21,58,85,1,128,7,0,2,1,1,48990,19905,3839,26711,0
347,6933,245,125,200,5,7,34,250,7,30,17,34,37,51,166,265,3,1053,58,0,2,1,1,49000,19906,3839,26712,0
21,662,339,213,244,17,9,65,356,10,42,26,48,52,74,259,421,5,2410,133,0,2,1,1,49010,19906,3839,26713,0
27,954,74,35,59,1,0,14,75,3,14,7,14,17,21,58,85,1,128,7,0,2,1,1,49010,19907,3839,26714,0
27,954,245,125,200,5,7,34,250,7,30,17,34,37,51,166,265,3,1053,58,0,2,1,1,49020,19908,3839,26715,0
17,518,184,100,137,2,15,30,186,6,38,20,39,44,59,214,322,3,991,55,0,2,3,3,49020,19909,3839,26716,0
17,518,103,65,74,8,5,16,111,7,17,9,17,24,26,89,119,3,417,23,0,2,3,3,49020,19910,3839,26717,0
106,1993,1178,367,1042,6,15,115,1184,9,94,51,95,103,146,644,976,4,4439,246,0,2,2,2,49020,19910,3839,26718,0
106,1993,177,108,140,8,0,27,185,6,30,16,32,36,48,162,248,3,794,44,0,2,2,2,49020,19912,3839,26719,0
195,4023,1943,715,1694,26,18,214,1969,12,185,120,237,197,357,1436,2721,7,20915,1161,0,2,62,48,49020,19914,3839,26720,0
195,4023,1168,838,957,57,25,144,1225,19,348,224,416,367,640,3018,5452,11,61921,3440,1,2,62,48,49030,19916,3839,26721,0
188,4296,77,34,69,0,0,8,77,3,24,16,29,27,45,114,213,1,387,21,0,2,2,5,49030,19916,3839,26722,0
188,4296,712,438,573,51,9,84,763,14,102,71,128,116,199,733,1364,8,11988,666,0,2,2,5,49040,19917,3839,26723,0
135,2731,1513,682,1277,25,13,200,1538,11,199,116,219,210,335,1557,2584,6,15641,868,0,2,3,1,49040,19919,3839,26724,1
135,2731,819,519,539,24,98,155,843,15,96,57,106,111,163,690,1107,8,9171,509,0,2,3,1,49050,19921,3839,26725,1
123,4965,1513,682,1277,25,13,200,1538,11,199,116,219,210,335,1557,2584,6,15641,868,0,2,12,2,49050,19923,3839,26726,1
96,1829,1020,354,843,12,15,144,1032,8,134,77,144,142,221,970,1580,4,6792,377,0,2,2,1,49050,19923,3839,26727,0
96,1829,1020,354,843,12,15,144,1032,8,134,77,144,142,221,970,1580,4,6792,377,0,2,2,1,49050,19923,3839,26728,0
20,509,205,80,86,16,53,53,221,7,18,10,19,25,29,94,134,3,497,27,0,2,9,2,49060,19923,3840,26729,0
74,3107,1178,367,1042,6,15,115,1184,9,94,51,95,103,146,644,976,4,4439,246,0,2,34,0,49060,19923,3840,26730,0
20,509,205,80,86,16,53,53,221,7,18,10,19,25,29,94,134,3,497,27,0,2,2,2,49070,19923,3841,26731,0
21,438,601,196,481,2,23,85,603,8,63,36,72,71,108,400,664,4,3036,168,0,2,2,2,49070,19923,3841,26732,0
21,438,156,79,106,5,16,28,161,5,14,8,15,19,23,64,97,2,261,14,0,2,2,2,49070,19923,3841,26733,0
16,610,601,196,481,2,23,85,603,8,63,36,72,71,108,400,664,4,3036,168,0,2,21,1,49070,19923,3841,26734,0
60,1265,207,111,150,11,0,50,218,5,26,19,36,31,55,133,272,3,943,52,0,2,2,2,49070,19923,3841,26735,1
60,1265,410,198,237,31,55,97,441,11,63,38,72,74,110,414,683,6,4293,238,0,2,2,2,49080,19924,3842,26736,1
255,6150,72,33,56,0,4,12,72,1,1,1,1,2,2,0,2,0,1,0,0,2,5,5,49080,19924,3842,26737,1
255,6150,1454,835,1044,76,110,219,1530,17,275,158,296,292,454,2297,3718,9,34017,1889,1,2,5,5,49090,19925,3842,26738,1
21,436,601,196,481,2,23,85,603,8,63,36,72,71,108,400,664,4,3036,168,0,2,1,1,49090,19925,3842,26739,1
21,436,156,79,106,5,16,28,161,5,14,8,15,19,23,64,97,2,261,14,0,2,1,1,49090,19925,3842,26740,1
16,610,601,196,481,2,23,85,603,8,63,36,72,71,108,400,664,4,3036,168,0,2,1,1,49090,19925,3842,26741,1
60,1265,207,111,150,11,0,50,218,5,26,19,36,31,55,133,272,3,943,52,0,2,2,2,49090,19925,3842,26742,0
60,1265,410,198,237,31,55,97,441,11,63,38,72,74,110,414,683,6,4293,238,0,2,2,2,49100,19926,3843,26743,0
255,6150,72,33,56,0,4,12,72,1,1,1,1,2,2,0,2,0,1,0,0,2,5,5,49100,19926,3843,26744,0
255,6150,1454,835,1044,76,110,219,1530,17,275,158,296,292,454,2297,3718,9,34017,1889,1,2,5,5,49110,19927,3843,26745,0
21,436,601,196,481,2,23,85,603,8,63,36,72,71,108,400,664,4,3036,168,0,2,2,2,49110,19927,3843,26746,0
21,436,156,79,106,5,16,28,161,5,14,8,15,19,23,64,97,2,261,14,0,2,2,2,49110,19927,3843,26747,0
16,610,601,196,481,2,23,85,603,8,63,36,72,71,108,400,664,4,3036,168,0,2,21,1,49110,19927,3843,26748,0
94,1804,1020,354,843,12,15,144,1032,8,134,77,144,142,221,970,1580,4,6792,377,0,2,2,1,49110,19927,3843,26749,0
256,6155,72,33,56,0,4,12,72,1,1,1,1,2,2,0,2,0,1,0,0,2,18,20,49110,19927,3843,26750,0
256,6155,1454,835,1044,76,110,219,1530,17,275,158,296,292,454,2297,3718,9,34017,1889,1,2,18,20,49120,19928,3843,26751,0
6,329,180,34,164,0,0,16,180,1,12,6,12,13,18,43,66,0,33,1,0,2,21,0,49120,19928,3843,26752,0
106,2001,1178,367,1042,6,15,115,1184,9,94,51,95,103,146,644,976,4,4439,246,0,2,2,1,49120,19928,3843,26753,0
106,2001,177,108,140,8,0,27,185,6,30,16,32,36,48,162,248,3,794,44,0,2,2,1,49120,19930,3843,26754,0
74,3124,1178,367,1042,6,15,115,1184,9,94,51,95,103,146,644,976,4,4439,246,0,2,8,3,49120,19930,3843,26755,0
62,1228,1098,241,925,5,10,155,1103,7,46,25,49,53,74,273,423,3,1580,87,0,2,1,2,49130,19932,3843,26756,0
62,1228,282,202,222,14,2,44,296,8,42,24,43,50,67,250,378,4,1548,86,0,2,1,2,49130,19933,3843,26757,0
62,1222,1098,241,925,5,10,155,1103,7,46,25,49,53,74,273,423,3,1580,87,0,2,0,1,49140,19935,3843,26758,0
62,1222,282,202,222,14,2,44,296,8,42,24,43,50,67,250,378,4,1548,86,0,2,0,1,49140,19936,3843,26759,0
106,1987,1178,367,1042,6,15,115,1184,9,94,51,95,103,146,644,976,4,4439,246,0,2,4,5,49140,19936,3843,26760,1
106,1987,177,108,140,8,0,27,185,6,30,16,32,36,48,162,248,3,794,44,0,2,4,5,49140,19938,3843,26761,1
62,1222,1098,241,925,5,10,155,1103,7,46,25,49,53,74,273,423,3,1580,87,0,2,1,1,49150,19940,3843,26762,1
62,1222,282,202,222,14,2,44,296,8,42,24,43,50,67,250,378,4,1548,86,0,2,1,1,49150,19941,3843,26763,1
110,2074,1178,367,1042,6,15,115,1184,9,94,51,95,103,146,644,976,4,4439,246,0,2,59,39,49150,19941,3843,26764,1
110,2074,177,108,140,8,0,27,185,6,30,16,32,36,48,162,248,3,794,44,0,2,59,39,49150,19943,3843,26765,1
110,2074,1178,367,1042,6,15,115,1184,9,94,51,95,103,146,644,976,4,4439,246,0,2,1,1,49150,19943,3843,26766,0
110,2074,177,108,140,8,0,27,185,6,30,16,32,36,48,162,248,3,794,44,0,2,1,1,49150,19945,3843,26767,0
108,2058,1178,367,1042,6,15,115,1184,9,94,51,95,103,146,644,976,4,4439,246,0,2,3,9,49150,19945,3843,26768,0
108,2058,177,108,140,8,0,27,185,6,30,16,32,36,48,162,248,3,794,44,0,2,3,9,49150,19947,3843,26769,0
229,5184,4293,999,3693,19,54,507,4312,9,155,88,170,164,258,1156,1898,4,9368,520,0,2,6,2,49150,19949,3843,26770,0
229,5184,1482,859,1002,125,135,219,1607,16,219,134,251,235,385,1766,3032,9,27804,1544,1,2,6,2,49160,19950,3843,26771,0
229,5193,4293,999,3693,19,54,507,4312,9,155,88,170,164,258,1156,1898,4,9368,520,0,2,2,1,49160,19952,3843,26772,0
229,5193,1482,859,1002,125,135,219,1607,16,219,134,251,235,385,1766,3032,9,27804,1544,1,2,2,1,49170,19953,3843,26773,0
74,3250,1020,354,843,12,15,144,1032,8,134,77,144,142,221,970,1580,4,6792,377,0,2,18,0,49170,19953,3843,26774,0
229,5193,4293,999,3693,19,54,507,4312,9,155,88,170,164,258,1156,1898,4,9368,520,0,2,7,2,49170,19955,3843,26775,0
229,5193,1482,859,1002,125,135,219,1607,16,219,134,251,235,385,1766,3032,9,27804,1544,1,2,7,2,49180,19956,3843,26776,0
74,3250,1020,354,843,12,15,144,1032,8,134,77,144,142,221,970,1580,4,6792,377,0,2,18,0,49180,19956,3843,26777,0
135,2731,1513,682,1277,25,13,200,1538,11,199,116,219,210,335,1557,2584,6,15641,868,0,2,91,47,49180,19958,3843,26778,0
135,2731,819,519,539,24,98,155,843,15,96,57,106,111,163,690,1107,8,9171,509,0,2,91,47,49190,19960,3843,26779,0
21,662,339,213,244,17,9,65,356,10,42,26,48,52,74,259,421,5,2410,133,0,2,2,2,49200,19960,3843,26780,0
20,408,294,64,250,0,0,43,294,1,20,10,20,21,30,86,131,0,65,3,0,2,2,2,49200,19960,3843,26781,0
20,408,78,46,62,3,0,14,81,3,8,4,8,11,12,28,41,1,62,3,0,2,2,2,49200,19961,3843,26782,0
123,4965,1513,682,1277,25,13,200,1538,11,199,116,219,210,335,1557,2584,6,15641,868,0,2,56,12,49200,19963,3843,26783,0
11,394,42,7,35,4,0,5,46,1,2,1,2,3,3,2,4,0,2,0,0,2,9,8,49200,19963,3843,26784,1
11,394,11,6,10,0,0,1,11,2,4,2,4,6,6,10,15,1,15,0,0,2,9,8,49200,19963,3843,26785,1
108,2058,1178,367,1042,6,15,115,1184,9,94,51,95,103,146,644,976,4,4439,246,0,2,57,44,49200,19963,3843,26786,0
108,2058,177,108,140,8,0,27,185,6,30,16,32,36,48,162,248,3,794,44,0,2,57,44,49200,19965,3843,26787,0
62,1222,1098,241,925,5,10,155,1103,7,46,25,49,53,74,273,423,3,1580,87,0,2,1,3,49210,19967,3843,26788,0
62,1222,282,202,222,14,2,44,296,8,42,24,43,50,67,250,378,4,1548,86,0,2,1,3,49210,19968,3843,26789,0
58,1219,207,111,150,11,0,50,218,5,26,19,36,31,55,133,272,3,943,52,0,2,1,15,49210,19968,3843,26790,0
58,1219,410,198,237,31,55,97,441,11,63,38,72,74,110,414,683,6,4293,238,0,2,1,15,49220,19969,3844,26791,0
58,1219,207,111,150,11,0,50,218,5,26,19,36,31,55,133,272,3,943,52,0,2,1,15,49220,19969,3844,26792,0
58,1219,410,198,237,31,55,97,441,11,63,38,72,74,110,414,683,6,4293,238,0,2,1,15,49230,19970,3845,26793,0
11,394,42,7,35,4,0,5,46,1,2,1,2,3,3,2,4,0,2,0,0,2,9,8,49230,19970,3845,26794,0
11,394,11,6,10,0,0,1,11,2,4,2,4,6,6,10,15,1,15,0,0,2,9,8,49230,19970,3845,26795,0
11,235,19,8,11,5,0,4,24,2,5,3,6,7,9,13,25,1,30,1,0,2,0,3,49230,19970,3845,26796,1
11,235,102,59,69,5,3,24,107,6,22,15,28,28,43,113,206,3,789,43,0,2,0,3,49230,19970,3845,26797,1
11,235,106,40,36,3,49,17,109,8,17,13,23,25,36,93,167,5,904,50,0,2,0,3,49230,19970,3845,26798,1
101,2069,773,419,590,28,0,166,801,10,204,113,217,214,330,1598,2554,5,13587,754,0,2,0,2,49230,19970,3846,26799,1
101,2069,421,273,302,44,34,57,465,17,81,59,107,98,166,583,1098,11,12329,684,0,2,0,2,49230,19970,3847,26800,1
26,524,2,2,2,0,0,0,2,0,0,0,0,0,0,0,0,0,0,0,0,2,2,4,49230,19970,3847,26800,1
26,524,99,48,90,1,3,5,100,0,0,0,0,0,0,0,0,0,0,0,0,2,2,4,49230,19971,3847,26801,1
26,524,8,5,5,2,0,1,10,0,0,0,0,0,0,0,0,0,0,0,0,2,2,4,49230,19971,3847,26802,1
26,524,1217,716,841,84,126,174,1301,14,185,118,215,199,333,1446,2542,8,20687,1149,0,2,2,4,49240,19973,3847,26803,1
26,524,160,89,115,0,13,31,160,7,15,11,17,22,28,78,124,3,495,27,0,2,2,4,49240,19973,3847,26804,1
26,524,10,10,9,9,0,0,19,0,0,0,0,0,0,0,0,0,0,0,0,2,2,4,49240,19973,3848,26805,1
26,524,173,84,99,8,29,36,181,5,12,7,13,17,20,54,81,2,221,12,0,2,2,4,49240,19974,3848,26806,1
26,524,3,1,1,3,0,0,6,0,0,0,0,0,0,0,0,0,0,0,0,2,2,4,49240,19974,3848,26807,1
163,5028,1660,832,1314,41,38,274,1701,20,312,209,395,332,604,2671,5058,12,64042,3557,1,2,0,5,49240,19976,3849,26809,1
163,5028,1057,646,719,113,100,145,1170,18,215,134,248,233,382,1740,3004,10,31186,1732,1,2,0,5,49250,19977,3850,26810,1
228,5143,4293,999,3693,19,54,507,4312,9,155,88,170,164,258,1156,1898,4,9368,520,0,2,1,4,49250,19979,3850,26811,1
228,5143,1482,859,1002,125,135,219,1607,16,219,134,251,235,385,1766,3032,9,27804,1544,1,2,1,4,49260,19980,3850,26812,1
210,5003,722,423,573,19,0,135,741,12,172,101,199,184,300,1320,2257,6,15668,870,0,2,2,6,49260,19982,3850,26814,1
210,5003,1508,847,911,44,250,301,1552,14,148,88,169,162,257,1120,1886,7,15077,837,0,2,2,6,49260,19983,3851,26815,1
73,1421,757,253,292,73,244,162,830,13,61,38,67,74,105,409,651,7,4654,258,0,2,1,9,49260,19984,3851,26816,1
7,299,72,33,56,0,4,12,72,1,1,1,1,2,2,0,2,0,1,0,0,2,1,1,49260,19984,3851,26817,1
11,394,42,7,35,4,0,5,46,1,2,1,2,3,3,2,4,0,2,0,0,2,1,1,49260,19984,3851,26818,1
11,394,11,6,10,0,0,1,11,2,4,2,4,6,6,10,15,1,15,0,0,2,1,1,49260,19984,3851,26819,1
81,3461,1289,550,1043,56,32,155,1345,10,167,93,185,177,278,1266,2075,5,11498,638,0,2,1,1,49260,19986,3852,26820,1
147,6935,1392,870,1177,35,17,170,1427,14,494,280,531,508,811,4473,7289,7,54850,3047,2,2,2,8,49260,19989,3853,26821,1
87,2905,773,419,590,28,0,166,801,10,204,113,217,214,330,1598,2554,5,13587,754,0,2,0,2,49260,19989,3854,26822,1
52,3380,520,294,400,33,13,81,553,10,261,204,367,271,571,2128,4614,7,32445,1802,1,2,0,6,49260,19990,3854,26823,1
97,4424,1338,495,1086,10,64,173,1348,11,122,82,157,133,239,883,1686,7,11934,663,0,2,4,11,49260,19992,3854,26824,1
150,4203,1660,832,1314,41,38,274,1701,20,312,209,395,332,604,2671,5058,12,64042,3557,1,2,1,1,49260,19994,3855,26826,1
79,4191,1457,730,1242,11,6,188,1468,10,292,166,329,302,495,2424,4078,5,22973,1276,1,2,1,1,49260,19996,3855,26827,1
38,2303,334,251,279,10,4,40,344,5,127,74,143,132,217,899,1528,2,4303,239,0,2,1,7,49260,19997,3855,26828,1
48,1750,1098,241,925,5,10,155,1103,7,46,25,49,53,74,273,423,3,1580,87,0,2,0,5,49270,19999,3855,26829,1
147,6933,1392,870,1177,35,17,170,1427,14,494,280,531,508,811,4473,7289,7,54850,3047,2,2,0,1,49270,20002,3856,26830,0
11,235,19,8,11,5,0,4,24,2,5,3,6,7,9,13,25,1,30,1,0,2,0,3,49270,20002,3856,26831,0
11,235,102,59,69,5,3,24,107,6,22,15,28,28,43,113,206,3,789,43,0,2,0,3,49270,20002,3856,26832,0
11,235,106,40,36,3,49,17,109,8,17,13,23,25,36,93,167,5,904,50,0,2,0,3,49270,20002,3856,26833,0
101,2069,773,419,590,28,0,166,801,10,204,113,217,214,330,1598,2554,5,13587,754,0,2,0,2,49270,20002,3857,26834,0
101,2069,421,273,302,44,34,57,465,17,81,59,107,98,166,583,1098,11,12329,684,0,2,0,2,49270,20002,3858,26835,0
26,524,2,2,2,0,0,0,2,0,0,0,0,0,0,0,0,0,0,0,0,2,2,4,49270,20002,3858,26835,0
26,524,99,48,90,1,3,5,100,0,0,0,0,0,0,0,0,0,0,0,0,2,2,4,49270,20003,3858,26836,0
26,524,8,5,5,2,0,1,10,0,0,0,0,0,0,0,0,0,0,0,0,2,2,4,49270,20003,3858,26837,0
26,524,1217,716,841,84,126,174,1301,14,185,118,215,199,333,1446,2542,8,20687,1149,0,2,2,4,49280,20005,3858,26838,0
26,524,160,89,115,0,13,31,160,7,15,11,17,22,28,78,124,3,495,27,0,2,2,4,49280,20005,3858,26839,0
26,524,10,10,9,9,0,0,19,0,0,0,0,0,0,0,0,0,0,0,0,2,2,4,49280,20005,3859,26840,0
26,524,173,84,99,8,29,36,181,5,12,7,13,17,20,54,81,2,221,12,0,2,2,4,49280,20006,3859,26841,0
26,524,3,1,1,3,0,0,6,0,0,0,0,0,0,0,0,0,0,0,0,2,2,4,49280,20006,3859,26842,0
163,5028,1660,832,1314,41,38,274,1701,20,312,209,395,332,604,2671,5058,12,64042,3557,1,2,0,5,49280,20008,3860,26844,0
163,5028,1057,646,719,113,100,145,1170,18,215,134,248,233,382,1740,3004,10,31186,1732,1,2,0,5,49290,20009,3861,26845,0
228,5143,4293,999,3693,19,54,507,4312,9,155,88,170,164,258,1156,1898,4,9368,520,0,2,1,4,49290,20011,3861,26846,0
228,5143,1482,859,1002,125,135,219,1607,16,219,134,251,235,385,1766,3032,9,27804,1544,1,2,1,4,49300,20012,3861,26847,0
210,5003,722,423,573,19,0,135,741,12,172,101,199,184,300,1320,2257,6,15668,870,0,2,2,6,49300,20014,3861,26849,0
210,5003,1508,847,911,44,250,301,1552,14,148,88,169,162,257,1120,1886,7,15077,837,0,2,2,6,49300,20015,3862,26850,0
73,1421,757,253,292,73,244,162,830,13,61,38,67,74,105,409,651,7,4654,258,0,2,1,9,49300,20016,3862,26851,0
7,299,72,33,56,0,4,12,72,1,1,1,1,2,2,0,2,0,1,0,0,2,1,1,49300,20016,3862,26852,0
11,394,42,7,35,4,0,5,46,1,2,1,2,3,3,2,4,0,2,0,0,2,1,1,49300,20016,3862,26853,0
11,394,11,6,10,0,0,1,11,2,4,2,4,6,6,10,15,1,15,0,0,2,1,1,49300,20016,3862,26854,0
81,3461,1289,550,1043,56,32,155,1345,10,167,93,185,177,278,1266,2075,5,11498,638,0,2,1,1,49300,20018,3863,26855,0
147,6933,1392,870,1177,35,17,170,1427,14,494,280,531,508,811,4473,7289,7,54850,3047,2,2,2,9,49300,20021,3864,26856,0
87,2905,773,419,590,28,0,166,801,10,204,113,217,214,330,1598,2554,5,13587,754,0,2,0,2,49300,20021,3865,26857,0
52,3380,520,294,400,33,13,81,553,10,261,204,367,271,571,2128,4614,7,32445,1802,1,2,0,6,49300,20022,3865,26858,0
97,4424,1338,495,1086,10,64,173,1348,11,122,82,157,133,239,883,1686,7,11934,663,0,2,4,11,49300,20024,3865,26859,0
150,4203,1660,832,1314,41,38,274,1701,20,312,209,395,332,604,2671,5058,12,64042,3557,1,2,1,1,49300,20026,3866,26861,0
79,4191,1457,730,1242,11,6,188,1468,10,292,166,329,302,495,2424,4078,5,22973,1276,1,2,1,1,49300,20028,3866,26862,0
38,2303,334,251,279,10,4,40,344,5,127,74,143,132,217,899,1528,2,4303,239,0,2,1,7,49300,20029,3866,26863,0
48,1750,1098,241,925,5,10,155,1103,7,46,25,49,53,74,273,423,3,1580,87,0,2,0,5,49310,20031,3866,26864,0
348,6936,1457,730,1242,11,6,188,1468,10,292,166,329,302,495,2424,4078,5,22973,1276,1,2,2,1,49310,20033,3866,26865,0
348,6936,74,35,59,1,0,14,75,3,14,7,14,17,21,58,85,1,128,7,0,2,2,1,49310,20034,3866,26866,0
348,6936,245,125,200,5,7,34,250,7,30,17,34,37,51,166,265,3,1053,58,0,2,2,1,49320,20035,3866,26867,0
80,4257,1457,730,1242,11,6,188,1468,10,292,166,329,302,495,2424,4078,5,22973,1276,1,2,8,0,49320,20037,3866,26868,0
80,4250,1457,730,1242,11,6,188,1468,10,292,166,329,302,495,2424,4078,5,22973,1276,1,2,1,1,49320,20039,3866,26869,0
47,1325,773,422,505,30,103,129,803,14,77,46,83,91,129,535,839,7,6334,351,0,2,32,41,49330,20040,3867,26870,0
45,1298,773,422,505,30,103,129,803,14,77,46,83,91,129,535,839,7,6334,351,0,2,2,12,49340,20041,3868,26871,0
7,353,139,89,101,2,0,35,141,7,54,34,62,61,96,330,569,4,2287,127,0,2,4,7,49340,20041,3868,26872,0
45,1298,773,422,505,30,103,129,803,14,77,46,83,91,129,535,839,7,6334,351,0,2,2,1,49350,20042,3869,26873,0
21,1023,1157,318,931,29,22,177,1186,6,104,63,125,110,188,712,1274,3,4596,255,0,2,7,7,49350,20042,3869,26874,0
45,1298,773,422,505,30,103,129,803,14,77,46,83,91,129,535,839,7,6334,351,0,2,1,0,49360,20043,3870,26875,0
119,4767,1513,682,1277,25,13,200,1538,11,199,116,219,210,335,1557,2584,6,15641,868,0,2,0,17,49360,20045,3870,26876,0
45,1297,773,422,505,30,103,129,803,14,77,46,83,91,129,535,839,7,6334,351,0,2,7,11,49370,20046,3871,26877,0
20,509,205,80,86,16,53,53,221,7,18,10,19,25,29,94,134,3,497,27,0,2,9,2,49380,20046,3872,26878,0
108,2066,1178,367,1042,6,15,115,1184,9,94,51,95,103,146,644,976,4,4439,246,0,2,2,1,49380,20046,3872,26879,0
108,2066,177,108,140,8,0,27,185,6,30,16,32,36,48,162,248,3,794,44,0,2,2,1,49380,20048,3872,26880,0
74,3124,1178,367,1042,6,15,115,1184,9,94,51,95,103,146,644,976,4,4439,246,0,2,42,3,49380,20048,3872,26881,0
347,6933,1457,730,1242,11,6,188,1468,10,292,166,329,302,495,2424,4078,5,22973,1276,1,2,1,1,49380,20050,3872,26882,0
347,6933,74,35,59,1,0,14,75,3,14,7,14,17,21,58,85,1,128,7,0,2,1,1,49380,20051,3872,26883,0
347,6933,245,125,200,5,7,34,250,7,30,17,34,37,51,166,265,3,1053,58,0,2,1,1,49390,20052,3872,26884,0
45,1297,773,422,505,30,103,129,803,14,77,46,83,91,129,535,839,7,6334,351,0,0,337,0,49400,20053,3873,26885,0
11,394,42,7,35,4,0,5,46,1,2,1,2,3,3,2,4,0,2,0,0,2,1,1,49400,20053,3873,26886,0
11,394,11,6,10,0,0,1,11,2,4,2,4,6,6,10,15,1,15,0,0,2,1,1,49400,20053,3873,26887,0
7,353,139,89,101,2,0,35,141,7,54,34,62,61,96,330,569,4,2287,127,0,0,70,0,49400,20053,3873,26888,0
21,1023,1157,318,931,29,22,177,1186,6,104,63,125,110,188,712,1274,3,4596,255,0,0,398,0,49400,20053,3873,26889,0
122,4899,1513,682,1277,25,13,200,1538,11,199,116,219,210,335,1557,2584,6,15641,868,0,2,0,20,49400,20055,3873,26890,0
64,1733,1455,414,1257,16,76,112,1471,5,41,23,46,46,69,231,381,2,1069,59,0,2,9,1,49400,20056,3873,26891,0
64,1733,669,365,481,22,61,110,691,15,103,63,122,118,185,747,1273,8,11311,628,0,2,9,1,49410,20056,3874,26892,0
64,1721,1455,414,1257,16,76,112,1471,5,41,23,46,46,69,231,381,2,1069,59,0,2,1,2,49410,20057,3874,26893,0
64,1721,669,365,481,22,61,110,691,15,103,63,122,118,185,747,1273,8,11311,628,0,2,1,2,49420,20057,3875,26894,0
67,3083,1455,414,1257,16,76,112,1471,5,41,23,46,46,69,231,381,2,1069,59,0,2,28,0,49420,20058,3875,26895,0
64,1721,1455,414,1257,16,76,112,1471,5,41,23,46,46,69,231,381,2,1069,59,0,2,8,1,49420,20059,3875,26896,0
64,1721,669,365,481,22,61,110,691,15,103,63,122,118,185,747,1273,8,11311,628,0,2,8,1,49430,20059,3876,26897,0
67,3083,1455,414,1257,16,76,112,1471,5,41,23,46,46,69,231,381,2,1069,59,0,2,28,0,49430,20060,3876,26898,0
181,4179,77,34,69,0,0,8,77,3,24,16,29,27,45,114,213,1,387,21,0,2,13,1,49430,20060,3876,26899,0
181,4179,712,438,573,51,9,84,763,14,102,71,128,116,199,733,1364,8,11988,666,0,2,13,1,49440,20061,3876,26900,0
72,3739,1296,573,1062,40,33,157,1336,8,201,118,231,209,349,1561,2689,4,12365,686,0,2,2,4,49440,20061,3876,26901,0
76,3893,1943,715,1694,26,18,214,1969,12,185,120,237,197,357,1436,2721,7,20915,1161,0,2,0,1,49440,20063,3876,26902,0
96,1829,1020,354,843,12,15,144,1032,8,134,77,144,142,221,970,1580,4,6792,377,0,2,1,1,49440,20063,3876,26903,0
96,1829,1020,354,843,12,15,144,1032,8,134,77,144,142,221,970,1580,4,6792,377,0,2,1,1,49440,20063,3876,26904,0
228,5144,4293,999,3693,19,54,507,4312,9,155,88,170,164,258,1156,1898,4,9368,520,0,2,4,0,49440,20065,3876,26905,0
228,5144,1482,859,1002,125,135,219,1607,16,219,134,251,235,385,1766,3032,9,27804,1544,1,2,4,0,49450,20066,3876,26906,0
348,6936,1457,730,1242,11,6,188,1468,10,292,166,329,302,495,2424,4078,5,22973,1276,1,2,2,1,49450,20068,3876,26907,0
348,6936,74,35,59,1,0,14,75,3,14,7,14,17,21,58,85,1,128,7,0,2,2,1,49450,20069,3876,26908,0
348,6936,245,125,200,5,7,34,250,7,30,17,34,37,51,166,265,3,1053,58,0,2,2,1,49460,20070,3876,26909,0
80,4250,1457,730,1242,11,6,188,1468,10,292,166,329,302,495,2424,4078,5,22973,1276,1,2,8,0,49460,20072,3876,26910,0
181,4179,77,34,69,0,0,8,77,3,24,16,29,27,45,114,213,1,387,21,0,2,13,1,49460,20072,3876,26911,0
181,4179,712,438,573,51,9,84,763,14,102,71,128,116,199,733,1364,8,11988,666,0,2,13,1,49470,20073,3876,26912,0
72,3739,1296,573,1062,40,33,157,1336,8,201,118,231,209,349,1561,2689,4,12365,686,0,2,2,4,49470,20073,3876,26913,0
76,3893,1943,715,1694,26,18,214,1969,12,185,120,237,197,357,1436,2721,7,20915,1161,0,2,0,1,49470,20075,3876,26914,0
52,1094,207,111,150,11,0,50,218,5,26,19,36,31,55,133,272,3,943,52,0,2,52,43,49470,20075,3876,26915,1
52,1094,410,198,237,31,55,97,441,11,63,38,72,74,110,414,683,6,4293,238,0,2,52,43,49480,20076,3877,26916,1
228,5136,4293,999,3693,19,54,507,4312,9,155,88,170,164,258,1156,1898,4,9368,520,0,2,1,2,49480,20078,3877,26917,1
228,5136,1482,859,1002,125,135,219,1607,16,219,134,251,235,385,1766,3032,9,27804,1544,1,2,1,2,49490,20079,3877,26918,1
12,419,42,7,35,4,0,5,46,1,2,1,2,3,3,2,4,0,2,0,0,2,4,1,49490,20079,3877,26919,1
12,419,11,6,10,0,0,1,11,2,4,2,4,6,6,10,15,1,15,0,0,2,4,1,49490,20079,3877,26920,1
161,7064,139,89,101,2,0,35,141,7,54,34,62,61,96,330,569,4,2287,127,0,2,1,4,49490,20079,3877,26921,1
161,7064,7,5,5,0,0,2,7,1,2,1,2,3,3,2,4,0,2,0,0,2,1,4,49490,20079,3877,26922,1
161,7062,139,89,101,2,0,35,141,7,54,34,62,61,96,330,569,4,2287,127,0,2,0,1,49490,20079,3877,26923,0
161,7062,7,5,5,0,0,2,7,1,2,1,2,3,3,2,4,0,2,0,0,2,0,1,49490,20079,3877,26924,0
52,1094,207,111,150,11,0,50,218,5,26,19,36,31,55,133,272,3,943,52,0,2,52,43,49490,20079,3877,26925,0
52,1094,410,198,237,31,55,97,441,11,63,38,72,74,110,414,683,6,4293,238,0,2,52,43,49500,20080,3878,26926,0
228,5136,4293,999,3693,19,54,507,4312,9,155,88,170,164,258,1156,1898,4,9368,520,0,2,1,2,49500,20082,3878,26927,0
228,5136,1482,859,1002,125,135,219,1607,16,219,134,251,235,385,1766,3032,9,27804,1544,1,2,1,2,49510,20083,3878,26928,0
12,419,42,7,35,4,0,5,46,1,2,1,2,3,3,2,4,0,2,0,0,2,4,1,49510,20083,3878,26929,0
12,419,11,6,10,0,0,1,11,2,4,2,4,6,6,10,15,1,15,0,0,2,4,1,49510,20083,3878,26930,0
161,7062,139,89,101,2,0,35,141,7,54,34,62,61,96,330,569,4,2287,127,0,2,1,5,49510,20083,3878,26931,0
161,7062,7,5,5,0,0,2,7,1,2,1,2,3,3,2,4,0,2,0,0,2,1,5,49510,20083,3878,26932,0
73,3848,1296,573,1062,40,33,157,1336,8,201,118,231,209,349,1561,2689,4,12365,686,0,2,26,0,49510,20083,3878,26933,1
73,3850,1296,573,1062,40,33,157,1336,8,201,118,231,209,349,1561,2689,4,12365,686,0,2,2,2,49510,20083,3878,26934,0
235,5317,4293,999,3693,19,54,507,4312,9,155,88,170,164,258,1156,1898,4,9368,520,0,2,35,1,49510,20085,3878,26935,1
235,5317,1482,859,1002,125,135,219,1607,16,219,134,251,235,385,1766,3032,9,27804,1544,1,2,35,1,49520,20086,3878,26936,1
234,5311,4293,999,3693,19,54,507,4312,9,155,88,170,164,258,1156,1898,4,9368,520,0,2,4,5,49520,20088,3878,26937,0
234,5311,1482,859,1002,125,135,219,1607,16,219,134,251,235,385,1766,3032,9,27804,1544,1,2,4,5,49530,20089,3878,26938,0
232,5292,4293,999,3693,19,54,507,4312,9,155,88,170,164,258,1156,1898,4,9368,520,0,2,10,10,49530,20091,3878,26939,1
232,5292,1482,859,1002,125,135,219,1607,16,219,134,251,235,385,1766,3032,9,27804,1544,1,2,10,10,49540,20092,3878,26940,1
232,5292,4293,999,3693,19,54,507,4312,9,155,88,170,164,258,1156,1898,4,9368,520,0,2,1,1,49540,20094,3878,26941,1
232,5292,1482,859,1002,125,135,219,1607,16,219,134,251,235,385,1766,3032,9,27804,1544,1,2,1,1,49550,20095,3878,26942,1
229,5195,4293,999,3693,19,54,507,4312,9,155,88,170,164,258,1156,1898,4,9368,520,0,2,8,39,49550,20097,3878,26943,1
229,5195,1482,859,1002,125,135,219,1607,16,219,134,251,235,385,1766,3032,9,27804,1544,1,2,8,39,49560,20098,3878,26944,1
4,95,53,23,39,0,0,13,53,2,8,4,8,10,12,26,39,1,39,2,0,0,37,0,49560,20098,3878,26945,1
4,95,515,298,307,33,80,99,548,12,63,44,77,75,121,419,753,7,5527,307,0,0,37,0,49570,20098,3878,26946,1
1,106,53,23,39,0,0,13,53,2,8,4,8,10,12,26,39,1,39,2,0,3,3,3,49570,20098,3878,26947,1
75,1461,757,253,292,73,244,162,830,13,61,38,67,74,105,409,651,7,4654,258,0,2,2,1,49570,20099,3878,26948,1
229,5199,4293,999,3693,19,54,507,4312,9,155,88,170,164,258,1156,1898,4,9368,520,0,2,4,4,49570,20101,3878,26949,0
229,5199,1482,859,1002,125,135,219,1607,16,219,134,251,235,385,1766,3032,9,27804,1544,1,2,4,4,49580,20102,3878,26950,0
83,2365,1523,757,1297,19,12,193,1542,12,193,117,230,205,347,1508,2664,7,19053,1058,0,2,2,1,49590,20104,3878,26951,0
83,2365,701,378,504,33,58,109,734,13,110,68,126,123,194,794,1346,7,10027,557,0,2,2,1,49590,20105,3879,26952,0
184,4257,77,34,69,0,0,8,77,3,24,16,29,27,45,114,213,1,387,21,0,2,5,4,49590,20105,3879,26953,0
184,4257,712,438,573,51,9,84,763,14,102,71,128,116,199,733,1364,8,11988,666,0,2,5,4,49600,20106,3879,26954,0
4,92,53,23,39,0,0,13,53,2,8,4,8,10,12,26,39,1,39,2,0,2,4,1,49600,20106,3879,26955,0
4,92,515,298,307,33,80,99,548,12,63,44,77,75,121,419,753,7,5527,307,0,2,4,1,49610,20106,3879,26956,0
193,3994,1943,715,1694,26,18,214,1969,12,185,120,237,197,357,1436,2721,7,20915,1161,0,2,2,1,49610,20108,3879,26957,0
193,3994,1168,838,957,57,25,144,1225,19,348,224,416,367,640,3018,5452,11,61921,3440,1,2,2,1,49620,20110,3879,26958,0
75,1461,757,253,292,73,244,162,830,13,61,38,67,74,105,409,651,7,4654,258,0,2,2,1,49620,20111,3879,26959,0
4,90,53,23,39,0,0,13,53,2,8,4,8,10,12,26,39,1,39,2,0,2,0,3,49620,20111,3879,26960,0
4,90,515,298,307,33,80,99,548,12,63,44,77,75,121,419,753,7,5527,307,0,2,0,3,49630,20111,3879,26961,0
96,1835,1020,354,843,12,15,144,1032,8,134,77,144,142,221,970,1580,4,6792,377,0,2,3,2,49630,20111,3879,26962,1
75,3288,1020,354,843,12,15,144,1032,8,134,77,144,142,221,970,1580,4,6792,377,0,2,17,0,49630,20111,3879,26963,1
229,5199,4293,999,3693,19,54,507,4312,9,155,88,170,164,258,1156,1898,4,9368,520,0,2,10,8,49630,20113,3879,26964,0
229,5199,1482,859,1002,125,135,219,1607,16,219,134,251,235,385,1766,3032,9,27804,1544,1,2,10,8,49640,20114,3879,26965,0
83,2365,1523,757,1297,19,12,193,1542,12,193,117,230,205,347,1508,2664,7,19053,1058,0,2,2,1,49650,20116,3879,26966,0
83,2365,701,378,504,33,58,109,734,13,110,68,126,123,194,794,1346,7,10027,557,0,2,2,1,49650,20117,3880,26967,0
184,4257,77,34,69,0,0,8,77,3,24,16,29,27,45,114,213,1,387,21,0,2,5,4,49650,20117,3880,26968,0
184,4257,712,438,573,51,9,84,763,14,102,71,128,116,199,733,1364,8,11988,666,0,2,5,4,49660,20118,3880,26969,0
4,90,53,23,39,0,0,13,53,2,8,4,8,10,12,26,39,1,39,2,0,0,37,0,49660,20118,3880,26970,0
4,90,515,298,307,33,80,99,548,12,63,44,77,75,121,419,753,7,5527,307,0,0,37,0,49670,20118,3880,26971,0
75,1461,757,253,292,73,244,162,830,13,61,38,67,74,105,409,651,7,4654,258,0,2,2,1,49670,20119,3880,26972,0
193,3994,1943,715,1694,26,18,214,1969,12,185,120,237,197,357,1436,2721,7,20915,1161,0,2,2,1,49670,20121,3880,26973,0
193,3994,1168,838,957,57,25,144,1225,19,348,224,416,367,640,3018,5452,11,61921,3440,1,2,2,1,49680,20123,3880,26974,0
73,3850,1296,573,1062,40,33,157,1336,8,201,118,231,209,349,1561,2689,4,12365,686,0,2,26,0,49680,20123,3880,26975,0
1,106,53,23,39,0,0,13,53,2,8,4,8,10,12,26,39,1,39,2,0,0,18,0,49680,20123,3880,26976,0
229,5171,4293,999,3693,19,54,507,4312,9,155,88,170,164,258,1156,1898,4,9368,520,0,2,17,10,49680,20125,3880,26977,0
229,5171,1482,859,1002,125,135,219,1607,16,219,134,251,235,385,1766,3032,9,27804,1544,1,2,17,10,49690,20126,3880,26978,0
83,2365,1523,757,1297,19,12,193,1542,12,193,117,230,205,347,1508,2664,7,19053,1058,0,2,2,1,49700,20128,3880,26979,0
83,2365,701,378,504,33,58,109,734,13,110,68,126,123,194,794,1346,7,10027,557,0,2,2,1,49700,20129,3881,26980,0
181,4189,77,34,69,0,0,8,77,3,24,16,29,27,45,114,213,1,387,21,0,2,5,4,49700,20129,3881,26981,0
181,4189,712,438,573,51,9,84,763,14,102,71,128,116,199,733,1364,8,11988,666,0,2,5,4,49710,20130,3881,26982,0
94,1804,1020,354,843,12,15,144,1032,8,134,77,144,142,221,970,1580,4,6792,377,0,2,1,1,49710,20130,3881,26983,0
4,90,53,23,39,0,0,13,53,2,8,4,8,10,12,26,39,1,39,2,0,0,37,0,49710,20130,3881,26984,0
4,90,515,298,307,33,80,99,548,12,63,44,77,75,121,419,753,7,5527,307,0,0,37,0,49720,20130,3881,26985,0
73,1421,757,253,292,73,244,162,830,13,61,38,67,74,105,409,651,7,4654,258,0,2,2,1,49720,20131,3881,26986,0
195,4029,1943,715,1694,26,18,214,1969,12,185,120,237,197,357,1436,2721,7,20915,1161,0,2,3,2,49720,20133,3881,26987,0
195,4029,1168,838,957,57,25,144,1225,19,348,224,416,367,640,3018,5452,11,61921,3440,1,2,3,2,49730,20135,3881,26988,0
73,3834,1296,573,1062,40,33,157,1336,8,201,118,231,209,349,1561,2689,4,12365,686,0,2,26,0,49730,20135,3881,26989,0
74,3250,1020,354,843,12,15,144,1032,8,134,77,144,142,221,970,1580,4,6792,377,0,2,18,0,49730,20135,3881,26990,0
1,106,53,23,39,0,0,13,53,2,8,4,8,10,12,26,39,1,39,2,0,0,18,0,49730,20135,3881,26991,0
96,1835,1020,354,843,12,15,144,1032,8,134,77,144,142,221,970,1580,4,6792,377,0,2,3,2,49730,20135,3881,26992,0
75,3288,1020,354,843,12,15,144,1032,8,134,77,144,142,221,970,1580,4,6792,377,0,2,17,0,49730,20135,3881,26993,0
52,1088,207,111,150,11,0,50,218,5,26,19,36,31,55,133,272,3,943,52,0,2,4,8,49730,20135,3881,26994,0
52,1088,410,198,237,31,55,97,441,11,63,38,72,74,110,414,683,6,4293,238,0,2,4,8,49740,20136,3882,26995,0
210,5003,722,423,573,19,0,135,741,12,172,101,199,184,300,1320,2257,6,15668,870,0,2,1,3,49740,20138,3882,26997,0
210,5003,1508,847,911,44,250,301,1552,14,148,88,169,162,257,1120,1886,7,15077,837,0,2,1,3,49740,20139,3883,26998,0
46,954,386,256,301,16,9,68,402,4,59,35,69,63,104,355,621,2,1453,80,0,2,2,4,49740,20139,3883,26999,0
46,954,264,131,164,11,41,46,275,6,38,22,40,44,62,214,338,3,1068,59,0,2,2,4,49750,20139,3884,27000,0
7,353,139,89,101,2,0,35,141,7,54,34,62,61,96,330,569,4,2287,127,0,2,1,1,49750,20139,3884,27001,0
52,1082,207,111,150,11,0,50,218,5,26,19,36,31,55,133,272,3,943,52,0,2,0,2,49750,20139,3884,27002,0
52,1082,410,198,237,31,55,97,441,11,63,38,72,74,110,414,683,6,4293,238,0,2,0,2,49760,20140,3885,27003,0
94,1805,1020,354,843,12,15,144,1032,8,134,77,144,142,221,970,1580,4,6792,377,0,2,2,2,49760,20140,3885,27004,0
73,1425,757,253,292,73,244,162,830,13,61,38,67,74,105,409,651,7,4654,258,0,2,3,2,49760,20141,3885,27005,0
346,6927,1457,730,1242,11,6,188,1468,10,292,166,329,302,495,2424,4078,5,22973,1276,1,2,6,6,49760,20143,3885,27006,0
346,6927,74,35,59,1,0,14,75,3,14,7,14,17,21,58,85,1,128,7,0,2,6,6,49760,20144,3885,27007,0
346,6927,245,125,200,5,7,34,250,7,30,17,34,37,51,166,265,3,1053,58,0,2,6,6,49770,20145,3885,27008,0
33,1914,384,251,317,7,8,52,391,11,70,44,84,81,128,467,811,6,5355,297,0,2,8,3,49770,20145,3885,27009,0
52,1082,207,111,150,11,0,50,218,5,26,19,36,31,55,133,272,3,943,52,0,2,4,10,49770,20145,3885,27010,0
52,1082,410,198,237,31,55,97,441,11,63,38,72,74,110,414,683,6,4293,238,0,2,4,10,49780,20146,3886,27011,0
229,5171,4293,999,3693,19,54,507,4312,9,155,88,170,164,258,1156,1898,4,9368,520,0,2,17,10,49780,20148,3886,27012,0
229,5171,1482,859,1002,125,135,219,1607,16,219,134,251,235,385,1766,3032,9,27804,1544,1,2,17,10,49790,20149,3886,27013,0
83,2365,1523,757,1297,19,12,193,1542,12,193,117,230,205,347,1508,2664,7,19053,1058,0,2,2,1,49800,20151,3886,27014,0
83,2365,701,378,504,33,58,109,734,13,110,68,126,123,194,794,1346,7,10027,557,0,2,2,1,49800,20152,3887,27015,0
181,4189,77,34,69,0,0,8,77,3,24,16,29,27,45,114,213,1,387,21,0,2,5,4,49800,20152,3887,27016,0
181,4189,712,438,573,51,9,84,763,14,102,71,128,116,199,733,1364,8,11988,666,0,2,5,4,49810,20153,3887,27017,0
94,1805,1020,354,843,12,15,144,1032,8,134,77,144,142,221,970,1580,4,6792,377,0,2,3,3,49810,20153,3887,27018,0
4,90,53,23,39,0,0,13,53,2,8,4,8,10,12,26,39,1,39,2,0,0,37,0,49810,20153,3887,27019,0
4,90,515,298,307,33,80,99,548,12,63,44,77,75,121,419,753,7,5527,307,0,0,37,0,49820,20153,3887,27020,0
210,5003,722,423,573,19,0,135,741,12,172,101,199,184,300,1320,2257,6,15668,870,0,2,1,3,49820,20155,3887,27022,0
210,5003,1508,847,911,44,250,301,1552,14,148,88,169,162,257,1120,1886,7,15077,837,0,2,1,3,49820,20156,3888,27023,0
73,1425,757,253,292,73,244,162,830,13,61,38,67,74,105,409,651,7,4654,258,0,2,5,3,49820,20157,3888,27024,0
46,954,386,256,301,16,9,68,402,4,59,35,69,63,104,355,621,2,1453,80,0,2,2,4,49820,20157,3888,27025,0
46,954,264,131,164,11,41,46,275,6,38,22,40,44,62,214,338,3,1068,59,0,2,2,4,49830,20157,3889,27026,0
195,4029,1943,715,1694,26,18,214,1969,12,185,120,237,197,357,1436,2721,7,20915,1161,0,2,3,2,49830,20159,3889,27027,0
195,4029,1168,838,957,57,25,144,1225,19,348,224,416,367,640,3018,5452,11,61921,3440,1,2,3,2,49840,20161,3889,27028,0
7,353,139,89,101,2,0,35,141,7,54,34,62,61,96,330,569,4,2287,127,0,2,1,1,49840,20161,3889,27029,0
73,3834,1296,573,1062,40,33,157,1336,8,201,118,231,209,349,1561,2689,4,12365,686,0,2,26,0,49840,20161,3889,27030,0
74,3250,1020,354,843,12,15,144,1032,8,134,77,144,142,221,970,1580,4,6792,377,0,2,18,0,49840,20161,3889,27031,0
1,106,53,23,39,0,0,13,53,2,8,4,8,10,12,26,39,1,39,2,0,0,18,0,49840,20161,3889,27032,0
167,5123,1660,832,1314,41,38,274,1701,20,312,209,395,332,604,2671,5058,12,64042,3557,1,2,8,3,49840,20163,3890,27034,0
167,5123,1057,646,719,113,100,145,1170,18,215,134,248,233,382,1740,3004,10,31186,1732,1,2,8,3,49850,20164,3891,27035,0
153,4268,1660,832,1314,41,38,274,1701,20,312,209,395,332,604,2671,5058,12,64042,3557,1,2,21,13,49850,20166,3892,27037,0
167,5122,1660,832,1314,41,38,274,1701,20,312,209,395,332,604,2671,5058,12,64042,3557,1,2,3,2,49850,20168,3893,27039,0
167,5122,1057,646,719,113,100,145,1170,18,215,134,248,233,382,1740,3004,10,31186,1732,1,2,3,2,49860,20169,3894,27040,0
155,4372,1660,832,1314,41,38,274,1701,20,312,209,395,332,604,2671,5058,12,64042,3557,1,2,11,0,49860,20171,3895,27042,0
155,4372,1660,832,1314,41,38,274,1701,20,312,209,395,332,604,2671,5058,12,64042,3557,1,2,3,0,49860,20173,3896,27044,0
167,5122,1660,832,1314,41,38,274,1701,20,312,209,395,332,604,2671,5058,12,64042,3557,1,2,11,5,49860,20175,3897,27046,0
167,5122,1057,646,719,113,100,145,1170,18,215,134,248,233,382,1740,3004,10,31186,1732,1,2,11,5,49870,20176,3898,27047,0
155,4372,1660,832,1314,41,38,274,1701,20,312,209,395,332,604,2671,5058,12,64042,3557,1,2,35,13,49870,20178,3899,27049,0
155,4372,1660,832,1314,41,38,274,1701,20,312,209,395,332,604,2671,5058,12,64042,3557,1,2,1,1,49870,20180,3900,27051,0
100,1967,1020,354,843,12,15,144,1032,8,134,77,144,142,221,970,1580,4,6792,377,0,2,25,0,49870,20180,3900,27052,1
256,6030,72,33,56,0,4,12,72,1,1,1,1,2,2,0,2,0,1,0,0,2,3,21,49870,20180,3900,27053,1
256,6030,1454,835,1044,76,110,219,1530,17,275,158,296,292,454,2297,3718,9,34017,1889,1,2,3,21,49880,20181,3900,27054,1
135,2748,1513,682,1277,25,13,200,1538,11,199,116,219,210,335,1557,2584,6,15641,868,0,2,6,2,49880,20183,3900,27055,0
135,2748,819,519,539,24,98,155,843,15,96,57,106,111,163,690,1107,8,9171,509,0,2,6,2,49890,20185,3900,27056,0
124,4990,1513,682,1277,25,13,200,1538,11,199,116,219,210,335,1557,2584,6,15641,868,0,2,16,0,49890,20187,3900,27057,0
60,1682,1455,414,1257,16,76,112,1471,5,41,23,46,46,69,231,381,2,1069,59,0,2,1,1,49890,20188,3900,27058,0
60,1682,669,365,481,22,61,110,691,15,103,63,122,118,185,747,1273,8,11311,628,0,2,1,1,49900,20188,3901,27059,0
66,3053,1455,414,1257,16,76,112,1471,5,41,23,46,46,69,231,381,2,1069,59,0,2,28,2,49900,20189,3901,27060,0
135,2748,1513,682,1277,25,13,200,1538,11,199,116,219,210,335,1557,2584,6,15641,868,0,2,6,2,49900,20191,3901,27061,0
135,2748,819,519,539,24,98,155,843,15,96,57,106,111,163,690,1107,8,9171,509,0,2,6,2,49910,20193,3901,27062,0
124,4990,1513,682,1277,25,13,200,1538,11,199,116,219,210,335,1557,2584,6,15641,868,0,2,16,0,49910,20195,3901,27063,0
60,1682,1455,414,1257,16,76,112,1471,5,41,23,46,46,69,231,381,2,1069,59,0,2,1,1,49910,20196,3901,27064,0
60,1682,669,365,481,22,61,110,691,15,103,63,122,118,185,747,1273,8,11311,628,0,2,1,1,49920,20196,3902,27065,0
66,3053,1455,414,1257,16,76,112,1471,5,41,23,46,46,69,231,381,2,1069,59,0,2,28,2,49920,20197,3902,27066,0
257,6191,72,33,56,0,4,12,72,1,1,1,1,2,2,0,2,0,1,0,0,2,8,1,49920,20197,3902,27068,0
257,6191,1454,835,1044,76,110,219,1530,17,275,158,296,292,454,2297,3718,9,34017,1889,1,2,8,1,49930,20198,3902,27069,0
231,5221,4293,999,3693,19,54,507,4312,9,155,88,170,164,258,1156,1898,4,9368,520,0,2,16,7,49930,20200,3902,27071,1
231,5221,1482,859,1002,125,135,219,1607,16,219,134,251,235,385,1766,3032,9,27804,1544,1,2,16,7,49940,20201,3902,27072,1
93,1852,1020,354,843,12,15,144,1032,8,134,77,144,142,221,970,1580,4,6792,377,0,2,29,21,49940,20201,3902,27073,1
12,422,42,7,35,4,0,5,46,1,2,1,2,3,3,2,4,0,2,0,0,2,6,1,49940,20201,3902,27074,1
12,422,11,6,10,0,0,1,11,2,4,2,4,6,6,10,15,1,15,0,0,2,6,1,49940,20201,3902,27075,1
155,4372,1660,832,1314,41,38,274,1701,20,312,209,395,332,604,2671,5058,12,64042,3557,1,2,1,1,49940,20203,3903,27077,0
166,5068,1660,832,1314,41,38,274,1701,20,312,209,395,332,604,2671,5058,12,64042,3557,1,2,11,5,49940,20205,3904,27079,1
166,5068,1057,646,719,113,100,145,1170,18,215,134,248,233,382,1740,3004,10,31186,1732,1,2,11,5,49950,20206,3905,27080,1
64,1726,1455,414,1257,16,76,112,1471,5,41,23,46,46,69,231,381,2,1069,59,0,2,1,1,49950,20207,3905,27081,1
64,1726,669,365,481,22,61,110,691,15,103,63,122,118,185,747,1273,8,11311,628,0,2,1,1,49960,20207,3906,27082,1
94,1811,1020,354,843,12,15,144,1032,8,134,77,144,142,221,970,1580,4,6792,377,0,2,3,2,49960,20207,3906,27083,1
155,4372,1660,832,1314,41,38,274,1701,20,312,209,395,332,604,2671,5058,12,64042,3557,1,2,35,13,49960,20209,3907,27085,1
68,3131,1455,414,1257,16,76,112,1471,5,41,23,46,46,69,231,381,2,1069,59,0,2,28,2,49960,20210,3907,27086,1
75,3288,1020,354,843,12,15,144,1032,8,134,77,144,142,221,970,1580,4,6792,377,0,2,17,0,49960,20210,3907,27087,1
100,1967,1020,354,843,12,15,144,1032,8,134,77,144,142,221,970,1580,4,6792,377,0,2,25,0,49960,20210,3907,27088,0
256,6030,72,33,56,0,4,12,72,1,1,1,1,2,2,0,2,0,1,0,0,2,3,21,49960,20210,3907,27089,0
256,6030,1454,835,1044,76,110,219,1530,17,275,158,296,292,454,2297,3718,9,34017,1889,1,2,3,21,49970,20211,3907,27090,0
257,6066,72,33,56,0,4,12,72,1,1,1,1,2,2,0,2,0,1,0,0,2,8,1,49970,20211,3907,27092,0
257,6066,1454,835,1044,76,110,219,1530,17,275,158,296,292,454,2297,3718,9,34017,1889,1,2,8,1,49980,20212,3907,27093,0
166,5068,1660,832,1314,41,38,274,1701,20,312,209,395,332,604,2671,5058,12,64042,3557,1,2,11,5,49980,20214,3908,27095,0
166,5068,1057,646,719,113,100,145,1170,18,215,134,248,233,382,1740,3004,10,31186,1732,1,2,11,5,49990,20215,3909,27096,0
64,1726,1455,414,1257,16,76,112,1471,5,41,23,46,46,69,231,381,2,1069,59,0,2,1,1,49990,20216,3909,27097,0
64,1726,669,365,481,22,61,110,691,15,103,63,122,118,185,747,1273,8,11311,628,0,2,1,1,50000,20216,3910,27098,0
100,1973,1020,354,843,12,15,144,1032,8,134,77,144,142,221,970,1580,4,6792,377,0,2,3,2,50000,20216,3910,27099,0
155,4372,1660,832,1314,41,38,274,1701,20,312,209,395,332,604,2671,5058,12,64042,3557,1,2,35,13,50000,20218,3911,27101,0
68,3131,1455,414,1257,16,76,112,1471,5,41,23,46,46,69,231,381,2,1069,59,0,2,28,2,50000,20219,3911,27102,0
75,3288,1020,354,843,12,15,144,1032,8,134,77,144,142,221,970,1580,4,6792,377,0,2,17,0,50000,20219,3911,27103,0
166,5068,1660,832,1314,41,38,274,1701,20,312,209,395,332,604,2671,5058,12,64042,3557,1,2,11,5,50000,20221,3912,27105,0
166,5068,1057,646,719,113,100,145,1170,18,215,134,248,233,382,1740,3004,10,31186,1732,1,2,11,5,50010,20222,3913,27106,0
64,1726,1455,414,1257,16,76,112,1471,5,41,23,46,46,69,231,381,2,1069,59,0,2,1,1,50010,20223,3913,27108,0
64,1726,669,365,481,22,61,110,691,15,103,63,122,118,185,747,1273,8,11311,628,0,2,1,1,50020,20223,3914,27109,0
99,2020,1020,354,843,12,15,144,1032,8,134,77,144,142,221,970,1580,4,6792,377,0,2,28,2,50020,20223,3914,27110,0
257,6066,72,33,56,0,4,12,72,1,1,1,1,2,2,0,2,0,1,0,0,2,11,22,50020,20223,3914,27111,0
257,6066,1454,835,1044,76,110,219,1530,17,275,158,296,292,454,2297,3718,9,34017,1889,1,2,11,22,50030,20224,3914,27112,0
155,4372,1660,832,1314,41,38,274,1701,20,312,209,395,332,604,2671,5058,12,64042,3557,1,2,35,13,50030,20226,3915,27114,0
68,3131,1455,414,1257,16,76,112,1471,5,41,23,46,46,69,231,381,2,1069,59,0,2,28,2,50030,20227,3915,27115,0
75,3288,1020,354,843,12,15,144,1032,8,134,77,144,142,221,970,1580,4,6792,377,0,2,17,0,50030,20227,3915,27116,0
214,4608,182,127,129,0,0,53,182,5,39,21,42,44,63,217,343,2,926,51,0,2,4,4,50030,20227,3916,27117,1
214,4608,1165,710,800,67,119,181,1232,18,243,153,282,261,435,2000,3492,10,36473,2026,1,2,4,4,50040,20227,3917,27118,1
102,2083,773,419,590,28,0,166,801,10,204,113,217,214,330,1598,2554,5,13587,754,0,2,8,8,50040,20227,3918,27119,1
102,2083,421,273,302,44,34,57,465,17,81,59,107,98,166,583,1098,11,12329,684,0,2,8,8,50040,20227,3919,27120,1
86,1808,477,336,357,30,23,73,507,16,194,134,250,210,384,1538,2962,10,30538,1696,0,2,4,4,50050,20228,3919,27121,1
351,7048,1457,730,1242,11,6,188,1468,10,292,166,329,302,495,2424,4078,5,22973,1276,1,2,6,6,50050,20230,3919,27122,1
351,7048,74,35,59,1,0,14,75,3,14,7,14,17,21,58,85,1,128,7,0,2,6,6,50050,20231,3919,27123,1
351,7048,245,125,200,5,7,34,250,7,30,17,34,37,51,166,265,3,1053,58,0,2,6,6,50060,20232,3919,27124,1
229,5199,4293,999,3693,19,54,507,4312,9,155,88,170,164,258,1156,1898,4,9368,520,0,2,4,4,50060,20234,3919,27125,1
229,5199,1482,859,1002,125,135,219,1607,16,219,134,251,235,385,1766,3032,9,27804,1544,1,2,4,4,50070,20235,3919,27126,1
96,1835,1020,354,843,12,15,144,1032,8,134,77,144,142,221,970,1580,4,6792,377,0,2,2,2,50070,20235,3919,27127,1
212,5103,722,423,573,19,0,135,741,12,172,101,199,184,300,1320,2257,6,15668,870,0,2,14,14,50070,20237,3919,27129,1
212,5103,1508,847,911,44,250,301,1552,14,148,88,169,162,257,1120,1886,7,15077,837,0,2,14,14,50070,20238,3920,27130,1
256,6158,72,33,56,0,4,12,72,1,1,1,1,2,2,0,2,0,1,0,0,2,7,7,50070,20238,3920,27131,1
256,6158,1454,835,1044,76,110,219,1530,17,275,158,296,292,454,2297,3718,9,34017,1889,1,2,7,7,50080,20239,3920,27132,1
102,1930,1178,367,1042,6,15,115,1184,9,94,51,95,103,146,644,976,4,4439,246,0,2,3,3,50080,20239,3920,27133,1
102,1930,177,108,140,8,0,27,185,6,30,16,32,36,48,162,248,3,794,44,0,2,3,3,50080,20241,3920,27134,1
193,3994,1943,715,1694,26,18,214,1969,12,185,120,237,197,357,1436,2721,7,20915,1161,0,2,12,12,50080,20243,3920,27135,1
193,3994,1168,838,957,57,25,144,1225,19,348,224,416,367,640,3018,5452,11,61921,3440,1,2,12,12,50090,20245,3920,27136,1
62,1240,1098,241,925,5,10,155,1103,7,46,25,49,53,74,273,423,3,1580,87,0,2,4,4,50100,20247,3920,27137,1
62,1240,282,202,222,14,2,44,296,8,42,24,43,50,67,250,378,4,1548,86,0,2,4,4,50100,20248,3920,27138,1
149,6984,1392,870,1177,35,17,170,1427,14,494,280,531,508,811,4473,7289,7,54850,3047,2,2,2,2,50100,20251,3921,27139,1
87,2923,773,419,590,28,0,166,801,10,204,113,217,214,330,1598,2554,5,13587,754,0,2,4,4,50100,20251,3922,27140,1
98,4450,1338,495,1086,10,64,173,1348,11,122,82,157,133,239,883,1686,7,11934,663,0,2,4,4,50100,20253,3922,27141,1
162,7089,139,89,101,2,0,35,141,7,54,34,62,61,96,330,569,4,2287,127,0,2,201,201,50100,20253,3922,27142,1
162,7089,7,5,5,0,0,2,7,1,2,1,2,3,3,2,4,0,2,0,0,2,201,201,50100,20253,3922,27143,1
32,948,465,148,393,5,8,60,470,4,31,20,31,35,51,161,261,2,523,29,0,2,4,4,50100,20254,3922,27144,1
32,948,16,12,9,0,0,6,16,1,2,1,2,3,3,2,4,0,2,0,0,2,4,4,50100,20254,3922,27145,1
132,5719,1782,648,1425,9,47,279,1791,8,171,97,189,179,286,1292,2140,4,9462,525,0,2,3,3,50100,20255,3923,27146,1
109,4106,1450,624,1228,12,26,181,1462,14,306,186,354,320,540,2580,4493,8,36391,2021,1,2,6,6,50100,20257,3924,27147,1
155,4372,1660,832,1314,41,38,274,1701,20,312,209,395,332,604,2671,5058,12,64042,3557,1,2,2,2,50100,20259,3925,27149,1
73,3850,1296,573,1062,40,33,157,1336,8,201,118,231,209,349,1561,2689,4,12365,686,0,2,3,3,50100,20259,3925,27150,1
79,4191,1457,730,1242,11,6,188,1468,10,292,166,329,302,495,2424,4078,5,22973,1276,1,2,35,35,50100,20261,3925,27151,1
39,2355,652,304,544,16,6,88,668,6,89,51,101,95,152,591,998,3,3399,188,0,2,14,14,50100,20262,3925,27152,1
75,3288,1020,354,843,12,15,144,1032,8,134,77,144,142,221,970,1580,4,6792,377,0,2,14,14,50100,20262,3925,27153,1
21,661,424,94,331,4,0,89,428,1,5,5,5,6,10,11,25,0,12,0,0,2,35,35,50100,20263,3925,27154,1
36,1978,384,251,317,7,8,52,391,11,70,44,84,81,128,467,811,6,5355,297,0,2,18,18,50100,20263,3925,27155,1
36,1591,386,256,301,16,9,68,402,4,59,35,69,63,104,355,621,2,1453,80,0,2,2,2,50100,20263,3925,27156,1
75,2972,1043,504,840,53,9,147,1096,9,180,112,198,189,310,1377,2344,4,11604,644,0,2,4,4,50100,20265,3925,27157,1
14,529,295,56,236,0,4,54,295,2,9,5,10,11,15,30,51,1,57,3,0,2,4,4,50100,20267,3925,27158,1
26,1029,373,158,315,8,0,51,381,5,76,44,79,81,123,486,779,2,2026,112,0,2,14,14,50100,20267,3925,27159,1
71,3006,1178,367,1042,6,15,115,1184,9,94,51,95,103,146,644,976,4,4439,246,0,2,3,3,50100,20267,3925,27160,1
76,3899,1943,715,1694,26,18,214,1969,12,185,120,237,197,357,1436,2721,7,20915,1161,0,2,4,4,50100,20269,3925,27161,1
48,1795,1098,241,925,5,10,155,1103,7,46,25,49,53,74,273,423,3,1580,87,0,2,11,11,50110,20271,3925,27162,1
214,4608,182,127,129,0,0,53,182,5,39,21,42,44,63,217,343,2,926,51,0,2,3,3,50110,20271,3926,27163,1
214,4608,1165,710,800,67,119,181,1232,18,243,153,282,261,435,2000,3492,10,36473,2026,1,2,3,3,50120,20271,3927,27164,1
102,2083,773,419,590,28,0,166,801,10,204,113,217,214,330,1598,2554,5,13587,754,0,2,1,1,50120,20271,3928,27165,1
102,2083,421,273,302,44,34,57,465,17,81,59,107,98,166,583,1098,11,12329,684,0,2,1,1,50120,20271,3929,27166,1
167,5122,1660,832,1314,41,38,274,1701,20,312,209,395,332,604,2671,5058,12,64042,3557,1,2,1,1,50120,20273,3930,27168,1
167,5122,1057,646,719,113,100,145,1170,18,215,134,248,233,382,1740,3004,10,31186,1732,1,2,1,1,50130,20274,3931,27169,1
229,5199,4293,999,3693,19,54,507,4312,9,155,88,170,164,258,1156,1898,4,9368,520,0,2,1,1,50130,20276,3931,27170,1
229,5199,1482,859,1002,125,135,219,1607,16,219,134,251,235,385,1766,3032,9,27804,1544,1,2,1,1,50140,20277,3931,27171,1
184,4257,77,34,69,0,0,8,77,3,24,16,29,27,45,114,213,1,387,21,0,2,2,2,50140,20277,3931,27172,1
184,4257,712,438,573,51,9,84,763,14,102,71,128,116,199,733,1364,8,11988,666,0,2,2,2,50150,20278,3931,27173,1
75,1461,757,253,292,73,244,162,830,13,61,38,67,74,105,409,651,7,4654,258,0,2,1,1,50150,20279,3931,27174,1
113,2492,1043,504,840,53,9,147,1096,9,180,112,198,189,310,1377,2344,4,11604,644,0,2,1,1,50150,20281,3931,27175,1
113,2492,383,288,292,26,6,62,409,11,65,38,67,76,105,429,656,5,3719,206,0,2,1,1,50150,20282,3931,27176,1
62,1240,1098,241,925,5,10,155,1103,7,46,25,49,53,74,273,423,3,1580,87,0,2,1,1,50160,20284,3931,27177,1
62,1240,282,202,222,14,2,44,296,8,42,24,43,50,67,250,378,4,1548,86,0,2,1,1,50160,20285,3931,27178,1
149,6984,1392,870,1177,35,17,170,1427,14,494,280,531,508,811,4473,7289,7,54850,3047,2,2,4,4,50160,20288,3932,27179,1
231,5221,4293,999,3693,19,54,507,4312,9,155,88,170,164,258,1156,1898,4,9368,520,0,2,16,7,50160,20290,3932,27180,0
231,5221,1482,859,1002,125,135,219,1607,16,219,134,251,235,385,1766,3032,9,27804,1544,1,2,16,7,50170,20291,3932,27181,0
99,2020,1020,354,843,12,15,144,1032,8,134,77,144,142,221,970,1580,4,6792,377,0,2,29,21,50170,20291,3932,27182,0
12,422,42,7,35,4,0,5,46,1,2,1,2,3,3,2,4,0,2,0,0,2,6,1,50170,20291,3932,27183,0
12,422,11,6,10,0,0,1,11,2,4,2,4,6,6,10,15,1,15,0,0,2,6,1,50170,20291,3932,27184,0
17,604,601,196,481,2,23,85,603,8,63,36,72,71,108,400,664,4,3036,168,0,2,2,0,50170,20291,3932,27185,0
230,5220,4293,999,3693,19,54,507,4312,9,155,88,170,164,258,1156,1898,4,9368,520,0,2,2,2,50170,20293,3932,27186,0
230,5220,1482,859,1002,125,135,219,1607,16,219,134,251,235,385,1766,3032,9,27804,1544,1,2,2,2,50180,20294,3932,27187,0
112,2476,1043,504,840,53,9,147,1096,9,180,112,198,189,310,1377,2344,4,11604,644,0,2,0,5,50180,20296,3932,27188,0
112,2476,383,288,292,26,6,62,409,11,65,38,67,76,105,429,656,5,3719,206,0,2,0,5,50180,20297,3932,27189,0
214,4608,182,127,129,0,0,53,182,5,39,21,42,44,63,217,343,2,926,51,0,2,7,7,50180,20297,3933,27190,0
214,4608,1165,710,800,67,119,181,1232,18,243,153,282,261,435,2000,3492,10,36473,2026,1,2,7,7,50190,20297,3934,27191,0
102,2083,773,419,590,28,0,166,801,10,204,113,217,214,330,1598,2554,5,13587,754,0,2,9,9,50190,20297,3935,27192,0
102,2083,421,273,302,44,34,57,465,17,81,59,107,98,166,583,1098,11,12329,684,0,2,9,9,50190,20297,3936,27193,0
167,5122,1660,832,1314,41,38,274,1701,20,312,209,395,332,604,2671,5058,12,64042,3557,1,2,1,1,50190,20299,3937,27195,0
167,5122,1057,646,719,113,100,145,1170,18,215,134,248,233,382,1740,3004,10,31186,1732,1,2,1,1,50200,20300,3938,27196,0
86,1808,477,336,357,30,23,73,507,16,194,134,250,210,384,1538,2962,10,30538,1696,0,2,4,4,50210,20301,3938,27197,0
351,7048,1457,730,1242,11,6,188,1468,10,292,166,329,302,495,2424,4078,5,22973,1276,1,2,6,6,50210,20303,3938,27198,0
351,7048,74,35,59,1,0,14,75,3,14,7,14,17,21,58,85,1,128,7,0,2,6,6,50210,20304,3938,27199,0
351,7048,245,125,200,5,7,34,250,7,30,17,34,37,51,166,265,3,1053,58,0,2,6,6,50220,20305,3938,27200,0
229,5199,4293,999,3693,19,54,507,4312,9,155,88,170,164,258,1156,1898,4,9368,520,0,2,5,5,50220,20307,3938,27201,0
229,5199,1482,859,1002,125,135,219,1607,16,219,134,251,235,385,1766,3032,9,27804,1544,1,2,5,5,50230,20308,3938,27202,0
184,4257,77,34,69,0,0,8,77,3,24,16,29,27,45,114,213,1,387,21,0,2,2,2,50230,20308,3938,27203,0
184,4257,712,438,573,51,9,84,763,14,102,71,128,116,199,733,1364,8,11988,666,0,2,2,2,50240,20309,3938,27204,0
96,1835,1020,354,843,12,15,144,1032,8,134,77,144,142,221,970,1580,4,6792,377,0,2,2,2,50240,20309,3938,27205,0
212,5103,722,423,573,19,0,135,741,12,172,101,199,184,300,1320,2257,6,15668,870,0,2,14,14,50240,20311,3938,27207,0
212,5103,1508,847,911,44,250,301,1552,14,148,88,169,162,257,1120,1886,7,15077,837,0,2,14,14,50240,20312,3939,27208,0
256,6158,72,33,56,0,4,12,72,1,1,1,1,2,2,0,2,0,1,0,0,2,7,7,50240,20312,3939,27209,0
256,6158,1454,835,1044,76,110,219,1530,17,275,158,296,292,454,2297,3718,9,34017,1889,1,2,7,7,50250,20313,3939,27210,0
75,1461,757,253,292,73,244,162,830,13,61,38,67,74,105,409,651,7,4654,258,0,2,1,1,50250,20314,3939,27211,0
113,2492,1043,504,840,53,9,147,1096,9,180,112,198,189,310,1377,2344,4,11604,644,0,2,1,1,50250,20316,3939,27212,0
113,2492,383,288,292,26,6,62,409,11,65,38,67,76,105,429,656,5,3719,206,0,2,1,1,50250,20317,3939,27213,0
102,1930,1178,367,1042,6,15,115,1184,9,94,51,95,103,146,644,976,4,4439,246,0,2,3,3,50250,20317,3939,27214,0
102,1930,177,108,140,8,0,27,185,6,30,16,32,36,48,162,248,3,794,44,0,2,3,3,50250,20319,3939,27215,0
193,3994,1943,715,1694,26,18,214,1969,12,185,120,237,197,357,1436,2721,7,20915,1161,0,2,12,12,50250,20321,3939,27216,0
193,3994,1168,838,957,57,25,144,1225,19,348,224,416,367,640,3018,5452,11,61921,3440,1,2,12,12,50260,20323,3939,27217,0
62,1240,1098,241,925,5,10,155,1103,7,46,25,49,53,74,273,423,3,1580,87,0,2,5,5,50270,20325,3939,27218,0
62,1240,282,202,222,14,2,44,296,8,42,24,43,50,67,250,378,4,1548,86,0,2,5,5,50270,20326,3939,27219,0
149,6984,1392,870,1177,35,17,170,1427,14,494,280,531,508,811,4473,7289,7,54850,3047,2,2,6,6,50270,20329,3940,27220,0
87,2923,773,419,590,28,0,166,801,10,204,113,217,214,330,1598,2554,5,13587,754,0,2,4,4,50270,20329,3941,27221,0
98,4450,1338,495,1086,10,64,173,1348,11,122,82,157,133,239,883,1686,7,11934,663,0,2,4,4,50270,20331,3941,27222,0
162,7089,139,89,101,2,0,35,141,7,54,34,62,61,96,330,569,4,2287,127,0,2,201,201,50270,20331,3941,27223,0
162,7089,7,5,5,0,0,2,7,1,2,1,2,3,3,2,4,0,2,0,0,2,201,201,50270,20331,3941,27224,0
32,948,465,148,393,5,8,60,470,4,31,20,31,35,51,161,261,2,523,29,0,2,4,4,50270,20332,3941,27225,0
32,948,16,12,9,0,0,6,16,1,2,1,2,3,3,2,4,0,2,0,0,2,4,4,50270,20332,3941,27226,0
132,5719,1782,648,1425,9,47,279,1791,8,171,97,189,179,286,1292,2140,4,9462,525,0,2,3,3,50270,20333,3942,27227,0
109,4106,1450,624,1228,12,26,181,1462,14,306,186,354,320,540,2580,4493,8,36391,2021,1,2,6,6,50270,20335,3943,27228,0
155,4372,1660,832,1314,41,38,274,1701,20,312,209,395,332,604,2671,5058,12,64042,3557,1,2,2,2,50270,20337,3944,27230,0
73,3850,1296,573,1062,40,33,157,1336,8,201,118,231,209,349,1561,2689,4,12365,686,0,2,3,3,50270,20337,3944,27231,0
79,4191,1457,730,1242,11,6,188,1468,10,292,166,329,302,495,2424,4078,5,22973,1276,1,2,35,35,50270,20339,3944,27232,0
39,2355,652,304,544,16,6,88,668,6,89,51,101,95,152,591,998,3,3399,188,0,2,14,14,50270,20340,3944,27233,0
75,3288,1020,354,843,12,15,144,1032,8,134,77,144,142,221,970,1580,4,6792,377,0,2,14,14,50270,20340,3944,27234,0
21,661,424,94,331,4,0,89,428,1,5,5,5,6,10,11,25,0,12,0,0,2,35,35,50270,20341,3944,27235,0
36,1978,384,251,317,7,8,52,391,11,70,44,84,81,128,467,811,6,5355,297,0,2,18,18,50270,20341,3944,27236,0
36,1591,386,256,301,16,9,68,402,4,59,35,69,63,104,355,621,2,1453,80,0,2,2,2,50270,20341,3944,27237,0
75,2972,1043,504,840,53,9,147,1096,9,180,112,198,189,310,1377,2344,4,11604,644,0,2,4,4,50270,20343,3944,27238,0
14,529,295,56,236,0,4,54,295,2,9,5,10,11,15,30,51,1,57,3,0,2,4,4,50270,20345,3944,27239,0
26,1029,373,158,315,8,0,51,381,5,76,44,79,81,123,486,779,2,2026,112,0,2,14,14,50270,20345,3944,27240,0
71,3006,1178,367,1042,6,15,115,1184,9,94,51,95,103,146,644,976,4,4439,246,0,2,3,3,50270,20345,3944,27241,0
76,3899,1943,715,1694,26,18,214,1969,12,185,120,237,197,357,1436,2721,7,20915,1161,0,2,4,4,50270,20347,3944,27242,0
48,1795,1098,241,925,5,10,155,1103,7,46,25,49,53,74,273,423,3,1580,87,0,2,11,11,50280,20349,3944,27243,0
17,604,601,196,481,2,23,85,603,8,63,36,72,71,108,400,664,4,3036,168,0,2,2,0,50280,20349,3944,27244,0
214,4592,182,127,129,0,0,53,182,5,39,21,42,44,63,217,343,2,926,51,0,2,7,7,50280,20349,3945,27245,0
214,4592,1165,710,800,67,119,181,1232,18,243,153,282,261,435,2000,3492,10,36473,2026,1,2,7,7,50290,20349,3946,27246,0
101,2069,773,419,590,28,0,166,801,10,204,113,217,214,330,1598,2554,5,13587,754,0,2,9,9,50290,20349,3947,27247,0
101,2069,421,273,302,44,34,57,465,17,81,59,107,98,166,583,1098,11,12329,684,0,2,9,9,50290,20349,3948,27248,0
166,5068,1660,832,1314,41,38,274,1701,20,312,209,395,332,604,2671,5058,12,64042,3557,1,2,1,1,50290,20351,3949,27250,0
166,5068,1057,646,719,113,100,145,1170,18,215,134,248,233,382,1740,3004,10,31186,1732,1,2,1,1,50300,20352,3950,27251,0
86,1804,477,336,357,30,23,73,507,16,194,134,250,210,384,1538,2962,10,30538,1696,0,2,4,4,50310,20353,3950,27252,0
346,6927,1457,730,1242,11,6,188,1468,10,292,166,329,302,495,2424,4078,5,22973,1276,1,2,6,6,50310,20355,3950,27253,0
346,6927,74,35,59,1,0,14,75,3,14,7,14,17,21,58,85,1,128,7,0,2,6,6,50310,20356,3950,27254,0
346,6927,245,125,200,5,7,34,250,7,30,17,34,37,51,166,265,3,1053,58,0,2,6,6,50320,20357,3950,27255,0
231,5221,4293,999,3693,19,54,507,4312,9,155,88,170,164,258,1156,1898,4,9368,520,0,2,5,5,50320,20359,3950,27256,0
231,5221,1482,859,1002,125,135,219,1607,16,219,134,251,235,385,1766,3032,9,27804,1544,1,2,5,5,50330,20360,3950,27257,0
181,4189,77,34,69,0,0,8,77,3,24,16,29,27,45,114,213,1,387,21,0,2,1,1,50330,20360,3950,27258,0
181,4189,712,438,573,51,9,84,763,14,102,71,128,116,199,733,1364,8,11988,666,0,2,1,1,50340,20361,3950,27259,0
99,2020,1020,354,843,12,15,144,1032,8,134,77,144,142,221,970,1580,4,6792,377,0,2,2,2,50340,20361,3950,27260,0
210,5003,722,423,573,19,0,135,741,12,172,101,199,184,300,1320,2257,6,15668,870,0,2,14,14,50340,20363,3950,27262,0
210,5003,1508,847,911,44,250,301,1552,14,148,88,169,162,257,1120,1886,7,15077,837,0,2,14,14,50340,20364,3951,27263,0
257,6066,72,33,56,0,4,12,72,1,1,1,1,2,2,0,2,0,1,0,0,2,7,7,50340,20364,3951,27264,0
257,6066,1454,835,1044,76,110,219,1530,17,275,158,296,292,454,2297,3718,9,34017,1889,1,2,7,7,50350,20365,3951,27265,0
73,1425,757,253,292,73,244,162,830,13,61,38,67,74,105,409,651,7,4654,258,0,2,1,1,50350,20366,3951,27266,0
113,2488,1043,504,840,53,9,147,1096,9,180,112,198,189,310,1377,2344,4,11604,644,0,2,1,1,50350,20368,3951,27267,0
113,2488,383,288,292,26,6,62,409,11,65,38,67,76,105,429,656,5,3719,206,0,2,1,1,50350,20369,3951,27268,0
108,2066,1178,367,1042,6,15,115,1184,9,94,51,95,103,146,644,976,4,4439,246,0,2,3,3,50350,20369,3951,27269,0
108,2066,177,108,140,8,0,27,185,6,30,16,32,36,48,162,248,3,794,44,0,2,3,3,50350,20371,3951,27270,0
195,4029,1943,715,1694,26,18,214,1969,12,185,120,237,197,357,1436,2721,7,20915,1161,0,2,12,12,50350,20373,3951,27271,0
195,4029,1168,838,957,57,25,144,1225,19,348,224,416,367,640,3018,5452,11,61921,3440,1,2,12,12,50360,20375,3951,27272,0
62,1222,1098,241,925,5,10,155,1103,7,46,25,49,53,74,273,423,3,1580,87,0,2,5,5,50370,20377,3951,27273,0
62,1222,282,202,222,14,2,44,296,8,42,24,43,50,67,250,378,4,1548,86,0,2,5,5,50370,20378,3951,27274,0
147,6933,1392,870,1177,35,17,170,1427,14,494,280,531,508,811,4473,7289,7,54850,3047,2,2,6,6,50370,20381,3952,27275,0
87,2905,773,419,590,28,0,166,801,10,204,113,217,214,330,1598,2554,5,13587,754,0,2,4,4,50370,20381,3953,27276,0
97,4424,1338,495,1086,10,64,173,1348,11,122,82,157,133,239,883,1686,7,11934,663,0,2,4,4,50370,20383,3953,27277,0
161,7062,139,89,101,2,0,35,141,7,54,34,62,61,96,330,569,4,2287,127,0,2,201,201,50370,20383,3953,27278,0
161,7062,7,5,5,0,0,2,7,1,2,1,2,3,3,2,4,0,2,0,0,2,201,201,50370,20383,3953,27279,0
32,948,465,148,393,5,8,60,470,4,31,20,31,35,51,161,261,2,523,29,0,2,4,4,50370,20384,3953,27280,0
32,948,16,12,9,0,0,6,16,1,2,1,2,3,3,2,4,0,2,0,0,2,4,4,50370,20384,3953,27281,0
132,5724,1782,648,1425,9,47,279,1791,8,171,97,189,179,286,1292,2140,4,9462,525,0,2,3,3,50370,20385,3954,27282,0
109,4106,1450,624,1228,12,26,181,1462,14,306,186,354,320,540,2580,4493,8,36391,2021,1,2,6,6,50370,20387,3955,27283,0
155,4372,1660,832,1314,41,38,274,1701,20,312,209,395,332,604,2671,5058,12,64042,3557,1,2,2,2,50370,20389,3956,27285,0
73,3834,1296,573,1062,40,33,157,1336,8,201,118,231,209,349,1561,2689,4,12365,686,0,2,3,3,50370,20389,3956,27286,0
80,4250,1457,730,1242,11,6,188,1468,10,292,166,329,302,495,2424,4078,5,22973,1276,1,2,35,35,50370,20391,3956,27287,0
39,2355,652,304,544,16,6,88,668,6,89,51,101,95,152,591,998,3,3399,188,0,2,14,14,50370,20392,3956,27288,0
75,3288,1020,354,843,12,15,144,1032,8,134,77,144,142,221,970,1580,4,6792,377,0,2,14,14,50370,20392,3956,27289,0
21,661,424,94,331,4,0,89,428,1,5,5,5,6,10,11,25,0,12,0,0,2,35,35,50370,20393,3956,27290,0
33,1914,384,251,317,7,8,52,391,11,70,44,84,81,128,467,811,6,5355,297,0,2,18,18,50370,20393,3956,27291,0
39,1774,386,256,301,16,9,68,402,4,59,35,69,63,104,355,621,2,1453,80,0,2,2,2,50370,20393,3956,27292,0
75,2972,1043,504,840,53,9,147,1096,9,180,112,198,189,310,1377,2344,4,11604,644,0,2,4,4,50370,20395,3956,27293,0
14,529,295,56,236,0,4,54,295,2,9,5,10,11,15,30,51,1,57,3,0,2,4,4,50370,20397,3956,27294,0
26,1029,373,158,315,8,0,51,381,5,76,44,79,81,123,486,779,2,2026,112,0,2,14,14,50370,20397,3956,27295,0
74,3124,1178,367,1042,6,15,115,1184,9,94,51,95,103,146,644,976,4,4439,246,0,2,3,3,50370,20397,3956,27296,0
76,3893,1943,715,1694,26,18,214,1969,12,185,120,237,197,357,1436,2721,7,20915,1161,0,2,4,4,50370,20399,3956,27297,0
48,1750,1098,241,925,5,10,155,1103,7,46,25,49,53,74,273,423,3,1580,87,0,2,11,11,50380,20401,3956,27298,0
18,646,601,196,481,2,23,85,603,8,63,36,72,71,108,400,664,4,3036,168,0,2,2,0,50380,20401,3956,27299,0
230,5220,4293,999,3693,19,54,507,4312,9,155,88,170,164,258,1156,1898,4,9368,520,0,2,2,2,50380,20403,3956,27300,0
230,5220,1482,859,1002,125,135,219,1607,16,219,134,251,235,385,1766,3032,9,27804,1544,1,2,2,2,50390,20404,3956,27301,0
112,2476,1043,504,840,53,9,147,1096,9,180,112,198,189,310,1377,2344,4,11604,644,0,2,0,5,50390,20406,3956,27302,0
112,2476,383,288,292,26,6,62,409,11,65,38,67,76,105,429,656,5,3719,206,0,2,0,5,50390,20407,3956,27303,0
230,5208,4293,999,3693,19,54,507,4312,9,155,88,170,164,258,1156,1898,4,9368,520,0,2,3,1,50390,20409,3956,27304,0
230,5208,1482,859,1002,125,135,219,1607,16,219,134,251,235,385,1766,3032,9,27804,1544,1,2,3,1,50400,20410,3956,27305,0
230,5208,4293,999,3693,19,54,507,4312,9,155,88,170,164,258,1156,1898,4,9368,520,0,2,3,1,50400,20412,3956,27306,0
230,5208,1482,859,1002,125,135,219,1607,16,219,134,251,235,385,1766,3032,9,27804,1544,1,2,3,1,50410,20413,3956,27307,0
214,4592,182,127,129,0,0,53,182,5,39,21,42,44,63,217,343,2,926,51,0,2,7,7,50410,20413,3957,27308,0
214,4592,1165,710,800,67,119,181,1232,18,243,153,282,261,435,2000,3492,10,36473,2026,1,2,7,7,50420,20413,3958,27309,0
101,2069,773,419,590,28,0,166,801,10,204,113,217,214,330,1598,2554,5,13587,754,0,2,9,9,50420,20413,3959,27310,0
101,2069,421,273,302,44,34,57,465,17,81,59,107,98,166,583,1098,11,12329,684,0,2,9,9,50420,20413,3960,27311,0
166,5068,1660,832,1314,41,38,274,1701,20,312,209,395,332,604,2671,5058,12,64042,3557,1,2,1,1,50420,20415,3961,27313,0
166,5068,1057,646,719,113,100,145,1170,18,215,134,248,233,382,1740,3004,10,31186,1732,1,2,1,1,50430,20416,3962,27314,0
86,1804,477,336,357,30,23,73,507,16,194,134,250,210,384,1538,2962,10,30538,1696,0,2,4,4,50440,20417,3962,27315,0
346,6927,1457,730,1242,11,6,188,1468,10,292,166,329,302,495,2424,4078,5,22973,1276,1,2,6,6,50440,20419,3962,27316,0
346,6927,74,35,59,1,0,14,75,3,14,7,14,17,21,58,85,1,128,7,0,2,6,6,50440,20420,3962,27317,0
346,6927,245,125,200,5,7,34,250,7,30,17,34,37,51,166,265,3,1053,58,0,2,6,6,50450,20421,3962,27318,0
230,5220,4293,999,3693,19,54,507,4312,9,155,88,170,164,258,1156,1898,4,9368,520,0,2,5,5,50450,20423,3962,27319,0
230,5220,1482,859,1002,125,135,219,1607,16,219,134,251,235,385,1766,3032,9,27804,1544,1,2,5,5,50460,20424,3962,27320,0
181,4189,77,34,69,0,0,8,77,3,24,16,29,27,45,114,213,1,387,21,0,2,1,1,50460,20424,3962,27321,0
181,4189,712,438,573,51,9,84,763,14,102,71,128,116,199,733,1364,8,11988,666,0,2,1,1,50470,20425,3962,27322,0
99,2020,1020,354,843,12,15,144,1032,8,134,77,144,142,221,970,1580,4,6792,377,0,2,2,2,50470,20425,3962,27323,0
210,5003,722,423,573,19,0,135,741,12,172,101,199,184,300,1320,2257,6,15668,870,0,2,14,14,50470,20427,3962,27325,0
210,5003,1508,847,911,44,250,301,1552,14,148,88,169,162,257,1120,1886,7,15077,837,0,2,14,14,50470,20428,3963,27326,0
257,6066,72,33,56,0,4,12,72,1,1,1,1,2,2,0,2,0,1,0,0,2,7,7,50470,20428,3963,27327,0
257,6066,1454,835,1044,76,110,219,1530,17,275,158,296,292,454,2297,3718,9,34017,1889,1,2,7,7,50480,20429,3963,27328,0
73,1425,757,253,292,73,244,162,830,13,61,38,67,74,105,409,651,7,4654,258,0,2,1,1,50480,20430,3963,27329,0
113,2488,1043,504,840,53,9,147,1096,9,180,112,198,189,310,1377,2344,4,11604,644,0,2,1,1,50480,20432,3963,27330,0
113,2488,383,288,292,26,6,62,409,11,65,38,67,76,105,429,656,5,3719,206,0,2,1,1,50480,20433,3963,27331,0
108,2066,1178,367,1042,6,15,115,1184,9,94,51,95,103,146,644,976,4,4439,246,0,2,3,3,50480,20433,3963,27332,0
108,2066,177,108,140,8,0,27,185,6,30,16,32,36,48,162,248,3,794,44,0,2,3,3,50480,20435,3963,27333,0
195,4029,1943,715,1694,26,18,214,1969,12,185,120,237,197,357,1436,2721,7,20915,1161,0,2,12,12,50480,20437,3963,27334,0
195,4029,1168,838,957,57,25,144,1225,19,348,224,416,367,640,3018,5452,11,61921,3440,1,2,12,12,50490,20439,3963,27335,0
62,1222,1098,241,925,5,10,155,1103,7,46,25,49,53,74,273,423,3,1580,87,0,2,5,5,50500,20441,3963,27336,0
62,1222,282,202,222,14,2,44,296,8,42,24,43,50,67,250,378,4,1548,86,0,2,5,5,50500,20442,3963,27337,0
147,6933,1392,870,1177,35,17,170,1427,14,494,280,531,508,811,4473,7289,7,54850,3047,2,2,6,6,50500,20445,3964,27338,0
87,2905,773,419,590,28,0,166,801,10,204,113,217,214,330,1598,2554,5,13587,754,0,2,4,4,50500,20445,3965,27339,0
97,4424,1338,495,1086,10,64,173,1348,11,122,82,157,133,239,883,1686,7,11934,663,0,2,4,4,50500,20447,3965,27340,0
161,7062,139,89,101,2,0,35,141,7,54,34,62,61,96,330,569,4,2287,127,0,2,201,201,50500,20447,3965,27341,0
161,7062,7,5,5,0,0,2,7,1,2,1,2,3,3,2,4,0,2,0,0,2,201,201,50500,20447,3965,27342,0
32,948,465,148,393,5,8,60,470,4,31,20,31,35,51,161,261,2,523,29,0,2,4,4,50500,20448,3965,27343,0
32,948,16,12,9,0,0,6,16,1,2,1,2,3,3,2,4,0,2,0,0,2,4,4,50500,20448,3965,27344,0
132,5724,1782,648,1425,9,47,279,1791,8,171,97,189,179,286,1292,2140,4,9462,525,0,2,3,3,50500,20449,3966,27345,0
109,4106,1450,624,1228,12,26,181,1462,14,306,186,354,320,540,2580,4493,8,36391,2021,1,2,6,6,50500,20451,3967,27346,0
155,4372,1660,832,1314,41,38,274,1701,20,312,209,395,332,604,2671,5058,12,64042,3557,1,2,2,2,50500,20453,3968,27348,0
73,3834,1296,573,1062,40,33,157,1336,8,201,118,231,209,349,1561,2689,4,12365,686,0,2,3,3,50500,20453,3968,27349,0
80,4250,1457,730,1242,11,6,188,1468,10,292,166,329,302,495,2424,4078,5,22973,1276,1,2,35,35,50500,20455,3968,27350,0
39,2355,652,304,544,16,6,88,668,6,89,51,101,95,152,591,998,3,3399,188,0,2,14,14,50500,20456,3968,27351,0
75,3288,1020,354,843,12,15,144,1032,8,134,77,144,142,221,970,1580,4,6792,377,0,2,14,14,50500,20456,3968,27352,0
21,661,424,94,331,4,0,89,428,1,5,5,5,6,10,11,25,0,12,0,0,2,35,35,50500,20457,3968,27353,0
33,1914,384,251,317,7,8,52,391,11,70,44,84,81,128,467,811,6,5355,297,0,2,18,18,50500,20457,3968,27354,0
39,1774,386,256,301,16,9,68,402,4,59,35,69,63,104,355,621,2,1453,80,0,2,2,2,50500,20457,3968,27355,0
75,2972,1043,504,840,53,9,147,1096,9,180,112,198,189,310,1377,2344,4,11604,644,0,2,4,4,50500,20459,3968,27356,0
14,529,295,56,236,0,4,54,295,2,9,5,10,11,15,30,51,1,57,3,0,2,4,4,50500,20461,3968,27357,0
26,1029,373,158,315,8,0,51,381,5,76,44,79,81,123,486,779,2,2026,112,0,2,14,14,50500,20461,3968,27358,0
74,3124,1178,367,1042,6,15,115,1184,9,94,51,95,103,146,644,976,4,4439,246,0,2,3,3,50500,20461,3968,27359,0
76,3893,1943,715,1694,26,18,214,1969,12,185,120,237,197,357,1436,2721,7,20915,1161,0,2,4,4,50500,20463,3968,27360,0
48,1750,1098,241,925,5,10,155,1103,7,46,25,49,53,74,273,423,3,1580,87,0,2,11,11,50510,20465,3968,27361,0
18,646,601,196,481,2,23,85,603,8,63,36,72,71,108,400,664,4,3036,168,0,2,2,0,50510,20465,3968,27362,0
11,235,19,8,11,5,0,4,24,2,5,3,6,7,9,13,25,1,30,1,0,2,3,2,50510,20465,3968,27363,0
11,235,102,59,69,5,3,24,107,6,22,15,28,28,43,113,206,3,789,43,0,2,3,2,50510,20465,3968,27364,0
11,235,106,40,36,3,49,17,109,8,17,13,23,25,36,93,167,5,904,50,0,2,3,2,50510,20465,3968,27365,0
214,4608,182,127,129,0,0,53,182,5,39,21,42,44,63,217,343,2,926,51,0,2,7,7,50510,20465,3969,27366,0
214,4608,1165,710,800,67,119,181,1232,18,243,153,282,261,435,2000,3492,10,36473,2026,1,2,7,7,50520,20465,3970,27367,0
102,2083,773,419,590,28,0,166,801,10,204,113,217,214,330,1598,2554,5,13587,754,0,2,9,9,50520,20465,3971,27368,0
102,2083,421,273,302,44,34,57,465,17,81,59,107,98,166,583,1098,11,12329,684,0,2,9,9,50520,20465,3972,27369,0
167,5122,1660,832,1314,41,38,274,1701,20,312,209,395,332,604,2671,5058,12,64042,3557,1,2,12,6,50520,20467,3973,27371,0
167,5122,1057,646,719,113,100,145,1170,18,215,134,248,233,382,1740,3004,10,31186,1732,1,2,12,6,50530,20468,3974,27372,0
86,1808,477,336,357,30,23,73,507,16,194,134,250,210,384,1538,2962,10,30538,1696,0,2,4,4,50540,20469,3974,27373,0
351,7048,1457,730,1242,11,6,188,1468,10,292,166,329,302,495,2424,4078,5,22973,1276,1,2,6,6,50540,20471,3974,27374,0
351,7048,74,35,59,1,0,14,75,3,14,7,14,17,21,58,85,1,128,7,0,2,6,6,50540,20472,3974,27375,0
351,7048,245,125,200,5,7,34,250,7,30,17,34,37,51,166,265,3,1053,58,0,2,6,6,50550,20473,3974,27376,0
60,1682,1455,414,1257,16,76,112,1471,5,41,23,46,46,69,231,381,2,1069,59,0,2,1,1,50550,20474,3974,27377,0
60,1682,669,365,481,22,61,110,691,15,103,63,122,118,185,747,1273,8,11311,628,0,2,1,1,50560,20474,3975,27378,0
230,5208,4293,999,3693,19,54,507,4312,9,155,88,170,164,258,1156,1898,4,9368,520,0,2,25,16,50560,20476,3975,27379,0
230,5208,1482,859,1002,125,135,219,1607,16,219,134,251,235,385,1766,3032,9,27804,1544,1,2,25,16,50570,20477,3975,27380,0
83,2365,1523,757,1297,19,12,193,1542,12,193,117,230,205,347,1508,2664,7,19053,1058,0,2,2,1,50580,20479,3975,27381,0
83,2365,701,378,504,33,58,109,734,13,110,68,126,123,194,794,1346,7,10027,557,0,2,2,1,50580,20480,3976,27382,0
188,4306,77,34,69,0,0,8,77,3,24,16,29,27,45,114,213,1,387,21,0,2,8,6,50580,20480,3976,27383,0
188,4306,712,438,573,51,9,84,763,14,102,71,128,116,199,733,1364,8,11988,666,0,2,8,6,50590,20481,3976,27384,0
96,1835,1020,354,843,12,15,144,1032,8,134,77,144,142,221,970,1580,4,6792,377,0,2,8,6,50590,20481,3976,27385,0
4,90,53,23,39,0,0,13,53,2,8,4,8,10,12,26,39,1,39,2,0,0,37,0,50590,20481,3976,27386,0
4,90,515,298,307,33,80,99,548,12,63,44,77,75,121,419,753,7,5527,307,0,0,37,0,50600,20481,3976,27387,0
212,5103,722,423,573,19,0,135,741,12,172,101,199,184,300,1320,2257,6,15668,870,0,2,14,14,50600,20483,3976,27389,0
212,5103,1508,847,911,44,250,301,1552,14,148,88,169,162,257,1120,1886,7,15077,837,0,2,14,14,50600,20484,3977,27390,0
256,6158,72,33,56,0,4,12,72,1,1,1,1,2,2,0,2,0,1,0,0,2,25,27,50600,20484,3977,27391,0
256,6158,1454,835,1044,76,110,219,1530,17,275,158,296,292,454,2297,3718,9,34017,1889,1,2,25,27,50610,20485,3977,27392,0
75,1461,757,253,292,73,244,162,830,13,61,38,67,74,105,409,651,7,4654,258,0,2,3,2,50610,20486,3977,27393,0
112,2476,1043,504,840,53,9,147,1096,9,180,112,198,189,310,1377,2344,4,11604,644,0,2,1,6,50610,20488,3977,27394,0
112,2476,383,288,292,26,6,62,409,11,65,38,67,76,105,429,656,5,3719,206,0,2,1,6,50610,20489,3977,27395,0
102,1930,1178,367,1042,6,15,115,1184,9,94,51,95,103,146,644,976,4,4439,246,0,2,3,3,50610,20489,3977,27396,0
102,1930,177,108,140,8,0,27,185,6,30,16,32,36,48,162,248,3,794,44,0,2,3,3,50610,20491,3977,27397,0
193,3994,1943,715,1694,26,18,214,1969,12,185,120,237,197,357,1436,2721,7,20915,1161,0,2,14,13,50610,20493,3977,27398,0
193,3994,1168,838,957,57,25,144,1225,19,348,224,416,367,640,3018,5452,11,61921,3440,1,2,14,13,50620,20495,3977,27399,0
62,1240,1098,241,925,5,10,155,1103,7,46,25,49,53,74,273,423,3,1580,87,0,2,5,5,50630,20497,3977,27400,0
62,1240,282,202,222,14,2,44,296,8,42,24,43,50,67,250,378,4,1548,86,0,2,5,5,50630,20498,3977,27401,0
149,6984,1392,870,1177,35,17,170,1427,14,494,280,531,508,811,4473,7289,7,54850,3047,2,2,6,6,50630,20501,3978,27402,0
87,2923,773,419,590,28,0,166,801,10,204,113,217,214,330,1598,2554,5,13587,754,0,2,4,4,50630,20501,3979,27403,0
98,4450,1338,495,1086,10,64,173,1348,11,122,82,157,133,239,883,1686,7,11934,663,0,2,4,4,50630,20503,3979,27404,0
162,7089,139,89,101,2,0,35,141,7,54,34,62,61,96,330,569,4,2287,127,0,2,201,201,50630,20503,3979,27405,0
162,7089,7,5,5,0,0,2,7,1,2,1,2,3,3,2,4,0,2,0,0,2,201,201,50630,20503,3979,27406,0
32,948,465,148,393,5,8,60,470,4,31,20,31,35,51,161,261,2,523,29,0,2,4,4,50630,20504,3979,27407,0
32,948,16,12,9,0,0,6,16,1,2,1,2,3,3,2,4,0,2,0,0,2,4,4,50630,20504,3979,27408,0
132,5719,1782,648,1425,9,47,279,1791,8,171,97,189,179,286,1292,2140,4,9462,525,0,2,3,3,50630,20505,3980,27409,0
6,329,180,34,164,0,0,16,180,1,12,6,12,13,18,43,66,0,33,1,0,2,21,0,50630,20505,3980,27410,0
23,607,102,59,69,5,3,24,107,6,22,15,28,28,43,113,206,3,789,43,0,2,1,1,50630,20505,3980,27411,0
109,4106,1450,624,1228,12,26,181,1462,14,306,186,354,320,540,2580,4493,8,36391,2021,1,2,6,6,50630,20507,3981,27412,0
155,4372,1660,832,1314,41,38,274,1701,20,312,209,395,332,604,2671,5058,12,64042,3557,1,2,37,15,50630,20509,3982,27414,0
73,3850,1296,573,1062,40,33,157,1336,8,201,118,231,209,349,1561,2689,4,12365,686,0,2,29,3,50630,20509,3982,27415,0
79,4191,1457,730,1242,11,6,188,1468,10,292,166,329,302,495,2424,4078,5,22973,1276,1,2,35,35,50630,20511,3982,27416,0
39,2355,652,304,544,16,6,88,668,6,89,51,101,95,152,591,998,3,3399,188,0,2,14,14,50630,20512,3982,27417,0
66,3053,1455,414,1257,16,76,112,1471,5,41,23,46,46,69,231,381,2,1069,59,0,2,28,2,50630,20513,3982,27418,0
75,3288,1020,354,843,12,15,144,1032,8,134,77,144,142,221,970,1580,4,6792,377,0,2,49,14,50630,20513,3982,27419,0
1,106,53,23,39,0,0,13,53,2,8,4,8,10,12,26,39,1,39,2,0,0,18,0,50630,20513,3982,27420,0
21,661,424,94,331,4,0,89,428,1,5,5,5,6,10,11,25,0,12,0,0,2,35,35,50630,20514,3982,27421,0
36,1978,384,251,317,7,8,52,391,11,70,44,84,81,128,467,811,6,5355,297,0,2,18,18,50630,20514,3982,27422,0
36,1591,386,256,301,16,9,68,402,4,59,35,69,63,104,355,621,2,1453,80,0,2,2,2,50630,20514,3982,27423,0
75,2972,1043,504,840,53,9,147,1096,9,180,112,198,189,310,1377,2344,4,11604,644,0,2,4,4,50630,20516,3982,27424,0
14,529,295,56,236,0,4,54,295,2,9,5,10,11,15,30,51,1,57,3,0,2,4,4,50630,20518,3982,27425,0
26,1029,373,158,315,8,0,51,381,5,76,44,79,81,123,486,779,2,2026,112,0,2,14,14,50630,20518,3982,27426,0
71,3006,1178,367,1042,6,15,115,1184,9,94,51,95,103,146,644,976,4,4439,246,0,2,3,3,50630,20518,3982,27427,0
76,3899,1943,715,1694,26,18,214,1969,12,185,120,237,197,357,1436,2721,7,20915,1161,0,2,4,4,50630,20520,3982,27428,0
48,1795,1098,241,925,5,10,155,1103,7,46,25,49,53,74,273,423,3,1580,87,0,2,11,11,50640,20522,3982,27429,0
17,604,601,196,481,2,23,85,603,8,63,36,72,71,108,400,664,4,3036,168,0,2,2,0,50640,20522,3982,27430,0
188,4306,77,34,69,0,0,8,77,3,24,16,29,27,45,114,213,1,387,21,0,2,8,0,50640,20522,3982,27431,0
188,4306,712,438,573,51,9,84,763,14,102,71,128,116,199,733,1364,8,11988,666,0,2,8,0,50650,20523,3982,27432,0
81,3472,1289,550,1043,56,32,155,1345,10,167,93,185,177,278,1266,2075,5,11498,638,0,2,3,1,50650,20525,3983,27433,0
11,235,19,8,11,5,0,4,24,2,5,3,6,7,9,13,25,1,30,1,0,2,9,5,50660,20529,3984,27441,0
11,235,102,59,69,5,3,24,107,6,22,15,28,28,43,113,206,3,789,43,0,2,9,5,50660,20529,3984,27442,0
11,235,106,40,36,3,49,17,109,8,17,13,23,25,36,93,167,5,904,50,0,2,9,5,50660,20529,3984,27443,0
214,4608,182,127,129,0,0,53,182,5,39,21,42,44,63,217,343,2,926,51,0,2,94,47,50670,20533,3986,27451,0
214,4608,1165,710,800,67,119,181,1232,18,243,153,282,261,435,2000,3492,10,36473,2026,1,2,94,47,50680,20533,3987,27452,0
102,2083,773,419,590,28,0,166,801,10,204,113,217,214,330,1598,2554,5,13587,754,0,2,34,32,50680,20533,3988,27453,0
102,2083,421,273,302,44,34,57,465,17,81,59,107,98,166,583,1098,11,12329,684,0,2,34,32,50680,20533,3989,27454,0
27,542,2,2,2,0,0,0,2,0,0,0,0,0,0,0,0,0,0,0,0,2,5,21,50680,20533,3989,27454,0
27,542,99,48,90,1,3,5,100,0,0,0,0,0,0,0,0,0,0,0,0,2,5,21,50680,20534,3989,27455,0
27,542,8,5,5,2,0,1,10,0,0,0,0,0,0,0,0,0,0,0,0,2,5,21,50680,20534,3989,27456,0
27,542,1217,716,841,84,126,174,1301,14,185,118,215,199,333,1446,2542,8,20687,1149,0,2,5,21,50690,20536,3989,27457,0
27,542,160,89,115,0,13,31,160,7,15,11,17,22,28,78,124,3,495,27,0,2,5,21,50690,20536,3989,27458,0
27,542,10,10,9,9,0,0,19,0,0,0,0,0,0,0,0,0,0,0,0,2,5,21,50690,20536,3990,27459,0
27,542,173,84,99,8,29,36,181,5,12,7,13,17,20,54,81,2,221,12,0,2,5,21,50690,20537,3990,27460,0
27,542,3,1,1,3,0,0,6,0,0,0,0,0,0,0,0,0,0,0,0,2,5,21,50690,20537,3990,27461,0
167,5122,1660,832,1314,41,38,274,1701,20,312,209,395,332,604,2671,5058,12,64042,3557,1,2,34,27,50690,20539,3991,27463,0
167,5122,1057,646,719,113,100,145,1170,18,215,134,248,233,382,1740,3004,10,31186,1732,1,2,34,27,50700,20540,3992,27464,0
17,349,95,58,50,9,16,20,104,12,33,24,45,45,69,209,378,8,3100,172,0,0,102,0,50700,20540,3992,27465,0
86,1808,477,336,357,30,23,73,507,16,194,134,250,210,384,1538,2962,10,30538,1696,0,2,24,17,50710,20541,3992,27466,0
59,1352,996,429,845,24,10,117,1020,7,76,50,88,83,138,494,879,4,3565,198,0,2,43,28,50710,20543,3992,27467,0
59,1352,456,277,329,12,42,72,468,13,85,50,97,98,147,592,972,7,7212,400,0,2,43,28,50710,20543,3992,27468,0
133,2659,1513,682,1277,25,13,200,1538,11,199,116,219,210,335,1557,2584,6,15641,868,0,2,94,8,50710,20545,3992,27469,0
133,2659,819,519,539,24,98,155,843,15,96,57,106,111,163,690,1107,8,9171,509,0,2,94,8,50720,20547,3992,27470,0
58,1234,207,111,150,11,0,50,218,5,26,19,36,31,55,133,272,3,943,52,0,2,118,22,50720,20547,3992,27471,0
58,1234,410,198,237,31,55,97,441,11,63,38,72,74,110,414,683,6,4293,238,0,2,118,22,50730,20548,3993,27472,0
351,7048,1457,730,1242,11,6,188,1468,10,292,166,329,302,495,2424,4078,5,22973,1276,1,2,197,123,50730,20550,3993,27473,0
351,7048,74,35,59,1,0,14,75,3,14,7,14,17,21,58,85,1,128,7,0,2,197,123,50730,20551,3993,27474,0
351,7048,245,125,200,5,7,34,250,7,30,17,34,37,51,166,265,3,1053,58,0,2,197,123,50740,20552,3993,27475,0
21,662,339,213,244,17,9,65,356,10,42,26,48,52,74,259,421,5,2410,133,0,2,20,21,50750,20552,3993,27476,0
60,1682,1455,414,1257,16,76,112,1471,5,41,23,46,46,69,231,381,2,1069,59,0,2,52,21,50750,20553,3993,27478,0
60,1682,669,365,481,22,61,110,691,15,103,63,122,118,185,747,1273,8,11311,628,0,2,52,21,50760,20553,3994,27479,0
230,5217,4293,999,3693,19,54,507,4312,9,155,88,170,164,258,1156,1898,4,9368,520,0,2,119,113,50760,20555,3994,27480,0
230,5217,1482,859,1002,125,135,219,1607,16,219,134,251,235,385,1766,3032,9,27804,1544,1,2,119,113,50770,20556,3994,27481,0
6,136,44,22,19,0,19,6,44,2,10,6,12,12,18,35,64,1,77,4,0,2,2,4,50770,20556,3994,27482,0
27,954,74,35,59,1,0,14,75,3,14,7,14,17,21,58,85,1,128,7,0,2,61,21,50770,20557,3994,27483,0
27,954,245,125,200,5,7,34,250,7,30,17,34,37,51,166,265,3,1053,58,0,2,61,21,50780,20558,3994,27484,0
50,586,647,139,84,35,284,233,682,0,0,0,0,0,0,0,0,0,0,0,0,2,133,24,50780,20558,3994,27485,0
83,2365,1523,757,1297,19,12,193,1542,12,193,117,230,205,347,1508,2664,7,19053,1058,0,2,57,17,50790,20560,3994,27486,0
83,2365,701,378,504,33,58,109,734,13,110,68,126,123,194,794,1346,7,10027,557,0,2,57,17,50790,20561,3995,27487,0
188,4306,77,34,69,0,0,8,77,3,24,16,29,27,45,114,213,1,387,21,0,2,159,86,50790,20561,3995,27488,0
188,4306,712,438,573,51,9,84,763,14,102,71,128,116,199,733,1364,8,11988,666,0,2,159,86,50800,20562,3995,27489,0
96,1835,1020,354,843,12,15,144,1032,8,134,77,144,142,221,970,1580,4,6792,377,0,2,214,77,50800,20562,3995,27490,0
46,955,447,308,343,6,5,95,453,7,96,59,111,103,170,651,1136,4,4600,255,0,2,11,10,50800,20565,3995,27491,0
46,955,322,174,179,16,74,51,338,10,41,26,46,51,72,252,408,5,2291,127,0,2,11,10,50800,20568,3996,27492,0
4,90,53,23,39,0,0,13,53,2,8,4,8,10,12,26,39,1,39,2,0,0,37,0,50800,20568,3996,27493,0
4,90,515,298,307,33,80,99,548,12,63,44,77,75,121,419,753,7,5527,307,0,0,37,0,50810,20568,3996,27494,0
23,388,424,94,331,4,0,89,428,1,5,5,5,6,10,11,25,0,12,0,0,2,13,11,50810,20569,3996,27495,0
23,388,38,23,23,6,0,8,44,3,11,7,11,14,18,42,68,1,102,5,0,2,13,11,50810,20569,3996,27496,0
18,466,205,80,86,16,53,53,221,7,18,10,19,25,29,94,134,3,497,27,0,0,140,0,50820,20569,3997,27497,0
17,518,184,100,137,2,15,30,186,6,38,20,39,44,59,214,322,3,991,55,0,2,6,4,50820,20570,3997,27498,0
17,518,103,65,74,8,5,16,111,7,17,9,17,24,26,89,119,3,417,23,0,2,6,4,50820,20571,3997,27499,0
212,5103,722,423,573,19,0,135,741,12,172,101,199,184,300,1320,2257,6,15668,870,0,2,106,78,50820,20573,3997,27501,0
212,5103,1508,847,911,44,250,301,1552,14,148,88,169,162,257,1120,1886,7,15077,837,0,2,106,78,50820,20574,3998,27502,0
256,6158,72,33,56,0,4,12,72,1,1,1,1,2,2,0,2,0,1,0,0,2,201,606,50820,20574,3998,27503,0
256,6158,1454,835,1044,76,110,219,1530,17,275,158,296,292,454,2297,3718,9,34017,1889,1,2,201,606,50830,20575,3998,27504,0
75,1461,757,253,292,73,244,162,830,13,61,38,67,74,105,409,651,7,4654,258,0,0,626,0,50830,20576,3998,27505,0
40,837,386,256,301,16,9,68,402,4,59,35,69,63,104,355,621,2,1453,80,0,2,56,77,50830,20576,3998,27506,0
40,837,264,131,164,11,41,46,275,6,38,22,40,44,62,214,338,3,1068,59,0,2,56,77,50840,20576,3999,27507,0
30,649,215,129,180,6,0,29,221,8,65,43,72,73,115,415,711,4,3153,175,0,2,12,6,50840,20576,3999,27508,0
30,649,97,69,77,3,3,16,100,6,22,13,23,28,36,113,173,3,542,30,0,2,12,6,50840,20577,3999,27509,0
112,2476,1043,504,840,53,9,147,1096,9,180,112,198,189,310,1377,2344,4,11604,644,0,2,77,147,50840,20579,3999,27510,0
112,2476,383,288,292,26,6,62,409,11,65,38,67,76,105,429,656,5,3719,206,0,2,77,147,50840,20580,3999,27511,0
20,408,294,64,250,0,0,43,294,1,20,10,20,21,30,86,131,0,65,3,0,2,2,0,50840,20580,3999,27512,0
20,408,78,46,62,3,0,14,81,3,8,4,8,11,12,28,41,1,62,3,0,2,2,0,50840,20581,3999,27513,0
5,118,110,30,77,3,13,16,113,4,21,15,30,25,45,100,208,2,597,33,0,2,2,0,50840,20581,3999,27514,0
5,118,28,15,21,1,0,6,29,0,0,0,0,0,0,0,0,0,0,0,0,2,2,0,50840,20581,3999,27515,0
102,1930,1178,367,1042,6,15,115,1184,9,94,51,95,103,146,644,976,4,4439,246,0,2,72,75,50840,20581,3999,27516,0
102,1930,177,108,140,8,0,27,185,6,30,16,32,36,48,162,248,3,794,44,0,2,72,75,50840,20583,3999,27517,0
193,3994,1943,715,1694,26,18,214,1969,12,185,120,237,197,357,1436,2721,7,20915,1161,0,2,125,68,50840,20585,3999,27518,0
193,3994,1168,838,957,57,25,144,1225,19,348,224,416,367,640,3018,5452,11,61921,3440,1,2,125,68,50850,20587,3999,27519,0
16,477,442,244,305,14,16,103,456,11,68,45,75,79,120,452,756,6,4588,254,0,2,5,3,50850,20589,3999,27520,0
16,477,182,102,99,11,40,35,193,3,11,6,11,14,17,42,64,1,97,5,0,2,5,3,50850,20590,3999,27521,0
62,1240,1098,241,925,5,10,155,1103,7,46,25,49,53,74,273,423,3,1580,87,0,2,51,29,50860,20592,3999,27522,0
62,1240,282,202,222,14,2,44,296,8,42,24,43,50,67,250,378,4,1548,86,0,2,51,29,50860,20593,3999,27523,0
21,433,601,196,481,2,23,85,603,8,63,36,72,71,108,400,664,4,3036,168,0,0,94,0,50860,20593,3999,27524,0
21,433,156,79,106,5,16,28,161,5,14,8,15,19,23,64,97,2,261,14,0,0,94,0,50860,20593,3999,27525,0
1,300,382,65,130,157,2,92,539,4,10,5,10,14,15,41,57,2,114,6,0,2,1,1,50860,20594,4000,27526,0
60,1092,282,196,195,3,0,86,285,8,130,71,141,138,212,936,1507,4,6538,363,0,2,6,6,50860,20594,4001,27527,0
7,114,44,19,17,0,16,11,44,3,14,7,14,17,21,58,85,1,128,7,0,2,1,1,50860,20594,4001,27528,0
3,66,127,75,83,2,11,30,129,4,14,7,14,18,21,61,87,2,175,9,0,2,1,1,50860,20594,4001,27529,0
3,66,652,304,544,16,6,88,668,6,89,51,101,95,152,591,998,3,3399,188,0,2,1,1,50860,20595,4001,27530,0
3,66,2,2,2,0,0,0,2,0,0,0,0,0,0,0,0,0,0,0,0,2,1,1,50860,20595,4001,27530,0
3,66,8,5,5,0,0,3,8,0,0,0,0,0,0,0,0,0,0,0,0,2,1,1,50860,20595,4001,27531,0
3,66,2,2,2,0,0,0,2,0,0,0,0,0,0,0,0,0,0,0,0,2,1,1,50860,20595,4001,27531,0
3,66,14,8,8,0,0,6,14,0,0,0,0,0,0,0,0,0,0,0,0,2,1,1,50860,20595,4001,27532,0
3,66,6,4,4,0,0,2,6,0,0,0,0,0,0,0,0,0,0,0,0,2,1,1,50860,20595,4001,27533,0
3,66,6,4,4,0,0,2,6,1,2,1,2,3,3,2,4,0,2,0,0,2,1,1,50860,20595,4001,27534,0
3,66,6,4,4,0,0,2,6,0,0,0,0,0,0,0,0,0,0,0,0,2,1,1,50860,20595,4001,27535,0
3,66,7,5,5,0,0,2,7,0,0,0,0,0,0,0,0,0,0,0,0,2,1,1,50860,20595,4001,27536,0
3,66,6,4,4,0,0,2,6,0,0,0,0,0,0,0,0,0,0,0,0,2,1,1,50860,20595,4001,27537,0
3,66,10,6,6,0,0,4,10,0,0,0,0,0,0,0,0,0,0,0,0,2,1,1,50860,20595,4001,27538,0
3,66,1,1,1,0,0,0,1,0,0,0,0,0,0,0,0,0,0,0,0,2,1,1,50860,20595,4001,27538,0
3,66,14,10,10,0,0,4,14,1,1,1,1,2,2,0,2,0,1,0,0,2,1,1,50860,20595,4001,27539,0
3,66,46,26,30,3,0,12,49,3,6,3,6,9,9,20,28,1,42,2,0,2,1,1,50870,20595,4001,27540,0
7,301,72,33,56,0,4,12,72,1,1,1,1,2,2,0,2,0,1,0,0,2,1,1,50870,20595,4001,27541,0
3,26,14,7,7,2,0,5,16,0,0,0,0,0,0,0,0,0,0,0,0,2,1,1,50870,20595,4001,27541,0
11,410,42,7,35,4,0,5,46,1,2,1,2,3,3,2,4,0,2,0,0,2,23,25,50870,20595,4001,27542,0
11,410,11,6,10,0,0,1,11,2,4,2,4,6,6,10,15,1,15,0,0,2,23,25,50870,20595,4001,27543,0
81,3472,1289,550,1043,56,32,155,1345,10,167,93,185,177,278,1266,2075,5,11498,638,0,2,93,26,50880,20601,4003,27551,0
36,1085,182,127,129,0,0,53,182,5,39,21,42,44,63,217,343,2,926,51,0,2,44,9,50880,20601,4004,27552,0
149,6984,1392,870,1177,35,17,170,1427,14,494,280,531,508,811,4473,7289,7,54850,3047,2,2,169,58,50880,20604,4005,27553,0
87,2923,773,419,590,28,0,166,801,10,204,113,217,214,330,1598,2554,5,13587,754,0,2,73,48,50880,20604,4006,27554,0
7,281,75,38,59,1,3,12,76,2,4,2,4,6,6,10,15,1,15,0,0,2,11,3,50880,20604,4006,27555,0
2,26,6,4,4,0,0,2,6,1,4,2,4,5,6,8,13,0,6,0,0,2,2,1,50880,20604,4006,27557,0
54,3424,520,294,400,33,13,81,553,10,261,204,367,271,571,2128,4614,7,32445,1802,1,2,190,104,50880,20605,4006,27559,0
98,4450,1338,495,1086,10,64,173,1348,11,122,82,157,133,239,883,1686,7,11934,663,0,2,145,50,50880,20607,4006,27560,0
164,7175,139,89,101,2,0,35,141,7,54,34,62,61,96,330,569,4,2287,127,0,2,437,294,50880,20607,4006,27561,0
164,7175,7,5,5,0,0,2,7,1,2,1,2,3,3,2,4,0,2,0,0,2,437,294,50880,20607,4006,27562,0
32,948,465,148,393,5,8,60,470,4,31,20,31,35,51,161,261,2,523,29,0,2,18,16,50880,20608,4006,27563,0
32,948,16,12,9,0,0,6,16,1,2,1,2,3,3,2,4,0,2,0,0,2,18,16,50880,20608,4006,27564,0
132,5719,1782,648,1425,9,47,279,1791,8,171,97,189,179,286,1292,2140,4,9462,525,0,2,253,113,50880,20609,4007,27565,0
20,541,256,139,192,9,7,47,265,4,23,12,24,27,36,112,171,2,357,19,0,2,16,10,50880,20610,4007,27566,0
6,329,180,34,164,0,0,16,180,1,12,6,12,13,18,43,66,0,33,1,0,2,21,0,50880,20610,4007,27567,0
23,607,102,59,69,5,3,24,107,6,22,15,28,28,43,113,206,3,789,43,0,2,21,14,50880,20610,4007,27568,0
109,4106,1450,624,1228,12,26,181,1462,14,306,186,354,320,540,2580,4493,8,36391,2021,1,2,204,68,50880,20612,4008,27569,0
155,4372,1660,832,1314,41,38,274,1701,20,312,209,395,332,604,2671,5058,12,64042,3557,1,2,115,42,50880,20614,4009,27571,0
120,4833,1513,682,1277,25,13,200,1538,11,199,116,219,210,335,1557,2584,6,15641,868,0,2,91,38,50880,20616,4009,27572,0
73,3850,1296,573,1062,40,33,157,1336,8,201,118,231,209,349,1561,2689,4,12365,686,0,2,144,39,50880,20616,4009,27573,0
14,341,207,111,150,11,0,50,218,5,26,19,36,31,55,133,272,3,943,52,0,0,101,0,50880,20616,4009,27574,0
79,4191,1457,730,1242,11,6,188,1468,10,292,166,329,302,495,2424,4078,5,22973,1276,1,2,135,64,50880,20618,4009,27575,0
39,2355,652,304,544,16,6,88,668,6,89,51,101,95,152,591,998,3,3399,188,0,2,79,51,50880,20619,4009,27576,0
66,3053,1455,414,1257,16,76,112,1471,5,41,23,46,46,69,231,381,2,1069,59,0,2,132,21,50880,20620,4009,27577,0
2,75,7,6,5,0,0,2,7,1,1,1,2,2,3,0,3,1,3,0,0,2,1,0,50880,20620,4009,27578,0
8,273,74,35,59,1,0,14,75,3,14,7,14,17,21,58,85,1,128,7,0,2,10,2,50880,20621,4009,27579,0
90,4427,1523,757,1297,19,12,193,1542,12,193,117,230,205,347,1508,2664,7,19053,1058,0,2,106,8,50890,20623,4009,27580,0
75,3288,1020,354,843,12,15,144,1032,8,134,77,144,142,221,970,1580,4,6792,377,0,2,174,53,50890,20623,4009,27581,0
37,1624,447,308,343,6,5,95,453,7,96,59,111,103,170,651,1136,4,4600,255,0,2,11,15,50890,20626,4009,27582,0
1,106,53,23,39,0,0,13,53,2,8,4,8,10,12,26,39,1,39,2,0,0,18,0,50890,20626,4009,27583,0
21,661,424,94,331,4,0,89,428,1,5,5,5,6,10,11,25,0,12,0,0,2,51,40,50890,20627,4009,27584,0
40,2367,334,251,279,10,4,40,344,5,127,74,143,132,217,899,1528,2,4303,239,0,2,27,23,50890,20628,4009,27585,0
12,492,184,100,137,2,15,30,186,6,38,20,39,44,59,214,322,3,991,55,0,2,7,7,50890,20629,4009,27586,0
35,1623,1293,570,1093,25,15,163,1318,10,195,123,241,205,364,1516,2795,6,17273,959,0,2,73,24,50900,20631,4009,27587,0
36,1978,384,251,317,7,8,52,391,11,70,44,84,81,128,467,811,6,5355,297,0,2,38,35,50900,20631,4009,27588,0
15,638,722,423,573,19,0,135,741,12,172,101,199,184,300,1320,2257,6,15668,870,0,2,15,3,50900,20633,4009,27590,0
36,1591,386,256,301,16,9,68,402,4,59,35,69,63,104,355,621,2,1453,80,0,2,109,50,50900,20633,4009,27591,0
16,1209,215,129,180,6,0,29,221,8,65,43,72,73,115,415,711,4,3153,175,0,2,12,11,50900,20633,4009,27592,0
75,2972,1043,504,840,53,9,147,1096,9,180,112,198,189,310,1377,2344,4,11604,644,0,2,111,58,50900,20635,4009,27593,0
14,529,295,56,236,0,4,54,295,2,9,5,10,11,15,30,51,1,57,3,0,2,30,16,50900,20637,4009,27594,0
26,1029,373,158,315,8,0,51,381,5,76,44,79,81,123,486,779,2,2026,112,0,2,38,29,50900,20637,4009,27595,0
71,3006,1178,367,1042,6,15,115,1184,9,94,51,95,103,146,644,976,4,4439,246,0,2,57,22,50900,20637,4009,27596,0
76,3899,1943,715,1694,26,18,214,1969,12,185,120,237,197,357,1436,2721,7,20915,1161,0,2,105,46,50900,20639,4009,27597,0
14,825,442,244,305,14,16,103,456,11,68,45,75,79,120,452,756,6,4588,254,0,2,8,2,50900,20641,4009,27598,0
48,1795,1098,241,925,5,10,155,1103,7,46,25,49,53,74,273,423,3,1580,87,0,2,94,75,50910,20643,4009,27599,0
17,604,601,196,481,2,23,85,603,8,63,36,72,71,108,400,664,4,3036,168,0,0,225,0,50910,20643,4009,27600,0
230,5248,4293,999,3693,19,54,507,4312,9,155,88,170,164,258,1156,1898,4,9368,520,0,2,10,9,50910,20645,4009,27601,0
230,5248,1482,859,1002,125,135,219,1607,16,219,134,251,235,385,1766,3032,9,27804,1544,1,2,10,9,50920,20646,4009,27602,0
50,588,647,139,84,35,284,233,682,0,0,0,0,0,0,0,0,0,0,0,0,2,1,1,50920,20646,4009,27603,0
163,7149,139,89,101,2,0,35,141,7,54,34,62,61,96,330,569,4,2287,127,0,2,30,38,50920,20646,4009,27604,0
163,7149,7,5,5,0,0,2,7,1,2,1,2,3,3,2,4,0,2,0,0,2,30,38,50920,20646,4009,27605,0
11,235,19,8,11,5,0,4,24,2,5,3,6,7,9,13,25,1,30,1,0,2,0,3,50920,20646,4009,27606,0
11,235,102,59,69,5,3,24,107,6,22,15,28,28,43,113,206,3,789,43,0,2,0,3,50920,20646,4009,27607,0
11,235,106,40,36,3,49,17,109,8,17,13,23,25,36,93,167,5,904,50,0,2,0,3,50920,20646,4009,27608,0
214,4592,182,127,129,0,0,53,182,5,39,21,42,44,63,217,343,2,926,51,0,2,1,3,50920,20646,4010,27609,0
214,4592,1165,710,800,67,119,181,1232,18,243,153,282,261,435,2000,3492,10,36473,2026,1,2,1,3,50930,20646,4011,27610,0
101,2069,773,419,590,28,0,166,801,10,204,113,217,214,330,1598,2554,5,13587,754,0,2,2,3,50930,20646,4012,27611,0
101,2069,421,273,302,44,34,57,465,17,81,59,107,98,166,583,1098,11,12329,684,0,2,2,3,50930,20646,4013,27612,0
26,524,2,2,2,0,0,0,2,0,0,0,0,0,0,0,0,0,0,0,0,2,4,6,50930,20646,4013,27612,0
26,524,99,48,90,1,3,5,100,0,0,0,0,0,0,0,0,0,0,0,0,2,4,6,50930,20647,4013,27613,0
26,524,8,5,5,2,0,1,10,0,0,0,0,0,0,0,0,0,0,0,0,2,4,6,50930,20647,4013,27614,0
26,524,1217,716,841,84,126,174,1301,14,185,118,215,199,333,1446,2542,8,20687,1149,0,2,4,6,50940,20649,4013,27615,0
26,524,160,89,115,0,13,31,160,7,15,11,17,22,28,78,124,3,495,27,0,2,4,6,50940,20649,4013,27616,0
26,524,10,10,9,9,0,0,19,0,0,0,0,0,0,0,0,0,0,0,0,2,4,6,50940,20649,4014,27617,0
26,524,173,84,99,8,29,36,181,5,12,7,13,17,20,54,81,2,221,12,0,2,4,6,50940,20650,4014,27618,0
26,524,3,1,1,3,0,0,6,0,0,0,0,0,0,0,0,0,0,0,0,2,4,6,50940,20650,4014,27619,0
166,5068,1660,832,1314,41,38,274,1701,20,312,209,395,332,604,2671,5058,12,64042,3557,1,2,12,16,50940,20652,4015,27621,0
166,5068,1057,646,719,113,100,145,1170,18,215,134,248,233,382,1740,3004,10,31186,1732,1,2,12,16,50950,20653,4016,27622,0
17,345,95,58,50,9,16,20,104,12,33,24,45,45,69,209,378,8,3100,172,0,2,3,3,50950,20653,4016,27623,0
86,1804,477,336,357,30,23,73,507,16,194,134,250,210,384,1538,2962,10,30538,1696,0,2,4,3,50960,20654,4016,27624,0
135,2748,1513,682,1277,25,13,200,1538,11,199,116,219,210,335,1557,2584,6,15641,868,0,2,101,54,50960,20656,4016,27625,0
135,2748,819,519,539,24,98,155,843,15,96,57,106,111,163,690,1107,8,9171,509,0,2,101,54,50970,20658,4016,27626,0
52,1082,207,111,150,11,0,50,218,5,26,19,36,31,55,133,272,3,943,52,0,2,68,72,50970,20658,4016,27627,0
52,1082,410,198,237,31,55,97,441,11,63,38,72,74,110,414,683,6,4293,238,0,2,68,72,50980,20659,4017,27628,0
346,6927,1457,730,1242,11,6,188,1468,10,292,166,329,302,495,2424,4078,5,22973,1276,1,2,18,36,50980,20661,4017,27629,0
346,6927,74,35,59,1,0,14,75,3,14,7,14,17,21,58,85,1,128,7,0,2,18,36,50980,20662,4017,27630,0
346,6927,245,125,200,5,7,34,250,7,30,17,34,37,51,166,265,3,1053,58,0,2,18,36,50990,20663,4017,27631,0
21,662,339,213,244,17,9,65,356,10,42,26,48,52,74,259,421,5,2410,133,0,2,3,3,51000,20663,4017,27632,0
64,1726,1455,414,1257,16,76,112,1471,5,41,23,46,46,69,231,381,2,1069,59,0,2,8,1,51000,20664,4017,27634,0
64,1726,669,365,481,22,61,110,691,15,103,63,122,118,185,747,1273,8,11311,628,0,2,8,1,51010,20664,4018,27635,0
231,5269,4293,999,3693,19,54,507,4312,9,155,88,170,164,258,1156,1898,4,9368,520,0,2,20,15,51010,20666,4018,27636,0
231,5269,1482,859,1002,125,135,219,1607,16,219,134,251,235,385,1766,3032,9,27804,1544,1,2,20,15,51020,20667,4018,27637,0
27,954,74,35,59,1,0,14,75,3,14,7,14,17,21,58,85,1,128,7,0,2,1,1,51020,20668,4018,27638,0
27,954,245,125,200,5,7,34,250,7,30,17,34,37,51,166,265,3,1053,58,0,2,1,1,51030,20669,4018,27639,0
50,586,647,139,84,35,284,233,682,0,0,0,0,0,0,0,0,0,0,0,0,2,1,1,51030,20669,4018,27640,0
45,1297,773,422,505,30,103,129,803,14,77,46,83,91,129,535,839,7,6334,351,0,0,337,0,51040,20670,4019,27641,0
185,4238,77,34,69,0,0,8,77,3,24,16,29,27,45,114,213,1,387,21,0,2,15,29,51040,20670,4019,27642,0
185,4238,712,438,573,51,9,84,763,14,102,71,128,116,199,733,1364,8,11988,666,0,2,15,29,51050,20671,4019,27643,0
99,2020,1020,354,843,12,15,144,1032,8,134,77,144,142,221,970,1580,4,6792,377,0,2,55,26,51050,20671,4019,27644,0
46,957,447,308,343,6,5,95,453,7,96,59,111,103,170,651,1136,4,4600,255,0,2,4,5,51050,20674,4019,27645,0
46,957,322,174,179,16,74,51,338,10,41,26,46,51,72,252,408,5,2291,127,0,2,4,5,51050,20677,4020,27646,0
23,382,424,94,331,4,0,89,428,1,5,5,5,6,10,11,25,0,12,0,0,2,1,2,51050,20678,4020,27647,0
23,382,38,23,23,6,0,8,44,3,11,7,11,14,18,42,68,1,102,5,0,2,1,2,51050,20678,4020,27648,0
20,509,205,80,86,16,53,53,221,7,18,10,19,25,29,94,134,3,497,27,0,2,9,2,51060,20678,4021,27649,0
17,518,184,100,137,2,15,30,186,6,38,20,39,44,59,214,322,3,991,55,0,2,5,5,51060,20679,4021,27650,0
17,518,103,65,74,8,5,16,111,7,17,9,17,24,26,89,119,3,417,23,0,2,5,5,51060,20680,4021,27651,0
210,5003,722,423,573,19,0,135,741,12,172,101,199,184,300,1320,2257,6,15668,870,0,2,19,40,51060,20682,4021,27653,0
210,5003,1508,847,911,44,250,301,1552,14,148,88,169,162,257,1120,1886,7,15077,837,0,2,19,40,51060,20683,4022,27654,0
257,6066,72,33,56,0,4,12,72,1,1,1,1,2,2,0,2,0,1,0,0,2,35,39,51060,20683,4022,27655,0
257,6066,1454,835,1044,76,110,219,1530,17,275,158,296,292,454,2297,3718,9,34017,1889,1,2,35,39,51070,20684,4022,27656,0
73,1425,757,253,292,73,244,162,830,13,61,38,67,74,105,409,651,7,4654,258,0,2,4,11,51070,20685,4022,27657,0
46,954,386,256,301,16,9,68,402,4,59,35,69,63,104,355,621,2,1453,80,0,2,36,5,51070,20685,4022,27658,0
46,954,264,131,164,11,41,46,275,6,38,22,40,44,62,214,338,3,1068,59,0,2,36,5,51080,20685,4023,27659,0
112,2472,1043,504,840,53,9,147,1096,9,180,112,198,189,310,1377,2344,4,11604,644,0,2,1,1,51080,20687,4023,27660,0
112,2472,383,288,292,26,6,62,409,11,65,38,67,76,105,429,656,5,3719,206,0,2,1,1,51080,20688,4023,27661,0
20,408,294,64,250,0,0,43,294,1,20,10,20,21,30,86,131,0,65,3,0,2,2,2,51080,20688,4023,27662,0
20,408,78,46,62,3,0,14,81,3,8,4,8,11,12,28,41,1,62,3,0,2,2,2,51080,20689,4023,27663,0
108,2066,1178,367,1042,6,15,115,1184,9,94,51,95,103,146,644,976,4,4439,246,0,2,75,50,51080,20689,4023,27664,0
108,2066,177,108,140,8,0,27,185,6,30,16,32,36,48,162,248,3,794,44,0,2,75,50,51080,20691,4023,27665,0
195,4029,1943,715,1694,26,18,214,1969,12,185,120,237,197,357,1436,2721,7,20915,1161,0,2,65,51,51080,20693,4023,27666,0
195,4029,1168,838,957,57,25,144,1225,19,348,224,416,367,640,3018,5452,11,61921,3440,1,2,65,51,51090,20695,4023,27667,0
62,1222,1098,241,925,5,10,155,1103,7,46,25,49,53,74,273,423,3,1580,87,0,2,1,3,51100,20697,4023,27668,0
62,1222,282,202,222,14,2,44,296,8,42,24,43,50,67,250,378,4,1548,86,0,2,1,3,51100,20698,4023,27669,0
21,436,601,196,481,2,23,85,603,8,63,36,72,71,108,400,664,4,3036,168,0,2,2,2,51110,20702,4024,27677,0
21,436,156,79,106,5,16,28,161,5,14,8,15,19,23,64,97,2,261,14,0,2,2,2,51110,20702,4024,27678,0
7,299,72,33,56,0,4,12,72,1,1,1,1,2,2,0,2,0,1,0,0,2,1,1,51110,20702,4024,27679,0
12,422,42,7,35,4,0,5,46,1,2,1,2,3,3,2,4,0,2,0,0,2,23,10,51110,20702,4024,27680,0
12,422,11,6,10,0,0,1,11,2,4,2,4,6,6,10,15,1,15,0,0,2,23,10,51110,20702,4024,27681,0
81,3472,1289,550,1043,56,32,155,1345,10,167,93,185,177,278,1266,2075,5,11498,638,0,2,1,1,51110,20704,4025,27682,0
147,6933,1392,870,1177,35,17,170,1427,14,494,280,531,508,811,4473,7289,7,54850,3047,2,2,2,9,51110,20707,4026,27683,0
87,2905,773,419,590,28,0,166,801,10,204,113,217,214,330,1598,2554,5,13587,754,0,2,0,2,51110,20707,4027,27684,0
7,353,139,89,101,2,0,35,141,7,54,34,62,61,96,330,569,4,2287,127,0,0,70,0,51110,20707,4027,27685,0
21,1023,1157,318,931,29,22,177,1186,6,104,63,125,110,188,712,1274,3,4596,255,0,0,398,0,51110,20707,4027,27686,0
52,3380,520,294,400,33,13,81,553,10,261,204,367,271,571,2128,4614,7,32445,1802,1,2,0,6,51110,20708,4027,27687,0
97,4424,1338,495,1086,10,64,173,1348,11,122,82,157,133,239,883,1686,7,11934,663,0,2,10,15,51110,20710,4027,27688,0
162,7122,139,89,101,2,0,35,141,7,54,34,62,61,96,330,569,4,2287,127,0,2,1,5,51110,20710,4027,27689,0
162,7122,7,5,5,0,0,2,7,1,2,1,2,3,3,2,4,0,2,0,0,2,1,5,51110,20710,4027,27690,0
132,5724,1782,648,1425,9,47,279,1791,8,171,97,189,179,286,1292,2140,4,9462,525,0,2,1,1,51110,20711,4028,27691,0
155,4372,1660,832,1314,41,38,274,1701,20,312,209,395,332,604,2671,5058,12,64042,3557,1,2,1,1,51110,20713,4029,27693,0
124,4990,1513,682,1277,25,13,200,1538,11,199,116,219,210,335,1557,2584,6,15641,868,0,2,72,32,51110,20715,4029,27694,0
73,3834,1296,573,1062,40,33,157,1336,8,201,118,231,209,349,1561,2689,4,12365,686,0,2,7,8,51110,20715,4029,27695,0
80,4250,1457,730,1242,11,6,188,1468,10,292,166,329,302,495,2424,4078,5,22973,1276,1,2,9,1,51110,20717,4029,27696,0
68,3131,1455,414,1257,16,76,112,1471,5,41,23,46,46,69,231,381,2,1069,59,0,2,28,0,51110,20718,4029,27697,0
38,2303,334,251,279,10,4,40,344,5,127,74,143,132,217,899,1528,2,4303,239,0,2,1,7,51110,20719,4029,27698,0
33,1914,384,251,317,7,8,52,391,11,70,44,84,81,128,467,811,6,5355,297,0,2,8,20,51110,20719,4029,27699,0
16,677,722,423,573,19,0,135,741,12,172,101,199,184,300,1320,2257,6,15668,870,0,2,11,0,51110,20721,4029,27701,0
39,1774,386,256,301,16,9,68,402,4,59,35,69,63,104,355,621,2,1453,80,0,2,24,0,51110,20721,4029,27702,0
75,2972,1043,504,840,53,9,147,1096,9,180,112,198,189,310,1377,2344,4,11604,644,0,2,7,5,51110,20723,4029,27703,0
74,3124,1178,367,1042,6,15,115,1184,9,94,51,95,103,146,644,976,4,4439,246,0,2,64,3,51110,20723,4029,27704,0
76,3893,1943,715,1694,26,18,214,1969,12,185,120,237,197,357,1436,2721,7,20915,1161,0,2,1,2,51110,20725,4029,27705,0
48,1750,1098,241,925,5,10,155,1103,7,46,25,49,53,74,273,423,3,1580,87,0,2,4,7,51120,20727,4029,27706,0
18,646,601,196,481,2,23,85,603,8,63,36,72,71,108,400,664,4,3036,168,0,2,21,1,51120,20727,4029,27707,0
231,5270,4293,999,3693,19,54,507,4312,9,155,88,170,164,258,1156,1898,4,9368,520,0,2,1,1,51120,20729,4029,27708,0
231,5270,1482,859,1002,125,135,219,1607,16,219,134,251,235,385,1766,3032,9,27804,1544,1,2,1,1,51130,20730,4029,27709,0
231,5276,4293,999,3693,19,54,507,4312,9,155,88,170,164,258,1156,1898,4,9368,520,0,2,1,0,51130,20732,4029,27710,0
231,5276,1482,859,1002,125,135,219,1607,16,219,134,251,235,385,1766,3032,9,27804,1544,1,2,1,0,51140,20733,4029,27711,0
231,5276,4293,999,3693,19,54,507,4312,9,155,88,170,164,258,1156,1898,4,9368,520,0,2,8,10,51140,20735,4029,27712,1
231,5276,1482,859,1002,125,135,219,1607,16,219,134,251,235,385,1766,3032,9,27804,1544,1,2,8,10,51150,20736,4029,27713,1
11,410,42,7,35,4,0,5,46,1,2,1,2,3,3,2,4,0,2,0,0,2,1,1,51150,20736,4029,27714,0
11,410,11,6,10,0,0,1,11,2,4,2,4,6,6,10,15,1,15,0,0,2,1,1,51150,20736,4029,27715,0
231,5276,4293,999,3693,19,54,507,4312,9,155,88,170,164,258,1156,1898,4,9368,520,0,2,22,18,51150,20738,4029,27716,0
231,5276,1482,859,1002,125,135,219,1607,16,219,134,251,235,385,1766,3032,9,27804,1544,1,2,22,18,51160,20739,4029,27717,0
50,586,647,139,84,35,284,233,682,0,0,0,0,0,0,0,0,0,0,0,0,2,1,1,51160,20739,4029,27718,0
185,4238,77,34,69,0,0,8,77,3,24,16,29,27,45,114,213,1,387,21,0,2,8,0,51160,20739,4029,27719,0
185,4238,712,438,573,51,9,84,763,14,102,71,128,116,199,733,1364,8,11988,666,0,2,8,0,51170,20740,4029,27720,0
112,2472,1043,504,840,53,9,147,1096,9,180,112,198,189,310,1377,2344,4,11604,644,0,2,0,5,51170,20742,4029,27721,0
112,2472,383,288,292,26,6,62,409,11,65,38,67,76,105,429,656,5,3719,206,0,2,0,5,51170,20743,4029,27722,0
81,3472,1289,550,1043,56,32,155,1345,10,167,93,185,177,278,1266,2075,5,11498,638,0,2,3,1,51170,20745,4030,27723,0
162,7122,139,89,101,2,0,35,141,7,54,34,62,61,96,330,569,4,2287,127,0,2,40,0,51170,20745,4030,27724,0
162,7122,7,5,5,0,0,2,7,1,2,1,2,3,3,2,4,0,2,0,0,2,40,0,51170,20745,4030,27725,0
11,410,42,7,35,4,0,5,46,1,2,1,2,3,3,2,4,0,2,0,0,2,1,1,51170,20745,4030,27726,0
11,410,11,6,10,0,0,1,11,2,4,2,4,6,6,10,15,1,15,0,0,2,1,1,51170,20745,4030,27727,0
12,422,42,7,35,4,0,5,46,1,2,1,2,3,3,2,4,0,2,0,0,2,1,1,51170,20745,4030,27728,0
12,422,11,6,10,0,0,1,11,2,4,2,4,6,6,10,15,1,15,0,0,2,1,1,51170,20745,4030,27729,0
138,2871,1513,682,1277,25,13,200,1538,11,199,116,219,210,335,1557,2584,6,15641,868,0,2,56,20,51170,20747,4030,27730,1
138,2871,819,519,539,24,98,155,843,15,96,57,106,111,163,690,1107,8,9171,509,0,2,56,20,51180,20749,4030,27731,1
126,5054,1513,682,1277,25,13,200,1538,11,199,116,219,210,335,1557,2584,6,15641,868,0,2,26,2,51180,20751,4030,27732,1
11,410,42,7,35,4,0,5,46,1,2,1,2,3,3,2,4,0,2,0,0,2,1,1,51180,20751,4030,27733,0
11,410,11,6,10,0,0,1,11,2,4,2,4,6,6,10,15,1,15,0,0,2,1,1,51180,20751,4030,27734,0
12,426,42,7,35,4,0,5,46,1,2,1,2,3,3,2,4,0,2,0,0,2,1,0,51180,20751,4030,27735,0
12,426,11,6,10,0,0,1,11,2,4,2,4,6,6,10,15,1,15,0,0,2,1,0,51180,20751,4030,27736,0
12,422,42,7,35,4,0,5,46,1,2,1,2,3,3,2,4,0,2,0,0,2,1,1,51180,20751,4030,27737,0
12,422,11,6,10,0,0,1,11,2,4,2,4,6,6,10,15,1,15,0,0,2,1,1,51180,20751,4030,27738,0
12,426,42,7,35,4,0,5,46,1,2,1,2,3,3,2,4,0,2,0,0,2,1,0,51180,20751,4030,27739,0
12,426,11,6,10,0,0,1,11,2,4,2,4,6,6,10,15,1,15,0,0,2,1,0,51180,20751,4030,27740,0
11,410,42,7,35,4,0,5,46,1,2,1,2,3,3,2,4,0,2,0,0,2,1,1,51180,20751,4030,27741,0
11,410,11,6,10,0,0,1,11,2,4,2,4,6,6,10,15,1,15,0,0,2,1,1,51180,20751,4030,27742,0
12,426,42,7,35,4,0,5,46,1,2,1,2,3,3,2,4,0,2,0,0,2,1,1,51180,20751,4030,27743,0
12,426,11,6,10,0,0,1,11,2,4,2,4,6,6,10,15,1,15,0,0,2,1,1,51180,20751,4030,27744,0
258,6089,72,33,56,0,4,12,72,1,1,1,1,2,2,0,2,0,1,0,0,2,9,3,51180,20751,4030,27746,0
258,6089,1454,835,1044,76,110,219,1530,17,275,158,296,292,454,2297,3718,9,34017,1889,1,2,9,3,51190,20752,4030,27747,0
8,329,75,38,59,1,3,12,76,2,4,2,4,6,6,10,15,1,15,0,0,2,17,0,51190,20752,4030,27748,0
12,426,42,7,35,4,0,5,46,1,2,1,2,3,3,2,4,0,2,0,0,2,1,1,51190,20752,4030,27749,0
12,426,11,6,10,0,0,1,11,2,4,2,4,6,6,10,15,1,15,0,0,2,1,1,51190,20752,4030,27750,0
258,6089,72,33,56,0,4,12,72,1,1,1,1,2,2,0,2,0,1,0,0,2,9,3,51190,20752,4030,27752,0
258,6089,1454,835,1044,76,110,219,1530,17,275,158,296,292,454,2297,3718,9,34017,1889,1,2,9,3,51200,20753,4030,27753,0
8,329,75,38,59,1,3,12,76,2,4,2,4,6,6,10,15,1,15,0,0,2,17,0,51200,20753,4030,27754,0
138,2871,1513,682,1277,25,13,200,1538,11,199,116,219,210,335,1557,2584,6,15641,868,0,2,56,20,51200,20755,4030,27755,0
138,2871,819,519,539,24,98,155,843,15,96,57,106,111,163,690,1107,8,9171,509,0,2,56,20,51210,20757,4030,27756,0
126,5054,1513,682,1277,25,13,200,1538,11,199,116,219,210,335,1557,2584,6,15641,868,0,2,26,2,51210,20759,4030,27757,0
141,2959,1513,682,1277,25,13,200,1538,11,199,116,219,210,335,1557,2584,6,15641,868,0,2,28,5,51210,20761,4030,27758,1
141,2959,819,519,539,24,98,155,843,15,96,57,106,111,163,690,1107,8,9171,509,0,2,28,5,51220,20763,4030,27759,1
128,5156,1513,682,1277,25,13,200,1538,11,199,116,219,210,335,1557,2584,6,15641,868,0,2,33,1,51220,20765,4030,27760,1
141,2959,1513,682,1277,25,13,200,1538,11,199,116,219,210,335,1557,2584,6,15641,868,0,2,28,5,51220,20767,4030,27761,0
141,2959,819,519,539,24,98,155,843,15,96,57,106,111,163,690,1107,8,9171,509,0,2,28,5,51230,20769,4030,27762,0
128,5156,1513,682,1277,25,13,200,1538,11,199,116,219,210,335,1557,2584,6,15641,868,0,2,33,1,51230,20771,4030,27763,0
12,426,42,7,35,4,0,5,46,1,2,1,2,3,3,2,4,0,2,0,0,2,1,1,51230,20771,4030,27764,0
12,426,11,6,10,0,0,1,11,2,4,2,4,6,6,10,15,1,15,0,0,2,1,1,51230,20771,4030,27765,0
204,4267,1943,715,1694,26,18,214,1969,12,185,120,237,197,357,1436,2721,7,20915,1161,0,2,49,7,51230,20773,4030,27766,1
204,4267,1168,838,957,57,25,144,1225,19,348,224,416,367,640,3018,5452,11,61921,3440,1,2,49,7,51240,20775,4030,27767,1
81,3472,1289,550,1043,56,32,155,1345,10,167,93,185,177,278,1266,2075,5,11498,638,0,2,5,5,51240,20777,4031,27768,1
162,7134,139,89,101,2,0,35,141,7,54,34,62,61,96,330,569,4,2287,127,0,2,8,0,51240,20777,4031,27769,1
162,7134,7,5,5,0,0,2,7,1,2,1,2,3,3,2,4,0,2,0,0,2,8,0,51240,20777,4031,27770,1
132,5730,1782,648,1425,9,47,279,1791,8,171,97,189,179,286,1292,2140,4,9462,525,0,2,9,5,51240,20778,4032,27771,1
109,4106,1450,624,1228,12,26,181,1462,14,306,186,354,320,540,2580,4493,8,36391,2021,1,2,2,2,51240,20780,4033,27772,1
128,5156,1513,682,1277,25,13,200,1538,11,199,116,219,210,335,1557,2584,6,15641,868,0,2,1,1,51240,20782,4033,27773,1
76,3893,1943,715,1694,26,18,214,1969,12,185,120,237,197,357,1436,2721,7,20915,1161,0,2,6,6,51240,20784,4033,27774,1
214,5107,722,423,573,19,0,135,741,12,172,101,199,184,300,1320,2257,6,15668,870,0,2,46,5,51240,20786,4033,27776,1
214,5107,1508,847,911,44,250,301,1552,14,148,88,169,162,257,1120,1886,7,15077,837,0,2,46,5,51240,20787,4034,27777,1
203,4282,1943,715,1694,26,18,214,1969,12,185,120,237,197,357,1436,2721,7,20915,1161,0,2,2,2,51240,20789,4034,27778,0
203,4282,1168,838,957,57,25,144,1225,19,348,224,416,367,640,3018,5452,11,61921,3440,1,2,2,2,51250,20791,4034,27779,0
204,4297,1943,715,1694,26,18,214,1969,12,185,120,237,197,357,1436,2721,7,20915,1161,0,2,5,2,51250,20793,4034,27780,0
204,4297,1168,838,957,57,25,144,1225,19,348,224,416,367,640,3018,5452,11,61921,3440,1,2,5,2,51260,20795,4034,27781,0
81,4076,1943,715,1694,26,18,214,1969,12,185,120,237,197,357,1436,2721,7,20915,1161,0,2,55,0,51260,20797,4034,27782,0
168,5128,1660,832,1314,41,38,274,1701,20,312,209,395,332,604,2671,5058,12,64042,3557,1,2,1,1,51260,20799,4035,27784,0
168,5128,1057,646,719,113,100,145,1170,18,215,134,248,233,382,1740,3004,10,31186,1732,1,2,1,1,51270,20800,4036,27785,0
110,4156,1450,624,1228,12,26,181,1462,14,306,186,354,320,540,2580,4493,8,36391,2021,1,2,18,0,51270,20802,4037,27786,0
204,4299,1943,715,1694,26,18,214,1969,12,185,120,237,197,357,1436,2721,7,20915,1161,0,2,1,1,51270,20804,4037,27787,0
204,4299,1168,838,957,57,25,144,1225,19,348,224,416,367,640,3018,5452,11,61921,3440,1,2,1,1,51280,20806,4037,27788,0
81,4076,1943,715,1694,26,18,214,1969,12,185,120,237,197,357,1436,2721,7,20915,1161,0,2,1,1,51280,20808,4037,27789,0
168,5128,1660,832,1314,41,38,274,1701,20,312,209,395,332,604,2671,5058,12,64042,3557,1,2,1,1,51280,20810,4038,27791,0
168,5128,1057,646,719,113,100,145,1170,18,215,134,248,233,382,1740,3004,10,31186,1732,1,2,1,1,51290,20811,4039,27792,0
110,4156,1450,624,1228,12,26,181,1462,14,306,186,354,320,540,2580,4493,8,36391,2021,1,2,18,0,51290,20813,4040,27793,0
97,1855,1020,354,843,12,15,144,1032,8,134,77,144,142,221,970,1580,4,6792,377,0,2,4,2,51290,20813,4040,27794,0
76,3351,1020,354,843,12,15,144,1032,8,134,77,144,142,221,970,1580,4,6792,377,0,2,17,0,51290,20813,4040,27795,0
97,1855,1020,354,843,12,15,144,1032,8,134,77,144,142,221,970,1580,4,6792,377,0,2,4,2,51290,20813,4040,27796,0
76,3351,1020,354,843,12,15,144,1032,8,134,77,144,142,221,970,1580,4,6792,377,0,2,17,0,51290,20813,4040,27797,0
214,5107,722,423,573,19,0,135,741,12,172,101,199,184,300,1320,2257,6,15668,870,0,2,2,2,51290,20815,4040,27799,1
214,5107,1508,847,911,44,250,301,1552,14,148,88,169,162,257,1120,1886,7,15077,837,0,2,2,2,51290,20816,4041,27800,1
81,4076,1943,715,1694,26,18,214,1969,12,185,120,237,197,357,1436,2721,7,20915,1161,0,2,4,4,51290,20818,4041,27801,0
214,5107,722,423,573,19,0,135,741,12,172,101,199,184,300,1320,2257,6,15668,870,0,2,46,5,51290,20820,4041,27803,0
214,5107,1508,847,911,44,250,301,1552,14,148,88,169,162,257,1120,1886,7,15077,837,0,2,46,5,51290,20821,4042,27804,0
204,4299,1943,715,1694,26,18,214,1969,12,185,120,237,197,357,1436,2721,7,20915,1161,0,2,54,9,51290,20823,4042,27805,0
204,4299,1168,838,957,57,25,144,1225,19,348,224,416,367,640,3018,5452,11,61921,3440,1,2,54,9,51300,20825,4042,27806,0
12,426,42,7,35,4,0,5,46,1,2,1,2,3,3,2,4,0,2,0,0,2,1,1,51300,20825,4042,27807,0
12,426,11,6,10,0,0,1,11,2,4,2,4,6,6,10,15,1,15,0,0,2,1,1,51300,20825,4042,27808,0
81,3472,1289,550,1043,56,32,155,1345,10,167,93,185,177,278,1266,2075,5,11498,638,0,2,5,5,51300,20827,4043,27809,0
162,7134,139,89,101,2,0,35,141,7,54,34,62,61,96,330,569,4,2287,127,0,2,8,0,51300,20827,4043,27810,0
162,7134,7,5,5,0,0,2,7,1,2,1,2,3,3,2,4,0,2,0,0,2,8,0,51300,20827,4043,27811,0
132,5730,1782,648,1425,9,47,279,1791,8,171,97,189,179,286,1292,2140,4,9462,525,0,2,9,5,51300,20828,4044,27812,0
109,4106,1450,624,1228,12,26,181,1462,14,306,186,354,320,540,2580,4493,8,36391,2021,1,2,2,2,51300,20830,4045,27813,0
128,5156,1513,682,1277,25,13,200,1538,11,199,116,219,210,335,1557,2584,6,15641,868,0,2,1,1,51300,20832,4045,27814,0
81,4076,1943,715,1694,26,18,214,1969,12,185,120,237,197,357,1436,2721,7,20915,1161,0,2,62,7,51300,20834,4045,27815,0
167,5074,1660,832,1314,41,38,274,1701,20,312,209,395,332,604,2671,5058,12,64042,3557,1,2,1,1,51300,20836,4046,27817,0
167,5074,1057,646,719,113,100,145,1170,18,215,134,248,233,382,1740,3004,10,31186,1732,1,2,1,1,51310,20837,4047,27818,0
100,2040,1020,354,843,12,15,144,1032,8,134,77,144,142,221,970,1580,4,6792,377,0,2,4,2,51310,20837,4047,27819,0
110,4156,1450,624,1228,12,26,181,1462,14,306,186,354,320,540,2580,4493,8,36391,2021,1,2,18,0,51310,20839,4048,27820,0
76,3351,1020,354,843,12,15,144,1032,8,134,77,144,142,221,970,1580,4,6792,377,0,2,17,0,51310,20839,4048,27821,0
346,6927,1457,730,1242,11,6,188,1468,10,292,166,329,302,495,2424,4078,5,22973,1276,1,2,1,1,51320,20845,4049,27829,0
346,6927,74,35,59,1,0,14,75,3,14,7,14,17,21,58,85,1,128,7,0,2,1,1,51320,20846,4049,27830,0
346,6927,245,125,200,5,7,34,250,7,30,17,34,37,51,166,265,3,1053,58,0,2,1,1,51330,20847,4049,27831,0
21,662,339,213,244,17,9,65,356,10,42,26,48,52,74,259,421,5,2410,133,0,2,1,1,51340,20847,4049,27832,0
27,954,74,35,59,1,0,14,75,3,14,7,14,17,21,58,85,1,128,7,0,2,1,1,51340,20848,4049,27833,0
27,954,245,125,200,5,7,34,250,7,30,17,34,37,51,166,265,3,1053,58,0,2,1,1,51350,20849,4049,27834,0
17,518,184,100,137,2,15,30,186,6,38,20,39,44,59,214,322,3,991,55,0,2,3,3,51350,20850,4049,27835,0
17,518,103,65,74,8,5,16,111,7,17,9,17,24,26,89,119,3,417,23,0,2,3,3,51350,20851,4049,27836,0
108,2066,1178,367,1042,6,15,115,1184,9,94,51,95,103,146,644,976,4,4439,246,0,2,2,2,51350,20851,4049,27837,0
108,2066,177,108,140,8,0,27,185,6,30,16,32,36,48,162,248,3,794,44,0,2,2,2,51350,20853,4049,27838,0
202,4260,1943,715,1694,26,18,214,1969,12,185,120,237,197,357,1436,2721,7,20915,1161,0,2,44,55,51350,20855,4049,27839,0
202,4260,1168,838,957,57,25,144,1225,19,348,224,416,367,640,3018,5452,11,61921,3440,1,2,44,55,51360,20857,4049,27840,0
76,3351,1020,354,843,12,15,144,1032,8,134,77,144,142,221,970,1580,4,6792,377,0,2,1,1,51360,20857,4049,27841,0
81,4076,1943,715,1694,26,18,214,1969,12,185,120,237,197,357,1436,2721,7,20915,1161,0,2,1,1,51360,20859,4049,27842,0
347,6940,1457,730,1242,11,6,188,1468,10,292,166,329,302,495,2424,4078,5,22973,1276,1,2,4,0,51360,20861,4049,27843,0
347,6940,74,35,59,1,0,14,75,3,14,7,14,17,21,58,85,1,128,7,0,2,4,0,51360,20862,4049,27844,0
347,6940,245,125,200,5,7,34,250,7,30,17,34,37,51,166,265,3,1053,58,0,2,4,0,51370,20863,4049,27845,0
9,367,75,38,59,1,3,12,76,2,4,2,4,6,6,10,15,1,15,0,0,2,13,0,51370,20863,4049,27846,0
12,426,42,7,35,4,0,5,46,1,2,1,2,3,3,2,4,0,2,0,0,2,1,1,51370,20863,4049,27847,0
12,426,11,6,10,0,0,1,11,2,4,2,4,6,6,10,15,1,15,0,0,2,1,1,51370,20863,4049,27848,0
168,5128,1660,832,1314,41,38,274,1701,20,312,209,395,332,604,2671,5058,12,64042,3557,1,2,6,6,51370,20865,4050,27850,0
168,5128,1057,646,719,113,100,145,1170,18,215,134,248,233,382,1740,3004,10,31186,1732,1,2,6,6,51380,20866,4051,27851,0
351,7048,1457,730,1242,11,6,188,1468,10,292,166,329,302,495,2424,4078,5,22973,1276,1,2,2,2,51380,20868,4051,27852,0
351,7048,74,35,59,1,0,14,75,3,14,7,14,17,21,58,85,1,128,7,0,2,2,2,51380,20869,4051,27853,0
351,7048,245,125,200,5,7,34,250,7,30,17,34,37,51,166,265,3,1053,58,0,2,2,2,51390,20870,4051,27854,0
212,5103,722,423,573,19,0,135,741,12,172,101,199,184,300,1320,2257,6,15668,870,0,2,1,1,51390,20872,4051,27856,0
212,5103,1508,847,911,44,250,301,1552,14,148,88,169,162,257,1120,1886,7,15077,837,0,2,1,1,51390,20873,4052,27857,0
110,4156,1450,624,1228,12,26,181,1462,14,306,186,354,320,540,2580,4493,8,36391,2021,1,2,1,1,51390,20875,4053,27858,0
168,5128,1660,832,1314,41,38,274,1701,20,312,209,395,332,604,2671,5058,12,64042,3557,1,2,6,6,51390,20877,4054,27860,0
168,5128,1057,646,719,113,100,145,1170,18,215,134,248,233,382,1740,3004,10,31186,1732,1,2,6,6,51400,20878,4055,27861,0
351,7048,1457,730,1242,11,6,188,1468,10,292,166,329,302,495,2424,4078,5,22973,1276,1,2,2,2,51400,20880,4055,27862,0
351,7048,74,35,59,1,0,14,75,3,14,7,14,17,21,58,85,1,128,7,0,2,2,2,51400,20881,4055,27863,0
351,7048,245,125,200,5,7,34,250,7,30,17,34,37,51,166,265,3,1053,58,0,2,2,2,51410,20882,4055,27864,0
212,5103,722,423,573,19,0,135,741,12,172,101,199,184,300,1320,2257,6,15668,870,0,2,1,1,51410,20884,4055,27866,0
212,5103,1508,847,911,44,250,301,1552,14,148,88,169,162,257,1120,1886,7,15077,837,0,2,1,1,51410,20885,4056,27867,0
110,4156,1450,624,1228,12,26,181,1462,14,306,186,354,320,540,2580,4493,8,36391,2021,1,2,1,1,51410,20887,4057,27868,0
167,5074,1660,832,1314,41,38,274,1701,20,312,209,395,332,604,2671,5058,12,64042,3557,1,2,1,1,51410,20889,4058,27870,0
167,5074,1057,646,719,113,100,145,1170,18,215,134,248,233,382,1740,3004,10,31186,1732,1,2,1,1,51420,20890,4059,27871,0
347,6940,1457,730,1242,11,6,188,1468,10,292,166,329,302,495,2424,4078,5,22973,1276,1,2,5,1,51420,20892,4059,27872,0
347,6940,74,35,59,1,0,14,75,3,14,7,14,17,21,58,85,1,128,7,0,2,5,1,51420,20893,4059,27873,0
347,6940,245,125,200,5,7,34,250,7,30,17,34,37,51,166,265,3,1053,58,0,2,5,1,51430,20894,4059,27874,0
21,662,339,213,244,17,9,65,356,10,42,26,48,52,74,259,421,5,2410,133,0,2,1,1,51440,20894,4059,27875,0
27,954,74,35,59,1,0,14,75,3,14,7,14,17,21,58,85,1,128,7,0,2,1,1,51440,20895,4059,27876,0
27,954,245,125,200,5,7,34,250,7,30,17,34,37,51,166,265,3,1053,58,0,2,1,1,51450,20896,4059,27877,0
100,2040,1020,354,843,12,15,144,1032,8,134,77,144,142,221,970,1580,4,6792,377,0,2,4,2,51450,20896,4059,27878,0
17,518,184,100,137,2,15,30,186,6,38,20,39,44,59,214,322,3,991,55,0,2,3,3,51450,20897,4059,27879,0
17,518,103,65,74,8,5,16,111,7,17,9,17,24,26,89,119,3,417,23,0,2,3,3,51450,20898,4059,27880,0
108,2066,1178,367,1042,6,15,115,1184,9,94,51,95,103,146,644,976,4,4439,246,0,2,2,2,51450,20898,4059,27881,0
108,2066,177,108,140,8,0,27,185,6,30,16,32,36,48,162,248,3,794,44,0,2,2,2,51450,20900,4059,27882,0
202,4260,1943,715,1694,26,18,214,1969,12,185,120,237,197,357,1436,2721,7,20915,1161,0,2,44,55,51450,20902,4059,27883,0
202,4260,1168,838,957,57,25,144,1225,19,348,224,416,367,640,3018,5452,11,61921,3440,1,2,44,55,51460,20904,4059,27884,0
12,426,42,7,35,4,0,5,46,1,2,1,2,3,3,2,4,0,2,0,0,2,1,1,51460,20904,4059,27885,0
12,426,11,6,10,0,0,1,11,2,4,2,4,6,6,10,15,1,15,0,0,2,1,1,51460,20904,4059,27886,0
9,367,75,38,59,1,3,12,76,2,4,2,4,6,6,10,15,1,15,0,0,2,13,0,51470,20908,4060,27894,0
110,4156,1450,624,1228,12,26,181,1462,14,306,186,354,320,540,2580,4493,8,36391,2021,1,2,18,0,51470,20910,4061,27895,0
76,3351,1020,354,843,12,15,144,1032,8,134,77,144,142,221,970,1580,4,6792,377,0,2,18,1,51470,20910,4061,27896,0
81,4076,1943,715,1694,26,18,214,1969,12,185,120,237,197,357,1436,2721,7,20915,1161,0,2,1,1,51470,20912,4061,27897,0
11,235,19,8,11,5,0,4,24,2,5,3,6,7,9,13,25,1,30,1,0,2,0,3,51470,20912,4061,27898,0
11,235,102,59,69,5,3,24,107,6,22,15,28,28,43,113,206,3,789,43,0,2,0,3,51470,20912,4061,27899,0
11,235,106,40,36,3,49,17,109,8,17,13,23,25,36,93,167,5,904,50,0,2,0,3,51470,20912,4061,27900,0
214,4592,182,127,129,0,0,53,182,5,39,21,42,44,63,217,343,2,926,51,0,2,1,3,51470,20912,4062,27901,0
214,4592,1165,710,800,67,119,181,1232,18,243,153,282,261,435,2000,3492,10,36473,2026,1,2,1,3,51480,20912,4063,27902,0
101,2069,773,419,590,28,0,166,801,10,204,113,217,214,330,1598,2554,5,13587,754,0,2,2,3,51480,20912,4064,27903,0
101,2069,421,273,302,44,34,57,465,17,81,59,107,98,166,583,1098,11,12329,684,0,2,2,3,51480,20912,4065,27904,0
26,524,2,2,2,0,0,0,2,0,0,0,0,0,0,0,0,0,0,0,0,2,4,6,51480,20912,4065,27904,0
26,524,99,48,90,1,3,5,100,0,0,0,0,0,0,0,0,0,0,0,0,2,4,6,51480,20913,4065,27905,0
26,524,8,5,5,2,0,1,10,0,0,0,0,0,0,0,0,0,0,0,0,2,4,6,51480,20913,4065,27906,0
26,524,1217,716,841,84,126,174,1301,14,185,118,215,199,333,1446,2542,8,20687,1149,0,2,4,6,51490,20915,4065,27907,0
26,524,160,89,115,0,13,31,160,7,15,11,17,22,28,78,124,3,495,27,0,2,4,6,51490,20915,4065,27908,0
26,524,10,10,9,9,0,0,19,0,0,0,0,0,0,0,0,0,0,0,0,2,4,6,51490,20915,4066,27909,0
26,524,173,84,99,8,29,36,181,5,12,7,13,17,20,54,81,2,221,12,0,2,4,6,51490,20916,4066,27910,0
26,524,3,1,1,3,0,0,6,0,0,0,0,0,0,0,0,0,0,0,0,2,4,6,51490,20916,4066,27911,0
167,5074,1660,832,1314,41,38,274,1701,20,312,209,395,332,604,2671,5058,12,64042,3557,1,2,12,16,51490,20918,4067,27913,0
167,5074,1057,646,719,113,100,145,1170,18,215,134,248,233,382,1740,3004,10,31186,1732,1,2,12,16,51500,20919,4068,27914,0
17,345,95,58,50,9,16,20,104,12,33,24,45,45,69,209,378,8,3100,172,0,2,3,3,51500,20919,4068,27915,0
86,1804,477,336,357,30,23,73,507,16,194,134,250,210,384,1538,2962,10,30538,1696,0,2,4,3,51510,20920,4068,27916,0
141,2959,1513,682,1277,25,13,200,1538,11,199,116,219,210,335,1557,2584,6,15641,868,0,2,183,77,51510,20922,4068,27917,0
141,2959,819,519,539,24,98,155,843,15,96,57,106,111,163,690,1107,8,9171,509,0,2,183,77,51520,20924,4068,27918,0
52,1082,207,111,150,11,0,50,218,5,26,19,36,31,55,133,272,3,943,52,0,2,68,72,51520,20924,4068,27919,0
52,1082,410,198,237,31,55,97,441,11,63,38,72,74,110,414,683,6,4293,238,0,2,68,72,51530,20925,4069,27920,0
347,6940,1457,730,1242,11,6,188,1468,10,292,166,329,302,495,2424,4078,5,22973,1276,1,2,21,35,51530,20927,4069,27921,0
347,6940,74,35,59,1,0,14,75,3,14,7,14,17,21,58,85,1,128,7,0,2,21,35,51530,20928,4069,27922,0
347,6940,245,125,200,5,7,34,250,7,30,17,34,37,51,166,265,3,1053,58,0,2,21,35,51540,20929,4069,27923,0
21,662,339,213,244,17,9,65,356,10,42,26,48,52,74,259,421,5,2410,133,0,2,2,2,51550,20929,4069,27924,0
64,1726,1455,414,1257,16,76,112,1471,5,41,23,46,46,69,231,381,2,1069,59,0,2,8,1,51550,20930,4069,27926,0
64,1726,669,365,481,22,61,110,691,15,103,63,122,118,185,747,1273,8,11311,628,0,2,8,1,51560,20930,4070,27927,0
231,5276,4293,999,3693,19,54,507,4312,9,155,88,170,164,258,1156,1898,4,9368,520,0,2,37,30,51560,20932,4070,27928,0
231,5276,1482,859,1002,125,135,219,1607,16,219,134,251,235,385,1766,3032,9,27804,1544,1,2,37,30,51570,20933,4070,27929,0
50,586,647,139,84,35,284,233,682,0,0,0,0,0,0,0,0,0,0,0,0,2,2,2,51570,20933,4070,27930,0
45,1297,773,422,505,30,103,129,803,14,77,46,83,91,129,535,839,7,6334,351,0,0,337,0,51580,20934,4071,27931,0
185,4238,77,34,69,0,0,8,77,3,24,16,29,27,45,114,213,1,387,21,0,2,15,29,51580,20934,4071,27932,0
185,4238,712,438,573,51,9,84,763,14,102,71,128,116,199,733,1364,8,11988,666,0,2,15,29,51590,20935,4071,27933,0
100,2040,1020,354,843,12,15,144,1032,8,134,77,144,142,221,970,1580,4,6792,377,0,2,55,26,51590,20935,4071,27934,0
46,957,447,308,343,6,5,95,453,7,96,59,111,103,170,651,1136,4,4600,255,0,2,4,5,51590,20938,4071,27935,0
46,957,322,174,179,16,74,51,338,10,41,26,46,51,72,252,408,5,2291,127,0,2,4,5,51590,20941,4072,27936,0
23,382,424,94,331,4,0,89,428,1,5,5,5,6,10,11,25,0,12,0,0,2,1,2,51590,20942,4072,27937,0
23,382,38,23,23,6,0,8,44,3,11,7,11,14,18,42,68,1,102,5,0,2,1,2,51590,20942,4072,27938,0
20,509,205,80,86,16,53,53,221,7,18,10,19,25,29,94,134,3,497,27,0,2,9,2,51600,20942,4073,27939,0
17,518,184,100,137,2,15,30,186,6,38,20,39,44,59,214,322,3,991,55,0,2,2,2,51600,20943,4073,27940,0
17,518,103,65,74,8,5,16,111,7,17,9,17,24,26,89,119,3,417,23,0,2,2,2,51600,20944,4073,27941,0
214,5107,722,423,573,19,0,135,741,12,172,101,199,184,300,1320,2257,6,15668,870,0,2,65,45,51600,20946,4073,27943,0
214,5107,1508,847,911,44,250,301,1552,14,148,88,169,162,257,1120,1886,7,15077,837,0,2,65,45,51600,20947,4074,27944,0
258,6089,72,33,56,0,4,12,72,1,1,1,1,2,2,0,2,0,1,0,0,2,44,42,51600,20947,4074,27945,0
258,6089,1454,835,1044,76,110,219,1530,17,275,158,296,292,454,2297,3718,9,34017,1889,1,2,44,42,51610,20948,4074,27946,0
73,1425,757,253,292,73,244,162,830,13,61,38,67,74,105,409,651,7,4654,258,0,2,4,11,51610,20949,4074,27947,0
46,954,386,256,301,16,9,68,402,4,59,35,69,63,104,355,621,2,1453,80,0,2,36,5,51610,20949,4074,27948,0
46,954,264,131,164,11,41,46,275,6,38,22,40,44,62,214,338,3,1068,59,0,2,36,5,51620,20949,4075,27949,0
112,2472,1043,504,840,53,9,147,1096,9,180,112,198,189,310,1377,2344,4,11604,644,0,2,1,1,51620,20951,4075,27950,0
112,2472,383,288,292,26,6,62,409,11,65,38,67,76,105,429,656,5,3719,206,0,2,1,1,51620,20952,4075,27951,0
20,408,294,64,250,0,0,43,294,1,20,10,20,21,30,86,131,0,65,3,0,2,2,2,51620,20952,4075,27952,0
20,408,78,46,62,3,0,14,81,3,8,4,8,11,12,28,41,1,62,3,0,2,2,2,51620,20953,4075,27953,0
108,2066,1178,367,1042,6,15,115,1184,9,94,51,95,103,146,644,976,4,4439,246,0,2,73,48,51620,20953,4075,27954,0
108,2066,177,108,140,8,0,27,185,6,30,16,32,36,48,162,248,3,794,44,0,2,73,48,51620,20955,4075,27955,0
202,4260,1943,715,1694,26,18,214,1969,12,185,120,237,197,357,1436,2721,7,20915,1161,0,2,70,22,51620,20957,4075,27956,0
202,4260,1168,838,957,57,25,144,1225,19,348,224,416,367,640,3018,5452,11,61921,3440,1,2,70,22,51630,20959,4075,27957,0
62,1222,1098,241,925,5,10,155,1103,7,46,25,49,53,74,273,423,3,1580,87,0,2,1,3,51640,20961,4075,27958,0
62,1222,282,202,222,14,2,44,296,8,42,24,43,50,67,250,378,4,1548,86,0,2,1,3,51640,20962,4075,27959,0
21,436,601,196,481,2,23,85,603,8,63,36,72,71,108,400,664,4,3036,168,0,2,2,2,51650,20966,4076,27967,0
21,436,156,79,106,5,16,28,161,5,14,8,15,19,23,64,97,2,261,14,0,2,2,2,51650,20966,4076,27968,0
7,299,72,33,56,0,4,12,72,1,1,1,1,2,2,0,2,0,1,0,0,2,1,1,51650,20966,4076,27969,0
12,426,42,7,35,4,0,5,46,1,2,1,2,3,3,2,4,0,2,0,0,2,24,10,51650,20966,4076,27970,0
12,426,11,6,10,0,0,1,11,2,4,2,4,6,6,10,15,1,15,0,0,2,24,10,51650,20966,4076,27971,0
81,3472,1289,550,1043,56,32,155,1345,10,167,93,185,177,278,1266,2075,5,11498,638,0,2,6,6,51660,20972,4078,27979,0
147,6933,1392,870,1177,35,17,170,1427,14,494,280,531,508,811,4473,7289,7,54850,3047,2,2,2,9,51660,20975,4079,27980,0
87,2905,773,419,590,28,0,166,801,10,204,113,217,214,330,1598,2554,5,13587,754,0,2,0,2,51660,20975,4080,27981,0
9,367,75,38,59,1,3,12,76,2,4,2,4,6,6,10,15,1,15,0,0,2,30,0,51660,20975,4080,27982,0
7,353,139,89,101,2,0,35,141,7,54,34,62,61,96,330,569,4,2287,127,0,0,70,0,51660,20975,4080,27983,0
21,1023,1157,318,931,29,22,177,1186,6,104,63,125,110,188,712,1274,3,4596,255,0,0,398,0,51660,20975,4080,27984,0
52,3380,520,294,400,33,13,81,553,10,261,204,367,271,571,2128,4614,7,32445,1802,1,2,0,6,51660,20976,4080,27985,0
97,4424,1338,495,1086,10,64,173,1348,11,122,82,157,133,239,883,1686,7,11934,663,0,2,10,15,51660,20978,4080,27986,0
162,7134,139,89,101,2,0,35,141,7,54,34,62,61,96,330,569,4,2287,127,0,2,49,5,51660,20978,4080,27987,0
162,7134,7,5,5,0,0,2,7,1,2,1,2,3,3,2,4,0,2,0,0,2,49,5,51660,20978,4080,27988,0
132,5730,1782,648,1425,9,47,279,1791,8,171,97,189,179,286,1292,2140,4,9462,525,0,2,10,6,51660,20979,4081,27989,0
110,4156,1450,624,1228,12,26,181,1462,14,306,186,354,320,540,2580,4493,8,36391,2021,1,2,2,2,51660,20981,4082,27990,0
155,4372,1660,832,1314,41,38,274,1701,20,312,209,395,332,604,2671,5058,12,64042,3557,1,2,1,1,51660,20983,4083,27992,0
128,5156,1513,682,1277,25,13,200,1538,11,199,116,219,210,335,1557,2584,6,15641,868,0,2,132,36,51660,20985,4083,27993,0
73,3834,1296,573,1062,40,33,157,1336,8,201,118,231,209,349,1561,2689,4,12365,686,0,2,7,8,51660,20985,4083,27994,0
80,4250,1457,730,1242,11,6,188,1468,10,292,166,329,302,495,2424,4078,5,22973,1276,1,2,9,1,51660,20987,4083,27995,0
68,3131,1455,414,1257,16,76,112,1471,5,41,23,46,46,69,231,381,2,1069,59,0,2,28,0,51660,20988,4083,27996,0
76,3351,1020,354,843,12,15,144,1032,8,134,77,144,142,221,970,1580,4,6792,377,0,2,1,1,51660,20988,4083,27997,0
38,2303,334,251,279,10,4,40,344,5,127,74,143,132,217,899,1528,2,4303,239,0,2,1,7,51660,20989,4083,27998,0
33,1914,384,251,317,7,8,52,391,11,70,44,84,81,128,467,811,6,5355,297,0,2,8,20,51660,20989,4083,27999,0
16,677,722,423,573,19,0,135,741,12,172,101,199,184,300,1320,2257,6,15668,870,0,2,11,0,51660,20991,4083,28001,0
39,1774,386,256,301,16,9,68,402,4,59,35,69,63,104,355,621,2,1453,80,0,2,24,0,51660,20991,4083,28002,0
75,2972,1043,504,840,53,9,147,1096,9,180,112,198,189,310,1377,2344,4,11604,644,0,2,7,5,51660,20993,4083,28003,0
74,3124,1178,367,1042,6,15,115,1184,9,94,51,95,103,146,644,976,4,4439,246,0,2,64,3,51660,20993,4083,28004,0
81,4076,1943,715,1694,26,18,214,1969,12,185,120,237,197,357,1436,2721,7,20915,1161,0,2,64,10,51660,20995,4083,28005,0
48,1750,1098,241,925,5,10,155,1103,7,46,25,49,53,74,273,423,3,1580,87,0,2,4,7,51670,20997,4083,28006,0
18,646,601,196,481,2,23,85,603,8,63,36,72,71,108,400,664,4,3036,168,0,2,21,1,51670,20997,4083,28007,0
22,453,601,196,481,2,23,85,603,8,63,36,72,71,108,400,664,4,3036,168,0,2,3,1,51670,20997,4083,28008,1
22,453,156,79,106,5,16,28,161,5,14,8,15,19,23,64,97,2,261,14,0,2,3,1,51670,20997,4083,28009,1
19,679,601,196,481,2,23,85,603,8,63,36,72,71,108,400,664,4,3036,168,0,2,13,0,51670,20997,4083,28010,1
22,453,601,196,481,2,23,85,603,8,63,36,72,71,108,400,664,4,3036,168,0,2,3,1,51670,20997,4083,28011,0
22,453,156,79,106,5,16,28,161,5,14,8,15,19,23,64,97,2,261,14,0,2,3,1,51670,20997,4083,28012,0
19,679,601,196,481,2,23,85,603,8,63,36,72,71,108,400,664,4,3036,168,0,2,13,0,51670,20997,4083,28013,0
348,6947,1457,730,1242,11,6,188,1468,10,292,166,329,302,495,2424,4078,5,22973,1276,1,2,1,1,51670,20999,4083,28014,0
348,6947,74,35,59,1,0,14,75,3,14,7,14,17,21,58,85,1,128,7,0,2,1,1,51670,21000,4083,28015,0
348,6947,245,125,200,5,7,34,250,7,30,17,34,37,51,166,265,3,1053,58,0,2,1,1,51680,21001,4083,28016,0
80,4253,1457,730,1242,11,6,188,1468,10,292,166,329,302,495,2424,4078,5,22973,1276,1,2,6,2,51680,21003,4083,28017,0
80,4253,1457,730,1242,11,6,188,1468,10,292,166,329,302,495,2424,4078,5,22973,1276,1,2,0,3,51680,21005,4083,28018,0
111,2463,1043,504,840,53,9,147,1096,9,180,112,198,189,310,1377,2344,4,11604,644,0,2,2,4,51680,21007,4083,28019,1
111,2463,383,288,292,26,6,62,409,11,65,38,67,76,105,429,656,5,3719,206,0,2,2,4,51680,21008,4083,28020,1
81,3472,1289,550,1043,56,32,155,1345,10,167,93,185,177,278,1266,2075,5,11498,638,0,2,3,3,51680,21010,4084,28021,1
82,4311,1457,730,1242,11,6,188,1468,10,292,166,329,302,495,2424,4078,5,22973,1276,1,2,12,4,51680,21012,4084,28022,0
203,4272,1943,715,1694,26,18,214,1969,12,185,120,237,197,357,1436,2721,7,20915,1161,0,2,5,2,51680,21014,4084,28023,0
203,4272,1168,838,957,57,25,144,1225,19,348,224,416,367,640,3018,5452,11,61921,3440,1,2,5,2,51690,21016,4084,28024,0
82,4120,1943,715,1694,26,18,214,1969,12,185,120,237,197,357,1436,2721,7,20915,1161,0,2,18,0,51690,21018,4084,28025,0
111,2463,1043,504,840,53,9,147,1096,9,180,112,198,189,310,1377,2344,4,11604,644,0,2,2,4,51690,21020,4084,28026,0
111,2463,383,288,292,26,6,62,409,11,65,38,67,76,105,429,656,5,3719,206,0,2,2,4,51690,21021,4084,28027,0
81,3472,1289,550,1043,56,32,155,1345,10,167,93,185,177,278,1266,2075,5,11498,638,0,2,3,3,51690,21023,4085,28028,0
348,6947,1457,730,1242,11,6,188,1468,10,292,166,329,302,495,2424,4078,5,22973,1276,1,2,1,1,51690,21025,4085,28029,0
348,6947,74,35,59,1,0,14,75,3,14,7,14,17,21,58,85,1,128,7,0,2,1,1,51690,21026,4085,28030,0
348,6947,245,125,200,5,7,34,250,7,30,17,34,37,51,166,265,3,1053,58,0,2,1,1,51700,21027,4085,28031,0
82,4311,1457,730,1242,11,6,188,1468,10,292,166,329,302,495,2424,4078,5,22973,1276,1,2,14,5,51700,21029,4085,28032,0
259,6096,72,33,56,0,4,12,72,1,1,1,1,2,2,0,2,0,1,0,0,2,1,1,51700,21029,4085,28033,0
259,6096,1454,835,1044,76,110,219,1530,17,275,158,296,292,454,2297,3718,9,34017,1889,1,2,1,1,51710,21030,4085,28034,0
231,5287,4293,999,3693,19,54,507,4312,9,155,88,170,164,258,1156,1898,4,9368,520,0,2,1,1,51710,21032,4085,28035,0
231,5287,1482,859,1002,125,135,219,1607,16,219,134,251,235,385,1766,3032,9,27804,1544,1,2,1,1,51720,21033,4085,28036,0
135,5789,1782,648,1425,9,47,279,1791,8,171,97,189,179,286,1292,2140,4,9462,525,0,2,14,0,51720,21034,4086,28037,0
135,5789,1782,648,1425,9,47,279,1791,8,171,97,189,179,286,1292,2140,4,9462,525,0,2,7,2,51720,21035,4087,28038,0
231,5287,4293,999,3693,19,54,507,4312,9,155,88,170,164,258,1156,1898,4,9368,520,0,2,1,1,51720,21037,4087,28039,0
231,5287,1482,859,1002,125,135,219,1607,16,219,134,251,235,385,1766,3032,9,27804,1544,1,2,1,1,51730,21038,4087,28040,0
259,6096,72,33,56,0,4,12,72,1,1,1,1,2,2,0,2,0,1,0,0,2,1,1,51730,21038,4087,28041,0
259,6096,1454,835,1044,76,110,219,1530,17,275,158,296,292,454,2297,3718,9,34017,1889,1,2,1,1,51740,21039,4087,28042,0
135,5789,1782,648,1425,9,47,279,1791,8,171,97,189,179,286,1292,2140,4,9462,525,0,2,19,0,51740,21040,4088,28043,0
202,4267,1943,715,1694,26,18,214,1969,12,185,120,237,197,357,1436,2721,7,20915,1161,0,2,2,0,51740,21042,4088,28044,0
202,4267,1168,838,957,57,25,144,1225,19,348,224,416,367,640,3018,5452,11,61921,3440,1,2,2,0,51750,21044,4088,28045,0
11,406,75,38,59,1,3,12,76,2,4,2,4,6,6,10,15,1,15,0,0,2,13,0,51750,21044,4088,28046,0
203,4272,1943,715,1694,26,18,214,1969,12,185,120,237,197,357,1436,2721,7,20915,1161,0,2,5,2,51750,21046,4088,28047,0
203,4272,1168,838,957,57,25,144,1225,19,348,224,416,367,640,3018,5452,11,61921,3440,1,2,5,2,51760,21048,4088,28048,0
82,4120,1943,715,1694,26,18,214,1969,12,185,120,237,197,357,1436,2721,7,20915,1161,0,2,18,0,51760,21050,4088,28049,0
203,4279,1943,715,1694,26,18,214,1969,12,185,120,237,197,357,1436,2721,7,20915,1161,0,2,2,0,51760,21052,4088,28050,0
203,4279,1168,838,957,57,25,144,1225,19,348,224,416,367,640,3018,5452,11,61921,3440,1,2,2,0,51770,21054,4088,28051,0
11,406,75,38,59,1,3,12,76,2,4,2,4,6,6,10,15,1,15,0,0,2,13,0,51770,21054,4088,28052,0
348,6963,1457,730,1242,11,6,188,1468,10,292,166,329,302,495,2424,4078,5,22973,1276,1,2,4,3,51770,21056,4088,28053,0
348,6963,74,35,59,1,0,14,75,3,14,7,14,17,21,58,85,1,128,7,0,2,4,3,51770,21057,4088,28054,0
348,6963,245,125,200,5,7,34,250,7,30,17,34,37,51,166,265,3,1053,58,0,2,4,3,51780,21058,4088,28055,0
11,428,75,38,59,1,3,12,76,2,4,2,4,6,6,10,15,1,15,0,0,2,5,4,51780,21058,4088,28056,0
348,6963,1457,730,1242,11,6,188,1468,10,292,166,329,302,495,2424,4078,5,22973,1276,1,2,4,3,51780,21060,4088,28057,0
348,6963,74,35,59,1,0,14,75,3,14,7,14,17,21,58,85,1,128,7,0,2,4,3,51780,21061,4088,28058,0
348,6963,245,125,200,5,7,34,250,7,30,17,34,37,51,166,265,3,1053,58,0,2,4,3,51790,21062,4088,28059,0
11,428,75,38,59,1,3,12,76,2,4,2,4,6,6,10,15,1,15,0,0,2,5,4,51790,21062,4088,28060,0
348,6963,1457,730,1242,11,6,188,1468,10,292,166,329,302,495,2424,4078,5,22973,1276,1,2,4,3,51790,21064,4088,28061,0
348,6963,74,35,59,1,0,14,75,3,14,7,14,17,21,58,85,1,128,7,0,2,4,3,51790,21065,4088,28062,0
348,6963,245,125,200,5,7,34,250,7,30,17,34,37,51,166,265,3,1053,58,0,2,4,3,51800,21066,4088,28063,0
231,5287,4293,999,3693,19,54,507,4312,9,155,88,170,164,258,1156,1898,4,9368,520,0,2,1,1,51800,21068,4088,28064,0
231,5287,1482,859,1002,125,135,219,1607,16,219,134,251,235,385,1766,3032,9,27804,1544,1,2,1,1,51810,21069,4088,28065,0
203,4279,1943,715,1694,26,18,214,1969,12,185,120,237,197,357,1436,2721,7,20915,1161,0,2,7,2,51810,21071,4088,28066,0
203,4279,1168,838,957,57,25,144,1225,19,348,224,416,367,640,3018,5452,11,61921,3440,1,2,7,2,51820,21073,4088,28067,0
11,428,75,38,59,1,3,12,76,2,4,2,4,6,6,10,15,1,15,0,0,2,18,4,51820,21073,4088,28068,0
82,4120,1943,715,1694,26,18,214,1969,12,185,120,237,197,357,1436,2721,7,20915,1161,0,2,18,0,51820,21075,4088,28069,0
191,4342,77,34,69,0,0,8,77,3,24,16,29,27,45,114,213,1,387,21,0,2,19,0,51820,21075,4088,28070,1
191,4342,712,438,573,51,9,84,763,14,102,71,128,116,199,733,1364,8,11988,666,0,2,19,0,51830,21076,4088,28071,1
87,3758,1289,550,1043,56,32,155,1345,10,167,93,185,177,278,1266,2075,5,11498,638,0,2,65,0,51830,21078,4089,28072,1
41,1265,773,422,505,30,103,129,803,14,77,46,83,91,129,535,839,7,6334,351,0,2,14,24,51840,21079,4090,28073,0
214,5107,722,423,573,19,0,135,741,12,172,101,199,184,300,1320,2257,6,15668,870,0,2,159,160,51840,21081,4090,28075,1
214,5107,1508,847,911,44,250,301,1552,14,148,88,169,162,257,1120,1886,7,15077,837,0,2,159,160,51840,21082,4091,28076,1
214,5107,722,423,573,19,0,135,741,12,172,101,199,184,300,1320,2257,6,15668,870,0,2,0,7,51840,21084,4091,28078,0
214,5107,1508,847,911,44,250,301,1552,14,148,88,169,162,257,1120,1886,7,15077,837,0,2,0,7,51840,21085,4092,28079,0
214,5106,722,423,573,19,0,135,741,12,172,101,199,184,300,1320,2257,6,15668,870,0,2,2,2,51840,21087,4092,28081,0
214,5106,1508,847,911,44,250,301,1552,14,148,88,169,162,257,1120,1886,7,15077,837,0,2,2,2,51840,21088,4093,28082,0
81,3468,1289,550,1043,56,32,155,1345,10,167,93,185,177,278,1266,2075,5,11498,638,0,2,2,2,51840,21090,4094,28083,0
39,2351,652,304,544,16,6,88,668,6,89,51,101,95,152,591,998,3,3399,188,0,2,1,1,51840,21091,4094,28084,0
35,1623,1293,570,1093,25,15,163,1318,10,195,123,241,205,364,1516,2795,6,17273,959,0,2,1,1,51850,21093,4094,28085,0
81,3468,1289,550,1043,56,32,155,1345,10,167,93,185,177,278,1266,2075,5,11498,638,0,2,2,2,51850,21095,4095,28086,0
81,3468,1289,550,1043,56,32,155,1345,10,167,93,185,177,278,1266,2075,5,11498,638,0,2,5,5,51850,21097,4096,28087,0
16,677,722,423,573,19,0,135,741,12,172,101,199,184,300,1320,2257,6,15668,870,0,2,1,1,51850,21099,4096,28089,1
39,2342,652,304,544,16,6,88,668,6,89,51,101,95,152,591,998,3,3399,188,0,2,1,5,51850,21100,4096,28090,0
100,2053,773,419,590,28,0,166,801,10,204,113,217,214,330,1598,2554,5,13587,754,0,2,5,9,51850,21100,4097,28091,0
100,2053,421,273,302,44,34,57,465,17,81,59,107,98,166,583,1098,11,12329,684,0,2,5,9,51850,21100,4098,28092,0
167,5072,1660,832,1314,41,38,274,1701,20,312,209,395,332,604,2671,5058,12,64042,3557,1,2,2,3,51850,21102,4099,28094,0
167,5072,1057,646,719,113,100,145,1170,18,215,134,248,233,382,1740,3004,10,31186,1732,1,2,2,3,51860,21103,4100,28095,0
87,2883,773,419,590,28,0,166,801,10,204,113,217,214,330,1598,2554,5,13587,754,0,2,2,5,51860,21103,4101,28096,0
86,1796,477,336,357,30,23,73,507,16,194,134,250,210,384,1538,2962,10,30538,1696,0,2,1,5,51870,21104,4101,28097,1
86,1788,477,336,357,30,23,73,507,16,194,134,250,210,384,1538,2962,10,30538,1696,0,2,1,1,51880,21105,4101,28098,0
100,2053,773,419,590,28,0,166,801,10,204,113,217,214,330,1598,2554,5,13587,754,0,2,5,9,51880,21105,4102,28099,0
100,2053,421,273,302,44,34,57,465,17,81,59,107,98,166,583,1098,11,12329,684,0,2,5,9,51880,21105,4103,28100,0
167,5072,1660,832,1314,41,38,274,1701,20,312,209,395,332,604,2671,5058,12,64042,3557,1,2,2,3,51880,21107,4104,28102,0
167,5072,1057,646,719,113,100,145,1170,18,215,134,248,233,382,1740,3004,10,31186,1732,1,2,2,3,51890,21108,4105,28103,0
86,1788,477,336,357,30,23,73,507,16,194,134,250,210,384,1538,2962,10,30538,1696,0,2,2,6,51900,21109,4105,28104,0
87,2883,773,419,590,28,0,166,801,10,204,113,217,214,330,1598,2554,5,13587,754,0,2,2,5,51900,21109,4106,28105,0
214,5106,722,423,573,19,0,135,741,12,172,101,199,184,300,1320,2257,6,15668,870,0,2,161,169,51900,21111,4106,28107,0
214,5106,1508,847,911,44,250,301,1552,14,148,88,169,162,257,1120,1886,7,15077,837,0,2,161,169,51900,21112,4107,28108,0
81,3468,1289,550,1043,56,32,155,1345,10,167,93,185,177,278,1266,2075,5,11498,638,0,2,9,9,51900,21114,4108,28109,0
39,2342,652,304,544,16,6,88,668,6,89,51,101,95,152,591,998,3,3399,188,0,2,2,6,51900,21115,4108,28110,0
35,1623,1293,570,1093,25,15,163,1318,10,195,123,241,205,364,1516,2795,6,17273,959,0,2,1,1,51910,21117,4108,28111,0
16,677,722,423,573,19,0,135,741,12,172,101,199,184,300,1320,2257,6,15668,870,0,2,1,1,51910,21119,4108,28113,0
100,2053,773,419,590,28,0,166,801,10,204,113,217,214,330,1598,2554,5,13587,754,0,2,5,9,51910,21119,4109,28114,0
100,2053,421,273,302,44,34,57,465,17,81,59,107,98,166,583,1098,11,12329,684,0,2,5,9,51910,21119,4110,28115,0
167,5072,1660,832,1314,41,38,274,1701,20,312,209,395,332,604,2671,5058,12,64042,3557,1,2,2,3,51910,21121,4111,28117,0
167,5072,1057,646,719,113,100,145,1170,18,215,134,248,233,382,1740,3004,10,31186,1732,1,2,2,3,51920,21122,4112,28118,0
86,1788,477,336,357,30,23,73,507,16,194,134,250,210,384,1538,2962,10,30538,1696,0,2,2,6,51930,21123,4112,28119,0
214,5106,722,423,573,19,0,135,741,12,172,101,199,184,300,1320,2257,6,15668,870,0,2,161,169,51930,21125,4112,28121,0
214,5106,1508,847,911,44,250,301,1552,14,148,88,169,162,257,1120,1886,7,15077,837,0,2,161,169,51930,21126,4113,28122,0
81,3468,1289,550,1043,56,32,155,1345,10,167,93,185,177,278,1266,2075,5,11498,638,0,2,9,9,51930,21128,4114,28123,0
87,2883,773,419,590,28,0,166,801,10,204,113,217,214,330,1598,2554,5,13587,754,0,2,2,5,51930,21128,4115,28124,0
39,2342,652,304,544,16,6,88,668,6,89,51,101,95,152,591,998,3,3399,188,0,2,2,6,51930,21129,4115,28125,0
35,1623,1293,570,1093,25,15,163,1318,10,195,123,241,205,364,1516,2795,6,17273,959,0,2,1,1,51940,21131,4115,28126,0
16,677,722,423,573,19,0,135,741,12,172,101,199,184,300,1320,2257,6,15668,870,0,2,1,1,51940,21133,4115,28128,0
87,3752,1289,550,1043,56,32,155,1345,10,167,93,185,177,278,1266,2075,5,11498,638,0,2,3,3,51940,21135,4116,28129,0
193,4386,77,34,69,0,0,8,77,3,24,16,29,27,45,114,213,1,387,21,0,2,43,20,51940,21135,4116,28130,0
193,4386,712,438,573,51,9,84,763,14,102,71,128,116,199,733,1364,8,11988,666,0,2,43,20,51950,21136,4116,28131,0
193,4386,77,34,69,0,0,8,77,3,24,16,29,27,45,114,213,1,387,21,0,2,40,38,51950,21136,4116,28132,0
193,4386,712,438,573,51,9,84,763,14,102,71,128,116,199,733,1364,8,11988,666,0,2,40,38,51960,21137,4116,28133,0
50,586,647,139,84,35,284,233,682,0,0,0,0,0,0,0,0,0,0,0,0,2,95,30,51960,21137,4116,28134,1
167,5087,1660,832,1314,41,38,274,1701,20,312,209,395,332,604,2671,5058,12,64042,3557,1,2,8,6,51960,21139,4117,28136,1
167,5087,1057,646,719,113,100,145,1170,18,215,134,248,233,382,1740,3004,10,31186,1732,1,2,8,6,51970,21140,4118,28137,1
214,5106,722,423,573,19,0,135,741,12,172,101,199,184,300,1320,2257,6,15668,870,0,2,1,1,51970,21142,4118,28139,1
214,5106,1508,847,911,44,250,301,1552,14,148,88,169,162,257,1120,1886,7,15077,837,0,2,1,1,51970,21143,4119,28140,1
156,4422,1660,832,1314,41,38,274,1701,20,312,209,395,332,604,2671,5058,12,64042,3557,1,2,10,0,51970,21145,4120,28142,1
167,5085,1660,832,1314,41,38,274,1701,20,312,209,395,332,604,2671,5058,12,64042,3557,1,2,3,2,51970,21147,4121,28144,0
167,5085,1057,646,719,113,100,145,1170,18,215,134,248,233,382,1740,3004,10,31186,1732,1,2,3,2,51980,21148,4122,28145,0
41,1265,773,422,505,30,103,129,803,14,77,46,83,91,129,535,839,7,6334,351,0,2,14,24,51990,21149,4123,28146,0
167,5085,1660,832,1314,41,38,274,1701,20,312,209,395,332,604,2671,5058,12,64042,3557,1,2,9,6,51990,21151,4124,28148,0
167,5085,1057,646,719,113,100,145,1170,18,215,134,248,233,382,1740,3004,10,31186,1732,1,2,9,6,52000,21152,4125,28149,0
214,5106,722,423,573,19,0,135,741,12,172,101,199,184,300,1320,2257,6,15668,870,0,2,1,1,52000,21154,4125,28151,0
214,5106,1508,847,911,44,250,301,1552,14,148,88,169,162,257,1120,1886,7,15077,837,0,2,1,1,52000,21155,4126,28152,0
156,4422,1660,832,1314,41,38,274,1701,20,312,209,395,332,604,2671,5058,12,64042,3557,1,2,10,0,52000,21157,4127,28154,0
50,586,647,139,84,35,284,233,682,0,0,0,0,0,0,0,0,0,0,0,0,2,95,30,52000,21157,4127,28155,0
193,4386,77,34,69,0,0,8,77,3,24,16,29,27,45,114,213,1,387,21,0,2,47,3,52000,21157,4127,28156,0
193,4386,712,438,573,51,9,84,763,14,102,71,128,116,199,733,1364,8,11988,666,0,2,47,3,52010,21158,4127,28157,0
87,3748,1289,550,1043,56,32,155,1345,10,167,93,185,177,278,1266,2075,5,11498,638,0,2,65,0,52010,21160,4128,28158,0
45,1258,773,422,505,30,103,129,803,14,77,46,83,91,129,535,839,7,6334,351,0,2,8,9,52020,21161,4129,28159,0
231,5261,4293,999,3693,19,54,507,4312,9,155,88,170,164,258,1156,1898,4,9368,520,0,2,10,7,52020,21163,4129,28160,0
231,5261,1482,859,1002,125,135,219,1607,16,219,134,251,235,385,1766,3032,9,27804,1544,1,2,10,7,52030,21164,4129,28161,0
88,3778,1289,550,1043,56,32,155,1345,10,167,93,185,177,278,1266,2075,5,11498,638,0,2,43,0,52030,21166,4130,28162,0
45,1258,773,422,505,30,103,129,803,14,77,46,83,91,129,535,839,7,6334,351,0,2,8,9,52040,21167,4131,28163,0
231,5261,4293,999,3693,19,54,507,4312,9,155,88,170,164,258,1156,1898,4,9368,520,0,2,10,7,52040,21169,4131,28164,0
231,5261,1482,859,1002,125,135,219,1607,16,219,134,251,235,385,1766,3032,9,27804,1544,1,2,10,7,52050,21170,4131,28165,0
88,3778,1289,550,1043,56,32,155,1345,10,167,93,185,177,278,1266,2075,5,11498,638,0,2,43,0,52050,21172,4132,28166,0
89,3806,1289,550,1043,56,32,155,1345,10,167,93,185,177,278,1266,2075,5,11498,638,0,2,7,0,52050,21174,4133,28167,0
204,4292,1943,715,1694,26,18,214,1969,12,185,120,237,197,357,1436,2721,7,20915,1161,0,2,2,1,52050,21176,4133,28168,0
204,4292,1168,838,957,57,25,144,1225,19,348,224,416,367,640,3018,5452,11,61921,3440,1,2,2,1,52060,21178,4133,28169,0
83,4156,1943,715,1694,26,18,214,1969,12,185,120,237,197,357,1436,2721,7,20915,1161,0,2,8,0,52060,21180,4133,28170,0
167,5085,1660,832,1314,41,38,274,1701,20,312,209,395,332,604,2671,5058,12,64042,3557,1,2,9,6,52060,21182,4134,28172,0
167,5085,1057,646,719,113,100,145,1170,18,215,134,248,233,382,1740,3004,10,31186,1732,1,2,9,6,52070,21183,4135,28173,0
231,5261,4293,999,3693,19,54,507,4312,9,155,88,170,164,258,1156,1898,4,9368,520,0,2,10,7,52070,21185,4135,28174,0
231,5261,1482,859,1002,125,135,219,1607,16,219,134,251,235,385,1766,3032,9,27804,1544,1,2,10,7,52080,21186,4135,28175,0
50,586,647,139,84,35,284,233,682,0,0,0,0,0,0,0,0,0,0,0,0,2,95,30,52080,21186,4135,28176,0
45,1258,773,422,505,30,103,129,803,14,77,46,83,91,129,535,839,7,6334,351,0,2,16,27,52090,21187,4136,28177,0
193,4386,77,34,69,0,0,8,77,3,24,16,29,27,45,114,213,1,387,21,0,2,47,3,52090,21187,4136,28178,0
193,4386,712,438,573,51,9,84,763,14,102,71,128,116,199,733,1364,8,11988,666,0,2,47,3,52100,21188,4136,28179,0
214,5106,722,423,573,19,0,135,741,12,172,101,199,184,300,1320,2257,6,15668,870,0,2,1,1,52100,21190,4136,28181,0
214,5106,1508,847,911,44,250,301,1552,14,148,88,169,162,257,1120,1886,7,15077,837,0,2,1,1,52100,21191,4137,28182,0
204,4292,1943,715,1694,26,18,214,1969,12,185,120,237,197,357,1436,2721,7,20915,1161,0,2,2,1,52100,21193,4137,28183,0
204,4292,1168,838,957,57,25,144,1225,19,348,224,416,367,640,3018,5452,11,61921,3440,1,2,2,1,52110,21195,4137,28184,0
88,3778,1289,550,1043,56,32,155,1345,10,167,93,185,177,278,1266,2075,5,11498,638,0,2,108,0,52110,21197,4138,28185,0
156,4422,1660,832,1314,41,38,274,1701,20,312,209,395,332,604,2671,5058,12,64042,3557,1,2,10,0,52110,21199,4139,28187,0
83,4156,1943,715,1694,26,18,214,1969,12,185,120,237,197,357,1436,2721,7,20915,1161,0,2,8,0,52110,21201,4139,28188,0
90,3836,1289,550,1043,56,32,155,1345,10,167,93,185,177,278,1266,2075,5,11498,638,0,2,7,0,52110,21203,4140,28189,0
51,1398,773,422,505,30,103,129,803,14,77,46,83,91,129,535,839,7,6334,351,0,2,35,7,52120,21204,4141,28190,0
221,5235,722,423,573,19,0,135,741,12,172,101,199,184,300,1320,2257,6,15668,870,0,2,46,21,52120,21206,4141,28192,1
221,5235,1508,847,911,44,250,301,1552,14,148,88,169,162,257,1120,1886,7,15077,837,0,2,46,21,52120,21207,4142,28193,1
222,5253,722,423,573,19,0,135,741,12,172,101,199,184,300,1320,2257,6,15668,870,0,2,52,39,52120,21209,4142,28195,1
222,5253,1508,847,911,44,250,301,1552,14,148,88,169,162,257,1120,1886,7,15077,837,0,2,52,39,52120,21210,4143,28196,1
88,3790,1289,550,1043,56,32,155,1345,10,167,93,185,177,278,1266,2075,5,11498,638,0,2,3,3,52120,21212,4144,28197,1
11,423,75,38,59,1,3,12,76,2,4,2,4,6,6,10,15,1,15,0,0,2,0,1,52120,21212,4144,28198,1
45,2193,722,423,573,19,0,135,741,12,172,101,199,184,300,1320,2257,6,15668,870,0,2,238,9,52120,21214,4144,28200,1
52,1417,773,422,505,30,103,129,803,14,77,46,83,91,129,535,839,7,6334,351,0,2,15,9,52130,21215,4145,28201,0
51,1398,773,422,505,30,103,129,803,14,77,46,83,91,129,535,839,7,6334,351,0,2,9,15,52140,21216,4146,28202,0
45,1258,773,422,505,30,103,129,803,14,77,46,83,91,129,535,839,7,6334,351,0,2,7,35,52150,21217,4147,28203,0
45,1258,773,422,505,30,103,129,803,14,77,46,83,91,129,535,839,7,6334,351,0,2,7,41,52160,21218,4148,28204,0
231,5265,4293,999,3693,19,54,507,4312,9,155,88,170,164,258,1156,1898,4,9368,520,0,2,2,1,52160,21220,4148,28205,1
231,5265,1482,859,1002,125,135,219,1607,16,219,134,251,235,385,1766,3032,9,27804,1544,1,2,2,1,52170,21221,4148,28206,1
50,586,647,139,84,35,284,233,682,0,0,0,0,0,0,0,0,0,0,0,0,2,1,1,52170,21221,4148,28207,1
117,2801,77,34,69,0,0,8,77,3,24,16,29,27,45,114,213,1,387,21,0,2,8,362,52170,21221,4148,28208,1
117,2801,712,438,573,51,9,84,763,14,102,71,128,116,199,733,1364,8,11988,666,0,2,8,362,52180,21222,4148,28209,1
80,1686,53,23,39,0,0,13,53,2,8,4,8,10,12,26,39,1,39,2,0,2,361,0,52180,21222,4148,28210,1
80,1686,515,298,307,33,80,99,548,12,63,44,77,75,121,419,753,7,5527,307,0,2,361,0,52190,21222,4148,28211,1
259,6096,72,33,56,0,4,12,72,1,1,1,1,2,2,0,2,0,1,0,0,2,4,4,52190,21222,4148,28212,1
259,6096,1454,835,1044,76,110,219,1530,17,275,158,296,292,454,2297,3718,9,34017,1889,1,2,4,4,52200,21223,4148,28213,1
97,4426,1338,495,1086,10,64,173,1348,11,122,82,157,133,239,883,1686,7,11934,663,0,2,2,5,52200,21225,4148,28214,1
16,1209,215,129,180,6,0,29,221,8,65,43,72,73,115,415,711,4,3153,175,0,2,1,1,52200,21225,4148,28215,1
79,1686,53,23,39,0,0,13,53,2,8,4,8,10,12,26,39,1,39,2,0,2,5,3,52200,21225,4148,28216,0
79,1686,515,298,307,33,80,99,548,12,63,44,77,75,121,419,753,7,5527,307,0,2,5,3,52210,21225,4148,28217,0
215,5118,722,423,573,19,0,135,741,12,172,101,199,184,300,1320,2257,6,15668,870,0,2,7,0,52210,21227,4148,28219,0
215,5118,1508,847,911,44,250,301,1552,14,148,88,169,162,257,1120,1886,7,15077,837,0,2,7,0,52210,21228,4149,28220,0
222,5253,722,423,573,19,0,135,741,12,172,101,199,184,300,1320,2257,6,15668,870,0,2,97,59,52210,21230,4149,28222,0
222,5253,1508,847,911,44,250,301,1552,14,148,88,169,162,257,1120,1886,7,15077,837,0,2,97,59,52210,21231,4150,28223,0
88,3790,1289,550,1043,56,32,155,1345,10,167,93,185,177,278,1266,2075,5,11498,638,0,2,3,3,52210,21233,4151,28224,0
11,423,75,38,59,1,3,12,76,2,4,2,4,6,6,10,15,1,15,0,0,2,0,1,52210,21233,4151,28225,0
45,2193,722,423,573,19,0,135,741,12,172,101,199,184,300,1320,2257,6,15668,870,0,2,238,9,52210,21235,4151,28227,0
231,5265,4293,999,3693,19,54,507,4312,9,155,88,170,164,258,1156,1898,4,9368,520,0,2,2,1,52210,21237,4151,28228,0
231,5265,1482,859,1002,125,135,219,1607,16,219,134,251,235,385,1766,3032,9,27804,1544,1,2,2,1,52220,21238,4151,28229,0
50,586,647,139,84,35,284,233,682,0,0,0,0,0,0,0,0,0,0,0,0,2,1,1,52220,21238,4151,28230,0
117,2801,77,34,69,0,0,8,77,3,24,16,29,27,45,114,213,1,387,21,0,2,8,362,52220,21238,4151,28231,0
117,2801,712,438,573,51,9,84,763,14,102,71,128,116,199,733,1364,8,11988,666,0,2,8,362,52230,21239,4151,28232,0
79,1686,53,23,39,0,0,13,53,2,8,4,8,10,12,26,39,1,39,2,0,2,363,0,52230,21239,4151,28233,0
79,1686,515,298,307,33,80,99,548,12,63,44,77,75,121,419,753,7,5527,307,0,2,363,0,52240,21239,4151,28234,0
259,6096,72,33,56,0,4,12,72,1,1,1,1,2,2,0,2,0,1,0,0,2,4,4,52240,21239,4151,28235,0
259,6096,1454,835,1044,76,110,219,1530,17,275,158,296,292,454,2297,3718,9,34017,1889,1,2,4,4,52250,21240,4151,28236,0
97,4426,1338,495,1086,10,64,173,1348,11,122,82,157,133,239,883,1686,7,11934,663,0,2,2,5,52250,21242,4151,28237,0
16,1209,215,129,180,6,0,29,221,8,65,43,72,73,115,415,711,4,3153,175,0,2,1,1,52250,21242,4151,28238,0
215,5118,722,423,573,19,0,135,741,12,172,101,199,184,300,1320,2257,6,15668,870,0,2,7,0,52250,21244,4151,28240,0
215,5118,1508,847,911,44,250,301,1552,14,148,88,169,162,257,1120,1886,7,15077,837,0,2,7,0,52250,21245,4152,28241,0
147,6933,1392,870,1177,35,17,170,1427,14,494,280,531,508,811,4473,7289,7,54850,3047,2,2,1,1,52250,21248,4153,28242,0
75,2972,1043,504,840,53,9,147,1096,9,180,112,198,189,310,1377,2344,4,11604,644,0,2,2,2,52250,21250,4153,28243,0
74,3124,1178,367,1042,6,15,115,1184,9,94,51,95,103,146,644,976,4,4439,246,0,2,1,1,52250,21250,4153,28244,0
147,6933,1392,870,1177,35,17,170,1427,14,494,280,531,508,811,4473,7289,7,54850,3047,2,2,1,1,52250,21253,4154,28245,0
75,2972,1043,504,840,53,9,147,1096,9,180,112,198,189,310,1377,2344,4,11604,644,0,2,2,2,52250,21255,4154,28246,0
74,3124,1178,367,1042,6,15,115,1184,9,94,51,95,103,146,644,976,4,4439,246,0,2,1,1,52250,21255,4154,28247,0
108,2071,1178,367,1042,6,15,115,1184,9,94,51,95,103,146,644,976,4,4439,246,0,2,1,1,52250,21255,4154,28248,0
108,2071,177,108,140,8,0,27,185,6,30,16,32,36,48,162,248,3,794,44,0,2,1,1,52250,21257,4154,28249,0
50,586,647,139,84,35,284,233,682,0,0,0,0,0,0,0,0,0,0,0,0,2,13,2,52250,21257,4154,28250,0
108,2071,1178,367,1042,6,15,115,1184,9,94,51,95,103,146,644,976,4,4439,246,0,2,1,1,52250,21257,4154,28251,0
108,2071,177,108,140,8,0,27,185,6,30,16,32,36,48,162,248,3,794,44,0,2,1,1,52250,21259,4154,28252,0
258,6107,72,33,56,0,4,12,72,1,1,1,1,2,2,0,2,0,1,0,0,2,14,7,52250,21259,4154,28253,0
258,6107,1454,835,1044,76,110,219,1530,17,275,158,296,292,454,2297,3718,9,34017,1889,1,2,14,7,52260,21260,4154,28254,0
15,466,42,7,35,4,0,5,46,1,2,1,2,3,3,2,4,0,2,0,0,2,21,6,52260,21260,4154,28255,0
15,466,11,6,10,0,0,1,11,2,4,2,4,6,6,10,15,1,15,0,0,2,21,6,52260,21260,4154,28256,0
15,466,42,7,35,4,0,5,46,1,2,1,2,3,3,2,4,0,2,0,0,2,21,6,52260,21260,4154,28257,0
15,466,11,6,10,0,0,1,11,2,4,2,4,6,6,10,15,1,15,0,0,2,21,6,52260,21260,4154,28258,0
258,6107,72,33,56,0,4,12,72,1,1,1,1,2,2,0,2,0,1,0,0,2,14,7,52260,21260,4154,28259,0
258,6107,1454,835,1044,76,110,219,1530,17,275,158,296,292,454,2297,3718,9,34017,1889,1,2,14,7,52270,21261,4154,28260,0
223,5265,722,423,573,19,0,135,741,12,172,101,199,184,300,1320,2257,6,15668,870,0,2,7,0,52270,21263,4154,28262,0
223,5265,1508,847,911,44,250,301,1552,14,148,88,169,162,257,1120,1886,7,15077,837,0,2,7,0,52270,21264,4155,28263,0
259,6114,72,33,56,0,4,12,72,1,1,1,1,2,2,0,2,0,1,0,0,2,14,7,52270,21264,4155,28264,0
259,6114,1454,835,1044,76,110,219,1530,17,275,158,296,292,454,2297,3718,9,34017,1889,1,2,14,7,52280,21265,4155,28265,0
108,2071,1178,367,1042,6,15,115,1184,9,94,51,95,103,146,644,976,4,4439,246,0,2,1,1,52280,21265,4155,28266,0
108,2071,177,108,140,8,0,27,185,6,30,16,32,36,48,162,248,3,794,44,0,2,1,1,52280,21267,4155,28267,0
15,466,42,7,35,4,0,5,46,1,2,1,2,3,3,2,4,0,2,0,0,2,21,6,52280,21267,4155,28268,0
15,466,11,6,10,0,0,1,11,2,4,2,4,6,6,10,15,1,15,0,0,2,21,6,52280,21267,4155,28269,0
90,3848,1289,550,1043,56,32,155,1345,10,167,93,185,177,278,1266,2075,5,11498,638,0,2,7,0,52280,21269,4156,28270,0
147,6933,1392,870,1177,35,17,170,1427,14,494,280,531,508,811,4473,7289,7,54850,3047,2,2,1,1,52280,21272,4157,28271,0
75,2972,1043,504,840,53,9,147,1096,9,180,112,198,189,310,1377,2344,4,11604,644,0,2,2,2,52280,21274,4157,28272,0
74,3124,1178,367,1042,6,15,115,1184,9,94,51,95,103,146,644,976,4,4439,246,0,2,1,1,52280,21274,4157,28273,0
214,4584,182,127,129,0,0,53,182,5,39,21,42,44,63,217,343,2,926,51,0,2,6,4,52280,21274,4158,28274,1
214,4584,1165,710,800,67,119,181,1232,18,243,153,282,261,435,2000,3492,10,36473,2026,1,2,6,4,52290,21274,4159,28275,1
100,2037,773,419,590,28,0,166,801,10,204,113,217,214,330,1598,2554,5,13587,754,0,2,4,4,52290,21274,4160,28276,1
100,2037,421,273,302,44,34,57,465,17,81,59,107,98,166,583,1098,11,12329,684,0,2,4,4,52290,21274,4161,28277,1
60,1084,282,196,195,3,0,86,285,8,130,71,141,138,212,936,1507,4,6538,363,0,2,2,2,52290,21274,4162,28278,1
17,384,85,59,61,8,0,16,93,5,18,10,18,23,28,86,126,2,316,17,0,2,0,1,52290,21274,4162,28279,1
90,3814,1289,550,1043,56,32,155,1345,10,167,93,185,177,278,1266,2075,5,11498,638,0,2,7,6,52290,21276,4163,28280,1
147,6905,1392,870,1177,35,17,170,1427,14,494,280,531,508,811,4473,7289,7,54850,3047,2,2,10,8,52290,21279,4164,28281,1
87,2871,773,419,590,28,0,166,801,10,204,113,217,214,330,1598,2554,5,13587,754,0,2,4,4,52290,21279,4165,28282,1
97,4414,1338,495,1086,10,64,173,1348,11,122,82,157,133,239,883,1686,7,11934,663,0,2,2,3,52290,21281,4165,28283,1
132,5730,1782,648,1425,9,47,279,1791,8,171,97,189,179,286,1292,2140,4,9462,525,0,2,2,2,52290,21282,4166,28284,1
23,577,102,59,69,5,3,24,107,6,22,15,28,28,43,113,206,3,789,43,0,2,10,9,52290,21282,4166,28285,1
156,4416,1660,832,1314,41,38,274,1701,20,312,209,395,332,604,2671,5058,12,64042,3557,1,2,3,2,52290,21284,4167,28287,1
73,3804,1296,573,1062,40,33,157,1336,8,201,118,231,209,349,1561,2689,4,12365,686,0,2,10,9,52290,21284,4167,28288,1
82,4295,1457,730,1242,11,6,188,1468,10,292,166,329,302,495,2424,4078,5,22973,1276,1,2,5,5,52290,21286,4167,28289,1
39,2324,652,304,544,16,6,88,668,6,89,51,101,95,152,591,998,3,3399,188,0,2,3,3,52290,21287,4167,28290,1
38,2301,334,251,279,10,4,40,344,5,127,74,143,132,217,899,1528,2,4303,239,0,2,2,1,52290,21288,4167,28291,1
33,1886,384,251,317,7,8,52,391,11,70,44,84,81,128,467,811,6,5355,297,0,2,11,9,52290,21288,4167,28292,1
39,1724,386,256,301,16,9,68,402,4,59,35,69,63,104,355,621,2,1453,80,0,2,14,15,52290,21288,4167,28293,1
75,2952,1043,504,840,53,9,147,1096,9,180,112,198,189,310,1377,2344,4,11604,644,0,2,10,8,52290,21290,4167,28294,1
82,4108,1943,715,1694,26,18,214,1969,12,185,120,237,197,357,1436,2721,7,20915,1161,0,2,3,3,52290,21292,4167,28295,1
51,595,647,139,84,35,284,233,682,0,0,0,0,0,0,0,0,0,0,0,0,2,20,2,52290,21292,4167,28296,1
111,2482,1043,504,840,53,9,147,1096,9,180,112,198,189,310,1377,2344,4,11604,644,0,2,3,0,52290,21294,4167,28297,1
111,2482,383,288,292,26,6,62,409,11,65,38,67,76,105,429,656,5,3719,206,0,2,3,0,52290,21295,4167,28298,1
78,3035,1043,504,840,53,9,147,1096,9,180,112,198,189,310,1377,2344,4,11604,644,0,2,12,0,52290,21297,4167,28299,1
214,4584,182,127,129,0,0,53,182,5,39,21,42,44,63,217,343,2,926,51,0,2,6,4,52290,21297,4168,28300,0
214,4584,1165,710,800,67,119,181,1232,18,243,153,282,261,435,2000,3492,10,36473,2026,1,2,6,4,52300,21297,4169,28301,0
100,2037,773,419,590,28,0,166,801,10,204,113,217,214,330,1598,2554,5,13587,754,0,2,4,4,52300,21297,4170,28302,0
100,2037,421,273,302,44,34,57,465,17,81,59,107,98,166,583,1098,11,12329,684,0,2,4,4,52300,21297,4171,28303,0
60,1084,282,196,195,3,0,86,285,8,130,71,141,138,212,936,1507,4,6538,363,0,2,2,2,52300,21297,4172,28304,0
17,384,85,59,61,8,0,16,93,5,18,10,18,23,28,86,126,2,316,17,0,2,0,1,52300,21297,4172,28305,0
90,3814,1289,550,1043,56,32,155,1345,10,167,93,185,177,278,1266,2075,5,11498,638,0,2,7,6,52300,21299,4173,28306,0
147,6905,1392,870,1177,35,17,170,1427,14,494,280,531,508,811,4473,7289,7,54850,3047,2,2,10,8,52300,21302,4174,28307,0
87,2871,773,419,590,28,0,166,801,10,204,113,217,214,330,1598,2554,5,13587,754,0,2,4,4,52300,21302,4175,28308,0
97,4414,1338,495,1086,10,64,173,1348,11,122,82,157,133,239,883,1686,7,11934,663,0,2,2,3,52300,21304,4175,28309,0
132,5730,1782,648,1425,9,47,279,1791,8,171,97,189,179,286,1292,2140,4,9462,525,0,2,2,2,52300,21305,4176,28310,0
23,577,102,59,69,5,3,24,107,6,22,15,28,28,43,113,206,3,789,43,0,2,10,9,52300,21305,4176,28311,0
156,4416,1660,832,1314,41,38,274,1701,20,312,209,395,332,604,2671,5058,12,64042,3557,1,2,3,2,52300,21307,4177,28313,0
73,3804,1296,573,1062,40,33,157,1336,8,201,118,231,209,349,1561,2689,4,12365,686,0,2,10,9,52300,21307,4177,28314,0
82,4295,1457,730,1242,11,6,188,1468,10,292,166,329,302,495,2424,4078,5,22973,1276,1,2,5,5,52300,21309,4177,28315,0
39,2324,652,304,544,16,6,88,668,6,89,51,101,95,152,591,998,3,3399,188,0,2,3,3,52300,21310,4177,28316,0
38,2301,334,251,279,10,4,40,344,5,127,74,143,132,217,899,1528,2,4303,239,0,2,2,1,52300,21311,4177,28317,0
33,1886,384,251,317,7,8,52,391,11,70,44,84,81,128,467,811,6,5355,297,0,2,11,9,52300,21311,4177,28318,0
39,1724,386,256,301,16,9,68,402,4,59,35,69,63,104,355,621,2,1453,80,0,2,14,15,52300,21311,4177,28319,0
75,2952,1043,504,840,53,9,147,1096,9,180,112,198,189,310,1377,2344,4,11604,644,0,2,10,8,52300,21313,4177,28320,0
82,4108,1943,715,1694,26,18,214,1969,12,185,120,237,197,357,1436,2721,7,20915,1161,0,2,3,3,52300,21315,4177,28321,0
51,595,647,139,84,35,284,233,682,0,0,0,0,0,0,0,0,0,0,0,0,2,20,2,52300,21315,4177,28322,0
111,2482,1043,504,840,53,9,147,1096,9,180,112,198,189,310,1377,2344,4,11604,644,0,2,3,0,52300,21317,4177,28323,0
111,2482,383,288,292,26,6,62,409,11,65,38,67,76,105,429,656,5,3719,206,0,2,3,0,52300,21318,4177,28324,0
78,3035,1043,504,840,53,9,147,1096,9,180,112,198,189,310,1377,2344,4,11604,644,0,2,12,0,52300,21320,4177,28325,0
50,586,647,139,84,35,284,233,682,0,0,0,0,0,0,0,0,0,0,0,0,2,13,2,52300,21320,4177,28326,0
227,5227,4293,999,3693,19,54,507,4312,9,155,88,170,164,258,1156,1898,4,9368,520,0,2,42,48,52300,21322,4177,28327,1
227,5227,1482,859,1002,125,135,219,1607,16,219,134,251,235,385,1766,3032,9,27804,1544,1,2,42,48,52310,21323,4177,28328,1
230,5249,4293,999,3693,19,54,507,4312,9,155,88,170,164,258,1156,1898,4,9368,520,0,2,12,17,52310,21325,4177,28329,1
230,5249,1482,859,1002,125,135,219,1607,16,219,134,251,235,385,1766,3032,9,27804,1544,1,2,12,17,52320,21326,4177,28330,1
206,4323,1943,715,1694,26,18,214,1969,12,185,120,237,197,357,1436,2721,7,20915,1161,0,2,18,21,52320,21328,4177,28331,1
206,4323,1168,838,957,57,25,144,1225,19,348,224,416,367,640,3018,5452,11,61921,3440,1,2,18,21,52330,21330,4177,28332,1
90,4382,1943,715,1694,26,18,214,1969,12,185,120,237,197,357,1436,2721,7,20915,1161,0,2,81,6,52330,21332,4177,28333,1
207,4339,1943,715,1694,26,18,214,1969,12,185,120,237,197,357,1436,2721,7,20915,1161,0,2,11,2,52330,21334,4177,28334,0
207,4339,1168,838,957,57,25,144,1225,19,348,224,416,367,640,3018,5452,11,61921,3440,1,2,11,2,52340,21336,4177,28335,0
207,4339,1943,715,1694,26,18,214,1969,12,185,120,237,197,357,1436,2721,7,20915,1161,0,2,27,21,52340,21338,4177,28336,0
207,4339,1168,838,957,57,25,144,1225,19,348,224,416,367,640,3018,5452,11,61921,3440,1,2,27,21,52350,21340,4177,28337,0
90,4382,1943,715,1694,26,18,214,1969,12,185,120,237,197,357,1436,2721,7,20915,1161,0,2,81,6,52350,21342,4177,28338,0
34,1617,1293,570,1093,25,15,163,1318,10,195,123,241,205,364,1516,2795,6,17273,959,0,2,1,2,52360,21344,4177,28339,0
103,2142,1020,354,843,12,15,144,1032,8,134,77,144,142,221,970,1580,4,6792,377,0,2,13,1,52360,21344,4177,28340,1
77,3417,1020,354,843,12,15,144,1032,8,134,77,144,142,221,970,1580,4,6792,377,0,2,15,0,52360,21344,4177,28341,1
104,2098,1020,354,843,12,15,144,1032,8,134,77,144,142,221,970,1580,4,6792,377,0,2,5,7,52360,21344,4177,28342,1
104,2104,1020,354,843,12,15,144,1032,8,134,77,144,142,221,970,1580,4,6792,377,0,2,4,2,52360,21344,4177,28343,0
77,3416,1020,354,843,12,15,144,1032,8,134,77,144,142,221,970,1580,4,6792,377,0,2,3,3,52360,21344,4177,28344,0
348,6977,1457,730,1242,11,6,188,1468,10,292,166,329,302,495,2424,4078,5,22973,1276,1,2,2,1,52360,21346,4177,28345,0
348,6977,74,35,59,1,0,14,75,3,14,7,14,17,21,58,85,1,128,7,0,2,2,1,52360,21347,4177,28346,0
348,6977,245,125,200,5,7,34,250,7,30,17,34,37,51,166,265,3,1053,58,0,2,2,1,52370,21348,4177,28347,0
348,6977,1457,730,1242,11,6,188,1468,10,292,166,329,302,495,2424,4078,5,22973,1276,1,2,2,1,52370,21350,4177,28348,0
348,6977,74,35,59,1,0,14,75,3,14,7,14,17,21,58,85,1,128,7,0,2,2,1,52370,21351,4177,28349,0
348,6977,245,125,200,5,7,34,250,7,30,17,34,37,51,166,265,3,1053,58,0,2,2,1,52380,21352,4177,28350,0
104,2104,1020,354,843,12,15,144,1032,8,134,77,144,142,221,970,1580,4,6792,377,0,2,13,1,52380,21352,4177,28351,0
77,3416,1020,354,843,12,15,144,1032,8,134,77,144,142,221,970,1580,4,6792,377,0,2,15,0,52380,21352,4177,28352,0
120,2925,77,34,69,0,0,8,77,3,24,16,29,27,45,114,213,1,387,21,0,2,19,0,52380,21352,4177,28353,1
120,2925,712,438,573,51,9,84,763,14,102,71,128,116,199,733,1364,8,11988,666,0,2,19,0,52390,21353,4177,28354,1
28,1220,373,158,315,8,0,51,381,5,76,44,79,81,123,486,779,2,2026,112,0,2,32,0,52390,21353,4177,28355,1
28,1210,373,158,315,8,0,51,381,5,76,44,79,81,123,486,779,2,2026,112,0,2,0,1,52390,21353,4177,28356,0
48,1310,773,422,505,30,103,129,803,14,77,46,83,91,129,535,839,7,6334,351,0,2,12,0,52400,21354,4178,28357,0
12,489,139,89,101,2,0,35,141,7,54,34,62,61,96,330,569,4,2287,127,0,2,21,0,52400,21354,4178,28358,0
48,1310,773,422,505,30,103,129,803,14,77,46,83,91,129,535,839,7,6334,351,0,2,12,0,52410,21355,4179,28359,0
12,489,139,89,101,2,0,35,141,7,54,34,62,61,96,330,569,4,2287,127,0,2,21,0,52410,21355,4179,28360,0
50,1354,773,422,505,30,103,129,803,14,77,46,83,91,129,535,839,7,6334,351,0,2,28,18,52420,21356,4180,28361,1
24,1115,1157,318,931,29,22,177,1186,6,104,63,125,110,188,712,1274,3,4596,255,0,2,29,0,52420,21356,4180,28362,1
50,1361,773,422,505,30,103,129,803,14,77,46,83,91,129,535,839,7,6334,351,0,2,15,17,52430,21357,4181,28363,1
23,1137,1157,318,931,29,22,177,1186,6,104,63,125,110,188,712,1274,3,4596,255,0,2,20,15,52430,21357,4181,28364,1
51,1412,773,422,505,30,103,129,803,14,77,46,83,91,129,535,839,7,6334,351,0,2,28,12,52440,21358,4182,28365,0
13,565,139,89,101,2,0,35,141,7,54,34,62,61,96,330,569,4,2287,127,0,2,28,0,52440,21358,4182,28366,0
53,1452,773,422,505,30,103,129,803,14,77,46,83,91,129,535,839,7,6334,351,0,2,26,19,52450,21359,4183,28367,1
23,1145,1157,318,931,29,22,177,1186,6,104,63,125,110,188,712,1274,3,4596,255,0,2,18,14,52450,21359,4183,28368,1
53,1452,773,422,505,30,103,129,803,14,77,46,83,91,129,535,839,7,6334,351,0,2,1,0,52460,21360,4184,28369,0
23,1101,1157,318,931,29,22,177,1186,6,104,63,125,110,188,712,1274,3,4596,255,0,2,5,19,52460,21360,4184,28370,0
57,1539,773,422,505,30,103,129,803,14,77,46,83,91,129,535,839,7,6334,351,0,2,23,1,52470,21361,4185,28371,0
23,1108,1157,318,931,29,22,177,1186,6,104,63,125,110,188,712,1274,3,4596,255,0,2,6,1,52470,21361,4185,28372,0
57,1539,773,422,505,30,103,129,803,14,77,46,83,91,129,535,839,7,6334,351,0,2,11,24,52480,21362,4186,28373,0
17,1072,1157,318,931,29,22,177,1186,6,104,63,125,110,188,712,1274,3,4596,255,0,2,3,18,52480,21362,4186,28374,0
63,1639,773,422,505,30,103,129,803,14,77,46,83,91,129,535,839,7,6334,351,0,2,32,8,52490,21363,4187,28375,1
24,1310,1157,318,931,29,22,177,1186,6,104,63,125,110,188,712,1274,3,4596,255,0,2,85,0,52490,21363,4187,28376,1
23,1297,1157,318,931,29,22,177,1186,6,104,63,125,110,188,712,1274,3,4596,255,0,2,2,9,52490,21363,4187,28377,0
13,571,139,89,101,2,0,35,141,7,54,34,62,61,96,330,569,4,2287,127,0,2,1,0,52490,21363,4187,28378,0
63,1639,773,422,505,30,103,129,803,14,77,46,83,91,129,535,839,7,6334,351,0,2,3,1,52500,21364,4188,28379,0
352,7047,1457,730,1242,11,6,188,1468,10,292,166,329,302,495,2424,4078,5,22973,1276,1,2,11,2,52500,21366,4188,28380,1
352,7047,74,35,59,1,0,14,75,3,14,7,14,17,21,58,85,1,128,7,0,2,11,2,52500,21367,4188,28381,1
352,7047,245,125,200,5,7,34,250,7,30,17,34,37,51,166,265,3,1053,58,0,2,11,2,52510,21368,4188,28382,1
117,2821,77,34,69,0,0,8,77,3,24,16,29,27,45,114,213,1,387,21,0,2,1,14,52510,21368,4188,28383,1
117,2821,712,438,573,51,9,84,763,14,102,71,128,116,199,733,1364,8,11988,666,0,2,1,14,52520,21369,4188,28384,1
27,1108,373,158,315,8,0,51,381,5,76,44,79,81,123,486,779,2,2026,112,0,2,0,18,52520,21369,4188,28385,1
50,586,647,139,84,35,284,233,682,0,0,0,0,0,0,0,0,0,0,0,0,2,9,1,52520,21369,4188,28386,0
50,586,647,139,84,35,284,233,682,0,0,0,0,0,0,0,0,0,0,0,0,2,20,1,52520,21369,4188,28387,0
50,586,647,139,84,35,284,233,682,0,0,0,0,0,0,0,0,0,0,0,0,2,20,1,52520,21369,4188,28388,0
50,586,647,139,84,35,284,233,682,0,0,0,0,0,0,0,0,0,0,0,0,2,9,1,52520,21369,4188,28389,0
67,1738,773,422,505,30,103,129,803,14,77,46,83,91,129,535,839,7,6334,351,0,2,17,7,52530,21370,4189,28390,0
25,1443,1157,318,931,29,22,177,1186,6,104,63,125,110,188,712,1274,3,4596,255,0,2,62,8,52530,21370,4189,28391,0
87,2475,1523,757,1297,19,12,193,1542,12,193,117,230,205,347,1508,2664,7,19053,1058,0,2,26,0,52540,21372,4189,28392,1
87,2475,701,378,504,33,58,109,734,13,110,68,126,123,194,794,1346,7,10027,557,0,2,26,0,52540,21373,4190,28393,1
91,4494,1523,757,1297,19,12,193,1542,12,193,117,230,205,347,1508,2664,7,19053,1058,0,2,21,0,52550,21375,4190,28394,1
69,1729,773,422,505,30,103,129,803,14,77,46,83,91,129,535,839,7,6334,351,0,2,12,9,52560,21376,4191,28395,0
25,1433,1157,318,931,29,22,177,1186,6,104,63,125,110,188,712,1274,3,4596,255,0,2,1,4,52560,21376,4191,28396,0
25,1432,1157,318,931,29,22,177,1186,6,104,63,125,110,188,712,1274,3,4596,255,0,2,2,2,52560,21376,4191,28397,0
68,1718,773,422,505,30,103,129,803,14,77,46,83,91,129,535,839,7,6334,351,0,2,1,2,52570,21377,4192,28398,0
25,1432,1157,318,931,29,22,177,1186,6,104,63,125,110,188,712,1274,3,4596,255,0,2,2,2,52570,21377,4192,28399,0
68,1718,773,422,505,30,103,129,803,14,77,46,83,91,129,535,839,7,6334,351,0,2,1,1,52580,21378,4193,28400,0
34,1617,1293,570,1093,25,15,163,1318,10,195,123,241,205,364,1516,2795,6,17273,959,0,2,1,2,52590,21380,4193,28401,0
349,6987,1457,730,1242,11,6,188,1468,10,292,166,329,302,495,2424,4078,5,22973,1276,1,2,4,1,52590,21382,4193,28402,0
349,6987,74,35,59,1,0,14,75,3,14,7,14,17,21,58,85,1,128,7,0,2,4,1,52590,21383,4193,28403,0
349,6987,245,125,200,5,7,34,250,7,30,17,34,37,51,166,265,3,1053,58,0,2,4,1,52600,21384,4193,28404,0
84,4398,1457,730,1242,11,6,188,1468,10,292,166,329,302,495,2424,4078,5,22973,1276,1,2,37,0,52600,21386,4193,28405,0
83,4348,1457,730,1242,11,6,188,1468,10,292,166,329,302,495,2424,4078,5,22973,1276,1,2,8,36,52600,21388,4193,28406,0
83,4374,1457,730,1242,11,6,188,1468,10,292,166,329,302,495,2424,4078,5,22973,1276,1,2,9,4,52600,21390,4193,28407,0
347,6972,1457,730,1242,11,6,188,1468,10,292,166,329,302,495,2424,4078,5,22973,1276,1,2,8,12,52600,21392,4193,28408,1
347,6972,74,35,59,1,0,14,75,3,14,7,14,17,21,58,85,1,128,7,0,2,8,12,52600,21393,4193,28409,1
347,6972,245,125,200,5,7,34,250,7,30,17,34,37,51,166,265,3,1053,58,0,2,8,12,52610,21394,4193,28410,1
27,950,74,35,59,1,0,14,75,3,14,7,14,17,21,58,85,1,128,7,0,2,2,2,52610,21395,4193,28411,1
27,950,245,125,200,5,7,34,250,7,30,17,34,37,51,166,265,3,1053,58,0,2,2,2,52620,21396,4193,28412,1
84,4416,1457,730,1242,11,6,188,1468,10,292,166,329,302,495,2424,4078,5,22973,1276,1,2,36,16,52620,21398,4193,28413,1
11,238,19,8,11,5,0,4,24,2,5,3,6,7,9,13,25,1,30,1,0,2,1,1,52620,21398,4193,28414,1
11,238,102,59,69,5,3,24,107,6,22,15,28,28,43,113,206,3,789,43,0,2,1,1,52620,21398,4193,28415,1
11,238,106,40,36,3,49,17,109,8,17,13,23,25,36,93,167,5,904,50,0,2,1,1,52620,21398,4193,28416,1
26,527,2,2,2,0,0,0,2,0,0,0,0,0,0,0,0,0,0,0,0,2,1,1,52620,21398,4193,28416,1
26,527,99,48,90,1,3,5,100,0,0,0,0,0,0,0,0,0,0,0,0,2,1,1,52620,21399,4193,28417,1
26,527,8,5,5,2,0,1,10,0,0,0,0,0,0,0,0,0,0,0,0,2,1,1,52620,21399,4193,28418,1
26,527,1217,716,841,84,126,174,1301,14,185,118,215,199,333,1446,2542,8,20687,1149,0,2,1,1,52630,21401,4193,28419,1
26,527,160,89,115,0,13,31,160,7,15,11,17,22,28,78,124,3,495,27,0,2,1,1,52630,21401,4193,28420,1
26,527,10,10,9,9,0,0,19,0,0,0,0,0,0,0,0,0,0,0,0,2,1,1,52630,21401,4194,28421,1
26,527,173,84,99,8,29,36,181,5,12,7,13,17,20,54,81,2,221,12,0,2,1,1,52630,21402,4194,28422,1
26,527,3,1,1,3,0,0,6,0,0,0,0,0,0,0,0,0,0,0,0,2,1,1,52630,21402,4194,28423,1
59,1355,996,429,845,24,10,117,1020,7,76,50,88,83,138,494,879,4,3565,198,0,2,1,1,52630,21404,4194,28424,1
59,1355,456,277,329,12,42,72,468,13,85,50,97,98,147,592,972,7,7212,400,0,2,1,1,52630,21404,4194,28425,1
141,2977,1513,682,1277,25,13,200,1538,11,199,116,219,210,335,1557,2584,6,15641,868,0,2,6,6,52630,21406,4194,28426,1
141,2977,819,519,539,24,98,155,843,15,96,57,106,111,163,690,1107,8,9171,509,0,2,6,6,52640,21408,4194,28427,1
348,6992,1457,730,1242,11,6,188,1468,10,292,166,329,302,495,2424,4078,5,22973,1276,1,2,5,5,52640,21410,4194,28428,1
348,6992,74,35,59,1,0,14,75,3,14,7,14,17,21,58,85,1,128,7,0,2,5,5,52640,21411,4194,28429,1
348,6992,245,125,200,5,7,34,250,7,30,17,34,37,51,166,265,3,1053,58,0,2,5,5,52650,21412,4194,28430,1
21,668,339,213,244,17,9,65,356,10,42,26,48,52,74,259,421,5,2410,133,0,2,2,2,52660,21412,4194,28431,1
231,5277,4293,999,3693,19,54,507,4312,9,155,88,170,164,258,1156,1898,4,9368,520,0,2,4,4,52660,21414,4194,28432,1
231,5277,1482,859,1002,125,135,219,1607,16,219,134,251,235,385,1766,3032,9,27804,1544,1,2,4,4,52670,21415,4194,28433,1
117,2804,77,34,69,0,0,8,77,3,24,16,29,27,45,114,213,1,387,21,0,2,1,1,52670,21415,4194,28434,1
117,2804,712,438,573,51,9,84,763,14,102,71,128,116,199,733,1364,8,11988,666,0,2,1,1,52680,21416,4194,28435,1
104,2107,1020,354,843,12,15,144,1032,8,134,77,144,142,221,970,1580,4,6792,377,0,2,1,1,52680,21416,4194,28436,1
46,963,447,308,343,6,5,95,453,7,96,59,111,103,170,651,1136,4,4600,255,0,2,2,2,52680,21419,4194,28437,1
46,963,322,174,179,16,74,51,338,10,41,26,46,51,72,252,408,5,2291,127,0,2,2,2,52680,21422,4195,28438,1
223,5307,722,423,573,19,0,135,741,12,172,101,199,184,300,1320,2257,6,15668,870,0,2,14,14,52680,21424,4195,28440,1
223,5307,1508,847,911,44,250,301,1552,14,148,88,169,162,257,1120,1886,7,15077,837,0,2,14,14,52680,21425,4196,28441,1
111,2485,1043,504,840,53,9,147,1096,9,180,112,198,189,310,1377,2344,4,11604,644,0,2,1,1,52680,21427,4196,28442,1
111,2485,383,288,292,26,6,62,409,11,65,38,67,76,105,429,656,5,3719,206,0,2,1,1,52680,21428,4196,28443,1
207,4345,1943,715,1694,26,18,214,1969,12,185,120,237,197,357,1436,2721,7,20915,1161,0,2,2,2,52680,21430,4196,28444,1
207,4345,1168,838,957,57,25,144,1225,19,348,224,416,367,640,3018,5452,11,61921,3440,1,2,2,2,52690,21432,4196,28445,1
16,480,442,244,305,14,16,103,456,11,68,45,75,79,120,452,756,6,4588,254,0,2,1,1,52690,21434,4196,28446,1
16,480,182,102,99,11,40,35,193,3,11,6,11,14,17,42,64,1,97,5,0,2,1,1,52690,21435,4196,28447,1
90,3848,1289,550,1043,56,32,155,1345,10,167,93,185,177,278,1266,2075,5,11498,638,0,2,1,1,52690,21437,4197,28448,1
97,4426,1338,495,1086,10,64,173,1348,11,122,82,157,133,239,883,1686,7,11934,663,0,2,2,2,52690,21439,4197,28449,1
162,7134,139,89,101,2,0,35,141,7,54,34,62,61,96,330,569,4,2287,127,0,2,1,1,52690,21439,4197,28450,1
162,7134,7,5,5,0,0,2,7,1,2,1,2,3,3,2,4,0,2,0,0,2,1,1,52690,21439,4197,28451,1
135,5792,1782,648,1425,9,47,279,1791,8,171,97,189,179,286,1292,2140,4,9462,525,0,2,1,1,52690,21440,4198,28452,1
128,5159,1513,682,1277,25,13,200,1538,11,199,116,219,210,335,1557,2584,6,15641,868,0,2,1,1,52690,21442,4198,28453,1
45,2208,722,423,573,19,0,135,741,12,172,101,199,184,300,1320,2257,6,15668,870,0,2,5,5,52690,21444,4198,28455,1
90,4388,1943,715,1694,26,18,214,1969,12,185,120,237,197,357,1436,2721,7,20915,1161,0,2,2,2,52690,21446,4198,28456,1
69,1731,773,422,505,30,103,129,803,14,77,46,83,91,129,535,839,7,6334,351,0,2,15,4,52700,21447,4199,28457,0
13,563,139,89,101,2,0,35,141,7,54,34,62,61,96,330,569,4,2287,127,0,2,4,4,52700,21447,4199,28458,0
347,6972,1457,730,1242,11,6,188,1468,10,292,166,329,302,495,2424,4078,5,22973,1276,1,2,8,9,52700,21449,4199,28459,0
347,6972,74,35,59,1,0,14,75,3,14,7,14,17,21,58,85,1,128,7,0,2,8,9,52700,21450,4199,28460,0
347,6972,245,125,200,5,7,34,250,7,30,17,34,37,51,166,265,3,1053,58,0,2,8,9,52710,21451,4199,28461,0
27,950,74,35,59,1,0,14,75,3,14,7,14,17,21,58,85,1,128,7,0,2,2,2,52710,21452,4199,28462,0
27,950,245,125,200,5,7,34,250,7,30,17,34,37,51,166,265,3,1053,58,0,2,2,2,52720,21453,4199,28463,0
84,4416,1457,730,1242,11,6,188,1468,10,292,166,329,302,495,2424,4078,5,22973,1276,1,2,39,5,52720,21455,4199,28464,0
11,238,19,8,11,5,0,4,24,2,5,3,6,7,9,13,25,1,30,1,0,2,1,1,52720,21455,4199,28465,0
11,238,102,59,69,5,3,24,107,6,22,15,28,28,43,113,206,3,789,43,0,2,1,1,52720,21455,4199,28466,0
11,238,106,40,36,3,49,17,109,8,17,13,23,25,36,93,167,5,904,50,0,2,1,1,52720,21455,4199,28467,0
26,527,2,2,2,0,0,0,2,0,0,0,0,0,0,0,0,0,0,0,0,2,1,1,52720,21455,4199,28467,0
26,527,99,48,90,1,3,5,100,0,0,0,0,0,0,0,0,0,0,0,0,2,1,1,52720,21456,4199,28468,0
26,527,8,5,5,2,0,1,10,0,0,0,0,0,0,0,0,0,0,0,0,2,1,1,52720,21456,4199,28469,0
26,527,1217,716,841,84,126,174,1301,14,185,118,215,199,333,1446,2542,8,20687,1149,0,2,1,1,52730,21458,4199,28470,0
26,527,160,89,115,0,13,31,160,7,15,11,17,22,28,78,124,3,495,27,0,2,1,1,52730,21458,4199,28471,0
26,527,10,10,9,9,0,0,19,0,0,0,0,0,0,0,0,0,0,0,0,2,1,1,52730,21458,4200,28472,0
26,527,173,84,99,8,29,36,181,5,12,7,13,17,20,54,81,2,221,12,0,2,1,1,52730,21459,4200,28473,0
26,527,3,1,1,3,0,0,6,0,0,0,0,0,0,0,0,0,0,0,0,2,1,1,52730,21459,4200,28474,0
59,1355,996,429,845,24,10,117,1020,7,76,50,88,83,138,494,879,4,3565,198,0,2,1,1,52730,21461,4200,28475,0
59,1355,456,277,329,12,42,72,468,13,85,50,97,98,147,592,972,7,7212,400,0,2,1,1,52730,21461,4200,28476,0
141,2977,1513,682,1277,25,13,200,1538,11,199,116,219,210,335,1557,2584,6,15641,868,0,2,6,6,52730,21463,4200,28477,0
141,2977,819,519,539,24,98,155,843,15,96,57,106,111,163,690,1107,8,9171,509,0,2,6,6,52740,21465,4200,28478,0
347,6987,1457,730,1242,11,6,188,1468,10,292,166,329,302,495,2424,4078,5,22973,1276,1,2,5,5,52740,21467,4200,28479,0
347,6987,74,35,59,1,0,14,75,3,14,7,14,17,21,58,85,1,128,7,0,2,5,5,52740,21468,4200,28480,0
347,6987,245,125,200,5,7,34,250,7,30,17,34,37,51,166,265,3,1053,58,0,2,5,5,52750,21469,4200,28481,0
21,668,339,213,244,17,9,65,356,10,42,26,48,52,74,259,421,5,2410,133,0,2,2,2,52760,21469,4200,28482,0
231,5277,4293,999,3693,19,54,507,4312,9,155,88,170,164,258,1156,1898,4,9368,520,0,2,4,4,52760,21471,4200,28483,0
231,5277,1482,859,1002,125,135,219,1607,16,219,134,251,235,385,1766,3032,9,27804,1544,1,2,4,4,52770,21472,4200,28484,0
117,2804,77,34,69,0,0,8,77,3,24,16,29,27,45,114,213,1,387,21,0,2,1,1,52770,21472,4200,28485,0
117,2804,712,438,573,51,9,84,763,14,102,71,128,116,199,733,1364,8,11988,666,0,2,1,1,52780,21473,4200,28486,0
104,2107,1020,354,843,12,15,144,1032,8,134,77,144,142,221,970,1580,4,6792,377,0,2,1,1,52780,21473,4200,28487,0
46,963,447,308,343,6,5,95,453,7,96,59,111,103,170,651,1136,4,4600,255,0,2,2,2,52780,21476,4200,28488,0
46,963,322,174,179,16,74,51,338,10,41,26,46,51,72,252,408,5,2291,127,0,2,2,2,52780,21479,4201,28489,0
223,5307,722,423,573,19,0,135,741,12,172,101,199,184,300,1320,2257,6,15668,870,0,2,14,14,52780,21481,4201,28491,0
223,5307,1508,847,911,44,250,301,1552,14,148,88,169,162,257,1120,1886,7,15077,837,0,2,14,14,52780,21482,4202,28492,0
111,2485,1043,504,840,53,9,147,1096,9,180,112,198,189,310,1377,2344,4,11604,644,0,2,1,1,52780,21484,4202,28493,0
111,2485,383,288,292,26,6,62,409,11,65,38,67,76,105,429,656,5,3719,206,0,2,1,1,52780,21485,4202,28494,0
207,4345,1943,715,1694,26,18,214,1969,12,185,120,237,197,357,1436,2721,7,20915,1161,0,2,2,2,52780,21487,4202,28495,0
207,4345,1168,838,957,57,25,144,1225,19,348,224,416,367,640,3018,5452,11,61921,3440,1,2,2,2,52790,21489,4202,28496,0
16,480,442,244,305,14,16,103,456,11,68,45,75,79,120,452,756,6,4588,254,0,2,1,1,52790,21491,4202,28497,0
16,480,182,102,99,11,40,35,193,3,11,6,11,14,17,42,64,1,97,5,0,2,1,1,52790,21492,4202,28498,0
90,3848,1289,550,1043,56,32,155,1345,10,167,93,185,177,278,1266,2075,5,11498,638,0,2,1,1,52790,21494,4203,28499,0
97,4426,1338,495,1086,10,64,173,1348,11,122,82,157,133,239,883,1686,7,11934,663,0,2,2,2,52790,21496,4203,28500,0
162,7134,139,89,101,2,0,35,141,7,54,34,62,61,96,330,569,4,2287,127,0,2,1,1,52790,21496,4203,28501,0
162,7134,7,5,5,0,0,2,7,1,2,1,2,3,3,2,4,0,2,0,0,2,1,1,52790,21496,4203,28502,0
135,5792,1782,648,1425,9,47,279,1791,8,171,97,189,179,286,1292,2140,4,9462,525,0,2,1,1,52790,21497,4204,28503,0
128,5159,1513,682,1277,25,13,200,1538,11,199,116,219,210,335,1557,2584,6,15641,868,0,2,1,1,52790,21499,4204,28504,0
45,2208,722,423,573,19,0,135,741,12,172,101,199,184,300,1320,2257,6,15668,870,0,2,5,5,52790,21501,4204,28506,0
90,4388,1943,715,1694,26,18,214,1969,12,185,120,237,197,357,1436,2721,7,20915,1161,0,2,2,2,52790,21503,4204,28507,0
28,1141,373,158,315,8,0,51,381,5,76,44,79,81,123,486,779,2,2026,112,0,2,16,4,52790,21503,4204,28508,1
352,7034,1457,730,1242,11,6,188,1468,10,292,166,329,302,495,2424,4078,5,22973,1276,1,2,0,1,52790,21505,4204,28509,0
352,7034,74,35,59,1,0,14,75,3,14,7,14,17,21,58,85,1,128,7,0,2,0,1,52790,21506,4204,28510,0
352,7034,245,125,200,5,7,34,250,7,30,17,34,37,51,166,265,3,1053,58,0,2,0,1,52800,21507,4204,28511,0
59,1355,996,429,845,24,10,117,1020,7,76,50,88,83,138,494,879,4,3565,198,0,2,3,2,52800,21509,4204,28512,0
59,1355,456,277,329,12,42,72,468,13,85,50,97,98,147,592,972,7,7212,400,0,2,3,2,52800,21509,4204,28513,0
22,666,339,213,244,17,9,65,356,10,42,26,48,52,74,259,421,5,2410,133,0,2,11,7,52810,21509,4204,28514,0
105,2128,1020,354,843,12,15,144,1032,8,134,77,144,142,221,970,1580,4,6792,377,0,2,10,5,52810,21509,4204,28515,1
259,6118,72,33,56,0,4,12,72,1,1,1,1,2,2,0,2,0,1,0,0,2,1,1,52810,21509,4204,28516,1
259,6118,1454,835,1044,76,110,219,1530,17,275,158,296,292,454,2297,3718,9,34017,1889,1,2,1,1,52820,21510,4204,28517,1
108,2217,1020,354,843,12,15,144,1032,8,134,77,144,142,221,970,1580,4,6792,377,0,2,19,2,52820,21510,4204,28518,0
82,3538,1020,354,843,12,15,144,1032,8,134,77,144,142,221,970,1580,4,6792,377,0,2,23,0,52820,21510,4204,28519,0
138,5836,1782,648,1425,9,47,279,1791,8,171,97,189,179,286,1292,2140,4,9462,525,0,2,15,3,52820,21511,4205,28520,1
82,3550,1020,354,843,12,15,144,1032,8,134,77,144,142,221,970,1580,4,6792,377,0,2,1,1,52820,21511,4205,28521,0
69,1731,773,422,505,30,103,129,803,14,77,46,83,91,129,535,839,7,6334,351,0,2,154,64,52830,21512,4206,28522,0
13,563,139,89,101,2,0,35,141,7,54,34,62,61,96,330,569,4,2287,127,0,2,33,4,52830,21512,4206,28523,0
25,1432,1157,318,931,29,22,177,1186,6,104,63,125,110,188,712,1274,3,4596,255,0,2,193,50,52830,21512,4206,28524,0
108,2217,1020,354,843,12,15,144,1032,8,134,77,144,142,221,970,1580,4,6792,377,0,2,2,2,52830,21512,4206,28525,0
108,2217,1020,354,843,12,15,144,1032,8,134,77,144,142,221,970,1580,4,6792,377,0,2,1,1,52830,21512,4206,28526,0
82,3556,1020,354,843,12,15,144,1032,8,134,77,144,142,221,970,1580,4,6792,377,0,2,3,3,52830,21512,4206,28527,0
108,2218,1020,354,843,12,15,144,1032,8,134,77,144,142,221,970,1580,4,6792,377,0,2,7,6,52830,21512,4206,28528,0
82,3566,1020,354,843,12,15,144,1032,8,134,77,144,142,221,970,1580,4,6792,377,0,2,6,2,52830,21512,4206,28529,0
59,1355,996,429,845,24,10,117,1020,7,76,50,88,83,138,494,879,4,3565,198,0,2,3,2,52830,21514,4206,28530,0
59,1355,456,277,329,12,42,72,468,13,85,50,97,98,147,592,972,7,7212,400,0,2,3,2,52830,21514,4206,28531,0
108,2218,1020,354,843,12,15,144,1032,8,134,77,144,142,221,970,1580,4,6792,377,0,2,28,5,52830,21514,4206,28532,0
259,6118,72,33,56,0,4,12,72,1,1,1,1,2,2,0,2,0,1,0,0,2,1,1,52830,21514,4206,28533,0
259,6118,1454,835,1044,76,110,219,1530,17,275,158,296,292,454,2297,3718,9,34017,1889,1,2,1,1,52840,21515,4206,28534,0
138,5836,1782,648,1425,9,47,279,1791,8,171,97,189,179,286,1292,2140,4,9462,525,0,2,15,3,52840,21516,4207,28535,0
82,3566,1020,354,843,12,15,144,1032,8,134,77,144,142,221,970,1580,4,6792,377,0,2,28,1,52840,21516,4207,28536,0
214,4584,182,127,129,0,0,53,182,5,39,21,42,44,63,217,343,2,926,51,0,2,6,4,52840,21516,4208,28537,0
214,4584,1165,710,800,67,119,181,1232,18,243,153,282,261,435,2000,3492,10,36473,2026,1,2,6,4,52850,21516,4209,28538,0
100,2037,773,419,590,28,0,166,801,10,204,113,217,214,330,1598,2554,5,13587,754,0,2,4,4,52850,21516,4210,28539,0
100,2037,421,273,302,44,34,57,465,17,81,59,107,98,166,583,1098,11,12329,684,0,2,4,4,52850,21516,4211,28540,0
51,595,647,139,84,35,284,233,682,0,0,0,0,0,0,0,0,0,0,0,0,2,42,4,52850,21516,4211,28541,0
60,1084,282,196,195,3,0,86,285,8,130,71,141,138,212,936,1507,4,6538,363,0,2,2,2,52850,21516,4212,28542,0
17,384,85,59,61,8,0,16,93,5,18,10,18,23,28,86,126,2,316,17,0,2,0,1,52850,21516,4212,28543,0
90,3826,1289,550,1043,56,32,155,1345,10,167,93,185,177,278,1266,2075,5,11498,638,0,2,7,6,52850,21518,4213,28544,0
147,6905,1392,870,1177,35,17,170,1427,14,494,280,531,508,811,4473,7289,7,54850,3047,2,2,10,8,52850,21521,4214,28545,0
87,2871,773,419,590,28,0,166,801,10,204,113,217,214,330,1598,2554,5,13587,754,0,2,4,4,52850,21521,4215,28546,0
97,4416,1338,495,1086,10,64,173,1348,11,122,82,157,133,239,883,1686,7,11934,663,0,2,2,3,52850,21523,4215,28547,0
138,5836,1782,648,1425,9,47,279,1791,8,171,97,189,179,286,1292,2140,4,9462,525,0,2,2,2,52850,21524,4216,28548,0
23,577,102,59,69,5,3,24,107,6,22,15,28,28,43,113,206,3,789,43,0,2,10,9,52850,21524,4216,28549,0
156,4416,1660,832,1314,41,38,274,1701,20,312,209,395,332,604,2671,5058,12,64042,3557,1,2,3,2,52850,21526,4217,28551,0
73,3804,1296,573,1062,40,33,157,1336,8,201,118,231,209,349,1561,2689,4,12365,686,0,2,10,9,52850,21526,4217,28552,0
84,4400,1457,730,1242,11,6,188,1468,10,292,166,329,302,495,2424,4078,5,22973,1276,1,2,5,5,52850,21528,4217,28553,0
39,2324,652,304,544,16,6,88,668,6,89,51,101,95,152,591,998,3,3399,188,0,2,3,3,52850,21529,4217,28554,0
38,2301,334,251,279,10,4,40,344,5,127,74,143,132,217,899,1528,2,4303,239,0,2,2,1,52850,21530,4217,28555,0
34,1617,1293,570,1093,25,15,163,1318,10,195,123,241,205,364,1516,2795,6,17273,959,0,2,1,2,52860,21532,4217,28556,0
33,1886,384,251,317,7,8,52,391,11,70,44,84,81,128,467,811,6,5355,297,0,2,11,9,52860,21532,4217,28557,0
39,1724,386,256,301,16,9,68,402,4,59,35,69,63,104,355,621,2,1453,80,0,2,14,15,52860,21532,4217,28558,0
78,3015,1043,504,840,53,9,147,1096,9,180,112,198,189,310,1377,2344,4,11604,644,0,2,10,8,52860,21534,4217,28559,0
90,4376,1943,715,1694,26,18,214,1969,12,185,120,237,197,357,1436,2721,7,20915,1161,0,2,3,3,52860,21536,4217,28560,0
230,5261,4293,999,3693,19,54,507,4312,9,155,88,170,164,258,1156,1898,4,9368,520,0,2,36,47,52860,21538,4217,28561,0
230,5261,1482,859,1002,125,135,219,1607,16,219,134,251,235,385,1766,3032,9,27804,1544,1,2,36,47,52870,21539,4217,28562,0
59,1355,996,429,845,24,10,117,1020,7,76,50,88,83,138,494,879,4,3565,198,0,2,5,5,52870,21541,4217,28563,0
59,1355,456,277,329,12,42,72,468,13,85,50,97,98,147,592,972,7,7212,400,0,2,5,5,52870,21541,4217,28564,0
59,1355,996,429,845,24,10,117,1020,7,76,50,88,83,138,494,879,4,3565,198,0,2,5,5,52870,21545,4217,28566,0
59,1355,456,277,329,12,42,72,468,13,85,50,97,98,147,592,972,7,7212,400,0,2,5,5,52870,21545,4217,28567,0
87,2475,1523,757,1297,19,12,193,1542,12,193,117,230,205,347,1508,2664,7,19053,1058,0,2,26,0,52880,21549,4217,28569,0
87,2475,701,378,504,33,58,109,734,13,110,68,126,123,194,794,1346,7,10027,557,0,2,26,0,52880,21550,4218,28570,0
91,4494,1523,757,1297,19,12,193,1542,12,193,117,230,205,347,1508,2664,7,19053,1058,0,2,21,0,52890,21552,4218,28571,0
78,2063,773,422,505,30,103,129,803,14,77,46,83,91,129,535,839,7,6334,351,0,2,59,1,52900,21553,4219,28572,0
1,135,149,67,118,4,0,27,153,1,17,14,28,18,42,69,175,0,144,8,0,0,29,0,52900,21553,4219,28573,0
78,2063,773,422,505,30,103,129,803,14,77,46,83,91,129,535,839,7,6334,351,0,2,59,1,52910,21554,4220,28574,0
1,135,149,67,118,4,0,27,153,1,17,14,28,18,42,69,175,0,144,8,0,0,29,0,52910,21554,4220,28575,0
60,1088,282,196,195,3,0,86,285,8,130,71,141,138,212,936,1507,4,6538,363,0,2,2,0,52910,21554,4221,28576,0
60,1088,282,196,195,3,0,86,285,8,130,71,141,138,212,936,1507,4,6538,363,0,2,2,0,52910,21554,4222,28577,0
100,2042,1020,354,843,12,15,144,1032,8,134,77,144,142,221,970,1580,4,6792,377,0,2,1,1,52910,21554,4222,28578,0
258,6111,72,33,56,0,4,12,72,1,1,1,1,2,2,0,2,0,1,0,0,2,2,2,52910,21554,4222,28579,0
258,6111,1454,835,1044,76,110,219,1530,17,275,158,296,292,454,2297,3718,9,34017,1889,1,2,2,2,52920,21555,4222,28580,0
11,238,19,8,11,5,0,4,24,2,5,3,6,7,9,13,25,1,30,1,0,2,1,1,52920,21555,4222,28581,0
11,238,102,59,69,5,3,24,107,6,22,15,28,28,43,113,206,3,789,43,0,2,1,1,52920,21555,4222,28582,0
11,238,106,40,36,3,49,17,109,8,17,13,23,25,36,93,167,5,904,50,0,2,1,1,52920,21555,4222,28583,0
26,527,2,2,2,0,0,0,2,0,0,0,0,0,0,0,0,0,0,0,0,2,1,1,52920,21555,4222,28583,0
26,527,99,48,90,1,3,5,100,0,0,0,0,0,0,0,0,0,0,0,0,2,1,1,52920,21556,4222,28584,0
26,527,8,5,5,2,0,1,10,0,0,0,0,0,0,0,0,0,0,0,0,2,1,1,52920,21556,4222,28585,0
26,527,1217,716,841,84,126,174,1301,14,185,118,215,199,333,1446,2542,8,20687,1149,0,2,1,1,52930,21558,4222,28586,0
26,527,160,89,115,0,13,31,160,7,15,11,17,22,28,78,124,3,495,27,0,2,1,1,52930,21558,4222,28587,0
26,527,10,10,9,9,0,0,19,0,0,0,0,0,0,0,0,0,0,0,0,2,1,1,52930,21558,4223,28588,0
26,527,173,84,99,8,29,36,181,5,12,7,13,17,20,54,81,2,221,12,0,2,1,1,52930,21559,4223,28589,0
26,527,3,1,1,3,0,0,6,0,0,0,0,0,0,0,0,0,0,0,0,2,1,1,52930,21559,4223,28590,0
59,1355,996,429,845,24,10,117,1020,7,76,50,88,83,138,494,879,4,3565,198,0,2,8,7,52930,21561,4223,28591,0
59,1355,456,277,329,12,42,72,468,13,85,50,97,98,147,592,972,7,7212,400,0,2,8,7,52930,21561,4223,28592,0
141,2977,1513,682,1277,25,13,200,1538,11,199,116,219,210,335,1557,2584,6,15641,868,0,2,6,6,52930,21563,4223,28593,0
141,2977,819,519,539,24,98,155,843,15,96,57,106,111,163,690,1107,8,9171,509,0,2,6,6,52940,21565,4223,28594,0
347,6987,1457,730,1242,11,6,188,1468,10,292,166,329,302,495,2424,4078,5,22973,1276,1,2,15,15,52940,21567,4223,28595,0
347,6987,74,35,59,1,0,14,75,3,14,7,14,17,21,58,85,1,128,7,0,2,15,15,52940,21568,4223,28596,0
347,6987,245,125,200,5,7,34,250,7,30,17,34,37,51,166,265,3,1053,58,0,2,15,15,52950,21569,4223,28597,0
21,668,339,213,244,17,9,65,356,10,42,26,48,52,74,259,421,5,2410,133,0,2,2,2,52960,21569,4223,28598,0
230,5261,4293,999,3693,19,54,507,4312,9,155,88,170,164,258,1156,1898,4,9368,520,0,2,42,52,52960,21571,4223,28599,0
230,5261,1482,859,1002,125,135,219,1607,16,219,134,251,235,385,1766,3032,9,27804,1544,1,2,42,52,52970,21572,4223,28600,0
27,950,74,35,59,1,0,14,75,3,14,7,14,17,21,58,85,1,128,7,0,2,2,2,52970,21573,4223,28601,0
27,950,245,125,200,5,7,34,250,7,30,17,34,37,51,166,265,3,1053,58,0,2,2,2,52980,21574,4223,28602,0
51,595,647,139,84,35,284,233,682,0,0,0,0,0,0,0,0,0,0,0,0,2,21,3,52980,21574,4223,28603,0
87,2475,1523,757,1297,19,12,193,1542,12,193,117,230,205,347,1508,2664,7,19053,1058,0,2,26,0,52990,21576,4223,28604,0
87,2475,701,378,504,33,58,109,734,13,110,68,126,123,194,794,1346,7,10027,557,0,2,26,0,52990,21577,4224,28605,0
78,2063,773,422,505,30,103,129,803,14,77,46,83,91,129,535,839,7,6334,351,0,2,220,60,53000,21578,4225,28606,0
117,2804,77,34,69,0,0,8,77,3,24,16,29,27,45,114,213,1,387,21,0,2,9,363,53000,21578,4225,28607,0
117,2804,712,438,573,51,9,84,763,14,102,71,128,116,199,733,1364,8,11988,666,0,2,9,363,53010,21579,4225,28608,0
108,2218,1020,354,843,12,15,144,1032,8,134,77,144,142,221,970,1580,4,6792,377,0,2,41,6,53010,21579,4225,28609,0
46,963,447,308,343,6,5,95,453,7,96,59,111,103,170,651,1136,4,4600,255,0,2,2,2,53010,21582,4225,28610,0
46,963,322,174,179,16,74,51,338,10,41,26,46,51,72,252,408,5,2291,127,0,2,2,2,53010,21585,4226,28611,0
79,1686,53,23,39,0,0,13,53,2,8,4,8,10,12,26,39,1,39,2,0,2,363,0,53010,21585,4226,28612,0
79,1686,515,298,307,33,80,99,548,12,63,44,77,75,121,419,753,7,5527,307,0,2,363,0,53020,21585,4226,28613,0
223,5307,722,423,573,19,0,135,741,12,172,101,199,184,300,1320,2257,6,15668,870,0,2,106,68,53020,21587,4226,28615,0
223,5307,1508,847,911,44,250,301,1552,14,148,88,169,162,257,1120,1886,7,15077,837,0,2,106,68,53020,21588,4227,28616,0
259,6118,72,33,56,0,4,12,72,1,1,1,1,2,2,0,2,0,1,0,0,2,6,5,53020,21588,4227,28617,0
259,6118,1454,835,1044,76,110,219,1530,17,275,158,296,292,454,2297,3718,9,34017,1889,1,2,6,5,53030,21589,4227,28618,0
111,2485,1043,504,840,53,9,147,1096,9,180,112,198,189,310,1377,2344,4,11604,644,0,2,4,1,53030,21591,4227,28619,0
111,2485,383,288,292,26,6,62,409,11,65,38,67,76,105,429,656,5,3719,206,0,2,4,1,53030,21592,4227,28620,0
207,4345,1943,715,1694,26,18,214,1969,12,185,120,237,197,357,1436,2721,7,20915,1161,0,2,29,22,53030,21594,4227,28621,0
207,4345,1168,838,957,57,25,144,1225,19,348,224,416,367,640,3018,5452,11,61921,3440,1,2,29,22,53040,21596,4227,28622,0
16,480,442,244,305,14,16,103,456,11,68,45,75,79,120,452,756,6,4588,254,0,2,1,1,53040,21598,4227,28623,0
16,480,182,102,99,11,40,35,193,3,11,6,11,14,17,42,64,1,97,5,0,2,1,1,53040,21599,4227,28624,0
60,1088,282,196,195,3,0,86,285,8,130,71,141,138,212,936,1507,4,6538,363,0,2,2,0,53040,21599,4228,28625,0
90,3826,1289,550,1043,56,32,155,1345,10,167,93,185,177,278,1266,2075,5,11498,638,0,2,4,4,53040,21601,4229,28626,0
11,423,75,38,59,1,3,12,76,2,4,2,4,6,6,10,15,1,15,0,0,2,0,1,53040,21601,4229,28627,0
13,563,139,89,101,2,0,35,141,7,54,34,62,61,96,330,569,4,2287,127,0,2,50,0,53040,21601,4229,28628,0
1,135,149,67,118,4,0,27,153,1,17,14,28,18,42,69,175,0,144,8,0,0,29,0,53040,21601,4229,28629,0
25,1432,1157,318,931,29,22,177,1186,6,104,63,125,110,188,712,1274,3,4596,255,0,2,193,50,53040,21601,4229,28630,0
97,4416,1338,495,1086,10,64,173,1348,11,122,82,157,133,239,883,1686,7,11934,663,0,2,4,7,53040,21603,4229,28631,0
162,7134,139,89,101,2,0,35,141,7,54,34,62,61,96,330,569,4,2287,127,0,2,1,1,53040,21603,4229,28632,0
162,7134,7,5,5,0,0,2,7,1,2,1,2,3,3,2,4,0,2,0,0,2,1,1,53040,21603,4229,28633,0
138,5836,1782,648,1425,9,47,279,1791,8,171,97,189,179,286,1292,2140,4,9462,525,0,2,34,3,53040,21604,4230,28634,0
32,2401,996,429,845,24,10,117,1020,7,76,50,88,83,138,494,879,4,3565,198,0,3,9,9,53040,21606,4230,28635,0
128,5159,1513,682,1277,25,13,200,1538,11,199,116,219,210,335,1557,2584,6,15641,868,0,2,1,1,53040,21608,4230,28636,0
84,4400,1457,730,1242,11,6,188,1468,10,292,166,329,302,495,2424,4078,5,22973,1276,1,2,39,5,53040,21610,4230,28637,0
91,4494,1523,757,1297,19,12,193,1542,12,193,117,230,205,347,1508,2664,7,19053,1058,0,2,21,0,53050,21612,4230,28638,0
82,3566,1020,354,843,12,15,144,1032,8,134,77,144,142,221,970,1580,4,6792,377,0,2,43,1,53050,21612,4230,28639,0
45,2208,722,423,573,19,0,135,741,12,172,101,199,184,300,1320,2257,6,15668,870,0,2,238,9,53050,21614,4230,28641,0
16,1209,215,129,180,6,0,29,221,8,65,43,72,73,115,415,711,4,3153,175,0,2,1,1,53050,21614,4230,28642,0
78,3015,1043,504,840,53,9,147,1096,9,180,112,198,189,310,1377,2344,4,11604,644,0,2,12,0,53050,21616,4230,28643,0
90,4376,1943,715,1694,26,18,214,1969,12,185,120,237,197,357,1436,2721,7,20915,1161,0,2,89,6,53050,21618,4230,28644,0
39,1724,386,256,301,16,9,68,402,4,59,35,69,63,104,355,621,2,1453,80,0,2,2,2,53050,21618,4230,28645,0
108,2218,1020,354,843,12,15,144,1032,8,134,77,144,142,221,970,1580,4,6792,377,0,2,1,1,53050,21618,4230,28646,0
259,6118,72,33,56,0,4,12,72,1,1,1,1,2,2,0,2,0,1,0,0,2,2,1,53050,21618,4230,28647,0
259,6118,1454,835,1044,76,110,219,1530,17,275,158,296,292,454,2297,3718,9,34017,1889,1,2,2,1,53060,21619,4230,28648,0
209,4372,1943,715,1694,26,18,214,1969,12,185,120,237,197,357,1436,2721,7,20915,1161,0,2,5,0,53060,21621,4230,28649,1
209,4372,1168,838,957,57,25,144,1225,19,348,224,416,367,640,3018,5452,11,61921,3440,1,2,5,0,53070,21623,4230,28650,1
91,4435,1943,715,1694,26,18,214,1969,12,185,120,237,197,357,1436,2721,7,20915,1161,0,2,13,0,53070,21625,4230,28651,1
351,7022,1457,730,1242,11,6,188,1468,10,292,166,329,302,495,2424,4078,5,22973,1276,1,2,0,2,53070,21627,4230,28652,0
351,7022,74,35,59,1,0,14,75,3,14,7,14,17,21,58,85,1,128,7,0,2,0,2,53070,21628,4230,28653,0
351,7022,245,125,200,5,7,34,250,7,30,17,34,37,51,166,265,3,1053,58,0,2,0,2,53080,21629,4230,28654,0
30,1214,373,158,315,8,0,51,381,5,76,44,79,81,123,486,779,2,2026,112,0,2,14,7,53080,21629,4230,28655,0
11,238,19,8,11,5,0,4,24,2,5,3,6,7,9,13,25,1,30,1,0,2,1,1,53080,21629,4230,28656,0
11,238,102,59,69,5,3,24,107,6,22,15,28,28,43,113,206,3,789,43,0,2,1,1,53080,21629,4230,28657,0
11,238,106,40,36,3,49,17,109,8,17,13,23,25,36,93,167,5,904,50,0,2,1,1,53080,21629,4230,28658,0
214,4584,182,127,129,0,0,53,182,5,39,21,42,44,63,217,343,2,926,51,0,2,6,4,53080,21629,4231,28659,0
214,4584,1165,710,800,67,119,181,1232,18,243,153,282,261,435,2000,3492,10,36473,2026,1,2,6,4,53090,21629,4232,28660,0
100,2037,773,419,590,28,0,166,801,10,204,113,217,214,330,1598,2554,5,13587,754,0,2,4,4,53090,21629,4233,28661,0
100,2037,421,273,302,44,34,57,465,17,81,59,107,98,166,583,1098,11,12329,684,0,2,4,4,53090,21629,4234,28662,0
26,527,2,2,2,0,0,0,2,0,0,0,0,0,0,0,0,0,0,0,0,2,1,1,53090,21629,4234,28662,0
26,527,99,48,90,1,3,5,100,0,0,0,0,0,0,0,0,0,0,0,0,2,1,1,53090,21630,4234,28663,0
26,527,8,5,5,2,0,1,10,0,0,0,0,0,0,0,0,0,0,0,0,2,1,1,53090,21630,4234,28664,0
26,527,1217,716,841,84,126,174,1301,14,185,118,215,199,333,1446,2542,8,20687,1149,0,2,1,1,53100,21632,4234,28665,0
26,527,160,89,115,0,13,31,160,7,15,11,17,22,28,78,124,3,495,27,0,2,1,1,53100,21632,4234,28666,0
26,527,10,10,9,9,0,0,19,0,0,0,0,0,0,0,0,0,0,0,0,2,1,1,53100,21632,4235,28667,0
26,527,173,84,99,8,29,36,181,5,12,7,13,17,20,54,81,2,221,12,0,2,1,1,53100,21633,4235,28668,0
26,527,3,1,1,3,0,0,6,0,0,0,0,0,0,0,0,0,0,0,0,2,1,1,53100,21633,4235,28669,0
59,1355,996,429,845,24,10,117,1020,7,76,50,88,83,138,494,879,4,3565,198,0,2,8,7,53100,21635,4235,28670,0
59,1355,456,277,329,12,42,72,468,13,85,50,97,98,147,592,972,7,7212,400,0,2,8,7,53100,21635,4235,28671,0
141,2977,1513,682,1277,25,13,200,1538,11,199,116,219,210,335,1557,2584,6,15641,868,0,2,6,6,53100,21637,4235,28672,0
141,2977,819,519,539,24,98,155,843,15,96,57,106,111,163,690,1107,8,9171,509,0,2,6,6,53110,21639,4235,28673,0
350,7046,1457,730,1242,11,6,188,1468,10,292,166,329,302,495,2424,4078,5,22973,1276,1,2,15,15,53110,21641,4235,28674,0
350,7046,74,35,59,1,0,14,75,3,14,7,14,17,21,58,85,1,128,7,0,2,15,15,53110,21642,4235,28675,0
350,7046,245,125,200,5,7,34,250,7,30,17,34,37,51,166,265,3,1053,58,0,2,15,15,53120,21643,4235,28676,0
21,668,339,213,244,17,9,65,356,10,42,26,48,52,74,259,421,5,2410,133,0,2,2,2,53130,21643,4235,28677,0
230,5261,4293,999,3693,19,54,507,4312,9,155,88,170,164,258,1156,1898,4,9368,520,0,2,40,51,53130,21645,4235,28678,0
230,5261,1482,859,1002,125,135,219,1607,16,219,134,251,235,385,1766,3032,9,27804,1544,1,2,40,51,53140,21646,4235,28679,0
27,950,74,35,59,1,0,14,75,3,14,7,14,17,21,58,85,1,128,7,0,2,2,2,53140,21647,4235,28680,0
27,950,245,125,200,5,7,34,250,7,30,17,34,37,51,166,265,3,1053,58,0,2,2,2,53150,21648,4235,28681,0
51,595,647,139,84,35,284,233,682,0,0,0,0,0,0,0,0,0,0,0,0,2,42,4,53150,21648,4235,28682,0
87,2475,1523,757,1297,19,12,193,1542,12,193,117,230,205,347,1508,2664,7,19053,1058,0,2,26,0,53160,21650,4235,28683,0
87,2475,701,378,504,33,58,109,734,13,110,68,126,123,194,794,1346,7,10027,557,0,2,26,0,53160,21651,4236,28684,0
78,2063,773,422,505,30,103,129,803,14,77,46,83,91,129,535,839,7,6334,351,0,2,220,60,53170,21652,4237,28685,0
117,2824,77,34,69,0,0,8,77,3,24,16,29,27,45,114,213,1,387,21,0,2,1,1,53170,21652,4237,28686,0
117,2824,712,438,573,51,9,84,763,14,102,71,128,116,199,733,1364,8,11988,666,0,2,1,1,53180,21653,4237,28687,0
108,2218,1020,354,843,12,15,144,1032,8,134,77,144,142,221,970,1580,4,6792,377,0,2,42,7,53180,21653,4237,28688,0
46,963,447,308,343,6,5,95,453,7,96,59,111,103,170,651,1136,4,4600,255,0,2,2,2,53180,21656,4237,28689,0
46,963,322,174,179,16,74,51,338,10,41,26,46,51,72,252,408,5,2291,127,0,2,2,2,53180,21659,4238,28690,0
223,5307,722,423,573,19,0,135,741,12,172,101,199,184,300,1320,2257,6,15668,870,0,2,14,14,53180,21661,4238,28692,0
223,5307,1508,847,911,44,250,301,1552,14,148,88,169,162,257,1120,1886,7,15077,837,0,2,14,14,53180,21662,4239,28693,0
259,6118,72,33,56,0,4,12,72,1,1,1,1,2,2,0,2,0,1,0,0,2,1,1,53180,21662,4239,28694,0
259,6118,1454,835,1044,76,110,219,1530,17,275,158,296,292,454,2297,3718,9,34017,1889,1,2,1,1,53190,21663,4239,28695,0
111,2485,1043,504,840,53,9,147,1096,9,180,112,198,189,310,1377,2344,4,11604,644,0,2,1,1,53190,21665,4239,28696,0
111,2485,383,288,292,26,6,62,409,11,65,38,67,76,105,429,656,5,3719,206,0,2,1,1,53190,21666,4239,28697,0
207,4345,1943,715,1694,26,18,214,1969,12,185,120,237,197,357,1436,2721,7,20915,1161,0,2,2,2,53190,21668,4239,28698,0
207,4345,1168,838,957,57,25,144,1225,19,348,224,416,367,640,3018,5452,11,61921,3440,1,2,2,2,53200,21670,4239,28699,0
16,480,442,244,305,14,16,103,456,11,68,45,75,79,120,452,756,6,4588,254,0,2,1,1,53200,21672,4239,28700,0
16,480,182,102,99,11,40,35,193,3,11,6,11,14,17,42,64,1,97,5,0,2,1,1,53200,21673,4239,28701,0
60,1088,282,196,195,3,0,86,285,8,130,71,141,138,212,936,1507,4,6538,363,0,2,4,2,53200,21673,4240,28702,0
17,384,85,59,61,8,0,16,93,5,18,10,18,23,28,86,126,2,316,17,0,2,0,1,53200,21673,4240,28703,0
90,3826,1289,550,1043,56,32,155,1345,10,167,93,185,177,278,1266,2075,5,11498,638,0,2,8,7,53200,21675,4241,28704,0
147,6905,1392,870,1177,35,17,170,1427,14,494,280,531,508,811,4473,7289,7,54850,3047,2,2,10,8,53200,21678,4242,28705,0
87,2871,773,419,590,28,0,166,801,10,204,113,217,214,330,1598,2554,5,13587,754,0,2,4,4,53200,21678,4243,28706,0
13,563,139,89,101,2,0,35,141,7,54,34,62,61,96,330,569,4,2287,127,0,2,50,0,53200,21678,4243,28707,0
1,135,149,67,118,4,0,27,153,1,17,14,28,18,42,69,175,0,144,8,0,0,29,0,53200,21678,4243,28708,0
25,1432,1157,318,931,29,22,177,1186,6,104,63,125,110,188,712,1274,3,4596,255,0,2,193,50,53200,21678,4243,28709,0
97,4416,1338,495,1086,10,64,173,1348,11,122,82,157,133,239,883,1686,7,11934,663,0,2,4,5,53200,21680,4243,28710,0
162,7134,139,89,101,2,0,35,141,7,54,34,62,61,96,330,569,4,2287,127,0,2,1,1,53200,21680,4243,28711,0
162,7134,7,5,5,0,0,2,7,1,2,1,2,3,3,2,4,0,2,0,0,2,1,1,53200,21680,4243,28712,0
138,5836,1782,648,1425,9,47,279,1791,8,171,97,189,179,286,1292,2140,4,9462,525,0,2,18,6,53200,21681,4244,28713,0
23,577,102,59,69,5,3,24,107,6,22,15,28,28,43,113,206,3,789,43,0,2,10,9,53200,21681,4244,28714,0
156,4416,1660,832,1314,41,38,274,1701,20,312,209,395,332,604,2671,5058,12,64042,3557,1,2,3,2,53200,21683,4245,28716,0
32,2401,996,429,845,24,10,117,1020,7,76,50,88,83,138,494,879,4,3565,198,0,3,15,15,53200,21685,4245,28717,0
128,5159,1513,682,1277,25,13,200,1538,11,199,116,219,210,335,1557,2584,6,15641,868,0,2,1,1,53200,21687,4245,28718,0
73,3804,1296,573,1062,40,33,157,1336,8,201,118,231,209,349,1561,2689,4,12365,686,0,2,10,9,53200,21687,4245,28719,0
84,4400,1457,730,1242,11,6,188,1468,10,292,166,329,302,495,2424,4078,5,22973,1276,1,2,44,10,53200,21689,4245,28720,0
39,2324,652,304,544,16,6,88,668,6,89,51,101,95,152,591,998,3,3399,188,0,2,3,3,53200,21690,4245,28721,0
91,4494,1523,757,1297,19,12,193,1542,12,193,117,230,205,347,1508,2664,7,19053,1058,0,2,21,0,53210,21692,4245,28722,0
82,3566,1020,354,843,12,15,144,1032,8,134,77,144,142,221,970,1580,4,6792,377,0,2,43,1,53210,21692,4245,28723,0
38,2301,334,251,279,10,4,40,344,5,127,74,143,132,217,899,1528,2,4303,239,0,2,2,1,53210,21693,4245,28724,0
34,1617,1293,570,1093,25,15,163,1318,10,195,123,241,205,364,1516,2795,6,17273,959,0,2,1,2,53220,21695,4245,28725,0
33,1886,384,251,317,7,8,52,391,11,70,44,84,81,128,467,811,6,5355,297,0,2,11,9,53220,21695,4245,28726,0
45,2208,722,423,573,19,0,135,741,12,172,101,199,184,300,1320,2257,6,15668,870,0,2,5,5,53220,21697,4245,28728,0
39,1724,386,256,301,16,9,68,402,4,59,35,69,63,104,355,621,2,1453,80,0,2,14,15,53220,21697,4245,28729,0
78,3015,1043,504,840,53,9,147,1096,9,180,112,198,189,310,1377,2344,4,11604,644,0,2,10,8,53220,21699,4245,28730,0
90,4376,1943,715,1694,26,18,214,1969,12,185,120,237,197,357,1436,2721,7,20915,1161,0,2,5,5,53220,21701,4245,28731,0
30,1193,373,158,315,8,0,51,381,5,76,44,79,81,123,486,779,2,2026,112,0,2,5,3,53220,21701,4245,28732,0
350,7046,1457,730,1242,11,6,188,1468,10,292,166,329,302,495,2424,4078,5,22973,1276,1,2,3,3,53220,21703,4245,28733,0
350,7046,74,35,59,1,0,14,75,3,14,7,14,17,21,58,85,1,128,7,0,2,3,3,53220,21704,4245,28734,0
350,7046,245,125,200,5,7,34,250,7,30,17,34,37,51,166,265,3,1053,58,0,2,3,3,53230,21705,4245,28735,0
28,1170,373,158,315,8,0,51,381,5,76,44,79,81,123,486,779,2,2026,112,0,2,6,10,53230,21705,4245,28736,0
234,5320,4293,999,3693,19,54,507,4312,9,155,88,170,164,258,1156,1898,4,9368,520,0,2,15,7,53230,21707,4245,28737,0
234,5320,1482,859,1002,125,135,219,1607,16,219,134,251,235,385,1766,3032,9,27804,1544,1,2,15,7,53240,21708,4245,28738,0
163,7176,139,89,101,2,0,35,141,7,54,34,62,61,96,330,569,4,2287,127,0,2,41,0,53240,21708,4245,28739,0
163,7176,7,5,5,0,0,2,7,1,2,1,2,3,3,2,4,0,2,0,0,2,41,0,53240,21708,4245,28740,0
39,1724,386,256,301,16,9,68,402,4,59,35,69,63,104,355,621,2,1453,80,0,2,2,2,53240,21708,4245,28741,0
15,466,42,7,35,4,0,5,46,1,2,1,2,3,3,2,4,0,2,0,0,2,1,1,53240,21708,4245,28742,0
15,466,11,6,10,0,0,1,11,2,4,2,4,6,6,10,15,1,15,0,0,2,1,1,53240,21708,4245,28743,0
97,2643,1523,757,1297,19,12,193,1542,12,193,117,230,205,347,1508,2664,7,19053,1058,0,2,48,5,53250,21710,4245,28744,0
97,2643,701,378,504,33,58,109,734,13,110,68,126,123,194,794,1346,7,10027,557,0,2,48,5,53250,21711,4246,28745,0
113,2514,1043,504,840,53,9,147,1096,9,180,112,198,189,310,1377,2344,4,11604,644,0,2,8,0,53250,21713,4246,28746,0
113,2514,383,288,292,26,6,62,409,11,65,38,67,76,105,429,656,5,3719,206,0,2,8,0,53250,21714,4246,28747,0
94,4604,1523,757,1297,19,12,193,1542,12,193,117,230,205,347,1508,2664,7,19053,1058,0,2,20,3,53260,21716,4246,28748,0
34,1626,1293,570,1093,25,15,163,1318,10,195,123,241,205,364,1516,2795,6,17273,959,0,2,4,0,53270,21718,4246,28749,0
34,1634,1293,570,1093,25,15,163,1318,10,195,123,241,205,364,1516,2795,6,17273,959,0,2,1,1,53280,21720,4246,28750,1
21,662,339,213,244,17,9,65,356,10,42,26,48,52,74,259,421,5,2410,133,0,2,7,11,53290,21720,4246,28751,0
34,1634,1293,570,1093,25,15,163,1318,10,195,123,241,205,364,1516,2795,6,17273,959,0,2,4,0,53300,21722,4246,28752,0
21,668,339,213,244,17,9,65,356,10,42,26,48,52,74,259,421,5,2410,133,0,2,3,3,53310,21722,4246,28753,0
15,466,42,7,35,4,0,5,46,1,2,1,2,3,3,2,4,0,2,0,0,2,1,1,53310,21722,4246,28754,0
15,466,11,6,10,0,0,1,11,2,4,2,4,6,6,10,15,1,15,0,0,2,1,1,53310,21722,4246,28755,0
79,2067,773,422,505,30,103,129,803,14,77,46,83,91,129,535,839,7,6334,351,0,2,1,1,53320,21723,4247,28756,0
26,1513,1157,318,931,29,22,177,1186,6,104,63,125,110,188,712,1274,3,4596,255,0,2,54,0,53320,21723,4247,28757,0
113,2514,1043,504,840,53,9,147,1096,9,180,112,198,189,310,1377,2344,4,11604,644,0,2,1,1,53320,21725,4247,28758,0
113,2514,383,288,292,26,6,62,409,11,65,38,67,76,105,429,656,5,3719,206,0,2,1,1,53320,21726,4247,28759,0
80,2120,773,422,505,30,103,129,803,14,77,46,83,91,129,535,839,7,6334,351,0,2,14,1,53330,21727,4248,28760,0
25,1456,1157,318,931,29,22,177,1186,6,104,63,125,110,188,712,1274,3,4596,255,0,2,22,1,53330,21727,4248,28761,0
210,4402,1943,715,1694,26,18,214,1969,12,185,120,237,197,357,1436,2721,7,20915,1161,0,2,7,4,53330,21729,4248,28762,1
210,4402,1168,838,957,57,25,144,1225,19,348,224,416,367,640,3018,5452,11,61921,3440,1,2,7,4,53340,21731,4248,28763,1
91,4486,1943,715,1694,26,18,214,1969,12,185,120,237,197,357,1436,2721,7,20915,1161,0,2,11,3,53340,21733,4248,28764,1
97,2643,1523,757,1297,19,12,193,1542,12,193,117,230,205,347,1508,2664,7,19053,1058,0,2,48,5,53350,21735,4248,28765,0
97,2643,701,378,504,33,58,109,734,13,110,68,126,123,194,794,1346,7,10027,557,0,2,48,5,53350,21736,4249,28766,0
113,2514,1043,504,840,53,9,147,1096,9,180,112,198,189,310,1377,2344,4,11604,644,0,2,8,0,53350,21738,4249,28767,0
113,2514,383,288,292,26,6,62,409,11,65,38,67,76,105,429,656,5,3719,206,0,2,8,0,53350,21739,4249,28768,0
94,4604,1523,757,1297,19,12,193,1542,12,193,117,230,205,347,1508,2664,7,19053,1058,0,2,20,3,53360,21741,4249,28769,0
80,2120,773,422,505,30,103,129,803,14,77,46,83,91,129,535,839,7,6334,351,0,2,14,1,53370,21742,4250,28770,0
25,1456,1157,318,931,29,22,177,1186,6,104,63,125,110,188,712,1274,3,4596,255,0,2,22,1,53370,21742,4250,28771,0
234,5320,4293,999,3693,19,54,507,4312,9,155,88,170,164,258,1156,1898,4,9368,520,0,2,15,7,53370,21744,4250,28772,0
234,5320,1482,859,1002,125,135,219,1607,16,219,134,251,235,385,1766,3032,9,27804,1544,1,2,15,7,53380,21745,4250,28773,0
163,7176,139,89,101,2,0,35,141,7,54,34,62,61,96,330,569,4,2287,127,0,2,41,0,53380,21745,4250,28774,0
163,7176,7,5,5,0,0,2,7,1,2,1,2,3,3,2,4,0,2,0,0,2,41,0,53380,21745,4250,28775,0
350,7046,1457,730,1242,11,6,188,1468,10,292,166,329,302,495,2424,4078,5,22973,1276,1,2,8,2,53380,21747,4250,28776,0
350,7046,74,35,59,1,0,14,75,3,14,7,14,17,21,58,85,1,128,7,0,2,8,2,53380,21748,4250,28777,0
350,7046,245,125,200,5,7,34,250,7,30,17,34,37,51,166,265,3,1053,58,0,2,8,2,53390,21749,4250,28778,0
117,2824,77,34,69,0,0,8,77,3,24,16,29,27,45,114,213,1,387,21,0,2,6,0,53390,21749,4250,28779,0
117,2824,712,438,573,51,9,84,763,14,102,71,128,116,199,733,1364,8,11988,666,0,2,6,0,53400,21750,4250,28780,0
28,1170,373,158,315,8,0,51,381,5,76,44,79,81,123,486,779,2,2026,112,0,2,30,0,53400,21750,4250,28781,0
83,2161,773,422,505,30,103,129,803,14,77,46,83,91,129,535,839,7,6334,351,0,2,9,2,53410,21751,4251,28782,1
27,1578,1157,318,931,29,22,177,1186,6,104,63,125,110,188,712,1274,3,4596,255,0,2,42,0,53410,21751,4251,28783,1
82,2143,773,422,505,30,103,129,803,14,77,46,83,91,129,535,839,7,6334,351,0,2,8,8,53420,21752,4252,28784,0
210,4422,1943,715,1694,26,18,214,1969,12,185,120,237,197,357,1436,2721,7,20915,1161,0,2,7,4,53420,21754,4252,28785,0
210,4422,1168,838,957,57,25,144,1225,19,348,224,416,367,640,3018,5452,11,61921,3440,1,2,7,4,53430,21756,4252,28786,0
91,4548,1943,715,1694,26,18,214,1969,12,185,120,237,197,357,1436,2721,7,20915,1161,0,2,8,0,53430,21758,4252,28787,0
82,2143,773,422,505,30,103,129,803,14,77,46,83,91,129,535,839,7,6334,351,0,2,1,1,53440,21759,4253,28788,0
82,2143,773,422,505,30,103,129,803,14,77,46,83,91,129,535,839,7,6334,351,0,2,9,2,53450,21760,4254,28789,0
27,1578,1157,318,931,29,22,177,1186,6,104,63,125,110,188,712,1274,3,4596,255,0,2,42,0,53450,21760,4254,28790,0
84,2178,773,422,505,30,103,129,803,14,77,46,83,91,129,535,839,7,6334,351,0,2,8,1,53460,21761,4255,28791,0
28,1711,1157,318,931,29,22,177,1186,6,104,63,125,110,188,712,1274,3,4596,255,0,2,59,0,53460,21761,4255,28792,0
210,4412,1943,715,1694,26,18,214,1969,12,185,120,237,197,357,1436,2721,7,20915,1161,0,2,0,1,53460,21763,4255,28793,0
210,4412,1168,838,957,57,25,144,1225,19,348,224,416,367,640,3018,5452,11,61921,3440,1,2,0,1,53470,21765,4255,28794,0
210,4418,1943,715,1694,26,18,214,1969,12,185,120,237,197,357,1436,2721,7,20915,1161,0,2,10,0,53470,21767,4255,28795,0
210,4418,1168,838,957,57,25,144,1225,19,348,224,416,367,640,3018,5452,11,61921,3440,1,2,10,0,53480,21769,4255,28796,0
91,4542,1943,715,1694,26,18,214,1969,12,185,120,237,197,357,1436,2721,7,20915,1161,0,2,29,0,53480,21771,4255,28797,0
73,1425,757,253,292,73,244,162,830,13,61,38,67,74,105,409,651,7,4654,258,0,2,4,0,53480,21772,4255,28798,0
73,1425,757,253,292,73,244,162,830,13,61,38,67,74,105,409,651,7,4654,258,0,2,4,0,53480,21773,4255,28799,0
54,1096,207,111,150,11,0,50,218,5,26,19,36,31,55,133,272,3,943,52,0,2,4,3,53480,21773,4255,28800,1
54,1096,410,198,237,31,55,97,441,11,63,38,72,74,110,414,683,6,4293,238,0,2,4,3,53490,21774,4256,28801,1
33,991,465,148,393,5,8,60,470,4,31,20,31,35,51,161,261,2,523,29,0,2,22,0,53490,21775,4256,28802,1
33,991,16,12,9,0,0,6,16,1,2,1,2,3,3,2,4,0,2,0,0,2,22,0,53490,21775,4256,28803,1
23,722,339,213,244,17,9,65,356,10,42,26,48,52,74,259,421,5,2410,133,0,2,11,0,53500,21775,4256,28804,1
36,1762,1293,570,1093,25,15,163,1318,10,195,123,241,205,364,1516,2795,6,17273,959,0,2,35,4,53510,21777,4256,28805,1
66,1783,1455,414,1257,16,76,112,1471,5,41,23,46,46,69,231,381,2,1069,59,0,2,12,0,53510,21778,4256,28806,0
66,1783,669,365,481,22,61,110,691,15,103,63,122,118,185,747,1273,8,11311,628,0,2,12,0,53520,21778,4257,28807,0
21,668,339,213,244,17,9,65,356,10,42,26,48,52,74,259,421,5,2410,133,0,2,3,3,53530,21778,4257,28808,0
234,5320,4293,999,3693,19,54,507,4312,9,155,88,170,164,258,1156,1898,4,9368,520,0,2,15,7,53530,21780,4257,28809,0
234,5320,1482,859,1002,125,135,219,1607,16,219,134,251,235,385,1766,3032,9,27804,1544,1,2,15,7,53540,21781,4257,28810,0
108,2218,1020,354,843,12,15,144,1032,8,134,77,144,142,221,970,1580,4,6792,377,0,2,1,1,53540,21781,4257,28811,0
259,6118,72,33,56,0,4,12,72,1,1,1,1,2,2,0,2,0,1,0,0,2,2,1,53540,21781,4257,28812,0
259,6118,1454,835,1044,76,110,219,1530,17,275,158,296,292,454,2297,3718,9,34017,1889,1,2,2,1,53550,21782,4257,28813,0
73,1425,757,253,292,73,244,162,830,13,61,38,67,74,105,409,651,7,4654,258,0,2,4,0,53550,21783,4257,28814,0
15,466,42,7,35,4,0,5,46,1,2,1,2,3,3,2,4,0,2,0,0,2,1,1,53550,21783,4257,28815,0
15,466,11,6,10,0,0,1,11,2,4,2,4,6,6,10,15,1,15,0,0,2,1,1,53550,21783,4257,28816,0
163,7176,139,89,101,2,0,35,141,7,54,34,62,61,96,330,569,4,2287,127,0,2,41,0,53550,21783,4257,28817,0
163,7176,7,5,5,0,0,2,7,1,2,1,2,3,3,2,4,0,2,0,0,2,41,0,53550,21783,4257,28818,0
34,1634,1293,570,1093,25,15,163,1318,10,195,123,241,205,364,1516,2795,6,17273,959,0,2,4,0,53560,21785,4257,28819,0
39,1724,386,256,301,16,9,68,402,4,59,35,69,63,104,355,621,2,1453,80,0,2,2,2,53560,21785,4257,28820,0
34,1617,1293,570,1093,25,15,163,1318,10,195,123,241,205,364,1516,2795,6,17273,959,0,2,0,4,53570,21787,4257,28821,0
72,1639,996,429,845,24,10,117,1020,7,76,50,88,83,138,494,879,4,3565,198,0,2,42,0,53570,21789,4257,28822,1
72,1639,456,277,329,12,42,72,468,13,85,50,97,98,147,592,972,7,7212,400,0,2,42,0,53570,21789,4257,28823,1
34,2781,996,429,845,24,10,117,1020,7,76,50,88,83,138,494,879,4,3565,198,0,2,117,4,53570,21791,4257,28824,1
209,4409,1943,715,1694,26,18,214,1969,12,185,120,237,197,357,1436,2721,7,20915,1161,0,2,4,6,53570,21793,4257,28825,0
209,4409,1168,838,957,57,25,144,1225,19,348,224,416,367,640,3018,5452,11,61921,3440,1,2,4,6,53580,21795,4257,28826,0
32,2401,996,429,845,24,10,117,1020,7,76,50,88,83,138,494,879,4,3565,198,0,2,1,1,53580,21797,4257,28827,0
92,4598,1943,715,1694,26,18,214,1969,12,185,120,237,197,357,1436,2721,7,20915,1161,0,2,26,1,53580,21799,4257,28828,0
67,1795,1455,414,1257,16,76,112,1471,5,41,23,46,46,69,231,381,2,1069,59,0,2,3,0,53580,21800,4257,28829,0
67,1795,669,365,481,22,61,110,691,15,103,63,122,118,185,747,1273,8,11311,628,0,2,3,0,53590,21800,4258,28830,0
73,1417,757,253,292,73,244,162,830,13,61,38,67,74,105,409,651,7,4654,258,0,2,0,1,53590,21801,4258,28831,0
74,1419,757,253,292,73,244,162,830,13,61,38,67,74,105,409,651,7,4654,258,0,2,1,1,53590,21802,4258,28832,0
21,572,256,139,192,9,7,47,265,4,23,12,24,27,36,112,171,2,357,19,0,2,10,0,53590,21803,4258,28833,0
67,1795,1455,414,1257,16,76,112,1471,5,41,23,46,46,69,231,381,2,1069,59,0,2,2,2,53590,21804,4258,28834,0
67,1795,669,365,481,22,61,110,691,15,103,63,122,118,185,747,1273,8,11311,628,0,2,2,2,53600,21804,4259,28835,0
230,5261,4293,999,3693,19,54,507,4312,9,155,88,170,164,258,1156,1898,4,9368,520,0,2,2,2,53600,21806,4259,28836,1
230,5261,1482,859,1002,125,135,219,1607,16,219,134,251,235,385,1766,3032,9,27804,1544,1,2,2,2,53610,21807,4259,28837,1
15,466,42,7,35,4,0,5,46,1,2,1,2,3,3,2,4,0,2,0,0,2,1,1,53610,21807,4259,28838,1
15,466,11,6,10,0,0,1,11,2,4,2,4,6,6,10,15,1,15,0,0,2,1,1,53610,21807,4259,28839,1
54,1096,207,111,150,11,0,50,218,5,26,19,36,31,55,133,272,3,943,52,0,2,4,3,53610,21807,4259,28840,0
54,1096,410,198,237,31,55,97,441,11,63,38,72,74,110,414,683,6,4293,238,0,2,4,3,53620,21808,4260,28841,0
33,991,465,148,393,5,8,60,470,4,31,20,31,35,51,161,261,2,523,29,0,2,22,0,53620,21809,4260,28842,0
33,991,16,12,9,0,0,6,16,1,2,1,2,3,3,2,4,0,2,0,0,2,22,0,53620,21809,4260,28843,0
23,722,339,213,244,17,9,65,356,10,42,26,48,52,74,259,421,5,2410,133,0,2,11,0,53630,21809,4260,28844,0
36,1779,1293,570,1093,25,15,163,1318,10,195,123,241,205,364,1516,2795,6,17273,959,0,2,35,4,53640,21811,4260,28845,0
123,2925,77,34,69,0,0,8,77,3,24,16,29,27,45,114,213,1,387,21,0,2,20,0,53640,21811,4260,28846,0
123,2925,712,438,573,51,9,84,763,14,102,71,128,116,199,733,1364,8,11988,666,0,2,20,0,53650,21812,4260,28847,0
30,1233,373,158,315,8,0,51,381,5,76,44,79,81,123,486,779,2,2026,112,0,2,14,0,53650,21812,4260,28848,0
123,2925,77,34,69,0,0,8,77,3,24,16,29,27,45,114,213,1,387,21,0,2,20,0,53650,21812,4260,28849,0
123,2925,712,438,573,51,9,84,763,14,102,71,128,116,199,733,1364,8,11988,666,0,2,20,0,53660,21813,4260,28850,0
30,1233,373,158,315,8,0,51,381,5,76,44,79,81,123,486,779,2,2026,112,0,2,14,0,53660,21813,4260,28851,0
84,2178,773,422,505,30,103,129,803,14,77,46,83,91,129,535,839,7,6334,351,0,2,8,1,53670,21814,4261,28852,0
28,1711,1157,318,931,29,22,177,1186,6,104,63,125,110,188,712,1274,3,4596,255,0,2,59,0,53670,21814,4261,28853,0
79,2067,773,422,505,30,103,129,803,14,77,46,83,91,129,535,839,7,6334,351,0,2,1,1,53680,21815,4262,28854,0
26,1513,1157,318,931,29,22,177,1186,6,104,63,125,110,188,712,1274,3,4596,255,0,2,54,0,53680,21815,4262,28855,0
209,4409,1943,715,1694,26,18,214,1969,12,185,120,237,197,357,1436,2721,7,20915,1161,0,2,4,6,53680,21817,4262,28856,0
209,4409,1168,838,957,57,25,144,1225,19,348,224,416,367,640,3018,5452,11,61921,3440,1,2,4,6,53690,21819,4262,28857,0
32,2401,996,429,845,24,10,117,1020,7,76,50,88,83,138,494,879,4,3565,198,0,2,1,1,53690,21821,4262,28858,0
92,4598,1943,715,1694,26,18,214,1969,12,185,120,237,197,357,1436,2721,7,20915,1161,0,2,26,1,53690,21823,4262,28859,0
29,1792,1157,318,931,29,22,177,1186,6,104,63,125,110,188,712,1274,3,4596,255,0,2,54,0,53690,21823,4262,28860,0
54,1096,207,111,150,11,0,50,218,5,26,19,36,31,55,133,272,3,943,52,0,2,4,3,53690,21823,4262,28861,0
54,1096,410,198,237,31,55,97,441,11,63,38,72,74,110,414,683,6,4293,238,0,2,4,3,53700,21824,4263,28862,0
23,722,339,213,244,17,9,65,356,10,42,26,48,52,74,259,421,5,2410,133,0,2,14,3,53710,21824,4263,28863,0
234,5320,4293,999,3693,19,54,507,4312,9,155,88,170,164,258,1156,1898,4,9368,520,0,2,15,7,53710,21826,4263,28864,0
234,5320,1482,859,1002,125,135,219,1607,16,219,134,251,235,385,1766,3032,9,27804,1544,1,2,15,7,53720,21827,4263,28865,0
85,2182,773,422,505,30,103,129,803,14,77,46,83,91,129,535,839,7,6334,351,0,2,1,1,53730,21828,4264,28866,0
108,2218,1020,354,843,12,15,144,1032,8,134,77,144,142,221,970,1580,4,6792,377,0,2,1,1,53730,21828,4264,28867,0
259,6118,72,33,56,0,4,12,72,1,1,1,1,2,2,0,2,0,1,0,0,2,2,1,53730,21828,4264,28868,0
259,6118,1454,835,1044,76,110,219,1530,17,275,158,296,292,454,2297,3718,9,34017,1889,1,2,2,1,53740,21829,4264,28869,0
73,1425,757,253,292,73,244,162,830,13,61,38,67,74,105,409,651,7,4654,258,0,2,4,0,53740,21830,4264,28870,0
15,466,42,7,35,4,0,5,46,1,2,1,2,3,3,2,4,0,2,0,0,2,1,1,53740,21830,4264,28871,0
15,466,11,6,10,0,0,1,11,2,4,2,4,6,6,10,15,1,15,0,0,2,1,1,53740,21830,4264,28872,0
163,7176,139,89,101,2,0,35,141,7,54,34,62,61,96,330,569,4,2287,127,0,2,41,0,53740,21830,4264,28873,0
163,7176,7,5,5,0,0,2,7,1,2,1,2,3,3,2,4,0,2,0,0,2,41,0,53740,21830,4264,28874,0
33,991,465,148,393,5,8,60,470,4,31,20,31,35,51,161,261,2,523,29,0,2,22,0,53740,21831,4264,28875,0
33,991,16,12,9,0,0,6,16,1,2,1,2,3,3,2,4,0,2,0,0,2,22,0,53740,21831,4264,28876,0
36,1779,1293,570,1093,25,15,163,1318,10,195,123,241,205,364,1516,2795,6,17273,959,0,2,39,4,53750,21833,4264,28877,0
39,1724,386,256,301,16,9,68,402,4,59,35,69,63,104,355,621,2,1453,80,0,2,2,2,53750,21833,4264,28878,0
54,1096,207,111,150,11,0,50,218,5,26,19,36,31,55,133,272,3,943,52,0,2,4,3,53750,21833,4264,28879,0
54,1096,410,198,237,31,55,97,441,11,63,38,72,74,110,414,683,6,4293,238,0,2,4,3,53760,21834,4265,28880,0
23,722,339,213,244,17,9,65,356,10,42,26,48,52,74,259,421,5,2410,133,0,2,14,3,53770,21834,4265,28881,0
234,5320,4293,999,3693,19,54,507,4312,9,155,88,170,164,258,1156,1898,4,9368,520,0,2,15,7,53770,21836,4265,28882,0
234,5320,1482,859,1002,125,135,219,1607,16,219,134,251,235,385,1766,3032,9,27804,1544,1,2,15,7,53780,21837,4265,28883,0
85,2182,773,422,505,30,103,129,803,14,77,46,83,91,129,535,839,7,6334,351,0,2,1,1,53790,21838,4266,28884,0
108,2218,1020,354,843,12,15,144,1032,8,134,77,144,142,221,970,1580,4,6792,377,0,2,1,1,53790,21838,4266,28885,0
259,6118,72,33,56,0,4,12,72,1,1,1,1,2,2,0,2,0,1,0,0,2,2,1,53790,21838,4266,28886,0
259,6118,1454,835,1044,76,110,219,1530,17,275,158,296,292,454,2297,3718,9,34017,1889,1,2,2,1,53800,21839,4266,28887,0
73,1425,757,253,292,73,244,162,830,13,61,38,67,74,105,409,651,7,4654,258,0,2,4,0,53800,21840,4266,28888,0
15,466,42,7,35,4,0,5,46,1,2,1,2,3,3,2,4,0,2,0,0,2,1,1,53800,21840,4266,28889,0
15,466,11,6,10,0,0,1,11,2,4,2,4,6,6,10,15,1,15,0,0,2,1,1,53800,21840,4266,28890,0
29,1792,1157,318,931,29,22,177,1186,6,104,63,125,110,188,712,1274,3,4596,255,0,2,54,0,53800,21840,4266,28891,0
163,7176,139,89,101,2,0,35,141,7,54,34,62,61,96,330,569,4,2287,127,0,2,41,0,53800,21840,4266,28892,0
163,7176,7,5,5,0,0,2,7,1,2,1,2,3,3,2,4,0,2,0,0,2,41,0,53800,21840,4266,28893,0
33,991,465,148,393,5,8,60,470,4,31,20,31,35,51,161,261,2,523,29,0,2,22,0,53800,21841,4266,28894,0
33,991,16,12,9,0,0,6,16,1,2,1,2,3,3,2,4,0,2,0,0,2,22,0,53800,21841,4266,28895,0
36,1779,1293,570,1093,25,15,163,1318,10,195,123,241,205,364,1516,2795,6,17273,959,0,2,39,4,53810,21843,4266,28896,0
39,1724,386,256,301,16,9,68,402,4,59,35,69,63,104,355,621,2,1453,80,0,2,2,2,53810,21843,4266,28897,0
67,1795,1455,414,1257,16,76,112,1471,5,41,23,46,46,69,231,381,2,1069,59,0,2,1,1,53810,21844,4266,28898,0
67,1795,669,365,481,22,61,110,691,15,103,63,122,118,185,747,1273,8,11311,628,0,2,1,1,53820,21844,4267,28899,0
67,1795,1455,414,1257,16,76,112,1471,5,41,23,46,46,69,231,381,2,1069,59,0,2,1,1,53820,21845,4267,28900,0
67,1795,669,365,481,22,61,110,691,15,103,63,122,118,185,747,1273,8,11311,628,0,2,1,1,53830,21845,4268,28901,0
24,749,339,213,244,17,9,65,356,10,42,26,48,52,74,259,421,5,2410,133,0,2,5,0,53840,21845,4268,28902,1
37,1850,1293,570,1093,25,15,163,1318,10,195,123,241,205,364,1516,2795,6,17273,959,0,2,16,0,53850,21847,4268,28903,1
67,1795,1455,414,1257,16,76,112,1471,5,41,23,46,46,69,231,381,2,1069,59,0,2,15,0,53850,21848,4268,28904,0
67,1795,669,365,481,22,61,110,691,15,103,63,122,118,185,747,1273,8,11311,628,0,2,15,0,53860,21848,4269,28905,0
36,1762,1293,570,1093,25,15,163,1318,10,195,123,241,205,364,1516,2795,6,17273,959,0,2,0,4,53870,21850,4269,28906,0
234,5320,4293,999,3693,19,54,507,4312,9,155,88,170,164,258,1156,1898,4,9368,520,0,2,2,2,53870,21852,4269,28907,0
234,5320,1482,859,1002,125,135,219,1607,16,219,134,251,235,385,1766,3032,9,27804,1544,1,2,2,2,53880,21853,4269,28908,0
15,466,42,7,35,4,0,5,46,1,2,1,2,3,3,2,4,0,2,0,0,2,1,1,53880,21853,4269,28909,0
15,466,11,6,10,0,0,1,11,2,4,2,4,6,6,10,15,1,15,0,0,2,1,1,53880,21853,4269,28910,0
74,1419,757,253,292,73,244,162,830,13,61,38,67,74,105,409,651,7,4654,258,0,2,1,2,53880,21854,4269,28911,0
21,572,256,139,192,9,7,47,265,4,23,12,24,27,36,112,171,2,357,19,0,2,10,0,53880,21855,4269,28912,0
25,753,339,213,244,17,9,65,356,10,42,26,48,52,74,259,421,5,2410,133,0,2,10,14,53890,21855,4269,28913,1
209,4399,1943,715,1694,26,18,214,1969,12,185,120,237,197,357,1436,2721,7,20915,1161,0,2,7,7,53890,21857,4269,28914,1
209,4399,1168,838,957,57,25,144,1225,19,348,224,416,367,640,3018,5452,11,61921,3440,1,2,7,7,53900,21859,4269,28915,1
38,1882,1293,570,1093,25,15,163,1318,10,195,123,241,205,364,1516,2795,6,17273,959,0,2,7,5,53910,21861,4269,28916,1
92,4613,1943,715,1694,26,18,214,1969,12,185,120,237,197,357,1436,2721,7,20915,1161,0,2,34,18,53910,21863,4269,28917,1
84,2139,773,422,505,30,103,129,803,14,77,46,83,91,129,535,839,7,6334,351,0,2,3,10,53920,21864,4270,28918,1
27,1631,1157,318,931,29,22,177,1186,6,104,63,125,110,188,712,1274,3,4596,255,0,2,0,54,53920,21864,4270,28919,1
85,2182,773,422,505,30,103,129,803,14,77,46,83,91,129,535,839,7,6334,351,0,2,10,3,53930,21865,4271,28920,0
29,1792,1157,318,931,29,22,177,1186,6,104,63,125,110,188,712,1274,3,4596,255,0,2,54,0,53930,21865,4271,28921,0
25,753,339,213,244,17,9,65,356,10,42,26,48,52,74,259,421,5,2410,133,0,2,10,9,53940,21865,4271,28922,0
209,4399,1943,715,1694,26,18,214,1969,12,185,120,237,197,357,1436,2721,7,20915,1161,0,2,7,7,53940,21867,4271,28923,0
209,4399,1168,838,957,57,25,144,1225,19,348,224,416,367,640,3018,5452,11,61921,3440,1,2,7,7,53950,21869,4271,28924,0
38,1882,1293,570,1093,25,15,163,1318,10,195,123,241,205,364,1516,2795,6,17273,959,0,2,18,0,53960,21871,4271,28925,0
92,4613,1943,715,1694,26,18,214,1969,12,185,120,237,197,357,1436,2721,7,20915,1161,0,2,34,18,53960,21873,4271,28926,0
98,2673,1523,757,1297,19,12,193,1542,12,193,117,230,205,347,1508,2664,7,19053,1058,0,2,29,15,53970,21875,4271,28928,1
98,2673,701,378,504,33,58,109,734,13,110,68,126,123,194,794,1346,7,10027,557,0,2,29,15,53970,21876,4272,28929,1
79,1692,53,23,39,0,0,13,53,2,8,4,8,10,12,26,39,1,39,2,0,2,4,0,53970,21876,4272,28930,1
79,1692,515,298,307,33,80,99,548,12,63,44,77,75,121,419,753,7,5527,307,0,2,4,0,53980,21876,4272,28931,1
113,2525,1043,504,840,53,9,147,1096,9,180,112,198,189,310,1377,2344,4,11604,644,0,2,7,1,53980,21878,4272,28932,1
113,2525,383,288,292,26,6,62,409,11,65,38,67,76,105,429,656,5,3719,206,0,2,7,1,53980,21879,4272,28933,1
94,4604,1523,757,1297,19,12,193,1542,12,193,117,230,205,347,1508,2664,7,19053,1058,0,2,8,8,53990,21881,4272,28934,1
67,1795,1455,414,1257,16,76,112,1471,5,41,23,46,46,69,231,381,2,1069,59,0,2,15,0,53990,21882,4272,28935,0
67,1795,669,365,481,22,61,110,691,15,103,63,122,118,185,747,1273,8,11311,628,0,2,15,0,54000,21882,4273,28936,0
74,1419,757,253,292,73,244,162,830,13,61,38,67,74,105,409,651,7,4654,258,0,2,1,2,54000,21883,4273,28937,0
21,572,256,139,192,9,7,47,265,4,23,12,24,27,36,112,171,2,357,19,0,2,10,0,54000,21884,4273,28938,0
38,1865,1293,570,1093,25,15,163,1318,10,195,123,241,205,364,1516,2795,6,17273,959,0,2,0,4,54010,21886,4273,28939,0
91,4587,1943,715,1694,26,18,214,1969,12,185,120,237,197,357,1436,2721,7,20915,1161,0,2,17,12,54010,21888,4273,28940,0
98,2670,1523,757,1297,19,12,193,1542,12,193,117,230,205,347,1508,2664,7,19053,1058,0,2,2,2,54020,21890,4273,28941,0
98,2670,701,378,504,33,58,109,734,13,110,68,126,123,194,794,1346,7,10027,557,0,2,2,2,54020,21891,4274,28942,0
113,2530,1043,504,840,53,9,147,1096,9,180,112,198,189,310,1377,2344,4,11604,644,0,2,2,4,54020,21893,4274,28943,0
113,2530,383,288,292,26,6,62,409,11,65,38,67,76,105,429,656,5,3719,206,0,2,2,4,54020,21894,4274,28944,0
75,1466,757,253,292,73,244,162,830,13,61,38,67,74,105,409,651,7,4654,258,0,2,14,2,54020,21895,4274,28945,1
52,3387,520,294,400,33,13,81,553,10,261,204,367,271,571,2128,4614,7,32445,1802,1,2,1,0,54020,21896,4274,28946,1
91,4587,1943,715,1694,26,18,214,1969,12,185,120,237,197,357,1436,2721,7,20915,1161,0,2,17,12,54020,21898,4274,28947,0
234,5333,4293,999,3693,19,54,507,4312,9,155,88,170,164,258,1156,1898,4,9368,520,0,2,6,5,54020,21900,4274,28948,0
234,5333,1482,859,1002,125,135,219,1607,16,219,134,251,235,385,1766,3032,9,27804,1544,1,2,6,5,54030,21901,4274,28949,0
75,1466,757,253,292,73,244,162,830,13,61,38,67,74,105,409,651,7,4654,258,0,2,14,2,54030,21902,4274,28950,0
52,3387,520,294,400,33,13,81,553,10,261,204,367,271,571,2128,4614,7,32445,1802,1,2,1,0,54030,21903,4274,28951,0
98,2670,1523,757,1297,19,12,193,1542,12,193,117,230,205,347,1508,2664,7,19053,1058,0,2,29,15,54040,21905,4274,28953,0
98,2670,701,378,504,33,58,109,734,13,110,68,126,123,194,794,1346,7,10027,557,0,2,29,15,54040,21906,4275,28954,0
79,1692,53,23,39,0,0,13,53,2,8,4,8,10,12,26,39,1,39,2,0,2,4,0,54040,21906,4275,28955,0
79,1692,515,298,307,33,80,99,548,12,63,44,77,75,121,419,753,7,5527,307,0,2,4,0,54050,21906,4275,28956,0
113,2530,1043,504,840,53,9,147,1096,9,180,112,198,189,310,1377,2344,4,11604,644,0,2,6,2,54050,21908,4275,28957,0
113,2530,383,288,292,26,6,62,409,11,65,38,67,76,105,429,656,5,3719,206,0,2,6,2,54050,21909,4275,28958,0
94,4604,1523,757,1297,19,12,193,1542,12,193,117,230,205,347,1508,2664,7,19053,1058,0,2,8,8,54060,21911,4275,28959,0
164,7205,139,89,101,2,0,35,141,7,54,34,62,61,96,330,569,4,2287,127,0,2,35,0,54060,21911,4275,28960,1
164,7205,7,5,5,0,0,2,7,1,2,1,2,3,3,2,4,0,2,0,0,2,35,0,54060,21911,4275,28961,1
234,5348,4293,999,3693,19,54,507,4312,9,155,88,170,164,258,1156,1898,4,9368,520,0,2,6,2,54060,21913,4275,28962,0
234,5348,1482,859,1002,125,135,219,1607,16,219,134,251,235,385,1766,3032,9,27804,1544,1,2,6,2,54070,21914,4275,28963,0
108,2220,2,2,2,0,0,0,2,0,0,0,0,0,0,0,0,0,0,0,0,3,2,2,54070,21914,4275,28963,0
108,2220,99,48,90,1,3,5,100,0,0,0,0,0,0,0,0,0,0,0,0,3,2,2,54070,21915,4275,28964,0
108,2220,8,5,5,2,0,1,10,0,0,0,0,0,0,0,0,0,0,0,0,3,2,2,54070,21915,4275,28965,0
108,2220,1217,716,841,84,126,174,1301,14,185,118,215,199,333,1446,2542,8,20687,1149,0,3,2,2,54080,21917,4275,28966,0
108,2220,160,89,115,0,13,31,160,7,15,11,17,22,28,78,124,3,495,27,0,3,2,2,54080,21917,4275,28967,0
108,2220,10,10,9,9,0,0,19,0,0,0,0,0,0,0,0,0,0,0,0,3,2,2,54080,21917,4276,28968,0
108,2220,173,84,99,8,29,36,181,5,12,7,13,17,20,54,81,2,221,12,0,3,2,2,54080,21918,4276,28969,0
108,2220,3,1,1,3,0,0,6,0,0,0,0,0,0,0,0,0,0,0,0,3,2,2,54080,21918,4276,28970,0
33,701,125,97,103,3,0,19,128,9,25,17,27,34,44,144,223,4,1087,60,0,0,126,0,54080,21918,4277,28971,1
75,1390,1178,367,1042,6,15,115,1184,9,94,51,95,103,146,644,976,4,4439,246,0,2,2,123,54080,21918,4277,28972,1
75,1390,177,108,140,8,0,27,185,6,30,16,32,36,48,162,248,3,794,44,0,2,2,123,54080,21920,4277,28973,1
71,1417,1178,367,1042,6,15,115,1184,9,94,51,95,103,146,644,976,4,4439,246,0,2,21,12,54080,21920,4277,28974,0
71,1417,177,108,140,8,0,27,185,6,30,16,32,36,48,162,248,3,794,44,0,2,21,12,54080,21922,4277,28975,0
15,468,42,7,35,4,0,5,46,1,2,1,2,3,3,2,4,0,2,0,0,2,1,1,54080,21922,4277,28976,0
15,468,11,6,10,0,0,1,11,2,4,2,4,6,6,10,15,1,15,0,0,2,1,1,54080,21922,4277,28977,0
85,1879,2,2,2,0,0,0,2,0,0,0,0,0,0,0,0,0,0,0,0,2,1,84,54080,21922,4277,28977,1
85,1879,99,48,90,1,3,5,100,0,0,0,0,0,0,0,0,0,0,0,0,2,1,84,54080,21923,4277,28978,1
85,1879,8,5,5,2,0,1,10,0,0,0,0,0,0,0,0,0,0,0,0,2,1,84,54080,21923,4277,28979,1
85,1879,1217,716,841,84,126,174,1301,14,185,118,215,199,333,1446,2542,8,20687,1149,0,2,1,84,54090,21925,4277,28980,1
85,1879,160,89,115,0,13,31,160,7,15,11,17,22,28,78,124,3,495,27,0,2,1,84,54090,21925,4277,28981,1
85,1879,10,10,9,9,0,0,19,0,0,0,0,0,0,0,0,0,0,0,0,2,1,84,54090,21925,4278,28982,1
85,1879,173,84,99,8,29,36,181,5,12,7,13,17,20,54,81,2,221,12,0,2,1,84,54090,21926,4278,28983,1
85,1879,3,1,1,3,0,0,6,0,0,0,0,0,0,0,0,0,0,0,0,2,1,84,54090,21926,4278,28984,1
23,363,102,57,55,5,16,25,107,5,17,10,18,22,28,81,124,2,330,18,0,0,93,0,54090,21926,4278,28985,1
24,380,102,57,55,5,16,25,107,5,17,10,18,22,28,81,124,2,330,18,0,2,22,18,54090,21926,4278,28986,1
22,528,2,2,2,0,0,0,2,0,0,0,0,0,0,0,0,0,0,0,0,2,5,330,54090,21926,4278,28986,1
22,528,99,48,90,1,3,5,100,0,0,0,0,0,0,0,0,0,0,0,0,2,5,330,54090,21927,4278,28987,1
22,528,8,5,5,2,0,1,10,0,0,0,0,0,0,0,0,0,0,0,0,2,5,330,54090,21927,4278,28988,1
22,528,1217,716,841,84,126,174,1301,14,185,118,215,199,333,1446,2542,8,20687,1149,0,2,5,330,54100,21929,4278,28989,1
22,528,160,89,115,0,13,31,160,7,15,11,17,22,28,78,124,3,495,27,0,2,5,330,54100,21929,4278,28990,1
22,528,10,10,9,9,0,0,19,0,0,0,0,0,0,0,0,0,0,0,0,2,5,330,54100,21929,4279,28991,1
22,528,173,84,99,8,29,36,181,5,12,7,13,17,20,54,81,2,221,12,0,2,5,330,54100,21930,4279,28992,1
22,528,3,1,1,3,0,0,6,0,0,0,0,0,0,0,0,0,0,0,0,2,5,330,54100,21930,4279,28993,1
63,1378,402,202,227,24,74,80,426,12,52,33,61,64,94,339,564,7,3969,220,0,0,330,0,54100,21931,4279,28994,1
259,6120,72,33,56,0,4,12,72,1,1,1,1,2,2,0,2,0,1,0,0,2,1,1,54100,21931,4279,28995,1
259,6120,1454,835,1044,76,110,219,1530,17,275,158,296,292,454,2297,3718,9,34017,1889,1,2,1,1,54110,21932,4279,28996,1
24,588,2,2,2,0,0,0,2,0,0,0,0,0,0,0,0,0,0,0,0,2,26,12,54110,21932,4279,28996,0
24,588,99,48,90,1,3,5,100,0,0,0,0,0,0,0,0,0,0,0,0,2,26,12,54110,21933,4279,28997,0
24,588,8,5,5,2,0,1,10,0,0,0,0,0,0,0,0,0,0,0,0,2,26,12,54110,21933,4279,28998,0
24,588,1217,716,841,84,126,174,1301,14,185,118,215,199,333,1446,2542,8,20687,1149,0,2,26,12,54120,21935,4279,28999,0
24,588,160,89,115,0,13,31,160,7,15,11,17,22,28,78,124,3,495,27,0,2,26,12,54120,21935,4279,29000,0
24,588,10,10,9,9,0,0,19,0,0,0,0,0,0,0,0,0,0,0,0,2,26,12,54120,21935,4280,29001,0
24,588,173,84,99,8,29,36,181,5,12,7,13,17,20,54,81,2,221,12,0,2,26,12,54120,21936,4280,29002,0
24,588,3,1,1,3,0,0,6,0,0,0,0,0,0,0,0,0,0,0,0,2,26,12,54120,21936,4280,29003,0
24,599,2,2,2,0,0,0,2,0,0,0,0,0,0,0,0,0,0,0,0,2,6,2,54120,21936,4280,29003,0
24,599,99,48,90,1,3,5,100,0,0,0,0,0,0,0,0,0,0,0,0,2,6,2,54120,21937,4280,29004,0
24,599,8,5,5,2,0,1,10,0,0,0,0,0,0,0,0,0,0,0,0,2,6,2,54120,21937,4280,29005,0
24,599,1217,716,841,84,126,174,1301,14,185,118,215,199,333,1446,2542,8,20687,1149,0,2,6,2,54130,21939,4280,29006,0
24,599,160,89,115,0,13,31,160,7,15,11,17,22,28,78,124,3,495,27,0,2,6,2,54130,21939,4280,29007,0
24,599,10,10,9,9,0,0,19,0,0,0,0,0,0,0,0,0,0,0,0,2,6,2,54130,21939,4281,29008,0
24,599,173,84,99,8,29,36,181,5,12,7,13,17,20,54,81,2,221,12,0,2,6,2,54130,21940,4281,29009,0
24,599,3,1,1,3,0,0,6,0,0,0,0,0,0,0,0,0,0,0,0,2,6,2,54130,21940,4281,29010,0
259,6120,72,33,56,0,4,12,72,1,1,1,1,2,2,0,2,0,1,0,0,2,1,1,54130,21940,4281,29011,0
259,6120,1454,835,1044,76,110,219,1530,17,275,158,296,292,454,2297,3718,9,34017,1889,1,2,1,1,54140,21941,4281,29012,0
39,1946,1293,570,1093,25,15,163,1318,10,195,123,241,205,364,1516,2795,6,17273,959,0,2,18,0,54150,21943,4281,29013,1
33,701,125,97,103,3,0,19,128,9,25,17,27,34,44,144,223,4,1087,60,0,2,0,1,54150,21943,4282,29014,0
234,5348,4293,999,3693,19,54,507,4312,9,155,88,170,164,258,1156,1898,4,9368,520,0,2,9,4,54150,21945,4282,29015,0
234,5348,1482,859,1002,125,135,219,1607,16,219,134,251,235,385,1766,3032,9,27804,1544,1,2,9,4,54160,21946,4282,29016,0
164,7205,139,89,101,2,0,35,141,7,54,34,62,61,96,330,569,4,2287,127,0,2,35,0,54160,21946,4282,29017,0
164,7205,7,5,5,0,0,2,7,1,2,1,2,3,3,2,4,0,2,0,0,2,35,0,54160,21946,4282,29018,0
39,1946,1293,570,1093,25,15,163,1318,10,195,123,241,205,364,1516,2795,6,17273,959,0,2,18,0,54170,21948,4282,29019,0
82,2133,1455,414,1257,16,76,112,1471,5,41,23,46,46,69,231,381,2,1069,59,0,2,141,45,54170,21949,4282,29020,0
82,2133,669,365,481,22,61,110,691,15,103,63,122,118,185,747,1273,8,11311,628,0,2,141,45,54180,21949,4283,29021,0
69,3191,1455,414,1257,16,76,112,1471,5,41,23,46,46,69,231,381,2,1069,59,0,2,19,0,54180,21950,4283,29022,0
98,2670,1523,757,1297,19,12,193,1542,12,193,117,230,205,347,1508,2664,7,19053,1058,0,2,29,15,54190,21952,4283,29024,0
98,2670,701,378,504,33,58,109,734,13,110,68,126,123,194,794,1346,7,10027,557,0,2,29,15,54190,21953,4284,29025,0
79,1692,53,23,39,0,0,13,53,2,8,4,8,10,12,26,39,1,39,2,0,2,4,0,54190,21953,4284,29026,0
79,1692,515,298,307,33,80,99,548,12,63,44,77,75,121,419,753,7,5527,307,0,2,4,0,54200,21953,4284,29027,0
113,2530,1043,504,840,53,9,147,1096,9,180,112,198,189,310,1377,2344,4,11604,644,0,2,6,2,54200,21955,4284,29028,0
113,2530,383,288,292,26,6,62,409,11,65,38,67,76,105,429,656,5,3719,206,0,2,6,2,54200,21956,4284,29029,0
94,4604,1523,757,1297,19,12,193,1542,12,193,117,230,205,347,1508,2664,7,19053,1058,0,2,8,8,54210,21958,4284,29030,0
39,1946,1293,570,1093,25,15,163,1318,10,195,123,241,205,364,1516,2795,6,17273,959,0,2,18,0,54220,21960,4284,29031,0
70,1621,996,429,845,24,10,117,1020,7,76,50,88,83,138,494,879,4,3565,198,0,2,19,18,54220,21962,4284,29032,1
70,1621,456,277,329,12,42,72,468,13,85,50,97,98,147,592,972,7,7212,400,0,2,19,18,54220,21962,4284,29033,1
34,2709,996,429,845,24,10,117,1020,7,76,50,88,83,138,494,879,4,3565,198,0,2,30,34,54220,21964,4284,29034,1
54,1096,207,111,150,11,0,50,218,5,26,19,36,31,55,133,272,3,943,52,0,2,4,3,54220,21964,4284,29035,0
54,1096,410,198,237,31,55,97,441,11,63,38,72,74,110,414,683,6,4293,238,0,2,4,3,54230,21965,4285,29036,0
25,753,339,213,244,17,9,65,356,10,42,26,48,52,74,259,421,5,2410,133,0,2,15,3,54240,21965,4285,29037,0
67,1795,1455,414,1257,16,76,112,1471,5,41,23,46,46,69,231,381,2,1069,59,0,2,15,0,54240,21966,4285,29039,0
67,1795,669,365,481,22,61,110,691,15,103,63,122,118,185,747,1273,8,11311,628,0,2,15,0,54250,21966,4286,29040,0
234,5320,4293,999,3693,19,54,507,4312,9,155,88,170,164,258,1156,1898,4,9368,520,0,2,17,9,54250,21968,4286,29041,0
234,5320,1482,859,1002,125,135,219,1607,16,219,134,251,235,385,1766,3032,9,27804,1544,1,2,17,9,54260,21969,4286,29042,0
98,2670,1523,757,1297,19,12,193,1542,12,193,117,230,205,347,1508,2664,7,19053,1058,0,2,29,15,54270,21971,4286,29043,0
98,2670,701,378,504,33,58,109,734,13,110,68,126,123,194,794,1346,7,10027,557,0,2,29,15,54270,21972,4287,29044,0
85,2182,773,422,505,30,103,129,803,14,77,46,83,91,129,535,839,7,6334,351,0,2,9,2,54280,21973,4288,29045,0
123,2925,77,34,69,0,0,8,77,3,24,16,29,27,45,114,213,1,387,21,0,2,20,0,54280,21973,4288,29046,0
123,2925,712,438,573,51,9,84,763,14,102,71,128,116,199,733,1364,8,11988,666,0,2,20,0,54290,21974,4288,29047,0
108,2218,1020,354,843,12,15,144,1032,8,134,77,144,142,221,970,1580,4,6792,377,0,2,1,1,54290,21974,4288,29048,0
79,1692,53,23,39,0,0,13,53,2,8,4,8,10,12,26,39,1,39,2,0,2,4,0,54290,21974,4288,29049,0
79,1692,515,298,307,33,80,99,548,12,63,44,77,75,121,419,753,7,5527,307,0,2,4,0,54300,21974,4288,29050,0
259,6118,72,33,56,0,4,12,72,1,1,1,1,2,2,0,2,0,1,0,0,2,2,1,54300,21974,4288,29051,0
259,6118,1454,835,1044,76,110,219,1530,17,275,158,296,292,454,2297,3718,9,34017,1889,1,2,2,1,54310,21975,4288,29052,0
74,1419,757,253,292,73,244,162,830,13,61,38,67,74,105,409,651,7,4654,258,0,2,5,2,54310,21976,4288,29053,0
113,2530,1043,504,840,53,9,147,1096,9,180,112,198,189,310,1377,2344,4,11604,644,0,2,6,2,54310,21978,4288,29054,0
113,2530,383,288,292,26,6,62,409,11,65,38,67,76,105,429,656,5,3719,206,0,2,6,2,54310,21979,4288,29055,0
209,4399,1943,715,1694,26,18,214,1969,12,185,120,237,197,357,1436,2721,7,20915,1161,0,2,11,13,54310,21981,4288,29056,0
209,4399,1168,838,957,57,25,144,1225,19,348,224,416,367,640,3018,5452,11,61921,3440,1,2,11,13,54320,21983,4288,29057,0
15,466,42,7,35,4,0,5,46,1,2,1,2,3,3,2,4,0,2,0,0,2,2,2,54320,21983,4288,29058,0
15,466,11,6,10,0,0,1,11,2,4,2,4,6,6,10,15,1,15,0,0,2,2,2,54320,21983,4288,29059,0
29,1792,1157,318,931,29,22,177,1186,6,104,63,125,110,188,712,1274,3,4596,255,0,2,113,0,54320,21983,4288,29060,0
163,7176,139,89,101,2,0,35,141,7,54,34,62,61,96,330,569,4,2287,127,0,2,41,0,54320,21983,4288,29061,0
163,7176,7,5,5,0,0,2,7,1,2,1,2,3,3,2,4,0,2,0,0,2,41,0,54320,21983,4288,29062,0
33,991,465,148,393,5,8,60,470,4,31,20,31,35,51,161,261,2,523,29,0,2,22,0,54320,21984,4288,29063,0
33,991,16,12,9,0,0,6,16,1,2,1,2,3,3,2,4,0,2,0,0,2,22,0,54320,21984,4288,29064,0
21,572,256,139,192,9,7,47,265,4,23,12,24,27,36,112,171,2,357,19,0,2,10,0,54320,21985,4288,29065,0
34,2709,996,429,845,24,10,117,1020,7,76,50,88,83,138,494,879,4,3565,198,0,2,1,1,54320,21987,4288,29066,0
94,4604,1523,757,1297,19,12,193,1542,12,193,117,230,205,347,1508,2664,7,19053,1058,0,2,8,8,54330,21989,4288,29067,0
39,1946,1293,570,1093,25,15,163,1318,10,195,123,241,205,364,1516,2795,6,17273,959,0,2,71,4,54340,21991,4288,29068,0
39,1724,386,256,301,16,9,68,402,4,59,35,69,63,104,355,621,2,1453,80,0,2,2,2,54340,21991,4288,29069,0
30,1233,373,158,315,8,0,51,381,5,76,44,79,81,123,486,779,2,2026,112,0,2,14,0,54340,21991,4288,29070,0
91,4587,1943,715,1694,26,18,214,1969,12,185,120,237,197,357,1436,2721,7,20915,1161,0,2,77,31,54340,21993,4288,29071,0
82,2133,1455,414,1257,16,76,112,1471,5,41,23,46,46,69,231,381,2,1069,59,0,2,0,22,54340,21994,4288,29072,0
82,2133,669,365,481,22,61,110,691,15,103,63,122,118,185,747,1273,8,11311,628,0,2,0,22,54350,21994,4289,29073,0
69,3182,1455,414,1257,16,76,112,1471,5,41,23,46,46,69,231,381,2,1069,59,0,2,7,5,54350,21995,4289,29074,0
83,2145,1455,414,1257,16,76,112,1471,5,41,23,46,46,69,231,381,2,1069,59,0,2,25,16,54350,21996,4289,29075,0
83,2145,669,365,481,22,61,110,691,15,103,63,122,118,185,747,1273,8,11311,628,0,2,25,16,54360,21996,4290,29076,0
69,3184,1455,414,1257,16,76,112,1471,5,41,23,46,46,69,231,381,2,1069,59,0,2,1,1,54360,21997,4290,29077,0
24,599,2,2,2,0,0,0,2,0,0,0,0,0,0,0,0,0,0,0,0,0,141,0,54360,21997,4290,29077,0
24,599,99,48,90,1,3,5,100,0,0,0,0,0,0,0,0,0,0,0,0,0,141,0,54360,21998,4290,29078,0
24,599,8,5,5,2,0,1,10,0,0,0,0,0,0,0,0,0,0,0,0,0,141,0,54360,21998,4290,29079,0
24,599,1217,716,841,84,126,174,1301,14,185,118,215,199,333,1446,2542,8,20687,1149,0,0,141,0,54370,22000,4290,29080,0
24,599,160,89,115,0,13,31,160,7,15,11,17,22,28,78,124,3,495,27,0,0,141,0,54370,22000,4290,29081,0
24,599,10,10,9,9,0,0,19,0,0,0,0,0,0,0,0,0,0,0,0,0,141,0,54370,22000,4291,29082,0
24,599,173,84,99,8,29,36,181,5,12,7,13,17,20,54,81,2,221,12,0,0,141,0,54370,22001,4291,29083,0
24,599,3,1,1,3,0,0,6,0,0,0,0,0,0,0,0,0,0,0,0,0,141,0,54370,22001,4291,29084,0
33,701,125,97,103,3,0,19,128,9,25,17,27,34,44,144,223,4,1087,60,0,0,125,0,54370,22001,4292,29085,0
24,380,102,57,55,5,16,25,107,5,17,10,18,22,28,81,124,2,330,18,0,0,97,0,54370,22001,4292,29086,0
63,1378,402,202,227,24,74,80,426,12,52,33,61,64,94,339,564,7,3969,220,0,3,83,284,54370,22002,4292,29087,0
259,6120,72,33,56,0,4,12,72,1,1,1,1,2,2,0,2,0,1,0,0,2,1,1,54370,22002,4292,29088,0
259,6120,1454,835,1044,76,110,219,1530,17,275,158,296,292,454,2297,3718,9,34017,1889,1,2,1,1,54380,22003,4292,29089,0
71,1417,1178,367,1042,6,15,115,1184,9,94,51,95,103,146,644,976,4,4439,246,0,2,23,135,54380,22003,4292,29090,0
71,1417,177,108,140,8,0,27,185,6,30,16,32,36,48,162,248,3,794,44,0,2,23,135,54380,22005,4292,29091,0
15,468,42,7,35,4,0,5,46,1,2,1,2,3,3,2,4,0,2,0,0,2,1,1,54380,22005,4292,29092,0
15,468,11,6,10,0,0,1,11,2,4,2,4,6,6,10,15,1,15,0,0,2,1,1,54380,22005,4292,29093,0
33,707,125,97,103,3,0,19,128,9,25,17,27,34,44,144,223,4,1087,60,0,2,2,1,54380,22005,4293,29094,0
75,3157,1178,367,1042,6,15,115,1184,9,94,51,95,103,146,644,976,4,4439,246,0,2,10,0,54380,22005,4293,29095,0
208,4359,1943,715,1694,26,18,214,1969,12,185,120,237,197,357,1436,2721,7,20915,1161,0,2,2,0,54380,22007,4293,29096,0
208,4359,1168,838,957,57,25,144,1225,19,348,224,416,367,640,3018,5452,11,61921,3440,1,2,2,0,54390,22009,4293,29097,0
90,4387,1943,715,1694,26,18,214,1969,12,185,120,237,197,357,1436,2721,7,20915,1161,0,2,1,0,54390,22011,4293,29098,0
90,4395,1943,715,1694,26,18,214,1969,12,185,120,237,197,357,1436,2721,7,20915,1161,0,2,2,0,54390,22013,4293,29099,0
51,597,647,139,84,35,284,233,682,0,0,0,0,0,0,0,0,0,0,0,0,2,10,2,54390,22013,4293,29100,1
71,1415,1178,367,1042,6,15,115,1184,9,94,51,95,103,146,644,976,4,4439,246,0,2,10,8,54390,22013,4293,29101,1
71,1415,177,108,140,8,0,27,185,6,30,16,32,36,48,162,248,3,794,44,0,2,10,8,54390,22015,4293,29102,1
210,4421,1943,715,1694,26,18,214,1969,12,185,120,237,197,357,1436,2721,7,20915,1161,0,2,9,4,54390,22017,4293,29103,1
210,4421,1168,838,957,57,25,144,1225,19,348,224,416,367,640,3018,5452,11,61921,3440,1,2,9,4,54400,22019,4293,29104,1
75,3160,1178,367,1042,6,15,115,1184,9,94,51,95,103,146,644,976,4,4439,246,0,2,15,0,54400,22019,4293,29105,1
76,3201,1178,367,1042,6,15,115,1184,9,94,51,95,103,146,644,976,4,4439,246,0,2,15,0,54400,22019,4293,29106,0
76,3201,1178,367,1042,6,15,115,1184,9,94,51,95,103,146,644,976,4,4439,246,0,2,1,1,54400,22019,4293,29107,0
72,1450,757,253,292,73,244,162,830,13,61,38,67,74,105,409,651,7,4654,258,0,2,6,9,54400,22020,4293,29108,1
15,468,42,7,35,4,0,5,46,1,2,1,2,3,3,2,4,0,2,0,0,2,1,0,54400,22020,4293,29109,1
15,468,11,6,10,0,0,1,11,2,4,2,4,6,6,10,15,1,15,0,0,2,1,0,54400,22020,4293,29110,1
51,595,647,139,84,35,284,233,682,0,0,0,0,0,0,0,0,0,0,0,0,2,1,2,54400,22020,4293,29111,0
210,4415,1943,715,1694,26,18,214,1969,12,185,120,237,197,357,1436,2721,7,20915,1161,0,2,0,1,54400,22022,4293,29112,0
210,4415,1168,838,957,57,25,144,1225,19,348,224,416,367,640,3018,5452,11,61921,3440,1,2,0,1,54410,22024,4293,29113,0
208,4359,1943,715,1694,26,18,214,1969,12,185,120,237,197,357,1436,2721,7,20915,1161,0,2,2,0,54410,22026,4293,29114,0
208,4359,1168,838,957,57,25,144,1225,19,348,224,416,367,640,3018,5452,11,61921,3440,1,2,2,0,54420,22028,4293,29115,0
90,4395,1943,715,1694,26,18,214,1969,12,185,120,237,197,357,1436,2721,7,20915,1161,0,2,3,0,54420,22030,4293,29116,0
83,2145,1455,414,1257,16,76,112,1471,5,41,23,46,46,69,231,381,2,1069,59,0,2,128,45,54420,22031,4293,29117,0
83,2145,669,365,481,22,61,110,691,15,103,63,122,118,185,747,1273,8,11311,628,0,2,128,45,54430,22031,4294,29118,0
69,3184,1455,414,1257,16,76,112,1471,5,41,23,46,46,69,231,381,2,1069,59,0,2,21,0,54430,22032,4294,29119,0
33,707,125,97,103,3,0,19,128,9,25,17,27,34,44,144,223,4,1087,60,0,2,2,1,54430,22032,4295,29120,0
76,3201,1178,367,1042,6,15,115,1184,9,94,51,95,103,146,644,976,4,4439,246,0,2,25,0,54430,22032,4295,29121,0
352,7039,1457,730,1242,11,6,188,1468,10,292,166,329,302,495,2424,4078,5,22973,1276,1,2,11,4,54430,22034,4295,29122,0
352,7039,74,35,59,1,0,14,75,3,14,7,14,17,21,58,85,1,128,7,0,2,11,4,54430,22035,4295,29123,0
352,7039,245,125,200,5,7,34,250,7,30,17,34,37,51,166,265,3,1053,58,0,2,11,4,54440,22036,4295,29124,0
84,4429,1457,730,1242,11,6,188,1468,10,292,166,329,302,495,2424,4078,5,22973,1276,1,2,7,0,54440,22038,4295,29125,0
352,7048,1457,730,1242,11,6,188,1468,10,292,166,329,302,495,2424,4078,5,22973,1276,1,2,3,2,54440,22040,4295,29126,0
352,7048,74,35,59,1,0,14,75,3,14,7,14,17,21,58,85,1,128,7,0,2,3,2,54440,22041,4295,29127,0
352,7048,245,125,200,5,7,34,250,7,30,17,34,37,51,166,265,3,1053,58,0,2,3,2,54450,22042,4295,29128,0
349,7017,1457,730,1242,11,6,188,1468,10,292,166,329,302,495,2424,4078,5,22973,1276,1,2,0,4,54450,22044,4295,29129,0
349,7017,74,35,59,1,0,14,75,3,14,7,14,17,21,58,85,1,128,7,0,2,0,4,54450,22045,4295,29130,0
349,7017,245,125,200,5,7,34,250,7,30,17,34,37,51,166,265,3,1053,58,0,2,0,4,54460,22046,4295,29131,0
51,595,647,139,84,35,284,233,682,0,0,0,0,0,0,0,0,0,0,0,0,2,8,1,54460,22046,4295,29132,0
71,1415,1178,367,1042,6,15,115,1184,9,94,51,95,103,146,644,976,4,4439,246,0,2,10,8,54460,22046,4295,29133,0
71,1415,177,108,140,8,0,27,185,6,30,16,32,36,48,162,248,3,794,44,0,2,10,8,54460,22048,4295,29134,0
210,4415,1943,715,1694,26,18,214,1969,12,185,120,237,197,357,1436,2721,7,20915,1161,0,2,8,4,54460,22050,4295,29135,0
210,4415,1168,838,957,57,25,144,1225,19,348,224,416,367,640,3018,5452,11,61921,3440,1,2,8,4,54470,22052,4295,29136,0
77,3237,1178,367,1042,6,15,115,1184,9,94,51,95,103,146,644,976,4,4439,246,0,2,15,0,54470,22052,4295,29137,0
349,7017,1457,730,1242,11,6,188,1468,10,292,166,329,302,495,2424,4078,5,22973,1276,1,2,8,4,54470,22054,4295,29138,0
349,7017,74,35,59,1,0,14,75,3,14,7,14,17,21,58,85,1,128,7,0,2,8,4,54470,22055,4295,29139,0
349,7017,245,125,200,5,7,34,250,7,30,17,34,37,51,166,265,3,1053,58,0,2,8,4,54480,22056,4295,29140,0
84,4429,1457,730,1242,11,6,188,1468,10,292,166,329,302,495,2424,4078,5,22973,1276,1,2,7,0,54480,22058,4295,29141,0
352,7076,1457,730,1242,11,6,188,1468,10,292,166,329,302,495,2424,4078,5,22973,1276,1,2,8,4,54480,22060,4295,29142,0
352,7076,74,35,59,1,0,14,75,3,14,7,14,17,21,58,85,1,128,7,0,2,8,4,54480,22061,4295,29143,0
352,7076,245,125,200,5,7,34,250,7,30,17,34,37,51,166,265,3,1053,58,0,2,8,4,54490,22062,4295,29144,0
234,5348,4293,999,3693,19,54,507,4312,9,155,88,170,164,258,1156,1898,4,9368,520,0,2,9,4,54490,22064,4295,29145,0
234,5348,1482,859,1002,125,135,219,1607,16,219,134,251,235,385,1766,3032,9,27804,1544,1,2,9,4,54500,22065,4295,29146,0
75,1466,757,253,292,73,244,162,830,13,61,38,67,74,105,409,651,7,4654,258,0,2,14,2,54500,22066,4295,29147,0
211,4429,1943,715,1694,26,18,214,1969,12,185,120,237,197,357,1436,2721,7,20915,1161,0,2,2,0,54500,22068,4295,29148,0
211,4429,1168,838,957,57,25,144,1225,19,348,224,416,367,640,3018,5452,11,61921,3440,1,2,2,0,54510,22070,4295,29149,0
52,3387,520,294,400,33,13,81,553,10,261,204,367,271,571,2128,4614,7,32445,1802,1,2,1,0,54510,22071,4295,29150,0
164,7205,139,89,101,2,0,35,141,7,54,34,62,61,96,330,569,4,2287,127,0,2,35,0,54510,22071,4295,29151,0
164,7205,7,5,5,0,0,2,7,1,2,1,2,3,3,2,4,0,2,0,0,2,35,0,54510,22071,4295,29152,0
84,4429,1457,730,1242,11,6,188,1468,10,292,166,329,302,495,2424,4078,5,22973,1276,1,2,7,0,54510,22073,4295,29153,0
91,4606,1943,715,1694,26,18,214,1969,12,185,120,237,197,357,1436,2721,7,20915,1161,0,2,3,0,54510,22075,4295,29154,0
77,3237,1178,367,1042,6,15,115,1184,9,94,51,95,103,146,644,976,4,4439,246,0,2,1,1,54510,22075,4295,29155,0
77,3237,1178,367,1042,6,15,115,1184,9,94,51,95,103,146,644,976,4,4439,246,0,2,1,1,54510,22075,4295,29156,0
352,7076,1457,730,1242,11,6,188,1468,10,292,166,329,302,495,2424,4078,5,22973,1276,1,2,8,4,54510,22077,4295,29157,0
352,7076,74,35,59,1,0,14,75,3,14,7,14,17,21,58,85,1,128,7,0,2,8,4,54510,22078,4295,29158,0
352,7076,245,125,200,5,7,34,250,7,30,17,34,37,51,166,265,3,1053,58,0,2,8,4,54520,22079,4295,29159,0
234,5348,4293,999,3693,19,54,507,4312,9,155,88,170,164,258,1156,1898,4,9368,520,0,2,9,4,54520,22081,4295,29160,0
234,5348,1482,859,1002,125,135,219,1607,16,219,134,251,235,385,1766,3032,9,27804,1544,1,2,9,4,54530,22082,4295,29161,0
75,1466,757,253,292,73,244,162,830,13,61,38,67,74,105,409,651,7,4654,258,0,2,14,2,54530,22083,4295,29162,0
211,4429,1943,715,1694,26,18,214,1969,12,185,120,237,197,357,1436,2721,7,20915,1161,0,2,2,0,54530,22085,4295,29163,0
211,4429,1168,838,957,57,25,144,1225,19,348,224,416,367,640,3018,5452,11,61921,3440,1,2,2,0,54540,22087,4295,29164,0
52,3387,520,294,400,33,13,81,553,10,261,204,367,271,571,2128,4614,7,32445,1802,1,2,1,0,54540,22088,4295,29165,0
164,7205,139,89,101,2,0,35,141,7,54,34,62,61,96,330,569,4,2287,127,0,2,35,0,54540,22088,4295,29166,0
164,7205,7,5,5,0,0,2,7,1,2,1,2,3,3,2,4,0,2,0,0,2,35,0,54540,22088,4295,29167,0
84,4429,1457,730,1242,11,6,188,1468,10,292,166,329,302,495,2424,4078,5,22973,1276,1,2,7,0,54540,22090,4295,29168,0
91,4606,1943,715,1694,26,18,214,1969,12,185,120,237,197,357,1436,2721,7,20915,1161,0,2,3,0,54540,22092,4295,29169,0
72,1450,757,253,292,73,244,162,830,13,61,38,67,74,105,409,651,7,4654,258,0,2,6,9,54540,22093,4295,29170,0
15,468,42,7,35,4,0,5,46,1,2,1,2,3,3,2,4,0,2,0,0,2,1,0,54540,22093,4295,29171,0
15,468,11,6,10,0,0,1,11,2,4,2,4,6,6,10,15,1,15,0,0,2,1,0,54540,22093,4295,29172,0
355,7107,1457,730,1242,11,6,188,1468,10,292,166,329,302,495,2424,4078,5,22973,1276,1,2,4,0,54540,22095,4295,29173,0
355,7107,74,35,59,1,0,14,75,3,14,7,14,17,21,58,85,1,128,7,0,2,4,0,54540,22096,4295,29174,0
355,7107,245,125,200,5,7,34,250,7,30,17,34,37,51,166,265,3,1053,58,0,2,4,0,54550,22097,4295,29175,0
12,459,75,38,59,1,3,12,76,2,4,2,4,6,6,10,15,1,15,0,0,2,9,0,54550,22097,4295,29176,0
355,7114,1457,730,1242,11,6,188,1468,10,292,166,329,302,495,2424,4078,5,22973,1276,1,2,4,4,54550,22099,4295,29177,0
355,7114,74,35,59,1,0,14,75,3,14,7,14,17,21,58,85,1,128,7,0,2,4,4,54550,22100,4295,29178,0
355,7114,245,125,200,5,7,34,250,7,30,17,34,37,51,166,265,3,1053,58,0,2,4,4,54560,22101,4295,29179,0
355,7114,1457,730,1242,11,6,188,1468,10,292,166,329,302,495,2424,4078,5,22973,1276,1,2,6,2,54560,22103,4295,29181,0
355,7114,74,35,59,1,0,14,75,3,14,7,14,17,21,58,85,1,128,7,0,2,6,2,54560,22104,4295,29182,0
355,7114,245,125,200,5,7,34,250,7,30,17,34,37,51,166,265,3,1053,58,0,2,6,2,54570,22105,4295,29183,0
12,459,75,38,59,1,3,12,76,2,4,2,4,6,6,10,15,1,15,0,0,2,9,0,54570,22105,4295,29185,0
70,1621,996,429,845,24,10,117,1020,7,76,50,88,83,138,494,879,4,3565,198,0,2,43,0,54570,22107,4295,29186,0
70,1621,456,277,329,12,42,72,468,13,85,50,97,98,147,592,972,7,7212,400,0,2,43,0,54570,22107,4295,29187,0
34,2709,996,429,845,24,10,117,1020,7,76,50,88,83,138,494,879,4,3565,198,0,2,113,4,54570,22109,4295,29188,0
79,2068,773,422,505,30,103,129,803,14,77,46,83,91,129,535,839,7,6334,351,0,2,1,0,54580,22110,4296,29189,0
117,2804,77,34,69,0,0,8,77,3,24,16,29,27,45,114,213,1,387,21,0,2,1,1,54580,22110,4296,29190,0
117,2804,712,438,573,51,9,84,763,14,102,71,128,116,199,733,1364,8,11988,666,0,2,1,1,54590,22111,4296,29191,0
79,2068,773,422,505,30,103,129,803,14,77,46,83,91,129,535,839,7,6334,351,0,2,1,0,54600,22112,4297,29192,0
117,2804,77,34,69,0,0,8,77,3,24,16,29,27,45,114,213,1,387,21,0,2,1,1,54600,22112,4297,29193,0
117,2804,712,438,573,51,9,84,763,14,102,71,128,116,199,733,1364,8,11988,666,0,2,1,1,54610,22113,4297,29194,0
75,1466,757,253,292,73,244,162,830,13,61,38,67,74,105,409,651,7,4654,258,0,2,9,6,54610,22114,4297,29195,0
15,466,42,7,35,4,0,5,46,1,2,1,2,3,3,2,4,0,2,0,0,2,0,1,54610,22114,4297,29196,0
15,466,11,6,10,0,0,1,11,2,4,2,4,6,6,10,15,1,15,0,0,2,0,1,54610,22114,4297,29197,0
85,2183,773,422,505,30,103,129,803,14,77,46,83,91,129,535,839,7,6334,351,0,2,1,0,54620,22115,4298,29198,0
123,2925,77,34,69,0,0,8,77,3,24,16,29,27,45,114,213,1,387,21,0,2,1,1,54620,22115,4298,29199,0
123,2925,712,438,573,51,9,84,763,14,102,71,128,116,199,733,1364,8,11988,666,0,2,1,1,54630,22116,4298,29200,0
72,1450,757,253,292,73,244,162,830,13,61,38,67,74,105,409,651,7,4654,258,0,2,6,9,54630,22117,4298,29201,0
15,470,42,7,35,4,0,5,46,1,2,1,2,3,3,2,4,0,2,0,0,2,1,0,54630,22117,4298,29202,0
15,470,11,6,10,0,0,1,11,2,4,2,4,6,6,10,15,1,15,0,0,2,1,0,54630,22117,4298,29203,0
75,1466,757,253,292,73,244,162,830,13,61,38,67,74,105,409,651,7,4654,258,0,2,9,6,54630,22118,4298,29204,0
15,466,42,7,35,4,0,5,46,1,2,1,2,3,3,2,4,0,2,0,0,2,0,1,54630,22118,4298,29205,0
15,466,11,6,10,0,0,1,11,2,4,2,4,6,6,10,15,1,15,0,0,2,0,1,54630,22118,4298,29206,0
85,2183,773,422,505,30,103,129,803,14,77,46,83,91,129,535,839,7,6334,351,0,2,1,0,54640,22119,4299,29207,0
123,2925,77,34,69,0,0,8,77,3,24,16,29,27,45,114,213,1,387,21,0,2,1,1,54640,22119,4299,29208,0
123,2925,712,438,573,51,9,84,763,14,102,71,128,116,199,733,1364,8,11988,666,0,2,1,1,54650,22120,4299,29209,0
72,1450,757,253,292,73,244,162,830,13,61,38,67,74,105,409,651,7,4654,258,0,2,6,9,54650,22121,4299,29210,0
15,470,42,7,35,4,0,5,46,1,2,1,2,3,3,2,4,0,2,0,0,2,1,0,54650,22121,4299,29211,0
15,470,11,6,10,0,0,1,11,2,4,2,4,6,6,10,15,1,15,0,0,2,1,0,54650,22121,4299,29212,0
353,7096,1457,730,1242,11,6,188,1468,10,292,166,329,302,495,2424,4078,5,22973,1276,1,2,3,4,54650,22123,4299,29213,0
353,7096,74,35,59,1,0,14,75,3,14,7,14,17,21,58,85,1,128,7,0,2,3,4,54650,22124,4299,29214,0
353,7096,245,125,200,5,7,34,250,7,30,17,34,37,51,166,265,3,1053,58,0,2,3,4,54660,22125,4299,29215,0
355,7107,1457,730,1242,11,6,188,1468,10,292,166,329,302,495,2424,4078,5,22973,1276,1,2,25,19,54660,22127,4299,29216,0
355,7107,74,35,59,1,0,14,75,3,14,7,14,17,21,58,85,1,128,7,0,2,25,19,54660,22128,4299,29217,0
355,7107,245,125,200,5,7,34,250,7,30,17,34,37,51,166,265,3,1053,58,0,2,25,19,54670,22129,4299,29218,0
355,7107,1457,730,1242,11,6,188,1468,10,292,166,329,302,495,2424,4078,5,22973,1276,1,2,28,23,54670,22131,4299,29219,0
355,7107,74,35,59,1,0,14,75,3,14,7,14,17,21,58,85,1,128,7,0,2,28,23,54670,22132,4299,29220,0
355,7107,245,125,200,5,7,34,250,7,30,17,34,37,51,166,265,3,1053,58,0,2,28,23,54680,22133,4299,29221,0
1,301,382,65,130,157,2,92,539,4,10,5,10,14,15,41,57,2,114,6,0,2,6,5,54680,22134,4300,29222,0
141,2980,1513,682,1277,25,13,200,1538,11,199,116,219,210,335,1557,2584,6,15641,868,0,2,14,4,54680,22136,4300,29223,1
141,2980,819,519,539,24,98,155,843,15,96,57,106,111,163,690,1107,8,9171,509,0,2,14,4,54690,22138,4300,29224,1
234,5348,4293,999,3693,19,54,507,4312,9,155,88,170,164,258,1156,1898,4,9368,520,0,2,1,1,54690,22140,4300,29225,1
234,5348,1482,859,1002,125,135,219,1607,16,219,134,251,235,385,1766,3032,9,27804,1544,1,2,1,1,54700,22141,4300,29226,1
67,1795,1455,414,1257,16,76,112,1471,5,41,23,46,46,69,231,381,2,1069,59,0,2,1,1,54700,22142,4300,29227,0
67,1795,669,365,481,22,61,110,691,15,103,63,122,118,185,747,1273,8,11311,628,0,2,1,1,54710,22142,4301,29228,0
234,5348,4293,999,3693,19,54,507,4312,9,155,88,170,164,258,1156,1898,4,9368,520,0,2,9,1,54710,22144,4301,29229,1
234,5348,1482,859,1002,125,135,219,1607,16,219,134,251,235,385,1766,3032,9,27804,1544,1,2,9,1,54720,22145,4301,29230,1
87,2475,1523,757,1297,19,12,193,1542,12,193,117,230,205,347,1508,2664,7,19053,1058,0,2,5,0,54730,22147,4301,29231,1
87,2475,701,378,504,33,58,109,734,13,110,68,126,123,194,794,1346,7,10027,557,0,2,5,0,54730,22148,4302,29232,1
75,1466,757,253,292,73,244,162,830,13,61,38,67,74,105,409,651,7,4654,258,0,2,3,2,54730,22149,4302,29233,0
46,954,386,256,301,16,9,68,402,4,59,35,69,63,104,355,621,2,1453,80,0,2,5,8,54730,22149,4302,29234,0
46,954,264,131,164,11,41,46,275,6,38,22,40,44,62,214,338,3,1068,59,0,2,5,8,54740,22149,4303,29235,0
16,480,442,244,305,14,16,103,456,11,68,45,75,79,120,452,756,6,4588,254,0,2,2,0,54740,22151,4303,29236,0
16,480,182,102,99,11,40,35,193,3,11,6,11,14,17,42,64,1,97,5,0,2,2,0,54740,22152,4303,29237,0
108,2219,1020,354,843,12,15,144,1032,8,134,77,144,142,221,970,1580,4,6792,377,0,2,15,0,54740,22152,4303,29238,0
259,6118,72,33,56,0,4,12,72,1,1,1,1,2,2,0,2,0,1,0,0,2,1,1,54740,22152,4303,29239,0
259,6118,1454,835,1044,76,110,219,1530,17,275,158,296,292,454,2297,3718,9,34017,1889,1,2,1,1,54750,22153,4303,29240,0
141,2980,1513,682,1277,25,13,200,1538,11,199,116,219,210,335,1557,2584,6,15641,868,0,2,2,3,54750,22155,4303,29241,1
141,2980,819,519,539,24,98,155,843,15,96,57,106,111,163,690,1107,8,9171,509,0,2,2,3,54760,22157,4303,29242,1
349,7017,1457,730,1242,11,6,188,1468,10,292,166,329,302,495,2424,4078,5,22973,1276,1,2,1,1,54760,22159,4303,29243,0
349,7017,74,35,59,1,0,14,75,3,14,7,14,17,21,58,85,1,128,7,0,2,1,1,54760,22160,4303,29244,0
349,7017,245,125,200,5,7,34,250,7,30,17,34,37,51,166,265,3,1053,58,0,2,1,1,54770,22161,4303,29245,0
211,4427,1943,715,1694,26,18,214,1969,12,185,120,237,197,357,1436,2721,7,20915,1161,0,2,2,2,54770,22163,4303,29246,0
211,4427,1168,838,957,57,25,144,1225,19,348,224,416,367,640,3018,5452,11,61921,3440,1,2,2,2,54780,22165,4303,29247,0
79,1689,53,23,39,0,0,13,53,2,8,4,8,10,12,26,39,1,39,2,0,2,0,1,54780,22165,4303,29248,0
79,1689,515,298,307,33,80,99,548,12,63,44,77,75,121,419,753,7,5527,307,0,2,0,1,54790,22165,4303,29249,0
74,1565,402,202,227,24,74,80,426,12,52,33,61,64,94,339,564,7,3969,220,0,2,37,1,54790,22166,4303,29250,1
68,1508,53,23,39,0,0,13,53,2,8,4,8,10,12,26,39,1,39,2,0,2,1,38,54790,22166,4303,29251,1
68,1508,515,298,307,33,80,99,548,12,63,44,77,75,121,419,753,7,5527,307,0,2,1,38,54800,22166,4303,29252,1
122,2921,77,34,69,0,0,8,77,3,24,16,29,27,45,114,213,1,387,21,0,2,1,4,54800,22166,4303,29253,1
122,2921,712,438,573,51,9,84,763,14,102,71,128,116,199,733,1364,8,11988,666,0,2,1,4,54810,22167,4303,29254,1
69,1540,53,23,39,0,0,13,53,2,8,4,8,10,12,26,39,1,39,2,0,2,29,25,54810,22167,4303,29255,1
69,1540,515,298,307,33,80,99,548,12,63,44,77,75,121,419,753,7,5527,307,0,2,29,25,54820,22167,4303,29256,1
16,1213,215,129,180,6,0,29,221,8,65,43,72,73,115,415,711,4,3153,175,0,2,1,1,54820,22167,4303,29257,1
98,2008,773,419,590,28,0,166,801,10,204,113,217,214,330,1598,2554,5,13587,754,0,2,5,11,54820,22167,4304,29258,0
98,2008,421,273,302,44,34,57,465,17,81,59,107,98,166,583,1098,11,12329,684,0,2,5,11,54820,22167,4305,29259,0
213,4606,182,127,129,0,0,53,182,5,39,21,42,44,63,217,343,2,926,51,0,2,9,7,54820,22167,4306,29260,0
213,4606,1165,710,800,67,119,181,1232,18,243,153,282,261,435,2000,3492,10,36473,2026,1,2,9,7,54830,22167,4307,29261,0
74,1569,402,202,227,24,74,80,426,12,52,33,61,64,94,339,564,7,3969,220,0,2,14,13,54830,22168,4307,29262,0
86,1823,773,419,590,28,0,166,801,10,204,113,217,214,330,1598,2554,5,13587,754,0,2,2,40,54830,22168,4308,29263,0
86,1823,421,273,302,44,34,57,465,17,81,59,107,98,166,583,1098,11,12329,684,0,2,2,40,54830,22168,4309,29264,0
85,1818,773,419,590,28,0,166,801,10,204,113,217,214,330,1598,2554,5,13587,754,0,2,0,2,54830,22168,4310,29265,0
85,1818,421,273,302,44,34,57,465,17,81,59,107,98,166,583,1098,11,12329,684,0,2,0,2,54830,22168,4311,29266,0
84,1807,773,419,590,28,0,166,801,10,204,113,217,214,330,1598,2554,5,13587,754,0,2,5,5,54830,22168,4312,29267,0
84,1807,421,273,302,44,34,57,465,17,81,59,107,98,166,583,1098,11,12329,684,0,2,5,5,54830,22168,4313,29268,0
84,1807,773,419,590,28,0,166,801,10,204,113,217,214,330,1598,2554,5,13587,754,0,2,1,2,54830,22168,4314,29269,0
84,1807,421,273,302,44,34,57,465,17,81,59,107,98,166,583,1098,11,12329,684,0,2,1,2,54830,22168,4315,29270,0
84,1807,773,419,590,28,0,166,801,10,204,113,217,214,330,1598,2554,5,13587,754,0,2,1,0,54830,22168,4316,29271,0
84,1807,421,273,302,44,34,57,465,17,81,59,107,98,166,583,1098,11,12329,684,0,2,1,0,54830,22168,4317,29272,0
357,7141,1457,730,1242,11,6,188,1468,10,292,166,329,302,495,2424,4078,5,22973,1276,1,2,6,0,54830,22170,4317,29273,0
357,7141,74,35,59,1,0,14,75,3,14,7,14,17,21,58,85,1,128,7,0,2,6,0,54830,22171,4317,29274,0
357,7141,245,125,200,5,7,34,250,7,30,17,34,37,51,166,265,3,1053,58,0,2,6,0,54840,22172,4317,29275,0
15,742,75,38,59,1,3,12,76,2,4,2,4,6,6,10,15,1,15,0,0,2,67,0,54840,22172,4317,29277,0
71,1698,996,429,845,24,10,117,1020,7,76,50,88,83,138,494,879,4,3565,198,0,2,29,18,54840,22174,4317,29278,1
71,1698,456,277,329,12,42,72,468,13,85,50,97,98,147,592,972,7,7212,400,0,2,29,18,54840,22174,4317,29279,1
36,2884,996,429,845,24,10,117,1020,7,76,50,88,83,138,494,879,4,3565,198,0,2,30,0,54840,22176,4317,29280,1
46,963,447,308,343,6,5,95,453,7,96,59,111,103,170,651,1136,4,4600,255,0,2,1,1,54840,22179,4317,29281,0
46,963,322,174,179,16,74,51,338,10,41,26,46,51,72,252,408,5,2291,127,0,2,1,1,54840,22182,4318,29282,0
46,963,447,308,343,6,5,95,453,7,96,59,111,103,170,651,1136,4,4600,255,0,2,1,1,54840,22185,4318,29283,0
46,963,322,174,179,16,74,51,338,10,41,26,46,51,72,252,408,5,2291,127,0,2,1,1,54840,22188,4319,29284,0
122,2921,77,34,69,0,0,8,77,3,24,16,29,27,45,114,213,1,387,21,0,2,1,4,54840,22188,4319,29285,0
122,2921,712,438,573,51,9,84,763,14,102,71,128,116,199,733,1364,8,11988,666,0,2,1,4,54850,22189,4319,29286,0
74,1569,402,202,227,24,74,80,426,12,52,33,61,64,94,339,564,7,3969,220,0,2,45,8,54850,22190,4319,29287,0
69,1540,53,23,39,0,0,13,53,2,8,4,8,10,12,26,39,1,39,2,0,2,29,63,54850,22190,4319,29288,0
69,1540,515,298,307,33,80,99,548,12,63,44,77,75,121,419,753,7,5527,307,0,2,29,63,54860,22190,4319,29289,0
211,4427,1943,715,1694,26,18,214,1969,12,185,120,237,197,357,1436,2721,7,20915,1161,0,2,2,2,54860,22192,4319,29290,0
211,4427,1168,838,957,57,25,144,1225,19,348,224,416,367,640,3018,5452,11,61921,3440,1,2,2,2,54870,22194,4319,29291,0
16,1213,215,129,180,6,0,29,221,8,65,43,72,73,115,415,711,4,3153,175,0,2,1,1,54870,22194,4319,29292,0
13,572,139,89,101,2,0,35,141,7,54,34,62,61,96,330,569,4,2287,127,0,2,2,0,54870,22194,4319,29293,0
80,2091,773,422,505,30,103,129,803,14,77,46,83,91,129,535,839,7,6334,351,0,2,11,2,54880,22195,4320,29294,0
213,4606,182,127,129,0,0,53,182,5,39,21,42,44,63,217,343,2,926,51,0,2,9,7,54880,22195,4321,29295,0
213,4606,1165,710,800,67,119,181,1232,18,243,153,282,261,435,2000,3492,10,36473,2026,1,2,9,7,54890,22195,4322,29296,0
84,1807,773,419,590,28,0,166,801,10,204,113,217,214,330,1598,2554,5,13587,754,0,2,13,59,54890,22195,4323,29297,0
84,1807,421,273,302,44,34,57,465,17,81,59,107,98,166,583,1098,11,12329,684,0,2,13,59,54890,22195,4324,29298,0
213,4560,1943,715,1694,26,18,214,1969,12,185,120,237,197,357,1436,2721,7,20915,1161,0,2,37,5,54890,22197,4324,29299,0
213,4560,1168,838,957,57,25,144,1225,19,348,224,416,367,640,3018,5452,11,61921,3440,1,2,37,5,54900,22199,4324,29300,0
80,2091,773,422,505,30,103,129,803,14,77,46,83,91,129,535,839,7,6334,351,0,2,11,2,54910,22200,4325,29301,0
13,572,139,89,101,2,0,35,141,7,54,34,62,61,96,330,569,4,2287,127,0,2,2,0,54910,22200,4325,29302,0
352,7059,1457,730,1242,11,6,188,1468,10,292,166,329,302,495,2424,4078,5,22973,1276,1,2,6,18,54910,22202,4325,29303,0
352,7059,74,35,59,1,0,14,75,3,14,7,14,17,21,58,85,1,128,7,0,2,6,18,54910,22203,4325,29304,0
352,7059,245,125,200,5,7,34,250,7,30,17,34,37,51,166,265,3,1053,58,0,2,6,18,54920,22204,4325,29305,0
213,4560,1943,715,1694,26,18,214,1969,12,185,120,237,197,357,1436,2721,7,20915,1161,0,2,37,5,54920,22206,4325,29306,0
213,4560,1168,838,957,57,25,144,1225,19,348,224,416,367,640,3018,5452,11,61921,3440,1,2,37,5,54930,22208,4325,29307,0
144,3005,1513,682,1277,25,13,200,1538,11,199,116,219,210,335,1557,2584,6,15641,868,0,2,13,2,54930,22210,4325,29308,1
144,3005,819,519,539,24,98,155,843,15,96,57,106,111,163,690,1107,8,9171,509,0,2,13,2,54940,22212,4325,29309,1
129,5195,1513,682,1277,25,13,200,1538,11,199,116,219,210,335,1557,2584,6,15641,868,0,2,24,0,54940,22214,4325,29310,1
352,7059,1457,730,1242,11,6,188,1468,10,292,166,329,302,495,2424,4078,5,22973,1276,1,2,6,18,54940,22216,4325,29311,0
352,7059,74,35,59,1,0,14,75,3,14,7,14,17,21,58,85,1,128,7,0,2,6,18,54940,22217,4325,29312,0
352,7059,245,125,200,5,7,34,250,7,30,17,34,37,51,166,265,3,1053,58,0,2,6,18,54950,22218,4325,29313,0
144,3005,1513,682,1277,25,13,200,1538,11,199,116,219,210,335,1557,2584,6,15641,868,0,2,13,2,54950,22220,4325,29314,0
144,3005,819,519,539,24,98,155,843,15,96,57,106,111,163,690,1107,8,9171,509,0,2,13,2,54960,22222,4325,29315,0
129,5195,1513,682,1277,25,13,200,1538,11,199,116,219,210,335,1557,2584,6,15641,868,0,2,24,0,54960,22224,4325,29316,0
76,1523,757,253,292,73,244,162,830,13,61,38,67,74,105,409,651,7,4654,258,0,2,21,4,54960,22225,4325,29317,1
53,3494,520,294,400,33,13,81,553,10,261,204,367,271,571,2128,4614,7,32445,1802,1,2,11,0,54960,22226,4325,29318,1
80,1573,757,253,292,73,244,162,830,13,61,38,67,74,105,409,651,7,4654,258,0,2,10,5,54960,22227,4325,29319,1
54,3601,520,294,400,33,13,81,553,10,261,204,367,271,571,2128,4614,7,32445,1802,1,2,11,0,54960,22228,4325,29320,1
80,1590,757,253,292,73,244,162,830,13,61,38,67,74,105,409,651,7,4654,258,0,2,5,11,54960,22229,4325,29321,0
144,3008,1513,682,1277,25,13,200,1538,11,199,116,219,210,335,1557,2584,6,15641,868,0,2,13,4,54960,22231,4325,29322,0
144,3008,819,519,539,24,98,155,843,15,96,57,106,111,163,690,1107,8,9171,509,0,2,13,4,54970,22233,4325,29323,0
349,7017,1457,730,1242,11,6,188,1468,10,292,166,329,302,495,2424,4078,5,22973,1276,1,2,1,1,54970,22235,4325,29324,0
349,7017,74,35,59,1,0,14,75,3,14,7,14,17,21,58,85,1,128,7,0,2,1,1,54970,22236,4325,29325,0
349,7017,245,125,200,5,7,34,250,7,30,17,34,37,51,166,265,3,1053,58,0,2,1,1,54980,22237,4325,29326,0
67,1795,1455,414,1257,16,76,112,1471,5,41,23,46,46,69,231,381,2,1069,59,0,2,1,1,54980,22238,4325,29327,0
67,1795,669,365,481,22,61,110,691,15,103,63,122,118,185,747,1273,8,11311,628,0,2,1,1,54990,22238,4326,29328,0
234,5348,4293,999,3693,19,54,507,4312,9,155,88,170,164,258,1156,1898,4,9368,520,0,2,10,2,54990,22240,4326,29329,0
234,5348,1482,859,1002,125,135,219,1607,16,219,134,251,235,385,1766,3032,9,27804,1544,1,2,10,2,55000,22241,4326,29330,0
87,2475,1523,757,1297,19,12,193,1542,12,193,117,230,205,347,1508,2664,7,19053,1058,0,2,5,0,55010,22243,4326,29331,0
87,2475,701,378,504,33,58,109,734,13,110,68,126,123,194,794,1346,7,10027,557,0,2,5,0,55010,22244,4327,29332,0
108,2219,1020,354,843,12,15,144,1032,8,134,77,144,142,221,970,1580,4,6792,377,0,2,15,0,55010,22244,4327,29333,0
259,6118,72,33,56,0,4,12,72,1,1,1,1,2,2,0,2,0,1,0,0,2,1,1,55010,22244,4327,29334,0
259,6118,1454,835,1044,76,110,219,1530,17,275,158,296,292,454,2297,3718,9,34017,1889,1,2,1,1,55020,22245,4327,29335,0
75,1466,757,253,292,73,244,162,830,13,61,38,67,74,105,409,651,7,4654,258,0,2,3,2,55020,22246,4327,29336,0
46,954,386,256,301,16,9,68,402,4,59,35,69,63,104,355,621,2,1453,80,0,2,5,8,55020,22246,4327,29337,0
46,954,264,131,164,11,41,46,275,6,38,22,40,44,62,214,338,3,1068,59,0,2,5,8,55030,22246,4328,29338,0
16,480,442,244,305,14,16,103,456,11,68,45,75,79,120,452,756,6,4588,254,0,2,2,0,55030,22248,4328,29339,0
16,480,182,102,99,11,40,35,193,3,11,6,11,14,17,42,64,1,97,5,0,2,2,0,55030,22249,4328,29340,0
1,301,382,65,130,157,2,92,539,4,10,5,10,14,15,41,57,2,114,6,0,2,6,5,55030,22250,4329,29341,0
80,1599,757,253,292,73,244,162,830,13,61,38,67,74,105,409,651,7,4654,258,0,2,8,4,55030,22251,4329,29342,0
129,5207,1513,682,1277,25,13,200,1538,11,199,116,219,210,335,1557,2584,6,15641,868,0,2,4,2,55030,22253,4329,29343,0
145,3016,1513,682,1277,25,13,200,1538,11,199,116,219,210,335,1557,2584,6,15641,868,0,2,4,1,55030,22255,4329,29344,0
145,3016,819,519,539,24,98,155,843,15,96,57,106,111,163,690,1107,8,9171,509,0,2,4,1,55040,22257,4329,29345,0
145,3018,1513,682,1277,25,13,200,1538,11,199,116,219,210,335,1557,2584,6,15641,868,0,2,1,1,55040,22259,4329,29346,0
145,3018,819,519,539,24,98,155,843,15,96,57,106,111,163,690,1107,8,9171,509,0,2,1,1,55050,22261,4329,29347,0
80,2091,773,422,505,30,103,129,803,14,77,46,83,91,129,535,839,7,6334,351,0,2,1,2,55060,22262,4330,29348,0
80,2091,773,422,505,30,103,129,803,14,77,46,83,91,129,535,839,7,6334,351,0,2,1,2,55070,22263,4331,29349,0
77,1551,757,253,292,73,244,162,830,13,61,38,67,74,105,409,651,7,4654,258,0,2,8,12,55070,22264,4331,29350,1
145,3018,1513,682,1277,25,13,200,1538,11,199,116,219,210,335,1557,2584,6,15641,868,0,2,5,2,55070,22266,4331,29351,0
145,3018,819,519,539,24,98,155,843,15,96,57,106,111,163,690,1107,8,9171,509,0,2,5,2,55080,22268,4331,29352,0
129,5207,1513,682,1277,25,13,200,1538,11,199,116,219,210,335,1557,2584,6,15641,868,0,2,4,2,55080,22270,4331,29353,0
145,3018,1513,682,1277,25,13,200,1538,11,199,116,219,210,335,1557,2584,6,15641,868,0,2,31,8,55080,22272,4331,29354,0
145,3018,819,519,539,24,98,155,843,15,96,57,106,111,163,690,1107,8,9171,509,0,2,31,8,55090,22274,4331,29355,0
352,7059,1457,730,1242,11,6,188,1468,10,292,166,329,302,495,2424,4078,5,22973,1276,1,2,1,1,55090,22276,4331,29356,0
352,7059,74,35,59,1,0,14,75,3,14,7,14,17,21,58,85,1,128,7,0,2,1,1,55090,22277,4331,29357,0
352,7059,245,125,200,5,7,34,250,7,30,17,34,37,51,166,265,3,1053,58,0,2,1,1,55100,22278,4331,29358,0
83,2145,1455,414,1257,16,76,112,1471,5,41,23,46,46,69,231,381,2,1069,59,0,2,1,1,55100,22279,4331,29359,0
83,2145,669,365,481,22,61,110,691,15,103,63,122,118,185,747,1273,8,11311,628,0,2,1,1,55110,22279,4332,29360,0
234,5348,4293,999,3693,19,54,507,4312,9,155,88,170,164,258,1156,1898,4,9368,520,0,2,10,2,55110,22281,4332,29361,0
234,5348,1482,859,1002,125,135,219,1607,16,219,134,251,235,385,1766,3032,9,27804,1544,1,2,10,2,55120,22282,4332,29362,0
98,2670,1523,757,1297,19,12,193,1542,12,193,117,230,205,347,1508,2664,7,19053,1058,0,2,7,1,55130,22284,4332,29363,0
98,2670,701,378,504,33,58,109,734,13,110,68,126,123,194,794,1346,7,10027,557,0,2,7,1,55130,22285,4333,29364,0
86,2206,773,422,505,30,103,129,803,14,77,46,83,91,129,535,839,7,6334,351,0,2,10,2,55140,22286,4334,29365,0
24,600,2,2,2,0,0,0,2,0,0,0,0,0,0,0,0,0,0,0,0,2,15,0,55140,22286,4334,29365,0
24,600,99,48,90,1,3,5,100,0,0,0,0,0,0,0,0,0,0,0,0,2,15,0,55140,22287,4334,29366,0
24,600,8,5,5,2,0,1,10,0,0,0,0,0,0,0,0,0,0,0,0,2,15,0,55140,22287,4334,29367,0
24,600,1217,716,841,84,126,174,1301,14,185,118,215,199,333,1446,2542,8,20687,1149,0,2,15,0,55150,22289,4334,29368,0
24,600,160,89,115,0,13,31,160,7,15,11,17,22,28,78,124,3,495,27,0,2,15,0,55150,22289,4334,29369,0
24,600,10,10,9,9,0,0,19,0,0,0,0,0,0,0,0,0,0,0,0,2,15,0,55150,22289,4335,29370,0
24,600,173,84,99,8,29,36,181,5,12,7,13,17,20,54,81,2,221,12,0,2,15,0,55150,22290,4335,29371,0
24,600,3,1,1,3,0,0,6,0,0,0,0,0,0,0,0,0,0,0,0,2,15,0,55150,22290,4335,29372,0
46,963,447,308,343,6,5,95,453,7,96,59,111,103,170,651,1136,4,4600,255,0,2,1,1,55150,22293,4335,29373,0
46,963,322,174,179,16,74,51,338,10,41,26,46,51,72,252,408,5,2291,127,0,2,1,1,55150,22296,4336,29374,0
259,6120,72,33,56,0,4,12,72,1,1,1,1,2,2,0,2,0,1,0,0,2,1,1,55150,22296,4336,29375,0
259,6120,1454,835,1044,76,110,219,1530,17,275,158,296,292,454,2297,3718,9,34017,1889,1,2,1,1,55160,22297,4336,29376,0
72,1450,757,253,292,73,244,162,830,13,61,38,67,74,105,409,651,7,4654,258,0,2,3,2,55160,22298,4336,29377,0
46,954,386,256,301,16,9,68,402,4,59,35,69,63,104,355,621,2,1453,80,0,2,5,8,55160,22298,4336,29378,0
46,954,264,131,164,11,41,46,275,6,38,22,40,44,62,214,338,3,1068,59,0,2,5,8,55170,22298,4337,29379,0
16,480,442,244,305,14,16,103,456,11,68,45,75,79,120,452,756,6,4588,254,0,2,2,0,55170,22300,4337,29380,0
16,480,182,102,99,11,40,35,193,3,11,6,11,14,17,42,64,1,97,5,0,2,2,0,55170,22301,4337,29381,0
1,301,382,65,130,157,2,92,539,4,10,5,10,14,15,41,57,2,114,6,0,2,6,5,55170,22302,4338,29382,0
13,572,139,89,101,2,0,35,141,7,54,34,62,61,96,330,569,4,2287,127,0,2,2,0,55170,22302,4338,29383,0
129,5207,1513,682,1277,25,13,200,1538,11,199,116,219,210,335,1557,2584,6,15641,868,0,2,28,2,55170,22304,4338,29384,0
77,1551,757,253,292,73,244,162,830,13,61,38,67,74,105,409,651,7,4654,258,0,2,34,18,55170,22305,4338,29385,0
54,3601,520,294,400,33,13,81,553,10,261,204,367,271,571,2128,4614,7,32445,1802,1,2,22,0,55170,22306,4338,29386,0
145,3018,1513,682,1277,25,13,200,1538,11,199,116,219,210,335,1557,2584,6,15641,868,0,2,31,8,55170,22308,4338,29387,0
145,3018,819,519,539,24,98,155,843,15,96,57,106,111,163,690,1107,8,9171,509,0,2,31,8,55180,22310,4338,29388,0
352,7059,1457,730,1242,11,6,188,1468,10,292,166,329,302,495,2424,4078,5,22973,1276,1,2,1,1,55180,22312,4338,29389,0
352,7059,74,35,59,1,0,14,75,3,14,7,14,17,21,58,85,1,128,7,0,2,1,1,55180,22313,4338,29390,0
352,7059,245,125,200,5,7,34,250,7,30,17,34,37,51,166,265,3,1053,58,0,2,1,1,55190,22314,4338,29391,0
83,2145,1455,414,1257,16,76,112,1471,5,41,23,46,46,69,231,381,2,1069,59,0,2,1,1,55190,22315,4338,29392,0
83,2145,669,365,481,22,61,110,691,15,103,63,122,118,185,747,1273,8,11311,628,0,2,1,1,55200,22315,4339,29393,0
234,5348,4293,999,3693,19,54,507,4312,9,155,88,170,164,258,1156,1898,4,9368,520,0,2,10,2,55200,22317,4339,29394,0
234,5348,1482,859,1002,125,135,219,1607,16,219,134,251,235,385,1766,3032,9,27804,1544,1,2,10,2,55210,22318,4339,29395,0
98,2670,1523,757,1297,19,12,193,1542,12,193,117,230,205,347,1508,2664,7,19053,1058,0,2,7,1,55220,22320,4339,29396,0
98,2670,701,378,504,33,58,109,734,13,110,68,126,123,194,794,1346,7,10027,557,0,2,7,1,55220,22321,4340,29397,0
86,2206,773,422,505,30,103,129,803,14,77,46,83,91,129,535,839,7,6334,351,0,2,10,2,55230,22322,4341,29398,0
24,600,2,2,2,0,0,0,2,0,0,0,0,0,0,0,0,0,0,0,0,2,15,0,55230,22322,4341,29398,0
24,600,99,48,90,1,3,5,100,0,0,0,0,0,0,0,0,0,0,0,0,2,15,0,55230,22323,4341,29399,0
24,600,8,5,5,2,0,1,10,0,0,0,0,0,0,0,0,0,0,0,0,2,15,0,55230,22323,4341,29400,0
24,600,1217,716,841,84,126,174,1301,14,185,118,215,199,333,1446,2542,8,20687,1149,0,2,15,0,55240,22325,4341,29401,0
24,600,160,89,115,0,13,31,160,7,15,11,17,22,28,78,124,3,495,27,0,2,15,0,55240,22325,4341,29402,0
24,600,10,10,9,9,0,0,19,0,0,0,0,0,0,0,0,0,0,0,0,2,15,0,55240,22325,4342,29403,0
24,600,173,84,99,8,29,36,181,5,12,7,13,17,20,54,81,2,221,12,0,2,15,0,55240,22326,4342,29404,0
24,600,3,1,1,3,0,0,6,0,0,0,0,0,0,0,0,0,0,0,0,2,15,0,55240,22326,4342,29405,0
46,963,447,308,343,6,5,95,453,7,96,59,111,103,170,651,1136,4,4600,255,0,2,1,1,55240,22329,4342,29406,0
46,963,322,174,179,16,74,51,338,10,41,26,46,51,72,252,408,5,2291,127,0,2,1,1,55240,22332,4343,29407,0
259,6120,72,33,56,0,4,12,72,1,1,1,1,2,2,0,2,0,1,0,0,2,1,1,55240,22332,4343,29408,0
259,6120,1454,835,1044,76,110,219,1530,17,275,158,296,292,454,2297,3718,9,34017,1889,1,2,1,1,55250,22333,4343,29409,0
77,1551,757,253,292,73,244,162,830,13,61,38,67,74,105,409,651,7,4654,258,0,2,3,2,55250,22334,4343,29410,0
46,954,386,256,301,16,9,68,402,4,59,35,69,63,104,355,621,2,1453,80,0,2,5,8,55250,22334,4343,29411,0
46,954,264,131,164,11,41,46,275,6,38,22,40,44,62,214,338,3,1068,59,0,2,5,8,55260,22334,4344,29412,0
16,480,442,244,305,14,16,103,456,11,68,45,75,79,120,452,756,6,4588,254,0,2,2,0,55260,22336,4344,29413,0
16,480,182,102,99,11,40,35,193,3,11,6,11,14,17,42,64,1,97,5,0,2,2,0,55260,22337,4344,29414,0
1,301,382,65,130,157,2,92,539,4,10,5,10,14,15,41,57,2,114,6,0,2,6,5,55260,22338,4345,29415,0
13,572,139,89,101,2,0,35,141,7,54,34,62,61,96,330,569,4,2287,127,0,2,2,0,55260,22338,4345,29416,0
129,5207,1513,682,1277,25,13,200,1538,11,199,116,219,210,335,1557,2584,6,15641,868,0,2,28,2,55260,22340,4345,29417,0
71,1698,996,429,845,24,10,117,1020,7,76,50,88,83,138,494,879,4,3565,198,0,2,29,18,55300,22358,4349,29446,0
71,1698,456,277,329,12,42,72,468,13,85,50,97,98,147,592,972,7,7212,400,0,2,29,18,55300,22358,4349,29447,0
36,2884,996,429,845,24,10,117,1020,7,76,50,88,83,138,494,879,4,3565,198,0,2,30,0,55300,22360,4349,29448,0
164,7206,139,89,101,2,0,35,141,7,54,34,62,61,96,330,569,4,2287,127,0,2,13,13,55300,22360,4349,29449,1
164,7206,7,5,5,0,0,2,7,1,2,1,2,3,3,2,4,0,2,0,0,2,13,13,55300,22360,4349,29450,1
236,5368,4293,999,3693,19,54,507,4312,9,155,88,170,164,258,1156,1898,4,9368,520,0,2,10,3,55300,22362,4349,29451,1
236,5368,1482,859,1002,125,135,219,1607,16,219,134,251,235,385,1766,3032,9,27804,1544,1,2,10,3,55310,22363,4349,29452,1
91,3852,1289,550,1043,56,32,155,1345,10,167,93,185,177,278,1266,2075,5,11498,638,0,2,24,0,55310,22365,4350,29453,1
170,7554,139,89,101,2,0,35,141,7,54,34,62,61,96,330,569,4,2287,127,0,2,198,13,55310,22365,4350,29454,1
170,7554,7,5,5,0,0,2,7,1,2,1,2,3,3,2,4,0,2,0,0,2,198,13,55310,22365,4350,29455,1
354,7093,1457,730,1242,11,6,188,1468,10,292,166,329,302,495,2424,4078,5,22973,1276,1,2,6,0,55310,22367,4350,29456,0
354,7093,74,35,59,1,0,14,75,3,14,7,14,17,21,58,85,1,128,7,0,2,6,0,55310,22368,4350,29457,0
354,7093,245,125,200,5,7,34,250,7,30,17,34,37,51,166,265,3,1053,58,0,2,6,0,55320,22369,4350,29458,0
15,742,75,38,59,1,3,12,76,2,4,2,4,6,6,10,15,1,15,0,0,2,67,0,55320,22369,4350,29460,0
236,5368,4293,999,3693,19,54,507,4312,9,155,88,170,164,258,1156,1898,4,9368,520,0,2,10,3,55320,22371,4350,29461,0
236,5368,1482,859,1002,125,135,219,1607,16,219,134,251,235,385,1766,3032,9,27804,1544,1,2,10,3,55330,22372,4350,29462,0
91,3852,1289,550,1043,56,32,155,1345,10,167,93,185,177,278,1266,2075,5,11498,638,0,2,24,0,55330,22374,4351,29463,0
170,7554,139,89,101,2,0,35,141,7,54,34,62,61,96,330,569,4,2287,127,0,2,199,14,55330,22374,4351,29464,0
170,7554,7,5,5,0,0,2,7,1,2,1,2,3,3,2,4,0,2,0,0,2,199,14,55330,22374,4351,29465,0
209,4527,1943,715,1694,26,18,214,1969,12,185,120,237,197,357,1436,2721,7,20915,1161,0,2,2,10,55350,22384,4353,29480,0
209,4527,1168,838,957,57,25,144,1225,19,348,224,416,367,640,3018,5452,11,61921,3440,1,2,2,10,55360,22386,4353,29481,0
23,737,339,213,244,17,9,65,356,10,42,26,48,52,74,259,421,5,2410,133,0,2,6,0,55370,22386,4353,29482,0
46,1902,1293,570,1093,25,15,163,1318,10,195,123,241,205,364,1516,2795,6,17273,959,0,2,25,0,55380,22388,4353,29483,0
209,4527,1943,715,1694,26,18,214,1969,12,185,120,237,197,357,1436,2721,7,20915,1161,0,2,2,10,55380,22390,4353,29484,0
209,4527,1168,838,957,57,25,144,1225,19,348,224,416,367,640,3018,5452,11,61921,3440,1,2,2,10,55390,22392,4353,29485,0
213,4606,182,127,129,0,0,53,182,5,39,21,42,44,63,217,343,2,926,51,0,2,9,7,55410,22400,4356,29500,0
213,4606,1165,710,800,67,119,181,1232,18,243,153,282,261,435,2000,3492,10,36473,2026,1,2,9,7,55420,22400,4357,29501,0
84,1807,773,419,590,28,0,166,801,10,204,113,217,214,330,1598,2554,5,13587,754,0,2,13,59,55420,22400,4358,29502,0
84,1807,421,273,302,44,34,57,465,17,81,59,107,98,166,583,1098,11,12329,684,0,2,13,59,55420,22400,4359,29503,0
71,1698,996,429,845,24,10,117,1020,7,76,50,88,83,138,494,879,4,3565,198,0,2,72,18,55420,22402,4359,29504,0
71,1698,456,277,329,12,42,72,468,13,85,50,97,98,147,592,972,7,7212,400,0,2,72,18,55420,22402,4359,29505,0
354,7093,1457,730,1242,11,6,188,1468,10,292,166,329,302,495,2424,4078,5,22973,1276,1,2,54,45,55420,22404,4359,29506,0
354,7093,74,35,59,1,0,14,75,3,14,7,14,17,21,58,85,1,128,7,0,2,54,45,55420,22405,4359,29507,0
354,7093,245,125,200,5,7,34,250,7,30,17,34,37,51,166,265,3,1053,58,0,2,54,45,55430,22406,4359,29508,0
25,753,339,213,244,17,9,65,356,10,42,26,48,52,74,259,421,5,2410,133,0,2,10,9,55440,22406,4359,29509,0
83,2145,1455,414,1257,16,76,112,1471,5,41,23,46,46,69,231,381,2,1069,59,0,2,128,45,55440,22407,4359,29511,0
83,2145,669,365,481,22,61,110,691,15,103,63,122,118,185,747,1273,8,11311,628,0,2,128,45,55450,22407,4360,29512,0
236,5368,4293,999,3693,19,54,507,4312,9,155,88,170,164,258,1156,1898,4,9368,520,0,2,12,5,55450,22409,4360,29513,0
236,5368,1482,859,1002,125,135,219,1607,16,219,134,251,235,385,1766,3032,9,27804,1544,1,2,12,5,55460,22410,4360,29514,0
51,595,647,139,84,35,284,233,682,0,0,0,0,0,0,0,0,0,0,0,0,2,8,1,55460,22410,4360,29515,0
98,2670,1523,757,1297,19,12,193,1542,12,193,117,230,205,347,1508,2664,7,19053,1058,0,2,78,20,55470,22412,4360,29516,0
98,2670,701,378,504,33,58,109,734,13,110,68,126,123,194,794,1346,7,10027,557,0,2,78,20,55470,22413,4361,29517,0
86,2206,773,422,505,30,103,129,803,14,77,46,83,91,129,535,839,7,6334,351,0,2,30,3,55480,22414,4362,29518,0
122,2921,77,34,69,0,0,8,77,3,24,16,29,27,45,114,213,1,387,21,0,2,27,4,55480,22414,4362,29519,0
122,2921,712,438,573,51,9,84,763,14,102,71,128,116,199,733,1364,8,11988,666,0,2,27,4,55490,22415,4362,29520,0
24,600,2,2,2,0,0,0,2,0,0,0,0,0,0,0,0,0,0,0,0,0,156,0,55490,22415,4362,29520,0
24,600,99,48,90,1,3,5,100,0,0,0,0,0,0,0,0,0,0,0,0,0,156,0,55490,22416,4362,29521,0
24,600,8,5,5,2,0,1,10,0,0,0,0,0,0,0,0,0,0,0,0,0,156,0,55490,22416,4362,29522,0
24,600,1217,716,841,84,126,174,1301,14,185,118,215,199,333,1446,2542,8,20687,1149,0,0,156,0,55500,22418,4362,29523,0
24,600,160,89,115,0,13,31,160,7,15,11,17,22,28,78,124,3,495,27,0,0,156,0,55500,22418,4362,29524,0
24,600,10,10,9,9,0,0,19,0,0,0,0,0,0,0,0,0,0,0,0,0,156,0,55500,22418,4363,29525,0
24,600,173,84,99,8,29,36,181,5,12,7,13,17,20,54,81,2,221,12,0,0,156,0,55500,22419,4363,29526,0
24,600,3,1,1,3,0,0,6,0,0,0,0,0,0,0,0,0,0,0,0,0,156,0,55500,22419,4363,29527,0
33,707,125,97,103,3,0,19,128,9,25,17,27,34,44,144,223,4,1087,60,0,0,126,0,55500,22419,4364,29528,0
24,380,102,57,55,5,16,25,107,5,17,10,18,22,28,81,124,2,330,18,0,0,97,0,55500,22419,4364,29529,0
74,1569,402,202,227,24,74,80,426,12,52,33,61,64,94,339,564,7,3969,220,0,3,123,302,55500,22420,4364,29530,0
69,1540,53,23,39,0,0,13,53,2,8,4,8,10,12,26,39,1,39,2,0,2,33,63,55500,22420,4364,29531,0
69,1540,515,298,307,33,80,99,548,12,63,44,77,75,121,419,753,7,5527,307,0,2,33,63,55510,22420,4364,29532,0
259,6120,72,33,56,0,4,12,72,1,1,1,1,2,2,0,2,0,1,0,0,2,1,1,55510,22420,4364,29533,0
259,6120,1454,835,1044,76,110,219,1530,17,275,158,296,292,454,2297,3718,9,34017,1889,1,2,1,1,55520,22421,4364,29534,0
77,1551,757,253,292,73,244,162,830,13,61,38,67,74,105,409,651,7,4654,258,0,2,40,27,55520,22422,4364,29535,0
113,2530,1043,504,840,53,9,147,1096,9,180,112,198,189,310,1377,2344,4,11604,644,0,2,14,2,55520,22424,4364,29536,0
113,2530,383,288,292,26,6,62,409,11,65,38,67,76,105,429,656,5,3719,206,0,2,14,2,55520,22425,4364,29537,0
71,1415,1178,367,1042,6,15,115,1184,9,94,51,95,103,146,644,976,4,4439,246,0,2,33,143,55520,22425,4364,29538,0
71,1415,177,108,140,8,0,27,185,6,30,16,32,36,48,162,248,3,794,44,0,2,33,143,55520,22427,4364,29539,0
209,4527,1943,715,1694,26,18,214,1969,12,185,120,237,197,357,1436,2721,7,20915,1161,0,2,61,25,55520,22429,4364,29540,0
209,4527,1168,838,957,57,25,144,1225,19,348,224,416,367,640,3018,5452,11,61921,3440,1,2,61,25,55530,22431,4364,29541,0
15,470,42,7,35,4,0,5,46,1,2,1,2,3,3,2,4,0,2,0,0,2,3,2,55530,22431,4364,29542,0
15,470,11,6,10,0,0,1,11,2,4,2,4,6,6,10,15,1,15,0,0,2,3,2,55530,22431,4364,29543,0
91,3852,1289,550,1043,56,32,155,1345,10,167,93,185,177,278,1266,2075,5,11498,638,0,2,24,0,55530,22433,4365,29544,0
15,742,75,38,59,1,3,12,76,2,4,2,4,6,6,10,15,1,15,0,0,2,76,0,55530,22433,4365,29545,0
29,1792,1157,318,931,29,22,177,1186,6,104,63,125,110,188,712,1274,3,4596,255,0,2,123,1,55530,22433,4365,29546,0
54,3601,520,294,400,33,13,81,553,10,261,204,367,271,571,2128,4614,7,32445,1802,1,2,22,0,55530,22434,4365,29547,0
170,7554,139,89,101,2,0,35,141,7,54,34,62,61,96,330,569,4,2287,127,0,2,199,14,55530,22434,4365,29548,0
170,7554,7,5,5,0,0,2,7,1,2,1,2,3,3,2,4,0,2,0,0,2,199,14,55530,22434,4365,29549,0
36,2884,996,429,845,24,10,117,1020,7,76,50,88,83,138,494,879,4,3565,198,0,2,144,5,55530,22436,4365,29550,0
69,3184,1455,414,1257,16,76,112,1471,5,41,23,46,46,69,231,381,2,1069,59,0,2,21,0,55530,22437,4365,29551,0
94,4604,1523,757,1297,19,12,193,1542,12,193,117,230,205,347,1508,2664,7,19053,1058,0,2,28,11,55540,22439,4365,29552,0
39,1946,1293,570,1093,25,15,163,1318,10,195,123,241,205,364,1516,2795,6,17273,959,0,2,36,0,55550,22441,4365,29553,0
16,1213,215,129,180,6,0,29,221,8,65,43,72,73,115,415,711,4,3153,175,0,2,1,1,55550,22441,4365,29554,0
30,1233,373,158,315,8,0,51,381,5,76,44,79,81,123,486,779,2,2026,112,0,2,44,0,55550,22441,4365,29555,0
77,3237,1178,367,1042,6,15,115,1184,9,94,51,95,103,146,644,976,4,4439,246,0,2,40,0,55550,22441,4365,29556,0
91,4606,1943,715,1694,26,18,214,1969,12,185,120,237,197,357,1436,2721,7,20915,1161,0,2,88,13,55550,22443,4365,29557,0
48,2177,1293,570,1093,25,15,163,1318,10,195,123,241,205,364,1516,2795,6,17273,959,0,2,75,6,55560,22445,4365,29558,1
25,773,339,213,244,17,9,65,356,10,42,26,48,52,74,259,421,5,2410,133,0,2,8,0,55570,22445,4365,29559,0
26,776,339,213,244,17,9,65,356,10,42,26,48,52,74,259,421,5,2410,133,0,2,2,1,55580,22445,4365,29560,0
55,2398,1293,570,1093,25,15,163,1318,10,195,123,241,205,364,1516,2795,6,17273,959,0,2,53,0,55590,22447,4365,29561,0
54,2391,1293,570,1093,25,15,163,1318,10,195,123,241,205,364,1516,2795,6,17273,959,0,2,8,14,55600,22449,4365,29562,1
54,2391,1293,570,1093,25,15,163,1318,10,195,123,241,205,364,1516,2795,6,17273,959,0,2,1,1,55610,22451,4365,29563,0
85,2188,773,422,505,30,103,129,803,14,77,46,83,91,129,535,839,7,6334,351,0,2,1,1,55620,22452,4366,29564,0
31,1981,1157,318,931,29,22,177,1186,6,104,63,125,110,188,712,1274,3,4596,255,0,2,61,1,55620,22452,4366,29565,0
26,776,339,213,244,17,9,65,356,10,42,26,48,52,74,259,421,5,2410,133,0,2,1,1,55630,22452,4366,29566,0
54,2368,1293,570,1093,25,15,163,1318,10,195,123,241,205,364,1516,2795,6,17273,959,0,2,22,21,55640,22454,4366,29567,0
86,2211,773,422,505,30,103,129,803,14,77,46,83,91,129,535,839,7,6334,351,0,2,1,1,55650,22455,4367,29568,0
31,1981,1157,318,931,29,22,177,1186,6,104,63,125,110,188,712,1274,3,4596,255,0,2,61,1,55650,22455,4367,29569,0
55,2425,1293,570,1093,25,15,163,1318,10,195,123,241,205,364,1516,2795,6,17273,959,0,2,24,0,55660,22457,4367,29570,0
78,1583,757,253,292,73,244,162,830,13,61,38,67,74,105,409,651,7,4654,258,0,2,4,0,55660,22458,4367,29571,0
22,606,256,139,192,9,7,47,265,4,23,12,24,27,36,112,171,2,357,19,0,2,5,0,55660,22459,4367,29572,0
39,1724,386,256,301,16,9,68,402,4,59,35,69,63,104,355,621,2,1453,80,0,2,1,1,55660,22459,4367,29573,0
78,1574,757,253,292,73,244,162,830,13,61,38,67,74,105,409,651,7,4654,258,0,2,1,1,55660,22460,4367,29574,0
78,1574,757,253,292,73,244,162,830,13,61,38,67,74,105,409,651,7,4654,258,0,2,4,0,55660,22461,4367,29575,0
22,606,256,139,192,9,7,47,265,4,23,12,24,27,36,112,171,2,357,19,0,2,5,0,55660,22462,4367,29576,0
39,1724,386,256,301,16,9,68,402,4,59,35,69,63,104,355,621,2,1453,80,0,2,1,1,55660,22462,4367,29577,0
55,2461,1293,570,1093,25,15,163,1318,10,195,123,241,205,364,1516,2795,6,17273,959,0,2,13,4,55670,22464,4367,29578,0
24,600,2,2,2,0,0,0,2,0,0,0,0,0,0,0,0,0,0,0,0,2,2,1,55670,22464,4367,29578,0
24,600,99,48,90,1,3,5,100,0,0,0,0,0,0,0,0,0,0,0,0,2,2,1,55670,22465,4367,29579,0
24,600,8,5,5,2,0,1,10,0,0,0,0,0,0,0,0,0,0,0,0,2,2,1,55670,22465,4367,29580,0
24,600,1217,716,841,84,126,174,1301,14,185,118,215,199,333,1446,2542,8,20687,1149,0,2,2,1,55680,22467,4367,29581,0
24,600,160,89,115,0,13,31,160,7,15,11,17,22,28,78,124,3,495,27,0,2,2,1,55680,22467,4367,29582,0
24,600,10,10,9,9,0,0,19,0,0,0,0,0,0,0,0,0,0,0,0,2,2,1,55680,22467,4368,29583,0
24,600,173,84,99,8,29,36,181,5,12,7,13,17,20,54,81,2,221,12,0,2,2,1,55680,22468,4368,29584,0
24,600,3,1,1,3,0,0,6,0,0,0,0,0,0,0,0,0,0,0,0,2,2,1,55680,22468,4368,29585,0
56,2400,1293,570,1093,25,15,163,1318,10,195,123,241,205,364,1516,2795,6,17273,959,0,2,29,49,55690,22470,4368,29586,0
24,600,2,2,2,0,0,0,2,0,0,0,0,0,0,0,0,0,0,0,0,2,2,1,55690,22470,4368,29586,0
24,600,99,48,90,1,3,5,100,0,0,0,0,0,0,0,0,0,0,0,0,2,2,1,55690,22471,4368,29587,0
24,600,8,5,5,2,0,1,10,0,0,0,0,0,0,0,0,0,0,0,0,2,2,1,55690,22471,4368,29588,0
24,600,1217,716,841,84,126,174,1301,14,185,118,215,199,333,1446,2542,8,20687,1149,0,2,2,1,55700,22473,4368,29589,0
24,600,160,89,115,0,13,31,160,7,15,11,17,22,28,78,124,3,495,27,0,2,2,1,55700,22473,4368,29590,0
24,600,10,10,9,9,0,0,19,0,0,0,0,0,0,0,0,0,0,0,0,2,2,1,55700,22473,4369,29591,0
24,600,173,84,99,8,29,36,181,5,12,7,13,17,20,54,81,2,221,12,0,2,2,1,55700,22474,4369,29592,0
24,600,3,1,1,3,0,0,6,0,0,0,0,0,0,0,0,0,0,0,0,2,2,1,55700,22474,4369,29593,0
80,1688,402,202,227,24,74,80,426,12,52,33,61,64,94,339,564,7,3969,220,0,2,25,0,55700,22475,4369,29594,1
68,1556,53,23,39,0,0,13,53,2,8,4,8,10,12,26,39,1,39,2,0,2,9,6,55700,22475,4369,29595,1
68,1556,515,298,307,33,80,99,548,12,63,44,77,75,121,419,753,7,5527,307,0,2,9,6,55710,22475,4369,29596,1
260,6185,72,33,56,0,4,12,72,1,1,1,1,2,2,0,2,0,1,0,0,2,9,1,55710,22475,4369,29597,1
260,6185,1454,835,1044,76,110,219,1530,17,275,158,296,292,454,2297,3718,9,34017,1889,1,2,9,1,55720,22476,4369,29598,1
235,5354,4293,999,3693,19,54,507,4312,9,155,88,170,164,258,1156,1898,4,9368,520,0,2,1,4,55720,22478,4369,29599,0
235,5354,1482,859,1002,125,135,219,1607,16,219,134,251,235,385,1766,3032,9,27804,1544,1,2,1,4,55730,22479,4369,29600,0
30,655,125,97,103,3,0,19,128,9,25,17,27,34,44,144,223,4,1087,60,0,2,1,10,55730,22479,4370,29601,0
82,3555,1020,354,843,12,15,144,1032,8,134,77,144,142,221,970,1580,4,6792,377,0,2,0,1,55730,22479,4370,29602,0
82,3557,1020,354,843,12,15,144,1032,8,134,77,144,142,221,970,1580,4,6792,377,0,2,2,2,55730,22479,4370,29603,0
30,657,125,97,103,3,0,19,128,9,25,17,27,34,44,144,223,4,1087,60,0,2,2,1,55730,22479,4371,29604,0
237,5377,4293,999,3693,19,54,507,4312,9,155,88,170,164,258,1156,1898,4,9368,520,0,2,5,2,55730,22481,4371,29606,1
237,5377,1482,859,1002,125,135,219,1607,16,219,134,251,235,385,1766,3032,9,27804,1544,1,2,5,2,55740,22482,4371,29607,1
80,1706,402,202,227,24,74,80,426,12,52,33,61,64,94,339,564,7,3969,220,0,2,6,6,55740,22483,4371,29608,1
261,6242,72,33,56,0,4,12,72,1,1,1,1,2,2,0,2,0,1,0,0,2,30,11,55740,22483,4371,29609,1
261,6242,1454,835,1044,76,110,219,1530,17,275,158,296,292,454,2297,3718,9,34017,1889,1,2,30,11,55750,22484,4371,29610,1
70,1373,1178,367,1042,6,15,115,1184,9,94,51,95,103,146,644,976,4,4439,246,0,2,6,10,55750,22484,4371,29611,1
70,1373,177,108,140,8,0,27,185,6,30,16,32,36,48,162,248,3,794,44,0,2,6,10,55750,22486,4371,29612,1
170,7555,139,89,101,2,0,35,141,7,54,34,62,61,96,330,569,4,2287,127,0,2,3,1,55750,22486,4371,29613,1
170,7555,7,5,5,0,0,2,7,1,2,1,2,3,3,2,4,0,2,0,0,2,3,1,55750,22486,4371,29614,1
138,5857,1782,648,1425,9,47,279,1791,8,171,97,189,179,286,1292,2140,4,9462,525,0,2,7,1,55750,22487,4372,29615,1
82,3581,1020,354,843,12,15,144,1032,8,134,77,144,142,221,970,1580,4,6792,377,0,2,9,0,55750,22487,4372,29616,1
262,6251,72,33,56,0,4,12,72,1,1,1,1,2,2,0,2,0,1,0,0,2,1,1,55750,22487,4372,29617,0
262,6251,1454,835,1044,76,110,219,1530,17,275,158,296,292,454,2297,3718,9,34017,1889,1,2,1,1,55760,22488,4372,29618,0
138,5861,1782,648,1425,9,47,279,1791,8,171,97,189,179,286,1292,2140,4,9462,525,0,2,6,6,55760,22489,4373,29619,0
262,6251,72,33,56,0,4,12,72,1,1,1,1,2,2,0,2,0,1,0,0,2,2,1,55760,22489,4373,29620,1
262,6251,1454,835,1044,76,110,219,1530,17,275,158,296,292,454,2297,3718,9,34017,1889,1,2,2,1,55770,22490,4373,29621,1
78,1663,402,202,227,24,74,80,426,12,52,33,61,64,94,339,564,7,3969,220,0,2,3,9,55770,22491,4373,29622,0
70,1570,53,23,39,0,0,13,53,2,8,4,8,10,12,26,39,1,39,2,0,2,4,2,55770,22491,4373,29623,0
70,1570,515,298,307,33,80,99,548,12,63,44,77,75,121,419,753,7,5527,307,0,2,4,2,55780,22491,4373,29624,0
78,1664,402,202,227,24,74,80,426,12,52,33,61,64,94,339,564,7,3969,220,0,2,8,0,55780,22492,4373,29625,1
70,1570,53,23,39,0,0,13,53,2,8,4,8,10,12,26,39,1,39,2,0,2,4,1,55780,22492,4373,29626,1
70,1570,515,298,307,33,80,99,548,12,63,44,77,75,121,419,753,7,5527,307,0,2,4,1,55790,22492,4373,29627,1
78,1701,402,202,227,24,74,80,426,12,52,33,61,64,94,339,564,7,3969,220,0,2,14,7,55790,22493,4373,29628,1
71,1575,53,23,39,0,0,13,53,2,8,4,8,10,12,26,39,1,39,2,0,2,4,3,55790,22493,4373,29629,1
71,1575,515,298,307,33,80,99,548,12,63,44,77,75,121,419,753,7,5527,307,0,2,4,3,55800,22493,4373,29630,1
22,452,601,196,481,2,23,85,603,8,63,36,72,71,108,400,664,4,3036,168,0,2,1,2,55800,22493,4373,29631,1
22,452,156,79,106,5,16,28,161,5,14,8,15,19,23,64,97,2,261,14,0,2,1,2,55800,22493,4373,29632,1
82,3585,1020,354,843,12,15,144,1032,8,134,77,144,142,221,970,1580,4,6792,377,0,2,2,1,55800,22493,4373,29633,1
71,1575,53,23,39,0,0,13,53,2,8,4,8,10,12,26,39,1,39,2,0,2,1,0,55800,22493,4373,29634,0
71,1575,515,298,307,33,80,99,548,12,63,44,77,75,121,419,753,7,5527,307,0,2,1,0,55810,22493,4373,29635,0
236,5371,4293,999,3693,19,54,507,4312,9,155,88,170,164,258,1156,1898,4,9368,520,0,2,1,2,55810,22495,4373,29636,1
236,5371,1482,859,1002,125,135,219,1607,16,219,134,251,235,385,1766,3032,9,27804,1544,1,2,1,2,55820,22496,4373,29637,1
262,6251,72,33,56,0,4,12,72,1,1,1,1,2,2,0,2,0,1,0,0,2,4,0,55820,22496,4373,29638,0
262,6251,1454,835,1044,76,110,219,1530,17,275,158,296,292,454,2297,3718,9,34017,1889,1,2,4,0,55830,22497,4373,29639,0
79,1714,402,202,227,24,74,80,426,12,52,33,61,64,94,339,564,7,3969,220,0,2,3,0,55830,22498,4373,29640,0
73,1606,53,23,39,0,0,13,53,2,8,4,8,10,12,26,39,1,39,2,0,2,14,1,55830,22498,4373,29641,0
73,1606,515,298,307,33,80,99,548,12,63,44,77,75,121,419,753,7,5527,307,0,2,14,1,55840,22498,4373,29642,0
77,1666,53,23,39,0,0,13,53,2,8,4,8,10,12,26,39,1,39,2,0,2,19,3,55840,22498,4373,29643,0
77,1666,515,298,307,33,80,99,548,12,63,44,77,75,121,419,753,7,5527,307,0,2,19,3,55850,22498,4373,29644,0
237,5376,4293,999,3693,19,54,507,4312,9,155,88,170,164,258,1156,1898,4,9368,520,0,2,1,1,55850,22500,4373,29645,1
237,5376,1482,859,1002,125,135,219,1607,16,219,134,251,235,385,1766,3032,9,27804,1544,1,2,1,1,55860,22501,4373,29646,1
32,665,125,97,103,3,0,19,128,9,25,17,27,34,44,144,223,4,1087,60,0,2,1,1,55860,22501,4374,29647,1
75,1595,53,23,39,0,0,13,53,2,8,4,8,10,12,26,39,1,39,2,0,2,8,25,55860,22501,4374,29648,1
75,1595,515,298,307,33,80,99,548,12,63,44,77,75,121,419,753,7,5527,307,0,2,8,25,55870,22501,4374,29649,1
263,6257,72,33,56,0,4,12,72,1,1,1,1,2,2,0,2,0,1,0,0,2,6,5,55870,22501,4374,29650,1
263,6257,1454,835,1044,76,110,219,1530,17,275,158,296,292,454,2297,3718,9,34017,1889,1,2,6,5,55880,22502,4374,29651,1
71,1380,1178,367,1042,6,15,115,1184,9,94,51,95,103,146,644,976,4,4439,246,0,2,3,1,55880,22502,4374,29652,1
71,1380,177,108,140,8,0,27,185,6,30,16,32,36,48,162,248,3,794,44,0,2,3,1,55880,22504,4374,29653,1
23,458,601,196,481,2,23,85,603,8,63,36,72,71,108,400,664,4,3036,168,0,2,4,3,55880,22504,4374,29654,1
23,458,156,79,106,5,16,28,161,5,14,8,15,19,23,64,97,2,261,14,0,2,4,3,55880,22504,4374,29655,1
84,3593,1020,354,843,12,15,144,1032,8,134,77,144,142,221,970,1580,4,6792,377,0,2,1,1,55880,22504,4374,29656,1
86,1809,477,336,357,30,23,73,507,16,194,134,250,210,384,1538,2962,10,30538,1696,0,2,5,1,55890,22505,4374,29657,1
74,1594,402,202,227,24,74,80,426,12,52,33,61,64,94,339,564,7,3969,220,0,2,6,1,55890,22506,4374,29658,1
86,1790,477,336,357,30,23,73,507,16,194,134,250,210,384,1538,2962,10,30538,1696,0,2,1,5,55900,22507,4374,29659,0
54,1125,207,111,150,11,0,50,218,5,26,19,36,31,55,133,272,3,943,52,0,2,8,0,55900,22507,4374,29660,0
54,1125,410,198,237,31,55,97,441,11,63,38,72,74,110,414,683,6,4293,238,0,2,8,0,55910,22508,4375,29661,0
74,1567,402,202,227,24,74,80,426,12,52,33,61,64,94,339,564,7,3969,220,0,2,4,9,55910,22509,4375,29662,0
51,595,647,139,84,35,284,233,682,0,0,0,0,0,0,0,0,0,0,0,0,2,3,2,55910,22509,4375,29663,0
54,1125,207,111,150,11,0,50,218,5,26,19,36,31,55,133,272,3,943,52,0,2,2,2,55910,22509,4375,29664,0
54,1125,410,198,237,31,55,97,441,11,63,38,72,74,110,414,683,6,4293,238,0,2,2,2,55920,22510,4376,29665,0
263,6260,72,33,56,0,4,12,72,1,1,1,1,2,2,0,2,0,1,0,0,2,2,0,55920,22510,4376,29667,0
263,6260,1454,835,1044,76,110,219,1530,17,275,158,296,292,454,2297,3718,9,34017,1889,1,2,2,0,55930,22511,4376,29668,0
98,2655,1523,757,1297,19,12,193,1542,12,193,117,230,205,347,1508,2664,7,19053,1058,0,2,0,5,55940,22513,4376,29669,0
98,2655,701,378,504,33,58,109,734,13,110,68,126,123,194,794,1346,7,10027,557,0,2,0,5,55940,22514,4377,29670,0
86,1790,477,336,357,30,23,73,507,16,194,134,250,210,384,1538,2962,10,30538,1696,0,2,1,1,55950,22515,4377,29671,0
54,1125,207,111,150,11,0,50,218,5,26,19,36,31,55,133,272,3,943,52,0,2,8,0,55950,22515,4377,29672,0
54,1125,410,198,237,31,55,97,441,11,63,38,72,74,110,414,683,6,4293,238,0,2,8,0,55960,22516,4378,29673,0
74,1567,402,202,227,24,74,80,426,12,52,33,61,64,94,339,564,7,3969,220,0,2,4,4,55960,22517,4378,29674,0
55,2371,1293,570,1093,25,15,163,1318,10,195,123,241,205,364,1516,2795,6,17273,959,0,2,0,7,55970,22519,4378,29675,0
51,595,647,139,84,35,284,233,682,0,0,0,0,0,0,0,0,0,0,0,0,2,3,2,55970,22519,4378,29676,0
94,4602,1523,757,1297,19,12,193,1542,12,193,117,230,205,347,1508,2664,7,19053,1058,0,2,0,1,55980,22521,4378,29677,0
55,2369,1293,570,1093,25,15,163,1318,10,195,123,241,205,364,1516,2795,6,17273,959,0,2,1,1,55990,22523,4378,29678,0
15,470,42,7,35,4,0,5,46,1,2,1,2,3,3,2,4,0,2,0,0,2,1,1,55990,22523,4378,29679,1
15,470,11,6,10,0,0,1,11,2,4,2,4,6,6,10,15,1,15,0,0,2,1,1,55990,22523,4378,29680,1
15,470,42,7,35,4,0,5,46,1,2,1,2,3,3,2,4,0,2,0,0,2,1,1,55990,22523,4378,29681,0
15,470,11,6,10,0,0,1,11,2,4,2,4,6,6,10,15,1,15,0,0,2,1,1,55990,22523,4378,29682,0
113,2553,1043,504,840,53,9,147,1096,9,180,112,198,189,310,1377,2344,4,11604,644,0,2,2,1,55990,22525,4378,29683,1
113,2553,383,288,292,26,6,62,409,11,65,38,67,76,105,429,656,5,3719,206,0,2,2,1,55990,22526,4378,29684,1
79,3054,1043,504,840,53,9,147,1096,9,180,112,198,189,310,1377,2344,4,11604,644,0,2,14,5,55990,22528,4378,29685,1
94,4591,1523,757,1297,19,12,193,1542,12,193,117,230,205,347,1508,2664,7,19053,1058,0,2,1,4,56000,22530,4378,29686,0
79,1724,402,202,227,24,74,80,426,12,52,33,61,64,94,339,564,7,3969,220,0,2,13,3,56000,22531,4378,29687,0
98,2655,1523,757,1297,19,12,193,1542,12,193,117,230,205,347,1508,2664,7,19053,1058,0,2,0,5,56010,22533,4378,29688,0
98,2655,701,378,504,33,58,109,734,13,110,68,126,123,194,794,1346,7,10027,557,0,2,0,5,56010,22534,4379,29689,0
94,4591,1523,757,1297,19,12,193,1542,12,193,117,230,205,347,1508,2664,7,19053,1058,0,2,1,5,56020,22536,4379,29690,0
79,1583,757,253,292,73,244,162,830,13,61,38,67,74,105,409,651,7,4654,258,0,2,5,4,56020,22537,4379,29691,1
25,685,256,139,192,9,7,47,265,4,23,12,24,27,36,112,171,2,357,19,0,2,18,0,56020,22538,4379,29692,1
80,1589,757,253,292,73,244,162,830,13,61,38,67,74,105,409,651,7,4654,258,0,2,1,1,56020,22539,4379,29693,0
78,1591,757,253,292,73,244,162,830,13,61,38,67,74,105,409,651,7,4654,258,0,2,6,5,56020,22540,4379,29694,0
78,1591,757,253,292,73,244,162,830,13,61,38,67,74,105,409,651,7,4654,258,0,2,1,1,56020,22541,4379,29695,0
78,1591,757,253,292,73,244,162,830,13,61,38,67,74,105,409,651,7,4654,258,0,2,3,1,56020,22542,4379,29696,0
25,685,256,139,192,9,7,47,265,4,23,12,24,27,36,112,171,2,357,19,0,2,18,0,56020,22543,4379,29697,0
237,5376,4293,999,3693,19,54,507,4312,9,155,88,170,164,258,1156,1898,4,9368,520,0,2,6,7,56020,22545,4379,29699,0
237,5376,1482,859,1002,125,135,219,1607,16,219,134,251,235,385,1766,3032,9,27804,1544,1,2,6,7,56030,22546,4379,29700,0
32,665,125,97,103,3,0,19,128,9,25,17,27,34,44,144,223,4,1087,60,0,2,3,11,56030,22546,4380,29701,0
79,1724,402,202,227,24,74,80,426,12,52,33,61,64,94,339,564,7,3969,220,0,2,63,16,56030,22547,4380,29702,0
75,1595,53,23,39,0,0,13,53,2,8,4,8,10,12,26,39,1,39,2,0,2,29,7,56030,22547,4380,29703,0
75,1595,515,298,307,33,80,99,548,12,63,44,77,75,121,419,753,7,5527,307,0,2,29,7,56040,22547,4380,29704,0
263,6260,72,33,56,0,4,12,72,1,1,1,1,2,2,0,2,0,1,0,0,2,47,12,56040,22547,4380,29705,0
263,6260,1454,835,1044,76,110,219,1530,17,275,158,296,292,454,2297,3718,9,34017,1889,1,2,47,12,56050,22548,4380,29706,0
71,1380,1178,367,1042,6,15,115,1184,9,94,51,95,103,146,644,976,4,4439,246,0,2,8,10,56050,22548,4380,29707,0
71,1380,177,108,140,8,0,27,185,6,30,16,32,36,48,162,248,3,794,44,0,2,8,10,56050,22550,4380,29708,0
23,458,601,196,481,2,23,85,603,8,63,36,72,71,108,400,664,4,3036,168,0,2,4,4,56050,22550,4380,29709,0
23,458,156,79,106,5,16,28,161,5,14,8,15,19,23,64,97,2,261,14,0,2,4,4,56050,22550,4380,29710,0
170,7555,139,89,101,2,0,35,141,7,54,34,62,61,96,330,569,4,2287,127,0,2,3,1,56050,22550,4380,29711,0
170,7555,7,5,5,0,0,2,7,1,2,1,2,3,3,2,4,0,2,0,0,2,3,1,56050,22550,4380,29712,0
138,5861,1782,648,1425,9,47,279,1791,8,171,97,189,179,286,1292,2140,4,9462,525,0,2,8,2,56050,22551,4381,29713,0
84,3593,1020,354,843,12,15,144,1032,8,134,77,144,142,221,970,1580,4,6792,377,0,2,13,4,56050,22551,4381,29714,0
28,807,339,213,244,17,9,65,356,10,42,26,48,52,74,259,421,5,2410,133,0,2,15,0,56060,22551,4381,29715,0
58,2553,1293,570,1093,25,15,163,1318,10,195,123,241,205,364,1516,2795,6,17273,959,0,2,148,0,56070,22553,4381,29716,0
92,3882,1289,550,1043,56,32,155,1345,10,167,93,185,177,278,1266,2075,5,11498,638,0,2,30,0,56070,22555,4382,29717,0
48,991,447,308,343,6,5,95,453,7,96,59,111,103,170,651,1136,4,4600,255,0,2,10,0,56070,22558,4382,29718,0
48,991,322,174,179,16,74,51,338,10,41,26,46,51,72,252,408,5,2291,127,0,2,10,0,56070,22561,4383,29719,0
38,1651,447,308,343,6,5,95,453,7,96,59,111,103,170,651,1136,4,4600,255,0,2,13,0,56070,22564,4383,29720,0
86,1790,477,336,357,30,23,73,507,16,194,134,250,210,384,1538,2962,10,30538,1696,0,2,1,1,56080,22565,4383,29721,0
54,1125,207,111,150,11,0,50,218,5,26,19,36,31,55,133,272,3,943,52,0,2,8,0,56080,22565,4383,29722,0
54,1125,410,198,237,31,55,97,441,11,63,38,72,74,110,414,683,6,4293,238,0,2,8,0,56090,22566,4384,29723,0
51,595,647,139,84,35,284,233,682,0,0,0,0,0,0,0,0,0,0,0,0,2,3,2,56090,22566,4384,29724,0
98,2655,1523,757,1297,19,12,193,1542,12,193,117,230,205,347,1508,2664,7,19053,1058,0,2,0,5,56100,22568,4384,29725,0
98,2655,701,378,504,33,58,109,734,13,110,68,126,123,194,794,1346,7,10027,557,0,2,0,5,56100,22569,4385,29726,0
24,600,2,2,2,0,0,0,2,0,0,0,0,0,0,0,0,0,0,0,0,2,2,1,56100,22569,4385,29726,0
24,600,99,48,90,1,3,5,100,0,0,0,0,0,0,0,0,0,0,0,0,2,2,1,56100,22570,4385,29727,0
24,600,8,5,5,2,0,1,10,0,0,0,0,0,0,0,0,0,0,0,0,2,2,1,56100,22570,4385,29728,0
24,600,1217,716,841,84,126,174,1301,14,185,118,215,199,333,1446,2542,8,20687,1149,0,2,2,1,56110,22572,4385,29729,0
24,600,160,89,115,0,13,31,160,7,15,11,17,22,28,78,124,3,495,27,0,2,2,1,56110,22572,4385,29730,0
24,600,10,10,9,9,0,0,19,0,0,0,0,0,0,0,0,0,0,0,0,2,2,1,56110,22572,4386,29731,0
24,600,173,84,99,8,29,36,181,5,12,7,13,17,20,54,81,2,221,12,0,2,2,1,56110,22573,4386,29732,0
24,600,3,1,1,3,0,0,6,0,0,0,0,0,0,0,0,0,0,0,0,2,2,1,56110,22573,4386,29733,0
79,1722,402,202,227,24,74,80,426,12,52,33,61,64,94,339,564,7,3969,220,0,2,3,3,56110,22574,4386,29734,0
78,1591,757,253,292,73,244,162,830,13,61,38,67,74,105,409,651,7,4654,258,0,2,7,1,56110,22575,4386,29735,0
15,470,42,7,35,4,0,5,46,1,2,1,2,3,3,2,4,0,2,0,0,2,1,1,56110,22575,4386,29736,0
15,470,11,6,10,0,0,1,11,2,4,2,4,6,6,10,15,1,15,0,0,2,1,1,56110,22575,4386,29737,0
25,685,256,139,192,9,7,47,265,4,23,12,24,27,36,112,171,2,357,19,0,2,23,0,56110,22576,4386,29738,0
94,4591,1523,757,1297,19,12,193,1542,12,193,117,230,205,347,1508,2664,7,19053,1058,0,2,1,5,56120,22578,4386,29739,0
39,1724,386,256,301,16,9,68,402,4,59,35,69,63,104,355,621,2,1453,80,0,2,1,1,56120,22578,4386,29740,0
238,5409,4293,999,3693,19,54,507,4312,9,155,88,170,164,258,1156,1898,4,9368,520,0,2,7,3,56120,22580,4386,29741,1
238,5409,1482,859,1002,125,135,219,1607,16,219,134,251,235,385,1766,3032,9,27804,1544,1,2,7,3,56130,22581,4386,29742,1
131,3042,77,34,69,0,0,8,77,3,24,16,29,27,45,114,213,1,387,21,0,2,22,9,56130,22581,4386,29743,1
131,3042,712,438,573,51,9,84,763,14,102,71,128,116,199,733,1364,8,11988,666,0,2,22,9,56140,22582,4386,29744,1
279,6562,72,33,56,0,4,12,72,1,1,1,1,2,2,0,2,0,1,0,0,2,46,1,56140,22582,4386,29745,1
279,6562,1454,835,1044,76,110,219,1530,17,275,158,296,292,454,2297,3718,9,34017,1889,1,2,46,1,56150,22583,4386,29746,1
171,7658,139,89,101,2,0,35,141,7,54,34,62,61,96,330,569,4,2287,127,0,2,33,0,56150,22583,4386,29747,1
171,7658,7,5,5,0,0,2,7,1,2,1,2,3,3,2,4,0,2,0,0,2,33,0,56150,22583,4386,29748,1
73,3804,1296,573,1062,40,33,157,1336,8,201,118,231,209,349,1561,2689,4,12365,686,0,2,1,1,56150,22583,4386,29749,1
30,1233,373,158,315,8,0,51,381,5,76,44,79,81,123,486,779,2,2026,112,0,2,1,1,56150,22583,4386,29750,1
279,6562,72,33,56,0,4,12,72,1,1,1,1,2,2,0,2,0,1,0,0,2,1,0,56150,22583,4386,29751,0
279,6562,1454,835,1044,76,110,219,1530,17,275,158,296,292,454,2297,3718,9,34017,1889,1,2,1,0,56160,22584,4386,29752,0
15,483,42,7,35,4,0,5,46,1,2,1,2,3,3,2,4,0,2,0,0,2,4,0,56160,22584,4386,29753,0
15,483,11,6,10,0,0,1,11,2,4,2,4,6,6,10,15,1,15,0,0,2,4,0,56160,22584,4386,29754,0
86,1790,477,336,357,30,23,73,507,16,194,134,250,210,384,1538,2962,10,30538,1696,0,2,1,1,56170,22585,4386,29755,0
54,1125,207,111,150,11,0,50,218,5,26,19,36,31,55,133,272,3,943,52,0,2,8,0,56170,22585,4386,29756,0
54,1125,410,198,237,31,55,97,441,11,63,38,72,74,110,414,683,6,4293,238,0,2,8,0,56180,22586,4387,29757,0
51,595,647,139,84,35,284,233,682,0,0,0,0,0,0,0,0,0,0,0,0,2,3,2,56180,22586,4387,29758,0
98,2655,1523,757,1297,19,12,193,1542,12,193,117,230,205,347,1508,2664,7,19053,1058,0,2,0,5,56190,22588,4387,29759,0
98,2655,701,378,504,33,58,109,734,13,110,68,126,123,194,794,1346,7,10027,557,0,2,0,5,56190,22589,4388,29760,0
24,600,2,2,2,0,0,0,2,0,0,0,0,0,0,0,0,0,0,0,0,2,2,1,56190,22589,4388,29760,0
24,600,99,48,90,1,3,5,100,0,0,0,0,0,0,0,0,0,0,0,0,2,2,1,56190,22590,4388,29761,0
24,600,8,5,5,2,0,1,10,0,0,0,0,0,0,0,0,0,0,0,0,2,2,1,56190,22590,4388,29762,0
24,600,1217,716,841,84,126,174,1301,14,185,118,215,199,333,1446,2542,8,20687,1149,0,2,2,1,56200,22592,4388,29763,0
24,600,160,89,115,0,13,31,160,7,15,11,17,22,28,78,124,3,495,27,0,2,2,1,56200,22592,4388,29764,0
24,600,10,10,9,9,0,0,19,0,0,0,0,0,0,0,0,0,0,0,0,2,2,1,56200,22592,4389,29765,0
24,600,173,84,99,8,29,36,181,5,12,7,13,17,20,54,81,2,221,12,0,2,2,1,56200,22593,4389,29766,0
24,600,3,1,1,3,0,0,6,0,0,0,0,0,0,0,0,0,0,0,0,2,2,1,56200,22593,4389,29767,0
79,1722,402,202,227,24,74,80,426,12,52,33,61,64,94,339,564,7,3969,220,0,2,3,3,56200,22594,4389,29768,0
78,1591,757,253,292,73,244,162,830,13,61,38,67,74,105,409,651,7,4654,258,0,2,7,1,56200,22595,4389,29769,0
15,470,42,7,35,4,0,5,46,1,2,1,2,3,3,2,4,0,2,0,0,2,1,1,56200,22595,4389,29770,0
15,470,11,6,10,0,0,1,11,2,4,2,4,6,6,10,15,1,15,0,0,2,1,1,56200,22595,4389,29771,0
25,685,256,139,192,9,7,47,265,4,23,12,24,27,36,112,171,2,357,19,0,2,23,0,56200,22596,4389,29772,0
94,4591,1523,757,1297,19,12,193,1542,12,193,117,230,205,347,1508,2664,7,19053,1058,0,2,1,5,56210,22598,4389,29773,0
39,1724,386,256,301,16,9,68,402,4,59,35,69,63,104,355,621,2,1453,80,0,2,1,1,56210,22598,4389,29774,0
15,483,42,7,35,4,0,5,46,1,2,1,2,3,3,2,4,0,2,0,0,2,4,0,56210,22598,4389,29775,0
15,483,11,6,10,0,0,1,11,2,4,2,4,6,6,10,15,1,15,0,0,2,4,0,56210,22598,4389,29776,0
113,2553,1043,504,840,53,9,147,1096,9,180,112,198,189,310,1377,2344,4,11604,644,0,2,2,1,56210,22600,4389,29777,0
113,2553,383,288,292,26,6,62,409,11,65,38,67,76,105,429,656,5,3719,206,0,2,2,1,56210,22601,4389,29778,0
92,3882,1289,550,1043,56,32,155,1345,10,167,93,185,177,278,1266,2075,5,11498,638,0,2,30,0,56210,22603,4390,29779,0
79,3054,1043,504,840,53,9,147,1096,9,180,112,198,189,310,1377,2344,4,11604,644,0,2,14,5,56210,22605,4390,29780,0
164,5028,1660,832,1314,41,38,274,1701,20,312,209,395,332,604,2671,5058,12,64042,3557,1,2,14,27,56210,22607,4391,29782,1
164,5028,1057,646,719,113,100,145,1170,18,215,134,248,233,382,1740,3004,10,31186,1732,1,2,14,27,56220,22608,4392,29783,1
15,472,42,7,35,4,0,5,46,1,2,1,2,3,3,2,4,0,2,0,0,2,1,0,56220,22608,4392,29784,1
15,472,11,6,10,0,0,1,11,2,4,2,4,6,6,10,15,1,15,0,0,2,1,0,56220,22608,4392,29785,1
155,4419,1660,832,1314,41,38,274,1701,20,312,209,395,332,604,2671,5058,12,64042,3557,1,2,6,6,56220,22610,4393,29787,1
164,5028,1660,832,1314,41,38,274,1701,20,312,209,395,332,604,2671,5058,12,64042,3557,1,2,14,27,56220,22612,4394,29789,0
164,5028,1057,646,719,113,100,145,1170,18,215,134,248,233,382,1740,3004,10,31186,1732,1,2,14,27,56230,22613,4395,29790,0
15,472,42,7,35,4,0,5,46,1,2,1,2,3,3,2,4,0,2,0,0,2,1,0,56230,22613,4395,29791,0
15,472,11,6,10,0,0,1,11,2,4,2,4,6,6,10,15,1,15,0,0,2,1,0,56230,22613,4395,29792,0
155,4419,1660,832,1314,41,38,274,1701,20,312,209,395,332,604,2671,5058,12,64042,3557,1,2,6,6,56230,22615,4396,29794,0
48,992,447,308,343,6,5,95,453,7,96,59,111,103,170,651,1136,4,4600,255,0,2,15,0,56230,22618,4396,29795,0
48,992,322,174,179,16,74,51,338,10,41,26,46,51,72,252,408,5,2291,127,0,2,15,0,56230,22621,4397,29796,0
38,1676,447,308,343,6,5,95,453,7,96,59,111,103,170,651,1136,4,4600,255,0,2,8,9,56230,22624,4397,29797,0
27,951,74,35,59,1,0,14,75,3,14,7,14,17,21,58,85,1,128,7,0,2,2,1,56230,22625,4397,29798,1
27,951,245,125,200,5,7,34,250,7,30,17,34,37,51,166,265,3,1053,58,0,2,2,1,56240,22626,4397,29799,1
259,6121,72,33,56,0,4,12,72,1,1,1,1,2,2,0,2,0,1,0,0,2,2,1,56240,22626,4397,29800,1
259,6121,1454,835,1044,76,110,219,1530,17,275,158,296,292,454,2297,3718,9,34017,1889,1,2,2,1,56250,22627,4397,29801,1
58,1174,207,111,150,11,0,50,218,5,26,19,36,31,55,133,272,3,943,52,0,2,8,0,56250,22627,4397,29802,0
58,1174,410,198,237,31,55,97,441,11,63,38,72,74,110,414,683,6,4293,238,0,2,8,0,56260,22628,4398,29803,0
259,6152,72,33,56,0,4,12,72,1,1,1,1,2,2,0,2,0,1,0,0,2,11,7,56260,22628,4398,29804,0
259,6152,1454,835,1044,76,110,219,1530,17,275,158,296,292,454,2297,3718,9,34017,1889,1,2,11,7,56270,22629,4398,29805,0
139,5869,1782,648,1425,9,47,279,1791,8,171,97,189,179,286,1292,2140,4,9462,525,0,2,13,0,56270,22630,4399,29806,0
27,951,74,35,59,1,0,14,75,3,14,7,14,17,21,58,85,1,128,7,0,2,2,1,56270,22631,4399,29807,0
27,951,245,125,200,5,7,34,250,7,30,17,34,37,51,166,265,3,1053,58,0,2,2,1,56280,22632,4399,29808,0
259,6121,72,33,56,0,4,12,72,1,1,1,1,2,2,0,2,0,1,0,0,2,2,1,56280,22632,4399,29809,0
259,6121,1454,835,1044,76,110,219,1530,17,275,158,296,292,454,2297,3718,9,34017,1889,1,2,2,1,56290,22633,4399,29810,0
132,3068,77,34,69,0,0,8,77,3,24,16,29,27,45,114,213,1,387,21,0,2,5,2,56290,22633,4399,29811,0
132,3068,712,438,573,51,9,84,763,14,102,71,128,116,199,733,1364,8,11988,666,0,2,5,2,56300,22634,4399,29812,0
97,4416,1338,495,1086,10,64,173,1348,11,122,82,157,133,239,883,1686,7,11934,663,0,2,1,1,56300,22636,4399,29813,0
73,3806,1296,573,1062,40,33,157,1336,8,201,118,231,209,349,1561,2689,4,12365,686,0,2,1,1,56300,22636,4399,29814,0
86,2206,773,422,505,30,103,129,803,14,77,46,83,91,129,535,839,7,6334,351,0,2,3,3,56310,22637,4400,29815,0
27,951,74,35,59,1,0,14,75,3,14,7,14,17,21,58,85,1,128,7,0,2,2,1,56310,22638,4400,29816,0
27,951,245,125,200,5,7,34,250,7,30,17,34,37,51,166,265,3,1053,58,0,2,2,1,56320,22639,4400,29817,0
259,6121,72,33,56,0,4,12,72,1,1,1,1,2,2,0,2,0,1,0,0,2,2,1,56320,22639,4400,29818,0
259,6121,1454,835,1044,76,110,219,1530,17,275,158,296,292,454,2297,3718,9,34017,1889,1,2,2,1,56330,22640,4400,29819,0
113,2553,1043,504,840,53,9,147,1096,9,180,112,198,189,310,1377,2344,4,11604,644,0,2,2,1,56330,22642,4400,29820,0
113,2553,383,288,292,26,6,62,409,11,65,38,67,76,105,429,656,5,3719,206,0,2,2,1,56330,22643,4400,29821,0
15,483,42,7,35,4,0,5,46,1,2,1,2,3,3,2,4,0,2,0,0,2,4,0,56330,22643,4400,29822,0
15,483,11,6,10,0,0,1,11,2,4,2,4,6,6,10,15,1,15,0,0,2,4,0,56330,22643,4400,29823,0
92,3882,1289,550,1043,56,32,155,1345,10,167,93,185,177,278,1266,2075,5,11498,638,0,2,30,0,56330,22645,4401,29824,0
79,3054,1043,504,840,53,9,147,1096,9,180,112,198,189,310,1377,2344,4,11604,644,0,2,14,5,56330,22647,4401,29825,0
164,5028,1660,832,1314,41,38,274,1701,20,312,209,395,332,604,2671,5058,12,64042,3557,1,2,14,27,56330,22649,4402,29827,0
164,5028,1057,646,719,113,100,145,1170,18,215,134,248,233,382,1740,3004,10,31186,1732,1,2,14,27,56340,22650,4403,29828,0
86,1790,477,336,357,30,23,73,507,16,194,134,250,210,384,1538,2962,10,30538,1696,0,2,1,1,56350,22651,4403,29829,0
54,1125,207,111,150,11,0,50,218,5,26,19,36,31,55,133,272,3,943,52,0,2,8,0,56350,22651,4403,29830,0
54,1125,410,198,237,31,55,97,441,11,63,38,72,74,110,414,683,6,4293,238,0,2,8,0,56360,22652,4404,29831,0
51,595,647,139,84,35,284,233,682,0,0,0,0,0,0,0,0,0,0,0,0,2,3,2,56360,22652,4404,29832,0
98,2655,1523,757,1297,19,12,193,1542,12,193,117,230,205,347,1508,2664,7,19053,1058,0,2,0,5,56370,22654,4404,29833,0
98,2655,701,378,504,33,58,109,734,13,110,68,126,123,194,794,1346,7,10027,557,0,2,0,5,56370,22655,4405,29834,0
24,600,2,2,2,0,0,0,2,0,0,0,0,0,0,0,0,0,0,0,0,2,2,1,56370,22655,4405,29834,0
24,600,99,48,90,1,3,5,100,0,0,0,0,0,0,0,0,0,0,0,0,2,2,1,56370,22656,4405,29835,0
24,600,8,5,5,2,0,1,10,0,0,0,0,0,0,0,0,0,0,0,0,2,2,1,56370,22656,4405,29836,0
24,600,1217,716,841,84,126,174,1301,14,185,118,215,199,333,1446,2542,8,20687,1149,0,2,2,1,56380,22658,4405,29837,0
24,600,160,89,115,0,13,31,160,7,15,11,17,22,28,78,124,3,495,27,0,2,2,1,56380,22658,4405,29838,0
24,600,10,10,9,9,0,0,19,0,0,0,0,0,0,0,0,0,0,0,0,2,2,1,56380,22658,4406,29839,0
24,600,173,84,99,8,29,36,181,5,12,7,13,17,20,54,81,2,221,12,0,2,2,1,56380,22659,4406,29840,0
24,600,3,1,1,3,0,0,6,0,0,0,0,0,0,0,0,0,0,0,0,2,2,1,56380,22659,4406,29841,0
79,1722,402,202,227,24,74,80,426,12,52,33,61,64,94,339,564,7,3969,220,0,2,3,3,56380,22660,4406,29842,0
78,1591,757,253,292,73,244,162,830,13,61,38,67,74,105,409,651,7,4654,258,0,2,7,1,56380,22661,4406,29843,0
15,472,42,7,35,4,0,5,46,1,2,1,2,3,3,2,4,0,2,0,0,2,2,1,56380,22661,4406,29844,0
15,472,11,6,10,0,0,1,11,2,4,2,4,6,6,10,15,1,15,0,0,2,2,1,56380,22661,4406,29845,0
25,685,256,139,192,9,7,47,265,4,23,12,24,27,36,112,171,2,357,19,0,2,23,0,56380,22662,4406,29846,0
155,4419,1660,832,1314,41,38,274,1701,20,312,209,395,332,604,2671,5058,12,64042,3557,1,2,6,6,56380,22664,4407,29848,0
94,4591,1523,757,1297,19,12,193,1542,12,193,117,230,205,347,1508,2664,7,19053,1058,0,2,1,5,56390,22666,4407,29849,0
39,1724,386,256,301,16,9,68,402,4,59,35,69,63,104,355,621,2,1453,80,0,2,1,1,56390,22666,4407,29850,0
122,2921,77,34,69,0,0,8,77,3,24,16,29,27,45,114,213,1,387,21,0,2,1,1,56390,22666,4407,29851,0
122,2921,712,438,573,51,9,84,763,14,102,71,128,116,199,733,1364,8,11988,666,0,2,1,1,56400,22667,4407,29852,0
122,2921,77,34,69,0,0,8,77,3,24,16,29,27,45,114,213,1,387,21,0,2,1,1,56400,22667,4407,29853,0
122,2921,712,438,573,51,9,84,763,14,102,71,128,116,199,733,1364,8,11988,666,0,2,1,1,56410,22668,4407,29854,0
48,992,447,308,343,6,5,95,453,7,96,59,111,103,170,651,1136,4,4600,255,0,2,25,0,56410,22671,4407,29855,0
48,992,322,174,179,16,74,51,338,10,41,26,46,51,72,252,408,5,2291,127,0,2,25,0,56410,22674,4408,29856,0
38,1676,447,308,343,6,5,95,453,7,96,59,111,103,170,651,1136,4,4600,255,0,2,12,0,56410,22677,4408,29857,0
86,2206,773,422,505,30,103,129,803,14,77,46,83,91,129,535,839,7,6334,351,0,2,3,3,56420,22678,4409,29858,0
243,5487,4293,999,3693,19,54,507,4312,9,155,88,170,164,258,1156,1898,4,9368,520,0,2,16,1,56420,22680,4409,29859,1
243,5487,1482,859,1002,125,135,219,1607,16,219,134,251,235,385,1766,3032,9,27804,1544,1,2,16,1,56430,22681,4409,29860,1
75,1601,53,23,39,0,0,13,53,2,8,4,8,10,12,26,39,1,39,2,0,2,1,0,56430,22681,4409,29861,1
75,1601,515,298,307,33,80,99,548,12,63,44,77,75,121,419,753,7,5527,307,0,2,1,0,56440,22681,4409,29862,1
288,6751,72,33,56,0,4,12,72,1,1,1,1,2,2,0,2,0,1,0,0,2,34,3,56440,22681,4409,29863,1
288,6751,1454,835,1044,76,110,219,1530,17,275,158,296,292,454,2297,3718,9,34017,1889,1,2,34,3,56450,22682,4409,29864,1
48,992,447,308,343,6,5,95,453,7,96,59,111,103,170,651,1136,4,4600,255,0,2,25,0,56450,22685,4409,29865,0
48,992,322,174,179,16,74,51,338,10,41,26,46,51,72,252,408,5,2291,127,0,2,25,0,56450,22688,4410,29866,0
38,1676,447,308,343,6,5,95,453,7,96,59,111,103,170,651,1136,4,4600,255,0,2,12,0,56450,22691,4410,29867,0
244,5496,4293,999,3693,19,54,507,4312,9,155,88,170,164,258,1156,1898,4,9368,520,0,2,4,3,56450,22693,4410,29868,0
244,5496,1482,859,1002,125,135,219,1607,16,219,134,251,235,385,1766,3032,9,27804,1544,1,2,4,3,56460,22694,4410,29869,0
244,5495,4293,999,3693,19,54,507,4312,9,155,88,170,164,258,1156,1898,4,9368,520,0,2,2,2,56460,22696,4410,29870,0
244,5495,1482,859,1002,125,135,219,1607,16,219,134,251,235,385,1766,3032,9,27804,1544,1,2,2,2,56470,22697,4410,29871,0
140,3230,77,34,69,0,0,8,77,3,24,16,29,27,45,114,213,1,387,21,0,2,46,13,56470,22697,4410,29872,1
140,3230,712,438,573,51,9,84,763,14,102,71,128,116,199,733,1364,8,11988,666,0,2,46,13,56480,22698,4410,29873,1
30,1233,373,158,315,8,0,51,381,5,76,44,79,81,123,486,779,2,2026,112,0,2,1,1,56480,22698,4410,29874,1
76,1603,53,23,39,0,0,13,53,2,8,4,8,10,12,26,39,1,39,2,0,2,1,1,56480,22698,4410,29875,0
76,1603,515,298,307,33,80,99,548,12,63,44,77,75,121,419,753,7,5527,307,0,2,1,1,56490,22698,4410,29876,0
58,1174,207,111,150,11,0,50,218,5,26,19,36,31,55,133,272,3,943,52,0,2,8,0,56490,22698,4410,29877,0
58,1174,410,198,237,31,55,97,441,11,63,38,72,74,110,414,683,6,4293,238,0,2,8,0,56500,22699,4411,29878,0
259,6153,72,33,56,0,4,12,72,1,1,1,1,2,2,0,2,0,1,0,0,2,11,7,56500,22699,4411,29879,0
259,6153,1454,835,1044,76,110,219,1530,17,275,158,296,292,454,2297,3718,9,34017,1889,1,2,11,7,56510,22700,4411,29880,0
139,5869,1782,648,1425,9,47,279,1791,8,171,97,189,179,286,1292,2140,4,9462,525,0,2,13,0,56510,22701,4412,29881,0
150,6861,139,89,101,2,0,35,141,7,54,34,62,61,96,330,569,4,2287,127,0,2,8,0,56510,22701,4412,29882,1
150,6861,7,5,5,0,0,2,7,1,2,1,2,3,3,2,4,0,2,0,0,2,8,0,56510,22701,4412,29883,1
11,238,19,8,11,5,0,4,24,2,5,3,6,7,9,13,25,1,30,1,0,2,9,8,56510,22701,4412,29884,0
11,238,102,59,69,5,3,24,107,6,22,15,28,28,43,113,206,3,789,43,0,2,9,8,56510,22701,4412,29885,0
11,238,106,40,36,3,49,17,109,8,17,13,23,25,36,93,167,5,904,50,0,2,9,8,56510,22701,4412,29886,0
213,4606,182,127,129,0,0,53,182,5,39,21,42,44,63,217,343,2,926,51,0,2,65,50,56510,22701,4413,29887,0
213,4606,1165,710,800,67,119,181,1232,18,243,153,282,261,435,2000,3492,10,36473,2026,1,2,65,50,56520,22701,4414,29888,0
84,1807,773,419,590,28,0,166,801,10,204,113,217,214,330,1598,2554,5,13587,754,0,2,51,100,56520,22701,4415,29889,0
84,1807,421,273,302,44,34,57,465,17,81,59,107,98,166,583,1098,11,12329,684,0,2,51,100,56520,22701,4416,29890,0
26,527,2,2,2,0,0,0,2,0,0,0,0,0,0,0,0,0,0,0,0,2,5,8,56520,22701,4416,29890,0
26,527,99,48,90,1,3,5,100,0,0,0,0,0,0,0,0,0,0,0,0,2,5,8,56520,22702,4416,29891,0
26,527,8,5,5,2,0,1,10,0,0,0,0,0,0,0,0,0,0,0,0,2,5,8,56520,22702,4416,29892,0
26,527,1217,716,841,84,126,174,1301,14,185,118,215,199,333,1446,2542,8,20687,1149,0,2,5,8,56530,22704,4416,29893,0
26,527,160,89,115,0,13,31,160,7,15,11,17,22,28,78,124,3,495,27,0,2,5,8,56530,22704,4416,29894,0
26,527,10,10,9,9,0,0,19,0,0,0,0,0,0,0,0,0,0,0,0,2,5,8,56530,22704,4417,29895,0
26,527,173,84,99,8,29,36,181,5,12,7,13,17,20,54,81,2,221,12,0,2,5,8,56530,22705,4417,29896,0
26,527,3,1,1,3,0,0,6,0,0,0,0,0,0,0,0,0,0,0,0,2,5,8,56530,22705,4417,29897,0
164,5028,1660,832,1314,41,38,274,1701,20,312,209,395,332,604,2671,5058,12,64042,3557,1,2,69,73,56530,22707,4418,29899,0
164,5028,1057,646,719,113,100,145,1170,18,215,134,248,233,382,1740,3004,10,31186,1732,1,2,69,73,56540,22708,4419,29900,0
17,345,95,58,50,9,16,20,104,12,33,24,45,45,69,209,378,8,3100,172,0,2,3,3,56540,22708,4419,29901,0
86,1790,477,336,357,30,23,73,507,16,194,134,250,210,384,1538,2962,10,30538,1696,0,2,25,22,56550,22709,4419,29902,0
71,1698,996,429,845,24,10,117,1020,7,76,50,88,83,138,494,879,4,3565,198,0,2,110,40,56550,22711,4419,29903,0
71,1698,456,277,329,12,42,72,468,13,85,50,97,98,147,592,972,7,7212,400,0,2,110,40,56550,22711,4419,29904,0
145,3018,1513,682,1277,25,13,200,1538,11,199,116,219,210,335,1557,2584,6,15641,868,0,2,257,93,56550,22713,4419,29905,0
145,3018,819,519,539,24,98,155,843,15,96,57,106,111,163,690,1107,8,9171,509,0,2,257,93,56560,22715,4419,29906,0
54,1125,207,111,150,11,0,50,218,5,26,19,36,31,55,133,272,3,943,52,0,2,98,74,56560,22715,4419,29907,0
54,1125,410,198,237,31,55,97,441,11,63,38,72,74,110,414,683,6,4293,238,0,2,98,74,56570,22716,4420,29908,0
354,7093,1457,730,1242,11,6,188,1468,10,292,166,329,302,495,2424,4078,5,22973,1276,1,2,167,150,56570,22718,4420,29909,0
354,7093,74,35,59,1,0,14,75,3,14,7,14,17,21,58,85,1,128,7,0,2,167,150,56570,22719,4420,29910,0
354,7093,245,125,200,5,7,34,250,7,30,17,34,37,51,166,265,3,1053,58,0,2,167,150,56580,22720,4420,29911,0
28,807,339,213,244,17,9,65,356,10,42,26,48,52,74,259,421,5,2410,133,0,2,34,7,56590,22720,4420,29912,0
83,2145,1455,414,1257,16,76,112,1471,5,41,23,46,46,69,231,381,2,1069,59,0,2,170,63,56590,22721,4420,29914,0
83,2145,669,365,481,22,61,110,691,15,103,63,122,118,185,747,1273,8,11311,628,0,2,170,63,56600,22721,4421,29915,0
238,5391,4293,999,3693,19,54,507,4312,9,155,88,170,164,258,1156,1898,4,9368,520,0,2,195,156,56600,22723,4421,29916,0
238,5391,1482,859,1002,125,135,219,1607,16,219,134,251,235,385,1766,3032,9,27804,1544,1,2,195,156,56610,22724,4421,29917,0
6,136,44,22,19,0,19,6,44,2,10,6,12,12,18,35,64,1,77,4,0,2,0,1,56610,22724,4421,29918,0
27,950,74,35,59,1,0,14,75,3,14,7,14,17,21,58,85,1,128,7,0,2,27,22,56610,22725,4421,29919,0
27,950,245,125,200,5,7,34,250,7,30,17,34,37,51,166,265,3,1053,58,0,2,27,22,56620,22726,4421,29920,0
51,595,647,139,84,35,284,233,682,0,0,0,0,0,0,0,0,0,0,0,0,2,237,38,56620,22726,4421,29921,0
98,2655,1523,757,1297,19,12,193,1542,12,193,117,230,205,347,1508,2664,7,19053,1058,0,2,103,18,56630,22728,4421,29922,0
98,2655,701,378,504,33,58,109,734,13,110,68,126,123,194,794,1346,7,10027,557,0,2,103,18,56630,22729,4422,29923,0
86,2211,773,422,505,30,103,129,803,14,77,46,83,91,129,535,839,7,6334,351,0,0,522,0,56640,22730,4423,29924,0
122,2921,77,34,69,0,0,8,77,3,24,16,29,27,45,114,213,1,387,21,0,2,148,399,56640,22730,4423,29925,0
122,2921,712,438,573,51,9,84,763,14,102,71,128,116,199,733,1364,8,11988,666,0,2,148,399,56650,22731,4423,29926,0
24,600,2,2,2,0,0,0,2,0,0,0,0,0,0,0,0,0,0,0,0,0,157,0,56650,22731,4423,29926,0
24,600,99,48,90,1,3,5,100,0,0,0,0,0,0,0,0,0,0,0,0,0,157,0,56650,22732,4423,29927,0
24,600,8,5,5,2,0,1,10,0,0,0,0,0,0,0,0,0,0,0,0,0,157,0,56650,22732,4423,29928,0
24,600,1217,716,841,84,126,174,1301,14,185,118,215,199,333,1446,2542,8,20687,1149,0,0,157,0,56660,22734,4423,29929,0
24,600,160,89,115,0,13,31,160,7,15,11,17,22,28,78,124,3,495,27,0,0,157,0,56660,22734,4423,29930,0
24,600,10,10,9,9,0,0,19,0,0,0,0,0,0,0,0,0,0,0,0,0,157,0,56660,22734,4424,29931,0
24,600,173,84,99,8,29,36,181,5,12,7,13,17,20,54,81,2,221,12,0,0,157,0,56660,22735,4424,29932,0
24,600,3,1,1,3,0,0,6,0,0,0,0,0,0,0,0,0,0,0,0,0,157,0,56660,22735,4424,29933,0
32,665,125,97,103,3,0,19,128,9,25,17,27,34,44,144,223,4,1087,60,0,0,118,0,56660,22735,4425,29934,0
24,380,102,57,55,5,16,25,107,5,17,10,18,22,28,81,124,2,330,18,0,0,97,0,56660,22735,4425,29935,0
79,1722,402,202,227,24,74,80,426,12,52,33,61,64,94,339,564,7,3969,220,0,3,222,256,56660,22736,4425,29936,0
48,992,447,308,343,6,5,95,453,7,96,59,111,103,170,651,1136,4,4600,255,0,2,34,10,56660,22739,4425,29937,0
48,992,322,174,179,16,74,51,338,10,41,26,46,51,72,252,408,5,2291,127,0,2,34,10,56660,22742,4426,29938,0
75,1595,53,23,39,0,0,13,53,2,8,4,8,10,12,26,39,1,39,2,0,0,392,0,56660,22742,4426,29939,0
75,1595,515,298,307,33,80,99,548,12,63,44,77,75,121,419,753,7,5527,307,0,0,392,0,56670,22742,4426,29940,0
23,382,424,94,331,4,0,89,428,1,5,5,5,6,10,11,25,0,12,0,0,2,4,4,56670,22743,4426,29941,0
23,382,38,23,23,6,0,8,44,3,11,7,11,14,18,42,68,1,102,5,0,2,4,4,56670,22743,4426,29942,0
20,509,205,80,86,16,53,53,221,7,18,10,19,25,29,94,134,3,497,27,0,0,147,0,56680,22743,4427,29943,0
17,518,184,100,137,2,15,30,186,6,38,20,39,44,59,214,322,3,991,55,0,2,6,6,56680,22744,4427,29944,0
17,518,103,65,74,8,5,16,111,7,17,9,17,24,26,89,119,3,417,23,0,2,6,6,56680,22745,4427,29945,0
223,5307,722,423,573,19,0,135,741,12,172,101,199,184,300,1320,2257,6,15668,870,0,2,384,311,56680,22747,4427,29947,0
223,5307,1508,847,911,44,250,301,1552,14,148,88,169,162,257,1120,1886,7,15077,837,0,2,384,311,56680,22748,4428,29948,0
263,6260,72,33,56,0,4,12,72,1,1,1,1,2,2,0,2,0,1,0,0,2,233,160,56680,22748,4428,29949,0
263,6260,1454,835,1044,76,110,219,1530,17,275,158,296,292,454,2297,3718,9,34017,1889,1,2,233,160,56690,22749,4428,29950,0
78,1591,757,253,292,73,244,162,830,13,61,38,67,74,105,409,651,7,4654,258,0,2,377,153,56690,22750,4428,29951,0
46,954,386,256,301,16,9,68,402,4,59,35,69,63,104,355,621,2,1453,80,0,2,45,16,56690,22750,4428,29952,0
46,954,264,131,164,11,41,46,275,6,38,22,40,44,62,214,338,3,1068,59,0,2,45,16,56700,22750,4429,29953,0
30,649,215,129,180,6,0,29,221,8,65,43,72,73,115,415,711,4,3153,175,0,2,9,4,56700,22750,4429,29954,0
30,649,97,69,77,3,3,16,100,6,22,13,23,28,36,113,173,3,542,30,0,2,9,4,56700,22751,4429,29955,0
113,2530,1043,504,840,53,9,147,1096,9,180,112,198,189,310,1377,2344,4,11604,644,0,2,88,147,56700,22753,4429,29956,0
113,2530,383,288,292,26,6,62,409,11,65,38,67,76,105,429,656,5,3719,206,0,2,88,147,56700,22754,4429,29957,0
20,408,294,64,250,0,0,43,294,1,20,10,20,21,30,86,131,0,65,3,0,2,2,2,56700,22754,4429,29958,0
20,408,78,46,62,3,0,14,81,3,8,4,8,11,12,28,41,1,62,3,0,2,2,2,56700,22755,4429,29959,0
71,1380,1178,367,1042,6,15,115,1184,9,94,51,95,103,146,644,976,4,4439,246,0,2,91,186,56700,22755,4429,29960,0
71,1380,177,108,140,8,0,27,185,6,30,16,32,36,48,162,248,3,794,44,0,2,91,186,56700,22757,4429,29961,0
209,4527,1943,715,1694,26,18,214,1969,12,185,120,237,197,357,1436,2721,7,20915,1161,0,2,209,88,56700,22759,4429,29962,0
209,4527,1168,838,957,57,25,144,1225,19,348,224,416,367,640,3018,5452,11,61921,3440,1,2,209,88,56710,22761,4429,29963,0
16,480,442,244,305,14,16,103,456,11,68,45,75,79,120,452,756,6,4588,254,0,2,5,3,56710,22763,4429,29964,0
16,480,182,102,99,11,40,35,193,3,11,6,11,14,17,42,64,1,97,5,0,2,5,3,56710,22764,4429,29965,0
62,1222,1098,241,925,5,10,155,1103,7,46,25,49,53,74,273,423,3,1580,87,0,2,10,12,56720,22766,4429,29966,0
62,1222,282,202,222,14,2,44,296,8,42,24,43,50,67,250,378,4,1548,86,0,2,10,12,56720,22767,4429,29967,0
23,458,601,196,481,2,23,85,603,8,63,36,72,71,108,400,664,4,3036,168,0,2,13,5,56730,22771,4430,29975,0
23,458,156,79,106,5,16,28,161,5,14,8,15,19,23,64,97,2,261,14,0,2,13,5,56730,22771,4430,29976,0
1,301,382,65,130,157,2,92,539,4,10,5,10,14,15,41,57,2,114,6,0,2,6,5,56730,22772,4431,29977,0
60,1088,282,196,195,3,0,86,285,8,130,71,141,138,212,936,1507,4,6538,363,0,2,4,2,56730,22772,4432,29978,0
7,299,72,33,56,0,4,12,72,1,1,1,1,2,2,0,2,0,1,0,0,2,1,1,56750,22780,4434,29993,0
17,384,85,59,61,8,0,16,93,5,18,10,18,23,28,86,126,2,316,17,0,2,0,1,56750,22780,4434,29994,0
15,472,42,7,35,4,0,5,46,1,2,1,2,3,3,2,4,0,2,0,0,2,47,15,56750,22780,4434,29995,0
15,472,11,6,10,0,0,1,11,2,4,2,4,6,6,10,15,1,15,0,0,2,47,15,56750,22780,4434,29996,0
91,3852,1289,550,1043,56,32,155,1345,10,167,93,185,177,278,1266,2075,5,11498,638,0,2,191,38,56760,22786,4436,30004,0
36,1085,182,127,129,0,0,53,182,5,39,21,42,44,63,217,343,2,926,51,0,2,40,6,56760,22786,4437,30005,0
147,6905,1392,870,1177,35,17,170,1427,14,494,280,531,508,811,4473,7289,7,54850,3047,2,2,121,72,56760,22789,4438,30006,0
87,2871,773,419,590,28,0,166,801,10,204,113,217,214,330,1598,2554,5,13587,754,0,2,68,49,56760,22789,4439,30007,0
15,742,75,38,59,1,3,12,76,2,4,2,4,6,6,10,15,1,15,0,0,2,128,2,56760,22789,4439,30008,0
2,26,6,4,4,0,0,2,6,1,4,2,4,5,6,8,13,0,6,0,0,2,2,1,56760,22789,4439,30010,0
13,572,139,89,101,2,0,35,141,7,54,34,62,61,96,330,569,4,2287,127,0,0,122,0,56760,22789,4439,30012,0
1,135,149,67,118,4,0,27,153,1,17,14,28,18,42,69,175,0,144,8,0,0,29,0,56760,22789,4439,30013,0
31,1981,1157,318,931,29,22,177,1186,6,104,63,125,110,188,712,1274,3,4596,255,0,0,777,0,56760,22789,4439,30014,0
54,3601,520,294,400,33,13,81,553,10,261,204,367,271,571,2128,4614,7,32445,1802,1,2,212,109,56760,22790,4439,30015,0
97,4416,1338,495,1086,10,64,173,1348,11,122,82,157,133,239,883,1686,7,11934,663,0,2,60,30,56760,22792,4439,30016,0
172,7584,139,89,101,2,0,35,141,7,54,34,62,61,96,330,569,4,2287,127,0,2,656,253,56760,22792,4439,30017,0
172,7584,7,5,5,0,0,2,7,1,2,1,2,3,3,2,4,0,2,0,0,2,656,253,56760,22792,4439,30018,0
33,991,465,148,393,5,8,60,470,4,31,20,31,35,51,161,261,2,523,29,0,2,31,7,56760,22793,4439,30019,0
33,991,16,12,9,0,0,6,16,1,2,1,2,3,3,2,4,0,2,0,0,2,31,7,56760,22793,4439,30020,0
138,5861,1782,648,1425,9,47,279,1791,8,171,97,189,179,286,1292,2140,4,9462,525,0,2,158,78,56760,22794,4440,30021,0
25,685,256,139,192,9,7,47,265,4,23,12,24,27,36,112,171,2,357,19,0,2,33,1,56760,22795,4440,30022,0
6,329,180,34,164,0,0,16,180,1,12,6,12,13,18,43,66,0,33,1,0,2,21,0,56760,22795,4440,30023,0
23,577,102,59,69,5,3,24,107,6,22,15,28,28,43,113,206,3,789,43,0,2,26,18,56760,22795,4440,30024,0
110,4156,1450,624,1228,12,26,181,1462,14,306,186,354,320,540,2580,4493,8,36391,2021,1,2,68,33,56760,22797,4441,30025,0
155,4419,1660,832,1314,41,38,274,1701,20,312,209,395,332,604,2671,5058,12,64042,3557,1,2,78,43,56760,22799,4442,30027,0
36,2884,996,429,845,24,10,117,1020,7,76,50,88,83,138,494,879,4,3565,198,0,0,744,0,56760,22801,4442,30028,0
129,5207,1513,682,1277,25,13,200,1538,11,199,116,219,210,335,1557,2584,6,15641,868,0,2,218,57,56760,22803,4442,30029,0
73,3804,1296,573,1062,40,33,157,1336,8,201,118,231,209,349,1561,2689,4,12365,686,0,2,108,29,56760,22803,4442,30030,0
14,341,207,111,150,11,0,50,218,5,26,19,36,31,55,133,272,3,943,52,0,2,26,1,56760,22803,4442,30031,0
84,4429,1457,730,1242,11,6,188,1468,10,292,166,329,302,495,2424,4078,5,22973,1276,1,2,129,55,56760,22805,4442,30032,0
39,2324,652,304,544,16,6,88,668,6,89,51,101,95,152,591,998,3,3399,188,0,2,67,56,56760,22806,4442,30033,0
69,3184,1455,414,1257,16,76,112,1471,5,41,23,46,46,69,231,381,2,1069,59,0,2,102,13,56760,22807,4442,30034,0
8,273,74,35,59,1,0,14,75,3,14,7,14,17,21,58,85,1,128,7,0,2,8,1,56760,22808,4442,30035,0
94,4591,1523,757,1297,19,12,193,1542,12,193,117,230,205,347,1508,2664,7,19053,1058,0,2,52,16,56770,22810,4442,30036,0
84,3593,1020,354,843,12,15,144,1032,8,134,77,144,142,221,970,1580,4,6792,377,0,2,169,36,56770,22810,4442,30037,0
38,1676,447,308,343,6,5,95,453,7,96,59,111,103,170,651,1136,4,4600,255,0,2,14,1,56770,22813,4442,30038,0
1,106,53,23,39,0,0,13,53,2,8,4,8,10,12,26,39,1,39,2,0,0,18,0,56770,22813,4442,30039,0
21,661,424,94,331,4,0,89,428,1,5,5,5,6,10,11,25,0,12,0,0,2,45,35,56770,22814,4442,30040,0
38,2301,334,251,279,10,4,40,344,5,127,74,143,132,217,899,1528,2,4303,239,0,2,17,19,56770,22815,4442,30041,0
12,492,184,100,137,2,15,30,186,6,38,20,39,44,59,214,322,3,991,55,0,2,3,4,56770,22816,4442,30042,0
58,2553,1293,570,1093,25,15,163,1318,10,195,123,241,205,364,1516,2795,6,17273,959,0,2,227,15,56780,22818,4442,30043,0
33,1886,384,251,317,7,8,52,391,11,70,44,84,81,128,467,811,6,5355,297,0,2,42,50,56780,22818,4442,30044,0
45,2208,722,423,573,19,0,135,741,12,172,101,199,184,300,1320,2257,6,15668,870,0,2,254,10,56780,22820,4442,30046,0
39,1724,386,256,301,16,9,68,402,4,59,35,69,63,104,355,621,2,1453,80,0,2,48,50,56780,22820,4442,30047,0
16,1213,215,129,180,6,0,29,221,8,65,43,72,73,115,415,711,4,3153,175,0,2,12,12,56780,22820,4442,30048,0
78,3015,1043,504,840,53,9,147,1096,9,180,112,198,189,310,1377,2344,4,11604,644,0,2,127,58,56780,22822,4442,30049,0
14,529,295,56,236,0,4,54,295,2,9,5,10,11,15,30,51,1,57,3,0,2,17,5,56780,22824,4442,30050,0
30,1233,373,158,315,8,0,51,381,5,76,44,79,81,123,486,779,2,2026,112,0,2,74,22,56780,22824,4442,30051,0
77,3237,1178,367,1042,6,15,115,1184,9,94,51,95,103,146,644,976,4,4439,246,0,2,126,14,56780,22824,4442,30052,0
91,4606,1943,715,1694,26,18,214,1969,12,185,120,237,197,357,1436,2721,7,20915,1161,0,2,321,48,56780,22826,4442,30053,0
14,825,442,244,305,14,16,103,456,11,68,45,75,79,120,452,756,6,4588,254,0,2,5,0,56780,22828,4442,30054,0
48,1750,1098,241,925,5,10,155,1103,7,46,25,49,53,74,273,423,3,1580,87,0,2,95,80,56790,22830,4442,30055,0
19,679,601,196,481,2,23,85,603,8,63,36,72,71,108,400,664,4,3036,168,0,2,72,4,56790,22830,4442,30056,0
238,5391,4293,999,3693,19,54,507,4312,9,155,88,170,164,258,1156,1898,4,9368,520,0,2,5,0,56790,22832,4442,30057,0
238,5391,1482,859,1002,125,135,219,1607,16,219,134,251,235,385,1766,3032,9,27804,1544,1,2,5,0,56800,22833,4442,30058,0
172,7584,139,89,101,2,0,35,141,7,54,34,62,61,96,330,569,4,2287,127,0,2,8,0,56800,22833,4442,30059,0
172,7584,7,5,5,0,0,2,7,1,2,1,2,3,3,2,4,0,2,0,0,2,8,0,56800,22833,4442,30060,0
172,7751,139,89,101,2,0,35,141,7,54,34,62,61,96,330,569,4,2287,127,0,2,47,5,56800,22833,4442,30061,1
172,7751,7,5,5,0,0,2,7,1,2,1,2,3,3,2,4,0,2,0,0,2,47,5,56800,22833,4442,30062,1
245,5510,4293,999,3693,19,54,507,4312,9,155,88,170,164,258,1156,1898,4,9368,520,0,2,5,0,56800,22835,4442,30063,0
245,5510,1482,859,1002,125,135,219,1607,16,219,134,251,235,385,1766,3032,9,27804,1544,1,2,5,0,56810,22836,4442,30064,0
174,7780,139,89,101,2,0,35,141,7,54,34,62,61,96,330,569,4,2287,127,0,2,8,0,56810,22836,4442,30065,0
174,7780,7,5,5,0,0,2,7,1,2,1,2,3,3,2,4,0,2,0,0,2,8,0,56810,22836,4442,30066,0
58,1174,207,111,150,11,0,50,218,5,26,19,36,31,55,133,272,3,943,52,0,2,8,0,56810,22836,4442,30067,0
58,1174,410,198,237,31,55,97,441,11,63,38,72,74,110,414,683,6,4293,238,0,2,8,0,56820,22837,4443,30068,0
27,951,74,35,59,1,0,14,75,3,14,7,14,17,21,58,85,1,128,7,0,2,2,1,56820,22838,4443,30069,0
27,951,245,125,200,5,7,34,250,7,30,17,34,37,51,166,265,3,1053,58,0,2,2,1,56830,22839,4443,30070,0
86,2211,773,422,505,30,103,129,803,14,77,46,83,91,129,535,839,7,6334,351,0,2,3,3,56840,22840,4444,30071,0
122,2921,77,34,69,0,0,8,77,3,24,16,29,27,45,114,213,1,387,21,0,2,1,1,56840,22840,4444,30072,0
122,2921,712,438,573,51,9,84,763,14,102,71,128,116,199,733,1364,8,11988,666,0,2,1,1,56850,22841,4444,30073,0
263,6293,72,33,56,0,4,12,72,1,1,1,1,2,2,0,2,0,1,0,0,2,13,8,56850,22841,4444,30074,0
263,6293,1454,835,1044,76,110,219,1530,17,275,158,296,292,454,2297,3718,9,34017,1889,1,2,13,8,56860,22842,4444,30075,0
113,2553,1043,504,840,53,9,147,1096,9,180,112,198,189,310,1377,2344,4,11604,644,0,2,2,1,56860,22844,4444,30076,0
113,2553,383,288,292,26,6,62,409,11,65,38,67,76,105,429,656,5,3719,206,0,2,2,1,56860,22845,4444,30077,0
15,485,42,7,35,4,0,5,46,1,2,1,2,3,3,2,4,0,2,0,0,2,4,0,56860,22845,4444,30078,0
15,485,11,6,10,0,0,1,11,2,4,2,4,6,6,10,15,1,15,0,0,2,4,0,56860,22845,4444,30079,0
92,3882,1289,550,1043,56,32,155,1345,10,167,93,185,177,278,1266,2075,5,11498,638,0,2,30,0,56860,22847,4445,30080,0
139,5894,1782,648,1425,9,47,279,1791,8,171,97,189,179,286,1292,2140,4,9462,525,0,2,13,0,56860,22848,4446,30081,0
79,3054,1043,504,840,53,9,147,1096,9,180,112,198,189,310,1377,2344,4,11604,644,0,2,14,5,56860,22850,4446,30082,0
58,1174,207,111,150,11,0,50,218,5,26,19,36,31,55,133,272,3,943,52,0,2,8,0,56860,22850,4446,30083,0
58,1174,410,198,237,31,55,97,441,11,63,38,72,74,110,414,683,6,4293,238,0,2,8,0,56870,22851,4447,30084,0
27,951,74,35,59,1,0,14,75,3,14,7,14,17,21,58,85,1,128,7,0,2,2,1,56870,22852,4447,30085,0
27,951,245,125,200,5,7,34,250,7,30,17,34,37,51,166,265,3,1053,58,0,2,2,1,56880,22853,4447,30086,0
86,2211,773,422,505,30,103,129,803,14,77,46,83,91,129,535,839,7,6334,351,0,2,3,3,56890,22854,4448,30087,0
122,2921,77,34,69,0,0,8,77,3,24,16,29,27,45,114,213,1,387,21,0,2,1,1,56890,22854,4448,30088,0
122,2921,712,438,573,51,9,84,763,14,102,71,128,116,199,733,1364,8,11988,666,0,2,1,1,56900,22855,4448,30089,0
263,6293,72,33,56,0,4,12,72,1,1,1,1,2,2,0,2,0,1,0,0,2,13,8,56900,22855,4448,30090,0
263,6293,1454,835,1044,76,110,219,1530,17,275,158,296,292,454,2297,3718,9,34017,1889,1,2,13,8,56910,22856,4448,30091,0
113,2553,1043,504,840,53,9,147,1096,9,180,112,198,189,310,1377,2344,4,11604,644,0,2,2,1,56910,22858,4448,30092,0
113,2553,383,288,292,26,6,62,409,11,65,38,67,76,105,429,656,5,3719,206,0,2,2,1,56910,22859,4448,30093,0
15,485,42,7,35,4,0,5,46,1,2,1,2,3,3,2,4,0,2,0,0,2,4,0,56910,22859,4448,30094,0
15,485,11,6,10,0,0,1,11,2,4,2,4,6,6,10,15,1,15,0,0,2,4,0,56910,22859,4448,30095,0
92,3882,1289,550,1043,56,32,155,1345,10,167,93,185,177,278,1266,2075,5,11498,638,0,2,30,0,56910,22861,4449,30096,0
139,5894,1782,648,1425,9,47,279,1791,8,171,97,189,179,286,1292,2140,4,9462,525,0,2,13,0,56910,22862,4450,30097,0
79,3054,1043,504,840,53,9,147,1096,9,180,112,198,189,310,1377,2344,4,11604,644,0,2,14,5,56910,22864,4450,30098,0
245,5514,4293,999,3693,19,54,507,4312,9,155,88,170,164,258,1156,1898,4,9368,520,0,2,1,1,56910,22866,4450,30099,0
245,5514,1482,859,1002,125,135,219,1607,16,219,134,251,235,385,1766,3032,9,27804,1544,1,2,1,1,56920,22867,4450,30100,0
58,1174,207,111,150,11,0,50,218,5,26,19,36,31,55,133,272,3,943,52,0,2,8,0,56920,22867,4450,30101,0
58,1174,410,198,237,31,55,97,441,11,63,38,72,74,110,414,683,6,4293,238,0,2,8,0,56930,22868,4451,30102,0
27,951,74,35,59,1,0,14,75,3,14,7,14,17,21,58,85,1,128,7,0,2,2,1,56930,22869,4451,30103,0
27,951,245,125,200,5,7,34,250,7,30,17,34,37,51,166,265,3,1053,58,0,2,2,1,56940,22870,4451,30104,0
86,2211,773,422,505,30,103,129,803,14,77,46,83,91,129,535,839,7,6334,351,0,2,3,3,56950,22871,4452,30105,0
140,3230,77,34,69,0,0,8,77,3,24,16,29,27,45,114,213,1,387,21,0,2,1,1,56950,22871,4452,30106,0
140,3230,712,438,573,51,9,84,763,14,102,71,128,116,199,733,1364,8,11988,666,0,2,1,1,56960,22872,4452,30107,0
288,6784,72,33,56,0,4,12,72,1,1,1,1,2,2,0,2,0,1,0,0,2,13,8,56960,22872,4452,30108,0
288,6784,1454,835,1044,76,110,219,1530,17,275,158,296,292,454,2297,3718,9,34017,1889,1,2,13,8,56970,22873,4452,30109,0
113,2553,1043,504,840,53,9,147,1096,9,180,112,198,189,310,1377,2344,4,11604,644,0,2,2,1,56970,22875,4452,30110,0
113,2553,383,288,292,26,6,62,409,11,65,38,67,76,105,429,656,5,3719,206,0,2,2,1,56970,22876,4452,30111,0
15,485,42,7,35,4,0,5,46,1,2,1,2,3,3,2,4,0,2,0,0,2,4,0,56970,22876,4452,30112,0
15,485,11,6,10,0,0,1,11,2,4,2,4,6,6,10,15,1,15,0,0,2,4,0,56970,22876,4452,30113,0
92,3882,1289,550,1043,56,32,155,1345,10,167,93,185,177,278,1266,2075,5,11498,638,0,2,30,0,56970,22878,4453,30114,0
139,5894,1782,648,1425,9,47,279,1791,8,171,97,189,179,286,1292,2140,4,9462,525,0,2,13,0,56970,22879,4454,30115,0
79,3054,1043,504,840,53,9,147,1096,9,180,112,198,189,310,1377,2344,4,11604,644,0,2,14,5,56970,22881,4454,30116,0
288,6780,72,33,56,0,4,12,72,1,1,1,1,2,2,0,2,0,1,0,0,2,1,1,56970,22881,4454,30117,0
288,6780,1454,835,1044,76,110,219,1530,17,275,158,296,292,454,2297,3718,9,34017,1889,1,2,1,1,56980,22882,4454,30118,0
245,5516,4293,999,3693,19,54,507,4312,9,155,88,170,164,258,1156,1898,4,9368,520,0,2,2,1,56980,22884,4454,30119,0
245,5516,1482,859,1002,125,135,219,1607,16,219,134,251,235,385,1766,3032,9,27804,1544,1,2,2,1,56990,22885,4454,30120,0
76,1597,53,23,39,0,0,13,53,2,8,4,8,10,12,26,39,1,39,2,0,2,0,1,56990,22885,4454,30121,0
76,1597,515,298,307,33,80,99,548,12,63,44,77,75,121,419,753,7,5527,307,0,2,0,1,57000,22885,4454,30122,0
28,807,339,213,244,17,9,65,356,10,42,26,48,52,74,259,421,5,2410,133,0,2,1,1,57010,22885,4454,30123,1
114,2580,1043,504,840,53,9,147,1096,9,180,112,198,189,310,1377,2344,4,11604,644,0,2,8,4,57010,22887,4454,30124,1
114,2580,383,288,292,26,6,62,409,11,65,38,67,76,105,429,656,5,3719,206,0,2,8,4,57010,22888,4454,30125,1
59,2584,1293,570,1093,25,15,163,1318,10,195,123,241,205,364,1516,2795,6,17273,959,0,2,9,0,57020,22890,4454,30126,1
59,2582,1293,570,1093,25,15,163,1318,10,195,123,241,205,364,1516,2795,6,17273,959,0,2,0,1,57030,22892,4454,30127,0
22,351,102,57,55,5,16,25,107,5,17,10,18,22,28,81,124,2,330,18,0,2,3,8,57030,22892,4454,30128,0
84,3593,1020,354,843,12,15,144,1032,8,134,77,144,142,221,970,1580,4,6792,377,0,2,1,1,57030,22892,4454,30129,0
28,807,339,213,244,17,9,65,356,10,42,26,48,52,74,259,421,5,2410,133,0,2,1,1,57040,22892,4454,30130,0
114,2580,1043,504,840,53,9,147,1096,9,180,112,198,189,310,1377,2344,4,11604,644,0,2,8,4,57040,22894,4454,30131,0
114,2580,383,288,292,26,6,62,409,11,65,38,67,76,105,429,656,5,3719,206,0,2,8,4,57040,22895,4454,30132,0
59,2582,1293,570,1093,25,15,163,1318,10,195,123,241,205,364,1516,2795,6,17273,959,0,2,8,0,57050,22897,4454,30133,0
85,3690,1020,354,843,12,15,144,1032,8,134,77,144,142,221,970,1580,4,6792,377,0,2,32,0,57050,22897,4454,30134,0
22,351,102,57,55,5,16,25,107,5,17,10,18,22,28,81,124,2,330,18,0,2,3,8,57050,22897,4454,30135,0
85,3690,1020,354,843,12,15,144,1032,8,134,77,144,142,221,970,1580,4,6792,377,0,2,33,1,57050,22897,4454,30136,0
89,1841,477,336,357,30,23,73,507,16,194,134,250,210,384,1538,2962,10,30538,1696,0,2,18,2,57060,22898,4454,30137,1
111,4196,1450,624,1228,12,26,181,1462,14,306,186,354,320,540,2580,4493,8,36391,2021,1,2,12,0,57060,22900,4455,30138,1
89,1841,477,336,357,30,23,73,507,16,194,134,250,210,384,1538,2962,10,30538,1696,0,2,4,4,57070,22901,4455,30139,0
89,1841,477,336,357,30,23,73,507,16,194,134,250,210,384,1538,2962,10,30538,1696,0,2,18,2,57080,22902,4455,30140,0
111,4196,1450,624,1228,12,26,181,1462,14,306,186,354,320,540,2580,4493,8,36391,2021,1,2,12,0,57080,22904,4456,30141,0
170,7554,139,89,101,2,0,35,141,7,54,34,62,61,96,330,569,4,2287,127,0,2,2,1,57080,22904,4456,30142,1
170,7554,7,5,5,0,0,2,7,1,2,1,2,3,3,2,4,0,2,0,0,2,2,1,57080,22904,4456,30143,1
170,7554,139,89,101,2,0,35,141,7,54,34,62,61,96,330,569,4,2287,127,0,2,2,1,57080,22904,4456,30144,0
170,7554,7,5,5,0,0,2,7,1,2,1,2,3,3,2,4,0,2,0,0,2,2,1,57080,22904,4456,30145,0
237,5388,4293,999,3693,19,54,507,4312,9,155,88,170,164,258,1156,1898,4,9368,520,0,2,1,1,57080,22906,4456,30146,0
237,5388,1482,859,1002,125,135,219,1607,16,219,134,251,235,385,1766,3032,9,27804,1544,1,2,1,1,57090,22907,4456,30147,0
30,659,125,97,103,3,0,19,128,9,25,17,27,34,44,144,223,4,1087,60,0,2,1,1,57090,22907,4457,30148,0
76,1643,53,23,39,0,0,13,53,2,8,4,8,10,12,26,39,1,39,2,0,2,17,5,57090,22907,4457,30149,0
76,1643,515,298,307,33,80,99,548,12,63,44,77,75,121,419,753,7,5527,307,0,2,17,5,57100,22907,4457,30150,0
262,6289,72,33,56,0,4,12,72,1,1,1,1,2,2,0,2,0,1,0,0,2,2,3,57100,22907,4457,30151,0
262,6289,1454,835,1044,76,110,219,1530,17,275,158,296,292,454,2297,3718,9,34017,1889,1,2,2,3,57110,22908,4457,30152,0
70,1375,1178,367,1042,6,15,115,1184,9,94,51,95,103,146,644,976,4,4439,246,0,2,1,3,57110,22908,4457,30153,0
70,1375,177,108,140,8,0,27,185,6,30,16,32,36,48,162,248,3,794,44,0,2,1,3,57110,22910,4457,30154,0
22,454,601,196,481,2,23,85,603,8,63,36,72,71,108,400,664,4,3036,168,0,2,3,4,57110,22910,4457,30155,0
22,454,156,79,106,5,16,28,161,5,14,8,15,19,23,64,97,2,261,14,0,2,3,4,57110,22910,4457,30156,0
87,3808,1020,354,843,12,15,144,1032,8,134,77,144,142,221,970,1580,4,6792,377,0,2,30,3,57110,22910,4457,30157,0
84,1807,773,419,590,28,0,166,801,10,204,113,217,214,330,1598,2554,5,13587,754,0,2,1,1,57110,22910,4458,30158,0
84,1807,421,273,302,44,34,57,465,17,81,59,107,98,166,583,1098,11,12329,684,0,2,1,1,57110,22910,4459,30159,0
145,3018,1513,682,1277,25,13,200,1538,11,199,116,219,210,335,1557,2584,6,15641,868,0,2,1,1,57110,22912,4459,30160,0
145,3018,819,519,539,24,98,155,843,15,96,57,106,111,163,690,1107,8,9171,509,0,2,1,1,57120,22914,4459,30161,0
58,1174,207,111,150,11,0,50,218,5,26,19,36,31,55,133,272,3,943,52,0,2,1,1,57120,22914,4459,30162,0
58,1174,410,198,237,31,55,97,441,11,63,38,72,74,110,414,683,6,4293,238,0,2,1,1,57130,22915,4460,30163,0
83,2145,1455,414,1257,16,76,112,1471,5,41,23,46,46,69,231,381,2,1069,59,0,2,1,1,57130,22916,4460,30164,0
83,2145,669,365,481,22,61,110,691,15,103,63,122,118,185,747,1273,8,11311,628,0,2,1,1,57140,22916,4461,30165,0
236,5368,4293,999,3693,19,54,507,4312,9,155,88,170,164,258,1156,1898,4,9368,520,0,2,2,2,57140,22918,4461,30166,0
236,5368,1482,859,1002,125,135,219,1607,16,219,134,251,235,385,1766,3032,9,27804,1544,1,2,2,2,57150,22919,4461,30167,0
122,2921,77,34,69,0,0,8,77,3,24,16,29,27,45,114,213,1,387,21,0,2,2,2,57150,22919,4461,30168,0
122,2921,712,438,573,51,9,84,763,14,102,71,128,116,199,733,1364,8,11988,666,0,2,2,2,57160,22920,4461,30169,0
74,1567,402,202,227,24,74,80,426,12,52,33,61,64,94,339,564,7,3969,220,0,2,2,2,57160,22921,4461,30170,0
20,509,205,80,86,16,53,53,221,7,18,10,19,25,29,94,134,3,497,27,0,2,1,1,57170,22921,4462,30171,0
259,6153,72,33,56,0,4,12,72,1,1,1,1,2,2,0,2,0,1,0,0,2,1,1,57170,22921,4462,30172,0
259,6153,1454,835,1044,76,110,219,1530,17,275,158,296,292,454,2297,3718,9,34017,1889,1,2,1,1,57180,22922,4462,30173,0
147,6905,1392,870,1177,35,17,170,1427,14,494,280,531,508,811,4473,7289,7,54850,3047,2,2,1,1,57180,22925,4463,30174,0
170,7554,139,89,101,2,0,35,141,7,54,34,62,61,96,330,569,4,2287,127,0,2,1,1,57180,22925,4463,30175,0
170,7554,7,5,5,0,0,2,7,1,2,1,2,3,3,2,4,0,2,0,0,2,1,1,57180,22925,4463,30176,0
111,4196,1450,624,1228,12,26,181,1462,14,306,186,354,320,540,2580,4493,8,36391,2021,1,2,1,1,57180,22927,4464,30177,0
129,5207,1513,682,1277,25,13,200,1538,11,199,116,219,210,335,1557,2584,6,15641,868,0,2,1,1,57180,22929,4464,30178,0
39,2324,652,304,544,16,6,88,668,6,89,51,101,95,152,591,998,3,3399,188,0,2,1,1,57180,22930,4464,30179,0
21,661,424,94,331,4,0,89,428,1,5,5,5,6,10,11,25,0,12,0,0,2,1,1,57180,22931,4464,30180,0
6,136,44,22,19,0,19,6,44,2,10,6,12,12,18,35,64,1,77,4,0,2,1,1,57180,22931,4464,30181,0
223,5307,722,423,573,19,0,135,741,12,172,101,199,184,300,1320,2257,6,15668,870,0,2,2,2,57180,22933,4464,30183,0
223,5307,1508,847,911,44,250,301,1552,14,148,88,169,162,257,1120,1886,7,15077,837,0,2,2,2,57180,22934,4465,30184,0
1,319,382,65,130,157,2,92,539,4,10,5,10,14,15,41,57,2,114,6,0,2,3,1,57180,22935,4466,30185,0
84,1807,773,419,590,28,0,166,801,10,204,113,217,214,330,1598,2554,5,13587,754,0,2,1,1,57180,22935,4467,30186,0
84,1807,421,273,302,44,34,57,465,17,81,59,107,98,166,583,1098,11,12329,684,0,2,1,1,57180,22935,4468,30187,0
145,3018,1513,682,1277,25,13,200,1538,11,199,116,219,210,335,1557,2584,6,15641,868,0,2,1,1,57180,22937,4468,30188,0
145,3018,819,519,539,24,98,155,843,15,96,57,106,111,163,690,1107,8,9171,509,0,2,1,1,57190,22939,4468,30189,0
58,1174,207,111,150,11,0,50,218,5,26,19,36,31,55,133,272,3,943,52,0,2,1,1,57190,22939,4468,30190,0
58,1174,410,198,237,31,55,97,441,11,63,38,72,74,110,414,683,6,4293,238,0,2,1,1,57200,22940,4469,30191,0
83,2145,1455,414,1257,16,76,112,1471,5,41,23,46,46,69,231,381,2,1069,59,0,2,1,1,57200,22941,4469,30192,0
83,2145,669,365,481,22,61,110,691,15,103,63,122,118,185,747,1273,8,11311,628,0,2,1,1,57210,22941,4470,30193,0
236,5368,4293,999,3693,19,54,507,4312,9,155,88,170,164,258,1156,1898,4,9368,520,0,2,2,2,57210,22943,4470,30194,0
236,5368,1482,859,1002,125,135,219,1607,16,219,134,251,235,385,1766,3032,9,27804,1544,1,2,2,2,57220,22944,4470,30195,0
122,2921,77,34,69,0,0,8,77,3,24,16,29,27,45,114,213,1,387,21,0,2,2,2,57220,22944,4470,30196,0
122,2921,712,438,573,51,9,84,763,14,102,71,128,116,199,733,1364,8,11988,666,0,2,2,2,57230,22945,4470,30197,0
74,1567,402,202,227,24,74,80,426,12,52,33,61,64,94,339,564,7,3969,220,0,2,2,2,57230,22946,4470,30198,0
20,509,205,80,86,16,53,53,221,7,18,10,19,25,29,94,134,3,497,27,0,2,1,1,57240,22946,4471,30199,0
259,6153,72,33,56,0,4,12,72,1,1,1,1,2,2,0,2,0,1,0,0,2,1,1,57240,22946,4471,30200,0
259,6153,1454,835,1044,76,110,219,1530,17,275,158,296,292,454,2297,3718,9,34017,1889,1,2,1,1,57250,22947,4471,30201,0
147,6905,1392,870,1177,35,17,170,1427,14,494,280,531,508,811,4473,7289,7,54850,3047,2,2,1,1,57250,22950,4472,30202,0
170,7554,139,89,101,2,0,35,141,7,54,34,62,61,96,330,569,4,2287,127,0,2,1,1,57250,22950,4472,30203,0
170,7554,7,5,5,0,0,2,7,1,2,1,2,3,3,2,4,0,2,0,0,2,1,1,57250,22950,4472,30204,0
111,4196,1450,624,1228,12,26,181,1462,14,306,186,354,320,540,2580,4493,8,36391,2021,1,2,1,1,57250,22952,4473,30205,0
129,5207,1513,682,1277,25,13,200,1538,11,199,116,219,210,335,1557,2584,6,15641,868,0,2,1,1,57250,22954,4473,30206,0
39,2324,652,304,544,16,6,88,668,6,89,51,101,95,152,591,998,3,3399,188,0,2,1,1,57250,22955,4473,30207,0
21,661,424,94,331,4,0,89,428,1,5,5,5,6,10,11,25,0,12,0,0,2,1,1,57250,22956,4473,30208,0
6,136,44,22,19,0,19,6,44,2,10,6,12,12,18,35,64,1,77,4,0,2,1,1,57250,22956,4473,30209,0
223,5307,722,423,573,19,0,135,741,12,172,101,199,184,300,1320,2257,6,15668,870,0,2,2,2,57250,22958,4473,30211,0
223,5307,1508,847,911,44,250,301,1552,14,148,88,169,162,257,1120,1886,7,15077,837,0,2,2,2,57250,22959,4474,30212,0
76,1643,53,23,39,0,0,13,53,2,8,4,8,10,12,26,39,1,39,2,0,2,8,4,57250,22959,4474,30214,0
76,1643,515,298,307,33,80,99,548,12,63,44,77,75,121,419,753,7,5527,307,0,2,8,4,57260,22959,4474,30215,0
139,5880,1782,648,1425,9,47,279,1791,8,171,97,189,179,286,1292,2140,4,9462,525,0,2,1,0,57260,22960,4475,30216,0
1,319,382,65,130,157,2,92,539,4,10,5,10,14,15,41,57,2,114,6,0,2,3,1,57260,22961,4476,30217,0
139,5880,1782,648,1425,9,47,279,1791,8,171,97,189,179,286,1292,2140,4,9462,525,0,2,1,0,57260,22962,4477,30218,0
356,7105,1457,730,1242,11,6,188,1468,10,292,166,329,302,495,2424,4078,5,22973,1276,1,2,6,1,57260,22964,4477,30219,0
356,7105,74,35,59,1,0,14,75,3,14,7,14,17,21,58,85,1,128,7,0,2,6,1,57260,22965,4477,30220,0
356,7105,245,125,200,5,7,34,250,7,30,17,34,37,51,166,265,3,1053,58,0,2,6,1,57270,22966,4477,30221,0
84,1807,773,419,590,28,0,166,801,10,204,113,217,214,330,1598,2554,5,13587,754,0,2,1,1,57270,22966,4478,30222,0
84,1807,421,273,302,44,34,57,465,17,81,59,107,98,166,583,1098,11,12329,684,0,2,1,1,57270,22966,4479,30223,0
89,1841,477,336,357,30,23,73,507,16,194,134,250,210,384,1538,2962,10,30538,1696,0,2,18,2,57280,22967,4479,30224,0
145,3018,1513,682,1277,25,13,200,1538,11,199,116,219,210,335,1557,2584,6,15641,868,0,2,1,1,57280,22969,4479,30225,0
145,3018,819,519,539,24,98,155,843,15,96,57,106,111,163,690,1107,8,9171,509,0,2,1,1,57290,22971,4479,30226,0
58,1174,207,111,150,11,0,50,218,5,26,19,36,31,55,133,272,3,943,52,0,2,1,1,57290,22971,4479,30227,0
58,1174,410,198,237,31,55,97,441,11,63,38,72,74,110,414,683,6,4293,238,0,2,1,1,57300,22972,4480,30228,0
83,2145,1455,414,1257,16,76,112,1471,5,41,23,46,46,69,231,381,2,1069,59,0,2,1,1,57300,22973,4480,30229,0
83,2145,669,365,481,22,61,110,691,15,103,63,122,118,185,747,1273,8,11311,628,0,2,1,1,57310,22973,4481,30230,0
238,5391,4293,999,3693,19,54,507,4312,9,155,88,170,164,258,1156,1898,4,9368,520,0,2,2,2,57310,22975,4481,30231,0
238,5391,1482,859,1002,125,135,219,1607,16,219,134,251,235,385,1766,3032,9,27804,1544,1,2,2,2,57320,22976,4481,30232,0
6,136,44,22,19,0,19,6,44,2,10,6,12,12,18,35,64,1,77,4,0,2,1,1,57320,22976,4481,30233,0
122,2921,77,34,69,0,0,8,77,3,24,16,29,27,45,114,213,1,387,21,0,2,2,2,57320,22976,4481,30234,0
122,2921,712,438,573,51,9,84,763,14,102,71,128,116,199,733,1364,8,11988,666,0,2,2,2,57330,22977,4481,30235,0
79,1722,402,202,227,24,74,80,426,12,52,33,61,64,94,339,564,7,3969,220,0,2,2,2,57330,22978,4481,30236,0
20,509,205,80,86,16,53,53,221,7,18,10,19,25,29,94,134,3,497,27,0,2,1,1,57340,22978,4482,30237,0
223,5307,722,423,573,19,0,135,741,12,172,101,199,184,300,1320,2257,6,15668,870,0,2,2,2,57340,22980,4482,30239,0
223,5307,1508,847,911,44,250,301,1552,14,148,88,169,162,257,1120,1886,7,15077,837,0,2,2,2,57340,22981,4483,30240,0
263,6293,72,33,56,0,4,12,72,1,1,1,1,2,2,0,2,0,1,0,0,2,1,1,57340,22981,4483,30241,0
263,6293,1454,835,1044,76,110,219,1530,17,275,158,296,292,454,2297,3718,9,34017,1889,1,2,1,1,57350,22982,4483,30242,0
1,319,382,65,130,157,2,92,539,4,10,5,10,14,15,41,57,2,114,6,0,2,3,1,57350,22983,4484,30243,0
147,6905,1392,870,1177,35,17,170,1427,14,494,280,531,508,811,4473,7289,7,54850,3047,2,2,1,1,57350,22986,4485,30244,0
172,7584,139,89,101,2,0,35,141,7,54,34,62,61,96,330,569,4,2287,127,0,2,3,2,57350,22986,4485,30245,0
172,7584,7,5,5,0,0,2,7,1,2,1,2,3,3,2,4,0,2,0,0,2,3,2,57350,22986,4485,30246,0
139,5905,1782,648,1425,9,47,279,1791,8,171,97,189,179,286,1292,2140,4,9462,525,0,2,1,0,57350,22987,4486,30247,0
111,4196,1450,624,1228,12,26,181,1462,14,306,186,354,320,540,2580,4493,8,36391,2021,1,2,13,1,57350,22989,4487,30248,0
129,5207,1513,682,1277,25,13,200,1538,11,199,116,219,210,335,1557,2584,6,15641,868,0,2,1,1,57350,22991,4487,30249,0
39,2324,652,304,544,16,6,88,668,6,89,51,101,95,152,591,998,3,3399,188,0,2,1,1,57350,22992,4487,30250,0
21,661,424,94,331,4,0,89,428,1,5,5,5,6,10,11,25,0,12,0,0,2,1,1,57350,22993,4487,30251,0
84,1807,773,419,590,28,0,166,801,10,204,113,217,214,330,1598,2554,5,13587,754,0,2,1,1,57350,22993,4488,30252,0
84,1807,421,273,302,44,34,57,465,17,81,59,107,98,166,583,1098,11,12329,684,0,2,1,1,57350,22993,4489,30253,0
89,1841,477,336,357,30,23,73,507,16,194,134,250,210,384,1538,2962,10,30538,1696,0,2,18,2,57360,22994,4489,30254,0
145,3018,1513,682,1277,25,13,200,1538,11,199,116,219,210,335,1557,2584,6,15641,868,0,2,1,1,57360,22996,4489,30255,0
145,3018,819,519,539,24,98,155,843,15,96,57,106,111,163,690,1107,8,9171,509,0,2,1,1,57370,22998,4489,30256,0
58,1174,207,111,150,11,0,50,218,5,26,19,36,31,55,133,272,3,943,52,0,2,1,1,57370,22998,4489,30257,0
58,1174,410,198,237,31,55,97,441,11,63,38,72,74,110,414,683,6,4293,238,0,2,1,1,57380,22999,4490,30258,0
83,2145,1455,414,1257,16,76,112,1471,5,41,23,46,46,69,231,381,2,1069,59,0,2,1,1,57380,23000,4490,30259,0
83,2145,669,365,481,22,61,110,691,15,103,63,122,118,185,747,1273,8,11311,628,0,2,1,1,57390,23000,4491,30260,0
238,5391,4293,999,3693,19,54,507,4312,9,155,88,170,164,258,1156,1898,4,9368,520,0,2,2,2,57390,23002,4491,30261,0
238,5391,1482,859,1002,125,135,219,1607,16,219,134,251,235,385,1766,3032,9,27804,1544,1,2,2,2,57400,23003,4491,30262,0
6,136,44,22,19,0,19,6,44,2,10,6,12,12,18,35,64,1,77,4,0,2,1,1,57400,23003,4491,30263,0
122,2921,77,34,69,0,0,8,77,3,24,16,29,27,45,114,213,1,387,21,0,2,2,2,57400,23003,4491,30264,0
122,2921,712,438,573,51,9,84,763,14,102,71,128,116,199,733,1364,8,11988,666,0,2,2,2,57410,23004,4491,30265,0
79,1722,402,202,227,24,74,80,426,12,52,33,61,64,94,339,564,7,3969,220,0,2,2,2,57410,23005,4491,30266,0
20,509,205,80,86,16,53,53,221,7,18,10,19,25,29,94,134,3,497,27,0,2,1,1,57420,23005,4492,30267,0
223,5307,722,423,573,19,0,135,741,12,172,101,199,184,300,1320,2257,6,15668,870,0,2,2,2,57420,23007,4492,30269,0
223,5307,1508,847,911,44,250,301,1552,14,148,88,169,162,257,1120,1886,7,15077,837,0,2,2,2,57420,23008,4493,30270,0
263,6293,72,33,56,0,4,12,72,1,1,1,1,2,2,0,2,0,1,0,0,2,1,1,57420,23008,4493,30271,0
263,6293,1454,835,1044,76,110,219,1530,17,275,158,296,292,454,2297,3718,9,34017,1889,1,2,1,1,57430,23009,4493,30272,0
1,319,382,65,130,157,2,92,539,4,10,5,10,14,15,41,57,2,114,6,0,2,3,1,57430,23010,4494,30273,0
147,6905,1392,870,1177,35,17,170,1427,14,494,280,531,508,811,4473,7289,7,54850,3047,2,2,1,1,57430,23013,4495,30274,0
172,7584,139,89,101,2,0,35,141,7,54,34,62,61,96,330,569,4,2287,127,0,2,3,2,57430,23013,4495,30275,0
172,7584,7,5,5,0,0,2,7,1,2,1,2,3,3,2,4,0,2,0,0,2,3,2,57430,23013,4495,30276,0
139,5905,1782,648,1425,9,47,279,1791,8,171,97,189,179,286,1292,2140,4,9462,525,0,2,1,0,57430,23014,4496,30277,0
111,4196,1450,624,1228,12,26,181,1462,14,306,186,354,320,540,2580,4493,8,36391,2021,1,2,13,1,57430,23016,4497,30278,0
129,5207,1513,682,1277,25,13,200,1538,11,199,116,219,210,335,1557,2584,6,15641,868,0,2,1,1,57430,23018,4497,30279,0
39,2324,652,304,544,16,6,88,668,6,89,51,101,95,152,591,998,3,3399,188,0,2,1,1,57430,23019,4497,30280,0
21,661,424,94,331,4,0,89,428,1,5,5,5,6,10,11,25,0,12,0,0,2,1,1,57430,23020,4497,30281,0
237,5388,4293,999,3693,19,54,507,4312,9,155,88,170,164,258,1156,1898,4,9368,520,0,2,1,1,57430,23022,4497,30283,0
237,5388,1482,859,1002,125,135,219,1607,16,219,134,251,235,385,1766,3032,9,27804,1544,1,2,1,1,57440,23023,4497,30284,0
30,659,125,97,103,3,0,19,128,9,25,17,27,34,44,144,223,4,1087,60,0,2,1,1,57440,23023,4498,30285,0
76,1643,53,23,39,0,0,13,53,2,8,4,8,10,12,26,39,1,39,2,0,2,24,8,57440,23023,4498,30286,0
76,1643,515,298,307,33,80,99,548,12,63,44,77,75,121,419,753,7,5527,307,0,2,24,8,57450,23023,4498,30287,0
262,6289,72,33,56,0,4,12,72,1,1,1,1,2,2,0,2,0,1,0,0,2,2,3,57450,23023,4498,30288,0
262,6289,1454,835,1044,76,110,219,1530,17,275,158,296,292,454,2297,3718,9,34017,1889,1,2,2,3,57460,23024,4498,30289,0
70,1375,1178,367,1042,6,15,115,1184,9,94,51,95,103,146,644,976,4,4439,246,0,2,1,3,57460,23024,4498,30290,0
70,1375,177,108,140,8,0,27,185,6,30,16,32,36,48,162,248,3,794,44,0,2,1,3,57460,23026,4498,30291,0
22,454,601,196,481,2,23,85,603,8,63,36,72,71,108,400,664,4,3036,168,0,2,3,4,57460,23026,4498,30292,0
22,454,156,79,106,5,16,28,161,5,14,8,15,19,23,64,97,2,261,14,0,2,3,4,57460,23026,4498,30293,0
87,3808,1020,354,843,12,15,144,1032,8,134,77,144,142,221,970,1580,4,6792,377,0,2,30,3,57460,23026,4498,30294,0
356,7105,1457,730,1242,11,6,188,1468,10,292,166,329,302,495,2424,4078,5,22973,1276,1,2,6,1,57460,23028,4498,30295,0
356,7105,74,35,59,1,0,14,75,3,14,7,14,17,21,58,85,1,128,7,0,2,6,1,57460,23029,4498,30296,0
356,7105,245,125,200,5,7,34,250,7,30,17,34,37,51,166,265,3,1053,58,0,2,6,1,57470,23030,4498,30297,0
58,1178,207,111,150,11,0,50,218,5,26,19,36,31,55,133,272,3,943,52,0,2,2,2,57470,23030,4498,30298,0
58,1178,410,198,237,31,55,97,441,11,63,38,72,74,110,414,683,6,4293,238,0,2,2,2,57480,23031,4499,30299,0
78,1593,757,253,292,73,244,162,830,13,61,38,67,74,105,409,651,7,4654,258,0,2,1,1,57480,23032,4499,30300,0
58,1178,207,111,150,11,0,50,218,5,26,19,36,31,55,133,272,3,943,52,0,2,2,2,57480,23032,4499,30301,0
58,1178,410,198,237,31,55,97,441,11,63,38,72,74,110,414,683,6,4293,238,0,2,2,2,57490,23033,4500,30302,0
78,1593,757,253,292,73,244,162,830,13,61,38,67,74,105,409,651,7,4654,258,0,2,1,1,57490,23034,4500,30303,0
58,1178,207,111,150,11,0,50,218,5,26,19,36,31,55,133,272,3,943,52,0,2,2,2,57490,23034,4500,30304,0
58,1178,410,198,237,31,55,97,441,11,63,38,72,74,110,414,683,6,4293,238,0,2,2,2,57500,23035,4501,30305,0
356,7105,1457,730,1242,11,6,188,1468,10,292,166,329,302,495,2424,4078,5,22973,1276,1,2,6,1,57500,23037,4501,30306,0
356,7105,74,35,59,1,0,14,75,3,14,7,14,17,21,58,85,1,128,7,0,2,6,1,57500,23038,4501,30307,0
356,7105,245,125,200,5,7,34,250,7,30,17,34,37,51,166,265,3,1053,58,0,2,6,1,57510,23039,4501,30308,0
78,1593,757,253,292,73,244,162,830,13,61,38,67,74,105,409,651,7,4654,258,0,2,1,1,57510,23040,4501,30309,0
58,1178,207,111,150,11,0,50,218,5,26,19,36,31,55,133,272,3,943,52,0,2,2,2,57510,23040,4501,30310,0
58,1178,410,198,237,31,55,97,441,11,63,38,72,74,110,414,683,6,4293,238,0,2,2,2,57520,23041,4502,30311,0
356,7105,1457,730,1242,11,6,188,1468,10,292,166,329,302,495,2424,4078,5,22973,1276,1,2,6,1,57520,23043,4502,30312,0
356,7105,74,35,59,1,0,14,75,3,14,7,14,17,21,58,85,1,128,7,0,2,6,1,57520,23044,4502,30313,0
356,7105,245,125,200,5,7,34,250,7,30,17,34,37,51,166,265,3,1053,58,0,2,6,1,57530,23045,4502,30314,0
78,1593,757,253,292,73,244,162,830,13,61,38,67,74,105,409,651,7,4654,258,0,2,1,1,57530,23046,4502,30315,0
213,4606,182,127,129,0,0,53,182,5,39,21,42,44,63,217,343,2,926,51,0,2,1,1,57530,23046,4503,30316,1
213,4606,1165,710,800,67,119,181,1232,18,243,153,282,261,435,2000,3492,10,36473,2026,1,2,1,1,57540,23046,4504,30317,1
164,5028,1660,832,1314,41,38,274,1701,20,312,209,395,332,604,2671,5058,12,64042,3557,1,2,2,2,57540,23048,4505,30319,1
164,5028,1057,646,719,113,100,145,1170,18,215,134,248,233,382,1740,3004,10,31186,1732,1,2,2,2,57550,23049,4506,30320,1
17,345,95,58,50,9,16,20,104,12,33,24,45,45,69,209,378,8,3100,172,0,2,3,3,57550,23049,4506,30321,1
89,1831,477,336,357,30,23,73,507,16,194,134,250,210,384,1538,2962,10,30538,1696,0,2,4,4,57560,23050,4506,30322,1
145,3014,1513,682,1277,25,13,200,1538,11,199,116,219,210,335,1557,2584,6,15641,868,0,2,2,2,57560,23052,4506,30323,1
145,3014,819,519,539,24,98,155,843,15,96,57,106,111,163,690,1107,8,9171,509,0,2,2,2,57570,23054,4506,30324,1
356,7105,1457,730,1242,11,6,188,1468,10,292,166,329,302,495,2424,4078,5,22973,1276,1,2,4,4,57570,23056,4506,30325,1
356,7105,74,35,59,1,0,14,75,3,14,7,14,17,21,58,85,1,128,7,0,2,4,4,57570,23057,4506,30326,1
356,7105,245,125,200,5,7,34,250,7,30,17,34,37,51,166,265,3,1053,58,0,2,4,4,57580,23058,4506,30327,1
237,5388,4293,999,3693,19,54,507,4312,9,155,88,170,164,258,1156,1898,4,9368,520,0,2,7,7,57580,23060,4506,30328,1
237,5388,1482,859,1002,125,135,219,1607,16,219,134,251,235,385,1766,3032,9,27804,1544,1,2,7,7,57590,23061,4506,30329,1
86,2211,773,422,505,30,103,129,803,14,77,46,83,91,129,535,839,7,6334,351,0,2,2,2,57600,23062,4507,30330,1
122,2921,77,34,69,0,0,8,77,3,24,16,29,27,45,114,213,1,387,21,0,2,1,1,57600,23062,4507,30331,1
122,2921,712,438,573,51,9,84,763,14,102,71,128,116,199,733,1364,8,11988,666,0,2,1,1,57610,23063,4507,30332,1
22,350,102,57,55,5,16,25,107,5,17,10,18,22,28,81,124,2,330,18,0,2,1,1,57610,23063,4507,30333,1
79,1722,402,202,227,24,74,80,426,12,52,33,61,64,94,339,564,7,3969,220,0,2,1,1,57610,23064,4507,30334,1
20,509,205,80,86,16,53,53,221,7,18,10,19,25,29,94,134,3,497,27,0,2,1,1,57620,23064,4508,30335,1
223,5301,722,423,573,19,0,135,741,12,172,101,199,184,300,1320,2257,6,15668,870,0,2,1,1,57620,23066,4508,30337,1
223,5301,1508,847,911,44,250,301,1552,14,148,88,169,162,257,1120,1886,7,15077,837,0,2,1,1,57620,23067,4509,30338,1
262,6289,72,33,56,0,4,12,72,1,1,1,1,2,2,0,2,0,1,0,0,2,6,6,57620,23067,4509,30339,1
262,6289,1454,835,1044,76,110,219,1530,17,275,158,296,292,454,2297,3718,9,34017,1889,1,2,6,6,57630,23068,4509,30340,1
78,1590,757,253,292,73,244,162,830,13,61,38,67,74,105,409,651,7,4654,258,0,2,9,9,57630,23069,4509,30341,1
46,954,386,256,301,16,9,68,402,4,59,35,69,63,104,355,621,2,1453,80,0,2,5,5,57630,23069,4509,30342,1
46,954,264,131,164,11,41,46,275,6,38,22,40,44,62,214,338,3,1068,59,0,2,5,5,57640,23069,4510,30343,1
114,2575,1043,504,840,53,9,147,1096,9,180,112,198,189,310,1377,2344,4,11604,644,0,2,3,3,57640,23071,4510,30344,1
114,2575,383,288,292,26,6,62,409,11,65,38,67,76,105,429,656,5,3719,206,0,2,3,3,57640,23072,4510,30345,1
20,408,294,64,250,0,0,43,294,1,20,10,20,21,30,86,131,0,65,3,0,2,2,2,57640,23072,4510,30346,1
20,408,78,46,62,3,0,14,81,3,8,4,8,11,12,28,41,1,62,3,0,2,2,2,57640,23073,4510,30347,1
70,1375,1178,367,1042,6,15,115,1184,9,94,51,95,103,146,644,976,4,4439,246,0,2,2,2,57640,23073,4510,30348,1
70,1375,177,108,140,8,0,27,185,6,30,16,32,36,48,162,248,3,794,44,0,2,2,2,57640,23075,4510,30349,1
60,1082,282,196,195,3,0,86,285,8,130,71,141,138,212,936,1507,4,6538,363,0,2,1,1,57640,23075,4511,30350,1
92,3882,1289,550,1043,56,32,155,1345,10,167,93,185,177,278,1266,2075,5,11498,638,0,2,2,2,57640,23077,4512,30351,1
147,6905,1392,870,1177,35,17,170,1427,14,494,280,531,508,811,4473,7289,7,54850,3047,2,2,2,2,57640,23080,4513,30352,1
15,742,75,38,59,1,3,12,76,2,4,2,4,6,6,10,15,1,15,0,0,2,1,1,57640,23080,4513,30353,1
31,1981,1157,318,931,29,22,177,1186,6,104,63,125,110,188,712,1274,3,4596,255,0,2,4,4,57640,23080,4513,30354,1
54,3601,520,294,400,33,13,81,553,10,261,204,367,271,571,2128,4614,7,32445,1802,1,2,1,1,57640,23081,4513,30355,1
172,7584,139,89,101,2,0,35,141,7,54,34,62,61,96,330,569,4,2287,127,0,2,9,9,57640,23081,4513,30356,1
172,7584,7,5,5,0,0,2,7,1,2,1,2,3,3,2,4,0,2,0,0,2,9,9,57640,23081,4513,30357,1
139,5902,1782,648,1425,9,47,279,1791,8,171,97,189,179,286,1292,2140,4,9462,525,0,2,3,3,57640,23082,4514,30358,1
25,685,256,139,192,9,7,47,265,4,23,12,24,27,36,112,171,2,357,19,0,2,3,3,57640,23083,4514,30359,1
111,4179,1450,624,1228,12,26,181,1462,14,306,186,354,320,540,2580,4493,8,36391,2021,1,2,6,6,57640,23085,4515,30360,1
84,4426,1457,730,1242,11,6,188,1468,10,292,166,329,302,495,2424,4078,5,22973,1276,1,2,1,1,57640,23087,4515,30361,1
69,3180,1455,414,1257,16,76,112,1471,5,41,23,46,46,69,231,381,2,1069,59,0,2,5,5,57640,23088,4515,30362,1
94,4585,1523,757,1297,19,12,193,1542,12,193,117,230,205,347,1508,2664,7,19053,1058,0,2,3,3,57650,23090,4515,30363,1
87,3802,1020,354,843,12,15,144,1032,8,134,77,144,142,221,970,1580,4,6792,377,0,2,3,3,57650,23090,4515,30364,1
38,2298,334,251,279,10,4,40,344,5,127,74,143,132,217,899,1528,2,4303,239,0,2,1,1,57650,23091,4515,30365,1
3,42,14,8,8,0,0,6,14,0,0,0,0,0,0,0,0,0,0,0,0,2,0,1,57650,23091,4515,30366,0
7,114,44,19,17,0,16,11,44,3,14,7,14,17,21,58,85,1,128,7,0,2,0,1,57650,23091,4515,30367,0
6,71,127,75,83,2,11,30,129,4,14,7,14,18,21,61,87,2,175,9,0,2,0,3,57650,23091,4515,30368,0
6,71,652,304,544,16,6,88,668,6,89,51,101,95,152,591,998,3,3399,188,0,2,0,3,57650,23092,4515,30369,0
6,71,2,2,2,0,0,0,2,0,0,0,0,0,0,0,0,0,0,0,0,2,0,3,57650,23092,4515,30369,0
6,71,8,5,5,0,0,3,8,0,0,0,0,0,0,0,0,0,0,0,0,2,0,3,57650,23092,4515,30370,0
6,71,2,2,2,0,0,0,2,0,0,0,0,0,0,0,0,0,0,0,0,2,0,3,57650,23092,4515,30370,0
6,71,14,8,8,0,0,6,14,0,0,0,0,0,0,0,0,0,0,0,0,2,0,3,57650,23092,4515,30371,0
6,71,6,4,4,0,0,2,6,0,0,0,0,0,0,0,0,0,0,0,0,2,0,3,57650,23092,4515,30372,0
6,71,6,4,4,0,0,2,6,1,2,1,2,3,3,2,4,0,2,0,0,2,0,3,57650,23092,4515,30373,0
6,71,6,4,4,0,0,2,6,0,0,0,0,0,0,0,0,0,0,0,0,2,0,3,57650,23092,4515,30374,0
6,71,7,5,5,0,0,2,7,0,0,0,0,0,0,0,0,0,0,0,0,2,0,3,57650,23092,4515,30375,0
6,71,6,4,4,0,0,2,6,0,0,0,0,0,0,0,0,0,0,0,0,2,0,3,57650,23092,4515,30376,0
6,71,10,6,6,0,0,4,10,0,0,0,0,0,0,0,0,0,0,0,0,2,0,3,57650,23092,4515,30377,0
6,71,1,1,1,0,0,0,1,0,0,0,0,0,0,0,0,0,0,0,0,2,0,3,57650,23092,4515,30377,0
6,71,14,10,10,0,0,4,14,1,1,1,1,2,2,0,2,0,1,0,0,2,0,3,57650,23092,4515,30378,0
6,71,46,26,30,3,0,12,49,3,6,3,6,9,9,20,28,1,42,2,0,2,0,3,57660,23092,4515,30379,0
17,384,85,59,61,8,0,16,93,5,18,10,18,23,28,86,126,2,316,17,0,2,0,1,57660,23092,4515,30380,0
237,5388,4293,999,3693,19,54,507,4312,9,155,88,170,164,258,1156,1898,4,9368,520,0,2,4,4,57660,23094,4515,30381,0
237,5388,1482,859,1002,125,135,219,1607,16,219,134,251,235,385,1766,3032,9,27804,1544,1,2,4,4,57670,23095,4515,30382,0
46,954,386,256,301,16,9,68,402,4,59,35,69,63,104,355,621,2,1453,80,0,2,6,4,57670,23095,4515,30383,0
46,954,264,131,164,11,41,46,275,6,38,22,40,44,62,214,338,3,1068,59,0,2,6,4,57680,23095,4516,30384,0
87,3802,1020,354,843,12,15,144,1032,8,134,77,144,142,221,970,1580,4,6792,377,0,2,4,2,57680,23095,4516,30385,0
11,238,19,8,11,5,0,4,24,2,5,3,6,7,9,13,25,1,30,1,0,2,10,6,57690,23099,4517,30393,1
11,238,102,59,69,5,3,24,107,6,22,15,28,28,43,113,206,3,789,43,0,2,10,6,57690,23099,4517,30394,1
11,238,106,40,36,3,49,17,109,8,17,13,23,25,36,93,167,5,904,50,0,2,10,6,57690,23099,4517,30395,1
213,4611,182,127,129,0,0,53,182,5,39,21,42,44,63,217,343,2,926,51,0,2,121,61,57690,23099,4518,30396,1
213,4611,1165,710,800,67,119,181,1232,18,243,153,282,261,435,2000,3492,10,36473,2026,1,2,121,61,57700,23099,4519,30397,1
83,1808,773,419,590,28,0,166,801,10,204,113,217,214,330,1598,2554,5,13587,754,0,2,32,18,57700,23099,4520,30398,1
83,1808,421,273,302,44,34,57,465,17,81,59,107,98,166,583,1098,11,12329,684,0,2,32,18,57700,23099,4521,30399,1
26,525,2,2,2,0,0,0,2,0,0,0,0,0,0,0,0,0,0,0,0,2,21,16,57700,23099,4521,30399,1
26,525,99,48,90,1,3,5,100,0,0,0,0,0,0,0,0,0,0,0,0,2,21,16,57700,23100,4521,30400,1
26,525,8,5,5,2,0,1,10,0,0,0,0,0,0,0,0,0,0,0,0,2,21,16,57700,23100,4521,30401,1
26,525,1217,716,841,84,126,174,1301,14,185,118,215,199,333,1446,2542,8,20687,1149,0,2,21,16,57710,23102,4521,30402,1
26,525,160,89,115,0,13,31,160,7,15,11,17,22,28,78,124,3,495,27,0,2,21,16,57710,23102,4521,30403,1
26,525,10,10,9,9,0,0,19,0,0,0,0,0,0,0,0,0,0,0,0,2,21,16,57710,23102,4522,30404,1
26,525,173,84,99,8,29,36,181,5,12,7,13,17,20,54,81,2,221,12,0,2,21,16,57710,23103,4522,30405,1
26,525,3,1,1,3,0,0,6,0,0,0,0,0,0,0,0,0,0,0,0,2,21,16,57710,23103,4522,30406,1
164,5032,1660,832,1314,41,38,274,1701,20,312,209,395,332,604,2671,5058,12,64042,3557,1,2,76,56,57710,23105,4523,30408,1
164,5032,1057,646,719,113,100,145,1170,18,215,134,248,233,382,1740,3004,10,31186,1732,1,2,76,56,57720,23106,4524,30409,1
17,344,95,58,50,9,16,20,104,12,33,24,45,45,69,209,378,8,3100,172,0,2,6,9,57720,23106,4524,30410,1
89,1830,477,336,357,30,23,73,507,16,194,134,250,210,384,1538,2962,10,30538,1696,0,2,79,61,57730,23107,4524,30411,1
71,1702,996,429,845,24,10,117,1020,7,76,50,88,83,138,494,879,4,3565,198,0,2,65,41,57730,23109,4524,30412,1
71,1702,456,277,329,12,42,72,468,13,85,50,97,98,147,592,972,7,7212,400,0,2,65,41,57730,23109,4524,30413,1
145,3016,1513,682,1277,25,13,200,1538,11,199,116,219,210,335,1557,2584,6,15641,868,0,2,58,40,57730,23111,4524,30414,1
145,3016,819,519,539,24,98,155,843,15,96,57,106,111,163,690,1107,8,9171,509,0,2,58,40,57740,23113,4524,30415,1
58,1177,207,111,150,11,0,50,218,5,26,19,36,31,55,133,272,3,943,52,0,2,77,47,57740,23113,4524,30416,1
58,1177,410,198,237,31,55,97,441,11,63,38,72,74,110,414,683,6,4293,238,0,2,77,47,57750,23114,4525,30417,1
356,7117,1457,730,1242,11,6,188,1468,10,292,166,329,302,495,2424,4078,5,22973,1276,1,2,248,177,57750,23116,4525,30418,1
356,7117,74,35,59,1,0,14,75,3,14,7,14,17,21,58,85,1,128,7,0,2,248,177,57750,23117,4525,30419,1
356,7117,245,125,200,5,7,34,250,7,30,17,34,37,51,166,265,3,1053,58,0,2,248,177,57760,23118,4525,30420,1
28,809,339,213,244,17,9,65,356,10,42,26,48,52,74,259,421,5,2410,133,0,2,23,11,57770,23118,4525,30421,1
84,2154,1455,414,1257,16,76,112,1471,5,41,23,46,46,69,231,381,2,1069,59,0,2,138,85,57770,23119,4525,30423,1
84,2154,669,365,481,22,61,110,691,15,103,63,122,118,185,747,1273,8,11311,628,0,2,138,85,57780,23119,4526,30424,1
237,5395,4293,999,3693,19,54,507,4312,9,155,88,170,164,258,1156,1898,4,9368,520,0,2,139,82,57780,23121,4526,30425,1
237,5395,1482,859,1002,125,135,219,1607,16,219,134,251,235,385,1766,3032,9,27804,1544,1,2,139,82,57790,23122,4526,30426,1
6,136,44,22,19,0,19,6,44,2,10,6,12,12,18,35,64,1,77,4,0,2,5,3,57790,23122,4526,30427,1
27,959,74,35,59,1,0,14,75,3,14,7,14,17,21,58,85,1,128,7,0,2,77,50,57790,23123,4526,30428,1
27,959,245,125,200,5,7,34,250,7,30,17,34,37,51,166,265,3,1053,58,0,2,77,50,57800,23124,4526,30429,1
51,595,647,139,84,35,284,233,682,0,0,0,0,0,0,0,0,0,0,0,0,2,11,0,57800,23124,4526,30430,1
98,2661,1523,757,1297,19,12,193,1542,12,193,117,230,205,347,1508,2664,7,19053,1058,0,2,142,110,57810,23126,4526,30431,1
98,2661,701,378,504,33,58,109,734,13,110,68,126,123,194,794,1346,7,10027,557,0,2,142,110,57810,23127,4527,30432,1
86,2225,773,422,505,30,103,129,803,14,77,46,83,91,129,535,839,7,6334,351,0,2,155,102,57820,23128,4528,30433,1
122,2937,77,34,69,0,0,8,77,3,24,16,29,27,45,114,213,1,387,21,0,2,152,75,57820,23128,4528,30434,1
122,2937,712,438,573,51,9,84,763,14,102,71,128,116,199,733,1364,8,11988,666,0,2,152,75,57830,23129,4528,30435,1
24,605,2,2,2,0,0,0,2,0,0,0,0,0,0,0,0,0,0,0,0,2,45,28,57830,23129,4528,30435,1
24,605,99,48,90,1,3,5,100,0,0,0,0,0,0,0,0,0,0,0,0,2,45,28,57830,23130,4528,30436,1
24,605,8,5,5,2,0,1,10,0,0,0,0,0,0,0,0,0,0,0,0,2,45,28,57830,23130,4528,30437,1
24,605,1217,716,841,84,126,174,1301,14,185,118,215,199,333,1446,2542,8,20687,1149,0,2,45,28,57840,23132,4528,30438,1
24,605,160,89,115,0,13,31,160,7,15,11,17,22,28,78,124,3,495,27,0,2,45,28,57840,23132,4528,30439,1
24,605,10,10,9,9,0,0,19,0,0,0,0,0,0,0,0,0,0,0,0,2,45,28,57840,23132,4529,30440,1
24,605,173,84,99,8,29,36,181,5,12,7,13,17,20,54,81,2,221,12,0,2,45,28,57840,23133,4529,30441,1
24,605,3,1,1,3,0,0,6,0,0,0,0,0,0,0,0,0,0,0,0,2,45,28,57840,23133,4529,30442,1
30,658,125,97,103,3,0,19,128,9,25,17,27,34,44,144,223,4,1087,60,0,2,23,20,57840,23133,4530,30443,1
22,350,102,57,55,5,16,25,107,5,17,10,18,22,28,81,124,2,330,18,0,2,7,2,57840,23133,4530,30444,1
79,1721,402,202,227,24,74,80,426,12,52,33,61,64,94,339,564,7,3969,220,0,2,36,33,57840,23134,4530,30445,1
48,992,447,308,343,6,5,95,453,7,96,59,111,103,170,651,1136,4,4600,255,0,2,17,17,57840,23137,4530,30446,1
48,992,322,174,179,16,74,51,338,10,41,26,46,51,72,252,408,5,2291,127,0,2,17,17,57840,23140,4531,30447,1
72,1644,53,23,39,0,0,13,53,2,8,4,8,10,12,26,39,1,39,2,0,2,27,16,57840,23140,4531,30448,1
72,1644,515,298,307,33,80,99,548,12,63,44,77,75,121,419,753,7,5527,307,0,2,27,16,57850,23140,4531,30449,1
23,381,424,94,331,4,0,89,428,1,5,5,5,6,10,11,25,0,12,0,0,2,14,14,57850,23141,4531,30450,1
23,381,38,23,23,6,0,8,44,3,11,7,11,14,18,42,68,1,102,5,0,2,14,14,57850,23141,4531,30451,1
20,511,205,80,86,16,53,53,221,7,18,10,19,25,29,94,134,3,497,27,0,2,23,13,57860,23141,4532,30452,1
17,519,184,100,137,2,15,30,186,6,38,20,39,44,59,214,322,3,991,55,0,2,30,21,57860,23142,4532,30453,1
17,519,103,65,74,8,5,16,111,7,17,9,17,24,26,89,119,3,417,23,0,2,30,21,57860,23143,4532,30454,1
226,5309,722,423,573,19,0,135,741,12,172,101,199,184,300,1320,2257,6,15668,870,0,2,124,76,57860,23145,4532,30456,1
226,5309,1508,847,911,44,250,301,1552,14,148,88,169,162,257,1120,1886,7,15077,837,0,2,124,76,57860,23146,4533,30457,1
285,6295,72,33,56,0,4,12,72,1,1,1,1,2,2,0,2,0,1,0,0,2,275,166,57860,23146,4533,30458,1
285,6295,1454,835,1044,76,110,219,1530,17,275,158,296,292,454,2297,3718,9,34017,1889,1,2,275,166,57870,23147,4533,30459,1
78,1590,757,253,292,73,244,162,830,13,61,38,67,74,105,409,651,7,4654,258,0,2,42,24,57870,23148,4533,30460,1
46,955,386,256,301,16,9,68,402,4,59,35,69,63,104,355,621,2,1453,80,0,2,21,13,57870,23148,4533,30461,1
46,955,264,131,164,11,41,46,275,6,38,22,40,44,62,214,338,3,1068,59,0,2,21,13,57880,23148,4534,30462,1
30,650,215,129,180,6,0,29,221,8,65,43,72,73,115,415,711,4,3153,175,0,2,25,18,57880,23148,4534,30463,1
30,650,97,69,77,3,3,16,100,6,22,13,23,28,36,113,173,3,542,30,0,2,25,18,57880,23149,4534,30464,1
115,2577,1043,504,840,53,9,147,1096,9,180,112,198,189,310,1377,2344,4,11604,644,0,2,88,53,57880,23151,4534,30465,1
115,2577,383,288,292,26,6,62,409,11,65,38,67,76,105,429,656,5,3719,206,0,2,88,53,57880,23152,4534,30466,1
20,411,294,64,250,0,0,43,294,1,20,10,20,21,30,86,131,0,65,3,0,2,30,20,57880,23152,4534,30467,1
20,411,78,46,62,3,0,14,81,3,8,4,8,11,12,28,41,1,62,3,0,2,30,20,57880,23153,4534,30468,1
5,119,110,30,77,3,13,16,113,4,21,15,30,25,45,100,208,2,597,33,0,2,7,3,57880,23153,4534,30469,1
5,119,28,15,21,1,0,6,29,0,0,0,0,0,0,0,0,0,0,0,0,2,7,3,57880,23153,4534,30470,1
70,1380,1178,367,1042,6,15,115,1184,9,94,51,95,103,146,644,976,4,4439,246,0,2,75,65,57880,23153,4534,30471,1
70,1380,177,108,140,8,0,27,185,6,30,16,32,36,48,162,248,3,794,44,0,2,75,65,57880,23155,4534,30472,1
209,4543,1943,715,1694,26,18,214,1969,12,185,120,237,197,357,1436,2721,7,20915,1161,0,2,215,134,57880,23157,4534,30473,1
209,4543,1168,838,957,57,25,144,1225,19,348,224,416,367,640,3018,5452,11,61921,3440,1,2,215,134,57890,23159,4534,30474,1
16,480,442,244,305,14,16,103,456,11,68,45,75,79,120,452,756,6,4588,254,0,2,11,8,57890,23161,4534,30475,1
16,480,182,102,99,11,40,35,193,3,11,6,11,14,17,42,64,1,97,5,0,2,11,8,57890,23162,4534,30476,1
62,1223,1098,241,925,5,10,155,1103,7,46,25,49,53,74,273,423,3,1580,87,0,2,42,27,57900,23164,4534,30477,1
62,1223,282,202,222,14,2,44,296,8,42,24,43,50,67,250,378,4,1548,86,0,2,42,27,57900,23165,4534,30478,1
22,460,601,196,481,2,23,85,603,8,63,36,72,71,108,400,664,4,3036,168,0,2,34,17,57900,23165,4534,30479,1
22,460,156,79,106,5,16,28,161,5,14,8,15,19,23,64,97,2,261,14,0,2,34,17,57900,23165,4534,30480,1
3,42,14,8,8,0,0,6,14,0,0,0,0,0,0,0,0,0,0,0,0,2,5,1,57900,23165,4534,30483,1
2,34,9,6,6,0,0,3,9,0,0,0,0,0,0,0,0,0,0,0,0,2,1,0,57900,23165,4534,30484,1
2,34,13,9,8,0,0,4,13,0,0,0,0,0,0,0,0,0,0,0,0,2,1,0,57900,23165,4534,30485,1
1,324,382,65,130,157,2,92,539,4,10,5,10,14,15,41,57,2,114,6,0,2,117,100,57900,23166,4535,30487,1
60,1081,282,196,195,3,0,86,285,8,130,71,141,138,212,936,1507,4,6538,363,0,2,84,46,57900,23166,4536,30488,1
4,77,127,75,83,2,11,30,129,4,14,7,14,18,21,61,87,2,175,9,0,2,4,2,57900,23166,4536,30489,1
4,77,652,304,544,16,6,88,668,6,89,51,101,95,152,591,998,3,3399,188,0,2,4,2,57900,23167,4536,30490,1
4,77,2,2,2,0,0,0,2,0,0,0,0,0,0,0,0,0,0,0,0,2,4,2,57900,23167,4536,30490,1
4,77,8,5,5,0,0,3,8,0,0,0,0,0,0,0,0,0,0,0,0,2,4,2,57900,23167,4536,30491,1
4,77,2,2,2,0,0,0,2,0,0,0,0,0,0,0,0,0,0,0,0,2,4,2,57900,23167,4536,30491,1
4,77,14,8,8,0,0,6,14,0,0,0,0,0,0,0,0,0,0,0,0,2,4,2,57900,23167,4536,30492,1
4,77,6,4,4,0,0,2,6,0,0,0,0,0,0,0,0,0,0,0,0,2,4,2,57900,23167,4536,30493,1
4,77,6,4,4,0,0,2,6,1,2,1,2,3,3,2,4,0,2,0,0,2,4,2,57900,23167,4536,30494,1
4,77,6,4,4,0,0,2,6,0,0,0,0,0,0,0,0,0,0,0,0,2,4,2,57900,23167,4536,30495,1
4,77,7,5,5,0,0,2,7,0,0,0,0,0,0,0,0,0,0,0,0,2,4,2,57900,23167,4536,30496,1
4,77,6,4,4,0,0,2,6,0,0,0,0,0,0,0,0,0,0,0,0,2,4,2,57900,23167,4536,30497,1
4,77,10,6,6,0,0,4,10,0,0,0,0,0,0,0,0,0,0,0,0,2,4,2,57900,23167,4536,30498,1
4,77,1,1,1,0,0,0,1,0,0,0,0,0,0,0,0,0,0,0,0,2,4,2,57900,23167,4536,30498,1
4,77,14,10,10,0,0,4,14,1,1,1,1,2,2,0,2,0,1,0,0,2,4,2,57900,23167,4536,30499,1
4,77,46,26,30,3,0,12,49,3,6,3,6,9,9,20,28,1,42,2,0,2,4,2,57910,23167,4536,30500,1
1,9,5,3,3,0,0,2,5,0,0,0,0,0,0,0,0,0,0,0,0,2,1,0,57910,23167,4536,30500,1
1,88,13,10,10,0,0,3,13,1,2,1,2,3,3,2,4,0,2,0,0,2,5,5,57910,23167,4536,30501,1
7,114,44,19,17,0,16,11,44,3,14,7,14,17,21,58,85,1,128,7,0,2,4,0,57910,23167,4536,30502,1
3,66,127,75,83,2,11,30,129,4,14,7,14,18,21,61,87,2,175,9,0,2,5,1,57910,23167,4536,30503,1
3,66,652,304,544,16,6,88,668,6,89,51,101,95,152,591,998,3,3399,188,0,2,5,1,57910,23168,4536,30504,1
3,66,2,2,2,0,0,0,2,0,0,0,0,0,0,0,0,0,0,0,0,2,5,1,57910,23168,4536,30504,1
3,66,8,5,5,0,0,3,8,0,0,0,0,0,0,0,0,0,0,0,0,2,5,1,57910,23168,4536,30505,1
3,66,2,2,2,0,0,0,2,0,0,0,0,0,0,0,0,0,0,0,0,2,5,1,57910,23168,4536,30505,1
3,66,14,8,8,0,0,6,14,0,0,0,0,0,0,0,0,0,0,0,0,2,5,1,57910,23168,4536,30506,1
3,66,6,4,4,0,0,2,6,0,0,0,0,0,0,0,0,0,0,0,0,2,5,1,57910,23168,4536,30507,1
3,66,6,4,4,0,0,2,6,1,2,1,2,3,3,2,4,0,2,0,0,2,5,1,57910,23168,4536,30508,1
3,66,6,4,4,0,0,2,6,0,0,0,0,0,0,0,0,0,0,0,0,2,5,1,57910,23168,4536,30509,1
3,66,7,5,5,0,0,2,7,0,0,0,0,0,0,0,0,0,0,0,0,2,5,1,57910,23168,4536,30510,1
3,66,6,4,4,0,0,2,6,0,0,0,0,0,0,0,0,0,0,0,0,2,5,1,57910,23168,4536,30511,1
3,66,10,6,6,0,0,4,10,0,0,0,0,0,0,0,0,0,0,0,0,2,5,1,57910,23168,4536,30512,1
3,66,1,1,1,0,0,0,1,0,0,0,0,0,0,0,0,0,0,0,0,2,5,1,57910,23168,4536,30512,1
3,66,14,10,10,0,0,4,14,1,1,1,1,2,2,0,2,0,1,0,0,2,5,1,57910,23168,4536,30513,1
3,66,46,26,30,3,0,12,49,3,6,3,6,9,9,20,28,1,42,2,0,2,5,1,57920,23168,4536,30514,1
7,298,72,33,56,0,4,12,72,1,1,1,1,2,2,0,2,0,1,0,0,2,27,10,57920,23168,4536,30515,1
12,229,127,75,83,2,11,30,129,4,14,7,14,18,21,61,87,2,175,9,0,2,15,6,57920,23168,4536,30516,1
12,229,652,304,544,16,6,88,668,6,89,51,101,95,152,591,998,3,3399,188,0,2,15,6,57920,23169,4536,30517,1
12,229,2,2,2,0,0,0,2,0,0,0,0,0,0,0,0,0,0,0,0,2,15,6,57920,23169,4536,30517,1
12,229,8,5,5,0,0,3,8,0,0,0,0,0,0,0,0,0,0,0,0,2,15,6,57920,23169,4536,30518,1
12,229,2,2,2,0,0,0,2,0,0,0,0,0,0,0,0,0,0,0,0,2,15,6,57920,23169,4536,30518,1
12,229,14,8,8,0,0,6,14,0,0,0,0,0,0,0,0,0,0,0,0,2,15,6,57920,23169,4536,30519,1
12,229,6,4,4,0,0,2,6,0,0,0,0,0,0,0,0,0,0,0,0,2,15,6,57920,23169,4536,30520,1
12,229,6,4,4,0,0,2,6,1,2,1,2,3,3,2,4,0,2,0,0,2,15,6,57920,23169,4536,30521,1
12,229,6,4,4,0,0,2,6,0,0,0,0,0,0,0,0,0,0,0,0,2,15,6,57920,23169,4536,30522,1
12,229,7,5,5,0,0,2,7,0,0,0,0,0,0,0,0,0,0,0,0,2,15,6,57920,23169,4536,30523,1
12,229,6,4,4,0,0,2,6,0,0,0,0,0,0,0,0,0,0,0,0,2,15,6,57920,23169,4536,30524,1
12,229,10,6,6,0,0,4,10,0,0,0,0,0,0,0,0,0,0,0,0,2,15,6,57920,23169,4536,30525,1
12,229,1,1,1,0,0,0,1,0,0,0,0,0,0,0,0,0,0,0,0,2,15,6,57920,23169,4536,30525,1
12,229,14,10,10,0,0,4,14,1,1,1,1,2,2,0,2,0,1,0,0,2,15,6,57920,23169,4536,30526,1
12,229,46,26,30,3,0,12,49,3,6,3,6,9,9,20,28,1,42,2,0,2,15,6,57930,23169,4536,30527,1
6,71,127,75,83,2,11,30,129,4,14,7,14,18,21,61,87,2,175,9,0,2,3,0,57930,23169,4536,30528,1
6,71,652,304,544,16,6,88,668,6,89,51,101,95,152,591,998,3,3399,188,0,2,3,0,57930,23170,4536,30529,1
6,71,2,2,2,0,0,0,2,0,0,0,0,0,0,0,0,0,0,0,0,2,3,0,57930,23170,4536,30529,1
6,71,8,5,5,0,0,3,8,0,0,0,0,0,0,0,0,0,0,0,0,2,3,0,57930,23170,4536,30530,1
6,71,2,2,2,0,0,0,2,0,0,0,0,0,0,0,0,0,0,0,0,2,3,0,57930,23170,4536,30530,1
6,71,14,8,8,0,0,6,14,0,0,0,0,0,0,0,0,0,0,0,0,2,3,0,57930,23170,4536,30531,1
6,71,6,4,4,0,0,2,6,0,0,0,0,0,0,0,0,0,0,0,0,2,3,0,57930,23170,4536,30532,1
6,71,6,4,4,0,0,2,6,1,2,1,2,3,3,2,4,0,2,0,0,2,3,0,57930,23170,4536,30533,1
6,71,6,4,4,0,0,2,6,0,0,0,0,0,0,0,0,0,0,0,0,2,3,0,57930,23170,4536,30534,1
6,71,7,5,5,0,0,2,7,0,0,0,0,0,0,0,0,0,0,0,0,2,3,0,57930,23170,4536,30535,1
6,71,6,4,4,0,0,2,6,0,0,0,0,0,0,0,0,0,0,0,0,2,3,0,57930,23170,4536,30536,1
6,71,10,6,6,0,0,4,10,0,0,0,0,0,0,0,0,0,0,0,0,2,3,0,57930,23170,4536,30537,1
6,71,1,1,1,0,0,0,1,0,0,0,0,0,0,0,0,0,0,0,0,2,3,0,57930,23170,4536,30537,1
6,71,14,10,10,0,0,4,14,1,1,1,1,2,2,0,2,0,1,0,0,2,3,0,57930,23170,4536,30538,1
6,71,46,26,30,3,0,12,49,3,6,3,6,9,9,20,28,1,42,2,0,2,3,0,57940,23170,4536,30539,1
3,26,14,7,7,2,0,5,16,0,0,0,0,0,0,0,0,0,0,0,0,2,3,0,57940,23170,4536,30539,1
7,103,38,23,23,0,0,15,38,0,0,0,0,0,0,0,0,0,0,0,0,2,8,0,57940,23170,4536,30540,1
17,384,85,59,61,8,0,16,93,5,18,10,18,23,28,86,126,2,316,17,0,2,18,15,57940,23170,4536,30541,1
15,484,42,7,35,4,0,5,46,1,2,1,2,3,3,2,4,0,2,0,0,2,49,50,57940,23170,4536,30542,1
15,484,11,6,10,0,0,1,11,2,4,2,4,6,6,10,15,1,15,0,0,2,49,50,57940,23170,4536,30543,1
92,3866,1289,550,1043,56,32,155,1345,10,167,93,185,177,278,1266,2075,5,11498,638,0,2,316,270,57950,23176,4538,30551,1
36,1084,182,127,129,0,0,53,182,5,39,21,42,44,63,217,343,2,926,51,0,2,42,29,57950,23176,4539,30552,1
147,6916,1392,870,1177,35,17,170,1427,14,494,280,531,508,811,4473,7289,7,54850,3047,2,2,280,169,57950,23179,4540,30553,1
88,2881,773,419,590,28,0,166,801,10,204,113,217,214,330,1598,2554,5,13587,754,0,2,164,83,57950,23179,4541,30554,1
15,742,75,38,59,1,3,12,76,2,4,2,4,6,6,10,15,1,15,0,0,2,138,76,57950,23179,4541,30555,1
2,26,6,4,4,0,0,2,6,1,4,2,4,5,6,8,13,0,6,0,0,2,2,3,57950,23179,4541,30557,1
13,570,139,89,101,2,0,35,141,7,54,34,62,61,96,330,569,4,2287,127,0,2,45,48,57950,23179,4541,30559,1
1,138,149,67,118,4,0,27,153,1,17,14,28,18,42,69,175,0,144,8,0,2,15,7,57950,23179,4541,30560,1
31,1983,1157,318,931,29,22,177,1186,6,104,63,125,110,188,712,1274,3,4596,255,0,2,368,271,57950,23179,4541,30561,1
54,3598,520,294,400,33,13,81,553,10,261,204,367,271,571,2128,4614,7,32445,1802,1,2,81,90,57950,23180,4541,30562,1
97,4401,1338,495,1086,10,64,173,1348,11,122,82,157,133,239,883,1686,7,11934,663,0,2,446,289,57950,23182,4541,30563,1
172,7590,139,89,101,2,0,35,141,7,54,34,62,61,96,330,569,4,2287,127,0,2,1162,594,57950,23182,4541,30564,1
172,7590,7,5,5,0,0,2,7,1,2,1,2,3,3,2,4,0,2,0,0,2,1162,594,57950,23182,4541,30565,1
33,989,465,148,393,5,8,60,470,4,31,20,31,35,51,161,261,2,523,29,0,2,97,53,57950,23183,4541,30566,1
33,989,16,12,9,0,0,6,16,1,2,1,2,3,3,2,4,0,2,0,0,2,97,53,57950,23183,4541,30567,1
139,5899,1782,648,1425,9,47,279,1791,8,171,97,189,179,286,1292,2140,4,9462,525,0,2,528,372,57950,23184,4542,30568,1
25,684,256,139,192,9,7,47,265,4,23,12,24,27,36,112,171,2,357,19,0,2,31,21,57950,23185,4542,30569,1
6,328,180,34,164,0,0,16,180,1,12,6,12,13,18,43,66,0,33,1,0,2,89,64,57950,23185,4542,30570,1
23,578,102,59,69,5,3,24,107,6,22,15,28,28,43,113,206,3,789,43,0,2,32,21,57950,23185,4542,30571,1
111,4186,1450,624,1228,12,26,181,1462,14,306,186,354,320,540,2580,4493,8,36391,2021,1,2,478,384,57950,23187,4543,30572,1
155,4437,1660,832,1314,41,38,274,1701,20,312,209,395,332,604,2671,5058,12,64042,3557,1,2,295,164,57950,23189,4544,30574,1
36,2873,996,429,845,24,10,117,1020,7,76,50,88,83,138,494,879,4,3565,198,0,2,391,315,57950,23191,4544,30575,1
129,5198,1513,682,1277,25,13,200,1538,11,199,116,219,210,335,1557,2584,6,15641,868,0,2,379,270,57950,23193,4544,30576,1
73,3803,1296,573,1062,40,33,157,1336,8,201,118,231,209,349,1561,2689,4,12365,686,0,2,277,191,57950,23193,4544,30577,1
14,341,207,111,150,11,0,50,218,5,26,19,36,31,55,133,272,3,943,52,0,2,24,15,57950,23193,4544,30578,1
84,4433,1457,730,1242,11,6,188,1468,10,292,166,329,302,495,2424,4078,5,22973,1276,1,2,439,270,57950,23195,4544,30579,1
39,2323,652,304,544,16,6,88,668,6,89,51,101,95,152,591,998,3,3399,188,0,2,180,111,57950,23196,4544,30580,1
69,3174,1455,414,1257,16,76,112,1471,5,41,23,46,46,69,231,381,2,1069,59,0,2,511,345,57950,23197,4544,30581,1
2,75,7,6,5,0,0,2,7,1,1,1,2,2,3,0,3,1,3,0,0,2,4,4,57950,23197,4544,30582,1
8,271,74,35,59,1,0,14,75,3,14,7,14,17,21,58,85,1,128,7,0,2,19,24,57950,23198,4544,30583,1
94,4592,1523,757,1297,19,12,193,1542,12,193,117,230,205,347,1508,2664,7,19053,1058,0,2,309,193,57960,23200,4544,30584,1
87,3811,1020,354,843,12,15,144,1032,8,134,77,144,142,221,970,1580,4,6792,377,0,2,355,220,57960,23200,4544,30585,1
38,1676,447,308,343,6,5,95,453,7,96,59,111,103,170,651,1136,4,4600,255,0,2,99,72,57960,23203,4544,30586,1
1,107,53,23,39,0,0,13,53,2,8,4,8,10,12,26,39,1,39,2,0,2,13,10,57960,23203,4544,30587,1
21,658,424,94,331,4,0,89,428,1,5,5,5,6,10,11,25,0,12,0,0,2,83,59,57960,23204,4544,30588,1
38,2302,334,251,279,10,4,40,344,5,127,74,143,132,217,899,1528,2,4303,239,0,2,123,97,57960,23205,4544,30589,1
12,493,184,100,137,2,15,30,186,6,38,20,39,44,59,214,322,3,991,55,0,2,47,32,57960,23206,4544,30590,1
59,2582,1293,570,1093,25,15,163,1318,10,195,123,241,205,364,1516,2795,6,17273,959,0,2,198,124,57970,23208,4544,30591,1
33,1883,384,251,317,7,8,52,391,11,70,44,84,81,128,467,811,6,5355,297,0,2,78,55,57970,23208,4544,30592,1
45,2208,722,423,573,19,0,135,741,12,172,101,199,184,300,1320,2257,6,15668,870,0,2,61,38,57970,23210,4544,30594,1
39,1727,386,256,301,16,9,68,402,4,59,35,69,63,104,355,621,2,1453,80,0,2,90,52,57970,23210,4544,30595,1
16,1214,215,129,180,6,0,29,221,8,65,43,72,73,115,415,711,4,3153,175,0,2,75,60,57970,23210,4544,30596,1
79,3060,1043,504,840,53,9,147,1096,9,180,112,198,189,310,1377,2344,4,11604,644,0,2,245,148,57970,23212,4544,30597,1
14,530,295,56,236,0,4,54,295,2,9,5,10,11,15,30,51,1,57,3,0,2,85,52,57970,23214,4544,30598,1
30,1241,373,158,315,8,0,51,381,5,76,44,79,81,123,486,779,2,2026,112,0,2,88,44,57970,23214,4544,30599,1
77,3211,1178,367,1042,6,15,115,1184,9,94,51,95,103,146,644,976,4,4439,246,0,2,460,373,57970,23214,4544,30600,1
91,4584,1943,715,1694,26,18,214,1969,12,185,120,237,197,357,1436,2721,7,20915,1161,0,2,582,518,57970,23216,4544,30601,1
14,826,442,244,305,14,16,103,456,11,68,45,75,79,120,452,756,6,4588,254,0,2,58,34,57970,23218,4544,30602,1
48,1744,1098,241,925,5,10,155,1103,7,46,25,49,53,74,273,423,3,1580,87,0,2,269,172,57980,23220,4544,30603,1
19,682,601,196,481,2,23,85,603,8,63,36,72,71,108,400,664,4,3036,168,0,2,139,107,57980,23220,4544,30604,1
213,4615,182,127,129,0,0,53,182,5,39,21,42,44,63,217,343,2,926,51,0,2,2,2,57980,23220,4545,30605,1
213,4615,1165,710,800,67,119,181,1232,18,243,153,282,261,435,2000,3492,10,36473,2026,1,2,2,2,57990,23220,4546,30606,1
58,1183,207,111,150,11,0,50,218,5,26,19,36,31,55,133,272,3,943,52,0,2,7,5,57990,23220,4546,30607,1
58,1183,410,198,237,31,55,97,441,11,63,38,72,74,110,414,683,6,4293,238,0,2,7,5,58000,23221,4547,30608,1
237,5397,4293,999,3693,19,54,507,4312,9,155,88,170,164,258,1156,1898,4,9368,520,0,2,3,2,58000,23223,4547,30609,1
237,5397,1482,859,1002,125,135,219,1607,16,219,134,251,235,385,1766,3032,9,27804,1544,1,2,3,2,58010,23224,4547,30610,1
285,6294,72,33,56,0,4,12,72,1,1,1,1,2,2,0,2,0,1,0,0,2,1,1,58010,23224,4547,30611,1
285,6294,1454,835,1044,76,110,219,1530,17,275,158,296,292,454,2297,3718,9,34017,1889,1,2,1,1,58020,23225,4547,30612,1
78,1580,757,253,292,73,244,162,830,13,61,38,67,74,105,409,651,7,4654,258,0,2,8,6,58020,23226,4547,30613,1
2,40,9,6,6,0,0,3,9,0,0,0,0,0,0,0,0,0,0,0,0,2,2,2,58020,23226,4547,30616,1
2,40,13,9,8,0,0,4,13,0,0,0,0,0,0,0,0,0,0,0,0,2,2,2,58020,23226,4547,30617,1
60,1081,282,196,195,3,0,86,285,8,130,71,141,138,212,936,1507,4,6538,363,0,2,10,10,58020,23226,4548,30618,1
4,77,127,75,83,2,11,30,129,4,14,7,14,18,21,61,87,2,175,9,0,2,2,1,58020,23226,4548,30619,1
4,77,652,304,544,16,6,88,668,6,89,51,101,95,152,591,998,3,3399,188,0,2,2,1,58020,23227,4548,30620,1
4,77,2,2,2,0,0,0,2,0,0,0,0,0,0,0,0,0,0,0,0,2,2,1,58020,23227,4548,30620,1
4,77,8,5,5,0,0,3,8,0,0,0,0,0,0,0,0,0,0,0,0,2,2,1,58020,23227,4548,30621,1
4,77,2,2,2,0,0,0,2,0,0,0,0,0,0,0,0,0,0,0,0,2,2,1,58020,23227,4548,30621,1
4,77,14,8,8,0,0,6,14,0,0,0,0,0,0,0,0,0,0,0,0,2,2,1,58020,23227,4548,30622,1
4,77,6,4,4,0,0,2,6,0,0,0,0,0,0,0,0,0,0,0,0,2,2,1,58020,23227,4548,30623,1
4,77,6,4,4,0,0,2,6,1,2,1,2,3,3,2,4,0,2,0,0,2,2,1,58020,23227,4548,30624,1
4,77,6,4,4,0,0,2,6,0,0,0,0,0,0,0,0,0,0,0,0,2,2,1,58020,23227,4548,30625,1
4,77,7,5,5,0,0,2,7,0,0,0,0,0,0,0,0,0,0,0,0,2,2,1,58020,23227,4548,30626,1
4,77,6,4,4,0,0,2,6,0,0,0,0,0,0,0,0,0,0,0,0,2,2,1,58020,23227,4548,30627,1
4,77,10,6,6,0,0,4,10,0,0,0,0,0,0,0,0,0,0,0,0,2,2,1,58020,23227,4548,30628,1
4,77,1,1,1,0,0,0,1,0,0,0,0,0,0,0,0,0,0,0,0,2,2,1,58020,23227,4548,30628,1
4,77,14,10,10,0,0,4,14,1,1,1,1,2,2,0,2,0,1,0,0,2,2,1,58020,23227,4548,30629,1
4,77,46,26,30,3,0,12,49,3,6,3,6,9,9,20,28,1,42,2,0,2,2,1,58030,23227,4548,30630,1
3,26,14,7,7,2,0,5,16,0,0,0,0,0,0,0,0,0,0,0,0,2,2,1,58030,23227,4548,30630,1
17,378,85,59,61,8,0,16,93,5,18,10,18,23,28,86,126,2,316,17,0,2,2,3,58030,23227,4548,30631,1
36,1088,182,127,129,0,0,53,182,5,39,21,42,44,63,217,343,2,926,51,0,2,3,2,58030,23227,4549,30632,1
97,4401,1338,495,1086,10,64,173,1348,11,122,82,157,133,239,883,1686,7,11934,663,0,2,1,1,58030,23229,4549,30633,1
125,5129,1513,682,1277,25,13,200,1538,11,199,116,219,210,335,1557,2584,6,15641,868,0,2,13,28,58030,23231,4549,30634,1
73,3803,1296,573,1062,40,33,157,1336,8,201,118,231,209,349,1561,2689,4,12365,686,0,2,1,1,58030,23231,4549,30635,1
88,2881,773,419,590,28,0,166,801,10,204,113,217,214,330,1598,2554,5,13587,754,0,2,4,4,58030,23231,4550,30636,0
98,2655,1523,757,1297,19,12,193,1542,12,193,117,230,205,347,1508,2664,7,19053,1058,0,2,1,1,58040,23233,4550,30637,0
98,2655,701,378,504,33,58,109,734,13,110,68,126,123,194,794,1346,7,10027,557,0,2,1,1,58040,23234,4551,30638,0
95,4653,1523,757,1297,19,12,193,1542,12,193,117,230,205,347,1508,2664,7,19053,1058,0,2,17,0,58050,23236,4551,30639,0
95,4653,1523,757,1297,19,12,193,1542,12,193,117,230,205,347,1508,2664,7,19053,1058,0,2,1,1,58060,23238,4551,30640,0
49,1844,1098,241,925,5,10,155,1103,7,46,25,49,53,74,273,423,3,1580,87,0,2,47,0,58070,23240,4551,30641,0
49,1845,1098,241,925,5,10,155,1103,7,46,25,49,53,74,273,423,3,1580,87,0,2,15,1,58080,23242,4551,30642,0
237,5390,4293,999,3693,19,54,507,4312,9,155,88,170,164,258,1156,1898,4,9368,520,0,2,1,1,58080,23244,4551,30643,0
237,5390,1482,859,1002,125,135,219,1607,16,219,134,251,235,385,1766,3032,9,27804,1544,1,2,1,1,58090,23245,4551,30644,0
262,6287,72,33,56,0,4,12,72,1,1,1,1,2,2,0,2,0,1,0,0,2,1,1,58090,23245,4551,30645,0
262,6287,1454,835,1044,76,110,219,1530,17,275,158,296,292,454,2297,3718,9,34017,1889,1,2,1,1,58100,23246,4551,30646,0
62,1229,1098,241,925,5,10,155,1103,7,46,25,49,53,74,273,423,3,1580,87,0,2,2,1,58110,23248,4551,30647,0
62,1229,282,202,222,14,2,44,296,8,42,24,43,50,67,250,378,4,1548,86,0,2,2,1,58110,23249,4551,30648,0
237,5390,4293,999,3693,19,54,507,4312,9,155,88,170,164,258,1156,1898,4,9368,520,0,2,1,1,58110,23251,4551,30649,0
237,5390,1482,859,1002,125,135,219,1607,16,219,134,251,235,385,1766,3032,9,27804,1544,1,2,1,1,58120,23252,4551,30650,0
262,6287,72,33,56,0,4,12,72,1,1,1,1,2,2,0,2,0,1,0,0,2,1,1,58120,23252,4551,30651,0
262,6287,1454,835,1044,76,110,219,1530,17,275,158,296,292,454,2297,3718,9,34017,1889,1,2,1,1,58130,23253,4551,30652,0
62,1229,1098,241,925,5,10,155,1103,7,46,25,49,53,74,273,423,3,1580,87,0,2,2,1,58140,23255,4551,30653,0
62,1229,282,202,222,14,2,44,296,8,42,24,43,50,67,250,378,4,1548,86,0,2,2,1,58140,23256,4551,30654,0
49,1845,1098,241,925,5,10,155,1103,7,46,25,49,53,74,273,423,3,1580,87,0,2,61,0,58150,23258,4551,30655,0
98,2655,1523,757,1297,19,12,193,1542,12,193,117,230,205,347,1508,2664,7,19053,1058,0,2,1,1,58160,23260,4551,30656,0
98,2655,701,378,504,33,58,109,734,13,110,68,126,123,194,794,1346,7,10027,557,0,2,1,1,58160,23261,4552,30657,0
95,4653,1523,757,1297,19,12,193,1542,12,193,117,230,205,347,1508,2664,7,19053,1058,0,2,17,0,58170,23263,4552,30658,0
163,5014,1660,832,1314,41,38,274,1701,20,312,209,395,332,604,2671,5058,12,64042,3557,1,2,1,4,58170,23265,4553,30660,0
163,5014,1057,646,719,113,100,145,1170,18,215,134,248,233,382,1740,3004,10,31186,1732,1,2,1,4,58180,23266,4554,30661,0
237,5399,4293,999,3693,19,54,507,4312,9,155,88,170,164,258,1156,1898,4,9368,520,0,2,1,1,58180,23268,4554,30662,0
237,5399,1482,859,1002,125,135,219,1607,16,219,134,251,235,385,1766,3032,9,27804,1544,1,2,1,1,58190,23269,4554,30663,0
98,2661,1523,757,1297,19,12,193,1542,12,193,117,230,205,347,1508,2664,7,19053,1058,0,2,2,1,58200,23271,4554,30664,0
98,2661,701,378,504,33,58,109,734,13,110,68,126,123,194,794,1346,7,10027,557,0,2,2,1,58200,23272,4555,30665,0
285,6292,72,33,56,0,4,12,72,1,1,1,1,2,2,0,2,0,1,0,0,2,1,1,58200,23272,4555,30666,0
285,6292,1454,835,1044,76,110,219,1530,17,275,158,296,292,454,2297,3718,9,34017,1889,1,2,1,1,58210,23273,4555,30667,0
62,1230,1098,241,925,5,10,155,1103,7,46,25,49,53,74,273,423,3,1580,87,0,2,2,1,58220,23275,4555,30668,0
62,1230,282,202,222,14,2,44,296,8,42,24,43,50,67,250,378,4,1548,86,0,2,2,1,58220,23276,4555,30669,0
95,4654,1523,757,1297,19,12,193,1542,12,193,117,230,205,347,1508,2664,7,19053,1058,0,2,17,0,58230,23278,4555,30670,0
49,1839,1098,241,925,5,10,155,1103,7,46,25,49,53,74,273,423,3,1580,87,0,2,61,0,58240,23280,4555,30671,0
98,2661,1523,757,1297,19,12,193,1542,12,193,117,230,205,347,1508,2664,7,19053,1058,0,2,0,1,58250,23282,4555,30672,0
98,2661,701,378,504,33,58,109,734,13,110,68,126,123,194,794,1346,7,10027,557,0,2,0,1,58250,23283,4556,30673,0
95,4654,1523,757,1297,19,12,193,1542,12,193,117,230,205,347,1508,2664,7,19053,1058,0,2,6,4,58260,23285,4556,30674,0
49,1838,1098,241,925,5,10,155,1103,7,46,25,49,53,74,273,423,3,1580,87,0,2,15,11,58270,23287,4556,30675,0
11,238,19,8,11,5,0,4,24,2,5,3,6,7,9,13,25,1,30,1,0,2,10,6,58280,23291,4557,30683,0
11,238,102,59,69,5,3,24,107,6,22,15,28,28,43,113,206,3,789,43,0,2,10,6,58280,23291,4557,30684,0
11,238,106,40,36,3,49,17,109,8,17,13,23,25,36,93,167,5,904,50,0,2,10,6,58280,23291,4557,30685,0
213,4615,182,127,129,0,0,53,182,5,39,21,42,44,63,217,343,2,926,51,0,2,123,63,58280,23291,4558,30686,0
213,4615,1165,710,800,67,119,181,1232,18,243,153,282,261,435,2000,3492,10,36473,2026,1,2,123,63,58290,23291,4559,30687,0
83,1808,773,419,590,28,0,166,801,10,204,113,217,214,330,1598,2554,5,13587,754,0,2,32,18,58290,23291,4560,30688,0
83,1808,421,273,302,44,34,57,465,17,81,59,107,98,166,583,1098,11,12329,684,0,2,32,18,58290,23291,4561,30689,0
26,525,2,2,2,0,0,0,2,0,0,0,0,0,0,0,0,0,0,0,0,2,21,16,58290,23291,4561,30689,0
26,525,99,48,90,1,3,5,100,0,0,0,0,0,0,0,0,0,0,0,0,2,21,16,58290,23292,4561,30690,0
26,525,8,5,5,2,0,1,10,0,0,0,0,0,0,0,0,0,0,0,0,2,21,16,58290,23292,4561,30691,0
26,525,1217,716,841,84,126,174,1301,14,185,118,215,199,333,1446,2542,8,20687,1149,0,2,21,16,58300,23294,4561,30692,0
26,525,160,89,115,0,13,31,160,7,15,11,17,22,28,78,124,3,495,27,0,2,21,16,58300,23294,4561,30693,0
26,525,10,10,9,9,0,0,19,0,0,0,0,0,0,0,0,0,0,0,0,2,21,16,58300,23294,4562,30694,0
26,525,173,84,99,8,29,36,181,5,12,7,13,17,20,54,81,2,221,12,0,2,21,16,58300,23295,4562,30695,0
26,525,3,1,1,3,0,0,6,0,0,0,0,0,0,0,0,0,0,0,0,2,21,16,58300,23295,4562,30696,0
164,5032,1660,832,1314,41,38,274,1701,20,312,209,395,332,604,2671,5058,12,64042,3557,1,2,78,58,58300,23297,4563,30698,0
164,5032,1057,646,719,113,100,145,1170,18,215,134,248,233,382,1740,3004,10,31186,1732,1,2,78,58,58310,23298,4564,30699,0
17,344,95,58,50,9,16,20,104,12,33,24,45,45,69,209,378,8,3100,172,0,2,6,9,58310,23298,4564,30700,0
89,1830,477,336,357,30,23,73,507,16,194,134,250,210,384,1538,2962,10,30538,1696,0,2,81,63,58320,23299,4564,30701,0
71,1702,996,429,845,24,10,117,1020,7,76,50,88,83,138,494,879,4,3565,198,0,2,65,41,58320,23301,4564,30702,0
71,1702,456,277,329,12,42,72,468,13,85,50,97,98,147,592,972,7,7212,400,0,2,65,41,58320,23301,4564,30703,0
145,3016,1513,682,1277,25,13,200,1538,11,199,116,219,210,335,1557,2584,6,15641,868,0,2,59,41,58320,23303,4564,30704,0
145,3016,819,519,539,24,98,155,843,15,96,57,106,111,163,690,1107,8,9171,509,0,2,59,41,58330,23305,4564,30705,0
58,1183,207,111,150,11,0,50,218,5,26,19,36,31,55,133,272,3,943,52,0,2,84,52,58330,23305,4564,30706,0
58,1183,410,198,237,31,55,97,441,11,63,38,72,74,110,414,683,6,4293,238,0,2,84,52,58340,23306,4565,30707,0
356,7117,1457,730,1242,11,6,188,1468,10,292,166,329,302,495,2424,4078,5,22973,1276,1,2,250,179,58340,23308,4565,30708,0
356,7117,74,35,59,1,0,14,75,3,14,7,14,17,21,58,85,1,128,7,0,2,250,179,58340,23309,4565,30709,0
356,7117,245,125,200,5,7,34,250,7,30,17,34,37,51,166,265,3,1053,58,0,2,250,179,58350,23310,4565,30710,0
28,809,339,213,244,17,9,65,356,10,42,26,48,52,74,259,421,5,2410,133,0,2,23,11,58360,23310,4565,30711,0
84,2154,1455,414,1257,16,76,112,1471,5,41,23,46,46,69,231,381,2,1069,59,0,2,138,85,58360,23311,4565,30713,0
84,2154,669,365,481,22,61,110,691,15,103,63,122,118,185,747,1273,8,11311,628,0,2,138,85,58370,23311,4566,30714,0
237,5399,4293,999,3693,19,54,507,4312,9,155,88,170,164,258,1156,1898,4,9368,520,0,2,145,87,58370,23313,4566,30715,0
237,5399,1482,859,1002,125,135,219,1607,16,219,134,251,235,385,1766,3032,9,27804,1544,1,2,145,87,58380,23314,4566,30716,0
6,136,44,22,19,0,19,6,44,2,10,6,12,12,18,35,64,1,77,4,0,2,5,3,58380,23314,4566,30717,0
27,959,74,35,59,1,0,14,75,3,14,7,14,17,21,58,85,1,128,7,0,2,77,50,58380,23315,4566,30718,0
27,959,245,125,200,5,7,34,250,7,30,17,34,37,51,166,265,3,1053,58,0,2,77,50,58390,23316,4566,30719,0
51,595,647,139,84,35,284,233,682,0,0,0,0,0,0,0,0,0,0,0,0,2,11,0,58390,23316,4566,30720,0
98,2661,1523,757,1297,19,12,193,1542,12,193,117,230,205,347,1508,2664,7,19053,1058,0,2,142,110,58400,23318,4566,30721,0
98,2661,701,378,504,33,58,109,734,13,110,68,126,123,194,794,1346,7,10027,557,0,2,142,110,58400,23319,4567,30722,0
86,2225,773,422,505,30,103,129,803,14,77,46,83,91,129,535,839,7,6334,351,0,2,157,104,58410,23320,4568,30723,0
122,2937,77,34,69,0,0,8,77,3,24,16,29,27,45,114,213,1,387,21,0,2,152,75,58410,23320,4568,30724,0
122,2937,712,438,573,51,9,84,763,14,102,71,128,116,199,733,1364,8,11988,666,0,2,152,75,58420,23321,4568,30725,0
24,605,2,2,2,0,0,0,2,0,0,0,0,0,0,0,0,0,0,0,0,2,45,28,58420,23321,4568,30725,0
24,605,99,48,90,1,3,5,100,0,0,0,0,0,0,0,0,0,0,0,0,2,45,28,58420,23322,4568,30726,0
24,605,8,5,5,2,0,1,10,0,0,0,0,0,0,0,0,0,0,0,0,2,45,28,58420,23322,4568,30727,0
24,605,1217,716,841,84,126,174,1301,14,185,118,215,199,333,1446,2542,8,20687,1149,0,2,45,28,58430,23324,4568,30728,0
24,605,160,89,115,0,13,31,160,7,15,11,17,22,28,78,124,3,495,27,0,2,45,28,58430,23324,4568,30729,0
24,605,10,10,9,9,0,0,19,0,0,0,0,0,0,0,0,0,0,0,0,2,45,28,58430,23324,4569,30730,0
24,605,173,84,99,8,29,36,181,5,12,7,13,17,20,54,81,2,221,12,0,2,45,28,58430,23325,4569,30731,0
24,605,3,1,1,3,0,0,6,0,0,0,0,0,0,0,0,0,0,0,0,2,45,28,58430,23325,4569,30732,0
30,658,125,97,103,3,0,19,128,9,25,17,27,34,44,144,223,4,1087,60,0,2,23,20,58430,23325,4570,30733,0
22,350,102,57,55,5,16,25,107,5,17,10,18,22,28,81,124,2,330,18,0,2,8,3,58430,23325,4570,30734,0
79,1721,402,202,227,24,74,80,426,12,52,33,61,64,94,339,564,7,3969,220,0,2,37,34,58430,23326,4570,30735,0
48,992,447,308,343,6,5,95,453,7,96,59,111,103,170,651,1136,4,4600,255,0,2,17,17,58430,23329,4570,30736,0
48,992,322,174,179,16,74,51,338,10,41,26,46,51,72,252,408,5,2291,127,0,2,17,17,58430,23332,4571,30737,0
72,1644,53,23,39,0,0,13,53,2,8,4,8,10,12,26,39,1,39,2,0,2,27,16,58430,23332,4571,30738,0
72,1644,515,298,307,33,80,99,548,12,63,44,77,75,121,419,753,7,5527,307,0,2,27,16,58440,23332,4571,30739,0
23,381,424,94,331,4,0,89,428,1,5,5,5,6,10,11,25,0,12,0,0,2,14,14,58440,23333,4571,30740,0
23,381,38,23,23,6,0,8,44,3,11,7,11,14,18,42,68,1,102,5,0,2,14,14,58440,23333,4571,30741,0
20,511,205,80,86,16,53,53,221,7,18,10,19,25,29,94,134,3,497,27,0,2,23,13,58450,23333,4572,30742,0
17,519,184,100,137,2,15,30,186,6,38,20,39,44,59,214,322,3,991,55,0,2,30,21,58450,23334,4572,30743,0
17,519,103,65,74,8,5,16,111,7,17,9,17,24,26,89,119,3,417,23,0,2,30,21,58450,23335,4572,30744,0
226,5309,722,423,573,19,0,135,741,12,172,101,199,184,300,1320,2257,6,15668,870,0,2,125,77,58450,23337,4572,30746,0
226,5309,1508,847,911,44,250,301,1552,14,148,88,169,162,257,1120,1886,7,15077,837,0,2,125,77,58450,23338,4573,30747,0
285,6292,72,33,56,0,4,12,72,1,1,1,1,2,2,0,2,0,1,0,0,2,277,168,58450,23338,4573,30748,0
285,6292,1454,835,1044,76,110,219,1530,17,275,158,296,292,454,2297,3718,9,34017,1889,1,2,277,168,58460,23339,4573,30749,0
78,1580,757,253,292,73,244,162,830,13,61,38,67,74,105,409,651,7,4654,258,0,2,52,32,58460,23340,4573,30750,0
46,955,386,256,301,16,9,68,402,4,59,35,69,63,104,355,621,2,1453,80,0,2,25,15,58460,23340,4573,30751,0
46,955,264,131,164,11,41,46,275,6,38,22,40,44,62,214,338,3,1068,59,0,2,25,15,58470,23340,4574,30752,0
30,650,215,129,180,6,0,29,221,8,65,43,72,73,115,415,711,4,3153,175,0,2,25,18,58470,23340,4574,30753,0
30,650,97,69,77,3,3,16,100,6,22,13,23,28,36,113,173,3,542,30,0,2,25,18,58470,23341,4574,30754,0
115,2577,1043,504,840,53,9,147,1096,9,180,112,198,189,310,1377,2344,4,11604,644,0,2,89,54,58470,23343,4574,30755,0
115,2577,383,288,292,26,6,62,409,11,65,38,67,76,105,429,656,5,3719,206,0,2,89,54,58470,23344,4574,30756,0
20,411,294,64,250,0,0,43,294,1,20,10,20,21,30,86,131,0,65,3,0,2,30,20,58470,23344,4574,30757,0
20,411,78,46,62,3,0,14,81,3,8,4,8,11,12,28,41,1,62,3,0,2,30,20,58470,23345,4574,30758,0
5,119,110,30,77,3,13,16,113,4,21,15,30,25,45,100,208,2,597,33,0,2,7,3,58470,23345,4574,30759,0
5,119,28,15,21,1,0,6,29,0,0,0,0,0,0,0,0,0,0,0,0,2,7,3,58470,23345,4574,30760,0
70,1380,1178,367,1042,6,15,115,1184,9,94,51,95,103,146,644,976,4,4439,246,0,2,77,67,58470,23345,4574,30761,0
70,1380,177,108,140,8,0,27,185,6,30,16,32,36,48,162,248,3,794,44,0,2,77,67,58470,23347,4574,30762,0
209,4543,1943,715,1694,26,18,214,1969,12,185,120,237,197,357,1436,2721,7,20915,1161,0,2,215,134,58470,23349,4574,30763,0
209,4543,1168,838,957,57,25,144,1225,19,348,224,416,367,640,3018,5452,11,61921,3440,1,2,215,134,58480,23351,4574,30764,0
16,480,442,244,305,14,16,103,456,11,68,45,75,79,120,452,756,6,4588,254,0,2,11,8,58480,23353,4574,30765,0
16,480,182,102,99,11,40,35,193,3,11,6,11,14,17,42,64,1,97,5,0,2,11,8,58480,23354,4574,30766,0
62,1230,1098,241,925,5,10,155,1103,7,46,25,49,53,74,273,423,3,1580,87,0,2,42,27,58490,23356,4574,30767,0
62,1230,282,202,222,14,2,44,296,8,42,24,43,50,67,250,378,4,1548,86,0,2,42,27,58490,23357,4574,30768,0
22,460,601,196,481,2,23,85,603,8,63,36,72,71,108,400,664,4,3036,168,0,2,34,17,58490,23357,4574,30769,0
22,460,156,79,106,5,16,28,161,5,14,8,15,19,23,64,97,2,261,14,0,2,34,17,58490,23357,4574,30770,0
3,42,14,8,8,0,0,6,14,0,0,0,0,0,0,0,0,0,0,0,0,2,5,2,58490,23357,4574,30773,0
2,40,9,6,6,0,0,3,9,0,0,0,0,0,0,0,0,0,0,0,0,2,3,2,58490,23357,4574,30774,0
2,40,13,9,8,0,0,4,13,0,0,0,0,0,0,0,0,0,0,0,0,2,3,2,58490,23357,4574,30775,0
1,324,382,65,130,157,2,92,539,4,10,5,10,14,15,41,57,2,114,6,0,2,117,100,58490,23358,4575,30777,0
60,1081,282,196,195,3,0,86,285,8,130,71,141,138,212,936,1507,4,6538,363,0,2,88,50,58490,23358,4576,30778,0
4,77,127,75,83,2,11,30,129,4,14,7,14,18,21,61,87,2,175,9,0,2,6,3,58490,23358,4576,30779,0
4,77,652,304,544,16,6,88,668,6,89,51,101,95,152,591,998,3,3399,188,0,2,6,3,58490,23359,4576,30780,0
4,77,2,2,2,0,0,0,2,0,0,0,0,0,0,0,0,0,0,0,0,2,6,3,58490,23359,4576,30780,0
4,77,8,5,5,0,0,3,8,0,0,0,0,0,0,0,0,0,0,0,0,2,6,3,58490,23359,4576,30781,0
4,77,2,2,2,0,0,0,2,0,0,0,0,0,0,0,0,0,0,0,0,2,6,3,58490,23359,4576,30781,0
4,77,14,8,8,0,0,6,14,0,0,0,0,0,0,0,0,0,0,0,0,2,6,3,58490,23359,4576,30782,0
4,77,6,4,4,0,0,2,6,0,0,0,0,0,0,0,0,0,0,0,0,2,6,3,58490,23359,4576,30783,0
4,77,6,4,4,0,0,2,6,1,2,1,2,3,3,2,4,0,2,0,0,2,6,3,58490,23359,4576,30784,0
4,77,6,4,4,0,0,2,6,0,0,0,0,0,0,0,0,0,0,0,0,2,6,3,58490,23359,4576,30785,0
4,77,7,5,5,0,0,2,7,0,0,0,0,0,0,0,0,0,0,0,0,2,6,3,58490,23359,4576,30786,0
4,77,6,4,4,0,0,2,6,0,0,0,0,0,0,0,0,0,0,0,0,2,6,3,58490,23359,4576,30787,0
4,77,10,6,6,0,0,4,10,0,0,0,0,0,0,0,0,0,0,0,0,2,6,3,58490,23359,4576,30788,0
4,77,1,1,1,0,0,0,1,0,0,0,0,0,0,0,0,0,0,0,0,2,6,3,58490,23359,4576,30788,0
4,77,14,10,10,0,0,4,14,1,1,1,1,2,2,0,2,0,1,0,0,2,6,3,58490,23359,4576,30789,0
4,77,46,26,30,3,0,12,49,3,6,3,6,9,9,20,28,1,42,2,0,2,6,3,58500,23359,4576,30790,0
1,9,5,3,3,0,0,2,5,0,0,0,0,0,0,0,0,0,0,0,0,2,1,0,58500,23359,4576,30790,0
1,88,13,10,10,0,0,3,13,1,2,1,2,3,3,2,4,0,2,0,0,2,5,5,58500,23359,4576,30791,0
7,114,44,19,17,0,16,11,44,3,14,7,14,17,21,58,85,1,128,7,0,2,4,1,58500,23359,4576,30792,0
3,66,127,75,83,2,11,30,129,4,14,7,14,18,21,61,87,2,175,9,0,2,5,1,58500,23359,4576,30793,0
3,66,652,304,544,16,6,88,668,6,89,51,101,95,152,591,998,3,3399,188,0,2,5,1,58500,23360,4576,30794,0
3,66,2,2,2,0,0,0,2,0,0,0,0,0,0,0,0,0,0,0,0,2,5,1,58500,23360,4576,30794,0
3,66,8,5,5,0,0,3,8,0,0,0,0,0,0,0,0,0,0,0,0,2,5,1,58500,23360,4576,30795,0
3,66,2,2,2,0,0,0,2,0,0,0,0,0,0,0,0,0,0,0,0,2,5,1,58500,23360,4576,30795,0
3,66,14,8,8,0,0,6,14,0,0,0,0,0,0,0,0,0,0,0,0,2,5,1,58500,23360,4576,30796,0
3,66,6,4,4,0,0,2,6,0,0,0,0,0,0,0,0,0,0,0,0,2,5,1,58500,23360,4576,30797,0
3,66,6,4,4,0,0,2,6,1,2,1,2,3,3,2,4,0,2,0,0,2,5,1,58500,23360,4576,30798,0
3,66,6,4,4,0,0,2,6,0,0,0,0,0,0,0,0,0,0,0,0,2,5,1,58500,23360,4576,30799,0
3,66,7,5,5,0,0,2,7,0,0,0,0,0,0,0,0,0,0,0,0,2,5,1,58500,23360,4576,30800,0
3,66,6,4,4,0,0,2,6,0,0,0,0,0,0,0,0,0,0,0,0,2,5,1,58500,23360,4576,30801,0
3,66,10,6,6,0,0,4,10,0,0,0,0,0,0,0,0,0,0,0,0,2,5,1,58500,23360,4576,30802,0
3,66,1,1,1,0,0,0,1,0,0,0,0,0,0,0,0,0,0,0,0,2,5,1,58500,23360,4576,30802,0
3,66,14,10,10,0,0,4,14,1,1,1,1,2,2,0,2,0,1,0,0,2,5,1,58500,23360,4576,30803,0
3,66,46,26,30,3,0,12,49,3,6,3,6,9,9,20,28,1,42,2,0,2,5,1,58510,23360,4576,30804,0
7,298,72,33,56,0,4,12,72,1,1,1,1,2,2,0,2,0,1,0,0,2,27,10,58510,23360,4576,30805,0
12,229,127,75,83,2,11,30,129,4,14,7,14,18,21,61,87,2,175,9,0,2,15,6,58510,23360,4576,30806,0
12,229,652,304,544,16,6,88,668,6,89,51,101,95,152,591,998,3,3399,188,0,2,15,6,58510,23361,4576,30807,0
12,229,2,2,2,0,0,0,2,0,0,0,0,0,0,0,0,0,0,0,0,2,15,6,58510,23361,4576,30807,0
12,229,8,5,5,0,0,3,8,0,0,0,0,0,0,0,0,0,0,0,0,2,15,6,58510,23361,4576,30808,0
12,229,2,2,2,0,0,0,2,0,0,0,0,0,0,0,0,0,0,0,0,2,15,6,58510,23361,4576,30808,0
12,229,14,8,8,0,0,6,14,0,0,0,0,0,0,0,0,0,0,0,0,2,15,6,58510,23361,4576,30809,0
12,229,6,4,4,0,0,2,6,0,0,0,0,0,0,0,0,0,0,0,0,2,15,6,58510,23361,4576,30810,0
12,229,6,4,4,0,0,2,6,1,2,1,2,3,3,2,4,0,2,0,0,2,15,6,58510,23361,4576,30811,0
12,229,6,4,4,0,0,2,6,0,0,0,0,0,0,0,0,0,0,0,0,2,15,6,58510,23361,4576,30812,0
12,229,7,5,5,0,0,2,7,0,0,0,0,0,0,0,0,0,0,0,0,2,15,6,58510,23361,4576,30813,0
12,229,6,4,4,0,0,2,6,0,0,0,0,0,0,0,0,0,0,0,0,2,15,6,58510,23361,4576,30814,0
12,229,10,6,6,0,0,4,10,0,0,0,0,0,0,0,0,0,0,0,0,2,15,6,58510,23361,4576,30815,0
12,229,1,1,1,0,0,0,1,0,0,0,0,0,0,0,0,0,0,0,0,2,15,6,58510,23361,4576,30815,0
12,229,14,10,10,0,0,4,14,1,1,1,1,2,2,0,2,0,1,0,0,2,15,6,58510,23361,4576,30816,0
12,229,46,26,30,3,0,12,49,3,6,3,6,9,9,20,28,1,42,2,0,2,15,6,58520,23361,4576,30817,0
6,71,127,75,83,2,11,30,129,4,14,7,14,18,21,61,87,2,175,9,0,2,3,3,58520,23361,4576,30818,0
6,71,652,304,544,16,6,88,668,6,89,51,101,95,152,591,998,3,3399,188,0,2,3,3,58520,23362,4576,30819,0
6,71,2,2,2,0,0,0,2,0,0,0,0,0,0,0,0,0,0,0,0,2,3,3,58520,23362,4576,30819,0
6,71,8,5,5,0,0,3,8,0,0,0,0,0,0,0,0,0,0,0,0,2,3,3,58520,23362,4576,30820,0
6,71,2,2,2,0,0,0,2,0,0,0,0,0,0,0,0,0,0,0,0,2,3,3,58520,23362,4576,30820,0
6,71,14,8,8,0,0,6,14,0,0,0,0,0,0,0,0,0,0,0,0,2,3,3,58520,23362,4576,30821,0
6,71,6,4,4,0,0,2,6,0,0,0,0,0,0,0,0,0,0,0,0,2,3,3,58520,23362,4576,30822,0
6,71,6,4,4,0,0,2,6,1,2,1,2,3,3,2,4,0,2,0,0,2,3,3,58520,23362,4576,30823,0
6,71,6,4,4,0,0,2,6,0,0,0,0,0,0,0,0,0,0,0,0,2,3,3,58520,23362,4576,30824,0
6,71,7,5,5,0,0,2,7,0,0,0,0,0,0,0,0,0,0,0,0,2,3,3,58520,23362,4576,30825,0
6,71,6,4,4,0,0,2,6,0,0,0,0,0,0,0,0,0,0,0,0,2,3,3,58520,23362,4576,30826,0
6,71,10,6,6,0,0,4,10,0,0,0,0,0,0,0,0,0,0,0,0,2,3,3,58520,23362,4576,30827,0
6,71,1,1,1,0,0,0,1,0,0,0,0,0,0,0,0,0,0,0,0,2,3,3,58520,23362,4576,30827,0
6,71,14,10,10,0,0,4,14,1,1,1,1,2,2,0,2,0,1,0,0,2,3,3,58520,23362,4576,30828,0
6,71,46,26,30,3,0,12,49,3,6,3,6,9,9,20,28,1,42,2,0,2,3,3,58530,23362,4576,30829,0
3,26,14,7,7,2,0,5,16,0,0,0,0,0,0,0,0,0,0,0,0,2,5,1,58530,23362,4576,30829,0
7,103,38,23,23,0,0,15,38,0,0,0,0,0,0,0,0,0,0,0,0,2,8,0,58530,23362,4576,30830,0
17,378,85,59,61,8,0,16,93,5,18,10,18,23,28,86,126,2,316,17,0,2,20,19,58530,23362,4576,30831,0
15,484,42,7,35,4,0,5,46,1,2,1,2,3,3,2,4,0,2,0,0,2,49,50,58530,23362,4576,30832,0
15,484,11,6,10,0,0,1,11,2,4,2,4,6,6,10,15,1,15,0,0,2,49,50,58530,23362,4576,30833,0
92,3866,1289,550,1043,56,32,155,1345,10,167,93,185,177,278,1266,2075,5,11498,638,0,2,316,270,58540,23368,4578,30841,0
36,1088,182,127,129,0,0,53,182,5,39,21,42,44,63,217,343,2,926,51,0,2,45,31,58540,23368,4579,30842,0
147,6916,1392,870,1177,35,17,170,1427,14,494,280,531,508,811,4473,7289,7,54850,3047,2,2,280,169,58540,23371,4580,30843,0
88,2881,773,419,590,28,0,166,801,10,204,113,217,214,330,1598,2554,5,13587,754,0,2,167,86,58540,23371,4581,30844,0
15,742,75,38,59,1,3,12,76,2,4,2,4,6,6,10,15,1,15,0,0,2,139,77,58540,23371,4581,30845,0
2,26,6,4,4,0,0,2,6,1,4,2,4,5,6,8,13,0,6,0,0,2,2,3,58540,23371,4581,30847,0
13,570,139,89,101,2,0,35,141,7,54,34,62,61,96,330,569,4,2287,127,0,2,45,48,58540,23371,4581,30849,0
1,138,149,67,118,4,0,27,153,1,17,14,28,18,42,69,175,0,144,8,0,2,15,7,58540,23371,4581,30850,0
31,1983,1157,318,931,29,22,177,1186,6,104,63,125,110,188,712,1274,3,4596,255,0,2,370,273,58540,23371,4581,30851,0
54,3598,520,294,400,33,13,81,553,10,261,204,367,271,571,2128,4614,7,32445,1802,1,2,81,90,58540,23372,4581,30852,0
97,4401,1338,495,1086,10,64,173,1348,11,122,82,157,133,239,883,1686,7,11934,663,0,2,447,290,58540,23374,4581,30853,0
172,7590,139,89,101,2,0,35,141,7,54,34,62,61,96,330,569,4,2287,127,0,2,1171,603,58540,23374,4581,30854,0
172,7590,7,5,5,0,0,2,7,1,2,1,2,3,3,2,4,0,2,0,0,2,1171,603,58540,23374,4581,30855,0
33,989,465,148,393,5,8,60,470,4,31,20,31,35,51,161,261,2,523,29,0,2,97,53,58540,23375,4581,30856,0
33,989,16,12,9,0,0,6,16,1,2,1,2,3,3,2,4,0,2,0,0,2,97,53,58540,23375,4581,30857,0
139,5899,1782,648,1425,9,47,279,1791,8,171,97,189,179,286,1292,2140,4,9462,525,0,2,529,373,58540,23376,4582,30858,0
25,684,256,139,192,9,7,47,265,4,23,12,24,27,36,112,171,2,357,19,0,2,33,23,58540,23377,4582,30859,0
6,328,180,34,164,0,0,16,180,1,12,6,12,13,18,43,66,0,33,1,0,2,89,64,58540,23377,4582,30860,0
23,578,102,59,69,5,3,24,107,6,22,15,28,28,43,113,206,3,789,43,0,2,32,21,58540,23377,4582,30861,0
111,4186,1450,624,1228,12,26,181,1462,14,306,186,354,320,540,2580,4493,8,36391,2021,1,2,482,388,58540,23379,4583,30862,0
155,4437,1660,832,1314,41,38,274,1701,20,312,209,395,332,604,2671,5058,12,64042,3557,1,2,295,164,58540,23381,4584,30864,0
36,2873,996,429,845,24,10,117,1020,7,76,50,88,83,138,494,879,4,3565,198,0,2,391,315,58540,23383,4584,30865,0
125,5129,1513,682,1277,25,13,200,1538,11,199,116,219,210,335,1557,2584,6,15641,868,0,2,386,292,58540,23385,4584,30866,0
73,3803,1296,573,1062,40,33,157,1336,8,201,118,231,209,349,1561,2689,4,12365,686,0,2,278,192,58540,23385,4584,30867,0
14,341,207,111,150,11,0,50,218,5,26,19,36,31,55,133,272,3,943,52,0,2,24,15,58540,23385,4584,30868,0
84,4433,1457,730,1242,11,6,188,1468,10,292,166,329,302,495,2424,4078,5,22973,1276,1,2,439,270,58540,23387,4584,30869,0
39,2323,652,304,544,16,6,88,668,6,89,51,101,95,152,591,998,3,3399,188,0,2,180,111,58540,23388,4584,30870,0
69,3174,1455,414,1257,16,76,112,1471,5,41,23,46,46,69,231,381,2,1069,59,0,2,515,349,58540,23389,4584,30871,0
2,75,7,6,5,0,0,2,7,1,1,1,2,2,3,0,3,1,3,0,0,2,4,4,58540,23389,4584,30872,0
8,271,74,35,59,1,0,14,75,3,14,7,14,17,21,58,85,1,128,7,0,2,19,24,58540,23390,4584,30873,0
95,4654,1523,757,1297,19,12,193,1542,12,193,117,230,205,347,1508,2664,7,19053,1058,0,2,318,200,58550,23392,4584,30874,0
87,3811,1020,354,843,12,15,144,1032,8,134,77,144,142,221,970,1580,4,6792,377,0,2,358,221,58550,23392,4584,30875,0
38,1676,447,308,343,6,5,95,453,7,96,59,111,103,170,651,1136,4,4600,255,0,2,99,72,58550,23395,4584,30876,0
1,107,53,23,39,0,0,13,53,2,8,4,8,10,12,26,39,1,39,2,0,2,13,10,58550,23395,4584,30877,0
21,658,424,94,331,4,0,89,428,1,5,5,5,6,10,11,25,0,12,0,0,2,83,59,58550,23396,4584,30878,0
38,2302,334,251,279,10,4,40,344,5,127,74,143,132,217,899,1528,2,4303,239,0,2,124,98,58550,23397,4584,30879,0
12,493,184,100,137,2,15,30,186,6,38,20,39,44,59,214,322,3,991,55,0,2,47,32,58550,23398,4584,30880,0
59,2582,1293,570,1093,25,15,163,1318,10,195,123,241,205,364,1516,2795,6,17273,959,0,2,198,124,58560,23400,4584,30881,0
33,1883,384,251,317,7,8,52,391,11,70,44,84,81,128,467,811,6,5355,297,0,2,78,55,58560,23400,4584,30882,0
45,2208,722,423,573,19,0,135,741,12,172,101,199,184,300,1320,2257,6,15668,870,0,2,61,38,58560,23402,4584,30884,0
39,1727,386,256,301,16,9,68,402,4,59,35,69,63,104,355,621,2,1453,80,0,2,90,52,58560,23402,4584,30885,0
16,1214,215,129,180,6,0,29,221,8,65,43,72,73,115,415,711,4,3153,175,0,2,75,60,58560,23402,4584,30886,0
79,3060,1043,504,840,53,9,147,1096,9,180,112,198,189,310,1377,2344,4,11604,644,0,2,245,148,58560,23404,4584,30887,0
14,530,295,56,236,0,4,54,295,2,9,5,10,11,15,30,51,1,57,3,0,2,85,52,58560,23406,4584,30888,0
30,1241,373,158,315,8,0,51,381,5,76,44,79,81,123,486,779,2,2026,112,0,2,88,44,58560,23406,4584,30889,0
77,3211,1178,367,1042,6,15,115,1184,9,94,51,95,103,146,644,976,4,4439,246,0,2,460,373,58560,23406,4584,30890,0
91,4584,1943,715,1694,26,18,214,1969,12,185,120,237,197,357,1436,2721,7,20915,1161,0,2,582,518,58560,23408,4584,30891,0
14,826,442,244,305,14,16,103,456,11,68,45,75,79,120,452,756,6,4588,254,0,2,58,34,58560,23410,4584,30892,0
49,1838,1098,241,925,5,10,155,1103,7,46,25,49,53,74,273,423,3,1580,87,0,2,284,183,58570,23412,4584,30893,0
19,682,601,196,481,2,23,85,603,8,63,36,72,71,108,400,664,4,3036,168,0,2,139,107,58570,23412,4584,30894,0
163,5018,1660,832,1314,41,38,274,1701,20,312,209,395,332,604,2671,5058,12,64042,3557,1,2,1,4,58570,23414,4585,30896,0
163,5018,1057,646,719,113,100,145,1170,18,215,134,248,233,382,1740,3004,10,31186,1732,1,2,1,4,58580,23415,4586,30897,0
15,492,42,7,35,4,0,5,46,1,2,1,2,3,3,2,4,0,2,0,0,2,8,4,58580,23415,4586,30898,0
15,492,11,6,10,0,0,1,11,2,4,2,4,6,6,10,15,1,15,0,0,2,8,4,58580,23415,4586,30899,0
15,492,42,7,35,4,0,5,46,1,2,1,2,3,3,2,4,0,2,0,0,2,8,4,58810,23489,4605,31002,0
15,492,11,6,10,0,0,1,11,2,4,2,4,6,6,10,15,1,15,0,0,2,8,4,58810,23489,4605,31003,0
111,4174,1450,624,1228,12,26,181,1462,14,306,186,354,320,540,2580,4493,8,36391,2021,1,2,3,3,59040,23565,4625,31106,0
58,1178,207,111,150,11,0,50,218,5,26,19,36,31,55,133,272,3,943,52,0,2,1,1,59040,23565,4625,31107,0
58,1178,410,198,237,31,55,97,441,11,63,38,72,74,110,414,683,6,4293,238,0,2,1,1,59050,23566,4626,31108,0
236,5393,4293,999,3693,19,54,507,4312,9,155,88,170,164,258,1156,1898,4,9368,520,0,2,1,2,59050,23568,4626,31109,0
236,5393,1482,859,1002,125,135,219,1607,16,219,134,251,235,385,1766,3032,9,27804,1544,1,2,1,2,59060,23569,4626,31110,0
147,6910,1392,870,1177,35,17,170,1427,14,494,280,531,508,811,4473,7289,7,54850,3047,2,2,1,2,59060,23572,4627,31111,0
157,4456,1660,832,1314,41,38,274,1701,20,312,209,395,332,604,2671,5058,12,64042,3557,1,2,23,7,59060,23574,4628,31113,1
154,4341,1660,832,1314,41,38,274,1701,20,312,209,395,332,604,2671,5058,12,64042,3557,1,2,15,25,59060,23576,4629,31115,1
58,1178,207,111,150,11,0,50,218,5,26,19,36,31,55,133,272,3,943,52,0,2,1,1,59060,23576,4629,31116,0
58,1178,410,198,237,31,55,97,441,11,63,38,72,74,110,414,683,6,4293,238,0,2,1,1,59070,23577,4630,31117,0
236,5393,4293,999,3693,19,54,507,4312,9,155,88,170,164,258,1156,1898,4,9368,520,0,2,1,2,59070,23579,4630,31118,0
236,5393,1482,859,1002,125,135,219,1607,16,219,134,251,235,385,1766,3032,9,27804,1544,1,2,1,2,59080,23580,4630,31119,0
147,6910,1392,870,1177,35,17,170,1427,14,494,280,531,508,811,4473,7289,7,54850,3047,2,2,1,2,59080,23583,4631,31120,0
111,4174,1450,624,1228,12,26,181,1462,14,306,186,354,320,540,2580,4493,8,36391,2021,1,2,3,3,59080,23585,4632,31121,0
154,4341,1660,832,1314,41,38,274,1701,20,312,209,395,332,604,2671,5058,12,64042,3557,1,2,28,22,59080,23587,4633,31123,0
15,495,42,7,35,4,0,5,46,1,2,1,2,3,3,2,4,0,2,0,0,2,7,1,59080,23587,4633,31124,0
15,495,11,6,10,0,0,1,11,2,4,2,4,6,6,10,15,1,15,0,0,2,7,1,59080,23587,4633,31125,0
356,7161,2,2,2,0,0,0,2,0,0,0,0,0,0,0,0,0,0,0,0,2,27,5,59090,23591,4634,31132,0
356,7161,99,48,90,1,3,5,100,0,0,0,0,0,0,0,0,0,0,0,0,2,27,5,59090,23592,4634,31133,0
356,7161,8,5,5,2,0,1,10,0,0,0,0,0,0,0,0,0,0,0,0,2,27,5,59090,23592,4634,31134,0
356,7161,1217,716,841,84,126,174,1301,14,185,118,215,199,333,1446,2542,8,20687,1149,0,2,27,5,59100,23594,4634,31135,0
356,7161,160,89,115,0,13,31,160,7,15,11,17,22,28,78,124,3,495,27,0,2,27,5,59100,23594,4634,31136,0
356,7161,10,10,9,9,0,0,19,0,0,0,0,0,0,0,0,0,0,0,0,2,27,5,59100,23594,4635,31137,0
356,7161,173,84,99,8,29,36,181,5,12,7,13,17,20,54,81,2,221,12,0,2,27,5,59100,23595,4635,31138,0
356,7161,3,1,1,3,0,0,6,0,0,0,0,0,0,0,0,0,0,0,0,2,27,5,59100,23595,4635,31139,0
262,5263,2,2,2,0,0,0,2,0,0,0,0,0,0,0,0,0,0,0,0,2,2,390,59100,23595,4635,31139,1
262,5263,99,48,90,1,3,5,100,0,0,0,0,0,0,0,0,0,0,0,0,2,2,390,59100,23596,4635,31140,1
262,5263,8,5,5,2,0,1,10,0,0,0,0,0,0,0,0,0,0,0,0,2,2,390,59100,23596,4635,31141,1
262,5263,1217,716,841,84,126,174,1301,14,185,118,215,199,333,1446,2542,8,20687,1149,0,2,2,390,59110,23598,4635,31142,1
262,5263,160,89,115,0,13,31,160,7,15,11,17,22,28,78,124,3,495,27,0,2,2,390,59110,23598,4635,31143,1
262,5263,10,10,9,9,0,0,19,0,0,0,0,0,0,0,0,0,0,0,0,2,2,390,59110,23598,4636,31144,1
262,5263,173,84,99,8,29,36,181,5,12,7,13,17,20,54,81,2,221,12,0,2,2,390,59110,23599,4636,31145,1
262,5263,3,1,1,3,0,0,6,0,0,0,0,0,0,0,0,0,0,0,0,2,2,390,59110,23599,4636,31146,1
94,1911,463,295,324,28,62,57,491,12,134,82,154,146,236,989,1696,6,11700,650,0,0,394,0,59120,23600,4636,31147,1
211,4544,2,2,2,0,0,0,2,0,0,0,0,0,0,0,0,0,0,0,0,2,2,147,59120,23600,4636,31147,1
211,4544,99,48,90,1,3,5,100,0,0,0,0,0,0,0,0,0,0,0,0,2,2,147,59120,23601,4636,31148,1
211,4544,8,5,5,2,0,1,10,0,0,0,0,0,0,0,0,0,0,0,0,2,2,147,59120,23601,4636,31149,1
211,4544,1217,716,841,84,126,174,1301,14,185,118,215,199,333,1446,2542,8,20687,1149,0,2,2,147,59130,23603,4636,31150,1
211,4544,160,89,115,0,13,31,160,7,15,11,17,22,28,78,124,3,495,27,0,2,2,147,59130,23603,4636,31151,1
211,4544,10,10,9,9,0,0,19,0,0,0,0,0,0,0,0,0,0,0,0,2,2,147,59130,23603,4637,31152,1
211,4544,173,84,99,8,29,36,181,5,12,7,13,17,20,54,81,2,221,12,0,2,2,147,59130,23604,4637,31153,1
211,4544,3,1,1,3,0,0,6,0,0,0,0,0,0,0,0,0,0,0,0,2,2,147,59130,23604,4637,31154,1
51,727,167,116,138,4,5,22,171,8,48,30,56,56,86,292,499,4,2330,129,0,0,140,0,59130,23604,4637,31155,1
125,5131,1513,682,1277,25,13,200,1538,11,199,116,219,210,335,1557,2584,6,15641,868,0,2,1,1,59130,23606,4637,31156,0
84,4436,1457,730,1242,11,6,188,1468,10,292,166,329,302,495,2424,4078,5,22973,1276,1,2,2,6,59130,23608,4637,31157,0
38,2304,334,251,279,10,4,40,344,5,127,74,143,132,217,899,1528,2,4303,239,0,2,1,1,59130,23609,4637,31158,0
209,4543,1943,715,1694,26,18,214,1969,12,185,120,237,197,357,1436,2721,7,20915,1161,0,2,2,2,59130,23611,4637,31159,0
209,4543,1168,838,957,57,25,144,1225,19,348,224,416,367,640,3018,5452,11,61921,3440,1,2,2,2,59140,23613,4637,31160,0
91,4584,1943,715,1694,26,18,214,1969,12,185,120,237,197,357,1436,2721,7,20915,1161,0,2,1,1,59140,23615,4637,31161,0
209,4543,1943,715,1694,26,18,214,1969,12,185,120,237,197,357,1436,2721,7,20915,1161,0,2,2,2,59140,23617,4637,31162,0
209,4543,1168,838,957,57,25,144,1225,19,348,224,416,367,640,3018,5452,11,61921,3440,1,2,2,2,59150,23619,4637,31163,0
91,4584,1943,715,1694,26,18,214,1969,12,185,120,237,197,357,1436,2721,7,20915,1161,0,2,1,1,59150,23621,4637,31164,0
10,379,42,7,35,4,0,5,46,1,2,1,2,3,3,2,4,0,2,0,0,2,1,21,59150,23621,4637,31165,0
10,379,11,6,10,0,0,1,11,2,4,2,4,6,6,10,15,1,15,0,0,2,1,21,59150,23621,4637,31166,0
10,379,42,7,35,4,0,5,46,1,2,1,2,3,3,2,4,0,2,0,0,2,1,21,59150,23621,4637,31167,0
10,379,11,6,10,0,0,1,11,2,4,2,4,6,6,10,15,1,15,0,0,2,1,21,59150,23621,4637,31168,0
115,2582,1043,504,840,53,9,147,1096,9,180,112,198,189,310,1377,2344,4,11604,644,0,2,1,0,59150,23623,4637,31169,0
115,2582,383,288,292,26,6,62,409,11,65,38,67,76,105,429,656,5,3719,206,0,2,1,0,59150,23624,4637,31170,0
79,3058,1043,504,840,53,9,147,1096,9,180,112,198,189,310,1377,2344,4,11604,644,0,2,1,1,59150,23626,4637,31171,0
115,2582,1043,504,840,53,9,147,1096,9,180,112,198,189,310,1377,2344,4,11604,644,0,2,1,0,59150,23628,4637,31172,0
115,2582,383,288,292,26,6,62,409,11,65,38,67,76,105,429,656,5,3719,206,0,2,1,0,59150,23629,4637,31173,0
79,3058,1043,504,840,53,9,147,1096,9,180,112,198,189,310,1377,2344,4,11604,644,0,2,1,1,59150,23631,4637,31174,0
115,2577,1043,504,840,53,9,147,1096,9,180,112,198,189,310,1377,2344,4,11604,644,0,2,0,1,59150,23633,4637,31175,0
115,2577,383,288,292,26,6,62,409,11,65,38,67,76,105,429,656,5,3719,206,0,2,0,1,59150,23634,4637,31176,0
79,3060,1043,504,840,53,9,147,1096,9,180,112,198,189,310,1377,2344,4,11604,644,0,2,1,1,59150,23636,4637,31177,0
209,4545,1943,715,1694,26,18,214,1969,12,185,120,237,197,357,1436,2721,7,20915,1161,0,2,1,1,59150,23638,4637,31178,0
209,4545,1168,838,957,57,25,144,1225,19,348,224,416,367,640,3018,5452,11,61921,3440,1,2,1,1,59160,23640,4637,31179,0
91,4597,1943,715,1694,26,18,214,1969,12,185,120,237,197,357,1436,2721,7,20915,1161,0,2,4,1,59160,23642,4637,31180,0
209,4545,1943,715,1694,26,18,214,1969,12,185,120,237,197,357,1436,2721,7,20915,1161,0,2,1,1,59160,23644,4637,31181,0
209,4545,1168,838,957,57,25,144,1225,19,348,224,416,367,640,3018,5452,11,61921,3440,1,2,1,1,59170,23646,4637,31182,0
91,4597,1943,715,1694,26,18,214,1969,12,185,120,237,197,357,1436,2721,7,20915,1161,0,2,4,1,59170,23648,4637,31183,0
172,7590,139,89,101,2,0,35,141,7,54,34,62,61,96,330,569,4,2287,127,0,2,2,2,59170,23648,4637,31184,1
172,7590,7,5,5,0,0,2,7,1,2,1,2,3,3,2,4,0,2,0,0,2,2,2,59170,23648,4637,31185,1
115,2577,1043,504,840,53,9,147,1096,9,180,112,198,189,310,1377,2344,4,11604,644,0,2,0,1,59170,23650,4637,31186,0
115,2577,383,288,292,26,6,62,409,11,65,38,67,76,105,429,656,5,3719,206,0,2,0,1,59170,23651,4637,31187,0
79,3060,1043,504,840,53,9,147,1096,9,180,112,198,189,310,1377,2344,4,11604,644,0,2,1,1,59170,23653,4637,31188,0
172,7590,139,89,101,2,0,35,141,7,54,34,62,61,96,330,569,4,2287,127,0,2,2,2,59170,23653,4637,31189,0
172,7590,7,5,5,0,0,2,7,1,2,1,2,3,3,2,4,0,2,0,0,2,2,2,59170,23653,4637,31190,0
118,2609,1043,504,840,53,9,147,1096,9,180,112,198,189,310,1377,2344,4,11604,644,0,2,10,1,59170,23655,4637,31191,1
118,2609,383,288,292,26,6,62,409,11,65,38,67,76,105,429,656,5,3719,206,0,2,10,1,59170,23656,4637,31192,1
82,3156,1043,504,840,53,9,147,1096,9,180,112,198,189,310,1377,2344,4,11604,644,0,2,17,0,59170,23658,4637,31193,1
82,3156,1043,504,840,53,9,147,1096,9,180,112,198,189,310,1377,2344,4,11604,644,0,2,1,0,59170,23660,4637,31194,0
82,3160,1043,504,840,53,9,147,1096,9,180,112,198,189,310,1377,2344,4,11604,644,0,2,1,1,59170,23662,4637,31195,0
118,2609,1043,504,840,53,9,147,1096,9,180,112,198,189,310,1377,2344,4,11604,644,0,2,10,1,59170,23664,4637,31196,0
118,2609,383,288,292,26,6,62,409,11,65,38,67,76,105,429,656,5,3719,206,0,2,10,1,59170,23665,4637,31197,0
82,3160,1043,504,840,53,9,147,1096,9,180,112,198,189,310,1377,2344,4,11604,644,0,2,18,0,59170,23667,4637,31198,0
82,1757,402,202,227,24,74,80,426,12,52,33,61,64,94,339,564,7,3969,220,0,2,8,1,59170,23668,4637,31199,1
72,1650,53,23,39,0,0,13,53,2,8,4,8,10,12,26,39,1,39,2,0,2,4,2,59170,23668,4637,31200,1
72,1650,515,298,307,33,80,99,548,12,63,44,77,75,121,419,753,7,5527,307,0,2,4,2,59180,23668,4637,31201,1
88,3885,1020,354,843,12,15,144,1032,8,134,77,144,142,221,970,1580,4,6792,377,0,2,10,1,59180,23668,4637,31202,1
82,1767,402,202,227,24,74,80,426,12,52,33,61,64,94,339,564,7,3969,220,0,2,5,1,59180,23669,4637,31203,1
72,1646,53,23,39,0,0,13,53,2,8,4,8,10,12,26,39,1,39,2,0,2,3,5,59180,23669,4637,31204,1
72,1646,515,298,307,33,80,99,548,12,63,44,77,75,121,419,753,7,5527,307,0,2,3,5,59190,23669,4637,31205,1
33,1004,465,148,393,5,8,60,470,4,31,20,31,35,51,161,261,2,523,29,0,2,3,0,59190,23670,4637,31206,0
33,1004,16,12,9,0,0,6,16,1,2,1,2,3,3,2,4,0,2,0,0,2,3,0,59190,23670,4637,31207,0
82,1767,402,202,227,24,74,80,426,12,52,33,61,64,94,339,564,7,3969,220,0,2,12,1,59190,23671,4637,31208,0
72,1646,53,23,39,0,0,13,53,2,8,4,8,10,12,26,39,1,39,2,0,2,3,3,59190,23671,4637,31209,0
72,1646,515,298,307,33,80,99,548,12,63,44,77,75,121,419,753,7,5527,307,0,2,3,3,59200,23671,4637,31210,0
33,1004,465,148,393,5,8,60,470,4,31,20,31,35,51,161,261,2,523,29,0,2,3,0,59200,23672,4637,31211,0
33,1004,16,12,9,0,0,6,16,1,2,1,2,3,3,2,4,0,2,0,0,2,3,0,59200,23672,4637,31212,0
88,3885,1020,354,843,12,15,144,1032,8,134,77,144,142,221,970,1580,4,6792,377,0,2,10,1,59200,23672,4637,31213,0
73,1667,53,23,39,0,0,13,53,2,8,4,8,10,12,26,39,1,39,2,0,2,7,2,59200,23672,4637,31214,0
73,1667,515,298,307,33,80,99,548,12,63,44,77,75,121,419,753,7,5527,307,0,2,7,2,59210,23672,4637,31215,0
90,3963,1020,354,843,12,15,144,1032,8,134,77,144,142,221,970,1580,4,6792,377,0,2,9,0,59210,23672,4637,31216,0
73,1667,53,23,39,0,0,13,53,2,8,4,8,10,12,26,39,1,39,2,0,2,4,3,59210,23672,4637,31217,1
73,1667,515,298,307,33,80,99,548,12,63,44,77,75,121,419,753,7,5527,307,0,2,4,3,59220,23672,4637,31218,1
73,1667,53,23,39,0,0,13,53,2,8,4,8,10,12,26,39,1,39,2,0,2,1,1,59220,23672,4637,31219,0
73,1667,515,298,307,33,80,99,548,12,63,44,77,75,121,419,753,7,5527,307,0,2,1,1,59230,23672,4637,31220,0
82,1767,402,202,227,24,74,80,426,12,52,33,61,64,94,339,564,7,3969,220,0,2,12,1,59230,23673,4637,31221,0
73,1667,53,23,39,0,0,13,53,2,8,4,8,10,12,26,39,1,39,2,0,2,10,4,59230,23673,4637,31222,0
73,1667,515,298,307,33,80,99,548,12,63,44,77,75,121,419,753,7,5527,307,0,2,10,4,59240,23673,4637,31223,0
33,1004,465,148,393,5,8,60,470,4,31,20,31,35,51,161,261,2,523,29,0,2,3,0,59240,23674,4637,31224,0
33,1004,16,12,9,0,0,6,16,1,2,1,2,3,3,2,4,0,2,0,0,2,3,0,59240,23674,4637,31225,0
90,3963,1020,354,843,12,15,144,1032,8,134,77,144,142,221,970,1580,4,6792,377,0,2,19,1,59240,23674,4637,31226,0
88,2248,773,422,505,30,103,129,803,14,77,46,83,91,129,535,839,7,6334,351,0,2,16,0,59250,23675,4638,31227,0
15,703,139,89,101,2,0,35,141,7,54,34,62,61,96,330,569,4,2287,127,0,2,21,0,59250,23675,4638,31228,0
88,2248,773,422,505,30,103,129,803,14,77,46,83,91,129,535,839,7,6334,351,0,2,16,0,59260,23676,4639,31229,0
15,703,139,89,101,2,0,35,141,7,54,34,62,61,96,330,569,4,2287,127,0,2,21,0,59260,23676,4639,31230,0
8,183,51,25,36,0,0,15,51,3,11,6,12,14,18,42,68,1,112,6,0,0,34,0,59260,23676,4639,31231,1
8,263,51,25,36,0,0,15,51,3,11,6,12,14,18,42,68,1,112,6,0,2,17,1,59260,23676,4639,31232,0
8,265,51,25,36,0,0,15,51,3,11,6,12,14,18,42,68,1,112,6,0,2,34,30,59260,23676,4639,31233,0
70,3212,1455,414,1257,16,76,112,1471,5,41,23,46,46,69,231,381,2,1069,59,0,2,16,0,59260,23677,4639,31234,1
85,2161,1455,414,1257,16,76,112,1471,5,41,23,46,46,69,231,381,2,1069,59,0,2,1,1,59260,23678,4639,31235,0
85,2161,669,365,481,22,61,110,691,15,103,63,122,118,185,747,1273,8,11311,628,0,2,1,1,59270,23678,4640,31236,0
10,382,42,7,35,4,0,5,46,1,2,1,2,3,3,2,4,0,2,0,0,2,7,1,59270,23678,4640,31237,0
10,382,11,6,10,0,0,1,11,2,4,2,4,6,6,10,15,1,15,0,0,2,7,1,59270,23678,4640,31238,0
211,4544,2,2,2,0,0,0,2,0,0,0,0,0,0,0,0,0,0,0,0,3,31,542,59270,23678,4640,31238,0
211,4544,99,48,90,1,3,5,100,0,0,0,0,0,0,0,0,0,0,0,0,3,31,542,59270,23679,4640,31239,0
211,4544,8,5,5,2,0,1,10,0,0,0,0,0,0,0,0,0,0,0,0,3,31,542,59270,23679,4640,31240,0
211,4544,1217,716,841,84,126,174,1301,14,185,118,215,199,333,1446,2542,8,20687,1149,0,3,31,542,59280,23681,4640,31241,0
211,4544,160,89,115,0,13,31,160,7,15,11,17,22,28,78,124,3,495,27,0,3,31,542,59280,23681,4640,31242,0
211,4544,10,10,9,9,0,0,19,0,0,0,0,0,0,0,0,0,0,0,0,3,31,542,59280,23681,4641,31243,0
211,4544,173,84,99,8,29,36,181,5,12,7,13,17,20,54,81,2,221,12,0,3,31,542,59280,23682,4641,31244,0
211,4544,3,1,1,3,0,0,6,0,0,0,0,0,0,0,0,0,0,0,0,3,31,542,59280,23682,4641,31245,0
94,1911,463,295,324,28,62,57,491,12,134,82,154,146,236,989,1696,6,11700,650,0,0,394,0,59290,23683,4641,31246,0
51,727,167,116,138,4,5,22,171,8,48,30,56,56,86,292,499,4,2330,129,0,0,140,0,59290,23683,4641,31247,0
125,5131,1513,682,1277,25,13,200,1538,11,199,116,219,210,335,1557,2584,6,15641,868,0,2,1,1,59290,23685,4641,31248,0
84,4436,1457,730,1242,11,6,188,1468,10,292,166,329,302,495,2424,4078,5,22973,1276,1,2,2,6,59290,23687,4641,31249,0
38,2304,334,251,279,10,4,40,344,5,127,74,143,132,217,899,1528,2,4303,239,0,2,1,1,59290,23688,4641,31250,0
8,265,51,25,36,0,0,15,51,3,11,6,12,14,18,42,68,1,112,6,0,0,54,0,59290,23688,4641,31251,0
78,1581,757,253,292,73,244,162,830,13,61,38,67,74,105,409,651,7,4654,258,0,2,1,1,59290,23689,4641,31252,0
46,956,386,256,301,16,9,68,402,4,59,35,69,63,104,355,621,2,1453,80,0,2,1,1,59290,23689,4641,31253,0
46,956,264,131,164,11,41,46,275,6,38,22,40,44,62,214,338,3,1068,59,0,2,1,1,59300,23689,4642,31254,0
78,1581,757,253,292,73,244,162,830,13,61,38,67,74,105,409,651,7,4654,258,0,2,1,1,59300,23690,4642,31255,0
46,956,386,256,301,16,9,68,402,4,59,35,69,63,104,355,621,2,1453,80,0,2,1,1,59300,23690,4642,31256,0
46,956,264,131,164,11,41,46,275,6,38,22,40,44,62,214,338,3,1068,59,0,2,1,1,59310,23690,4643,31257,0
85,2161,1455,414,1257,16,76,112,1471,5,41,23,46,46,69,231,381,2,1069,59,0,2,1,1,59310,23691,4643,31258,0
85,2161,669,365,481,22,61,110,691,15,103,63,122,118,185,747,1273,8,11311,628,0,2,1,1,59320,23691,4644,31259,0
70,3212,1455,414,1257,16,76,112,1471,5,41,23,46,46,69,231,381,2,1069,59,0,2,16,0,59320,23692,4644,31260,0
285,6275,72,33,56,0,4,12,72,1,1,1,1,2,2,0,2,0,1,0,0,2,2,4,59320,23692,4644,31261,0
285,6275,1454,835,1044,76,110,219,1530,17,275,158,296,292,454,2297,3718,9,34017,1889,1,2,2,4,59330,23693,4644,31262,0
285,6275,72,33,56,0,4,12,72,1,1,1,1,2,2,0,2,0,1,0,0,2,2,4,59330,23693,4644,31263,0
285,6275,1454,835,1044,76,110,219,1530,17,275,158,296,292,454,2297,3718,9,34017,1889,1,2,2,4,59340,23694,4644,31264,0
74,1755,996,429,845,24,10,117,1020,7,76,50,88,83,138,494,879,4,3565,198,0,2,16,0,59340,23696,4644,31265,1
74,1755,456,277,329,12,42,72,468,13,85,50,97,98,147,592,972,7,7212,400,0,2,16,0,59340,23696,4644,31266,1
74,1755,996,429,845,24,10,117,1020,7,76,50,88,83,138,494,879,4,3565,198,0,2,3,6,59340,23698,4644,31267,1
74,1755,456,277,329,12,42,72,468,13,85,50,97,98,147,592,972,7,7212,400,0,2,3,6,59340,23698,4644,31268,1
74,1755,996,429,845,24,10,117,1020,7,76,50,88,83,138,494,879,4,3565,198,0,2,5,2,59340,23700,4644,31269,0
74,1755,456,277,329,12,42,72,468,13,85,50,97,98,147,592,972,7,7212,400,0,2,5,2,59340,23700,4644,31270,0
74,1762,996,429,845,24,10,117,1020,7,76,50,88,83,138,494,879,4,3565,198,0,2,10,5,59340,23702,4644,31271,0
74,1762,456,277,329,12,42,72,468,13,85,50,97,98,147,592,972,7,7212,400,0,2,10,5,59340,23702,4644,31272,0
39,2970,996,429,845,24,10,117,1020,7,76,50,88,83,138,494,879,4,3565,198,0,2,29,1,59340,23704,4644,31273,0
82,1769,402,202,227,24,74,80,426,12,52,33,61,64,94,339,564,7,3969,220,0,2,2,1,59340,23705,4644,31274,0
82,1769,402,202,227,24,74,80,426,12,52,33,61,64,94,339,564,7,3969,220,0,2,2,1,59340,23706,4644,31275,0
74,1762,996,429,845,24,10,117,1020,7,76,50,88,83,138,494,879,4,3565,198,0,2,1,1,59340,23708,4644,31276,0
74,1762,456,277,329,12,42,72,468,13,85,50,97,98,147,592,972,7,7212,400,0,2,1,1,59340,23708,4644,31277,0
74,1762,996,429,845,24,10,117,1020,7,76,50,88,83,138,494,879,4,3565,198,0,2,21,0,59340,23710,4644,31278,0
74,1762,456,277,329,12,42,72,468,13,85,50,97,98,147,592,972,7,7212,400,0,2,21,0,59340,23710,4644,31279,0
39,2970,996,429,845,24,10,117,1020,7,76,50,88,83,138,494,879,4,3565,198,0,2,29,1,59340,23712,4644,31280,0
10,393,42,7,35,4,0,5,46,1,2,1,2,3,3,2,4,0,2,0,0,2,3,1,59340,23712,4644,31281,1
10,393,11,6,10,0,0,1,11,2,4,2,4,6,6,10,15,1,15,0,0,2,3,1,59340,23712,4644,31282,1
73,1672,996,429,845,24,10,117,1020,7,76,50,88,83,138,494,879,4,3565,198,0,2,48,53,59340,23714,4644,31283,1
73,1672,456,277,329,12,42,72,468,13,85,50,97,98,147,592,972,7,7212,400,0,2,48,53,59340,23714,4644,31284,1
58,1187,207,111,150,11,0,50,218,5,26,19,36,31,55,133,272,3,943,52,0,2,3,0,59340,23714,4644,31285,1
58,1187,410,198,237,31,55,97,441,11,63,38,72,74,110,414,683,6,4293,238,0,2,3,0,59350,23715,4645,31286,1
39,2971,996,429,845,24,10,117,1020,7,76,50,88,83,138,494,879,4,3565,198,0,2,3,1,59350,23717,4645,31287,1
2,71,167,116,138,4,5,22,171,8,48,30,56,56,86,292,499,4,2330,129,0,0,13,0,59350,23717,4645,31288,0
73,1672,996,429,845,24,10,117,1020,7,76,50,88,83,138,494,879,4,3565,198,0,2,2,2,59350,23719,4645,31289,0
73,1672,456,277,329,12,42,72,468,13,85,50,97,98,147,592,972,7,7212,400,0,2,2,2,59350,23719,4645,31290,0
58,1191,207,111,150,11,0,50,218,5,26,19,36,31,55,133,272,3,943,52,0,2,1,1,59350,23719,4645,31291,0
58,1191,410,198,237,31,55,97,441,11,63,38,72,74,110,414,683,6,4293,238,0,2,1,1,59360,23720,4646,31292,0
76,1730,996,429,845,24,10,117,1020,7,76,50,88,83,138,494,879,4,3565,198,0,2,12,12,59360,23722,4646,31293,0
76,1730,456,277,329,12,42,72,468,13,85,50,97,98,147,592,972,7,7212,400,0,2,12,12,59360,23722,4646,31294,0
11,410,42,7,35,4,0,5,46,1,2,1,2,3,3,2,4,0,2,0,0,2,4,2,59360,23722,4646,31295,0
11,410,11,6,10,0,0,1,11,2,4,2,4,6,6,10,15,1,15,0,0,2,4,2,59360,23722,4646,31296,0
58,1196,207,111,150,11,0,50,218,5,26,19,36,31,55,133,272,3,943,52,0,2,6,3,59360,23722,4646,31297,0
58,1196,410,198,237,31,55,97,441,11,63,38,72,74,110,414,683,6,4293,238,0,2,6,3,59370,23723,4647,31298,0
11,410,42,7,35,4,0,5,46,1,2,1,2,3,3,2,4,0,2,0,0,2,3,3,59370,23723,4647,31299,1
11,410,11,6,10,0,0,1,11,2,4,2,4,6,6,10,15,1,15,0,0,2,3,3,59370,23723,4647,31300,1
58,1196,207,111,150,11,0,50,218,5,26,19,36,31,55,133,272,3,943,52,0,2,1,1,59370,23723,4647,31301,1
58,1196,410,198,237,31,55,97,441,11,63,38,72,74,110,414,683,6,4293,238,0,2,1,1,59380,23724,4648,31302,1
76,1711,996,429,845,24,10,117,1020,7,76,50,88,83,138,494,879,4,3565,198,0,2,18,19,59380,23726,4648,31303,0
76,1711,456,277,329,12,42,72,468,13,85,50,97,98,147,592,972,7,7212,400,0,2,18,19,59380,23726,4648,31304,0
39,2971,996,429,845,24,10,117,1020,7,76,50,88,83,138,494,879,4,3565,198,0,2,2,2,59380,23728,4648,31305,0
74,1700,996,429,845,24,10,117,1020,7,76,50,88,83,138,494,879,4,3565,198,0,2,4,4,59380,23730,4648,31306,0
74,1700,456,277,329,12,42,72,468,13,85,50,97,98,147,592,972,7,7212,400,0,2,4,4,59380,23730,4648,31307,0
74,1693,996,429,845,24,10,117,1020,7,76,50,88,83,138,494,879,4,3565,198,0,2,1,1,59380,23732,4648,31308,0
74,1693,456,277,329,12,42,72,468,13,85,50,97,98,147,592,972,7,7212,400,0,2,1,1,59380,23732,4648,31309,0
164,5065,1660,832,1314,41,38,274,1701,20,312,209,395,332,604,2671,5058,12,64042,3557,1,2,10,0,59380,23734,4649,31311,0
164,5065,1057,646,719,113,100,145,1170,18,215,134,248,233,382,1740,3004,10,31186,1732,1,2,10,0,59390,23735,4650,31312,0
88,3896,1020,354,843,12,15,144,1032,8,134,77,144,142,221,970,1580,4,6792,377,0,2,5,1,59390,23735,4650,31313,0
164,5065,1660,832,1314,41,38,274,1701,20,312,209,395,332,604,2671,5058,12,64042,3557,1,2,10,0,59390,23737,4651,31315,0
164,5065,1057,646,719,113,100,145,1170,18,215,134,248,233,382,1740,3004,10,31186,1732,1,2,10,0,59400,23738,4652,31316,0
88,3896,1020,354,843,12,15,144,1032,8,134,77,144,142,221,970,1580,4,6792,377,0,2,5,1,59400,23738,4652,31317,0
11,410,42,7,35,4,0,5,46,1,2,1,2,3,3,2,4,0,2,0,0,2,4,0,59400,23738,4652,31318,0
11,410,11,6,10,0,0,1,11,2,4,2,4,6,6,10,15,1,15,0,0,2,4,0,59400,23738,4652,31319,0
74,1693,996,429,845,24,10,117,1020,7,76,50,88,83,138,494,879,4,3565,198,0,2,68,74,59400,23740,4652,31320,0
74,1693,456,277,329,12,42,72,468,13,85,50,97,98,147,592,972,7,7212,400,0,2,68,74,59400,23740,4652,31321,0
58,1196,207,111,150,11,0,50,218,5,26,19,36,31,55,133,272,3,943,52,0,2,7,1,59400,23740,4652,31322,0
58,1196,410,198,237,31,55,97,441,11,63,38,72,74,110,414,683,6,4293,238,0,2,7,1,59410,23741,4653,31323,0
2,71,167,116,138,4,5,22,171,8,48,30,56,56,86,292,499,4,2330,129,0,0,13,0,59410,23741,4653,31324,0
39,2971,996,429,845,24,10,117,1020,7,76,50,88,83,138,494,879,4,3565,198,0,2,5,3,59410,23743,4653,31325,0
78,1601,757,253,292,73,244,162,830,13,61,38,67,74,105,409,651,7,4654,258,0,2,5,3,59410,23744,4653,31326,0
56,3691,520,294,400,33,13,81,553,10,261,204,367,271,571,2128,4614,7,32445,1802,1,2,17,2,59410,23745,4653,31327,0
78,1601,757,253,292,73,244,162,830,13,61,38,67,74,105,409,651,7,4654,258,0,2,5,3,59410,23746,4653,31328,0
56,3691,520,294,400,33,13,81,553,10,261,204,367,271,571,2128,4614,7,32445,1802,1,2,17,2,59410,23747,4653,31329,0
60,1081,282,196,195,3,0,86,285,8,130,71,141,138,212,936,1507,4,6538,363,0,2,0,17,59410,23747,4654,31330,1
1,90,13,10,10,0,0,3,13,1,2,1,2,3,3,2,4,0,2,0,0,2,1,1,59410,23747,4654,31331,1
7,114,44,19,17,0,16,11,44,3,14,7,14,17,21,58,85,1,128,7,0,2,0,1,59410,23747,4654,31332,1
3,66,127,75,83,2,11,30,129,4,14,7,14,18,21,61,87,2,175,9,0,2,0,1,59410,23747,4654,31333,1
3,66,652,304,544,16,6,88,668,6,89,51,101,95,152,591,998,3,3399,188,0,2,0,1,59410,23748,4654,31334,1
3,66,2,2,2,0,0,0,2,0,0,0,0,0,0,0,0,0,0,0,0,2,0,1,59410,23748,4654,31334,1
3,66,8,5,5,0,0,3,8,0,0,0,0,0,0,0,0,0,0,0,0,2,0,1,59410,23748,4654,31335,1
3,66,2,2,2,0,0,0,2,0,0,0,0,0,0,0,0,0,0,0,0,2,0,1,59410,23748,4654,31335,1
3,66,14,8,8,0,0,6,14,0,0,0,0,0,0,0,0,0,0,0,0,2,0,1,59410,23748,4654,31336,1
3,66,6,4,4,0,0,2,6,0,0,0,0,0,0,0,0,0,0,0,0,2,0,1,59410,23748,4654,31337,1
3,66,6,4,4,0,0,2,6,1,2,1,2,3,3,2,4,0,2,0,0,2,0,1,59410,23748,4654,31338,1
3,66,6,4,4,0,0,2,6,0,0,0,0,0,0,0,0,0,0,0,0,2,0,1,59410,23748,4654,31339,1
3,66,7,5,5,0,0,2,7,0,0,0,0,0,0,0,0,0,0,0,0,2,0,1,59410,23748,4654,31340,1
3,66,6,4,4,0,0,2,6,0,0,0,0,0,0,0,0,0,0,0,0,2,0,1,59410,23748,4654,31341,1
3,66,10,6,6,0,0,4,10,0,0,0,0,0,0,0,0,0,0,0,0,2,0,1,59410,23748,4654,31342,1
3,66,1,1,1,0,0,0,1,0,0,0,0,0,0,0,0,0,0,0,0,2,0,1,59410,23748,4654,31342,1
3,66,14,10,10,0,0,4,14,1,1,1,1,2,2,0,2,0,1,0,0,2,0,1,59410,23748,4654,31343,1
3,66,46,26,30,3,0,12,49,3,6,3,6,9,9,20,28,1,42,2,0,2,0,1,59420,23748,4654,31344,1
7,298,72,33,56,0,4,12,72,1,1,1,1,2,2,0,2,0,1,0,0,2,0,1,59420,23748,4654,31345,1
12,229,127,75,83,2,11,30,129,4,14,7,14,18,21,61,87,2,175,9,0,2,0,2,59420,23748,4654,31346,1
12,229,652,304,544,16,6,88,668,6,89,51,101,95,152,591,998,3,3399,188,0,2,0,2,59420,23749,4654,31347,1
12,229,2,2,2,0,0,0,2,0,0,0,0,0,0,0,0,0,0,0,0,2,0,2,59420,23749,4654,31347,1
12,229,8,5,5,0,0,3,8,0,0,0,0,0,0,0,0,0,0,0,0,2,0,2,59420,23749,4654,31348,1
12,229,2,2,2,0,0,0,2,0,0,0,0,0,0,0,0,0,0,0,0,2,0,2,59420,23749,4654,31348,1
12,229,14,8,8,0,0,6,14,0,0,0,0,0,0,0,0,0,0,0,0,2,0,2,59420,23749,4654,31349,1
12,229,6,4,4,0,0,2,6,0,0,0,0,0,0,0,0,0,0,0,0,2,0,2,59420,23749,4654,31350,1
12,229,6,4,4,0,0,2,6,1,2,1,2,3,3,2,4,0,2,0,0,2,0,2,59420,23749,4654,31351,1
12,229,6,4,4,0,0,2,6,0,0,0,0,0,0,0,0,0,0,0,0,2,0,2,59420,23749,4654,31352,1
12,229,7,5,5,0,0,2,7,0,0,0,0,0,0,0,0,0,0,0,0,2,0,2,59420,23749,4654,31353,1
12,229,6,4,4,0,0,2,6,0,0,0,0,0,0,0,0,0,0,0,0,2,0,2,59420,23749,4654,31354,1
12,229,10,6,6,0,0,4,10,0,0,0,0,0,0,0,0,0,0,0,0,2,0,2,59420,23749,4654,31355,1
12,229,1,1,1,0,0,0,1,0,0,0,0,0,0,0,0,0,0,0,0,2,0,2,59420,23749,4654,31355,1
12,229,14,10,10,0,0,4,14,1,1,1,1,2,2,0,2,0,1,0,0,2,0,2,59420,23749,4654,31356,1
12,229,46,26,30,3,0,12,49,3,6,3,6,9,9,20,28,1,42,2,0,2,0,2,59430,23749,4654,31357,1
6,71,127,75,83,2,11,30,129,4,14,7,14,18,21,61,87,2,175,9,0,2,0,1,59430,23749,4654,31358,1
6,71,652,304,544,16,6,88,668,6,89,51,101,95,152,591,998,3,3399,188,0,2,0,1,59430,23750,4654,31359,1
6,71,2,2,2,0,0,0,2,0,0,0,0,0,0,0,0,0,0,0,0,2,0,1,59430,23750,4654,31359,1
6,71,8,5,5,0,0,3,8,0,0,0,0,0,0,0,0,0,0,0,0,2,0,1,59430,23750,4654,31360,1
6,71,2,2,2,0,0,0,2,0,0,0,0,0,0,0,0,0,0,0,0,2,0,1,59430,23750,4654,31360,1
6,71,14,8,8,0,0,6,14,0,0,0,0,0,0,0,0,0,0,0,0,2,0,1,59430,23750,4654,31361,1
6,71,6,4,4,0,0,2,6,0,0,0,0,0,0,0,0,0,0,0,0,2,0,1,59430,23750,4654,31362,1
6,71,6,4,4,0,0,2,6,1,2,1,2,3,3,2,4,0,2,0,0,2,0,1,59430,23750,4654,31363,1
6,71,6,4,4,0,0,2,6,0,0,0,0,0,0,0,0,0,0,0,0,2,0,1,59430,23750,4654,31364,1
6,71,7,5,5,0,0,2,7,0,0,0,0,0,0,0,0,0,0,0,0,2,0,1,59430,23750,4654,31365,1
6,71,6,4,4,0,0,2,6,0,0,0,0,0,0,0,0,0,0,0,0,2,0,1,59430,23750,4654,31366,1
6,71,10,6,6,0,0,4,10,0,0,0,0,0,0,0,0,0,0,0,0,2,0,1,59430,23750,4654,31367,1
6,71,1,1,1,0,0,0,1,0,0,0,0,0,0,0,0,0,0,0,0,2,0,1,59430,23750,4654,31367,1
6,71,14,10,10,0,0,4,14,1,1,1,1,2,2,0,2,0,1,0,0,2,0,1,59430,23750,4654,31368,1
6,71,46,26,30,3,0,12,49,3,6,3,6,9,9,20,28,1,42,2,0,2,0,1,59440,23750,4654,31369,1
3,26,14,7,7,2,0,5,16,0,0,0,0,0,0,0,0,0,0,0,0,2,0,1,59440,23750,4654,31369,1
213,4619,182,127,129,0,0,53,182,5,39,21,42,44,63,217,343,2,926,51,0,2,20,19,59440,23750,4655,31370,1
213,4619,1165,710,800,67,119,181,1232,18,243,153,282,261,435,2000,3492,10,36473,2026,1,2,20,19,59450,23750,4656,31371,1
83,1808,773,419,590,28,0,166,801,10,204,113,217,214,330,1598,2554,5,13587,754,0,2,4,3,59450,23750,4657,31372,1
83,1808,421,273,302,44,34,57,465,17,81,59,107,98,166,583,1098,11,12329,684,0,2,4,3,59450,23750,4658,31373,1
164,5065,1660,832,1314,41,38,274,1701,20,312,209,395,332,604,2671,5058,12,64042,3557,1,2,1,1,59450,23752,4659,31375,1
164,5065,1057,646,719,113,100,145,1170,18,215,134,248,233,382,1740,3004,10,31186,1732,1,2,1,1,59460,23753,4660,31376,1
89,1830,477,336,357,30,23,73,507,16,194,134,250,210,384,1538,2962,10,30538,1696,0,2,1,1,59470,23754,4660,31377,1
71,1702,996,429,845,24,10,117,1020,7,76,50,88,83,138,494,879,4,3565,198,0,2,1,4,59470,23756,4660,31378,1
71,1702,456,277,329,12,42,72,468,13,85,50,97,98,147,592,972,7,7212,400,0,2,1,4,59470,23756,4660,31379,1
145,3016,1513,682,1277,25,13,200,1538,11,199,116,219,210,335,1557,2584,6,15641,868,0,2,0,2,59470,23758,4660,31380,1
145,3016,819,519,539,24,98,155,843,15,96,57,106,111,163,690,1107,8,9171,509,0,2,0,2,59480,23760,4660,31381,1
58,1174,207,111,150,11,0,50,218,5,26,19,36,31,55,133,272,3,943,52,0,2,5,15,59480,23760,4660,31382,1
58,1174,410,198,237,31,55,97,441,11,63,38,72,74,110,414,683,6,4293,238,0,2,5,15,59490,23761,4661,31383,1
211,4551,2,2,2,0,0,0,2,0,0,0,0,0,0,0,0,0,0,0,0,2,15,10,59490,23761,4661,31383,1
211,4551,99,48,90,1,3,5,100,0,0,0,0,0,0,0,0,0,0,0,0,2,15,10,59490,23762,4661,31384,1
211,4551,8,5,5,2,0,1,10,0,0,0,0,0,0,0,0,0,0,0,0,2,15,10,59490,23762,4661,31385,1
211,4551,1217,716,841,84,126,174,1301,14,185,118,215,199,333,1446,2542,8,20687,1149,0,2,15,10,59500,23764,4661,31386,1
211,4551,160,89,115,0,13,31,160,7,15,11,17,22,28,78,124,3,495,27,0,2,15,10,59500,23764,4661,31387,1
211,4551,10,10,9,9,0,0,19,0,0,0,0,0,0,0,0,0,0,0,0,2,15,10,59500,23764,4662,31388,1
211,4551,173,84,99,8,29,36,181,5,12,7,13,17,20,54,81,2,221,12,0,2,15,10,59500,23765,4662,31389,1
211,4551,3,1,1,3,0,0,6,0,0,0,0,0,0,0,0,0,0,0,0,2,15,10,59500,23765,4662,31390,1
94,1909,463,295,324,28,62,57,491,12,134,82,154,146,236,989,1696,6,11700,650,0,2,3,5,59510,23766,4662,31391,1
51,727,167,116,138,4,5,22,171,8,48,30,56,56,86,292,499,4,2330,129,0,2,0,1,59510,23766,4662,31392,1
28,810,339,213,244,17,9,65,356,10,42,26,48,52,74,259,421,5,2410,133,0,2,4,4,59520,23766,4662,31393,1
85,2161,1455,414,1257,16,76,112,1471,5,41,23,46,46,69,231,381,2,1069,59,0,2,3,12,59520,23767,4662,31395,1
85,2161,669,365,481,22,61,110,691,15,103,63,122,118,185,747,1273,8,11311,628,0,2,3,12,59530,23767,4663,31396,1
236,5392,4293,999,3693,19,54,507,4312,9,155,88,170,164,258,1156,1898,4,9368,520,0,2,6,8,59530,23769,4663,31397,1
236,5392,1482,859,1002,125,135,219,1607,16,219,134,251,235,385,1766,3032,9,27804,1544,1,2,6,8,59540,23770,4663,31398,1
27,959,74,35,59,1,0,14,75,3,14,7,14,17,21,58,85,1,128,7,0,2,1,1,59540,23771,4663,31399,1
27,959,245,125,200,5,7,34,250,7,30,17,34,37,51,166,265,3,1053,58,0,2,1,1,59550,23772,4663,31400,1
98,2661,1523,757,1297,19,12,193,1542,12,193,117,230,205,347,1508,2664,7,19053,1058,0,2,1,6,59560,23774,4663,31401,1
98,2661,701,378,504,33,58,109,734,13,110,68,126,123,194,794,1346,7,10027,557,0,2,1,6,59560,23775,4664,31402,1
86,2225,773,422,505,30,103,129,803,14,77,46,83,91,129,535,839,7,6334,351,0,2,1,3,59570,23776,4665,31403,1
122,2937,77,34,69,0,0,8,77,3,24,16,29,27,45,114,213,1,387,21,0,2,1,1,59570,23776,4665,31404,1
122,2937,712,438,573,51,9,84,763,14,102,71,128,116,199,733,1364,8,11988,666,0,2,1,1,59580,23777,4665,31405,1
30,658,125,97,103,3,0,19,128,9,25,17,27,34,44,144,223,4,1087,60,0,2,0,1,59580,23777,4666,31406,1
82,1776,402,202,227,24,74,80,426,12,52,33,61,64,94,339,564,7,3969,220,0,2,12,8,59580,23778,4666,31407,1
48,992,447,308,343,6,5,95,453,7,96,59,111,103,170,651,1136,4,4600,255,0,2,0,1,59580,23781,4666,31408,1
48,992,322,174,179,16,74,51,338,10,41,26,46,51,72,252,408,5,2291,127,0,2,0,1,59580,23784,4667,31409,1
72,1646,53,23,39,0,0,13,53,2,8,4,8,10,12,26,39,1,39,2,0,2,2,2,59580,23784,4667,31410,1
72,1646,515,298,307,33,80,99,548,12,63,44,77,75,121,419,753,7,5527,307,0,2,2,2,59590,23784,4667,31411,1
20,511,205,80,86,16,53,53,221,7,18,10,19,25,29,94,134,3,497,27,0,2,1,0,59600,23784,4668,31412,1
226,5306,722,423,573,19,0,135,741,12,172,101,199,184,300,1320,2257,6,15668,870,0,2,7,14,59600,23786,4668,31414,1
226,5306,1508,847,911,44,250,301,1552,14,148,88,169,162,257,1120,1886,7,15077,837,0,2,7,14,59600,23787,4669,31415,1
285,6283,72,33,56,0,4,12,72,1,1,1,1,2,2,0,2,0,1,0,0,2,14,15,59600,23787,4669,31416,1
285,6283,1454,835,1044,76,110,219,1530,17,275,158,296,292,454,2297,3718,9,34017,1889,1,2,14,15,59610,23788,4669,31417,1
78,1601,757,253,292,73,244,162,830,13,61,38,67,74,105,409,651,7,4654,258,0,2,2,4,59610,23789,4669,31418,1
46,954,386,256,301,16,9,68,402,4,59,35,69,63,104,355,621,2,1453,80,0,2,1,4,59610,23789,4669,31419,1
46,954,264,131,164,11,41,46,275,6,38,22,40,44,62,214,338,3,1068,59,0,2,1,4,59620,23789,4670,31420,1
30,650,215,129,180,6,0,29,221,8,65,43,72,73,115,415,711,4,3153,175,0,2,0,1,59620,23789,4670,31421,1
30,650,97,69,77,3,3,16,100,6,22,13,23,28,36,113,173,3,542,30,0,2,0,1,59620,23790,4670,31422,1
118,2612,1043,504,840,53,9,147,1096,9,180,112,198,189,310,1377,2344,4,11604,644,0,2,13,8,59620,23792,4670,31423,1
118,2612,383,288,292,26,6,62,409,11,65,38,67,76,105,429,656,5,3719,206,0,2,13,8,59620,23793,4670,31424,1
70,1382,1178,367,1042,6,15,115,1184,9,94,51,95,103,146,644,976,4,4439,246,0,2,5,4,59620,23793,4670,31425,1
70,1382,177,108,140,8,0,27,185,6,30,16,32,36,48,162,248,3,794,44,0,2,5,4,59620,23795,4670,31426,1
209,4552,1943,715,1694,26,18,214,1969,12,185,120,237,197,357,1436,2721,7,20915,1161,0,2,15,12,59620,23797,4670,31427,1
209,4552,1168,838,957,57,25,144,1225,19,348,224,416,367,640,3018,5452,11,61921,3440,1,2,15,12,59630,23799,4670,31428,1
62,1226,1098,241,925,5,10,155,1103,7,46,25,49,53,74,273,423,3,1580,87,0,2,5,7,59640,23801,4670,31429,1
62,1226,282,202,222,14,2,44,296,8,42,24,43,50,67,250,378,4,1548,86,0,2,5,7,59640,23802,4670,31430,1
22,458,601,196,481,2,23,85,603,8,63,36,72,71,108,400,664,4,3036,168,0,2,2,3,59640,23802,4670,31431,1
22,458,156,79,106,5,16,28,161,5,14,8,15,19,23,64,97,2,261,14,0,2,2,3,59640,23802,4670,31432,1
92,3868,1289,550,1043,56,32,155,1345,10,167,93,185,177,278,1266,2075,5,11498,638,0,2,4,7,59640,23804,4671,31433,1
36,1088,182,127,129,0,0,53,182,5,39,21,42,44,63,217,343,2,926,51,0,2,0,8,59640,23804,4672,31434,1
147,6910,1392,870,1177,35,17,170,1427,14,494,280,531,508,811,4473,7289,7,54850,3047,2,2,0,15,59640,23807,4673,31435,1
88,2881,773,419,590,28,0,166,801,10,204,113,217,214,330,1598,2554,5,13587,754,0,2,0,12,59640,23807,4674,31436,1
15,744,75,38,59,1,3,12,76,2,4,2,4,6,6,10,15,1,15,0,0,2,4,4,59640,23807,4674,31437,1
1,136,149,67,118,4,0,27,153,1,17,14,28,18,42,69,175,0,144,8,0,2,2,4,59640,23807,4674,31438,1
31,1986,1157,318,931,29,22,177,1186,6,104,63,125,110,188,712,1274,3,4596,255,0,2,20,15,59640,23807,4674,31439,1
56,3685,520,294,400,33,13,81,553,10,261,204,367,271,571,2128,4614,7,32445,1802,1,2,10,15,59640,23808,4674,31440,1
97,4403,1338,495,1086,10,64,173,1348,11,122,82,157,133,239,883,1686,7,11934,663,0,2,4,11,59640,23810,4674,31441,1
172,7588,139,89,101,2,0,35,141,7,54,34,62,61,96,330,569,4,2287,127,0,2,12,30,59640,23810,4674,31442,1
172,7588,7,5,5,0,0,2,7,1,2,1,2,3,3,2,4,0,2,0,0,2,12,30,59640,23810,4674,31443,1
33,1004,465,148,393,5,8,60,470,4,31,20,31,35,51,161,261,2,523,29,0,2,0,8,59640,23811,4674,31444,1
33,1004,16,12,9,0,0,6,16,1,2,1,2,3,3,2,4,0,2,0,0,2,0,8,59640,23811,4674,31445,1
139,5895,1782,648,1425,9,47,279,1791,8,171,97,189,179,286,1292,2140,4,9462,525,0,2,28,58,59640,23812,4675,31446,1
25,684,256,139,192,9,7,47,265,4,23,12,24,27,36,112,171,2,357,19,0,2,0,5,59640,23813,4675,31447,1
23,578,102,59,69,5,3,24,107,6,22,15,28,28,43,113,206,3,789,43,0,2,0,1,59640,23813,4675,31448,1
111,4174,1450,624,1228,12,26,181,1462,14,306,186,354,320,540,2580,4493,8,36391,2021,1,2,12,25,59640,23815,4676,31449,1
154,4337,1660,832,1314,41,38,274,1701,20,312,209,395,332,604,2671,5058,12,64042,3557,1,2,4,30,59640,23817,4677,31451,1
36,2870,996,429,845,24,10,117,1020,7,76,50,88,83,138,494,879,4,3565,198,0,2,11,16,59640,23819,4677,31452,1
125,5131,1513,682,1277,25,13,200,1538,11,199,116,219,210,335,1557,2584,6,15641,868,0,2,0,6,59640,23821,4677,31453,1
73,3803,1296,573,1062,40,33,157,1336,8,201,118,231,209,349,1561,2689,4,12365,686,0,2,0,11,59640,23821,4677,31454,1
14,341,207,111,150,11,0,50,218,5,26,19,36,31,55,133,272,3,943,52,0,2,0,4,59640,23821,4677,31455,1
84,4438,1457,730,1242,11,6,188,1468,10,292,166,329,302,495,2424,4078,5,22973,1276,1,2,3,14,59640,23823,4677,31456,1
39,2323,652,304,544,16,6,88,668,6,89,51,101,95,152,591,998,3,3399,188,0,2,0,4,59640,23824,4677,31457,1
70,3212,1455,414,1257,16,76,112,1471,5,41,23,46,46,69,231,381,2,1069,59,0,2,0,4,59640,23825,4677,31458,1
95,4652,1523,757,1297,19,12,193,1542,12,193,117,230,205,347,1508,2664,7,19053,1058,0,2,9,16,59650,23827,4677,31459,1
88,3896,1020,354,843,12,15,144,1032,8,134,77,144,142,221,970,1580,4,6792,377,0,2,0,6,59650,23827,4677,31460,1
38,1676,447,308,343,6,5,95,453,7,96,59,111,103,170,651,1136,4,4600,255,0,2,0,4,59650,23830,4677,31461,1
21,658,424,94,331,4,0,89,428,1,5,5,5,6,10,11,25,0,12,0,0,2,0,1,59650,23831,4677,31462,1
38,2302,334,251,279,10,4,40,344,5,127,74,143,132,217,899,1528,2,4303,239,0,2,5,14,59650,23832,4677,31463,1
12,493,184,100,137,2,15,30,186,6,38,20,39,44,59,214,322,3,991,55,0,2,0,3,59650,23833,4677,31464,1
59,2582,1293,570,1093,25,15,163,1318,10,195,123,241,205,364,1516,2795,6,17273,959,0,2,0,4,59660,23835,4677,31465,1
33,1883,384,251,317,7,8,52,391,11,70,44,84,81,128,467,811,6,5355,297,0,2,0,8,59660,23835,4677,31466,1
45,2209,722,423,573,19,0,135,741,12,172,101,199,184,300,1320,2257,6,15668,870,0,2,2,7,59660,23837,4677,31468,1
39,1727,386,256,301,16,9,68,402,4,59,35,69,63,104,355,621,2,1453,80,0,2,0,2,59660,23837,4677,31469,1
82,3157,1043,504,840,53,9,147,1096,9,180,112,198,189,310,1377,2344,4,11604,644,0,2,9,17,59660,23839,4677,31470,1
30,1241,373,158,315,8,0,51,381,5,76,44,79,81,123,486,779,2,2026,112,0,2,0,2,59660,23839,4677,31471,1
77,3213,1178,367,1042,6,15,115,1184,9,94,51,95,103,146,644,976,4,4439,246,0,2,4,7,59660,23839,4677,31472,1
91,4597,1943,715,1694,26,18,214,1969,12,185,120,237,197,357,1436,2721,7,20915,1161,0,2,0,8,59660,23841,4677,31473,1
14,826,442,244,305,14,16,103,456,11,68,45,75,79,120,452,756,6,4588,254,0,2,0,2,59660,23843,4677,31474,1
49,1838,1098,241,925,5,10,155,1103,7,46,25,49,53,74,273,423,3,1580,87,0,2,0,1,59670,23845,4677,31475,1
19,680,601,196,481,2,23,85,603,8,63,36,72,71,108,400,664,4,3036,168,0,2,2,3,59670,23845,4677,31476,1
88,2881,773,419,590,28,0,166,801,10,204,113,217,214,330,1598,2554,5,13587,754,0,2,2,2,59670,23845,4678,31477,0
60,1081,282,196,195,3,0,86,285,8,130,71,141,138,212,936,1507,4,6538,363,0,2,0,17,59670,23845,4679,31478,0
1,90,13,10,10,0,0,3,13,1,2,1,2,3,3,2,4,0,2,0,0,2,1,1,59670,23845,4679,31479,0
7,114,44,19,17,0,16,11,44,3,14,7,14,17,21,58,85,1,128,7,0,2,0,1,59670,23845,4679,31480,0
3,66,127,75,83,2,11,30,129,4,14,7,14,18,21,61,87,2,175,9,0,2,0,1,59670,23845,4679,31481,0
3,66,652,304,544,16,6,88,668,6,89,51,101,95,152,591,998,3,3399,188,0,2,0,1,59670,23846,4679,31482,0
3,66,2,2,2,0,0,0,2,0,0,0,0,0,0,0,0,0,0,0,0,2,0,1,59670,23846,4679,31482,0
3,66,8,5,5,0,0,3,8,0,0,0,0,0,0,0,0,0,0,0,0,2,0,1,59670,23846,4679,31483,0
3,66,2,2,2,0,0,0,2,0,0,0,0,0,0,0,0,0,0,0,0,2,0,1,59670,23846,4679,31483,0
3,66,14,8,8,0,0,6,14,0,0,0,0,0,0,0,0,0,0,0,0,2,0,1,59670,23846,4679,31484,0
3,66,6,4,4,0,0,2,6,0,0,0,0,0,0,0,0,0,0,0,0,2,0,1,59670,23846,4679,31485,0
3,66,6,4,4,0,0,2,6,1,2,1,2,3,3,2,4,0,2,0,0,2,0,1,59670,23846,4679,31486,0
3,66,6,4,4,0,0,2,6,0,0,0,0,0,0,0,0,0,0,0,0,2,0,1,59670,23846,4679,31487,0
3,66,7,5,5,0,0,2,7,0,0,0,0,0,0,0,0,0,0,0,0,2,0,1,59670,23846,4679,31488,0
3,66,6,4,4,0,0,2,6,0,0,0,0,0,0,0,0,0,0,0,0,2,0,1,59670,23846,4679,31489,0
3,66,10,6,6,0,0,4,10,0,0,0,0,0,0,0,0,0,0,0,0,2,0,1,59670,23846,4679,31490,0
3,66,1,1,1,0,0,0,1,0,0,0,0,0,0,0,0,0,0,0,0,2,0,1,59670,23846,4679,31490,0
3,66,14,10,10,0,0,4,14,1,1,1,1,2,2,0,2,0,1,0,0,2,0,1,59670,23846,4679,31491,0
3,66,46,26,30,3,0,12,49,3,6,3,6,9,9,20,28,1,42,2,0,2,0,1,59680,23846,4679,31492,0
7,298,72,33,56,0,4,12,72,1,1,1,1,2,2,0,2,0,1,0,0,2,0,1,59680,23846,4679,31493,0
12,229,127,75,83,2,11,30,129,4,14,7,14,18,21,61,87,2,175,9,0,2,0,2,59680,23846,4679,31494,0
12,229,652,304,544,16,6,88,668,6,89,51,101,95,152,591,998,3,3399,188,0,2,0,2,59680,23847,4679,31495,0
12,229,2,2,2,0,0,0,2,0,0,0,0,0,0,0,0,0,0,0,0,2,0,2,59680,23847,4679,31495,0
12,229,8,5,5,0,0,3,8,0,0,0,0,0,0,0,0,0,0,0,0,2,0,2,59680,23847,4679,31496,0
12,229,2,2,2,0,0,0,2,0,0,0,0,0,0,0,0,0,0,0,0,2,0,2,59680,23847,4679,31496,0
12,229,14,8,8,0,0,6,14,0,0,0,0,0,0,0,0,0,0,0,0,2,0,2,59680,23847,4679,31497,0
12,229,6,4,4,0,0,2,6,0,0,0,0,0,0,0,0,0,0,0,0,2,0,2,59680,23847,4679,31498,0
12,229,6,4,4,0,0,2,6,1,2,1,2,3,3,2,4,0,2,0,0,2,0,2,59680,23847,4679,31499,0
12,229,6,4,4,0,0,2,6,0,0,0,0,0,0,0,0,0,0,0,0,2,0,2,59680,23847,4679,31500,0
12,229,7,5,5,0,0,2,7,0,0,0,0,0,0,0,0,0,0,0,0,2,0,2,59680,23847,4679,31501,0
12,229,6,4,4,0,0,2,6,0,0,0,0,0,0,0,0,0,0,0,0,2,0,2,59680,23847,4679,31502,0
12,229,10,6,6,0,0,4,10,0,0,0,0,0,0,0,0,0,0,0,0,2,0,2,59680,23847,4679,31503,0
12,229,1,1,1,0,0,0,1,0,0,0,0,0,0,0,0,0,0,0,0,2,0,2,59680,23847,4679,31503,0
12,229,14,10,10,0,0,4,14,1,1,1,1,2,2,0,2,0,1,0,0,2,0,2,59680,23847,4679,31504,0
12,229,46,26,30,3,0,12,49,3,6,3,6,9,9,20,28,1,42,2,0,2,0,2,59690,23847,4679,31505,0
6,71,127,75,83,2,11,30,129,4,14,7,14,18,21,61,87,2,175,9,0,2,0,1,59690,23847,4679,31506,0
6,71,652,304,544,16,6,88,668,6,89,51,101,95,152,591,998,3,3399,188,0,2,0,1,59690,23848,4679,31507,0
6,71,2,2,2,0,0,0,2,0,0,0,0,0,0,0,0,0,0,0,0,2,0,1,59690,23848,4679,31507,0
6,71,8,5,5,0,0,3,8,0,0,0,0,0,0,0,0,0,0,0,0,2,0,1,59690,23848,4679,31508,0
6,71,2,2,2,0,0,0,2,0,0,0,0,0,0,0,0,0,0,0,0,2,0,1,59690,23848,4679,31508,0
6,71,14,8,8,0,0,6,14,0,0,0,0,0,0,0,0,0,0,0,0,2,0,1,59690,23848,4679,31509,0
6,71,6,4,4,0,0,2,6,0,0,0,0,0,0,0,0,0,0,0,0,2,0,1,59690,23848,4679,31510,0
6,71,6,4,4,0,0,2,6,1,2,1,2,3,3,2,4,0,2,0,0,2,0,1,59690,23848,4679,31511,0
6,71,6,4,4,0,0,2,6,0,0,0,0,0,0,0,0,0,0,0,0,2,0,1,59690,23848,4679,31512,0
6,71,7,5,5,0,0,2,7,0,0,0,0,0,0,0,0,0,0,0,0,2,0,1,59690,23848,4679,31513,0
6,71,6,4,4,0,0,2,6,0,0,0,0,0,0,0,0,0,0,0,0,2,0,1,59690,23848,4679,31514,0
6,71,10,6,6,0,0,4,10,0,0,0,0,0,0,0,0,0,0,0,0,2,0,1,59690,23848,4679,31515,0
6,71,1,1,1,0,0,0,1,0,0,0,0,0,0,0,0,0,0,0,0,2,0,1,59690,23848,4679,31515,0
6,71,14,10,10,0,0,4,14,1,1,1,1,2,2,0,2,0,1,0,0,2,0,1,59690,23848,4679,31516,0
6,71,46,26,30,3,0,12,49,3,6,3,6,9,9,20,28,1,42,2,0,2,0,1,59700,23848,4679,31517,0
3,26,14,7,7,2,0,5,16,0,0,0,0,0,0,0,0,0,0,0,0,2,0,1,59700,23848,4679,31517,0
213,4619,182,127,129,0,0,53,182,5,39,21,42,44,63,217,343,2,926,51,0,2,20,19,59700,23848,4680,31518,0
213,4619,1165,710,800,67,119,181,1232,18,243,153,282,261,435,2000,3492,10,36473,2026,1,2,20,19,59710,23848,4681,31519,0
83,1808,773,419,590,28,0,166,801,10,204,113,217,214,330,1598,2554,5,13587,754,0,2,4,3,59710,23848,4682,31520,0
83,1808,421,273,302,44,34,57,465,17,81,59,107,98,166,583,1098,11,12329,684,0,2,4,3,59710,23848,4683,31521,0
164,5065,1660,832,1314,41,38,274,1701,20,312,209,395,332,604,2671,5058,12,64042,3557,1,2,1,1,59710,23850,4684,31523,0
164,5065,1057,646,719,113,100,145,1170,18,215,134,248,233,382,1740,3004,10,31186,1732,1,2,1,1,59720,23851,4685,31524,0
89,1830,477,336,357,30,23,73,507,16,194,134,250,210,384,1538,2962,10,30538,1696,0,2,1,1,59730,23852,4685,31525,0
71,1702,996,429,845,24,10,117,1020,7,76,50,88,83,138,494,879,4,3565,198,0,2,1,4,59730,23854,4685,31526,0
71,1702,456,277,329,12,42,72,468,13,85,50,97,98,147,592,972,7,7212,400,0,2,1,4,59730,23854,4685,31527,0
145,3016,1513,682,1277,25,13,200,1538,11,199,116,219,210,335,1557,2584,6,15641,868,0,2,0,2,59730,23856,4685,31528,0
145,3016,819,519,539,24,98,155,843,15,96,57,106,111,163,690,1107,8,9171,509,0,2,0,2,59740,23858,4685,31529,0
58,1174,207,111,150,11,0,50,218,5,26,19,36,31,55,133,272,3,943,52,0,2,5,15,59740,23858,4685,31530,0
58,1174,410,198,237,31,55,97,441,11,63,38,72,74,110,414,683,6,4293,238,0,2,5,15,59750,23859,4686,31531,0
211,4551,2,2,2,0,0,0,2,0,0,0,0,0,0,0,0,0,0,0,0,2,15,10,59750,23859,4686,31531,0
211,4551,99,48,90,1,3,5,100,0,0,0,0,0,0,0,0,0,0,0,0,2,15,10,59750,23860,4686,31532,0
211,4551,8,5,5,2,0,1,10,0,0,0,0,0,0,0,0,0,0,0,0,2,15,10,59750,23860,4686,31533,0
211,4551,1217,716,841,84,126,174,1301,14,185,118,215,199,333,1446,2542,8,20687,1149,0,2,15,10,59760,23862,4686,31534,0
211,4551,160,89,115,0,13,31,160,7,15,11,17,22,28,78,124,3,495,27,0,2,15,10,59760,23862,4686,31535,0
211,4551,10,10,9,9,0,0,19,0,0,0,0,0,0,0,0,0,0,0,0,2,15,10,59760,23862,4687,31536,0
211,4551,173,84,99,8,29,36,181,5,12,7,13,17,20,54,81,2,221,12,0,2,15,10,59760,23863,4687,31537,0
211,4551,3,1,1,3,0,0,6,0,0,0,0,0,0,0,0,0,0,0,0,2,15,10,59760,23863,4687,31538,0
94,1909,463,295,324,28,62,57,491,12,134,82,154,146,236,989,1696,6,11700,650,0,2,3,5,59770,23864,4687,31539,0
51,727,167,116,138,4,5,22,171,8,48,30,56,56,86,292,499,4,2330,129,0,2,0,1,59770,23864,4687,31540,0
28,810,339,213,244,17,9,65,356,10,42,26,48,52,74,259,421,5,2410,133,0,2,4,4,59780,23864,4687,31541,0
85,2161,1455,414,1257,16,76,112,1471,5,41,23,46,46,69,231,381,2,1069,59,0,2,3,12,59780,23865,4687,31543,0
85,2161,669,365,481,22,61,110,691,15,103,63,122,118,185,747,1273,8,11311,628,0,2,3,12,59790,23865,4688,31544,0
236,5392,4293,999,3693,19,54,507,4312,9,155,88,170,164,258,1156,1898,4,9368,520,0,2,6,8,59790,23867,4688,31545,0
236,5392,1482,859,1002,125,135,219,1607,16,219,134,251,235,385,1766,3032,9,27804,1544,1,2,6,8,59800,23868,4688,31546,0
27,959,74,35,59,1,0,14,75,3,14,7,14,17,21,58,85,1,128,7,0,2,1,1,59800,23869,4688,31547,0
27,959,245,125,200,5,7,34,250,7,30,17,34,37,51,166,265,3,1053,58,0,2,1,1,59810,23870,4688,31548,0
98,2661,1523,757,1297,19,12,193,1542,12,193,117,230,205,347,1508,2664,7,19053,1058,0,2,1,6,59820,23872,4688,31549,0
98,2661,701,378,504,33,58,109,734,13,110,68,126,123,194,794,1346,7,10027,557,0,2,1,6,59820,23873,4689,31550,0
86,2225,773,422,505,30,103,129,803,14,77,46,83,91,129,535,839,7,6334,351,0,2,1,3,59830,23874,4690,31551,0
122,2937,77,34,69,0,0,8,77,3,24,16,29,27,45,114,213,1,387,21,0,2,1,1,59830,23874,4690,31552,0
122,2937,712,438,573,51,9,84,763,14,102,71,128,116,199,733,1364,8,11988,666,0,2,1,1,59840,23875,4690,31553,0
30,658,125,97,103,3,0,19,128,9,25,17,27,34,44,144,223,4,1087,60,0,2,0,1,59840,23875,4691,31554,0
82,1776,402,202,227,24,74,80,426,12,52,33,61,64,94,339,564,7,3969,220,0,2,12,8,59840,23876,4691,31555,0
48,992,447,308,343,6,5,95,453,7,96,59,111,103,170,651,1136,4,4600,255,0,2,0,1,59840,23879,4691,31556,0
48,992,322,174,179,16,74,51,338,10,41,26,46,51,72,252,408,5,2291,127,0,2,0,1,59840,23882,4692,31557,0
72,1646,53,23,39,0,0,13,53,2,8,4,8,10,12,26,39,1,39,2,0,2,2,2,59840,23882,4692,31558,0
72,1646,515,298,307,33,80,99,548,12,63,44,77,75,121,419,753,7,5527,307,0,2,2,2,59850,23882,4692,31559,0
20,511,205,80,86,16,53,53,221,7,18,10,19,25,29,94,134,3,497,27,0,2,1,0,59860,23882,4693,31560,0
226,5306,722,423,573,19,0,135,741,12,172,101,199,184,300,1320,2257,6,15668,870,0,2,7,14,59860,23884,4693,31562,0
226,5306,1508,847,911,44,250,301,1552,14,148,88,169,162,257,1120,1886,7,15077,837,0,2,7,14,59860,23885,4694,31563,0
285,6283,72,33,56,0,4,12,72,1,1,1,1,2,2,0,2,0,1,0,0,2,14,15,59860,23885,4694,31564,0
285,6283,1454,835,1044,76,110,219,1530,17,275,158,296,292,454,2297,3718,9,34017,1889,1,2,14,15,59870,23886,4694,31565,0
78,1601,757,253,292,73,244,162,830,13,61,38,67,74,105,409,651,7,4654,258,0,2,2,4,59870,23887,4694,31566,0
46,954,386,256,301,16,9,68,402,4,59,35,69,63,104,355,621,2,1453,80,0,2,1,4,59870,23887,4694,31567,0
46,954,264,131,164,11,41,46,275,6,38,22,40,44,62,214,338,3,1068,59,0,2,1,4,59880,23887,4695,31568,0
30,650,215,129,180,6,0,29,221,8,65,43,72,73,115,415,711,4,3153,175,0,2,0,1,59880,23887,4695,31569,0
30,650,97,69,77,3,3,16,100,6,22,13,23,28,36,113,173,3,542,30,0,2,0,1,59880,23888,4695,31570,0
118,2612,1043,504,840,53,9,147,1096,9,180,112,198,189,310,1377,2344,4,11604,644,0,2,13,8,59880,23890,4695,31571,0
118,2612,383,288,292,26,6,62,409,11,65,38,67,76,105,429,656,5,3719,206,0,2,13,8,59880,23891,4695,31572,0
70,1382,1178,367,1042,6,15,115,1184,9,94,51,95,103,146,644,976,4,4439,246,0,2,5,4,59880,23891,4695,31573,0
70,1382,177,108,140,8,0,27,185,6,30,16,32,36,48,162,248,3,794,44,0,2,5,4,59880,23893,4695,31574,0
209,4552,1943,715,1694,26,18,214,1969,12,185,120,237,197,357,1436,2721,7,20915,1161,0,2,15,12,59880,23895,4695,31575,0
209,4552,1168,838,957,57,25,144,1225,19,348,224,416,367,640,3018,5452,11,61921,3440,1,2,15,12,59890,23897,4695,31576,0
62,1226,1098,241,925,5,10,155,1103,7,46,25,49,53,74,273,423,3,1580,87,0,2,5,7,59900,23899,4695,31577,0
62,1226,282,202,222,14,2,44,296,8,42,24,43,50,67,250,378,4,1548,86,0,2,5,7,59900,23900,4695,31578,0
22,458,601,196,481,2,23,85,603,8,63,36,72,71,108,400,664,4,3036,168,0,2,2,3,59900,23900,4695,31579,0
22,458,156,79,106,5,16,28,161,5,14,8,15,19,23,64,97,2,261,14,0,2,2,3,59900,23900,4695,31580,0
92,3868,1289,550,1043,56,32,155,1345,10,167,93,185,177,278,1266,2075,5,11498,638,0,2,4,7,59900,23902,4696,31581,0
36,1088,182,127,129,0,0,53,182,5,39,21,42,44,63,217,343,2,926,51,0,2,0,8,59900,23902,4697,31582,0
147,6910,1392,870,1177,35,17,170,1427,14,494,280,531,508,811,4473,7289,7,54850,3047,2,2,0,15,59900,23905,4698,31583,0
88,2881,773,419,590,28,0,166,801,10,204,113,217,214,330,1598,2554,5,13587,754,0,2,2,14,59900,23905,4699,31584,0
15,744,75,38,59,1,3,12,76,2,4,2,4,6,6,10,15,1,15,0,0,2,4,4,59900,23905,4699,31585,0
1,136,149,67,118,4,0,27,153,1,17,14,28,18,42,69,175,0,144,8,0,2,2,4,59900,23905,4699,31586,0
31,1986,1157,318,931,29,22,177,1186,6,104,63,125,110,188,712,1274,3,4596,255,0,2,20,15,59900,23905,4699,31587,0
56,3685,520,294,400,33,13,81,553,10,261,204,367,271,571,2128,4614,7,32445,1802,1,2,10,15,59900,23906,4699,31588,0
97,4403,1338,495,1086,10,64,173,1348,11,122,82,157,133,239,883,1686,7,11934,663,0,2,4,11,59900,23908,4699,31589,0
172,7588,139,89,101,2,0,35,141,7,54,34,62,61,96,330,569,4,2287,127,0,2,12,30,59900,23908,4699,31590,0
172,7588,7,5,5,0,0,2,7,1,2,1,2,3,3,2,4,0,2,0,0,2,12,30,59900,23908,4699,31591,0
33,1004,465,148,393,5,8,60,470,4,31,20,31,35,51,161,261,2,523,29,0,2,0,8,59900,23909,4699,31592,0
33,1004,16,12,9,0,0,6,16,1,2,1,2,3,3,2,4,0,2,0,0,2,0,8,59900,23909,4699,31593,0
139,5895,1782,648,1425,9,47,279,1791,8,171,97,189,179,286,1292,2140,4,9462,525,0,2,28,58,59900,23910,4700,31594,0
25,684,256,139,192,9,7,47,265,4,23,12,24,27,36,112,171,2,357,19,0,2,0,5,59900,23911,4700,31595,0
23,578,102,59,69,5,3,24,107,6,22,15,28,28,43,113,206,3,789,43,0,2,0,1,59900,23911,4700,31596,0
111,4174,1450,624,1228,12,26,181,1462,14,306,186,354,320,540,2580,4493,8,36391,2021,1,2,12,25,59900,23913,4701,31597,0
154,4337,1660,832,1314,41,38,274,1701,20,312,209,395,332,604,2671,5058,12,64042,3557,1,2,4,30,59900,23915,4702,31599,0
36,2870,996,429,845,24,10,117,1020,7,76,50,88,83,138,494,879,4,3565,198,0,2,11,16,59900,23917,4702,31600,0
125,5131,1513,682,1277,25,13,200,1538,11,199,116,219,210,335,1557,2584,6,15641,868,0,2,0,6,59900,23919,4702,31601,0
73,3803,1296,573,1062,40,33,157,1336,8,201,118,231,209,349,1561,2689,4,12365,686,0,2,0,11,59900,23919,4702,31602,0
14,341,207,111,150,11,0,50,218,5,26,19,36,31,55,133,272,3,943,52,0,2,0,4,59900,23919,4702,31603,0
84,4438,1457,730,1242,11,6,188,1468,10,292,166,329,302,495,2424,4078,5,22973,1276,1,2,3,14,59900,23921,4702,31604,0
39,2323,652,304,544,16,6,88,668,6,89,51,101,95,152,591,998,3,3399,188,0,2,0,4,59900,23922,4702,31605,0
70,3212,1455,414,1257,16,76,112,1471,5,41,23,46,46,69,231,381,2,1069,59,0,2,0,4,59900,23923,4702,31606,0
95,4652,1523,757,1297,19,12,193,1542,12,193,117,230,205,347,1508,2664,7,19053,1058,0,2,9,16,59910,23925,4702,31607,0
88,3896,1020,354,843,12,15,144,1032,8,134,77,144,142,221,970,1580,4,6792,377,0,2,0,6,59910,23925,4702,31608,0
38,1676,447,308,343,6,5,95,453,7,96,59,111,103,170,651,1136,4,4600,255,0,2,0,4,59910,23928,4702,31609,0
21,658,424,94,331,4,0,89,428,1,5,5,5,6,10,11,25,0,12,0,0,2,0,1,59910,23929,4702,31610,0
38,2302,334,251,279,10,4,40,344,5,127,74,143,132,217,899,1528,2,4303,239,0,2,5,14,59910,23930,4702,31611,0
12,493,184,100,137,2,15,30,186,6,38,20,39,44,59,214,322,3,991,55,0,2,0,3,59910,23931,4702,31612,0
59,2582,1293,570,1093,25,15,163,1318,10,195,123,241,205,364,1516,2795,6,17273,959,0,2,0,4,59920,23933,4702,31613,0
33,1883,384,251,317,7,8,52,391,11,70,44,84,81,128,467,811,6,5355,297,0,2,0,8,59920,23933,4702,31614,0
45,2209,722,423,573,19,0,135,741,12,172,101,199,184,300,1320,2257,6,15668,870,0,2,2,7,59920,23935,4702,31616,0
39,1727,386,256,301,16,9,68,402,4,59,35,69,63,104,355,621,2,1453,80,0,2,0,2,59920,23935,4702,31617,0
82,3157,1043,504,840,53,9,147,1096,9,180,112,198,189,310,1377,2344,4,11604,644,0,2,9,17,59920,23937,4702,31618,0
30,1241,373,158,315,8,0,51,381,5,76,44,79,81,123,486,779,2,2026,112,0,2,0,2,59920,23937,4702,31619,0
77,3213,1178,367,1042,6,15,115,1184,9,94,51,95,103,146,644,976,4,4439,246,0,2,4,7,59920,23937,4702,31620,0
91,4597,1943,715,1694,26,18,214,1969,12,185,120,237,197,357,1436,2721,7,20915,1161,0,2,0,8,59920,23939,4702,31621,0
14,826,442,244,305,14,16,103,456,11,68,45,75,79,120,452,756,6,4588,254,0,2,0,2,59920,23941,4702,31622,0
49,1838,1098,241,925,5,10,155,1103,7,46,25,49,53,74,273,423,3,1580,87,0,2,0,1,59930,23943,4702,31623,0
19,680,601,196,481,2,23,85,603,8,63,36,72,71,108,400,664,4,3036,168,0,2,2,3,59930,23943,4702,31624,0
60,1081,282,196,195,3,0,86,285,8,130,71,141,138,212,936,1507,4,6538,363,0,2,0,17,59930,23943,4703,31625,0
1,90,13,10,10,0,0,3,13,1,2,1,2,3,3,2,4,0,2,0,0,2,1,1,59930,23943,4703,31626,0
7,114,44,19,17,0,16,11,44,3,14,7,14,17,21,58,85,1,128,7,0,2,0,1,59930,23943,4703,31627,0
3,66,127,75,83,2,11,30,129,4,14,7,14,18,21,61,87,2,175,9,0,2,0,1,59930,23943,4703,31628,0
3,66,652,304,544,16,6,88,668,6,89,51,101,95,152,591,998,3,3399,188,0,2,0,1,59930,23944,4703,31629,0
3,66,2,2,2,0,0,0,2,0,0,0,0,0,0,0,0,0,0,0,0,2,0,1,59930,23944,4703,31629,0
3,66,8,5,5,0,0,3,8,0,0,0,0,0,0,0,0,0,0,0,0,2,0,1,59930,23944,4703,31630,0
3,66,2,2,2,0,0,0,2,0,0,0,0,0,0,0,0,0,0,0,0,2,0,1,59930,23944,4703,31630,0
3,66,14,8,8,0,0,6,14,0,0,0,0,0,0,0,0,0,0,0,0,2,0,1,59930,23944,4703,31631,0
3,66,6,4,4,0,0,2,6,0,0,0,0,0,0,0,0,0,0,0,0,2,0,1,59930,23944,4703,31632,0
3,66,6,4,4,0,0,2,6,1,2,1,2,3,3,2,4,0,2,0,0,2,0,1,59930,23944,4703,31633,0
3,66,6,4,4,0,0,2,6,0,0,0,0,0,0,0,0,0,0,0,0,2,0,1,59930,23944,4703,31634,0
3,66,7,5,5,0,0,2,7,0,0,0,0,0,0,0,0,0,0,0,0,2,0,1,59930,23944,4703,31635,0
3,66,6,4,4,0,0,2,6,0,0,0,0,0,0,0,0,0,0,0,0,2,0,1,59930,23944,4703,31636,0
3,66,10,6,6,0,0,4,10,0,0,0,0,0,0,0,0,0,0,0,0,2,0,1,59930,23944,4703,31637,0
3,66,1,1,1,0,0,0,1,0,0,0,0,0,0,0,0,0,0,0,0,2,0,1,59930,23944,4703,31637,0
3,66,14,10,10,0,0,4,14,1,1,1,1,2,2,0,2,0,1,0,0,2,0,1,59930,23944,4703,31638,0
3,66,46,26,30,3,0,12,49,3,6,3,6,9,9,20,28,1,42,2,0,2,0,1,59940,23944,4703,31639,0
7,298,72,33,56,0,4,12,72,1,1,1,1,2,2,0,2,0,1,0,0,2,0,1,59940,23944,4703,31640,0
12,229,127,75,83,2,11,30,129,4,14,7,14,18,21,61,87,2,175,9,0,2,0,2,59940,23944,4703,31641,0
12,229,652,304,544,16,6,88,668,6,89,51,101,95,152,591,998,3,3399,188,0,2,0,2,59940,23945,4703,31642,0
12,229,2,2,2,0,0,0,2,0,0,0,0,0,0,0,0,0,0,0,0,2,0,2,59940,23945,4703,31642,0
12,229,8,5,5,0,0,3,8,0,0,0,0,0,0,0,0,0,0,0,0,2,0,2,59940,23945,4703,31643,0
12,229,2,2,2,0,0,0,2,0,0,0,0,0,0,0,0,0,0,0,0,2,0,2,59940,23945,4703,31643,0
12,229,14,8,8,0,0,6,14,0,0,0,0,0,0,0,0,0,0,0,0,2,0,2,59940,23945,4703,31644,0
12,229,6,4,4,0,0,2,6,0,0,0,0,0,0,0,0,0,0,0,0,2,0,2,59940,23945,4703,31645,0
12,229,6,4,4,0,0,2,6,1,2,1,2,3,3,2,4,0,2,0,0,2,0,2,59940,23945,4703,31646,0
12,229,6,4,4,0,0,2,6,0,0,0,0,0,0,0,0,0,0,0,0,2,0,2,59940,23945,4703,31647,0
12,229,7,5,5,0,0,2,7,0,0,0,0,0,0,0,0,0,0,0,0,2,0,2,59940,23945,4703,31648,0
12,229,6,4,4,0,0,2,6,0,0,0,0,0,0,0,0,0,0,0,0,2,0,2,59940,23945,4703,31649,0
12,229,10,6,6,0,0,4,10,0,0,0,0,0,0,0,0,0,0,0,0,2,0,2,59940,23945,4703,31650,0
12,229,1,1,1,0,0,0,1,0,0,0,0,0,0,0,0,0,0,0,0,2,0,2,59940,23945,4703,31650,0
12,229,14,10,10,0,0,4,14,1,1,1,1,2,2,0,2,0,1,0,0,2,0,2,59940,23945,4703,31651,0
12,229,46,26,30,3,0,12,49,3,6,3,6,9,9,20,28,1,42,2,0,2,0,2,59950,23945,4703,31652,0
6,71,127,75,83,2,11,30,129,4,14,7,14,18,21,61,87,2,175,9,0,2,0,1,59950,23945,4703,31653,0
6,71,652,304,544,16,6,88,668,6,89,51,101,95,152,591,998,3,3399,188,0,2,0,1,59950,23946,4703,31654,0
6,71,2,2,2,0,0,0,2,0,0,0,0,0,0,0,0,0,0,0,0,2,0,1,59950,23946,4703,31654,0
6,71,8,5,5,0,0,3,8,0,0,0,0,0,0,0,0,0,0,0,0,2,0,1,59950,23946,4703,31655,0
6,71,2,2,2,0,0,0,2,0,0,0,0,0,0,0,0,0,0,0,0,2,0,1,59950,23946,4703,31655,0
6,71,14,8,8,0,0,6,14,0,0,0,0,0,0,0,0,0,0,0,0,2,0,1,59950,23946,4703,31656,0
6,71,6,4,4,0,0,2,6,0,0,0,0,0,0,0,0,0,0,0,0,2,0,1,59950,23946,4703,31657,0
6,71,6,4,4,0,0,2,6,1,2,1,2,3,3,2,4,0,2,0,0,2,0,1,59950,23946,4703,31658,0
6,71,6,4,4,0,0,2,6,0,0,0,0,0,0,0,0,0,0,0,0,2,0,1,59950,23946,4703,31659,0
6,71,7,5,5,0,0,2,7,0,0,0,0,0,0,0,0,0,0,0,0,2,0,1,59950,23946,4703,31660,0
6,71,6,4,4,0,0,2,6,0,0,0,0,0,0,0,0,0,0,0,0,2,0,1,59950,23946,4703,31661,0
6,71,10,6,6,0,0,4,10,0,0,0,0,0,0,0,0,0,0,0,0,2,0,1,59950,23946,4703,31662,0
6,71,1,1,1,0,0,0,1,0,0,0,0,0,0,0,0,0,0,0,0,2,0,1,59950,23946,4703,31662,0
6,71,14,10,10,0,0,4,14,1,1,1,1,2,2,0,2,0,1,0,0,2,0,1,59950,23946,4703,31663,0
6,71,46,26,30,3,0,12,49,3,6,3,6,9,9,20,28,1,42,2,0,2,0,1,59960,23946,4703,31664,0
3,26,14,7,7,2,0,5,16,0,0,0,0,0,0,0,0,0,0,0,0,2,0,1,59960,23946,4703,31664,0
11,413,42,7,35,4,0,5,46,1,2,1,2,3,3,2,4,0,2,0,0,2,7,1,59960,23946,4703,31665,0
11,413,11,6,10,0,0,1,11,2,4,2,4,6,6,10,15,1,15,0,0,2,7,1,59960,23946,4703,31666,0
213,4619,182,127,129,0,0,53,182,5,39,21,42,44,63,217,343,2,926,51,0,2,20,19,59960,23946,4704,31667,0
213,4619,1165,710,800,67,119,181,1232,18,243,153,282,261,435,2000,3492,10,36473,2026,1,2,20,19,59970,23946,4705,31668,0
83,1808,773,419,590,28,0,166,801,10,204,113,217,214,330,1598,2554,5,13587,754,0,2,4,3,59970,23946,4706,31669,0
83,1808,421,273,302,44,34,57,465,17,81,59,107,98,166,583,1098,11,12329,684,0,2,4,3,59970,23946,4707,31670,0
164,5065,1660,832,1314,41,38,274,1701,20,312,209,395,332,604,2671,5058,12,64042,3557,1,2,11,1,59970,23948,4708,31672,0
164,5065,1057,646,719,113,100,145,1170,18,215,134,248,233,382,1740,3004,10,31186,1732,1,2,11,1,59980,23949,4709,31673,0
89,1830,477,336,357,30,23,73,507,16,194,134,250,210,384,1538,2962,10,30538,1696,0,2,1,1,59990,23950,4709,31674,0
74,1693,996,429,845,24,10,117,1020,7,76,50,88,83,138,494,879,4,3565,198,0,2,1,4,59990,23952,4709,31675,0
74,1693,456,277,329,12,42,72,468,13,85,50,97,98,147,592,972,7,7212,400,0,2,1,4,59990,23952,4709,31676,0
145,3016,1513,682,1277,25,13,200,1538,11,199,116,219,210,335,1557,2584,6,15641,868,0,2,0,2,59990,23954,4709,31677,0
145,3016,819,519,539,24,98,155,843,15,96,57,106,111,163,690,1107,8,9171,509,0,2,0,2,60000,23956,4709,31678,0
58,1192,207,111,150,11,0,50,218,5,26,19,36,31,55,133,272,3,943,52,0,2,5,15,60000,23956,4709,31679,0
58,1192,410,198,237,31,55,97,441,11,63,38,72,74,110,414,683,6,4293,238,0,2,5,15,60010,23957,4710,31680,0
211,4551,2,2,2,0,0,0,2,0,0,0,0,0,0,0,0,0,0,0,0,3,46,552,60010,23957,4710,31680,0
211,4551,99,48,90,1,3,5,100,0,0,0,0,0,0,0,0,0,0,0,0,3,46,552,60010,23958,4710,31681,0
211,4551,8,5,5,2,0,1,10,0,0,0,0,0,0,0,0,0,0,0,0,3,46,552,60010,23958,4710,31682,0
211,4551,1217,716,841,84,126,174,1301,14,185,118,215,199,333,1446,2542,8,20687,1149,0,3,46,552,60020,23960,4710,31683,0
211,4551,160,89,115,0,13,31,160,7,15,11,17,22,28,78,124,3,495,27,0,3,46,552,60020,23960,4710,31684,0
211,4551,10,10,9,9,0,0,19,0,0,0,0,0,0,0,0,0,0,0,0,3,46,552,60020,23960,4711,31685,0
211,4551,173,84,99,8,29,36,181,5,12,7,13,17,20,54,81,2,221,12,0,3,46,552,60020,23961,4711,31686,0
211,4551,3,1,1,3,0,0,6,0,0,0,0,0,0,0,0,0,0,0,0,3,46,552,60020,23961,4711,31687,0
94,1909,463,295,324,28,62,57,491,12,134,82,154,146,236,989,1696,6,11700,650,0,0,392,0,60030,23962,4711,31688,0
51,727,167,116,138,4,5,22,171,8,48,30,56,56,86,292,499,4,2330,129,0,0,139,0,60030,23962,4711,31689,0
28,810,339,213,244,17,9,65,356,10,42,26,48,52,74,259,421,5,2410,133,0,2,4,4,60040,23962,4711,31690,0
85,2161,1455,414,1257,16,76,112,1471,5,41,23,46,46,69,231,381,2,1069,59,0,2,4,13,60040,23963,4711,31692,0
85,2161,669,365,481,22,61,110,691,15,103,63,122,118,185,747,1273,8,11311,628,0,2,4,13,60050,23963,4712,31693,0
236,5392,4293,999,3693,19,54,507,4312,9,155,88,170,164,258,1156,1898,4,9368,520,0,2,6,8,60050,23965,4712,31694,0
236,5392,1482,859,1002,125,135,219,1607,16,219,134,251,235,385,1766,3032,9,27804,1544,1,2,6,8,60060,23966,4712,31695,0
27,959,74,35,59,1,0,14,75,3,14,7,14,17,21,58,85,1,128,7,0,2,1,1,60060,23967,4712,31696,0
27,959,245,125,200,5,7,34,250,7,30,17,34,37,51,166,265,3,1053,58,0,2,1,1,60070,23968,4712,31697,0
98,2661,1523,757,1297,19,12,193,1542,12,193,117,230,205,347,1508,2664,7,19053,1058,0,2,1,6,60080,23970,4712,31698,0
98,2661,701,378,504,33,58,109,734,13,110,68,126,123,194,794,1346,7,10027,557,0,2,1,6,60080,23971,4713,31699,0
88,2248,773,422,505,30,103,129,803,14,77,46,83,91,129,535,839,7,6334,351,0,2,1,3,60090,23972,4714,31700,0
122,2937,77,34,69,0,0,8,77,3,24,16,29,27,45,114,213,1,387,21,0,2,1,1,60090,23972,4714,31701,0
122,2937,712,438,573,51,9,84,763,14,102,71,128,116,199,733,1364,8,11988,666,0,2,1,1,60100,23973,4714,31702,0
30,658,125,97,103,3,0,19,128,9,25,17,27,34,44,144,223,4,1087,60,0,2,0,1,60100,23973,4715,31703,0
82,1776,402,202,227,24,74,80,426,12,52,33,61,64,94,339,564,7,3969,220,0,2,14,9,60100,23974,4715,31704,0
48,992,447,308,343,6,5,95,453,7,96,59,111,103,170,651,1136,4,4600,255,0,2,0,1,60100,23977,4715,31705,0
48,992,322,174,179,16,74,51,338,10,41,26,46,51,72,252,408,5,2291,127,0,2,0,1,60100,23980,4716,31706,0
73,1667,53,23,39,0,0,13,53,2,8,4,8,10,12,26,39,1,39,2,0,2,2,2,60100,23980,4716,31707,0
73,1667,515,298,307,33,80,99,548,12,63,44,77,75,121,419,753,7,5527,307,0,2,2,2,60110,23980,4716,31708,0
20,511,205,80,86,16,53,53,221,7,18,10,19,25,29,94,134,3,497,27,0,2,1,0,60120,23980,4717,31709,0
226,5306,722,423,573,19,0,135,741,12,172,101,199,184,300,1320,2257,6,15668,870,0,2,7,14,60120,23982,4717,31711,0
226,5306,1508,847,911,44,250,301,1552,14,148,88,169,162,257,1120,1886,7,15077,837,0,2,7,14,60120,23983,4718,31712,0
285,6283,72,33,56,0,4,12,72,1,1,1,1,2,2,0,2,0,1,0,0,2,16,19,60120,23983,4718,31713,0
285,6283,1454,835,1044,76,110,219,1530,17,275,158,296,292,454,2297,3718,9,34017,1889,1,2,16,19,60130,23984,4718,31714,0
78,1601,757,253,292,73,244,162,830,13,61,38,67,74,105,409,651,7,4654,258,0,2,8,8,60130,23985,4718,31715,0
46,954,386,256,301,16,9,68,402,4,59,35,69,63,104,355,621,2,1453,80,0,2,2,5,60130,23985,4718,31716,0
46,954,264,131,164,11,41,46,275,6,38,22,40,44,62,214,338,3,1068,59,0,2,2,5,60140,23985,4719,31717,0
30,650,215,129,180,6,0,29,221,8,65,43,72,73,115,415,711,4,3153,175,0,2,0,1,60140,23985,4719,31718,0
30,650,97,69,77,3,3,16,100,6,22,13,23,28,36,113,173,3,542,30,0,2,0,1,60140,23986,4719,31719,0
118,2612,1043,504,840,53,9,147,1096,9,180,112,198,189,310,1377,2344,4,11604,644,0,2,13,8,60140,23988,4719,31720,0
118,2612,383,288,292,26,6,62,409,11,65,38,67,76,105,429,656,5,3719,206,0,2,13,8,60140,23989,4719,31721,0
70,1382,1178,367,1042,6,15,115,1184,9,94,51,95,103,146,644,976,4,4439,246,0,2,5,4,60140,23989,4719,31722,0
70,1382,177,108,140,8,0,27,185,6,30,16,32,36,48,162,248,3,794,44,0,2,5,4,60140,23991,4719,31723,0
209,4552,1943,715,1694,26,18,214,1969,12,185,120,237,197,357,1436,2721,7,20915,1161,0,2,15,12,60140,23993,4719,31724,0
209,4552,1168,838,957,57,25,144,1225,19,348,224,416,367,640,3018,5452,11,61921,3440,1,2,15,12,60150,23995,4719,31725,0
62,1226,1098,241,925,5,10,155,1103,7,46,25,49,53,74,273,423,3,1580,87,0,2,5,7,60160,23997,4719,31726,0
62,1226,282,202,222,14,2,44,296,8,42,24,43,50,67,250,378,4,1548,86,0,2,5,7,60160,23998,4719,31727,0
22,458,601,196,481,2,23,85,603,8,63,36,72,71,108,400,664,4,3036,168,0,2,2,3,60160,23998,4719,31728,0
22,458,156,79,106,5,16,28,161,5,14,8,15,19,23,64,97,2,261,14,0,2,2,3,60160,23998,4719,31729,0
92,3868,1289,550,1043,56,32,155,1345,10,167,93,185,177,278,1266,2075,5,11498,638,0,2,4,7,60160,24000,4720,31730,0
36,1088,182,127,129,0,0,53,182,5,39,21,42,44,63,217,343,2,926,51,0,2,0,8,60160,24000,4721,31731,0
147,6910,1392,870,1177,35,17,170,1427,14,494,280,531,508,811,4473,7289,7,54850,3047,2,2,0,15,60160,24003,4722,31732,0
88,2881,773,419,590,28,0,166,801,10,204,113,217,214,330,1598,2554,5,13587,754,0,2,2,14,60160,24003,4723,31733,0
15,744,75,38,59,1,3,12,76,2,4,2,4,6,6,10,15,1,15,0,0,2,4,4,60160,24003,4723,31734,0
8,263,51,25,36,0,0,15,51,3,11,6,12,14,18,42,68,1,112,6,0,2,12,15,60160,24003,4723,31735,0
1,136,149,67,118,4,0,27,153,1,17,14,28,18,42,69,175,0,144,8,0,2,2,4,60160,24003,4723,31736,0
31,1986,1157,318,931,29,22,177,1186,6,104,63,125,110,188,712,1274,3,4596,255,0,2,20,15,60160,24003,4723,31737,0
56,3685,520,294,400,33,13,81,553,10,261,204,367,271,571,2128,4614,7,32445,1802,1,2,26,16,60160,24004,4723,31738,0
97,4403,1338,495,1086,10,64,173,1348,11,122,82,157,133,239,883,1686,7,11934,663,0,2,4,11,60160,24006,4723,31739,0
172,7588,139,89,101,2,0,35,141,7,54,34,62,61,96,330,569,4,2287,127,0,2,12,30,60160,24006,4723,31740,0
172,7588,7,5,5,0,0,2,7,1,2,1,2,3,3,2,4,0,2,0,0,2,12,30,60160,24006,4723,31741,0
33,1004,465,148,393,5,8,60,470,4,31,20,31,35,51,161,261,2,523,29,0,2,0,8,60160,24007,4723,31742,0
33,1004,16,12,9,0,0,6,16,1,2,1,2,3,3,2,4,0,2,0,0,2,0,8,60160,24007,4723,31743,0
139,5895,1782,648,1425,9,47,279,1791,8,171,97,189,179,286,1292,2140,4,9462,525,0,2,28,58,60160,24008,4724,31744,0
25,684,256,139,192,9,7,47,265,4,23,12,24,27,36,112,171,2,357,19,0,2,0,5,60160,24009,4724,31745,0
23,578,102,59,69,5,3,24,107,6,22,15,28,28,43,113,206,3,789,43,0,2,0,1,60160,24009,4724,31746,0
111,4174,1450,624,1228,12,26,181,1462,14,306,186,354,320,540,2580,4493,8,36391,2021,1,2,12,25,60160,24011,4725,31747,0
154,4337,1660,832,1314,41,38,274,1701,20,312,209,395,332,604,2671,5058,12,64042,3557,1,2,4,30,60160,24013,4726,31749,0
39,2966,996,429,845,24,10,117,1020,7,76,50,88,83,138,494,879,4,3565,198,0,2,10,16,60160,24015,4726,31750,0
125,5131,1513,682,1277,25,13,200,1538,11,199,116,219,210,335,1557,2584,6,15641,868,0,2,1,7,60160,24017,4726,31751,0
73,3803,1296,573,1062,40,33,157,1336,8,201,118,231,209,349,1561,2689,4,12365,686,0,2,0,11,60160,24017,4726,31752,0
14,341,207,111,150,11,0,50,218,5,26,19,36,31,55,133,272,3,943,52,0,2,0,4,60160,24017,4726,31753,0
84,4438,1457,730,1242,11,6,188,1468,10,292,166,329,302,495,2424,4078,5,22973,1276,1,2,5,20,60160,24019,4726,31754,0
39,2323,652,304,544,16,6,88,668,6,89,51,101,95,152,591,998,3,3399,188,0,2,0,4,60160,24020,4726,31755,0
70,3212,1455,414,1257,16,76,112,1471,5,41,23,46,46,69,231,381,2,1069,59,0,2,16,4,60160,24021,4726,31756,0
95,4652,1523,757,1297,19,12,193,1542,12,193,117,230,205,347,1508,2664,7,19053,1058,0,2,9,16,60170,24023,4726,31757,0
90,3974,1020,354,843,12,15,144,1032,8,134,77,144,142,221,970,1580,4,6792,377,0,2,5,7,60170,24023,4726,31758,0
38,1676,447,308,343,6,5,95,453,7,96,59,111,103,170,651,1136,4,4600,255,0,2,0,4,60170,24026,4726,31759,0
21,658,424,94,331,4,0,89,428,1,5,5,5,6,10,11,25,0,12,0,0,2,0,1,60170,24027,4726,31760,0
38,2302,334,251,279,10,4,40,344,5,127,74,143,132,217,899,1528,2,4303,239,0,2,6,15,60170,24028,4726,31761,0
12,493,184,100,137,2,15,30,186,6,38,20,39,44,59,214,322,3,991,55,0,2,0,3,60170,24029,4726,31762,0
59,2582,1293,570,1093,25,15,163,1318,10,195,123,241,205,364,1516,2795,6,17273,959,0,2,0,4,60180,24031,4726,31763,0
33,1883,384,251,317,7,8,52,391,11,70,44,84,81,128,467,811,6,5355,297,0,2,0,8,60180,24031,4726,31764,0
45,2209,722,423,573,19,0,135,741,12,172,101,199,184,300,1320,2257,6,15668,870,0,2,2,7,60180,24033,4726,31766,0
39,1727,386,256,301,16,9,68,402,4,59,35,69,63,104,355,621,2,1453,80,0,2,0,2,60180,24033,4726,31767,0
82,3157,1043,504,840,53,9,147,1096,9,180,112,198,189,310,1377,2344,4,11604,644,0,2,9,17,60180,24035,4726,31768,0
30,1241,373,158,315,8,0,51,381,5,76,44,79,81,123,486,779,2,2026,112,0,2,0,2,60180,24035,4726,31769,0
77,3213,1178,367,1042,6,15,115,1184,9,94,51,95,103,146,644,976,4,4439,246,0,2,4,7,60180,24035,4726,31770,0
91,4597,1943,715,1694,26,18,214,1969,12,185,120,237,197,357,1436,2721,7,20915,1161,0,2,0,8,60180,24037,4726,31771,0
14,826,442,244,305,14,16,103,456,11,68,45,75,79,120,452,756,6,4588,254,0,2,0,2,60180,24039,4726,31772,0
49,1838,1098,241,925,5,10,155,1103,7,46,25,49,53,74,273,423,3,1580,87,0,2,0,1,60190,24041,4726,31773,0
19,680,601,196,481,2,23,85,603,8,63,36,72,71,108,400,664,4,3036,168,0,2,2,3,60190,24041,4726,31774,0
60,1081,282,196,195,3,0,86,285,8,130,71,141,138,212,936,1507,4,6538,363,0,2,0,17,60190,24041,4727,31775,0
1,90,13,10,10,0,0,3,13,1,2,1,2,3,3,2,4,0,2,0,0,2,1,1,60190,24041,4727,31776,0
7,114,44,19,17,0,16,11,44,3,14,7,14,17,21,58,85,1,128,7,0,2,0,1,60190,24041,4727,31777,0
3,66,127,75,83,2,11,30,129,4,14,7,14,18,21,61,87,2,175,9,0,2,0,1,60190,24041,4727,31778,0
3,66,652,304,544,16,6,88,668,6,89,51,101,95,152,591,998,3,3399,188,0,2,0,1,60190,24042,4727,31779,0
3,66,2,2,2,0,0,0,2,0,0,0,0,0,0,0,0,0,0,0,0,2,0,1,60190,24042,4727,31779,0
3,66,8,5,5,0,0,3,8,0,0,0,0,0,0,0,0,0,0,0,0,2,0,1,60190,24042,4727,31780,0
3,66,2,2,2,0,0,0,2,0,0,0,0,0,0,0,0,0,0,0,0,2,0,1,60190,24042,4727,31780,0
3,66,14,8,8,0,0,6,14,0,0,0,0,0,0,0,0,0,0,0,0,2,0,1,60190,24042,4727,31781,0
3,66,6,4,4,0,0,2,6,0,0,0,0,0,0,0,0,0,0,0,0,2,0,1,60190,24042,4727,31782,0
3,66,6,4,4,0,0,2,6,1,2,1,2,3,3,2,4,0,2,0,0,2,0,1,60190,24042,4727,31783,0
3,66,6,4,4,0,0,2,6,0,0,0,0,0,0,0,0,0,0,0,0,2,0,1,60190,24042,4727,31784,0
3,66,7,5,5,0,0,2,7,0,0,0,0,0,0,0,0,0,0,0,0,2,0,1,60190,24042,4727,31785,0
3,66,6,4,4,0,0,2,6,0,0,0,0,0,0,0,0,0,0,0,0,2,0,1,60190,24042,4727,31786,0
3,66,10,6,6,0,0,4,10,0,0,0,0,0,0,0,0,0,0,0,0,2,0,1,60190,24042,4727,31787,0
3,66,1,1,1,0,0,0,1,0,0,0,0,0,0,0,0,0,0,0,0,2,0,1,60190,24042,4727,31787,0
3,66,14,10,10,0,0,4,14,1,1,1,1,2,2,0,2,0,1,0,0,2,0,1,60190,24042,4727,31788,0
3,66,46,26,30,3,0,12,49,3,6,3,6,9,9,20,28,1,42,2,0,2,0,1,60200,24042,4727,31789,0
7,298,72,33,56,0,4,12,72,1,1,1,1,2,2,0,2,0,1,0,0,2,0,1,60200,24042,4727,31790,0
12,229,127,75,83,2,11,30,129,4,14,7,14,18,21,61,87,2,175,9,0,2,0,2,60200,24042,4727,31791,0
12,229,652,304,544,16,6,88,668,6,89,51,101,95,152,591,998,3,3399,188,0,2,0,2,60200,24043,4727,31792,0
12,229,2,2,2,0,0,0,2,0,0,0,0,0,0,0,0,0,0,0,0,2,0,2,60200,24043,4727,31792,0
12,229,8,5,5,0,0,3,8,0,0,0,0,0,0,0,0,0,0,0,0,2,0,2,60200,24043,4727,31793,0
12,229,2,2,2,0,0,0,2,0,0,0,0,0,0,0,0,0,0,0,0,2,0,2,60200,24043,4727,31793,0
12,229,14,8,8,0,0,6,14,0,0,0,0,0,0,0,0,0,0,0,0,2,0,2,60200,24043,4727,31794,0
12,229,6,4,4,0,0,2,6,0,0,0,0,0,0,0,0,0,0,0,0,2,0,2,60200,24043,4727,31795,0
12,229,6,4,4,0,0,2,6,1,2,1,2,3,3,2,4,0,2,0,0,2,0,2,60200,24043,4727,31796,0
12,229,6,4,4,0,0,2,6,0,0,0,0,0,0,0,0,0,0,0,0,2,0,2,60200,24043,4727,31797,0
12,229,7,5,5,0,0,2,7,0,0,0,0,0,0,0,0,0,0,0,0,2,0,2,60200,24043,4727,31798,0
12,229,6,4,4,0,0,2,6,0,0,0,0,0,0,0,0,0,0,0,0,2,0,2,60200,24043,4727,31799,0
12,229,10,6,6,0,0,4,10,0,0,0,0,0,0,0,0,0,0,0,0,2,0,2,60200,24043,4727,31800,0
12,229,1,1,1,0,0,0,1,0,0,0,0,0,0,0,0,0,0,0,0,2,0,2,60200,24043,4727,31800,0
12,229,14,10,10,0,0,4,14,1,1,1,1,2,2,0,2,0,1,0,0,2,0,2,60200,24043,4727,31801,0
12,229,46,26,30,3,0,12,49,3,6,3,6,9,9,20,28,1,42,2,0,2,0,2,60210,24043,4727,31802,0
6,71,127,75,83,2,11,30,129,4,14,7,14,18,21,61,87,2,175,9,0,2,0,1,60210,24043,4727,31803,0
6,71,652,304,544,16,6,88,668,6,89,51,101,95,152,591,998,3,3399,188,0,2,0,1,60210,24044,4727,31804,0
6,71,2,2,2,0,0,0,2,0,0,0,0,0,0,0,0,0,0,0,0,2,0,1,60210,24044,4727,31804,0
6,71,8,5,5,0,0,3,8,0,0,0,0,0,0,0,0,0,0,0,0,2,0,1,60210,24044,4727,31805,0
6,71,2,2,2,0,0,0,2,0,0,0,0,0,0,0,0,0,0,0,0,2,0,1,60210,24044,4727,31805,0
6,71,14,8,8,0,0,6,14,0,0,0,0,0,0,0,0,0,0,0,0,2,0,1,60210,24044,4727,31806,0
6,71,6,4,4,0,0,2,6,0,0,0,0,0,0,0,0,0,0,0,0,2,0,1,60210,24044,4727,31807,0
6,71,6,4,4,0,0,2,6,1,2,1,2,3,3,2,4,0,2,0,0,2,0,1,60210,24044,4727,31808,0
6,71,6,4,4,0,0,2,6,0,0,0,0,0,0,0,0,0,0,0,0,2,0,1,60210,24044,4727,31809,0
6,71,7,5,5,0,0,2,7,0,0,0,0,0,0,0,0,0,0,0,0,2,0,1,60210,24044,4727,31810,0
6,71,6,4,4,0,0,2,6,0,0,0,0,0,0,0,0,0,0,0,0,2,0,1,60210,24044,4727,31811,0
6,71,10,6,6,0,0,4,10,0,0,0,0,0,0,0,0,0,0,0,0,2,0,1,60210,24044,4727,31812,0
6,71,1,1,1,0,0,0,1,0,0,0,0,0,0,0,0,0,0,0,0,2,0,1,60210,24044,4727,31812,0
6,71,14,10,10,0,0,4,14,1,1,1,1,2,2,0,2,0,1,0,0,2,0,1,60210,24044,4727,31813,0
6,71,46,26,30,3,0,12,49,3,6,3,6,9,9,20,28,1,42,2,0,2,0,1,60220,24044,4727,31814,0
3,26,14,7,7,2,0,5,16,0,0,0,0,0,0,0,0,0,0,0,0,2,0,1,60220,24044,4727,31814,0
11,413,42,7,35,4,0,5,46,1,2,1,2,3,3,2,4,0,2,0,0,2,7,1,60220,24044,4727,31815,0
11,413,11,6,10,0,0,1,11,2,4,2,4,6,6,10,15,1,15,0,0,2,7,1,60220,24044,4727,31816,0
213,4619,182,127,129,0,0,53,182,5,39,21,42,44,63,217,343,2,926,51,0,2,20,19,60220,24044,4728,31817,0
213,4619,1165,710,800,67,119,181,1232,18,243,153,282,261,435,2000,3492,10,36473,2026,1,2,20,19,60230,24044,4729,31818,0
83,1808,773,419,590,28,0,166,801,10,204,113,217,214,330,1598,2554,5,13587,754,0,2,4,3,60230,24044,4730,31819,0
83,1808,421,273,302,44,34,57,465,17,81,59,107,98,166,583,1098,11,12329,684,0,2,4,3,60230,24044,4731,31820,0
164,5065,1660,832,1314,41,38,274,1701,20,312,209,395,332,604,2671,5058,12,64042,3557,1,2,11,1,60230,24046,4732,31822,0
164,5065,1057,646,719,113,100,145,1170,18,215,134,248,233,382,1740,3004,10,31186,1732,1,2,11,1,60240,24047,4733,31823,0
89,1830,477,336,357,30,23,73,507,16,194,134,250,210,384,1538,2962,10,30538,1696,0,2,1,1,60250,24048,4733,31824,0
74,1693,996,429,845,24,10,117,1020,7,76,50,88,83,138,494,879,4,3565,198,0,2,1,4,60250,24050,4733,31825,0
74,1693,456,277,329,12,42,72,468,13,85,50,97,98,147,592,972,7,7212,400,0,2,1,4,60250,24050,4733,31826,0
145,3016,1513,682,1277,25,13,200,1538,11,199,116,219,210,335,1557,2584,6,15641,868,0,2,0,2,60250,24052,4733,31827,0
145,3016,819,519,539,24,98,155,843,15,96,57,106,111,163,690,1107,8,9171,509,0,2,0,2,60260,24054,4733,31828,0
58,1192,207,111,150,11,0,50,218,5,26,19,36,31,55,133,272,3,943,52,0,2,5,15,60260,24054,4733,31829,0
58,1192,410,198,237,31,55,97,441,11,63,38,72,74,110,414,683,6,4293,238,0,2,5,15,60270,24055,4734,31830,0
211,4551,2,2,2,0,0,0,2,0,0,0,0,0,0,0,0,0,0,0,0,3,46,552,60270,24055,4734,31830,0
211,4551,99,48,90,1,3,5,100,0,0,0,0,0,0,0,0,0,0,0,0,3,46,552,60270,24056,4734,31831,0
211,4551,8,5,5,2,0,1,10,0,0,0,0,0,0,0,0,0,0,0,0,3,46,552,60270,24056,4734,31832,0
211,4551,1217,716,841,84,126,174,1301,14,185,118,215,199,333,1446,2542,8,20687,1149,0,3,46,552,60280,24058,4734,31833,0
211,4551,160,89,115,0,13,31,160,7,15,11,17,22,28,78,124,3,495,27,0,3,46,552,60280,24058,4734,31834,0
211,4551,10,10,9,9,0,0,19,0,0,0,0,0,0,0,0,0,0,0,0,3,46,552,60280,24058,4735,31835,0
211,4551,173,84,99,8,29,36,181,5,12,7,13,17,20,54,81,2,221,12,0,3,46,552,60280,24059,4735,31836,0
211,4551,3,1,1,3,0,0,6,0,0,0,0,0,0,0,0,0,0,0,0,3,46,552,60280,24059,4735,31837,0
94,1909,463,295,324,28,62,57,491,12,134,82,154,146,236,989,1696,6,11700,650,0,0,392,0,60290,24060,4735,31838,0
51,727,167,116,138,4,5,22,171,8,48,30,56,56,86,292,499,4,2330,129,0,0,139,0,60290,24060,4735,31839,0
28,810,339,213,244,17,9,65,356,10,42,26,48,52,74,259,421,5,2410,133,0,2,4,4,60300,24060,4735,31840,0
85,2161,1455,414,1257,16,76,112,1471,5,41,23,46,46,69,231,381,2,1069,59,0,2,4,13,60300,24061,4735,31842,0
85,2161,669,365,481,22,61,110,691,15,103,63,122,118,185,747,1273,8,11311,628,0,2,4,13,60310,24061,4736,31843,0
236,5392,4293,999,3693,19,54,507,4312,9,155,88,170,164,258,1156,1898,4,9368,520,0,2,6,8,60310,24063,4736,31844,0
236,5392,1482,859,1002,125,135,219,1607,16,219,134,251,235,385,1766,3032,9,27804,1544,1,2,6,8,60320,24064,4736,31845,0
27,959,74,35,59,1,0,14,75,3,14,7,14,17,21,58,85,1,128,7,0,2,1,1,60320,24065,4736,31846,0
27,959,245,125,200,5,7,34,250,7,30,17,34,37,51,166,265,3,1053,58,0,2,1,1,60330,24066,4736,31847,0
98,2661,1523,757,1297,19,12,193,1542,12,193,117,230,205,347,1508,2664,7,19053,1058,0,2,1,6,60340,24068,4736,31848,0
98,2661,701,378,504,33,58,109,734,13,110,68,126,123,194,794,1346,7,10027,557,0,2,1,6,60340,24069,4737,31849,0
88,2248,773,422,505,30,103,129,803,14,77,46,83,91,129,535,839,7,6334,351,0,2,1,3,60350,24070,4738,31850,0
122,2937,77,34,69,0,0,8,77,3,24,16,29,27,45,114,213,1,387,21,0,2,1,1,60350,24070,4738,31851,0
122,2937,712,438,573,51,9,84,763,14,102,71,128,116,199,733,1364,8,11988,666,0,2,1,1,60360,24071,4738,31852,0
30,658,125,97,103,3,0,19,128,9,25,17,27,34,44,144,223,4,1087,60,0,2,0,1,60360,24071,4739,31853,0
82,1776,402,202,227,24,74,80,426,12,52,33,61,64,94,339,564,7,3969,220,0,2,14,9,60360,24072,4739,31854,0
48,992,447,308,343,6,5,95,453,7,96,59,111,103,170,651,1136,4,4600,255,0,2,0,1,60360,24075,4739,31855,0
48,992,322,174,179,16,74,51,338,10,41,26,46,51,72,252,408,5,2291,127,0,2,0,1,60360,24078,4740,31856,0
73,1667,53,23,39,0,0,13,53,2,8,4,8,10,12,26,39,1,39,2,0,2,2,2,60360,24078,4740,31857,0
73,1667,515,298,307,33,80,99,548,12,63,44,77,75,121,419,753,7,5527,307,0,2,2,2,60370,24078,4740,31858,0
20,511,205,80,86,16,53,53,221,7,18,10,19,25,29,94,134,3,497,27,0,2,1,0,60380,24078,4741,31859,0
226,5306,722,423,573,19,0,135,741,12,172,101,199,184,300,1320,2257,6,15668,870,0,2,7,14,60380,24080,4741,31861,0
226,5306,1508,847,911,44,250,301,1552,14,148,88,169,162,257,1120,1886,7,15077,837,0,2,7,14,60380,24081,4742,31862,0
285,6283,72,33,56,0,4,12,72,1,1,1,1,2,2,0,2,0,1,0,0,2,16,19,60380,24081,4742,31863,0
285,6283,1454,835,1044,76,110,219,1530,17,275,158,296,292,454,2297,3718,9,34017,1889,1,2,16,19,60390,24082,4742,31864,0
78,1601,757,253,292,73,244,162,830,13,61,38,67,74,105,409,651,7,4654,258,0,2,8,8,60390,24083,4742,31865,0
46,954,386,256,301,16,9,68,402,4,59,35,69,63,104,355,621,2,1453,80,0,2,2,5,60390,24083,4742,31866,0
46,954,264,131,164,11,41,46,275,6,38,22,40,44,62,214,338,3,1068,59,0,2,2,5,60400,24083,4743,31867,0
30,650,215,129,180,6,0,29,221,8,65,43,72,73,115,415,711,4,3153,175,0,2,0,1,60400,24083,4743,31868,0
30,650,97,69,77,3,3,16,100,6,22,13,23,28,36,113,173,3,542,30,0,2,0,1,60400,24084,4743,31869,0
118,2612,1043,504,840,53,9,147,1096,9,180,112,198,189,310,1377,2344,4,11604,644,0,2,13,8,60400,24086,4743,31870,0
118,2612,383,288,292,26,6,62,409,11,65,38,67,76,105,429,656,5,3719,206,0,2,13,8,60400,24087,4743,31871,0
70,1382,1178,367,1042,6,15,115,1184,9,94,51,95,103,146,644,976,4,4439,246,0,2,5,4,60400,24087,4743,31872,0
70,1382,177,108,140,8,0,27,185,6,30,16,32,36,48,162,248,3,794,44,0,2,5,4,60400,24089,4743,31873,0
209,4552,1943,715,1694,26,18,214,1969,12,185,120,237,197,357,1436,2721,7,20915,1161,0,2,15,12,60400,24091,4743,31874,0
209,4552,1168,838,957,57,25,144,1225,19,348,224,416,367,640,3018,5452,11,61921,3440,1,2,15,12,60410,24093,4743,31875,0
62,1226,1098,241,925,5,10,155,1103,7,46,25,49,53,74,273,423,3,1580,87,0,2,5,7,60420,24095,4743,31876,0
62,1226,282,202,222,14,2,44,296,8,42,24,43,50,67,250,378,4,1548,86,0,2,5,7,60420,24096,4743,31877,0
22,458,601,196,481,2,23,85,603,8,63,36,72,71,108,400,664,4,3036,168,0,2,2,3,60420,24096,4743,31878,0
22,458,156,79,106,5,16,28,161,5,14,8,15,19,23,64,97,2,261,14,0,2,2,3,60420,24096,4743,31879,0
92,3868,1289,550,1043,56,32,155,1345,10,167,93,185,177,278,1266,2075,5,11498,638,0,2,4,7,60420,24098,4744,31880,0
36,1088,182,127,129,0,0,53,182,5,39,21,42,44,63,217,343,2,926,51,0,2,0,8,60420,24098,4745,31881,0
147,6910,1392,870,1177,35,17,170,1427,14,494,280,531,508,811,4473,7289,7,54850,3047,2,2,0,15,60420,24101,4746,31882,0
88,2881,773,419,590,28,0,166,801,10,204,113,217,214,330,1598,2554,5,13587,754,0,2,2,14,60420,24101,4747,31883,0
15,744,75,38,59,1,3,12,76,2,4,2,4,6,6,10,15,1,15,0,0,2,4,4,60420,24101,4747,31884,0
8,263,51,25,36,0,0,15,51,3,11,6,12,14,18,42,68,1,112,6,0,2,12,15,60420,24101,4747,31885,0
1,136,149,67,118,4,0,27,153,1,17,14,28,18,42,69,175,0,144,8,0,2,2,4,60420,24101,4747,31886,0
31,1986,1157,318,931,29,22,177,1186,6,104,63,125,110,188,712,1274,3,4596,255,0,2,20,15,60420,24101,4747,31887,0
56,3685,520,294,400,33,13,81,553,10,261,204,367,271,571,2128,4614,7,32445,1802,1,2,26,16,60420,24102,4747,31888,0
97,4403,1338,495,1086,10,64,173,1348,11,122,82,157,133,239,883,1686,7,11934,663,0,2,4,11,60420,24104,4747,31889,0
172,7588,139,89,101,2,0,35,141,7,54,34,62,61,96,330,569,4,2287,127,0,2,12,30,60420,24104,4747,31890,0
172,7588,7,5,5,0,0,2,7,1,2,1,2,3,3,2,4,0,2,0,0,2,12,30,60420,24104,4747,31891,0
33,1004,465,148,393,5,8,60,470,4,31,20,31,35,51,161,261,2,523,29,0,2,0,8,60420,24105,4747,31892,0
33,1004,16,12,9,0,0,6,16,1,2,1,2,3,3,2,4,0,2,0,0,2,0,8,60420,24105,4747,31893,0
139,5895,1782,648,1425,9,47,279,1791,8,171,97,189,179,286,1292,2140,4,9462,525,0,2,28,58,60420,24106,4748,31894,0
25,684,256,139,192,9,7,47,265,4,23,12,24,27,36,112,171,2,357,19,0,2,0,5,60420,24107,4748,31895,0
23,578,102,59,69,5,3,24,107,6,22,15,28,28,43,113,206,3,789,43,0,2,0,1,60420,24107,4748,31896,0
111,4174,1450,624,1228,12,26,181,1462,14,306,186,354,320,540,2580,4493,8,36391,2021,1,2,12,25,60420,24109,4749,31897,0
154,4337,1660,832,1314,41,38,274,1701,20,312,209,395,332,604,2671,5058,12,64042,3557,1,2,4,30,60420,24111,4750,31899,0
39,2966,996,429,845,24,10,117,1020,7,76,50,88,83,138,494,879,4,3565,198,0,2,10,16,60420,24113,4750,31900,0
125,5131,1513,682,1277,25,13,200,1538,11,199,116,219,210,335,1557,2584,6,15641,868,0,2,1,7,60420,24115,4750,31901,0
73,3803,1296,573,1062,40,33,157,1336,8,201,118,231,209,349,1561,2689,4,12365,686,0,2,0,11,60420,24115,4750,31902,0
14,341,207,111,150,11,0,50,218,5,26,19,36,31,55,133,272,3,943,52,0,2,0,4,60420,24115,4750,31903,0
84,4438,1457,730,1242,11,6,188,1468,10,292,166,329,302,495,2424,4078,5,22973,1276,1,2,5,20,60420,24117,4750,31904,0
39,2323,652,304,544,16,6,88,668,6,89,51,101,95,152,591,998,3,3399,188,0,2,0,4,60420,24118,4750,31905,0
70,3212,1455,414,1257,16,76,112,1471,5,41,23,46,46,69,231,381,2,1069,59,0,2,16,4,60420,24119,4750,31906,0
95,4652,1523,757,1297,19,12,193,1542,12,193,117,230,205,347,1508,2664,7,19053,1058,0,2,9,16,60430,24121,4750,31907,0
90,3974,1020,354,843,12,15,144,1032,8,134,77,144,142,221,970,1580,4,6792,377,0,2,5,7,60430,24121,4750,31908,0
38,1676,447,308,343,6,5,95,453,7,96,59,111,103,170,651,1136,4,4600,255,0,2,0,4,60430,24124,4750,31909,0
21,658,424,94,331,4,0,89,428,1,5,5,5,6,10,11,25,0,12,0,0,2,0,1,60430,24125,4750,31910,0
38,2302,334,251,279,10,4,40,344,5,127,74,143,132,217,899,1528,2,4303,239,0,2,6,15,60430,24126,4750,31911,0
12,493,184,100,137,2,15,30,186,6,38,20,39,44,59,214,322,3,991,55,0,2,0,3,60430,24127,4750,31912,0
59,2582,1293,570,1093,25,15,163,1318,10,195,123,241,205,364,1516,2795,6,17273,959,0,2,0,4,60440,24129,4750,31913,0
33,1883,384,251,317,7,8,52,391,11,70,44,84,81,128,467,811,6,5355,297,0,2,0,8,60440,24129,4750,31914,0
45,2209,722,423,573,19,0,135,741,12,172,101,199,184,300,1320,2257,6,15668,870,0,2,2,7,60440,24131,4750,31916,0
39,1727,386,256,301,16,9,68,402,4,59,35,69,63,104,355,621,2,1453,80,0,2,0,2,60440,24131,4750,31917,0
82,3157,1043,504,840,53,9,147,1096,9,180,112,198,189,310,1377,2344,4,11604,644,0,2,9,17,60440,24133,4750,31918,0
30,1241,373,158,315,8,0,51,381,5,76,44,79,81,123,486,779,2,2026,112,0,2,0,2,60440,24133,4750,31919,0
77,3213,1178,367,1042,6,15,115,1184,9,94,51,95,103,146,644,976,4,4439,246,0,2,4,7,60440,24133,4750,31920,0
91,4597,1943,715,1694,26,18,214,1969,12,185,120,237,197,357,1436,2721,7,20915,1161,0,2,0,8,60440,24135,4750,31921,0
14,826,442,244,305,14,16,103,456,11,68,45,75,79,120,452,756,6,4588,254,0,2,0,2,60440,24137,4750,31922,0
49,1838,1098,241,925,5,10,155,1103,7,46,25,49,53,74,273,423,3,1580,87,0,2,0,1,60450,24139,4750,31923,0
19,680,601,196,481,2,23,85,603,8,63,36,72,71,108,400,664,4,3036,168,0,2,2,3,60450,24139,4750,31924,0
89,3932,1020,354,843,12,15,144,1032,8,134,77,144,142,221,970,1580,4,6792,377,0,2,38,0,60450,24139,4750,31925,0
89,3941,1020,354,843,12,15,144,1032,8,134,77,144,142,221,970,1580,4,6792,377,0,2,2,1,60450,24139,4750,31926,1
83,1787,402,202,227,24,74,80,426,12,52,33,61,64,94,339,564,7,3969,220,0,2,4,1,60450,24140,4750,31927,1
285,6294,72,33,56,0,4,12,72,1,1,1,1,2,2,0,2,0,1,0,0,2,7,3,60450,24140,4750,31928,1
285,6294,1454,835,1044,76,110,219,1530,17,275,158,296,292,454,2297,3718,9,34017,1889,1,2,7,3,60460,24141,4750,31929,1
89,3941,1020,354,843,12,15,144,1032,8,134,77,144,142,221,970,1580,4,6792,377,0,2,1,1,60460,24141,4750,31930,1
83,1788,402,202,227,24,74,80,426,12,52,33,61,64,94,339,564,7,3969,220,0,2,6,0,60460,24142,4750,31931,0
28,699,466,257,367,18,25,50,484,7,126,86,171,133,257,898,1813,4,8612,478,0,0,192,0,60460,24142,4750,31932,1
28,699,507,281,342,29,59,88,536,10,53,29,57,63,86,336,514,5,2764,153,0,0,192,0,60460,24142,4750,31933,1
97,2135,1043,504,840,53,9,147,1096,9,180,112,198,189,310,1377,2344,4,11604,644,0,2,37,189,60460,24144,4750,31934,1
97,2135,383,288,292,26,6,62,409,11,65,38,67,76,105,429,656,5,3719,206,0,2,37,189,60460,24145,4750,31935,1
95,4640,1523,757,1297,19,12,193,1542,12,193,117,230,205,347,1508,2664,7,19053,1058,0,2,2,3,60470,24147,4750,31936,1
82,3159,1043,504,840,53,9,147,1096,9,180,112,198,189,310,1377,2344,4,11604,644,0,2,5,5,60470,24149,4750,31937,1
28,702,466,257,367,18,25,50,484,7,126,86,171,133,257,898,1813,4,8612,478,0,2,10,6,60470,24149,4750,31938,0
28,702,507,281,342,29,59,88,536,10,53,29,57,63,86,336,514,5,2764,153,0,2,10,6,60470,24149,4750,31939,0
90,1927,1043,504,840,53,9,147,1096,9,180,112,198,189,310,1377,2344,4,11604,644,0,2,0,40,60470,24151,4750,31940,0
90,1927,383,288,292,26,6,62,409,11,65,38,67,76,105,429,656,5,3719,206,0,2,0,40,60470,24152,4750,31941,0
227,5367,722,423,573,19,0,135,741,12,172,101,199,184,300,1320,2257,6,15668,870,0,2,9,0,60470,24154,4750,31943,1
227,5367,1508,847,911,44,250,301,1552,14,148,88,169,162,257,1120,1886,7,15077,837,0,2,9,0,60470,24155,4751,31944,1
229,5396,722,423,573,19,0,135,741,12,172,101,199,184,300,1320,2257,6,15668,870,0,2,4,1,60470,24157,4751,31946,1
229,5396,1508,847,911,44,250,301,1552,14,148,88,169,162,257,1120,1886,7,15077,837,0,2,4,1,60470,24158,4752,31947,1
92,3868,1289,550,1043,56,32,155,1345,10,167,93,185,177,278,1266,2075,5,11498,638,0,2,2,19,60470,24160,4753,31948,1
1,15,127,75,83,2,11,30,129,4,14,7,14,18,21,61,87,2,175,9,0,0,4,0,60470,24160,4753,31949,1
1,15,652,304,544,16,6,88,668,6,89,51,101,95,152,591,998,3,3399,188,0,0,4,0,60470,24161,4753,31950,1
1,15,2,2,2,0,0,0,2,0,0,0,0,0,0,0,0,0,0,0,0,0,4,0,60470,24161,4753,31950,1
1,15,8,5,5,0,0,3,8,0,0,0,0,0,0,0,0,0,0,0,0,0,4,0,60470,24161,4753,31951,1
1,15,2,2,2,0,0,0,2,0,0,0,0,0,0,0,0,0,0,0,0,0,4,0,60470,24161,4753,31951,1
1,15,14,8,8,0,0,6,14,0,0,0,0,0,0,0,0,0,0,0,0,0,4,0,60470,24161,4753,31952,1
1,15,6,4,4,0,0,2,6,0,0,0,0,0,0,0,0,0,0,0,0,0,4,0,60470,24161,4753,31953,1
1,15,6,4,4,0,0,2,6,1,2,1,2,3,3,2,4,0,2,0,0,0,4,0,60470,24161,4753,31954,1
1,15,6,4,4,0,0,2,6,0,0,0,0,0,0,0,0,0,0,0,0,0,4,0,60470,24161,4753,31955,1
1,15,7,5,5,0,0,2,7,0,0,0,0,0,0,0,0,0,0,0,0,0,4,0,60470,24161,4753,31956,1
1,15,6,4,4,0,0,2,6,0,0,0,0,0,0,0,0,0,0,0,0,0,4,0,60470,24161,4753,31957,1
1,15,10,6,6,0,0,4,10,0,0,0,0,0,0,0,0,0,0,0,0,0,4,0,60470,24161,4753,31958,1
1,15,1,1,1,0,0,0,1,0,0,0,0,0,0,0,0,0,0,0,0,0,4,0,60470,24161,4753,31958,1
1,15,14,10,10,0,0,4,14,1,1,1,1,2,2,0,2,0,1,0,0,0,4,0,60470,24161,4753,31959,1
1,15,46,26,30,3,0,12,49,3,6,3,6,9,9,20,28,1,42,2,0,0,4,0,60480,24161,4753,31960,1
2,51,127,75,83,2,11,30,129,4,14,7,14,18,21,61,87,2,175,9,0,0,14,0,60480,24161,4753,31961,1
2,51,652,304,544,16,6,88,668,6,89,51,101,95,152,591,998,3,3399,188,0,0,14,0,60480,24162,4753,31962,1
2,51,2,2,2,0,0,0,2,0,0,0,0,0,0,0,0,0,0,0,0,0,14,0,60480,24162,4753,31962,1
2,51,8,5,5,0,0,3,8,0,0,0,0,0,0,0,0,0,0,0,0,0,14,0,60480,24162,4753,31963,1
2,51,2,2,2,0,0,0,2,0,0,0,0,0,0,0,0,0,0,0,0,0,14,0,60480,24162,4753,31963,1
2,51,14,8,8,0,0,6,14,0,0,0,0,0,0,0,0,0,0,0,0,0,14,0,60480,24162,4753,31964,1
2,51,6,4,4,0,0,2,6,0,0,0,0,0,0,0,0,0,0,0,0,0,14,0,60480,24162,4753,31965,1
2,51,6,4,4,0,0,2,6,1,2,1,2,3,3,2,4,0,2,0,0,0,14,0,60480,24162,4753,31966,1
2,51,6,4,4,0,0,2,6,0,0,0,0,0,0,0,0,0,0,0,0,0,14,0,60480,24162,4753,31967,1
2,51,7,5,5,0,0,2,7,0,0,0,0,0,0,0,0,0,0,0,0,0,14,0,60480,24162,4753,31968,1
2,51,6,4,4,0,0,2,6,0,0,0,0,0,0,0,0,0,0,0,0,0,14,0,60480,24162,4753,31969,1
2,51,10,6,6,0,0,4,10,0,0,0,0,0,0,0,0,0,0,0,0,0,14,0,60480,24162,4753,31970,1
2,51,1,1,1,0,0,0,1,0,0,0,0,0,0,0,0,0,0,0,0,0,14,0,60480,24162,4753,31970,1
2,51,14,10,10,0,0,4,14,1,1,1,1,2,2,0,2,0,1,0,0,0,14,0,60480,24162,4753,31971,1
2,51,46,26,30,3,0,12,49,3,6,3,6,9,9,20,28,1,42,2,0,0,14,0,60490,24162,4753,31972,1
1,6,2,2,2,0,0,0,2,0,0,0,0,0,0,0,0,0,0,0,0,0,2,0,60490,24162,4753,31972,1
1,18,3,3,3,0,0,0,3,0,0,0,0,0,0,0,0,0,0,0,0,0,3,0,60490,24162,4753,31972,1
83,1788,402,202,227,24,74,80,426,12,52,33,61,64,94,339,564,7,3969,220,0,2,10,1,60490,24163,4753,31973,0
285,6294,72,33,56,0,4,12,72,1,1,1,1,2,2,0,2,0,1,0,0,2,7,3,60490,24163,4753,31974,0
285,6294,1454,835,1044,76,110,219,1530,17,275,158,296,292,454,2297,3718,9,34017,1889,1,2,7,3,60500,24164,4753,31975,0
89,3941,1020,354,843,12,15,144,1032,8,134,77,144,142,221,970,1580,4,6792,377,0,2,39,0,60500,24164,4753,31976,0
231,5436,722,423,573,19,0,135,741,12,172,101,199,184,300,1320,2257,6,15668,870,0,2,9,1,60500,24166,4753,31978,1
231,5436,1508,847,911,44,250,301,1552,14,148,88,169,162,257,1120,1886,7,15077,837,0,2,9,1,60500,24167,4754,31979,1
231,5436,722,423,573,19,0,135,741,12,172,101,199,184,300,1320,2257,6,15668,870,0,2,20,0,60500,24169,4754,31981,0
231,5436,1508,847,911,44,250,301,1552,14,148,88,169,162,257,1120,1886,7,15077,837,0,2,20,0,60500,24170,4755,31982,0
92,3868,1289,550,1043,56,32,155,1345,10,167,93,185,177,278,1266,2075,5,11498,638,0,2,2,19,60500,24172,4756,31983,0
1,15,127,75,83,2,11,30,129,4,14,7,14,18,21,61,87,2,175,9,0,0,4,0,60500,24172,4756,31984,0
1,15,652,304,544,16,6,88,668,6,89,51,101,95,152,591,998,3,3399,188,0,0,4,0,60500,24173,4756,31985,0
1,15,2,2,2,0,0,0,2,0,0,0,0,0,0,0,0,0,0,0,0,0,4,0,60500,24173,4756,31985,0
1,15,8,5,5,0,0,3,8,0,0,0,0,0,0,0,0,0,0,0,0,0,4,0,60500,24173,4756,31986,0
1,15,2,2,2,0,0,0,2,0,0,0,0,0,0,0,0,0,0,0,0,0,4,0,60500,24173,4756,31986,0
1,15,14,8,8,0,0,6,14,0,0,0,0,0,0,0,0,0,0,0,0,0,4,0,60500,24173,4756,31987,0
1,15,6,4,4,0,0,2,6,0,0,0,0,0,0,0,0,0,0,0,0,0,4,0,60500,24173,4756,31988,0
1,15,6,4,4,0,0,2,6,1,2,1,2,3,3,2,4,0,2,0,0,0,4,0,60500,24173,4756,31989,0
1,15,6,4,4,0,0,2,6,0,0,0,0,0,0,0,0,0,0,0,0,0,4,0,60500,24173,4756,31990,0
1,15,7,5,5,0,0,2,7,0,0,0,0,0,0,0,0,0,0,0,0,0,4,0,60500,24173,4756,31991,0
1,15,6,4,4,0,0,2,6,0,0,0,0,0,0,0,0,0,0,0,0,0,4,0,60500,24173,4756,31992,0
1,15,10,6,6,0,0,4,10,0,0,0,0,0,0,0,0,0,0,0,0,0,4,0,60500,24173,4756,31993,0
1,15,1,1,1,0,0,0,1,0,0,0,0,0,0,0,0,0,0,0,0,0,4,0,60500,24173,4756,31993,0
1,15,14,10,10,0,0,4,14,1,1,1,1,2,2,0,2,0,1,0,0,0,4,0,60500,24173,4756,31994,0
1,15,46,26,30,3,0,12,49,3,6,3,6,9,9,20,28,1,42,2,0,0,4,0,60510,24173,4756,31995,0
2,51,127,75,83,2,11,30,129,4,14,7,14,18,21,61,87,2,175,9,0,0,14,0,60510,24173,4756,31996,0
2,51,652,304,544,16,6,88,668,6,89,51,101,95,152,591,998,3,3399,188,0,0,14,0,60510,24174,4756,31997,0
2,51,2,2,2,0,0,0,2,0,0,0,0,0,0,0,0,0,0,0,0,0,14,0,60510,24174,4756,31997,0
2,51,8,5,5,0,0,3,8,0,0,0,0,0,0,0,0,0,0,0,0,0,14,0,60510,24174,4756,31998,0
2,51,2,2,2,0,0,0,2,0,0,0,0,0,0,0,0,0,0,0,0,0,14,0,60510,24174,4756,31998,0
2,51,14,8,8,0,0,6,14,0,0,0,0,0,0,0,0,0,0,0,0,0,14,0,60510,24174,4756,31999,0
2,51,6,4,4,0,0,2,6,0,0,0,0,0,0,0,0,0,0,0,0,0,14,0,60510,24174,4756,32000,0
2,51,6,4,4,0,0,2,6,1,2,1,2,3,3,2,4,0,2,0,0,0,14,0,60510,24174,4756,32001,0
2,51,6,4,4,0,0,2,6,0,0,0,0,0,0,0,0,0,0,0,0,0,14,0,60510,24174,4756,32002,0
2,51,7,5,5,0,0,2,7,0,0,0,0,0,0,0,0,0,0,0,0,0,14,0,60510,24174,4756,32003,0
2,51,6,4,4,0,0,2,6,0,0,0,0,0,0,0,0,0,0,0,0,0,14,0,60510,24174,4756,32004,0
2,51,10,6,6,0,0,4,10,0,0,0,0,0,0,0,0,0,0,0,0,0,14,0,60510,24174,4756,32005,0
2,51,1,1,1,0,0,0,1,0,0,0,0,0,0,0,0,0,0,0,0,0,14,0,60510,24174,4756,32005,0
2,51,14,10,10,0,0,4,14,1,1,1,1,2,2,0,2,0,1,0,0,0,14,0,60510,24174,4756,32006,0
2,51,46,26,30,3,0,12,49,3,6,3,6,9,9,20,28,1,42,2,0,0,14,0,60520,24174,4756,32007,0
1,6,2,2,2,0,0,0,2,0,0,0,0,0,0,0,0,0,0,0,0,0,2,0,60520,24174,4756,32007,0
1,18,3,3,3,0,0,0,3,0,0,0,0,0,0,0,0,0,0,0,0,0,3,0,60520,24174,4756,32007,0
28,702,466,257,367,18,25,50,484,7,126,86,171,133,257,898,1813,4,8612,478,0,0,196,0,60520,24174,4756,32008,0
28,702,507,281,342,29,59,88,536,10,53,29,57,63,86,336,514,5,2764,153,0,0,196,0,60520,24174,4756,32009,0
90,1927,1043,504,840,53,9,147,1096,9,180,112,198,189,310,1377,2344,4,11604,644,0,2,3,195,60520,24176,4756,32010,0
90,1927,383,288,292,26,6,62,409,11,65,38,67,76,105,429,656,5,3719,206,0,2,3,195,60520,24177,4756,32011,0
95,4640,1523,757,1297,19,12,193,1542,12,193,117,230,205,347,1508,2664,7,19053,1058,0,2,2,3,60530,24179,4756,32012,0
82,3159,1043,504,840,53,9,147,1096,9,180,112,198,189,310,1377,2344,4,11604,644,0,2,5,5,60530,24181,4756,32013,0
240,5520,4293,999,3693,19,54,507,4312,9,155,88,170,164,258,1156,1898,4,9368,520,0,2,50,9,60530,24183,4756,32014,1
240,5520,1482,859,1002,125,135,219,1607,16,219,134,251,235,385,1766,3032,9,27804,1544,1,2,50,9,60540,24184,4756,32015,1
285,6299,72,33,56,0,4,12,72,1,1,1,1,2,2,0,2,0,1,0,0,2,5,0,60540,24184,4756,32016,1
285,6299,1454,835,1044,76,110,219,1530,17,275,158,296,292,454,2297,3718,9,34017,1889,1,2,5,0,60550,24185,4756,32017,1
98,4433,1338,495,1086,10,64,173,1348,11,122,82,157,133,239,883,1686,7,11934,663,0,2,31,0,60550,24187,4756,32018,1
240,5514,4293,999,3693,19,54,507,4312,9,155,88,170,164,258,1156,1898,4,9368,520,0,2,1,3,60550,24189,4756,32019,0
240,5514,1482,859,1002,125,135,219,1607,16,219,134,251,235,385,1766,3032,9,27804,1544,1,2,1,3,60560,24190,4756,32020,0
83,1788,402,202,227,24,74,80,426,12,52,33,61,64,94,339,564,7,3969,220,0,2,10,1,60560,24191,4756,32021,0
285,6294,72,33,56,0,4,12,72,1,1,1,1,2,2,0,2,0,1,0,0,2,7,3,60560,24191,4756,32022,0
285,6294,1454,835,1044,76,110,219,1530,17,275,158,296,292,454,2297,3718,9,34017,1889,1,2,7,3,60570,24192,4756,32023,0
91,4019,1020,354,843,12,15,144,1032,8,134,77,144,142,221,970,1580,4,6792,377,0,2,39,0,60570,24192,4756,32024,0
83,1788,402,202,227,24,74,80,426,12,52,33,61,64,94,339,564,7,3969,220,0,2,10,1,60570,24193,4756,32025,0
285,6294,72,33,56,0,4,12,72,1,1,1,1,2,2,0,2,0,1,0,0,2,7,3,60570,24193,4756,32026,0
285,6294,1454,835,1044,76,110,219,1530,17,275,158,296,292,454,2297,3718,9,34017,1889,1,2,7,3,60580,24194,4756,32027,0
91,4019,1020,354,843,12,15,144,1032,8,134,77,144,142,221,970,1580,4,6792,377,0,2,39,0,60580,24194,4756,32028,0
240,5514,4293,999,3693,19,54,507,4312,9,155,88,170,164,258,1156,1898,4,9368,520,0,2,48,9,60580,24196,4756,32029,0
240,5514,1482,859,1002,125,135,219,1607,16,219,134,251,235,385,1766,3032,9,27804,1544,1,2,48,9,60590,24197,4756,32030,0
285,6299,72,33,56,0,4,12,72,1,1,1,1,2,2,0,2,0,1,0,0,2,5,0,60590,24197,4756,32031,0
285,6299,1454,835,1044,76,110,219,1530,17,275,158,296,292,454,2297,3718,9,34017,1889,1,2,5,0,60600,24198,4756,32032,0
98,4433,1338,495,1086,10,64,173,1348,11,122,82,157,133,239,883,1686,7,11934,663,0,2,31,0,60600,24200,4756,32033,0
173,7581,139,89,101,2,0,35,141,7,54,34,62,61,96,330,569,4,2287,127,0,2,40,32,60600,24200,4756,32034,0
173,7581,7,5,5,0,0,2,7,1,2,1,2,3,3,2,4,0,2,0,0,2,40,32,60600,24200,4756,32035,0
173,7528,139,89,101,2,0,35,141,7,54,34,62,61,96,330,569,4,2287,127,0,2,20,30,60600,24200,4756,32036,1
173,7528,7,5,5,0,0,2,7,1,2,1,2,3,3,2,4,0,2,0,0,2,20,30,60600,24200,4756,32037,1
173,7537,139,89,101,2,0,35,141,7,54,34,62,61,96,330,569,4,2287,127,0,2,16,7,60600,24200,4756,32038,1
173,7537,7,5,5,0,0,2,7,1,2,1,2,3,3,2,4,0,2,0,0,2,16,7,60600,24200,4756,32039,1
173,7537,139,89,101,2,0,35,141,7,54,34,62,61,96,330,569,4,2287,127,0,2,1,1,60600,24200,4756,32040,0
173,7537,7,5,5,0,0,2,7,1,2,1,2,3,3,2,4,0,2,0,0,2,1,1,60600,24200,4756,32041,0
236,5588,722,423,573,19,0,135,741,12,172,101,199,184,300,1320,2257,6,15668,870,0,2,37,9,60600,24202,4756,32043,1
236,5588,1508,847,911,44,250,301,1552,14,148,88,169,162,257,1120,1886,7,15077,837,0,2,37,9,60600,24203,4757,32044,1
1,26,127,75,83,2,11,30,129,4,14,7,14,18,21,61,87,2,175,9,0,0,7,0,60610,24207,4758,32052,1
1,26,652,304,544,16,6,88,668,6,89,51,101,95,152,591,998,3,3399,188,0,0,7,0,60610,24208,4758,32053,1
1,26,2,2,2,0,0,0,2,0,0,0,0,0,0,0,0,0,0,0,0,0,7,0,60610,24208,4758,32053,1
1,26,8,5,5,0,0,3,8,0,0,0,0,0,0,0,0,0,0,0,0,0,7,0,60610,24208,4758,32054,1
1,26,2,2,2,0,0,0,2,0,0,0,0,0,0,0,0,0,0,0,0,0,7,0,60610,24208,4758,32054,1
1,26,14,8,8,0,0,6,14,0,0,0,0,0,0,0,0,0,0,0,0,0,7,0,60610,24208,4758,32055,1
1,26,6,4,4,0,0,2,6,0,0,0,0,0,0,0,0,0,0,0,0,0,7,0,60610,24208,4758,32056,1
1,26,6,4,4,0,0,2,6,1,2,1,2,3,3,2,4,0,2,0,0,0,7,0,60610,24208,4758,32057,1
1,26,6,4,4,0,0,2,6,0,0,0,0,0,0,0,0,0,0,0,0,0,7,0,60610,24208,4758,32058,1
1,26,7,5,5,0,0,2,7,0,0,0,0,0,0,0,0,0,0,0,0,0,7,0,60610,24208,4758,32059,1
1,26,6,4,4,0,0,2,6,0,0,0,0,0,0,0,0,0,0,0,0,0,7,0,60610,24208,4758,32060,1
1,26,10,6,6,0,0,4,10,0,0,0,0,0,0,0,0,0,0,0,0,0,7,0,60610,24208,4758,32061,1
1,26,1,1,1,0,0,0,1,0,0,0,0,0,0,0,0,0,0,0,0,0,7,0,60610,24208,4758,32061,1
1,26,14,10,10,0,0,4,14,1,1,1,1,2,2,0,2,0,1,0,0,0,7,0,60610,24208,4758,32062,1
1,26,46,26,30,3,0,12,49,3,6,3,6,9,9,20,28,1,42,2,0,0,7,0,60620,24208,4758,32063,1
1,7,2,2,2,0,0,0,2,0,0,0,0,0,0,0,0,0,0,0,0,0,2,0,60620,24208,4758,32063,1
1,20,127,75,83,2,11,30,129,4,14,7,14,18,21,61,87,2,175,9,0,0,7,0,60630,24212,4759,32071,1
1,20,652,304,544,16,6,88,668,6,89,51,101,95,152,591,998,3,3399,188,0,0,7,0,60630,24213,4759,32072,1
1,20,2,2,2,0,0,0,2,0,0,0,0,0,0,0,0,0,0,0,0,0,7,0,60630,24213,4759,32072,1
1,20,8,5,5,0,0,3,8,0,0,0,0,0,0,0,0,0,0,0,0,0,7,0,60630,24213,4759,32073,1
1,20,2,2,2,0,0,0,2,0,0,0,0,0,0,0,0,0,0,0,0,0,7,0,60630,24213,4759,32073,1
1,20,14,8,8,0,0,6,14,0,0,0,0,0,0,0,0,0,0,0,0,0,7,0,60630,24213,4759,32074,1
1,20,6,4,4,0,0,2,6,0,0,0,0,0,0,0,0,0,0,0,0,0,7,0,60630,24213,4759,32075,1
1,20,6,4,4,0,0,2,6,1,2,1,2,3,3,2,4,0,2,0,0,0,7,0,60630,24213,4759,32076,1
1,20,6,4,4,0,0,2,6,0,0,0,0,0,0,0,0,0,0,0,0,0,7,0,60630,24213,4759,32077,1
1,20,7,5,5,0,0,2,7,0,0,0,0,0,0,0,0,0,0,0,0,0,7,0,60630,24213,4759,32078,1
1,20,6,4,4,0,0,2,6,0,0,0,0,0,0,0,0,0,0,0,0,0,7,0,60630,24213,4759,32079,1
1,20,10,6,6,0,0,4,10,0,0,0,0,0,0,0,0,0,0,0,0,0,7,0,60630,24213,4759,32080,1
1,20,1,1,1,0,0,0,1,0,0,0,0,0,0,0,0,0,0,0,0,0,7,0,60630,24213,4759,32080,1
1,20,14,10,10,0,0,4,14,1,1,1,1,2,2,0,2,0,1,0,0,0,7,0,60630,24213,4759,32081,1
1,20,46,26,30,3,0,12,49,3,6,3,6,9,9,20,28,1,42,2,0,0,7,0,60640,24213,4759,32082,1
1,7,2,2,2,0,0,0,2,0,0,0,0,0,0,0,0,0,0,0,0,0,2,0,60640,24213,4759,32082,1
1,13,127,75,83,2,11,30,129,4,14,7,14,18,21,61,87,2,175,9,0,0,6,0,60640,24213,4759,32083,1
1,13,652,304,544,16,6,88,668,6,89,51,101,95,152,591,998,3,3399,188,0,0,6,0,60640,24214,4759,32084,1
1,13,2,2,2,0,0,0,2,0,0,0,0,0,0,0,0,0,0,0,0,0,6,0,60640,24214,4759,32084,1
1,13,8,5,5,0,0,3,8,0,0,0,0,0,0,0,0,0,0,0,0,0,6,0,60640,24214,4759,32085,1
1,13,2,2,2,0,0,0,2,0,0,0,0,0,0,0,0,0,0,0,0,0,6,0,60640,24214,4759,32085,1
1,13,14,8,8,0,0,6,14,0,0,0,0,0,0,0,0,0,0,0,0,0,6,0,60640,24214,4759,32086,1
1,13,6,4,4,0,0,2,6,0,0,0,0,0,0,0,0,0,0,0,0,0,6,0,60640,24214,4759,32087,1
1,13,6,4,4,0,0,2,6,1,2,1,2,3,3,2,4,0,2,0,0,0,6,0,60640,24214,4759,32088,1
1,13,6,4,4,0,0,2,6,0,0,0,0,0,0,0,0,0,0,0,0,0,6,0,60640,24214,4759,32089,1
1,13,7,5,5,0,0,2,7,0,0,0,0,0,0,0,0,0,0,0,0,0,6,0,60640,24214,4759,32090,1
1,13,6,4,4,0,0,2,6,0,0,0,0,0,0,0,0,0,0,0,0,0,6,0,60640,24214,4759,32091,1
1,13,10,6,6,0,0,4,10,0,0,0,0,0,0,0,0,0,0,0,0,0,6,0,60640,24214,4759,32092,1
1,13,1,1,1,0,0,0,1,0,0,0,0,0,0,0,0,0,0,0,0,0,6,0,60640,24214,4759,32092,1
1,13,14,10,10,0,0,4,14,1,1,1,1,2,2,0,2,0,1,0,0,0,6,0,60640,24214,4759,32093,1
1,13,46,26,30,3,0,12,49,3,6,3,6,9,9,20,28,1,42,2,0,0,6,0,60650,24214,4759,32094,1
1,16,127,75,83,2,11,30,129,4,14,7,14,18,21,61,87,2,175,9,0,0,6,0,60660,24218,4760,32102,1
1,16,652,304,544,16,6,88,668,6,89,51,101,95,152,591,998,3,3399,188,0,0,6,0,60660,24219,4760,32103,1
1,16,2,2,2,0,0,0,2,0,0,0,0,0,0,0,0,0,0,0,0,0,6,0,60660,24219,4760,32103,1
1,16,8,5,5,0,0,3,8,0,0,0,0,0,0,0,0,0,0,0,0,0,6,0,60660,24219,4760,32104,1
1,16,2,2,2,0,0,0,2,0,0,0,0,0,0,0,0,0,0,0,0,0,6,0,60660,24219,4760,32104,1
1,16,14,8,8,0,0,6,14,0,0,0,0,0,0,0,0,0,0,0,0,0,6,0,60660,24219,4760,32105,1
1,16,6,4,4,0,0,2,6,0,0,0,0,0,0,0,0,0,0,0,0,0,6,0,60660,24219,4760,32106,1
1,16,6,4,4,0,0,2,6,1,2,1,2,3,3,2,4,0,2,0,0,0,6,0,60660,24219,4760,32107,1
1,16,6,4,4,0,0,2,6,0,0,0,0,0,0,0,0,0,0,0,0,0,6,0,60660,24219,4760,32108,1
1,16,7,5,5,0,0,2,7,0,0,0,0,0,0,0,0,0,0,0,0,0,6,0,60660,24219,4760,32109,1
1,16,6,4,4,0,0,2,6,0,0,0,0,0,0,0,0,0,0,0,0,0,6,0,60660,24219,4760,32110,1
1,16,10,6,6,0,0,4,10,0,0,0,0,0,0,0,0,0,0,0,0,0,6,0,60660,24219,4760,32111,1
1,16,1,1,1,0,0,0,1,0,0,0,0,0,0,0,0,0,0,0,0,0,6,0,60660,24219,4760,32111,1
1,16,14,10,10,0,0,4,14,1,1,1,1,2,2,0,2,0,1,0,0,0,6,0,60660,24219,4760,32112,1
1,16,46,26,30,3,0,12,49,3,6,3,6,9,9,20,28,1,42,2,0,0,6,0,60670,24219,4760,32113,1
1,10,2,2,2,0,0,0,2,1,2,1,2,3,3,2,4,0,2,0,0,0,2,0,60670,24219,4760,32113,1
1,13,127,75,83,2,11,30,129,4,14,7,14,18,21,61,87,2,175,9,0,0,6,0,60670,24219,4760,32114,1
1,13,652,304,544,16,6,88,668,6,89,51,101,95,152,591,998,3,3399,188,0,0,6,0,60670,24220,4760,32115,1
1,13,2,2,2,0,0,0,2,0,0,0,0,0,0,0,0,0,0,0,0,0,6,0,60670,24220,4760,32115,1
1,13,8,5,5,0,0,3,8,0,0,0,0,0,0,0,0,0,0,0,0,0,6,0,60670,24220,4760,32116,1
1,13,2,2,2,0,0,0,2,0,0,0,0,0,0,0,0,0,0,0,0,0,6,0,60670,24220,4760,32116,1
1,13,14,8,8,0,0,6,14,0,0,0,0,0,0,0,0,0,0,0,0,0,6,0,60670,24220,4760,32117,1
1,13,6,4,4,0,0,2,6,0,0,0,0,0,0,0,0,0,0,0,0,0,6,0,60670,24220,4760,32118,1
1,13,6,4,4,0,0,2,6,1,2,1,2,3,3,2,4,0,2,0,0,0,6,0,60670,24220,4760,32119,1
1,13,6,4,4,0,0,2,6,0,0,0,0,0,0,0,0,0,0,0,0,0,6,0,60670,24220,4760,32120,1
1,13,7,5,5,0,0,2,7,0,0,0,0,0,0,0,0,0,0,0,0,0,6,0,60670,24220,4760,32121,1
1,13,6,4,4,0,0,2,6,0,0,0,0,0,0,0,0,0,0,0,0,0,6,0,60670,24220,4760,32122,1
1,13,10,6,6,0,0,4,10,0,0,0,0,0,0,0,0,0,0,0,0,0,6,0,60670,24220,4760,32123,1
1,13,1,1,1,0,0,0,1,0,0,0,0,0,0,0,0,0,0,0,0,0,6,0,60670,24220,4760,32123,1
1,13,14,10,10,0,0,4,14,1,1,1,1,2,2,0,2,0,1,0,0,0,6,0,60670,24220,4760,32124,1
1,13,46,26,30,3,0,12,49,3,6,3,6,9,9,20,28,1,42,2,0,0,6,0,60680,24220,4760,32125,1
2,26,10,6,6,0,0,4,10,2,4,2,4,6,6,10,15,1,15,0,0,0,10,0,60680,24220,4760,32126,1
3,47,15,10,10,0,0,5,15,2,4,2,4,6,6,10,15,1,15,0,0,0,15,0,60680,24220,4760,32127,1
3,39,15,9,9,0,0,6,15,0,0,0,0,0,0,0,0,0,0,0,0,0,16,0,60680,24220,4760,32128,1
2,36,10,7,7,0,0,3,10,1,2,1,2,3,3,2,4,0,2,0,0,0,11,0,60680,24220,4760,32129,1
3,46,15,9,9,0,0,6,15,1,4,2,4,5,6,8,13,0,6,0,0,0,15,0,60680,24220,4760,32130,1
2,21,10,6,6,0,0,4,10,0,0,0,0,0,0,0,0,0,0,0,0,0,10,0,60680,24220,4760,32131,1
173,7444,139,89,101,2,0,35,141,7,54,34,62,61,96,330,569,4,2287,127,0,2,18,151,60680,24220,4760,32132,1
173,7444,7,5,5,0,0,2,7,1,2,1,2,3,3,2,4,0,2,0,0,2,18,151,60680,24220,4760,32133,1
84,1794,402,202,227,24,74,80,426,12,52,33,61,64,94,339,564,7,3969,220,0,2,1,1,60680,24221,4760,32134,0
92,3984,1020,354,843,12,15,144,1032,8,134,77,144,142,221,970,1580,4,6792,377,0,2,13,0,60680,24221,4760,32135,0
86,2229,773,422,505,30,103,129,803,14,77,46,83,91,129,535,839,7,6334,351,0,2,3,1,60690,24222,4761,32136,0
32,2074,1157,318,931,29,22,177,1186,6,104,63,125,110,188,712,1274,3,4596,255,0,2,34,0,60690,24222,4761,32137,0
32,2078,1157,318,931,29,22,177,1186,6,104,63,125,110,188,712,1274,3,4596,255,0,2,1,0,60690,24222,4761,32138,0
32,2083,1157,318,931,29,22,177,1186,6,104,63,125,110,188,712,1274,3,4596,255,0,2,5,2,60690,24222,4761,32139,0
32,2079,1157,318,931,29,22,177,1186,6,104,63,125,110,188,712,1274,3,4596,255,0,2,1,1,60690,24222,4761,32140,0
86,2229,773,422,505,30,103,129,803,14,77,46,83,91,129,535,839,7,6334,351,0,2,3,1,60700,24223,4762,32141,0
32,2079,1157,318,931,29,22,177,1186,6,104,63,125,110,188,712,1274,3,4596,255,0,2,38,0,60700,24223,4762,32142,0
84,1794,402,202,227,24,74,80,426,12,52,33,61,64,94,339,564,7,3969,220,0,2,1,1,60700,24224,4762,32143,0
92,3984,1020,354,843,12,15,144,1032,8,134,77,144,142,221,970,1580,4,6792,377,0,2,13,0,60700,24224,4762,32144,0
32,938,339,213,244,17,9,65,356,10,42,26,48,52,74,259,421,5,2410,133,0,2,29,3,60710,24224,4762,32145,1
60,2660,1293,570,1093,25,15,163,1318,10,195,123,241,205,364,1516,2795,6,17273,959,0,2,17,0,60720,24226,4762,32146,1
32,948,339,213,244,17,9,65,356,10,42,26,48,52,74,259,421,5,2410,133,0,2,2,0,60730,24226,4762,32147,0
60,2660,1293,570,1093,25,15,163,1318,10,195,123,241,205,364,1516,2795,6,17273,959,0,2,2,2,60740,24228,4762,32148,0
33,960,339,213,244,17,9,65,356,10,42,26,48,52,74,259,421,5,2410,133,0,2,6,2,60750,24228,4762,32149,0
33,960,339,213,244,17,9,65,356,10,42,26,48,52,74,259,421,5,2410,133,0,2,3,3,60760,24228,4762,32150,0
60,2658,1293,570,1093,25,15,163,1318,10,195,123,241,205,364,1516,2795,6,17273,959,0,2,2,2,60770,24230,4762,32151,0
60,2658,1293,570,1093,25,15,163,1318,10,195,123,241,205,364,1516,2795,6,17273,959,0,2,1,0,60780,24232,4762,32152,0
48,992,447,308,343,6,5,95,453,7,96,59,111,103,170,651,1136,4,4600,255,0,2,1,1,60780,24235,4762,32153,0
48,992,322,174,179,16,74,51,338,10,41,26,46,51,72,252,408,5,2291,127,0,2,1,1,60780,24238,4763,32154,0
48,992,447,308,343,6,5,95,453,7,96,59,111,103,170,651,1136,4,4600,255,0,2,1,1,60780,24241,4763,32155,0
48,992,322,174,179,16,74,51,338,10,41,26,46,51,72,252,408,5,2291,127,0,2,1,1,60780,24244,4764,32156,0
33,961,339,213,244,17,9,65,356,10,42,26,48,52,74,259,421,5,2410,133,0,2,1,1,60790,24244,4764,32157,0
34,983,339,213,244,17,9,65,356,10,42,26,48,52,74,259,421,5,2410,133,0,2,24,23,60800,24244,4764,32158,1
61,2743,1293,570,1093,25,15,163,1318,10,195,123,241,205,364,1516,2795,6,17273,959,0,2,21,0,60810,24246,4764,32159,1
61,2743,1293,570,1093,25,15,163,1318,10,195,123,241,205,364,1516,2795,6,17273,959,0,2,1,1,60820,24248,4764,32160,0
61,2731,1293,570,1093,25,15,163,1318,10,195,123,241,205,364,1516,2795,6,17273,959,0,2,0,2,60830,24250,4764,32161,0
34,995,339,213,244,17,9,65,356,10,42,26,48,52,74,259,421,5,2410,133,0,2,3,1,60840,24250,4764,32162,0
61,2731,1293,570,1093,25,15,163,1318,10,195,123,241,205,364,1516,2795,6,17273,959,0,2,1,1,60850,24252,4764,32163,0
61,2731,1293,570,1093,25,15,163,1318,10,195,123,241,205,364,1516,2795,6,17273,959,0,2,1,1,60860,24254,4764,32164,0
84,1794,402,202,227,24,74,80,426,12,52,33,61,64,94,339,564,7,3969,220,0,2,1,1,60860,24255,4764,32165,0
86,2229,773,422,505,30,103,129,803,14,77,46,83,91,129,535,839,7,6334,351,0,2,3,1,60870,24256,4765,32166,0
84,1794,402,202,227,24,74,80,426,12,52,33,61,64,94,339,564,7,3969,220,0,2,1,1,60870,24257,4765,32167,0
48,992,447,308,343,6,5,95,453,7,96,59,111,103,170,651,1136,4,4600,255,0,2,1,1,60870,24260,4765,32168,0
48,992,322,174,179,16,74,51,338,10,41,26,46,51,72,252,408,5,2291,127,0,2,1,1,60870,24263,4766,32169,0
32,2079,1157,318,931,29,22,177,1186,6,104,63,125,110,188,712,1274,3,4596,255,0,2,38,0,60870,24263,4766,32170,0
92,3984,1020,354,843,12,15,144,1032,8,134,77,144,142,221,970,1580,4,6792,377,0,2,13,0,60870,24263,4766,32171,0
84,1794,402,202,227,24,74,80,426,12,52,33,61,64,94,339,564,7,3969,220,0,2,1,1,60870,24264,4766,32172,0
88,2252,773,422,505,30,103,129,803,14,77,46,83,91,129,535,839,7,6334,351,0,2,3,1,60880,24265,4767,32173,0
84,1794,402,202,227,24,74,80,426,12,52,33,61,64,94,339,564,7,3969,220,0,2,2,2,60880,24266,4767,32174,0
48,992,447,308,343,6,5,95,453,7,96,59,111,103,170,651,1136,4,4600,255,0,2,1,1,60880,24269,4767,32175,0
48,992,322,174,179,16,74,51,338,10,41,26,46,51,72,252,408,5,2291,127,0,2,1,1,60880,24272,4768,32176,0
32,2079,1157,318,931,29,22,177,1186,6,104,63,125,110,188,712,1274,3,4596,255,0,2,38,0,60880,24272,4768,32177,0
94,4062,1020,354,843,12,15,144,1032,8,134,77,144,142,221,970,1580,4,6792,377,0,2,13,0,60880,24272,4768,32178,0
88,2252,773,422,505,30,103,129,803,14,77,46,83,91,129,535,839,7,6334,351,0,2,3,1,60890,24273,4769,32179,0
84,1794,402,202,227,24,74,80,426,12,52,33,61,64,94,339,564,7,3969,220,0,2,2,2,60890,24274,4769,32180,0
48,992,447,308,343,6,5,95,453,7,96,59,111,103,170,651,1136,4,4600,255,0,2,1,1,60890,24277,4769,32181,0
48,992,322,174,179,16,74,51,338,10,41,26,46,51,72,252,408,5,2291,127,0,2,1,1,60890,24280,4770,32182,0
32,2079,1157,318,931,29,22,177,1186,6,104,63,125,110,188,712,1274,3,4596,255,0,2,38,0,60890,24280,4770,32183,0
94,4062,1020,354,843,12,15,144,1032,8,134,77,144,142,221,970,1580,4,6792,377,0,2,13,0,60890,24280,4770,32184,0
3,42,14,8,8,0,0,6,14,0,0,0,0,0,0,0,0,0,0,0,0,2,5,2,60890,24280,4770,32187,1
2,40,9,6,6,0,0,3,9,0,0,0,0,0,0,0,0,0,0,0,0,2,3,2,60890,24280,4770,32188,1
2,40,13,9,8,0,0,4,13,0,0,0,0,0,0,0,0,0,0,0,0,2,3,2,60890,24280,4770,32189,1
1,324,382,65,130,157,2,92,539,4,10,5,10,14,15,41,57,2,114,6,0,2,119,100,60890,24281,4771,32191,1
60,1081,282,196,195,3,0,86,285,8,130,71,141,138,212,936,1507,4,6538,363,0,2,72,51,60890,24281,4772,32192,1
4,77,127,75,83,2,11,30,129,4,14,7,14,18,21,61,87,2,175,9,0,2,6,3,60890,24281,4772,32193,1
4,77,652,304,544,16,6,88,668,6,89,51,101,95,152,591,998,3,3399,188,0,2,6,3,60890,24282,4772,32194,1
4,77,2,2,2,0,0,0,2,0,0,0,0,0,0,0,0,0,0,0,0,2,6,3,60890,24282,4772,32194,1
4,77,8,5,5,0,0,3,8,0,0,0,0,0,0,0,0,0,0,0,0,2,6,3,60890,24282,4772,32195,1
4,77,2,2,2,0,0,0,2,0,0,0,0,0,0,0,0,0,0,0,0,2,6,3,60890,24282,4772,32195,1
4,77,14,8,8,0,0,6,14,0,0,0,0,0,0,0,0,0,0,0,0,2,6,3,60890,24282,4772,32196,1
4,77,6,4,4,0,0,2,6,0,0,0,0,0,0,0,0,0,0,0,0,2,6,3,60890,24282,4772,32197,1
4,77,6,4,4,0,0,2,6,1,2,1,2,3,3,2,4,0,2,0,0,2,6,3,60890,24282,4772,32198,1
4,77,6,4,4,0,0,2,6,0,0,0,0,0,0,0,0,0,0,0,0,2,6,3,60890,24282,4772,32199,1
4,77,7,5,5,0,0,2,7,0,0,0,0,0,0,0,0,0,0,0,0,2,6,3,60890,24282,4772,32200,1
4,77,6,4,4,0,0,2,6,0,0,0,0,0,0,0,0,0,0,0,0,2,6,3,60890,24282,4772,32201,1
4,77,10,6,6,0,0,4,10,0,0,0,0,0,0,0,0,0,0,0,0,2,6,3,60890,24282,4772,32202,1
4,77,1,1,1,0,0,0,1,0,0,0,0,0,0,0,0,0,0,0,0,2,6,3,60890,24282,4772,32202,1
4,77,14,10,10,0,0,4,14,1,1,1,1,2,2,0,2,0,1,0,0,2,6,3,60890,24282,4772,32203,1
4,77,46,26,30,3,0,12,49,3,6,3,6,9,9,20,28,1,42,2,0,2,6,3,60900,24282,4772,32204,1
1,9,5,3,3,0,0,2,5,0,0,0,0,0,0,0,0,0,0,0,0,2,1,0,60900,24282,4772,32204,1
1,90,13,10,10,0,0,3,13,1,2,1,2,3,3,2,4,0,2,0,0,2,5,5,60900,24282,4772,32205,1
7,114,44,19,17,0,16,11,44,3,14,7,14,17,21,58,85,1,128,7,0,2,3,1,60900,24282,4772,32206,1
3,66,127,75,83,2,11,30,129,4,14,7,14,18,21,61,87,2,175,9,0,2,4,1,60900,24282,4772,32207,1
3,66,652,304,544,16,6,88,668,6,89,51,101,95,152,591,998,3,3399,188,0,2,4,1,60900,24283,4772,32208,1
3,66,2,2,2,0,0,0,2,0,0,0,0,0,0,0,0,0,0,0,0,2,4,1,60900,24283,4772,32208,1
3,66,8,5,5,0,0,3,8,0,0,0,0,0,0,0,0,0,0,0,0,2,4,1,60900,24283,4772,32209,1
3,66,2,2,2,0,0,0,2,0,0,0,0,0,0,0,0,0,0,0,0,2,4,1,60900,24283,4772,32209,1
3,66,14,8,8,0,0,6,14,0,0,0,0,0,0,0,0,0,0,0,0,2,4,1,60900,24283,4772,32210,1
3,66,6,4,4,0,0,2,6,0,0,0,0,0,0,0,0,0,0,0,0,2,4,1,60900,24283,4772,32211,1
3,66,6,4,4,0,0,2,6,1,2,1,2,3,3,2,4,0,2,0,0,2,4,1,60900,24283,4772,32212,1
3,66,6,4,4,0,0,2,6,0,0,0,0,0,0,0,0,0,0,0,0,2,4,1,60900,24283,4772,32213,1
3,66,7,5,5,0,0,2,7,0,0,0,0,0,0,0,0,0,0,0,0,2,4,1,60900,24283,4772,32214,1
3,66,6,4,4,0,0,2,6,0,0,0,0,0,0,0,0,0,0,0,0,2,4,1,60900,24283,4772,32215,1
3,66,10,6,6,0,0,4,10,0,0,0,0,0,0,0,0,0,0,0,0,2,4,1,60900,24283,4772,32216,1
3,66,1,1,1,0,0,0,1,0,0,0,0,0,0,0,0,0,0,0,0,2,4,1,60900,24283,4772,32216,1
3,66,14,10,10,0,0,4,14,1,1,1,1,2,2,0,2,0,1,0,0,2,4,1,60900,24283,4772,32217,1
3,66,46,26,30,3,0,12,49,3,6,3,6,9,9,20,28,1,42,2,0,2,4,1,60910,24283,4772,32218,1
7,298,72,33,56,0,4,12,72,1,1,1,1,2,2,0,2,0,1,0,0,2,26,10,60910,24283,4772,32219,1
12,229,127,75,83,2,11,30,129,4,14,7,14,18,21,61,87,2,175,9,0,2,13,6,60910,24283,4772,32220,1
12,229,652,304,544,16,6,88,668,6,89,51,101,95,152,591,998,3,3399,188,0,2,13,6,60910,24284,4772,32221,1
12,229,2,2,2,0,0,0,2,0,0,0,0,0,0,0,0,0,0,0,0,2,13,6,60910,24284,4772,32221,1
12,229,8,5,5,0,0,3,8,0,0,0,0,0,0,0,0,0,0,0,0,2,13,6,60910,24284,4772,32222,1
12,229,2,2,2,0,0,0,2,0,0,0,0,0,0,0,0,0,0,0,0,2,13,6,60910,24284,4772,32222,1
12,229,14,8,8,0,0,6,14,0,0,0,0,0,0,0,0,0,0,0,0,2,13,6,60910,24284,4772,32223,1
12,229,6,4,4,0,0,2,6,0,0,0,0,0,0,0,0,0,0,0,0,2,13,6,60910,24284,4772,32224,1
12,229,6,4,4,0,0,2,6,1,2,1,2,3,3,2,4,0,2,0,0,2,13,6,60910,24284,4772,32225,1
12,229,6,4,4,0,0,2,6,0,0,0,0,0,0,0,0,0,0,0,0,2,13,6,60910,24284,4772,32226,1
12,229,7,5,5,0,0,2,7,0,0,0,0,0,0,0,0,0,0,0,0,2,13,6,60910,24284,4772,32227,1
12,229,6,4,4,0,0,2,6,0,0,0,0,0,0,0,0,0,0,0,0,2,13,6,60910,24284,4772,32228,1
12,229,10,6,6,0,0,4,10,0,0,0,0,0,0,0,0,0,0,0,0,2,13,6,60910,24284,4772,32229,1
12,229,1,1,1,0,0,0,1,0,0,0,0,0,0,0,0,0,0,0,0,2,13,6,60910,24284,4772,32229,1
12,229,14,10,10,0,0,4,14,1,1,1,1,2,2,0,2,0,1,0,0,2,13,6,60910,24284,4772,32230,1
12,229,46,26,30,3,0,12,49,3,6,3,6,9,9,20,28,1,42,2,0,2,13,6,60920,24284,4772,32231,1
6,71,127,75,83,2,11,30,129,4,14,7,14,18,21,61,87,2,175,9,0,2,2,3,60920,24284,4772,32232,1
6,71,652,304,544,16,6,88,668,6,89,51,101,95,152,591,998,3,3399,188,0,2,2,3,60920,24285,4772,32233,1
6,71,2,2,2,0,0,0,2,0,0,0,0,0,0,0,0,0,0,0,0,2,2,3,60920,24285,4772,32233,1
6,71,8,5,5,0,0,3,8,0,0,0,0,0,0,0,0,0,0,0,0,2,2,3,60920,24285,4772,32234,1
6,71,2,2,2,0,0,0,2,0,0,0,0,0,0,0,0,0,0,0,0,2,2,3,60920,24285,4772,32234,1
6,71,14,8,8,0,0,6,14,0,0,0,0,0,0,0,0,0,0,0,0,2,2,3,60920,24285,4772,32235,1
6,71,6,4,4,0,0,2,6,0,0,0,0,0,0,0,0,0,0,0,0,2,2,3,60920,24285,4772,32236,1
6,71,6,4,4,0,0,2,6,1,2,1,2,3,3,2,4,0,2,0,0,2,2,3,60920,24285,4772,32237,1
6,71,6,4,4,0,0,2,6,0,0,0,0,0,0,0,0,0,0,0,0,2,2,3,60920,24285,4772,32238,1
6,71,7,5,5,0,0,2,7,0,0,0,0,0,0,0,0,0,0,0,0,2,2,3,60920,24285,4772,32239,1
6,71,6,4,4,0,0,2,6,0,0,0,0,0,0,0,0,0,0,0,0,2,2,3,60920,24285,4772,32240,1
6,71,10,6,6,0,0,4,10,0,0,0,0,0,0,0,0,0,0,0,0,2,2,3,60920,24285,4772,32241,1
6,71,1,1,1,0,0,0,1,0,0,0,0,0,0,0,0,0,0,0,0,2,2,3,60920,24285,4772,32241,1
6,71,14,10,10,0,0,4,14,1,1,1,1,2,2,0,2,0,1,0,0,2,2,3,60920,24285,4772,32242,1
6,71,46,26,30,3,0,12,49,3,6,3,6,9,9,20,28,1,42,2,0,2,2,3,60930,24285,4772,32243,1
3,26,14,7,7,2,0,5,16,0,0,0,0,0,0,0,0,0,0,0,0,2,4,1,60930,24285,4772,32243,1
7,103,38,23,23,0,0,15,38,0,0,0,0,0,0,0,0,0,0,0,0,2,8,0,60930,24285,4772,32244,1
17,378,85,59,61,8,0,16,93,5,18,10,18,23,28,86,126,2,316,17,0,2,20,19,60930,24285,4772,32245,1
11,413,42,7,35,4,0,5,46,1,2,1,2,3,3,2,4,0,2,0,0,2,59,66,60930,24285,4772,32246,1
11,413,11,6,10,0,0,1,11,2,4,2,4,6,6,10,15,1,15,0,0,2,59,66,60930,24285,4772,32247,1
11,238,19,8,11,5,0,4,24,2,5,3,6,7,9,13,25,1,30,1,0,3,10,6,60940,24289,4773,32255,1
11,238,102,59,69,5,3,24,107,6,22,15,28,28,43,113,206,3,789,43,0,3,10,6,60940,24289,4773,32256,1
11,238,106,40,36,3,49,17,109,8,17,13,23,25,36,93,167,5,904,50,0,3,10,6,60940,24289,4773,32257,1
213,4619,182,127,129,0,0,53,182,5,39,21,42,44,63,217,343,2,926,51,0,3,128,67,60950,24293,4775,32265,1
213,4619,1165,710,800,67,119,181,1232,18,243,153,282,261,435,2000,3492,10,36473,2026,1,3,128,67,60960,24293,4776,32266,1
83,1808,773,419,590,28,0,166,801,10,204,113,217,214,330,1598,2554,5,13587,754,0,3,37,22,60960,24293,4777,32267,1
83,1808,421,273,302,44,34,57,465,17,81,59,107,98,166,583,1098,11,12329,684,0,3,37,22,60960,24293,4778,32268,1
26,525,2,2,2,0,0,0,2,0,0,0,0,0,0,0,0,0,0,0,0,3,21,16,60960,24293,4778,32268,1
26,525,99,48,90,1,3,5,100,0,0,0,0,0,0,0,0,0,0,0,0,3,21,16,60960,24294,4778,32269,1
26,525,8,5,5,2,0,1,10,0,0,0,0,0,0,0,0,0,0,0,0,3,21,16,60960,24294,4778,32270,1
26,525,1217,716,841,84,126,174,1301,14,185,118,215,199,333,1446,2542,8,20687,1149,0,3,21,16,60970,24296,4778,32271,1
26,525,160,89,115,0,13,31,160,7,15,11,17,22,28,78,124,3,495,27,0,3,21,16,60970,24296,4778,32272,1
26,525,10,10,9,9,0,0,19,0,0,0,0,0,0,0,0,0,0,0,0,3,21,16,60970,24296,4779,32273,1
26,525,173,84,99,8,29,36,181,5,12,7,13,17,20,54,81,2,221,12,0,3,21,16,60970,24297,4779,32274,1
26,525,3,1,1,3,0,0,6,0,0,0,0,0,0,0,0,0,0,0,0,3,21,16,60970,24297,4779,32275,1
164,5065,1660,832,1314,41,38,274,1701,20,312,209,395,332,604,2671,5058,12,64042,3557,1,3,89,62,60970,24299,4780,32277,1
164,5065,1057,646,719,113,100,145,1170,18,215,134,248,233,382,1740,3004,10,31186,1732,1,3,89,62,60980,24300,4781,32278,1
17,344,95,58,50,9,16,20,104,12,33,24,45,45,69,209,378,8,3100,172,0,3,6,9,60980,24300,4781,32279,1
89,1830,477,336,357,30,23,73,507,16,194,134,250,210,384,1538,2962,10,30538,1696,0,3,97,63,60990,24301,4781,32280,1
74,1693,996,429,845,24,10,117,1020,7,76,50,88,83,138,494,879,4,3565,198,0,3,127,91,60990,24303,4781,32281,1
74,1693,456,277,329,12,42,72,468,13,85,50,97,98,147,592,972,7,7212,400,0,3,127,91,60990,24303,4781,32282,1
145,3016,1513,682,1277,25,13,200,1538,11,199,116,219,210,335,1557,2584,6,15641,868,0,3,58,42,60990,24305,4781,32283,1
145,3016,819,519,539,24,98,155,843,15,96,57,106,111,163,690,1107,8,9171,509,0,3,58,42,61000,24307,4781,32284,1
58,1192,207,111,150,11,0,50,218,5,26,19,36,31,55,133,272,3,943,52,0,3,87,59,61000,24307,4781,32285,1
58,1192,410,198,237,31,55,97,441,11,63,38,72,74,110,414,683,6,4293,238,0,3,87,59,61010,24308,4782,32286,1
211,4551,2,2,2,0,0,0,2,0,0,0,0,0,0,0,0,0,0,0,0,3,185,615,61010,24308,4782,32286,1
211,4551,99,48,90,1,3,5,100,0,0,0,0,0,0,0,0,0,0,0,0,3,185,615,61010,24309,4782,32287,1
211,4551,8,5,5,2,0,1,10,0,0,0,0,0,0,0,0,0,0,0,0,3,185,615,61010,24309,4782,32288,1
211,4551,1217,716,841,84,126,174,1301,14,185,118,215,199,333,1446,2542,8,20687,1149,0,3,185,615,61020,24311,4782,32289,1
211,4551,160,89,115,0,13,31,160,7,15,11,17,22,28,78,124,3,495,27,0,3,185,615,61020,24311,4782,32290,1
211,4551,10,10,9,9,0,0,19,0,0,0,0,0,0,0,0,0,0,0,0,3,185,615,61020,24311,4783,32291,1
211,4551,173,84,99,8,29,36,181,5,12,7,13,17,20,54,81,2,221,12,0,3,185,615,61020,24312,4783,32292,1
211,4551,3,1,1,3,0,0,6,0,0,0,0,0,0,0,0,0,0,0,0,3,185,615,61020,24312,4783,32293,1
94,1909,463,295,324,28,62,57,491,12,134,82,154,146,236,989,1696,6,11700,650,0,0,392,0,61030,24313,4783,32294,1
51,727,167,116,138,4,5,22,171,8,48,30,56,56,86,292,499,4,2330,129,0,0,139,0,61030,24313,4783,32295,1
28,810,339,213,244,17,9,65,356,10,42,26,48,52,74,259,421,5,2410,133,0,3,23,11,61040,24313,4783,32296,1
85,2161,1455,414,1257,16,76,112,1471,5,41,23,46,46,69,231,381,2,1069,59,0,3,133,89,61040,24314,4783,32298,1
85,2161,669,365,481,22,61,110,691,15,103,63,122,118,185,747,1273,8,11311,628,0,3,133,89,61050,24314,4784,32299,1
247,5639,4293,999,3693,19,54,507,4312,9,155,88,170,164,258,1156,1898,4,9368,520,0,3,203,107,61050,24316,4784,32300,1
247,5639,1482,859,1002,125,135,219,1607,16,219,134,251,235,385,1766,3032,9,27804,1544,1,3,203,107,61060,24317,4784,32301,1
6,136,44,22,19,0,19,6,44,2,10,6,12,12,18,35,64,1,77,4,0,3,6,4,61060,24317,4784,32302,1
27,959,74,35,59,1,0,14,75,3,14,7,14,17,21,58,85,1,128,7,0,3,78,51,61060,24318,4784,32303,1
27,959,245,125,200,5,7,34,250,7,30,17,34,37,51,166,265,3,1053,58,0,3,78,51,61070,24319,4784,32304,1
51,595,647,139,84,35,284,233,682,0,0,0,0,0,0,0,0,0,0,0,0,3,11,0,61070,24319,4784,32305,1
98,2661,1523,757,1297,19,12,193,1542,12,193,117,230,205,347,1508,2664,7,19053,1058,0,3,138,111,61080,24321,4784,32306,1
98,2661,701,378,504,33,58,109,734,13,110,68,126,123,194,794,1346,7,10027,557,0,3,138,111,61080,24322,4785,32307,1
88,2252,773,422,505,30,103,129,803,14,77,46,83,91,129,535,839,7,6334,351,0,3,173,104,61090,24323,4786,32308,1
140,3246,77,34,69,0,0,8,77,3,24,16,29,27,45,114,213,1,387,21,0,3,154,77,61090,24323,4786,32309,1
140,3246,712,438,573,51,9,84,763,14,102,71,128,116,199,733,1364,8,11988,666,0,3,154,77,61100,24324,4786,32310,1
24,605,2,2,2,0,0,0,2,0,0,0,0,0,0,0,0,0,0,0,0,3,45,28,61100,24324,4786,32310,1
24,605,99,48,90,1,3,5,100,0,0,0,0,0,0,0,0,0,0,0,0,3,45,28,61100,24325,4786,32311,1
24,605,8,5,5,2,0,1,10,0,0,0,0,0,0,0,0,0,0,0,0,3,45,28,61100,24325,4786,32312,1
24,605,1217,716,841,84,126,174,1301,14,185,118,215,199,333,1446,2542,8,20687,1149,0,3,45,28,61110,24327,4786,32313,1
24,605,160,89,115,0,13,31,160,7,15,11,17,22,28,78,124,3,495,27,0,3,45,28,61110,24327,4786,32314,1
24,605,10,10,9,9,0,0,19,0,0,0,0,0,0,0,0,0,0,0,0,3,45,28,61110,24327,4787,32315,1
24,605,173,84,99,8,29,36,181,5,12,7,13,17,20,54,81,2,221,12,0,3,45,28,61110,24328,4787,32316,1
24,605,3,1,1,3,0,0,6,0,0,0,0,0,0,0,0,0,0,0,0,3,45,28,61110,24328,4787,32317,1
30,658,125,97,103,3,0,19,128,9,25,17,27,34,44,144,223,4,1087,60,0,3,23,21,61110,24328,4788,32318,1
22,350,102,57,55,5,16,25,107,5,17,10,18,22,28,81,124,2,330,18,0,3,10,10,61110,24328,4788,32319,1
84,1794,402,202,227,24,74,80,426,12,52,33,61,64,94,339,564,7,3969,220,0,3,70,42,61110,24329,4788,32320,1
48,992,447,308,343,6,5,95,453,7,96,59,111,103,170,651,1136,4,4600,255,0,3,17,18,61110,24332,4788,32321,1
48,992,322,174,179,16,74,51,338,10,41,26,46,51,72,252,408,5,2291,127,0,3,17,18,61110,24335,4789,32322,1
74,1669,53,23,39,0,0,13,53,2,8,4,8,10,12,26,39,1,39,2,0,3,61,28,61110,24335,4789,32323,1
74,1669,515,298,307,33,80,99,548,12,63,44,77,75,121,419,753,7,5527,307,0,3,61,28,61120,24335,4789,32324,1
23,381,424,94,331,4,0,89,428,1,5,5,5,6,10,11,25,0,12,0,0,3,14,14,61120,24336,4789,32325,1
23,381,38,23,23,6,0,8,44,3,11,7,11,14,18,42,68,1,102,5,0,3,14,14,61120,24336,4789,32326,1
20,511,205,80,86,16,53,53,221,7,18,10,19,25,29,94,134,3,497,27,0,3,25,14,61130,24336,4790,32327,1
17,519,184,100,137,2,15,30,186,6,38,20,39,44,59,214,322,3,991,55,0,3,30,21,61130,24337,4790,32328,1
17,519,103,65,74,8,5,16,111,7,17,9,17,24,26,89,119,3,417,23,0,3,30,21,61130,24338,4790,32329,1
2,71,167,116,138,4,5,22,171,8,48,30,56,56,86,292,499,4,2330,129,0,0,13,0,61130,24338,4790,32330,1
231,5436,722,423,573,19,0,135,741,12,172,101,199,184,300,1320,2257,6,15668,870,0,3,140,79,61130,24340,4790,32332,1
231,5436,1508,847,911,44,250,301,1552,14,148,88,169,162,257,1120,1886,7,15077,837,0,3,140,79,61130,24341,4791,32333,1
310,6786,72,33,56,0,4,12,72,1,1,1,1,2,2,0,2,0,1,0,0,3,298,186,61130,24341,4791,32334,1
310,6786,1454,835,1044,76,110,219,1530,17,275,158,296,292,454,2297,3718,9,34017,1889,1,3,298,186,61140,24342,4791,32335,1
78,1601,757,253,292,73,244,162,830,13,61,38,67,74,105,409,651,7,4654,258,0,3,53,33,61140,24343,4791,32336,1
46,954,386,256,301,16,9,68,402,4,59,35,69,63,104,355,621,2,1453,80,0,3,23,16,61140,24343,4791,32337,1
46,954,264,131,164,11,41,46,275,6,38,22,40,44,62,214,338,3,1068,59,0,3,23,16,61150,24343,4792,32338,1
28,702,466,257,367,18,25,50,484,7,126,86,171,133,257,898,1813,4,8612,478,0,0,196,0,61150,24343,4792,32339,1
28,702,507,281,342,29,59,88,536,10,53,29,57,63,86,336,514,5,2764,153,0,0,196,0,61150,24343,4792,32340,1
30,650,215,129,180,6,0,29,221,8,65,43,72,73,115,415,711,4,3153,175,0,3,24,18,61150,24343,4792,32341,1
30,650,97,69,77,3,3,16,100,6,22,13,23,28,36,113,173,3,542,30,0,3,24,18,61150,24344,4792,32342,1
90,1927,1043,504,840,53,9,147,1096,9,180,112,198,189,310,1377,2344,4,11604,644,0,3,77,216,61150,24346,4792,32343,1
90,1927,383,288,292,26,6,62,409,11,65,38,67,76,105,429,656,5,3719,206,0,3,77,216,61150,24347,4792,32344,1
20,411,294,64,250,0,0,43,294,1,20,10,20,21,30,86,131,0,65,3,0,3,30,20,61150,24347,4792,32345,1
20,411,78,46,62,3,0,14,81,3,8,4,8,11,12,28,41,1,62,3,0,3,30,20,61150,24348,4792,32346,1
5,119,110,30,77,3,13,16,113,4,21,15,30,25,45,100,208,2,597,33,0,3,7,3,61150,24348,4792,32347,1
5,119,28,15,21,1,0,6,29,0,0,0,0,0,0,0,0,0,0,0,0,3,7,3,61150,24348,4792,32348,1
70,1382,1178,367,1042,6,15,115,1184,9,94,51,95,103,146,644,976,4,4439,246,0,3,78,69,61150,24348,4792,32349,1
70,1382,177,108,140,8,0,27,185,6,30,16,32,36,48,162,248,3,794,44,0,3,78,69,61150,24350,4792,32350,1
209,4552,1943,715,1694,26,18,214,1969,12,185,120,237,197,357,1436,2721,7,20915,1161,0,3,222,138,61150,24352,4792,32351,1
209,4552,1168,838,957,57,25,144,1225,19,348,224,416,367,640,3018,5452,11,61921,3440,1,3,222,138,61160,24354,4792,32352,1
16,480,442,244,305,14,16,103,456,11,68,45,75,79,120,452,756,6,4588,254,0,3,11,8,61160,24356,4792,32353,1
16,480,182,102,99,11,40,35,193,3,11,6,11,14,17,42,64,1,97,5,0,3,11,8,61160,24357,4792,32354,1
62,1226,1098,241,925,5,10,155,1103,7,46,25,49,53,74,273,423,3,1580,87,0,3,42,28,61170,24359,4792,32355,1
62,1226,282,202,222,14,2,44,296,8,42,24,43,50,67,250,378,4,1548,86,0,3,42,28,61170,24360,4792,32356,1
22,458,601,196,481,2,23,85,603,8,63,36,72,71,108,400,664,4,3036,168,0,3,35,20,61170,24360,4792,32357,1
22,458,156,79,106,5,16,28,161,5,14,8,15,19,23,64,97,2,261,14,0,3,35,20,61170,24360,4792,32358,1
92,3868,1289,550,1043,56,32,155,1345,10,167,93,185,177,278,1266,2075,5,11498,638,0,2,307,281,61180,24366,4794,32366,1
36,1088,182,127,129,0,0,53,182,5,39,21,42,44,63,217,343,2,926,51,0,2,40,34,61180,24366,4795,32367,1
147,6910,1392,870,1177,35,17,170,1427,14,494,280,531,508,811,4473,7289,7,54850,3047,2,2,268,173,61180,24369,4796,32368,1
88,2881,773,419,590,28,0,166,801,10,204,113,217,214,330,1598,2554,5,13587,754,0,2,153,84,61180,24369,4797,32369,1
15,744,75,38,59,1,3,12,76,2,4,2,4,6,6,10,15,1,15,0,0,2,139,77,61180,24369,4797,32370,1
1,15,127,75,83,2,11,30,129,4,14,7,14,18,21,61,87,2,175,9,0,0,4,0,61180,24369,4797,32371,1
1,15,652,304,544,16,6,88,668,6,89,51,101,95,152,591,998,3,3399,188,0,0,4,0,61180,24370,4797,32372,1
1,15,2,2,2,0,0,0,2,0,0,0,0,0,0,0,0,0,0,0,0,0,4,0,61180,24370,4797,32372,1
1,15,8,5,5,0,0,3,8,0,0,0,0,0,0,0,0,0,0,0,0,0,4,0,61180,24370,4797,32373,1
1,15,2,2,2,0,0,0,2,0,0,0,0,0,0,0,0,0,0,0,0,0,4,0,61180,24370,4797,32373,1
1,15,14,8,8,0,0,6,14,0,0,0,0,0,0,0,0,0,0,0,0,0,4,0,61180,24370,4797,32374,1
1,15,6,4,4,0,0,2,6,0,0,0,0,0,0,0,0,0,0,0,0,0,4,0,61180,24370,4797,32375,1
1,15,6,4,4,0,0,2,6,1,2,1,2,3,3,2,4,0,2,0,0,0,4,0,61180,24370,4797,32376,1
1,15,6,4,4,0,0,2,6,0,0,0,0,0,0,0,0,0,0,0,0,0,4,0,61180,24370,4797,32377,1
1,15,7,5,5,0,0,2,7,0,0,0,0,0,0,0,0,0,0,0,0,0,4,0,61180,24370,4797,32378,1
1,15,6,4,4,0,0,2,6,0,0,0,0,0,0,0,0,0,0,0,0,0,4,0,61180,24370,4797,32379,1
1,15,10,6,6,0,0,4,10,0,0,0,0,0,0,0,0,0,0,0,0,0,4,0,61180,24370,4797,32380,1
1,15,1,1,1,0,0,0,1,0,0,0,0,0,0,0,0,0,0,0,0,0,4,0,61180,24370,4797,32380,1
1,15,14,10,10,0,0,4,14,1,1,1,1,2,2,0,2,0,1,0,0,0,4,0,61180,24370,4797,32381,1
1,15,46,26,30,3,0,12,49,3,6,3,6,9,9,20,28,1,42,2,0,0,4,0,61190,24370,4797,32382,1
2,51,127,75,83,2,11,30,129,4,14,7,14,18,21,61,87,2,175,9,0,0,14,0,61190,24370,4797,32383,1
2,51,652,304,544,16,6,88,668,6,89,51,101,95,152,591,998,3,3399,188,0,0,14,0,61190,24371,4797,32384,1
2,51,2,2,2,0,0,0,2,0,0,0,0,0,0,0,0,0,0,0,0,0,14,0,61190,24371,4797,32384,1
2,51,8,5,5,0,0,3,8,0,0,0,0,0,0,0,0,0,0,0,0,0,14,0,61190,24371,4797,32385,1
2,51,2,2,2,0,0,0,2,0,0,0,0,0,0,0,0,0,0,0,0,0,14,0,61190,24371,4797,32385,1
2,51,14,8,8,0,0,6,14,0,0,0,0,0,0,0,0,0,0,0,0,0,14,0,61190,24371,4797,32386,1
2,51,6,4,4,0,0,2,6,0,0,0,0,0,0,0,0,0,0,0,0,0,14,0,61190,24371,4797,32387,1
2,51,6,4,4,0,0,2,6,1,2,1,2,3,3,2,4,0,2,0,0,0,14,0,61190,24371,4797,32388,1
2,51,6,4,4,0,0,2,6,0,0,0,0,0,0,0,0,0,0,0,0,0,14,0,61190,24371,4797,32389,1
2,51,7,5,5,0,0,2,7,0,0,0,0,0,0,0,0,0,0,0,0,0,14,0,61190,24371,4797,32390,1
2,51,6,4,4,0,0,2,6,0,0,0,0,0,0,0,0,0,0,0,0,0,14,0,61190,24371,4797,32391,1
2,51,10,6,6,0,0,4,10,0,0,0,0,0,0,0,0,0,0,0,0,0,14,0,61190,24371,4797,32392,1
2,51,1,1,1,0,0,0,1,0,0,0,0,0,0,0,0,0,0,0,0,0,14,0,61190,24371,4797,32392,1
2,51,14,10,10,0,0,4,14,1,1,1,1,2,2,0,2,0,1,0,0,0,14,0,61190,24371,4797,32393,1
2,51,46,26,30,3,0,12,49,3,6,3,6,9,9,20,28,1,42,2,0,0,14,0,61200,24371,4797,32394,1
1,6,2,2,2,0,0,0,2,0,0,0,0,0,0,0,0,0,0,0,0,0,2,0,61200,24371,4797,32394,1
8,263,51,25,36,0,0,15,51,3,11,6,12,14,18,42,68,1,112,6,0,0,51,0,61200,24371,4797,32395,1
1,18,3,3,3,0,0,0,3,0,0,0,0,0,0,0,0,0,0,0,0,0,3,0,61200,24371,4797,32395,1
2,26,6,4,4,0,0,2,6,1,4,2,4,5,6,8,13,0,6,0,0,2,2,3,61200,24371,4797,32397,1
15,703,139,89,101,2,0,35,141,7,54,34,62,61,96,330,569,4,2287,127,0,2,66,48,61200,24371,4797,32399,1
1,136,149,67,118,4,0,27,153,1,17,14,28,18,42,69,175,0,144,8,0,2,13,7,61200,24371,4797,32400,1
32,2079,1157,318,931,29,22,177,1186,6,104,63,125,110,188,712,1274,3,4596,255,0,2,414,274,61200,24371,4797,32401,1
56,3685,520,294,400,33,13,81,553,10,261,204,367,271,571,2128,4614,7,32445,1802,1,2,94,93,61200,24372,4797,32402,1
98,4433,1338,495,1086,10,64,173,1348,11,122,82,157,133,239,883,1686,7,11934,663,0,2,472,291,61200,24374,4797,32403,1
174,7788,139,89,101,2,0,35,141,7,54,34,62,61,96,330,569,4,2287,127,0,2,1208,625,61200,24374,4797,32404,1
174,7788,7,5,5,0,0,2,7,1,2,1,2,3,3,2,4,0,2,0,0,2,1208,625,61200,24374,4797,32405,1
33,1004,465,148,393,5,8,60,470,4,31,20,31,35,51,161,261,2,523,29,0,2,94,55,61200,24375,4797,32406,1
33,1004,16,12,9,0,0,6,16,1,2,1,2,3,3,2,4,0,2,0,0,2,94,55,61200,24375,4797,32407,1
139,5895,1782,648,1425,9,47,279,1791,8,171,97,189,179,286,1292,2140,4,9462,525,0,2,485,358,61200,24376,4798,32408,1
25,684,256,139,192,9,7,47,265,4,23,12,24,27,36,112,171,2,357,19,0,2,28,23,61200,24377,4798,32409,1
6,328,180,34,164,0,0,16,180,1,12,6,12,13,18,43,66,0,33,1,0,2,89,64,61200,24377,4798,32410,1
23,578,102,59,69,5,3,24,107,6,22,15,28,28,43,113,206,3,789,43,0,2,31,21,61200,24377,4798,32411,1
111,4174,1450,624,1228,12,26,181,1462,14,306,186,354,320,540,2580,4493,8,36391,2021,1,2,479,386,61200,24379,4799,32412,1
154,4337,1660,832,1314,41,38,274,1701,20,312,209,395,332,604,2671,5058,12,64042,3557,1,2,303,192,61200,24381,4800,32414,1
39,2966,996,429,845,24,10,117,1020,7,76,50,88,83,138,494,879,4,3565,198,0,2,418,318,61200,24383,4800,32415,1
125,5131,1513,682,1277,25,13,200,1538,11,199,116,219,210,335,1557,2584,6,15641,868,0,2,382,294,61200,24385,4800,32416,1
73,3805,1296,573,1062,40,33,157,1336,8,201,118,231,209,349,1561,2689,4,12365,686,0,2,268,193,61200,24385,4800,32417,1
14,341,207,111,150,11,0,50,218,5,26,19,36,31,55,133,272,3,943,52,0,2,21,16,61200,24385,4800,32418,1
84,4438,1457,730,1242,11,6,188,1468,10,292,166,329,302,495,2424,4078,5,22973,1276,1,2,425,271,61200,24387,4800,32419,1
39,2323,652,304,544,16,6,88,668,6,89,51,101,95,152,591,998,3,3399,188,0,2,177,112,61200,24388,4800,32420,1
70,3212,1455,414,1257,16,76,112,1471,5,41,23,46,46,69,231,381,2,1069,59,0,2,529,351,61200,24389,4800,32421,1
2,75,7,6,5,0,0,2,7,1,1,1,2,2,3,0,3,1,3,0,0,2,4,4,61200,24389,4800,32422,1
8,271,74,35,59,1,0,14,75,3,14,7,14,17,21,58,85,1,128,7,0,2,19,24,61200,24390,4800,32423,1
95,4640,1523,757,1297,19,12,193,1542,12,193,117,230,205,347,1508,2664,7,19053,1058,0,2,324,197,61210,24392,4800,32424,1
94,4062,1020,354,843,12,15,144,1032,8,134,77,144,142,221,970,1580,4,6792,377,0,2,478,214,61210,24392,4800,32425,1
38,1676,447,308,343,6,5,95,453,7,96,59,111,103,170,651,1136,4,4600,255,0,2,95,72,61210,24395,4800,32426,1
1,107,53,23,39,0,0,13,53,2,8,4,8,10,12,26,39,1,39,2,0,2,13,10,61210,24395,4800,32427,1
21,658,424,94,331,4,0,89,428,1,5,5,5,6,10,11,25,0,12,0,0,2,83,60,61210,24396,4800,32428,1
38,2302,334,251,279,10,4,40,344,5,127,74,143,132,217,899,1528,2,4303,239,0,2,114,97,61210,24397,4800,32429,1
12,493,184,100,137,2,15,30,186,6,38,20,39,44,59,214,322,3,991,55,0,2,46,34,61210,24398,4800,32430,1
59,2582,1293,570,1093,25,15,163,1318,10,195,123,241,205,364,1516,2795,6,17273,959,0,2,202,124,61220,24400,4800,32431,1
33,1883,384,251,317,7,8,52,391,11,70,44,84,81,128,467,811,6,5355,297,0,2,70,55,61220,24400,4800,32432,1
45,2209,722,423,573,19,0,135,741,12,172,101,199,184,300,1320,2257,6,15668,870,0,2,56,38,61220,24402,4800,32434,1
39,1727,386,256,301,16,9,68,402,4,59,35,69,63,104,355,621,2,1453,80,0,2,88,52,61220,24402,4800,32435,1
16,1214,215,129,180,6,0,29,221,8,65,43,72,73,115,415,711,4,3153,175,0,2,75,60,61220,24402,4800,32436,1
82,3159,1043,504,840,53,9,147,1096,9,180,112,198,189,310,1377,2344,4,11604,644,0,2,259,152,61220,24404,4800,32437,1
14,530,295,56,236,0,4,54,295,2,9,5,10,11,15,30,51,1,57,3,0,2,85,52,61220,24406,4800,32438,1
30,1241,373,158,315,8,0,51,381,5,76,44,79,81,123,486,779,2,2026,112,0,2,87,45,61220,24406,4800,32439,1
77,3213,1178,367,1042,6,15,115,1184,9,94,51,95,103,146,644,976,4,4439,246,0,2,459,375,61220,24406,4800,32440,1
91,4597,1943,715,1694,26,18,214,1969,12,185,120,237,197,357,1436,2721,7,20915,1161,0,2,578,519,61220,24408,4800,32441,1
14,826,442,244,305,14,16,103,456,11,68,45,75,79,120,452,756,6,4588,254,0,2,56,34,61220,24410,4800,32442,1
49,1838,1098,241,925,5,10,155,1103,7,46,25,49,53,74,273,423,3,1580,87,0,2,333,172,61230,24412,4800,32443,1
19,680,601,196,481,2,23,85,603,8,63,36,72,71,108,400,664,4,3036,168,0,2,138,107,61230,24412,4800,32444,1
247,5639,4293,999,3693,19,54,507,4312,9,155,88,170,164,258,1156,1898,4,9368,520,0,2,17,10,61230,24414,4800,32445,0
247,5639,1482,859,1002,125,135,219,1607,16,219,134,251,235,385,1766,3032,9,27804,1544,1,2,17,10,61240,24415,4800,32446,0
247,5639,4293,999,3693,19,54,507,4312,9,155,88,170,164,258,1156,1898,4,9368,520,0,2,44,14,61240,24417,4800,32447,0
247,5639,1482,859,1002,125,135,219,1607,16,219,134,251,235,385,1766,3032,9,27804,1544,1,2,44,14,61250,24418,4800,32448,0
140,3246,77,34,69,0,0,8,77,3,24,16,29,27,45,114,213,1,387,21,0,2,58,9,61250,24418,4800,32449,0
140,3246,712,438,573,51,9,84,763,14,102,71,128,116,199,733,1364,8,11988,666,0,2,58,9,61260,24419,4800,32450,0
74,1669,53,23,39,0,0,13,53,2,8,4,8,10,12,26,39,1,39,2,0,2,1,1,61260,24419,4800,32451,0
74,1669,515,298,307,33,80,99,548,12,63,44,77,75,121,419,753,7,5527,307,0,2,1,1,61270,24419,4800,32452,0
310,6786,72,33,56,0,4,12,72,1,1,1,1,2,2,0,2,0,1,0,0,2,76,1,61270,24419,4800,32453,0
310,6786,1454,835,1044,76,110,219,1530,17,275,158,296,292,454,2297,3718,9,34017,1889,1,2,76,1,61280,24420,4800,32454,0
98,4433,1338,495,1086,10,64,173,1348,11,122,82,157,133,239,883,1686,7,11934,663,0,2,1,1,61280,24422,4800,32455,0
174,7788,139,89,101,2,0,35,141,7,54,34,62,61,96,330,569,4,2287,127,0,2,112,5,61280,24422,4800,32456,0
174,7788,7,5,5,0,0,2,7,1,2,1,2,3,3,2,4,0,2,0,0,2,112,5,61280,24422,4800,32457,0
73,3805,1296,573,1062,40,33,157,1336,8,201,118,231,209,349,1561,2689,4,12365,686,0,2,2,2,61280,24422,4800,32458,0
34,995,339,213,244,17,9,65,356,10,42,26,48,52,74,259,421,5,2410,133,0,2,37,2,61290,24422,4800,32459,0
61,2731,1293,570,1093,25,15,163,1318,10,195,123,241,205,364,1516,2795,6,17273,959,0,2,37,0,61300,24424,4800,32460,0
226,5282,722,423,573,19,0,135,741,12,172,101,199,184,300,1320,2257,6,15668,870,0,2,1,8,61300,24426,4800,32462,1
226,5282,1508,847,911,44,250,301,1552,14,148,88,169,162,257,1120,1886,7,15077,837,0,2,1,8,61300,24427,4801,32463,1
46,2234,722,423,573,19,0,135,741,12,172,101,199,184,300,1320,2257,6,15668,870,0,2,5,0,61300,24429,4801,32465,1
226,5282,722,423,573,19,0,135,741,12,172,101,199,184,300,1320,2257,6,15668,870,0,2,1,8,61300,24431,4801,32467,0
226,5282,1508,847,911,44,250,301,1552,14,148,88,169,162,257,1120,1886,7,15077,837,0,2,1,8,61300,24432,4802,32468,0
46,2234,722,423,573,19,0,135,741,12,172,101,199,184,300,1320,2257,6,15668,870,0,2,5,0,61300,24434,4802,32470,0
84,1801,773,419,590,28,0,166,801,10,204,113,217,214,330,1598,2554,5,13587,754,0,2,3,10,61300,24434,4803,32471,0
84,1801,421,273,302,44,34,57,465,17,81,59,107,98,166,583,1098,11,12329,684,0,2,3,10,61300,24434,4804,32472,0
25,684,256,139,192,9,7,47,265,4,23,12,24,27,36,112,171,2,357,19,0,2,1,2,61300,24435,4804,32473,0
154,4337,1660,832,1314,41,38,274,1701,20,312,209,395,332,604,2671,5058,12,64042,3557,1,2,3,3,61300,24437,4805,32475,0
125,5127,1513,682,1277,25,13,200,1538,11,199,116,219,210,335,1557,2584,6,15641,868,0,2,0,1,61300,24439,4805,32476,0
84,1801,773,419,590,28,0,166,801,10,204,113,217,214,330,1598,2554,5,13587,754,0,2,3,10,61300,24439,4806,32477,0
84,1801,421,273,302,44,34,57,465,17,81,59,107,98,166,583,1098,11,12329,684,0,2,3,10,61300,24439,4807,32478,0
25,684,256,139,192,9,7,47,265,4,23,12,24,27,36,112,171,2,357,19,0,2,1,2,61300,24440,4807,32479,0
154,4337,1660,832,1314,41,38,274,1701,20,312,209,395,332,604,2671,5058,12,64042,3557,1,2,3,3,61300,24442,4808,32481,0
125,5127,1513,682,1277,25,13,200,1538,11,199,116,219,210,335,1557,2584,6,15641,868,0,2,0,1,61300,24444,4808,32482,0
92,2959,773,419,590,28,0,166,801,10,204,113,217,214,330,1598,2554,5,13587,754,0,2,16,0,61300,24444,4809,32483,0
58,1174,207,111,150,11,0,50,218,5,26,19,36,31,55,133,272,3,943,52,0,2,2,2,61300,24444,4809,32484,0
58,1174,410,198,237,31,55,97,441,11,63,38,72,74,110,414,683,6,4293,238,0,2,2,2,61310,24445,4810,32485,0
211,4551,2,2,2,0,0,0,2,0,0,0,0,0,0,0,0,0,0,0,0,2,1,1,61310,24445,4810,32485,0
211,4551,99,48,90,1,3,5,100,0,0,0,0,0,0,0,0,0,0,0,0,2,1,1,61310,24446,4810,32486,0
211,4551,8,5,5,2,0,1,10,0,0,0,0,0,0,0,0,0,0,0,0,2,1,1,61310,24446,4810,32487,0
211,4551,1217,716,841,84,126,174,1301,14,185,118,215,199,333,1446,2542,8,20687,1149,0,2,1,1,61320,24448,4810,32488,0
211,4551,160,89,115,0,13,31,160,7,15,11,17,22,28,78,124,3,495,27,0,2,1,1,61320,24448,4810,32489,0
211,4551,10,10,9,9,0,0,19,0,0,0,0,0,0,0,0,0,0,0,0,2,1,1,61320,24448,4811,32490,0
211,4551,173,84,99,8,29,36,181,5,12,7,13,17,20,54,81,2,221,12,0,2,1,1,61320,24449,4811,32491,0
211,4551,3,1,1,3,0,0,6,0,0,0,0,0,0,0,0,0,0,0,0,2,1,1,61320,24449,4811,32492,0
154,4337,1660,832,1314,41,38,274,1701,20,312,209,395,332,604,2671,5058,12,64042,3557,1,2,1,1,61320,24451,4812,32494,0
46,2233,722,423,573,19,0,135,741,12,172,101,199,184,300,1320,2257,6,15668,870,0,2,1,4,61320,24453,4812,32496,0
58,1174,207,111,150,11,0,50,218,5,26,19,36,31,55,133,272,3,943,52,0,2,2,2,61320,24453,4812,32497,0
58,1174,410,198,237,31,55,97,441,11,63,38,72,74,110,414,683,6,4293,238,0,2,2,2,61330,24454,4813,32498,0
211,4551,2,2,2,0,0,0,2,0,0,0,0,0,0,0,0,0,0,0,0,2,1,1,61330,24454,4813,32498,0
211,4551,99,48,90,1,3,5,100,0,0,0,0,0,0,0,0,0,0,0,0,2,1,1,61330,24455,4813,32499,0
211,4551,8,5,5,2,0,1,10,0,0,0,0,0,0,0,0,0,0,0,0,2,1,1,61330,24455,4813,32500,0
211,4551,1217,716,841,84,126,174,1301,14,185,118,215,199,333,1446,2542,8,20687,1149,0,2,1,1,61340,24457,4813,32501,0
211,4551,160,89,115,0,13,31,160,7,15,11,17,22,28,78,124,3,495,27,0,2,1,1,61340,24457,4813,32502,0
211,4551,10,10,9,9,0,0,19,0,0,0,0,0,0,0,0,0,0,0,0,2,1,1,61340,24457,4814,32503,0
211,4551,173,84,99,8,29,36,181,5,12,7,13,17,20,54,81,2,221,12,0,2,1,1,61340,24458,4814,32504,0
211,4551,3,1,1,3,0,0,6,0,0,0,0,0,0,0,0,0,0,0,0,2,1,1,61340,24458,4814,32505,0
154,4337,1660,832,1314,41,38,274,1701,20,312,209,395,332,604,2671,5058,12,64042,3557,1,2,1,1,61340,24460,4815,32507,0
46,2233,722,423,573,19,0,135,741,12,172,101,199,184,300,1320,2257,6,15668,870,0,2,1,4,61340,24462,4815,32509,0
92,2959,773,419,590,28,0,166,801,10,204,113,217,214,330,1598,2554,5,13587,754,0,2,16,0,61340,24462,4816,32510,0
84,1801,773,419,590,28,0,166,801,10,204,113,217,214,330,1598,2554,5,13587,754,0,2,3,10,61340,24462,4817,32511,0
84,1801,421,273,302,44,34,57,465,17,81,59,107,98,166,583,1098,11,12329,684,0,2,3,10,61340,24462,4818,32512,0
58,1174,207,111,150,11,0,50,218,5,26,19,36,31,55,133,272,3,943,52,0,2,2,2,61340,24462,4818,32513,0
58,1174,410,198,237,31,55,97,441,11,63,38,72,74,110,414,683,6,4293,238,0,2,2,2,61350,24463,4819,32514,0
211,4551,2,2,2,0,0,0,2,0,0,0,0,0,0,0,0,0,0,0,0,2,1,1,61350,24463,4819,32514,0
211,4551,99,48,90,1,3,5,100,0,0,0,0,0,0,0,0,0,0,0,0,2,1,1,61350,24464,4819,32515,0
211,4551,8,5,5,2,0,1,10,0,0,0,0,0,0,0,0,0,0,0,0,2,1,1,61350,24464,4819,32516,0
211,4551,1217,716,841,84,126,174,1301,14,185,118,215,199,333,1446,2542,8,20687,1149,0,2,1,1,61360,24466,4819,32517,0
211,4551,160,89,115,0,13,31,160,7,15,11,17,22,28,78,124,3,495,27,0,2,1,1,61360,24466,4819,32518,0
211,4551,10,10,9,9,0,0,19,0,0,0,0,0,0,0,0,0,0,0,0,2,1,1,61360,24466,4820,32519,0
211,4551,173,84,99,8,29,36,181,5,12,7,13,17,20,54,81,2,221,12,0,2,1,1,61360,24467,4820,32520,0
211,4551,3,1,1,3,0,0,6,0,0,0,0,0,0,0,0,0,0,0,0,2,1,1,61360,24467,4820,32521,0
84,1794,402,202,227,24,74,80,426,12,52,33,61,64,94,339,564,7,3969,220,0,2,1,1,61360,24468,4820,32522,0
226,5282,722,423,573,19,0,135,741,12,172,101,199,184,300,1320,2257,6,15668,870,0,2,1,8,61360,24470,4820,32524,0
226,5282,1508,847,911,44,250,301,1552,14,148,88,169,162,257,1120,1886,7,15077,837,0,2,1,8,61360,24471,4821,32525,0
92,2959,773,419,590,28,0,166,801,10,204,113,217,214,330,1598,2554,5,13587,754,0,2,16,0,61360,24471,4822,32526,0
25,684,256,139,192,9,7,47,265,4,23,12,24,27,36,112,171,2,357,19,0,2,1,2,61360,24472,4822,32527,0
154,4337,1660,832,1314,41,38,274,1701,20,312,209,395,332,604,2671,5058,12,64042,3557,1,2,4,4,61360,24474,4823,32529,0
125,5127,1513,682,1277,25,13,200,1538,11,199,116,219,210,335,1557,2584,6,15641,868,0,2,0,1,61360,24476,4823,32530,0
46,2233,722,423,573,19,0,135,741,12,172,101,199,184,300,1320,2257,6,15668,870,0,2,6,4,61360,24478,4823,32532,0
288,6363,72,33,56,0,4,12,72,1,1,1,1,2,2,0,2,0,1,0,0,2,90,46,61360,24478,4823,32533,0
288,6363,1454,835,1044,76,110,219,1530,17,275,158,296,292,454,2297,3718,9,34017,1889,1,2,90,46,61370,24479,4823,32534,0
86,1828,402,202,227,24,74,80,426,12,52,33,61,64,94,339,564,7,3969,220,0,2,13,1,61370,24480,4823,32535,0
287,6329,72,33,56,0,4,12,72,1,1,1,1,2,2,0,2,0,1,0,0,2,4,13,61370,24480,4823,32536,0
287,6329,1454,835,1044,76,110,219,1530,17,275,158,296,292,454,2297,3718,9,34017,1889,1,2,4,13,61380,24481,4823,32537,0
236,5588,722,423,573,19,0,135,741,12,172,101,199,184,300,1320,2257,6,15668,870,0,2,37,9,61380,24483,4823,32539,0
236,5588,1508,847,911,44,250,301,1552,14,148,88,169,162,257,1120,1886,7,15077,837,0,2,37,9,61380,24484,4824,32540,0
1,26,127,75,83,2,11,30,129,4,14,7,14,18,21,61,87,2,175,9,0,0,7,0,61390,24488,4825,32548,0
1,26,652,304,544,16,6,88,668,6,89,51,101,95,152,591,998,3,3399,188,0,0,7,0,61390,24489,4825,32549,0
1,26,2,2,2,0,0,0,2,0,0,0,0,0,0,0,0,0,0,0,0,0,7,0,61390,24489,4825,32549,0
1,26,8,5,5,0,0,3,8,0,0,0,0,0,0,0,0,0,0,0,0,0,7,0,61390,24489,4825,32550,0
1,26,2,2,2,0,0,0,2,0,0,0,0,0,0,0,0,0,0,0,0,0,7,0,61390,24489,4825,32550,0
1,26,14,8,8,0,0,6,14,0,0,0,0,0,0,0,0,0,0,0,0,0,7,0,61390,24489,4825,32551,0
1,26,6,4,4,0,0,2,6,0,0,0,0,0,0,0,0,0,0,0,0,0,7,0,61390,24489,4825,32552,0
1,26,6,4,4,0,0,2,6,1,2,1,2,3,3,2,4,0,2,0,0,0,7,0,61390,24489,4825,32553,0
1,26,6,4,4,0,0,2,6,0,0,0,0,0,0,0,0,0,0,0,0,0,7,0,61390,24489,4825,32554,0
1,26,7,5,5,0,0,2,7,0,0,0,0,0,0,0,0,0,0,0,0,0,7,0,61390,24489,4825,32555,0
1,26,6,4,4,0,0,2,6,0,0,0,0,0,0,0,0,0,0,0,0,0,7,0,61390,24489,4825,32556,0
1,26,10,6,6,0,0,4,10,0,0,0,0,0,0,0,0,0,0,0,0,0,7,0,61390,24489,4825,32557,0
1,26,1,1,1,0,0,0,1,0,0,0,0,0,0,0,0,0,0,0,0,0,7,0,61390,24489,4825,32557,0
1,26,14,10,10,0,0,4,14,1,1,1,1,2,2,0,2,0,1,0,0,0,7,0,61390,24489,4825,32558,0
1,26,46,26,30,3,0,12,49,3,6,3,6,9,9,20,28,1,42,2,0,0,7,0,61400,24489,4825,32559,0
1,7,2,2,2,0,0,0,2,0,0,0,0,0,0,0,0,0,0,0,0,0,2,0,61400,24489,4825,32559,0
1,20,127,75,83,2,11,30,129,4,14,7,14,18,21,61,87,2,175,9,0,0,7,0,61410,24493,4826,32567,0
1,20,652,304,544,16,6,88,668,6,89,51,101,95,152,591,998,3,3399,188,0,0,7,0,61410,24494,4826,32568,0
1,20,2,2,2,0,0,0,2,0,0,0,0,0,0,0,0,0,0,0,0,0,7,0,61410,24494,4826,32568,0
1,20,8,5,5,0,0,3,8,0,0,0,0,0,0,0,0,0,0,0,0,0,7,0,61410,24494,4826,32569,0
1,20,2,2,2,0,0,0,2,0,0,0,0,0,0,0,0,0,0,0,0,0,7,0,61410,24494,4826,32569,0
1,20,14,8,8,0,0,6,14,0,0,0,0,0,0,0,0,0,0,0,0,0,7,0,61410,24494,4826,32570,0
1,20,6,4,4,0,0,2,6,0,0,0,0,0,0,0,0,0,0,0,0,0,7,0,61410,24494,4826,32571,0
1,20,6,4,4,0,0,2,6,1,2,1,2,3,3,2,4,0,2,0,0,0,7,0,61410,24494,4826,32572,0
1,20,6,4,4,0,0,2,6,0,0,0,0,0,0,0,0,0,0,0,0,0,7,0,61410,24494,4826,32573,0
1,20,7,5,5,0,0,2,7,0,0,0,0,0,0,0,0,0,0,0,0,0,7,0,61410,24494,4826,32574,0
1,20,6,4,4,0,0,2,6,0,0,0,0,0,0,0,0,0,0,0,0,0,7,0,61410,24494,4826,32575,0
1,20,10,6,6,0,0,4,10,0,0,0,0,0,0,0,0,0,0,0,0,0,7,0,61410,24494,4826,32576,0
1,20,1,1,1,0,0,0,1,0,0,0,0,0,0,0,0,0,0,0,0,0,7,0,61410,24494,4826,32576,0
1,20,14,10,10,0,0,4,14,1,1,1,1,2,2,0,2,0,1,0,0,0,7,0,61410,24494,4826,32577,0
1,20,46,26,30,3,0,12,49,3,6,3,6,9,9,20,28,1,42,2,0,0,7,0,61420,24494,4826,32578,0
1,7,2,2,2,0,0,0,2,0,0,0,0,0,0,0,0,0,0,0,0,0,2,0,61420,24494,4826,32578,0
1,13,127,75,83,2,11,30,129,4,14,7,14,18,21,61,87,2,175,9,0,0,6,0,61420,24494,4826,32579,0
1,13,652,304,544,16,6,88,668,6,89,51,101,95,152,591,998,3,3399,188,0,0,6,0,61420,24495,4826,32580,0
1,13,2,2,2,0,0,0,2,0,0,0,0,0,0,0,0,0,0,0,0,0,6,0,61420,24495,4826,32580,0
1,13,8,5,5,0,0,3,8,0,0,0,0,0,0,0,0,0,0,0,0,0,6,0,61420,24495,4826,32581,0
1,13,2,2,2,0,0,0,2,0,0,0,0,0,0,0,0,0,0,0,0,0,6,0,61420,24495,4826,32581,0
1,13,14,8,8,0,0,6,14,0,0,0,0,0,0,0,0,0,0,0,0,0,6,0,61420,24495,4826,32582,0
1,13,6,4,4,0,0,2,6,0,0,0,0,0,0,0,0,0,0,0,0,0,6,0,61420,24495,4826,32583,0
1,13,6,4,4,0,0,2,6,1,2,1,2,3,3,2,4,0,2,0,0,0,6,0,61420,24495,4826,32584,0
1,13,6,4,4,0,0,2,6,0,0,0,0,0,0,0,0,0,0,0,0,0,6,0,61420,24495,4826,32585,0
1,13,7,5,5,0,0,2,7,0,0,0,0,0,0,0,0,0,0,0,0,0,6,0,61420,24495,4826,32586,0
1,13,6,4,4,0,0,2,6,0,0,0,0,0,0,0,0,0,0,0,0,0,6,0,61420,24495,4826,32587,0
1,13,10,6,6,0,0,4,10,0,0,0,0,0,0,0,0,0,0,0,0,0,6,0,61420,24495,4826,32588,0
1,13,1,1,1,0,0,0,1,0,0,0,0,0,0,0,0,0,0,0,0,0,6,0,61420,24495,4826,32588,0
1,13,14,10,10,0,0,4,14,1,1,1,1,2,2,0,2,0,1,0,0,0,6,0,61420,24495,4826,32589,0
1,13,46,26,30,3,0,12,49,3,6,3,6,9,9,20,28,1,42,2,0,0,6,0,61430,24495,4826,32590,0
1,16,127,75,83,2,11,30,129,4,14,7,14,18,21,61,87,2,175,9,0,0,6,0,61440,24499,4827,32598,0
1,16,652,304,544,16,6,88,668,6,89,51,101,95,152,591,998,3,3399,188,0,0,6,0,61440,24500,4827,32599,0
1,16,2,2,2,0,0,0,2,0,0,0,0,0,0,0,0,0,0,0,0,0,6,0,61440,24500,4827,32599,0
1,16,8,5,5,0,0,3,8,0,0,0,0,0,0,0,0,0,0,0,0,0,6,0,61440,24500,4827,32600,0
1,16,2,2,2,0,0,0,2,0,0,0,0,0,0,0,0,0,0,0,0,0,6,0,61440,24500,4827,32600,0
1,16,14,8,8,0,0,6,14,0,0,0,0,0,0,0,0,0,0,0,0,0,6,0,61440,24500,4827,32601,0
1,16,6,4,4,0,0,2,6,0,0,0,0,0,0,0,0,0,0,0,0,0,6,0,61440,24500,4827,32602,0
1,16,6,4,4,0,0,2,6,1,2,1,2,3,3,2,4,0,2,0,0,0,6,0,61440,24500,4827,32603,0
1,16,6,4,4,0,0,2,6,0,0,0,0,0,0,0,0,0,0,0,0,0,6,0,61440,24500,4827,32604,0
1,16,7,5,5,0,0,2,7,0,0,0,0,0,0,0,0,0,0,0,0,0,6,0,61440,24500,4827,32605,0
1,16,6,4,4,0,0,2,6,0,0,0,0,0,0,0,0,0,0,0,0,0,6,0,61440,24500,4827,32606,0
1,16,10,6,6,0,0,4,10,0,0,0,0,0,0,0,0,0,0,0,0,0,6,0,61440,24500,4827,32607,0
1,16,1,1,1,0,0,0,1,0,0,0,0,0,0,0,0,0,0,0,0,0,6,0,61440,24500,4827,32607,0
1,16,14,10,10,0,0,4,14,1,1,1,1,2,2,0,2,0,1,0,0,0,6,0,61440,24500,4827,32608,0
1,16,46,26,30,3,0,12,49,3,6,3,6,9,9,20,28,1,42,2,0,0,6,0,61450,24500,4827,32609,0
1,10,2,2,2,0,0,0,2,1,2,1,2,3,3,2,4,0,2,0,0,0,2,0,61450,24500,4827,32609,0
1,13,127,75,83,2,11,30,129,4,14,7,14,18,21,61,87,2,175,9,0,0,6,0,61450,24500,4827,32610,0
1,13,652,304,544,16,6,88,668,6,89,51,101,95,152,591,998,3,3399,188,0,0,6,0,61450,24501,4827,32611,0
1,13,2,2,2,0,0,0,2,0,0,0,0,0,0,0,0,0,0,0,0,0,6,0,61450,24501,4827,32611,0
1,13,8,5,5,0,0,3,8,0,0,0,0,0,0,0,0,0,0,0,0,0,6,0,61450,24501,4827,32612,0
1,13,2,2,2,0,0,0,2,0,0,0,0,0,0,0,0,0,0,0,0,0,6,0,61450,24501,4827,32612,0
1,13,14,8,8,0,0,6,14,0,0,0,0,0,0,0,0,0,0,0,0,0,6,0,61450,24501,4827,32613,0
1,13,6,4,4,0,0,2,6,0,0,0,0,0,0,0,0,0,0,0,0,0,6,0,61450,24501,4827,32614,0
1,13,6,4,4,0,0,2,6,1,2,1,2,3,3,2,4,0,2,0,0,0,6,0,61450,24501,4827,32615,0
1,13,6,4,4,0,0,2,6,0,0,0,0,0,0,0,0,0,0,0,0,0,6,0,61450,24501,4827,32616,0
1,13,7,5,5,0,0,2,7,0,0,0,0,0,0,0,0,0,0,0,0,0,6,0,61450,24501,4827,32617,0
1,13,6,4,4,0,0,2,6,0,0,0,0,0,0,0,0,0,0,0,0,0,6,0,61450,24501,4827,32618,0
1,13,10,6,6,0,0,4,10,0,0,0,0,0,0,0,0,0,0,0,0,0,6,0,61450,24501,4827,32619,0
1,13,1,1,1,0,0,0,1,0,0,0,0,0,0,0,0,0,0,0,0,0,6,0,61450,24501,4827,32619,0
1,13,14,10,10,0,0,4,14,1,1,1,1,2,2,0,2,0,1,0,0,0,6,0,61450,24501,4827,32620,0
1,13,46,26,30,3,0,12,49,3,6,3,6,9,9,20,28,1,42,2,0,0,6,0,61460,24501,4827,32621,0
2,26,10,6,6,0,0,4,10,2,4,2,4,6,6,10,15,1,15,0,0,0,10,0,61460,24501,4827,32622,0
3,47,15,10,10,0,0,5,15,2,4,2,4,6,6,10,15,1,15,0,0,0,15,0,61460,24501,4827,32623,0
3,39,15,9,9,0,0,6,15,0,0,0,0,0,0,0,0,0,0,0,0,0,16,0,61460,24501,4827,32624,0
2,36,10,7,7,0,0,3,10,1,2,1,2,3,3,2,4,0,2,0,0,0,11,0,61460,24501,4827,32625,0
3,46,15,9,9,0,0,6,15,1,4,2,4,5,6,8,13,0,6,0,0,0,15,0,61460,24501,4827,32626,0
2,21,10,6,6,0,0,4,10,0,0,0,0,0,0,0,0,0,0,0,0,0,10,0,61460,24501,4827,32627,0
175,7644,139,89,101,2,0,35,141,7,54,34,62,61,96,330,569,4,2287,127,0,2,94,220,61460,24501,4827,32628,0
175,7644,7,5,5,0,0,2,7,1,2,1,2,3,3,2,4,0,2,0,0,2,94,220,61460,24501,4827,32629,0
86,1828,402,202,227,24,74,80,426,12,52,33,61,64,94,339,564,7,3969,220,0,2,13,1,61460,24502,4827,32630,0
287,6329,72,33,56,0,4,12,72,1,1,1,1,2,2,0,2,0,1,0,0,2,86,51,61460,24502,4827,32631,0
287,6329,1454,835,1044,76,110,219,1530,17,275,158,296,292,454,2297,3718,9,34017,1889,1,2,86,51,61470,24503,4827,32632,0
12,509,124,78,88,2,3,26,126,4,13,7,13,17,20,56,81,2,163,9,0,3,38,45,61470,24503,4827,32633,1
86,1822,402,202,227,24,74,80,426,12,52,33,61,64,94,339,564,7,3969,220,0,2,2,2,61480,24508,4828,32641,1
214,4654,182,127,129,0,0,53,182,5,39,21,42,44,63,217,343,2,926,51,0,2,8,1,61480,24508,4829,32642,1
214,4654,1165,710,800,67,119,181,1232,18,243,153,282,261,435,2000,3492,10,36473,2026,1,2,8,1,61490,24508,4830,32643,1
75,1692,53,23,39,0,0,13,53,2,8,4,8,10,12,26,39,1,39,2,0,2,6,0,61490,24508,4830,32644,1
75,1692,515,298,307,33,80,99,548,12,63,44,77,75,121,419,753,7,5527,307,0,2,6,0,61500,24508,4830,32645,1
149,6994,1392,870,1177,35,17,170,1427,14,494,280,531,508,811,4473,7289,7,54850,3047,2,2,12,0,61500,24511,4831,32646,1
12,509,124,78,88,2,3,26,126,4,13,7,13,17,20,56,81,2,163,9,0,3,38,45,61500,24511,4831,32647,0
86,1822,402,202,227,24,74,80,426,12,52,33,61,64,94,339,564,7,3969,220,0,2,2,2,61510,24516,4832,32655,0
12,509,124,78,88,2,3,26,126,4,13,7,13,17,20,56,81,2,163,9,0,3,38,45,61510,24516,4832,32656,0
84,1801,773,419,590,28,0,166,801,10,204,113,217,214,330,1598,2554,5,13587,754,0,2,3,10,61510,24516,4833,32657,0
84,1801,421,273,302,44,34,57,465,17,81,59,107,98,166,583,1098,11,12329,684,0,2,3,10,61510,24516,4834,32658,0
58,1192,207,111,150,11,0,50,218,5,26,19,36,31,55,133,272,3,943,52,0,2,2,2,61510,24516,4834,32659,0
58,1192,410,198,237,31,55,97,441,11,63,38,72,74,110,414,683,6,4293,238,0,2,2,2,61520,24517,4835,32660,0
211,4551,2,2,2,0,0,0,2,0,0,0,0,0,0,0,0,0,0,0,0,2,1,1,61520,24517,4835,32660,0
211,4551,99,48,90,1,3,5,100,0,0,0,0,0,0,0,0,0,0,0,0,2,1,1,61520,24518,4835,32661,0
211,4551,8,5,5,2,0,1,10,0,0,0,0,0,0,0,0,0,0,0,0,2,1,1,61520,24518,4835,32662,0
211,4551,1217,716,841,84,126,174,1301,14,185,118,215,199,333,1446,2542,8,20687,1149,0,2,1,1,61530,24520,4835,32663,0
211,4551,160,89,115,0,13,31,160,7,15,11,17,22,28,78,124,3,495,27,0,2,1,1,61530,24520,4835,32664,0
211,4551,10,10,9,9,0,0,19,0,0,0,0,0,0,0,0,0,0,0,0,2,1,1,61530,24520,4836,32665,0
211,4551,173,84,99,8,29,36,181,5,12,7,13,17,20,54,81,2,221,12,0,2,1,1,61530,24521,4836,32666,0
211,4551,3,1,1,3,0,0,6,0,0,0,0,0,0,0,0,0,0,0,0,2,1,1,61530,24521,4836,32667,0
86,1822,402,202,227,24,74,80,426,12,52,33,61,64,94,339,564,7,3969,220,0,2,15,3,61530,24522,4836,32668,0
236,5564,722,423,573,19,0,135,741,12,172,101,199,184,300,1320,2257,6,15668,870,0,2,1,8,61530,24524,4836,32670,0
236,5564,1508,847,911,44,250,301,1552,14,148,88,169,162,257,1120,1886,7,15077,837,0,2,1,8,61530,24525,4837,32671,0
312,6821,72,33,56,0,4,12,72,1,1,1,1,2,2,0,2,0,1,0,0,2,86,51,61530,24525,4837,32672,0
312,6821,1454,835,1044,76,110,219,1530,17,275,158,296,292,454,2297,3718,9,34017,1889,1,2,86,51,61540,24526,4837,32673,0
92,2959,773,419,590,28,0,166,801,10,204,113,217,214,330,1598,2554,5,13587,754,0,2,16,0,61550,24530,4839,32681,0
25,684,256,139,192,9,7,47,265,4,23,12,24,27,36,112,171,2,357,19,0,2,1,2,61550,24531,4839,32682,0
154,4337,1660,832,1314,41,38,274,1701,20,312,209,395,332,604,2671,5058,12,64042,3557,1,2,4,4,61550,24533,4840,32684,0
125,5127,1513,682,1277,25,13,200,1538,11,199,116,219,210,335,1557,2584,6,15641,868,0,2,0,1,61550,24535,4840,32685,0
46,2233,722,423,573,19,0,135,741,12,172,101,199,184,300,1320,2257,6,15668,870,0,2,6,4,61550,24537,4840,32687,0
214,4654,182,127,129,0,0,53,182,5,39,21,42,44,63,217,343,2,926,51,0,2,8,1,61550,24537,4841,32688,0
214,4654,1165,710,800,67,119,181,1232,18,243,153,282,261,435,2000,3492,10,36473,2026,1,2,8,1,61560,24537,4842,32689,0
75,1692,53,23,39,0,0,13,53,2,8,4,8,10,12,26,39,1,39,2,0,2,6,0,61560,24537,4842,32690,0
75,1692,515,298,307,33,80,99,548,12,63,44,77,75,121,419,753,7,5527,307,0,2,6,0,61570,24537,4842,32691,0
149,6994,1392,870,1177,35,17,170,1427,14,494,280,531,508,811,4473,7289,7,54850,3047,2,2,12,0,61570,24540,4843,32692,0
12,509,124,78,88,2,3,26,126,4,13,7,13,17,20,56,81,2,163,9,0,3,38,45,61570,24540,4843,32693,0
84,1801,773,419,590,28,0,166,801,10,204,113,217,214,330,1598,2554,5,13587,754,0,2,3,10,61570,24540,4844,32694,0
84,1801,421,273,302,44,34,57,465,17,81,59,107,98,166,583,1098,11,12329,684,0,2,3,10,61570,24540,4845,32695,0
58,1192,207,111,150,11,0,50,218,5,26,19,36,31,55,133,272,3,943,52,0,2,2,2,61570,24540,4845,32696,0
58,1192,410,198,237,31,55,97,441,11,63,38,72,74,110,414,683,6,4293,238,0,2,2,2,61580,24541,4846,32697,0
211,4551,2,2,2,0,0,0,2,0,0,0,0,0,0,0,0,0,0,0,0,2,1,1,61580,24541,4846,32697,0
211,4551,99,48,90,1,3,5,100,0,0,0,0,0,0,0,0,0,0,0,0,2,1,1,61580,24542,4846,32698,0
211,4551,8,5,5,2,0,1,10,0,0,0,0,0,0,0,0,0,0,0,0,2,1,1,61580,24542,4846,32699,0
211,4551,1217,716,841,84,126,174,1301,14,185,118,215,199,333,1446,2542,8,20687,1149,0,2,1,1,61590,24544,4846,32700,0
211,4551,160,89,115,0,13,31,160,7,15,11,17,22,28,78,124,3,495,27,0,2,1,1,61590,24544,4846,32701,0
211,4551,10,10,9,9,0,0,19,0,0,0,0,0,0,0,0,0,0,0,0,2,1,1,61590,24544,4847,32702,0
211,4551,173,84,99,8,29,36,181,5,12,7,13,17,20,54,81,2,221,12,0,2,1,1,61590,24545,4847,32703,0
211,4551,3,1,1,3,0,0,6,0,0,0,0,0,0,0,0,0,0,0,0,2,1,1,61590,24545,4847,32704,0
86,1822,402,202,227,24,74,80,426,12,52,33,61,64,94,339,564,7,3969,220,0,2,15,3,61590,24546,4847,32705,0
236,5564,722,423,573,19,0,135,741,12,172,101,199,184,300,1320,2257,6,15668,870,0,2,1,8,61590,24548,4847,32707,0
236,5564,1508,847,911,44,250,301,1552,14,148,88,169,162,257,1120,1886,7,15077,837,0,2,1,8,61590,24549,4848,32708,0
312,6821,72,33,56,0,4,12,72,1,1,1,1,2,2,0,2,0,1,0,0,2,86,51,61590,24549,4848,32709,0
312,6821,1454,835,1044,76,110,219,1530,17,275,158,296,292,454,2297,3718,9,34017,1889,1,2,86,51,61600,24550,4848,32710,0
92,2959,773,419,590,28,0,166,801,10,204,113,217,214,330,1598,2554,5,13587,754,0,2,16,0,61610,24554,4850,32718,0
25,684,256,139,192,9,7,47,265,4,23,12,24,27,36,112,171,2,357,19,0,2,1,2,61610,24555,4850,32719,0
154,4337,1660,832,1314,41,38,274,1701,20,312,209,395,332,604,2671,5058,12,64042,3557,1,2,4,4,61610,24557,4851,32721,0
125,5127,1513,682,1277,25,13,200,1538,11,199,116,219,210,335,1557,2584,6,15641,868,0,2,0,1,61610,24559,4851,32722,0
46,2233,722,423,573,19,0,135,741,12,172,101,199,184,300,1320,2257,6,15668,870,0,2,6,4,61610,24561,4851,32724,0
78,1609,757,253,292,73,244,162,830,13,61,38,67,74,105,409,651,7,4654,258,0,2,4,1,61610,24562,4851,32725,0
247,5655,4293,999,3693,19,54,507,4312,9,155,88,170,164,258,1156,1898,4,9368,520,0,2,15,12,61610,24564,4851,32726,1
247,5655,1482,859,1002,125,135,219,1607,16,219,134,251,235,385,1766,3032,9,27804,1544,1,2,15,12,61620,24565,4851,32727,1
248,5674,4293,999,3693,19,54,507,4312,9,155,88,170,164,258,1156,1898,4,9368,520,0,2,17,9,61620,24567,4851,32728,0
248,5674,1482,859,1002,125,135,219,1607,16,219,134,251,235,385,1766,3032,9,27804,1544,1,2,17,9,61630,24568,4851,32729,0
245,5645,4293,999,3693,19,54,507,4312,9,155,88,170,164,258,1156,1898,4,9368,520,0,2,1,7,61630,24570,4851,32730,0
245,5645,1482,859,1002,125,135,219,1607,16,219,134,251,235,385,1766,3032,9,27804,1544,1,2,1,7,61640,24571,4851,32731,0
245,5645,4293,999,3693,19,54,507,4312,9,155,88,170,164,258,1156,1898,4,9368,520,0,2,33,28,61640,24573,4851,32732,0
245,5645,1482,859,1002,125,135,219,1607,16,219,134,251,235,385,1766,3032,9,27804,1544,1,2,33,28,61650,24574,4851,32733,0
1,319,382,65,130,157,2,92,539,4,10,5,10,14,15,41,57,2,114,6,0,2,1,1,61650,24575,4852,32734,0
1,319,382,65,130,157,2,92,539,4,10,5,10,14,15,41,57,2,114,6,0,2,1,1,61650,24576,4853,32735,0
57,3792,520,294,400,33,13,81,553,10,261,204,367,271,571,2128,4614,7,32445,1802,1,2,14,0,61650,24577,4853,32736,0
78,1602,757,253,292,73,244,162,830,13,61,38,67,74,105,409,651,7,4654,258,0,2,3,4,61650,24578,4853,32737,0
57,3898,520,294,400,33,13,81,553,10,261,204,367,271,571,2128,4614,7,32445,1802,1,2,8,1,61650,24579,4853,32738,0
58,1198,207,111,150,11,0,50,218,5,26,19,36,31,55,133,272,3,943,52,0,2,1,0,61650,24579,4853,32739,1
58,1198,410,198,237,31,55,97,441,11,63,38,72,74,110,414,683,6,4293,238,0,2,1,0,61660,24580,4854,32740,1
255,5847,4293,999,3693,19,54,507,4312,9,155,88,170,164,258,1156,1898,4,9368,520,0,2,51,1,61660,24582,4854,32742,1
255,5847,1482,859,1002,125,135,219,1607,16,219,134,251,235,385,1766,3032,9,27804,1544,1,2,51,1,61670,24583,4854,32743,1
237,5596,722,423,573,19,0,135,741,12,172,101,199,184,300,1320,2257,6,15668,870,0,2,5,0,61670,24585,4854,32745,1
237,5596,1508,847,911,44,250,301,1552,14,148,88,169,162,257,1120,1886,7,15077,837,0,2,5,0,61670,24586,4855,32746,1
17,774,75,38,59,1,3,12,76,2,4,2,4,6,6,10,15,1,15,0,0,2,14,0,61670,24586,4855,32747,1
1,41,7,5,5,0,0,2,7,1,2,1,2,3,3,2,4,0,2,0,0,0,7,0,61670,24586,4855,32748,1
175,7644,139,89,101,2,0,35,141,7,54,34,62,61,96,330,569,4,2287,127,0,2,6,3,61670,24586,4855,32749,1
175,7644,7,5,5,0,0,2,7,1,2,1,2,3,3,2,4,0,2,0,0,2,6,3,61670,24586,4855,32750,1
111,4178,1450,624,1228,12,26,181,1462,14,306,186,354,320,540,2580,4493,8,36391,2021,1,2,6,7,61670,24588,4856,32751,1
39,2321,652,304,544,16,6,88,668,6,89,51,101,95,152,591,998,3,3399,188,0,2,1,3,61670,24589,4856,32752,1
14,717,442,244,305,14,16,103,456,11,68,45,75,79,120,452,756,6,4588,254,0,2,3,28,61670,24591,4856,32753,1
139,5919,1782,648,1425,9,47,279,1791,8,171,97,189,179,286,1292,2140,4,9462,525,0,2,3,0,61670,24592,4857,32754,1
236,5564,722,423,573,19,0,135,741,12,172,101,199,184,300,1320,2257,6,15668,870,0,2,0,5,61670,24594,4857,32756,0
236,5564,1508,847,911,44,250,301,1552,14,148,88,169,162,257,1120,1886,7,15077,837,0,2,0,5,61670,24595,4858,32757,0
14,725,442,244,305,14,16,103,456,11,68,45,75,79,120,452,756,6,4588,254,0,2,2,1,61670,24597,4858,32758,0
79,1591,757,253,292,73,244,162,830,13,61,38,67,74,105,409,651,7,4654,258,0,2,1,3,61670,24598,4858,32759,0
58,1198,207,111,150,11,0,50,218,5,26,19,36,31,55,133,272,3,943,52,0,2,1,0,61670,24598,4858,32760,0
58,1198,410,198,237,31,55,97,441,11,63,38,72,74,110,414,683,6,4293,238,0,2,1,0,61680,24599,4859,32761,0
255,5847,4293,999,3693,19,54,507,4312,9,155,88,170,164,258,1156,1898,4,9368,520,0,2,51,1,61680,24601,4859,32763,0
255,5847,1482,859,1002,125,135,219,1607,16,219,134,251,235,385,1766,3032,9,27804,1544,1,2,51,1,61690,24602,4859,32764,0
17,774,75,38,59,1,3,12,76,2,4,2,4,6,6,10,15,1,15,0,0,2,14,0,61690,24602,4859,32765,0
1,41,7,5,5,0,0,2,7,1,2,1,2,3,3,2,4,0,2,0,0,0,7,0,61690,24602,4859,32766,0
175,7644,139,89,101,2,0,35,141,7,54,34,62,61,96,330,569,4,2287,127,0,2,6,3,61690,24602,4859,32767,0
175,7644,7,5,5,0,0,2,7,1,2,1,2,3,3,2,4,0,2,0,0,2,6,3,61690,24602,4859,32768,0
139,5919,1782,648,1425,9,47,279,1791,8,171,97,189,179,286,1292,2140,4,9462,525,0,2,3,0,61690,24603,4860,32769,0
111,4178,1450,624,1228,12,26,181,1462,14,306,186,354,320,540,2580,4493,8,36391,2021,1,2,6,7,61690,24605,4861,32770,0
39,2321,652,304,544,16,6,88,668,6,89,51,101,95,152,591,998,3,3399,188,0,2,1,3,61690,24606,4861,32771,0
14,725,442,244,305,14,16,103,456,11,68,45,75,79,120,452,756,6,4588,254,0,2,4,28,61690,24608,4861,32772,0
79,1593,757,253,292,73,244,162,830,13,61,38,67,74,105,409,651,7,4654,258,0,2,1,1,61690,24609,4861,32773,0
10,382,42,7,35,4,0,5,46,1,2,1,2,3,3,2,4,0,2,0,0,2,1,1,61690,24609,4861,32774,0
10,382,11,6,10,0,0,1,11,2,4,2,4,6,6,10,15,1,15,0,0,2,1,1,61690,24609,4861,32775,0
10,382,42,7,35,4,0,5,46,1,2,1,2,3,3,2,4,0,2,0,0,2,1,1,61690,24609,4861,32776,0
10,382,11,6,10,0,0,1,11,2,4,2,4,6,6,10,15,1,15,0,0,2,1,1,61690,24609,4861,32777,0
1,319,382,65,130,157,2,92,539,4,10,5,10,14,15,41,57,2,114,6,0,2,1,1,61690,24610,4862,32778,0
11,413,42,7,35,4,0,5,46,1,2,1,2,3,3,2,4,0,2,0,0,2,1,1,61690,24610,4862,32779,0
11,413,11,6,10,0,0,1,11,2,4,2,4,6,6,10,15,1,15,0,0,2,1,1,61690,24610,4862,32780,0
11,413,42,7,35,4,0,5,46,1,2,1,2,3,3,2,4,0,2,0,0,2,1,1,61690,24610,4862,32781,0
11,413,11,6,10,0,0,1,11,2,4,2,4,6,6,10,15,1,15,0,0,2,1,1,61690,24610,4862,32782,0
51,608,647,139,84,35,284,233,682,0,0,0,0,0,0,0,0,0,0,0,0,2,13,2,61690,24610,4862,32783,0
60,4055,520,294,400,33,13,81,553,10,261,204,367,271,571,2128,4614,7,32445,1802,1,2,42,15,61690,24611,4862,32784,0
62,4177,520,294,400,33,13,81,553,10,261,204,367,271,571,2128,4614,7,32445,1802,1,2,14,0,61690,24612,4862,32785,0
1,319,382,65,130,157,2,92,539,4,10,5,10,14,15,41,57,2,114,6,0,2,1,1,61690,24613,4863,32786,0
11,413,42,7,35,4,0,5,46,1,2,1,2,3,3,2,4,0,2,0,0,2,1,1,61690,24613,4863,32787,0
11,413,11,6,10,0,0,1,11,2,4,2,4,6,6,10,15,1,15,0,0,2,1,1,61690,24613,4863,32788,0
51,608,647,139,84,35,284,233,682,0,0,0,0,0,0,0,0,0,0,0,0,2,9,2,61690,24613,4863,32789,1
33,1892,384,251,317,7,8,52,391,11,70,44,84,81,128,467,811,6,5355,297,0,2,1,0,61690,24613,4863,32790,1
51,604,647,139,84,35,284,233,682,0,0,0,0,0,0,0,0,0,0,0,0,2,3,7,61690,24613,4863,32792,0
11,413,42,7,35,4,0,5,46,1,2,1,2,3,3,2,4,0,2,0,0,2,1,1,61690,24613,4863,32793,0
11,413,11,6,10,0,0,1,11,2,4,2,4,6,6,10,15,1,15,0,0,2,1,1,61690,24613,4863,32794,0
51,604,647,139,84,35,284,233,682,0,0,0,0,0,0,0,0,0,0,0,0,2,16,2,61690,24613,4863,32796,0
33,1892,384,251,317,7,8,52,391,11,70,44,84,81,128,467,811,6,5355,297,0,2,1,0,61690,24613,4863,32797,0
79,1593,757,253,292,73,244,162,830,13,61,38,67,74,105,409,651,7,4654,258,0,2,1,1,61690,24614,4863,32798,0
62,4177,520,294,400,33,13,81,553,10,261,204,367,271,571,2128,4614,7,32445,1802,1,2,62,0,61690,24615,4863,32799,0
79,1593,757,253,292,73,244,162,830,13,61,38,67,74,105,409,651,7,4654,258,0,2,1,1,61690,24616,4863,32800,0
62,4177,520,294,400,33,13,81,553,10,261,204,367,271,571,2128,4614,7,32445,1802,1,2,62,0,61690,24617,4863,32801,0
79,1593,757,253,292,73,244,162,830,13,61,38,67,74,105,409,651,7,4654,258,0,2,1,1,61690,24618,4863,32802,0
62,4177,520,294,400,33,13,81,553,10,261,204,367,271,571,2128,4614,7,32445,1802,1,2,62,0,61690,24619,4863,32803,0
81,1607,757,253,292,73,244,162,830,13,61,38,67,74,105,409,651,7,4654,258,0,2,9,5,61690,24620,4863,32804,0
63,4221,520,294,400,33,13,81,553,10,261,204,367,271,571,2128,4614,7,32445,1802,1,2,12,10,61690,24621,4863,32805,0
81,1608,757,253,292,73,244,162,830,13,61,38,67,74,105,409,651,7,4654,258,0,2,9,5,61690,24622,4863,32806,0
92,1762,757,253,292,73,244,162,830,13,61,38,67,74,105,409,651,7,4654,258,0,2,49,19,61690,24623,4863,32807,0
64,4282,520,294,400,33,13,81,553,10,261,204,367,271,571,2128,4614,7,32445,1802,1,2,7,0,61690,24624,4863,32808,0
92,1762,757,253,292,73,244,162,830,13,61,38,67,74,105,409,651,7,4654,258,0,2,34,22,61690,24625,4863,32809,0
64,4283,520,294,400,33,13,81,553,10,261,204,367,271,571,2128,4614,7,32445,1802,1,2,10,7,61690,24626,4863,32810,0
92,1758,757,253,292,73,244,162,830,13,61,38,67,74,105,409,651,7,4654,258,0,2,0,2,61690,24627,4863,32811,0
2,36,127,75,83,2,11,30,129,4,14,7,14,18,21,61,87,2,175,9,0,0,10,0,61690,24627,4863,32812,0
2,36,652,304,544,16,6,88,668,6,89,51,101,95,152,591,998,3,3399,188,0,0,10,0,61690,24628,4863,32813,0
2,36,2,2,2,0,0,0,2,0,0,0,0,0,0,0,0,0,0,0,0,0,10,0,61690,24628,4863,32813,0
2,36,8,5,5,0,0,3,8,0,0,0,0,0,0,0,0,0,0,0,0,0,10,0,61690,24628,4863,32814,0
2,36,2,2,2,0,0,0,2,0,0,0,0,0,0,0,0,0,0,0,0,0,10,0,61690,24628,4863,32814,0
2,36,14,8,8,0,0,6,14,0,0,0,0,0,0,0,0,0,0,0,0,0,10,0,61690,24628,4863,32815,0
2,36,6,4,4,0,0,2,6,0,0,0,0,0,0,0,0,0,0,0,0,0,10,0,61690,24628,4863,32816,0
2,36,6,4,4,0,0,2,6,1,2,1,2,3,3,2,4,0,2,0,0,0,10,0,61690,24628,4863,32817,0
2,36,6,4,4,0,0,2,6,0,0,0,0,0,0,0,0,0,0,0,0,0,10,0,61690,24628,4863,32818,0
2,36,7,5,5,0,0,2,7,0,0,0,0,0,0,0,0,0,0,0,0,0,10,0,61690,24628,4863,32819,0
2,36,6,4,4,0,0,2,6,0,0,0,0,0,0,0,0,0,0,0,0,0,10,0,61690,24628,4863,32820,0
2,36,10,6,6,0,0,4,10,0,0,0,0,0,0,0,0,0,0,0,0,0,10,0,61690,24628,4863,32821,0
2,36,1,1,1,0,0,0,1,0,0,0,0,0,0,0,0,0,0,0,0,0,10,0,61690,24628,4863,32821,0
2,36,14,10,10,0,0,4,14,1,1,1,1,2,2,0,2,0,1,0,0,0,10,0,61690,24628,4863,32822,0
2,36,46,26,30,3,0,12,49,3,6,3,6,9,9,20,28,1,42,2,0,0,10,0,61700,24628,4863,32823,0
1,6,2,2,2,0,0,0,2,0,0,0,0,0,0,0,0,0,0,0,0,0,2,0,61710,24632,4864,32830,0
176,7674,139,89,101,2,0,35,141,7,54,34,62,61,96,330,569,4,2287,127,0,2,5,0,61710,24632,4864,32831,0
176,7674,7,5,5,0,0,2,7,1,2,1,2,3,3,2,4,0,2,0,0,2,5,0,61710,24632,4864,32832,0
141,3259,77,34,69,0,0,8,77,3,24,16,29,27,45,114,213,1,387,21,0,2,3,1,61710,24632,4864,32833,1
141,3259,712,438,573,51,9,84,763,14,102,71,128,116,199,733,1364,8,11988,666,0,2,3,1,61720,24633,4864,32834,1
73,3803,1296,573,1062,40,33,157,1336,8,201,118,231,209,349,1561,2689,4,12365,686,0,2,1,1,61720,24633,4864,32835,1
92,1761,757,253,292,73,244,162,830,13,61,38,67,74,105,409,651,7,4654,258,0,2,3,1,61720,24634,4864,32836,0
92,1761,757,253,292,73,244,162,830,13,61,38,67,74,105,409,651,7,4654,258,0,2,2,2,61720,24635,4864,32837,0
75,1704,996,429,845,24,10,117,1020,7,76,50,88,83,138,494,879,4,3565,198,0,2,9,2,61720,24637,4864,32838,0
75,1704,456,277,329,12,42,72,468,13,85,50,97,98,147,592,972,7,7212,400,0,2,9,2,61720,24637,4864,32839,0
40,3026,996,429,845,24,10,117,1020,7,76,50,88,83,138,494,879,4,3565,198,0,2,26,0,61720,24639,4864,32840,0
11,413,42,7,35,4,0,5,46,1,2,1,2,3,3,2,4,0,2,0,0,2,3,3,61720,24639,4864,32841,0
11,413,11,6,10,0,0,1,11,2,4,2,4,6,6,10,15,1,15,0,0,2,3,3,61720,24639,4864,32842,0
93,1841,757,253,292,73,244,162,830,13,61,38,67,74,105,409,651,7,4654,258,0,2,21,20,61720,24640,4864,32843,0
63,4272,520,294,400,33,13,81,553,10,261,204,367,271,571,2128,4614,7,32445,1802,1,2,14,15,61720,24641,4864,32844,0
93,1841,757,253,292,73,244,162,830,13,61,38,67,74,105,409,651,7,4654,258,0,2,2,2,61720,24642,4864,32845,0
75,1704,996,429,845,24,10,117,1020,7,76,50,88,83,138,494,879,4,3565,198,0,2,9,2,61720,24644,4864,32846,0
75,1704,456,277,329,12,42,72,468,13,85,50,97,98,147,592,972,7,7212,400,0,2,9,2,61720,24644,4864,32847,0
40,3026,996,429,845,24,10,117,1020,7,76,50,88,83,138,494,879,4,3565,198,0,2,26,0,61720,24646,4864,32848,0
91,1827,757,253,292,73,244,162,830,13,61,38,67,74,105,409,651,7,4654,258,0,2,4,10,61720,24647,4864,32849,0
91,1827,757,253,292,73,244,162,830,13,61,38,67,74,105,409,651,7,4654,258,0,2,7,7,61720,24648,4864,32850,0
63,4320,520,294,400,33,13,81,553,10,261,204,367,271,571,2128,4614,7,32445,1802,1,2,9,1,61720,24649,4864,32851,0
79,1593,757,253,292,73,244,162,830,13,61,38,67,74,105,409,651,7,4654,258,0,2,1,1,61720,24650,4864,32852,1
11,413,42,7,35,4,0,5,46,1,2,1,2,3,3,2,4,0,2,0,0,2,3,3,61720,24650,4864,32853,0
11,413,11,6,10,0,0,1,11,2,4,2,4,6,6,10,15,1,15,0,0,2,3,3,61720,24650,4864,32854,0
91,1827,757,253,292,73,244,162,830,13,61,38,67,74,105,409,651,7,4654,258,0,2,3,3,61720,24651,4864,32855,0
79,1596,757,253,292,73,244,162,830,13,61,38,67,74,105,409,651,7,4654,258,0,2,3,1,61720,24652,4864,32856,0
63,1255,207,111,150,11,0,50,218,5,26,19,36,31,55,133,272,3,943,52,0,2,15,0,61720,24652,4864,32857,1
63,1255,410,198,237,31,55,97,441,11,63,38,72,74,110,414,683,6,4293,238,0,2,15,0,61730,24653,4865,32858,1
254,5825,4293,999,3693,19,54,507,4312,9,155,88,170,164,258,1156,1898,4,9368,520,0,2,13,14,61730,24655,4865,32859,1
254,5825,1482,859,1002,125,135,219,1607,16,219,134,251,235,385,1766,3032,9,27804,1544,1,2,13,14,61740,24656,4865,32860,1
17,774,75,38,59,1,3,12,76,2,4,2,4,6,6,10,15,1,15,0,0,2,0,1,61740,24656,4865,32861,1
175,7644,139,89,101,2,0,35,141,7,54,34,62,61,96,330,569,4,2287,127,0,2,3,4,61740,24656,4865,32862,1
175,7644,7,5,5,0,0,2,7,1,2,1,2,3,3,2,4,0,2,0,0,2,3,4,61740,24656,4865,32863,1
164,5055,1660,832,1314,41,38,274,1701,20,312,209,395,332,604,2671,5058,12,64042,3557,1,2,12,14,61740,24658,4866,32865,1
164,5055,1057,646,719,113,100,145,1170,18,215,134,248,233,382,1740,3004,10,31186,1732,1,2,12,14,61750,24659,4867,32866,1
155,4396,1660,832,1314,41,38,274,1701,20,312,209,395,332,604,2671,5058,12,64042,3557,1,2,9,0,61750,24661,4868,32868,1
91,1827,757,253,292,73,244,162,830,13,61,38,67,74,105,409,651,7,4654,258,0,2,86,41,61750,24662,4868,32869,0
63,4320,520,294,400,33,13,81,553,10,261,204,367,271,571,2128,4614,7,32445,1802,1,2,29,10,61750,24663,4868,32870,0
91,1830,757,253,292,73,244,162,830,13,61,38,67,74,105,409,651,7,4654,258,0,2,3,1,61750,24664,4868,32871,0
63,1255,207,111,150,11,0,50,218,5,26,19,36,31,55,133,272,3,943,52,0,2,15,0,61750,24664,4868,32872,0
63,1255,410,198,237,31,55,97,441,11,63,38,72,74,110,414,683,6,4293,238,0,2,15,0,61760,24665,4869,32873,0
254,5825,4293,999,3693,19,54,507,4312,9,155,88,170,164,258,1156,1898,4,9368,520,0,2,13,14,61760,24667,4869,32874,0
254,5825,1482,859,1002,125,135,219,1607,16,219,134,251,235,385,1766,3032,9,27804,1544,1,2,13,14,61770,24668,4869,32875,0
17,774,75,38,59,1,3,12,76,2,4,2,4,6,6,10,15,1,15,0,0,2,0,1,61770,24668,4869,32876,0
175,7644,139,89,101,2,0,35,141,7,54,34,62,61,96,330,569,4,2287,127,0,2,3,4,61770,24668,4869,32877,0
175,7644,7,5,5,0,0,2,7,1,2,1,2,3,3,2,4,0,2,0,0,2,3,4,61770,24668,4869,32878,0
164,5055,1660,832,1314,41,38,274,1701,20,312,209,395,332,604,2671,5058,12,64042,3557,1,2,12,14,61770,24670,4870,32880,0
164,5055,1057,646,719,113,100,145,1170,18,215,134,248,233,382,1740,3004,10,31186,1732,1,2,12,14,61780,24671,4871,32881,0
155,4396,1660,832,1314,41,38,274,1701,20,312,209,395,332,604,2671,5058,12,64042,3557,1,2,9,0,61780,24673,4872,32883,0
141,3259,77,34,69,0,0,8,77,3,24,16,29,27,45,114,213,1,387,21,0,2,3,1,61780,24673,4872,32884,0
141,3259,712,438,573,51,9,84,763,14,102,71,128,116,199,733,1364,8,11988,666,0,2,3,1,61790,24674,4872,32885,0
2,36,127,75,83,2,11,30,129,4,14,7,14,18,21,61,87,2,175,9,0,0,10,0,61790,24674,4872,32886,0
2,36,652,304,544,16,6,88,668,6,89,51,101,95,152,591,998,3,3399,188,0,0,10,0,61790,24675,4872,32887,0
2,36,2,2,2,0,0,0,2,0,0,0,0,0,0,0,0,0,0,0,0,0,10,0,61790,24675,4872,32887,0
2,36,8,5,5,0,0,3,8,0,0,0,0,0,0,0,0,0,0,0,0,0,10,0,61790,24675,4872,32888,0
2,36,2,2,2,0,0,0,2,0,0,0,0,0,0,0,0,0,0,0,0,0,10,0,61790,24675,4872,32888,0
2,36,14,8,8,0,0,6,14,0,0,0,0,0,0,0,0,0,0,0,0,0,10,0,61790,24675,4872,32889,0
2,36,6,4,4,0,0,2,6,0,0,0,0,0,0,0,0,0,0,0,0,0,10,0,61790,24675,4872,32890,0
2,36,6,4,4,0,0,2,6,1,2,1,2,3,3,2,4,0,2,0,0,0,10,0,61790,24675,4872,32891,0
2,36,6,4,4,0,0,2,6,0,0,0,0,0,0,0,0,0,0,0,0,0,10,0,61790,24675,4872,32892,0
2,36,7,5,5,0,0,2,7,0,0,0,0,0,0,0,0,0,0,0,0,0,10,0,61790,24675,4872,32893,0
2,36,6,4,4,0,0,2,6,0,0,0,0,0,0,0,0,0,0,0,0,0,10,0,61790,24675,4872,32894,0
2,36,10,6,6,0,0,4,10,0,0,0,0,0,0,0,0,0,0,0,0,0,10,0,61790,24675,4872,32895,0
2,36,1,1,1,0,0,0,1,0,0,0,0,0,0,0,0,0,0,0,0,0,10,0,61790,24675,4872,32895,0
2,36,14,10,10,0,0,4,14,1,1,1,1,2,2,0,2,0,1,0,0,0,10,0,61790,24675,4872,32896,0
2,36,46,26,30,3,0,12,49,3,6,3,6,9,9,20,28,1,42,2,0,0,10,0,61800,24675,4872,32897,0
1,6,2,2,2,0,0,0,2,0,0,0,0,0,0,0,0,0,0,0,0,0,2,0,61810,24679,4873,32904,0
176,7674,139,89,101,2,0,35,141,7,54,34,62,61,96,330,569,4,2287,127,0,2,5,0,61810,24679,4873,32905,0
176,7674,7,5,5,0,0,2,7,1,2,1,2,3,3,2,4,0,2,0,0,2,5,0,61810,24679,4873,32906,0
73,3803,1296,573,1062,40,33,157,1336,8,201,118,231,209,349,1561,2689,4,12365,686,0,2,1,1,61810,24679,4873,32907,0
1,8,127,75,83,2,11,30,129,4,14,7,14,18,21,61,87,2,175,9,0,0,2,0,61810,24679,4873,32908,0
1,8,652,304,544,16,6,88,668,6,89,51,101,95,152,591,998,3,3399,188,0,0,2,0,61810,24680,4873,32909,0
1,8,2,2,2,0,0,0,2,0,0,0,0,0,0,0,0,0,0,0,0,0,2,0,61810,24680,4873,32909,0
1,8,8,5,5,0,0,3,8,0,0,0,0,0,0,0,0,0,0,0,0,0,2,0,61810,24680,4873,32910,0
1,8,2,2,2,0,0,0,2,0,0,0,0,0,0,0,0,0,0,0,0,0,2,0,61810,24680,4873,32910,0
1,8,14,8,8,0,0,6,14,0,0,0,0,0,0,0,0,0,0,0,0,0,2,0,61810,24680,4873,32911,0
1,8,6,4,4,0,0,2,6,0,0,0,0,0,0,0,0,0,0,0,0,0,2,0,61810,24680,4873,32912,0
1,8,6,4,4,0,0,2,6,1,2,1,2,3,3,2,4,0,2,0,0,0,2,0,61810,24680,4873,32913,0
1,8,6,4,4,0,0,2,6,0,0,0,0,0,0,0,0,0,0,0,0,0,2,0,61810,24680,4873,32914,0
1,8,7,5,5,0,0,2,7,0,0,0,0,0,0,0,0,0,0,0,0,0,2,0,61810,24680,4873,32915,0
1,8,6,4,4,0,0,2,6,0,0,0,0,0,0,0,0,0,0,0,0,0,2,0,61810,24680,4873,32916,0
1,8,10,6,6,0,0,4,10,0,0,0,0,0,0,0,0,0,0,0,0,0,2,0,61810,24680,4873,32917,0
1,8,1,1,1,0,0,0,1,0,0,0,0,0,0,0,0,0,0,0,0,0,2,0,61810,24680,4873,32917,0
1,8,14,10,10,0,0,4,14,1,1,1,1,2,2,0,2,0,1,0,0,0,2,0,61810,24680,4873,32918,0
1,8,46,26,30,3,0,12,49,3,6,3,6,9,9,20,28,1,42,2,0,0,2,0,61820,24680,4873,32919,0
1,6,2,2,2,0,0,0,2,0,0,0,0,0,0,0,0,0,0,0,0,0,2,0,61830,24684,4874,32926,0
99,4460,1338,495,1086,10,64,173,1348,11,122,82,157,133,239,883,1686,7,11934,663,0,2,6,0,61830,24686,4874,32927,0
314,6831,72,33,56,0,4,12,72,1,1,1,1,2,2,0,2,0,1,0,0,2,6,3,61830,24686,4874,32928,1
314,6831,1454,835,1044,76,110,219,1530,17,275,158,296,292,454,2297,3718,9,34017,1889,1,2,6,3,61840,24687,4874,32929,1
64,1275,207,111,150,11,0,50,218,5,26,19,36,31,55,133,272,3,943,52,0,2,7,0,61840,24687,4874,32930,1
64,1275,410,198,237,31,55,97,441,11,63,38,72,74,110,414,683,6,4293,238,0,2,7,0,61850,24688,4875,32931,1
254,5830,4293,999,3693,19,54,507,4312,9,155,88,170,164,258,1156,1898,4,9368,520,0,2,4,3,61850,24690,4875,32932,1
254,5830,1482,859,1002,125,135,219,1607,16,219,134,251,235,385,1766,3032,9,27804,1544,1,2,4,3,61860,24691,4875,32933,1
93,3899,1289,550,1043,56,32,155,1345,10,167,93,185,177,278,1266,2075,5,11498,638,0,2,7,0,61860,24693,4876,32934,1
2,56,16,12,9,0,0,6,16,1,2,1,2,3,3,2,4,0,2,0,0,0,17,0,61860,24693,4876,32935,1
20,439,207,111,150,11,0,50,218,5,26,19,36,31,55,133,272,3,943,52,0,2,32,0,61860,24693,4876,32936,1
212,4563,2,2,2,0,0,0,2,0,0,0,0,0,0,0,0,0,0,0,0,2,5,0,61860,24693,4876,32936,1
212,4563,99,48,90,1,3,5,100,0,0,0,0,0,0,0,0,0,0,0,0,2,5,0,61860,24694,4876,32937,1
212,4563,8,5,5,2,0,1,10,0,0,0,0,0,0,0,0,0,0,0,0,2,5,0,61860,24694,4876,32938,1
212,4563,1217,716,841,84,126,174,1301,14,185,118,215,199,333,1446,2542,8,20687,1149,0,2,5,0,61870,24696,4876,32939,1
212,4563,160,89,115,0,13,31,160,7,15,11,17,22,28,78,124,3,495,27,0,2,5,0,61870,24696,4876,32940,1
212,4563,10,10,9,9,0,0,19,0,0,0,0,0,0,0,0,0,0,0,0,2,5,0,61870,24696,4877,32941,1
212,4563,173,84,99,8,29,36,181,5,12,7,13,17,20,54,81,2,221,12,0,2,5,0,61870,24697,4877,32942,1
212,4563,3,1,1,3,0,0,6,0,0,0,0,0,0,0,0,0,0,0,0,2,5,0,61870,24697,4877,32943,1
1,6,2,2,2,0,0,0,2,0,0,0,0,0,0,0,0,0,0,0,0,0,2,0,61880,24698,4877,32955,1
86,4507,1457,730,1242,11,6,188,1468,10,292,166,329,302,495,2424,4078,5,22973,1276,1,2,18,0,61880,24700,4877,32956,1
212,4563,2,2,2,0,0,0,2,0,0,0,0,0,0,0,0,0,0,0,0,2,5,0,61880,24700,4877,32956,0
212,4563,99,48,90,1,3,5,100,0,0,0,0,0,0,0,0,0,0,0,0,2,5,0,61880,24701,4877,32957,0
212,4563,8,5,5,2,0,1,10,0,0,0,0,0,0,0,0,0,0,0,0,2,5,0,61880,24701,4877,32958,0
212,4563,1217,716,841,84,126,174,1301,14,185,118,215,199,333,1446,2542,8,20687,1149,0,2,5,0,61890,24703,4877,32959,0
212,4563,160,89,115,0,13,31,160,7,15,11,17,22,28,78,124,3,495,27,0,2,5,0,61890,24703,4877,32960,0
212,4563,10,10,9,9,0,0,19,0,0,0,0,0,0,0,0,0,0,0,0,2,5,0,61890,24703,4878,32961,0
212,4563,173,84,99,8,29,36,181,5,12,7,13,17,20,54,81,2,221,12,0,2,5,0,61890,24704,4878,32962,0
212,4563,3,1,1,3,0,0,6,0,0,0,0,0,0,0,0,0,0,0,0,2,5,0,61890,24704,4878,32963,0
1,6,2,2,2,0,0,0,2,0,0,0,0,0,0,0,0,0,0,0,0,0,2,0,61900,24705,4878,32975,0
86,4507,1457,730,1242,11,6,188,1468,10,292,166,329,302,495,2424,4078,5,22973,1276,1,2,18,0,61900,24707,4878,32976,0
314,6831,72,33,56,0,4,12,72,1,1,1,1,2,2,0,2,0,1,0,0,2,6,3,61900,24707,4878,32977,0
314,6831,1454,835,1044,76,110,219,1530,17,275,158,296,292,454,2297,3718,9,34017,1889,1,2,6,3,61910,24708,4878,32978,0
1,8,127,75,83,2,11,30,129,4,14,7,14,18,21,61,87,2,175,9,0,0,2,0,61910,24708,4878,32979,0
1,8,652,304,544,16,6,88,668,6,89,51,101,95,152,591,998,3,3399,188,0,0,2,0,61910,24709,4878,32980,0
1,8,2,2,2,0,0,0,2,0,0,0,0,0,0,0,0,0,0,0,0,0,2,0,61910,24709,4878,32980,0
1,8,8,5,5,0,0,3,8,0,0,0,0,0,0,0,0,0,0,0,0,0,2,0,61910,24709,4878,32981,0
1,8,2,2,2,0,0,0,2,0,0,0,0,0,0,0,0,0,0,0,0,0,2,0,61910,24709,4878,32981,0
1,8,14,8,8,0,0,6,14,0,0,0,0,0,0,0,0,0,0,0,0,0,2,0,61910,24709,4878,32982,0
1,8,6,4,4,0,0,2,6,0,0,0,0,0,0,0,0,0,0,0,0,0,2,0,61910,24709,4878,32983,0
1,8,6,4,4,0,0,2,6,1,2,1,2,3,3,2,4,0,2,0,0,0,2,0,61910,24709,4878,32984,0
1,8,6,4,4,0,0,2,6,0,0,0,0,0,0,0,0,0,0,0,0,0,2,0,61910,24709,4878,32985,0
1,8,7,5,5,0,0,2,7,0,0,0,0,0,0,0,0,0,0,0,0,0,2,0,61910,24709,4878,32986,0
1,8,6,4,4,0,0,2,6,0,0,0,0,0,0,0,0,0,0,0,0,0,2,0,61910,24709,4878,32987,0
1,8,10,6,6,0,0,4,10,0,0,0,0,0,0,0,0,0,0,0,0,0,2,0,61910,24709,4878,32988,0
1,8,1,1,1,0,0,0,1,0,0,0,0,0,0,0,0,0,0,0,0,0,2,0,61910,24709,4878,32988,0
1,8,14,10,10,0,0,4,14,1,1,1,1,2,2,0,2,0,1,0,0,0,2,0,61910,24709,4878,32989,0
1,8,46,26,30,3,0,12,49,3,6,3,6,9,9,20,28,1,42,2,0,0,2,0,61920,24709,4878,32990,0
1,6,2,2,2,0,0,0,2,0,0,0,0,0,0,0,0,0,0,0,0,0,2,0,61930,24713,4879,32997,0
99,4460,1338,495,1086,10,64,173,1348,11,122,82,157,133,239,883,1686,7,11934,663,0,2,6,0,61930,24715,4879,32998,0
213,4573,2,2,2,0,0,0,2,0,0,0,0,0,0,0,0,0,0,0,0,2,8,1,61930,24715,4879,32998,1
213,4573,99,48,90,1,3,5,100,0,0,0,0,0,0,0,0,0,0,0,0,2,8,1,61930,24716,4879,32999,1
213,4573,8,5,5,2,0,1,10,0,0,0,0,0,0,0,0,0,0,0,0,2,8,1,61930,24716,4879,33000,1
213,4573,1217,716,841,84,126,174,1301,14,185,118,215,199,333,1446,2542,8,20687,1149,0,2,8,1,61940,24718,4879,33001,1
213,4573,160,89,115,0,13,31,160,7,15,11,17,22,28,78,124,3,495,27,0,2,8,1,61940,24718,4879,33002,1
213,4573,10,10,9,9,0,0,19,0,0,0,0,0,0,0,0,0,0,0,0,2,8,1,61940,24718,4880,33003,1
213,4573,173,84,99,8,29,36,181,5,12,7,13,17,20,54,81,2,221,12,0,2,8,1,61940,24719,4880,33004,1
213,4573,3,1,1,3,0,0,6,0,0,0,0,0,0,0,0,0,0,0,0,2,8,1,61940,24719,4880,33005,1
27,965,74,35,59,1,0,14,75,3,14,7,14,17,21,58,85,1,128,7,0,2,1,0,61940,24720,4880,33006,1
27,965,245,125,200,5,7,34,250,7,30,17,34,37,51,166,265,3,1053,58,0,2,1,0,61950,24721,4880,33007,1
86,4564,1457,730,1242,11,6,188,1468,10,292,166,329,302,495,2424,4078,5,22973,1276,1,2,20,0,61950,24723,4880,33008,1
62,1229,1098,241,925,5,10,155,1103,7,46,25,49,53,74,273,423,3,1580,87,0,2,1,0,61960,24725,4880,33009,0
62,1229,282,202,222,14,2,44,296,8,42,24,43,50,67,250,378,4,1548,86,0,2,1,0,61960,24726,4880,33010,0
50,1879,1098,241,925,5,10,155,1103,7,46,25,49,53,74,273,423,3,1580,87,0,2,21,0,61970,24728,4880,33011,0
50,1879,1098,241,925,5,10,155,1103,7,46,25,49,53,74,273,423,3,1580,87,0,2,1,1,61980,24730,4880,33012,0
213,4573,2,2,2,0,0,0,2,0,0,0,0,0,0,0,0,0,0,0,0,2,8,1,61980,24730,4880,33012,0
213,4573,99,48,90,1,3,5,100,0,0,0,0,0,0,0,0,0,0,0,0,2,8,1,61980,24731,4880,33013,0
213,4573,8,5,5,2,0,1,10,0,0,0,0,0,0,0,0,0,0,0,0,2,8,1,61980,24731,4880,33014,0
213,4573,1217,716,841,84,126,174,1301,14,185,118,215,199,333,1446,2542,8,20687,1149,0,2,8,1,61990,24733,4880,33015,0
213,4573,160,89,115,0,13,31,160,7,15,11,17,22,28,78,124,3,495,27,0,2,8,1,61990,24733,4880,33016,0
213,4573,10,10,9,9,0,0,19,0,0,0,0,0,0,0,0,0,0,0,0,2,8,1,61990,24733,4881,33017,0
213,4573,173,84,99,8,29,36,181,5,12,7,13,17,20,54,81,2,221,12,0,2,8,1,61990,24734,4881,33018,0
213,4573,3,1,1,3,0,0,6,0,0,0,0,0,0,0,0,0,0,0,0,2,8,1,61990,24734,4881,33019,0
27,965,74,35,59,1,0,14,75,3,14,7,14,17,21,58,85,1,128,7,0,2,1,0,61990,24735,4881,33020,0
27,965,245,125,200,5,7,34,250,7,30,17,34,37,51,166,265,3,1053,58,0,2,1,0,62000,24736,4881,33021,0
86,4564,1457,730,1242,11,6,188,1468,10,292,166,329,302,495,2424,4078,5,22973,1276,1,2,20,0,62000,24738,4881,33022,0
62,1229,1098,241,925,5,10,155,1103,7,46,25,49,53,74,273,423,3,1580,87,0,2,1,0,62010,24740,4881,33023,0
62,1229,282,202,222,14,2,44,296,8,42,24,43,50,67,250,378,4,1548,86,0,2,1,0,62010,24741,4881,33024,0
50,1879,1098,241,925,5,10,155,1103,7,46,25,49,53,74,273,423,3,1580,87,0,2,21,0,62020,24743,4881,33025,0
65,1299,207,111,150,11,0,50,218,5,26,19,36,31,55,133,272,3,943,52,0,2,14,2,62020,24743,4881,33026,0
65,1299,410,198,237,31,55,97,441,11,63,38,72,74,110,414,683,6,4293,238,0,2,14,2,62030,24744,4882,33027,0
254,5835,4293,999,3693,19,54,507,4312,9,155,88,170,164,258,1156,1898,4,9368,520,0,2,2,1,62030,24746,4882,33028,0
254,5835,1482,859,1002,125,135,219,1607,16,219,134,251,235,385,1766,3032,9,27804,1544,1,2,2,1,62040,24747,4882,33029,0
19,437,207,111,150,11,0,50,218,5,26,19,36,31,55,133,272,3,943,52,0,2,2,4,62040,24747,4882,33030,0
65,1299,207,111,150,11,0,50,218,5,26,19,36,31,55,133,272,3,943,52,0,2,19,0,62040,24747,4882,33031,0
65,1299,410,198,237,31,55,97,441,11,63,38,72,74,110,414,683,6,4293,238,0,2,19,0,62050,24748,4883,33032,0
254,5835,4293,999,3693,19,54,507,4312,9,155,88,170,164,258,1156,1898,4,9368,520,0,2,5,3,62050,24750,4883,33033,0
254,5835,1482,859,1002,125,135,219,1607,16,219,134,251,235,385,1766,3032,9,27804,1544,1,2,5,3,62060,24751,4883,33034,0
93,3899,1289,550,1043,56,32,155,1345,10,167,93,185,177,278,1266,2075,5,11498,638,0,2,7,0,62060,24753,4884,33035,0
2,56,16,12,9,0,0,6,16,1,2,1,2,3,3,2,4,0,2,0,0,0,17,0,62060,24753,4884,33036,0
19,437,207,111,150,11,0,50,218,5,26,19,36,31,55,133,272,3,943,52,0,2,31,1,62060,24753,4884,33037,0
314,6843,72,33,56,0,4,12,72,1,1,1,1,2,2,0,2,0,1,0,0,2,1,0,62060,24753,4884,33038,0
314,6843,1454,835,1044,76,110,219,1530,17,275,158,296,292,454,2297,3718,9,34017,1889,1,2,1,0,62070,24754,4884,33039,0
141,3263,77,34,69,0,0,8,77,3,24,16,29,27,45,114,213,1,387,21,0,2,3,2,62070,24754,4884,33040,0
141,3263,712,438,573,51,9,84,763,14,102,71,128,116,199,733,1364,8,11988,666,0,2,3,2,62080,24755,4884,33041,0
73,3805,1296,573,1062,40,33,157,1336,8,201,118,231,209,349,1561,2689,4,12365,686,0,2,1,1,62080,24755,4884,33042,0
94,1909,463,295,324,28,62,57,491,12,134,82,154,146,236,989,1696,6,11700,650,0,2,7,7,62090,24756,4884,33043,0
309,6791,72,33,56,0,4,12,72,1,1,1,1,2,2,0,2,0,1,0,0,2,10,15,62090,24756,4884,33044,1
309,6791,1454,835,1044,76,110,219,1530,17,275,158,296,292,454,2297,3718,9,34017,1889,1,2,10,15,62100,24757,4884,33045,1
73,3806,1296,573,1062,40,33,157,1336,8,201,118,231,209,349,1561,2689,4,12365,686,0,2,4,0,62100,24757,4884,33046,0
73,3830,1296,573,1062,40,33,157,1336,8,201,118,231,209,349,1561,2689,4,12365,686,0,2,7,4,62100,24757,4884,33047,0
100,4602,1338,495,1086,10,64,173,1348,11,122,82,157,133,239,883,1686,7,11934,663,0,2,40,0,62100,24759,4884,33048,0
314,6831,72,33,56,0,4,12,72,1,1,1,1,2,2,0,2,0,1,0,0,2,2,1,62100,24759,4884,33049,0
314,6831,1454,835,1044,76,110,219,1530,17,275,158,296,292,454,2297,3718,9,34017,1889,1,2,2,1,62110,24760,4884,33050,0
314,6831,72,33,56,0,4,12,72,1,1,1,1,2,2,0,2,0,1,0,0,2,2,1,62110,24760,4884,33051,0
314,6831,1454,835,1044,76,110,219,1530,17,275,158,296,292,454,2297,3718,9,34017,1889,1,2,2,1,62120,24761,4884,33052,0
94,1909,463,295,324,28,62,57,491,12,134,82,154,146,236,989,1696,6,11700,650,0,2,7,7,62130,24762,4884,33053,0
23,474,601,196,481,2,23,85,603,8,63,36,72,71,108,400,664,4,3036,168,0,2,8,0,62130,24762,4884,33054,1
23,474,156,79,106,5,16,28,161,5,14,8,15,19,23,64,97,2,261,14,0,2,8,0,62130,24762,4884,33055,1
20,707,601,196,481,2,23,85,603,8,63,36,72,71,108,400,664,4,3036,168,0,2,15,0,62130,24762,4884,33056,1
20,707,601,196,481,2,23,85,603,8,63,36,72,71,108,400,664,4,3036,168,0,2,2,2,62130,24762,4884,33057,0
23,474,601,196,481,2,23,85,603,8,63,36,72,71,108,400,664,4,3036,168,0,2,8,0,62130,24762,4884,33058,0
23,474,156,79,106,5,16,28,161,5,14,8,15,19,23,64,97,2,261,14,0,2,8,0,62130,24762,4884,33059,0
20,707,601,196,481,2,23,85,603,8,63,36,72,71,108,400,664,4,3036,168,0,2,15,0,62130,24762,4884,33060,0
309,6791,72,33,56,0,4,12,72,1,1,1,1,2,2,0,2,0,1,0,0,2,10,15,62130,24762,4884,33061,0
309,6791,1454,835,1044,76,110,219,1530,17,275,158,296,292,454,2297,3718,9,34017,1889,1,2,10,15,62140,24763,4884,33062,0
100,4602,1338,495,1086,10,64,173,1348,11,122,82,157,133,239,883,1686,7,11934,663,0,2,40,0,62140,24765,4884,33063,0
215,4676,182,127,129,0,0,53,182,5,39,21,42,44,63,217,343,2,926,51,0,2,3,1,62140,24765,4885,33064,1
215,4676,1165,710,800,67,119,181,1232,18,243,153,282,261,435,2000,3492,10,36473,2026,1,2,3,1,62150,24765,4886,33065,1
152,7085,1392,870,1177,35,17,170,1427,14,494,280,531,508,811,4473,7289,7,54850,3047,2,2,45,0,62150,24768,4887,33066,1
141,3263,77,34,69,0,0,8,77,3,24,16,29,27,45,114,213,1,387,21,0,2,3,2,62150,24768,4887,33067,0
141,3263,712,438,573,51,9,84,763,14,102,71,128,116,199,733,1364,8,11988,666,0,2,3,2,62160,24769,4887,33068,0
73,3830,1296,573,1062,40,33,157,1336,8,201,118,231,209,349,1561,2689,4,12365,686,0,2,9,2,62160,24769,4887,33069,0
215,4676,182,127,129,0,0,53,182,5,39,21,42,44,63,217,343,2,926,51,0,2,3,1,62160,24769,4888,33070,0
215,4676,1165,710,800,67,119,181,1232,18,243,153,282,261,435,2000,3492,10,36473,2026,1,2,3,1,62170,24769,4889,33071,0
152,7085,1392,870,1177,35,17,170,1427,14,494,280,531,508,811,4473,7289,7,54850,3047,2,2,45,0,62170,24772,4890,33072,0
126,5153,1513,682,1277,25,13,200,1538,11,199,116,219,210,335,1557,2584,6,15641,868,0,2,28,0,62170,24774,4890,33073,1
149,3076,1513,682,1277,25,13,200,1538,11,199,116,219,210,335,1557,2584,6,15641,868,0,2,14,2,62170,24776,4890,33074,1
149,3076,819,519,539,24,98,155,843,15,96,57,106,111,163,690,1107,8,9171,509,0,2,14,2,62180,24778,4890,33075,1
88,2266,773,422,505,30,103,129,803,14,77,46,83,91,129,535,839,7,6334,351,0,2,2,0,62190,24779,4891,33076,1
34,2119,1157,318,931,29,22,177,1186,6,104,63,125,110,188,712,1274,3,4596,255,0,2,8,0,62190,24779,4891,33077,0
126,5153,1513,682,1277,25,13,200,1538,11,199,116,219,210,335,1557,2584,6,15641,868,0,2,3,0,62190,24781,4891,33078,0
149,3116,1513,682,1277,25,13,200,1538,11,199,116,219,210,335,1557,2584,6,15641,868,0,2,21,10,62190,24783,4891,33079,1
149,3116,819,519,539,24,98,155,843,15,96,57,106,111,163,690,1107,8,9171,509,0,2,21,10,62200,24785,4891,33080,1
86,2245,773,422,505,30,103,129,803,14,77,46,83,91,129,535,839,7,6334,351,0,2,5,7,62210,24786,4892,33081,1
31,2079,1157,318,931,29,22,177,1186,6,104,63,125,110,188,712,1274,3,4596,255,0,2,7,17,62210,24786,4892,33082,1
254,5829,4293,999,3693,19,54,507,4312,9,155,88,170,164,258,1156,1898,4,9368,520,0,2,2,2,62210,24788,4892,33083,1
254,5829,1482,859,1002,125,135,219,1607,16,219,134,251,235,385,1766,3032,9,27804,1544,1,2,2,2,62220,24789,4892,33084,1
149,3083,1513,682,1277,25,13,200,1538,11,199,116,219,210,335,1557,2584,6,15641,868,0,2,17,17,62220,24791,4892,33085,1
149,3083,819,519,539,24,98,155,843,15,96,57,106,111,163,690,1107,8,9171,509,0,2,17,17,62230,24793,4892,33086,1
150,3111,1513,682,1277,25,13,200,1538,11,199,116,219,210,335,1557,2584,6,15641,868,0,2,8,7,62230,24795,4892,33087,1
150,3111,819,519,539,24,98,155,843,15,96,57,106,111,163,690,1107,8,9171,509,0,2,8,7,62240,24797,4892,33088,1
86,2238,773,422,505,30,103,129,803,14,77,46,83,91,129,535,839,7,6334,351,0,2,1,5,62250,24798,4893,33089,1
150,3111,1513,682,1277,25,13,200,1538,11,199,116,219,210,335,1557,2584,6,15641,868,0,2,1,1,62250,24800,4893,33090,1
150,3111,819,519,539,24,98,155,843,15,96,57,106,111,163,690,1107,8,9171,509,0,2,1,1,62260,24802,4893,33091,1
86,2240,773,422,505,30,103,129,803,14,77,46,83,91,129,535,839,7,6334,351,0,2,5,1,62270,24803,4894,33092,1
150,3126,1513,682,1277,25,13,200,1538,11,199,116,219,210,335,1557,2584,6,15641,868,0,2,3,0,62270,24805,4894,33093,1
150,3126,819,519,539,24,98,155,843,15,96,57,106,111,163,690,1107,8,9171,509,0,2,3,0,62280,24807,4894,33094,1
149,3115,1513,682,1277,25,13,200,1538,11,199,116,219,210,335,1557,2584,6,15641,868,0,2,2,7,62280,24809,4894,33095,1
149,3115,819,519,539,24,98,155,843,15,96,57,106,111,163,690,1107,8,9171,509,0,2,2,7,62290,24811,4894,33096,1
66,1312,207,111,150,11,0,50,218,5,26,19,36,31,55,133,272,3,943,52,0,2,8,0,62290,24811,4894,33097,1
66,1312,410,198,237,31,55,97,441,11,63,38,72,74,110,414,683,6,4293,238,0,2,8,0,62300,24812,4895,33098,1
85,2238,773,422,505,30,103,129,803,14,77,46,83,91,129,535,839,7,6334,351,0,2,3,7,62310,24813,4896,33099,1
149,3116,1513,682,1277,25,13,200,1538,11,199,116,219,210,335,1557,2584,6,15641,868,0,2,7,6,62310,24815,4896,33100,1
149,3116,819,519,539,24,98,155,843,15,96,57,106,111,163,690,1107,8,9171,509,0,2,7,6,62320,24817,4896,33101,1
85,2238,773,422,505,30,103,129,803,14,77,46,83,91,129,535,839,7,6334,351,0,2,1,1,62330,24818,4897,33102,1
31,2079,1157,318,931,29,22,177,1186,6,104,63,125,110,188,712,1274,3,4596,255,0,2,1,1,62330,24818,4897,33103,1
254,5829,4293,999,3693,19,54,507,4312,9,155,88,170,164,258,1156,1898,4,9368,520,0,2,2,2,62330,24820,4897,33104,0
254,5829,1482,859,1002,125,135,219,1607,16,219,134,251,235,385,1766,3032,9,27804,1544,1,2,2,2,62340,24821,4897,33105,0
149,3116,1513,682,1277,25,13,200,1538,11,199,116,219,210,335,1557,2584,6,15641,868,0,2,30,7,62340,24823,4897,33106,0
149,3116,819,519,539,24,98,155,843,15,96,57,106,111,163,690,1107,8,9171,509,0,2,30,7,62350,24825,4897,33107,0
66,1312,207,111,150,11,0,50,218,5,26,19,36,31,55,133,272,3,943,52,0,2,8,0,62350,24825,4897,33108,0
66,1312,410,198,237,31,55,97,441,11,63,38,72,74,110,414,683,6,4293,238,0,2,8,0,62360,24826,4898,33109,0
85,2238,773,422,505,30,103,129,803,14,77,46,83,91,129,535,839,7,6334,351,0,2,8,12,62370,24827,4899,33110,0
31,2079,1157,318,931,29,22,177,1186,6,104,63,125,110,188,712,1274,3,4596,255,0,2,7,9,62370,24827,4899,33111,0
126,5153,1513,682,1277,25,13,200,1538,11,199,116,219,210,335,1557,2584,6,15641,868,0,2,31,0,62370,24829,4899,33112,0
149,3110,1513,682,1277,25,13,200,1538,11,199,116,219,210,335,1557,2584,6,15641,868,0,2,0,1,62370,24831,4899,33113,0
149,3110,819,519,539,24,98,155,843,15,96,57,106,111,163,690,1107,8,9171,509,0,2,0,1,62380,24833,4899,33114,0
127,5180,1513,682,1277,25,13,200,1538,11,199,116,219,210,335,1557,2584,6,15641,868,0,2,20,0,62380,24835,4899,33115,0
149,3215,1513,682,1277,25,13,200,1538,11,199,116,219,210,335,1557,2584,6,15641,868,0,2,28,8,62380,24837,4899,33116,1
149,3215,819,519,539,24,98,155,843,15,96,57,106,111,163,690,1107,8,9171,509,0,2,28,8,62390,24839,4899,33117,1
127,5207,1513,682,1277,25,13,200,1538,11,199,116,219,210,335,1557,2584,6,15641,868,0,2,28,20,62390,24841,4899,33118,1
215,4676,182,127,129,0,0,53,182,5,39,21,42,44,63,217,343,2,926,51,0,2,3,1,62390,24841,4900,33119,0
215,4676,1165,710,800,67,119,181,1232,18,243,153,282,261,435,2000,3492,10,36473,2026,1,2,3,1,62400,24841,4901,33120,0
149,3116,1513,682,1277,25,13,200,1538,11,199,116,219,210,335,1557,2584,6,15641,868,0,2,30,7,62400,24843,4901,33121,0
149,3116,819,519,539,24,98,155,843,15,96,57,106,111,163,690,1107,8,9171,509,0,2,30,7,62410,24845,4901,33122,0
66,1312,207,111,150,11,0,50,218,5,26,19,36,31,55,133,272,3,943,52,0,2,27,0,62410,24845,4901,33123,0
66,1312,410,198,237,31,55,97,441,11,63,38,72,74,110,414,683,6,4293,238,0,2,27,0,62420,24846,4902,33124,0
214,4585,2,2,2,0,0,0,2,0,0,0,0,0,0,0,0,0,0,0,0,2,5,0,62420,24846,4902,33124,0
214,4585,99,48,90,1,3,5,100,0,0,0,0,0,0,0,0,0,0,0,0,2,5,0,62420,24847,4902,33125,0
214,4585,8,5,5,2,0,1,10,0,0,0,0,0,0,0,0,0,0,0,0,2,5,0,62420,24847,4902,33126,0
214,4585,1217,716,841,84,126,174,1301,14,185,118,215,199,333,1446,2542,8,20687,1149,0,2,5,0,62430,24849,4902,33127,0
214,4585,160,89,115,0,13,31,160,7,15,11,17,22,28,78,124,3,495,27,0,2,5,0,62430,24849,4902,33128,0
214,4585,10,10,9,9,0,0,19,0,0,0,0,0,0,0,0,0,0,0,0,2,5,0,62430,24849,4903,33129,0
214,4585,173,84,99,8,29,36,181,5,12,7,13,17,20,54,81,2,221,12,0,2,5,0,62430,24850,4903,33130,0
214,4585,3,1,1,3,0,0,6,0,0,0,0,0,0,0,0,0,0,0,0,2,5,0,62430,24850,4903,33131,0
94,1909,463,295,324,28,62,57,491,12,134,82,154,146,236,989,1696,6,11700,650,0,2,7,7,62440,24851,4903,33132,0
254,5829,4293,999,3693,19,54,507,4312,9,155,88,170,164,258,1156,1898,4,9368,520,0,2,7,5,62440,24853,4903,33133,0
254,5829,1482,859,1002,125,135,219,1607,16,219,134,251,235,385,1766,3032,9,27804,1544,1,2,7,5,62450,24854,4903,33134,0
85,2238,773,422,505,30,103,129,803,14,77,46,83,91,129,535,839,7,6334,351,0,2,8,12,62460,24855,4904,33135,0
141,3263,77,34,69,0,0,8,77,3,24,16,29,27,45,114,213,1,387,21,0,2,3,2,62460,24855,4904,33136,0
141,3263,712,438,573,51,9,84,763,14,102,71,128,116,199,733,1364,8,11988,666,0,2,3,2,62470,24856,4904,33137,0
309,6791,72,33,56,0,4,12,72,1,1,1,1,2,2,0,2,0,1,0,0,2,18,19,62470,24856,4904,33138,0
309,6791,1454,835,1044,76,110,219,1530,17,275,158,296,292,454,2297,3718,9,34017,1889,1,2,18,19,62480,24857,4904,33139,0
62,1229,1098,241,925,5,10,155,1103,7,46,25,49,53,74,273,423,3,1580,87,0,2,1,0,62490,24859,4904,33140,0
62,1229,282,202,222,14,2,44,296,8,42,24,43,50,67,250,378,4,1548,86,0,2,1,0,62490,24860,4904,33141,0
23,474,601,196,481,2,23,85,603,8,63,36,72,71,108,400,664,4,3036,168,0,2,8,0,62490,24860,4904,33142,0
23,474,156,79,106,5,16,28,161,5,14,8,15,19,23,64,97,2,261,14,0,2,8,0,62490,24860,4904,33143,0
93,3899,1289,550,1043,56,32,155,1345,10,167,93,185,177,278,1266,2075,5,11498,638,0,2,7,0,62490,24862,4905,33144,0
152,7085,1392,870,1177,35,17,170,1427,14,494,280,531,508,811,4473,7289,7,54850,3047,2,2,45,0,62490,24865,4906,33145,0
2,56,16,12,9,0,0,6,16,1,2,1,2,3,3,2,4,0,2,0,0,0,17,0,62490,24865,4906,33146,0
1,8,127,75,83,2,11,30,129,4,14,7,14,18,21,61,87,2,175,9,0,0,2,0,62490,24865,4906,33147,0
1,8,652,304,544,16,6,88,668,6,89,51,101,95,152,591,998,3,3399,188,0,0,2,0,62490,24866,4906,33148,0
1,8,2,2,2,0,0,0,2,0,0,0,0,0,0,0,0,0,0,0,0,0,2,0,62490,24866,4906,33148,0
1,8,8,5,5,0,0,3,8,0,0,0,0,0,0,0,0,0,0,0,0,0,2,0,62490,24866,4906,33149,0
1,8,2,2,2,0,0,0,2,0,0,0,0,0,0,0,0,0,0,0,0,0,2,0,62490,24866,4906,33149,0
1,8,14,8,8,0,0,6,14,0,0,0,0,0,0,0,0,0,0,0,0,0,2,0,62490,24866,4906,33150,0
1,8,6,4,4,0,0,2,6,0,0,0,0,0,0,0,0,0,0,0,0,0,2,0,62490,24866,4906,33151,0
1,8,6,4,4,0,0,2,6,1,2,1,2,3,3,2,4,0,2,0,0,0,2,0,62490,24866,4906,33152,0
1,8,6,4,4,0,0,2,6,0,0,0,0,0,0,0,0,0,0,0,0,0,2,0,62490,24866,4906,33153,0
1,8,7,5,5,0,0,2,7,0,0,0,0,0,0,0,0,0,0,0,0,0,2,0,62490,24866,4906,33154,0
1,8,6,4,4,0,0,2,6,0,0,0,0,0,0,0,0,0,0,0,0,0,2,0,62490,24866,4906,33155,0
1,8,10,6,6,0,0,4,10,0,0,0,0,0,0,0,0,0,0,0,0,0,2,0,62490,24866,4906,33156,0
1,8,1,1,1,0,0,0,1,0,0,0,0,0,0,0,0,0,0,0,0,0,2,0,62490,24866,4906,33156,0
1,8,14,10,10,0,0,4,14,1,1,1,1,2,2,0,2,0,1,0,0,0,2,0,62490,24866,4906,33157,0
1,8,46,26,30,3,0,12,49,3,6,3,6,9,9,20,28,1,42,2,0,0,2,0,62500,24866,4906,33158,0
1,6,2,2,2,0,0,0,2,0,0,0,0,0,0,0,0,0,0,0,0,0,2,0,62510,24870,4907,33165,0
1,6,2,2,2,0,0,0,2,0,0,0,0,0,0,0,0,0,0,0,0,0,2,0,62520,24871,4907,33177,0
31,2079,1157,318,931,29,22,177,1186,6,104,63,125,110,188,712,1274,3,4596,255,0,2,7,9,62520,24871,4907,33178,0
100,4602,1338,495,1086,10,64,173,1348,11,122,82,157,133,239,883,1686,7,11934,663,0,2,46,0,62520,24873,4907,33179,0
126,5153,1513,682,1277,25,13,200,1538,11,199,116,219,210,335,1557,2584,6,15641,868,0,2,31,0,62520,24875,4907,33180,0
73,3830,1296,573,1062,40,33,157,1336,8,201,118,231,209,349,1561,2689,4,12365,686,0,2,9,2,62520,24875,4907,33181,0
19,437,207,111,150,11,0,50,218,5,26,19,36,31,55,133,272,3,943,52,0,2,31,1,62520,24875,4907,33182,0
88,4633,1457,730,1242,11,6,188,1468,10,292,166,329,302,495,2424,4078,5,22973,1276,1,2,18,0,62520,24877,4907,33183,0
50,1879,1098,241,925,5,10,155,1103,7,46,25,49,53,74,273,423,3,1580,87,0,2,21,0,62530,24879,4907,33184,0
20,707,601,196,481,2,23,85,603,8,63,36,72,71,108,400,664,4,3036,168,0,2,15,0,62530,24879,4907,33185,0
215,4676,182,127,129,0,0,53,182,5,39,21,42,44,63,217,343,2,926,51,0,2,3,1,62530,24879,4908,33186,0
215,4676,1165,710,800,67,119,181,1232,18,243,153,282,261,435,2000,3492,10,36473,2026,1,2,3,1,62540,24879,4909,33187,0
149,3116,1513,682,1277,25,13,200,1538,11,199,116,219,210,335,1557,2584,6,15641,868,0,2,30,7,62540,24881,4909,33188,0
149,3116,819,519,539,24,98,155,843,15,96,57,106,111,163,690,1107,8,9171,509,0,2,30,7,62550,24883,4909,33189,0
66,1312,207,111,150,11,0,50,218,5,26,19,36,31,55,133,272,3,943,52,0,2,27,0,62550,24883,4909,33190,0
66,1312,410,198,237,31,55,97,441,11,63,38,72,74,110,414,683,6,4293,238,0,2,27,0,62560,24884,4910,33191,0
214,4585,2,2,2,0,0,0,2,0,0,0,0,0,0,0,0,0,0,0,0,2,5,0,62560,24884,4910,33191,0
214,4585,99,48,90,1,3,5,100,0,0,0,0,0,0,0,0,0,0,0,0,2,5,0,62560,24885,4910,33192,0
214,4585,8,5,5,2,0,1,10,0,0,0,0,0,0,0,0,0,0,0,0,2,5,0,62560,24885,4910,33193,0
214,4585,1217,716,841,84,126,174,1301,14,185,118,215,199,333,1446,2542,8,20687,1149,0,2,5,0,62570,24887,4910,33194,0
214,4585,160,89,115,0,13,31,160,7,15,11,17,22,28,78,124,3,495,27,0,2,5,0,62570,24887,4910,33195,0
214,4585,10,10,9,9,0,0,19,0,0,0,0,0,0,0,0,0,0,0,0,2,5,0,62570,24887,4911,33196,0
214,4585,173,84,99,8,29,36,181,5,12,7,13,17,20,54,81,2,221,12,0,2,5,0,62570,24888,4911,33197,0
214,4585,3,1,1,3,0,0,6,0,0,0,0,0,0,0,0,0,0,0,0,2,5,0,62570,24888,4911,33198,0
94,1909,463,295,324,28,62,57,491,12,134,82,154,146,236,989,1696,6,11700,650,0,2,7,7,62580,24889,4911,33199,0
254,5829,4293,999,3693,19,54,507,4312,9,155,88,170,164,258,1156,1898,4,9368,520,0,2,7,5,62580,24891,4911,33200,0
254,5829,1482,859,1002,125,135,219,1607,16,219,134,251,235,385,1766,3032,9,27804,1544,1,2,7,5,62590,24892,4911,33201,0
85,2238,773,422,505,30,103,129,803,14,77,46,83,91,129,535,839,7,6334,351,0,2,8,12,62600,24893,4912,33202,0
141,3263,77,34,69,0,0,8,77,3,24,16,29,27,45,114,213,1,387,21,0,2,3,2,62600,24893,4912,33203,0
141,3263,712,438,573,51,9,84,763,14,102,71,128,116,199,733,1364,8,11988,666,0,2,3,2,62610,24894,4912,33204,0
309,6791,72,33,56,0,4,12,72,1,1,1,1,2,2,0,2,0,1,0,0,2,18,19,62610,24894,4912,33205,0
309,6791,1454,835,1044,76,110,219,1530,17,275,158,296,292,454,2297,3718,9,34017,1889,1,2,18,19,62620,24895,4912,33206,0
62,1229,1098,241,925,5,10,155,1103,7,46,25,49,53,74,273,423,3,1580,87,0,2,1,0,62630,24897,4912,33207,0
62,1229,282,202,222,14,2,44,296,8,42,24,43,50,67,250,378,4,1548,86,0,2,1,0,62630,24898,4912,33208,0
23,474,601,196,481,2,23,85,603,8,63,36,72,71,108,400,664,4,3036,168,0,2,8,0,62630,24898,4912,33209,0
23,474,156,79,106,5,16,28,161,5,14,8,15,19,23,64,97,2,261,14,0,2,8,0,62630,24898,4912,33210,0
93,3899,1289,550,1043,56,32,155,1345,10,167,93,185,177,278,1266,2075,5,11498,638,0,2,7,0,62630,24900,4913,33211,0
152,7085,1392,870,1177,35,17,170,1427,14,494,280,531,508,811,4473,7289,7,54850,3047,2,2,45,0,62630,24903,4914,33212,0
2,56,16,12,9,0,0,6,16,1,2,1,2,3,3,2,4,0,2,0,0,0,17,0,62630,24903,4914,33213,0
1,8,127,75,83,2,11,30,129,4,14,7,14,18,21,61,87,2,175,9,0,0,2,0,62630,24903,4914,33214,0
1,8,652,304,544,16,6,88,668,6,89,51,101,95,152,591,998,3,3399,188,0,0,2,0,62630,24904,4914,33215,0
1,8,2,2,2,0,0,0,2,0,0,0,0,0,0,0,0,0,0,0,0,0,2,0,62630,24904,4914,33215,0
1,8,8,5,5,0,0,3,8,0,0,0,0,0,0,0,0,0,0,0,0,0,2,0,62630,24904,4914,33216,0
1,8,2,2,2,0,0,0,2,0,0,0,0,0,0,0,0,0,0,0,0,0,2,0,62630,24904,4914,33216,0
1,8,14,8,8,0,0,6,14,0,0,0,0,0,0,0,0,0,0,0,0,0,2,0,62630,24904,4914,33217,0
1,8,6,4,4,0,0,2,6,0,0,0,0,0,0,0,0,0,0,0,0,0,2,0,62630,24904,4914,33218,0
1,8,6,4,4,0,0,2,6,1,2,1,2,3,3,2,4,0,2,0,0,0,2,0,62630,24904,4914,33219,0
1,8,6,4,4,0,0,2,6,0,0,0,0,0,0,0,0,0,0,0,0,0,2,0,62630,24904,4914,33220,0
1,8,7,5,5,0,0,2,7,0,0,0,0,0,0,0,0,0,0,0,0,0,2,0,62630,24904,4914,33221,0
1,8,6,4,4,0,0,2,6,0,0,0,0,0,0,0,0,0,0,0,0,0,2,0,62630,24904,4914,33222,0
1,8,10,6,6,0,0,4,10,0,0,0,0,0,0,0,0,0,0,0,0,0,2,0,62630,24904,4914,33223,0
1,8,1,1,1,0,0,0,1,0,0,0,0,0,0,0,0,0,0,0,0,0,2,0,62630,24904,4914,33223,0
1,8,14,10,10,0,0,4,14,1,1,1,1,2,2,0,2,0,1,0,0,0,2,0,62630,24904,4914,33224,0
1,8,46,26,30,3,0,12,49,3,6,3,6,9,9,20,28,1,42,2,0,0,2,0,62640,24904,4914,33225,0
1,6,2,2,2,0,0,0,2,0,0,0,0,0,0,0,0,0,0,0,0,0,2,0,62650,24908,4915,33232,0
1,6,2,2,2,0,0,0,2,0,0,0,0,0,0,0,0,0,0,0,0,0,2,0,62660,24909,4915,33244,0
31,2079,1157,318,931,29,22,177,1186,6,104,63,125,110,188,712,1274,3,4596,255,0,2,7,9,62660,24909,4915,33245,0
100,4602,1338,495,1086,10,64,173,1348,11,122,82,157,133,239,883,1686,7,11934,663,0,2,46,0,62660,24911,4915,33246,0
126,5153,1513,682,1277,25,13,200,1538,11,199,116,219,210,335,1557,2584,6,15641,868,0,2,31,0,62660,24913,4915,33247,0
73,3830,1296,573,1062,40,33,157,1336,8,201,118,231,209,349,1561,2689,4,12365,686,0,2,9,2,62660,24913,4915,33248,0
19,437,207,111,150,11,0,50,218,5,26,19,36,31,55,133,272,3,943,52,0,2,31,1,62660,24913,4915,33249,0
88,4633,1457,730,1242,11,6,188,1468,10,292,166,329,302,495,2424,4078,5,22973,1276,1,2,18,0,62660,24915,4915,33250,0
50,1879,1098,241,925,5,10,155,1103,7,46,25,49,53,74,273,423,3,1580,87,0,2,21,0,62670,24917,4915,33251,0
20,707,601,196,481,2,23,85,603,8,63,36,72,71,108,400,664,4,3036,168,0,2,15,0,62670,24917,4915,33252,0
155,3182,1513,682,1277,25,13,200,1538,11,199,116,219,210,335,1557,2584,6,15641,868,0,2,77,58,62670,24919,4915,33253,1
155,3182,819,519,539,24,98,155,843,15,96,57,106,111,163,690,1107,8,9171,509,0,2,77,58,62680,24921,4915,33254,1
126,5159,1513,682,1277,25,13,200,1538,11,199,116,219,210,335,1557,2584,6,15641,868,0,2,33,4,62680,24923,4915,33255,0
126,5221,1513,682,1277,25,13,200,1538,11,199,116,219,210,335,1557,2584,6,15641,868,0,2,24,14,62680,24925,4915,33256,0
154,3165,1513,682,1277,25,13,200,1538,11,199,116,219,210,335,1557,2584,6,15641,868,0,2,4,6,62680,24927,4915,33257,0
154,3165,819,519,539,24,98,155,843,15,96,57,106,111,163,690,1107,8,9171,509,0,2,4,6,62690,24929,4915,33258,0
34,1000,339,213,244,17,9,65,356,10,42,26,48,52,74,259,421,5,2410,133,0,2,2,1,62700,24929,4915,33259,0
20,416,294,64,250,0,0,43,294,1,20,10,20,21,30,86,131,0,65,3,0,2,2,1,62700,24929,4915,33260,0
20,416,78,46,62,3,0,14,81,3,8,4,8,11,12,28,41,1,62,3,0,2,2,1,62700,24930,4915,33261,0
31,2071,1157,318,931,29,22,177,1186,6,104,63,125,110,188,712,1274,3,4596,255,0,2,0,4,62700,24930,4915,33262,0
126,5241,1513,682,1277,25,13,200,1538,11,199,116,219,210,335,1557,2584,6,15641,868,0,2,8,4,62700,24932,4915,33263,0
154,3163,1513,682,1277,25,13,200,1538,11,199,116,219,210,335,1557,2584,6,15641,868,0,2,1,2,62700,24934,4915,33264,0
154,3163,819,519,539,24,98,155,843,15,96,57,106,111,163,690,1107,8,9171,509,0,2,1,2,62710,24936,4915,33265,0
31,2065,1157,318,931,29,22,177,1186,6,104,63,125,110,188,712,1274,3,4596,255,0,2,0,1,62710,24936,4915,33266,0
126,5241,1513,682,1277,25,13,200,1538,11,199,116,219,210,335,1557,2584,6,15641,868,0,2,5,3,62710,24938,4915,33267,0
236,5565,722,423,573,19,0,135,741,12,172,101,199,184,300,1320,2257,6,15668,870,0,2,12,8,62710,24940,4915,33269,0
236,5565,1508,847,911,44,250,301,1552,14,148,88,169,162,257,1120,1886,7,15077,837,0,2,12,8,62710,24941,4916,33270,0
236,5605,722,423,573,19,0,135,741,12,172,101,199,184,300,1320,2257,6,15668,870,0,2,14,4,62710,24943,4916,33272,1
236,5605,1508,847,911,44,250,301,1552,14,148,88,169,162,257,1120,1886,7,15077,837,0,2,14,4,62710,24944,4917,33273,1
49,2332,722,423,573,19,0,135,741,12,172,101,199,184,300,1320,2257,6,15668,870,0,2,51,0,62710,24946,4917,33275,1
236,5565,722,423,573,19,0,135,741,12,172,101,199,184,300,1320,2257,6,15668,870,0,2,12,8,62710,24948,4917,33277,0
236,5565,1508,847,911,44,250,301,1552,14,148,88,169,162,257,1120,1886,7,15077,837,0,2,12,8,62710,24949,4918,33278,0
127,5289,1513,682,1277,25,13,200,1538,11,199,116,219,210,335,1557,2584,6,15641,868,0,2,36,16,62710,24951,4918,33279,0
154,3163,1513,682,1277,25,13,200,1538,11,199,116,219,210,335,1557,2584,6,15641,868,0,2,4,4,62710,24953,4918,33280,1
154,3163,819,519,539,24,98,155,843,15,96,57,106,111,163,690,1107,8,9171,509,0,2,4,4,62720,24955,4918,33281,1
34,1000,339,213,244,17,9,65,356,10,42,26,48,52,74,259,421,5,2410,133,0,2,1,1,62730,24955,4918,33282,1
20,416,294,64,250,0,0,43,294,1,20,10,20,21,30,86,131,0,65,3,0,2,1,1,62730,24955,4918,33283,1
20,416,78,46,62,3,0,14,81,3,8,4,8,11,12,28,41,1,62,3,0,2,1,1,62730,24956,4918,33284,1
127,5289,1513,682,1277,25,13,200,1538,11,199,116,219,210,335,1557,2584,6,15641,868,0,2,4,4,62730,24958,4918,33285,1
149,3215,1513,682,1277,25,13,200,1538,11,199,116,219,210,335,1557,2584,6,15641,868,0,2,27,8,62730,24960,4918,33286,0
149,3215,819,519,539,24,98,155,843,15,96,57,106,111,163,690,1107,8,9171,509,0,2,27,8,62740,24962,4918,33287,0
127,5207,1513,682,1277,25,13,200,1538,11,199,116,219,210,335,1557,2584,6,15641,868,0,2,28,0,62740,24964,4918,33288,0
212,4578,1943,715,1694,26,18,214,1969,12,185,120,237,197,357,1436,2721,7,20915,1161,0,2,5,0,62740,24966,4918,33289,0
212,4578,1168,838,957,57,25,144,1225,19,348,224,416,367,640,3018,5452,11,61921,3440,1,2,5,0,62750,24968,4918,33290,0
92,4733,1943,715,1694,26,18,214,1969,12,185,120,237,197,357,1436,2721,7,20915,1161,0,2,40,0,62750,24970,4918,33291,0
236,5605,722,423,573,19,0,135,741,12,172,101,199,184,300,1320,2257,6,15668,870,0,2,14,4,62750,24972,4918,33293,0
236,5605,1508,847,911,44,250,301,1552,14,148,88,169,162,257,1120,1886,7,15077,837,0,2,14,4,62750,24973,4919,33294,0
49,2332,722,423,573,19,0,135,741,12,172,101,199,184,300,1320,2257,6,15668,870,0,2,51,0,62750,24975,4919,33296,0
154,3262,1513,682,1277,25,13,200,1538,11,199,116,219,210,335,1557,2584,6,15641,868,0,2,73,57,62750,24977,4919,33297,0
154,3262,819,519,539,24,98,155,843,15,96,57,106,111,163,690,1107,8,9171,509,0,2,73,57,62760,24979,4919,33298,0
34,1000,339,213,244,17,9,65,356,10,42,26,48,52,74,259,421,5,2410,133,0,2,2,1,62770,24979,4919,33299,0
20,416,294,64,250,0,0,43,294,1,20,10,20,21,30,86,131,0,65,3,0,2,2,1,62770,24979,4919,33300,0
20,416,78,46,62,3,0,14,81,3,8,4,8,11,12,28,41,1,62,3,0,2,2,1,62770,24980,4919,33301,0
31,2065,1157,318,931,29,22,177,1186,6,104,63,125,110,188,712,1274,3,4596,255,0,2,0,5,62770,24980,4919,33302,0
128,5343,1513,682,1277,25,13,200,1538,11,199,116,219,210,335,1557,2584,6,15641,868,0,2,77,12,62770,24982,4919,33303,0
141,3269,77,34,69,0,0,8,77,3,24,16,29,27,45,114,213,1,387,21,0,2,4,3,62770,24982,4919,33304,0
141,3269,712,438,573,51,9,84,763,14,102,71,128,116,199,733,1364,8,11988,666,0,2,4,3,62780,24983,4919,33305,0
94,3940,1289,550,1043,56,32,155,1345,10,167,93,185,177,278,1266,2075,5,11498,638,0,2,10,0,62780,24985,4920,33306,0
212,4578,1943,715,1694,26,18,214,1969,12,185,120,237,197,357,1436,2721,7,20915,1161,0,2,5,0,62780,24987,4920,33307,0
212,4578,1168,838,957,57,25,144,1225,19,348,224,416,367,640,3018,5452,11,61921,3440,1,2,5,0,62790,24989,4920,33308,0
92,4733,1943,715,1694,26,18,214,1969,12,185,120,237,197,357,1436,2721,7,20915,1161,0,2,40,0,62790,24991,4920,33309,0
235,5544,722,423,573,19,0,135,741,12,172,101,199,184,300,1320,2257,6,15668,870,0,2,12,14,62790,24993,4920,33311,0
235,5544,1508,847,911,44,250,301,1552,14,148,88,169,162,257,1120,1886,7,15077,837,0,2,12,14,62790,24994,4921,33312,0
141,3269,77,34,69,0,0,8,77,3,24,16,29,27,45,114,213,1,387,21,0,2,4,3,62790,24994,4921,33313,0
141,3269,712,438,573,51,9,84,763,14,102,71,128,116,199,733,1364,8,11988,666,0,2,4,3,62800,24995,4921,33314,0
94,3940,1289,550,1043,56,32,155,1345,10,167,93,185,177,278,1266,2075,5,11498,638,0,2,10,0,62800,24997,4922,33315,0
47,2258,722,423,573,19,0,135,741,12,172,101,199,184,300,1320,2257,6,15668,870,0,2,6,1,62800,24999,4922,33317,1
47,2258,722,423,573,19,0,135,741,12,172,101,199,184,300,1320,2257,6,15668,870,0,2,1,1,62800,25001,4922,33319,0
96,1940,463,295,324,28,62,57,491,12,134,82,154,146,236,989,1696,6,11700,650,0,2,5,2,62810,25002,4922,33320,1
2,67,16,12,9,0,0,6,16,1,2,1,2,3,3,2,4,0,2,0,0,2,4,1,62810,25002,4922,33321,0
4,77,127,75,83,2,11,30,129,4,14,7,14,18,21,61,87,2,175,9,0,2,1,1,62810,25002,4922,33322,1
4,77,652,304,544,16,6,88,668,6,89,51,101,95,152,591,998,3,3399,188,0,2,1,1,62810,25003,4922,33323,1
4,77,2,2,2,0,0,0,2,0,0,0,0,0,0,0,0,0,0,0,0,2,1,1,62810,25003,4922,33323,1
4,77,8,5,5,0,0,3,8,0,0,0,0,0,0,0,0,0,0,0,0,2,1,1,62810,25003,4922,33324,1
4,77,2,2,2,0,0,0,2,0,0,0,0,0,0,0,0,0,0,0,0,2,1,1,62810,25003,4922,33324,1
4,77,14,8,8,0,0,6,14,0,0,0,0,0,0,0,0,0,0,0,0,2,1,1,62810,25003,4922,33325,1
4,77,6,4,4,0,0,2,6,0,0,0,0,0,0,0,0,0,0,0,0,2,1,1,62810,25003,4922,33326,1
4,77,6,4,4,0,0,2,6,1,2,1,2,3,3,2,4,0,2,0,0,2,1,1,62810,25003,4922,33327,1
4,77,6,4,4,0,0,2,6,0,0,0,0,0,0,0,0,0,0,0,0,2,1,1,62810,25003,4922,33328,1
4,77,7,5,5,0,0,2,7,0,0,0,0,0,0,0,0,0,0,0,0,2,1,1,62810,25003,4922,33329,1
4,77,6,4,4,0,0,2,6,0,0,0,0,0,0,0,0,0,0,0,0,2,1,1,62810,25003,4922,33330,1
4,77,10,6,6,0,0,4,10,0,0,0,0,0,0,0,0,0,0,0,0,2,1,1,62810,25003,4922,33331,1
4,77,1,1,1,0,0,0,1,0,0,0,0,0,0,0,0,0,0,0,0,2,1,1,62810,25003,4922,33331,1
4,77,14,10,10,0,0,4,14,1,1,1,1,2,2,0,2,0,1,0,0,2,1,1,62810,25003,4922,33332,1
4,77,46,26,30,3,0,12,49,3,6,3,6,9,9,20,28,1,42,2,0,2,1,1,62820,25003,4922,33333,1
7,296,72,33,56,0,4,12,72,1,1,1,1,2,2,0,2,0,1,0,0,2,26,23,62820,25003,4922,33334,1
94,3942,1289,550,1043,56,32,155,1345,10,167,93,185,177,278,1266,2075,5,11498,638,0,2,3,3,62820,25005,4923,33335,1
152,7086,1392,870,1177,35,17,170,1427,14,494,280,531,508,811,4473,7289,7,54850,3047,2,2,1,1,62820,25008,4924,33336,1
23,579,102,59,69,5,3,24,107,6,22,15,28,28,43,113,206,3,789,43,0,2,1,1,62820,25008,4924,33337,1
155,4397,1660,832,1314,41,38,274,1701,20,312,209,395,332,604,2671,5058,12,64042,3557,1,2,1,1,62820,25010,4925,33339,1
8,271,74,35,59,1,0,14,75,3,14,7,14,17,21,58,85,1,128,7,0,2,3,1,62820,25011,4925,33340,1
38,2302,334,251,279,10,4,40,344,5,127,74,143,132,217,899,1528,2,4303,239,0,2,1,1,62820,25012,4925,33341,1
61,2733,1293,570,1093,25,15,163,1318,10,195,123,241,205,364,1516,2795,6,17273,959,0,2,4,2,62830,25014,4925,33342,1
92,4735,1943,715,1694,26,18,214,1969,12,185,120,237,197,357,1436,2721,7,20915,1161,0,2,2,2,62830,25016,4925,33343,1
215,4676,182,127,129,0,0,53,182,5,39,21,42,44,63,217,343,2,926,51,0,2,3,1,62830,25016,4926,33344,0
215,4676,1165,710,800,67,119,181,1232,18,243,153,282,261,435,2000,3492,10,36473,2026,1,2,3,1,62840,25016,4927,33345,0
154,3262,1513,682,1277,25,13,200,1538,11,199,116,219,210,335,1557,2584,6,15641,868,0,2,108,50,62840,25018,4927,33346,0
154,3262,819,519,539,24,98,155,843,15,96,57,106,111,163,690,1107,8,9171,509,0,2,108,50,62850,25020,4927,33347,0
66,1312,207,111,150,11,0,50,218,5,26,19,36,31,55,133,272,3,943,52,0,2,8,0,62850,25020,4927,33348,0
66,1312,410,198,237,31,55,97,441,11,63,38,72,74,110,414,683,6,4293,238,0,2,8,0,62860,25021,4928,33349,0
94,1909,463,295,324,28,62,57,491,12,134,82,154,146,236,989,1696,6,11700,650,0,2,7,7,62870,25022,4928,33350,0
34,1000,339,213,244,17,9,65,356,10,42,26,48,52,74,259,421,5,2410,133,0,2,2,1,62880,25022,4928,33351,0
254,5829,4293,999,3693,19,54,507,4312,9,155,88,170,164,258,1156,1898,4,9368,520,0,2,2,2,62880,25024,4928,33352,0
254,5829,1482,859,1002,125,135,219,1607,16,219,134,251,235,385,1766,3032,9,27804,1544,1,2,2,2,62890,25025,4928,33353,0
85,2238,773,422,505,30,103,129,803,14,77,46,83,91,129,535,839,7,6334,351,0,2,8,12,62900,25026,4929,33354,0
141,3269,77,34,69,0,0,8,77,3,24,16,29,27,45,114,213,1,387,21,0,2,7,5,62900,25026,4929,33355,0
141,3269,712,438,573,51,9,84,763,14,102,71,128,116,199,733,1364,8,11988,666,0,2,7,5,62910,25027,4929,33356,0
236,5565,722,423,573,19,0,135,741,12,172,101,199,184,300,1320,2257,6,15668,870,0,2,12,8,62910,25029,4929,33358,0
236,5565,1508,847,911,44,250,301,1552,14,148,88,169,162,257,1120,1886,7,15077,837,0,2,12,8,62910,25030,4930,33359,0
309,6803,72,33,56,0,4,12,72,1,1,1,1,2,2,0,2,0,1,0,0,2,12,16,62910,25030,4930,33360,0
309,6803,1454,835,1044,76,110,219,1530,17,275,158,296,292,454,2297,3718,9,34017,1889,1,2,12,16,62920,25031,4930,33361,0
20,416,294,64,250,0,0,43,294,1,20,10,20,21,30,86,131,0,65,3,0,2,2,1,62920,25031,4930,33362,0
20,416,78,46,62,3,0,14,81,3,8,4,8,11,12,28,41,1,62,3,0,2,2,1,62920,25032,4930,33363,0
212,4578,1943,715,1694,26,18,214,1969,12,185,120,237,197,357,1436,2721,7,20915,1161,0,2,5,0,62920,25034,4930,33364,0
212,4578,1168,838,957,57,25,144,1225,19,348,224,416,367,640,3018,5452,11,61921,3440,1,2,5,0,62930,25036,4930,33365,0
23,474,601,196,481,2,23,85,603,8,63,36,72,71,108,400,664,4,3036,168,0,2,8,0,62930,25036,4930,33366,0
23,474,156,79,106,5,16,28,161,5,14,8,15,19,23,64,97,2,261,14,0,2,8,0,62930,25036,4930,33367,0
94,3940,1289,550,1043,56,32,155,1345,10,167,93,185,177,278,1266,2075,5,11498,638,0,2,10,0,62930,25038,4931,33368,0
152,7085,1392,870,1177,35,17,170,1427,14,494,280,531,508,811,4473,7289,7,54850,3047,2,2,45,0,62930,25041,4932,33369,0
31,2065,1157,318,931,29,22,177,1186,6,104,63,125,110,188,712,1274,3,4596,255,0,2,7,14,62930,25041,4932,33370,0
100,4602,1338,495,1086,10,64,173,1348,11,122,82,157,133,239,883,1686,7,11934,663,0,2,40,0,62930,25043,4932,33371,0
128,5343,1513,682,1277,25,13,200,1538,11,199,116,219,210,335,1557,2584,6,15641,868,0,2,128,4,62930,25045,4932,33372,0
73,3830,1296,573,1062,40,33,157,1336,8,201,118,231,209,349,1561,2689,4,12365,686,0,2,9,2,62930,25045,4932,33373,0
92,4733,1943,715,1694,26,18,214,1969,12,185,120,237,197,357,1436,2721,7,20915,1161,0,2,40,0,62930,25047,4932,33374,0
20,707,601,196,481,2,23,85,603,8,63,36,72,71,108,400,664,4,3036,168,0,2,15,0,62930,25047,4932,33375,0
312,6826,72,33,56,0,4,12,72,1,1,1,1,2,2,0,2,0,1,0,0,2,10,5,62930,25047,4932,33376,0
312,6826,1454,835,1044,76,110,219,1530,17,275,158,296,292,454,2297,3718,9,34017,1889,1,2,10,5,62940,25048,4932,33377,0
101,4715,1338,495,1086,10,64,173,1348,11,122,82,157,133,239,883,1686,7,11934,663,0,2,37,0,62940,25050,4932,33378,0
20,507,205,80,86,16,53,53,221,7,18,10,19,25,29,94,134,3,497,27,0,2,1,2,62950,25050,4933,33379,1
309,6789,72,33,56,0,4,12,72,1,1,1,1,2,2,0,2,0,1,0,0,2,1,1,62950,25050,4933,33380,1
309,6789,1454,835,1044,76,110,219,1530,17,275,158,296,292,454,2297,3718,9,34017,1889,1,2,1,1,62960,25051,4933,33381,1
36,1070,182,127,129,0,0,53,182,5,39,21,42,44,63,217,343,2,926,51,0,2,2,3,62960,25051,4934,33382,1
152,7069,1392,870,1177,35,17,170,1427,14,494,280,531,508,811,4473,7289,7,54850,3047,2,2,4,3,62960,25054,4935,33383,1
139,5902,1782,648,1425,9,47,279,1791,8,171,97,189,179,286,1292,2140,4,9462,525,0,2,2,6,62960,25055,4936,33384,1
111,4132,1450,624,1228,12,26,181,1462,14,306,186,354,320,540,2580,4493,8,36391,2021,1,2,6,6,62960,25057,4937,33385,1
155,4385,1660,832,1314,41,38,274,1701,20,312,209,395,332,604,2671,5058,12,64042,3557,1,2,2,4,62960,25059,4938,33387,1
128,5327,1513,682,1277,25,13,200,1538,11,199,116,219,210,335,1557,2584,6,15641,868,0,2,4,3,62960,25061,4938,33388,1
95,4632,1523,757,1297,19,12,193,1542,12,193,117,230,205,347,1508,2664,7,19053,1058,0,2,1,1,62970,25063,4938,33389,1
60,1079,282,196,195,3,0,86,285,8,130,71,141,138,212,936,1507,4,6538,363,0,2,2,2,62970,25063,4939,33390,0
215,4676,182,127,129,0,0,53,182,5,39,21,42,44,63,217,343,2,926,51,0,2,2,1,62970,25063,4940,33391,0
215,4676,1165,710,800,67,119,181,1232,18,243,153,282,261,435,2000,3492,10,36473,2026,1,2,2,1,62980,25063,4941,33392,0
164,5053,1660,832,1314,41,38,274,1701,20,312,209,395,332,604,2671,5058,12,64042,3557,1,2,1,1,62980,25065,4942,33394,0
164,5053,1057,646,719,113,100,145,1170,18,215,134,248,233,382,1740,3004,10,31186,1732,1,2,1,1,62990,25066,4943,33395,0
91,1828,757,253,292,73,244,162,830,13,61,38,67,74,105,409,651,7,4654,258,0,2,3,3,62990,25067,4943,33396,0
46,952,386,256,301,16,9,68,402,4,59,35,69,63,104,355,621,2,1453,80,0,2,3,3,62990,25067,4943,33397,0
46,952,264,131,164,11,41,46,275,6,38,22,40,44,62,214,338,3,1068,59,0,2,3,3,63000,25067,4944,33398,0
92,2955,773,419,590,28,0,166,801,10,204,113,217,214,330,1598,2554,5,13587,754,0,2,3,3,63000,25067,4945,33399,0
155,4385,1660,832,1314,41,38,274,1701,20,312,209,395,332,604,2671,5058,12,64042,3557,1,2,2,1,63000,25069,4946,33401,0
111,4132,1450,624,1228,12,26,181,1462,14,306,186,354,320,540,2580,4493,8,36391,2021,1,2,2,1,63000,25071,4947,33402,0
254,5825,4293,999,3693,19,54,507,4312,9,155,88,170,164,258,1156,1898,4,9368,520,0,2,2,2,63000,25073,4947,33403,0
254,5825,1482,859,1002,125,135,219,1607,16,219,134,251,235,385,1766,3032,9,27804,1544,1,2,2,2,63010,25074,4947,33404,0
90,1921,1043,504,840,53,9,147,1096,9,180,112,198,189,310,1377,2344,4,11604,644,0,2,4,4,63010,25076,4947,33405,0
90,1921,383,288,292,26,6,62,409,11,65,38,67,76,105,429,656,5,3719,206,0,2,4,4,63010,25077,4947,33406,0
152,7067,1392,870,1177,35,17,170,1427,14,494,280,531,508,811,4473,7289,7,54850,3047,2,2,1,1,63010,25080,4948,33407,0
60,1079,282,196,195,3,0,86,285,8,130,71,141,138,212,936,1507,4,6538,363,0,2,2,2,63010,25080,4949,33408,0
215,4676,182,127,129,0,0,53,182,5,39,21,42,44,63,217,343,2,926,51,0,2,2,1,63010,25080,4950,33409,0
215,4676,1165,710,800,67,119,181,1232,18,243,153,282,261,435,2000,3492,10,36473,2026,1,2,2,1,63020,25080,4951,33410,0
164,5053,1660,832,1314,41,38,274,1701,20,312,209,395,332,604,2671,5058,12,64042,3557,1,2,1,1,63020,25082,4952,33412,0
164,5053,1057,646,719,113,100,145,1170,18,215,134,248,233,382,1740,3004,10,31186,1732,1,2,1,1,63030,25083,4953,33413,0
254,5825,4293,999,3693,19,54,507,4312,9,155,88,170,164,258,1156,1898,4,9368,520,0,2,2,2,63030,25085,4953,33414,0
254,5825,1482,859,1002,125,135,219,1607,16,219,134,251,235,385,1766,3032,9,27804,1544,1,2,2,2,63040,25086,4953,33415,0
20,507,205,80,86,16,53,53,221,7,18,10,19,25,29,94,134,3,497,27,0,2,1,2,63050,25086,4954,33416,0
309,6789,72,33,56,0,4,12,72,1,1,1,1,2,2,0,2,0,1,0,0,2,1,1,63050,25086,4954,33417,0
309,6789,1454,835,1044,76,110,219,1530,17,275,158,296,292,454,2297,3718,9,34017,1889,1,2,1,1,63060,25087,4954,33418,0
91,1828,757,253,292,73,244,162,830,13,61,38,67,74,105,409,651,7,4654,258,0,2,3,3,63060,25088,4954,33419,0
46,952,386,256,301,16,9,68,402,4,59,35,69,63,104,355,621,2,1453,80,0,2,3,3,63060,25088,4954,33420,0
46,952,264,131,164,11,41,46,275,6,38,22,40,44,62,214,338,3,1068,59,0,2,3,3,63070,25088,4955,33421,0
90,1921,1043,504,840,53,9,147,1096,9,180,112,198,189,310,1377,2344,4,11604,644,0,2,4,4,63070,25090,4955,33422,0
90,1921,383,288,292,26,6,62,409,11,65,38,67,76,105,429,656,5,3719,206,0,2,4,4,63070,25091,4955,33423,0
36,1070,182,127,129,0,0,53,182,5,39,21,42,44,63,217,343,2,926,51,0,2,2,3,63070,25091,4956,33424,0
152,7067,1392,870,1177,35,17,170,1427,14,494,280,531,508,811,4473,7289,7,54850,3047,2,2,5,4,63070,25094,4957,33425,0
92,2955,773,419,590,28,0,166,801,10,204,113,217,214,330,1598,2554,5,13587,754,0,2,3,3,63070,25094,4958,33426,0
139,5902,1782,648,1425,9,47,279,1791,8,171,97,189,179,286,1292,2140,4,9462,525,0,2,2,6,63070,25095,4959,33427,0
111,4132,1450,624,1228,12,26,181,1462,14,306,186,354,320,540,2580,4493,8,36391,2021,1,2,8,7,63070,25097,4960,33428,0
155,4385,1660,832,1314,41,38,274,1701,20,312,209,395,332,604,2671,5058,12,64042,3557,1,2,4,5,63070,25099,4961,33430,0
128,5327,1513,682,1277,25,13,200,1538,11,199,116,219,210,335,1557,2584,6,15641,868,0,2,4,3,63070,25101,4961,33431,0
95,4632,1523,757,1297,19,12,193,1542,12,193,117,230,205,347,1508,2664,7,19053,1058,0,2,1,1,63080,25103,4961,33432,0
94,3936,1289,550,1043,56,32,155,1345,10,167,93,185,177,278,1266,2075,5,11498,638,0,2,10,10,63080,25105,4962,33433,0
35,1052,182,127,129,0,0,53,182,5,39,21,42,44,63,217,343,2,926,51,0,2,3,6,63080,25105,4963,33434,0
152,7065,1392,870,1177,35,17,170,1427,14,494,280,531,508,811,4473,7289,7,54850,3047,2,2,4,4,63080,25108,4964,33435,0
100,4589,1338,495,1086,10,64,173,1348,11,122,82,157,133,239,883,1686,7,11934,663,0,2,69,68,63080,25110,4964,33436,0
176,7684,139,89,101,2,0,35,141,7,54,34,62,61,96,330,569,4,2287,127,0,2,217,219,63080,25110,4964,33437,0
176,7684,7,5,5,0,0,2,7,1,2,1,2,3,3,2,4,0,2,0,0,2,217,219,63080,25110,4964,33438,0
139,5896,1782,648,1425,9,47,279,1791,8,171,97,189,179,286,1292,2140,4,9462,525,0,2,9,9,63080,25111,4965,33439,0
155,4383,1660,832,1314,41,38,274,1701,20,312,209,395,332,604,2671,5058,12,64042,3557,1,2,7,7,63080,25113,4966,33441,0
40,3016,996,429,845,24,10,117,1020,7,76,50,88,83,138,494,879,4,3565,198,0,2,36,36,63080,25115,4966,33442,0
128,5326,1513,682,1277,25,13,200,1538,11,199,116,219,210,335,1557,2584,6,15641,868,0,2,48,47,63080,25117,4966,33443,0
73,3826,1296,573,1062,40,33,157,1336,8,201,118,231,209,349,1561,2689,4,12365,686,0,2,7,7,63080,25117,4966,33444,0
86,4499,1457,730,1242,11,6,188,1468,10,292,166,329,302,495,2424,4078,5,22973,1276,1,2,18,18,63080,25119,4966,33445,0
39,2317,652,304,544,16,6,88,668,6,89,51,101,95,152,591,998,3,3399,188,0,2,93,96,63080,25120,4966,33446,0
70,3204,1455,414,1257,16,76,112,1471,5,41,23,46,46,69,231,381,2,1069,59,0,2,24,24,63080,25121,4966,33447,0
92,4727,1943,715,1694,26,18,214,1969,12,185,120,237,197,357,1436,2721,7,20915,1161,0,2,12,12,63080,25123,4966,33448,0
94,3936,1289,550,1043,56,32,155,1345,10,167,93,185,177,278,1266,2075,5,11498,638,0,2,10,10,63080,25125,4967,33449,0
35,1052,182,127,129,0,0,53,182,5,39,21,42,44,63,217,343,2,926,51,0,2,3,6,63080,25125,4968,33450,0
152,7065,1392,870,1177,35,17,170,1427,14,494,280,531,508,811,4473,7289,7,54850,3047,2,2,4,4,63080,25128,4969,33451,0
100,4589,1338,495,1086,10,64,173,1348,11,122,82,157,133,239,883,1686,7,11934,663,0,2,69,68,63080,25130,4969,33452,0
176,7684,139,89,101,2,0,35,141,7,54,34,62,61,96,330,569,4,2287,127,0,2,217,219,63080,25130,4969,33453,0
176,7684,7,5,5,0,0,2,7,1,2,1,2,3,3,2,4,0,2,0,0,2,217,219,63080,25130,4969,33454,0
139,5896,1782,648,1425,9,47,279,1791,8,171,97,189,179,286,1292,2140,4,9462,525,0,2,9,9,63080,25131,4970,33455,0
155,4383,1660,832,1314,41,38,274,1701,20,312,209,395,332,604,2671,5058,12,64042,3557,1,2,7,7,63080,25133,4971,33457,0
40,3016,996,429,845,24,10,117,1020,7,76,50,88,83,138,494,879,4,3565,198,0,2,36,36,63080,25135,4971,33458,0
128,5326,1513,682,1277,25,13,200,1538,11,199,116,219,210,335,1557,2584,6,15641,868,0,2,48,47,63080,25137,4971,33459,0
73,3826,1296,573,1062,40,33,157,1336,8,201,118,231,209,349,1561,2689,4,12365,686,0,2,7,7,63080,25137,4971,33460,0
86,4499,1457,730,1242,11,6,188,1468,10,292,166,329,302,495,2424,4078,5,22973,1276,1,2,18,18,63080,25139,4971,33461,0
39,2317,652,304,544,16,6,88,668,6,89,51,101,95,152,591,998,3,3399,188,0,2,93,96,63080,25140,4971,33462,0
70,3204,1455,414,1257,16,76,112,1471,5,41,23,46,46,69,231,381,2,1069,59,0,2,24,24,63080,25141,4971,33463,0
92,4727,1943,715,1694,26,18,214,1969,12,185,120,237,197,357,1436,2721,7,20915,1161,0,2,12,12,63080,25143,4971,33464,0
96,1940,463,295,324,28,62,57,491,12,134,82,154,146,236,989,1696,6,11700,650,0,2,5,2,63090,25144,4971,33465,0
235,5544,722,423,573,19,0,135,741,12,172,101,199,184,300,1320,2257,6,15668,870,0,2,12,14,63090,25146,4971,33467,0
235,5544,1508,847,911,44,250,301,1552,14,148,88,169,162,257,1120,1886,7,15077,837,0,2,12,14,63090,25147,4972,33468,0
47,2258,722,423,573,19,0,135,741,12,172,101,199,184,300,1320,2257,6,15668,870,0,2,6,1,63090,25149,4972,33470,0
2,67,16,12,9,0,0,6,16,1,2,1,2,3,3,2,4,0,2,0,0,2,4,1,63090,25149,4972,33471,0
4,77,127,75,83,2,11,30,129,4,14,7,14,18,21,61,87,2,175,9,0,2,1,1,63090,25149,4972,33472,0
4,77,652,304,544,16,6,88,668,6,89,51,101,95,152,591,998,3,3399,188,0,2,1,1,63090,25150,4972,33473,0
4,77,2,2,2,0,0,0,2,0,0,0,0,0,0,0,0,0,0,0,0,2,1,1,63090,25150,4972,33473,0
4,77,8,5,5,0,0,3,8,0,0,0,0,0,0,0,0,0,0,0,0,2,1,1,63090,25150,4972,33474,0
4,77,2,2,2,0,0,0,2,0,0,0,0,0,0,0,0,0,0,0,0,2,1,1,63090,25150,4972,33474,0
4,77,14,8,8,0,0,6,14,0,0,0,0,0,0,0,0,0,0,0,0,2,1,1,63090,25150,4972,33475,0
4,77,6,4,4,0,0,2,6,0,0,0,0,0,0,0,0,0,0,0,0,2,1,1,63090,25150,4972,33476,0
4,77,6,4,4,0,0,2,6,1,2,1,2,3,3,2,4,0,2,0,0,2,1,1,63090,25150,4972,33477,0
4,77,6,4,4,0,0,2,6,0,0,0,0,0,0,0,0,0,0,0,0,2,1,1,63090,25150,4972,33478,0
4,77,7,5,5,0,0,2,7,0,0,0,0,0,0,0,0,0,0,0,0,2,1,1,63090,25150,4972,33479,0
4,77,6,4,4,0,0,2,6,0,0,0,0,0,0,0,0,0,0,0,0,2,1,1,63090,25150,4972,33480,0
4,77,10,6,6,0,0,4,10,0,0,0,0,0,0,0,0,0,0,0,0,2,1,1,63090,25150,4972,33481,0
4,77,1,1,1,0,0,0,1,0,0,0,0,0,0,0,0,0,0,0,0,2,1,1,63090,25150,4972,33481,0
4,77,14,10,10,0,0,4,14,1,1,1,1,2,2,0,2,0,1,0,0,2,1,1,63090,25150,4972,33482,0
4,77,46,26,30,3,0,12,49,3,6,3,6,9,9,20,28,1,42,2,0,2,1,1,63100,25150,4972,33483,0
7,296,72,33,56,0,4,12,72,1,1,1,1,2,2,0,2,0,1,0,0,2,26,23,63100,25150,4972,33484,0
94,3938,1289,550,1043,56,32,155,1345,10,167,93,185,177,278,1266,2075,5,11498,638,0,2,3,3,63100,25152,4973,33485,0
152,7066,1392,870,1177,35,17,170,1427,14,494,280,531,508,811,4473,7289,7,54850,3047,2,2,1,1,63100,25155,4974,33486,0
23,579,102,59,69,5,3,24,107,6,22,15,28,28,43,113,206,3,789,43,0,2,1,1,63100,25155,4974,33487,0
155,4384,1660,832,1314,41,38,274,1701,20,312,209,395,332,604,2671,5058,12,64042,3557,1,2,1,1,63100,25157,4975,33489,0
8,271,74,35,59,1,0,14,75,3,14,7,14,17,21,58,85,1,128,7,0,2,3,1,63100,25158,4975,33490,0
38,2302,334,251,279,10,4,40,344,5,127,74,143,132,217,899,1528,2,4303,239,0,2,1,1,63100,25159,4975,33491,0
61,2733,1293,570,1093,25,15,163,1318,10,195,123,241,205,364,1516,2795,6,17273,959,0,2,4,2,63110,25161,4975,33492,0
92,4729,1943,715,1694,26,18,214,1969,12,185,120,237,197,357,1436,2721,7,20915,1161,0,2,2,2,63110,25163,4975,33493,0
164,5047,1660,832,1314,41,38,274,1701,20,312,209,395,332,604,2671,5058,12,64042,3557,1,2,6,8,63110,25165,4976,33495,1
164,5047,1057,646,719,113,100,145,1170,18,215,134,248,233,382,1740,3004,10,31186,1732,1,2,6,8,63120,25166,4977,33496,1
89,1826,477,336,357,30,23,73,507,16,194,134,250,210,384,1538,2962,10,30538,1696,0,2,2,2,63130,25167,4977,33497,1
128,5324,1513,682,1277,25,13,200,1538,11,199,116,219,210,335,1557,2584,6,15641,868,0,2,3,3,63130,25169,4977,33498,1
312,6826,72,33,56,0,4,12,72,1,1,1,1,2,2,0,2,0,1,0,0,2,6,4,63130,25169,4977,33499,1
312,6826,1454,835,1044,76,110,219,1530,17,275,158,296,292,454,2297,3718,9,34017,1889,1,2,6,4,63140,25170,4977,33500,1
177,7801,139,89,101,2,0,35,141,7,54,34,62,61,96,330,569,4,2287,127,0,2,68,0,63140,25170,4977,33501,1
177,7801,7,5,5,0,0,2,7,1,2,1,2,3,3,2,4,0,2,0,0,2,68,0,63140,25170,4977,33502,1
211,4632,1943,715,1694,26,18,214,1969,12,185,120,237,197,357,1436,2721,7,20915,1161,0,2,18,4,63140,25172,4977,33503,1
211,4632,1168,838,957,57,25,144,1225,19,348,224,416,367,640,3018,5452,11,61921,3440,1,2,18,4,63150,25174,4977,33504,1
94,4715,1943,715,1694,26,18,214,1969,12,185,120,237,197,357,1436,2721,7,20915,1161,0,2,35,0,63150,25176,4977,33505,1
312,6828,72,33,56,0,4,12,72,1,1,1,1,2,2,0,2,0,1,0,0,2,5,2,63150,25176,4977,33506,1
312,6828,1454,835,1044,76,110,219,1530,17,275,158,296,292,454,2297,3718,9,34017,1889,1,2,5,2,63160,25177,4977,33507,1
94,4715,1943,715,1694,26,18,214,1969,12,185,120,237,197,357,1436,2721,7,20915,1161,0,2,5,3,63160,25179,4977,33508,1
164,5047,1660,832,1314,41,38,274,1701,20,312,209,395,332,604,2671,5058,12,64042,3557,1,2,6,8,63160,25181,4978,33510,0
164,5047,1057,646,719,113,100,145,1170,18,215,134,248,233,382,1740,3004,10,31186,1732,1,2,6,8,63170,25182,4979,33511,0
89,1826,477,336,357,30,23,73,507,16,194,134,250,210,384,1538,2962,10,30538,1696,0,2,2,2,63180,25183,4979,33512,0
128,5324,1513,682,1277,25,13,200,1538,11,199,116,219,210,335,1557,2584,6,15641,868,0,2,3,3,63180,25185,4979,33513,0
60,1079,282,196,195,3,0,86,285,8,130,71,141,138,212,936,1507,4,6538,363,0,2,2,2,63180,25185,4980,33514,0
4,77,127,75,83,2,11,30,129,4,14,7,14,18,21,61,87,2,175,9,0,2,1,1,63180,25185,4980,33515,0
4,77,652,304,544,16,6,88,668,6,89,51,101,95,152,591,998,3,3399,188,0,2,1,1,63180,25186,4980,33516,0
4,77,2,2,2,0,0,0,2,0,0,0,0,0,0,0,0,0,0,0,0,2,1,1,63180,25186,4980,33516,0
4,77,8,5,5,0,0,3,8,0,0,0,0,0,0,0,0,0,0,0,0,2,1,1,63180,25186,4980,33517,0
4,77,2,2,2,0,0,0,2,0,0,0,0,0,0,0,0,0,0,0,0,2,1,1,63180,25186,4980,33517,0
4,77,14,8,8,0,0,6,14,0,0,0,0,0,0,0,0,0,0,0,0,2,1,1,63180,25186,4980,33518,0
4,77,6,4,4,0,0,2,6,0,0,0,0,0,0,0,0,0,0,0,0,2,1,1,63180,25186,4980,33519,0
4,77,6,4,4,0,0,2,6,1,2,1,2,3,3,2,4,0,2,0,0,2,1,1,63180,25186,4980,33520,0
4,77,6,4,4,0,0,2,6,0,0,0,0,0,0,0,0,0,0,0,0,2,1,1,63180,25186,4980,33521,0
4,77,7,5,5,0,0,2,7,0,0,0,0,0,0,0,0,0,0,0,0,2,1,1,63180,25186,4980,33522,0
4,77,6,4,4,0,0,2,6,0,0,0,0,0,0,0,0,0,0,0,0,2,1,1,63180,25186,4980,33523,0
4,77,10,6,6,0,0,4,10,0,0,0,0,0,0,0,0,0,0,0,0,2,1,1,63180,25186,4980,33524,0
4,77,1,1,1,0,0,0,1,0,0,0,0,0,0,0,0,0,0,0,0,2,1,1,63180,25186,4980,33524,0
4,77,14,10,10,0,0,4,14,1,1,1,1,2,2,0,2,0,1,0,0,2,1,1,63180,25186,4980,33525,0
4,77,46,26,30,3,0,12,49,3,6,3,6,9,9,20,28,1,42,2,0,2,1,1,63190,25186,4980,33526,0
7,296,72,33,56,0,4,12,72,1,1,1,1,2,2,0,2,0,1,0,0,2,26,23,63190,25186,4980,33527,0
215,4676,182,127,129,0,0,53,182,5,39,21,42,44,63,217,343,2,926,51,0,2,2,1,63190,25186,4981,33528,0
215,4676,1165,710,800,67,119,181,1232,18,243,153,282,261,435,2000,3492,10,36473,2026,1,2,2,1,63200,25186,4982,33529,0
164,5047,1660,832,1314,41,38,274,1701,20,312,209,395,332,604,2671,5058,12,64042,3557,1,2,7,9,63200,25188,4983,33531,0
164,5047,1057,646,719,113,100,145,1170,18,215,134,248,233,382,1740,3004,10,31186,1732,1,2,7,9,63210,25189,4984,33532,0
89,1826,477,336,357,30,23,73,507,16,194,134,250,210,384,1538,2962,10,30538,1696,0,2,2,2,63220,25190,4984,33533,0
96,1940,463,295,324,28,62,57,491,12,134,82,154,146,236,989,1696,6,11700,650,0,2,5,2,63230,25191,4984,33534,0
254,5825,4293,999,3693,19,54,507,4312,9,155,88,170,164,258,1156,1898,4,9368,520,0,2,2,2,63230,25193,4984,33535,0
254,5825,1482,859,1002,125,135,219,1607,16,219,134,251,235,385,1766,3032,9,27804,1544,1,2,2,2,63240,25194,4984,33536,0
20,507,205,80,86,16,53,53,221,7,18,10,19,25,29,94,134,3,497,27,0,2,1,2,63250,25194,4985,33537,0
235,5544,722,423,573,19,0,135,741,12,172,101,199,184,300,1320,2257,6,15668,870,0,2,12,14,63250,25196,4985,33539,0
235,5544,1508,847,911,44,250,301,1552,14,148,88,169,162,257,1120,1886,7,15077,837,0,2,12,14,63250,25197,4986,33540,0
312,6826,72,33,56,0,4,12,72,1,1,1,1,2,2,0,2,0,1,0,0,2,1,1,63250,25197,4986,33541,0
312,6826,1454,835,1044,76,110,219,1530,17,275,158,296,292,454,2297,3718,9,34017,1889,1,2,1,1,63260,25198,4986,33542,0
91,1828,757,253,292,73,244,162,830,13,61,38,67,74,105,409,651,7,4654,258,0,2,3,3,63260,25199,4986,33543,0
46,952,386,256,301,16,9,68,402,4,59,35,69,63,104,355,621,2,1453,80,0,2,3,3,63260,25199,4986,33544,0
46,952,264,131,164,11,41,46,275,6,38,22,40,44,62,214,338,3,1068,59,0,2,3,3,63270,25199,4987,33545,0
90,1921,1043,504,840,53,9,147,1096,9,180,112,198,189,310,1377,2344,4,11604,644,0,2,4,4,63270,25201,4987,33546,0
90,1921,383,288,292,26,6,62,409,11,65,38,67,76,105,429,656,5,3719,206,0,2,4,4,63270,25202,4987,33547,0
94,3938,1289,550,1043,56,32,155,1345,10,167,93,185,177,278,1266,2075,5,11498,638,0,2,13,13,63270,25204,4988,33548,0
35,1052,182,127,129,0,0,53,182,5,39,21,42,44,63,217,343,2,926,51,0,2,5,9,63270,25204,4989,33549,0
152,7066,1392,870,1177,35,17,170,1427,14,494,280,531,508,811,4473,7289,7,54850,3047,2,2,10,9,63270,25207,4990,33550,0
92,2955,773,419,590,28,0,166,801,10,204,113,217,214,330,1598,2554,5,13587,754,0,2,3,3,63270,25207,4991,33551,0
2,67,16,12,9,0,0,6,16,1,2,1,2,3,3,2,4,0,2,0,0,2,4,1,63270,25207,4991,33552,0
101,4702,1338,495,1086,10,64,173,1348,11,122,82,157,133,239,883,1686,7,11934,663,0,2,69,68,63270,25209,4991,33553,0
177,7811,139,89,101,2,0,35,141,7,54,34,62,61,96,330,569,4,2287,127,0,2,217,219,63270,25209,4991,33554,0
177,7811,7,5,5,0,0,2,7,1,2,1,2,3,3,2,4,0,2,0,0,2,217,219,63270,25209,4991,33555,0
139,5896,1782,648,1425,9,47,279,1791,8,171,97,189,179,286,1292,2140,4,9462,525,0,2,11,15,63270,25210,4992,33556,0
23,579,102,59,69,5,3,24,107,6,22,15,28,28,43,113,206,3,789,43,0,2,1,1,63270,25210,4992,33557,0
111,4132,1450,624,1228,12,26,181,1462,14,306,186,354,320,540,2580,4493,8,36391,2021,1,2,8,7,63270,25212,4993,33558,0
155,4384,1660,832,1314,41,38,274,1701,20,312,209,395,332,604,2671,5058,12,64042,3557,1,2,12,13,63270,25214,4994,33560,0
40,3016,996,429,845,24,10,117,1020,7,76,50,88,83,138,494,879,4,3565,198,0,2,36,36,63270,25216,4994,33561,0
128,5324,1513,682,1277,25,13,200,1538,11,199,116,219,210,335,1557,2584,6,15641,868,0,2,55,53,63270,25218,4994,33562,0
73,3826,1296,573,1062,40,33,157,1336,8,201,118,231,209,349,1561,2689,4,12365,686,0,2,7,7,63270,25218,4994,33563,0
86,4499,1457,730,1242,11,6,188,1468,10,292,166,329,302,495,2424,4078,5,22973,1276,1,2,18,18,63270,25220,4994,33564,0
39,2317,652,304,544,16,6,88,668,6,89,51,101,95,152,591,998,3,3399,188,0,2,93,96,63270,25221,4994,33565,0
70,3204,1455,414,1257,16,76,112,1471,5,41,23,46,46,69,231,381,2,1069,59,0,2,24,24,63270,25222,4994,33566,0
8,271,74,35,59,1,0,14,75,3,14,7,14,17,21,58,85,1,128,7,0,2,3,1,63270,25223,4994,33567,0
95,4632,1523,757,1297,19,12,193,1542,12,193,117,230,205,347,1508,2664,7,19053,1058,0,2,1,1,63280,25225,4994,33568,0
38,2302,334,251,279,10,4,40,344,5,127,74,143,132,217,899,1528,2,4303,239,0,2,1,1,63280,25226,4994,33569,0
61,2733,1293,570,1093,25,15,163,1318,10,195,123,241,205,364,1516,2795,6,17273,959,0,2,4,2,63290,25228,4994,33570,0
47,2258,722,423,573,19,0,135,741,12,172,101,199,184,300,1320,2257,6,15668,870,0,2,6,1,63290,25230,4994,33572,0
92,4729,1943,715,1694,26,18,214,1969,12,185,120,237,197,357,1436,2721,7,20915,1161,0,2,14,14,63290,25232,4994,33573,0
177,7819,139,89,101,2,0,35,141,7,54,34,62,61,96,330,569,4,2287,127,0,2,4,4,63290,25232,4994,33574,0
177,7819,7,5,5,0,0,2,7,1,2,1,2,3,3,2,4,0,2,0,0,2,4,4,63290,25232,4994,33575,0
177,7819,139,89,101,2,0,35,141,7,54,34,62,61,96,330,569,4,2287,127,0,2,1,0,63290,25232,4994,33576,0
177,7819,7,5,5,0,0,2,7,1,2,1,2,3,3,2,4,0,2,0,0,2,1,0,63290,25232,4994,33577,0
177,7819,139,89,101,2,0,35,141,7,54,34,62,61,96,330,569,4,2287,127,0,2,2,2,63290,25232,4994,33578,0
177,7819,7,5,5,0,0,2,7,1,2,1,2,3,3,2,4,0,2,0,0,2,2,2,63290,25232,4994,33579,0
101,4702,1338,495,1086,10,64,173,1348,11,122,82,157,133,239,883,1686,7,11934,663,0,2,7,7,63290,25234,4994,33580,0
101,4691,1338,495,1086,10,64,173,1348,11,122,82,157,133,239,883,1686,7,11934,663,0,2,7,9,63290,25236,4994,33581,0
254,5822,4293,999,3693,19,54,507,4312,9,155,88,170,164,258,1156,1898,4,9368,520,0,2,1,1,63290,25238,4994,33582,0
254,5822,1482,859,1002,125,135,219,1607,16,219,134,251,235,385,1766,3032,9,27804,1544,1,2,1,1,63300,25239,4994,33583,0
254,5820,4293,999,3693,19,54,507,4312,9,155,88,170,164,258,1156,1898,4,9368,520,0,2,0,1,63300,25241,4994,33584,0
254,5820,1482,859,1002,125,135,219,1607,16,219,134,251,235,385,1766,3032,9,27804,1544,1,2,0,1,63310,25242,4994,33585,0
254,5820,4293,999,3693,19,54,507,4312,9,155,88,170,164,258,1156,1898,4,9368,520,0,2,1,2,63310,25244,4994,33586,0
254,5820,1482,859,1002,125,135,219,1607,16,219,134,251,235,385,1766,3032,9,27804,1544,1,2,1,2,63320,25245,4994,33587,0
312,6826,72,33,56,0,4,12,72,1,1,1,1,2,2,0,2,0,1,0,0,2,15,4,63320,25245,4994,33588,0
312,6826,1454,835,1044,76,110,219,1530,17,275,158,296,292,454,2297,3718,9,34017,1889,1,2,15,4,63330,25246,4994,33589,0
101,4691,1338,495,1086,10,64,173,1348,11,122,82,157,133,239,883,1686,7,11934,663,0,2,35,0,63330,25248,4994,33590,0
177,7819,139,89,101,2,0,35,141,7,54,34,62,61,96,330,569,4,2287,127,0,2,69,0,63330,25248,4994,33591,0
177,7819,7,5,5,0,0,2,7,1,2,1,2,3,3,2,4,0,2,0,0,2,69,0,63330,25248,4994,33592,0
235,5549,722,423,573,19,0,135,741,12,172,101,199,184,300,1320,2257,6,15668,870,0,2,3,1,63330,25250,4994,33594,0
235,5549,1508,847,911,44,250,301,1552,14,148,88,169,162,257,1120,1886,7,15077,837,0,2,3,1,63330,25251,4995,33595,0
315,6881,72,33,56,0,4,12,72,1,1,1,1,2,2,0,2,0,1,0,0,2,13,4,63330,25251,4995,33596,0
315,6881,1454,835,1044,76,110,219,1530,17,275,158,296,292,454,2297,3718,9,34017,1889,1,2,13,4,63340,25252,4995,33597,0
1,6,2,2,2,0,0,0,2,0,0,0,0,0,0,0,0,0,0,0,0,0,2,0,63340,25252,4995,33597,0
1,6,99,48,90,1,3,5,100,0,0,0,0,0,0,0,0,0,0,0,0,0,2,0,63340,25253,4995,33598,0
1,6,8,5,5,2,0,1,10,0,0,0,0,0,0,0,0,0,0,0,0,0,2,0,63340,25253,4995,33599,0
1,6,1217,716,841,84,126,174,1301,14,185,118,215,199,333,1446,2542,8,20687,1149,0,0,2,0,63350,25255,4995,33600,0
1,6,160,89,115,0,13,31,160,7,15,11,17,22,28,78,124,3,495,27,0,0,2,0,63350,25255,4995,33601,0
1,6,10,10,9,9,0,0,19,0,0,0,0,0,0,0,0,0,0,0,0,0,2,0,63350,25255,4996,33602,0
1,6,173,84,99,8,29,36,181,5,12,7,13,17,20,54,81,2,221,12,0,0,2,0,63350,25256,4996,33603,0
1,6,3,1,1,3,0,0,6,0,0,0,0,0,0,0,0,0,0,0,0,0,2,0,63350,25256,4996,33604,0
1,6,2,2,2,0,0,0,2,0,0,0,0,0,0,0,0,0,0,0,0,0,2,0,63350,25256,4996,33604,0
74,3868,1296,573,1062,40,33,157,1336,8,201,118,231,209,349,1561,2689,4,12365,686,0,2,14,0,63350,25256,4996,33605,0
33,1885,384,251,317,7,8,52,391,11,70,44,84,81,128,467,811,6,5355,297,0,2,1,3,63350,25256,4996,33606,0
39,1696,447,308,343,6,5,95,453,7,96,59,111,103,170,651,1136,4,4600,255,0,2,9,5,63350,25259,4996,33607,0
41,2010,722,423,573,19,0,135,741,12,172,101,199,184,300,1320,2257,6,15668,870,0,2,0,51,63350,25261,4996,33609,0
94,4731,1943,715,1694,26,18,214,1969,12,185,120,237,197,357,1436,2721,7,20915,1161,0,2,7,0,63350,25263,4996,33610,1
94,4721,1943,715,1694,26,18,214,1969,12,185,120,237,197,357,1436,2721,7,20915,1161,0,2,0,1,63350,25265,4996,33611,0
235,5549,722,423,573,19,0,135,741,12,172,101,199,184,300,1320,2257,6,15668,870,0,2,3,1,63350,25267,4996,33613,0
235,5549,1508,847,911,44,250,301,1552,14,148,88,169,162,257,1120,1886,7,15077,837,0,2,3,1,63350,25268,4997,33614,0
315,6881,72,33,56,0,4,12,72,1,1,1,1,2,2,0,2,0,1,0,0,2,13,4,63350,25268,4997,33615,0
315,6881,1454,835,1044,76,110,219,1530,17,275,158,296,292,454,2297,3718,9,34017,1889,1,2,13,4,63360,25269,4997,33616,0
1,6,2,2,2,0,0,0,2,0,0,0,0,0,0,0,0,0,0,0,0,0,2,0,63360,25269,4997,33616,0
1,6,99,48,90,1,3,5,100,0,0,0,0,0,0,0,0,0,0,0,0,0,2,0,63360,25270,4997,33617,0
1,6,8,5,5,2,0,1,10,0,0,0,0,0,0,0,0,0,0,0,0,0,2,0,63360,25270,4997,33618,0
1,6,1217,716,841,84,126,174,1301,14,185,118,215,199,333,1446,2542,8,20687,1149,0,0,2,0,63370,25272,4997,33619,0
1,6,160,89,115,0,13,31,160,7,15,11,17,22,28,78,124,3,495,27,0,0,2,0,63370,25272,4997,33620,0
1,6,10,10,9,9,0,0,19,0,0,0,0,0,0,0,0,0,0,0,0,0,2,0,63370,25272,4998,33621,0
1,6,173,84,99,8,29,36,181,5,12,7,13,17,20,54,81,2,221,12,0,0,2,0,63370,25273,4998,33622,0
1,6,3,1,1,3,0,0,6,0,0,0,0,0,0,0,0,0,0,0,0,0,2,0,63370,25273,4998,33623,0
1,6,2,2,2,0,0,0,2,0,0,0,0,0,0,0,0,0,0,0,0,0,2,0,63370,25273,4998,33623,0
74,3868,1296,573,1062,40,33,157,1336,8,201,118,231,209,349,1561,2689,4,12365,686,0,2,14,0,63370,25273,4998,33624,0
39,1696,447,308,343,6,5,95,453,7,96,59,111,103,170,651,1136,4,4600,255,0,2,9,5,63370,25276,4998,33625,0
33,1885,384,251,317,7,8,52,391,11,70,44,84,81,128,467,811,6,5355,297,0,2,1,3,63370,25276,4998,33626,0
41,2010,722,423,573,19,0,135,741,12,172,101,199,184,300,1320,2257,6,15668,870,0,2,0,51,63370,25278,4998,33628,0
60,1079,282,196,195,3,0,86,285,8,130,71,141,138,212,936,1507,4,6538,363,0,2,2,2,63370,25278,4999,33629,0
4,77,127,75,83,2,11,30,129,4,14,7,14,18,21,61,87,2,175,9,0,2,1,1,63370,25278,4999,33630,0
4,77,652,304,544,16,6,88,668,6,89,51,101,95,152,591,998,3,3399,188,0,2,1,1,63370,25279,4999,33631,0
4,77,2,2,2,0,0,0,2,0,0,0,0,0,0,0,0,0,0,0,0,2,1,1,63370,25279,4999,33631,0
4,77,8,5,5,0,0,3,8,0,0,0,0,0,0,0,0,0,0,0,0,2,1,1,63370,25279,4999,33632,0
4,77,2,2,2,0,0,0,2,0,0,0,0,0,0,0,0,0,0,0,0,2,1,1,63370,25279,4999,33632,0
4,77,14,8,8,0,0,6,14,0,0,0,0,0,0,0,0,0,0,0,0,2,1,1,63370,25279,4999,33633,0
4,77,6,4,4,0,0,2,6,0,0,0,0,0,0,0,0,0,0,0,0,2,1,1,63370,25279,4999,33634,0
4,77,6,4,4,0,0,2,6,1,2,1,2,3,3,2,4,0,2,0,0,2,1,1,63370,25279,4999,33635,0
4,77,6,4,4,0,0,2,6,0,0,0,0,0,0,0,0,0,0,0,0,2,1,1,63370,25279,4999,33636,0
4,77,7,5,5,0,0,2,7,0,0,0,0,0,0,0,0,0,0,0,0,2,1,1,63370,25279,4999,33637,0
4,77,6,4,4,0,0,2,6,0,0,0,0,0,0,0,0,0,0,0,0,2,1,1,63370,25279,4999,33638,0
4,77,10,6,6,0,0,4,10,0,0,0,0,0,0,0,0,0,0,0,0,2,1,1,63370,25279,4999,33639,0
4,77,1,1,1,0,0,0,1,0,0,0,0,0,0,0,0,0,0,0,0,2,1,1,63370,25279,4999,33639,0
4,77,14,10,10,0,0,4,14,1,1,1,1,2,2,0,2,0,1,0,0,2,1,1,63370,25279,4999,33640,0
4,77,46,26,30,3,0,12,49,3,6,3,6,9,9,20,28,1,42,2,0,2,1,1,63380,25279,4999,33641,0
7,296,72,33,56,0,4,12,72,1,1,1,1,2,2,0,2,0,1,0,0,2,26,23,63380,25279,4999,33642,0
215,4676,182,127,129,0,0,53,182,5,39,21,42,44,63,217,343,2,926,51,0,2,2,1,63380,25279,5000,33643,0
215,4676,1165,710,800,67,119,181,1232,18,243,153,282,261,435,2000,3492,10,36473,2026,1,2,2,1,63390,25279,5001,33644,0
164,5047,1660,832,1314,41,38,274,1701,20,312,209,395,332,604,2671,5058,12,64042,3557,1,2,7,9,63390,25281,5002,33646,0
164,5047,1057,646,719,113,100,145,1170,18,215,134,248,233,382,1740,3004,10,31186,1732,1,2,7,9,63400,25282,5003,33647,0
89,1826,477,336,357,30,23,73,507,16,194,134,250,210,384,1538,2962,10,30538,1696,0,2,2,2,63410,25283,5003,33648,0
154,3262,1513,682,1277,25,13,200,1538,11,199,116,219,210,335,1557,2584,6,15641,868,0,2,100,65,63410,25285,5003,33649,0
154,3262,819,519,539,24,98,155,843,15,96,57,106,111,163,690,1107,8,9171,509,0,2,100,65,63420,25287,5003,33650,0
96,1940,463,295,324,28,62,57,491,12,134,82,154,146,236,989,1696,6,11700,650,0,2,5,2,63430,25288,5003,33651,0
34,1000,339,213,244,17,9,65,356,10,42,26,48,52,74,259,421,5,2410,133,0,2,2,1,63440,25288,5003,33652,0
254,5820,4293,999,3693,19,54,507,4312,9,155,88,170,164,258,1156,1898,4,9368,520,0,2,3,4,63440,25290,5003,33653,0
254,5820,1482,859,1002,125,135,219,1607,16,219,134,251,235,385,1766,3032,9,27804,1544,1,2,3,4,63450,25291,5003,33654,0
141,3269,77,34,69,0,0,8,77,3,24,16,29,27,45,114,213,1,387,21,0,2,4,3,63450,25291,5003,33655,0
141,3269,712,438,573,51,9,84,763,14,102,71,128,116,199,733,1364,8,11988,666,0,2,4,3,63460,25292,5003,33656,0
20,507,205,80,86,16,53,53,221,7,18,10,19,25,29,94,134,3,497,27,0,2,1,2,63470,25292,5004,33657,0
235,5590,722,423,573,19,0,135,741,12,172,101,199,184,300,1320,2257,6,15668,870,0,2,27,23,63470,25294,5004,33659,0
235,5590,1508,847,911,44,250,301,1552,14,148,88,169,162,257,1120,1886,7,15077,837,0,2,27,23,63470,25295,5005,33660,0
315,6881,72,33,56,0,4,12,72,1,1,1,1,2,2,0,2,0,1,0,0,2,29,9,63470,25295,5005,33661,0
315,6881,1454,835,1044,76,110,219,1530,17,275,158,296,292,454,2297,3718,9,34017,1889,1,2,29,9,63480,25296,5005,33662,0
91,1828,757,253,292,73,244,162,830,13,61,38,67,74,105,409,651,7,4654,258,0,2,3,3,63480,25297,5005,33663,0
46,952,386,256,301,16,9,68,402,4,59,35,69,63,104,355,621,2,1453,80,0,2,3,3,63480,25297,5005,33664,0
46,952,264,131,164,11,41,46,275,6,38,22,40,44,62,214,338,3,1068,59,0,2,3,3,63490,25297,5006,33665,0
90,1921,1043,504,840,53,9,147,1096,9,180,112,198,189,310,1377,2344,4,11604,644,0,2,4,4,63490,25299,5006,33666,0
90,1921,383,288,292,26,6,62,409,11,65,38,67,76,105,429,656,5,3719,206,0,2,4,4,63490,25300,5006,33667,0
20,416,294,64,250,0,0,43,294,1,20,10,20,21,30,86,131,0,65,3,0,2,2,1,63490,25300,5006,33668,0
20,416,78,46,62,3,0,14,81,3,8,4,8,11,12,28,41,1,62,3,0,2,2,1,63490,25301,5006,33669,0
212,4578,1943,715,1694,26,18,214,1969,12,185,120,237,197,357,1436,2721,7,20915,1161,0,2,5,0,63490,25303,5006,33670,0
212,4578,1168,838,957,57,25,144,1225,19,348,224,416,367,640,3018,5452,11,61921,3440,1,2,5,0,63500,25305,5006,33671,0
94,3938,1289,550,1043,56,32,155,1345,10,167,93,185,177,278,1266,2075,5,11498,638,0,2,23,13,63500,25307,5007,33672,0
35,1052,182,127,129,0,0,53,182,5,39,21,42,44,63,217,343,2,926,51,0,2,5,9,63500,25307,5008,33673,0
152,7066,1392,870,1177,35,17,170,1427,14,494,280,531,508,811,4473,7289,7,54850,3047,2,2,10,9,63500,25310,5009,33674,0
92,2955,773,419,590,28,0,166,801,10,204,113,217,214,330,1598,2554,5,13587,754,0,2,3,3,63500,25310,5010,33675,0
2,67,16,12,9,0,0,6,16,1,2,1,2,3,3,2,4,0,2,0,0,2,4,1,63500,25310,5010,33676,0
1,6,2,2,2,0,0,0,2,0,0,0,0,0,0,0,0,0,0,0,0,0,2,0,63500,25310,5010,33676,0
1,6,99,48,90,1,3,5,100,0,0,0,0,0,0,0,0,0,0,0,0,0,2,0,63500,25311,5010,33677,0
1,6,8,5,5,2,0,1,10,0,0,0,0,0,0,0,0,0,0,0,0,0,2,0,63500,25311,5010,33678,0
1,6,1217,716,841,84,126,174,1301,14,185,118,215,199,333,1446,2542,8,20687,1149,0,0,2,0,63510,25313,5010,33679,0
1,6,160,89,115,0,13,31,160,7,15,11,17,22,28,78,124,3,495,27,0,0,2,0,63510,25313,5010,33680,0
1,6,10,10,9,9,0,0,19,0,0,0,0,0,0,0,0,0,0,0,0,0,2,0,63510,25313,5011,33681,0
1,6,173,84,99,8,29,36,181,5,12,7,13,17,20,54,81,2,221,12,0,0,2,0,63510,25314,5011,33682,0
1,6,3,1,1,3,0,0,6,0,0,0,0,0,0,0,0,0,0,0,0,0,2,0,63510,25314,5011,33683,0
1,6,2,2,2,0,0,0,2,0,0,0,0,0,0,0,0,0,0,0,0,0,2,0,63510,25314,5011,33683,0
31,2065,1157,318,931,29,22,177,1186,6,104,63,125,110,188,712,1274,3,4596,255,0,2,0,5,63510,25314,5011,33684,0
101,4691,1338,495,1086,10,64,173,1348,11,122,82,157,133,239,883,1686,7,11934,663,0,2,104,68,63510,25316,5011,33685,0
177,7819,139,89,101,2,0,35,141,7,54,34,62,61,96,330,569,4,2287,127,0,2,286,219,63510,25316,5011,33686,0
177,7819,7,5,5,0,0,2,7,1,2,1,2,3,3,2,4,0,2,0,0,2,286,219,63510,25316,5011,33687,0
139,5896,1782,648,1425,9,47,279,1791,8,171,97,189,179,286,1292,2140,4,9462,525,0,2,11,15,63510,25317,5012,33688,0
23,579,102,59,69,5,3,24,107,6,22,15,28,28,43,113,206,3,789,43,0,2,1,1,63510,25317,5012,33689,0
111,4132,1450,624,1228,12,26,181,1462,14,306,186,354,320,540,2580,4493,8,36391,2021,1,2,8,7,63510,25319,5013,33690,0
155,4384,1660,832,1314,41,38,274,1701,20,312,209,395,332,604,2671,5058,12,64042,3557,1,2,12,13,63510,25321,5014,33692,0
40,3016,996,429,845,24,10,117,1020,7,76,50,88,83,138,494,879,4,3565,198,0,2,36,36,63510,25323,5014,33693,0
128,5324,1513,682,1277,25,13,200,1538,11,199,116,219,210,335,1557,2584,6,15641,868,0,2,159,64,63510,25325,5014,33694,0
74,3868,1296,573,1062,40,33,157,1336,8,201,118,231,209,349,1561,2689,4,12365,686,0,2,21,7,63510,25325,5014,33695,0
88,4625,1457,730,1242,11,6,188,1468,10,292,166,329,302,495,2424,4078,5,22973,1276,1,2,18,18,63510,25327,5014,33696,0
39,2317,652,304,544,16,6,88,668,6,89,51,101,95,152,591,998,3,3399,188,0,2,93,96,63510,25328,5014,33697,0
70,3204,1455,414,1257,16,76,112,1471,5,41,23,46,46,69,231,381,2,1069,59,0,2,24,24,63510,25329,5014,33698,0
8,271,74,35,59,1,0,14,75,3,14,7,14,17,21,58,85,1,128,7,0,2,3,1,63510,25330,5014,33699,0
95,4632,1523,757,1297,19,12,193,1542,12,193,117,230,205,347,1508,2664,7,19053,1058,0,2,1,1,63520,25332,5014,33700,0
39,1696,447,308,343,6,5,95,453,7,96,59,111,103,170,651,1136,4,4600,255,0,2,9,5,63520,25335,5014,33701,0
38,2302,334,251,279,10,4,40,344,5,127,74,143,132,217,899,1528,2,4303,239,0,2,1,1,63520,25336,5014,33702,0
61,2733,1293,570,1093,25,15,163,1318,10,195,123,241,205,364,1516,2795,6,17273,959,0,2,4,2,63530,25338,5014,33703,0
33,1885,384,251,317,7,8,52,391,11,70,44,84,81,128,467,811,6,5355,297,0,2,1,3,63530,25338,5014,33704,0
44,2109,722,423,573,19,0,135,741,12,172,101,199,184,300,1320,2257,6,15668,870,0,2,6,52,63530,25340,5014,33706,0
92,4729,1943,715,1694,26,18,214,1969,12,185,120,237,197,357,1436,2721,7,20915,1161,0,2,54,14,63530,25342,5014,33707,0
213,4582,1943,715,1694,26,18,214,1969,12,185,120,237,197,357,1436,2721,7,20915,1161,0,2,3,3,63530,25344,5014,33708,0
213,4582,1168,838,957,57,25,144,1225,19,348,224,416,367,640,3018,5452,11,61921,3440,1,2,3,3,63540,25346,5014,33709,0
96,4914,1943,715,1694,26,18,214,1969,12,185,120,237,197,357,1436,2721,7,20915,1161,0,2,50,3,63540,25348,5014,33710,0
76,1715,996,429,845,24,10,117,1020,7,76,50,88,83,138,494,879,4,3565,198,0,2,1,1,63540,25350,5014,33711,0
76,1715,456,277,329,12,42,72,468,13,85,50,97,98,147,592,972,7,7212,400,0,2,1,1,63540,25350,5014,33712,0
43,3113,996,429,845,24,10,117,1020,7,76,50,88,83,138,494,879,4,3565,198,0,2,13,0,63540,25352,5014,33713,0
60,1079,282,196,195,3,0,86,285,8,130,71,141,138,212,936,1507,4,6538,363,0,2,2,2,63540,25352,5015,33714,0
4,77,127,75,83,2,11,30,129,4,14,7,14,18,21,61,87,2,175,9,0,2,1,1,63540,25352,5015,33715,0
4,77,652,304,544,16,6,88,668,6,89,51,101,95,152,591,998,3,3399,188,0,2,1,1,63540,25353,5015,33716,0
4,77,2,2,2,0,0,0,2,0,0,0,0,0,0,0,0,0,0,0,0,2,1,1,63540,25353,5015,33716,0
4,77,8,5,5,0,0,3,8,0,0,0,0,0,0,0,0,0,0,0,0,2,1,1,63540,25353,5015,33717,0
4,77,2,2,2,0,0,0,2,0,0,0,0,0,0,0,0,0,0,0,0,2,1,1,63540,25353,5015,33717,0
4,77,14,8,8,0,0,6,14,0,0,0,0,0,0,0,0,0,0,0,0,2,1,1,63540,25353,5015,33718,0
4,77,6,4,4,0,0,2,6,0,0,0,0,0,0,0,0,0,0,0,0,2,1,1,63540,25353,5015,33719,0
4,77,6,4,4,0,0,2,6,1,2,1,2,3,3,2,4,0,2,0,0,2,1,1,63540,25353,5015,33720,0
4,77,6,4,4,0,0,2,6,0,0,0,0,0,0,0,0,0,0,0,0,2,1,1,63540,25353,5015,33721,0
4,77,7,5,5,0,0,2,7,0,0,0,0,0,0,0,0,0,0,0,0,2,1,1,63540,25353,5015,33722,0
4,77,6,4,4,0,0,2,6,0,0,0,0,0,0,0,0,0,0,0,0,2,1,1,63540,25353,5015,33723,0
4,77,10,6,6,0,0,4,10,0,0,0,0,0,0,0,0,0,0,0,0,2,1,1,63540,25353,5015,33724,0
4,77,1,1,1,0,0,0,1,0,0,0,0,0,0,0,0,0,0,0,0,2,1,1,63540,25353,5015,33724,0
4,77,14,10,10,0,0,4,14,1,1,1,1,2,2,0,2,0,1,0,0,2,1,1,63540,25353,5015,33725,0
4,77,46,26,30,3,0,12,49,3,6,3,6,9,9,20,28,1,42,2,0,2,1,1,63550,25353,5015,33726,0
7,296,72,33,56,0,4,12,72,1,1,1,1,2,2,0,2,0,1,0,0,2,26,23,63550,25353,5015,33727,0
215,4676,182,127,129,0,0,53,182,5,39,21,42,44,63,217,343,2,926,51,0,2,2,1,63550,25353,5016,33728,0
215,4676,1165,710,800,67,119,181,1232,18,243,153,282,261,435,2000,3492,10,36473,2026,1,2,2,1,63560,25353,5017,33729,0
164,5047,1660,832,1314,41,38,274,1701,20,312,209,395,332,604,2671,5058,12,64042,3557,1,2,7,9,63560,25355,5018,33731,0
164,5047,1057,646,719,113,100,145,1170,18,215,134,248,233,382,1740,3004,10,31186,1732,1,2,7,9,63570,25356,5019,33732,0
89,1826,477,336,357,30,23,73,507,16,194,134,250,210,384,1538,2962,10,30538,1696,0,2,2,2,63580,25357,5019,33733,0
154,3262,1513,682,1277,25,13,200,1538,11,199,116,219,210,335,1557,2584,6,15641,868,0,2,100,65,63580,25359,5019,33734,0
154,3262,819,519,539,24,98,155,843,15,96,57,106,111,163,690,1107,8,9171,509,0,2,100,65,63590,25361,5019,33735,0
96,1940,463,295,324,28,62,57,491,12,134,82,154,146,236,989,1696,6,11700,650,0,2,5,2,63600,25362,5019,33736,0
34,1000,339,213,244,17,9,65,356,10,42,26,48,52,74,259,421,5,2410,133,0,2,2,1,63610,25362,5019,33737,0
254,5820,4293,999,3693,19,54,507,4312,9,155,88,170,164,258,1156,1898,4,9368,520,0,2,3,4,63610,25364,5019,33738,0
254,5820,1482,859,1002,125,135,219,1607,16,219,134,251,235,385,1766,3032,9,27804,1544,1,2,3,4,63620,25365,5019,33739,0
141,3269,77,34,69,0,0,8,77,3,24,16,29,27,45,114,213,1,387,21,0,2,4,3,63620,25365,5019,33740,0
141,3269,712,438,573,51,9,84,763,14,102,71,128,116,199,733,1364,8,11988,666,0,2,4,3,63630,25366,5019,33741,0
20,507,205,80,86,16,53,53,221,7,18,10,19,25,29,94,134,3,497,27,0,2,1,2,63640,25366,5020,33742,0
235,5590,722,423,573,19,0,135,741,12,172,101,199,184,300,1320,2257,6,15668,870,0,2,27,23,63640,25368,5020,33744,0
235,5590,1508,847,911,44,250,301,1552,14,148,88,169,162,257,1120,1886,7,15077,837,0,2,27,23,63640,25369,5021,33745,0
315,6881,72,33,56,0,4,12,72,1,1,1,1,2,2,0,2,0,1,0,0,2,29,9,63640,25369,5021,33746,0
315,6881,1454,835,1044,76,110,219,1530,17,275,158,296,292,454,2297,3718,9,34017,1889,1,2,29,9,63650,25370,5021,33747,0
91,1828,757,253,292,73,244,162,830,13,61,38,67,74,105,409,651,7,4654,258,0,2,3,3,63650,25371,5021,33748,0
46,952,386,256,301,16,9,68,402,4,59,35,69,63,104,355,621,2,1453,80,0,2,3,3,63650,25371,5021,33749,0
46,952,264,131,164,11,41,46,275,6,38,22,40,44,62,214,338,3,1068,59,0,2,3,3,63660,25371,5022,33750,0
90,1921,1043,504,840,53,9,147,1096,9,180,112,198,189,310,1377,2344,4,11604,644,0,2,4,4,63660,25373,5022,33751,0
90,1921,383,288,292,26,6,62,409,11,65,38,67,76,105,429,656,5,3719,206,0,2,4,4,63660,25374,5022,33752,0
20,416,294,64,250,0,0,43,294,1,20,10,20,21,30,86,131,0,65,3,0,2,2,1,63660,25374,5022,33753,0
20,416,78,46,62,3,0,14,81,3,8,4,8,11,12,28,41,1,62,3,0,2,2,1,63660,25375,5022,33754,0
212,4578,1943,715,1694,26,18,214,1969,12,185,120,237,197,357,1436,2721,7,20915,1161,0,2,5,0,63660,25377,5022,33755,0
212,4578,1168,838,957,57,25,144,1225,19,348,224,416,367,640,3018,5452,11,61921,3440,1,2,5,0,63670,25379,5022,33756,0
94,3938,1289,550,1043,56,32,155,1345,10,167,93,185,177,278,1266,2075,5,11498,638,0,2,23,13,63670,25381,5023,33757,0
35,1052,182,127,129,0,0,53,182,5,39,21,42,44,63,217,343,2,926,51,0,2,5,9,63670,25381,5024,33758,0
152,7066,1392,870,1177,35,17,170,1427,14,494,280,531,508,811,4473,7289,7,54850,3047,2,2,10,9,63670,25384,5025,33759,0
92,2955,773,419,590,28,0,166,801,10,204,113,217,214,330,1598,2554,5,13587,754,0,2,3,3,63670,25384,5026,33760,0
2,67,16,12,9,0,0,6,16,1,2,1,2,3,3,2,4,0,2,0,0,2,4,1,63670,25384,5026,33761,0
1,6,2,2,2,0,0,0,2,0,0,0,0,0,0,0,0,0,0,0,0,0,2,0,63670,25384,5026,33761,0
1,6,99,48,90,1,3,5,100,0,0,0,0,0,0,0,0,0,0,0,0,0,2,0,63670,25385,5026,33762,0
1,6,8,5,5,2,0,1,10,0,0,0,0,0,0,0,0,0,0,0,0,0,2,0,63670,25385,5026,33763,0
1,6,1217,716,841,84,126,174,1301,14,185,118,215,199,333,1446,2542,8,20687,1149,0,0,2,0,63680,25387,5026,33764,0
1,6,160,89,115,0,13,31,160,7,15,11,17,22,28,78,124,3,495,27,0,0,2,0,63680,25387,5026,33765,0
1,6,10,10,9,9,0,0,19,0,0,0,0,0,0,0,0,0,0,0,0,0,2,0,63680,25387,5027,33766,0
1,6,173,84,99,8,29,36,181,5,12,7,13,17,20,54,81,2,221,12,0,0,2,0,63680,25388,5027,33767,0
1,6,3,1,1,3,0,0,6,0,0,0,0,0,0,0,0,0,0,0,0,0,2,0,63680,25388,5027,33768,0
1,6,2,2,2,0,0,0,2,0,0,0,0,0,0,0,0,0,0,0,0,0,2,0,63680,25388,5027,33768,0
31,2065,1157,318,931,29,22,177,1186,6,104,63,125,110,188,712,1274,3,4596,255,0,2,0,5,63680,25388,5027,33769,0
101,4691,1338,495,1086,10,64,173,1348,11,122,82,157,133,239,883,1686,7,11934,663,0,2,104,68,63680,25390,5027,33770,0
177,7819,139,89,101,2,0,35,141,7,54,34,62,61,96,330,569,4,2287,127,0,2,286,219,63680,25390,5027,33771,0
177,7819,7,5,5,0,0,2,7,1,2,1,2,3,3,2,4,0,2,0,0,2,286,219,63680,25390,5027,33772,0
139,5896,1782,648,1425,9,47,279,1791,8,171,97,189,179,286,1292,2140,4,9462,525,0,2,11,15,63680,25391,5028,33773,0
23,579,102,59,69,5,3,24,107,6,22,15,28,28,43,113,206,3,789,43,0,2,1,1,63680,25391,5028,33774,0
111,4132,1450,624,1228,12,26,181,1462,14,306,186,354,320,540,2580,4493,8,36391,2021,1,2,8,7,63680,25393,5029,33775,0
155,4384,1660,832,1314,41,38,274,1701,20,312,209,395,332,604,2671,5058,12,64042,3557,1,2,12,13,63680,25395,5030,33777,0
40,3016,996,429,845,24,10,117,1020,7,76,50,88,83,138,494,879,4,3565,198,0,2,36,36,63680,25397,5030,33778,0
128,5324,1513,682,1277,25,13,200,1538,11,199,116,219,210,335,1557,2584,6,15641,868,0,2,159,64,63680,25399,5030,33779,0
74,3868,1296,573,1062,40,33,157,1336,8,201,118,231,209,349,1561,2689,4,12365,686,0,2,21,7,63680,25399,5030,33780,0
88,4625,1457,730,1242,11,6,188,1468,10,292,166,329,302,495,2424,4078,5,22973,1276,1,2,18,18,63680,25401,5030,33781,0
39,2317,652,304,544,16,6,88,668,6,89,51,101,95,152,591,998,3,3399,188,0,2,93,96,63680,25402,5030,33782,0
70,3204,1455,414,1257,16,76,112,1471,5,41,23,46,46,69,231,381,2,1069,59,0,2,24,24,63680,25403,5030,33783,0
8,271,74,35,59,1,0,14,75,3,14,7,14,17,21,58,85,1,128,7,0,2,3,1,63680,25404,5030,33784,0
95,4632,1523,757,1297,19,12,193,1542,12,193,117,230,205,347,1508,2664,7,19053,1058,0,2,1,1,63690,25406,5030,33785,0
39,1696,447,308,343,6,5,95,453,7,96,59,111,103,170,651,1136,4,4600,255,0,2,9,5,63690,25409,5030,33786,0
38,2302,334,251,279,10,4,40,344,5,127,74,143,132,217,899,1528,2,4303,239,0,2,1,1,63690,25410,5030,33787,0
61,2733,1293,570,1093,25,15,163,1318,10,195,123,241,205,364,1516,2795,6,17273,959,0,2,4,2,63700,25412,5030,33788,0
33,1885,384,251,317,7,8,52,391,11,70,44,84,81,128,467,811,6,5355,297,0,2,1,3,63700,25412,5030,33789,0
44,2109,722,423,573,19,0,135,741,12,172,101,199,184,300,1320,2257,6,15668,870,0,2,6,52,63700,25414,5030,33791,0
92,4729,1943,715,1694,26,18,214,1969,12,185,120,237,197,357,1436,2721,7,20915,1161,0,2,54,14,63700,25416,5030,33792,0
35,1068,182,127,129,0,0,53,182,5,39,21,42,44,63,217,343,2,926,51,0,2,15,14,63700,25416,5031,33793,0
91,2944,773,419,590,28,0,166,801,10,204,113,217,214,330,1598,2554,5,13587,754,0,2,5,8,63700,25416,5032,33794,0
76,1715,996,429,845,24,10,117,1020,7,76,50,88,83,138,494,879,4,3565,198,0,2,1,1,63700,25418,5032,33795,0
76,1715,456,277,329,12,42,72,468,13,85,50,97,98,147,592,972,7,7212,400,0,2,1,1,63700,25418,5032,33796,0
43,3113,996,429,845,24,10,117,1020,7,76,50,88,83,138,494,879,4,3565,198,0,2,13,0,63700,25420,5032,33797,0
213,4683,1943,715,1694,26,18,214,1969,12,185,120,237,197,357,1436,2721,7,20915,1161,0,2,15,6,63700,25422,5032,33798,0
213,4683,1168,838,957,57,25,144,1225,19,348,224,416,367,640,3018,5452,11,61921,3440,1,2,15,6,63710,25424,5032,33799,0
94,4721,1943,715,1694,26,18,214,1969,12,185,120,237,197,357,1436,2721,7,20915,1161,0,2,3,3,63710,25426,5032,33800,0
35,1068,182,127,129,0,0,53,182,5,39,21,42,44,63,217,343,2,926,51,0,2,15,14,63710,25426,5033,33801,0
91,2944,773,419,590,28,0,166,801,10,204,113,217,214,330,1598,2554,5,13587,754,0,2,5,8,63710,25426,5034,33802,0
85,2166,1455,414,1257,16,76,112,1471,5,41,23,46,46,69,231,381,2,1069,59,0,2,2,1,63710,25427,5034,33803,0
85,2166,669,365,481,22,61,110,691,15,103,63,122,118,185,747,1273,8,11311,628,0,2,2,1,63720,25427,5035,33804,0
213,4582,1943,715,1694,26,18,214,1969,12,185,120,237,197,357,1436,2721,7,20915,1161,0,2,3,3,63720,25429,5035,33805,0
213,4582,1168,838,957,57,25,144,1225,19,348,224,416,367,640,3018,5452,11,61921,3440,1,2,3,3,63730,25431,5035,33806,0
96,4914,1943,715,1694,26,18,214,1969,12,185,120,237,197,357,1436,2721,7,20915,1161,0,2,50,3,63730,25433,5035,33807,0
177,7829,139,89,101,2,0,35,141,7,54,34,62,61,96,330,569,4,2287,127,0,2,1,0,63730,25433,5035,33808,0
177,7829,7,5,5,0,0,2,7,1,2,1,2,3,3,2,4,0,2,0,0,2,1,0,63730,25433,5035,33809,0
166,5073,1660,832,1314,41,38,274,1701,20,312,209,395,332,604,2671,5058,12,64042,3557,1,2,10,1,63730,25435,5036,33811,0
166,5073,1057,646,719,113,100,145,1170,18,215,134,248,233,382,1740,3004,10,31186,1732,1,2,10,1,63740,25436,5037,33812,0
157,4508,1660,832,1314,41,38,274,1701,20,312,209,395,332,604,2671,5058,12,64042,3557,1,2,29,0,63740,25438,5038,33814,0
212,4659,1943,715,1694,26,18,214,1969,12,185,120,237,197,357,1436,2721,7,20915,1161,0,2,5,16,63740,25440,5038,33815,0
212,4659,1168,838,957,57,25,144,1225,19,348,224,416,367,640,3018,5452,11,61921,3440,1,2,5,16,63750,25442,5038,33816,0
94,4721,1943,715,1694,26,18,214,1969,12,185,120,237,197,357,1436,2721,7,20915,1161,0,2,7,7,63750,25444,5038,33817,0
215,4685,1943,715,1694,26,18,214,1969,12,185,120,237,197,357,1436,2721,7,20915,1161,0,2,20,8,63750,25446,5038,33818,0
215,4685,1168,838,957,57,25,144,1225,19,348,224,416,367,640,3018,5452,11,61921,3440,1,2,20,8,63760,25448,5038,33819,0
95,4853,1943,715,1694,26,18,214,1969,12,185,120,237,197,357,1436,2721,7,20915,1161,0,2,43,0,63760,25450,5038,33820,0
85,2166,1455,414,1257,16,76,112,1471,5,41,23,46,46,69,231,381,2,1069,59,0,2,2,1,63760,25451,5038,33821,0
85,2166,669,365,481,22,61,110,691,15,103,63,122,118,185,747,1273,8,11311,628,0,2,2,1,63770,25451,5039,33822,0
177,7829,139,89,101,2,0,35,141,7,54,34,62,61,96,330,569,4,2287,127,0,2,1,0,63770,25451,5039,33823,0
177,7829,7,5,5,0,0,2,7,1,2,1,2,3,3,2,4,0,2,0,0,2,1,0,63770,25451,5039,33824,0
166,5073,1660,832,1314,41,38,274,1701,20,312,209,395,332,604,2671,5058,12,64042,3557,1,2,10,1,63770,25453,5040,33826,0
166,5073,1057,646,719,113,100,145,1170,18,215,134,248,233,382,1740,3004,10,31186,1732,1,2,10,1,63780,25454,5041,33827,0
157,4508,1660,832,1314,41,38,274,1701,20,312,209,395,332,604,2671,5058,12,64042,3557,1,2,29,0,63780,25456,5042,33829,0
11,413,42,7,35,4,0,5,46,1,2,1,2,3,3,2,4,0,2,0,0,2,1,1,63780,25456,5042,33830,0
11,413,11,6,10,0,0,1,11,2,4,2,4,6,6,10,15,1,15,0,0,2,1,1,63780,25456,5042,33831,0
315,6882,72,33,56,0,4,12,72,1,1,1,1,2,2,0,2,0,1,0,0,2,4,3,63780,25456,5042,33832,0
315,6882,1454,835,1044,76,110,219,1530,17,275,158,296,292,454,2297,3718,9,34017,1889,1,2,4,3,63790,25457,5042,33833,0
70,1382,1178,367,1042,6,15,115,1184,9,94,51,95,103,146,644,976,4,4439,246,0,2,2,2,63790,25457,5042,33834,0
70,1382,177,108,140,8,0,27,185,6,30,16,32,36,48,162,248,3,794,44,0,2,2,2,63790,25459,5042,33835,0
213,4582,1943,715,1694,26,18,214,1969,12,185,120,237,197,357,1436,2721,7,20915,1161,0,2,1,1,63790,25461,5042,33836,0
213,4582,1168,838,957,57,25,144,1225,19,348,224,416,367,640,3018,5452,11,61921,3440,1,2,1,1,63800,25463,5042,33837,0
23,474,601,196,481,2,23,85,603,8,63,36,72,71,108,400,664,4,3036,168,0,2,1,1,63800,25463,5042,33838,0
23,474,156,79,106,5,16,28,161,5,14,8,15,19,23,64,97,2,261,14,0,2,1,1,63800,25463,5042,33839,0
17,774,75,38,59,1,3,12,76,2,4,2,4,6,6,10,15,1,15,0,0,2,1,1,63800,25463,5042,33840,0
11,413,42,7,35,4,0,5,46,1,2,1,2,3,3,2,4,0,2,0,0,2,1,1,63800,25463,5042,33841,0
11,413,11,6,10,0,0,1,11,2,4,2,4,6,6,10,15,1,15,0,0,2,1,1,63800,25463,5042,33842,0
315,6882,72,33,56,0,4,12,72,1,1,1,1,2,2,0,2,0,1,0,0,2,4,3,63800,25463,5042,33843,0
315,6882,1454,835,1044,76,110,219,1530,17,275,158,296,292,454,2297,3718,9,34017,1889,1,2,4,3,63810,25464,5042,33844,0
70,1382,1178,367,1042,6,15,115,1184,9,94,51,95,103,146,644,976,4,4439,246,0,2,2,2,63810,25464,5042,33845,0
70,1382,177,108,140,8,0,27,185,6,30,16,32,36,48,162,248,3,794,44,0,2,2,2,63810,25466,5042,33846,0
213,4582,1943,715,1694,26,18,214,1969,12,185,120,237,197,357,1436,2721,7,20915,1161,0,2,1,1,63810,25468,5042,33847,0
213,4582,1168,838,957,57,25,144,1225,19,348,224,416,367,640,3018,5452,11,61921,3440,1,2,1,1,63820,25470,5042,33848,0
23,474,601,196,481,2,23,85,603,8,63,36,72,71,108,400,664,4,3036,168,0,2,1,1,63820,25470,5042,33849,0
23,474,156,79,106,5,16,28,161,5,14,8,15,19,23,64,97,2,261,14,0,2,1,1,63820,25470,5042,33850,0
17,774,75,38,59,1,3,12,76,2,4,2,4,6,6,10,15,1,15,0,0,2,1,1,63820,25470,5042,33851,0
75,1694,996,429,845,24,10,117,1020,7,76,50,88,83,138,494,879,4,3565,198,0,2,6,9,63820,25472,5042,33852,0
75,1694,456,277,329,12,42,72,468,13,85,50,97,98,147,592,972,7,7212,400,0,2,6,9,63820,25472,5042,33853,0
42,3095,996,429,845,24,10,117,1020,7,76,50,88,83,138,494,879,4,3565,198,0,2,12,7,63820,25474,5042,33854,0
75,1694,996,429,845,24,10,117,1020,7,76,50,88,83,138,494,879,4,3565,198,0,2,6,9,63820,25476,5042,33855,0
75,1694,456,277,329,12,42,72,468,13,85,50,97,98,147,592,972,7,7212,400,0,2,6,9,63820,25476,5042,33856,0
42,3095,996,429,845,24,10,117,1020,7,76,50,88,83,138,494,879,4,3565,198,0,2,12,7,63820,25478,5042,33857,0
11,413,42,7,35,4,0,5,46,1,2,1,2,3,3,2,4,0,2,0,0,2,1,1,63820,25478,5042,33858,0
11,413,11,6,10,0,0,1,11,2,4,2,4,6,6,10,15,1,15,0,0,2,1,1,63820,25478,5042,33859,0
166,5073,1660,832,1314,41,38,274,1701,20,312,209,395,332,604,2671,5058,12,64042,3557,1,2,10,1,63820,25480,5043,33861,0
166,5073,1057,646,719,113,100,145,1170,18,215,134,248,233,382,1740,3004,10,31186,1732,1,2,10,1,63830,25481,5044,33862,0
76,1705,996,429,845,24,10,117,1020,7,76,50,88,83,138,494,879,4,3565,198,0,2,1,1,63830,25483,5044,33863,0
76,1705,456,277,329,12,42,72,468,13,85,50,97,98,147,592,972,7,7212,400,0,2,1,1,63830,25483,5044,33864,0
85,2166,1455,414,1257,16,76,112,1471,5,41,23,46,46,69,231,381,2,1069,59,0,2,2,1,63830,25484,5044,33865,0
85,2166,669,365,481,22,61,110,691,15,103,63,122,118,185,747,1273,8,11311,628,0,2,2,1,63840,25484,5045,33866,0
315,6882,72,33,56,0,4,12,72,1,1,1,1,2,2,0,2,0,1,0,0,2,4,3,63840,25484,5045,33867,0
315,6882,1454,835,1044,76,110,219,1530,17,275,158,296,292,454,2297,3718,9,34017,1889,1,2,4,3,63850,25485,5045,33868,0
70,1382,1178,367,1042,6,15,115,1184,9,94,51,95,103,146,644,976,4,4439,246,0,2,2,2,63850,25485,5045,33869,0
70,1382,177,108,140,8,0,27,185,6,30,16,32,36,48,162,248,3,794,44,0,2,2,2,63850,25487,5045,33870,0
216,4689,1943,715,1694,26,18,214,1969,12,185,120,237,197,357,1436,2721,7,20915,1161,0,2,4,4,63850,25489,5045,33871,0
216,4689,1168,838,957,57,25,144,1225,19,348,224,416,367,640,3018,5452,11,61921,3440,1,2,4,4,63860,25491,5045,33872,0
23,474,601,196,481,2,23,85,603,8,63,36,72,71,108,400,664,4,3036,168,0,2,1,1,63860,25491,5045,33873,0
23,474,156,79,106,5,16,28,161,5,14,8,15,19,23,64,97,2,261,14,0,2,1,1,63860,25491,5045,33874,0
35,1068,182,127,129,0,0,53,182,5,39,21,42,44,63,217,343,2,926,51,0,2,15,14,63860,25491,5046,33875,0
91,2944,773,419,590,28,0,166,801,10,204,113,217,214,330,1598,2554,5,13587,754,0,2,5,8,63860,25491,5047,33876,0
17,774,75,38,59,1,3,12,76,2,4,2,4,6,6,10,15,1,15,0,0,2,1,1,63860,25491,5047,33877,0
177,7829,139,89,101,2,0,35,141,7,54,34,62,61,96,330,569,4,2287,127,0,2,1,0,63860,25491,5047,33878,0
177,7829,7,5,5,0,0,2,7,1,2,1,2,3,3,2,4,0,2,0,0,2,1,0,63860,25491,5047,33879,0
157,4508,1660,832,1314,41,38,274,1701,20,312,209,395,332,604,2671,5058,12,64042,3557,1,2,29,0,63860,25493,5048,33881,0
45,3192,996,429,845,24,10,117,1020,7,76,50,88,83,138,494,879,4,3565,198,0,2,13,0,63860,25495,5048,33882,0
99,5038,1943,715,1694,26,18,214,1969,12,185,120,237,197,357,1436,2721,7,20915,1161,0,2,50,3,63860,25497,5048,33883,0
11,413,42,7,35,4,0,5,46,1,2,1,2,3,3,2,4,0,2,0,0,2,1,1,63860,25497,5048,33884,0
11,413,11,6,10,0,0,1,11,2,4,2,4,6,6,10,15,1,15,0,0,2,1,1,63860,25497,5048,33885,0
213,4576,1943,715,1694,26,18,214,1969,12,185,120,237,197,357,1436,2721,7,20915,1161,0,2,3,5,63860,25499,5048,33886,0
213,4576,1168,838,957,57,25,144,1225,19,348,224,416,367,640,3018,5452,11,61921,3440,1,2,3,5,63870,25501,5048,33887,0
11,413,42,7,35,4,0,5,46,1,2,1,2,3,3,2,4,0,2,0,0,2,1,1,63870,25501,5048,33888,0
11,413,11,6,10,0,0,1,11,2,4,2,4,6,6,10,15,1,15,0,0,2,1,1,63870,25501,5048,33889,0
215,4604,1943,715,1694,26,18,214,1969,12,185,120,237,197,357,1436,2721,7,20915,1161,0,2,12,5,63870,25503,5048,33890,0
215,4604,1168,838,957,57,25,144,1225,19,348,224,416,367,640,3018,5452,11,61921,3440,1,2,12,5,63880,25505,5048,33891,0
11,413,42,7,35,4,0,5,46,1,2,1,2,3,3,2,4,0,2,0,0,2,1,1,63880,25505,5048,33892,0
11,413,11,6,10,0,0,1,11,2,4,2,4,6,6,10,15,1,15,0,0,2,1,1,63880,25505,5048,33893,0
215,4602,1943,715,1694,26,18,214,1969,12,185,120,237,197,357,1436,2721,7,20915,1161,0,2,10,9,63880,25507,5048,33894,0
215,4602,1168,838,957,57,25,144,1225,19,348,224,416,367,640,3018,5452,11,61921,3440,1,2,10,9,63890,25509,5048,33895,0
43,3130,996,429,845,24,10,117,1020,7,76,50,88,83,138,494,879,4,3565,198,0,2,7,14,63890,25511,5048,33896,0
11,413,42,7,35,4,0,5,46,1,2,1,2,3,3,2,4,0,2,0,0,2,1,1,63890,25511,5048,33897,0
11,413,11,6,10,0,0,1,11,2,4,2,4,6,6,10,15,1,15,0,0,2,1,1,63890,25511,5048,33898,0
166,5073,1660,832,1314,41,38,274,1701,20,312,209,395,332,604,2671,5058,12,64042,3557,1,2,10,1,63890,25513,5049,33900,0
166,5073,1057,646,719,113,100,145,1170,18,215,134,248,233,382,1740,3004,10,31186,1732,1,2,10,1,63900,25514,5050,33901,0
76,1705,996,429,845,24,10,117,1020,7,76,50,88,83,138,494,879,4,3565,198,0,2,1,1,63900,25516,5050,33902,0
76,1705,456,277,329,12,42,72,468,13,85,50,97,98,147,592,972,7,7212,400,0,2,1,1,63900,25516,5050,33903,0
85,2166,1455,414,1257,16,76,112,1471,5,41,23,46,46,69,231,381,2,1069,59,0,2,2,1,63900,25517,5050,33904,0
85,2166,669,365,481,22,61,110,691,15,103,63,122,118,185,747,1273,8,11311,628,0,2,2,1,63910,25517,5051,33905,0
315,6882,72,33,56,0,4,12,72,1,1,1,1,2,2,0,2,0,1,0,0,2,4,3,63910,25517,5051,33906,0
315,6882,1454,835,1044,76,110,219,1530,17,275,158,296,292,454,2297,3718,9,34017,1889,1,2,4,3,63920,25518,5051,33907,0
70,1382,1178,367,1042,6,15,115,1184,9,94,51,95,103,146,644,976,4,4439,246,0,2,2,2,63920,25518,5051,33908,0
70,1382,177,108,140,8,0,27,185,6,30,16,32,36,48,162,248,3,794,44,0,2,2,2,63920,25520,5051,33909,0
216,4689,1943,715,1694,26,18,214,1969,12,185,120,237,197,357,1436,2721,7,20915,1161,0,2,4,4,63920,25522,5051,33910,0
216,4689,1168,838,957,57,25,144,1225,19,348,224,416,367,640,3018,5452,11,61921,3440,1,2,4,4,63930,25524,5051,33911,0
23,474,601,196,481,2,23,85,603,8,63,36,72,71,108,400,664,4,3036,168,0,2,1,1,63930,25524,5051,33912,0
23,474,156,79,106,5,16,28,161,5,14,8,15,19,23,64,97,2,261,14,0,2,1,1,63930,25524,5051,33913,0
35,1068,182,127,129,0,0,53,182,5,39,21,42,44,63,217,343,2,926,51,0,2,15,14,63930,25524,5052,33914,0
91,2944,773,419,590,28,0,166,801,10,204,113,217,214,330,1598,2554,5,13587,754,0,2,5,8,63930,25524,5053,33915,0
17,774,75,38,59,1,3,12,76,2,4,2,4,6,6,10,15,1,15,0,0,2,1,1,63930,25524,5053,33916,0
177,7829,139,89,101,2,0,35,141,7,54,34,62,61,96,330,569,4,2287,127,0,2,1,0,63930,25524,5053,33917,0
177,7829,7,5,5,0,0,2,7,1,2,1,2,3,3,2,4,0,2,0,0,2,1,0,63930,25524,5053,33918,0
157,4508,1660,832,1314,41,38,274,1701,20,312,209,395,332,604,2671,5058,12,64042,3557,1,2,29,0,63930,25526,5054,33920,0
43,3130,996,429,845,24,10,117,1020,7,76,50,88,83,138,494,879,4,3565,198,0,2,7,1,63930,25528,5054,33921,0
99,5038,1943,715,1694,26,18,214,1969,12,185,120,237,197,357,1436,2721,7,20915,1161,0,2,50,3,63930,25530,5054,33922,0
175,5294,1660,832,1314,41,38,274,1701,20,312,209,395,332,604,2671,5058,12,64042,3557,1,2,55,15,63930,25532,5055,33924,0
175,5294,1057,646,719,113,100,145,1170,18,215,134,248,233,382,1740,3004,10,31186,1732,1,2,55,15,63940,25533,5056,33925,0
141,3272,77,34,69,0,0,8,77,3,24,16,29,27,45,114,213,1,387,21,0,2,3,2,63940,25533,5056,33926,0
141,3272,712,438,573,51,9,84,763,14,102,71,128,116,199,733,1364,8,11988,666,0,2,3,2,63950,25534,5056,33927,0
1,319,382,65,130,157,2,92,539,4,10,5,10,14,15,41,57,2,114,6,0,2,1,1,63950,25535,5057,33928,0
11,413,42,7,35,4,0,5,46,1,2,1,2,3,3,2,4,0,2,0,0,2,1,1,63950,25535,5057,33929,0
11,413,11,6,10,0,0,1,11,2,4,2,4,6,6,10,15,1,15,0,0,2,1,1,63950,25535,5057,33930,0
215,4602,1943,715,1694,26,18,214,1969,12,185,120,237,197,357,1436,2721,7,20915,1161,0,2,14,8,63950,25537,5057,33931,0
215,4602,1168,838,957,57,25,144,1225,19,348,224,416,367,640,3018,5452,11,61921,3440,1,2,14,8,63960,25539,5057,33932,0
1,319,382,65,130,157,2,92,539,4,10,5,10,14,15,41,57,2,114,6,0,2,1,1,63960,25540,5058,33933,0
179,5366,1660,832,1314,41,38,274,1701,20,312,209,395,332,604,2671,5058,12,64042,3557,1,2,24,7,63960,25542,5059,33935,0
179,5366,1057,646,719,113,100,145,1170,18,215,134,248,233,382,1740,3004,10,31186,1732,1,2,24,7,63970,25543,5060,33936,0
141,3279,77,34,69,0,0,8,77,3,24,16,29,27,45,114,213,1,387,21,0,2,1,1,63970,25543,5060,33937,0
141,3279,712,438,573,51,9,84,763,14,102,71,128,116,199,733,1364,8,11988,666,0,2,1,1,63980,25544,5060,33938,0
162,4813,1660,832,1314,41,38,274,1701,20,312,209,395,332,604,2671,5058,12,64042,3557,1,2,93,14,63980,25546,5061,33940,0
212,4569,2,2,2,0,0,0,2,0,0,0,0,0,0,0,0,0,0,0,0,2,3,1,63980,25546,5061,33940,0
212,4569,99,48,90,1,3,5,100,0,0,0,0,0,0,0,0,0,0,0,0,2,3,1,63980,25547,5061,33941,0
212,4569,8,5,5,2,0,1,10,0,0,0,0,0,0,0,0,0,0,0,0,2,3,1,63980,25547,5061,33942,0
212,4569,1217,716,841,84,126,174,1301,14,185,118,215,199,333,1446,2542,8,20687,1149,0,2,3,1,63990,25549,5061,33943,0
212,4569,160,89,115,0,13,31,160,7,15,11,17,22,28,78,124,3,495,27,0,2,3,1,63990,25549,5061,33944,0
212,4569,10,10,9,9,0,0,19,0,0,0,0,0,0,0,0,0,0,0,0,2,3,1,63990,25549,5062,33945,0
212,4569,173,84,99,8,29,36,181,5,12,7,13,17,20,54,81,2,221,12,0,2,3,1,63990,25550,5062,33946,0
212,4569,3,1,1,3,0,0,6,0,0,0,0,0,0,0,0,0,0,0,0,2,3,1,63990,25550,5062,33947,0
212,4569,2,2,2,0,0,0,2,0,0,0,0,0,0,0,0,0,0,0,0,2,3,1,63990,25550,5062,33947,0
212,4569,99,48,90,1,3,5,100,0,0,0,0,0,0,0,0,0,0,0,0,2,3,1,63990,25551,5062,33948,0
212,4569,8,5,5,2,0,1,10,0,0,0,0,0,0,0,0,0,0,0,0,2,3,1,63990,25551,5062,33949,0
212,4569,1217,716,841,84,126,174,1301,14,185,118,215,199,333,1446,2542,8,20687,1149,0,2,3,1,64000,25553,5062,33950,0
212,4569,160,89,115,0,13,31,160,7,15,11,17,22,28,78,124,3,495,27,0,2,3,1,64000,25553,5062,33951,0
212,4569,10,10,9,9,0,0,19,0,0,0,0,0,0,0,0,0,0,0,0,2,3,1,64000,25553,5063,33952,0
212,4569,173,84,99,8,29,36,181,5,12,7,13,17,20,54,81,2,221,12,0,2,3,1,64000,25554,5063,33953,0
212,4569,3,1,1,3,0,0,6,0,0,0,0,0,0,0,0,0,0,0,0,2,3,1,64000,25554,5063,33954,0
20,507,205,80,86,16,53,53,221,7,18,10,19,25,29,94,134,3,497,27,0,2,24,8,64010,25554,5064,33955,0
20,507,205,80,86,16,53,53,221,7,18,10,19,25,29,94,134,3,497,27,0,2,24,8,64020,25554,5065,33956,0
97,1999,463,295,324,28,62,57,491,12,134,82,154,146,236,989,1696,6,11700,650,0,2,15,0,64030,25555,5065,33957,0
95,3958,1289,550,1043,56,32,155,1345,10,167,93,185,177,278,1266,2075,5,11498,638,0,2,5,0,64030,25557,5066,33958,0
179,5366,1660,832,1314,41,38,274,1701,20,312,209,395,332,604,2671,5058,12,64042,3557,1,2,1,1,64030,25559,5067,33960,0
179,5366,1057,646,719,113,100,145,1170,18,215,134,248,233,382,1740,3004,10,31186,1732,1,2,1,1,64040,25560,5068,33961,0
235,5582,722,423,573,19,0,135,741,12,172,101,199,184,300,1320,2257,6,15668,870,0,2,0,1,64040,25562,5068,33963,0
235,5582,1508,847,911,44,250,301,1552,14,148,88,169,162,257,1120,1886,7,15077,837,0,2,0,1,64040,25563,5069,33964,0
52,622,647,139,84,35,284,233,682,0,0,0,0,0,0,0,0,0,0,0,0,2,19,0,64040,25563,5069,33965,0
24,513,601,196,481,2,23,85,603,8,63,36,72,71,108,400,664,4,3036,168,0,2,31,31,64040,25563,5069,33966,0
24,513,156,79,106,5,16,28,161,5,14,8,15,19,23,64,97,2,261,14,0,2,31,31,64040,25563,5069,33967,0
22,807,601,196,481,2,23,85,603,8,63,36,72,71,108,400,664,4,3036,168,0,2,19,0,64040,25563,5069,33968,0
52,622,647,139,84,35,284,233,682,0,0,0,0,0,0,0,0,0,0,0,0,2,3,3,64040,25563,5069,33969,0
76,1707,53,23,39,0,0,13,53,2,8,4,8,10,12,26,39,1,39,2,0,2,13,3,64040,25563,5069,33970,0
76,1707,515,298,307,33,80,99,548,12,63,44,77,75,121,419,753,7,5527,307,0,2,13,3,64050,25563,5069,33971,0
216,4748,1943,715,1694,26,18,214,1969,12,185,120,237,197,357,1436,2721,7,20915,1161,0,2,26,16,64050,25565,5069,33972,0
216,4748,1168,838,957,57,25,144,1225,19,348,224,416,367,640,3018,5452,11,61921,3440,1,2,26,16,64060,25567,5069,33973,0
24,500,601,196,481,2,23,85,603,8,63,36,72,71,108,400,664,4,3036,168,0,2,15,11,64060,25567,5069,33974,0
24,500,156,79,106,5,16,28,161,5,14,8,15,19,23,64,97,2,261,14,0,2,15,11,64060,25567,5069,33975,0
22,807,601,196,481,2,23,85,603,8,63,36,72,71,108,400,664,4,3036,168,0,2,2,2,64060,25567,5069,33976,0
314,6858,72,33,56,0,4,12,72,1,1,1,1,2,2,0,2,0,1,0,0,2,0,5,64060,25567,5069,33977,0
314,6858,1454,835,1044,76,110,219,1530,17,275,158,296,292,454,2297,3718,9,34017,1889,1,2,0,5,64070,25568,5069,33978,0
217,4757,1943,715,1694,26,18,214,1969,12,185,120,237,197,357,1436,2721,7,20915,1161,0,2,4,2,64070,25570,5069,33979,1
217,4757,1168,838,957,57,25,144,1225,19,348,224,416,367,640,3018,5452,11,61921,3440,1,2,4,2,64080,25572,5069,33980,1
26,557,601,196,481,2,23,85,603,8,63,36,72,71,108,400,664,4,3036,168,0,2,21,11,64080,25572,5069,33981,1
26,557,156,79,106,5,16,28,161,5,14,8,15,19,23,64,97,2,261,14,0,2,21,11,64080,25572,5069,33982,1
23,855,601,196,481,2,23,85,603,8,63,36,72,71,108,400,664,4,3036,168,0,2,25,0,64080,25572,5069,33983,1
79,1795,53,23,39,0,0,13,53,2,8,4,8,10,12,26,39,1,39,2,0,2,17,4,64080,25572,5069,33985,0
79,1795,515,298,307,33,80,99,548,12,63,44,77,75,121,419,753,7,5527,307,0,2,17,4,64090,25572,5069,33986,0
314,6864,72,33,56,0,4,12,72,1,1,1,1,2,2,0,2,0,1,0,0,2,13,7,64090,25572,5069,33987,0
314,6864,1454,835,1044,76,110,219,1530,17,275,158,296,292,454,2297,3718,9,34017,1889,1,2,13,7,64100,25573,5069,33988,0
217,4758,1943,715,1694,26,18,214,1969,12,185,120,237,197,357,1436,2721,7,20915,1161,0,2,3,4,64100,25575,5069,33989,0
217,4758,1168,838,957,57,25,144,1225,19,348,224,416,367,640,3018,5452,11,61921,3440,1,2,3,4,64110,25577,5069,33990,0
94,4062,1020,354,843,12,15,144,1032,8,134,77,144,142,221,970,1580,4,6792,377,0,2,1,1,64110,25577,5069,33993,0
86,1832,402,202,227,24,74,80,426,12,52,33,61,64,94,339,564,7,3969,220,0,2,7,4,64110,25578,5069,33994,1
79,1799,53,23,39,0,0,13,53,2,8,4,8,10,12,26,39,1,39,2,0,2,1,1,64110,25578,5069,33995,1
79,1799,515,298,307,33,80,99,548,12,63,44,77,75,121,419,753,7,5527,307,0,2,1,1,64120,25578,5069,33996,1
314,6871,72,33,56,0,4,12,72,1,1,1,1,2,2,0,2,0,1,0,0,2,5,1,64120,25578,5069,33997,1
314,6871,1454,835,1044,76,110,219,1530,17,275,158,296,292,454,2297,3718,9,34017,1889,1,2,5,1,64130,25579,5069,33998,1
128,5332,1513,682,1277,25,13,200,1538,11,199,116,219,210,335,1557,2584,6,15641,868,0,2,4,3,64130,25581,5069,33999,1
214,4605,2,2,2,0,0,0,2,0,0,0,0,0,0,0,0,0,0,0,0,2,8,1,64130,25581,5069,33999,0
214,4605,99,48,90,1,3,5,100,0,0,0,0,0,0,0,0,0,0,0,0,2,8,1,64130,25582,5069,34000,0
214,4605,8,5,5,2,0,1,10,0,0,0,0,0,0,0,0,0,0,0,0,2,8,1,64130,25582,5069,34001,0
214,4605,1217,716,841,84,126,174,1301,14,185,118,215,199,333,1446,2542,8,20687,1149,0,2,8,1,64140,25584,5069,34002,0
214,4605,160,89,115,0,13,31,160,7,15,11,17,22,28,78,124,3,495,27,0,2,8,1,64140,25584,5069,34003,0
214,4605,10,10,9,9,0,0,19,0,0,0,0,0,0,0,0,0,0,0,0,2,8,1,64140,25584,5070,34004,0
214,4605,173,84,99,8,29,36,181,5,12,7,13,17,20,54,81,2,221,12,0,2,8,1,64140,25585,5070,34005,0
214,4605,3,1,1,3,0,0,6,0,0,0,0,0,0,0,0,0,0,0,0,2,8,1,64140,25585,5070,34006,0
87,1837,402,202,227,24,74,80,426,12,52,33,61,64,94,339,564,7,3969,220,0,2,1,1,64140,25586,5070,34008,0
315,6924,72,33,56,0,4,12,72,1,1,1,1,2,2,0,2,0,1,0,0,2,20,18,64140,25586,5070,34009,0
315,6924,1454,835,1044,76,110,219,1530,17,275,158,296,292,454,2297,3718,9,34017,1889,1,2,20,18,64150,25587,5070,34010,0
27,596,601,196,481,2,23,85,603,8,63,36,72,71,108,400,664,4,3036,168,0,2,8,1,64150,25587,5070,34013,0
27,596,156,79,106,5,16,28,161,5,14,8,15,19,23,64,97,2,261,14,0,2,8,1,64150,25587,5070,34014,0
20,864,75,38,59,1,3,12,76,2,4,2,4,6,6,10,15,1,15,0,0,2,32,8,64150,25587,5070,34015,0
136,5760,1782,648,1425,9,47,279,1791,8,171,97,189,179,286,1292,2140,4,9462,525,0,2,4,40,64150,25588,5071,34016,0
99,5044,1943,715,1694,26,18,214,1969,12,185,120,237,197,357,1436,2721,7,20915,1161,0,2,5,4,64150,25590,5071,34017,0
165,5078,1660,832,1314,41,38,274,1701,20,312,209,395,332,604,2671,5058,12,64042,3557,1,2,14,7,64150,25592,5072,34019,1
165,5078,1057,646,719,113,100,145,1170,18,215,134,248,233,382,1740,3004,10,31186,1732,1,2,14,7,64160,25593,5073,34020,1
76,1699,996,429,845,24,10,117,1020,7,76,50,88,83,138,494,879,4,3565,198,0,2,7,3,64160,25595,5073,34021,1
76,1699,456,277,329,12,42,72,468,13,85,50,97,98,147,592,972,7,7212,400,0,2,7,3,64160,25595,5073,34022,1
217,4679,2,2,2,0,0,0,2,0,0,0,0,0,0,0,0,0,0,0,0,2,23,3,64160,25595,5073,34022,1
217,4679,99,48,90,1,3,5,100,0,0,0,0,0,0,0,0,0,0,0,0,2,23,3,64160,25596,5073,34023,1
217,4679,8,5,5,2,0,1,10,0,0,0,0,0,0,0,0,0,0,0,0,2,23,3,64160,25596,5073,34024,1
217,4679,1217,716,841,84,126,174,1301,14,185,118,215,199,333,1446,2542,8,20687,1149,0,2,23,3,64170,25598,5073,34025,1
217,4679,160,89,115,0,13,31,160,7,15,11,17,22,28,78,124,3,495,27,0,2,23,3,64170,25598,5073,34026,1
217,4679,10,10,9,9,0,0,19,0,0,0,0,0,0,0,0,0,0,0,0,2,23,3,64170,25598,5074,34027,1
217,4679,173,84,99,8,29,36,181,5,12,7,13,17,20,54,81,2,221,12,0,2,23,3,64170,25599,5074,34028,1
217,4679,3,1,1,3,0,0,6,0,0,0,0,0,0,0,0,0,0,0,0,2,23,3,64170,25599,5074,34029,1
49,729,167,116,138,4,5,22,171,8,48,30,56,56,86,292,499,4,2330,129,0,2,18,9,64170,25599,5074,34030,1
254,5836,4293,999,3693,19,54,507,4312,9,155,88,170,164,258,1156,1898,4,9368,520,0,2,6,2,64170,25601,5074,34031,1
254,5836,1482,859,1002,125,135,219,1607,16,219,134,251,235,385,1766,3032,9,27804,1544,1,2,6,2,64180,25602,5074,34032,1
98,2668,1523,757,1297,19,12,193,1542,12,193,117,230,205,347,1508,2664,7,19053,1058,0,2,5,2,64190,25604,5074,34033,1
98,2668,701,378,504,33,58,109,734,13,110,68,126,123,194,794,1346,7,10027,557,0,2,5,2,64190,25605,5075,34034,1
80,1826,53,23,39,0,0,13,53,2,8,4,8,10,12,26,39,1,39,2,0,2,30,4,64190,25605,5075,34035,1
80,1826,515,298,307,33,80,99,548,12,63,44,77,75,121,419,753,7,5527,307,0,2,30,4,64200,25605,5075,34036,1
315,6944,72,33,56,0,4,12,72,1,1,1,1,2,2,0,2,0,1,0,0,2,14,6,64200,25605,5075,34037,1
315,6944,1454,835,1044,76,110,219,1530,17,275,158,296,292,454,2297,3718,9,34017,1889,1,2,14,6,64210,25606,5075,34038,1
30,658,215,129,180,6,0,29,221,8,65,43,72,73,115,415,711,4,3153,175,0,2,3,1,64210,25606,5075,34039,1
30,658,97,69,77,3,3,16,100,6,22,13,23,28,36,113,173,3,542,30,0,2,3,1,64210,25607,5075,34040,1
94,3940,1289,550,1043,56,32,155,1345,10,167,93,185,177,278,1266,2075,5,11498,638,0,2,1,1,64210,25609,5076,34041,1
20,968,75,38,59,1,3,12,76,2,4,2,4,6,6,10,15,1,15,0,0,2,22,6,64210,25609,5076,34042,1
101,4718,1338,495,1086,10,64,173,1348,11,122,82,157,133,239,883,1686,7,11934,663,0,2,11,3,64210,25611,5076,34043,1
136,5760,1782,648,1425,9,47,279,1791,8,171,97,189,179,286,1292,2140,4,9462,525,0,2,2,2,64210,25612,5077,34044,1
111,4139,1450,624,1228,12,26,181,1462,14,306,186,354,320,540,2580,4493,8,36391,2021,1,2,2,1,64210,25614,5078,34045,1
156,4476,1660,832,1314,41,38,274,1701,20,312,209,395,332,604,2671,5058,12,64042,3557,1,2,4,8,64210,25616,5079,34047,1
43,3139,996,429,845,24,10,117,1020,7,76,50,88,83,138,494,879,4,3565,198,0,2,1,0,64210,25618,5079,34048,1
90,4662,1457,730,1242,11,6,188,1468,10,292,166,329,302,495,2424,4078,5,22973,1276,1,2,22,15,64210,25620,5079,34049,1
95,4642,1523,757,1297,19,12,193,1542,12,193,117,230,205,347,1508,2664,7,19053,1058,0,2,5,1,64220,25622,5079,34050,1
16,1224,215,129,180,6,0,29,221,8,65,43,72,73,115,415,711,4,3153,175,0,2,3,0,64220,25622,5079,34051,1
23,855,601,196,481,2,23,85,603,8,63,36,72,71,108,400,664,4,3036,168,0,2,1,1,64220,25622,5079,34052,1
217,4679,2,2,2,0,0,0,2,0,0,0,0,0,0,0,0,0,0,0,0,2,2,2,64220,25622,5079,34052,0
217,4679,99,48,90,1,3,5,100,0,0,0,0,0,0,0,0,0,0,0,0,2,2,2,64220,25623,5079,34053,0
217,4679,8,5,5,2,0,1,10,0,0,0,0,0,0,0,0,0,0,0,0,2,2,2,64220,25623,5079,34054,0
217,4679,1217,716,841,84,126,174,1301,14,185,118,215,199,333,1446,2542,8,20687,1149,0,2,2,2,64230,25625,5079,34055,0
217,4679,160,89,115,0,13,31,160,7,15,11,17,22,28,78,124,3,495,27,0,2,2,2,64230,25625,5079,34056,0
217,4679,10,10,9,9,0,0,19,0,0,0,0,0,0,0,0,0,0,0,0,2,2,2,64230,25625,5080,34057,0
217,4679,173,84,99,8,29,36,181,5,12,7,13,17,20,54,81,2,221,12,0,2,2,2,64230,25626,5080,34058,0
217,4679,3,1,1,3,0,0,6,0,0,0,0,0,0,0,0,0,0,0,0,2,2,2,64230,25626,5080,34059,0
315,6939,72,33,56,0,4,12,72,1,1,1,1,2,2,0,2,0,1,0,0,2,3,7,64230,25626,5080,34060,0
315,6939,1454,835,1044,76,110,219,1530,17,275,158,296,292,454,2297,3718,9,34017,1889,1,2,3,7,64240,25627,5080,34061,0
156,4472,1660,832,1314,41,38,274,1701,20,312,209,395,332,604,2671,5058,12,64042,3557,1,2,1,2,64240,25629,5081,34065,0
94,4062,1020,354,843,12,15,144,1032,8,134,77,144,142,221,970,1580,4,6792,377,0,2,1,1,64240,25629,5081,34066,0
30,634,601,196,481,2,23,85,603,8,63,36,72,71,108,400,664,4,3036,168,0,2,8,0,64240,25629,5081,34069,0
30,634,156,79,106,5,16,28,161,5,14,8,15,19,23,64,97,2,261,14,0,2,8,0,64240,25629,5081,34070,0
102,4744,1338,495,1086,10,64,173,1348,11,122,82,157,133,239,883,1686,7,11934,663,0,2,20,23,64240,25631,5081,34071,0
29,1088,601,196,481,2,23,85,603,8,63,36,72,71,108,400,664,4,3036,168,0,2,73,0,64240,25631,5081,34072,0
33,1200,601,196,481,2,23,85,603,8,63,36,72,71,108,400,664,4,3036,168,0,2,40,0,64240,25631,5081,34073,0
217,4692,2,2,2,0,0,0,2,0,0,0,0,0,0,0,0,0,0,0,0,2,6,4,64240,25631,5081,34073,1
217,4692,99,48,90,1,3,5,100,0,0,0,0,0,0,0,0,0,0,0,0,2,6,4,64240,25632,5081,34074,1
217,4692,8,5,5,2,0,1,10,0,0,0,0,0,0,0,0,0,0,0,0,2,6,4,64240,25632,5081,34075,1
217,4692,1217,716,841,84,126,174,1301,14,185,118,215,199,333,1446,2542,8,20687,1149,0,2,6,4,64250,25634,5081,34076,1
217,4692,160,89,115,0,13,31,160,7,15,11,17,22,28,78,124,3,495,27,0,2,6,4,64250,25634,5081,34077,1
217,4692,10,10,9,9,0,0,19,0,0,0,0,0,0,0,0,0,0,0,0,2,6,4,64250,25634,5082,34078,1
217,4692,173,84,99,8,29,36,181,5,12,7,13,17,20,54,81,2,221,12,0,2,6,4,64250,25635,5082,34079,1
217,4692,3,1,1,3,0,0,6,0,0,0,0,0,0,0,0,0,0,0,0,2,6,4,64250,25635,5082,34080,1
51,767,167,116,138,4,5,22,171,8,48,30,56,56,86,292,499,4,2330,129,0,2,20,19,64250,25635,5082,34081,1
52,622,647,139,84,35,284,233,682,0,0,0,0,0,0,0,0,0,0,0,0,2,14,2,64250,25635,5082,34082,1
30,663,215,129,180,6,0,29,221,8,65,43,72,73,115,415,711,4,3153,175,0,2,2,2,64250,25635,5082,34083,1
30,663,97,69,77,3,3,16,100,6,22,13,23,28,36,113,173,3,542,30,0,2,2,2,64250,25636,5082,34084,1
31,704,601,196,481,2,23,85,603,8,63,36,72,71,108,400,664,4,3036,168,0,2,17,0,64250,25636,5082,34085,1
31,704,156,79,106,5,16,28,161,5,14,8,15,19,23,64,97,2,261,14,0,2,17,0,64250,25636,5082,34086,1
20,911,75,38,59,1,3,12,76,2,4,2,4,6,6,10,15,1,15,0,0,2,3,15,64250,25636,5082,34087,1
165,5086,1660,832,1314,41,38,274,1701,20,312,209,395,332,604,2671,5058,12,64042,3557,1,2,4,3,64250,25638,5083,34089,1
165,5086,1057,646,719,113,100,145,1170,18,215,134,248,233,382,1740,3004,10,31186,1732,1,2,4,3,64260,25639,5084,34090,1
98,2666,1523,757,1297,19,12,193,1542,12,193,117,230,205,347,1508,2664,7,19053,1058,0,2,2,3,64270,25641,5084,34092,1
98,2666,701,378,504,33,58,109,734,13,110,68,126,123,194,794,1346,7,10027,557,0,2,2,3,64270,25642,5085,34093,1
235,5586,722,423,573,19,0,135,741,12,172,101,199,184,300,1320,2257,6,15668,870,0,2,1,1,64270,25644,5085,34095,1
235,5586,1508,847,911,44,250,301,1552,14,148,88,169,162,257,1120,1886,7,15077,837,0,2,1,1,64270,25645,5086,34096,1
220,4815,1943,715,1694,26,18,214,1969,12,185,120,237,197,357,1436,2721,7,20915,1161,0,2,21,6,64270,25647,5086,34097,1
220,4815,1168,838,957,57,25,144,1225,19,348,224,416,367,640,3018,5452,11,61921,3440,1,2,21,6,64280,25649,5086,34098,1
156,4471,1660,832,1314,41,38,274,1701,20,312,209,395,332,604,2671,5058,12,64042,3557,1,2,10,5,64280,25651,5087,34100,1
95,4639,1523,757,1297,19,12,193,1542,12,193,117,230,205,347,1508,2664,7,19053,1058,0,2,1,4,64290,25653,5087,34101,1
33,1183,601,196,481,2,23,85,603,8,63,36,72,71,108,400,664,4,3036,168,0,2,2,5,64290,25653,5087,34102,1
235,5588,722,423,573,19,0,135,741,12,172,101,199,184,300,1320,2257,6,15668,870,0,2,4,2,64290,25655,5087,34104,0
235,5588,1508,847,911,44,250,301,1552,14,148,88,169,162,257,1120,1886,7,15077,837,0,2,4,2,64290,25656,5088,34105,0
1,54,37,13,25,0,6,6,37,1,2,1,2,3,3,2,4,0,2,0,0,2,17,0,64290,25656,5088,34106,0
1,54,133,47,40,1,43,49,134,0,0,0,0,0,0,0,0,0,0,0,0,2,17,0,64290,25656,5088,34107,0
235,5588,722,423,573,19,0,135,741,12,172,101,199,184,300,1320,2257,6,15668,870,0,2,1,1,64290,25658,5088,34109,0
235,5588,1508,847,911,44,250,301,1552,14,148,88,169,162,257,1120,1886,7,15077,837,0,2,1,1,64290,25659,5089,34110,0
1,54,37,13,25,0,6,6,37,1,2,1,2,3,3,2,4,0,2,0,0,2,1,1,64290,25659,5089,34111,0
1,54,133,47,40,1,43,49,134,0,0,0,0,0,0,0,0,0,0,0,0,2,1,1,64290,25659,5089,34112,0
315,6939,72,33,56,0,4,12,72,1,1,1,1,2,2,0,2,0,1,0,0,2,0,5,64290,25659,5089,34113,0
315,6939,1454,835,1044,76,110,219,1530,17,275,158,296,292,454,2297,3718,9,34017,1889,1,2,0,5,64300,25660,5089,34114,0
31,704,601,196,481,2,23,85,603,8,63,36,72,71,108,400,664,4,3036,168,0,2,1,0,64300,25660,5089,34115,0
31,704,156,79,106,5,16,28,161,5,14,8,15,19,23,64,97,2,261,14,0,2,1,0,64300,25660,5089,34116,0
80,1826,53,23,39,0,0,13,53,2,8,4,8,10,12,26,39,1,39,2,0,2,1,0,64300,25660,5089,34117,0
80,1826,515,298,307,33,80,99,548,12,63,44,77,75,121,419,753,7,5527,307,0,2,1,0,64310,25660,5089,34118,0
97,1999,463,295,324,28,62,57,491,12,134,82,154,146,236,989,1696,6,11700,650,0,2,15,0,64320,25661,5089,34119,0
95,3958,1289,550,1043,56,32,155,1345,10,167,93,185,177,278,1266,2075,5,11498,638,0,2,5,0,64320,25663,5090,34120,0
165,5085,1660,832,1314,41,38,274,1701,20,312,209,395,332,604,2671,5058,12,64042,3557,1,2,1,1,64320,25665,5091,34122,0
165,5085,1057,646,719,113,100,145,1170,18,215,134,248,233,382,1740,3004,10,31186,1732,1,2,1,1,64330,25666,5092,34123,0
166,5096,1660,832,1314,41,38,274,1701,20,312,209,395,332,604,2671,5058,12,64042,3557,1,2,1,1,64330,25668,5093,34125,0
166,5096,1057,646,719,113,100,145,1170,18,215,134,248,233,382,1740,3004,10,31186,1732,1,2,1,1,64340,25669,5094,34126,0
111,4170,1450,624,1228,12,26,181,1462,14,306,186,354,320,540,2580,4493,8,36391,2021,1,2,12,3,64340,25671,5095,34127,0
76,1699,996,429,845,24,10,117,1020,7,76,50,88,83,138,494,879,4,3565,198,0,2,1,1,64340,25673,5095,34128,0
76,1699,456,277,329,12,42,72,468,13,85,50,97,98,147,592,972,7,7212,400,0,2,1,1,64340,25673,5095,34129,0
217,4683,2,2,2,0,0,0,2,0,0,0,0,0,0,0,0,0,0,0,0,2,4,5,64340,25673,5095,34129,1
217,4683,99,48,90,1,3,5,100,0,0,0,0,0,0,0,0,0,0,0,0,2,4,5,64340,25674,5095,34130,1
217,4683,8,5,5,2,0,1,10,0,0,0,0,0,0,0,0,0,0,0,0,2,4,5,64340,25674,5095,34131,1
217,4683,1217,716,841,84,126,174,1301,14,185,118,215,199,333,1446,2542,8,20687,1149,0,2,4,5,64350,25676,5095,34132,1
217,4683,160,89,115,0,13,31,160,7,15,11,17,22,28,78,124,3,495,27,0,2,4,5,64350,25676,5095,34133,1
217,4683,10,10,9,9,0,0,19,0,0,0,0,0,0,0,0,0,0,0,0,2,4,5,64350,25676,5096,34134,1
217,4683,173,84,99,8,29,36,181,5,12,7,13,17,20,54,81,2,221,12,0,2,4,5,64350,25677,5096,34135,1
217,4683,3,1,1,3,0,0,6,0,0,0,0,0,0,0,0,0,0,0,0,2,4,5,64350,25677,5096,34136,1
254,5836,4293,999,3693,19,54,507,4312,9,155,88,170,164,258,1156,1898,4,9368,520,0,2,2,1,64350,25679,5096,34138,1
254,5836,1482,859,1002,125,135,219,1607,16,219,134,251,235,385,1766,3032,9,27804,1544,1,2,2,1,64360,25680,5096,34139,1
98,2660,1523,757,1297,19,12,193,1542,12,193,117,230,205,347,1508,2664,7,19053,1058,0,2,2,3,64370,25682,5096,34140,1
98,2660,701,378,504,33,58,109,734,13,110,68,126,123,194,794,1346,7,10027,557,0,2,2,3,64370,25683,5097,34141,1
87,1836,402,202,227,24,74,80,426,12,52,33,61,64,94,339,564,7,3969,220,0,2,7,5,64370,25684,5097,34142,1
80,1834,53,23,39,0,0,13,53,2,8,4,8,10,12,26,39,1,39,2,0,2,14,12,64370,25684,5097,34143,1
80,1834,515,298,307,33,80,99,548,12,63,44,77,75,121,419,753,7,5527,307,0,2,14,12,64380,25684,5097,34144,1
235,5585,722,423,573,19,0,135,741,12,172,101,199,184,300,1320,2257,6,15668,870,0,2,3,5,64380,25686,5097,34146,1
235,5585,1508,847,911,44,250,301,1552,14,148,88,169,162,257,1120,1886,7,15077,837,0,2,3,5,64380,25687,5098,34147,1
314,6932,72,33,56,0,4,12,72,1,1,1,1,2,2,0,2,0,1,0,0,2,15,18,64380,25687,5098,34148,1
314,6932,1454,835,1044,76,110,219,1530,17,275,158,296,292,454,2297,3718,9,34017,1889,1,2,15,18,64390,25688,5098,34149,1
1,62,37,13,25,0,6,6,37,1,2,1,2,3,3,2,4,0,2,0,0,2,3,0,64390,25688,5098,34150,1
1,62,133,47,40,1,43,49,134,0,0,0,0,0,0,0,0,0,0,0,0,2,3,0,64390,25688,5098,34151,1
31,716,601,196,481,2,23,85,603,8,63,36,72,71,108,400,664,4,3036,168,0,2,3,3,64390,25688,5098,34152,1
31,716,156,79,106,5,16,28,161,5,14,8,15,19,23,64,97,2,261,14,0,2,3,3,64390,25688,5098,34153,1
94,3938,1289,550,1043,56,32,155,1345,10,167,93,185,177,278,1266,2075,5,11498,638,0,2,1,1,64390,25690,5099,34154,1
20,918,75,38,59,1,3,12,76,2,4,2,4,6,6,10,15,1,15,0,0,2,2,1,64390,25690,5099,34155,1
136,5782,1782,648,1425,9,47,279,1791,8,171,97,189,179,286,1292,2140,4,9462,525,0,2,4,4,64390,25691,5100,34156,1
95,4080,1020,354,843,12,15,144,1032,8,134,77,144,142,221,970,1580,4,6792,377,0,2,5,1,64390,25691,5100,34157,1
2,145,53,23,39,0,0,13,53,2,8,4,8,10,12,26,39,1,39,2,0,2,11,0,64390,25691,5100,34158,1
31,712,601,196,481,2,23,85,603,8,63,36,72,71,108,400,664,4,3036,168,0,2,1,1,64390,25691,5100,34159,0
31,712,156,79,106,5,16,28,161,5,14,8,15,19,23,64,97,2,261,14,0,2,1,1,64390,25691,5100,34160,0
43,3157,996,429,845,24,10,117,1020,7,76,50,88,83,138,494,879,4,3565,198,0,2,2,0,64390,25693,5100,34161,1
166,5096,1660,832,1314,41,38,274,1701,20,312,209,395,332,604,2671,5058,12,64042,3557,1,2,1,1,64390,25695,5101,34163,0
166,5096,1057,646,719,113,100,145,1170,18,215,134,248,233,382,1740,3004,10,31186,1732,1,2,1,1,64400,25696,5102,34164,0
43,3157,996,429,845,24,10,117,1020,7,76,50,88,83,138,494,879,4,3565,198,0,2,3,1,64400,25698,5102,34165,0
98,2660,1523,757,1297,19,12,193,1542,12,193,117,230,205,347,1508,2664,7,19053,1058,0,2,2,4,64410,25700,5102,34167,1
98,2660,701,378,504,33,58,109,734,13,110,68,126,123,194,794,1346,7,10027,557,0,2,2,4,64410,25701,5103,34168,1
87,1836,402,202,227,24,74,80,426,12,52,33,61,64,94,339,564,7,3969,220,0,2,1,1,64410,25702,5103,34169,1
82,1862,53,23,39,0,0,13,53,2,8,4,8,10,12,26,39,1,39,2,0,2,40,5,64410,25702,5103,34170,1
82,1862,515,298,307,33,80,99,548,12,63,44,77,75,121,419,753,7,5527,307,0,2,40,5,64420,25702,5103,34171,1
235,5585,722,423,573,19,0,135,741,12,172,101,199,184,300,1320,2257,6,15668,870,0,2,1,1,64420,25704,5103,34173,1
235,5585,1508,847,911,44,250,301,1552,14,148,88,169,162,257,1120,1886,7,15077,837,0,2,1,1,64420,25705,5104,34174,1
314,6932,72,33,56,0,4,12,72,1,1,1,1,2,2,0,2,0,1,0,0,2,5,5,64420,25705,5104,34175,1
314,6932,1454,835,1044,76,110,219,1530,17,275,158,296,292,454,2297,3718,9,34017,1889,1,2,5,5,64430,25706,5104,34176,1
90,4662,1457,730,1242,11,6,188,1468,10,292,166,329,302,495,2424,4078,5,22973,1276,1,2,1,1,64430,25708,5104,34177,1
95,4080,1020,354,843,12,15,144,1032,8,134,77,144,142,221,970,1580,4,6792,377,0,2,1,1,64430,25708,5104,34178,1
2,145,53,23,39,0,0,13,53,2,8,4,8,10,12,26,39,1,39,2,0,2,1,1,64430,25708,5104,34179,1
52,622,647,139,84,35,284,233,682,0,0,0,0,0,0,0,0,0,0,0,0,2,5,2,64430,25708,5104,34180,0
33,814,601,196,481,2,23,85,603,8,63,36,72,71,108,400,664,4,3036,168,0,2,28,6,64430,25708,5104,34181,0
33,814,156,79,106,5,16,28,161,5,14,8,15,19,23,64,97,2,261,14,0,2,28,6,64430,25708,5104,34182,0
34,1230,601,196,481,2,23,85,603,8,63,36,72,71,108,400,664,4,3036,168,0,2,32,4,64430,25708,5104,34183,0
76,1714,996,429,845,24,10,117,1020,7,76,50,88,83,138,494,879,4,3565,198,0,2,5,4,64430,25710,5104,34184,0
76,1714,456,277,329,12,42,72,468,13,85,50,97,98,147,592,972,7,7212,400,0,2,5,4,64430,25710,5104,34185,0
166,5101,1660,832,1314,41,38,274,1701,20,312,209,395,332,604,2671,5058,12,64042,3557,1,2,2,2,64430,25712,5105,34187,1
166,5101,1057,646,719,113,100,145,1170,18,215,134,248,233,382,1740,3004,10,31186,1732,1,2,2,2,64440,25713,5106,34188,1
217,4685,2,2,2,0,0,0,2,0,0,0,0,0,0,0,0,0,0,0,0,2,5,4,64440,25713,5106,34188,1
217,4685,99,48,90,1,3,5,100,0,0,0,0,0,0,0,0,0,0,0,0,2,5,4,64440,25714,5106,34189,1
217,4685,8,5,5,2,0,1,10,0,0,0,0,0,0,0,0,0,0,0,0,2,5,4,64440,25714,5106,34190,1
217,4685,1217,716,841,84,126,174,1301,14,185,118,215,199,333,1446,2542,8,20687,1149,0,2,5,4,64450,25716,5106,34191,1
217,4685,160,89,115,0,13,31,160,7,15,11,17,22,28,78,124,3,495,27,0,2,5,4,64450,25716,5106,34192,1
217,4685,10,10,9,9,0,0,19,0,0,0,0,0,0,0,0,0,0,0,0,2,5,4,64450,25716,5107,34193,1
217,4685,173,84,99,8,29,36,181,5,12,7,13,17,20,54,81,2,221,12,0,2,5,4,64450,25717,5107,34194,1
217,4685,3,1,1,3,0,0,6,0,0,0,0,0,0,0,0,0,0,0,0,2,5,4,64450,25717,5107,34195,1
254,5841,4293,999,3693,19,54,507,4312,9,155,88,170,164,258,1156,1898,4,9368,520,0,2,4,2,64450,25719,5107,34197,1
254,5841,1482,859,1002,125,135,219,1607,16,219,134,251,235,385,1766,3032,9,27804,1544,1,2,4,2,64460,25720,5107,34198,1
314,6935,72,33,56,0,4,12,72,1,1,1,1,2,2,0,2,0,1,0,0,2,4,2,64460,25720,5107,34199,1
314,6935,1454,835,1044,76,110,219,1530,17,275,158,296,292,454,2297,3718,9,34017,1889,1,2,4,2,64470,25721,5107,34200,1
20,927,75,38,59,1,3,12,76,2,4,2,4,6,6,10,15,1,15,0,0,2,3,3,64470,25721,5107,34201,1
86,1893,53,23,39,0,0,13,53,2,8,4,8,10,12,26,39,1,39,2,0,2,10,2,64470,25721,5107,34202,0
86,1893,515,298,307,33,80,99,548,12,63,44,77,75,121,419,753,7,5527,307,0,2,10,2,64480,25721,5107,34203,0
92,4702,1457,730,1242,11,6,188,1468,10,292,166,329,302,495,2424,4078,5,22973,1276,1,2,8,3,64480,25723,5107,34204,0
313,6932,72,33,56,0,4,12,72,1,1,1,1,2,2,0,2,0,1,0,0,2,1,2,64480,25723,5107,34205,0
313,6932,1454,835,1044,76,110,219,1530,17,275,158,296,292,454,2297,3718,9,34017,1889,1,2,1,2,64490,25724,5107,34206,0
313,6930,72,33,56,0,4,12,72,1,1,1,1,2,2,0,2,0,1,0,0,2,3,3,64490,25724,5107,34207,0
313,6930,1454,835,1044,76,110,219,1530,17,275,158,296,292,454,2297,3718,9,34017,1889,1,2,3,3,64500,25725,5107,34208,0
136,5790,1782,648,1425,9,47,279,1791,8,171,97,189,179,286,1292,2140,4,9462,525,0,2,2,2,64500,25726,5108,34209,0
52,622,647,139,84,35,284,233,682,0,0,0,0,0,0,0,0,0,0,0,0,2,2,5,64500,25726,5108,34210,0
31,726,601,196,481,2,23,85,603,8,63,36,72,71,108,400,664,4,3036,168,0,2,2,18,64500,25726,5108,34211,0
31,726,156,79,106,5,16,28,161,5,14,8,15,19,23,64,97,2,261,14,0,2,2,18,64500,25726,5108,34212,0
34,1230,601,196,481,2,23,85,603,8,63,36,72,71,108,400,664,4,3036,168,0,2,3,3,64500,25726,5108,34213,0
39,1718,386,256,301,16,9,68,402,4,59,35,69,63,104,355,621,2,1453,80,0,2,3,3,64500,25726,5108,34214,0
136,5794,1782,648,1425,9,47,279,1791,8,171,97,189,179,286,1292,2140,4,9462,525,0,2,1,1,64500,25727,5109,34215,0
86,1893,53,23,39,0,0,13,53,2,8,4,8,10,12,26,39,1,39,2,0,2,10,6,64500,25727,5109,34216,0
86,1893,515,298,307,33,80,99,548,12,63,44,77,75,121,419,753,7,5527,307,0,2,10,6,64510,25727,5109,34217,0
95,4101,1020,354,843,12,15,144,1032,8,134,77,144,142,221,970,1580,4,6792,377,0,2,7,2,64510,25727,5109,34218,0
179,5366,1660,832,1314,41,38,274,1701,20,312,209,395,332,604,2671,5058,12,64042,3557,1,2,64,7,64510,25729,5110,34220,0
179,5366,1057,646,719,113,100,145,1170,18,215,134,248,233,382,1740,3004,10,31186,1732,1,2,64,7,64520,25730,5111,34221,0
141,3279,77,34,69,0,0,8,77,3,24,16,29,27,45,114,213,1,387,21,0,2,4,3,64520,25730,5111,34222,0
141,3279,712,438,573,51,9,84,763,14,102,71,128,116,199,733,1364,8,11988,666,0,2,4,3,64530,25731,5111,34223,0
162,4813,1660,832,1314,41,38,274,1701,20,312,209,395,332,604,2671,5058,12,64042,3557,1,2,93,14,64530,25733,5112,34225,0
31,726,601,196,481,2,23,85,603,8,63,36,72,71,108,400,664,4,3036,168,0,2,1,1,64530,25733,5112,34226,0
31,726,156,79,106,5,16,28,161,5,14,8,15,19,23,64,97,2,261,14,0,2,1,1,64530,25733,5112,34227,0
35,1271,601,196,481,2,23,85,603,8,63,36,72,71,108,400,664,4,3036,168,0,2,16,0,64530,25733,5112,34228,0
166,5101,1660,832,1314,41,38,274,1701,20,312,209,395,332,604,2671,5058,12,64042,3557,1,2,16,8,64530,25735,5113,34230,0
166,5101,1057,646,719,113,100,145,1170,18,215,134,248,233,382,1740,3004,10,31186,1732,1,2,16,8,64540,25736,5114,34231,0
76,1714,996,429,845,24,10,117,1020,7,76,50,88,83,138,494,879,4,3565,198,0,2,8,3,64540,25738,5114,34232,0
76,1714,456,277,329,12,42,72,468,13,85,50,97,98,147,592,972,7,7212,400,0,2,8,3,64540,25738,5114,34233,0
217,4685,2,2,2,0,0,0,2,0,0,0,0,0,0,0,0,0,0,0,0,2,33,4,64540,25738,5114,34233,0
217,4685,99,48,90,1,3,5,100,0,0,0,0,0,0,0,0,0,0,0,0,2,33,4,64540,25739,5114,34234,0
217,4685,8,5,5,2,0,1,10,0,0,0,0,0,0,0,0,0,0,0,0,2,33,4,64540,25739,5114,34235,0
217,4685,1217,716,841,84,126,174,1301,14,185,118,215,199,333,1446,2542,8,20687,1149,0,2,33,4,64550,25741,5114,34236,0
217,4685,160,89,115,0,13,31,160,7,15,11,17,22,28,78,124,3,495,27,0,2,33,4,64550,25741,5114,34237,0
217,4685,10,10,9,9,0,0,19,0,0,0,0,0,0,0,0,0,0,0,0,2,33,4,64550,25741,5115,34238,0
217,4685,173,84,99,8,29,36,181,5,12,7,13,17,20,54,81,2,221,12,0,2,33,4,64550,25742,5115,34239,0
217,4685,3,1,1,3,0,0,6,0,0,0,0,0,0,0,0,0,0,0,0,2,33,4,64550,25742,5115,34240,0
51,767,167,116,138,4,5,22,171,8,48,30,56,56,86,292,499,4,2330,129,0,2,24,14,64550,25742,5115,34241,0
254,5841,4293,999,3693,19,54,507,4312,9,155,88,170,164,258,1156,1898,4,9368,520,0,2,10,3,64550,25744,5115,34243,0
254,5841,1482,859,1002,125,135,219,1607,16,219,134,251,235,385,1766,3032,9,27804,1544,1,2,10,3,64560,25745,5115,34244,0
52,622,647,139,84,35,284,233,682,0,0,0,0,0,0,0,0,0,0,0,0,2,32,1,64560,25745,5115,34245,0
98,2660,1523,757,1297,19,12,193,1542,12,193,117,230,205,347,1508,2664,7,19053,1058,0,2,5,6,64570,25747,5115,34246,0
98,2660,701,378,504,33,58,109,734,13,110,68,126,123,194,794,1346,7,10027,557,0,2,5,6,64570,25748,5116,34247,0
87,1836,402,202,227,24,74,80,426,12,52,33,61,64,94,339,564,7,3969,220,0,2,10,5,64570,25749,5116,34248,0
86,1893,53,23,39,0,0,13,53,2,8,4,8,10,12,26,39,1,39,2,0,2,105,6,64570,25749,5116,34249,0
86,1893,515,298,307,33,80,99,548,12,63,44,77,75,121,419,753,7,5527,307,0,2,105,6,64580,25749,5116,34250,0
235,5585,722,423,573,19,0,135,741,12,172,101,199,184,300,1320,2257,6,15668,870,0,2,3,4,64580,25751,5116,34252,0
235,5585,1508,847,911,44,250,301,1552,14,148,88,169,162,257,1120,1886,7,15077,837,0,2,3,4,64580,25752,5117,34253,0
313,6930,72,33,56,0,4,12,72,1,1,1,1,2,2,0,2,0,1,0,0,2,40,36,64580,25752,5117,34254,0
313,6930,1454,835,1044,76,110,219,1530,17,275,158,296,292,454,2297,3718,9,34017,1889,1,2,40,36,64590,25753,5117,34255,0
30,663,215,129,180,6,0,29,221,8,65,43,72,73,115,415,711,4,3153,175,0,2,3,1,64590,25753,5117,34256,0
30,663,97,69,77,3,3,16,100,6,22,13,23,28,36,113,173,3,542,30,0,2,3,1,64590,25754,5117,34257,0
220,4815,1943,715,1694,26,18,214,1969,12,185,120,237,197,357,1436,2721,7,20915,1161,0,2,45,19,64590,25756,5117,34258,0
220,4815,1168,838,957,57,25,144,1225,19,348,224,416,367,640,3018,5452,11,61921,3440,1,2,45,19,64600,25758,5117,34259,0
1,62,37,13,25,0,6,6,37,1,2,1,2,3,3,2,4,0,2,0,0,0,42,0,64600,25758,5117,34260,0
1,62,133,47,40,1,43,49,134,0,0,0,0,0,0,0,0,0,0,0,0,0,42,0,64600,25758,5117,34261,0
31,726,601,196,481,2,23,85,603,8,63,36,72,71,108,400,664,4,3036,168,0,2,94,41,64600,25758,5117,34262,0
31,726,156,79,106,5,16,28,161,5,14,8,15,19,23,64,97,2,261,14,0,2,94,41,64600,25758,5117,34263,0
20,927,75,38,59,1,3,12,76,2,4,2,4,6,6,10,15,1,15,0,0,2,46,17,64600,25758,5117,34264,0
102,4744,1338,495,1086,10,64,173,1348,11,122,82,157,133,239,883,1686,7,11934,663,0,2,31,26,64600,25760,5117,34265,0
136,5794,1782,648,1425,9,47,279,1791,8,171,97,189,179,286,1292,2140,4,9462,525,0,2,8,44,64600,25761,5118,34266,0
111,4170,1450,624,1228,12,26,181,1462,14,306,186,354,320,540,2580,4493,8,36391,2021,1,2,13,3,64600,25763,5119,34267,0
156,4471,1660,832,1314,41,38,274,1701,20,312,209,395,332,604,2671,5058,12,64042,3557,1,2,10,10,64600,25765,5120,34269,0
43,3157,996,429,845,24,10,117,1020,7,76,50,88,83,138,494,879,4,3565,198,0,2,5,0,64600,25767,5120,34270,0
128,5332,1513,682,1277,25,13,200,1538,11,199,116,219,210,335,1557,2584,6,15641,868,0,2,4,3,64600,25769,5120,34271,0
92,4702,1457,730,1242,11,6,188,1468,10,292,166,329,302,495,2424,4078,5,22973,1276,1,2,30,18,64600,25771,5120,34272,0
95,4639,1523,757,1297,19,12,193,1542,12,193,117,230,205,347,1508,2664,7,19053,1058,0,2,2,1,64610,25773,5120,34273,0
95,4101,1020,354,843,12,15,144,1032,8,134,77,144,142,221,970,1580,4,6792,377,0,2,12,3,64610,25773,5120,34274,0
2,145,53,23,39,0,0,13,53,2,8,4,8,10,12,26,39,1,39,2,0,2,11,0,64610,25773,5120,34275,0
39,1718,386,256,301,16,9,68,402,4,59,35,69,63,104,355,621,2,1453,80,0,2,3,3,64610,25773,5120,34276,0
16,1224,215,129,180,6,0,29,221,8,65,43,72,73,115,415,711,4,3153,175,0,2,3,0,64610,25773,5120,34277,0
99,5044,1943,715,1694,26,18,214,1969,12,185,120,237,197,357,1436,2721,7,20915,1161,0,2,5,4,64610,25775,5120,34278,0
35,1271,601,196,481,2,23,85,603,8,63,36,72,71,108,400,664,4,3036,168,0,2,203,5,64610,25775,5120,34279,0
1,319,382,65,130,157,2,92,539,4,10,5,10,14,15,41,57,2,114,6,0,2,1,1,64610,25776,5121,34280,0
11,413,42,7,35,4,0,5,46,1,2,1,2,3,3,2,4,0,2,0,0,2,1,1,64610,25776,5121,34281,0
11,413,11,6,10,0,0,1,11,2,4,2,4,6,6,10,15,1,15,0,0,2,1,1,64610,25776,5121,34282,0
179,5394,1660,832,1314,41,38,274,1701,20,312,209,395,332,604,2671,5058,12,64042,3557,1,2,64,7,64610,25778,5122,34284,0
179,5394,1057,646,719,113,100,145,1170,18,215,134,248,233,382,1740,3004,10,31186,1732,1,2,64,7,64620,25779,5123,34285,0
217,4691,2,2,2,0,0,0,2,0,0,0,0,0,0,0,0,0,0,0,0,2,3,1,64620,25779,5123,34285,0
217,4691,99,48,90,1,3,5,100,0,0,0,0,0,0,0,0,0,0,0,0,2,3,1,64620,25780,5123,34286,0
217,4691,8,5,5,2,0,1,10,0,0,0,0,0,0,0,0,0,0,0,0,2,3,1,64620,25780,5123,34287,0
217,4691,1217,716,841,84,126,174,1301,14,185,118,215,199,333,1446,2542,8,20687,1149,0,2,3,1,64630,25782,5123,34288,0
217,4691,160,89,115,0,13,31,160,7,15,11,17,22,28,78,124,3,495,27,0,2,3,1,64630,25782,5123,34289,0
217,4691,10,10,9,9,0,0,19,0,0,0,0,0,0,0,0,0,0,0,0,2,3,1,64630,25782,5124,34290,0
217,4691,173,84,99,8,29,36,181,5,12,7,13,17,20,54,81,2,221,12,0,2,3,1,64630,25783,5124,34291,0
217,4691,3,1,1,3,0,0,6,0,0,0,0,0,0,0,0,0,0,0,0,2,3,1,64630,25783,5124,34292,0
141,3279,77,34,69,0,0,8,77,3,24,16,29,27,45,114,213,1,387,21,0,2,4,3,64630,25783,5124,34293,0
141,3279,712,438,573,51,9,84,763,14,102,71,128,116,199,733,1364,8,11988,666,0,2,4,3,64640,25784,5124,34294,0
20,507,205,80,86,16,53,53,221,7,18,10,19,25,29,94,134,3,497,27,0,2,24,8,64650,25784,5125,34295,0
222,4835,1943,715,1694,26,18,214,1969,12,185,120,237,197,357,1436,2721,7,20915,1161,0,2,14,8,64650,25786,5125,34296,0
222,4835,1168,838,957,57,25,144,1225,19,348,224,416,367,640,3018,5452,11,61921,3440,1,2,14,8,64660,25788,5125,34297,0
161,4776,1660,832,1314,41,38,274,1701,20,312,209,395,332,604,2671,5058,12,64042,3557,1,2,93,14,64660,25790,5126,34299,0
1,319,382,65,130,157,2,92,539,4,10,5,10,14,15,41,57,2,114,6,0,2,1,1,64660,25791,5127,34300,0
11,413,42,7,35,4,0,5,46,1,2,1,2,3,3,2,4,0,2,0,0,2,1,1,64660,25791,5127,34301,0
11,413,11,6,10,0,0,1,11,2,4,2,4,6,6,10,15,1,15,0,0,2,1,1,64660,25791,5127,34302,0
179,5394,1660,832,1314,41,38,274,1701,20,312,209,395,332,604,2671,5058,12,64042,3557,1,2,64,7,64660,25793,5128,34304,0
179,5394,1057,646,719,113,100,145,1170,18,215,134,248,233,382,1740,3004,10,31186,1732,1,2,64,7,64670,25794,5129,34305,0
217,4691,2,2,2,0,0,0,2,0,0,0,0,0,0,0,0,0,0,0,0,2,3,1,64670,25794,5129,34305,0
217,4691,99,48,90,1,3,5,100,0,0,0,0,0,0,0,0,0,0,0,0,2,3,1,64670,25795,5129,34306,0
217,4691,8,5,5,2,0,1,10,0,0,0,0,0,0,0,0,0,0,0,0,2,3,1,64670,25795,5129,34307,0
217,4691,1217,716,841,84,126,174,1301,14,185,118,215,199,333,1446,2542,8,20687,1149,0,2,3,1,64680,25797,5129,34308,0
217,4691,160,89,115,0,13,31,160,7,15,11,17,22,28,78,124,3,495,27,0,2,3,1,64680,25797,5129,34309,0
217,4691,10,10,9,9,0,0,19,0,0,0,0,0,0,0,0,0,0,0,0,2,3,1,64680,25797,5130,34310,0
217,4691,173,84,99,8,29,36,181,5,12,7,13,17,20,54,81,2,221,12,0,2,3,1,64680,25798,5130,34311,0
217,4691,3,1,1,3,0,0,6,0,0,0,0,0,0,0,0,0,0,0,0,2,3,1,64680,25798,5130,34312,0
141,3279,77,34,69,0,0,8,77,3,24,16,29,27,45,114,213,1,387,21,0,2,4,3,64680,25798,5130,34313,0
141,3279,712,438,573,51,9,84,763,14,102,71,128,116,199,733,1364,8,11988,666,0,2,4,3,64690,25799,5130,34314,0
20,507,205,80,86,16,53,53,221,7,18,10,19,25,29,94,134,3,497,27,0,2,24,8,64700,25799,5131,34315,0
222,4835,1943,715,1694,26,18,214,1969,12,185,120,237,197,357,1436,2721,7,20915,1161,0,2,14,8,64700,25801,5131,34316,0
222,4835,1168,838,957,57,25,144,1225,19,348,224,416,367,640,3018,5452,11,61921,3440,1,2,14,8,64710,25803,5131,34317,0
161,4776,1660,832,1314,41,38,274,1701,20,312,209,395,332,604,2671,5058,12,64042,3557,1,2,93,14,64710,25805,5132,34319,0
179,5394,1660,832,1314,41,38,274,1701,20,312,209,395,332,604,2671,5058,12,64042,3557,1,2,16,8,64710,25807,5133,34321,0
179,5394,1057,646,719,113,100,145,1170,18,215,134,248,233,382,1740,3004,10,31186,1732,1,2,16,8,64720,25808,5134,34322,0
76,1714,996,429,845,24,10,117,1020,7,76,50,88,83,138,494,879,4,3565,198,0,2,14,12,64720,25810,5134,34323,0
76,1714,456,277,329,12,42,72,468,13,85,50,97,98,147,592,972,7,7212,400,0,2,14,12,64720,25810,5134,34324,0
217,4691,2,2,2,0,0,0,2,0,0,0,0,0,0,0,0,0,0,0,0,2,41,5,64720,25810,5134,34324,0
217,4691,99,48,90,1,3,5,100,0,0,0,0,0,0,0,0,0,0,0,0,2,41,5,64720,25811,5134,34325,0
217,4691,8,5,5,2,0,1,10,0,0,0,0,0,0,0,0,0,0,0,0,2,41,5,64720,25811,5134,34326,0
217,4691,1217,716,841,84,126,174,1301,14,185,118,215,199,333,1446,2542,8,20687,1149,0,2,41,5,64730,25813,5134,34327,0
217,4691,160,89,115,0,13,31,160,7,15,11,17,22,28,78,124,3,495,27,0,2,41,5,64730,25813,5134,34328,0
217,4691,10,10,9,9,0,0,19,0,0,0,0,0,0,0,0,0,0,0,0,2,41,5,64730,25813,5135,34329,0
217,4691,173,84,99,8,29,36,181,5,12,7,13,17,20,54,81,2,221,12,0,2,41,5,64730,25814,5135,34330,0
217,4691,3,1,1,3,0,0,6,0,0,0,0,0,0,0,0,0,0,0,0,2,41,5,64730,25814,5135,34331,0
97,1999,463,295,324,28,62,57,491,12,134,82,154,146,236,989,1696,6,11700,650,0,2,15,0,64740,25815,5135,34332,0
51,767,167,116,138,4,5,22,171,8,48,30,56,56,86,292,499,4,2330,129,0,2,24,14,64740,25815,5135,34333,0
254,5841,4293,999,3693,19,54,507,4312,9,155,88,170,164,258,1156,1898,4,9368,520,0,2,10,3,64740,25817,5135,34335,0
254,5841,1482,859,1002,125,135,219,1607,16,219,134,251,235,385,1766,3032,9,27804,1544,1,2,10,3,64750,25818,5135,34336,0
27,965,74,35,59,1,0,14,75,3,14,7,14,17,21,58,85,1,128,7,0,2,1,0,64750,25819,5135,34337,0
27,965,245,125,200,5,7,34,250,7,30,17,34,37,51,166,265,3,1053,58,0,2,1,0,64760,25820,5135,34338,0
52,622,647,139,84,35,284,233,682,0,0,0,0,0,0,0,0,0,0,0,0,2,32,1,64760,25820,5135,34339,0
98,2660,1523,757,1297,19,12,193,1542,12,193,117,230,205,347,1508,2664,7,19053,1058,0,2,5,6,64770,25822,5135,34340,0
98,2660,701,378,504,33,58,109,734,13,110,68,126,123,194,794,1346,7,10027,557,0,2,5,6,64770,25823,5136,34341,0
87,1836,402,202,227,24,74,80,426,12,52,33,61,64,94,339,564,7,3969,220,0,2,10,5,64770,25824,5136,34342,0
86,1893,53,23,39,0,0,13,53,2,8,4,8,10,12,26,39,1,39,2,0,2,105,6,64770,25824,5136,34343,0
86,1893,515,298,307,33,80,99,548,12,63,44,77,75,121,419,753,7,5527,307,0,2,105,6,64780,25824,5136,34344,0
235,5585,722,423,573,19,0,135,741,12,172,101,199,184,300,1320,2257,6,15668,870,0,2,17,8,64780,25826,5136,34346,0
235,5585,1508,847,911,44,250,301,1552,14,148,88,169,162,257,1120,1886,7,15077,837,0,2,17,8,64780,25827,5137,34347,0
313,6930,72,33,56,0,4,12,72,1,1,1,1,2,2,0,2,0,1,0,0,2,40,36,64780,25827,5137,34348,0
313,6930,1454,835,1044,76,110,219,1530,17,275,158,296,292,454,2297,3718,9,34017,1889,1,2,40,36,64790,25828,5137,34349,0
30,663,215,129,180,6,0,29,221,8,65,43,72,73,115,415,711,4,3153,175,0,2,3,1,64790,25828,5137,34350,0
30,663,97,69,77,3,3,16,100,6,22,13,23,28,36,113,173,3,542,30,0,2,3,1,64790,25829,5137,34351,0
222,4835,1943,715,1694,26,18,214,1969,12,185,120,237,197,357,1436,2721,7,20915,1161,0,2,65,27,64790,25831,5137,34352,0
222,4835,1168,838,957,57,25,144,1225,19,348,224,416,367,640,3018,5452,11,61921,3440,1,2,65,27,64800,25833,5137,34353,0
1,62,37,13,25,0,6,6,37,1,2,1,2,3,3,2,4,0,2,0,0,0,42,0,64800,25833,5137,34354,0
1,62,133,47,40,1,43,49,134,0,0,0,0,0,0,0,0,0,0,0,0,0,42,0,64800,25833,5137,34355,0
31,726,601,196,481,2,23,85,603,8,63,36,72,71,108,400,664,4,3036,168,0,2,94,41,64800,25833,5137,34356,0
31,726,156,79,106,5,16,28,161,5,14,8,15,19,23,64,97,2,261,14,0,2,94,41,64800,25833,5137,34357,0
95,3958,1289,550,1043,56,32,155,1345,10,167,93,185,177,278,1266,2075,5,11498,638,0,2,5,0,64800,25835,5138,34358,0
20,927,75,38,59,1,3,12,76,2,4,2,4,6,6,10,15,1,15,0,0,2,46,17,64800,25835,5138,34359,0
102,4744,1338,495,1086,10,64,173,1348,11,122,82,157,133,239,883,1686,7,11934,663,0,2,31,26,64800,25837,5138,34360,0
136,5794,1782,648,1425,9,47,279,1791,8,171,97,189,179,286,1292,2140,4,9462,525,0,2,8,44,64800,25838,5139,34361,0
111,4170,1450,624,1228,12,26,181,1462,14,306,186,354,320,540,2580,4493,8,36391,2021,1,2,13,3,64800,25840,5140,34362,0
161,4776,1660,832,1314,41,38,274,1701,20,312,209,395,332,604,2671,5058,12,64042,3557,1,2,10,10,64800,25842,5141,34364,0
43,3157,996,429,845,24,10,117,1020,7,76,50,88,83,138,494,879,4,3565,198,0,2,23,20,64800,25844,5141,34365,0
128,5332,1513,682,1277,25,13,200,1538,11,199,116,219,210,335,1557,2584,6,15641,868,0,2,4,3,64800,25846,5141,34366,0
92,4702,1457,730,1242,11,6,188,1468,10,292,166,329,302,495,2424,4078,5,22973,1276,1,2,50,18,64800,25848,5141,34367,0
95,4639,1523,757,1297,19,12,193,1542,12,193,117,230,205,347,1508,2664,7,19053,1058,0,2,2,1,64810,25850,5141,34368,0
95,4101,1020,354,843,12,15,144,1032,8,134,77,144,142,221,970,1580,4,6792,377,0,2,12,3,64810,25850,5141,34369,0
2,145,53,23,39,0,0,13,53,2,8,4,8,10,12,26,39,1,39,2,0,2,11,0,64810,25850,5141,34370,0
44,2109,722,423,573,19,0,135,741,12,172,101,199,184,300,1320,2257,6,15668,870,0,2,51,0,64810,25852,5141,34372,0
39,1718,386,256,301,16,9,68,402,4,59,35,69,63,104,355,621,2,1453,80,0,2,3,3,64810,25852,5141,34373,0
16,1224,215,129,180,6,0,29,221,8,65,43,72,73,115,415,711,4,3153,175,0,2,3,0,64810,25852,5141,34374,0
99,5044,1943,715,1694,26,18,214,1969,12,185,120,237,197,357,1436,2721,7,20915,1161,0,2,48,4,64810,25854,5141,34375,0
35,1271,601,196,481,2,23,85,603,8,63,36,72,71,108,400,664,4,3036,168,0,2,203,5,64810,25854,5141,34376,0
139,5872,1782,648,1425,9,47,279,1791,8,171,97,189,179,286,1292,2140,4,9462,525,0,2,0,3,64810,25855,5142,34377,0
179,5394,1660,832,1314,41,38,274,1701,20,312,209,395,332,604,2671,5058,12,64042,3557,1,2,16,8,64810,25857,5143,34379,0
179,5394,1057,646,719,113,100,145,1170,18,215,134,248,233,382,1740,3004,10,31186,1732,1,2,16,8,64820,25858,5144,34380,0
76,1714,996,429,845,24,10,117,1020,7,76,50,88,83,138,494,879,4,3565,198,0,2,14,12,64820,25860,5144,34381,0
76,1714,456,277,329,12,42,72,468,13,85,50,97,98,147,592,972,7,7212,400,0,2,14,12,64820,25860,5144,34382,0
217,4691,2,2,2,0,0,0,2,0,0,0,0,0,0,0,0,0,0,0,0,2,41,5,64820,25860,5144,34382,0
217,4691,99,48,90,1,3,5,100,0,0,0,0,0,0,0,0,0,0,0,0,2,41,5,64820,25861,5144,34383,0
217,4691,8,5,5,2,0,1,10,0,0,0,0,0,0,0,0,0,0,0,0,2,41,5,64820,25861,5144,34384,0
217,4691,1217,716,841,84,126,174,1301,14,185,118,215,199,333,1446,2542,8,20687,1149,0,2,41,5,64830,25863,5144,34385,0
217,4691,160,89,115,0,13,31,160,7,15,11,17,22,28,78,124,3,495,27,0,2,41,5,64830,25863,5144,34386,0
217,4691,10,10,9,9,0,0,19,0,0,0,0,0,0,0,0,0,0,0,0,2,41,5,64830,25863,5145,34387,0
217,4691,173,84,99,8,29,36,181,5,12,7,13,17,20,54,81,2,221,12,0,2,41,5,64830,25864,5145,34388,0
217,4691,3,1,1,3,0,0,6,0,0,0,0,0,0,0,0,0,0,0,0,2,41,5,64830,25864,5145,34389,0
97,1999,463,295,324,28,62,57,491,12,134,82,154,146,236,989,1696,6,11700,650,0,2,15,0,64840,25865,5145,34390,0
51,767,167,116,138,4,5,22,171,8,48,30,56,56,86,292,499,4,2330,129,0,2,24,14,64840,25865,5145,34391,0
254,5841,4293,999,3693,19,54,507,4312,9,155,88,170,164,258,1156,1898,4,9368,520,0,2,10,3,64840,25867,5145,34393,0
254,5841,1482,859,1002,125,135,219,1607,16,219,134,251,235,385,1766,3032,9,27804,1544,1,2,10,3,64850,25868,5145,34394,0
27,965,74,35,59,1,0,14,75,3,14,7,14,17,21,58,85,1,128,7,0,2,1,0,64850,25869,5145,34395,0
27,965,245,125,200,5,7,34,250,7,30,17,34,37,51,166,265,3,1053,58,0,2,1,0,64860,25870,5145,34396,0
52,622,647,139,84,35,284,233,682,0,0,0,0,0,0,0,0,0,0,0,0,2,32,1,64860,25870,5145,34397,0
98,2660,1523,757,1297,19,12,193,1542,12,193,117,230,205,347,1508,2664,7,19053,1058,0,2,5,6,64870,25872,5145,34398,0
98,2660,701,378,504,33,58,109,734,13,110,68,126,123,194,794,1346,7,10027,557,0,2,5,6,64870,25873,5146,34399,0
87,1836,402,202,227,24,74,80,426,12,52,33,61,64,94,339,564,7,3969,220,0,2,10,5,64870,25874,5146,34400,0
86,1893,53,23,39,0,0,13,53,2,8,4,8,10,12,26,39,1,39,2,0,2,105,6,64870,25874,5146,34401,0
86,1893,515,298,307,33,80,99,548,12,63,44,77,75,121,419,753,7,5527,307,0,2,105,6,64880,25874,5146,34402,0
235,5585,722,423,573,19,0,135,741,12,172,101,199,184,300,1320,2257,6,15668,870,0,2,17,8,64880,25876,5146,34404,0
235,5585,1508,847,911,44,250,301,1552,14,148,88,169,162,257,1120,1886,7,15077,837,0,2,17,8,64880,25877,5147,34405,0
313,6930,72,33,56,0,4,12,72,1,1,1,1,2,2,0,2,0,1,0,0,2,40,36,64880,25877,5147,34406,0
313,6930,1454,835,1044,76,110,219,1530,17,275,158,296,292,454,2297,3718,9,34017,1889,1,2,40,36,64890,25878,5147,34407,0
30,663,215,129,180,6,0,29,221,8,65,43,72,73,115,415,711,4,3153,175,0,2,3,1,64890,25878,5147,34408,0
30,663,97,69,77,3,3,16,100,6,22,13,23,28,36,113,173,3,542,30,0,2,3,1,64890,25879,5147,34409,0
222,4835,1943,715,1694,26,18,214,1969,12,185,120,237,197,357,1436,2721,7,20915,1161,0,2,65,27,64890,25881,5147,34410,0
222,4835,1168,838,957,57,25,144,1225,19,348,224,416,367,640,3018,5452,11,61921,3440,1,2,65,27,64900,25883,5147,34411,0
1,62,37,13,25,0,6,6,37,1,2,1,2,3,3,2,4,0,2,0,0,0,42,0,64900,25883,5147,34412,0
1,62,133,47,40,1,43,49,134,0,0,0,0,0,0,0,0,0,0,0,0,0,42,0,64900,25883,5147,34413,0
31,726,601,196,481,2,23,85,603,8,63,36,72,71,108,400,664,4,3036,168,0,2,94,41,64900,25883,5147,34414,0
31,726,156,79,106,5,16,28,161,5,14,8,15,19,23,64,97,2,261,14,0,2,94,41,64900,25883,5147,34415,0
95,3958,1289,550,1043,56,32,155,1345,10,167,93,185,177,278,1266,2075,5,11498,638,0,2,5,0,64900,25885,5148,34416,0
20,927,75,38,59,1,3,12,76,2,4,2,4,6,6,10,15,1,15,0,0,2,46,17,64900,25885,5148,34417,0
102,4744,1338,495,1086,10,64,173,1348,11,122,82,157,133,239,883,1686,7,11934,663,0,2,31,26,64900,25887,5148,34418,0
136,5794,1782,648,1425,9,47,279,1791,8,171,97,189,179,286,1292,2140,4,9462,525,0,2,8,44,64900,25888,5149,34419,0
111,4170,1450,624,1228,12,26,181,1462,14,306,186,354,320,540,2580,4493,8,36391,2021,1,2,13,3,64900,25890,5150,34420,0
161,4776,1660,832,1314,41,38,274,1701,20,312,209,395,332,604,2671,5058,12,64042,3557,1,2,10,10,64900,25892,5151,34422,0
43,3157,996,429,845,24,10,117,1020,7,76,50,88,83,138,494,879,4,3565,198,0,2,23,20,64900,25894,5151,34423,0
128,5332,1513,682,1277,25,13,200,1538,11,199,116,219,210,335,1557,2584,6,15641,868,0,2,4,3,64900,25896,5151,34424,0
92,4702,1457,730,1242,11,6,188,1468,10,292,166,329,302,495,2424,4078,5,22973,1276,1,2,50,18,64900,25898,5151,34425,0
95,4639,1523,757,1297,19,12,193,1542,12,193,117,230,205,347,1508,2664,7,19053,1058,0,2,2,1,64910,25900,5151,34426,0
95,4101,1020,354,843,12,15,144,1032,8,134,77,144,142,221,970,1580,4,6792,377,0,2,12,3,64910,25900,5151,34427,0
2,145,53,23,39,0,0,13,53,2,8,4,8,10,12,26,39,1,39,2,0,2,11,0,64910,25900,5151,34428,0
44,2109,722,423,573,19,0,135,741,12,172,101,199,184,300,1320,2257,6,15668,870,0,2,51,0,64910,25902,5151,34430,0
39,1718,386,256,301,16,9,68,402,4,59,35,69,63,104,355,621,2,1453,80,0,2,3,3,64910,25902,5151,34431,0
16,1224,215,129,180,6,0,29,221,8,65,43,72,73,115,415,711,4,3153,175,0,2,3,0,64910,25902,5151,34432,0
99,5044,1943,715,1694,26,18,214,1969,12,185,120,237,197,357,1436,2721,7,20915,1161,0,2,48,4,64910,25904,5151,34433,0
35,1271,601,196,481,2,23,85,603,8,63,36,72,71,108,400,664,4,3036,168,0,2,203,5,64910,25904,5151,34434,0
136,5770,1782,648,1425,9,47,279,1791,8,171,97,189,179,286,1292,2140,4,9462,525,0,2,0,3,64910,25905,5152,34435,0
136,5770,1782,648,1425,9,47,279,1791,8,171,97,189,179,286,1292,2140,4,9462,525,0,2,0,3,64910,25906,5153,34436,0
31,729,601,196,481,2,23,85,603,8,63,36,72,71,108,400,664,4,3036,168,0,2,7,5,64910,25906,5153,34437,0
31,729,156,79,106,5,16,28,161,5,14,8,15,19,23,64,97,2,261,14,0,2,7,5,64910,25906,5153,34438,0
39,1392,601,196,481,2,23,85,603,8,63,36,72,71,108,400,664,4,3036,168,0,2,44,0,64910,25906,5153,34439,0
35,1079,182,127,129,0,0,53,182,5,39,21,42,44,63,217,343,2,926,51,0,2,8,2,64910,25906,5154,34440,1
35,1079,182,127,129,0,0,53,182,5,39,21,42,44,63,217,343,2,926,51,0,2,8,2,64910,25906,5155,34441,0
313,6898,72,33,56,0,4,12,72,1,1,1,1,2,2,0,2,0,1,0,0,2,4,5,64910,25906,5155,34442,1
313,6898,1454,835,1044,76,110,219,1530,17,275,158,296,292,454,2297,3718,9,34017,1889,1,2,4,5,64920,25907,5155,34443,1
62,1231,1098,241,925,5,10,155,1103,7,46,25,49,53,74,273,423,3,1580,87,0,2,2,1,64930,25909,5155,34444,1
62,1231,282,202,222,14,2,44,296,8,42,24,43,50,67,250,378,4,1548,86,0,2,2,1,64930,25910,5155,34445,1
136,5770,1782,648,1425,9,47,279,1791,8,171,97,189,179,286,1292,2140,4,9462,525,0,2,2,6,64930,25911,5156,34446,1
31,729,601,196,481,2,23,85,603,8,63,36,72,71,108,400,664,4,3036,168,0,2,7,5,64930,25911,5156,34447,0
31,729,156,79,106,5,16,28,161,5,14,8,15,19,23,64,97,2,261,14,0,2,7,5,64930,25911,5156,34448,0
39,1392,601,196,481,2,23,85,603,8,63,36,72,71,108,400,664,4,3036,168,0,2,44,0,64930,25911,5156,34449,0
86,1927,53,23,39,0,0,13,53,2,8,4,8,10,12,26,39,1,39,2,0,2,8,5,64930,25911,5156,34450,0
86,1927,515,298,307,33,80,99,548,12,63,44,77,75,121,419,753,7,5527,307,0,2,8,5,64940,25911,5156,34451,0
313,6928,72,33,56,0,4,12,72,1,1,1,1,2,2,0,2,0,1,0,0,2,1,1,64940,25911,5156,34452,0
313,6928,1454,835,1044,76,110,219,1530,17,275,158,296,292,454,2297,3718,9,34017,1889,1,2,1,1,64950,25912,5156,34453,0
21,960,75,38,59,1,3,12,76,2,4,2,4,6,6,10,15,1,15,0,0,2,17,0,64950,25912,5156,34454,0
254,5860,4293,999,3693,19,54,507,4312,9,155,88,170,164,258,1156,1898,4,9368,520,0,2,5,0,64950,25914,5156,34455,0
254,5860,1482,859,1002,125,135,219,1607,16,219,134,251,235,385,1766,3032,9,27804,1544,1,2,5,0,64960,25915,5156,34456,0
22,992,75,38,59,1,3,12,76,2,4,2,4,6,6,10,15,1,15,0,0,2,21,0,64960,25915,5156,34457,0
177,7847,139,89,101,2,0,35,141,7,54,34,62,61,96,330,569,4,2287,127,0,2,2,0,64960,25915,5156,34458,0
177,7847,7,5,5,0,0,2,7,1,2,1,2,3,3,2,4,0,2,0,0,2,2,0,64960,25915,5156,34459,0
86,1955,53,23,39,0,0,13,53,2,8,4,8,10,12,26,39,1,39,2,0,2,7,4,64960,25915,5156,34460,0
86,1955,515,298,307,33,80,99,548,12,63,44,77,75,121,419,753,7,5527,307,0,2,7,4,64970,25915,5156,34461,0
23,1030,75,38,59,1,3,12,76,2,4,2,4,6,6,10,15,1,15,0,0,2,30,0,64970,25915,5156,34462,0
313,6940,72,33,56,0,4,12,72,1,1,1,1,2,2,0,2,0,1,0,0,2,4,1,64970,25915,5156,34463,1
313,6940,1454,835,1044,76,110,219,1530,17,275,158,296,292,454,2297,3718,9,34017,1889,1,2,4,1,64980,25916,5156,34464,1
102,4762,1338,495,1086,10,64,173,1348,11,122,82,157,133,239,883,1686,7,11934,663,0,2,6,0,64980,25918,5156,34465,1
313,6898,72,33,56,0,4,12,72,1,1,1,1,2,2,0,2,0,1,0,0,2,4,5,64980,25918,5156,34466,0
313,6898,1454,835,1044,76,110,219,1530,17,275,158,296,292,454,2297,3718,9,34017,1889,1,2,4,5,64990,25919,5156,34467,0
62,1231,1098,241,925,5,10,155,1103,7,46,25,49,53,74,273,423,3,1580,87,0,2,2,1,65000,25921,5156,34468,0
62,1231,282,202,222,14,2,44,296,8,42,24,43,50,67,250,378,4,1548,86,0,2,2,1,65000,25922,5156,34469,0
136,5770,1782,648,1425,9,47,279,1791,8,171,97,189,179,286,1292,2140,4,9462,525,0,2,2,6,65000,25923,5157,34470,0
254,5857,4293,999,3693,19,54,507,4312,9,155,88,170,164,258,1156,1898,4,9368,520,0,2,3,5,65000,25925,5157,34472,0
254,5857,1482,859,1002,125,135,219,1607,16,219,134,251,235,385,1766,3032,9,27804,1544,1,2,3,5,65010,25926,5157,34473,0
86,1965,53,23,39,0,0,13,53,2,8,4,8,10,12,26,39,1,39,2,0,2,10,9,65010,25926,5157,34474,0
86,1965,515,298,307,33,80,99,548,12,63,44,77,75,121,419,753,7,5527,307,0,2,10,9,65020,25926,5157,34475,0
51,757,167,116,138,4,5,22,171,8,48,30,56,56,86,292,499,4,2330,129,0,2,3,6,65020,25926,5157,34476,1
1,210,42,7,23,2,8,9,44,0,0,0,0,0,0,0,0,0,0,0,0,2,40,12,65020,25926,5157,34477,1
254,5844,4293,999,3693,19,54,507,4312,9,155,88,170,164,258,1156,1898,4,9368,520,0,2,6,7,65020,25928,5157,34478,1
254,5844,1482,859,1002,125,135,219,1607,16,219,134,251,235,385,1766,3032,9,27804,1544,1,2,6,7,65030,25929,5157,34479,1
86,1952,53,23,39,0,0,13,53,2,8,4,8,10,12,26,39,1,39,2,0,2,2,10,65030,25929,5157,34480,1
86,1952,515,298,307,33,80,99,548,12,63,44,77,75,121,419,753,7,5527,307,0,2,2,10,65040,25929,5157,34481,1
30,654,215,129,180,6,0,29,221,8,65,43,72,73,115,415,711,4,3153,175,0,2,1,2,65040,25929,5157,34482,1
30,654,97,69,77,3,3,16,100,6,22,13,23,28,36,113,173,3,542,30,0,2,1,2,65040,25930,5157,34483,1
76,1736,996,429,845,24,10,117,1020,7,76,50,88,83,138,494,879,4,3565,198,0,2,6,3,65040,25932,5157,34484,0
76,1736,456,277,329,12,42,72,468,13,85,50,97,98,147,592,972,7,7212,400,0,2,6,3,65040,25932,5157,34485,0
44,3214,996,429,845,24,10,117,1020,7,76,50,88,83,138,494,879,4,3565,198,0,2,11,0,65040,25934,5157,34486,0
177,7850,139,89,101,2,0,35,141,7,54,34,62,61,96,330,569,4,2287,127,0,2,18,14,65040,25934,5157,34487,1
177,7850,7,5,5,0,0,2,7,1,2,1,2,3,3,2,4,0,2,0,0,2,18,14,65040,25934,5157,34488,1
2,114,37,13,25,0,6,6,37,1,2,1,2,3,3,2,4,0,2,0,0,2,18,0,65040,25934,5157,34490,1
2,114,133,47,40,1,43,49,134,0,0,0,0,0,0,0,0,0,0,0,0,2,18,0,65040,25934,5157,34491,1
313,6905,72,33,56,0,4,12,72,1,1,1,1,2,2,0,2,0,1,0,0,2,10,5,65040,25934,5157,34492,0
313,6905,1454,835,1044,76,110,219,1530,17,275,158,296,292,454,2297,3718,9,34017,1889,1,2,10,5,65050,25935,5157,34493,0
139,6150,1782,648,1425,9,47,279,1791,8,171,97,189,179,286,1292,2140,4,9462,525,0,2,79,0,65050,25936,5158,34494,0
51,757,167,116,138,4,5,22,171,8,48,30,56,56,86,292,499,4,2330,129,0,2,3,6,65050,25936,5158,34495,0
254,5844,4293,999,3693,19,54,507,4312,9,155,88,170,164,258,1156,1898,4,9368,520,0,2,9,7,65050,25938,5158,34497,0
254,5844,1482,859,1002,125,135,219,1607,16,219,134,251,235,385,1766,3032,9,27804,1544,1,2,9,7,65060,25939,5158,34498,0
86,1952,53,23,39,0,0,13,53,2,8,4,8,10,12,26,39,1,39,2,0,2,8,9,65060,25939,5158,34499,0
86,1952,515,298,307,33,80,99,548,12,63,44,77,75,121,419,753,7,5527,307,0,2,8,9,65070,25939,5158,34500,0
313,6940,72,33,56,0,4,12,72,1,1,1,1,2,2,0,2,0,1,0,0,2,4,1,65070,25939,5158,34501,0
313,6940,1454,835,1044,76,110,219,1530,17,275,158,296,292,454,2297,3718,9,34017,1889,1,2,4,1,65080,25940,5158,34502,0
30,654,215,129,180,6,0,29,221,8,65,43,72,73,115,415,711,4,3153,175,0,2,1,2,65080,25940,5158,34503,0
30,654,97,69,77,3,3,16,100,6,22,13,23,28,36,113,173,3,542,30,0,2,1,2,65080,25941,5158,34504,0
2,114,37,13,25,0,6,6,37,1,2,1,2,3,3,2,4,0,2,0,0,2,18,0,65080,25941,5158,34505,0
2,114,133,47,40,1,43,49,134,0,0,0,0,0,0,0,0,0,0,0,0,2,18,0,65080,25941,5158,34506,0
23,1030,75,38,59,1,3,12,76,2,4,2,4,6,6,10,15,1,15,0,0,2,68,0,65080,25941,5158,34507,0
102,4762,1338,495,1086,10,64,173,1348,11,122,82,157,133,239,883,1686,7,11934,663,0,2,6,0,65080,25943,5158,34508,0
177,7847,139,89,101,2,0,35,141,7,54,34,62,61,96,330,569,4,2287,127,0,2,2,0,65080,25943,5158,34509,0
177,7847,7,5,5,0,0,2,7,1,2,1,2,3,3,2,4,0,2,0,0,2,2,0,65080,25943,5158,34510,0
76,1736,996,429,845,24,10,117,1020,7,76,50,88,83,138,494,879,4,3565,198,0,2,6,3,65080,25945,5158,34511,0
76,1736,456,277,329,12,42,72,468,13,85,50,97,98,147,592,972,7,7212,400,0,2,6,3,65080,25945,5158,34512,0
177,7850,139,89,101,2,0,35,141,7,54,34,62,61,96,330,569,4,2287,127,0,2,18,14,65080,25945,5158,34513,0
177,7850,7,5,5,0,0,2,7,1,2,1,2,3,3,2,4,0,2,0,0,2,18,14,65080,25945,5158,34514,0
44,3214,996,429,845,24,10,117,1020,7,76,50,88,83,138,494,879,4,3565,198,0,2,11,0,65080,25947,5158,34515,0
24,607,2,2,2,0,0,0,2,0,0,0,0,0,0,0,0,0,0,0,0,2,2,2,65080,25947,5158,34515,0
24,607,99,48,90,1,3,5,100,0,0,0,0,0,0,0,0,0,0,0,0,2,2,2,65080,25948,5158,34516,0
24,607,8,5,5,2,0,1,10,0,0,0,0,0,0,0,0,0,0,0,0,2,2,2,65080,25948,5158,34517,0
24,607,1217,716,841,84,126,174,1301,14,185,118,215,199,333,1446,2542,8,20687,1149,0,2,2,2,65090,25950,5158,34518,0
24,607,160,89,115,0,13,31,160,7,15,11,17,22,28,78,124,3,495,27,0,2,2,2,65090,25950,5158,34519,0
24,607,10,10,9,9,0,0,19,0,0,0,0,0,0,0,0,0,0,0,0,2,2,2,65090,25950,5159,34520,0
24,607,173,84,99,8,29,36,181,5,12,7,13,17,20,54,81,2,221,12,0,2,2,2,65090,25951,5159,34521,0
24,607,3,1,1,3,0,0,6,0,0,0,0,0,0,0,0,0,0,0,0,2,2,2,65090,25951,5159,34522,0
88,1873,402,202,227,24,74,80,426,12,52,33,61,64,94,339,564,7,3969,220,0,2,8,0,65090,25952,5159,34523,0
96,4196,1020,354,843,12,15,144,1032,8,134,77,144,142,221,970,1580,4,6792,377,0,2,37,2,65090,25952,5159,34524,0
180,5401,1660,832,1314,41,38,274,1701,20,312,209,395,332,604,2671,5058,12,64042,3557,1,2,5,1,65090,25954,5160,34526,0
180,5401,1057,646,719,113,100,145,1170,18,215,134,248,233,382,1740,3004,10,31186,1732,1,2,5,1,65100,25955,5161,34527,0
162,4835,1660,832,1314,41,38,274,1701,20,312,209,395,332,604,2671,5058,12,64042,3557,1,2,24,0,65100,25957,5162,34529,0
178,5362,1660,832,1314,41,38,274,1701,20,312,209,395,332,604,2671,5058,12,64042,3557,1,2,4,15,65100,25959,5163,34531,0
178,5362,1057,646,719,113,100,145,1170,18,215,134,248,233,382,1740,3004,10,31186,1732,1,2,4,15,65110,25960,5164,34532,0
67,1349,207,111,150,11,0,50,218,5,26,19,36,31,55,133,272,3,943,52,0,2,11,3,65110,25960,5164,34533,0
67,1349,410,198,237,31,55,97,441,11,63,38,72,74,110,414,683,6,4293,238,0,2,11,3,65120,25961,5165,34534,0
7,164,167,116,138,4,5,22,171,8,48,30,56,56,86,292,499,4,2330,129,0,2,37,2,65120,25961,5165,34535,0
24,607,2,2,2,0,0,0,2,0,0,0,0,0,0,0,0,0,0,0,0,2,2,2,65120,25961,5165,34535,0
24,607,99,48,90,1,3,5,100,0,0,0,0,0,0,0,0,0,0,0,0,2,2,2,65120,25962,5165,34536,0
24,607,8,5,5,2,0,1,10,0,0,0,0,0,0,0,0,0,0,0,0,2,2,2,65120,25962,5165,34537,0
24,607,1217,716,841,84,126,174,1301,14,185,118,215,199,333,1446,2542,8,20687,1149,0,2,2,2,65130,25964,5165,34538,0
24,607,160,89,115,0,13,31,160,7,15,11,17,22,28,78,124,3,495,27,0,2,2,2,65130,25964,5165,34539,0
24,607,10,10,9,9,0,0,19,0,0,0,0,0,0,0,0,0,0,0,0,2,2,2,65130,25964,5166,34540,0
24,607,173,84,99,8,29,36,181,5,12,7,13,17,20,54,81,2,221,12,0,2,2,2,65130,25965,5166,34541,0
24,607,3,1,1,3,0,0,6,0,0,0,0,0,0,0,0,0,0,0,0,2,2,2,65130,25965,5166,34542,0
88,1873,402,202,227,24,74,80,426,12,52,33,61,64,94,339,564,7,3969,220,0,2,8,0,65130,25966,5166,34543,0
96,4196,1020,354,843,12,15,144,1032,8,134,77,144,142,221,970,1580,4,6792,377,0,2,37,2,65130,25966,5166,34544,0
88,2299,773,422,505,30,103,129,803,14,77,46,83,91,129,535,839,7,6334,351,0,2,26,15,65140,25967,5167,34545,0
32,2102,1157,318,931,29,22,177,1186,6,104,63,125,110,188,712,1274,3,4596,255,0,2,20,0,65140,25967,5167,34546,0
33,2202,1157,318,931,29,22,177,1186,6,104,63,125,110,188,712,1274,3,4596,255,0,2,38,0,65140,25967,5167,34547,0
7,164,167,116,138,4,5,22,171,8,48,30,56,56,86,292,499,4,2330,129,0,2,4,0,65140,25967,5167,34548,0
7,164,167,116,138,4,5,22,171,8,48,30,56,56,86,292,499,4,2330,129,0,2,1,1,65140,25967,5167,34549,0
88,2299,773,422,505,30,103,129,803,14,77,46,83,91,129,535,839,7,6334,351,0,2,1,1,65150,25968,5168,34550,0
85,2238,773,422,505,30,103,129,803,14,77,46,83,91,129,535,839,7,6334,351,0,2,1,1,65160,25969,5169,34551,0
62,2790,1293,570,1093,25,15,163,1318,10,195,123,241,205,364,1516,2795,6,17273,959,0,2,18,0,65170,25971,5169,34552,0
178,5362,1660,832,1314,41,38,274,1701,20,312,209,395,332,604,2671,5058,12,64042,3557,1,2,5,12,65170,25973,5170,34554,0
178,5362,1057,646,719,113,100,145,1170,18,215,134,248,233,382,1740,3004,10,31186,1732,1,2,5,12,65180,25974,5171,34555,0
67,1349,207,111,150,11,0,50,218,5,26,19,36,31,55,133,272,3,943,52,0,2,11,3,65180,25974,5171,34556,0
67,1349,410,198,237,31,55,97,441,11,63,38,72,74,110,414,683,6,4293,238,0,2,11,3,65190,25975,5172,34557,0
7,164,167,116,138,4,5,22,171,8,48,30,56,56,86,292,499,4,2330,129,0,2,41,2,65190,25975,5172,34558,0
162,4835,1660,832,1314,41,38,274,1701,20,312,209,395,332,604,2671,5058,12,64042,3557,1,2,24,0,65190,25977,5173,34560,0
88,2299,773,422,505,30,103,129,803,14,77,46,83,91,129,535,839,7,6334,351,0,2,26,15,65200,25978,5174,34561,0
33,2202,1157,318,931,29,22,177,1186,6,104,63,125,110,188,712,1274,3,4596,255,0,2,58,0,65200,25978,5174,34562,0
313,6905,72,33,56,0,4,12,72,1,1,1,1,2,2,0,2,0,1,0,0,2,10,5,65200,25978,5174,34563,0
313,6905,1454,835,1044,76,110,219,1530,17,275,158,296,292,454,2297,3718,9,34017,1889,1,2,10,5,65210,25979,5174,34564,0
139,6150,1782,648,1425,9,47,279,1791,8,171,97,189,179,286,1292,2140,4,9462,525,0,2,79,0,65210,25980,5175,34565,0
85,2238,773,422,505,30,103,129,803,14,77,46,83,91,129,535,839,7,6334,351,0,2,1,1,65220,25981,5176,34566,0
62,2790,1293,570,1093,25,15,163,1318,10,195,123,241,205,364,1516,2795,6,17273,959,0,2,18,0,65230,25983,5176,34567,0
180,5384,1660,832,1314,41,38,274,1701,20,312,209,395,332,604,2671,5058,12,64042,3557,1,2,9,4,65230,25985,5177,34569,1
180,5384,1057,646,719,113,100,145,1170,18,215,134,248,233,382,1740,3004,10,31186,1732,1,2,9,4,65240,25986,5178,34570,1
165,4899,1660,832,1314,41,38,274,1701,20,312,209,395,332,604,2671,5058,12,64042,3557,1,2,17,1,65240,25988,5179,34572,1
180,5384,1660,832,1314,41,38,274,1701,20,312,209,395,332,604,2671,5058,12,64042,3557,1,2,9,4,65240,25990,5180,34574,0
180,5384,1057,646,719,113,100,145,1170,18,215,134,248,233,382,1740,3004,10,31186,1732,1,2,9,4,65250,25991,5181,34575,0
165,4899,1660,832,1314,41,38,274,1701,20,312,209,395,332,604,2671,5058,12,64042,3557,1,2,17,1,65250,25993,5182,34577,0
141,3284,77,34,69,0,0,8,77,3,24,16,29,27,45,114,213,1,387,21,0,2,4,3,65250,25993,5182,34578,0
141,3284,712,438,573,51,9,84,763,14,102,71,128,116,199,733,1364,8,11988,666,0,2,4,3,65260,25994,5182,34579,0
1,6,2,2,2,0,0,0,2,0,0,0,0,0,0,0,0,0,0,0,0,0,2,0,65270,25998,5183,34586,0
103,4779,1338,495,1086,10,64,173,1348,11,122,82,157,133,239,883,1686,7,11934,663,0,2,7,0,65270,26000,5183,34587,0
141,3284,77,34,69,0,0,8,77,3,24,16,29,27,45,114,213,1,387,21,0,2,4,3,65270,26000,5183,34588,0
141,3284,712,438,573,51,9,84,763,14,102,71,128,116,199,733,1364,8,11988,666,0,2,4,3,65280,26001,5183,34589,0
1,6,2,2,2,0,0,0,2,0,0,0,0,0,0,0,0,0,0,0,0,0,2,0,65290,26005,5184,34596,0
103,4779,1338,495,1086,10,64,173,1348,11,122,82,157,133,239,883,1686,7,11934,663,0,2,7,0,65290,26007,5184,34597,0
48,992,447,308,343,6,5,95,453,7,96,59,111,103,170,651,1136,4,4600,255,0,2,2,2,65290,26010,5184,34598,0
48,992,322,174,179,16,74,51,338,10,41,26,46,51,72,252,408,5,2291,127,0,2,2,2,65290,26013,5185,34599,0
48,992,447,308,343,6,5,95,453,7,96,59,111,103,170,651,1136,4,4600,255,0,2,2,2,65290,26016,5185,34600,0
48,992,322,174,179,16,74,51,338,10,41,26,46,51,72,252,408,5,2291,127,0,2,2,2,65290,26019,5186,34601,0
29,716,601,196,481,2,23,85,603,8,63,36,72,71,108,400,664,4,3036,168,0,2,5,7,65290,26019,5186,34602,0
29,716,156,79,106,5,16,28,161,5,14,8,15,19,23,64,97,2,261,14,0,2,5,7,65290,26019,5186,34603,0
40,1425,601,196,481,2,23,85,603,8,63,36,72,71,108,400,664,4,3036,168,0,2,22,4,65290,26019,5186,34604,0
180,5384,1660,832,1314,41,38,274,1701,20,312,209,395,332,604,2671,5058,12,64042,3557,1,2,14,16,65290,26021,5187,34606,0
180,5384,1057,646,719,113,100,145,1170,18,215,134,248,233,382,1740,3004,10,31186,1732,1,2,14,16,65300,26022,5188,34607,0
76,1736,996,429,845,24,10,117,1020,7,76,50,88,83,138,494,879,4,3565,198,0,2,6,3,65300,26024,5188,34608,0
76,1736,456,277,329,12,42,72,468,13,85,50,97,98,147,592,972,7,7212,400,0,2,6,3,65300,26024,5188,34609,0
67,1349,207,111,150,11,0,50,218,5,26,19,36,31,55,133,272,3,943,52,0,2,11,3,65300,26024,5188,34610,0
67,1349,410,198,237,31,55,97,441,11,63,38,72,74,110,414,683,6,4293,238,0,2,11,3,65310,26025,5189,34611,0
88,2299,773,422,505,30,103,129,803,14,77,46,83,91,129,535,839,7,6334,351,0,2,1,1,65320,26026,5190,34612,0
141,3284,77,34,69,0,0,8,77,3,24,16,29,27,45,114,213,1,387,21,0,2,4,3,65320,26026,5190,34613,0
141,3284,712,438,573,51,9,84,763,14,102,71,128,116,199,733,1364,8,11988,666,0,2,4,3,65330,26027,5190,34614,0
48,992,447,308,343,6,5,95,453,7,96,59,111,103,170,651,1136,4,4600,255,0,2,2,2,65330,26030,5190,34615,0
48,992,322,174,179,16,74,51,338,10,41,26,46,51,72,252,408,5,2291,127,0,2,2,2,65330,26033,5191,34616,0
7,164,167,116,138,4,5,22,171,8,48,30,56,56,86,292,499,4,2330,129,0,2,41,2,65330,26033,5191,34617,0
313,6915,72,33,56,0,4,12,72,1,1,1,1,2,2,0,2,0,1,0,0,2,14,10,65330,26033,5191,34618,0
313,6915,1454,835,1044,76,110,219,1530,17,275,158,296,292,454,2297,3718,9,34017,1889,1,2,14,10,65340,26034,5191,34619,0
62,1231,1098,241,925,5,10,155,1103,7,46,25,49,53,74,273,423,3,1580,87,0,2,2,1,65350,26036,5191,34620,0
62,1231,282,202,222,14,2,44,296,8,42,24,43,50,67,250,378,4,1548,86,0,2,2,1,65350,26037,5191,34621,0
35,1079,182,127,129,0,0,53,182,5,39,21,42,44,63,217,343,2,926,51,0,2,8,2,65350,26037,5192,34622,0
1,6,2,2,2,0,0,0,2,0,0,0,0,0,0,0,0,0,0,0,0,0,2,0,65360,26041,5193,34629,0
103,4797,1338,495,1086,10,64,173,1348,11,122,82,157,133,239,883,1686,7,11934,663,0,2,7,0,65360,26043,5193,34630,0
177,7868,139,89,101,2,0,35,141,7,54,34,62,61,96,330,569,4,2287,127,0,2,18,14,65360,26043,5193,34631,0
177,7868,7,5,5,0,0,2,7,1,2,1,2,3,3,2,4,0,2,0,0,2,18,14,65360,26043,5193,34632,0
139,6150,1782,648,1425,9,47,279,1791,8,171,97,189,179,286,1292,2140,4,9462,525,0,2,81,6,65360,26044,5194,34633,0
165,4899,1660,832,1314,41,38,274,1701,20,312,209,395,332,604,2671,5058,12,64042,3557,1,2,41,1,65360,26046,5195,34635,0
44,3214,996,429,845,24,10,117,1020,7,76,50,88,83,138,494,879,4,3565,198,0,2,11,0,65360,26048,5195,34636,0
62,2790,1293,570,1093,25,15,163,1318,10,195,123,241,205,364,1516,2795,6,17273,959,0,2,18,0,65370,26050,5195,34637,0
29,716,601,196,481,2,23,85,603,8,63,36,72,71,108,400,664,4,3036,168,0,2,5,7,65370,26050,5195,34638,0
29,716,156,79,106,5,16,28,161,5,14,8,15,19,23,64,97,2,261,14,0,2,5,7,65370,26050,5195,34639,0
40,1425,601,196,481,2,23,85,603,8,63,36,72,71,108,400,664,4,3036,168,0,2,22,4,65370,26050,5195,34640,0
180,5384,1660,832,1314,41,38,274,1701,20,312,209,395,332,604,2671,5058,12,64042,3557,1,2,14,16,65370,26052,5196,34642,0
180,5384,1057,646,719,113,100,145,1170,18,215,134,248,233,382,1740,3004,10,31186,1732,1,2,14,16,65380,26053,5197,34643,0
76,1736,996,429,845,24,10,117,1020,7,76,50,88,83,138,494,879,4,3565,198,0,2,6,3,65380,26055,5197,34644,0
76,1736,456,277,329,12,42,72,468,13,85,50,97,98,147,592,972,7,7212,400,0,2,6,3,65380,26055,5197,34645,0
67,1349,207,111,150,11,0,50,218,5,26,19,36,31,55,133,272,3,943,52,0,2,11,3,65380,26055,5197,34646,0
67,1349,410,198,237,31,55,97,441,11,63,38,72,74,110,414,683,6,4293,238,0,2,11,3,65390,26056,5198,34647,0
88,2299,773,422,505,30,103,129,803,14,77,46,83,91,129,535,839,7,6334,351,0,2,1,1,65400,26057,5199,34648,0
141,3284,77,34,69,0,0,8,77,3,24,16,29,27,45,114,213,1,387,21,0,2,4,3,65400,26057,5199,34649,0
141,3284,712,438,573,51,9,84,763,14,102,71,128,116,199,733,1364,8,11988,666,0,2,4,3,65410,26058,5199,34650,0
48,992,447,308,343,6,5,95,453,7,96,59,111,103,170,651,1136,4,4600,255,0,2,2,2,65410,26061,5199,34651,0
48,992,322,174,179,16,74,51,338,10,41,26,46,51,72,252,408,5,2291,127,0,2,2,2,65410,26064,5200,34652,0
7,164,167,116,138,4,5,22,171,8,48,30,56,56,86,292,499,4,2330,129,0,2,41,2,65410,26064,5200,34653,0
313,6915,72,33,56,0,4,12,72,1,1,1,1,2,2,0,2,0,1,0,0,2,14,10,65410,26064,5200,34654,0
313,6915,1454,835,1044,76,110,219,1530,17,275,158,296,292,454,2297,3718,9,34017,1889,1,2,14,10,65420,26065,5200,34655,0
62,1231,1098,241,925,5,10,155,1103,7,46,25,49,53,74,273,423,3,1580,87,0,2,2,1,65430,26067,5200,34656,0
62,1231,282,202,222,14,2,44,296,8,42,24,43,50,67,250,378,4,1548,86,0,2,2,1,65430,26068,5200,34657,0
35,1079,182,127,129,0,0,53,182,5,39,21,42,44,63,217,343,2,926,51,0,2,8,2,65430,26068,5201,34658,0
1,6,2,2,2,0,0,0,2,0,0,0,0,0,0,0,0,0,0,0,0,0,2,0,65440,26072,5202,34665,0
103,4797,1338,495,1086,10,64,173,1348,11,122,82,157,133,239,883,1686,7,11934,663,0,2,7,0,65440,26074,5202,34666,0
177,7868,139,89,101,2,0,35,141,7,54,34,62,61,96,330,569,4,2287,127,0,2,18,14,65440,26074,5202,34667,0
177,7868,7,5,5,0,0,2,7,1,2,1,2,3,3,2,4,0,2,0,0,2,18,14,65440,26074,5202,34668,0
139,6150,1782,648,1425,9,47,279,1791,8,171,97,189,179,286,1292,2140,4,9462,525,0,2,81,6,65440,26075,5203,34669,0
165,4899,1660,832,1314,41,38,274,1701,20,312,209,395,332,604,2671,5058,12,64042,3557,1,2,41,1,65440,26077,5204,34671,0
44,3214,996,429,845,24,10,117,1020,7,76,50,88,83,138,494,879,4,3565,198,0,2,11,0,65440,26079,5204,34672,0
62,2790,1293,570,1093,25,15,163,1318,10,195,123,241,205,364,1516,2795,6,17273,959,0,2,18,0,65450,26081,5204,34673,0
180,5387,1660,832,1314,41,38,274,1701,20,312,209,395,332,604,2671,5058,12,64042,3557,1,2,10,10,65450,26083,5205,34675,0
180,5387,1057,646,719,113,100,145,1170,18,215,134,248,233,382,1740,3004,10,31186,1732,1,2,10,10,65460,26084,5206,34676,0
166,4970,1660,832,1314,41,38,274,1701,20,312,209,395,332,604,2671,5058,12,64042,3557,1,2,42,0,65460,26086,5207,34678,0
180,5387,1660,832,1314,41,38,274,1701,20,312,209,395,332,604,2671,5058,12,64042,3557,1,2,10,10,65460,26088,5208,34680,0
180,5387,1057,646,719,113,100,145,1170,18,215,134,248,233,382,1740,3004,10,31186,1732,1,2,10,10,65470,26089,5209,34681,0
166,4970,1660,832,1314,41,38,274,1701,20,312,209,395,332,604,2671,5058,12,64042,3557,1,2,42,0,65470,26091,5210,34683,0
31,946,339,213,244,17,9,65,356,10,42,26,48,52,74,259,421,5,2410,133,0,2,0,16,65480,26091,5210,34684,1
62,2798,1293,570,1093,25,15,163,1318,10,195,123,241,205,364,1516,2795,6,17273,959,0,2,7,1,65490,26093,5210,34685,1
52,622,647,139,84,35,284,233,682,0,0,0,0,0,0,0,0,0,0,0,0,2,3,0,65490,26093,5210,34686,0
223,4840,1943,715,1694,26,18,214,1969,12,185,120,237,197,357,1436,2721,7,20915,1161,0,2,4,3,65490,26095,5210,34687,0
223,4840,1168,838,957,57,25,144,1225,19,348,224,416,367,640,3018,5452,11,61921,3440,1,2,4,3,65500,26097,5210,34688,0
28,725,466,257,367,18,25,50,484,7,126,86,171,133,257,898,1813,4,8612,478,0,2,6,1,65500,26097,5210,34689,0
28,725,507,281,342,29,59,88,536,10,53,29,57,63,86,336,514,5,2764,153,0,2,6,1,65500,26097,5210,34690,0
28,707,466,257,367,18,25,50,484,7,126,86,171,133,257,898,1813,4,8612,478,0,2,1,6,65500,26097,5210,34691,0
28,707,507,281,342,29,59,88,536,10,53,29,57,63,86,336,514,5,2764,153,0,2,1,6,65500,26097,5210,34692,0
99,5070,1943,715,1694,26,18,214,1969,12,185,120,237,197,357,1436,2721,7,20915,1161,0,2,11,3,65500,26099,5210,34693,0
20,893,75,38,59,1,3,12,76,2,4,2,4,6,6,10,15,1,15,0,0,2,4,13,65500,26099,5210,34694,0
218,4705,2,2,2,0,0,0,2,0,0,0,0,0,0,0,0,0,0,0,0,2,6,1,65500,26099,5210,34694,0
218,4705,99,48,90,1,3,5,100,0,0,0,0,0,0,0,0,0,0,0,0,2,6,1,65500,26100,5210,34695,0
218,4705,8,5,5,2,0,1,10,0,0,0,0,0,0,0,0,0,0,0,0,2,6,1,65500,26100,5210,34696,0
218,4705,1217,716,841,84,126,174,1301,14,185,118,215,199,333,1446,2542,8,20687,1149,0,2,6,1,65510,26102,5210,34697,0
218,4705,160,89,115,0,13,31,160,7,15,11,17,22,28,78,124,3,495,27,0,2,6,1,65510,26102,5210,34698,0
218,4705,10,10,9,9,0,0,19,0,0,0,0,0,0,0,0,0,0,0,0,2,6,1,65510,26102,5211,34699,0
218,4705,173,84,99,8,29,36,181,5,12,7,13,17,20,54,81,2,221,12,0,2,6,1,65510,26103,5211,34700,0
218,4705,3,1,1,3,0,0,6,0,0,0,0,0,0,0,0,0,0,0,0,2,6,1,65510,26103,5211,34701,0
21,1042,75,38,59,1,3,12,76,2,4,2,4,6,6,10,15,1,15,0,0,2,29,1,65510,26103,5211,34702,0
39,2322,652,304,544,16,6,88,668,6,89,51,101,95,152,591,998,3,3399,188,0,2,1,0,65510,26104,5211,34703,0
223,4840,1943,715,1694,26,18,214,1969,12,185,120,237,197,357,1436,2721,7,20915,1161,0,2,4,3,65510,26106,5211,34704,0
223,4840,1168,838,957,57,25,144,1225,19,348,224,416,367,640,3018,5452,11,61921,3440,1,2,4,3,65520,26108,5211,34705,0
99,5070,1943,715,1694,26,18,214,1969,12,185,120,237,197,357,1436,2721,7,20915,1161,0,2,11,3,65520,26110,5211,34706,0
28,707,466,257,367,18,25,50,484,7,126,86,171,133,257,898,1813,4,8612,478,0,2,2,2,65520,26110,5211,34707,0
28,707,507,281,342,29,59,88,536,10,53,29,57,63,86,336,514,5,2764,153,0,2,2,2,65520,26110,5211,34708,0
52,622,647,139,84,35,284,233,682,0,0,0,0,0,0,0,0,0,0,0,0,2,3,0,65520,26110,5211,34709,0
218,4705,2,2,2,0,0,0,2,0,0,0,0,0,0,0,0,0,0,0,0,2,6,1,65520,26110,5211,34709,0
218,4705,99,48,90,1,3,5,100,0,0,0,0,0,0,0,0,0,0,0,0,2,6,1,65520,26111,5211,34710,0
218,4705,8,5,5,2,0,1,10,0,0,0,0,0,0,0,0,0,0,0,0,2,6,1,65520,26111,5211,34711,0
218,4705,1217,716,841,84,126,174,1301,14,185,118,215,199,333,1446,2542,8,20687,1149,0,2,6,1,65530,26113,5211,34712,0
218,4705,160,89,115,0,13,31,160,7,15,11,17,22,28,78,124,3,495,27,0,2,6,1,65530,26113,5211,34713,0
218,4705,10,10,9,9,0,0,19,0,0,0,0,0,0,0,0,0,0,0,0,2,6,1,65530,26113,5212,34714,0
218,4705,173,84,99,8,29,36,181,5,12,7,13,17,20,54,81,2,221,12,0,2,6,1,65530,26114,5212,34715,0
218,4705,3,1,1,3,0,0,6,0,0,0,0,0,0,0,0,0,0,0,0,2,6,1,65530,26114,5212,34716,0
21,1042,75,38,59,1,3,12,76,2,4,2,4,6,6,10,15,1,15,0,0,2,33,14,65530,26114,5212,34717,0
39,2322,652,304,544,16,6,88,668,6,89,51,101,95,152,591,998,3,3399,188,0,2,1,0,65530,26115,5212,34718,0
23,367,102,57,55,5,16,25,107,5,17,10,18,22,28,81,124,2,330,18,0,2,4,1,65530,26115,5212,34719,0
92,4051,1020,354,843,12,15,144,1032,8,134,77,144,142,221,970,1580,4,6792,377,0,2,12,0,65530,26115,5212,34720,0
23,367,102,57,55,5,16,25,107,5,17,10,18,22,28,81,124,2,330,18,0,2,4,1,65530,26115,5212,34721,0
96,4133,1020,354,843,12,15,144,1032,8,134,77,144,142,221,970,1580,4,6792,377,0,2,12,0,65530,26115,5212,34722,0
51,1046,447,308,343,6,5,95,453,7,96,59,111,103,170,651,1136,4,4600,255,0,2,14,0,65530,26118,5212,34723,0
51,1046,322,174,179,16,74,51,338,10,41,26,46,51,72,252,408,5,2291,127,0,2,14,0,65530,26121,5213,34724,0
41,1806,447,308,343,6,5,95,453,7,96,59,111,103,170,651,1136,4,4600,255,0,2,26,0,65530,26124,5213,34725,0
91,2946,773,419,590,28,0,166,801,10,204,113,217,214,330,1598,2554,5,13587,754,0,2,1,1,65530,26124,5214,34726,0
46,955,386,256,301,16,9,68,402,4,59,35,69,63,104,355,621,2,1453,80,0,2,2,0,65530,26124,5214,34727,0
46,955,264,131,164,11,41,46,275,6,38,22,40,44,62,214,338,3,1068,59,0,2,2,0,65540,26124,5215,34728,0
52,1071,447,308,343,6,5,95,453,7,96,59,111,103,170,651,1136,4,4600,255,0,2,9,1,65540,26127,5215,34729,1
52,1071,322,174,179,16,74,51,338,10,41,26,46,51,72,252,408,5,2291,127,0,2,9,1,65540,26130,5216,34730,1
95,3964,1289,550,1043,56,32,155,1345,10,167,93,185,177,278,1266,2075,5,11498,638,0,2,2,2,65540,26132,5217,34731,1
44,3226,996,429,845,24,10,117,1020,7,76,50,88,83,138,494,879,4,3565,198,0,2,7,7,65540,26134,5217,34732,1
95,4642,1523,757,1297,19,12,193,1542,12,193,117,230,205,347,1508,2664,7,19053,1058,0,2,1,1,65550,26136,5217,34733,1
42,1899,447,308,343,6,5,95,453,7,96,59,111,103,170,651,1136,4,4600,255,0,2,20,7,65550,26139,5217,34734,1
52,1071,447,308,343,6,5,95,453,7,96,59,111,103,170,651,1136,4,4600,255,0,2,23,1,65550,26142,5217,34735,0
52,1071,322,174,179,16,74,51,338,10,41,26,46,51,72,252,408,5,2291,127,0,2,23,1,65550,26145,5218,34736,0
46,955,386,256,301,16,9,68,402,4,59,35,69,63,104,355,621,2,1453,80,0,2,2,0,65550,26145,5218,34737,0
46,955,264,131,164,11,41,46,275,6,38,22,40,44,62,214,338,3,1068,59,0,2,2,0,65560,26145,5219,34738,0
95,3964,1289,550,1043,56,32,155,1345,10,167,93,185,177,278,1266,2075,5,11498,638,0,2,2,2,65560,26147,5220,34739,0
91,2946,773,419,590,28,0,166,801,10,204,113,217,214,330,1598,2554,5,13587,754,0,2,1,1,65560,26147,5221,34740,0
44,3226,996,429,845,24,10,117,1020,7,76,50,88,83,138,494,879,4,3565,198,0,2,7,7,65560,26149,5221,34741,0
95,4642,1523,757,1297,19,12,193,1542,12,193,117,230,205,347,1508,2664,7,19053,1058,0,2,1,1,65570,26151,5221,34742,0
42,1899,447,308,343,6,5,95,453,7,96,59,111,103,170,651,1136,4,4600,255,0,2,42,3,65570,26154,5221,34743,0
180,5387,1660,832,1314,41,38,274,1701,20,312,209,395,332,604,2671,5058,12,64042,3557,1,2,10,10,65570,26156,5222,34745,0
180,5387,1057,646,719,113,100,145,1170,18,215,134,248,233,382,1740,3004,10,31186,1732,1,2,10,10,65580,26157,5223,34746,0
218,4705,2,2,2,0,0,0,2,0,0,0,0,0,0,0,0,0,0,0,0,2,6,1,65580,26157,5223,34746,0
218,4705,99,48,90,1,3,5,100,0,0,0,0,0,0,0,0,0,0,0,0,2,6,1,65580,26158,5223,34747,0
218,4705,8,5,5,2,0,1,10,0,0,0,0,0,0,0,0,0,0,0,0,2,6,1,65580,26158,5223,34748,0
218,4705,1217,716,841,84,126,174,1301,14,185,118,215,199,333,1446,2542,8,20687,1149,0,2,6,1,65590,26160,5223,34749,0
218,4705,160,89,115,0,13,31,160,7,15,11,17,22,28,78,124,3,495,27,0,2,6,1,65590,26160,5223,34750,0
218,4705,10,10,9,9,0,0,19,0,0,0,0,0,0,0,0,0,0,0,0,2,6,1,65590,26160,5224,34751,0
218,4705,173,84,99,8,29,36,181,5,12,7,13,17,20,54,81,2,221,12,0,2,6,1,65590,26161,5224,34752,0
218,4705,3,1,1,3,0,0,6,0,0,0,0,0,0,0,0,0,0,0,0,2,6,1,65590,26161,5224,34753,0
52,622,647,139,84,35,284,233,682,0,0,0,0,0,0,0,0,0,0,0,0,2,3,0,65590,26161,5224,34754,0
23,367,102,57,55,5,16,25,107,5,17,10,18,22,28,81,124,2,330,18,0,2,4,1,65590,26161,5224,34755,0
52,1071,447,308,343,6,5,95,453,7,96,59,111,103,170,651,1136,4,4600,255,0,2,23,1,65590,26164,5224,34756,0
52,1071,322,174,179,16,74,51,338,10,41,26,46,51,72,252,408,5,2291,127,0,2,23,1,65590,26167,5225,34757,0
46,955,386,256,301,16,9,68,402,4,59,35,69,63,104,355,621,2,1453,80,0,2,2,0,65590,26167,5225,34758,0
46,955,264,131,164,11,41,46,275,6,38,22,40,44,62,214,338,3,1068,59,0,2,2,0,65600,26167,5226,34759,0
28,707,466,257,367,18,25,50,484,7,126,86,171,133,257,898,1813,4,8612,478,0,2,2,2,65600,26167,5226,34760,0
28,707,507,281,342,29,59,88,536,10,53,29,57,63,86,336,514,5,2764,153,0,2,2,2,65600,26167,5226,34761,0
223,4840,1943,715,1694,26,18,214,1969,12,185,120,237,197,357,1436,2721,7,20915,1161,0,2,4,3,65600,26169,5226,34762,0
223,4840,1168,838,957,57,25,144,1225,19,348,224,416,367,640,3018,5452,11,61921,3440,1,2,4,3,65610,26171,5226,34763,0
95,3964,1289,550,1043,56,32,155,1345,10,167,93,185,177,278,1266,2075,5,11498,638,0,2,2,2,65610,26173,5227,34764,0
91,2946,773,419,590,28,0,166,801,10,204,113,217,214,330,1598,2554,5,13587,754,0,2,1,1,65610,26173,5228,34765,0
24,1145,75,38,59,1,3,12,76,2,4,2,4,6,6,10,15,1,15,0,0,2,33,14,65610,26173,5228,34766,0
166,4970,1660,832,1314,41,38,274,1701,20,312,209,395,332,604,2671,5058,12,64042,3557,1,2,42,0,65610,26175,5229,34768,0
44,3226,996,429,845,24,10,117,1020,7,76,50,88,83,138,494,879,4,3565,198,0,2,7,7,65610,26177,5229,34769,0
39,2322,652,304,544,16,6,88,668,6,89,51,101,95,152,591,998,3,3399,188,0,2,1,0,65610,26178,5229,34770,0
95,4642,1523,757,1297,19,12,193,1542,12,193,117,230,205,347,1508,2664,7,19053,1058,0,2,1,1,65620,26180,5229,34771,0
97,4228,1020,354,843,12,15,144,1032,8,134,77,144,142,221,970,1580,4,6792,377,0,2,12,0,65620,26180,5229,34772,0
42,1899,447,308,343,6,5,95,453,7,96,59,111,103,170,651,1136,4,4600,255,0,2,42,3,65620,26183,5229,34773,0
99,5070,1943,715,1694,26,18,214,1969,12,185,120,237,197,357,1436,2721,7,20915,1161,0,2,11,3,65620,26185,5229,34774,0
68,1571,773,419,590,28,0,166,801,10,204,113,217,214,330,1598,2554,5,13587,754,0,2,2,46,65620,26185,5230,34775,0
68,1571,421,273,302,44,34,57,465,17,81,59,107,98,166,583,1098,11,12329,684,0,2,2,46,65620,26185,5231,34776,0
91,2922,773,419,590,28,0,166,801,10,204,113,217,214,330,1598,2554,5,13587,754,0,2,9,15,65620,26185,5232,34777,0
180,5387,1660,832,1314,41,38,274,1701,20,312,209,395,332,604,2671,5058,12,64042,3557,1,2,10,10,65620,26187,5233,34779,0
180,5387,1057,646,719,113,100,145,1170,18,215,134,248,233,382,1740,3004,10,31186,1732,1,2,10,10,65630,26188,5234,34780,0
218,4705,2,2,2,0,0,0,2,0,0,0,0,0,0,0,0,0,0,0,0,2,6,1,65630,26188,5234,34780,0
218,4705,99,48,90,1,3,5,100,0,0,0,0,0,0,0,0,0,0,0,0,2,6,1,65630,26189,5234,34781,0
218,4705,8,5,5,2,0,1,10,0,0,0,0,0,0,0,0,0,0,0,0,2,6,1,65630,26189,5234,34782,0
218,4705,1217,716,841,84,126,174,1301,14,185,118,215,199,333,1446,2542,8,20687,1149,0,2,6,1,65640,26191,5234,34783,0
218,4705,160,89,115,0,13,31,160,7,15,11,17,22,28,78,124,3,495,27,0,2,6,1,65640,26191,5234,34784,0
218,4705,10,10,9,9,0,0,19,0,0,0,0,0,0,0,0,0,0,0,0,2,6,1,65640,26191,5235,34785,0
218,4705,173,84,99,8,29,36,181,5,12,7,13,17,20,54,81,2,221,12,0,2,6,1,65640,26192,5235,34786,0
218,4705,3,1,1,3,0,0,6,0,0,0,0,0,0,0,0,0,0,0,0,2,6,1,65640,26192,5235,34787,0
52,622,647,139,84,35,284,233,682,0,0,0,0,0,0,0,0,0,0,0,0,2,3,0,65640,26192,5235,34788,0
23,367,102,57,55,5,16,25,107,5,17,10,18,22,28,81,124,2,330,18,0,2,4,1,65640,26192,5235,34789,0
52,1071,447,308,343,6,5,95,453,7,96,59,111,103,170,651,1136,4,4600,255,0,2,23,1,65640,26195,5235,34790,0
52,1071,322,174,179,16,74,51,338,10,41,26,46,51,72,252,408,5,2291,127,0,2,23,1,65640,26198,5236,34791,0
46,955,386,256,301,16,9,68,402,4,59,35,69,63,104,355,621,2,1453,80,0,2,2,0,65640,26198,5236,34792,0
46,955,264,131,164,11,41,46,275,6,38,22,40,44,62,214,338,3,1068,59,0,2,2,0,65650,26198,5237,34793,0
28,707,466,257,367,18,25,50,484,7,126,86,171,133,257,898,1813,4,8612,478,0,2,2,2,65650,26198,5237,34794,0
28,707,507,281,342,29,59,88,536,10,53,29,57,63,86,336,514,5,2764,153,0,2,2,2,65650,26198,5237,34795,0
223,4840,1943,715,1694,26,18,214,1969,12,185,120,237,197,357,1436,2721,7,20915,1161,0,2,4,3,65650,26200,5237,34796,0
223,4840,1168,838,957,57,25,144,1225,19,348,224,416,367,640,3018,5452,11,61921,3440,1,2,4,3,65660,26202,5237,34797,0
95,3964,1289,550,1043,56,32,155,1345,10,167,93,185,177,278,1266,2075,5,11498,638,0,2,2,2,65660,26204,5238,34798,0
91,2946,773,419,590,28,0,166,801,10,204,113,217,214,330,1598,2554,5,13587,754,0,2,1,1,65660,26204,5239,34799,0
24,1145,75,38,59,1,3,12,76,2,4,2,4,6,6,10,15,1,15,0,0,2,33,14,65660,26204,5239,34800,0
166,4970,1660,832,1314,41,38,274,1701,20,312,209,395,332,604,2671,5058,12,64042,3557,1,2,42,0,65660,26206,5240,34802,0
44,3226,996,429,845,24,10,117,1020,7,76,50,88,83,138,494,879,4,3565,198,0,2,7,7,65660,26208,5240,34803,0
39,2322,652,304,544,16,6,88,668,6,89,51,101,95,152,591,998,3,3399,188,0,2,1,0,65660,26209,5240,34804,0
95,4642,1523,757,1297,19,12,193,1542,12,193,117,230,205,347,1508,2664,7,19053,1058,0,2,1,1,65670,26211,5240,34805,0
97,4228,1020,354,843,12,15,144,1032,8,134,77,144,142,221,970,1580,4,6792,377,0,2,12,0,65670,26211,5240,34806,0
42,1899,447,308,343,6,5,95,453,7,96,59,111,103,170,651,1136,4,4600,255,0,2,42,3,65670,26214,5240,34807,0
99,5070,1943,715,1694,26,18,214,1969,12,185,120,237,197,357,1436,2721,7,20915,1161,0,2,11,3,65670,26216,5240,34808,0
90,2885,773,419,590,28,0,166,801,10,204,113,217,214,330,1598,2554,5,13587,754,0,2,2,10,65670,26216,5241,34809,0
68,1561,773,419,590,28,0,166,801,10,204,113,217,214,330,1598,2554,5,13587,754,0,2,4,11,65670,26216,5242,34810,0
68,1561,421,273,302,44,34,57,465,17,81,59,107,98,166,583,1098,11,12329,684,0,2,4,11,65670,26216,5243,34811,0
254,5861,4293,999,3693,19,54,507,4312,9,155,88,170,164,258,1156,1898,4,9368,520,0,2,4,2,65670,26218,5243,34812,0
254,5861,1482,859,1002,125,135,219,1607,16,219,134,251,235,385,1766,3032,9,27804,1544,1,2,4,2,65680,26219,5243,34813,0
4,61,20,12,12,0,0,8,20,1,2,1,2,3,3,2,4,0,2,0,0,0,20,0,65680,26219,5243,34814,0
178,7880,139,89,101,2,0,35,141,7,54,34,62,61,96,330,569,4,2287,127,0,2,6,0,65680,26219,5243,34815,0
178,7880,7,5,5,0,0,2,7,1,2,1,2,3,3,2,4,0,2,0,0,2,6,0,65680,26219,5243,34816,0
256,5900,4293,999,3693,19,54,507,4312,9,155,88,170,164,258,1156,1898,4,9368,520,0,2,18,3,65680,26221,5243,34817,0
256,5900,1482,859,1002,125,135,219,1607,16,219,134,251,235,385,1766,3032,9,27804,1544,1,2,18,3,65690,26222,5243,34818,0
2,51,14,9,9,0,0,5,14,0,0,0,0,0,0,0,0,0,0,0,0,0,13,0,65690,26222,5243,34819,0
177,7850,139,89,101,2,0,35,141,7,54,34,62,61,96,330,569,4,2287,127,0,2,8,4,65690,26222,5243,34820,0
177,7850,7,5,5,0,0,2,7,1,2,1,2,3,3,2,4,0,2,0,0,2,8,4,65690,26222,5243,34821,0
51,1913,1098,241,925,5,10,155,1103,7,46,25,49,53,74,273,423,3,1580,87,0,2,12,0,65700,26224,5243,34822,0
68,1561,773,419,590,28,0,166,801,10,204,113,217,214,330,1598,2554,5,13587,754,0,2,6,57,65700,26224,5244,34823,0
68,1561,421,273,302,44,34,57,465,17,81,59,107,98,166,583,1098,11,12329,684,0,2,6,57,65700,26224,5245,34824,0
90,2885,773,419,590,28,0,166,801,10,204,113,217,214,330,1598,2554,5,13587,754,0,2,9,23,65700,26224,5246,34825,0
11,415,42,7,35,4,0,5,46,1,2,1,2,3,3,2,4,0,2,0,0,2,1,0,65700,26224,5246,34826,1
11,415,11,6,10,0,0,1,11,2,4,2,4,6,6,10,15,1,15,0,0,2,1,0,65700,26224,5246,34827,1
242,5716,722,423,573,19,0,135,741,12,172,101,199,184,300,1320,2257,6,15668,870,0,2,33,3,65700,26226,5246,34829,1
242,5716,1508,847,911,44,250,301,1552,14,148,88,169,162,257,1120,1886,7,15077,837,0,2,33,3,65700,26227,5247,34830,1
46,2172,722,423,573,19,0,135,741,12,172,101,199,184,300,1320,2257,6,15668,870,0,2,18,0,65700,26229,5247,34832,1
242,5718,722,423,573,19,0,135,741,12,172,101,199,184,300,1320,2257,6,15668,870,0,2,1,1,65700,26231,5247,34834,0
242,5718,1508,847,911,44,250,301,1552,14,148,88,169,162,257,1120,1886,7,15077,837,0,2,1,1,65700,26232,5248,34835,0
254,5861,4293,999,3693,19,54,507,4312,9,155,88,170,164,258,1156,1898,4,9368,520,0,2,4,2,65700,26234,5248,34836,0
254,5861,1482,859,1002,125,135,219,1607,16,219,134,251,235,385,1766,3032,9,27804,1544,1,2,4,2,65710,26235,5248,34837,0
4,61,20,12,12,0,0,8,20,1,2,1,2,3,3,2,4,0,2,0,0,0,20,0,65710,26235,5248,34838,0
178,7880,139,89,101,2,0,35,141,7,54,34,62,61,96,330,569,4,2287,127,0,2,6,0,65710,26235,5248,34839,0
178,7880,7,5,5,0,0,2,7,1,2,1,2,3,3,2,4,0,2,0,0,2,6,0,65710,26235,5248,34840,0
242,5718,722,423,573,19,0,135,741,12,172,101,199,184,300,1320,2257,6,15668,870,0,2,1,1,65710,26237,5248,34842,0
242,5718,1508,847,911,44,250,301,1552,14,148,88,169,162,257,1120,1886,7,15077,837,0,2,1,1,65710,26238,5249,34843,0
46,2170,722,423,573,19,0,135,741,12,172,101,199,184,300,1320,2257,6,15668,870,0,2,1,2,65710,26240,5249,34845,0
11,413,42,7,35,4,0,5,46,1,2,1,2,3,3,2,4,0,2,0,0,2,0,1,65710,26240,5249,34846,0
11,413,11,6,10,0,0,1,11,2,4,2,4,6,6,10,15,1,15,0,0,2,0,1,65710,26240,5249,34847,0
242,5716,722,423,573,19,0,135,741,12,172,101,199,184,300,1320,2257,6,15668,870,0,2,2,3,65710,26242,5249,34849,0
242,5716,1508,847,911,44,250,301,1552,14,148,88,169,162,257,1120,1886,7,15077,837,0,2,2,3,65710,26243,5250,34850,0
242,5735,722,423,573,19,0,135,741,12,172,101,199,184,300,1320,2257,6,15668,870,0,2,8,2,65710,26245,5250,34852,0
242,5735,1508,847,911,44,250,301,1552,14,148,88,169,162,257,1120,1886,7,15077,837,0,2,8,2,65710,26246,5251,34853,0
243,5749,722,423,573,19,0,135,741,12,172,101,199,184,300,1320,2257,6,15668,870,0,2,11,6,65710,26248,5251,34855,0
243,5749,1508,847,911,44,250,301,1552,14,148,88,169,162,257,1120,1886,7,15077,837,0,2,11,6,65710,26249,5252,34856,0
243,5757,722,423,573,19,0,135,741,12,172,101,199,184,300,1320,2257,6,15668,870,0,2,3,1,65710,26251,5252,34858,1
243,5757,1508,847,911,44,250,301,1552,14,148,88,169,162,257,1120,1886,7,15077,837,0,2,3,1,65710,26252,5253,34859,1
47,2227,722,423,573,19,0,135,741,12,172,101,199,184,300,1320,2257,6,15668,870,0,2,13,0,65710,26254,5253,34861,1
47,2225,722,423,573,19,0,135,741,12,172,101,199,184,300,1320,2257,6,15668,870,0,2,1,1,65710,26256,5253,34863,0
242,5792,722,423,573,19,0,135,741,12,172,101,199,184,300,1320,2257,6,15668,870,0,2,21,14,65710,26258,5253,34865,0
242,5792,1508,847,911,44,250,301,1552,14,148,88,169,162,257,1120,1886,7,15077,837,0,2,21,14,65710,26259,5254,34866,0
241,5777,722,423,573,19,0,135,741,12,172,101,199,184,300,1320,2257,6,15668,870,0,2,1,6,65710,26261,5254,34868,0
241,5777,1508,847,911,44,250,301,1552,14,148,88,169,162,257,1120,1886,7,15077,837,0,2,1,6,65710,26262,5255,34869,0
243,5819,722,423,573,19,0,135,741,12,172,101,199,184,300,1320,2257,6,15668,870,0,2,12,2,65710,26264,5255,34871,1
243,5819,1508,847,911,44,250,301,1552,14,148,88,169,162,257,1120,1886,7,15077,837,0,2,12,2,65710,26265,5256,34872,1
243,5819,722,423,573,19,0,135,741,12,172,101,199,184,300,1320,2257,6,15668,870,0,2,0,1,65710,26267,5256,34874,0
243,5819,1508,847,911,44,250,301,1552,14,148,88,169,162,257,1120,1886,7,15077,837,0,2,0,1,65710,26268,5257,34875,0
244,5784,722,423,573,19,0,135,741,12,172,101,199,184,300,1320,2257,6,15668,870,0,2,14,21,65710,26270,5257,34877,0
244,5784,1508,847,911,44,250,301,1552,14,148,88,169,162,257,1120,1886,7,15077,837,0,2,14,21,65710,26271,5258,34878,0
244,5775,722,423,573,19,0,135,741,12,172,101,199,184,300,1320,2257,6,15668,870,0,2,1,4,65710,26273,5258,34880,1
244,5775,1508,847,911,44,250,301,1552,14,148,88,169,162,257,1120,1886,7,15077,837,0,2,1,4,65710,26274,5259,34881,1
47,2225,722,423,573,19,0,135,741,12,172,101,199,184,300,1320,2257,6,15668,870,0,2,1,1,65710,26276,5259,34883,0
244,5775,722,423,573,19,0,135,741,12,172,101,199,184,300,1320,2257,6,15668,870,0,2,8,0,65710,26278,5259,34885,0
244,5775,1508,847,911,44,250,301,1552,14,148,88,169,162,257,1120,1886,7,15077,837,0,2,8,0,65710,26279,5260,34886,0
244,5770,722,423,573,19,0,135,741,12,172,101,199,184,300,1320,2257,6,15668,870,0,2,1,2,65710,26281,5260,34888,0
244,5770,1508,847,911,44,250,301,1552,14,148,88,169,162,257,1120,1886,7,15077,837,0,2,1,2,65710,26282,5261,34889,0
256,5920,4293,999,3693,19,54,507,4312,9,155,88,170,164,258,1156,1898,4,9368,520,0,2,18,3,65710,26284,5261,34890,0
256,5920,1482,859,1002,125,135,219,1607,16,219,134,251,235,385,1766,3032,9,27804,1544,1,2,18,3,65720,26285,5261,34891,0
2,51,14,9,9,0,0,5,14,0,0,0,0,0,0,0,0,0,0,0,0,0,13,0,65720,26285,5261,34892,0
178,7880,139,89,101,2,0,35,141,7,54,34,62,61,96,330,569,4,2287,127,0,2,8,4,65720,26285,5261,34893,0
178,7880,7,5,5,0,0,2,7,1,2,1,2,3,3,2,4,0,2,0,0,2,8,4,65720,26285,5261,34894,0
51,1913,1098,241,925,5,10,155,1103,7,46,25,49,53,74,273,423,3,1580,87,0,2,12,0,65730,26287,5261,34895,0
244,5779,722,423,573,19,0,135,741,12,172,101,199,184,300,1320,2257,6,15668,870,0,2,6,0,65730,26289,5261,34897,0
244,5779,1508,847,911,44,250,301,1552,14,148,88,169,162,257,1120,1886,7,15077,837,0,2,6,0,65730,26290,5262,34898,0
47,2225,722,423,573,19,0,135,741,12,172,101,199,184,300,1320,2257,6,15668,870,0,2,1,1,65730,26292,5262,34900,0
244,5779,722,423,573,19,0,135,741,12,172,101,199,184,300,1320,2257,6,15668,870,0,2,59,3,65730,26294,5262,34902,0
244,5779,1508,847,911,44,250,301,1552,14,148,88,169,162,257,1120,1886,7,15077,837,0,2,59,3,65730,26295,5263,34903,0
47,2225,722,423,573,19,0,135,741,12,172,101,199,184,300,1320,2257,6,15668,870,0,2,30,0,65730,26297,5263,34905,0
92,1945,1043,504,840,53,9,147,1096,9,180,112,198,189,310,1377,2344,4,11604,644,0,2,3,0,65730,26299,5263,34906,0
92,1945,383,288,292,26,6,62,409,11,65,38,67,76,105,429,656,5,3719,206,0,2,3,0,65730,26300,5263,34907,0
101,4044,1289,550,1043,56,32,155,1345,10,167,93,185,177,278,1266,2075,5,11498,638,0,2,23,9,65730,26302,5264,34908,0
3,42,14,8,8,0,0,6,14,0,0,0,0,0,0,0,0,0,0,0,0,2,0,1,65730,26302,5264,34910,1
60,1079,282,196,195,3,0,86,285,8,130,71,141,138,212,936,1507,4,6538,363,0,2,3,3,65730,26302,5265,34911,1
1,9,5,3,3,0,0,2,5,0,0,0,0,0,0,0,0,0,0,0,0,2,0,1,65730,26302,5265,34911,1
1,90,13,10,10,0,0,3,13,1,2,1,2,3,3,2,4,0,2,0,0,2,0,1,65730,26302,5265,34912,1
3,66,127,75,83,2,11,30,129,4,14,7,14,18,21,61,87,2,175,9,0,2,0,1,65730,26302,5265,34913,1
3,66,652,304,544,16,6,88,668,6,89,51,101,95,152,591,998,3,3399,188,0,2,0,1,65730,26303,5265,34914,1
3,66,2,2,2,0,0,0,2,0,0,0,0,0,0,0,0,0,0,0,0,2,0,1,65730,26303,5265,34914,1
3,66,8,5,5,0,0,3,8,0,0,0,0,0,0,0,0,0,0,0,0,2,0,1,65730,26303,5265,34915,1
3,66,2,2,2,0,0,0,2,0,0,0,0,0,0,0,0,0,0,0,0,2,0,1,65730,26303,5265,34915,1
3,66,14,8,8,0,0,6,14,0,0,0,0,0,0,0,0,0,0,0,0,2,0,1,65730,26303,5265,34916,1
3,66,6,4,4,0,0,2,6,0,0,0,0,0,0,0,0,0,0,0,0,2,0,1,65730,26303,5265,34917,1
3,66,6,4,4,0,0,2,6,1,2,1,2,3,3,2,4,0,2,0,0,2,0,1,65730,26303,5265,34918,1
3,66,6,4,4,0,0,2,6,0,0,0,0,0,0,0,0,0,0,0,0,2,0,1,65730,26303,5265,34919,1
3,66,7,5,5,0,0,2,7,0,0,0,0,0,0,0,0,0,0,0,0,2,0,1,65730,26303,5265,34920,1
3,66,6,4,4,0,0,2,6,0,0,0,0,0,0,0,0,0,0,0,0,2,0,1,65730,26303,5265,34921,1
3,66,10,6,6,0,0,4,10,0,0,0,0,0,0,0,0,0,0,0,0,2,0,1,65730,26303,5265,34922,1
3,66,1,1,1,0,0,0,1,0,0,0,0,0,0,0,0,0,0,0,0,2,0,1,65730,26303,5265,34922,1
3,66,14,10,10,0,0,4,14,1,1,1,1,2,2,0,2,0,1,0,0,2,0,1,65730,26303,5265,34923,1
3,66,46,26,30,3,0,12,49,3,6,3,6,9,9,20,28,1,42,2,0,2,0,1,65740,26303,5265,34924,1
11,238,19,8,11,5,0,4,24,2,5,3,6,7,9,13,25,1,30,1,0,2,0,1,65740,26303,5265,34925,1
11,238,102,59,69,5,3,24,107,6,22,15,28,28,43,113,206,3,789,43,0,2,0,1,65740,26303,5265,34926,1
11,238,106,40,36,3,49,17,109,8,17,13,23,25,36,93,167,5,904,50,0,2,0,1,65740,26303,5265,34927,1
218,4706,2,2,2,0,0,0,2,0,0,0,0,0,0,0,0,0,0,0,0,2,1,1,65740,26303,5265,34927,1
218,4706,99,48,90,1,3,5,100,0,0,0,0,0,0,0,0,0,0,0,0,2,1,1,65740,26304,5265,34928,1
218,4706,8,5,5,2,0,1,10,0,0,0,0,0,0,0,0,0,0,0,0,2,1,1,65740,26304,5265,34929,1
218,4706,1217,716,841,84,126,174,1301,14,185,118,215,199,333,1446,2542,8,20687,1149,0,2,1,1,65750,26306,5265,34930,1
218,4706,160,89,115,0,13,31,160,7,15,11,17,22,28,78,124,3,495,27,0,2,1,1,65750,26306,5265,34931,1
218,4706,10,10,9,9,0,0,19,0,0,0,0,0,0,0,0,0,0,0,0,2,1,1,65750,26306,5266,34932,1
218,4706,173,84,99,8,29,36,181,5,12,7,13,17,20,54,81,2,221,12,0,2,1,1,65750,26307,5266,34933,1
218,4706,3,1,1,3,0,0,6,0,0,0,0,0,0,0,0,0,0,0,0,2,1,1,65750,26307,5266,34934,1
98,2660,1523,757,1297,19,12,193,1542,12,193,117,230,205,347,1508,2664,7,19053,1058,0,2,1,1,65760,26309,5266,34935,1
98,2660,701,378,504,33,58,109,734,13,110,68,126,123,194,794,1346,7,10027,557,0,2,1,1,65760,26310,5267,34936,1
85,2240,773,422,505,30,103,129,803,14,77,46,83,91,129,535,839,7,6334,351,0,2,3,1,65770,26311,5268,34937,1
30,660,125,97,103,3,0,19,128,9,25,17,27,34,44,144,223,4,1087,60,0,2,4,1,65770,26311,5269,34938,1
1,20,127,75,83,2,11,30,129,4,14,7,14,18,21,61,87,2,175,9,0,2,0,1,65770,26311,5269,34939,1
1,20,652,304,544,16,6,88,668,6,89,51,101,95,152,591,998,3,3399,188,0,2,0,1,65770,26312,5269,34940,1
1,20,2,2,2,0,0,0,2,0,0,0,0,0,0,0,0,0,0,0,0,2,0,1,65770,26312,5269,34940,1
1,20,8,5,5,0,0,3,8,0,0,0,0,0,0,0,0,0,0,0,0,2,0,1,65770,26312,5269,34941,1
1,20,2,2,2,0,0,0,2,0,0,0,0,0,0,0,0,0,0,0,0,2,0,1,65770,26312,5269,34941,1
1,20,14,8,8,0,0,6,14,0,0,0,0,0,0,0,0,0,0,0,0,2,0,1,65770,26312,5269,34942,1
1,20,6,4,4,0,0,2,6,0,0,0,0,0,0,0,0,0,0,0,0,2,0,1,65770,26312,5269,34943,1
1,20,6,4,4,0,0,2,6,1,2,1,2,3,3,2,4,0,2,0,0,2,0,1,65770,26312,5269,34944,1
1,20,6,4,4,0,0,2,6,0,0,0,0,0,0,0,0,0,0,0,0,2,0,1,65770,26312,5269,34945,1
1,20,7,5,5,0,0,2,7,0,0,0,0,0,0,0,0,0,0,0,0,2,0,1,65770,26312,5269,34946,1
1,20,6,4,4,0,0,2,6,0,0,0,0,0,0,0,0,0,0,0,0,2,0,1,65770,26312,5269,34947,1
1,20,10,6,6,0,0,4,10,0,0,0,0,0,0,0,0,0,0,0,0,2,0,1,65770,26312,5269,34948,1
1,20,1,1,1,0,0,0,1,0,0,0,0,0,0,0,0,0,0,0,0,2,0,1,65770,26312,5269,34948,1
1,20,14,10,10,0,0,4,14,1,1,1,1,2,2,0,2,0,1,0,0,2,0,1,65770,26312,5269,34949,1
1,20,46,26,30,3,0,12,49,3,6,3,6,9,9,20,28,1,42,2,0,2,0,1,65780,26312,5269,34950,1
3,39,15,9,9,0,0,6,15,0,0,0,0,0,0,0,0,0,0,0,0,2,0,1,65780,26312,5269,34951,1
2,36,10,7,7,0,0,3,10,1,2,1,2,3,3,2,4,0,2,0,0,2,0,1,65780,26312,5269,34952,1
8,263,51,25,36,0,0,15,51,3,11,6,12,14,18,42,68,1,112,6,0,2,0,1,65780,26312,5269,34953,1
63,4331,520,294,400,33,13,81,553,10,261,204,367,271,571,2128,4614,7,32445,1802,1,2,9,9,65780,26313,5269,34954,1
44,2109,722,423,573,19,0,135,741,12,172,101,199,184,300,1320,2257,6,15668,870,0,2,1,1,65780,26315,5269,34956,1
85,2238,773,422,505,30,103,129,803,14,77,46,83,91,129,535,839,7,6334,351,0,2,2,3,65790,26316,5270,34957,1
151,7095,1392,870,1177,35,17,170,1427,14,494,280,531,508,811,4473,7289,7,54850,3047,2,2,26,26,65790,26319,5271,34958,1
15,703,139,89,101,2,0,35,141,7,54,34,62,61,96,330,569,4,2287,127,0,2,1,1,65790,26319,5271,34959,1
151,7095,1392,870,1177,35,17,170,1427,14,494,280,531,508,811,4473,7289,7,54850,3047,2,2,2,2,65790,26322,5272,34960,0
151,7095,1392,870,1177,35,17,170,1427,14,494,280,531,508,811,4473,7289,7,54850,3047,2,2,1,1,65790,26325,5273,34961,0
151,7095,1392,870,1177,35,17,170,1427,14,494,280,531,508,811,4473,7289,7,54850,3047,2,2,26,26,65790,26328,5274,34962,0
15,703,139,89,101,2,0,35,141,7,54,34,62,61,96,330,569,4,2287,127,0,2,1,1,65790,26328,5274,34963,0
47,2228,722,423,573,19,0,135,741,12,172,101,199,184,300,1320,2257,6,15668,870,0,2,4,2,65790,26330,5274,34965,0
3,42,14,8,8,0,0,6,14,0,0,0,0,0,0,0,0,0,0,0,0,2,0,1,65790,26330,5274,34967,0
60,1079,282,196,195,3,0,86,285,8,130,71,141,138,212,936,1507,4,6538,363,0,2,3,3,65790,26330,5275,34968,0
1,9,5,3,3,0,0,2,5,0,0,0,0,0,0,0,0,0,0,0,0,2,0,1,65790,26330,5275,34968,0
1,90,13,10,10,0,0,3,13,1,2,1,2,3,3,2,4,0,2,0,0,2,0,1,65790,26330,5275,34969,0
3,66,127,75,83,2,11,30,129,4,14,7,14,18,21,61,87,2,175,9,0,2,0,1,65790,26330,5275,34970,0
3,66,652,304,544,16,6,88,668,6,89,51,101,95,152,591,998,3,3399,188,0,2,0,1,65790,26331,5275,34971,0
3,66,2,2,2,0,0,0,2,0,0,0,0,0,0,0,0,0,0,0,0,2,0,1,65790,26331,5275,34971,0
3,66,8,5,5,0,0,3,8,0,0,0,0,0,0,0,0,0,0,0,0,2,0,1,65790,26331,5275,34972,0
3,66,2,2,2,0,0,0,2,0,0,0,0,0,0,0,0,0,0,0,0,2,0,1,65790,26331,5275,34972,0
3,66,14,8,8,0,0,6,14,0,0,0,0,0,0,0,0,0,0,0,0,2,0,1,65790,26331,5275,34973,0
3,66,6,4,4,0,0,2,6,0,0,0,0,0,0,0,0,0,0,0,0,2,0,1,65790,26331,5275,34974,0
3,66,6,4,4,0,0,2,6,1,2,1,2,3,3,2,4,0,2,0,0,2,0,1,65790,26331,5275,34975,0
3,66,6,4,4,0,0,2,6,0,0,0,0,0,0,0,0,0,0,0,0,2,0,1,65790,26331,5275,34976,0
3,66,7,5,5,0,0,2,7,0,0,0,0,0,0,0,0,0,0,0,0,2,0,1,65790,26331,5275,34977,0
3,66,6,4,4,0,0,2,6,0,0,0,0,0,0,0,0,0,0,0,0,2,0,1,65790,26331,5275,34978,0
3,66,10,6,6,0,0,4,10,0,0,0,0,0,0,0,0,0,0,0,0,2,0,1,65790,26331,5275,34979,0
3,66,1,1,1,0,0,0,1,0,0,0,0,0,0,0,0,0,0,0,0,2,0,1,65790,26331,5275,34979,0
3,66,14,10,10,0,0,4,14,1,1,1,1,2,2,0,2,0,1,0,0,2,0,1,65790,26331,5275,34980,0
3,66,46,26,30,3,0,12,49,3,6,3,6,9,9,20,28,1,42,2,0,2,0,1,65800,26331,5275,34981,0
11,238,19,8,11,5,0,4,24,2,5,3,6,7,9,13,25,1,30,1,0,2,0,1,65800,26331,5275,34982,0
11,238,102,59,69,5,3,24,107,6,22,15,28,28,43,113,206,3,789,43,0,2,0,1,65800,26331,5275,34983,0
11,238,106,40,36,3,49,17,109,8,17,13,23,25,36,93,167,5,904,50,0,2,0,1,65800,26331,5275,34984,0
218,4706,2,2,2,0,0,0,2,0,0,0,0,0,0,0,0,0,0,0,0,2,1,1,65800,26331,5275,34984,0
218,4706,99,48,90,1,3,5,100,0,0,0,0,0,0,0,0,0,0,0,0,2,1,1,65800,26332,5275,34985,0
218,4706,8,5,5,2,0,1,10,0,0,0,0,0,0,0,0,0,0,0,0,2,1,1,65800,26332,5275,34986,0
218,4706,1217,716,841,84,126,174,1301,14,185,118,215,199,333,1446,2542,8,20687,1149,0,2,1,1,65810,26334,5275,34987,0
218,4706,160,89,115,0,13,31,160,7,15,11,17,22,28,78,124,3,495,27,0,2,1,1,65810,26334,5275,34988,0
218,4706,10,10,9,9,0,0,19,0,0,0,0,0,0,0,0,0,0,0,0,2,1,1,65810,26334,5276,34989,0
218,4706,173,84,99,8,29,36,181,5,12,7,13,17,20,54,81,2,221,12,0,2,1,1,65810,26335,5276,34990,0
218,4706,3,1,1,3,0,0,6,0,0,0,0,0,0,0,0,0,0,0,0,2,1,1,65810,26335,5276,34991,0
98,2660,1523,757,1297,19,12,193,1542,12,193,117,230,205,347,1508,2664,7,19053,1058,0,2,1,1,65820,26337,5276,34992,0
98,2660,701,378,504,33,58,109,734,13,110,68,126,123,194,794,1346,7,10027,557,0,2,1,1,65820,26338,5277,34993,0
85,2238,773,422,505,30,103,129,803,14,77,46,83,91,129,535,839,7,6334,351,0,2,2,1,65830,26339,5278,34994,0
30,660,125,97,103,3,0,19,128,9,25,17,27,34,44,144,223,4,1087,60,0,2,4,1,65830,26339,5279,34995,0
1,20,127,75,83,2,11,30,129,4,14,7,14,18,21,61,87,2,175,9,0,2,0,1,65830,26339,5279,34996,0
1,20,652,304,544,16,6,88,668,6,89,51,101,95,152,591,998,3,3399,188,0,2,0,1,65830,26340,5279,34997,0
1,20,2,2,2,0,0,0,2,0,0,0,0,0,0,0,0,0,0,0,0,2,0,1,65830,26340,5279,34997,0
1,20,8,5,5,0,0,3,8,0,0,0,0,0,0,0,0,0,0,0,0,2,0,1,65830,26340,5279,34998,0
1,20,2,2,2,0,0,0,2,0,0,0,0,0,0,0,0,0,0,0,0,2,0,1,65830,26340,5279,34998,0
1,20,14,8,8,0,0,6,14,0,0,0,0,0,0,0,0,0,0,0,0,2,0,1,65830,26340,5279,34999,0
1,20,6,4,4,0,0,2,6,0,0,0,0,0,0,0,0,0,0,0,0,2,0,1,65830,26340,5279,35000,0
1,20,6,4,4,0,0,2,6,1,2,1,2,3,3,2,4,0,2,0,0,2,0,1,65830,26340,5279,35001,0
1,20,6,4,4,0,0,2,6,0,0,0,0,0,0,0,0,0,0,0,0,2,0,1,65830,26340,5279,35002,0
1,20,7,5,5,0,0,2,7,0,0,0,0,0,0,0,0,0,0,0,0,2,0,1,65830,26340,5279,35003,0
1,20,6,4,4,0,0,2,6,0,0,0,0,0,0,0,0,0,0,0,0,2,0,1,65830,26340,5279,35004,0
1,20,10,6,6,0,0,4,10,0,0,0,0,0,0,0,0,0,0,0,0,2,0,1,65830,26340,5279,35005,0
1,20,1,1,1,0,0,0,1,0,0,0,0,0,0,0,0,0,0,0,0,2,0,1,65830,26340,5279,35005,0
1,20,14,10,10,0,0,4,14,1,1,1,1,2,2,0,2,0,1,0,0,2,0,1,65830,26340,5279,35006,0
1,20,46,26,30,3,0,12,49,3,6,3,6,9,9,20,28,1,42,2,0,2,0,1,65840,26340,5279,35007,0
3,39,15,9,9,0,0,6,15,0,0,0,0,0,0,0,0,0,0,0,0,2,0,1,65840,26340,5279,35008,0
2,36,10,7,7,0,0,3,10,1,2,1,2,3,3,2,4,0,2,0,0,2,0,1,65840,26340,5279,35009,0
8,263,51,25,36,0,0,15,51,3,11,6,12,14,18,42,68,1,112,6,0,2,0,1,65840,26340,5279,35010,0
63,4331,520,294,400,33,13,81,553,10,261,204,367,271,571,2128,4614,7,32445,1802,1,2,9,9,65840,26341,5279,35011,0
44,2109,722,423,573,19,0,135,741,12,172,101,199,184,300,1320,2257,6,15668,870,0,2,1,1,65840,26343,5279,35013,0
47,2228,722,423,573,19,0,135,741,12,172,101,199,184,300,1320,2257,6,15668,870,0,2,4,2,65840,26345,5279,35015,0
218,4705,2,2,2,0,0,0,2,0,0,0,0,0,0,0,0,0,0,0,0,2,1,1,65840,26345,5279,35015,0
218,4705,99,48,90,1,3,5,100,0,0,0,0,0,0,0,0,0,0,0,0,2,1,1,65840,26346,5279,35016,0
218,4705,8,5,5,2,0,1,10,0,0,0,0,0,0,0,0,0,0,0,0,2,1,1,65840,26346,5279,35017,0
218,4705,1217,716,841,84,126,174,1301,14,185,118,215,199,333,1446,2542,8,20687,1149,0,2,1,1,65850,26348,5279,35018,0
218,4705,160,89,115,0,13,31,160,7,15,11,17,22,28,78,124,3,495,27,0,2,1,1,65850,26348,5279,35019,0
218,4705,10,10,9,9,0,0,19,0,0,0,0,0,0,0,0,0,0,0,0,2,1,1,65850,26348,5280,35020,0
218,4705,173,84,99,8,29,36,181,5,12,7,13,17,20,54,81,2,221,12,0,2,1,1,65850,26349,5280,35021,0
218,4705,3,1,1,3,0,0,6,0,0,0,0,0,0,0,0,0,0,0,0,2,1,1,65850,26349,5280,35022,0
218,4705,2,2,2,0,0,0,2,0,0,0,0,0,0,0,0,0,0,0,0,2,1,1,65850,26349,5280,35022,0
218,4705,99,48,90,1,3,5,100,0,0,0,0,0,0,0,0,0,0,0,0,2,1,1,65850,26350,5280,35023,0
218,4705,8,5,5,2,0,1,10,0,0,0,0,0,0,0,0,0,0,0,0,2,1,1,65850,26350,5280,35024,0
218,4705,1217,716,841,84,126,174,1301,14,185,118,215,199,333,1446,2542,8,20687,1149,0,2,1,1,65860,26352,5280,35025,0
218,4705,160,89,115,0,13,31,160,7,15,11,17,22,28,78,124,3,495,27,0,2,1,1,65860,26352,5280,35026,0
218,4705,10,10,9,9,0,0,19,0,0,0,0,0,0,0,0,0,0,0,0,2,1,1,65860,26352,5281,35027,0
218,4705,173,84,99,8,29,36,181,5,12,7,13,17,20,54,81,2,221,12,0,2,1,1,65860,26353,5281,35028,0
218,4705,3,1,1,3,0,0,6,0,0,0,0,0,0,0,0,0,0,0,0,2,1,1,65860,26353,5281,35029,0
3,42,14,8,8,0,0,6,14,0,0,0,0,0,0,0,0,0,0,0,0,2,0,1,65860,26353,5281,35031,0
60,1079,282,196,195,3,0,86,285,8,130,71,141,138,212,936,1507,4,6538,363,0,2,3,3,65860,26353,5282,35032,0
1,9,5,3,3,0,0,2,5,0,0,0,0,0,0,0,0,0,0,0,0,2,0,1,65860,26353,5282,35032,0
1,90,13,10,10,0,0,3,13,1,2,1,2,3,3,2,4,0,2,0,0,2,0,1,65860,26353,5282,35033,0
3,66,127,75,83,2,11,30,129,4,14,7,14,18,21,61,87,2,175,9,0,2,0,1,65860,26353,5282,35034,0
3,66,652,304,544,16,6,88,668,6,89,51,101,95,152,591,998,3,3399,188,0,2,0,1,65860,26354,5282,35035,0
3,66,2,2,2,0,0,0,2,0,0,0,0,0,0,0,0,0,0,0,0,2,0,1,65860,26354,5282,35035,0
3,66,8,5,5,0,0,3,8,0,0,0,0,0,0,0,0,0,0,0,0,2,0,1,65860,26354,5282,35036,0
3,66,2,2,2,0,0,0,2,0,0,0,0,0,0,0,0,0,0,0,0,2,0,1,65860,26354,5282,35036,0
3,66,14,8,8,0,0,6,14,0,0,0,0,0,0,0,0,0,0,0,0,2,0,1,65860,26354,5282,35037,0
3,66,6,4,4,0,0,2,6,0,0,0,0,0,0,0,0,0,0,0,0,2,0,1,65860,26354,5282,35038,0
3,66,6,4,4,0,0,2,6,1,2,1,2,3,3,2,4,0,2,0,0,2,0,1,65860,26354,5282,35039,0
3,66,6,4,4,0,0,2,6,0,0,0,0,0,0,0,0,0,0,0,0,2,0,1,65860,26354,5282,35040,0
3,66,7,5,5,0,0,2,7,0,0,0,0,0,0,0,0,0,0,0,0,2,0,1,65860,26354,5282,35041,0
3,66,6,4,4,0,0,2,6,0,0,0,0,0,0,0,0,0,0,0,0,2,0,1,65860,26354,5282,35042,0
3,66,10,6,6,0,0,4,10,0,0,0,0,0,0,0,0,0,0,0,0,2,0,1,65860,26354,5282,35043,0
3,66,1,1,1,0,0,0,1,0,0,0,0,0,0,0,0,0,0,0,0,2,0,1,65860,26354,5282,35043,0
3,66,14,10,10,0,0,4,14,1,1,1,1,2,2,0,2,0,1,0,0,2,0,1,65860,26354,5282,35044,0
3,66,46,26,30,3,0,12,49,3,6,3,6,9,9,20,28,1,42,2,0,2,0,1,65870,26354,5282,35045,0
11,238,19,8,11,5,0,4,24,2,5,3,6,7,9,13,25,1,30,1,0,2,0,1,65870,26354,5282,35046,0
11,238,102,59,69,5,3,24,107,6,22,15,28,28,43,113,206,3,789,43,0,2,0,1,65870,26354,5282,35047,0
11,238,106,40,36,3,49,17,109,8,17,13,23,25,36,93,167,5,904,50,0,2,0,1,65870,26354,5282,35048,0
68,1561,773,419,590,28,0,166,801,10,204,113,217,214,330,1598,2554,5,13587,754,0,2,6,57,65870,26354,5283,35049,0
68,1561,421,273,302,44,34,57,465,17,81,59,107,98,166,583,1098,11,12329,684,0,2,6,57,65870,26354,5284,35050,0
256,5923,4293,999,3693,19,54,507,4312,9,155,88,170,164,258,1156,1898,4,9368,520,0,2,22,5,65870,26356,5284,35051,0
256,5923,1482,859,1002,125,135,219,1607,16,219,134,251,235,385,1766,3032,9,27804,1544,1,2,22,5,65880,26357,5284,35052,0
98,2660,1523,757,1297,19,12,193,1542,12,193,117,230,205,347,1508,2664,7,19053,1058,0,2,1,1,65890,26359,5284,35053,0
98,2660,701,378,504,33,58,109,734,13,110,68,126,123,194,794,1346,7,10027,557,0,2,1,1,65890,26360,5285,35054,0
88,2299,773,422,505,30,103,129,803,14,77,46,83,91,129,535,839,7,6334,351,0,2,2,1,65900,26361,5286,35055,0
30,660,125,97,103,3,0,19,128,9,25,17,27,34,44,144,223,4,1087,60,0,2,4,1,65900,26361,5287,35056,0
151,7095,1392,870,1177,35,17,170,1427,14,494,280,531,508,811,4473,7289,7,54850,3047,2,2,26,26,65900,26364,5288,35057,0
90,2885,773,419,590,28,0,166,801,10,204,113,217,214,330,1598,2554,5,13587,754,0,2,9,23,65900,26364,5289,35058,0
1,20,127,75,83,2,11,30,129,4,14,7,14,18,21,61,87,2,175,9,0,2,0,1,65900,26364,5289,35059,0
1,20,652,304,544,16,6,88,668,6,89,51,101,95,152,591,998,3,3399,188,0,2,0,1,65900,26365,5289,35060,0
1,20,2,2,2,0,0,0,2,0,0,0,0,0,0,0,0,0,0,0,0,2,0,1,65900,26365,5289,35060,0
1,20,8,5,5,0,0,3,8,0,0,0,0,0,0,0,0,0,0,0,0,2,0,1,65900,26365,5289,35061,0
1,20,2,2,2,0,0,0,2,0,0,0,0,0,0,0,0,0,0,0,0,2,0,1,65900,26365,5289,35061,0
1,20,14,8,8,0,0,6,14,0,0,0,0,0,0,0,0,0,0,0,0,2,0,1,65900,26365,5289,35062,0
1,20,6,4,4,0,0,2,6,0,0,0,0,0,0,0,0,0,0,0,0,2,0,1,65900,26365,5289,35063,0
1,20,6,4,4,0,0,2,6,1,2,1,2,3,3,2,4,0,2,0,0,2,0,1,65900,26365,5289,35064,0
1,20,6,4,4,0,0,2,6,0,0,0,0,0,0,0,0,0,0,0,0,2,0,1,65900,26365,5289,35065,0
1,20,7,5,5,0,0,2,7,0,0,0,0,0,0,0,0,0,0,0,0,2,0,1,65900,26365,5289,35066,0
1,20,6,4,4,0,0,2,6,0,0,0,0,0,0,0,0,0,0,0,0,2,0,1,65900,26365,5289,35067,0
1,20,10,6,6,0,0,4,10,0,0,0,0,0,0,0,0,0,0,0,0,2,0,1,65900,26365,5289,35068,0
1,20,1,1,1,0,0,0,1,0,0,0,0,0,0,0,0,0,0,0,0,2,0,1,65900,26365,5289,35068,0
1,20,14,10,10,0,0,4,14,1,1,1,1,2,2,0,2,0,1,0,0,2,0,1,65900,26365,5289,35069,0
1,20,46,26,30,3,0,12,49,3,6,3,6,9,9,20,28,1,42,2,0,2,0,1,65910,26365,5289,35070,0
3,39,15,9,9,0,0,6,15,0,0,0,0,0,0,0,0,0,0,0,0,2,0,1,65910,26365,5289,35071,0
2,36,10,7,7,0,0,3,10,1,2,1,2,3,3,2,4,0,2,0,0,2,0,1,65910,26365,5289,35072,0
4,61,20,12,12,0,0,8,20,1,2,1,2,3,3,2,4,0,2,0,0,0,20,0,65910,26365,5289,35073,0
8,263,51,25,36,0,0,15,51,3,11,6,12,14,18,42,68,1,112,6,0,2,0,1,65910,26365,5289,35074,0
2,51,14,9,9,0,0,5,14,0,0,0,0,0,0,0,0,0,0,0,0,0,13,0,65910,26365,5289,35075,0
15,703,139,89,101,2,0,35,141,7,54,34,62,61,96,330,569,4,2287,127,0,2,1,1,65910,26365,5289,35076,0
63,4331,520,294,400,33,13,81,553,10,261,204,367,271,571,2128,4614,7,32445,1802,1,2,9,9,65910,26366,5289,35077,0
178,7898,139,89,101,2,0,35,141,7,54,34,62,61,96,330,569,4,2287,127,0,2,14,4,65910,26366,5289,35078,0
178,7898,7,5,5,0,0,2,7,1,2,1,2,3,3,2,4,0,2,0,0,2,14,4,65910,26366,5289,35079,0
47,2228,722,423,573,19,0,135,741,12,172,101,199,184,300,1320,2257,6,15668,870,0,2,1,1,65910,26368,5289,35081,0
51,1913,1098,241,925,5,10,155,1103,7,46,25,49,53,74,273,423,3,1580,87,0,2,12,0,65920,26370,5289,35082,0
3,42,14,8,8,0,0,6,14,0,0,0,0,0,0,0,0,0,0,0,0,2,0,1,65920,26370,5289,35084,0
60,1079,282,196,195,3,0,86,285,8,130,71,141,138,212,936,1507,4,6538,363,0,2,3,3,65920,26370,5290,35085,0
1,9,5,3,3,0,0,2,5,0,0,0,0,0,0,0,0,0,0,0,0,2,0,1,65920,26370,5290,35085,0
1,90,13,10,10,0,0,3,13,1,2,1,2,3,3,2,4,0,2,0,0,2,0,1,65920,26370,5290,35086,0
3,66,127,75,83,2,11,30,129,4,14,7,14,18,21,61,87,2,175,9,0,2,0,1,65920,26370,5290,35087,0
3,66,652,304,544,16,6,88,668,6,89,51,101,95,152,591,998,3,3399,188,0,2,0,1,65920,26371,5290,35088,0
3,66,2,2,2,0,0,0,2,0,0,0,0,0,0,0,0,0,0,0,0,2,0,1,65920,26371,5290,35088,0
3,66,8,5,5,0,0,3,8,0,0,0,0,0,0,0,0,0,0,0,0,2,0,1,65920,26371,5290,35089,0
3,66,2,2,2,0,0,0,2,0,0,0,0,0,0,0,0,0,0,0,0,2,0,1,65920,26371,5290,35089,0
3,66,14,8,8,0,0,6,14,0,0,0,0,0,0,0,0,0,0,0,0,2,0,1,65920,26371,5290,35090,0
3,66,6,4,4,0,0,2,6,0,0,0,0,0,0,0,0,0,0,0,0,2,0,1,65920,26371,5290,35091,0
3,66,6,4,4,0,0,2,6,1,2,1,2,3,3,2,4,0,2,0,0,2,0,1,65920,26371,5290,35092,0
3,66,6,4,4,0,0,2,6,0,0,0,0,0,0,0,0,0,0,0,0,2,0,1,65920,26371,5290,35093,0
3,66,7,5,5,0,0,2,7,0,0,0,0,0,0,0,0,0,0,0,0,2,0,1,65920,26371,5290,35094,0
3,66,6,4,4,0,0,2,6,0,0,0,0,0,0,0,0,0,0,0,0,2,0,1,65920,26371,5290,35095,0
3,66,10,6,6,0,0,4,10,0,0,0,0,0,0,0,0,0,0,0,0,2,0,1,65920,26371,5290,35096,0
3,66,1,1,1,0,0,0,1,0,0,0,0,0,0,0,0,0,0,0,0,2,0,1,65920,26371,5290,35096,0
3,66,14,10,10,0,0,4,14,1,1,1,1,2,2,0,2,0,1,0,0,2,0,1,65920,26371,5290,35097,0
3,66,46,26,30,3,0,12,49,3,6,3,6,9,9,20,28,1,42,2,0,2,0,1,65930,26371,5290,35098,0
11,238,19,8,11,5,0,4,24,2,5,3,6,7,9,13,25,1,30,1,0,2,0,1,65930,26371,5290,35099,0
11,238,102,59,69,5,3,24,107,6,22,15,28,28,43,113,206,3,789,43,0,2,0,1,65930,26371,5290,35100,0
11,238,106,40,36,3,49,17,109,8,17,13,23,25,36,93,167,5,904,50,0,2,0,1,65930,26371,5290,35101,0
68,1561,773,419,590,28,0,166,801,10,204,113,217,214,330,1598,2554,5,13587,754,0,2,6,57,65930,26371,5291,35102,0
68,1561,421,273,302,44,34,57,465,17,81,59,107,98,166,583,1098,11,12329,684,0,2,6,57,65930,26371,5292,35103,0
256,5923,4293,999,3693,19,54,507,4312,9,155,88,170,164,258,1156,1898,4,9368,520,0,2,22,5,65930,26373,5292,35104,0
256,5923,1482,859,1002,125,135,219,1607,16,219,134,251,235,385,1766,3032,9,27804,1544,1,2,22,5,65940,26374,5292,35105,0
98,2660,1523,757,1297,19,12,193,1542,12,193,117,230,205,347,1508,2664,7,19053,1058,0,2,1,1,65950,26376,5292,35106,0
98,2660,701,378,504,33,58,109,734,13,110,68,126,123,194,794,1346,7,10027,557,0,2,1,1,65950,26377,5293,35107,0
88,2299,773,422,505,30,103,129,803,14,77,46,83,91,129,535,839,7,6334,351,0,2,2,1,65960,26378,5294,35108,0
30,660,125,97,103,3,0,19,128,9,25,17,27,34,44,144,223,4,1087,60,0,2,4,1,65960,26378,5295,35109,0
151,7095,1392,870,1177,35,17,170,1427,14,494,280,531,508,811,4473,7289,7,54850,3047,2,2,26,26,65960,26381,5296,35110,0
90,2885,773,419,590,28,0,166,801,10,204,113,217,214,330,1598,2554,5,13587,754,0,2,9,23,65960,26381,5297,35111,0
1,20,127,75,83,2,11,30,129,4,14,7,14,18,21,61,87,2,175,9,0,2,0,1,65960,26381,5297,35112,0
1,20,652,304,544,16,6,88,668,6,89,51,101,95,152,591,998,3,3399,188,0,2,0,1,65960,26382,5297,35113,0
1,20,2,2,2,0,0,0,2,0,0,0,0,0,0,0,0,0,0,0,0,2,0,1,65960,26382,5297,35113,0
1,20,8,5,5,0,0,3,8,0,0,0,0,0,0,0,0,0,0,0,0,2,0,1,65960,26382,5297,35114,0
1,20,2,2,2,0,0,0,2,0,0,0,0,0,0,0,0,0,0,0,0,2,0,1,65960,26382,5297,35114,0
1,20,14,8,8,0,0,6,14,0,0,0,0,0,0,0,0,0,0,0,0,2,0,1,65960,26382,5297,35115,0
1,20,6,4,4,0,0,2,6,0,0,0,0,0,0,0,0,0,0,0,0,2,0,1,65960,26382,5297,35116,0
1,20,6,4,4,0,0,2,6,1,2,1,2,3,3,2,4,0,2,0,0,2,0,1,65960,26382,5297,35117,0
1,20,6,4,4,0,0,2,6,0,0,0,0,0,0,0,0,0,0,0,0,2,0,1,65960,26382,5297,35118,0
1,20,7,5,5,0,0,2,7,0,0,0,0,0,0,0,0,0,0,0,0,2,0,1,65960,26382,5297,35119,0
1,20,6,4,4,0,0,2,6,0,0,0,0,0,0,0,0,0,0,0,0,2,0,1,65960,26382,5297,35120,0
1,20,10,6,6,0,0,4,10,0,0,0,0,0,0,0,0,0,0,0,0,2,0,1,65960,26382,5297,35121,0
1,20,1,1,1,0,0,0,1,0,0,0,0,0,0,0,0,0,0,0,0,2,0,1,65960,26382,5297,35121,0
1,20,14,10,10,0,0,4,14,1,1,1,1,2,2,0,2,0,1,0,0,2,0,1,65960,26382,5297,35122,0
1,20,46,26,30,3,0,12,49,3,6,3,6,9,9,20,28,1,42,2,0,2,0,1,65970,26382,5297,35123,0
3,39,15,9,9,0,0,6,15,0,0,0,0,0,0,0,0,0,0,0,0,2,0,1,65970,26382,5297,35124,0
2,36,10,7,7,0,0,3,10,1,2,1,2,3,3,2,4,0,2,0,0,2,0,1,65970,26382,5297,35125,0
4,61,20,12,12,0,0,8,20,1,2,1,2,3,3,2,4,0,2,0,0,0,20,0,65970,26382,5297,35126,0
8,263,51,25,36,0,0,15,51,3,11,6,12,14,18,42,68,1,112,6,0,2,0,1,65970,26382,5297,35127,0
2,51,14,9,9,0,0,5,14,0,0,0,0,0,0,0,0,0,0,0,0,0,13,0,65970,26382,5297,35128,0
15,703,139,89,101,2,0,35,141,7,54,34,62,61,96,330,569,4,2287,127,0,2,1,1,65970,26382,5297,35129,0
63,4331,520,294,400,33,13,81,553,10,261,204,367,271,571,2128,4614,7,32445,1802,1,2,9,9,65970,26383,5297,35130,0
178,7898,139,89,101,2,0,35,141,7,54,34,62,61,96,330,569,4,2287,127,0,2,14,4,65970,26383,5297,35131,0
178,7898,7,5,5,0,0,2,7,1,2,1,2,3,3,2,4,0,2,0,0,2,14,4,65970,26383,5297,35132,0
47,2228,722,423,573,19,0,135,741,12,172,101,199,184,300,1320,2257,6,15668,870,0,2,1,1,65970,26385,5297,35134,0
51,1913,1098,241,925,5,10,155,1103,7,46,25,49,53,74,273,423,3,1580,87,0,2,12,0,65980,26387,5297,35135,0
38,779,386,256,301,16,9,68,402,4,59,35,69,63,104,355,621,2,1453,80,0,2,5,39,65980,26387,5297,35136,1
38,779,264,131,164,11,41,46,275,6,38,22,40,44,62,214,338,3,1068,59,0,2,5,39,65990,26387,5298,35137,1
40,1789,386,256,301,16,9,68,402,4,59,35,69,63,104,355,621,2,1453,80,0,2,14,7,65990,26387,5298,35138,1
254,5844,4293,999,3693,19,54,507,4312,9,155,88,170,164,258,1156,1898,4,9368,520,0,2,1,1,65990,26389,5298,35139,0
254,5844,1482,859,1002,125,135,219,1607,16,219,134,251,235,385,1766,3032,9,27804,1544,1,2,1,1,66000,26390,5298,35140,0
41,830,386,256,301,16,9,68,402,4,59,35,69,63,104,355,621,2,1453,80,0,2,13,0,66000,26390,5298,35141,1
41,830,264,131,164,11,41,46,275,6,38,22,40,44,62,214,338,3,1068,59,0,2,13,0,66010,26390,5299,35142,1
42,1848,386,256,301,16,9,68,402,4,59,35,69,63,104,355,621,2,1453,80,0,2,10,0,66010,26390,5299,35143,1
244,5785,722,423,573,19,0,135,741,12,172,101,199,184,300,1320,2257,6,15668,870,0,2,2,0,66010,26392,5299,35145,0
244,5785,1508,847,911,44,250,301,1552,14,148,88,169,162,257,1120,1886,7,15077,837,0,2,2,0,66010,26393,5300,35146,0
60,1078,282,196,195,3,0,86,285,8,130,71,141,138,212,936,1507,4,6538,363,0,2,1,1,66010,26393,5301,35147,0
89,1825,477,336,357,30,23,73,507,16,194,134,250,210,384,1538,2962,10,30538,1696,0,2,1,1,66020,26394,5301,35148,0
76,1735,996,429,845,24,10,117,1020,7,76,50,88,83,138,494,879,4,3565,198,0,2,1,1,66020,26396,5301,35149,0
76,1735,456,277,329,12,42,72,468,13,85,50,97,98,147,592,972,7,7212,400,0,2,1,1,66020,26396,5301,35150,0
154,3261,1513,682,1277,25,13,200,1538,11,199,116,219,210,335,1557,2584,6,15641,868,0,2,1,1,66020,26398,5301,35151,0
154,3261,819,519,539,24,98,155,843,15,96,57,106,111,163,690,1107,8,9171,509,0,2,1,1,66030,26400,5301,35152,0
67,1348,207,111,150,11,0,50,218,5,26,19,36,31,55,133,272,3,943,52,0,2,1,1,66030,26400,5301,35153,0
67,1348,410,198,237,31,55,97,441,11,63,38,72,74,110,414,683,6,4293,238,0,2,1,1,66040,26401,5302,35154,0
27,964,74,35,59,1,0,14,75,3,14,7,14,17,21,58,85,1,128,7,0,2,1,1,66040,26402,5302,35156,0
27,964,245,125,200,5,7,34,250,7,30,17,34,37,51,166,265,3,1053,58,0,2,1,1,66050,26403,5302,35157,0
313,6904,72,33,56,0,4,12,72,1,1,1,1,2,2,0,2,0,1,0,0,2,1,1,66050,26403,5302,35158,0
313,6904,1454,835,1044,76,110,219,1530,17,275,158,296,292,454,2297,3718,9,34017,1889,1,2,1,1,66060,26404,5302,35159,0
46,954,386,256,301,16,9,68,402,4,59,35,69,63,104,355,621,2,1453,80,0,2,1,1,66060,26404,5302,35160,0
46,954,264,131,164,11,41,46,275,6,38,22,40,44,62,214,338,3,1068,59,0,2,1,1,66070,26404,5303,35161,0
223,4839,1943,715,1694,26,18,214,1969,12,185,120,237,197,357,1436,2721,7,20915,1161,0,2,1,1,66070,26406,5303,35162,0
223,4839,1168,838,957,57,25,144,1225,19,348,224,416,367,640,3018,5452,11,61921,3440,1,2,1,1,66080,26408,5303,35163,0
95,3960,1289,550,1043,56,32,155,1345,10,167,93,185,177,278,1266,2075,5,11498,638,0,2,3,3,66080,26410,5304,35164,0
1,134,149,67,118,4,0,27,153,1,17,14,28,18,42,69,175,0,144,8,0,2,2,2,66080,26410,5304,35165,0
95,4641,1523,757,1297,19,12,193,1542,12,193,117,230,205,347,1508,2664,7,19053,1058,0,2,1,1,66090,26412,5304,35166,0
62,2789,1293,570,1093,25,15,163,1318,10,195,123,241,205,364,1516,2795,6,17273,959,0,2,1,1,66100,26414,5304,35167,0
256,5923,4293,999,3693,19,54,507,4312,9,155,88,170,164,258,1156,1898,4,9368,520,0,2,1,1,66100,26416,5304,35168,0
256,5923,1482,859,1002,125,135,219,1607,16,219,134,251,235,385,1766,3032,9,27804,1544,1,2,1,1,66110,26417,5304,35169,0
62,2790,1293,570,1093,25,15,163,1318,10,195,123,241,205,364,1516,2795,6,17273,959,0,2,19,19,66120,26419,5304,35170,0
62,2808,1293,570,1093,25,15,163,1318,10,195,123,241,205,364,1516,2795,6,17273,959,0,2,3,0,66130,26421,5304,35171,0
244,5785,722,423,573,19,0,135,741,12,172,101,199,184,300,1320,2257,6,15668,870,0,2,2,0,66130,26423,5304,35173,0
244,5785,1508,847,911,44,250,301,1552,14,148,88,169,162,257,1120,1886,7,15077,837,0,2,2,0,66130,26424,5305,35174,0
218,4703,2,2,2,0,0,0,2,0,0,0,0,0,0,0,0,0,0,0,0,2,19,17,66130,26424,5305,35174,1
218,4703,99,48,90,1,3,5,100,0,0,0,0,0,0,0,0,0,0,0,0,2,19,17,66130,26425,5305,35175,1
218,4703,8,5,5,2,0,1,10,0,0,0,0,0,0,0,0,0,0,0,0,2,19,17,66130,26425,5305,35176,1
218,4703,1217,716,841,84,126,174,1301,14,185,118,215,199,333,1446,2542,8,20687,1149,0,2,19,17,66140,26427,5305,35177,1
218,4703,160,89,115,0,13,31,160,7,15,11,17,22,28,78,124,3,495,27,0,2,19,17,66140,26427,5305,35178,1
218,4703,10,10,9,9,0,0,19,0,0,0,0,0,0,0,0,0,0,0,0,2,19,17,66140,26427,5306,35179,1
218,4703,173,84,99,8,29,36,181,5,12,7,13,17,20,54,81,2,221,12,0,2,19,17,66140,26428,5306,35180,1
218,4703,3,1,1,3,0,0,6,0,0,0,0,0,0,0,0,0,0,0,0,2,19,17,66140,26428,5306,35181,1
88,1878,402,202,227,24,74,80,426,12,52,33,61,64,94,339,564,7,3969,220,0,2,1,1,66140,26429,5306,35182,0
256,5936,4293,999,3693,19,54,507,4312,9,155,88,170,164,258,1156,1898,4,9368,520,0,2,9,6,66140,26431,5306,35183,1
256,5936,1482,859,1002,125,135,219,1607,16,219,134,251,235,385,1766,3032,9,27804,1544,1,2,9,6,66150,26432,5306,35184,1
24,600,2,2,2,0,0,0,2,0,0,0,0,0,0,0,0,0,0,0,0,2,0,5,66150,26432,5306,35184,1
24,600,99,48,90,1,3,5,100,0,0,0,0,0,0,0,0,0,0,0,0,2,0,5,66150,26433,5306,35185,1
24,600,8,5,5,2,0,1,10,0,0,0,0,0,0,0,0,0,0,0,0,2,0,5,66150,26433,5306,35186,1
24,600,1217,716,841,84,126,174,1301,14,185,118,215,199,333,1446,2542,8,20687,1149,0,2,0,5,66160,26435,5306,35187,1
24,600,160,89,115,0,13,31,160,7,15,11,17,22,28,78,124,3,495,27,0,2,0,5,66160,26435,5306,35188,1
24,600,10,10,9,9,0,0,19,0,0,0,0,0,0,0,0,0,0,0,0,2,0,5,66160,26435,5307,35189,1
24,600,173,84,99,8,29,36,181,5,12,7,13,17,20,54,81,2,221,12,0,2,0,5,66160,26436,5307,35190,1
24,600,3,1,1,3,0,0,6,0,0,0,0,0,0,0,0,0,0,0,0,2,0,5,66160,26436,5307,35191,1
88,1887,402,202,227,24,74,80,426,12,52,33,61,64,94,339,564,7,3969,220,0,2,2,1,66160,26437,5307,35192,1
88,1985,53,23,39,0,0,13,53,2,8,4,8,10,12,26,39,1,39,2,0,2,4,0,66160,26437,5307,35193,1
88,1985,515,298,307,33,80,99,548,12,63,44,77,75,121,419,753,7,5527,307,0,2,4,0,66170,26437,5307,35194,1
310,6900,72,33,56,0,4,12,72,1,1,1,1,2,2,0,2,0,1,0,0,2,27,23,66170,26437,5307,35195,1
310,6900,1454,835,1044,76,110,219,1530,17,275,158,296,292,454,2297,3718,9,34017,1889,1,2,27,23,66180,26438,5307,35196,1
178,7961,139,89,101,2,0,35,141,7,54,34,62,61,96,330,569,4,2287,127,0,2,39,42,66180,26438,5307,35197,1
178,7961,7,5,5,0,0,2,7,1,2,1,2,3,3,2,4,0,2,0,0,2,39,42,66180,26438,5307,35198,1
138,6146,1782,648,1425,9,47,279,1791,8,171,97,189,179,286,1292,2140,4,9462,525,0,2,19,19,66180,26439,5308,35199,1
97,4228,1020,354,843,12,15,144,1032,8,134,77,144,142,221,970,1580,4,6792,377,0,2,2,2,66180,26439,5308,35200,1
83,3201,1043,504,840,53,9,147,1096,9,180,112,198,189,310,1377,2344,4,11604,644,0,2,17,1,66180,26441,5308,35201,1
41,830,386,256,301,16,9,68,402,4,59,35,69,63,104,355,621,2,1453,80,0,2,4,4,66180,26441,5308,35202,1
41,830,264,131,164,11,41,46,275,6,38,22,40,44,62,214,338,3,1068,59,0,2,4,4,66190,26441,5309,35203,1
60,1078,282,196,195,3,0,86,285,8,130,71,141,138,212,936,1507,4,6538,363,0,2,3,3,66190,26441,5310,35204,0
223,4839,1943,715,1694,26,18,214,1969,12,185,120,237,197,357,1436,2721,7,20915,1161,0,2,1,3,66190,26443,5310,35205,0
223,4839,1168,838,957,57,25,144,1225,19,348,224,416,367,640,3018,5452,11,61921,3440,1,2,1,3,66200,26445,5310,35206,0
62,2789,1293,570,1093,25,15,163,1318,10,195,123,241,205,364,1516,2795,6,17273,959,0,2,1,3,66210,26447,5310,35207,0
141,3287,77,34,69,0,0,8,77,3,24,16,29,27,45,114,213,1,387,21,0,2,4,1,66210,26447,5310,35208,0
141,3287,712,438,573,51,9,84,763,14,102,71,128,116,199,733,1364,8,11988,666,0,2,4,1,66220,26448,5310,35209,0
26,755,442,244,305,14,16,103,456,11,68,45,75,79,120,452,756,6,4588,254,0,2,101,44,66220,26450,5310,35210,0
26,755,182,102,99,11,40,35,193,3,11,6,11,14,17,42,64,1,97,5,0,2,101,44,66220,26451,5310,35211,0
14,732,442,244,305,14,16,103,456,11,68,45,75,79,120,452,756,6,4588,254,0,2,2,2,66220,26453,5310,35212,0
26,761,442,244,305,14,16,103,456,11,68,45,75,79,120,452,756,6,4588,254,0,2,4,2,66220,26455,5310,35213,0
26,761,182,102,99,11,40,35,193,3,11,6,11,14,17,42,64,1,97,5,0,2,4,2,66220,26456,5310,35214,0
38,1045,442,244,305,14,16,103,456,11,68,45,75,79,120,452,756,6,4588,254,0,2,74,18,66220,26458,5310,35215,1
38,1045,182,102,99,11,40,35,193,3,11,6,11,14,17,42,64,1,97,5,0,2,74,18,66220,26459,5310,35216,1
38,1039,442,244,305,14,16,103,456,11,68,45,75,79,120,452,756,6,4588,254,0,2,6,6,66220,26461,5310,35217,1
38,1039,182,102,99,11,40,35,193,3,11,6,11,14,17,42,64,1,97,5,0,2,6,6,66220,26462,5310,35218,1
14,732,442,244,305,14,16,103,456,11,68,45,75,79,120,452,756,6,4588,254,0,2,1,1,66220,26464,5310,35219,0
50,1304,442,244,305,14,16,103,456,11,68,45,75,79,120,452,756,6,4588,254,0,2,84,29,66220,26466,5310,35220,1
50,1304,182,102,99,11,40,35,193,3,11,6,11,14,17,42,64,1,97,5,0,2,84,29,66220,26467,5310,35221,1
19,987,442,244,305,14,16,103,456,11,68,45,75,79,120,452,756,6,4588,254,0,2,57,0,66220,26469,5310,35222,1
50,1308,442,244,305,14,16,103,456,11,68,45,75,79,120,452,756,6,4588,254,0,2,5,5,66220,26471,5310,35223,0
50,1308,182,102,99,11,40,35,193,3,11,6,11,14,17,42,64,1,97,5,0,2,5,5,66220,26472,5310,35224,0
56,1403,442,244,305,14,16,103,456,11,68,45,75,79,120,452,756,6,4588,254,0,2,35,17,66220,26474,5310,35225,1
56,1403,182,102,99,11,40,35,193,3,11,6,11,14,17,42,64,1,97,5,0,2,35,17,66220,26475,5310,35226,1
20,1078,442,244,305,14,16,103,456,11,68,45,75,79,120,452,756,6,4588,254,0,2,12,0,66220,26477,5310,35227,1
56,1403,442,244,305,14,16,103,456,11,68,45,75,79,120,452,756,6,4588,254,0,2,9,9,66220,26479,5310,35228,1
56,1403,182,102,99,11,40,35,193,3,11,6,11,14,17,42,64,1,97,5,0,2,9,9,66220,26480,5310,35229,1
56,1416,442,244,305,14,16,103,456,11,68,45,75,79,120,452,756,6,4588,254,0,2,9,5,66220,26482,5310,35230,0
56,1416,182,102,99,11,40,35,193,3,11,6,11,14,17,42,64,1,97,5,0,2,9,5,66220,26483,5310,35231,0
20,1083,442,244,305,14,16,103,456,11,68,45,75,79,120,452,756,6,4588,254,0,2,11,3,66220,26485,5310,35232,0
56,1420,442,244,305,14,16,103,456,11,68,45,75,79,120,452,756,6,4588,254,0,2,1,1,66220,26487,5310,35233,0
56,1420,182,102,99,11,40,35,193,3,11,6,11,14,17,42,64,1,97,5,0,2,1,1,66220,26488,5310,35234,0
180,5391,1660,832,1314,41,38,274,1701,20,312,209,395,332,604,2671,5058,12,64042,3557,1,2,2,1,66220,26490,5311,35236,1
180,5391,1057,646,719,113,100,145,1170,18,215,134,248,233,382,1740,3004,10,31186,1732,1,2,2,1,66230,26491,5312,35237,1
76,1739,996,429,845,24,10,117,1020,7,76,50,88,83,138,494,879,4,3565,198,0,2,2,1,66230,26493,5312,35238,1
76,1739,456,277,329,12,42,72,468,13,85,50,97,98,147,592,972,7,7212,400,0,2,2,1,66230,26493,5312,35239,1
67,1325,207,111,150,11,0,50,218,5,26,19,36,31,55,133,272,3,943,52,0,2,0,7,66230,26493,5312,35240,1
67,1325,410,198,237,31,55,97,441,11,63,38,72,74,110,414,683,6,4293,238,0,2,0,7,66240,26494,5313,35241,1
37,833,91,45,69,0,3,18,91,3,9,6,10,12,16,33,57,1,95,5,0,0,183,0,66240,26496,5313,35242,1
37,833,367,234,237,17,34,68,384,16,55,34,61,71,95,381,584,8,5183,287,0,0,183,0,66240,26497,5313,35243,1
7,164,167,116,138,4,5,22,171,8,48,30,56,56,86,292,499,4,2330,129,0,2,1,1,66240,26497,5313,35244,1
244,5785,722,423,573,19,0,135,741,12,172,101,199,184,300,1320,2257,6,15668,870,0,2,4,3,66240,26499,5313,35246,1
244,5785,1508,847,911,44,250,301,1552,14,148,88,169,162,257,1120,1886,7,15077,837,0,2,4,3,66240,26500,5314,35247,1
19,622,442,244,305,14,16,103,456,11,68,45,75,79,120,452,756,6,4588,254,0,2,1,173,66240,26502,5314,35248,1
19,622,182,102,99,11,40,35,193,3,11,6,11,14,17,42,64,1,97,5,0,2,1,173,66240,26503,5314,35249,1
20,1083,442,244,305,14,16,103,456,11,68,45,75,79,120,452,756,6,4588,254,0,2,9,9,66240,26505,5314,35250,1
178,7898,139,89,101,2,0,35,141,7,54,34,62,61,96,330,569,4,2287,127,0,2,1,1,66240,26505,5314,35251,0
178,7898,7,5,5,0,0,2,7,1,2,1,2,3,3,2,4,0,2,0,0,2,1,1,66240,26505,5314,35252,0
180,5391,1660,832,1314,41,38,274,1701,20,312,209,395,332,604,2671,5058,12,64042,3557,1,2,1,1,66240,26507,5315,35254,0
180,5391,1057,646,719,113,100,145,1170,18,215,134,248,233,382,1740,3004,10,31186,1732,1,2,1,1,66250,26508,5316,35255,0
76,1735,996,429,845,24,10,117,1020,7,76,50,88,83,138,494,879,4,3565,198,0,2,2,3,66250,26510,5316,35256,0
76,1735,456,277,329,12,42,72,468,13,85,50,97,98,147,592,972,7,7212,400,0,2,2,3,66250,26510,5316,35257,0
44,988,91,45,69,0,3,18,91,3,9,6,10,12,16,33,57,1,95,5,0,2,49,0,66250,26512,5316,35258,0
44,988,367,234,237,17,34,68,384,16,55,34,61,71,95,381,584,8,5183,287,0,2,49,0,66250,26513,5316,35259,0
76,1734,996,429,845,24,10,117,1020,7,76,50,88,83,138,494,879,4,3565,198,0,2,2,3,66250,26515,5316,35261,1
76,1734,456,277,329,12,42,72,468,13,85,50,97,98,147,592,972,7,7212,400,0,2,2,3,66250,26515,5316,35262,1
49,1088,91,45,69,0,3,18,91,3,9,6,10,12,16,33,57,1,95,5,0,2,46,2,66250,26517,5316,35263,1
49,1088,367,234,237,17,34,68,384,16,55,34,61,71,95,381,584,8,5183,287,0,2,46,2,66250,26518,5316,35264,1
18,608,442,244,305,14,16,103,456,11,68,45,75,79,120,452,756,6,4588,254,0,2,7,5,66250,26520,5316,35265,1
18,608,182,102,99,11,40,35,193,3,11,6,11,14,17,42,64,1,97,5,0,2,7,5,66250,26521,5316,35266,1
21,1150,442,244,305,14,16,103,456,11,68,45,75,79,120,452,756,6,4588,254,0,2,16,0,66250,26523,5316,35267,1
49,1103,91,45,69,0,3,18,91,3,9,6,10,12,16,33,57,1,95,5,0,2,13,8,66250,26525,5316,35268,0
49,1103,367,234,237,17,34,68,384,16,55,34,61,71,95,381,584,8,5183,287,0,2,13,8,66250,26526,5316,35269,0
18,611,442,244,305,14,16,103,456,11,68,45,75,79,120,452,756,6,4588,254,0,2,25,8,66250,26528,5316,35270,0
18,611,182,102,99,11,40,35,193,3,11,6,11,14,17,42,64,1,97,5,0,2,25,8,66250,26529,5316,35271,0
244,5821,722,423,573,19,0,135,741,12,172,101,199,184,300,1320,2257,6,15668,870,0,2,3,0,66250,26531,5316,35273,1
244,5821,1508,847,911,44,250,301,1552,14,148,88,169,162,257,1120,1886,7,15077,837,0,2,3,0,66250,26532,5317,35274,1
19,625,442,244,305,14,16,103,456,11,68,45,75,79,120,452,756,6,4588,254,0,2,3,1,66250,26534,5317,35275,1
19,625,182,102,99,11,40,35,193,3,11,6,11,14,17,42,64,1,97,5,0,2,3,1,66250,26535,5317,35276,1
21,1128,442,244,305,14,16,103,456,11,68,45,75,79,120,452,756,6,4588,254,0,2,0,2,66250,26537,5317,35277,1
244,5824,722,423,573,19,0,135,741,12,172,101,199,184,300,1320,2257,6,15668,870,0,2,1,1,66250,26539,5317,35279,0
244,5824,1508,847,911,44,250,301,1552,14,148,88,169,162,257,1120,1886,7,15077,837,0,2,1,1,66250,26540,5318,35280,0
19,627,442,244,305,14,16,103,456,11,68,45,75,79,120,452,756,6,4588,254,0,2,2,1,66250,26542,5318,35281,0
19,627,182,102,99,11,40,35,193,3,11,6,11,14,17,42,64,1,97,5,0,2,2,1,66250,26543,5318,35282,0
19,628,442,244,305,14,16,103,456,11,68,45,75,79,120,452,756,6,4588,254,0,2,1,0,66250,26545,5318,35283,0
19,628,182,102,99,11,40,35,193,3,11,6,11,14,17,42,64,1,97,5,0,2,1,0,66250,26546,5318,35284,0
19,669,442,244,305,14,16,103,456,11,68,45,75,79,120,452,756,6,4588,254,0,2,26,14,66250,26548,5318,35286,1
19,669,182,102,99,11,40,35,193,3,11,6,11,14,17,42,64,1,97,5,0,2,26,14,66250,26549,5318,35287,1
62,2808,1293,570,1093,25,15,163,1318,10,195,123,241,205,364,1516,2795,6,17273,959,0,2,22,19,66260,26551,5318,35288,0
218,4703,2,2,2,0,0,0,2,0,0,0,0,0,0,0,0,0,0,0,0,2,19,17,66260,26551,5318,35288,0
218,4703,99,48,90,1,3,5,100,0,0,0,0,0,0,0,0,0,0,0,0,2,19,17,66260,26552,5318,35289,0
218,4703,8,5,5,2,0,1,10,0,0,0,0,0,0,0,0,0,0,0,0,2,19,17,66260,26552,5318,35290,0
218,4703,1217,716,841,84,126,174,1301,14,185,118,215,199,333,1446,2542,8,20687,1149,0,2,19,17,66270,26554,5318,35291,0
218,4703,160,89,115,0,13,31,160,7,15,11,17,22,28,78,124,3,495,27,0,2,19,17,66270,26554,5318,35292,0
218,4703,10,10,9,9,0,0,19,0,0,0,0,0,0,0,0,0,0,0,0,2,19,17,66270,26554,5319,35293,0
218,4703,173,84,99,8,29,36,181,5,12,7,13,17,20,54,81,2,221,12,0,2,19,17,66270,26555,5319,35294,0
218,4703,3,1,1,3,0,0,6,0,0,0,0,0,0,0,0,0,0,0,0,2,19,17,66270,26555,5319,35295,0
41,830,386,256,301,16,9,68,402,4,59,35,69,63,104,355,621,2,1453,80,0,2,18,39,66270,26555,5319,35296,0
41,830,264,131,164,11,41,46,275,6,38,22,40,44,62,214,338,3,1068,59,0,2,18,39,66280,26555,5320,35297,0
42,1848,386,256,301,16,9,68,402,4,59,35,69,63,104,355,621,2,1453,80,0,2,24,7,66280,26555,5320,35298,0
19,669,442,244,305,14,16,103,456,11,68,45,75,79,120,452,756,6,4588,254,0,2,6,6,66280,26557,5320,35299,1
19,669,182,102,99,11,40,35,193,3,11,6,11,14,17,42,64,1,97,5,0,2,6,6,66280,26558,5320,35300,1
60,1078,282,196,195,3,0,86,285,8,130,71,141,138,212,936,1507,4,6538,363,0,2,3,3,66280,26558,5321,35301,0
89,1825,477,336,357,30,23,73,507,16,194,134,250,210,384,1538,2962,10,30538,1696,0,2,1,1,66290,26559,5321,35302,0
76,1735,996,429,845,24,10,117,1020,7,76,50,88,83,138,494,879,4,3565,198,0,2,1,1,66290,26561,5321,35303,0
76,1735,456,277,329,12,42,72,468,13,85,50,97,98,147,592,972,7,7212,400,0,2,1,1,66290,26561,5321,35304,0
154,3261,1513,682,1277,25,13,200,1538,11,199,116,219,210,335,1557,2584,6,15641,868,0,2,1,1,66290,26563,5321,35305,0
154,3261,819,519,539,24,98,155,843,15,96,57,106,111,163,690,1107,8,9171,509,0,2,1,1,66300,26565,5321,35306,0
67,1348,207,111,150,11,0,50,218,5,26,19,36,31,55,133,272,3,943,52,0,2,1,1,66300,26565,5321,35307,0
67,1348,410,198,237,31,55,97,441,11,63,38,72,74,110,414,683,6,4293,238,0,2,1,1,66310,26566,5322,35308,0
27,964,74,35,59,1,0,14,75,3,14,7,14,17,21,58,85,1,128,7,0,2,1,1,66310,26567,5322,35310,0
27,964,245,125,200,5,7,34,250,7,30,17,34,37,51,166,265,3,1053,58,0,2,1,1,66320,26568,5322,35311,0
313,6904,72,33,56,0,4,12,72,1,1,1,1,2,2,0,2,0,1,0,0,2,1,1,66320,26568,5322,35312,0
313,6904,1454,835,1044,76,110,219,1530,17,275,158,296,292,454,2297,3718,9,34017,1889,1,2,1,1,66330,26569,5322,35313,0
46,954,386,256,301,16,9,68,402,4,59,35,69,63,104,355,621,2,1453,80,0,2,1,1,66330,26569,5322,35314,0
46,954,264,131,164,11,41,46,275,6,38,22,40,44,62,214,338,3,1068,59,0,2,1,1,66340,26569,5323,35315,0
223,4839,1943,715,1694,26,18,214,1969,12,185,120,237,197,357,1436,2721,7,20915,1161,0,2,1,3,66340,26571,5323,35316,0
223,4839,1168,838,957,57,25,144,1225,19,348,224,416,367,640,3018,5452,11,61921,3440,1,2,1,3,66350,26573,5323,35317,0
95,3960,1289,550,1043,56,32,155,1345,10,167,93,185,177,278,1266,2075,5,11498,638,0,2,3,3,66350,26575,5324,35318,0
1,134,149,67,118,4,0,27,153,1,17,14,28,18,42,69,175,0,144,8,0,2,2,2,66350,26575,5324,35319,0
95,4641,1523,757,1297,19,12,193,1542,12,193,117,230,205,347,1508,2664,7,19053,1058,0,2,1,1,66360,26577,5324,35320,0
62,2807,1293,570,1093,25,15,163,1318,10,195,123,241,205,364,1516,2795,6,17273,959,0,2,1,3,66370,26579,5324,35321,0
256,5936,4293,999,3693,19,54,507,4312,9,155,88,170,164,258,1156,1898,4,9368,520,0,2,9,6,66370,26581,5324,35322,0
256,5936,1482,859,1002,125,135,219,1607,16,219,134,251,235,385,1766,3032,9,27804,1544,1,2,9,6,66380,26582,5324,35323,0
24,600,2,2,2,0,0,0,2,0,0,0,0,0,0,0,0,0,0,0,0,2,0,5,66380,26582,5324,35323,0
24,600,99,48,90,1,3,5,100,0,0,0,0,0,0,0,0,0,0,0,0,2,0,5,66380,26583,5324,35324,0
24,600,8,5,5,2,0,1,10,0,0,0,0,0,0,0,0,0,0,0,0,2,0,5,66380,26583,5324,35325,0
24,600,1217,716,841,84,126,174,1301,14,185,118,215,199,333,1446,2542,8,20687,1149,0,2,0,5,66390,26585,5324,35326,0
24,600,160,89,115,0,13,31,160,7,15,11,17,22,28,78,124,3,495,27,0,2,0,5,66390,26585,5324,35327,0
24,600,10,10,9,9,0,0,19,0,0,0,0,0,0,0,0,0,0,0,0,2,0,5,66390,26585,5325,35328,0
24,600,173,84,99,8,29,36,181,5,12,7,13,17,20,54,81,2,221,12,0,2,0,5,66390,26586,5325,35329,0
24,600,3,1,1,3,0,0,6,0,0,0,0,0,0,0,0,0,0,0,0,2,0,5,66390,26586,5325,35330,0
88,1887,402,202,227,24,74,80,426,12,52,33,61,64,94,339,564,7,3969,220,0,2,3,2,66390,26587,5325,35331,0
88,1985,53,23,39,0,0,13,53,2,8,4,8,10,12,26,39,1,39,2,0,2,4,0,66390,26587,5325,35332,0
88,1985,515,298,307,33,80,99,548,12,63,44,77,75,121,419,753,7,5527,307,0,2,4,0,66400,26587,5325,35333,0
310,6900,72,33,56,0,4,12,72,1,1,1,1,2,2,0,2,0,1,0,0,2,27,23,66400,26587,5325,35334,0
310,6900,1454,835,1044,76,110,219,1530,17,275,158,296,292,454,2297,3718,9,34017,1889,1,2,27,23,66410,26588,5325,35335,0
178,7961,139,89,101,2,0,35,141,7,54,34,62,61,96,330,569,4,2287,127,0,2,39,42,66410,26588,5325,35336,0
178,7961,7,5,5,0,0,2,7,1,2,1,2,3,3,2,4,0,2,0,0,2,39,42,66410,26588,5325,35337,0
138,6146,1782,648,1425,9,47,279,1791,8,171,97,189,179,286,1292,2140,4,9462,525,0,2,19,19,66410,26589,5326,35338,0
97,4228,1020,354,843,12,15,144,1032,8,134,77,144,142,221,970,1580,4,6792,377,0,2,2,2,66410,26589,5326,35339,0
83,3201,1043,504,840,53,9,147,1096,9,180,112,198,189,310,1377,2344,4,11604,644,0,2,17,1,66410,26591,5326,35340,0
180,5391,1660,832,1314,41,38,274,1701,20,312,209,395,332,604,2671,5058,12,64042,3557,1,2,3,2,66410,26593,5327,35342,0
180,5391,1057,646,719,113,100,145,1170,18,215,134,248,233,382,1740,3004,10,31186,1732,1,2,3,2,66420,26594,5328,35343,0
76,1734,996,429,845,24,10,117,1020,7,76,50,88,83,138,494,879,4,3565,198,0,2,4,5,66420,26596,5328,35344,0
76,1734,456,277,329,12,42,72,468,13,85,50,97,98,147,592,972,7,7212,400,0,2,4,5,66420,26596,5328,35345,0
67,1325,207,111,150,11,0,50,218,5,26,19,36,31,55,133,272,3,943,52,0,2,0,7,66420,26596,5328,35346,0
67,1325,410,198,237,31,55,97,441,11,63,38,72,74,110,414,683,6,4293,238,0,2,0,7,66430,26597,5329,35347,0
141,3287,77,34,69,0,0,8,77,3,24,16,29,27,45,114,213,1,387,21,0,2,4,1,66430,26597,5329,35349,0
141,3287,712,438,573,51,9,84,763,14,102,71,128,116,199,733,1364,8,11988,666,0,2,4,1,66440,26598,5329,35350,0
49,1103,91,45,69,0,3,18,91,3,9,6,10,12,16,33,57,1,95,5,0,0,281,0,66440,26600,5329,35351,0
49,1103,367,234,237,17,34,68,384,16,55,34,61,71,95,381,584,8,5183,287,0,0,281,0,66440,26601,5329,35352,0
244,5824,722,423,573,19,0,135,741,12,172,101,199,184,300,1320,2257,6,15668,870,0,2,7,3,66440,26603,5329,35355,0
244,5824,1508,847,911,44,250,301,1552,14,148,88,169,162,257,1120,1886,7,15077,837,0,2,7,3,66440,26604,5330,35356,0
19,669,442,244,305,14,16,103,456,11,68,45,75,79,120,452,756,6,4588,254,0,2,113,58,66440,26606,5330,35357,0
19,669,182,102,99,11,40,35,193,3,11,6,11,14,17,42,64,1,97,5,0,2,113,58,66440,26607,5330,35358,0
178,7961,139,89,101,2,0,35,141,7,54,34,62,61,96,330,569,4,2287,127,0,2,1,1,66440,26607,5330,35359,0
178,7961,7,5,5,0,0,2,7,1,2,1,2,3,3,2,4,0,2,0,0,2,1,1,66440,26607,5330,35360,0
21,1128,442,244,305,14,16,103,456,11,68,45,75,79,120,452,756,6,4588,254,0,2,94,3,66440,26609,5330,35361,0
217,4704,182,127,129,0,0,53,182,5,39,21,42,44,63,217,343,2,926,51,0,2,35,7,66440,26609,5331,35362,1
217,4704,1165,710,800,67,119,181,1232,18,243,153,282,261,435,2000,3492,10,36473,2026,1,2,35,7,66450,26609,5332,35363,1
152,7140,1392,870,1177,35,17,170,1427,14,494,280,531,508,811,4473,7289,7,54850,3047,2,2,15,5,66450,26612,5333,35364,1
219,4763,2,2,2,0,0,0,2,0,0,0,0,0,0,0,0,0,0,0,0,2,16,2,66450,26612,5333,35364,0
219,4763,99,48,90,1,3,5,100,0,0,0,0,0,0,0,0,0,0,0,0,2,16,2,66450,26613,5333,35365,0
219,4763,8,5,5,2,0,1,10,0,0,0,0,0,0,0,0,0,0,0,0,2,16,2,66450,26613,5333,35366,0
219,4763,1217,716,841,84,126,174,1301,14,185,118,215,199,333,1446,2542,8,20687,1149,0,2,16,2,66460,26615,5333,35367,0
219,4763,160,89,115,0,13,31,160,7,15,11,17,22,28,78,124,3,495,27,0,2,16,2,66460,26615,5333,35368,0
219,4763,10,10,9,9,0,0,19,0,0,0,0,0,0,0,0,0,0,0,0,2,16,2,66460,26615,5334,35369,0
219,4763,173,84,99,8,29,36,181,5,12,7,13,17,20,54,81,2,221,12,0,2,16,2,66460,26616,5334,35370,0
219,4763,3,1,1,3,0,0,6,0,0,0,0,0,0,0,0,0,0,0,0,2,16,2,66460,26616,5334,35371,0
97,4034,1289,550,1043,56,32,155,1345,10,167,93,185,177,278,1266,2075,5,11498,638,0,2,25,5,66460,26618,5335,35372,0
222,4841,182,127,129,0,0,53,182,5,39,21,42,44,63,217,343,2,926,51,0,2,35,0,66470,26622,5337,35380,0
222,4841,1165,710,800,67,119,181,1232,18,243,153,282,261,435,2000,3492,10,36473,2026,1,2,35,0,66480,26622,5338,35381,0
219,4759,2,2,2,0,0,0,2,0,0,0,0,0,0,0,0,0,0,0,0,2,1,4,66480,26622,5338,35381,0
219,4759,99,48,90,1,3,5,100,0,0,0,0,0,0,0,0,0,0,0,0,2,1,4,66480,26623,5338,35382,0
219,4759,8,5,5,2,0,1,10,0,0,0,0,0,0,0,0,0,0,0,0,2,1,4,66480,26623,5338,35383,0
219,4759,1217,716,841,84,126,174,1301,14,185,118,215,199,333,1446,2542,8,20687,1149,0,2,1,4,66490,26625,5338,35384,0
219,4759,160,89,115,0,13,31,160,7,15,11,17,22,28,78,124,3,495,27,0,2,1,4,66490,26625,5338,35385,0
219,4759,10,10,9,9,0,0,19,0,0,0,0,0,0,0,0,0,0,0,0,2,1,4,66490,26625,5339,35386,0
219,4759,173,84,99,8,29,36,181,5,12,7,13,17,20,54,81,2,221,12,0,2,1,4,66490,26626,5339,35387,0
219,4759,3,1,1,3,0,0,6,0,0,0,0,0,0,0,0,0,0,0,0,2,1,4,66490,26626,5339,35388,0
305,6771,72,33,56,0,4,12,72,1,1,1,1,2,2,0,2,0,1,0,0,2,1,32,66490,26626,5339,35389,0
305,6771,1454,835,1044,76,110,219,1530,17,275,158,296,292,454,2297,3718,9,34017,1889,1,2,1,32,66500,26627,5339,35390,0
218,4716,2,2,2,0,0,0,2,0,0,0,0,0,0,0,0,0,0,0,0,2,0,10,66500,26627,5339,35390,0
218,4716,99,48,90,1,3,5,100,0,0,0,0,0,0,0,0,0,0,0,0,2,0,10,66500,26628,5339,35391,0
218,4716,8,5,5,2,0,1,10,0,0,0,0,0,0,0,0,0,0,0,0,2,0,10,66500,26628,5339,35392,0
218,4716,1217,716,841,84,126,174,1301,14,185,118,215,199,333,1446,2542,8,20687,1149,0,2,0,10,66510,26630,5339,35393,0
218,4716,160,89,115,0,13,31,160,7,15,11,17,22,28,78,124,3,495,27,0,2,0,10,66510,26630,5339,35394,0
218,4716,10,10,9,9,0,0,19,0,0,0,0,0,0,0,0,0,0,0,0,2,0,10,66510,26630,5340,35395,0
218,4716,173,84,99,8,29,36,181,5,12,7,13,17,20,54,81,2,221,12,0,2,0,10,66510,26631,5340,35396,0
218,4716,3,1,1,3,0,0,6,0,0,0,0,0,0,0,0,0,0,0,0,2,0,10,66510,26631,5340,35397,0
60,1078,282,196,195,3,0,86,285,8,130,71,141,138,212,936,1507,4,6538,363,0,2,3,3,66510,26631,5341,35398,0
89,1825,477,336,357,30,23,73,507,16,194,134,250,210,384,1538,2962,10,30538,1696,0,2,1,1,66520,26632,5341,35399,0
76,1733,996,429,845,24,10,117,1020,7,76,50,88,83,138,494,879,4,3565,198,0,2,1,1,66520,26634,5341,35400,0
76,1733,456,277,329,12,42,72,468,13,85,50,97,98,147,592,972,7,7212,400,0,2,1,1,66520,26634,5341,35401,0
154,3261,1513,682,1277,25,13,200,1538,11,199,116,219,210,335,1557,2584,6,15641,868,0,2,1,1,66520,26636,5341,35402,0
154,3261,819,519,539,24,98,155,843,15,96,57,106,111,163,690,1107,8,9171,509,0,2,1,1,66530,26638,5341,35403,0
67,1324,207,111,150,11,0,50,218,5,26,19,36,31,55,133,272,3,943,52,0,2,1,1,66530,26638,5341,35404,0
67,1324,410,198,237,31,55,97,441,11,63,38,72,74,110,414,683,6,4293,238,0,2,1,1,66540,26639,5342,35405,0
27,964,74,35,59,1,0,14,75,3,14,7,14,17,21,58,85,1,128,7,0,2,1,1,66540,26640,5342,35407,0
27,964,245,125,200,5,7,34,250,7,30,17,34,37,51,166,265,3,1053,58,0,2,1,1,66550,26641,5342,35408,0
310,6899,72,33,56,0,4,12,72,1,1,1,1,2,2,0,2,0,1,0,0,2,1,1,66550,26641,5342,35409,0
310,6899,1454,835,1044,76,110,219,1530,17,275,158,296,292,454,2297,3718,9,34017,1889,1,2,1,1,66560,26642,5342,35410,0
41,829,386,256,301,16,9,68,402,4,59,35,69,63,104,355,621,2,1453,80,0,2,1,1,66560,26642,5342,35411,0
41,829,264,131,164,11,41,46,275,6,38,22,40,44,62,214,338,3,1068,59,0,2,1,1,66570,26642,5343,35412,0
223,4839,1943,715,1694,26,18,214,1969,12,185,120,237,197,357,1436,2721,7,20915,1161,0,2,1,3,66570,26644,5343,35413,0
223,4839,1168,838,957,57,25,144,1225,19,348,224,416,367,640,3018,5452,11,61921,3440,1,2,1,3,66580,26646,5343,35414,0
95,3960,1289,550,1043,56,32,155,1345,10,167,93,185,177,278,1266,2075,5,11498,638,0,2,3,3,66580,26648,5344,35415,0
1,134,149,67,118,4,0,27,153,1,17,14,28,18,42,69,175,0,144,8,0,2,2,2,66580,26648,5344,35416,0
95,4641,1523,757,1297,19,12,193,1542,12,193,117,230,205,347,1508,2664,7,19053,1058,0,2,1,1,66590,26650,5344,35417,0
62,2807,1293,570,1093,25,15,163,1318,10,195,123,241,205,364,1516,2795,6,17273,959,0,2,23,22,66600,26652,5344,35418,0
222,4841,182,127,129,0,0,53,182,5,39,21,42,44,63,217,343,2,926,51,0,2,70,7,66610,26656,5346,35426,0
222,4841,1165,710,800,67,119,181,1232,18,243,153,282,261,435,2000,3492,10,36473,2026,1,2,70,7,66620,26656,5347,35427,0
218,4716,2,2,2,0,0,0,2,0,0,0,0,0,0,0,0,0,0,0,0,2,13,12,66620,26656,5347,35427,0
218,4716,99,48,90,1,3,5,100,0,0,0,0,0,0,0,0,0,0,0,0,2,13,12,66620,26657,5347,35428,0
218,4716,8,5,5,2,0,1,10,0,0,0,0,0,0,0,0,0,0,0,0,2,13,12,66620,26657,5347,35429,0
218,4716,1217,716,841,84,126,174,1301,14,185,118,215,199,333,1446,2542,8,20687,1149,0,2,13,12,66630,26659,5347,35430,0
218,4716,160,89,115,0,13,31,160,7,15,11,17,22,28,78,124,3,495,27,0,2,13,12,66630,26659,5347,35431,0
218,4716,10,10,9,9,0,0,19,0,0,0,0,0,0,0,0,0,0,0,0,2,13,12,66630,26659,5348,35432,0
218,4716,173,84,99,8,29,36,181,5,12,7,13,17,20,54,81,2,221,12,0,2,13,12,66630,26660,5348,35433,0
218,4716,3,1,1,3,0,0,6,0,0,0,0,0,0,0,0,0,0,0,0,2,13,12,66630,26660,5348,35434,0
305,6771,72,33,56,0,4,12,72,1,1,1,1,2,2,0,2,0,1,0,0,2,1,32,66630,26660,5348,35435,0
305,6771,1454,835,1044,76,110,219,1530,17,275,158,296,292,454,2297,3718,9,34017,1889,1,2,1,32,66640,26661,5348,35436,0
97,4034,1289,550,1043,56,32,155,1345,10,167,93,185,177,278,1266,2075,5,11498,638,0,2,25,5,66640,26663,5349,35437,0
152,7140,1392,870,1177,35,17,170,1427,14,494,280,531,508,811,4473,7289,7,54850,3047,2,2,15,5,66640,26666,5350,35438,0
95,3960,1289,550,1043,56,32,155,1345,10,167,93,185,177,278,1266,2075,5,11498,638,0,2,2,2,66640,26668,5351,35439,0
90,3892,1289,550,1043,56,32,155,1345,10,167,93,185,177,278,1266,2075,5,11498,638,0,2,15,25,66640,26670,5352,35440,0
60,1078,282,196,195,3,0,86,285,8,130,71,141,138,212,936,1507,4,6538,363,0,2,3,3,66640,26670,5353,35441,0
89,1825,477,336,357,30,23,73,507,16,194,134,250,210,384,1538,2962,10,30538,1696,0,2,1,1,66650,26671,5353,35442,0
76,1733,996,429,845,24,10,117,1020,7,76,50,88,83,138,494,879,4,3565,198,0,2,1,1,66650,26673,5353,35443,0
76,1733,456,277,329,12,42,72,468,13,85,50,97,98,147,592,972,7,7212,400,0,2,1,1,66650,26673,5353,35444,0
154,3261,1513,682,1277,25,13,200,1538,11,199,116,219,210,335,1557,2584,6,15641,868,0,2,1,1,66650,26675,5353,35445,0
154,3261,819,519,539,24,98,155,843,15,96,57,106,111,163,690,1107,8,9171,509,0,2,1,1,66660,26677,5353,35446,0
67,1324,207,111,150,11,0,50,218,5,26,19,36,31,55,133,272,3,943,52,0,2,1,1,66660,26677,5353,35447,0
67,1324,410,198,237,31,55,97,441,11,63,38,72,74,110,414,683,6,4293,238,0,2,1,1,66670,26678,5354,35448,0
27,964,74,35,59,1,0,14,75,3,14,7,14,17,21,58,85,1,128,7,0,2,1,1,66670,26679,5354,35450,0
27,964,245,125,200,5,7,34,250,7,30,17,34,37,51,166,265,3,1053,58,0,2,1,1,66680,26680,5354,35451,0
305,6770,72,33,56,0,4,12,72,1,1,1,1,2,2,0,2,0,1,0,0,2,1,1,66680,26680,5354,35452,0
305,6770,1454,835,1044,76,110,219,1530,17,275,158,296,292,454,2297,3718,9,34017,1889,1,2,1,1,66690,26681,5354,35453,0
41,829,386,256,301,16,9,68,402,4,59,35,69,63,104,355,621,2,1453,80,0,2,1,1,66690,26681,5354,35454,0
41,829,264,131,164,11,41,46,275,6,38,22,40,44,62,214,338,3,1068,59,0,2,1,1,66700,26681,5355,35455,0
223,4839,1943,715,1694,26,18,214,1969,12,185,120,237,197,357,1436,2721,7,20915,1161,0,2,1,3,66700,26683,5355,35456,0
223,4839,1168,838,957,57,25,144,1225,19,348,224,416,367,640,3018,5452,11,61921,3440,1,2,1,3,66710,26685,5355,35457,0
97,4030,1289,550,1043,56,32,155,1345,10,167,93,185,177,278,1266,2075,5,11498,638,0,2,3,3,66710,26687,5356,35458,0
1,134,149,67,118,4,0,27,153,1,17,14,28,18,42,69,175,0,144,8,0,2,2,2,66710,26687,5356,35459,0
95,4641,1523,757,1297,19,12,193,1542,12,193,117,230,205,347,1508,2664,7,19053,1058,0,2,1,1,66720,26689,5356,35460,0
62,2807,1293,570,1093,25,15,163,1318,10,195,123,241,205,364,1516,2795,6,17273,959,0,2,23,22,66730,26691,5356,35461,0
256,5918,4293,999,3693,19,54,507,4312,9,155,88,170,164,258,1156,1898,4,9368,520,0,2,2,3,66730,26693,5356,35462,0
256,5918,1482,859,1002,125,135,219,1607,16,219,134,251,235,385,1766,3032,9,27804,1544,1,2,2,3,66740,26694,5356,35463,0
141,3282,77,34,69,0,0,8,77,3,24,16,29,27,45,114,213,1,387,21,0,2,2,5,66740,26694,5356,35464,0
141,3282,712,438,573,51,9,84,763,14,102,71,128,116,199,733,1364,8,11988,666,0,2,2,5,66750,26695,5356,35465,0
235,5587,722,423,573,19,0,135,741,12,172,101,199,184,300,1320,2257,6,15668,870,0,2,2,2,66750,26697,5356,35467,1
235,5587,1508,847,911,44,250,301,1552,14,148,88,169,162,257,1120,1886,7,15077,837,0,2,2,2,66750,26698,5357,35468,1
90,3892,1289,550,1043,56,32,155,1345,10,167,93,185,177,278,1266,2075,5,11498,638,0,2,17,27,66750,26700,5358,35469,0
256,5918,4293,999,3693,19,54,507,4312,9,155,88,170,164,258,1156,1898,4,9368,520,0,2,2,3,66750,26702,5358,35470,0
256,5918,1482,859,1002,125,135,219,1607,16,219,134,251,235,385,1766,3032,9,27804,1544,1,2,2,3,66760,26703,5358,35471,0
141,3282,77,34,69,0,0,8,77,3,24,16,29,27,45,114,213,1,387,21,0,2,2,5,66760,26703,5358,35472,0
141,3282,712,438,573,51,9,84,763,14,102,71,128,116,199,733,1364,8,11988,666,0,2,2,5,66770,26704,5358,35473,0
235,5587,722,423,573,19,0,135,741,12,172,101,199,184,300,1320,2257,6,15668,870,0,2,2,2,66770,26706,5358,35475,0
235,5587,1508,847,911,44,250,301,1552,14,148,88,169,162,257,1120,1886,7,15077,837,0,2,2,2,66770,26707,5359,35476,0
92,1951,1043,504,840,53,9,147,1096,9,180,112,198,189,310,1377,2344,4,11604,644,0,2,1,0,66770,26709,5359,35477,0
92,1951,383,288,292,26,6,62,409,11,65,38,67,76,105,429,656,5,3719,206,0,2,1,0,66770,26710,5359,35478,0
92,1951,1043,504,840,53,9,147,1096,9,180,112,198,189,310,1377,2344,4,11604,644,0,2,1,1,66770,26712,5359,35479,0
92,1951,383,288,292,26,6,62,409,11,65,38,67,76,105,429,656,5,3719,206,0,2,1,1,66770,26713,5359,35480,0
62,2807,1293,570,1093,25,15,163,1318,10,195,123,241,205,364,1516,2795,6,17273,959,0,2,7,7,66780,26715,5359,35481,0
92,1957,1043,504,840,53,9,147,1096,9,180,112,198,189,310,1377,2344,4,11604,644,0,2,2,1,66780,26717,5359,35482,1
92,1957,383,288,292,26,6,62,409,11,65,38,67,76,105,429,656,5,3719,206,0,2,2,1,66780,26718,5359,35483,1
101,4065,1289,550,1043,56,32,155,1345,10,167,93,185,177,278,1266,2075,5,11498,638,0,2,4,0,66780,26720,5360,35484,1
33,970,339,213,244,17,9,65,356,10,42,26,48,52,74,259,421,5,2410,133,0,2,0,3,66790,26720,5360,35485,0
64,2837,1293,570,1093,25,15,163,1318,10,195,123,241,205,364,1516,2795,6,17273,959,0,2,5,1,66800,26722,5360,35486,0
256,5940,4293,999,3693,19,54,507,4312,9,155,88,170,164,258,1156,1898,4,9368,520,0,2,1,1,66800,26724,5360,35487,1
256,5940,1482,859,1002,125,135,219,1607,16,219,134,251,235,385,1766,3032,9,27804,1544,1,2,1,1,66810,26725,5360,35488,1
141,3291,77,34,69,0,0,8,77,3,24,16,29,27,45,114,213,1,387,21,0,2,1,1,66810,26725,5360,35489,1
141,3291,712,438,573,51,9,84,763,14,102,71,128,116,199,733,1364,8,11988,666,0,2,1,1,66820,26726,5360,35490,1
98,4059,1289,550,1043,56,32,155,1345,10,167,93,185,177,278,1266,2075,5,11498,638,0,2,17,7,66820,26728,5361,35491,1
40,2477,652,304,544,16,6,88,668,6,89,51,101,95,152,591,998,3,3399,188,0,2,47,1,66820,26729,5361,35492,1
35,1016,339,213,244,17,9,65,356,10,42,26,48,52,74,259,421,5,2410,133,0,2,6,2,66830,26729,5361,35493,1
62,2819,1293,570,1093,25,15,163,1318,10,195,123,241,205,364,1516,2795,6,17273,959,0,2,12,3,66840,26731,5361,35494,1
64,2839,1293,570,1093,25,15,163,1318,10,195,123,241,205,364,1516,2795,6,17273,959,0,2,10,2,66850,26733,5361,35495,0
92,1957,1043,504,840,53,9,147,1096,9,180,112,198,189,310,1377,2344,4,11604,644,0,2,5,0,66850,26735,5361,35496,0
92,1957,383,288,292,26,6,62,409,11,65,38,67,76,105,429,656,5,3719,206,0,2,5,0,66850,26736,5361,35497,0
96,3993,1289,550,1043,56,32,155,1345,10,167,93,185,177,278,1266,2075,5,11498,638,0,2,27,9,66850,26738,5362,35498,0
33,970,339,213,244,17,9,65,356,10,42,26,48,52,74,259,421,5,2410,133,0,2,0,3,66860,26738,5362,35499,0
64,2839,1293,570,1093,25,15,163,1318,10,195,123,241,205,364,1516,2795,6,17273,959,0,2,20,8,66870,26740,5362,35500,0
34,986,339,213,244,17,9,65,356,10,42,26,48,52,74,259,421,5,2410,133,0,2,6,2,66880,26740,5362,35501,0
64,2851,1293,570,1093,25,15,163,1318,10,195,123,241,205,364,1516,2795,6,17273,959,0,2,12,3,66890,26742,5362,35502,0
256,5940,4293,999,3693,19,54,507,4312,9,155,88,170,164,258,1156,1898,4,9368,520,0,2,1,1,66890,26744,5362,35503,0
256,5940,1482,859,1002,125,135,219,1607,16,219,134,251,235,385,1766,3032,9,27804,1544,1,2,1,1,66900,26745,5362,35504,0
141,3291,77,34,69,0,0,8,77,3,24,16,29,27,45,114,213,1,387,21,0,2,1,1,66900,26745,5362,35505,0
141,3291,712,438,573,51,9,84,763,14,102,71,128,116,199,733,1364,8,11988,666,0,2,1,1,66910,26746,5362,35506,0
98,4059,1289,550,1043,56,32,155,1345,10,167,93,185,177,278,1266,2075,5,11498,638,0,2,17,7,66910,26748,5363,35507,0
40,2477,652,304,544,16,6,88,668,6,89,51,101,95,152,591,998,3,3399,188,0,2,47,1,66910,26749,5363,35508,0
96,3982,1289,550,1043,56,32,155,1345,10,167,93,185,177,278,1266,2075,5,11498,638,0,2,0,1,66910,26751,5364,35509,0
21,521,205,80,86,16,53,53,221,7,18,10,19,25,29,94,134,3,497,27,0,2,5,2,66920,26751,5365,35510,0
85,3247,1043,504,840,53,9,147,1096,9,180,112,198,189,310,1377,2344,4,11604,644,0,2,9,0,66920,26753,5365,35511,0
179,7896,139,89,101,2,0,35,141,7,54,34,62,61,96,330,569,4,2287,127,0,2,6,0,66920,26753,5365,35512,0
179,7896,7,5,5,0,0,2,7,1,2,1,2,3,3,2,4,0,2,0,0,2,6,0,66920,26753,5365,35513,0
50,1112,91,45,69,0,3,18,91,3,9,6,10,12,16,33,57,1,95,5,0,2,2,0,66920,26755,5365,35514,1
50,1112,367,234,237,17,34,68,384,16,55,34,61,71,95,381,584,8,5183,287,0,2,2,0,66920,26756,5365,35515,1
23,1181,442,244,305,14,16,103,456,11,68,45,75,79,120,452,756,6,4588,254,0,2,9,1,66920,26758,5365,35516,1
20,522,205,80,86,16,53,53,221,7,18,10,19,25,29,94,134,3,497,27,0,2,3,5,66930,26758,5366,35517,0
141,3301,77,34,69,0,0,8,77,3,24,16,29,27,45,114,213,1,387,21,0,2,4,2,66930,26758,5366,35518,1
141,3301,712,438,573,51,9,84,763,14,102,71,128,116,199,733,1364,8,11988,666,0,2,4,2,66940,26759,5366,35519,1
84,3226,1043,504,840,53,9,147,1096,9,180,112,198,189,310,1377,2344,4,11604,644,0,2,10,7,66940,26761,5366,35520,1
2,173,42,7,35,4,0,5,46,1,2,1,2,3,3,2,4,0,2,0,0,2,4,77,66940,26761,5366,35521,1
2,173,11,6,10,0,0,1,11,2,4,2,4,6,6,10,15,1,15,0,0,2,4,77,66940,26761,5366,35522,1
20,522,205,80,86,16,53,53,221,7,18,10,19,25,29,94,134,3,497,27,0,2,5,1,66950,26761,5367,35523,0
27,1218,442,244,305,14,16,103,456,11,68,45,75,79,120,452,756,6,4588,254,0,2,17,7,66950,26763,5367,35524,0
96,3982,1289,550,1043,56,32,155,1345,10,167,93,185,177,278,1266,2075,5,11498,638,0,2,0,1,66950,26765,5368,35525,0
179,7896,139,89,101,2,0,35,141,7,54,34,62,61,96,330,569,4,2287,127,0,2,6,0,66950,26765,5368,35526,0
179,7896,7,5,5,0,0,2,7,1,2,1,2,3,3,2,4,0,2,0,0,2,6,0,66950,26765,5368,35527,0
20,522,205,80,86,16,53,53,221,7,18,10,19,25,29,94,134,3,497,27,0,2,1,1,66960,26765,5369,35528,0
142,3311,77,34,69,0,0,8,77,3,24,16,29,27,45,114,213,1,387,21,0,2,2,1,66960,26765,5369,35529,0
142,3311,712,438,573,51,9,84,763,14,102,71,128,116,199,733,1364,8,11988,666,0,2,2,1,66970,26766,5369,35530,0
20,522,205,80,86,16,53,53,221,7,18,10,19,25,29,94,134,3,497,27,0,2,2,1,66980,26766,5370,35531,0
20,522,205,80,86,16,53,53,221,7,18,10,19,25,29,94,134,3,497,27,0,2,1,1,66990,26766,5371,35532,0
180,5393,1660,832,1314,41,38,274,1701,20,312,209,395,332,604,2671,5058,12,64042,3557,1,2,1,1,66990,26768,5372,35534,0
180,5393,1057,646,719,113,100,145,1170,18,215,134,248,233,382,1740,3004,10,31186,1732,1,2,1,1,67000,26769,5373,35535,0
50,1112,91,45,69,0,3,18,91,3,9,6,10,12,16,33,57,1,95,5,0,2,2,0,67000,26771,5373,35536,0
50,1112,367,234,237,17,34,68,384,16,55,34,61,71,95,381,584,8,5183,287,0,2,2,0,67000,26772,5373,35537,0
27,1218,442,244,305,14,16,103,456,11,68,45,75,79,120,452,756,6,4588,254,0,2,25,7,67000,26774,5373,35538,0
1,86,42,7,35,4,0,5,46,1,2,1,2,3,3,2,4,0,2,0,0,2,23,42,67000,26774,5373,35539,1
1,86,11,6,10,0,0,1,11,2,4,2,4,6,6,10,15,1,15,0,0,2,23,42,67000,26774,5373,35540,1
142,3311,77,34,69,0,0,8,77,3,24,16,29,27,45,114,213,1,387,21,0,2,5,2,67000,26774,5373,35541,0
142,3311,712,438,573,51,9,84,763,14,102,71,128,116,199,733,1364,8,11988,666,0,2,5,2,67010,26775,5373,35542,0
20,522,205,80,86,16,53,53,221,7,18,10,19,25,29,94,134,3,497,27,0,2,10,4,67020,26775,5374,35543,0
84,3226,1043,504,840,53,9,147,1096,9,180,112,198,189,310,1377,2344,4,11604,644,0,2,12,0,67020,26777,5374,35544,0
1,86,42,7,35,4,0,5,46,1,2,1,2,3,3,2,4,0,2,0,0,2,19,111,67020,26777,5374,35545,0
1,86,11,6,10,0,0,1,11,2,4,2,4,6,6,10,15,1,15,0,0,2,19,111,67020,26777,5374,35546,0
180,5393,1660,832,1314,41,38,274,1701,20,312,209,395,332,604,2671,5058,12,64042,3557,1,2,1,1,67020,26779,5375,35548,0
180,5393,1057,646,719,113,100,145,1170,18,215,134,248,233,382,1740,3004,10,31186,1732,1,2,1,1,67030,26780,5376,35549,0
180,5397,1660,832,1314,41,38,274,1701,20,312,209,395,332,604,2671,5058,12,64042,3557,1,2,1,1,67030,26782,5377,35551,0
180,5397,1057,646,719,113,100,145,1170,18,215,134,248,233,382,1740,3004,10,31186,1732,1,2,1,1,67040,26783,5378,35552,0
34,986,339,213,244,17,9,65,356,10,42,26,48,52,74,259,421,5,2410,133,0,2,6,5,67050,26783,5378,35553,0
256,5938,4293,999,3693,19,54,507,4312,9,155,88,170,164,258,1156,1898,4,9368,520,0,2,2,3,67050,26785,5378,35554,0
256,5938,1482,859,1002,125,135,219,1607,16,219,134,251,235,385,1766,3032,9,27804,1544,1,2,2,3,67060,26786,5378,35555,0
142,3309,77,34,69,0,0,8,77,3,24,16,29,27,45,114,213,1,387,21,0,2,2,5,67060,26786,5378,35556,0
142,3309,712,438,573,51,9,84,763,14,102,71,128,116,199,733,1364,8,11988,666,0,2,2,5,67070,26787,5378,35557,0
244,5826,722,423,573,19,0,135,741,12,172,101,199,184,300,1320,2257,6,15668,870,0,2,2,2,67070,26789,5378,35559,0
244,5826,1508,847,911,44,250,301,1552,14,148,88,169,162,257,1120,1886,7,15077,837,0,2,2,2,67070,26790,5379,35560,0
92,1957,1043,504,840,53,9,147,1096,9,180,112,198,189,310,1377,2344,4,11604,644,0,2,5,0,67070,26792,5379,35561,0
92,1957,383,288,292,26,6,62,409,11,65,38,67,76,105,429,656,5,3719,206,0,2,5,0,67070,26793,5379,35562,0
99,4081,1289,550,1043,56,32,155,1345,10,167,93,185,177,278,1266,2075,5,11498,638,0,2,43,36,67070,26795,5380,35563,0
179,7977,139,89,101,2,0,35,141,7,54,34,62,61,96,330,569,4,2287,127,0,2,6,0,67070,26795,5380,35564,0
179,7977,7,5,5,0,0,2,7,1,2,1,2,3,3,2,4,0,2,0,0,2,6,0,67070,26795,5380,35565,0
64,2851,1293,570,1093,25,15,163,1318,10,195,123,241,205,364,1516,2795,6,17273,959,0,2,32,11,67080,26797,5380,35566,0
224,4845,1943,715,1694,26,18,214,1969,12,185,120,237,197,357,1436,2721,7,20915,1161,0,2,3,1,67080,26799,5380,35567,0
224,4845,1168,838,957,57,25,144,1225,19,348,224,416,367,640,3018,5452,11,61921,3440,1,2,3,1,67090,26801,5380,35568,0
98,4059,1289,550,1043,56,32,155,1345,10,167,93,185,177,278,1266,2075,5,11498,638,0,2,2,2,67090,26803,5381,35569,0
99,5070,1943,715,1694,26,18,214,1969,12,185,120,237,197,357,1436,2721,7,20915,1161,0,2,2,2,67090,26805,5381,35570,0
218,4718,2,2,2,0,0,0,2,0,0,0,0,0,0,0,0,0,0,0,0,2,1,0,67170,26821,5387,35619,0
218,4718,99,48,90,1,3,5,100,0,0,0,0,0,0,0,0,0,0,0,0,2,1,0,67170,26822,5387,35620,0
218,4718,8,5,5,2,0,1,10,0,0,0,0,0,0,0,0,0,0,0,0,2,1,0,67170,26822,5387,35621,0
218,4718,1217,716,841,84,126,174,1301,14,185,118,215,199,333,1446,2542,8,20687,1149,0,2,1,0,67180,26824,5387,35622,0
218,4718,160,89,115,0,13,31,160,7,15,11,17,22,28,78,124,3,495,27,0,2,1,0,67180,26824,5387,35623,0
218,4718,10,10,9,9,0,0,19,0,0,0,0,0,0,0,0,0,0,0,0,2,1,0,67180,26824,5388,35624,0
218,4718,173,84,99,8,29,36,181,5,12,7,13,17,20,54,81,2,221,12,0,2,1,0,67180,26825,5388,35625,0
218,4718,3,1,1,3,0,0,6,0,0,0,0,0,0,0,0,0,0,0,0,2,1,0,67180,26825,5388,35626,0
25,412,219,78,157,11,5,46,230,3,24,20,34,27,54,114,256,2,545,30,0,2,7,8,67180,26826,5388,35627,0
25,412,108,64,79,9,0,20,117,5,15,11,19,20,30,70,129,3,410,22,0,2,7,8,67180,26826,5388,35628,0
10,454,219,78,157,11,5,46,230,3,24,20,34,27,54,114,256,2,545,30,0,2,6,6,67180,26827,5388,35629,0
25,418,219,78,157,11,5,46,230,3,24,20,34,27,54,114,256,2,545,30,0,2,28,15,67180,26828,5388,35630,0
25,418,108,64,79,9,0,20,117,5,15,11,19,20,30,70,129,3,410,22,0,2,28,15,67180,26828,5388,35631,0
10,454,219,78,157,11,5,46,230,3,24,20,34,27,54,114,256,2,545,30,0,2,53,40,67180,26829,5388,35632,0
9,441,219,78,157,11,5,46,230,3,24,20,34,27,54,114,256,2,545,30,0,2,1,4,67180,26830,5388,35633,0
25,418,219,78,157,11,5,46,230,3,24,20,34,27,54,114,256,2,545,30,0,2,1,1,67180,26831,5388,35634,0
25,418,108,64,79,9,0,20,117,5,15,11,19,20,30,70,129,3,410,22,0,2,1,1,67180,26831,5388,35635,0
180,5397,1660,832,1314,41,38,274,1701,20,312,209,395,332,604,2671,5058,12,64042,3557,1,2,1,1,67180,26833,5389,35637,0
180,5397,1057,646,719,113,100,145,1170,18,215,134,248,233,382,1740,3004,10,31186,1732,1,2,1,1,67190,26834,5390,35638,0
34,986,339,213,244,17,9,65,356,10,42,26,48,52,74,259,421,5,2410,133,0,2,6,5,67200,26834,5390,35639,0
256,5938,4293,999,3693,19,54,507,4312,9,155,88,170,164,258,1156,1898,4,9368,520,0,2,2,3,67200,26836,5390,35640,0
256,5938,1482,859,1002,125,135,219,1607,16,219,134,251,235,385,1766,3032,9,27804,1544,1,2,2,3,67210,26837,5390,35641,0
142,3309,77,34,69,0,0,8,77,3,24,16,29,27,45,114,213,1,387,21,0,2,2,5,67210,26837,5390,35642,0
142,3309,712,438,573,51,9,84,763,14,102,71,128,116,199,733,1364,8,11988,666,0,2,2,5,67220,26838,5390,35643,0
244,5826,722,423,573,19,0,135,741,12,172,101,199,184,300,1320,2257,6,15668,870,0,2,2,2,67220,26840,5390,35645,0
244,5826,1508,847,911,44,250,301,1552,14,148,88,169,162,257,1120,1886,7,15077,837,0,2,2,2,67220,26841,5391,35646,0
92,1957,1043,504,840,53,9,147,1096,9,180,112,198,189,310,1377,2344,4,11604,644,0,2,5,0,67220,26843,5391,35647,0
92,1957,383,288,292,26,6,62,409,11,65,38,67,76,105,429,656,5,3719,206,0,2,5,0,67220,26844,5391,35648,0
99,4081,1289,550,1043,56,32,155,1345,10,167,93,185,177,278,1266,2075,5,11498,638,0,2,43,36,67220,26846,5392,35649,0
179,7977,139,89,101,2,0,35,141,7,54,34,62,61,96,330,569,4,2287,127,0,2,6,0,67220,26846,5392,35650,0
179,7977,7,5,5,0,0,2,7,1,2,1,2,3,3,2,4,0,2,0,0,2,6,0,67220,26846,5392,35651,0
64,2851,1293,570,1093,25,15,163,1318,10,195,123,241,205,364,1516,2795,6,17273,959,0,2,32,11,67230,26848,5392,35652,0
44,3226,996,429,845,24,10,117,1020,7,76,50,88,83,138,494,879,4,3565,198,0,2,2,1,67230,26850,5392,35653,1
98,2666,1523,757,1297,19,12,193,1542,12,193,117,230,205,347,1508,2664,7,19053,1058,0,2,5,3,67240,26852,5392,35654,0
98,2666,701,378,504,33,58,109,734,13,110,68,126,123,194,794,1346,7,10027,557,0,2,5,3,67240,26853,5393,35655,0
96,4691,1523,757,1297,19,12,193,1542,12,193,117,230,205,347,1508,2664,7,19053,1058,0,2,16,0,67250,26855,5393,35656,0
224,4845,1943,715,1694,26,18,214,1969,12,185,120,237,197,357,1436,2721,7,20915,1161,0,2,3,1,67250,26857,5393,35657,0
224,4845,1168,838,957,57,25,144,1225,19,348,224,416,367,640,3018,5452,11,61921,3440,1,2,3,1,67260,26859,5393,35658,0
99,4081,1289,550,1043,56,32,155,1345,10,167,93,185,177,278,1266,2075,5,11498,638,0,2,2,2,67260,26861,5394,35659,0
99,5070,1943,715,1694,26,18,214,1969,12,185,120,237,197,357,1436,2721,7,20915,1161,0,2,2,2,67260,26863,5394,35660,0
98,2666,1523,757,1297,19,12,193,1542,12,193,117,230,205,347,1508,2664,7,19053,1058,0,2,5,3,67270,26865,5394,35661,0
98,2666,701,378,504,33,58,109,734,13,110,68,126,123,194,794,1346,7,10027,557,0,2,5,3,67270,26866,5395,35662,0
96,4691,1523,757,1297,19,12,193,1542,12,193,117,230,205,347,1508,2664,7,19053,1058,0,2,16,0,67280,26868,5395,35663,0
1,86,42,7,35,4,0,5,46,1,2,1,2,3,3,2,4,0,2,0,0,2,19,111,67280,26868,5395,35664,0
1,86,11,6,10,0,0,1,11,2,4,2,4,6,6,10,15,1,15,0,0,2,19,111,67280,26868,5395,35665,0
222,4841,182,127,129,0,0,53,182,5,39,21,42,44,63,217,343,2,926,51,0,2,70,7,67290,26872,5397,35673,0
222,4841,1165,710,800,67,119,181,1232,18,243,153,282,261,435,2000,3492,10,36473,2026,1,2,70,7,67300,26872,5398,35674,0
180,5397,1660,832,1314,41,38,274,1701,20,312,209,395,332,604,2671,5058,12,64042,3557,1,2,3,2,67300,26874,5399,35676,0
180,5397,1057,646,719,113,100,145,1170,18,215,134,248,233,382,1740,3004,10,31186,1732,1,2,3,2,67310,26875,5400,35677,0
76,1733,996,429,845,24,10,117,1020,7,76,50,88,83,138,494,879,4,3565,198,0,2,4,5,67310,26877,5400,35678,0
76,1733,456,277,329,12,42,72,468,13,85,50,97,98,147,592,972,7,7212,400,0,2,4,5,67310,26877,5400,35679,0
67,1324,207,111,150,11,0,50,218,5,26,19,36,31,55,133,272,3,943,52,0,2,0,7,67310,26877,5400,35680,0
67,1324,410,198,237,31,55,97,441,11,63,38,72,74,110,414,683,6,4293,238,0,2,0,7,67320,26878,5401,35681,0
218,4716,2,2,2,0,0,0,2,0,0,0,0,0,0,0,0,0,0,0,0,2,32,29,67320,26878,5401,35681,0
218,4716,99,48,90,1,3,5,100,0,0,0,0,0,0,0,0,0,0,0,0,2,32,29,67320,26879,5401,35682,0
218,4716,8,5,5,2,0,1,10,0,0,0,0,0,0,0,0,0,0,0,0,2,32,29,67320,26879,5401,35683,0
218,4716,1217,716,841,84,126,174,1301,14,185,118,215,199,333,1446,2542,8,20687,1149,0,2,32,29,67330,26881,5401,35684,0
218,4716,160,89,115,0,13,31,160,7,15,11,17,22,28,78,124,3,495,27,0,2,32,29,67330,26881,5401,35685,0
218,4716,10,10,9,9,0,0,19,0,0,0,0,0,0,0,0,0,0,0,0,2,32,29,67330,26881,5402,35686,0
218,4716,173,84,99,8,29,36,181,5,12,7,13,17,20,54,81,2,221,12,0,2,32,29,67330,26882,5402,35687,0
218,4716,3,1,1,3,0,0,6,0,0,0,0,0,0,0,0,0,0,0,0,2,32,29,67330,26882,5402,35688,0
51,757,167,116,138,4,5,22,171,8,48,30,56,56,86,292,499,4,2330,129,0,2,3,6,67330,26882,5402,35689,0
256,5938,4293,999,3693,19,54,507,4312,9,155,88,170,164,258,1156,1898,4,9368,520,0,2,20,15,67330,26884,5402,35691,0
256,5938,1482,859,1002,125,135,219,1607,16,219,134,251,235,385,1766,3032,9,27804,1544,1,2,20,15,67340,26885,5402,35692,0
88,2299,773,422,505,30,103,129,803,14,77,46,83,91,129,535,839,7,6334,351,0,2,26,15,67350,26886,5403,35693,0
142,3309,77,34,69,0,0,8,77,3,24,16,29,27,45,114,213,1,387,21,0,2,10,4,67350,26886,5403,35694,0
142,3309,712,438,573,51,9,84,763,14,102,71,128,116,199,733,1364,8,11988,666,0,2,10,4,67360,26887,5403,35695,0
24,600,2,2,2,0,0,0,2,0,0,0,0,0,0,0,0,0,0,0,0,2,2,7,67360,26887,5403,35695,0
24,600,99,48,90,1,3,5,100,0,0,0,0,0,0,0,0,0,0,0,0,2,2,7,67360,26888,5403,35696,0
24,600,8,5,5,2,0,1,10,0,0,0,0,0,0,0,0,0,0,0,0,2,2,7,67360,26888,5403,35697,0
24,600,1217,716,841,84,126,174,1301,14,185,118,215,199,333,1446,2542,8,20687,1149,0,2,2,7,67370,26890,5403,35698,0
24,600,160,89,115,0,13,31,160,7,15,11,17,22,28,78,124,3,495,27,0,2,2,7,67370,26890,5403,35699,0
24,600,10,10,9,9,0,0,19,0,0,0,0,0,0,0,0,0,0,0,0,2,2,7,67370,26890,5404,35700,0
24,600,173,84,99,8,29,36,181,5,12,7,13,17,20,54,81,2,221,12,0,2,2,7,67370,26891,5404,35701,0
24,600,3,1,1,3,0,0,6,0,0,0,0,0,0,0,0,0,0,0,0,2,2,7,67370,26891,5404,35702,0
88,1887,402,202,227,24,74,80,426,12,52,33,61,64,94,339,564,7,3969,220,0,2,11,2,67370,26892,5404,35703,0
88,1985,53,23,39,0,0,13,53,2,8,4,8,10,12,26,39,1,39,2,0,2,12,9,67370,26892,5404,35704,0
88,1985,515,298,307,33,80,99,548,12,63,44,77,75,121,419,753,7,5527,307,0,2,12,9,67380,26892,5404,35705,0
20,522,205,80,86,16,53,53,221,7,18,10,19,25,29,94,134,3,497,27,0,2,10,4,67390,26892,5405,35706,0
50,1112,91,45,69,0,3,18,91,3,9,6,10,12,16,33,57,1,95,5,0,0,283,0,67390,26894,5405,35707,0
50,1112,367,234,237,17,34,68,384,16,55,34,61,71,95,381,584,8,5183,287,0,0,283,0,67390,26895,5405,35708,0
244,5826,722,423,573,19,0,135,741,12,172,101,199,184,300,1320,2257,6,15668,870,0,2,68,6,67390,26897,5405,35711,0
244,5826,1508,847,911,44,250,301,1552,14,148,88,169,162,257,1120,1886,7,15077,837,0,2,68,6,67390,26898,5406,35712,0
305,6770,72,33,56,0,4,12,72,1,1,1,1,2,2,0,2,0,1,0,0,2,32,56,67390,26898,5406,35713,0
305,6770,1454,835,1044,76,110,219,1530,17,275,158,296,292,454,2297,3718,9,34017,1889,1,2,32,56,67400,26899,5406,35714,0
41,829,386,256,301,16,9,68,402,4,59,35,69,63,104,355,621,2,1453,80,0,2,18,39,67400,26899,5406,35715,0
41,829,264,131,164,11,41,46,275,6,38,22,40,44,62,214,338,3,1068,59,0,2,18,39,67410,26899,5407,35716,0
30,654,215,129,180,6,0,29,221,8,65,43,72,73,115,415,711,4,3153,175,0,2,1,2,67410,26899,5407,35717,0
30,654,97,69,77,3,3,16,100,6,22,13,23,28,36,113,173,3,542,30,0,2,1,2,67410,26900,5407,35718,0
224,4845,1943,715,1694,26,18,214,1969,12,185,120,237,197,357,1436,2721,7,20915,1161,0,2,3,1,67410,26902,5407,35719,0
224,4845,1168,838,957,57,25,144,1225,19,348,224,416,367,640,3018,5452,11,61921,3440,1,2,3,1,67420,26904,5407,35720,0
19,669,442,244,305,14,16,103,456,11,68,45,75,79,120,452,756,6,4588,254,0,2,113,58,67420,26906,5407,35721,0
19,669,182,102,99,11,40,35,193,3,11,6,11,14,17,42,64,1,97,5,0,2,113,58,67420,26907,5407,35722,0
2,114,37,13,25,0,6,6,37,1,2,1,2,3,3,2,4,0,2,0,0,2,18,0,67420,26907,5407,35723,0
2,114,133,47,40,1,43,49,134,0,0,0,0,0,0,0,0,0,0,0,0,2,18,0,67420,26907,5407,35724,0
29,716,601,196,481,2,23,85,603,8,63,36,72,71,108,400,664,4,3036,168,0,2,10,10,67420,26907,5407,35725,0
29,716,156,79,106,5,16,28,161,5,14,8,15,19,23,64,97,2,261,14,0,2,10,10,67420,26907,5407,35726,0
99,4081,1289,550,1043,56,32,155,1345,10,167,93,185,177,278,1266,2075,5,11498,638,0,2,42,12,67420,26909,5408,35727,0
152,7140,1392,870,1177,35,17,170,1427,14,494,280,531,508,811,4473,7289,7,54850,3047,2,2,15,5,67420,26912,5409,35728,0
24,1145,75,38,59,1,3,12,76,2,4,2,4,6,6,10,15,1,15,0,0,2,68,0,67420,26912,5409,35729,0
33,2202,1157,318,931,29,22,177,1186,6,104,63,125,110,188,712,1274,3,4596,255,0,2,58,0,67420,26912,5409,35730,0
103,4797,1338,495,1086,10,64,173,1348,11,122,82,157,133,239,883,1686,7,11934,663,0,2,6,0,67420,26914,5409,35731,0
179,7977,139,89,101,2,0,35,141,7,54,34,62,61,96,330,569,4,2287,127,0,2,42,43,67420,26914,5409,35732,0
179,7977,7,5,5,0,0,2,7,1,2,1,2,3,3,2,4,0,2,0,0,2,42,43,67420,26914,5409,35733,0
138,6146,1782,648,1425,9,47,279,1791,8,171,97,189,179,286,1292,2140,4,9462,525,0,2,19,19,67420,26915,5410,35734,0
40,2477,652,304,544,16,6,88,668,6,89,51,101,95,152,591,998,3,3399,188,0,2,47,1,67420,26916,5410,35735,0
97,4228,1020,354,843,12,15,144,1032,8,134,77,144,142,221,970,1580,4,6792,377,0,2,39,4,67420,26916,5410,35736,0
47,2228,722,423,573,19,0,135,741,12,172,101,199,184,300,1320,2257,6,15668,870,0,2,32,0,67420,26918,5410,35738,0
42,1848,386,256,301,16,9,68,402,4,59,35,69,63,104,355,621,2,1453,80,0,2,24,7,67420,26918,5410,35739,0
84,3226,1043,504,840,53,9,147,1096,9,180,112,198,189,310,1377,2344,4,11604,644,0,2,29,1,67420,26920,5410,35740,0
99,5070,1943,715,1694,26,18,214,1969,12,185,120,237,197,357,1436,2721,7,20915,1161,0,2,2,2,67420,26922,5410,35741,0
27,1218,442,244,305,14,16,103,456,11,68,45,75,79,120,452,756,6,4588,254,0,2,118,9,67420,26924,5410,35742,0
40,1425,601,196,481,2,23,85,603,8,63,36,72,71,108,400,664,4,3036,168,0,2,66,4,67420,26924,5410,35743,0
1,86,42,7,35,4,0,5,46,1,2,1,2,3,3,2,4,0,2,0,0,2,19,111,67420,26924,5410,35744,0
1,86,11,6,10,0,0,1,11,2,4,2,4,6,6,10,15,1,15,0,0,2,19,111,67420,26924,5410,35745,0
222,4841,182,127,129,0,0,53,182,5,39,21,42,44,63,217,343,2,926,51,0,2,70,7,67430,26928,5412,35753,0
222,4841,1165,710,800,67,119,181,1232,18,243,153,282,261,435,2000,3492,10,36473,2026,1,2,70,7,67440,26928,5413,35754,0
180,5397,1660,832,1314,41,38,274,1701,20,312,209,395,332,604,2671,5058,12,64042,3557,1,2,3,2,67440,26930,5414,35756,0
180,5397,1057,646,719,113,100,145,1170,18,215,134,248,233,382,1740,3004,10,31186,1732,1,2,3,2,67450,26931,5415,35757,0
76,1733,996,429,845,24,10,117,1020,7,76,50,88,83,138,494,879,4,3565,198,0,2,4,5,67450,26933,5415,35758,0
76,1733,456,277,329,12,42,72,468,13,85,50,97,98,147,592,972,7,7212,400,0,2,4,5,67450,26933,5415,35759,0
67,1324,207,111,150,11,0,50,218,5,26,19,36,31,55,133,272,3,943,52,0,2,0,7,67450,26933,5415,35760,0
67,1324,410,198,237,31,55,97,441,11,63,38,72,74,110,414,683,6,4293,238,0,2,0,7,67460,26934,5416,35761,0
218,4716,2,2,2,0,0,0,2,0,0,0,0,0,0,0,0,0,0,0,0,2,32,29,67460,26934,5416,35761,0
218,4716,99,48,90,1,3,5,100,0,0,0,0,0,0,0,0,0,0,0,0,2,32,29,67460,26935,5416,35762,0
218,4716,8,5,5,2,0,1,10,0,0,0,0,0,0,0,0,0,0,0,0,2,32,29,67460,26935,5416,35763,0
218,4716,1217,716,841,84,126,174,1301,14,185,118,215,199,333,1446,2542,8,20687,1149,0,2,32,29,67470,26937,5416,35764,0
218,4716,160,89,115,0,13,31,160,7,15,11,17,22,28,78,124,3,495,27,0,2,32,29,67470,26937,5416,35765,0
218,4716,10,10,9,9,0,0,19,0,0,0,0,0,0,0,0,0,0,0,0,2,32,29,67470,26937,5417,35766,0
218,4716,173,84,99,8,29,36,181,5,12,7,13,17,20,54,81,2,221,12,0,2,32,29,67470,26938,5417,35767,0
218,4716,3,1,1,3,0,0,6,0,0,0,0,0,0,0,0,0,0,0,0,2,32,29,67470,26938,5417,35768,0
51,757,167,116,138,4,5,22,171,8,48,30,56,56,86,292,499,4,2330,129,0,2,3,6,67470,26938,5417,35769,0
256,5938,4293,999,3693,19,54,507,4312,9,155,88,170,164,258,1156,1898,4,9368,520,0,2,20,15,67470,26940,5417,35771,0
256,5938,1482,859,1002,125,135,219,1607,16,219,134,251,235,385,1766,3032,9,27804,1544,1,2,20,15,67480,26941,5417,35772,0
88,2299,773,422,505,30,103,129,803,14,77,46,83,91,129,535,839,7,6334,351,0,2,26,15,67490,26942,5418,35773,0
142,3309,77,34,69,0,0,8,77,3,24,16,29,27,45,114,213,1,387,21,0,2,10,4,67490,26942,5418,35774,0
142,3309,712,438,573,51,9,84,763,14,102,71,128,116,199,733,1364,8,11988,666,0,2,10,4,67500,26943,5418,35775,0
24,600,2,2,2,0,0,0,2,0,0,0,0,0,0,0,0,0,0,0,0,2,2,7,67500,26943,5418,35775,0
24,600,99,48,90,1,3,5,100,0,0,0,0,0,0,0,0,0,0,0,0,2,2,7,67500,26944,5418,35776,0
24,600,8,5,5,2,0,1,10,0,0,0,0,0,0,0,0,0,0,0,0,2,2,7,67500,26944,5418,35777,0
24,600,1217,716,841,84,126,174,1301,14,185,118,215,199,333,1446,2542,8,20687,1149,0,2,2,7,67510,26946,5418,35778,0
24,600,160,89,115,0,13,31,160,7,15,11,17,22,28,78,124,3,495,27,0,2,2,7,67510,26946,5418,35779,0
24,600,10,10,9,9,0,0,19,0,0,0,0,0,0,0,0,0,0,0,0,2,2,7,67510,26946,5419,35780,0
24,600,173,84,99,8,29,36,181,5,12,7,13,17,20,54,81,2,221,12,0,2,2,7,67510,26947,5419,35781,0
24,600,3,1,1,3,0,0,6,0,0,0,0,0,0,0,0,0,0,0,0,2,2,7,67510,26947,5419,35782,0
88,1887,402,202,227,24,74,80,426,12,52,33,61,64,94,339,564,7,3969,220,0,2,11,2,67510,26948,5419,35783,0
88,1985,53,23,39,0,0,13,53,2,8,4,8,10,12,26,39,1,39,2,0,2,12,9,67510,26948,5419,35784,0
88,1985,515,298,307,33,80,99,548,12,63,44,77,75,121,419,753,7,5527,307,0,2,12,9,67520,26948,5419,35785,0
20,522,205,80,86,16,53,53,221,7,18,10,19,25,29,94,134,3,497,27,0,2,10,4,67530,26948,5420,35786,0
50,1112,91,45,69,0,3,18,91,3,9,6,10,12,16,33,57,1,95,5,0,0,283,0,67530,26950,5420,35787,0
50,1112,367,234,237,17,34,68,384,16,55,34,61,71,95,381,584,8,5183,287,0,0,283,0,67530,26951,5420,35788,0
244,5826,722,423,573,19,0,135,741,12,172,101,199,184,300,1320,2257,6,15668,870,0,2,68,6,67530,26953,5420,35791,0
244,5826,1508,847,911,44,250,301,1552,14,148,88,169,162,257,1120,1886,7,15077,837,0,2,68,6,67530,26954,5421,35792,0
305,6770,72,33,56,0,4,12,72,1,1,1,1,2,2,0,2,0,1,0,0,2,32,56,67530,26954,5421,35793,0
305,6770,1454,835,1044,76,110,219,1530,17,275,158,296,292,454,2297,3718,9,34017,1889,1,2,32,56,67540,26955,5421,35794,0
41,829,386,256,301,16,9,68,402,4,59,35,69,63,104,355,621,2,1453,80,0,2,18,39,67540,26955,5421,35795,0
41,829,264,131,164,11,41,46,275,6,38,22,40,44,62,214,338,3,1068,59,0,2,18,39,67550,26955,5422,35796,0
30,654,215,129,180,6,0,29,221,8,65,43,72,73,115,415,711,4,3153,175,0,2,1,2,67550,26955,5422,35797,0
30,654,97,69,77,3,3,16,100,6,22,13,23,28,36,113,173,3,542,30,0,2,1,2,67550,26956,5422,35798,0
224,4845,1943,715,1694,26,18,214,1969,12,185,120,237,197,357,1436,2721,7,20915,1161,0,2,3,1,67550,26958,5422,35799,0
224,4845,1168,838,957,57,25,144,1225,19,348,224,416,367,640,3018,5452,11,61921,3440,1,2,3,1,67560,26960,5422,35800,0
19,669,442,244,305,14,16,103,456,11,68,45,75,79,120,452,756,6,4588,254,0,2,113,58,67560,26962,5422,35801,0
19,669,182,102,99,11,40,35,193,3,11,6,11,14,17,42,64,1,97,5,0,2,113,58,67560,26963,5422,35802,0
2,114,37,13,25,0,6,6,37,1,2,1,2,3,3,2,4,0,2,0,0,2,18,0,67560,26963,5422,35803,0
2,114,133,47,40,1,43,49,134,0,0,0,0,0,0,0,0,0,0,0,0,2,18,0,67560,26963,5422,35804,0
29,716,601,196,481,2,23,85,603,8,63,36,72,71,108,400,664,4,3036,168,0,2,10,10,67560,26963,5422,35805,0
29,716,156,79,106,5,16,28,161,5,14,8,15,19,23,64,97,2,261,14,0,2,10,10,67560,26963,5422,35806,0
99,4081,1289,550,1043,56,32,155,1345,10,167,93,185,177,278,1266,2075,5,11498,638,0,2,42,12,67560,26965,5423,35807,0
152,7140,1392,870,1177,35,17,170,1427,14,494,280,531,508,811,4473,7289,7,54850,3047,2,2,15,5,67560,26968,5424,35808,0
24,1145,75,38,59,1,3,12,76,2,4,2,4,6,6,10,15,1,15,0,0,2,68,0,67560,26968,5424,35809,0
33,2202,1157,318,931,29,22,177,1186,6,104,63,125,110,188,712,1274,3,4596,255,0,2,58,0,67560,26968,5424,35810,0
103,4797,1338,495,1086,10,64,173,1348,11,122,82,157,133,239,883,1686,7,11934,663,0,2,6,0,67560,26970,5424,35811,0
179,7977,139,89,101,2,0,35,141,7,54,34,62,61,96,330,569,4,2287,127,0,2,42,43,67560,26970,5424,35812,0
179,7977,7,5,5,0,0,2,7,1,2,1,2,3,3,2,4,0,2,0,0,2,42,43,67560,26970,5424,35813,0
138,6146,1782,648,1425,9,47,279,1791,8,171,97,189,179,286,1292,2140,4,9462,525,0,2,19,19,67560,26971,5425,35814,0
40,2477,652,304,544,16,6,88,668,6,89,51,101,95,152,591,998,3,3399,188,0,2,47,1,67560,26972,5425,35815,0
97,4228,1020,354,843,12,15,144,1032,8,134,77,144,142,221,970,1580,4,6792,377,0,2,39,4,67560,26972,5425,35816,0
47,2228,722,423,573,19,0,135,741,12,172,101,199,184,300,1320,2257,6,15668,870,0,2,32,0,67560,26974,5425,35818,0
42,1848,386,256,301,16,9,68,402,4,59,35,69,63,104,355,621,2,1453,80,0,2,24,7,67560,26974,5425,35819,0
84,3226,1043,504,840,53,9,147,1096,9,180,112,198,189,310,1377,2344,4,11604,644,0,2,29,1,67560,26976,5425,35820,0
99,5070,1943,715,1694,26,18,214,1969,12,185,120,237,197,357,1436,2721,7,20915,1161,0,2,2,2,67560,26978,5425,35821,0
27,1218,442,244,305,14,16,103,456,11,68,45,75,79,120,452,756,6,4588,254,0,2,118,9,67560,26980,5425,35822,0
40,1425,601,196,481,2,23,85,603,8,63,36,72,71,108,400,664,4,3036,168,0,2,66,4,67560,26980,5425,35823,0
88,2299,773,422,505,30,103,129,803,14,77,46,83,91,129,535,839,7,6334,351,0,2,1,1,67570,26981,5426,35824,0
1,86,42,7,35,4,0,5,46,1,2,1,2,3,3,2,4,0,2,0,0,2,1,1,67570,26981,5426,35825,0
1,86,11,6,10,0,0,1,11,2,4,2,4,6,6,10,15,1,15,0,0,2,1,1,67570,26981,5426,35826,0
53,1164,91,45,69,0,3,18,91,3,9,6,10,12,16,33,57,1,95,5,0,2,21,0,67570,26983,5426,35827,1
53,1164,367,234,237,17,34,68,384,16,55,34,61,71,95,381,584,8,5183,287,0,2,21,0,67570,26984,5426,35828,1
27,1248,442,244,305,14,16,103,456,11,68,45,75,79,120,452,756,6,4588,254,0,2,4,0,67570,26986,5426,35829,1
29,1261,442,244,305,14,16,103,456,11,68,45,75,79,120,452,756,6,4588,254,0,2,1,1,67570,26988,5426,35830,0
30,1268,442,244,305,14,16,103,456,11,68,45,75,79,120,452,756,6,4588,254,0,2,4,2,67570,26990,5426,35831,0
25,397,219,78,157,11,5,46,230,3,24,20,34,27,54,114,256,2,545,30,0,2,1,3,67570,26991,5426,35832,0
25,397,108,64,79,9,0,20,117,5,15,11,19,20,30,70,129,3,410,22,0,2,1,3,67570,26991,5426,35833,0
30,1268,442,244,305,14,16,103,456,11,68,45,75,79,120,452,756,6,4588,254,0,2,5,3,67570,26993,5426,35834,0
53,1164,91,45,69,0,3,18,91,3,9,6,10,12,16,33,57,1,95,5,0,2,21,0,67570,26995,5426,35835,0
53,1164,367,234,237,17,34,68,384,16,55,34,61,71,95,381,584,8,5183,287,0,2,21,0,67570,26996,5426,35836,0
30,1268,442,244,305,14,16,103,456,11,68,45,75,79,120,452,756,6,4588,254,0,2,7,1,67570,26998,5426,35837,0
224,4857,1943,715,1694,26,18,214,1969,12,185,120,237,197,357,1436,2721,7,20915,1161,0,2,13,13,67570,27000,5426,35838,0
224,4857,1168,838,957,57,25,144,1225,19,348,224,416,367,640,3018,5452,11,61921,3440,1,2,13,13,67580,27002,5426,35839,0
41,843,386,256,301,16,9,68,402,4,59,35,69,63,104,355,621,2,1453,80,0,2,2,0,67580,27002,5426,35840,1
41,843,264,131,164,11,41,46,275,6,38,22,40,44,62,214,338,3,1068,59,0,2,2,0,67590,27002,5427,35841,1
43,1873,386,256,301,16,9,68,402,4,59,35,69,63,104,355,621,2,1453,80,0,2,6,0,67590,27002,5427,35842,1
1,86,42,7,35,4,0,5,46,1,2,1,2,3,3,2,4,0,2,0,0,2,1,1,67590,27002,5427,35843,0
1,86,11,6,10,0,0,1,11,2,4,2,4,6,6,10,15,1,15,0,0,2,1,1,67590,27002,5427,35844,0
224,4857,1943,715,1694,26,18,214,1969,12,185,120,237,197,357,1436,2721,7,20915,1161,0,2,13,13,67590,27004,5427,35845,0
224,4857,1168,838,957,57,25,144,1225,19,348,224,416,367,640,3018,5452,11,61921,3440,1,2,13,13,67600,27006,5427,35846,0
43,898,386,256,301,16,9,68,402,4,59,35,69,63,104,355,621,2,1453,80,0,2,12,1,67600,27006,5427,35847,1
43,898,264,131,164,11,41,46,275,6,38,22,40,44,62,214,338,3,1068,59,0,2,12,1,67610,27006,5428,35848,1
1,86,42,7,35,4,0,5,46,1,2,1,2,3,3,2,4,0,2,0,0,2,1,1,67610,27006,5428,35849,0
1,86,11,6,10,0,0,1,11,2,4,2,4,6,6,10,15,1,15,0,0,2,1,1,67610,27006,5428,35850,0
98,2666,1523,757,1297,19,12,193,1542,12,193,117,230,205,347,1508,2664,7,19053,1058,0,2,5,3,67620,27008,5428,35851,0
98,2666,701,378,504,33,58,109,734,13,110,68,126,123,194,794,1346,7,10027,557,0,2,5,3,67620,27009,5429,35852,0
88,2299,773,422,505,30,103,129,803,14,77,46,83,91,129,535,839,7,6334,351,0,2,1,1,67630,27010,5430,35853,0
53,1164,91,45,69,0,3,18,91,3,9,6,10,12,16,33,57,1,95,5,0,2,21,0,67630,27012,5430,35854,0
53,1164,367,234,237,17,34,68,384,16,55,34,61,71,95,381,584,8,5183,287,0,2,21,0,67630,27013,5430,35855,0
96,4691,1523,757,1297,19,12,193,1542,12,193,117,230,205,347,1508,2664,7,19053,1058,0,2,16,0,67640,27015,5430,35856,0
30,1268,442,244,305,14,16,103,456,11,68,45,75,79,120,452,756,6,4588,254,0,2,7,1,67640,27017,5430,35857,0
68,1356,207,111,150,11,0,50,218,5,26,19,36,31,55,133,272,3,943,52,0,2,10,2,67640,27017,5430,35858,0
68,1356,410,198,237,31,55,97,441,11,63,38,72,74,110,414,683,6,4293,238,0,2,10,2,67650,27018,5431,35859,0
75,3898,1296,573,1062,40,33,157,1336,8,201,118,231,209,349,1561,2689,4,12365,686,0,2,20,0,67650,27018,5431,35860,0
43,898,386,256,301,16,9,68,402,4,59,35,69,63,104,355,621,2,1453,80,0,2,14,1,67650,27018,5431,35861,0
43,898,264,131,164,11,41,46,275,6,38,22,40,44,62,214,338,3,1068,59,0,2,14,1,67660,27018,5432,35862,0
43,1873,386,256,301,16,9,68,402,4,59,35,69,63,104,355,621,2,1453,80,0,2,6,0,67660,27018,5432,35863,0
29,724,601,196,481,2,23,85,603,8,63,36,72,71,108,400,664,4,3036,168,0,2,1,1,67660,27018,5432,35864,0
29,724,156,79,106,5,16,28,161,5,14,8,15,19,23,64,97,2,261,14,0,2,1,1,67660,27018,5432,35865,0
41,1472,601,196,481,2,23,85,603,8,63,36,72,71,108,400,664,4,3036,168,0,2,29,0,67660,27018,5432,35866,0
68,1356,207,111,150,11,0,50,218,5,26,19,36,31,55,133,272,3,943,52,0,2,10,2,67660,27018,5432,35867,0
68,1356,410,198,237,31,55,97,441,11,63,38,72,74,110,414,683,6,4293,238,0,2,10,2,67670,27019,5433,35868,0
75,3898,1296,573,1062,40,33,157,1336,8,201,118,231,209,349,1561,2689,4,12365,686,0,2,20,0,67670,27019,5433,35869,0
29,724,601,196,481,2,23,85,603,8,63,36,72,71,108,400,664,4,3036,168,0,2,1,1,67670,27019,5433,35870,0
29,724,156,79,106,5,16,28,161,5,14,8,15,19,23,64,97,2,261,14,0,2,1,1,67670,27019,5433,35871,0
41,1472,601,196,481,2,23,85,603,8,63,36,72,71,108,400,664,4,3036,168,0,2,29,0,67670,27019,5433,35872,0
94,2434,773,422,505,30,103,129,803,14,77,46,83,91,129,535,839,7,6334,351,0,2,23,0,67680,27020,5434,35873,0
34,2285,1157,318,931,29,22,177,1186,6,104,63,125,110,188,712,1274,3,4596,255,0,2,36,0,67680,27020,5434,35874,0
1,86,42,7,35,4,0,5,46,1,2,1,2,3,3,2,4,0,2,0,0,2,1,1,67680,27020,5434,35875,0
1,86,11,6,10,0,0,1,11,2,4,2,4,6,6,10,15,1,15,0,0,2,1,1,67680,27020,5434,35876,0
180,5397,1660,832,1314,41,38,274,1701,20,312,209,395,332,604,2671,5058,12,64042,3557,1,2,1,1,67680,27022,5435,35878,0
180,5397,1057,646,719,113,100,145,1170,18,215,134,248,233,382,1740,3004,10,31186,1732,1,2,1,1,67690,27023,5436,35879,0
34,986,339,213,244,17,9,65,356,10,42,26,48,52,74,259,421,5,2410,133,0,2,6,5,67700,27023,5436,35880,0
256,5938,4293,999,3693,19,54,507,4312,9,155,88,170,164,258,1156,1898,4,9368,520,0,2,2,3,67700,27025,5436,35881,0
256,5938,1482,859,1002,125,135,219,1607,16,219,134,251,235,385,1766,3032,9,27804,1544,1,2,2,3,67710,27026,5436,35882,0
98,2666,1523,757,1297,19,12,193,1542,12,193,117,230,205,347,1508,2664,7,19053,1058,0,2,5,3,67720,27028,5436,35883,0
98,2666,701,378,504,33,58,109,734,13,110,68,126,123,194,794,1346,7,10027,557,0,2,5,3,67720,27029,5437,35884,0
88,2299,773,422,505,30,103,129,803,14,77,46,83,91,129,535,839,7,6334,351,0,2,1,1,67730,27030,5438,35885,0
142,3309,77,34,69,0,0,8,77,3,24,16,29,27,45,114,213,1,387,21,0,2,2,5,67730,27030,5438,35886,0
142,3309,712,438,573,51,9,84,763,14,102,71,128,116,199,733,1364,8,11988,666,0,2,2,5,67740,27031,5438,35887,0
53,1164,91,45,69,0,3,18,91,3,9,6,10,12,16,33,57,1,95,5,0,2,21,0,67740,27033,5438,35888,0
53,1164,367,234,237,17,34,68,384,16,55,34,61,71,95,381,584,8,5183,287,0,2,21,0,67740,27034,5438,35889,0
244,5826,722,423,573,19,0,135,741,12,172,101,199,184,300,1320,2257,6,15668,870,0,2,2,2,67740,27036,5438,35891,0
244,5826,1508,847,911,44,250,301,1552,14,148,88,169,162,257,1120,1886,7,15077,837,0,2,2,2,67740,27037,5439,35892,0
92,1957,1043,504,840,53,9,147,1096,9,180,112,198,189,310,1377,2344,4,11604,644,0,2,5,0,67740,27039,5439,35893,0
92,1957,383,288,292,26,6,62,409,11,65,38,67,76,105,429,656,5,3719,206,0,2,5,0,67740,27040,5439,35894,0
224,4857,1943,715,1694,26,18,214,1969,12,185,120,237,197,357,1436,2721,7,20915,1161,0,2,16,14,67740,27042,5439,35895,0
224,4857,1168,838,957,57,25,144,1225,19,348,224,416,367,640,3018,5452,11,61921,3440,1,2,16,14,67750,27044,5439,35896,0
99,4081,1289,550,1043,56,32,155,1345,10,167,93,185,177,278,1266,2075,5,11498,638,0,2,45,38,67750,27046,5440,35897,0
179,7977,139,89,101,2,0,35,141,7,54,34,62,61,96,330,569,4,2287,127,0,2,6,0,67750,27046,5440,35898,0
179,7977,7,5,5,0,0,2,7,1,2,1,2,3,3,2,4,0,2,0,0,2,6,0,67750,27046,5440,35899,0
96,4691,1523,757,1297,19,12,193,1542,12,193,117,230,205,347,1508,2664,7,19053,1058,0,2,16,0,67760,27048,5440,35900,0
64,2851,1293,570,1093,25,15,163,1318,10,195,123,241,205,364,1516,2795,6,17273,959,0,2,32,11,67770,27050,5440,35901,0
99,5070,1943,715,1694,26,18,214,1969,12,185,120,237,197,357,1436,2721,7,20915,1161,0,2,2,2,67770,27052,5440,35902,0
30,1268,442,244,305,14,16,103,456,11,68,45,75,79,120,452,756,6,4588,254,0,2,7,1,67770,27054,5440,35903,0
256,5953,4293,999,3693,19,54,507,4312,9,155,88,170,164,258,1156,1898,4,9368,520,0,2,10,5,67770,27056,5440,35904,0
256,5953,1482,859,1002,125,135,219,1607,16,219,134,251,235,385,1766,3032,9,27804,1544,1,2,10,5,67780,27057,5440,35905,0
3,33,15,9,9,0,0,6,15,0,0,0,0,0,0,0,0,0,0,0,0,0,15,0,67780,27057,5440,35906,0
180,8007,139,89,101,2,0,35,141,7,54,34,62,61,96,330,569,4,2287,127,0,2,7,0,67780,27057,5440,35907,0
180,8007,7,5,5,0,0,2,7,1,2,1,2,3,3,2,4,0,2,0,0,2,7,0,67780,27057,5440,35908,0
94,2434,773,422,505,30,103,129,803,14,77,46,83,91,129,535,839,7,6334,351,0,2,23,0,67790,27058,5441,35909,0
34,2285,1157,318,931,29,22,177,1186,6,104,63,125,110,188,712,1274,3,4596,255,0,2,36,0,67790,27058,5441,35910,0
258,5960,4293,999,3693,19,54,507,4312,9,155,88,170,164,258,1156,1898,4,9368,520,0,2,4,1,67790,27060,5441,35912,1
258,5960,1482,859,1002,125,135,219,1607,16,219,134,251,235,385,1766,3032,9,27804,1544,1,2,4,1,67800,27061,5441,35913,1
25,1183,75,38,59,1,3,12,76,2,4,2,4,6,6,10,15,1,15,0,0,2,12,0,67800,27061,5441,35914,1
2,18,10,6,6,0,0,4,10,0,0,0,0,0,0,0,0,0,0,0,0,0,10,0,67800,27061,5441,35915,1
256,5953,4293,999,3693,19,54,507,4312,9,155,88,170,164,258,1156,1898,4,9368,520,0,2,10,5,67800,27063,5441,35916,0
256,5953,1482,859,1002,125,135,219,1607,16,219,134,251,235,385,1766,3032,9,27804,1544,1,2,10,5,67810,27064,5441,35917,0
3,33,15,9,9,0,0,6,15,0,0,0,0,0,0,0,0,0,0,0,0,0,15,0,67810,27064,5441,35918,0
180,8007,139,89,101,2,0,35,141,7,54,34,62,61,96,330,569,4,2287,127,0,2,7,0,67810,27064,5441,35919,0
180,8007,7,5,5,0,0,2,7,1,2,1,2,3,3,2,4,0,2,0,0,2,7,0,67810,27064,5441,35920,0
258,5960,4293,999,3693,19,54,507,4312,9,155,88,170,164,258,1156,1898,4,9368,520,0,2,4,1,67810,27066,5441,35922,0
258,5960,1482,859,1002,125,135,219,1607,16,219,134,251,235,385,1766,3032,9,27804,1544,1,2,4,1,67820,27067,5441,35923,0
25,1183,75,38,59,1,3,12,76,2,4,2,4,6,6,10,15,1,15,0,0,2,12,0,67820,27067,5441,35924,0
2,18,10,6,6,0,0,4,10,0,0,0,0,0,0,0,0,0,0,0,0,0,10,0,67820,27067,5441,35925,0
180,5397,1660,832,1314,41,38,274,1701,20,312,209,395,332,604,2671,5058,12,64042,3557,1,2,1,2,67820,27069,5442,35927,0
180,5397,1057,646,719,113,100,145,1170,18,215,134,248,233,382,1740,3004,10,31186,1732,1,2,1,2,67830,27070,5443,35928,0
53,1166,91,45,69,0,3,18,91,3,9,6,10,12,16,33,57,1,95,5,0,2,2,2,67830,27072,5443,35929,0
53,1166,367,234,237,17,34,68,384,16,55,34,61,71,95,381,584,8,5183,287,0,2,2,2,67830,27073,5443,35930,0
180,5397,1660,832,1314,41,38,274,1701,20,312,209,395,332,604,2671,5058,12,64042,3557,1,2,1,2,67830,27075,5444,35932,0
180,5397,1057,646,719,113,100,145,1170,18,215,134,248,233,382,1740,3004,10,31186,1732,1,2,1,2,67840,27076,5445,35933,0
53,1166,91,45,69,0,3,18,91,3,9,6,10,12,16,33,57,1,95,5,0,2,2,2,67840,27078,5445,35934,0
53,1166,367,234,237,17,34,68,384,16,55,34,61,71,95,381,584,8,5183,287,0,2,2,2,67840,27079,5445,35935,0
218,4720,2,2,2,0,0,0,2,0,0,0,0,0,0,0,0,0,0,0,0,2,1,1,67840,27079,5445,35935,0
218,4720,99,48,90,1,3,5,100,0,0,0,0,0,0,0,0,0,0,0,0,2,1,1,67840,27080,5445,35936,0
218,4720,8,5,5,2,0,1,10,0,0,0,0,0,0,0,0,0,0,0,0,2,1,1,67840,27080,5445,35937,0
218,4720,1217,716,841,84,126,174,1301,14,185,118,215,199,333,1446,2542,8,20687,1149,0,2,1,1,67850,27082,5445,35938,0
218,4720,160,89,115,0,13,31,160,7,15,11,17,22,28,78,124,3,495,27,0,2,1,1,67850,27082,5445,35939,0
218,4720,10,10,9,9,0,0,19,0,0,0,0,0,0,0,0,0,0,0,0,2,1,1,67850,27082,5446,35940,0
218,4720,173,84,99,8,29,36,181,5,12,7,13,17,20,54,81,2,221,12,0,2,1,1,67850,27083,5446,35941,0
218,4720,3,1,1,3,0,0,6,0,0,0,0,0,0,0,0,0,0,0,0,2,1,1,67850,27083,5446,35942,0
40,2509,652,304,544,16,6,88,668,6,89,51,101,95,152,591,998,3,3399,188,0,2,7,1,67850,27084,5446,35943,0
52,1137,91,45,69,0,3,18,91,3,9,6,10,12,16,33,57,1,95,5,0,2,2,10,67850,27086,5446,35944,0
52,1137,367,234,237,17,34,68,384,16,55,34,61,71,95,381,584,8,5183,287,0,2,2,10,67850,27087,5446,35945,0
52,1137,91,45,69,0,3,18,91,3,9,6,10,12,16,33,57,1,95,5,0,2,2,10,67850,27089,5446,35946,0
52,1137,367,234,237,17,34,68,384,16,55,34,61,71,95,381,584,8,5183,287,0,2,2,10,67850,27090,5446,35947,0
218,4720,2,2,2,0,0,0,2,0,0,0,0,0,0,0,0,0,0,0,0,2,1,1,67850,27090,5446,35947,0
218,4720,99,48,90,1,3,5,100,0,0,0,0,0,0,0,0,0,0,0,0,2,1,1,67850,27091,5446,35948,0
218,4720,8,5,5,2,0,1,10,0,0,0,0,0,0,0,0,0,0,0,0,2,1,1,67850,27091,5446,35949,0
218,4720,1217,716,841,84,126,174,1301,14,185,118,215,199,333,1446,2542,8,20687,1149,0,2,1,1,67860,27093,5446,35950,0
218,4720,160,89,115,0,13,31,160,7,15,11,17,22,28,78,124,3,495,27,0,2,1,1,67860,27093,5446,35951,0
218,4720,10,10,9,9,0,0,19,0,0,0,0,0,0,0,0,0,0,0,0,2,1,1,67860,27093,5447,35952,0
218,4720,173,84,99,8,29,36,181,5,12,7,13,17,20,54,81,2,221,12,0,2,1,1,67860,27094,5447,35953,0
218,4720,3,1,1,3,0,0,6,0,0,0,0,0,0,0,0,0,0,0,0,2,1,1,67860,27094,5447,35954,0
40,2509,652,304,544,16,6,88,668,6,89,51,101,95,152,591,998,3,3399,188,0,2,7,1,67860,27095,5447,35955,0
227,4920,1943,715,1694,26,18,214,1969,12,185,120,237,197,357,1436,2721,7,20915,1161,0,2,13,2,67860,27097,5447,35956,1
227,4920,1168,838,957,57,25,144,1225,19,348,224,416,367,640,3018,5452,11,61921,3440,1,2,13,2,67870,27099,5447,35957,1
218,4727,2,2,2,0,0,0,2,0,0,0,0,0,0,0,0,0,0,0,0,2,2,0,67870,27099,5447,35957,0
218,4727,99,48,90,1,3,5,100,0,0,0,0,0,0,0,0,0,0,0,0,2,2,0,67870,27100,5447,35958,0
218,4727,8,5,5,2,0,1,10,0,0,0,0,0,0,0,0,0,0,0,0,2,2,0,67870,27100,5447,35959,0
218,4727,1217,716,841,84,126,174,1301,14,185,118,215,199,333,1446,2542,8,20687,1149,0,2,2,0,67880,27102,5447,35960,0
218,4727,160,89,115,0,13,31,160,7,15,11,17,22,28,78,124,3,495,27,0,2,2,0,67880,27102,5447,35961,0
218,4727,10,10,9,9,0,0,19,0,0,0,0,0,0,0,0,0,0,0,0,2,2,0,67880,27102,5448,35962,0
218,4727,173,84,99,8,29,36,181,5,12,7,13,17,20,54,81,2,221,12,0,2,2,0,67880,27103,5448,35963,0
218,4727,3,1,1,3,0,0,6,0,0,0,0,0,0,0,0,0,0,0,0,2,2,0,67880,27103,5448,35964,0
227,4920,1943,715,1694,26,18,214,1969,12,185,120,237,197,357,1436,2721,7,20915,1161,0,2,13,2,67880,27105,5448,35965,0
227,4920,1168,838,957,57,25,144,1225,19,348,224,416,367,640,3018,5452,11,61921,3440,1,2,13,2,67890,27107,5448,35966,0
180,5397,1660,832,1314,41,38,274,1701,20,312,209,395,332,604,2671,5058,12,64042,3557,1,2,1,2,67890,27109,5449,35968,0
180,5397,1057,646,719,113,100,145,1170,18,215,134,248,233,382,1740,3004,10,31186,1732,1,2,1,2,67900,27110,5450,35969,0
68,1356,207,111,150,11,0,50,218,5,26,19,36,31,55,133,272,3,943,52,0,2,10,2,67900,27110,5450,35970,0
68,1356,410,198,237,31,55,97,441,11,63,38,72,74,110,414,683,6,4293,238,0,2,10,2,67910,27111,5451,35971,0
218,4720,2,2,2,0,0,0,2,0,0,0,0,0,0,0,0,0,0,0,0,2,1,1,67910,27111,5451,35971,0
218,4720,99,48,90,1,3,5,100,0,0,0,0,0,0,0,0,0,0,0,0,2,1,1,67910,27112,5451,35972,0
218,4720,8,5,5,2,0,1,10,0,0,0,0,0,0,0,0,0,0,0,0,2,1,1,67910,27112,5451,35973,0
218,4720,1217,716,841,84,126,174,1301,14,185,118,215,199,333,1446,2542,8,20687,1149,0,2,1,1,67920,27114,5451,35974,0
218,4720,160,89,115,0,13,31,160,7,15,11,17,22,28,78,124,3,495,27,0,2,1,1,67920,27114,5451,35975,0
218,4720,10,10,9,9,0,0,19,0,0,0,0,0,0,0,0,0,0,0,0,2,1,1,67920,27114,5452,35976,0
218,4720,173,84,99,8,29,36,181,5,12,7,13,17,20,54,81,2,221,12,0,2,1,1,67920,27115,5452,35977,0
218,4720,3,1,1,3,0,0,6,0,0,0,0,0,0,0,0,0,0,0,0,2,1,1,67920,27115,5452,35978,0
258,5975,4293,999,3693,19,54,507,4312,9,155,88,170,164,258,1156,1898,4,9368,520,0,2,10,5,67920,27117,5452,35979,0
258,5975,1482,859,1002,125,135,219,1607,16,219,134,251,235,385,1766,3032,9,27804,1544,1,2,10,5,67930,27118,5452,35980,0
94,2434,773,422,505,30,103,129,803,14,77,46,83,91,129,535,839,7,6334,351,0,2,23,0,67940,27119,5453,35981,0
52,1139,91,45,69,0,3,18,91,3,9,6,10,12,16,33,57,1,95,5,0,2,2,2,67940,27121,5453,35982,0
52,1139,367,234,237,17,34,68,384,16,55,34,61,71,95,381,584,8,5183,287,0,2,2,2,67940,27122,5453,35983,0
43,898,386,256,301,16,9,68,402,4,59,35,69,63,104,355,621,2,1453,80,0,2,14,1,67940,27122,5453,35984,0
43,898,264,131,164,11,41,46,275,6,38,22,40,44,62,214,338,3,1068,59,0,2,14,1,67950,27122,5454,35985,0
29,724,601,196,481,2,23,85,603,8,63,36,72,71,108,400,664,4,3036,168,0,2,1,1,67950,27122,5454,35986,0
29,724,156,79,106,5,16,28,161,5,14,8,15,19,23,64,97,2,261,14,0,2,1,1,67950,27122,5454,35987,0
3,33,15,9,9,0,0,6,15,0,0,0,0,0,0,0,0,0,0,0,0,0,15,0,67950,27122,5454,35988,0
34,2285,1157,318,931,29,22,177,1186,6,104,63,125,110,188,712,1274,3,4596,255,0,2,36,0,67950,27122,5454,35989,0
180,8007,139,89,101,2,0,35,141,7,54,34,62,61,96,330,569,4,2287,127,0,2,7,0,67950,27122,5454,35990,0
180,8007,7,5,5,0,0,2,7,1,2,1,2,3,3,2,4,0,2,0,0,2,7,0,67950,27122,5454,35991,0
75,3898,1296,573,1062,40,33,157,1336,8,201,118,231,209,349,1561,2689,4,12365,686,0,2,20,0,67950,27122,5454,35992,0
40,2509,652,304,544,16,6,88,668,6,89,51,101,95,152,591,998,3,3399,188,0,2,7,1,67950,27123,5454,35993,0
43,1873,386,256,301,16,9,68,402,4,59,35,69,63,104,355,621,2,1453,80,0,2,6,0,67950,27123,5454,35994,0
41,1472,601,196,481,2,23,85,603,8,63,36,72,71,108,400,664,4,3036,168,0,2,29,0,67950,27123,5454,35995,0
31,934,339,213,244,17,9,65,356,10,42,26,48,52,74,259,421,5,2410,133,0,2,0,15,67960,27123,5454,35996,0
64,2859,1293,570,1093,25,15,163,1318,10,195,123,241,205,364,1516,2795,6,17273,959,0,2,7,1,67970,27125,5454,35997,0
180,5397,1660,832,1314,41,38,274,1701,20,312,209,395,332,604,2671,5058,12,64042,3557,1,2,1,2,67970,27127,5455,35999,0
180,5397,1057,646,719,113,100,145,1170,18,215,134,248,233,382,1740,3004,10,31186,1732,1,2,1,2,67980,27128,5456,36000,0
68,1356,207,111,150,11,0,50,218,5,26,19,36,31,55,133,272,3,943,52,0,2,10,2,67980,27128,5456,36001,0
68,1356,410,198,237,31,55,97,441,11,63,38,72,74,110,414,683,6,4293,238,0,2,10,2,67990,27129,5457,36002,0
218,4720,2,2,2,0,0,0,2,0,0,0,0,0,0,0,0,0,0,0,0,2,1,1,67990,27129,5457,36002,0
218,4720,99,48,90,1,3,5,100,0,0,0,0,0,0,0,0,0,0,0,0,2,1,1,67990,27130,5457,36003,0
218,4720,8,5,5,2,0,1,10,0,0,0,0,0,0,0,0,0,0,0,0,2,1,1,67990,27130,5457,36004,0
218,4720,1217,716,841,84,126,174,1301,14,185,118,215,199,333,1446,2542,8,20687,1149,0,2,1,1,68000,27132,5457,36005,0
218,4720,160,89,115,0,13,31,160,7,15,11,17,22,28,78,124,3,495,27,0,2,1,1,68000,27132,5457,36006,0
218,4720,10,10,9,9,0,0,19,0,0,0,0,0,0,0,0,0,0,0,0,2,1,1,68000,27132,5458,36007,0
218,4720,173,84,99,8,29,36,181,5,12,7,13,17,20,54,81,2,221,12,0,2,1,1,68000,27133,5458,36008,0
218,4720,3,1,1,3,0,0,6,0,0,0,0,0,0,0,0,0,0,0,0,2,1,1,68000,27133,5458,36009,0
258,5975,4293,999,3693,19,54,507,4312,9,155,88,170,164,258,1156,1898,4,9368,520,0,2,10,5,68000,27135,5458,36010,0
258,5975,1482,859,1002,125,135,219,1607,16,219,134,251,235,385,1766,3032,9,27804,1544,1,2,10,5,68010,27136,5458,36011,0
94,2434,773,422,505,30,103,129,803,14,77,46,83,91,129,535,839,7,6334,351,0,2,23,0,68020,27137,5459,36012,0
52,1139,91,45,69,0,3,18,91,3,9,6,10,12,16,33,57,1,95,5,0,2,2,2,68020,27139,5459,36013,0
52,1139,367,234,237,17,34,68,384,16,55,34,61,71,95,381,584,8,5183,287,0,2,2,2,68020,27140,5459,36014,0
43,898,386,256,301,16,9,68,402,4,59,35,69,63,104,355,621,2,1453,80,0,2,14,1,68020,27140,5459,36015,0
43,898,264,131,164,11,41,46,275,6,38,22,40,44,62,214,338,3,1068,59,0,2,14,1,68030,27140,5460,36016,0
29,724,601,196,481,2,23,85,603,8,63,36,72,71,108,400,664,4,3036,168,0,2,1,1,68030,27140,5460,36017,0
29,724,156,79,106,5,16,28,161,5,14,8,15,19,23,64,97,2,261,14,0,2,1,1,68030,27140,5460,36018,0
3,33,15,9,9,0,0,6,15,0,0,0,0,0,0,0,0,0,0,0,0,0,15,0,68030,27140,5460,36019,0
34,2285,1157,318,931,29,22,177,1186,6,104,63,125,110,188,712,1274,3,4596,255,0,2,36,0,68030,27140,5460,36020,0
180,8007,139,89,101,2,0,35,141,7,54,34,62,61,96,330,569,4,2287,127,0,2,7,0,68030,27140,5460,36021,0
180,8007,7,5,5,0,0,2,7,1,2,1,2,3,3,2,4,0,2,0,0,2,7,0,68030,27140,5460,36022,0
75,3898,1296,573,1062,40,33,157,1336,8,201,118,231,209,349,1561,2689,4,12365,686,0,2,20,0,68030,27140,5460,36023,0
40,2509,652,304,544,16,6,88,668,6,89,51,101,95,152,591,998,3,3399,188,0,2,7,1,68030,27141,5460,36024,0
43,1873,386,256,301,16,9,68,402,4,59,35,69,63,104,355,621,2,1453,80,0,2,6,0,68030,27141,5460,36025,0
41,1472,601,196,481,2,23,85,603,8,63,36,72,71,108,400,664,4,3036,168,0,2,29,0,68030,27141,5460,36026,0
31,932,339,213,244,17,9,65,356,10,42,26,48,52,74,259,421,5,2410,133,0,2,0,1,68040,27141,5460,36027,0
31,932,339,213,244,17,9,65,356,10,42,26,48,52,74,259,421,5,2410,133,0,2,0,1,68050,27141,5460,36028,0
223,4835,1943,715,1694,26,18,214,1969,12,185,120,237,197,357,1436,2721,7,20915,1161,0,2,2,3,68050,27143,5460,36029,0
223,4835,1168,838,957,57,25,144,1225,19,348,224,416,367,640,3018,5452,11,61921,3440,1,2,2,3,68060,27145,5460,36030,0
41,1474,601,196,481,2,23,85,603,8,63,36,72,71,108,400,664,4,3036,168,0,2,3,2,68060,27145,5460,36031,0
94,2434,773,422,505,30,103,129,803,14,77,46,83,91,129,535,839,7,6334,351,0,2,2,2,68070,27146,5461,36032,0
218,4736,2,2,2,0,0,0,2,0,0,0,0,0,0,0,0,0,0,0,0,2,4,1,68070,27146,5461,36032,0
218,4736,99,48,90,1,3,5,100,0,0,0,0,0,0,0,0,0,0,0,0,2,4,1,68070,27147,5461,36033,0
218,4736,8,5,5,2,0,1,10,0,0,0,0,0,0,0,0,0,0,0,0,2,4,1,68070,27147,5461,36034,0
218,4736,1217,716,841,84,126,174,1301,14,185,118,215,199,333,1446,2542,8,20687,1149,0,2,4,1,68080,27149,5461,36035,0
218,4736,160,89,115,0,13,31,160,7,15,11,17,22,28,78,124,3,495,27,0,2,4,1,68080,27149,5461,36036,0
218,4736,10,10,9,9,0,0,19,0,0,0,0,0,0,0,0,0,0,0,0,2,4,1,68080,27149,5462,36037,0
218,4736,173,84,99,8,29,36,181,5,12,7,13,17,20,54,81,2,221,12,0,2,4,1,68080,27150,5462,36038,0
218,4736,3,1,1,3,0,0,6,0,0,0,0,0,0,0,0,0,0,0,0,2,4,1,68080,27150,5462,36039,0
94,2434,773,422,505,30,103,129,803,14,77,46,83,91,129,535,839,7,6334,351,0,2,2,2,68090,27151,5463,36040,0
218,4740,2,2,2,0,0,0,2,0,0,0,0,0,0,0,0,0,0,0,0,2,5,0,68090,27151,5463,36040,0
218,4740,99,48,90,1,3,5,100,0,0,0,0,0,0,0,0,0,0,0,0,2,5,0,68090,27152,5463,36041,0
218,4740,8,5,5,2,0,1,10,0,0,0,0,0,0,0,0,0,0,0,0,2,5,0,68090,27152,5463,36042,0
218,4740,1217,716,841,84,126,174,1301,14,185,118,215,199,333,1446,2542,8,20687,1149,0,2,5,0,68100,27154,5463,36043,0
218,4740,160,89,115,0,13,31,160,7,15,11,17,22,28,78,124,3,495,27,0,2,5,0,68100,27154,5463,36044,0
218,4740,10,10,9,9,0,0,19,0,0,0,0,0,0,0,0,0,0,0,0,2,5,0,68100,27154,5464,36045,0
218,4740,173,84,99,8,29,36,181,5,12,7,13,17,20,54,81,2,221,12,0,2,5,0,68100,27155,5464,36046,0
218,4740,3,1,1,3,0,0,6,0,0,0,0,0,0,0,0,0,0,0,0,2,5,0,68100,27155,5464,36047,0
223,4835,1943,715,1694,26,18,214,1969,12,185,120,237,197,357,1436,2721,7,20915,1161,0,2,2,3,68100,27157,5464,36048,0
223,4835,1168,838,957,57,25,144,1225,19,348,224,416,367,640,3018,5452,11,61921,3440,1,2,2,3,68110,27159,5464,36049,0
41,1474,601,196,481,2,23,85,603,8,63,36,72,71,108,400,664,4,3036,168,0,2,3,2,68110,27159,5464,36050,0
2,40,9,6,6,0,0,3,9,0,0,0,0,0,0,0,0,0,0,0,0,2,1,0,68110,27159,5464,36052,1
2,40,13,9,8,0,0,4,13,0,0,0,0,0,0,0,0,0,0,0,0,2,1,0,68110,27159,5464,36053,1
1,319,382,65,130,157,2,92,539,4,10,5,10,14,15,41,57,2,114,6,0,2,1,3,68110,27160,5465,36055,1
60,1078,282,196,195,3,0,86,285,8,130,71,141,138,212,936,1507,4,6538,363,0,2,3,2,68110,27160,5466,36056,1
4,77,127,75,83,2,11,30,129,4,14,7,14,18,21,61,87,2,175,9,0,2,2,1,68110,27160,5466,36057,1
4,77,652,304,544,16,6,88,668,6,89,51,101,95,152,591,998,3,3399,188,0,2,2,1,68110,27161,5466,36058,1
4,77,2,2,2,0,0,0,2,0,0,0,0,0,0,0,0,0,0,0,0,2,2,1,68110,27161,5466,36058,1
4,77,8,5,5,0,0,3,8,0,0,0,0,0,0,0,0,0,0,0,0,2,2,1,68110,27161,5466,36059,1
4,77,2,2,2,0,0,0,2,0,0,0,0,0,0,0,0,0,0,0,0,2,2,1,68110,27161,5466,36059,1
4,77,14,8,8,0,0,6,14,0,0,0,0,0,0,0,0,0,0,0,0,2,2,1,68110,27161,5466,36060,1
4,77,6,4,4,0,0,2,6,0,0,0,0,0,0,0,0,0,0,0,0,2,2,1,68110,27161,5466,36061,1
4,77,6,4,4,0,0,2,6,1,2,1,2,3,3,2,4,0,2,0,0,2,2,1,68110,27161,5466,36062,1
4,77,6,4,4,0,0,2,6,0,0,0,0,0,0,0,0,0,0,0,0,2,2,1,68110,27161,5466,36063,1
4,77,7,5,5,0,0,2,7,0,0,0,0,0,0,0,0,0,0,0,0,2,2,1,68110,27161,5466,36064,1
4,77,6,4,4,0,0,2,6,0,0,0,0,0,0,0,0,0,0,0,0,2,2,1,68110,27161,5466,36065,1
4,77,10,6,6,0,0,4,10,0,0,0,0,0,0,0,0,0,0,0,0,2,2,1,68110,27161,5466,36066,1
4,77,1,1,1,0,0,0,1,0,0,0,0,0,0,0,0,0,0,0,0,2,2,1,68110,27161,5466,36066,1
4,77,14,10,10,0,0,4,14,1,1,1,1,2,2,0,2,0,1,0,0,2,2,1,68110,27161,5466,36067,1
4,77,46,26,30,3,0,12,49,3,6,3,6,9,9,20,28,1,42,2,0,2,2,1,68120,27161,5466,36068,1
7,296,72,33,56,0,4,12,72,1,1,1,1,2,2,0,2,0,1,0,0,2,1,0,68120,27161,5466,36069,1
12,229,127,75,83,2,11,30,129,4,14,7,14,18,21,61,87,2,175,9,0,2,0,1,68120,27161,5466,36070,1
12,229,652,304,544,16,6,88,668,6,89,51,101,95,152,591,998,3,3399,188,0,2,0,1,68120,27162,5466,36071,1
12,229,2,2,2,0,0,0,2,0,0,0,0,0,0,0,0,0,0,0,0,2,0,1,68120,27162,5466,36071,1
12,229,8,5,5,0,0,3,8,0,0,0,0,0,0,0,0,0,0,0,0,2,0,1,68120,27162,5466,36072,1
12,229,2,2,2,0,0,0,2,0,0,0,0,0,0,0,0,0,0,0,0,2,0,1,68120,27162,5466,36072,1
12,229,14,8,8,0,0,6,14,0,0,0,0,0,0,0,0,0,0,0,0,2,0,1,68120,27162,5466,36073,1
12,229,6,4,4,0,0,2,6,0,0,0,0,0,0,0,0,0,0,0,0,2,0,1,68120,27162,5466,36074,1
12,229,6,4,4,0,0,2,6,1,2,1,2,3,3,2,4,0,2,0,0,2,0,1,68120,27162,5466,36075,1
12,229,6,4,4,0,0,2,6,0,0,0,0,0,0,0,0,0,0,0,0,2,0,1,68120,27162,5466,36076,1
12,229,7,5,5,0,0,2,7,0,0,0,0,0,0,0,0,0,0,0,0,2,0,1,68120,27162,5466,36077,1
12,229,6,4,4,0,0,2,6,0,0,0,0,0,0,0,0,0,0,0,0,2,0,1,68120,27162,5466,36078,1
12,229,10,6,6,0,0,4,10,0,0,0,0,0,0,0,0,0,0,0,0,2,0,1,68120,27162,5466,36079,1
12,229,1,1,1,0,0,0,1,0,0,0,0,0,0,0,0,0,0,0,0,2,0,1,68120,27162,5466,36079,1
12,229,14,10,10,0,0,4,14,1,1,1,1,2,2,0,2,0,1,0,0,2,0,1,68120,27162,5466,36080,1
12,229,46,26,30,3,0,12,49,3,6,3,6,9,9,20,28,1,42,2,0,2,0,1,68130,27162,5466,36081,1
6,71,127,75,83,2,11,30,129,4,14,7,14,18,21,61,87,2,175,9,0,2,1,0,68130,27162,5466,36082,1
6,71,652,304,544,16,6,88,668,6,89,51,101,95,152,591,998,3,3399,188,0,2,1,0,68130,27163,5466,36083,1
6,71,2,2,2,0,0,0,2,0,0,0,0,0,0,0,0,0,0,0,0,2,1,0,68130,27163,5466,36083,1
6,71,8,5,5,0,0,3,8,0,0,0,0,0,0,0,0,0,0,0,0,2,1,0,68130,27163,5466,36084,1
6,71,2,2,2,0,0,0,2,0,0,0,0,0,0,0,0,0,0,0,0,2,1,0,68130,27163,5466,36084,1
6,71,14,8,8,0,0,6,14,0,0,0,0,0,0,0,0,0,0,0,0,2,1,0,68130,27163,5466,36085,1
6,71,6,4,4,0,0,2,6,0,0,0,0,0,0,0,0,0,0,0,0,2,1,0,68130,27163,5466,36086,1
6,71,6,4,4,0,0,2,6,1,2,1,2,3,3,2,4,0,2,0,0,2,1,0,68130,27163,5466,36087,1
6,71,6,4,4,0,0,2,6,0,0,0,0,0,0,0,0,0,0,0,0,2,1,0,68130,27163,5466,36088,1
6,71,7,5,5,0,0,2,7,0,0,0,0,0,0,0,0,0,0,0,0,2,1,0,68130,27163,5466,36089,1
6,71,6,4,4,0,0,2,6,0,0,0,0,0,0,0,0,0,0,0,0,2,1,0,68130,27163,5466,36090,1
6,71,10,6,6,0,0,4,10,0,0,0,0,0,0,0,0,0,0,0,0,2,1,0,68130,27163,5466,36091,1
6,71,1,1,1,0,0,0,1,0,0,0,0,0,0,0,0,0,0,0,0,2,1,0,68130,27163,5466,36091,1
6,71,14,10,10,0,0,4,14,1,1,1,1,2,2,0,2,0,1,0,0,2,1,0,68130,27163,5466,36092,1
6,71,46,26,30,3,0,12,49,3,6,3,6,9,9,20,28,1,42,2,0,2,1,0,68140,27163,5466,36093,1
17,378,85,59,61,8,0,16,93,5,18,10,18,23,28,86,126,2,316,17,0,2,1,0,68140,27163,5466,36094,1
12,515,124,78,88,2,3,26,126,4,13,7,13,17,20,56,81,2,163,9,0,2,6,2,68140,27163,5466,36095,1
1,86,42,7,35,4,0,5,46,1,2,1,2,3,3,2,4,0,2,0,0,2,1,0,68140,27163,5466,36096,1
1,86,11,6,10,0,0,1,11,2,4,2,4,6,6,10,15,1,15,0,0,2,1,0,68140,27163,5466,36097,1
11,242,19,8,11,5,0,4,24,2,5,3,6,7,9,13,25,1,30,1,0,2,5,2,68140,27163,5466,36098,1
11,242,102,59,69,5,3,24,107,6,22,15,28,28,43,113,206,3,789,43,0,2,5,2,68140,27163,5466,36099,1
11,242,106,40,36,3,49,17,109,8,17,13,23,25,36,93,167,5,904,50,0,2,5,2,68140,27163,5466,36100,1
222,4859,182,127,129,0,0,53,182,5,39,21,42,44,63,217,343,2,926,51,0,2,15,7,68150,27167,5468,36108,1
222,4859,1165,710,800,67,119,181,1232,18,243,153,282,261,435,2000,3492,10,36473,2026,1,2,15,7,68160,27167,5469,36109,1
68,1565,773,419,590,28,0,166,801,10,204,113,217,214,330,1598,2554,5,13587,754,0,2,8,5,68160,27167,5470,36110,1
68,1565,421,273,302,44,34,57,465,17,81,59,107,98,166,583,1098,11,12329,684,0,2,8,5,68160,27167,5471,36111,1
26,529,2,2,2,0,0,0,2,0,0,0,0,0,0,0,0,0,0,0,0,2,6,2,68160,27167,5471,36111,1
26,529,99,48,90,1,3,5,100,0,0,0,0,0,0,0,0,0,0,0,0,2,6,2,68160,27168,5471,36112,1
26,529,8,5,5,2,0,1,10,0,0,0,0,0,0,0,0,0,0,0,0,2,6,2,68160,27168,5471,36113,1
26,529,1217,716,841,84,126,174,1301,14,185,118,215,199,333,1446,2542,8,20687,1149,0,2,6,2,68170,27170,5471,36114,1
26,529,160,89,115,0,13,31,160,7,15,11,17,22,28,78,124,3,495,27,0,2,6,2,68170,27170,5471,36115,1
26,529,10,10,9,9,0,0,19,0,0,0,0,0,0,0,0,0,0,0,0,2,6,2,68170,27170,5472,36116,1
26,529,173,84,99,8,29,36,181,5,12,7,13,17,20,54,81,2,221,12,0,2,6,2,68170,27171,5472,36117,1
26,529,3,1,1,3,0,0,6,0,0,0,0,0,0,0,0,0,0,0,0,2,6,2,68170,27171,5472,36118,1
180,5401,1660,832,1314,41,38,274,1701,20,312,209,395,332,604,2671,5058,12,64042,3557,1,2,7,4,68170,27173,5473,36120,1
180,5401,1057,646,719,113,100,145,1170,18,215,134,248,233,382,1740,3004,10,31186,1732,1,2,7,4,68180,27174,5474,36121,1
17,348,95,58,50,9,16,20,104,12,33,24,45,45,69,209,378,8,3100,172,0,2,4,1,68180,27174,5474,36122,1
89,1829,477,336,357,30,23,73,507,16,194,134,250,210,384,1538,2962,10,30538,1696,0,2,6,2,68190,27175,5474,36123,1
76,1743,996,429,845,24,10,117,1020,7,76,50,88,83,138,494,879,4,3565,198,0,2,9,5,68190,27177,5474,36124,1
76,1743,456,277,329,12,42,72,468,13,85,50,97,98,147,592,972,7,7212,400,0,2,9,5,68190,27177,5474,36125,1
154,3265,1513,682,1277,25,13,200,1538,11,199,116,219,210,335,1557,2584,6,15641,868,0,2,6,3,68190,27179,5474,36126,1
154,3265,819,519,539,24,98,155,843,15,96,57,106,111,163,690,1107,8,9171,509,0,2,6,3,68200,27181,5474,36127,1
68,1364,207,111,150,11,0,50,218,5,26,19,36,31,55,133,272,3,943,52,0,2,7,4,68200,27181,5474,36128,1
68,1364,410,198,237,31,55,97,441,11,63,38,72,74,110,414,683,6,4293,238,0,2,7,4,68210,27182,5475,36129,1
218,4738,2,2,2,0,0,0,2,0,0,0,0,0,0,0,0,0,0,0,0,2,20,13,68210,27182,5475,36129,1
218,4738,99,48,90,1,3,5,100,0,0,0,0,0,0,0,0,0,0,0,0,2,20,13,68210,27183,5475,36130,1
218,4738,8,5,5,2,0,1,10,0,0,0,0,0,0,0,0,0,0,0,0,2,20,13,68210,27183,5475,36131,1
218,4738,1217,716,841,84,126,174,1301,14,185,118,215,199,333,1446,2542,8,20687,1149,0,2,20,13,68220,27185,5475,36132,1
218,4738,160,89,115,0,13,31,160,7,15,11,17,22,28,78,124,3,495,27,0,2,20,13,68220,27185,5475,36133,1
218,4738,10,10,9,9,0,0,19,0,0,0,0,0,0,0,0,0,0,0,0,2,20,13,68220,27185,5476,36134,1
218,4738,173,84,99,8,29,36,181,5,12,7,13,17,20,54,81,2,221,12,0,2,20,13,68220,27186,5476,36135,1
218,4738,3,1,1,3,0,0,6,0,0,0,0,0,0,0,0,0,0,0,0,2,20,13,68220,27186,5476,36136,1
97,1999,463,295,324,28,62,57,491,12,134,82,154,146,236,989,1696,6,11700,650,0,2,3,4,68230,27187,5476,36137,1
51,757,167,116,138,4,5,22,171,8,48,30,56,56,86,292,499,4,2330,129,0,2,3,1,68230,27187,5476,36138,1
31,936,339,213,244,17,9,65,356,10,42,26,48,52,74,259,421,5,2410,133,0,2,3,1,68240,27187,5476,36139,1
85,2182,1455,414,1257,16,76,112,1471,5,41,23,46,46,69,231,381,2,1069,59,0,2,8,4,68240,27188,5476,36141,1
85,2182,669,365,481,22,61,110,691,15,103,63,122,118,185,747,1273,8,11311,628,0,2,8,4,68250,27188,5477,36142,1
256,6014,4293,999,3693,19,54,507,4312,9,155,88,170,164,258,1156,1898,4,9368,520,0,2,24,22,68250,27190,5477,36143,1
256,6014,1482,859,1002,125,135,219,1607,16,219,134,251,235,385,1766,3032,9,27804,1544,1,2,24,22,68260,27191,5477,36144,1
6,140,44,22,19,0,19,6,44,2,10,6,12,12,18,35,64,1,77,4,0,2,3,1,68260,27191,5477,36145,1
27,968,74,35,59,1,0,14,75,3,14,7,14,17,21,58,85,1,128,7,0,2,8,4,68260,27192,5477,36146,1
27,968,245,125,200,5,7,34,250,7,30,17,34,37,51,166,265,3,1053,58,0,2,8,4,68270,27193,5477,36147,1
52,622,647,139,84,35,284,233,682,0,0,0,0,0,0,0,0,0,0,0,0,2,1,1,68270,27193,5477,36148,1
98,2670,1523,757,1297,19,12,193,1542,12,193,117,230,205,347,1508,2664,7,19053,1058,0,2,6,2,68280,27195,5477,36149,1
98,2670,701,378,504,33,58,109,734,13,110,68,126,123,194,794,1346,7,10027,557,0,2,6,2,68280,27196,5478,36150,1
94,2438,773,422,505,30,103,129,803,14,77,46,83,91,129,535,839,7,6334,351,0,2,7,4,68290,27197,5479,36151,1
142,3319,77,34,69,0,0,8,77,3,24,16,29,27,45,114,213,1,387,21,0,2,9,6,68290,27197,5479,36152,1
142,3319,712,438,573,51,9,84,763,14,102,71,128,116,199,733,1364,8,11988,666,0,2,9,6,68300,27198,5479,36153,1
24,628,2,2,2,0,0,0,2,0,0,0,0,0,0,0,0,0,0,0,0,2,15,13,68300,27198,5479,36153,1
24,628,99,48,90,1,3,5,100,0,0,0,0,0,0,0,0,0,0,0,0,2,15,13,68300,27199,5479,36154,1
24,628,8,5,5,2,0,1,10,0,0,0,0,0,0,0,0,0,0,0,0,2,15,13,68300,27199,5479,36155,1
24,628,1217,716,841,84,126,174,1301,14,185,118,215,199,333,1446,2542,8,20687,1149,0,2,15,13,68310,27201,5479,36156,1
24,628,160,89,115,0,13,31,160,7,15,11,17,22,28,78,124,3,495,27,0,2,15,13,68310,27201,5479,36157,1
24,628,10,10,9,9,0,0,19,0,0,0,0,0,0,0,0,0,0,0,0,2,15,13,68310,27201,5480,36158,1
24,628,173,84,99,8,29,36,181,5,12,7,13,17,20,54,81,2,221,12,0,2,15,13,68310,27202,5480,36159,1
24,628,3,1,1,3,0,0,6,0,0,0,0,0,0,0,0,0,0,0,0,2,15,13,68310,27202,5480,36160,1
30,664,125,97,103,3,0,19,128,9,25,17,27,34,44,144,223,4,1087,60,0,2,5,3,68310,27202,5481,36161,1
23,367,102,57,55,5,16,25,107,5,17,10,18,22,28,81,124,2,330,18,0,2,2,1,68310,27202,5481,36162,1
88,1899,402,202,227,24,74,80,426,12,52,33,61,64,94,339,564,7,3969,220,0,2,6,3,68310,27203,5481,36163,1
52,1075,447,308,343,6,5,95,453,7,96,59,111,103,170,651,1136,4,4600,255,0,2,4,2,68310,27206,5481,36164,1
52,1075,322,174,179,16,74,51,338,10,41,26,46,51,72,252,408,5,2291,127,0,2,4,2,68310,27209,5482,36165,1
88,1993,53,23,39,0,0,13,53,2,8,4,8,10,12,26,39,1,39,2,0,2,8,6,68310,27209,5482,36166,1
88,1993,515,298,307,33,80,99,548,12,63,44,77,75,121,419,753,7,5527,307,0,2,8,6,68320,27209,5482,36167,1
23,389,424,94,331,4,0,89,428,1,5,5,5,6,10,11,25,0,12,0,0,2,6,2,68320,27210,5482,36168,1
23,389,38,23,23,6,0,8,44,3,11,7,11,14,18,42,68,1,102,5,0,2,6,2,68320,27210,5482,36169,1
20,526,205,80,86,16,53,53,221,7,18,10,19,25,29,94,134,3,497,27,0,2,4,1,68330,27210,5483,36170,1
17,523,184,100,137,2,15,30,186,6,38,20,39,44,59,214,322,3,991,55,0,2,7,3,68330,27211,5483,36171,1
17,523,103,65,74,8,5,16,111,7,17,9,17,24,26,89,119,3,417,23,0,2,7,3,68330,27212,5483,36172,1
53,1178,91,45,69,0,3,18,91,3,9,6,10,12,16,33,57,1,95,5,0,2,14,11,68330,27214,5483,36173,1
53,1178,367,234,237,17,34,68,384,16,55,34,61,71,95,381,584,8,5183,287,0,2,14,11,68330,27215,5483,36174,1
244,5842,722,423,573,19,0,135,741,12,172,101,199,184,300,1320,2257,6,15668,870,0,2,13,9,68330,27217,5483,36176,1
244,5842,1508,847,911,44,250,301,1552,14,148,88,169,162,257,1120,1886,7,15077,837,0,2,13,9,68330,27218,5484,36177,1
305,6844,72,33,56,0,4,12,72,1,1,1,1,2,2,0,2,0,1,0,0,2,30,32,68330,27218,5484,36178,1
305,6844,1454,835,1044,76,110,219,1530,17,275,158,296,292,454,2297,3718,9,34017,1889,1,2,30,32,68340,27219,5484,36179,1
91,1836,757,253,292,73,244,162,830,13,61,38,67,74,105,409,651,7,4654,258,0,2,6,6,68340,27220,5484,36180,1
43,902,386,256,301,16,9,68,402,4,59,35,69,63,104,355,621,2,1453,80,0,2,4,3,68340,27220,5484,36181,1
43,902,264,131,164,11,41,46,275,6,38,22,40,44,62,214,338,3,1068,59,0,2,4,3,68350,27220,5485,36182,1
28,707,466,257,367,18,25,50,484,7,126,86,171,133,257,898,1813,4,8612,478,0,2,1,0,68350,27220,5485,36183,1
28,707,507,281,342,29,59,88,536,10,53,29,57,63,86,336,514,5,2764,153,0,2,1,0,68350,27220,5485,36184,1
30,658,215,129,180,6,0,29,221,8,65,43,72,73,115,415,711,4,3153,175,0,2,5,2,68350,27220,5485,36185,1
30,658,97,69,77,3,3,16,100,6,22,13,23,28,36,113,173,3,542,30,0,2,5,2,68350,27221,5485,36186,1
92,1975,1043,504,840,53,9,147,1096,9,180,112,198,189,310,1377,2344,4,11604,644,0,2,10,4,68350,27223,5485,36187,1
92,1975,383,288,292,26,6,62,409,11,65,38,67,76,105,429,656,5,3719,206,0,2,10,4,68350,27224,5485,36188,1
20,420,294,64,250,0,0,43,294,1,20,10,20,21,30,86,131,0,65,3,0,2,5,2,68350,27224,5485,36189,1
20,420,78,46,62,3,0,14,81,3,8,4,8,11,12,28,41,1,62,3,0,2,5,2,68350,27225,5485,36190,1
5,123,110,30,77,3,13,16,113,4,21,15,30,25,45,100,208,2,597,33,0,2,3,1,68350,27225,5485,36191,1
5,123,28,15,21,1,0,6,29,0,0,0,0,0,0,0,0,0,0,0,0,2,3,1,68350,27225,5485,36192,1
70,1394,1178,367,1042,6,15,115,1184,9,94,51,95,103,146,644,976,4,4439,246,0,2,6,2,68350,27225,5485,36193,1
70,1394,177,108,140,8,0,27,185,6,30,16,32,36,48,162,248,3,794,44,0,2,6,2,68350,27227,5485,36194,1
223,4852,1943,715,1694,26,18,214,1969,12,185,120,237,197,357,1436,2721,7,20915,1161,0,2,9,11,68350,27229,5485,36195,1
223,4852,1168,838,957,57,25,144,1225,19,348,224,416,367,640,3018,5452,11,61921,3440,1,2,9,11,68360,27231,5485,36196,1
19,682,442,244,305,14,16,103,456,11,68,45,75,79,120,452,756,6,4588,254,0,2,13,12,68360,27233,5485,36197,1
19,682,182,102,99,11,40,35,193,3,11,6,11,14,17,42,64,1,97,5,0,2,13,12,68360,27234,5485,36198,1
62,1255,1098,241,925,5,10,155,1103,7,46,25,49,53,74,273,423,3,1580,87,0,2,11,5,68370,27236,5485,36199,1
62,1255,282,202,222,14,2,44,296,8,42,24,43,50,67,250,378,4,1548,86,0,2,11,5,68370,27237,5485,36200,1
29,728,601,196,481,2,23,85,603,8,63,36,72,71,108,400,664,4,3036,168,0,2,3,2,68370,27237,5485,36201,1
29,728,156,79,106,5,16,28,161,5,14,8,15,19,23,64,97,2,261,14,0,2,3,2,68370,27237,5485,36202,1
99,4089,1289,550,1043,56,32,155,1345,10,167,93,185,177,278,1266,2075,5,11498,638,0,2,7,3,68370,27239,5486,36203,1
35,1083,182,127,129,0,0,53,182,5,39,21,42,44,63,217,343,2,926,51,0,2,6,4,68370,27239,5487,36204,1
152,7159,1392,870,1177,35,17,170,1427,14,494,280,531,508,811,4473,7289,7,54850,3047,2,2,11,10,68370,27242,5488,36205,1
90,2889,773,419,590,28,0,166,801,10,204,113,217,214,330,1598,2554,5,13587,754,0,2,6,2,68370,27242,5489,36206,1
24,1149,75,38,59,1,3,12,76,2,4,2,4,6,6,10,15,1,15,0,0,2,3,1,68370,27242,5489,36207,1
8,263,51,25,36,0,0,15,51,3,11,6,12,14,18,42,68,1,112,6,0,2,2,1,68370,27242,5489,36208,1
2,51,14,9,9,0,0,5,14,0,0,0,0,0,0,0,0,0,0,0,0,2,2,1,68370,27242,5489,36209,1
1,134,149,67,118,4,0,27,153,1,17,14,28,18,42,69,175,0,144,8,0,2,1,0,68370,27242,5489,36210,1
34,2285,1157,318,931,29,22,177,1186,6,104,63,125,110,188,712,1274,3,4596,255,0,2,1,1,68370,27242,5489,36211,1
63,4333,520,294,400,33,13,81,553,10,261,204,367,271,571,2128,4614,7,32445,1802,1,2,6,5,68370,27243,5489,36212,1
180,8011,139,89,101,2,0,35,141,7,54,34,62,61,96,330,569,4,2287,127,0,2,3,2,68370,27243,5489,36213,1
180,8011,7,5,5,0,0,2,7,1,2,1,2,3,3,2,4,0,2,0,0,2,3,2,68370,27243,5489,36214,1
138,6148,1782,648,1425,9,47,279,1791,8,171,97,189,179,286,1292,2140,4,9462,525,0,2,5,3,68370,27244,5490,36215,1
25,684,256,139,192,9,7,47,265,4,23,12,24,27,36,112,171,2,357,19,0,2,3,2,68370,27245,5490,36216,1
23,583,102,59,69,5,3,24,107,6,22,15,28,28,43,113,206,3,789,43,0,2,5,1,68370,27245,5490,36217,1
111,4174,1450,624,1228,12,26,181,1462,14,306,186,354,320,540,2580,4493,8,36391,2021,1,2,8,4,68370,27247,5491,36218,1
166,4983,1660,832,1314,41,38,274,1701,20,312,209,395,332,604,2671,5058,12,64042,3557,1,2,8,7,68370,27249,5492,36220,1
44,3230,996,429,845,24,10,117,1020,7,76,50,88,83,138,494,879,4,3565,198,0,2,6,3,68370,27251,5492,36221,1
128,5336,1513,682,1277,25,13,200,1538,11,199,116,219,210,335,1557,2584,6,15641,868,0,2,10,6,68370,27253,5492,36222,1
75,3910,1296,573,1062,40,33,157,1336,8,201,118,231,209,349,1561,2689,4,12365,686,0,2,8,3,68370,27253,5492,36223,1
19,453,207,111,150,11,0,50,218,5,26,19,36,31,55,133,272,3,943,52,0,2,8,2,68370,27253,5492,36224,1
92,4718,1457,730,1242,11,6,188,1468,10,292,166,329,302,495,2424,4078,5,22973,1276,1,2,8,3,68370,27255,5492,36225,1
40,2521,652,304,544,16,6,88,668,6,89,51,101,95,152,591,998,3,3399,188,0,2,8,2,68370,27256,5492,36226,1
70,3216,1455,414,1257,16,76,112,1471,5,41,23,46,46,69,231,381,2,1069,59,0,2,9,3,68370,27257,5492,36227,1
2,79,7,6,5,0,0,2,7,1,1,1,2,2,3,0,3,1,3,0,0,2,4,1,68370,27257,5492,36228,1
8,275,74,35,59,1,0,14,75,3,14,7,14,17,21,58,85,1,128,7,0,2,5,2,68370,27258,5492,36229,1
96,4695,1523,757,1297,19,12,193,1542,12,193,117,230,205,347,1508,2664,7,19053,1058,0,2,9,5,68380,27260,5492,36230,1
97,4232,1020,354,843,12,15,144,1032,8,134,77,144,142,221,970,1580,4,6792,377,0,2,4,1,68380,27260,5492,36231,1
42,1903,447,308,343,6,5,95,453,7,96,59,111,103,170,651,1136,4,4600,255,0,2,4,1,68380,27263,5492,36232,1
2,145,53,23,39,0,0,13,53,2,8,4,8,10,12,26,39,1,39,2,0,2,0,1,68380,27263,5492,36233,1
21,662,424,94,331,4,0,89,428,1,5,5,5,6,10,11,25,0,12,0,0,2,4,1,68380,27264,5492,36234,1
38,2306,334,251,279,10,4,40,344,5,127,74,143,132,217,899,1528,2,4303,239,0,2,7,2,68380,27265,5492,36235,1
12,497,184,100,137,2,15,30,186,6,38,20,39,44,59,214,322,3,991,55,0,2,5,1,68380,27266,5492,36236,1
64,2863,1293,570,1093,25,15,163,1318,10,195,123,241,205,364,1516,2795,6,17273,959,0,2,6,3,68390,27268,5492,36237,1
33,1897,384,251,317,7,8,52,391,11,70,44,84,81,128,467,811,6,5355,297,0,2,9,4,68390,27268,5492,36238,1
47,2248,722,423,573,19,0,135,741,12,172,101,199,184,300,1320,2257,6,15668,870,0,2,15,6,68390,27270,5492,36240,1
43,1877,386,256,301,16,9,68,402,4,59,35,69,63,104,355,621,2,1453,80,0,2,5,2,68390,27270,5492,36241,1
16,1245,215,129,180,6,0,29,221,8,65,43,72,73,115,415,711,4,3153,175,0,2,13,9,68390,27270,5492,36242,1
84,3236,1043,504,840,53,9,147,1096,9,180,112,198,189,310,1377,2344,4,11604,644,0,2,12,5,68390,27272,5492,36243,1
14,534,295,56,236,0,4,54,295,2,9,5,10,11,15,30,51,1,57,3,0,2,4,1,68390,27274,5492,36244,1
30,1245,373,158,315,8,0,51,381,5,76,44,79,81,123,486,779,2,2026,112,0,2,3,2,68390,27274,5492,36245,1
77,3225,1178,367,1042,6,15,115,1184,9,94,51,95,103,146,644,976,4,4439,246,0,2,8,3,68390,27274,5492,36246,1
99,5086,1943,715,1694,26,18,214,1969,12,185,120,237,197,357,1436,2721,7,20915,1161,0,2,10,3,68390,27276,5492,36247,1
30,1272,442,244,305,14,16,103,456,11,68,45,75,79,120,452,756,6,4588,254,0,2,4,1,68390,27278,5492,36248,1
51,1917,1098,241,925,5,10,155,1103,7,46,25,49,53,74,273,423,3,1580,87,0,2,7,3,68400,27280,5492,36249,1
40,1147,339,213,244,17,9,65,356,10,42,26,48,52,74,259,421,5,2410,133,0,2,37,1,68410,27280,5492,36250,1
53,629,647,139,84,35,284,233,682,0,0,0,0,0,0,0,0,0,0,0,0,2,10,0,68410,27280,5492,36251,1
64,2924,1293,570,1093,25,15,163,1318,10,195,123,241,205,364,1516,2795,6,17273,959,0,2,22,6,68420,27282,5492,36252,1
40,1155,339,213,244,17,9,65,356,10,42,26,48,52,74,259,421,5,2410,133,0,2,4,2,68430,27282,5492,36253,0
53,633,647,139,84,35,284,233,682,0,0,0,0,0,0,0,0,0,0,0,0,2,4,2,68430,27282,5492,36254,0
64,2924,1293,570,1093,25,15,163,1318,10,195,123,241,205,364,1516,2795,6,17273,959,0,2,12,2,68440,27284,5492,36255,0
2,40,9,6,6,0,0,3,9,0,0,0,0,0,0,0,0,0,0,0,0,2,1,0,68440,27284,5492,36257,0
2,40,13,9,8,0,0,4,13,0,0,0,0,0,0,0,0,0,0,0,0,2,1,0,68440,27284,5492,36258,0
1,319,382,65,130,157,2,92,539,4,10,5,10,14,15,41,57,2,114,6,0,2,1,3,68440,27285,5493,36260,0
60,1078,282,196,195,3,0,86,285,8,130,71,141,138,212,936,1507,4,6538,363,0,2,3,2,68440,27285,5494,36261,0
4,77,127,75,83,2,11,30,129,4,14,7,14,18,21,61,87,2,175,9,0,2,2,1,68440,27285,5494,36262,0
4,77,652,304,544,16,6,88,668,6,89,51,101,95,152,591,998,3,3399,188,0,2,2,1,68440,27286,5494,36263,0
4,77,2,2,2,0,0,0,2,0,0,0,0,0,0,0,0,0,0,0,0,2,2,1,68440,27286,5494,36263,0
4,77,8,5,5,0,0,3,8,0,0,0,0,0,0,0,0,0,0,0,0,2,2,1,68440,27286,5494,36264,0
4,77,2,2,2,0,0,0,2,0,0,0,0,0,0,0,0,0,0,0,0,2,2,1,68440,27286,5494,36264,0
4,77,14,8,8,0,0,6,14,0,0,0,0,0,0,0,0,0,0,0,0,2,2,1,68440,27286,5494,36265,0
4,77,6,4,4,0,0,2,6,0,0,0,0,0,0,0,0,0,0,0,0,2,2,1,68440,27286,5494,36266,0
4,77,6,4,4,0,0,2,6,1,2,1,2,3,3,2,4,0,2,0,0,2,2,1,68440,27286,5494,36267,0
4,77,6,4,4,0,0,2,6,0,0,0,0,0,0,0,0,0,0,0,0,2,2,1,68440,27286,5494,36268,0
4,77,7,5,5,0,0,2,7,0,0,0,0,0,0,0,0,0,0,0,0,2,2,1,68440,27286,5494,36269,0
4,77,6,4,4,0,0,2,6,0,0,0,0,0,0,0,0,0,0,0,0,2,2,1,68440,27286,5494,36270,0
4,77,10,6,6,0,0,4,10,0,0,0,0,0,0,0,0,0,0,0,0,2,2,1,68440,27286,5494,36271,0
4,77,1,1,1,0,0,0,1,0,0,0,0,0,0,0,0,0,0,0,0,2,2,1,68440,27286,5494,36271,0
4,77,14,10,10,0,0,4,14,1,1,1,1,2,2,0,2,0,1,0,0,2,2,1,68440,27286,5494,36272,0
4,77,46,26,30,3,0,12,49,3,6,3,6,9,9,20,28,1,42,2,0,2,2,1,68450,27286,5494,36273,0
7,296,72,33,56,0,4,12,72,1,1,1,1,2,2,0,2,0,1,0,0,2,1,0,68450,27286,5494,36274,0
12,229,127,75,83,2,11,30,129,4,14,7,14,18,21,61,87,2,175,9,0,2,0,1,68450,27286,5494,36275,0
12,229,652,304,544,16,6,88,668,6,89,51,101,95,152,591,998,3,3399,188,0,2,0,1,68450,27287,5494,36276,0
12,229,2,2,2,0,0,0,2,0,0,0,0,0,0,0,0,0,0,0,0,2,0,1,68450,27287,5494,36276,0
12,229,8,5,5,0,0,3,8,0,0,0,0,0,0,0,0,0,0,0,0,2,0,1,68450,27287,5494,36277,0
12,229,2,2,2,0,0,0,2,0,0,0,0,0,0,0,0,0,0,0,0,2,0,1,68450,27287,5494,36277,0
12,229,14,8,8,0,0,6,14,0,0,0,0,0,0,0,0,0,0,0,0,2,0,1,68450,27287,5494,36278,0
12,229,6,4,4,0,0,2,6,0,0,0,0,0,0,0,0,0,0,0,0,2,0,1,68450,27287,5494,36279,0
12,229,6,4,4,0,0,2,6,1,2,1,2,3,3,2,4,0,2,0,0,2,0,1,68450,27287,5494,36280,0
12,229,6,4,4,0,0,2,6,0,0,0,0,0,0,0,0,0,0,0,0,2,0,1,68450,27287,5494,36281,0
12,229,7,5,5,0,0,2,7,0,0,0,0,0,0,0,0,0,0,0,0,2,0,1,68450,27287,5494,36282,0
12,229,6,4,4,0,0,2,6,0,0,0,0,0,0,0,0,0,0,0,0,2,0,1,68450,27287,5494,36283,0
12,229,10,6,6,0,0,4,10,0,0,0,0,0,0,0,0,0,0,0,0,2,0,1,68450,27287,5494,36284,0
12,229,1,1,1,0,0,0,1,0,0,0,0,0,0,0,0,0,0,0,0,2,0,1,68450,27287,5494,36284,0
12,229,14,10,10,0,0,4,14,1,1,1,1,2,2,0,2,0,1,0,0,2,0,1,68450,27287,5494,36285,0
12,229,46,26,30,3,0,12,49,3,6,3,6,9,9,20,28,1,42,2,0,2,0,1,68460,27287,5494,36286,0
6,71,127,75,83,2,11,30,129,4,14,7,14,18,21,61,87,2,175,9,0,2,1,0,68460,27287,5494,36287,0
6,71,652,304,544,16,6,88,668,6,89,51,101,95,152,591,998,3,3399,188,0,2,1,0,68460,27288,5494,36288,0
6,71,2,2,2,0,0,0,2,0,0,0,0,0,0,0,0,0,0,0,0,2,1,0,68460,27288,5494,36288,0
6,71,8,5,5,0,0,3,8,0,0,0,0,0,0,0,0,0,0,0,0,2,1,0,68460,27288,5494,36289,0
6,71,2,2,2,0,0,0,2,0,0,0,0,0,0,0,0,0,0,0,0,2,1,0,68460,27288,5494,36289,0
6,71,14,8,8,0,0,6,14,0,0,0,0,0,0,0,0,0,0,0,0,2,1,0,68460,27288,5494,36290,0
6,71,6,4,4,0,0,2,6,0,0,0,0,0,0,0,0,0,0,0,0,2,1,0,68460,27288,5494,36291,0
6,71,6,4,4,0,0,2,6,1,2,1,2,3,3,2,4,0,2,0,0,2,1,0,68460,27288,5494,36292,0
6,71,6,4,4,0,0,2,6,0,0,0,0,0,0,0,0,0,0,0,0,2,1,0,68460,27288,5494,36293,0
6,71,7,5,5,0,0,2,7,0,0,0,0,0,0,0,0,0,0,0,0,2,1,0,68460,27288,5494,36294,0
6,71,6,4,4,0,0,2,6,0,0,0,0,0,0,0,0,0,0,0,0,2,1,0,68460,27288,5494,36295,0
6,71,10,6,6,0,0,4,10,0,0,0,0,0,0,0,0,0,0,0,0,2,1,0,68460,27288,5494,36296,0
6,71,1,1,1,0,0,0,1,0,0,0,0,0,0,0,0,0,0,0,0,2,1,0,68460,27288,5494,36296,0
6,71,14,10,10,0,0,4,14,1,1,1,1,2,2,0,2,0,1,0,0,2,1,0,68460,27288,5494,36297,0
6,71,46,26,30,3,0,12,49,3,6,3,6,9,9,20,28,1,42,2,0,2,1,0,68470,27288,5494,36298,0
17,378,85,59,61,8,0,16,93,5,18,10,18,23,28,86,126,2,316,17,0,2,1,0,68470,27288,5494,36299,0
12,515,124,78,88,2,3,26,126,4,13,7,13,17,20,56,81,2,163,9,0,2,6,2,68470,27288,5494,36300,0
1,86,42,7,35,4,0,5,46,1,2,1,2,3,3,2,4,0,2,0,0,2,1,0,68470,27288,5494,36301,0
1,86,11,6,10,0,0,1,11,2,4,2,4,6,6,10,15,1,15,0,0,2,1,0,68470,27288,5494,36302,0
11,242,19,8,11,5,0,4,24,2,5,3,6,7,9,13,25,1,30,1,0,2,5,2,68470,27288,5494,36303,0
11,242,102,59,69,5,3,24,107,6,22,15,28,28,43,113,206,3,789,43,0,2,5,2,68470,27288,5494,36304,0
11,242,106,40,36,3,49,17,109,8,17,13,23,25,36,93,167,5,904,50,0,2,5,2,68470,27288,5494,36305,0
222,4859,182,127,129,0,0,53,182,5,39,21,42,44,63,217,343,2,926,51,0,2,15,7,68480,27292,5496,36313,0
222,4859,1165,710,800,67,119,181,1232,18,243,153,282,261,435,2000,3492,10,36473,2026,1,2,15,7,68490,27292,5497,36314,0
68,1565,773,419,590,28,0,166,801,10,204,113,217,214,330,1598,2554,5,13587,754,0,2,8,5,68490,27292,5498,36315,0
68,1565,421,273,302,44,34,57,465,17,81,59,107,98,166,583,1098,11,12329,684,0,2,8,5,68490,27292,5499,36316,0
26,529,2,2,2,0,0,0,2,0,0,0,0,0,0,0,0,0,0,0,0,2,6,2,68490,27292,5499,36316,0
26,529,99,48,90,1,3,5,100,0,0,0,0,0,0,0,0,0,0,0,0,2,6,2,68490,27293,5499,36317,0
26,529,8,5,5,2,0,1,10,0,0,0,0,0,0,0,0,0,0,0,0,2,6,2,68490,27293,5499,36318,0
26,529,1217,716,841,84,126,174,1301,14,185,118,215,199,333,1446,2542,8,20687,1149,0,2,6,2,68500,27295,5499,36319,0
26,529,160,89,115,0,13,31,160,7,15,11,17,22,28,78,124,3,495,27,0,2,6,2,68500,27295,5499,36320,0
26,529,10,10,9,9,0,0,19,0,0,0,0,0,0,0,0,0,0,0,0,2,6,2,68500,27295,5500,36321,0
26,529,173,84,99,8,29,36,181,5,12,7,13,17,20,54,81,2,221,12,0,2,6,2,68500,27296,5500,36322,0
26,529,3,1,1,3,0,0,6,0,0,0,0,0,0,0,0,0,0,0,0,2,6,2,68500,27296,5500,36323,0
180,5401,1660,832,1314,41,38,274,1701,20,312,209,395,332,604,2671,5058,12,64042,3557,1,2,7,4,68500,27298,5501,36325,0
180,5401,1057,646,719,113,100,145,1170,18,215,134,248,233,382,1740,3004,10,31186,1732,1,2,7,4,68510,27299,5502,36326,0
17,348,95,58,50,9,16,20,104,12,33,24,45,45,69,209,378,8,3100,172,0,2,4,1,68510,27299,5502,36327,0
89,1829,477,336,357,30,23,73,507,16,194,134,250,210,384,1538,2962,10,30538,1696,0,2,6,2,68520,27300,5502,36328,0
76,1743,996,429,845,24,10,117,1020,7,76,50,88,83,138,494,879,4,3565,198,0,2,9,5,68520,27302,5502,36329,0
76,1743,456,277,329,12,42,72,468,13,85,50,97,98,147,592,972,7,7212,400,0,2,9,5,68520,27302,5502,36330,0
154,3265,1513,682,1277,25,13,200,1538,11,199,116,219,210,335,1557,2584,6,15641,868,0,2,6,3,68520,27304,5502,36331,0
154,3265,819,519,539,24,98,155,843,15,96,57,106,111,163,690,1107,8,9171,509,0,2,6,3,68530,27306,5502,36332,0
68,1364,207,111,150,11,0,50,218,5,26,19,36,31,55,133,272,3,943,52,0,2,7,4,68530,27306,5502,36333,0
68,1364,410,198,237,31,55,97,441,11,63,38,72,74,110,414,683,6,4293,238,0,2,7,4,68540,27307,5503,36334,0
218,4738,2,2,2,0,0,0,2,0,0,0,0,0,0,0,0,0,0,0,0,2,20,13,68540,27307,5503,36334,0
218,4738,99,48,90,1,3,5,100,0,0,0,0,0,0,0,0,0,0,0,0,2,20,13,68540,27308,5503,36335,0
218,4738,8,5,5,2,0,1,10,0,0,0,0,0,0,0,0,0,0,0,0,2,20,13,68540,27308,5503,36336,0
218,4738,1217,716,841,84,126,174,1301,14,185,118,215,199,333,1446,2542,8,20687,1149,0,2,20,13,68550,27310,5503,36337,0
218,4738,160,89,115,0,13,31,160,7,15,11,17,22,28,78,124,3,495,27,0,2,20,13,68550,27310,5503,36338,0
218,4738,10,10,9,9,0,0,19,0,0,0,0,0,0,0,0,0,0,0,0,2,20,13,68550,27310,5504,36339,0
218,4738,173,84,99,8,29,36,181,5,12,7,13,17,20,54,81,2,221,12,0,2,20,13,68550,27311,5504,36340,0
218,4738,3,1,1,3,0,0,6,0,0,0,0,0,0,0,0,0,0,0,0,2,20,13,68550,27311,5504,36341,0
97,1999,463,295,324,28,62,57,491,12,134,82,154,146,236,989,1696,6,11700,650,0,2,3,4,68560,27312,5504,36342,0
51,757,167,116,138,4,5,22,171,8,48,30,56,56,86,292,499,4,2330,129,0,2,3,1,68560,27312,5504,36343,0
31,936,339,213,244,17,9,65,356,10,42,26,48,52,74,259,421,5,2410,133,0,2,3,1,68570,27312,5504,36344,0
85,2182,1455,414,1257,16,76,112,1471,5,41,23,46,46,69,231,381,2,1069,59,0,2,8,4,68570,27313,5504,36346,0
85,2182,669,365,481,22,61,110,691,15,103,63,122,118,185,747,1273,8,11311,628,0,2,8,4,68580,27313,5505,36347,0
256,6014,4293,999,3693,19,54,507,4312,9,155,88,170,164,258,1156,1898,4,9368,520,0,2,24,22,68580,27315,5505,36348,0
256,6014,1482,859,1002,125,135,219,1607,16,219,134,251,235,385,1766,3032,9,27804,1544,1,2,24,22,68590,27316,5505,36349,0
6,140,44,22,19,0,19,6,44,2,10,6,12,12,18,35,64,1,77,4,0,2,3,1,68590,27316,5505,36350,0
27,968,74,35,59,1,0,14,75,3,14,7,14,17,21,58,85,1,128,7,0,2,8,4,68590,27317,5505,36351,0
27,968,245,125,200,5,7,34,250,7,30,17,34,37,51,166,265,3,1053,58,0,2,8,4,68600,27318,5505,36352,0
52,622,647,139,84,35,284,233,682,0,0,0,0,0,0,0,0,0,0,0,0,2,1,1,68600,27318,5505,36353,0
98,2670,1523,757,1297,19,12,193,1542,12,193,117,230,205,347,1508,2664,7,19053,1058,0,2,6,2,68610,27320,5505,36354,0
98,2670,701,378,504,33,58,109,734,13,110,68,126,123,194,794,1346,7,10027,557,0,2,6,2,68610,27321,5506,36355,0
94,2438,773,422,505,30,103,129,803,14,77,46,83,91,129,535,839,7,6334,351,0,2,7,4,68620,27322,5507,36356,0
142,3319,77,34,69,0,0,8,77,3,24,16,29,27,45,114,213,1,387,21,0,2,9,6,68620,27322,5507,36357,0
142,3319,712,438,573,51,9,84,763,14,102,71,128,116,199,733,1364,8,11988,666,0,2,9,6,68630,27323,5507,36358,0
24,628,2,2,2,0,0,0,2,0,0,0,0,0,0,0,0,0,0,0,0,2,15,13,68630,27323,5507,36358,0
24,628,99,48,90,1,3,5,100,0,0,0,0,0,0,0,0,0,0,0,0,2,15,13,68630,27324,5507,36359,0
24,628,8,5,5,2,0,1,10,0,0,0,0,0,0,0,0,0,0,0,0,2,15,13,68630,27324,5507,36360,0
24,628,1217,716,841,84,126,174,1301,14,185,118,215,199,333,1446,2542,8,20687,1149,0,2,15,13,68640,27326,5507,36361,0
24,628,160,89,115,0,13,31,160,7,15,11,17,22,28,78,124,3,495,27,0,2,15,13,68640,27326,5507,36362,0
24,628,10,10,9,9,0,0,19,0,0,0,0,0,0,0,0,0,0,0,0,2,15,13,68640,27326,5508,36363,0
24,628,173,84,99,8,29,36,181,5,12,7,13,17,20,54,81,2,221,12,0,2,15,13,68640,27327,5508,36364,0
24,628,3,1,1,3,0,0,6,0,0,0,0,0,0,0,0,0,0,0,0,2,15,13,68640,27327,5508,36365,0
30,664,125,97,103,3,0,19,128,9,25,17,27,34,44,144,223,4,1087,60,0,2,5,3,68640,27327,5509,36366,0
23,367,102,57,55,5,16,25,107,5,17,10,18,22,28,81,124,2,330,18,0,2,2,1,68640,27327,5509,36367,0
88,1899,402,202,227,24,74,80,426,12,52,33,61,64,94,339,564,7,3969,220,0,2,6,3,68640,27328,5509,36368,0
52,1075,447,308,343,6,5,95,453,7,96,59,111,103,170,651,1136,4,4600,255,0,2,4,2,68640,27331,5509,36369,0
52,1075,322,174,179,16,74,51,338,10,41,26,46,51,72,252,408,5,2291,127,0,2,4,2,68640,27334,5510,36370,0
88,1993,53,23,39,0,0,13,53,2,8,4,8,10,12,26,39,1,39,2,0,2,8,6,68640,27334,5510,36371,0
88,1993,515,298,307,33,80,99,548,12,63,44,77,75,121,419,753,7,5527,307,0,2,8,6,68650,27334,5510,36372,0
23,389,424,94,331,4,0,89,428,1,5,5,5,6,10,11,25,0,12,0,0,2,6,2,68650,27335,5510,36373,0
23,389,38,23,23,6,0,8,44,3,11,7,11,14,18,42,68,1,102,5,0,2,6,2,68650,27335,5510,36374,0
20,526,205,80,86,16,53,53,221,7,18,10,19,25,29,94,134,3,497,27,0,2,4,1,68660,27335,5511,36375,0
17,523,184,100,137,2,15,30,186,6,38,20,39,44,59,214,322,3,991,55,0,2,7,3,68660,27336,5511,36376,0
17,523,103,65,74,8,5,16,111,7,17,9,17,24,26,89,119,3,417,23,0,2,7,3,68660,27337,5511,36377,0
53,1178,91,45,69,0,3,18,91,3,9,6,10,12,16,33,57,1,95,5,0,2,14,11,68660,27339,5511,36378,0
53,1178,367,234,237,17,34,68,384,16,55,34,61,71,95,381,584,8,5183,287,0,2,14,11,68660,27340,5511,36379,0
244,5842,722,423,573,19,0,135,741,12,172,101,199,184,300,1320,2257,6,15668,870,0,2,13,9,68660,27342,5511,36381,0
244,5842,1508,847,911,44,250,301,1552,14,148,88,169,162,257,1120,1886,7,15077,837,0,2,13,9,68660,27343,5512,36382,0
305,6844,72,33,56,0,4,12,72,1,1,1,1,2,2,0,2,0,1,0,0,2,30,32,68660,27343,5512,36383,0
305,6844,1454,835,1044,76,110,219,1530,17,275,158,296,292,454,2297,3718,9,34017,1889,1,2,30,32,68670,27344,5512,36384,0
91,1836,757,253,292,73,244,162,830,13,61,38,67,74,105,409,651,7,4654,258,0,2,6,6,68670,27345,5512,36385,0
43,902,386,256,301,16,9,68,402,4,59,35,69,63,104,355,621,2,1453,80,0,2,4,3,68670,27345,5512,36386,0
43,902,264,131,164,11,41,46,275,6,38,22,40,44,62,214,338,3,1068,59,0,2,4,3,68680,27345,5513,36387,0
28,707,466,257,367,18,25,50,484,7,126,86,171,133,257,898,1813,4,8612,478,0,2,1,0,68680,27345,5513,36388,0
28,707,507,281,342,29,59,88,536,10,53,29,57,63,86,336,514,5,2764,153,0,2,1,0,68680,27345,5513,36389,0
30,658,215,129,180,6,0,29,221,8,65,43,72,73,115,415,711,4,3153,175,0,2,5,2,68680,27345,5513,36390,0
30,658,97,69,77,3,3,16,100,6,22,13,23,28,36,113,173,3,542,30,0,2,5,2,68680,27346,5513,36391,0
92,1975,1043,504,840,53,9,147,1096,9,180,112,198,189,310,1377,2344,4,11604,644,0,2,10,4,68680,27348,5513,36392,0
92,1975,383,288,292,26,6,62,409,11,65,38,67,76,105,429,656,5,3719,206,0,2,10,4,68680,27349,5513,36393,0
20,420,294,64,250,0,0,43,294,1,20,10,20,21,30,86,131,0,65,3,0,2,5,2,68680,27349,5513,36394,0
20,420,78,46,62,3,0,14,81,3,8,4,8,11,12,28,41,1,62,3,0,2,5,2,68680,27350,5513,36395,0
5,123,110,30,77,3,13,16,113,4,21,15,30,25,45,100,208,2,597,33,0,2,3,1,68680,27350,5513,36396,0
5,123,28,15,21,1,0,6,29,0,0,0,0,0,0,0,0,0,0,0,0,2,3,1,68680,27350,5513,36397,0
70,1394,1178,367,1042,6,15,115,1184,9,94,51,95,103,146,644,976,4,4439,246,0,2,6,2,68680,27350,5513,36398,0
70,1394,177,108,140,8,0,27,185,6,30,16,32,36,48,162,248,3,794,44,0,2,6,2,68680,27352,5513,36399,0
223,4852,1943,715,1694,26,18,214,1969,12,185,120,237,197,357,1436,2721,7,20915,1161,0,2,9,11,68680,27354,5513,36400,0
223,4852,1168,838,957,57,25,144,1225,19,348,224,416,367,640,3018,5452,11,61921,3440,1,2,9,11,68690,27356,5513,36401,0
19,682,442,244,305,14,16,103,456,11,68,45,75,79,120,452,756,6,4588,254,0,2,13,12,68690,27358,5513,36402,0
19,682,182,102,99,11,40,35,193,3,11,6,11,14,17,42,64,1,97,5,0,2,13,12,68690,27359,5513,36403,0
62,1255,1098,241,925,5,10,155,1103,7,46,25,49,53,74,273,423,3,1580,87,0,2,11,5,68700,27361,5513,36404,0
62,1255,282,202,222,14,2,44,296,8,42,24,43,50,67,250,378,4,1548,86,0,2,11,5,68700,27362,5513,36405,0
29,728,601,196,481,2,23,85,603,8,63,36,72,71,108,400,664,4,3036,168,0,2,3,2,68700,27362,5513,36406,0
29,728,156,79,106,5,16,28,161,5,14,8,15,19,23,64,97,2,261,14,0,2,3,2,68700,27362,5513,36407,0
99,4089,1289,550,1043,56,32,155,1345,10,167,93,185,177,278,1266,2075,5,11498,638,0,2,7,3,68700,27364,5514,36408,0
35,1083,182,127,129,0,0,53,182,5,39,21,42,44,63,217,343,2,926,51,0,2,6,4,68700,27364,5515,36409,0
152,7159,1392,870,1177,35,17,170,1427,14,494,280,531,508,811,4473,7289,7,54850,3047,2,2,11,10,68700,27367,5516,36410,0
90,2889,773,419,590,28,0,166,801,10,204,113,217,214,330,1598,2554,5,13587,754,0,2,6,2,68700,27367,5517,36411,0
24,1149,75,38,59,1,3,12,76,2,4,2,4,6,6,10,15,1,15,0,0,2,3,1,68700,27367,5517,36412,0
8,263,51,25,36,0,0,15,51,3,11,6,12,14,18,42,68,1,112,6,0,2,2,1,68700,27367,5517,36413,0
2,51,14,9,9,0,0,5,14,0,0,0,0,0,0,0,0,0,0,0,0,2,2,1,68700,27367,5517,36414,0
1,134,149,67,118,4,0,27,153,1,17,14,28,18,42,69,175,0,144,8,0,2,1,0,68700,27367,5517,36415,0
34,2285,1157,318,931,29,22,177,1186,6,104,63,125,110,188,712,1274,3,4596,255,0,2,1,1,68700,27367,5517,36416,0
63,4333,520,294,400,33,13,81,553,10,261,204,367,271,571,2128,4614,7,32445,1802,1,2,6,5,68700,27368,5517,36417,0
180,8011,139,89,101,2,0,35,141,7,54,34,62,61,96,330,569,4,2287,127,0,2,3,2,68700,27368,5517,36418,0
180,8011,7,5,5,0,0,2,7,1,2,1,2,3,3,2,4,0,2,0,0,2,3,2,68700,27368,5517,36419,0
138,6148,1782,648,1425,9,47,279,1791,8,171,97,189,179,286,1292,2140,4,9462,525,0,2,5,3,68700,27369,5518,36420,0
25,684,256,139,192,9,7,47,265,4,23,12,24,27,36,112,171,2,357,19,0,2,3,2,68700,27370,5518,36421,0
23,583,102,59,69,5,3,24,107,6,22,15,28,28,43,113,206,3,789,43,0,2,5,1,68700,27370,5518,36422,0
111,4174,1450,624,1228,12,26,181,1462,14,306,186,354,320,540,2580,4493,8,36391,2021,1,2,8,4,68700,27372,5519,36423,0
166,4983,1660,832,1314,41,38,274,1701,20,312,209,395,332,604,2671,5058,12,64042,3557,1,2,8,7,68700,27374,5520,36425,0
44,3230,996,429,845,24,10,117,1020,7,76,50,88,83,138,494,879,4,3565,198,0,2,6,3,68700,27376,5520,36426,0
128,5336,1513,682,1277,25,13,200,1538,11,199,116,219,210,335,1557,2584,6,15641,868,0,2,10,6,68700,27378,5520,36427,0
75,3910,1296,573,1062,40,33,157,1336,8,201,118,231,209,349,1561,2689,4,12365,686,0,2,8,3,68700,27378,5520,36428,0
19,453,207,111,150,11,0,50,218,5,26,19,36,31,55,133,272,3,943,52,0,2,8,2,68700,27378,5520,36429,0
92,4718,1457,730,1242,11,6,188,1468,10,292,166,329,302,495,2424,4078,5,22973,1276,1,2,8,3,68700,27380,5520,36430,0
40,2521,652,304,544,16,6,88,668,6,89,51,101,95,152,591,998,3,3399,188,0,2,8,2,68700,27381,5520,36431,0
70,3216,1455,414,1257,16,76,112,1471,5,41,23,46,46,69,231,381,2,1069,59,0,2,9,3,68700,27382,5520,36432,0
2,79,7,6,5,0,0,2,7,1,1,1,2,2,3,0,3,1,3,0,0,2,4,1,68700,27382,5520,36433,0
8,275,74,35,59,1,0,14,75,3,14,7,14,17,21,58,85,1,128,7,0,2,5,2,68700,27383,5520,36434,0
96,4695,1523,757,1297,19,12,193,1542,12,193,117,230,205,347,1508,2664,7,19053,1058,0,2,9,5,68710,27385,5520,36435,0
97,4232,1020,354,843,12,15,144,1032,8,134,77,144,142,221,970,1580,4,6792,377,0,2,4,1,68710,27385,5520,36436,0
42,1903,447,308,343,6,5,95,453,7,96,59,111,103,170,651,1136,4,4600,255,0,2,4,1,68710,27388,5520,36437,0
2,145,53,23,39,0,0,13,53,2,8,4,8,10,12,26,39,1,39,2,0,2,0,1,68710,27388,5520,36438,0
21,662,424,94,331,4,0,89,428,1,5,5,5,6,10,11,25,0,12,0,0,2,4,1,68710,27389,5520,36439,0
38,2306,334,251,279,10,4,40,344,5,127,74,143,132,217,899,1528,2,4303,239,0,2,7,2,68710,27390,5520,36440,0
12,497,184,100,137,2,15,30,186,6,38,20,39,44,59,214,322,3,991,55,0,2,5,1,68710,27391,5520,36441,0
64,2863,1293,570,1093,25,15,163,1318,10,195,123,241,205,364,1516,2795,6,17273,959,0,2,6,3,68720,27393,5520,36442,0
33,1897,384,251,317,7,8,52,391,11,70,44,84,81,128,467,811,6,5355,297,0,2,9,4,68720,27393,5520,36443,0
47,2248,722,423,573,19,0,135,741,12,172,101,199,184,300,1320,2257,6,15668,870,0,2,15,6,68720,27395,5520,36445,0
43,1877,386,256,301,16,9,68,402,4,59,35,69,63,104,355,621,2,1453,80,0,2,5,2,68720,27395,5520,36446,0
16,1245,215,129,180,6,0,29,221,8,65,43,72,73,115,415,711,4,3153,175,0,2,13,9,68720,27395,5520,36447,0
84,3236,1043,504,840,53,9,147,1096,9,180,112,198,189,310,1377,2344,4,11604,644,0,2,12,5,68720,27397,5520,36448,0
14,534,295,56,236,0,4,54,295,2,9,5,10,11,15,30,51,1,57,3,0,2,4,1,68720,27399,5520,36449,0
30,1245,373,158,315,8,0,51,381,5,76,44,79,81,123,486,779,2,2026,112,0,2,3,2,68720,27399,5520,36450,0
77,3225,1178,367,1042,6,15,115,1184,9,94,51,95,103,146,644,976,4,4439,246,0,2,8,3,68720,27399,5520,36451,0
99,5086,1943,715,1694,26,18,214,1969,12,185,120,237,197,357,1436,2721,7,20915,1161,0,2,10,3,68720,27401,5520,36452,0
30,1272,442,244,305,14,16,103,456,11,68,45,75,79,120,452,756,6,4588,254,0,2,4,1,68720,27403,5520,36453,0
51,1917,1098,241,925,5,10,155,1103,7,46,25,49,53,74,273,423,3,1580,87,0,2,7,3,68730,27405,5520,36454,0
40,1155,339,213,244,17,9,65,356,10,42,26,48,52,74,259,421,5,2410,133,0,2,40,2,68740,27405,5520,36455,0
53,633,647,139,84,35,284,233,682,0,0,0,0,0,0,0,0,0,0,0,0,2,13,1,68740,27405,5520,36456,0
64,2924,1293,570,1093,25,15,163,1318,10,195,123,241,205,364,1516,2795,6,17273,959,0,2,33,7,68750,27407,5520,36457,0
70,1387,207,111,150,11,0,50,218,5,26,19,36,31,55,133,272,3,943,52,0,2,13,0,68750,27407,5520,36458,0
70,1387,410,198,237,31,55,97,441,11,63,38,72,74,110,414,683,6,4293,238,0,2,13,0,68760,27408,5521,36459,0
218,4733,2,2,2,0,0,0,2,0,0,0,0,0,0,0,0,0,0,0,0,2,2,5,68760,27408,5521,36459,0
218,4733,99,48,90,1,3,5,100,0,0,0,0,0,0,0,0,0,0,0,0,2,2,5,68760,27409,5521,36460,0
218,4733,8,5,5,2,0,1,10,0,0,0,0,0,0,0,0,0,0,0,0,2,2,5,68760,27409,5521,36461,0
218,4733,1217,716,841,84,126,174,1301,14,185,118,215,199,333,1446,2542,8,20687,1149,0,2,2,5,68770,27411,5521,36462,0
218,4733,160,89,115,0,13,31,160,7,15,11,17,22,28,78,124,3,495,27,0,2,2,5,68770,27411,5521,36463,0
218,4733,10,10,9,9,0,0,19,0,0,0,0,0,0,0,0,0,0,0,0,2,2,5,68770,27411,5522,36464,0
218,4733,173,84,99,8,29,36,181,5,12,7,13,17,20,54,81,2,221,12,0,2,2,5,68770,27412,5522,36465,0
218,4733,3,1,1,3,0,0,6,0,0,0,0,0,0,0,0,0,0,0,0,2,2,5,68770,27412,5522,36466,0
70,1387,207,111,150,11,0,50,218,5,26,19,36,31,55,133,272,3,943,52,0,2,13,0,68770,27412,5522,36467,0
70,1387,410,198,237,31,55,97,441,11,63,38,72,74,110,414,683,6,4293,238,0,2,13,0,68780,27413,5523,36468,0
218,4733,2,2,2,0,0,0,2,0,0,0,0,0,0,0,0,0,0,0,0,2,2,5,68780,27413,5523,36468,0
218,4733,99,48,90,1,3,5,100,0,0,0,0,0,0,0,0,0,0,0,0,2,2,5,68780,27414,5523,36469,0
218,4733,8,5,5,2,0,1,10,0,0,0,0,0,0,0,0,0,0,0,0,2,2,5,68780,27414,5523,36470,0
218,4733,1217,716,841,84,126,174,1301,14,185,118,215,199,333,1446,2542,8,20687,1149,0,2,2,5,68790,27416,5523,36471,0
218,4733,160,89,115,0,13,31,160,7,15,11,17,22,28,78,124,3,495,27,0,2,2,5,68790,27416,5523,36472,0
218,4733,10,10,9,9,0,0,19,0,0,0,0,0,0,0,0,0,0,0,0,2,2,5,68790,27416,5524,36473,0
218,4733,173,84,99,8,29,36,181,5,12,7,13,17,20,54,81,2,221,12,0,2,2,5,68790,27417,5524,36474,0
218,4733,3,1,1,3,0,0,6,0,0,0,0,0,0,0,0,0,0,0,0,2,2,5,68790,27417,5524,36475,0
218,4738,2,2,2,0,0,0,2,0,0,0,0,0,0,0,0,0,0,0,0,2,6,6,68790,27417,5524,36475,0
218,4738,99,48,90,1,3,5,100,0,0,0,0,0,0,0,0,0,0,0,0,2,6,6,68790,27418,5524,36476,0
218,4738,8,5,5,2,0,1,10,0,0,0,0,0,0,0,0,0,0,0,0,2,6,6,68790,27418,5524,36477,0
218,4738,1217,716,841,84,126,174,1301,14,185,118,215,199,333,1446,2542,8,20687,1149,0,2,6,6,68800,27420,5524,36478,0
218,4738,160,89,115,0,13,31,160,7,15,11,17,22,28,78,124,3,495,27,0,2,6,6,68800,27420,5524,36479,0
218,4738,10,10,9,9,0,0,19,0,0,0,0,0,0,0,0,0,0,0,0,2,6,6,68800,27420,5525,36480,0
218,4738,173,84,99,8,29,36,181,5,12,7,13,17,20,54,81,2,221,12,0,2,6,6,68800,27421,5525,36481,0
218,4738,3,1,1,3,0,0,6,0,0,0,0,0,0,0,0,0,0,0,0,2,6,6,68800,27421,5525,36482,0
142,3314,77,34,69,0,0,8,77,3,24,16,29,27,45,114,213,1,387,21,0,2,10,9,68800,27421,5525,36483,0
142,3314,712,438,573,51,9,84,763,14,102,71,128,116,199,733,1364,8,11988,666,0,2,10,9,68810,27422,5525,36484,0
303,6728,72,33,56,0,4,12,72,1,1,1,1,2,2,0,2,0,1,0,0,2,0,9,68810,27422,5525,36485,0
303,6728,1454,835,1044,76,110,219,1530,17,275,158,296,292,454,2297,3718,9,34017,1889,1,2,0,9,68820,27423,5525,36486,0
30,1241,373,158,315,8,0,51,381,5,76,44,79,81,123,486,779,2,2026,112,0,2,1,1,68820,27423,5525,36487,0
4,163,27,21,21,0,0,6,27,3,6,3,6,9,9,20,28,1,42,2,0,0,28,0,68820,27423,5525,36488,0
1,6,2,2,2,0,0,0,2,0,0,0,0,0,0,0,0,0,0,0,0,0,2,0,68820,27423,5525,36488,0
2,40,9,6,6,0,0,3,9,0,0,0,0,0,0,0,0,0,0,0,0,2,1,0,68820,27423,5525,36490,1
2,40,13,9,8,0,0,4,13,0,0,0,0,0,0,0,0,0,0,0,0,2,1,0,68820,27423,5525,36491,1
1,319,382,65,130,157,2,92,539,4,10,5,10,14,15,41,57,2,114,6,0,2,1,3,68820,27424,5526,36493,1
60,1078,282,196,195,3,0,86,285,8,130,71,141,138,212,936,1507,4,6538,363,0,2,3,2,68820,27424,5527,36494,1
4,77,127,75,83,2,11,30,129,4,14,7,14,18,21,61,87,2,175,9,0,2,2,1,68820,27424,5527,36495,1
4,77,652,304,544,16,6,88,668,6,89,51,101,95,152,591,998,3,3399,188,0,2,2,1,68820,27425,5527,36496,1
4,77,2,2,2,0,0,0,2,0,0,0,0,0,0,0,0,0,0,0,0,2,2,1,68820,27425,5527,36496,1
4,77,8,5,5,0,0,3,8,0,0,0,0,0,0,0,0,0,0,0,0,2,2,1,68820,27425,5527,36497,1
4,77,2,2,2,0,0,0,2,0,0,0,0,0,0,0,0,0,0,0,0,2,2,1,68820,27425,5527,36497,1
4,77,14,8,8,0,0,6,14,0,0,0,0,0,0,0,0,0,0,0,0,2,2,1,68820,27425,5527,36498,1
4,77,6,4,4,0,0,2,6,0,0,0,0,0,0,0,0,0,0,0,0,2,2,1,68820,27425,5527,36499,1
4,77,6,4,4,0,0,2,6,1,2,1,2,3,3,2,4,0,2,0,0,2,2,1,68820,27425,5527,36500,1
4,77,6,4,4,0,0,2,6,0,0,0,0,0,0,0,0,0,0,0,0,2,2,1,68820,27425,5527,36501,1
4,77,7,5,5,0,0,2,7,0,0,0,0,0,0,0,0,0,0,0,0,2,2,1,68820,27425,5527,36502,1
4,77,6,4,4,0,0,2,6,0,0,0,0,0,0,0,0,0,0,0,0,2,2,1,68820,27425,5527,36503,1
4,77,10,6,6,0,0,4,10,0,0,0,0,0,0,0,0,0,0,0,0,2,2,1,68820,27425,5527,36504,1
4,77,1,1,1,0,0,0,1,0,0,0,0,0,0,0,0,0,0,0,0,2,2,1,68820,27425,5527,36504,1
4,77,14,10,10,0,0,4,14,1,1,1,1,2,2,0,2,0,1,0,0,2,2,1,68820,27425,5527,36505,1
4,77,46,26,30,3,0,12,49,3,6,3,6,9,9,20,28,1,42,2,0,2,2,1,68830,27425,5527,36506,1
7,296,72,33,56,0,4,12,72,1,1,1,1,2,2,0,2,0,1,0,0,2,1,0,68830,27425,5527,36507,1
12,229,127,75,83,2,11,30,129,4,14,7,14,18,21,61,87,2,175,9,0,2,0,1,68830,27425,5527,36508,1
12,229,652,304,544,16,6,88,668,6,89,51,101,95,152,591,998,3,3399,188,0,2,0,1,68830,27426,5527,36509,1
12,229,2,2,2,0,0,0,2,0,0,0,0,0,0,0,0,0,0,0,0,2,0,1,68830,27426,5527,36509,1
12,229,8,5,5,0,0,3,8,0,0,0,0,0,0,0,0,0,0,0,0,2,0,1,68830,27426,5527,36510,1
12,229,2,2,2,0,0,0,2,0,0,0,0,0,0,0,0,0,0,0,0,2,0,1,68830,27426,5527,36510,1
12,229,14,8,8,0,0,6,14,0,0,0,0,0,0,0,0,0,0,0,0,2,0,1,68830,27426,5527,36511,1
12,229,6,4,4,0,0,2,6,0,0,0,0,0,0,0,0,0,0,0,0,2,0,1,68830,27426,5527,36512,1
12,229,6,4,4,0,0,2,6,1,2,1,2,3,3,2,4,0,2,0,0,2,0,1,68830,27426,5527,36513,1
12,229,6,4,4,0,0,2,6,0,0,0,0,0,0,0,0,0,0,0,0,2,0,1,68830,27426,5527,36514,1
12,229,7,5,5,0,0,2,7,0,0,0,0,0,0,0,0,0,0,0,0,2,0,1,68830,27426,5527,36515,1
12,229,6,4,4,0,0,2,6,0,0,0,0,0,0,0,0,0,0,0,0,2,0,1,68830,27426,5527,36516,1
12,229,10,6,6,0,0,4,10,0,0,0,0,0,0,0,0,0,0,0,0,2,0,1,68830,27426,5527,36517,1
12,229,1,1,1,0,0,0,1,0,0,0,0,0,0,0,0,0,0,0,0,2,0,1,68830,27426,5527,36517,1
12,229,14,10,10,0,0,4,14,1,1,1,1,2,2,0,2,0,1,0,0,2,0,1,68830,27426,5527,36518,1
12,229,46,26,30,3,0,12,49,3,6,3,6,9,9,20,28,1,42,2,0,2,0,1,68840,27426,5527,36519,1
6,71,127,75,83,2,11,30,129,4,14,7,14,18,21,61,87,2,175,9,0,2,1,0,68840,27426,5527,36520,1
6,71,652,304,544,16,6,88,668,6,89,51,101,95,152,591,998,3,3399,188,0,2,1,0,68840,27427,5527,36521,1
6,71,2,2,2,0,0,0,2,0,0,0,0,0,0,0,0,0,0,0,0,2,1,0,68840,27427,5527,36521,1
6,71,8,5,5,0,0,3,8,0,0,0,0,0,0,0,0,0,0,0,0,2,1,0,68840,27427,5527,36522,1
6,71,2,2,2,0,0,0,2,0,0,0,0,0,0,0,0,0,0,0,0,2,1,0,68840,27427,5527,36522,1
6,71,14,8,8,0,0,6,14,0,0,0,0,0,0,0,0,0,0,0,0,2,1,0,68840,27427,5527,36523,1
6,71,6,4,4,0,0,2,6,0,0,0,0,0,0,0,0,0,0,0,0,2,1,0,68840,27427,5527,36524,1
6,71,6,4,4,0,0,2,6,1,2,1,2,3,3,2,4,0,2,0,0,2,1,0,68840,27427,5527,36525,1
6,71,6,4,4,0,0,2,6,0,0,0,0,0,0,0,0,0,0,0,0,2,1,0,68840,27427,5527,36526,1
6,71,7,5,5,0,0,2,7,0,0,0,0,0,0,0,0,0,0,0,0,2,1,0,68840,27427,5527,36527,1
6,71,6,4,4,0,0,2,6,0,0,0,0,0,0,0,0,0,0,0,0,2,1,0,68840,27427,5527,36528,1
6,71,10,6,6,0,0,4,10,0,0,0,0,0,0,0,0,0,0,0,0,2,1,0,68840,27427,5527,36529,1
6,71,1,1,1,0,0,0,1,0,0,0,0,0,0,0,0,0,0,0,0,2,1,0,68840,27427,5527,36529,1
6,71,14,10,10,0,0,4,14,1,1,1,1,2,2,0,2,0,1,0,0,2,1,0,68840,27427,5527,36530,1
6,71,46,26,30,3,0,12,49,3,6,3,6,9,9,20,28,1,42,2,0,2,1,0,68850,27427,5527,36531,1
17,378,85,59,61,8,0,16,93,5,18,10,18,23,28,86,126,2,316,17,0,2,1,0,68850,27427,5527,36532,1
12,515,124,78,88,2,3,26,126,4,13,7,13,17,20,56,81,2,163,9,0,2,6,2,68850,27427,5527,36533,1
1,86,42,7,35,4,0,5,46,1,2,1,2,3,3,2,4,0,2,0,0,2,1,0,68850,27427,5527,36534,1
1,86,11,6,10,0,0,1,11,2,4,2,4,6,6,10,15,1,15,0,0,2,1,0,68850,27427,5527,36535,1
11,242,19,8,11,5,0,4,24,2,5,3,6,7,9,13,25,1,30,1,0,2,5,2,68850,27427,5527,36536,1
11,242,102,59,69,5,3,24,107,6,22,15,28,28,43,113,206,3,789,43,0,2,5,2,68850,27427,5527,36537,1
11,242,106,40,36,3,49,17,109,8,17,13,23,25,36,93,167,5,904,50,0,2,5,2,68850,27427,5527,36538,1
222,4859,182,127,129,0,0,53,182,5,39,21,42,44,63,217,343,2,926,51,0,2,15,7,68860,27431,5529,36546,1
222,4859,1165,710,800,67,119,181,1232,18,243,153,282,261,435,2000,3492,10,36473,2026,1,2,15,7,68870,27431,5530,36547,1
68,1565,773,419,590,28,0,166,801,10,204,113,217,214,330,1598,2554,5,13587,754,0,2,8,5,68870,27431,5531,36548,1
68,1565,421,273,302,44,34,57,465,17,81,59,107,98,166,583,1098,11,12329,684,0,2,8,5,68870,27431,5532,36549,1
26,529,2,2,2,0,0,0,2,0,0,0,0,0,0,0,0,0,0,0,0,2,6,2,68870,27431,5532,36549,1
26,529,99,48,90,1,3,5,100,0,0,0,0,0,0,0,0,0,0,0,0,2,6,2,68870,27432,5532,36550,1
26,529,8,5,5,2,0,1,10,0,0,0,0,0,0,0,0,0,0,0,0,2,6,2,68870,27432,5532,36551,1
26,529,1217,716,841,84,126,174,1301,14,185,118,215,199,333,1446,2542,8,20687,1149,0,2,6,2,68880,27434,5532,36552,1
26,529,160,89,115,0,13,31,160,7,15,11,17,22,28,78,124,3,495,27,0,2,6,2,68880,27434,5532,36553,1
26,529,10,10,9,9,0,0,19,0,0,0,0,0,0,0,0,0,0,0,0,2,6,2,68880,27434,5533,36554,1
26,529,173,84,99,8,29,36,181,5,12,7,13,17,20,54,81,2,221,12,0,2,6,2,68880,27435,5533,36555,1
26,529,3,1,1,3,0,0,6,0,0,0,0,0,0,0,0,0,0,0,0,2,6,2,68880,27435,5533,36556,1
180,5401,1660,832,1314,41,38,274,1701,20,312,209,395,332,604,2671,5058,12,64042,3557,1,2,7,4,68880,27437,5534,36558,1
180,5401,1057,646,719,113,100,145,1170,18,215,134,248,233,382,1740,3004,10,31186,1732,1,2,7,4,68890,27438,5535,36559,1
17,348,95,58,50,9,16,20,104,12,33,24,45,45,69,209,378,8,3100,172,0,2,4,1,68890,27438,5535,36560,1
89,1829,477,336,357,30,23,73,507,16,194,134,250,210,384,1538,2962,10,30538,1696,0,2,6,2,68900,27439,5535,36561,1
76,1743,996,429,845,24,10,117,1020,7,76,50,88,83,138,494,879,4,3565,198,0,2,9,5,68900,27441,5535,36562,1
76,1743,456,277,329,12,42,72,468,13,85,50,97,98,147,592,972,7,7212,400,0,2,9,5,68900,27441,5535,36563,1
154,3265,1513,682,1277,25,13,200,1538,11,199,116,219,210,335,1557,2584,6,15641,868,0,2,6,3,68900,27443,5535,36564,1
154,3265,819,519,539,24,98,155,843,15,96,57,106,111,163,690,1107,8,9171,509,0,2,6,3,68910,27445,5535,36565,1
70,1395,207,111,150,11,0,50,218,5,26,19,36,31,55,133,272,3,943,52,0,2,7,4,68910,27445,5535,36566,1
70,1395,410,198,237,31,55,97,441,11,63,38,72,74,110,414,683,6,4293,238,0,2,7,4,68920,27446,5536,36567,1
218,4751,2,2,2,0,0,0,2,0,0,0,0,0,0,0,0,0,0,0,0,2,20,13,68920,27446,5536,36567,1
218,4751,99,48,90,1,3,5,100,0,0,0,0,0,0,0,0,0,0,0,0,2,20,13,68920,27447,5536,36568,1
218,4751,8,5,5,2,0,1,10,0,0,0,0,0,0,0,0,0,0,0,0,2,20,13,68920,27447,5536,36569,1
218,4751,1217,716,841,84,126,174,1301,14,185,118,215,199,333,1446,2542,8,20687,1149,0,2,20,13,68930,27449,5536,36570,1
218,4751,160,89,115,0,13,31,160,7,15,11,17,22,28,78,124,3,495,27,0,2,20,13,68930,27449,5536,36571,1
218,4751,10,10,9,9,0,0,19,0,0,0,0,0,0,0,0,0,0,0,0,2,20,13,68930,27449,5537,36572,1
218,4751,173,84,99,8,29,36,181,5,12,7,13,17,20,54,81,2,221,12,0,2,20,13,68930,27450,5537,36573,1
218,4751,3,1,1,3,0,0,6,0,0,0,0,0,0,0,0,0,0,0,0,2,20,13,68930,27450,5537,36574,1
97,1999,463,295,324,28,62,57,491,12,134,82,154,146,236,989,1696,6,11700,650,0,2,3,4,68940,27451,5537,36575,1
51,757,167,116,138,4,5,22,171,8,48,30,56,56,86,292,499,4,2330,129,0,2,3,1,68940,27451,5537,36576,1
37,1105,339,213,244,17,9,65,356,10,42,26,48,52,74,259,421,5,2410,133,0,2,3,17,68950,27451,5537,36577,1
85,2182,1455,414,1257,16,76,112,1471,5,41,23,46,46,69,231,381,2,1069,59,0,2,8,4,68950,27452,5537,36579,1
85,2182,669,365,481,22,61,110,691,15,103,63,122,118,185,747,1273,8,11311,628,0,2,8,4,68960,27452,5538,36580,1
258,6040,4293,999,3693,19,54,507,4312,9,155,88,170,164,258,1156,1898,4,9368,520,0,2,26,23,68960,27454,5538,36581,1
258,6040,1482,859,1002,125,135,219,1607,16,219,134,251,235,385,1766,3032,9,27804,1544,1,2,26,23,68970,27455,5538,36582,1
6,140,44,22,19,0,19,6,44,2,10,6,12,12,18,35,64,1,77,4,0,2,3,1,68970,27455,5538,36583,1
27,968,74,35,59,1,0,14,75,3,14,7,14,17,21,58,85,1,128,7,0,2,8,4,68970,27456,5538,36584,1
27,968,245,125,200,5,7,34,250,7,30,17,34,37,51,166,265,3,1053,58,0,2,8,4,68980,27457,5538,36585,1
53,633,647,139,84,35,284,233,682,0,0,0,0,0,0,0,0,0,0,0,0,2,1,1,68980,27457,5538,36586,1
98,2670,1523,757,1297,19,12,193,1542,12,193,117,230,205,347,1508,2664,7,19053,1058,0,2,6,2,68990,27459,5538,36587,1
98,2670,701,378,504,33,58,109,734,13,110,68,126,123,194,794,1346,7,10027,557,0,2,6,2,68990,27460,5539,36588,1
94,2438,773,422,505,30,103,129,803,14,77,46,83,91,129,535,839,7,6334,351,0,2,9,6,69000,27461,5540,36589,1
142,3319,77,34,69,0,0,8,77,3,24,16,29,27,45,114,213,1,387,21,0,2,9,6,69000,27461,5540,36590,1
142,3319,712,438,573,51,9,84,763,14,102,71,128,116,199,733,1364,8,11988,666,0,2,9,6,69010,27462,5540,36591,1
24,628,2,2,2,0,0,0,2,0,0,0,0,0,0,0,0,0,0,0,0,2,15,13,69010,27462,5540,36591,1
24,628,99,48,90,1,3,5,100,0,0,0,0,0,0,0,0,0,0,0,0,2,15,13,69010,27463,5540,36592,1
24,628,8,5,5,2,0,1,10,0,0,0,0,0,0,0,0,0,0,0,0,2,15,13,69010,27463,5540,36593,1
24,628,1217,716,841,84,126,174,1301,14,185,118,215,199,333,1446,2542,8,20687,1149,0,2,15,13,69020,27465,5540,36594,1
24,628,160,89,115,0,13,31,160,7,15,11,17,22,28,78,124,3,495,27,0,2,15,13,69020,27465,5540,36595,1
24,628,10,10,9,9,0,0,19,0,0,0,0,0,0,0,0,0,0,0,0,2,15,13,69020,27465,5541,36596,1
24,628,173,84,99,8,29,36,181,5,12,7,13,17,20,54,81,2,221,12,0,2,15,13,69020,27466,5541,36597,1
24,628,3,1,1,3,0,0,6,0,0,0,0,0,0,0,0,0,0,0,0,2,15,13,69020,27466,5541,36598,1
30,664,125,97,103,3,0,19,128,9,25,17,27,34,44,144,223,4,1087,60,0,2,5,3,69020,27466,5542,36599,1
23,367,102,57,55,5,16,25,107,5,17,10,18,22,28,81,124,2,330,18,0,2,2,1,69020,27466,5542,36600,1
88,1899,402,202,227,24,74,80,426,12,52,33,61,64,94,339,564,7,3969,220,0,2,6,3,69020,27467,5542,36601,1
52,1075,447,308,343,6,5,95,453,7,96,59,111,103,170,651,1136,4,4600,255,0,2,4,2,69020,27470,5542,36602,1
52,1075,322,174,179,16,74,51,338,10,41,26,46,51,72,252,408,5,2291,127,0,2,4,2,69020,27473,5543,36603,1
88,1993,53,23,39,0,0,13,53,2,8,4,8,10,12,26,39,1,39,2,0,2,8,6,69020,27473,5543,36604,1
88,1993,515,298,307,33,80,99,548,12,63,44,77,75,121,419,753,7,5527,307,0,2,8,6,69030,27473,5543,36605,1
23,389,424,94,331,4,0,89,428,1,5,5,5,6,10,11,25,0,12,0,0,2,6,2,69030,27474,5543,36606,1
23,389,38,23,23,6,0,8,44,3,11,7,11,14,18,42,68,1,102,5,0,2,6,2,69030,27474,5543,36607,1
20,526,205,80,86,16,53,53,221,7,18,10,19,25,29,94,134,3,497,27,0,2,4,1,69040,27474,5544,36608,1
17,523,184,100,137,2,15,30,186,6,38,20,39,44,59,214,322,3,991,55,0,2,7,3,69040,27475,5544,36609,1
17,523,103,65,74,8,5,16,111,7,17,9,17,24,26,89,119,3,417,23,0,2,7,3,69040,27476,5544,36610,1
52,1151,91,45,69,0,3,18,91,3,9,6,10,12,16,33,57,1,95,5,0,2,13,10,69040,27478,5544,36611,1
52,1151,367,234,237,17,34,68,384,16,55,34,61,71,95,381,584,8,5183,287,0,2,13,10,69040,27479,5544,36612,1
244,5842,722,423,573,19,0,135,741,12,172,101,199,184,300,1320,2257,6,15668,870,0,2,13,9,69040,27481,5544,36614,1
244,5842,1508,847,911,44,250,301,1552,14,148,88,169,162,257,1120,1886,7,15077,837,0,2,13,9,69040,27482,5545,36615,1
305,6844,72,33,56,0,4,12,72,1,1,1,1,2,2,0,2,0,1,0,0,2,30,32,69040,27482,5545,36616,1
305,6844,1454,835,1044,76,110,219,1530,17,275,158,296,292,454,2297,3718,9,34017,1889,1,2,30,32,69050,27483,5545,36617,1
91,1836,757,253,292,73,244,162,830,13,61,38,67,74,105,409,651,7,4654,258,0,2,6,6,69050,27484,5545,36618,1
43,902,386,256,301,16,9,68,402,4,59,35,69,63,104,355,621,2,1453,80,0,2,4,3,69050,27484,5545,36619,1
43,902,264,131,164,11,41,46,275,6,38,22,40,44,62,214,338,3,1068,59,0,2,4,3,69060,27484,5546,36620,1
28,707,466,257,367,18,25,50,484,7,126,86,171,133,257,898,1813,4,8612,478,0,2,1,0,69060,27484,5546,36621,1
28,707,507,281,342,29,59,88,536,10,53,29,57,63,86,336,514,5,2764,153,0,2,1,0,69060,27484,5546,36622,1
30,658,215,129,180,6,0,29,221,8,65,43,72,73,115,415,711,4,3153,175,0,2,5,2,69060,27484,5546,36623,1
30,658,97,69,77,3,3,16,100,6,22,13,23,28,36,113,173,3,542,30,0,2,5,2,69060,27485,5546,36624,1
92,1975,1043,504,840,53,9,147,1096,9,180,112,198,189,310,1377,2344,4,11604,644,0,2,10,4,69060,27487,5546,36625,1
92,1975,383,288,292,26,6,62,409,11,65,38,67,76,105,429,656,5,3719,206,0,2,10,4,69060,27488,5546,36626,1
20,420,294,64,250,0,0,43,294,1,20,10,20,21,30,86,131,0,65,3,0,2,5,2,69060,27488,5546,36627,1
20,420,78,46,62,3,0,14,81,3,8,4,8,11,12,28,41,1,62,3,0,2,5,2,69060,27489,5546,36628,1
5,123,110,30,77,3,13,16,113,4,21,15,30,25,45,100,208,2,597,33,0,2,3,1,69060,27489,5546,36629,1
5,123,28,15,21,1,0,6,29,0,0,0,0,0,0,0,0,0,0,0,0,2,3,1,69060,27489,5546,36630,1
70,1394,1178,367,1042,6,15,115,1184,9,94,51,95,103,146,644,976,4,4439,246,0,2,6,2,69060,27489,5546,36631,1
70,1394,177,108,140,8,0,27,185,6,30,16,32,36,48,162,248,3,794,44,0,2,6,2,69060,27491,5546,36632,1
226,4927,1943,715,1694,26,18,214,1969,12,185,120,237,197,357,1436,2721,7,20915,1161,0,2,11,14,69060,27493,5546,36633,1
226,4927,1168,838,957,57,25,144,1225,19,348,224,416,367,640,3018,5452,11,61921,3440,1,2,11,14,69070,27495,5546,36634,1
19,682,442,244,305,14,16,103,456,11,68,45,75,79,120,452,756,6,4588,254,0,2,13,12,69070,27497,5546,36635,1
19,682,182,102,99,11,40,35,193,3,11,6,11,14,17,42,64,1,97,5,0,2,13,12,69070,27498,5546,36636,1
62,1255,1098,241,925,5,10,155,1103,7,46,25,49,53,74,273,423,3,1580,87,0,2,11,5,69080,27500,5546,36637,1
62,1255,282,202,222,14,2,44,296,8,42,24,43,50,67,250,378,4,1548,86,0,2,11,5,69080,27501,5546,36638,1
29,728,601,196,481,2,23,85,603,8,63,36,72,71,108,400,664,4,3036,168,0,2,3,2,69080,27501,5546,36639,1
29,728,156,79,106,5,16,28,161,5,14,8,15,19,23,64,97,2,261,14,0,2,3,2,69080,27501,5546,36640,1
99,4089,1289,550,1043,56,32,155,1345,10,167,93,185,177,278,1266,2075,5,11498,638,0,2,7,3,69080,27503,5547,36641,1
35,1083,182,127,129,0,0,53,182,5,39,21,42,44,63,217,343,2,926,51,0,2,6,4,69080,27503,5548,36642,1
152,7159,1392,870,1177,35,17,170,1427,14,494,280,531,508,811,4473,7289,7,54850,3047,2,2,11,10,69080,27506,5549,36643,1
90,2889,773,419,590,28,0,166,801,10,204,113,217,214,330,1598,2554,5,13587,754,0,2,6,2,69080,27506,5550,36644,1
25,1187,75,38,59,1,3,12,76,2,4,2,4,6,6,10,15,1,15,0,0,2,3,1,69080,27506,5550,36645,1
8,263,51,25,36,0,0,15,51,3,11,6,12,14,18,42,68,1,112,6,0,2,2,1,69080,27506,5550,36646,1
2,51,14,9,9,0,0,5,14,0,0,0,0,0,0,0,0,0,0,0,0,2,2,1,69080,27506,5550,36647,1
1,134,149,67,118,4,0,27,153,1,17,14,28,18,42,69,175,0,144,8,0,2,1,0,69080,27506,5550,36648,1
34,2285,1157,318,931,29,22,177,1186,6,104,63,125,110,188,712,1274,3,4596,255,0,2,1,1,69080,27506,5550,36649,1
63,4333,520,294,400,33,13,81,553,10,261,204,367,271,571,2128,4614,7,32445,1802,1,2,6,5,69080,27507,5550,36650,1
180,8011,139,89,101,2,0,35,141,7,54,34,62,61,96,330,569,4,2287,127,0,2,3,2,69080,27507,5550,36651,1
180,8011,7,5,5,0,0,2,7,1,2,1,2,3,3,2,4,0,2,0,0,2,3,2,69080,27507,5550,36652,1
138,6148,1782,648,1425,9,47,279,1791,8,171,97,189,179,286,1292,2140,4,9462,525,0,2,5,3,69080,27508,5551,36653,1
25,684,256,139,192,9,7,47,265,4,23,12,24,27,36,112,171,2,357,19,0,2,3,2,69080,27509,5551,36654,1
23,583,102,59,69,5,3,24,107,6,22,15,28,28,43,113,206,3,789,43,0,2,5,1,69080,27509,5551,36655,1
111,4174,1450,624,1228,12,26,181,1462,14,306,186,354,320,540,2580,4493,8,36391,2021,1,2,8,4,69080,27511,5552,36656,1
166,4983,1660,832,1314,41,38,274,1701,20,312,209,395,332,604,2671,5058,12,64042,3557,1,2,8,7,69080,27513,5553,36658,1
44,3230,996,429,845,24,10,117,1020,7,76,50,88,83,138,494,879,4,3565,198,0,2,6,3,69080,27515,5553,36659,1
128,5336,1513,682,1277,25,13,200,1538,11,199,116,219,210,335,1557,2584,6,15641,868,0,2,10,6,69080,27517,5553,36660,1
75,3910,1296,573,1062,40,33,157,1336,8,201,118,231,209,349,1561,2689,4,12365,686,0,2,8,3,69080,27517,5553,36661,1
19,453,207,111,150,11,0,50,218,5,26,19,36,31,55,133,272,3,943,52,0,2,8,2,69080,27517,5553,36662,1
92,4718,1457,730,1242,11,6,188,1468,10,292,166,329,302,495,2424,4078,5,22973,1276,1,2,8,3,69080,27519,5553,36663,1
40,2521,652,304,544,16,6,88,668,6,89,51,101,95,152,591,998,3,3399,188,0,2,8,2,69080,27520,5553,36664,1
70,3216,1455,414,1257,16,76,112,1471,5,41,23,46,46,69,231,381,2,1069,59,0,2,9,3,69080,27521,5553,36665,1
2,79,7,6,5,0,0,2,7,1,1,1,2,2,3,0,3,1,3,0,0,2,4,1,69080,27521,5553,36666,1
8,275,74,35,59,1,0,14,75,3,14,7,14,17,21,58,85,1,128,7,0,2,5,2,69080,27522,5553,36667,1
96,4695,1523,757,1297,19,12,193,1542,12,193,117,230,205,347,1508,2664,7,19053,1058,0,2,9,5,69090,27524,5553,36668,1
97,4232,1020,354,843,12,15,144,1032,8,134,77,144,142,221,970,1580,4,6792,377,0,2,4,1,69090,27524,5553,36669,1
42,1903,447,308,343,6,5,95,453,7,96,59,111,103,170,651,1136,4,4600,255,0,2,4,1,69090,27527,5553,36670,1
2,145,53,23,39,0,0,13,53,2,8,4,8,10,12,26,39,1,39,2,0,2,0,1,69090,27527,5553,36671,1
21,662,424,94,331,4,0,89,428,1,5,5,5,6,10,11,25,0,12,0,0,2,4,1,69090,27528,5553,36672,1
38,2306,334,251,279,10,4,40,344,5,127,74,143,132,217,899,1528,2,4303,239,0,2,7,2,69090,27529,5553,36673,1
12,497,184,100,137,2,15,30,186,6,38,20,39,44,59,214,322,3,991,55,0,2,5,1,69090,27530,5553,36674,1
64,2936,1293,570,1093,25,15,163,1318,10,195,123,241,205,364,1516,2795,6,17273,959,0,2,13,4,69100,27532,5553,36675,1
33,1897,384,251,317,7,8,52,391,11,70,44,84,81,128,467,811,6,5355,297,0,2,9,4,69100,27532,5553,36676,1
47,2248,722,423,573,19,0,135,741,12,172,101,199,184,300,1320,2257,6,15668,870,0,2,15,6,69100,27534,5553,36678,1
43,1877,386,256,301,16,9,68,402,4,59,35,69,63,104,355,621,2,1453,80,0,2,5,2,69100,27534,5553,36679,1
16,1245,215,129,180,6,0,29,221,8,65,43,72,73,115,415,711,4,3153,175,0,2,13,9,69100,27534,5553,36680,1
84,3236,1043,504,840,53,9,147,1096,9,180,112,198,189,310,1377,2344,4,11604,644,0,2,12,5,69100,27536,5553,36681,1
14,534,295,56,236,0,4,54,295,2,9,5,10,11,15,30,51,1,57,3,0,2,4,1,69100,27538,5553,36682,1
30,1245,373,158,315,8,0,51,381,5,76,44,79,81,123,486,779,2,2026,112,0,2,3,2,69100,27538,5553,36683,1
77,3225,1178,367,1042,6,15,115,1184,9,94,51,95,103,146,644,976,4,4439,246,0,2,8,3,69100,27538,5553,36684,1
99,5086,1943,715,1694,26,18,214,1969,12,185,120,237,197,357,1436,2721,7,20915,1161,0,2,10,3,69100,27540,5553,36685,1
30,1272,442,244,305,14,16,103,456,11,68,45,75,79,120,452,756,6,4588,254,0,2,4,1,69100,27542,5553,36686,1
51,1917,1098,241,925,5,10,155,1103,7,46,25,49,53,74,273,423,3,1580,87,0,2,7,3,69110,27544,5553,36687,1
41,1474,601,196,481,2,23,85,603,8,63,36,72,71,108,400,664,4,3036,168,0,2,3,2,69110,27544,5553,36688,1
2,40,9,6,6,0,0,3,9,0,0,0,0,0,0,0,0,0,0,0,0,2,1,0,69110,27544,5553,36690,0
2,40,13,9,8,0,0,4,13,0,0,0,0,0,0,0,0,0,0,0,0,2,1,0,69110,27544,5553,36691,0
1,319,382,65,130,157,2,92,539,4,10,5,10,14,15,41,57,2,114,6,0,2,1,3,69110,27545,5554,36693,0
60,1078,282,196,195,3,0,86,285,8,130,71,141,138,212,936,1507,4,6538,363,0,2,3,2,69110,27545,5555,36694,0
4,77,127,75,83,2,11,30,129,4,14,7,14,18,21,61,87,2,175,9,0,2,2,1,69110,27545,5555,36695,0
4,77,652,304,544,16,6,88,668,6,89,51,101,95,152,591,998,3,3399,188,0,2,2,1,69110,27546,5555,36696,0
4,77,2,2,2,0,0,0,2,0,0,0,0,0,0,0,0,0,0,0,0,2,2,1,69110,27546,5555,36696,0
4,77,8,5,5,0,0,3,8,0,0,0,0,0,0,0,0,0,0,0,0,2,2,1,69110,27546,5555,36697,0
4,77,2,2,2,0,0,0,2,0,0,0,0,0,0,0,0,0,0,0,0,2,2,1,69110,27546,5555,36697,0
4,77,14,8,8,0,0,6,14,0,0,0,0,0,0,0,0,0,0,0,0,2,2,1,69110,27546,5555,36698,0
4,77,6,4,4,0,0,2,6,0,0,0,0,0,0,0,0,0,0,0,0,2,2,1,69110,27546,5555,36699,0
4,77,6,4,4,0,0,2,6,1,2,1,2,3,3,2,4,0,2,0,0,2,2,1,69110,27546,5555,36700,0
4,77,6,4,4,0,0,2,6,0,0,0,0,0,0,0,0,0,0,0,0,2,2,1,69110,27546,5555,36701,0
4,77,7,5,5,0,0,2,7,0,0,0,0,0,0,0,0,0,0,0,0,2,2,1,69110,27546,5555,36702,0
4,77,6,4,4,0,0,2,6,0,0,0,0,0,0,0,0,0,0,0,0,2,2,1,69110,27546,5555,36703,0
4,77,10,6,6,0,0,4,10,0,0,0,0,0,0,0,0,0,0,0,0,2,2,1,69110,27546,5555,36704,0
4,77,1,1,1,0,0,0,1,0,0,0,0,0,0,0,0,0,0,0,0,2,2,1,69110,27546,5555,36704,0
4,77,14,10,10,0,0,4,14,1,1,1,1,2,2,0,2,0,1,0,0,2,2,1,69110,27546,5555,36705,0
4,77,46,26,30,3,0,12,49,3,6,3,6,9,9,20,28,1,42,2,0,2,2,1,69120,27546,5555,36706,0
7,296,72,33,56,0,4,12,72,1,1,1,1,2,2,0,2,0,1,0,0,2,1,0,69120,27546,5555,36707,0
12,229,127,75,83,2,11,30,129,4,14,7,14,18,21,61,87,2,175,9,0,2,0,1,69120,27546,5555,36708,0
12,229,652,304,544,16,6,88,668,6,89,51,101,95,152,591,998,3,3399,188,0,2,0,1,69120,27547,5555,36709,0
12,229,2,2,2,0,0,0,2,0,0,0,0,0,0,0,0,0,0,0,0,2,0,1,69120,27547,5555,36709,0
12,229,8,5,5,0,0,3,8,0,0,0,0,0,0,0,0,0,0,0,0,2,0,1,69120,27547,5555,36710,0
12,229,2,2,2,0,0,0,2,0,0,0,0,0,0,0,0,0,0,0,0,2,0,1,69120,27547,5555,36710,0
12,229,14,8,8,0,0,6,14,0,0,0,0,0,0,0,0,0,0,0,0,2,0,1,69120,27547,5555,36711,0
12,229,6,4,4,0,0,2,6,0,0,0,0,0,0,0,0,0,0,0,0,2,0,1,69120,27547,5555,36712,0
12,229,6,4,4,0,0,2,6,1,2,1,2,3,3,2,4,0,2,0,0,2,0,1,69120,27547,5555,36713,0
12,229,6,4,4,0,0,2,6,0,0,0,0,0,0,0,0,0,0,0,0,2,0,1,69120,27547,5555,36714,0
12,229,7,5,5,0,0,2,7,0,0,0,0,0,0,0,0,0,0,0,0,2,0,1,69120,27547,5555,36715,0
12,229,6,4,4,0,0,2,6,0,0,0,0,0,0,0,0,0,0,0,0,2,0,1,69120,27547,5555,36716,0
12,229,10,6,6,0,0,4,10,0,0,0,0,0,0,0,0,0,0,0,0,2,0,1,69120,27547,5555,36717,0
12,229,1,1,1,0,0,0,1,0,0,0,0,0,0,0,0,0,0,0,0,2,0,1,69120,27547,5555,36717,0
12,229,14,10,10,0,0,4,14,1,1,1,1,2,2,0,2,0,1,0,0,2,0,1,69120,27547,5555,36718,0
12,229,46,26,30,3,0,12,49,3,6,3,6,9,9,20,28,1,42,2,0,2,0,1,69130,27547,5555,36719,0
6,71,127,75,83,2,11,30,129,4,14,7,14,18,21,61,87,2,175,9,0,2,1,0,69130,27547,5555,36720,0
6,71,652,304,544,16,6,88,668,6,89,51,101,95,152,591,998,3,3399,188,0,2,1,0,69130,27548,5555,36721,0
6,71,2,2,2,0,0,0,2,0,0,0,0,0,0,0,0,0,0,0,0,2,1,0,69130,27548,5555,36721,0
6,71,8,5,5,0,0,3,8,0,0,0,0,0,0,0,0,0,0,0,0,2,1,0,69130,27548,5555,36722,0
6,71,2,2,2,0,0,0,2,0,0,0,0,0,0,0,0,0,0,0,0,2,1,0,69130,27548,5555,36722,0
6,71,14,8,8,0,0,6,14,0,0,0,0,0,0,0,0,0,0,0,0,2,1,0,69130,27548,5555,36723,0
6,71,6,4,4,0,0,2,6,0,0,0,0,0,0,0,0,0,0,0,0,2,1,0,69130,27548,5555,36724,0
6,71,6,4,4,0,0,2,6,1,2,1,2,3,3,2,4,0,2,0,0,2,1,0,69130,27548,5555,36725,0
6,71,6,4,4,0,0,2,6,0,0,0,0,0,0,0,0,0,0,0,0,2,1,0,69130,27548,5555,36726,0
6,71,7,5,5,0,0,2,7,0,0,0,0,0,0,0,0,0,0,0,0,2,1,0,69130,27548,5555,36727,0
6,71,6,4,4,0,0,2,6,0,0,0,0,0,0,0,0,0,0,0,0,2,1,0,69130,27548,5555,36728,0
6,71,10,6,6,0,0,4,10,0,0,0,0,0,0,0,0,0,0,0,0,2,1,0,69130,27548,5555,36729,0
6,71,1,1,1,0,0,0,1,0,0,0,0,0,0,0,0,0,0,0,0,2,1,0,69130,27548,5555,36729,0
6,71,14,10,10,0,0,4,14,1,1,1,1,2,2,0,2,0,1,0,0,2,1,0,69130,27548,5555,36730,0
6,71,46,26,30,3,0,12,49,3,6,3,6,9,9,20,28,1,42,2,0,2,1,0,69140,27548,5555,36731,0
17,378,85,59,61,8,0,16,93,5,18,10,18,23,28,86,126,2,316,17,0,2,1,0,69140,27548,5555,36732,0
12,515,124,78,88,2,3,26,126,4,13,7,13,17,20,56,81,2,163,9,0,2,6,2,69140,27548,5555,36733,0
1,86,42,7,35,4,0,5,46,1,2,1,2,3,3,2,4,0,2,0,0,2,1,0,69140,27548,5555,36734,0
1,86,11,6,10,0,0,1,11,2,4,2,4,6,6,10,15,1,15,0,0,2,1,0,69140,27548,5555,36735,0
11,242,19,8,11,5,0,4,24,2,5,3,6,7,9,13,25,1,30,1,0,2,5,2,69140,27548,5555,36736,0
11,242,102,59,69,5,3,24,107,6,22,15,28,28,43,113,206,3,789,43,0,2,5,2,69140,27548,5555,36737,0
11,242,106,40,36,3,49,17,109,8,17,13,23,25,36,93,167,5,904,50,0,2,5,2,69140,27548,5555,36738,0
222,4859,182,127,129,0,0,53,182,5,39,21,42,44,63,217,343,2,926,51,0,2,15,7,69150,27552,5557,36746,0
222,4859,1165,710,800,67,119,181,1232,18,243,153,282,261,435,2000,3492,10,36473,2026,1,2,15,7,69160,27552,5558,36747,0
68,1565,773,419,590,28,0,166,801,10,204,113,217,214,330,1598,2554,5,13587,754,0,2,8,5,69160,27552,5559,36748,0
68,1565,421,273,302,44,34,57,465,17,81,59,107,98,166,583,1098,11,12329,684,0,2,8,5,69160,27552,5560,36749,0
26,529,2,2,2,0,0,0,2,0,0,0,0,0,0,0,0,0,0,0,0,2,6,2,69160,27552,5560,36749,0
26,529,99,48,90,1,3,5,100,0,0,0,0,0,0,0,0,0,0,0,0,2,6,2,69160,27553,5560,36750,0
26,529,8,5,5,2,0,1,10,0,0,0,0,0,0,0,0,0,0,0,0,2,6,2,69160,27553,5560,36751,0
26,529,1217,716,841,84,126,174,1301,14,185,118,215,199,333,1446,2542,8,20687,1149,0,2,6,2,69170,27555,5560,36752,0
26,529,160,89,115,0,13,31,160,7,15,11,17,22,28,78,124,3,495,27,0,2,6,2,69170,27555,5560,36753,0
26,529,10,10,9,9,0,0,19,0,0,0,0,0,0,0,0,0,0,0,0,2,6,2,69170,27555,5561,36754,0
26,529,173,84,99,8,29,36,181,5,12,7,13,17,20,54,81,2,221,12,0,2,6,2,69170,27556,5561,36755,0
26,529,3,1,1,3,0,0,6,0,0,0,0,0,0,0,0,0,0,0,0,2,6,2,69170,27556,5561,36756,0
180,5401,1660,832,1314,41,38,274,1701,20,312,209,395,332,604,2671,5058,12,64042,3557,1,2,7,4,69170,27558,5562,36758,0
180,5401,1057,646,719,113,100,145,1170,18,215,134,248,233,382,1740,3004,10,31186,1732,1,2,7,4,69180,27559,5563,36759,0
17,348,95,58,50,9,16,20,104,12,33,24,45,45,69,209,378,8,3100,172,0,2,4,1,69180,27559,5563,36760,0
89,1829,477,336,357,30,23,73,507,16,194,134,250,210,384,1538,2962,10,30538,1696,0,2,6,2,69190,27560,5563,36761,0
76,1743,996,429,845,24,10,117,1020,7,76,50,88,83,138,494,879,4,3565,198,0,2,9,5,69190,27562,5563,36762,0
76,1743,456,277,329,12,42,72,468,13,85,50,97,98,147,592,972,7,7212,400,0,2,9,5,69190,27562,5563,36763,0
154,3265,1513,682,1277,25,13,200,1538,11,199,116,219,210,335,1557,2584,6,15641,868,0,2,6,3,69190,27564,5563,36764,0
154,3265,819,519,539,24,98,155,843,15,96,57,106,111,163,690,1107,8,9171,509,0,2,6,3,69200,27566,5563,36765,0
70,1395,207,111,150,11,0,50,218,5,26,19,36,31,55,133,272,3,943,52,0,2,7,4,69200,27566,5563,36766,0
70,1395,410,198,237,31,55,97,441,11,63,38,72,74,110,414,683,6,4293,238,0,2,7,4,69210,27567,5564,36767,0
218,4751,2,2,2,0,0,0,2,0,0,0,0,0,0,0,0,0,0,0,0,2,20,13,69210,27567,5564,36767,0
218,4751,99,48,90,1,3,5,100,0,0,0,0,0,0,0,0,0,0,0,0,2,20,13,69210,27568,5564,36768,0
218,4751,8,5,5,2,0,1,10,0,0,0,0,0,0,0,0,0,0,0,0,2,20,13,69210,27568,5564,36769,0
218,4751,1217,716,841,84,126,174,1301,14,185,118,215,199,333,1446,2542,8,20687,1149,0,2,20,13,69220,27570,5564,36770,0
218,4751,160,89,115,0,13,31,160,7,15,11,17,22,28,78,124,3,495,27,0,2,20,13,69220,27570,5564,36771,0
218,4751,10,10,9,9,0,0,19,0,0,0,0,0,0,0,0,0,0,0,0,2,20,13,69220,27570,5565,36772,0
218,4751,173,84,99,8,29,36,181,5,12,7,13,17,20,54,81,2,221,12,0,2,20,13,69220,27571,5565,36773,0
218,4751,3,1,1,3,0,0,6,0,0,0,0,0,0,0,0,0,0,0,0,2,20,13,69220,27571,5565,36774,0
97,1999,463,295,324,28,62,57,491,12,134,82,154,146,236,989,1696,6,11700,650,0,2,3,4,69230,27572,5565,36775,0
51,757,167,116,138,4,5,22,171,8,48,30,56,56,86,292,499,4,2330,129,0,2,3,1,69230,27572,5565,36776,0
37,1105,339,213,244,17,9,65,356,10,42,26,48,52,74,259,421,5,2410,133,0,2,3,17,69240,27572,5565,36777,0
85,2182,1455,414,1257,16,76,112,1471,5,41,23,46,46,69,231,381,2,1069,59,0,2,8,4,69240,27573,5565,36779,0
85,2182,669,365,481,22,61,110,691,15,103,63,122,118,185,747,1273,8,11311,628,0,2,8,4,69250,27573,5566,36780,0
258,6040,4293,999,3693,19,54,507,4312,9,155,88,170,164,258,1156,1898,4,9368,520,0,2,26,23,69250,27575,5566,36781,0
258,6040,1482,859,1002,125,135,219,1607,16,219,134,251,235,385,1766,3032,9,27804,1544,1,2,26,23,69260,27576,5566,36782,0
6,140,44,22,19,0,19,6,44,2,10,6,12,12,18,35,64,1,77,4,0,2,3,1,69260,27576,5566,36783,0
27,968,74,35,59,1,0,14,75,3,14,7,14,17,21,58,85,1,128,7,0,2,8,4,69260,27577,5566,36784,0
27,968,245,125,200,5,7,34,250,7,30,17,34,37,51,166,265,3,1053,58,0,2,8,4,69270,27578,5566,36785,0
53,633,647,139,84,35,284,233,682,0,0,0,0,0,0,0,0,0,0,0,0,2,1,1,69270,27578,5566,36786,0
98,2670,1523,757,1297,19,12,193,1542,12,193,117,230,205,347,1508,2664,7,19053,1058,0,2,6,2,69280,27580,5566,36787,0
98,2670,701,378,504,33,58,109,734,13,110,68,126,123,194,794,1346,7,10027,557,0,2,6,2,69280,27581,5567,36788,0
94,2438,773,422,505,30,103,129,803,14,77,46,83,91,129,535,839,7,6334,351,0,2,9,6,69290,27582,5568,36789,0
142,3319,77,34,69,0,0,8,77,3,24,16,29,27,45,114,213,1,387,21,0,2,9,6,69290,27582,5568,36790,0
142,3319,712,438,573,51,9,84,763,14,102,71,128,116,199,733,1364,8,11988,666,0,2,9,6,69300,27583,5568,36791,0
24,628,2,2,2,0,0,0,2,0,0,0,0,0,0,0,0,0,0,0,0,2,15,13,69300,27583,5568,36791,0
24,628,99,48,90,1,3,5,100,0,0,0,0,0,0,0,0,0,0,0,0,2,15,13,69300,27584,5568,36792,0
24,628,8,5,5,2,0,1,10,0,0,0,0,0,0,0,0,0,0,0,0,2,15,13,69300,27584,5568,36793,0
24,628,1217,716,841,84,126,174,1301,14,185,118,215,199,333,1446,2542,8,20687,1149,0,2,15,13,69310,27586,5568,36794,0
24,628,160,89,115,0,13,31,160,7,15,11,17,22,28,78,124,3,495,27,0,2,15,13,69310,27586,5568,36795,0
24,628,10,10,9,9,0,0,19,0,0,0,0,0,0,0,0,0,0,0,0,2,15,13,69310,27586,5569,36796,0
24,628,173,84,99,8,29,36,181,5,12,7,13,17,20,54,81,2,221,12,0,2,15,13,69310,27587,5569,36797,0
24,628,3,1,1,3,0,0,6,0,0,0,0,0,0,0,0,0,0,0,0,2,15,13,69310,27587,5569,36798,0
30,664,125,97,103,3,0,19,128,9,25,17,27,34,44,144,223,4,1087,60,0,2,5,3,69310,27587,5570,36799,0
23,367,102,57,55,5,16,25,107,5,17,10,18,22,28,81,124,2,330,18,0,2,2,1,69310,27587,5570,36800,0
88,1899,402,202,227,24,74,80,426,12,52,33,61,64,94,339,564,7,3969,220,0,2,6,3,69310,27588,5570,36801,0
52,1075,447,308,343,6,5,95,453,7,96,59,111,103,170,651,1136,4,4600,255,0,2,4,2,69310,27591,5570,36802,0
52,1075,322,174,179,16,74,51,338,10,41,26,46,51,72,252,408,5,2291,127,0,2,4,2,69310,27594,5571,36803,0
88,1993,53,23,39,0,0,13,53,2,8,4,8,10,12,26,39,1,39,2,0,2,8,6,69310,27594,5571,36804,0
88,1993,515,298,307,33,80,99,548,12,63,44,77,75,121,419,753,7,5527,307,0,2,8,6,69320,27594,5571,36805,0
23,389,424,94,331,4,0,89,428,1,5,5,5,6,10,11,25,0,12,0,0,2,6,2,69320,27595,5571,36806,0
23,389,38,23,23,6,0,8,44,3,11,7,11,14,18,42,68,1,102,5,0,2,6,2,69320,27595,5571,36807,0
20,526,205,80,86,16,53,53,221,7,18,10,19,25,29,94,134,3,497,27,0,2,4,1,69330,27595,5572,36808,0
17,523,184,100,137,2,15,30,186,6,38,20,39,44,59,214,322,3,991,55,0,2,7,3,69330,27596,5572,36809,0
17,523,103,65,74,8,5,16,111,7,17,9,17,24,26,89,119,3,417,23,0,2,7,3,69330,27597,5572,36810,0
52,1151,91,45,69,0,3,18,91,3,9,6,10,12,16,33,57,1,95,5,0,2,13,10,69330,27599,5572,36811,0
52,1151,367,234,237,17,34,68,384,16,55,34,61,71,95,381,584,8,5183,287,0,2,13,10,69330,27600,5572,36812,0
244,5842,722,423,573,19,0,135,741,12,172,101,199,184,300,1320,2257,6,15668,870,0,2,13,9,69330,27602,5572,36814,0
244,5842,1508,847,911,44,250,301,1552,14,148,88,169,162,257,1120,1886,7,15077,837,0,2,13,9,69330,27603,5573,36815,0
305,6844,72,33,56,0,4,12,72,1,1,1,1,2,2,0,2,0,1,0,0,2,30,32,69330,27603,5573,36816,0
305,6844,1454,835,1044,76,110,219,1530,17,275,158,296,292,454,2297,3718,9,34017,1889,1,2,30,32,69340,27604,5573,36817,0
91,1836,757,253,292,73,244,162,830,13,61,38,67,74,105,409,651,7,4654,258,0,2,6,6,69340,27605,5573,36818,0
43,902,386,256,301,16,9,68,402,4,59,35,69,63,104,355,621,2,1453,80,0,2,4,3,69340,27605,5573,36819,0
43,902,264,131,164,11,41,46,275,6,38,22,40,44,62,214,338,3,1068,59,0,2,4,3,69350,27605,5574,36820,0
28,707,466,257,367,18,25,50,484,7,126,86,171,133,257,898,1813,4,8612,478,0,2,1,0,69350,27605,5574,36821,0
28,707,507,281,342,29,59,88,536,10,53,29,57,63,86,336,514,5,2764,153,0,2,1,0,69350,27605,5574,36822,0
30,658,215,129,180,6,0,29,221,8,65,43,72,73,115,415,711,4,3153,175,0,2,5,2,69350,27605,5574,36823,0
30,658,97,69,77,3,3,16,100,6,22,13,23,28,36,113,173,3,542,30,0,2,5,2,69350,27606,5574,36824,0
92,1975,1043,504,840,53,9,147,1096,9,180,112,198,189,310,1377,2344,4,11604,644,0,2,10,4,69350,27608,5574,36825,0
92,1975,383,288,292,26,6,62,409,11,65,38,67,76,105,429,656,5,3719,206,0,2,10,4,69350,27609,5574,36826,0
20,420,294,64,250,0,0,43,294,1,20,10,20,21,30,86,131,0,65,3,0,2,5,2,69350,27609,5574,36827,0
20,420,78,46,62,3,0,14,81,3,8,4,8,11,12,28,41,1,62,3,0,2,5,2,69350,27610,5574,36828,0
5,123,110,30,77,3,13,16,113,4,21,15,30,25,45,100,208,2,597,33,0,2,3,1,69350,27610,5574,36829,0
5,123,28,15,21,1,0,6,29,0,0,0,0,0,0,0,0,0,0,0,0,2,3,1,69350,27610,5574,36830,0
70,1394,1178,367,1042,6,15,115,1184,9,94,51,95,103,146,644,976,4,4439,246,0,2,6,2,69350,27610,5574,36831,0
70,1394,177,108,140,8,0,27,185,6,30,16,32,36,48,162,248,3,794,44,0,2,6,2,69350,27612,5574,36832,0
226,4927,1943,715,1694,26,18,214,1969,12,185,120,237,197,357,1436,2721,7,20915,1161,0,2,11,14,69350,27614,5574,36833,0
226,4927,1168,838,957,57,25,144,1225,19,348,224,416,367,640,3018,5452,11,61921,3440,1,2,11,14,69360,27616,5574,36834,0
19,682,442,244,305,14,16,103,456,11,68,45,75,79,120,452,756,6,4588,254,0,2,13,12,69360,27618,5574,36835,0
19,682,182,102,99,11,40,35,193,3,11,6,11,14,17,42,64,1,97,5,0,2,13,12,69360,27619,5574,36836,0
62,1255,1098,241,925,5,10,155,1103,7,46,25,49,53,74,273,423,3,1580,87,0,2,11,5,69370,27621,5574,36837,0
62,1255,282,202,222,14,2,44,296,8,42,24,43,50,67,250,378,4,1548,86,0,2,11,5,69370,27622,5574,36838,0
29,728,601,196,481,2,23,85,603,8,63,36,72,71,108,400,664,4,3036,168,0,2,3,2,69370,27622,5574,36839,0
29,728,156,79,106,5,16,28,161,5,14,8,15,19,23,64,97,2,261,14,0,2,3,2,69370,27622,5574,36840,0
99,4089,1289,550,1043,56,32,155,1345,10,167,93,185,177,278,1266,2075,5,11498,638,0,2,7,3,69370,27624,5575,36841,0
35,1083,182,127,129,0,0,53,182,5,39,21,42,44,63,217,343,2,926,51,0,2,6,4,69370,27624,5576,36842,0
152,7159,1392,870,1177,35,17,170,1427,14,494,280,531,508,811,4473,7289,7,54850,3047,2,2,11,10,69370,27627,5577,36843,0
90,2889,773,419,590,28,0,166,801,10,204,113,217,214,330,1598,2554,5,13587,754,0,2,6,2,69370,27627,5578,36844,0
25,1187,75,38,59,1,3,12,76,2,4,2,4,6,6,10,15,1,15,0,0,2,3,1,69370,27627,5578,36845,0
8,263,51,25,36,0,0,15,51,3,11,6,12,14,18,42,68,1,112,6,0,2,2,1,69370,27627,5578,36846,0
2,51,14,9,9,0,0,5,14,0,0,0,0,0,0,0,0,0,0,0,0,2,2,1,69370,27627,5578,36847,0
1,134,149,67,118,4,0,27,153,1,17,14,28,18,42,69,175,0,144,8,0,2,1,0,69370,27627,5578,36848,0
34,2285,1157,318,931,29,22,177,1186,6,104,63,125,110,188,712,1274,3,4596,255,0,2,1,1,69370,27627,5578,36849,0
63,4333,520,294,400,33,13,81,553,10,261,204,367,271,571,2128,4614,7,32445,1802,1,2,6,5,69370,27628,5578,36850,0
180,8011,139,89,101,2,0,35,141,7,54,34,62,61,96,330,569,4,2287,127,0,2,3,2,69370,27628,5578,36851,0
180,8011,7,5,5,0,0,2,7,1,2,1,2,3,3,2,4,0,2,0,0,2,3,2,69370,27628,5578,36852,0
138,6148,1782,648,1425,9,47,279,1791,8,171,97,189,179,286,1292,2140,4,9462,525,0,2,5,3,69370,27629,5579,36853,0
25,684,256,139,192,9,7,47,265,4,23,12,24,27,36,112,171,2,357,19,0,2,3,2,69370,27630,5579,36854,0
23,583,102,59,69,5,3,24,107,6,22,15,28,28,43,113,206,3,789,43,0,2,5,1,69370,27630,5579,36855,0
111,4174,1450,624,1228,12,26,181,1462,14,306,186,354,320,540,2580,4493,8,36391,2021,1,2,8,4,69370,27632,5580,36856,0
166,4983,1660,832,1314,41,38,274,1701,20,312,209,395,332,604,2671,5058,12,64042,3557,1,2,8,7,69370,27634,5581,36858,0
44,3230,996,429,845,24,10,117,1020,7,76,50,88,83,138,494,879,4,3565,198,0,2,6,3,69370,27636,5581,36859,0
128,5336,1513,682,1277,25,13,200,1538,11,199,116,219,210,335,1557,2584,6,15641,868,0,2,10,6,69370,27638,5581,36860,0
75,3910,1296,573,1062,40,33,157,1336,8,201,118,231,209,349,1561,2689,4,12365,686,0,2,8,3,69370,27638,5581,36861,0
19,453,207,111,150,11,0,50,218,5,26,19,36,31,55,133,272,3,943,52,0,2,8,2,69370,27638,5581,36862,0
92,4718,1457,730,1242,11,6,188,1468,10,292,166,329,302,495,2424,4078,5,22973,1276,1,2,8,3,69370,27640,5581,36863,0
40,2521,652,304,544,16,6,88,668,6,89,51,101,95,152,591,998,3,3399,188,0,2,8,2,69370,27641,5581,36864,0
70,3216,1455,414,1257,16,76,112,1471,5,41,23,46,46,69,231,381,2,1069,59,0,2,9,3,69370,27642,5581,36865,0
2,79,7,6,5,0,0,2,7,1,1,1,2,2,3,0,3,1,3,0,0,2,4,1,69370,27642,5581,36866,0
8,275,74,35,59,1,0,14,75,3,14,7,14,17,21,58,85,1,128,7,0,2,5,2,69370,27643,5581,36867,0
96,4695,1523,757,1297,19,12,193,1542,12,193,117,230,205,347,1508,2664,7,19053,1058,0,2,9,5,69380,27645,5581,36868,0
97,4232,1020,354,843,12,15,144,1032,8,134,77,144,142,221,970,1580,4,6792,377,0,2,4,1,69380,27645,5581,36869,0
42,1903,447,308,343,6,5,95,453,7,96,59,111,103,170,651,1136,4,4600,255,0,2,4,1,69380,27648,5581,36870,0
2,145,53,23,39,0,0,13,53,2,8,4,8,10,12,26,39,1,39,2,0,2,0,1,69380,27648,5581,36871,0
21,662,424,94,331,4,0,89,428,1,5,5,5,6,10,11,25,0,12,0,0,2,4,1,69380,27649,5581,36872,0
38,2306,334,251,279,10,4,40,344,5,127,74,143,132,217,899,1528,2,4303,239,0,2,7,2,69380,27650,5581,36873,0
12,497,184,100,137,2,15,30,186,6,38,20,39,44,59,214,322,3,991,55,0,2,5,1,69380,27651,5581,36874,0
64,2936,1293,570,1093,25,15,163,1318,10,195,123,241,205,364,1516,2795,6,17273,959,0,2,13,4,69390,27653,5581,36875,0
33,1897,384,251,317,7,8,52,391,11,70,44,84,81,128,467,811,6,5355,297,0,2,9,4,69390,27653,5581,36876,0
47,2248,722,423,573,19,0,135,741,12,172,101,199,184,300,1320,2257,6,15668,870,0,2,15,6,69390,27655,5581,36878,0
43,1877,386,256,301,16,9,68,402,4,59,35,69,63,104,355,621,2,1453,80,0,2,5,2,69390,27655,5581,36879,0
16,1245,215,129,180,6,0,29,221,8,65,43,72,73,115,415,711,4,3153,175,0,2,13,9,69390,27655,5581,36880,0
84,3236,1043,504,840,53,9,147,1096,9,180,112,198,189,310,1377,2344,4,11604,644,0,2,12,5,69390,27657,5581,36881,0
14,534,295,56,236,0,4,54,295,2,9,5,10,11,15,30,51,1,57,3,0,2,4,1,69390,27659,5581,36882,0
30,1245,373,158,315,8,0,51,381,5,76,44,79,81,123,486,779,2,2026,112,0,2,3,2,69390,27659,5581,36883,0
77,3225,1178,367,1042,6,15,115,1184,9,94,51,95,103,146,644,976,4,4439,246,0,2,8,3,69390,27659,5581,36884,0
99,5086,1943,715,1694,26,18,214,1969,12,185,120,237,197,357,1436,2721,7,20915,1161,0,2,10,3,69390,27661,5581,36885,0
30,1272,442,244,305,14,16,103,456,11,68,45,75,79,120,452,756,6,4588,254,0,2,4,1,69390,27663,5581,36886,0
51,1917,1098,241,925,5,10,155,1103,7,46,25,49,53,74,273,423,3,1580,87,0,2,7,3,69400,27665,5581,36887,0
41,1474,601,196,481,2,23,85,603,8,63,36,72,71,108,400,664,4,3036,168,0,2,3,2,69400,27665,5581,36888,0
45,919,386,256,301,16,9,68,402,4,59,35,69,63,104,355,621,2,1453,80,0,2,12,6,69400,27665,5581,36889,1
45,919,264,131,164,11,41,46,275,6,38,22,40,44,62,214,338,3,1068,59,0,2,12,6,69410,27665,5582,36890,1
44,1910,386,256,301,16,9,68,402,4,59,35,69,63,104,355,621,2,1453,80,0,2,6,0,69410,27665,5582,36891,1
142,3324,77,34,69,0,0,8,77,3,24,16,29,27,45,114,213,1,387,21,0,2,10,9,69410,27665,5582,36892,0
142,3324,712,438,573,51,9,84,763,14,102,71,128,116,199,733,1364,8,11988,666,0,2,10,9,69420,27666,5582,36893,0
303,6802,72,33,56,0,4,12,72,1,1,1,1,2,2,0,2,0,1,0,0,2,0,9,69420,27666,5582,36894,0
303,6802,1454,835,1044,76,110,219,1530,17,275,158,296,292,454,2297,3718,9,34017,1889,1,2,0,9,69430,27667,5582,36895,0
30,1245,373,158,315,8,0,51,381,5,76,44,79,81,123,486,779,2,2026,112,0,2,1,1,69430,27667,5582,36896,0
45,919,386,256,301,16,9,68,402,4,59,35,69,63,104,355,621,2,1453,80,0,2,12,6,69430,27667,5582,36897,0
45,919,264,131,164,11,41,46,275,6,38,22,40,44,62,214,338,3,1068,59,0,2,12,6,69440,27667,5583,36898,0
44,1910,386,256,301,16,9,68,402,4,59,35,69,63,104,355,621,2,1453,80,0,2,6,0,69440,27667,5583,36899,0
54,1174,91,45,69,0,3,18,91,3,9,6,10,12,16,33,57,1,95,5,0,2,10,4,69440,27669,5583,36900,0
54,1174,367,234,237,17,34,68,384,16,55,34,61,71,95,381,584,8,5183,287,0,2,10,4,69440,27670,5583,36901,0
31,1314,442,244,305,14,16,103,456,11,68,45,75,79,120,452,756,6,4588,254,0,2,8,1,69440,27672,5583,36902,0
218,4738,2,2,2,0,0,0,2,0,0,0,0,0,0,0,0,0,0,0,0,2,6,6,69440,27672,5583,36902,0
218,4738,99,48,90,1,3,5,100,0,0,0,0,0,0,0,0,0,0,0,0,2,6,6,69440,27673,5583,36903,0
218,4738,8,5,5,2,0,1,10,0,0,0,0,0,0,0,0,0,0,0,0,2,6,6,69440,27673,5583,36904,0
218,4738,1217,716,841,84,126,174,1301,14,185,118,215,199,333,1446,2542,8,20687,1149,0,2,6,6,69450,27675,5583,36905,0
218,4738,160,89,115,0,13,31,160,7,15,11,17,22,28,78,124,3,495,27,0,2,6,6,69450,27675,5583,36906,0
218,4738,10,10,9,9,0,0,19,0,0,0,0,0,0,0,0,0,0,0,0,2,6,6,69450,27675,5584,36907,0
218,4738,173,84,99,8,29,36,181,5,12,7,13,17,20,54,81,2,221,12,0,2,6,6,69450,27676,5584,36908,0
218,4738,3,1,1,3,0,0,6,0,0,0,0,0,0,0,0,0,0,0,0,2,6,6,69450,27676,5584,36909,0
53,1176,91,45,69,0,3,18,91,3,9,6,10,12,16,33,57,1,95,5,0,2,1,1,69450,27678,5584,36910,1
53,1176,367,234,237,17,34,68,384,16,55,34,61,71,95,381,584,8,5183,287,0,2,1,1,69450,27679,5584,36911,1
303,6803,72,33,56,0,4,12,72,1,1,1,1,2,2,0,2,0,1,0,0,2,9,12,69450,27679,5584,36912,1
303,6803,1454,835,1044,76,110,219,1530,17,275,158,296,292,454,2297,3718,9,34017,1889,1,2,9,12,69460,27680,5584,36913,1
54,1188,91,45,69,0,3,18,91,3,9,6,10,12,16,33,57,1,95,5,0,2,10,4,69460,27682,5584,36914,0
54,1188,367,234,237,17,34,68,384,16,55,34,61,71,95,381,584,8,5183,287,0,2,10,4,69460,27683,5584,36915,0
31,1318,442,244,305,14,16,103,456,11,68,45,75,79,120,452,756,6,4588,254,0,2,8,1,69460,27685,5584,36916,0
54,1186,91,45,69,0,3,18,91,3,9,6,10,12,16,33,57,1,95,5,0,2,1,1,69460,27687,5584,36917,0
54,1186,367,234,237,17,34,68,384,16,55,34,61,71,95,381,584,8,5183,287,0,2,1,1,69460,27688,5584,36918,0
4,163,27,21,21,0,0,6,27,3,6,3,6,9,9,20,28,1,42,2,0,0,28,0,69460,27688,5584,36919,0
1,6,2,2,2,0,0,0,2,0,0,0,0,0,0,0,0,0,0,0,0,0,2,0,69460,27688,5584,36919,0
303,6803,72,33,56,0,4,12,72,1,1,1,1,2,2,0,2,0,1,0,0,2,9,12,69460,27688,5584,36920,0
303,6803,1454,835,1044,76,110,219,1530,17,275,158,296,292,454,2297,3718,9,34017,1889,1,2,9,12,69470,27689,5584,36921,0
218,4753,2,2,2,0,0,0,2,0,0,0,0,0,0,0,0,0,0,0,0,2,1,0,69470,27689,5584,36921,0
218,4753,99,48,90,1,3,5,100,0,0,0,0,0,0,0,0,0,0,0,0,2,1,0,69470,27690,5584,36922,0
218,4753,8,5,5,2,0,1,10,0,0,0,0,0,0,0,0,0,0,0,0,2,1,0,69470,27690,5584,36923,0
218,4753,1217,716,841,84,126,174,1301,14,185,118,215,199,333,1446,2542,8,20687,1149,0,2,1,0,69480,27692,5584,36924,0
218,4753,160,89,115,0,13,31,160,7,15,11,17,22,28,78,124,3,495,27,0,2,1,0,69480,27692,5584,36925,0
218,4753,10,10,9,9,0,0,19,0,0,0,0,0,0,0,0,0,0,0,0,2,1,0,69480,27692,5585,36926,0
218,4753,173,84,99,8,29,36,181,5,12,7,13,17,20,54,81,2,221,12,0,2,1,0,69480,27693,5585,36927,0
218,4753,3,1,1,3,0,0,6,0,0,0,0,0,0,0,0,0,0,0,0,2,1,0,69480,27693,5585,36928,0
25,397,219,78,157,11,5,46,230,3,24,20,34,27,54,114,256,2,545,30,0,0,102,0,69480,27694,5585,36929,0
25,397,108,64,79,9,0,20,117,5,15,11,19,20,30,70,129,3,410,22,0,0,102,0,69480,27694,5585,36930,0
44,3230,996,429,845,24,10,117,1020,7,76,50,88,83,138,494,879,4,3565,198,0,2,2,1,69480,27696,5585,36931,0
9,441,219,78,157,11,5,46,230,3,24,20,34,27,54,114,256,2,545,30,0,0,148,0,69480,27697,5585,36932,0
218,4753,2,2,2,0,0,0,2,0,0,0,0,0,0,0,0,0,0,0,0,2,6,6,69480,27697,5585,36932,0
218,4753,99,48,90,1,3,5,100,0,0,0,0,0,0,0,0,0,0,0,0,2,6,6,69480,27698,5585,36933,0
218,4753,8,5,5,2,0,1,10,0,0,0,0,0,0,0,0,0,0,0,0,2,6,6,69480,27698,5585,36934,0
218,4753,1217,716,841,84,126,174,1301,14,185,118,215,199,333,1446,2542,8,20687,1149,0,2,6,6,69490,27700,5585,36935,0
218,4753,160,89,115,0,13,31,160,7,15,11,17,22,28,78,124,3,495,27,0,2,6,6,69490,27700,5585,36936,0
218,4753,10,10,9,9,0,0,19,0,0,0,0,0,0,0,0,0,0,0,0,2,6,6,69490,27700,5586,36937,0
218,4753,173,84,99,8,29,36,181,5,12,7,13,17,20,54,81,2,221,12,0,2,6,6,69490,27701,5586,36938,0
218,4753,3,1,1,3,0,0,6,0,0,0,0,0,0,0,0,0,0,0,0,2,6,6,69490,27701,5586,36939,0
53,1159,91,45,69,0,3,18,91,3,9,6,10,12,16,33,57,1,95,5,0,2,11,5,69490,27703,5586,36940,0
53,1159,367,234,237,17,34,68,384,16,55,34,61,71,95,381,584,8,5183,287,0,2,11,5,69490,27704,5586,36941,0
45,919,386,256,301,16,9,68,402,4,59,35,69,63,104,355,621,2,1453,80,0,2,12,6,69490,27704,5586,36942,0
45,919,264,131,164,11,41,46,275,6,38,22,40,44,62,214,338,3,1068,59,0,2,12,6,69500,27704,5587,36943,0
4,163,27,21,21,0,0,6,27,3,6,3,6,9,9,20,28,1,42,2,0,0,28,0,69500,27704,5587,36944,0
1,6,2,2,2,0,0,0,2,0,0,0,0,0,0,0,0,0,0,0,0,0,2,0,69500,27704,5587,36944,0
44,1910,386,256,301,16,9,68,402,4,59,35,69,63,104,355,621,2,1453,80,0,2,6,0,69500,27704,5587,36945,0
31,1318,442,244,305,14,16,103,456,11,68,45,75,79,120,452,756,6,4588,254,0,2,8,1,69500,27706,5587,36946,0
218,4753,2,2,2,0,0,0,2,0,0,0,0,0,0,0,0,0,0,0,0,2,6,6,69500,27706,5587,36946,0
218,4753,99,48,90,1,3,5,100,0,0,0,0,0,0,0,0,0,0,0,0,2,6,6,69500,27707,5587,36947,0
218,4753,8,5,5,2,0,1,10,0,0,0,0,0,0,0,0,0,0,0,0,2,6,6,69500,27707,5587,36948,0
218,4753,1217,716,841,84,126,174,1301,14,185,118,215,199,333,1446,2542,8,20687,1149,0,2,6,6,69510,27709,5587,36949,0
218,4753,160,89,115,0,13,31,160,7,15,11,17,22,28,78,124,3,495,27,0,2,6,6,69510,27709,5587,36950,0
218,4753,10,10,9,9,0,0,19,0,0,0,0,0,0,0,0,0,0,0,0,2,6,6,69510,27709,5588,36951,0
218,4753,173,84,99,8,29,36,181,5,12,7,13,17,20,54,81,2,221,12,0,2,6,6,69510,27710,5588,36952,0
218,4753,3,1,1,3,0,0,6,0,0,0,0,0,0,0,0,0,0,0,0,2,6,6,69510,27710,5588,36953,0
53,1159,91,45,69,0,3,18,91,3,9,6,10,12,16,33,57,1,95,5,0,2,11,5,69510,27712,5588,36954,0
53,1159,367,234,237,17,34,68,384,16,55,34,61,71,95,381,584,8,5183,287,0,2,11,5,69510,27713,5588,36955,0
45,919,386,256,301,16,9,68,402,4,59,35,69,63,104,355,621,2,1453,80,0,2,12,6,69510,27713,5588,36956,0
45,919,264,131,164,11,41,46,275,6,38,22,40,44,62,214,338,3,1068,59,0,2,12,6,69520,27713,5589,36957,0
4,163,27,21,21,0,0,6,27,3,6,3,6,9,9,20,28,1,42,2,0,0,28,0,69520,27713,5589,36958,0
1,6,2,2,2,0,0,0,2,0,0,0,0,0,0,0,0,0,0,0,0,0,2,0,69520,27713,5589,36958,0
44,1910,386,256,301,16,9,68,402,4,59,35,69,63,104,355,621,2,1453,80,0,2,6,0,69520,27713,5589,36959,0
31,1318,442,244,305,14,16,103,456,11,68,45,75,79,120,452,756,6,4588,254,0,2,8,1,69520,27715,5589,36960,0
68,1562,773,419,590,28,0,166,801,10,204,113,217,214,330,1598,2554,5,13587,754,0,2,3,5,69520,27715,5590,36961,1
68,1562,421,273,302,44,34,57,465,17,81,59,107,98,166,583,1098,11,12329,684,0,2,3,5,69520,27715,5591,36962,1
68,1577,773,419,590,28,0,166,801,10,204,113,217,214,330,1598,2554,5,13587,754,0,2,6,1,69520,27715,5592,36963,1
68,1577,421,273,302,44,34,57,465,17,81,59,107,98,166,583,1098,11,12329,684,0,2,6,1,69520,27715,5593,36964,1
154,3265,1513,682,1277,25,13,200,1538,11,199,116,219,210,335,1557,2584,6,15641,868,0,2,1,1,69520,27717,5593,36965,0
154,3265,819,519,539,24,98,155,843,15,96,57,106,111,163,690,1107,8,9171,509,0,2,1,1,69530,27719,5593,36966,0
97,1999,463,295,324,28,62,57,491,12,134,82,154,146,236,989,1696,6,11700,650,0,2,1,1,69540,27720,5593,36967,0
256,6014,4293,999,3693,19,54,507,4312,9,155,88,170,164,258,1156,1898,4,9368,520,0,2,1,1,69540,27722,5593,36968,0
256,6014,1482,859,1002,125,135,219,1607,16,219,134,251,235,385,1766,3032,9,27804,1544,1,2,1,1,69550,27723,5593,36969,0
52,622,647,139,84,35,284,233,682,0,0,0,0,0,0,0,0,0,0,0,0,2,2,2,69550,27723,5593,36970,0
88,1899,402,202,227,24,74,80,426,12,52,33,61,64,94,339,564,7,3969,220,0,2,1,1,69550,27724,5593,36971,0
54,1186,91,45,69,0,3,18,91,3,9,6,10,12,16,33,57,1,95,5,0,2,5,5,69550,27726,5593,36972,0
54,1186,367,234,237,17,34,68,384,16,55,34,61,71,95,381,584,8,5183,287,0,2,5,5,69550,27727,5593,36973,0
305,6844,72,33,56,0,4,12,72,1,1,1,1,2,2,0,2,0,1,0,0,2,2,2,69550,27727,5593,36974,0
305,6844,1454,835,1044,76,110,219,1530,17,275,158,296,292,454,2297,3718,9,34017,1889,1,2,2,2,69560,27728,5593,36975,0
68,1577,773,419,590,28,0,166,801,10,204,113,217,214,330,1598,2554,5,13587,754,0,2,8,5,69560,27728,5594,36976,0
68,1577,421,273,302,44,34,57,465,17,81,59,107,98,166,583,1098,11,12329,684,0,2,8,5,69560,27728,5595,36977,0
147,3371,77,34,69,0,0,8,77,3,24,16,29,27,45,114,213,1,387,21,0,2,21,8,69560,27728,5595,36978,0
147,3371,712,438,573,51,9,84,763,14,102,71,128,116,199,733,1364,8,11988,666,0,2,21,8,69570,27729,5595,36979,0
304,6811,72,33,56,0,4,12,72,1,1,1,1,2,2,0,2,0,1,0,0,2,8,6,69570,27729,5595,36980,0
304,6811,1454,835,1044,76,110,219,1530,17,275,158,296,292,454,2297,3718,9,34017,1889,1,2,8,6,69580,27730,5595,36981,0
54,1186,91,45,69,0,3,18,91,3,9,6,10,12,16,33,57,1,95,5,0,2,1,1,69580,27732,5595,36982,0
54,1186,367,234,237,17,34,68,384,16,55,34,61,71,95,381,584,8,5183,287,0,2,1,1,69580,27733,5595,36983,0
154,3265,1513,682,1277,25,13,200,1538,11,199,116,219,210,335,1557,2584,6,15641,868,0,2,1,1,69580,27735,5595,36984,0
154,3265,819,519,539,24,98,155,843,15,96,57,106,111,163,690,1107,8,9171,509,0,2,1,1,69590,27737,5595,36985,0
97,1999,463,295,324,28,62,57,491,12,134,82,154,146,236,989,1696,6,11700,650,0,2,1,1,69600,27738,5595,36986,0
256,6014,4293,999,3693,19,54,507,4312,9,155,88,170,164,258,1156,1898,4,9368,520,0,2,1,1,69600,27740,5595,36987,0
256,6014,1482,859,1002,125,135,219,1607,16,219,134,251,235,385,1766,3032,9,27804,1544,1,2,1,1,69610,27741,5595,36988,0
52,622,647,139,84,35,284,233,682,0,0,0,0,0,0,0,0,0,0,0,0,2,2,2,69610,27741,5595,36989,0
88,1899,402,202,227,24,74,80,426,12,52,33,61,64,94,339,564,7,3969,220,0,2,1,1,69610,27742,5595,36990,0
54,1186,91,45,69,0,3,18,91,3,9,6,10,12,16,33,57,1,95,5,0,2,6,6,69610,27744,5595,36991,0
54,1186,367,234,237,17,34,68,384,16,55,34,61,71,95,381,584,8,5183,287,0,2,6,6,69610,27745,5595,36992,0
305,6844,72,33,56,0,4,12,72,1,1,1,1,2,2,0,2,0,1,0,0,2,2,2,69610,27745,5595,36993,0
305,6844,1454,835,1044,76,110,219,1530,17,275,158,296,292,454,2297,3718,9,34017,1889,1,2,2,2,69620,27746,5595,36994,0
147,3371,77,34,69,0,0,8,77,3,24,16,29,27,45,114,213,1,387,21,0,2,21,8,69620,27746,5595,36995,0
147,3371,712,438,573,51,9,84,763,14,102,71,128,116,199,733,1364,8,11988,666,0,2,21,8,69630,27747,5595,36996,0
304,6811,72,33,56,0,4,12,72,1,1,1,1,2,2,0,2,0,1,0,0,2,8,6,69630,27747,5595,36997,0
304,6811,1454,835,1044,76,110,219,1530,17,275,158,296,292,454,2297,3718,9,34017,1889,1,2,8,6,69640,27748,5595,36998,0
57,1214,91,45,69,0,3,18,91,3,9,6,10,12,16,33,57,1,95,5,0,2,17,7,69640,27750,5595,36999,0
57,1214,367,234,237,17,34,68,384,16,55,34,61,71,95,381,584,8,5183,287,0,2,17,7,69640,27751,5595,37000,0
8,377,91,45,69,0,3,18,91,3,9,6,10,12,16,33,57,1,95,5,0,3,18,0,69640,27753,5595,37001,0
77,1753,996,429,845,24,10,117,1020,7,76,50,88,83,138,494,879,4,3565,198,0,2,2,1,69640,27755,5595,37002,1
77,1753,456,277,329,12,42,72,468,13,85,50,97,98,147,592,972,7,7212,400,0,2,2,1,69640,27755,5595,37003,1
57,1214,91,45,69,0,3,18,91,3,9,6,10,12,16,33,57,1,95,5,0,2,17,7,69640,27757,5595,37004,0
57,1214,367,234,237,17,34,68,384,16,55,34,61,71,95,381,584,8,5183,287,0,2,17,7,69640,27758,5595,37005,0
8,377,91,45,69,0,3,18,91,3,9,6,10,12,16,33,57,1,95,5,0,3,18,0,69640,27760,5595,37006,0
7,298,72,33,56,0,4,12,72,1,1,1,1,2,2,0,2,0,1,0,0,2,2,2,69640,27760,5595,37007,0
257,6042,4293,999,3693,19,54,507,4312,9,155,88,170,164,258,1156,1898,4,9368,520,0,2,8,0,69640,27762,5595,37008,0
257,6042,1482,859,1002,125,135,219,1607,16,219,134,251,235,385,1766,3032,9,27804,1544,1,2,8,0,69650,27763,5595,37009,0
7,298,72,33,56,0,4,12,72,1,1,1,1,2,2,0,2,0,1,0,0,2,2,2,69650,27763,5595,37010,0
257,6042,4293,999,3693,19,54,507,4312,9,155,88,170,164,258,1156,1898,4,9368,520,0,2,8,0,69650,27765,5595,37011,0
257,6042,1482,859,1002,125,135,219,1607,16,219,134,251,235,385,1766,3032,9,27804,1544,1,2,8,0,69660,27766,5595,37012,0
155,3277,1513,682,1277,25,13,200,1538,11,199,116,219,210,335,1557,2584,6,15641,868,0,2,3,0,69660,27768,5595,37013,1
155,3277,819,519,539,24,98,155,843,15,96,57,106,111,163,690,1107,8,9171,509,0,2,3,0,69670,27770,5595,37014,1
40,1143,339,213,244,17,9,65,356,10,42,26,48,52,74,259,421,5,2410,133,0,2,8,2,69680,27770,5595,37015,1
65,3000,1293,570,1093,25,15,163,1318,10,195,123,241,205,364,1516,2795,6,17273,959,0,2,16,0,69690,27772,5595,37016,1
52,1096,447,308,343,6,5,95,453,7,96,59,111,103,170,651,1136,4,4600,255,0,2,5,3,69690,27775,5595,37017,1
52,1096,322,174,179,16,74,51,338,10,41,26,46,51,72,252,408,5,2291,127,0,2,5,3,69690,27778,5596,37018,1
42,1907,447,308,343,6,5,95,453,7,96,59,111,103,170,651,1136,4,4600,255,0,2,5,3,69690,27781,5596,37019,1
219,4759,2,2,2,0,0,0,2,0,0,0,0,0,0,0,0,0,0,0,0,2,28,25,69690,27781,5596,37019,1
219,4759,99,48,90,1,3,5,100,0,0,0,0,0,0,0,0,0,0,0,0,2,28,25,69690,27782,5596,37020,1
219,4759,8,5,5,2,0,1,10,0,0,0,0,0,0,0,0,0,0,0,0,2,28,25,69690,27782,5596,37021,1
219,4759,1217,716,841,84,126,174,1301,14,185,118,215,199,333,1446,2542,8,20687,1149,0,2,28,25,69700,27784,5596,37022,1
219,4759,160,89,115,0,13,31,160,7,15,11,17,22,28,78,124,3,495,27,0,2,28,25,69700,27784,5596,37023,1
219,4759,10,10,9,9,0,0,19,0,0,0,0,0,0,0,0,0,0,0,0,2,28,25,69700,27784,5597,37024,1
219,4759,173,84,99,8,29,36,181,5,12,7,13,17,20,54,81,2,221,12,0,2,28,25,69700,27785,5597,37025,1
219,4759,3,1,1,3,0,0,6,0,0,0,0,0,0,0,0,0,0,0,0,2,28,25,69700,27785,5597,37026,1
40,2521,652,304,544,16,6,88,668,6,89,51,101,95,152,591,998,3,3399,188,0,2,5,5,69700,27786,5597,37027,1
155,3277,1513,682,1277,25,13,200,1538,11,199,116,219,210,335,1557,2584,6,15641,868,0,2,3,0,69700,27788,5597,37028,0
155,3277,819,519,539,24,98,155,843,15,96,57,106,111,163,690,1107,8,9171,509,0,2,3,0,69710,27790,5597,37029,0
40,1143,339,213,244,17,9,65,356,10,42,26,48,52,74,259,421,5,2410,133,0,2,8,2,69720,27790,5597,37030,0
65,3000,1293,570,1093,25,15,163,1318,10,195,123,241,205,364,1516,2795,6,17273,959,0,2,16,0,69730,27792,5597,37031,0
219,4759,2,2,2,0,0,0,2,0,0,0,0,0,0,0,0,0,0,0,0,2,28,25,69730,27792,5597,37031,0
219,4759,99,48,90,1,3,5,100,0,0,0,0,0,0,0,0,0,0,0,0,2,28,25,69730,27793,5597,37032,0
219,4759,8,5,5,2,0,1,10,0,0,0,0,0,0,0,0,0,0,0,0,2,28,25,69730,27793,5597,37033,0
219,4759,1217,716,841,84,126,174,1301,14,185,118,215,199,333,1446,2542,8,20687,1149,0,2,28,25,69740,27795,5597,37034,0
219,4759,160,89,115,0,13,31,160,7,15,11,17,22,28,78,124,3,495,27,0,2,28,25,69740,27795,5597,37035,0
219,4759,10,10,9,9,0,0,19,0,0,0,0,0,0,0,0,0,0,0,0,2,28,25,69740,27795,5598,37036,0
219,4759,173,84,99,8,29,36,181,5,12,7,13,17,20,54,81,2,221,12,0,2,28,25,69740,27796,5598,37037,0
219,4759,3,1,1,3,0,0,6,0,0,0,0,0,0,0,0,0,0,0,0,2,28,25,69740,27796,5598,37038,0
40,2521,652,304,544,16,6,88,668,6,89,51,101,95,152,591,998,3,3399,188,0,2,5,5,69740,27797,5598,37039,0
77,1753,996,429,845,24,10,117,1020,7,76,50,88,83,138,494,879,4,3565,198,0,2,2,1,69740,27799,5598,37040,0
77,1753,456,277,329,12,42,72,468,13,85,50,97,98,147,592,972,7,7212,400,0,2,2,1,69740,27799,5598,37041,0
42,1906,447,308,343,6,5,95,453,7,96,59,111,103,170,651,1136,4,4600,255,0,2,1,1,69740,27802,5598,37042,0
142,3324,77,34,69,0,0,8,77,3,24,16,29,27,45,114,213,1,387,21,0,2,10,9,69740,27802,5598,37043,0
142,3324,712,438,573,51,9,84,763,14,102,71,128,116,199,733,1364,8,11988,666,0,2,10,9,69750,27803,5598,37044,0
303,6802,72,33,56,0,4,12,72,1,1,1,1,2,2,0,2,0,1,0,0,2,0,9,69750,27803,5598,37045,0
303,6802,1454,835,1044,76,110,219,1530,17,275,158,296,292,454,2297,3718,9,34017,1889,1,2,0,9,69760,27804,5598,37046,0
30,1245,373,158,315,8,0,51,381,5,76,44,79,81,123,486,779,2,2026,112,0,2,1,1,69760,27804,5598,37047,0
75,3937,1296,573,1062,40,33,157,1336,8,201,118,231,209,349,1561,2689,4,12365,686,0,2,9,0,69760,27804,5598,37048,0
75,4003,1296,573,1062,40,33,157,1336,8,201,118,231,209,349,1561,2689,4,12365,686,0,2,6,0,69760,27804,5598,37049,0
143,3347,77,34,69,0,0,8,77,3,24,16,29,27,45,114,213,1,387,21,0,2,9,1,69760,27804,5598,37050,1
143,3347,712,438,573,51,9,84,763,14,102,71,128,116,199,733,1364,8,11988,666,0,2,9,1,69770,27805,5598,37051,1
70,1383,207,111,150,11,0,50,218,5,26,19,36,31,55,133,272,3,943,52,0,2,8,0,69770,27805,5598,37052,1
70,1383,410,198,237,31,55,97,441,11,63,38,72,74,110,414,683,6,4293,238,0,2,8,0,69780,27806,5599,37053,1
305,6850,72,33,56,0,4,12,72,1,1,1,1,2,2,0,2,0,1,0,0,2,2,1,69780,27806,5599,37054,1
305,6850,1454,835,1044,76,110,219,1530,17,275,158,296,292,454,2297,3718,9,34017,1889,1,2,2,1,69790,27807,5599,37055,1
28,800,256,139,192,9,7,47,265,4,23,12,24,27,36,112,171,2,357,19,0,2,24,0,69790,27808,5599,37056,1
76,3946,1296,573,1062,40,33,157,1336,8,201,118,231,209,349,1561,2689,4,12365,686,0,2,27,0,69790,27808,5599,37057,1
21,498,207,111,150,11,0,50,218,5,26,19,36,31,55,133,272,3,943,52,0,2,12,0,69790,27808,5599,37058,1
70,1383,207,111,150,11,0,50,218,5,26,19,36,31,55,133,272,3,943,52,0,2,8,0,69790,27808,5599,37059,0
70,1383,410,198,237,31,55,97,441,11,63,38,72,74,110,414,683,6,4293,238,0,2,8,0,69800,27809,5600,37060,0
305,6850,72,33,56,0,4,12,72,1,1,1,1,2,2,0,2,0,1,0,0,2,2,1,69800,27809,5600,37061,0
305,6850,1454,835,1044,76,110,219,1530,17,275,158,296,292,454,2297,3718,9,34017,1889,1,2,2,1,69810,27810,5600,37062,0
28,800,256,139,192,9,7,47,265,4,23,12,24,27,36,112,171,2,357,19,0,2,24,0,69810,27811,5600,37063,0
76,3946,1296,573,1062,40,33,157,1336,8,201,118,231,209,349,1561,2689,4,12365,686,0,2,27,0,69810,27811,5600,37064,0
21,498,207,111,150,11,0,50,218,5,26,19,36,31,55,133,272,3,943,52,0,2,12,0,69810,27811,5600,37065,0
52,1096,447,308,343,6,5,95,453,7,96,59,111,103,170,651,1136,4,4600,255,0,2,5,3,69810,27814,5600,37066,0
52,1096,322,174,179,16,74,51,338,10,41,26,46,51,72,252,408,5,2291,127,0,2,5,3,69810,27817,5601,37067,0
42,1906,447,308,343,6,5,95,453,7,96,59,111,103,170,651,1136,4,4600,255,0,2,4,2,69810,27820,5601,37068,0
143,3347,77,34,69,0,0,8,77,3,24,16,29,27,45,114,213,1,387,21,0,2,19,10,69810,27820,5601,37069,0
143,3347,712,438,573,51,9,84,763,14,102,71,128,116,199,733,1364,8,11988,666,0,2,19,10,69820,27821,5601,37070,0
303,6808,72,33,56,0,4,12,72,1,1,1,1,2,2,0,2,0,1,0,0,2,0,9,69820,27821,5601,37071,0
303,6808,1454,835,1044,76,110,219,1530,17,275,158,296,292,454,2297,3718,9,34017,1889,1,2,0,9,69830,27822,5601,37072,0
76,4039,1296,573,1062,40,33,157,1336,8,201,118,231,209,349,1561,2689,4,12365,686,0,2,15,0,69830,27822,5601,37073,0
30,1245,373,158,315,8,0,51,381,5,76,44,79,81,123,486,779,2,2026,112,0,2,1,1,69830,27822,5601,37074,0
147,3379,77,34,69,0,0,8,77,3,24,16,29,27,45,114,213,1,387,21,0,2,5,4,69830,27822,5601,37075,0
147,3379,712,438,573,51,9,84,763,14,102,71,128,116,199,733,1364,8,11988,666,0,2,5,4,69840,27823,5601,37076,0
56,1200,91,45,69,0,3,18,91,3,9,6,10,12,16,33,57,1,95,5,0,2,5,0,69840,27825,5601,37077,0
56,1200,367,234,237,17,34,68,384,16,55,34,61,71,95,381,584,8,5183,287,0,2,5,0,69840,27826,5601,37078,0
301,6795,72,33,56,0,4,12,72,1,1,1,1,2,2,0,2,0,1,0,0,2,3,6,69840,27826,5601,37079,0
301,6795,1454,835,1044,76,110,219,1530,17,275,158,296,292,454,2297,3718,9,34017,1889,1,2,3,6,69850,27827,5601,37080,0
147,3364,77,34,69,0,0,8,77,3,24,16,29,27,45,114,213,1,387,21,0,2,7,4,69850,27827,5601,37081,1
147,3364,712,438,573,51,9,84,763,14,102,71,128,116,199,733,1364,8,11988,666,0,2,7,4,69860,27828,5601,37082,1
304,6818,72,33,56,0,4,12,72,1,1,1,1,2,2,0,2,0,1,0,0,2,4,0,69860,27828,5601,37083,1
304,6818,1454,835,1044,76,110,219,1530,17,275,158,296,292,454,2297,3718,9,34017,1889,1,2,4,0,69870,27829,5601,37084,1
148,3384,77,34,69,0,0,8,77,3,24,16,29,27,45,114,213,1,387,21,0,2,11,7,69870,27829,5601,37085,0
148,3384,712,438,573,51,9,84,763,14,102,71,128,116,199,733,1364,8,11988,666,0,2,11,7,69880,27830,5601,37086,0
146,3375,77,34,69,0,0,8,77,3,24,16,29,27,45,114,213,1,387,21,0,2,4,6,69880,27830,5601,37087,0
146,3375,712,438,573,51,9,84,763,14,102,71,128,116,199,733,1364,8,11988,666,0,2,4,6,69890,27831,5601,37088,0
56,1200,91,45,69,0,3,18,91,3,9,6,10,12,16,33,57,1,95,5,0,2,1,1,69890,27833,5601,37089,0
56,1200,367,234,237,17,34,68,384,16,55,34,61,71,95,381,584,8,5183,287,0,2,1,1,69890,27834,5601,37090,0
31,958,339,213,244,17,9,65,356,10,42,26,48,52,74,259,421,5,2410,133,0,2,15,7,69900,27834,5601,37091,1
65,2927,1293,570,1093,25,15,163,1318,10,195,123,241,205,364,1516,2795,6,17273,959,0,2,27,0,69910,27836,5601,37092,1
146,3375,77,34,69,0,0,8,77,3,24,16,29,27,45,114,213,1,387,21,0,2,18,12,69910,27836,5601,37093,0
146,3375,712,438,573,51,9,84,763,14,102,71,128,116,199,733,1364,8,11988,666,0,2,18,12,69920,27837,5601,37094,0
56,1200,91,45,69,0,3,18,91,3,9,6,10,12,16,33,57,1,95,5,0,2,5,0,69920,27839,5601,37095,0
56,1200,367,234,237,17,34,68,384,16,55,34,61,71,95,381,584,8,5183,287,0,2,5,0,69920,27840,5601,37096,0
304,6818,72,33,56,0,4,12,72,1,1,1,1,2,2,0,2,0,1,0,0,2,3,2,69920,27840,5601,37097,0
304,6818,1454,835,1044,76,110,219,1530,17,275,158,296,292,454,2297,3718,9,34017,1889,1,2,3,2,69930,27841,5601,37098,0
7,298,72,33,56,0,4,12,72,1,1,1,1,2,2,0,2,0,1,0,0,2,2,2,69930,27841,5601,37099,0
68,1577,773,419,590,28,0,166,801,10,204,113,217,214,330,1598,2554,5,13587,754,0,2,8,5,69930,27841,5602,37100,0
68,1577,421,273,302,44,34,57,465,17,81,59,107,98,166,583,1098,11,12329,684,0,2,8,5,69930,27841,5603,37101,0
155,3277,1513,682,1277,25,13,200,1538,11,199,116,219,210,335,1557,2584,6,15641,868,0,2,1,1,69930,27843,5603,37102,0
155,3277,819,519,539,24,98,155,843,15,96,57,106,111,163,690,1107,8,9171,509,0,2,1,1,69940,27845,5603,37103,0
72,1414,207,111,150,11,0,50,218,5,26,19,36,31,55,133,272,3,943,52,0,2,8,0,69940,27845,5603,37104,0
72,1414,410,198,237,31,55,97,441,11,63,38,72,74,110,414,683,6,4293,238,0,2,8,0,69950,27846,5604,37105,0
97,1999,463,295,324,28,62,57,491,12,134,82,154,146,236,989,1696,6,11700,650,0,2,1,1,69960,27847,5604,37106,0
259,6068,4293,999,3693,19,54,507,4312,9,155,88,170,164,258,1156,1898,4,9368,520,0,2,9,1,69960,27849,5604,37107,0
259,6068,1482,859,1002,125,135,219,1607,16,219,134,251,235,385,1766,3032,9,27804,1544,1,2,9,1,69970,27850,5604,37108,0
53,633,647,139,84,35,284,233,682,0,0,0,0,0,0,0,0,0,0,0,0,2,2,2,69970,27850,5604,37109,0
147,3398,77,34,69,0,0,8,77,3,24,16,29,27,45,114,213,1,387,21,0,2,9,1,69970,27850,5604,37110,0
147,3398,712,438,573,51,9,84,763,14,102,71,128,116,199,733,1364,8,11988,666,0,2,9,1,69980,27851,5604,37111,0
88,1899,402,202,227,24,74,80,426,12,52,33,61,64,94,339,564,7,3969,220,0,2,1,1,69980,27852,5604,37112,0
52,1096,447,308,343,6,5,95,453,7,96,59,111,103,170,651,1136,4,4600,255,0,2,5,3,69980,27855,5604,37113,0
52,1096,322,174,179,16,74,51,338,10,41,26,46,51,72,252,408,5,2291,127,0,2,5,3,69980,27858,5605,37114,0
59,1228,91,45,69,0,3,18,91,3,9,6,10,12,16,33,57,1,95,5,0,2,23,13,69980,27860,5605,37115,0
59,1228,367,234,237,17,34,68,384,16,55,34,61,71,95,381,584,8,5183,287,0,2,23,13,69980,27861,5605,37116,0
304,6824,72,33,56,0,4,12,72,1,1,1,1,2,2,0,2,0,1,0,0,2,4,3,69980,27861,5605,37117,0
304,6824,1454,835,1044,76,110,219,1530,17,275,158,296,292,454,2297,3718,9,34017,1889,1,2,4,3,69990,27862,5605,37118,0
28,800,256,139,192,9,7,47,265,4,23,12,24,27,36,112,171,2,357,19,0,2,24,0,69990,27863,5605,37119,0
76,4039,1296,573,1062,40,33,157,1336,8,201,118,231,209,349,1561,2689,4,12365,686,0,2,42,0,69990,27863,5605,37120,0
21,498,207,111,150,11,0,50,218,5,26,19,36,31,55,133,272,3,943,52,0,2,12,0,69990,27863,5605,37121,0
42,1906,447,308,343,6,5,95,453,7,96,59,111,103,170,651,1136,4,4600,255,0,2,4,2,69990,27866,5605,37122,0
8,377,91,45,69,0,3,18,91,3,9,6,10,12,16,33,57,1,95,5,0,3,18,0,69990,27868,5605,37123,0
7,298,72,33,56,0,4,12,72,1,1,1,1,2,2,0,2,0,1,0,0,2,2,2,69990,27868,5605,37124,0
31,958,339,213,244,17,9,65,356,10,42,26,48,52,74,259,421,5,2410,133,0,2,15,7,70000,27868,5605,37125,0
65,2927,1293,570,1093,25,15,163,1318,10,195,123,241,205,364,1516,2795,6,17273,959,0,2,27,0,70010,27870,5605,37126,0
7,298,72,33,56,0,4,12,72,1,1,1,1,2,2,0,2,0,1,0,0,2,2,2,70010,27870,5605,37127,0
77,1753,996,429,845,24,10,117,1020,7,76,50,88,83,138,494,879,4,3565,198,0,2,2,1,70010,27872,5605,37128,0
77,1753,456,277,329,12,42,72,468,13,85,50,97,98,147,592,972,7,7212,400,0,2,2,1,70010,27872,5605,37129,0
155,3277,1513,682,1277,25,13,200,1538,11,199,116,219,210,335,1557,2584,6,15641,868,0,2,3,0,70010,27874,5605,37130,0
155,3277,819,519,539,24,98,155,843,15,96,57,106,111,163,690,1107,8,9171,509,0,2,3,0,70020,27876,5605,37131,0
72,1414,207,111,150,11,0,50,218,5,26,19,36,31,55,133,272,3,943,52,0,2,13,0,70020,27876,5605,37132,0
72,1414,410,198,237,31,55,97,441,11,63,38,72,74,110,414,683,6,4293,238,0,2,13,0,70030,27877,5606,37133,0
219,4759,2,2,2,0,0,0,2,0,0,0,0,0,0,0,0,0,0,0,0,2,30,24,70030,27877,5606,37133,0
219,4759,99,48,90,1,3,5,100,0,0,0,0,0,0,0,0,0,0,0,0,2,30,24,70030,27878,5606,37134,0
219,4759,8,5,5,2,0,1,10,0,0,0,0,0,0,0,0,0,0,0,0,2,30,24,70030,27878,5606,37135,0
219,4759,1217,716,841,84,126,174,1301,14,185,118,215,199,333,1446,2542,8,20687,1149,0,2,30,24,70040,27880,5606,37136,0
219,4759,160,89,115,0,13,31,160,7,15,11,17,22,28,78,124,3,495,27,0,2,30,24,70040,27880,5606,37137,0
219,4759,10,10,9,9,0,0,19,0,0,0,0,0,0,0,0,0,0,0,0,2,30,24,70040,27880,5607,37138,0
219,4759,173,84,99,8,29,36,181,5,12,7,13,17,20,54,81,2,221,12,0,2,30,24,70040,27881,5607,37139,0
219,4759,3,1,1,3,0,0,6,0,0,0,0,0,0,0,0,0,0,0,0,2,30,24,70040,27881,5607,37140,0
40,1165,339,213,244,17,9,65,356,10,42,26,48,52,74,259,421,5,2410,133,0,2,47,3,70050,27881,5607,37141,0
259,6068,4293,999,3693,19,54,507,4312,9,155,88,170,164,258,1156,1898,4,9368,520,0,2,4,0,70050,27883,5607,37143,0
259,6068,1482,859,1002,125,135,219,1607,16,219,134,251,235,385,1766,3032,9,27804,1544,1,2,4,0,70060,27884,5607,37144,0
53,633,647,139,84,35,284,233,682,0,0,0,0,0,0,0,0,0,0,0,0,2,13,1,70060,27884,5607,37145,0
147,3398,77,34,69,0,0,8,77,3,24,16,29,27,45,114,213,1,387,21,0,2,39,20,70060,27884,5607,37146,0
147,3398,712,438,573,51,9,84,763,14,102,71,128,116,199,733,1364,8,11988,666,0,2,39,20,70070,27885,5607,37147,0
59,1228,91,45,69,0,3,18,91,3,9,6,10,12,16,33,57,1,95,5,0,2,7,10,70070,27887,5607,37148,0
59,1228,367,234,237,17,34,68,384,16,55,34,61,71,95,381,584,8,5183,287,0,2,7,10,70070,27888,5607,37149,0
304,6824,72,33,56,0,4,12,72,1,1,1,1,2,2,0,2,0,1,0,0,2,18,18,70070,27888,5607,37150,0
304,6824,1454,835,1044,76,110,219,1530,17,275,158,296,292,454,2297,3718,9,34017,1889,1,2,18,18,70080,27889,5607,37151,0
25,397,219,78,157,11,5,46,230,3,24,20,34,27,54,114,256,2,545,30,0,0,102,0,70080,27890,5607,37152,0
25,397,108,64,79,9,0,20,117,5,15,11,19,20,30,70,129,3,410,22,0,0,102,0,70080,27890,5607,37153,0
226,4927,1943,715,1694,26,18,214,1969,12,185,120,237,197,357,1436,2721,7,20915,1161,0,2,26,15,70080,27892,5607,37154,0
226,4927,1168,838,957,57,25,144,1225,19,348,224,416,367,640,3018,5452,11,61921,3440,1,2,26,15,70090,27894,5607,37155,0
25,1187,75,38,59,1,3,12,76,2,4,2,4,6,6,10,15,1,15,0,0,2,12,0,70090,27894,5607,37156,0
2,18,10,6,6,0,0,4,10,0,0,0,0,0,0,0,0,0,0,0,0,0,10,0,70090,27894,5607,37157,0
44,3230,996,429,845,24,10,117,1020,7,76,50,88,83,138,494,879,4,3565,198,0,2,2,1,70090,27896,5607,37158,0
40,2521,652,304,544,16,6,88,668,6,89,51,101,95,152,591,998,3,3399,188,0,2,5,5,70090,27897,5607,37159,0
66,3064,1293,570,1093,25,15,163,1318,10,195,123,241,205,364,1516,2795,6,17273,959,0,2,49,7,70100,27899,5607,37160,0
9,441,219,78,157,11,5,46,230,3,24,20,34,27,54,114,256,2,545,30,0,0,148,0,70100,27900,5607,37161,0
7,298,72,33,56,0,4,12,72,1,1,1,1,2,2,0,2,0,1,0,0,2,2,2,70100,27900,5607,37162,0
68,1577,773,419,590,28,0,166,801,10,204,113,217,214,330,1598,2554,5,13587,754,0,2,8,5,70100,27900,5608,37163,0
68,1577,421,273,302,44,34,57,465,17,81,59,107,98,166,583,1098,11,12329,684,0,2,8,5,70100,27900,5609,37164,0
155,3277,1513,682,1277,25,13,200,1538,11,199,116,219,210,335,1557,2584,6,15641,868,0,2,1,1,70100,27902,5609,37165,0
155,3277,819,519,539,24,98,155,843,15,96,57,106,111,163,690,1107,8,9171,509,0,2,1,1,70110,27904,5609,37166,0
72,1414,207,111,150,11,0,50,218,5,26,19,36,31,55,133,272,3,943,52,0,2,8,0,70110,27904,5609,37167,0
72,1414,410,198,237,31,55,97,441,11,63,38,72,74,110,414,683,6,4293,238,0,2,8,0,70120,27905,5610,37168,0
97,1999,463,295,324,28,62,57,491,12,134,82,154,146,236,989,1696,6,11700,650,0,2,1,1,70130,27906,5610,37169,0
40,1165,339,213,244,17,9,65,356,10,42,26,48,52,74,259,421,5,2410,133,0,2,15,7,70140,27906,5610,37170,0
259,6068,4293,999,3693,19,54,507,4312,9,155,88,170,164,258,1156,1898,4,9368,520,0,2,9,1,70140,27908,5610,37171,0
259,6068,1482,859,1002,125,135,219,1607,16,219,134,251,235,385,1766,3032,9,27804,1544,1,2,9,1,70150,27909,5610,37172,0
53,633,647,139,84,35,284,233,682,0,0,0,0,0,0,0,0,0,0,0,0,2,2,2,70150,27909,5610,37173,0
147,3398,77,34,69,0,0,8,77,3,24,16,29,27,45,114,213,1,387,21,0,2,9,1,70150,27909,5610,37174,0
147,3398,712,438,573,51,9,84,763,14,102,71,128,116,199,733,1364,8,11988,666,0,2,9,1,70160,27910,5610,37175,0
88,1899,402,202,227,24,74,80,426,12,52,33,61,64,94,339,564,7,3969,220,0,2,1,1,70160,27911,5610,37176,0
52,1096,447,308,343,6,5,95,453,7,96,59,111,103,170,651,1136,4,4600,255,0,2,5,3,70160,27914,5610,37177,0
52,1096,322,174,179,16,74,51,338,10,41,26,46,51,72,252,408,5,2291,127,0,2,5,3,70160,27917,5611,37178,0
59,1228,91,45,69,0,3,18,91,3,9,6,10,12,16,33,57,1,95,5,0,2,23,13,70160,27919,5611,37179,0
59,1228,367,234,237,17,34,68,384,16,55,34,61,71,95,381,584,8,5183,287,0,2,23,13,70160,27920,5611,37180,0
304,6824,72,33,56,0,4,12,72,1,1,1,1,2,2,0,2,0,1,0,0,2,4,3,70160,27920,5611,37181,0
304,6824,1454,835,1044,76,110,219,1530,17,275,158,296,292,454,2297,3718,9,34017,1889,1,2,4,3,70170,27921,5611,37182,0
28,800,256,139,192,9,7,47,265,4,23,12,24,27,36,112,171,2,357,19,0,2,24,0,70170,27922,5611,37183,0
76,4039,1296,573,1062,40,33,157,1336,8,201,118,231,209,349,1561,2689,4,12365,686,0,2,42,0,70170,27922,5611,37184,0
21,498,207,111,150,11,0,50,218,5,26,19,36,31,55,133,272,3,943,52,0,2,12,0,70170,27922,5611,37185,0
42,1906,447,308,343,6,5,95,453,7,96,59,111,103,170,651,1136,4,4600,255,0,2,4,2,70170,27925,5611,37186,0
8,377,91,45,69,0,3,18,91,3,9,6,10,12,16,33,57,1,95,5,0,3,18,0,70170,27927,5611,37187,0
66,3064,1293,570,1093,25,15,163,1318,10,195,123,241,205,364,1516,2795,6,17273,959,0,2,27,0,70180,27929,5611,37188,0
220,4770,2,2,2,0,0,0,2,0,0,0,0,0,0,0,0,0,0,0,0,2,2,0,70180,27929,5611,37188,0
220,4770,99,48,90,1,3,5,100,0,0,0,0,0,0,0,0,0,0,0,0,2,2,0,70180,27930,5611,37189,0
220,4770,8,5,5,2,0,1,10,0,0,0,0,0,0,0,0,0,0,0,0,2,2,0,70180,27930,5611,37190,0
220,4770,1217,716,841,84,126,174,1301,14,185,118,215,199,333,1446,2542,8,20687,1149,0,2,2,0,70190,27932,5611,37191,0
220,4770,160,89,115,0,13,31,160,7,15,11,17,22,28,78,124,3,495,27,0,2,2,0,70190,27932,5611,37192,0
220,4770,10,10,9,9,0,0,19,0,0,0,0,0,0,0,0,0,0,0,0,2,2,0,70190,27932,5612,37193,0
220,4770,173,84,99,8,29,36,181,5,12,7,13,17,20,54,81,2,221,12,0,2,2,0,70190,27933,5612,37194,0
220,4770,3,1,1,3,0,0,6,0,0,0,0,0,0,0,0,0,0,0,0,2,2,0,70190,27933,5612,37195,0
123,5254,1513,682,1277,25,13,200,1538,11,199,116,219,210,335,1557,2584,6,15641,868,0,2,15,32,70190,27935,5612,37196,0
34,1970,384,251,317,7,8,52,391,11,70,44,84,81,128,467,811,6,5355,297,0,2,17,0,70190,27935,5612,37197,0
220,4770,2,2,2,0,0,0,2,0,0,0,0,0,0,0,0,0,0,0,0,2,1,0,70190,27935,5612,37197,0
220,4770,99,48,90,1,3,5,100,0,0,0,0,0,0,0,0,0,0,0,0,2,1,0,70190,27936,5612,37198,0
220,4770,8,5,5,2,0,1,10,0,0,0,0,0,0,0,0,0,0,0,0,2,1,0,70190,27936,5612,37199,0
220,4770,1217,716,841,84,126,174,1301,14,185,118,215,199,333,1446,2542,8,20687,1149,0,2,1,0,70200,27938,5612,37200,0
220,4770,160,89,115,0,13,31,160,7,15,11,17,22,28,78,124,3,495,27,0,2,1,0,70200,27938,5612,37201,0
220,4770,10,10,9,9,0,0,19,0,0,0,0,0,0,0,0,0,0,0,0,2,1,0,70200,27938,5613,37202,0
220,4770,173,84,99,8,29,36,181,5,12,7,13,17,20,54,81,2,221,12,0,2,1,0,70200,27939,5613,37203,0
220,4770,3,1,1,3,0,0,6,0,0,0,0,0,0,0,0,0,0,0,0,2,1,0,70200,27939,5613,37204,0
123,5258,1513,682,1277,25,13,200,1538,11,199,116,219,210,335,1557,2584,6,15641,868,0,2,15,32,70200,27941,5613,37205,0
219,4755,2,2,2,0,0,0,2,0,0,0,0,0,0,0,0,0,0,0,0,2,2,3,70200,27941,5613,37205,0
219,4755,99,48,90,1,3,5,100,0,0,0,0,0,0,0,0,0,0,0,0,2,2,3,70200,27942,5613,37206,0
219,4755,8,5,5,2,0,1,10,0,0,0,0,0,0,0,0,0,0,0,0,2,2,3,70200,27942,5613,37207,0
219,4755,1217,716,841,84,126,174,1301,14,185,118,215,199,333,1446,2542,8,20687,1149,0,2,2,3,70210,27944,5613,37208,0
219,4755,160,89,115,0,13,31,160,7,15,11,17,22,28,78,124,3,495,27,0,2,2,3,70210,27944,5613,37209,0
219,4755,10,10,9,9,0,0,19,0,0,0,0,0,0,0,0,0,0,0,0,2,2,3,70210,27944,5614,37210,0
219,4755,173,84,99,8,29,36,181,5,12,7,13,17,20,54,81,2,221,12,0,2,2,3,70210,27945,5614,37211,0
219,4755,3,1,1,3,0,0,6,0,0,0,0,0,0,0,0,0,0,0,0,2,2,3,70210,27945,5614,37212,0
89,1778,477,336,357,30,23,73,507,16,194,134,250,210,384,1538,2962,10,30538,1696,0,2,34,42,70220,27946,5614,37213,1
155,3275,1513,682,1277,25,13,200,1538,11,199,116,219,210,335,1557,2584,6,15641,868,0,2,2,2,70220,27948,5614,37214,1
155,3275,819,519,539,24,98,155,843,15,96,57,106,111,163,690,1107,8,9171,509,0,2,2,2,70230,27950,5614,37215,1
110,4151,1450,624,1228,12,26,181,1462,14,306,186,354,320,540,2580,4493,8,36391,2021,1,2,2,5,70230,27952,5615,37216,1
89,1778,477,336,357,30,23,73,507,16,194,134,250,210,384,1538,2962,10,30538,1696,0,2,34,42,70240,27953,5615,37217,0
155,3275,1513,682,1277,25,13,200,1538,11,199,116,219,210,335,1557,2584,6,15641,868,0,2,2,2,70240,27955,5615,37218,0
155,3275,819,519,539,24,98,155,843,15,96,57,106,111,163,690,1107,8,9171,509,0,2,2,2,70250,27957,5615,37219,0
110,4151,1450,624,1228,12,26,181,1462,14,306,186,354,320,540,2580,4493,8,36391,2021,1,2,2,5,70250,27959,5616,37220,0
220,4776,2,2,2,0,0,0,2,0,0,0,0,0,0,0,0,0,0,0,0,2,3,1,70250,27959,5616,37220,0
220,4776,99,48,90,1,3,5,100,0,0,0,0,0,0,0,0,0,0,0,0,2,3,1,70250,27960,5616,37221,0
220,4776,8,5,5,2,0,1,10,0,0,0,0,0,0,0,0,0,0,0,0,2,3,1,70250,27960,5616,37222,0
220,4776,1217,716,841,84,126,174,1301,14,185,118,215,199,333,1446,2542,8,20687,1149,0,2,3,1,70260,27962,5616,37223,0
220,4776,160,89,115,0,13,31,160,7,15,11,17,22,28,78,124,3,495,27,0,2,3,1,70260,27962,5616,37224,0
220,4776,10,10,9,9,0,0,19,0,0,0,0,0,0,0,0,0,0,0,0,2,3,1,70260,27962,5617,37225,0
220,4776,173,84,99,8,29,36,181,5,12,7,13,17,20,54,81,2,221,12,0,2,3,1,70260,27963,5617,37226,0
220,4776,3,1,1,3,0,0,6,0,0,0,0,0,0,0,0,0,0,0,0,2,3,1,70260,27963,5617,37227,0
149,3468,77,34,69,0,0,8,77,3,24,16,29,27,45,114,213,1,387,21,0,2,16,0,70260,27963,5617,37228,1
149,3468,712,438,573,51,9,84,763,14,102,71,128,116,199,733,1364,8,11988,666,0,2,16,0,70270,27964,5617,37229,1
87,1953,53,23,39,0,0,13,53,2,8,4,8,10,12,26,39,1,39,2,0,2,1,7,70270,27964,5617,37230,1
87,1953,515,298,307,33,80,99,548,12,63,44,77,75,121,419,753,7,5527,307,0,2,1,7,70280,27964,5617,37231,1
219,4755,2,2,2,0,0,0,2,0,0,0,0,0,0,0,0,0,0,0,0,2,2,3,70280,27964,5617,37231,0
219,4755,99,48,90,1,3,5,100,0,0,0,0,0,0,0,0,0,0,0,0,2,2,3,70280,27965,5617,37232,0
219,4755,8,5,5,2,0,1,10,0,0,0,0,0,0,0,0,0,0,0,0,2,2,3,70280,27965,5617,37233,0
219,4755,1217,716,841,84,126,174,1301,14,185,118,215,199,333,1446,2542,8,20687,1149,0,2,2,3,70290,27967,5617,37234,0
219,4755,160,89,115,0,13,31,160,7,15,11,17,22,28,78,124,3,495,27,0,2,2,3,70290,27967,5617,37235,0
219,4755,10,10,9,9,0,0,19,0,0,0,0,0,0,0,0,0,0,0,0,2,2,3,70290,27967,5618,37236,0
219,4755,173,84,99,8,29,36,181,5,12,7,13,17,20,54,81,2,221,12,0,2,2,3,70290,27968,5618,37237,0
219,4755,3,1,1,3,0,0,6,0,0,0,0,0,0,0,0,0,0,0,0,2,2,3,70290,27968,5618,37238,0
149,3468,77,34,69,0,0,8,77,3,24,16,29,27,45,114,213,1,387,21,0,2,16,0,70290,27968,5618,37239,0
149,3468,712,438,573,51,9,84,763,14,102,71,128,116,199,733,1364,8,11988,666,0,2,16,0,70300,27969,5618,37240,0
87,1953,53,23,39,0,0,13,53,2,8,4,8,10,12,26,39,1,39,2,0,2,1,7,70300,27969,5618,37241,0
87,1953,515,298,307,33,80,99,548,12,63,44,77,75,121,419,753,7,5527,307,0,2,1,7,70310,27969,5618,37242,0
219,4765,2,2,2,0,0,0,2,0,0,0,0,0,0,0,0,0,0,0,0,2,3,3,70310,27969,5618,37242,0
219,4765,99,48,90,1,3,5,100,0,0,0,0,0,0,0,0,0,0,0,0,2,3,3,70310,27970,5618,37243,0
219,4765,8,5,5,2,0,1,10,0,0,0,0,0,0,0,0,0,0,0,0,2,3,3,70310,27970,5618,37244,0
219,4765,1217,716,841,84,126,174,1301,14,185,118,215,199,333,1446,2542,8,20687,1149,0,2,3,3,70320,27972,5618,37245,0
219,4765,160,89,115,0,13,31,160,7,15,11,17,22,28,78,124,3,495,27,0,2,3,3,70320,27972,5618,37246,0
219,4765,10,10,9,9,0,0,19,0,0,0,0,0,0,0,0,0,0,0,0,2,3,3,70320,27972,5619,37247,0
219,4765,173,84,99,8,29,36,181,5,12,7,13,17,20,54,81,2,221,12,0,2,3,3,70320,27973,5619,37248,0
219,4765,3,1,1,3,0,0,6,0,0,0,0,0,0,0,0,0,0,0,0,2,3,3,70320,27973,5619,37249,0
77,4118,1296,573,1062,40,33,157,1336,8,201,118,231,209,349,1561,2689,4,12365,686,0,2,24,0,70320,27973,5619,37250,0
148,3423,77,34,69,0,0,8,77,3,24,16,29,27,45,114,213,1,387,21,0,2,15,14,70320,27973,5619,37251,0
148,3423,712,438,573,51,9,84,763,14,102,71,128,116,199,733,1364,8,11988,666,0,2,15,14,70330,27974,5619,37252,0
308,6881,72,33,56,0,4,12,72,1,1,1,1,2,2,0,2,0,1,0,0,2,14,1,70330,27974,5619,37253,0
308,6881,1454,835,1044,76,110,219,1530,17,275,158,296,292,454,2297,3718,9,34017,1889,1,2,14,1,70340,27975,5619,37254,0
76,4080,1296,573,1062,40,33,157,1336,8,201,118,231,209,349,1561,2689,4,12365,686,0,2,24,8,70340,27975,5619,37255,0
148,3409,77,34,69,0,0,8,77,3,24,16,29,27,45,114,213,1,387,21,0,2,3,4,70340,27975,5619,37256,0
148,3409,712,438,573,51,9,84,763,14,102,71,128,116,199,733,1364,8,11988,666,0,2,3,4,70350,27976,5619,37257,0
76,4115,1296,573,1062,40,33,157,1336,8,201,118,231,209,349,1561,2689,4,12365,686,0,2,13,0,70350,27976,5619,37258,0
76,4117,1296,573,1062,40,33,157,1336,8,201,118,231,209,349,1561,2689,4,12365,686,0,2,11,8,70350,27976,5619,37259,0
150,3460,77,34,69,0,0,8,77,3,24,16,29,27,45,114,213,1,387,21,0,2,11,6,70350,27976,5619,37260,0
150,3460,712,438,573,51,9,84,763,14,102,71,128,116,199,733,1364,8,11988,666,0,2,11,6,70360,27977,5619,37261,0
147,3410,77,34,69,0,0,8,77,3,24,16,29,27,45,114,213,1,387,21,0,2,8,12,70360,27977,5619,37262,0
147,3410,712,438,573,51,9,84,763,14,102,71,128,116,199,733,1364,8,11988,666,0,2,8,12,70370,27978,5619,37263,0
150,3446,77,34,69,0,0,8,77,3,24,16,29,27,45,114,213,1,387,21,0,2,15,5,70370,27978,5619,37264,0
150,3446,712,438,573,51,9,84,763,14,102,71,128,116,199,733,1364,8,11988,666,0,2,15,5,70380,27979,5619,37265,0
148,3413,77,34,69,0,0,8,77,3,24,16,29,27,45,114,213,1,387,21,0,2,6,15,70380,27979,5619,37266,0
148,3413,712,438,573,51,9,84,763,14,102,71,128,116,199,733,1364,8,11988,666,0,2,6,15,70390,27980,5619,37267,0
34,1970,384,251,317,7,8,52,391,11,70,44,84,81,128,467,811,6,5355,297,0,2,5,4,70390,27980,5619,37268,0
148,3413,77,34,69,0,0,8,77,3,24,16,29,27,45,114,213,1,387,21,0,2,34,32,70390,27980,5619,37269,0
148,3413,712,438,573,51,9,84,763,14,102,71,128,116,199,733,1364,8,11988,666,0,2,34,32,70400,27981,5619,37270,0
308,6881,72,33,56,0,4,12,72,1,1,1,1,2,2,0,2,0,1,0,0,2,14,1,70400,27981,5619,37271,0
308,6881,1454,835,1044,76,110,219,1530,17,275,158,296,292,454,2297,3718,9,34017,1889,1,2,14,1,70410,27982,5619,37272,0
76,4117,1296,573,1062,40,33,157,1336,8,201,118,231,209,349,1561,2689,4,12365,686,0,2,42,10,70410,27982,5619,37273,0
219,4765,2,2,2,0,0,0,2,0,0,0,0,0,0,0,0,0,0,0,0,2,3,3,70410,27982,5619,37273,0
219,4765,99,48,90,1,3,5,100,0,0,0,0,0,0,0,0,0,0,0,0,2,3,3,70410,27983,5619,37274,0
219,4765,8,5,5,2,0,1,10,0,0,0,0,0,0,0,0,0,0,0,0,2,3,3,70410,27983,5619,37275,0
219,4765,1217,716,841,84,126,174,1301,14,185,118,215,199,333,1446,2542,8,20687,1149,0,2,3,3,70420,27985,5619,37276,0
219,4765,160,89,115,0,13,31,160,7,15,11,17,22,28,78,124,3,495,27,0,2,3,3,70420,27985,5619,37277,0
219,4765,10,10,9,9,0,0,19,0,0,0,0,0,0,0,0,0,0,0,0,2,3,3,70420,27985,5620,37278,0
219,4765,173,84,99,8,29,36,181,5,12,7,13,17,20,54,81,2,221,12,0,2,3,3,70420,27986,5620,37279,0
219,4765,3,1,1,3,0,0,6,0,0,0,0,0,0,0,0,0,0,0,0,2,3,3,70420,27986,5620,37280,0
77,4118,1296,573,1062,40,33,157,1336,8,201,118,231,209,349,1561,2689,4,12365,686,0,2,24,0,70420,27986,5620,37281,0
227,4936,1943,715,1694,26,18,214,1969,12,185,120,237,197,357,1436,2721,7,20915,1161,0,2,4,1,70420,27988,5620,37282,0
227,4936,1168,838,957,57,25,144,1225,19,348,224,416,367,640,3018,5452,11,61921,3440,1,2,4,1,70430,27990,5620,37283,0
89,1778,477,336,357,30,23,73,507,16,194,134,250,210,384,1538,2962,10,30538,1696,0,2,34,42,70440,27991,5620,37284,0
155,3275,1513,682,1277,25,13,200,1538,11,199,116,219,210,335,1557,2584,6,15641,868,0,2,2,2,70440,27993,5620,37285,0
155,3275,819,519,539,24,98,155,843,15,96,57,106,111,163,690,1107,8,9171,509,0,2,2,2,70450,27995,5620,37286,0
219,4761,2,2,2,0,0,0,2,0,0,0,0,0,0,0,0,0,0,0,0,2,2,3,70450,27995,5620,37286,0
219,4761,99,48,90,1,3,5,100,0,0,0,0,0,0,0,0,0,0,0,0,2,2,3,70450,27996,5620,37287,0
219,4761,8,5,5,2,0,1,10,0,0,0,0,0,0,0,0,0,0,0,0,2,2,3,70450,27996,5620,37288,0
219,4761,1217,716,841,84,126,174,1301,14,185,118,215,199,333,1446,2542,8,20687,1149,0,2,2,3,70460,27998,5620,37289,0
219,4761,160,89,115,0,13,31,160,7,15,11,17,22,28,78,124,3,495,27,0,2,2,3,70460,27998,5620,37290,0
219,4761,10,10,9,9,0,0,19,0,0,0,0,0,0,0,0,0,0,0,0,2,2,3,70460,27998,5621,37291,0
219,4761,173,84,99,8,29,36,181,5,12,7,13,17,20,54,81,2,221,12,0,2,2,3,70460,27999,5621,37292,0
219,4761,3,1,1,3,0,0,6,0,0,0,0,0,0,0,0,0,0,0,0,2,2,3,70460,27999,5621,37293,0
150,3483,77,34,69,0,0,8,77,3,24,16,29,27,45,114,213,1,387,21,0,2,34,32,70460,27999,5621,37294,0
150,3483,712,438,573,51,9,84,763,14,102,71,128,116,199,733,1364,8,11988,666,0,2,34,32,70470,28000,5621,37295,0
308,6881,72,33,56,0,4,12,72,1,1,1,1,2,2,0,2,0,1,0,0,2,14,1,70470,28000,5621,37296,0
308,6881,1454,835,1044,76,110,219,1530,17,275,158,296,292,454,2297,3718,9,34017,1889,1,2,14,1,70480,28001,5621,37297,0
110,4151,1450,624,1228,12,26,181,1462,14,306,186,354,320,540,2580,4493,8,36391,2021,1,2,2,5,70480,28003,5622,37298,0
123,5258,1513,682,1277,25,13,200,1538,11,199,116,219,210,335,1557,2584,6,15641,868,0,2,15,32,70480,28005,5622,37299,0
77,4196,1296,573,1062,40,33,157,1336,8,201,118,231,209,349,1561,2689,4,12365,686,0,2,42,10,70480,28005,5622,37300,0
89,1778,477,336,357,30,23,73,507,16,194,134,250,210,384,1538,2962,10,30538,1696,0,2,34,42,70490,28006,5622,37301,0
155,3275,1513,682,1277,25,13,200,1538,11,199,116,219,210,335,1557,2584,6,15641,868,0,2,2,2,70490,28008,5622,37302,0
155,3275,819,519,539,24,98,155,843,15,96,57,106,111,163,690,1107,8,9171,509,0,2,2,2,70500,28010,5622,37303,0
219,4761,2,2,2,0,0,0,2,0,0,0,0,0,0,0,0,0,0,0,0,2,2,3,70500,28010,5622,37303,0
219,4761,99,48,90,1,3,5,100,0,0,0,0,0,0,0,0,0,0,0,0,2,2,3,70500,28011,5622,37304,0
219,4761,8,5,5,2,0,1,10,0,0,0,0,0,0,0,0,0,0,0,0,2,2,3,70500,28011,5622,37305,0
219,4761,1217,716,841,84,126,174,1301,14,185,118,215,199,333,1446,2542,8,20687,1149,0,2,2,3,70510,28013,5622,37306,0
219,4761,160,89,115,0,13,31,160,7,15,11,17,22,28,78,124,3,495,27,0,2,2,3,70510,28013,5622,37307,0
219,4761,10,10,9,9,0,0,19,0,0,0,0,0,0,0,0,0,0,0,0,2,2,3,70510,28013,5623,37308,0
219,4761,173,84,99,8,29,36,181,5,12,7,13,17,20,54,81,2,221,12,0,2,2,3,70510,28014,5623,37309,0
219,4761,3,1,1,3,0,0,6,0,0,0,0,0,0,0,0,0,0,0,0,2,2,3,70510,28014,5623,37310,0
150,3483,77,34,69,0,0,8,77,3,24,16,29,27,45,114,213,1,387,21,0,2,34,32,70510,28014,5623,37311,0
150,3483,712,438,573,51,9,84,763,14,102,71,128,116,199,733,1364,8,11988,666,0,2,34,32,70520,28015,5623,37312,0
308,6881,72,33,56,0,4,12,72,1,1,1,1,2,2,0,2,0,1,0,0,2,14,1,70520,28015,5623,37313,0
308,6881,1454,835,1044,76,110,219,1530,17,275,158,296,292,454,2297,3718,9,34017,1889,1,2,14,1,70530,28016,5623,37314,0
110,4151,1450,624,1228,12,26,181,1462,14,306,186,354,320,540,2580,4493,8,36391,2021,1,2,2,5,70530,28018,5624,37315,0
123,5258,1513,682,1277,25,13,200,1538,11,199,116,219,210,335,1557,2584,6,15641,868,0,2,15,32,70530,28020,5624,37316,0
77,4196,1296,573,1062,40,33,157,1336,8,201,118,231,209,349,1561,2689,4,12365,686,0,2,42,10,70530,28020,5624,37317,0
220,4775,2,2,2,0,0,0,2,0,0,0,0,0,0,0,0,0,0,0,0,2,6,4,70530,28020,5624,37317,1
220,4775,99,48,90,1,3,5,100,0,0,0,0,0,0,0,0,0,0,0,0,2,6,4,70530,28021,5624,37318,1
220,4775,8,5,5,2,0,1,10,0,0,0,0,0,0,0,0,0,0,0,0,2,6,4,70530,28021,5624,37319,1
220,4775,1217,716,841,84,126,174,1301,14,185,118,215,199,333,1446,2542,8,20687,1149,0,2,6,4,70540,28023,5624,37320,1
220,4775,160,89,115,0,13,31,160,7,15,11,17,22,28,78,124,3,495,27,0,2,6,4,70540,28023,5624,37321,1
220,4775,10,10,9,9,0,0,19,0,0,0,0,0,0,0,0,0,0,0,0,2,6,4,70540,28023,5625,37322,1
220,4775,173,84,99,8,29,36,181,5,12,7,13,17,20,54,81,2,221,12,0,2,6,4,70540,28024,5625,37323,1
220,4775,3,1,1,3,0,0,6,0,0,0,0,0,0,0,0,0,0,0,0,2,6,4,70540,28024,5625,37324,1
77,4244,1296,573,1062,40,33,157,1336,8,201,118,231,209,349,1561,2689,4,12365,686,0,2,14,1,70540,28024,5625,37325,1
227,4936,1943,715,1694,26,18,214,1969,12,185,120,237,197,357,1436,2721,7,20915,1161,0,2,4,1,70540,28026,5625,37326,0
227,4936,1168,838,957,57,25,144,1225,19,348,224,416,367,640,3018,5452,11,61921,3440,1,2,4,1,70550,28028,5625,37327,0
220,4772,2,2,2,0,0,0,2,0,0,0,0,0,0,0,0,0,0,0,0,2,5,0,70550,28028,5625,37327,0
220,4772,99,48,90,1,3,5,100,0,0,0,0,0,0,0,0,0,0,0,0,2,5,0,70550,28029,5625,37328,0
220,4772,8,5,5,2,0,1,10,0,0,0,0,0,0,0,0,0,0,0,0,2,5,0,70550,28029,5625,37329,0
220,4772,1217,716,841,84,126,174,1301,14,185,118,215,199,333,1446,2542,8,20687,1149,0,2,5,0,70560,28031,5625,37330,0
220,4772,160,89,115,0,13,31,160,7,15,11,17,22,28,78,124,3,495,27,0,2,5,0,70560,28031,5625,37331,0
220,4772,10,10,9,9,0,0,19,0,0,0,0,0,0,0,0,0,0,0,0,2,5,0,70560,28031,5626,37332,0
220,4772,173,84,99,8,29,36,181,5,12,7,13,17,20,54,81,2,221,12,0,2,5,0,70560,28032,5626,37333,0
220,4772,3,1,1,3,0,0,6,0,0,0,0,0,0,0,0,0,0,0,0,2,5,0,70560,28032,5626,37334,0
34,1970,384,251,317,7,8,52,391,11,70,44,84,81,128,467,811,6,5355,297,0,2,18,0,70560,28032,5626,37335,0
220,4775,2,2,2,0,0,0,2,0,0,0,0,0,0,0,0,0,0,0,0,2,6,4,70560,28032,5626,37335,0
220,4775,99,48,90,1,3,5,100,0,0,0,0,0,0,0,0,0,0,0,0,2,6,4,70560,28033,5626,37336,0
220,4775,8,5,5,2,0,1,10,0,0,0,0,0,0,0,0,0,0,0,0,2,6,4,70560,28033,5626,37337,0
220,4775,1217,716,841,84,126,174,1301,14,185,118,215,199,333,1446,2542,8,20687,1149,0,2,6,4,70570,28035,5626,37338,0
220,4775,160,89,115,0,13,31,160,7,15,11,17,22,28,78,124,3,495,27,0,2,6,4,70570,28035,5626,37339,0
220,4775,10,10,9,9,0,0,19,0,0,0,0,0,0,0,0,0,0,0,0,2,6,4,70570,28035,5627,37340,0
220,4775,173,84,99,8,29,36,181,5,12,7,13,17,20,54,81,2,221,12,0,2,6,4,70570,28036,5627,37341,0
220,4775,3,1,1,3,0,0,6,0,0,0,0,0,0,0,0,0,0,0,0,2,6,4,70570,28036,5627,37342,0
77,4244,1296,573,1062,40,33,157,1336,8,201,118,231,209,349,1561,2689,4,12365,686,0,2,14,1,70570,28036,5627,37343,0
259,6068,4293,999,3693,19,54,507,4312,9,155,88,170,164,258,1156,1898,4,9368,520,0,2,1,1,70570,28038,5627,37344,0
259,6068,1482,859,1002,125,135,219,1607,16,219,134,251,235,385,1766,3032,9,27804,1544,1,2,1,1,70580,28039,5627,37345,0
99,4099,1289,550,1043,56,32,155,1345,10,167,93,185,177,278,1266,2075,5,11498,638,0,2,2,1,70580,28041,5628,37346,0
2,25,127,75,83,2,11,30,129,4,14,7,14,18,21,61,87,2,175,9,0,2,4,0,70580,28041,5628,37347,0
2,25,652,304,544,16,6,88,668,6,89,51,101,95,152,591,998,3,3399,188,0,2,4,0,70580,28042,5628,37348,0
2,25,2,2,2,0,0,0,2,0,0,0,0,0,0,0,0,0,0,0,0,2,4,0,70580,28042,5628,37348,0
2,25,8,5,5,0,0,3,8,0,0,0,0,0,0,0,0,0,0,0,0,2,4,0,70580,28042,5628,37349,0
2,25,2,2,2,0,0,0,2,0,0,0,0,0,0,0,0,0,0,0,0,2,4,0,70580,28042,5628,37349,0
2,25,14,8,8,0,0,6,14,0,0,0,0,0,0,0,0,0,0,0,0,2,4,0,70580,28042,5628,37350,0
2,25,6,4,4,0,0,2,6,0,0,0,0,0,0,0,0,0,0,0,0,2,4,0,70580,28042,5628,37351,0
2,25,6,4,4,0,0,2,6,1,2,1,2,3,3,2,4,0,2,0,0,2,4,0,70580,28042,5628,37352,0
2,25,6,4,4,0,0,2,6,0,0,0,0,0,0,0,0,0,0,0,0,2,4,0,70580,28042,5628,37353,0
2,25,7,5,5,0,0,2,7,0,0,0,0,0,0,0,0,0,0,0,0,2,4,0,70580,28042,5628,37354,0
2,25,6,4,4,0,0,2,6,0,0,0,0,0,0,0,0,0,0,0,0,2,4,0,70580,28042,5628,37355,0
2,25,10,6,6,0,0,4,10,0,0,0,0,0,0,0,0,0,0,0,0,2,4,0,70580,28042,5628,37356,0
2,25,1,1,1,0,0,0,1,0,0,0,0,0,0,0,0,0,0,0,0,2,4,0,70580,28042,5628,37356,0
2,25,14,10,10,0,0,4,14,1,1,1,1,2,2,0,2,0,1,0,0,2,4,0,70580,28042,5628,37357,0
2,25,46,26,30,3,0,12,49,3,6,3,6,9,9,20,28,1,42,2,0,2,4,0,70590,28042,5628,37358,0
148,3416,77,34,69,0,0,8,77,3,24,16,29,27,45,114,213,1,387,21,0,2,2,2,70590,28042,5628,37359,0
148,3416,712,438,573,51,9,84,763,14,102,71,128,116,199,733,1364,8,11988,666,0,2,2,2,70600,28043,5628,37360,0
148,3416,77,34,69,0,0,8,77,3,24,16,29,27,45,114,213,1,387,21,0,2,1,1,70600,28043,5628,37361,0
148,3416,712,438,573,51,9,84,763,14,102,71,128,116,199,733,1364,8,11988,666,0,2,1,1,70610,28044,5628,37362,0
15,703,139,89,101,2,0,35,141,7,54,34,62,61,96,330,569,4,2287,127,0,2,1,1,70610,28044,5628,37363,1
92,4718,1457,730,1242,11,6,188,1468,10,292,166,329,302,495,2424,4078,5,22973,1276,1,2,1,1,70610,28046,5628,37364,1
244,5842,722,423,573,19,0,135,741,12,172,101,199,184,300,1320,2257,6,15668,870,0,2,4,4,70610,28048,5628,37366,0
244,5842,1508,847,911,44,250,301,1552,14,148,88,169,162,257,1120,1886,7,15077,837,0,2,4,4,70610,28049,5629,37367,0
78,1782,996,429,845,24,10,117,1020,7,76,50,88,83,138,494,879,4,3565,198,0,2,5,1,70610,28051,5629,37368,0
78,1782,456,277,329,12,42,72,468,13,85,50,97,98,147,592,972,7,7212,400,0,2,5,1,70610,28051,5629,37369,0
47,3342,996,429,845,24,10,117,1020,7,76,50,88,83,138,494,879,4,3565,198,0,2,21,8,70610,28053,5629,37370,0
259,6068,4293,999,3693,19,54,507,4312,9,155,88,170,164,258,1156,1898,4,9368,520,0,2,1,1,70610,28055,5629,37371,0
259,6068,1482,859,1002,125,135,219,1607,16,219,134,251,235,385,1766,3032,9,27804,1544,1,2,1,1,70620,28056,5629,37372,0
148,3416,77,34,69,0,0,8,77,3,24,16,29,27,45,114,213,1,387,21,0,2,3,3,70620,28056,5629,37373,0
148,3416,712,438,573,51,9,84,763,14,102,71,128,116,199,733,1364,8,11988,666,0,2,3,3,70630,28057,5629,37374,0
244,5842,722,423,573,19,0,135,741,12,172,101,199,184,300,1320,2257,6,15668,870,0,2,4,4,70630,28059,5629,37376,0
244,5842,1508,847,911,44,250,301,1552,14,148,88,169,162,257,1120,1886,7,15077,837,0,2,4,4,70630,28060,5630,37377,0
99,4099,1289,550,1043,56,32,155,1345,10,167,93,185,177,278,1266,2075,5,11498,638,0,2,2,1,70630,28062,5631,37378,0
2,25,127,75,83,2,11,30,129,4,14,7,14,18,21,61,87,2,175,9,0,2,4,0,70630,28062,5631,37379,0
2,25,652,304,544,16,6,88,668,6,89,51,101,95,152,591,998,3,3399,188,0,2,4,0,70630,28063,5631,37380,0
2,25,2,2,2,0,0,0,2,0,0,0,0,0,0,0,0,0,0,0,0,2,4,0,70630,28063,5631,37380,0
2,25,8,5,5,0,0,3,8,0,0,0,0,0,0,0,0,0,0,0,0,2,4,0,70630,28063,5631,37381,0
2,25,2,2,2,0,0,0,2,0,0,0,0,0,0,0,0,0,0,0,0,2,4,0,70630,28063,5631,37381,0
2,25,14,8,8,0,0,6,14,0,0,0,0,0,0,0,0,0,0,0,0,2,4,0,70630,28063,5631,37382,0
2,25,6,4,4,0,0,2,6,0,0,0,0,0,0,0,0,0,0,0,0,2,4,0,70630,28063,5631,37383,0
2,25,6,4,4,0,0,2,6,1,2,1,2,3,3,2,4,0,2,0,0,2,4,0,70630,28063,5631,37384,0
2,25,6,4,4,0,0,2,6,0,0,0,0,0,0,0,0,0,0,0,0,2,4,0,70630,28063,5631,37385,0
2,25,7,5,5,0,0,2,7,0,0,0,0,0,0,0,0,0,0,0,0,2,4,0,70630,28063,5631,37386,0
2,25,6,4,4,0,0,2,6,0,0,0,0,0,0,0,0,0,0,0,0,2,4,0,70630,28063,5631,37387,0
2,25,10,6,6,0,0,4,10,0,0,0,0,0,0,0,0,0,0,0,0,2,4,0,70630,28063,5631,37388,0
2,25,1,1,1,0,0,0,1,0,0,0,0,0,0,0,0,0,0,0,0,2,4,0,70630,28063,5631,37388,0
2,25,14,10,10,0,0,4,14,1,1,1,1,2,2,0,2,0,1,0,0,2,4,0,70630,28063,5631,37389,0
2,25,46,26,30,3,0,12,49,3,6,3,6,9,9,20,28,1,42,2,0,2,4,0,70640,28063,5631,37390,0
15,703,139,89,101,2,0,35,141,7,54,34,62,61,96,330,569,4,2287,127,0,2,1,1,70640,28063,5631,37391,0
92,4718,1457,730,1242,11,6,188,1468,10,292,166,329,302,495,2424,4078,5,22973,1276,1,2,1,1,70640,28065,5631,37392,0
78,1782,996,429,845,24,10,117,1020,7,76,50,88,83,138,494,879,4,3565,198,0,2,5,1,70640,28067,5631,37393,0
78,1782,456,277,329,12,42,72,468,13,85,50,97,98,147,592,972,7,7212,400,0,2,5,1,70640,28067,5631,37394,0
47,3342,996,429,845,24,10,117,1020,7,76,50,88,83,138,494,879,4,3565,198,0,2,21,8,70640,28069,5631,37395,0
221,4792,2,2,2,0,0,0,2,0,0,0,0,0,0,0,0,0,0,0,0,2,5,0,70640,28069,5631,37395,0
221,4792,99,48,90,1,3,5,100,0,0,0,0,0,0,0,0,0,0,0,0,2,5,0,70640,28070,5631,37396,0
221,4792,8,5,5,2,0,1,10,0,0,0,0,0,0,0,0,0,0,0,0,2,5,0,70640,28070,5631,37397,0
221,4792,1217,716,841,84,126,174,1301,14,185,118,215,199,333,1446,2542,8,20687,1149,0,2,5,0,70650,28072,5631,37398,0
221,4792,160,89,115,0,13,31,160,7,15,11,17,22,28,78,124,3,495,27,0,2,5,0,70650,28072,5631,37399,0
221,4792,10,10,9,9,0,0,19,0,0,0,0,0,0,0,0,0,0,0,0,2,5,0,70650,28072,5632,37400,0
221,4792,173,84,99,8,29,36,181,5,12,7,13,17,20,54,81,2,221,12,0,2,5,0,70650,28073,5632,37401,0
221,4792,3,1,1,3,0,0,6,0,0,0,0,0,0,0,0,0,0,0,0,2,5,0,70650,28073,5632,37402,0
259,6068,4293,999,3693,19,54,507,4312,9,155,88,170,164,258,1156,1898,4,9368,520,0,2,1,1,70650,28075,5632,37403,0
259,6068,1482,859,1002,125,135,219,1607,16,219,134,251,235,385,1766,3032,9,27804,1544,1,2,1,1,70660,28076,5632,37404,0
150,3486,77,34,69,0,0,8,77,3,24,16,29,27,45,114,213,1,387,21,0,2,3,3,70660,28076,5632,37405,0
150,3486,712,438,573,51,9,84,763,14,102,71,128,116,199,733,1364,8,11988,666,0,2,3,3,70670,28077,5632,37406,0
244,5842,722,423,573,19,0,135,741,12,172,101,199,184,300,1320,2257,6,15668,870,0,2,4,4,70670,28079,5632,37408,0
244,5842,1508,847,911,44,250,301,1552,14,148,88,169,162,257,1120,1886,7,15077,837,0,2,4,4,70670,28080,5633,37409,0
227,4936,1943,715,1694,26,18,214,1969,12,185,120,237,197,357,1436,2721,7,20915,1161,0,2,4,1,70670,28082,5633,37410,0
227,4936,1168,838,957,57,25,144,1225,19,348,224,416,367,640,3018,5452,11,61921,3440,1,2,4,1,70680,28084,5633,37411,0
99,4099,1289,550,1043,56,32,155,1345,10,167,93,185,177,278,1266,2075,5,11498,638,0,2,2,1,70680,28086,5634,37412,0
2,25,127,75,83,2,11,30,129,4,14,7,14,18,21,61,87,2,175,9,0,2,4,0,70680,28086,5634,37413,0
2,25,652,304,544,16,6,88,668,6,89,51,101,95,152,591,998,3,3399,188,0,2,4,0,70680,28087,5634,37414,0
2,25,2,2,2,0,0,0,2,0,0,0,0,0,0,0,0,0,0,0,0,2,4,0,70680,28087,5634,37414,0
2,25,8,5,5,0,0,3,8,0,0,0,0,0,0,0,0,0,0,0,0,2,4,0,70680,28087,5634,37415,0
2,25,2,2,2,0,0,0,2,0,0,0,0,0,0,0,0,0,0,0,0,2,4,0,70680,28087,5634,37415,0
2,25,14,8,8,0,0,6,14,0,0,0,0,0,0,0,0,0,0,0,0,2,4,0,70680,28087,5634,37416,0
2,25,6,4,4,0,0,2,6,0,0,0,0,0,0,0,0,0,0,0,0,2,4,0,70680,28087,5634,37417,0
2,25,6,4,4,0,0,2,6,1,2,1,2,3,3,2,4,0,2,0,0,2,4,0,70680,28087,5634,37418,0
2,25,6,4,4,0,0,2,6,0,0,0,0,0,0,0,0,0,0,0,0,2,4,0,70680,28087,5634,37419,0
2,25,7,5,5,0,0,2,7,0,0,0,0,0,0,0,0,0,0,0,0,2,4,0,70680,28087,5634,37420,0
2,25,6,4,4,0,0,2,6,0,0,0,0,0,0,0,0,0,0,0,0,2,4,0,70680,28087,5634,37421,0
2,25,10,6,6,0,0,4,10,0,0,0,0,0,0,0,0,0,0,0,0,2,4,0,70680,28087,5634,37422,0
2,25,1,1,1,0,0,0,1,0,0,0,0,0,0,0,0,0,0,0,0,2,4,0,70680,28087,5634,37422,0
2,25,14,10,10,0,0,4,14,1,1,1,1,2,2,0,2,0,1,0,0,2,4,0,70680,28087,5634,37423,0
2,25,46,26,30,3,0,12,49,3,6,3,6,9,9,20,28,1,42,2,0,2,4,0,70690,28087,5634,37424,0
15,703,139,89,101,2,0,35,141,7,54,34,62,61,96,330,569,4,2287,127,0,2,1,1,70690,28087,5634,37425,0
92,4718,1457,730,1242,11,6,188,1468,10,292,166,329,302,495,2424,4078,5,22973,1276,1,2,1,1,70690,28089,5634,37426,0
34,1970,384,251,317,7,8,52,391,11,70,44,84,81,128,467,811,6,5355,297,0,2,18,0,70690,28089,5634,37427,0
88,1991,53,23,39,0,0,13,53,2,8,4,8,10,12,26,39,1,39,2,0,2,1,1,70690,28089,5634,37428,0
88,1991,515,298,307,33,80,99,548,12,63,44,77,75,121,419,753,7,5527,307,0,2,1,1,70700,28089,5634,37429,0
99,4099,1289,550,1043,56,32,155,1345,10,167,93,185,177,278,1266,2075,5,11498,638,0,2,5,5,70700,28091,5635,37430,0
3,229,53,23,39,0,0,13,53,2,8,4,8,10,12,26,39,1,39,2,0,2,22,0,70700,28091,5635,37431,0
30,1248,373,158,315,8,0,51,381,5,76,44,79,81,123,486,779,2,2026,112,0,2,5,1,70700,28091,5635,37432,0
221,4792,2,2,2,0,0,0,2,0,0,0,0,0,0,0,0,0,0,0,0,2,5,0,70700,28091,5635,37432,0
221,4792,99,48,90,1,3,5,100,0,0,0,0,0,0,0,0,0,0,0,0,2,5,0,70700,28092,5635,37433,0
221,4792,8,5,5,2,0,1,10,0,0,0,0,0,0,0,0,0,0,0,0,2,5,0,70700,28092,5635,37434,0
221,4792,1217,716,841,84,126,174,1301,14,185,118,215,199,333,1446,2542,8,20687,1149,0,2,5,0,70710,28094,5635,37435,0
221,4792,160,89,115,0,13,31,160,7,15,11,17,22,28,78,124,3,495,27,0,2,5,0,70710,28094,5635,37436,0
221,4792,10,10,9,9,0,0,19,0,0,0,0,0,0,0,0,0,0,0,0,2,5,0,70710,28094,5636,37437,0
221,4792,173,84,99,8,29,36,181,5,12,7,13,17,20,54,81,2,221,12,0,2,5,0,70710,28095,5636,37438,0
221,4792,3,1,1,3,0,0,6,0,0,0,0,0,0,0,0,0,0,0,0,2,5,0,70710,28095,5636,37439,0
259,6068,4293,999,3693,19,54,507,4312,9,155,88,170,164,258,1156,1898,4,9368,520,0,2,1,1,70710,28097,5636,37440,0
259,6068,1482,859,1002,125,135,219,1607,16,219,134,251,235,385,1766,3032,9,27804,1544,1,2,1,1,70720,28098,5636,37441,0
150,3486,77,34,69,0,0,8,77,3,24,16,29,27,45,114,213,1,387,21,0,2,3,3,70720,28098,5636,37442,0
150,3486,712,438,573,51,9,84,763,14,102,71,128,116,199,733,1364,8,11988,666,0,2,3,3,70730,28099,5636,37443,0
244,5842,722,423,573,19,0,135,741,12,172,101,199,184,300,1320,2257,6,15668,870,0,2,4,4,70730,28101,5636,37445,0
244,5842,1508,847,911,44,250,301,1552,14,148,88,169,162,257,1120,1886,7,15077,837,0,2,4,4,70730,28102,5637,37446,0
227,4936,1943,715,1694,26,18,214,1969,12,185,120,237,197,357,1436,2721,7,20915,1161,0,2,4,1,70730,28104,5637,37447,0
227,4936,1168,838,957,57,25,144,1225,19,348,224,416,367,640,3018,5452,11,61921,3440,1,2,4,1,70740,28106,5637,37448,0
99,4099,1289,550,1043,56,32,155,1345,10,167,93,185,177,278,1266,2075,5,11498,638,0,2,2,1,70740,28108,5638,37449,0
2,25,127,75,83,2,11,30,129,4,14,7,14,18,21,61,87,2,175,9,0,2,4,0,70740,28108,5638,37450,0
2,25,652,304,544,16,6,88,668,6,89,51,101,95,152,591,998,3,3399,188,0,2,4,0,70740,28109,5638,37451,0
2,25,2,2,2,0,0,0,2,0,0,0,0,0,0,0,0,0,0,0,0,2,4,0,70740,28109,5638,37451,0
2,25,8,5,5,0,0,3,8,0,0,0,0,0,0,0,0,0,0,0,0,2,4,0,70740,28109,5638,37452,0
2,25,2,2,2,0,0,0,2,0,0,0,0,0,0,0,0,0,0,0,0,2,4,0,70740,28109,5638,37452,0
2,25,14,8,8,0,0,6,14,0,0,0,0,0,0,0,0,0,0,0,0,2,4,0,70740,28109,5638,37453,0
2,25,6,4,4,0,0,2,6,0,0,0,0,0,0,0,0,0,0,0,0,2,4,0,70740,28109,5638,37454,0
2,25,6,4,4,0,0,2,6,1,2,1,2,3,3,2,4,0,2,0,0,2,4,0,70740,28109,5638,37455,0
2,25,6,4,4,0,0,2,6,0,0,0,0,0,0,0,0,0,0,0,0,2,4,0,70740,28109,5638,37456,0
2,25,7,5,5,0,0,2,7,0,0,0,0,0,0,0,0,0,0,0,0,2,4,0,70740,28109,5638,37457,0
2,25,6,4,4,0,0,2,6,0,0,0,0,0,0,0,0,0,0,0,0,2,4,0,70740,28109,5638,37458,0
2,25,10,6,6,0,0,4,10,0,0,0,0,0,0,0,0,0,0,0,0,2,4,0,70740,28109,5638,37459,0
2,25,1,1,1,0,0,0,1,0,0,0,0,0,0,0,0,0,0,0,0,2,4,0,70740,28109,5638,37459,0
2,25,14,10,10,0,0,4,14,1,1,1,1,2,2,0,2,0,1,0,0,2,4,0,70740,28109,5638,37460,0
2,25,46,26,30,3,0,12,49,3,6,3,6,9,9,20,28,1,42,2,0,2,4,0,70750,28109,5638,37461,0
15,703,139,89,101,2,0,35,141,7,54,34,62,61,96,330,569,4,2287,127,0,2,1,1,70750,28109,5638,37462,0
92,4718,1457,730,1242,11,6,188,1468,10,292,166,329,302,495,2424,4078,5,22973,1276,1,2,1,1,70750,28111,5638,37463,0
34,1970,384,251,317,7,8,52,391,11,70,44,84,81,128,467,811,6,5355,297,0,2,18,0,70750,28111,5638,37464,0
88,1991,53,23,39,0,0,13,53,2,8,4,8,10,12,26,39,1,39,2,0,2,1,1,70750,28111,5638,37465,0
88,1991,515,298,307,33,80,99,548,12,63,44,77,75,121,419,753,7,5527,307,0,2,1,1,70760,28111,5638,37466,0
99,4099,1289,550,1043,56,32,155,1345,10,167,93,185,177,278,1266,2075,5,11498,638,0,2,5,5,70760,28113,5639,37467,0
3,229,53,23,39,0,0,13,53,2,8,4,8,10,12,26,39,1,39,2,0,2,22,0,70760,28113,5639,37468,0
30,1248,373,158,315,8,0,51,381,5,76,44,79,81,123,486,779,2,2026,112,0,2,5,1,70760,28113,5639,37469,0
23,613,102,59,69,5,3,24,107,6,22,15,28,28,43,113,206,3,789,43,0,2,10,4,70760,28113,5639,37470,0
87,1963,53,23,39,0,0,13,53,2,8,4,8,10,12,26,39,1,39,2,0,2,7,5,70760,28113,5639,37471,0
87,1963,515,298,307,33,80,99,548,12,63,44,77,75,121,419,753,7,5527,307,0,2,7,5,70770,28113,5639,37472,0
92,1965,1043,504,840,53,9,147,1096,9,180,112,198,189,310,1377,2344,4,11604,644,0,2,1,2,70770,28115,5639,37473,0
92,1965,383,288,292,26,6,62,409,11,65,38,67,76,105,429,656,5,3719,206,0,2,1,2,70770,28116,5639,37474,0
227,4916,1943,715,1694,26,18,214,1969,12,185,120,237,197,357,1436,2721,7,20915,1161,0,2,2,4,70770,28118,5639,37475,0
227,4916,1168,838,957,57,25,144,1225,19,348,224,416,367,640,3018,5452,11,61921,3440,1,2,2,4,70780,28120,5639,37476,0
77,4237,1296,573,1062,40,33,157,1336,8,201,118,231,209,349,1561,2689,4,12365,686,0,2,3,8,70780,28120,5639,37477,0
2,145,53,23,39,0,0,13,53,2,8,4,8,10,12,26,39,1,39,2,0,2,4,4,70780,28120,5639,37478,0
30,1248,373,158,315,8,0,51,381,5,76,44,79,81,123,486,779,2,2026,112,0,2,12,2,70780,28120,5639,37479,0
228,4924,1943,715,1694,26,18,214,1969,12,185,120,237,197,357,1436,2721,7,20915,1161,0,2,2,2,70780,28122,5639,37480,0
228,4924,1168,838,957,57,25,144,1225,19,348,224,416,367,640,3018,5452,11,61921,3440,1,2,2,2,70790,28124,5639,37481,0
103,4795,1338,495,1086,10,64,173,1348,11,122,82,157,133,239,883,1686,7,11934,663,0,2,1,3,70790,28126,5639,37482,0
23,613,102,59,69,5,3,24,107,6,22,15,28,28,43,113,206,3,789,43,0,2,10,4,70790,28126,5639,37483,0
87,1963,53,23,39,0,0,13,53,2,8,4,8,10,12,26,39,1,39,2,0,2,7,5,70790,28126,5639,37484,0
87,1963,515,298,307,33,80,99,548,12,63,44,77,75,121,419,753,7,5527,307,0,2,7,5,70800,28126,5639,37485,0
92,1965,1043,504,840,53,9,147,1096,9,180,112,198,189,310,1377,2344,4,11604,644,0,2,1,2,70800,28128,5639,37486,0
92,1965,383,288,292,26,6,62,409,11,65,38,67,76,105,429,656,5,3719,206,0,2,1,2,70800,28129,5639,37487,0
228,4924,1943,715,1694,26,18,214,1969,12,185,120,237,197,357,1436,2721,7,20915,1161,0,2,4,6,70800,28131,5639,37488,0
228,4924,1168,838,957,57,25,144,1225,19,348,224,416,367,640,3018,5452,11,61921,3440,1,2,4,6,70810,28133,5639,37489,0
103,4795,1338,495,1086,10,64,173,1348,11,122,82,157,133,239,883,1686,7,11934,663,0,2,1,3,70810,28135,5639,37490,0
77,4237,1296,573,1062,40,33,157,1336,8,201,118,231,209,349,1561,2689,4,12365,686,0,2,3,8,70810,28135,5639,37491,0
2,145,53,23,39,0,0,13,53,2,8,4,8,10,12,26,39,1,39,2,0,2,4,4,70810,28135,5639,37492,0
30,1248,373,158,315,8,0,51,381,5,76,44,79,81,123,486,779,2,2026,112,0,2,12,2,70810,28135,5639,37493,0
148,3416,77,34,69,0,0,8,77,3,24,16,29,27,45,114,213,1,387,21,0,2,2,2,70810,28135,5639,37494,0
148,3416,712,438,573,51,9,84,763,14,102,71,128,116,199,733,1364,8,11988,666,0,2,2,2,70820,28136,5639,37495,0
78,4335,1296,573,1062,40,33,157,1336,8,201,118,231,209,349,1561,2689,4,12365,686,0,2,54,0,70820,28136,5639,37496,0
148,3404,77,34,69,0,0,8,77,3,24,16,29,27,45,114,213,1,387,21,0,2,2,2,70820,28136,5639,37497,0
148,3404,712,438,573,51,9,84,763,14,102,71,128,116,199,733,1364,8,11988,666,0,2,2,2,70830,28137,5639,37498,0
148,3416,77,34,69,0,0,8,77,3,24,16,29,27,45,114,213,1,387,21,0,2,2,2,70830,28137,5639,37499,0
148,3416,712,438,573,51,9,84,763,14,102,71,128,116,199,733,1364,8,11988,666,0,2,2,2,70840,28138,5639,37500,0
78,4335,1296,573,1062,40,33,157,1336,8,201,118,231,209,349,1561,2689,4,12365,686,0,2,54,0,70840,28138,5639,37501,0
148,3404,77,34,69,0,0,8,77,3,24,16,29,27,45,114,213,1,387,21,0,2,2,2,70840,28138,5639,37502,0
148,3404,712,438,573,51,9,84,763,14,102,71,128,116,199,733,1364,8,11988,666,0,2,2,2,70850,28139,5639,37503,0
109,2070,477,336,357,30,23,73,507,16,194,134,250,210,384,1538,2962,10,30538,1696,0,2,46,0,70860,28140,5639,37504,1
111,2091,477,336,357,30,23,73,507,16,194,134,250,210,384,1538,2962,10,30538,1696,0,2,5,6,70870,28141,5639,37505,1
122,4845,1450,624,1228,12,26,181,1462,14,306,186,354,320,540,2580,4493,8,36391,2021,1,2,139,0,70870,28143,5640,37506,1
122,4887,1450,624,1228,12,26,181,1462,14,306,186,354,320,540,2580,4493,8,36391,2021,1,2,2,0,70870,28145,5641,37507,0
62,1174,282,196,195,3,0,86,285,8,130,71,141,138,212,936,1507,4,6538,363,0,2,24,0,70870,28145,5642,37508,0
1,90,13,10,10,0,0,3,13,1,2,1,2,3,3,2,4,0,2,0,0,2,1,1,70870,28145,5642,37509,0
111,2091,477,336,357,30,23,73,507,16,194,134,250,210,384,1538,2962,10,30538,1696,0,2,2,2,70880,28146,5642,37510,0
122,4887,1450,624,1228,12,26,181,1462,14,306,186,354,320,540,2580,4493,8,36391,2021,1,2,8,8,70880,28148,5643,37511,0
111,2094,477,336,357,30,23,73,507,16,194,134,250,210,384,1538,2962,10,30538,1696,0,2,1,1,70890,28149,5643,37512,0
122,4939,1450,624,1228,12,26,181,1462,14,306,186,354,320,540,2580,4493,8,36391,2021,1,2,23,23,70890,28151,5644,37513,0
111,2104,477,336,357,30,23,73,507,16,194,134,250,210,384,1538,2962,10,30538,1696,0,2,2,2,70900,28152,5644,37514,0
108,2074,477,336,357,30,23,73,507,16,194,134,250,210,384,1538,2962,10,30538,1696,0,2,7,9,70910,28153,5644,37515,0
108,2070,477,336,357,30,23,73,507,16,194,134,250,210,384,1538,2962,10,30538,1696,0,2,4,4,70920,28154,5644,37516,0
122,4959,1450,624,1228,12,26,181,1462,14,306,186,354,320,540,2580,4493,8,36391,2021,1,2,10,10,70920,28156,5645,37517,0
58,1067,282,196,195,3,0,86,285,8,130,71,141,138,212,936,1507,4,6538,363,0,2,2,5,70920,28156,5646,37518,1
29,743,601,196,481,2,23,85,603,8,63,36,72,71,108,400,664,4,3036,168,0,2,4,0,70920,28156,5646,37519,1
29,743,156,79,106,5,16,28,161,5,14,8,15,19,23,64,97,2,261,14,0,2,4,0,70920,28156,5646,37520,1
99,4109,1289,550,1043,56,32,155,1345,10,167,93,185,177,278,1266,2075,5,11498,638,0,2,5,2,70920,28158,5647,37521,1
25,1181,75,38,59,1,3,12,76,2,4,2,4,6,6,10,15,1,15,0,0,2,9,10,70920,28158,5647,37522,1
103,4810,1338,495,1086,10,64,173,1348,11,122,82,157,133,239,883,1686,7,11934,663,0,2,6,5,70920,28160,5647,37523,1
180,8032,139,89,101,2,0,35,141,7,54,34,62,61,96,330,569,4,2287,127,0,2,11,8,70920,28160,5647,37524,1
180,8032,7,5,5,0,0,2,7,1,2,1,2,3,3,2,4,0,2,0,0,2,11,8,70920,28160,5647,37525,1
138,6179,1782,648,1425,9,47,279,1791,8,171,97,189,179,286,1292,2140,4,9462,525,0,2,17,16,70920,28161,5648,37526,1
92,4728,1457,730,1242,11,6,188,1468,10,292,166,329,302,495,2424,4078,5,22973,1276,1,2,6,3,70920,28163,5648,37527,1
97,4242,1020,354,843,12,15,144,1032,8,134,77,144,142,221,970,1580,4,6792,377,0,2,5,3,70920,28163,5648,37528,1
21,670,424,94,331,4,0,89,428,1,5,5,5,6,10,11,25,0,12,0,0,2,2,1,70920,28164,5648,37529,1
66,3075,1293,570,1093,25,15,163,1318,10,195,123,241,205,364,1516,2795,6,17273,959,0,2,4,1,70930,28166,5648,37530,1
14,546,295,56,236,0,4,54,295,2,9,5,10,11,15,30,51,1,57,3,0,2,5,2,70930,28168,5648,37531,1
99,5096,1943,715,1694,26,18,214,1969,12,185,120,237,197,357,1436,2721,7,20915,1161,0,2,3,3,70930,28170,5648,37532,1
31,1326,442,244,305,14,16,103,456,11,68,45,75,79,120,452,756,6,4588,254,0,2,2,1,70930,28172,5648,37533,1
45,1575,601,196,481,2,23,85,603,8,63,36,72,71,108,400,664,4,3036,168,0,2,31,0,70930,28172,5648,37534,1
9,447,219,78,157,11,5,46,230,3,24,20,34,27,54,114,256,2,545,30,0,2,8,0,70930,28173,5648,37535,0
1,55,14,12,10,0,0,4,14,1,2,1,2,3,3,2,4,0,2,0,0,0,14,0,70930,28173,5648,37536,0
1,58,14,12,10,0,0,4,14,1,2,1,2,3,3,2,4,0,2,0,0,0,14,0,70930,28173,5648,37537,0
1,55,14,12,10,0,0,4,14,1,2,1,2,3,3,2,4,0,2,0,0,0,14,0,70930,28173,5648,37538,0
1,77,19,18,14,0,0,5,19,1,2,1,2,3,3,2,4,0,2,0,0,0,19,0,70930,28173,5648,37539,0
120,4779,1450,624,1228,12,26,181,1462,14,306,186,354,320,540,2580,4493,8,36391,2021,1,2,35,66,70930,28175,5649,37540,0
92,1983,1043,504,840,53,9,147,1096,9,180,112,198,189,310,1377,2344,4,11604,644,0,2,2,1,70930,28177,5649,37541,0
92,1983,383,288,292,26,6,62,409,11,65,38,67,76,105,429,656,5,3719,206,0,2,2,1,70930,28178,5649,37542,0
86,3304,1043,504,840,53,9,147,1096,9,180,112,198,189,310,1377,2344,4,11604,644,0,2,13,0,70930,28180,5649,37543,0
244,5852,722,423,573,19,0,135,741,12,172,101,199,184,300,1320,2257,6,15668,870,0,2,1,0,70930,28182,5649,37545,0
244,5852,1508,847,911,44,250,301,1552,14,148,88,169,162,257,1120,1886,7,15077,837,0,2,1,0,70930,28183,5650,37546,0
45,3296,996,429,845,24,10,117,1020,7,76,50,88,83,138,494,879,4,3565,198,0,2,0,11,70930,28185,5650,37547,0
58,1067,282,196,195,3,0,86,285,8,130,71,141,138,212,936,1507,4,6538,363,0,2,2,5,70930,28185,5651,37548,0
29,743,601,196,481,2,23,85,603,8,63,36,72,71,108,400,664,4,3036,168,0,2,4,0,70930,28185,5651,37549,0
29,743,156,79,106,5,16,28,161,5,14,8,15,19,23,64,97,2,261,14,0,2,4,0,70930,28185,5651,37550,0
99,4109,1289,550,1043,56,32,155,1345,10,167,93,185,177,278,1266,2075,5,11498,638,0,2,5,2,70930,28187,5652,37551,0
25,1181,75,38,59,1,3,12,76,2,4,2,4,6,6,10,15,1,15,0,0,2,9,10,70930,28187,5652,37552,0
103,4810,1338,495,1086,10,64,173,1348,11,122,82,157,133,239,883,1686,7,11934,663,0,2,6,5,70930,28189,5652,37553,0
180,8032,139,89,101,2,0,35,141,7,54,34,62,61,96,330,569,4,2287,127,0,2,11,8,70930,28189,5652,37554,0
180,8032,7,5,5,0,0,2,7,1,2,1,2,3,3,2,4,0,2,0,0,2,11,8,70930,28189,5652,37555,0
138,6179,1782,648,1425,9,47,279,1791,8,171,97,189,179,286,1292,2140,4,9462,525,0,2,17,16,70930,28190,5653,37556,0
92,4728,1457,730,1242,11,6,188,1468,10,292,166,329,302,495,2424,4078,5,22973,1276,1,2,6,3,70930,28192,5653,37557,0
97,4242,1020,354,843,12,15,144,1032,8,134,77,144,142,221,970,1580,4,6792,377,0,2,5,3,70930,28192,5653,37558,0
21,670,424,94,331,4,0,89,428,1,5,5,5,6,10,11,25,0,12,0,0,2,2,1,70930,28193,5653,37559,0
66,3075,1293,570,1093,25,15,163,1318,10,195,123,241,205,364,1516,2795,6,17273,959,0,2,4,1,70940,28195,5653,37560,0
14,546,295,56,236,0,4,54,295,2,9,5,10,11,15,30,51,1,57,3,0,2,5,2,70940,28197,5653,37561,0
9,447,219,78,157,11,5,46,230,3,24,20,34,27,54,114,256,2,545,30,0,2,8,0,70940,28198,5653,37562,0
99,5096,1943,715,1694,26,18,214,1969,12,185,120,237,197,357,1436,2721,7,20915,1161,0,2,3,3,70940,28200,5653,37563,0
31,1326,442,244,305,14,16,103,456,11,68,45,75,79,120,452,756,6,4588,254,0,2,2,1,70940,28202,5653,37564,0
45,1575,601,196,481,2,23,85,603,8,63,36,72,71,108,400,664,4,3036,168,0,2,31,0,70940,28202,5653,37565,0
150,3474,77,34,69,0,0,8,77,3,24,16,29,27,45,114,213,1,387,21,0,2,4,4,70940,28202,5653,37566,0
150,3474,712,438,573,51,9,84,763,14,102,71,128,116,199,733,1364,8,11988,666,0,2,4,4,70950,28203,5653,37567,0
87,1961,53,23,39,0,0,13,53,2,8,4,8,10,12,26,39,1,39,2,0,2,1,1,70950,28203,5653,37568,0
87,1961,515,298,307,33,80,99,548,12,63,44,77,75,121,419,753,7,5527,307,0,2,1,1,70960,28203,5653,37569,0
99,4109,1289,550,1043,56,32,155,1345,10,167,93,185,177,278,1266,2075,5,11498,638,0,2,5,5,70960,28205,5654,37570,0
23,613,102,59,69,5,3,24,107,6,22,15,28,28,43,113,206,3,789,43,0,2,10,4,70960,28205,5654,37571,0
79,4449,1296,573,1062,40,33,157,1336,8,201,118,231,209,349,1561,2689,4,12365,686,0,2,53,0,70960,28205,5654,37572,0
3,229,53,23,39,0,0,13,53,2,8,4,8,10,12,26,39,1,39,2,0,2,22,0,70960,28205,5654,37573,0
30,1251,373,158,315,8,0,51,381,5,76,44,79,81,123,486,779,2,2026,112,0,2,5,1,70960,28205,5654,37574,0
244,5852,722,423,573,19,0,135,741,12,172,101,199,184,300,1320,2257,6,15668,870,0,2,1,0,70960,28207,5654,37576,0
244,5852,1508,847,911,44,250,301,1552,14,148,88,169,162,257,1120,1886,7,15077,837,0,2,1,0,70960,28208,5655,37577,0
45,3296,996,429,845,24,10,117,1020,7,76,50,88,83,138,494,879,4,3565,198,0,2,0,11,70960,28210,5655,37578,0
108,2057,477,336,357,30,23,73,507,16,194,134,250,210,384,1538,2962,10,30538,1696,0,2,3,5,70970,28211,5655,37579,0
120,4779,1450,624,1228,12,26,181,1462,14,306,186,354,320,540,2580,4493,8,36391,2021,1,2,6,6,70970,28213,5656,37580,0
92,1983,1043,504,840,53,9,147,1096,9,180,112,198,189,310,1377,2344,4,11604,644,0,2,2,1,70970,28215,5656,37581,0
92,1983,383,288,292,26,6,62,409,11,65,38,67,76,105,429,656,5,3719,206,0,2,2,1,70970,28216,5656,37582,0
86,3304,1043,504,840,53,9,147,1096,9,180,112,198,189,310,1377,2344,4,11604,644,0,2,13,0,70970,28218,5656,37583,0
221,4792,2,2,2,0,0,0,2,0,0,0,0,0,0,0,0,0,0,0,0,2,1,1,70970,28218,5656,37583,0
221,4792,99,48,90,1,3,5,100,0,0,0,0,0,0,0,0,0,0,0,0,2,1,1,70970,28219,5656,37584,0
221,4792,8,5,5,2,0,1,10,0,0,0,0,0,0,0,0,0,0,0,0,2,1,1,70970,28219,5656,37585,0
221,4792,1217,716,841,84,126,174,1301,14,185,118,215,199,333,1446,2542,8,20687,1149,0,2,1,1,70980,28221,5656,37586,0
221,4792,160,89,115,0,13,31,160,7,15,11,17,22,28,78,124,3,495,27,0,2,1,1,70980,28221,5656,37587,0
221,4792,10,10,9,9,0,0,19,0,0,0,0,0,0,0,0,0,0,0,0,2,1,1,70980,28221,5657,37588,0
221,4792,173,84,99,8,29,36,181,5,12,7,13,17,20,54,81,2,221,12,0,2,1,1,70980,28222,5657,37589,0
221,4792,3,1,1,3,0,0,6,0,0,0,0,0,0,0,0,0,0,0,0,2,1,1,70980,28222,5657,37590,0
55,783,167,116,138,4,5,22,171,8,48,30,56,56,86,292,499,4,2330,129,0,2,16,10,70980,28222,5657,37591,0
150,3474,77,34,69,0,0,8,77,3,24,16,29,27,45,114,213,1,387,21,0,2,4,4,70980,28222,5657,37592,0
150,3474,712,438,573,51,9,84,763,14,102,71,128,116,199,733,1364,8,11988,666,0,2,4,4,70990,28223,5657,37593,0
87,1961,53,23,39,0,0,13,53,2,8,4,8,10,12,26,39,1,39,2,0,2,1,1,70990,28223,5657,37594,0
87,1961,515,298,307,33,80,99,548,12,63,44,77,75,121,419,753,7,5527,307,0,2,1,1,71000,28223,5657,37595,0
99,4109,1289,550,1043,56,32,155,1345,10,167,93,185,177,278,1266,2075,5,11498,638,0,2,5,5,71000,28225,5658,37596,0
23,613,102,59,69,5,3,24,107,6,22,15,28,28,43,113,206,3,789,43,0,2,10,4,71000,28225,5658,37597,0
79,4449,1296,573,1062,40,33,157,1336,8,201,118,231,209,349,1561,2689,4,12365,686,0,2,53,0,71000,28225,5658,37598,0
3,229,53,23,39,0,0,13,53,2,8,4,8,10,12,26,39,1,39,2,0,2,22,0,71000,28225,5658,37599,0
30,1251,373,158,315,8,0,51,381,5,76,44,79,81,123,486,779,2,2026,112,0,2,5,1,71000,28225,5658,37600,0
92,1973,1043,504,840,53,9,147,1096,9,180,112,198,189,310,1377,2344,4,11604,644,0,2,2,1,71000,28227,5658,37601,0
92,1973,383,288,292,26,6,62,409,11,65,38,67,76,105,429,656,5,3719,206,0,2,2,1,71000,28228,5658,37602,0
86,3304,1043,504,840,53,9,147,1096,9,180,112,198,189,310,1377,2344,4,11604,644,0,2,13,0,71000,28230,5658,37603,0
58,1067,282,196,195,3,0,86,285,8,130,71,141,138,212,936,1507,4,6538,363,0,2,2,5,71000,28230,5659,37604,0
78,1782,996,429,845,24,10,117,1020,7,76,50,88,83,138,494,879,4,3565,198,0,2,5,1,71000,28232,5659,37605,0
78,1782,456,277,329,12,42,72,468,13,85,50,97,98,147,592,972,7,7212,400,0,2,5,1,71000,28232,5659,37606,0
221,4792,2,2,2,0,0,0,2,0,0,0,0,0,0,0,0,0,0,0,0,2,6,4,71000,28232,5659,37606,0
221,4792,99,48,90,1,3,5,100,0,0,0,0,0,0,0,0,0,0,0,0,2,6,4,71000,28233,5659,37607,0
221,4792,8,5,5,2,0,1,10,0,0,0,0,0,0,0,0,0,0,0,0,2,6,4,71000,28233,5659,37608,0
221,4792,1217,716,841,84,126,174,1301,14,185,118,215,199,333,1446,2542,8,20687,1149,0,2,6,4,71010,28235,5659,37609,0
221,4792,160,89,115,0,13,31,160,7,15,11,17,22,28,78,124,3,495,27,0,2,6,4,71010,28235,5659,37610,0
221,4792,10,10,9,9,0,0,19,0,0,0,0,0,0,0,0,0,0,0,0,2,6,4,71010,28235,5660,37611,0
221,4792,173,84,99,8,29,36,181,5,12,7,13,17,20,54,81,2,221,12,0,2,6,4,71010,28236,5660,37612,0
221,4792,3,1,1,3,0,0,6,0,0,0,0,0,0,0,0,0,0,0,0,2,6,4,71010,28236,5660,37613,0
150,3474,77,34,69,0,0,8,77,3,24,16,29,27,45,114,213,1,387,21,0,2,16,0,71010,28236,5660,37614,0
150,3474,712,438,573,51,9,84,763,14,102,71,128,116,199,733,1364,8,11988,666,0,2,16,0,71020,28237,5660,37615,0
87,1961,53,23,39,0,0,13,53,2,8,4,8,10,12,26,39,1,39,2,0,2,8,12,71020,28237,5660,37616,0
87,1961,515,298,307,33,80,99,548,12,63,44,77,75,121,419,753,7,5527,307,0,2,8,12,71030,28237,5660,37617,0
244,5852,722,423,573,19,0,135,741,12,172,101,199,184,300,1320,2257,6,15668,870,0,2,1,0,71030,28239,5660,37619,0
244,5852,1508,847,911,44,250,301,1552,14,148,88,169,162,257,1120,1886,7,15077,837,0,2,1,0,71030,28240,5661,37620,0
92,1973,1043,504,840,53,9,147,1096,9,180,112,198,189,310,1377,2344,4,11604,644,0,2,1,2,71030,28242,5661,37621,0
92,1973,383,288,292,26,6,62,409,11,65,38,67,76,105,429,656,5,3719,206,0,2,1,2,71030,28243,5661,37622,0
228,4924,1943,715,1694,26,18,214,1969,12,185,120,237,197,357,1436,2721,7,20915,1161,0,2,4,6,71030,28245,5661,37623,0
228,4924,1168,838,957,57,25,144,1225,19,348,224,416,367,640,3018,5452,11,61921,3440,1,2,4,6,71040,28247,5661,37624,0
29,743,601,196,481,2,23,85,603,8,63,36,72,71,108,400,664,4,3036,168,0,2,4,0,71040,28247,5661,37625,0
29,743,156,79,106,5,16,28,161,5,14,8,15,19,23,64,97,2,261,14,0,2,4,0,71040,28247,5661,37626,0
99,4109,1289,550,1043,56,32,155,1345,10,167,93,185,177,278,1266,2075,5,11498,638,0,2,5,2,71040,28249,5662,37627,0
25,1181,75,38,59,1,3,12,76,2,4,2,4,6,6,10,15,1,15,0,0,2,9,10,71040,28249,5662,37628,0
103,4810,1338,495,1086,10,64,173,1348,11,122,82,157,133,239,883,1686,7,11934,663,0,2,7,8,71040,28251,5662,37629,0
180,8032,139,89,101,2,0,35,141,7,54,34,62,61,96,330,569,4,2287,127,0,2,11,8,71040,28251,5662,37630,0
180,8032,7,5,5,0,0,2,7,1,2,1,2,3,3,2,4,0,2,0,0,2,11,8,71040,28251,5662,37631,0
138,6179,1782,648,1425,9,47,279,1791,8,171,97,189,179,286,1292,2140,4,9462,525,0,2,17,16,71040,28252,5663,37632,0
45,3296,996,429,845,24,10,117,1020,7,76,50,88,83,138,494,879,4,3565,198,0,2,10,8,71040,28254,5663,37633,0
79,4449,1296,573,1062,40,33,157,1336,8,201,118,231,209,349,1561,2689,4,12365,686,0,2,39,8,71040,28254,5663,37634,0
92,4728,1457,730,1242,11,6,188,1468,10,292,166,329,302,495,2424,4078,5,22973,1276,1,2,6,3,71040,28256,5663,37635,0
97,4242,1020,354,843,12,15,144,1032,8,134,77,144,142,221,970,1580,4,6792,377,0,2,5,3,71040,28256,5663,37636,0
3,229,53,23,39,0,0,13,53,2,8,4,8,10,12,26,39,1,39,2,0,2,4,4,71040,28256,5663,37637,0
21,670,424,94,331,4,0,89,428,1,5,5,5,6,10,11,25,0,12,0,0,2,2,1,71040,28257,5663,37638,0
66,3075,1293,570,1093,25,15,163,1318,10,195,123,241,205,364,1516,2795,6,17273,959,0,2,4,1,71050,28259,5663,37639,0
14,546,295,56,236,0,4,54,295,2,9,5,10,11,15,30,51,1,57,3,0,2,5,2,71050,28261,5663,37640,0
30,1251,373,158,315,8,0,51,381,5,76,44,79,81,123,486,779,2,2026,112,0,2,12,2,71050,28261,5663,37641,0
9,447,219,78,157,11,5,46,230,3,24,20,34,27,54,114,256,2,545,30,0,2,8,0,71050,28262,5663,37642,0
99,5096,1943,715,1694,26,18,214,1969,12,185,120,237,197,357,1436,2721,7,20915,1161,0,2,3,3,71050,28264,5663,37643,0
31,1326,442,244,305,14,16,103,456,11,68,45,75,79,120,452,756,6,4588,254,0,2,2,1,71050,28266,5663,37644,0
45,1575,601,196,481,2,23,85,603,8,63,36,72,71,108,400,664,4,3036,168,0,2,31,0,71050,28266,5663,37645,0
81,1820,996,429,845,24,10,117,1020,7,76,50,88,83,138,494,879,4,3565,198,0,2,9,2,71050,28268,5663,37646,0
81,1820,456,277,329,12,42,72,468,13,85,50,97,98,147,592,972,7,7212,400,0,2,9,2,71050,28268,5663,37647,0
46,3385,996,429,845,24,10,117,1020,7,76,50,88,83,138,494,879,4,3565,198,0,2,25,2,71050,28270,5663,37648,0
92,1973,1043,504,840,53,9,147,1096,9,180,112,198,189,310,1377,2344,4,11604,644,0,2,2,1,71050,28272,5663,37649,0
92,1973,383,288,292,26,6,62,409,11,65,38,67,76,105,429,656,5,3719,206,0,2,2,1,71050,28273,5663,37650,0
86,3304,1043,504,840,53,9,147,1096,9,180,112,198,189,310,1377,2344,4,11604,644,0,2,13,0,71050,28275,5663,37651,0
308,6877,72,33,56,0,4,12,72,1,1,1,1,2,2,0,2,0,1,0,0,2,5,5,71050,28275,5663,37652,0
308,6877,1454,835,1044,76,110,219,1530,17,275,158,296,292,454,2297,3718,9,34017,1889,1,2,5,5,71060,28276,5663,37653,0
30,1260,373,158,315,8,0,51,381,5,76,44,79,81,123,486,779,2,2026,112,0,2,3,1,71060,28276,5663,37654,0
245,5865,722,423,573,19,0,135,741,12,172,101,199,184,300,1320,2257,6,15668,870,0,2,3,0,71060,28278,5663,37656,0
245,5865,1508,847,911,44,250,301,1552,14,148,88,169,162,257,1120,1886,7,15077,837,0,2,3,0,71060,28279,5664,37657,0
220,4772,2,2,2,0,0,0,2,0,0,0,0,0,0,0,0,0,0,0,0,2,1,4,71060,28279,5664,37657,0
220,4772,99,48,90,1,3,5,100,0,0,0,0,0,0,0,0,0,0,0,0,2,1,4,71060,28280,5664,37658,0
220,4772,8,5,5,2,0,1,10,0,0,0,0,0,0,0,0,0,0,0,0,2,1,4,71060,28280,5664,37659,0
220,4772,1217,716,841,84,126,174,1301,14,185,118,215,199,333,1446,2542,8,20687,1149,0,2,1,4,71070,28282,5664,37660,0
220,4772,160,89,115,0,13,31,160,7,15,11,17,22,28,78,124,3,495,27,0,2,1,4,71070,28282,5664,37661,0
220,4772,10,10,9,9,0,0,19,0,0,0,0,0,0,0,0,0,0,0,0,2,1,4,71070,28282,5665,37662,0
220,4772,173,84,99,8,29,36,181,5,12,7,13,17,20,54,81,2,221,12,0,2,1,4,71070,28283,5665,37663,0
220,4772,3,1,1,3,0,0,6,0,0,0,0,0,0,0,0,0,0,0,0,2,1,4,71070,28283,5665,37664,0
80,4548,1296,573,1062,40,33,157,1336,8,201,118,231,209,349,1561,2689,4,12365,686,0,2,22,0,71070,28283,5665,37665,0
220,4772,2,2,2,0,0,0,2,0,0,0,0,0,0,0,0,0,0,0,0,2,1,4,71070,28283,5665,37665,0
220,4772,99,48,90,1,3,5,100,0,0,0,0,0,0,0,0,0,0,0,0,2,1,4,71070,28284,5665,37666,0
220,4772,8,5,5,2,0,1,10,0,0,0,0,0,0,0,0,0,0,0,0,2,1,4,71070,28284,5665,37667,0
220,4772,1217,716,841,84,126,174,1301,14,185,118,215,199,333,1446,2542,8,20687,1149,0,2,1,4,71080,28286,5665,37668,0
220,4772,160,89,115,0,13,31,160,7,15,11,17,22,28,78,124,3,495,27,0,2,1,4,71080,28286,5665,37669,0
220,4772,10,10,9,9,0,0,19,0,0,0,0,0,0,0,0,0,0,0,0,2,1,4,71080,28286,5666,37670,0
220,4772,173,84,99,8,29,36,181,5,12,7,13,17,20,54,81,2,221,12,0,2,1,4,71080,28287,5666,37671,0
220,4772,3,1,1,3,0,0,6,0,0,0,0,0,0,0,0,0,0,0,0,2,1,4,71080,28287,5666,37672,0
80,4548,1296,573,1062,40,33,157,1336,8,201,118,231,209,349,1561,2689,4,12365,686,0,2,22,0,71080,28287,5666,37673,0
180,5413,1660,832,1314,41,38,274,1701,20,312,209,395,332,604,2671,5058,12,64042,3557,1,2,2,1,71080,28289,5667,37675,0
180,5413,1057,646,719,113,100,145,1170,18,215,134,248,233,382,1740,3004,10,31186,1732,1,2,2,1,71090,28290,5668,37676,0
167,5019,1660,832,1314,41,38,274,1701,20,312,209,395,332,604,2671,5058,12,64042,3557,1,2,13,0,71090,28292,5669,37678,0
308,6877,72,33,56,0,4,12,72,1,1,1,1,2,2,0,2,0,1,0,0,2,5,5,71090,28292,5669,37679,0
308,6877,1454,835,1044,76,110,219,1530,17,275,158,296,292,454,2297,3718,9,34017,1889,1,2,5,5,71100,28293,5669,37680,0
30,1260,373,158,315,8,0,51,381,5,76,44,79,81,123,486,779,2,2026,112,0,2,3,1,71100,28293,5669,37681,0
180,5413,1660,832,1314,41,38,274,1701,20,312,209,395,332,604,2671,5058,12,64042,3557,1,2,2,1,71100,28295,5670,37683,0
180,5413,1057,646,719,113,100,145,1170,18,215,134,248,233,382,1740,3004,10,31186,1732,1,2,2,1,71110,28296,5671,37684,0
167,5019,1660,832,1314,41,38,274,1701,20,312,209,395,332,604,2671,5058,12,64042,3557,1,2,13,0,71110,28298,5672,37686,0
1,104,42,7,35,4,0,5,46,1,2,1,2,3,3,2,4,0,2,0,0,2,10,0,71110,28298,5672,37687,0
1,104,11,6,10,0,0,1,11,2,4,2,4,6,6,10,15,1,15,0,0,2,10,0,71110,28298,5672,37688,0
1,104,42,7,35,4,0,5,46,1,2,1,2,3,3,2,4,0,2,0,0,2,10,0,71110,28298,5672,37689,0
1,104,11,6,10,0,0,1,11,2,4,2,4,6,6,10,15,1,15,0,0,2,10,0,71110,28298,5672,37690,0
221,4792,2,2,2,0,0,0,2,0,0,0,0,0,0,0,0,0,0,0,0,2,1,1,71110,28298,5672,37690,0
221,4792,99,48,90,1,3,5,100,0,0,0,0,0,0,0,0,0,0,0,0,2,1,1,71110,28299,5672,37691,0
221,4792,8,5,5,2,0,1,10,0,0,0,0,0,0,0,0,0,0,0,0,2,1,1,71110,28299,5672,37692,0
221,4792,1217,716,841,84,126,174,1301,14,185,118,215,199,333,1446,2542,8,20687,1149,0,2,1,1,71120,28301,5672,37693,0
221,4792,160,89,115,0,13,31,160,7,15,11,17,22,28,78,124,3,495,27,0,2,1,1,71120,28301,5672,37694,0
221,4792,10,10,9,9,0,0,19,0,0,0,0,0,0,0,0,0,0,0,0,2,1,1,71120,28301,5673,37695,0
221,4792,173,84,99,8,29,36,181,5,12,7,13,17,20,54,81,2,221,12,0,2,1,1,71120,28302,5673,37696,0
221,4792,3,1,1,3,0,0,6,0,0,0,0,0,0,0,0,0,0,0,0,2,1,1,71120,28302,5673,37697,0
55,783,167,116,138,4,5,22,171,8,48,30,56,56,86,292,499,4,2330,129,0,2,16,10,71120,28302,5673,37698,0
245,5865,722,423,573,19,0,135,741,12,172,101,199,184,300,1320,2257,6,15668,870,0,2,3,0,71120,28304,5673,37700,0
245,5865,1508,847,911,44,250,301,1552,14,148,88,169,162,257,1120,1886,7,15077,837,0,2,3,0,71120,28305,5674,37701,0
72,1422,207,111,150,11,0,50,218,5,26,19,36,31,55,133,272,3,943,52,0,2,2,2,71120,28305,5674,37702,0
72,1422,410,198,237,31,55,97,441,11,63,38,72,74,110,414,683,6,4293,238,0,2,2,2,71130,28306,5675,37703,0
92,1851,757,253,292,73,244,162,830,13,61,38,67,74,105,409,651,7,4654,258,0,2,9,4,71130,28307,5675,37704,0
66,4389,520,294,400,33,13,81,553,10,261,204,367,271,571,2128,4614,7,32445,1802,1,2,10,0,71130,28308,5675,37705,0
66,4392,520,294,400,33,13,81,553,10,261,204,367,271,571,2128,4614,7,32445,1802,1,2,4,3,71130,28309,5675,37706,0
1,104,42,7,35,4,0,5,46,1,2,1,2,3,3,2,4,0,2,0,0,2,10,0,71130,28309,5675,37707,0
1,104,11,6,10,0,0,1,11,2,4,2,4,6,6,10,15,1,15,0,0,2,10,0,71130,28309,5675,37708,0
180,5413,1660,832,1314,41,38,274,1701,20,312,209,395,332,604,2671,5058,12,64042,3557,1,2,2,1,71130,28311,5676,37710,0
180,5413,1057,646,719,113,100,145,1170,18,215,134,248,233,382,1740,3004,10,31186,1732,1,2,2,1,71140,28312,5677,37711,0
220,4772,2,2,2,0,0,0,2,0,0,0,0,0,0,0,0,0,0,0,0,2,1,4,71140,28312,5677,37711,0
220,4772,99,48,90,1,3,5,100,0,0,0,0,0,0,0,0,0,0,0,0,2,1,4,71140,28313,5677,37712,0
220,4772,8,5,5,2,0,1,10,0,0,0,0,0,0,0,0,0,0,0,0,2,1,4,71140,28313,5677,37713,0
220,4772,1217,716,841,84,126,174,1301,14,185,118,215,199,333,1446,2542,8,20687,1149,0,2,1,4,71150,28315,5677,37714,0
220,4772,160,89,115,0,13,31,160,7,15,11,17,22,28,78,124,3,495,27,0,2,1,4,71150,28315,5677,37715,0
220,4772,10,10,9,9,0,0,19,0,0,0,0,0,0,0,0,0,0,0,0,2,1,4,71150,28315,5678,37716,0
220,4772,173,84,99,8,29,36,181,5,12,7,13,17,20,54,81,2,221,12,0,2,1,4,71150,28316,5678,37717,0
220,4772,3,1,1,3,0,0,6,0,0,0,0,0,0,0,0,0,0,0,0,2,1,4,71150,28316,5678,37718,0
245,5865,722,423,573,19,0,135,741,12,172,101,199,184,300,1320,2257,6,15668,870,0,2,3,0,71150,28318,5678,37720,0
245,5865,1508,847,911,44,250,301,1552,14,148,88,169,162,257,1120,1886,7,15077,837,0,2,3,0,71150,28319,5679,37721,0
308,6877,72,33,56,0,4,12,72,1,1,1,1,2,2,0,2,0,1,0,0,2,5,5,71150,28319,5679,37722,0
308,6877,1454,835,1044,76,110,219,1530,17,275,158,296,292,454,2297,3718,9,34017,1889,1,2,5,5,71160,28320,5679,37723,0
167,5019,1660,832,1314,41,38,274,1701,20,312,209,395,332,604,2671,5058,12,64042,3557,1,2,13,0,71160,28322,5680,37725,0
80,4548,1296,573,1062,40,33,157,1336,8,201,118,231,209,349,1561,2689,4,12365,686,0,2,22,0,71160,28322,5680,37726,0
30,1260,373,158,315,8,0,51,381,5,76,44,79,81,123,486,779,2,2026,112,0,2,3,1,71160,28322,5680,37727,0
41,1220,339,213,244,17,9,65,356,10,42,26,48,52,74,259,421,5,2410,133,0,2,18,10,71170,28322,5680,37728,1
67,3166,1293,570,1093,25,15,163,1318,10,195,123,241,205,364,1516,2795,6,17273,959,0,2,30,1,71180,28324,5680,37729,1
220,4765,2,2,2,0,0,0,2,0,0,0,0,0,0,0,0,0,0,0,0,2,0,7,71180,28324,5680,37729,0
220,4765,99,48,90,1,3,5,100,0,0,0,0,0,0,0,0,0,0,0,0,2,0,7,71180,28325,5680,37730,0
220,4765,8,5,5,2,0,1,10,0,0,0,0,0,0,0,0,0,0,0,0,2,0,7,71180,28325,5680,37731,0
220,4765,1217,716,841,84,126,174,1301,14,185,118,215,199,333,1446,2542,8,20687,1149,0,2,0,7,71190,28327,5680,37732,0
220,4765,160,89,115,0,13,31,160,7,15,11,17,22,28,78,124,3,495,27,0,2,0,7,71190,28327,5680,37733,0
220,4765,10,10,9,9,0,0,19,0,0,0,0,0,0,0,0,0,0,0,0,2,0,7,71190,28327,5681,37734,0
220,4765,173,84,99,8,29,36,181,5,12,7,13,17,20,54,81,2,221,12,0,2,0,7,71190,28328,5681,37735,0
220,4765,3,1,1,3,0,0,6,0,0,0,0,0,0,0,0,0,0,0,0,2,0,7,71190,28328,5681,37736,0
52,611,647,139,84,35,284,233,682,0,0,0,0,0,0,0,0,0,0,0,0,2,0,28,71190,28328,5681,37738,0
31,1865,384,251,317,7,8,52,391,11,70,44,84,81,128,467,811,6,5355,297,0,2,0,42,71190,28328,5681,37739,0
1,104,42,7,35,4,0,5,46,1,2,1,2,3,3,2,4,0,2,0,0,2,10,0,71190,28328,5681,37740,0
1,104,11,6,10,0,0,1,11,2,4,2,4,6,6,10,15,1,15,0,0,2,10,0,71190,28328,5681,37741,0
180,5413,1660,832,1314,41,38,274,1701,20,312,209,395,332,604,2671,5058,12,64042,3557,1,2,2,1,71190,28330,5682,37743,0
180,5413,1057,646,719,113,100,145,1170,18,215,134,248,233,382,1740,3004,10,31186,1732,1,2,2,1,71200,28331,5683,37744,0
220,4772,2,2,2,0,0,0,2,0,0,0,0,0,0,0,0,0,0,0,0,2,1,4,71200,28331,5683,37744,0
220,4772,99,48,90,1,3,5,100,0,0,0,0,0,0,0,0,0,0,0,0,2,1,4,71200,28332,5683,37745,0
220,4772,8,5,5,2,0,1,10,0,0,0,0,0,0,0,0,0,0,0,0,2,1,4,71200,28332,5683,37746,0
220,4772,1217,716,841,84,126,174,1301,14,185,118,215,199,333,1446,2542,8,20687,1149,0,2,1,4,71210,28334,5683,37747,0
220,4772,160,89,115,0,13,31,160,7,15,11,17,22,28,78,124,3,495,27,0,2,1,4,71210,28334,5683,37748,0
220,4772,10,10,9,9,0,0,19,0,0,0,0,0,0,0,0,0,0,0,0,2,1,4,71210,28334,5684,37749,0
220,4772,173,84,99,8,29,36,181,5,12,7,13,17,20,54,81,2,221,12,0,2,1,4,71210,28335,5684,37750,0
220,4772,3,1,1,3,0,0,6,0,0,0,0,0,0,0,0,0,0,0,0,2,1,4,71210,28335,5684,37751,0
245,5865,722,423,573,19,0,135,741,12,172,101,199,184,300,1320,2257,6,15668,870,0,2,3,0,71210,28337,5684,37753,0
245,5865,1508,847,911,44,250,301,1552,14,148,88,169,162,257,1120,1886,7,15077,837,0,2,3,0,71210,28338,5685,37754,0
308,6877,72,33,56,0,4,12,72,1,1,1,1,2,2,0,2,0,1,0,0,2,5,5,71210,28338,5685,37755,0
308,6877,1454,835,1044,76,110,219,1530,17,275,158,296,292,454,2297,3718,9,34017,1889,1,2,5,5,71220,28339,5685,37756,0
167,5019,1660,832,1314,41,38,274,1701,20,312,209,395,332,604,2671,5058,12,64042,3557,1,2,13,0,71220,28341,5686,37758,0
80,4548,1296,573,1062,40,33,157,1336,8,201,118,231,209,349,1561,2689,4,12365,686,0,2,22,0,71220,28341,5686,37759,0
30,1260,373,158,315,8,0,51,381,5,76,44,79,81,123,486,779,2,2026,112,0,2,3,1,71220,28341,5686,37760,0
220,4770,2,2,2,0,0,0,2,0,0,0,0,0,0,0,0,0,0,0,0,2,2,2,71220,28341,5686,37760,0
220,4770,99,48,90,1,3,5,100,0,0,0,0,0,0,0,0,0,0,0,0,2,2,2,71220,28342,5686,37761,0
220,4770,8,5,5,2,0,1,10,0,0,0,0,0,0,0,0,0,0,0,0,2,2,2,71220,28342,5686,37762,0
220,4770,1217,716,841,84,126,174,1301,14,185,118,215,199,333,1446,2542,8,20687,1149,0,2,2,2,71230,28344,5686,37763,0
220,4770,160,89,115,0,13,31,160,7,15,11,17,22,28,78,124,3,495,27,0,2,2,2,71230,28344,5686,37764,0
220,4770,10,10,9,9,0,0,19,0,0,0,0,0,0,0,0,0,0,0,0,2,2,2,71230,28344,5687,37765,0
220,4770,173,84,99,8,29,36,181,5,12,7,13,17,20,54,81,2,221,12,0,2,2,2,71230,28345,5687,37766,0
220,4770,3,1,1,3,0,0,6,0,0,0,0,0,0,0,0,0,0,0,0,2,2,2,71230,28345,5687,37767,0
219,4745,2,2,2,0,0,0,2,0,0,0,0,0,0,0,0,0,0,0,0,2,0,7,71230,28345,5687,37767,0
219,4745,99,48,90,1,3,5,100,0,0,0,0,0,0,0,0,0,0,0,0,2,0,7,71230,28346,5687,37768,0
219,4745,8,5,5,2,0,1,10,0,0,0,0,0,0,0,0,0,0,0,0,2,0,7,71230,28346,5687,37769,0
219,4745,1217,716,841,84,126,174,1301,14,185,118,215,199,333,1446,2542,8,20687,1149,0,2,0,7,71240,28348,5687,37770,0
219,4745,160,89,115,0,13,31,160,7,15,11,17,22,28,78,124,3,495,27,0,2,0,7,71240,28348,5687,37771,0
219,4745,10,10,9,9,0,0,19,0,0,0,0,0,0,0,0,0,0,0,0,2,0,7,71240,28348,5688,37772,0
219,4745,173,84,99,8,29,36,181,5,12,7,13,17,20,54,81,2,221,12,0,2,0,7,71240,28349,5688,37773,0
219,4745,3,1,1,3,0,0,6,0,0,0,0,0,0,0,0,0,0,0,0,2,0,7,71240,28349,5688,37774,0
52,611,647,139,84,35,284,233,682,0,0,0,0,0,0,0,0,0,0,0,0,2,0,28,71240,28349,5688,37776,0
31,1865,384,251,317,7,8,52,391,11,70,44,84,81,128,467,811,6,5355,297,0,2,0,42,71240,28349,5688,37777,0
73,1482,207,111,150,11,0,50,218,5,26,19,36,31,55,133,272,3,943,52,0,2,16,5,71240,28349,5688,37778,0
73,1482,410,198,237,31,55,97,441,11,63,38,72,74,110,414,683,6,4293,238,0,2,16,5,71250,28350,5689,37779,0
138,6248,1782,648,1425,9,47,279,1791,8,171,97,189,179,286,1292,2140,4,9462,525,0,2,17,5,71250,28351,5690,37780,0
89,1926,402,202,227,24,74,80,426,12,52,33,61,64,94,339,564,7,3969,220,0,2,7,4,71250,28352,5690,37781,0
100,4333,1020,354,843,12,15,144,1032,8,134,77,144,142,221,970,1580,4,6792,377,0,2,24,8,71250,28352,5690,37782,0
89,1938,402,202,227,24,74,80,426,12,52,33,61,64,94,339,564,7,3969,220,0,2,2,0,71250,28353,5690,37783,0
139,6303,1782,648,1425,9,47,279,1791,8,171,97,189,179,286,1292,2140,4,9462,525,0,2,12,0,71250,28354,5691,37784,0
73,1512,207,111,150,11,0,50,218,5,26,19,36,31,55,133,272,3,943,52,0,2,3,0,71250,28354,5691,37785,0
73,1512,410,198,237,31,55,97,441,11,63,38,72,74,110,414,683,6,4293,238,0,2,3,0,71260,28355,5692,37786,0
139,6326,1782,648,1425,9,47,279,1791,8,171,97,189,179,286,1292,2140,4,9462,525,0,2,3,1,71260,28356,5693,37787,0
220,4770,2,2,2,0,0,0,2,0,0,0,0,0,0,0,0,0,0,0,0,2,2,2,71260,28356,5693,37787,0
220,4770,99,48,90,1,3,5,100,0,0,0,0,0,0,0,0,0,0,0,0,2,2,2,71260,28357,5693,37788,0
220,4770,8,5,5,2,0,1,10,0,0,0,0,0,0,0,0,0,0,0,0,2,2,2,71260,28357,5693,37789,0
220,4770,1217,716,841,84,126,174,1301,14,185,118,215,199,333,1446,2542,8,20687,1149,0,2,2,2,71270,28359,5693,37790,0
220,4770,160,89,115,0,13,31,160,7,15,11,17,22,28,78,124,3,495,27,0,2,2,2,71270,28359,5693,37791,0
220,4770,10,10,9,9,0,0,19,0,0,0,0,0,0,0,0,0,0,0,0,2,2,2,71270,28359,5694,37792,0
220,4770,173,84,99,8,29,36,181,5,12,7,13,17,20,54,81,2,221,12,0,2,2,2,71270,28360,5694,37793,0
220,4770,3,1,1,3,0,0,6,0,0,0,0,0,0,0,0,0,0,0,0,2,2,2,71270,28360,5694,37794,0
73,1512,207,111,150,11,0,50,218,5,26,19,36,31,55,133,272,3,943,52,0,2,19,5,71270,28360,5694,37795,0
73,1512,410,198,237,31,55,97,441,11,63,38,72,74,110,414,683,6,4293,238,0,2,19,5,71280,28361,5695,37796,0
89,1938,402,202,227,24,74,80,426,12,52,33,61,64,94,339,564,7,3969,220,0,2,9,4,71280,28362,5695,37797,0
139,6326,1782,648,1425,9,47,279,1791,8,171,97,189,179,286,1292,2140,4,9462,525,0,2,31,5,71280,28363,5696,37798,0
100,4333,1020,354,843,12,15,144,1032,8,134,77,144,142,221,970,1580,4,6792,377,0,2,24,8,71280,28363,5696,37799,0
53,1120,447,308,343,6,5,95,453,7,96,59,111,103,170,651,1136,4,4600,255,0,2,5,1,71280,28366,5696,37800,1
53,1120,322,174,179,16,74,51,338,10,41,26,46,51,72,252,408,5,2291,127,0,2,5,1,71280,28369,5697,37801,1
19,699,442,244,305,14,16,103,456,11,68,45,75,79,120,452,756,6,4588,254,0,2,4,2,71280,28371,5697,37802,1
19,699,182,102,99,11,40,35,193,3,11,6,11,14,17,42,64,1,97,5,0,2,4,2,71280,28372,5697,37803,1
35,1433,442,244,305,14,16,103,456,11,68,45,75,79,120,452,756,6,4588,254,0,2,30,3,71280,28374,5697,37804,1
155,3263,1513,682,1277,25,13,200,1538,11,199,116,219,210,335,1557,2584,6,15641,868,0,2,3,3,71280,28376,5697,37805,0
155,3263,819,519,539,24,98,155,843,15,96,57,106,111,163,690,1107,8,9171,509,0,2,3,3,71290,28378,5697,37806,0
19,702,442,244,305,14,16,103,456,11,68,45,75,79,120,452,756,6,4588,254,0,2,3,1,71290,28380,5697,37807,0
19,702,182,102,99,11,40,35,193,3,11,6,11,14,17,42,64,1,97,5,0,2,3,1,71290,28381,5697,37808,0
19,709,442,244,305,14,16,103,456,11,68,45,75,79,120,452,756,6,4588,254,0,2,6,2,71290,28383,5697,37809,0
19,709,182,102,99,11,40,35,193,3,11,6,11,14,17,42,64,1,97,5,0,2,6,2,71290,28384,5697,37810,0
19,709,442,244,305,14,16,103,456,11,68,45,75,79,120,452,756,6,4588,254,0,2,2,2,71290,28386,5697,37811,0
19,709,182,102,99,11,40,35,193,3,11,6,11,14,17,42,64,1,97,5,0,2,2,2,71290,28387,5697,37812,0
155,3263,1513,682,1277,25,13,200,1538,11,199,116,219,210,335,1557,2584,6,15641,868,0,2,3,3,71290,28389,5697,37813,0
155,3263,819,519,539,24,98,155,843,15,96,57,106,111,163,690,1107,8,9171,509,0,2,3,3,71300,28391,5697,37814,0
17,378,85,59,61,8,0,16,93,5,18,10,18,23,28,86,126,2,316,17,0,2,2,2,71300,28391,5697,37815,0
99,4109,1289,550,1043,56,32,155,1345,10,167,93,185,177,278,1266,2075,5,11498,638,0,2,3,3,71300,28393,5698,37816,0
180,8032,139,89,101,2,0,35,141,7,54,34,62,61,96,330,569,4,2287,127,0,2,11,11,71300,28393,5698,37817,0
180,8032,7,5,5,0,0,2,7,1,2,1,2,3,3,2,4,0,2,0,0,2,11,11,71300,28393,5698,37818,0
33,1004,465,148,393,5,8,60,470,4,31,20,31,35,51,161,261,2,523,29,0,2,1,1,71300,28394,5698,37819,0
33,1004,16,12,9,0,0,6,16,1,2,1,2,3,3,2,4,0,2,0,0,2,1,1,71300,28394,5698,37820,0
28,800,256,139,192,9,7,47,265,4,23,12,24,27,36,112,171,2,357,19,0,2,1,1,71300,28395,5698,37821,0
123,5258,1513,682,1277,25,13,200,1538,11,199,116,219,210,335,1557,2584,6,15641,868,0,2,26,26,71300,28397,5698,37822,0
96,4695,1523,757,1297,19,12,193,1542,12,193,117,230,205,347,1508,2664,7,19053,1058,0,2,2,2,71310,28399,5698,37823,0
97,4242,1020,354,843,12,15,144,1032,8,134,77,144,142,221,970,1580,4,6792,377,0,2,1,1,71310,28399,5698,37824,0
21,670,424,94,331,4,0,89,428,1,5,5,5,6,10,11,25,0,12,0,0,2,10,10,71310,28400,5698,37825,0
14,546,295,56,236,0,4,54,295,2,9,5,10,11,15,30,51,1,57,3,0,2,4,4,71310,28402,5698,37826,0
99,5096,1943,715,1694,26,18,214,1969,12,185,120,237,197,357,1436,2721,7,20915,1161,0,2,9,9,71310,28404,5698,37827,0
51,1917,1098,241,925,5,10,155,1103,7,46,25,49,53,74,273,423,3,1580,87,0,2,6,6,71320,28406,5698,37828,0
228,4926,1943,715,1694,26,18,214,1969,12,185,120,237,197,357,1436,2721,7,20915,1161,0,2,2,3,71320,28408,5698,37829,0
228,4926,1168,838,957,57,25,144,1225,19,348,224,416,367,640,3018,5452,11,61921,3440,1,2,2,3,71330,28410,5698,37830,0
228,4926,1943,715,1694,26,18,214,1969,12,185,120,237,197,357,1436,2721,7,20915,1161,0,2,2,3,71330,28412,5698,37831,0
228,4926,1168,838,957,57,25,144,1225,19,348,224,416,367,640,3018,5452,11,61921,3440,1,2,2,3,71340,28414,5698,37832,0
35,1441,442,244,305,14,16,103,456,11,68,45,75,79,120,452,756,6,4588,254,0,2,1,1,71340,28416,5698,37833,0
180,5417,1660,832,1314,41,38,274,1701,20,312,209,395,332,604,2671,5058,12,64042,3557,1,2,1,0,71340,28418,5699,37835,0
180,5417,1057,646,719,113,100,145,1170,18,215,134,248,233,382,1740,3004,10,31186,1732,1,2,1,0,71350,28419,5700,37836,0
78,1787,996,429,845,24,10,117,1020,7,76,50,88,83,138,494,879,4,3565,198,0,2,3,1,71350,28421,5700,37837,0
78,1787,456,277,329,12,42,72,468,13,85,50,97,98,147,592,972,7,7212,400,0,2,3,1,71350,28421,5700,37838,0
220,4774,2,2,2,0,0,0,2,0,0,0,0,0,0,0,0,0,0,0,0,2,1,1,71350,28421,5700,37838,0
220,4774,99,48,90,1,3,5,100,0,0,0,0,0,0,0,0,0,0,0,0,2,1,1,71350,28422,5700,37839,0
220,4774,8,5,5,2,0,1,10,0,0,0,0,0,0,0,0,0,0,0,0,2,1,1,71350,28422,5700,37840,0
220,4774,1217,716,841,84,126,174,1301,14,185,118,215,199,333,1446,2542,8,20687,1149,0,2,1,1,71360,28424,5700,37841,0
220,4774,160,89,115,0,13,31,160,7,15,11,17,22,28,78,124,3,495,27,0,2,1,1,71360,28424,5700,37842,0
220,4774,10,10,9,9,0,0,19,0,0,0,0,0,0,0,0,0,0,0,0,2,1,1,71360,28424,5701,37843,0
220,4774,173,84,99,8,29,36,181,5,12,7,13,17,20,54,81,2,221,12,0,2,1,1,71360,28425,5701,37844,0
220,4774,3,1,1,3,0,0,6,0,0,0,0,0,0,0,0,0,0,0,0,2,1,1,71360,28425,5701,37845,0
51,766,167,116,138,4,5,22,171,8,48,30,56,56,86,292,499,4,2330,129,0,2,4,1,71360,28425,5701,37846,0
30,662,215,129,180,6,0,29,221,8,65,43,72,73,115,415,711,4,3153,175,0,2,1,1,71360,28425,5701,37847,0
30,662,97,69,77,3,3,16,100,6,22,13,23,28,36,113,173,3,542,30,0,2,1,1,71360,28426,5701,37848,0
29,745,601,196,481,2,23,85,603,8,63,36,72,71,108,400,664,4,3036,168,0,2,3,2,71360,28426,5701,37849,0
29,745,156,79,106,5,16,28,161,5,14,8,15,19,23,64,97,2,261,14,0,2,3,2,71360,28426,5701,37850,0
45,1575,601,196,481,2,23,85,603,8,63,36,72,71,108,400,664,4,3036,168,0,2,1,1,71360,28426,5701,37851,0
53,1120,447,308,343,6,5,95,453,7,96,59,111,103,170,651,1136,4,4600,255,0,2,5,1,71360,28429,5701,37852,0
53,1120,322,174,179,16,74,51,338,10,41,26,46,51,72,252,408,5,2291,127,0,2,5,1,71360,28432,5702,37853,0
19,709,442,244,305,14,16,103,456,11,68,45,75,79,120,452,756,6,4588,254,0,2,10,2,71360,28434,5702,37854,0
19,709,182,102,99,11,40,35,193,3,11,6,11,14,17,42,64,1,97,5,0,2,10,2,71360,28435,5702,37855,0
35,1441,442,244,305,14,16,103,456,11,68,45,75,79,120,452,756,6,4588,254,0,2,30,3,71360,28437,5702,37856,0
17,378,85,59,61,8,0,16,93,5,18,10,18,23,28,86,126,2,316,17,0,2,2,2,71360,28437,5702,37857,0
99,4109,1289,550,1043,56,32,155,1345,10,167,93,185,177,278,1266,2075,5,11498,638,0,2,3,3,71360,28439,5703,37858,0
180,8032,139,89,101,2,0,35,141,7,54,34,62,61,96,330,569,4,2287,127,0,2,11,11,71360,28439,5703,37859,0
180,8032,7,5,5,0,0,2,7,1,2,1,2,3,3,2,4,0,2,0,0,2,11,11,71360,28439,5703,37860,0
33,1004,465,148,393,5,8,60,470,4,31,20,31,35,51,161,261,2,523,29,0,2,1,1,71360,28440,5703,37861,0
33,1004,16,12,9,0,0,6,16,1,2,1,2,3,3,2,4,0,2,0,0,2,1,1,71360,28440,5703,37862,0
28,800,256,139,192,9,7,47,265,4,23,12,24,27,36,112,171,2,357,19,0,2,1,1,71360,28441,5703,37863,0
123,5258,1513,682,1277,25,13,200,1538,11,199,116,219,210,335,1557,2584,6,15641,868,0,2,26,26,71360,28443,5703,37864,0
96,4695,1523,757,1297,19,12,193,1542,12,193,117,230,205,347,1508,2664,7,19053,1058,0,2,2,2,71370,28445,5703,37865,0
97,4242,1020,354,843,12,15,144,1032,8,134,77,144,142,221,970,1580,4,6792,377,0,2,1,1,71370,28445,5703,37866,0
21,670,424,94,331,4,0,89,428,1,5,5,5,6,10,11,25,0,12,0,0,2,10,10,71370,28446,5703,37867,0
14,546,295,56,236,0,4,54,295,2,9,5,10,11,15,30,51,1,57,3,0,2,4,4,71370,28448,5703,37868,0
99,5096,1943,715,1694,26,18,214,1969,12,185,120,237,197,357,1436,2721,7,20915,1161,0,2,9,9,71370,28450,5703,37869,0
51,1917,1098,241,925,5,10,155,1103,7,46,25,49,53,74,273,423,3,1580,87,0,2,6,6,71380,28452,5703,37870,0
224,4878,182,127,129,0,0,53,182,5,39,21,42,44,63,217,343,2,926,51,0,2,11,4,71380,28452,5704,37871,0
224,4878,1165,710,800,67,119,181,1232,18,243,153,282,261,435,2000,3492,10,36473,2026,1,2,11,4,71390,28452,5705,37872,0
29,843,256,139,192,9,7,47,265,4,23,12,24,27,36,112,171,2,357,19,0,2,12,0,71390,28453,5705,37873,0
180,5417,1660,832,1314,41,38,274,1701,20,312,209,395,332,604,2671,5058,12,64042,3557,1,2,1,0,71390,28455,5706,37875,0
180,5417,1057,646,719,113,100,145,1170,18,215,134,248,233,382,1740,3004,10,31186,1732,1,2,1,0,71400,28456,5707,37876,0
78,1787,996,429,845,24,10,117,1020,7,76,50,88,83,138,494,879,4,3565,198,0,2,3,1,71400,28458,5707,37877,0
78,1787,456,277,329,12,42,72,468,13,85,50,97,98,147,592,972,7,7212,400,0,2,3,1,71400,28458,5707,37878,0
220,4774,2,2,2,0,0,0,2,0,0,0,0,0,0,0,0,0,0,0,0,2,1,1,71400,28458,5707,37878,0
220,4774,99,48,90,1,3,5,100,0,0,0,0,0,0,0,0,0,0,0,0,2,1,1,71400,28459,5707,37879,0
220,4774,8,5,5,2,0,1,10,0,0,0,0,0,0,0,0,0,0,0,0,2,1,1,71400,28459,5707,37880,0
220,4774,1217,716,841,84,126,174,1301,14,185,118,215,199,333,1446,2542,8,20687,1149,0,2,1,1,71410,28461,5707,37881,0
220,4774,160,89,115,0,13,31,160,7,15,11,17,22,28,78,124,3,495,27,0,2,1,1,71410,28461,5707,37882,0
220,4774,10,10,9,9,0,0,19,0,0,0,0,0,0,0,0,0,0,0,0,2,1,1,71410,28461,5708,37883,0
220,4774,173,84,99,8,29,36,181,5,12,7,13,17,20,54,81,2,221,12,0,2,1,1,71410,28462,5708,37884,0
220,4774,3,1,1,3,0,0,6,0,0,0,0,0,0,0,0,0,0,0,0,2,1,1,71410,28462,5708,37885,0
51,766,167,116,138,4,5,22,171,8,48,30,56,56,86,292,499,4,2330,129,0,2,4,1,71410,28462,5708,37886,0
30,662,215,129,180,6,0,29,221,8,65,43,72,73,115,415,711,4,3153,175,0,2,1,1,71410,28462,5708,37887,0
30,662,97,69,77,3,3,16,100,6,22,13,23,28,36,113,173,3,542,30,0,2,1,1,71410,28463,5708,37888,0
29,745,601,196,481,2,23,85,603,8,63,36,72,71,108,400,664,4,3036,168,0,2,3,2,71410,28463,5708,37889,0
29,745,156,79,106,5,16,28,161,5,14,8,15,19,23,64,97,2,261,14,0,2,3,2,71410,28463,5708,37890,0
45,1575,601,196,481,2,23,85,603,8,63,36,72,71,108,400,664,4,3036,168,0,2,1,1,71410,28463,5708,37891,0
231,4983,182,127,129,0,0,53,182,5,39,21,42,44,63,217,343,2,926,51,0,2,69,22,71410,28463,5709,37892,1
231,4983,1165,710,800,67,119,181,1232,18,243,153,282,261,435,2000,3492,10,36473,2026,1,2,69,22,71420,28463,5710,37893,1
89,1780,477,336,357,30,23,73,507,16,194,134,250,210,384,1538,2962,10,30538,1696,0,2,1,1,71430,28464,5710,37894,1
150,3478,77,34,69,0,0,8,77,3,24,16,29,27,45,114,213,1,387,21,0,2,2,2,71430,28464,5710,37895,1
150,3478,712,438,573,51,9,84,763,14,102,71,128,116,199,733,1364,8,11988,666,0,2,2,2,71440,28465,5710,37896,1
308,6881,72,33,56,0,4,12,72,1,1,1,1,2,2,0,2,0,1,0,0,2,2,2,71440,28465,5710,37897,1
308,6881,1454,835,1044,76,110,219,1530,17,275,158,296,292,454,2297,3718,9,34017,1889,1,2,2,2,71450,28466,5710,37898,1
91,1839,757,253,292,73,244,162,830,13,61,38,67,74,105,409,651,7,4654,258,0,2,3,3,71450,28467,5710,37899,1
92,1977,1043,504,840,53,9,147,1096,9,180,112,198,189,310,1377,2344,4,11604,644,0,2,2,2,71450,28469,5710,37900,1
92,1977,383,288,292,26,6,62,409,11,65,38,67,76,105,429,656,5,3719,206,0,2,2,2,71450,28470,5710,37901,1
62,1263,1098,241,925,5,10,155,1103,7,46,25,49,53,74,273,423,3,1580,87,0,2,5,1,71460,28472,5710,37902,1
62,1263,282,202,222,14,2,44,296,8,42,24,43,50,67,250,378,4,1548,86,0,2,5,1,71460,28473,5710,37903,1
35,1087,182,127,129,0,0,53,182,5,39,21,42,44,63,217,343,2,926,51,0,2,2,2,71460,28473,5711,37904,1
153,7207,1392,870,1177,35,17,170,1427,14,494,280,531,508,811,4473,7289,7,54850,3047,2,2,17,11,71460,28476,5712,37905,1
16,1247,215,129,180,6,0,29,221,8,65,43,72,73,115,415,711,4,3153,175,0,2,1,1,71460,28476,5712,37906,1
84,3302,1043,504,840,53,9,147,1096,9,180,112,198,189,310,1377,2344,4,11604,644,0,2,8,12,71460,28478,5712,37907,1
231,4983,182,127,129,0,0,53,182,5,39,21,42,44,63,217,343,2,926,51,0,2,5,6,71460,28478,5713,37908,0
231,4983,1165,710,800,67,119,181,1232,18,243,153,282,261,435,2000,3492,10,36473,2026,1,2,5,6,71470,28478,5714,37909,0
29,850,256,139,192,9,7,47,265,4,23,12,24,27,36,112,171,2,357,19,0,2,7,2,71470,28479,5714,37910,0
60,1163,282,196,195,3,0,86,285,8,130,71,141,138,212,936,1507,4,6538,363,0,2,24,0,71470,28479,5715,37911,0
1,90,13,10,10,0,0,3,13,1,2,1,2,3,3,2,4,0,2,0,0,2,1,1,71470,28479,5715,37912,0
108,2057,477,336,357,30,23,73,507,16,194,134,250,210,384,1538,2962,10,30538,1696,0,2,41,0,71480,28480,5715,37913,0
1,55,14,12,10,0,0,4,14,1,2,1,2,3,3,2,4,0,2,0,0,0,14,0,71480,28480,5715,37914,0
1,58,14,12,10,0,0,4,14,1,2,1,2,3,3,2,4,0,2,0,0,0,14,0,71480,28480,5715,37915,0
1,55,14,12,10,0,0,4,14,1,2,1,2,3,3,2,4,0,2,0,0,0,14,0,71480,28480,5715,37916,0
1,77,19,18,14,0,0,5,19,1,2,1,2,3,3,2,4,0,2,0,0,0,19,0,71480,28480,5715,37917,0
120,4779,1450,624,1228,12,26,181,1462,14,306,186,354,320,540,2580,4493,8,36391,2021,1,2,110,0,71480,28482,5716,37918,0
46,3395,996,429,845,24,10,117,1020,7,76,50,88,83,138,494,879,4,3565,198,0,2,3,2,71480,28484,5716,37919,0
81,1825,996,429,845,24,10,117,1020,7,76,50,88,83,138,494,879,4,3565,198,0,2,9,2,71480,28486,5716,37920,0
81,1825,456,277,329,12,42,72,468,13,85,50,97,98,147,592,972,7,7212,400,0,2,9,2,71480,28486,5716,37921,0
46,3395,996,429,845,24,10,117,1020,7,76,50,88,83,138,494,879,4,3565,198,0,2,26,2,71480,28488,5716,37922,0
224,4878,182,127,129,0,0,53,182,5,39,21,42,44,63,217,343,2,926,51,0,2,11,4,71480,28488,5717,37923,0
224,4878,1165,710,800,67,119,181,1232,18,243,153,282,261,435,2000,3492,10,36473,2026,1,2,11,4,71490,28488,5718,37924,0
29,850,256,139,192,9,7,47,265,4,23,12,24,27,36,112,171,2,357,19,0,2,17,0,71490,28489,5718,37925,0
231,4983,182,127,129,0,0,53,182,5,39,21,42,44,63,217,343,2,926,51,0,2,68,22,71490,28489,5719,37926,0
231,4983,1165,710,800,67,119,181,1232,18,243,153,282,261,435,2000,3492,10,36473,2026,1,2,68,22,71500,28489,5720,37927,0
108,2059,477,336,357,30,23,73,507,16,194,134,250,210,384,1538,2962,10,30538,1696,0,2,1,1,71510,28490,5720,37928,0
150,3478,77,34,69,0,0,8,77,3,24,16,29,27,45,114,213,1,387,21,0,2,2,2,71510,28490,5720,37929,0
150,3478,712,438,573,51,9,84,763,14,102,71,128,116,199,733,1364,8,11988,666,0,2,2,2,71520,28491,5720,37930,0
308,6881,72,33,56,0,4,12,72,1,1,1,1,2,2,0,2,0,1,0,0,2,2,2,71520,28491,5720,37931,0
308,6881,1454,835,1044,76,110,219,1530,17,275,158,296,292,454,2297,3718,9,34017,1889,1,2,2,2,71530,28492,5720,37932,0
91,1839,757,253,292,73,244,162,830,13,61,38,67,74,105,409,651,7,4654,258,0,2,3,3,71530,28493,5720,37933,0
92,1977,1043,504,840,53,9,147,1096,9,180,112,198,189,310,1377,2344,4,11604,644,0,2,2,2,71530,28495,5720,37934,0
92,1977,383,288,292,26,6,62,409,11,65,38,67,76,105,429,656,5,3719,206,0,2,2,2,71530,28496,5720,37935,0
62,1263,1098,241,925,5,10,155,1103,7,46,25,49,53,74,273,423,3,1580,87,0,2,5,1,71540,28498,5720,37936,0
62,1263,282,202,222,14,2,44,296,8,42,24,43,50,67,250,378,4,1548,86,0,2,5,1,71540,28499,5720,37937,0
35,1087,182,127,129,0,0,53,182,5,39,21,42,44,63,217,343,2,926,51,0,2,2,2,71540,28499,5721,37938,0
153,7207,1392,870,1177,35,17,170,1427,14,494,280,531,508,811,4473,7289,7,54850,3047,2,2,17,11,71540,28502,5722,37939,0
16,1247,215,129,180,6,0,29,221,8,65,43,72,73,115,415,711,4,3153,175,0,2,1,1,71540,28502,5722,37940,0
84,3302,1043,504,840,53,9,147,1096,9,180,112,198,189,310,1377,2344,4,11604,644,0,2,8,12,71540,28504,5722,37941,0
230,4971,1943,715,1694,26,18,214,1969,12,185,120,237,197,357,1436,2721,7,20915,1161,0,2,13,3,71540,28506,5722,37942,0
230,4971,1168,838,957,57,25,144,1225,19,348,224,416,367,640,3018,5452,11,61921,3440,1,2,13,3,71550,28508,5722,37943,0
99,5127,1943,715,1694,26,18,214,1969,12,185,120,237,197,357,1436,2721,7,20915,1161,0,2,18,2,71550,28510,5722,37944,0
230,4971,1943,715,1694,26,18,214,1969,12,185,120,237,197,357,1436,2721,7,20915,1161,0,2,13,3,71550,28512,5722,37945,0
230,4971,1168,838,957,57,25,144,1225,19,348,224,416,367,640,3018,5452,11,61921,3440,1,2,13,3,71560,28514,5722,37946,0
99,5127,1943,715,1694,26,18,214,1969,12,185,120,237,197,357,1436,2721,7,20915,1161,0,2,18,2,71560,28516,5722,37947,0
231,4976,1943,715,1694,26,18,214,1969,12,185,120,237,197,357,1436,2721,7,20915,1161,0,2,2,0,71560,28518,5722,37948,0
231,4976,1168,838,957,57,25,144,1225,19,348,224,416,367,640,3018,5452,11,61921,3440,1,2,2,0,71570,28520,5722,37949,0
100,5223,1943,715,1694,26,18,214,1969,12,185,120,237,197,357,1436,2721,7,20915,1161,0,2,28,1,71570,28522,5722,37950,0
91,1839,757,253,292,73,244,162,830,13,61,38,67,74,105,409,651,7,4654,258,0,2,1,1,71570,28523,5722,37951,0
30,878,256,139,192,9,7,47,265,4,23,12,24,27,36,112,171,2,357,19,0,2,4,0,71570,28524,5722,37952,0
231,4976,1943,715,1694,26,18,214,1969,12,185,120,237,197,357,1436,2721,7,20915,1161,0,2,2,0,71570,28526,5722,37953,0
231,4976,1168,838,957,57,25,144,1225,19,348,224,416,367,640,3018,5452,11,61921,3440,1,2,2,0,71580,28528,5722,37954,0
100,5223,1943,715,1694,26,18,214,1969,12,185,120,237,197,357,1436,2721,7,20915,1161,0,2,28,1,71580,28530,5722,37955,0
17,378,85,59,61,8,0,16,93,5,18,10,18,23,28,86,126,2,316,17,0,2,2,2,71580,28530,5722,37956,0
180,5417,1660,832,1314,41,38,274,1701,20,312,209,395,332,604,2671,5058,12,64042,3557,1,2,1,0,71580,28532,5723,37958,0
180,5417,1057,646,719,113,100,145,1170,18,215,134,248,233,382,1740,3004,10,31186,1732,1,2,1,0,71590,28533,5724,37959,0
81,1825,996,429,845,24,10,117,1020,7,76,50,88,83,138,494,879,4,3565,198,0,2,12,3,71590,28535,5724,37960,0
81,1825,456,277,329,12,42,72,468,13,85,50,97,98,147,592,972,7,7212,400,0,2,12,3,71590,28535,5724,37961,0
219,4747,2,2,2,0,0,0,2,0,0,0,0,0,0,0,0,0,0,0,0,2,3,3,71590,28535,5724,37961,0
219,4747,99,48,90,1,3,5,100,0,0,0,0,0,0,0,0,0,0,0,0,2,3,3,71590,28536,5724,37962,0
219,4747,8,5,5,2,0,1,10,0,0,0,0,0,0,0,0,0,0,0,0,2,3,3,71590,28536,5724,37963,0
219,4747,1217,716,841,84,126,174,1301,14,185,118,215,199,333,1446,2542,8,20687,1149,0,2,3,3,71600,28538,5724,37964,0
219,4747,160,89,115,0,13,31,160,7,15,11,17,22,28,78,124,3,495,27,0,2,3,3,71600,28538,5724,37965,0
219,4747,10,10,9,9,0,0,19,0,0,0,0,0,0,0,0,0,0,0,0,2,3,3,71600,28538,5725,37966,0
219,4747,173,84,99,8,29,36,181,5,12,7,13,17,20,54,81,2,221,12,0,2,3,3,71600,28539,5725,37967,0
219,4747,3,1,1,3,0,0,6,0,0,0,0,0,0,0,0,0,0,0,0,2,3,3,71600,28539,5725,37968,0
55,792,167,116,138,4,5,22,171,8,48,30,56,56,86,292,499,4,2330,129,0,2,4,1,71600,28539,5725,37969,0
53,1120,447,308,343,6,5,95,453,7,96,59,111,103,170,651,1136,4,4600,255,0,2,5,1,71600,28542,5725,37970,0
53,1120,322,174,179,16,74,51,338,10,41,26,46,51,72,252,408,5,2291,127,0,2,5,1,71600,28545,5726,37971,0
30,662,215,129,180,6,0,29,221,8,65,43,72,73,115,415,711,4,3153,175,0,2,1,1,71600,28545,5726,37972,0
30,662,97,69,77,3,3,16,100,6,22,13,23,28,36,113,173,3,542,30,0,2,1,1,71600,28546,5726,37973,0
231,4976,1943,715,1694,26,18,214,1969,12,185,120,237,197,357,1436,2721,7,20915,1161,0,2,17,6,71600,28548,5726,37974,0
231,4976,1168,838,957,57,25,144,1225,19,348,224,416,367,640,3018,5452,11,61921,3440,1,2,17,6,71610,28550,5726,37975,0
19,709,442,244,305,14,16,103,456,11,68,45,75,79,120,452,756,6,4588,254,0,2,10,2,71610,28552,5726,37976,0
19,709,182,102,99,11,40,35,193,3,11,6,11,14,17,42,64,1,97,5,0,2,10,2,71610,28553,5726,37977,0
29,745,601,196,481,2,23,85,603,8,63,36,72,71,108,400,664,4,3036,168,0,2,3,2,71610,28553,5726,37978,0
29,745,156,79,106,5,16,28,161,5,14,8,15,19,23,64,97,2,261,14,0,2,3,2,71610,28553,5726,37979,0
99,4109,1289,550,1043,56,32,155,1345,10,167,93,185,177,278,1266,2075,5,11498,638,0,2,3,3,71610,28555,5727,37980,0
180,8032,139,89,101,2,0,35,141,7,54,34,62,61,96,330,569,4,2287,127,0,2,11,11,71610,28555,5727,37981,0
180,8032,7,5,5,0,0,2,7,1,2,1,2,3,3,2,4,0,2,0,0,2,11,11,71610,28555,5727,37982,0
33,1004,465,148,393,5,8,60,470,4,31,20,31,35,51,161,261,2,523,29,0,2,1,1,71610,28556,5727,37983,0
33,1004,16,12,9,0,0,6,16,1,2,1,2,3,3,2,4,0,2,0,0,2,1,1,71610,28556,5727,37984,0
29,850,256,139,192,9,7,47,265,4,23,12,24,27,36,112,171,2,357,19,0,2,18,1,71610,28557,5727,37985,0
46,3395,996,429,845,24,10,117,1020,7,76,50,88,83,138,494,879,4,3565,198,0,2,26,2,71610,28559,5727,37986,0
123,5258,1513,682,1277,25,13,200,1538,11,199,116,219,210,335,1557,2584,6,15641,868,0,2,26,26,71610,28561,5727,37987,0
96,4695,1523,757,1297,19,12,193,1542,12,193,117,230,205,347,1508,2664,7,19053,1058,0,2,2,2,71620,28563,5727,37988,0
100,4333,1020,354,843,12,15,144,1032,8,134,77,144,142,221,970,1580,4,6792,377,0,2,1,1,71620,28563,5727,37989,0
21,670,424,94,331,4,0,89,428,1,5,5,5,6,10,11,25,0,12,0,0,2,10,10,71620,28564,5727,37990,0
14,546,295,56,236,0,4,54,295,2,9,5,10,11,15,30,51,1,57,3,0,2,4,4,71620,28566,5727,37991,0
100,5223,1943,715,1694,26,18,214,1969,12,185,120,237,197,357,1436,2721,7,20915,1161,0,2,54,11,71620,28568,5727,37992,0
35,1441,442,244,305,14,16,103,456,11,68,45,75,79,120,452,756,6,4588,254,0,2,30,3,71620,28570,5727,37993,0
51,1917,1098,241,925,5,10,155,1103,7,46,25,49,53,74,273,423,3,1580,87,0,2,6,6,71630,28572,5727,37994,0
45,1575,601,196,481,2,23,85,603,8,63,36,72,71,108,400,664,4,3036,168,0,2,1,1,71630,28572,5727,37995,0
91,1839,757,253,292,73,244,162,830,13,61,38,67,74,105,409,651,7,4654,258,0,2,1,1,71630,28573,5727,37996,0
30,878,256,139,192,9,7,47,265,4,23,12,24,27,36,112,171,2,357,19,0,2,4,0,71630,28574,5727,37997,0
1,321,382,65,130,157,2,92,539,4,10,5,10,14,15,41,57,2,114,6,0,2,1,0,71630,28575,5728,37998,0
180,8032,139,89,101,2,0,35,141,7,54,34,62,61,96,330,569,4,2287,127,0,2,3,10,71630,28575,5728,37999,0
180,8032,7,5,5,0,0,2,7,1,2,1,2,3,3,2,4,0,2,0,0,2,3,10,71630,28575,5728,38000,0
180,8032,139,89,101,2,0,35,141,7,54,34,62,61,96,330,569,4,2287,127,0,2,3,10,71630,28575,5728,38001,0
180,8032,7,5,5,0,0,2,7,1,2,1,2,3,3,2,4,0,2,0,0,2,3,10,71630,28575,5728,38002,0
91,1842,757,253,292,73,244,162,830,13,61,38,67,74,105,409,651,7,4654,258,0,2,1,1,71630,28576,5728,38003,0
180,8032,139,89,101,2,0,35,141,7,54,34,62,61,96,330,569,4,2287,127,0,2,3,10,71630,28576,5728,38004,0
180,8032,7,5,5,0,0,2,7,1,2,1,2,3,3,2,4,0,2,0,0,2,3,10,71630,28576,5728,38005,0
30,878,256,139,192,9,7,47,265,4,23,12,24,27,36,112,171,2,357,19,0,2,4,0,71630,28577,5728,38006,0
1,321,382,65,130,157,2,92,539,4,10,5,10,14,15,41,57,2,114,6,0,2,1,0,71630,28578,5729,38007,0
17,378,85,59,61,8,0,16,93,5,18,10,18,23,28,86,126,2,316,17,0,2,2,2,71630,28578,5729,38008,0
180,5417,1660,832,1314,41,38,274,1701,20,312,209,395,332,604,2671,5058,12,64042,3557,1,2,1,0,71630,28580,5730,38010,0
180,5417,1057,646,719,113,100,145,1170,18,215,134,248,233,382,1740,3004,10,31186,1732,1,2,1,0,71640,28581,5731,38011,0
81,1825,996,429,845,24,10,117,1020,7,76,50,88,83,138,494,879,4,3565,198,0,2,12,3,71640,28583,5731,38012,0
81,1825,456,277,329,12,42,72,468,13,85,50,97,98,147,592,972,7,7212,400,0,2,12,3,71640,28583,5731,38013,0
219,4747,2,2,2,0,0,0,2,0,0,0,0,0,0,0,0,0,0,0,0,2,3,3,71640,28583,5731,38013,0
219,4747,99,48,90,1,3,5,100,0,0,0,0,0,0,0,0,0,0,0,0,2,3,3,71640,28584,5731,38014,0
219,4747,8,5,5,2,0,1,10,0,0,0,0,0,0,0,0,0,0,0,0,2,3,3,71640,28584,5731,38015,0
219,4747,1217,716,841,84,126,174,1301,14,185,118,215,199,333,1446,2542,8,20687,1149,0,2,3,3,71650,28586,5731,38016,0
219,4747,160,89,115,0,13,31,160,7,15,11,17,22,28,78,124,3,495,27,0,2,3,3,71650,28586,5731,38017,0
219,4747,10,10,9,9,0,0,19,0,0,0,0,0,0,0,0,0,0,0,0,2,3,3,71650,28586,5732,38018,0
219,4747,173,84,99,8,29,36,181,5,12,7,13,17,20,54,81,2,221,12,0,2,3,3,71650,28587,5732,38019,0
219,4747,3,1,1,3,0,0,6,0,0,0,0,0,0,0,0,0,0,0,0,2,3,3,71650,28587,5732,38020,0
55,792,167,116,138,4,5,22,171,8,48,30,56,56,86,292,499,4,2330,129,0,2,4,1,71650,28587,5732,38021,0
53,1120,447,308,343,6,5,95,453,7,96,59,111,103,170,651,1136,4,4600,255,0,2,5,1,71650,28590,5732,38022,0
53,1120,322,174,179,16,74,51,338,10,41,26,46,51,72,252,408,5,2291,127,0,2,5,1,71650,28593,5733,38023,0
91,1842,757,253,292,73,244,162,830,13,61,38,67,74,105,409,651,7,4654,258,0,2,1,1,71650,28594,5733,38024,0
30,662,215,129,180,6,0,29,221,8,65,43,72,73,115,415,711,4,3153,175,0,2,1,1,71650,28594,5733,38025,0
30,662,97,69,77,3,3,16,100,6,22,13,23,28,36,113,173,3,542,30,0,2,1,1,71650,28595,5733,38026,0
231,4976,1943,715,1694,26,18,214,1969,12,185,120,237,197,357,1436,2721,7,20915,1161,0,2,17,6,71650,28597,5733,38027,0
231,4976,1168,838,957,57,25,144,1225,19,348,224,416,367,640,3018,5452,11,61921,3440,1,2,17,6,71660,28599,5733,38028,0
19,709,442,244,305,14,16,103,456,11,68,45,75,79,120,452,756,6,4588,254,0,2,10,2,71660,28601,5733,38029,0
19,709,182,102,99,11,40,35,193,3,11,6,11,14,17,42,64,1,97,5,0,2,10,2,71660,28602,5733,38030,0
29,745,601,196,481,2,23,85,603,8,63,36,72,71,108,400,664,4,3036,168,0,2,3,2,71660,28602,5733,38031,0
29,745,156,79,106,5,16,28,161,5,14,8,15,19,23,64,97,2,261,14,0,2,3,2,71660,28602,5733,38032,0
99,4109,1289,550,1043,56,32,155,1345,10,167,93,185,177,278,1266,2075,5,11498,638,0,2,3,3,71660,28604,5734,38033,0
180,8032,139,89,101,2,0,35,141,7,54,34,62,61,96,330,569,4,2287,127,0,2,14,21,71660,28604,5734,38034,0
180,8032,7,5,5,0,0,2,7,1,2,1,2,3,3,2,4,0,2,0,0,2,14,21,71660,28604,5734,38035,0
33,1004,465,148,393,5,8,60,470,4,31,20,31,35,51,161,261,2,523,29,0,2,1,1,71660,28605,5734,38036,0
33,1004,16,12,9,0,0,6,16,1,2,1,2,3,3,2,4,0,2,0,0,2,1,1,71660,28605,5734,38037,0
30,878,256,139,192,9,7,47,265,4,23,12,24,27,36,112,171,2,357,19,0,2,22,1,71660,28606,5734,38038,0
46,3395,996,429,845,24,10,117,1020,7,76,50,88,83,138,494,879,4,3565,198,0,2,26,2,71660,28608,5734,38039,0
123,5258,1513,682,1277,25,13,200,1538,11,199,116,219,210,335,1557,2584,6,15641,868,0,2,26,26,71660,28610,5734,38040,0
96,4695,1523,757,1297,19,12,193,1542,12,193,117,230,205,347,1508,2664,7,19053,1058,0,2,2,2,71670,28612,5734,38041,0
100,4333,1020,354,843,12,15,144,1032,8,134,77,144,142,221,970,1580,4,6792,377,0,2,1,1,71670,28612,5734,38042,0
21,670,424,94,331,4,0,89,428,1,5,5,5,6,10,11,25,0,12,0,0,2,10,10,71670,28613,5734,38043,0
14,546,295,56,236,0,4,54,295,2,9,5,10,11,15,30,51,1,57,3,0,2,4,4,71670,28615,5734,38044,0
100,5223,1943,715,1694,26,18,214,1969,12,185,120,237,197,357,1436,2721,7,20915,1161,0,2,54,11,71670,28617,5734,38045,0
35,1441,442,244,305,14,16,103,456,11,68,45,75,79,120,452,756,6,4588,254,0,2,30,3,71670,28619,5734,38046,0
51,1917,1098,241,925,5,10,155,1103,7,46,25,49,53,74,273,423,3,1580,87,0,2,6,6,71680,28621,5734,38047,0
45,1575,601,196,481,2,23,85,603,8,63,36,72,71,108,400,664,4,3036,168,0,2,1,1,71680,28621,5734,38048,0
87,1961,53,23,39,0,0,13,53,2,8,4,8,10,12,26,39,1,39,2,0,2,1,1,71680,28621,5734,38049,1
87,1961,515,298,307,33,80,99,548,12,63,44,77,75,121,419,753,7,5527,307,0,2,1,1,71690,28621,5734,38050,1
105,4860,1338,495,1086,10,64,173,1348,11,122,82,157,133,239,883,1686,7,11934,663,0,2,13,5,71690,28623,5734,38051,1
139,6326,1782,648,1425,9,47,279,1791,8,171,97,189,179,286,1292,2140,4,9462,525,0,2,3,3,71690,28624,5735,38052,1
80,4548,1296,573,1062,40,33,157,1336,8,201,118,231,209,349,1561,2689,4,12365,686,0,2,20,20,71690,28624,5735,38053,1
100,5223,1943,715,1694,26,18,214,1969,12,185,120,237,197,357,1436,2721,7,20915,1161,0,2,5,6,71690,28626,5735,38054,1
87,1961,53,23,39,0,0,13,53,2,8,4,8,10,12,26,39,1,39,2,0,2,1,1,71690,28626,5735,38055,0
87,1961,515,298,307,33,80,99,548,12,63,44,77,75,121,419,753,7,5527,307,0,2,1,1,71700,28626,5735,38056,0
105,4860,1338,495,1086,10,64,173,1348,11,122,82,157,133,239,883,1686,7,11934,663,0,2,13,5,71700,28628,5735,38057,0
139,6326,1782,648,1425,9,47,279,1791,8,171,97,189,179,286,1292,2140,4,9462,525,0,2,3,3,71700,28629,5736,38058,0
80,4548,1296,573,1062,40,33,157,1336,8,201,118,231,209,349,1561,2689,4,12365,686,0,2,20,20,71700,28629,5736,38059,0
100,5223,1943,715,1694,26,18,214,1969,12,185,120,237,197,357,1436,2721,7,20915,1161,0,2,5,6,71700,28631,5736,38060,0
1,321,382,65,130,157,2,92,539,4,10,5,10,14,15,41,57,2,114,6,0,2,1,0,71700,28632,5737,38061,0
1,321,382,65,130,157,2,92,539,4,10,5,10,14,15,41,57,2,114,6,0,2,1,0,71700,28633,5738,38062,0
60,1167,282,196,195,3,0,86,285,8,130,71,141,138,212,936,1507,4,6538,363,0,2,3,3,71700,28633,5739,38063,1
91,1864,757,253,292,73,244,162,830,13,61,38,67,74,105,409,651,7,4654,258,0,2,7,10,71700,28634,5739,38065,1
45,935,386,256,301,16,9,68,402,4,59,35,69,63,104,355,621,2,1453,80,0,2,2,0,71700,28634,5739,38066,1
45,935,264,131,164,11,41,46,275,6,38,22,40,44,62,214,338,3,1068,59,0,2,2,0,71710,28634,5740,38067,1
35,1093,182,127,129,0,0,53,182,5,39,21,42,44,63,217,343,2,926,51,0,2,1,1,71710,28634,5741,38068,1
153,7221,1392,870,1177,35,17,170,1427,14,494,280,531,508,811,4473,7289,7,54850,3047,2,2,4,2,71710,28637,5742,38069,1
92,2899,773,419,590,28,0,166,801,10,204,113,217,214,330,1598,2554,5,13587,754,0,2,9,16,71710,28637,5743,38070,1
1,24,127,75,83,2,11,30,129,4,14,7,14,18,21,61,87,2,175,9,0,2,1,1,71710,28637,5743,38071,1
1,24,652,304,544,16,6,88,668,6,89,51,101,95,152,591,998,3,3399,188,0,2,1,1,71710,28638,5743,38072,1
1,24,2,2,2,0,0,0,2,0,0,0,0,0,0,0,0,0,0,0,0,2,1,1,71710,28638,5743,38072,1
1,24,8,5,5,0,0,3,8,0,0,0,0,0,0,0,0,0,0,0,0,2,1,1,71710,28638,5743,38073,1
1,24,2,2,2,0,0,0,2,0,0,0,0,0,0,0,0,0,0,0,0,2,1,1,71710,28638,5743,38073,1
1,24,14,8,8,0,0,6,14,0,0,0,0,0,0,0,0,0,0,0,0,2,1,1,71710,28638,5743,38074,1
1,24,6,4,4,0,0,2,6,0,0,0,0,0,0,0,0,0,0,0,0,2,1,1,71710,28638,5743,38075,1
1,24,6,4,4,0,0,2,6,1,2,1,2,3,3,2,4,0,2,0,0,2,1,1,71710,28638,5743,38076,1
1,24,6,4,4,0,0,2,6,0,0,0,0,0,0,0,0,0,0,0,0,2,1,1,71710,28638,5743,38077,1
1,24,7,5,5,0,0,2,7,0,0,0,0,0,0,0,0,0,0,0,0,2,1,1,71710,28638,5743,38078,1
1,24,6,4,4,0,0,2,6,0,0,0,0,0,0,0,0,0,0,0,0,2,1,1,71710,28638,5743,38079,1
1,24,10,6,6,0,0,4,10,0,0,0,0,0,0,0,0,0,0,0,0,2,1,1,71710,28638,5743,38080,1
1,24,1,1,1,0,0,0,1,0,0,0,0,0,0,0,0,0,0,0,0,2,1,1,71710,28638,5743,38080,1
1,24,14,10,10,0,0,4,14,1,1,1,1,2,2,0,2,0,1,0,0,2,1,1,71710,28638,5743,38081,1
1,24,46,26,30,3,0,12,49,3,6,3,6,9,9,20,28,1,42,2,0,2,1,1,71720,28638,5743,38082,1
105,4868,1338,495,1086,10,64,173,1348,11,122,82,157,133,239,883,1686,7,11934,663,0,2,3,2,71720,28640,5743,38083,1
180,8038,139,89,101,2,0,35,141,7,54,34,62,61,96,330,569,4,2287,127,0,2,2,1,71720,28640,5743,38084,1
180,8038,7,5,5,0,0,2,7,1,2,1,2,3,3,2,4,0,2,0,0,2,2,1,71720,28640,5743,38085,1
139,6352,1782,648,1425,9,47,279,1791,8,171,97,189,179,286,1292,2140,4,9462,525,0,2,4,4,71720,28641,5744,38086,1
30,938,256,139,192,9,7,47,265,4,23,12,24,27,36,112,171,2,357,19,0,2,12,5,71720,28642,5744,38087,1
123,5266,1513,682,1277,25,13,200,1538,11,199,116,219,210,335,1557,2584,6,15641,868,0,2,5,5,71720,28644,5744,38088,1
92,4741,1457,730,1242,11,6,188,1468,10,292,166,329,302,495,2424,4078,5,22973,1276,1,2,4,3,71720,28646,5744,38089,1
42,1932,447,308,343,6,5,95,453,7,96,59,111,103,170,651,1136,4,4600,255,0,2,4,4,71720,28649,5744,38090,1
38,2315,334,251,279,10,4,40,344,5,127,74,143,132,217,899,1528,2,4303,239,0,2,1,5,71720,28650,5744,38091,1
31,1885,384,251,317,7,8,52,391,11,70,44,84,81,128,467,811,6,5355,297,0,2,5,5,71720,28650,5744,38092,1
47,2254,722,423,573,19,0,135,741,12,172,101,199,184,300,1320,2257,6,15668,870,0,2,2,2,71720,28652,5744,38094,1
45,1961,386,256,301,16,9,68,402,4,59,35,69,63,104,355,621,2,1453,80,0,2,13,4,71720,28652,5744,38095,1
84,3328,1043,504,840,53,9,147,1096,9,180,112,198,189,310,1377,2344,4,11604,644,0,2,5,12,71720,28654,5744,38096,1
30,1267,373,158,315,8,0,51,381,5,76,44,79,81,123,486,779,2,2026,112,0,2,2,6,71720,28654,5744,38097,1
100,5228,1943,715,1694,26,18,214,1969,12,185,120,237,197,357,1436,2721,7,20915,1161,0,2,2,1,71720,28656,5744,38098,1
60,1167,282,196,195,3,0,86,285,8,130,71,141,138,212,936,1507,4,6538,363,0,2,3,3,71720,28656,5745,38099,0
91,1864,757,253,292,73,244,162,830,13,61,38,67,74,105,409,651,7,4654,258,0,2,7,10,71720,28657,5745,38101,0
45,935,386,256,301,16,9,68,402,4,59,35,69,63,104,355,621,2,1453,80,0,2,2,0,71720,28657,5745,38102,0
45,935,264,131,164,11,41,46,275,6,38,22,40,44,62,214,338,3,1068,59,0,2,2,0,71730,28657,5746,38103,0
35,1093,182,127,129,0,0,53,182,5,39,21,42,44,63,217,343,2,926,51,0,2,1,1,71730,28657,5747,38104,0
153,7221,1392,870,1177,35,17,170,1427,14,494,280,531,508,811,4473,7289,7,54850,3047,2,2,4,2,71730,28660,5748,38105,0
92,2899,773,419,590,28,0,166,801,10,204,113,217,214,330,1598,2554,5,13587,754,0,2,9,16,71730,28660,5749,38106,0
1,24,127,75,83,2,11,30,129,4,14,7,14,18,21,61,87,2,175,9,0,2,1,1,71730,28660,5749,38107,0
1,24,652,304,544,16,6,88,668,6,89,51,101,95,152,591,998,3,3399,188,0,2,1,1,71730,28661,5749,38108,0
1,24,2,2,2,0,0,0,2,0,0,0,0,0,0,0,0,0,0,0,0,2,1,1,71730,28661,5749,38108,0
1,24,8,5,5,0,0,3,8,0,0,0,0,0,0,0,0,0,0,0,0,2,1,1,71730,28661,5749,38109,0
1,24,2,2,2,0,0,0,2,0,0,0,0,0,0,0,0,0,0,0,0,2,1,1,71730,28661,5749,38109,0
1,24,14,8,8,0,0,6,14,0,0,0,0,0,0,0,0,0,0,0,0,2,1,1,71730,28661,5749,38110,0
1,24,6,4,4,0,0,2,6,0,0,0,0,0,0,0,0,0,0,0,0,2,1,1,71730,28661,5749,38111,0
1,24,6,4,4,0,0,2,6,1,2,1,2,3,3,2,4,0,2,0,0,2,1,1,71730,28661,5749,38112,0
1,24,6,4,4,0,0,2,6,0,0,0,0,0,0,0,0,0,0,0,0,2,1,1,71730,28661,5749,38113,0
1,24,7,5,5,0,0,2,7,0,0,0,0,0,0,0,0,0,0,0,0,2,1,1,71730,28661,5749,38114,0
1,24,6,4,4,0,0,2,6,0,0,0,0,0,0,0,0,0,0,0,0,2,1,1,71730,28661,5749,38115,0
1,24,10,6,6,0,0,4,10,0,0,0,0,0,0,0,0,0,0,0,0,2,1,1,71730,28661,5749,38116,0
1,24,1,1,1,0,0,0,1,0,0,0,0,0,0,0,0,0,0,0,0,2,1,1,71730,28661,5749,38116,0
1,24,14,10,10,0,0,4,14,1,1,1,1,2,2,0,2,0,1,0,0,2,1,1,71730,28661,5749,38117,0
1,24,46,26,30,3,0,12,49,3,6,3,6,9,9,20,28,1,42,2,0,2,1,1,71740,28661,5749,38118,0
105,4868,1338,495,1086,10,64,173,1348,11,122,82,157,133,239,883,1686,7,11934,663,0,2,3,2,71740,28663,5749,38119,0
180,8038,139,89,101,2,0,35,141,7,54,34,62,61,96,330,569,4,2287,127,0,2,2,1,71740,28663,5749,38120,0
180,8038,7,5,5,0,0,2,7,1,2,1,2,3,3,2,4,0,2,0,0,2,2,1,71740,28663,5749,38121,0
139,6352,1782,648,1425,9,47,279,1791,8,171,97,189,179,286,1292,2140,4,9462,525,0,2,4,4,71740,28664,5750,38122,0
30,938,256,139,192,9,7,47,265,4,23,12,24,27,36,112,171,2,357,19,0,2,12,5,71740,28665,5750,38123,0
123,5266,1513,682,1277,25,13,200,1538,11,199,116,219,210,335,1557,2584,6,15641,868,0,2,5,5,71740,28667,5750,38124,0
92,4741,1457,730,1242,11,6,188,1468,10,292,166,329,302,495,2424,4078,5,22973,1276,1,2,4,3,71740,28669,5750,38125,0
42,1932,447,308,343,6,5,95,453,7,96,59,111,103,170,651,1136,4,4600,255,0,2,4,4,71740,28672,5750,38126,0
38,2315,334,251,279,10,4,40,344,5,127,74,143,132,217,899,1528,2,4303,239,0,2,1,5,71740,28673,5750,38127,0
31,1885,384,251,317,7,8,52,391,11,70,44,84,81,128,467,811,6,5355,297,0,2,5,5,71740,28673,5750,38128,0
47,2254,722,423,573,19,0,135,741,12,172,101,199,184,300,1320,2257,6,15668,870,0,2,2,2,71740,28675,5750,38130,0
45,1961,386,256,301,16,9,68,402,4,59,35,69,63,104,355,621,2,1453,80,0,2,13,4,71740,28675,5750,38131,0
84,3328,1043,504,840,53,9,147,1096,9,180,112,198,189,310,1377,2344,4,11604,644,0,2,5,12,71740,28677,5750,38132,0
30,1267,373,158,315,8,0,51,381,5,76,44,79,81,123,486,779,2,2026,112,0,2,2,6,71740,28677,5750,38133,0
100,5228,1943,715,1694,26,18,214,1969,12,185,120,237,197,357,1436,2721,7,20915,1161,0,2,2,1,71740,28679,5750,38134,0
73,1510,207,111,150,11,0,50,218,5,26,19,36,31,55,133,272,3,943,52,0,2,0,1,71740,28679,5750,38135,1
73,1510,410,198,237,31,55,97,441,11,63,38,72,74,110,414,683,6,4293,238,0,2,0,1,71750,28680,5751,38136,1
258,6040,4293,999,3693,19,54,507,4312,9,155,88,170,164,258,1156,1898,4,9368,520,0,2,0,6,71750,28682,5751,38138,1
258,6040,1482,859,1002,125,135,219,1607,16,219,134,251,235,385,1766,3032,9,27804,1544,1,2,0,6,71760,28683,5751,38139,1
83,1769,53,23,39,0,0,13,53,2,8,4,8,10,12,26,39,1,39,2,0,2,0,35,71760,28683,5751,38140,1
83,1769,515,298,307,33,80,99,548,12,63,44,77,75,121,419,753,7,5527,307,0,2,0,35,71770,28683,5751,38141,1
18,304,424,94,331,4,0,89,428,1,5,5,5,6,10,11,25,0,12,0,0,2,0,12,71770,28684,5751,38142,1
18,304,38,23,23,6,0,8,44,3,11,7,11,14,18,42,68,1,102,5,0,2,0,12,71770,28684,5751,38143,1
300,6660,72,33,56,0,4,12,72,1,1,1,1,2,2,0,2,0,1,0,0,2,9,53,71770,28684,5751,38144,1
300,6660,1454,835,1044,76,110,219,1530,17,275,158,296,292,454,2297,3718,9,34017,1889,1,2,9,53,71780,28685,5751,38145,1
22,1058,75,38,59,1,3,12,76,2,4,2,4,6,6,10,15,1,15,0,0,2,0,71,71780,28685,5751,38146,1
91,4033,1338,495,1086,10,64,173,1348,11,122,82,157,133,239,883,1686,7,11934,663,0,2,0,293,71780,28687,5751,38147,1
179,8008,139,89,101,2,0,35,141,7,54,34,62,61,96,330,569,4,2287,127,0,2,0,18,71780,28687,5751,38148,1
179,8008,7,5,5,0,0,2,7,1,2,1,2,3,3,2,4,0,2,0,0,2,0,18,71780,28687,5751,38149,1
79,4485,1296,573,1062,40,33,157,1336,8,201,118,231,209,349,1561,2689,4,12365,686,0,2,0,14,71780,28687,5751,38150,1
20,626,424,94,331,4,0,89,428,1,5,5,5,6,10,11,25,0,12,0,0,2,0,68,71780,28688,5751,38151,1
65,2991,1293,570,1093,25,15,163,1318,10,195,123,241,205,364,1516,2795,6,17273,959,0,2,0,22,71790,28690,5751,38152,1
12,478,295,56,236,0,4,54,295,2,9,5,10,11,15,30,51,1,57,3,0,2,0,59,71790,28692,5751,38153,1
29,1210,373,158,315,8,0,51,381,5,76,44,79,81,123,486,779,2,2026,112,0,2,0,14,71790,28692,5751,38154,1
102,5247,1943,715,1694,26,18,214,1969,12,185,120,237,197,357,1436,2721,7,20915,1161,0,2,17,7,71790,28694,5751,38155,1
73,1510,207,111,150,11,0,50,218,5,26,19,36,31,55,133,272,3,943,52,0,2,0,1,71790,28694,5751,38156,0
73,1510,410,198,237,31,55,97,441,11,63,38,72,74,110,414,683,6,4293,238,0,2,0,1,71800,28695,5752,38157,0
258,6040,4293,999,3693,19,54,507,4312,9,155,88,170,164,258,1156,1898,4,9368,520,0,2,0,6,71800,28697,5752,38159,0
258,6040,1482,859,1002,125,135,219,1607,16,219,134,251,235,385,1766,3032,9,27804,1544,1,2,0,6,71810,28698,5752,38160,0
83,1769,53,23,39,0,0,13,53,2,8,4,8,10,12,26,39,1,39,2,0,2,0,35,71810,28698,5752,38161,0
83,1769,515,298,307,33,80,99,548,12,63,44,77,75,121,419,753,7,5527,307,0,2,0,35,71820,28698,5752,38162,0
18,304,424,94,331,4,0,89,428,1,5,5,5,6,10,11,25,0,12,0,0,2,0,12,71820,28699,5752,38163,0
18,304,38,23,23,6,0,8,44,3,11,7,11,14,18,42,68,1,102,5,0,2,0,12,71820,28699,5752,38164,0
300,6660,72,33,56,0,4,12,72,1,1,1,1,2,2,0,2,0,1,0,0,2,9,53,71820,28699,5752,38165,0
300,6660,1454,835,1044,76,110,219,1530,17,275,158,296,292,454,2297,3718,9,34017,1889,1,2,9,53,71830,28700,5752,38166,0
22,1058,75,38,59,1,3,12,76,2,4,2,4,6,6,10,15,1,15,0,0,2,0,71,71830,28700,5752,38167,0
91,4033,1338,495,1086,10,64,173,1348,11,122,82,157,133,239,883,1686,7,11934,663,0,2,0,293,71830,28702,5752,38168,0
179,8008,139,89,101,2,0,35,141,7,54,34,62,61,96,330,569,4,2287,127,0,2,0,18,71830,28702,5752,38169,0
179,8008,7,5,5,0,0,2,7,1,2,1,2,3,3,2,4,0,2,0,0,2,0,18,71830,28702,5752,38170,0
79,4485,1296,573,1062,40,33,157,1336,8,201,118,231,209,349,1561,2689,4,12365,686,0,2,0,14,71830,28702,5752,38171,0
20,626,424,94,331,4,0,89,428,1,5,5,5,6,10,11,25,0,12,0,0,2,0,68,71830,28703,5752,38172,0
65,2991,1293,570,1093,25,15,163,1318,10,195,123,241,205,364,1516,2795,6,17273,959,0,2,0,22,71840,28705,5752,38173,0
12,478,295,56,236,0,4,54,295,2,9,5,10,11,15,30,51,1,57,3,0,2,0,59,71840,28707,5752,38174,0
29,1210,373,158,315,8,0,51,381,5,76,44,79,81,123,486,779,2,2026,112,0,2,0,14,71840,28707,5752,38175,0
102,5247,1943,715,1694,26,18,214,1969,12,185,120,237,197,357,1436,2721,7,20915,1161,0,2,17,7,71840,28709,5752,38176,0
18,306,424,94,331,4,0,89,428,1,5,5,5,6,10,11,25,0,12,0,0,2,3,1,71840,28710,5752,38177,0
18,306,38,23,23,6,0,8,44,3,11,7,11,14,18,42,68,1,102,5,0,2,3,1,71840,28710,5752,38178,0
95,2070,1043,504,840,53,9,147,1096,9,180,112,198,189,310,1377,2344,4,11604,644,0,2,38,23,71840,28712,5752,38179,0
95,2070,383,288,292,26,6,62,409,11,65,38,67,76,105,429,656,5,3719,206,0,2,38,23,71840,28713,5752,38180,0
82,3278,1043,504,840,53,9,147,1096,9,180,112,198,189,310,1377,2344,4,11604,644,0,2,2,12,71840,28715,5752,38181,0
18,306,424,94,331,4,0,89,428,1,5,5,5,6,10,11,25,0,12,0,0,2,3,1,71840,28716,5752,38182,0
18,306,38,23,23,6,0,8,44,3,11,7,11,14,18,42,68,1,102,5,0,2,3,1,71840,28716,5752,38183,0
95,2070,1043,504,840,53,9,147,1096,9,180,112,198,189,310,1377,2344,4,11604,644,0,2,38,23,71840,28718,5752,38184,0
95,2070,383,288,292,26,6,62,409,11,65,38,67,76,105,429,656,5,3719,206,0,2,38,23,71840,28719,5752,38185,0
82,3278,1043,504,840,53,9,147,1096,9,180,112,198,189,310,1377,2344,4,11604,644,0,2,2,12,71840,28721,5752,38186,0
1,321,382,65,130,157,2,92,539,4,10,5,10,14,15,41,57,2,114,6,0,2,1,0,71840,28722,5753,38187,0
60,1167,282,196,195,3,0,86,285,8,130,71,141,138,212,936,1507,4,6538,363,0,2,27,3,71840,28722,5754,38188,0
1,90,13,10,10,0,0,3,13,1,2,1,2,3,3,2,4,0,2,0,0,2,1,1,71840,28722,5754,38189,0
17,378,85,59,61,8,0,16,93,5,18,10,18,23,28,86,126,2,316,17,0,2,2,2,71840,28722,5754,38190,0
231,4983,182,127,129,0,0,53,182,5,39,21,42,44,63,217,343,2,926,51,0,2,68,22,71840,28722,5755,38191,0
231,4983,1165,710,800,67,119,181,1232,18,243,153,282,261,435,2000,3492,10,36473,2026,1,2,68,22,71850,28722,5756,38192,0
180,5417,1660,832,1314,41,38,274,1701,20,312,209,395,332,604,2671,5058,12,64042,3557,1,2,1,0,71850,28724,5757,38194,0
180,5417,1057,646,719,113,100,145,1170,18,215,134,248,233,382,1740,3004,10,31186,1732,1,2,1,0,71860,28725,5758,38195,0
108,2059,477,336,357,30,23,73,507,16,194,134,250,210,384,1538,2962,10,30538,1696,0,2,42,1,71870,28726,5758,38196,0
81,1825,996,429,845,24,10,117,1020,7,76,50,88,83,138,494,879,4,3565,198,0,2,12,3,71870,28728,5758,38197,0
81,1825,456,277,329,12,42,72,468,13,85,50,97,98,147,592,972,7,7212,400,0,2,12,3,71870,28728,5758,38198,0
73,1510,207,111,150,11,0,50,218,5,26,19,36,31,55,133,272,3,943,52,0,2,0,1,71870,28728,5758,38199,0
73,1510,410,198,237,31,55,97,441,11,63,38,72,74,110,414,683,6,4293,238,0,2,0,1,71880,28729,5759,38200,0
219,4747,2,2,2,0,0,0,2,0,0,0,0,0,0,0,0,0,0,0,0,2,3,3,71880,28729,5759,38200,0
219,4747,99,48,90,1,3,5,100,0,0,0,0,0,0,0,0,0,0,0,0,2,3,3,71880,28730,5759,38201,0
219,4747,8,5,5,2,0,1,10,0,0,0,0,0,0,0,0,0,0,0,0,2,3,3,71880,28730,5759,38202,0
219,4747,1217,716,841,84,126,174,1301,14,185,118,215,199,333,1446,2542,8,20687,1149,0,2,3,3,71890,28732,5759,38203,0
219,4747,160,89,115,0,13,31,160,7,15,11,17,22,28,78,124,3,495,27,0,2,3,3,71890,28732,5759,38204,0
219,4747,10,10,9,9,0,0,19,0,0,0,0,0,0,0,0,0,0,0,0,2,3,3,71890,28732,5760,38205,0
219,4747,173,84,99,8,29,36,181,5,12,7,13,17,20,54,81,2,221,12,0,2,3,3,71890,28733,5760,38206,0
219,4747,3,1,1,3,0,0,6,0,0,0,0,0,0,0,0,0,0,0,0,2,3,3,71890,28733,5760,38207,0
55,792,167,116,138,4,5,22,171,8,48,30,56,56,86,292,499,4,2330,129,0,2,4,1,71890,28733,5760,38208,0
258,6040,4293,999,3693,19,54,507,4312,9,155,88,170,164,258,1156,1898,4,9368,520,0,2,0,6,71890,28735,5760,38210,0
258,6040,1482,859,1002,125,135,219,1607,16,219,134,251,235,385,1766,3032,9,27804,1544,1,2,0,6,71900,28736,5760,38211,0
150,3478,77,34,69,0,0,8,77,3,24,16,29,27,45,114,213,1,387,21,0,2,2,2,71900,28736,5760,38212,0
150,3478,712,438,573,51,9,84,763,14,102,71,128,116,199,733,1364,8,11988,666,0,2,2,2,71910,28737,5760,38213,0
53,1120,447,308,343,6,5,95,453,7,96,59,111,103,170,651,1136,4,4600,255,0,2,5,1,71910,28740,5760,38214,0
53,1120,322,174,179,16,74,51,338,10,41,26,46,51,72,252,408,5,2291,127,0,2,5,1,71910,28743,5761,38215,0
83,1769,53,23,39,0,0,13,53,2,8,4,8,10,12,26,39,1,39,2,0,2,1,36,71910,28743,5761,38216,0
83,1769,515,298,307,33,80,99,548,12,63,44,77,75,121,419,753,7,5527,307,0,2,1,36,71920,28743,5761,38217,0
18,306,424,94,331,4,0,89,428,1,5,5,5,6,10,11,25,0,12,0,0,2,3,13,71920,28744,5761,38218,0
18,306,38,23,23,6,0,8,44,3,11,7,11,14,18,42,68,1,102,5,0,2,3,13,71920,28744,5761,38219,0
300,6660,72,33,56,0,4,12,72,1,1,1,1,2,2,0,2,0,1,0,0,2,11,55,71920,28744,5761,38220,0
300,6660,1454,835,1044,76,110,219,1530,17,275,158,296,292,454,2297,3718,9,34017,1889,1,2,11,55,71930,28745,5761,38221,0
91,1864,757,253,292,73,244,162,830,13,61,38,67,74,105,409,651,7,4654,258,0,2,11,14,71930,28746,5761,38222,0
45,935,386,256,301,16,9,68,402,4,59,35,69,63,104,355,621,2,1453,80,0,2,2,0,71930,28746,5761,38223,0
45,935,264,131,164,11,41,46,275,6,38,22,40,44,62,214,338,3,1068,59,0,2,2,0,71940,28746,5762,38224,0
30,662,215,129,180,6,0,29,221,8,65,43,72,73,115,415,711,4,3153,175,0,2,1,1,71940,28746,5762,38225,0
30,662,97,69,77,3,3,16,100,6,22,13,23,28,36,113,173,3,542,30,0,2,1,1,71940,28747,5762,38226,0
95,2070,1043,504,840,53,9,147,1096,9,180,112,198,189,310,1377,2344,4,11604,644,0,2,38,23,71940,28749,5762,38227,0
95,2070,383,288,292,26,6,62,409,11,65,38,67,76,105,429,656,5,3719,206,0,2,38,23,71940,28750,5762,38228,0
231,4976,1943,715,1694,26,18,214,1969,12,185,120,237,197,357,1436,2721,7,20915,1161,0,2,17,6,71940,28752,5762,38229,0
231,4976,1168,838,957,57,25,144,1225,19,348,224,416,367,640,3018,5452,11,61921,3440,1,2,17,6,71950,28754,5762,38230,0
19,709,442,244,305,14,16,103,456,11,68,45,75,79,120,452,756,6,4588,254,0,2,10,2,71950,28756,5762,38231,0
19,709,182,102,99,11,40,35,193,3,11,6,11,14,17,42,64,1,97,5,0,2,10,2,71950,28757,5762,38232,0
62,1263,1098,241,925,5,10,155,1103,7,46,25,49,53,74,273,423,3,1580,87,0,2,5,1,71960,28759,5762,38233,0
62,1263,282,202,222,14,2,44,296,8,42,24,43,50,67,250,378,4,1548,86,0,2,5,1,71960,28760,5762,38234,0
29,745,601,196,481,2,23,85,603,8,63,36,72,71,108,400,664,4,3036,168,0,2,3,2,71960,28760,5762,38235,0
29,745,156,79,106,5,16,28,161,5,14,8,15,19,23,64,97,2,261,14,0,2,3,2,71960,28760,5762,38236,0
99,4109,1289,550,1043,56,32,155,1345,10,167,93,185,177,278,1266,2075,5,11498,638,0,2,3,3,71960,28762,5763,38237,0
35,1093,182,127,129,0,0,53,182,5,39,21,42,44,63,217,343,2,926,51,0,2,3,3,71960,28762,5764,38238,0
153,7221,1392,870,1177,35,17,170,1427,14,494,280,531,508,811,4473,7289,7,54850,3047,2,2,21,13,71960,28765,5765,38239,0
92,2899,773,419,590,28,0,166,801,10,204,113,217,214,330,1598,2554,5,13587,754,0,2,9,16,71960,28765,5766,38240,0
22,1058,75,38,59,1,3,12,76,2,4,2,4,6,6,10,15,1,15,0,0,2,0,71,71960,28765,5766,38241,0
1,55,14,12,10,0,0,4,14,1,2,1,2,3,3,2,4,0,2,0,0,0,14,0,71960,28765,5766,38242,0
1,58,14,12,10,0,0,4,14,1,2,1,2,3,3,2,4,0,2,0,0,0,14,0,71960,28765,5766,38243,0
1,55,14,12,10,0,0,4,14,1,2,1,2,3,3,2,4,0,2,0,0,0,14,0,71960,28765,5766,38244,0
1,77,19,18,14,0,0,5,19,1,2,1,2,3,3,2,4,0,2,0,0,0,19,0,71960,28765,5766,38245,0
1,24,127,75,83,2,11,30,129,4,14,7,14,18,21,61,87,2,175,9,0,2,1,1,71960,28765,5766,38246,0
1,24,652,304,544,16,6,88,668,6,89,51,101,95,152,591,998,3,3399,188,0,2,1,1,71960,28766,5766,38247,0
1,24,2,2,2,0,0,0,2,0,0,0,0,0,0,0,0,0,0,0,0,2,1,1,71960,28766,5766,38247,0
1,24,8,5,5,0,0,3,8,0,0,0,0,0,0,0,0,0,0,0,0,2,1,1,71960,28766,5766,38248,0
1,24,2,2,2,0,0,0,2,0,0,0,0,0,0,0,0,0,0,0,0,2,1,1,71960,28766,5766,38248,0
1,24,14,8,8,0,0,6,14,0,0,0,0,0,0,0,0,0,0,0,0,2,1,1,71960,28766,5766,38249,0
1,24,6,4,4,0,0,2,6,0,0,0,0,0,0,0,0,0,0,0,0,2,1,1,71960,28766,5766,38250,0
1,24,6,4,4,0,0,2,6,1,2,1,2,3,3,2,4,0,2,0,0,2,1,1,71960,28766,5766,38251,0
1,24,6,4,4,0,0,2,6,0,0,0,0,0,0,0,0,0,0,0,0,2,1,1,71960,28766,5766,38252,0
1,24,7,5,5,0,0,2,7,0,0,0,0,0,0,0,0,0,0,0,0,2,1,1,71960,28766,5766,38253,0
1,24,6,4,4,0,0,2,6,0,0,0,0,0,0,0,0,0,0,0,0,2,1,1,71960,28766,5766,38254,0
1,24,10,6,6,0,0,4,10,0,0,0,0,0,0,0,0,0,0,0,0,2,1,1,71960,28766,5766,38255,0
1,24,1,1,1,0,0,0,1,0,0,0,0,0,0,0,0,0,0,0,0,2,1,1,71960,28766,5766,38255,0
1,24,14,10,10,0,0,4,14,1,1,1,1,2,2,0,2,0,1,0,0,2,1,1,71960,28766,5766,38256,0
1,24,46,26,30,3,0,12,49,3,6,3,6,9,9,20,28,1,42,2,0,2,1,1,71970,28766,5766,38257,0
91,4033,1338,495,1086,10,64,173,1348,11,122,82,157,133,239,883,1686,7,11934,663,0,2,15,299,71970,28768,5766,38258,0
179,8008,139,89,101,2,0,35,141,7,54,34,62,61,96,330,569,4,2287,127,0,2,16,40,71970,28768,5766,38259,0
179,8008,7,5,5,0,0,2,7,1,2,1,2,3,3,2,4,0,2,0,0,2,16,40,71970,28768,5766,38260,0
33,1004,465,148,393,5,8,60,470,4,31,20,31,35,51,161,261,2,523,29,0,2,1,1,71970,28769,5766,38261,0
33,1004,16,12,9,0,0,6,16,1,2,1,2,3,3,2,4,0,2,0,0,2,1,1,71970,28769,5766,38262,0
139,6352,1782,648,1425,9,47,279,1791,8,171,97,189,179,286,1292,2140,4,9462,525,0,2,7,7,71970,28770,5767,38263,0
30,938,256,139,192,9,7,47,265,4,23,12,24,27,36,112,171,2,357,19,0,2,32,4,71970,28771,5767,38264,0
120,4779,1450,624,1228,12,26,181,1462,14,306,186,354,320,540,2580,4493,8,36391,2021,1,2,110,0,71970,28773,5768,38265,0
46,3395,996,429,845,24,10,117,1020,7,76,50,88,83,138,494,879,4,3565,198,0,2,26,2,71970,28775,5768,38266,0
123,5266,1513,682,1277,25,13,200,1538,11,199,116,219,210,335,1557,2584,6,15641,868,0,2,31,31,71970,28777,5768,38267,0
79,4485,1296,573,1062,40,33,157,1336,8,201,118,231,209,349,1561,2689,4,12365,686,0,2,20,34,71970,28777,5768,38268,0
92,4741,1457,730,1242,11,6,188,1468,10,292,166,329,302,495,2424,4078,5,22973,1276,1,2,4,3,71970,28779,5768,38269,0
96,4695,1523,757,1297,19,12,193,1542,12,193,117,230,205,347,1508,2664,7,19053,1058,0,2,2,2,71980,28781,5768,38270,0
100,4333,1020,354,843,12,15,144,1032,8,134,77,144,142,221,970,1580,4,6792,377,0,2,1,1,71980,28781,5768,38271,0
42,1932,447,308,343,6,5,95,453,7,96,59,111,103,170,651,1136,4,4600,255,0,2,4,4,71980,28784,5768,38272,0
20,626,424,94,331,4,0,89,428,1,5,5,5,6,10,11,25,0,12,0,0,2,6,74,71980,28785,5768,38273,0
38,2315,334,251,279,10,4,40,344,5,127,74,143,132,217,899,1528,2,4303,239,0,2,1,5,71980,28786,5768,38274,0
65,2991,1293,570,1093,25,15,163,1318,10,195,123,241,205,364,1516,2795,6,17273,959,0,2,0,22,71990,28788,5768,38275,0
31,1885,384,251,317,7,8,52,391,11,70,44,84,81,128,467,811,6,5355,297,0,2,5,5,71990,28788,5768,38276,0
47,2254,722,423,573,19,0,135,741,12,172,101,199,184,300,1320,2257,6,15668,870,0,2,2,2,71990,28790,5768,38278,0
45,1961,386,256,301,16,9,68,402,4,59,35,69,63,104,355,621,2,1453,80,0,2,13,4,71990,28790,5768,38279,0
16,1247,215,129,180,6,0,29,221,8,65,43,72,73,115,415,711,4,3153,175,0,2,1,1,71990,28790,5768,38280,0
82,3278,1043,504,840,53,9,147,1096,9,180,112,198,189,310,1377,2344,4,11604,644,0,2,15,36,71990,28792,5768,38281,0
12,478,295,56,236,0,4,54,295,2,9,5,10,11,15,30,51,1,57,3,0,2,0,59,71990,28794,5768,38282,0
29,1210,373,158,315,8,0,51,381,5,76,44,79,81,123,486,779,2,2026,112,0,2,2,20,71990,28794,5768,38283,0
102,5247,1943,715,1694,26,18,214,1969,12,185,120,237,197,357,1436,2721,7,20915,1161,0,2,78,25,71990,28796,5768,38284,0
35,1441,442,244,305,14,16,103,456,11,68,45,75,79,120,452,756,6,4588,254,0,2,30,3,71990,28798,5768,38285,0
51,1917,1098,241,925,5,10,155,1103,7,46,25,49,53,74,273,423,3,1580,87,0,2,6,6,72000,28800,5768,38286,0
45,1575,601,196,481,2,23,85,603,8,63,36,72,71,108,400,664,4,3036,168,0,2,1,1,72000,28800,5768,38287,0
22,1058,75,38,59,1,3,12,76,2,4,2,4,6,6,10,15,1,15,0,0,2,2,2,72000,28800,5768,38289,0
253,5893,4293,999,3693,19,54,507,4312,9,155,88,170,164,258,1156,1898,4,9368,520,0,2,0,37,72000,28802,5768,38291,0
253,5893,1482,859,1002,125,135,219,1607,16,219,134,251,235,385,1766,3032,9,27804,1544,1,2,0,37,72010,28803,5768,38292,0
21,1025,75,38,59,1,3,12,76,2,4,2,4,6,6,10,15,1,15,0,0,2,0,21,72010,28803,5768,38293,0
168,7511,139,89,101,2,0,35,141,7,54,34,62,61,96,330,569,4,2287,127,0,2,2,186,72010,28803,5768,38294,0
168,7511,7,5,5,0,0,2,7,1,2,1,2,3,3,2,4,0,2,0,0,2,2,186,72010,28803,5768,38295,0
253,5889,4293,999,3693,19,54,507,4312,9,155,88,170,164,258,1156,1898,4,9368,520,0,2,1,2,72010,28805,5768,38297,0
253,5889,1482,859,1002,125,135,219,1607,16,219,134,251,235,385,1766,3032,9,27804,1544,1,2,1,2,72020,28806,5768,38298,0
292,6512,72,33,56,0,4,12,72,1,1,1,1,2,2,0,2,0,1,0,0,2,0,42,72020,28806,5768,38299,0
292,6512,1454,835,1044,76,110,219,1530,17,275,158,296,292,454,2297,3718,9,34017,1889,1,2,0,42,72030,28807,5768,38300,0
99,4109,1289,550,1043,56,32,155,1345,10,167,93,185,177,278,1266,2075,5,11498,638,0,2,2,3,72030,28809,5769,38301,0
20,985,75,38,59,1,3,12,76,2,4,2,4,6,6,10,15,1,15,0,0,2,0,17,72030,28809,5769,38302,0
125,5615,1782,648,1425,9,47,279,1791,8,171,97,189,179,286,1292,2140,4,9462,525,0,2,7,157,72030,28810,5770,38303,0
22,1058,75,38,59,1,3,12,76,2,4,2,4,6,6,10,15,1,15,0,0,2,2,2,72030,28810,5770,38305,0
253,5889,4293,999,3693,19,54,507,4312,9,155,88,170,164,258,1156,1898,4,9368,520,0,2,1,39,72030,28812,5770,38307,0
253,5889,1482,859,1002,125,135,219,1607,16,219,134,251,235,385,1766,3032,9,27804,1544,1,2,1,39,72040,28813,5770,38308,0
292,6512,72,33,56,0,4,12,72,1,1,1,1,2,2,0,2,0,1,0,0,2,0,42,72040,28813,5770,38309,0
292,6512,1454,835,1044,76,110,219,1530,17,275,158,296,292,454,2297,3718,9,34017,1889,1,2,0,42,72050,28814,5770,38310,0
99,4109,1289,550,1043,56,32,155,1345,10,167,93,185,177,278,1266,2075,5,11498,638,0,2,2,3,72050,28816,5771,38311,0
20,985,75,38,59,1,3,12,76,2,4,2,4,6,6,10,15,1,15,0,0,2,0,38,72050,28816,5771,38312,0
168,7511,139,89,101,2,0,35,141,7,54,34,62,61,96,330,569,4,2287,127,0,2,2,186,72050,28816,5771,38313,0
168,7511,7,5,5,0,0,2,7,1,2,1,2,3,3,2,4,0,2,0,0,2,2,186,72050,28816,5771,38314,0
125,5615,1782,648,1425,9,47,279,1791,8,171,97,189,179,286,1292,2140,4,9462,525,0,2,7,157,72050,28817,5772,38315,0
156,3283,1513,682,1277,25,13,200,1538,11,199,116,219,210,335,1557,2584,6,15641,868,0,2,4,1,72050,28819,5772,38316,0
156,3283,819,519,539,24,98,155,843,15,96,57,106,111,163,690,1107,8,9171,509,0,2,4,1,72060,28821,5772,38317,0
156,3283,1513,682,1277,25,13,200,1538,11,199,116,219,210,335,1557,2584,6,15641,868,0,2,4,1,72060,28823,5772,38318,0
156,3283,819,519,539,24,98,155,843,15,96,57,106,111,163,690,1107,8,9171,509,0,2,4,1,72070,28825,5772,38319,0
123,5258,1513,682,1277,25,13,200,1538,11,199,116,219,210,335,1557,2584,6,15641,868,0,2,11,11,72070,28827,5772,38320,0
124,5321,1513,682,1277,25,13,200,1538,11,199,116,219,210,335,1557,2584,6,15641,868,0,2,29,0,72070,28829,5772,38321,0
124,5323,1513,682,1277,25,13,200,1538,11,199,116,219,210,335,1557,2584,6,15641,868,0,2,7,2,72070,28831,5772,38322,0
154,3591,77,34,69,0,0,8,77,3,24,16,29,27,45,114,213,1,387,21,0,2,19,1,72070,28831,5772,38324,0
154,3591,712,438,573,51,9,84,763,14,102,71,128,116,199,733,1364,8,11988,666,0,2,19,1,72080,28832,5772,38325,0
102,5249,1943,715,1694,26,18,214,1969,12,185,120,237,197,357,1436,2721,7,20915,1161,0,2,2,2,72080,28834,5772,38326,0
124,5323,1513,682,1277,25,13,200,1538,11,199,116,219,210,335,1557,2584,6,15641,868,0,2,45,11,72080,28836,5772,38327,0
154,3591,77,34,69,0,0,8,77,3,24,16,29,27,45,114,213,1,387,21,0,2,19,1,72080,28836,5772,38329,0
154,3591,712,438,573,51,9,84,763,14,102,71,128,116,199,733,1364,8,11988,666,0,2,19,1,72090,28837,5772,38330,0
102,5249,1943,715,1694,26,18,214,1969,12,185,120,237,197,357,1436,2721,7,20915,1161,0,2,2,2,72090,28839,5772,38331,0
82,1853,996,429,845,24,10,117,1020,7,76,50,88,83,138,494,879,4,3565,198,0,2,11,0,72090,28841,5772,38332,0
82,1853,456,277,329,12,42,72,468,13,85,50,97,98,147,592,972,7,7212,400,0,2,11,0,72090,28841,5772,38333,0
47,3455,996,429,845,24,10,117,1020,7,76,50,88,83,138,494,879,4,3565,198,0,2,12,0,72090,28843,5772,38334,0
49,1683,601,196,481,2,23,85,603,8,63,36,72,71,108,400,664,4,3036,168,0,2,35,0,72090,28843,5772,38335,0
51,1739,601,196,481,2,23,85,603,8,63,36,72,71,108,400,664,4,3036,168,0,2,29,6,72090,28843,5772,38336,0
183,5668,1660,832,1314,41,38,274,1701,20,312,209,395,332,604,2671,5058,12,64042,3557,1,2,58,0,72090,28845,5773,38338,0
183,5668,1057,646,719,113,100,145,1170,18,215,134,248,233,382,1740,3004,10,31186,1732,1,2,58,0,72100,28846,5774,38339,0
51,1754,601,196,481,2,23,85,603,8,63,36,72,71,108,400,664,4,3036,168,0,2,11,12,72100,28846,5774,38340,1
183,5584,1660,832,1314,41,38,274,1701,20,312,209,395,332,604,2671,5058,12,64042,3557,1,2,17,23,72100,28848,5775,38342,1
183,5584,1057,646,719,113,100,145,1170,18,215,134,248,233,382,1740,3004,10,31186,1732,1,2,17,23,72110,28849,5776,38343,1
183,5584,1660,832,1314,41,38,274,1701,20,312,209,395,332,604,2671,5058,12,64042,3557,1,2,1,1,72110,28851,5777,38345,0
183,5584,1057,646,719,113,100,145,1170,18,215,134,248,233,382,1740,3004,10,31186,1732,1,2,1,1,72120,28852,5778,38346,0
51,1740,601,196,481,2,23,85,603,8,63,36,72,71,108,400,664,4,3036,168,0,2,4,4,72120,28852,5778,38347,0
183,5583,1660,832,1314,41,38,274,1701,20,312,209,395,332,604,2671,5058,12,64042,3557,1,2,2,3,72120,28854,5779,38349,0
183,5583,1057,646,719,113,100,145,1170,18,215,134,248,233,382,1740,3004,10,31186,1732,1,2,2,3,72130,28855,5780,38350,0
183,5583,1660,832,1314,41,38,274,1701,20,312,209,395,332,604,2671,5058,12,64042,3557,1,2,4,10,72130,28857,5781,38352,1
183,5583,1057,646,719,113,100,145,1170,18,215,134,248,233,382,1740,3004,10,31186,1732,1,2,4,10,72140,28858,5782,38353,1
184,5591,1660,832,1314,41,38,274,1701,20,312,209,395,332,604,2671,5058,12,64042,3557,1,2,6,5,72140,28860,5783,38355,0
184,5591,1057,646,719,113,100,145,1170,18,215,134,248,233,382,1740,3004,10,31186,1732,1,2,6,5,72150,28861,5784,38356,0
184,5591,1660,832,1314,41,38,274,1701,20,312,209,395,332,604,2671,5058,12,64042,3557,1,2,6,5,72150,28863,5785,38358,0
184,5591,1057,646,719,113,100,145,1170,18,215,134,248,233,382,1740,3004,10,31186,1732,1,2,6,5,72160,28864,5786,38359,0
51,1747,601,196,481,2,23,85,603,8,63,36,72,71,108,400,664,4,3036,168,0,2,8,5,72160,28864,5786,38360,0
184,5591,1660,832,1314,41,38,274,1701,20,312,209,395,332,604,2671,5058,12,64042,3557,1,2,47,0,72160,28866,5787,38362,0
184,5591,1057,646,719,113,100,145,1170,18,215,134,248,233,382,1740,3004,10,31186,1732,1,2,47,0,72170,28867,5788,38363,0
51,1747,601,196,481,2,23,85,603,8,63,36,72,71,108,400,664,4,3036,168,0,2,60,0,72170,28867,5788,38364,0
110,4163,1450,624,1228,12,26,181,1462,14,306,186,354,320,540,2580,4493,8,36391,2021,1,2,2,1,72170,28869,5789,38365,0
92,4758,1457,730,1242,11,6,188,1468,10,292,166,329,302,495,2424,4078,5,22973,1276,1,2,3,0,72170,28871,5789,38366,0
96,4707,1523,757,1297,19,12,193,1542,12,193,117,230,205,347,1508,2664,7,19053,1058,0,2,2,1,72180,28873,5789,38367,0
100,5271,1943,715,1694,26,18,214,1969,12,185,120,237,197,357,1436,2721,7,20915,1161,0,2,8,4,72180,28875,5789,38368,0
222,4823,2,2,2,0,0,0,2,0,0,0,0,0,0,0,0,0,0,0,0,2,11,2,72180,28875,5789,38368,0
222,4823,99,48,90,1,3,5,100,0,0,0,0,0,0,0,0,0,0,0,0,2,11,2,72180,28876,5789,38369,0
222,4823,8,5,5,2,0,1,10,0,0,0,0,0,0,0,0,0,0,0,0,2,11,2,72180,28876,5789,38370,0
222,4823,1217,716,841,84,126,174,1301,14,185,118,215,199,333,1446,2542,8,20687,1149,0,2,11,2,72190,28878,5789,38371,0
222,4823,160,89,115,0,13,31,160,7,15,11,17,22,28,78,124,3,495,27,0,2,11,2,72190,28878,5789,38372,0
222,4823,10,10,9,9,0,0,19,0,0,0,0,0,0,0,0,0,0,0,0,2,11,2,72190,28878,5790,38373,0
222,4823,173,84,99,8,29,36,181,5,12,7,13,17,20,54,81,2,221,12,0,2,11,2,72190,28879,5790,38374,0
222,4823,3,1,1,3,0,0,6,0,0,0,0,0,0,0,0,0,0,0,0,2,11,2,72190,28879,5790,38375,0
94,4851,1457,730,1242,11,6,188,1468,10,292,166,329,302,495,2424,4078,5,22973,1276,1,2,27,0,72190,28881,5790,38376,0
222,4823,2,2,2,0,0,0,2,0,0,0,0,0,0,0,0,0,0,0,0,2,11,2,72190,28881,5790,38376,0
222,4823,99,48,90,1,3,5,100,0,0,0,0,0,0,0,0,0,0,0,0,2,11,2,72190,28882,5790,38377,0
222,4823,8,5,5,2,0,1,10,0,0,0,0,0,0,0,0,0,0,0,0,2,11,2,72190,28882,5790,38378,0
222,4823,1217,716,841,84,126,174,1301,14,185,118,215,199,333,1446,2542,8,20687,1149,0,2,11,2,72200,28884,5790,38379,0
222,4823,160,89,115,0,13,31,160,7,15,11,17,22,28,78,124,3,495,27,0,2,11,2,72200,28884,5790,38380,0
222,4823,10,10,9,9,0,0,19,0,0,0,0,0,0,0,0,0,0,0,0,2,11,2,72200,28884,5791,38381,0
222,4823,173,84,99,8,29,36,181,5,12,7,13,17,20,54,81,2,221,12,0,2,11,2,72200,28885,5791,38382,0
222,4823,3,1,1,3,0,0,6,0,0,0,0,0,0,0,0,0,0,0,0,2,11,2,72200,28885,5791,38383,0
94,4851,1457,730,1242,11,6,188,1468,10,292,166,329,302,495,2424,4078,5,22973,1276,1,2,27,0,72200,28887,5791,38384,0
156,3271,1513,682,1277,25,13,200,1538,11,199,116,219,210,335,1557,2584,6,15641,868,0,2,4,1,72200,28889,5791,38385,0
156,3271,819,519,539,24,98,155,843,15,96,57,106,111,163,690,1107,8,9171,509,0,2,4,1,72210,28891,5791,38386,0
221,4796,2,2,2,0,0,0,2,0,0,0,0,0,0,0,0,0,0,0,0,2,11,2,72210,28891,5791,38386,0
221,4796,99,48,90,1,3,5,100,0,0,0,0,0,0,0,0,0,0,0,0,2,11,2,72210,28892,5791,38387,0
221,4796,8,5,5,2,0,1,10,0,0,0,0,0,0,0,0,0,0,0,0,2,11,2,72210,28892,5791,38388,0
221,4796,1217,716,841,84,126,174,1301,14,185,118,215,199,333,1446,2542,8,20687,1149,0,2,11,2,72220,28894,5791,38389,0
221,4796,160,89,115,0,13,31,160,7,15,11,17,22,28,78,124,3,495,27,0,2,11,2,72220,28894,5791,38390,0
221,4796,10,10,9,9,0,0,19,0,0,0,0,0,0,0,0,0,0,0,0,2,11,2,72220,28894,5792,38391,0
221,4796,173,84,99,8,29,36,181,5,12,7,13,17,20,54,81,2,221,12,0,2,11,2,72220,28895,5792,38392,0
221,4796,3,1,1,3,0,0,6,0,0,0,0,0,0,0,0,0,0,0,0,2,11,2,72220,28895,5792,38393,0
124,5331,1513,682,1277,25,13,200,1538,11,199,116,219,210,335,1557,2584,6,15641,868,0,2,45,11,72220,28897,5792,38394,0
94,4864,1457,730,1242,11,6,188,1468,10,292,166,329,302,495,2424,4078,5,22973,1276,1,2,27,0,72220,28899,5792,38395,0
30,880,256,139,192,9,7,47,265,4,23,12,24,27,36,112,171,2,357,19,0,2,2,1,72220,28900,5792,38396,0
30,940,256,139,192,9,7,47,265,4,23,12,24,27,36,112,171,2,357,19,0,2,2,1,72220,28901,5792,38397,0
156,3271,1513,682,1277,25,13,200,1538,11,199,116,219,210,335,1557,2584,6,15641,868,0,2,4,1,72220,28903,5792,38398,0
156,3271,819,519,539,24,98,155,843,15,96,57,106,111,163,690,1107,8,9171,509,0,2,4,1,72230,28905,5792,38399,0
221,4796,2,2,2,0,0,0,2,0,0,0,0,0,0,0,0,0,0,0,0,2,11,2,72230,28905,5792,38399,0
221,4796,99,48,90,1,3,5,100,0,0,0,0,0,0,0,0,0,0,0,0,2,11,2,72230,28906,5792,38400,0
221,4796,8,5,5,2,0,1,10,0,0,0,0,0,0,0,0,0,0,0,0,2,11,2,72230,28906,5792,38401,0
221,4796,1217,716,841,84,126,174,1301,14,185,118,215,199,333,1446,2542,8,20687,1149,0,2,11,2,72240,28908,5792,38402,0
221,4796,160,89,115,0,13,31,160,7,15,11,17,22,28,78,124,3,495,27,0,2,11,2,72240,28908,5792,38403,0
221,4796,10,10,9,9,0,0,19,0,0,0,0,0,0,0,0,0,0,0,0,2,11,2,72240,28908,5793,38404,0
221,4796,173,84,99,8,29,36,181,5,12,7,13,17,20,54,81,2,221,12,0,2,11,2,72240,28909,5793,38405,0
221,4796,3,1,1,3,0,0,6,0,0,0,0,0,0,0,0,0,0,0,0,2,11,2,72240,28909,5793,38406,0
30,940,256,139,192,9,7,47,265,4,23,12,24,27,36,112,171,2,357,19,0,2,2,1,72240,28910,5793,38407,0
124,5331,1513,682,1277,25,13,200,1538,11,199,116,219,210,335,1557,2584,6,15641,868,0,2,45,11,72240,28912,5793,38408,0
94,4864,1457,730,1242,11,6,188,1468,10,292,166,329,302,495,2424,4078,5,22973,1276,1,2,27,0,72240,28914,5793,38409,0
30,880,256,139,192,9,7,47,265,4,23,12,24,27,36,112,171,2,357,19,0,2,2,1,72240,28915,5793,38410,0
154,3597,77,34,69,0,0,8,77,3,24,16,29,27,45,114,213,1,387,21,0,2,1,1,72240,28915,5793,38411,1
154,3597,712,438,573,51,9,84,763,14,102,71,128,116,199,733,1364,8,11988,666,0,2,1,1,72250,28916,5793,38412,1
20,526,205,80,86,16,53,53,221,7,18,10,19,25,29,94,134,3,497,27,0,2,3,3,72260,28916,5794,38413,1
95,2085,1043,504,840,53,9,147,1096,9,180,112,198,189,310,1377,2344,4,11604,644,0,2,5,3,72260,28918,5794,38414,1
95,2085,383,288,292,26,6,62,409,11,65,38,67,76,105,429,656,5,3719,206,0,2,5,3,72260,28919,5794,38415,1
82,3282,1043,504,840,53,9,147,1096,9,180,112,198,189,310,1377,2344,4,11604,644,0,2,1,1,72260,28921,5794,38416,1
223,4836,2,2,2,0,0,0,2,0,0,0,0,0,0,0,0,0,0,0,0,2,15,4,72260,28921,5794,38416,1
223,4836,99,48,90,1,3,5,100,0,0,0,0,0,0,0,0,0,0,0,0,2,15,4,72260,28922,5794,38417,1
223,4836,8,5,5,2,0,1,10,0,0,0,0,0,0,0,0,0,0,0,0,2,15,4,72260,28922,5794,38418,1
223,4836,1217,716,841,84,126,174,1301,14,185,118,215,199,333,1446,2542,8,20687,1149,0,2,15,4,72270,28924,5794,38419,1
223,4836,160,89,115,0,13,31,160,7,15,11,17,22,28,78,124,3,495,27,0,2,15,4,72270,28924,5794,38420,1
223,4836,10,10,9,9,0,0,19,0,0,0,0,0,0,0,0,0,0,0,0,2,15,4,72270,28924,5795,38421,1
223,4836,173,84,99,8,29,36,181,5,12,7,13,17,20,54,81,2,221,12,0,2,15,4,72270,28925,5795,38422,1
223,4836,3,1,1,3,0,0,6,0,0,0,0,0,0,0,0,0,0,0,0,2,15,4,72270,28925,5795,38423,1
31,1922,384,251,317,7,8,52,391,11,70,44,84,81,128,467,811,6,5355,297,0,2,6,0,72270,28925,5795,38424,1
82,1853,996,429,845,24,10,117,1020,7,76,50,88,83,138,494,879,4,3565,198,0,2,11,0,72270,28927,5795,38425,0
82,1853,456,277,329,12,42,72,468,13,85,50,97,98,147,592,972,7,7212,400,0,2,11,0,72270,28927,5795,38426,0
47,3455,996,429,845,24,10,117,1020,7,76,50,88,83,138,494,879,4,3565,198,0,2,12,0,72270,28929,5795,38427,0
41,1220,339,213,244,17,9,65,356,10,42,26,48,52,74,259,421,5,2410,133,0,2,18,10,72280,28929,5795,38428,0
66,3082,1293,570,1093,25,15,163,1318,10,195,123,241,205,364,1516,2795,6,17273,959,0,2,30,1,72290,28931,5795,38429,0
97,2016,463,295,324,28,62,57,491,12,134,82,154,146,236,989,1696,6,11700,650,0,2,5,2,72300,28932,5795,38430,0
39,2361,334,251,279,10,4,40,344,5,127,74,143,132,217,899,1528,2,4303,239,0,2,6,0,72300,28933,5795,38431,0
223,4836,2,2,2,0,0,0,2,0,0,0,0,0,0,0,0,0,0,0,0,2,15,4,72300,28933,5795,38431,0
223,4836,99,48,90,1,3,5,100,0,0,0,0,0,0,0,0,0,0,0,0,2,15,4,72300,28934,5795,38432,0
223,4836,8,5,5,2,0,1,10,0,0,0,0,0,0,0,0,0,0,0,0,2,15,4,72300,28934,5795,38433,0
223,4836,1217,716,841,84,126,174,1301,14,185,118,215,199,333,1446,2542,8,20687,1149,0,2,15,4,72310,28936,5795,38434,0
223,4836,160,89,115,0,13,31,160,7,15,11,17,22,28,78,124,3,495,27,0,2,15,4,72310,28936,5795,38435,0
223,4836,10,10,9,9,0,0,19,0,0,0,0,0,0,0,0,0,0,0,0,2,15,4,72310,28936,5796,38436,0
223,4836,173,84,99,8,29,36,181,5,12,7,13,17,20,54,81,2,221,12,0,2,15,4,72310,28937,5796,38437,0
223,4836,3,1,1,3,0,0,6,0,0,0,0,0,0,0,0,0,0,0,0,2,15,4,72310,28937,5796,38438,0
31,1922,384,251,317,7,8,52,391,11,70,44,84,81,128,467,811,6,5355,297,0,2,6,0,72310,28937,5796,38439,0
97,2016,463,295,324,28,62,57,491,12,134,82,154,146,236,989,1696,6,11700,650,0,2,5,2,72320,28938,5796,38440,0
39,2361,334,251,279,10,4,40,344,5,127,74,143,132,217,899,1528,2,4303,239,0,2,6,0,72320,28939,5796,38441,0
101,2731,1523,757,1297,19,12,193,1542,12,193,117,230,205,347,1508,2664,7,19053,1058,0,2,17,3,72330,28941,5796,38442,0
101,2731,701,378,504,33,58,109,734,13,110,68,126,123,194,794,1346,7,10027,557,0,2,17,3,72330,28942,5797,38443,0
97,4762,1523,757,1297,19,12,193,1542,12,193,117,230,205,347,1508,2664,7,19053,1058,0,2,19,0,72340,28944,5797,38444,0
101,2732,1523,757,1297,19,12,193,1542,12,193,117,230,205,347,1508,2664,7,19053,1058,0,2,8,4,72350,28946,5797,38445,0
101,2732,701,378,504,33,58,109,734,13,110,68,126,123,194,794,1346,7,10027,557,0,2,8,4,72350,28947,5798,38446,0
231,4976,1943,715,1694,26,18,214,1969,12,185,120,237,197,357,1436,2721,7,20915,1161,0,2,1,1,72350,28949,5798,38447,0
231,4976,1168,838,957,57,25,144,1225,19,348,224,416,367,640,3018,5452,11,61921,3440,1,2,1,1,72360,28951,5798,38448,0
77,3228,1178,367,1042,6,15,115,1184,9,94,51,95,103,146,644,976,4,4439,246,0,2,12,1,72360,28951,5798,38449,0
97,4762,1523,757,1297,19,12,193,1542,12,193,117,230,205,347,1508,2664,7,19053,1058,0,2,1,1,72370,28953,5798,38450,0
100,2714,1523,757,1297,19,12,193,1542,12,193,117,230,205,347,1508,2664,7,19053,1058,0,2,11,16,72380,28955,5798,38451,0
100,2714,701,378,504,33,58,109,734,13,110,68,126,123,194,794,1346,7,10027,557,0,2,11,16,72380,28956,5799,38452,0
97,4761,1523,757,1297,19,12,193,1542,12,193,117,230,205,347,1508,2664,7,19053,1058,0,2,1,2,72390,28958,5799,38453,0
97,4761,1523,757,1297,19,12,193,1542,12,193,117,230,205,347,1508,2664,7,19053,1058,0,2,4,4,72400,28960,5799,38454,0
291,6482,72,33,56,0,4,12,72,1,1,1,1,2,2,0,2,0,1,0,0,2,0,4,72400,28960,5799,38456,0
291,6482,1454,835,1044,76,110,219,1530,17,275,158,296,292,454,2297,3718,9,34017,1889,1,2,0,4,72410,28961,5799,38457,0
17,910,75,38,59,1,3,12,76,2,4,2,4,6,6,10,15,1,15,0,0,2,0,20,72410,28961,5799,38458,0
91,4033,1338,495,1086,10,64,173,1348,11,122,82,157,133,239,883,1686,7,11934,663,0,2,1,1,72410,28963,5799,38459,0
110,4163,1450,624,1228,12,26,181,1462,14,306,186,354,320,540,2580,4493,8,36391,2021,1,2,2,1,72410,28965,5800,38460,0
94,4881,1457,730,1242,11,6,188,1468,10,292,166,329,302,495,2424,4078,5,22973,1276,1,2,3,0,72410,28967,5800,38461,0
96,4707,1523,757,1297,19,12,193,1542,12,193,117,230,205,347,1508,2664,7,19053,1058,0,2,2,1,72420,28969,5800,38462,0
100,5271,1943,715,1694,26,18,214,1969,12,185,120,237,197,357,1436,2721,7,20915,1161,0,2,8,4,72420,28971,5800,38463,0
54,1145,447,308,343,6,5,95,453,7,96,59,111,103,170,651,1136,4,4600,255,0,2,7,1,72420,28974,5800,38464,0
54,1145,322,174,179,16,74,51,338,10,41,26,46,51,72,252,408,5,2291,127,0,2,7,1,72420,28977,5801,38465,0
45,2011,447,308,343,6,5,95,453,7,96,59,111,103,170,651,1136,4,4600,255,0,2,27,0,72420,28980,5801,38466,0
291,6482,72,33,56,0,4,12,72,1,1,1,1,2,2,0,2,0,1,0,0,2,0,4,72420,28980,5801,38468,0
291,6482,1454,835,1044,76,110,219,1530,17,275,158,296,292,454,2297,3718,9,34017,1889,1,2,0,4,72430,28981,5801,38469,0
17,910,75,38,59,1,3,12,76,2,4,2,4,6,6,10,15,1,15,0,0,2,0,20,72430,28981,5801,38470,0
91,4033,1338,495,1086,10,64,173,1348,11,122,82,157,133,239,883,1686,7,11934,663,0,2,1,1,72430,28983,5801,38471,0
54,1145,447,308,343,6,5,95,453,7,96,59,111,103,170,651,1136,4,4600,255,0,2,1,1,72430,28986,5801,38472,0
54,1145,322,174,179,16,74,51,338,10,41,26,46,51,72,252,408,5,2291,127,0,2,1,1,72430,28989,5802,38473,0
91,1842,757,253,292,73,244,162,830,13,61,38,67,74,105,409,651,7,4654,258,0,2,1,1,72430,28990,5802,38474,0
31,911,256,139,192,9,7,47,265,4,23,12,24,27,36,112,171,2,357,19,0,2,5,0,72430,28991,5802,38475,0
91,1876,757,253,292,73,244,162,830,13,61,38,67,74,105,409,651,7,4654,258,0,2,39,34,72430,28992,5802,38477,0
18,939,75,38,59,1,3,12,76,2,4,2,4,6,6,10,15,1,15,0,0,2,6,0,72430,28992,5802,38478,0
30,948,256,139,192,9,7,47,265,4,23,12,24,27,36,112,171,2,357,19,0,2,3,2,72430,28993,5802,38479,0
47,2254,722,423,573,19,0,135,741,12,172,101,199,184,300,1320,2257,6,15668,870,0,2,1,1,72430,28995,5802,38481,0
91,1876,757,253,292,73,244,162,830,13,61,38,67,74,105,409,651,7,4654,258,0,2,39,34,72430,28996,5802,38483,0
18,939,75,38,59,1,3,12,76,2,4,2,4,6,6,10,15,1,15,0,0,2,6,0,72430,28996,5802,38484,0
30,948,256,139,192,9,7,47,265,4,23,12,24,27,36,112,171,2,357,19,0,2,3,2,72430,28997,5802,38485,0
47,2254,722,423,573,19,0,135,741,12,172,101,199,184,300,1320,2257,6,15668,870,0,2,1,1,72430,28999,5802,38487,0
91,1842,757,253,292,73,244,162,830,13,61,38,67,74,105,409,651,7,4654,258,0,2,1,1,72430,29000,5802,38488,0
31,911,256,139,192,9,7,47,265,4,23,12,24,27,36,112,171,2,357,19,0,2,5,0,72430,29001,5802,38489,0
231,4976,1943,715,1694,26,18,214,1969,12,185,120,237,197,357,1436,2721,7,20915,1161,0,2,1,1,72430,29003,5802,38490,0
231,4976,1168,838,957,57,25,144,1225,19,348,224,416,367,640,3018,5452,11,61921,3440,1,2,1,1,72440,29005,5802,38491,0
77,3228,1178,367,1042,6,15,115,1184,9,94,51,95,103,146,644,976,4,4439,246,0,2,12,1,72440,29005,5802,38492,0
154,3597,77,34,69,0,0,8,77,3,24,16,29,27,45,114,213,1,387,21,0,2,1,1,72440,29005,5802,38493,0
154,3597,712,438,573,51,9,84,763,14,102,71,128,116,199,733,1364,8,11988,666,0,2,1,1,72450,29006,5802,38494,0
20,526,205,80,86,16,53,53,221,7,18,10,19,25,29,94,134,3,497,27,0,2,3,3,72460,29006,5803,38495,0
95,2085,1043,504,840,53,9,147,1096,9,180,112,198,189,310,1377,2344,4,11604,644,0,2,5,3,72460,29008,5803,38496,0
95,2085,383,288,292,26,6,62,409,11,65,38,67,76,105,429,656,5,3719,206,0,2,5,3,72460,29009,5803,38497,0
82,3282,1043,504,840,53,9,147,1096,9,180,112,198,189,310,1377,2344,4,11604,644,0,2,1,1,72460,29011,5803,38498,0
100,2714,1523,757,1297,19,12,193,1542,12,193,117,230,205,347,1508,2664,7,19053,1058,0,2,16,3,72470,29013,5803,38499,0
100,2714,701,378,504,33,58,109,734,13,110,68,126,123,194,794,1346,7,10027,557,0,2,16,3,72470,29014,5804,38500,0
97,4761,1523,757,1297,19,12,193,1542,12,193,117,230,205,347,1508,2664,7,19053,1058,0,2,18,0,72480,29016,5804,38501,0
222,4829,2,2,2,0,0,0,2,0,0,0,0,0,0,0,0,0,0,0,0,2,2,2,72480,29016,5804,38501,0
222,4829,99,48,90,1,3,5,100,0,0,0,0,0,0,0,0,0,0,0,0,2,2,2,72480,29017,5804,38502,0
222,4829,8,5,5,2,0,1,10,0,0,0,0,0,0,0,0,0,0,0,0,2,2,2,72480,29017,5804,38503,0
222,4829,1217,716,841,84,126,174,1301,14,185,118,215,199,333,1446,2542,8,20687,1149,0,2,2,2,72490,29019,5804,38504,0
222,4829,160,89,115,0,13,31,160,7,15,11,17,22,28,78,124,3,495,27,0,2,2,2,72490,29019,5804,38505,0
222,4829,10,10,9,9,0,0,19,0,0,0,0,0,0,0,0,0,0,0,0,2,2,2,72490,29019,5805,38506,0
222,4829,173,84,99,8,29,36,181,5,12,7,13,17,20,54,81,2,221,12,0,2,2,2,72490,29020,5805,38507,0
222,4829,3,1,1,3,0,0,6,0,0,0,0,0,0,0,0,0,0,0,0,2,2,2,72490,29020,5805,38508,0
250,5779,4293,999,3693,19,54,507,4312,9,155,88,170,164,258,1156,1898,4,9368,520,0,2,4,27,72490,29022,5805,38510,0
250,5779,1482,859,1002,125,135,219,1607,16,219,134,251,235,385,1766,3032,9,27804,1544,1,2,4,27,72500,29023,5805,38511,0
17,901,75,38,59,1,3,12,76,2,4,2,4,6,6,10,15,1,15,0,0,2,0,22,72500,29023,5805,38512,0
167,7471,139,89,101,2,0,35,141,7,54,34,62,61,96,330,569,4,2287,127,0,2,0,19,72500,29023,5805,38513,0
167,7471,7,5,5,0,0,2,7,1,2,1,2,3,3,2,4,0,2,0,0,2,0,19,72500,29023,5805,38514,0
222,4829,2,2,2,0,0,0,2,0,0,0,0,0,0,0,0,0,0,0,0,2,2,2,72500,29023,5805,38514,0
222,4829,99,48,90,1,3,5,100,0,0,0,0,0,0,0,0,0,0,0,0,2,2,2,72500,29024,5805,38515,0
222,4829,8,5,5,2,0,1,10,0,0,0,0,0,0,0,0,0,0,0,0,2,2,2,72500,29024,5805,38516,0
222,4829,1217,716,841,84,126,174,1301,14,185,118,215,199,333,1446,2542,8,20687,1149,0,2,2,2,72510,29026,5805,38517,0
222,4829,160,89,115,0,13,31,160,7,15,11,17,22,28,78,124,3,495,27,0,2,2,2,72510,29026,5805,38518,0
222,4829,10,10,9,9,0,0,19,0,0,0,0,0,0,0,0,0,0,0,0,2,2,2,72510,29026,5806,38519,0
222,4829,173,84,99,8,29,36,181,5,12,7,13,17,20,54,81,2,221,12,0,2,2,2,72510,29027,5806,38520,0
222,4829,3,1,1,3,0,0,6,0,0,0,0,0,0,0,0,0,0,0,0,2,2,2,72510,29027,5806,38521,0
250,5779,4293,999,3693,19,54,507,4312,9,155,88,170,164,258,1156,1898,4,9368,520,0,2,4,27,72510,29029,5806,38523,0
250,5779,1482,859,1002,125,135,219,1607,16,219,134,251,235,385,1766,3032,9,27804,1544,1,2,4,27,72520,29030,5806,38524,0
17,901,75,38,59,1,3,12,76,2,4,2,4,6,6,10,15,1,15,0,0,2,0,22,72520,29030,5806,38525,0
167,7471,139,89,101,2,0,35,141,7,54,34,62,61,96,330,569,4,2287,127,0,2,0,19,72520,29030,5806,38526,0
167,7471,7,5,5,0,0,2,7,1,2,1,2,3,3,2,4,0,2,0,0,2,0,19,72520,29030,5806,38527,0
184,5593,1660,832,1314,41,38,274,1701,20,312,209,395,332,604,2671,5058,12,64042,3557,1,2,3,3,72520,29032,5807,38529,1
184,5593,1057,646,719,113,100,145,1170,18,215,134,248,233,382,1740,3004,10,31186,1732,1,2,3,3,72530,29033,5808,38530,1
82,1855,996,429,845,24,10,117,1020,7,76,50,88,83,138,494,879,4,3565,198,0,2,3,3,72530,29035,5808,38531,1
82,1855,456,277,329,12,42,72,468,13,85,50,97,98,147,592,972,7,7212,400,0,2,3,3,72530,29035,5808,38532,1
217,4669,2,2,2,0,0,0,2,0,0,0,0,0,0,0,0,0,0,0,0,2,27,55,72530,29035,5808,38532,1
217,4669,99,48,90,1,3,5,100,0,0,0,0,0,0,0,0,0,0,0,0,2,27,55,72530,29036,5808,38533,1
217,4669,8,5,5,2,0,1,10,0,0,0,0,0,0,0,0,0,0,0,0,2,27,55,72530,29036,5808,38534,1
217,4669,1217,716,841,84,126,174,1301,14,185,118,215,199,333,1446,2542,8,20687,1149,0,2,27,55,72540,29038,5808,38535,1
217,4669,160,89,115,0,13,31,160,7,15,11,17,22,28,78,124,3,495,27,0,2,27,55,72540,29038,5808,38536,1
217,4669,10,10,9,9,0,0,19,0,0,0,0,0,0,0,0,0,0,0,0,2,27,55,72540,29038,5809,38537,1
217,4669,173,84,99,8,29,36,181,5,12,7,13,17,20,54,81,2,221,12,0,2,27,55,72540,29039,5809,38538,1
217,4669,3,1,1,3,0,0,6,0,0,0,0,0,0,0,0,0,0,0,0,2,27,55,72540,29039,5809,38539,1
55,796,167,116,138,4,5,22,171,8,48,30,56,56,86,292,499,4,2330,129,0,2,6,6,72540,29039,5809,38540,1
52,621,647,139,84,35,284,233,682,0,0,0,0,0,0,0,0,0,0,0,0,2,3,1,72540,29039,5809,38542,1
76,1637,53,23,39,0,0,13,53,2,8,4,8,10,12,26,39,1,39,2,0,2,5,66,72540,29039,5809,38543,1
76,1637,515,298,307,33,80,99,548,12,63,44,77,75,121,419,753,7,5527,307,0,2,5,66,72550,29039,5809,38544,1
30,664,215,129,180,6,0,29,221,8,65,43,72,73,115,415,711,4,3153,175,0,2,2,2,72550,29039,5809,38545,1
30,664,97,69,77,3,3,16,100,6,22,13,23,28,36,113,173,3,542,30,0,2,2,2,72550,29040,5809,38546,1
230,4915,1943,715,1694,26,18,214,1969,12,185,120,237,197,357,1436,2721,7,20915,1161,0,2,1,11,72550,29042,5809,38547,1
230,4915,1168,838,957,57,25,144,1225,19,348,224,416,367,640,3018,5452,11,61921,3440,1,2,1,11,72560,29044,5809,38548,1
29,743,601,196,481,2,23,85,603,8,63,36,72,71,108,400,664,4,3036,168,0,2,3,3,72560,29044,5809,38549,1
29,743,156,79,106,5,16,28,161,5,14,8,15,19,23,64,97,2,261,14,0,2,3,3,72560,29044,5809,38550,1
99,4118,1289,550,1043,56,32,155,1345,10,167,93,185,177,278,1266,2075,5,11498,638,0,2,1,0,72560,29046,5810,38551,1
18,948,75,38,59,1,3,12,76,2,4,2,4,6,6,10,15,1,15,0,0,2,1,0,72560,29046,5810,38552,1
167,5017,1660,832,1314,41,38,274,1701,20,312,209,395,332,604,2671,5058,12,64042,3557,1,2,3,1,72560,29048,5811,38554,1
90,4699,1457,730,1242,11,6,188,1468,10,292,166,329,302,495,2424,4078,5,22973,1276,1,2,0,61,72560,29050,5811,38555,1
28,1839,384,251,317,7,8,52,391,11,70,44,84,81,128,467,811,6,5355,297,0,2,4,20,72560,29050,5811,38556,1
47,2254,722,423,573,19,0,135,741,12,172,101,199,184,300,1320,2257,6,15668,870,0,2,1,1,72560,29052,5811,38558,1
51,1747,601,196,481,2,23,85,603,8,63,36,72,71,108,400,664,4,3036,168,0,2,2,2,72560,29052,5811,38559,1
100,2715,1523,757,1297,19,12,193,1542,12,193,117,230,205,347,1508,2664,7,19053,1058,0,2,4,2,72570,29054,5811,38560,0
100,2715,701,378,504,33,58,109,734,13,110,68,126,123,194,794,1346,7,10027,557,0,2,4,2,72570,29055,5812,38561,0
97,4761,1523,757,1297,19,12,193,1542,12,193,117,230,205,347,1508,2664,7,19053,1058,0,2,2,2,72580,29057,5812,38562,0
91,1879,757,253,292,73,244,162,830,13,61,38,67,74,105,409,651,7,4654,258,0,2,1,1,72580,29058,5812,38563,0
31,979,256,139,192,9,7,47,265,4,23,12,24,27,36,112,171,2,357,19,0,2,5,0,72580,29059,5812,38564,0
120,4791,1450,624,1228,12,26,181,1462,14,306,186,354,320,540,2580,4493,8,36391,2021,1,2,2,1,72580,29061,5813,38565,0
94,4894,1457,730,1242,11,6,188,1468,10,292,166,329,302,495,2424,4078,5,22973,1276,1,2,3,0,72580,29063,5813,38566,0
97,4773,1523,757,1297,19,12,193,1542,12,193,117,230,205,347,1508,2664,7,19053,1058,0,2,2,1,72590,29065,5813,38567,0
102,5297,1943,715,1694,26,18,214,1969,12,185,120,237,197,357,1436,2721,7,20915,1161,0,2,8,4,72590,29067,5813,38568,0
99,2685,1523,757,1297,19,12,193,1542,12,193,117,230,205,347,1508,2664,7,19053,1058,0,2,0,10,72600,29069,5813,38570,0
99,2685,701,378,504,33,58,109,734,13,110,68,126,123,194,794,1346,7,10027,557,0,2,0,10,72600,29070,5814,38571,0
221,4803,2,2,2,0,0,0,2,0,0,0,0,0,0,0,0,0,0,0,0,2,2,5,72600,29070,5814,38571,1
221,4803,99,48,90,1,3,5,100,0,0,0,0,0,0,0,0,0,0,0,0,2,2,5,72600,29071,5814,38572,1
221,4803,8,5,5,2,0,1,10,0,0,0,0,0,0,0,0,0,0,0,0,2,2,5,72600,29071,5814,38573,1
221,4803,1217,716,841,84,126,174,1301,14,185,118,215,199,333,1446,2542,8,20687,1149,0,2,2,5,72610,29073,5814,38574,1
221,4803,160,89,115,0,13,31,160,7,15,11,17,22,28,78,124,3,495,27,0,2,2,5,72610,29073,5814,38575,1
221,4803,10,10,9,9,0,0,19,0,0,0,0,0,0,0,0,0,0,0,0,2,2,5,72610,29073,5815,38576,1
221,4803,173,84,99,8,29,36,181,5,12,7,13,17,20,54,81,2,221,12,0,2,2,5,72610,29074,5815,38577,1
221,4803,3,1,1,3,0,0,6,0,0,0,0,0,0,0,0,0,0,0,0,2,2,5,72610,29074,5815,38578,1
99,4088,1289,550,1043,56,32,155,1345,10,167,93,185,177,278,1266,2075,5,11498,638,0,2,5,6,72610,29076,5816,38580,1
15,827,75,38,59,1,3,12,76,2,4,2,4,6,6,10,15,1,15,0,0,2,0,19,72610,29076,5816,38581,1
291,6479,72,33,56,0,4,12,72,1,1,1,1,2,2,0,2,0,1,0,0,2,4,7,72610,29076,5816,38582,0
291,6479,1454,835,1044,76,110,219,1530,17,275,158,296,292,454,2297,3718,9,34017,1889,1,2,4,7,72620,29077,5816,38583,0
125,5597,1782,648,1425,9,47,279,1791,8,171,97,189,179,286,1292,2140,4,9462,525,0,2,3,7,72620,29078,5817,38584,0
91,1879,757,253,292,73,244,162,830,13,61,38,67,74,105,409,651,7,4654,258,0,2,1,1,72620,29079,5817,38585,0
31,979,256,139,192,9,7,47,265,4,23,12,24,27,36,112,171,2,357,19,0,2,5,0,72620,29080,5817,38586,0
120,4791,1450,624,1228,12,26,181,1462,14,306,186,354,320,540,2580,4493,8,36391,2021,1,2,2,1,72620,29082,5818,38587,0
94,4894,1457,730,1242,11,6,188,1468,10,292,166,329,302,495,2424,4078,5,22973,1276,1,2,3,0,72620,29084,5818,38588,0
97,4773,1523,757,1297,19,12,193,1542,12,193,117,230,205,347,1508,2664,7,19053,1058,0,2,2,1,72630,29086,5818,38589,0
102,5297,1943,715,1694,26,18,214,1969,12,185,120,237,197,357,1436,2721,7,20915,1161,0,2,8,4,72630,29088,5818,38590,0
100,2715,1523,757,1297,19,12,193,1542,12,193,117,230,205,347,1508,2664,7,19053,1058,0,2,4,2,72640,29090,5818,38591,0
100,2715,701,378,504,33,58,109,734,13,110,68,126,123,194,794,1346,7,10027,557,0,2,4,2,72640,29091,5819,38592,0
97,4773,1523,757,1297,19,12,193,1542,12,193,117,230,205,347,1508,2664,7,19053,1058,0,2,2,2,72650,29093,5819,38593,0
221,4803,2,2,2,0,0,0,2,0,0,0,0,0,0,0,0,0,0,0,0,2,2,5,72650,29093,5819,38593,0
221,4803,99,48,90,1,3,5,100,0,0,0,0,0,0,0,0,0,0,0,0,2,2,5,72650,29094,5819,38594,0
221,4803,8,5,5,2,0,1,10,0,0,0,0,0,0,0,0,0,0,0,0,2,2,5,72650,29094,5819,38595,0
221,4803,1217,716,841,84,126,174,1301,14,185,118,215,199,333,1446,2542,8,20687,1149,0,2,2,5,72660,29096,5819,38596,0
221,4803,160,89,115,0,13,31,160,7,15,11,17,22,28,78,124,3,495,27,0,2,2,5,72660,29096,5819,38597,0
221,4803,10,10,9,9,0,0,19,0,0,0,0,0,0,0,0,0,0,0,0,2,2,5,72660,29096,5820,38598,0
221,4803,173,84,99,8,29,36,181,5,12,7,13,17,20,54,81,2,221,12,0,2,2,5,72660,29097,5820,38599,0
221,4803,3,1,1,3,0,0,6,0,0,0,0,0,0,0,0,0,0,0,0,2,2,5,72660,29097,5820,38600,0
99,2686,1523,757,1297,19,12,193,1542,12,193,117,230,205,347,1508,2664,7,19053,1058,0,2,0,10,72670,29099,5820,38602,0
99,2686,701,378,504,33,58,109,734,13,110,68,126,123,194,794,1346,7,10027,557,0,2,0,10,72670,29100,5821,38603,0
99,4088,1289,550,1043,56,32,155,1345,10,167,93,185,177,278,1266,2075,5,11498,638,0,2,5,6,72670,29102,5822,38604,0
15,827,75,38,59,1,3,12,76,2,4,2,4,6,6,10,15,1,15,0,0,2,0,19,72670,29102,5822,38605,0
291,6479,72,33,56,0,4,12,72,1,1,1,1,2,2,0,2,0,1,0,0,2,4,7,72670,29102,5822,38606,0
291,6479,1454,835,1044,76,110,219,1530,17,275,158,296,292,454,2297,3718,9,34017,1889,1,2,4,7,72680,29103,5822,38607,0
125,5597,1782,648,1425,9,47,279,1791,8,171,97,189,179,286,1292,2140,4,9462,525,0,2,3,7,72680,29104,5823,38608,0
215,4636,2,2,2,0,0,0,2,0,0,0,0,0,0,0,0,0,0,0,0,2,4,7,72680,29104,5823,38608,0
215,4636,99,48,90,1,3,5,100,0,0,0,0,0,0,0,0,0,0,0,0,2,4,7,72680,29105,5823,38609,0
215,4636,8,5,5,2,0,1,10,0,0,0,0,0,0,0,0,0,0,0,0,2,4,7,72680,29105,5823,38610,0
215,4636,1217,716,841,84,126,174,1301,14,185,118,215,199,333,1446,2542,8,20687,1149,0,2,4,7,72690,29107,5823,38611,0
215,4636,160,89,115,0,13,31,160,7,15,11,17,22,28,78,124,3,495,27,0,2,4,7,72690,29107,5823,38612,0
215,4636,10,10,9,9,0,0,19,0,0,0,0,0,0,0,0,0,0,0,0,2,4,7,72690,29107,5824,38613,0
215,4636,173,84,99,8,29,36,181,5,12,7,13,17,20,54,81,2,221,12,0,2,4,7,72690,29108,5824,38614,0
215,4636,3,1,1,3,0,0,6,0,0,0,0,0,0,0,0,0,0,0,0,2,4,7,72690,29108,5824,38615,0
250,5779,4293,999,3693,19,54,507,4312,9,155,88,170,164,258,1156,1898,4,9368,520,0,2,4,27,72690,29110,5824,38617,0
250,5779,1482,859,1002,125,135,219,1607,16,219,134,251,235,385,1766,3032,9,27804,1544,1,2,4,27,72700,29111,5824,38618,0
99,2686,1523,757,1297,19,12,193,1542,12,193,117,230,205,347,1508,2664,7,19053,1058,0,2,4,12,72710,29113,5824,38619,0
99,2686,701,378,504,33,58,109,734,13,110,68,126,123,194,794,1346,7,10027,557,0,2,4,12,72710,29114,5825,38620,0
291,6479,72,33,56,0,4,12,72,1,1,1,1,2,2,0,2,0,1,0,0,2,4,7,72710,29114,5825,38621,0
291,6479,1454,835,1044,76,110,219,1530,17,275,158,296,292,454,2297,3718,9,34017,1889,1,2,4,7,72720,29115,5825,38622,0
91,1879,757,253,292,73,244,162,830,13,61,38,67,74,105,409,651,7,4654,258,0,2,1,1,72720,29116,5825,38623,0
99,4097,1289,550,1043,56,32,155,1345,10,167,93,185,177,278,1266,2075,5,11498,638,0,2,5,6,72720,29118,5826,38624,0
15,836,75,38,59,1,3,12,76,2,4,2,4,6,6,10,15,1,15,0,0,2,0,41,72720,29118,5826,38625,0
167,7471,139,89,101,2,0,35,141,7,54,34,62,61,96,330,569,4,2287,127,0,2,0,19,72720,29118,5826,38626,0
167,7471,7,5,5,0,0,2,7,1,2,1,2,3,3,2,4,0,2,0,0,2,0,19,72720,29118,5826,38627,0
125,5597,1782,648,1425,9,47,279,1791,8,171,97,189,179,286,1292,2140,4,9462,525,0,2,3,7,72720,29119,5827,38628,0
31,979,256,139,192,9,7,47,265,4,23,12,24,27,36,112,171,2,357,19,0,2,5,0,72720,29120,5827,38629,0
120,4791,1450,624,1228,12,26,181,1462,14,306,186,354,320,540,2580,4493,8,36391,2021,1,2,2,1,72720,29122,5828,38630,0
90,4729,1457,730,1242,11,6,188,1468,10,292,166,329,302,495,2424,4078,5,22973,1276,1,2,3,0,72720,29124,5828,38631,0
97,4773,1523,757,1297,19,12,193,1542,12,193,117,230,205,347,1508,2664,7,19053,1058,0,2,4,3,72730,29126,5828,38632,0
102,5297,1943,715,1694,26,18,214,1969,12,185,120,237,197,357,1436,2721,7,20915,1161,0,2,8,4,72730,29128,5828,38633,0
73,1518,207,111,150,11,0,50,218,5,26,19,36,31,55,133,272,3,943,52,0,2,2,2,72730,29128,5828,38634,0
73,1518,410,198,237,31,55,97,441,11,63,38,72,74,110,414,683,6,4293,238,0,2,2,2,72740,29129,5829,38635,0
92,1894,757,253,292,73,244,162,830,13,61,38,67,74,105,409,651,7,4654,258,0,2,9,4,72740,29130,5829,38636,0
66,4392,520,294,400,33,13,81,553,10,261,204,367,271,571,2128,4614,7,32445,1802,1,2,11,0,72740,29131,5829,38637,0
184,5593,1660,832,1314,41,38,274,1701,20,312,209,395,332,604,2671,5058,12,64042,3557,1,2,3,3,72740,29133,5830,38639,0
184,5593,1057,646,719,113,100,145,1170,18,215,134,248,233,382,1740,3004,10,31186,1732,1,2,3,3,72750,29134,5831,38640,0
82,1855,996,429,845,24,10,117,1020,7,76,50,88,83,138,494,879,4,3565,198,0,2,3,3,72750,29136,5831,38641,0
82,1855,456,277,329,12,42,72,468,13,85,50,97,98,147,592,972,7,7212,400,0,2,3,3,72750,29136,5831,38642,0
215,4636,2,2,2,0,0,0,2,0,0,0,0,0,0,0,0,0,0,0,0,2,27,55,72750,29136,5831,38642,0
215,4636,99,48,90,1,3,5,100,0,0,0,0,0,0,0,0,0,0,0,0,2,27,55,72750,29137,5831,38643,0
215,4636,8,5,5,2,0,1,10,0,0,0,0,0,0,0,0,0,0,0,0,2,27,55,72750,29137,5831,38644,0
215,4636,1217,716,841,84,126,174,1301,14,185,118,215,199,333,1446,2542,8,20687,1149,0,2,27,55,72760,29139,5831,38645,0
215,4636,160,89,115,0,13,31,160,7,15,11,17,22,28,78,124,3,495,27,0,2,27,55,72760,29139,5831,38646,0
215,4636,10,10,9,9,0,0,19,0,0,0,0,0,0,0,0,0,0,0,0,2,27,55,72760,29139,5832,38647,0
215,4636,173,84,99,8,29,36,181,5,12,7,13,17,20,54,81,2,221,12,0,2,27,55,72760,29140,5832,38648,0
215,4636,3,1,1,3,0,0,6,0,0,0,0,0,0,0,0,0,0,0,0,2,27,55,72760,29140,5832,38649,0
55,796,167,116,138,4,5,22,171,8,48,30,56,56,86,292,499,4,2330,129,0,2,6,6,72760,29140,5832,38650,0
52,621,647,139,84,35,284,233,682,0,0,0,0,0,0,0,0,0,0,0,0,2,3,1,72760,29140,5832,38652,0
76,1637,53,23,39,0,0,13,53,2,8,4,8,10,12,26,39,1,39,2,0,2,5,66,72760,29140,5832,38653,0
76,1637,515,298,307,33,80,99,548,12,63,44,77,75,121,419,753,7,5527,307,0,2,5,66,72770,29140,5832,38654,0
30,664,215,129,180,6,0,29,221,8,65,43,72,73,115,415,711,4,3153,175,0,2,2,2,72770,29140,5832,38655,0
30,664,97,69,77,3,3,16,100,6,22,13,23,28,36,113,173,3,542,30,0,2,2,2,72770,29141,5832,38656,0
230,4915,1943,715,1694,26,18,214,1969,12,185,120,237,197,357,1436,2721,7,20915,1161,0,2,1,11,72770,29143,5832,38657,0
230,4915,1168,838,957,57,25,144,1225,19,348,224,416,367,640,3018,5452,11,61921,3440,1,2,1,11,72780,29145,5832,38658,0
29,743,601,196,481,2,23,85,603,8,63,36,72,71,108,400,664,4,3036,168,0,2,3,3,72780,29145,5832,38659,0
29,743,156,79,106,5,16,28,161,5,14,8,15,19,23,64,97,2,261,14,0,2,3,3,72780,29145,5832,38660,0
99,4097,1289,550,1043,56,32,155,1345,10,167,93,185,177,278,1266,2075,5,11498,638,0,2,1,0,72780,29147,5833,38661,0
15,836,75,38,59,1,3,12,76,2,4,2,4,6,6,10,15,1,15,0,0,2,1,0,72780,29147,5833,38662,0
167,5017,1660,832,1314,41,38,274,1701,20,312,209,395,332,604,2671,5058,12,64042,3557,1,2,3,1,72780,29149,5834,38664,0
90,4729,1457,730,1242,11,6,188,1468,10,292,166,329,302,495,2424,4078,5,22973,1276,1,2,0,61,72780,29151,5834,38665,0
28,1839,384,251,317,7,8,52,391,11,70,44,84,81,128,467,811,6,5355,297,0,2,4,20,72780,29151,5834,38666,0
47,2254,722,423,573,19,0,135,741,12,172,101,199,184,300,1320,2257,6,15668,870,0,2,1,1,72780,29153,5834,38668,0
51,1747,601,196,481,2,23,85,603,8,63,36,72,71,108,400,664,4,3036,168,0,2,2,2,72780,29153,5834,38669,0
246,5700,4293,999,3693,19,54,507,4312,9,155,88,170,164,258,1156,1898,4,9368,520,0,2,8,25,72780,29155,5834,38671,1
246,5700,1482,859,1002,125,135,219,1607,16,219,134,251,235,385,1766,3032,9,27804,1544,1,2,8,25,72790,29156,5834,38672,1
13,806,75,38,59,1,3,12,76,2,4,2,4,6,6,10,15,1,15,0,0,2,0,11,72790,29156,5834,38673,1
169,7506,139,89,101,2,0,35,141,7,54,34,62,61,96,330,569,4,2287,127,0,2,11,0,72790,29156,5834,38674,1
169,7506,7,5,5,0,0,2,7,1,2,1,2,3,3,2,4,0,2,0,0,2,11,0,72790,29156,5834,38675,1
246,5700,4293,999,3693,19,54,507,4312,9,155,88,170,164,258,1156,1898,4,9368,520,0,2,8,25,72790,29158,5834,38677,0
246,5700,1482,859,1002,125,135,219,1607,16,219,134,251,235,385,1766,3032,9,27804,1544,1,2,8,25,72800,29159,5834,38678,0
13,806,75,38,59,1,3,12,76,2,4,2,4,6,6,10,15,1,15,0,0,2,0,11,72800,29159,5834,38679,0
169,7506,139,89,101,2,0,35,141,7,54,34,62,61,96,330,569,4,2287,127,0,2,11,0,72800,29159,5834,38680,0
169,7506,7,5,5,0,0,2,7,1,2,1,2,3,3,2,4,0,2,0,0,2,11,0,72800,29159,5834,38681,0
99,4845,1523,757,1297,19,12,193,1542,12,193,117,230,205,347,1508,2664,7,19053,1058,0,2,24,11,72810,29161,5834,38682,0
55,770,167,116,138,4,5,22,171,8,48,30,56,56,86,292,499,4,2330,129,0,2,8,17,72810,29161,5834,38683,0
13,788,75,38,59,1,3,12,76,2,4,2,4,6,6,10,15,1,15,0,0,2,6,12,72810,29161,5834,38685,0
215,4638,2,2,2,0,0,0,2,0,0,0,0,0,0,0,0,0,0,0,0,2,6,5,72810,29161,5834,38685,0
215,4638,99,48,90,1,3,5,100,0,0,0,0,0,0,0,0,0,0,0,0,2,6,5,72810,29162,5834,38686,0
215,4638,8,5,5,2,0,1,10,0,0,0,0,0,0,0,0,0,0,0,0,2,6,5,72810,29162,5834,38687,0
215,4638,1217,716,841,84,126,174,1301,14,185,118,215,199,333,1446,2542,8,20687,1149,0,2,6,5,72820,29164,5834,38688,0
215,4638,160,89,115,0,13,31,160,7,15,11,17,22,28,78,124,3,495,27,0,2,6,5,72820,29164,5834,38689,0
215,4638,10,10,9,9,0,0,19,0,0,0,0,0,0,0,0,0,0,0,0,2,6,5,72820,29164,5835,38690,0
215,4638,173,84,99,8,29,36,181,5,12,7,13,17,20,54,81,2,221,12,0,2,6,5,72820,29165,5835,38691,0
215,4638,3,1,1,3,0,0,6,0,0,0,0,0,0,0,0,0,0,0,0,2,6,5,72820,29165,5835,38692,0
13,808,75,38,59,1,3,12,76,2,4,2,4,6,6,10,15,1,15,0,0,2,8,14,72820,29165,5835,38694,0
215,4638,2,2,2,0,0,0,2,0,0,0,0,0,0,0,0,0,0,0,0,2,6,5,72820,29165,5835,38694,0
215,4638,99,48,90,1,3,5,100,0,0,0,0,0,0,0,0,0,0,0,0,2,6,5,72820,29166,5835,38695,0
215,4638,8,5,5,2,0,1,10,0,0,0,0,0,0,0,0,0,0,0,0,2,6,5,72820,29166,5835,38696,0
215,4638,1217,716,841,84,126,174,1301,14,185,118,215,199,333,1446,2542,8,20687,1149,0,2,6,5,72830,29168,5835,38697,0
215,4638,160,89,115,0,13,31,160,7,15,11,17,22,28,78,124,3,495,27,0,2,6,5,72830,29168,5835,38698,0
215,4638,10,10,9,9,0,0,19,0,0,0,0,0,0,0,0,0,0,0,0,2,6,5,72830,29168,5836,38699,0
215,4638,173,84,99,8,29,36,181,5,12,7,13,17,20,54,81,2,221,12,0,2,6,5,72830,29169,5836,38700,0
215,4638,3,1,1,3,0,0,6,0,0,0,0,0,0,0,0,0,0,0,0,2,6,5,72830,29169,5836,38701,0
55,770,167,116,138,4,5,22,171,8,48,30,56,56,86,292,499,4,2330,129,0,2,8,17,72830,29169,5836,38702,0
13,808,75,38,59,1,3,12,76,2,4,2,4,6,6,10,15,1,15,0,0,2,14,26,72830,29169,5836,38704,0
99,4845,1523,757,1297,19,12,193,1542,12,193,117,230,205,347,1508,2664,7,19053,1058,0,2,24,11,72840,29171,5836,38705,0
84,1876,402,202,227,24,74,80,426,12,52,33,61,64,94,339,564,7,3969,220,0,2,21,33,72840,29172,5836,38707,0
90,3983,1338,495,1086,10,64,173,1348,11,122,82,157,133,239,883,1686,7,11934,663,0,2,17,25,72840,29174,5836,38708,0
125,5588,1782,648,1425,9,47,279,1791,8,171,97,189,179,286,1292,2140,4,9462,525,0,2,11,10,72840,29175,5837,38709,0
98,4153,1020,354,843,12,15,144,1032,8,134,77,144,142,221,970,1580,4,6792,377,0,2,4,33,72840,29175,5837,38710,0
84,1876,402,202,227,24,74,80,426,12,52,33,61,64,94,339,564,7,3969,220,0,2,21,33,72840,29176,5837,38712,0
90,3983,1338,495,1086,10,64,173,1348,11,122,82,157,133,239,883,1686,7,11934,663,0,2,17,25,72840,29178,5837,38713,0
125,5588,1782,648,1425,9,47,279,1791,8,171,97,189,179,286,1292,2140,4,9462,525,0,2,11,10,72840,29179,5838,38714,0
98,4153,1020,354,843,12,15,144,1032,8,134,77,144,142,221,970,1580,4,6792,377,0,2,4,33,72840,29179,5838,38715,0
217,4661,2,2,2,0,0,0,2,0,0,0,0,0,0,0,0,0,0,0,0,2,4,1,72840,29179,5838,38715,0
217,4661,99,48,90,1,3,5,100,0,0,0,0,0,0,0,0,0,0,0,0,2,4,1,72840,29180,5838,38716,0
217,4661,8,5,5,2,0,1,10,0,0,0,0,0,0,0,0,0,0,0,0,2,4,1,72840,29180,5838,38717,0
217,4661,1217,716,841,84,126,174,1301,14,185,118,215,199,333,1446,2542,8,20687,1149,0,2,4,1,72850,29182,5838,38718,0
217,4661,160,89,115,0,13,31,160,7,15,11,17,22,28,78,124,3,495,27,0,2,4,1,72850,29182,5838,38719,0
217,4661,10,10,9,9,0,0,19,0,0,0,0,0,0,0,0,0,0,0,0,2,4,1,72850,29182,5839,38720,0
217,4661,173,84,99,8,29,36,181,5,12,7,13,17,20,54,81,2,221,12,0,2,4,1,72850,29183,5839,38721,0
217,4661,3,1,1,3,0,0,6,0,0,0,0,0,0,0,0,0,0,0,0,2,4,1,72850,29183,5839,38722,0
245,5671,4293,999,3693,19,54,507,4312,9,155,88,170,164,258,1156,1898,4,9368,520,0,2,13,12,72850,29185,5839,38723,0
245,5671,1482,859,1002,125,135,219,1607,16,219,134,251,235,385,1766,3032,9,27804,1544,1,2,13,12,72860,29186,5839,38724,0
24,613,2,2,2,0,0,0,2,0,0,0,0,0,0,0,0,0,0,0,0,2,1,10,72860,29186,5839,38724,0
24,613,99,48,90,1,3,5,100,0,0,0,0,0,0,0,0,0,0,0,0,2,1,10,72860,29187,5839,38725,0
24,613,8,5,5,2,0,1,10,0,0,0,0,0,0,0,0,0,0,0,0,2,1,10,72860,29187,5839,38726,0
24,613,1217,716,841,84,126,174,1301,14,185,118,215,199,333,1446,2542,8,20687,1149,0,2,1,10,72870,29189,5839,38727,0
24,613,160,89,115,0,13,31,160,7,15,11,17,22,28,78,124,3,495,27,0,2,1,10,72870,29189,5839,38728,0
24,613,10,10,9,9,0,0,19,0,0,0,0,0,0,0,0,0,0,0,0,2,1,10,72870,29189,5840,38729,0
24,613,173,84,99,8,29,36,181,5,12,7,13,17,20,54,81,2,221,12,0,2,1,10,72870,29190,5840,38730,0
24,613,3,1,1,3,0,0,6,0,0,0,0,0,0,0,0,0,0,0,0,2,1,10,72870,29190,5840,38731,0
69,1497,402,202,227,24,74,80,426,12,52,33,61,64,94,339,564,7,3969,220,0,2,8,93,72870,29191,5840,38732,0
74,1599,53,23,39,0,0,13,53,2,8,4,8,10,12,26,39,1,39,2,0,2,0,15,72870,29191,5840,38733,0
74,1599,515,298,307,33,80,99,548,12,63,44,77,75,121,419,753,7,5527,307,0,2,0,15,72880,29191,5840,38734,0
291,6500,72,33,56,0,4,12,72,1,1,1,1,2,2,0,2,0,1,0,0,2,15,5,72880,29191,5840,38735,0
291,6500,1454,835,1044,76,110,219,1530,17,275,158,296,292,454,2297,3718,9,34017,1889,1,2,15,5,72890,29192,5840,38736,0
62,1233,1098,241,925,5,10,155,1103,7,46,25,49,53,74,273,423,3,1580,87,0,2,0,4,72900,29194,5840,38737,0
62,1233,282,202,222,14,2,44,296,8,42,24,43,50,67,250,378,4,1548,86,0,2,0,4,72900,29195,5840,38738,0
68,3066,1020,354,843,12,15,144,1032,8,134,77,144,142,221,970,1580,4,6792,377,0,2,11,281,72900,29195,5840,38739,0
220,4688,2,2,2,0,0,0,2,0,0,0,0,0,0,0,0,0,0,0,0,2,8,3,72900,29195,5840,38739,0
220,4688,99,48,90,1,3,5,100,0,0,0,0,0,0,0,0,0,0,0,0,2,8,3,72900,29196,5840,38740,0
220,4688,8,5,5,2,0,1,10,0,0,0,0,0,0,0,0,0,0,0,0,2,8,3,72900,29196,5840,38741,0
220,4688,1217,716,841,84,126,174,1301,14,185,118,215,199,333,1446,2542,8,20687,1149,0,2,8,3,72910,29198,5840,38742,0
220,4688,160,89,115,0,13,31,160,7,15,11,17,22,28,78,124,3,495,27,0,2,8,3,72910,29198,5840,38743,0
220,4688,10,10,9,9,0,0,19,0,0,0,0,0,0,0,0,0,0,0,0,2,8,3,72910,29198,5841,38744,0
220,4688,173,84,99,8,29,36,181,5,12,7,13,17,20,54,81,2,221,12,0,2,8,3,72910,29199,5841,38745,0
220,4688,3,1,1,3,0,0,6,0,0,0,0,0,0,0,0,0,0,0,0,2,8,3,72910,29199,5841,38746,0
220,4688,2,2,2,0,0,0,2,0,0,0,0,0,0,0,0,0,0,0,0,2,2,0,72910,29199,5841,38746,0
220,4688,99,48,90,1,3,5,100,0,0,0,0,0,0,0,0,0,0,0,0,2,2,0,72910,29200,5841,38747,0
220,4688,8,5,5,2,0,1,10,0,0,0,0,0,0,0,0,0,0,0,0,2,2,0,72910,29200,5841,38748,0
220,4688,1217,716,841,84,126,174,1301,14,185,118,215,199,333,1446,2542,8,20687,1149,0,2,2,0,72920,29202,5841,38749,0
220,4688,160,89,115,0,13,31,160,7,15,11,17,22,28,78,124,3,495,27,0,2,2,0,72920,29202,5841,38750,0
220,4688,10,10,9,9,0,0,19,0,0,0,0,0,0,0,0,0,0,0,0,2,2,0,72920,29202,5842,38751,0
220,4688,173,84,99,8,29,36,181,5,12,7,13,17,20,54,81,2,221,12,0,2,2,0,72920,29203,5842,38752,0
220,4688,3,1,1,3,0,0,6,0,0,0,0,0,0,0,0,0,0,0,0,2,2,0,72920,29203,5842,38753,0
291,6500,72,33,56,0,4,12,72,1,1,1,1,2,2,0,2,0,1,0,0,2,2,0,72920,29203,5842,38754,0
291,6500,1454,835,1044,76,110,219,1530,17,275,158,296,292,454,2297,3718,9,34017,1889,1,2,2,0,72930,29204,5842,38755,0
220,4688,2,2,2,0,0,0,2,0,0,0,0,0,0,0,0,0,0,0,0,2,14,4,72930,29204,5842,38755,0
220,4688,99,48,90,1,3,5,100,0,0,0,0,0,0,0,0,0,0,0,0,2,14,4,72930,29205,5842,38756,0
220,4688,8,5,5,2,0,1,10,0,0,0,0,0,0,0,0,0,0,0,0,2,14,4,72930,29205,5842,38757,0
220,4688,1217,716,841,84,126,174,1301,14,185,118,215,199,333,1446,2542,8,20687,1149,0,2,14,4,72940,29207,5842,38758,0
220,4688,160,89,115,0,13,31,160,7,15,11,17,22,28,78,124,3,495,27,0,2,14,4,72940,29207,5842,38759,0
220,4688,10,10,9,9,0,0,19,0,0,0,0,0,0,0,0,0,0,0,0,2,14,4,72940,29207,5843,38760,0
220,4688,173,84,99,8,29,36,181,5,12,7,13,17,20,54,81,2,221,12,0,2,14,4,72940,29208,5843,38761,0
220,4688,3,1,1,3,0,0,6,0,0,0,0,0,0,0,0,0,0,0,0,2,14,4,72940,29208,5843,38762,0
245,5671,4293,999,3693,19,54,507,4312,9,155,88,170,164,258,1156,1898,4,9368,520,0,2,13,12,72940,29210,5843,38763,0
245,5671,1482,859,1002,125,135,219,1607,16,219,134,251,235,385,1766,3032,9,27804,1544,1,2,13,12,72950,29211,5843,38764,0
24,613,2,2,2,0,0,0,2,0,0,0,0,0,0,0,0,0,0,0,0,2,1,10,72950,29211,5843,38764,0
24,613,99,48,90,1,3,5,100,0,0,0,0,0,0,0,0,0,0,0,0,2,1,10,72950,29212,5843,38765,0
24,613,8,5,5,2,0,1,10,0,0,0,0,0,0,0,0,0,0,0,0,2,1,10,72950,29212,5843,38766,0
24,613,1217,716,841,84,126,174,1301,14,185,118,215,199,333,1446,2542,8,20687,1149,0,2,1,10,72960,29214,5843,38767,0
24,613,160,89,115,0,13,31,160,7,15,11,17,22,28,78,124,3,495,27,0,2,1,10,72960,29214,5843,38768,0
24,613,10,10,9,9,0,0,19,0,0,0,0,0,0,0,0,0,0,0,0,2,1,10,72960,29214,5844,38769,0
24,613,173,84,99,8,29,36,181,5,12,7,13,17,20,54,81,2,221,12,0,2,1,10,72960,29215,5844,38770,0
24,613,3,1,1,3,0,0,6,0,0,0,0,0,0,0,0,0,0,0,0,2,1,10,72960,29215,5844,38771,0
69,1497,402,202,227,24,74,80,426,12,52,33,61,64,94,339,564,7,3969,220,0,2,8,93,72960,29216,5844,38772,0
74,1599,53,23,39,0,0,13,53,2,8,4,8,10,12,26,39,1,39,2,0,2,0,15,72960,29216,5844,38773,0
74,1599,515,298,307,33,80,99,548,12,63,44,77,75,121,419,753,7,5527,307,0,2,0,15,72970,29216,5844,38774,0
291,6500,72,33,56,0,4,12,72,1,1,1,1,2,2,0,2,0,1,0,0,2,17,5,72970,29216,5844,38775,0
291,6500,1454,835,1044,76,110,219,1530,17,275,158,296,292,454,2297,3718,9,34017,1889,1,2,17,5,72980,29217,5844,38776,0
62,1233,1098,241,925,5,10,155,1103,7,46,25,49,53,74,273,423,3,1580,87,0,2,0,4,72990,29219,5844,38777,0
62,1233,282,202,222,14,2,44,296,8,42,24,43,50,67,250,378,4,1548,86,0,2,0,4,72990,29220,5844,38778,0
68,3066,1020,354,843,12,15,144,1032,8,134,77,144,142,221,970,1580,4,6792,377,0,2,11,281,72990,29220,5844,38779,0
234,4977,1943,715,1694,26,18,214,1969,12,185,120,237,197,357,1436,2721,7,20915,1161,0,2,4,0,72990,29222,5844,38780,0
234,4977,1168,838,957,57,25,144,1225,19,348,224,416,367,640,3018,5452,11,61921,3440,1,2,4,0,73000,29224,5844,38781,0
103,5339,1943,715,1694,26,18,214,1969,12,185,120,237,197,357,1436,2721,7,20915,1161,0,2,12,0,73000,29226,5844,38782,0
234,4977,1943,715,1694,26,18,214,1969,12,185,120,237,197,357,1436,2721,7,20915,1161,0,2,4,0,73000,29228,5844,38783,0
234,4977,1168,838,957,57,25,144,1225,19,348,224,416,367,640,3018,5452,11,61921,3440,1,2,4,0,73010,29230,5844,38784,0
103,5339,1943,715,1694,26,18,214,1969,12,185,120,237,197,357,1436,2721,7,20915,1161,0,2,12,0,73010,29232,5844,38785,0
1,323,382,65,130,157,2,92,539,4,10,5,10,14,15,41,57,2,114,6,0,2,2,1,73010,29233,5845,38786,0
1,321,382,65,130,157,2,92,539,4,10,5,10,14,15,41,57,2,114,6,0,2,1,1,73010,29234,5846,38787,0
21,538,205,80,86,16,53,53,221,7,18,10,19,25,29,94,134,3,497,27,0,2,4,2,73020,29234,5847,38788,0
83,3323,1043,504,840,53,9,147,1096,9,180,112,198,189,310,1377,2344,4,11604,644,0,2,16,0,73020,29236,5847,38789,1
21,538,205,80,86,16,53,53,221,7,18,10,19,25,29,94,134,3,497,27,0,2,8,3,73030,29236,5848,38790,0
21,538,205,80,86,16,53,53,221,7,18,10,19,25,29,94,134,3,497,27,0,2,12,5,73040,29236,5849,38791,0
83,3323,1043,504,840,53,9,147,1096,9,180,112,198,189,310,1377,2344,4,11604,644,0,2,16,0,73040,29238,5849,38792,0
1,321,382,65,130,157,2,92,539,4,10,5,10,14,15,41,57,2,114,6,0,2,1,1,73040,29239,5850,38793,0
60,1167,282,196,195,3,0,86,285,8,130,71,141,138,212,936,1507,4,6538,363,0,2,27,3,73040,29239,5851,38794,0
1,90,13,10,10,0,0,3,13,1,2,1,2,3,3,2,4,0,2,0,0,2,1,1,73040,29239,5851,38795,0
231,4983,182,127,129,0,0,53,182,5,39,21,42,44,63,217,343,2,926,51,0,2,71,32,73040,29239,5852,38796,0
231,4983,1165,710,800,67,119,181,1232,18,243,153,282,261,435,2000,3492,10,36473,2026,1,2,71,32,73050,29239,5853,38797,0
184,5593,1660,832,1314,41,38,274,1701,20,312,209,395,332,604,2671,5058,12,64042,3557,1,2,50,3,73050,29241,5854,38799,0
184,5593,1057,646,719,113,100,145,1170,18,215,134,248,233,382,1740,3004,10,31186,1732,1,2,50,3,73060,29242,5855,38800,0
108,2059,477,336,357,30,23,73,507,16,194,134,250,210,384,1538,2962,10,30538,1696,0,2,42,1,73070,29243,5855,38801,0
82,1855,996,429,845,24,10,117,1020,7,76,50,88,83,138,494,879,4,3565,198,0,2,14,3,73070,29245,5855,38802,0
82,1855,456,277,329,12,42,72,468,13,85,50,97,98,147,592,972,7,7212,400,0,2,14,3,73070,29245,5855,38803,0
156,3271,1513,682,1277,25,13,200,1538,11,199,116,219,210,335,1557,2584,6,15641,868,0,2,3,3,73070,29247,5855,38804,0
156,3271,819,519,539,24,98,155,843,15,96,57,106,111,163,690,1107,8,9171,509,0,2,3,3,73080,29249,5855,38805,0
73,1518,207,111,150,11,0,50,218,5,26,19,36,31,55,133,272,3,943,52,0,2,21,8,73080,29249,5855,38806,0
73,1518,410,198,237,31,55,97,441,11,63,38,72,74,110,414,683,6,4293,238,0,2,21,8,73090,29250,5856,38807,0
220,4688,2,2,2,0,0,0,2,0,0,0,0,0,0,0,0,0,0,0,0,2,67,83,73090,29250,5856,38807,0
220,4688,99,48,90,1,3,5,100,0,0,0,0,0,0,0,0,0,0,0,0,2,67,83,73090,29251,5856,38808,0
220,4688,8,5,5,2,0,1,10,0,0,0,0,0,0,0,0,0,0,0,0,2,67,83,73090,29251,5856,38809,0
220,4688,1217,716,841,84,126,174,1301,14,185,118,215,199,333,1446,2542,8,20687,1149,0,2,67,83,73100,29253,5856,38810,0
220,4688,160,89,115,0,13,31,160,7,15,11,17,22,28,78,124,3,495,27,0,2,67,83,73100,29253,5856,38811,0
220,4688,10,10,9,9,0,0,19,0,0,0,0,0,0,0,0,0,0,0,0,2,67,83,73100,29253,5857,38812,0
220,4688,173,84,99,8,29,36,181,5,12,7,13,17,20,54,81,2,221,12,0,2,67,83,73100,29254,5857,38813,0
220,4688,3,1,1,3,0,0,6,0,0,0,0,0,0,0,0,0,0,0,0,2,67,83,73100,29254,5857,38814,0
97,2016,463,295,324,28,62,57,491,12,134,82,154,146,236,989,1696,6,11700,650,0,2,5,2,73110,29255,5857,38815,0
55,770,167,116,138,4,5,22,171,8,48,30,56,56,86,292,499,4,2330,129,0,2,24,27,73110,29255,5857,38816,0
41,1220,339,213,244,17,9,65,356,10,42,26,48,52,74,259,421,5,2410,133,0,2,18,10,73120,29255,5857,38817,0
245,5671,4293,999,3693,19,54,507,4312,9,155,88,170,164,258,1156,1898,4,9368,520,0,2,26,109,73120,29257,5857,38819,0
245,5671,1482,859,1002,125,135,219,1607,16,219,134,251,235,385,1766,3032,9,27804,1544,1,2,26,109,73130,29258,5857,38820,0
52,621,647,139,84,35,284,233,682,0,0,0,0,0,0,0,0,0,0,0,0,2,2,28,73130,29258,5857,38821,0
99,2686,1523,757,1297,19,12,193,1542,12,193,117,230,205,347,1508,2664,7,19053,1058,0,2,18,13,73140,29260,5857,38822,0
99,2686,701,378,504,33,58,109,734,13,110,68,126,123,194,794,1346,7,10027,557,0,2,18,13,73140,29261,5858,38823,0
154,3597,77,34,69,0,0,8,77,3,24,16,29,27,45,114,213,1,387,21,0,2,22,4,73140,29261,5858,38824,0
154,3597,712,438,573,51,9,84,763,14,102,71,128,116,199,733,1364,8,11988,666,0,2,22,4,73150,29262,5858,38825,0
24,613,2,2,2,0,0,0,2,0,0,0,0,0,0,0,0,0,0,0,0,2,1,10,73150,29262,5858,38825,0
24,613,99,48,90,1,3,5,100,0,0,0,0,0,0,0,0,0,0,0,0,2,1,10,73150,29263,5858,38826,0
24,613,8,5,5,2,0,1,10,0,0,0,0,0,0,0,0,0,0,0,0,2,1,10,73150,29263,5858,38827,0
24,613,1217,716,841,84,126,174,1301,14,185,118,215,199,333,1446,2542,8,20687,1149,0,2,1,10,73160,29265,5858,38828,0
24,613,160,89,115,0,13,31,160,7,15,11,17,22,28,78,124,3,495,27,0,2,1,10,73160,29265,5858,38829,0
24,613,10,10,9,9,0,0,19,0,0,0,0,0,0,0,0,0,0,0,0,2,1,10,73160,29265,5859,38830,0
24,613,173,84,99,8,29,36,181,5,12,7,13,17,20,54,81,2,221,12,0,2,1,10,73160,29266,5859,38831,0
24,613,3,1,1,3,0,0,6,0,0,0,0,0,0,0,0,0,0,0,0,2,1,10,73160,29266,5859,38832,0
69,1497,402,202,227,24,74,80,426,12,52,33,61,64,94,339,564,7,3969,220,0,2,38,130,73160,29267,5859,38833,0
74,1599,53,23,39,0,0,13,53,2,8,4,8,10,12,26,39,1,39,2,0,2,6,117,73160,29267,5859,38834,0
74,1599,515,298,307,33,80,99,548,12,63,44,77,75,121,419,753,7,5527,307,0,2,6,117,73170,29267,5859,38835,0
18,306,424,94,331,4,0,89,428,1,5,5,5,6,10,11,25,0,12,0,0,2,3,13,73170,29268,5859,38836,0
18,306,38,23,23,6,0,8,44,3,11,7,11,14,18,42,68,1,102,5,0,2,3,13,73170,29268,5859,38837,0
21,538,205,80,86,16,53,53,221,7,18,10,19,25,29,94,134,3,497,27,0,2,15,8,73180,29268,5860,38838,0
291,6500,72,33,56,0,4,12,72,1,1,1,1,2,2,0,2,0,1,0,0,2,32,113,73180,29268,5860,38839,0
291,6500,1454,835,1044,76,110,219,1530,17,275,158,296,292,454,2297,3718,9,34017,1889,1,2,32,113,73190,29269,5860,38840,0
92,1894,757,253,292,73,244,162,830,13,61,38,67,74,105,409,651,7,4654,258,0,2,55,48,73190,29270,5860,38841,0
45,935,386,256,301,16,9,68,402,4,59,35,69,63,104,355,621,2,1453,80,0,2,2,0,73190,29270,5860,38842,0
45,935,264,131,164,11,41,46,275,6,38,22,40,44,62,214,338,3,1068,59,0,2,2,0,73200,29270,5861,38843,0
30,664,215,129,180,6,0,29,221,8,65,43,72,73,115,415,711,4,3153,175,0,2,2,2,73200,29270,5861,38844,0
30,664,97,69,77,3,3,16,100,6,22,13,23,28,36,113,173,3,542,30,0,2,2,2,73200,29271,5861,38845,0
95,2085,1043,504,840,53,9,147,1096,9,180,112,198,189,310,1377,2344,4,11604,644,0,2,42,25,73200,29273,5861,38846,0
95,2085,383,288,292,26,6,62,409,11,65,38,67,76,105,429,656,5,3719,206,0,2,42,25,73200,29274,5861,38847,0
234,4977,1943,715,1694,26,18,214,1969,12,185,120,237,197,357,1436,2721,7,20915,1161,0,2,6,12,73200,29276,5861,38848,0
234,4977,1168,838,957,57,25,144,1225,19,348,224,416,367,640,3018,5452,11,61921,3440,1,2,6,12,73210,29278,5861,38849,0
62,1233,1098,241,925,5,10,155,1103,7,46,25,49,53,74,273,423,3,1580,87,0,2,5,5,73220,29280,5861,38850,0
62,1233,282,202,222,14,2,44,296,8,42,24,43,50,67,250,378,4,1548,86,0,2,5,5,73220,29281,5861,38851,0
29,743,601,196,481,2,23,85,603,8,63,36,72,71,108,400,664,4,3036,168,0,2,3,3,73220,29281,5861,38852,0
29,743,156,79,106,5,16,28,161,5,14,8,15,19,23,64,97,2,261,14,0,2,3,3,73220,29281,5861,38853,0
99,4097,1289,550,1043,56,32,155,1345,10,167,93,185,177,278,1266,2075,5,11498,638,0,2,8,9,73220,29283,5862,38854,0
35,1093,182,127,129,0,0,53,182,5,39,21,42,44,63,217,343,2,926,51,0,2,3,3,73220,29283,5863,38855,0
153,7221,1392,870,1177,35,17,170,1427,14,494,280,531,508,811,4473,7289,7,54850,3047,2,2,21,13,73220,29286,5864,38856,0
92,2899,773,419,590,28,0,166,801,10,204,113,217,214,330,1598,2554,5,13587,754,0,2,9,16,73220,29286,5865,38857,0
13,808,75,38,59,1,3,12,76,2,4,2,4,6,6,10,15,1,15,0,0,2,23,209,73220,29286,5865,38858,0
1,55,14,12,10,0,0,4,14,1,2,1,2,3,3,2,4,0,2,0,0,0,14,0,73220,29286,5865,38859,0
1,58,14,12,10,0,0,4,14,1,2,1,2,3,3,2,4,0,2,0,0,0,14,0,73220,29286,5865,38860,0
1,55,14,12,10,0,0,4,14,1,2,1,2,3,3,2,4,0,2,0,0,0,14,0,73220,29286,5865,38861,0
1,77,19,18,14,0,0,5,19,1,2,1,2,3,3,2,4,0,2,0,0,0,19,0,73220,29286,5865,38862,0
1,24,127,75,83,2,11,30,129,4,14,7,14,18,21,61,87,2,175,9,0,2,1,1,73220,29286,5865,38863,0
1,24,652,304,544,16,6,88,668,6,89,51,101,95,152,591,998,3,3399,188,0,2,1,1,73220,29287,5865,38864,0
1,24,2,2,2,0,0,0,2,0,0,0,0,0,0,0,0,0,0,0,0,2,1,1,73220,29287,5865,38864,0
1,24,8,5,5,0,0,3,8,0,0,0,0,0,0,0,0,0,0,0,0,2,1,1,73220,29287,5865,38865,0
1,24,2,2,2,0,0,0,2,0,0,0,0,0,0,0,0,0,0,0,0,2,1,1,73220,29287,5865,38865,0
1,24,14,8,8,0,0,6,14,0,0,0,0,0,0,0,0,0,0,0,0,2,1,1,73220,29287,5865,38866,0
1,24,6,4,4,0,0,2,6,0,0,0,0,0,0,0,0,0,0,0,0,2,1,1,73220,29287,5865,38867,0
1,24,6,4,4,0,0,2,6,1,2,1,2,3,3,2,4,0,2,0,0,2,1,1,73220,29287,5865,38868,0
1,24,6,4,4,0,0,2,6,0,0,0,0,0,0,0,0,0,0,0,0,2,1,1,73220,29287,5865,38869,0
1,24,7,5,5,0,0,2,7,0,0,0,0,0,0,0,0,0,0,0,0,2,1,1,73220,29287,5865,38870,0
1,24,6,4,4,0,0,2,6,0,0,0,0,0,0,0,0,0,0,0,0,2,1,1,73220,29287,5865,38871,0
1,24,10,6,6,0,0,4,10,0,0,0,0,0,0,0,0,0,0,0,0,2,1,1,73220,29287,5865,38872,0
1,24,1,1,1,0,0,0,1,0,0,0,0,0,0,0,0,0,0,0,0,2,1,1,73220,29287,5865,38872,0
1,24,14,10,10,0,0,4,14,1,1,1,1,2,2,0,2,0,1,0,0,2,1,1,73220,29287,5865,38873,0
1,24,46,26,30,3,0,12,49,3,6,3,6,9,9,20,28,1,42,2,0,2,1,1,73230,29287,5865,38874,0
66,4392,520,294,400,33,13,81,553,10,261,204,367,271,571,2128,4614,7,32445,1802,1,2,11,0,73230,29288,5865,38875,0
90,3983,1338,495,1086,10,64,173,1348,11,122,82,157,133,239,883,1686,7,11934,663,0,2,33,325,73230,29290,5865,38876,0
169,7506,139,89,101,2,0,35,141,7,54,34,62,61,96,330,569,4,2287,127,0,2,15,224,73230,29290,5865,38877,0
169,7506,7,5,5,0,0,2,7,1,2,1,2,3,3,2,4,0,2,0,0,2,15,224,73230,29290,5865,38878,0
125,5588,1782,648,1425,9,47,279,1791,8,171,97,189,179,286,1292,2140,4,9462,525,0,2,52,179,73230,29291,5866,38879,0
31,979,256,139,192,9,7,47,265,4,23,12,24,27,36,112,171,2,357,19,0,2,15,7,73230,29292,5866,38880,0
120,4791,1450,624,1228,12,26,181,1462,14,306,186,354,320,540,2580,4493,8,36391,2021,1,2,110,0,73230,29294,5867,38881,0
167,5017,1660,832,1314,41,38,274,1701,20,312,209,395,332,604,2671,5058,12,64042,3557,1,2,3,1,73230,29296,5868,38883,0
47,3455,996,429,845,24,10,117,1020,7,76,50,88,83,138,494,879,4,3565,198,0,2,12,0,73230,29298,5868,38884,0
124,5331,1513,682,1277,25,13,200,1538,11,199,116,219,210,335,1557,2584,6,15641,868,0,2,5,5,73230,29300,5868,38885,0
79,4485,1296,573,1062,40,33,157,1336,8,201,118,231,209,349,1561,2689,4,12365,686,0,2,20,34,73230,29300,5868,38886,0
90,4729,1457,730,1242,11,6,188,1468,10,292,166,329,302,495,2424,4078,5,22973,1276,1,2,4,64,73230,29302,5868,38887,0
99,4845,1523,757,1297,19,12,193,1542,12,193,117,230,205,347,1508,2664,7,19053,1058,0,2,31,0,73240,29304,5868,38888,0
68,3066,1020,354,843,12,15,144,1032,8,134,77,144,142,221,970,1580,4,6792,377,0,2,37,320,73240,29304,5868,38889,0
42,1932,447,308,343,6,5,95,453,7,96,59,111,103,170,651,1136,4,4600,255,0,2,4,4,73240,29307,5868,38890,0
20,626,424,94,331,4,0,89,428,1,5,5,5,6,10,11,25,0,12,0,0,2,0,68,73240,29308,5868,38891,0
39,2361,334,251,279,10,4,40,344,5,127,74,143,132,217,899,1528,2,4303,239,0,2,7,5,73240,29309,5868,38892,0
66,3082,1293,570,1093,25,15,163,1318,10,195,123,241,205,364,1516,2795,6,17273,959,0,2,30,23,73250,29311,5868,38893,0
28,1839,384,251,317,7,8,52,391,11,70,44,84,81,128,467,811,6,5355,297,0,2,15,67,73250,29311,5868,38894,0
47,2254,722,423,573,19,0,135,741,12,172,101,199,184,300,1320,2257,6,15668,870,0,2,4,4,73250,29313,5868,38896,0
45,1961,386,256,301,16,9,68,402,4,59,35,69,63,104,355,621,2,1453,80,0,2,13,4,73250,29313,5868,38897,0
16,1247,215,129,180,6,0,29,221,8,65,43,72,73,115,415,711,4,3153,175,0,2,1,1,73250,29313,5868,38898,0
83,3323,1043,504,840,53,9,147,1096,9,180,112,198,189,310,1377,2344,4,11604,644,0,2,31,36,73250,29315,5868,38899,0
12,478,295,56,236,0,4,54,295,2,9,5,10,11,15,30,51,1,57,3,0,2,0,59,73250,29317,5868,38900,0
29,1210,373,158,315,8,0,51,381,5,76,44,79,81,123,486,779,2,2026,112,0,2,2,20,73250,29317,5868,38901,0
77,3228,1178,367,1042,6,15,115,1184,9,94,51,95,103,146,644,976,4,4439,246,0,2,12,1,73250,29317,5868,38902,0
103,5339,1943,715,1694,26,18,214,1969,12,185,120,237,197,357,1436,2721,7,20915,1161,0,2,38,16,73250,29319,5868,38903,0
51,1747,601,196,481,2,23,85,603,8,63,36,72,71,108,400,664,4,3036,168,0,2,62,2,73250,29319,5868,38904,0
112,2133,477,336,357,30,23,73,507,16,194,134,250,210,384,1538,2962,10,30538,1696,0,2,14,0,73260,29320,5868,38905,1
123,4932,1450,624,1228,12,26,181,1462,14,306,186,354,320,540,2580,4493,8,36391,2021,1,2,24,0,73260,29322,5869,38906,1
52,1777,601,196,481,2,23,85,603,8,63,36,72,71,108,400,664,4,3036,168,0,2,24,0,73260,29322,5869,38907,0
45,940,386,256,301,16,9,68,402,4,59,35,69,63,104,355,621,2,1453,80,0,2,4,0,73260,29322,5869,38908,0
45,940,264,131,164,11,41,46,275,6,38,22,40,44,62,214,338,3,1068,59,0,2,4,0,73270,29322,5870,38909,0
45,940,386,256,301,16,9,68,402,4,59,35,69,63,104,355,621,2,1453,80,0,2,1,1,73270,29322,5870,38910,0
45,940,264,131,164,11,41,46,275,6,38,22,40,44,62,214,338,3,1068,59,0,2,1,1,73280,29322,5871,38911,0
45,940,386,256,301,16,9,68,402,4,59,35,69,63,104,355,621,2,1453,80,0,2,4,0,73280,29322,5871,38912,0
45,940,264,131,164,11,41,46,275,6,38,22,40,44,62,214,338,3,1068,59,0,2,4,0,73290,29322,5872,38913,0
52,1777,601,196,481,2,23,85,603,8,63,36,72,71,108,400,664,4,3036,168,0,2,24,0,73290,29322,5872,38914,0
52,1785,601,196,481,2,23,85,603,8,63,36,72,71,108,400,664,4,3036,168,0,2,7,21,73290,29322,5872,38915,0
52,1785,601,196,481,2,23,85,603,8,63,36,72,71,108,400,664,4,3036,168,0,2,7,21,73290,29322,5872,38916,0
94,2363,1455,414,1257,16,76,112,1471,5,41,23,46,46,69,231,381,2,1069,59,0,2,55,2,73290,29323,5872,38917,0
94,2363,669,365,481,22,61,110,691,15,103,63,122,118,185,747,1273,8,11311,628,0,2,55,2,73300,29323,5873,38918,0
71,3276,1455,414,1257,16,76,112,1471,5,41,23,46,46,69,231,381,2,1069,59,0,2,19,0,73300,29324,5873,38919,0
314,6855,72,33,56,0,4,12,72,1,1,1,1,2,2,0,2,0,1,0,0,2,142,46,73300,29324,5873,38920,1
314,6855,1454,835,1044,76,110,219,1530,17,275,158,296,292,454,2297,3718,9,34017,1889,1,2,142,46,73310,29325,5873,38921,1
68,1302,1098,241,925,5,10,155,1103,7,46,25,49,53,74,273,423,3,1580,87,0,2,45,19,73320,29327,5873,38922,1
68,1302,282,202,222,14,2,44,296,8,42,24,43,50,67,250,378,4,1548,86,0,2,45,19,73320,29328,5873,38923,1
90,3974,1338,495,1086,10,64,173,1348,11,122,82,157,133,239,883,1686,7,11934,663,0,2,0,3,73320,29330,5873,38924,1
170,7538,139,89,101,2,0,35,141,7,54,34,62,61,96,330,569,4,2287,127,0,2,39,0,73320,29330,5873,38925,1
170,7538,7,5,5,0,0,2,7,1,2,1,2,3,3,2,4,0,2,0,0,2,39,0,73320,29330,5873,38926,1
1,321,382,65,130,157,2,92,539,4,10,5,10,14,15,41,57,2,114,6,0,2,1,1,73320,29331,5874,38927,0
45,940,386,256,301,16,9,68,402,4,59,35,69,63,104,355,621,2,1453,80,0,2,4,0,73320,29331,5874,38928,0
45,940,264,131,164,11,41,46,275,6,38,22,40,44,62,214,338,3,1068,59,0,2,4,0,73330,29331,5875,38929,0
52,1777,601,196,481,2,23,85,603,8,63,36,72,71,108,400,664,4,3036,168,0,2,24,0,73330,29331,5875,38930,0
112,2133,477,336,357,30,23,73,507,16,194,134,250,210,384,1538,2962,10,30538,1696,0,2,14,0,73340,29332,5875,38931,0
123,4932,1450,624,1228,12,26,181,1462,14,306,186,354,320,540,2580,4493,8,36391,2021,1,2,24,0,73340,29334,5876,38932,0
94,2363,1455,414,1257,16,76,112,1471,5,41,23,46,46,69,231,381,2,1069,59,0,2,55,2,73340,29335,5876,38933,0
94,2363,669,365,481,22,61,110,691,15,103,63,122,118,185,747,1273,8,11311,628,0,2,55,2,73350,29335,5877,38934,0
71,3276,1455,414,1257,16,76,112,1471,5,41,23,46,46,69,231,381,2,1069,59,0,2,19,0,73350,29336,5877,38935,0
172,5098,1660,832,1314,41,38,274,1701,20,312,209,395,332,604,2671,5058,12,64042,3557,1,2,21,0,73350,29338,5878,38937,0
185,5602,1660,832,1314,41,38,274,1701,20,312,209,395,332,604,2671,5058,12,64042,3557,1,2,7,1,73350,29340,5879,38939,0
185,5602,1057,646,719,113,100,145,1170,18,215,134,248,233,382,1740,3004,10,31186,1732,1,2,7,1,73360,29341,5880,38940,0
185,5602,1660,832,1314,41,38,274,1701,20,312,209,395,332,604,2671,5058,12,64042,3557,1,2,7,1,73360,29343,5881,38942,0
185,5602,1057,646,719,113,100,145,1170,18,215,134,248,233,382,1740,3004,10,31186,1732,1,2,7,1,73370,29344,5882,38943,0
172,5098,1660,832,1314,41,38,274,1701,20,312,209,395,332,604,2671,5058,12,64042,3557,1,2,21,0,73370,29346,5883,38945,0
1,323,382,65,130,157,2,92,539,4,10,5,10,14,15,41,57,2,114,6,0,2,2,1,73370,29347,5884,38946,0
231,4977,182,127,129,0,0,53,182,5,39,21,42,44,63,217,343,2,926,51,0,2,0,5,73370,29347,5885,38947,1
231,4977,1165,710,800,67,119,181,1232,18,243,153,282,261,435,2000,3492,10,36473,2026,1,2,0,5,73380,29347,5886,38948,1
182,5535,1660,832,1314,41,38,274,1701,20,312,209,395,332,604,2671,5058,12,64042,3557,1,2,0,13,73380,29349,5887,38950,1
182,5535,1057,646,719,113,100,145,1170,18,215,134,248,233,382,1740,3004,10,31186,1732,1,2,0,13,73390,29350,5888,38951,1
245,5664,4293,999,3693,19,54,507,4312,9,155,88,170,164,258,1156,1898,4,9368,520,0,2,0,6,73390,29352,5888,38952,1
245,5664,1482,859,1002,125,135,219,1607,16,219,134,251,235,385,1766,3032,9,27804,1544,1,2,0,6,73400,29353,5888,38953,1
99,2671,1523,757,1297,19,12,193,1542,12,193,117,230,205,347,1508,2664,7,19053,1058,0,2,7,10,73410,29355,5888,38954,1
99,2671,701,378,504,33,58,109,734,13,110,68,126,123,194,794,1346,7,10027,557,0,2,7,10,73410,29356,5889,38955,1
290,6477,72,33,56,0,4,12,72,1,1,1,1,2,2,0,2,0,1,0,0,2,0,5,73410,29356,5889,38956,1
290,6477,1454,835,1044,76,110,219,1530,17,275,158,296,292,454,2297,3718,9,34017,1889,1,2,0,5,73420,29357,5889,38957,1
27,665,466,257,367,18,25,50,484,7,126,86,171,133,257,898,1813,4,8612,478,0,2,0,10,73420,29357,5889,38958,1
27,665,507,281,342,29,59,88,536,10,53,29,57,63,86,336,514,5,2764,153,0,2,0,10,73420,29357,5889,38959,1
25,546,215,129,180,6,0,29,221,8,65,43,72,73,115,415,711,4,3153,175,0,2,0,24,73420,29357,5889,38960,1
25,546,97,69,77,3,3,16,100,6,22,13,23,28,36,113,173,3,542,30,0,2,0,24,73420,29358,5889,38961,1
231,4941,1943,715,1694,26,18,214,1969,12,185,120,237,197,357,1436,2721,7,20915,1161,0,2,0,9,73420,29360,5889,38962,1
231,4941,1168,838,957,57,25,144,1225,19,348,224,416,367,640,3018,5452,11,61921,3440,1,2,0,9,73430,29362,5889,38963,1
125,5588,1782,648,1425,9,47,279,1791,8,171,97,189,179,286,1292,2140,4,9462,525,0,2,0,1,73430,29363,5890,38964,1
15,1066,215,129,180,6,0,29,221,8,65,43,72,73,115,415,711,4,3153,175,0,2,0,29,73430,29363,5890,38965,1
83,3318,1043,504,840,53,9,147,1096,9,180,112,198,189,310,1377,2344,4,11604,644,0,2,1,6,73430,29365,5890,38966,1
29,1210,373,158,315,8,0,51,381,5,76,44,79,81,123,486,779,2,2026,112,0,2,0,1,73430,29365,5890,38967,1
101,5272,1943,715,1694,26,18,214,1969,12,185,120,237,197,357,1436,2721,7,20915,1161,0,2,0,11,73430,29367,5890,38968,1
92,1891,757,253,292,73,244,162,830,13,61,38,67,74,105,409,651,7,4654,258,0,2,2,2,73430,29368,5890,38969,0
231,4977,182,127,129,0,0,53,182,5,39,21,42,44,63,217,343,2,926,51,0,2,0,5,73430,29368,5891,38970,0
231,4977,1165,710,800,67,119,181,1232,18,243,153,282,261,435,2000,3492,10,36473,2026,1,2,0,5,73440,29368,5892,38971,0
182,5535,1660,832,1314,41,38,274,1701,20,312,209,395,332,604,2671,5058,12,64042,3557,1,2,0,13,73440,29370,5893,38973,0
182,5535,1057,646,719,113,100,145,1170,18,215,134,248,233,382,1740,3004,10,31186,1732,1,2,0,13,73450,29371,5894,38974,0
245,5664,4293,999,3693,19,54,507,4312,9,155,88,170,164,258,1156,1898,4,9368,520,0,2,0,6,73450,29373,5894,38975,0
245,5664,1482,859,1002,125,135,219,1607,16,219,134,251,235,385,1766,3032,9,27804,1544,1,2,0,6,73460,29374,5894,38976,0
99,2671,1523,757,1297,19,12,193,1542,12,193,117,230,205,347,1508,2664,7,19053,1058,0,2,7,10,73470,29376,5894,38977,0
99,2671,701,378,504,33,58,109,734,13,110,68,126,123,194,794,1346,7,10027,557,0,2,7,10,73470,29377,5895,38978,0
290,6477,72,33,56,0,4,12,72,1,1,1,1,2,2,0,2,0,1,0,0,2,0,5,73470,29377,5895,38979,0
290,6477,1454,835,1044,76,110,219,1530,17,275,158,296,292,454,2297,3718,9,34017,1889,1,2,0,5,73480,29378,5895,38980,0
27,665,466,257,367,18,25,50,484,7,126,86,171,133,257,898,1813,4,8612,478,0,2,0,10,73480,29378,5895,38981,0
27,665,507,281,342,29,59,88,536,10,53,29,57,63,86,336,514,5,2764,153,0,2,0,10,73480,29378,5895,38982,0
25,546,215,129,180,6,0,29,221,8,65,43,72,73,115,415,711,4,3153,175,0,2,0,24,73480,29378,5895,38983,0
25,546,97,69,77,3,3,16,100,6,22,13,23,28,36,113,173,3,542,30,0,2,0,24,73480,29379,5895,38984,0
231,4941,1943,715,1694,26,18,214,1969,12,185,120,237,197,357,1436,2721,7,20915,1161,0,2,0,9,73480,29381,5895,38985,0
231,4941,1168,838,957,57,25,144,1225,19,348,224,416,367,640,3018,5452,11,61921,3440,1,2,0,9,73490,29383,5895,38986,0
125,5588,1782,648,1425,9,47,279,1791,8,171,97,189,179,286,1292,2140,4,9462,525,0,2,0,1,73490,29384,5896,38987,0
15,1066,215,129,180,6,0,29,221,8,65,43,72,73,115,415,711,4,3153,175,0,2,0,29,73490,29384,5896,38988,0
83,3318,1043,504,840,53,9,147,1096,9,180,112,198,189,310,1377,2344,4,11604,644,0,2,1,6,73490,29386,5896,38989,0
29,1210,373,158,315,8,0,51,381,5,76,44,79,81,123,486,779,2,2026,112,0,2,0,1,73490,29386,5896,38990,0
101,5272,1943,715,1694,26,18,214,1969,12,185,120,237,197,357,1436,2721,7,20915,1161,0,2,0,11,73490,29388,5896,38991,0
92,1891,757,253,292,73,244,162,830,13,61,38,67,74,105,409,651,7,4654,258,0,2,2,2,73490,29389,5896,38992,0
1,323,382,65,130,157,2,92,539,4,10,5,10,14,15,41,57,2,114,6,0,2,2,1,73490,29390,5897,38993,0
183,5544,1660,832,1314,41,38,274,1701,20,312,209,395,332,604,2671,5058,12,64042,3557,1,2,7,1,73490,29392,5898,38995,0
183,5544,1057,646,719,113,100,145,1170,18,215,134,248,233,382,1740,3004,10,31186,1732,1,2,7,1,73500,29393,5899,38996,0
112,2133,477,336,357,30,23,73,507,16,194,134,250,210,384,1538,2962,10,30538,1696,0,2,14,0,73510,29394,5899,38997,0
94,2363,1455,414,1257,16,76,112,1471,5,41,23,46,46,69,231,381,2,1069,59,0,2,55,2,73510,29395,5899,38998,0
94,2363,669,365,481,22,61,110,691,15,103,63,122,118,185,747,1273,8,11311,628,0,2,55,2,73520,29395,5900,38999,0
92,1891,757,253,292,73,244,162,830,13,61,38,67,74,105,409,651,7,4654,258,0,2,2,2,73520,29396,5900,39000,0
123,4932,1450,624,1228,12,26,181,1462,14,306,186,354,320,540,2580,4493,8,36391,2021,1,2,24,0,73520,29398,5901,39001,0
172,5098,1660,832,1314,41,38,274,1701,20,312,209,395,332,604,2671,5058,12,64042,3557,1,2,21,0,73520,29400,5902,39003,0
71,3276,1455,414,1257,16,76,112,1471,5,41,23,46,46,69,231,381,2,1069,59,0,2,19,0,73520,29401,5902,39004,0
52,1785,601,196,481,2,23,85,603,8,63,36,72,71,108,400,664,4,3036,168,0,2,7,21,73520,29401,5902,39005,0
1,323,382,65,130,157,2,92,539,4,10,5,10,14,15,41,57,2,114,6,0,2,2,1,73520,29402,5903,39006,0
183,5544,1660,832,1314,41,38,274,1701,20,312,209,395,332,604,2671,5058,12,64042,3557,1,2,7,1,73520,29404,5904,39008,0
183,5544,1057,646,719,113,100,145,1170,18,215,134,248,233,382,1740,3004,10,31186,1732,1,2,7,1,73530,29405,5905,39009,0
112,2133,477,336,357,30,23,73,507,16,194,134,250,210,384,1538,2962,10,30538,1696,0,2,14,0,73540,29406,5905,39010,0
94,2363,1455,414,1257,16,76,112,1471,5,41,23,46,46,69,231,381,2,1069,59,0,2,55,2,73540,29407,5905,39011,0
94,2363,669,365,481,22,61,110,691,15,103,63,122,118,185,747,1273,8,11311,628,0,2,55,2,73550,29407,5906,39012,0
92,1891,757,253,292,73,244,162,830,13,61,38,67,74,105,409,651,7,4654,258,0,2,2,2,73550,29408,5906,39013,0
123,4932,1450,624,1228,12,26,181,1462,14,306,186,354,320,540,2580,4493,8,36391,2021,1,2,24,0,73550,29410,5907,39014,0
172,5098,1660,832,1314,41,38,274,1701,20,312,209,395,332,604,2671,5058,12,64042,3557,1,2,21,0,73550,29412,5908,39016,0
71,3276,1455,414,1257,16,76,112,1471,5,41,23,46,46,69,231,381,2,1069,59,0,2,19,0,73550,29413,5908,39017,0
52,1785,601,196,481,2,23,85,603,8,63,36,72,71,108,400,664,4,3036,168,0,2,7,21,73550,29413,5908,39018,0
98,2641,1523,757,1297,19,12,193,1542,12,193,117,230,205,347,1508,2664,7,19053,1058,0,2,3,9,73560,29415,5908,39019,0
98,2641,701,378,504,33,58,109,734,13,110,68,126,123,194,794,1346,7,10027,557,0,2,3,9,73560,29416,5909,39020,0
99,4689,1523,757,1297,19,12,193,1542,12,193,117,230,205,347,1508,2664,7,19053,1058,0,2,31,95,73570,29418,5909,39021,0
98,2660,1523,757,1297,19,12,193,1542,12,193,117,230,205,347,1508,2664,7,19053,1058,0,2,4,0,73580,29420,5909,39022,0
98,2660,701,378,504,33,58,109,734,13,110,68,126,123,194,794,1346,7,10027,557,0,2,4,0,73580,29421,5910,39023,0
106,2921,1523,757,1297,19,12,193,1542,12,193,117,230,205,347,1508,2664,7,19053,1058,0,2,54,10,73590,29423,5910,39024,0
106,2921,701,378,504,33,58,109,734,13,110,68,126,123,194,794,1346,7,10027,557,0,2,54,10,73590,29424,5911,39025,0
106,2923,1523,757,1297,19,12,193,1542,12,193,117,230,205,347,1508,2664,7,19053,1058,0,2,17,9,73600,29426,5911,39026,0
106,2923,701,378,504,33,58,109,734,13,110,68,126,123,194,794,1346,7,10027,557,0,2,17,9,73600,29427,5912,39027,0
106,2923,1523,757,1297,19,12,193,1542,12,193,117,230,205,347,1508,2664,7,19053,1058,0,2,1,1,73610,29429,5912,39028,0
106,2923,701,378,504,33,58,109,734,13,110,68,126,123,194,794,1346,7,10027,557,0,2,1,1,73610,29430,5913,39029,0
107,2933,1523,757,1297,19,12,193,1542,12,193,117,230,205,347,1508,2664,7,19053,1058,0,2,26,19,73620,29432,5913,39030,0
107,2933,701,378,504,33,58,109,734,13,110,68,126,123,194,794,1346,7,10027,557,0,2,26,19,73620,29433,5914,39031,0
100,4747,1523,757,1297,19,12,193,1542,12,193,117,230,205,347,1508,2664,7,19053,1058,0,2,38,0,73630,29435,5914,39032,0
107,2933,1523,757,1297,19,12,193,1542,12,193,117,230,205,347,1508,2664,7,19053,1058,0,2,2,3,73640,29437,5914,39033,0
107,2933,701,378,504,33,58,109,734,13,110,68,126,123,194,794,1346,7,10027,557,0,2,2,3,73640,29438,5915,39034,0
108,2938,1523,757,1297,19,12,193,1542,12,193,117,230,205,347,1508,2664,7,19053,1058,0,2,1,1,73650,29440,5915,39035,0
108,2938,701,378,504,33,58,109,734,13,110,68,126,123,194,794,1346,7,10027,557,0,2,1,1,73650,29441,5916,39036,0
54,1145,447,308,343,6,5,95,453,7,96,59,111,103,170,651,1136,4,4600,255,0,2,7,1,73650,29444,5916,39037,0
54,1145,322,174,179,16,74,51,338,10,41,26,46,51,72,252,408,5,2291,127,0,2,7,1,73650,29447,5917,39038,0
45,2037,447,308,343,6,5,95,453,7,96,59,111,103,170,651,1136,4,4600,255,0,2,27,0,73650,29450,5917,39039,0
19,713,442,244,305,14,16,103,456,11,68,45,75,79,120,452,756,6,4588,254,0,2,1,1,73650,29452,5917,39040,0
19,713,182,102,99,11,40,35,193,3,11,6,11,14,17,42,64,1,97,5,0,2,1,1,73650,29453,5917,39041,0
36,1510,442,244,305,14,16,103,456,11,68,45,75,79,120,452,756,6,4588,254,0,2,16,0,73650,29455,5917,39042,0
22,373,102,57,55,5,16,25,107,5,17,10,18,22,28,81,124,2,330,18,0,2,5,4,73650,29455,5917,39043,0
1,14,6,4,4,0,0,2,6,0,0,0,0,0,0,0,0,0,0,0,0,0,6,0,73660,29456,5917,39056,0
69,3105,1020,354,843,12,15,144,1032,8,134,77,144,142,221,970,1580,4,6792,377,0,2,7,0,73660,29456,5917,39057,0
22,373,102,57,55,5,16,25,107,5,17,10,18,22,28,81,124,2,330,18,0,2,5,4,73660,29456,5917,39058,0
1,14,6,4,4,0,0,2,6,0,0,0,0,0,0,0,0,0,0,0,0,0,6,0,73670,29457,5917,39071,0
69,3105,1020,354,843,12,15,144,1032,8,134,77,144,142,221,970,1580,4,6792,377,0,2,7,0,73670,29457,5917,39072,0
19,713,442,244,305,14,16,103,456,11,68,45,75,79,120,452,756,6,4588,254,0,2,1,1,73670,29459,5917,39073,0
19,713,182,102,99,11,40,35,193,3,11,6,11,14,17,42,64,1,97,5,0,2,1,1,73670,29460,5917,39074,0
36,1510,442,244,305,14,16,103,456,11,68,45,75,79,120,452,756,6,4588,254,0,2,16,0,73670,29462,5917,39075,0
42,1241,339,213,244,17,9,65,356,10,42,26,48,52,74,259,421,5,2410,133,0,2,7,3,73680,29462,5917,39076,1
21,541,205,80,86,16,53,53,221,7,18,10,19,25,29,94,134,3,497,27,0,2,3,3,73690,29462,5918,39077,1
65,3082,1293,570,1093,25,15,163,1318,10,195,123,241,205,364,1516,2795,6,17273,959,0,2,71,55,73700,29464,5918,39078,1
67,1570,773,419,590,28,0,166,801,10,204,113,217,214,330,1598,2554,5,13587,754,0,2,1,3,73700,29464,5919,39079,0
67,1570,421,273,302,44,34,57,465,17,81,59,107,98,166,583,1098,11,12329,684,0,2,1,3,73700,29464,5920,39080,0
185,5602,1660,832,1314,41,38,274,1701,20,312,209,395,332,604,2671,5058,12,64042,3557,1,2,1,1,73700,29466,5921,39082,0
185,5602,1057,646,719,113,100,145,1170,18,215,134,248,233,382,1740,3004,10,31186,1732,1,2,1,1,73710,29467,5922,39083,0
90,3983,1338,495,1086,10,64,173,1348,11,122,82,157,133,239,883,1686,7,11934,663,0,2,2,2,73710,29469,5922,39084,0
124,4939,1450,624,1228,12,26,181,1462,14,306,186,354,320,540,2580,4493,8,36391,2021,1,2,6,4,73710,29471,5923,39085,0
67,1570,773,419,590,28,0,166,801,10,204,113,217,214,330,1598,2554,5,13587,754,0,2,1,3,73710,29471,5924,39086,0
67,1570,421,273,302,44,34,57,465,17,81,59,107,98,166,583,1098,11,12329,684,0,2,1,3,73710,29471,5925,39087,0
185,5602,1660,832,1314,41,38,274,1701,20,312,209,395,332,604,2671,5058,12,64042,3557,1,2,1,1,73710,29473,5926,39089,0
185,5602,1057,646,719,113,100,145,1170,18,215,134,248,233,382,1740,3004,10,31186,1732,1,2,1,1,73720,29474,5927,39090,0
90,3983,1338,495,1086,10,64,173,1348,11,122,82,157,133,239,883,1686,7,11934,663,0,2,2,2,73720,29476,5927,39091,0
124,4939,1450,624,1228,12,26,181,1462,14,306,186,354,320,540,2580,4493,8,36391,2021,1,2,6,4,73720,29478,5928,39092,0
14,429,149,95,105,2,0,41,151,8,54,28,55,62,83,334,494,4,2013,111,0,0,71,0,73730,29482,5929,39100,1
14,429,82,56,54,0,13,15,82,4,13,8,16,17,24,56,98,2,241,13,0,0,71,0,73740,29482,5929,39101,1
16,436,149,95,105,2,0,41,151,8,54,28,55,62,83,334,494,4,2013,111,0,0,75,0,73740,29482,5929,39102,1
12,387,149,95,105,2,0,41,151,8,54,28,55,62,83,334,494,4,2013,111,0,2,28,27,73740,29482,5929,39103,1
12,387,82,56,54,0,13,15,82,4,13,8,16,17,24,56,98,2,241,13,0,2,28,27,73750,29482,5929,39104,1
12,318,149,95,105,2,0,41,151,8,54,28,55,62,83,334,494,4,2013,111,0,2,63,72,73750,29482,5929,39105,1
231,4979,182,127,129,0,0,53,182,5,39,21,42,44,63,217,343,2,926,51,0,2,4,3,73750,29482,5930,39106,1
231,4979,1165,710,800,67,119,181,1232,18,243,153,282,261,435,2000,3492,10,36473,2026,1,2,4,3,73760,29482,5931,39107,1
185,5602,1660,832,1314,41,38,274,1701,20,312,209,395,332,604,2671,5058,12,64042,3557,1,2,5,4,73760,29484,5932,39109,1
185,5602,1057,646,719,113,100,145,1170,18,215,134,248,233,382,1740,3004,10,31186,1732,1,2,5,4,73770,29485,5933,39110,1
112,2103,477,336,357,30,23,73,507,16,194,134,250,210,384,1538,2962,10,30538,1696,0,2,9,11,73780,29486,5933,39111,1
73,1518,207,111,150,11,0,50,218,5,26,19,36,31,55,133,272,3,943,52,0,2,2,1,73780,29486,5933,39112,1
73,1518,410,198,237,31,55,97,441,11,63,38,72,74,110,414,683,6,4293,238,0,2,2,1,73790,29487,5934,39113,1
245,5869,722,423,573,19,0,135,741,12,172,101,199,184,300,1320,2257,6,15668,870,0,2,2,3,73790,29489,5934,39115,1
245,5869,1508,847,911,44,250,301,1552,14,148,88,169,162,257,1120,1886,7,15077,837,0,2,2,3,73790,29490,5935,39116,1
231,4979,182,127,129,0,0,53,182,5,39,21,42,44,63,217,343,2,926,51,0,2,4,3,73790,29490,5936,39117,0
231,4979,1165,710,800,67,119,181,1232,18,243,153,282,261,435,2000,3492,10,36473,2026,1,2,4,3,73800,29490,5937,39118,0
12,387,149,95,105,2,0,41,151,8,54,28,55,62,83,334,494,4,2013,111,0,0,72,0,73810,29494,5938,39126,0
12,387,82,56,54,0,13,15,82,4,13,8,16,17,24,56,98,2,241,13,0,0,72,0,73820,29494,5938,39127,0
185,5602,1660,832,1314,41,38,274,1701,20,312,209,395,332,604,2671,5058,12,64042,3557,1,2,5,4,73820,29496,5939,39129,0
185,5602,1057,646,719,113,100,145,1170,18,215,134,248,233,382,1740,3004,10,31186,1732,1,2,5,4,73830,29497,5940,39130,0
112,2103,477,336,357,30,23,73,507,16,194,134,250,210,384,1538,2962,10,30538,1696,0,2,9,11,73840,29498,5940,39131,0
73,1518,207,111,150,11,0,50,218,5,26,19,36,31,55,133,272,3,943,52,0,2,2,1,73840,29498,5940,39132,0
73,1518,410,198,237,31,55,97,441,11,63,38,72,74,110,414,683,6,4293,238,0,2,2,1,73850,29499,5941,39133,0
245,5869,722,423,573,19,0,135,741,12,172,101,199,184,300,1320,2257,6,15668,870,0,2,2,3,73850,29501,5941,39135,0
245,5869,1508,847,911,44,250,301,1552,14,148,88,169,162,257,1120,1886,7,15077,837,0,2,2,3,73850,29502,5942,39136,0
12,318,149,95,105,2,0,41,151,8,54,28,55,62,83,334,494,4,2013,111,0,0,66,0,73850,29502,5942,39137,0
232,4964,1943,715,1694,26,18,214,1969,12,185,120,237,197,357,1436,2721,7,20915,1161,0,2,3,0,73850,29504,5942,39138,0
232,4964,1168,838,957,57,25,144,1225,19,348,224,416,367,640,3018,5452,11,61921,3440,1,2,3,0,73860,29506,5942,39139,0
7,296,72,33,56,0,4,12,72,1,1,1,1,2,2,0,2,0,1,0,0,2,5,5,73860,29506,5942,39140,1
245,5671,4293,999,3693,19,54,507,4312,9,155,88,170,164,258,1156,1898,4,9368,520,0,2,1,1,73860,29508,5942,39141,1
245,5671,1482,859,1002,125,135,219,1607,16,219,134,251,235,385,1766,3032,9,27804,1544,1,2,1,1,73870,29509,5942,39142,1
245,5880,722,423,573,19,0,135,741,12,172,101,199,184,300,1320,2257,6,15668,870,0,2,5,7,73870,29511,5942,39144,1
245,5880,1508,847,911,44,250,301,1552,14,148,88,169,162,257,1120,1886,7,15077,837,0,2,5,7,73870,29512,5943,39145,1
291,6502,72,33,56,0,4,12,72,1,1,1,1,2,2,0,2,0,1,0,0,2,1,1,73870,29512,5943,39146,1
291,6502,1454,835,1044,76,110,219,1530,17,275,158,296,292,454,2297,3718,9,34017,1889,1,2,1,1,73880,29513,5943,39147,1
124,5347,1513,682,1277,25,13,200,1538,11,199,116,219,210,335,1557,2584,6,15641,868,0,2,12,10,73880,29515,5943,39148,1
39,2363,334,251,279,10,4,40,344,5,127,74,143,132,217,899,1528,2,4303,239,0,2,2,1,73880,29516,5943,39149,1
7,296,72,33,56,0,4,12,72,1,1,1,1,2,2,0,2,0,1,0,0,2,5,5,73880,29516,5943,39150,0
245,5671,4293,999,3693,19,54,507,4312,9,155,88,170,164,258,1156,1898,4,9368,520,0,2,1,1,73880,29518,5943,39151,0
245,5671,1482,859,1002,125,135,219,1607,16,219,134,251,235,385,1766,3032,9,27804,1544,1,2,1,1,73890,29519,5943,39152,0
245,5880,722,423,573,19,0,135,741,12,172,101,199,184,300,1320,2257,6,15668,870,0,2,5,7,73890,29521,5943,39154,0
245,5880,1508,847,911,44,250,301,1552,14,148,88,169,162,257,1120,1886,7,15077,837,0,2,5,7,73890,29522,5944,39155,0
291,6502,72,33,56,0,4,12,72,1,1,1,1,2,2,0,2,0,1,0,0,2,1,1,73890,29522,5944,39156,0
291,6502,1454,835,1044,76,110,219,1530,17,275,158,296,292,454,2297,3718,9,34017,1889,1,2,1,1,73900,29523,5944,39157,0
124,5347,1513,682,1277,25,13,200,1538,11,199,116,219,210,335,1557,2584,6,15641,868,0,2,12,10,73900,29525,5944,39158,0
39,2363,334,251,279,10,4,40,344,5,127,74,143,132,217,899,1528,2,4303,239,0,2,2,1,73900,29526,5944,39159,0
123,5301,1513,682,1277,25,13,200,1538,11,199,116,219,210,335,1557,2584,6,15641,868,0,2,0,9,73900,29528,5944,39160,0
123,5301,1513,682,1277,25,13,200,1538,11,199,116,219,210,335,1557,2584,6,15641,868,0,2,0,9,73900,29530,5944,39161,0
235,4993,1943,715,1694,26,18,214,1969,12,185,120,237,197,357,1436,2721,7,20915,1161,0,2,21,21,73900,29532,5944,39162,0
235,4993,1168,838,957,57,25,144,1225,19,348,224,416,367,640,3018,5452,11,61921,3440,1,2,21,21,73910,29534,5944,39163,0
3,49,16,9,9,0,0,7,16,0,0,0,0,0,0,0,0,0,0,0,0,0,16,0,73910,29534,5944,39164,0
53,1862,601,196,481,2,23,85,603,8,63,36,72,71,108,400,664,4,3036,168,0,2,19,0,73910,29534,5944,39165,0
313,6832,72,33,56,0,4,12,72,1,1,1,1,2,2,0,2,0,1,0,0,2,142,46,73910,29534,5944,39166,0
313,6832,1454,835,1044,76,110,219,1530,17,275,158,296,292,454,2297,3718,9,34017,1889,1,2,142,46,73920,29535,5944,39167,0
68,1302,1098,241,925,5,10,155,1103,7,46,25,49,53,74,273,423,3,1580,87,0,2,45,19,73930,29537,5944,39168,0
68,1302,282,202,222,14,2,44,296,8,42,24,43,50,67,250,378,4,1548,86,0,2,45,19,73930,29538,5944,39169,0
90,3974,1338,495,1086,10,64,173,1348,11,122,82,157,133,239,883,1686,7,11934,663,0,2,0,3,73930,29540,5944,39170,0
170,7538,139,89,101,2,0,35,141,7,54,34,62,61,96,330,569,4,2287,127,0,2,39,0,73930,29540,5944,39171,0
170,7538,7,5,5,0,0,2,7,1,2,1,2,3,3,2,4,0,2,0,0,2,39,0,73930,29540,5944,39172,0
232,4966,1943,715,1694,26,18,214,1969,12,185,120,237,197,357,1436,2721,7,20915,1161,0,2,1,1,73930,29542,5944,39173,0
232,4966,1168,838,957,57,25,144,1225,19,348,224,416,367,640,3018,5452,11,61921,3440,1,2,1,1,73940,29544,5944,39174,0
47,3455,996,429,845,24,10,117,1020,7,76,50,88,83,138,494,879,4,3565,198,0,2,1,1,73940,29546,5944,39175,0
101,5272,1943,715,1694,26,18,214,1969,12,185,120,237,197,357,1436,2721,7,20915,1161,0,2,2,2,73940,29548,5944,39176,0
99,2681,1523,757,1297,19,12,193,1542,12,193,117,230,205,347,1508,2664,7,19053,1058,0,2,1,1,73950,29550,5944,39177,1
99,2681,701,378,504,33,58,109,734,13,110,68,126,123,194,794,1346,7,10027,557,0,2,1,1,73950,29551,5945,39178,1
28,713,466,257,367,18,25,50,484,7,126,86,171,133,257,898,1813,4,8612,478,0,2,4,0,73950,29551,5945,39179,1
28,713,507,281,342,29,59,88,536,10,53,29,57,63,86,336,514,5,2764,153,0,2,4,0,73950,29551,5945,39180,1
71,1445,1178,367,1042,6,15,115,1184,9,94,51,95,103,146,644,976,4,4439,246,0,2,26,25,73950,29551,5945,39181,1
71,1445,177,108,140,8,0,27,185,6,30,16,32,36,48,162,248,3,794,44,0,2,26,25,73950,29553,5945,39182,1
237,5000,1943,715,1694,26,18,214,1969,12,185,120,237,197,357,1436,2721,7,20915,1161,0,2,5,3,73950,29555,5945,39183,1
237,5000,1168,838,957,57,25,144,1225,19,348,224,416,367,640,3018,5452,11,61921,3440,1,2,5,3,73960,29557,5945,39184,1
99,4102,1289,550,1043,56,32,155,1345,10,167,93,185,177,278,1266,2075,5,11498,638,0,2,2,2,73960,29559,5946,39185,1
77,3228,1178,367,1042,6,15,115,1184,9,94,51,95,103,146,644,976,4,4439,246,0,2,1,1,73960,29559,5946,39186,1
103,5339,1943,715,1694,26,18,214,1969,12,185,120,237,197,357,1436,2721,7,20915,1161,0,2,1,1,73960,29561,5946,39187,1
245,5864,722,423,573,19,0,135,741,12,172,101,199,184,300,1320,2257,6,15668,870,0,2,5,8,73960,29563,5946,39189,0
245,5864,1508,847,911,44,250,301,1552,14,148,88,169,162,257,1120,1886,7,15077,837,0,2,5,8,73960,29564,5947,39190,0
71,1439,1178,367,1042,6,15,115,1184,9,94,51,95,103,146,644,976,4,4439,246,0,2,5,2,73960,29564,5947,39191,0
71,1439,177,108,140,8,0,27,185,6,30,16,32,36,48,162,248,3,794,44,0,2,5,2,73960,29566,5947,39192,0
77,3233,1178,367,1042,6,15,115,1184,9,94,51,95,103,146,644,976,4,4439,246,0,2,1,0,73960,29566,5947,39193,0
99,2681,1523,757,1297,19,12,193,1542,12,193,117,230,205,347,1508,2664,7,19053,1058,0,2,1,1,73970,29568,5947,39194,0
99,2681,701,378,504,33,58,109,734,13,110,68,126,123,194,794,1346,7,10027,557,0,2,1,1,73970,29569,5948,39195,0
245,5864,722,423,573,19,0,135,741,12,172,101,199,184,300,1320,2257,6,15668,870,0,2,5,8,73970,29571,5948,39197,0
245,5864,1508,847,911,44,250,301,1552,14,148,88,169,162,257,1120,1886,7,15077,837,0,2,5,8,73970,29572,5949,39198,0
28,713,466,257,367,18,25,50,484,7,126,86,171,133,257,898,1813,4,8612,478,0,2,4,0,73970,29572,5949,39199,0
28,713,507,281,342,29,59,88,536,10,53,29,57,63,86,336,514,5,2764,153,0,2,4,0,73970,29572,5949,39200,0
71,1439,1178,367,1042,6,15,115,1184,9,94,51,95,103,146,644,976,4,4439,246,0,2,31,27,73970,29572,5949,39201,0
71,1439,177,108,140,8,0,27,185,6,30,16,32,36,48,162,248,3,794,44,0,2,31,27,73970,29574,5949,39202,0
237,5000,1943,715,1694,26,18,214,1969,12,185,120,237,197,357,1436,2721,7,20915,1161,0,2,5,3,73970,29576,5949,39203,0
237,5000,1168,838,957,57,25,144,1225,19,348,224,416,367,640,3018,5452,11,61921,3440,1,2,5,3,73980,29578,5949,39204,0
99,4102,1289,550,1043,56,32,155,1345,10,167,93,185,177,278,1266,2075,5,11498,638,0,2,2,2,73980,29580,5950,39205,0
77,3233,1178,367,1042,6,15,115,1184,9,94,51,95,103,146,644,976,4,4439,246,0,2,2,1,73980,29580,5950,39206,0
103,5339,1943,715,1694,26,18,214,1969,12,185,120,237,197,357,1436,2721,7,20915,1161,0,2,1,1,73980,29582,5950,39207,0
238,5016,1943,715,1694,26,18,214,1969,12,185,120,237,197,357,1436,2721,7,20915,1161,0,2,21,21,73980,29584,5950,39208,0
238,5016,1168,838,957,57,25,144,1225,19,348,224,416,367,640,3018,5452,11,61921,3440,1,2,21,21,73990,29586,5950,39209,0
3,49,16,9,9,0,0,7,16,0,0,0,0,0,0,0,0,0,0,0,0,0,16,0,73990,29586,5950,39210,0
53,1862,601,196,481,2,23,85,603,8,63,36,72,71,108,400,664,4,3036,168,0,2,19,0,73990,29586,5950,39211,0
232,4966,1943,715,1694,26,18,214,1969,12,185,120,237,197,357,1436,2721,7,20915,1161,0,2,3,0,73990,29588,5950,39212,0
232,4966,1168,838,957,57,25,144,1225,19,348,224,416,367,640,3018,5452,11,61921,3440,1,2,3,0,74000,29590,5950,39213,0
47,3455,996,429,845,24,10,117,1020,7,76,50,88,83,138,494,879,4,3565,198,0,2,1,1,74000,29592,5950,39214,0
101,5272,1943,715,1694,26,18,214,1969,12,185,120,237,197,357,1436,2721,7,20915,1161,0,2,2,2,74000,29594,5950,39215,0
108,2938,1523,757,1297,19,12,193,1542,12,193,117,230,205,347,1508,2664,7,19053,1058,0,2,66,10,74010,29596,5950,39216,0
108,2938,701,378,504,33,58,109,734,13,110,68,126,123,194,794,1346,7,10027,557,0,2,66,10,74010,29597,5951,39217,0
100,4747,1523,757,1297,19,12,193,1542,12,193,117,230,205,347,1508,2664,7,19053,1058,0,2,69,95,74020,29599,5951,39218,0
19,709,442,244,305,14,16,103,456,11,68,45,75,79,120,452,756,6,4588,254,0,2,2,2,74020,29601,5951,39219,0
19,709,182,102,99,11,40,35,193,3,11,6,11,14,17,42,64,1,97,5,0,2,2,2,74020,29602,5951,39220,0
36,1456,442,244,305,14,16,103,456,11,68,45,75,79,120,452,756,6,4588,254,0,2,4,0,74020,29604,5951,39221,0
19,717,442,244,305,14,16,103,456,11,68,45,75,79,120,452,756,6,4588,254,0,2,2,2,74020,29606,5951,39222,0
19,717,182,102,99,11,40,35,193,3,11,6,11,14,17,42,64,1,97,5,0,2,2,2,74020,29607,5951,39223,0
170,7538,139,89,101,2,0,35,141,7,54,34,62,61,96,330,569,4,2287,127,0,2,1,1,74020,29607,5951,39224,0
170,7538,7,5,5,0,0,2,7,1,2,1,2,3,3,2,4,0,2,0,0,2,1,1,74020,29607,5951,39225,0
93,1905,757,253,292,73,244,162,830,13,61,38,67,74,105,409,651,7,4654,258,0,2,30,0,74020,29608,5951,39226,0
33,1041,256,139,192,9,7,47,265,4,23,12,24,27,36,112,171,2,357,19,0,2,40,0,74020,29609,5951,39227,0
93,1905,757,253,292,73,244,162,830,13,61,38,67,74,105,409,651,7,4654,258,0,2,19,6,74020,29610,5951,39228,0
33,1041,256,139,192,9,7,47,265,4,23,12,24,27,36,112,171,2,357,19,0,2,0,2,74020,29611,5951,39229,0
92,1891,757,253,292,73,244,162,830,13,61,38,67,74,105,409,651,7,4654,258,0,2,0,35,74020,29612,5951,39230,0
33,1041,256,139,192,9,7,47,265,4,23,12,24,27,36,112,171,2,357,19,0,2,14,4,74020,29613,5951,39231,0
18,310,424,94,331,4,0,89,428,1,5,5,5,6,10,11,25,0,12,0,0,2,3,1,74020,29614,5951,39232,1
18,310,38,23,23,6,0,8,44,3,11,7,11,14,18,42,68,1,102,5,0,2,3,1,74020,29614,5951,39233,1
21,653,424,94,331,4,0,89,428,1,5,5,5,6,10,11,25,0,12,0,0,2,15,0,74020,29615,5951,39234,1
18,310,424,94,331,4,0,89,428,1,5,5,5,6,10,11,25,0,12,0,0,2,3,1,74020,29616,5951,39235,0
18,310,38,23,23,6,0,8,44,3,11,7,11,14,18,42,68,1,102,5,0,2,3,1,74020,29616,5951,39236,0
21,653,424,94,331,4,0,89,428,1,5,5,5,6,10,11,25,0,12,0,0,2,15,0,74020,29617,5951,39237,0
52,623,647,139,84,35,284,233,682,0,0,0,0,0,0,0,0,0,0,0,0,2,3,1,74020,29617,5951,39238,0
25,552,215,129,180,6,0,29,221,8,65,43,72,73,115,415,711,4,3153,175,0,2,3,1,74020,29617,5951,39239,0
25,552,97,69,77,3,3,16,100,6,22,13,23,28,36,113,173,3,542,30,0,2,3,1,74020,29618,5951,39240,0
232,4972,1943,715,1694,26,18,214,1969,12,185,120,237,197,357,1436,2721,7,20915,1161,0,2,1,1,74020,29620,5951,39241,0
232,4972,1168,838,957,57,25,144,1225,19,348,224,416,367,640,3018,5452,11,61921,3440,1,2,1,1,74030,29622,5951,39242,0
52,623,647,139,84,35,284,233,682,0,0,0,0,0,0,0,0,0,0,0,0,2,3,1,74030,29622,5951,39243,0
25,552,215,129,180,6,0,29,221,8,65,43,72,73,115,415,711,4,3153,175,0,2,3,1,74030,29622,5951,39244,0
25,552,97,69,77,3,3,16,100,6,22,13,23,28,36,113,173,3,542,30,0,2,3,1,74030,29623,5951,39245,0
232,4972,1943,715,1694,26,18,214,1969,12,185,120,237,197,357,1436,2721,7,20915,1161,0,2,1,1,74030,29625,5951,39246,0
232,4972,1168,838,957,57,25,144,1225,19,348,224,416,367,640,3018,5452,11,61921,3440,1,2,1,1,74040,29627,5951,39247,0
52,625,647,139,84,35,284,233,682,0,0,0,0,0,0,0,0,0,0,0,0,2,3,2,74040,29627,5951,39248,0
232,4978,1943,715,1694,26,18,214,1969,12,185,120,237,197,357,1436,2721,7,20915,1161,0,2,1,1,74040,29629,5951,39249,0
232,4978,1168,838,957,57,25,144,1225,19,348,224,416,367,640,3018,5452,11,61921,3440,1,2,1,1,74050,29631,5951,39250,0
19,720,442,244,305,14,16,103,456,11,68,45,75,79,120,452,756,6,4588,254,0,2,2,1,74050,29633,5951,39251,0
19,720,182,102,99,11,40,35,193,3,11,6,11,14,17,42,64,1,97,5,0,2,2,1,74050,29634,5951,39252,0
19,720,442,244,305,14,16,103,456,11,68,45,75,79,120,452,756,6,4588,254,0,2,4,3,74050,29636,5951,39253,0
19,720,182,102,99,11,40,35,193,3,11,6,11,14,17,42,64,1,97,5,0,2,4,3,74050,29637,5951,39254,0
170,7538,139,89,101,2,0,35,141,7,54,34,62,61,96,330,569,4,2287,127,0,2,1,1,74050,29637,5951,39255,0
170,7538,7,5,5,0,0,2,7,1,2,1,2,3,3,2,4,0,2,0,0,2,1,1,74050,29637,5951,39256,0
36,1456,442,244,305,14,16,103,456,11,68,45,75,79,120,452,756,6,4588,254,0,2,4,0,74050,29639,5951,39257,0
236,5073,1943,715,1694,26,18,214,1969,12,185,120,237,197,357,1436,2721,7,20915,1161,0,2,15,0,74050,29641,5951,39258,0
236,5073,1168,838,957,57,25,144,1225,19,348,224,416,367,640,3018,5452,11,61921,3440,1,2,15,0,74060,29643,5951,39259,0
100,4116,1289,550,1043,56,32,155,1345,10,167,93,185,177,278,1266,2075,5,11498,638,0,2,3,1,74060,29645,5952,39260,0
16,895,75,38,59,1,3,12,76,2,4,2,4,6,6,10,15,1,15,0,0,2,19,0,74060,29645,5952,39261,0
42,1241,339,213,244,17,9,65,356,10,42,26,48,52,74,259,421,5,2410,133,0,2,7,3,74070,29645,5952,39262,0
21,541,205,80,86,16,53,53,221,7,18,10,19,25,29,94,134,3,497,27,0,2,3,3,74080,29645,5953,39263,0
65,3082,1293,570,1093,25,15,163,1318,10,195,123,241,205,364,1516,2795,6,17273,959,0,2,71,55,74090,29647,5953,39264,0
7,296,72,33,56,0,4,12,72,1,1,1,1,2,2,0,2,0,1,0,0,2,5,5,74090,29647,5953,39265,0
231,4973,182,127,129,0,0,53,182,5,39,21,42,44,63,217,343,2,926,51,0,2,4,3,74090,29647,5954,39266,0
231,4973,1165,710,800,67,119,181,1232,18,243,153,282,261,435,2000,3492,10,36473,2026,1,2,4,3,74100,29647,5955,39267,0
67,1570,773,419,590,28,0,166,801,10,204,113,217,214,330,1598,2554,5,13587,754,0,2,1,3,74100,29647,5956,39268,0
67,1570,421,273,302,44,34,57,465,17,81,59,107,98,166,583,1098,11,12329,684,0,2,1,3,74100,29647,5957,39269,0
12,387,149,95,105,2,0,41,151,8,54,28,55,62,83,334,494,4,2013,111,0,0,72,0,74110,29651,5958,39277,0
12,387,82,56,54,0,13,15,82,4,13,8,16,17,24,56,98,2,241,13,0,0,72,0,74120,29651,5958,39278,0
183,5544,1660,832,1314,41,38,274,1701,20,312,209,395,332,604,2671,5058,12,64042,3557,1,2,6,5,74120,29653,5959,39280,0
183,5544,1057,646,719,113,100,145,1170,18,215,134,248,233,382,1740,3004,10,31186,1732,1,2,6,5,74130,29654,5960,39281,0
112,2103,477,336,357,30,23,73,507,16,194,134,250,210,384,1538,2962,10,30538,1696,0,2,9,11,74140,29655,5960,39282,0
73,1518,207,111,150,11,0,50,218,5,26,19,36,31,55,133,272,3,943,52,0,2,2,1,74140,29655,5960,39283,0
73,1518,410,198,237,31,55,97,441,11,63,38,72,74,110,414,683,6,4293,238,0,2,2,1,74150,29656,5961,39284,0
245,5664,4293,999,3693,19,54,507,4312,9,155,88,170,164,258,1156,1898,4,9368,520,0,2,1,1,74150,29658,5961,39285,0
245,5664,1482,859,1002,125,135,219,1607,16,219,134,251,235,385,1766,3032,9,27804,1544,1,2,1,1,74160,29659,5961,39286,0
108,2933,1523,757,1297,19,12,193,1542,12,193,117,230,205,347,1508,2664,7,19053,1058,0,2,1,1,74170,29661,5961,39287,0
108,2933,701,378,504,33,58,109,734,13,110,68,126,123,194,794,1346,7,10027,557,0,2,1,1,74170,29662,5962,39288,0
22,373,102,57,55,5,16,25,107,5,17,10,18,22,28,81,124,2,330,18,0,2,5,4,74170,29662,5962,39289,0
54,1145,447,308,343,6,5,95,453,7,96,59,111,103,170,651,1136,4,4600,255,0,2,7,1,74170,29665,5962,39290,0
54,1145,322,174,179,16,74,51,338,10,41,26,46,51,72,252,408,5,2291,127,0,2,7,1,74170,29668,5963,39291,0
18,310,424,94,331,4,0,89,428,1,5,5,5,6,10,11,25,0,12,0,0,2,3,1,74170,29669,5963,39292,0
18,310,38,23,23,6,0,8,44,3,11,7,11,14,18,42,68,1,102,5,0,2,3,1,74170,29669,5963,39293,0
245,5864,722,423,573,19,0,135,741,12,172,101,199,184,300,1320,2257,6,15668,870,0,2,12,18,74170,29671,5963,39295,0
245,5864,1508,847,911,44,250,301,1552,14,148,88,169,162,257,1120,1886,7,15077,837,0,2,12,18,74170,29672,5964,39296,0
313,6834,72,33,56,0,4,12,72,1,1,1,1,2,2,0,2,0,1,0,0,2,1,1,74170,29672,5964,39297,0
313,6834,1454,835,1044,76,110,219,1530,17,275,158,296,292,454,2297,3718,9,34017,1889,1,2,1,1,74180,29673,5964,39298,0
27,671,466,257,367,18,25,50,484,7,126,86,171,133,257,898,1813,4,8612,478,0,2,4,0,74180,29673,5964,39299,0
27,671,507,281,342,29,59,88,536,10,53,29,57,63,86,336,514,5,2764,153,0,2,4,0,74180,29673,5964,39300,0
71,1439,1178,367,1042,6,15,115,1184,9,94,51,95,103,146,644,976,4,4439,246,0,2,31,27,74180,29673,5964,39301,0
71,1439,177,108,140,8,0,27,185,6,30,16,32,36,48,162,248,3,794,44,0,2,31,27,74180,29675,5964,39302,0
236,5011,1943,715,1694,26,18,214,1969,12,185,120,237,197,357,1436,2721,7,20915,1161,0,2,26,24,74180,29677,5964,39303,0
236,5011,1168,838,957,57,25,144,1225,19,348,224,416,367,640,3018,5452,11,61921,3440,1,2,26,24,74190,29679,5964,39304,0
99,4102,1289,550,1043,56,32,155,1345,10,167,93,185,177,278,1266,2075,5,11498,638,0,2,2,2,74190,29681,5965,39305,0
1,14,6,4,4,0,0,2,6,0,0,0,0,0,0,0,0,0,0,0,0,0,6,0,74200,29682,5965,39318,0
3,49,16,9,9,0,0,7,16,0,0,0,0,0,0,0,0,0,0,0,0,0,16,0,74200,29682,5965,39319,0
12,318,149,95,105,2,0,41,151,8,54,28,55,62,83,334,494,4,2013,111,0,0,66,0,74200,29682,5965,39320,0
90,3974,1338,495,1086,10,64,173,1348,11,122,82,157,133,239,883,1686,7,11934,663,0,2,2,2,74200,29684,5965,39321,0
124,4939,1450,624,1228,12,26,181,1462,14,306,186,354,320,540,2580,4493,8,36391,2021,1,2,6,4,74200,29686,5966,39322,0
123,5301,1513,682,1277,25,13,200,1538,11,199,116,219,210,335,1557,2584,6,15641,868,0,2,11,18,74200,29688,5966,39323,0
69,3105,1020,354,843,12,15,144,1032,8,134,77,144,142,221,970,1580,4,6792,377,0,2,7,0,74200,29688,5966,39324,0
45,2037,447,308,343,6,5,95,453,7,96,59,111,103,170,651,1136,4,4600,255,0,2,27,0,74200,29691,5966,39325,0
21,653,424,94,331,4,0,89,428,1,5,5,5,6,10,11,25,0,12,0,0,2,15,0,74200,29692,5966,39326,0
39,2363,334,251,279,10,4,40,344,5,127,74,143,132,217,899,1528,2,4303,239,0,2,2,1,74200,29693,5966,39327,0
77,3233,1178,367,1042,6,15,115,1184,9,94,51,95,103,146,644,976,4,4439,246,0,2,2,1,74200,29693,5966,39328,0
101,5272,1943,715,1694,26,18,214,1969,12,185,120,237,197,357,1436,2721,7,20915,1161,0,2,1,1,74200,29695,5966,39329,0
37,1525,442,244,305,14,16,103,456,11,68,45,75,79,120,452,756,6,4588,254,0,2,16,0,74200,29697,5966,39330,0
53,1862,601,196,481,2,23,85,603,8,63,36,72,71,108,400,664,4,3036,168,0,2,19,0,74200,29697,5966,39331,0
52,625,647,139,84,35,284,233,682,0,0,0,0,0,0,0,0,0,0,0,0,2,3,2,74200,29697,5966,39332,0
232,4978,1943,715,1694,26,18,214,1969,12,185,120,237,197,357,1436,2721,7,20915,1161,0,2,1,1,74200,29699,5966,39333,0
232,4978,1168,838,957,57,25,144,1225,19,348,224,416,367,640,3018,5452,11,61921,3440,1,2,1,1,74210,29701,5966,39334,0
245,5671,4293,999,3693,19,54,507,4312,9,155,88,170,164,258,1156,1898,4,9368,520,0,2,2,2,74210,29703,5966,39335,0
245,5671,1482,859,1002,125,135,219,1607,16,219,134,251,235,385,1766,3032,9,27804,1544,1,2,2,2,74220,29704,5966,39336,0
94,2438,773,422,505,30,103,129,803,14,77,46,83,91,129,535,839,7,6334,351,0,2,1,1,74230,29705,5967,39337,0
69,1497,402,202,227,24,74,80,426,12,52,33,61,64,94,339,564,7,3969,220,0,2,2,2,74230,29706,5967,39338,0
95,2085,1043,504,840,53,9,147,1096,9,180,112,198,189,310,1377,2344,4,11604,644,0,2,1,1,74230,29708,5967,39339,0
95,2085,383,288,292,26,6,62,409,11,65,38,67,76,105,429,656,5,3719,206,0,2,1,1,74230,29709,5967,39340,0
220,4689,2,2,2,0,0,0,2,0,0,0,0,0,0,0,0,0,0,0,0,2,1,1,74230,29709,5967,39340,0
220,4689,99,48,90,1,3,5,100,0,0,0,0,0,0,0,0,0,0,0,0,2,1,1,74230,29710,5967,39341,0
220,4689,8,5,5,2,0,1,10,0,0,0,0,0,0,0,0,0,0,0,0,2,1,1,74230,29710,5967,39342,0
220,4689,1217,716,841,84,126,174,1301,14,185,118,215,199,333,1446,2542,8,20687,1149,0,2,1,1,74240,29712,5967,39343,0
220,4689,160,89,115,0,13,31,160,7,15,11,17,22,28,78,124,3,495,27,0,2,1,1,74240,29712,5967,39344,0
220,4689,10,10,9,9,0,0,19,0,0,0,0,0,0,0,0,0,0,0,0,2,1,1,74240,29712,5968,39345,0
220,4689,173,84,99,8,29,36,181,5,12,7,13,17,20,54,81,2,221,12,0,2,1,1,74240,29713,5968,39346,0
220,4689,3,1,1,3,0,0,6,0,0,0,0,0,0,0,0,0,0,0,0,2,1,1,74240,29713,5968,39347,0
236,5079,1943,715,1694,26,18,214,1969,12,185,120,237,197,357,1436,2721,7,20915,1161,0,2,15,0,74240,29715,5968,39348,0
236,5079,1168,838,957,57,25,144,1225,19,348,224,416,367,640,3018,5452,11,61921,3440,1,2,15,0,74250,29717,5968,39349,0
100,4116,1289,550,1043,56,32,155,1345,10,167,93,185,177,278,1266,2075,5,11498,638,0,2,3,1,74250,29719,5969,39350,0
16,895,75,38,59,1,3,12,76,2,4,2,4,6,6,10,15,1,15,0,0,2,19,0,74250,29719,5969,39351,0
220,4689,2,2,2,0,0,0,2,0,0,0,0,0,0,0,0,0,0,0,0,2,1,1,74250,29719,5969,39351,0
220,4689,99,48,90,1,3,5,100,0,0,0,0,0,0,0,0,0,0,0,0,2,1,1,74250,29720,5969,39352,0
220,4689,8,5,5,2,0,1,10,0,0,0,0,0,0,0,0,0,0,0,0,2,1,1,74250,29720,5969,39353,0
220,4689,1217,716,841,84,126,174,1301,14,185,118,215,199,333,1446,2542,8,20687,1149,0,2,1,1,74260,29722,5969,39354,0
220,4689,160,89,115,0,13,31,160,7,15,11,17,22,28,78,124,3,495,27,0,2,1,1,74260,29722,5969,39355,0
220,4689,10,10,9,9,0,0,19,0,0,0,0,0,0,0,0,0,0,0,0,2,1,1,74260,29722,5970,39356,0
220,4689,173,84,99,8,29,36,181,5,12,7,13,17,20,54,81,2,221,12,0,2,1,1,74260,29723,5970,39357,0
220,4689,3,1,1,3,0,0,6,0,0,0,0,0,0,0,0,0,0,0,0,2,1,1,74260,29723,5970,39358,0
245,5671,4293,999,3693,19,54,507,4312,9,155,88,170,164,258,1156,1898,4,9368,520,0,2,2,2,74260,29725,5970,39359,0
245,5671,1482,859,1002,125,135,219,1607,16,219,134,251,235,385,1766,3032,9,27804,1544,1,2,2,2,74270,29726,5970,39360,0
94,2438,773,422,505,30,103,129,803,14,77,46,83,91,129,535,839,7,6334,351,0,2,1,1,74280,29727,5971,39361,0
69,1497,402,202,227,24,74,80,426,12,52,33,61,64,94,339,564,7,3969,220,0,2,2,2,74280,29728,5971,39362,0
95,2085,1043,504,840,53,9,147,1096,9,180,112,198,189,310,1377,2344,4,11604,644,0,2,1,1,74280,29730,5971,39363,0
95,2085,383,288,292,26,6,62,409,11,65,38,67,76,105,429,656,5,3719,206,0,2,1,1,74280,29731,5971,39364,0
71,1445,1178,367,1042,6,15,115,1184,9,94,51,95,103,146,644,976,4,4439,246,0,2,1,1,74280,29731,5971,39365,0
71,1445,177,108,140,8,0,27,185,6,30,16,32,36,48,162,248,3,794,44,0,2,1,1,74280,29733,5971,39366,0
220,4689,2,2,2,0,0,0,2,0,0,0,0,0,0,0,0,0,0,0,0,2,1,1,74280,29733,5971,39366,0
220,4689,99,48,90,1,3,5,100,0,0,0,0,0,0,0,0,0,0,0,0,2,1,1,74280,29734,5971,39367,0
220,4689,8,5,5,2,0,1,10,0,0,0,0,0,0,0,0,0,0,0,0,2,1,1,74280,29734,5971,39368,0
220,4689,1217,716,841,84,126,174,1301,14,185,118,215,199,333,1446,2542,8,20687,1149,0,2,1,1,74290,29736,5971,39369,0
220,4689,160,89,115,0,13,31,160,7,15,11,17,22,28,78,124,3,495,27,0,2,1,1,74290,29736,5971,39370,0
220,4689,10,10,9,9,0,0,19,0,0,0,0,0,0,0,0,0,0,0,0,2,1,1,74290,29736,5972,39371,0
220,4689,173,84,99,8,29,36,181,5,12,7,13,17,20,54,81,2,221,12,0,2,1,1,74290,29737,5972,39372,0
220,4689,3,1,1,3,0,0,6,0,0,0,0,0,0,0,0,0,0,0,0,2,1,1,74290,29737,5972,39373,0
245,5664,4293,999,3693,19,54,507,4312,9,155,88,170,164,258,1156,1898,4,9368,520,0,2,2,2,74290,29739,5972,39374,0
245,5664,1482,859,1002,125,135,219,1607,16,219,134,251,235,385,1766,3032,9,27804,1544,1,2,2,2,74300,29740,5972,39375,0
94,2438,773,422,505,30,103,129,803,14,77,46,83,91,129,535,839,7,6334,351,0,2,1,1,74310,29741,5973,39376,0
69,1497,402,202,227,24,74,80,426,12,52,33,61,64,94,339,564,7,3969,220,0,2,2,2,74310,29742,5973,39377,0
95,2085,1043,504,840,53,9,147,1096,9,180,112,198,189,310,1377,2344,4,11604,644,0,2,1,1,74310,29744,5973,39378,0
95,2085,383,288,292,26,6,62,409,11,65,38,67,76,105,429,656,5,3719,206,0,2,1,1,74310,29745,5973,39379,0
52,625,647,139,84,35,284,233,682,0,0,0,0,0,0,0,0,0,0,0,0,2,3,2,74310,29745,5973,39380,0
240,5118,1943,715,1694,26,18,214,1969,12,185,120,237,197,357,1436,2721,7,20915,1161,0,2,16,1,74310,29747,5973,39381,0
240,5118,1168,838,957,57,25,144,1225,19,348,224,416,367,640,3018,5452,11,61921,3440,1,2,16,1,74320,29749,5973,39382,0
100,4121,1289,550,1043,56,32,155,1345,10,167,93,185,177,278,1266,2075,5,11498,638,0,2,3,1,74320,29751,5974,39383,0
16,895,75,38,59,1,3,12,76,2,4,2,4,6,6,10,15,1,15,0,0,2,19,0,74320,29751,5974,39384,0
7,296,72,33,56,0,4,12,72,1,1,1,1,2,2,0,2,0,1,0,0,2,5,5,74320,29751,5974,39385,0
231,4973,182,127,129,0,0,53,182,5,39,21,42,44,63,217,343,2,926,51,0,2,4,3,74320,29751,5975,39386,0
231,4973,1165,710,800,67,119,181,1232,18,243,153,282,261,435,2000,3492,10,36473,2026,1,2,4,3,74330,29751,5976,39387,0
67,1570,773,419,590,28,0,166,801,10,204,113,217,214,330,1598,2554,5,13587,754,0,2,1,3,74330,29751,5977,39388,0
67,1570,421,273,302,44,34,57,465,17,81,59,107,98,166,583,1098,11,12329,684,0,2,1,3,74330,29751,5978,39389,0
12,387,149,95,105,2,0,41,151,8,54,28,55,62,83,334,494,4,2013,111,0,0,72,0,74340,29755,5979,39397,0
12,387,82,56,54,0,13,15,82,4,13,8,16,17,24,56,98,2,241,13,0,0,72,0,74350,29755,5979,39398,0
183,5544,1660,832,1314,41,38,274,1701,20,312,209,395,332,604,2671,5058,12,64042,3557,1,2,6,5,74350,29757,5980,39400,0
183,5544,1057,646,719,113,100,145,1170,18,215,134,248,233,382,1740,3004,10,31186,1732,1,2,6,5,74360,29758,5981,39401,0
112,2103,477,336,357,30,23,73,507,16,194,134,250,210,384,1538,2962,10,30538,1696,0,2,9,11,74370,29759,5981,39402,0
73,1518,207,111,150,11,0,50,218,5,26,19,36,31,55,133,272,3,943,52,0,2,2,1,74370,29759,5981,39403,0
73,1518,410,198,237,31,55,97,441,11,63,38,72,74,110,414,683,6,4293,238,0,2,2,1,74380,29760,5982,39404,0
220,4689,2,2,2,0,0,0,2,0,0,0,0,0,0,0,0,0,0,0,0,2,1,1,74380,29760,5982,39404,0
220,4689,99,48,90,1,3,5,100,0,0,0,0,0,0,0,0,0,0,0,0,2,1,1,74380,29761,5982,39405,0
220,4689,8,5,5,2,0,1,10,0,0,0,0,0,0,0,0,0,0,0,0,2,1,1,74380,29761,5982,39406,0
220,4689,1217,716,841,84,126,174,1301,14,185,118,215,199,333,1446,2542,8,20687,1149,0,2,1,1,74390,29763,5982,39407,0
220,4689,160,89,115,0,13,31,160,7,15,11,17,22,28,78,124,3,495,27,0,2,1,1,74390,29763,5982,39408,0
220,4689,10,10,9,9,0,0,19,0,0,0,0,0,0,0,0,0,0,0,0,2,1,1,74390,29763,5983,39409,0
220,4689,173,84,99,8,29,36,181,5,12,7,13,17,20,54,81,2,221,12,0,2,1,1,74390,29764,5983,39410,0
220,4689,3,1,1,3,0,0,6,0,0,0,0,0,0,0,0,0,0,0,0,2,1,1,74390,29764,5983,39411,0
245,5664,4293,999,3693,19,54,507,4312,9,155,88,170,164,258,1156,1898,4,9368,520,0,2,3,3,74390,29766,5983,39412,0
245,5664,1482,859,1002,125,135,219,1607,16,219,134,251,235,385,1766,3032,9,27804,1544,1,2,3,3,74400,29767,5983,39413,0
108,2933,1523,757,1297,19,12,193,1542,12,193,117,230,205,347,1508,2664,7,19053,1058,0,2,1,1,74410,29769,5983,39414,0
108,2933,701,378,504,33,58,109,734,13,110,68,126,123,194,794,1346,7,10027,557,0,2,1,1,74410,29770,5984,39415,0
94,2438,773,422,505,30,103,129,803,14,77,46,83,91,129,535,839,7,6334,351,0,2,1,1,74420,29771,5985,39416,0
22,373,102,57,55,5,16,25,107,5,17,10,18,22,28,81,124,2,330,18,0,2,5,4,74420,29771,5985,39417,0
69,1497,402,202,227,24,74,80,426,12,52,33,61,64,94,339,564,7,3969,220,0,2,2,2,74420,29772,5985,39418,0
54,1145,447,308,343,6,5,95,453,7,96,59,111,103,170,651,1136,4,4600,255,0,2,7,1,74420,29775,5985,39419,0
54,1145,322,174,179,16,74,51,338,10,41,26,46,51,72,252,408,5,2291,127,0,2,7,1,74420,29778,5986,39420,0
18,310,424,94,331,4,0,89,428,1,5,5,5,6,10,11,25,0,12,0,0,2,3,1,74420,29779,5986,39421,0
18,310,38,23,23,6,0,8,44,3,11,7,11,14,18,42,68,1,102,5,0,2,3,1,74420,29779,5986,39422,0
245,5864,722,423,573,19,0,135,741,12,172,101,199,184,300,1320,2257,6,15668,870,0,2,12,18,74420,29781,5986,39424,0
245,5864,1508,847,911,44,250,301,1552,14,148,88,169,162,257,1120,1886,7,15077,837,0,2,12,18,74420,29782,5987,39425,0
313,6834,72,33,56,0,4,12,72,1,1,1,1,2,2,0,2,0,1,0,0,2,1,1,74420,29782,5987,39426,0
313,6834,1454,835,1044,76,110,219,1530,17,275,158,296,292,454,2297,3718,9,34017,1889,1,2,1,1,74430,29783,5987,39427,0
27,671,466,257,367,18,25,50,484,7,126,86,171,133,257,898,1813,4,8612,478,0,2,4,0,74430,29783,5987,39428,0
27,671,507,281,342,29,59,88,536,10,53,29,57,63,86,336,514,5,2764,153,0,2,4,0,74430,29783,5987,39429,0
95,2085,1043,504,840,53,9,147,1096,9,180,112,198,189,310,1377,2344,4,11604,644,0,2,1,1,74430,29785,5987,39430,0
95,2085,383,288,292,26,6,62,409,11,65,38,67,76,105,429,656,5,3719,206,0,2,1,1,74430,29786,5987,39431,0
71,1445,1178,367,1042,6,15,115,1184,9,94,51,95,103,146,644,976,4,4439,246,0,2,31,27,74430,29786,5987,39432,0
71,1445,177,108,140,8,0,27,185,6,30,16,32,36,48,162,248,3,794,44,0,2,31,27,74430,29788,5987,39433,0
240,5118,1943,715,1694,26,18,214,1969,12,185,120,237,197,357,1436,2721,7,20915,1161,0,2,26,24,74430,29790,5987,39434,0
240,5118,1168,838,957,57,25,144,1225,19,348,224,416,367,640,3018,5452,11,61921,3440,1,2,26,24,74440,29792,5987,39435,0
100,4121,1289,550,1043,56,32,155,1345,10,167,93,185,177,278,1266,2075,5,11498,638,0,2,2,2,74440,29794,5988,39436,0
1,14,6,4,4,0,0,2,6,0,0,0,0,0,0,0,0,0,0,0,0,0,6,0,74450,29795,5988,39449,0
3,49,16,9,9,0,0,7,16,0,0,0,0,0,0,0,0,0,0,0,0,0,16,0,74450,29795,5988,39450,0
12,318,149,95,105,2,0,41,151,8,54,28,55,62,83,334,494,4,2013,111,0,0,66,0,74450,29795,5988,39451,0
90,3974,1338,495,1086,10,64,173,1348,11,122,82,157,133,239,883,1686,7,11934,663,0,2,2,2,74450,29797,5988,39452,0
124,4939,1450,624,1228,12,26,181,1462,14,306,186,354,320,540,2580,4493,8,36391,2021,1,2,6,4,74450,29799,5989,39453,0
123,5301,1513,682,1277,25,13,200,1538,11,199,116,219,210,335,1557,2584,6,15641,868,0,2,11,18,74450,29801,5989,39454,0
69,3105,1020,354,843,12,15,144,1032,8,134,77,144,142,221,970,1580,4,6792,377,0,2,7,0,74450,29801,5989,39455,0
45,2037,447,308,343,6,5,95,453,7,96,59,111,103,170,651,1136,4,4600,255,0,2,27,0,74450,29804,5989,39456,0
21,653,424,94,331,4,0,89,428,1,5,5,5,6,10,11,25,0,12,0,0,2,15,0,74450,29805,5989,39457,0
39,2363,334,251,279,10,4,40,344,5,127,74,143,132,217,899,1528,2,4303,239,0,2,2,1,74450,29806,5989,39458,0
77,3233,1178,367,1042,6,15,115,1184,9,94,51,95,103,146,644,976,4,4439,246,0,2,2,1,74450,29806,5989,39459,0
101,5272,1943,715,1694,26,18,214,1969,12,185,120,237,197,357,1436,2721,7,20915,1161,0,2,1,1,74450,29808,5989,39460,0
37,1525,442,244,305,14,16,103,456,11,68,45,75,79,120,452,756,6,4588,254,0,2,16,0,74450,29810,5989,39461,0
53,1862,601,196,481,2,23,85,603,8,63,36,72,71,108,400,664,4,3036,168,0,2,19,0,74450,29810,5989,39462,0
231,4973,182,127,129,0,0,53,182,5,39,21,42,44,63,217,343,2,926,51,0,2,0,5,74450,29810,5990,39463,0
231,4973,1165,710,800,67,119,181,1232,18,243,153,282,261,435,2000,3492,10,36473,2026,1,2,0,5,74460,29810,5991,39464,0
183,5544,1660,832,1314,41,38,274,1701,20,312,209,395,332,604,2671,5058,12,64042,3557,1,2,0,13,74460,29812,5992,39466,0
183,5544,1057,646,719,113,100,145,1170,18,215,134,248,233,382,1740,3004,10,31186,1732,1,2,0,13,74470,29813,5993,39467,0
42,1241,339,213,244,17,9,65,356,10,42,26,48,52,74,259,421,5,2410,133,0,2,7,3,74480,29813,5993,39468,0
245,5664,4293,999,3693,19,54,507,4312,9,155,88,170,164,258,1156,1898,4,9368,520,0,2,0,6,74480,29815,5993,39469,0
245,5664,1482,859,1002,125,135,219,1607,16,219,134,251,235,385,1766,3032,9,27804,1544,1,2,0,6,74490,29816,5993,39470,0
52,625,647,139,84,35,284,233,682,0,0,0,0,0,0,0,0,0,0,0,0,2,6,3,74490,29816,5993,39471,0
108,2933,1523,757,1297,19,12,193,1542,12,193,117,230,205,347,1508,2664,7,19053,1058,0,2,73,20,74500,29818,5993,39472,0
108,2933,701,378,504,33,58,109,734,13,110,68,126,123,194,794,1346,7,10027,557,0,2,73,20,74500,29819,5994,39473,0
21,541,205,80,86,16,53,53,221,7,18,10,19,25,29,94,134,3,497,27,0,2,3,3,74510,29819,5995,39474,0
313,6834,72,33,56,0,4,12,72,1,1,1,1,2,2,0,2,0,1,0,0,2,142,51,74510,29819,5995,39475,0
313,6834,1454,835,1044,76,110,219,1530,17,275,158,296,292,454,2297,3718,9,34017,1889,1,2,142,51,74520,29820,5995,39476,0
27,671,466,257,367,18,25,50,484,7,126,86,171,133,257,898,1813,4,8612,478,0,2,0,10,74520,29820,5995,39477,0
27,671,507,281,342,29,59,88,536,10,53,29,57,63,86,336,514,5,2764,153,0,2,0,10,74520,29820,5995,39478,0
25,552,215,129,180,6,0,29,221,8,65,43,72,73,115,415,711,4,3153,175,0,2,3,25,74520,29820,5995,39479,0
25,552,97,69,77,3,3,16,100,6,22,13,23,28,36,113,173,3,542,30,0,2,3,25,74520,29821,5995,39480,0
71,1445,1178,367,1042,6,15,115,1184,9,94,51,95,103,146,644,976,4,4439,246,0,2,1,1,74520,29821,5995,39481,0
71,1445,177,108,140,8,0,27,185,6,30,16,32,36,48,162,248,3,794,44,0,2,1,1,74520,29823,5995,39482,0
240,5118,1943,715,1694,26,18,214,1969,12,185,120,237,197,357,1436,2721,7,20915,1161,0,2,20,11,74520,29825,5995,39483,0
240,5118,1168,838,957,57,25,144,1225,19,348,224,416,367,640,3018,5452,11,61921,3440,1,2,20,11,74530,29827,5995,39484,0
19,720,442,244,305,14,16,103,456,11,68,45,75,79,120,452,756,6,4588,254,0,2,3,2,74530,29829,5995,39485,0
19,720,182,102,99,11,40,35,193,3,11,6,11,14,17,42,64,1,97,5,0,2,3,2,74530,29830,5995,39486,0
68,1302,1098,241,925,5,10,155,1103,7,46,25,49,53,74,273,423,3,1580,87,0,2,45,19,74540,29832,5995,39487,0
68,1302,282,202,222,14,2,44,296,8,42,24,43,50,67,250,378,4,1548,86,0,2,45,19,74540,29833,5995,39488,0
100,4121,1289,550,1043,56,32,155,1345,10,167,93,185,177,278,1266,2075,5,11498,638,0,2,3,1,74540,29835,5996,39489,0
16,895,75,38,59,1,3,12,76,2,4,2,4,6,6,10,15,1,15,0,0,2,19,0,74540,29835,5996,39490,0
90,3974,1338,495,1086,10,64,173,1348,11,122,82,157,133,239,883,1686,7,11934,663,0,2,0,3,74540,29837,5996,39491,0
170,7538,139,89,101,2,0,35,141,7,54,34,62,61,96,330,569,4,2287,127,0,2,40,1,74540,29837,5996,39492,0
170,7538,7,5,5,0,0,2,7,1,2,1,2,3,3,2,4,0,2,0,0,2,40,1,74540,29837,5996,39493,0
125,5588,1782,648,1425,9,47,279,1791,8,171,97,189,179,286,1292,2140,4,9462,525,0,2,0,1,74540,29838,5997,39494,0
47,3455,996,429,845,24,10,117,1020,7,76,50,88,83,138,494,879,4,3565,198,0,2,1,1,74540,29840,5997,39495,0
100,4747,1523,757,1297,19,12,193,1542,12,193,117,230,205,347,1508,2664,7,19053,1058,0,2,69,95,74550,29842,5997,39496,0
65,3082,1293,570,1093,25,15,163,1318,10,195,123,241,205,364,1516,2795,6,17273,959,0,2,71,55,74560,29844,5997,39497,0
15,1066,215,129,180,6,0,29,221,8,65,43,72,73,115,415,711,4,3153,175,0,2,0,29,74560,29844,5997,39498,0
83,3318,1043,504,840,53,9,147,1096,9,180,112,198,189,310,1377,2344,4,11604,644,0,2,1,6,74560,29846,5997,39499,0
29,1210,373,158,315,8,0,51,381,5,76,44,79,81,123,486,779,2,2026,112,0,2,0,1,74560,29846,5997,39500,0
101,5272,1943,715,1694,26,18,214,1969,12,185,120,237,197,357,1436,2721,7,20915,1161,0,2,2,13,74560,29848,5997,39501,0
37,1525,442,244,305,14,16,103,456,11,68,45,75,79,120,452,756,6,4588,254,0,2,4,0,74560,29850,5997,39502,0
69,1323,1098,241,925,5,10,155,1103,7,46,25,49,53,74,273,423,3,1580,87,0,2,3,0,74570,29852,5997,39503,0
69,1323,282,202,222,14,2,44,296,8,42,24,43,50,67,250,378,4,1548,86,0,2,3,0,74570,29853,5997,39504,0
2,40,13,9,8,0,0,4,13,0,0,0,0,0,0,0,0,0,0,0,0,0,13,0,74570,29853,5997,39505,0
2,42,14,10,9,0,0,4,14,0,0,0,0,0,0,0,0,0,0,0,0,0,14,0,74570,29853,5997,39506,0
2,33,12,8,7,0,0,4,12,0,0,0,0,0,0,0,0,0,0,0,0,0,12,0,74570,29853,5997,39507,0
52,1990,1098,241,925,5,10,155,1103,7,46,25,49,53,74,273,423,3,1580,87,0,2,15,0,74580,29855,5997,39508,0
69,1323,1098,241,925,5,10,155,1103,7,46,25,49,53,74,273,423,3,1580,87,0,2,3,0,74590,29857,5997,39509,0
69,1323,282,202,222,14,2,44,296,8,42,24,43,50,67,250,378,4,1548,86,0,2,3,0,74590,29858,5997,39510,0
2,40,13,9,8,0,0,4,13,0,0,0,0,0,0,0,0,0,0,0,0,0,13,0,74590,29858,5997,39511,0
2,42,14,10,9,0,0,4,14,0,0,0,0,0,0,0,0,0,0,0,0,0,14,0,74590,29858,5997,39512,0
2,33,12,8,7,0,0,4,12,0,0,0,0,0,0,0,0,0,0,0,0,0,12,0,74590,29858,5997,39513,0
52,1990,1098,241,925,5,10,155,1103,7,46,25,49,53,74,273,423,3,1580,87,0,2,15,0,74600,29860,5997,39514,0
92,1891,757,253,292,73,244,162,830,13,61,38,67,74,105,409,651,7,4654,258,0,2,8,0,74600,29861,5997,39515,0
33,1041,256,139,192,9,7,47,265,4,23,12,24,27,36,112,171,2,357,19,0,2,48,0,74600,29862,5997,39516,0
169,5034,1660,832,1314,41,38,274,1701,20,312,209,395,332,604,2671,5058,12,64042,3557,1,2,13,36,74600,29864,5998,39518,0
169,5034,1660,832,1314,41,38,274,1701,20,312,209,395,332,604,2671,5058,12,64042,3557,1,2,13,36,74600,29866,5999,39520,0
94,2466,773,422,505,30,103,129,803,14,77,46,83,91,129,535,839,7,6334,351,0,2,51,47,74610,29867,6000,39521,0
221,4701,2,2,2,0,0,0,2,0,0,0,0,0,0,0,0,0,0,0,0,2,2,2,74610,29867,6000,39521,0
221,4701,99,48,90,1,3,5,100,0,0,0,0,0,0,0,0,0,0,0,0,2,2,2,74610,29868,6000,39522,0
221,4701,8,5,5,2,0,1,10,0,0,0,0,0,0,0,0,0,0,0,0,2,2,2,74610,29868,6000,39523,0
221,4701,1217,716,841,84,126,174,1301,14,185,118,215,199,333,1446,2542,8,20687,1149,0,2,2,2,74620,29870,6000,39524,0
221,4701,160,89,115,0,13,31,160,7,15,11,17,22,28,78,124,3,495,27,0,2,2,2,74620,29870,6000,39525,0
221,4701,10,10,9,9,0,0,19,0,0,0,0,0,0,0,0,0,0,0,0,2,2,2,74620,29870,6001,39526,0
221,4701,173,84,99,8,29,36,181,5,12,7,13,17,20,54,81,2,221,12,0,2,2,2,74620,29871,6001,39527,0
221,4701,3,1,1,3,0,0,6,0,0,0,0,0,0,0,0,0,0,0,0,2,2,2,74620,29871,6001,39528,0
101,4167,1289,550,1043,56,32,155,1345,10,167,93,185,177,278,1266,2075,5,11498,638,0,2,14,0,74620,29873,6002,39529,0
158,3681,77,34,69,0,0,8,77,3,24,16,29,27,45,114,213,1,387,21,0,2,18,0,74620,29873,6002,39530,0
158,3681,712,438,573,51,9,84,763,14,102,71,128,116,199,733,1364,8,11988,666,0,2,18,0,74630,29874,6002,39531,0
30,1324,373,158,315,8,0,51,381,5,76,44,79,81,123,486,779,2,2026,112,0,2,15,0,74630,29874,6002,39532,0
221,4701,2,2,2,0,0,0,2,0,0,0,0,0,0,0,0,0,0,0,0,2,2,2,74630,29874,6002,39532,0
221,4701,99,48,90,1,3,5,100,0,0,0,0,0,0,0,0,0,0,0,0,2,2,2,74630,29875,6002,39533,0
221,4701,8,5,5,2,0,1,10,0,0,0,0,0,0,0,0,0,0,0,0,2,2,2,74630,29875,6002,39534,0
221,4701,1217,716,841,84,126,174,1301,14,185,118,215,199,333,1446,2542,8,20687,1149,0,2,2,2,74640,29877,6002,39535,0
221,4701,160,89,115,0,13,31,160,7,15,11,17,22,28,78,124,3,495,27,0,2,2,2,74640,29877,6002,39536,0
221,4701,10,10,9,9,0,0,19,0,0,0,0,0,0,0,0,0,0,0,0,2,2,2,74640,29877,6003,39537,0
221,4701,173,84,99,8,29,36,181,5,12,7,13,17,20,54,81,2,221,12,0,2,2,2,74640,29878,6003,39538,0
221,4701,3,1,1,3,0,0,6,0,0,0,0,0,0,0,0,0,0,0,0,2,2,2,74640,29878,6003,39539,0
101,4167,1289,550,1043,56,32,155,1345,10,167,93,185,177,278,1266,2075,5,11498,638,0,2,14,0,74640,29880,6004,39540,0
241,5125,1943,715,1694,26,18,214,1969,12,185,120,237,197,357,1436,2721,7,20915,1161,0,2,8,7,74640,29882,6004,39541,0
241,5125,1168,838,957,57,25,144,1225,19,348,224,416,367,640,3018,5452,11,61921,3440,1,2,8,7,74650,29884,6004,39542,0
101,5303,1943,715,1694,26,18,214,1969,12,185,120,237,197,357,1436,2721,7,20915,1161,0,2,5,2,74650,29886,6004,39543,0
159,3699,77,34,69,0,0,8,77,3,24,16,29,27,45,114,213,1,387,21,0,2,4,1,74650,29886,6004,39544,0
159,3699,712,438,573,51,9,84,763,14,102,71,128,116,199,733,1364,8,11988,666,0,2,4,1,74660,29887,6004,39545,0
80,4558,1296,573,1062,40,33,157,1336,8,201,118,231,209,349,1561,2689,4,12365,686,0,2,20,0,74660,29887,6004,39546,0
94,2466,773,422,505,30,103,129,803,14,77,46,83,91,129,535,839,7,6334,351,0,2,51,47,74670,29888,6005,39547,0
45,955,386,256,301,16,9,68,402,4,59,35,69,63,104,355,621,2,1453,80,0,2,8,5,74670,29888,6005,39549,0
45,955,264,131,164,11,41,46,275,6,38,22,40,44,62,214,338,3,1068,59,0,2,8,5,74680,29888,6006,39550,0
17,930,75,38,59,1,3,12,76,2,4,2,4,6,6,10,15,1,15,0,0,2,9,0,74680,29888,6006,39551,0
241,5125,1943,715,1694,26,18,214,1969,12,185,120,237,197,357,1436,2721,7,20915,1161,0,2,8,7,74680,29890,6006,39552,0
241,5125,1168,838,957,57,25,144,1225,19,348,224,416,367,640,3018,5452,11,61921,3440,1,2,8,7,74690,29892,6006,39553,0
101,5303,1943,715,1694,26,18,214,1969,12,185,120,237,197,357,1436,2721,7,20915,1161,0,2,5,2,74690,29894,6006,39554,0
221,4705,2,2,2,0,0,0,2,0,0,0,0,0,0,0,0,0,0,0,0,2,1,1,74690,29894,6006,39554,1
221,4705,99,48,90,1,3,5,100,0,0,0,0,0,0,0,0,0,0,0,0,2,1,1,74690,29895,6006,39555,1
221,4705,8,5,5,2,0,1,10,0,0,0,0,0,0,0,0,0,0,0,0,2,1,1,74690,29895,6006,39556,1
221,4705,1217,716,841,84,126,174,1301,14,185,118,215,199,333,1446,2542,8,20687,1149,0,2,1,1,74700,29897,6006,39557,1
221,4705,160,89,115,0,13,31,160,7,15,11,17,22,28,78,124,3,495,27,0,2,1,1,74700,29897,6006,39558,1
221,4705,10,10,9,9,0,0,19,0,0,0,0,0,0,0,0,0,0,0,0,2,1,1,74700,29897,6007,39559,1
221,4705,173,84,99,8,29,36,181,5,12,7,13,17,20,54,81,2,221,12,0,2,1,1,74700,29898,6007,39560,1
221,4705,3,1,1,3,0,0,6,0,0,0,0,0,0,0,0,0,0,0,0,2,1,1,74700,29898,6007,39561,1
43,2676,652,304,544,16,6,88,668,6,89,51,101,95,152,591,998,3,3399,188,0,2,36,0,74700,29899,6007,39562,1
45,955,386,256,301,16,9,68,402,4,59,35,69,63,104,355,621,2,1453,80,0,2,8,5,74700,29899,6007,39564,0
45,955,264,131,164,11,41,46,275,6,38,22,40,44,62,214,338,3,1068,59,0,2,8,5,74710,29899,6008,39565,0
17,930,75,38,59,1,3,12,76,2,4,2,4,6,6,10,15,1,15,0,0,2,9,0,74710,29899,6008,39566,0
221,4705,2,2,2,0,0,0,2,0,0,0,0,0,0,0,0,0,0,0,0,2,3,0,74710,29899,6008,39566,0
221,4705,99,48,90,1,3,5,100,0,0,0,0,0,0,0,0,0,0,0,0,2,3,0,74710,29900,6008,39567,0
221,4705,8,5,5,2,0,1,10,0,0,0,0,0,0,0,0,0,0,0,0,2,3,0,74710,29900,6008,39568,0
221,4705,1217,716,841,84,126,174,1301,14,185,118,215,199,333,1446,2542,8,20687,1149,0,2,3,0,74720,29902,6008,39569,0
221,4705,160,89,115,0,13,31,160,7,15,11,17,22,28,78,124,3,495,27,0,2,3,0,74720,29902,6008,39570,0
221,4705,10,10,9,9,0,0,19,0,0,0,0,0,0,0,0,0,0,0,0,2,3,0,74720,29902,6009,39571,0
221,4705,173,84,99,8,29,36,181,5,12,7,13,17,20,54,81,2,221,12,0,2,3,0,74720,29903,6009,39572,0
221,4705,3,1,1,3,0,0,6,0,0,0,0,0,0,0,0,0,0,0,0,2,3,0,74720,29903,6009,39573,0
94,2454,773,422,505,30,103,129,803,14,77,46,83,91,129,535,839,7,6334,351,0,2,43,44,74730,29904,6010,39574,0
94,2454,773,422,505,30,103,129,803,14,77,46,83,91,129,535,839,7,6334,351,0,2,43,44,74740,29905,6011,39575,0
313,6832,72,33,56,0,4,12,72,1,1,1,1,2,2,0,2,0,1,0,0,2,4,6,74740,29905,6011,39576,0
313,6832,1454,835,1044,76,110,219,1530,17,275,158,296,292,454,2297,3718,9,34017,1889,1,2,4,6,74750,29906,6011,39577,0
126,5612,1782,648,1425,9,47,279,1791,8,171,97,189,179,286,1292,2140,4,9462,525,0,2,15,0,74750,29907,6012,39578,0
94,2418,773,422,505,30,103,129,803,14,77,46,83,91,129,535,839,7,6334,351,0,2,0,7,74760,29908,6013,39579,0
247,5178,1943,715,1694,26,18,214,1969,12,185,120,237,197,357,1436,2721,7,20915,1161,0,2,23,4,74760,29910,6013,39580,0
247,5178,1168,838,957,57,25,144,1225,19,348,224,416,367,640,3018,5452,11,61921,3440,1,2,23,4,74770,29912,6013,39581,0
313,6832,72,33,56,0,4,12,72,1,1,1,1,2,2,0,2,0,1,0,0,2,4,6,74770,29912,6013,39582,0
313,6832,1454,835,1044,76,110,219,1530,17,275,158,296,292,454,2297,3718,9,34017,1889,1,2,4,6,74780,29913,6013,39583,0
126,5612,1782,648,1425,9,47,279,1791,8,171,97,189,179,286,1292,2140,4,9462,525,0,2,15,0,74780,29914,6014,39584,0
154,3603,77,34,69,0,0,8,77,3,24,16,29,27,45,114,213,1,387,21,0,2,1,0,74780,29914,6014,39585,1
154,3603,712,438,573,51,9,84,763,14,102,71,128,116,199,733,1364,8,11988,666,0,2,1,0,74790,29915,6014,39586,1
313,6841,72,33,56,0,4,12,72,1,1,1,1,2,2,0,2,0,1,0,0,2,7,5,74790,29915,6014,39587,1
313,6841,1454,835,1044,76,110,219,1530,17,275,158,296,292,454,2297,3718,9,34017,1889,1,2,7,5,74800,29916,6014,39588,1
80,4551,1296,573,1062,40,33,157,1336,8,201,118,231,209,349,1561,2689,4,12365,686,0,2,13,0,74800,29916,6014,39589,1
153,3603,77,34,69,0,0,8,77,3,24,16,29,27,45,114,213,1,387,21,0,2,13,11,74800,29916,6014,39590,0
153,3603,712,438,573,51,9,84,763,14,102,71,128,116,199,733,1364,8,11988,666,0,2,13,11,74810,29917,6014,39591,0
221,4701,2,2,2,0,0,0,2,0,0,0,0,0,0,0,0,0,0,0,0,2,2,2,74810,29917,6014,39591,0
221,4701,99,48,90,1,3,5,100,0,0,0,0,0,0,0,0,0,0,0,0,2,2,2,74810,29918,6014,39592,0
221,4701,8,5,5,2,0,1,10,0,0,0,0,0,0,0,0,0,0,0,0,2,2,2,74810,29918,6014,39593,0
221,4701,1217,716,841,84,126,174,1301,14,185,118,215,199,333,1446,2542,8,20687,1149,0,2,2,2,74820,29920,6014,39594,0
221,4701,160,89,115,0,13,31,160,7,15,11,17,22,28,78,124,3,495,27,0,2,2,2,74820,29920,6014,39595,0
221,4701,10,10,9,9,0,0,19,0,0,0,0,0,0,0,0,0,0,0,0,2,2,2,74820,29920,6015,39596,0
221,4701,173,84,99,8,29,36,181,5,12,7,13,17,20,54,81,2,221,12,0,2,2,2,74820,29921,6015,39597,0
221,4701,3,1,1,3,0,0,6,0,0,0,0,0,0,0,0,0,0,0,0,2,2,2,74820,29921,6015,39598,0
94,2454,773,422,505,30,103,129,803,14,77,46,83,91,129,535,839,7,6334,351,0,2,50,47,74830,29922,6016,39599,0
313,6832,72,33,56,0,4,12,72,1,1,1,1,2,2,0,2,0,1,0,0,2,4,6,74830,29922,6016,39600,0
313,6832,1454,835,1044,76,110,219,1530,17,275,158,296,292,454,2297,3718,9,34017,1889,1,2,4,6,74840,29923,6016,39601,0
92,1891,757,253,292,73,244,162,830,13,61,38,67,74,105,409,651,7,4654,258,0,2,8,0,74840,29924,6016,39602,0
241,5125,1943,715,1694,26,18,214,1969,12,185,120,237,197,357,1436,2721,7,20915,1161,0,2,8,7,74840,29926,6016,39603,0
241,5125,1168,838,957,57,25,144,1225,19,348,224,416,367,640,3018,5452,11,61921,3440,1,2,8,7,74850,29928,6016,39604,0
69,1323,1098,241,925,5,10,155,1103,7,46,25,49,53,74,273,423,3,1580,87,0,2,3,0,74860,29930,6016,39605,0
69,1323,282,202,222,14,2,44,296,8,42,24,43,50,67,250,378,4,1548,86,0,2,3,0,74860,29931,6016,39606,0
101,4167,1289,550,1043,56,32,155,1345,10,167,93,185,177,278,1266,2075,5,11498,638,0,2,14,0,74860,29933,6017,39607,0
2,40,13,9,8,0,0,4,13,0,0,0,0,0,0,0,0,0,0,0,0,0,13,0,74860,29933,6017,39608,0
2,42,14,10,9,0,0,4,14,0,0,0,0,0,0,0,0,0,0,0,0,0,14,0,74860,29933,6017,39609,0
2,33,12,8,7,0,0,4,12,0,0,0,0,0,0,0,0,0,0,0,0,0,12,0,74860,29933,6017,39610,0
126,5612,1782,648,1425,9,47,279,1791,8,171,97,189,179,286,1292,2140,4,9462,525,0,2,15,0,74860,29934,6018,39611,0
33,1041,256,139,192,9,7,47,265,4,23,12,24,27,36,112,171,2,357,19,0,2,48,0,74860,29935,6018,39612,0
169,5034,1660,832,1314,41,38,274,1701,20,312,209,395,332,604,2671,5058,12,64042,3557,1,2,13,36,74860,29937,6019,39614,0
101,5303,1943,715,1694,26,18,214,1969,12,185,120,237,197,357,1436,2721,7,20915,1161,0,2,5,2,74860,29939,6019,39615,0
52,1990,1098,241,925,5,10,155,1103,7,46,25,49,53,74,273,423,3,1580,87,0,2,15,0,74870,29941,6019,39616,0
154,3603,77,34,69,0,0,8,77,3,24,16,29,27,45,114,213,1,387,21,0,2,1,0,74870,29941,6019,39617,0
154,3603,712,438,573,51,9,84,763,14,102,71,128,116,199,733,1364,8,11988,666,0,2,1,0,74880,29942,6019,39618,0
313,6841,72,33,56,0,4,12,72,1,1,1,1,2,2,0,2,0,1,0,0,2,7,5,74880,29942,6019,39619,0
313,6841,1454,835,1044,76,110,219,1530,17,275,158,296,292,454,2297,3718,9,34017,1889,1,2,7,5,74890,29943,6019,39620,0
80,4551,1296,573,1062,40,33,157,1336,8,201,118,231,209,349,1561,2689,4,12365,686,0,2,13,0,74890,29943,6019,39621,0
154,3603,77,34,69,0,0,8,77,3,24,16,29,27,45,114,213,1,387,21,0,2,1,0,74890,29943,6019,39622,0
154,3603,712,438,573,51,9,84,763,14,102,71,128,116,199,733,1364,8,11988,666,0,2,1,0,74900,29944,6019,39623,0
313,6841,72,33,56,0,4,12,72,1,1,1,1,2,2,0,2,0,1,0,0,2,7,5,74900,29944,6019,39624,0
313,6841,1454,835,1044,76,110,219,1530,17,275,158,296,292,454,2297,3718,9,34017,1889,1,2,7,5,74910,29945,6019,39625,0
80,4551,1296,573,1062,40,33,157,1336,8,201,118,231,209,349,1561,2689,4,12365,686,0,2,13,0,74910,29945,6019,39626,0
221,4701,2,2,2,0,0,0,2,0,0,0,0,0,0,0,0,0,0,0,0,2,2,2,74910,29945,6019,39626,0
221,4701,99,48,90,1,3,5,100,0,0,0,0,0,0,0,0,0,0,0,0,2,2,2,74910,29946,6019,39627,0
221,4701,8,5,5,2,0,1,10,0,0,0,0,0,0,0,0,0,0,0,0,2,2,2,74910,29946,6019,39628,0
221,4701,1217,716,841,84,126,174,1301,14,185,118,215,199,333,1446,2542,8,20687,1149,0,2,2,2,74920,29948,6019,39629,0
221,4701,160,89,115,0,13,31,160,7,15,11,17,22,28,78,124,3,495,27,0,2,2,2,74920,29948,6019,39630,0
221,4701,10,10,9,9,0,0,19,0,0,0,0,0,0,0,0,0,0,0,0,2,2,2,74920,29948,6020,39631,0
221,4701,173,84,99,8,29,36,181,5,12,7,13,17,20,54,81,2,221,12,0,2,2,2,74920,29949,6020,39632,0
221,4701,3,1,1,3,0,0,6,0,0,0,0,0,0,0,0,0,0,0,0,2,2,2,74920,29949,6020,39633,0
94,2454,773,422,505,30,103,129,803,14,77,46,83,91,129,535,839,7,6334,351,0,2,50,47,74930,29950,6021,39634,0
154,3603,77,34,69,0,0,8,77,3,24,16,29,27,45,114,213,1,387,21,0,2,1,0,74930,29950,6021,39635,0
154,3603,712,438,573,51,9,84,763,14,102,71,128,116,199,733,1364,8,11988,666,0,2,1,0,74940,29951,6021,39636,0
313,6841,72,33,56,0,4,12,72,1,1,1,1,2,2,0,2,0,1,0,0,2,11,11,74940,29951,6021,39637,0
313,6841,1454,835,1044,76,110,219,1530,17,275,158,296,292,454,2297,3718,9,34017,1889,1,2,11,11,74950,29952,6021,39638,0
92,1891,757,253,292,73,244,162,830,13,61,38,67,74,105,409,651,7,4654,258,0,2,8,0,74950,29953,6021,39639,0
241,5125,1943,715,1694,26,18,214,1969,12,185,120,237,197,357,1436,2721,7,20915,1161,0,2,8,7,74950,29955,6021,39640,0
241,5125,1168,838,957,57,25,144,1225,19,348,224,416,367,640,3018,5452,11,61921,3440,1,2,8,7,74960,29957,6021,39641,0
69,1323,1098,241,925,5,10,155,1103,7,46,25,49,53,74,273,423,3,1580,87,0,2,3,0,74970,29959,6021,39642,0
69,1323,282,202,222,14,2,44,296,8,42,24,43,50,67,250,378,4,1548,86,0,2,3,0,74970,29960,6021,39643,0
101,4167,1289,550,1043,56,32,155,1345,10,167,93,185,177,278,1266,2075,5,11498,638,0,2,14,0,74970,29962,6022,39644,0
2,40,13,9,8,0,0,4,13,0,0,0,0,0,0,0,0,0,0,0,0,0,13,0,74970,29962,6022,39645,0
2,42,14,10,9,0,0,4,14,0,0,0,0,0,0,0,0,0,0,0,0,0,14,0,74970,29962,6022,39646,0
2,33,12,8,7,0,0,4,12,0,0,0,0,0,0,0,0,0,0,0,0,0,12,0,74970,29962,6022,39647,0
126,5612,1782,648,1425,9,47,279,1791,8,171,97,189,179,286,1292,2140,4,9462,525,0,2,15,0,74970,29963,6023,39648,0
33,1041,256,139,192,9,7,47,265,4,23,12,24,27,36,112,171,2,357,19,0,2,48,0,74970,29964,6023,39649,0
169,5034,1660,832,1314,41,38,274,1701,20,312,209,395,332,604,2671,5058,12,64042,3557,1,2,13,36,74970,29966,6024,39651,0
80,4551,1296,573,1062,40,33,157,1336,8,201,118,231,209,349,1561,2689,4,12365,686,0,2,13,0,74970,29966,6024,39652,0
101,5303,1943,715,1694,26,18,214,1969,12,185,120,237,197,357,1436,2721,7,20915,1161,0,2,5,2,74970,29968,6024,39653,0
52,1990,1098,241,925,5,10,155,1103,7,46,25,49,53,74,273,423,3,1580,87,0,2,15,0,74980,29970,6024,39654,0
153,3609,77,34,69,0,0,8,77,3,24,16,29,27,45,114,213,1,387,21,0,2,13,11,74980,29970,6024,39655,0
153,3609,712,438,573,51,9,84,763,14,102,71,128,116,199,733,1364,8,11988,666,0,2,13,11,74990,29971,6024,39656,0
221,4705,2,2,2,0,0,0,2,0,0,0,0,0,0,0,0,0,0,0,0,2,4,1,74990,29971,6024,39656,0
221,4705,99,48,90,1,3,5,100,0,0,0,0,0,0,0,0,0,0,0,0,2,4,1,74990,29972,6024,39657,0
221,4705,8,5,5,2,0,1,10,0,0,0,0,0,0,0,0,0,0,0,0,2,4,1,74990,29972,6024,39658,0
221,4705,1217,716,841,84,126,174,1301,14,185,118,215,199,333,1446,2542,8,20687,1149,0,2,4,1,75000,29974,6024,39659,0
221,4705,160,89,115,0,13,31,160,7,15,11,17,22,28,78,124,3,495,27,0,2,4,1,75000,29974,6024,39660,0
221,4705,10,10,9,9,0,0,19,0,0,0,0,0,0,0,0,0,0,0,0,2,4,1,75000,29974,6025,39661,0
221,4705,173,84,99,8,29,36,181,5,12,7,13,17,20,54,81,2,221,12,0,2,4,1,75000,29975,6025,39662,0
221,4705,3,1,1,3,0,0,6,0,0,0,0,0,0,0,0,0,0,0,0,2,4,1,75000,29975,6025,39663,0
43,2676,652,304,544,16,6,88,668,6,89,51,101,95,152,591,998,3,3399,188,0,2,36,0,75000,29976,6025,39664,0
246,5902,722,423,573,19,0,135,741,12,172,101,199,184,300,1320,2257,6,15668,870,0,2,6,0,75000,29978,6025,39666,0
246,5902,1508,847,911,44,250,301,1552,14,148,88,169,162,257,1120,1886,7,15077,837,0,2,6,0,75000,29979,6026,39667,0
48,2297,722,423,573,19,0,135,741,12,172,101,199,184,300,1320,2257,6,15668,870,0,2,11,0,75000,29981,6026,39669,0
159,3705,77,34,69,0,0,8,77,3,24,16,29,27,45,114,213,1,387,21,0,2,21,0,75000,29981,6026,39670,0
159,3705,712,438,573,51,9,84,763,14,102,71,128,116,199,733,1364,8,11988,666,0,2,21,0,75010,29982,6026,39671,0
81,4624,1296,573,1062,40,33,157,1336,8,201,118,231,209,349,1561,2689,4,12365,686,0,2,20,0,75010,29982,6026,39672,0
30,1324,373,158,315,8,0,51,381,5,76,44,79,81,123,486,779,2,2026,112,0,2,15,0,75010,29982,6026,39673,0
94,2418,773,422,505,30,103,129,803,14,77,46,83,91,129,535,839,7,6334,351,0,2,0,7,75020,29983,6027,39674,0
247,5178,1943,715,1694,26,18,214,1969,12,185,120,237,197,357,1436,2721,7,20915,1161,0,2,23,4,75020,29985,6027,39675,0
247,5178,1168,838,957,57,25,144,1225,19,348,224,416,367,640,3018,5452,11,61921,3440,1,2,23,4,75030,29987,6027,39676,0
246,5902,722,423,573,19,0,135,741,12,172,101,199,184,300,1320,2257,6,15668,870,0,2,6,0,75030,29989,6027,39678,0
246,5902,1508,847,911,44,250,301,1552,14,148,88,169,162,257,1120,1886,7,15077,837,0,2,6,0,75030,29990,6028,39679,0
48,2297,722,423,573,19,0,135,741,12,172,101,199,184,300,1320,2257,6,15668,870,0,2,11,0,75030,29992,6028,39681,0
245,5880,722,423,573,19,0,135,741,12,172,101,199,184,300,1320,2257,6,15668,870,0,2,5,1,75030,29994,6028,39683,0
245,5880,1508,847,911,44,250,301,1552,14,148,88,169,162,257,1120,1886,7,15077,837,0,2,5,1,75030,29995,6029,39684,0
45,1291,339,213,244,17,9,65,356,10,42,26,48,52,74,259,421,5,2410,133,0,2,22,13,75040,29995,6029,39685,1
66,3225,1293,570,1093,25,15,163,1318,10,195,123,241,205,364,1516,2795,6,17273,959,0,2,70,0,75050,29997,6029,39686,1
153,3613,77,34,69,0,0,8,77,3,24,16,29,27,45,114,213,1,387,21,0,2,1,1,75050,29997,6029,39687,0
153,3613,712,438,573,51,9,84,763,14,102,71,128,116,199,733,1364,8,11988,666,0,2,1,1,75060,29998,6029,39688,0
81,4663,1296,573,1062,40,33,157,1336,8,201,118,231,209,349,1561,2689,4,12365,686,0,2,29,0,75060,29998,6029,39689,0
153,3613,77,34,69,0,0,8,77,3,24,16,29,27,45,114,213,1,387,21,0,2,1,1,75060,29998,6029,39690,0
153,3613,712,438,573,51,9,84,763,14,102,71,128,116,199,733,1364,8,11988,666,0,2,1,1,75070,29999,6029,39691,0
81,4663,1296,573,1062,40,33,157,1336,8,201,118,231,209,349,1561,2689,4,12365,686,0,2,29,0,75070,29999,6029,39692,0
228,4801,2,2,2,0,0,0,2,0,0,0,0,0,0,0,0,0,0,0,0,2,38,8,75070,29999,6029,39692,0
228,4801,99,48,90,1,3,5,100,0,0,0,0,0,0,0,0,0,0,0,0,2,38,8,75070,30000,6029,39693,0
228,4801,8,5,5,2,0,1,10,0,0,0,0,0,0,0,0,0,0,0,0,2,38,8,75070,30000,6029,39694,0
228,4801,1217,716,841,84,126,174,1301,14,185,118,215,199,333,1446,2542,8,20687,1149,0,2,38,8,75080,30002,6029,39695,0
228,4801,160,89,115,0,13,31,160,7,15,11,17,22,28,78,124,3,495,27,0,2,38,8,75080,30002,6029,39696,0
228,4801,10,10,9,9,0,0,19,0,0,0,0,0,0,0,0,0,0,0,0,2,38,8,75080,30002,6030,39697,0
228,4801,173,84,99,8,29,36,181,5,12,7,13,17,20,54,81,2,221,12,0,2,38,8,75080,30003,6030,39698,0
228,4801,3,1,1,3,0,0,6,0,0,0,0,0,0,0,0,0,0,0,0,2,38,8,75080,30003,6030,39699,0
98,2019,463,295,324,28,62,57,491,12,134,82,154,146,236,989,1696,6,11700,650,0,2,8,11,75090,30004,6030,39700,0
28,978,74,35,59,1,0,14,75,3,14,7,14,17,21,58,85,1,128,7,0,2,12,8,75090,30005,6030,39701,0
28,978,245,125,200,5,7,34,250,7,30,17,34,37,51,166,265,3,1053,58,0,2,12,8,75100,30006,6030,39702,0
92,4896,1457,730,1242,11,6,188,1468,10,292,166,329,302,495,2424,4078,5,22973,1276,1,2,73,3,75100,30008,6030,39703,0
39,2350,334,251,279,10,4,40,344,5,127,74,143,132,217,899,1528,2,4303,239,0,2,3,4,75100,30009,6030,39704,0
245,5880,722,423,573,19,0,135,741,12,172,101,199,184,300,1320,2257,6,15668,870,0,2,5,1,75100,30011,6030,39706,0
245,5880,1508,847,911,44,250,301,1552,14,148,88,169,162,257,1120,1886,7,15077,837,0,2,5,1,75100,30012,6031,39707,0
221,4705,2,2,2,0,0,0,2,0,0,0,0,0,0,0,0,0,0,0,0,2,1,1,75100,30012,6031,39707,0
221,4705,99,48,90,1,3,5,100,0,0,0,0,0,0,0,0,0,0,0,0,2,1,1,75100,30013,6031,39708,0
221,4705,8,5,5,2,0,1,10,0,0,0,0,0,0,0,0,0,0,0,0,2,1,1,75100,30013,6031,39709,0
221,4705,1217,716,841,84,126,174,1301,14,185,118,215,199,333,1446,2542,8,20687,1149,0,2,1,1,75110,30015,6031,39710,0
221,4705,160,89,115,0,13,31,160,7,15,11,17,22,28,78,124,3,495,27,0,2,1,1,75110,30015,6031,39711,0
221,4705,10,10,9,9,0,0,19,0,0,0,0,0,0,0,0,0,0,0,0,2,1,1,75110,30015,6032,39712,0
221,4705,173,84,99,8,29,36,181,5,12,7,13,17,20,54,81,2,221,12,0,2,1,1,75110,30016,6032,39713,0
221,4705,3,1,1,3,0,0,6,0,0,0,0,0,0,0,0,0,0,0,0,2,1,1,75110,30016,6032,39714,0
1,106,42,7,35,4,0,5,46,1,2,1,2,3,3,2,4,0,2,0,0,2,2,1,75110,30016,6032,39715,0
1,106,11,6,10,0,0,1,11,2,4,2,4,6,6,10,15,1,15,0,0,2,2,1,75110,30016,6032,39716,0
237,5024,1943,715,1694,26,18,214,1969,12,185,120,237,197,357,1436,2721,7,20915,1161,0,2,0,15,75110,30018,6032,39717,0
237,5024,1168,838,957,57,25,144,1225,19,348,224,416,367,640,3018,5452,11,61921,3440,1,2,0,15,75120,30020,6032,39718,0
100,4148,1289,550,1043,56,32,155,1345,10,167,93,185,177,278,1266,2075,5,11498,638,0,2,1,3,75120,30022,6033,39719,0
14,843,75,38,59,1,3,12,76,2,4,2,4,6,6,10,15,1,15,0,0,2,0,19,75120,30022,6033,39720,0
245,5666,4293,999,3693,19,54,507,4312,9,155,88,170,164,258,1156,1898,4,9368,520,0,2,2,2,75120,30024,6033,39721,0
245,5666,1482,859,1002,125,135,219,1607,16,219,134,251,235,385,1766,3032,9,27804,1544,1,2,2,2,75130,30025,6033,39722,0
228,4801,2,2,2,0,0,0,2,0,0,0,0,0,0,0,0,0,0,0,0,2,38,8,75130,30025,6033,39722,0
228,4801,99,48,90,1,3,5,100,0,0,0,0,0,0,0,0,0,0,0,0,2,38,8,75130,30026,6033,39723,0
228,4801,8,5,5,2,0,1,10,0,0,0,0,0,0,0,0,0,0,0,0,2,38,8,75130,30026,6033,39724,0
228,4801,1217,716,841,84,126,174,1301,14,185,118,215,199,333,1446,2542,8,20687,1149,0,2,38,8,75140,30028,6033,39725,0
228,4801,160,89,115,0,13,31,160,7,15,11,17,22,28,78,124,3,495,27,0,2,38,8,75140,30028,6033,39726,0
228,4801,10,10,9,9,0,0,19,0,0,0,0,0,0,0,0,0,0,0,0,2,38,8,75140,30028,6034,39727,0
228,4801,173,84,99,8,29,36,181,5,12,7,13,17,20,54,81,2,221,12,0,2,38,8,75140,30029,6034,39728,0
228,4801,3,1,1,3,0,0,6,0,0,0,0,0,0,0,0,0,0,0,0,2,38,8,75140,30029,6034,39729,0
98,2019,463,295,324,28,62,57,491,12,134,82,154,146,236,989,1696,6,11700,650,0,2,8,11,75150,30030,6034,39730,0
28,978,74,35,59,1,0,14,75,3,14,7,14,17,21,58,85,1,128,7,0,2,12,8,75150,30031,6034,39731,0
28,978,245,125,200,5,7,34,250,7,30,17,34,37,51,166,265,3,1053,58,0,2,12,8,75160,30032,6034,39732,0
92,4896,1457,730,1242,11,6,188,1468,10,292,166,329,302,495,2424,4078,5,22973,1276,1,2,73,3,75160,30034,6034,39733,0
39,2350,334,251,279,10,4,40,344,5,127,74,143,132,217,899,1528,2,4303,239,0,2,3,4,75160,30035,6034,39734,0
1,106,42,7,35,4,0,5,46,1,2,1,2,3,3,2,4,0,2,0,0,2,2,1,75160,30035,6034,39735,0
1,106,11,6,10,0,0,1,11,2,4,2,4,6,6,10,15,1,15,0,0,2,2,1,75160,30035,6034,39736,0
45,1291,339,213,244,17,9,65,356,10,42,26,48,52,74,259,421,5,2410,133,0,2,22,13,75170,30035,6034,39737,0
66,3225,1293,570,1093,25,15,163,1318,10,195,123,241,205,364,1516,2795,6,17273,959,0,2,70,0,75180,30037,6034,39738,0
245,5666,4293,999,3693,19,54,507,4312,9,155,88,170,164,258,1156,1898,4,9368,520,0,2,2,2,75180,30039,6034,39739,0
245,5666,1482,859,1002,125,135,219,1607,16,219,134,251,235,385,1766,3032,9,27804,1544,1,2,2,2,75190,30040,6034,39740,0
237,5024,1943,715,1694,26,18,214,1969,12,185,120,237,197,357,1436,2721,7,20915,1161,0,2,0,15,75190,30042,6034,39741,0
237,5024,1168,838,957,57,25,144,1225,19,348,224,416,367,640,3018,5452,11,61921,3440,1,2,0,15,75200,30044,6034,39742,0
100,4148,1289,550,1043,56,32,155,1345,10,167,93,185,177,278,1266,2075,5,11498,638,0,2,1,3,75200,30046,6035,39743,0
14,843,75,38,59,1,3,12,76,2,4,2,4,6,6,10,15,1,15,0,0,2,0,19,75200,30046,6035,39744,0
1,106,42,7,35,4,0,5,46,1,2,1,2,3,3,2,4,0,2,0,0,2,2,1,75200,30046,6035,39745,0
1,106,11,6,10,0,0,1,11,2,4,2,4,6,6,10,15,1,15,0,0,2,2,1,75200,30046,6035,39746,0
228,4805,2,2,2,0,0,0,2,0,0,0,0,0,0,0,0,0,0,0,0,2,4,1,75200,30046,6035,39746,0
228,4805,99,48,90,1,3,5,100,0,0,0,0,0,0,0,0,0,0,0,0,2,4,1,75200,30047,6035,39747,0
228,4805,8,5,5,2,0,1,10,0,0,0,0,0,0,0,0,0,0,0,0,2,4,1,75200,30047,6035,39748,0
228,4805,1217,716,841,84,126,174,1301,14,185,118,215,199,333,1446,2542,8,20687,1149,0,2,4,1,75210,30049,6035,39749,0
228,4805,160,89,115,0,13,31,160,7,15,11,17,22,28,78,124,3,495,27,0,2,4,1,75210,30049,6035,39750,0
228,4805,10,10,9,9,0,0,19,0,0,0,0,0,0,0,0,0,0,0,0,2,4,1,75210,30049,6036,39751,0
228,4805,173,84,99,8,29,36,181,5,12,7,13,17,20,54,81,2,221,12,0,2,4,1,75210,30050,6036,39752,0
228,4805,3,1,1,3,0,0,6,0,0,0,0,0,0,0,0,0,0,0,0,2,4,1,75210,30050,6036,39753,0
45,1291,339,213,244,17,9,65,356,10,42,26,48,52,74,259,421,5,2410,133,0,2,22,13,75220,30050,6036,39754,0
245,5666,4293,999,3693,19,54,507,4312,9,155,88,170,164,258,1156,1898,4,9368,520,0,2,2,2,75220,30052,6036,39755,0
245,5666,1482,859,1002,125,135,219,1607,16,219,134,251,235,385,1766,3032,9,27804,1544,1,2,2,2,75230,30053,6036,39756,0
94,2418,773,422,505,30,103,129,803,14,77,46,83,91,129,535,839,7,6334,351,0,2,0,7,75240,30054,6037,39757,0
158,3715,77,34,69,0,0,8,77,3,24,16,29,27,45,114,213,1,387,21,0,2,14,12,75240,30054,6037,39758,0
158,3715,712,438,573,51,9,84,763,14,102,71,128,116,199,733,1364,8,11988,666,0,2,14,12,75250,30055,6037,39759,0
246,5918,722,423,573,19,0,135,741,12,172,101,199,184,300,1320,2257,6,15668,870,0,2,5,1,75250,30057,6037,39761,0
246,5918,1508,847,911,44,250,301,1552,14,148,88,169,162,257,1120,1886,7,15077,837,0,2,5,1,75250,30058,6038,39762,0
243,5077,1943,715,1694,26,18,214,1969,12,185,120,237,197,357,1436,2721,7,20915,1161,0,2,23,4,75250,30060,6038,39763,0
243,5077,1168,838,957,57,25,144,1225,19,348,224,416,367,640,3018,5452,11,61921,3440,1,2,23,4,75260,30062,6038,39764,0
82,4736,1296,573,1062,40,33,157,1336,8,201,118,231,209,349,1561,2689,4,12365,686,0,2,29,0,75260,30062,6038,39765,0
43,2676,652,304,544,16,6,88,668,6,89,51,101,95,152,591,998,3,3399,188,0,2,36,0,75260,30063,6038,39766,0
66,3225,1293,570,1093,25,15,163,1318,10,195,123,241,205,364,1516,2795,6,17273,959,0,2,70,0,75270,30065,6038,39767,0
1,106,42,7,35,4,0,5,46,1,2,1,2,3,3,2,4,0,2,0,0,2,2,1,75270,30065,6038,39768,0
1,106,11,6,10,0,0,1,11,2,4,2,4,6,6,10,15,1,15,0,0,2,2,1,75270,30065,6038,39769,0
228,4805,2,2,2,0,0,0,2,0,0,0,0,0,0,0,0,0,0,0,0,2,4,1,75270,30065,6038,39769,0
228,4805,99,48,90,1,3,5,100,0,0,0,0,0,0,0,0,0,0,0,0,2,4,1,75270,30066,6038,39770,0
228,4805,8,5,5,2,0,1,10,0,0,0,0,0,0,0,0,0,0,0,0,2,4,1,75270,30066,6038,39771,0
228,4805,1217,716,841,84,126,174,1301,14,185,118,215,199,333,1446,2542,8,20687,1149,0,2,4,1,75280,30068,6038,39772,0
228,4805,160,89,115,0,13,31,160,7,15,11,17,22,28,78,124,3,495,27,0,2,4,1,75280,30068,6038,39773,0
228,4805,10,10,9,9,0,0,19,0,0,0,0,0,0,0,0,0,0,0,0,2,4,1,75280,30068,6039,39774,0
228,4805,173,84,99,8,29,36,181,5,12,7,13,17,20,54,81,2,221,12,0,2,4,1,75280,30069,6039,39775,0
228,4805,3,1,1,3,0,0,6,0,0,0,0,0,0,0,0,0,0,0,0,2,4,1,75280,30069,6039,39776,0
45,1291,339,213,244,17,9,65,356,10,42,26,48,52,74,259,421,5,2410,133,0,2,22,13,75290,30069,6039,39777,0
245,5666,4293,999,3693,19,54,507,4312,9,155,88,170,164,258,1156,1898,4,9368,520,0,2,2,2,75290,30071,6039,39778,0
245,5666,1482,859,1002,125,135,219,1607,16,219,134,251,235,385,1766,3032,9,27804,1544,1,2,2,2,75300,30072,6039,39779,0
94,2418,773,422,505,30,103,129,803,14,77,46,83,91,129,535,839,7,6334,351,0,2,0,7,75310,30073,6040,39780,0
158,3715,77,34,69,0,0,8,77,3,24,16,29,27,45,114,213,1,387,21,0,2,14,12,75310,30073,6040,39781,0
158,3715,712,438,573,51,9,84,763,14,102,71,128,116,199,733,1364,8,11988,666,0,2,14,12,75320,30074,6040,39782,0
246,5918,722,423,573,19,0,135,741,12,172,101,199,184,300,1320,2257,6,15668,870,0,2,5,1,75320,30076,6040,39784,0
246,5918,1508,847,911,44,250,301,1552,14,148,88,169,162,257,1120,1886,7,15077,837,0,2,5,1,75320,30077,6041,39785,0
243,5077,1943,715,1694,26,18,214,1969,12,185,120,237,197,357,1436,2721,7,20915,1161,0,2,23,4,75320,30079,6041,39786,0
243,5077,1168,838,957,57,25,144,1225,19,348,224,416,367,640,3018,5452,11,61921,3440,1,2,23,4,75330,30081,6041,39787,0
82,4736,1296,573,1062,40,33,157,1336,8,201,118,231,209,349,1561,2689,4,12365,686,0,2,29,0,75330,30081,6041,39788,0
43,2676,652,304,544,16,6,88,668,6,89,51,101,95,152,591,998,3,3399,188,0,2,36,0,75330,30082,6041,39789,0
66,3225,1293,570,1093,25,15,163,1318,10,195,123,241,205,364,1516,2795,6,17273,959,0,2,70,0,75340,30084,6041,39790,0
153,3638,77,34,69,0,0,8,77,3,24,16,29,27,45,114,213,1,387,21,0,2,6,1,75340,30084,6041,39791,0
153,3638,712,438,573,51,9,84,763,14,102,71,128,116,199,733,1364,8,11988,666,0,2,6,1,75350,30085,6041,39792,0
314,6872,72,33,56,0,4,12,72,1,1,1,1,2,2,0,2,0,1,0,0,2,14,6,75350,30085,6041,39793,0
314,6872,1454,835,1044,76,110,219,1530,17,275,158,296,292,454,2297,3718,9,34017,1889,1,2,14,6,75360,30086,6041,39794,0
83,4788,1296,573,1062,40,33,157,1336,8,201,118,231,209,349,1561,2689,4,12365,686,0,2,27,0,75360,30086,6041,39795,0
19,720,442,244,305,14,16,103,456,11,68,45,75,79,120,452,756,6,4588,254,0,2,1,1,75360,30088,6041,39796,0
19,720,182,102,99,11,40,35,193,3,11,6,11,14,17,42,64,1,97,5,0,2,1,1,75360,30089,6041,39797,0
19,720,442,244,305,14,16,103,456,11,68,45,75,79,120,452,756,6,4588,254,0,2,1,1,75360,30091,6041,39798,0
19,720,182,102,99,11,40,35,193,3,11,6,11,14,17,42,64,1,97,5,0,2,1,1,75360,30092,6041,39799,0
153,3638,77,34,69,0,0,8,77,3,24,16,29,27,45,114,213,1,387,21,0,2,6,1,75360,30092,6041,39800,0
153,3638,712,438,573,51,9,84,763,14,102,71,128,116,199,733,1364,8,11988,666,0,2,6,1,75370,30093,6041,39801,0
314,6872,72,33,56,0,4,12,72,1,1,1,1,2,2,0,2,0,1,0,0,2,14,6,75370,30093,6041,39802,0
314,6872,1454,835,1044,76,110,219,1530,17,275,158,296,292,454,2297,3718,9,34017,1889,1,2,14,6,75380,30094,6041,39803,0
83,4788,1296,573,1062,40,33,157,1336,8,201,118,231,209,349,1561,2689,4,12365,686,0,2,27,0,75380,30094,6041,39804,0
74,1599,53,23,39,0,0,13,53,2,8,4,8,10,12,26,39,1,39,2,0,2,2,1,75380,30094,6041,39805,0
74,1599,515,298,307,33,80,99,548,12,63,44,77,75,121,419,753,7,5527,307,0,2,2,1,75390,30094,6041,39806,0
99,2610,773,422,505,30,103,129,803,14,77,46,83,91,129,535,839,7,6334,351,0,2,41,11,75400,30095,6042,39807,0
35,2389,1157,318,931,29,22,177,1186,6,104,63,125,110,188,712,1274,3,4596,255,0,2,48,0,75400,30095,6042,39808,0
248,5184,1943,715,1694,26,18,214,1969,12,185,120,237,197,357,1436,2721,7,20915,1161,0,2,3,1,75400,30097,6042,39809,1
248,5184,1168,838,957,57,25,144,1225,19,348,224,416,367,640,3018,5452,11,61921,3440,1,2,3,1,75410,30099,6042,39810,1
170,5066,1660,832,1314,41,38,274,1701,20,312,209,395,332,604,2671,5058,12,64042,3557,1,2,10,3,75410,30101,6043,39812,1
248,5184,1943,715,1694,26,18,214,1969,12,185,120,237,197,357,1436,2721,7,20915,1161,0,2,3,1,75410,30103,6043,39813,0
248,5184,1168,838,957,57,25,144,1225,19,348,224,416,367,640,3018,5452,11,61921,3440,1,2,3,1,75420,30105,6043,39814,0
170,5066,1660,832,1314,41,38,274,1701,20,312,209,395,332,604,2671,5058,12,64042,3557,1,2,10,3,75420,30107,6044,39816,0
74,1599,53,23,39,0,0,13,53,2,8,4,8,10,12,26,39,1,39,2,0,2,2,1,75420,30107,6044,39817,0
74,1599,515,298,307,33,80,99,548,12,63,44,77,75,121,419,753,7,5527,307,0,2,2,1,75430,30107,6044,39818,0
99,2574,773,422,505,30,103,129,803,14,77,46,83,91,129,535,839,7,6334,351,0,2,41,11,75440,30108,6045,39819,0
35,2389,1157,318,931,29,22,177,1186,6,104,63,125,110,188,712,1274,3,4596,255,0,2,48,0,75440,30108,6045,39820,0
158,3740,77,34,69,0,0,8,77,3,24,16,29,27,45,114,213,1,387,21,0,2,6,1,75440,30108,6045,39821,0
158,3740,712,438,573,51,9,84,763,14,102,71,128,116,199,733,1364,8,11988,666,0,2,6,1,75450,30109,6045,39822,0
74,1599,53,23,39,0,0,13,53,2,8,4,8,10,12,26,39,1,39,2,0,2,2,1,75450,30109,6045,39823,0
74,1599,515,298,307,33,80,99,548,12,63,44,77,75,121,419,753,7,5527,307,0,2,2,1,75460,30109,6045,39824,0
314,6872,72,33,56,0,4,12,72,1,1,1,1,2,2,0,2,0,1,0,0,2,14,6,75460,30109,6045,39825,0
314,6872,1454,835,1044,76,110,219,1530,17,275,158,296,292,454,2297,3718,9,34017,1889,1,2,14,6,75470,30110,6045,39826,0
244,5083,1943,715,1694,26,18,214,1969,12,185,120,237,197,357,1436,2721,7,20915,1161,0,2,3,1,75470,30112,6045,39827,0
244,5083,1168,838,957,57,25,144,1225,19,348,224,416,367,640,3018,5452,11,61921,3440,1,2,3,1,75480,30114,6045,39828,0
19,720,442,244,305,14,16,103,456,11,68,45,75,79,120,452,756,6,4588,254,0,2,1,1,75480,30116,6045,39829,0
19,720,182,102,99,11,40,35,193,3,11,6,11,14,17,42,64,1,97,5,0,2,1,1,75480,30117,6045,39830,0
170,5066,1660,832,1314,41,38,274,1701,20,312,209,395,332,604,2671,5058,12,64042,3557,1,2,10,3,75480,30119,6046,39832,0
84,4861,1296,573,1062,40,33,157,1336,8,201,118,231,209,349,1561,2689,4,12365,686,0,2,27,0,75480,30119,6046,39833,0
95,2929,773,419,590,28,0,166,801,10,204,113,217,214,330,1598,2554,5,13587,754,0,2,8,3,75480,30119,6047,39834,0
81,3273,1178,367,1042,6,15,115,1184,9,94,51,95,103,146,644,976,4,4439,246,0,2,4,1,75480,30119,6047,39835,0
95,2929,773,419,590,28,0,166,801,10,204,113,217,214,330,1598,2554,5,13587,754,0,2,8,3,75480,30119,6048,39836,0
81,3273,1178,367,1042,6,15,115,1184,9,94,51,95,103,146,644,976,4,4439,246,0,2,4,1,75480,30119,6048,39837,0
228,4805,2,2,2,0,0,0,2,0,0,0,0,0,0,0,0,0,0,0,0,2,38,8,75480,30119,6048,39837,0
228,4805,99,48,90,1,3,5,100,0,0,0,0,0,0,0,0,0,0,0,0,2,38,8,75480,30120,6048,39838,0
228,4805,8,5,5,2,0,1,10,0,0,0,0,0,0,0,0,0,0,0,0,2,38,8,75480,30120,6048,39839,0
228,4805,1217,716,841,84,126,174,1301,14,185,118,215,199,333,1446,2542,8,20687,1149,0,2,38,8,75490,30122,6048,39840,0
228,4805,160,89,115,0,13,31,160,7,15,11,17,22,28,78,124,3,495,27,0,2,38,8,75490,30122,6048,39841,0
228,4805,10,10,9,9,0,0,19,0,0,0,0,0,0,0,0,0,0,0,0,2,38,8,75490,30122,6049,39842,0
228,4805,173,84,99,8,29,36,181,5,12,7,13,17,20,54,81,2,221,12,0,2,38,8,75490,30123,6049,39843,0
228,4805,3,1,1,3,0,0,6,0,0,0,0,0,0,0,0,0,0,0,0,2,38,8,75490,30123,6049,39844,0
98,2019,463,295,324,28,62,57,491,12,134,82,154,146,236,989,1696,6,11700,650,0,2,8,11,75500,30124,6049,39845,0
28,978,74,35,59,1,0,14,75,3,14,7,14,17,21,58,85,1,128,7,0,2,12,8,75500,30125,6049,39847,0
28,978,245,125,200,5,7,34,250,7,30,17,34,37,51,166,265,3,1053,58,0,2,12,8,75510,30126,6049,39848,0
99,2574,773,422,505,30,103,129,803,14,77,46,83,91,129,535,839,7,6334,351,0,2,41,11,75520,30127,6050,39849,0
158,3740,77,34,69,0,0,8,77,3,24,16,29,27,45,114,213,1,387,21,0,2,21,0,75520,30127,6050,39850,0
158,3740,712,438,573,51,9,84,763,14,102,71,128,116,199,733,1364,8,11988,666,0,2,21,0,75530,30128,6050,39851,0
246,5918,722,423,573,19,0,135,741,12,172,101,199,184,300,1320,2257,6,15668,870,0,2,6,0,75530,30130,6050,39853,0
246,5918,1508,847,911,44,250,301,1552,14,148,88,169,162,257,1120,1886,7,15077,837,0,2,6,0,75530,30131,6051,39854,0
45,955,386,256,301,16,9,68,402,4,59,35,69,63,104,355,621,2,1453,80,0,2,8,5,75530,30131,6051,39855,0
45,955,264,131,164,11,41,46,275,6,38,22,40,44,62,214,338,3,1068,59,0,2,8,5,75540,30131,6052,39856,0
244,5083,1943,715,1694,26,18,214,1969,12,185,120,237,197,357,1436,2721,7,20915,1161,0,2,0,15,75540,30133,6052,39857,0
244,5083,1168,838,957,57,25,144,1225,19,348,224,416,367,640,3018,5452,11,61921,3440,1,2,0,15,75550,30135,6052,39858,0
100,4148,1289,550,1043,56,32,155,1345,10,167,93,185,177,278,1266,2075,5,11498,638,0,2,1,3,75550,30137,6053,39859,0
14,843,75,38,59,1,3,12,76,2,4,2,4,6,6,10,15,1,15,0,0,2,7,17,75550,30137,6053,39860,0
35,2389,1157,318,931,29,22,177,1186,6,104,63,125,110,188,712,1274,3,4596,255,0,2,48,0,75550,30137,6053,39861,0
84,4861,1296,573,1062,40,33,157,1336,8,201,118,231,209,349,1561,2689,4,12365,686,0,2,20,0,75550,30137,6053,39862,0
92,4896,1457,730,1242,11,6,188,1468,10,292,166,329,302,495,2424,4078,5,22973,1276,1,2,73,3,75550,30139,6053,39863,0
39,2350,334,251,279,10,4,40,344,5,127,74,143,132,217,899,1528,2,4303,239,0,2,3,4,75550,30140,6053,39864,0
48,2297,722,423,573,19,0,135,741,12,172,101,199,184,300,1320,2257,6,15668,870,0,2,11,0,75550,30142,6053,39866,0
30,1324,373,158,315,8,0,51,381,5,76,44,79,81,123,486,779,2,2026,112,0,2,15,0,75550,30142,6053,39867,0
158,3740,77,34,69,0,0,8,77,3,24,16,29,27,45,114,213,1,387,21,0,2,6,1,75550,30142,6053,39869,0
158,3740,712,438,573,51,9,84,763,14,102,71,128,116,199,733,1364,8,11988,666,0,2,6,1,75560,30143,6053,39870,0
74,1599,53,23,39,0,0,13,53,2,8,4,8,10,12,26,39,1,39,2,0,2,2,1,75560,30143,6053,39871,0
74,1599,515,298,307,33,80,99,548,12,63,44,77,75,121,419,753,7,5527,307,0,2,2,1,75570,30143,6053,39872,0
314,6872,72,33,56,0,4,12,72,1,1,1,1,2,2,0,2,0,1,0,0,2,14,6,75570,30143,6053,39873,0
314,6872,1454,835,1044,76,110,219,1530,17,275,158,296,292,454,2297,3718,9,34017,1889,1,2,14,6,75580,30144,6053,39874,0
244,5083,1943,715,1694,26,18,214,1969,12,185,120,237,197,357,1436,2721,7,20915,1161,0,2,3,1,75580,30146,6053,39875,0
244,5083,1168,838,957,57,25,144,1225,19,348,224,416,367,640,3018,5452,11,61921,3440,1,2,3,1,75590,30148,6053,39876,0
19,720,442,244,305,14,16,103,456,11,68,45,75,79,120,452,756,6,4588,254,0,2,1,1,75590,30150,6053,39877,0
19,720,182,102,99,11,40,35,193,3,11,6,11,14,17,42,64,1,97,5,0,2,1,1,75590,30151,6053,39878,0
95,2929,773,419,590,28,0,166,801,10,204,113,217,214,330,1598,2554,5,13587,754,0,2,8,3,75590,30151,6054,39879,0
170,5066,1660,832,1314,41,38,274,1701,20,312,209,395,332,604,2671,5058,12,64042,3557,1,2,10,3,75590,30153,6055,39881,0
84,4861,1296,573,1062,40,33,157,1336,8,201,118,231,209,349,1561,2689,4,12365,686,0,2,27,0,75590,30153,6055,39882,0
81,3273,1178,367,1042,6,15,115,1184,9,94,51,95,103,146,644,976,4,4439,246,0,2,4,1,75590,30153,6055,39883,0
100,2600,773,422,505,30,103,129,803,14,77,46,83,91,129,535,839,7,6334,351,0,2,5,0,75600,30154,6056,39885,0
36,2459,1157,318,931,29,22,177,1186,6,104,63,125,110,188,712,1274,3,4596,255,0,2,34,0,75600,30154,6056,39886,0
100,2600,773,422,505,30,103,129,803,14,77,46,83,91,129,535,839,7,6334,351,0,2,5,0,75610,30155,6057,39887,0
36,2459,1157,318,931,29,22,177,1186,6,104,63,125,110,188,712,1274,3,4596,255,0,2,34,0,75610,30155,6057,39888,0
124,4939,1450,624,1228,12,26,181,1462,14,306,186,354,320,540,2580,4493,8,36391,2021,1,2,1,1,75610,30157,6058,39889,0
92,4912,1457,730,1242,11,6,188,1468,10,292,166,329,302,495,2424,4078,5,22973,1276,1,2,7,7,75610,30159,6058,39890,0
100,2600,773,422,505,30,103,129,803,14,77,46,83,91,129,535,839,7,6334,351,0,2,5,0,75620,30160,6059,39891,0
36,2459,1157,318,931,29,22,177,1186,6,104,63,125,110,188,712,1274,3,4596,255,0,2,34,0,75620,30160,6059,39893,0
124,4939,1450,624,1228,12,26,181,1462,14,306,186,354,320,540,2580,4493,8,36391,2021,1,2,1,1,75620,30162,6060,39894,0
92,4912,1457,730,1242,11,6,188,1468,10,292,166,329,302,495,2424,4078,5,22973,1276,1,2,7,7,75620,30164,6060,39895,0
124,4939,1450,624,1228,12,26,181,1462,14,306,186,354,320,540,2580,4493,8,36391,2021,1,2,1,1,75620,30166,6061,39896,0
92,4912,1457,730,1242,11,6,188,1468,10,292,166,329,302,495,2424,4078,5,22973,1276,1,2,7,7,75620,30168,6061,39897,0
100,2600,773,422,505,30,103,129,803,14,77,46,83,91,129,535,839,7,6334,351,0,2,5,0,75630,30169,6062,39898,0
36,2459,1157,318,931,29,22,177,1186,6,104,63,125,110,188,712,1274,3,4596,255,0,2,34,0,75630,30169,6062,39900,0
124,4939,1450,624,1228,12,26,181,1462,14,306,186,354,320,540,2580,4493,8,36391,2021,1,2,1,1,75630,30171,6063,39901,0
92,4912,1457,730,1242,11,6,188,1468,10,292,166,329,302,495,2424,4078,5,22973,1276,1,2,7,7,75630,30173,6063,39902,0
1,106,42,7,35,4,0,5,46,1,2,1,2,3,3,2,4,0,2,0,0,2,1,1,75630,30173,6063,39903,0
1,106,11,6,10,0,0,1,11,2,4,2,4,6,6,10,15,1,15,0,0,2,1,1,75630,30173,6063,39904,0
1,106,42,7,35,4,0,5,46,1,2,1,2,3,3,2,4,0,2,0,0,2,1,1,75630,30173,6063,39905,0
1,106,11,6,10,0,0,1,11,2,4,2,4,6,6,10,15,1,15,0,0,2,1,1,75630,30173,6063,39906,0
230,4829,2,2,2,0,0,0,2,0,0,0,0,0,0,0,0,0,0,0,0,2,17,9,75630,30173,6063,39906,0
230,4829,99,48,90,1,3,5,100,0,0,0,0,0,0,0,0,0,0,0,0,2,17,9,75630,30174,6063,39907,0
230,4829,8,5,5,2,0,1,10,0,0,0,0,0,0,0,0,0,0,0,0,2,17,9,75630,30174,6063,39908,0
230,4829,1217,716,841,84,126,174,1301,14,185,118,215,199,333,1446,2542,8,20687,1149,0,2,17,9,75640,30176,6063,39909,0
230,4829,160,89,115,0,13,31,160,7,15,11,17,22,28,78,124,3,495,27,0,2,17,9,75640,30176,6063,39910,0
230,4829,10,10,9,9,0,0,19,0,0,0,0,0,0,0,0,0,0,0,0,2,17,9,75640,30176,6064,39911,0
230,4829,173,84,99,8,29,36,181,5,12,7,13,17,20,54,81,2,221,12,0,2,17,9,75640,30177,6064,39912,0
230,4829,3,1,1,3,0,0,6,0,0,0,0,0,0,0,0,0,0,0,0,2,17,9,75640,30177,6064,39913,0
28,978,74,35,59,1,0,14,75,3,14,7,14,17,21,58,85,1,128,7,0,2,1,1,75640,30178,6064,39914,0
28,978,245,125,200,5,7,34,250,7,30,17,34,37,51,166,265,3,1053,58,0,2,1,1,75650,30179,6064,39915,0
111,4421,1289,550,1043,56,32,155,1345,10,167,93,185,177,278,1266,2075,5,11498,638,0,2,55,0,75650,30181,6065,39916,0
96,4991,1457,730,1242,11,6,188,1468,10,292,166,329,302,495,2424,4078,5,22973,1276,1,2,24,1,75650,30183,6065,39917,0
1,106,42,7,35,4,0,5,46,1,2,1,2,3,3,2,4,0,2,0,0,2,1,1,75650,30183,6065,39918,0
1,106,11,6,10,0,0,1,11,2,4,2,4,6,6,10,15,1,15,0,0,2,1,1,75650,30183,6065,39919,0
1,106,42,7,35,4,0,5,46,1,2,1,2,3,3,2,4,0,2,0,0,2,1,1,75650,30183,6065,39920,0
1,106,11,6,10,0,0,1,11,2,4,2,4,6,6,10,15,1,15,0,0,2,1,1,75650,30183,6065,39921,0
230,4829,2,2,2,0,0,0,2,0,0,0,0,0,0,0,0,0,0,0,0,2,17,9,75650,30183,6065,39921,0
230,4829,99,48,90,1,3,5,100,0,0,0,0,0,0,0,0,0,0,0,0,2,17,9,75650,30184,6065,39922,0
230,4829,8,5,5,2,0,1,10,0,0,0,0,0,0,0,0,0,0,0,0,2,17,9,75650,30184,6065,39923,0
230,4829,1217,716,841,84,126,174,1301,14,185,118,215,199,333,1446,2542,8,20687,1149,0,2,17,9,75660,30186,6065,39924,0
230,4829,160,89,115,0,13,31,160,7,15,11,17,22,28,78,124,3,495,27,0,2,17,9,75660,30186,6065,39925,0
230,4829,10,10,9,9,0,0,19,0,0,0,0,0,0,0,0,0,0,0,0,2,17,9,75660,30186,6066,39926,0
230,4829,173,84,99,8,29,36,181,5,12,7,13,17,20,54,81,2,221,12,0,2,17,9,75660,30187,6066,39927,0
230,4829,3,1,1,3,0,0,6,0,0,0,0,0,0,0,0,0,0,0,0,2,17,9,75660,30187,6066,39928,0
28,978,74,35,59,1,0,14,75,3,14,7,14,17,21,58,85,1,128,7,0,2,1,1,75660,30188,6066,39929,0
28,978,245,125,200,5,7,34,250,7,30,17,34,37,51,166,265,3,1053,58,0,2,1,1,75670,30189,6066,39930,0
111,4421,1289,550,1043,56,32,155,1345,10,167,93,185,177,278,1266,2075,5,11498,638,0,2,55,0,75670,30191,6067,39931,0
96,4991,1457,730,1242,11,6,188,1468,10,292,166,329,302,495,2424,4078,5,22973,1276,1,2,24,1,75670,30193,6067,39932,0
1,108,42,7,35,4,0,5,46,1,2,1,2,3,3,2,4,0,2,0,0,2,1,0,75670,30193,6067,39933,0
1,108,11,6,10,0,0,1,11,2,4,2,4,6,6,10,15,1,15,0,0,2,1,0,75670,30193,6067,39934,0
38,2327,334,251,279,10,4,40,344,5,127,74,143,132,217,899,1528,2,4303,239,0,2,6,5,75670,30194,6067,39935,0
1,108,42,7,35,4,0,5,46,1,2,1,2,3,3,2,4,0,2,0,0,2,1,0,75670,30194,6067,39936,0
1,108,11,6,10,0,0,1,11,2,4,2,4,6,6,10,15,1,15,0,0,2,1,0,75670,30194,6067,39937,0
38,2327,334,251,279,10,4,40,344,5,127,74,143,132,217,899,1528,2,4303,239,0,2,6,5,75670,30195,6067,39938,0
48,1340,339,213,244,17,9,65,356,10,42,26,48,52,74,259,421,5,2410,133,0,2,22,5,75680,30195,6067,39939,1
67,3269,1293,570,1093,25,15,163,1318,10,195,123,241,205,364,1516,2795,6,17273,959,0,2,14,0,75690,30197,6067,39940,1
157,3295,1513,682,1277,25,13,200,1538,11,199,116,219,210,335,1557,2584,6,15641,868,0,2,5,0,75690,30199,6067,39941,1
157,3295,819,519,539,24,98,155,843,15,96,57,106,111,163,690,1107,8,9171,509,0,2,5,0,75700,30201,6067,39942,1
125,5375,1513,682,1277,25,13,200,1538,11,199,116,219,210,335,1557,2584,6,15641,868,0,2,24,0,75700,30203,6067,39943,1
157,3295,1513,682,1277,25,13,200,1538,11,199,116,219,210,335,1557,2584,6,15641,868,0,2,5,0,75700,30205,6067,39944,0
157,3295,819,519,539,24,98,155,843,15,96,57,106,111,163,690,1107,8,9171,509,0,2,5,0,75710,30207,6067,39945,0
125,5375,1513,682,1277,25,13,200,1538,11,199,116,219,210,335,1557,2584,6,15641,868,0,2,24,0,75710,30209,6067,39946,0
183,5547,1660,832,1314,41,38,274,1701,20,312,209,395,332,604,2671,5058,12,64042,3557,1,2,3,3,75710,30211,6068,39948,0
183,5547,1057,646,719,113,100,145,1170,18,215,134,248,233,382,1740,3004,10,31186,1732,1,2,3,3,75720,30212,6069,39949,0
2,40,9,6,6,0,0,3,9,0,0,0,0,0,0,0,0,0,0,0,0,2,0,1,75720,30212,6069,39950,0
2,40,13,9,8,0,0,4,13,0,0,0,0,0,0,0,0,0,0,0,0,2,0,1,75720,30212,6069,39951,0
1,108,42,7,35,4,0,5,46,1,2,1,2,3,3,2,4,0,2,0,0,2,0,1,75720,30212,6069,39952,0
1,108,11,6,10,0,0,1,11,2,4,2,4,6,6,10,15,1,15,0,0,2,0,1,75720,30212,6069,39953,0
17,348,95,58,50,9,16,20,104,12,33,24,45,45,69,209,378,8,3100,172,0,2,0,1,75720,30212,6069,39954,0
52,625,647,139,84,35,284,233,682,0,0,0,0,0,0,0,0,0,0,0,0,2,0,1,75720,30212,6069,39956,0
100,2600,773,422,505,30,103,129,803,14,77,46,83,91,129,535,839,7,6334,351,0,2,0,1,75730,30213,6070,39957,0
158,3740,77,34,69,0,0,8,77,3,24,16,29,27,45,114,213,1,387,21,0,2,0,1,75730,30213,6070,39958,0
158,3740,712,438,573,51,9,84,763,14,102,71,128,116,199,733,1364,8,11988,666,0,2,0,1,75740,30214,6070,39959,0
69,1497,402,202,227,24,74,80,426,12,52,33,61,64,94,339,564,7,3969,220,0,2,0,1,75740,30215,6070,39960,0
59,1228,91,45,69,0,3,18,91,3,9,6,10,12,16,33,57,1,95,5,0,2,0,1,75740,30217,6070,39961,0
59,1228,367,234,237,17,34,68,384,16,55,34,61,71,95,381,584,8,5183,287,0,2,0,1,75740,30218,6070,39962,0
95,2929,773,419,590,28,0,166,801,10,204,113,217,214,330,1598,2554,5,13587,754,0,2,0,1,75740,30218,6071,39963,0
4,163,27,21,21,0,0,6,27,3,6,3,6,9,9,20,28,1,42,2,0,2,0,1,75740,30218,6071,39964,0
15,1066,215,129,180,6,0,29,221,8,65,43,72,73,115,415,711,4,3153,175,0,2,0,1,75740,30218,6071,39965,0
53,1862,601,196,481,2,23,85,603,8,63,36,72,71,108,400,664,4,3036,168,0,2,0,1,75740,30218,6071,39966,0
183,5547,1660,832,1314,41,38,274,1701,20,312,209,395,332,604,2671,5058,12,64042,3557,1,2,3,3,75740,30220,6072,39968,0
183,5547,1057,646,719,113,100,145,1170,18,215,134,248,233,382,1740,3004,10,31186,1732,1,2,3,3,75750,30221,6073,39969,0
49,1371,339,213,244,17,9,65,356,10,42,26,48,52,74,259,421,5,2410,133,0,2,24,17,75760,30221,6073,39970,1
68,3294,1293,570,1093,25,15,163,1318,10,195,123,241,205,364,1516,2795,6,17273,959,0,2,11,6,75770,30223,6073,39971,1
49,1371,339,213,244,17,9,65,356,10,42,26,48,52,74,259,421,5,2410,133,0,2,29,5,75780,30223,6073,39972,0
68,3294,1293,570,1093,25,15,163,1318,10,195,123,241,205,364,1516,2795,6,17273,959,0,2,19,0,75790,30225,6073,39973,0
246,5928,722,423,573,19,0,135,741,12,172,101,199,184,300,1320,2257,6,15668,870,0,2,1,0,75790,30227,6073,39975,0
246,5928,1508,847,911,44,250,301,1552,14,148,88,169,162,257,1120,1886,7,15077,837,0,2,1,0,75790,30228,6074,39976,0
2,40,9,6,6,0,0,3,9,0,0,0,0,0,0,0,0,0,0,0,0,2,0,1,75790,30228,6074,39977,0
2,40,13,9,8,0,0,4,13,0,0,0,0,0,0,0,0,0,0,0,0,2,0,1,75790,30228,6074,39978,0
1,108,42,7,35,4,0,5,46,1,2,1,2,3,3,2,4,0,2,0,0,2,0,1,75790,30228,6074,39979,0
1,108,11,6,10,0,0,1,11,2,4,2,4,6,6,10,15,1,15,0,0,2,0,1,75790,30228,6074,39980,0
17,348,95,58,50,9,16,20,104,12,33,24,45,45,69,209,378,8,3100,172,0,2,0,1,75790,30228,6074,39981,0
52,625,647,139,84,35,284,233,682,0,0,0,0,0,0,0,0,0,0,0,0,2,0,1,75790,30228,6074,39983,0
100,2600,773,422,505,30,103,129,803,14,77,46,83,91,129,535,839,7,6334,351,0,2,0,1,75800,30229,6075,39984,0
158,3740,77,34,69,0,0,8,77,3,24,16,29,27,45,114,213,1,387,21,0,2,0,1,75800,30229,6075,39985,0
158,3740,712,438,573,51,9,84,763,14,102,71,128,116,199,733,1364,8,11988,666,0,2,0,1,75810,30230,6075,39986,0
69,1497,402,202,227,24,74,80,426,12,52,33,61,64,94,339,564,7,3969,220,0,2,0,1,75810,30231,6075,39987,0
59,1228,91,45,69,0,3,18,91,3,9,6,10,12,16,33,57,1,95,5,0,2,0,1,75810,30233,6075,39988,0
59,1228,367,234,237,17,34,68,384,16,55,34,61,71,95,381,584,8,5183,287,0,2,0,1,75810,30234,6075,39989,0
95,2929,773,419,590,28,0,166,801,10,204,113,217,214,330,1598,2554,5,13587,754,0,2,0,1,75810,30234,6076,39990,0
4,163,27,21,21,0,0,6,27,3,6,3,6,9,9,20,28,1,42,2,0,2,0,1,75810,30234,6076,39991,0
15,1066,215,129,180,6,0,29,221,8,65,43,72,73,115,415,711,4,3153,175,0,2,0,1,75810,30234,6076,39992,0
53,1862,601,196,481,2,23,85,603,8,63,36,72,71,108,400,664,4,3036,168,0,2,0,1,75810,30234,6076,39993,0
246,5928,722,423,573,19,0,135,741,12,172,101,199,184,300,1320,2257,6,15668,870,0,2,1,0,75810,30236,6076,39995,0
246,5928,1508,847,911,44,250,301,1552,14,148,88,169,162,257,1120,1886,7,15077,837,0,2,1,0,75810,30237,6077,39996,0
78,1822,996,429,845,24,10,117,1020,7,76,50,88,83,138,494,879,4,3565,198,0,2,10,13,75810,30239,6077,39997,0
78,1822,456,277,329,12,42,72,468,13,85,50,97,98,147,592,972,7,7212,400,0,2,10,13,75810,30239,6077,39998,0
78,1822,996,429,845,24,10,117,1020,7,76,50,88,83,138,494,879,4,3565,198,0,2,10,13,75810,30241,6077,39999,0
78,1822,456,277,329,12,42,72,468,13,85,50,97,98,147,592,972,7,7212,400,0,2,10,13,75810,30241,6077,40000,0
248,5735,4293,999,3693,19,54,507,4312,9,155,88,170,164,258,1156,1898,4,9368,520,0,2,18,5,75810,30243,6077,40001,1
248,5735,1482,859,1002,125,135,219,1607,16,219,134,251,235,385,1766,3032,9,27804,1544,1,2,18,5,75820,30244,6077,40002,1
95,2086,1043,504,840,53,9,147,1096,9,180,112,198,189,310,1377,2344,4,11604,644,0,2,1,0,75820,30246,6077,40003,1
95,2086,383,288,292,26,6,62,409,11,65,38,67,76,105,429,656,5,3719,206,0,2,1,0,75820,30247,6077,40004,1
170,7538,139,89,101,2,0,35,141,7,54,34,62,61,96,330,569,4,2287,127,0,2,1,1,75820,30247,6077,40005,1
170,7538,7,5,5,0,0,2,7,1,2,1,2,3,3,2,4,0,2,0,0,2,1,1,75820,30247,6077,40006,1
171,7568,4293,999,3693,19,54,507,4312,9,155,88,170,164,258,1156,1898,4,9368,520,0,2,38,0,75830,30252,6077,40009,0
171,7568,1482,859,1002,125,135,219,1607,16,219,134,251,235,385,1766,3032,9,27804,1544,1,2,38,0,75840,30253,6077,40010,0
248,5735,4293,999,3693,19,54,507,4312,9,155,88,170,164,258,1156,1898,4,9368,520,0,2,0,1,75840,30255,6077,40011,0
248,5735,1482,859,1002,125,135,219,1607,16,219,134,251,235,385,1766,3032,9,27804,1544,1,2,0,1,75850,30256,6077,40012,0
95,2085,1043,504,840,53,9,147,1096,9,180,112,198,189,310,1377,2344,4,11604,644,0,2,0,1,75850,30258,6077,40013,0
95,2085,383,288,292,26,6,62,409,11,65,38,67,76,105,429,656,5,3719,206,0,2,0,1,75850,30259,6077,40014,0
171,7568,4293,999,3693,19,54,507,4312,9,155,88,170,164,258,1156,1898,4,9368,520,0,2,1,1,75850,30261,6077,40015,0
171,7568,1482,859,1002,125,135,219,1607,16,219,134,251,235,385,1766,3032,9,27804,1544,1,2,1,1,75860,30262,6077,40016,0
247,5132,1943,715,1694,26,18,214,1969,12,185,120,237,197,357,1436,2721,7,20915,1161,0,2,6,1,75860,30264,6077,40017,1
247,5132,1168,838,957,57,25,144,1225,19,348,224,416,367,640,3018,5452,11,61921,3440,1,2,6,1,75870,30266,6077,40018,1
102,5395,1943,715,1694,26,18,214,1969,12,185,120,237,197,357,1436,2721,7,20915,1161,0,2,20,0,75870,30268,6077,40019,1
247,5125,1943,715,1694,26,18,214,1969,12,185,120,237,197,357,1436,2721,7,20915,1161,0,2,7,7,75870,30270,6077,40020,0
247,5125,1168,838,957,57,25,144,1225,19,348,224,416,367,640,3018,5452,11,61921,3440,1,2,7,7,75880,30272,6077,40021,0
96,4991,1457,730,1242,11,6,188,1468,10,292,166,329,302,495,2424,4078,5,22973,1276,1,2,3,3,75880,30274,6077,40022,0
30,1324,373,158,315,8,0,51,381,5,76,44,79,81,123,486,779,2,2026,112,0,2,1,1,75880,30274,6077,40023,0
101,5370,1943,715,1694,26,18,214,1969,12,185,120,237,197,357,1436,2721,7,20915,1161,0,2,10,10,75880,30276,6077,40024,0
247,5125,1943,715,1694,26,18,214,1969,12,185,120,237,197,357,1436,2721,7,20915,1161,0,2,11,6,75880,30278,6077,40025,0
247,5125,1168,838,957,57,25,144,1225,19,348,224,416,367,640,3018,5452,11,61921,3440,1,2,11,6,75890,30280,6077,40026,0
96,4991,1457,730,1242,11,6,188,1468,10,292,166,329,302,495,2424,4078,5,22973,1276,1,2,3,3,75890,30282,6077,40027,0
30,1324,373,158,315,8,0,51,381,5,76,44,79,81,123,486,779,2,2026,112,0,2,1,1,75890,30282,6077,40028,0
101,5370,1943,715,1694,26,18,214,1969,12,185,120,237,197,357,1436,2721,7,20915,1161,0,2,29,9,75890,30284,6077,40029,0
1,94,42,7,35,4,0,5,46,1,2,1,2,3,3,2,4,0,2,0,0,2,1,8,75890,30284,6077,40030,0
1,94,11,6,10,0,0,1,11,2,4,2,4,6,6,10,15,1,15,0,0,2,1,8,75890,30284,6077,40031,0
1,94,42,7,35,4,0,5,46,1,2,1,2,3,3,2,4,0,2,0,0,2,1,8,75890,30284,6077,40032,0
1,94,11,6,10,0,0,1,11,2,4,2,4,6,6,10,15,1,15,0,0,2,1,8,75890,30284,6077,40033,0
171,7568,4293,999,3693,19,54,507,4312,9,155,88,170,164,258,1156,1898,4,9368,520,0,2,3,3,75890,30286,6077,40034,0
171,7568,1482,859,1002,125,135,219,1607,16,219,134,251,235,385,1766,3032,9,27804,1544,1,2,3,3,75900,30287,6077,40035,0
248,5735,4293,999,3693,19,54,507,4312,9,155,88,170,164,258,1156,1898,4,9368,520,0,2,17,5,75900,30289,6077,40036,0
248,5735,1482,859,1002,125,135,219,1607,16,219,134,251,235,385,1766,3032,9,27804,1544,1,2,17,5,75910,30290,6077,40037,0
171,7568,4293,999,3693,19,54,507,4312,9,155,88,170,164,258,1156,1898,4,9368,520,0,3,38,0,75910,30292,6077,40038,0
171,7568,1482,859,1002,125,135,219,1607,16,219,134,251,235,385,1766,3032,9,27804,1544,1,3,38,0,75920,30293,6077,40039,0
125,5391,1513,682,1277,25,13,200,1538,11,199,116,219,210,335,1557,2584,6,15641,868,0,2,14,6,75920,30295,6077,40040,0
125,5391,1513,682,1277,25,13,200,1538,11,199,116,219,210,335,1557,2584,6,15641,868,0,2,14,6,75920,30297,6077,40041,0
169,5066,1660,832,1314,41,38,274,1701,20,312,209,395,332,604,2671,5058,12,64042,3557,1,2,1,2,75920,30299,6078,40043,1
169,5066,1660,832,1314,41,38,274,1701,20,312,209,395,332,604,2671,5058,12,64042,3557,1,2,1,2,75920,30301,6079,40045,0
2,40,9,6,6,0,0,3,9,0,0,0,0,0,0,0,0,0,0,0,0,2,0,1,75920,30301,6079,40046,0
2,40,13,9,8,0,0,4,13,0,0,0,0,0,0,0,0,0,0,0,0,2,0,1,75920,30301,6079,40047,0
1,94,42,7,35,4,0,5,46,1,2,1,2,3,3,2,4,0,2,0,0,2,2,9,75920,30301,6079,40048,0
1,94,11,6,10,0,0,1,11,2,4,2,4,6,6,10,15,1,15,0,0,2,2,9,75920,30301,6079,40049,0
17,348,95,58,50,9,16,20,104,12,33,24,45,45,69,209,378,8,3100,172,0,2,0,1,75920,30301,6079,40050,0
157,3295,1513,682,1277,25,13,200,1538,11,199,116,219,210,335,1557,2584,6,15641,868,0,2,5,0,75920,30303,6079,40051,0
157,3295,819,519,539,24,98,155,843,15,96,57,106,111,163,690,1107,8,9171,509,0,2,5,0,75930,30305,6079,40052,0
52,625,647,139,84,35,284,233,682,0,0,0,0,0,0,0,0,0,0,0,0,2,0,1,75930,30305,6079,40054,0
100,2600,773,422,505,30,103,129,803,14,77,46,83,91,129,535,839,7,6334,351,0,2,0,1,75940,30306,6080,40055,0
158,3740,77,34,69,0,0,8,77,3,24,16,29,27,45,114,213,1,387,21,0,2,0,1,75940,30306,6080,40056,0
158,3740,712,438,573,51,9,84,763,14,102,71,128,116,199,733,1364,8,11988,666,0,2,0,1,75950,30307,6080,40057,0
69,1497,402,202,227,24,74,80,426,12,52,33,61,64,94,339,564,7,3969,220,0,2,0,1,75950,30308,6080,40058,0
59,1228,91,45,69,0,3,18,91,3,9,6,10,12,16,33,57,1,95,5,0,2,0,1,75950,30310,6080,40059,0
59,1228,367,234,237,17,34,68,384,16,55,34,61,71,95,381,584,8,5183,287,0,2,0,1,75950,30311,6080,40060,0
95,2929,773,419,590,28,0,166,801,10,204,113,217,214,330,1598,2554,5,13587,754,0,2,0,1,75950,30311,6081,40061,0
4,163,27,21,21,0,0,6,27,3,6,3,6,9,9,20,28,1,42,2,0,2,0,1,75950,30311,6081,40062,0
169,5066,1660,832,1314,41,38,274,1701,20,312,209,395,332,604,2671,5058,12,64042,3557,1,2,1,2,75950,30313,6082,40064,0
125,5391,1513,682,1277,25,13,200,1538,11,199,116,219,210,335,1557,2584,6,15641,868,0,2,38,6,75950,30315,6082,40065,0
38,2327,334,251,279,10,4,40,344,5,127,74,143,132,217,899,1528,2,4303,239,0,2,6,5,75950,30316,6082,40066,0
15,1066,215,129,180,6,0,29,221,8,65,43,72,73,115,415,711,4,3153,175,0,2,0,1,75950,30316,6082,40067,0
53,1862,601,196,481,2,23,85,603,8,63,36,72,71,108,400,664,4,3036,168,0,2,0,1,75950,30316,6082,40068,0
228,4805,2,2,2,0,0,0,2,0,0,0,0,0,0,0,0,0,0,0,0,2,1,1,75950,30316,6082,40068,0
228,4805,99,48,90,1,3,5,100,0,0,0,0,0,0,0,0,0,0,0,0,2,1,1,75950,30317,6082,40069,0
228,4805,8,5,5,2,0,1,10,0,0,0,0,0,0,0,0,0,0,0,0,2,1,1,75950,30317,6082,40070,0
228,4805,1217,716,841,84,126,174,1301,14,185,118,215,199,333,1446,2542,8,20687,1149,0,2,1,1,75960,30319,6082,40071,0
228,4805,160,89,115,0,13,31,160,7,15,11,17,22,28,78,124,3,495,27,0,2,1,1,75960,30319,6082,40072,0
228,4805,10,10,9,9,0,0,19,0,0,0,0,0,0,0,0,0,0,0,0,2,1,1,75960,30319,6083,40073,0
228,4805,173,84,99,8,29,36,181,5,12,7,13,17,20,54,81,2,221,12,0,2,1,1,75960,30320,6083,40074,0
228,4805,3,1,1,3,0,0,6,0,0,0,0,0,0,0,0,0,0,0,0,2,1,1,75960,30320,6083,40075,0
2,40,9,6,6,0,0,3,9,0,0,0,0,0,0,0,0,0,0,0,0,2,0,1,75960,30320,6083,40076,0
2,40,13,9,8,0,0,4,13,0,0,0,0,0,0,0,0,0,0,0,0,2,0,1,75960,30320,6083,40077,0
1,94,42,7,35,4,0,5,46,1,2,1,2,3,3,2,4,0,2,0,0,2,2,9,75960,30320,6083,40078,0
1,94,11,6,10,0,0,1,11,2,4,2,4,6,6,10,15,1,15,0,0,2,2,9,75960,30320,6083,40079,0
17,348,95,58,50,9,16,20,104,12,33,24,45,45,69,209,378,8,3100,172,0,2,0,1,75960,30320,6083,40080,0
157,3295,1513,682,1277,25,13,200,1538,11,199,116,219,210,335,1557,2584,6,15641,868,0,2,5,0,75960,30322,6083,40081,0
157,3295,819,519,539,24,98,155,843,15,96,57,106,111,163,690,1107,8,9171,509,0,2,5,0,75970,30324,6083,40082,0
52,625,647,139,84,35,284,233,682,0,0,0,0,0,0,0,0,0,0,0,0,2,0,1,75970,30324,6083,40084,0
100,2600,773,422,505,30,103,129,803,14,77,46,83,91,129,535,839,7,6334,351,0,2,0,1,75980,30325,6084,40085,0
158,3740,77,34,69,0,0,8,77,3,24,16,29,27,45,114,213,1,387,21,0,2,0,1,75980,30325,6084,40086,0
158,3740,712,438,573,51,9,84,763,14,102,71,128,116,199,733,1364,8,11988,666,0,2,0,1,75990,30326,6084,40087,0
69,1497,402,202,227,24,74,80,426,12,52,33,61,64,94,339,564,7,3969,220,0,2,0,1,75990,30327,6084,40088,0
59,1228,91,45,69,0,3,18,91,3,9,6,10,12,16,33,57,1,95,5,0,2,0,1,75990,30329,6084,40089,0
59,1228,367,234,237,17,34,68,384,16,55,34,61,71,95,381,584,8,5183,287,0,2,0,1,75990,30330,6084,40090,0
95,2929,773,419,590,28,0,166,801,10,204,113,217,214,330,1598,2554,5,13587,754,0,2,0,1,75990,30330,6085,40091,0
4,163,27,21,21,0,0,6,27,3,6,3,6,9,9,20,28,1,42,2,0,2,0,1,75990,30330,6085,40092,0
169,5066,1660,832,1314,41,38,274,1701,20,312,209,395,332,604,2671,5058,12,64042,3557,1,2,1,2,75990,30332,6086,40094,0
125,5391,1513,682,1277,25,13,200,1538,11,199,116,219,210,335,1557,2584,6,15641,868,0,2,38,6,75990,30334,6086,40095,0
38,2327,334,251,279,10,4,40,344,5,127,74,143,132,217,899,1528,2,4303,239,0,2,6,5,75990,30335,6086,40096,0
15,1066,215,129,180,6,0,29,221,8,65,43,72,73,115,415,711,4,3153,175,0,2,0,1,75990,30335,6086,40097,0
53,1862,601,196,481,2,23,85,603,8,63,36,72,71,108,400,664,4,3036,168,0,2,0,1,75990,30335,6086,40098,0
233,5719,722,423,573,19,0,135,741,12,172,101,199,184,300,1320,2257,6,15668,870,0,2,0,42,75990,30337,6086,40100,0
233,5719,1508,847,911,44,250,301,1552,14,148,88,169,162,257,1120,1886,7,15077,837,0,2,0,42,75990,30338,6087,40101,0
233,5719,722,423,573,19,0,135,741,12,172,101,199,184,300,1320,2257,6,15668,870,0,2,0,42,75990,30340,6087,40103,0
233,5719,1508,847,911,44,250,301,1552,14,148,88,169,162,257,1120,1886,7,15077,837,0,2,0,42,75990,30341,6088,40104,0
313,6859,72,33,56,0,4,12,72,1,1,1,1,2,2,0,2,0,1,0,0,2,16,17,75990,30341,6088,40105,1
313,6859,1454,835,1044,76,110,219,1530,17,275,158,296,292,454,2297,3718,9,34017,1889,1,2,16,17,76000,30342,6088,40106,1
313,6859,72,33,56,0,4,12,72,1,1,1,1,2,2,0,2,0,1,0,0,2,2,2,76000,30342,6088,40107,0
313,6859,1454,835,1044,76,110,219,1530,17,275,158,296,292,454,2297,3718,9,34017,1889,1,2,2,2,76010,30343,6088,40108,0
313,6859,72,33,56,0,4,12,72,1,1,1,1,2,2,0,2,0,1,0,0,2,16,17,76010,30343,6088,40109,0
313,6859,1454,835,1044,76,110,219,1530,17,275,158,296,292,454,2297,3718,9,34017,1889,1,2,16,17,76020,30344,6088,40110,0
246,5918,722,423,573,19,0,135,741,12,172,101,199,184,300,1320,2257,6,15668,870,0,2,1,1,76020,30346,6088,40112,0
246,5918,1508,847,911,44,250,301,1552,14,148,88,169,162,257,1120,1886,7,15077,837,0,2,1,1,76020,30347,6089,40113,0
246,5918,722,423,573,19,0,135,741,12,172,101,199,184,300,1320,2257,6,15668,870,0,2,1,1,76020,30349,6089,40115,0
246,5918,1508,847,911,44,250,301,1552,14,148,88,169,162,257,1120,1886,7,15077,837,0,2,1,1,76020,30350,6090,40116,0
183,5550,1660,832,1314,41,38,274,1701,20,312,209,395,332,604,2671,5058,12,64042,3557,1,2,3,3,76020,30352,6091,40118,0
183,5550,1057,646,719,113,100,145,1170,18,215,134,248,233,382,1740,3004,10,31186,1732,1,2,3,3,76030,30353,6092,40119,0
84,4869,1296,573,1062,40,33,157,1336,8,201,118,231,209,349,1561,2689,4,12365,686,0,2,2,1,76030,30353,6092,40120,0
84,4869,1296,573,1062,40,33,157,1336,8,201,118,231,209,349,1561,2689,4,12365,686,0,2,2,1,76030,30353,6092,40121,0
48,1338,339,213,244,17,9,65,356,10,42,26,48,52,74,259,421,5,2410,133,0,2,6,11,76040,30353,6092,40122,1
311,6810,72,33,56,0,4,12,72,1,1,1,1,2,2,0,2,0,1,0,0,2,9,22,76040,30353,6092,40123,1
311,6810,1454,835,1044,76,110,219,1530,17,275,158,296,292,454,2297,3718,9,34017,1889,1,2,9,22,76050,30354,6092,40124,1
48,1338,339,213,244,17,9,65,356,10,42,26,48,52,74,259,421,5,2410,133,0,2,1,1,76060,30354,6092,40125,0
309,6777,72,33,56,0,4,12,72,1,1,1,1,2,2,0,2,0,1,0,0,2,0,5,76060,30354,6092,40126,0
309,6777,1454,835,1044,76,110,219,1530,17,275,158,296,292,454,2297,3718,9,34017,1889,1,2,0,5,76070,30355,6092,40127,0
48,1338,339,213,244,17,9,65,356,10,42,26,48,52,74,259,421,5,2410,133,0,2,6,11,76080,30355,6092,40128,0
309,6777,72,33,56,0,4,12,72,1,1,1,1,2,2,0,2,0,1,0,0,2,4,22,76080,30355,6092,40129,0
309,6777,1454,835,1044,76,110,219,1530,17,275,158,296,292,454,2297,3718,9,34017,1889,1,2,4,22,76090,30356,6092,40130,0
183,5550,1660,832,1314,41,38,274,1701,20,312,209,395,332,604,2671,5058,12,64042,3557,1,2,2,0,76090,30358,6093,40132,0
183,5550,1057,646,719,113,100,145,1170,18,215,134,248,233,382,1740,3004,10,31186,1732,1,2,2,0,76100,30359,6094,40133,0
183,5550,1660,832,1314,41,38,274,1701,20,312,209,395,332,604,2671,5058,12,64042,3557,1,2,5,3,76100,30361,6095,40135,0
183,5550,1057,646,719,113,100,145,1170,18,215,134,248,233,382,1740,3004,10,31186,1732,1,2,5,3,76110,30362,6096,40136,0
230,4967,182,127,129,0,0,53,182,5,39,21,42,44,63,217,343,2,926,51,0,2,7,12,76110,30362,6097,40137,0
230,4967,1165,710,800,67,119,181,1232,18,243,153,282,261,435,2000,3492,10,36473,2026,1,2,7,12,76120,30362,6098,40138,0
1,323,382,65,130,157,2,92,539,4,10,5,10,14,15,41,57,2,114,6,0,2,1,1,76120,30363,6099,40139,0
170,5135,1660,832,1314,41,38,274,1701,20,312,209,395,332,604,2671,5058,12,64042,3557,1,2,23,0,76120,30365,6100,40141,0
170,5135,1660,832,1314,41,38,274,1701,20,312,209,395,332,604,2671,5058,12,64042,3557,1,2,23,0,76120,30367,6101,40143,0
1,323,382,65,130,157,2,92,539,4,10,5,10,14,15,41,57,2,114,6,0,2,1,1,76120,30368,6102,40144,0
230,4967,182,127,129,0,0,53,182,5,39,21,42,44,63,217,343,2,926,51,0,2,7,12,76120,30368,6103,40145,0
230,4967,1165,710,800,67,119,181,1232,18,243,153,282,261,435,2000,3492,10,36473,2026,1,2,7,12,76130,30368,6104,40146,0
66,3225,1293,570,1093,25,15,163,1318,10,195,123,241,205,364,1516,2795,6,17273,959,0,2,2,4,76140,30370,6104,40147,0
66,3254,1293,570,1093,25,15,163,1318,10,195,123,241,205,364,1516,2795,6,17273,959,0,2,10,3,76150,30372,6104,40148,1
48,1341,339,213,244,17,9,65,356,10,42,26,48,52,74,259,421,5,2410,133,0,2,2,2,76160,30372,6104,40149,0
311,6841,72,33,56,0,4,12,72,1,1,1,1,2,2,0,2,0,1,0,0,2,10,0,76160,30372,6104,40150,0
311,6841,1454,835,1044,76,110,219,1530,17,275,158,296,292,454,2297,3718,9,34017,1889,1,2,10,0,76170,30373,6104,40151,0
112,4510,1289,550,1043,56,32,155,1345,10,167,93,185,177,278,1266,2075,5,11498,638,0,2,28,0,76170,30375,6105,40152,0
48,1341,339,213,244,17,9,65,356,10,42,26,48,52,74,259,421,5,2410,133,0,2,2,2,76180,30375,6105,40153,0
66,3254,1293,570,1093,25,15,163,1318,10,195,123,241,205,364,1516,2795,6,17273,959,0,2,12,7,76190,30377,6105,40154,0
1,323,382,65,130,157,2,92,539,4,10,5,10,14,15,41,57,2,114,6,0,2,1,1,76190,30378,6106,40155,0
183,5553,1660,832,1314,41,38,274,1701,20,312,209,395,332,604,2671,5058,12,64042,3557,1,2,5,3,76190,30380,6107,40157,0
183,5553,1057,646,719,113,100,145,1170,18,215,134,248,233,382,1740,3004,10,31186,1732,1,2,5,3,76200,30381,6108,40158,0
230,4829,2,2,2,0,0,0,2,0,0,0,0,0,0,0,0,0,0,0,0,2,1,1,76200,30381,6108,40158,0
230,4829,99,48,90,1,3,5,100,0,0,0,0,0,0,0,0,0,0,0,0,2,1,1,76200,30382,6108,40159,0
230,4829,8,5,5,2,0,1,10,0,0,0,0,0,0,0,0,0,0,0,0,2,1,1,76200,30382,6108,40160,0
230,4829,1217,716,841,84,126,174,1301,14,185,118,215,199,333,1446,2542,8,20687,1149,0,2,1,1,76210,30384,6108,40161,0
230,4829,160,89,115,0,13,31,160,7,15,11,17,22,28,78,124,3,495,27,0,2,1,1,76210,30384,6108,40162,0
230,4829,10,10,9,9,0,0,19,0,0,0,0,0,0,0,0,0,0,0,0,2,1,1,76210,30384,6109,40163,0
230,4829,173,84,99,8,29,36,181,5,12,7,13,17,20,54,81,2,221,12,0,2,1,1,76210,30385,6109,40164,0
230,4829,3,1,1,3,0,0,6,0,0,0,0,0,0,0,0,0,0,0,0,2,1,1,76210,30385,6109,40165,0
233,5719,722,423,573,19,0,135,741,12,172,101,199,184,300,1320,2257,6,15668,870,0,2,1,1,76210,30387,6109,40167,0
233,5719,1508,847,911,44,250,301,1552,14,148,88,169,162,257,1120,1886,7,15077,837,0,2,1,1,76210,30388,6110,40168,0
308,6764,72,33,56,0,4,12,72,1,1,1,1,2,2,0,2,0,1,0,0,2,16,17,76210,30388,6110,40169,0
308,6764,1454,835,1044,76,110,219,1530,17,275,158,296,292,454,2297,3718,9,34017,1889,1,2,16,17,76220,30389,6110,40170,0
170,5135,1660,832,1314,41,38,274,1701,20,312,209,395,332,604,2671,5058,12,64042,3557,1,2,23,0,76220,30391,6111,40172,0
84,4869,1296,573,1062,40,33,157,1336,8,201,118,231,209,349,1561,2689,4,12365,686,0,2,2,1,76220,30391,6111,40173,0
68,3323,1293,570,1093,25,15,163,1318,10,195,123,241,205,364,1516,2795,6,17273,959,0,2,12,7,76230,30393,6111,40174,0
1,323,382,65,130,157,2,92,539,4,10,5,10,14,15,41,57,2,114,6,0,2,1,1,76230,30394,6112,40175,0
183,5553,1660,832,1314,41,38,274,1701,20,312,209,395,332,604,2671,5058,12,64042,3557,1,2,5,3,76230,30396,6113,40177,0
183,5553,1057,646,719,113,100,145,1170,18,215,134,248,233,382,1740,3004,10,31186,1732,1,2,5,3,76240,30397,6114,40178,0
230,4829,2,2,2,0,0,0,2,0,0,0,0,0,0,0,0,0,0,0,0,2,1,1,76240,30397,6114,40178,0
230,4829,99,48,90,1,3,5,100,0,0,0,0,0,0,0,0,0,0,0,0,2,1,1,76240,30398,6114,40179,0
230,4829,8,5,5,2,0,1,10,0,0,0,0,0,0,0,0,0,0,0,0,2,1,1,76240,30398,6114,40180,0
230,4829,1217,716,841,84,126,174,1301,14,185,118,215,199,333,1446,2542,8,20687,1149,0,2,1,1,76250,30400,6114,40181,0
230,4829,160,89,115,0,13,31,160,7,15,11,17,22,28,78,124,3,495,27,0,2,1,1,76250,30400,6114,40182,0
230,4829,10,10,9,9,0,0,19,0,0,0,0,0,0,0,0,0,0,0,0,2,1,1,76250,30400,6115,40183,0
230,4829,173,84,99,8,29,36,181,5,12,7,13,17,20,54,81,2,221,12,0,2,1,1,76250,30401,6115,40184,0
230,4829,3,1,1,3,0,0,6,0,0,0,0,0,0,0,0,0,0,0,0,2,1,1,76250,30401,6115,40185,0
233,5719,722,423,573,19,0,135,741,12,172,101,199,184,300,1320,2257,6,15668,870,0,2,1,1,76250,30403,6115,40187,0
233,5719,1508,847,911,44,250,301,1552,14,148,88,169,162,257,1120,1886,7,15077,837,0,2,1,1,76250,30404,6116,40188,0
308,6764,72,33,56,0,4,12,72,1,1,1,1,2,2,0,2,0,1,0,0,2,16,17,76250,30404,6116,40189,0
308,6764,1454,835,1044,76,110,219,1530,17,275,158,296,292,454,2297,3718,9,34017,1889,1,2,16,17,76260,30405,6116,40190,0
170,5135,1660,832,1314,41,38,274,1701,20,312,209,395,332,604,2671,5058,12,64042,3557,1,2,23,0,76260,30407,6117,40192,0
84,4869,1296,573,1062,40,33,157,1336,8,201,118,231,209,349,1561,2689,4,12365,686,0,2,2,1,76260,30407,6117,40193,0
68,3323,1293,570,1093,25,15,163,1318,10,195,123,241,205,364,1516,2795,6,17273,959,0,2,12,7,76270,30409,6117,40194,0
95,2385,1455,414,1257,16,76,112,1471,5,41,23,46,46,69,231,381,2,1069,59,0,2,3,0,76270,30410,6117,40195,0
95,2385,669,365,481,22,61,110,691,15,103,63,122,118,185,747,1273,8,11311,628,0,2,3,0,76280,30410,6118,40196,0
245,5668,4293,999,3693,19,54,507,4312,9,155,88,170,164,258,1156,1898,4,9368,520,0,2,1,1,76280,30412,6118,40197,0
245,5668,1482,859,1002,125,135,219,1607,16,219,134,251,235,385,1766,3032,9,27804,1544,1,2,1,1,76290,30413,6118,40198,0
170,7538,139,89,101,2,0,35,141,7,54,34,62,61,96,330,569,4,2287,127,0,2,2,2,76290,30413,6118,40199,0
170,7538,7,5,5,0,0,2,7,1,2,1,2,3,3,2,4,0,2,0,0,2,2,2,76290,30413,6118,40200,0
72,3308,1455,414,1257,16,76,112,1471,5,41,23,46,46,69,231,381,2,1069,59,0,2,12,0,76290,30414,6118,40201,0
21,541,205,80,86,16,53,53,221,7,18,10,19,25,29,94,134,3,497,27,0,2,5,1,76300,30414,6119,40202,0
21,541,205,80,86,16,53,53,221,7,18,10,19,25,29,94,134,3,497,27,0,2,1,1,76310,30414,6120,40203,0
21,541,205,80,86,16,53,53,221,7,18,10,19,25,29,94,134,3,497,27,0,2,1,1,76320,30414,6121,40204,0
95,2385,1455,414,1257,16,76,112,1471,5,41,23,46,46,69,231,381,2,1069,59,0,2,3,0,76320,30415,6121,40205,0
95,2385,669,365,481,22,61,110,691,15,103,63,122,118,185,747,1273,8,11311,628,0,2,3,0,76330,30415,6122,40206,0
21,541,205,80,86,16,53,53,221,7,18,10,19,25,29,94,134,3,497,27,0,2,5,1,76340,30415,6123,40207,0
72,3308,1455,414,1257,16,76,112,1471,5,41,23,46,46,69,231,381,2,1069,59,0,2,12,0,76340,30416,6123,40208,0
310,6828,72,33,56,0,4,12,72,1,1,1,1,2,2,0,2,0,1,0,0,2,10,0,76340,30416,6123,40209,0
310,6828,1454,835,1044,76,110,219,1530,17,275,158,296,292,454,2297,3718,9,34017,1889,1,2,10,0,76350,30417,6123,40210,0
112,4510,1289,550,1043,56,32,155,1345,10,167,93,185,177,278,1266,2075,5,11498,638,0,2,28,0,76350,30419,6124,40211,0
233,5732,722,423,573,19,0,135,741,12,172,101,199,184,300,1320,2257,6,15668,870,0,2,2,0,76350,30421,6124,40213,1
233,5732,1508,847,911,44,250,301,1552,14,148,88,169,162,257,1120,1886,7,15077,837,0,2,2,0,76350,30422,6125,40214,1
49,2385,722,423,573,19,0,135,741,12,172,101,199,184,300,1320,2257,6,15668,870,0,2,16,0,76350,30424,6125,40216,1
233,5732,722,423,573,19,0,135,741,12,172,101,199,184,300,1320,2257,6,15668,870,0,2,2,0,76350,30426,6125,40218,0
233,5732,1508,847,911,44,250,301,1552,14,148,88,169,162,257,1120,1886,7,15077,837,0,2,2,0,76350,30427,6126,40219,0
49,2385,722,423,573,19,0,135,741,12,172,101,199,184,300,1320,2257,6,15668,870,0,2,16,0,76350,30429,6126,40221,0
233,4889,2,2,2,0,0,0,2,0,0,0,0,0,0,0,0,0,0,0,0,2,8,0,76350,30429,6126,40221,0
233,4889,99,48,90,1,3,5,100,0,0,0,0,0,0,0,0,0,0,0,0,2,8,0,76350,30430,6126,40222,0
233,4889,8,5,5,2,0,1,10,0,0,0,0,0,0,0,0,0,0,0,0,2,8,0,76350,30430,6126,40223,0
233,4889,1217,716,841,84,126,174,1301,14,185,118,215,199,333,1446,2542,8,20687,1149,0,2,8,0,76360,30432,6126,40224,0
233,4889,160,89,115,0,13,31,160,7,15,11,17,22,28,78,124,3,495,27,0,2,8,0,76360,30432,6126,40225,0
233,4889,10,10,9,9,0,0,19,0,0,0,0,0,0,0,0,0,0,0,0,2,8,0,76360,30432,6127,40226,0
233,4889,173,84,99,8,29,36,181,5,12,7,13,17,20,54,81,2,221,12,0,2,8,0,76360,30433,6127,40227,0
233,4889,3,1,1,3,0,0,6,0,0,0,0,0,0,0,0,0,0,0,0,2,8,0,76360,30433,6127,40228,0
29,1886,384,251,317,7,8,52,391,11,70,44,84,81,128,467,811,6,5355,297,0,2,7,0,76360,30433,6127,40229,0
233,4889,2,2,2,0,0,0,2,0,0,0,0,0,0,0,0,0,0,0,0,2,8,0,76360,30433,6127,40229,0
233,4889,99,48,90,1,3,5,100,0,0,0,0,0,0,0,0,0,0,0,0,2,8,0,76360,30434,6127,40230,0
233,4889,8,5,5,2,0,1,10,0,0,0,0,0,0,0,0,0,0,0,0,2,8,0,76360,30434,6127,40231,0
233,4889,1217,716,841,84,126,174,1301,14,185,118,215,199,333,1446,2542,8,20687,1149,0,2,8,0,76370,30436,6127,40232,0
233,4889,160,89,115,0,13,31,160,7,15,11,17,22,28,78,124,3,495,27,0,2,8,0,76370,30436,6127,40233,0
233,4889,10,10,9,9,0,0,19,0,0,0,0,0,0,0,0,0,0,0,0,2,8,0,76370,30436,6128,40234,0
233,4889,173,84,99,8,29,36,181,5,12,7,13,17,20,54,81,2,221,12,0,2,8,0,76370,30437,6128,40235,0
233,4889,3,1,1,3,0,0,6,0,0,0,0,0,0,0,0,0,0,0,0,2,8,0,76370,30437,6128,40236,0
29,1886,384,251,317,7,8,52,391,11,70,44,84,81,128,467,811,6,5355,297,0,2,7,0,76370,30437,6128,40237,0
157,3301,1513,682,1277,25,13,200,1538,11,199,116,219,210,335,1557,2584,6,15641,868,0,2,4,1,76370,30439,6128,40239,0
157,3301,819,519,539,24,98,155,843,15,96,57,106,111,163,690,1107,8,9171,509,0,2,4,1,76380,30441,6128,40240,0
125,5391,1513,682,1277,25,13,200,1538,11,199,116,219,210,335,1557,2584,6,15641,868,0,2,8,1,76380,30443,6128,40241,0
24,614,2,2,2,0,0,0,2,0,0,0,0,0,0,0,0,0,0,0,0,2,1,0,76380,30443,6128,40241,0
24,614,99,48,90,1,3,5,100,0,0,0,0,0,0,0,0,0,0,0,0,2,1,0,76380,30444,6128,40242,0
24,614,8,5,5,2,0,1,10,0,0,0,0,0,0,0,0,0,0,0,0,2,1,0,76380,30444,6128,40243,0
24,614,1217,716,841,84,126,174,1301,14,185,118,215,199,333,1446,2542,8,20687,1149,0,2,1,0,76390,30446,6128,40244,0
24,614,160,89,115,0,13,31,160,7,15,11,17,22,28,78,124,3,495,27,0,2,1,0,76390,30446,6128,40245,0
24,614,10,10,9,9,0,0,19,0,0,0,0,0,0,0,0,0,0,0,0,2,1,0,76390,30446,6129,40246,0
24,614,173,84,99,8,29,36,181,5,12,7,13,17,20,54,81,2,221,12,0,2,1,0,76390,30447,6129,40247,0
24,614,3,1,1,3,0,0,6,0,0,0,0,0,0,0,0,0,0,0,0,2,1,0,76390,30447,6129,40248,0
157,3301,1513,682,1277,25,13,200,1538,11,199,116,219,210,335,1557,2584,6,15641,868,0,2,4,1,76390,30449,6129,40250,0
157,3301,819,519,539,24,98,155,843,15,96,57,106,111,163,690,1107,8,9171,509,0,2,4,1,76400,30451,6129,40251,0
125,5391,1513,682,1277,25,13,200,1538,11,199,116,219,210,335,1557,2584,6,15641,868,0,2,8,1,76400,30453,6129,40252,0
233,5758,722,423,573,19,0,135,741,12,172,101,199,184,300,1320,2257,6,15668,870,0,2,2,0,76400,30455,6129,40254,0
233,5758,1508,847,911,44,250,301,1552,14,148,88,169,162,257,1120,1886,7,15077,837,0,2,2,0,76400,30456,6130,40255,0
100,4734,1523,757,1297,19,12,193,1542,12,193,117,230,205,347,1508,2664,7,19053,1058,0,2,1,5,76410,30458,6130,40256,0
68,3312,1293,570,1093,25,15,163,1318,10,195,123,241,205,364,1516,2795,6,17273,959,0,2,0,3,76420,30460,6130,40257,0
233,5758,722,423,573,19,0,135,741,12,172,101,199,184,300,1320,2257,6,15668,870,0,2,2,0,76420,30462,6130,40259,0
233,5758,1508,847,911,44,250,301,1552,14,148,88,169,162,257,1120,1886,7,15077,837,0,2,2,0,76420,30463,6131,40260,0
100,4734,1523,757,1297,19,12,193,1542,12,193,117,230,205,347,1508,2664,7,19053,1058,0,2,1,5,76430,30465,6131,40261,0
68,3312,1293,570,1093,25,15,163,1318,10,195,123,241,205,364,1516,2795,6,17273,959,0,2,0,3,76440,30467,6131,40262,0
157,3301,1513,682,1277,25,13,200,1538,11,199,116,219,210,335,1557,2584,6,15641,868,0,2,4,1,76440,30469,6131,40264,0
157,3301,819,519,539,24,98,155,843,15,96,57,106,111,163,690,1107,8,9171,509,0,2,4,1,76450,30471,6131,40265,0
125,5391,1513,682,1277,25,13,200,1538,11,199,116,219,210,335,1557,2584,6,15641,868,0,2,8,1,76450,30473,6131,40266,0
159,3342,1513,682,1277,25,13,200,1538,11,199,116,219,210,335,1557,2584,6,15641,868,0,2,39,26,76450,30475,6131,40267,0
159,3342,819,519,539,24,98,155,843,15,96,57,106,111,163,690,1107,8,9171,509,0,2,39,26,76460,30477,6131,40268,0
125,5391,1513,682,1277,25,13,200,1538,11,199,116,219,210,335,1557,2584,6,15641,868,0,2,1,1,76460,30479,6131,40269,0
159,3338,1513,682,1277,25,13,200,1538,11,199,116,219,210,335,1557,2584,6,15641,868,0,2,10,14,76460,30481,6131,40270,0
159,3338,819,519,539,24,98,155,843,15,96,57,106,111,163,690,1107,8,9171,509,0,2,10,14,76470,30483,6131,40271,0
157,3301,1513,682,1277,25,13,200,1538,11,199,116,219,210,335,1557,2584,6,15641,868,0,2,4,1,76470,30485,6131,40273,0
157,3301,819,519,539,24,98,155,843,15,96,57,106,111,163,690,1107,8,9171,509,0,2,4,1,76480,30487,6131,40274,0
125,5391,1513,682,1277,25,13,200,1538,11,199,116,219,210,335,1557,2584,6,15641,868,0,2,8,1,76480,30489,6131,40275,0
37,940,466,257,367,18,25,50,484,7,126,86,171,133,257,898,1813,4,8612,478,0,2,83,0,76480,30489,6131,40276,0
37,940,507,281,342,29,59,88,536,10,53,29,57,63,86,336,514,5,2764,153,0,2,83,0,76480,30489,6131,40277,0
89,1894,1043,504,840,53,9,147,1096,9,180,112,198,189,310,1377,2344,4,11604,644,0,2,1,37,76480,30491,6131,40278,0
89,1894,383,288,292,26,6,62,409,11,65,38,67,76,105,429,656,5,3719,206,0,2,1,37,76480,30492,6131,40279,0
249,5128,1943,715,1694,26,18,214,1969,12,185,120,237,197,357,1436,2721,7,20915,1161,0,2,22,17,76480,30494,6131,40280,0
249,5128,1168,838,957,57,25,144,1225,19,348,224,416,367,640,3018,5452,11,61921,3440,1,2,22,17,76490,30496,6131,40281,0
102,5449,1943,715,1694,26,18,214,1969,12,185,120,237,197,357,1436,2721,7,20915,1161,0,2,15,0,76490,30498,6131,40282,0
37,940,466,257,367,18,25,50,484,7,126,86,171,133,257,898,1813,4,8612,478,0,2,83,0,76490,30498,6131,40283,0
37,940,507,281,342,29,59,88,536,10,53,29,57,63,86,336,514,5,2764,153,0,2,83,0,76490,30498,6131,40284,0
89,1894,1043,504,840,53,9,147,1096,9,180,112,198,189,310,1377,2344,4,11604,644,0,2,1,37,76490,30500,6131,40285,0
89,1894,383,288,292,26,6,62,409,11,65,38,67,76,105,429,656,5,3719,206,0,2,1,37,76490,30501,6131,40286,0
249,5128,1943,715,1694,26,18,214,1969,12,185,120,237,197,357,1436,2721,7,20915,1161,0,2,22,17,76490,30503,6131,40287,0
249,5128,1168,838,957,57,25,144,1225,19,348,224,416,367,640,3018,5452,11,61921,3440,1,2,22,17,76500,30505,6131,40288,0
102,5449,1943,715,1694,26,18,214,1969,12,185,120,237,197,357,1436,2721,7,20915,1161,0,2,15,0,76500,30507,6131,40289,0
159,3344,1513,682,1277,25,13,200,1538,11,199,116,219,210,335,1557,2584,6,15641,868,0,2,49,40,76500,30509,6131,40290,0
159,3344,819,519,539,24,98,155,843,15,96,57,106,111,163,690,1107,8,9171,509,0,2,49,40,76510,30511,6131,40291,0
125,5391,1513,682,1277,25,13,200,1538,11,199,116,219,210,335,1557,2584,6,15641,868,0,2,1,1,76510,30513,6131,40292,0
233,5797,722,423,573,19,0,135,741,12,172,101,199,184,300,1320,2257,6,15668,870,0,2,10,2,76510,30515,6131,40294,0
233,5797,1508,847,911,44,250,301,1552,14,148,88,169,162,257,1120,1886,7,15077,837,0,2,10,2,76510,30516,6132,40295,0
100,4747,1523,757,1297,19,12,193,1542,12,193,117,230,205,347,1508,2664,7,19053,1058,0,2,2,1,76520,30518,6132,40296,0
245,5668,4293,999,3693,19,54,507,4312,9,155,88,170,164,258,1156,1898,4,9368,520,0,2,1,1,76520,30520,6132,40297,0
245,5668,1482,859,1002,125,135,219,1607,16,219,134,251,235,385,1766,3032,9,27804,1544,1,2,1,1,76530,30521,6132,40298,0
170,7538,139,89,101,2,0,35,141,7,54,34,62,61,96,330,569,4,2287,127,0,2,2,2,76530,30521,6132,40299,0
170,7538,7,5,5,0,0,2,7,1,2,1,2,3,3,2,4,0,2,0,0,2,2,2,76530,30521,6132,40300,0
233,5797,722,423,573,19,0,135,741,12,172,101,199,184,300,1320,2257,6,15668,870,0,2,10,2,76530,30523,6132,40302,0
233,5797,1508,847,911,44,250,301,1552,14,148,88,169,162,257,1120,1886,7,15077,837,0,2,10,2,76530,30524,6133,40303,0
100,4747,1523,757,1297,19,12,193,1542,12,193,117,230,205,347,1508,2664,7,19053,1058,0,2,2,1,76540,30526,6133,40304,0
234,4906,2,2,2,0,0,0,2,0,0,0,0,0,0,0,0,0,0,0,0,2,8,3,76540,30526,6133,40304,0
234,4906,99,48,90,1,3,5,100,0,0,0,0,0,0,0,0,0,0,0,0,2,8,3,76540,30527,6133,40305,0
234,4906,8,5,5,2,0,1,10,0,0,0,0,0,0,0,0,0,0,0,0,2,8,3,76540,30527,6133,40306,0
234,4906,1217,716,841,84,126,174,1301,14,185,118,215,199,333,1446,2542,8,20687,1149,0,2,8,3,76550,30529,6133,40307,0
234,4906,160,89,115,0,13,31,160,7,15,11,17,22,28,78,124,3,495,27,0,2,8,3,76550,30529,6133,40308,0
234,4906,10,10,9,9,0,0,19,0,0,0,0,0,0,0,0,0,0,0,0,2,8,3,76550,30529,6134,40309,0
234,4906,173,84,99,8,29,36,181,5,12,7,13,17,20,54,81,2,221,12,0,2,8,3,76550,30530,6134,40310,0
234,4906,3,1,1,3,0,0,6,0,0,0,0,0,0,0,0,0,0,0,0,2,8,3,76550,30530,6134,40311,0
97,5074,1457,730,1242,11,6,188,1468,10,292,166,329,302,495,2424,4078,5,22973,1276,1,2,13,0,76550,30532,6134,40312,0
249,5132,1943,715,1694,26,18,214,1969,12,185,120,237,197,357,1436,2721,7,20915,1161,0,2,2,2,76550,30534,6134,40313,0
249,5132,1168,838,957,57,25,144,1225,19,348,224,416,367,640,3018,5452,11,61921,3440,1,2,2,2,76560,30536,6134,40314,0
97,5072,1457,730,1242,11,6,188,1468,10,292,166,329,302,495,2424,4078,5,22973,1276,1,2,1,1,76560,30538,6134,40315,0
248,5116,1943,715,1694,26,18,214,1969,12,185,120,237,197,357,1436,2721,7,20915,1161,0,2,0,2,76560,30540,6134,40316,0
248,5116,1168,838,957,57,25,144,1225,19,348,224,416,367,640,3018,5452,11,61921,3440,1,2,0,2,76570,30542,6134,40317,0
234,4906,2,2,2,0,0,0,2,0,0,0,0,0,0,0,0,0,0,0,0,2,8,3,76570,30542,6134,40317,0
234,4906,99,48,90,1,3,5,100,0,0,0,0,0,0,0,0,0,0,0,0,2,8,3,76570,30543,6134,40318,0
234,4906,8,5,5,2,0,1,10,0,0,0,0,0,0,0,0,0,0,0,0,2,8,3,76570,30543,6134,40319,0
234,4906,1217,716,841,84,126,174,1301,14,185,118,215,199,333,1446,2542,8,20687,1149,0,2,8,3,76580,30545,6134,40320,0
234,4906,160,89,115,0,13,31,160,7,15,11,17,22,28,78,124,3,495,27,0,2,8,3,76580,30545,6134,40321,0
234,4906,10,10,9,9,0,0,19,0,0,0,0,0,0,0,0,0,0,0,0,2,8,3,76580,30545,6135,40322,0
234,4906,173,84,99,8,29,36,181,5,12,7,13,17,20,54,81,2,221,12,0,2,8,3,76580,30546,6135,40323,0
234,4906,3,1,1,3,0,0,6,0,0,0,0,0,0,0,0,0,0,0,0,2,8,3,76580,30546,6135,40324,0
248,5116,1943,715,1694,26,18,214,1969,12,185,120,237,197,357,1436,2721,7,20915,1161,0,2,1,3,76580,30548,6135,40325,0
248,5116,1168,838,957,57,25,144,1225,19,348,224,416,367,640,3018,5452,11,61921,3440,1,2,1,3,76590,30550,6135,40326,0
97,5072,1457,730,1242,11,6,188,1468,10,292,166,329,302,495,2424,4078,5,22973,1276,1,2,13,0,76590,30552,6135,40327,0
78,1822,996,429,845,24,10,117,1020,7,76,50,88,83,138,494,879,4,3565,198,0,2,3,4,76590,30554,6135,40328,0
78,1822,456,277,329,12,42,72,468,13,85,50,97,98,147,592,972,7,7212,400,0,2,3,4,76590,30554,6135,40329,0
78,1822,996,429,845,24,10,117,1020,7,76,50,88,83,138,494,879,4,3565,198,0,2,3,4,76590,30556,6135,40330,0
78,1822,456,277,329,12,42,72,468,13,85,50,97,98,147,592,972,7,7212,400,0,2,3,4,76590,30556,6135,40331,0
248,5119,1943,715,1694,26,18,214,1969,12,185,120,237,197,357,1436,2721,7,20915,1161,0,2,3,1,76590,30558,6135,40332,0
248,5119,1168,838,957,57,25,144,1225,19,348,224,416,367,640,3018,5452,11,61921,3440,1,2,3,1,76600,30560,6135,40333,0
103,5526,1943,715,1694,26,18,214,1969,12,185,120,237,197,357,1436,2721,7,20915,1161,0,2,25,0,76600,30562,6135,40334,0
248,5119,1943,715,1694,26,18,214,1969,12,185,120,237,197,357,1436,2721,7,20915,1161,0,2,3,1,76600,30564,6135,40335,0
248,5119,1168,838,957,57,25,144,1225,19,348,224,416,367,640,3018,5452,11,61921,3440,1,2,3,1,76610,30566,6135,40336,0
103,5526,1943,715,1694,26,18,214,1969,12,185,120,237,197,357,1436,2721,7,20915,1161,0,2,25,0,76610,30568,6135,40337,0
234,4911,2,2,2,0,0,0,2,0,0,0,0,0,0,0,0,0,0,0,0,2,1,1,76610,30568,6135,40337,0
234,4911,99,48,90,1,3,5,100,0,0,0,0,0,0,0,0,0,0,0,0,2,1,1,76610,30569,6135,40338,0
234,4911,8,5,5,2,0,1,10,0,0,0,0,0,0,0,0,0,0,0,0,2,1,1,76610,30569,6135,40339,0
234,4911,1217,716,841,84,126,174,1301,14,185,118,215,199,333,1446,2542,8,20687,1149,0,2,1,1,76620,30571,6135,40340,0
234,4911,160,89,115,0,13,31,160,7,15,11,17,22,28,78,124,3,495,27,0,2,1,1,76620,30571,6135,40341,0
234,4911,10,10,9,9,0,0,19,0,0,0,0,0,0,0,0,0,0,0,0,2,1,1,76620,30571,6136,40342,0
234,4911,173,84,99,8,29,36,181,5,12,7,13,17,20,54,81,2,221,12,0,2,1,1,76620,30572,6136,40343,0
234,4911,3,1,1,3,0,0,6,0,0,0,0,0,0,0,0,0,0,0,0,2,1,1,76620,30572,6136,40344,0
158,3743,77,34,69,0,0,8,77,3,24,16,29,27,45,114,213,1,387,21,0,2,1,1,76620,30572,6136,40345,0
158,3743,712,438,573,51,9,84,763,14,102,71,128,116,199,733,1364,8,11988,666,0,2,1,1,76630,30573,6136,40346,0
89,1902,1043,504,840,53,9,147,1096,9,180,112,198,189,310,1377,2344,4,11604,644,0,2,3,3,76630,30575,6136,40347,0
89,1902,383,288,292,26,6,62,409,11,65,38,67,76,105,429,656,5,3719,206,0,2,3,3,76630,30576,6136,40348,0
248,5121,1943,715,1694,26,18,214,1969,12,185,120,237,197,357,1436,2721,7,20915,1161,0,2,1,1,76630,30578,6136,40349,0
248,5121,1168,838,957,57,25,144,1225,19,348,224,416,367,640,3018,5452,11,61921,3440,1,2,1,1,76640,30580,6136,40350,0
100,5227,1457,730,1242,11,6,188,1468,10,292,166,329,302,495,2424,4078,5,22973,1276,1,2,39,0,76640,30582,6136,40351,0
234,4911,2,2,2,0,0,0,2,0,0,0,0,0,0,0,0,0,0,0,0,2,1,1,76640,30582,6136,40351,0
234,4911,99,48,90,1,3,5,100,0,0,0,0,0,0,0,0,0,0,0,0,2,1,1,76640,30583,6136,40352,0
234,4911,8,5,5,2,0,1,10,0,0,0,0,0,0,0,0,0,0,0,0,2,1,1,76640,30583,6136,40353,0
234,4911,1217,716,841,84,126,174,1301,14,185,118,215,199,333,1446,2542,8,20687,1149,0,2,1,1,76650,30585,6136,40354,0
234,4911,160,89,115,0,13,31,160,7,15,11,17,22,28,78,124,3,495,27,0,2,1,1,76650,30585,6136,40355,0
234,4911,10,10,9,9,0,0,19,0,0,0,0,0,0,0,0,0,0,0,0,2,1,1,76650,30585,6137,40356,0
234,4911,173,84,99,8,29,36,181,5,12,7,13,17,20,54,81,2,221,12,0,2,1,1,76650,30586,6137,40357,0
234,4911,3,1,1,3,0,0,6,0,0,0,0,0,0,0,0,0,0,0,0,2,1,1,76650,30586,6137,40358,0
158,3743,77,34,69,0,0,8,77,3,24,16,29,27,45,114,213,1,387,21,0,2,1,1,76650,30586,6137,40359,0
158,3743,712,438,573,51,9,84,763,14,102,71,128,116,199,733,1364,8,11988,666,0,2,1,1,76660,30587,6137,40360,0
89,1902,1043,504,840,53,9,147,1096,9,180,112,198,189,310,1377,2344,4,11604,644,0,2,3,3,76660,30589,6137,40361,0
89,1902,383,288,292,26,6,62,409,11,65,38,67,76,105,429,656,5,3719,206,0,2,3,3,76660,30590,6137,40362,0
248,5121,1943,715,1694,26,18,214,1969,12,185,120,237,197,357,1436,2721,7,20915,1161,0,2,1,1,76660,30592,6137,40363,0
248,5121,1168,838,957,57,25,144,1225,19,348,224,416,367,640,3018,5452,11,61921,3440,1,2,1,1,76670,30594,6137,40364,0
100,5227,1457,730,1242,11,6,188,1468,10,292,166,329,302,495,2424,4078,5,22973,1276,1,2,39,0,76670,30596,6137,40365,0
235,4912,2,2,2,0,0,0,2,0,0,0,0,0,0,0,0,0,0,0,0,2,4,1,76670,30596,6137,40365,0
235,4912,99,48,90,1,3,5,100,0,0,0,0,0,0,0,0,0,0,0,0,2,4,1,76670,30597,6137,40366,0
235,4912,8,5,5,2,0,1,10,0,0,0,0,0,0,0,0,0,0,0,0,2,4,1,76670,30597,6137,40367,0
235,4912,1217,716,841,84,126,174,1301,14,185,118,215,199,333,1446,2542,8,20687,1149,0,2,4,1,76680,30599,6137,40368,0
235,4912,160,89,115,0,13,31,160,7,15,11,17,22,28,78,124,3,495,27,0,2,4,1,76680,30599,6137,40369,0
235,4912,10,10,9,9,0,0,19,0,0,0,0,0,0,0,0,0,0,0,0,2,4,1,76680,30599,6138,40370,0
235,4912,173,84,99,8,29,36,181,5,12,7,13,17,20,54,81,2,221,12,0,2,4,1,76680,30600,6138,40371,0
235,4912,3,1,1,3,0,0,6,0,0,0,0,0,0,0,0,0,0,0,0,2,4,1,76680,30600,6138,40372,0
29,1894,384,251,317,7,8,52,391,11,70,44,84,81,128,467,811,6,5355,297,0,2,3,0,76680,30600,6138,40373,0
235,4917,2,2,2,0,0,0,2,0,0,0,0,0,0,0,0,0,0,0,0,2,4,1,76680,30600,6138,40373,0
235,4917,99,48,90,1,3,5,100,0,0,0,0,0,0,0,0,0,0,0,0,2,4,1,76680,30601,6138,40374,0
235,4917,8,5,5,2,0,1,10,0,0,0,0,0,0,0,0,0,0,0,0,2,4,1,76680,30601,6138,40375,0
235,4917,1217,716,841,84,126,174,1301,14,185,118,215,199,333,1446,2542,8,20687,1149,0,2,4,1,76690,30603,6138,40376,0
235,4917,160,89,115,0,13,31,160,7,15,11,17,22,28,78,124,3,495,27,0,2,4,1,76690,30603,6138,40377,0
235,4917,10,10,9,9,0,0,19,0,0,0,0,0,0,0,0,0,0,0,0,2,4,1,76690,30603,6139,40378,0
235,4917,173,84,99,8,29,36,181,5,12,7,13,17,20,54,81,2,221,12,0,2,4,1,76690,30604,6139,40379,0
235,4917,3,1,1,3,0,0,6,0,0,0,0,0,0,0,0,0,0,0,0,2,4,1,76690,30604,6139,40380,0
29,1894,384,251,317,7,8,52,391,11,70,44,84,81,128,467,811,6,5355,297,0,2,3,0,76690,30604,6139,40381,0
24,614,2,2,2,0,0,0,2,0,0,0,0,0,0,0,0,0,0,0,0,2,1,0,76690,30604,6139,40381,0
24,614,99,48,90,1,3,5,100,0,0,0,0,0,0,0,0,0,0,0,0,2,1,0,76690,30605,6139,40382,0
24,614,8,5,5,2,0,1,10,0,0,0,0,0,0,0,0,0,0,0,0,2,1,0,76690,30605,6139,40383,0
24,614,1217,716,841,84,126,174,1301,14,185,118,215,199,333,1446,2542,8,20687,1149,0,2,1,0,76700,30607,6139,40384,0
24,614,160,89,115,0,13,31,160,7,15,11,17,22,28,78,124,3,495,27,0,2,1,0,76700,30607,6139,40385,0
24,614,10,10,9,9,0,0,19,0,0,0,0,0,0,0,0,0,0,0,0,2,1,0,76700,30607,6140,40386,0
24,614,173,84,99,8,29,36,181,5,12,7,13,17,20,54,81,2,221,12,0,2,1,0,76700,30608,6140,40387,0
24,614,3,1,1,3,0,0,6,0,0,0,0,0,0,0,0,0,0,0,0,2,1,0,76700,30608,6140,40388,0
176,5282,1660,832,1314,41,38,274,1701,20,312,209,395,332,604,2671,5058,12,64042,3557,1,2,52,17,76700,30610,6141,40390,0
158,3743,77,34,69,0,0,8,77,3,24,16,29,27,45,114,213,1,387,21,0,2,1,1,76700,30610,6141,40391,0
158,3743,712,438,573,51,9,84,763,14,102,71,128,116,199,733,1364,8,11988,666,0,2,1,1,76710,30611,6141,40392,0
47,3455,996,429,845,24,10,117,1020,7,76,50,88,83,138,494,879,4,3565,198,0,2,1,1,76710,30613,6141,40393,0
112,4510,1289,550,1043,56,32,155,1345,10,167,93,185,177,278,1266,2075,5,11498,638,0,2,2,0,76710,30615,6142,40394,0
54,1156,447,308,343,6,5,95,453,7,96,59,111,103,170,651,1136,4,4600,255,0,2,5,0,76710,30618,6142,40395,1
54,1156,322,174,179,16,74,51,338,10,41,26,46,51,72,252,408,5,2291,127,0,2,5,0,76710,30621,6143,40396,1
47,2152,447,308,343,6,5,95,453,7,96,59,111,103,170,651,1136,4,4600,255,0,2,25,0,76710,30624,6143,40397,1
90,3956,1338,495,1086,10,64,173,1348,11,122,82,157,133,239,883,1686,7,11934,663,0,2,0,2,76710,30626,6143,40398,0
170,5125,1660,832,1314,41,38,274,1701,20,312,209,395,332,604,2671,5058,12,64042,3557,1,2,1,1,76710,30628,6144,40400,0
233,5808,722,423,573,19,0,135,741,12,172,101,199,184,300,1320,2257,6,15668,870,0,2,7,2,76710,30630,6144,40402,1
233,5808,1508,847,911,44,250,301,1552,14,148,88,169,162,257,1120,1886,7,15077,837,0,2,7,2,76710,30631,6145,40403,1
232,5798,722,423,573,19,0,135,741,12,172,101,199,184,300,1320,2257,6,15668,870,0,2,3,5,76710,30633,6145,40405,1
232,5798,1508,847,911,44,250,301,1552,14,148,88,169,162,257,1120,1886,7,15077,837,0,2,3,5,76710,30634,6146,40406,1
29,1879,384,251,317,7,8,52,391,11,70,44,84,81,128,467,811,6,5355,297,0,2,4,5,76710,30634,6146,40407,0
21,500,207,111,150,11,0,50,218,5,26,19,36,31,55,133,272,3,943,52,0,2,13,8,76710,30634,6146,40408,1
29,1306,373,158,315,8,0,51,381,5,76,44,79,81,123,486,779,2,2026,112,0,2,2,4,76710,30634,6146,40409,1
230,4977,182,127,129,0,0,53,182,5,39,21,42,44,63,217,343,2,926,51,0,2,1,0,76710,30634,6147,40410,0
230,4977,1165,710,800,67,119,181,1232,18,243,153,282,261,435,2000,3492,10,36473,2026,1,2,1,0,76720,30634,6148,40411,0
36,1120,182,127,129,0,0,53,182,5,39,21,42,44,63,217,343,2,926,51,0,2,4,0,76720,30634,6149,40412,0
112,4514,1289,550,1043,56,32,155,1345,10,167,93,185,177,278,1266,2075,5,11498,638,0,2,2,2,76720,30636,6150,40413,0
14,845,75,38,59,1,3,12,76,2,4,2,4,6,6,10,15,1,15,0,0,2,1,1,76720,30636,6150,40414,0
36,2461,1157,318,931,29,22,177,1186,6,104,63,125,110,188,712,1274,3,4596,255,0,2,1,1,76720,30636,6150,40415,0
90,3992,1338,495,1086,10,64,173,1348,11,122,82,157,133,239,883,1686,7,11934,663,0,2,9,9,76720,30638,6150,40416,0
171,7580,4293,999,3693,19,54,507,4312,9,155,88,170,164,258,1156,1898,4,9368,520,0,2,6,6,76720,30640,6150,40417,0
171,7580,1482,859,1002,125,135,219,1607,16,219,134,251,235,385,1766,3032,9,27804,1544,1,2,6,6,76730,30641,6150,40418,0
170,5149,1660,832,1314,41,38,274,1701,20,312,209,395,332,604,2671,5058,12,64042,3557,1,2,7,7,76730,30643,6151,40420,0
47,3469,996,429,845,24,10,117,1020,7,76,50,88,83,138,494,879,4,3565,198,0,2,7,7,76730,30645,6151,40421,0
125,5393,1513,682,1277,25,13,200,1538,11,199,116,219,210,335,1557,2584,6,15641,868,0,2,1,1,76730,30647,6151,40422,0
84,4877,1296,573,1062,40,33,157,1336,8,201,118,231,209,349,1561,2689,4,12365,686,0,2,4,4,76730,30647,6151,40423,0
100,5229,1457,730,1242,11,6,188,1468,10,292,166,329,302,495,2424,4078,5,22973,1276,1,2,1,1,76730,30649,6151,40424,0
72,3310,1455,414,1257,16,76,112,1471,5,41,23,46,46,69,231,381,2,1069,59,0,2,1,1,76730,30650,6151,40425,0
21,655,424,94,331,4,0,89,428,1,5,5,5,6,10,11,25,0,12,0,0,2,1,1,76730,30651,6151,40426,0
83,3328,1043,504,840,53,9,147,1096,9,180,112,198,189,310,1377,2344,4,11604,644,0,2,5,5,76730,30653,6151,40427,0
81,3287,1178,367,1042,6,15,115,1184,9,94,51,95,103,146,644,976,4,4439,246,0,2,9,7,76730,30653,6151,40428,0
37,1527,442,244,305,14,16,103,456,11,68,45,75,79,120,452,756,6,4588,254,0,2,1,1,76730,30655,6151,40429,0
52,1994,1098,241,925,5,10,155,1103,7,46,25,49,53,74,273,423,3,1580,87,0,2,2,2,76740,30657,6151,40430,0
125,5396,1513,682,1277,25,13,200,1538,11,199,116,219,210,335,1557,2584,6,15641,868,0,2,11,1,76740,30659,6151,40431,0
159,3781,77,34,69,0,0,8,77,3,24,16,29,27,45,114,213,1,387,21,0,2,9,0,76740,30659,6151,40432,0
159,3781,712,438,573,51,9,84,763,14,102,71,128,116,199,733,1364,8,11988,666,0,2,9,0,76750,30660,6151,40433,0
170,7547,139,89,101,2,0,35,141,7,54,34,62,61,96,330,569,4,2287,127,0,2,1,0,76750,30660,6151,40434,0
170,7547,7,5,5,0,0,2,7,1,2,1,2,3,3,2,4,0,2,0,0,2,1,0,76750,30660,6151,40435,0
30,1324,373,158,315,8,0,51,381,5,76,44,79,81,123,486,779,2,2026,112,0,2,2,1,76750,30660,6151,40436,0
30,1342,373,158,315,8,0,51,381,5,76,44,79,81,123,486,779,2,2026,112,0,2,2,2,76750,30660,6151,40437,0
53,1862,601,196,481,2,23,85,603,8,63,36,72,71,108,400,664,4,3036,168,0,2,4,2,76750,30660,6151,40438,0
29,743,601,196,481,2,23,85,603,8,63,36,72,71,108,400,664,4,3036,168,0,2,2,1,76750,30660,6151,40439,0
29,743,156,79,106,5,16,28,161,5,14,8,15,19,23,64,97,2,261,14,0,2,2,1,76750,30660,6151,40440,0
36,2459,1157,318,931,29,22,177,1186,6,104,63,125,110,188,712,1274,3,4596,255,0,2,1,0,76750,30660,6151,40441,0
103,5526,1943,715,1694,26,18,214,1969,12,185,120,237,197,357,1436,2721,7,20915,1161,0,2,0,1,76750,30662,6151,40442,0
36,2434,1157,318,931,29,22,177,1186,6,104,63,125,110,188,712,1274,3,4596,255,0,2,6,7,76750,30662,6151,40443,0
36,2425,1157,318,931,29,22,177,1186,6,104,63,125,110,188,712,1274,3,4596,255,0,2,4,4,76750,30662,6151,40444,0
75,1617,53,23,39,0,0,13,53,2,8,4,8,10,12,26,39,1,39,2,0,2,8,1,76750,30662,6151,40445,1
75,1617,515,298,307,33,80,99,548,12,63,44,77,75,121,419,753,7,5527,307,0,2,8,1,76760,30662,6151,40446,1
85,4928,1296,573,1062,40,33,157,1336,8,201,118,231,209,349,1561,2689,4,12365,686,0,2,18,0,76760,30662,6151,40447,1
159,3781,77,34,69,0,0,8,77,3,24,16,29,27,45,114,213,1,387,21,0,2,9,0,76760,30662,6151,40448,0
159,3781,712,438,573,51,9,84,763,14,102,71,128,116,199,733,1364,8,11988,666,0,2,9,0,76770,30663,6151,40449,0
21,500,207,111,150,11,0,50,218,5,26,19,36,31,55,133,272,3,943,52,0,2,13,8,76770,30663,6151,40450,0
29,1306,373,158,315,8,0,51,381,5,76,44,79,81,123,486,779,2,2026,112,0,2,2,4,76770,30663,6151,40451,0
52,625,647,139,84,35,284,233,682,0,0,0,0,0,0,0,0,0,0,0,0,2,2,1,76770,30663,6151,40452,0
54,1156,447,308,343,6,5,95,453,7,96,59,111,103,170,651,1136,4,4600,255,0,2,5,0,76770,30666,6151,40453,0
54,1156,322,174,179,16,74,51,338,10,41,26,46,51,72,252,408,5,2291,127,0,2,5,0,76770,30669,6152,40454,0
232,5798,722,423,573,19,0,135,741,12,172,101,199,184,300,1320,2257,6,15668,870,0,2,10,7,76770,30671,6152,40456,0
232,5798,1508,847,911,44,250,301,1552,14,148,88,169,162,257,1120,1886,7,15077,837,0,2,10,7,76770,30672,6153,40457,0
90,3956,1338,495,1086,10,64,173,1348,11,122,82,157,133,239,883,1686,7,11934,663,0,2,0,2,76770,30674,6153,40458,0
170,5125,1660,832,1314,41,38,274,1701,20,312,209,395,332,604,2671,5058,12,64042,3557,1,2,1,1,76770,30676,6154,40460,0
47,2152,447,308,343,6,5,95,453,7,96,59,111,103,170,651,1136,4,4600,255,0,2,25,0,76770,30679,6154,40461,0
29,1879,384,251,317,7,8,52,391,11,70,44,84,81,128,467,811,6,5355,297,0,2,4,5,76770,30679,6154,40462,0
230,4977,182,127,129,0,0,53,182,5,39,21,42,44,63,217,343,2,926,51,0,2,1,0,76770,30679,6155,40463,0
230,4977,1165,710,800,67,119,181,1232,18,243,153,282,261,435,2000,3492,10,36473,2026,1,2,1,0,76780,30679,6156,40464,0
36,1120,182,127,129,0,0,53,182,5,39,21,42,44,63,217,343,2,926,51,0,2,4,0,76780,30679,6157,40465,0
112,4514,1289,550,1043,56,32,155,1345,10,167,93,185,177,278,1266,2075,5,11498,638,0,2,2,2,76780,30681,6158,40466,0
14,845,75,38,59,1,3,12,76,2,4,2,4,6,6,10,15,1,15,0,0,2,1,1,76780,30681,6158,40467,0
36,2461,1157,318,931,29,22,177,1186,6,104,63,125,110,188,712,1274,3,4596,255,0,2,1,1,76780,30681,6158,40468,0
90,3974,1338,495,1086,10,64,173,1348,11,122,82,157,133,239,883,1686,7,11934,663,0,2,9,9,76780,30683,6158,40469,0
171,7580,4293,999,3693,19,54,507,4312,9,155,88,170,164,258,1156,1898,4,9368,520,0,2,6,6,76780,30685,6158,40470,0
171,7580,1482,859,1002,125,135,219,1607,16,219,134,251,235,385,1766,3032,9,27804,1544,1,2,6,6,76790,30686,6158,40471,0
170,5139,1660,832,1314,41,38,274,1701,20,312,209,395,332,604,2671,5058,12,64042,3557,1,2,7,7,76790,30688,6159,40473,0
47,3469,996,429,845,24,10,117,1020,7,76,50,88,83,138,494,879,4,3565,198,0,2,7,7,76790,30690,6159,40474,0
125,5393,1513,682,1277,25,13,200,1538,11,199,116,219,210,335,1557,2584,6,15641,868,0,2,1,1,76790,30692,6159,40475,0
84,4877,1296,573,1062,40,33,157,1336,8,201,118,231,209,349,1561,2689,4,12365,686,0,2,4,4,76790,30692,6159,40476,0
100,5229,1457,730,1242,11,6,188,1468,10,292,166,329,302,495,2424,4078,5,22973,1276,1,2,1,1,76790,30694,6159,40477,0
72,3310,1455,414,1257,16,76,112,1471,5,41,23,46,46,69,231,381,2,1069,59,0,2,1,1,76790,30695,6159,40478,0
21,655,424,94,331,4,0,89,428,1,5,5,5,6,10,11,25,0,12,0,0,2,1,1,76790,30696,6159,40479,0
83,3328,1043,504,840,53,9,147,1096,9,180,112,198,189,310,1377,2344,4,11604,644,0,2,5,5,76790,30698,6159,40480,0
81,3287,1178,367,1042,6,15,115,1184,9,94,51,95,103,146,644,976,4,4439,246,0,2,9,7,76790,30698,6159,40481,0
37,1527,442,244,305,14,16,103,456,11,68,45,75,79,120,452,756,6,4588,254,0,2,1,1,76790,30700,6159,40482,0
52,1994,1098,241,925,5,10,155,1103,7,46,25,49,53,74,273,423,3,1580,87,0,2,2,2,76800,30702,6159,40483,0
176,5286,1660,832,1314,41,38,274,1701,20,312,209,395,332,604,2671,5058,12,64042,3557,1,2,52,17,76800,30704,6160,40485,0
125,5396,1513,682,1277,25,13,200,1538,11,199,116,219,210,335,1557,2584,6,15641,868,0,2,11,1,76800,30706,6160,40486,0
60,1610,466,257,367,18,25,50,484,7,126,86,171,133,257,898,1813,4,8612,478,0,2,132,0,76800,30706,6160,40487,1
60,1610,507,281,342,29,59,88,536,10,53,29,57,63,86,336,514,5,2764,153,0,2,132,0,76800,30706,6160,40488,1
21,1078,466,257,367,18,25,50,484,7,126,86,171,133,257,898,1813,4,8612,478,0,0,183,0,76800,30706,6160,40489,1
235,4919,2,2,2,0,0,0,2,0,0,0,0,0,0,0,0,0,0,0,0,2,1,0,76800,30706,6160,40489,0
235,4919,99,48,90,1,3,5,100,0,0,0,0,0,0,0,0,0,0,0,0,2,1,0,76800,30707,6160,40490,0
235,4919,8,5,5,2,0,1,10,0,0,0,0,0,0,0,0,0,0,0,0,2,1,0,76800,30707,6160,40491,0
235,4919,1217,716,841,84,126,174,1301,14,185,118,215,199,333,1446,2542,8,20687,1149,0,2,1,0,76810,30709,6160,40492,0
235,4919,160,89,115,0,13,31,160,7,15,11,17,22,28,78,124,3,495,27,0,2,1,0,76810,30709,6160,40493,0
235,4919,10,10,9,9,0,0,19,0,0,0,0,0,0,0,0,0,0,0,0,2,1,0,76810,30709,6161,40494,0
235,4919,173,84,99,8,29,36,181,5,12,7,13,17,20,54,81,2,221,12,0,2,1,0,76810,30710,6161,40495,0
235,4919,3,1,1,3,0,0,6,0,0,0,0,0,0,0,0,0,0,0,0,2,1,0,76810,30710,6161,40496,0
54,657,647,139,84,35,284,233,682,0,0,0,0,0,0,0,0,0,0,0,0,2,35,0,76810,30710,6161,40497,0
66,1698,466,257,367,18,25,50,484,7,126,86,171,133,257,898,1813,4,8612,478,0,2,16,0,76810,30710,6161,40498,0
66,1698,507,281,342,29,59,88,536,10,53,29,57,63,86,336,514,5,2764,153,0,2,16,0,76810,30710,6161,40499,0
25,1292,466,257,367,18,25,50,484,7,126,86,171,133,257,898,1813,4,8612,478,0,2,50,0,76810,30710,6161,40500,0
66,1701,466,257,367,18,25,50,484,7,126,86,171,133,257,898,1813,4,8612,478,0,2,2,0,76810,30710,6161,40501,0
66,1701,507,281,342,29,59,88,536,10,53,29,57,63,86,336,514,5,2764,153,0,2,2,0,76810,30710,6161,40502,0
54,657,647,139,84,35,284,233,682,0,0,0,0,0,0,0,0,0,0,0,0,2,2,2,76810,30710,6161,40503,0
66,1702,466,257,367,18,25,50,484,7,126,86,171,133,257,898,1813,4,8612,478,0,2,1,1,76810,30710,6161,40504,0
66,1702,507,281,342,29,59,88,536,10,53,29,57,63,86,336,514,5,2764,153,0,2,1,1,76810,30710,6161,40505,0
25,1299,466,257,367,18,25,50,484,7,126,86,171,133,257,898,1813,4,8612,478,0,2,23,4,76810,30710,6161,40506,0
66,1712,466,257,367,18,25,50,484,7,126,86,171,133,257,898,1813,4,8612,478,0,2,2,1,76810,30710,6161,40507,1
66,1712,507,281,342,29,59,88,536,10,53,29,57,63,86,336,514,5,2764,153,0,2,2,1,76810,30710,6161,40508,1
26,1396,466,257,367,18,25,50,484,7,126,86,171,133,257,898,1813,4,8612,478,0,2,21,3,76810,30710,6161,40509,1
66,1712,466,257,367,18,25,50,484,7,126,86,171,133,257,898,1813,4,8612,478,0,2,2,2,76810,30710,6161,40510,1
66,1712,507,281,342,29,59,88,536,10,53,29,57,63,86,336,514,5,2764,153,0,2,2,2,76810,30710,6161,40511,1
27,1494,466,257,367,18,25,50,484,7,126,86,171,133,257,898,1813,4,8612,478,0,2,23,0,76810,30710,6161,40512,1
170,7547,139,89,101,2,0,35,141,7,54,34,62,61,96,330,569,4,2287,127,0,2,1,0,76810,30710,6161,40513,0
170,7547,7,5,5,0,0,2,7,1,2,1,2,3,3,2,4,0,2,0,0,2,1,0,76810,30710,6161,40514,0
30,1324,373,158,315,8,0,51,381,5,76,44,79,81,123,486,779,2,2026,112,0,2,2,1,76810,30710,6161,40515,0
53,1862,601,196,481,2,23,85,603,8,63,36,72,71,108,400,664,4,3036,168,0,2,4,2,76810,30710,6161,40516,0
159,3781,77,34,69,0,0,8,77,3,24,16,29,27,45,114,213,1,387,21,0,2,1,1,76810,30710,6161,40517,0
159,3781,712,438,573,51,9,84,763,14,102,71,128,116,199,733,1364,8,11988,666,0,2,1,1,76820,30711,6161,40518,0
29,743,601,196,481,2,23,85,603,8,63,36,72,71,108,400,664,4,3036,168,0,2,2,1,76820,30711,6161,40519,0
29,743,156,79,106,5,16,28,161,5,14,8,15,19,23,64,97,2,261,14,0,2,2,1,76820,30711,6161,40520,0
112,4514,1289,550,1043,56,32,155,1345,10,167,93,185,177,278,1266,2075,5,11498,638,0,2,2,0,76820,30713,6162,40521,0
36,2427,1157,318,931,29,22,177,1186,6,104,63,125,110,188,712,1274,3,4596,255,0,2,11,11,76820,30713,6162,40522,0
47,3469,996,429,845,24,10,117,1020,7,76,50,88,83,138,494,879,4,3565,198,0,2,1,1,76820,30715,6162,40523,0
29,1324,373,158,315,8,0,51,381,5,76,44,79,81,123,486,779,2,2026,112,0,2,2,2,76820,30715,6162,40524,0
103,5526,1943,715,1694,26,18,214,1969,12,185,120,237,197,357,1436,2721,7,20915,1161,0,2,0,1,76820,30717,6162,40525,0
112,2106,477,336,357,30,23,73,507,16,194,134,250,210,384,1538,2962,10,30538,1696,0,2,9,9,76830,30718,6162,40526,1
78,1824,996,429,845,24,10,117,1020,7,76,50,88,83,138,494,879,4,3565,198,0,2,1,1,76830,30720,6162,40527,1
78,1824,456,277,329,12,42,72,468,13,85,50,97,98,147,592,972,7,7212,400,0,2,1,1,76830,30720,6162,40528,1
248,5735,4293,999,3693,19,54,507,4312,9,155,88,170,164,258,1156,1898,4,9368,520,0,2,1,1,76830,30722,6162,40529,1
248,5735,1482,859,1002,125,135,219,1607,16,219,134,251,235,385,1766,3032,9,27804,1544,1,2,1,1,76840,30723,6162,40530,1
100,2601,773,422,505,30,103,129,803,14,77,46,83,91,129,535,839,7,6334,351,0,2,1,1,76850,30724,6163,40531,1
103,5544,1943,715,1694,26,18,214,1969,12,185,120,237,197,357,1436,2721,7,20915,1161,0,2,10,9,76850,30726,6163,40532,1
113,2113,477,336,357,30,23,73,507,16,194,134,250,210,384,1538,2962,10,30538,1696,0,2,34,24,76860,30727,6163,40533,1
126,4991,1450,624,1228,12,26,181,1462,14,306,186,354,320,540,2580,4493,8,36391,2021,1,2,11,0,76860,30729,6164,40534,1
248,5737,4293,999,3693,19,54,507,4312,9,155,88,170,164,258,1156,1898,4,9368,520,0,2,1,1,76860,30731,6164,40535,0
248,5737,1482,859,1002,125,135,219,1607,16,219,134,251,235,385,1766,3032,9,27804,1544,1,2,1,1,76870,30732,6164,40536,0
24,614,2,2,2,0,0,0,2,0,0,0,0,0,0,0,0,0,0,0,0,2,1,0,76870,30732,6164,40536,0
24,614,99,48,90,1,3,5,100,0,0,0,0,0,0,0,0,0,0,0,0,2,1,0,76870,30733,6164,40537,0
24,614,8,5,5,2,0,1,10,0,0,0,0,0,0,0,0,0,0,0,0,2,1,0,76870,30733,6164,40538,0
24,614,1217,716,841,84,126,174,1301,14,185,118,215,199,333,1446,2542,8,20687,1149,0,2,1,0,76880,30735,6164,40539,0
24,614,160,89,115,0,13,31,160,7,15,11,17,22,28,78,124,3,495,27,0,2,1,0,76880,30735,6164,40540,0
24,614,10,10,9,9,0,0,19,0,0,0,0,0,0,0,0,0,0,0,0,2,1,0,76880,30735,6165,40541,0
24,614,173,84,99,8,29,36,181,5,12,7,13,17,20,54,81,2,221,12,0,2,1,0,76880,30736,6165,40542,0
24,614,3,1,1,3,0,0,6,0,0,0,0,0,0,0,0,0,0,0,0,2,1,0,76880,30736,6165,40543,0
171,7589,4293,999,3693,19,54,507,4312,9,155,88,170,164,258,1156,1898,4,9368,520,0,2,3,2,76880,30738,6165,40544,0
171,7589,1482,859,1002,125,135,219,1607,16,219,134,251,235,385,1766,3032,9,27804,1544,1,2,3,2,76890,30739,6165,40545,0
125,5398,1513,682,1277,25,13,200,1538,11,199,116,219,210,335,1557,2584,6,15641,868,0,2,11,1,76890,30741,6165,40546,0
29,1324,373,158,315,8,0,51,381,5,76,44,79,81,123,486,779,2,2026,112,0,2,2,1,76890,30741,6165,40547,0
53,1862,601,196,481,2,23,85,603,8,63,36,72,71,108,400,664,4,3036,168,0,2,4,2,76890,30741,6165,40548,0
248,5737,4293,999,3693,19,54,507,4312,9,155,88,170,164,258,1156,1898,4,9368,520,0,2,1,1,76890,30743,6165,40549,0
248,5737,1482,859,1002,125,135,219,1607,16,219,134,251,235,385,1766,3032,9,27804,1544,1,2,1,1,76900,30744,6165,40550,0
24,614,2,2,2,0,0,0,2,0,0,0,0,0,0,0,0,0,0,0,0,2,1,0,76900,30744,6165,40550,0
24,614,99,48,90,1,3,5,100,0,0,0,0,0,0,0,0,0,0,0,0,2,1,0,76900,30745,6165,40551,0
24,614,8,5,5,2,0,1,10,0,0,0,0,0,0,0,0,0,0,0,0,2,1,0,76900,30745,6165,40552,0
24,614,1217,716,841,84,126,174,1301,14,185,118,215,199,333,1446,2542,8,20687,1149,0,2,1,0,76910,30747,6165,40553,0
24,614,160,89,115,0,13,31,160,7,15,11,17,22,28,78,124,3,495,27,0,2,1,0,76910,30747,6165,40554,0
24,614,10,10,9,9,0,0,19,0,0,0,0,0,0,0,0,0,0,0,0,2,1,0,76910,30747,6166,40555,0
24,614,173,84,99,8,29,36,181,5,12,7,13,17,20,54,81,2,221,12,0,2,1,0,76910,30748,6166,40556,0
24,614,3,1,1,3,0,0,6,0,0,0,0,0,0,0,0,0,0,0,0,2,1,0,76910,30748,6166,40557,0
171,7589,4293,999,3693,19,54,507,4312,9,155,88,170,164,258,1156,1898,4,9368,520,0,2,3,2,76910,30750,6166,40558,0
171,7589,1482,859,1002,125,135,219,1607,16,219,134,251,235,385,1766,3032,9,27804,1544,1,2,3,2,76920,30751,6166,40559,0
125,5398,1513,682,1277,25,13,200,1538,11,199,116,219,210,335,1557,2584,6,15641,868,0,2,11,1,76920,30753,6166,40560,0
29,1324,373,158,315,8,0,51,381,5,76,44,79,81,123,486,779,2,2026,112,0,2,2,1,76920,30753,6166,40561,0
53,1862,601,196,481,2,23,85,603,8,63,36,72,71,108,400,664,4,3036,168,0,2,4,2,76920,30753,6166,40562,0
28,452,219,78,157,11,5,46,230,3,24,20,34,27,54,114,256,2,545,30,0,2,14,2,76920,30754,6166,40563,0
28,452,108,64,79,9,0,20,117,5,15,11,19,20,30,70,129,3,410,22,0,2,14,2,76920,30754,6166,40564,0
72,1466,1178,367,1042,6,15,115,1184,9,94,51,95,103,146,644,976,4,4439,246,0,2,19,11,76920,30754,6166,40565,0
72,1466,177,108,140,8,0,27,185,6,30,16,32,36,48,162,248,3,794,44,0,2,19,11,76920,30756,6166,40566,0
66,1714,466,257,367,18,25,50,484,7,126,86,171,133,257,898,1813,4,8612,478,0,2,3,1,76920,30756,6166,40567,0
66,1714,507,281,342,29,59,88,536,10,53,29,57,63,86,336,514,5,2764,153,0,2,3,1,76920,30756,6166,40568,0
28,1596,466,257,367,18,25,50,484,7,126,86,171,133,257,898,1813,4,8612,478,0,2,22,2,76920,30756,6166,40569,0
101,2611,773,422,505,30,103,129,803,14,77,46,83,91,129,535,839,7,6334,351,0,2,9,2,76930,30757,6167,40570,0
101,2611,773,422,505,30,103,129,803,14,77,46,83,91,129,535,839,7,6334,351,0,2,9,2,76940,30758,6168,40571,0
52,625,647,139,84,35,284,233,682,0,0,0,0,0,0,0,0,0,0,0,0,2,2,1,76940,30758,6168,40572,0
75,1617,53,23,39,0,0,13,53,2,8,4,8,10,12,26,39,1,39,2,0,2,8,1,76940,30758,6168,40573,0
75,1617,515,298,307,33,80,99,548,12,63,44,77,75,121,419,753,7,5527,307,0,2,8,1,76950,30758,6168,40574,0
85,4936,1296,573,1062,40,33,157,1336,8,201,118,231,209,349,1561,2689,4,12365,686,0,2,18,0,76950,30758,6168,40575,0
112,2106,477,336,357,30,23,73,507,16,194,134,250,210,384,1538,2962,10,30538,1696,0,2,9,9,76960,30759,6168,40576,0
78,1824,996,429,845,24,10,117,1020,7,76,50,88,83,138,494,879,4,3565,198,0,2,1,1,76960,30761,6168,40577,0
78,1824,456,277,329,12,42,72,468,13,85,50,97,98,147,592,972,7,7212,400,0,2,1,1,76960,30761,6168,40578,0
248,5737,4293,999,3693,19,54,507,4312,9,155,88,170,164,258,1156,1898,4,9368,520,0,2,1,1,76960,30763,6168,40579,0
248,5737,1482,859,1002,125,135,219,1607,16,219,134,251,235,385,1766,3032,9,27804,1544,1,2,1,1,76970,30764,6168,40580,0
101,2612,773,422,505,30,103,129,803,14,77,46,83,91,129,535,839,7,6334,351,0,2,1,1,76980,30765,6169,40581,0
103,5544,1943,715,1694,26,18,214,1969,12,185,120,237,197,357,1436,2721,7,20915,1161,0,2,10,9,76980,30767,6169,40582,0
113,2116,477,336,357,30,23,73,507,16,194,134,250,210,384,1538,2962,10,30538,1696,0,2,34,24,76990,30768,6169,40583,0
126,4991,1450,624,1228,12,26,181,1462,14,306,186,354,320,540,2580,4493,8,36391,2021,1,2,11,0,76990,30770,6170,40584,0
313,6885,72,33,56,0,4,12,72,1,1,1,1,2,2,0,2,0,1,0,0,2,18,1,76990,30770,6170,40585,0
313,6885,1454,835,1044,76,110,219,1530,17,275,158,296,292,454,2297,3718,9,34017,1889,1,2,18,1,77000,30771,6170,40586,0
313,6885,72,33,56,0,4,12,72,1,1,1,1,2,2,0,2,0,1,0,0,2,2,2,77000,30771,6170,40587,0
313,6885,1454,835,1044,76,110,219,1530,17,275,158,296,292,454,2297,3718,9,34017,1889,1,2,2,2,77010,30772,6170,40588,0
67,1570,773,419,590,28,0,166,801,10,204,113,217,214,330,1598,2554,5,13587,754,0,2,3,1,77010,30772,6171,40589,0
67,1570,421,273,302,44,34,57,465,17,81,59,107,98,166,583,1098,11,12329,684,0,2,3,1,77010,30772,6172,40590,0
69,1499,402,202,227,24,74,80,426,12,52,33,61,64,94,339,564,7,3969,220,0,2,1,1,77010,30773,6172,40591,0
69,3122,1020,354,843,12,15,144,1032,8,134,77,144,142,221,970,1580,4,6792,377,0,2,25,10,77010,30773,6172,40592,0
313,6885,72,33,56,0,4,12,72,1,1,1,1,2,2,0,2,0,1,0,0,2,18,1,77010,30773,6172,40593,0
313,6885,1454,835,1044,76,110,219,1530,17,275,158,296,292,454,2297,3718,9,34017,1889,1,2,18,1,77020,30774,6172,40594,0
72,1466,1178,367,1042,6,15,115,1184,9,94,51,95,103,146,644,976,4,4439,246,0,2,19,11,77020,30774,6172,40595,0
72,1466,177,108,140,8,0,27,185,6,30,16,32,36,48,162,248,3,794,44,0,2,19,11,77020,30776,6172,40596,0
67,1570,773,419,590,28,0,166,801,10,204,113,217,214,330,1598,2554,5,13587,754,0,2,3,1,77020,30776,6173,40597,0
67,1570,421,273,302,44,34,57,465,17,81,59,107,98,166,583,1098,11,12329,684,0,2,3,1,77020,30776,6174,40598,0
69,1499,402,202,227,24,74,80,426,12,52,33,61,64,94,339,564,7,3969,220,0,2,1,1,77020,30777,6174,40599,0
69,3122,1020,354,843,12,15,144,1032,8,134,77,144,142,221,970,1580,4,6792,377,0,2,25,10,77020,30777,6174,40600,0
247,5945,722,423,573,19,0,135,741,12,172,101,199,184,300,1320,2257,6,15668,870,0,2,9,0,77020,30779,6174,40602,1
247,5945,1508,847,911,44,250,301,1552,14,148,88,169,162,257,1120,1886,7,15077,837,0,2,9,0,77020,30780,6175,40603,1
92,4888,1457,730,1242,11,6,188,1468,10,292,166,329,302,495,2424,4078,5,22973,1276,1,2,8,16,77020,30782,6175,40604,1
28,1833,384,251,317,7,8,52,391,11,70,44,84,81,128,467,811,6,5355,297,0,2,6,7,77020,30782,6175,40605,1
247,5945,722,423,573,19,0,135,741,12,172,101,199,184,300,1320,2257,6,15668,870,0,2,9,0,77020,30784,6175,40607,0
247,5945,1508,847,911,44,250,301,1552,14,148,88,169,162,257,1120,1886,7,15077,837,0,2,9,0,77020,30785,6176,40608,0
92,4888,1457,730,1242,11,6,188,1468,10,292,166,329,302,495,2424,4078,5,22973,1276,1,2,8,16,77020,30787,6176,40609,0
28,1833,384,251,317,7,8,52,391,11,70,44,84,81,128,467,811,6,5355,297,0,2,6,7,77020,30787,6176,40610,0
164,3436,1513,682,1277,25,13,200,1538,11,199,116,219,210,335,1557,2584,6,15641,868,0,2,18,0,77020,30789,6176,40611,0
164,3436,819,519,539,24,98,155,843,15,96,57,106,111,163,690,1107,8,9171,509,0,2,18,0,77030,30791,6176,40612,0
50,1389,339,213,244,17,9,65,356,10,42,26,48,52,74,259,421,5,2410,133,0,2,25,6,77040,30791,6176,40613,0
69,3465,1293,570,1093,25,15,163,1318,10,195,123,241,205,364,1516,2795,6,17273,959,0,2,49,0,77050,30793,6176,40614,0
50,1396,339,213,244,17,9,65,356,10,42,26,48,52,74,259,421,5,2410,133,0,2,8,5,77060,30793,6176,40615,0
69,3468,1293,570,1093,25,15,163,1318,10,195,123,241,205,364,1516,2795,6,17273,959,0,2,2,1,77070,30795,6176,40616,0
73,3679,1293,570,1093,25,15,163,1318,10,195,123,241,205,364,1516,2795,6,17273,959,0,2,51,0,77080,30797,6176,40617,0
164,3417,1513,682,1277,25,13,200,1538,11,199,116,219,210,335,1557,2584,6,15641,868,0,2,3,5,77080,30799,6176,40618,0
164,3417,819,519,539,24,98,155,843,15,96,57,106,111,163,690,1107,8,9171,509,0,2,3,5,77090,30801,6176,40619,0
72,3663,1293,570,1093,25,15,163,1318,10,195,123,241,205,364,1516,2795,6,17273,959,0,2,58,17,77100,30803,6176,40620,0
50,1402,339,213,244,17,9,65,356,10,42,26,48,52,74,259,421,5,2410,133,0,2,11,9,77110,30803,6176,40621,0
54,657,647,139,84,35,284,233,682,0,0,0,0,0,0,0,0,0,0,0,0,2,3,3,77110,30803,6176,40622,0
66,1714,466,257,367,18,25,50,484,7,126,86,171,133,257,898,1813,4,8612,478,0,2,2,2,77110,30803,6176,40623,0
66,1714,507,281,342,29,59,88,536,10,53,29,57,63,86,336,514,5,2764,153,0,2,2,2,77110,30803,6176,40624,0
28,1596,466,257,367,18,25,50,484,7,126,86,171,133,257,898,1813,4,8612,478,0,2,6,6,77110,30803,6176,40625,0
235,4919,2,2,2,0,0,0,2,0,0,0,0,0,0,0,0,0,0,0,0,2,1,0,77110,30803,6176,40625,0
235,4919,99,48,90,1,3,5,100,0,0,0,0,0,0,0,0,0,0,0,0,2,1,0,77110,30804,6176,40626,0
235,4919,8,5,5,2,0,1,10,0,0,0,0,0,0,0,0,0,0,0,0,2,1,0,77110,30804,6176,40627,0
235,4919,1217,716,841,84,126,174,1301,14,185,118,215,199,333,1446,2542,8,20687,1149,0,2,1,0,77120,30806,6176,40628,0
235,4919,160,89,115,0,13,31,160,7,15,11,17,22,28,78,124,3,495,27,0,2,1,0,77120,30806,6176,40629,0
235,4919,10,10,9,9,0,0,19,0,0,0,0,0,0,0,0,0,0,0,0,2,1,0,77120,30806,6177,40630,0
235,4919,173,84,99,8,29,36,181,5,12,7,13,17,20,54,81,2,221,12,0,2,1,0,77120,30807,6177,40631,0
235,4919,3,1,1,3,0,0,6,0,0,0,0,0,0,0,0,0,0,0,0,2,1,0,77120,30807,6177,40632,0
54,657,647,139,84,35,284,233,682,0,0,0,0,0,0,0,0,0,0,0,0,2,35,0,77120,30807,6177,40633,0
66,1714,466,257,367,18,25,50,484,7,126,86,171,133,257,898,1813,4,8612,478,0,2,153,0,77120,30807,6177,40634,0
66,1714,507,281,342,29,59,88,536,10,53,29,57,63,86,336,514,5,2764,153,0,2,153,0,77120,30807,6177,40635,0
28,1596,466,257,367,18,25,50,484,7,126,86,171,133,257,898,1813,4,8612,478,0,0,313,0,77120,30807,6177,40636,0
28,452,219,78,157,11,5,46,230,3,24,20,34,27,54,114,256,2,545,30,0,2,14,2,77120,30808,6177,40637,0
28,452,108,64,79,9,0,20,117,5,15,11,19,20,30,70,129,3,410,22,0,2,14,2,77120,30808,6177,40638,0
52,625,647,139,84,35,284,233,682,0,0,0,0,0,0,0,0,0,0,0,0,2,2,2,77120,30808,6177,40639,0
164,3417,1513,682,1277,25,13,200,1538,11,199,116,219,210,335,1557,2584,6,15641,868,0,2,21,5,77120,30810,6177,40640,0
164,3417,819,519,539,24,98,155,843,15,96,57,106,111,163,690,1107,8,9171,509,0,2,21,5,77130,30812,6177,40641,0
50,1402,339,213,244,17,9,65,356,10,42,26,48,52,74,259,421,5,2410,133,0,2,33,9,77140,30812,6177,40642,0
72,3663,1293,570,1093,25,15,163,1318,10,195,123,241,205,364,1516,2795,6,17273,959,0,2,143,1,77150,30814,6177,40643,0
52,625,647,139,84,35,284,233,682,0,0,0,0,0,0,0,0,0,0,0,0,2,2,2,77150,30814,6177,40644,0
55,770,167,116,138,4,5,22,171,8,48,30,56,56,86,292,499,4,2330,129,0,2,6,6,77150,30814,6177,40645,0
101,5285,1457,730,1242,11,6,188,1468,10,292,166,329,302,495,2424,4078,5,22973,1276,1,2,16,0,77150,30816,6177,40646,0
51,1410,339,213,244,17,9,65,356,10,42,26,48,52,74,259,421,5,2410,133,0,2,8,1,77160,30816,6177,40647,0
72,3697,1293,570,1093,25,15,163,1318,10,195,123,241,205,364,1516,2795,6,17273,959,0,2,12,3,77170,30818,6177,40648,0
54,657,647,139,84,35,284,233,682,0,0,0,0,0,0,0,0,0,0,0,0,2,2,1,77170,30818,6177,40649,0
233,5825,722,423,573,19,0,135,741,12,172,101,199,184,300,1320,2257,6,15668,870,0,2,9,0,77170,30820,6177,40651,0
233,5825,1508,847,911,44,250,301,1552,14,148,88,169,162,257,1120,1886,7,15077,837,0,2,9,0,77170,30821,6178,40652,0
100,5205,1457,730,1242,11,6,188,1468,10,292,166,329,302,495,2424,4078,5,22973,1276,1,2,8,16,77170,30823,6178,40653,0
29,1873,384,251,317,7,8,52,391,11,70,44,84,81,128,467,811,6,5355,297,0,2,6,7,77170,30823,6178,40654,0
52,1439,339,213,244,17,9,65,356,10,42,26,48,52,74,259,421,5,2410,133,0,2,10,0,77180,30823,6178,40655,0
73,3713,1293,570,1093,25,15,163,1318,10,195,123,241,205,364,1516,2795,6,17273,959,0,2,14,0,77190,30825,6178,40656,0
55,770,167,116,138,4,5,22,171,8,48,30,56,56,86,292,499,4,2330,129,0,2,6,6,77190,30825,6178,40657,0
101,5285,1457,730,1242,11,6,188,1468,10,292,166,329,302,495,2424,4078,5,22973,1276,1,2,16,0,77190,30827,6178,40658,0
54,657,647,139,84,35,284,233,682,0,0,0,0,0,0,0,0,0,0,0,0,2,2,1,77190,30827,6178,40659,0
233,5825,722,423,573,19,0,135,741,12,172,101,199,184,300,1320,2257,6,15668,870,0,2,9,0,77190,30829,6178,40661,0
233,5825,1508,847,911,44,250,301,1552,14,148,88,169,162,257,1120,1886,7,15077,837,0,2,9,0,77190,30830,6179,40662,0
101,5261,1457,730,1242,11,6,188,1468,10,292,166,329,302,495,2424,4078,5,22973,1276,1,2,8,16,77190,30832,6179,40663,0
29,1873,384,251,317,7,8,52,391,11,70,44,84,81,128,467,811,6,5355,297,0,2,6,7,77190,30832,6179,40664,0
51,1410,339,213,244,17,9,65,356,10,42,26,48,52,74,259,421,5,2410,133,0,2,8,1,77200,30832,6179,40665,0
72,3697,1293,570,1093,25,15,163,1318,10,195,123,241,205,364,1516,2795,6,17273,959,0,2,12,3,77210,30834,6179,40666,0
69,1499,402,202,227,24,74,80,426,12,52,33,61,64,94,339,564,7,3969,220,0,2,2,2,77210,30835,6179,40667,0
233,5835,722,423,573,19,0,135,741,12,172,101,199,184,300,1320,2257,6,15668,870,0,2,6,0,77210,30837,6179,40669,0
233,5835,1508,847,911,44,250,301,1552,14,148,88,169,162,257,1120,1886,7,15077,837,0,2,6,0,77210,30838,6180,40670,0
171,7601,4293,999,3693,19,54,507,4312,9,155,88,170,164,258,1156,1898,4,9368,520,0,2,4,4,77210,30840,6180,40671,0
171,7601,1482,859,1002,125,135,219,1607,16,219,134,251,235,385,1766,3032,9,27804,1544,1,2,4,4,77220,30841,6180,40672,0
33,1007,465,148,393,5,8,60,470,4,31,20,31,35,51,161,261,2,523,29,0,2,1,1,77220,30842,6180,40673,0
33,1007,16,12,9,0,0,6,16,1,2,1,2,3,3,2,4,0,2,0,0,2,1,1,77220,30842,6180,40674,0
126,5666,1782,648,1425,9,47,279,1791,8,171,97,189,179,286,1292,2140,4,9462,525,0,2,18,18,77220,30843,6181,40675,0
125,5401,1513,682,1277,25,13,200,1538,11,199,116,219,210,335,1557,2584,6,15641,868,0,2,1,1,77220,30845,6181,40676,0
43,2679,652,304,544,16,6,88,668,6,89,51,101,95,152,591,998,3,3399,188,0,2,1,1,77220,30846,6181,40677,0
69,3128,1020,354,843,12,15,144,1032,8,134,77,144,142,221,970,1580,4,6792,377,0,2,2,2,77220,30846,6181,40678,0
1,94,42,7,35,4,0,5,46,1,2,1,2,3,3,2,4,0,2,0,0,2,2,2,77220,30846,6181,40679,0
1,94,11,6,10,0,0,1,11,2,4,2,4,6,6,10,15,1,15,0,0,2,2,2,77220,30846,6181,40680,0
230,4977,182,127,129,0,0,53,182,5,39,21,42,44,63,217,343,2,926,51,0,2,8,12,77220,30846,6182,40681,0
230,4977,1165,710,800,67,119,181,1232,18,243,153,282,261,435,2000,3492,10,36473,2026,1,2,8,12,77230,30846,6183,40682,0
67,1570,773,419,590,28,0,166,801,10,204,113,217,214,330,1598,2554,5,13587,754,0,2,3,1,77230,30846,6184,40683,0
67,1570,421,273,302,44,34,57,465,17,81,59,107,98,166,583,1098,11,12329,684,0,2,3,1,77230,30846,6185,40684,0
183,5553,1660,832,1314,41,38,274,1701,20,312,209,395,332,604,2671,5058,12,64042,3557,1,2,3,3,77230,30848,6186,40686,0
183,5553,1057,646,719,113,100,145,1170,18,215,134,248,233,382,1740,3004,10,31186,1732,1,2,3,3,77240,30849,6187,40687,0
113,2116,477,336,357,30,23,73,507,16,194,134,250,210,384,1538,2962,10,30538,1696,0,2,43,33,77250,30850,6187,40688,0
78,1824,996,429,845,24,10,117,1020,7,76,50,88,83,138,494,879,4,3565,198,0,2,11,15,77250,30852,6187,40689,0
78,1824,456,277,329,12,42,72,468,13,85,50,97,98,147,592,972,7,7212,400,0,2,11,15,77250,30852,6187,40690,0
164,3417,1513,682,1277,25,13,200,1538,11,199,116,219,210,335,1557,2584,6,15641,868,0,2,69,44,77250,30854,6187,40691,0
164,3417,819,519,539,24,98,155,843,15,96,57,106,111,163,690,1107,8,9171,509,0,2,69,44,77260,30856,6187,40692,0
235,4919,2,2,2,0,0,0,2,0,0,0,0,0,0,0,0,0,0,0,0,2,39,14,77260,30856,6187,40692,0
235,4919,99,48,90,1,3,5,100,0,0,0,0,0,0,0,0,0,0,0,0,2,39,14,77260,30857,6187,40693,0
235,4919,8,5,5,2,0,1,10,0,0,0,0,0,0,0,0,0,0,0,0,2,39,14,77260,30857,6187,40694,0
235,4919,1217,716,841,84,126,174,1301,14,185,118,215,199,333,1446,2542,8,20687,1149,0,2,39,14,77270,30859,6187,40695,0
235,4919,160,89,115,0,13,31,160,7,15,11,17,22,28,78,124,3,495,27,0,2,39,14,77270,30859,6187,40696,0
235,4919,10,10,9,9,0,0,19,0,0,0,0,0,0,0,0,0,0,0,0,2,39,14,77270,30859,6188,40697,0
235,4919,173,84,99,8,29,36,181,5,12,7,13,17,20,54,81,2,221,12,0,2,39,14,77270,30860,6188,40698,0
235,4919,3,1,1,3,0,0,6,0,0,0,0,0,0,0,0,0,0,0,0,2,39,14,77270,30860,6188,40699,0
55,770,167,116,138,4,5,22,171,8,48,30,56,56,86,292,499,4,2330,129,0,2,6,6,77270,30860,6188,40700,0
51,1410,339,213,244,17,9,65,356,10,42,26,48,52,74,259,421,5,2410,133,0,2,78,28,77280,30860,6188,40701,0
95,2385,1455,414,1257,16,76,112,1471,5,41,23,46,46,69,231,381,2,1069,59,0,2,3,0,77280,30861,6188,40702,0
95,2385,669,365,481,22,61,110,691,15,103,63,122,118,185,747,1273,8,11311,628,0,2,3,0,77290,30861,6189,40703,0
248,5737,4293,999,3693,19,54,507,4312,9,155,88,170,164,258,1156,1898,4,9368,520,0,2,18,6,77290,30863,6189,40704,0
248,5737,1482,859,1002,125,135,219,1607,16,219,134,251,235,385,1766,3032,9,27804,1544,1,2,18,6,77300,30864,6189,40705,0
28,978,74,35,59,1,0,14,75,3,14,7,14,17,21,58,85,1,128,7,0,2,1,1,77300,30865,6189,40706,0
28,978,245,125,200,5,7,34,250,7,30,17,34,37,51,166,265,3,1053,58,0,2,1,1,77310,30866,6189,40707,0
54,657,647,139,84,35,284,233,682,0,0,0,0,0,0,0,0,0,0,0,0,2,35,0,77310,30866,6189,40708,0
101,2612,773,422,505,30,103,129,803,14,77,46,83,91,129,535,839,7,6334,351,0,2,10,3,77320,30867,6190,40709,0
159,3781,77,34,69,0,0,8,77,3,24,16,29,27,45,114,213,1,387,21,0,2,11,2,77320,30867,6190,40710,0
159,3781,712,438,573,51,9,84,763,14,102,71,128,116,199,733,1364,8,11988,666,0,2,11,2,77330,30868,6190,40711,0
69,1499,402,202,227,24,74,80,426,12,52,33,61,64,94,339,564,7,3969,220,0,2,1,1,77330,30869,6190,40712,0
54,1156,447,308,343,6,5,95,453,7,96,59,111,103,170,651,1136,4,4600,255,0,2,5,0,77330,30872,6190,40713,0
54,1156,322,174,179,16,74,51,338,10,41,26,46,51,72,252,408,5,2291,127,0,2,5,0,77330,30875,6191,40714,0
75,1617,53,23,39,0,0,13,53,2,8,4,8,10,12,26,39,1,39,2,0,2,8,1,77330,30875,6191,40715,0
75,1617,515,298,307,33,80,99,548,12,63,44,77,75,121,419,753,7,5527,307,0,2,8,1,77340,30875,6191,40716,0
21,541,205,80,86,16,53,53,221,7,18,10,19,25,29,94,134,3,497,27,0,2,5,1,77350,30875,6192,40717,0
233,5825,722,423,573,19,0,135,741,12,172,101,199,184,300,1320,2257,6,15668,870,0,2,23,49,77350,30877,6192,40719,0
233,5825,1508,847,911,44,250,301,1552,14,148,88,169,162,257,1120,1886,7,15077,837,0,2,23,49,77350,30878,6193,40720,0
313,6885,72,33,56,0,4,12,72,1,1,1,1,2,2,0,2,0,1,0,0,2,32,23,77350,30878,6193,40721,0
313,6885,1454,835,1044,76,110,219,1530,17,275,158,296,292,454,2297,3718,9,34017,1889,1,2,32,23,77360,30879,6193,40722,0
66,1714,466,257,367,18,25,50,484,7,126,86,171,133,257,898,1813,4,8612,478,0,2,237,1,77360,30879,6193,40723,0
66,1714,507,281,342,29,59,88,536,10,53,29,57,63,86,336,514,5,2764,153,0,2,237,1,77360,30879,6193,40724,0
89,1902,1043,504,840,53,9,147,1096,9,180,112,198,189,310,1377,2344,4,11604,644,0,2,4,40,77360,30881,6193,40725,0
89,1902,383,288,292,26,6,62,409,11,65,38,67,76,105,429,656,5,3719,206,0,2,4,40,77360,30882,6193,40726,0
72,1466,1178,367,1042,6,15,115,1184,9,94,51,95,103,146,644,976,4,4439,246,0,2,19,11,77360,30882,6193,40727,0
72,1466,177,108,140,8,0,27,185,6,30,16,32,36,48,162,248,3,794,44,0,2,19,11,77360,30884,6193,40728,0
28,452,219,78,157,11,5,46,230,3,24,20,34,27,54,114,256,2,545,30,0,2,14,2,77360,30885,6193,40729,0
28,452,108,64,79,9,0,20,117,5,15,11,19,20,30,70,129,3,410,22,0,2,14,2,77360,30885,6193,40730,0
248,5121,1943,715,1694,26,18,214,1969,12,185,120,237,197,357,1436,2721,7,20915,1161,0,2,38,28,77360,30887,6193,40731,0
248,5121,1168,838,957,57,25,144,1225,19,348,224,416,367,640,3018,5452,11,61921,3440,1,2,38,28,77370,30889,6193,40732,0
29,743,601,196,481,2,23,85,603,8,63,36,72,71,108,400,664,4,3036,168,0,2,2,1,77370,30889,6193,40733,0
29,743,156,79,106,5,16,28,161,5,14,8,15,19,23,64,97,2,261,14,0,2,2,1,77370,30889,6193,40734,0
112,4514,1289,550,1043,56,32,155,1345,10,167,93,185,177,278,1266,2075,5,11498,638,0,2,87,2,77370,30891,6194,40735,0
36,1120,182,127,129,0,0,53,182,5,39,21,42,44,63,217,343,2,926,51,0,2,4,0,77370,30891,6195,40736,0
14,845,75,38,59,1,3,12,76,2,4,2,4,6,6,10,15,1,15,0,0,2,1,1,77370,30891,6195,40737,0
36,2427,1157,318,931,29,22,177,1186,6,104,63,125,110,188,712,1274,3,4596,255,0,2,12,12,77370,30891,6195,40738,0
90,3974,1338,495,1086,10,64,173,1348,11,122,82,157,133,239,883,1686,7,11934,663,0,2,9,11,77370,30893,6195,40739,0
171,7589,4293,999,3693,19,54,507,4312,9,155,88,170,164,258,1156,1898,4,9368,520,0,3,43,5,77370,30895,6195,40740,0
171,7589,1482,859,1002,125,135,219,1607,16,219,134,251,235,385,1766,3032,9,27804,1544,1,3,43,5,77380,30896,6195,40741,0
126,4991,1450,624,1228,12,26,181,1462,14,306,186,354,320,540,2580,4493,8,36391,2021,1,2,11,0,77380,30898,6196,40742,0
176,5286,1660,832,1314,41,38,274,1701,20,312,209,395,332,604,2671,5058,12,64042,3557,1,2,60,25,77380,30900,6197,40744,0
47,3469,996,429,845,24,10,117,1020,7,76,50,88,83,138,494,879,4,3565,198,0,2,8,8,77380,30902,6197,40745,0
125,5398,1513,682,1277,25,13,200,1538,11,199,116,219,210,335,1557,2584,6,15641,868,0,2,2,2,77380,30904,6197,40746,0
85,4936,1296,573,1062,40,33,157,1336,8,201,118,231,209,349,1561,2689,4,12365,686,0,2,22,4,77380,30904,6197,40747,0
21,500,207,111,150,11,0,50,218,5,26,19,36,31,55,133,272,3,943,52,0,2,13,8,77380,30904,6197,40748,0
101,5261,1457,730,1242,11,6,188,1468,10,292,166,329,302,495,2424,4078,5,22973,1276,1,2,96,5,77380,30906,6197,40749,0
72,3310,1455,414,1257,16,76,112,1471,5,41,23,46,46,69,231,381,2,1069,59,0,2,13,1,77380,30907,6197,40750,0
100,4747,1523,757,1297,19,12,193,1542,12,193,117,230,205,347,1508,2664,7,19053,1058,0,2,0,3,77390,30909,6197,40751,0
69,3122,1020,354,843,12,15,144,1032,8,134,77,144,142,221,970,1580,4,6792,377,0,2,25,10,77390,30909,6197,40752,0
47,2152,447,308,343,6,5,95,453,7,96,59,111,103,170,651,1136,4,4600,255,0,2,25,0,77390,30912,6197,40753,0
21,655,424,94,331,4,0,89,428,1,5,5,5,6,10,11,25,0,12,0,0,2,1,1,77390,30913,6197,40754,0
72,3697,1293,570,1093,25,15,163,1318,10,195,123,241,205,364,1516,2795,6,17273,959,0,2,174,7,77400,30915,6197,40755,0
29,1873,384,251,317,7,8,52,391,11,70,44,84,81,128,467,811,6,5355,297,0,2,14,5,77400,30915,6197,40756,0
49,2385,722,423,573,19,0,135,741,12,172,101,199,184,300,1320,2257,6,15668,870,0,2,16,0,77400,30917,6197,40758,0
28,1596,466,257,367,18,25,50,484,7,126,86,171,133,257,898,1813,4,8612,478,0,0,313,0,77400,30917,6197,40759,0
83,3328,1043,504,840,53,9,147,1096,9,180,112,198,189,310,1377,2344,4,11604,644,0,2,5,5,77400,30919,6197,40760,0
29,1324,373,158,315,8,0,51,381,5,76,44,79,81,123,486,779,2,2026,112,0,2,5,7,77400,30919,6197,40761,0
81,3287,1178,367,1042,6,15,115,1184,9,94,51,95,103,146,644,976,4,4439,246,0,2,9,7,77400,30919,6197,40762,0
103,5544,1943,715,1694,26,18,214,1969,12,185,120,237,197,357,1436,2721,7,20915,1161,0,2,76,16,77400,30921,6197,40763,0
37,1527,442,244,305,14,16,103,456,11,68,45,75,79,120,452,756,6,4588,254,0,2,1,1,77400,30923,6197,40764,0
52,1994,1098,241,925,5,10,155,1103,7,46,25,49,53,74,273,423,3,1580,87,0,2,2,2,77410,30925,6197,40765,0
69,1499,402,202,227,24,74,80,426,12,52,33,61,64,94,339,564,7,3969,220,0,2,2,2,77410,30926,6197,40766,0
233,5835,722,423,573,19,0,135,741,12,172,101,199,184,300,1320,2257,6,15668,870,0,2,6,0,77410,30928,6197,40768,0
233,5835,1508,847,911,44,250,301,1552,14,148,88,169,162,257,1120,1886,7,15077,837,0,2,6,0,77410,30929,6198,40769,0
171,7601,4293,999,3693,19,54,507,4312,9,155,88,170,164,258,1156,1898,4,9368,520,0,2,4,4,77410,30931,6198,40770,0
171,7601,1482,859,1002,125,135,219,1607,16,219,134,251,235,385,1766,3032,9,27804,1544,1,2,4,4,77420,30932,6198,40771,0
33,1007,465,148,393,5,8,60,470,4,31,20,31,35,51,161,261,2,523,29,0,2,1,1,77420,30933,6198,40772,0
33,1007,16,12,9,0,0,6,16,1,2,1,2,3,3,2,4,0,2,0,0,2,1,1,77420,30933,6198,40773,0
126,5666,1782,648,1425,9,47,279,1791,8,171,97,189,179,286,1292,2140,4,9462,525,0,2,18,18,77420,30934,6199,40774,0
125,5401,1513,682,1277,25,13,200,1538,11,199,116,219,210,335,1557,2584,6,15641,868,0,2,1,1,77420,30936,6199,40775,0
43,2679,652,304,544,16,6,88,668,6,89,51,101,95,152,591,998,3,3399,188,0,2,1,1,77420,30937,6199,40776,0
69,3128,1020,354,843,12,15,144,1032,8,134,77,144,142,221,970,1580,4,6792,377,0,2,2,2,77420,30937,6199,40777,0
23,607,2,2,2,0,0,0,2,0,0,0,0,0,0,0,0,0,0,0,0,2,1,2,77420,30937,6199,40777,1
23,607,99,48,90,1,3,5,100,0,0,0,0,0,0,0,0,0,0,0,0,2,1,2,77420,30938,6199,40778,1
23,607,8,5,5,2,0,1,10,0,0,0,0,0,0,0,0,0,0,0,0,2,1,2,77420,30938,6199,40779,1
23,607,1217,716,841,84,126,174,1301,14,185,118,215,199,333,1446,2542,8,20687,1149,0,2,1,2,77430,30940,6199,40780,1
23,607,160,89,115,0,13,31,160,7,15,11,17,22,28,78,124,3,495,27,0,2,1,2,77430,30940,6199,40781,1
23,607,10,10,9,9,0,0,19,0,0,0,0,0,0,0,0,0,0,0,0,2,1,2,77430,30940,6200,40782,1
23,607,173,84,99,8,29,36,181,5,12,7,13,17,20,54,81,2,221,12,0,2,1,2,77430,30941,6200,40783,1
23,607,3,1,1,3,0,0,6,0,0,0,0,0,0,0,0,0,0,0,0,2,1,2,77430,30941,6200,40784,1
69,1509,402,202,227,24,74,80,426,12,52,33,61,64,94,339,564,7,3969,220,0,2,24,14,77430,30942,6200,40785,1
69,1509,402,202,227,24,74,80,426,12,52,33,61,64,94,339,564,7,3969,220,0,2,5,5,77430,30943,6200,40786,0
2,121,37,13,25,0,6,6,37,1,2,1,2,3,3,2,4,0,2,0,0,2,9,0,77430,30943,6200,40787,0
2,121,133,47,40,1,43,49,134,0,0,0,0,0,0,0,0,0,0,0,0,2,9,0,77430,30943,6200,40788,0
68,1497,402,202,227,24,74,80,426,12,52,33,61,64,94,339,564,7,3969,220,0,2,20,19,77430,30944,6200,40789,0
23,607,2,2,2,0,0,0,2,0,0,0,0,0,0,0,0,0,0,0,0,2,1,2,77430,30944,6200,40789,0
23,607,99,48,90,1,3,5,100,0,0,0,0,0,0,0,0,0,0,0,0,2,1,2,77430,30945,6200,40790,0
23,607,8,5,5,2,0,1,10,0,0,0,0,0,0,0,0,0,0,0,0,2,1,2,77430,30945,6200,40791,0
23,607,1217,716,841,84,126,174,1301,14,185,118,215,199,333,1446,2542,8,20687,1149,0,2,1,2,77440,30947,6200,40792,0
23,607,160,89,115,0,13,31,160,7,15,11,17,22,28,78,124,3,495,27,0,2,1,2,77440,30947,6200,40793,0
23,607,10,10,9,9,0,0,19,0,0,0,0,0,0,0,0,0,0,0,0,2,1,2,77440,30947,6201,40794,0
23,607,173,84,99,8,29,36,181,5,12,7,13,17,20,54,81,2,221,12,0,2,1,2,77440,30948,6201,40795,0
23,607,3,1,1,3,0,0,6,0,0,0,0,0,0,0,0,0,0,0,0,2,1,2,77440,30948,6201,40796,0
68,1497,402,202,227,24,74,80,426,12,52,33,61,64,94,339,564,7,3969,220,0,2,27,16,77440,30949,6201,40797,0
2,121,37,13,25,0,6,6,37,1,2,1,2,3,3,2,4,0,2,0,0,2,9,0,77440,30949,6201,40798,0
2,121,133,47,40,1,43,49,134,0,0,0,0,0,0,0,0,0,0,0,0,2,9,0,77440,30949,6201,40799,0
162,3389,1513,682,1277,25,13,200,1538,11,199,116,219,210,335,1557,2584,6,15641,868,0,2,0,7,77440,30951,6201,40800,0
162,3389,819,519,539,24,98,155,843,15,96,57,106,111,163,690,1107,8,9171,509,0,2,0,7,77450,30953,6201,40801,0
236,4937,2,2,2,0,0,0,2,0,0,0,0,0,0,0,0,0,0,0,0,2,10,4,77450,30953,6201,40801,0
236,4937,99,48,90,1,3,5,100,0,0,0,0,0,0,0,0,0,0,0,0,2,10,4,77450,30954,6201,40802,0
236,4937,8,5,5,2,0,1,10,0,0,0,0,0,0,0,0,0,0,0,0,2,10,4,77450,30954,6201,40803,0
236,4937,1217,716,841,84,126,174,1301,14,185,118,215,199,333,1446,2542,8,20687,1149,0,2,10,4,77460,30956,6201,40804,0
236,4937,160,89,115,0,13,31,160,7,15,11,17,22,28,78,124,3,495,27,0,2,10,4,77460,30956,6201,40805,0
236,4937,10,10,9,9,0,0,19,0,0,0,0,0,0,0,0,0,0,0,0,2,10,4,77460,30956,6202,40806,0
236,4937,173,84,99,8,29,36,181,5,12,7,13,17,20,54,81,2,221,12,0,2,10,4,77460,30957,6202,40807,0
236,4937,3,1,1,3,0,0,6,0,0,0,0,0,0,0,0,0,0,0,0,2,10,4,77460,30957,6202,40808,0
248,5130,1943,715,1694,26,18,214,1969,12,185,120,237,197,357,1436,2721,7,20915,1161,0,2,1,0,77460,30959,6202,40809,0
248,5130,1168,838,957,57,25,144,1225,19,348,224,416,367,640,3018,5452,11,61921,3440,1,2,1,0,77470,30961,6202,40810,0
103,5260,1457,730,1242,11,6,188,1468,10,292,166,329,302,495,2424,4078,5,22973,1276,1,2,10,16,77470,30963,6202,40811,0
29,1903,384,251,317,7,8,52,391,11,70,44,84,81,128,467,811,6,5355,297,0,2,4,0,77470,30963,6202,40812,0
236,4937,2,2,2,0,0,0,2,0,0,0,0,0,0,0,0,0,0,0,0,2,10,4,77470,30963,6202,40812,0
236,4937,99,48,90,1,3,5,100,0,0,0,0,0,0,0,0,0,0,0,0,2,10,4,77470,30964,6202,40813,0
236,4937,8,5,5,2,0,1,10,0,0,0,0,0,0,0,0,0,0,0,0,2,10,4,77470,30964,6202,40814,0
236,4937,1217,716,841,84,126,174,1301,14,185,118,215,199,333,1446,2542,8,20687,1149,0,2,10,4,77480,30966,6202,40815,0
236,4937,160,89,115,0,13,31,160,7,15,11,17,22,28,78,124,3,495,27,0,2,10,4,77480,30966,6202,40816,0
236,4937,10,10,9,9,0,0,19,0,0,0,0,0,0,0,0,0,0,0,0,2,10,4,77480,30966,6203,40817,0
236,4937,173,84,99,8,29,36,181,5,12,7,13,17,20,54,81,2,221,12,0,2,10,4,77480,30967,6203,40818,0
236,4937,3,1,1,3,0,0,6,0,0,0,0,0,0,0,0,0,0,0,0,2,10,4,77480,30967,6203,40819,0
248,5130,1943,715,1694,26,18,214,1969,12,185,120,237,197,357,1436,2721,7,20915,1161,0,2,1,0,77480,30969,6203,40820,0
248,5130,1168,838,957,57,25,144,1225,19,348,224,416,367,640,3018,5452,11,61921,3440,1,2,1,0,77490,30971,6203,40821,0
103,5260,1457,730,1242,11,6,188,1468,10,292,166,329,302,495,2424,4078,5,22973,1276,1,2,10,16,77490,30973,6203,40822,0
29,1903,384,251,317,7,8,52,391,11,70,44,84,81,128,467,811,6,5355,297,0,2,4,0,77490,30973,6203,40823,0
162,3389,1513,682,1277,25,13,200,1538,11,199,116,219,210,335,1557,2584,6,15641,868,0,2,0,7,77490,30975,6203,40824,0
162,3389,819,519,539,24,98,155,843,15,96,57,106,111,163,690,1107,8,9171,509,0,2,0,7,77500,30977,6203,40825,0
159,3782,77,34,69,0,0,8,77,3,24,16,29,27,45,114,213,1,387,21,0,2,5,2,77500,30977,6203,40826,1
159,3782,712,438,573,51,9,84,763,14,102,71,128,116,199,733,1364,8,11988,666,0,2,5,2,77510,30978,6203,40827,1
72,3698,1293,570,1093,25,15,163,1318,10,195,123,241,205,364,1516,2795,6,17273,959,0,2,2,1,77520,30980,6203,40828,1
83,3389,1043,504,840,53,9,147,1096,9,180,112,198,189,310,1377,2344,4,11604,644,0,2,16,0,77520,30982,6203,40829,1
248,5737,4293,999,3693,19,54,507,4312,9,155,88,170,164,258,1156,1898,4,9368,520,0,2,1,0,77520,30984,6203,40830,0
248,5737,1482,859,1002,125,135,219,1607,16,219,134,251,235,385,1766,3032,9,27804,1544,1,2,1,0,77530,30985,6203,40831,0
18,312,424,94,331,4,0,89,428,1,5,5,5,6,10,11,25,0,12,0,0,2,2,1,77530,30986,6203,40832,0
18,312,38,23,23,6,0,8,44,3,11,7,11,14,18,42,68,1,102,5,0,2,2,1,77530,30986,6203,40833,0
89,1894,1043,504,840,53,9,147,1096,9,180,112,198,189,310,1377,2344,4,11604,644,0,2,1,2,77530,30988,6203,40834,0
89,1894,383,288,292,26,6,62,409,11,65,38,67,76,105,429,656,5,3719,206,0,2,1,2,77530,30989,6203,40835,0
248,5737,4293,999,3693,19,54,507,4312,9,155,88,170,164,258,1156,1898,4,9368,520,0,2,1,0,77530,30991,6203,40836,0
248,5737,1482,859,1002,125,135,219,1607,16,219,134,251,235,385,1766,3032,9,27804,1544,1,2,1,0,77540,30992,6203,40837,0
18,312,424,94,331,4,0,89,428,1,5,5,5,6,10,11,25,0,12,0,0,2,2,1,77540,30993,6203,40838,0
18,312,38,23,23,6,0,8,44,3,11,7,11,14,18,42,68,1,102,5,0,2,2,1,77540,30993,6203,40839,0
89,1894,1043,504,840,53,9,147,1096,9,180,112,198,189,310,1377,2344,4,11604,644,0,2,1,2,77540,30995,6203,40840,0
89,1894,383,288,292,26,6,62,409,11,65,38,67,76,105,429,656,5,3719,206,0,2,1,2,77540,30996,6203,40841,0
233,5831,722,423,573,19,0,135,741,12,172,101,199,184,300,1320,2257,6,15668,870,0,2,13,9,77540,30998,6203,40843,1
233,5831,1508,847,911,44,250,301,1552,14,148,88,169,162,257,1120,1886,7,15077,837,0,2,13,9,77540,30999,6204,40844,1
51,2434,722,423,573,19,0,135,741,12,172,101,199,184,300,1320,2257,6,15668,870,0,2,13,0,77540,31001,6204,40846,1
233,5831,722,423,573,19,0,135,741,12,172,101,199,184,300,1320,2257,6,15668,870,0,2,13,9,77540,31003,6204,40848,0
233,5831,1508,847,911,44,250,301,1552,14,148,88,169,162,257,1120,1886,7,15077,837,0,2,13,9,77540,31004,6205,40849,0
51,2434,722,423,573,19,0,135,741,12,172,101,199,184,300,1320,2257,6,15668,870,0,2,13,0,77540,31006,6205,40851,0
77,1854,996,429,845,24,10,117,1020,7,76,50,88,83,138,494,879,4,3565,198,0,2,30,21,77540,31008,6205,40852,0
77,1854,456,277,329,12,42,72,468,13,85,50,97,98,147,592,972,7,7212,400,0,2,30,21,77540,31008,6205,40853,0
47,3494,996,429,845,24,10,117,1020,7,76,50,88,83,138,494,879,4,3565,198,0,2,23,3,77540,31010,6205,40854,0
233,5841,722,423,573,19,0,135,741,12,172,101,199,184,300,1320,2257,6,15668,870,0,2,13,9,77540,31012,6205,40856,0
233,5841,1508,847,911,44,250,301,1552,14,148,88,169,162,257,1120,1886,7,15077,837,0,2,13,9,77540,31013,6206,40857,0
51,2434,722,423,573,19,0,135,741,12,172,101,199,184,300,1320,2257,6,15668,870,0,2,13,0,77540,31015,6206,40859,0
53,1447,339,213,244,17,9,65,356,10,42,26,48,52,74,259,421,5,2410,133,0,2,10,0,77550,31015,6206,40860,0
73,3747,1293,570,1093,25,15,163,1318,10,195,123,241,205,364,1516,2795,6,17273,959,0,2,14,0,77560,31017,6206,40861,0
52,1451,339,213,244,17,9,65,356,10,42,26,48,52,74,259,421,5,2410,133,0,2,23,17,77570,31017,6206,40862,1
73,3779,1293,570,1093,25,15,163,1318,10,195,123,241,205,364,1516,2795,6,17273,959,0,2,37,7,77580,31019,6206,40863,1
52,1451,339,213,244,17,9,65,356,10,42,26,48,52,74,259,421,5,2410,133,0,2,23,17,77590,31019,6206,40864,0
73,3779,1293,570,1093,25,15,163,1318,10,195,123,241,205,364,1516,2795,6,17273,959,0,2,37,7,77600,31021,6206,40865,0
159,3782,77,34,69,0,0,8,77,3,24,16,29,27,45,114,213,1,387,21,0,2,5,2,77600,31021,6206,40866,0
159,3782,712,438,573,51,9,84,763,14,102,71,128,116,199,733,1364,8,11988,666,0,2,5,2,77610,31022,6206,40867,0
73,3748,1293,570,1093,25,15,163,1318,10,195,123,241,205,364,1516,2795,6,17273,959,0,2,2,1,77620,31024,6206,40868,0
83,3389,1043,504,840,53,9,147,1096,9,180,112,198,189,310,1377,2344,4,11604,644,0,2,16,0,77620,31026,6206,40869,0
77,1854,996,429,845,24,10,117,1020,7,76,50,88,83,138,494,879,4,3565,198,0,2,30,21,77620,31028,6206,40870,0
77,1854,456,277,329,12,42,72,468,13,85,50,97,98,147,592,972,7,7212,400,0,2,30,21,77620,31028,6206,40871,0
47,3494,996,429,845,24,10,117,1020,7,76,50,88,83,138,494,879,4,3565,198,0,2,23,3,77620,31030,6206,40872,0
176,5309,1660,832,1314,41,38,274,1701,20,312,209,395,332,604,2671,5058,12,64042,3557,1,2,3,0,77620,31032,6207,40874,0
233,5841,722,423,573,19,0,135,741,12,172,101,199,184,300,1320,2257,6,15668,870,0,2,13,9,77620,31034,6207,40876,0
233,5841,1508,847,911,44,250,301,1552,14,148,88,169,162,257,1120,1886,7,15077,837,0,2,13,9,77620,31035,6208,40877,0
51,2434,722,423,573,19,0,135,741,12,172,101,199,184,300,1320,2257,6,15668,870,0,2,13,0,77620,31037,6208,40879,0
113,2119,477,336,357,30,23,73,507,16,194,134,250,210,384,1538,2962,10,30538,1696,0,2,10,7,77630,31038,6208,40880,0
113,2123,477,336,357,30,23,73,507,16,194,134,250,210,384,1538,2962,10,30538,1696,0,2,7,5,77640,31039,6208,40881,0
117,2176,477,336,357,30,23,73,507,16,194,134,250,210,384,1538,2962,10,30538,1696,0,2,29,14,77650,31040,6208,40882,1
128,5170,1450,624,1228,12,26,181,1462,14,306,186,354,320,540,2580,4493,8,36391,2021,1,2,44,0,77650,31042,6209,40883,1
78,1883,996,429,845,24,10,117,1020,7,76,50,88,83,138,494,879,4,3565,198,0,2,15,6,77650,31044,6209,40884,0
78,1883,456,277,329,12,42,72,468,13,85,50,97,98,147,592,972,7,7212,400,0,2,15,6,77650,31044,6209,40885,0
47,3558,996,429,845,24,10,117,1020,7,76,50,88,83,138,494,879,4,3565,198,0,2,26,6,77650,31046,6209,40886,0
75,1547,1178,367,1042,6,15,115,1184,9,94,51,95,103,146,644,976,4,4439,246,0,2,19,1,77650,31046,6209,40887,0
75,1547,177,108,140,8,0,27,185,6,30,16,32,36,48,162,248,3,794,44,0,2,19,1,77650,31048,6209,40888,0
112,4514,1289,550,1043,56,32,155,1345,10,167,93,185,177,278,1266,2075,5,11498,638,0,2,3,1,77650,31050,6210,40889,0
81,3287,1178,367,1042,6,15,115,1184,9,94,51,95,103,146,644,976,4,4439,246,0,2,1,1,77650,31050,6210,40890,0
103,5555,1943,715,1694,26,18,214,1969,12,185,120,237,197,357,1436,2721,7,20915,1161,0,2,9,3,77650,31052,6210,40891,0
78,1611,1178,367,1042,6,15,115,1184,9,94,51,95,103,146,644,976,4,4439,246,0,2,38,20,77650,31052,6210,40892,0
78,1611,177,108,140,8,0,27,185,6,30,16,32,36,48,162,248,3,794,44,0,2,38,20,77650,31054,6210,40893,0
84,3507,1178,367,1042,6,15,115,1184,9,94,51,95,103,146,644,976,4,4439,246,0,2,44,0,77650,31054,6210,40894,0
103,5555,1943,715,1694,26,18,214,1969,12,185,120,237,197,357,1436,2721,7,20915,1161,0,2,1,1,77650,31056,6210,40895,0
110,2979,1523,757,1297,19,12,193,1542,12,193,117,230,205,347,1508,2664,7,19053,1058,0,2,12,0,77660,31058,6210,40896,0
110,2979,701,378,504,33,58,109,734,13,110,68,126,123,194,794,1346,7,10027,557,0,2,12,0,77660,31059,6211,40897,0
101,4811,1523,757,1297,19,12,193,1542,12,193,117,230,205,347,1508,2664,7,19053,1058,0,2,27,0,77670,31061,6211,40898,0
78,1883,996,429,845,24,10,117,1020,7,76,50,88,83,138,494,879,4,3565,198,0,2,15,6,77670,31063,6211,40899,0
78,1883,456,277,329,12,42,72,468,13,85,50,97,98,147,592,972,7,7212,400,0,2,15,6,77670,31063,6211,40900,0
47,3558,996,429,845,24,10,117,1020,7,76,50,88,83,138,494,879,4,3565,198,0,2,26,6,77670,31065,6211,40901,0
44,2727,652,304,544,16,6,88,668,6,89,51,101,95,152,591,998,3,3399,188,0,2,22,11,77670,31066,6211,40902,1
44,2733,652,304,544,16,6,88,668,6,89,51,101,95,152,591,998,3,3399,188,0,2,2,2,77670,31067,6211,40903,0
234,5861,722,423,573,19,0,135,741,12,172,101,199,184,300,1320,2257,6,15668,870,0,2,9,0,77670,31069,6211,40905,0
234,5861,1508,847,911,44,250,301,1552,14,148,88,169,162,257,1120,1886,7,15077,837,0,2,9,0,77670,31070,6212,40906,0
112,4516,1289,550,1043,56,32,155,1345,10,167,93,185,177,278,1266,2075,5,11498,638,0,2,1,1,77670,31072,6213,40907,0
153,7223,1392,870,1177,35,17,170,1427,14,494,280,531,508,811,4473,7289,7,54850,3047,2,2,1,1,77670,31075,6214,40908,0
95,2931,773,419,590,28,0,166,801,10,204,113,217,214,330,1598,2554,5,13587,754,0,2,1,1,77670,31075,6215,40909,0
101,5269,1457,730,1242,11,6,188,1468,10,292,166,329,302,495,2424,4078,5,22973,1276,1,2,4,4,77670,31077,6215,40910,0
43,2695,652,304,544,16,6,88,668,6,89,51,101,95,152,591,998,3,3399,188,0,2,2,12,77670,31078,6215,40911,0
116,2173,477,336,357,30,23,73,507,16,194,134,250,210,384,1538,2962,10,30538,1696,0,2,1,1,77680,31079,6215,40912,0
78,1607,1178,367,1042,6,15,115,1184,9,94,51,95,103,146,644,976,4,4439,246,0,2,6,10,77680,31079,6215,40913,0
78,1607,177,108,140,8,0,27,185,6,30,16,32,36,48,162,248,3,794,44,0,2,6,10,77680,31081,6215,40914,0
84,3507,1178,367,1042,6,15,115,1184,9,94,51,95,103,146,644,976,4,4439,246,0,2,10,10,77680,31081,6215,40915,0
103,5555,1943,715,1694,26,18,214,1969,12,185,120,237,197,357,1436,2721,7,20915,1161,0,2,1,1,77680,31083,6215,40916,0
116,2173,477,336,357,30,23,73,507,16,194,134,250,210,384,1538,2962,10,30538,1696,0,2,38,18,77690,31084,6215,40917,0
128,5170,1450,624,1228,12,26,181,1462,14,306,186,354,320,540,2580,4493,8,36391,2021,1,2,44,0,77690,31086,6216,40918,0
28,981,74,35,59,1,0,14,75,3,14,7,14,17,21,58,85,1,128,7,0,2,2,1,77690,31087,6216,40919,0
28,981,245,125,200,5,7,34,250,7,30,17,34,37,51,166,265,3,1053,58,0,2,2,1,77700,31088,6216,40920,0
84,3547,1178,367,1042,6,15,115,1184,9,94,51,95,103,146,644,976,4,4439,246,0,2,8,0,77700,31088,6216,40921,0
28,981,74,35,59,1,0,14,75,3,14,7,14,17,21,58,85,1,128,7,0,2,2,1,77700,31089,6216,40922,0
28,981,245,125,200,5,7,34,250,7,30,17,34,37,51,166,265,3,1053,58,0,2,2,1,77710,31090,6216,40923,0
1,96,42,7,35,4,0,5,46,1,2,1,2,3,3,2,4,0,2,0,0,2,1,0,77710,31090,6216,40924,1
1,96,11,6,10,0,0,1,11,2,4,2,4,6,6,10,15,1,15,0,0,2,1,0,77710,31090,6216,40925,1
79,1627,1178,367,1042,6,15,115,1184,9,94,51,95,103,146,644,976,4,4439,246,0,2,9,3,77710,31090,6216,40926,1
79,1627,177,108,140,8,0,27,185,6,30,16,32,36,48,162,248,3,794,44,0,2,9,3,77710,31092,6216,40927,1
87,3601,1178,367,1042,6,15,115,1184,9,94,51,95,103,146,644,976,4,4439,246,0,2,45,28,77710,31092,6216,40928,1
54,1488,339,213,244,17,9,65,356,10,42,26,48,52,74,259,421,5,2410,133,0,2,23,17,77720,31092,6216,40929,0
74,3830,1293,570,1093,25,15,163,1318,10,195,123,241,205,364,1516,2795,6,17273,959,0,2,37,7,77730,31094,6216,40930,0
54,1488,339,213,244,17,9,65,356,10,42,26,48,52,74,259,421,5,2410,133,0,2,23,17,77740,31094,6216,40931,0
74,3830,1293,570,1093,25,15,163,1318,10,195,123,241,205,364,1516,2795,6,17273,959,0,2,37,7,77750,31096,6216,40932,0
239,5959,722,423,573,19,0,135,741,12,172,101,199,184,300,1320,2257,6,15668,870,0,2,32,6,77750,31098,6216,40934,1
239,5959,1508,847,911,44,250,301,1552,14,148,88,169,162,257,1120,1886,7,15077,837,0,2,32,6,77750,31099,6217,40935,1
54,2723,722,423,573,19,0,135,741,12,172,101,199,184,300,1320,2257,6,15668,870,0,2,58,0,77750,31101,6217,40937,1
235,5967,722,423,573,19,0,135,741,12,172,101,199,184,300,1320,2257,6,15668,870,0,2,8,1,77750,31103,6217,40939,1
235,5967,1508,847,911,44,250,301,1552,14,148,88,169,162,257,1120,1886,7,15077,837,0,2,8,1,77750,31104,6218,40940,1
55,2800,722,423,573,19,0,135,741,12,172,101,199,184,300,1320,2257,6,15668,870,0,2,19,0,77750,31106,6218,40942,1
87,3622,1178,367,1042,6,15,115,1184,9,94,51,95,103,146,644,976,4,4439,246,0,2,15,12,77750,31106,6218,40943,0
87,3625,1178,367,1042,6,15,115,1184,9,94,51,95,103,146,644,976,4,4439,246,0,2,1,0,77750,31106,6218,40944,0
248,5130,1943,715,1694,26,18,214,1969,12,185,120,237,197,357,1436,2721,7,20915,1161,0,2,4,4,77750,31108,6218,40945,0
248,5130,1168,838,957,57,25,144,1225,19,348,224,416,367,640,3018,5452,11,61921,3440,1,2,4,4,77760,31110,6218,40946,0
248,5135,1943,715,1694,26,18,214,1969,12,185,120,237,197,357,1436,2721,7,20915,1161,0,2,7,4,77760,31112,6218,40947,0
248,5135,1168,838,957,57,25,144,1225,19,348,224,416,367,640,3018,5452,11,61921,3440,1,2,7,4,77770,31114,6218,40948,0
103,5558,1943,715,1694,26,18,214,1969,12,185,120,237,197,357,1436,2721,7,20915,1161,0,2,3,0,77770,31116,6218,40949,0
103,5579,1943,715,1694,26,18,214,1969,12,185,120,237,197,357,1436,2721,7,20915,1161,0,2,8,2,77770,31118,6218,40950,0
41,821,1178,367,1042,6,15,115,1184,9,94,51,95,103,146,644,976,4,4439,246,0,2,0,125,77770,31118,6218,40951,0
41,821,177,108,140,8,0,27,185,6,30,16,32,36,48,162,248,3,794,44,0,2,0,125,77770,31120,6218,40952,0
279,5775,1943,715,1694,26,18,214,1969,12,185,120,237,197,357,1436,2721,7,20915,1161,0,2,122,0,77770,31122,6218,40953,0
279,5775,1168,838,957,57,25,144,1225,19,348,224,416,367,640,3018,5452,11,61921,3440,1,2,122,0,77780,31124,6218,40954,0
80,3144,1178,367,1042,6,15,115,1184,9,94,51,95,103,146,644,976,4,4439,246,0,2,0,35,77780,31124,6218,40955,0
104,5687,1943,715,1694,26,18,214,1969,12,185,120,237,197,357,1436,2721,7,20915,1161,0,2,35,0,77780,31126,6218,40956,0
7,107,127,75,83,2,11,30,129,4,14,7,14,18,21,61,87,2,175,9,0,0,26,0,77780,31126,6218,40957,1
7,107,652,304,544,16,6,88,668,6,89,51,101,95,152,591,998,3,3399,188,0,0,26,0,77780,31127,6218,40958,1
7,107,2,2,2,0,0,0,2,0,0,0,0,0,0,0,0,0,0,0,0,0,26,0,77780,31127,6218,40958,1
7,107,8,5,5,0,0,3,8,0,0,0,0,0,0,0,0,0,0,0,0,0,26,0,77780,31127,6218,40959,1
7,107,2,2,2,0,0,0,2,0,0,0,0,0,0,0,0,0,0,0,0,0,26,0,77780,31127,6218,40959,1
7,107,14,8,8,0,0,6,14,0,0,0,0,0,0,0,0,0,0,0,0,0,26,0,77780,31127,6218,40960,1
7,107,6,4,4,0,0,2,6,0,0,0,0,0,0,0,0,0,0,0,0,0,26,0,77780,31127,6218,40961,1
7,107,6,4,4,0,0,2,6,1,2,1,2,3,3,2,4,0,2,0,0,0,26,0,77780,31127,6218,40962,1
7,107,6,4,4,0,0,2,6,0,0,0,0,0,0,0,0,0,0,0,0,0,26,0,77780,31127,6218,40963,1
7,107,7,5,5,0,0,2,7,0,0,0,0,0,0,0,0,0,0,0,0,0,26,0,77780,31127,6218,40964,1
7,107,6,4,4,0,0,2,6,0,0,0,0,0,0,0,0,0,0,0,0,0,26,0,77780,31127,6218,40965,1
7,107,10,6,6,0,0,4,10,0,0,0,0,0,0,0,0,0,0,0,0,0,26,0,77780,31127,6218,40966,1
7,107,1,1,1,0,0,0,1,0,0,0,0,0,0,0,0,0,0,0,0,0,26,0,77780,31127,6218,40966,1
7,107,14,10,10,0,0,4,14,1,1,1,1,2,2,0,2,0,1,0,0,0,26,0,77780,31127,6218,40967,1
7,107,46,26,30,3,0,12,49,3,6,3,6,9,9,20,28,1,42,2,0,0,26,0,77790,31127,6218,40968,1
280,5752,1943,715,1694,26,18,214,1969,12,185,120,237,197,357,1436,2721,7,20915,1161,0,2,94,101,77790,31129,6218,40969,0
280,5752,1168,838,957,57,25,144,1225,19,348,224,416,367,640,3018,5452,11,61921,3440,1,2,94,101,77800,31131,6218,40970,0
104,5687,1943,715,1694,26,18,214,1969,12,185,120,237,197,357,1436,2721,7,20915,1161,0,2,2,2,77800,31133,6218,40971,0
278,5743,1943,715,1694,26,18,214,1969,12,185,120,237,197,357,1436,2721,7,20915,1161,0,2,6,11,77800,31135,6218,40972,0
278,5743,1168,838,957,57,25,144,1225,19,348,224,416,367,640,3018,5452,11,61921,3440,1,2,6,11,77810,31137,6218,40973,0
275,5744,1943,715,1694,26,18,214,1969,12,185,120,237,197,357,1436,2721,7,20915,1161,0,2,33,41,77810,31139,6218,40974,1
275,5744,1168,838,957,57,25,144,1225,19,348,224,416,367,640,3018,5452,11,61921,3440,1,2,33,41,77820,31141,6218,40975,1
54,1488,339,213,244,17,9,65,356,10,42,26,48,52,74,259,421,5,2410,133,0,2,1,1,77830,31141,6218,40976,1
74,3867,1293,570,1093,25,15,163,1318,10,195,123,241,205,364,1516,2795,6,17273,959,0,2,13,2,77840,31143,6218,40977,1
248,5130,1943,715,1694,26,18,214,1969,12,185,120,237,197,357,1436,2721,7,20915,1161,0,2,1,1,77840,31145,6218,40978,0
248,5130,1168,838,957,57,25,144,1225,19,348,224,416,367,640,3018,5452,11,61921,3440,1,2,1,1,77850,31147,6218,40979,0
249,5128,1943,715,1694,26,18,214,1969,12,185,120,237,197,357,1436,2721,7,20915,1161,0,2,11,8,77850,31149,6218,40980,0
249,5128,1168,838,957,57,25,144,1225,19,348,224,416,367,640,3018,5452,11,61921,3440,1,2,11,8,77860,31151,6218,40981,0
54,1488,339,213,244,17,9,65,356,10,42,26,48,52,74,259,421,5,2410,133,0,2,1,1,77870,31151,6218,40982,0
74,3867,1293,570,1093,25,15,163,1318,10,195,123,241,205,364,1516,2795,6,17273,959,0,2,13,2,77880,31153,6218,40983,0
235,5973,722,423,573,19,0,135,741,12,172,101,199,184,300,1320,2257,6,15668,870,0,2,5,5,77880,31155,6218,40985,0
235,5973,1508,847,911,44,250,301,1552,14,148,88,169,162,257,1120,1886,7,15077,837,0,2,5,5,77880,31156,6219,40986,0
234,5944,722,423,573,19,0,135,741,12,172,101,199,184,300,1320,2257,6,15668,870,0,2,1,6,77880,31158,6219,40988,0
234,5944,1508,847,911,44,250,301,1552,14,148,88,169,162,257,1120,1886,7,15077,837,0,2,1,6,77880,31159,6220,40989,0
55,2800,722,423,573,19,0,135,741,12,172,101,199,184,300,1320,2257,6,15668,870,0,2,1,1,77880,31161,6220,40991,0
7,107,127,75,83,2,11,30,129,4,14,7,14,18,21,61,87,2,175,9,0,0,26,0,77880,31161,6220,40992,0
7,107,652,304,544,16,6,88,668,6,89,51,101,95,152,591,998,3,3399,188,0,0,26,0,77880,31162,6220,40993,0
7,107,2,2,2,0,0,0,2,0,0,0,0,0,0,0,0,0,0,0,0,0,26,0,77880,31162,6220,40993,0
7,107,8,5,5,0,0,3,8,0,0,0,0,0,0,0,0,0,0,0,0,0,26,0,77880,31162,6220,40994,0
7,107,2,2,2,0,0,0,2,0,0,0,0,0,0,0,0,0,0,0,0,0,26,0,77880,31162,6220,40994,0
7,107,14,8,8,0,0,6,14,0,0,0,0,0,0,0,0,0,0,0,0,0,26,0,77880,31162,6220,40995,0
7,107,6,4,4,0,0,2,6,0,0,0,0,0,0,0,0,0,0,0,0,0,26,0,77880,31162,6220,40996,0
7,107,6,4,4,0,0,2,6,1,2,1,2,3,3,2,4,0,2,0,0,0,26,0,77880,31162,6220,40997,0
7,107,6,4,4,0,0,2,6,0,0,0,0,0,0,0,0,0,0,0,0,0,26,0,77880,31162,6220,40998,0
7,107,7,5,5,0,0,2,7,0,0,0,0,0,0,0,0,0,0,0,0,0,26,0,77880,31162,6220,40999,0
7,107,6,4,4,0,0,2,6,0,0,0,0,0,0,0,0,0,0,0,0,0,26,0,77880,31162,6220,41000,0
7,107,10,6,6,0,0,4,10,0,0,0,0,0,0,0,0,0,0,0,0,0,26,0,77880,31162,6220,41001,0
7,107,1,1,1,0,0,0,1,0,0,0,0,0,0,0,0,0,0,0,0,0,26,0,77880,31162,6220,41001,0
7,107,14,10,10,0,0,4,14,1,1,1,1,2,2,0,2,0,1,0,0,0,26,0,77880,31162,6220,41002,0
7,107,46,26,30,3,0,12,49,3,6,3,6,9,9,20,28,1,42,2,0,0,26,0,77890,31162,6220,41003,0
249,5128,1943,715,1694,26,18,214,1969,12,185,120,237,197,357,1436,2721,7,20915,1161,0,2,11,8,77890,31164,6220,41004,0
249,5128,1168,838,957,57,25,144,1225,19,348,224,416,367,640,3018,5452,11,61921,3440,1,2,11,8,77900,31166,6220,41005,0
249,5128,1943,715,1694,26,18,214,1969,12,185,120,237,197,357,1436,2721,7,20915,1161,0,2,1,1,77900,31168,6220,41006,0
249,5128,1168,838,957,57,25,144,1225,19,348,224,416,367,640,3018,5452,11,61921,3440,1,2,1,1,77910,31170,6220,41007,0
234,5944,722,423,573,19,0,135,741,12,172,101,199,184,300,1320,2257,6,15668,870,0,2,34,6,77910,31172,6220,41009,0
234,5944,1508,847,911,44,250,301,1552,14,148,88,169,162,257,1120,1886,7,15077,837,0,2,34,6,77910,31173,6221,41010,0
55,2800,722,423,573,19,0,135,741,12,172,101,199,184,300,1320,2257,6,15668,870,0,2,77,0,77910,31175,6221,41012,0
233,5970,722,423,573,19,0,135,741,12,172,101,199,184,300,1320,2257,6,15668,870,0,2,16,9,77910,31177,6221,41014,0
233,5970,1508,847,911,44,250,301,1552,14,148,88,169,162,257,1120,1886,7,15077,837,0,2,16,9,77910,31178,6222,41015,0
125,5397,1513,682,1277,25,13,200,1538,11,199,116,219,210,335,1557,2584,6,15641,868,0,2,3,3,77910,31180,6222,41016,0
234,5861,722,423,573,19,0,135,741,12,172,101,199,184,300,1320,2257,6,15668,870,0,2,9,0,77910,31182,6222,41018,0
234,5861,1508,847,911,44,250,301,1552,14,148,88,169,162,257,1120,1886,7,15077,837,0,2,9,0,77910,31183,6223,41019,0
112,4516,1289,550,1043,56,32,155,1345,10,167,93,185,177,278,1266,2075,5,11498,638,0,2,1,1,77910,31185,6224,41020,0
153,7223,1392,870,1177,35,17,170,1427,14,494,280,531,508,811,4473,7289,7,54850,3047,2,2,1,1,77910,31188,6225,41021,0
95,2931,773,419,590,28,0,166,801,10,204,113,217,214,330,1598,2554,5,13587,754,0,2,1,1,77910,31188,6226,41022,0
101,5269,1457,730,1242,11,6,188,1468,10,292,166,329,302,495,2424,4078,5,22973,1276,1,2,4,4,77910,31190,6226,41023,0
43,2695,652,304,544,16,6,88,668,6,89,51,101,95,152,591,998,3,3399,188,0,2,15,14,77910,31191,6226,41024,0
41,821,1178,367,1042,6,15,115,1184,9,94,51,95,103,146,644,976,4,4439,246,0,2,0,125,77910,31191,6226,41025,0
41,821,177,108,140,8,0,27,185,6,30,16,32,36,48,162,248,3,794,44,0,2,0,125,77910,31193,6226,41026,0
276,5742,1943,715,1694,26,18,214,1969,12,185,120,237,197,357,1436,2721,7,20915,1161,0,2,102,0,77910,31195,6226,41027,0
276,5742,1168,838,957,57,25,144,1225,19,348,224,416,367,640,3018,5452,11,61921,3440,1,2,102,0,77920,31197,6226,41028,0
80,3144,1178,367,1042,6,15,115,1184,9,94,51,95,103,146,644,976,4,4439,246,0,2,0,35,77920,31197,6226,41029,0
104,5687,1943,715,1694,26,18,214,1969,12,185,120,237,197,357,1436,2721,7,20915,1161,0,2,35,0,77920,31199,6226,41030,0
233,5970,722,423,573,19,0,135,741,12,172,101,199,184,300,1320,2257,6,15668,870,0,2,16,9,77920,31201,6226,41032,0
233,5970,1508,847,911,44,250,301,1552,14,148,88,169,162,257,1120,1886,7,15077,837,0,2,16,9,77920,31202,6227,41033,0
125,5397,1513,682,1277,25,13,200,1538,11,199,116,219,210,335,1557,2584,6,15641,868,0,2,3,3,77920,31204,6227,41034,0
234,6000,722,423,573,19,0,135,741,12,172,101,199,184,300,1320,2257,6,15668,870,0,2,9,0,77920,31206,6227,41036,0
234,6000,1508,847,911,44,250,301,1552,14,148,88,169,162,257,1120,1886,7,15077,837,0,2,9,0,77920,31207,6228,41037,0
112,4516,1289,550,1043,56,32,155,1345,10,167,93,185,177,278,1266,2075,5,11498,638,0,2,1,1,77920,31209,6229,41038,0
153,7223,1392,870,1177,35,17,170,1427,14,494,280,531,508,811,4473,7289,7,54850,3047,2,2,1,1,77920,31212,6230,41039,0
95,2931,773,419,590,28,0,166,801,10,204,113,217,214,330,1598,2554,5,13587,754,0,2,1,1,77920,31212,6231,41040,0
103,5268,1457,730,1242,11,6,188,1468,10,292,166,329,302,495,2424,4078,5,22973,1276,1,2,4,4,77920,31214,6231,41041,0
43,2698,652,304,544,16,6,88,668,6,89,51,101,95,152,591,998,3,3399,188,0,2,15,14,77920,31215,6231,41042,0
234,6000,722,423,573,19,0,135,741,12,172,101,199,184,300,1320,2257,6,15668,870,0,2,9,0,77920,31217,6231,41044,0
234,6000,1508,847,911,44,250,301,1552,14,148,88,169,162,257,1120,1886,7,15077,837,0,2,9,0,77920,31218,6232,41045,0
112,4516,1289,550,1043,56,32,155,1345,10,167,93,185,177,278,1266,2075,5,11498,638,0,2,1,1,77920,31220,6233,41046,0
153,7223,1392,870,1177,35,17,170,1427,14,494,280,531,508,811,4473,7289,7,54850,3047,2,2,1,1,77920,31223,6234,41047,0
95,2931,773,419,590,28,0,166,801,10,204,113,217,214,330,1598,2554,5,13587,754,0,2,1,1,77920,31223,6235,41048,0
103,5268,1457,730,1242,11,6,188,1468,10,292,166,329,302,495,2424,4078,5,22973,1276,1,2,4,4,77920,31225,6235,41049,0
43,2698,652,304,544,16,6,88,668,6,89,51,101,95,152,591,998,3,3399,188,0,2,15,14,77920,31226,6235,41050,0
109,2961,1523,757,1297,19,12,193,1542,12,193,117,230,205,347,1508,2664,7,19053,1058,0,2,8,1,77930,31228,6235,41051,0
109,2961,701,378,504,33,58,109,734,13,110,68,126,123,194,794,1346,7,10027,557,0,2,8,1,77930,31229,6236,41052,0
101,4838,1523,757,1297,19,12,193,1542,12,193,117,230,205,347,1508,2664,7,19053,1058,0,2,19,1,77940,31231,6236,41053,0
81,1651,1178,367,1042,6,15,115,1184,9,94,51,95,103,146,644,976,4,4439,246,0,2,11,0,77940,31231,6236,41054,0
81,1651,177,108,140,8,0,27,185,6,30,16,32,36,48,162,248,3,794,44,0,2,11,0,77940,31233,6236,41055,0
109,2961,1523,757,1297,19,12,193,1542,12,193,117,230,205,347,1508,2664,7,19053,1058,0,2,8,1,77950,31235,6236,41056,0
109,2961,701,378,504,33,58,109,734,13,110,68,126,123,194,794,1346,7,10027,557,0,2,8,1,77950,31236,6237,41057,0
101,4838,1523,757,1297,19,12,193,1542,12,193,117,230,205,347,1508,2664,7,19053,1058,0,2,19,1,77960,31238,6237,41058,0
276,5747,1943,715,1694,26,18,214,1969,12,185,120,237,197,357,1436,2721,7,20915,1161,0,2,10,7,77960,31240,6237,41059,0
276,5747,1168,838,957,57,25,144,1225,19,348,224,416,367,640,3018,5452,11,61921,3440,1,2,10,7,77970,31242,6237,41060,0
104,5722,1943,715,1694,26,18,214,1969,12,185,120,237,197,357,1436,2721,7,20915,1161,0,2,11,2,77970,31244,6237,41061,0
248,5739,4293,999,3693,19,54,507,4312,9,155,88,170,164,258,1156,1898,4,9368,520,0,2,3,1,77970,31246,6237,41063,1
248,5739,1482,859,1002,125,135,219,1607,16,219,134,251,235,385,1766,3032,9,27804,1544,1,2,3,1,77980,31247,6237,41064,1
234,5859,722,423,573,19,0,135,741,12,172,101,199,184,300,1320,2257,6,15668,870,0,2,1,1,77980,31249,6237,41066,1
234,5859,1508,847,911,44,250,301,1552,14,148,88,169,162,257,1120,1886,7,15077,837,0,2,1,1,77980,31250,6238,41067,1
171,7587,4293,999,3693,19,54,507,4312,9,155,88,170,164,258,1156,1898,4,9368,520,0,2,1,3,77980,31252,6238,41068,1
171,7587,1482,859,1002,125,135,219,1607,16,219,134,251,235,385,1766,3032,9,27804,1544,1,2,1,3,77990,31253,6238,41069,1
248,5739,4293,999,3693,19,54,507,4312,9,155,88,170,164,258,1156,1898,4,9368,520,0,2,3,1,77990,31255,6238,41071,0
248,5739,1482,859,1002,125,135,219,1607,16,219,134,251,235,385,1766,3032,9,27804,1544,1,2,3,1,78000,31256,6238,41072,0
234,5859,722,423,573,19,0,135,741,12,172,101,199,184,300,1320,2257,6,15668,870,0,2,1,1,78000,31258,6238,41074,0
234,5859,1508,847,911,44,250,301,1552,14,148,88,169,162,257,1120,1886,7,15077,837,0,2,1,1,78000,31259,6239,41075,0
171,7587,4293,999,3693,19,54,507,4312,9,155,88,170,164,258,1156,1898,4,9368,520,0,2,1,3,78000,31261,6239,41076,0
171,7587,1482,859,1002,125,135,219,1607,16,219,134,251,235,385,1766,3032,9,27804,1544,1,2,1,3,78010,31262,6239,41077,0
70,1528,402,202,227,24,74,80,426,12,52,33,61,64,94,339,564,7,3969,220,0,2,9,3,78010,31263,6239,41079,0
20,531,205,80,86,16,53,53,221,7,18,10,19,25,29,94,134,3,497,27,0,2,1,2,78020,31263,6240,41080,0
92,1890,757,253,292,73,244,162,830,13,61,38,67,74,105,409,651,7,4654,258,0,2,1,1,78020,31264,6240,41081,0
70,3188,1020,354,843,12,15,144,1032,8,134,77,144,142,221,970,1580,4,6792,377,0,2,13,0,78020,31264,6240,41082,0
70,1528,402,202,227,24,74,80,426,12,52,33,61,64,94,339,564,7,3969,220,0,2,9,3,78020,31265,6240,41084,0
20,531,205,80,86,16,53,53,221,7,18,10,19,25,29,94,134,3,497,27,0,2,1,2,78030,31265,6241,41085,0
92,1890,757,253,292,73,244,162,830,13,61,38,67,74,105,409,651,7,4654,258,0,2,1,1,78030,31266,6241,41086,0
70,3188,1020,354,843,12,15,144,1032,8,134,77,144,142,221,970,1580,4,6792,377,0,2,13,0,78030,31266,6241,41087,0
55,1174,447,308,343,6,5,95,453,7,96,59,111,103,170,651,1136,4,4600,255,0,2,12,0,78030,31269,6241,41088,0
55,1174,322,174,179,16,74,51,338,10,41,26,46,51,72,252,408,5,2291,127,0,2,12,0,78030,31272,6242,41089,0
232,5822,722,423,573,19,0,135,741,12,172,101,199,184,300,1320,2257,6,15668,870,0,2,1,18,78030,31274,6242,41091,0
232,5822,1508,847,911,44,250,301,1552,14,148,88,169,162,257,1120,1886,7,15077,837,0,2,1,18,78030,31275,6243,41092,0
47,2189,447,308,343,6,5,95,453,7,96,59,111,103,170,651,1136,4,4600,255,0,2,7,0,78030,31278,6243,41093,0
55,1174,447,308,343,6,5,95,453,7,96,59,111,103,170,651,1136,4,4600,255,0,2,12,0,78030,31281,6243,41094,0
55,1174,322,174,179,16,74,51,338,10,41,26,46,51,72,252,408,5,2291,127,0,2,12,0,78030,31284,6244,41095,0
232,5822,722,423,573,19,0,135,741,12,172,101,199,184,300,1320,2257,6,15668,870,0,2,1,18,78030,31286,6244,41097,0
232,5822,1508,847,911,44,250,301,1552,14,148,88,169,162,257,1120,1886,7,15077,837,0,2,1,18,78030,31287,6245,41098,0
47,2189,447,308,343,6,5,95,453,7,96,59,111,103,170,651,1136,4,4600,255,0,2,7,0,78030,31290,6245,41099,0
276,5755,1943,715,1694,26,18,214,1969,12,185,120,237,197,357,1436,2721,7,20915,1161,0,2,1,1,78030,31292,6245,41100,0
276,5755,1168,838,957,57,25,144,1225,19,348,224,416,367,640,3018,5452,11,61921,3440,1,2,1,1,78040,31294,6245,41101,0
24,612,2,2,2,0,0,0,2,0,0,0,0,0,0,0,0,0,0,0,0,2,3,0,78040,31294,6245,41101,0
24,612,99,48,90,1,3,5,100,0,0,0,0,0,0,0,0,0,0,0,0,2,3,0,78040,31295,6245,41102,0
24,612,8,5,5,2,0,1,10,0,0,0,0,0,0,0,0,0,0,0,0,2,3,0,78040,31295,6245,41103,0
24,612,1217,716,841,84,126,174,1301,14,185,118,215,199,333,1446,2542,8,20687,1149,0,2,3,0,78050,31297,6245,41104,0
24,612,160,89,115,0,13,31,160,7,15,11,17,22,28,78,124,3,495,27,0,2,3,0,78050,31297,6245,41105,0
24,612,10,10,9,9,0,0,19,0,0,0,0,0,0,0,0,0,0,0,0,2,3,0,78050,31297,6246,41106,0
24,612,173,84,99,8,29,36,181,5,12,7,13,17,20,54,81,2,221,12,0,2,3,0,78050,31298,6246,41107,0
24,612,3,1,1,3,0,0,6,0,0,0,0,0,0,0,0,0,0,0,0,2,3,0,78050,31298,6246,41108,0
86,3411,1043,504,840,53,9,147,1096,9,180,112,198,189,310,1377,2344,4,11604,644,0,2,8,1,78050,31300,6246,41109,1
234,6000,722,423,573,19,0,135,741,12,172,101,199,184,300,1320,2257,6,15668,870,0,2,1,1,78050,31302,6246,41111,0
234,6000,1508,847,911,44,250,301,1552,14,148,88,169,162,257,1120,1886,7,15077,837,0,2,1,1,78050,31303,6247,41112,0
233,6008,722,423,573,19,0,135,741,12,172,101,199,184,300,1320,2257,6,15668,870,0,2,2,1,78050,31305,6247,41114,0
233,6008,1508,847,911,44,250,301,1552,14,148,88,169,162,257,1120,1886,7,15077,837,0,2,2,1,78050,31306,6248,41115,0
275,5744,1943,715,1694,26,18,214,1969,12,185,120,237,197,357,1436,2721,7,20915,1161,0,2,8,9,78050,31308,6248,41116,0
275,5744,1168,838,957,57,25,144,1225,19,348,224,416,367,640,3018,5452,11,61921,3440,1,2,8,9,78060,31310,6248,41117,0
274,5752,1943,715,1694,26,18,214,1969,12,185,120,237,197,357,1436,2721,7,20915,1161,0,2,2,1,78060,31312,6248,41118,1
274,5752,1168,838,957,57,25,144,1225,19,348,224,416,367,640,3018,5452,11,61921,3440,1,2,2,1,78070,31314,6248,41119,1
248,5739,4293,999,3693,19,54,507,4312,9,155,88,170,164,258,1156,1898,4,9368,520,0,2,3,1,78070,31316,6248,41122,0
248,5739,1482,859,1002,125,135,219,1607,16,219,134,251,235,385,1766,3032,9,27804,1544,1,2,3,1,78080,31317,6248,41123,0
69,1526,402,202,227,24,74,80,426,12,52,33,61,64,94,339,564,7,3969,220,0,2,9,3,78080,31318,6248,41124,0
55,1174,447,308,343,6,5,95,453,7,96,59,111,103,170,651,1136,4,4600,255,0,2,12,0,78080,31321,6248,41125,0
55,1174,322,174,179,16,74,51,338,10,41,26,46,51,72,252,408,5,2291,127,0,2,12,0,78080,31324,6249,41126,0
20,531,205,80,86,16,53,53,221,7,18,10,19,25,29,94,134,3,497,27,0,2,1,2,78090,31324,6250,41127,0
232,5961,722,423,573,19,0,135,741,12,172,101,199,184,300,1320,2257,6,15668,870,0,2,2,19,78090,31326,6250,41129,0
232,5961,1508,847,911,44,250,301,1552,14,148,88,169,162,257,1120,1886,7,15077,837,0,2,2,19,78090,31327,6251,41130,0
92,1890,757,253,292,73,244,162,830,13,61,38,67,74,105,409,651,7,4654,258,0,2,1,1,78090,31328,6251,41131,0
171,7599,4293,999,3693,19,54,507,4312,9,155,88,170,164,258,1156,1898,4,9368,520,0,2,1,3,78090,31330,6251,41132,0
171,7599,1482,859,1002,125,135,219,1607,16,219,134,251,235,385,1766,3032,9,27804,1544,1,2,1,3,78100,31331,6251,41133,0
70,3194,1020,354,843,12,15,144,1032,8,134,77,144,142,221,970,1580,4,6792,377,0,2,13,0,78100,31331,6251,41134,0
47,2189,447,308,343,6,5,95,453,7,96,59,111,103,170,651,1136,4,4600,255,0,2,7,0,78100,31334,6251,41135,0
86,3411,1043,504,840,53,9,147,1096,9,180,112,198,189,310,1377,2344,4,11604,644,0,2,1,1,78100,31336,6251,41136,0
78,1883,996,429,845,24,10,117,1020,7,76,50,88,83,138,494,879,4,3565,198,0,2,37,37,78100,31338,6251,41137,0
78,1883,456,277,329,12,42,72,468,13,85,50,97,98,147,592,972,7,7212,400,0,2,37,37,78100,31338,6251,41138,0
68,1497,402,202,227,24,74,80,426,12,52,33,61,64,94,339,564,7,3969,220,0,2,1,1,78100,31339,6251,41139,0
276,5747,1943,715,1694,26,18,214,1969,12,185,120,237,197,357,1436,2721,7,20915,1161,0,2,2,2,78100,31341,6251,41140,0
276,5747,1168,838,957,57,25,144,1225,19,348,224,416,367,640,3018,5452,11,61921,3440,1,2,2,2,78110,31343,6251,41141,0
236,4937,2,2,2,0,0,0,2,0,0,0,0,0,0,0,0,0,0,0,0,2,0,1,78110,31343,6251,41141,0
236,4937,99,48,90,1,3,5,100,0,0,0,0,0,0,0,0,0,0,0,0,2,0,1,78110,31344,6251,41142,0
236,4937,8,5,5,2,0,1,10,0,0,0,0,0,0,0,0,0,0,0,0,2,0,1,78110,31344,6251,41143,0
236,4937,1217,716,841,84,126,174,1301,14,185,118,215,199,333,1446,2542,8,20687,1149,0,2,0,1,78120,31346,6251,41144,0
236,4937,160,89,115,0,13,31,160,7,15,11,17,22,28,78,124,3,495,27,0,2,0,1,78120,31346,6251,41145,0
236,4937,10,10,9,9,0,0,19,0,0,0,0,0,0,0,0,0,0,0,0,2,0,1,78120,31346,6252,41146,0
236,4937,173,84,99,8,29,36,181,5,12,7,13,17,20,54,81,2,221,12,0,2,0,1,78120,31347,6252,41147,0
236,4937,3,1,1,3,0,0,6,0,0,0,0,0,0,0,0,0,0,0,0,2,0,1,78120,31347,6252,41148,0
54,657,647,139,84,35,284,233,682,0,0,0,0,0,0,0,0,0,0,0,0,2,1,1,78120,31347,6252,41149,0
66,1720,466,257,367,18,25,50,484,7,126,86,171,133,257,898,1813,4,8612,478,0,2,2,1,78120,31347,6252,41150,0
66,1720,507,281,342,29,59,88,536,10,53,29,57,63,86,336,514,5,2764,153,0,2,2,1,78120,31347,6252,41151,0
277,5779,1943,715,1694,26,18,214,1969,12,185,120,237,197,357,1436,2721,7,20915,1161,0,2,11,6,78120,31349,6252,41152,0
277,5779,1168,838,957,57,25,144,1225,19,348,224,416,367,640,3018,5452,11,61921,3440,1,2,11,6,78130,31351,6252,41153,0
68,1497,402,202,227,24,74,80,426,12,52,33,61,64,94,339,564,7,3969,220,0,2,1,1,78130,31352,6252,41154,0
69,3128,1020,354,843,12,15,144,1032,8,134,77,144,142,221,970,1580,4,6792,377,0,2,1,1,78130,31352,6252,41155,0
248,5739,4293,999,3693,19,54,507,4312,9,155,88,170,164,258,1156,1898,4,9368,520,0,2,3,1,78130,31354,6252,41158,0
248,5739,1482,859,1002,125,135,219,1607,16,219,134,251,235,385,1766,3032,9,27804,1544,1,2,3,1,78140,31355,6252,41159,0
69,1526,402,202,227,24,74,80,426,12,52,33,61,64,94,339,564,7,3969,220,0,2,9,3,78140,31356,6252,41160,0
55,1174,447,308,343,6,5,95,453,7,96,59,111,103,170,651,1136,4,4600,255,0,2,12,0,78140,31359,6252,41161,0
55,1174,322,174,179,16,74,51,338,10,41,26,46,51,72,252,408,5,2291,127,0,2,12,0,78140,31362,6253,41162,0
20,531,205,80,86,16,53,53,221,7,18,10,19,25,29,94,134,3,497,27,0,2,1,2,78150,31362,6254,41163,0
232,5961,722,423,573,19,0,135,741,12,172,101,199,184,300,1320,2257,6,15668,870,0,2,2,19,78150,31364,6254,41165,0
232,5961,1508,847,911,44,250,301,1552,14,148,88,169,162,257,1120,1886,7,15077,837,0,2,2,19,78150,31365,6255,41166,0
92,1890,757,253,292,73,244,162,830,13,61,38,67,74,105,409,651,7,4654,258,0,2,1,1,78150,31366,6255,41167,0
171,7599,4293,999,3693,19,54,507,4312,9,155,88,170,164,258,1156,1898,4,9368,520,0,2,1,3,78150,31368,6255,41168,0
171,7599,1482,859,1002,125,135,219,1607,16,219,134,251,235,385,1766,3032,9,27804,1544,1,2,1,3,78160,31369,6255,41169,0
70,3194,1020,354,843,12,15,144,1032,8,134,77,144,142,221,970,1580,4,6792,377,0,2,13,0,78160,31369,6255,41170,0
47,2189,447,308,343,6,5,95,453,7,96,59,111,103,170,651,1136,4,4600,255,0,2,7,0,78160,31372,6255,41171,0
69,1526,402,202,227,24,74,80,426,12,52,33,61,64,94,339,564,7,3969,220,0,2,1,1,78160,31373,6255,41172,0
70,3194,1020,354,843,12,15,144,1032,8,134,77,144,142,221,970,1580,4,6792,377,0,2,1,1,78160,31373,6255,41173,0
86,3411,1043,504,840,53,9,147,1096,9,180,112,198,189,310,1377,2344,4,11604,644,0,2,8,1,78160,31375,6255,41174,0
66,1720,466,257,367,18,25,50,484,7,126,86,171,133,257,898,1813,4,8612,478,0,2,2,1,78160,31375,6255,41175,0
66,1720,507,281,342,29,59,88,536,10,53,29,57,63,86,336,514,5,2764,153,0,2,2,1,78160,31375,6255,41176,0
277,5779,1943,715,1694,26,18,214,1969,12,185,120,237,197,357,1436,2721,7,20915,1161,0,2,11,6,78160,31377,6255,41177,0
277,5779,1168,838,957,57,25,144,1225,19,348,224,416,367,640,3018,5452,11,61921,3440,1,2,11,6,78170,31379,6255,41178,0
276,5747,1943,715,1694,26,18,214,1969,12,185,120,237,197,357,1436,2721,7,20915,1161,0,2,1,1,78170,31381,6255,41179,0
276,5747,1168,838,957,57,25,144,1225,19,348,224,416,367,640,3018,5452,11,61921,3440,1,2,1,1,78180,31383,6255,41180,0
104,5724,1943,715,1694,26,18,214,1969,12,185,120,237,197,357,1436,2721,7,20915,1161,0,2,11,3,78180,31385,6255,41181,0
78,1883,996,429,845,24,10,117,1020,7,76,50,88,83,138,494,879,4,3565,198,0,2,37,37,78180,31387,6255,41182,0
78,1883,456,277,329,12,42,72,468,13,85,50,97,98,147,592,972,7,7212,400,0,2,37,37,78180,31387,6255,41183,0
236,4937,2,2,2,0,0,0,2,0,0,0,0,0,0,0,0,0,0,0,0,2,0,1,78180,31387,6255,41183,0
236,4937,99,48,90,1,3,5,100,0,0,0,0,0,0,0,0,0,0,0,0,2,0,1,78180,31388,6255,41184,0
236,4937,8,5,5,2,0,1,10,0,0,0,0,0,0,0,0,0,0,0,0,2,0,1,78180,31388,6255,41185,0
236,4937,1217,716,841,84,126,174,1301,14,185,118,215,199,333,1446,2542,8,20687,1149,0,2,0,1,78190,31390,6255,41186,0
236,4937,160,89,115,0,13,31,160,7,15,11,17,22,28,78,124,3,495,27,0,2,0,1,78190,31390,6255,41187,0
236,4937,10,10,9,9,0,0,19,0,0,0,0,0,0,0,0,0,0,0,0,2,0,1,78190,31390,6256,41188,0
236,4937,173,84,99,8,29,36,181,5,12,7,13,17,20,54,81,2,221,12,0,2,0,1,78190,31391,6256,41189,0
236,4937,3,1,1,3,0,0,6,0,0,0,0,0,0,0,0,0,0,0,0,2,0,1,78190,31391,6256,41190,0
54,657,647,139,84,35,284,233,682,0,0,0,0,0,0,0,0,0,0,0,0,2,1,1,78190,31391,6256,41191,0
69,1526,402,202,227,24,74,80,426,12,52,33,61,64,94,339,564,7,3969,220,0,2,1,1,78190,31392,6256,41192,0
277,5779,1943,715,1694,26,18,214,1969,12,185,120,237,197,357,1436,2721,7,20915,1161,0,2,2,2,78190,31394,6256,41193,0
277,5779,1168,838,957,57,25,144,1225,19,348,224,416,367,640,3018,5452,11,61921,3440,1,2,2,2,78200,31396,6256,41194,0
276,5746,1943,715,1694,26,18,214,1969,12,185,120,237,197,357,1436,2721,7,20915,1161,0,2,4,4,78200,31398,6256,41195,0
276,5746,1168,838,957,57,25,144,1225,19,348,224,416,367,640,3018,5452,11,61921,3440,1,2,4,4,78210,31400,6256,41196,0
67,1744,466,257,367,18,25,50,484,7,126,86,171,133,257,898,1813,4,8612,478,0,2,6,0,78210,31400,6256,41197,0
67,1744,507,281,342,29,59,88,536,10,53,29,57,63,86,336,514,5,2764,153,0,2,6,0,78210,31400,6256,41198,0
275,5715,1943,715,1694,26,18,214,1969,12,185,120,237,197,357,1436,2721,7,20915,1161,0,2,4,10,78210,31402,6256,41199,0
275,5715,1168,838,957,57,25,144,1225,19,348,224,416,367,640,3018,5452,11,61921,3440,1,2,4,10,78220,31404,6256,41200,0
277,5778,1943,715,1694,26,18,214,1969,12,185,120,237,197,357,1436,2721,7,20915,1161,0,2,4,4,78220,31406,6256,41201,0
277,5778,1168,838,957,57,25,144,1225,19,348,224,416,367,640,3018,5452,11,61921,3440,1,2,4,4,78230,31408,6256,41202,0
277,5778,1943,715,1694,26,18,214,1969,12,185,120,237,197,357,1436,2721,7,20915,1161,0,2,1,1,78230,31410,6256,41203,0
277,5778,1168,838,957,57,25,144,1225,19,348,224,416,367,640,3018,5452,11,61921,3440,1,2,1,1,78240,31412,6256,41204,0
104,5724,1943,715,1694,26,18,214,1969,12,185,120,237,197,357,1436,2721,7,20915,1161,0,2,11,3,78240,31414,6256,41205,0
231,5969,722,423,573,19,0,135,741,12,172,101,199,184,300,1320,2257,6,15668,870,0,2,3,2,78240,31416,6256,41207,0
231,5969,1508,847,911,44,250,301,1552,14,148,88,169,162,257,1120,1886,7,15077,837,0,2,3,2,78240,31417,6257,41208,0
273,5733,1943,715,1694,26,18,214,1969,12,185,120,237,197,357,1436,2721,7,20915,1161,0,2,1,4,78240,31419,6257,41209,0
273,5733,1168,838,957,57,25,144,1225,19,348,224,416,367,640,3018,5452,11,61921,3440,1,2,1,4,78250,31421,6257,41210,0
274,5764,1943,715,1694,26,18,214,1969,12,185,120,237,197,357,1436,2721,7,20915,1161,0,2,10,13,78250,31423,6257,41211,0
274,5764,1168,838,957,57,25,144,1225,19,348,224,416,367,640,3018,5452,11,61921,3440,1,2,10,13,78260,31425,6257,41212,0
183,5551,1660,832,1314,41,38,274,1701,20,312,209,395,332,604,2671,5058,12,64042,3557,1,2,7,7,78260,31427,6258,41214,0
183,5551,1057,646,719,113,100,145,1170,18,215,134,248,233,382,1740,3004,10,31186,1732,1,2,7,7,78270,31428,6259,41215,0
67,1750,466,257,367,18,25,50,484,7,126,86,171,133,257,898,1813,4,8612,478,0,2,6,0,78270,31428,6259,41216,0
67,1750,507,281,342,29,59,88,536,10,53,29,57,63,86,336,514,5,2764,153,0,2,6,0,78270,31428,6259,41217,0
273,5732,1943,715,1694,26,18,214,1969,12,185,120,237,197,357,1436,2721,7,20915,1161,0,2,4,10,78270,31430,6259,41218,0
273,5732,1168,838,957,57,25,144,1225,19,348,224,416,367,640,3018,5452,11,61921,3440,1,2,4,10,78280,31432,6259,41219,0
116,2173,477,336,357,30,23,73,507,16,194,134,250,210,384,1538,2962,10,30538,1696,0,2,38,18,78290,31433,6259,41221,0
78,1883,996,429,845,24,10,117,1020,7,76,50,88,83,138,494,879,4,3565,198,0,2,52,43,78290,31435,6259,41222,0
78,1883,456,277,329,12,42,72,468,13,85,50,97,98,147,592,972,7,7212,400,0,2,52,43,78290,31435,6259,41223,0
236,4937,2,2,2,0,0,0,2,0,0,0,0,0,0,0,0,0,0,0,0,2,0,1,78290,31435,6259,41223,0
236,4937,99,48,90,1,3,5,100,0,0,0,0,0,0,0,0,0,0,0,0,2,0,1,78290,31436,6259,41224,0
236,4937,8,5,5,2,0,1,10,0,0,0,0,0,0,0,0,0,0,0,0,2,0,1,78290,31436,6259,41225,0
236,4937,1217,716,841,84,126,174,1301,14,185,118,215,199,333,1446,2542,8,20687,1149,0,2,0,1,78300,31438,6259,41226,0
236,4937,160,89,115,0,13,31,160,7,15,11,17,22,28,78,124,3,495,27,0,2,0,1,78300,31438,6259,41227,0
236,4937,10,10,9,9,0,0,19,0,0,0,0,0,0,0,0,0,0,0,0,2,0,1,78300,31438,6260,41228,0
236,4937,173,84,99,8,29,36,181,5,12,7,13,17,20,54,81,2,221,12,0,2,0,1,78300,31439,6260,41229,0
236,4937,3,1,1,3,0,0,6,0,0,0,0,0,0,0,0,0,0,0,0,2,0,1,78300,31439,6260,41230,0
54,1488,339,213,244,17,9,65,356,10,42,26,48,52,74,259,421,5,2410,133,0,2,24,18,78310,31439,6260,41231,0
248,5739,4293,999,3693,19,54,507,4312,9,155,88,170,164,258,1156,1898,4,9368,520,0,2,3,1,78310,31441,6260,41233,0
248,5739,1482,859,1002,125,135,219,1607,16,219,134,251,235,385,1766,3032,9,27804,1544,1,2,3,1,78320,31442,6260,41234,0
28,981,74,35,59,1,0,14,75,3,14,7,14,17,21,58,85,1,128,7,0,2,2,1,78320,31443,6260,41235,0
28,981,245,125,200,5,7,34,250,7,30,17,34,37,51,166,265,3,1053,58,0,2,2,1,78330,31444,6260,41236,0
54,657,647,139,84,35,284,233,682,0,0,0,0,0,0,0,0,0,0,0,0,2,1,1,78330,31444,6260,41237,0
109,2961,1523,757,1297,19,12,193,1542,12,193,117,230,205,347,1508,2664,7,19053,1058,0,2,8,1,78340,31446,6260,41238,0
109,2961,701,378,504,33,58,109,734,13,110,68,126,123,194,794,1346,7,10027,557,0,2,8,1,78340,31447,6261,41239,0
69,1526,402,202,227,24,74,80,426,12,52,33,61,64,94,339,564,7,3969,220,0,2,11,5,78340,31448,6261,41240,0
55,1174,447,308,343,6,5,95,453,7,96,59,111,103,170,651,1136,4,4600,255,0,2,12,0,78340,31451,6261,41241,0
55,1174,322,174,179,16,74,51,338,10,41,26,46,51,72,252,408,5,2291,127,0,2,12,0,78340,31454,6262,41242,0
20,531,205,80,86,16,53,53,221,7,18,10,19,25,29,94,134,3,497,27,0,2,1,2,78350,31454,6263,41243,0
231,5969,722,423,573,19,0,135,741,12,172,101,199,184,300,1320,2257,6,15668,870,0,2,64,36,78350,31456,6263,41245,0
231,5969,1508,847,911,44,250,301,1552,14,148,88,169,162,257,1120,1886,7,15077,837,0,2,64,36,78350,31457,6264,41246,0
92,1890,757,253,292,73,244,162,830,13,61,38,67,74,105,409,651,7,4654,258,0,2,1,1,78350,31458,6264,41247,0
67,1750,466,257,367,18,25,50,484,7,126,86,171,133,257,898,1813,4,8612,478,0,2,8,1,78350,31458,6264,41248,0
67,1750,507,281,342,29,59,88,536,10,53,29,57,63,86,336,514,5,2764,153,0,2,8,1,78350,31458,6264,41249,0
41,821,1178,367,1042,6,15,115,1184,9,94,51,95,103,146,644,976,4,4439,246,0,2,0,173,78350,31458,6264,41250,0
41,821,177,108,140,8,0,27,185,6,30,16,32,36,48,162,248,3,794,44,0,2,0,173,78350,31460,6264,41251,0
283,5921,1943,715,1694,26,18,214,1969,12,185,120,237,197,357,1436,2721,7,20915,1161,0,2,190,36,78350,31462,6264,41252,0
283,5921,1168,838,957,57,25,144,1225,19,348,224,416,367,640,3018,5452,11,61921,3440,1,2,190,36,78360,31464,6264,41253,0
112,4516,1289,550,1043,56,32,155,1345,10,167,93,185,177,278,1266,2075,5,11498,638,0,2,1,1,78360,31466,6265,41254,0
153,7223,1392,870,1177,35,17,170,1427,14,494,280,531,508,811,4473,7289,7,54850,3047,2,2,1,1,78360,31469,6266,41255,0
95,2931,773,419,590,28,0,166,801,10,204,113,217,214,330,1598,2554,5,13587,754,0,2,1,1,78360,31469,6267,41256,0
7,107,127,75,83,2,11,30,129,4,14,7,14,18,21,61,87,2,175,9,0,0,26,0,78360,31469,6267,41257,0
7,107,652,304,544,16,6,88,668,6,89,51,101,95,152,591,998,3,3399,188,0,0,26,0,78360,31470,6267,41258,0
7,107,2,2,2,0,0,0,2,0,0,0,0,0,0,0,0,0,0,0,0,0,26,0,78360,31470,6267,41258,0
7,107,8,5,5,0,0,3,8,0,0,0,0,0,0,0,0,0,0,0,0,0,26,0,78360,31470,6267,41259,0
7,107,2,2,2,0,0,0,2,0,0,0,0,0,0,0,0,0,0,0,0,0,26,0,78360,31470,6267,41259,0
7,107,14,8,8,0,0,6,14,0,0,0,0,0,0,0,0,0,0,0,0,0,26,0,78360,31470,6267,41260,0
7,107,6,4,4,0,0,2,6,0,0,0,0,0,0,0,0,0,0,0,0,0,26,0,78360,31470,6267,41261,0
7,107,6,4,4,0,0,2,6,1,2,1,2,3,3,2,4,0,2,0,0,0,26,0,78360,31470,6267,41262,0
7,107,6,4,4,0,0,2,6,0,0,0,0,0,0,0,0,0,0,0,0,0,26,0,78360,31470,6267,41263,0
7,107,7,5,5,0,0,2,7,0,0,0,0,0,0,0,0,0,0,0,0,0,26,0,78360,31470,6267,41264,0
7,107,6,4,4,0,0,2,6,0,0,0,0,0,0,0,0,0,0,0,0,0,26,0,78360,31470,6267,41265,0
7,107,10,6,6,0,0,4,10,0,0,0,0,0,0,0,0,0,0,0,0,0,26,0,78360,31470,6267,41266,0
7,107,1,1,1,0,0,0,1,0,0,0,0,0,0,0,0,0,0,0,0,0,26,0,78360,31470,6267,41266,0
7,107,14,10,10,0,0,4,14,1,1,1,1,2,2,0,2,0,1,0,0,0,26,0,78360,31470,6267,41267,0
7,107,46,26,30,3,0,12,49,3,6,3,6,9,9,20,28,1,42,2,0,0,26,0,78370,31470,6267,41268,0
171,7599,4293,999,3693,19,54,507,4312,9,155,88,170,164,258,1156,1898,4,9368,520,0,2,1,3,78370,31472,6267,41269,0
171,7599,1482,859,1002,125,135,219,1607,16,219,134,251,235,385,1766,3032,9,27804,1544,1,2,1,3,78380,31473,6267,41270,0
128,5170,1450,624,1228,12,26,181,1462,14,306,186,354,320,540,2580,4493,8,36391,2021,1,2,44,0,78380,31475,6268,41271,0
47,3558,996,429,845,24,10,117,1020,7,76,50,88,83,138,494,879,4,3565,198,0,2,26,6,78380,31477,6268,41272,0
125,5397,1513,682,1277,25,13,200,1538,11,199,116,219,210,335,1557,2584,6,15641,868,0,2,3,3,78380,31479,6268,41273,0
103,5268,1457,730,1242,11,6,188,1468,10,292,166,329,302,495,2424,4078,5,22973,1276,1,2,4,4,78380,31481,6268,41274,0
43,2698,652,304,544,16,6,88,668,6,89,51,101,95,152,591,998,3,3399,188,0,2,15,14,78380,31482,6268,41275,0
101,4838,1523,757,1297,19,12,193,1542,12,193,117,230,205,347,1508,2664,7,19053,1058,0,2,19,1,78390,31484,6268,41276,0
70,3194,1020,354,843,12,15,144,1032,8,134,77,144,142,221,970,1580,4,6792,377,0,2,14,1,78390,31484,6268,41277,0
47,2189,447,308,343,6,5,95,453,7,96,59,111,103,170,651,1136,4,4600,255,0,2,7,0,78390,31487,6268,41278,0
74,3867,1293,570,1093,25,15,163,1318,10,195,123,241,205,364,1516,2795,6,17273,959,0,2,48,7,78400,31489,6268,41279,0
55,2800,722,423,573,19,0,135,741,12,172,101,199,184,300,1320,2257,6,15668,870,0,2,77,0,78400,31491,6268,41281,0
86,3411,1043,504,840,53,9,147,1096,9,180,112,198,189,310,1377,2344,4,11604,644,0,2,8,1,78400,31493,6268,41282,0
86,3482,1178,367,1042,6,15,115,1184,9,94,51,95,103,146,644,976,4,4439,246,0,2,0,35,78400,31493,6268,41283,0
104,5735,1943,715,1694,26,18,214,1969,12,185,120,237,197,357,1436,2721,7,20915,1161,0,2,57,5,78400,31495,6268,41284,0
80,3144,1178,367,1042,6,15,115,1184,9,94,51,95,103,146,644,976,4,4439,246,0,2,0,72,78400,31495,6268,41285,1
110,6063,1943,715,1694,26,18,214,1969,12,185,120,237,197,357,1436,2721,7,20915,1161,0,2,70,0,78400,31497,6268,41286,1
235,4924,2,2,2,0,0,0,2,0,0,0,0,0,0,0,0,0,0,0,0,2,1,1,78400,31497,6268,41286,1
235,4924,99,48,90,1,3,5,100,0,0,0,0,0,0,0,0,0,0,0,0,2,1,1,78400,31498,6268,41287,1
235,4924,8,5,5,2,0,1,10,0,0,0,0,0,0,0,0,0,0,0,0,2,1,1,78400,31498,6268,41288,1
235,4924,1217,716,841,84,126,174,1301,14,185,118,215,199,333,1446,2542,8,20687,1149,0,2,1,1,78410,31500,6268,41289,1
235,4924,160,89,115,0,13,31,160,7,15,11,17,22,28,78,124,3,495,27,0,2,1,1,78410,31500,6268,41290,1
235,4924,10,10,9,9,0,0,19,0,0,0,0,0,0,0,0,0,0,0,0,2,1,1,78410,31500,6269,41291,1
235,4924,173,84,99,8,29,36,181,5,12,7,13,17,20,54,81,2,221,12,0,2,1,1,78410,31501,6269,41292,1
235,4924,3,1,1,3,0,0,6,0,0,0,0,0,0,0,0,0,0,0,0,2,1,1,78410,31501,6269,41293,1
75,1629,53,23,39,0,0,13,53,2,8,4,8,10,12,26,39,1,39,2,0,2,4,4,78410,31501,6269,41294,1
75,1629,515,298,307,33,80,99,548,12,63,44,77,75,121,419,753,7,5527,307,0,2,4,4,78420,31501,6269,41295,1
313,6894,72,33,56,0,4,12,72,1,1,1,1,2,2,0,2,0,1,0,0,2,3,3,78420,31501,6269,41296,1
313,6894,1454,835,1044,76,110,219,1530,17,275,158,296,292,454,2297,3718,9,34017,1889,1,2,3,3,78430,31502,6269,41297,1
66,1717,466,257,367,18,25,50,484,7,126,86,171,133,257,898,1813,4,8612,478,0,2,1,1,78430,31502,6269,41298,1
66,1717,507,281,342,29,59,88,536,10,53,29,57,63,86,336,514,5,2764,153,0,2,1,1,78430,31502,6269,41299,1
101,5325,1457,730,1242,11,6,188,1468,10,292,166,329,302,495,2424,4078,5,22973,1276,1,2,9,2,78430,31504,6269,41300,1
183,5551,1660,832,1314,41,38,274,1701,20,312,209,395,332,604,2671,5058,12,64042,3557,1,2,7,7,78430,31506,6270,41302,0
183,5551,1057,646,719,113,100,145,1170,18,215,134,248,233,382,1740,3004,10,31186,1732,1,2,7,7,78440,31507,6271,41303,0
24,612,2,2,2,0,0,0,2,0,0,0,0,0,0,0,0,0,0,0,0,2,3,0,78440,31507,6271,41303,0
24,612,99,48,90,1,3,5,100,0,0,0,0,0,0,0,0,0,0,0,0,2,3,0,78440,31508,6271,41304,0
24,612,8,5,5,2,0,1,10,0,0,0,0,0,0,0,0,0,0,0,0,2,3,0,78440,31508,6271,41305,0
24,612,1217,716,841,84,126,174,1301,14,185,118,215,199,333,1446,2542,8,20687,1149,0,2,3,0,78450,31510,6271,41306,0
24,612,160,89,115,0,13,31,160,7,15,11,17,22,28,78,124,3,495,27,0,2,3,0,78450,31510,6271,41307,0
24,612,10,10,9,9,0,0,19,0,0,0,0,0,0,0,0,0,0,0,0,2,3,0,78450,31510,6272,41308,0
24,612,173,84,99,8,29,36,181,5,12,7,13,17,20,54,81,2,221,12,0,2,3,0,78450,31511,6272,41309,0
24,612,3,1,1,3,0,0,6,0,0,0,0,0,0,0,0,0,0,0,0,2,3,0,78450,31511,6272,41310,0
235,4924,2,2,2,0,0,0,2,0,0,0,0,0,0,0,0,0,0,0,0,2,1,1,78450,31511,6272,41310,0
235,4924,99,48,90,1,3,5,100,0,0,0,0,0,0,0,0,0,0,0,0,2,1,1,78450,31512,6272,41311,0
235,4924,8,5,5,2,0,1,10,0,0,0,0,0,0,0,0,0,0,0,0,2,1,1,78450,31512,6272,41312,0
235,4924,1217,716,841,84,126,174,1301,14,185,118,215,199,333,1446,2542,8,20687,1149,0,2,1,1,78460,31514,6272,41313,0
235,4924,160,89,115,0,13,31,160,7,15,11,17,22,28,78,124,3,495,27,0,2,1,1,78460,31514,6272,41314,0
235,4924,10,10,9,9,0,0,19,0,0,0,0,0,0,0,0,0,0,0,0,2,1,1,78460,31514,6273,41315,0
235,4924,173,84,99,8,29,36,181,5,12,7,13,17,20,54,81,2,221,12,0,2,1,1,78460,31515,6273,41316,0
235,4924,3,1,1,3,0,0,6,0,0,0,0,0,0,0,0,0,0,0,0,2,1,1,78460,31515,6273,41317,0
75,1629,53,23,39,0,0,13,53,2,8,4,8,10,12,26,39,1,39,2,0,2,4,4,78460,31515,6273,41318,0
75,1629,515,298,307,33,80,99,548,12,63,44,77,75,121,419,753,7,5527,307,0,2,4,4,78470,31515,6273,41319,0
313,6894,72,33,56,0,4,12,72,1,1,1,1,2,2,0,2,0,1,0,0,2,3,3,78470,31515,6273,41320,0
313,6894,1454,835,1044,76,110,219,1530,17,275,158,296,292,454,2297,3718,9,34017,1889,1,2,3,3,78480,31516,6273,41321,0
66,1717,466,257,367,18,25,50,484,7,126,86,171,133,257,898,1813,4,8612,478,0,2,1,1,78480,31516,6273,41322,0
66,1717,507,281,342,29,59,88,536,10,53,29,57,63,86,336,514,5,2764,153,0,2,1,1,78480,31516,6273,41323,0
101,5325,1457,730,1242,11,6,188,1468,10,292,166,329,302,495,2424,4078,5,22973,1276,1,2,9,2,78480,31518,6273,41324,0
159,3787,77,34,69,0,0,8,77,3,24,16,29,27,45,114,213,1,387,21,0,2,1,0,78480,31518,6273,41325,0
159,3787,712,438,573,51,9,84,763,14,102,71,128,116,199,733,1364,8,11988,666,0,2,1,0,78490,31519,6273,41326,0
112,4538,1289,550,1043,56,32,155,1345,10,167,93,185,177,278,1266,2075,5,11498,638,0,2,11,0,78490,31521,6274,41327,0
163,3497,1513,682,1277,25,13,200,1538,11,199,116,219,210,335,1557,2584,6,15641,868,0,2,33,4,78490,31523,6274,41328,0
163,3497,819,519,539,24,98,155,843,15,96,57,106,111,163,690,1107,8,9171,509,0,2,33,4,78500,31525,6274,41329,0
125,5397,1513,682,1277,25,13,200,1538,11,199,116,219,210,335,1557,2584,6,15641,868,0,2,4,5,78500,31527,6274,41330,0
7,123,127,75,83,2,11,30,129,4,14,7,14,18,21,61,87,2,175,9,0,2,11,1,78500,31527,6274,41331,0
7,123,652,304,544,16,6,88,668,6,89,51,101,95,152,591,998,3,3399,188,0,2,11,1,78500,31528,6274,41332,0
7,123,2,2,2,0,0,0,2,0,0,0,0,0,0,0,0,0,0,0,0,2,11,1,78500,31528,6274,41332,0
7,123,8,5,5,0,0,3,8,0,0,0,0,0,0,0,0,0,0,0,0,2,11,1,78500,31528,6274,41333,0
7,123,2,2,2,0,0,0,2,0,0,0,0,0,0,0,0,0,0,0,0,2,11,1,78500,31528,6274,41333,0
7,123,14,8,8,0,0,6,14,0,0,0,0,0,0,0,0,0,0,0,0,2,11,1,78500,31528,6274,41334,0
7,123,6,4,4,0,0,2,6,0,0,0,0,0,0,0,0,0,0,0,0,2,11,1,78500,31528,6274,41335,0
7,123,6,4,4,0,0,2,6,1,2,1,2,3,3,2,4,0,2,0,0,2,11,1,78500,31528,6274,41336,0
7,123,6,4,4,0,0,2,6,0,0,0,0,0,0,0,0,0,0,0,0,2,11,1,78500,31528,6274,41337,0
7,123,7,5,5,0,0,2,7,0,0,0,0,0,0,0,0,0,0,0,0,2,11,1,78500,31528,6274,41338,0
7,123,6,4,4,0,0,2,6,0,0,0,0,0,0,0,0,0,0,0,0,2,11,1,78500,31528,6274,41339,0
7,123,10,6,6,0,0,4,10,0,0,0,0,0,0,0,0,0,0,0,0,2,11,1,78500,31528,6274,41340,0
7,123,1,1,1,0,0,0,1,0,0,0,0,0,0,0,0,0,0,0,0,2,11,1,78500,31528,6274,41340,0
7,123,14,10,10,0,0,4,14,1,1,1,1,2,2,0,2,0,1,0,0,2,11,1,78500,31528,6274,41341,0
7,123,46,26,30,3,0,12,49,3,6,3,6,9,9,20,28,1,42,2,0,2,11,1,78510,31528,6274,41342,0
7,123,127,75,83,2,11,30,129,4,14,7,14,18,21,61,87,2,175,9,0,2,11,1,78510,31528,6274,41343,0
7,123,652,304,544,16,6,88,668,6,89,51,101,95,152,591,998,3,3399,188,0,2,11,1,78510,31529,6274,41344,0
7,123,2,2,2,0,0,0,2,0,0,0,0,0,0,0,0,0,0,0,0,2,11,1,78510,31529,6274,41344,0
7,123,8,5,5,0,0,3,8,0,0,0,0,0,0,0,0,0,0,0,0,2,11,1,78510,31529,6274,41345,0
7,123,2,2,2,0,0,0,2,0,0,0,0,0,0,0,0,0,0,0,0,2,11,1,78510,31529,6274,41345,0
7,123,14,8,8,0,0,6,14,0,0,0,0,0,0,0,0,0,0,0,0,2,11,1,78510,31529,6274,41346,0
7,123,6,4,4,0,0,2,6,0,0,0,0,0,0,0,0,0,0,0,0,2,11,1,78510,31529,6274,41347,0
7,123,6,4,4,0,0,2,6,1,2,1,2,3,3,2,4,0,2,0,0,2,11,1,78510,31529,6274,41348,0
7,123,6,4,4,0,0,2,6,0,0,0,0,0,0,0,0,0,0,0,0,2,11,1,78510,31529,6274,41349,0
7,123,7,5,5,0,0,2,7,0,0,0,0,0,0,0,0,0,0,0,0,2,11,1,78510,31529,6274,41350,0
7,123,6,4,4,0,0,2,6,0,0,0,0,0,0,0,0,0,0,0,0,2,11,1,78510,31529,6274,41351,0
7,123,10,6,6,0,0,4,10,0,0,0,0,0,0,0,0,0,0,0,0,2,11,1,78510,31529,6274,41352,0
7,123,1,1,1,0,0,0,1,0,0,0,0,0,0,0,0,0,0,0,0,2,11,1,78510,31529,6274,41352,0
7,123,14,10,10,0,0,4,14,1,1,1,1,2,2,0,2,0,1,0,0,2,11,1,78510,31529,6274,41353,0
7,123,46,26,30,3,0,12,49,3,6,3,6,9,9,20,28,1,42,2,0,2,11,1,78520,31529,6274,41354,0
159,3787,77,34,69,0,0,8,77,3,24,16,29,27,45,114,213,1,387,21,0,2,1,0,78520,31529,6274,41355,0
159,3787,712,438,573,51,9,84,763,14,102,71,128,116,199,733,1364,8,11988,666,0,2,1,0,78530,31530,6274,41356,0
112,4538,1289,550,1043,56,32,155,1345,10,167,93,185,177,278,1266,2075,5,11498,638,0,2,11,0,78530,31532,6275,41357,0
163,3497,1513,682,1277,25,13,200,1538,11,199,116,219,210,335,1557,2584,6,15641,868,0,2,33,4,78530,31534,6275,41358,0
163,3497,819,519,539,24,98,155,843,15,96,57,106,111,163,690,1107,8,9171,509,0,2,33,4,78540,31536,6275,41359,0
125,5397,1513,682,1277,25,13,200,1538,11,199,116,219,210,335,1557,2584,6,15641,868,0,2,4,5,78540,31538,6275,41360,0
229,4964,182,127,129,0,0,53,182,5,39,21,42,44,63,217,343,2,926,51,0,2,4,7,78540,31538,6276,41361,1
229,4964,1165,710,800,67,119,181,1232,18,243,153,282,261,435,2000,3492,10,36473,2026,1,2,4,7,78550,31538,6277,41362,1
14,411,149,95,105,2,0,41,151,8,54,28,55,62,83,334,494,4,2013,111,0,2,33,23,78550,31538,6277,41363,1
14,411,82,56,54,0,13,15,82,4,13,8,16,17,24,56,98,2,241,13,0,2,33,23,78560,31538,6277,41364,1
158,7390,1392,870,1177,35,17,170,1427,14,494,280,531,508,811,4473,7289,7,54850,3047,2,2,29,0,78560,31541,6278,41365,1
30,1440,373,158,315,8,0,51,381,5,76,44,79,81,123,486,779,2,2026,112,0,2,24,0,78560,31541,6278,41366,1
229,4964,182,127,129,0,0,53,182,5,39,21,42,44,63,217,343,2,926,51,0,2,4,7,78560,31541,6279,41367,0
229,4964,1165,710,800,67,119,181,1232,18,243,153,282,261,435,2000,3492,10,36473,2026,1,2,4,7,78570,31541,6280,41368,0
14,411,149,95,105,2,0,41,151,8,54,28,55,62,83,334,494,4,2013,111,0,2,33,23,78570,31541,6280,41369,0
14,411,82,56,54,0,13,15,82,4,13,8,16,17,24,56,98,2,241,13,0,2,33,23,78580,31541,6280,41370,0
158,7390,1392,870,1177,35,17,170,1427,14,494,280,531,508,811,4473,7289,7,54850,3047,2,2,29,0,78580,31544,6281,41371,0
30,1440,373,158,315,8,0,51,381,5,76,44,79,81,123,486,779,2,2026,112,0,2,24,0,78580,31544,6281,41372,0
159,3778,77,34,69,0,0,8,77,3,24,16,29,27,45,114,213,1,387,21,0,2,1,1,78580,31544,6281,41373,0
159,3778,712,438,573,51,9,84,763,14,102,71,128,116,199,733,1364,8,11988,666,0,2,1,1,78590,31545,6281,41374,0
273,5728,1943,715,1694,26,18,214,1969,12,185,120,237,197,357,1436,2721,7,20915,1161,0,2,1,1,78590,31547,6281,41375,0
273,5728,1168,838,957,57,25,144,1225,19,348,224,416,367,640,3018,5452,11,61921,3440,1,2,1,1,78600,31549,6281,41376,0
229,4964,182,127,129,0,0,53,182,5,39,21,42,44,63,217,343,2,926,51,0,2,4,7,78600,31549,6282,41377,0
229,4964,1165,710,800,67,119,181,1232,18,243,153,282,261,435,2000,3492,10,36473,2026,1,2,4,7,78610,31549,6283,41378,0
14,411,149,95,105,2,0,41,151,8,54,28,55,62,83,334,494,4,2013,111,0,2,33,23,78610,31549,6283,41379,0
14,411,82,56,54,0,13,15,82,4,13,8,16,17,24,56,98,2,241,13,0,2,33,23,78620,31549,6283,41380,0
236,4942,2,2,2,0,0,0,2,0,0,0,0,0,0,0,0,0,0,0,0,2,1,1,78620,31549,6283,41380,0
236,4942,99,48,90,1,3,5,100,0,0,0,0,0,0,0,0,0,0,0,0,2,1,1,78620,31550,6283,41381,0
236,4942,8,5,5,2,0,1,10,0,0,0,0,0,0,0,0,0,0,0,0,2,1,1,78620,31550,6283,41382,0
236,4942,1217,716,841,84,126,174,1301,14,185,118,215,199,333,1446,2542,8,20687,1149,0,2,1,1,78630,31552,6283,41383,0
236,4942,160,89,115,0,13,31,160,7,15,11,17,22,28,78,124,3,495,27,0,2,1,1,78630,31552,6283,41384,0
236,4942,10,10,9,9,0,0,19,0,0,0,0,0,0,0,0,0,0,0,0,2,1,1,78630,31552,6284,41385,0
236,4942,173,84,99,8,29,36,181,5,12,7,13,17,20,54,81,2,221,12,0,2,1,1,78630,31553,6284,41386,0
236,4942,3,1,1,3,0,0,6,0,0,0,0,0,0,0,0,0,0,0,0,2,1,1,78630,31553,6284,41387,0
75,1629,53,23,39,0,0,13,53,2,8,4,8,10,12,26,39,1,39,2,0,2,4,4,78630,31553,6284,41388,0
75,1629,515,298,307,33,80,99,548,12,63,44,77,75,121,419,753,7,5527,307,0,2,4,4,78640,31553,6284,41389,0
313,6894,72,33,56,0,4,12,72,1,1,1,1,2,2,0,2,0,1,0,0,2,3,3,78640,31553,6284,41390,0
313,6894,1454,835,1044,76,110,219,1530,17,275,158,296,292,454,2297,3718,9,34017,1889,1,2,3,3,78650,31554,6284,41391,0
67,1753,466,257,367,18,25,50,484,7,126,86,171,133,257,898,1813,4,8612,478,0,2,1,1,78650,31554,6284,41392,0
67,1753,507,281,342,29,59,88,536,10,53,29,57,63,86,336,514,5,2764,153,0,2,1,1,78650,31554,6284,41393,0
158,7390,1392,870,1177,35,17,170,1427,14,494,280,531,508,811,4473,7289,7,54850,3047,2,2,29,0,78650,31557,6285,41394,0
103,5324,1457,730,1242,11,6,188,1468,10,292,166,329,302,495,2424,4078,5,22973,1276,1,2,9,2,78650,31559,6285,41395,0
30,1440,373,158,315,8,0,51,381,5,76,44,79,81,123,486,779,2,2026,112,0,2,24,0,78650,31559,6285,41396,0
229,4964,182,127,129,0,0,53,182,5,39,21,42,44,63,217,343,2,926,51,0,2,4,7,78650,31559,6286,41397,0
229,4964,1165,710,800,67,119,181,1232,18,243,153,282,261,435,2000,3492,10,36473,2026,1,2,4,7,78660,31559,6287,41398,0
14,411,149,95,105,2,0,41,151,8,54,28,55,62,83,334,494,4,2013,111,0,2,33,23,78660,31559,6287,41399,0
14,411,82,56,54,0,13,15,82,4,13,8,16,17,24,56,98,2,241,13,0,2,33,23,78670,31559,6287,41400,0
236,4942,2,2,2,0,0,0,2,0,0,0,0,0,0,0,0,0,0,0,0,2,1,1,78670,31559,6287,41400,0
236,4942,99,48,90,1,3,5,100,0,0,0,0,0,0,0,0,0,0,0,0,2,1,1,78670,31560,6287,41401,0
236,4942,8,5,5,2,0,1,10,0,0,0,0,0,0,0,0,0,0,0,0,2,1,1,78670,31560,6287,41402,0
236,4942,1217,716,841,84,126,174,1301,14,185,118,215,199,333,1446,2542,8,20687,1149,0,2,1,1,78680,31562,6287,41403,0
236,4942,160,89,115,0,13,31,160,7,15,11,17,22,28,78,124,3,495,27,0,2,1,1,78680,31562,6287,41404,0
236,4942,10,10,9,9,0,0,19,0,0,0,0,0,0,0,0,0,0,0,0,2,1,1,78680,31562,6288,41405,0
236,4942,173,84,99,8,29,36,181,5,12,7,13,17,20,54,81,2,221,12,0,2,1,1,78680,31563,6288,41406,0
236,4942,3,1,1,3,0,0,6,0,0,0,0,0,0,0,0,0,0,0,0,2,1,1,78680,31563,6288,41407,0
75,1629,53,23,39,0,0,13,53,2,8,4,8,10,12,26,39,1,39,2,0,2,4,4,78680,31563,6288,41408,0
75,1629,515,298,307,33,80,99,548,12,63,44,77,75,121,419,753,7,5527,307,0,2,4,4,78690,31563,6288,41409,0
313,6894,72,33,56,0,4,12,72,1,1,1,1,2,2,0,2,0,1,0,0,2,3,3,78690,31563,6288,41410,0
313,6894,1454,835,1044,76,110,219,1530,17,275,158,296,292,454,2297,3718,9,34017,1889,1,2,3,3,78700,31564,6288,41411,0
67,1753,466,257,367,18,25,50,484,7,126,86,171,133,257,898,1813,4,8612,478,0,2,1,1,78700,31564,6288,41412,0
67,1753,507,281,342,29,59,88,536,10,53,29,57,63,86,336,514,5,2764,153,0,2,1,1,78700,31564,6288,41413,0
158,7390,1392,870,1177,35,17,170,1427,14,494,280,531,508,811,4473,7289,7,54850,3047,2,2,29,0,78700,31567,6289,41414,0
103,5324,1457,730,1242,11,6,188,1468,10,292,166,329,302,495,2424,4078,5,22973,1276,1,2,9,2,78700,31569,6289,41415,0
30,1440,373,158,315,8,0,51,381,5,76,44,79,81,123,486,779,2,2026,112,0,2,24,0,78700,31569,6289,41416,0
52,1451,339,213,244,17,9,65,356,10,42,26,48,52,74,259,421,5,2410,133,0,2,0,10,78710,31569,6289,41417,0
73,3817,1293,570,1093,25,15,163,1318,10,195,123,241,205,364,1516,2795,6,17273,959,0,2,0,14,78720,31571,6289,41418,0
52,1451,339,213,244,17,9,65,356,10,42,26,48,52,74,259,421,5,2410,133,0,2,0,10,78730,31571,6289,41419,0
73,3817,1293,570,1093,25,15,163,1318,10,195,123,241,205,364,1516,2795,6,17273,959,0,2,0,14,78740,31573,6289,41420,0
236,4942,2,2,2,0,0,0,2,0,0,0,0,0,0,0,0,0,0,0,0,2,1,1,78740,31573,6289,41420,0
236,4942,99,48,90,1,3,5,100,0,0,0,0,0,0,0,0,0,0,0,0,2,1,1,78740,31574,6289,41421,0
236,4942,8,5,5,2,0,1,10,0,0,0,0,0,0,0,0,0,0,0,0,2,1,1,78740,31574,6289,41422,0
236,4942,1217,716,841,84,126,174,1301,14,185,118,215,199,333,1446,2542,8,20687,1149,0,2,1,1,78750,31576,6289,41423,0
236,4942,160,89,115,0,13,31,160,7,15,11,17,22,28,78,124,3,495,27,0,2,1,1,78750,31576,6289,41424,0
236,4942,10,10,9,9,0,0,19,0,0,0,0,0,0,0,0,0,0,0,0,2,1,1,78750,31576,6290,41425,0
236,4942,173,84,99,8,29,36,181,5,12,7,13,17,20,54,81,2,221,12,0,2,1,1,78750,31577,6290,41426,0
236,4942,3,1,1,3,0,0,6,0,0,0,0,0,0,0,0,0,0,0,0,2,1,1,78750,31577,6290,41427,0
103,5336,1457,730,1242,11,6,188,1468,10,292,166,329,302,495,2424,4078,5,22973,1276,1,2,6,4,78750,31579,6290,41428,0
236,4942,2,2,2,0,0,0,2,0,0,0,0,0,0,0,0,0,0,0,0,2,1,1,78750,31579,6290,41428,0
236,4942,99,48,90,1,3,5,100,0,0,0,0,0,0,0,0,0,0,0,0,2,1,1,78750,31580,6290,41429,0
236,4942,8,5,5,2,0,1,10,0,0,0,0,0,0,0,0,0,0,0,0,2,1,1,78750,31580,6290,41430,0
236,4942,1217,716,841,84,126,174,1301,14,185,118,215,199,333,1446,2542,8,20687,1149,0,2,1,1,78760,31582,6290,41431,0
236,4942,160,89,115,0,13,31,160,7,15,11,17,22,28,78,124,3,495,27,0,2,1,1,78760,31582,6290,41432,0
236,4942,10,10,9,9,0,0,19,0,0,0,0,0,0,0,0,0,0,0,0,2,1,1,78760,31582,6291,41433,0
236,4942,173,84,99,8,29,36,181,5,12,7,13,17,20,54,81,2,221,12,0,2,1,1,78760,31583,6291,41434,0
236,4942,3,1,1,3,0,0,6,0,0,0,0,0,0,0,0,0,0,0,0,2,1,1,78760,31583,6291,41435,0
103,5336,1457,730,1242,11,6,188,1468,10,292,166,329,302,495,2424,4078,5,22973,1276,1,2,6,4,78760,31585,6291,41436,0
69,1526,402,202,227,24,74,80,426,12,52,33,61,64,94,339,564,7,3969,220,0,2,2,2,78760,31586,6291,41437,0
2,121,37,13,25,0,6,6,37,1,2,1,2,3,3,2,4,0,2,0,0,2,1,1,78760,31586,6291,41438,0
2,121,133,47,40,1,43,49,134,0,0,0,0,0,0,0,0,0,0,0,0,2,1,1,78760,31586,6291,41439,0
183,5551,1660,832,1314,41,38,274,1701,20,312,209,395,332,604,2671,5058,12,64042,3557,1,2,10,6,78760,31588,6292,41441,0
183,5551,1057,646,719,113,100,145,1170,18,215,134,248,233,382,1740,3004,10,31186,1732,1,2,10,6,78770,31589,6293,41442,0
78,1883,996,429,845,24,10,117,1020,7,76,50,88,83,138,494,879,4,3565,198,0,2,2,2,78770,31591,6293,41443,0
78,1883,456,277,329,12,42,72,468,13,85,50,97,98,147,592,972,7,7212,400,0,2,2,2,78770,31591,6293,41444,0
236,4942,2,2,2,0,0,0,2,0,0,0,0,0,0,0,0,0,0,0,0,2,4,4,78770,31591,6293,41444,0
236,4942,99,48,90,1,3,5,100,0,0,0,0,0,0,0,0,0,0,0,0,2,4,4,78770,31592,6293,41445,0
236,4942,8,5,5,2,0,1,10,0,0,0,0,0,0,0,0,0,0,0,0,2,4,4,78770,31592,6293,41446,0
236,4942,1217,716,841,84,126,174,1301,14,185,118,215,199,333,1446,2542,8,20687,1149,0,2,4,4,78780,31594,6293,41447,0
236,4942,160,89,115,0,13,31,160,7,15,11,17,22,28,78,124,3,495,27,0,2,4,4,78780,31594,6293,41448,0
236,4942,10,10,9,9,0,0,19,0,0,0,0,0,0,0,0,0,0,0,0,2,4,4,78780,31594,6294,41449,0
236,4942,173,84,99,8,29,36,181,5,12,7,13,17,20,54,81,2,221,12,0,2,4,4,78780,31595,6294,41450,0
236,4942,3,1,1,3,0,0,6,0,0,0,0,0,0,0,0,0,0,0,0,2,4,4,78780,31595,6294,41451,0
109,2963,1523,757,1297,19,12,193,1542,12,193,117,230,205,347,1508,2664,7,19053,1058,0,2,4,2,78790,31597,6294,41452,0
109,2963,701,378,504,33,58,109,734,13,110,68,126,123,194,794,1346,7,10027,557,0,2,4,2,78790,31598,6295,41453,0
313,6900,72,33,56,0,4,12,72,1,1,1,1,2,2,0,2,0,1,0,0,2,7,6,78790,31598,6295,41454,0
313,6900,1454,835,1044,76,110,219,1530,17,275,158,296,292,454,2297,3718,9,34017,1889,1,2,7,6,78800,31599,6295,41455,0
2,156,37,13,25,0,6,6,37,1,2,1,2,3,3,2,4,0,2,0,0,2,51,9,78800,31599,6295,41456,0
2,156,133,47,40,1,43,49,134,0,0,0,0,0,0,0,0,0,0,0,0,2,51,9,78800,31599,6295,41457,0
53,1862,601,196,481,2,23,85,603,8,63,36,72,71,108,400,664,4,3036,168,0,2,1,1,78800,31599,6295,41458,0
89,2050,996,429,845,24,10,117,1020,7,76,50,88,83,138,494,879,4,3565,198,0,2,39,2,78800,31601,6295,41460,1
89,2050,456,277,329,12,42,72,468,13,85,50,97,98,147,592,972,7,7212,400,0,2,39,2,78800,31601,6295,41461,1
48,3659,996,429,845,24,10,117,1020,7,76,50,88,83,138,494,879,4,3565,198,0,2,56,4,78800,31603,6295,41462,1
89,2050,996,429,845,24,10,117,1020,7,76,50,88,83,138,494,879,4,3565,198,0,2,39,2,78800,31605,6295,41463,0
89,2050,456,277,329,12,42,72,468,13,85,50,97,98,147,592,972,7,7212,400,0,2,39,2,78800,31605,6295,41464,0
48,3659,996,429,845,24,10,117,1020,7,76,50,88,83,138,494,879,4,3565,198,0,2,56,4,78800,31607,6295,41465,0
275,5732,1943,715,1694,26,18,214,1969,12,185,120,237,197,357,1436,2721,7,20915,1161,0,2,2,4,78800,31609,6295,41466,0
275,5732,1168,838,957,57,25,144,1225,19,348,224,416,367,640,3018,5452,11,61921,3440,1,2,2,4,78810,31611,6295,41467,0
105,5773,1943,715,1694,26,18,214,1969,12,185,120,237,197,357,1436,2721,7,20915,1161,0,2,31,0,78810,31613,6295,41468,0
52,1451,339,213,244,17,9,65,356,10,42,26,48,52,74,259,421,5,2410,133,0,2,6,6,78820,31613,6295,41470,0
272,5717,1943,715,1694,26,18,214,1969,12,185,120,237,197,357,1436,2721,7,20915,1161,0,2,2,4,78820,31615,6295,41471,0
272,5717,1168,838,957,57,25,144,1225,19,348,224,416,367,640,3018,5452,11,61921,3440,1,2,2,4,78830,31617,6295,41472,0
105,5775,1943,715,1694,26,18,214,1969,12,185,120,237,197,357,1436,2721,7,20915,1161,0,2,31,0,78830,31619,6295,41473,0
183,5551,1660,832,1314,41,38,274,1701,20,312,209,395,332,604,2671,5058,12,64042,3557,1,2,10,6,78830,31621,6296,41475,0
183,5551,1057,646,719,113,100,145,1170,18,215,134,248,233,382,1740,3004,10,31186,1732,1,2,10,6,78840,31622,6297,41476,0
89,2050,996,429,845,24,10,117,1020,7,76,50,88,83,138,494,879,4,3565,198,0,2,2,2,78840,31624,6297,41477,0
89,2050,456,277,329,12,42,72,468,13,85,50,97,98,147,592,972,7,7212,400,0,2,2,2,78840,31624,6297,41478,0
236,4942,2,2,2,0,0,0,2,0,0,0,0,0,0,0,0,0,0,0,0,2,4,4,78840,31624,6297,41478,0
236,4942,99,48,90,1,3,5,100,0,0,0,0,0,0,0,0,0,0,0,0,2,4,4,78840,31625,6297,41479,0
236,4942,8,5,5,2,0,1,10,0,0,0,0,0,0,0,0,0,0,0,0,2,4,4,78840,31625,6297,41480,0
236,4942,1217,716,841,84,126,174,1301,14,185,118,215,199,333,1446,2542,8,20687,1149,0,2,4,4,78850,31627,6297,41481,0
236,4942,160,89,115,0,13,31,160,7,15,11,17,22,28,78,124,3,495,27,0,2,4,4,78850,31627,6297,41482,0
236,4942,10,10,9,9,0,0,19,0,0,0,0,0,0,0,0,0,0,0,0,2,4,4,78850,31627,6298,41483,0
236,4942,173,84,99,8,29,36,181,5,12,7,13,17,20,54,81,2,221,12,0,2,4,4,78850,31628,6298,41484,0
236,4942,3,1,1,3,0,0,6,0,0,0,0,0,0,0,0,0,0,0,0,2,4,4,78850,31628,6298,41485,0
109,2963,1523,757,1297,19,12,193,1542,12,193,117,230,205,347,1508,2664,7,19053,1058,0,2,4,2,78860,31630,6298,41486,0
109,2963,701,378,504,33,58,109,734,13,110,68,126,123,194,794,1346,7,10027,557,0,2,4,2,78860,31631,6299,41487,0
69,1526,402,202,227,24,74,80,426,12,52,33,61,64,94,339,564,7,3969,220,0,2,2,2,78860,31632,6299,41488,0
313,6900,72,33,56,0,4,12,72,1,1,1,1,2,2,0,2,0,1,0,0,2,7,6,78860,31632,6299,41489,0
313,6900,1454,835,1044,76,110,219,1530,17,275,158,296,292,454,2297,3718,9,34017,1889,1,2,7,6,78870,31633,6299,41490,0
2,156,37,13,25,0,6,6,37,1,2,1,2,3,3,2,4,0,2,0,0,2,51,9,78870,31633,6299,41491,0
2,156,133,47,40,1,43,49,134,0,0,0,0,0,0,0,0,0,0,0,0,2,51,9,78870,31633,6299,41492,0
53,1862,601,196,481,2,23,85,603,8,63,36,72,71,108,400,664,4,3036,168,0,2,1,1,78870,31633,6299,41493,0
52,1451,339,213,244,17,9,65,356,10,42,26,48,52,74,259,421,5,2410,133,0,2,6,6,78880,31633,6299,41494,0
159,3783,77,34,69,0,0,8,77,3,24,16,29,27,45,114,213,1,387,21,0,2,1,1,78880,31633,6299,41495,0
159,3783,712,438,573,51,9,84,763,14,102,71,128,116,199,733,1364,8,11988,666,0,2,1,1,78890,31634,6299,41496,0
272,5713,1943,715,1694,26,18,214,1969,12,185,120,237,197,357,1436,2721,7,20915,1161,0,2,1,1,78890,31636,6299,41497,0
272,5713,1168,838,957,57,25,144,1225,19,348,224,416,367,640,3018,5452,11,61921,3440,1,2,1,1,78900,31638,6299,41498,0
72,1466,1178,367,1042,6,15,115,1184,9,94,51,95,103,146,644,976,4,4439,246,0,2,1,1,78900,31638,6299,41499,0
72,1466,177,108,140,8,0,27,185,6,30,16,32,36,48,162,248,3,794,44,0,2,1,1,78900,31640,6299,41500,0
72,1466,1178,367,1042,6,15,115,1184,9,94,51,95,103,146,644,976,4,4439,246,0,2,1,1,78900,31640,6299,41501,0
72,1466,177,108,140,8,0,27,185,6,30,16,32,36,48,162,248,3,794,44,0,2,1,1,78900,31642,6299,41502,0
54,657,647,139,84,35,284,233,682,0,0,0,0,0,0,0,0,0,0,0,0,2,7,4,78900,31642,6299,41503,0
54,657,647,139,84,35,284,233,682,0,0,0,0,0,0,0,0,0,0,0,0,2,7,4,78900,31642,6299,41504,0
272,5721,1943,715,1694,26,18,214,1969,12,185,120,237,197,357,1436,2721,7,20915,1161,0,2,1,1,78900,31644,6299,41505,0
272,5721,1168,838,957,57,25,144,1225,19,348,224,416,367,640,3018,5452,11,61921,3440,1,2,1,1,78910,31646,6299,41506,0
54,657,647,139,84,35,284,233,682,0,0,0,0,0,0,0,0,0,0,0,0,2,7,4,78910,31646,6299,41508,0
41,821,1178,367,1042,6,15,115,1184,9,94,51,95,103,146,644,976,4,4439,246,0,2,1,1,78910,31646,6299,41509,0
41,821,177,108,140,8,0,27,185,6,30,16,32,36,48,162,248,3,794,44,0,2,1,1,78910,31648,6299,41510,0
54,657,647,139,84,35,284,233,682,0,0,0,0,0,0,0,0,0,0,0,0,2,7,4,78910,31648,6299,41512,0
41,821,1178,367,1042,6,15,115,1184,9,94,51,95,103,146,644,976,4,4439,246,0,2,1,1,78910,31648,6299,41513,0
41,821,177,108,140,8,0,27,185,6,30,16,32,36,48,162,248,3,794,44,0,2,1,1,78910,31650,6299,41514,0
110,3013,1523,757,1297,19,12,193,1542,12,193,117,230,205,347,1508,2664,7,19053,1058,0,2,21,10,78920,31652,6299,41515,0
110,3013,701,378,504,33,58,109,734,13,110,68,126,123,194,794,1346,7,10027,557,0,2,21,10,78920,31653,6300,41516,0
103,4933,1523,757,1297,19,12,193,1542,12,193,117,230,205,347,1508,2664,7,19053,1058,0,2,36,14,78930,31655,6300,41517,0
110,6063,1943,715,1694,26,18,214,1969,12,185,120,237,197,357,1436,2721,7,20915,1161,0,2,1,0,78930,31657,6300,41518,0
283,5921,1943,715,1694,26,18,214,1969,12,185,120,237,197,357,1436,2721,7,20915,1161,0,2,1,0,78930,31659,6300,41519,0
283,5921,1168,838,957,57,25,144,1225,19,348,224,416,367,640,3018,5452,11,61921,3440,1,2,1,0,78940,31661,6300,41520,0
110,6071,1943,715,1694,26,18,214,1969,12,185,120,237,197,357,1436,2721,7,20915,1161,0,2,3,3,78940,31663,6300,41521,0
110,3013,1523,757,1297,19,12,193,1542,12,193,117,230,205,347,1508,2664,7,19053,1058,0,2,21,10,78950,31665,6300,41522,0
110,3013,701,378,504,33,58,109,734,13,110,68,126,123,194,794,1346,7,10027,557,0,2,21,10,78950,31666,6301,41523,0
103,4933,1523,757,1297,19,12,193,1542,12,193,117,230,205,347,1508,2664,7,19053,1058,0,2,36,14,78960,31668,6301,41524,0
92,1890,757,253,292,73,244,162,830,13,61,38,67,74,105,409,651,7,4654,258,0,2,2,1,78960,31669,6301,41525,0
92,1890,757,253,292,73,244,162,830,13,61,38,67,74,105,409,651,7,4654,258,0,2,2,1,78960,31670,6301,41526,0
92,1890,757,253,292,73,244,162,830,13,61,38,67,74,105,409,651,7,4654,258,0,2,7,1,78960,31671,6301,41527,0
92,1890,757,253,292,73,244,162,830,13,61,38,67,74,105,409,651,7,4654,258,0,2,1,1,78960,31672,6301,41528,0
92,1890,757,253,292,73,244,162,830,13,61,38,67,74,105,409,651,7,4654,258,0,2,5,5,78960,31673,6301,41529,0
92,1890,757,253,292,73,244,162,830,13,61,38,67,74,105,409,651,7,4654,258,0,2,7,1,78960,31674,6301,41530,0
60,1163,282,196,195,3,0,86,285,8,130,71,141,138,212,936,1507,4,6538,363,0,2,1,3,78960,31674,6302,41531,0
229,4960,182,127,129,0,0,53,182,5,39,21,42,44,63,217,343,2,926,51,0,2,1,2,78960,31674,6303,41532,0
229,4960,1165,710,800,67,119,181,1232,18,243,153,282,261,435,2000,3492,10,36473,2026,1,2,1,2,78970,31674,6304,41533,0
183,5551,1660,832,1314,41,38,274,1701,20,312,209,395,332,604,2671,5058,12,64042,3557,1,2,1,1,78970,31676,6305,41535,0
183,5551,1057,646,719,113,100,145,1170,18,215,134,248,233,382,1740,3004,10,31186,1732,1,2,1,1,78980,31677,6306,41536,0
92,1886,757,253,292,73,244,162,830,13,61,38,67,74,105,409,651,7,4654,258,0,2,1,2,78980,31678,6306,41537,0
45,953,386,256,301,16,9,68,402,4,59,35,69,63,104,355,621,2,1453,80,0,2,1,1,78980,31678,6306,41538,0
45,953,264,131,164,11,41,46,275,6,38,22,40,44,62,214,338,3,1068,59,0,2,1,1,78990,31678,6307,41539,0
95,2927,773,419,590,28,0,166,801,10,204,113,217,214,330,1598,2554,5,13587,754,0,2,2,2,78990,31678,6308,41540,0
176,5284,1660,832,1314,41,38,274,1701,20,312,209,395,332,604,2671,5058,12,64042,3557,1,2,1,1,78990,31680,6309,41542,0
176,5309,1660,832,1314,41,38,274,1701,20,312,209,395,332,604,2671,5058,12,64042,3557,1,2,3,0,78990,31682,6310,41544,0
60,1163,282,196,195,3,0,86,285,8,130,71,141,138,212,936,1507,4,6538,363,0,2,1,3,78990,31682,6311,41545,0
229,4960,182,127,129,0,0,53,182,5,39,21,42,44,63,217,343,2,926,51,0,2,1,2,78990,31682,6312,41546,0
229,4960,1165,710,800,67,119,181,1232,18,243,153,282,261,435,2000,3492,10,36473,2026,1,2,1,2,79000,31682,6313,41547,0
183,5551,1660,832,1314,41,38,274,1701,20,312,209,395,332,604,2671,5058,12,64042,3557,1,2,1,1,79000,31684,6314,41549,0
183,5551,1057,646,719,113,100,145,1170,18,215,134,248,233,382,1740,3004,10,31186,1732,1,2,1,1,79010,31685,6315,41550,0
92,1886,757,253,292,73,244,162,830,13,61,38,67,74,105,409,651,7,4654,258,0,2,1,2,79010,31686,6315,41551,0
45,953,386,256,301,16,9,68,402,4,59,35,69,63,104,355,621,2,1453,80,0,2,1,1,79010,31686,6315,41552,0
45,953,264,131,164,11,41,46,275,6,38,22,40,44,62,214,338,3,1068,59,0,2,1,1,79020,31686,6316,41553,0
95,2927,773,419,590,28,0,166,801,10,204,113,217,214,330,1598,2554,5,13587,754,0,2,2,2,79020,31686,6317,41554,0
176,5307,1660,832,1314,41,38,274,1701,20,312,209,395,332,604,2671,5058,12,64042,3557,1,2,1,1,79020,31688,6318,41556,0
314,6930,72,33,56,0,4,12,72,1,1,1,1,2,2,0,2,0,1,0,0,2,6,4,79020,31688,6318,41557,0
314,6930,1454,835,1044,76,110,219,1530,17,275,158,296,292,454,2297,3718,9,34017,1889,1,2,6,4,79030,31689,6318,41558,0
171,7609,4293,999,3693,19,54,507,4312,9,155,88,170,164,258,1156,1898,4,9368,520,0,2,16,2,79030,31691,6318,41559,0
171,7609,1482,859,1002,125,135,219,1607,16,219,134,251,235,385,1766,3032,9,27804,1544,1,2,16,2,79040,31692,6318,41560,0
282,5913,1943,715,1694,26,18,214,1969,12,185,120,237,197,357,1436,2721,7,20915,1161,0,2,1,2,79040,31694,6318,41561,0
282,5913,1168,838,957,57,25,144,1225,19,348,224,416,367,640,3018,5452,11,61921,3440,1,2,1,2,79050,31696,6318,41562,0
314,6930,72,33,56,0,4,12,72,1,1,1,1,2,2,0,2,0,1,0,0,2,6,4,79050,31696,6318,41563,0
314,6930,1454,835,1044,76,110,219,1530,17,275,158,296,292,454,2297,3718,9,34017,1889,1,2,6,4,79060,31697,6318,41564,0
171,7609,4293,999,3693,19,54,507,4312,9,155,88,170,164,258,1156,1898,4,9368,520,0,2,16,2,79060,31699,6318,41565,0
171,7609,1482,859,1002,125,135,219,1607,16,219,134,251,235,385,1766,3032,9,27804,1544,1,2,16,2,79070,31700,6318,41566,0
1,94,42,7,35,4,0,5,46,1,2,1,2,3,3,2,4,0,2,0,0,2,1,1,79070,31700,6318,41567,0
1,94,11,6,10,0,0,1,11,2,4,2,4,6,6,10,15,1,15,0,0,2,1,1,79070,31700,6318,41568,0
1,94,42,7,35,4,0,5,46,1,2,1,2,3,3,2,4,0,2,0,0,2,1,1,79070,31700,6318,41569,0
1,94,11,6,10,0,0,1,11,2,4,2,4,6,6,10,15,1,15,0,0,2,1,1,79070,31700,6318,41570,0
101,2612,773,422,505,30,103,129,803,14,77,46,83,91,129,535,839,7,6334,351,0,2,1,1,79080,31701,6319,41571,0
36,2427,1157,318,931,29,22,177,1186,6,104,63,125,110,188,712,1274,3,4596,255,0,2,7,7,79080,31701,6319,41572,0
101,2612,773,422,505,30,103,129,803,14,77,46,83,91,129,535,839,7,6334,351,0,2,1,1,79090,31702,6320,41573,0
36,2427,1157,318,931,29,22,177,1186,6,104,63,125,110,188,712,1274,3,4596,255,0,2,7,7,79090,31702,6320,41574,0
1,96,42,7,35,4,0,5,46,1,2,1,2,3,3,2,4,0,2,0,0,2,1,0,79090,31702,6320,41575,0
1,96,11,6,10,0,0,1,11,2,4,2,4,6,6,10,15,1,15,0,0,2,1,0,79090,31702,6320,41576,0
41,821,1178,367,1042,6,15,115,1184,9,94,51,95,103,146,644,976,4,4439,246,0,2,1,0,79090,31702,6320,41577,0
41,821,177,108,140,8,0,27,185,6,30,16,32,36,48,162,248,3,794,44,0,2,1,0,79090,31704,6320,41578,0
281,5902,1943,715,1694,26,18,214,1969,12,185,120,237,197,357,1436,2721,7,20915,1161,0,2,57,7,79090,31706,6320,41579,0
281,5902,1168,838,957,57,25,144,1225,19,348,224,416,367,640,3018,5452,11,61921,3440,1,2,57,7,79100,31708,6320,41580,0
112,4538,1289,550,1043,56,32,155,1345,10,167,93,185,177,278,1266,2075,5,11498,638,0,2,3,1,79100,31710,6321,41581,0
80,3144,1178,367,1042,6,15,115,1184,9,94,51,95,103,146,644,976,4,4439,246,0,2,2,1,79100,31710,6321,41582,0
111,6122,1943,715,1694,26,18,214,1969,12,185,120,237,197,357,1436,2721,7,20915,1161,0,2,80,3,79100,31712,6321,41583,0
1,94,42,7,35,4,0,5,46,1,2,1,2,3,3,2,4,0,2,0,0,2,1,1,79100,31712,6321,41584,0
1,94,11,6,10,0,0,1,11,2,4,2,4,6,6,10,15,1,15,0,0,2,1,1,79100,31712,6321,41585,0
52,1464,339,213,244,17,9,65,356,10,42,26,48,52,74,259,421,5,2410,133,0,2,8,2,79110,31712,6321,41586,0
75,3895,1293,570,1093,25,15,163,1318,10,195,123,241,205,364,1516,2795,6,17273,959,0,2,30,2,79120,31714,6321,41587,0
248,5737,4293,999,3693,19,54,507,4312,9,155,88,170,164,258,1156,1898,4,9368,520,0,2,2,4,79120,31716,6321,41588,0
248,5737,1482,859,1002,125,135,219,1607,16,219,134,251,235,385,1766,3032,9,27804,1544,1,2,2,4,79130,31717,6321,41589,0
1,94,42,7,35,4,0,5,46,1,2,1,2,3,3,2,4,0,2,0,0,2,1,1,79130,31717,6321,41590,0
1,94,11,6,10,0,0,1,11,2,4,2,4,6,6,10,15,1,15,0,0,2,1,1,79130,31717,6321,41591,0
52,1464,339,213,244,17,9,65,356,10,42,26,48,52,74,259,421,5,2410,133,0,2,8,2,79140,31717,6321,41592,0
75,3895,1293,570,1093,25,15,163,1318,10,195,123,241,205,364,1516,2795,6,17273,959,0,2,30,2,79150,31719,6321,41593,0
60,1163,282,196,195,3,0,86,285,8,130,71,141,138,212,936,1507,4,6538,363,0,2,1,3,79150,31719,6322,41594,0
1,96,42,7,35,4,0,5,46,1,2,1,2,3,3,2,4,0,2,0,0,2,1,1,79150,31719,6322,41595,0
1,96,11,6,10,0,0,1,11,2,4,2,4,6,6,10,15,1,15,0,0,2,1,1,79150,31719,6322,41596,0
229,4960,182,127,129,0,0,53,182,5,39,21,42,44,63,217,343,2,926,51,0,2,1,2,79150,31719,6323,41597,0
229,4960,1165,710,800,67,119,181,1232,18,243,153,282,261,435,2000,3492,10,36473,2026,1,2,1,2,79160,31719,6324,41598,0
183,5549,1660,832,1314,41,38,274,1701,20,312,209,395,332,604,2671,5058,12,64042,3557,1,2,1,1,79160,31721,6325,41600,0
183,5549,1057,646,719,113,100,145,1170,18,215,134,248,233,382,1740,3004,10,31186,1732,1,2,1,1,79170,31722,6326,41601,0
92,1886,757,253,292,73,244,162,830,13,61,38,67,74,105,409,651,7,4654,258,0,2,10,4,79170,31723,6326,41602,0
45,953,386,256,301,16,9,68,402,4,59,35,69,63,104,355,621,2,1453,80,0,2,1,1,79170,31723,6326,41603,0
45,953,264,131,164,11,41,46,275,6,38,22,40,44,62,214,338,3,1068,59,0,2,1,1,79180,31723,6327,41604,0
95,2927,773,419,590,28,0,166,801,10,204,113,217,214,330,1598,2554,5,13587,754,0,2,2,2,79180,31723,6328,41605,0
176,5307,1660,832,1314,41,38,274,1701,20,312,209,395,332,604,2671,5058,12,64042,3557,1,2,4,1,79180,31725,6329,41607,0
159,3785,77,34,69,0,0,8,77,3,24,16,29,27,45,114,213,1,387,21,0,2,2,6,79180,31725,6329,41608,0
159,3785,712,438,573,51,9,84,763,14,102,71,128,116,199,733,1364,8,11988,666,0,2,2,6,79190,31726,6329,41609,0
69,1527,402,202,227,24,74,80,426,12,52,33,61,64,94,339,564,7,3969,220,0,2,5,2,79190,31727,6329,41610,0
70,3211,1020,354,843,12,15,144,1032,8,134,77,144,142,221,970,1580,4,6792,377,0,2,8,5,79190,31727,6329,41611,0
9,449,219,78,157,11,5,46,230,3,24,20,34,27,54,114,256,2,545,30,0,2,21,8,79190,31728,6329,41612,0
53,1862,601,196,481,2,23,85,603,8,63,36,72,71,108,400,664,4,3036,168,0,2,1,1,79190,31728,6329,41613,0
171,7566,4293,999,3693,19,54,507,4312,9,155,88,170,164,258,1156,1898,4,9368,520,0,2,4,5,79190,31730,6329,41614,0
171,7566,1482,859,1002,125,135,219,1607,16,219,134,251,235,385,1766,3032,9,27804,1544,1,2,4,5,79200,31731,6329,41615,0
33,999,465,148,393,5,8,60,470,4,31,20,31,35,51,161,261,2,523,29,0,2,2,1,79200,31732,6329,41616,0
33,999,16,12,9,0,0,6,16,1,2,1,2,3,3,2,4,0,2,0,0,2,2,1,79200,31732,6329,41617,0
126,5520,1782,648,1425,9,47,279,1791,8,171,97,189,179,286,1292,2140,4,9462,525,0,2,26,18,79200,31733,6330,41618,0
125,5389,1513,682,1277,25,13,200,1538,11,199,116,219,210,335,1557,2584,6,15641,868,0,2,1,1,79200,31735,6330,41619,0
43,2690,652,304,544,16,6,88,668,6,89,51,101,95,152,591,998,3,3399,188,0,2,1,1,79200,31736,6330,41620,0
70,3187,1020,354,843,12,15,144,1032,8,134,77,144,142,221,970,1580,4,6792,377,0,2,3,3,79200,31736,6330,41621,0
45,1953,386,256,301,16,9,68,402,4,59,35,69,63,104,355,621,2,1453,80,0,2,1,1,79200,31736,6330,41622,0
37,1519,442,244,305,14,16,103,456,11,68,45,75,79,120,452,756,6,4588,254,0,2,1,1,79200,31738,6330,41623,0
52,1986,1098,241,925,5,10,155,1103,7,46,25,49,53,74,273,423,3,1580,87,0,2,1,1,79210,31740,6330,41624,0
158,7384,1392,870,1177,35,17,170,1427,14,494,280,531,508,811,4473,7289,7,54850,3047,2,2,0,2,79210,31743,6331,41625,0
95,2916,773,419,590,28,0,166,801,10,204,113,217,214,330,1598,2554,5,13587,754,0,2,0,4,79210,31743,6332,41626,0
70,3187,1020,354,843,12,15,144,1032,8,134,77,144,142,221,970,1580,4,6792,377,0,2,8,8,79210,31743,6332,41627,0
60,1163,282,196,195,3,0,86,285,8,130,71,141,138,212,936,1507,4,6538,363,0,2,1,3,79210,31743,6333,41628,0
1,96,42,7,35,4,0,5,46,1,2,1,2,3,3,2,4,0,2,0,0,2,1,1,79210,31743,6333,41629,0
1,96,11,6,10,0,0,1,11,2,4,2,4,6,6,10,15,1,15,0,0,2,1,1,79210,31743,6333,41630,0
229,4960,182,127,129,0,0,53,182,5,39,21,42,44,63,217,343,2,926,51,0,2,1,2,79210,31743,6334,41631,0
229,4960,1165,710,800,67,119,181,1232,18,243,153,282,261,435,2000,3492,10,36473,2026,1,2,1,2,79220,31743,6335,41632,0
183,5549,1660,832,1314,41,38,274,1701,20,312,209,395,332,604,2671,5058,12,64042,3557,1,2,1,1,79220,31745,6336,41634,0
183,5549,1057,646,719,113,100,145,1170,18,215,134,248,233,382,1740,3004,10,31186,1732,1,2,1,1,79230,31746,6337,41635,0
92,1886,757,253,292,73,244,162,830,13,61,38,67,74,105,409,651,7,4654,258,0,2,10,4,79230,31747,6337,41636,0
45,953,386,256,301,16,9,68,402,4,59,35,69,63,104,355,621,2,1453,80,0,2,1,1,79230,31747,6337,41637,0
45,953,264,131,164,11,41,46,275,6,38,22,40,44,62,214,338,3,1068,59,0,2,1,1,79240,31747,6338,41638,0
95,2927,773,419,590,28,0,166,801,10,204,113,217,214,330,1598,2554,5,13587,754,0,2,2,2,79240,31747,6339,41639,0
176,5307,1660,832,1314,41,38,274,1701,20,312,209,395,332,604,2671,5058,12,64042,3557,1,2,4,1,79240,31749,6340,41641,0
115,3128,1523,757,1297,19,12,193,1542,12,193,117,230,205,347,1508,2664,7,19053,1058,0,2,43,1,79250,31751,6340,41642,0
115,3128,701,378,504,33,58,109,734,13,110,68,126,123,194,794,1346,7,10027,557,0,2,43,1,79250,31752,6341,41643,0
107,5109,1523,757,1297,19,12,193,1542,12,193,117,230,205,347,1508,2664,7,19053,1058,0,2,47,0,79260,31754,6341,41644,0
115,3128,1523,757,1297,19,12,193,1542,12,193,117,230,205,347,1508,2664,7,19053,1058,0,2,43,1,79270,31756,6341,41645,0
115,3128,701,378,504,33,58,109,734,13,110,68,126,123,194,794,1346,7,10027,557,0,2,43,1,79270,31757,6342,41646,0
107,5109,1523,757,1297,19,12,193,1542,12,193,117,230,205,347,1508,2664,7,19053,1058,0,2,47,0,79280,31759,6342,41647,0
159,3785,77,34,69,0,0,8,77,3,24,16,29,27,45,114,213,1,387,21,0,2,2,6,79280,31759,6342,41648,0
159,3785,712,438,573,51,9,84,763,14,102,71,128,116,199,733,1364,8,11988,666,0,2,2,6,79290,31760,6342,41649,0
69,1527,402,202,227,24,74,80,426,12,52,33,61,64,94,339,564,7,3969,220,0,2,5,2,79290,31761,6342,41650,0
158,7384,1392,870,1177,35,17,170,1427,14,494,280,531,508,811,4473,7289,7,54850,3047,2,2,0,2,79290,31764,6343,41651,0
95,2912,773,419,590,28,0,166,801,10,204,113,217,214,330,1598,2554,5,13587,754,0,2,0,4,79290,31764,6344,41652,0
171,7566,4293,999,3693,19,54,507,4312,9,155,88,170,164,258,1156,1898,4,9368,520,0,2,4,5,79290,31766,6344,41653,0
171,7566,1482,859,1002,125,135,219,1607,16,219,134,251,235,385,1766,3032,9,27804,1544,1,2,4,5,79300,31767,6344,41654,0
33,999,465,148,393,5,8,60,470,4,31,20,31,35,51,161,261,2,523,29,0,2,2,1,79300,31768,6344,41655,0
33,999,16,12,9,0,0,6,16,1,2,1,2,3,3,2,4,0,2,0,0,2,2,1,79300,31768,6344,41656,0
126,5520,1782,648,1425,9,47,279,1791,8,171,97,189,179,286,1292,2140,4,9462,525,0,2,26,18,79300,31769,6345,41657,0
125,5389,1513,682,1277,25,13,200,1538,11,199,116,219,210,335,1557,2584,6,15641,868,0,2,1,1,79300,31771,6345,41658,0
43,2690,652,304,544,16,6,88,668,6,89,51,101,95,152,591,998,3,3399,188,0,2,1,1,79300,31772,6345,41659,0
70,3187,1020,354,843,12,15,144,1032,8,134,77,144,142,221,970,1580,4,6792,377,0,2,19,16,79300,31772,6345,41660,0
45,1953,386,256,301,16,9,68,402,4,59,35,69,63,104,355,621,2,1453,80,0,2,1,1,79300,31772,6345,41661,0
9,449,219,78,157,11,5,46,230,3,24,20,34,27,54,114,256,2,545,30,0,2,21,8,79300,31773,6345,41662,0
37,1519,442,244,305,14,16,103,456,11,68,45,75,79,120,452,756,6,4588,254,0,2,1,1,79300,31775,6345,41663,0
52,1986,1098,241,925,5,10,155,1103,7,46,25,49,53,74,273,423,3,1580,87,0,2,1,1,79310,31777,6345,41664,0
53,1862,601,196,481,2,23,85,603,8,63,36,72,71,108,400,664,4,3036,168,0,2,1,1,79310,31777,6345,41665,0
1,96,42,7,35,4,0,5,46,1,2,1,2,3,3,2,4,0,2,0,0,2,1,0,79310,31777,6345,41666,0
1,96,11,6,10,0,0,1,11,2,4,2,4,6,6,10,15,1,15,0,0,2,1,0,79310,31777,6345,41667,0
183,5549,1660,832,1314,41,38,274,1701,20,312,209,395,332,604,2671,5058,12,64042,3557,1,2,17,13,79310,31779,6346,41669,0
183,5549,1057,646,719,113,100,145,1170,18,215,134,248,233,382,1740,3004,10,31186,1732,1,2,17,13,79320,31780,6347,41670,0
116,2173,477,336,357,30,23,73,507,16,194,134,250,210,384,1538,2962,10,30538,1696,0,2,38,18,79330,31781,6347,41671,0
89,2050,996,429,845,24,10,117,1020,7,76,50,88,83,138,494,879,4,3565,198,0,2,90,35,79330,31783,6347,41672,0
89,2050,456,277,329,12,42,72,468,13,85,50,97,98,147,592,972,7,7212,400,0,2,90,35,79330,31783,6347,41673,0
163,3497,1513,682,1277,25,13,200,1538,11,199,116,219,210,335,1557,2584,6,15641,868,0,2,33,11,79330,31785,6347,41674,0
163,3497,819,519,539,24,98,155,843,15,96,57,106,111,163,690,1107,8,9171,509,0,2,33,11,79340,31787,6347,41675,0
236,4942,2,2,2,0,0,0,2,0,0,0,0,0,0,0,0,0,0,0,0,2,14,9,79340,31787,6347,41675,0
236,4942,99,48,90,1,3,5,100,0,0,0,0,0,0,0,0,0,0,0,0,2,14,9,79340,31788,6347,41676,0
236,4942,8,5,5,2,0,1,10,0,0,0,0,0,0,0,0,0,0,0,0,2,14,9,79340,31788,6347,41677,0
236,4942,1217,716,841,84,126,174,1301,14,185,118,215,199,333,1446,2542,8,20687,1149,0,2,14,9,79350,31790,6347,41678,0
236,4942,160,89,115,0,13,31,160,7,15,11,17,22,28,78,124,3,495,27,0,2,14,9,79350,31790,6347,41679,0
236,4942,10,10,9,9,0,0,19,0,0,0,0,0,0,0,0,0,0,0,0,2,14,9,79350,31790,6348,41680,0
236,4942,173,84,99,8,29,36,181,5,12,7,13,17,20,54,81,2,221,12,0,2,14,9,79350,31791,6348,41681,0
236,4942,3,1,1,3,0,0,6,0,0,0,0,0,0,0,0,0,0,0,0,2,14,9,79350,31791,6348,41682,0
52,1464,339,213,244,17,9,65,356,10,42,26,48,52,74,259,421,5,2410,133,0,2,14,8,79360,31791,6348,41683,0
248,5739,4293,999,3693,19,54,507,4312,9,155,88,170,164,258,1156,1898,4,9368,520,0,2,1,0,79360,31793,6348,41684,0
248,5739,1482,859,1002,125,135,219,1607,16,219,134,251,235,385,1766,3032,9,27804,1544,1,2,1,0,79370,31794,6348,41685,0
28,981,74,35,59,1,0,14,75,3,14,7,14,17,21,58,85,1,128,7,0,2,2,1,79370,31795,6348,41686,0
28,981,245,125,200,5,7,34,250,7,30,17,34,37,51,166,265,3,1053,58,0,2,2,1,79380,31796,6348,41687,0
54,657,647,139,84,35,284,233,682,0,0,0,0,0,0,0,0,0,0,0,0,2,1,1,79380,31796,6348,41688,0
115,3128,1523,757,1297,19,12,193,1542,12,193,117,230,205,347,1508,2664,7,19053,1058,0,2,75,13,79390,31798,6348,41689,0
115,3128,701,378,504,33,58,109,734,13,110,68,126,123,194,794,1346,7,10027,557,0,2,75,13,79390,31799,6349,41690,0
101,2612,773,422,505,30,103,129,803,14,77,46,83,91,129,535,839,7,6334,351,0,2,1,1,79400,31800,6350,41691,0
159,3785,77,34,69,0,0,8,77,3,24,16,29,27,45,114,213,1,387,21,0,2,9,9,79400,31800,6350,41692,0
159,3785,712,438,573,51,9,84,763,14,102,71,128,116,199,733,1364,8,11988,666,0,2,9,9,79410,31801,6350,41693,0
24,612,2,2,2,0,0,0,2,0,0,0,0,0,0,0,0,0,0,0,0,2,4,2,79410,31801,6350,41693,0
24,612,99,48,90,1,3,5,100,0,0,0,0,0,0,0,0,0,0,0,0,2,4,2,79410,31802,6350,41694,0
24,612,8,5,5,2,0,1,10,0,0,0,0,0,0,0,0,0,0,0,0,2,4,2,79410,31802,6350,41695,0
24,612,1217,716,841,84,126,174,1301,14,185,118,215,199,333,1446,2542,8,20687,1149,0,2,4,2,79420,31804,6350,41696,0
24,612,160,89,115,0,13,31,160,7,15,11,17,22,28,78,124,3,495,27,0,2,4,2,79420,31804,6350,41697,0
24,612,10,10,9,9,0,0,19,0,0,0,0,0,0,0,0,0,0,0,0,2,4,2,79420,31804,6351,41698,0
24,612,173,84,99,8,29,36,181,5,12,7,13,17,20,54,81,2,221,12,0,2,4,2,79420,31805,6351,41699,0
24,612,3,1,1,3,0,0,6,0,0,0,0,0,0,0,0,0,0,0,0,2,4,2,79420,31805,6351,41700,0
69,1527,402,202,227,24,74,80,426,12,52,33,61,64,94,339,564,7,3969,220,0,2,32,18,79420,31806,6351,41701,0
18,312,424,94,331,4,0,89,428,1,5,5,5,6,10,11,25,0,12,0,0,2,2,1,79420,31807,6351,41702,0
18,312,38,23,23,6,0,8,44,3,11,7,11,14,18,42,68,1,102,5,0,2,2,1,79420,31807,6351,41703,0
231,5969,722,423,573,19,0,135,741,12,172,101,199,184,300,1320,2257,6,15668,870,0,2,59,17,79420,31809,6351,41705,0
231,5969,1508,847,911,44,250,301,1552,14,148,88,169,162,257,1120,1886,7,15077,837,0,2,59,17,79420,31810,6352,41706,0
314,6930,72,33,56,0,4,12,72,1,1,1,1,2,2,0,2,0,1,0,0,2,13,10,79420,31810,6352,41707,0
314,6930,1454,835,1044,76,110,219,1530,17,275,158,296,292,454,2297,3718,9,34017,1889,1,2,13,10,79430,31811,6352,41708,0
67,1753,466,257,367,18,25,50,484,7,126,86,171,133,257,898,1813,4,8612,478,0,2,8,1,79430,31811,6352,41709,0
67,1753,507,281,342,29,59,88,536,10,53,29,57,63,86,336,514,5,2764,153,0,2,8,1,79430,31811,6352,41710,0
89,1894,1043,504,840,53,9,147,1096,9,180,112,198,189,310,1377,2344,4,11604,644,0,2,1,2,79430,31813,6352,41711,0
89,1894,383,288,292,26,6,62,409,11,65,38,67,76,105,429,656,5,3719,206,0,2,1,2,79430,31814,6352,41712,0
41,821,1178,367,1042,6,15,115,1184,9,94,51,95,103,146,644,976,4,4439,246,0,2,1,125,79430,31814,6352,41713,0
41,821,177,108,140,8,0,27,185,6,30,16,32,36,48,162,248,3,794,44,0,2,1,125,79430,31816,6352,41714,0
281,5902,1943,715,1694,26,18,214,1969,12,185,120,237,197,357,1436,2721,7,20915,1161,0,2,195,42,79430,31818,6352,41715,0
281,5902,1168,838,957,57,25,144,1225,19,348,224,416,367,640,3018,5452,11,61921,3440,1,2,195,42,79440,31820,6352,41716,0
2,156,37,13,25,0,6,6,37,1,2,1,2,3,3,2,4,0,2,0,0,2,57,6,79440,31820,6352,41717,0
2,156,133,47,40,1,43,49,134,0,0,0,0,0,0,0,0,0,0,0,0,2,57,6,79440,31820,6352,41718,0
112,4538,1289,550,1043,56,32,155,1345,10,167,93,185,177,278,1266,2075,5,11498,638,0,2,14,1,79440,31822,6353,41719,0
158,7384,1392,870,1177,35,17,170,1427,14,494,280,531,508,811,4473,7289,7,54850,3047,2,2,0,2,79440,31825,6354,41720,0
95,2912,773,419,590,28,0,166,801,10,204,113,217,214,330,1598,2554,5,13587,754,0,2,0,4,79440,31825,6355,41721,0
7,123,127,75,83,2,11,30,129,4,14,7,14,18,21,61,87,2,175,9,0,0,36,0,79440,31825,6355,41722,0
7,123,652,304,544,16,6,88,668,6,89,51,101,95,152,591,998,3,3399,188,0,0,36,0,79440,31826,6355,41723,0
7,123,2,2,2,0,0,0,2,0,0,0,0,0,0,0,0,0,0,0,0,0,36,0,79440,31826,6355,41723,0
7,123,8,5,5,0,0,3,8,0,0,0,0,0,0,0,0,0,0,0,0,0,36,0,79440,31826,6355,41724,0
7,123,2,2,2,0,0,0,2,0,0,0,0,0,0,0,0,0,0,0,0,0,36,0,79440,31826,6355,41724,0
7,123,14,8,8,0,0,6,14,0,0,0,0,0,0,0,0,0,0,0,0,0,36,0,79440,31826,6355,41725,0
7,123,6,4,4,0,0,2,6,0,0,0,0,0,0,0,0,0,0,0,0,0,36,0,79440,31826,6355,41726,0
7,123,6,4,4,0,0,2,6,1,2,1,2,3,3,2,4,0,2,0,0,0,36,0,79440,31826,6355,41727,0
7,123,6,4,4,0,0,2,6,0,0,0,0,0,0,0,0,0,0,0,0,0,36,0,79440,31826,6355,41728,0
7,123,7,5,5,0,0,2,7,0,0,0,0,0,0,0,0,0,0,0,0,0,36,0,79440,31826,6355,41729,0
7,123,6,4,4,0,0,2,6,0,0,0,0,0,0,0,0,0,0,0,0,0,36,0,79440,31826,6355,41730,0
7,123,10,6,6,0,0,4,10,0,0,0,0,0,0,0,0,0,0,0,0,0,36,0,79440,31826,6355,41731,0
7,123,1,1,1,0,0,0,1,0,0,0,0,0,0,0,0,0,0,0,0,0,36,0,79440,31826,6355,41731,0
7,123,14,10,10,0,0,4,14,1,1,1,1,2,2,0,2,0,1,0,0,0,36,0,79440,31826,6355,41732,0
7,123,46,26,30,3,0,12,49,3,6,3,6,9,9,20,28,1,42,2,0,0,36,0,79450,31826,6355,41733,0
36,2427,1157,318,931,29,22,177,1186,6,104,63,125,110,188,712,1274,3,4596,255,0,2,7,7,79450,31826,6355,41734,0
171,7566,4293,999,3693,19,54,507,4312,9,155,88,170,164,258,1156,1898,4,9368,520,0,2,20,7,79450,31828,6355,41735,0
171,7566,1482,859,1002,125,135,219,1607,16,219,134,251,235,385,1766,3032,9,27804,1544,1,2,20,7,79460,31829,6355,41736,0
33,999,465,148,393,5,8,60,470,4,31,20,31,35,51,161,261,2,523,29,0,2,2,1,79460,31830,6355,41737,0
33,999,16,12,9,0,0,6,16,1,2,1,2,3,3,2,4,0,2,0,0,2,2,1,79460,31830,6355,41738,0
126,5520,1782,648,1425,9,47,279,1791,8,171,97,189,179,286,1292,2140,4,9462,525,0,2,26,18,79460,31831,6356,41739,0
128,5170,1450,624,1228,12,26,181,1462,14,306,186,354,320,540,2580,4493,8,36391,2021,1,2,44,0,79460,31833,6357,41740,0
48,3659,996,429,845,24,10,117,1020,7,76,50,88,83,138,494,879,4,3565,198,0,2,105,13,79460,31835,6357,41741,0
125,5389,1513,682,1277,25,13,200,1538,11,199,116,219,210,335,1557,2584,6,15641,868,0,2,8,9,79460,31837,6357,41742,0
103,5336,1457,730,1242,11,6,188,1468,10,292,166,329,302,495,2424,4078,5,22973,1276,1,2,8,12,79460,31839,6357,41743,0
43,2690,652,304,544,16,6,88,668,6,89,51,101,95,152,591,998,3,3399,188,0,2,1,1,79460,31840,6357,41744,0
107,5109,1523,757,1297,19,12,193,1542,12,193,117,230,205,347,1508,2664,7,19053,1058,0,2,102,15,79470,31842,6357,41745,0
70,3187,1020,354,843,12,15,144,1032,8,134,77,144,142,221,970,1580,4,6792,377,0,2,19,16,79470,31842,6357,41746,0
75,3895,1293,570,1093,25,15,163,1318,10,195,123,241,205,364,1516,2795,6,17273,959,0,2,45,5,79480,31844,6357,41747,0
29,1903,384,251,317,7,8,52,391,11,70,44,84,81,128,467,811,6,5355,297,0,2,4,0,79480,31844,6357,41748,0
55,2800,722,423,573,19,0,135,741,12,172,101,199,184,300,1320,2257,6,15668,870,0,2,77,0,79480,31846,6357,41750,0
45,1953,386,256,301,16,9,68,402,4,59,35,69,63,104,355,621,2,1453,80,0,2,1,1,79480,31846,6357,41751,0
86,3411,1043,504,840,53,9,147,1096,9,180,112,198,189,310,1377,2344,4,11604,644,0,2,23,0,79480,31848,6357,41752,0
80,3144,1178,367,1042,6,15,115,1184,9,94,51,95,103,146,644,976,4,4439,246,0,2,2,36,79480,31848,6357,41753,0
9,449,219,78,157,11,5,46,230,3,24,20,34,27,54,114,256,2,545,30,0,2,21,8,79480,31849,6357,41754,0
111,6122,1943,715,1694,26,18,214,1969,12,185,120,237,197,357,1436,2721,7,20915,1161,0,2,168,8,79480,31851,6357,41755,0
37,1519,442,244,305,14,16,103,456,11,68,45,75,79,120,452,756,6,4588,254,0,2,1,1,79480,31853,6357,41756,0
52,1986,1098,241,925,5,10,155,1103,7,46,25,49,53,74,273,423,3,1580,87,0,2,1,1,79490,31855,6357,41757,0
53,1862,601,196,481,2,23,85,603,8,63,36,72,71,108,400,664,4,3036,168,0,2,2,2,79490,31855,6357,41758,0
76,3910,1293,570,1093,25,15,163,1318,10,195,123,241,205,364,1516,2795,6,17273,959,0,2,16,12,79500,31857,6357,41759,0
125,5389,1513,682,1277,25,13,200,1538,11,199,116,219,210,335,1557,2584,6,15641,868,0,2,1,1,79500,31859,6357,41760,0
75,3895,1293,570,1093,25,15,163,1318,10,195,123,241,205,364,1516,2795,6,17273,959,0,2,4,4,79510,31861,6357,41761,0
30,1440,373,158,315,8,0,51,381,5,76,44,79,81,123,486,779,2,2026,112,0,2,1,1,79510,31861,6357,41762,0
164,3518,1513,682,1277,25,13,200,1538,11,199,116,219,210,335,1557,2584,6,15641,868,0,2,4,0,79510,31863,6357,41763,0
164,3518,819,519,539,24,98,155,843,15,96,57,106,111,163,690,1107,8,9171,509,0,2,4,0,79520,31865,6357,41764,0
126,5406,1513,682,1277,25,13,200,1538,11,199,116,219,210,335,1557,2584,6,15641,868,0,2,3,0,79520,31867,6357,41765,0
41,821,1178,367,1042,6,15,115,1184,9,94,51,95,103,146,644,976,4,4439,246,0,2,1,1,79520,31867,6357,41766,0
41,821,177,108,140,8,0,27,185,6,30,16,32,36,48,162,248,3,794,44,0,2,1,1,79520,31869,6357,41767,0
112,4538,1289,550,1043,56,32,155,1345,10,167,93,185,177,278,1266,2075,5,11498,638,0,2,1,1,79520,31871,6358,41768,0
158,7384,1392,870,1177,35,17,170,1427,14,494,280,531,508,811,4473,7289,7,54850,3047,2,2,1,1,79520,31874,6359,41769,0
95,2912,773,419,590,28,0,166,801,10,204,113,217,214,330,1598,2554,5,13587,754,0,2,1,1,79520,31874,6360,41770,0
12,318,149,95,105,2,0,41,151,8,54,28,55,62,83,334,494,4,2013,111,0,2,1,1,79520,31874,6360,41771,0
15,703,139,89,101,2,0,35,141,7,54,34,62,61,96,330,569,4,2287,127,0,2,1,1,79520,31874,6360,41772,0
36,2427,1157,318,931,29,22,177,1186,6,104,63,125,110,188,712,1274,3,4596,255,0,2,2,2,79520,31874,6360,41773,0
90,3974,1338,495,1086,10,64,173,1348,11,122,82,157,133,239,883,1686,7,11934,663,0,2,3,3,79520,31876,6360,41774,0
171,7566,4293,999,3693,19,54,507,4312,9,155,88,170,164,258,1156,1898,4,9368,520,0,2,1,1,79520,31878,6360,41775,0
171,7566,1482,859,1002,125,135,219,1607,16,219,134,251,235,385,1766,3032,9,27804,1544,1,2,1,1,79530,31879,6360,41776,0
126,5520,1782,648,1425,9,47,279,1791,8,171,97,189,179,286,1292,2140,4,9462,525,0,2,1,1,79530,31880,6361,41777,0
6,328,180,34,164,0,0,16,180,1,12,6,12,13,18,43,66,0,33,1,0,2,1,1,79530,31880,6361,41778,0
128,5170,1450,624,1228,12,26,181,1462,14,306,186,354,320,540,2580,4493,8,36391,2021,1,2,2,2,79530,31882,6362,41779,0
176,5307,1660,832,1314,41,38,274,1701,20,312,209,395,332,604,2671,5058,12,64042,3557,1,2,4,4,79530,31884,6363,41781,0
125,5389,1513,682,1277,25,13,200,1538,11,199,116,219,210,335,1557,2584,6,15641,868,0,2,2,2,79530,31886,6363,41782,0
72,3310,1455,414,1257,16,76,112,1471,5,41,23,46,46,69,231,381,2,1069,59,0,2,1,1,79530,31887,6363,41783,0
107,5109,1523,757,1297,19,12,193,1542,12,193,117,230,205,347,1508,2664,7,19053,1058,0,2,1,1,79540,31889,6363,41784,0
29,1903,384,251,317,7,8,52,391,11,70,44,84,81,128,467,811,6,5355,297,0,2,2,2,79540,31889,6363,41785,0
55,2800,722,423,573,19,0,135,741,12,172,101,199,184,300,1320,2257,6,15668,870,0,2,1,1,79540,31891,6363,41787,0
86,3411,1043,504,840,53,9,147,1096,9,180,112,198,189,310,1377,2344,4,11604,644,0,2,2,2,79540,31893,6363,41788,0
80,3144,1178,367,1042,6,15,115,1184,9,94,51,95,103,146,644,976,4,4439,246,0,2,1,1,79540,31893,6363,41789,0
53,1862,601,196,481,2,23,85,603,8,63,36,72,71,108,400,664,4,3036,168,0,2,4,4,79540,31893,6363,41790,0
3,42,14,8,8,0,0,6,14,0,0,0,0,0,0,0,0,0,0,0,0,2,1,0,79540,31893,6363,41793,0
2,40,9,6,6,0,0,3,9,0,0,0,0,0,0,0,0,0,0,0,0,2,1,0,79540,31893,6363,41794,0
2,40,13,9,8,0,0,4,13,0,0,0,0,0,0,0,0,0,0,0,0,2,1,0,79540,31893,6363,41795,0
60,1163,282,196,195,3,0,86,285,8,130,71,141,138,212,936,1507,4,6538,363,0,2,1,0,79550,31894,6364,41809,0
4,77,127,75,83,2,11,30,129,4,14,7,14,18,21,61,87,2,175,9,0,2,1,0,79550,31894,6364,41810,0
4,77,652,304,544,16,6,88,668,6,89,51,101,95,152,591,998,3,3399,188,0,2,1,0,79550,31895,6364,41811,0
4,77,2,2,2,0,0,0,2,0,0,0,0,0,0,0,0,0,0,0,0,2,1,0,79550,31895,6364,41811,0
4,77,8,5,5,0,0,3,8,0,0,0,0,0,0,0,0,0,0,0,0,2,1,0,79550,31895,6364,41812,0
4,77,2,2,2,0,0,0,2,0,0,0,0,0,0,0,0,0,0,0,0,2,1,0,79550,31895,6364,41812,0
4,77,14,8,8,0,0,6,14,0,0,0,0,0,0,0,0,0,0,0,0,2,1,0,79550,31895,6364,41813,0
4,77,6,4,4,0,0,2,6,0,0,0,0,0,0,0,0,0,0,0,0,2,1,0,79550,31895,6364,41814,0
4,77,6,4,4,0,0,2,6,1,2,1,2,3,3,2,4,0,2,0,0,2,1,0,79550,31895,6364,41815,0
4,77,6,4,4,0,0,2,6,0,0,0,0,0,0,0,0,0,0,0,0,2,1,0,79550,31895,6364,41816,0
4,77,7,5,5,0,0,2,7,0,0,0,0,0,0,0,0,0,0,0,0,2,1,0,79550,31895,6364,41817,0
4,77,6,4,4,0,0,2,6,0,0,0,0,0,0,0,0,0,0,0,0,2,1,0,79550,31895,6364,41818,0
4,77,10,6,6,0,0,4,10,0,0,0,0,0,0,0,0,0,0,0,0,2,1,0,79550,31895,6364,41819,0
4,77,1,1,1,0,0,0,1,0,0,0,0,0,0,0,0,0,0,0,0,2,1,0,79550,31895,6364,41819,0
4,77,14,10,10,0,0,4,14,1,1,1,1,2,2,0,2,0,1,0,0,2,1,0,79550,31895,6364,41820,0
4,77,46,26,30,3,0,12,49,3,6,3,6,9,9,20,28,1,42,2,0,2,1,0,79560,31895,6364,41821,0
1,9,5,3,3,0,0,2,5,0,0,0,0,0,0,0,0,0,0,0,0,2,1,0,79560,31895,6364,41821,0
1,90,13,10,10,0,0,3,13,1,2,1,2,3,3,2,4,0,2,0,0,2,1,0,79560,31895,6364,41822,0
7,114,44,19,17,0,16,11,44,3,14,7,14,17,21,58,85,1,128,7,0,2,1,0,79560,31895,6364,41823,0
3,66,127,75,83,2,11,30,129,4,14,7,14,18,21,61,87,2,175,9,0,2,1,0,79570,31896,6364,41836,0
3,66,652,304,544,16,6,88,668,6,89,51,101,95,152,591,998,3,3399,188,0,2,1,0,79570,31897,6364,41837,0
3,66,2,2,2,0,0,0,2,0,0,0,0,0,0,0,0,0,0,0,0,2,1,0,79570,31897,6364,41837,0
3,66,8,5,5,0,0,3,8,0,0,0,0,0,0,0,0,0,0,0,0,2,1,0,79570,31897,6364,41838,0
3,66,2,2,2,0,0,0,2,0,0,0,0,0,0,0,0,0,0,0,0,2,1,0,79570,31897,6364,41838,0
3,66,14,8,8,0,0,6,14,0,0,0,0,0,0,0,0,0,0,0,0,2,1,0,79570,31897,6364,41839,0
3,66,6,4,4,0,0,2,6,0,0,0,0,0,0,0,0,0,0,0,0,2,1,0,79570,31897,6364,41840,0
3,66,6,4,4,0,0,2,6,1,2,1,2,3,3,2,4,0,2,0,0,2,1,0,79570,31897,6364,41841,0
3,66,6,4,4,0,0,2,6,0,0,0,0,0,0,0,0,0,0,0,0,2,1,0,79570,31897,6364,41842,0
3,66,7,5,5,0,0,2,7,0,0,0,0,0,0,0,0,0,0,0,0,2,1,0,79570,31897,6364,41843,0
3,66,6,4,4,0,0,2,6,0,0,0,0,0,0,0,0,0,0,0,0,2,1,0,79570,31897,6364,41844,0
3,66,10,6,6,0,0,4,10,0,0,0,0,0,0,0,0,0,0,0,0,2,1,0,79570,31897,6364,41845,0
3,66,1,1,1,0,0,0,1,0,0,0,0,0,0,0,0,0,0,0,0,2,1,0,79570,31897,6364,41845,0
3,66,14,10,10,0,0,4,14,1,1,1,1,2,2,0,2,0,1,0,0,2,1,0,79570,31897,6364,41846,0
3,66,46,26,30,3,0,12,49,3,6,3,6,9,9,20,28,1,42,2,0,2,1,0,79580,31897,6364,41847,0
7,296,72,33,56,0,4,12,72,1,1,1,1,2,2,0,2,0,1,0,0,2,1,0,79600,31905,6366,41862,0
12,229,127,75,83,2,11,30,129,4,14,7,14,18,21,61,87,2,175,9,0,2,1,0,79600,31905,6366,41863,0
12,229,652,304,544,16,6,88,668,6,89,51,101,95,152,591,998,3,3399,188,0,2,1,0,79600,31906,6366,41864,0
12,229,2,2,2,0,0,0,2,0,0,0,0,0,0,0,0,0,0,0,0,2,1,0,79600,31906,6366,41864,0
12,229,8,5,5,0,0,3,8,0,0,0,0,0,0,0,0,0,0,0,0,2,1,0,79600,31906,6366,41865,0
12,229,2,2,2,0,0,0,2,0,0,0,0,0,0,0,0,0,0,0,0,2,1,0,79600,31906,6366,41865,0
12,229,14,8,8,0,0,6,14,0,0,0,0,0,0,0,0,0,0,0,0,2,1,0,79600,31906,6366,41866,0
12,229,6,4,4,0,0,2,6,0,0,0,0,0,0,0,0,0,0,0,0,2,1,0,79600,31906,6366,41867,0
12,229,6,4,4,0,0,2,6,1,2,1,2,3,3,2,4,0,2,0,0,2,1,0,79600,31906,6366,41868,0
12,229,6,4,4,0,0,2,6,0,0,0,0,0,0,0,0,0,0,0,0,2,1,0,79600,31906,6366,41869,0
12,229,7,5,5,0,0,2,7,0,0,0,0,0,0,0,0,0,0,0,0,2,1,0,79600,31906,6366,41870,0
12,229,6,4,4,0,0,2,6,0,0,0,0,0,0,0,0,0,0,0,0,2,1,0,79600,31906,6366,41871,0
12,229,10,6,6,0,0,4,10,0,0,0,0,0,0,0,0,0,0,0,0,2,1,0,79600,31906,6366,41872,0
12,229,1,1,1,0,0,0,1,0,0,0,0,0,0,0,0,0,0,0,0,2,1,0,79600,31906,6366,41872,0
12,229,14,10,10,0,0,4,14,1,1,1,1,2,2,0,2,0,1,0,0,2,1,0,79600,31906,6366,41873,0
12,229,46,26,30,3,0,12,49,3,6,3,6,9,9,20,28,1,42,2,0,2,1,0,79610,31906,6366,41874,0
6,71,127,75,83,2,11,30,129,4,14,7,14,18,21,61,87,2,175,9,0,2,1,0,79610,31906,6366,41875,0
6,71,652,304,544,16,6,88,668,6,89,51,101,95,152,591,998,3,3399,188,0,2,1,0,79610,31907,6366,41876,0
6,71,2,2,2,0,0,0,2,0,0,0,0,0,0,0,0,0,0,0,0,2,1,0,79610,31907,6366,41876,0
6,71,8,5,5,0,0,3,8,0,0,0,0,0,0,0,0,0,0,0,0,2,1,0,79610,31907,6366,41877,0
6,71,2,2,2,0,0,0,2,0,0,0,0,0,0,0,0,0,0,0,0,2,1,0,79610,31907,6366,41877,0
6,71,14,8,8,0,0,6,14,0,0,0,0,0,0,0,0,0,0,0,0,2,1,0,79610,31907,6366,41878,0
6,71,6,4,4,0,0,2,6,0,0,0,0,0,0,0,0,0,0,0,0,2,1,0,79610,31907,6366,41879,0
6,71,6,4,4,0,0,2,6,1,2,1,2,3,3,2,4,0,2,0,0,2,1,0,79610,31907,6366,41880,0
6,71,6,4,4,0,0,2,6,0,0,0,0,0,0,0,0,0,0,0,0,2,1,0,79610,31907,6366,41881,0
6,71,7,5,5,0,0,2,7,0,0,0,0,0,0,0,0,0,0,0,0,2,1,0,79610,31907,6366,41882,0
6,71,6,4,4,0,0,2,6,0,0,0,0,0,0,0,0,0,0,0,0,2,1,0,79610,31907,6366,41883,0
6,71,10,6,6,0,0,4,10,0,0,0,0,0,0,0,0,0,0,0,0,2,1,0,79610,31907,6366,41884,0
6,71,1,1,1,0,0,0,1,0,0,0,0,0,0,0,0,0,0,0,0,2,1,0,79610,31907,6366,41884,0
6,71,14,10,10,0,0,4,14,1,1,1,1,2,2,0,2,0,1,0,0,2,1,0,79610,31907,6366,41885,0
6,71,46,26,30,3,0,12,49,3,6,3,6,9,9,20,28,1,42,2,0,2,1,0,79620,31907,6366,41886,0
3,26,14,7,7,2,0,5,16,0,0,0,0,0,0,0,0,0,0,0,0,2,1,0,79620,31907,6366,41886,0
7,103,38,23,23,0,0,15,38,0,0,0,0,0,0,0,0,0,0,0,0,2,1,0,79620,31907,6366,41887,0
17,378,85,59,61,8,0,16,93,5,18,10,18,23,28,86,126,2,316,17,0,2,1,0,79620,31907,6366,41888,0
12,515,124,78,88,2,3,26,126,4,13,7,13,17,20,56,81,2,163,9,0,2,1,0,79620,31907,6366,41891,0
1,96,42,7,35,4,0,5,46,1,2,1,2,3,3,2,4,0,2,0,0,2,1,0,79620,31907,6366,41892,0
1,96,11,6,10,0,0,1,11,2,4,2,4,6,6,10,15,1,15,0,0,2,1,0,79620,31907,6366,41893,0
11,242,19,8,11,5,0,4,24,2,5,3,6,7,9,13,25,1,30,1,0,2,1,0,79630,31911,6367,41901,0
11,242,102,59,69,5,3,24,107,6,22,15,28,28,43,113,206,3,789,43,0,2,1,0,79630,31911,6367,41902,0
11,242,106,40,36,3,49,17,109,8,17,13,23,25,36,93,167,5,904,50,0,2,1,0,79630,31911,6367,41903,0
229,4960,182,127,129,0,0,53,182,5,39,21,42,44,63,217,343,2,926,51,0,2,1,0,79640,31915,6369,41911,0
229,4960,1165,710,800,67,119,181,1232,18,243,153,282,261,435,2000,3492,10,36473,2026,1,2,1,0,79650,31915,6370,41912,0
67,1570,773,419,590,28,0,166,801,10,204,113,217,214,330,1598,2554,5,13587,754,0,2,1,0,79650,31915,6371,41913,0
67,1570,421,273,302,44,34,57,465,17,81,59,107,98,166,583,1098,11,12329,684,0,2,1,0,79650,31915,6372,41914,0
14,411,149,95,105,2,0,41,151,8,54,28,55,62,83,334,494,4,2013,111,0,2,1,0,79650,31915,6372,41915,0
14,411,82,56,54,0,13,15,82,4,13,8,16,17,24,56,98,2,241,13,0,2,1,0,79660,31915,6372,41916,0
26,529,2,2,2,0,0,0,2,0,0,0,0,0,0,0,0,0,0,0,0,2,1,0,79660,31915,6372,41916,0
26,529,99,48,90,1,3,5,100,0,0,0,0,0,0,0,0,0,0,0,0,2,1,0,79660,31916,6372,41917,0
26,529,8,5,5,2,0,1,10,0,0,0,0,0,0,0,0,0,0,0,0,2,1,0,79660,31916,6372,41918,0
26,529,1217,716,841,84,126,174,1301,14,185,118,215,199,333,1446,2542,8,20687,1149,0,2,1,0,79670,31918,6372,41919,0
26,529,160,89,115,0,13,31,160,7,15,11,17,22,28,78,124,3,495,27,0,2,1,0,79670,31918,6372,41920,0
26,529,10,10,9,9,0,0,19,0,0,0,0,0,0,0,0,0,0,0,0,2,1,0,79670,31918,6373,41921,0
26,529,173,84,99,8,29,36,181,5,12,7,13,17,20,54,81,2,221,12,0,2,1,0,79670,31919,6373,41922,0
26,529,3,1,1,3,0,0,6,0,0,0,0,0,0,0,0,0,0,0,0,2,1,0,79670,31919,6373,41923,0
183,5549,1660,832,1314,41,38,274,1701,20,312,209,395,332,604,2671,5058,12,64042,3557,1,2,1,0,79670,31921,6374,41925,0
183,5549,1057,646,719,113,100,145,1170,18,215,134,248,233,382,1740,3004,10,31186,1732,1,2,1,0,79680,31922,6375,41926,0
17,348,95,58,50,9,16,20,104,12,33,24,45,45,69,209,378,8,3100,172,0,2,1,0,79680,31922,6375,41927,0
116,2173,477,336,357,30,23,73,507,16,194,134,250,210,384,1538,2962,10,30538,1696,0,2,1,0,79690,31923,6375,41928,0
89,2050,996,429,845,24,10,117,1020,7,76,50,88,83,138,494,879,4,3565,198,0,2,1,0,79690,31925,6375,41929,0
89,2050,456,277,329,12,42,72,468,13,85,50,97,98,147,592,972,7,7212,400,0,2,1,0,79690,31925,6375,41930,0
163,3497,1513,682,1277,25,13,200,1538,11,199,116,219,210,335,1557,2584,6,15641,868,0,2,1,0,79690,31927,6375,41931,0
163,3497,819,519,539,24,98,155,843,15,96,57,106,111,163,690,1107,8,9171,509,0,2,1,0,79700,31929,6375,41932,0
73,1518,207,111,150,11,0,50,218,5,26,19,36,31,55,133,272,3,943,52,0,2,1,0,79700,31929,6375,41933,0
73,1518,410,198,237,31,55,97,441,11,63,38,72,74,110,414,683,6,4293,238,0,2,1,0,79710,31930,6376,41934,0
236,4942,2,2,2,0,0,0,2,0,0,0,0,0,0,0,0,0,0,0,0,2,1,0,79710,31930,6376,41934,0
236,4942,99,48,90,1,3,5,100,0,0,0,0,0,0,0,0,0,0,0,0,2,1,0,79710,31931,6376,41935,0
236,4942,8,5,5,2,0,1,10,0,0,0,0,0,0,0,0,0,0,0,0,2,1,0,79710,31931,6376,41936,0
236,4942,1217,716,841,84,126,174,1301,14,185,118,215,199,333,1446,2542,8,20687,1149,0,2,1,0,79720,31933,6376,41937,0
236,4942,160,89,115,0,13,31,160,7,15,11,17,22,28,78,124,3,495,27,0,2,1,0,79720,31933,6376,41938,0
236,4942,10,10,9,9,0,0,19,0,0,0,0,0,0,0,0,0,0,0,0,2,1,0,79720,31933,6377,41939,0
236,4942,173,84,99,8,29,36,181,5,12,7,13,17,20,54,81,2,221,12,0,2,1,0,79720,31934,6377,41940,0
236,4942,3,1,1,3,0,0,6,0,0,0,0,0,0,0,0,0,0,0,0,2,1,0,79720,31934,6377,41941,0
98,2019,463,295,324,28,62,57,491,12,134,82,154,146,236,989,1696,6,11700,650,0,2,1,0,79730,31935,6377,41942,0
55,770,167,116,138,4,5,22,171,8,48,30,56,56,86,292,499,4,2330,129,0,2,1,0,79730,31935,6377,41943,0
52,1464,339,213,244,17,9,65,356,10,42,26,48,52,74,259,421,5,2410,133,0,2,1,0,79740,31935,6377,41944,0
95,2385,1455,414,1257,16,76,112,1471,5,41,23,46,46,69,231,381,2,1069,59,0,2,1,0,79740,31936,6377,41946,0
95,2385,669,365,481,22,61,110,691,15,103,63,122,118,185,747,1273,8,11311,628,0,2,1,0,79750,31936,6378,41947,0
248,5739,4293,999,3693,19,54,507,4312,9,155,88,170,164,258,1156,1898,4,9368,520,0,2,1,0,79750,31938,6378,41948,0
248,5739,1482,859,1002,125,135,219,1607,16,219,134,251,235,385,1766,3032,9,27804,1544,1,2,1,0,79760,31939,6378,41949,0
6,140,44,22,19,0,19,6,44,2,10,6,12,12,18,35,64,1,77,4,0,2,1,0,79760,31939,6378,41950,0
28,981,74,35,59,1,0,14,75,3,14,7,14,17,21,58,85,1,128,7,0,2,1,0,79760,31940,6378,41951,0
28,981,245,125,200,5,7,34,250,7,30,17,34,37,51,166,265,3,1053,58,0,2,1,0,79770,31941,6378,41952,0
54,657,647,139,84,35,284,233,682,0,0,0,0,0,0,0,0,0,0,0,0,2,1,0,79770,31941,6378,41953,0
115,3128,1523,757,1297,19,12,193,1542,12,193,117,230,205,347,1508,2664,7,19053,1058,0,2,1,0,79780,31943,6378,41954,0
115,3128,701,378,504,33,58,109,734,13,110,68,126,123,194,794,1346,7,10027,557,0,2,1,0,79780,31944,6379,41955,0
101,2612,773,422,505,30,103,129,803,14,77,46,83,91,129,535,839,7,6334,351,0,2,1,0,79790,31945,6380,41956,0
159,3785,77,34,69,0,0,8,77,3,24,16,29,27,45,114,213,1,387,21,0,2,1,0,79790,31945,6380,41957,0
159,3785,712,438,573,51,9,84,763,14,102,71,128,116,199,733,1364,8,11988,666,0,2,1,0,79800,31946,6380,41958,0
24,612,2,2,2,0,0,0,2,0,0,0,0,0,0,0,0,0,0,0,0,2,1,0,79800,31946,6380,41958,0
24,612,99,48,90,1,3,5,100,0,0,0,0,0,0,0,0,0,0,0,0,2,1,0,79800,31947,6380,41959,0
24,612,8,5,5,2,0,1,10,0,0,0,0,0,0,0,0,0,0,0,0,2,1,0,79800,31947,6380,41960,0
24,612,1217,716,841,84,126,174,1301,14,185,118,215,199,333,1446,2542,8,20687,1149,0,2,1,0,79810,31949,6380,41961,0
24,612,160,89,115,0,13,31,160,7,15,11,17,22,28,78,124,3,495,27,0,2,1,0,79810,31949,6380,41962,0
24,612,10,10,9,9,0,0,19,0,0,0,0,0,0,0,0,0,0,0,0,2,1,0,79810,31949,6381,41963,0
24,612,173,84,99,8,29,36,181,5,12,7,13,17,20,54,81,2,221,12,0,2,1,0,79810,31950,6381,41964,0
24,612,3,1,1,3,0,0,6,0,0,0,0,0,0,0,0,0,0,0,0,2,1,0,79810,31950,6381,41965,0
30,664,125,97,103,3,0,19,128,9,25,17,27,34,44,144,223,4,1087,60,0,2,1,0,79810,31950,6382,41966,0
22,373,102,57,55,5,16,25,107,5,17,10,18,22,28,81,124,2,330,18,0,2,1,0,79810,31950,6382,41967,0
69,1527,402,202,227,24,74,80,426,12,52,33,61,64,94,339,564,7,3969,220,0,2,1,0,79810,31951,6382,41968,0
55,1174,447,308,343,6,5,95,453,7,96,59,111,103,170,651,1136,4,4600,255,0,2,1,0,79810,31954,6382,41969,0
55,1174,322,174,179,16,74,51,338,10,41,26,46,51,72,252,408,5,2291,127,0,2,1,0,79810,31957,6383,41970,0
75,1629,53,23,39,0,0,13,53,2,8,4,8,10,12,26,39,1,39,2,0,2,1,0,79810,31957,6383,41971,0
75,1629,515,298,307,33,80,99,548,12,63,44,77,75,121,419,753,7,5527,307,0,2,1,0,79820,31957,6383,41972,0
18,312,424,94,331,4,0,89,428,1,5,5,5,6,10,11,25,0,12,0,0,2,1,0,79820,31958,6383,41973,0
18,312,38,23,23,6,0,8,44,3,11,7,11,14,18,42,68,1,102,5,0,2,1,0,79820,31958,6383,41974,0
20,531,205,80,86,16,53,53,221,7,18,10,19,25,29,94,134,3,497,27,0,2,1,0,79830,31958,6384,41975,0
17,523,184,100,137,2,15,30,186,6,38,20,39,44,59,214,322,3,991,55,0,2,1,0,79830,31959,6384,41976,0
17,523,103,65,74,8,5,16,111,7,17,9,17,24,26,89,119,3,417,23,0,2,1,0,79830,31960,6384,41977,0
59,1228,91,45,69,0,3,18,91,3,9,6,10,12,16,33,57,1,95,5,0,2,1,0,79830,31962,6384,41978,0
59,1228,367,234,237,17,34,68,384,16,55,34,61,71,95,381,584,8,5183,287,0,2,1,0,79830,31963,6384,41979,0
231,5969,722,423,573,19,0,135,741,12,172,101,199,184,300,1320,2257,6,15668,870,0,2,1,0,79830,31965,6384,41981,0
231,5969,1508,847,911,44,250,301,1552,14,148,88,169,162,257,1120,1886,7,15077,837,0,2,1,0,79830,31966,6385,41982,0
314,6930,72,33,56,0,4,12,72,1,1,1,1,2,2,0,2,0,1,0,0,2,1,0,79830,31966,6385,41983,0
314,6930,1454,835,1044,76,110,219,1530,17,275,158,296,292,454,2297,3718,9,34017,1889,1,2,1,0,79840,31967,6385,41984,0
92,1886,757,253,292,73,244,162,830,13,61,38,67,74,105,409,651,7,4654,258,0,2,1,0,79840,31968,6385,41985,0
45,953,386,256,301,16,9,68,402,4,59,35,69,63,104,355,621,2,1453,80,0,2,1,0,79840,31968,6385,41986,0
45,953,264,131,164,11,41,46,275,6,38,22,40,44,62,214,338,3,1068,59,0,2,1,0,79850,31968,6386,41987,0
67,1753,466,257,367,18,25,50,484,7,126,86,171,133,257,898,1813,4,8612,478,0,2,1,0,79850,31968,6386,41988,0
67,1753,507,281,342,29,59,88,536,10,53,29,57,63,86,336,514,5,2764,153,0,2,1,0,79850,31968,6386,41989,0
25,552,215,129,180,6,0,29,221,8,65,43,72,73,115,415,711,4,3153,175,0,2,1,0,79850,31968,6386,41990,0
25,552,97,69,77,3,3,16,100,6,22,13,23,28,36,113,173,3,542,30,0,2,1,0,79850,31969,6386,41991,0
89,1894,1043,504,840,53,9,147,1096,9,180,112,198,189,310,1377,2344,4,11604,644,0,2,1,0,79850,31971,6386,41992,0
89,1894,383,288,292,26,6,62,409,11,65,38,67,76,105,429,656,5,3719,206,0,2,1,0,79850,31972,6386,41993,0
20,420,294,64,250,0,0,43,294,1,20,10,20,21,30,86,131,0,65,3,0,2,1,0,79850,31972,6386,41994,0
20,420,78,46,62,3,0,14,81,3,8,4,8,11,12,28,41,1,62,3,0,2,1,0,79850,31973,6386,41995,0
5,123,110,30,77,3,13,16,113,4,21,15,30,25,45,100,208,2,597,33,0,2,1,0,79850,31973,6386,41996,0
5,123,28,15,21,1,0,6,29,0,0,0,0,0,0,0,0,0,0,0,0,2,1,0,79850,31973,6386,41997,0
41,821,1178,367,1042,6,15,115,1184,9,94,51,95,103,146,644,976,4,4439,246,0,2,1,1,79850,31973,6386,41998,0
41,821,177,108,140,8,0,27,185,6,30,16,32,36,48,162,248,3,794,44,0,2,1,1,79850,31975,6386,41999,0
28,452,219,78,157,11,5,46,230,3,24,20,34,27,54,114,256,2,545,30,0,2,1,0,79850,31976,6386,42000,0
28,452,108,64,79,9,0,20,117,5,15,11,19,20,30,70,129,3,410,22,0,2,1,0,79850,31976,6386,42001,0
281,5902,1943,715,1694,26,18,214,1969,12,185,120,237,197,357,1436,2721,7,20915,1161,0,2,1,1,79850,31978,6386,42002,0
281,5902,1168,838,957,57,25,144,1225,19,348,224,416,367,640,3018,5452,11,61921,3440,1,2,1,1,79860,31980,6386,42003,0
19,720,442,244,305,14,16,103,456,11,68,45,75,79,120,452,756,6,4588,254,0,2,1,0,79860,31982,6386,42004,0
19,720,182,102,99,11,40,35,193,3,11,6,11,14,17,42,64,1,97,5,0,2,1,0,79860,31983,6386,42005,0
69,1323,1098,241,925,5,10,155,1103,7,46,25,49,53,74,273,423,3,1580,87,0,2,1,0,79870,31985,6386,42006,0
69,1323,282,202,222,14,2,44,296,8,42,24,43,50,67,250,378,4,1548,86,0,2,1,0,79870,31986,6386,42007,0
2,156,37,13,25,0,6,6,37,1,2,1,2,3,3,2,4,0,2,0,0,2,1,0,79870,31986,6386,42008,0
2,156,133,47,40,1,43,49,134,0,0,0,0,0,0,0,0,0,0,0,0,2,1,0,79870,31986,6386,42009,0
29,743,601,196,481,2,23,85,603,8,63,36,72,71,108,400,664,4,3036,168,0,2,1,0,79870,31986,6386,42010,0
29,743,156,79,106,5,16,28,161,5,14,8,15,19,23,64,97,2,261,14,0,2,1,0,79870,31986,6386,42011,0
112,4538,1289,550,1043,56,32,155,1345,10,167,93,185,177,278,1266,2075,5,11498,638,0,2,1,1,79870,31988,6387,42012,0
36,1120,182,127,129,0,0,53,182,5,39,21,42,44,63,217,343,2,926,51,0,2,1,1,79870,31988,6388,42013,0
158,7384,1392,870,1177,35,17,170,1427,14,494,280,531,508,811,4473,7289,7,54850,3047,2,2,1,1,79870,31991,6389,42014,0
95,2912,773,419,590,28,0,166,801,10,204,113,217,214,330,1598,2554,5,13587,754,0,2,1,1,79870,31991,6390,42015,0
7,123,127,75,83,2,11,30,129,4,14,7,14,18,21,61,87,2,175,9,0,2,1,0,79870,31991,6390,42016,0
7,123,652,304,544,16,6,88,668,6,89,51,101,95,152,591,998,3,3399,188,0,2,1,0,79870,31992,6390,42017,0
7,123,2,2,2,0,0,0,2,0,0,0,0,0,0,0,0,0,0,0,0,2,1,0,79870,31992,6390,42017,0
7,123,8,5,5,0,0,3,8,0,0,0,0,0,0,0,0,0,0,0,0,2,1,0,79870,31992,6390,42018,0
7,123,2,2,2,0,0,0,2,0,0,0,0,0,0,0,0,0,0,0,0,2,1,0,79870,31992,6390,42018,0
7,123,14,8,8,0,0,6,14,0,0,0,0,0,0,0,0,0,0,0,0,2,1,0,79870,31992,6390,42019,0
7,123,6,4,4,0,0,2,6,0,0,0,0,0,0,0,0,0,0,0,0,2,1,0,79870,31992,6390,42020,0
7,123,6,4,4,0,0,2,6,1,2,1,2,3,3,2,4,0,2,0,0,2,1,0,79870,31992,6390,42021,0
7,123,6,4,4,0,0,2,6,0,0,0,0,0,0,0,0,0,0,0,0,2,1,0,79870,31992,6390,42022,0
7,123,7,5,5,0,0,2,7,0,0,0,0,0,0,0,0,0,0,0,0,2,1,0,79870,31992,6390,42023,0
7,123,6,4,4,0,0,2,6,0,0,0,0,0,0,0,0,0,0,0,0,2,1,0,79870,31992,6390,42024,0
7,123,10,6,6,0,0,4,10,0,0,0,0,0,0,0,0,0,0,0,0,2,1,0,79870,31992,6390,42025,0
7,123,1,1,1,0,0,0,1,0,0,0,0,0,0,0,0,0,0,0,0,2,1,0,79870,31992,6390,42025,0
7,123,14,10,10,0,0,4,14,1,1,1,1,2,2,0,2,0,1,0,0,2,1,0,79870,31992,6390,42026,0
7,123,46,26,30,3,0,12,49,3,6,3,6,9,9,20,28,1,42,2,0,2,1,0,79880,31992,6390,42027,0
14,845,75,38,59,1,3,12,76,2,4,2,4,6,6,10,15,1,15,0,0,2,1,0,79880,31992,6390,42028,0
2,67,16,12,9,0,0,6,16,1,2,1,2,3,3,2,4,0,2,0,0,2,1,0,79880,31992,6390,42029,0
1,6,2,2,2,0,0,0,2,0,0,0,0,0,0,0,0,0,0,0,0,2,1,0,79880,31992,6390,42029,0
1,6,99,48,90,1,3,5,100,0,0,0,0,0,0,0,0,0,0,0,0,2,1,0,79880,31993,6390,42030,0
1,6,8,5,5,2,0,1,10,0,0,0,0,0,0,0,0,0,0,0,0,2,1,0,79880,31993,6390,42031,0
1,6,1217,716,841,84,126,174,1301,14,185,118,215,199,333,1446,2542,8,20687,1149,0,2,1,0,79890,31995,6390,42032,0
1,6,160,89,115,0,13,31,160,7,15,11,17,22,28,78,124,3,495,27,0,2,1,0,79890,31995,6390,42033,0
1,6,10,10,9,9,0,0,19,0,0,0,0,0,0,0,0,0,0,0,0,2,1,0,79890,31995,6391,42034,0
1,6,173,84,99,8,29,36,181,5,12,7,13,17,20,54,81,2,221,12,0,2,1,0,79890,31996,6391,42035,0
1,6,3,1,1,3,0,0,6,0,0,0,0,0,0,0,0,0,0,0,0,2,1,0,79890,31996,6391,42036,0
1,6,2,2,2,0,0,0,2,0,0,0,0,0,0,0,0,0,0,0,0,2,1,0,79890,31996,6391,42036,0
1,8,127,75,83,2,11,30,129,4,14,7,14,18,21,61,87,2,175,9,0,2,1,0,79890,31996,6391,42037,0
1,8,652,304,544,16,6,88,668,6,89,51,101,95,152,591,998,3,3399,188,0,2,1,0,79890,31997,6391,42038,0
1,8,2,2,2,0,0,0,2,0,0,0,0,0,0,0,0,0,0,0,0,2,1,0,79890,31997,6391,42038,0
1,8,8,5,5,0,0,3,8,0,0,0,0,0,0,0,0,0,0,0,0,2,1,0,79890,31997,6391,42039,0
1,8,2,2,2,0,0,0,2,0,0,0,0,0,0,0,0,0,0,0,0,2,1,0,79890,31997,6391,42039,0
1,8,14,8,8,0,0,6,14,0,0,0,0,0,0,0,0,0,0,0,0,2,1,0,79890,31997,6391,42040,0
1,8,6,4,4,0,0,2,6,0,0,0,0,0,0,0,0,0,0,0,0,2,1,0,79890,31997,6391,42041,0
1,8,6,4,4,0,0,2,6,1,2,1,2,3,3,2,4,0,2,0,0,2,1,0,79890,31997,6391,42042,0
1,8,6,4,4,0,0,2,6,0,0,0,0,0,0,0,0,0,0,0,0,2,1,0,79890,31997,6391,42043,0
1,8,7,5,5,0,0,2,7,0,0,0,0,0,0,0,0,0,0,0,0,2,1,0,79890,31997,6391,42044,0
1,8,6,4,4,0,0,2,6,0,0,0,0,0,0,0,0,0,0,0,0,2,1,0,79890,31997,6391,42045,0
1,8,10,6,6,0,0,4,10,0,0,0,0,0,0,0,0,0,0,0,0,2,1,0,79890,31997,6391,42046,0
1,8,1,1,1,0,0,0,1,0,0,0,0,0,0,0,0,0,0,0,0,2,1,0,79890,31997,6391,42046,0
1,8,14,10,10,0,0,4,14,1,1,1,1,2,2,0,2,0,1,0,0,2,1,0,79890,31997,6391,42047,0
1,8,46,26,30,3,0,12,49,3,6,3,6,9,9,20,28,1,42,2,0,2,1,0,79900,31997,6391,42048,0
1,6,2,2,2,0,0,0,2,0,0,0,0,0,0,0,0,0,0,0,0,2,1,0,79900,31997,6391,42048,0
1,6,2,2,2,0,0,0,2,0,0,0,0,0,0,0,0,0,0,0,0,2,1,0,79910,31998,6391,42060,0
2,25,127,75,83,2,11,30,129,4,14,7,14,18,21,61,87,2,175,9,0,2,1,0,79910,31998,6391,42061,0
2,25,652,304,544,16,6,88,668,6,89,51,101,95,152,591,998,3,3399,188,0,2,1,0,79910,31999,6391,42062,0
2,25,2,2,2,0,0,0,2,0,0,0,0,0,0,0,0,0,0,0,0,2,1,0,79910,31999,6391,42062,0
2,25,8,5,5,0,0,3,8,0,0,0,0,0,0,0,0,0,0,0,0,2,1,0,79910,31999,6391,42063,0
2,25,2,2,2,0,0,0,2,0,0,0,0,0,0,0,0,0,0,0,0,2,1,0,79910,31999,6391,42063,0
2,25,14,8,8,0,0,6,14,0,0,0,0,0,0,0,0,0,0,0,0,2,1,0,79910,31999,6391,42064,0
2,25,6,4,4,0,0,2,6,0,0,0,0,0,0,0,0,0,0,0,0,2,1,0,79910,31999,6391,42065,0
2,25,6,4,4,0,0,2,6,1,2,1,2,3,3,2,4,0,2,0,0,2,1,0,79910,31999,6391,42066,0
2,25,6,4,4,0,0,2,6,0,0,0,0,0,0,0,0,0,0,0,0,2,1,0,79910,31999,6391,42067,0
2,25,7,5,5,0,0,2,7,0,0,0,0,0,0,0,0,0,0,0,0,2,1,0,79910,31999,6391,42068,0
2,25,6,4,4,0,0,2,6,0,0,0,0,0,0,0,0,0,0,0,0,2,1,0,79910,31999,6391,42069,0
2,25,10,6,6,0,0,4,10,0,0,0,0,0,0,0,0,0,0,0,0,2,1,0,79910,31999,6391,42070,0
2,25,1,1,1,0,0,0,1,0,0,0,0,0,0,0,0,0,0,0,0,2,1,0,79910,31999,6391,42070,0
2,25,14,10,10,0,0,4,14,1,1,1,1,2,2,0,2,0,1,0,0,2,1,0,79910,31999,6391,42071,0
2,25,46,26,30,3,0,12,49,3,6,3,6,9,9,20,28,1,42,2,0,2,1,0,79920,31999,6391,42072,0
1,55,14,12,10,0,0,4,14,1,2,1,2,3,3,2,4,0,2,0,0,2,1,0,79920,31999,6391,42073,0
1,58,14,12,10,0,0,4,14,1,2,1,2,3,3,2,4,0,2,0,0,2,1,0,79920,31999,6391,42074,0
1,55,14,12,10,0,0,4,14,1,2,1,2,3,3,2,4,0,2,0,0,2,1,0,79920,31999,6391,42075,0
1,77,19,18,14,0,0,5,19,1,2,1,2,3,3,2,4,0,2,0,0,2,1,0,79920,31999,6391,42076,0
2,18,10,6,6,0,0,4,10,0,0,0,0,0,0,0,0,0,0,0,0,2,1,0,79920,31999,6391,42077,0
2,36,127,75,83,2,11,30,129,4,14,7,14,18,21,61,87,2,175,9,0,2,1,0,79920,31999,6391,42078,0
2,36,652,304,544,16,6,88,668,6,89,51,101,95,152,591,998,3,3399,188,0,2,1,0,79920,32000,6391,42079,0
2,36,2,2,2,0,0,0,2,0,0,0,0,0,0,0,0,0,0,0,0,2,1,0,79920,32000,6391,42079,0
2,36,8,5,5,0,0,3,8,0,0,0,0,0,0,0,0,0,0,0,0,2,1,0,79920,32000,6391,42080,0
2,36,2,2,2,0,0,0,2,0,0,0,0,0,0,0,0,0,0,0,0,2,1,0,79920,32000,6391,42080,0
2,36,14,8,8,0,0,6,14,0,0,0,0,0,0,0,0,0,0,0,0,2,1,0,79920,32000,6391,42081,0
2,36,6,4,4,0,0,2,6,0,0,0,0,0,0,0,0,0,0,0,0,2,1,0,79920,32000,6391,42082,0
2,36,6,4,4,0,0,2,6,1,2,1,2,3,3,2,4,0,2,0,0,2,1,0,79920,32000,6391,42083,0
2,36,6,4,4,0,0,2,6,0,0,0,0,0,0,0,0,0,0,0,0,2,1,0,79920,32000,6391,42084,0
2,36,7,5,5,0,0,2,7,0,0,0,0,0,0,0,0,0,0,0,0,2,1,0,79920,32000,6391,42085,0
2,36,6,4,4,0,0,2,6,0,0,0,0,0,0,0,0,0,0,0,0,2,1,0,79920,32000,6391,42086,0
2,36,10,6,6,0,0,4,10,0,0,0,0,0,0,0,0,0,0,0,0,2,1,0,79920,32000,6391,42087,0
2,36,1,1,1,0,0,0,1,0,0,0,0,0,0,0,0,0,0,0,0,2,1,0,79920,32000,6391,42087,0
2,36,14,10,10,0,0,4,14,1,1,1,1,2,2,0,2,0,1,0,0,2,1,0,79920,32000,6391,42088,0
2,36,46,26,30,3,0,12,49,3,6,3,6,9,9,20,28,1,42,2,0,2,1,0,79930,32000,6391,42089,0
1,6,2,2,2,0,0,0,2,0,0,0,0,0,0,0,0,0,0,0,0,2,1,0,79930,32000,6391,42089,0
1,26,127,75,83,2,11,30,129,4,14,7,14,18,21,61,87,2,175,9,0,2,1,0,79930,32000,6391,42090,0
1,26,652,304,544,16,6,88,668,6,89,51,101,95,152,591,998,3,3399,188,0,2,1,0,79930,32001,6391,42091,0
1,26,2,2,2,0,0,0,2,0,0,0,0,0,0,0,0,0,0,0,0,2,1,0,79930,32001,6391,42091,0
1,26,8,5,5,0,0,3,8,0,0,0,0,0,0,0,0,0,0,0,0,2,1,0,79930,32001,6391,42092,0
1,26,2,2,2,0,0,0,2,0,0,0,0,0,0,0,0,0,0,0,0,2,1,0,79930,32001,6391,42092,0
1,26,14,8,8,0,0,6,14,0,0,0,0,0,0,0,0,0,0,0,0,2,1,0,79930,32001,6391,42093,0
1,26,6,4,4,0,0,2,6,0,0,0,0,0,0,0,0,0,0,0,0,2,1,0,79930,32001,6391,42094,0
1,26,6,4,4,0,0,2,6,1,2,1,2,3,3,2,4,0,2,0,0,2,1,0,79930,32001,6391,42095,0
1,26,6,4,4,0,0,2,6,0,0,0,0,0,0,0,0,0,0,0,0,2,1,0,79930,32001,6391,42096,0
1,26,7,5,5,0,0,2,7,0,0,0,0,0,0,0,0,0,0,0,0,2,1,0,79930,32001,6391,42097,0
1,26,6,4,4,0,0,2,6,0,0,0,0,0,0,0,0,0,0,0,0,2,1,0,79930,32001,6391,42098,0
1,26,10,6,6,0,0,4,10,0,0,0,0,0,0,0,0,0,0,0,0,2,1,0,79930,32001,6391,42099,0
1,26,1,1,1,0,0,0,1,0,0,0,0,0,0,0,0,0,0,0,0,2,1,0,79930,32001,6391,42099,0
1,26,14,10,10,0,0,4,14,1,1,1,1,2,2,0,2,0,1,0,0,2,1,0,79930,32001,6391,42100,0
1,26,46,26,30,3,0,12,49,3,6,3,6,9,9,20,28,1,42,2,0,2,1,0,79940,32001,6391,42101,0
1,7,2,2,2,0,0,0,2,0,0,0,0,0,0,0,0,0,0,0,0,2,1,0,79940,32001,6391,42101,0
1,24,127,75,83,2,11,30,129,4,14,7,14,18,21,61,87,2,175,9,0,2,1,0,79940,32001,6391,42102,0
1,24,652,304,544,16,6,88,668,6,89,51,101,95,152,591,998,3,3399,188,0,2,1,0,79940,32002,6391,42103,0
1,24,2,2,2,0,0,0,2,0,0,0,0,0,0,0,0,0,0,0,0,2,1,0,79940,32002,6391,42103,0
1,24,8,5,5,0,0,3,8,0,0,0,0,0,0,0,0,0,0,0,0,2,1,0,79940,32002,6391,42104,0
1,24,2,2,2,0,0,0,2,0,0,0,0,0,0,0,0,0,0,0,0,2,1,0,79940,32002,6391,42104,0
1,24,14,8,8,0,0,6,14,0,0,0,0,0,0,0,0,0,0,0,0,2,1,0,79940,32002,6391,42105,0
1,24,6,4,4,0,0,2,6,0,0,0,0,0,0,0,0,0,0,0,0,2,1,0,79940,32002,6391,42106,0
1,24,6,4,4,0,0,2,6,1,2,1,2,3,3,2,4,0,2,0,0,2,1,0,79940,32002,6391,42107,0
1,24,6,4,4,0,0,2,6,0,0,0,0,0,0,0,0,0,0,0,0,2,1,0,79940,32002,6391,42108,0
1,24,7,5,5,0,0,2,7,0,0,0,0,0,0,0,0,0,0,0,0,2,1,0,79940,32002,6391,42109,0
1,24,6,4,4,0,0,2,6,0,0,0,0,0,0,0,0,0,0,0,0,2,1,0,79940,32002,6391,42110,0
1,24,10,6,6,0,0,4,10,0,0,0,0,0,0,0,0,0,0,0,0,2,1,0,79940,32002,6391,42111,0
1,24,1,1,1,0,0,0,1,0,0,0,0,0,0,0,0,0,0,0,0,2,1,0,79940,32002,6391,42111,0
1,24,14,10,10,0,0,4,14,1,1,1,1,2,2,0,2,0,1,0,0,2,1,0,79940,32002,6391,42112,0
1,24,46,26,30,3,0,12,49,3,6,3,6,9,9,20,28,1,42,2,0,2,1,0,79950,32002,6391,42113,0
1,7,2,2,2,0,0,0,2,0,0,0,0,0,0,0,0,0,0,0,0,2,1,0,79950,32002,6391,42113,0
3,33,15,9,9,0,0,6,15,0,0,0,0,0,0,0,0,0,0,0,0,2,1,0,79950,32002,6391,42114,0
1,13,127,75,83,2,11,30,129,4,14,7,14,18,21,61,87,2,175,9,0,2,1,0,79950,32002,6391,42115,0
1,13,652,304,544,16,6,88,668,6,89,51,101,95,152,591,998,3,3399,188,0,2,1,0,79950,32003,6391,42116,0
1,13,2,2,2,0,0,0,2,0,0,0,0,0,0,0,0,0,0,0,0,2,1,0,79950,32003,6391,42116,0
1,13,8,5,5,0,0,3,8,0,0,0,0,0,0,0,0,0,0,0,0,2,1,0,79950,32003,6391,42117,0
1,13,2,2,2,0,0,0,2,0,0,0,0,0,0,0,0,0,0,0,0,2,1,0,79950,32003,6391,42117,0
1,13,14,8,8,0,0,6,14,0,0,0,0,0,0,0,0,0,0,0,0,2,1,0,79950,32003,6391,42118,0
1,13,6,4,4,0,0,2,6,0,0,0,0,0,0,0,0,0,0,0,0,2,1,0,79950,32003,6391,42119,0
1,13,6,4,4,0,0,2,6,1,2,1,2,3,3,2,4,0,2,0,0,2,1,0,79950,32003,6391,42120,0
1,13,6,4,4,0,0,2,6,0,0,0,0,0,0,0,0,0,0,0,0,2,1,0,79950,32003,6391,42121,0
1,13,7,5,5,0,0,2,7,0,0,0,0,0,0,0,0,0,0,0,0,2,1,0,79950,32003,6391,42122,0
1,13,6,4,4,0,0,2,6,0,0,0,0,0,0,0,0,0,0,0,0,2,1,0,79950,32003,6391,42123,0
1,13,10,6,6,0,0,4,10,0,0,0,0,0,0,0,0,0,0,0,0,2,1,0,79950,32003,6391,42124,0
1,13,1,1,1,0,0,0,1,0,0,0,0,0,0,0,0,0,0,0,0,2,1,0,79950,32003,6391,42124,0
1,13,14,10,10,0,0,4,14,1,1,1,1,2,2,0,2,0,1,0,0,2,1,0,79950,32003,6391,42125,0
1,13,46,26,30,3,0,12,49,3,6,3,6,9,9,20,28,1,42,2,0,2,1,0,79960,32003,6391,42126,0
1,16,127,75,83,2,11,30,129,4,14,7,14,18,21,61,87,2,175,9,0,2,1,0,79960,32003,6391,42127,0
1,16,652,304,544,16,6,88,668,6,89,51,101,95,152,591,998,3,3399,188,0,2,1,0,79960,32004,6391,42128,0
1,16,2,2,2,0,0,0,2,0,0,0,0,0,0,0,0,0,0,0,0,2,1,0,79960,32004,6391,42128,0
1,16,8,5,5,0,0,3,8,0,0,0,0,0,0,0,0,0,0,0,0,2,1,0,79960,32004,6391,42129,0
1,16,2,2,2,0,0,0,2,0,0,0,0,0,0,0,0,0,0,0,0,2,1,0,79960,32004,6391,42129,0
1,16,14,8,8,0,0,6,14,0,0,0,0,0,0,0,0,0,0,0,0,2,1,0,79960,32004,6391,42130,0
1,16,6,4,4,0,0,2,6,0,0,0,0,0,0,0,0,0,0,0,0,2,1,0,79960,32004,6391,42131,0
1,16,6,4,4,0,0,2,6,1,2,1,2,3,3,2,4,0,2,0,0,2,1,0,79960,32004,6391,42132,0
1,16,6,4,4,0,0,2,6,0,0,0,0,0,0,0,0,0,0,0,0,2,1,0,79960,32004,6391,42133,0
1,16,7,5,5,0,0,2,7,0,0,0,0,0,0,0,0,0,0,0,0,2,1,0,79960,32004,6391,42134,0
1,16,6,4,4,0,0,2,6,0,0,0,0,0,0,0,0,0,0,0,0,2,1,0,79960,32004,6391,42135,0
1,16,10,6,6,0,0,4,10,0,0,0,0,0,0,0,0,0,0,0,0,2,1,0,79960,32004,6391,42136,0
1,16,1,1,1,0,0,0,1,0,0,0,0,0,0,0,0,0,0,0,0,2,1,0,79960,32004,6391,42136,0
1,16,14,10,10,0,0,4,14,1,1,1,1,2,2,0,2,0,1,0,0,2,1,0,79960,32004,6391,42137,0
1,16,46,26,30,3,0,12,49,3,6,3,6,9,9,20,28,1,42,2,0,2,1,0,79970,32004,6391,42138,0
1,10,2,2,2,0,0,0,2,1,2,1,2,3,3,2,4,0,2,0,0,2,1,0,79970,32004,6391,42138,0
1,13,127,75,83,2,11,30,129,4,14,7,14,18,21,61,87,2,175,9,0,2,1,0,79970,32004,6391,42139,0
1,13,652,304,544,16,6,88,668,6,89,51,101,95,152,591,998,3,3399,188,0,2,1,0,79970,32005,6391,42140,0
1,13,2,2,2,0,0,0,2,0,0,0,0,0,0,0,0,0,0,0,0,2,1,0,79970,32005,6391,42140,0
1,13,8,5,5,0,0,3,8,0,0,0,0,0,0,0,0,0,0,0,0,2,1,0,79970,32005,6391,42141,0
1,13,2,2,2,0,0,0,2,0,0,0,0,0,0,0,0,0,0,0,0,2,1,0,79970,32005,6391,42141,0
1,13,14,8,8,0,0,6,14,0,0,0,0,0,0,0,0,0,0,0,0,2,1,0,79970,32005,6391,42142,0
1,13,6,4,4,0,0,2,6,0,0,0,0,0,0,0,0,0,0,0,0,2,1,0,79970,32005,6391,42143,0
1,13,6,4,4,0,0,2,6,1,2,1,2,3,3,2,4,0,2,0,0,2,1,0,79970,32005,6391,42144,0
1,13,6,4,4,0,0,2,6,0,0,0,0,0,0,0,0,0,0,0,0,2,1,0,79970,32005,6391,42145,0
1,13,7,5,5,0,0,2,7,0,0,0,0,0,0,0,0,0,0,0,0,2,1,0,79970,32005,6391,42146,0
1,13,6,4,4,0,0,2,6,0,0,0,0,0,0,0,0,0,0,0,0,2,1,0,79970,32005,6391,42147,0
1,13,10,6,6,0,0,4,10,0,0,0,0,0,0,0,0,0,0,0,0,2,1,0,79970,32005,6391,42148,0
1,13,1,1,1,0,0,0,1,0,0,0,0,0,0,0,0,0,0,0,0,2,1,0,79970,32005,6391,42148,0
1,13,14,10,10,0,0,4,14,1,1,1,1,2,2,0,2,0,1,0,0,2,1,0,79970,32005,6391,42149,0
1,13,46,26,30,3,0,12,49,3,6,3,6,9,9,20,28,1,42,2,0,2,1,0,79980,32005,6391,42150,0
2,26,10,6,6,0,0,4,10,2,4,2,4,6,6,10,15,1,15,0,0,2,1,0,79980,32005,6391,42151,0
3,47,15,10,10,0,0,5,15,2,4,2,4,6,6,10,15,1,15,0,0,2,1,0,79980,32005,6391,42152,0
3,39,15,9,9,0,0,6,15,0,0,0,0,0,0,0,0,0,0,0,0,2,1,0,79980,32005,6391,42153,0
2,36,10,7,7,0,0,3,10,1,2,1,2,3,3,2,4,0,2,0,0,2,1,0,79980,32005,6391,42154,0
3,46,15,9,9,0,0,6,15,1,4,2,4,5,6,8,13,0,6,0,0,2,1,0,79980,32005,6391,42155,0
2,21,10,6,6,0,0,4,10,0,0,0,0,0,0,0,0,0,0,0,0,2,1,0,79980,32005,6391,42156,0
4,61,20,12,12,0,0,8,20,1,2,1,2,3,3,2,4,0,2,0,0,2,1,0,79980,32005,6391,42157,0
2,51,127,75,83,2,11,30,129,4,14,7,14,18,21,61,87,2,175,9,0,2,1,0,79980,32005,6391,42158,0
2,51,652,304,544,16,6,88,668,6,89,51,101,95,152,591,998,3,3399,188,0,2,1,0,79980,32006,6391,42159,0
2,51,2,2,2,0,0,0,2,0,0,0,0,0,0,0,0,0,0,0,0,2,1,0,79980,32006,6391,42159,0
2,51,8,5,5,0,0,3,8,0,0,0,0,0,0,0,0,0,0,0,0,2,1,0,79980,32006,6391,42160,0
2,51,2,2,2,0,0,0,2,0,0,0,0,0,0,0,0,0,0,0,0,2,1,0,79980,32006,6391,42160,0
2,51,14,8,8,0,0,6,14,0,0,0,0,0,0,0,0,0,0,0,0,2,1,0,79980,32006,6391,42161,0
2,51,6,4,4,0,0,2,6,0,0,0,0,0,0,0,0,0,0,0,0,2,1,0,79980,32006,6391,42162,0
2,51,6,4,4,0,0,2,6,1,2,1,2,3,3,2,4,0,2,0,0,2,1,0,79980,32006,6391,42163,0
2,51,6,4,4,0,0,2,6,0,0,0,0,0,0,0,0,0,0,0,0,2,1,0,79980,32006,6391,42164,0
2,51,7,5,5,0,0,2,7,0,0,0,0,0,0,0,0,0,0,0,0,2,1,0,79980,32006,6391,42165,0
2,51,6,4,4,0,0,2,6,0,0,0,0,0,0,0,0,0,0,0,0,2,1,0,79980,32006,6391,42166,0
2,51,10,6,6,0,0,4,10,0,0,0,0,0,0,0,0,0,0,0,0,2,1,0,79980,32006,6391,42167,0
2,51,1,1,1,0,0,0,1,0,0,0,0,0,0,0,0,0,0,0,0,2,1,0,79980,32006,6391,42167,0
2,51,14,10,10,0,0,4,14,1,1,1,1,2,2,0,2,0,1,0,0,2,1,0,79980,32006,6391,42168,0
2,51,46,26,30,3,0,12,49,3,6,3,6,9,9,20,28,1,42,2,0,2,1,0,79990,32006,6391,42169,0
1,6,2,2,2,0,0,0,2,0,0,0,0,0,0,0,0,0,0,0,0,2,1,0,79990,32006,6391,42169,0
8,263,51,25,36,0,0,15,51,3,11,6,12,14,18,42,68,1,112,6,0,2,1,0,79990,32006,6391,42170,0
1,14,6,4,4,0,0,2,6,0,0,0,0,0,0,0,0,0,0,0,0,2,1,0,79990,32006,6391,42171,0
4,163,27,21,21,0,0,6,27,3,6,3,6,9,9,20,28,1,42,2,0,2,1,0,79990,32006,6391,42172,0
1,6,2,2,2,0,0,0,2,0,0,0,0,0,0,0,0,0,0,0,0,2,1,0,79990,32006,6391,42172,0
1,41,7,5,5,0,0,2,7,1,2,1,2,3,3,2,4,0,2,0,0,2,1,0,79990,32006,6391,42173,0
2,51,14,9,9,0,0,5,14,0,0,0,0,0,0,0,0,0,0,0,0,2,1,0,79990,32006,6391,42174,0
2,40,13,9,8,0,0,4,13,0,0,0,0,0,0,0,0,0,0,0,0,2,1,0,79990,32006,6391,42175,0
2,42,14,10,9,0,0,4,14,0,0,0,0,0,0,0,0,0,0,0,0,2,1,0,79990,32006,6391,42176,0
2,33,12,8,7,0,0,4,12,0,0,0,0,0,0,0,0,0,0,0,0,2,1,0,79990,32006,6391,42177,0
3,49,16,9,9,0,0,7,16,0,0,0,0,0,0,0,0,0,0,0,0,2,1,0,79990,32006,6391,42178,0
1,18,3,3,3,0,0,0,3,0,0,0,0,0,0,0,0,0,0,0,0,2,1,0,79990,32006,6391,42178,0
2,26,6,4,4,0,0,2,6,1,4,2,4,5,6,8,13,0,6,0,0,2,1,0,79990,32006,6391,42180,0
12,318,149,95,105,2,0,41,151,8,54,28,55,62,83,334,494,4,2013,111,0,2,1,1,79990,32006,6391,42182,0
15,703,139,89,101,2,0,35,141,7,54,34,62,61,96,330,569,4,2287,127,0,2,1,1,79990,32006,6391,42183,0
1,134,149,67,118,4,0,27,153,1,17,14,28,18,42,69,175,0,144,8,0,2,1,0,79990,32006,6391,42184,0
36,2427,1157,318,931,29,22,177,1186,6,104,63,125,110,188,712,1274,3,4596,255,0,2,2,2,79990,32006,6391,42185,0
66,4392,520,294,400,33,13,81,553,10,261,204,367,271,571,2128,4614,7,32445,1802,1,2,1,1,79990,32007,6391,42186,0
90,3974,1338,495,1086,10,64,173,1348,11,122,82,157,133,239,883,1686,7,11934,663,0,2,3,3,79990,32009,6391,42187,0
171,7566,4293,999,3693,19,54,507,4312,9,155,88,170,164,258,1156,1898,4,9368,520,0,2,1,1,79990,32011,6391,42188,0
171,7566,1482,859,1002,125,135,219,1607,16,219,134,251,235,385,1766,3032,9,27804,1544,1,2,1,1,80000,32012,6391,42189,0
33,999,465,148,393,5,8,60,470,4,31,20,31,35,51,161,261,2,523,29,0,2,1,0,80000,32013,6391,42190,0
33,999,16,12,9,0,0,6,16,1,2,1,2,3,3,2,4,0,2,0,0,2,1,0,80000,32013,6391,42191,0
126,5520,1782,648,1425,9,47,279,1791,8,171,97,189,179,286,1292,2140,4,9462,525,0,2,1,1,80000,32014,6392,42192,0
33,1041,256,139,192,9,7,47,265,4,23,12,24,27,36,112,171,2,357,19,0,2,1,0,80000,32015,6392,42193,0
6,328,180,34,164,0,0,16,180,1,12,6,12,13,18,43,66,0,33,1,0,2,1,1,80000,32015,6392,42194,0
23,613,102,59,69,5,3,24,107,6,22,15,28,28,43,113,206,3,789,43,0,2,1,0,80000,32015,6392,42195,0
128,5170,1450,624,1228,12,26,181,1462,14,306,186,354,320,540,2580,4493,8,36391,2021,1,2,2,2,80000,32017,6393,42196,0
176,5307,1660,832,1314,41,38,274,1701,20,312,209,395,332,604,2671,5058,12,64042,3557,1,2,4,4,80000,32019,6394,42198,0
48,3659,996,429,845,24,10,117,1020,7,76,50,88,83,138,494,879,4,3565,198,0,2,1,0,80000,32021,6394,42199,0
125,5389,1513,682,1277,25,13,200,1538,11,199,116,219,210,335,1557,2584,6,15641,868,0,2,2,2,80000,32023,6394,42200,0
85,4936,1296,573,1062,40,33,157,1336,8,201,118,231,209,349,1561,2689,4,12365,686,0,2,1,0,80000,32023,6394,42201,0
21,500,207,111,150,11,0,50,218,5,26,19,36,31,55,133,272,3,943,52,0,2,1,0,80000,32023,6394,42202,0
103,5336,1457,730,1242,11,6,188,1468,10,292,166,329,302,495,2424,4078,5,22973,1276,1,2,1,0,80000,32025,6394,42203,0
43,2690,652,304,544,16,6,88,668,6,89,51,101,95,152,591,998,3,3399,188,0,2,1,0,80000,32026,6394,42204,0
72,3310,1455,414,1257,16,76,112,1471,5,41,23,46,46,69,231,381,2,1069,59,0,2,3,3,80000,32027,6394,42205,0
2,79,7,6,5,0,0,2,7,1,1,1,2,2,3,0,3,1,3,0,0,2,1,0,80000,32027,6394,42206,0
8,275,74,35,59,1,0,14,75,3,14,7,14,17,21,58,85,1,128,7,0,2,1,0,80000,32028,6394,42207,0
107,5109,1523,757,1297,19,12,193,1542,12,193,117,230,205,347,1508,2664,7,19053,1058,0,2,1,1,80010,32030,6394,42208,0
70,3187,1020,354,843,12,15,144,1032,8,134,77,144,142,221,970,1580,4,6792,377,0,2,1,0,80010,32030,6394,42209,0
47,2189,447,308,343,6,5,95,453,7,96,59,111,103,170,651,1136,4,4600,255,0,2,1,0,80010,32033,6394,42210,0
3,229,53,23,39,0,0,13,53,2,8,4,8,10,12,26,39,1,39,2,0,2,1,0,80010,32033,6394,42211,0
21,655,424,94,331,4,0,89,428,1,5,5,5,6,10,11,25,0,12,0,0,2,2,2,80010,32034,6394,42212,0
38,2327,334,251,279,10,4,40,344,5,127,74,143,132,217,899,1528,2,4303,239,0,2,1,0,80010,32035,6394,42213,0
12,497,184,100,137,2,15,30,186,6,38,20,39,44,59,214,322,3,991,55,0,2,2,2,80010,32036,6394,42214,0
8,377,91,45,69,0,3,18,91,3,9,6,10,12,16,33,57,1,95,5,0,2,1,0,80010,32038,6394,42215,0
75,3895,1293,570,1093,25,15,163,1318,10,195,123,241,205,364,1516,2795,6,17273,959,0,2,1,0,80020,32040,6394,42216,0
29,1903,384,251,317,7,8,52,391,11,70,44,84,81,128,467,811,6,5355,297,0,2,2,2,80020,32040,6394,42217,0
55,2800,722,423,573,19,0,135,741,12,172,101,199,184,300,1320,2257,6,15668,870,0,2,1,1,80020,32042,6394,42219,0
45,1953,386,256,301,16,9,68,402,4,59,35,69,63,104,355,621,2,1453,80,0,2,1,0,80020,32042,6394,42220,0
28,1596,466,257,367,18,25,50,484,7,126,86,171,133,257,898,1813,4,8612,478,0,2,1,0,80020,32042,6394,42221,0
15,1066,215,129,180,6,0,29,221,8,65,43,72,73,115,415,711,4,3153,175,0,2,1,0,80020,32042,6394,42222,0
86,3411,1043,504,840,53,9,147,1096,9,180,112,198,189,310,1377,2344,4,11604,644,0,2,3,3,80020,32044,6394,42223,0
12,478,295,56,236,0,4,54,295,2,9,5,10,11,15,30,51,1,57,3,0,2,1,0,80020,32046,6394,42224,0
30,1440,373,158,315,8,0,51,381,5,76,44,79,81,123,486,779,2,2026,112,0,2,1,0,80020,32046,6394,42225,0
80,3144,1178,367,1042,6,15,115,1184,9,94,51,95,103,146,644,976,4,4439,246,0,2,1,1,80020,32046,6394,42226,0
9,449,219,78,157,11,5,46,230,3,24,20,34,27,54,114,256,2,545,30,0,2,1,0,80020,32047,6394,42227,0
111,6122,1943,715,1694,26,18,214,1969,12,185,120,237,197,357,1436,2721,7,20915,1161,0,2,1,1,80020,32049,6394,42228,0
37,1519,442,244,305,14,16,103,456,11,68,45,75,79,120,452,756,6,4588,254,0,2,1,0,80020,32051,6394,42229,0
52,1986,1098,241,925,5,10,155,1103,7,46,25,49,53,74,273,423,3,1580,87,0,2,1,0,80030,32053,6394,42230,0
53,1862,601,196,481,2,23,85,603,8,63,36,72,71,108,400,664,4,3036,168,0,2,4,4,80030,32053,6394,42231,0
164,3518,1513,682,1277,25,13,200,1538,11,199,116,219,210,335,1557,2584,6,15641,868,0,2,4,0,80030,32055,6394,42232,0
164,3518,819,519,539,24,98,155,843,15,96,57,106,111,163,690,1107,8,9171,509,0,2,4,0,80040,32057,6394,42233,0
126,5406,1513,682,1277,25,13,200,1538,11,199,116,219,210,335,1557,2584,6,15641,868,0,2,3,0,80040,32059,6394,42234,0
282,5915,1943,715,1694,26,18,214,1969,12,185,120,237,197,357,1436,2721,7,20915,1161,0,2,9,1,80040,32061,6394,42235,0
282,5915,1168,838,957,57,25,144,1225,19,348,224,416,367,640,3018,5452,11,61921,3440,1,2,9,1,80050,32063,6394,42236,0
282,5915,1943,715,1694,26,18,214,1969,12,185,120,237,197,357,1436,2721,7,20915,1161,0,2,9,1,80050,32065,6394,42237,0
282,5915,1168,838,957,57,25,144,1225,19,348,224,416,367,640,3018,5452,11,61921,3440,1,2,9,1,80060,32067,6394,42238,0
164,3518,1513,682,1277,25,13,200,1538,11,199,116,219,210,335,1557,2584,6,15641,868,0,2,4,0,80060,32069,6394,42239,0
164,3518,819,519,539,24,98,155,843,15,96,57,106,111,163,690,1107,8,9171,509,0,2,4,0,80070,32071,6394,42240,0
282,5915,1943,715,1694,26,18,214,1969,12,185,120,237,197,357,1436,2721,7,20915,1161,0,2,9,1,80070,32073,6394,42241,0
282,5915,1168,838,957,57,25,144,1225,19,348,224,416,367,640,3018,5452,11,61921,3440,1,2,9,1,80080,32075,6394,42242,0
126,5406,1513,682,1277,25,13,200,1538,11,199,116,219,210,335,1557,2584,6,15641,868,0,2,3,0,80080,32077,6394,42243,0
164,3518,1513,682,1277,25,13,200,1538,11,199,116,219,210,335,1557,2584,6,15641,868,0,2,4,0,80080,32079,6394,42244,0
164,3518,819,519,539,24,98,155,843,15,96,57,106,111,163,690,1107,8,9171,509,0,2,4,0,80090,32081,6394,42245,0
282,5915,1943,715,1694,26,18,214,1969,12,185,120,237,197,357,1436,2721,7,20915,1161,0,2,9,1,80090,32083,6394,42246,0
282,5915,1168,838,957,57,25,144,1225,19,348,224,416,367,640,3018,5452,11,61921,3440,1,2,9,1,80100,32085,6394,42247,0
126,5406,1513,682,1277,25,13,200,1538,11,199,116,219,210,335,1557,2584,6,15641,868,0,2,3,0,80100,32087,6394,42248,0
129,5191,1450,624,1228,12,26,181,1462,14,306,186,354,320,540,2580,4493,8,36391,2021,1,2,4,1,80100,32089,6395,42249,0
184,5563,1660,832,1314,41,38,274,1701,20,312,209,395,332,604,2671,5058,12,64042,3557,1,2,4,1,80100,32091,6396,42251,0
184,5563,1057,646,719,113,100,145,1170,18,215,134,248,233,382,1740,3004,10,31186,1732,1,2,4,1,80110,32092,6397,42252,0
236,4942,2,2,2,0,0,0,2,0,0,0,0,0,0,0,0,0,0,0,0,2,3,3,80110,32092,6397,42252,0
236,4942,99,48,90,1,3,5,100,0,0,0,0,0,0,0,0,0,0,0,0,2,3,3,80110,32093,6397,42253,0
236,4942,8,5,5,2,0,1,10,0,0,0,0,0,0,0,0,0,0,0,0,2,3,3,80110,32093,6397,42254,0
236,4942,1217,716,841,84,126,174,1301,14,185,118,215,199,333,1446,2542,8,20687,1149,0,2,3,3,80120,32095,6397,42255,0
236,4942,160,89,115,0,13,31,160,7,15,11,17,22,28,78,124,3,495,27,0,2,3,3,80120,32095,6397,42256,0
236,4942,10,10,9,9,0,0,19,0,0,0,0,0,0,0,0,0,0,0,0,2,3,3,80120,32095,6398,42257,0
236,4942,173,84,99,8,29,36,181,5,12,7,13,17,20,54,81,2,221,12,0,2,3,3,80120,32096,6398,42258,0
236,4942,3,1,1,3,0,0,6,0,0,0,0,0,0,0,0,0,0,0,0,2,3,3,80120,32096,6398,42259,0
249,5765,4293,999,3693,19,54,507,4312,9,155,88,170,164,258,1156,1898,4,9368,520,0,2,9,0,80120,32098,6398,42260,0
249,5765,1482,859,1002,125,135,219,1607,16,219,134,251,235,385,1766,3032,9,27804,1544,1,2,9,0,80130,32099,6398,42261,0
314,6910,72,33,56,0,4,12,72,1,1,1,1,2,2,0,2,0,1,0,0,2,1,6,80130,32099,6398,42262,0
314,6910,1454,835,1044,76,110,219,1530,17,275,158,296,292,454,2297,3718,9,34017,1889,1,2,1,6,80140,32100,6398,42263,0
104,5361,1457,730,1242,11,6,188,1468,10,292,166,329,302,495,2424,4078,5,22973,1276,1,2,11,0,80140,32102,6398,42264,0
229,4960,182,127,129,0,0,53,182,5,39,21,42,44,63,217,343,2,926,51,0,2,5,4,80140,32102,6399,42265,0
229,4960,1165,710,800,67,119,181,1232,18,243,153,282,261,435,2000,3492,10,36473,2026,1,2,5,4,80150,32102,6400,42266,0
92,1886,757,253,292,73,244,162,830,13,61,38,67,74,105,409,651,7,4654,258,0,2,1,1,80150,32103,6400,42267,0
229,4960,182,127,129,0,0,53,182,5,39,21,42,44,63,217,343,2,926,51,0,2,5,4,80150,32103,6401,42268,0
229,4960,1165,710,800,67,119,181,1232,18,243,153,282,261,435,2000,3492,10,36473,2026,1,2,5,4,80160,32103,6402,42269,0
92,1886,757,253,292,73,244,162,830,13,61,38,67,74,105,409,651,7,4654,258,0,2,1,1,80160,32104,6402,42270,0
20,534,205,80,86,16,53,53,221,7,18,10,19,25,29,94,134,3,497,27,0,2,5,5,80170,32104,6403,42271,0
81,3172,1178,367,1042,6,15,115,1184,9,94,51,95,103,146,644,976,4,4439,246,0,2,8,0,80170,32104,6403,42272,0
314,6932,72,33,56,0,4,12,72,1,1,1,1,2,2,0,2,0,1,0,0,2,1,1,80170,32104,6403,42273,0
314,6932,1454,835,1044,76,110,219,1530,17,275,158,296,292,454,2297,3718,9,34017,1889,1,2,1,1,80180,32105,6403,42274,0
144,5944,1782,648,1425,9,47,279,1791,8,171,97,189,179,286,1292,2140,4,9462,525,0,2,96,0,80180,32106,6404,42275,0
314,6932,72,33,56,0,4,12,72,1,1,1,1,2,2,0,2,0,1,0,0,2,1,1,80180,32106,6404,42276,0
314,6932,1454,835,1044,76,110,219,1530,17,275,158,296,292,454,2297,3718,9,34017,1889,1,2,1,1,80190,32107,6404,42277,0
144,5944,1782,648,1425,9,47,279,1791,8,171,97,189,179,286,1292,2140,4,9462,525,0,2,96,0,80190,32108,6405,42278,0
51,1442,339,213,244,17,9,65,356,10,42,26,48,52,74,259,421,5,2410,133,0,2,12,15,80200,32108,6405,42279,0
77,3944,1293,570,1093,25,15,163,1318,10,195,123,241,205,364,1516,2795,6,17273,959,0,2,15,5,80210,32110,6405,42280,0
166,3529,1513,682,1277,25,13,200,1538,11,199,116,219,210,335,1557,2584,6,15641,868,0,2,5,4,80210,32112,6405,42281,0
166,3529,819,519,539,24,98,155,843,15,96,57,106,111,163,690,1107,8,9171,509,0,2,5,4,80220,32114,6405,42282,0
31,1087,74,35,59,1,0,14,75,3,14,7,14,17,21,58,85,1,128,7,0,2,28,4,80220,32115,6405,42283,0
31,1087,245,125,200,5,7,34,250,7,30,17,34,37,51,166,265,3,1053,58,0,2,28,4,80230,32116,6405,42284,0
282,5915,1943,715,1694,26,18,214,1969,12,185,120,237,197,357,1436,2721,7,20915,1161,0,2,1,1,80230,32118,6405,42285,0
282,5915,1168,838,957,57,25,144,1225,19,348,224,416,367,640,3018,5452,11,61921,3440,1,2,1,1,80240,32120,6405,42286,0
111,6122,1943,715,1694,26,18,214,1969,12,185,120,237,197,357,1436,2721,7,20915,1161,0,2,1,1,80240,32122,6405,42287,0
184,5563,1660,832,1314,41,38,274,1701,20,312,209,395,332,604,2671,5058,12,64042,3557,1,2,4,1,80240,32124,6406,42289,0
184,5563,1057,646,719,113,100,145,1170,18,215,134,248,233,382,1740,3004,10,31186,1732,1,2,4,1,80250,32125,6407,42290,0
236,4942,2,2,2,0,0,0,2,0,0,0,0,0,0,0,0,0,0,0,0,2,3,3,80250,32125,6407,42290,0
236,4942,99,48,90,1,3,5,100,0,0,0,0,0,0,0,0,0,0,0,0,2,3,3,80250,32126,6407,42291,0
236,4942,8,5,5,2,0,1,10,0,0,0,0,0,0,0,0,0,0,0,0,2,3,3,80250,32126,6407,42292,0
236,4942,1217,716,841,84,126,174,1301,14,185,118,215,199,333,1446,2542,8,20687,1149,0,2,3,3,80260,32128,6407,42293,0
236,4942,160,89,115,0,13,31,160,7,15,11,17,22,28,78,124,3,495,27,0,2,3,3,80260,32128,6407,42294,0
236,4942,10,10,9,9,0,0,19,0,0,0,0,0,0,0,0,0,0,0,0,2,3,3,80260,32128,6408,42295,0
236,4942,173,84,99,8,29,36,181,5,12,7,13,17,20,54,81,2,221,12,0,2,3,3,80260,32129,6408,42296,0
236,4942,3,1,1,3,0,0,6,0,0,0,0,0,0,0,0,0,0,0,0,2,3,3,80260,32129,6408,42297,0
249,5765,4293,999,3693,19,54,507,4312,9,155,88,170,164,258,1156,1898,4,9368,520,0,2,9,0,80260,32131,6408,42298,0
249,5765,1482,859,1002,125,135,219,1607,16,219,134,251,235,385,1766,3032,9,27804,1544,1,2,9,0,80270,32132,6408,42299,0
314,6912,72,33,56,0,4,12,72,1,1,1,1,2,2,0,2,0,1,0,0,2,1,6,80270,32132,6408,42300,0
314,6912,1454,835,1044,76,110,219,1530,17,275,158,296,292,454,2297,3718,9,34017,1889,1,2,1,6,80280,32133,6408,42301,0
104,5361,1457,730,1242,11,6,188,1468,10,292,166,329,302,495,2424,4078,5,22973,1276,1,2,11,0,80280,32135,6408,42302,0
20,534,205,80,86,16,53,53,221,7,18,10,19,25,29,94,134,3,497,27,0,2,5,5,80290,32135,6409,42303,0
81,3172,1178,367,1042,6,15,115,1184,9,94,51,95,103,146,644,976,4,4439,246,0,2,8,0,80290,32135,6409,42304,0
76,3910,1293,570,1093,25,15,163,1318,10,195,123,241,205,364,1516,2795,6,17273,959,0,2,16,12,80300,32137,6409,42305,0
3,42,14,8,8,0,0,6,14,0,0,0,0,0,0,0,0,0,0,0,0,2,1,0,80300,32137,6409,42308,0
2,40,9,6,6,0,0,3,9,0,0,0,0,0,0,0,0,0,0,0,0,2,1,0,80300,32137,6409,42309,0
2,40,13,9,8,0,0,4,13,0,0,0,0,0,0,0,0,0,0,0,0,2,1,0,80300,32137,6409,42310,0
60,1163,282,196,195,3,0,86,285,8,130,71,141,138,212,936,1507,4,6538,363,0,2,1,0,80310,32138,6410,42324,0
4,77,127,75,83,2,11,30,129,4,14,7,14,18,21,61,87,2,175,9,0,2,1,0,80310,32138,6410,42325,0
4,77,652,304,544,16,6,88,668,6,89,51,101,95,152,591,998,3,3399,188,0,2,1,0,80310,32139,6410,42326,0
4,77,2,2,2,0,0,0,2,0,0,0,0,0,0,0,0,0,0,0,0,2,1,0,80310,32139,6410,42326,0
4,77,8,5,5,0,0,3,8,0,0,0,0,0,0,0,0,0,0,0,0,2,1,0,80310,32139,6410,42327,0
4,77,2,2,2,0,0,0,2,0,0,0,0,0,0,0,0,0,0,0,0,2,1,0,80310,32139,6410,42327,0
4,77,14,8,8,0,0,6,14,0,0,0,0,0,0,0,0,0,0,0,0,2,1,0,80310,32139,6410,42328,0
4,77,6,4,4,0,0,2,6,0,0,0,0,0,0,0,0,0,0,0,0,2,1,0,80310,32139,6410,42329,0
4,77,6,4,4,0,0,2,6,1,2,1,2,3,3,2,4,0,2,0,0,2,1,0,80310,32139,6410,42330,0
4,77,6,4,4,0,0,2,6,0,0,0,0,0,0,0,0,0,0,0,0,2,1,0,80310,32139,6410,42331,0
4,77,7,5,5,0,0,2,7,0,0,0,0,0,0,0,0,0,0,0,0,2,1,0,80310,32139,6410,42332,0
4,77,6,4,4,0,0,2,6,0,0,0,0,0,0,0,0,0,0,0,0,2,1,0,80310,32139,6410,42333,0
4,77,10,6,6,0,0,4,10,0,0,0,0,0,0,0,0,0,0,0,0,2,1,0,80310,32139,6410,42334,0
4,77,1,1,1,0,0,0,1,0,0,0,0,0,0,0,0,0,0,0,0,2,1,0,80310,32139,6410,42334,0
4,77,14,10,10,0,0,4,14,1,1,1,1,2,2,0,2,0,1,0,0,2,1,0,80310,32139,6410,42335,0
4,77,46,26,30,3,0,12,49,3,6,3,6,9,9,20,28,1,42,2,0,2,1,0,80320,32139,6410,42336,0
1,9,5,3,3,0,0,2,5,0,0,0,0,0,0,0,0,0,0,0,0,2,1,0,80320,32139,6410,42336,0
1,90,13,10,10,0,0,3,13,1,2,1,2,3,3,2,4,0,2,0,0,2,1,0,80320,32139,6410,42337,0
7,114,44,19,17,0,16,11,44,3,14,7,14,17,21,58,85,1,128,7,0,2,1,0,80320,32139,6410,42338,0
3,66,127,75,83,2,11,30,129,4,14,7,14,18,21,61,87,2,175,9,0,2,1,0,80330,32140,6410,42351,0
3,66,652,304,544,16,6,88,668,6,89,51,101,95,152,591,998,3,3399,188,0,2,1,0,80330,32141,6410,42352,0
3,66,2,2,2,0,0,0,2,0,0,0,0,0,0,0,0,0,0,0,0,2,1,0,80330,32141,6410,42352,0
3,66,8,5,5,0,0,3,8,0,0,0,0,0,0,0,0,0,0,0,0,2,1,0,80330,32141,6410,42353,0
3,66,2,2,2,0,0,0,2,0,0,0,0,0,0,0,0,0,0,0,0,2,1,0,80330,32141,6410,42353,0
3,66,14,8,8,0,0,6,14,0,0,0,0,0,0,0,0,0,0,0,0,2,1,0,80330,32141,6410,42354,0
3,66,6,4,4,0,0,2,6,0,0,0,0,0,0,0,0,0,0,0,0,2,1,0,80330,32141,6410,42355,0
3,66,6,4,4,0,0,2,6,1,2,1,2,3,3,2,4,0,2,0,0,2,1,0,80330,32141,6410,42356,0
3,66,6,4,4,0,0,2,6,0,0,0,0,0,0,0,0,0,0,0,0,2,1,0,80330,32141,6410,42357,0
3,66,7,5,5,0,0,2,7,0,0,0,0,0,0,0,0,0,0,0,0,2,1,0,80330,32141,6410,42358,0
3,66,6,4,4,0,0,2,6,0,0,0,0,0,0,0,0,0,0,0,0,2,1,0,80330,32141,6410,42359,0
3,66,10,6,6,0,0,4,10,0,0,0,0,0,0,0,0,0,0,0,0,2,1,0,80330,32141,6410,42360,0
3,66,1,1,1,0,0,0,1,0,0,0,0,0,0,0,0,0,0,0,0,2,1,0,80330,32141,6410,42360,0
3,66,14,10,10,0,0,4,14,1,1,1,1,2,2,0,2,0,1,0,0,2,1,0,80330,32141,6410,42361,0
3,66,46,26,30,3,0,12,49,3,6,3,6,9,9,20,28,1,42,2,0,2,1,0,80340,32141,6410,42362,0
7,296,72,33,56,0,4,12,72,1,1,1,1,2,2,0,2,0,1,0,0,2,1,0,80360,32149,6412,42377,0
12,229,127,75,83,2,11,30,129,4,14,7,14,18,21,61,87,2,175,9,0,2,1,0,80360,32149,6412,42378,0
12,229,652,304,544,16,6,88,668,6,89,51,101,95,152,591,998,3,3399,188,0,2,1,0,80360,32150,6412,42379,0
12,229,2,2,2,0,0,0,2,0,0,0,0,0,0,0,0,0,0,0,0,2,1,0,80360,32150,6412,42379,0
12,229,8,5,5,0,0,3,8,0,0,0,0,0,0,0,0,0,0,0,0,2,1,0,80360,32150,6412,42380,0
12,229,2,2,2,0,0,0,2,0,0,0,0,0,0,0,0,0,0,0,0,2,1,0,80360,32150,6412,42380,0
12,229,14,8,8,0,0,6,14,0,0,0,0,0,0,0,0,0,0,0,0,2,1,0,80360,32150,6412,42381,0
12,229,6,4,4,0,0,2,6,0,0,0,0,0,0,0,0,0,0,0,0,2,1,0,80360,32150,6412,42382,0
12,229,6,4,4,0,0,2,6,1,2,1,2,3,3,2,4,0,2,0,0,2,1,0,80360,32150,6412,42383,0
12,229,6,4,4,0,0,2,6,0,0,0,0,0,0,0,0,0,0,0,0,2,1,0,80360,32150,6412,42384,0
12,229,7,5,5,0,0,2,7,0,0,0,0,0,0,0,0,0,0,0,0,2,1,0,80360,32150,6412,42385,0
12,229,6,4,4,0,0,2,6,0,0,0,0,0,0,0,0,0,0,0,0,2,1,0,80360,32150,6412,42386,0
12,229,10,6,6,0,0,4,10,0,0,0,0,0,0,0,0,0,0,0,0,2,1,0,80360,32150,6412,42387,0
12,229,1,1,1,0,0,0,1,0,0,0,0,0,0,0,0,0,0,0,0,2,1,0,80360,32150,6412,42387,0
12,229,14,10,10,0,0,4,14,1,1,1,1,2,2,0,2,0,1,0,0,2,1,0,80360,32150,6412,42388,0
12,229,46,26,30,3,0,12,49,3,6,3,6,9,9,20,28,1,42,2,0,2,1,0,80370,32150,6412,42389,0
6,71,127,75,83,2,11,30,129,4,14,7,14,18,21,61,87,2,175,9,0,2,1,0,80370,32150,6412,42390,0
6,71,652,304,544,16,6,88,668,6,89,51,101,95,152,591,998,3,3399,188,0,2,1,0,80370,32151,6412,42391,0
6,71,2,2,2,0,0,0,2,0,0,0,0,0,0,0,0,0,0,0,0,2,1,0,80370,32151,6412,42391,0
6,71,8,5,5,0,0,3,8,0,0,0,0,0,0,0,0,0,0,0,0,2,1,0,80370,32151,6412,42392,0
6,71,2,2,2,0,0,0,2,0,0,0,0,0,0,0,0,0,0,0,0,2,1,0,80370,32151,6412,42392,0
6,71,14,8,8,0,0,6,14,0,0,0,0,0,0,0,0,0,0,0,0,2,1,0,80370,32151,6412,42393,0
6,71,6,4,4,0,0,2,6,0,0,0,0,0,0,0,0,0,0,0,0,2,1,0,80370,32151,6412,42394,0
6,71,6,4,4,0,0,2,6,1,2,1,2,3,3,2,4,0,2,0,0,2,1,0,80370,32151,6412,42395,0
6,71,6,4,4,0,0,2,6,0,0,0,0,0,0,0,0,0,0,0,0,2,1,0,80370,32151,6412,42396,0
6,71,7,5,5,0,0,2,7,0,0,0,0,0,0,0,0,0,0,0,0,2,1,0,80370,32151,6412,42397,0
6,71,6,4,4,0,0,2,6,0,0,0,0,0,0,0,0,0,0,0,0,2,1,0,80370,32151,6412,42398,0
6,71,10,6,6,0,0,4,10,0,0,0,0,0,0,0,0,0,0,0,0,2,1,0,80370,32151,6412,42399,0
6,71,1,1,1,0,0,0,1,0,0,0,0,0,0,0,0,0,0,0,0,2,1,0,80370,32151,6412,42399,0
6,71,14,10,10,0,0,4,14,1,1,1,1,2,2,0,2,0,1,0,0,2,1,0,80370,32151,6412,42400,0
6,71,46,26,30,3,0,12,49,3,6,3,6,9,9,20,28,1,42,2,0,2,1,0,80380,32151,6412,42401,0
3,26,14,7,7,2,0,5,16,0,0,0,0,0,0,0,0,0,0,0,0,2,1,0,80380,32151,6412,42401,0
7,103,38,23,23,0,0,15,38,0,0,0,0,0,0,0,0,0,0,0,0,2,1,0,80380,32151,6412,42402,0
17,378,85,59,61,8,0,16,93,5,18,10,18,23,28,86,126,2,316,17,0,2,1,0,80380,32151,6412,42403,0
12,515,124,78,88,2,3,26,126,4,13,7,13,17,20,56,81,2,163,9,0,2,1,0,80380,32151,6412,42406,0
1,96,42,7,35,4,0,5,46,1,2,1,2,3,3,2,4,0,2,0,0,2,1,0,80380,32151,6412,42407,0
1,96,11,6,10,0,0,1,11,2,4,2,4,6,6,10,15,1,15,0,0,2,1,0,80380,32151,6412,42408,0
11,242,19,8,11,5,0,4,24,2,5,3,6,7,9,13,25,1,30,1,0,2,1,0,80390,32155,6413,42416,0
11,242,102,59,69,5,3,24,107,6,22,15,28,28,43,113,206,3,789,43,0,2,1,0,80390,32155,6413,42417,0
11,242,106,40,36,3,49,17,109,8,17,13,23,25,36,93,167,5,904,50,0,2,1,0,80390,32155,6413,42418,0
229,4960,182,127,129,0,0,53,182,5,39,21,42,44,63,217,343,2,926,51,0,2,1,0,80400,32159,6415,42426,0
229,4960,1165,710,800,67,119,181,1232,18,243,153,282,261,435,2000,3492,10,36473,2026,1,2,1,0,80410,32159,6416,42427,0
67,1570,773,419,590,28,0,166,801,10,204,113,217,214,330,1598,2554,5,13587,754,0,2,1,0,80410,32159,6417,42428,0
67,1570,421,273,302,44,34,57,465,17,81,59,107,98,166,583,1098,11,12329,684,0,2,1,0,80410,32159,6418,42429,0
14,411,149,95,105,2,0,41,151,8,54,28,55,62,83,334,494,4,2013,111,0,2,1,0,80410,32159,6418,42430,0
14,411,82,56,54,0,13,15,82,4,13,8,16,17,24,56,98,2,241,13,0,2,1,0,80420,32159,6418,42431,0
26,529,2,2,2,0,0,0,2,0,0,0,0,0,0,0,0,0,0,0,0,2,1,0,80420,32159,6418,42431,0
26,529,99,48,90,1,3,5,100,0,0,0,0,0,0,0,0,0,0,0,0,2,1,0,80420,32160,6418,42432,0
26,529,8,5,5,2,0,1,10,0,0,0,0,0,0,0,0,0,0,0,0,2,1,0,80420,32160,6418,42433,0
26,529,1217,716,841,84,126,174,1301,14,185,118,215,199,333,1446,2542,8,20687,1149,0,2,1,0,80430,32162,6418,42434,0
26,529,160,89,115,0,13,31,160,7,15,11,17,22,28,78,124,3,495,27,0,2,1,0,80430,32162,6418,42435,0
26,529,10,10,9,9,0,0,19,0,0,0,0,0,0,0,0,0,0,0,0,2,1,0,80430,32162,6419,42436,0
26,529,173,84,99,8,29,36,181,5,12,7,13,17,20,54,81,2,221,12,0,2,1,0,80430,32163,6419,42437,0
26,529,3,1,1,3,0,0,6,0,0,0,0,0,0,0,0,0,0,0,0,2,1,0,80430,32163,6419,42438,0
184,5563,1660,832,1314,41,38,274,1701,20,312,209,395,332,604,2671,5058,12,64042,3557,1,2,1,0,80430,32165,6420,42440,0
184,5563,1057,646,719,113,100,145,1170,18,215,134,248,233,382,1740,3004,10,31186,1732,1,2,1,0,80440,32166,6421,42441,0
17,348,95,58,50,9,16,20,104,12,33,24,45,45,69,209,378,8,3100,172,0,2,1,0,80440,32166,6421,42442,0
116,2173,477,336,357,30,23,73,507,16,194,134,250,210,384,1538,2962,10,30538,1696,0,2,1,0,80450,32167,6421,42443,0
89,2050,996,429,845,24,10,117,1020,7,76,50,88,83,138,494,879,4,3565,198,0,2,1,0,80450,32169,6421,42444,0
89,2050,456,277,329,12,42,72,468,13,85,50,97,98,147,592,972,7,7212,400,0,2,1,0,80450,32169,6421,42445,0
164,3518,1513,682,1277,25,13,200,1538,11,199,116,219,210,335,1557,2584,6,15641,868,0,2,1,0,80450,32171,6421,42446,0
164,3518,819,519,539,24,98,155,843,15,96,57,106,111,163,690,1107,8,9171,509,0,2,1,0,80460,32173,6421,42447,0
73,1518,207,111,150,11,0,50,218,5,26,19,36,31,55,133,272,3,943,52,0,2,1,0,80460,32173,6421,42448,0
73,1518,410,198,237,31,55,97,441,11,63,38,72,74,110,414,683,6,4293,238,0,2,1,0,80470,32174,6422,42449,0
236,4942,2,2,2,0,0,0,2,0,0,0,0,0,0,0,0,0,0,0,0,2,1,0,80470,32174,6422,42449,0
236,4942,99,48,90,1,3,5,100,0,0,0,0,0,0,0,0,0,0,0,0,2,1,0,80470,32175,6422,42450,0
236,4942,8,5,5,2,0,1,10,0,0,0,0,0,0,0,0,0,0,0,0,2,1,0,80470,32175,6422,42451,0
236,4942,1217,716,841,84,126,174,1301,14,185,118,215,199,333,1446,2542,8,20687,1149,0,2,1,0,80480,32177,6422,42452,0
236,4942,160,89,115,0,13,31,160,7,15,11,17,22,28,78,124,3,495,27,0,2,1,0,80480,32177,6422,42453,0
236,4942,10,10,9,9,0,0,19,0,0,0,0,0,0,0,0,0,0,0,0,2,1,0,80480,32177,6423,42454,0
236,4942,173,84,99,8,29,36,181,5,12,7,13,17,20,54,81,2,221,12,0,2,1,0,80480,32178,6423,42455,0
236,4942,3,1,1,3,0,0,6,0,0,0,0,0,0,0,0,0,0,0,0,2,1,0,80480,32178,6423,42456,0
98,2019,463,295,324,28,62,57,491,12,134,82,154,146,236,989,1696,6,11700,650,0,2,1,0,80490,32179,6423,42457,0
55,770,167,116,138,4,5,22,171,8,48,30,56,56,86,292,499,4,2330,129,0,2,1,0,80490,32179,6423,42458,0
52,1464,339,213,244,17,9,65,356,10,42,26,48,52,74,259,421,5,2410,133,0,2,1,0,80500,32179,6423,42459,0
95,2385,1455,414,1257,16,76,112,1471,5,41,23,46,46,69,231,381,2,1069,59,0,2,1,0,80500,32180,6423,42461,0
95,2385,669,365,481,22,61,110,691,15,103,63,122,118,185,747,1273,8,11311,628,0,2,1,0,80510,32180,6424,42462,0
249,5765,4293,999,3693,19,54,507,4312,9,155,88,170,164,258,1156,1898,4,9368,520,0,2,1,0,80510,32182,6424,42463,0
249,5765,1482,859,1002,125,135,219,1607,16,219,134,251,235,385,1766,3032,9,27804,1544,1,2,1,0,80520,32183,6424,42464,0
6,140,44,22,19,0,19,6,44,2,10,6,12,12,18,35,64,1,77,4,0,2,1,0,80520,32183,6424,42465,0
28,981,74,35,59,1,0,14,75,3,14,7,14,17,21,58,85,1,128,7,0,2,1,0,80520,32184,6424,42466,0
28,981,245,125,200,5,7,34,250,7,30,17,34,37,51,166,265,3,1053,58,0,2,1,0,80530,32185,6424,42467,0
54,657,647,139,84,35,284,233,682,0,0,0,0,0,0,0,0,0,0,0,0,2,1,0,80530,32185,6424,42468,0
115,3128,1523,757,1297,19,12,193,1542,12,193,117,230,205,347,1508,2664,7,19053,1058,0,2,1,0,80540,32187,6424,42469,0
115,3128,701,378,504,33,58,109,734,13,110,68,126,123,194,794,1346,7,10027,557,0,2,1,0,80540,32188,6425,42470,0
101,2612,773,422,505,30,103,129,803,14,77,46,83,91,129,535,839,7,6334,351,0,2,1,0,80550,32189,6426,42471,0
159,3785,77,34,69,0,0,8,77,3,24,16,29,27,45,114,213,1,387,21,0,2,1,0,80550,32189,6426,42472,0
159,3785,712,438,573,51,9,84,763,14,102,71,128,116,199,733,1364,8,11988,666,0,2,1,0,80560,32190,6426,42473,0
24,612,2,2,2,0,0,0,2,0,0,0,0,0,0,0,0,0,0,0,0,2,1,0,80560,32190,6426,42473,0
24,612,99,48,90,1,3,5,100,0,0,0,0,0,0,0,0,0,0,0,0,2,1,0,80560,32191,6426,42474,0
24,612,8,5,5,2,0,1,10,0,0,0,0,0,0,0,0,0,0,0,0,2,1,0,80560,32191,6426,42475,0
24,612,1217,716,841,84,126,174,1301,14,185,118,215,199,333,1446,2542,8,20687,1149,0,2,1,0,80570,32193,6426,42476,0
24,612,160,89,115,0,13,31,160,7,15,11,17,22,28,78,124,3,495,27,0,2,1,0,80570,32193,6426,42477,0
24,612,10,10,9,9,0,0,19,0,0,0,0,0,0,0,0,0,0,0,0,2,1,0,80570,32193,6427,42478,0
24,612,173,84,99,8,29,36,181,5,12,7,13,17,20,54,81,2,221,12,0,2,1,0,80570,32194,6427,42479,0
24,612,3,1,1,3,0,0,6,0,0,0,0,0,0,0,0,0,0,0,0,2,1,0,80570,32194,6427,42480,0
30,664,125,97,103,3,0,19,128,9,25,17,27,34,44,144,223,4,1087,60,0,2,1,0,80570,32194,6428,42481,0
22,373,102,57,55,5,16,25,107,5,17,10,18,22,28,81,124,2,330,18,0,2,1,0,80570,32194,6428,42482,0
69,1527,402,202,227,24,74,80,426,12,52,33,61,64,94,339,564,7,3969,220,0,2,1,0,80570,32195,6428,42483,0
55,1174,447,308,343,6,5,95,453,7,96,59,111,103,170,651,1136,4,4600,255,0,2,1,0,80570,32198,6428,42484,0
55,1174,322,174,179,16,74,51,338,10,41,26,46,51,72,252,408,5,2291,127,0,2,1,0,80570,32201,6429,42485,0
75,1629,53,23,39,0,0,13,53,2,8,4,8,10,12,26,39,1,39,2,0,2,1,0,80570,32201,6429,42486,0
75,1629,515,298,307,33,80,99,548,12,63,44,77,75,121,419,753,7,5527,307,0,2,1,0,80580,32201,6429,42487,0
18,312,424,94,331,4,0,89,428,1,5,5,5,6,10,11,25,0,12,0,0,2,1,0,80580,32202,6429,42488,0
18,312,38,23,23,6,0,8,44,3,11,7,11,14,18,42,68,1,102,5,0,2,1,0,80580,32202,6429,42489,0
20,531,205,80,86,16,53,53,221,7,18,10,19,25,29,94,134,3,497,27,0,2,1,0,80590,32202,6430,42490,0
17,523,184,100,137,2,15,30,186,6,38,20,39,44,59,214,322,3,991,55,0,2,1,0,80590,32203,6430,42491,0
17,523,103,65,74,8,5,16,111,7,17,9,17,24,26,89,119,3,417,23,0,2,1,0,80590,32204,6430,42492,0
59,1228,91,45,69,0,3,18,91,3,9,6,10,12,16,33,57,1,95,5,0,2,1,0,80590,32206,6430,42493,0
59,1228,367,234,237,17,34,68,384,16,55,34,61,71,95,381,584,8,5183,287,0,2,1,0,80590,32207,6430,42494,0
231,5969,722,423,573,19,0,135,741,12,172,101,199,184,300,1320,2257,6,15668,870,0,2,1,0,80590,32209,6430,42496,0
231,5969,1508,847,911,44,250,301,1552,14,148,88,169,162,257,1120,1886,7,15077,837,0,2,1,0,80590,32210,6431,42497,0
314,6912,72,33,56,0,4,12,72,1,1,1,1,2,2,0,2,0,1,0,0,2,1,0,80590,32210,6431,42498,0
314,6912,1454,835,1044,76,110,219,1530,17,275,158,296,292,454,2297,3718,9,34017,1889,1,2,1,0,80600,32211,6431,42499,0
92,1886,757,253,292,73,244,162,830,13,61,38,67,74,105,409,651,7,4654,258,0,2,1,0,80600,32212,6431,42500,0
45,953,386,256,301,16,9,68,402,4,59,35,69,63,104,355,621,2,1453,80,0,2,1,0,80600,32212,6431,42501,0
45,953,264,131,164,11,41,46,275,6,38,22,40,44,62,214,338,3,1068,59,0,2,1,0,80610,32212,6432,42502,0
67,1753,466,257,367,18,25,50,484,7,126,86,171,133,257,898,1813,4,8612,478,0,2,1,0,80610,32212,6432,42503,0
67,1753,507,281,342,29,59,88,536,10,53,29,57,63,86,336,514,5,2764,153,0,2,1,0,80610,32212,6432,42504,0
25,552,215,129,180,6,0,29,221,8,65,43,72,73,115,415,711,4,3153,175,0,2,1,0,80610,32212,6432,42505,0
25,552,97,69,77,3,3,16,100,6,22,13,23,28,36,113,173,3,542,30,0,2,1,0,80610,32213,6432,42506,0
89,1894,1043,504,840,53,9,147,1096,9,180,112,198,189,310,1377,2344,4,11604,644,0,2,1,0,80610,32215,6432,42507,0
89,1894,383,288,292,26,6,62,409,11,65,38,67,76,105,429,656,5,3719,206,0,2,1,0,80610,32216,6432,42508,0
20,420,294,64,250,0,0,43,294,1,20,10,20,21,30,86,131,0,65,3,0,2,1,0,80610,32216,6432,42509,0
20,420,78,46,62,3,0,14,81,3,8,4,8,11,12,28,41,1,62,3,0,2,1,0,80610,32217,6432,42510,0
5,123,110,30,77,3,13,16,113,4,21,15,30,25,45,100,208,2,597,33,0,2,1,0,80610,32217,6432,42511,0
5,123,28,15,21,1,0,6,29,0,0,0,0,0,0,0,0,0,0,0,0,2,1,0,80610,32217,6432,42512,0
41,821,1178,367,1042,6,15,115,1184,9,94,51,95,103,146,644,976,4,4439,246,0,2,1,1,80610,32217,6432,42513,0
41,821,177,108,140,8,0,27,185,6,30,16,32,36,48,162,248,3,794,44,0,2,1,1,80610,32219,6432,42514,0
28,452,219,78,157,11,5,46,230,3,24,20,34,27,54,114,256,2,545,30,0,2,1,0,80610,32220,6432,42515,0
28,452,108,64,79,9,0,20,117,5,15,11,19,20,30,70,129,3,410,22,0,2,1,0,80610,32220,6432,42516,0
282,5915,1943,715,1694,26,18,214,1969,12,185,120,237,197,357,1436,2721,7,20915,1161,0,2,1,1,80610,32222,6432,42517,0
282,5915,1168,838,957,57,25,144,1225,19,348,224,416,367,640,3018,5452,11,61921,3440,1,2,1,1,80620,32224,6432,42518,0
19,720,442,244,305,14,16,103,456,11,68,45,75,79,120,452,756,6,4588,254,0,2,1,0,80620,32226,6432,42519,0
19,720,182,102,99,11,40,35,193,3,11,6,11,14,17,42,64,1,97,5,0,2,1,0,80620,32227,6432,42520,0
69,1323,1098,241,925,5,10,155,1103,7,46,25,49,53,74,273,423,3,1580,87,0,2,1,0,80630,32229,6432,42521,0
69,1323,282,202,222,14,2,44,296,8,42,24,43,50,67,250,378,4,1548,86,0,2,1,0,80630,32230,6432,42522,0
2,156,37,13,25,0,6,6,37,1,2,1,2,3,3,2,4,0,2,0,0,2,1,0,80630,32230,6432,42523,0
2,156,133,47,40,1,43,49,134,0,0,0,0,0,0,0,0,0,0,0,0,2,1,0,80630,32230,6432,42524,0
29,743,601,196,481,2,23,85,603,8,63,36,72,71,108,400,664,4,3036,168,0,2,1,0,80630,32230,6432,42525,0
29,743,156,79,106,5,16,28,161,5,14,8,15,19,23,64,97,2,261,14,0,2,1,0,80630,32230,6432,42526,0
36,1120,182,127,129,0,0,53,182,5,39,21,42,44,63,217,343,2,926,51,0,2,1,1,80630,32230,6433,42527,0
7,123,127,75,83,2,11,30,129,4,14,7,14,18,21,61,87,2,175,9,0,2,1,0,80630,32230,6433,42528,0
7,123,652,304,544,16,6,88,668,6,89,51,101,95,152,591,998,3,3399,188,0,2,1,0,80630,32231,6433,42529,0
7,123,2,2,2,0,0,0,2,0,0,0,0,0,0,0,0,0,0,0,0,2,1,0,80630,32231,6433,42529,0
7,123,8,5,5,0,0,3,8,0,0,0,0,0,0,0,0,0,0,0,0,2,1,0,80630,32231,6433,42530,0
7,123,2,2,2,0,0,0,2,0,0,0,0,0,0,0,0,0,0,0,0,2,1,0,80630,32231,6433,42530,0
7,123,14,8,8,0,0,6,14,0,0,0,0,0,0,0,0,0,0,0,0,2,1,0,80630,32231,6433,42531,0
7,123,6,4,4,0,0,2,6,0,0,0,0,0,0,0,0,0,0,0,0,2,1,0,80630,32231,6433,42532,0
7,123,6,4,4,0,0,2,6,1,2,1,2,3,3,2,4,0,2,0,0,2,1,0,80630,32231,6433,42533,0
7,123,6,4,4,0,0,2,6,0,0,0,0,0,0,0,0,0,0,0,0,2,1,0,80630,32231,6433,42534,0
7,123,7,5,5,0,0,2,7,0,0,0,0,0,0,0,0,0,0,0,0,2,1,0,80630,32231,6433,42535,0
7,123,6,4,4,0,0,2,6,0,0,0,0,0,0,0,0,0,0,0,0,2,1,0,80630,32231,6433,42536,0
7,123,10,6,6,0,0,4,10,0,0,0,0,0,0,0,0,0,0,0,0,2,1,0,80630,32231,6433,42537,0
7,123,1,1,1,0,0,0,1,0,0,0,0,0,0,0,0,0,0,0,0,2,1,0,80630,32231,6433,42537,0
7,123,14,10,10,0,0,4,14,1,1,1,1,2,2,0,2,0,1,0,0,2,1,0,80630,32231,6433,42538,0
7,123,46,26,30,3,0,12,49,3,6,3,6,9,9,20,28,1,42,2,0,2,1,0,80640,32231,6433,42539,0
14,845,75,38,59,1,3,12,76,2,4,2,4,6,6,10,15,1,15,0,0,2,1,0,80640,32231,6433,42540,0
2,67,16,12,9,0,0,6,16,1,2,1,2,3,3,2,4,0,2,0,0,2,1,0,80640,32231,6433,42541,0
1,6,2,2,2,0,0,0,2,0,0,0,0,0,0,0,0,0,0,0,0,2,1,0,80640,32231,6433,42541,0
1,6,99,48,90,1,3,5,100,0,0,0,0,0,0,0,0,0,0,0,0,2,1,0,80640,32232,6433,42542,0
1,6,8,5,5,2,0,1,10,0,0,0,0,0,0,0,0,0,0,0,0,2,1,0,80640,32232,6433,42543,0
1,6,1217,716,841,84,126,174,1301,14,185,118,215,199,333,1446,2542,8,20687,1149,0,2,1,0,80650,32234,6433,42544,0
1,6,160,89,115,0,13,31,160,7,15,11,17,22,28,78,124,3,495,27,0,2,1,0,80650,32234,6433,42545,0
1,6,10,10,9,9,0,0,19,0,0,0,0,0,0,0,0,0,0,0,0,2,1,0,80650,32234,6434,42546,0
1,6,173,84,99,8,29,36,181,5,12,7,13,17,20,54,81,2,221,12,0,2,1,0,80650,32235,6434,42547,0
1,6,3,1,1,3,0,0,6,0,0,0,0,0,0,0,0,0,0,0,0,2,1,0,80650,32235,6434,42548,0
1,6,2,2,2,0,0,0,2,0,0,0,0,0,0,0,0,0,0,0,0,2,1,0,80650,32235,6434,42548,0
1,8,127,75,83,2,11,30,129,4,14,7,14,18,21,61,87,2,175,9,0,2,1,0,80650,32235,6434,42549,0
1,8,652,304,544,16,6,88,668,6,89,51,101,95,152,591,998,3,3399,188,0,2,1,0,80650,32236,6434,42550,0
1,8,2,2,2,0,0,0,2,0,0,0,0,0,0,0,0,0,0,0,0,2,1,0,80650,32236,6434,42550,0
1,8,8,5,5,0,0,3,8,0,0,0,0,0,0,0,0,0,0,0,0,2,1,0,80650,32236,6434,42551,0
1,8,2,2,2,0,0,0,2,0,0,0,0,0,0,0,0,0,0,0,0,2,1,0,80650,32236,6434,42551,0
1,8,14,8,8,0,0,6,14,0,0,0,0,0,0,0,0,0,0,0,0,2,1,0,80650,32236,6434,42552,0
1,8,6,4,4,0,0,2,6,0,0,0,0,0,0,0,0,0,0,0,0,2,1,0,80650,32236,6434,42553,0
1,8,6,4,4,0,0,2,6,1,2,1,2,3,3,2,4,0,2,0,0,2,1,0,80650,32236,6434,42554,0
1,8,6,4,4,0,0,2,6,0,0,0,0,0,0,0,0,0,0,0,0,2,1,0,80650,32236,6434,42555,0
1,8,7,5,5,0,0,2,7,0,0,0,0,0,0,0,0,0,0,0,0,2,1,0,80650,32236,6434,42556,0
1,8,6,4,4,0,0,2,6,0,0,0,0,0,0,0,0,0,0,0,0,2,1,0,80650,32236,6434,42557,0
1,8,10,6,6,0,0,4,10,0,0,0,0,0,0,0,0,0,0,0,0,2,1,0,80650,32236,6434,42558,0
1,8,1,1,1,0,0,0,1,0,0,0,0,0,0,0,0,0,0,0,0,2,1,0,80650,32236,6434,42558,0
1,8,14,10,10,0,0,4,14,1,1,1,1,2,2,0,2,0,1,0,0,2,1,0,80650,32236,6434,42559,0
1,8,46,26,30,3,0,12,49,3,6,3,6,9,9,20,28,1,42,2,0,2,1,0,80660,32236,6434,42560,0
1,6,2,2,2,0,0,0,2,0,0,0,0,0,0,0,0,0,0,0,0,2,1,0,80660,32236,6434,42560,0
1,6,2,2,2,0,0,0,2,0,0,0,0,0,0,0,0,0,0,0,0,2,1,0,80670,32237,6434,42572,0
2,25,127,75,83,2,11,30,129,4,14,7,14,18,21,61,87,2,175,9,0,2,1,0,80670,32237,6434,42573,0
2,25,652,304,544,16,6,88,668,6,89,51,101,95,152,591,998,3,3399,188,0,2,1,0,80670,32238,6434,42574,0
2,25,2,2,2,0,0,0,2,0,0,0,0,0,0,0,0,0,0,0,0,2,1,0,80670,32238,6434,42574,0
2,25,8,5,5,0,0,3,8,0,0,0,0,0,0,0,0,0,0,0,0,2,1,0,80670,32238,6434,42575,0
2,25,2,2,2,0,0,0,2,0,0,0,0,0,0,0,0,0,0,0,0,2,1,0,80670,32238,6434,42575,0
2,25,14,8,8,0,0,6,14,0,0,0,0,0,0,0,0,0,0,0,0,2,1,0,80670,32238,6434,42576,0
2,25,6,4,4,0,0,2,6,0,0,0,0,0,0,0,0,0,0,0,0,2,1,0,80670,32238,6434,42577,0
2,25,6,4,4,0,0,2,6,1,2,1,2,3,3,2,4,0,2,0,0,2,1,0,80670,32238,6434,42578,0
2,25,6,4,4,0,0,2,6,0,0,0,0,0,0,0,0,0,0,0,0,2,1,0,80670,32238,6434,42579,0
2,25,7,5,5,0,0,2,7,0,0,0,0,0,0,0,0,0,0,0,0,2,1,0,80670,32238,6434,42580,0
2,25,6,4,4,0,0,2,6,0,0,0,0,0,0,0,0,0,0,0,0,2,1,0,80670,32238,6434,42581,0
2,25,10,6,6,0,0,4,10,0,0,0,0,0,0,0,0,0,0,0,0,2,1,0,80670,32238,6434,42582,0
2,25,1,1,1,0,0,0,1,0,0,0,0,0,0,0,0,0,0,0,0,2,1,0,80670,32238,6434,42582,0
2,25,14,10,10,0,0,4,14,1,1,1,1,2,2,0,2,0,1,0,0,2,1,0,80670,32238,6434,42583,0
2,25,46,26,30,3,0,12,49,3,6,3,6,9,9,20,28,1,42,2,0,2,1,0,80680,32238,6434,42584,0
1,55,14,12,10,0,0,4,14,1,2,1,2,3,3,2,4,0,2,0,0,2,1,0,80680,32238,6434,42585,0
1,58,14,12,10,0,0,4,14,1,2,1,2,3,3,2,4,0,2,0,0,2,1,0,80680,32238,6434,42586,0
1,55,14,12,10,0,0,4,14,1,2,1,2,3,3,2,4,0,2,0,0,2,1,0,80680,32238,6434,42587,0
1,77,19,18,14,0,0,5,19,1,2,1,2,3,3,2,4,0,2,0,0,2,1,0,80680,32238,6434,42588,0
2,18,10,6,6,0,0,4,10,0,0,0,0,0,0,0,0,0,0,0,0,2,1,0,80680,32238,6434,42589,0
2,36,127,75,83,2,11,30,129,4,14,7,14,18,21,61,87,2,175,9,0,2,1,0,80680,32238,6434,42590,0
2,36,652,304,544,16,6,88,668,6,89,51,101,95,152,591,998,3,3399,188,0,2,1,0,80680,32239,6434,42591,0
2,36,2,2,2,0,0,0,2,0,0,0,0,0,0,0,0,0,0,0,0,2,1,0,80680,32239,6434,42591,0
2,36,8,5,5,0,0,3,8,0,0,0,0,0,0,0,0,0,0,0,0,2,1,0,80680,32239,6434,42592,0
2,36,2,2,2,0,0,0,2,0,0,0,0,0,0,0,0,0,0,0,0,2,1,0,80680,32239,6434,42592,0
2,36,14,8,8,0,0,6,14,0,0,0,0,0,0,0,0,0,0,0,0,2,1,0,80680,32239,6434,42593,0
2,36,6,4,4,0,0,2,6,0,0,0,0,0,0,0,0,0,0,0,0,2,1,0,80680,32239,6434,42594,0
2,36,6,4,4,0,0,2,6,1,2,1,2,3,3,2,4,0,2,0,0,2,1,0,80680,32239,6434,42595,0
2,36,6,4,4,0,0,2,6,0,0,0,0,0,0,0,0,0,0,0,0,2,1,0,80680,32239,6434,42596,0
2,36,7,5,5,0,0,2,7,0,0,0,0,0,0,0,0,0,0,0,0,2,1,0,80680,32239,6434,42597,0
2,36,6,4,4,0,0,2,6,0,0,0,0,0,0,0,0,0,0,0,0,2,1,0,80680,32239,6434,42598,0
2,36,10,6,6,0,0,4,10,0,0,0,0,0,0,0,0,0,0,0,0,2,1,0,80680,32239,6434,42599,0
2,36,1,1,1,0,0,0,1,0,0,0,0,0,0,0,0,0,0,0,0,2,1,0,80680,32239,6434,42599,0
2,36,14,10,10,0,0,4,14,1,1,1,1,2,2,0,2,0,1,0,0,2,1,0,80680,32239,6434,42600,0
2,36,46,26,30,3,0,12,49,3,6,3,6,9,9,20,28,1,42,2,0,2,1,0,80690,32239,6434,42601,0
1,6,2,2,2,0,0,0,2,0,0,0,0,0,0,0,0,0,0,0,0,2,1,0,80690,32239,6434,42601,0
1,26,127,75,83,2,11,30,129,4,14,7,14,18,21,61,87,2,175,9,0,2,1,0,80690,32239,6434,42602,0
1,26,652,304,544,16,6,88,668,6,89,51,101,95,152,591,998,3,3399,188,0,2,1,0,80690,32240,6434,42603,0
1,26,2,2,2,0,0,0,2,0,0,0,0,0,0,0,0,0,0,0,0,2,1,0,80690,32240,6434,42603,0
1,26,8,5,5,0,0,3,8,0,0,0,0,0,0,0,0,0,0,0,0,2,1,0,80690,32240,6434,42604,0
1,26,2,2,2,0,0,0,2,0,0,0,0,0,0,0,0,0,0,0,0,2,1,0,80690,32240,6434,42604,0
1,26,14,8,8,0,0,6,14,0,0,0,0,0,0,0,0,0,0,0,0,2,1,0,80690,32240,6434,42605,0
1,26,6,4,4,0,0,2,6,0,0,0,0,0,0,0,0,0,0,0,0,2,1,0,80690,32240,6434,42606,0
1,26,6,4,4,0,0,2,6,1,2,1,2,3,3,2,4,0,2,0,0,2,1,0,80690,32240,6434,42607,0
1,26,6,4,4,0,0,2,6,0,0,0,0,0,0,0,0,0,0,0,0,2,1,0,80690,32240,6434,42608,0
1,26,7,5,5,0,0,2,7,0,0,0,0,0,0,0,0,0,0,0,0,2,1,0,80690,32240,6434,42609,0
1,26,6,4,4,0,0,2,6,0,0,0,0,0,0,0,0,0,0,0,0,2,1,0,80690,32240,6434,42610,0
1,26,10,6,6,0,0,4,10,0,0,0,0,0,0,0,0,0,0,0,0,2,1,0,80690,32240,6434,42611,0
1,26,1,1,1,0,0,0,1,0,0,0,0,0,0,0,0,0,0,0,0,2,1,0,80690,32240,6434,42611,0
1,26,14,10,10,0,0,4,14,1,1,1,1,2,2,0,2,0,1,0,0,2,1,0,80690,32240,6434,42612,0
1,26,46,26,30,3,0,12,49,3,6,3,6,9,9,20,28,1,42,2,0,2,1,0,80700,32240,6434,42613,0
1,7,2,2,2,0,0,0,2,0,0,0,0,0,0,0,0,0,0,0,0,2,1,0,80700,32240,6434,42613,0
1,24,127,75,83,2,11,30,129,4,14,7,14,18,21,61,87,2,175,9,0,2,1,0,80700,32240,6434,42614,0
1,24,652,304,544,16,6,88,668,6,89,51,101,95,152,591,998,3,3399,188,0,2,1,0,80700,32241,6434,42615,0
1,24,2,2,2,0,0,0,2,0,0,0,0,0,0,0,0,0,0,0,0,2,1,0,80700,32241,6434,42615,0
1,24,8,5,5,0,0,3,8,0,0,0,0,0,0,0,0,0,0,0,0,2,1,0,80700,32241,6434,42616,0
1,24,2,2,2,0,0,0,2,0,0,0,0,0,0,0,0,0,0,0,0,2,1,0,80700,32241,6434,42616,0
1,24,14,8,8,0,0,6,14,0,0,0,0,0,0,0,0,0,0,0,0,2,1,0,80700,32241,6434,42617,0
1,24,6,4,4,0,0,2,6,0,0,0,0,0,0,0,0,0,0,0,0,2,1,0,80700,32241,6434,42618,0
1,24,6,4,4,0,0,2,6,1,2,1,2,3,3,2,4,0,2,0,0,2,1,0,80700,32241,6434,42619,0
1,24,6,4,4,0,0,2,6,0,0,0,0,0,0,0,0,0,0,0,0,2,1,0,80700,32241,6434,42620,0
1,24,7,5,5,0,0,2,7,0,0,0,0,0,0,0,0,0,0,0,0,2,1,0,80700,32241,6434,42621,0
1,24,6,4,4,0,0,2,6,0,0,0,0,0,0,0,0,0,0,0,0,2,1,0,80700,32241,6434,42622,0
1,24,10,6,6,0,0,4,10,0,0,0,0,0,0,0,0,0,0,0,0,2,1,0,80700,32241,6434,42623,0
1,24,1,1,1,0,0,0,1,0,0,0,0,0,0,0,0,0,0,0,0,2,1,0,80700,32241,6434,42623,0
1,24,14,10,10,0,0,4,14,1,1,1,1,2,2,0,2,0,1,0,0,2,1,0,80700,32241,6434,42624,0
1,24,46,26,30,3,0,12,49,3,6,3,6,9,9,20,28,1,42,2,0,2,1,0,80710,32241,6434,42625,0
1,7,2,2,2,0,0,0,2,0,0,0,0,0,0,0,0,0,0,0,0,2,1,0,80710,32241,6434,42625,0
3,33,15,9,9,0,0,6,15,0,0,0,0,0,0,0,0,0,0,0,0,2,1,0,80710,32241,6434,42626,0
1,13,127,75,83,2,11,30,129,4,14,7,14,18,21,61,87,2,175,9,0,2,1,0,80710,32241,6434,42627,0
1,13,652,304,544,16,6,88,668,6,89,51,101,95,152,591,998,3,3399,188,0,2,1,0,80710,32242,6434,42628,0
1,13,2,2,2,0,0,0,2,0,0,0,0,0,0,0,0,0,0,0,0,2,1,0,80710,32242,6434,42628,0
1,13,8,5,5,0,0,3,8,0,0,0,0,0,0,0,0,0,0,0,0,2,1,0,80710,32242,6434,42629,0
1,13,2,2,2,0,0,0,2,0,0,0,0,0,0,0,0,0,0,0,0,2,1,0,80710,32242,6434,42629,0
1,13,14,8,8,0,0,6,14,0,0,0,0,0,0,0,0,0,0,0,0,2,1,0,80710,32242,6434,42630,0
1,13,6,4,4,0,0,2,6,0,0,0,0,0,0,0,0,0,0,0,0,2,1,0,80710,32242,6434,42631,0
1,13,6,4,4,0,0,2,6,1,2,1,2,3,3,2,4,0,2,0,0,2,1,0,80710,32242,6434,42632,0
1,13,6,4,4,0,0,2,6,0,0,0,0,0,0,0,0,0,0,0,0,2,1,0,80710,32242,6434,42633,0
1,13,7,5,5,0,0,2,7,0,0,0,0,0,0,0,0,0,0,0,0,2,1,0,80710,32242,6434,42634,0
1,13,6,4,4,0,0,2,6,0,0,0,0,0,0,0,0,0,0,0,0,2,1,0,80710,32242,6434,42635,0
1,13,10,6,6,0,0,4,10,0,0,0,0,0,0,0,0,0,0,0,0,2,1,0,80710,32242,6434,42636,0
1,13,1,1,1,0,0,0,1,0,0,0,0,0,0,0,0,0,0,0,0,2,1,0,80710,32242,6434,42636,0
1,13,14,10,10,0,0,4,14,1,1,1,1,2,2,0,2,0,1,0,0,2,1,0,80710,32242,6434,42637,0
1,13,46,26,30,3,0,12,49,3,6,3,6,9,9,20,28,1,42,2,0,2,1,0,80720,32242,6434,42638,0
1,16,127,75,83,2,11,30,129,4,14,7,14,18,21,61,87,2,175,9,0,2,1,0,80720,32242,6434,42639,0
1,16,652,304,544,16,6,88,668,6,89,51,101,95,152,591,998,3,3399,188,0,2,1,0,80720,32243,6434,42640,0
1,16,2,2,2,0,0,0,2,0,0,0,0,0,0,0,0,0,0,0,0,2,1,0,80720,32243,6434,42640,0
1,16,8,5,5,0,0,3,8,0,0,0,0,0,0,0,0,0,0,0,0,2,1,0,80720,32243,6434,42641,0
1,16,2,2,2,0,0,0,2,0,0,0,0,0,0,0,0,0,0,0,0,2,1,0,80720,32243,6434,42641,0
1,16,14,8,8,0,0,6,14,0,0,0,0,0,0,0,0,0,0,0,0,2,1,0,80720,32243,6434,42642,0
1,16,6,4,4,0,0,2,6,0,0,0,0,0,0,0,0,0,0,0,0,2,1,0,80720,32243,6434,42643,0
1,16,6,4,4,0,0,2,6,1,2,1,2,3,3,2,4,0,2,0,0,2,1,0,80720,32243,6434,42644,0
1,16,6,4,4,0,0,2,6,0,0,0,0,0,0,0,0,0,0,0,0,2,1,0,80720,32243,6434,42645,0
1,16,7,5,5,0,0,2,7,0,0,0,0,0,0,0,0,0,0,0,0,2,1,0,80720,32243,6434,42646,0
1,16,6,4,4,0,0,2,6,0,0,0,0,0,0,0,0,0,0,0,0,2,1,0,80720,32243,6434,42647,0
1,16,10,6,6,0,0,4,10,0,0,0,0,0,0,0,0,0,0,0,0,2,1,0,80720,32243,6434,42648,0
1,16,1,1,1,0,0,0,1,0,0,0,0,0,0,0,0,0,0,0,0,2,1,0,80720,32243,6434,42648,0
1,16,14,10,10,0,0,4,14,1,1,1,1,2,2,0,2,0,1,0,0,2,1,0,80720,32243,6434,42649,0
1,16,46,26,30,3,0,12,49,3,6,3,6,9,9,20,28,1,42,2,0,2,1,0,80730,32243,6434,42650,0
1,10,2,2,2,0,0,0,2,1,2,1,2,3,3,2,4,0,2,0,0,2,1,0,80730,32243,6434,42650,0
1,13,127,75,83,2,11,30,129,4,14,7,14,18,21,61,87,2,175,9,0,2,1,0,80730,32243,6434,42651,0
1,13,652,304,544,16,6,88,668,6,89,51,101,95,152,591,998,3,3399,188,0,2,1,0,80730,32244,6434,42652,0
1,13,2,2,2,0,0,0,2,0,0,0,0,0,0,0,0,0,0,0,0,2,1,0,80730,32244,6434,42652,0
1,13,8,5,5,0,0,3,8,0,0,0,0,0,0,0,0,0,0,0,0,2,1,0,80730,32244,6434,42653,0
1,13,2,2,2,0,0,0,2,0,0,0,0,0,0,0,0,0,0,0,0,2,1,0,80730,32244,6434,42653,0
1,13,14,8,8,0,0,6,14,0,0,0,0,0,0,0,0,0,0,0,0,2,1,0,80730,32244,6434,42654,0
1,13,6,4,4,0,0,2,6,0,0,0,0,0,0,0,0,0,0,0,0,2,1,0,80730,32244,6434,42655,0
1,13,6,4,4,0,0,2,6,1,2,1,2,3,3,2,4,0,2,0,0,2,1,0,80730,32244,6434,42656,0
1,13,6,4,4,0,0,2,6,0,0,0,0,0,0,0,0,0,0,0,0,2,1,0,80730,32244,6434,42657,0
1,13,7,5,5,0,0,2,7,0,0,0,0,0,0,0,0,0,0,0,0,2,1,0,80730,32244,6434,42658,0
1,13,6,4,4,0,0,2,6,0,0,0,0,0,0,0,0,0,0,0,0,2,1,0,80730,32244,6434,42659,0
1,13,10,6,6,0,0,4,10,0,0,0,0,0,0,0,0,0,0,0,0,2,1,0,80730,32244,6434,42660,0
1,13,1,1,1,0,0,0,1,0,0,0,0,0,0,0,0,0,0,0,0,2,1,0,80730,32244,6434,42660,0
1,13,14,10,10,0,0,4,14,1,1,1,1,2,2,0,2,0,1,0,0,2,1,0,80730,32244,6434,42661,0
1,13,46,26,30,3,0,12,49,3,6,3,6,9,9,20,28,1,42,2,0,2,1,0,80740,32244,6434,42662,0
2,26,10,6,6,0,0,4,10,2,4,2,4,6,6,10,15,1,15,0,0,2,1,0,80740,32244,6434,42663,0
3,47,15,10,10,0,0,5,15,2,4,2,4,6,6,10,15,1,15,0,0,2,1,0,80740,32244,6434,42664,0
3,39,15,9,9,0,0,6,15,0,0,0,0,0,0,0,0,0,0,0,0,2,1,0,80740,32244,6434,42665,0
2,36,10,7,7,0,0,3,10,1,2,1,2,3,3,2,4,0,2,0,0,2,1,0,80740,32244,6434,42666,0
3,46,15,9,9,0,0,6,15,1,4,2,4,5,6,8,13,0,6,0,0,2,1,0,80740,32244,6434,42667,0
2,21,10,6,6,0,0,4,10,0,0,0,0,0,0,0,0,0,0,0,0,2,1,0,80740,32244,6434,42668,0
4,61,20,12,12,0,0,8,20,1,2,1,2,3,3,2,4,0,2,0,0,2,1,0,80740,32244,6434,42669,0
2,51,127,75,83,2,11,30,129,4,14,7,14,18,21,61,87,2,175,9,0,2,1,0,80740,32244,6434,42670,0
2,51,652,304,544,16,6,88,668,6,89,51,101,95,152,591,998,3,3399,188,0,2,1,0,80740,32245,6434,42671,0
2,51,2,2,2,0,0,0,2,0,0,0,0,0,0,0,0,0,0,0,0,2,1,0,80740,32245,6434,42671,0
2,51,8,5,5,0,0,3,8,0,0,0,0,0,0,0,0,0,0,0,0,2,1,0,80740,32245,6434,42672,0
2,51,2,2,2,0,0,0,2,0,0,0,0,0,0,0,0,0,0,0,0,2,1,0,80740,32245,6434,42672,0
2,51,14,8,8,0,0,6,14,0,0,0,0,0,0,0,0,0,0,0,0,2,1,0,80740,32245,6434,42673,0
2,51,6,4,4,0,0,2,6,0,0,0,0,0,0,0,0,0,0,0,0,2,1,0,80740,32245,6434,42674,0
2,51,6,4,4,0,0,2,6,1,2,1,2,3,3,2,4,0,2,0,0,2,1,0,80740,32245,6434,42675,0
2,51,6,4,4,0,0,2,6,0,0,0,0,0,0,0,0,0,0,0,0,2,1,0,80740,32245,6434,42676,0
2,51,7,5,5,0,0,2,7,0,0,0,0,0,0,0,0,0,0,0,0,2,1,0,80740,32245,6434,42677,0
2,51,6,4,4,0,0,2,6,0,0,0,0,0,0,0,0,0,0,0,0,2,1,0,80740,32245,6434,42678,0
2,51,10,6,6,0,0,4,10,0,0,0,0,0,0,0,0,0,0,0,0,2,1,0,80740,32245,6434,42679,0
2,51,1,1,1,0,0,0,1,0,0,0,0,0,0,0,0,0,0,0,0,2,1,0,80740,32245,6434,42679,0
2,51,14,10,10,0,0,4,14,1,1,1,1,2,2,0,2,0,1,0,0,2,1,0,80740,32245,6434,42680,0
2,51,46,26,30,3,0,12,49,3,6,3,6,9,9,20,28,1,42,2,0,2,1,0,80750,32245,6434,42681,0
1,6,2,2,2,0,0,0,2,0,0,0,0,0,0,0,0,0,0,0,0,2,1,0,80750,32245,6434,42681,0
8,263,51,25,36,0,0,15,51,3,11,6,12,14,18,42,68,1,112,6,0,2,1,0,80750,32245,6434,42682,0
1,14,6,4,4,0,0,2,6,0,0,0,0,0,0,0,0,0,0,0,0,2,1,0,80750,32245,6434,42683,0
4,163,27,21,21,0,0,6,27,3,6,3,6,9,9,20,28,1,42,2,0,2,1,0,80750,32245,6434,42684,0
1,6,2,2,2,0,0,0,2,0,0,0,0,0,0,0,0,0,0,0,0,2,1,0,80750,32245,6434,42684,0
1,41,7,5,5,0,0,2,7,1,2,1,2,3,3,2,4,0,2,0,0,2,1,0,80750,32245,6434,42685,0
2,51,14,9,9,0,0,5,14,0,0,0,0,0,0,0,0,0,0,0,0,2,1,0,80750,32245,6434,42686,0
2,40,13,9,8,0,0,4,13,0,0,0,0,0,0,0,0,0,0,0,0,2,1,0,80750,32245,6434,42687,0
2,42,14,10,9,0,0,4,14,0,0,0,0,0,0,0,0,0,0,0,0,2,1,0,80750,32245,6434,42688,0
2,33,12,8,7,0,0,4,12,0,0,0,0,0,0,0,0,0,0,0,0,2,1,0,80750,32245,6434,42689,0
3,49,16,9,9,0,0,7,16,0,0,0,0,0,0,0,0,0,0,0,0,2,1,0,80750,32245,6434,42690,0
1,18,3,3,3,0,0,0,3,0,0,0,0,0,0,0,0,0,0,0,0,2,1,0,80750,32245,6434,42690,0
2,26,6,4,4,0,0,2,6,1,4,2,4,5,6,8,13,0,6,0,0,2,1,0,80750,32245,6434,42692,0
1,134,149,67,118,4,0,27,153,1,17,14,28,18,42,69,175,0,144,8,0,2,1,0,80750,32245,6434,42694,0
66,4392,520,294,400,33,13,81,553,10,261,204,367,271,571,2128,4614,7,32445,1802,1,2,1,1,80750,32246,6434,42695,0
90,3974,1338,495,1086,10,64,173,1348,11,122,82,157,133,239,883,1686,7,11934,663,0,2,1,1,80750,32248,6434,42696,0
33,999,465,148,393,5,8,60,470,4,31,20,31,35,51,161,261,2,523,29,0,2,1,0,80750,32249,6434,42697,0
33,999,16,12,9,0,0,6,16,1,2,1,2,3,3,2,4,0,2,0,0,2,1,0,80750,32249,6434,42698,0
33,1041,256,139,192,9,7,47,265,4,23,12,24,27,36,112,171,2,357,19,0,2,1,0,80750,32250,6434,42699,0
23,613,102,59,69,5,3,24,107,6,22,15,28,28,43,113,206,3,789,43,0,2,1,0,80750,32250,6434,42700,0
48,3659,996,429,845,24,10,117,1020,7,76,50,88,83,138,494,879,4,3565,198,0,2,1,0,80750,32252,6434,42701,0
126,5406,1513,682,1277,25,13,200,1538,11,199,116,219,210,335,1557,2584,6,15641,868,0,2,1,1,80750,32254,6434,42702,0
85,4936,1296,573,1062,40,33,157,1336,8,201,118,231,209,349,1561,2689,4,12365,686,0,2,1,0,80750,32254,6434,42703,0
21,500,207,111,150,11,0,50,218,5,26,19,36,31,55,133,272,3,943,52,0,2,1,0,80750,32254,6434,42704,0
104,5361,1457,730,1242,11,6,188,1468,10,292,166,329,302,495,2424,4078,5,22973,1276,1,2,1,0,80750,32256,6434,42705,0
43,2690,652,304,544,16,6,88,668,6,89,51,101,95,152,591,998,3,3399,188,0,2,1,0,80750,32257,6434,42706,0
72,3310,1455,414,1257,16,76,112,1471,5,41,23,46,46,69,231,381,2,1069,59,0,2,3,3,80750,32258,6434,42707,0
2,79,7,6,5,0,0,2,7,1,1,1,2,2,3,0,3,1,3,0,0,2,1,0,80750,32258,6434,42708,0
8,275,74,35,59,1,0,14,75,3,14,7,14,17,21,58,85,1,128,7,0,2,1,0,80750,32259,6434,42709,0
70,3187,1020,354,843,12,15,144,1032,8,134,77,144,142,221,970,1580,4,6792,377,0,2,1,0,80750,32259,6434,42710,0
47,2189,447,308,343,6,5,95,453,7,96,59,111,103,170,651,1136,4,4600,255,0,2,1,0,80750,32262,6434,42711,0
3,229,53,23,39,0,0,13,53,2,8,4,8,10,12,26,39,1,39,2,0,2,1,0,80750,32262,6434,42712,0
21,655,424,94,331,4,0,89,428,1,5,5,5,6,10,11,25,0,12,0,0,2,2,2,80750,32263,6434,42713,0
38,2327,334,251,279,10,4,40,344,5,127,74,143,132,217,899,1528,2,4303,239,0,2,1,0,80750,32264,6434,42714,0
12,497,184,100,137,2,15,30,186,6,38,20,39,44,59,214,322,3,991,55,0,2,2,2,80750,32265,6434,42715,0
8,377,91,45,69,0,3,18,91,3,9,6,10,12,16,33,57,1,95,5,0,2,1,0,80750,32267,6434,42716,0
75,3895,1293,570,1093,25,15,163,1318,10,195,123,241,205,364,1516,2795,6,17273,959,0,2,1,0,80760,32269,6434,42717,0
29,1903,384,251,317,7,8,52,391,11,70,44,84,81,128,467,811,6,5355,297,0,2,2,2,80760,32269,6434,42718,0
45,1953,386,256,301,16,9,68,402,4,59,35,69,63,104,355,621,2,1453,80,0,2,1,0,80760,32269,6434,42719,0
28,1596,466,257,367,18,25,50,484,7,126,86,171,133,257,898,1813,4,8612,478,0,2,1,0,80760,32269,6434,42720,0
15,1066,215,129,180,6,0,29,221,8,65,43,72,73,115,415,711,4,3153,175,0,2,1,0,80760,32269,6434,42721,0
86,3411,1043,504,840,53,9,147,1096,9,180,112,198,189,310,1377,2344,4,11604,644,0,2,1,1,80760,32271,6434,42722,0
12,478,295,56,236,0,4,54,295,2,9,5,10,11,15,30,51,1,57,3,0,2,1,0,80760,32273,6434,42723,0
30,1440,373,158,315,8,0,51,381,5,76,44,79,81,123,486,779,2,2026,112,0,2,1,0,80760,32273,6434,42724,0
80,3144,1178,367,1042,6,15,115,1184,9,94,51,95,103,146,644,976,4,4439,246,0,2,1,1,80760,32273,6434,42725,0
9,449,219,78,157,11,5,46,230,3,24,20,34,27,54,114,256,2,545,30,0,2,1,0,80760,32274,6434,42726,0
111,6122,1943,715,1694,26,18,214,1969,12,185,120,237,197,357,1436,2721,7,20915,1161,0,2,1,1,80760,32276,6434,42727,0
37,1519,442,244,305,14,16,103,456,11,68,45,75,79,120,452,756,6,4588,254,0,2,1,0,80760,32278,6434,42728,0
52,1986,1098,241,925,5,10,155,1103,7,46,25,49,53,74,273,423,3,1580,87,0,2,1,0,80770,32280,6434,42729,0
53,1862,601,196,481,2,23,85,603,8,63,36,72,71,108,400,664,4,3036,168,0,2,4,4,80770,32280,6434,42730,0
166,3529,1513,682,1277,25,13,200,1538,11,199,116,219,210,335,1557,2584,6,15641,868,0,2,5,4,80770,32282,6434,42731,0
166,3529,819,519,539,24,98,155,843,15,96,57,106,111,163,690,1107,8,9171,509,0,2,5,4,80780,32284,6434,42732,0
51,1442,339,213,244,17,9,65,356,10,42,26,48,52,74,259,421,5,2410,133,0,2,12,15,80790,32284,6434,42733,0
77,3944,1293,570,1093,25,15,163,1318,10,195,123,241,205,364,1516,2795,6,17273,959,0,2,15,5,80800,32286,6434,42734,0
129,5191,1450,624,1228,12,26,181,1462,14,306,186,354,320,540,2580,4493,8,36391,2021,1,2,4,1,80800,32288,6435,42735,0
31,1087,74,35,59,1,0,14,75,3,14,7,14,17,21,58,85,1,128,7,0,2,28,4,80800,32289,6435,42736,0
31,1087,245,125,200,5,7,34,250,7,30,17,34,37,51,166,265,3,1053,58,0,2,28,4,80810,32290,6435,42737,0
104,2698,773,422,505,30,103,129,803,14,77,46,83,91,129,535,839,7,6334,351,0,2,15,0,80820,32291,6436,42738,0
101,2612,773,422,505,30,103,129,803,14,77,46,83,91,129,535,839,7,6334,351,0,2,0,15,80830,32292,6437,42739,0
282,5915,1943,715,1694,26,18,214,1969,12,185,120,237,197,357,1436,2721,7,20915,1161,0,2,1,1,80830,32294,6437,42740,0
282,5915,1168,838,957,57,25,144,1225,19,348,224,416,367,640,3018,5452,11,61921,3440,1,2,1,1,80840,32296,6437,42741,0
111,6122,1943,715,1694,26,18,214,1969,12,185,120,237,197,357,1436,2721,7,20915,1161,0,2,1,1,80840,32298,6437,42742,0
179,5318,1660,832,1314,41,38,274,1701,20,312,209,395,332,604,2671,5058,12,64042,3557,1,2,6,0,80840,32300,6438,42744,0
186,5684,1660,832,1314,41,38,274,1701,20,312,209,395,332,604,2671,5058,12,64042,3557,1,2,18,0,80840,32302,6439,42746,0
186,5684,1057,646,719,113,100,145,1170,18,215,134,248,233,382,1740,3004,10,31186,1732,1,2,18,0,80850,32303,6440,42747,0
186,5709,1660,832,1314,41,38,274,1701,20,312,209,395,332,604,2671,5058,12,64042,3557,1,2,11,6,80850,32305,6441,42749,0
186,5709,1057,646,719,113,100,145,1170,18,215,134,248,233,382,1740,3004,10,31186,1732,1,2,11,6,80860,32306,6442,42750,0
182,5417,1660,832,1314,41,38,274,1701,20,312,209,395,332,604,2671,5058,12,64042,3557,1,2,47,0,80860,32308,6443,42752,0
277,5793,1943,715,1694,26,18,214,1969,12,185,120,237,197,357,1436,2721,7,20915,1161,0,2,6,0,80860,32310,6443,42753,0
277,5793,1168,838,957,57,25,144,1225,19,348,224,416,367,640,3018,5452,11,61921,3440,1,2,6,0,80870,32312,6443,42754,0
105,5755,1943,715,1694,26,18,214,1969,12,185,120,237,197,357,1436,2721,7,20915,1161,0,2,9,0,80870,32314,6443,42755,0
105,5753,1943,715,1694,26,18,214,1969,12,185,120,237,197,357,1436,2721,7,20915,1161,0,2,1,1,80870,32316,6443,42756,0
276,5747,1943,715,1694,26,18,214,1969,12,185,120,237,197,357,1436,2721,7,20915,1161,0,2,0,6,80870,32318,6443,42757,0
276,5747,1168,838,957,57,25,144,1225,19,348,224,416,367,640,3018,5452,11,61921,3440,1,2,0,6,80880,32320,6443,42758,0
104,5722,1943,715,1694,26,18,214,1969,12,185,120,237,197,357,1436,2721,7,20915,1161,0,2,0,9,80880,32322,6443,42759,0
187,5720,1660,832,1314,41,38,274,1701,20,312,209,395,332,604,2671,5058,12,64042,3557,1,2,1,1,80880,32324,6444,42761,0
187,5720,1057,646,719,113,100,145,1170,18,215,134,248,233,382,1740,3004,10,31186,1732,1,2,1,1,80890,32325,6445,42762,0
187,5730,1660,832,1314,41,38,274,1701,20,312,209,395,332,604,2671,5058,12,64042,3557,1,2,2,2,80890,32327,6446,42764,0
187,5730,1057,646,719,113,100,145,1170,18,215,134,248,233,382,1740,3004,10,31186,1732,1,2,2,2,80900,32328,6447,42765,0
182,5417,1660,832,1314,41,38,274,1701,20,312,209,395,332,604,2671,5058,12,64042,3557,1,2,2,2,80900,32330,6448,42767,0
182,5417,1660,832,1314,41,38,274,1701,20,312,209,395,332,604,2671,5058,12,64042,3557,1,2,2,2,80900,32332,6449,42769,0
187,5730,1660,832,1314,41,38,274,1701,20,312,209,395,332,604,2671,5058,12,64042,3557,1,2,2,2,80900,32334,6450,42771,0
187,5730,1057,646,719,113,100,145,1170,18,215,134,248,233,382,1740,3004,10,31186,1732,1,2,2,2,80910,32335,6451,42772,0
187,5730,1660,832,1314,41,38,274,1701,20,312,209,395,332,604,2671,5058,12,64042,3557,1,2,1,1,80910,32337,6452,42774,0
187,5730,1057,646,719,113,100,145,1170,18,215,134,248,233,382,1740,3004,10,31186,1732,1,2,1,1,80920,32338,6453,42775,0
189,5757,1660,832,1314,41,38,274,1701,20,312,209,395,332,604,2671,5058,12,64042,3557,1,2,2,0,80920,32340,6454,42777,0
189,5757,1057,646,719,113,100,145,1170,18,215,134,248,233,382,1740,3004,10,31186,1732,1,2,2,0,80930,32341,6455,42778,0
248,5737,4293,999,3693,19,54,507,4312,9,155,88,170,164,258,1156,1898,4,9368,520,0,2,2,4,80930,32343,6455,42779,0
248,5737,1482,859,1002,125,135,219,1607,16,219,134,251,235,385,1766,3032,9,27804,1544,1,2,2,4,80940,32344,6455,42780,0
76,3910,1293,570,1093,25,15,163,1318,10,195,123,241,205,364,1516,2795,6,17273,959,0,2,4,4,80950,32346,6455,42781,0
30,1440,373,158,315,8,0,51,381,5,76,44,79,81,123,486,779,2,2026,112,0,2,1,1,80950,32346,6455,42782,0
52,1442,339,213,244,17,9,65,356,10,42,26,48,52,74,259,421,5,2410,133,0,2,33,29,80960,32346,6455,42783,0
77,3947,1293,570,1093,25,15,163,1318,10,195,123,241,205,364,1516,2795,6,17273,959,0,2,4,3,80970,32348,6455,42784,0
1,98,42,7,35,4,0,5,46,1,2,1,2,3,3,2,4,0,2,0,0,2,3,2,80970,32348,6455,42785,1
1,98,11,6,10,0,0,1,11,2,4,2,4,6,6,10,15,1,15,0,0,2,3,2,80970,32348,6455,42786,1
181,5514,1660,832,1314,41,38,274,1701,20,312,209,395,332,604,2671,5058,12,64042,3557,1,2,0,19,80970,32350,6456,42788,1
181,5514,1057,646,719,113,100,145,1170,18,215,134,248,233,382,1740,3004,10,31186,1732,1,2,0,19,80980,32351,6457,42789,1
237,4939,2,2,2,0,0,0,2,0,0,0,0,0,0,0,0,0,0,0,0,2,7,14,80980,32351,6457,42789,1
237,4939,99,48,90,1,3,5,100,0,0,0,0,0,0,0,0,0,0,0,0,2,7,14,80980,32352,6457,42790,1
237,4939,8,5,5,2,0,1,10,0,0,0,0,0,0,0,0,0,0,0,0,2,7,14,80980,32352,6457,42791,1
237,4939,1217,716,841,84,126,174,1301,14,185,118,215,199,333,1446,2542,8,20687,1149,0,2,7,14,80990,32354,6457,42792,1
237,4939,160,89,115,0,13,31,160,7,15,11,17,22,28,78,124,3,495,27,0,2,7,14,80990,32354,6457,42793,1
237,4939,10,10,9,9,0,0,19,0,0,0,0,0,0,0,0,0,0,0,0,2,7,14,80990,32354,6458,42794,1
237,4939,173,84,99,8,29,36,181,5,12,7,13,17,20,54,81,2,221,12,0,2,7,14,80990,32355,6458,42795,1
237,4939,3,1,1,3,0,0,6,0,0,0,0,0,0,0,0,0,0,0,0,2,7,14,80990,32355,6458,42796,1
19,513,205,80,86,16,53,53,221,7,18,10,19,25,29,94,134,3,497,27,0,2,3,9,81000,32355,6459,42797,1
106,4498,1289,550,1043,56,32,155,1345,10,167,93,185,177,278,1266,2075,5,11498,638,0,2,10,21,81000,32357,6460,42798,1
129,5167,1450,624,1228,12,26,181,1462,14,306,186,354,320,540,2580,4493,8,36391,2021,1,2,20,36,81000,32359,6461,42799,1
97,5225,1457,730,1242,11,6,188,1468,10,292,166,329,302,495,2424,4078,5,22973,1276,1,2,47,74,81000,32361,6461,42800,1
2,56,7,6,5,0,0,2,7,1,1,1,2,2,3,0,3,1,3,0,0,2,4,10,81000,32361,6461,42801,1
1,98,42,7,35,4,0,5,46,1,2,1,2,3,3,2,4,0,2,0,0,2,3,2,81000,32361,6461,42802,0
1,98,11,6,10,0,0,1,11,2,4,2,4,6,6,10,15,1,15,0,0,2,3,2,81000,32361,6461,42803,0
181,5514,1660,832,1314,41,38,274,1701,20,312,209,395,332,604,2671,5058,12,64042,3557,1,2,0,19,81000,32363,6462,42805,0
181,5514,1057,646,719,113,100,145,1170,18,215,134,248,233,382,1740,3004,10,31186,1732,1,2,0,19,81010,32364,6463,42806,0
237,4939,2,2,2,0,0,0,2,0,0,0,0,0,0,0,0,0,0,0,0,2,7,14,81010,32364,6463,42806,0
237,4939,99,48,90,1,3,5,100,0,0,0,0,0,0,0,0,0,0,0,0,2,7,14,81010,32365,6463,42807,0
237,4939,8,5,5,2,0,1,10,0,0,0,0,0,0,0,0,0,0,0,0,2,7,14,81010,32365,6463,42808,0
237,4939,1217,716,841,84,126,174,1301,14,185,118,215,199,333,1446,2542,8,20687,1149,0,2,7,14,81020,32367,6463,42809,0
237,4939,160,89,115,0,13,31,160,7,15,11,17,22,28,78,124,3,495,27,0,2,7,14,81020,32367,6463,42810,0
237,4939,10,10,9,9,0,0,19,0,0,0,0,0,0,0,0,0,0,0,0,2,7,14,81020,32367,6464,42811,0
237,4939,173,84,99,8,29,36,181,5,12,7,13,17,20,54,81,2,221,12,0,2,7,14,81020,32368,6464,42812,0
237,4939,3,1,1,3,0,0,6,0,0,0,0,0,0,0,0,0,0,0,0,2,7,14,81020,32368,6464,42813,0
19,513,205,80,86,16,53,53,221,7,18,10,19,25,29,94,134,3,497,27,0,2,3,9,81030,32368,6465,42814,0
106,4498,1289,550,1043,56,32,155,1345,10,167,93,185,177,278,1266,2075,5,11498,638,0,2,10,21,81030,32370,6466,42815,0
129,5167,1450,624,1228,12,26,181,1462,14,306,186,354,320,540,2580,4493,8,36391,2021,1,2,20,36,81030,32372,6467,42816,0
97,5225,1457,730,1242,11,6,188,1468,10,292,166,329,302,495,2424,4078,5,22973,1276,1,2,47,74,81030,32374,6467,42817,0
2,56,7,6,5,0,0,2,7,1,1,1,2,2,3,0,3,1,3,0,0,2,4,10,81030,32374,6467,42818,0
187,5718,1660,832,1314,41,38,274,1701,20,312,209,395,332,604,2671,5058,12,64042,3557,1,2,25,0,81030,32376,6468,42820,0
187,5718,1057,646,719,113,100,145,1170,18,215,134,248,233,382,1740,3004,10,31186,1732,1,2,25,0,81040,32377,6469,42821,0
182,5438,1660,832,1314,41,38,274,1701,20,312,209,395,332,604,2671,5058,12,64042,3557,1,2,53,0,81040,32379,6470,42823,0
52,1442,339,213,244,17,9,65,356,10,42,26,48,52,74,259,421,5,2410,133,0,2,33,29,81050,32379,6470,42824,0
77,3947,1293,570,1093,25,15,163,1318,10,195,123,241,205,364,1516,2795,6,17273,959,0,2,4,3,81060,32381,6470,42825,0
3,42,14,8,8,0,0,6,14,0,0,0,0,0,0,0,0,0,0,0,0,2,1,0,81060,32381,6470,42828,0
2,40,9,6,6,0,0,3,9,0,0,0,0,0,0,0,0,0,0,0,0,2,1,0,81060,32381,6470,42829,0
2,40,13,9,8,0,0,4,13,0,0,0,0,0,0,0,0,0,0,0,0,2,1,0,81060,32381,6470,42830,0
60,1163,282,196,195,3,0,86,285,8,130,71,141,138,212,936,1507,4,6538,363,0,2,1,0,81070,32382,6471,42844,0
4,77,127,75,83,2,11,30,129,4,14,7,14,18,21,61,87,2,175,9,0,2,1,0,81070,32382,6471,42845,0
4,77,652,304,544,16,6,88,668,6,89,51,101,95,152,591,998,3,3399,188,0,2,1,0,81070,32383,6471,42846,0
4,77,2,2,2,0,0,0,2,0,0,0,0,0,0,0,0,0,0,0,0,2,1,0,81070,32383,6471,42846,0
4,77,8,5,5,0,0,3,8,0,0,0,0,0,0,0,0,0,0,0,0,2,1,0,81070,32383,6471,42847,0
4,77,2,2,2,0,0,0,2,0,0,0,0,0,0,0,0,0,0,0,0,2,1,0,81070,32383,6471,42847,0
4,77,14,8,8,0,0,6,14,0,0,0,0,0,0,0,0,0,0,0,0,2,1,0,81070,32383,6471,42848,0
4,77,6,4,4,0,0,2,6,0,0,0,0,0,0,0,0,0,0,0,0,2,1,0,81070,32383,6471,42849,0
4,77,6,4,4,0,0,2,6,1,2,1,2,3,3,2,4,0,2,0,0,2,1,0,81070,32383,6471,42850,0
4,77,6,4,4,0,0,2,6,0,0,0,0,0,0,0,0,0,0,0,0,2,1,0,81070,32383,6471,42851,0
4,77,7,5,5,0,0,2,7,0,0,0,0,0,0,0,0,0,0,0,0,2,1,0,81070,32383,6471,42852,0
4,77,6,4,4,0,0,2,6,0,0,0,0,0,0,0,0,0,0,0,0,2,1,0,81070,32383,6471,42853,0
4,77,10,6,6,0,0,4,10,0,0,0,0,0,0,0,0,0,0,0,0,2,1,0,81070,32383,6471,42854,0
4,77,1,1,1,0,0,0,1,0,0,0,0,0,0,0,0,0,0,0,0,2,1,0,81070,32383,6471,42854,0
4,77,14,10,10,0,0,4,14,1,1,1,1,2,2,0,2,0,1,0,0,2,1,0,81070,32383,6471,42855,0
4,77,46,26,30,3,0,12,49,3,6,3,6,9,9,20,28,1,42,2,0,2,1,0,81080,32383,6471,42856,0
1,9,5,3,3,0,0,2,5,0,0,0,0,0,0,0,0,0,0,0,0,2,1,0,81080,32383,6471,42856,0
1,90,13,10,10,0,0,3,13,1,2,1,2,3,3,2,4,0,2,0,0,2,1,0,81080,32383,6471,42857,0
7,114,44,19,17,0,16,11,44,3,14,7,14,17,21,58,85,1,128,7,0,2,1,0,81080,32383,6471,42858,0
3,66,127,75,83,2,11,30,129,4,14,7,14,18,21,61,87,2,175,9,0,2,1,0,81090,32384,6471,42871,0
3,66,652,304,544,16,6,88,668,6,89,51,101,95,152,591,998,3,3399,188,0,2,1,0,81090,32385,6471,42872,0
3,66,2,2,2,0,0,0,2,0,0,0,0,0,0,0,0,0,0,0,0,2,1,0,81090,32385,6471,42872,0
3,66,8,5,5,0,0,3,8,0,0,0,0,0,0,0,0,0,0,0,0,2,1,0,81090,32385,6471,42873,0
3,66,2,2,2,0,0,0,2,0,0,0,0,0,0,0,0,0,0,0,0,2,1,0,81090,32385,6471,42873,0
3,66,14,8,8,0,0,6,14,0,0,0,0,0,0,0,0,0,0,0,0,2,1,0,81090,32385,6471,42874,0
3,66,6,4,4,0,0,2,6,0,0,0,0,0,0,0,0,0,0,0,0,2,1,0,81090,32385,6471,42875,0
3,66,6,4,4,0,0,2,6,1,2,1,2,3,3,2,4,0,2,0,0,2,1,0,81090,32385,6471,42876,0
3,66,6,4,4,0,0,2,6,0,0,0,0,0,0,0,0,0,0,0,0,2,1,0,81090,32385,6471,42877,0
3,66,7,5,5,0,0,2,7,0,0,0,0,0,0,0,0,0,0,0,0,2,1,0,81090,32385,6471,42878,0
3,66,6,4,4,0,0,2,6,0,0,0,0,0,0,0,0,0,0,0,0,2,1,0,81090,32385,6471,42879,0
3,66,10,6,6,0,0,4,10,0,0,0,0,0,0,0,0,0,0,0,0,2,1,0,81090,32385,6471,42880,0
3,66,1,1,1,0,0,0,1,0,0,0,0,0,0,0,0,0,0,0,0,2,1,0,81090,32385,6471,42880,0
3,66,14,10,10,0,0,4,14,1,1,1,1,2,2,0,2,0,1,0,0,2,1,0,81090,32385,6471,42881,0
3,66,46,26,30,3,0,12,49,3,6,3,6,9,9,20,28,1,42,2,0,2,1,0,81100,32385,6471,42882,0
7,296,72,33,56,0,4,12,72,1,1,1,1,2,2,0,2,0,1,0,0,2,1,0,81120,32393,6473,42897,0
12,229,127,75,83,2,11,30,129,4,14,7,14,18,21,61,87,2,175,9,0,2,1,0,81120,32393,6473,42898,0
12,229,652,304,544,16,6,88,668,6,89,51,101,95,152,591,998,3,3399,188,0,2,1,0,81120,32394,6473,42899,0
12,229,2,2,2,0,0,0,2,0,0,0,0,0,0,0,0,0,0,0,0,2,1,0,81120,32394,6473,42899,0
12,229,8,5,5,0,0,3,8,0,0,0,0,0,0,0,0,0,0,0,0,2,1,0,81120,32394,6473,42900,0
12,229,2,2,2,0,0,0,2,0,0,0,0,0,0,0,0,0,0,0,0,2,1,0,81120,32394,6473,42900,0
12,229,14,8,8,0,0,6,14,0,0,0,0,0,0,0,0,0,0,0,0,2,1,0,81120,32394,6473,42901,0
12,229,6,4,4,0,0,2,6,0,0,0,0,0,0,0,0,0,0,0,0,2,1,0,81120,32394,6473,42902,0
12,229,6,4,4,0,0,2,6,1,2,1,2,3,3,2,4,0,2,0,0,2,1,0,81120,32394,6473,42903,0
12,229,6,4,4,0,0,2,6,0,0,0,0,0,0,0,0,0,0,0,0,2,1,0,81120,32394,6473,42904,0
12,229,7,5,5,0,0,2,7,0,0,0,0,0,0,0,0,0,0,0,0,2,1,0,81120,32394,6473,42905,0
12,229,6,4,4,0,0,2,6,0,0,0,0,0,0,0,0,0,0,0,0,2,1,0,81120,32394,6473,42906,0
12,229,10,6,6,0,0,4,10,0,0,0,0,0,0,0,0,0,0,0,0,2,1,0,81120,32394,6473,42907,0
12,229,1,1,1,0,0,0,1,0,0,0,0,0,0,0,0,0,0,0,0,2,1,0,81120,32394,6473,42907,0
12,229,14,10,10,0,0,4,14,1,1,1,1,2,2,0,2,0,1,0,0,2,1,0,81120,32394,6473,42908,0
12,229,46,26,30,3,0,12,49,3,6,3,6,9,9,20,28,1,42,2,0,2,1,0,81130,32394,6473,42909,0
6,71,127,75,83,2,11,30,129,4,14,7,14,18,21,61,87,2,175,9,0,2,1,0,81130,32394,6473,42910,0
6,71,652,304,544,16,6,88,668,6,89,51,101,95,152,591,998,3,3399,188,0,2,1,0,81130,32395,6473,42911,0
6,71,2,2,2,0,0,0,2,0,0,0,0,0,0,0,0,0,0,0,0,2,1,0,81130,32395,6473,42911,0
6,71,8,5,5,0,0,3,8,0,0,0,0,0,0,0,0,0,0,0,0,2,1,0,81130,32395,6473,42912,0
6,71,2,2,2,0,0,0,2,0,0,0,0,0,0,0,0,0,0,0,0,2,1,0,81130,32395,6473,42912,0
6,71,14,8,8,0,0,6,14,0,0,0,0,0,0,0,0,0,0,0,0,2,1,0,81130,32395,6473,42913,0
6,71,6,4,4,0,0,2,6,0,0,0,0,0,0,0,0,0,0,0,0,2,1,0,81130,32395,6473,42914,0
6,71,6,4,4,0,0,2,6,1,2,1,2,3,3,2,4,0,2,0,0,2,1,0,81130,32395,6473,42915,0
6,71,6,4,4,0,0,2,6,0,0,0,0,0,0,0,0,0,0,0,0,2,1,0,81130,32395,6473,42916,0
6,71,7,5,5,0,0,2,7,0,0,0,0,0,0,0,0,0,0,0,0,2,1,0,81130,32395,6473,42917,0
6,71,6,4,4,0,0,2,6,0,0,0,0,0,0,0,0,0,0,0,0,2,1,0,81130,32395,6473,42918,0
6,71,10,6,6,0,0,4,10,0,0,0,0,0,0,0,0,0,0,0,0,2,1,0,81130,32395,6473,42919,0
6,71,1,1,1,0,0,0,1,0,0,0,0,0,0,0,0,0,0,0,0,2,1,0,81130,32395,6473,42919,0
6,71,14,10,10,0,0,4,14,1,1,1,1,2,2,0,2,0,1,0,0,2,1,0,81130,32395,6473,42920,0
6,71,46,26,30,3,0,12,49,3,6,3,6,9,9,20,28,1,42,2,0,2,1,0,81140,32395,6473,42921,0
3,26,14,7,7,2,0,5,16,0,0,0,0,0,0,0,0,0,0,0,0,2,1,0,81140,32395,6473,42921,0
7,103,38,23,23,0,0,15,38,0,0,0,0,0,0,0,0,0,0,0,0,2,1,0,81140,32395,6473,42922,0
17,378,85,59,61,8,0,16,93,5,18,10,18,23,28,86,126,2,316,17,0,2,1,0,81140,32395,6473,42923,0
12,515,124,78,88,2,3,26,126,4,13,7,13,17,20,56,81,2,163,9,0,2,1,0,81140,32395,6473,42926,0
1,98,42,7,35,4,0,5,46,1,2,1,2,3,3,2,4,0,2,0,0,2,1,0,81140,32395,6473,42927,0
1,98,11,6,10,0,0,1,11,2,4,2,4,6,6,10,15,1,15,0,0,2,1,0,81140,32395,6473,42928,0
11,242,19,8,11,5,0,4,24,2,5,3,6,7,9,13,25,1,30,1,0,2,1,0,81150,32399,6474,42936,0
11,242,102,59,69,5,3,24,107,6,22,15,28,28,43,113,206,3,789,43,0,2,1,0,81150,32399,6474,42937,0
11,242,106,40,36,3,49,17,109,8,17,13,23,25,36,93,167,5,904,50,0,2,1,0,81150,32399,6474,42938,0
229,4960,182,127,129,0,0,53,182,5,39,21,42,44,63,217,343,2,926,51,0,2,6,4,81160,32403,6476,42946,0
229,4960,1165,710,800,67,119,181,1232,18,243,153,282,261,435,2000,3492,10,36473,2026,1,2,6,4,81170,32403,6477,42947,0
67,1570,773,419,590,28,0,166,801,10,204,113,217,214,330,1598,2554,5,13587,754,0,2,1,0,81170,32403,6478,42948,0
67,1570,421,273,302,44,34,57,465,17,81,59,107,98,166,583,1098,11,12329,684,0,2,1,0,81170,32403,6479,42949,0
14,411,149,95,105,2,0,41,151,8,54,28,55,62,83,334,494,4,2013,111,0,2,1,0,81170,32403,6479,42950,0
14,411,82,56,54,0,13,15,82,4,13,8,16,17,24,56,98,2,241,13,0,2,1,0,81180,32403,6479,42951,0
26,529,2,2,2,0,0,0,2,0,0,0,0,0,0,0,0,0,0,0,0,2,1,0,81180,32403,6479,42951,0
26,529,99,48,90,1,3,5,100,0,0,0,0,0,0,0,0,0,0,0,0,2,1,0,81180,32404,6479,42952,0
26,529,8,5,5,2,0,1,10,0,0,0,0,0,0,0,0,0,0,0,0,2,1,0,81180,32404,6479,42953,0
26,529,1217,716,841,84,126,174,1301,14,185,118,215,199,333,1446,2542,8,20687,1149,0,2,1,0,81190,32406,6479,42954,0
26,529,160,89,115,0,13,31,160,7,15,11,17,22,28,78,124,3,495,27,0,2,1,0,81190,32406,6479,42955,0
26,529,10,10,9,9,0,0,19,0,0,0,0,0,0,0,0,0,0,0,0,2,1,0,81190,32406,6480,42956,0
26,529,173,84,99,8,29,36,181,5,12,7,13,17,20,54,81,2,221,12,0,2,1,0,81190,32407,6480,42957,0
26,529,3,1,1,3,0,0,6,0,0,0,0,0,0,0,0,0,0,0,0,2,1,0,81190,32407,6480,42958,0
188,5732,1660,832,1314,41,38,274,1701,20,312,209,395,332,604,2671,5058,12,64042,3557,1,2,5,1,81190,32409,6481,42960,0
188,5732,1057,646,719,113,100,145,1170,18,215,134,248,233,382,1740,3004,10,31186,1732,1,2,5,1,81200,32410,6482,42961,0
17,348,95,58,50,9,16,20,104,12,33,24,45,45,69,209,378,8,3100,172,0,2,1,0,81200,32410,6482,42962,0
116,2173,477,336,357,30,23,73,507,16,194,134,250,210,384,1538,2962,10,30538,1696,0,2,1,0,81210,32411,6482,42963,0
89,2050,996,429,845,24,10,117,1020,7,76,50,88,83,138,494,879,4,3565,198,0,2,1,0,81210,32413,6482,42964,0
89,2050,456,277,329,12,42,72,468,13,85,50,97,98,147,592,972,7,7212,400,0,2,1,0,81210,32413,6482,42965,0
166,3529,1513,682,1277,25,13,200,1538,11,199,116,219,210,335,1557,2584,6,15641,868,0,2,6,4,81210,32415,6482,42966,0
166,3529,819,519,539,24,98,155,843,15,96,57,106,111,163,690,1107,8,9171,509,0,2,6,4,81220,32417,6482,42967,0
73,1518,207,111,150,11,0,50,218,5,26,19,36,31,55,133,272,3,943,52,0,2,1,0,81220,32417,6482,42968,0
73,1518,410,198,237,31,55,97,441,11,63,38,72,74,110,414,683,6,4293,238,0,2,1,0,81230,32418,6483,42969,0
237,4939,2,2,2,0,0,0,2,0,0,0,0,0,0,0,0,0,0,0,0,2,4,3,81230,32418,6483,42969,0
237,4939,99,48,90,1,3,5,100,0,0,0,0,0,0,0,0,0,0,0,0,2,4,3,81230,32419,6483,42970,0
237,4939,8,5,5,2,0,1,10,0,0,0,0,0,0,0,0,0,0,0,0,2,4,3,81230,32419,6483,42971,0
237,4939,1217,716,841,84,126,174,1301,14,185,118,215,199,333,1446,2542,8,20687,1149,0,2,4,3,81240,32421,6483,42972,0
237,4939,160,89,115,0,13,31,160,7,15,11,17,22,28,78,124,3,495,27,0,2,4,3,81240,32421,6483,42973,0
237,4939,10,10,9,9,0,0,19,0,0,0,0,0,0,0,0,0,0,0,0,2,4,3,81240,32421,6484,42974,0
237,4939,173,84,99,8,29,36,181,5,12,7,13,17,20,54,81,2,221,12,0,2,4,3,81240,32422,6484,42975,0
237,4939,3,1,1,3,0,0,6,0,0,0,0,0,0,0,0,0,0,0,0,2,4,3,81240,32422,6484,42976,0
98,2019,463,295,324,28,62,57,491,12,134,82,154,146,236,989,1696,6,11700,650,0,2,1,0,81250,32423,6484,42977,0
55,770,167,116,138,4,5,22,171,8,48,30,56,56,86,292,499,4,2330,129,0,2,1,0,81250,32423,6484,42978,0
52,1442,339,213,244,17,9,65,356,10,42,26,48,52,74,259,421,5,2410,133,0,2,46,44,81260,32423,6484,42979,0
95,2385,1455,414,1257,16,76,112,1471,5,41,23,46,46,69,231,381,2,1069,59,0,2,1,0,81260,32424,6484,42981,0
95,2385,669,365,481,22,61,110,691,15,103,63,122,118,185,747,1273,8,11311,628,0,2,1,0,81270,32424,6485,42982,0
249,5763,4293,999,3693,19,54,507,4312,9,155,88,170,164,258,1156,1898,4,9368,520,0,2,10,0,81270,32426,6485,42983,0
249,5763,1482,859,1002,125,135,219,1607,16,219,134,251,235,385,1766,3032,9,27804,1544,1,2,10,0,81280,32427,6485,42984,0
6,140,44,22,19,0,19,6,44,2,10,6,12,12,18,35,64,1,77,4,0,2,1,0,81280,32427,6485,42985,0
31,1087,74,35,59,1,0,14,75,3,14,7,14,17,21,58,85,1,128,7,0,2,1,0,81280,32428,6485,42986,0
31,1087,245,125,200,5,7,34,250,7,30,17,34,37,51,166,265,3,1053,58,0,2,1,0,81290,32429,6485,42987,0
54,657,647,139,84,35,284,233,682,0,0,0,0,0,0,0,0,0,0,0,0,2,1,0,81290,32429,6485,42988,0
115,3128,1523,757,1297,19,12,193,1542,12,193,117,230,205,347,1508,2664,7,19053,1058,0,2,1,0,81300,32431,6485,42989,0
115,3128,701,378,504,33,58,109,734,13,110,68,126,123,194,794,1346,7,10027,557,0,2,1,0,81300,32432,6486,42990,0
101,2612,773,422,505,30,103,129,803,14,77,46,83,91,129,535,839,7,6334,351,0,2,1,0,81310,32433,6487,42991,0
159,3785,77,34,69,0,0,8,77,3,24,16,29,27,45,114,213,1,387,21,0,2,1,0,81310,32433,6487,42992,0
159,3785,712,438,573,51,9,84,763,14,102,71,128,116,199,733,1364,8,11988,666,0,2,1,0,81320,32434,6487,42993,0
24,612,2,2,2,0,0,0,2,0,0,0,0,0,0,0,0,0,0,0,0,2,1,0,81320,32434,6487,42993,0
24,612,99,48,90,1,3,5,100,0,0,0,0,0,0,0,0,0,0,0,0,2,1,0,81320,32435,6487,42994,0
24,612,8,5,5,2,0,1,10,0,0,0,0,0,0,0,0,0,0,0,0,2,1,0,81320,32435,6487,42995,0
24,612,1217,716,841,84,126,174,1301,14,185,118,215,199,333,1446,2542,8,20687,1149,0,2,1,0,81330,32437,6487,42996,0
24,612,160,89,115,0,13,31,160,7,15,11,17,22,28,78,124,3,495,27,0,2,1,0,81330,32437,6487,42997,0
24,612,10,10,9,9,0,0,19,0,0,0,0,0,0,0,0,0,0,0,0,2,1,0,81330,32437,6488,42998,0
24,612,173,84,99,8,29,36,181,5,12,7,13,17,20,54,81,2,221,12,0,2,1,0,81330,32438,6488,42999,0
24,612,3,1,1,3,0,0,6,0,0,0,0,0,0,0,0,0,0,0,0,2,1,0,81330,32438,6488,43000,0
30,664,125,97,103,3,0,19,128,9,25,17,27,34,44,144,223,4,1087,60,0,2,1,0,81330,32438,6489,43001,0
22,373,102,57,55,5,16,25,107,5,17,10,18,22,28,81,124,2,330,18,0,2,1,0,81330,32438,6489,43002,0
69,1527,402,202,227,24,74,80,426,12,52,33,61,64,94,339,564,7,3969,220,0,2,1,0,81330,32439,6489,43003,0
55,1174,447,308,343,6,5,95,453,7,96,59,111,103,170,651,1136,4,4600,255,0,2,1,0,81330,32442,6489,43004,0
55,1174,322,174,179,16,74,51,338,10,41,26,46,51,72,252,408,5,2291,127,0,2,1,0,81330,32445,6490,43005,0
75,1629,53,23,39,0,0,13,53,2,8,4,8,10,12,26,39,1,39,2,0,2,1,0,81330,32445,6490,43006,0
75,1629,515,298,307,33,80,99,548,12,63,44,77,75,121,419,753,7,5527,307,0,2,1,0,81340,32445,6490,43007,0
18,312,424,94,331,4,0,89,428,1,5,5,5,6,10,11,25,0,12,0,0,2,1,0,81340,32446,6490,43008,0
18,312,38,23,23,6,0,8,44,3,11,7,11,14,18,42,68,1,102,5,0,2,1,0,81340,32446,6490,43009,0
19,513,205,80,86,16,53,53,221,7,18,10,19,25,29,94,134,3,497,27,0,2,1,0,81350,32446,6491,43010,0
17,523,184,100,137,2,15,30,186,6,38,20,39,44,59,214,322,3,991,55,0,2,1,0,81350,32447,6491,43011,0
17,523,103,65,74,8,5,16,111,7,17,9,17,24,26,89,119,3,417,23,0,2,1,0,81350,32448,6491,43012,0
59,1228,91,45,69,0,3,18,91,3,9,6,10,12,16,33,57,1,95,5,0,2,1,0,81350,32450,6491,43013,0
59,1228,367,234,237,17,34,68,384,16,55,34,61,71,95,381,584,8,5183,287,0,2,1,0,81350,32451,6491,43014,0
231,5969,722,423,573,19,0,135,741,12,172,101,199,184,300,1320,2257,6,15668,870,0,2,1,0,81350,32453,6491,43016,0
231,5969,1508,847,911,44,250,301,1552,14,148,88,169,162,257,1120,1886,7,15077,837,0,2,1,0,81350,32454,6492,43017,0
314,6912,72,33,56,0,4,12,72,1,1,1,1,2,2,0,2,0,1,0,0,2,3,7,81350,32454,6492,43018,0
314,6912,1454,835,1044,76,110,219,1530,17,275,158,296,292,454,2297,3718,9,34017,1889,1,2,3,7,81360,32455,6492,43019,0
92,1886,757,253,292,73,244,162,830,13,61,38,67,74,105,409,651,7,4654,258,0,2,2,1,81360,32456,6492,43020,0
45,953,386,256,301,16,9,68,402,4,59,35,69,63,104,355,621,2,1453,80,0,2,1,0,81360,32456,6492,43021,0
45,953,264,131,164,11,41,46,275,6,38,22,40,44,62,214,338,3,1068,59,0,2,1,0,81370,32456,6493,43022,0
67,1753,466,257,367,18,25,50,484,7,126,86,171,133,257,898,1813,4,8612,478,0,2,1,0,81370,32456,6493,43023,0
67,1753,507,281,342,29,59,88,536,10,53,29,57,63,86,336,514,5,2764,153,0,2,1,0,81370,32456,6493,43024,0
25,552,215,129,180,6,0,29,221,8,65,43,72,73,115,415,711,4,3153,175,0,2,1,0,81370,32456,6493,43025,0
25,552,97,69,77,3,3,16,100,6,22,13,23,28,36,113,173,3,542,30,0,2,1,0,81370,32457,6493,43026,0
89,1894,1043,504,840,53,9,147,1096,9,180,112,198,189,310,1377,2344,4,11604,644,0,2,1,0,81370,32459,6493,43027,0
89,1894,383,288,292,26,6,62,409,11,65,38,67,76,105,429,656,5,3719,206,0,2,1,0,81370,32460,6493,43028,0
20,420,294,64,250,0,0,43,294,1,20,10,20,21,30,86,131,0,65,3,0,2,1,0,81370,32460,6493,43029,0
20,420,78,46,62,3,0,14,81,3,8,4,8,11,12,28,41,1,62,3,0,2,1,0,81370,32461,6493,43030,0
5,123,110,30,77,3,13,16,113,4,21,15,30,25,45,100,208,2,597,33,0,2,1,0,81370,32461,6493,43031,0
5,123,28,15,21,1,0,6,29,0,0,0,0,0,0,0,0,0,0,0,0,2,1,0,81370,32461,6493,43032,0
41,821,1178,367,1042,6,15,115,1184,9,94,51,95,103,146,644,976,4,4439,246,0,2,1,1,81370,32461,6493,43033,0
41,821,177,108,140,8,0,27,185,6,30,16,32,36,48,162,248,3,794,44,0,2,1,1,81370,32463,6493,43034,0
28,452,219,78,157,11,5,46,230,3,24,20,34,27,54,114,256,2,545,30,0,2,1,0,81370,32464,6493,43035,0
28,452,108,64,79,9,0,20,117,5,15,11,19,20,30,70,129,3,410,22,0,2,1,0,81370,32464,6493,43036,0
282,5915,1943,715,1694,26,18,214,1969,12,185,120,237,197,357,1436,2721,7,20915,1161,0,2,1,1,81370,32466,6493,43037,0
282,5915,1168,838,957,57,25,144,1225,19,348,224,416,367,640,3018,5452,11,61921,3440,1,2,1,1,81380,32468,6493,43038,0
19,720,442,244,305,14,16,103,456,11,68,45,75,79,120,452,756,6,4588,254,0,2,1,0,81380,32470,6493,43039,0
19,720,182,102,99,11,40,35,193,3,11,6,11,14,17,42,64,1,97,5,0,2,1,0,81380,32471,6493,43040,0
69,1323,1098,241,925,5,10,155,1103,7,46,25,49,53,74,273,423,3,1580,87,0,2,1,0,81390,32473,6493,43041,0
69,1323,282,202,222,14,2,44,296,8,42,24,43,50,67,250,378,4,1548,86,0,2,1,0,81390,32474,6493,43042,0
2,156,37,13,25,0,6,6,37,1,2,1,2,3,3,2,4,0,2,0,0,2,1,0,81390,32474,6493,43043,0
2,156,133,47,40,1,43,49,134,0,0,0,0,0,0,0,0,0,0,0,0,2,1,0,81390,32474,6493,43044,0
29,743,601,196,481,2,23,85,603,8,63,36,72,71,108,400,664,4,3036,168,0,2,1,0,81390,32474,6493,43045,0
29,743,156,79,106,5,16,28,161,5,14,8,15,19,23,64,97,2,261,14,0,2,1,0,81390,32474,6493,43046,0
36,1120,182,127,129,0,0,53,182,5,39,21,42,44,63,217,343,2,926,51,0,2,1,1,81390,32474,6494,43047,0
7,123,127,75,83,2,11,30,129,4,14,7,14,18,21,61,87,2,175,9,0,2,1,0,81390,32474,6494,43048,0
7,123,652,304,544,16,6,88,668,6,89,51,101,95,152,591,998,3,3399,188,0,2,1,0,81390,32475,6494,43049,0
7,123,2,2,2,0,0,0,2,0,0,0,0,0,0,0,0,0,0,0,0,2,1,0,81390,32475,6494,43049,0
7,123,8,5,5,0,0,3,8,0,0,0,0,0,0,0,0,0,0,0,0,2,1,0,81390,32475,6494,43050,0
7,123,2,2,2,0,0,0,2,0,0,0,0,0,0,0,0,0,0,0,0,2,1,0,81390,32475,6494,43050,0
7,123,14,8,8,0,0,6,14,0,0,0,0,0,0,0,0,0,0,0,0,2,1,0,81390,32475,6494,43051,0
7,123,6,4,4,0,0,2,6,0,0,0,0,0,0,0,0,0,0,0,0,2,1,0,81390,32475,6494,43052,0
7,123,6,4,4,0,0,2,6,1,2,1,2,3,3,2,4,0,2,0,0,2,1,0,81390,32475,6494,43053,0
7,123,6,4,4,0,0,2,6,0,0,0,0,0,0,0,0,0,0,0,0,2,1,0,81390,32475,6494,43054,0
7,123,7,5,5,0,0,2,7,0,0,0,0,0,0,0,0,0,0,0,0,2,1,0,81390,32475,6494,43055,0
7,123,6,4,4,0,0,2,6,0,0,0,0,0,0,0,0,0,0,0,0,2,1,0,81390,32475,6494,43056,0
7,123,10,6,6,0,0,4,10,0,0,0,0,0,0,0,0,0,0,0,0,2,1,0,81390,32475,6494,43057,0
7,123,1,1,1,0,0,0,1,0,0,0,0,0,0,0,0,0,0,0,0,2,1,0,81390,32475,6494,43057,0
7,123,14,10,10,0,0,4,14,1,1,1,1,2,2,0,2,0,1,0,0,2,1,0,81390,32475,6494,43058,0
7,123,46,26,30,3,0,12,49,3,6,3,6,9,9,20,28,1,42,2,0,2,1,0,81400,32475,6494,43059,0
14,845,75,38,59,1,3,12,76,2,4,2,4,6,6,10,15,1,15,0,0,2,1,0,81400,32475,6494,43060,0
2,67,16,12,9,0,0,6,16,1,2,1,2,3,3,2,4,0,2,0,0,2,1,0,81400,32475,6494,43061,0
1,6,2,2,2,0,0,0,2,0,0,0,0,0,0,0,0,0,0,0,0,2,1,0,81400,32475,6494,43061,0
1,6,99,48,90,1,3,5,100,0,0,0,0,0,0,0,0,0,0,0,0,2,1,0,81400,32476,6494,43062,0
1,6,8,5,5,2,0,1,10,0,0,0,0,0,0,0,0,0,0,0,0,2,1,0,81400,32476,6494,43063,0
1,6,1217,716,841,84,126,174,1301,14,185,118,215,199,333,1446,2542,8,20687,1149,0,2,1,0,81410,32478,6494,43064,0
1,6,160,89,115,0,13,31,160,7,15,11,17,22,28,78,124,3,495,27,0,2,1,0,81410,32478,6494,43065,0
1,6,10,10,9,9,0,0,19,0,0,0,0,0,0,0,0,0,0,0,0,2,1,0,81410,32478,6495,43066,0
1,6,173,84,99,8,29,36,181,5,12,7,13,17,20,54,81,2,221,12,0,2,1,0,81410,32479,6495,43067,0
1,6,3,1,1,3,0,0,6,0,0,0,0,0,0,0,0,0,0,0,0,2,1,0,81410,32479,6495,43068,0
1,6,2,2,2,0,0,0,2,0,0,0,0,0,0,0,0,0,0,0,0,2,1,0,81410,32479,6495,43068,0
1,8,127,75,83,2,11,30,129,4,14,7,14,18,21,61,87,2,175,9,0,2,1,0,81410,32479,6495,43069,0
1,8,652,304,544,16,6,88,668,6,89,51,101,95,152,591,998,3,3399,188,0,2,1,0,81410,32480,6495,43070,0
1,8,2,2,2,0,0,0,2,0,0,0,0,0,0,0,0,0,0,0,0,2,1,0,81410,32480,6495,43070,0
1,8,8,5,5,0,0,3,8,0,0,0,0,0,0,0,0,0,0,0,0,2,1,0,81410,32480,6495,43071,0
1,8,2,2,2,0,0,0,2,0,0,0,0,0,0,0,0,0,0,0,0,2,1,0,81410,32480,6495,43071,0
1,8,14,8,8,0,0,6,14,0,0,0,0,0,0,0,0,0,0,0,0,2,1,0,81410,32480,6495,43072,0
1,8,6,4,4,0,0,2,6,0,0,0,0,0,0,0,0,0,0,0,0,2,1,0,81410,32480,6495,43073,0
1,8,6,4,4,0,0,2,6,1,2,1,2,3,3,2,4,0,2,0,0,2,1,0,81410,32480,6495,43074,0
1,8,6,4,4,0,0,2,6,0,0,0,0,0,0,0,0,0,0,0,0,2,1,0,81410,32480,6495,43075,0
1,8,7,5,5,0,0,2,7,0,0,0,0,0,0,0,0,0,0,0,0,2,1,0,81410,32480,6495,43076,0
1,8,6,4,4,0,0,2,6,0,0,0,0,0,0,0,0,0,0,0,0,2,1,0,81410,32480,6495,43077,0
1,8,10,6,6,0,0,4,10,0,0,0,0,0,0,0,0,0,0,0,0,2,1,0,81410,32480,6495,43078,0
1,8,1,1,1,0,0,0,1,0,0,0,0,0,0,0,0,0,0,0,0,2,1,0,81410,32480,6495,43078,0
1,8,14,10,10,0,0,4,14,1,1,1,1,2,2,0,2,0,1,0,0,2,1,0,81410,32480,6495,43079,0
1,8,46,26,30,3,0,12,49,3,6,3,6,9,9,20,28,1,42,2,0,2,1,0,81420,32480,6495,43080,0
1,6,2,2,2,0,0,0,2,0,0,0,0,0,0,0,0,0,0,0,0,2,1,0,81420,32480,6495,43080,0
1,6,2,2,2,0,0,0,2,0,0,0,0,0,0,0,0,0,0,0,0,2,1,0,81430,32481,6495,43092,0
2,25,127,75,83,2,11,30,129,4,14,7,14,18,21,61,87,2,175,9,0,2,1,0,81430,32481,6495,43093,0
2,25,652,304,544,16,6,88,668,6,89,51,101,95,152,591,998,3,3399,188,0,2,1,0,81430,32482,6495,43094,0
2,25,2,2,2,0,0,0,2,0,0,0,0,0,0,0,0,0,0,0,0,2,1,0,81430,32482,6495,43094,0
2,25,8,5,5,0,0,3,8,0,0,0,0,0,0,0,0,0,0,0,0,2,1,0,81430,32482,6495,43095,0
2,25,2,2,2,0,0,0,2,0,0,0,0,0,0,0,0,0,0,0,0,2,1,0,81430,32482,6495,43095,0
2,25,14,8,8,0,0,6,14,0,0,0,0,0,0,0,0,0,0,0,0,2,1,0,81430,32482,6495,43096,0
2,25,6,4,4,0,0,2,6,0,0,0,0,0,0,0,0,0,0,0,0,2,1,0,81430,32482,6495,43097,0
2,25,6,4,4,0,0,2,6,1,2,1,2,3,3,2,4,0,2,0,0,2,1,0,81430,32482,6495,43098,0
2,25,6,4,4,0,0,2,6,0,0,0,0,0,0,0,0,0,0,0,0,2,1,0,81430,32482,6495,43099,0
2,25,7,5,5,0,0,2,7,0,0,0,0,0,0,0,0,0,0,0,0,2,1,0,81430,32482,6495,43100,0
2,25,6,4,4,0,0,2,6,0,0,0,0,0,0,0,0,0,0,0,0,2,1,0,81430,32482,6495,43101,0
2,25,10,6,6,0,0,4,10,0,0,0,0,0,0,0,0,0,0,0,0,2,1,0,81430,32482,6495,43102,0
2,25,1,1,1,0,0,0,1,0,0,0,0,0,0,0,0,0,0,0,0,2,1,0,81430,32482,6495,43102,0
2,25,14,10,10,0,0,4,14,1,1,1,1,2,2,0,2,0,1,0,0,2,1,0,81430,32482,6495,43103,0
2,25,46,26,30,3,0,12,49,3,6,3,6,9,9,20,28,1,42,2,0,2,1,0,81440,32482,6495,43104,0
1,55,14,12,10,0,0,4,14,1,2,1,2,3,3,2,4,0,2,0,0,2,1,0,81440,32482,6495,43105,0
1,58,14,12,10,0,0,4,14,1,2,1,2,3,3,2,4,0,2,0,0,2,1,0,81440,32482,6495,43106,0
1,55,14,12,10,0,0,4,14,1,2,1,2,3,3,2,4,0,2,0,0,2,1,0,81440,32482,6495,43107,0
1,77,19,18,14,0,0,5,19,1,2,1,2,3,3,2,4,0,2,0,0,2,1,0,81440,32482,6495,43108,0
2,18,10,6,6,0,0,4,10,0,0,0,0,0,0,0,0,0,0,0,0,2,1,0,81440,32482,6495,43109,0
2,36,127,75,83,2,11,30,129,4,14,7,14,18,21,61,87,2,175,9,0,2,1,0,81440,32482,6495,43110,0
2,36,652,304,544,16,6,88,668,6,89,51,101,95,152,591,998,3,3399,188,0,2,1,0,81440,32483,6495,43111,0
2,36,2,2,2,0,0,0,2,0,0,0,0,0,0,0,0,0,0,0,0,2,1,0,81440,32483,6495,43111,0
2,36,8,5,5,0,0,3,8,0,0,0,0,0,0,0,0,0,0,0,0,2,1,0,81440,32483,6495,43112,0
2,36,2,2,2,0,0,0,2,0,0,0,0,0,0,0,0,0,0,0,0,2,1,0,81440,32483,6495,43112,0
2,36,14,8,8,0,0,6,14,0,0,0,0,0,0,0,0,0,0,0,0,2,1,0,81440,32483,6495,43113,0
2,36,6,4,4,0,0,2,6,0,0,0,0,0,0,0,0,0,0,0,0,2,1,0,81440,32483,6495,43114,0
2,36,6,4,4,0,0,2,6,1,2,1,2,3,3,2,4,0,2,0,0,2,1,0,81440,32483,6495,43115,0
2,36,6,4,4,0,0,2,6,0,0,0,0,0,0,0,0,0,0,0,0,2,1,0,81440,32483,6495,43116,0
2,36,7,5,5,0,0,2,7,0,0,0,0,0,0,0,0,0,0,0,0,2,1,0,81440,32483,6495,43117,0
2,36,6,4,4,0,0,2,6,0,0,0,0,0,0,0,0,0,0,0,0,2,1,0,81440,32483,6495,43118,0
2,36,10,6,6,0,0,4,10,0,0,0,0,0,0,0,0,0,0,0,0,2,1,0,81440,32483,6495,43119,0
2,36,1,1,1,0,0,0,1,0,0,0,0,0,0,0,0,0,0,0,0,2,1,0,81440,32483,6495,43119,0
2,36,14,10,10,0,0,4,14,1,1,1,1,2,2,0,2,0,1,0,0,2,1,0,81440,32483,6495,43120,0
2,36,46,26,30,3,0,12,49,3,6,3,6,9,9,20,28,1,42,2,0,2,1,0,81450,32483,6495,43121,0
1,6,2,2,2,0,0,0,2,0,0,0,0,0,0,0,0,0,0,0,0,2,1,0,81450,32483,6495,43121,0
1,26,127,75,83,2,11,30,129,4,14,7,14,18,21,61,87,2,175,9,0,2,1,0,81450,32483,6495,43122,0
1,26,652,304,544,16,6,88,668,6,89,51,101,95,152,591,998,3,3399,188,0,2,1,0,81450,32484,6495,43123,0
1,26,2,2,2,0,0,0,2,0,0,0,0,0,0,0,0,0,0,0,0,2,1,0,81450,32484,6495,43123,0
1,26,8,5,5,0,0,3,8,0,0,0,0,0,0,0,0,0,0,0,0,2,1,0,81450,32484,6495,43124,0
1,26,2,2,2,0,0,0,2,0,0,0,0,0,0,0,0,0,0,0,0,2,1,0,81450,32484,6495,43124,0
1,26,14,8,8,0,0,6,14,0,0,0,0,0,0,0,0,0,0,0,0,2,1,0,81450,32484,6495,43125,0
1,26,6,4,4,0,0,2,6,0,0,0,0,0,0,0,0,0,0,0,0,2,1,0,81450,32484,6495,43126,0
1,26,6,4,4,0,0,2,6,1,2,1,2,3,3,2,4,0,2,0,0,2,1,0,81450,32484,6495,43127,0
1,26,6,4,4,0,0,2,6,0,0,0,0,0,0,0,0,0,0,0,0,2,1,0,81450,32484,6495,43128,0
1,26,7,5,5,0,0,2,7,0,0,0,0,0,0,0,0,0,0,0,0,2,1,0,81450,32484,6495,43129,0
1,26,6,4,4,0,0,2,6,0,0,0,0,0,0,0,0,0,0,0,0,2,1,0,81450,32484,6495,43130,0
1,26,10,6,6,0,0,4,10,0,0,0,0,0,0,0,0,0,0,0,0,2,1,0,81450,32484,6495,43131,0
1,26,1,1,1,0,0,0,1,0,0,0,0,0,0,0,0,0,0,0,0,2,1,0,81450,32484,6495,43131,0
1,26,14,10,10,0,0,4,14,1,1,1,1,2,2,0,2,0,1,0,0,2,1,0,81450,32484,6495,43132,0
1,26,46,26,30,3,0,12,49,3,6,3,6,9,9,20,28,1,42,2,0,2,1,0,81460,32484,6495,43133,0
1,7,2,2,2,0,0,0,2,0,0,0,0,0,0,0,0,0,0,0,0,2,1,0,81460,32484,6495,43133,0
1,24,127,75,83,2,11,30,129,4,14,7,14,18,21,61,87,2,175,9,0,2,1,0,81460,32484,6495,43134,0
1,24,652,304,544,16,6,88,668,6,89,51,101,95,152,591,998,3,3399,188,0,2,1,0,81460,32485,6495,43135,0
1,24,2,2,2,0,0,0,2,0,0,0,0,0,0,0,0,0,0,0,0,2,1,0,81460,32485,6495,43135,0
1,24,8,5,5,0,0,3,8,0,0,0,0,0,0,0,0,0,0,0,0,2,1,0,81460,32485,6495,43136,0
1,24,2,2,2,0,0,0,2,0,0,0,0,0,0,0,0,0,0,0,0,2,1,0,81460,32485,6495,43136,0
1,24,14,8,8,0,0,6,14,0,0,0,0,0,0,0,0,0,0,0,0,2,1,0,81460,32485,6495,43137,0
1,24,6,4,4,0,0,2,6,0,0,0,0,0,0,0,0,0,0,0,0,2,1,0,81460,32485,6495,43138,0
1,24,6,4,4,0,0,2,6,1,2,1,2,3,3,2,4,0,2,0,0,2,1,0,81460,32485,6495,43139,0
1,24,6,4,4,0,0,2,6,0,0,0,0,0,0,0,0,0,0,0,0,2,1,0,81460,32485,6495,43140,0
1,24,7,5,5,0,0,2,7,0,0,0,0,0,0,0,0,0,0,0,0,2,1,0,81460,32485,6495,43141,0
1,24,6,4,4,0,0,2,6,0,0,0,0,0,0,0,0,0,0,0,0,2,1,0,81460,32485,6495,43142,0
1,24,10,6,6,0,0,4,10,0,0,0,0,0,0,0,0,0,0,0,0,2,1,0,81460,32485,6495,43143,0
1,24,1,1,1,0,0,0,1,0,0,0,0,0,0,0,0,0,0,0,0,2,1,0,81460,32485,6495,43143,0
1,24,14,10,10,0,0,4,14,1,1,1,1,2,2,0,2,0,1,0,0,2,1,0,81460,32485,6495,43144,0
1,24,46,26,30,3,0,12,49,3,6,3,6,9,9,20,28,1,42,2,0,2,1,0,81470,32485,6495,43145,0
1,7,2,2,2,0,0,0,2,0,0,0,0,0,0,0,0,0,0,0,0,2,1,0,81470,32485,6495,43145,0
3,33,15,9,9,0,0,6,15,0,0,0,0,0,0,0,0,0,0,0,0,2,1,0,81470,32485,6495,43146,0
1,13,127,75,83,2,11,30,129,4,14,7,14,18,21,61,87,2,175,9,0,2,1,0,81470,32485,6495,43147,0
1,13,652,304,544,16,6,88,668,6,89,51,101,95,152,591,998,3,3399,188,0,2,1,0,81470,32486,6495,43148,0
1,13,2,2,2,0,0,0,2,0,0,0,0,0,0,0,0,0,0,0,0,2,1,0,81470,32486,6495,43148,0
1,13,8,5,5,0,0,3,8,0,0,0,0,0,0,0,0,0,0,0,0,2,1,0,81470,32486,6495,43149,0
1,13,2,2,2,0,0,0,2,0,0,0,0,0,0,0,0,0,0,0,0,2,1,0,81470,32486,6495,43149,0
1,13,14,8,8,0,0,6,14,0,0,0,0,0,0,0,0,0,0,0,0,2,1,0,81470,32486,6495,43150,0
1,13,6,4,4,0,0,2,6,0,0,0,0,0,0,0,0,0,0,0,0,2,1,0,81470,32486,6495,43151,0
1,13,6,4,4,0,0,2,6,1,2,1,2,3,3,2,4,0,2,0,0,2,1,0,81470,32486,6495,43152,0
1,13,6,4,4,0,0,2,6,0,0,0,0,0,0,0,0,0,0,0,0,2,1,0,81470,32486,6495,43153,0
1,13,7,5,5,0,0,2,7,0,0,0,0,0,0,0,0,0,0,0,0,2,1,0,81470,32486,6495,43154,0
1,13,6,4,4,0,0,2,6,0,0,0,0,0,0,0,0,0,0,0,0,2,1,0,81470,32486,6495,43155,0
1,13,10,6,6,0,0,4,10,0,0,0,0,0,0,0,0,0,0,0,0,2,1,0,81470,32486,6495,43156,0
1,13,1,1,1,0,0,0,1,0,0,0,0,0,0,0,0,0,0,0,0,2,1,0,81470,32486,6495,43156,0
1,13,14,10,10,0,0,4,14,1,1,1,1,2,2,0,2,0,1,0,0,2,1,0,81470,32486,6495,43157,0
1,13,46,26,30,3,0,12,49,3,6,3,6,9,9,20,28,1,42,2,0,2,1,0,81480,32486,6495,43158,0
1,16,127,75,83,2,11,30,129,4,14,7,14,18,21,61,87,2,175,9,0,2,1,0,81480,32486,6495,43159,0
1,16,652,304,544,16,6,88,668,6,89,51,101,95,152,591,998,3,3399,188,0,2,1,0,81480,32487,6495,43160,0
1,16,2,2,2,0,0,0,2,0,0,0,0,0,0,0,0,0,0,0,0,2,1,0,81480,32487,6495,43160,0
1,16,8,5,5,0,0,3,8,0,0,0,0,0,0,0,0,0,0,0,0,2,1,0,81480,32487,6495,43161,0
1,16,2,2,2,0,0,0,2,0,0,0,0,0,0,0,0,0,0,0,0,2,1,0,81480,32487,6495,43161,0
1,16,14,8,8,0,0,6,14,0,0,0,0,0,0,0,0,0,0,0,0,2,1,0,81480,32487,6495,43162,0
1,16,6,4,4,0,0,2,6,0,0,0,0,0,0,0,0,0,0,0,0,2,1,0,81480,32487,6495,43163,0
1,16,6,4,4,0,0,2,6,1,2,1,2,3,3,2,4,0,2,0,0,2,1,0,81480,32487,6495,43164,0
1,16,6,4,4,0,0,2,6,0,0,0,0,0,0,0,0,0,0,0,0,2,1,0,81480,32487,6495,43165,0
1,16,7,5,5,0,0,2,7,0,0,0,0,0,0,0,0,0,0,0,0,2,1,0,81480,32487,6495,43166,0
1,16,6,4,4,0,0,2,6,0,0,0,0,0,0,0,0,0,0,0,0,2,1,0,81480,32487,6495,43167,0
1,16,10,6,6,0,0,4,10,0,0,0,0,0,0,0,0,0,0,0,0,2,1,0,81480,32487,6495,43168,0
1,16,1,1,1,0,0,0,1,0,0,0,0,0,0,0,0,0,0,0,0,2,1,0,81480,32487,6495,43168,0
1,16,14,10,10,0,0,4,14,1,1,1,1,2,2,0,2,0,1,0,0,2,1,0,81480,32487,6495,43169,0
1,16,46,26,30,3,0,12,49,3,6,3,6,9,9,20,28,1,42,2,0,2,1,0,81490,32487,6495,43170,0
1,10,2,2,2,0,0,0,2,1,2,1,2,3,3,2,4,0,2,0,0,2,1,0,81490,32487,6495,43170,0
1,13,127,75,83,2,11,30,129,4,14,7,14,18,21,61,87,2,175,9,0,2,1,0,81490,32487,6495,43171,0
1,13,652,304,544,16,6,88,668,6,89,51,101,95,152,591,998,3,3399,188,0,2,1,0,81490,32488,6495,43172,0
1,13,2,2,2,0,0,0,2,0,0,0,0,0,0,0,0,0,0,0,0,2,1,0,81490,32488,6495,43172,0
1,13,8,5,5,0,0,3,8,0,0,0,0,0,0,0,0,0,0,0,0,2,1,0,81490,32488,6495,43173,0
1,13,2,2,2,0,0,0,2,0,0,0,0,0,0,0,0,0,0,0,0,2,1,0,81490,32488,6495,43173,0
1,13,14,8,8,0,0,6,14,0,0,0,0,0,0,0,0,0,0,0,0,2,1,0,81490,32488,6495,43174,0
1,13,6,4,4,0,0,2,6,0,0,0,0,0,0,0,0,0,0,0,0,2,1,0,81490,32488,6495,43175,0
1,13,6,4,4,0,0,2,6,1,2,1,2,3,3,2,4,0,2,0,0,2,1,0,81490,32488,6495,43176,0
1,13,6,4,4,0,0,2,6,0,0,0,0,0,0,0,0,0,0,0,0,2,1,0,81490,32488,6495,43177,0
1,13,7,5,5,0,0,2,7,0,0,0,0,0,0,0,0,0,0,0,0,2,1,0,81490,32488,6495,43178,0
1,13,6,4,4,0,0,2,6,0,0,0,0,0,0,0,0,0,0,0,0,2,1,0,81490,32488,6495,43179,0
1,13,10,6,6,0,0,4,10,0,0,0,0,0,0,0,0,0,0,0,0,2,1,0,81490,32488,6495,43180,0
1,13,1,1,1,0,0,0,1,0,0,0,0,0,0,0,0,0,0,0,0,2,1,0,81490,32488,6495,43180,0
1,13,14,10,10,0,0,4,14,1,1,1,1,2,2,0,2,0,1,0,0,2,1,0,81490,32488,6495,43181,0
1,13,46,26,30,3,0,12,49,3,6,3,6,9,9,20,28,1,42,2,0,2,1,0,81500,32488,6495,43182,0
2,26,10,6,6,0,0,4,10,2,4,2,4,6,6,10,15,1,15,0,0,2,1,0,81500,32488,6495,43183,0
3,47,15,10,10,0,0,5,15,2,4,2,4,6,6,10,15,1,15,0,0,2,1,0,81500,32488,6495,43184,0
3,39,15,9,9,0,0,6,15,0,0,0,0,0,0,0,0,0,0,0,0,2,1,0,81500,32488,6495,43185,0
2,36,10,7,7,0,0,3,10,1,2,1,2,3,3,2,4,0,2,0,0,2,1,0,81500,32488,6495,43186,0
3,46,15,9,9,0,0,6,15,1,4,2,4,5,6,8,13,0,6,0,0,2,1,0,81500,32488,6495,43187,0
2,21,10,6,6,0,0,4,10,0,0,0,0,0,0,0,0,0,0,0,0,2,1,0,81500,32488,6495,43188,0
4,61,20,12,12,0,0,8,20,1,2,1,2,3,3,2,4,0,2,0,0,2,1,0,81500,32488,6495,43189,0
2,51,127,75,83,2,11,30,129,4,14,7,14,18,21,61,87,2,175,9,0,2,1,0,81500,32488,6495,43190,0
2,51,652,304,544,16,6,88,668,6,89,51,101,95,152,591,998,3,3399,188,0,2,1,0,81500,32489,6495,43191,0
2,51,2,2,2,0,0,0,2,0,0,0,0,0,0,0,0,0,0,0,0,2,1,0,81500,32489,6495,43191,0
2,51,8,5,5,0,0,3,8,0,0,0,0,0,0,0,0,0,0,0,0,2,1,0,81500,32489,6495,43192,0
2,51,2,2,2,0,0,0,2,0,0,0,0,0,0,0,0,0,0,0,0,2,1,0,81500,32489,6495,43192,0
2,51,14,8,8,0,0,6,14,0,0,0,0,0,0,0,0,0,0,0,0,2,1,0,81500,32489,6495,43193,0
2,51,6,4,4,0,0,2,6,0,0,0,0,0,0,0,0,0,0,0,0,2,1,0,81500,32489,6495,43194,0
2,51,6,4,4,0,0,2,6,1,2,1,2,3,3,2,4,0,2,0,0,2,1,0,81500,32489,6495,43195,0
2,51,6,4,4,0,0,2,6,0,0,0,0,0,0,0,0,0,0,0,0,2,1,0,81500,32489,6495,43196,0
2,51,7,5,5,0,0,2,7,0,0,0,0,0,0,0,0,0,0,0,0,2,1,0,81500,32489,6495,43197,0
2,51,6,4,4,0,0,2,6,0,0,0,0,0,0,0,0,0,0,0,0,2,1,0,81500,32489,6495,43198,0
2,51,10,6,6,0,0,4,10,0,0,0,0,0,0,0,0,0,0,0,0,2,1,0,81500,32489,6495,43199,0
2,51,1,1,1,0,0,0,1,0,0,0,0,0,0,0,0,0,0,0,0,2,1,0,81500,32489,6495,43199,0
2,51,14,10,10,0,0,4,14,1,1,1,1,2,2,0,2,0,1,0,0,2,1,0,81500,32489,6495,43200,0
2,51,46,26,30,3,0,12,49,3,6,3,6,9,9,20,28,1,42,2,0,2,1,0,81510,32489,6495,43201,0
1,6,2,2,2,0,0,0,2,0,0,0,0,0,0,0,0,0,0,0,0,2,1,0,81510,32489,6495,43201,0
8,263,51,25,36,0,0,15,51,3,11,6,12,14,18,42,68,1,112,6,0,2,1,0,81510,32489,6495,43202,0
1,14,6,4,4,0,0,2,6,0,0,0,0,0,0,0,0,0,0,0,0,2,1,0,81510,32489,6495,43203,0
4,163,27,21,21,0,0,6,27,3,6,3,6,9,9,20,28,1,42,2,0,2,1,0,81510,32489,6495,43204,0
1,6,2,2,2,0,0,0,2,0,0,0,0,0,0,0,0,0,0,0,0,2,1,0,81510,32489,6495,43204,0
1,41,7,5,5,0,0,2,7,1,2,1,2,3,3,2,4,0,2,0,0,2,1,0,81510,32489,6495,43205,0
2,51,14,9,9,0,0,5,14,0,0,0,0,0,0,0,0,0,0,0,0,2,1,0,81510,32489,6495,43206,0
2,40,13,9,8,0,0,4,13,0,0,0,0,0,0,0,0,0,0,0,0,2,1,0,81510,32489,6495,43207,0
2,42,14,10,9,0,0,4,14,0,0,0,0,0,0,0,0,0,0,0,0,2,1,0,81510,32489,6495,43208,0
2,33,12,8,7,0,0,4,12,0,0,0,0,0,0,0,0,0,0,0,0,2,1,0,81510,32489,6495,43209,0
3,49,16,9,9,0,0,7,16,0,0,0,0,0,0,0,0,0,0,0,0,2,1,0,81510,32489,6495,43210,0
1,18,3,3,3,0,0,0,3,0,0,0,0,0,0,0,0,0,0,0,0,2,1,0,81510,32489,6495,43210,0
2,26,6,4,4,0,0,2,6,1,4,2,4,5,6,8,13,0,6,0,0,2,1,0,81510,32489,6495,43212,0
1,134,149,67,118,4,0,27,153,1,17,14,28,18,42,69,175,0,144,8,0,2,1,0,81510,32489,6495,43214,0
66,4392,520,294,400,33,13,81,553,10,261,204,367,271,571,2128,4614,7,32445,1802,1,2,1,1,81510,32490,6495,43215,0
90,3974,1338,495,1086,10,64,173,1348,11,122,82,157,133,239,883,1686,7,11934,663,0,2,1,1,81510,32492,6495,43216,0
33,999,465,148,393,5,8,60,470,4,31,20,31,35,51,161,261,2,523,29,0,2,1,0,81510,32493,6495,43217,0
33,999,16,12,9,0,0,6,16,1,2,1,2,3,3,2,4,0,2,0,0,2,1,0,81510,32493,6495,43218,0
144,5944,1782,648,1425,9,47,279,1791,8,171,97,189,179,286,1292,2140,4,9462,525,0,2,96,0,81510,32494,6496,43219,0
33,1041,256,139,192,9,7,47,265,4,23,12,24,27,36,112,171,2,357,19,0,2,1,0,81510,32495,6496,43220,0
23,613,102,59,69,5,3,24,107,6,22,15,28,28,43,113,206,3,789,43,0,2,1,0,81510,32495,6496,43221,0
48,3659,996,429,845,24,10,117,1020,7,76,50,88,83,138,494,879,4,3565,198,0,2,1,0,81510,32497,6496,43222,0
126,5406,1513,682,1277,25,13,200,1538,11,199,116,219,210,335,1557,2584,6,15641,868,0,2,1,1,81510,32499,6496,43223,0
85,4936,1296,573,1062,40,33,157,1336,8,201,118,231,209,349,1561,2689,4,12365,686,0,2,1,0,81510,32499,6496,43224,0
21,500,207,111,150,11,0,50,218,5,26,19,36,31,55,133,272,3,943,52,0,2,1,0,81510,32499,6496,43225,0
98,5250,1457,730,1242,11,6,188,1468,10,292,166,329,302,495,2424,4078,5,22973,1276,1,2,12,0,81510,32501,6496,43226,0
43,2690,652,304,544,16,6,88,668,6,89,51,101,95,152,591,998,3,3399,188,0,2,1,0,81510,32502,6496,43227,0
72,3310,1455,414,1257,16,76,112,1471,5,41,23,46,46,69,231,381,2,1069,59,0,2,3,3,81510,32503,6496,43228,0
2,56,7,6,5,0,0,2,7,1,1,1,2,2,3,0,3,1,3,0,0,2,1,0,81510,32503,6496,43229,0
8,275,74,35,59,1,0,14,75,3,14,7,14,17,21,58,85,1,128,7,0,2,1,0,81510,32504,6496,43230,0
70,3187,1020,354,843,12,15,144,1032,8,134,77,144,142,221,970,1580,4,6792,377,0,2,1,0,81510,32504,6496,43231,0
47,2189,447,308,343,6,5,95,453,7,96,59,111,103,170,651,1136,4,4600,255,0,2,1,0,81510,32507,6496,43232,0
3,229,53,23,39,0,0,13,53,2,8,4,8,10,12,26,39,1,39,2,0,2,1,0,81510,32507,6496,43233,0
21,655,424,94,331,4,0,89,428,1,5,5,5,6,10,11,25,0,12,0,0,2,2,2,81510,32508,6496,43234,0
38,2327,334,251,279,10,4,40,344,5,127,74,143,132,217,899,1528,2,4303,239,0,2,1,0,81510,32509,6496,43235,0
12,497,184,100,137,2,15,30,186,6,38,20,39,44,59,214,322,3,991,55,0,2,2,2,81510,32510,6496,43236,0
8,377,91,45,69,0,3,18,91,3,9,6,10,12,16,33,57,1,95,5,0,2,1,0,81510,32512,6496,43237,0
78,3962,1293,570,1093,25,15,163,1318,10,195,123,241,205,364,1516,2795,6,17273,959,0,2,20,8,81520,32514,6496,43238,0
29,1903,384,251,317,7,8,52,391,11,70,44,84,81,128,467,811,6,5355,297,0,2,2,2,81520,32514,6496,43239,0
45,1953,386,256,301,16,9,68,402,4,59,35,69,63,104,355,621,2,1453,80,0,2,1,0,81520,32514,6496,43240,0
28,1596,466,257,367,18,25,50,484,7,126,86,171,133,257,898,1813,4,8612,478,0,2,1,0,81520,32514,6496,43241,0
15,1066,215,129,180,6,0,29,221,8,65,43,72,73,115,415,711,4,3153,175,0,2,1,0,81520,32514,6496,43242,0
86,3411,1043,504,840,53,9,147,1096,9,180,112,198,189,310,1377,2344,4,11604,644,0,2,1,1,81520,32516,6496,43243,0
12,478,295,56,236,0,4,54,295,2,9,5,10,11,15,30,51,1,57,3,0,2,1,0,81520,32518,6496,43244,0
30,1440,373,158,315,8,0,51,381,5,76,44,79,81,123,486,779,2,2026,112,0,2,1,0,81520,32518,6496,43245,0
81,3172,1178,367,1042,6,15,115,1184,9,94,51,95,103,146,644,976,4,4439,246,0,2,1,1,81520,32518,6496,43246,0
9,449,219,78,157,11,5,46,230,3,24,20,34,27,54,114,256,2,545,30,0,2,1,0,81520,32519,6496,43247,0
111,6122,1943,715,1694,26,18,214,1969,12,185,120,237,197,357,1436,2721,7,20915,1161,0,2,1,1,81520,32521,6496,43248,0
37,1519,442,244,305,14,16,103,456,11,68,45,75,79,120,452,756,6,4588,254,0,2,1,0,81520,32523,6496,43249,0
52,1986,1098,241,925,5,10,155,1103,7,46,25,49,53,74,273,423,3,1580,87,0,2,1,0,81530,32525,6496,43250,0
53,1862,601,196,481,2,23,85,603,8,63,36,72,71,108,400,664,4,3036,168,0,2,4,4,81530,32525,6496,43251,0
3,42,14,8,8,0,0,6,14,0,0,0,0,0,0,0,0,0,0,0,0,2,1,0,81530,32525,6496,43254,0
2,40,9,6,6,0,0,3,9,0,0,0,0,0,0,0,0,0,0,0,0,2,1,0,81530,32525,6496,43255,0
2,40,13,9,8,0,0,4,13,0,0,0,0,0,0,0,0,0,0,0,0,2,1,0,81530,32525,6496,43256,0
60,1163,282,196,195,3,0,86,285,8,130,71,141,138,212,936,1507,4,6538,363,0,2,1,0,81540,32526,6497,43270,0
4,77,127,75,83,2,11,30,129,4,14,7,14,18,21,61,87,2,175,9,0,2,1,0,81540,32526,6497,43271,0
4,77,652,304,544,16,6,88,668,6,89,51,101,95,152,591,998,3,3399,188,0,2,1,0,81540,32527,6497,43272,0
4,77,2,2,2,0,0,0,2,0,0,0,0,0,0,0,0,0,0,0,0,2,1,0,81540,32527,6497,43272,0
4,77,8,5,5,0,0,3,8,0,0,0,0,0,0,0,0,0,0,0,0,2,1,0,81540,32527,6497,43273,0
4,77,2,2,2,0,0,0,2,0,0,0,0,0,0,0,0,0,0,0,0,2,1,0,81540,32527,6497,43273,0
4,77,14,8,8,0,0,6,14,0,0,0,0,0,0,0,0,0,0,0,0,2,1,0,81540,32527,6497,43274,0
4,77,6,4,4,0,0,2,6,0,0,0,0,0,0,0,0,0,0,0,0,2,1,0,81540,32527,6497,43275,0
4,77,6,4,4,0,0,2,6,1,2,1,2,3,3,2,4,0,2,0,0,2,1,0,81540,32527,6497,43276,0
4,77,6,4,4,0,0,2,6,0,0,0,0,0,0,0,0,0,0,0,0,2,1,0,81540,32527,6497,43277,0
4,77,7,5,5,0,0,2,7,0,0,0,0,0,0,0,0,0,0,0,0,2,1,0,81540,32527,6497,43278,0
4,77,6,4,4,0,0,2,6,0,0,0,0,0,0,0,0,0,0,0,0,2,1,0,81540,32527,6497,43279,0
4,77,10,6,6,0,0,4,10,0,0,0,0,0,0,0,0,0,0,0,0,2,1,0,81540,32527,6497,43280,0
4,77,1,1,1,0,0,0,1,0,0,0,0,0,0,0,0,0,0,0,0,2,1,0,81540,32527,6497,43280,0
4,77,14,10,10,0,0,4,14,1,1,1,1,2,2,0,2,0,1,0,0,2,1,0,81540,32527,6497,43281,0
4,77,46,26,30,3,0,12,49,3,6,3,6,9,9,20,28,1,42,2,0,2,1,0,81550,32527,6497,43282,0
1,9,5,3,3,0,0,2,5,0,0,0,0,0,0,0,0,0,0,0,0,2,1,0,81550,32527,6497,43282,0
1,90,13,10,10,0,0,3,13,1,2,1,2,3,3,2,4,0,2,0,0,2,1,0,81550,32527,6497,43283,0
7,114,44,19,17,0,16,11,44,3,14,7,14,17,21,58,85,1,128,7,0,2,1,0,81550,32527,6497,43284,0
3,66,127,75,83,2,11,30,129,4,14,7,14,18,21,61,87,2,175,9,0,2,1,0,81560,32528,6497,43297,0
3,66,652,304,544,16,6,88,668,6,89,51,101,95,152,591,998,3,3399,188,0,2,1,0,81560,32529,6497,43298,0
3,66,2,2,2,0,0,0,2,0,0,0,0,0,0,0,0,0,0,0,0,2,1,0,81560,32529,6497,43298,0
3,66,8,5,5,0,0,3,8,0,0,0,0,0,0,0,0,0,0,0,0,2,1,0,81560,32529,6497,43299,0
3,66,2,2,2,0,0,0,2,0,0,0,0,0,0,0,0,0,0,0,0,2,1,0,81560,32529,6497,43299,0
3,66,14,8,8,0,0,6,14,0,0,0,0,0,0,0,0,0,0,0,0,2,1,0,81560,32529,6497,43300,0
3,66,6,4,4,0,0,2,6,0,0,0,0,0,0,0,0,0,0,0,0,2,1,0,81560,32529,6497,43301,0
3,66,6,4,4,0,0,2,6,1,2,1,2,3,3,2,4,0,2,0,0,2,1,0,81560,32529,6497,43302,0
3,66,6,4,4,0,0,2,6,0,0,0,0,0,0,0,0,0,0,0,0,2,1,0,81560,32529,6497,43303,0
3,66,7,5,5,0,0,2,7,0,0,0,0,0,0,0,0,0,0,0,0,2,1,0,81560,32529,6497,43304,0
3,66,6,4,4,0,0,2,6,0,0,0,0,0,0,0,0,0,0,0,0,2,1,0,81560,32529,6497,43305,0
3,66,10,6,6,0,0,4,10,0,0,0,0,0,0,0,0,0,0,0,0,2,1,0,81560,32529,6497,43306,0
3,66,1,1,1,0,0,0,1,0,0,0,0,0,0,0,0,0,0,0,0,2,1,0,81560,32529,6497,43306,0
3,66,14,10,10,0,0,4,14,1,1,1,1,2,2,0,2,0,1,0,0,2,1,0,81560,32529,6497,43307,0
3,66,46,26,30,3,0,12,49,3,6,3,6,9,9,20,28,1,42,2,0,2,1,0,81570,32529,6497,43308,0
7,296,72,33,56,0,4,12,72,1,1,1,1,2,2,0,2,0,1,0,0,2,1,0,81590,32537,6499,43323,0
12,229,127,75,83,2,11,30,129,4,14,7,14,18,21,61,87,2,175,9,0,2,1,0,81590,32537,6499,43324,0
12,229,652,304,544,16,6,88,668,6,89,51,101,95,152,591,998,3,3399,188,0,2,1,0,81590,32538,6499,43325,0
12,229,2,2,2,0,0,0,2,0,0,0,0,0,0,0,0,0,0,0,0,2,1,0,81590,32538,6499,43325,0
12,229,8,5,5,0,0,3,8,0,0,0,0,0,0,0,0,0,0,0,0,2,1,0,81590,32538,6499,43326,0
12,229,2,2,2,0,0,0,2,0,0,0,0,0,0,0,0,0,0,0,0,2,1,0,81590,32538,6499,43326,0
12,229,14,8,8,0,0,6,14,0,0,0,0,0,0,0,0,0,0,0,0,2,1,0,81590,32538,6499,43327,0
12,229,6,4,4,0,0,2,6,0,0,0,0,0,0,0,0,0,0,0,0,2,1,0,81590,32538,6499,43328,0
12,229,6,4,4,0,0,2,6,1,2,1,2,3,3,2,4,0,2,0,0,2,1,0,81590,32538,6499,43329,0
12,229,6,4,4,0,0,2,6,0,0,0,0,0,0,0,0,0,0,0,0,2,1,0,81590,32538,6499,43330,0
12,229,7,5,5,0,0,2,7,0,0,0,0,0,0,0,0,0,0,0,0,2,1,0,81590,32538,6499,43331,0
12,229,6,4,4,0,0,2,6,0,0,0,0,0,0,0,0,0,0,0,0,2,1,0,81590,32538,6499,43332,0
12,229,10,6,6,0,0,4,10,0,0,0,0,0,0,0,0,0,0,0,0,2,1,0,81590,32538,6499,43333,0
12,229,1,1,1,0,0,0,1,0,0,0,0,0,0,0,0,0,0,0,0,2,1,0,81590,32538,6499,43333,0
12,229,14,10,10,0,0,4,14,1,1,1,1,2,2,0,2,0,1,0,0,2,1,0,81590,32538,6499,43334,0
12,229,46,26,30,3,0,12,49,3,6,3,6,9,9,20,28,1,42,2,0,2,1,0,81600,32538,6499,43335,0
6,71,127,75,83,2,11,30,129,4,14,7,14,18,21,61,87,2,175,9,0,2,1,0,81600,32538,6499,43336,0
6,71,652,304,544,16,6,88,668,6,89,51,101,95,152,591,998,3,3399,188,0,2,1,0,81600,32539,6499,43337,0
6,71,2,2,2,0,0,0,2,0,0,0,0,0,0,0,0,0,0,0,0,2,1,0,81600,32539,6499,43337,0
6,71,8,5,5,0,0,3,8,0,0,0,0,0,0,0,0,0,0,0,0,2,1,0,81600,32539,6499,43338,0
6,71,2,2,2,0,0,0,2,0,0,0,0,0,0,0,0,0,0,0,0,2,1,0,81600,32539,6499,43338,0
6,71,14,8,8,0,0,6,14,0,0,0,0,0,0,0,0,0,0,0,0,2,1,0,81600,32539,6499,43339,0
6,71,6,4,4,0,0,2,6,0,0,0,0,0,0,0,0,0,0,0,0,2,1,0,81600,32539,6499,43340,0
6,71,6,4,4,0,0,2,6,1,2,1,2,3,3,2,4,0,2,0,0,2,1,0,81600,32539,6499,43341,0
6,71,6,4,4,0,0,2,6,0,0,0,0,0,0,0,0,0,0,0,0,2,1,0,81600,32539,6499,43342,0
6,71,7,5,5,0,0,2,7,0,0,0,0,0,0,0,0,0,0,0,0,2,1,0,81600,32539,6499,43343,0
6,71,6,4,4,0,0,2,6,0,0,0,0,0,0,0,0,0,0,0,0,2,1,0,81600,32539,6499,43344,0
6,71,10,6,6,0,0,4,10,0,0,0,0,0,0,0,0,0,0,0,0,2,1,0,81600,32539,6499,43345,0
6,71,1,1,1,0,0,0,1,0,0,0,0,0,0,0,0,0,0,0,0,2,1,0,81600,32539,6499,43345,0
6,71,14,10,10,0,0,4,14,1,1,1,1,2,2,0,2,0,1,0,0,2,1,0,81600,32539,6499,43346,0
6,71,46,26,30,3,0,12,49,3,6,3,6,9,9,20,28,1,42,2,0,2,1,0,81610,32539,6499,43347,0
3,26,14,7,7,2,0,5,16,0,0,0,0,0,0,0,0,0,0,0,0,2,1,0,81610,32539,6499,43347,0
7,103,38,23,23,0,0,15,38,0,0,0,0,0,0,0,0,0,0,0,0,2,1,0,81610,32539,6499,43348,0
17,378,85,59,61,8,0,16,93,5,18,10,18,23,28,86,126,2,316,17,0,2,1,0,81610,32539,6499,43349,0
12,515,124,78,88,2,3,26,126,4,13,7,13,17,20,56,81,2,163,9,0,2,1,0,81610,32539,6499,43352,0
1,98,42,7,35,4,0,5,46,1,2,1,2,3,3,2,4,0,2,0,0,2,1,0,81610,32539,6499,43353,0
1,98,11,6,10,0,0,1,11,2,4,2,4,6,6,10,15,1,15,0,0,2,1,0,81610,32539,6499,43354,0
11,242,19,8,11,5,0,4,24,2,5,3,6,7,9,13,25,1,30,1,0,2,1,0,81620,32543,6500,43362,0
11,242,102,59,69,5,3,24,107,6,22,15,28,28,43,113,206,3,789,43,0,2,1,0,81620,32543,6500,43363,0
11,242,106,40,36,3,49,17,109,8,17,13,23,25,36,93,167,5,904,50,0,2,1,0,81620,32543,6500,43364,0
229,4960,182,127,129,0,0,53,182,5,39,21,42,44,63,217,343,2,926,51,0,2,6,4,81630,32547,6502,43372,0
229,4960,1165,710,800,67,119,181,1232,18,243,153,282,261,435,2000,3492,10,36473,2026,1,2,6,4,81640,32547,6503,43373,0
67,1570,773,419,590,28,0,166,801,10,204,113,217,214,330,1598,2554,5,13587,754,0,2,1,0,81640,32547,6504,43374,0
67,1570,421,273,302,44,34,57,465,17,81,59,107,98,166,583,1098,11,12329,684,0,2,1,0,81640,32547,6505,43375,0
14,411,149,95,105,2,0,41,151,8,54,28,55,62,83,334,494,4,2013,111,0,2,1,0,81640,32547,6505,43376,0
14,411,82,56,54,0,13,15,82,4,13,8,16,17,24,56,98,2,241,13,0,2,1,0,81650,32547,6505,43377,0
26,529,2,2,2,0,0,0,2,0,0,0,0,0,0,0,0,0,0,0,0,2,1,0,81650,32547,6505,43377,0
26,529,99,48,90,1,3,5,100,0,0,0,0,0,0,0,0,0,0,0,0,2,1,0,81650,32548,6505,43378,0
26,529,8,5,5,2,0,1,10,0,0,0,0,0,0,0,0,0,0,0,0,2,1,0,81650,32548,6505,43379,0
26,529,1217,716,841,84,126,174,1301,14,185,118,215,199,333,1446,2542,8,20687,1149,0,2,1,0,81660,32550,6505,43380,0
26,529,160,89,115,0,13,31,160,7,15,11,17,22,28,78,124,3,495,27,0,2,1,0,81660,32550,6505,43381,0
26,529,10,10,9,9,0,0,19,0,0,0,0,0,0,0,0,0,0,0,0,2,1,0,81660,32550,6506,43382,0
26,529,173,84,99,8,29,36,181,5,12,7,13,17,20,54,81,2,221,12,0,2,1,0,81660,32551,6506,43383,0
26,529,3,1,1,3,0,0,6,0,0,0,0,0,0,0,0,0,0,0,0,2,1,0,81660,32551,6506,43384,0
188,5732,1660,832,1314,41,38,274,1701,20,312,209,395,332,604,2671,5058,12,64042,3557,1,2,5,1,81660,32553,6507,43386,0
188,5732,1057,646,719,113,100,145,1170,18,215,134,248,233,382,1740,3004,10,31186,1732,1,2,5,1,81670,32554,6508,43387,0
17,348,95,58,50,9,16,20,104,12,33,24,45,45,69,209,378,8,3100,172,0,2,1,0,81670,32554,6508,43388,0
116,2173,477,336,357,30,23,73,507,16,194,134,250,210,384,1538,2962,10,30538,1696,0,2,1,0,81680,32555,6508,43389,0
89,2050,996,429,845,24,10,117,1020,7,76,50,88,83,138,494,879,4,3565,198,0,2,1,0,81680,32557,6508,43390,0
89,2050,456,277,329,12,42,72,468,13,85,50,97,98,147,592,972,7,7212,400,0,2,1,0,81680,32557,6508,43391,0
166,3529,1513,682,1277,25,13,200,1538,11,199,116,219,210,335,1557,2584,6,15641,868,0,2,6,4,81680,32559,6508,43392,0
166,3529,819,519,539,24,98,155,843,15,96,57,106,111,163,690,1107,8,9171,509,0,2,6,4,81690,32561,6508,43393,0
73,1518,207,111,150,11,0,50,218,5,26,19,36,31,55,133,272,3,943,52,0,2,1,0,81690,32561,6508,43394,0
73,1518,410,198,237,31,55,97,441,11,63,38,72,74,110,414,683,6,4293,238,0,2,1,0,81700,32562,6509,43395,0
237,4939,2,2,2,0,0,0,2,0,0,0,0,0,0,0,0,0,0,0,0,2,4,3,81700,32562,6509,43395,0
237,4939,99,48,90,1,3,5,100,0,0,0,0,0,0,0,0,0,0,0,0,2,4,3,81700,32563,6509,43396,0
237,4939,8,5,5,2,0,1,10,0,0,0,0,0,0,0,0,0,0,0,0,2,4,3,81700,32563,6509,43397,0
237,4939,1217,716,841,84,126,174,1301,14,185,118,215,199,333,1446,2542,8,20687,1149,0,2,4,3,81710,32565,6509,43398,0
237,4939,160,89,115,0,13,31,160,7,15,11,17,22,28,78,124,3,495,27,0,2,4,3,81710,32565,6509,43399,0
237,4939,10,10,9,9,0,0,19,0,0,0,0,0,0,0,0,0,0,0,0,2,4,3,81710,32565,6510,43400,0
237,4939,173,84,99,8,29,36,181,5,12,7,13,17,20,54,81,2,221,12,0,2,4,3,81710,32566,6510,43401,0
237,4939,3,1,1,3,0,0,6,0,0,0,0,0,0,0,0,0,0,0,0,2,4,3,81710,32566,6510,43402,0
98,2019,463,295,324,28,62,57,491,12,134,82,154,146,236,989,1696,6,11700,650,0,2,1,0,81720,32567,6510,43403,0
55,770,167,116,138,4,5,22,171,8,48,30,56,56,86,292,499,4,2330,129,0,2,1,0,81720,32567,6510,43404,0
52,1442,339,213,244,17,9,65,356,10,42,26,48,52,74,259,421,5,2410,133,0,2,46,44,81730,32567,6510,43405,0
95,2385,1455,414,1257,16,76,112,1471,5,41,23,46,46,69,231,381,2,1069,59,0,2,1,0,81730,32568,6510,43407,0
95,2385,669,365,481,22,61,110,691,15,103,63,122,118,185,747,1273,8,11311,628,0,2,1,0,81740,32568,6511,43408,0
249,5763,4293,999,3693,19,54,507,4312,9,155,88,170,164,258,1156,1898,4,9368,520,0,2,10,0,81740,32570,6511,43409,0
249,5763,1482,859,1002,125,135,219,1607,16,219,134,251,235,385,1766,3032,9,27804,1544,1,2,10,0,81750,32571,6511,43410,0
6,140,44,22,19,0,19,6,44,2,10,6,12,12,18,35,64,1,77,4,0,2,1,0,81750,32571,6511,43411,0
31,1087,74,35,59,1,0,14,75,3,14,7,14,17,21,58,85,1,128,7,0,2,1,0,81750,32572,6511,43412,0
31,1087,245,125,200,5,7,34,250,7,30,17,34,37,51,166,265,3,1053,58,0,2,1,0,81760,32573,6511,43413,0
54,657,647,139,84,35,284,233,682,0,0,0,0,0,0,0,0,0,0,0,0,2,1,0,81760,32573,6511,43414,0
115,3128,1523,757,1297,19,12,193,1542,12,193,117,230,205,347,1508,2664,7,19053,1058,0,2,1,0,81770,32575,6511,43415,0
115,3128,701,378,504,33,58,109,734,13,110,68,126,123,194,794,1346,7,10027,557,0,2,1,0,81770,32576,6512,43416,0
101,2612,773,422,505,30,103,129,803,14,77,46,83,91,129,535,839,7,6334,351,0,2,1,0,81780,32577,6513,43417,0
159,3785,77,34,69,0,0,8,77,3,24,16,29,27,45,114,213,1,387,21,0,2,1,0,81780,32577,6513,43418,0
159,3785,712,438,573,51,9,84,763,14,102,71,128,116,199,733,1364,8,11988,666,0,2,1,0,81790,32578,6513,43419,0
24,612,2,2,2,0,0,0,2,0,0,0,0,0,0,0,0,0,0,0,0,2,1,0,81790,32578,6513,43419,0
24,612,99,48,90,1,3,5,100,0,0,0,0,0,0,0,0,0,0,0,0,2,1,0,81790,32579,6513,43420,0
24,612,8,5,5,2,0,1,10,0,0,0,0,0,0,0,0,0,0,0,0,2,1,0,81790,32579,6513,43421,0
24,612,1217,716,841,84,126,174,1301,14,185,118,215,199,333,1446,2542,8,20687,1149,0,2,1,0,81800,32581,6513,43422,0
24,612,160,89,115,0,13,31,160,7,15,11,17,22,28,78,124,3,495,27,0,2,1,0,81800,32581,6513,43423,0
24,612,10,10,9,9,0,0,19,0,0,0,0,0,0,0,0,0,0,0,0,2,1,0,81800,32581,6514,43424,0
24,612,173,84,99,8,29,36,181,5,12,7,13,17,20,54,81,2,221,12,0,2,1,0,81800,32582,6514,43425,0
24,612,3,1,1,3,0,0,6,0,0,0,0,0,0,0,0,0,0,0,0,2,1,0,81800,32582,6514,43426,0
30,664,125,97,103,3,0,19,128,9,25,17,27,34,44,144,223,4,1087,60,0,2,1,0,81800,32582,6515,43427,0
22,373,102,57,55,5,16,25,107,5,17,10,18,22,28,81,124,2,330,18,0,2,1,0,81800,32582,6515,43428,0
69,1527,402,202,227,24,74,80,426,12,52,33,61,64,94,339,564,7,3969,220,0,2,1,0,81800,32583,6515,43429,0
55,1174,447,308,343,6,5,95,453,7,96,59,111,103,170,651,1136,4,4600,255,0,2,1,0,81800,32586,6515,43430,0
55,1174,322,174,179,16,74,51,338,10,41,26,46,51,72,252,408,5,2291,127,0,2,1,0,81800,32589,6516,43431,0
75,1629,53,23,39,0,0,13,53,2,8,4,8,10,12,26,39,1,39,2,0,2,1,0,81800,32589,6516,43432,0
75,1629,515,298,307,33,80,99,548,12,63,44,77,75,121,419,753,7,5527,307,0,2,1,0,81810,32589,6516,43433,0
18,312,424,94,331,4,0,89,428,1,5,5,5,6,10,11,25,0,12,0,0,2,1,0,81810,32590,6516,43434,0
18,312,38,23,23,6,0,8,44,3,11,7,11,14,18,42,68,1,102,5,0,2,1,0,81810,32590,6516,43435,0
19,513,205,80,86,16,53,53,221,7,18,10,19,25,29,94,134,3,497,27,0,2,1,0,81820,32590,6517,43436,0
17,523,184,100,137,2,15,30,186,6,38,20,39,44,59,214,322,3,991,55,0,2,1,0,81820,32591,6517,43437,0
17,523,103,65,74,8,5,16,111,7,17,9,17,24,26,89,119,3,417,23,0,2,1,0,81820,32592,6517,43438,0
59,1228,91,45,69,0,3,18,91,3,9,6,10,12,16,33,57,1,95,5,0,2,1,0,81820,32594,6517,43439,0
59,1228,367,234,237,17,34,68,384,16,55,34,61,71,95,381,584,8,5183,287,0,2,1,0,81820,32595,6517,43440,0
231,5969,722,423,573,19,0,135,741,12,172,101,199,184,300,1320,2257,6,15668,870,0,2,1,0,81820,32597,6517,43442,0
231,5969,1508,847,911,44,250,301,1552,14,148,88,169,162,257,1120,1886,7,15077,837,0,2,1,0,81820,32598,6518,43443,0
314,6912,72,33,56,0,4,12,72,1,1,1,1,2,2,0,2,0,1,0,0,2,3,7,81820,32598,6518,43444,0
314,6912,1454,835,1044,76,110,219,1530,17,275,158,296,292,454,2297,3718,9,34017,1889,1,2,3,7,81830,32599,6518,43445,0
92,1886,757,253,292,73,244,162,830,13,61,38,67,74,105,409,651,7,4654,258,0,2,2,1,81830,32600,6518,43446,0
45,953,386,256,301,16,9,68,402,4,59,35,69,63,104,355,621,2,1453,80,0,2,1,0,81830,32600,6518,43447,0
45,953,264,131,164,11,41,46,275,6,38,22,40,44,62,214,338,3,1068,59,0,2,1,0,81840,32600,6519,43448,0
67,1753,466,257,367,18,25,50,484,7,126,86,171,133,257,898,1813,4,8612,478,0,2,1,0,81840,32600,6519,43449,0
67,1753,507,281,342,29,59,88,536,10,53,29,57,63,86,336,514,5,2764,153,0,2,1,0,81840,32600,6519,43450,0
25,552,215,129,180,6,0,29,221,8,65,43,72,73,115,415,711,4,3153,175,0,2,1,0,81840,32600,6519,43451,0
25,552,97,69,77,3,3,16,100,6,22,13,23,28,36,113,173,3,542,30,0,2,1,0,81840,32601,6519,43452,0
89,1894,1043,504,840,53,9,147,1096,9,180,112,198,189,310,1377,2344,4,11604,644,0,2,1,0,81840,32603,6519,43453,0
89,1894,383,288,292,26,6,62,409,11,65,38,67,76,105,429,656,5,3719,206,0,2,1,0,81840,32604,6519,43454,0
20,420,294,64,250,0,0,43,294,1,20,10,20,21,30,86,131,0,65,3,0,2,1,0,81840,32604,6519,43455,0
20,420,78,46,62,3,0,14,81,3,8,4,8,11,12,28,41,1,62,3,0,2,1,0,81840,32605,6519,43456,0
5,123,110,30,77,3,13,16,113,4,21,15,30,25,45,100,208,2,597,33,0,2,1,0,81840,32605,6519,43457,0
5,123,28,15,21,1,0,6,29,0,0,0,0,0,0,0,0,0,0,0,0,2,1,0,81840,32605,6519,43458,0
41,821,1178,367,1042,6,15,115,1184,9,94,51,95,103,146,644,976,4,4439,246,0,2,1,1,81840,32605,6519,43459,0
41,821,177,108,140,8,0,27,185,6,30,16,32,36,48,162,248,3,794,44,0,2,1,1,81840,32607,6519,43460,0
28,452,219,78,157,11,5,46,230,3,24,20,34,27,54,114,256,2,545,30,0,2,1,0,81840,32608,6519,43461,0
28,452,108,64,79,9,0,20,117,5,15,11,19,20,30,70,129,3,410,22,0,2,1,0,81840,32608,6519,43462,0
282,5915,1943,715,1694,26,18,214,1969,12,185,120,237,197,357,1436,2721,7,20915,1161,0,2,1,1,81840,32610,6519,43463,0
282,5915,1168,838,957,57,25,144,1225,19,348,224,416,367,640,3018,5452,11,61921,3440,1,2,1,1,81850,32612,6519,43464,0
19,720,442,244,305,14,16,103,456,11,68,45,75,79,120,452,756,6,4588,254,0,2,1,0,81850,32614,6519,43465,0
19,720,182,102,99,11,40,35,193,3,11,6,11,14,17,42,64,1,97,5,0,2,1,0,81850,32615,6519,43466,0
69,1323,1098,241,925,5,10,155,1103,7,46,25,49,53,74,273,423,3,1580,87,0,2,1,0,81860,32617,6519,43467,0
69,1323,282,202,222,14,2,44,296,8,42,24,43,50,67,250,378,4,1548,86,0,2,1,0,81860,32618,6519,43468,0
2,156,37,13,25,0,6,6,37,1,2,1,2,3,3,2,4,0,2,0,0,2,1,0,81860,32618,6519,43469,0
2,156,133,47,40,1,43,49,134,0,0,0,0,0,0,0,0,0,0,0,0,2,1,0,81860,32618,6519,43470,0
29,743,601,196,481,2,23,85,603,8,63,36,72,71,108,400,664,4,3036,168,0,2,1,0,81860,32618,6519,43471,0
29,743,156,79,106,5,16,28,161,5,14,8,15,19,23,64,97,2,261,14,0,2,1,0,81860,32618,6519,43472,0
36,1120,182,127,129,0,0,53,182,5,39,21,42,44,63,217,343,2,926,51,0,2,1,1,81860,32618,6520,43473,0
7,123,127,75,83,2,11,30,129,4,14,7,14,18,21,61,87,2,175,9,0,2,1,0,81860,32618,6520,43474,0
7,123,652,304,544,16,6,88,668,6,89,51,101,95,152,591,998,3,3399,188,0,2,1,0,81860,32619,6520,43475,0
7,123,2,2,2,0,0,0,2,0,0,0,0,0,0,0,0,0,0,0,0,2,1,0,81860,32619,6520,43475,0
7,123,8,5,5,0,0,3,8,0,0,0,0,0,0,0,0,0,0,0,0,2,1,0,81860,32619,6520,43476,0
7,123,2,2,2,0,0,0,2,0,0,0,0,0,0,0,0,0,0,0,0,2,1,0,81860,32619,6520,43476,0
7,123,14,8,8,0,0,6,14,0,0,0,0,0,0,0,0,0,0,0,0,2,1,0,81860,32619,6520,43477,0
7,123,6,4,4,0,0,2,6,0,0,0,0,0,0,0,0,0,0,0,0,2,1,0,81860,32619,6520,43478,0
7,123,6,4,4,0,0,2,6,1,2,1,2,3,3,2,4,0,2,0,0,2,1,0,81860,32619,6520,43479,0
7,123,6,4,4,0,0,2,6,0,0,0,0,0,0,0,0,0,0,0,0,2,1,0,81860,32619,6520,43480,0
7,123,7,5,5,0,0,2,7,0,0,0,0,0,0,0,0,0,0,0,0,2,1,0,81860,32619,6520,43481,0
7,123,6,4,4,0,0,2,6,0,0,0,0,0,0,0,0,0,0,0,0,2,1,0,81860,32619,6520,43482,0
7,123,10,6,6,0,0,4,10,0,0,0,0,0,0,0,0,0,0,0,0,2,1,0,81860,32619,6520,43483,0
7,123,1,1,1,0,0,0,1,0,0,0,0,0,0,0,0,0,0,0,0,2,1,0,81860,32619,6520,43483,0
7,123,14,10,10,0,0,4,14,1,1,1,1,2,2,0,2,0,1,0,0,2,1,0,81860,32619,6520,43484,0
7,123,46,26,30,3,0,12,49,3,6,3,6,9,9,20,28,1,42,2,0,2,1,0,81870,32619,6520,43485,0
14,845,75,38,59,1,3,12,76,2,4,2,4,6,6,10,15,1,15,0,0,2,1,0,81870,32619,6520,43486,0
2,67,16,12,9,0,0,6,16,1,2,1,2,3,3,2,4,0,2,0,0,2,1,0,81870,32619,6520,43487,0
1,6,2,2,2,0,0,0,2,0,0,0,0,0,0,0,0,0,0,0,0,2,1,0,81870,32619,6520,43487,0
1,6,99,48,90,1,3,5,100,0,0,0,0,0,0,0,0,0,0,0,0,2,1,0,81870,32620,6520,43488,0
1,6,8,5,5,2,0,1,10,0,0,0,0,0,0,0,0,0,0,0,0,2,1,0,81870,32620,6520,43489,0
1,6,1217,716,841,84,126,174,1301,14,185,118,215,199,333,1446,2542,8,20687,1149,0,2,1,0,81880,32622,6520,43490,0
1,6,160,89,115,0,13,31,160,7,15,11,17,22,28,78,124,3,495,27,0,2,1,0,81880,32622,6520,43491,0
1,6,10,10,9,9,0,0,19,0,0,0,0,0,0,0,0,0,0,0,0,2,1,0,81880,32622,6521,43492,0
1,6,173,84,99,8,29,36,181,5,12,7,13,17,20,54,81,2,221,12,0,2,1,0,81880,32623,6521,43493,0
1,6,3,1,1,3,0,0,6,0,0,0,0,0,0,0,0,0,0,0,0,2,1,0,81880,32623,6521,43494,0
1,6,2,2,2,0,0,0,2,0,0,0,0,0,0,0,0,0,0,0,0,2,1,0,81880,32623,6521,43494,0
1,8,127,75,83,2,11,30,129,4,14,7,14,18,21,61,87,2,175,9,0,2,1,0,81880,32623,6521,43495,0
1,8,652,304,544,16,6,88,668,6,89,51,101,95,152,591,998,3,3399,188,0,2,1,0,81880,32624,6521,43496,0
1,8,2,2,2,0,0,0,2,0,0,0,0,0,0,0,0,0,0,0,0,2,1,0,81880,32624,6521,43496,0
1,8,8,5,5,0,0,3,8,0,0,0,0,0,0,0,0,0,0,0,0,2,1,0,81880,32624,6521,43497,0
1,8,2,2,2,0,0,0,2,0,0,0,0,0,0,0,0,0,0,0,0,2,1,0,81880,32624,6521,43497,0
1,8,14,8,8,0,0,6,14,0,0,0,0,0,0,0,0,0,0,0,0,2,1,0,81880,32624,6521,43498,0
1,8,6,4,4,0,0,2,6,0,0,0,0,0,0,0,0,0,0,0,0,2,1,0,81880,32624,6521,43499,0
1,8,6,4,4,0,0,2,6,1,2,1,2,3,3,2,4,0,2,0,0,2,1,0,81880,32624,6521,43500,0
1,8,6,4,4,0,0,2,6,0,0,0,0,0,0,0,0,0,0,0,0,2,1,0,81880,32624,6521,43501,0
1,8,7,5,5,0,0,2,7,0,0,0,0,0,0,0,0,0,0,0,0,2,1,0,81880,32624,6521,43502,0
1,8,6,4,4,0,0,2,6,0,0,0,0,0,0,0,0,0,0,0,0,2,1,0,81880,32624,6521,43503,0
1,8,10,6,6,0,0,4,10,0,0,0,0,0,0,0,0,0,0,0,0,2,1,0,81880,32624,6521,43504,0
1,8,1,1,1,0,0,0,1,0,0,0,0,0,0,0,0,0,0,0,0,2,1,0,81880,32624,6521,43504,0
1,8,14,10,10,0,0,4,14,1,1,1,1,2,2,0,2,0,1,0,0,2,1,0,81880,32624,6521,43505,0
1,8,46,26,30,3,0,12,49,3,6,3,6,9,9,20,28,1,42,2,0,2,1,0,81890,32624,6521,43506,0
1,6,2,2,2,0,0,0,2,0,0,0,0,0,0,0,0,0,0,0,0,2,1,0,81890,32624,6521,43506,0
1,6,2,2,2,0,0,0,2,0,0,0,0,0,0,0,0,0,0,0,0,2,1,0,81900,32625,6521,43518,0
2,25,127,75,83,2,11,30,129,4,14,7,14,18,21,61,87,2,175,9,0,2,1,0,81900,32625,6521,43519,0
2,25,652,304,544,16,6,88,668,6,89,51,101,95,152,591,998,3,3399,188,0,2,1,0,81900,32626,6521,43520,0
2,25,2,2,2,0,0,0,2,0,0,0,0,0,0,0,0,0,0,0,0,2,1,0,81900,32626,6521,43520,0
2,25,8,5,5,0,0,3,8,0,0,0,0,0,0,0,0,0,0,0,0,2,1,0,81900,32626,6521,43521,0
2,25,2,2,2,0,0,0,2,0,0,0,0,0,0,0,0,0,0,0,0,2,1,0,81900,32626,6521,43521,0
2,25,14,8,8,0,0,6,14,0,0,0,0,0,0,0,0,0,0,0,0,2,1,0,81900,32626,6521,43522,0
2,25,6,4,4,0,0,2,6,0,0,0,0,0,0,0,0,0,0,0,0,2,1,0,81900,32626,6521,43523,0
2,25,6,4,4,0,0,2,6,1,2,1,2,3,3,2,4,0,2,0,0,2,1,0,81900,32626,6521,43524,0
2,25,6,4,4,0,0,2,6,0,0,0,0,0,0,0,0,0,0,0,0,2,1,0,81900,32626,6521,43525,0
2,25,7,5,5,0,0,2,7,0,0,0,0,0,0,0,0,0,0,0,0,2,1,0,81900,32626,6521,43526,0
2,25,6,4,4,0,0,2,6,0,0,0,0,0,0,0,0,0,0,0,0,2,1,0,81900,32626,6521,43527,0
2,25,10,6,6,0,0,4,10,0,0,0,0,0,0,0,0,0,0,0,0,2,1,0,81900,32626,6521,43528,0
2,25,1,1,1,0,0,0,1,0,0,0,0,0,0,0,0,0,0,0,0,2,1,0,81900,32626,6521,43528,0
2,25,14,10,10,0,0,4,14,1,1,1,1,2,2,0,2,0,1,0,0,2,1,0,81900,32626,6521,43529,0
2,25,46,26,30,3,0,12,49,3,6,3,6,9,9,20,28,1,42,2,0,2,1,0,81910,32626,6521,43530,0
1,55,14,12,10,0,0,4,14,1,2,1,2,3,3,2,4,0,2,0,0,2,1,0,81910,32626,6521,43531,0
1,58,14,12,10,0,0,4,14,1,2,1,2,3,3,2,4,0,2,0,0,2,1,0,81910,32626,6521,43532,0
1,55,14,12,10,0,0,4,14,1,2,1,2,3,3,2,4,0,2,0,0,2,1,0,81910,32626,6521,43533,0
1,77,19,18,14,0,0,5,19,1,2,1,2,3,3,2,4,0,2,0,0,2,1,0,81910,32626,6521,43534,0
2,18,10,6,6,0,0,4,10,0,0,0,0,0,0,0,0,0,0,0,0,2,1,0,81910,32626,6521,43535,0
2,36,127,75,83,2,11,30,129,4,14,7,14,18,21,61,87,2,175,9,0,2,1,0,81910,32626,6521,43536,0
2,36,652,304,544,16,6,88,668,6,89,51,101,95,152,591,998,3,3399,188,0,2,1,0,81910,32627,6521,43537,0
2,36,2,2,2,0,0,0,2,0,0,0,0,0,0,0,0,0,0,0,0,2,1,0,81910,32627,6521,43537,0
2,36,8,5,5,0,0,3,8,0,0,0,0,0,0,0,0,0,0,0,0,2,1,0,81910,32627,6521,43538,0
2,36,2,2,2,0,0,0,2,0,0,0,0,0,0,0,0,0,0,0,0,2,1,0,81910,32627,6521,43538,0
2,36,14,8,8,0,0,6,14,0,0,0,0,0,0,0,0,0,0,0,0,2,1,0,81910,32627,6521,43539,0
2,36,6,4,4,0,0,2,6,0,0,0,0,0,0,0,0,0,0,0,0,2,1,0,81910,32627,6521,43540,0
2,36,6,4,4,0,0,2,6,1,2,1,2,3,3,2,4,0,2,0,0,2,1,0,81910,32627,6521,43541,0
2,36,6,4,4,0,0,2,6,0,0,0,0,0,0,0,0,0,0,0,0,2,1,0,81910,32627,6521,43542,0
2,36,7,5,5,0,0,2,7,0,0,0,0,0,0,0,0,0,0,0,0,2,1,0,81910,32627,6521,43543,0
2,36,6,4,4,0,0,2,6,0,0,0,0,0,0,0,0,0,0,0,0,2,1,0,81910,32627,6521,43544,0
2,36,10,6,6,0,0,4,10,0,0,0,0,0,0,0,0,0,0,0,0,2,1,0,81910,32627,6521,43545,0
2,36,1,1,1,0,0,0,1,0,0,0,0,0,0,0,0,0,0,0,0,2,1,0,81910,32627,6521,43545,0
2,36,14,10,10,0,0,4,14,1,1,1,1,2,2,0,2,0,1,0,0,2,1,0,81910,32627,6521,43546,0
2,36,46,26,30,3,0,12,49,3,6,3,6,9,9,20,28,1,42,2,0,2,1,0,81920,32627,6521,43547,0
1,6,2,2,2,0,0,0,2,0,0,0,0,0,0,0,0,0,0,0,0,2,1,0,81920,32627,6521,43547,0
1,26,127,75,83,2,11,30,129,4,14,7,14,18,21,61,87,2,175,9,0,2,1,0,81920,32627,6521,43548,0
1,26,652,304,544,16,6,88,668,6,89,51,101,95,152,591,998,3,3399,188,0,2,1,0,81920,32628,6521,43549,0
1,26,2,2,2,0,0,0,2,0,0,0,0,0,0,0,0,0,0,0,0,2,1,0,81920,32628,6521,43549,0
1,26,8,5,5,0,0,3,8,0,0,0,0,0,0,0,0,0,0,0,0,2,1,0,81920,32628,6521,43550,0
1,26,2,2,2,0,0,0,2,0,0,0,0,0,0,0,0,0,0,0,0,2,1,0,81920,32628,6521,43550,0
1,26,14,8,8,0,0,6,14,0,0,0,0,0,0,0,0,0,0,0,0,2,1,0,81920,32628,6521,43551,0
1,26,6,4,4,0,0,2,6,0,0,0,0,0,0,0,0,0,0,0,0,2,1,0,81920,32628,6521,43552,0
1,26,6,4,4,0,0,2,6,1,2,1,2,3,3,2,4,0,2,0,0,2,1,0,81920,32628,6521,43553,0
1,26,6,4,4,0,0,2,6,0,0,0,0,0,0,0,0,0,0,0,0,2,1,0,81920,32628,6521,43554,0
1,26,7,5,5,0,0,2,7,0,0,0,0,0,0,0,0,0,0,0,0,2,1,0,81920,32628,6521,43555,0
1,26,6,4,4,0,0,2,6,0,0,0,0,0,0,0,0,0,0,0,0,2,1,0,81920,32628,6521,43556,0
1,26,10,6,6,0,0,4,10,0,0,0,0,0,0,0,0,0,0,0,0,2,1,0,81920,32628,6521,43557,0
1,26,1,1,1,0,0,0,1,0,0,0,0,0,0,0,0,0,0,0,0,2,1,0,81920,32628,6521,43557,0
1,26,14,10,10,0,0,4,14,1,1,1,1,2,2,0,2,0,1,0,0,2,1,0,81920,32628,6521,43558,0
1,26,46,26,30,3,0,12,49,3,6,3,6,9,9,20,28,1,42,2,0,2,1,0,81930,32628,6521,43559,0
1,7,2,2,2,0,0,0,2,0,0,0,0,0,0,0,0,0,0,0,0,2,1,0,81930,32628,6521,43559,0
1,24,127,75,83,2,11,30,129,4,14,7,14,18,21,61,87,2,175,9,0,2,1,0,81930,32628,6521,43560,0
1,24,652,304,544,16,6,88,668,6,89,51,101,95,152,591,998,3,3399,188,0,2,1,0,81930,32629,6521,43561,0
1,24,2,2,2,0,0,0,2,0,0,0,0,0,0,0,0,0,0,0,0,2,1,0,81930,32629,6521,43561,0
1,24,8,5,5,0,0,3,8,0,0,0,0,0,0,0,0,0,0,0,0,2,1,0,81930,32629,6521,43562,0
1,24,2,2,2,0,0,0,2,0,0,0,0,0,0,0,0,0,0,0,0,2,1,0,81930,32629,6521,43562,0
1,24,14,8,8,0,0,6,14,0,0,0,0,0,0,0,0,0,0,0,0,2,1,0,81930,32629,6521,43563,0
1,24,6,4,4,0,0,2,6,0,0,0,0,0,0,0,0,0,0,0,0,2,1,0,81930,32629,6521,43564,0
1,24,6,4,4,0,0,2,6,1,2,1,2,3,3,2,4,0,2,0,0,2,1,0,81930,32629,6521,43565,0
1,24,6,4,4,0,0,2,6,0,0,0,0,0,0,0,0,0,0,0,0,2,1,0,81930,32629,6521,43566,0
1,24,7,5,5,0,0,2,7,0,0,0,0,0,0,0,0,0,0,0,0,2,1,0,81930,32629,6521,43567,0
1,24,6,4,4,0,0,2,6,0,0,0,0,0,0,0,0,0,0,0,0,2,1,0,81930,32629,6521,43568,0
1,24,10,6,6,0,0,4,10,0,0,0,0,0,0,0,0,0,0,0,0,2,1,0,81930,32629,6521,43569,0
1,24,1,1,1,0,0,0,1,0,0,0,0,0,0,0,0,0,0,0,0,2,1,0,81930,32629,6521,43569,0
1,24,14,10,10,0,0,4,14,1,1,1,1,2,2,0,2,0,1,0,0,2,1,0,81930,32629,6521,43570,0
1,24,46,26,30,3,0,12,49,3,6,3,6,9,9,20,28,1,42,2,0,2,1,0,81940,32629,6521,43571,0
1,7,2,2,2,0,0,0,2,0,0,0,0,0,0,0,0,0,0,0,0,2,1,0,81940,32629,6521,43571,0
3,33,15,9,9,0,0,6,15,0,0,0,0,0,0,0,0,0,0,0,0,2,1,0,81940,32629,6521,43572,0
1,13,127,75,83,2,11,30,129,4,14,7,14,18,21,61,87,2,175,9,0,2,1,0,81940,32629,6521,43573,0
1,13,652,304,544,16,6,88,668,6,89,51,101,95,152,591,998,3,3399,188,0,2,1,0,81940,32630,6521,43574,0
1,13,2,2,2,0,0,0,2,0,0,0,0,0,0,0,0,0,0,0,0,2,1,0,81940,32630,6521,43574,0
1,13,8,5,5,0,0,3,8,0,0,0,0,0,0,0,0,0,0,0,0,2,1,0,81940,32630,6521,43575,0
1,13,2,2,2,0,0,0,2,0,0,0,0,0,0,0,0,0,0,0,0,2,1,0,81940,32630,6521,43575,0
1,13,14,8,8,0,0,6,14,0,0,0,0,0,0,0,0,0,0,0,0,2,1,0,81940,32630,6521,43576,0
1,13,6,4,4,0,0,2,6,0,0,0,0,0,0,0,0,0,0,0,0,2,1,0,81940,32630,6521,43577,0
1,13,6,4,4,0,0,2,6,1,2,1,2,3,3,2,4,0,2,0,0,2,1,0,81940,32630,6521,43578,0
1,13,6,4,4,0,0,2,6,0,0,0,0,0,0,0,0,0,0,0,0,2,1,0,81940,32630,6521,43579,0
1,13,7,5,5,0,0,2,7,0,0,0,0,0,0,0,0,0,0,0,0,2,1,0,81940,32630,6521,43580,0
1,13,6,4,4,0,0,2,6,0,0,0,0,0,0,0,0,0,0,0,0,2,1,0,81940,32630,6521,43581,0
1,13,10,6,6,0,0,4,10,0,0,0,0,0,0,0,0,0,0,0,0,2,1,0,81940,32630,6521,43582,0
1,13,1,1,1,0,0,0,1,0,0,0,0,0,0,0,0,0,0,0,0,2,1,0,81940,32630,6521,43582,0
1,13,14,10,10,0,0,4,14,1,1,1,1,2,2,0,2,0,1,0,0,2,1,0,81940,32630,6521,43583,0
1,13,46,26,30,3,0,12,49,3,6,3,6,9,9,20,28,1,42,2,0,2,1,0,81950,32630,6521,43584,0
1,16,127,75,83,2,11,30,129,4,14,7,14,18,21,61,87,2,175,9,0,2,1,0,81950,32630,6521,43585,0
1,16,652,304,544,16,6,88,668,6,89,51,101,95,152,591,998,3,3399,188,0,2,1,0,81950,32631,6521,43586,0
1,16,2,2,2,0,0,0,2,0,0,0,0,0,0,0,0,0,0,0,0,2,1,0,81950,32631,6521,43586,0
1,16,8,5,5,0,0,3,8,0,0,0,0,0,0,0,0,0,0,0,0,2,1,0,81950,32631,6521,43587,0
1,16,2,2,2,0,0,0,2,0,0,0,0,0,0,0,0,0,0,0,0,2,1,0,81950,32631,6521,43587,0
1,16,14,8,8,0,0,6,14,0,0,0,0,0,0,0,0,0,0,0,0,2,1,0,81950,32631,6521,43588,0
1,16,6,4,4,0,0,2,6,0,0,0,0,0,0,0,0,0,0,0,0,2,1,0,81950,32631,6521,43589,0
1,16,6,4,4,0,0,2,6,1,2,1,2,3,3,2,4,0,2,0,0,2,1,0,81950,32631,6521,43590,0
1,16,6,4,4,0,0,2,6,0,0,0,0,0,0,0,0,0,0,0,0,2,1,0,81950,32631,6521,43591,0
1,16,7,5,5,0,0,2,7,0,0,0,0,0,0,0,0,0,0,0,0,2,1,0,81950,32631,6521,43592,0
1,16,6,4,4,0,0,2,6,0,0,0,0,0,0,0,0,0,0,0,0,2,1,0,81950,32631,6521,43593,0
1,16,10,6,6,0,0,4,10,0,0,0,0,0,0,0,0,0,0,0,0,2,1,0,81950,32631,6521,43594,0
1,16,1,1,1,0,0,0,1,0,0,0,0,0,0,0,0,0,0,0,0,2,1,0,81950,32631,6521,43594,0
1,16,14,10,10,0,0,4,14,1,1,1,1,2,2,0,2,0,1,0,0,2,1,0,81950,32631,6521,43595,0
1,16,46,26,30,3,0,12,49,3,6,3,6,9,9,20,28,1,42,2,0,2,1,0,81960,32631,6521,43596,0
1,10,2,2,2,0,0,0,2,1,2,1,2,3,3,2,4,0,2,0,0,2,1,0,81960,32631,6521,43596,0
1,13,127,75,83,2,11,30,129,4,14,7,14,18,21,61,87,2,175,9,0,2,1,0,81960,32631,6521,43597,0
1,13,652,304,544,16,6,88,668,6,89,51,101,95,152,591,998,3,3399,188,0,2,1,0,81960,32632,6521,43598,0
1,13,2,2,2,0,0,0,2,0,0,0,0,0,0,0,0,0,0,0,0,2,1,0,81960,32632,6521,43598,0
1,13,8,5,5,0,0,3,8,0,0,0,0,0,0,0,0,0,0,0,0,2,1,0,81960,32632,6521,43599,0
1,13,2,2,2,0,0,0,2,0,0,0,0,0,0,0,0,0,0,0,0,2,1,0,81960,32632,6521,43599,0
1,13,14,8,8,0,0,6,14,0,0,0,0,0,0,0,0,0,0,0,0,2,1,0,81960,32632,6521,43600,0
1,13,6,4,4,0,0,2,6,0,0,0,0,0,0,0,0,0,0,0,0,2,1,0,81960,32632,6521,43601,0
1,13,6,4,4,0,0,2,6,1,2,1,2,3,3,2,4,0,2,0,0,2,1,0,81960,32632,6521,43602,0
1,13,6,4,4,0,0,2,6,0,0,0,0,0,0,0,0,0,0,0,0,2,1,0,81960,32632,6521,43603,0
1,13,7,5,5,0,0,2,7,0,0,0,0,0,0,0,0,0,0,0,0,2,1,0,81960,32632,6521,43604,0
1,13,6,4,4,0,0,2,6,0,0,0,0,0,0,0,0,0,0,0,0,2,1,0,81960,32632,6521,43605,0
1,13,10,6,6,0,0,4,10,0,0,0,0,0,0,0,0,0,0,0,0,2,1,0,81960,32632,6521,43606,0
1,13,1,1,1,0,0,0,1,0,0,0,0,0,0,0,0,0,0,0,0,2,1,0,81960,32632,6521,43606,0
1,13,14,10,10,0,0,4,14,1,1,1,1,2,2,0,2,0,1,0,0,2,1,0,81960,32632,6521,43607,0
1,13,46,26,30,3,0,12,49,3,6,3,6,9,9,20,28,1,42,2,0,2,1,0,81970,32632,6521,43608,0
2,26,10,6,6,0,0,4,10,2,4,2,4,6,6,10,15,1,15,0,0,2,1,0,81970,32632,6521,43609,0
3,47,15,10,10,0,0,5,15,2,4,2,4,6,6,10,15,1,15,0,0,2,1,0,81970,32632,6521,43610,0
3,39,15,9,9,0,0,6,15,0,0,0,0,0,0,0,0,0,0,0,0,2,1,0,81970,32632,6521,43611,0
2,36,10,7,7,0,0,3,10,1,2,1,2,3,3,2,4,0,2,0,0,2,1,0,81970,32632,6521,43612,0
3,46,15,9,9,0,0,6,15,1,4,2,4,5,6,8,13,0,6,0,0,2,1,0,81970,32632,6521,43613,0
2,21,10,6,6,0,0,4,10,0,0,0,0,0,0,0,0,0,0,0,0,2,1,0,81970,32632,6521,43614,0
4,61,20,12,12,0,0,8,20,1,2,1,2,3,3,2,4,0,2,0,0,2,1,0,81970,32632,6521,43615,0
2,51,127,75,83,2,11,30,129,4,14,7,14,18,21,61,87,2,175,9,0,2,1,0,81970,32632,6521,43616,0
2,51,652,304,544,16,6,88,668,6,89,51,101,95,152,591,998,3,3399,188,0,2,1,0,81970,32633,6521,43617,0
2,51,2,2,2,0,0,0,2,0,0,0,0,0,0,0,0,0,0,0,0,2,1,0,81970,32633,6521,43617,0
2,51,8,5,5,0,0,3,8,0,0,0,0,0,0,0,0,0,0,0,0,2,1,0,81970,32633,6521,43618,0
2,51,2,2,2,0,0,0,2,0,0,0,0,0,0,0,0,0,0,0,0,2,1,0,81970,32633,6521,43618,0
2,51,14,8,8,0,0,6,14,0,0,0,0,0,0,0,0,0,0,0,0,2,1,0,81970,32633,6521,43619,0
2,51,6,4,4,0,0,2,6,0,0,0,0,0,0,0,0,0,0,0,0,2,1,0,81970,32633,6521,43620,0
2,51,6,4,4,0,0,2,6,1,2,1,2,3,3,2,4,0,2,0,0,2,1,0,81970,32633,6521,43621,0
2,51,6,4,4,0,0,2,6,0,0,0,0,0,0,0,0,0,0,0,0,2,1,0,81970,32633,6521,43622,0
2,51,7,5,5,0,0,2,7,0,0,0,0,0,0,0,0,0,0,0,0,2,1,0,81970,32633,6521,43623,0
2,51,6,4,4,0,0,2,6,0,0,0,0,0,0,0,0,0,0,0,0,2,1,0,81970,32633,6521,43624,0
2,51,10,6,6,0,0,4,10,0,0,0,0,0,0,0,0,0,0,0,0,2,1,0,81970,32633,6521,43625,0
2,51,1,1,1,0,0,0,1,0,0,0,0,0,0,0,0,0,0,0,0,2,1,0,81970,32633,6521,43625,0
2,51,14,10,10,0,0,4,14,1,1,1,1,2,2,0,2,0,1,0,0,2,1,0,81970,32633,6521,43626,0
2,51,46,26,30,3,0,12,49,3,6,3,6,9,9,20,28,1,42,2,0,2,1,0,81980,32633,6521,43627,0
1,6,2,2,2,0,0,0,2,0,0,0,0,0,0,0,0,0,0,0,0,2,1,0,81980,32633,6521,43627,0
8,263,51,25,36,0,0,15,51,3,11,6,12,14,18,42,68,1,112,6,0,2,1,0,81980,32633,6521,43628,0
1,14,6,4,4,0,0,2,6,0,0,0,0,0,0,0,0,0,0,0,0,2,1,0,81980,32633,6521,43629,0
4,163,27,21,21,0,0,6,27,3,6,3,6,9,9,20,28,1,42,2,0,2,1,0,81980,32633,6521,43630,0
1,6,2,2,2,0,0,0,2,0,0,0,0,0,0,0,0,0,0,0,0,2,1,0,81980,32633,6521,43630,0
1,41,7,5,5,0,0,2,7,1,2,1,2,3,3,2,4,0,2,0,0,2,1,0,81980,32633,6521,43631,0
2,51,14,9,9,0,0,5,14,0,0,0,0,0,0,0,0,0,0,0,0,2,1,0,81980,32633,6521,43632,0
2,40,13,9,8,0,0,4,13,0,0,0,0,0,0,0,0,0,0,0,0,2,1,0,81980,32633,6521,43633,0
2,42,14,10,9,0,0,4,14,0,0,0,0,0,0,0,0,0,0,0,0,2,1,0,81980,32633,6521,43634,0
2,33,12,8,7,0,0,4,12,0,0,0,0,0,0,0,0,0,0,0,0,2,1,0,81980,32633,6521,43635,0
3,49,16,9,9,0,0,7,16,0,0,0,0,0,0,0,0,0,0,0,0,2,1,0,81980,32633,6521,43636,0
1,18,3,3,3,0,0,0,3,0,0,0,0,0,0,0,0,0,0,0,0,2,1,0,81980,32633,6521,43636,0
2,26,6,4,4,0,0,2,6,1,4,2,4,5,6,8,13,0,6,0,0,2,1,0,81980,32633,6521,43638,0
1,134,149,67,118,4,0,27,153,1,17,14,28,18,42,69,175,0,144,8,0,2,1,0,81980,32633,6521,43640,0
66,4392,520,294,400,33,13,81,553,10,261,204,367,271,571,2128,4614,7,32445,1802,1,2,1,1,81980,32634,6521,43641,0
90,3974,1338,495,1086,10,64,173,1348,11,122,82,157,133,239,883,1686,7,11934,663,0,2,1,1,81980,32636,6521,43642,0
33,999,465,148,393,5,8,60,470,4,31,20,31,35,51,161,261,2,523,29,0,2,1,0,81980,32637,6521,43643,0
33,999,16,12,9,0,0,6,16,1,2,1,2,3,3,2,4,0,2,0,0,2,1,0,81980,32637,6521,43644,0
144,5944,1782,648,1425,9,47,279,1791,8,171,97,189,179,286,1292,2140,4,9462,525,0,2,96,0,81980,32638,6522,43645,0
33,1041,256,139,192,9,7,47,265,4,23,12,24,27,36,112,171,2,357,19,0,2,1,0,81980,32639,6522,43646,0
23,613,102,59,69,5,3,24,107,6,22,15,28,28,43,113,206,3,789,43,0,2,1,0,81980,32639,6522,43647,0
48,3659,996,429,845,24,10,117,1020,7,76,50,88,83,138,494,879,4,3565,198,0,2,1,0,81980,32641,6522,43648,0
126,5406,1513,682,1277,25,13,200,1538,11,199,116,219,210,335,1557,2584,6,15641,868,0,2,1,1,81980,32643,6522,43649,0
85,4936,1296,573,1062,40,33,157,1336,8,201,118,231,209,349,1561,2689,4,12365,686,0,2,1,0,81980,32643,6522,43650,0
21,500,207,111,150,11,0,50,218,5,26,19,36,31,55,133,272,3,943,52,0,2,1,0,81980,32643,6522,43651,0
98,5250,1457,730,1242,11,6,188,1468,10,292,166,329,302,495,2424,4078,5,22973,1276,1,2,12,0,81980,32645,6522,43652,0
43,2690,652,304,544,16,6,88,668,6,89,51,101,95,152,591,998,3,3399,188,0,2,1,0,81980,32646,6522,43653,0
72,3310,1455,414,1257,16,76,112,1471,5,41,23,46,46,69,231,381,2,1069,59,0,2,3,3,81980,32647,6522,43654,0
2,56,7,6,5,0,0,2,7,1,1,1,2,2,3,0,3,1,3,0,0,2,1,0,81980,32647,6522,43655,0
8,275,74,35,59,1,0,14,75,3,14,7,14,17,21,58,85,1,128,7,0,2,1,0,81980,32648,6522,43656,0
70,3187,1020,354,843,12,15,144,1032,8,134,77,144,142,221,970,1580,4,6792,377,0,2,1,0,81980,32648,6522,43657,0
47,2189,447,308,343,6,5,95,453,7,96,59,111,103,170,651,1136,4,4600,255,0,2,1,0,81980,32651,6522,43658,0
3,229,53,23,39,0,0,13,53,2,8,4,8,10,12,26,39,1,39,2,0,2,1,0,81980,32651,6522,43659,0
21,655,424,94,331,4,0,89,428,1,5,5,5,6,10,11,25,0,12,0,0,2,2,2,81980,32652,6522,43660,0
38,2327,334,251,279,10,4,40,344,5,127,74,143,132,217,899,1528,2,4303,239,0,2,1,0,81980,32653,6522,43661,0
12,497,184,100,137,2,15,30,186,6,38,20,39,44,59,214,322,3,991,55,0,2,2,2,81980,32654,6522,43662,0
8,377,91,45,69,0,3,18,91,3,9,6,10,12,16,33,57,1,95,5,0,2,1,0,81980,32656,6522,43663,0
78,3962,1293,570,1093,25,15,163,1318,10,195,123,241,205,364,1516,2795,6,17273,959,0,2,20,8,81990,32658,6522,43664,0
29,1903,384,251,317,7,8,52,391,11,70,44,84,81,128,467,811,6,5355,297,0,2,2,2,81990,32658,6522,43665,0
45,1953,386,256,301,16,9,68,402,4,59,35,69,63,104,355,621,2,1453,80,0,2,1,0,81990,32658,6522,43666,0
28,1596,466,257,367,18,25,50,484,7,126,86,171,133,257,898,1813,4,8612,478,0,2,1,0,81990,32658,6522,43667,0
15,1066,215,129,180,6,0,29,221,8,65,43,72,73,115,415,711,4,3153,175,0,2,1,0,81990,32658,6522,43668,0
86,3411,1043,504,840,53,9,147,1096,9,180,112,198,189,310,1377,2344,4,11604,644,0,2,1,1,81990,32660,6522,43669,0
12,478,295,56,236,0,4,54,295,2,9,5,10,11,15,30,51,1,57,3,0,2,1,0,81990,32662,6522,43670,0
30,1440,373,158,315,8,0,51,381,5,76,44,79,81,123,486,779,2,2026,112,0,2,1,0,81990,32662,6522,43671,0
81,3172,1178,367,1042,6,15,115,1184,9,94,51,95,103,146,644,976,4,4439,246,0,2,1,1,81990,32662,6522,43672,0
9,449,219,78,157,11,5,46,230,3,24,20,34,27,54,114,256,2,545,30,0,2,1,0,81990,32663,6522,43673,0
111,6122,1943,715,1694,26,18,214,1969,12,185,120,237,197,357,1436,2721,7,20915,1161,0,2,1,1,81990,32665,6522,43674,0
37,1519,442,244,305,14,16,103,456,11,68,45,75,79,120,452,756,6,4588,254,0,2,1,0,81990,32667,6522,43675,0
52,1986,1098,241,925,5,10,155,1103,7,46,25,49,53,74,273,423,3,1580,87,0,2,1,0,82000,32669,6522,43676,0
53,1862,601,196,481,2,23,85,603,8,63,36,72,71,108,400,664,4,3036,168,0,2,4,4,82000,32669,6522,43677,0
1,96,42,7,35,4,0,5,46,1,2,1,2,3,3,2,4,0,2,0,0,2,1,1,82000,32669,6522,43678,0
1,96,11,6,10,0,0,1,11,2,4,2,4,6,6,10,15,1,15,0,0,2,1,1,82000,32669,6522,43679,0
73,1512,207,111,150,11,0,50,218,5,26,19,36,31,55,133,272,3,943,52,0,2,0,1,82000,32669,6522,43680,0
73,1512,410,198,237,31,55,97,441,11,63,38,72,74,110,414,683,6,4293,238,0,2,0,1,82010,32670,6523,43681,0
315,6908,72,33,56,0,4,12,72,1,1,1,1,2,2,0,2,0,1,0,0,2,1,2,82010,32670,6523,43682,0
315,6908,1454,835,1044,76,110,219,1530,17,275,158,296,292,454,2297,3718,9,34017,1889,1,2,1,2,82020,32671,6523,43683,0
19,721,442,244,305,14,16,103,456,11,68,45,75,79,120,452,756,6,4588,254,0,2,21,21,82020,32673,6523,43684,0
19,721,182,102,99,11,40,35,193,3,11,6,11,14,17,42,64,1,97,5,0,2,21,21,82020,32674,6523,43685,0
1,96,42,7,35,4,0,5,46,1,2,1,2,3,3,2,4,0,2,0,0,2,1,1,82020,32674,6523,43686,0
1,96,11,6,10,0,0,1,11,2,4,2,4,6,6,10,15,1,15,0,0,2,1,1,82020,32674,6523,43687,0
6,151,127,75,83,2,11,30,129,4,14,7,14,18,21,61,87,2,175,9,0,2,9,4,82020,32674,6523,43688,1
6,151,652,304,544,16,6,88,668,6,89,51,101,95,152,591,998,3,3399,188,0,2,9,4,82020,32675,6523,43689,1
6,151,2,2,2,0,0,0,2,0,0,0,0,0,0,0,0,0,0,0,0,2,9,4,82020,32675,6523,43689,1
6,151,8,5,5,0,0,3,8,0,0,0,0,0,0,0,0,0,0,0,0,2,9,4,82020,32675,6523,43690,1
6,151,2,2,2,0,0,0,2,0,0,0,0,0,0,0,0,0,0,0,0,2,9,4,82020,32675,6523,43690,1
6,151,14,8,8,0,0,6,14,0,0,0,0,0,0,0,0,0,0,0,0,2,9,4,82020,32675,6523,43691,1
6,151,6,4,4,0,0,2,6,0,0,0,0,0,0,0,0,0,0,0,0,2,9,4,82020,32675,6523,43692,1
6,151,6,4,4,0,0,2,6,1,2,1,2,3,3,2,4,0,2,0,0,2,9,4,82020,32675,6523,43693,1
6,151,6,4,4,0,0,2,6,0,0,0,0,0,0,0,0,0,0,0,0,2,9,4,82020,32675,6523,43694,1
6,151,7,5,5,0,0,2,7,0,0,0,0,0,0,0,0,0,0,0,0,2,9,4,82020,32675,6523,43695,1
6,151,6,4,4,0,0,2,6,0,0,0,0,0,0,0,0,0,0,0,0,2,9,4,82020,32675,6523,43696,1
6,151,10,6,6,0,0,4,10,0,0,0,0,0,0,0,0,0,0,0,0,2,9,4,82020,32675,6523,43697,1
6,151,1,1,1,0,0,0,1,0,0,0,0,0,0,0,0,0,0,0,0,2,9,4,82020,32675,6523,43697,1
6,151,14,10,10,0,0,4,14,1,1,1,1,2,2,0,2,0,1,0,0,2,9,4,82020,32675,6523,43698,1
6,151,46,26,30,3,0,12,49,3,6,3,6,9,9,20,28,1,42,2,0,2,9,4,82030,32675,6523,43699,1
103,2661,773,422,505,30,103,129,803,14,77,46,83,91,129,535,839,7,6334,351,0,2,26,19,82040,32676,6524,43700,0
38,2498,1157,318,931,29,22,177,1186,6,104,63,125,110,188,712,1274,3,4596,255,0,2,45,0,82040,32676,6524,43701,0
73,1512,207,111,150,11,0,50,218,5,26,19,36,31,55,133,272,3,943,52,0,2,0,1,82040,32676,6524,43702,0
73,1512,410,198,237,31,55,97,441,11,63,38,72,74,110,414,683,6,4293,238,0,2,0,1,82050,32677,6525,43703,0
315,6908,72,33,56,0,4,12,72,1,1,1,1,2,2,0,2,0,1,0,0,2,1,2,82050,32677,6525,43704,0
315,6908,1454,835,1044,76,110,219,1530,17,275,158,296,292,454,2297,3718,9,34017,1889,1,2,1,2,82060,32678,6525,43705,0
19,721,442,244,305,14,16,103,456,11,68,45,75,79,120,452,756,6,4588,254,0,2,21,21,82060,32680,6525,43706,0
19,721,182,102,99,11,40,35,193,3,11,6,11,14,17,42,64,1,97,5,0,2,21,21,82060,32681,6525,43707,0
6,151,127,75,83,2,11,30,129,4,14,7,14,18,21,61,87,2,175,9,0,2,9,4,82060,32681,6525,43708,0
6,151,652,304,544,16,6,88,668,6,89,51,101,95,152,591,998,3,3399,188,0,2,9,4,82060,32682,6525,43709,0
6,151,2,2,2,0,0,0,2,0,0,0,0,0,0,0,0,0,0,0,0,2,9,4,82060,32682,6525,43709,0
6,151,8,5,5,0,0,3,8,0,0,0,0,0,0,0,0,0,0,0,0,2,9,4,82060,32682,6525,43710,0
6,151,2,2,2,0,0,0,2,0,0,0,0,0,0,0,0,0,0,0,0,2,9,4,82060,32682,6525,43710,0
6,151,14,8,8,0,0,6,14,0,0,0,0,0,0,0,0,0,0,0,0,2,9,4,82060,32682,6525,43711,0
6,151,6,4,4,0,0,2,6,0,0,0,0,0,0,0,0,0,0,0,0,2,9,4,82060,32682,6525,43712,0
6,151,6,4,4,0,0,2,6,1,2,1,2,3,3,2,4,0,2,0,0,2,9,4,82060,32682,6525,43713,0
6,151,6,4,4,0,0,2,6,0,0,0,0,0,0,0,0,0,0,0,0,2,9,4,82060,32682,6525,43714,0
6,151,7,5,5,0,0,2,7,0,0,0,0,0,0,0,0,0,0,0,0,2,9,4,82060,32682,6525,43715,0
6,151,6,4,4,0,0,2,6,0,0,0,0,0,0,0,0,0,0,0,0,2,9,4,82060,32682,6525,43716,0
6,151,10,6,6,0,0,4,10,0,0,0,0,0,0,0,0,0,0,0,0,2,9,4,82060,32682,6525,43717,0
6,151,1,1,1,0,0,0,1,0,0,0,0,0,0,0,0,0,0,0,0,2,9,4,82060,32682,6525,43717,0
6,151,14,10,10,0,0,4,14,1,1,1,1,2,2,0,2,0,1,0,0,2,9,4,82060,32682,6525,43718,0
6,151,46,26,30,3,0,12,49,3,6,3,6,9,9,20,28,1,42,2,0,2,9,4,82070,32682,6525,43719,0
6,153,127,75,83,2,11,30,129,4,14,7,14,18,21,61,87,2,175,9,0,2,3,3,82070,32682,6525,43720,0
6,153,652,304,544,16,6,88,668,6,89,51,101,95,152,591,998,3,3399,188,0,2,3,3,82070,32683,6525,43721,0
6,153,2,2,2,0,0,0,2,0,0,0,0,0,0,0,0,0,0,0,0,2,3,3,82070,32683,6525,43721,0
6,153,8,5,5,0,0,3,8,0,0,0,0,0,0,0,0,0,0,0,0,2,3,3,82070,32683,6525,43722,0
6,153,2,2,2,0,0,0,2,0,0,0,0,0,0,0,0,0,0,0,0,2,3,3,82070,32683,6525,43722,0
6,153,14,8,8,0,0,6,14,0,0,0,0,0,0,0,0,0,0,0,0,2,3,3,82070,32683,6525,43723,0
6,153,6,4,4,0,0,2,6,0,0,0,0,0,0,0,0,0,0,0,0,2,3,3,82070,32683,6525,43724,0
6,153,6,4,4,0,0,2,6,1,2,1,2,3,3,2,4,0,2,0,0,2,3,3,82070,32683,6525,43725,0
6,153,6,4,4,0,0,2,6,0,0,0,0,0,0,0,0,0,0,0,0,2,3,3,82070,32683,6525,43726,0
6,153,7,5,5,0,0,2,7,0,0,0,0,0,0,0,0,0,0,0,0,2,3,3,82070,32683,6525,43727,0
6,153,6,4,4,0,0,2,6,0,0,0,0,0,0,0,0,0,0,0,0,2,3,3,82070,32683,6525,43728,0
6,153,10,6,6,0,0,4,10,0,0,0,0,0,0,0,0,0,0,0,0,2,3,3,82070,32683,6525,43729,0
6,153,1,1,1,0,0,0,1,0,0,0,0,0,0,0,0,0,0,0,0,2,3,3,82070,32683,6525,43729,0
6,153,14,10,10,0,0,4,14,1,1,1,1,2,2,0,2,0,1,0,0,2,3,3,82070,32683,6525,43730,0
6,153,46,26,30,3,0,12,49,3,6,3,6,9,9,20,28,1,42,2,0,2,3,3,82080,32683,6525,43731,0
6,153,127,75,83,2,11,30,129,4,14,7,14,18,21,61,87,2,175,9,0,2,3,3,82080,32683,6525,43732,0
6,153,652,304,544,16,6,88,668,6,89,51,101,95,152,591,998,3,3399,188,0,2,3,3,82080,32684,6525,43733,0
6,153,2,2,2,0,0,0,2,0,0,0,0,0,0,0,0,0,0,0,0,2,3,3,82080,32684,6525,43733,0
6,153,8,5,5,0,0,3,8,0,0,0,0,0,0,0,0,0,0,0,0,2,3,3,82080,32684,6525,43734,0
6,153,2,2,2,0,0,0,2,0,0,0,0,0,0,0,0,0,0,0,0,2,3,3,82080,32684,6525,43734,0
6,153,14,8,8,0,0,6,14,0,0,0,0,0,0,0,0,0,0,0,0,2,3,3,82080,32684,6525,43735,0
6,153,6,4,4,0,0,2,6,0,0,0,0,0,0,0,0,0,0,0,0,2,3,3,82080,32684,6525,43736,0
6,153,6,4,4,0,0,2,6,1,2,1,2,3,3,2,4,0,2,0,0,2,3,3,82080,32684,6525,43737,0
6,153,6,4,4,0,0,2,6,0,0,0,0,0,0,0,0,0,0,0,0,2,3,3,82080,32684,6525,43738,0
6,153,7,5,5,0,0,2,7,0,0,0,0,0,0,0,0,0,0,0,0,2,3,3,82080,32684,6525,43739,0
6,153,6,4,4,0,0,2,6,0,0,0,0,0,0,0,0,0,0,0,0,2,3,3,82080,32684,6525,43740,0
6,153,10,6,6,0,0,4,10,0,0,0,0,0,0,0,0,0,0,0,0,2,3,3,82080,32684,6525,43741,0
6,153,1,1,1,0,0,0,1,0,0,0,0,0,0,0,0,0,0,0,0,2,3,3,82080,32684,6525,43741,0
6,153,14,10,10,0,0,4,14,1,1,1,1,2,2,0,2,0,1,0,0,2,3,3,82080,32684,6525,43742,0
6,153,46,26,30,3,0,12,49,3,6,3,6,9,9,20,28,1,42,2,0,2,3,3,82090,32684,6525,43743,0
6,153,127,75,83,2,11,30,129,4,14,7,14,18,21,61,87,2,175,9,0,2,10,5,82090,32684,6525,43744,0
6,153,652,304,544,16,6,88,668,6,89,51,101,95,152,591,998,3,3399,188,0,2,10,5,82090,32685,6525,43745,0
6,153,2,2,2,0,0,0,2,0,0,0,0,0,0,0,0,0,0,0,0,2,10,5,82090,32685,6525,43745,0
6,153,8,5,5,0,0,3,8,0,0,0,0,0,0,0,0,0,0,0,0,2,10,5,82090,32685,6525,43746,0
6,153,2,2,2,0,0,0,2,0,0,0,0,0,0,0,0,0,0,0,0,2,10,5,82090,32685,6525,43746,0
6,153,14,8,8,0,0,6,14,0,0,0,0,0,0,0,0,0,0,0,0,2,10,5,82090,32685,6525,43747,0
6,153,6,4,4,0,0,2,6,0,0,0,0,0,0,0,0,0,0,0,0,2,10,5,82090,32685,6525,43748,0
6,153,6,4,4,0,0,2,6,1,2,1,2,3,3,2,4,0,2,0,0,2,10,5,82090,32685,6525,43749,0
6,153,6,4,4,0,0,2,6,0,0,0,0,0,0,0,0,0,0,0,0,2,10,5,82090,32685,6525,43750,0
6,153,7,5,5,0,0,2,7,0,0,0,0,0,0,0,0,0,0,0,0,2,10,5,82090,32685,6525,43751,0
6,153,6,4,4,0,0,2,6,0,0,0,0,0,0,0,0,0,0,0,0,2,10,5,82090,32685,6525,43752,0
6,153,10,6,6,0,0,4,10,0,0,0,0,0,0,0,0,0,0,0,0,2,10,5,82090,32685,6525,43753,0
6,153,1,1,1,0,0,0,1,0,0,0,0,0,0,0,0,0,0,0,0,2,10,5,82090,32685,6525,43753,0
6,153,14,10,10,0,0,4,14,1,1,1,1,2,2,0,2,0,1,0,0,2,10,5,82090,32685,6525,43754,0
6,153,46,26,30,3,0,12,49,3,6,3,6,9,9,20,28,1,42,2,0,2,10,5,82100,32685,6525,43755,0
103,2661,773,422,505,30,103,129,803,14,77,46,83,91,129,535,839,7,6334,351,0,2,26,19,82110,32686,6526,43756,0
38,2498,1157,318,931,29,22,177,1186,6,104,63,125,110,188,712,1274,3,4596,255,0,2,45,0,82110,32686,6526,43757,0
90,2054,996,429,845,24,10,117,1020,7,76,50,88,83,138,494,879,4,3565,198,0,2,1,0,82110,32688,6526,43758,1
90,2054,456,277,329,12,42,72,468,13,85,50,97,98,147,592,972,7,7212,400,0,2,1,0,82110,32688,6526,43759,1
49,3737,996,429,845,24,10,117,1020,7,76,50,88,83,138,494,879,4,3565,198,0,2,20,0,82110,32690,6526,43760,1
107,2805,773,422,505,30,103,129,803,14,77,46,83,91,129,535,839,7,6334,351,0,2,33,0,82120,32691,6527,43761,0
2,235,149,67,118,4,0,27,153,1,17,14,28,18,42,69,175,0,144,8,0,2,30,0,82120,32691,6527,43762,0
91,2069,996,429,845,24,10,117,1020,7,76,50,88,83,138,494,879,4,3565,198,0,2,8,11,82120,32693,6527,43763,0
91,2069,456,277,329,12,42,72,468,13,85,50,97,98,147,592,972,7,7212,400,0,2,8,11,82120,32693,6527,43764,0
49,3805,996,429,845,24,10,117,1020,7,76,50,88,83,138,494,879,4,3565,198,0,2,23,1,82120,32695,6527,43765,0
91,2063,996,429,845,24,10,117,1020,7,76,50,88,83,138,494,879,4,3565,198,0,2,4,3,82120,32697,6527,43766,0
91,2063,456,277,329,12,42,72,468,13,85,50,97,98,147,592,972,7,7212,400,0,2,4,3,82120,32697,6527,43767,0
91,2055,996,429,845,24,10,117,1020,7,76,50,88,83,138,494,879,4,3565,198,0,2,8,12,82120,32699,6527,43768,0
91,2055,456,277,329,12,42,72,468,13,85,50,97,98,147,592,972,7,7212,400,0,2,8,12,82120,32699,6527,43769,0
49,3805,996,429,845,24,10,117,1020,7,76,50,88,83,138,494,879,4,3565,198,0,2,1,1,82120,32701,6527,43770,0
91,2055,996,429,845,24,10,117,1020,7,76,50,88,83,138,494,879,4,3565,198,0,2,20,25,82120,32703,6527,43771,0
91,2055,456,277,329,12,42,72,468,13,85,50,97,98,147,592,972,7,7212,400,0,2,20,25,82120,32703,6527,43772,0
49,3805,996,429,845,24,10,117,1020,7,76,50,88,83,138,494,879,4,3565,198,0,2,42,0,82120,32705,6527,43773,0
6,153,127,75,83,2,11,30,129,4,14,7,14,18,21,61,87,2,175,9,0,2,10,5,82120,32705,6527,43774,0
6,153,652,304,544,16,6,88,668,6,89,51,101,95,152,591,998,3,3399,188,0,2,10,5,82120,32706,6527,43775,0
6,153,2,2,2,0,0,0,2,0,0,0,0,0,0,0,0,0,0,0,0,2,10,5,82120,32706,6527,43775,0
6,153,8,5,5,0,0,3,8,0,0,0,0,0,0,0,0,0,0,0,0,2,10,5,82120,32706,6527,43776,0
6,153,2,2,2,0,0,0,2,0,0,0,0,0,0,0,0,0,0,0,0,2,10,5,82120,32706,6527,43776,0
6,153,14,8,8,0,0,6,14,0,0,0,0,0,0,0,0,0,0,0,0,2,10,5,82120,32706,6527,43777,0
6,153,6,4,4,0,0,2,6,0,0,0,0,0,0,0,0,0,0,0,0,2,10,5,82120,32706,6527,43778,0
6,153,6,4,4,0,0,2,6,1,2,1,2,3,3,2,4,0,2,0,0,2,10,5,82120,32706,6527,43779,0
6,153,6,4,4,0,0,2,6,0,0,0,0,0,0,0,0,0,0,0,0,2,10,5,82120,32706,6527,43780,0
6,153,7,5,5,0,0,2,7,0,0,0,0,0,0,0,0,0,0,0,0,2,10,5,82120,32706,6527,43781,0
6,153,6,4,4,0,0,2,6,0,0,0,0,0,0,0,0,0,0,0,0,2,10,5,82120,32706,6527,43782,0
6,153,10,6,6,0,0,4,10,0,0,0,0,0,0,0,0,0,0,0,0,2,10,5,82120,32706,6527,43783,0
6,153,1,1,1,0,0,0,1,0,0,0,0,0,0,0,0,0,0,0,0,2,10,5,82120,32706,6527,43783,0
6,153,14,10,10,0,0,4,14,1,1,1,1,2,2,0,2,0,1,0,0,2,10,5,82120,32706,6527,43784,0
6,153,46,26,30,3,0,12,49,3,6,3,6,9,9,20,28,1,42,2,0,2,10,5,82130,32706,6527,43785,0
117,3174,1523,757,1297,19,12,193,1542,12,193,117,230,205,347,1508,2664,7,19053,1058,0,2,12,0,82140,32708,6527,43786,0
117,3174,701,378,504,33,58,109,734,13,110,68,126,123,194,794,1346,7,10027,557,0,2,12,0,82140,32709,6528,43787,0
108,5173,1523,757,1297,19,12,193,1542,12,193,117,230,205,347,1508,2664,7,19053,1058,0,2,27,0,82150,32711,6528,43788,0
57,1522,339,213,244,17,9,65,356,10,42,26,48,52,74,259,421,5,2410,133,0,2,132,120,82160,32711,6528,43789,0
79,4018,1293,570,1093,25,15,163,1318,10,195,123,241,205,364,1516,2795,6,17273,959,0,2,39,10,82170,32713,6528,43790,0
76,3947,1293,570,1093,25,15,163,1318,10,195,123,241,205,364,1516,2795,6,17273,959,0,2,3,3,82180,32715,6528,43791,0
76,3942,1293,570,1093,25,15,163,1318,10,195,123,241,205,364,1516,2795,6,17273,959,0,2,0,1,82190,32717,6528,43792,0
76,3942,1293,570,1093,25,15,163,1318,10,195,123,241,205,364,1516,2795,6,17273,959,0,2,3,4,82200,32719,6528,43793,0
91,2055,996,429,845,24,10,117,1020,7,76,50,88,83,138,494,879,4,3565,198,0,2,20,25,82200,32721,6528,43794,0
91,2055,456,277,329,12,42,72,468,13,85,50,97,98,147,592,972,7,7212,400,0,2,20,25,82200,32721,6528,43795,0
49,3805,996,429,845,24,10,117,1020,7,76,50,88,83,138,494,879,4,3565,198,0,2,42,0,82200,32723,6528,43796,0
77,3957,1293,570,1093,25,15,163,1318,10,195,123,241,205,364,1516,2795,6,17273,959,0,2,3,4,82210,32725,6528,43797,0
57,1522,339,213,244,17,9,65,356,10,42,26,48,52,74,259,421,5,2410,133,0,2,132,120,82220,32725,6528,43798,0
79,4018,1293,570,1093,25,15,163,1318,10,195,123,241,205,364,1516,2795,6,17273,959,0,2,39,10,82230,32727,6528,43799,0
6,163,127,75,83,2,11,30,129,4,14,7,14,18,21,61,87,2,175,9,0,2,1,0,82230,32727,6528,43800,0
6,163,652,304,544,16,6,88,668,6,89,51,101,95,152,591,998,3,3399,188,0,2,1,0,82230,32728,6528,43801,0
6,163,2,2,2,0,0,0,2,0,0,0,0,0,0,0,0,0,0,0,0,2,1,0,82230,32728,6528,43801,0
6,163,8,5,5,0,0,3,8,0,0,0,0,0,0,0,0,0,0,0,0,2,1,0,82230,32728,6528,43802,0
6,163,2,2,2,0,0,0,2,0,0,0,0,0,0,0,0,0,0,0,0,2,1,0,82230,32728,6528,43802,0
6,163,14,8,8,0,0,6,14,0,0,0,0,0,0,0,0,0,0,0,0,2,1,0,82230,32728,6528,43803,0
6,163,6,4,4,0,0,2,6,0,0,0,0,0,0,0,0,0,0,0,0,2,1,0,82230,32728,6528,43804,0
6,163,6,4,4,0,0,2,6,1,2,1,2,3,3,2,4,0,2,0,0,2,1,0,82230,32728,6528,43805,0
6,163,6,4,4,0,0,2,6,0,0,0,0,0,0,0,0,0,0,0,0,2,1,0,82230,32728,6528,43806,0
6,163,7,5,5,0,0,2,7,0,0,0,0,0,0,0,0,0,0,0,0,2,1,0,82230,32728,6528,43807,0
6,163,6,4,4,0,0,2,6,0,0,0,0,0,0,0,0,0,0,0,0,2,1,0,82230,32728,6528,43808,0
6,163,10,6,6,0,0,4,10,0,0,0,0,0,0,0,0,0,0,0,0,2,1,0,82230,32728,6528,43809,0
6,163,1,1,1,0,0,0,1,0,0,0,0,0,0,0,0,0,0,0,0,2,1,0,82230,32728,6528,43809,0
6,163,14,10,10,0,0,4,14,1,1,1,1,2,2,0,2,0,1,0,0,2,1,0,82230,32728,6528,43810,0
6,163,46,26,30,3,0,12,49,3,6,3,6,9,9,20,28,1,42,2,0,2,1,0,82240,32728,6528,43811,0
231,5945,722,423,573,19,0,135,741,12,172,101,199,184,300,1320,2257,6,15668,870,0,2,0,9,82240,32730,6528,43813,0
231,5945,1508,847,911,44,250,301,1552,14,148,88,169,162,257,1120,1886,7,15077,837,0,2,0,9,82240,32731,6529,43814,0
314,6928,72,33,56,0,4,12,72,1,1,1,1,2,2,0,2,0,1,0,0,2,4,2,82240,32731,6529,43815,0
314,6928,1454,835,1044,76,110,219,1530,17,275,158,296,292,454,2297,3718,9,34017,1889,1,2,4,2,82250,32732,6529,43816,0
91,4008,1338,495,1086,10,64,173,1348,11,122,82,157,133,239,883,1686,7,11934,663,0,2,18,1,82250,32734,6529,43817,0
231,5945,722,423,573,19,0,135,741,12,172,101,199,184,300,1320,2257,6,15668,870,0,2,0,9,82250,32736,6529,43819,0
231,5945,1508,847,911,44,250,301,1552,14,148,88,169,162,257,1120,1886,7,15077,837,0,2,0,9,82250,32737,6530,43820,0
6,163,127,75,83,2,11,30,129,4,14,7,14,18,21,61,87,2,175,9,0,2,1,0,82250,32737,6530,43821,0
6,163,652,304,544,16,6,88,668,6,89,51,101,95,152,591,998,3,3399,188,0,2,1,0,82250,32738,6530,43822,0
6,163,2,2,2,0,0,0,2,0,0,0,0,0,0,0,0,0,0,0,0,2,1,0,82250,32738,6530,43822,0
6,163,8,5,5,0,0,3,8,0,0,0,0,0,0,0,0,0,0,0,0,2,1,0,82250,32738,6530,43823,0
6,163,2,2,2,0,0,0,2,0,0,0,0,0,0,0,0,0,0,0,0,2,1,0,82250,32738,6530,43823,0
6,163,14,8,8,0,0,6,14,0,0,0,0,0,0,0,0,0,0,0,0,2,1,0,82250,32738,6530,43824,0
6,163,6,4,4,0,0,2,6,0,0,0,0,0,0,0,0,0,0,0,0,2,1,0,82250,32738,6530,43825,0
6,163,6,4,4,0,0,2,6,1,2,1,2,3,3,2,4,0,2,0,0,2,1,0,82250,32738,6530,43826,0
6,163,6,4,4,0,0,2,6,0,0,0,0,0,0,0,0,0,0,0,0,2,1,0,82250,32738,6530,43827,0
6,163,7,5,5,0,0,2,7,0,0,0,0,0,0,0,0,0,0,0,0,2,1,0,82250,32738,6530,43828,0
6,163,6,4,4,0,0,2,6,0,0,0,0,0,0,0,0,0,0,0,0,2,1,0,82250,32738,6530,43829,0
6,163,10,6,6,0,0,4,10,0,0,0,0,0,0,0,0,0,0,0,0,2,1,0,82250,32738,6530,43830,0
6,163,1,1,1,0,0,0,1,0,0,0,0,0,0,0,0,0,0,0,0,2,1,0,82250,32738,6530,43830,0
6,163,14,10,10,0,0,4,14,1,1,1,1,2,2,0,2,0,1,0,0,2,1,0,82250,32738,6530,43831,0
6,163,46,26,30,3,0,12,49,3,6,3,6,9,9,20,28,1,42,2,0,2,1,0,82260,32738,6530,43832,0
91,2055,996,429,845,24,10,117,1020,7,76,50,88,83,138,494,879,4,3565,198,0,2,20,25,82260,32740,6530,43833,0
91,2055,456,277,329,12,42,72,468,13,85,50,97,98,147,592,972,7,7212,400,0,2,20,25,82260,32740,6530,43834,0
49,3805,996,429,845,24,10,117,1020,7,76,50,88,83,138,494,879,4,3565,198,0,2,42,0,82260,32742,6530,43835,0
78,4013,1293,570,1093,25,15,163,1318,10,195,123,241,205,364,1516,2795,6,17273,959,0,2,3,4,82270,32744,6530,43836,0
231,5978,722,423,573,19,0,135,741,12,172,101,199,184,300,1320,2257,6,15668,870,0,2,7,1,82270,32746,6530,43838,1
231,5978,1508,847,911,44,250,301,1552,14,148,88,169,162,257,1120,1886,7,15077,837,0,2,7,1,82270,32747,6531,43839,1
56,2875,722,423,573,19,0,135,741,12,172,101,199,184,300,1320,2257,6,15668,870,0,2,23,0,82270,32749,6531,43841,1
232,5970,722,423,573,19,0,135,741,12,172,101,199,184,300,1320,2257,6,15668,870,0,2,8,7,82270,32751,6531,43843,0
232,5970,1508,847,911,44,250,301,1552,14,148,88,169,162,257,1120,1886,7,15077,837,0,2,8,7,82270,32752,6532,43844,0
56,2883,722,423,573,19,0,135,741,12,172,101,199,184,300,1320,2257,6,15668,870,0,2,3,0,82270,32754,6532,43846,0
314,6928,72,33,56,0,4,12,72,1,1,1,1,2,2,0,2,0,1,0,0,2,4,2,82270,32754,6532,43847,0
314,6928,1454,835,1044,76,110,219,1530,17,275,158,296,292,454,2297,3718,9,34017,1889,1,2,4,2,82280,32755,6532,43848,0
91,4008,1338,495,1086,10,64,173,1348,11,122,82,157,133,239,883,1686,7,11934,663,0,2,18,1,82280,32757,6532,43849,0
232,5970,722,423,573,19,0,135,741,12,172,101,199,184,300,1320,2257,6,15668,870,0,2,13,6,82280,32759,6532,43851,0
232,5970,1508,847,911,44,250,301,1552,14,148,88,169,162,257,1120,1886,7,15077,837,0,2,13,6,82280,32760,6533,43852,0
56,2883,722,423,573,19,0,135,741,12,172,101,199,184,300,1320,2257,6,15668,870,0,2,26,0,82280,32762,6533,43854,0
253,5855,4293,999,3693,19,54,507,4312,9,155,88,170,164,258,1156,1898,4,9368,520,0,2,26,2,82280,32764,6533,43855,1
253,5855,1482,859,1002,125,135,219,1607,16,219,134,251,235,385,1766,3032,9,27804,1544,1,2,26,2,82290,32765,6533,43856,1
70,1557,402,202,227,24,74,80,426,12,52,33,61,64,94,339,564,7,3969,220,0,2,10,2,82290,32766,6533,43857,1
172,7635,4293,999,3693,19,54,507,4312,9,155,88,170,164,258,1156,1898,4,9368,520,0,2,43,0,82290,32768,6533,43858,1
172,7635,1482,859,1002,125,135,219,1607,16,219,134,251,235,385,1766,3032,9,27804,1544,1,2,43,0,82300,32769,6533,43859,1
253,5855,4293,999,3693,19,54,507,4312,9,155,88,170,164,258,1156,1898,4,9368,520,0,2,26,2,82300,32771,6533,43860,0
253,5855,1482,859,1002,125,135,219,1607,16,219,134,251,235,385,1766,3032,9,27804,1544,1,2,26,2,82310,32772,6533,43861,0
70,1557,402,202,227,24,74,80,426,12,52,33,61,64,94,339,564,7,3969,220,0,2,10,2,82310,32773,6533,43862,0
172,7635,4293,999,3693,19,54,507,4312,9,155,88,170,164,258,1156,1898,4,9368,520,0,2,43,0,82310,32775,6533,43863,0
172,7635,1482,859,1002,125,135,219,1607,16,219,134,251,235,385,1766,3032,9,27804,1544,1,2,43,0,82320,32776,6533,43864,0
107,2805,773,422,505,30,103,129,803,14,77,46,83,91,129,535,839,7,6334,351,0,2,33,0,82330,32777,6534,43865,0
2,235,149,67,118,4,0,27,153,1,17,14,28,18,42,69,175,0,144,8,0,2,30,0,82330,32777,6534,43866,0
253,5853,4293,999,3693,19,54,507,4312,9,155,88,170,164,258,1156,1898,4,9368,520,0,2,26,2,82330,32779,6534,43867,0
253,5853,1482,859,1002,125,135,219,1607,16,219,134,251,235,385,1766,3032,9,27804,1544,1,2,26,2,82340,32780,6534,43868,0
70,1557,402,202,227,24,74,80,426,12,52,33,61,64,94,339,564,7,3969,220,0,2,10,2,82340,32781,6534,43869,0
315,6924,72,33,56,0,4,12,72,1,1,1,1,2,2,0,2,0,1,0,0,2,4,2,82340,32781,6534,43870,0
315,6924,1454,835,1044,76,110,219,1530,17,275,158,296,292,454,2297,3718,9,34017,1889,1,2,4,2,82350,32782,6534,43871,0
91,4008,1338,495,1086,10,64,173,1348,11,122,82,157,133,239,883,1686,7,11934,663,0,2,18,1,82350,32784,6534,43872,0
172,7635,4293,999,3693,19,54,507,4312,9,155,88,170,164,258,1156,1898,4,9368,520,0,2,43,0,82350,32786,6534,43873,0
172,7635,1482,859,1002,125,135,219,1607,16,219,134,251,235,385,1766,3032,9,27804,1544,1,2,43,0,82360,32787,6534,43874,0
253,5853,4293,999,3693,19,54,507,4312,9,155,88,170,164,258,1156,1898,4,9368,520,0,2,26,2,82360,32789,6534,43875,0
253,5853,1482,859,1002,125,135,219,1607,16,219,134,251,235,385,1766,3032,9,27804,1544,1,2,26,2,82370,32790,6534,43876,0
70,1557,402,202,227,24,74,80,426,12,52,33,61,64,94,339,564,7,3969,220,0,2,10,2,82370,32791,6534,43877,0
315,6924,72,33,56,0,4,12,72,1,1,1,1,2,2,0,2,0,1,0,0,2,4,2,82370,32791,6534,43878,0
315,6924,1454,835,1044,76,110,219,1530,17,275,158,296,292,454,2297,3718,9,34017,1889,1,2,4,2,82380,32792,6534,43879,0
91,4008,1338,495,1086,10,64,173,1348,11,122,82,157,133,239,883,1686,7,11934,663,0,2,18,1,82380,32794,6534,43880,0
172,7635,4293,999,3693,19,54,507,4312,9,155,88,170,164,258,1156,1898,4,9368,520,0,2,43,0,82380,32796,6534,43881,0
172,7635,1482,859,1002,125,135,219,1607,16,219,134,251,235,385,1766,3032,9,27804,1544,1,2,43,0,82390,32797,6534,43882,0
1,98,42,7,35,4,0,5,46,1,2,1,2,3,3,2,4,0,2,0,0,2,3,2,82390,32797,6534,43883,0
1,98,11,6,10,0,0,1,11,2,4,2,4,6,6,10,15,1,15,0,0,2,3,2,82390,32797,6534,43884,0
188,5732,1660,832,1314,41,38,274,1701,20,312,209,395,332,604,2671,5058,12,64042,3557,1,2,25,19,82390,32799,6535,43886,0
188,5732,1057,646,719,113,100,145,1170,18,215,134,248,233,382,1740,3004,10,31186,1732,1,2,25,19,82400,32800,6536,43887,0
73,1512,207,111,150,11,0,50,218,5,26,19,36,31,55,133,272,3,943,52,0,2,0,1,82400,32800,6536,43888,0
73,1512,410,198,237,31,55,97,441,11,63,38,72,74,110,414,683,6,4293,238,0,2,0,1,82410,32801,6537,43889,0
237,4939,2,2,2,0,0,0,2,0,0,0,0,0,0,0,0,0,0,0,0,2,7,14,82410,32801,6537,43889,0
237,4939,99,48,90,1,3,5,100,0,0,0,0,0,0,0,0,0,0,0,0,2,7,14,82410,32802,6537,43890,0
237,4939,8,5,5,2,0,1,10,0,0,0,0,0,0,0,0,0,0,0,0,2,7,14,82410,32802,6537,43891,0
237,4939,1217,716,841,84,126,174,1301,14,185,118,215,199,333,1446,2542,8,20687,1149,0,2,7,14,82420,32804,6537,43892,0
237,4939,160,89,115,0,13,31,160,7,15,11,17,22,28,78,124,3,495,27,0,2,7,14,82420,32804,6537,43893,0
237,4939,10,10,9,9,0,0,19,0,0,0,0,0,0,0,0,0,0,0,0,2,7,14,82420,32804,6538,43894,0
237,4939,173,84,99,8,29,36,181,5,12,7,13,17,20,54,81,2,221,12,0,2,7,14,82420,32805,6538,43895,0
237,4939,3,1,1,3,0,0,6,0,0,0,0,0,0,0,0,0,0,0,0,2,7,14,82420,32805,6538,43896,0
57,1522,339,213,244,17,9,65,356,10,42,26,48,52,74,259,421,5,2410,133,0,2,132,120,82430,32805,6538,43897,0
253,5853,4293,999,3693,19,54,507,4312,9,155,88,170,164,258,1156,1898,4,9368,520,0,2,2,4,82430,32807,6538,43898,0
253,5853,1482,859,1002,125,135,219,1607,16,219,134,251,235,385,1766,3032,9,27804,1544,1,2,2,4,82440,32808,6538,43899,0
31,1087,74,35,59,1,0,14,75,3,14,7,14,17,21,58,85,1,128,7,0,2,28,4,82440,32809,6538,43900,0
31,1087,245,125,200,5,7,34,250,7,30,17,34,37,51,166,265,3,1053,58,0,2,28,4,82450,32810,6538,43901,0
117,3174,1523,757,1297,19,12,193,1542,12,193,117,230,205,347,1508,2664,7,19053,1058,0,2,12,0,82460,32812,6538,43902,0
117,3174,701,378,504,33,58,109,734,13,110,68,126,123,194,794,1346,7,10027,557,0,2,12,0,82460,32813,6539,43903,0
107,2805,773,422,505,30,103,129,803,14,77,46,83,91,129,535,839,7,6334,351,0,2,59,19,82470,32814,6540,43904,0
19,513,205,80,86,16,53,53,221,7,18,10,19,25,29,94,134,3,497,27,0,2,8,14,82480,32814,6541,43905,0
232,5970,722,423,573,19,0,135,741,12,172,101,199,184,300,1320,2257,6,15668,870,0,2,13,15,82480,32816,6541,43907,0
232,5970,1508,847,911,44,250,301,1552,14,148,88,169,162,257,1120,1886,7,15077,837,0,2,13,15,82480,32817,6542,43908,0
315,6924,72,33,56,0,4,12,72,1,1,1,1,2,2,0,2,0,1,0,0,2,1,2,82480,32817,6542,43909,0
315,6924,1454,835,1044,76,110,219,1530,17,275,158,296,292,454,2297,3718,9,34017,1889,1,2,1,2,82490,32818,6542,43910,0
282,5915,1943,715,1694,26,18,214,1969,12,185,120,237,197,357,1436,2721,7,20915,1161,0,2,1,1,82490,32820,6542,43911,0
282,5915,1168,838,957,57,25,144,1225,19,348,224,416,367,640,3018,5452,11,61921,3440,1,2,1,1,82500,32822,6542,43912,0
19,721,442,244,305,14,16,103,456,11,68,45,75,79,120,452,756,6,4588,254,0,2,21,21,82500,32824,6542,43913,0
19,721,182,102,99,11,40,35,193,3,11,6,11,14,17,42,64,1,97,5,0,2,21,21,82500,32825,6542,43914,0
106,4498,1289,550,1043,56,32,155,1345,10,167,93,185,177,278,1266,2075,5,11498,638,0,2,10,21,82500,32827,6543,43915,0
6,163,127,75,83,2,11,30,129,4,14,7,14,18,21,61,87,2,175,9,0,2,1,0,82500,32827,6543,43916,0
6,163,652,304,544,16,6,88,668,6,89,51,101,95,152,591,998,3,3399,188,0,2,1,0,82500,32828,6543,43917,0
6,163,2,2,2,0,0,0,2,0,0,0,0,0,0,0,0,0,0,0,0,2,1,0,82500,32828,6543,43917,0
6,163,8,5,5,0,0,3,8,0,0,0,0,0,0,0,0,0,0,0,0,2,1,0,82500,32828,6543,43918,0
6,163,2,2,2,0,0,0,2,0,0,0,0,0,0,0,0,0,0,0,0,2,1,0,82500,32828,6543,43918,0
6,163,14,8,8,0,0,6,14,0,0,0,0,0,0,0,0,0,0,0,0,2,1,0,82500,32828,6543,43919,0
6,163,6,4,4,0,0,2,6,0,0,0,0,0,0,0,0,0,0,0,0,2,1,0,82500,32828,6543,43920,0
6,163,6,4,4,0,0,2,6,1,2,1,2,3,3,2,4,0,2,0,0,2,1,0,82500,32828,6543,43921,0
6,163,6,4,4,0,0,2,6,0,0,0,0,0,0,0,0,0,0,0,0,2,1,0,82500,32828,6543,43922,0
6,163,7,5,5,0,0,2,7,0,0,0,0,0,0,0,0,0,0,0,0,2,1,0,82500,32828,6543,43923,0
6,163,6,4,4,0,0,2,6,0,0,0,0,0,0,0,0,0,0,0,0,2,1,0,82500,32828,6543,43924,0
6,163,10,6,6,0,0,4,10,0,0,0,0,0,0,0,0,0,0,0,0,2,1,0,82500,32828,6543,43925,0
6,163,1,1,1,0,0,0,1,0,0,0,0,0,0,0,0,0,0,0,0,2,1,0,82500,32828,6543,43925,0
6,163,14,10,10,0,0,4,14,1,1,1,1,2,2,0,2,0,1,0,0,2,1,0,82500,32828,6543,43926,0
6,163,46,26,30,3,0,12,49,3,6,3,6,9,9,20,28,1,42,2,0,2,1,0,82510,32828,6543,43927,0
2,235,149,67,118,4,0,27,153,1,17,14,28,18,42,69,175,0,144,8,0,2,30,0,82510,32828,6543,43928,0
38,2498,1157,318,931,29,22,177,1186,6,104,63,125,110,188,712,1274,3,4596,255,0,2,45,0,82510,32828,6543,43929,0
129,5167,1450,624,1228,12,26,181,1462,14,306,186,354,320,540,2580,4493,8,36391,2021,1,2,24,37,82510,32830,6544,43930,0
182,5438,1660,832,1314,41,38,274,1701,20,312,209,395,332,604,2671,5058,12,64042,3557,1,2,53,0,82510,32832,6545,43932,0
98,5250,1457,730,1242,11,6,188,1468,10,292,166,329,302,495,2424,4078,5,22973,1276,1,2,47,74,82510,32834,6545,43933,0
2,56,7,6,5,0,0,2,7,1,1,1,2,2,3,0,3,1,3,0,0,2,4,10,82510,32834,6545,43934,0
108,5173,1523,757,1297,19,12,193,1542,12,193,117,230,205,347,1508,2664,7,19053,1058,0,2,27,0,82520,32836,6545,43935,0
78,4013,1293,570,1093,25,15,163,1318,10,195,123,241,205,364,1516,2795,6,17273,959,0,2,59,26,82530,32838,6545,43936,0
56,2883,722,423,573,19,0,135,741,12,172,101,199,184,300,1320,2257,6,15668,870,0,2,26,0,82530,32840,6545,43938,0
30,1440,373,158,315,8,0,51,381,5,76,44,79,81,123,486,779,2,2026,112,0,2,1,1,82530,32840,6545,43939,0
81,3172,1178,367,1042,6,15,115,1184,9,94,51,95,103,146,644,976,4,4439,246,0,2,8,0,82530,32840,6545,43940,0
111,6122,1943,715,1694,26,18,214,1969,12,185,120,237,197,357,1436,2721,7,20915,1161,0,2,1,1,82530,32842,6545,43941,0
71,1576,402,202,227,24,74,80,426,12,52,33,61,64,94,339,564,7,3969,220,0,2,7,3,82530,32843,6545,43942,0
71,3226,1020,354,843,12,15,144,1032,8,134,77,144,142,221,970,1580,4,6792,377,0,2,22,0,82530,32843,6545,43943,0
71,1576,402,202,227,24,74,80,426,12,52,33,61,64,94,339,564,7,3969,220,0,2,7,3,82530,32844,6545,43944,0
71,3226,1020,354,843,12,15,144,1032,8,134,77,144,142,221,970,1580,4,6792,377,0,2,22,0,82530,32844,6545,43945,0
189,5744,1660,832,1314,41,38,274,1701,20,312,209,395,332,604,2671,5058,12,64042,3557,1,2,12,4,82530,32846,6546,43947,0
189,5744,1057,646,719,113,100,145,1170,18,215,134,248,233,382,1740,3004,10,31186,1732,1,2,12,4,82540,32847,6547,43948,0
184,5506,1660,832,1314,41,38,274,1701,20,312,209,395,332,604,2671,5058,12,64042,3557,1,2,27,2,82540,32849,6548,43950,0
189,5744,1660,832,1314,41,38,274,1701,20,312,209,395,332,604,2671,5058,12,64042,3557,1,2,12,4,82540,32851,6549,43952,0
189,5744,1057,646,719,113,100,145,1170,18,215,134,248,233,382,1740,3004,10,31186,1732,1,2,12,4,82550,32852,6550,43953,0
184,5506,1660,832,1314,41,38,274,1701,20,312,209,395,332,604,2671,5058,12,64042,3557,1,2,27,2,82550,32854,6551,43955,0
1,94,42,7,35,4,0,5,46,1,2,1,2,3,3,2,4,0,2,0,0,2,2,4,82550,32854,6551,43956,1
1,94,11,6,10,0,0,1,11,2,4,2,4,6,6,10,15,1,15,0,0,2,2,4,82550,32854,6551,43957,1
221,4758,182,127,129,0,0,53,182,5,39,21,42,44,63,217,343,2,926,51,0,2,47,95,82550,32854,6552,43958,1
221,4758,1165,710,800,67,119,181,1232,18,243,153,282,261,435,2000,3492,10,36473,2026,1,2,47,95,82560,32854,6553,43959,1
25,514,2,2,2,0,0,0,2,0,0,0,0,0,0,0,0,0,0,0,0,2,0,4,82560,32854,6553,43959,1
25,514,99,48,90,1,3,5,100,0,0,0,0,0,0,0,0,0,0,0,0,2,0,4,82560,32855,6553,43960,1
25,514,8,5,5,2,0,1,10,0,0,0,0,0,0,0,0,0,0,0,0,2,0,4,82560,32855,6553,43961,1
25,514,1217,716,841,84,126,174,1301,14,185,118,215,199,333,1446,2542,8,20687,1149,0,2,0,4,82570,32857,6553,43962,1
25,514,160,89,115,0,13,31,160,7,15,11,17,22,28,78,124,3,495,27,0,2,0,4,82570,32857,6553,43963,1
25,514,10,10,9,9,0,0,19,0,0,0,0,0,0,0,0,0,0,0,0,2,0,4,82570,32857,6554,43964,1
25,514,173,84,99,8,29,36,181,5,12,7,13,17,20,54,81,2,221,12,0,2,0,4,82570,32858,6554,43965,1
25,514,3,1,1,3,0,0,6,0,0,0,0,0,0,0,0,0,0,0,0,2,0,4,82570,32858,6554,43966,1
174,5298,1660,832,1314,41,38,274,1701,20,312,209,395,332,604,2671,5058,12,64042,3557,1,2,9,93,82570,32860,6555,43968,1
174,5298,1057,646,719,113,100,145,1170,18,215,134,248,233,382,1740,3004,10,31186,1732,1,2,9,93,82580,32861,6556,43969,1
116,2173,477,336,357,30,23,73,507,16,194,134,250,210,384,1538,2962,10,30538,1696,0,2,1,1,82590,32862,6556,43970,1
90,2044,996,429,845,24,10,117,1020,7,76,50,88,83,138,494,879,4,3565,198,0,2,1,2,82590,32864,6556,43971,1
90,2044,456,277,329,12,42,72,468,13,85,50,97,98,147,592,972,7,7212,400,0,2,1,2,82590,32864,6556,43972,1
160,3459,1513,682,1277,25,13,200,1538,11,199,116,219,210,335,1557,2584,6,15641,868,0,2,4,23,82590,32866,6556,43973,1
160,3459,819,519,539,24,98,155,843,15,96,57,106,111,163,690,1107,8,9171,509,0,2,4,23,82600,32868,6556,43974,1
59,1120,207,111,150,11,0,50,218,5,26,19,36,31,55,133,272,3,943,52,0,2,34,157,82600,32868,6556,43975,1
59,1120,410,198,237,31,55,97,441,11,63,38,72,74,110,414,683,6,4293,238,0,2,34,157,82610,32869,6557,43976,1
235,4913,2,2,2,0,0,0,2,0,0,0,0,0,0,0,0,0,0,0,0,2,3,10,82610,32869,6557,43976,1
235,4913,99,48,90,1,3,5,100,0,0,0,0,0,0,0,0,0,0,0,0,2,3,10,82610,32870,6557,43977,1
235,4913,8,5,5,2,0,1,10,0,0,0,0,0,0,0,0,0,0,0,0,2,3,10,82610,32870,6557,43978,1
235,4913,1217,716,841,84,126,174,1301,14,185,118,215,199,333,1446,2542,8,20687,1149,0,2,3,10,82620,32872,6557,43979,1
235,4913,160,89,115,0,13,31,160,7,15,11,17,22,28,78,124,3,495,27,0,2,3,10,82620,32872,6557,43980,1
235,4913,10,10,9,9,0,0,19,0,0,0,0,0,0,0,0,0,0,0,0,2,3,10,82620,32872,6558,43981,1
235,4913,173,84,99,8,29,36,181,5,12,7,13,17,20,54,81,2,221,12,0,2,3,10,82620,32873,6558,43982,1
235,4913,3,1,1,3,0,0,6,0,0,0,0,0,0,0,0,0,0,0,0,2,3,10,82620,32873,6558,43983,1
90,2308,1455,414,1257,16,76,112,1471,5,41,23,46,46,69,231,381,2,1069,59,0,2,0,27,82620,32874,6558,43984,1
90,2308,669,365,481,22,61,110,691,15,103,63,122,118,185,747,1273,8,11311,628,0,2,0,27,82630,32874,6559,43985,1
251,5838,4293,999,3693,19,54,507,4312,9,155,88,170,164,258,1156,1898,4,9368,520,0,2,1,5,82630,32876,6559,43986,1
251,5838,1482,859,1002,125,135,219,1607,16,219,134,251,235,385,1766,3032,9,27804,1544,1,2,1,5,82640,32877,6559,43987,1
117,3160,1523,757,1297,19,12,193,1542,12,193,117,230,205,347,1508,2664,7,19053,1058,0,2,0,4,82650,32879,6559,43988,1
117,3160,701,378,504,33,58,109,734,13,110,68,126,123,194,794,1346,7,10027,557,0,2,0,4,82650,32880,6560,43989,1
105,2779,773,422,505,30,103,129,803,14,77,46,83,91,129,535,839,7,6334,351,0,2,2,8,82660,32881,6561,43990,1
149,3603,77,34,69,0,0,8,77,3,24,16,29,27,45,114,213,1,387,21,0,2,5,56,82660,32881,6561,43991,1
149,3603,712,438,573,51,9,84,763,14,102,71,128,116,199,733,1364,8,11988,666,0,2,5,56,82670,32882,6561,43992,1
71,1576,402,202,227,24,74,80,426,12,52,33,61,64,94,339,564,7,3969,220,0,2,2,2,82670,32883,6561,43993,1
51,1113,447,308,343,6,5,95,453,7,96,59,111,103,170,651,1136,4,4600,255,0,2,2,14,82670,32886,6561,43994,1
51,1113,322,174,179,16,74,51,338,10,41,26,46,51,72,252,408,5,2291,127,0,2,2,14,82670,32889,6562,43995,1
15,490,184,100,137,2,15,30,186,6,38,20,39,44,59,214,322,3,991,55,0,2,3,12,82670,32890,6562,43996,1
15,490,103,65,74,8,5,16,111,7,17,9,17,24,26,89,119,3,417,23,0,2,3,12,82670,32891,6562,43997,1
58,1203,91,45,69,0,3,18,91,3,9,6,10,12,16,33,57,1,95,5,0,2,3,16,82670,32893,6562,43998,1
58,1203,367,234,237,17,34,68,384,16,55,34,61,71,95,381,584,8,5183,287,0,2,3,16,82670,32894,6562,43999,1
228,5903,722,423,573,19,0,135,741,12,172,101,199,184,300,1320,2257,6,15668,870,0,2,3,18,82670,32896,6562,44001,1
228,5903,1508,847,911,44,250,301,1552,14,148,88,169,162,257,1120,1886,7,15077,837,0,2,3,18,82670,32897,6563,44002,1
315,6914,72,33,56,0,4,12,72,1,1,1,1,2,2,0,2,0,1,0,0,2,2,3,82670,32897,6563,44003,1
315,6914,1454,835,1044,76,110,219,1530,17,275,158,296,292,454,2297,3718,9,34017,1889,1,2,2,3,82680,32898,6563,44004,1
89,1819,757,253,292,73,244,162,830,13,61,38,67,74,105,409,651,7,4654,258,0,2,4,15,82680,32899,6563,44005,1
38,814,386,256,301,16,9,68,402,4,59,35,69,63,104,355,621,2,1453,80,0,2,1,34,82680,32899,6563,44006,1
38,814,264,131,164,11,41,46,275,6,38,22,40,44,62,214,338,3,1068,59,0,2,1,34,82690,32899,6564,44007,1
40,796,1178,367,1042,6,15,115,1184,9,94,51,95,103,146,644,976,4,4439,246,0,2,2,6,82690,32899,6564,44008,1
40,796,177,108,140,8,0,27,185,6,30,16,32,36,48,162,248,3,794,44,0,2,2,6,82690,32901,6564,44009,1
280,5888,1943,715,1694,26,18,214,1969,12,185,120,237,197,357,1436,2721,7,20915,1161,0,2,0,15,82690,32903,6564,44010,1
280,5888,1168,838,957,57,25,144,1225,19,348,224,416,367,640,3018,5452,11,61921,3440,1,2,0,15,82700,32905,6564,44011,1
19,717,442,244,305,14,16,103,456,11,68,45,75,79,120,452,756,6,4588,254,0,2,1,4,82700,32907,6564,44012,1
19,717,182,102,99,11,40,35,193,3,11,6,11,14,17,42,64,1,97,5,0,2,1,4,82700,32908,6564,44013,1
65,1263,1098,241,925,5,10,155,1103,7,46,25,49,53,74,273,423,3,1580,87,0,2,1,20,82710,32910,6564,44014,1
65,1263,282,202,222,14,2,44,296,8,42,24,43,50,67,250,378,4,1548,86,0,2,1,20,82710,32911,6564,44015,1
23,642,601,196,481,2,23,85,603,8,63,36,72,71,108,400,664,4,3036,168,0,2,1,22,82710,32911,6564,44016,1
23,642,156,79,106,5,16,28,161,5,14,8,15,19,23,64,97,2,261,14,0,2,1,22,82710,32911,6564,44017,1
104,4436,1289,550,1043,56,32,155,1345,10,167,93,185,177,278,1266,2075,5,11498,638,0,2,2,12,82710,32913,6565,44018,1
31,994,182,127,129,0,0,53,182,5,39,21,42,44,63,217,343,2,926,51,0,2,6,27,82710,32913,6566,44019,1
151,7251,1392,870,1177,35,17,170,1427,14,494,280,531,508,811,4473,7289,7,54850,3047,2,2,12,25,82710,32916,6567,44020,1
95,2896,773,419,590,28,0,166,801,10,204,113,217,214,330,1598,2554,5,13587,754,0,2,1,3,82710,32916,6568,44021,1
2,58,16,12,9,0,0,6,16,1,2,1,2,3,3,2,4,0,2,0,0,2,1,5,82710,32916,6568,44022,1
65,4378,520,294,400,33,13,81,553,10,261,204,367,271,571,2128,4614,7,32445,1802,1,2,1,2,82710,32917,6568,44023,1
90,3988,1338,495,1086,10,64,173,1348,11,122,82,157,133,239,883,1686,7,11934,663,0,2,0,2,82710,32919,6568,44024,1
144,5933,1782,648,1425,9,47,279,1791,8,171,97,189,179,286,1292,2140,4,9462,525,0,2,0,2,82710,32920,6569,44025,1
32,982,256,139,192,9,7,47,265,4,23,12,24,27,36,112,171,2,357,19,0,2,4,15,82710,32921,6569,44026,1
19,517,102,59,69,5,3,24,107,6,22,15,28,28,43,113,206,3,789,43,0,2,1,13,82710,32921,6569,44027,1
119,4920,1450,624,1228,12,26,181,1462,14,306,186,354,320,540,2580,4493,8,36391,2021,1,2,4,64,82710,32923,6570,44028,1
176,5162,1660,832,1314,41,38,274,1701,20,312,209,395,332,604,2671,5058,12,64042,3557,1,2,7,91,82710,32925,6571,44030,1
120,5123,1513,682,1277,25,13,200,1538,11,199,116,219,210,335,1557,2584,6,15641,868,0,2,7,66,82710,32927,6571,44031,1
84,4916,1296,573,1062,40,33,157,1336,8,201,118,231,209,349,1561,2689,4,12365,686,0,2,0,2,82710,32927,6571,44032,1
20,467,207,111,150,11,0,50,218,5,26,19,36,31,55,133,272,3,943,52,0,2,0,7,82710,32927,6571,44033,1
98,5241,1457,730,1242,11,6,188,1468,10,292,166,329,302,495,2424,4078,5,22973,1276,1,2,0,3,82710,32929,6571,44034,1
72,3266,1455,414,1257,16,76,112,1471,5,41,23,46,46,69,231,381,2,1069,59,0,2,3,7,82710,32930,6571,44035,1
107,5160,1523,757,1297,19,12,193,1542,12,193,117,230,205,347,1508,2664,7,19053,1058,0,2,1,3,82720,32932,6571,44036,1
70,3204,1020,354,843,12,15,144,1032,8,134,77,144,142,221,970,1580,4,6792,377,0,2,2,11,82720,32932,6571,44037,1
44,2058,447,308,343,6,5,95,453,7,96,59,111,103,170,651,1136,4,4600,255,0,2,2,22,82720,32935,6571,44038,1
9,444,184,100,137,2,15,30,186,6,38,20,39,44,59,214,322,3,991,55,0,2,4,14,82720,32936,6571,44039,1
75,3960,1293,570,1093,25,15,163,1318,10,195,123,241,205,364,1516,2795,6,17273,959,0,2,5,19,82730,32938,6571,44040,1
85,3387,1043,504,840,53,9,147,1096,9,180,112,198,189,310,1377,2344,4,11604,644,0,2,1,4,82730,32940,6571,44041,1
79,3101,1178,367,1042,6,15,115,1184,9,94,51,95,103,146,644,976,4,4439,246,0,2,1,20,82730,32940,6571,44042,1
35,1497,442,244,305,14,16,103,456,11,68,45,75,79,120,452,756,6,4588,254,0,2,0,3,82730,32942,6571,44043,1
48,1943,1098,241,925,5,10,155,1103,7,46,25,49,53,74,273,423,3,1580,87,0,2,4,14,82740,32944,6571,44044,1
48,1649,601,196,481,2,23,85,603,8,63,36,72,71,108,400,664,4,3036,168,0,2,0,95,82740,32944,6571,44045,1
1,94,42,7,35,4,0,5,46,1,2,1,2,3,3,2,4,0,2,0,0,2,2,4,82740,32944,6571,44046,0
1,94,11,6,10,0,0,1,11,2,4,2,4,6,6,10,15,1,15,0,0,2,2,4,82740,32944,6571,44047,0
221,4758,182,127,129,0,0,53,182,5,39,21,42,44,63,217,343,2,926,51,0,2,47,95,82740,32944,6572,44048,0
221,4758,1165,710,800,67,119,181,1232,18,243,153,282,261,435,2000,3492,10,36473,2026,1,2,47,95,82750,32944,6573,44049,0
25,514,2,2,2,0,0,0,2,0,0,0,0,0,0,0,0,0,0,0,0,2,0,4,82750,32944,6573,44049,0
25,514,99,48,90,1,3,5,100,0,0,0,0,0,0,0,0,0,0,0,0,2,0,4,82750,32945,6573,44050,0
25,514,8,5,5,2,0,1,10,0,0,0,0,0,0,0,0,0,0,0,0,2,0,4,82750,32945,6573,44051,0
25,514,1217,716,841,84,126,174,1301,14,185,118,215,199,333,1446,2542,8,20687,1149,0,2,0,4,82760,32947,6573,44052,0
25,514,160,89,115,0,13,31,160,7,15,11,17,22,28,78,124,3,495,27,0,2,0,4,82760,32947,6573,44053,0
25,514,10,10,9,9,0,0,19,0,0,0,0,0,0,0,0,0,0,0,0,2,0,4,82760,32947,6574,44054,0
25,514,173,84,99,8,29,36,181,5,12,7,13,17,20,54,81,2,221,12,0,2,0,4,82760,32948,6574,44055,0
25,514,3,1,1,3,0,0,6,0,0,0,0,0,0,0,0,0,0,0,0,2,0,4,82760,32948,6574,44056,0
174,5298,1660,832,1314,41,38,274,1701,20,312,209,395,332,604,2671,5058,12,64042,3557,1,2,9,93,82760,32950,6575,44058,0
174,5298,1057,646,719,113,100,145,1170,18,215,134,248,233,382,1740,3004,10,31186,1732,1,2,9,93,82770,32951,6576,44059,0
116,2173,477,336,357,30,23,73,507,16,194,134,250,210,384,1538,2962,10,30538,1696,0,2,1,1,82780,32952,6576,44060,0
90,2044,996,429,845,24,10,117,1020,7,76,50,88,83,138,494,879,4,3565,198,0,2,1,2,82780,32954,6576,44061,0
90,2044,456,277,329,12,42,72,468,13,85,50,97,98,147,592,972,7,7212,400,0,2,1,2,82780,32954,6576,44062,0
160,3459,1513,682,1277,25,13,200,1538,11,199,116,219,210,335,1557,2584,6,15641,868,0,2,4,23,82780,32956,6576,44063,0
160,3459,819,519,539,24,98,155,843,15,96,57,106,111,163,690,1107,8,9171,509,0,2,4,23,82790,32958,6576,44064,0
59,1120,207,111,150,11,0,50,218,5,26,19,36,31,55,133,272,3,943,52,0,2,34,157,82790,32958,6576,44065,0
59,1120,410,198,237,31,55,97,441,11,63,38,72,74,110,414,683,6,4293,238,0,2,34,157,82800,32959,6577,44066,0
235,4913,2,2,2,0,0,0,2,0,0,0,0,0,0,0,0,0,0,0,0,2,3,10,82800,32959,6577,44066,0
235,4913,99,48,90,1,3,5,100,0,0,0,0,0,0,0,0,0,0,0,0,2,3,10,82800,32960,6577,44067,0
235,4913,8,5,5,2,0,1,10,0,0,0,0,0,0,0,0,0,0,0,0,2,3,10,82800,32960,6577,44068,0
235,4913,1217,716,841,84,126,174,1301,14,185,118,215,199,333,1446,2542,8,20687,1149,0,2,3,10,82810,32962,6577,44069,0
235,4913,160,89,115,0,13,31,160,7,15,11,17,22,28,78,124,3,495,27,0,2,3,10,82810,32962,6577,44070,0
235,4913,10,10,9,9,0,0,19,0,0,0,0,0,0,0,0,0,0,0,0,2,3,10,82810,32962,6578,44071,0
235,4913,173,84,99,8,29,36,181,5,12,7,13,17,20,54,81,2,221,12,0,2,3,10,82810,32963,6578,44072,0
235,4913,3,1,1,3,0,0,6,0,0,0,0,0,0,0,0,0,0,0,0,2,3,10,82810,32963,6578,44073,0
90,2308,1455,414,1257,16,76,112,1471,5,41,23,46,46,69,231,381,2,1069,59,0,2,0,27,82810,32964,6578,44074,0
90,2308,669,365,481,22,61,110,691,15,103,63,122,118,185,747,1273,8,11311,628,0,2,0,27,82820,32964,6579,44075,0
251,5838,4293,999,3693,19,54,507,4312,9,155,88,170,164,258,1156,1898,4,9368,520,0,2,1,5,82820,32966,6579,44076,0
251,5838,1482,859,1002,125,135,219,1607,16,219,134,251,235,385,1766,3032,9,27804,1544,1,2,1,5,82830,32967,6579,44077,0
117,3160,1523,757,1297,19,12,193,1542,12,193,117,230,205,347,1508,2664,7,19053,1058,0,2,0,4,82840,32969,6579,44078,0
117,3160,701,378,504,33,58,109,734,13,110,68,126,123,194,794,1346,7,10027,557,0,2,0,4,82840,32970,6580,44079,0
105,2779,773,422,505,30,103,129,803,14,77,46,83,91,129,535,839,7,6334,351,0,2,2,8,82850,32971,6581,44080,0
149,3603,77,34,69,0,0,8,77,3,24,16,29,27,45,114,213,1,387,21,0,2,5,56,82850,32971,6581,44081,0
149,3603,712,438,573,51,9,84,763,14,102,71,128,116,199,733,1364,8,11988,666,0,2,5,56,82860,32972,6581,44082,0
71,1576,402,202,227,24,74,80,426,12,52,33,61,64,94,339,564,7,3969,220,0,2,2,2,82860,32973,6581,44083,0
51,1113,447,308,343,6,5,95,453,7,96,59,111,103,170,651,1136,4,4600,255,0,2,2,14,82860,32976,6581,44084,0
51,1113,322,174,179,16,74,51,338,10,41,26,46,51,72,252,408,5,2291,127,0,2,2,14,82860,32979,6582,44085,0
15,490,184,100,137,2,15,30,186,6,38,20,39,44,59,214,322,3,991,55,0,2,3,12,82860,32980,6582,44086,0
15,490,103,65,74,8,5,16,111,7,17,9,17,24,26,89,119,3,417,23,0,2,3,12,82860,32981,6582,44087,0
58,1203,91,45,69,0,3,18,91,3,9,6,10,12,16,33,57,1,95,5,0,2,3,16,82860,32983,6582,44088,0
58,1203,367,234,237,17,34,68,384,16,55,34,61,71,95,381,584,8,5183,287,0,2,3,16,82860,32984,6582,44089,0
228,5903,722,423,573,19,0,135,741,12,172,101,199,184,300,1320,2257,6,15668,870,0,2,3,18,82860,32986,6582,44091,0
228,5903,1508,847,911,44,250,301,1552,14,148,88,169,162,257,1120,1886,7,15077,837,0,2,3,18,82860,32987,6583,44092,0
315,6914,72,33,56,0,4,12,72,1,1,1,1,2,2,0,2,0,1,0,0,2,2,3,82860,32987,6583,44093,0
315,6914,1454,835,1044,76,110,219,1530,17,275,158,296,292,454,2297,3718,9,34017,1889,1,2,2,3,82870,32988,6583,44094,0
89,1819,757,253,292,73,244,162,830,13,61,38,67,74,105,409,651,7,4654,258,0,2,4,15,82870,32989,6583,44095,0
38,814,386,256,301,16,9,68,402,4,59,35,69,63,104,355,621,2,1453,80,0,2,1,34,82870,32989,6583,44096,0
38,814,264,131,164,11,41,46,275,6,38,22,40,44,62,214,338,3,1068,59,0,2,1,34,82880,32989,6584,44097,0
40,796,1178,367,1042,6,15,115,1184,9,94,51,95,103,146,644,976,4,4439,246,0,2,2,6,82880,32989,6584,44098,0
40,796,177,108,140,8,0,27,185,6,30,16,32,36,48,162,248,3,794,44,0,2,2,6,82880,32991,6584,44099,0
280,5888,1943,715,1694,26,18,214,1969,12,185,120,237,197,357,1436,2721,7,20915,1161,0,2,0,15,82880,32993,6584,44100,0
280,5888,1168,838,957,57,25,144,1225,19,348,224,416,367,640,3018,5452,11,61921,3440,1,2,0,15,82890,32995,6584,44101,0
19,717,442,244,305,14,16,103,456,11,68,45,75,79,120,452,756,6,4588,254,0,2,1,4,82890,32997,6584,44102,0
19,717,182,102,99,11,40,35,193,3,11,6,11,14,17,42,64,1,97,5,0,2,1,4,82890,32998,6584,44103,0
65,1263,1098,241,925,5,10,155,1103,7,46,25,49,53,74,273,423,3,1580,87,0,2,1,20,82900,33000,6584,44104,0
65,1263,282,202,222,14,2,44,296,8,42,24,43,50,67,250,378,4,1548,86,0,2,1,20,82900,33001,6584,44105,0
23,642,601,196,481,2,23,85,603,8,63,36,72,71,108,400,664,4,3036,168,0,2,1,22,82900,33001,6584,44106,0
23,642,156,79,106,5,16,28,161,5,14,8,15,19,23,64,97,2,261,14,0,2,1,22,82900,33001,6584,44107,0
104,4436,1289,550,1043,56,32,155,1345,10,167,93,185,177,278,1266,2075,5,11498,638,0,2,2,12,82900,33003,6585,44108,0
31,994,182,127,129,0,0,53,182,5,39,21,42,44,63,217,343,2,926,51,0,2,6,27,82900,33003,6586,44109,0
151,7251,1392,870,1177,35,17,170,1427,14,494,280,531,508,811,4473,7289,7,54850,3047,2,2,12,25,82900,33006,6587,44110,0
95,2896,773,419,590,28,0,166,801,10,204,113,217,214,330,1598,2554,5,13587,754,0,2,1,3,82900,33006,6588,44111,0
2,58,16,12,9,0,0,6,16,1,2,1,2,3,3,2,4,0,2,0,0,2,1,5,82900,33006,6588,44112,0
65,4378,520,294,400,33,13,81,553,10,261,204,367,271,571,2128,4614,7,32445,1802,1,2,1,2,82900,33007,6588,44113,0
90,3988,1338,495,1086,10,64,173,1348,11,122,82,157,133,239,883,1686,7,11934,663,0,2,0,2,82900,33009,6588,44114,0
144,5933,1782,648,1425,9,47,279,1791,8,171,97,189,179,286,1292,2140,4,9462,525,0,2,0,2,82900,33010,6589,44115,0
32,982,256,139,192,9,7,47,265,4,23,12,24,27,36,112,171,2,357,19,0,2,4,15,82900,33011,6589,44116,0
19,517,102,59,69,5,3,24,107,6,22,15,28,28,43,113,206,3,789,43,0,2,1,13,82900,33011,6589,44117,0
119,4920,1450,624,1228,12,26,181,1462,14,306,186,354,320,540,2580,4493,8,36391,2021,1,2,4,64,82900,33013,6590,44118,0
176,5162,1660,832,1314,41,38,274,1701,20,312,209,395,332,604,2671,5058,12,64042,3557,1,2,7,91,82900,33015,6591,44120,0
120,5123,1513,682,1277,25,13,200,1538,11,199,116,219,210,335,1557,2584,6,15641,868,0,2,7,66,82900,33017,6591,44121,0
84,4916,1296,573,1062,40,33,157,1336,8,201,118,231,209,349,1561,2689,4,12365,686,0,2,0,2,82900,33017,6591,44122,0
20,467,207,111,150,11,0,50,218,5,26,19,36,31,55,133,272,3,943,52,0,2,0,7,82900,33017,6591,44123,0
98,5241,1457,730,1242,11,6,188,1468,10,292,166,329,302,495,2424,4078,5,22973,1276,1,2,0,3,82900,33019,6591,44124,0
72,3266,1455,414,1257,16,76,112,1471,5,41,23,46,46,69,231,381,2,1069,59,0,2,3,7,82900,33020,6591,44125,0
107,5160,1523,757,1297,19,12,193,1542,12,193,117,230,205,347,1508,2664,7,19053,1058,0,2,1,3,82910,33022,6591,44126,0
70,3204,1020,354,843,12,15,144,1032,8,134,77,144,142,221,970,1580,4,6792,377,0,2,2,11,82910,33022,6591,44127,0
44,2058,447,308,343,6,5,95,453,7,96,59,111,103,170,651,1136,4,4600,255,0,2,2,22,82910,33025,6591,44128,0
9,444,184,100,137,2,15,30,186,6,38,20,39,44,59,214,322,3,991,55,0,2,4,14,82910,33026,6591,44129,0
75,3960,1293,570,1093,25,15,163,1318,10,195,123,241,205,364,1516,2795,6,17273,959,0,2,5,19,82920,33028,6591,44130,0
85,3387,1043,504,840,53,9,147,1096,9,180,112,198,189,310,1377,2344,4,11604,644,0,2,1,4,82920,33030,6591,44131,0
79,3101,1178,367,1042,6,15,115,1184,9,94,51,95,103,146,644,976,4,4439,246,0,2,1,20,82920,33030,6591,44132,0
35,1497,442,244,305,14,16,103,456,11,68,45,75,79,120,452,756,6,4588,254,0,2,0,3,82920,33032,6591,44133,0
48,1943,1098,241,925,5,10,155,1103,7,46,25,49,53,74,273,423,3,1580,87,0,2,4,14,82930,33034,6591,44134,0
48,1649,601,196,481,2,23,85,603,8,63,36,72,71,108,400,664,4,3036,168,0,2,0,95,82930,33034,6591,44135,0
7,296,72,33,56,0,4,12,72,1,1,1,1,2,2,0,2,0,1,0,0,2,1,1,82930,33034,6591,44136,0
7,296,72,33,56,0,4,12,72,1,1,1,1,2,2,0,2,0,1,0,0,2,1,1,82930,33034,6591,44137,0
105,2779,773,422,505,30,103,129,803,14,77,46,83,91,129,535,839,7,6334,351,0,2,1,1,82940,33035,6592,44138,0
3,330,149,67,118,4,0,27,153,1,17,14,28,18,42,69,175,0,144,8,0,2,25,0,82940,33035,6592,44139,0
105,2779,773,422,505,30,103,129,803,14,77,46,83,91,129,535,839,7,6334,351,0,2,1,1,82950,33036,6593,44140,0
3,330,149,67,118,4,0,27,153,1,17,14,28,18,42,69,175,0,144,8,0,2,25,0,82950,33036,6593,44141,0
3,42,14,8,8,0,0,6,14,0,0,0,0,0,0,0,0,0,0,0,0,2,0,1,82950,33036,6593,44144,0
2,40,9,6,6,0,0,3,9,0,0,0,0,0,0,0,0,0,0,0,0,2,0,1,82950,33036,6593,44145,0
2,40,13,9,8,0,0,4,13,0,0,0,0,0,0,0,0,0,0,0,0,2,0,1,82950,33036,6593,44146,0
1,323,382,65,130,157,2,92,539,4,10,5,10,14,15,41,57,2,114,6,0,2,0,1,82950,33037,6594,44148,0
60,1163,282,196,195,3,0,86,285,8,130,71,141,138,212,936,1507,4,6538,363,0,2,0,1,82960,33038,6595,44161,0
4,77,127,75,83,2,11,30,129,4,14,7,14,18,21,61,87,2,175,9,0,2,0,1,82960,33038,6595,44162,0
4,77,652,304,544,16,6,88,668,6,89,51,101,95,152,591,998,3,3399,188,0,2,0,1,82960,33039,6595,44163,0
4,77,2,2,2,0,0,0,2,0,0,0,0,0,0,0,0,0,0,0,0,2,0,1,82960,33039,6595,44163,0
4,77,8,5,5,0,0,3,8,0,0,0,0,0,0,0,0,0,0,0,0,2,0,1,82960,33039,6595,44164,0
4,77,2,2,2,0,0,0,2,0,0,0,0,0,0,0,0,0,0,0,0,2,0,1,82960,33039,6595,44164,0
4,77,14,8,8,0,0,6,14,0,0,0,0,0,0,0,0,0,0,0,0,2,0,1,82960,33039,6595,44165,0
4,77,6,4,4,0,0,2,6,0,0,0,0,0,0,0,0,0,0,0,0,2,0,1,82960,33039,6595,44166,0
4,77,6,4,4,0,0,2,6,1,2,1,2,3,3,2,4,0,2,0,0,2,0,1,82960,33039,6595,44167,0
4,77,6,4,4,0,0,2,6,0,0,0,0,0,0,0,0,0,0,0,0,2,0,1,82960,33039,6595,44168,0
4,77,7,5,5,0,0,2,7,0,0,0,0,0,0,0,0,0,0,0,0,2,0,1,82960,33039,6595,44169,0
4,77,6,4,4,0,0,2,6,0,0,0,0,0,0,0,0,0,0,0,0,2,0,1,82960,33039,6595,44170,0
4,77,10,6,6,0,0,4,10,0,0,0,0,0,0,0,0,0,0,0,0,2,0,1,82960,33039,6595,44171,0
4,77,1,1,1,0,0,0,1,0,0,0,0,0,0,0,0,0,0,0,0,2,0,1,82960,33039,6595,44171,0
4,77,14,10,10,0,0,4,14,1,1,1,1,2,2,0,2,0,1,0,0,2,0,1,82960,33039,6595,44172,0
4,77,46,26,30,3,0,12,49,3,6,3,6,9,9,20,28,1,42,2,0,2,0,1,82970,33039,6595,44173,0
1,9,5,3,3,0,0,2,5,0,0,0,0,0,0,0,0,0,0,0,0,2,0,1,82970,33039,6595,44173,0
1,90,13,10,10,0,0,3,13,1,2,1,2,3,3,2,4,0,2,0,0,2,0,1,82970,33039,6595,44174,0
7,114,44,19,17,0,16,11,44,3,14,7,14,17,21,58,85,1,128,7,0,2,0,1,82970,33039,6595,44175,0
3,66,127,75,83,2,11,30,129,4,14,7,14,18,21,61,87,2,175,9,0,2,0,1,82980,33040,6595,44188,0
3,66,652,304,544,16,6,88,668,6,89,51,101,95,152,591,998,3,3399,188,0,2,0,1,82980,33041,6595,44189,0
3,66,2,2,2,0,0,0,2,0,0,0,0,0,0,0,0,0,0,0,0,2,0,1,82980,33041,6595,44189,0
3,66,8,5,5,0,0,3,8,0,0,0,0,0,0,0,0,0,0,0,0,2,0,1,82980,33041,6595,44190,0
3,66,2,2,2,0,0,0,2,0,0,0,0,0,0,0,0,0,0,0,0,2,0,1,82980,33041,6595,44190,0
3,66,14,8,8,0,0,6,14,0,0,0,0,0,0,0,0,0,0,0,0,2,0,1,82980,33041,6595,44191,0
3,66,6,4,4,0,0,2,6,0,0,0,0,0,0,0,0,0,0,0,0,2,0,1,82980,33041,6595,44192,0
3,66,6,4,4,0,0,2,6,1,2,1,2,3,3,2,4,0,2,0,0,2,0,1,82980,33041,6595,44193,0
3,66,6,4,4,0,0,2,6,0,0,0,0,0,0,0,0,0,0,0,0,2,0,1,82980,33041,6595,44194,0
3,66,7,5,5,0,0,2,7,0,0,0,0,0,0,0,0,0,0,0,0,2,0,1,82980,33041,6595,44195,0
3,66,6,4,4,0,0,2,6,0,0,0,0,0,0,0,0,0,0,0,0,2,0,1,82980,33041,6595,44196,0
3,66,10,6,6,0,0,4,10,0,0,0,0,0,0,0,0,0,0,0,0,2,0,1,82980,33041,6595,44197,0
3,66,1,1,1,0,0,0,1,0,0,0,0,0,0,0,0,0,0,0,0,2,0,1,82980,33041,6595,44197,0
3,66,14,10,10,0,0,4,14,1,1,1,1,2,2,0,2,0,1,0,0,2,0,1,82980,33041,6595,44198,0
3,66,46,26,30,3,0,12,49,3,6,3,6,9,9,20,28,1,42,2,0,2,0,1,82990,33041,6595,44199,0
7,296,72,33,56,0,4,12,72,1,1,1,1,2,2,0,2,0,1,0,0,2,0,1,83010,33049,6597,44214,0
12,229,127,75,83,2,11,30,129,4,14,7,14,18,21,61,87,2,175,9,0,2,0,1,83010,33049,6597,44215,0
12,229,652,304,544,16,6,88,668,6,89,51,101,95,152,591,998,3,3399,188,0,2,0,1,83010,33050,6597,44216,0
12,229,2,2,2,0,0,0,2,0,0,0,0,0,0,0,0,0,0,0,0,2,0,1,83010,33050,6597,44216,0
12,229,8,5,5,0,0,3,8,0,0,0,0,0,0,0,0,0,0,0,0,2,0,1,83010,33050,6597,44217,0
12,229,2,2,2,0,0,0,2,0,0,0,0,0,0,0,0,0,0,0,0,2,0,1,83010,33050,6597,44217,0
12,229,14,8,8,0,0,6,14,0,0,0,0,0,0,0,0,0,0,0,0,2,0,1,83010,33050,6597,44218,0
12,229,6,4,4,0,0,2,6,0,0,0,0,0,0,0,0,0,0,0,0,2,0,1,83010,33050,6597,44219,0
12,229,6,4,4,0,0,2,6,1,2,1,2,3,3,2,4,0,2,0,0,2,0,1,83010,33050,6597,44220,0
12,229,6,4,4,0,0,2,6,0,0,0,0,0,0,0,0,0,0,0,0,2,0,1,83010,33050,6597,44221,0
12,229,7,5,5,0,0,2,7,0,0,0,0,0,0,0,0,0,0,0,0,2,0,1,83010,33050,6597,44222,0
12,229,6,4,4,0,0,2,6,0,0,0,0,0,0,0,0,0,0,0,0,2,0,1,83010,33050,6597,44223,0
12,229,10,6,6,0,0,4,10,0,0,0,0,0,0,0,0,0,0,0,0,2,0,1,83010,33050,6597,44224,0
12,229,1,1,1,0,0,0,1,0,0,0,0,0,0,0,0,0,0,0,0,2,0,1,83010,33050,6597,44224,0
12,229,14,10,10,0,0,4,14,1,1,1,1,2,2,0,2,0,1,0,0,2,0,1,83010,33050,6597,44225,0
12,229,46,26,30,3,0,12,49,3,6,3,6,9,9,20,28,1,42,2,0,2,0,1,83020,33050,6597,44226,0
6,71,127,75,83,2,11,30,129,4,14,7,14,18,21,61,87,2,175,9,0,2,0,1,83020,33050,6597,44227,0
6,71,652,304,544,16,6,88,668,6,89,51,101,95,152,591,998,3,3399,188,0,2,0,1,83020,33051,6597,44228,0
6,71,2,2,2,0,0,0,2,0,0,0,0,0,0,0,0,0,0,0,0,2,0,1,83020,33051,6597,44228,0
6,71,8,5,5,0,0,3,8,0,0,0,0,0,0,0,0,0,0,0,0,2,0,1,83020,33051,6597,44229,0
6,71,2,2,2,0,0,0,2,0,0,0,0,0,0,0,0,0,0,0,0,2,0,1,83020,33051,6597,44229,0
6,71,14,8,8,0,0,6,14,0,0,0,0,0,0,0,0,0,0,0,0,2,0,1,83020,33051,6597,44230,0
6,71,6,4,4,0,0,2,6,0,0,0,0,0,0,0,0,0,0,0,0,2,0,1,83020,33051,6597,44231,0
6,71,6,4,4,0,0,2,6,1,2,1,2,3,3,2,4,0,2,0,0,2,0,1,83020,33051,6597,44232,0
6,71,6,4,4,0,0,2,6,0,0,0,0,0,0,0,0,0,0,0,0,2,0,1,83020,33051,6597,44233,0
6,71,7,5,5,0,0,2,7,0,0,0,0,0,0,0,0,0,0,0,0,2,0,1,83020,33051,6597,44234,0
6,71,6,4,4,0,0,2,6,0,0,0,0,0,0,0,0,0,0,0,0,2,0,1,83020,33051,6597,44235,0
6,71,10,6,6,0,0,4,10,0,0,0,0,0,0,0,0,0,0,0,0,2,0,1,83020,33051,6597,44236,0
6,71,1,1,1,0,0,0,1,0,0,0,0,0,0,0,0,0,0,0,0,2,0,1,83020,33051,6597,44236,0
6,71,14,10,10,0,0,4,14,1,1,1,1,2,2,0,2,0,1,0,0,2,0,1,83020,33051,6597,44237,0
6,71,46,26,30,3,0,12,49,3,6,3,6,9,9,20,28,1,42,2,0,2,0,1,83030,33051,6597,44238,0
3,26,14,7,7,2,0,5,16,0,0,0,0,0,0,0,0,0,0,0,0,2,0,1,83030,33051,6597,44238,0
7,103,38,23,23,0,0,15,38,0,0,0,0,0,0,0,0,0,0,0,0,2,0,1,83030,33051,6597,44239,0
17,378,85,59,61,8,0,16,93,5,18,10,18,23,28,86,126,2,316,17,0,2,0,1,83030,33051,6597,44240,0
12,515,124,78,88,2,3,26,126,4,13,7,13,17,20,56,81,2,163,9,0,2,0,1,83030,33051,6597,44243,0
1,94,42,7,35,4,0,5,46,1,2,1,2,3,3,2,4,0,2,0,0,2,0,1,83030,33051,6597,44244,0
1,94,11,6,10,0,0,1,11,2,4,2,4,6,6,10,15,1,15,0,0,2,0,1,83030,33051,6597,44245,0
11,242,19,8,11,5,0,4,24,2,5,3,6,7,9,13,25,1,30,1,0,2,0,1,83040,33055,6598,44253,0
11,242,102,59,69,5,3,24,107,6,22,15,28,28,43,113,206,3,789,43,0,2,0,1,83040,33055,6598,44254,0
11,242,106,40,36,3,49,17,109,8,17,13,23,25,36,93,167,5,904,50,0,2,0,1,83040,33055,6598,44255,0
221,4758,182,127,129,0,0,53,182,5,39,21,42,44,63,217,343,2,926,51,0,2,0,1,83050,33059,6600,44263,0
221,4758,1165,710,800,67,119,181,1232,18,243,153,282,261,435,2000,3492,10,36473,2026,1,2,0,1,83060,33059,6601,44264,0
67,1570,773,419,590,28,0,166,801,10,204,113,217,214,330,1598,2554,5,13587,754,0,2,0,1,83060,33059,6602,44265,0
67,1570,421,273,302,44,34,57,465,17,81,59,107,98,166,583,1098,11,12329,684,0,2,0,1,83060,33059,6603,44266,0
14,411,149,95,105,2,0,41,151,8,54,28,55,62,83,334,494,4,2013,111,0,2,0,1,83060,33059,6603,44267,0
14,411,82,56,54,0,13,15,82,4,13,8,16,17,24,56,98,2,241,13,0,2,0,1,83070,33059,6603,44268,0
25,514,2,2,2,0,0,0,2,0,0,0,0,0,0,0,0,0,0,0,0,2,0,1,83070,33059,6603,44268,0
25,514,99,48,90,1,3,5,100,0,0,0,0,0,0,0,0,0,0,0,0,2,0,1,83070,33060,6603,44269,0
25,514,8,5,5,2,0,1,10,0,0,0,0,0,0,0,0,0,0,0,0,2,0,1,83070,33060,6603,44270,0
25,514,1217,716,841,84,126,174,1301,14,185,118,215,199,333,1446,2542,8,20687,1149,0,2,0,1,83080,33062,6603,44271,0
25,514,160,89,115,0,13,31,160,7,15,11,17,22,28,78,124,3,495,27,0,2,0,1,83080,33062,6603,44272,0
25,514,10,10,9,9,0,0,19,0,0,0,0,0,0,0,0,0,0,0,0,2,0,1,83080,33062,6604,44273,0
25,514,173,84,99,8,29,36,181,5,12,7,13,17,20,54,81,2,221,12,0,2,0,1,83080,33063,6604,44274,0
25,514,3,1,1,3,0,0,6,0,0,0,0,0,0,0,0,0,0,0,0,2,0,1,83080,33063,6604,44275,0
174,5298,1660,832,1314,41,38,274,1701,20,312,209,395,332,604,2671,5058,12,64042,3557,1,2,0,1,83080,33065,6605,44277,0
174,5298,1057,646,719,113,100,145,1170,18,215,134,248,233,382,1740,3004,10,31186,1732,1,2,0,1,83090,33066,6606,44278,0
17,348,95,58,50,9,16,20,104,12,33,24,45,45,69,209,378,8,3100,172,0,2,0,1,83090,33066,6606,44279,0
116,2173,477,336,357,30,23,73,507,16,194,134,250,210,384,1538,2962,10,30538,1696,0,2,0,1,83100,33067,6606,44280,0
90,2044,996,429,845,24,10,117,1020,7,76,50,88,83,138,494,879,4,3565,198,0,2,0,1,83100,33069,6606,44281,0
90,2044,456,277,329,12,42,72,468,13,85,50,97,98,147,592,972,7,7212,400,0,2,0,1,83100,33069,6606,44282,0
160,3459,1513,682,1277,25,13,200,1538,11,199,116,219,210,335,1557,2584,6,15641,868,0,2,0,1,83100,33071,6606,44283,0
160,3459,819,519,539,24,98,155,843,15,96,57,106,111,163,690,1107,8,9171,509,0,2,0,1,83110,33073,6606,44284,0
59,1120,207,111,150,11,0,50,218,5,26,19,36,31,55,133,272,3,943,52,0,2,0,1,83110,33073,6606,44285,0
59,1120,410,198,237,31,55,97,441,11,63,38,72,74,110,414,683,6,4293,238,0,2,0,1,83120,33074,6607,44286,0
235,4913,2,2,2,0,0,0,2,0,0,0,0,0,0,0,0,0,0,0,0,2,0,1,83120,33074,6607,44286,0
235,4913,99,48,90,1,3,5,100,0,0,0,0,0,0,0,0,0,0,0,0,2,0,1,83120,33075,6607,44287,0
235,4913,8,5,5,2,0,1,10,0,0,0,0,0,0,0,0,0,0,0,0,2,0,1,83120,33075,6607,44288,0
235,4913,1217,716,841,84,126,174,1301,14,185,118,215,199,333,1446,2542,8,20687,1149,0,2,0,1,83130,33077,6607,44289,0
235,4913,160,89,115,0,13,31,160,7,15,11,17,22,28,78,124,3,495,27,0,2,0,1,83130,33077,6607,44290,0
235,4913,10,10,9,9,0,0,19,0,0,0,0,0,0,0,0,0,0,0,0,2,0,1,83130,33077,6608,44291,0
235,4913,173,84,99,8,29,36,181,5,12,7,13,17,20,54,81,2,221,12,0,2,0,1,83130,33078,6608,44292,0
235,4913,3,1,1,3,0,0,6,0,0,0,0,0,0,0,0,0,0,0,0,2,0,1,83130,33078,6608,44293,0
98,2019,463,295,324,28,62,57,491,12,134,82,154,146,236,989,1696,6,11700,650,0,2,0,1,83140,33079,6608,44294,0
55,770,167,116,138,4,5,22,171,8,48,30,56,56,86,292,499,4,2330,129,0,2,0,1,83140,33079,6608,44295,0
57,1522,339,213,244,17,9,65,356,10,42,26,48,52,74,259,421,5,2410,133,0,2,0,1,83150,33079,6608,44296,0
90,2308,1455,414,1257,16,76,112,1471,5,41,23,46,46,69,231,381,2,1069,59,0,2,0,1,83150,33080,6608,44298,0
90,2308,669,365,481,22,61,110,691,15,103,63,122,118,185,747,1273,8,11311,628,0,2,0,1,83160,33080,6609,44299,0
251,5838,4293,999,3693,19,54,507,4312,9,155,88,170,164,258,1156,1898,4,9368,520,0,2,0,1,83160,33082,6609,44300,0
251,5838,1482,859,1002,125,135,219,1607,16,219,134,251,235,385,1766,3032,9,27804,1544,1,2,0,1,83170,33083,6609,44301,0
6,140,44,22,19,0,19,6,44,2,10,6,12,12,18,35,64,1,77,4,0,2,0,1,83170,33083,6609,44302,0
31,1087,74,35,59,1,0,14,75,3,14,7,14,17,21,58,85,1,128,7,0,2,0,1,83170,33084,6609,44303,0
31,1087,245,125,200,5,7,34,250,7,30,17,34,37,51,166,265,3,1053,58,0,2,0,1,83180,33085,6609,44304,0
54,657,647,139,84,35,284,233,682,0,0,0,0,0,0,0,0,0,0,0,0,2,0,1,83180,33085,6609,44305,0
117,3160,1523,757,1297,19,12,193,1542,12,193,117,230,205,347,1508,2664,7,19053,1058,0,2,0,1,83190,33087,6609,44306,0
117,3160,701,378,504,33,58,109,734,13,110,68,126,123,194,794,1346,7,10027,557,0,2,0,1,83190,33088,6610,44307,0
105,2779,773,422,505,30,103,129,803,14,77,46,83,91,129,535,839,7,6334,351,0,2,0,1,83200,33089,6611,44308,0
149,3603,77,34,69,0,0,8,77,3,24,16,29,27,45,114,213,1,387,21,0,2,0,1,83200,33089,6611,44309,0
149,3603,712,438,573,51,9,84,763,14,102,71,128,116,199,733,1364,8,11988,666,0,2,0,1,83210,33090,6611,44310,0
24,612,2,2,2,0,0,0,2,0,0,0,0,0,0,0,0,0,0,0,0,2,0,1,83210,33090,6611,44310,0
24,612,99,48,90,1,3,5,100,0,0,0,0,0,0,0,0,0,0,0,0,2,0,1,83210,33091,6611,44311,0
24,612,8,5,5,2,0,1,10,0,0,0,0,0,0,0,0,0,0,0,0,2,0,1,83210,33091,6611,44312,0
24,612,1217,716,841,84,126,174,1301,14,185,118,215,199,333,1446,2542,8,20687,1149,0,2,0,1,83220,33093,6611,44313,0
24,612,160,89,115,0,13,31,160,7,15,11,17,22,28,78,124,3,495,27,0,2,0,1,83220,33093,6611,44314,0
24,612,10,10,9,9,0,0,19,0,0,0,0,0,0,0,0,0,0,0,0,2,0,1,83220,33093,6612,44315,0
24,612,173,84,99,8,29,36,181,5,12,7,13,17,20,54,81,2,221,12,0,2,0,1,83220,33094,6612,44316,0
24,612,3,1,1,3,0,0,6,0,0,0,0,0,0,0,0,0,0,0,0,2,0,1,83220,33094,6612,44317,0
30,664,125,97,103,3,0,19,128,9,25,17,27,34,44,144,223,4,1087,60,0,2,0,1,83220,33094,6613,44318,0
22,373,102,57,55,5,16,25,107,5,17,10,18,22,28,81,124,2,330,18,0,2,0,1,83220,33094,6613,44319,0
71,1576,402,202,227,24,74,80,426,12,52,33,61,64,94,339,564,7,3969,220,0,2,0,1,83220,33095,6613,44320,0
51,1113,447,308,343,6,5,95,453,7,96,59,111,103,170,651,1136,4,4600,255,0,2,0,1,83220,33098,6613,44321,0
51,1113,322,174,179,16,74,51,338,10,41,26,46,51,72,252,408,5,2291,127,0,2,0,1,83220,33101,6614,44322,0
75,1629,53,23,39,0,0,13,53,2,8,4,8,10,12,26,39,1,39,2,0,2,0,1,83220,33101,6614,44323,0
75,1629,515,298,307,33,80,99,548,12,63,44,77,75,121,419,753,7,5527,307,0,2,0,1,83230,33101,6614,44324,0
18,312,424,94,331,4,0,89,428,1,5,5,5,6,10,11,25,0,12,0,0,2,0,1,83230,33102,6614,44325,0
18,312,38,23,23,6,0,8,44,3,11,7,11,14,18,42,68,1,102,5,0,2,0,1,83230,33102,6614,44326,0
19,513,205,80,86,16,53,53,221,7,18,10,19,25,29,94,134,3,497,27,0,2,0,1,83240,33102,6615,44327,0
15,490,184,100,137,2,15,30,186,6,38,20,39,44,59,214,322,3,991,55,0,2,0,1,83240,33103,6615,44328,0
15,490,103,65,74,8,5,16,111,7,17,9,17,24,26,89,119,3,417,23,0,2,0,1,83240,33104,6615,44329,0
58,1203,91,45,69,0,3,18,91,3,9,6,10,12,16,33,57,1,95,5,0,2,0,1,83240,33106,6615,44330,0
58,1203,367,234,237,17,34,68,384,16,55,34,61,71,95,381,584,8,5183,287,0,2,0,1,83240,33107,6615,44331,0
228,5903,722,423,573,19,0,135,741,12,172,101,199,184,300,1320,2257,6,15668,870,0,2,0,1,83240,33109,6615,44333,0
228,5903,1508,847,911,44,250,301,1552,14,148,88,169,162,257,1120,1886,7,15077,837,0,2,0,1,83240,33110,6616,44334,0
315,6914,72,33,56,0,4,12,72,1,1,1,1,2,2,0,2,0,1,0,0,2,0,1,83240,33110,6616,44335,0
315,6914,1454,835,1044,76,110,219,1530,17,275,158,296,292,454,2297,3718,9,34017,1889,1,2,0,1,83250,33111,6616,44336,0
89,1819,757,253,292,73,244,162,830,13,61,38,67,74,105,409,651,7,4654,258,0,2,0,1,83250,33112,6616,44337,0
38,814,386,256,301,16,9,68,402,4,59,35,69,63,104,355,621,2,1453,80,0,2,0,1,83250,33112,6616,44338,0
38,814,264,131,164,11,41,46,275,6,38,22,40,44,62,214,338,3,1068,59,0,2,0,1,83260,33112,6617,44339,0
67,1753,466,257,367,18,25,50,484,7,126,86,171,133,257,898,1813,4,8612,478,0,2,0,1,83260,33112,6617,44340,0
67,1753,507,281,342,29,59,88,536,10,53,29,57,63,86,336,514,5,2764,153,0,2,0,1,83260,33112,6617,44341,0
25,552,215,129,180,6,0,29,221,8,65,43,72,73,115,415,711,4,3153,175,0,2,0,1,83260,33112,6617,44342,0
25,552,97,69,77,3,3,16,100,6,22,13,23,28,36,113,173,3,542,30,0,2,0,1,83260,33113,6617,44343,0
89,1894,1043,504,840,53,9,147,1096,9,180,112,198,189,310,1377,2344,4,11604,644,0,2,0,1,83260,33115,6617,44344,0
89,1894,383,288,292,26,6,62,409,11,65,38,67,76,105,429,656,5,3719,206,0,2,0,1,83260,33116,6617,44345,0
20,420,294,64,250,0,0,43,294,1,20,10,20,21,30,86,131,0,65,3,0,2,0,1,83260,33116,6617,44346,0
20,420,78,46,62,3,0,14,81,3,8,4,8,11,12,28,41,1,62,3,0,2,0,1,83260,33117,6617,44347,0
5,123,110,30,77,3,13,16,113,4,21,15,30,25,45,100,208,2,597,33,0,2,0,1,83260,33117,6617,44348,0
5,123,28,15,21,1,0,6,29,0,0,0,0,0,0,0,0,0,0,0,0,2,0,1,83260,33117,6617,44349,0
40,796,1178,367,1042,6,15,115,1184,9,94,51,95,103,146,644,976,4,4439,246,0,2,0,1,83260,33117,6617,44350,0
40,796,177,108,140,8,0,27,185,6,30,16,32,36,48,162,248,3,794,44,0,2,0,1,83260,33119,6617,44351,0
28,452,219,78,157,11,5,46,230,3,24,20,34,27,54,114,256,2,545,30,0,2,0,1,83260,33120,6617,44352,0
28,452,108,64,79,9,0,20,117,5,15,11,19,20,30,70,129,3,410,22,0,2,0,1,83260,33120,6617,44353,0
280,5888,1943,715,1694,26,18,214,1969,12,185,120,237,197,357,1436,2721,7,20915,1161,0,2,0,1,83260,33122,6617,44354,0
280,5888,1168,838,957,57,25,144,1225,19,348,224,416,367,640,3018,5452,11,61921,3440,1,2,0,1,83270,33124,6617,44355,0
19,717,442,244,305,14,16,103,456,11,68,45,75,79,120,452,756,6,4588,254,0,2,0,1,83270,33126,6617,44356,0
19,717,182,102,99,11,40,35,193,3,11,6,11,14,17,42,64,1,97,5,0,2,0,1,83270,33127,6617,44357,0
65,1263,1098,241,925,5,10,155,1103,7,46,25,49,53,74,273,423,3,1580,87,0,2,0,1,83280,33129,6617,44358,0
65,1263,282,202,222,14,2,44,296,8,42,24,43,50,67,250,378,4,1548,86,0,2,0,1,83280,33130,6617,44359,0
2,156,37,13,25,0,6,6,37,1,2,1,2,3,3,2,4,0,2,0,0,2,0,1,83280,33130,6617,44360,0
2,156,133,47,40,1,43,49,134,0,0,0,0,0,0,0,0,0,0,0,0,2,0,1,83280,33130,6617,44361,0
23,642,601,196,481,2,23,85,603,8,63,36,72,71,108,400,664,4,3036,168,0,2,0,1,83280,33130,6617,44362,0
23,642,156,79,106,5,16,28,161,5,14,8,15,19,23,64,97,2,261,14,0,2,0,1,83280,33130,6617,44363,0
104,4436,1289,550,1043,56,32,155,1345,10,167,93,185,177,278,1266,2075,5,11498,638,0,2,0,1,83280,33132,6618,44364,0
31,994,182,127,129,0,0,53,182,5,39,21,42,44,63,217,343,2,926,51,0,2,0,1,83280,33132,6619,44365,0
151,7251,1392,870,1177,35,17,170,1427,14,494,280,531,508,811,4473,7289,7,54850,3047,2,2,0,1,83280,33135,6620,44366,0
95,2896,773,419,590,28,0,166,801,10,204,113,217,214,330,1598,2554,5,13587,754,0,2,0,1,83280,33135,6621,44367,0
6,163,127,75,83,2,11,30,129,4,14,7,14,18,21,61,87,2,175,9,0,2,0,1,83280,33135,6621,44368,0
6,163,652,304,544,16,6,88,668,6,89,51,101,95,152,591,998,3,3399,188,0,2,0,1,83280,33136,6621,44369,0
6,163,2,2,2,0,0,0,2,0,0,0,0,0,0,0,0,0,0,0,0,2,0,1,83280,33136,6621,44369,0
6,163,8,5,5,0,0,3,8,0,0,0,0,0,0,0,0,0,0,0,0,2,0,1,83280,33136,6621,44370,0
6,163,2,2,2,0,0,0,2,0,0,0,0,0,0,0,0,0,0,0,0,2,0,1,83280,33136,6621,44370,0
6,163,14,8,8,0,0,6,14,0,0,0,0,0,0,0,0,0,0,0,0,2,0,1,83280,33136,6621,44371,0
6,163,6,4,4,0,0,2,6,0,0,0,0,0,0,0,0,0,0,0,0,2,0,1,83280,33136,6621,44372,0
6,163,6,4,4,0,0,2,6,1,2,1,2,3,3,2,4,0,2,0,0,2,0,1,83280,33136,6621,44373,0
6,163,6,4,4,0,0,2,6,0,0,0,0,0,0,0,0,0,0,0,0,2,0,1,83280,33136,6621,44374,0
6,163,7,5,5,0,0,2,7,0,0,0,0,0,0,0,0,0,0,0,0,2,0,1,83280,33136,6621,44375,0
6,163,6,4,4,0,0,2,6,0,0,0,0,0,0,0,0,0,0,0,0,2,0,1,83280,33136,6621,44376,0
6,163,10,6,6,0,0,4,10,0,0,0,0,0,0,0,0,0,0,0,0,2,0,1,83280,33136,6621,44377,0
6,163,1,1,1,0,0,0,1,0,0,0,0,0,0,0,0,0,0,0,0,2,0,1,83280,33136,6621,44377,0
6,163,14,10,10,0,0,4,14,1,1,1,1,2,2,0,2,0,1,0,0,2,0,1,83280,33136,6621,44378,0
6,163,46,26,30,3,0,12,49,3,6,3,6,9,9,20,28,1,42,2,0,2,0,1,83290,33136,6621,44379,0
14,845,75,38,59,1,3,12,76,2,4,2,4,6,6,10,15,1,15,0,0,2,0,1,83290,33136,6621,44380,0
2,58,16,12,9,0,0,6,16,1,2,1,2,3,3,2,4,0,2,0,0,2,0,1,83290,33136,6621,44381,0
1,6,2,2,2,0,0,0,2,0,0,0,0,0,0,0,0,0,0,0,0,2,0,1,83290,33136,6621,44381,0
1,6,99,48,90,1,3,5,100,0,0,0,0,0,0,0,0,0,0,0,0,2,0,1,83290,33137,6621,44382,0
1,6,8,5,5,2,0,1,10,0,0,0,0,0,0,0,0,0,0,0,0,2,0,1,83290,33137,6621,44383,0
1,6,1217,716,841,84,126,174,1301,14,185,118,215,199,333,1446,2542,8,20687,1149,0,2,0,1,83300,33139,6621,44384,0
1,6,160,89,115,0,13,31,160,7,15,11,17,22,28,78,124,3,495,27,0,2,0,1,83300,33139,6621,44385,0
1,6,10,10,9,9,0,0,19,0,0,0,0,0,0,0,0,0,0,0,0,2,0,1,83300,33139,6622,44386,0
1,6,173,84,99,8,29,36,181,5,12,7,13,17,20,54,81,2,221,12,0,2,0,1,83300,33140,6622,44387,0
1,6,3,1,1,3,0,0,6,0,0,0,0,0,0,0,0,0,0,0,0,2,0,1,83300,33140,6622,44388,0
1,6,2,2,2,0,0,0,2,0,0,0,0,0,0,0,0,0,0,0,0,2,0,1,83300,33140,6622,44388,0
1,8,127,75,83,2,11,30,129,4,14,7,14,18,21,61,87,2,175,9,0,2,0,1,83300,33140,6622,44389,0
1,8,652,304,544,16,6,88,668,6,89,51,101,95,152,591,998,3,3399,188,0,2,0,1,83300,33141,6622,44390,0
1,8,2,2,2,0,0,0,2,0,0,0,0,0,0,0,0,0,0,0,0,2,0,1,83300,33141,6622,44390,0
1,8,8,5,5,0,0,3,8,0,0,0,0,0,0,0,0,0,0,0,0,2,0,1,83300,33141,6622,44391,0
1,8,2,2,2,0,0,0,2,0,0,0,0,0,0,0,0,0,0,0,0,2,0,1,83300,33141,6622,44391,0
1,8,14,8,8,0,0,6,14,0,0,0,0,0,0,0,0,0,0,0,0,2,0,1,83300,33141,6622,44392,0
1,8,6,4,4,0,0,2,6,0,0,0,0,0,0,0,0,0,0,0,0,2,0,1,83300,33141,6622,44393,0
1,8,6,4,4,0,0,2,6,1,2,1,2,3,3,2,4,0,2,0,0,2,0,1,83300,33141,6622,44394,0
1,8,6,4,4,0,0,2,6,0,0,0,0,0,0,0,0,0,0,0,0,2,0,1,83300,33141,6622,44395,0
1,8,7,5,5,0,0,2,7,0,0,0,0,0,0,0,0,0,0,0,0,2,0,1,83300,33141,6622,44396,0
1,8,6,4,4,0,0,2,6,0,0,0,0,0,0,0,0,0,0,0,0,2,0,1,83300,33141,6622,44397,0
1,8,10,6,6,0,0,4,10,0,0,0,0,0,0,0,0,0,0,0,0,2,0,1,83300,33141,6622,44398,0
1,8,1,1,1,0,0,0,1,0,0,0,0,0,0,0,0,0,0,0,0,2,0,1,83300,33141,6622,44398,0
1,8,14,10,10,0,0,4,14,1,1,1,1,2,2,0,2,0,1,0,0,2,0,1,83300,33141,6622,44399,0
1,8,46,26,30,3,0,12,49,3,6,3,6,9,9,20,28,1,42,2,0,2,0,1,83310,33141,6622,44400,0
1,6,2,2,2,0,0,0,2,0,0,0,0,0,0,0,0,0,0,0,0,2,0,1,83310,33141,6622,44400,0
1,6,2,2,2,0,0,0,2,0,0,0,0,0,0,0,0,0,0,0,0,2,0,1,83320,33142,6622,44412,0
2,25,127,75,83,2,11,30,129,4,14,7,14,18,21,61,87,2,175,9,0,2,0,1,83320,33142,6622,44413,0
2,25,652,304,544,16,6,88,668,6,89,51,101,95,152,591,998,3,3399,188,0,2,0,1,83320,33143,6622,44414,0
2,25,2,2,2,0,0,0,2,0,0,0,0,0,0,0,0,0,0,0,0,2,0,1,83320,33143,6622,44414,0
2,25,8,5,5,0,0,3,8,0,0,0,0,0,0,0,0,0,0,0,0,2,0,1,83320,33143,6622,44415,0
2,25,2,2,2,0,0,0,2,0,0,0,0,0,0,0,0,0,0,0,0,2,0,1,83320,33143,6622,44415,0
2,25,14,8,8,0,0,6,14,0,0,0,0,0,0,0,0,0,0,0,0,2,0,1,83320,33143,6622,44416,0
2,25,6,4,4,0,0,2,6,0,0,0,0,0,0,0,0,0,0,0,0,2,0,1,83320,33143,6622,44417,0
2,25,6,4,4,0,0,2,6,1,2,1,2,3,3,2,4,0,2,0,0,2,0,1,83320,33143,6622,44418,0
2,25,6,4,4,0,0,2,6,0,0,0,0,0,0,0,0,0,0,0,0,2,0,1,83320,33143,6622,44419,0
2,25,7,5,5,0,0,2,7,0,0,0,0,0,0,0,0,0,0,0,0,2,0,1,83320,33143,6622,44420,0
2,25,6,4,4,0,0,2,6,0,0,0,0,0,0,0,0,0,0,0,0,2,0,1,83320,33143,6622,44421,0
2,25,10,6,6,0,0,4,10,0,0,0,0,0,0,0,0,0,0,0,0,2,0,1,83320,33143,6622,44422,0
2,25,1,1,1,0,0,0,1,0,0,0,0,0,0,0,0,0,0,0,0,2,0,1,83320,33143,6622,44422,0
2,25,14,10,10,0,0,4,14,1,1,1,1,2,2,0,2,0,1,0,0,2,0,1,83320,33143,6622,44423,0
2,25,46,26,30,3,0,12,49,3,6,3,6,9,9,20,28,1,42,2,0,2,0,1,83330,33143,6622,44424,0
1,55,14,12,10,0,0,4,14,1,2,1,2,3,3,2,4,0,2,0,0,2,0,1,83330,33143,6622,44425,0
1,58,14,12,10,0,0,4,14,1,2,1,2,3,3,2,4,0,2,0,0,2,0,1,83330,33143,6622,44426,0
1,55,14,12,10,0,0,4,14,1,2,1,2,3,3,2,4,0,2,0,0,2,0,1,83330,33143,6622,44427,0
1,77,19,18,14,0,0,5,19,1,2,1,2,3,3,2,4,0,2,0,0,2,0,1,83330,33143,6622,44428,0
2,18,10,6,6,0,0,4,10,0,0,0,0,0,0,0,0,0,0,0,0,2,0,1,83330,33143,6622,44429,0
2,36,127,75,83,2,11,30,129,4,14,7,14,18,21,61,87,2,175,9,0,2,0,1,83330,33143,6622,44430,0
2,36,652,304,544,16,6,88,668,6,89,51,101,95,152,591,998,3,3399,188,0,2,0,1,83330,33144,6622,44431,0
2,36,2,2,2,0,0,0,2,0,0,0,0,0,0,0,0,0,0,0,0,2,0,1,83330,33144,6622,44431,0
2,36,8,5,5,0,0,3,8,0,0,0,0,0,0,0,0,0,0,0,0,2,0,1,83330,33144,6622,44432,0
2,36,2,2,2,0,0,0,2,0,0,0,0,0,0,0,0,0,0,0,0,2,0,1,83330,33144,6622,44432,0
2,36,14,8,8,0,0,6,14,0,0,0,0,0,0,0,0,0,0,0,0,2,0,1,83330,33144,6622,44433,0
2,36,6,4,4,0,0,2,6,0,0,0,0,0,0,0,0,0,0,0,0,2,0,1,83330,33144,6622,44434,0
2,36,6,4,4,0,0,2,6,1,2,1,2,3,3,2,4,0,2,0,0,2,0,1,83330,33144,6622,44435,0
2,36,6,4,4,0,0,2,6,0,0,0,0,0,0,0,0,0,0,0,0,2,0,1,83330,33144,6622,44436,0
2,36,7,5,5,0,0,2,7,0,0,0,0,0,0,0,0,0,0,0,0,2,0,1,83330,33144,6622,44437,0
2,36,6,4,4,0,0,2,6,0,0,0,0,0,0,0,0,0,0,0,0,2,0,1,83330,33144,6622,44438,0
2,36,10,6,6,0,0,4,10,0,0,0,0,0,0,0,0,0,0,0,0,2,0,1,83330,33144,6622,44439,0
2,36,1,1,1,0,0,0,1,0,0,0,0,0,0,0,0,0,0,0,0,2,0,1,83330,33144,6622,44439,0
2,36,14,10,10,0,0,4,14,1,1,1,1,2,2,0,2,0,1,0,0,2,0,1,83330,33144,6622,44440,0
2,36,46,26,30,3,0,12,49,3,6,3,6,9,9,20,28,1,42,2,0,2,0,1,83340,33144,6622,44441,0
1,6,2,2,2,0,0,0,2,0,0,0,0,0,0,0,0,0,0,0,0,2,0,1,83340,33144,6622,44441,0
1,26,127,75,83,2,11,30,129,4,14,7,14,18,21,61,87,2,175,9,0,2,0,1,83340,33144,6622,44442,0
1,26,652,304,544,16,6,88,668,6,89,51,101,95,152,591,998,3,3399,188,0,2,0,1,83340,33145,6622,44443,0
1,26,2,2,2,0,0,0,2,0,0,0,0,0,0,0,0,0,0,0,0,2,0,1,83340,33145,6622,44443,0
1,26,8,5,5,0,0,3,8,0,0,0,0,0,0,0,0,0,0,0,0,2,0,1,83340,33145,6622,44444,0
1,26,2,2,2,0,0,0,2,0,0,0,0,0,0,0,0,0,0,0,0,2,0,1,83340,33145,6622,44444,0
1,26,14,8,8,0,0,6,14,0,0,0,0,0,0,0,0,0,0,0,0,2,0,1,83340,33145,6622,44445,0
1,26,6,4,4,0,0,2,6,0,0,0,0,0,0,0,0,0,0,0,0,2,0,1,83340,33145,6622,44446,0
1,26,6,4,4,0,0,2,6,1,2,1,2,3,3,2,4,0,2,0,0,2,0,1,83340,33145,6622,44447,0
1,26,6,4,4,0,0,2,6,0,0,0,0,0,0,0,0,0,0,0,0,2,0,1,83340,33145,6622,44448,0
1,26,7,5,5,0,0,2,7,0,0,0,0,0,0,0,0,0,0,0,0,2,0,1,83340,33145,6622,44449,0
1,26,6,4,4,0,0,2,6,0,0,0,0,0,0,0,0,0,0,0,0,2,0,1,83340,33145,6622,44450,0
1,26,10,6,6,0,0,4,10,0,0,0,0,0,0,0,0,0,0,0,0,2,0,1,83340,33145,6622,44451,0
1,26,1,1,1,0,0,0,1,0,0,0,0,0,0,0,0,0,0,0,0,2,0,1,83340,33145,6622,44451,0
1,26,14,10,10,0,0,4,14,1,1,1,1,2,2,0,2,0,1,0,0,2,0,1,83340,33145,6622,44452,0
1,26,46,26,30,3,0,12,49,3,6,3,6,9,9,20,28,1,42,2,0,2,0,1,83350,33145,6622,44453,0
1,7,2,2,2,0,0,0,2,0,0,0,0,0,0,0,0,0,0,0,0,2,0,1,83350,33145,6622,44453,0
1,24,127,75,83,2,11,30,129,4,14,7,14,18,21,61,87,2,175,9,0,2,0,1,83350,33145,6622,44454,0
1,24,652,304,544,16,6,88,668,6,89,51,101,95,152,591,998,3,3399,188,0,2,0,1,83350,33146,6622,44455,0
1,24,2,2,2,0,0,0,2,0,0,0,0,0,0,0,0,0,0,0,0,2,0,1,83350,33146,6622,44455,0
1,24,8,5,5,0,0,3,8,0,0,0,0,0,0,0,0,0,0,0,0,2,0,1,83350,33146,6622,44456,0
1,24,2,2,2,0,0,0,2,0,0,0,0,0,0,0,0,0,0,0,0,2,0,1,83350,33146,6622,44456,0
1,24,14,8,8,0,0,6,14,0,0,0,0,0,0,0,0,0,0,0,0,2,0,1,83350,33146,6622,44457,0
1,24,6,4,4,0,0,2,6,0,0,0,0,0,0,0,0,0,0,0,0,2,0,1,83350,33146,6622,44458,0
1,24,6,4,4,0,0,2,6,1,2,1,2,3,3,2,4,0,2,0,0,2,0,1,83350,33146,6622,44459,0
1,24,6,4,4,0,0,2,6,0,0,0,0,0,0,0,0,0,0,0,0,2,0,1,83350,33146,6622,44460,0
1,24,7,5,5,0,0,2,7,0,0,0,0,0,0,0,0,0,0,0,0,2,0,1,83350,33146,6622,44461,0
1,24,6,4,4,0,0,2,6,0,0,0,0,0,0,0,0,0,0,0,0,2,0,1,83350,33146,6622,44462,0
1,24,10,6,6,0,0,4,10,0,0,0,0,0,0,0,0,0,0,0,0,2,0,1,83350,33146,6622,44463,0
1,24,1,1,1,0,0,0,1,0,0,0,0,0,0,0,0,0,0,0,0,2,0,1,83350,33146,6622,44463,0
1,24,14,10,10,0,0,4,14,1,1,1,1,2,2,0,2,0,1,0,0,2,0,1,83350,33146,6622,44464,0
1,24,46,26,30,3,0,12,49,3,6,3,6,9,9,20,28,1,42,2,0,2,0,1,83360,33146,6622,44465,0
1,7,2,2,2,0,0,0,2,0,0,0,0,0,0,0,0,0,0,0,0,2,0,1,83360,33146,6622,44465,0
3,33,15,9,9,0,0,6,15,0,0,0,0,0,0,0,0,0,0,0,0,2,0,1,83360,33146,6622,44466,0
1,13,127,75,83,2,11,30,129,4,14,7,14,18,21,61,87,2,175,9,0,2,0,1,83360,33146,6622,44467,0
1,13,652,304,544,16,6,88,668,6,89,51,101,95,152,591,998,3,3399,188,0,2,0,1,83360,33147,6622,44468,0
1,13,2,2,2,0,0,0,2,0,0,0,0,0,0,0,0,0,0,0,0,2,0,1,83360,33147,6622,44468,0
1,13,8,5,5,0,0,3,8,0,0,0,0,0,0,0,0,0,0,0,0,2,0,1,83360,33147,6622,44469,0
1,13,2,2,2,0,0,0,2,0,0,0,0,0,0,0,0,0,0,0,0,2,0,1,83360,33147,6622,44469,0
1,13,14,8,8,0,0,6,14,0,0,0,0,0,0,0,0,0,0,0,0,2,0,1,83360,33147,6622,44470,0
1,13,6,4,4,0,0,2,6,0,0,0,0,0,0,0,0,0,0,0,0,2,0,1,83360,33147,6622,44471,0
1,13,6,4,4,0,0,2,6,1,2,1,2,3,3,2,4,0,2,0,0,2,0,1,83360,33147,6622,44472,0
1,13,6,4,4,0,0,2,6,0,0,0,0,0,0,0,0,0,0,0,0,2,0,1,83360,33147,6622,44473,0
1,13,7,5,5,0,0,2,7,0,0,0,0,0,0,0,0,0,0,0,0,2,0,1,83360,33147,6622,44474,0
1,13,6,4,4,0,0,2,6,0,0,0,0,0,0,0,0,0,0,0,0,2,0,1,83360,33147,6622,44475,0
1,13,10,6,6,0,0,4,10,0,0,0,0,0,0,0,0,0,0,0,0,2,0,1,83360,33147,6622,44476,0
1,13,1,1,1,0,0,0,1,0,0,0,0,0,0,0,0,0,0,0,0,2,0,1,83360,33147,6622,44476,0
1,13,14,10,10,0,0,4,14,1,1,1,1,2,2,0,2,0,1,0,0,2,0,1,83360,33147,6622,44477,0
1,13,46,26,30,3,0,12,49,3,6,3,6,9,9,20,28,1,42,2,0,2,0,1,83370,33147,6622,44478,0
1,16,127,75,83,2,11,30,129,4,14,7,14,18,21,61,87,2,175,9,0,2,0,1,83370,33147,6622,44479,0
1,16,652,304,544,16,6,88,668,6,89,51,101,95,152,591,998,3,3399,188,0,2,0,1,83370,33148,6622,44480,0
1,16,2,2,2,0,0,0,2,0,0,0,0,0,0,0,0,0,0,0,0,2,0,1,83370,33148,6622,44480,0
1,16,8,5,5,0,0,3,8,0,0,0,0,0,0,0,0,0,0,0,0,2,0,1,83370,33148,6622,44481,0
1,16,2,2,2,0,0,0,2,0,0,0,0,0,0,0,0,0,0,0,0,2,0,1,83370,33148,6622,44481,0
1,16,14,8,8,0,0,6,14,0,0,0,0,0,0,0,0,0,0,0,0,2,0,1,83370,33148,6622,44482,0
1,16,6,4,4,0,0,2,6,0,0,0,0,0,0,0,0,0,0,0,0,2,0,1,83370,33148,6622,44483,0
1,16,6,4,4,0,0,2,6,1,2,1,2,3,3,2,4,0,2,0,0,2,0,1,83370,33148,6622,44484,0
1,16,6,4,4,0,0,2,6,0,0,0,0,0,0,0,0,0,0,0,0,2,0,1,83370,33148,6622,44485,0
1,16,7,5,5,0,0,2,7,0,0,0,0,0,0,0,0,0,0,0,0,2,0,1,83370,33148,6622,44486,0
1,16,6,4,4,0,0,2,6,0,0,0,0,0,0,0,0,0,0,0,0,2,0,1,83370,33148,6622,44487,0
1,16,10,6,6,0,0,4,10,0,0,0,0,0,0,0,0,0,0,0,0,2,0,1,83370,33148,6622,44488,0
1,16,1,1,1,0,0,0,1,0,0,0,0,0,0,0,0,0,0,0,0,2,0,1,83370,33148,6622,44488,0
1,16,14,10,10,0,0,4,14,1,1,1,1,2,2,0,2,0,1,0,0,2,0,1,83370,33148,6622,44489,0
1,16,46,26,30,3,0,12,49,3,6,3,6,9,9,20,28,1,42,2,0,2,0,1,83380,33148,6622,44490,0
1,10,2,2,2,0,0,0,2,1,2,1,2,3,3,2,4,0,2,0,0,2,0,1,83380,33148,6622,44490,0
1,13,127,75,83,2,11,30,129,4,14,7,14,18,21,61,87,2,175,9,0,2,0,1,83380,33148,6622,44491,0
1,13,652,304,544,16,6,88,668,6,89,51,101,95,152,591,998,3,3399,188,0,2,0,1,83380,33149,6622,44492,0
1,13,2,2,2,0,0,0,2,0,0,0,0,0,0,0,0,0,0,0,0,2,0,1,83380,33149,6622,44492,0
1,13,8,5,5,0,0,3,8,0,0,0,0,0,0,0,0,0,0,0,0,2,0,1,83380,33149,6622,44493,0
1,13,2,2,2,0,0,0,2,0,0,0,0,0,0,0,0,0,0,0,0,2,0,1,83380,33149,6622,44493,0
1,13,14,8,8,0,0,6,14,0,0,0,0,0,0,0,0,0,0,0,0,2,0,1,83380,33149,6622,44494,0
1,13,6,4,4,0,0,2,6,0,0,0,0,0,0,0,0,0,0,0,0,2,0,1,83380,33149,6622,44495,0
1,13,6,4,4,0,0,2,6,1,2,1,2,3,3,2,4,0,2,0,0,2,0,1,83380,33149,6622,44496,0
1,13,6,4,4,0,0,2,6,0,0,0,0,0,0,0,0,0,0,0,0,2,0,1,83380,33149,6622,44497,0
1,13,7,5,5,0,0,2,7,0,0,0,0,0,0,0,0,0,0,0,0,2,0,1,83380,33149,6622,44498,0
1,13,6,4,4,0,0,2,6,0,0,0,0,0,0,0,0,0,0,0,0,2,0,1,83380,33149,6622,44499,0
1,13,10,6,6,0,0,4,10,0,0,0,0,0,0,0,0,0,0,0,0,2,0,1,83380,33149,6622,44500,0
1,13,1,1,1,0,0,0,1,0,0,0,0,0,0,0,0,0,0,0,0,2,0,1,83380,33149,6622,44500,0
1,13,14,10,10,0,0,4,14,1,1,1,1,2,2,0,2,0,1,0,0,2,0,1,83380,33149,6622,44501,0
1,13,46,26,30,3,0,12,49,3,6,3,6,9,9,20,28,1,42,2,0,2,0,1,83390,33149,6622,44502,0
2,26,10,6,6,0,0,4,10,2,4,2,4,6,6,10,15,1,15,0,0,2,0,1,83390,33149,6622,44503,0
3,47,15,10,10,0,0,5,15,2,4,2,4,6,6,10,15,1,15,0,0,2,0,1,83390,33149,6622,44504,0
3,39,15,9,9,0,0,6,15,0,0,0,0,0,0,0,0,0,0,0,0,2,0,1,83390,33149,6622,44505,0
2,36,10,7,7,0,0,3,10,1,2,1,2,3,3,2,4,0,2,0,0,2,0,1,83390,33149,6622,44506,0
3,46,15,9,9,0,0,6,15,1,4,2,4,5,6,8,13,0,6,0,0,2,0,1,83390,33149,6622,44507,0
2,21,10,6,6,0,0,4,10,0,0,0,0,0,0,0,0,0,0,0,0,2,0,1,83390,33149,6622,44508,0
4,61,20,12,12,0,0,8,20,1,2,1,2,3,3,2,4,0,2,0,0,2,0,1,83390,33149,6622,44509,0
2,51,127,75,83,2,11,30,129,4,14,7,14,18,21,61,87,2,175,9,0,2,0,1,83390,33149,6622,44510,0
2,51,652,304,544,16,6,88,668,6,89,51,101,95,152,591,998,3,3399,188,0,2,0,1,83390,33150,6622,44511,0
2,51,2,2,2,0,0,0,2,0,0,0,0,0,0,0,0,0,0,0,0,2,0,1,83390,33150,6622,44511,0
2,51,8,5,5,0,0,3,8,0,0,0,0,0,0,0,0,0,0,0,0,2,0,1,83390,33150,6622,44512,0
2,51,2,2,2,0,0,0,2,0,0,0,0,0,0,0,0,0,0,0,0,2,0,1,83390,33150,6622,44512,0
2,51,14,8,8,0,0,6,14,0,0,0,0,0,0,0,0,0,0,0,0,2,0,1,83390,33150,6622,44513,0
2,51,6,4,4,0,0,2,6,0,0,0,0,0,0,0,0,0,0,0,0,2,0,1,83390,33150,6622,44514,0
2,51,6,4,4,0,0,2,6,1,2,1,2,3,3,2,4,0,2,0,0,2,0,1,83390,33150,6622,44515,0
2,51,6,4,4,0,0,2,6,0,0,0,0,0,0,0,0,0,0,0,0,2,0,1,83390,33150,6622,44516,0
2,51,7,5,5,0,0,2,7,0,0,0,0,0,0,0,0,0,0,0,0,2,0,1,83390,33150,6622,44517,0
2,51,6,4,4,0,0,2,6,0,0,0,0,0,0,0,0,0,0,0,0,2,0,1,83390,33150,6622,44518,0
2,51,10,6,6,0,0,4,10,0,0,0,0,0,0,0,0,0,0,0,0,2,0,1,83390,33150,6622,44519,0
2,51,1,1,1,0,0,0,1,0,0,0,0,0,0,0,0,0,0,0,0,2,0,1,83390,33150,6622,44519,0
2,51,14,10,10,0,0,4,14,1,1,1,1,2,2,0,2,0,1,0,0,2,0,1,83390,33150,6622,44520,0
2,51,46,26,30,3,0,12,49,3,6,3,6,9,9,20,28,1,42,2,0,2,0,1,83400,33150,6622,44521,0
1,6,2,2,2,0,0,0,2,0,0,0,0,0,0,0,0,0,0,0,0,2,0,1,83400,33150,6622,44521,0
8,263,51,25,36,0,0,15,51,3,11,6,12,14,18,42,68,1,112,6,0,2,0,1,83400,33150,6622,44522,0
1,14,6,4,4,0,0,2,6,0,0,0,0,0,0,0,0,0,0,0,0,2,0,1,83400,33150,6622,44523,0
4,163,27,21,21,0,0,6,27,3,6,3,6,9,9,20,28,1,42,2,0,2,0,1,83400,33150,6622,44524,0
1,6,2,2,2,0,0,0,2,0,0,0,0,0,0,0,0,0,0,0,0,2,0,1,83400,33150,6622,44524,0
1,41,7,5,5,0,0,2,7,1,2,1,2,3,3,2,4,0,2,0,0,2,0,1,83400,33150,6622,44525,0
2,51,14,9,9,0,0,5,14,0,0,0,0,0,0,0,0,0,0,0,0,2,0,1,83400,33150,6622,44526,0
2,40,13,9,8,0,0,4,13,0,0,0,0,0,0,0,0,0,0,0,0,2,0,1,83400,33150,6622,44527,0
2,42,14,10,9,0,0,4,14,0,0,0,0,0,0,0,0,0,0,0,0,2,0,1,83400,33150,6622,44528,0
2,33,12,8,7,0,0,4,12,0,0,0,0,0,0,0,0,0,0,0,0,2,0,1,83400,33150,6622,44529,0
3,49,16,9,9,0,0,7,16,0,0,0,0,0,0,0,0,0,0,0,0,2,0,1,83400,33150,6622,44530,0
1,18,3,3,3,0,0,0,3,0,0,0,0,0,0,0,0,0,0,0,0,2,0,1,83400,33150,6622,44530,0
2,26,6,4,4,0,0,2,6,1,4,2,4,5,6,8,13,0,6,0,0,2,0,1,83400,33150,6622,44532,0
12,318,149,95,105,2,0,41,151,8,54,28,55,62,83,334,494,4,2013,111,0,2,0,1,83400,33150,6622,44534,0
15,703,139,89,101,2,0,35,141,7,54,34,62,61,96,330,569,4,2287,127,0,2,0,1,83400,33150,6622,44535,0
3,330,149,67,118,4,0,27,153,1,17,14,28,18,42,69,175,0,144,8,0,2,0,1,83400,33150,6622,44536,0
38,2498,1157,318,931,29,22,177,1186,6,104,63,125,110,188,712,1274,3,4596,255,0,2,0,1,83400,33150,6622,44537,0
65,4378,520,294,400,33,13,81,553,10,261,204,367,271,571,2128,4614,7,32445,1802,1,2,0,1,83400,33151,6622,44538,0
90,3988,1338,495,1086,10,64,173,1348,11,122,82,157,133,239,883,1686,7,11934,663,0,2,0,1,83400,33153,6622,44539,0
172,7635,4293,999,3693,19,54,507,4312,9,155,88,170,164,258,1156,1898,4,9368,520,0,2,0,1,83400,33155,6622,44540,0
172,7635,1482,859,1002,125,135,219,1607,16,219,134,251,235,385,1766,3032,9,27804,1544,1,2,0,1,83410,33156,6622,44541,0
33,999,465,148,393,5,8,60,470,4,31,20,31,35,51,161,261,2,523,29,0,2,0,1,83410,33157,6622,44542,0
33,999,16,12,9,0,0,6,16,1,2,1,2,3,3,2,4,0,2,0,0,2,0,1,83410,33157,6622,44543,0
144,5933,1782,648,1425,9,47,279,1791,8,171,97,189,179,286,1292,2140,4,9462,525,0,2,0,1,83410,33158,6623,44544,0
32,982,256,139,192,9,7,47,265,4,23,12,24,27,36,112,171,2,357,19,0,2,0,1,83410,33159,6623,44545,0
6,328,180,34,164,0,0,16,180,1,12,6,12,13,18,43,66,0,33,1,0,2,0,1,83410,33159,6623,44546,0
19,517,102,59,69,5,3,24,107,6,22,15,28,28,43,113,206,3,789,43,0,2,0,1,83410,33159,6623,44547,0
119,4920,1450,624,1228,12,26,181,1462,14,306,186,354,320,540,2580,4493,8,36391,2021,1,2,0,1,83410,33161,6624,44548,0
176,5162,1660,832,1314,41,38,274,1701,20,312,209,395,332,604,2671,5058,12,64042,3557,1,2,0,1,83410,33163,6625,44550,0
49,3805,996,429,845,24,10,117,1020,7,76,50,88,83,138,494,879,4,3565,198,0,2,0,1,83410,33165,6625,44551,0
120,5123,1513,682,1277,25,13,200,1538,11,199,116,219,210,335,1557,2584,6,15641,868,0,2,0,1,83410,33167,6625,44552,0
84,4916,1296,573,1062,40,33,157,1336,8,201,118,231,209,349,1561,2689,4,12365,686,0,2,0,1,83410,33167,6625,44553,0
20,467,207,111,150,11,0,50,218,5,26,19,36,31,55,133,272,3,943,52,0,2,0,1,83410,33167,6625,44554,0
98,5241,1457,730,1242,11,6,188,1468,10,292,166,329,302,495,2424,4078,5,22973,1276,1,2,0,1,83410,33169,6625,44555,0
43,2690,652,304,544,16,6,88,668,6,89,51,101,95,152,591,998,3,3399,188,0,2,0,1,83410,33170,6625,44556,0
72,3266,1455,414,1257,16,76,112,1471,5,41,23,46,46,69,231,381,2,1069,59,0,2,0,1,83410,33171,6625,44557,0
2,56,7,6,5,0,0,2,7,1,1,1,2,2,3,0,3,1,3,0,0,2,0,1,83410,33171,6625,44558,0
8,275,74,35,59,1,0,14,75,3,14,7,14,17,21,58,85,1,128,7,0,2,0,1,83410,33172,6625,44559,0
107,5160,1523,757,1297,19,12,193,1542,12,193,117,230,205,347,1508,2664,7,19053,1058,0,2,0,1,83420,33174,6625,44560,0
70,3204,1020,354,843,12,15,144,1032,8,134,77,144,142,221,970,1580,4,6792,377,0,2,0,1,83420,33174,6625,44561,0
44,2058,447,308,343,6,5,95,453,7,96,59,111,103,170,651,1136,4,4600,255,0,2,0,1,83420,33177,6625,44562,0
3,229,53,23,39,0,0,13,53,2,8,4,8,10,12,26,39,1,39,2,0,2,0,1,83420,33177,6625,44563,0
21,655,424,94,331,4,0,89,428,1,5,5,5,6,10,11,25,0,12,0,0,2,0,1,83420,33178,6625,44564,0
38,2327,334,251,279,10,4,40,344,5,127,74,143,132,217,899,1528,2,4303,239,0,2,0,1,83420,33179,6625,44565,0
9,444,184,100,137,2,15,30,186,6,38,20,39,44,59,214,322,3,991,55,0,2,0,1,83420,33180,6625,44566,0
8,377,91,45,69,0,3,18,91,3,9,6,10,12,16,33,57,1,95,5,0,2,0,1,83420,33182,6625,44567,0
75,3960,1293,570,1093,25,15,163,1318,10,195,123,241,205,364,1516,2795,6,17273,959,0,2,0,1,83430,33184,6625,44568,0
29,1903,384,251,317,7,8,52,391,11,70,44,84,81,128,467,811,6,5355,297,0,2,0,1,83430,33184,6625,44569,0
56,2883,722,423,573,19,0,135,741,12,172,101,199,184,300,1320,2257,6,15668,870,0,2,0,1,83430,33186,6625,44571,0
45,1953,386,256,301,16,9,68,402,4,59,35,69,63,104,355,621,2,1453,80,0,2,0,1,83430,33186,6625,44572,0
28,1596,466,257,367,18,25,50,484,7,126,86,171,133,257,898,1813,4,8612,478,0,2,0,1,83430,33186,6625,44573,0
15,1066,215,129,180,6,0,29,221,8,65,43,72,73,115,415,711,4,3153,175,0,2,0,1,83430,33186,6625,44574,0
85,3387,1043,504,840,53,9,147,1096,9,180,112,198,189,310,1377,2344,4,11604,644,0,2,0,1,83430,33188,6625,44575,0
12,478,295,56,236,0,4,54,295,2,9,5,10,11,15,30,51,1,57,3,0,2,0,1,83430,33190,6625,44576,0
30,1440,373,158,315,8,0,51,381,5,76,44,79,81,123,486,779,2,2026,112,0,2,0,1,83430,33190,6625,44577,0
79,3101,1178,367,1042,6,15,115,1184,9,94,51,95,103,146,644,976,4,4439,246,0,2,0,1,83430,33190,6625,44578,0
9,449,219,78,157,11,5,46,230,3,24,20,34,27,54,114,256,2,545,30,0,2,0,1,83430,33191,6625,44579,0
111,6122,1943,715,1694,26,18,214,1969,12,185,120,237,197,357,1436,2721,7,20915,1161,0,2,0,1,83430,33193,6625,44580,0
35,1497,442,244,305,14,16,103,456,11,68,45,75,79,120,452,756,6,4588,254,0,2,0,1,83430,33195,6625,44581,0
48,1943,1098,241,925,5,10,155,1103,7,46,25,49,53,74,273,423,3,1580,87,0,2,0,1,83440,33197,6625,44582,0
48,1649,601,196,481,2,23,85,603,8,63,36,72,71,108,400,664,4,3036,168,0,2,0,1,83440,33197,6625,44583,0
2,34,9,6,6,0,0,3,9,0,0,0,0,0,0,0,0,0,0,0,0,2,0,2,83440,33197,6625,44584,0
2,34,13,9,8,0,0,4,13,0,0,0,0,0,0,0,0,0,0,0,0,2,0,2,83440,33197,6625,44585,0
11,230,19,8,11,5,0,4,24,2,5,3,6,7,9,13,25,1,30,1,0,2,0,4,83440,33197,6625,44586,0
11,230,102,59,69,5,3,24,107,6,22,15,28,28,43,113,206,3,789,43,0,2,0,4,83440,33197,6625,44587,0
11,230,106,40,36,3,49,17,109,8,17,13,23,25,36,93,167,5,904,50,0,2,0,4,83440,33197,6625,44588,0
221,4746,182,127,129,0,0,53,182,5,39,21,42,44,63,217,343,2,926,51,0,2,0,4,83450,33201,6627,44596,0
221,4746,1165,710,800,67,119,181,1232,18,243,153,282,261,435,2000,3492,10,36473,2026,1,2,0,4,83460,33201,6628,44597,0
67,1558,773,419,590,28,0,166,801,10,204,113,217,214,330,1598,2554,5,13587,754,0,2,0,4,83460,33201,6629,44598,0
67,1558,421,273,302,44,34,57,465,17,81,59,107,98,166,583,1098,11,12329,684,0,2,0,4,83460,33201,6630,44599,0
14,407,149,95,105,2,0,41,151,8,54,28,55,62,83,334,494,4,2013,111,0,2,1,2,83460,33201,6630,44600,0
14,407,82,56,54,0,13,15,82,4,13,8,16,17,24,56,98,2,241,13,0,2,1,2,83470,33201,6630,44601,0
25,502,2,2,2,0,0,0,2,0,0,0,0,0,0,0,0,0,0,0,0,2,0,4,83470,33201,6630,44601,0
25,502,99,48,90,1,3,5,100,0,0,0,0,0,0,0,0,0,0,0,0,2,0,4,83470,33202,6630,44602,0
25,502,8,5,5,2,0,1,10,0,0,0,0,0,0,0,0,0,0,0,0,2,0,4,83470,33202,6630,44603,0
25,502,1217,716,841,84,126,174,1301,14,185,118,215,199,333,1446,2542,8,20687,1149,0,2,0,4,83480,33204,6630,44604,0
25,502,160,89,115,0,13,31,160,7,15,11,17,22,28,78,124,3,495,27,0,2,0,4,83480,33204,6630,44605,0
25,502,10,10,9,9,0,0,19,0,0,0,0,0,0,0,0,0,0,0,0,2,0,4,83480,33204,6631,44606,0
25,502,173,84,99,8,29,36,181,5,12,7,13,17,20,54,81,2,221,12,0,2,0,4,83480,33205,6631,44607,0
25,502,3,1,1,3,0,0,6,0,0,0,0,0,0,0,0,0,0,0,0,2,0,4,83480,33205,6631,44608,0
174,5286,1660,832,1314,41,38,274,1701,20,312,209,395,332,604,2671,5058,12,64042,3557,1,2,0,4,83480,33207,6632,44610,0
174,5286,1057,646,719,113,100,145,1170,18,215,134,248,233,382,1740,3004,10,31186,1732,1,2,0,4,83490,33208,6633,44611,0
17,336,95,58,50,9,16,20,104,12,33,24,45,45,69,209,378,8,3100,172,0,2,0,4,83490,33208,6633,44612,0
116,2161,477,336,357,30,23,73,507,16,194,134,250,210,384,1538,2962,10,30538,1696,0,2,0,4,83500,33209,6633,44613,0
90,2032,996,429,845,24,10,117,1020,7,76,50,88,83,138,494,879,4,3565,198,0,2,0,4,83500,33211,6633,44614,0
90,2032,456,277,329,12,42,72,468,13,85,50,97,98,147,592,972,7,7212,400,0,2,0,4,83500,33211,6633,44615,0
160,3447,1513,682,1277,25,13,200,1538,11,199,116,219,210,335,1557,2584,6,15641,868,0,2,0,4,83500,33213,6633,44616,0
160,3447,819,519,539,24,98,155,843,15,96,57,106,111,163,690,1107,8,9171,509,0,2,0,4,83510,33215,6633,44617,0
59,1108,207,111,150,11,0,50,218,5,26,19,36,31,55,133,272,3,943,52,0,2,0,4,83510,33215,6633,44618,0
59,1108,410,198,237,31,55,97,441,11,63,38,72,74,110,414,683,6,4293,238,0,2,0,4,83520,33216,6634,44619,0
235,4901,2,2,2,0,0,0,2,0,0,0,0,0,0,0,0,0,0,0,0,2,0,4,83520,33216,6634,44619,0
235,4901,99,48,90,1,3,5,100,0,0,0,0,0,0,0,0,0,0,0,0,2,0,4,83520,33217,6634,44620,0
235,4901,8,5,5,2,0,1,10,0,0,0,0,0,0,0,0,0,0,0,0,2,0,4,83520,33217,6634,44621,0
235,4901,1217,716,841,84,126,174,1301,14,185,118,215,199,333,1446,2542,8,20687,1149,0,2,0,4,83530,33219,6634,44622,0
235,4901,160,89,115,0,13,31,160,7,15,11,17,22,28,78,124,3,495,27,0,2,0,4,83530,33219,6634,44623,0
235,4901,10,10,9,9,0,0,19,0,0,0,0,0,0,0,0,0,0,0,0,2,0,4,83530,33219,6635,44624,0
235,4901,173,84,99,8,29,36,181,5,12,7,13,17,20,54,81,2,221,12,0,2,0,4,83530,33220,6635,44625,0
235,4901,3,1,1,3,0,0,6,0,0,0,0,0,0,0,0,0,0,0,0,2,0,4,83530,33220,6635,44626,0
57,1510,339,213,244,17,9,65,356,10,42,26,48,52,74,259,421,5,2410,133,0,2,0,4,83540,33220,6635,44627,0
90,2296,1455,414,1257,16,76,112,1471,5,41,23,46,46,69,231,381,2,1069,59,0,2,0,4,83540,33221,6635,44629,0
90,2296,669,365,481,22,61,110,691,15,103,63,122,118,185,747,1273,8,11311,628,0,2,0,4,83550,33221,6636,44630,0
251,5826,4293,999,3693,19,54,507,4312,9,155,88,170,164,258,1156,1898,4,9368,520,0,2,0,4,83550,33223,6636,44631,0
251,5826,1482,859,1002,125,135,219,1607,16,219,134,251,235,385,1766,3032,9,27804,1544,1,2,0,4,83560,33224,6636,44632,0
6,128,44,22,19,0,19,6,44,2,10,6,12,12,18,35,64,1,77,4,0,2,0,3,83560,33224,6636,44633,0
31,1075,74,35,59,1,0,14,75,3,14,7,14,17,21,58,85,1,128,7,0,2,0,4,83560,33225,6636,44634,0
31,1075,245,125,200,5,7,34,250,7,30,17,34,37,51,166,265,3,1053,58,0,2,0,4,83570,33226,6636,44635,0
117,3148,1523,757,1297,19,12,193,1542,12,193,117,230,205,347,1508,2664,7,19053,1058,0,2,0,4,83580,33228,6636,44636,0
117,3148,701,378,504,33,58,109,734,13,110,68,126,123,194,794,1346,7,10027,557,0,2,0,4,83580,33229,6637,44637,0
105,2767,773,422,505,30,103,129,803,14,77,46,83,91,129,535,839,7,6334,351,0,2,0,4,83590,33230,6638,44638,0
149,3591,77,34,69,0,0,8,77,3,24,16,29,27,45,114,213,1,387,21,0,2,0,4,83590,33230,6638,44639,0
149,3591,712,438,573,51,9,84,763,14,102,71,128,116,199,733,1364,8,11988,666,0,2,0,4,83600,33231,6638,44640,0
24,600,2,2,2,0,0,0,2,0,0,0,0,0,0,0,0,0,0,0,0,2,0,4,83600,33231,6638,44640,0
24,600,99,48,90,1,3,5,100,0,0,0,0,0,0,0,0,0,0,0,0,2,0,4,83600,33232,6638,44641,0
24,600,8,5,5,2,0,1,10,0,0,0,0,0,0,0,0,0,0,0,0,2,0,4,83600,33232,6638,44642,0
24,600,1217,716,841,84,126,174,1301,14,185,118,215,199,333,1446,2542,8,20687,1149,0,2,0,4,83610,33234,6638,44643,0
24,600,160,89,115,0,13,31,160,7,15,11,17,22,28,78,124,3,495,27,0,2,0,4,83610,33234,6638,44644,0
24,600,10,10,9,9,0,0,19,0,0,0,0,0,0,0,0,0,0,0,0,2,0,4,83610,33234,6639,44645,0
24,600,173,84,99,8,29,36,181,5,12,7,13,17,20,54,81,2,221,12,0,2,0,4,83610,33235,6639,44646,0
24,600,3,1,1,3,0,0,6,0,0,0,0,0,0,0,0,0,0,0,0,2,0,4,83610,33235,6639,44647,0
51,1101,447,308,343,6,5,95,453,7,96,59,111,103,170,651,1136,4,4600,255,0,2,0,4,83610,33238,6639,44648,0
51,1101,322,174,179,16,74,51,338,10,41,26,46,51,72,252,408,5,2291,127,0,2,0,4,83610,33241,6640,44649,0
75,1617,53,23,39,0,0,13,53,2,8,4,8,10,12,26,39,1,39,2,0,2,0,4,83610,33241,6640,44650,0
75,1617,515,298,307,33,80,99,548,12,63,44,77,75,121,419,753,7,5527,307,0,2,0,4,83620,33241,6640,44651,0
18,300,424,94,331,4,0,89,428,1,5,5,5,6,10,11,25,0,12,0,0,2,0,4,83620,33242,6640,44652,0
18,300,38,23,23,6,0,8,44,3,11,7,11,14,18,42,68,1,102,5,0,2,0,4,83620,33242,6640,44653,0
19,501,205,80,86,16,53,53,221,7,18,10,19,25,29,94,134,3,497,27,0,2,0,4,83630,33242,6641,44654,0
15,478,184,100,137,2,15,30,186,6,38,20,39,44,59,214,322,3,991,55,0,2,0,4,83630,33243,6641,44655,0
15,478,103,65,74,8,5,16,111,7,17,9,17,24,26,89,119,3,417,23,0,2,0,4,83630,33244,6641,44656,0
58,1197,91,45,69,0,3,18,91,3,9,6,10,12,16,33,57,1,95,5,0,2,0,1,83630,33246,6641,44657,0
58,1197,367,234,237,17,34,68,384,16,55,34,61,71,95,381,584,8,5183,287,0,2,0,1,83630,33247,6641,44658,0
228,5891,722,423,573,19,0,135,741,12,172,101,199,184,300,1320,2257,6,15668,870,0,2,0,4,83630,33249,6641,44660,0
228,5891,1508,847,911,44,250,301,1552,14,148,88,169,162,257,1120,1886,7,15077,837,0,2,0,4,83630,33250,6642,44661,0
315,6902,72,33,56,0,4,12,72,1,1,1,1,2,2,0,2,0,1,0,0,2,0,4,83630,33250,6642,44662,0
315,6902,1454,835,1044,76,110,219,1530,17,275,158,296,292,454,2297,3718,9,34017,1889,1,2,0,4,83640,33251,6642,44663,0
89,1807,757,253,292,73,244,162,830,13,61,38,67,74,105,409,651,7,4654,258,0,2,1,4,83640,33252,6642,44664,0
38,802,386,256,301,16,9,68,402,4,59,35,69,63,104,355,621,2,1453,80,0,2,0,4,83640,33252,6642,44665,0
38,802,264,131,164,11,41,46,275,6,38,22,40,44,62,214,338,3,1068,59,0,2,0,4,83650,33252,6643,44666,0
25,540,215,129,180,6,0,29,221,8,65,43,72,73,115,415,711,4,3153,175,0,2,0,4,83650,33252,6643,44667,0
25,540,97,69,77,3,3,16,100,6,22,13,23,28,36,113,173,3,542,30,0,2,0,4,83650,33253,6643,44668,0
89,1882,1043,504,840,53,9,147,1096,9,180,112,198,189,310,1377,2344,4,11604,644,0,2,0,4,83650,33255,6643,44669,0
89,1882,383,288,292,26,6,62,409,11,65,38,67,76,105,429,656,5,3719,206,0,2,0,4,83650,33256,6643,44670,0
20,408,294,64,250,0,0,43,294,1,20,10,20,21,30,86,131,0,65,3,0,2,0,4,83650,33256,6643,44671,0
20,408,78,46,62,3,0,14,81,3,8,4,8,11,12,28,41,1,62,3,0,2,0,4,83650,33257,6643,44672,0
5,111,110,30,77,3,13,16,113,4,21,15,30,25,45,100,208,2,597,33,0,2,0,4,83650,33257,6643,44673,0
5,111,28,15,21,1,0,6,29,0,0,0,0,0,0,0,0,0,0,0,0,2,0,4,83650,33257,6643,44674,0
40,784,1178,367,1042,6,15,115,1184,9,94,51,95,103,146,644,976,4,4439,246,0,2,0,4,83650,33257,6643,44675,0
40,784,177,108,140,8,0,27,185,6,30,16,32,36,48,162,248,3,794,44,0,2,0,4,83650,33259,6643,44676,0
280,5876,1943,715,1694,26,18,214,1969,12,185,120,237,197,357,1436,2721,7,20915,1161,0,2,0,4,83650,33261,6643,44677,0
280,5876,1168,838,957,57,25,144,1225,19,348,224,416,367,640,3018,5452,11,61921,3440,1,2,0,4,83660,33263,6643,44678,0
19,705,442,244,305,14,16,103,456,11,68,45,75,79,120,452,756,6,4588,254,0,2,0,4,83660,33265,6643,44679,0
19,705,182,102,99,11,40,35,193,3,11,6,11,14,17,42,64,1,97,5,0,2,0,4,83660,33266,6643,44680,0
65,1251,1098,241,925,5,10,155,1103,7,46,25,49,53,74,273,423,3,1580,87,0,2,0,4,83670,33268,6643,44681,0
65,1251,282,202,222,14,2,44,296,8,42,24,43,50,67,250,378,4,1548,86,0,2,0,4,83670,33269,6643,44682,0
23,630,601,196,481,2,23,85,603,8,63,36,72,71,108,400,664,4,3036,168,0,2,0,4,83670,33269,6643,44683,0
23,630,156,79,106,5,16,28,161,5,14,8,15,19,23,64,97,2,261,14,0,2,0,4,83670,33269,6643,44684,0
104,4424,1289,550,1043,56,32,155,1345,10,167,93,185,177,278,1266,2075,5,11498,638,0,2,0,4,83670,33271,6644,44685,0
31,982,182,127,129,0,0,53,182,5,39,21,42,44,63,217,343,2,926,51,0,2,0,4,83670,33271,6645,44686,0
151,7235,1392,870,1177,35,17,170,1427,14,494,280,531,508,811,4473,7289,7,54850,3047,2,2,1,5,83670,33274,6646,44687,0
95,2884,773,419,590,28,0,166,801,10,204,113,217,214,330,1598,2554,5,13587,754,0,2,0,4,83670,33274,6647,44688,0
14,833,75,38,59,1,3,12,76,2,4,2,4,6,6,10,15,1,15,0,0,2,0,4,83670,33274,6647,44689,0
19,505,102,59,69,5,3,24,107,6,22,15,28,28,43,113,206,3,789,43,0,2,0,4,83670,33274,6647,44690,0
119,4908,1450,624,1228,12,26,181,1462,14,306,186,354,320,540,2580,4493,8,36391,2021,1,2,0,4,83670,33276,6648,44691,0
176,5150,1660,832,1314,41,38,274,1701,20,312,209,395,332,604,2671,5058,12,64042,3557,1,2,0,4,83670,33278,6649,44693,0
49,3793,996,429,845,24,10,117,1020,7,76,50,88,83,138,494,879,4,3565,198,0,2,0,4,83670,33280,6649,44694,0
120,5111,1513,682,1277,25,13,200,1538,11,199,116,219,210,335,1557,2584,6,15641,868,0,2,0,4,83670,33282,6649,44695,0
84,4904,1296,573,1062,40,33,157,1336,8,201,118,231,209,349,1561,2689,4,12365,686,0,2,0,4,83670,33282,6649,44696,0
20,455,207,111,150,11,0,50,218,5,26,19,36,31,55,133,272,3,943,52,0,2,0,4,83670,33282,6649,44697,0
98,5229,1457,730,1242,11,6,188,1468,10,292,166,329,302,495,2424,4078,5,22973,1276,1,2,0,4,83670,33284,6649,44698,0
43,2678,652,304,544,16,6,88,668,6,89,51,101,95,152,591,998,3,3399,188,0,2,0,4,83670,33285,6649,44699,0
72,3254,1455,414,1257,16,76,112,1471,5,41,23,46,46,69,231,381,2,1069,59,0,2,0,4,83670,33286,6649,44700,0
2,44,7,6,5,0,0,2,7,1,1,1,2,2,3,0,3,1,3,0,0,2,0,4,83670,33286,6649,44701,0
8,263,74,35,59,1,0,14,75,3,14,7,14,17,21,58,85,1,128,7,0,2,0,4,83670,33287,6649,44702,0
107,5148,1523,757,1297,19,12,193,1542,12,193,117,230,205,347,1508,2664,7,19053,1058,0,2,0,4,83680,33289,6649,44703,0
70,3192,1020,354,843,12,15,144,1032,8,134,77,144,142,221,970,1580,4,6792,377,0,2,0,4,83680,33289,6649,44704,0
44,2046,447,308,343,6,5,95,453,7,96,59,111,103,170,651,1136,4,4600,255,0,2,0,4,83680,33292,6649,44705,0
21,643,424,94,331,4,0,89,428,1,5,5,5,6,10,11,25,0,12,0,0,2,0,4,83680,33293,6649,44706,0
38,2315,334,251,279,10,4,40,344,5,127,74,143,132,217,899,1528,2,4303,239,0,2,0,4,83680,33294,6649,44707,0
9,432,184,100,137,2,15,30,186,6,38,20,39,44,59,214,322,3,991,55,0,2,0,4,83680,33295,6649,44708,0
75,3948,1293,570,1093,25,15,163,1318,10,195,123,241,205,364,1516,2795,6,17273,959,0,2,0,4,83690,33297,6649,44709,0
29,1891,384,251,317,7,8,52,391,11,70,44,84,81,128,467,811,6,5355,297,0,2,0,4,83690,33297,6649,44710,0
56,2871,722,423,573,19,0,135,741,12,172,101,199,184,300,1320,2257,6,15668,870,0,2,0,4,83690,33299,6649,44712,0
45,1941,386,256,301,16,9,68,402,4,59,35,69,63,104,355,621,2,1453,80,0,2,0,4,83690,33299,6649,44713,0
15,1054,215,129,180,6,0,29,221,8,65,43,72,73,115,415,711,4,3153,175,0,2,0,4,83690,33299,6649,44714,0
85,3375,1043,504,840,53,9,147,1096,9,180,112,198,189,310,1377,2344,4,11604,644,0,2,0,4,83690,33301,6649,44715,0
12,466,295,56,236,0,4,54,295,2,9,5,10,11,15,30,51,1,57,3,0,2,0,4,83690,33303,6649,44716,0
30,1428,373,158,315,8,0,51,381,5,76,44,79,81,123,486,779,2,2026,112,0,2,0,4,83690,33303,6649,44717,0
79,3089,1178,367,1042,6,15,115,1184,9,94,51,95,103,146,644,976,4,4439,246,0,2,0,4,83690,33303,6649,44718,0
111,6110,1943,715,1694,26,18,214,1969,12,185,120,237,197,357,1436,2721,7,20915,1161,0,2,0,4,83690,33305,6649,44719,0
35,1485,442,244,305,14,16,103,456,11,68,45,75,79,120,452,756,6,4588,254,0,2,0,4,83690,33307,6649,44720,0
48,1931,1098,241,925,5,10,155,1103,7,46,25,49,53,74,273,423,3,1580,87,0,2,0,4,83700,33309,6649,44721,0
48,1645,601,196,481,2,23,85,603,8,63,36,72,71,108,400,664,4,3036,168,0,2,0,2,83700,33309,6649,44722,0
1,313,382,65,130,157,2,92,539,4,10,5,10,14,15,41,57,2,114,6,0,2,9,9,83700,33310,6650,44723,1
60,1118,282,196,195,3,0,86,285,8,130,71,141,138,212,936,1507,4,6538,363,0,2,15,15,83700,33310,6651,44724,1
7,111,44,19,17,0,16,11,44,3,14,7,14,17,21,58,85,1,128,7,0,2,1,1,83700,33310,6651,44725,1
3,63,127,75,83,2,11,30,129,4,14,7,14,18,21,61,87,2,175,9,0,2,1,1,83700,33310,6651,44726,1
3,63,652,304,544,16,6,88,668,6,89,51,101,95,152,591,998,3,3399,188,0,2,1,1,83700,33311,6651,44727,1
3,63,2,2,2,0,0,0,2,0,0,0,0,0,0,0,0,0,0,0,0,2,1,1,83700,33311,6651,44727,1
3,63,8,5,5,0,0,3,8,0,0,0,0,0,0,0,0,0,0,0,0,2,1,1,83700,33311,6651,44728,1
3,63,2,2,2,0,0,0,2,0,0,0,0,0,0,0,0,0,0,0,0,2,1,1,83700,33311,6651,44728,1
3,63,14,8,8,0,0,6,14,0,0,0,0,0,0,0,0,0,0,0,0,2,1,1,83700,33311,6651,44729,1
3,63,6,4,4,0,0,2,6,0,0,0,0,0,0,0,0,0,0,0,0,2,1,1,83700,33311,6651,44730,1
3,63,6,4,4,0,0,2,6,1,2,1,2,3,3,2,4,0,2,0,0,2,1,1,83700,33311,6651,44731,1
3,63,6,4,4,0,0,2,6,0,0,0,0,0,0,0,0,0,0,0,0,2,1,1,83700,33311,6651,44732,1
3,63,7,5,5,0,0,2,7,0,0,0,0,0,0,0,0,0,0,0,0,2,1,1,83700,33311,6651,44733,1
3,63,6,4,4,0,0,2,6,0,0,0,0,0,0,0,0,0,0,0,0,2,1,1,83700,33311,6651,44734,1
3,63,10,6,6,0,0,4,10,0,0,0,0,0,0,0,0,0,0,0,0,2,1,1,83700,33311,6651,44735,1
3,63,1,1,1,0,0,0,1,0,0,0,0,0,0,0,0,0,0,0,0,2,1,1,83700,33311,6651,44735,1
3,63,14,10,10,0,0,4,14,1,1,1,1,2,2,0,2,0,1,0,0,2,1,1,83700,33311,6651,44736,1
3,63,46,26,30,3,0,12,49,3,6,3,6,9,9,20,28,1,42,2,0,2,1,1,83710,33311,6651,44737,1
7,293,72,33,56,0,4,12,72,1,1,1,1,2,2,0,2,0,1,0,0,2,1,1,83710,33311,6651,44738,1
12,226,127,75,83,2,11,30,129,4,14,7,14,18,21,61,87,2,175,9,0,2,1,1,83710,33311,6651,44739,1
12,226,652,304,544,16,6,88,668,6,89,51,101,95,152,591,998,3,3399,188,0,2,1,1,83710,33312,6651,44740,1
12,226,2,2,2,0,0,0,2,0,0,0,0,0,0,0,0,0,0,0,0,2,1,1,83710,33312,6651,44740,1
12,226,8,5,5,0,0,3,8,0,0,0,0,0,0,0,0,0,0,0,0,2,1,1,83710,33312,6651,44741,1
12,226,2,2,2,0,0,0,2,0,0,0,0,0,0,0,0,0,0,0,0,2,1,1,83710,33312,6651,44741,1
12,226,14,8,8,0,0,6,14,0,0,0,0,0,0,0,0,0,0,0,0,2,1,1,83710,33312,6651,44742,1
12,226,6,4,4,0,0,2,6,0,0,0,0,0,0,0,0,0,0,0,0,2,1,1,83710,33312,6651,44743,1
12,226,6,4,4,0,0,2,6,1,2,1,2,3,3,2,4,0,2,0,0,2,1,1,83710,33312,6651,44744,1
12,226,6,4,4,0,0,2,6,0,0,0,0,0,0,0,0,0,0,0,0,2,1,1,83710,33312,6651,44745,1
12,226,7,5,5,0,0,2,7,0,0,0,0,0,0,0,0,0,0,0,0,2,1,1,83710,33312,6651,44746,1
12,226,6,4,4,0,0,2,6,0,0,0,0,0,0,0,0,0,0,0,0,2,1,1,83710,33312,6651,44747,1
12,226,10,6,6,0,0,4,10,0,0,0,0,0,0,0,0,0,0,0,0,2,1,1,83710,33312,6651,44748,1
12,226,1,1,1,0,0,0,1,0,0,0,0,0,0,0,0,0,0,0,0,2,1,1,83710,33312,6651,44748,1
12,226,14,10,10,0,0,4,14,1,1,1,1,2,2,0,2,0,1,0,0,2,1,1,83710,33312,6651,44749,1
12,226,46,26,30,3,0,12,49,3,6,3,6,9,9,20,28,1,42,2,0,2,1,1,83720,33312,6651,44750,1
3,23,14,7,7,2,0,5,16,0,0,0,0,0,0,0,0,0,0,0,0,2,1,1,83720,33312,6651,44750,1
11,227,19,8,11,5,0,4,24,2,5,3,6,7,9,13,25,1,30,1,0,2,1,1,83720,33312,6651,44751,1
11,227,102,59,69,5,3,24,107,6,22,15,28,28,43,113,206,3,789,43,0,2,1,1,83720,33312,6651,44752,1
11,227,106,40,36,3,49,17,109,8,17,13,23,25,36,93,167,5,904,50,0,2,1,1,83720,33312,6651,44753,1
221,4718,182,127,129,0,0,53,182,5,39,21,42,44,63,217,343,2,926,51,0,2,19,17,83720,33312,6652,44754,1
221,4718,1165,710,800,67,119,181,1232,18,243,153,282,261,435,2000,3492,10,36473,2026,1,2,19,17,83730,33312,6653,44755,1
67,1551,773,419,590,28,0,166,801,10,204,113,217,214,330,1598,2554,5,13587,754,0,2,2,3,83730,33312,6654,44756,1
67,1551,421,273,302,44,34,57,465,17,81,59,107,98,166,583,1098,11,12329,684,0,2,2,3,83730,33312,6655,44757,1
14,404,149,95,105,2,0,41,151,8,54,28,55,62,83,334,494,4,2013,111,0,2,5,8,83730,33312,6655,44758,1
14,404,82,56,54,0,13,15,82,4,13,8,16,17,24,56,98,2,241,13,0,2,5,8,83740,33312,6655,44759,1
25,489,2,2,2,0,0,0,2,0,0,0,0,0,0,0,0,0,0,0,0,2,3,5,83740,33312,6655,44759,1
25,489,99,48,90,1,3,5,100,0,0,0,0,0,0,0,0,0,0,0,0,2,3,5,83740,33313,6655,44760,1
25,489,8,5,5,2,0,1,10,0,0,0,0,0,0,0,0,0,0,0,0,2,3,5,83740,33313,6655,44761,1
25,489,1217,716,841,84,126,174,1301,14,185,118,215,199,333,1446,2542,8,20687,1149,0,2,3,5,83750,33315,6655,44762,1
25,489,160,89,115,0,13,31,160,7,15,11,17,22,28,78,124,3,495,27,0,2,3,5,83750,33315,6655,44763,1
25,489,10,10,9,9,0,0,19,0,0,0,0,0,0,0,0,0,0,0,0,2,3,5,83750,33315,6656,44764,1
25,489,173,84,99,8,29,36,181,5,12,7,13,17,20,54,81,2,221,12,0,2,3,5,83750,33316,6656,44765,1
25,489,3,1,1,3,0,0,6,0,0,0,0,0,0,0,0,0,0,0,0,2,3,5,83750,33316,6656,44766,1
174,5271,1660,832,1314,41,38,274,1701,20,312,209,395,332,604,2671,5058,12,64042,3557,1,2,33,29,83750,33318,6657,44768,1
174,5271,1057,646,719,113,100,145,1170,18,215,134,248,233,382,1740,3004,10,31186,1732,1,2,33,29,83760,33319,6658,44769,1
17,327,95,58,50,9,16,20,104,12,33,24,45,45,69,209,378,8,3100,172,0,2,1,3,83760,33319,6658,44770,1
116,2120,477,336,357,30,23,73,507,16,194,134,250,210,384,1538,2962,10,30538,1696,0,2,43,41,83770,33320,6658,44771,1
90,2017,996,429,845,24,10,117,1020,7,76,50,88,83,138,494,879,4,3565,198,0,2,7,8,83770,33322,6658,44772,1
90,2017,456,277,329,12,42,72,468,13,85,50,97,98,147,592,972,7,7212,400,0,2,7,8,83770,33322,6658,44773,1
160,3411,1513,682,1277,25,13,200,1538,11,199,116,219,210,335,1557,2584,6,15641,868,0,2,19,28,83770,33324,6658,44774,1
160,3411,819,519,539,24,98,155,843,15,96,57,106,111,163,690,1107,8,9171,509,0,2,19,28,83780,33326,6658,44775,1
59,1095,207,111,150,11,0,50,218,5,26,19,36,31,55,133,272,3,943,52,0,2,5,7,83780,33326,6658,44776,1
59,1095,410,198,237,31,55,97,441,11,63,38,72,74,110,414,683,6,4293,238,0,2,5,7,83790,33327,6659,44777,1
235,4869,2,2,2,0,0,0,2,0,0,0,0,0,0,0,0,0,0,0,0,2,20,24,83790,33327,6659,44777,1
235,4869,99,48,90,1,3,5,100,0,0,0,0,0,0,0,0,0,0,0,0,2,20,24,83790,33328,6659,44778,1
235,4869,8,5,5,2,0,1,10,0,0,0,0,0,0,0,0,0,0,0,0,2,20,24,83790,33328,6659,44779,1
235,4869,1217,716,841,84,126,174,1301,14,185,118,215,199,333,1446,2542,8,20687,1149,0,2,20,24,83800,33330,6659,44780,1
235,4869,160,89,115,0,13,31,160,7,15,11,17,22,28,78,124,3,495,27,0,2,20,24,83800,33330,6659,44781,1
235,4869,10,10,9,9,0,0,19,0,0,0,0,0,0,0,0,0,0,0,0,2,20,24,83800,33330,6660,44782,1
235,4869,173,84,99,8,29,36,181,5,12,7,13,17,20,54,81,2,221,12,0,2,20,24,83800,33331,6660,44783,1
235,4869,3,1,1,3,0,0,6,0,0,0,0,0,0,0,0,0,0,0,0,2,20,24,83800,33331,6660,44784,1
98,2010,463,295,324,28,62,57,491,12,134,82,154,146,236,989,1696,6,11700,650,0,2,8,9,83810,33332,6660,44785,1
57,1484,339,213,244,17,9,65,356,10,42,26,48,52,74,259,421,5,2410,133,0,2,11,11,83820,33332,6660,44786,1
90,2288,1455,414,1257,16,76,112,1471,5,41,23,46,46,69,231,381,2,1069,59,0,2,4,4,83820,33333,6660,44787,1
90,2288,669,365,481,22,61,110,691,15,103,63,122,118,185,747,1273,8,11311,628,0,2,4,4,83830,33333,6661,44788,1
251,5813,4293,999,3693,19,54,507,4312,9,155,88,170,164,258,1156,1898,4,9368,520,0,2,13,15,83830,33335,6661,44789,1
251,5813,1482,859,1002,125,135,219,1607,16,219,134,251,235,385,1766,3032,9,27804,1544,1,2,13,15,83840,33336,6661,44790,1
31,1078,74,35,59,1,0,14,75,3,14,7,14,17,21,58,85,1,128,7,0,2,9,7,83840,33337,6661,44791,1
31,1078,245,125,200,5,7,34,250,7,30,17,34,37,51,166,265,3,1053,58,0,2,9,7,83850,33338,6661,44792,1
117,3127,1523,757,1297,19,12,193,1542,12,193,117,230,205,347,1508,2664,7,19053,1058,0,2,10,11,83860,33340,6661,44793,1
117,3127,701,378,504,33,58,109,734,13,110,68,126,123,194,794,1346,7,10027,557,0,2,10,11,83860,33341,6662,44794,1
105,2753,773,422,505,30,103,129,803,14,77,46,83,91,129,535,839,7,6334,351,0,2,5,5,83870,33342,6663,44795,1
146,3571,77,34,69,0,0,8,77,3,24,16,29,27,45,114,213,1,387,21,0,2,13,21,83870,33342,6663,44796,1
146,3571,712,438,573,51,9,84,763,14,102,71,128,116,199,733,1364,8,11988,666,0,2,13,21,83880,33343,6663,44797,1
30,657,125,97,103,3,0,19,128,9,25,17,27,34,44,144,223,4,1087,60,0,2,2,4,83880,33343,6664,44798,1
22,367,102,57,55,5,16,25,107,5,17,10,18,22,28,81,124,2,330,18,0,2,2,2,83880,33343,6664,44799,1
71,1560,402,202,227,24,74,80,426,12,52,33,61,64,94,339,564,7,3969,220,0,2,7,8,83880,33344,6664,44800,1
51,1090,447,308,343,6,5,95,453,7,96,59,111,103,170,651,1136,4,4600,255,0,2,13,11,83880,33347,6664,44801,1
51,1090,322,174,179,16,74,51,338,10,41,26,46,51,72,252,408,5,2291,127,0,2,13,11,83880,33350,6665,44802,1
75,1603,53,23,39,0,0,13,53,2,8,4,8,10,12,26,39,1,39,2,0,2,6,9,83880,33350,6665,44803,1
75,1603,515,298,307,33,80,99,548,12,63,44,77,75,121,419,753,7,5527,307,0,2,6,9,83890,33350,6665,44804,1
18,296,424,94,331,4,0,89,428,1,5,5,5,6,10,11,25,0,12,0,0,2,1,3,83890,33351,6665,44805,1
18,296,38,23,23,6,0,8,44,3,11,7,11,14,18,42,68,1,102,5,0,2,1,3,83890,33351,6665,44806,1
19,499,205,80,86,16,53,53,221,7,18,10,19,25,29,94,134,3,497,27,0,2,3,3,83900,33351,6666,44807,1
15,476,184,100,137,2,15,30,186,6,38,20,39,44,59,214,322,3,991,55,0,2,3,5,83900,33352,6666,44808,1
15,476,103,65,74,8,5,16,111,7,17,9,17,24,26,89,119,3,417,23,0,2,3,5,83900,33353,6666,44809,1
58,1189,91,45,69,0,3,18,91,3,9,6,10,12,16,33,57,1,95,5,0,2,5,6,83900,33355,6666,44810,1
58,1189,367,234,237,17,34,68,384,16,55,34,61,71,95,381,584,8,5183,287,0,2,5,6,83900,33356,6666,44811,1
228,5843,722,423,573,19,0,135,741,12,172,101,199,184,300,1320,2257,6,15668,870,0,2,34,33,83900,33358,6666,44813,1
228,5843,1508,847,911,44,250,301,1552,14,148,88,169,162,257,1120,1886,7,15077,837,0,2,34,33,83900,33359,6667,44814,1
314,6872,72,33,56,0,4,12,72,1,1,1,1,2,2,0,2,0,1,0,0,2,20,23,83900,33359,6667,44815,1
314,6872,1454,835,1044,76,110,219,1530,17,275,158,296,292,454,2297,3718,9,34017,1889,1,2,20,23,83910,33360,6667,44816,1
89,1801,757,253,292,73,244,162,830,13,61,38,67,74,105,409,651,7,4654,258,0,2,2,2,83910,33361,6667,44817,1
38,787,386,256,301,16,9,68,402,4,59,35,69,63,104,355,621,2,1453,80,0,2,5,5,83910,33361,6667,44818,1
38,787,264,131,164,11,41,46,275,6,38,22,40,44,62,214,338,3,1068,59,0,2,5,5,83920,33361,6668,44819,1
67,1747,466,257,367,18,25,50,484,7,126,86,171,133,257,898,1813,4,8612,478,0,2,9,18,83920,33361,6668,44820,1
67,1747,507,281,342,29,59,88,536,10,53,29,57,63,86,336,514,5,2764,153,0,2,9,18,83920,33361,6668,44821,1
25,538,215,129,180,6,0,29,221,8,65,43,72,73,115,415,711,4,3153,175,0,2,2,2,83920,33361,6668,44822,1
25,538,97,69,77,3,3,16,100,6,22,13,23,28,36,113,173,3,542,30,0,2,2,2,83920,33362,6668,44823,1
89,1877,1043,504,840,53,9,147,1096,9,180,112,198,189,310,1377,2344,4,11604,644,0,2,3,3,83920,33364,6668,44824,1
89,1877,383,288,292,26,6,62,409,11,65,38,67,76,105,429,656,5,3719,206,0,2,3,3,83920,33365,6668,44825,1
280,5869,1943,715,1694,26,18,214,1969,12,185,120,237,197,357,1436,2721,7,20915,1161,0,2,19,22,83920,33367,6668,44826,1
280,5869,1168,838,957,57,25,144,1225,19,348,224,416,367,640,3018,5452,11,61921,3440,1,2,19,22,83930,33369,6668,44827,1
19,699,442,244,305,14,16,103,456,11,68,45,75,79,120,452,756,6,4588,254,0,2,2,2,83930,33371,6668,44828,1
19,699,182,102,99,11,40,35,193,3,11,6,11,14,17,42,64,1,97,5,0,2,2,2,83930,33372,6668,44829,1
2,153,37,13,25,0,6,6,37,1,2,1,2,3,3,2,4,0,2,0,0,2,1,1,83930,33372,6668,44830,1
2,153,133,47,40,1,43,49,134,0,0,0,0,0,0,0,0,0,0,0,0,2,1,1,83930,33372,6668,44831,1
23,630,601,196,481,2,23,85,603,8,63,36,72,71,108,400,664,4,3036,168,0,2,2,2,83930,33372,6668,44832,1
23,630,156,79,106,5,16,28,161,5,14,8,15,19,23,64,97,2,261,14,0,2,2,2,83930,33372,6668,44833,1
104,4398,1289,550,1043,56,32,155,1345,10,167,93,185,177,278,1266,2075,5,11498,638,0,2,9,10,83930,33374,6669,44834,1
31,963,182,127,129,0,0,53,182,5,39,21,42,44,63,217,343,2,926,51,0,2,7,8,83930,33374,6670,44835,1
151,7198,1392,870,1177,35,17,170,1427,14,494,280,531,508,811,4473,7289,7,54850,3047,2,2,14,15,83930,33377,6671,44836,1
95,2841,773,419,590,28,0,166,801,10,204,113,217,214,330,1598,2554,5,13587,754,0,2,16,16,83930,33377,6672,44837,1
1,52,14,12,10,0,0,4,14,1,2,1,2,3,3,2,4,0,2,0,0,2,1,1,83940,33378,6672,44850,1
1,55,14,12,10,0,0,4,14,1,2,1,2,3,3,2,4,0,2,0,0,2,1,1,83940,33378,6672,44851,1
1,52,14,12,10,0,0,4,14,1,2,1,2,3,3,2,4,0,2,0,0,2,1,1,83940,33378,6672,44852,1
1,71,19,18,14,0,0,5,19,1,2,1,2,3,3,2,4,0,2,0,0,2,2,2,83940,33378,6672,44853,1
3,44,15,10,10,0,0,5,15,2,4,2,4,6,6,10,15,1,15,0,0,2,1,1,83940,33378,6672,44854,1
2,33,10,7,7,0,0,3,10,1,2,1,2,3,3,2,4,0,2,0,0,2,1,1,83940,33378,6672,44855,1
3,43,15,9,9,0,0,6,15,1,4,2,4,5,6,8,13,0,6,0,0,2,1,1,83940,33378,6672,44856,1
12,313,149,95,105,2,0,41,151,8,54,28,55,62,83,334,494,4,2013,111,0,2,3,3,83940,33378,6672,44857,1
15,699,139,89,101,2,0,35,141,7,54,34,62,61,96,330,569,4,2287,127,0,2,4,4,83940,33378,6672,44858,1
3,324,149,67,118,4,0,27,153,1,17,14,28,18,42,69,175,0,144,8,0,2,2,2,83940,33378,6672,44859,1
38,2497,1157,318,931,29,22,177,1186,6,104,63,125,110,188,712,1274,3,4596,255,0,2,1,1,83940,33378,6672,44860,1
65,4371,520,294,400,33,13,81,553,10,261,204,367,271,571,2128,4614,7,32445,1802,1,2,3,3,83940,33379,6672,44861,1
90,3959,1338,495,1086,10,64,173,1348,11,122,82,157,133,239,883,1686,7,11934,663,0,2,11,11,83940,33381,6672,44862,1
172,7590,4293,999,3693,19,54,507,4312,9,155,88,170,164,258,1156,1898,4,9368,520,0,2,15,15,83940,33383,6672,44863,1
172,7590,1482,859,1002,125,135,219,1607,16,219,134,251,235,385,1766,3032,9,27804,1544,1,2,15,15,83950,33384,6672,44864,1
33,984,465,148,393,5,8,60,470,4,31,20,31,35,51,161,261,2,523,29,0,2,5,5,83950,33385,6672,44865,1
33,984,16,12,9,0,0,6,16,1,2,1,2,3,3,2,4,0,2,0,0,2,5,5,83950,33385,6672,44866,1
144,5870,1782,648,1425,9,47,279,1791,8,171,97,189,179,286,1292,2140,4,9462,525,0,2,30,31,83950,33386,6673,44867,1
32,968,256,139,192,9,7,47,265,4,23,12,24,27,36,112,171,2,357,19,0,2,4,7,83950,33387,6673,44868,1
6,328,180,34,164,0,0,16,180,1,12,6,12,13,18,43,66,0,33,1,0,2,0,2,83950,33387,6673,44869,1
19,499,102,59,69,5,3,24,107,6,22,15,28,28,43,113,206,3,789,43,0,2,2,2,83950,33387,6673,44870,1
119,4854,1450,624,1228,12,26,181,1462,14,306,186,354,320,540,2580,4493,8,36391,2021,1,2,23,24,83950,33389,6674,44871,1
176,5109,1660,832,1314,41,38,274,1701,20,312,209,395,332,604,2671,5058,12,64042,3557,1,2,14,15,83950,33391,6675,44873,1
49,3780,996,429,845,24,10,117,1020,7,76,50,88,83,138,494,879,4,3565,198,0,2,5,5,83950,33393,6675,44874,1
120,5083,1513,682,1277,25,13,200,1538,11,199,116,219,210,335,1557,2584,6,15641,868,0,2,10,10,83950,33395,6675,44875,1
84,4871,1296,573,1062,40,33,157,1336,8,201,118,231,209,349,1561,2689,4,12365,686,0,2,11,11,83950,33395,6675,44876,1
20,449,207,111,150,11,0,50,218,5,26,19,36,31,55,133,272,3,943,52,0,2,2,2,83950,33395,6675,44877,1
98,5169,1457,730,1242,11,6,188,1468,10,292,166,329,302,495,2424,4078,5,22973,1276,1,2,20,20,83950,33397,6675,44878,1
43,2669,652,304,544,16,6,88,668,6,89,51,101,95,152,591,998,3,3399,188,0,2,3,3,83950,33398,6675,44879,1
72,3231,1455,414,1257,16,76,112,1471,5,41,23,46,46,69,231,381,2,1069,59,0,2,9,9,83950,33399,6675,44880,1
107,5128,1523,757,1297,19,12,193,1542,12,193,117,230,205,347,1508,2664,7,19053,1058,0,2,12,12,83960,33401,6675,44881,1
70,3177,1020,354,843,12,15,144,1032,8,134,77,144,142,221,970,1580,4,6792,377,0,2,5,5,83960,33401,6675,44882,1
44,2024,447,308,343,6,5,95,453,7,96,59,111,103,170,651,1136,4,4600,255,0,2,8,8,83960,33404,6675,44883,1
21,637,424,94,331,4,0,89,428,1,5,5,5,6,10,11,25,0,12,0,0,2,2,2,83960,33405,6675,44884,1
38,2309,334,251,279,10,4,40,344,5,127,74,143,132,217,899,1528,2,4303,239,0,2,2,2,83960,33406,6675,44885,1
9,423,184,100,137,2,15,30,186,6,38,20,39,44,59,214,322,3,991,55,0,2,3,3,83960,33407,6675,44886,1
75,3937,1293,570,1093,25,15,163,1318,10,195,123,241,205,364,1516,2795,6,17273,959,0,2,5,5,83970,33409,6675,44887,1
29,1873,384,251,317,7,8,52,391,11,70,44,84,81,128,467,811,6,5355,297,0,2,6,6,83970,33409,6675,44888,1
56,2846,722,423,573,19,0,135,741,12,172,101,199,184,300,1320,2257,6,15668,870,0,2,10,10,83970,33411,6675,44890,1
45,1932,386,256,301,16,9,68,402,4,59,35,69,63,104,355,621,2,1453,80,0,2,3,3,83970,33411,6675,44891,1
28,1590,466,257,367,18,25,50,484,7,126,86,171,133,257,898,1813,4,8612,478,0,2,2,2,83970,33411,6675,44892,1
15,1051,215,129,180,6,0,29,221,8,65,43,72,73,115,415,711,4,3153,175,0,2,1,1,83970,33411,6675,44893,1
85,3359,1043,504,840,53,9,147,1096,9,180,112,198,189,310,1377,2344,4,11604,644,0,2,6,6,83970,33413,6675,44894,1
30,1422,373,158,315,8,0,51,381,5,76,44,79,81,123,486,779,2,2026,112,0,2,2,2,83970,33413,6675,44895,1
79,3071,1178,367,1042,6,15,115,1184,9,94,51,95,103,146,644,976,4,4439,246,0,2,6,6,83970,33413,6675,44896,1
111,6048,1943,715,1694,26,18,214,1969,12,185,120,237,197,357,1436,2721,7,20915,1161,0,2,26,26,83970,33415,6675,44897,1
35,1473,442,244,305,14,16,103,456,11,68,45,75,79,120,452,756,6,4588,254,0,2,4,4,83970,33417,6675,44898,1
48,1928,1098,241,925,5,10,155,1103,7,46,25,49,53,74,273,423,3,1580,87,0,2,1,1,83980,33419,6675,44899,1
48,1639,601,196,481,2,23,85,603,8,63,36,72,71,108,400,664,4,3036,168,0,2,1,1,83980,33419,6675,44900,1
104,4398,1289,550,1043,56,32,155,1345,10,167,93,185,177,278,1266,2075,5,11498,638,0,2,2,3,83980,33421,6676,44901,1
38,2497,1157,318,931,29,22,177,1186,6,104,63,125,110,188,712,1274,3,4596,255,0,2,2,4,83980,33421,6676,44902,1
90,3959,1338,495,1086,10,64,173,1348,11,122,82,157,133,239,883,1686,7,11934,663,0,2,2,13,83980,33423,6676,44903,1
172,7590,4293,999,3693,19,54,507,4312,9,155,88,170,164,258,1156,1898,4,9368,520,0,2,0,5,83980,33425,6676,44904,1
172,7590,1482,859,1002,125,135,219,1607,16,219,134,251,235,385,1766,3032,9,27804,1544,1,2,0,5,83990,33426,6676,44905,1
119,4854,1450,624,1228,12,26,181,1462,14,306,186,354,320,540,2580,4493,8,36391,2021,1,2,2,3,83990,33428,6677,44906,1
120,5083,1513,682,1277,25,13,200,1538,11,199,116,219,210,335,1557,2584,6,15641,868,0,2,2,5,83990,33430,6677,44907,1
72,3231,1455,414,1257,16,76,112,1471,5,41,23,46,46,69,231,381,2,1069,59,0,2,2,6,83990,33431,6677,44908,1
107,5128,1523,757,1297,19,12,193,1542,12,193,117,230,205,347,1508,2664,7,19053,1058,0,2,2,2,84000,33433,6677,44909,1
70,3177,1020,354,843,12,15,144,1032,8,134,77,144,142,221,970,1580,4,6792,377,0,2,0,1,84000,33433,6677,44910,1
21,637,424,94,331,4,0,89,428,1,5,5,5,6,10,11,25,0,12,0,0,2,2,3,84000,33434,6677,44911,1
9,423,184,100,137,2,15,30,186,6,38,20,39,44,59,214,322,3,991,55,0,2,2,3,84000,33435,6677,44912,1
29,1873,384,251,317,7,8,52,391,11,70,44,84,81,128,467,811,6,5355,297,0,2,3,4,84000,33435,6677,44913,1
85,3359,1043,504,840,53,9,147,1096,9,180,112,198,189,310,1377,2344,4,11604,644,0,2,4,6,84000,33437,6677,44914,1
48,1639,601,196,481,2,23,85,603,8,63,36,72,71,108,400,664,4,3036,168,0,2,2,3,84000,33437,6677,44915,1
228,5833,722,423,573,19,0,135,741,12,172,101,199,184,300,1320,2257,6,15668,870,0,2,4,5,84000,33439,6677,44917,0
228,5833,1508,847,911,44,250,301,1552,14,148,88,169,162,257,1120,1886,7,15077,837,0,2,4,5,84000,33440,6678,44918,0
38,2493,1157,318,931,29,22,177,1186,6,104,63,125,110,188,712,1274,3,4596,255,0,2,0,1,84000,33440,6678,44919,0
1,92,42,7,35,4,0,5,46,1,2,1,2,3,3,2,4,0,2,0,0,2,0,1,84000,33440,6678,44920,0
1,92,11,6,10,0,0,1,11,2,4,2,4,6,6,10,15,1,15,0,0,2,0,1,84000,33440,6678,44921,0
174,5263,1660,832,1314,41,38,274,1701,20,312,209,395,332,604,2671,5058,12,64042,3557,1,2,1,2,84000,33442,6679,44923,0
174,5263,1057,646,719,113,100,145,1170,18,215,134,248,233,382,1740,3004,10,31186,1732,1,2,1,2,84010,33443,6680,44924,0
251,5822,4293,999,3693,19,54,507,4312,9,155,88,170,164,258,1156,1898,4,9368,520,0,2,5,5,84010,33445,6680,44925,0
251,5822,1482,859,1002,125,135,219,1607,16,219,134,251,235,385,1766,3032,9,27804,1544,1,2,5,5,84020,33446,6680,44926,0
104,2739,773,422,505,30,103,129,803,14,77,46,83,91,129,535,839,7,6334,351,0,2,23,28,84030,33447,6681,44927,0
89,1896,1043,504,840,53,9,147,1096,9,180,112,198,189,310,1377,2344,4,11604,644,0,2,6,4,84030,33449,6681,44928,0
89,1896,383,288,292,26,6,62,409,11,65,38,67,76,105,429,656,5,3719,206,0,2,6,4,84030,33450,6681,44929,0
95,2839,773,419,590,28,0,166,801,10,204,113,217,214,330,1598,2554,5,13587,754,0,2,0,2,84030,33450,6682,44930,0
3,305,149,67,118,4,0,27,153,1,17,14,28,18,42,69,175,0,144,8,0,2,0,5,84030,33450,6682,44931,0
38,2493,1157,318,931,29,22,177,1186,6,104,63,125,110,188,712,1274,3,4596,255,0,2,2,3,84030,33450,6682,44932,0
172,7590,4293,999,3693,19,54,507,4312,9,155,88,170,164,258,1156,1898,4,9368,520,0,2,2,3,84030,33452,6682,44933,0
172,7590,1482,859,1002,125,135,219,1607,16,219,134,251,235,385,1766,3032,9,27804,1544,1,2,2,3,84040,33453,6682,44934,0
144,5870,1782,648,1425,9,47,279,1791,8,171,97,189,179,286,1292,2140,4,9462,525,0,2,2,2,84040,33454,6683,44935,0
48,1928,1098,241,925,5,10,155,1103,7,46,25,49,53,74,273,423,3,1580,87,0,2,1,1,84050,33456,6683,44936,0
48,1639,601,196,481,2,23,85,603,8,63,36,72,71,108,400,664,4,3036,168,0,2,1,1,84050,33456,6683,44937,0
95,2843,773,419,590,28,0,166,801,10,204,113,217,214,330,1598,2554,5,13587,754,0,2,1,1,84050,33456,6684,44938,0
3,299,149,67,118,4,0,27,153,1,17,14,28,18,42,69,175,0,144,8,0,2,2,2,84050,33456,6684,44939,0
3,42,14,8,8,0,0,6,14,0,0,0,0,0,0,0,0,0,0,0,0,2,0,1,84050,33456,6684,44942,0
2,34,9,6,6,0,0,3,9,0,0,0,0,0,0,0,0,0,0,0,0,2,0,3,84050,33456,6684,44943,0
2,34,13,9,8,0,0,4,13,0,0,0,0,0,0,0,0,0,0,0,0,2,0,3,84050,33456,6684,44944,0
1,313,382,65,130,157,2,92,539,4,10,5,10,14,15,41,57,2,114,6,0,2,9,10,84050,33457,6685,44946,0
60,1118,282,196,195,3,0,86,285,8,130,71,141,138,212,936,1507,4,6538,363,0,2,15,16,84060,33458,6686,44959,0
4,77,127,75,83,2,11,30,129,4,14,7,14,18,21,61,87,2,175,9,0,2,0,1,84060,33458,6686,44960,0
4,77,652,304,544,16,6,88,668,6,89,51,101,95,152,591,998,3,3399,188,0,2,0,1,84060,33459,6686,44961,0
4,77,2,2,2,0,0,0,2,0,0,0,0,0,0,0,0,0,0,0,0,2,0,1,84060,33459,6686,44961,0
4,77,8,5,5,0,0,3,8,0,0,0,0,0,0,0,0,0,0,0,0,2,0,1,84060,33459,6686,44962,0
4,77,2,2,2,0,0,0,2,0,0,0,0,0,0,0,0,0,0,0,0,2,0,1,84060,33459,6686,44962,0
4,77,14,8,8,0,0,6,14,0,0,0,0,0,0,0,0,0,0,0,0,2,0,1,84060,33459,6686,44963,0
4,77,6,4,4,0,0,2,6,0,0,0,0,0,0,0,0,0,0,0,0,2,0,1,84060,33459,6686,44964,0
4,77,6,4,4,0,0,2,6,1,2,1,2,3,3,2,4,0,2,0,0,2,0,1,84060,33459,6686,44965,0
4,77,6,4,4,0,0,2,6,0,0,0,0,0,0,0,0,0,0,0,0,2,0,1,84060,33459,6686,44966,0
4,77,7,5,5,0,0,2,7,0,0,0,0,0,0,0,0,0,0,0,0,2,0,1,84060,33459,6686,44967,0
4,77,6,4,4,0,0,2,6,0,0,0,0,0,0,0,0,0,0,0,0,2,0,1,84060,33459,6686,44968,0
4,77,10,6,6,0,0,4,10,0,0,0,0,0,0,0,0,0,0,0,0,2,0,1,84060,33459,6686,44969,0
4,77,1,1,1,0,0,0,1,0,0,0,0,0,0,0,0,0,0,0,0,2,0,1,84060,33459,6686,44969,0
4,77,14,10,10,0,0,4,14,1,1,1,1,2,2,0,2,0,1,0,0,2,0,1,84060,33459,6686,44970,0
4,77,46,26,30,3,0,12,49,3,6,3,6,9,9,20,28,1,42,2,0,2,0,1,84070,33459,6686,44971,0
1,9,5,3,3,0,0,2,5,0,0,0,0,0,0,0,0,0,0,0,0,2,0,1,84070,33459,6686,44971,0
1,90,13,10,10,0,0,3,13,1,2,1,2,3,3,2,4,0,2,0,0,2,0,1,84070,33459,6686,44972,0
7,111,44,19,17,0,16,11,44,3,14,7,14,17,21,58,85,1,128,7,0,2,1,2,84070,33459,6686,44973,0
3,63,127,75,83,2,11,30,129,4,14,7,14,18,21,61,87,2,175,9,0,2,1,2,84080,33460,6686,44986,0
3,63,652,304,544,16,6,88,668,6,89,51,101,95,152,591,998,3,3399,188,0,2,1,2,84080,33461,6686,44987,0
3,63,2,2,2,0,0,0,2,0,0,0,0,0,0,0,0,0,0,0,0,2,1,2,84080,33461,6686,44987,0
3,63,8,5,5,0,0,3,8,0,0,0,0,0,0,0,0,0,0,0,0,2,1,2,84080,33461,6686,44988,0
3,63,2,2,2,0,0,0,2,0,0,0,0,0,0,0,0,0,0,0,0,2,1,2,84080,33461,6686,44988,0
3,63,14,8,8,0,0,6,14,0,0,0,0,0,0,0,0,0,0,0,0,2,1,2,84080,33461,6686,44989,0
3,63,6,4,4,0,0,2,6,0,0,0,0,0,0,0,0,0,0,0,0,2,1,2,84080,33461,6686,44990,0
3,63,6,4,4,0,0,2,6,1,2,1,2,3,3,2,4,0,2,0,0,2,1,2,84080,33461,6686,44991,0
3,63,6,4,4,0,0,2,6,0,0,0,0,0,0,0,0,0,0,0,0,2,1,2,84080,33461,6686,44992,0
3,63,7,5,5,0,0,2,7,0,0,0,0,0,0,0,0,0,0,0,0,2,1,2,84080,33461,6686,44993,0
3,63,6,4,4,0,0,2,6,0,0,0,0,0,0,0,0,0,0,0,0,2,1,2,84080,33461,6686,44994,0
3,63,10,6,6,0,0,4,10,0,0,0,0,0,0,0,0,0,0,0,0,2,1,2,84080,33461,6686,44995,0
3,63,1,1,1,0,0,0,1,0,0,0,0,0,0,0,0,0,0,0,0,2,1,2,84080,33461,6686,44995,0
3,63,14,10,10,0,0,4,14,1,1,1,1,2,2,0,2,0,1,0,0,2,1,2,84080,33461,6686,44996,0
3,63,46,26,30,3,0,12,49,3,6,3,6,9,9,20,28,1,42,2,0,2,1,2,84090,33461,6686,44997,0
7,293,72,33,56,0,4,12,72,1,1,1,1,2,2,0,2,0,1,0,0,2,1,2,84110,33469,6688,45012,0
12,226,127,75,83,2,11,30,129,4,14,7,14,18,21,61,87,2,175,9,0,2,1,2,84110,33469,6688,45013,0
12,226,652,304,544,16,6,88,668,6,89,51,101,95,152,591,998,3,3399,188,0,2,1,2,84110,33470,6688,45014,0
12,226,2,2,2,0,0,0,2,0,0,0,0,0,0,0,0,0,0,0,0,2,1,2,84110,33470,6688,45014,0
12,226,8,5,5,0,0,3,8,0,0,0,0,0,0,0,0,0,0,0,0,2,1,2,84110,33470,6688,45015,0
12,226,2,2,2,0,0,0,2,0,0,0,0,0,0,0,0,0,0,0,0,2,1,2,84110,33470,6688,45015,0
12,226,14,8,8,0,0,6,14,0,0,0,0,0,0,0,0,0,0,0,0,2,1,2,84110,33470,6688,45016,0
12,226,6,4,4,0,0,2,6,0,0,0,0,0,0,0,0,0,0,0,0,2,1,2,84110,33470,6688,45017,0
12,226,6,4,4,0,0,2,6,1,2,1,2,3,3,2,4,0,2,0,0,2,1,2,84110,33470,6688,45018,0
12,226,6,4,4,0,0,2,6,0,0,0,0,0,0,0,0,0,0,0,0,2,1,2,84110,33470,6688,45019,0
12,226,7,5,5,0,0,2,7,0,0,0,0,0,0,0,0,0,0,0,0,2,1,2,84110,33470,6688,45020,0
12,226,6,4,4,0,0,2,6,0,0,0,0,0,0,0,0,0,0,0,0,2,1,2,84110,33470,6688,45021,0
12,226,10,6,6,0,0,4,10,0,0,0,0,0,0,0,0,0,0,0,0,2,1,2,84110,33470,6688,45022,0
12,226,1,1,1,0,0,0,1,0,0,0,0,0,0,0,0,0,0,0,0,2,1,2,84110,33470,6688,45022,0
12,226,14,10,10,0,0,4,14,1,1,1,1,2,2,0,2,0,1,0,0,2,1,2,84110,33470,6688,45023,0
12,226,46,26,30,3,0,12,49,3,6,3,6,9,9,20,28,1,42,2,0,2,1,2,84120,33470,6688,45024,0
6,71,127,75,83,2,11,30,129,4,14,7,14,18,21,61,87,2,175,9,0,2,0,1,84120,33470,6688,45025,0
6,71,652,304,544,16,6,88,668,6,89,51,101,95,152,591,998,3,3399,188,0,2,0,1,84120,33471,6688,45026,0
6,71,2,2,2,0,0,0,2,0,0,0,0,0,0,0,0,0,0,0,0,2,0,1,84120,33471,6688,45026,0
6,71,8,5,5,0,0,3,8,0,0,0,0,0,0,0,0,0,0,0,0,2,0,1,84120,33471,6688,45027,0
6,71,2,2,2,0,0,0,2,0,0,0,0,0,0,0,0,0,0,0,0,2,0,1,84120,33471,6688,45027,0
6,71,14,8,8,0,0,6,14,0,0,0,0,0,0,0,0,0,0,0,0,2,0,1,84120,33471,6688,45028,0
6,71,6,4,4,0,0,2,6,0,0,0,0,0,0,0,0,0,0,0,0,2,0,1,84120,33471,6688,45029,0
6,71,6,4,4,0,0,2,6,1,2,1,2,3,3,2,4,0,2,0,0,2,0,1,84120,33471,6688,45030,0
6,71,6,4,4,0,0,2,6,0,0,0,0,0,0,0,0,0,0,0,0,2,0,1,84120,33471,6688,45031,0
6,71,7,5,5,0,0,2,7,0,0,0,0,0,0,0,0,0,0,0,0,2,0,1,84120,33471,6688,45032,0
6,71,6,4,4,0,0,2,6,0,0,0,0,0,0,0,0,0,0,0,0,2,0,1,84120,33471,6688,45033,0
6,71,10,6,6,0,0,4,10,0,0,0,0,0,0,0,0,0,0,0,0,2,0,1,84120,33471,6688,45034,0
6,71,1,1,1,0,0,0,1,0,0,0,0,0,0,0,0,0,0,0,0,2,0,1,84120,33471,6688,45034,0
6,71,14,10,10,0,0,4,14,1,1,1,1,2,2,0,2,0,1,0,0,2,0,1,84120,33471,6688,45035,0
6,71,46,26,30,3,0,12,49,3,6,3,6,9,9,20,28,1,42,2,0,2,0,1,84130,33471,6688,45036,0
3,23,14,7,7,2,0,5,16,0,0,0,0,0,0,0,0,0,0,0,0,2,1,2,84130,33471,6688,45036,0
7,103,38,23,23,0,0,15,38,0,0,0,0,0,0,0,0,0,0,0,0,2,0,1,84130,33471,6688,45037,0
17,378,85,59,61,8,0,16,93,5,18,10,18,23,28,86,126,2,316,17,0,2,0,1,84130,33471,6688,45038,0
12,515,124,78,88,2,3,26,126,4,13,7,13,17,20,56,81,2,163,9,0,2,0,1,84130,33471,6688,45041,0
1,92,42,7,35,4,0,5,46,1,2,1,2,3,3,2,4,0,2,0,0,2,0,2,84130,33471,6688,45042,0
1,92,11,6,10,0,0,1,11,2,4,2,4,6,6,10,15,1,15,0,0,2,0,2,84130,33471,6688,45043,0
11,227,19,8,11,5,0,4,24,2,5,3,6,7,9,13,25,1,30,1,0,2,1,6,84140,33475,6689,45051,0
11,227,102,59,69,5,3,24,107,6,22,15,28,28,43,113,206,3,789,43,0,2,1,6,84140,33475,6689,45052,0
11,227,106,40,36,3,49,17,109,8,17,13,23,25,36,93,167,5,904,50,0,2,1,6,84140,33475,6689,45053,0
221,4718,182,127,129,0,0,53,182,5,39,21,42,44,63,217,343,2,926,51,0,2,19,22,84150,33479,6691,45061,0
221,4718,1165,710,800,67,119,181,1232,18,243,153,282,261,435,2000,3492,10,36473,2026,1,2,19,22,84160,33479,6692,45062,0
67,1551,773,419,590,28,0,166,801,10,204,113,217,214,330,1598,2554,5,13587,754,0,2,2,8,84160,33479,6693,45063,0
67,1551,421,273,302,44,34,57,465,17,81,59,107,98,166,583,1098,11,12329,684,0,2,2,8,84160,33479,6694,45064,0
14,404,149,95,105,2,0,41,151,8,54,28,55,62,83,334,494,4,2013,111,0,2,6,11,84160,33479,6694,45065,0
14,404,82,56,54,0,13,15,82,4,13,8,16,17,24,56,98,2,241,13,0,2,6,11,84170,33479,6694,45066,0
25,489,2,2,2,0,0,0,2,0,0,0,0,0,0,0,0,0,0,0,0,2,3,10,84170,33479,6694,45066,0
25,489,99,48,90,1,3,5,100,0,0,0,0,0,0,0,0,0,0,0,0,2,3,10,84170,33480,6694,45067,0
25,489,8,5,5,2,0,1,10,0,0,0,0,0,0,0,0,0,0,0,0,2,3,10,84170,33480,6694,45068,0
25,489,1217,716,841,84,126,174,1301,14,185,118,215,199,333,1446,2542,8,20687,1149,0,2,3,10,84180,33482,6694,45069,0
25,489,160,89,115,0,13,31,160,7,15,11,17,22,28,78,124,3,495,27,0,2,3,10,84180,33482,6694,45070,0
25,489,10,10,9,9,0,0,19,0,0,0,0,0,0,0,0,0,0,0,0,2,3,10,84180,33482,6695,45071,0
25,489,173,84,99,8,29,36,181,5,12,7,13,17,20,54,81,2,221,12,0,2,3,10,84180,33483,6695,45072,0
25,489,3,1,1,3,0,0,6,0,0,0,0,0,0,0,0,0,0,0,0,2,3,10,84180,33483,6695,45073,0
174,5263,1660,832,1314,41,38,274,1701,20,312,209,395,332,604,2671,5058,12,64042,3557,1,2,34,36,84180,33485,6696,45075,0
174,5263,1057,646,719,113,100,145,1170,18,215,134,248,233,382,1740,3004,10,31186,1732,1,2,34,36,84190,33486,6697,45076,0
17,327,95,58,50,9,16,20,104,12,33,24,45,45,69,209,378,8,3100,172,0,2,1,8,84190,33486,6697,45077,0
116,2120,477,336,357,30,23,73,507,16,194,134,250,210,384,1538,2962,10,30538,1696,0,2,43,46,84200,33487,6697,45078,0
90,2017,996,429,845,24,10,117,1020,7,76,50,88,83,138,494,879,4,3565,198,0,2,7,13,84200,33489,6697,45079,0
90,2017,456,277,329,12,42,72,468,13,85,50,97,98,147,592,972,7,7212,400,0,2,7,13,84200,33489,6697,45080,0
160,3411,1513,682,1277,25,13,200,1538,11,199,116,219,210,335,1557,2584,6,15641,868,0,2,19,33,84200,33491,6697,45081,0
160,3411,819,519,539,24,98,155,843,15,96,57,106,111,163,690,1107,8,9171,509,0,2,19,33,84210,33493,6697,45082,0
59,1095,207,111,150,11,0,50,218,5,26,19,36,31,55,133,272,3,943,52,0,2,5,12,84210,33493,6697,45083,0
59,1095,410,198,237,31,55,97,441,11,63,38,72,74,110,414,683,6,4293,238,0,2,5,12,84220,33494,6698,45084,0
235,4869,2,2,2,0,0,0,2,0,0,0,0,0,0,0,0,0,0,0,0,2,20,29,84220,33494,6698,45084,0
235,4869,99,48,90,1,3,5,100,0,0,0,0,0,0,0,0,0,0,0,0,2,20,29,84220,33495,6698,45085,0
235,4869,8,5,5,2,0,1,10,0,0,0,0,0,0,0,0,0,0,0,0,2,20,29,84220,33495,6698,45086,0
235,4869,1217,716,841,84,126,174,1301,14,185,118,215,199,333,1446,2542,8,20687,1149,0,2,20,29,84230,33497,6698,45087,0
235,4869,160,89,115,0,13,31,160,7,15,11,17,22,28,78,124,3,495,27,0,2,20,29,84230,33497,6698,45088,0
235,4869,10,10,9,9,0,0,19,0,0,0,0,0,0,0,0,0,0,0,0,2,20,29,84230,33497,6699,45089,0
235,4869,173,84,99,8,29,36,181,5,12,7,13,17,20,54,81,2,221,12,0,2,20,29,84230,33498,6699,45090,0
235,4869,3,1,1,3,0,0,6,0,0,0,0,0,0,0,0,0,0,0,0,2,20,29,84230,33498,6699,45091,0
98,2010,463,295,324,28,62,57,491,12,134,82,154,146,236,989,1696,6,11700,650,0,2,8,10,84240,33499,6699,45092,0
55,770,167,116,138,4,5,22,171,8,48,30,56,56,86,292,499,4,2330,129,0,2,0,1,84240,33499,6699,45093,0
57,1484,339,213,244,17,9,65,356,10,42,26,48,52,74,259,421,5,2410,133,0,2,11,16,84250,33499,6699,45094,0
90,2288,1455,414,1257,16,76,112,1471,5,41,23,46,46,69,231,381,2,1069,59,0,2,4,9,84250,33500,6699,45096,0
90,2288,669,365,481,22,61,110,691,15,103,63,122,118,185,747,1273,8,11311,628,0,2,4,9,84260,33500,6700,45097,0
251,5822,4293,999,3693,19,54,507,4312,9,155,88,170,164,258,1156,1898,4,9368,520,0,2,18,25,84260,33502,6700,45098,0
251,5822,1482,859,1002,125,135,219,1607,16,219,134,251,235,385,1766,3032,9,27804,1544,1,2,18,25,84270,33503,6700,45099,0
6,128,44,22,19,0,19,6,44,2,10,6,12,12,18,35,64,1,77,4,0,2,0,4,84270,33503,6700,45100,0
31,1078,74,35,59,1,0,14,75,3,14,7,14,17,21,58,85,1,128,7,0,2,9,12,84270,33504,6700,45101,0
31,1078,245,125,200,5,7,34,250,7,30,17,34,37,51,166,265,3,1053,58,0,2,9,12,84280,33505,6700,45102,0
54,657,647,139,84,35,284,233,682,0,0,0,0,0,0,0,0,0,0,0,0,2,0,1,84280,33505,6700,45103,0
117,3127,1523,757,1297,19,12,193,1542,12,193,117,230,205,347,1508,2664,7,19053,1058,0,2,10,16,84290,33507,6700,45104,0
117,3127,701,378,504,33,58,109,734,13,110,68,126,123,194,794,1346,7,10027,557,0,2,10,16,84290,33508,6701,45105,0
104,2739,773,422,505,30,103,129,803,14,77,46,83,91,129,535,839,7,6334,351,0,2,28,38,84300,33509,6702,45106,0
146,3571,77,34,69,0,0,8,77,3,24,16,29,27,45,114,213,1,387,21,0,2,13,26,84300,33509,6702,45107,0
146,3571,712,438,573,51,9,84,763,14,102,71,128,116,199,733,1364,8,11988,666,0,2,13,26,84310,33510,6702,45108,0
24,600,2,2,2,0,0,0,2,0,0,0,0,0,0,0,0,0,0,0,0,2,0,5,84310,33510,6702,45108,0
24,600,99,48,90,1,3,5,100,0,0,0,0,0,0,0,0,0,0,0,0,2,0,5,84310,33511,6702,45109,0
24,600,8,5,5,2,0,1,10,0,0,0,0,0,0,0,0,0,0,0,0,2,0,5,84310,33511,6702,45110,0
24,600,1217,716,841,84,126,174,1301,14,185,118,215,199,333,1446,2542,8,20687,1149,0,2,0,5,84320,33513,6702,45111,0
24,600,160,89,115,0,13,31,160,7,15,11,17,22,28,78,124,3,495,27,0,2,0,5,84320,33513,6702,45112,0
24,600,10,10,9,9,0,0,19,0,0,0,0,0,0,0,0,0,0,0,0,2,0,5,84320,33513,6703,45113,0
24,600,173,84,99,8,29,36,181,5,12,7,13,17,20,54,81,2,221,12,0,2,0,5,84320,33514,6703,45114,0
24,600,3,1,1,3,0,0,6,0,0,0,0,0,0,0,0,0,0,0,0,2,0,5,84320,33514,6703,45115,0
30,657,125,97,103,3,0,19,128,9,25,17,27,34,44,144,223,4,1087,60,0,2,2,5,84320,33514,6704,45116,0
22,367,102,57,55,5,16,25,107,5,17,10,18,22,28,81,124,2,330,18,0,2,2,3,84320,33514,6704,45117,0
71,1560,402,202,227,24,74,80,426,12,52,33,61,64,94,339,564,7,3969,220,0,2,7,9,84320,33515,6704,45118,0
51,1090,447,308,343,6,5,95,453,7,96,59,111,103,170,651,1136,4,4600,255,0,2,13,16,84320,33518,6704,45119,0
51,1090,322,174,179,16,74,51,338,10,41,26,46,51,72,252,408,5,2291,127,0,2,13,16,84320,33521,6705,45120,0
75,1603,53,23,39,0,0,13,53,2,8,4,8,10,12,26,39,1,39,2,0,2,6,14,84320,33521,6705,45121,0
75,1603,515,298,307,33,80,99,548,12,63,44,77,75,121,419,753,7,5527,307,0,2,6,14,84330,33521,6705,45122,0
18,296,424,94,331,4,0,89,428,1,5,5,5,6,10,11,25,0,12,0,0,2,1,8,84330,33522,6705,45123,0
18,296,38,23,23,6,0,8,44,3,11,7,11,14,18,42,68,1,102,5,0,2,1,8,84330,33522,6705,45124,0
19,499,205,80,86,16,53,53,221,7,18,10,19,25,29,94,134,3,497,27,0,2,3,8,84340,33522,6706,45125,0
15,476,184,100,137,2,15,30,186,6,38,20,39,44,59,214,322,3,991,55,0,2,3,10,84340,33523,6706,45126,0
15,476,103,65,74,8,5,16,111,7,17,9,17,24,26,89,119,3,417,23,0,2,3,10,84340,33524,6706,45127,0
58,1189,91,45,69,0,3,18,91,3,9,6,10,12,16,33,57,1,95,5,0,2,5,8,84340,33526,6706,45128,0
58,1189,367,234,237,17,34,68,384,16,55,34,61,71,95,381,584,8,5183,287,0,2,5,8,84340,33527,6706,45129,0
228,5833,722,423,573,19,0,135,741,12,172,101,199,184,300,1320,2257,6,15668,870,0,2,38,43,84340,33529,6706,45131,0
228,5833,1508,847,911,44,250,301,1552,14,148,88,169,162,257,1120,1886,7,15077,837,0,2,38,43,84340,33530,6707,45132,0
314,6872,72,33,56,0,4,12,72,1,1,1,1,2,2,0,2,0,1,0,0,2,20,28,84340,33530,6707,45133,0
314,6872,1454,835,1044,76,110,219,1530,17,275,158,296,292,454,2297,3718,9,34017,1889,1,2,20,28,84350,33531,6707,45134,0
89,1801,757,253,292,73,244,162,830,13,61,38,67,74,105,409,651,7,4654,258,0,2,3,7,84350,33532,6707,45135,0
38,787,386,256,301,16,9,68,402,4,59,35,69,63,104,355,621,2,1453,80,0,2,5,10,84350,33532,6707,45136,0
38,787,264,131,164,11,41,46,275,6,38,22,40,44,62,214,338,3,1068,59,0,2,5,10,84360,33532,6708,45137,0
67,1747,466,257,367,18,25,50,484,7,126,86,171,133,257,898,1813,4,8612,478,0,2,9,19,84360,33532,6708,45138,0
67,1747,507,281,342,29,59,88,536,10,53,29,57,63,86,336,514,5,2764,153,0,2,9,19,84360,33532,6708,45139,0
25,538,215,129,180,6,0,29,221,8,65,43,72,73,115,415,711,4,3153,175,0,2,2,7,84360,33532,6708,45140,0
25,538,97,69,77,3,3,16,100,6,22,13,23,28,36,113,173,3,542,30,0,2,2,7,84360,33533,6708,45141,0
89,1896,1043,504,840,53,9,147,1096,9,180,112,198,189,310,1377,2344,4,11604,644,0,2,9,12,84360,33535,6708,45142,0
89,1896,383,288,292,26,6,62,409,11,65,38,67,76,105,429,656,5,3719,206,0,2,9,12,84360,33536,6708,45143,0
20,408,294,64,250,0,0,43,294,1,20,10,20,21,30,86,131,0,65,3,0,2,0,5,84360,33536,6708,45144,0
20,408,78,46,62,3,0,14,81,3,8,4,8,11,12,28,41,1,62,3,0,2,0,5,84360,33537,6708,45145,0
5,111,110,30,77,3,13,16,113,4,21,15,30,25,45,100,208,2,597,33,0,2,0,5,84360,33537,6708,45146,0
5,111,28,15,21,1,0,6,29,0,0,0,0,0,0,0,0,0,0,0,0,2,0,5,84360,33537,6708,45147,0
40,784,1178,367,1042,6,15,115,1184,9,94,51,95,103,146,644,976,4,4439,246,0,2,0,5,84360,33537,6708,45148,0
40,784,177,108,140,8,0,27,185,6,30,16,32,36,48,162,248,3,794,44,0,2,0,5,84360,33539,6708,45149,0
28,452,219,78,157,11,5,46,230,3,24,20,34,27,54,114,256,2,545,30,0,2,0,1,84360,33540,6708,45150,0
28,452,108,64,79,9,0,20,117,5,15,11,19,20,30,70,129,3,410,22,0,2,0,1,84360,33540,6708,45151,0
280,5869,1943,715,1694,26,18,214,1969,12,185,120,237,197,357,1436,2721,7,20915,1161,0,2,19,27,84360,33542,6708,45152,0
280,5869,1168,838,957,57,25,144,1225,19,348,224,416,367,640,3018,5452,11,61921,3440,1,2,19,27,84370,33544,6708,45153,0
19,699,442,244,305,14,16,103,456,11,68,45,75,79,120,452,756,6,4588,254,0,2,2,7,84370,33546,6708,45154,0
19,699,182,102,99,11,40,35,193,3,11,6,11,14,17,42,64,1,97,5,0,2,2,7,84370,33547,6708,45155,0
65,1251,1098,241,925,5,10,155,1103,7,46,25,49,53,74,273,423,3,1580,87,0,2,0,5,84380,33549,6708,45156,0
65,1251,282,202,222,14,2,44,296,8,42,24,43,50,67,250,378,4,1548,86,0,2,0,5,84380,33550,6708,45157,0
2,153,37,13,25,0,6,6,37,1,2,1,2,3,3,2,4,0,2,0,0,2,1,2,84380,33550,6708,45158,0
2,153,133,47,40,1,43,49,134,0,0,0,0,0,0,0,0,0,0,0,0,2,1,2,84380,33550,6708,45159,0
23,630,601,196,481,2,23,85,603,8,63,36,72,71,108,400,664,4,3036,168,0,2,2,7,84380,33550,6708,45160,0
23,630,156,79,106,5,16,28,161,5,14,8,15,19,23,64,97,2,261,14,0,2,2,7,84380,33550,6708,45161,0
104,4398,1289,550,1043,56,32,155,1345,10,167,93,185,177,278,1266,2075,5,11498,638,0,2,10,17,84380,33552,6709,45162,0
31,963,182,127,129,0,0,53,182,5,39,21,42,44,63,217,343,2,926,51,0,2,7,13,84380,33552,6710,45163,0
151,7198,1392,870,1177,35,17,170,1427,14,494,280,531,508,811,4473,7289,7,54850,3047,2,2,15,21,84380,33555,6711,45164,0
95,2843,773,419,590,28,0,166,801,10,204,113,217,214,330,1598,2554,5,13587,754,0,2,17,24,84380,33555,6712,45165,0
6,163,127,75,83,2,11,30,129,4,14,7,14,18,21,61,87,2,175,9,0,2,0,1,84380,33555,6712,45166,0
6,163,652,304,544,16,6,88,668,6,89,51,101,95,152,591,998,3,3399,188,0,2,0,1,84380,33556,6712,45167,0
6,163,2,2,2,0,0,0,2,0,0,0,0,0,0,0,0,0,0,0,0,2,0,1,84380,33556,6712,45167,0
6,163,8,5,5,0,0,3,8,0,0,0,0,0,0,0,0,0,0,0,0,2,0,1,84380,33556,6712,45168,0
6,163,2,2,2,0,0,0,2,0,0,0,0,0,0,0,0,0,0,0,0,2,0,1,84380,33556,6712,45168,0
6,163,14,8,8,0,0,6,14,0,0,0,0,0,0,0,0,0,0,0,0,2,0,1,84380,33556,6712,45169,0
6,163,6,4,4,0,0,2,6,0,0,0,0,0,0,0,0,0,0,0,0,2,0,1,84380,33556,6712,45170,0
6,163,6,4,4,0,0,2,6,1,2,1,2,3,3,2,4,0,2,0,0,2,0,1,84380,33556,6712,45171,0
6,163,6,4,4,0,0,2,6,0,0,0,0,0,0,0,0,0,0,0,0,2,0,1,84380,33556,6712,45172,0
6,163,7,5,5,0,0,2,7,0,0,0,0,0,0,0,0,0,0,0,0,2,0,1,84380,33556,6712,45173,0
6,163,6,4,4,0,0,2,6,0,0,0,0,0,0,0,0,0,0,0,0,2,0,1,84380,33556,6712,45174,0
6,163,10,6,6,0,0,4,10,0,0,0,0,0,0,0,0,0,0,0,0,2,0,1,84380,33556,6712,45175,0
6,163,1,1,1,0,0,0,1,0,0,0,0,0,0,0,0,0,0,0,0,2,0,1,84380,33556,6712,45175,0
6,163,14,10,10,0,0,4,14,1,1,1,1,2,2,0,2,0,1,0,0,2,0,1,84380,33556,6712,45176,0
6,163,46,26,30,3,0,12,49,3,6,3,6,9,9,20,28,1,42,2,0,2,0,1,84390,33556,6712,45177,0
14,833,75,38,59,1,3,12,76,2,4,2,4,6,6,10,15,1,15,0,0,2,0,5,84390,33556,6712,45178,0
2,58,16,12,9,0,0,6,16,1,2,1,2,3,3,2,4,0,2,0,0,2,0,1,84390,33556,6712,45179,0
1,6,2,2,2,0,0,0,2,0,0,0,0,0,0,0,0,0,0,0,0,2,0,1,84390,33556,6712,45179,0
1,6,99,48,90,1,3,5,100,0,0,0,0,0,0,0,0,0,0,0,0,2,0,1,84390,33557,6712,45180,0
1,6,8,5,5,2,0,1,10,0,0,0,0,0,0,0,0,0,0,0,0,2,0,1,84390,33557,6712,45181,0
1,6,1217,716,841,84,126,174,1301,14,185,118,215,199,333,1446,2542,8,20687,1149,0,2,0,1,84400,33559,6712,45182,0
1,6,160,89,115,0,13,31,160,7,15,11,17,22,28,78,124,3,495,27,0,2,0,1,84400,33559,6712,45183,0
1,6,10,10,9,9,0,0,19,0,0,0,0,0,0,0,0,0,0,0,0,2,0,1,84400,33559,6713,45184,0
1,6,173,84,99,8,29,36,181,5,12,7,13,17,20,54,81,2,221,12,0,2,0,1,84400,33560,6713,45185,0
1,6,3,1,1,3,0,0,6,0,0,0,0,0,0,0,0,0,0,0,0,2,0,1,84400,33560,6713,45186,0
1,6,2,2,2,0,0,0,2,0,0,0,0,0,0,0,0,0,0,0,0,2,0,1,84400,33560,6713,45186,0
1,8,127,75,83,2,11,30,129,4,14,7,14,18,21,61,87,2,175,9,0,2,0,1,84400,33560,6713,45187,0
1,8,652,304,544,16,6,88,668,6,89,51,101,95,152,591,998,3,3399,188,0,2,0,1,84400,33561,6713,45188,0
1,8,2,2,2,0,0,0,2,0,0,0,0,0,0,0,0,0,0,0,0,2,0,1,84400,33561,6713,45188,0
1,8,8,5,5,0,0,3,8,0,0,0,0,0,0,0,0,0,0,0,0,2,0,1,84400,33561,6713,45189,0
1,8,2,2,2,0,0,0,2,0,0,0,0,0,0,0,0,0,0,0,0,2,0,1,84400,33561,6713,45189,0
1,8,14,8,8,0,0,6,14,0,0,0,0,0,0,0,0,0,0,0,0,2,0,1,84400,33561,6713,45190,0
1,8,6,4,4,0,0,2,6,0,0,0,0,0,0,0,0,0,0,0,0,2,0,1,84400,33561,6713,45191,0
1,8,6,4,4,0,0,2,6,1,2,1,2,3,3,2,4,0,2,0,0,2,0,1,84400,33561,6713,45192,0
1,8,6,4,4,0,0,2,6,0,0,0,0,0,0,0,0,0,0,0,0,2,0,1,84400,33561,6713,45193,0
1,8,7,5,5,0,0,2,7,0,0,0,0,0,0,0,0,0,0,0,0,2,0,1,84400,33561,6713,45194,0
1,8,6,4,4,0,0,2,6,0,0,0,0,0,0,0,0,0,0,0,0,2,0,1,84400,33561,6713,45195,0
1,8,10,6,6,0,0,4,10,0,0,0,0,0,0,0,0,0,0,0,0,2,0,1,84400,33561,6713,45196,0
1,8,1,1,1,0,0,0,1,0,0,0,0,0,0,0,0,0,0,0,0,2,0,1,84400,33561,6713,45196,0
1,8,14,10,10,0,0,4,14,1,1,1,1,2,2,0,2,0,1,0,0,2,0,1,84400,33561,6713,45197,0
1,8,46,26,30,3,0,12,49,3,6,3,6,9,9,20,28,1,42,2,0,2,0,1,84410,33561,6713,45198,0
1,6,2,2,2,0,0,0,2,0,0,0,0,0,0,0,0,0,0,0,0,2,0,1,84410,33561,6713,45198,0
1,6,2,2,2,0,0,0,2,0,0,0,0,0,0,0,0,0,0,0,0,2,0,1,84420,33562,6713,45210,0
2,25,127,75,83,2,11,30,129,4,14,7,14,18,21,61,87,2,175,9,0,2,0,1,84420,33562,6713,45211,0
2,25,652,304,544,16,6,88,668,6,89,51,101,95,152,591,998,3,3399,188,0,2,0,1,84420,33563,6713,45212,0
2,25,2,2,2,0,0,0,2,0,0,0,0,0,0,0,0,0,0,0,0,2,0,1,84420,33563,6713,45212,0
2,25,8,5,5,0,0,3,8,0,0,0,0,0,0,0,0,0,0,0,0,2,0,1,84420,33563,6713,45213,0
2,25,2,2,2,0,0,0,2,0,0,0,0,0,0,0,0,0,0,0,0,2,0,1,84420,33563,6713,45213,0
2,25,14,8,8,0,0,6,14,0,0,0,0,0,0,0,0,0,0,0,0,2,0,1,84420,33563,6713,45214,0
2,25,6,4,4,0,0,2,6,0,0,0,0,0,0,0,0,0,0,0,0,2,0,1,84420,33563,6713,45215,0
2,25,6,4,4,0,0,2,6,1,2,1,2,3,3,2,4,0,2,0,0,2,0,1,84420,33563,6713,45216,0
2,25,6,4,4,0,0,2,6,0,0,0,0,0,0,0,0,0,0,0,0,2,0,1,84420,33563,6713,45217,0
2,25,7,5,5,0,0,2,7,0,0,0,0,0,0,0,0,0,0,0,0,2,0,1,84420,33563,6713,45218,0
2,25,6,4,4,0,0,2,6,0,0,0,0,0,0,0,0,0,0,0,0,2,0,1,84420,33563,6713,45219,0
2,25,10,6,6,0,0,4,10,0,0,0,0,0,0,0,0,0,0,0,0,2,0,1,84420,33563,6713,45220,0
2,25,1,1,1,0,0,0,1,0,0,0,0,0,0,0,0,0,0,0,0,2,0,1,84420,33563,6713,45220,0
2,25,14,10,10,0,0,4,14,1,1,1,1,2,2,0,2,0,1,0,0,2,0,1,84420,33563,6713,45221,0
2,25,46,26,30,3,0,12,49,3,6,3,6,9,9,20,28,1,42,2,0,2,0,1,84430,33563,6713,45222,0
1,52,14,12,10,0,0,4,14,1,2,1,2,3,3,2,4,0,2,0,0,2,1,2,84430,33563,6713,45223,0
1,55,14,12,10,0,0,4,14,1,2,1,2,3,3,2,4,0,2,0,0,2,1,2,84430,33563,6713,45224,0
1,52,14,12,10,0,0,4,14,1,2,1,2,3,3,2,4,0,2,0,0,2,1,2,84430,33563,6713,45225,0
1,71,19,18,14,0,0,5,19,1,2,1,2,3,3,2,4,0,2,0,0,2,2,3,84430,33563,6713,45226,0
2,18,10,6,6,0,0,4,10,0,0,0,0,0,0,0,0,0,0,0,0,2,0,1,84430,33563,6713,45227,0
2,36,127,75,83,2,11,30,129,4,14,7,14,18,21,61,87,2,175,9,0,2,0,1,84430,33563,6713,45228,0
2,36,652,304,544,16,6,88,668,6,89,51,101,95,152,591,998,3,3399,188,0,2,0,1,84430,33564,6713,45229,0
2,36,2,2,2,0,0,0,2,0,0,0,0,0,0,0,0,0,0,0,0,2,0,1,84430,33564,6713,45229,0
2,36,8,5,5,0,0,3,8,0,0,0,0,0,0,0,0,0,0,0,0,2,0,1,84430,33564,6713,45230,0
2,36,2,2,2,0,0,0,2,0,0,0,0,0,0,0,0,0,0,0,0,2,0,1,84430,33564,6713,45230,0
2,36,14,8,8,0,0,6,14,0,0,0,0,0,0,0,0,0,0,0,0,2,0,1,84430,33564,6713,45231,0
2,36,6,4,4,0,0,2,6,0,0,0,0,0,0,0,0,0,0,0,0,2,0,1,84430,33564,6713,45232,0
2,36,6,4,4,0,0,2,6,1,2,1,2,3,3,2,4,0,2,0,0,2,0,1,84430,33564,6713,45233,0
2,36,6,4,4,0,0,2,6,0,0,0,0,0,0,0,0,0,0,0,0,2,0,1,84430,33564,6713,45234,0
2,36,7,5,5,0,0,2,7,0,0,0,0,0,0,0,0,0,0,0,0,2,0,1,84430,33564,6713,45235,0
2,36,6,4,4,0,0,2,6,0,0,0,0,0,0,0,0,0,0,0,0,2,0,1,84430,33564,6713,45236,0
2,36,10,6,6,0,0,4,10,0,0,0,0,0,0,0,0,0,0,0,0,2,0,1,84430,33564,6713,45237,0
2,36,1,1,1,0,0,0,1,0,0,0,0,0,0,0,0,0,0,0,0,2,0,1,84430,33564,6713,45237,0
2,36,14,10,10,0,0,4,14,1,1,1,1,2,2,0,2,0,1,0,0,2,0,1,84430,33564,6713,45238,0
2,36,46,26,30,3,0,12,49,3,6,3,6,9,9,20,28,1,42,2,0,2,0,1,84440,33564,6713,45239,0
1,6,2,2,2,0,0,0,2,0,0,0,0,0,0,0,0,0,0,0,0,2,0,1,84440,33564,6713,45239,0
1,26,127,75,83,2,11,30,129,4,14,7,14,18,21,61,87,2,175,9,0,2,0,1,84440,33564,6713,45240,0
1,26,652,304,544,16,6,88,668,6,89,51,101,95,152,591,998,3,3399,188,0,2,0,1,84440,33565,6713,45241,0
1,26,2,2,2,0,0,0,2,0,0,0,0,0,0,0,0,0,0,0,0,2,0,1,84440,33565,6713,45241,0
1,26,8,5,5,0,0,3,8,0,0,0,0,0,0,0,0,0,0,0,0,2,0,1,84440,33565,6713,45242,0
1,26,2,2,2,0,0,0,2,0,0,0,0,0,0,0,0,0,0,0,0,2,0,1,84440,33565,6713,45242,0
1,26,14,8,8,0,0,6,14,0,0,0,0,0,0,0,0,0,0,0,0,2,0,1,84440,33565,6713,45243,0
1,26,6,4,4,0,0,2,6,0,0,0,0,0,0,0,0,0,0,0,0,2,0,1,84440,33565,6713,45244,0
1,26,6,4,4,0,0,2,6,1,2,1,2,3,3,2,4,0,2,0,0,2,0,1,84440,33565,6713,45245,0
1,26,6,4,4,0,0,2,6,0,0,0,0,0,0,0,0,0,0,0,0,2,0,1,84440,33565,6713,45246,0
1,26,7,5,5,0,0,2,7,0,0,0,0,0,0,0,0,0,0,0,0,2,0,1,84440,33565,6713,45247,0
1,26,6,4,4,0,0,2,6,0,0,0,0,0,0,0,0,0,0,0,0,2,0,1,84440,33565,6713,45248,0
1,26,10,6,6,0,0,4,10,0,0,0,0,0,0,0,0,0,0,0,0,2,0,1,84440,33565,6713,45249,0
1,26,1,1,1,0,0,0,1,0,0,0,0,0,0,0,0,0,0,0,0,2,0,1,84440,33565,6713,45249,0
1,26,14,10,10,0,0,4,14,1,1,1,1,2,2,0,2,0,1,0,0,2,0,1,84440,33565,6713,45250,0
1,26,46,26,30,3,0,12,49,3,6,3,6,9,9,20,28,1,42,2,0,2,0,1,84450,33565,6713,45251,0
1,7,2,2,2,0,0,0,2,0,0,0,0,0,0,0,0,0,0,0,0,2,0,1,84450,33565,6713,45251,0
1,24,127,75,83,2,11,30,129,4,14,7,14,18,21,61,87,2,175,9,0,2,0,1,84450,33565,6713,45252,0
1,24,652,304,544,16,6,88,668,6,89,51,101,95,152,591,998,3,3399,188,0,2,0,1,84450,33566,6713,45253,0
1,24,2,2,2,0,0,0,2,0,0,0,0,0,0,0,0,0,0,0,0,2,0,1,84450,33566,6713,45253,0
1,24,8,5,5,0,0,3,8,0,0,0,0,0,0,0,0,0,0,0,0,2,0,1,84450,33566,6713,45254,0
1,24,2,2,2,0,0,0,2,0,0,0,0,0,0,0,0,0,0,0,0,2,0,1,84450,33566,6713,45254,0
1,24,14,8,8,0,0,6,14,0,0,0,0,0,0,0,0,0,0,0,0,2,0,1,84450,33566,6713,45255,0
1,24,6,4,4,0,0,2,6,0,0,0,0,0,0,0,0,0,0,0,0,2,0,1,84450,33566,6713,45256,0
1,24,6,4,4,0,0,2,6,1,2,1,2,3,3,2,4,0,2,0,0,2,0,1,84450,33566,6713,45257,0
1,24,6,4,4,0,0,2,6,0,0,0,0,0,0,0,0,0,0,0,0,2,0,1,84450,33566,6713,45258,0
1,24,7,5,5,0,0,2,7,0,0,0,0,0,0,0,0,0,0,0,0,2,0,1,84450,33566,6713,45259,0
1,24,6,4,4,0,0,2,6,0,0,0,0,0,0,0,0,0,0,0,0,2,0,1,84450,33566,6713,45260,0
1,24,10,6,6,0,0,4,10,0,0,0,0,0,0,0,0,0,0,0,0,2,0,1,84450,33566,6713,45261,0
1,24,1,1,1,0,0,0,1,0,0,0,0,0,0,0,0,0,0,0,0,2,0,1,84450,33566,6713,45261,0
1,24,14,10,10,0,0,4,14,1,1,1,1,2,2,0,2,0,1,0,0,2,0,1,84450,33566,6713,45262,0
1,24,46,26,30,3,0,12,49,3,6,3,6,9,9,20,28,1,42,2,0,2,0,1,84460,33566,6713,45263,0
1,7,2,2,2,0,0,0,2,0,0,0,0,0,0,0,0,0,0,0,0,2,0,1,84460,33566,6713,45263,0
3,33,15,9,9,0,0,6,15,0,0,0,0,0,0,0,0,0,0,0,0,2,0,1,84460,33566,6713,45264,0
1,13,127,75,83,2,11,30,129,4,14,7,14,18,21,61,87,2,175,9,0,2,0,1,84460,33566,6713,45265,0
1,13,652,304,544,16,6,88,668,6,89,51,101,95,152,591,998,3,3399,188,0,2,0,1,84460,33567,6713,45266,0
1,13,2,2,2,0,0,0,2,0,0,0,0,0,0,0,0,0,0,0,0,2,0,1,84460,33567,6713,45266,0
1,13,8,5,5,0,0,3,8,0,0,0,0,0,0,0,0,0,0,0,0,2,0,1,84460,33567,6713,45267,0
1,13,2,2,2,0,0,0,2,0,0,0,0,0,0,0,0,0,0,0,0,2,0,1,84460,33567,6713,45267,0
1,13,14,8,8,0,0,6,14,0,0,0,0,0,0,0,0,0,0,0,0,2,0,1,84460,33567,6713,45268,0
1,13,6,4,4,0,0,2,6,0,0,0,0,0,0,0,0,0,0,0,0,2,0,1,84460,33567,6713,45269,0
1,13,6,4,4,0,0,2,6,1,2,1,2,3,3,2,4,0,2,0,0,2,0,1,84460,33567,6713,45270,0
1,13,6,4,4,0,0,2,6,0,0,0,0,0,0,0,0,0,0,0,0,2,0,1,84460,33567,6713,45271,0
1,13,7,5,5,0,0,2,7,0,0,0,0,0,0,0,0,0,0,0,0,2,0,1,84460,33567,6713,45272,0
1,13,6,4,4,0,0,2,6,0,0,0,0,0,0,0,0,0,0,0,0,2,0,1,84460,33567,6713,45273,0
1,13,10,6,6,0,0,4,10,0,0,0,0,0,0,0,0,0,0,0,0,2,0,1,84460,33567,6713,45274,0
1,13,1,1,1,0,0,0,1,0,0,0,0,0,0,0,0,0,0,0,0,2,0,1,84460,33567,6713,45274,0
1,13,14,10,10,0,0,4,14,1,1,1,1,2,2,0,2,0,1,0,0,2,0,1,84460,33567,6713,45275,0
1,13,46,26,30,3,0,12,49,3,6,3,6,9,9,20,28,1,42,2,0,2,0,1,84470,33567,6713,45276,0
1,16,127,75,83,2,11,30,129,4,14,7,14,18,21,61,87,2,175,9,0,2,0,1,84470,33567,6713,45277,0
1,16,652,304,544,16,6,88,668,6,89,51,101,95,152,591,998,3,3399,188,0,2,0,1,84470,33568,6713,45278,0
1,16,2,2,2,0,0,0,2,0,0,0,0,0,0,0,0,0,0,0,0,2,0,1,84470,33568,6713,45278,0
1,16,8,5,5,0,0,3,8,0,0,0,0,0,0,0,0,0,0,0,0,2,0,1,84470,33568,6713,45279,0
1,16,2,2,2,0,0,0,2,0,0,0,0,0,0,0,0,0,0,0,0,2,0,1,84470,33568,6713,45279,0
1,16,14,8,8,0,0,6,14,0,0,0,0,0,0,0,0,0,0,0,0,2,0,1,84470,33568,6713,45280,0
1,16,6,4,4,0,0,2,6,0,0,0,0,0,0,0,0,0,0,0,0,2,0,1,84470,33568,6713,45281,0
1,16,6,4,4,0,0,2,6,1,2,1,2,3,3,2,4,0,2,0,0,2,0,1,84470,33568,6713,45282,0
1,16,6,4,4,0,0,2,6,0,0,0,0,0,0,0,0,0,0,0,0,2,0,1,84470,33568,6713,45283,0
1,16,7,5,5,0,0,2,7,0,0,0,0,0,0,0,0,0,0,0,0,2,0,1,84470,33568,6713,45284,0
1,16,6,4,4,0,0,2,6,0,0,0,0,0,0,0,0,0,0,0,0,2,0,1,84470,33568,6713,45285,0
1,16,10,6,6,0,0,4,10,0,0,0,0,0,0,0,0,0,0,0,0,2,0,1,84470,33568,6713,45286,0
1,16,1,1,1,0,0,0,1,0,0,0,0,0,0,0,0,0,0,0,0,2,0,1,84470,33568,6713,45286,0
1,16,14,10,10,0,0,4,14,1,1,1,1,2,2,0,2,0,1,0,0,2,0,1,84470,33568,6713,45287,0
1,16,46,26,30,3,0,12,49,3,6,3,6,9,9,20,28,1,42,2,0,2,0,1,84480,33568,6713,45288,0
1,10,2,2,2,0,0,0,2,1,2,1,2,3,3,2,4,0,2,0,0,2,0,1,84480,33568,6713,45288,0
1,13,127,75,83,2,11,30,129,4,14,7,14,18,21,61,87,2,175,9,0,2,0,1,84480,33568,6713,45289,0
1,13,652,304,544,16,6,88,668,6,89,51,101,95,152,591,998,3,3399,188,0,2,0,1,84480,33569,6713,45290,0
1,13,2,2,2,0,0,0,2,0,0,0,0,0,0,0,0,0,0,0,0,2,0,1,84480,33569,6713,45290,0
1,13,8,5,5,0,0,3,8,0,0,0,0,0,0,0,0,0,0,0,0,2,0,1,84480,33569,6713,45291,0
1,13,2,2,2,0,0,0,2,0,0,0,0,0,0,0,0,0,0,0,0,2,0,1,84480,33569,6713,45291,0
1,13,14,8,8,0,0,6,14,0,0,0,0,0,0,0,0,0,0,0,0,2,0,1,84480,33569,6713,45292,0
1,13,6,4,4,0,0,2,6,0,0,0,0,0,0,0,0,0,0,0,0,2,0,1,84480,33569,6713,45293,0
1,13,6,4,4,0,0,2,6,1,2,1,2,3,3,2,4,0,2,0,0,2,0,1,84480,33569,6713,45294,0
1,13,6,4,4,0,0,2,6,0,0,0,0,0,0,0,0,0,0,0,0,2,0,1,84480,33569,6713,45295,0
1,13,7,5,5,0,0,2,7,0,0,0,0,0,0,0,0,0,0,0,0,2,0,1,84480,33569,6713,45296,0
1,13,6,4,4,0,0,2,6,0,0,0,0,0,0,0,0,0,0,0,0,2,0,1,84480,33569,6713,45297,0
1,13,10,6,6,0,0,4,10,0,0,0,0,0,0,0,0,0,0,0,0,2,0,1,84480,33569,6713,45298,0
1,13,1,1,1,0,0,0,1,0,0,0,0,0,0,0,0,0,0,0,0,2,0,1,84480,33569,6713,45298,0
1,13,14,10,10,0,0,4,14,1,1,1,1,2,2,0,2,0,1,0,0,2,0,1,84480,33569,6713,45299,0
1,13,46,26,30,3,0,12,49,3,6,3,6,9,9,20,28,1,42,2,0,2,0,1,84490,33569,6713,45300,0
2,26,10,6,6,0,0,4,10,2,4,2,4,6,6,10,15,1,15,0,0,2,0,1,84490,33569,6713,45301,0
3,44,15,10,10,0,0,5,15,2,4,2,4,6,6,10,15,1,15,0,0,2,1,2,84490,33569,6713,45302,0
3,39,15,9,9,0,0,6,15,0,0,0,0,0,0,0,0,0,0,0,0,2,0,1,84490,33569,6713,45303,0
2,33,10,7,7,0,0,3,10,1,2,1,2,3,3,2,4,0,2,0,0,2,1,2,84490,33569,6713,45304,0
3,43,15,9,9,0,0,6,15,1,4,2,4,5,6,8,13,0,6,0,0,2,1,2,84490,33569,6713,45305,0
2,21,10,6,6,0,0,4,10,0,0,0,0,0,0,0,0,0,0,0,0,2,0,1,84490,33569,6713,45306,0
4,61,20,12,12,0,0,8,20,1,2,1,2,3,3,2,4,0,2,0,0,2,0,1,84490,33569,6713,45307,0
2,51,127,75,83,2,11,30,129,4,14,7,14,18,21,61,87,2,175,9,0,2,0,1,84490,33569,6713,45308,0
2,51,652,304,544,16,6,88,668,6,89,51,101,95,152,591,998,3,3399,188,0,2,0,1,84490,33570,6713,45309,0
2,51,2,2,2,0,0,0,2,0,0,0,0,0,0,0,0,0,0,0,0,2,0,1,84490,33570,6713,45309,0
2,51,8,5,5,0,0,3,8,0,0,0,0,0,0,0,0,0,0,0,0,2,0,1,84490,33570,6713,45310,0
2,51,2,2,2,0,0,0,2,0,0,0,0,0,0,0,0,0,0,0,0,2,0,1,84490,33570,6713,45310,0
2,51,14,8,8,0,0,6,14,0,0,0,0,0,0,0,0,0,0,0,0,2,0,1,84490,33570,6713,45311,0
2,51,6,4,4,0,0,2,6,0,0,0,0,0,0,0,0,0,0,0,0,2,0,1,84490,33570,6713,45312,0
2,51,6,4,4,0,0,2,6,1,2,1,2,3,3,2,4,0,2,0,0,2,0,1,84490,33570,6713,45313,0
2,51,6,4,4,0,0,2,6,0,0,0,0,0,0,0,0,0,0,0,0,2,0,1,84490,33570,6713,45314,0
2,51,7,5,5,0,0,2,7,0,0,0,0,0,0,0,0,0,0,0,0,2,0,1,84490,33570,6713,45315,0
2,51,6,4,4,0,0,2,6,0,0,0,0,0,0,0,0,0,0,0,0,2,0,1,84490,33570,6713,45316,0
2,51,10,6,6,0,0,4,10,0,0,0,0,0,0,0,0,0,0,0,0,2,0,1,84490,33570,6713,45317,0
2,51,1,1,1,0,0,0,1,0,0,0,0,0,0,0,0,0,0,0,0,2,0,1,84490,33570,6713,45317,0
2,51,14,10,10,0,0,4,14,1,1,1,1,2,2,0,2,0,1,0,0,2,0,1,84490,33570,6713,45318,0
2,51,46,26,30,3,0,12,49,3,6,3,6,9,9,20,28,1,42,2,0,2,0,1,84500,33570,6713,45319,0
1,6,2,2,2,0,0,0,2,0,0,0,0,0,0,0,0,0,0,0,0,2,0,1,84500,33570,6713,45319,0
8,263,51,25,36,0,0,15,51,3,11,6,12,14,18,42,68,1,112,6,0,2,0,1,84500,33570,6713,45320,0
1,14,6,4,4,0,0,2,6,0,0,0,0,0,0,0,0,0,0,0,0,2,0,1,84500,33570,6713,45321,0
4,163,27,21,21,0,0,6,27,3,6,3,6,9,9,20,28,1,42,2,0,2,0,1,84500,33570,6713,45322,0
1,6,2,2,2,0,0,0,2,0,0,0,0,0,0,0,0,0,0,0,0,2,0,1,84500,33570,6713,45322,0
1,41,7,5,5,0,0,2,7,1,2,1,2,3,3,2,4,0,2,0,0,2,0,1,84500,33570,6713,45323,0
2,51,14,9,9,0,0,5,14,0,0,0,0,0,0,0,0,0,0,0,0,2,0,1,84500,33570,6713,45324,0
2,40,13,9,8,0,0,4,13,0,0,0,0,0,0,0,0,0,0,0,0,2,0,1,84500,33570,6713,45325,0
2,42,14,10,9,0,0,4,14,0,0,0,0,0,0,0,0,0,0,0,0,2,0,1,84500,33570,6713,45326,0
2,33,12,8,7,0,0,4,12,0,0,0,0,0,0,0,0,0,0,0,0,2,0,1,84500,33570,6713,45327,0
3,49,16,9,9,0,0,7,16,0,0,0,0,0,0,0,0,0,0,0,0,2,0,1,84500,33570,6713,45328,0
1,18,3,3,3,0,0,0,3,0,0,0,0,0,0,0,0,0,0,0,0,2,0,1,84500,33570,6713,45328,0
2,26,6,4,4,0,0,2,6,1,4,2,4,5,6,8,13,0,6,0,0,2,0,1,84500,33570,6713,45330,0
12,313,149,95,105,2,0,41,151,8,54,28,55,62,83,334,494,4,2013,111,0,2,3,4,84500,33570,6713,45332,0
15,699,139,89,101,2,0,35,141,7,54,34,62,61,96,330,569,4,2287,127,0,2,4,5,84500,33570,6713,45333,0
3,299,149,67,118,4,0,27,153,1,17,14,28,18,42,69,175,0,144,8,0,2,4,10,84500,33570,6713,45334,0
38,2493,1157,318,931,29,22,177,1186,6,104,63,125,110,188,712,1274,3,4596,255,0,2,5,10,84500,33570,6713,45335,0
65,4371,520,294,400,33,13,81,553,10,261,204,367,271,571,2128,4614,7,32445,1802,1,2,3,4,84500,33571,6713,45336,0
90,3959,1338,495,1086,10,64,173,1348,11,122,82,157,133,239,883,1686,7,11934,663,0,2,11,23,84500,33573,6713,45337,0
172,7590,4293,999,3693,19,54,507,4312,9,155,88,170,164,258,1156,1898,4,9368,520,0,2,17,24,84500,33575,6713,45338,0
172,7590,1482,859,1002,125,135,219,1607,16,219,134,251,235,385,1766,3032,9,27804,1544,1,2,17,24,84510,33576,6713,45339,0
33,984,465,148,393,5,8,60,470,4,31,20,31,35,51,161,261,2,523,29,0,2,5,6,84510,33577,6713,45340,0
33,984,16,12,9,0,0,6,16,1,2,1,2,3,3,2,4,0,2,0,0,2,5,6,84510,33577,6713,45341,0
144,5870,1782,648,1425,9,47,279,1791,8,171,97,189,179,286,1292,2140,4,9462,525,0,2,32,34,84510,33578,6714,45342,0
32,968,256,139,192,9,7,47,265,4,23,12,24,27,36,112,171,2,357,19,0,2,4,8,84510,33579,6714,45343,0
6,328,180,34,164,0,0,16,180,1,12,6,12,13,18,43,66,0,33,1,0,2,0,3,84510,33579,6714,45344,0
19,499,102,59,69,5,3,24,107,6,22,15,28,28,43,113,206,3,789,43,0,2,2,7,84510,33579,6714,45345,0
119,4854,1450,624,1228,12,26,181,1462,14,306,186,354,320,540,2580,4493,8,36391,2021,1,2,24,31,84510,33581,6715,45346,0
176,5109,1660,832,1314,41,38,274,1701,20,312,209,395,332,604,2671,5058,12,64042,3557,1,2,14,20,84510,33583,6716,45348,0
49,3780,996,429,845,24,10,117,1020,7,76,50,88,83,138,494,879,4,3565,198,0,2,5,10,84510,33585,6716,45349,0
120,5083,1513,682,1277,25,13,200,1538,11,199,116,219,210,335,1557,2584,6,15641,868,0,2,12,20,84510,33587,6716,45350,0
84,4871,1296,573,1062,40,33,157,1336,8,201,118,231,209,349,1561,2689,4,12365,686,0,2,11,16,84510,33587,6716,45351,0
20,449,207,111,150,11,0,50,218,5,26,19,36,31,55,133,272,3,943,52,0,2,2,7,84510,33587,6716,45352,0
98,5169,1457,730,1242,11,6,188,1468,10,292,166,329,302,495,2424,4078,5,22973,1276,1,2,20,25,84510,33589,6716,45353,0
43,2669,652,304,544,16,6,88,668,6,89,51,101,95,152,591,998,3,3399,188,0,2,3,8,84510,33590,6716,45354,0
72,3231,1455,414,1257,16,76,112,1471,5,41,23,46,46,69,231,381,2,1069,59,0,2,10,19,84510,33591,6716,45355,0
2,44,7,6,5,0,0,2,7,1,1,1,2,2,3,0,3,1,3,0,0,2,0,5,84510,33591,6716,45356,0
8,263,74,35,59,1,0,14,75,3,14,7,14,17,21,58,85,1,128,7,0,2,0,5,84510,33592,6716,45357,0
107,5128,1523,757,1297,19,12,193,1542,12,193,117,230,205,347,1508,2664,7,19053,1058,0,2,14,19,84520,33594,6716,45358,0
70,3177,1020,354,843,12,15,144,1032,8,134,77,144,142,221,970,1580,4,6792,377,0,2,5,11,84520,33594,6716,45359,0
44,2024,447,308,343,6,5,95,453,7,96,59,111,103,170,651,1136,4,4600,255,0,2,8,13,84520,33597,6716,45360,0
3,229,53,23,39,0,0,13,53,2,8,4,8,10,12,26,39,1,39,2,0,2,0,1,84520,33597,6716,45361,0
21,637,424,94,331,4,0,89,428,1,5,5,5,6,10,11,25,0,12,0,0,2,4,10,84520,33598,6716,45362,0
38,2309,334,251,279,10,4,40,344,5,127,74,143,132,217,899,1528,2,4303,239,0,2,2,7,84520,33599,6716,45363,0
9,423,184,100,137,2,15,30,186,6,38,20,39,44,59,214,322,3,991,55,0,2,5,11,84520,33600,6716,45364,0
8,377,91,45,69,0,3,18,91,3,9,6,10,12,16,33,57,1,95,5,0,2,0,1,84520,33602,6716,45365,0
75,3937,1293,570,1093,25,15,163,1318,10,195,123,241,205,364,1516,2795,6,17273,959,0,2,5,10,84530,33604,6716,45366,0
29,1873,384,251,317,7,8,52,391,11,70,44,84,81,128,467,811,6,5355,297,0,2,9,15,84530,33604,6716,45367,0
56,2846,722,423,573,19,0,135,741,12,172,101,199,184,300,1320,2257,6,15668,870,0,2,10,15,84530,33606,6716,45369,0
45,1932,386,256,301,16,9,68,402,4,59,35,69,63,104,355,621,2,1453,80,0,2,3,8,84530,33606,6716,45370,0
28,1590,466,257,367,18,25,50,484,7,126,86,171,133,257,898,1813,4,8612,478,0,2,2,3,84530,33606,6716,45371,0
15,1051,215,129,180,6,0,29,221,8,65,43,72,73,115,415,711,4,3153,175,0,2,1,6,84530,33606,6716,45372,0
85,3359,1043,504,840,53,9,147,1096,9,180,112,198,189,310,1377,2344,4,11604,644,0,2,9,16,84530,33608,6716,45373,0
12,466,295,56,236,0,4,54,295,2,9,5,10,11,15,30,51,1,57,3,0,2,0,5,84530,33610,6716,45374,0
30,1422,373,158,315,8,0,51,381,5,76,44,79,81,123,486,779,2,2026,112,0,2,2,7,84530,33610,6716,45375,0
79,3071,1178,367,1042,6,15,115,1184,9,94,51,95,103,146,644,976,4,4439,246,0,2,6,11,84530,33610,6716,45376,0
9,449,219,78,157,11,5,46,230,3,24,20,34,27,54,114,256,2,545,30,0,2,0,1,84530,33611,6716,45377,0
111,6048,1943,715,1694,26,18,214,1969,12,185,120,237,197,357,1436,2721,7,20915,1161,0,2,26,31,84530,33613,6716,45378,0
35,1473,442,244,305,14,16,103,456,11,68,45,75,79,120,452,756,6,4588,254,0,2,4,9,84530,33615,6716,45379,0
48,1928,1098,241,925,5,10,155,1103,7,46,25,49,53,74,273,423,3,1580,87,0,2,2,7,84540,33617,6716,45380,0
48,1639,601,196,481,2,23,85,603,8,63,36,72,71,108,400,664,4,3036,168,0,2,4,8,84540,33617,6716,45381,0
172,5239,1660,832,1314,41,38,274,1701,20,312,209,395,332,604,2671,5058,12,64042,3557,1,2,3,11,84540,33619,6717,45383,0
172,5239,1057,646,719,113,100,145,1170,18,215,134,248,233,382,1740,3004,10,31186,1732,1,2,3,11,84550,33620,6718,45384,0
174,5041,1660,832,1314,41,38,274,1701,20,312,209,395,332,604,2671,5058,12,64042,3557,1,2,2,27,84550,33622,6719,45386,0
168,5062,1660,832,1314,41,38,274,1701,20,312,209,395,332,604,2671,5058,12,64042,3557,1,2,0,23,84550,33624,6720,45388,0
168,5062,1057,646,719,113,100,145,1170,18,215,134,248,233,382,1740,3004,10,31186,1732,1,2,0,23,84560,33625,6721,45389,0
168,4910,1660,832,1314,41,38,274,1701,20,312,209,395,332,604,2671,5058,12,64042,3557,1,2,0,53,84560,33627,6722,45391,0
3,42,14,8,8,0,0,6,14,0,0,0,0,0,0,0,0,0,0,0,0,2,0,1,84560,33627,6722,45394,0
2,34,9,6,6,0,0,3,9,0,0,0,0,0,0,0,0,0,0,0,0,2,0,3,84560,33627,6722,45395,0
2,34,13,9,8,0,0,4,13,0,0,0,0,0,0,0,0,0,0,0,0,2,0,3,84560,33627,6722,45396,0
1,313,382,65,130,157,2,92,539,4,10,5,10,14,15,41,57,2,114,6,0,2,9,10,84560,33628,6723,45398,0
60,1118,282,196,195,3,0,86,285,8,130,71,141,138,212,936,1507,4,6538,363,0,2,15,16,84570,33629,6724,45411,0
4,77,127,75,83,2,11,30,129,4,14,7,14,18,21,61,87,2,175,9,0,2,0,1,84570,33629,6724,45412,0
4,77,652,304,544,16,6,88,668,6,89,51,101,95,152,591,998,3,3399,188,0,2,0,1,84570,33630,6724,45413,0
4,77,2,2,2,0,0,0,2,0,0,0,0,0,0,0,0,0,0,0,0,2,0,1,84570,33630,6724,45413,0
4,77,8,5,5,0,0,3,8,0,0,0,0,0,0,0,0,0,0,0,0,2,0,1,84570,33630,6724,45414,0
4,77,2,2,2,0,0,0,2,0,0,0,0,0,0,0,0,0,0,0,0,2,0,1,84570,33630,6724,45414,0
4,77,14,8,8,0,0,6,14,0,0,0,0,0,0,0,0,0,0,0,0,2,0,1,84570,33630,6724,45415,0
4,77,6,4,4,0,0,2,6,0,0,0,0,0,0,0,0,0,0,0,0,2,0,1,84570,33630,6724,45416,0
4,77,6,4,4,0,0,2,6,1,2,1,2,3,3,2,4,0,2,0,0,2,0,1,84570,33630,6724,45417,0
4,77,6,4,4,0,0,2,6,0,0,0,0,0,0,0,0,0,0,0,0,2,0,1,84570,33630,6724,45418,0
4,77,7,5,5,0,0,2,7,0,0,0,0,0,0,0,0,0,0,0,0,2,0,1,84570,33630,6724,45419,0
4,77,6,4,4,0,0,2,6,0,0,0,0,0,0,0,0,0,0,0,0,2,0,1,84570,33630,6724,45420,0
4,77,10,6,6,0,0,4,10,0,0,0,0,0,0,0,0,0,0,0,0,2,0,1,84570,33630,6724,45421,0
4,77,1,1,1,0,0,0,1,0,0,0,0,0,0,0,0,0,0,0,0,2,0,1,84570,33630,6724,45421,0
4,77,14,10,10,0,0,4,14,1,1,1,1,2,2,0,2,0,1,0,0,2,0,1,84570,33630,6724,45422,0
4,77,46,26,30,3,0,12,49,3,6,3,6,9,9,20,28,1,42,2,0,2,0,1,84580,33630,6724,45423,0
1,9,5,3,3,0,0,2,5,0,0,0,0,0,0,0,0,0,0,0,0,2,0,1,84580,33630,6724,45423,0
1,90,13,10,10,0,0,3,13,1,2,1,2,3,3,2,4,0,2,0,0,2,0,1,84580,33630,6724,45424,0
7,111,44,19,17,0,16,11,44,3,14,7,14,17,21,58,85,1,128,7,0,2,1,2,84580,33630,6724,45425,0
3,63,127,75,83,2,11,30,129,4,14,7,14,18,21,61,87,2,175,9,0,2,1,2,84590,33631,6724,45438,0
3,63,652,304,544,16,6,88,668,6,89,51,101,95,152,591,998,3,3399,188,0,2,1,2,84590,33632,6724,45439,0
3,63,2,2,2,0,0,0,2,0,0,0,0,0,0,0,0,0,0,0,0,2,1,2,84590,33632,6724,45439,0
3,63,8,5,5,0,0,3,8,0,0,0,0,0,0,0,0,0,0,0,0,2,1,2,84590,33632,6724,45440,0
3,63,2,2,2,0,0,0,2,0,0,0,0,0,0,0,0,0,0,0,0,2,1,2,84590,33632,6724,45440,0
3,63,14,8,8,0,0,6,14,0,0,0,0,0,0,0,0,0,0,0,0,2,1,2,84590,33632,6724,45441,0
3,63,6,4,4,0,0,2,6,0,0,0,0,0,0,0,0,0,0,0,0,2,1,2,84590,33632,6724,45442,0
3,63,6,4,4,0,0,2,6,1,2,1,2,3,3,2,4,0,2,0,0,2,1,2,84590,33632,6724,45443,0
3,63,6,4,4,0,0,2,6,0,0,0,0,0,0,0,0,0,0,0,0,2,1,2,84590,33632,6724,45444,0
3,63,7,5,5,0,0,2,7,0,0,0,0,0,0,0,0,0,0,0,0,2,1,2,84590,33632,6724,45445,0
3,63,6,4,4,0,0,2,6,0,0,0,0,0,0,0,0,0,0,0,0,2,1,2,84590,33632,6724,45446,0
3,63,10,6,6,0,0,4,10,0,0,0,0,0,0,0,0,0,0,0,0,2,1,2,84590,33632,6724,45447,0
3,63,1,1,1,0,0,0,1,0,0,0,0,0,0,0,0,0,0,0,0,2,1,2,84590,33632,6724,45447,0
3,63,14,10,10,0,0,4,14,1,1,1,1,2,2,0,2,0,1,0,0,2,1,2,84590,33632,6724,45448,0
3,63,46,26,30,3,0,12,49,3,6,3,6,9,9,20,28,1,42,2,0,2,1,2,84600,33632,6724,45449,0
7,293,72,33,56,0,4,12,72,1,1,1,1,2,2,0,2,0,1,0,0,2,2,3,84620,33640,6726,45464,0
12,226,127,75,83,2,11,30,129,4,14,7,14,18,21,61,87,2,175,9,0,2,1,2,84620,33640,6726,45465,0
12,226,652,304,544,16,6,88,668,6,89,51,101,95,152,591,998,3,3399,188,0,2,1,2,84620,33641,6726,45466,0
12,226,2,2,2,0,0,0,2,0,0,0,0,0,0,0,0,0,0,0,0,2,1,2,84620,33641,6726,45466,0
12,226,8,5,5,0,0,3,8,0,0,0,0,0,0,0,0,0,0,0,0,2,1,2,84620,33641,6726,45467,0
12,226,2,2,2,0,0,0,2,0,0,0,0,0,0,0,0,0,0,0,0,2,1,2,84620,33641,6726,45467,0
12,226,14,8,8,0,0,6,14,0,0,0,0,0,0,0,0,0,0,0,0,2,1,2,84620,33641,6726,45468,0
12,226,6,4,4,0,0,2,6,0,0,0,0,0,0,0,0,0,0,0,0,2,1,2,84620,33641,6726,45469,0
12,226,6,4,4,0,0,2,6,1,2,1,2,3,3,2,4,0,2,0,0,2,1,2,84620,33641,6726,45470,0
12,226,6,4,4,0,0,2,6,0,0,0,0,0,0,0,0,0,0,0,0,2,1,2,84620,33641,6726,45471,0
12,226,7,5,5,0,0,2,7,0,0,0,0,0,0,0,0,0,0,0,0,2,1,2,84620,33641,6726,45472,0
12,226,6,4,4,0,0,2,6,0,0,0,0,0,0,0,0,0,0,0,0,2,1,2,84620,33641,6726,45473,0
12,226,10,6,6,0,0,4,10,0,0,0,0,0,0,0,0,0,0,0,0,2,1,2,84620,33641,6726,45474,0
12,226,1,1,1,0,0,0,1,0,0,0,0,0,0,0,0,0,0,0,0,2,1,2,84620,33641,6726,45474,0
12,226,14,10,10,0,0,4,14,1,1,1,1,2,2,0,2,0,1,0,0,2,1,2,84620,33641,6726,45475,0
12,226,46,26,30,3,0,12,49,3,6,3,6,9,9,20,28,1,42,2,0,2,1,2,84630,33641,6726,45476,0
6,71,127,75,83,2,11,30,129,4,14,7,14,18,21,61,87,2,175,9,0,2,0,1,84630,33641,6726,45477,0
6,71,652,304,544,16,6,88,668,6,89,51,101,95,152,591,998,3,3399,188,0,2,0,1,84630,33642,6726,45478,0
6,71,2,2,2,0,0,0,2,0,0,0,0,0,0,0,0,0,0,0,0,2,0,1,84630,33642,6726,45478,0
6,71,8,5,5,0,0,3,8,0,0,0,0,0,0,0,0,0,0,0,0,2,0,1,84630,33642,6726,45479,0
6,71,2,2,2,0,0,0,2,0,0,0,0,0,0,0,0,0,0,0,0,2,0,1,84630,33642,6726,45479,0
6,71,14,8,8,0,0,6,14,0,0,0,0,0,0,0,0,0,0,0,0,2,0,1,84630,33642,6726,45480,0
6,71,6,4,4,0,0,2,6,0,0,0,0,0,0,0,0,0,0,0,0,2,0,1,84630,33642,6726,45481,0
6,71,6,4,4,0,0,2,6,1,2,1,2,3,3,2,4,0,2,0,0,2,0,1,84630,33642,6726,45482,0
6,71,6,4,4,0,0,2,6,0,0,0,0,0,0,0,0,0,0,0,0,2,0,1,84630,33642,6726,45483,0
6,71,7,5,5,0,0,2,7,0,0,0,0,0,0,0,0,0,0,0,0,2,0,1,84630,33642,6726,45484,0
6,71,6,4,4,0,0,2,6,0,0,0,0,0,0,0,0,0,0,0,0,2,0,1,84630,33642,6726,45485,0
6,71,10,6,6,0,0,4,10,0,0,0,0,0,0,0,0,0,0,0,0,2,0,1,84630,33642,6726,45486,0
6,71,1,1,1,0,0,0,1,0,0,0,0,0,0,0,0,0,0,0,0,2,0,1,84630,33642,6726,45486,0
6,71,14,10,10,0,0,4,14,1,1,1,1,2,2,0,2,0,1,0,0,2,0,1,84630,33642,6726,45487,0
6,71,46,26,30,3,0,12,49,3,6,3,6,9,9,20,28,1,42,2,0,2,0,1,84640,33642,6726,45488,0
3,23,14,7,7,2,0,5,16,0,0,0,0,0,0,0,0,0,0,0,0,2,1,2,84640,33642,6726,45488,0
7,103,38,23,23,0,0,15,38,0,0,0,0,0,0,0,0,0,0,0,0,2,0,1,84640,33642,6726,45489,0
17,378,85,59,61,8,0,16,93,5,18,10,18,23,28,86,126,2,316,17,0,2,0,1,84640,33642,6726,45490,0
12,515,124,78,88,2,3,26,126,4,13,7,13,17,20,56,81,2,163,9,0,2,0,1,84640,33642,6726,45493,0
1,92,42,7,35,4,0,5,46,1,2,1,2,3,3,2,4,0,2,0,0,2,2,6,84640,33642,6726,45494,0
1,92,11,6,10,0,0,1,11,2,4,2,4,6,6,10,15,1,15,0,0,2,2,6,84640,33642,6726,45495,0
11,227,19,8,11,5,0,4,24,2,5,3,6,7,9,13,25,1,30,1,0,2,1,6,84650,33646,6727,45503,0
11,227,102,59,69,5,3,24,107,6,22,15,28,28,43,113,206,3,789,43,0,2,1,6,84650,33646,6727,45504,0
11,227,106,40,36,3,49,17,109,8,17,13,23,25,36,93,167,5,904,50,0,2,1,6,84650,33646,6727,45505,0
221,4718,182,127,129,0,0,53,182,5,39,21,42,44,63,217,343,2,926,51,0,2,65,116,84660,33650,6729,45513,0
221,4718,1165,710,800,67,119,181,1232,18,243,153,282,261,435,2000,3492,10,36473,2026,1,2,65,116,84670,33650,6730,45514,0
67,1551,773,419,590,28,0,166,801,10,204,113,217,214,330,1598,2554,5,13587,754,0,2,2,8,84670,33650,6731,45515,0
67,1551,421,273,302,44,34,57,465,17,81,59,107,98,166,583,1098,11,12329,684,0,2,2,8,84670,33650,6732,45516,0
14,404,149,95,105,2,0,41,151,8,54,28,55,62,83,334,494,4,2013,111,0,2,6,11,84670,33650,6732,45517,0
14,404,82,56,54,0,13,15,82,4,13,8,16,17,24,56,98,2,241,13,0,2,6,11,84680,33650,6732,45518,0
25,489,2,2,2,0,0,0,2,0,0,0,0,0,0,0,0,0,0,0,0,2,3,14,84680,33650,6732,45518,0
25,489,99,48,90,1,3,5,100,0,0,0,0,0,0,0,0,0,0,0,0,2,3,14,84680,33651,6732,45519,0
25,489,8,5,5,2,0,1,10,0,0,0,0,0,0,0,0,0,0,0,0,2,3,14,84680,33651,6732,45520,0
25,489,1217,716,841,84,126,174,1301,14,185,118,215,199,333,1446,2542,8,20687,1149,0,2,3,14,84690,33653,6732,45521,0
25,489,160,89,115,0,13,31,160,7,15,11,17,22,28,78,124,3,495,27,0,2,3,14,84690,33653,6732,45522,0
25,489,10,10,9,9,0,0,19,0,0,0,0,0,0,0,0,0,0,0,0,2,3,14,84690,33653,6733,45523,0
25,489,173,84,99,8,29,36,181,5,12,7,13,17,20,54,81,2,221,12,0,2,3,14,84690,33654,6733,45524,0
25,489,3,1,1,3,0,0,6,0,0,0,0,0,0,0,0,0,0,0,0,2,3,14,84690,33654,6733,45525,0
174,5263,1660,832,1314,41,38,274,1701,20,312,209,395,332,604,2671,5058,12,64042,3557,1,2,54,132,84690,33656,6734,45527,0
174,5263,1057,646,719,113,100,145,1170,18,215,134,248,233,382,1740,3004,10,31186,1732,1,2,54,132,84700,33657,6735,45528,0
17,327,95,58,50,9,16,20,104,12,33,24,45,45,69,209,378,8,3100,172,0,2,1,8,84700,33657,6735,45529,0
116,2120,477,336,357,30,23,73,507,16,194,134,250,210,384,1538,2962,10,30538,1696,0,2,44,47,84710,33658,6735,45530,0
90,2017,996,429,845,24,10,117,1020,7,76,50,88,83,138,494,879,4,3565,198,0,2,8,15,84710,33660,6735,45531,0
90,2017,456,277,329,12,42,72,468,13,85,50,97,98,147,592,972,7,7212,400,0,2,8,15,84710,33660,6735,45532,0
160,3411,1513,682,1277,25,13,200,1538,11,199,116,219,210,335,1557,2584,6,15641,868,0,2,23,56,84710,33662,6735,45533,0
160,3411,819,519,539,24,98,155,843,15,96,57,106,111,163,690,1107,8,9171,509,0,2,23,56,84720,33664,6735,45534,0
59,1095,207,111,150,11,0,50,218,5,26,19,36,31,55,133,272,3,943,52,0,2,36,166,84720,33664,6735,45535,0
59,1095,410,198,237,31,55,97,441,11,63,38,72,74,110,414,683,6,4293,238,0,2,36,166,84730,33665,6736,45536,0
235,4869,2,2,2,0,0,0,2,0,0,0,0,0,0,0,0,0,0,0,0,2,22,38,84730,33665,6736,45536,0
235,4869,99,48,90,1,3,5,100,0,0,0,0,0,0,0,0,0,0,0,0,2,22,38,84730,33666,6736,45537,0
235,4869,8,5,5,2,0,1,10,0,0,0,0,0,0,0,0,0,0,0,0,2,22,38,84730,33666,6736,45538,0
235,4869,1217,716,841,84,126,174,1301,14,185,118,215,199,333,1446,2542,8,20687,1149,0,2,22,38,84740,33668,6736,45539,0
235,4869,160,89,115,0,13,31,160,7,15,11,17,22,28,78,124,3,495,27,0,2,22,38,84740,33668,6736,45540,0
235,4869,10,10,9,9,0,0,19,0,0,0,0,0,0,0,0,0,0,0,0,2,22,38,84740,33668,6737,45541,0
235,4869,173,84,99,8,29,36,181,5,12,7,13,17,20,54,81,2,221,12,0,2,22,38,84740,33669,6737,45542,0
235,4869,3,1,1,3,0,0,6,0,0,0,0,0,0,0,0,0,0,0,0,2,22,38,84740,33669,6737,45543,0
98,2010,463,295,324,28,62,57,491,12,134,82,154,146,236,989,1696,6,11700,650,0,2,8,10,84750,33670,6737,45544,0
55,770,167,116,138,4,5,22,171,8,48,30,56,56,86,292,499,4,2330,129,0,2,0,1,84750,33670,6737,45545,0
57,1484,339,213,244,17,9,65,356,10,42,26,48,52,74,259,421,5,2410,133,0,2,11,16,84760,33670,6737,45546,0
90,2288,1455,414,1257,16,76,112,1471,5,41,23,46,46,69,231,381,2,1069,59,0,2,4,36,84760,33671,6737,45548,0
90,2288,669,365,481,22,61,110,691,15,103,63,122,118,185,747,1273,8,11311,628,0,2,4,36,84770,33671,6738,45549,0
251,5822,4293,999,3693,19,54,507,4312,9,155,88,170,164,258,1156,1898,4,9368,520,0,2,19,30,84770,33673,6738,45550,0
251,5822,1482,859,1002,125,135,219,1607,16,219,134,251,235,385,1766,3032,9,27804,1544,1,2,19,30,84780,33674,6738,45551,0
6,128,44,22,19,0,19,6,44,2,10,6,12,12,18,35,64,1,77,4,0,2,0,4,84780,33674,6738,45552,0
31,1078,74,35,59,1,0,14,75,3,14,7,14,17,21,58,85,1,128,7,0,2,9,12,84780,33675,6738,45553,0
31,1078,245,125,200,5,7,34,250,7,30,17,34,37,51,166,265,3,1053,58,0,2,9,12,84790,33676,6738,45554,0
54,657,647,139,84,35,284,233,682,0,0,0,0,0,0,0,0,0,0,0,0,2,0,1,84790,33676,6738,45555,0
117,3127,1523,757,1297,19,12,193,1542,12,193,117,230,205,347,1508,2664,7,19053,1058,0,2,10,20,84800,33678,6738,45556,0
117,3127,701,378,504,33,58,109,734,13,110,68,126,123,194,794,1346,7,10027,557,0,2,10,20,84800,33679,6739,45557,0
104,2739,773,422,505,30,103,129,803,14,77,46,83,91,129,535,839,7,6334,351,0,2,31,47,84810,33680,6740,45558,0
146,3571,77,34,69,0,0,8,77,3,24,16,29,27,45,114,213,1,387,21,0,2,18,82,84810,33680,6740,45559,0
146,3571,712,438,573,51,9,84,763,14,102,71,128,116,199,733,1364,8,11988,666,0,2,18,82,84820,33681,6740,45560,0
24,600,2,2,2,0,0,0,2,0,0,0,0,0,0,0,0,0,0,0,0,2,0,5,84820,33681,6740,45560,0
24,600,99,48,90,1,3,5,100,0,0,0,0,0,0,0,0,0,0,0,0,2,0,5,84820,33682,6740,45561,0
24,600,8,5,5,2,0,1,10,0,0,0,0,0,0,0,0,0,0,0,0,2,0,5,84820,33682,6740,45562,0
24,600,1217,716,841,84,126,174,1301,14,185,118,215,199,333,1446,2542,8,20687,1149,0,2,0,5,84830,33684,6740,45563,0
24,600,160,89,115,0,13,31,160,7,15,11,17,22,28,78,124,3,495,27,0,2,0,5,84830,33684,6740,45564,0
24,600,10,10,9,9,0,0,19,0,0,0,0,0,0,0,0,0,0,0,0,2,0,5,84830,33684,6741,45565,0
24,600,173,84,99,8,29,36,181,5,12,7,13,17,20,54,81,2,221,12,0,2,0,5,84830,33685,6741,45566,0
24,600,3,1,1,3,0,0,6,0,0,0,0,0,0,0,0,0,0,0,0,2,0,5,84830,33685,6741,45567,0
30,657,125,97,103,3,0,19,128,9,25,17,27,34,44,144,223,4,1087,60,0,2,2,5,84830,33685,6742,45568,0
22,367,102,57,55,5,16,25,107,5,17,10,18,22,28,81,124,2,330,18,0,2,2,3,84830,33685,6742,45569,0
71,1560,402,202,227,24,74,80,426,12,52,33,61,64,94,339,564,7,3969,220,0,2,16,14,84830,33686,6742,45570,0
51,1090,447,308,343,6,5,95,453,7,96,59,111,103,170,651,1136,4,4600,255,0,2,15,30,84830,33689,6742,45571,0
51,1090,322,174,179,16,74,51,338,10,41,26,46,51,72,252,408,5,2291,127,0,2,15,30,84830,33692,6743,45572,0
75,1603,53,23,39,0,0,13,53,2,8,4,8,10,12,26,39,1,39,2,0,2,6,14,84830,33692,6743,45573,0
75,1603,515,298,307,33,80,99,548,12,63,44,77,75,121,419,753,7,5527,307,0,2,6,14,84840,33692,6743,45574,0
18,296,424,94,331,4,0,89,428,1,5,5,5,6,10,11,25,0,12,0,0,2,1,8,84840,33693,6743,45575,0
18,296,38,23,23,6,0,8,44,3,11,7,11,14,18,42,68,1,102,5,0,2,1,8,84840,33693,6743,45576,0
19,499,205,80,86,16,53,53,221,7,18,10,19,25,29,94,134,3,497,27,0,2,3,8,84850,33693,6744,45577,0
15,476,184,100,137,2,15,30,186,6,38,20,39,44,59,214,322,3,991,55,0,2,6,22,84850,33694,6744,45578,0
15,476,103,65,74,8,5,16,111,7,17,9,17,24,26,89,119,3,417,23,0,2,6,22,84850,33695,6744,45579,0
58,1189,91,45,69,0,3,18,91,3,9,6,10,12,16,33,57,1,95,5,0,2,8,24,84850,33697,6744,45580,0
58,1189,367,234,237,17,34,68,384,16,55,34,61,71,95,381,584,8,5183,287,0,2,8,24,84850,33698,6744,45581,0
228,5833,722,423,573,19,0,135,741,12,172,101,199,184,300,1320,2257,6,15668,870,0,2,41,61,84850,33700,6744,45583,0
228,5833,1508,847,911,44,250,301,1552,14,148,88,169,162,257,1120,1886,7,15077,837,0,2,41,61,84850,33701,6745,45584,0
314,6872,72,33,56,0,4,12,72,1,1,1,1,2,2,0,2,0,1,0,0,2,22,31,84850,33701,6745,45585,0
314,6872,1454,835,1044,76,110,219,1530,17,275,158,296,292,454,2297,3718,9,34017,1889,1,2,22,31,84860,33702,6745,45586,0
89,1801,757,253,292,73,244,162,830,13,61,38,67,74,105,409,651,7,4654,258,0,2,7,22,84860,33703,6745,45587,0
38,787,386,256,301,16,9,68,402,4,59,35,69,63,104,355,621,2,1453,80,0,2,6,44,84860,33703,6745,45588,0
38,787,264,131,164,11,41,46,275,6,38,22,40,44,62,214,338,3,1068,59,0,2,6,44,84870,33703,6746,45589,0
67,1747,466,257,367,18,25,50,484,7,126,86,171,133,257,898,1813,4,8612,478,0,2,9,19,84870,33703,6746,45590,0
67,1747,507,281,342,29,59,88,536,10,53,29,57,63,86,336,514,5,2764,153,0,2,9,19,84870,33703,6746,45591,0
25,538,215,129,180,6,0,29,221,8,65,43,72,73,115,415,711,4,3153,175,0,2,2,7,84870,33703,6746,45592,0
25,538,97,69,77,3,3,16,100,6,22,13,23,28,36,113,173,3,542,30,0,2,2,7,84870,33704,6746,45593,0
89,1896,1043,504,840,53,9,147,1096,9,180,112,198,189,310,1377,2344,4,11604,644,0,2,9,12,84870,33706,6746,45594,0
89,1896,383,288,292,26,6,62,409,11,65,38,67,76,105,429,656,5,3719,206,0,2,9,12,84870,33707,6746,45595,0
20,408,294,64,250,0,0,43,294,1,20,10,20,21,30,86,131,0,65,3,0,2,0,5,84870,33707,6746,45596,0
20,408,78,46,62,3,0,14,81,3,8,4,8,11,12,28,41,1,62,3,0,2,0,5,84870,33708,6746,45597,0
5,111,110,30,77,3,13,16,113,4,21,15,30,25,45,100,208,2,597,33,0,2,0,5,84870,33708,6746,45598,0
5,111,28,15,21,1,0,6,29,0,0,0,0,0,0,0,0,0,0,0,0,2,0,5,84870,33708,6746,45599,0
40,784,1178,367,1042,6,15,115,1184,9,94,51,95,103,146,644,976,4,4439,246,0,2,2,11,84870,33708,6746,45600,0
40,784,177,108,140,8,0,27,185,6,30,16,32,36,48,162,248,3,794,44,0,2,2,11,84870,33710,6746,45601,0
28,452,219,78,157,11,5,46,230,3,24,20,34,27,54,114,256,2,545,30,0,2,0,1,84870,33711,6746,45602,0
28,452,108,64,79,9,0,20,117,5,15,11,19,20,30,70,129,3,410,22,0,2,0,1,84870,33711,6746,45603,0
280,5869,1943,715,1694,26,18,214,1969,12,185,120,237,197,357,1436,2721,7,20915,1161,0,2,19,42,84870,33713,6746,45604,0
280,5869,1168,838,957,57,25,144,1225,19,348,224,416,367,640,3018,5452,11,61921,3440,1,2,19,42,84880,33715,6746,45605,0
19,699,442,244,305,14,16,103,456,11,68,45,75,79,120,452,756,6,4588,254,0,2,3,11,84880,33717,6746,45606,0
19,699,182,102,99,11,40,35,193,3,11,6,11,14,17,42,64,1,97,5,0,2,3,11,84880,33718,6746,45607,0
65,1251,1098,241,925,5,10,155,1103,7,46,25,49,53,74,273,423,3,1580,87,0,2,1,25,84890,33720,6746,45608,0
65,1251,282,202,222,14,2,44,296,8,42,24,43,50,67,250,378,4,1548,86,0,2,1,25,84890,33721,6746,45609,0
2,153,37,13,25,0,6,6,37,1,2,1,2,3,3,2,4,0,2,0,0,2,1,2,84890,33721,6746,45610,0
2,153,133,47,40,1,43,49,134,0,0,0,0,0,0,0,0,0,0,0,0,2,1,2,84890,33721,6746,45611,0
23,630,601,196,481,2,23,85,603,8,63,36,72,71,108,400,664,4,3036,168,0,2,3,29,84890,33721,6746,45612,0
23,630,156,79,106,5,16,28,161,5,14,8,15,19,23,64,97,2,261,14,0,2,3,29,84890,33721,6746,45613,0
104,4398,1289,550,1043,56,32,155,1345,10,167,93,185,177,278,1266,2075,5,11498,638,0,2,12,29,84890,33723,6747,45614,0
31,963,182,127,129,0,0,53,182,5,39,21,42,44,63,217,343,2,926,51,0,2,12,39,84890,33723,6748,45615,0
151,7198,1392,870,1177,35,17,170,1427,14,494,280,531,508,811,4473,7289,7,54850,3047,2,2,27,46,84890,33726,6749,45616,0
95,2843,773,419,590,28,0,166,801,10,204,113,217,214,330,1598,2554,5,13587,754,0,2,17,26,84890,33726,6750,45617,0
6,163,127,75,83,2,11,30,129,4,14,7,14,18,21,61,87,2,175,9,0,2,0,1,84890,33726,6750,45618,0
6,163,652,304,544,16,6,88,668,6,89,51,101,95,152,591,998,3,3399,188,0,2,0,1,84890,33727,6750,45619,0
6,163,2,2,2,0,0,0,2,0,0,0,0,0,0,0,0,0,0,0,0,2,0,1,84890,33727,6750,45619,0
6,163,8,5,5,0,0,3,8,0,0,0,0,0,0,0,0,0,0,0,0,2,0,1,84890,33727,6750,45620,0
6,163,2,2,2,0,0,0,2,0,0,0,0,0,0,0,0,0,0,0,0,2,0,1,84890,33727,6750,45620,0
6,163,14,8,8,0,0,6,14,0,0,0,0,0,0,0,0,0,0,0,0,2,0,1,84890,33727,6750,45621,0
6,163,6,4,4,0,0,2,6,0,0,0,0,0,0,0,0,0,0,0,0,2,0,1,84890,33727,6750,45622,0
6,163,6,4,4,0,0,2,6,1,2,1,2,3,3,2,4,0,2,0,0,2,0,1,84890,33727,6750,45623,0
6,163,6,4,4,0,0,2,6,0,0,0,0,0,0,0,0,0,0,0,0,2,0,1,84890,33727,6750,45624,0
6,163,7,5,5,0,0,2,7,0,0,0,0,0,0,0,0,0,0,0,0,2,0,1,84890,33727,6750,45625,0
6,163,6,4,4,0,0,2,6,0,0,0,0,0,0,0,0,0,0,0,0,2,0,1,84890,33727,6750,45626,0
6,163,10,6,6,0,0,4,10,0,0,0,0,0,0,0,0,0,0,0,0,2,0,1,84890,33727,6750,45627,0
6,163,1,1,1,0,0,0,1,0,0,0,0,0,0,0,0,0,0,0,0,2,0,1,84890,33727,6750,45627,0
6,163,14,10,10,0,0,4,14,1,1,1,1,2,2,0,2,0,1,0,0,2,0,1,84890,33727,6750,45628,0
6,163,46,26,30,3,0,12,49,3,6,3,6,9,9,20,28,1,42,2,0,2,0,1,84900,33727,6750,45629,0
14,833,75,38,59,1,3,12,76,2,4,2,4,6,6,10,15,1,15,0,0,2,0,5,84900,33727,6750,45630,0
2,58,16,12,9,0,0,6,16,1,2,1,2,3,3,2,4,0,2,0,0,2,1,6,84900,33727,6750,45631,0
1,6,2,2,2,0,0,0,2,0,0,0,0,0,0,0,0,0,0,0,0,2,0,1,84900,33727,6750,45631,0
1,6,99,48,90,1,3,5,100,0,0,0,0,0,0,0,0,0,0,0,0,2,0,1,84900,33728,6750,45632,0
1,6,8,5,5,2,0,1,10,0,0,0,0,0,0,0,0,0,0,0,0,2,0,1,84900,33728,6750,45633,0
1,6,1217,716,841,84,126,174,1301,14,185,118,215,199,333,1446,2542,8,20687,1149,0,2,0,1,84910,33730,6750,45634,0
1,6,160,89,115,0,13,31,160,7,15,11,17,22,28,78,124,3,495,27,0,2,0,1,84910,33730,6750,45635,0
1,6,10,10,9,9,0,0,19,0,0,0,0,0,0,0,0,0,0,0,0,2,0,1,84910,33730,6751,45636,0
1,6,173,84,99,8,29,36,181,5,12,7,13,17,20,54,81,2,221,12,0,2,0,1,84910,33731,6751,45637,0
1,6,3,1,1,3,0,0,6,0,0,0,0,0,0,0,0,0,0,0,0,2,0,1,84910,33731,6751,45638,0
1,6,2,2,2,0,0,0,2,0,0,0,0,0,0,0,0,0,0,0,0,2,0,1,84910,33731,6751,45638,0
1,8,127,75,83,2,11,30,129,4,14,7,14,18,21,61,87,2,175,9,0,2,0,1,84910,33731,6751,45639,0
1,8,652,304,544,16,6,88,668,6,89,51,101,95,152,591,998,3,3399,188,0,2,0,1,84910,33732,6751,45640,0
1,8,2,2,2,0,0,0,2,0,0,0,0,0,0,0,0,0,0,0,0,2,0,1,84910,33732,6751,45640,0
1,8,8,5,5,0,0,3,8,0,0,0,0,0,0,0,0,0,0,0,0,2,0,1,84910,33732,6751,45641,0
1,8,2,2,2,0,0,0,2,0,0,0,0,0,0,0,0,0,0,0,0,2,0,1,84910,33732,6751,45641,0
1,8,14,8,8,0,0,6,14,0,0,0,0,0,0,0,0,0,0,0,0,2,0,1,84910,33732,6751,45642,0
1,8,6,4,4,0,0,2,6,0,0,0,0,0,0,0,0,0,0,0,0,2,0,1,84910,33732,6751,45643,0
1,8,6,4,4,0,0,2,6,1,2,1,2,3,3,2,4,0,2,0,0,2,0,1,84910,33732,6751,45644,0
1,8,6,4,4,0,0,2,6,0,0,0,0,0,0,0,0,0,0,0,0,2,0,1,84910,33732,6751,45645,0
1,8,7,5,5,0,0,2,7,0,0,0,0,0,0,0,0,0,0,0,0,2,0,1,84910,33732,6751,45646,0
1,8,6,4,4,0,0,2,6,0,0,0,0,0,0,0,0,0,0,0,0,2,0,1,84910,33732,6751,45647,0
1,8,10,6,6,0,0,4,10,0,0,0,0,0,0,0,0,0,0,0,0,2,0,1,84910,33732,6751,45648,0
1,8,1,1,1,0,0,0,1,0,0,0,0,0,0,0,0,0,0,0,0,2,0,1,84910,33732,6751,45648,0
1,8,14,10,10,0,0,4,14,1,1,1,1,2,2,0,2,0,1,0,0,2,0,1,84910,33732,6751,45649,0
1,8,46,26,30,3,0,12,49,3,6,3,6,9,9,20,28,1,42,2,0,2,0,1,84920,33732,6751,45650,0
1,6,2,2,2,0,0,0,2,0,0,0,0,0,0,0,0,0,0,0,0,2,0,1,84920,33732,6751,45650,0
1,6,2,2,2,0,0,0,2,0,0,0,0,0,0,0,0,0,0,0,0,2,0,1,84930,33733,6751,45662,0
2,25,127,75,83,2,11,30,129,4,14,7,14,18,21,61,87,2,175,9,0,2,0,1,84930,33733,6751,45663,0
2,25,652,304,544,16,6,88,668,6,89,51,101,95,152,591,998,3,3399,188,0,2,0,1,84930,33734,6751,45664,0
2,25,2,2,2,0,0,0,2,0,0,0,0,0,0,0,0,0,0,0,0,2,0,1,84930,33734,6751,45664,0
2,25,8,5,5,0,0,3,8,0,0,0,0,0,0,0,0,0,0,0,0,2,0,1,84930,33734,6751,45665,0
2,25,2,2,2,0,0,0,2,0,0,0,0,0,0,0,0,0,0,0,0,2,0,1,84930,33734,6751,45665,0
2,25,14,8,8,0,0,6,14,0,0,0,0,0,0,0,0,0,0,0,0,2,0,1,84930,33734,6751,45666,0
2,25,6,4,4,0,0,2,6,0,0,0,0,0,0,0,0,0,0,0,0,2,0,1,84930,33734,6751,45667,0
2,25,6,4,4,0,0,2,6,1,2,1,2,3,3,2,4,0,2,0,0,2,0,1,84930,33734,6751,45668,0
2,25,6,4,4,0,0,2,6,0,0,0,0,0,0,0,0,0,0,0,0,2,0,1,84930,33734,6751,45669,0
2,25,7,5,5,0,0,2,7,0,0,0,0,0,0,0,0,0,0,0,0,2,0,1,84930,33734,6751,45670,0
2,25,6,4,4,0,0,2,6,0,0,0,0,0,0,0,0,0,0,0,0,2,0,1,84930,33734,6751,45671,0
2,25,10,6,6,0,0,4,10,0,0,0,0,0,0,0,0,0,0,0,0,2,0,1,84930,33734,6751,45672,0
2,25,1,1,1,0,0,0,1,0,0,0,0,0,0,0,0,0,0,0,0,2,0,1,84930,33734,6751,45672,0
2,25,14,10,10,0,0,4,14,1,1,1,1,2,2,0,2,0,1,0,0,2,0,1,84930,33734,6751,45673,0
2,25,46,26,30,3,0,12,49,3,6,3,6,9,9,20,28,1,42,2,0,2,0,1,84940,33734,6751,45674,0
1,52,14,12,10,0,0,4,14,1,2,1,2,3,3,2,4,0,2,0,0,2,1,2,84940,33734,6751,45675,0
1,55,14,12,10,0,0,4,14,1,2,1,2,3,3,2,4,0,2,0,0,2,1,2,84940,33734,6751,45676,0
1,52,14,12,10,0,0,4,14,1,2,1,2,3,3,2,4,0,2,0,0,2,1,2,84940,33734,6751,45677,0
1,71,19,18,14,0,0,5,19,1,2,1,2,3,3,2,4,0,2,0,0,2,2,3,84940,33734,6751,45678,0
2,18,10,6,6,0,0,4,10,0,0,0,0,0,0,0,0,0,0,0,0,2,0,1,84940,33734,6751,45679,0
2,36,127,75,83,2,11,30,129,4,14,7,14,18,21,61,87,2,175,9,0,2,0,1,84940,33734,6751,45680,0
2,36,652,304,544,16,6,88,668,6,89,51,101,95,152,591,998,3,3399,188,0,2,0,1,84940,33735,6751,45681,0
2,36,2,2,2,0,0,0,2,0,0,0,0,0,0,0,0,0,0,0,0,2,0,1,84940,33735,6751,45681,0
2,36,8,5,5,0,0,3,8,0,0,0,0,0,0,0,0,0,0,0,0,2,0,1,84940,33735,6751,45682,0
2,36,2,2,2,0,0,0,2,0,0,0,0,0,0,0,0,0,0,0,0,2,0,1,84940,33735,6751,45682,0
2,36,14,8,8,0,0,6,14,0,0,0,0,0,0,0,0,0,0,0,0,2,0,1,84940,33735,6751,45683,0
2,36,6,4,4,0,0,2,6,0,0,0,0,0,0,0,0,0,0,0,0,2,0,1,84940,33735,6751,45684,0
2,36,6,4,4,0,0,2,6,1,2,1,2,3,3,2,4,0,2,0,0,2,0,1,84940,33735,6751,45685,0
2,36,6,4,4,0,0,2,6,0,0,0,0,0,0,0,0,0,0,0,0,2,0,1,84940,33735,6751,45686,0
2,36,7,5,5,0,0,2,7,0,0,0,0,0,0,0,0,0,0,0,0,2,0,1,84940,33735,6751,45687,0
2,36,6,4,4,0,0,2,6,0,0,0,0,0,0,0,0,0,0,0,0,2,0,1,84940,33735,6751,45688,0
2,36,10,6,6,0,0,4,10,0,0,0,0,0,0,0,0,0,0,0,0,2,0,1,84940,33735,6751,45689,0
2,36,1,1,1,0,0,0,1,0,0,0,0,0,0,0,0,0,0,0,0,2,0,1,84940,33735,6751,45689,0
2,36,14,10,10,0,0,4,14,1,1,1,1,2,2,0,2,0,1,0,0,2,0,1,84940,33735,6751,45690,0
2,36,46,26,30,3,0,12,49,3,6,3,6,9,9,20,28,1,42,2,0,2,0,1,84950,33735,6751,45691,0
1,6,2,2,2,0,0,0,2,0,0,0,0,0,0,0,0,0,0,0,0,2,0,1,84950,33735,6751,45691,0
1,26,127,75,83,2,11,30,129,4,14,7,14,18,21,61,87,2,175,9,0,2,0,1,84950,33735,6751,45692,0
1,26,652,304,544,16,6,88,668,6,89,51,101,95,152,591,998,3,3399,188,0,2,0,1,84950,33736,6751,45693,0
1,26,2,2,2,0,0,0,2,0,0,0,0,0,0,0,0,0,0,0,0,2,0,1,84950,33736,6751,45693,0
1,26,8,5,5,0,0,3,8,0,0,0,0,0,0,0,0,0,0,0,0,2,0,1,84950,33736,6751,45694,0
1,26,2,2,2,0,0,0,2,0,0,0,0,0,0,0,0,0,0,0,0,2,0,1,84950,33736,6751,45694,0
1,26,14,8,8,0,0,6,14,0,0,0,0,0,0,0,0,0,0,0,0,2,0,1,84950,33736,6751,45695,0
1,26,6,4,4,0,0,2,6,0,0,0,0,0,0,0,0,0,0,0,0,2,0,1,84950,33736,6751,45696,0
1,26,6,4,4,0,0,2,6,1,2,1,2,3,3,2,4,0,2,0,0,2,0,1,84950,33736,6751,45697,0
1,26,6,4,4,0,0,2,6,0,0,0,0,0,0,0,0,0,0,0,0,2,0,1,84950,33736,6751,45698,0
1,26,7,5,5,0,0,2,7,0,0,0,0,0,0,0,0,0,0,0,0,2,0,1,84950,33736,6751,45699,0
1,26,6,4,4,0,0,2,6,0,0,0,0,0,0,0,0,0,0,0,0,2,0,1,84950,33736,6751,45700,0
1,26,10,6,6,0,0,4,10,0,0,0,0,0,0,0,0,0,0,0,0,2,0,1,84950,33736,6751,45701,0
1,26,1,1,1,0,0,0,1,0,0,0,0,0,0,0,0,0,0,0,0,2,0,1,84950,33736,6751,45701,0
1,26,14,10,10,0,0,4,14,1,1,1,1,2,2,0,2,0,1,0,0,2,0,1,84950,33736,6751,45702,0
1,26,46,26,30,3,0,12,49,3,6,3,6,9,9,20,28,1,42,2,0,2,0,1,84960,33736,6751,45703,0
1,7,2,2,2,0,0,0,2,0,0,0,0,0,0,0,0,0,0,0,0,2,0,1,84960,33736,6751,45703,0
1,24,127,75,83,2,11,30,129,4,14,7,14,18,21,61,87,2,175,9,0,2,0,1,84960,33736,6751,45704,0
1,24,652,304,544,16,6,88,668,6,89,51,101,95,152,591,998,3,3399,188,0,2,0,1,84960,33737,6751,45705,0
1,24,2,2,2,0,0,0,2,0,0,0,0,0,0,0,0,0,0,0,0,2,0,1,84960,33737,6751,45705,0
1,24,8,5,5,0,0,3,8,0,0,0,0,0,0,0,0,0,0,0,0,2,0,1,84960,33737,6751,45706,0
1,24,2,2,2,0,0,0,2,0,0,0,0,0,0,0,0,0,0,0,0,2,0,1,84960,33737,6751,45706,0
1,24,14,8,8,0,0,6,14,0,0,0,0,0,0,0,0,0,0,0,0,2,0,1,84960,33737,6751,45707,0
1,24,6,4,4,0,0,2,6,0,0,0,0,0,0,0,0,0,0,0,0,2,0,1,84960,33737,6751,45708,0
1,24,6,4,4,0,0,2,6,1,2,1,2,3,3,2,4,0,2,0,0,2,0,1,84960,33737,6751,45709,0
1,24,6,4,4,0,0,2,6,0,0,0,0,0,0,0,0,0,0,0,0,2,0,1,84960,33737,6751,45710,0
1,24,7,5,5,0,0,2,7,0,0,0,0,0,0,0,0,0,0,0,0,2,0,1,84960,33737,6751,45711,0
1,24,6,4,4,0,0,2,6,0,0,0,0,0,0,0,0,0,0,0,0,2,0,1,84960,33737,6751,45712,0
1,24,10,6,6,0,0,4,10,0,0,0,0,0,0,0,0,0,0,0,0,2,0,1,84960,33737,6751,45713,0
1,24,1,1,1,0,0,0,1,0,0,0,0,0,0,0,0,0,0,0,0,2,0,1,84960,33737,6751,45713,0
1,24,14,10,10,0,0,4,14,1,1,1,1,2,2,0,2,0,1,0,0,2,0,1,84960,33737,6751,45714,0
1,24,46,26,30,3,0,12,49,3,6,3,6,9,9,20,28,1,42,2,0,2,0,1,84970,33737,6751,45715,0
1,7,2,2,2,0,0,0,2,0,0,0,0,0,0,0,0,0,0,0,0,2,0,1,84970,33737,6751,45715,0
3,33,15,9,9,0,0,6,15,0,0,0,0,0,0,0,0,0,0,0,0,2,0,1,84970,33737,6751,45716,0
1,13,127,75,83,2,11,30,129,4,14,7,14,18,21,61,87,2,175,9,0,2,0,1,84970,33737,6751,45717,0
1,13,652,304,544,16,6,88,668,6,89,51,101,95,152,591,998,3,3399,188,0,2,0,1,84970,33738,6751,45718,0
1,13,2,2,2,0,0,0,2,0,0,0,0,0,0,0,0,0,0,0,0,2,0,1,84970,33738,6751,45718,0
1,13,8,5,5,0,0,3,8,0,0,0,0,0,0,0,0,0,0,0,0,2,0,1,84970,33738,6751,45719,0
1,13,2,2,2,0,0,0,2,0,0,0,0,0,0,0,0,0,0,0,0,2,0,1,84970,33738,6751,45719,0
1,13,14,8,8,0,0,6,14,0,0,0,0,0,0,0,0,0,0,0,0,2,0,1,84970,33738,6751,45720,0
1,13,6,4,4,0,0,2,6,0,0,0,0,0,0,0,0,0,0,0,0,2,0,1,84970,33738,6751,45721,0
1,13,6,4,4,0,0,2,6,1,2,1,2,3,3,2,4,0,2,0,0,2,0,1,84970,33738,6751,45722,0
1,13,6,4,4,0,0,2,6,0,0,0,0,0,0,0,0,0,0,0,0,2,0,1,84970,33738,6751,45723,0
1,13,7,5,5,0,0,2,7,0,0,0,0,0,0,0,0,0,0,0,0,2,0,1,84970,33738,6751,45724,0
1,13,6,4,4,0,0,2,6,0,0,0,0,0,0,0,0,0,0,0,0,2,0,1,84970,33738,6751,45725,0
1,13,10,6,6,0,0,4,10,0,0,0,0,0,0,0,0,0,0,0,0,2,0,1,84970,33738,6751,45726,0
1,13,1,1,1,0,0,0,1,0,0,0,0,0,0,0,0,0,0,0,0,2,0,1,84970,33738,6751,45726,0
1,13,14,10,10,0,0,4,14,1,1,1,1,2,2,0,2,0,1,0,0,2,0,1,84970,33738,6751,45727,0
1,13,46,26,30,3,0,12,49,3,6,3,6,9,9,20,28,1,42,2,0,2,0,1,84980,33738,6751,45728,0
1,16,127,75,83,2,11,30,129,4,14,7,14,18,21,61,87,2,175,9,0,2,0,1,84980,33738,6751,45729,0
1,16,652,304,544,16,6,88,668,6,89,51,101,95,152,591,998,3,3399,188,0,2,0,1,84980,33739,6751,45730,0
1,16,2,2,2,0,0,0,2,0,0,0,0,0,0,0,0,0,0,0,0,2,0,1,84980,33739,6751,45730,0
1,16,8,5,5,0,0,3,8,0,0,0,0,0,0,0,0,0,0,0,0,2,0,1,84980,33739,6751,45731,0
1,16,2,2,2,0,0,0,2,0,0,0,0,0,0,0,0,0,0,0,0,2,0,1,84980,33739,6751,45731,0
1,16,14,8,8,0,0,6,14,0,0,0,0,0,0,0,0,0,0,0,0,2,0,1,84980,33739,6751,45732,0
1,16,6,4,4,0,0,2,6,0,0,0,0,0,0,0,0,0,0,0,0,2,0,1,84980,33739,6751,45733,0
1,16,6,4,4,0,0,2,6,1,2,1,2,3,3,2,4,0,2,0,0,2,0,1,84980,33739,6751,45734,0
1,16,6,4,4,0,0,2,6,0,0,0,0,0,0,0,0,0,0,0,0,2,0,1,84980,33739,6751,45735,0
1,16,7,5,5,0,0,2,7,0,0,0,0,0,0,0,0,0,0,0,0,2,0,1,84980,33739,6751,45736,0
1,16,6,4,4,0,0,2,6,0,0,0,0,0,0,0,0,0,0,0,0,2,0,1,84980,33739,6751,45737,0
1,16,10,6,6,0,0,4,10,0,0,0,0,0,0,0,0,0,0,0,0,2,0,1,84980,33739,6751,45738,0
1,16,1,1,1,0,0,0,1,0,0,0,0,0,0,0,0,0,0,0,0,2,0,1,84980,33739,6751,45738,0
1,16,14,10,10,0,0,4,14,1,1,1,1,2,2,0,2,0,1,0,0,2,0,1,84980,33739,6751,45739,0
1,16,46,26,30,3,0,12,49,3,6,3,6,9,9,20,28,1,42,2,0,2,0,1,84990,33739,6751,45740,0
1,10,2,2,2,0,0,0,2,1,2,1,2,3,3,2,4,0,2,0,0,2,0,1,84990,33739,6751,45740,0
1,13,127,75,83,2,11,30,129,4,14,7,14,18,21,61,87,2,175,9,0,2,0,1,84990,33739,6751,45741,0
1,13,652,304,544,16,6,88,668,6,89,51,101,95,152,591,998,3,3399,188,0,2,0,1,84990,33740,6751,45742,0
1,13,2,2,2,0,0,0,2,0,0,0,0,0,0,0,0,0,0,0,0,2,0,1,84990,33740,6751,45742,0
1,13,8,5,5,0,0,3,8,0,0,0,0,0,0,0,0,0,0,0,0,2,0,1,84990,33740,6751,45743,0
1,13,2,2,2,0,0,0,2,0,0,0,0,0,0,0,0,0,0,0,0,2,0,1,84990,33740,6751,45743,0
1,13,14,8,8,0,0,6,14,0,0,0,0,0,0,0,0,0,0,0,0,2,0,1,84990,33740,6751,45744,0
1,13,6,4,4,0,0,2,6,0,0,0,0,0,0,0,0,0,0,0,0,2,0,1,84990,33740,6751,45745,0
1,13,6,4,4,0,0,2,6,1,2,1,2,3,3,2,4,0,2,0,0,2,0,1,84990,33740,6751,45746,0
1,13,6,4,4,0,0,2,6,0,0,0,0,0,0,0,0,0,0,0,0,2,0,1,84990,33740,6751,45747,0
1,13,7,5,5,0,0,2,7,0,0,0,0,0,0,0,0,0,0,0,0,2,0,1,84990,33740,6751,45748,0
1,13,6,4,4,0,0,2,6,0,0,0,0,0,0,0,0,0,0,0,0,2,0,1,84990,33740,6751,45749,0
1,13,10,6,6,0,0,4,10,0,0,0,0,0,0,0,0,0,0,0,0,2,0,1,84990,33740,6751,45750,0
1,13,1,1,1,0,0,0,1,0,0,0,0,0,0,0,0,0,0,0,0,2,0,1,84990,33740,6751,45750,0
1,13,14,10,10,0,0,4,14,1,1,1,1,2,2,0,2,0,1,0,0,2,0,1,84990,33740,6751,45751,0
1,13,46,26,30,3,0,12,49,3,6,3,6,9,9,20,28,1,42,2,0,2,0,1,85000,33740,6751,45752,0
2,26,10,6,6,0,0,4,10,2,4,2,4,6,6,10,15,1,15,0,0,2,0,1,85000,33740,6751,45753,0
3,44,15,10,10,0,0,5,15,2,4,2,4,6,6,10,15,1,15,0,0,2,1,2,85000,33740,6751,45754,0
3,39,15,9,9,0,0,6,15,0,0,0,0,0,0,0,0,0,0,0,0,2,0,1,85000,33740,6751,45755,0
2,33,10,7,7,0,0,3,10,1,2,1,2,3,3,2,4,0,2,0,0,2,1,2,85000,33740,6751,45756,0
3,43,15,9,9,0,0,6,15,1,4,2,4,5,6,8,13,0,6,0,0,2,1,2,85000,33740,6751,45757,0
2,21,10,6,6,0,0,4,10,0,0,0,0,0,0,0,0,0,0,0,0,2,0,1,85000,33740,6751,45758,0
4,61,20,12,12,0,0,8,20,1,2,1,2,3,3,2,4,0,2,0,0,2,0,1,85000,33740,6751,45759,0
2,51,127,75,83,2,11,30,129,4,14,7,14,18,21,61,87,2,175,9,0,2,0,1,85000,33740,6751,45760,0
2,51,652,304,544,16,6,88,668,6,89,51,101,95,152,591,998,3,3399,188,0,2,0,1,85000,33741,6751,45761,0
2,51,2,2,2,0,0,0,2,0,0,0,0,0,0,0,0,0,0,0,0,2,0,1,85000,33741,6751,45761,0
2,51,8,5,5,0,0,3,8,0,0,0,0,0,0,0,0,0,0,0,0,2,0,1,85000,33741,6751,45762,0
2,51,2,2,2,0,0,0,2,0,0,0,0,0,0,0,0,0,0,0,0,2,0,1,85000,33741,6751,45762,0
2,51,14,8,8,0,0,6,14,0,0,0,0,0,0,0,0,0,0,0,0,2,0,1,85000,33741,6751,45763,0
2,51,6,4,4,0,0,2,6,0,0,0,0,0,0,0,0,0,0,0,0,2,0,1,85000,33741,6751,45764,0
2,51,6,4,4,0,0,2,6,1,2,1,2,3,3,2,4,0,2,0,0,2,0,1,85000,33741,6751,45765,0
2,51,6,4,4,0,0,2,6,0,0,0,0,0,0,0,0,0,0,0,0,2,0,1,85000,33741,6751,45766,0
2,51,7,5,5,0,0,2,7,0,0,0,0,0,0,0,0,0,0,0,0,2,0,1,85000,33741,6751,45767,0
2,51,6,4,4,0,0,2,6,0,0,0,0,0,0,0,0,0,0,0,0,2,0,1,85000,33741,6751,45768,0
2,51,10,6,6,0,0,4,10,0,0,0,0,0,0,0,0,0,0,0,0,2,0,1,85000,33741,6751,45769,0
2,51,1,1,1,0,0,0,1,0,0,0,0,0,0,0,0,0,0,0,0,2,0,1,85000,33741,6751,45769,0
2,51,14,10,10,0,0,4,14,1,1,1,1,2,2,0,2,0,1,0,0,2,0,1,85000,33741,6751,45770,0
2,51,46,26,30,3,0,12,49,3,6,3,6,9,9,20,28,1,42,2,0,2,0,1,85010,33741,6751,45771,0
1,6,2,2,2,0,0,0,2,0,0,0,0,0,0,0,0,0,0,0,0,2,0,1,85010,33741,6751,45771,0
8,263,51,25,36,0,0,15,51,3,11,6,12,14,18,42,68,1,112,6,0,2,0,1,85010,33741,6751,45772,0
1,14,6,4,4,0,0,2,6,0,0,0,0,0,0,0,0,0,0,0,0,2,0,1,85010,33741,6751,45773,0
4,163,27,21,21,0,0,6,27,3,6,3,6,9,9,20,28,1,42,2,0,2,0,1,85010,33741,6751,45774,0
1,6,2,2,2,0,0,0,2,0,0,0,0,0,0,0,0,0,0,0,0,2,0,1,85010,33741,6751,45774,0
1,41,7,5,5,0,0,2,7,1,2,1,2,3,3,2,4,0,2,0,0,2,0,1,85010,33741,6751,45775,0
2,51,14,9,9,0,0,5,14,0,0,0,0,0,0,0,0,0,0,0,0,2,0,1,85010,33741,6751,45776,0
2,40,13,9,8,0,0,4,13,0,0,0,0,0,0,0,0,0,0,0,0,2,0,1,85010,33741,6751,45777,0
2,42,14,10,9,0,0,4,14,0,0,0,0,0,0,0,0,0,0,0,0,2,0,1,85010,33741,6751,45778,0
2,33,12,8,7,0,0,4,12,0,0,0,0,0,0,0,0,0,0,0,0,2,0,1,85010,33741,6751,45779,0
3,49,16,9,9,0,0,7,16,0,0,0,0,0,0,0,0,0,0,0,0,2,0,1,85010,33741,6751,45780,0
1,18,3,3,3,0,0,0,3,0,0,0,0,0,0,0,0,0,0,0,0,2,0,1,85010,33741,6751,45780,0
2,26,6,4,4,0,0,2,6,1,4,2,4,5,6,8,13,0,6,0,0,2,0,1,85010,33741,6751,45782,0
12,313,149,95,105,2,0,41,151,8,54,28,55,62,83,334,494,4,2013,111,0,2,3,4,85010,33741,6751,45784,0
15,699,139,89,101,2,0,35,141,7,54,34,62,61,96,330,569,4,2287,127,0,2,4,5,85010,33741,6751,45785,0
3,299,149,67,118,4,0,27,153,1,17,14,28,18,42,69,175,0,144,8,0,2,27,8,85010,33741,6751,45786,0
38,2493,1157,318,931,29,22,177,1186,6,104,63,125,110,188,712,1274,3,4596,255,0,2,5,10,85010,33741,6751,45787,0
65,4371,520,294,400,33,13,81,553,10,261,204,367,271,571,2128,4614,7,32445,1802,1,2,3,5,85010,33742,6751,45788,0
90,3959,1338,495,1086,10,64,173,1348,11,122,82,157,133,239,883,1686,7,11934,663,0,2,11,25,85010,33744,6751,45789,0
172,7590,4293,999,3693,19,54,507,4312,9,155,88,170,164,258,1156,1898,4,9368,520,0,2,17,24,85010,33746,6751,45790,0
172,7590,1482,859,1002,125,135,219,1607,16,219,134,251,235,385,1766,3032,9,27804,1544,1,2,17,24,85020,33747,6751,45791,0
33,984,465,148,393,5,8,60,470,4,31,20,31,35,51,161,261,2,523,29,0,2,5,6,85020,33748,6751,45792,0
33,984,16,12,9,0,0,6,16,1,2,1,2,3,3,2,4,0,2,0,0,2,5,6,85020,33748,6751,45793,0
144,5870,1782,648,1425,9,47,279,1791,8,171,97,189,179,286,1292,2140,4,9462,525,0,2,32,36,85020,33749,6752,45794,0
32,968,256,139,192,9,7,47,265,4,23,12,24,27,36,112,171,2,357,19,0,2,8,23,85020,33750,6752,45795,0
6,328,180,34,164,0,0,16,180,1,12,6,12,13,18,43,66,0,33,1,0,2,0,3,85020,33750,6752,45796,0
19,499,102,59,69,5,3,24,107,6,22,15,28,28,43,113,206,3,789,43,0,2,3,20,85020,33750,6752,45797,0
119,4854,1450,624,1228,12,26,181,1462,14,306,186,354,320,540,2580,4493,8,36391,2021,1,2,28,95,85020,33752,6753,45798,0
176,5109,1660,832,1314,41,38,274,1701,20,312,209,395,332,604,2671,5058,12,64042,3557,1,2,48,113,85020,33754,6754,45800,0
49,3780,996,429,845,24,10,117,1020,7,76,50,88,83,138,494,879,4,3565,198,0,2,5,10,85020,33756,6754,45801,0
120,5083,1513,682,1277,25,13,200,1538,11,199,116,219,210,335,1557,2584,6,15641,868,0,2,19,86,85020,33758,6754,45802,0
84,4871,1296,573,1062,40,33,157,1336,8,201,118,231,209,349,1561,2689,4,12365,686,0,2,11,18,85020,33758,6754,45803,0
20,449,207,111,150,11,0,50,218,5,26,19,36,31,55,133,272,3,943,52,0,2,2,14,85020,33758,6754,45804,0
98,5169,1457,730,1242,11,6,188,1468,10,292,166,329,302,495,2424,4078,5,22973,1276,1,2,20,28,85020,33760,6754,45805,0
43,2669,652,304,544,16,6,88,668,6,89,51,101,95,152,591,998,3,3399,188,0,2,3,8,85020,33761,6754,45806,0
72,3231,1455,414,1257,16,76,112,1471,5,41,23,46,46,69,231,381,2,1069,59,0,2,13,26,85020,33762,6754,45807,0
2,44,7,6,5,0,0,2,7,1,1,1,2,2,3,0,3,1,3,0,0,2,0,5,85020,33762,6754,45808,0
8,263,74,35,59,1,0,14,75,3,14,7,14,17,21,58,85,1,128,7,0,2,0,5,85020,33763,6754,45809,0
107,5128,1523,757,1297,19,12,193,1542,12,193,117,230,205,347,1508,2664,7,19053,1058,0,2,15,22,85030,33765,6754,45810,0
70,3177,1020,354,843,12,15,144,1032,8,134,77,144,142,221,970,1580,4,6792,377,0,2,29,22,85030,33765,6754,45811,0
44,2024,447,308,343,6,5,95,453,7,96,59,111,103,170,651,1136,4,4600,255,0,2,10,35,85030,33768,6754,45812,0
3,229,53,23,39,0,0,13,53,2,8,4,8,10,12,26,39,1,39,2,0,2,0,1,85030,33768,6754,45813,0
21,637,424,94,331,4,0,89,428,1,5,5,5,6,10,11,25,0,12,0,0,2,4,10,85030,33769,6754,45814,0
38,2309,334,251,279,10,4,40,344,5,127,74,143,132,217,899,1528,2,4303,239,0,2,2,7,85030,33770,6754,45815,0
9,423,184,100,137,2,15,30,186,6,38,20,39,44,59,214,322,3,991,55,0,2,9,25,85030,33771,6754,45816,0
8,377,91,45,69,0,3,18,91,3,9,6,10,12,16,33,57,1,95,5,0,2,0,1,85030,33773,6754,45817,0
75,3937,1293,570,1093,25,15,163,1318,10,195,123,241,205,364,1516,2795,6,17273,959,0,2,10,29,85040,33775,6754,45818,0
29,1873,384,251,317,7,8,52,391,11,70,44,84,81,128,467,811,6,5355,297,0,2,9,15,85040,33775,6754,45819,0
56,2846,722,423,573,19,0,135,741,12,172,101,199,184,300,1320,2257,6,15668,870,0,2,10,15,85040,33777,6754,45821,0
45,1932,386,256,301,16,9,68,402,4,59,35,69,63,104,355,621,2,1453,80,0,2,3,8,85040,33777,6754,45822,0
28,1590,466,257,367,18,25,50,484,7,126,86,171,133,257,898,1813,4,8612,478,0,2,2,3,85040,33777,6754,45823,0
15,1051,215,129,180,6,0,29,221,8,65,43,72,73,115,415,711,4,3153,175,0,2,1,6,85040,33777,6754,45824,0
85,3359,1043,504,840,53,9,147,1096,9,180,112,198,189,310,1377,2344,4,11604,644,0,2,10,20,85040,33779,6754,45825,0
12,466,295,56,236,0,4,54,295,2,9,5,10,11,15,30,51,1,57,3,0,2,0,5,85040,33781,6754,45826,0
30,1422,373,158,315,8,0,51,381,5,76,44,79,81,123,486,779,2,2026,112,0,2,2,7,85040,33781,6754,45827,0
79,3071,1178,367,1042,6,15,115,1184,9,94,51,95,103,146,644,976,4,4439,246,0,2,7,31,85040,33781,6754,45828,0
9,449,219,78,157,11,5,46,230,3,24,20,34,27,54,114,256,2,545,30,0,2,0,1,85040,33782,6754,45829,0
111,6048,1943,715,1694,26,18,214,1969,12,185,120,237,197,357,1436,2721,7,20915,1161,0,2,26,31,85040,33784,6754,45830,0
35,1473,442,244,305,14,16,103,456,11,68,45,75,79,120,452,756,6,4588,254,0,2,4,12,85040,33786,6754,45831,0
48,1928,1098,241,925,5,10,155,1103,7,46,25,49,53,74,273,423,3,1580,87,0,2,6,21,85050,33788,6754,45832,0
48,1639,601,196,481,2,23,85,603,8,63,36,72,71,108,400,664,4,3036,168,0,2,4,103,85050,33788,6754,45833,0
168,5062,1660,832,1314,41,38,274,1701,20,312,209,395,332,604,2671,5058,12,64042,3557,1,2,0,31,85050,33790,6755,45835,0
168,5062,1057,646,719,113,100,145,1170,18,215,134,248,233,382,1740,3004,10,31186,1732,1,2,0,31,85060,33791,6756,45836,0
168,4910,1660,832,1314,41,38,274,1701,20,312,209,395,332,604,2671,5058,12,64042,3557,1,2,0,78,85060,33793,6757,45838,0
236,4872,2,2,2,0,0,0,2,0,0,0,0,0,0,0,0,0,0,0,0,2,1,1,85060,33793,6757,45838,0
236,4872,99,48,90,1,3,5,100,0,0,0,0,0,0,0,0,0,0,0,0,2,1,1,85060,33794,6757,45839,0
236,4872,8,5,5,2,0,1,10,0,0,0,0,0,0,0,0,0,0,0,0,2,1,1,85060,33794,6757,45840,0
236,4872,1217,716,841,84,126,174,1301,14,185,118,215,199,333,1446,2542,8,20687,1149,0,2,1,1,85070,33796,6757,45841,0
236,4872,160,89,115,0,13,31,160,7,15,11,17,22,28,78,124,3,495,27,0,2,1,1,85070,33796,6757,45842,0
236,4872,10,10,9,9,0,0,19,0,0,0,0,0,0,0,0,0,0,0,0,2,1,1,85070,33796,6758,45843,0
236,4872,173,84,99,8,29,36,181,5,12,7,13,17,20,54,81,2,221,12,0,2,1,1,85070,33797,6758,45844,0
236,4872,3,1,1,3,0,0,6,0,0,0,0,0,0,0,0,0,0,0,0,2,1,1,85070,33797,6758,45845,0
101,5251,1457,730,1242,11,6,188,1468,10,292,166,329,302,495,2424,4078,5,22973,1276,1,2,23,0,85070,33799,6758,45846,0
65,1270,1098,241,925,5,10,155,1103,7,46,25,49,53,74,273,423,3,1580,87,0,2,2,0,85080,33801,6758,45847,0
65,1270,282,202,222,14,2,44,296,8,42,24,43,50,67,250,378,4,1548,86,0,2,2,0,85080,33802,6758,45848,0
49,1964,1098,241,925,5,10,155,1103,7,46,25,49,53,74,273,423,3,1580,87,0,2,23,0,85090,33804,6758,45849,0
236,4872,2,2,2,0,0,0,2,0,0,0,0,0,0,0,0,0,0,0,0,2,1,1,85090,33804,6758,45849,0
236,4872,99,48,90,1,3,5,100,0,0,0,0,0,0,0,0,0,0,0,0,2,1,1,85090,33805,6758,45850,0
236,4872,8,5,5,2,0,1,10,0,0,0,0,0,0,0,0,0,0,0,0,2,1,1,85090,33805,6758,45851,0
236,4872,1217,716,841,84,126,174,1301,14,185,118,215,199,333,1446,2542,8,20687,1149,0,2,1,1,85100,33807,6758,45852,0
236,4872,160,89,115,0,13,31,160,7,15,11,17,22,28,78,124,3,495,27,0,2,1,1,85100,33807,6758,45853,0
236,4872,10,10,9,9,0,0,19,0,0,0,0,0,0,0,0,0,0,0,0,2,1,1,85100,33807,6759,45854,0
236,4872,173,84,99,8,29,36,181,5,12,7,13,17,20,54,81,2,221,12,0,2,1,1,85100,33808,6759,45855,0
236,4872,3,1,1,3,0,0,6,0,0,0,0,0,0,0,0,0,0,0,0,2,1,1,85100,33808,6759,45856,0
101,5251,1457,730,1242,11,6,188,1468,10,292,166,329,302,495,2424,4078,5,22973,1276,1,2,23,0,85100,33810,6759,45857,0
18,476,205,80,86,16,53,53,221,7,18,10,19,25,29,94,134,3,497,27,0,2,1,4,85110,33810,6760,45858,0
226,5756,722,423,573,19,0,135,741,12,172,101,199,184,300,1320,2257,6,15668,870,0,2,10,26,85110,33812,6760,45860,0
226,5756,1508,847,911,44,250,301,1552,14,148,88,169,162,257,1120,1886,7,15077,837,0,2,10,26,85110,33813,6761,45861,0
65,1270,1098,241,925,5,10,155,1103,7,46,25,49,53,74,273,423,3,1580,87,0,2,2,0,85120,33815,6761,45862,0
65,1270,282,202,222,14,2,44,296,8,42,24,43,50,67,250,378,4,1548,86,0,2,2,0,85120,33816,6761,45863,0
49,1964,1098,241,925,5,10,155,1103,7,46,25,49,53,74,273,423,3,1580,87,0,2,23,0,85130,33818,6761,45864,0
163,4979,1660,832,1314,41,38,274,1701,20,312,209,395,332,604,2671,5058,12,64042,3557,1,2,3,15,85130,33820,6762,45866,1
163,4979,1057,646,719,113,100,145,1170,18,215,134,248,233,382,1740,3004,10,31186,1732,1,2,3,15,85140,33821,6763,45867,1
114,2084,477,336,357,30,23,73,507,16,194,134,250,210,384,1538,2962,10,30538,1696,0,2,2,11,85150,33822,6763,45868,1
59,1095,207,111,150,11,0,50,218,5,26,19,36,31,55,133,272,3,943,52,0,2,1,1,85150,33822,6763,45869,1
59,1095,410,198,237,31,55,97,441,11,63,38,72,74,110,414,683,6,4293,238,0,2,1,1,85160,33823,6764,45870,1
57,1176,91,45,69,0,3,18,91,3,9,6,10,12,16,33,57,1,95,5,0,2,1,3,85160,33825,6764,45871,1
57,1176,367,234,237,17,34,68,384,16,55,34,61,71,95,381,584,8,5183,287,0,2,1,3,85160,33826,6764,45872,1
104,4398,1289,550,1043,56,32,155,1345,10,167,93,185,177,278,1266,2075,5,11498,638,0,2,3,11,85160,33828,6765,45873,1
95,2843,773,419,590,28,0,166,801,10,204,113,217,214,330,1598,2554,5,13587,754,0,2,1,1,85160,33828,6766,45874,1
90,3959,1338,495,1086,10,64,173,1348,11,122,82,157,133,239,883,1686,7,11934,663,0,2,1,1,85160,33830,6766,45875,1
119,4854,1450,624,1228,12,26,181,1462,14,306,186,354,320,540,2580,4493,8,36391,2021,1,2,1,1,85160,33832,6767,45876,1
120,5083,1513,682,1277,25,13,200,1538,11,199,116,219,210,335,1557,2584,6,15641,868,0,2,7,7,85160,33834,6767,45877,1
72,3231,1455,414,1257,16,76,112,1471,5,41,23,46,46,69,231,381,2,1069,59,0,2,2,2,85160,33835,6767,45878,1
107,5128,1523,757,1297,19,12,193,1542,12,193,117,230,205,347,1508,2664,7,19053,1058,0,2,3,3,85170,33837,6767,45879,1
21,637,424,94,331,4,0,89,428,1,5,5,5,6,10,11,25,0,12,0,0,2,1,1,85170,33838,6767,45880,1
56,2845,722,423,573,19,0,135,741,12,172,101,199,184,300,1320,2257,6,15668,870,0,2,3,5,85170,33840,6767,45882,1
85,3340,1043,504,840,53,9,147,1096,9,180,112,198,189,310,1377,2344,4,11604,644,0,2,3,5,85170,33842,6767,45883,1
111,6048,1943,715,1694,26,18,214,1969,12,185,120,237,197,357,1436,2721,7,20915,1161,0,2,0,1,85170,33844,6767,45884,1
48,1639,601,196,481,2,23,85,603,8,63,36,72,71,108,400,664,4,3036,168,0,2,4,4,85170,33844,6767,45885,1
18,476,205,80,86,16,53,53,221,7,18,10,19,25,29,94,134,3,497,27,0,2,1,4,85180,33844,6768,45886,0
226,5756,722,423,573,19,0,135,741,12,172,101,199,184,300,1320,2257,6,15668,870,0,2,10,26,85180,33846,6768,45888,0
226,5756,1508,847,911,44,250,301,1552,14,148,88,169,162,257,1120,1886,7,15077,837,0,2,10,26,85180,33847,6769,45889,0
163,4979,1660,832,1314,41,38,274,1701,20,312,209,395,332,604,2671,5058,12,64042,3557,1,2,3,15,85180,33849,6770,45891,0
163,4979,1057,646,719,113,100,145,1170,18,215,134,248,233,382,1740,3004,10,31186,1732,1,2,3,15,85190,33850,6771,45892,0
114,2084,477,336,357,30,23,73,507,16,194,134,250,210,384,1538,2962,10,30538,1696,0,2,2,11,85200,33851,6771,45893,0
59,1095,207,111,150,11,0,50,218,5,26,19,36,31,55,133,272,3,943,52,0,2,1,1,85200,33851,6771,45894,0
59,1095,410,198,237,31,55,97,441,11,63,38,72,74,110,414,683,6,4293,238,0,2,1,1,85210,33852,6772,45895,0
57,1176,91,45,69,0,3,18,91,3,9,6,10,12,16,33,57,1,95,5,0,2,1,3,85210,33854,6772,45896,0
57,1176,367,234,237,17,34,68,384,16,55,34,61,71,95,381,584,8,5183,287,0,2,1,3,85210,33855,6772,45897,0
104,4398,1289,550,1043,56,32,155,1345,10,167,93,185,177,278,1266,2075,5,11498,638,0,2,3,11,85210,33857,6773,45898,0
95,2843,773,419,590,28,0,166,801,10,204,113,217,214,330,1598,2554,5,13587,754,0,2,1,1,85210,33857,6774,45899,0
90,3959,1338,495,1086,10,64,173,1348,11,122,82,157,133,239,883,1686,7,11934,663,0,2,1,1,85210,33859,6774,45900,0
119,4854,1450,624,1228,12,26,181,1462,14,306,186,354,320,540,2580,4493,8,36391,2021,1,2,1,1,85210,33861,6775,45901,0
120,5083,1513,682,1277,25,13,200,1538,11,199,116,219,210,335,1557,2584,6,15641,868,0,2,7,7,85210,33863,6775,45902,0
72,3231,1455,414,1257,16,76,112,1471,5,41,23,46,46,69,231,381,2,1069,59,0,2,2,2,85210,33864,6775,45903,0
107,5128,1523,757,1297,19,12,193,1542,12,193,117,230,205,347,1508,2664,7,19053,1058,0,2,3,3,85220,33866,6775,45904,0
21,637,424,94,331,4,0,89,428,1,5,5,5,6,10,11,25,0,12,0,0,2,1,1,85220,33867,6775,45905,0
56,2845,722,423,573,19,0,135,741,12,172,101,199,184,300,1320,2257,6,15668,870,0,2,3,5,85220,33869,6775,45907,0
85,3340,1043,504,840,53,9,147,1096,9,180,112,198,189,310,1377,2344,4,11604,644,0,2,3,5,85220,33871,6775,45908,0
111,6048,1943,715,1694,26,18,214,1969,12,185,120,237,197,357,1436,2721,7,20915,1161,0,2,0,1,85220,33873,6775,45909,0
48,1639,601,196,481,2,23,85,603,8,63,36,72,71,108,400,664,4,3036,168,0,2,4,4,85220,33873,6775,45910,0
8,210,127,75,83,2,11,30,129,4,14,7,14,18,21,61,87,2,175,9,0,2,15,0,85220,33873,6775,45911,0
8,210,652,304,544,16,6,88,668,6,89,51,101,95,152,591,998,3,3399,188,0,2,15,0,85220,33874,6775,45912,0
8,210,2,2,2,0,0,0,2,0,0,0,0,0,0,0,0,0,0,0,0,2,15,0,85220,33874,6775,45912,0
8,210,8,5,5,0,0,3,8,0,0,0,0,0,0,0,0,0,0,0,0,2,15,0,85220,33874,6775,45913,0
8,210,2,2,2,0,0,0,2,0,0,0,0,0,0,0,0,0,0,0,0,2,15,0,85220,33874,6775,45913,0
8,210,14,8,8,0,0,6,14,0,0,0,0,0,0,0,0,0,0,0,0,2,15,0,85220,33874,6775,45914,0
8,210,6,4,4,0,0,2,6,0,0,0,0,0,0,0,0,0,0,0,0,2,15,0,85220,33874,6775,45915,0
8,210,6,4,4,0,0,2,6,1,2,1,2,3,3,2,4,0,2,0,0,2,15,0,85220,33874,6775,45916,0
8,210,6,4,4,0,0,2,6,0,0,0,0,0,0,0,0,0,0,0,0,2,15,0,85220,33874,6775,45917,0
8,210,7,5,5,0,0,2,7,0,0,0,0,0,0,0,0,0,0,0,0,2,15,0,85220,33874,6775,45918,0
8,210,6,4,4,0,0,2,6,0,0,0,0,0,0,0,0,0,0,0,0,2,15,0,85220,33874,6775,45919,0
8,210,10,6,6,0,0,4,10,0,0,0,0,0,0,0,0,0,0,0,0,2,15,0,85220,33874,6775,45920,0
8,210,1,1,1,0,0,0,1,0,0,0,0,0,0,0,0,0,0,0,0,2,15,0,85220,33874,6775,45920,0
8,210,14,10,10,0,0,4,14,1,1,1,1,2,2,0,2,0,1,0,0,2,15,0,85220,33874,6775,45921,0
8,210,46,26,30,3,0,12,49,3,6,3,6,9,9,20,28,1,42,2,0,2,15,0,85230,33874,6775,45922,0
8,210,127,75,83,2,11,30,129,4,14,7,14,18,21,61,87,2,175,9,0,2,15,0,85230,33874,6775,45923,0
8,210,652,304,544,16,6,88,668,6,89,51,101,95,152,591,998,3,3399,188,0,2,15,0,85230,33875,6775,45924,0
8,210,2,2,2,0,0,0,2,0,0,0,0,0,0,0,0,0,0,0,0,2,15,0,85230,33875,6775,45924,0
8,210,8,5,5,0,0,3,8,0,0,0,0,0,0,0,0,0,0,0,0,2,15,0,85230,33875,6775,45925,0
8,210,2,2,2,0,0,0,2,0,0,0,0,0,0,0,0,0,0,0,0,2,15,0,85230,33875,6775,45925,0
8,210,14,8,8,0,0,6,14,0,0,0,0,0,0,0,0,0,0,0,0,2,15,0,85230,33875,6775,45926,0
8,210,6,4,4,0,0,2,6,0,0,0,0,0,0,0,0,0,0,0,0,2,15,0,85230,33875,6775,45927,0
8,210,6,4,4,0,0,2,6,1,2,1,2,3,3,2,4,0,2,0,0,2,15,0,85230,33875,6775,45928,0
8,210,6,4,4,0,0,2,6,0,0,0,0,0,0,0,0,0,0,0,0,2,15,0,85230,33875,6775,45929,0
8,210,7,5,5,0,0,2,7,0,0,0,0,0,0,0,0,0,0,0,0,2,15,0,85230,33875,6775,45930,0
8,210,6,4,4,0,0,2,6,0,0,0,0,0,0,0,0,0,0,0,0,2,15,0,85230,33875,6775,45931,0
8,210,10,6,6,0,0,4,10,0,0,0,0,0,0,0,0,0,0,0,0,2,15,0,85230,33875,6775,45932,0
8,210,1,1,1,0,0,0,1,0,0,0,0,0,0,0,0,0,0,0,0,2,15,0,85230,33875,6775,45932,0
8,210,14,10,10,0,0,4,14,1,1,1,1,2,2,0,2,0,1,0,0,2,15,0,85230,33875,6775,45933,0
8,210,46,26,30,3,0,12,49,3,6,3,6,9,9,20,28,1,42,2,0,2,15,0,85240,33875,6775,45934,0
23,642,601,196,481,2,23,85,603,8,63,36,72,71,108,400,664,4,3036,168,0,2,1,0,85240,33875,6775,45935,1
23,642,156,79,106,5,16,28,161,5,14,8,15,19,23,64,97,2,261,14,0,2,1,0,85240,33875,6775,45936,1
172,7582,4293,999,3693,19,54,507,4312,9,155,88,170,164,258,1156,1898,4,9368,520,0,2,1,2,85240,33877,6775,45937,1
172,7582,1482,859,1002,125,135,219,1607,16,219,134,251,235,385,1766,3032,9,27804,1544,1,2,1,2,85250,33878,6775,45938,1
52,1740,601,196,481,2,23,85,603,8,63,36,72,71,108,400,664,4,3036,168,0,2,31,0,85250,33878,6775,45939,1
105,2754,773,422,505,30,103,129,803,14,77,46,83,91,129,535,839,7,6334,351,0,2,9,4,85260,33879,6776,45940,0
42,2613,1157,318,931,29,22,177,1186,6,104,63,125,110,188,712,1274,3,4596,255,0,2,37,6,85260,33879,6776,45941,0
105,2754,773,422,505,30,103,129,803,14,77,46,83,91,129,535,839,7,6334,351,0,2,9,4,85270,33880,6777,45942,0
42,2613,1157,318,931,29,22,177,1186,6,104,63,125,110,188,712,1274,3,4596,255,0,2,37,6,85270,33880,6777,45943,0
23,642,601,196,481,2,23,85,603,8,63,36,72,71,108,400,664,4,3036,168,0,2,1,0,85270,33880,6777,45944,0
23,642,156,79,106,5,16,28,161,5,14,8,15,19,23,64,97,2,261,14,0,2,1,0,85270,33880,6777,45945,0
172,7582,4293,999,3693,19,54,507,4312,9,155,88,170,164,258,1156,1898,4,9368,520,0,2,1,2,85270,33882,6777,45946,0
172,7582,1482,859,1002,125,135,219,1607,16,219,134,251,235,385,1766,3032,9,27804,1544,1,2,1,2,85280,33883,6777,45947,0
52,1740,601,196,481,2,23,85,603,8,63,36,72,71,108,400,664,4,3036,168,0,2,31,0,85280,33883,6777,45948,0
219,4666,182,127,129,0,0,53,182,5,39,21,42,44,63,217,343,2,926,51,0,2,0,7,85280,33883,6778,45949,0
219,4666,1165,710,800,67,119,181,1232,18,243,153,282,261,435,2000,3492,10,36473,2026,1,2,0,7,85290,33883,6779,45950,0
150,7150,1392,870,1177,35,17,170,1427,14,494,280,531,508,811,4473,7289,7,54850,3047,2,2,3,11,85290,33886,6780,45951,0
114,2073,477,336,357,30,23,73,507,16,194,134,250,210,384,1538,2962,10,30538,1696,0,2,2,9,85300,33887,6780,45952,0
18,474,205,80,86,16,53,53,221,7,18,10,19,25,29,94,134,3,497,27,0,2,1,1,85310,33887,6781,45953,0
12,314,149,95,105,2,0,41,151,8,54,28,55,62,83,334,494,4,2013,111,0,2,1,1,85310,33887,6781,45954,0
172,7582,4293,999,3693,19,54,507,4312,9,155,88,170,164,258,1156,1898,4,9368,520,0,2,2,2,85310,33889,6781,45955,0
172,7582,1482,859,1002,125,135,219,1607,16,219,134,251,235,385,1766,3032,9,27804,1544,1,2,2,2,85320,33890,6781,45956,0
32,965,256,139,192,9,7,47,265,4,23,12,24,27,36,112,171,2,357,19,0,2,1,1,85320,33891,6781,45957,0
55,2831,722,423,573,19,0,135,741,12,172,101,199,184,300,1320,2257,6,15668,870,0,2,1,6,85320,33893,6781,45959,0
35,1463,442,244,305,14,16,103,456,11,68,45,75,79,120,452,756,6,4588,254,0,2,0,1,85320,33895,6781,45960,0
114,2073,477,336,357,30,23,73,507,16,194,134,250,210,384,1538,2962,10,30538,1696,0,2,2,9,85330,33896,6781,45961,0
18,474,205,80,86,16,53,53,221,7,18,10,19,25,29,94,134,3,497,27,0,2,1,1,85340,33896,6782,45962,0
12,314,149,95,105,2,0,41,151,8,54,28,55,62,83,334,494,4,2013,111,0,2,1,1,85340,33896,6782,45963,0
172,7582,4293,999,3693,19,54,507,4312,9,155,88,170,164,258,1156,1898,4,9368,520,0,2,2,2,85340,33898,6782,45964,0
172,7582,1482,859,1002,125,135,219,1607,16,219,134,251,235,385,1766,3032,9,27804,1544,1,2,2,2,85350,33899,6782,45965,0
32,965,256,139,192,9,7,47,265,4,23,12,24,27,36,112,171,2,357,19,0,2,1,1,85350,33900,6782,45966,0
55,2831,722,423,573,19,0,135,741,12,172,101,199,184,300,1320,2257,6,15668,870,0,2,1,6,85350,33902,6782,45968,0
35,1463,442,244,305,14,16,103,456,11,68,45,75,79,120,452,756,6,4588,254,0,2,0,1,85350,33904,6782,45969,0
219,4666,182,127,129,0,0,53,182,5,39,21,42,44,63,217,343,2,926,51,0,2,0,7,85350,33904,6783,45970,0
219,4666,1165,710,800,67,119,181,1232,18,243,153,282,261,435,2000,3492,10,36473,2026,1,2,0,7,85360,33904,6784,45971,0
150,7150,1392,870,1177,35,17,170,1427,14,494,280,531,508,811,4473,7289,7,54850,3047,2,2,3,11,85360,33907,6785,45972,0
219,4666,182,127,129,0,0,53,182,5,39,21,42,44,63,217,343,2,926,51,0,2,0,1,85360,33907,6786,45975,0
219,4666,1165,710,800,67,119,181,1232,18,243,153,282,261,435,2000,3492,10,36473,2026,1,2,0,1,85370,33907,6787,45976,0
92,2323,1455,414,1257,16,76,112,1471,5,41,23,46,46,69,231,381,2,1069,59,0,2,13,3,85370,33908,6787,45977,0
92,2323,669,365,481,22,61,110,691,15,103,63,122,118,185,747,1273,8,11311,628,0,2,13,3,85380,33908,6788,45978,0
74,3363,1455,414,1257,16,76,112,1471,5,41,23,46,46,69,231,381,2,1069,59,0,2,24,0,85380,33909,6788,45979,0
14,833,75,38,59,1,3,12,76,2,4,2,4,6,6,10,15,1,15,0,0,2,1,1,85380,33909,6788,45981,0
14,833,75,38,59,1,3,12,76,2,4,2,4,6,6,10,15,1,15,0,0,2,1,1,85380,33909,6788,45983,0
219,4666,182,127,129,0,0,53,182,5,39,21,42,44,63,217,343,2,926,51,0,2,0,1,85380,33909,6789,45984,0
219,4666,1165,710,800,67,119,181,1232,18,243,153,282,261,435,2000,3492,10,36473,2026,1,2,0,1,85390,33909,6790,45985,0
9,449,219,78,157,11,5,46,230,3,24,20,34,27,54,114,256,2,545,30,0,2,1,1,85390,33910,6790,45986,0
29,461,219,78,157,11,5,46,230,3,24,20,34,27,54,114,256,2,545,30,0,2,2,1,85390,33911,6790,45987,0
29,461,108,64,79,9,0,20,117,5,15,11,19,20,30,70,129,3,410,22,0,2,2,1,85390,33911,6790,45988,0
11,488,219,78,157,11,5,46,230,3,24,20,34,27,54,114,256,2,545,30,0,2,15,11,85390,33912,6790,45989,0
26,435,219,78,157,11,5,46,230,3,24,20,34,27,54,114,256,2,545,30,0,2,0,6,85390,33913,6790,45990,0
26,435,108,64,79,9,0,20,117,5,15,11,19,20,30,70,129,3,410,22,0,2,0,6,85390,33913,6790,45991,0
10,475,219,78,157,11,5,46,230,3,24,20,34,27,54,114,256,2,545,30,0,2,1,7,85390,33914,6790,45992,0
235,4840,2,2,2,0,0,0,2,0,0,0,0,0,0,0,0,0,0,0,0,2,0,11,85390,33914,6790,45992,0
235,4840,99,48,90,1,3,5,100,0,0,0,0,0,0,0,0,0,0,0,0,2,0,11,85390,33915,6790,45993,0
235,4840,8,5,5,2,0,1,10,0,0,0,0,0,0,0,0,0,0,0,0,2,0,11,85390,33915,6790,45994,0
235,4840,1217,716,841,84,126,174,1301,14,185,118,215,199,333,1446,2542,8,20687,1149,0,2,0,11,85400,33917,6790,45995,0
235,4840,160,89,115,0,13,31,160,7,15,11,17,22,28,78,124,3,495,27,0,2,0,11,85400,33917,6790,45996,0
235,4840,10,10,9,9,0,0,19,0,0,0,0,0,0,0,0,0,0,0,0,2,0,11,85400,33917,6791,45997,0
235,4840,173,84,99,8,29,36,181,5,12,7,13,17,20,54,81,2,221,12,0,2,0,11,85400,33918,6791,45998,0
235,4840,3,1,1,3,0,0,6,0,0,0,0,0,0,0,0,0,0,0,0,2,0,11,85400,33918,6791,45999,0
10,475,219,78,157,11,5,46,230,3,24,20,34,27,54,114,256,2,545,30,0,2,2,2,85400,33919,6791,46000,0
235,4840,2,2,2,0,0,0,2,0,0,0,0,0,0,0,0,0,0,0,0,2,0,11,85400,33919,6791,46000,0
235,4840,99,48,90,1,3,5,100,0,0,0,0,0,0,0,0,0,0,0,0,2,0,11,85400,33920,6791,46001,0
235,4840,8,5,5,2,0,1,10,0,0,0,0,0,0,0,0,0,0,0,0,2,0,11,85400,33920,6791,46002,0
235,4840,1217,716,841,84,126,174,1301,14,185,118,215,199,333,1446,2542,8,20687,1149,0,2,0,11,85410,33922,6791,46003,0
235,4840,160,89,115,0,13,31,160,7,15,11,17,22,28,78,124,3,495,27,0,2,0,11,85410,33922,6791,46004,0
235,4840,10,10,9,9,0,0,19,0,0,0,0,0,0,0,0,0,0,0,0,2,0,11,85410,33922,6792,46005,0
235,4840,173,84,99,8,29,36,181,5,12,7,13,17,20,54,81,2,221,12,0,2,0,11,85410,33923,6792,46006,0
235,4840,3,1,1,3,0,0,6,0,0,0,0,0,0,0,0,0,0,0,0,2,0,11,85410,33923,6792,46007,0
235,4842,2,2,2,0,0,0,2,0,0,0,0,0,0,0,0,0,0,0,0,2,2,2,85410,33923,6792,46007,0
235,4842,99,48,90,1,3,5,100,0,0,0,0,0,0,0,0,0,0,0,0,2,2,2,85410,33924,6792,46008,0
235,4842,8,5,5,2,0,1,10,0,0,0,0,0,0,0,0,0,0,0,0,2,2,2,85410,33924,6792,46009,0
235,4842,1217,716,841,84,126,174,1301,14,185,118,215,199,333,1446,2542,8,20687,1149,0,2,2,2,85420,33926,6792,46010,0
235,4842,160,89,115,0,13,31,160,7,15,11,17,22,28,78,124,3,495,27,0,2,2,2,85420,33926,6792,46011,0
235,4842,10,10,9,9,0,0,19,0,0,0,0,0,0,0,0,0,0,0,0,2,2,2,85420,33926,6793,46012,0
235,4842,173,84,99,8,29,36,181,5,12,7,13,17,20,54,81,2,221,12,0,2,2,2,85420,33927,6793,46013,0
235,4842,3,1,1,3,0,0,6,0,0,0,0,0,0,0,0,0,0,0,0,2,2,2,85420,33927,6793,46014,0
146,3595,77,34,69,0,0,8,77,3,24,16,29,27,45,114,213,1,387,21,0,2,17,13,85420,33927,6793,46015,0
146,3595,712,438,573,51,9,84,763,14,102,71,128,116,199,733,1364,8,11988,666,0,2,17,13,85430,33928,6793,46016,0
226,5756,722,423,573,19,0,135,741,12,172,101,199,184,300,1320,2257,6,15668,870,0,2,5,6,85430,33930,6793,46018,0
226,5756,1508,847,911,44,250,301,1552,14,148,88,169,162,257,1120,1886,7,15077,837,0,2,5,6,85430,33931,6794,46019,0
280,5857,1943,715,1694,26,18,214,1969,12,185,120,237,197,357,1436,2721,7,20915,1161,0,2,7,11,85430,33933,6794,46020,0
280,5857,1168,838,957,57,25,144,1225,19,348,224,416,367,640,3018,5452,11,61921,3440,1,2,7,11,85440,33935,6794,46021,0
104,4414,1289,550,1043,56,32,155,1345,10,167,93,185,177,278,1266,2075,5,11498,638,0,2,14,15,85440,33937,6795,46022,0
90,3963,1338,495,1086,10,64,173,1348,11,122,82,157,133,239,883,1686,7,11934,663,0,2,3,3,85440,33939,6795,46023,0
168,4914,1660,832,1314,41,38,274,1701,20,312,209,395,332,604,2671,5058,12,64042,3557,1,2,3,3,85440,33941,6796,46025,0
49,3782,996,429,845,24,10,117,1020,7,76,50,88,83,138,494,879,4,3565,198,0,2,2,2,85440,33943,6796,46026,0
120,5085,1513,682,1277,25,13,200,1538,11,199,116,219,210,335,1557,2584,6,15641,868,0,2,2,2,85440,33945,6796,46027,0
84,4875,1296,573,1062,40,33,157,1336,8,201,118,231,209,349,1561,2689,4,12365,686,0,2,6,7,85440,33945,6796,46028,0
101,5249,1457,730,1242,11,6,188,1468,10,292,166,329,302,495,2424,4078,5,22973,1276,1,2,11,14,85440,33947,6796,46029,0
43,2669,652,304,544,16,6,88,668,6,89,51,101,95,152,591,998,3,3399,188,0,2,7,9,85440,33948,6796,46030,0
8,269,74,35,59,1,0,14,75,3,14,7,14,17,21,58,85,1,128,7,0,2,4,4,85440,33949,6796,46031,0
70,3179,1020,354,843,12,15,144,1032,8,134,77,144,142,221,970,1580,4,6792,377,0,2,2,2,85440,33949,6796,46032,0
29,1875,384,251,317,7,8,52,391,11,70,44,84,81,128,467,811,6,5355,297,0,2,2,2,85440,33949,6796,46033,0
55,2829,722,423,573,19,0,135,741,12,172,101,199,184,300,1320,2257,6,15668,870,0,2,6,8,85440,33951,6796,46035,0
85,3346,1043,504,840,53,9,147,1096,9,180,112,198,189,310,1377,2344,4,11604,644,0,2,3,3,85440,33953,6796,46036,0
30,1424,373,158,315,8,0,51,381,5,76,44,79,81,123,486,779,2,2026,112,0,2,2,2,85440,33953,6796,46037,0
111,6050,1943,715,1694,26,18,214,1969,12,185,120,237,197,357,1436,2721,7,20915,1161,0,2,2,2,85440,33955,6796,46038,0
49,1968,1098,241,925,5,10,155,1103,7,46,25,49,53,74,273,423,3,1580,87,0,2,3,3,85450,33957,6796,46039,0
58,1091,207,111,150,11,0,50,218,5,26,19,36,31,55,133,272,3,943,52,0,2,15,14,85450,33957,6796,46040,0
58,1091,410,198,237,31,55,97,441,11,63,38,72,74,110,414,683,6,4293,238,0,2,15,14,85460,33958,6797,46041,0
251,5809,4293,999,3693,19,54,507,4312,9,155,88,170,164,258,1156,1898,4,9368,520,0,2,1,7,85460,33960,6797,46042,0
251,5809,1482,859,1002,125,135,219,1607,16,219,134,251,235,385,1766,3032,9,27804,1544,1,2,1,7,85470,33961,6797,46043,0
105,2754,773,422,505,30,103,129,803,14,77,46,83,91,129,535,839,7,6334,351,0,2,3,3,85480,33962,6798,46044,0
314,6868,72,33,56,0,4,12,72,1,1,1,1,2,2,0,2,0,1,0,0,2,2,4,85480,33962,6798,46045,0
314,6868,1454,835,1044,76,110,219,1530,17,275,158,296,292,454,2297,3718,9,34017,1889,1,2,2,4,85490,33963,6798,46046,0
89,1799,757,253,292,73,244,162,830,13,61,38,67,74,105,409,651,7,4654,258,0,2,4,2,85490,33964,6798,46047,0
314,6853,72,33,56,0,4,12,72,1,1,1,1,2,2,0,2,0,1,0,0,2,0,2,85490,33964,6798,46048,0
314,6853,1454,835,1044,76,110,219,1530,17,275,158,296,292,454,2297,3718,9,34017,1889,1,2,0,2,85500,33965,6798,46049,0
88,1782,757,253,292,73,244,162,830,13,61,38,67,74,105,409,651,7,4654,258,0,2,0,14,85500,33966,6798,46050,0
144,5870,1782,648,1425,9,47,279,1791,8,171,97,189,179,286,1292,2140,4,9462,525,0,2,1,1,85500,33967,6799,46051,0
111,2037,477,336,357,30,23,73,507,16,194,134,250,210,384,1538,2962,10,30538,1696,0,2,3,11,85510,33968,6799,46052,0
2,183,37,13,25,0,6,6,37,1,2,1,2,3,3,2,4,0,2,0,0,2,20,0,85510,33968,6799,46053,0
2,183,133,47,40,1,43,49,134,0,0,0,0,0,0,0,0,0,0,0,0,2,20,0,85510,33968,6799,46054,0
2,103,37,13,25,0,6,6,37,1,2,1,2,3,3,2,4,0,2,0,0,0,37,0,85510,33968,6799,46055,0
146,3596,77,34,69,0,0,8,77,3,24,16,29,27,45,114,213,1,387,21,0,2,10,2,85510,33968,6799,46056,0
146,3596,712,438,573,51,9,84,763,14,102,71,128,116,199,733,1364,8,11988,666,0,2,10,2,85520,33969,6799,46057,0
146,3596,77,34,69,0,0,8,77,3,24,16,29,27,45,114,213,1,387,21,0,2,1,0,85520,33969,6799,46058,0
146,3596,712,438,573,51,9,84,763,14,102,71,128,116,199,733,1364,8,11988,666,0,2,1,0,85530,33970,6799,46059,0
92,2323,1455,414,1257,16,76,112,1471,5,41,23,46,46,69,231,381,2,1069,59,0,2,13,3,85530,33971,6799,46060,0
92,2323,669,365,481,22,61,110,691,15,103,63,122,118,185,747,1273,8,11311,628,0,2,13,3,85540,33971,6800,46061,0
74,3363,1455,414,1257,16,76,112,1471,5,41,23,46,46,69,231,381,2,1069,59,0,2,24,0,85540,33972,6800,46062,0
146,3596,77,34,69,0,0,8,77,3,24,16,29,27,45,114,213,1,387,21,0,2,3,2,85540,33972,6800,46063,0
146,3596,712,438,573,51,9,84,763,14,102,71,128,116,199,733,1364,8,11988,666,0,2,3,2,85550,33973,6800,46064,0
235,4842,2,2,2,0,0,0,2,0,0,0,0,0,0,0,0,0,0,0,0,2,2,2,85550,33973,6800,46064,0
235,4842,99,48,90,1,3,5,100,0,0,0,0,0,0,0,0,0,0,0,0,2,2,2,85550,33974,6800,46065,0
235,4842,8,5,5,2,0,1,10,0,0,0,0,0,0,0,0,0,0,0,0,2,2,2,85550,33974,6800,46066,0
235,4842,1217,716,841,84,126,174,1301,14,185,118,215,199,333,1446,2542,8,20687,1149,0,2,2,2,85560,33976,6800,46067,0
235,4842,160,89,115,0,13,31,160,7,15,11,17,22,28,78,124,3,495,27,0,2,2,2,85560,33976,6800,46068,0
235,4842,10,10,9,9,0,0,19,0,0,0,0,0,0,0,0,0,0,0,0,2,2,2,85560,33976,6801,46069,0
235,4842,173,84,99,8,29,36,181,5,12,7,13,17,20,54,81,2,221,12,0,2,2,2,85560,33977,6801,46070,0
235,4842,3,1,1,3,0,0,6,0,0,0,0,0,0,0,0,0,0,0,0,2,2,2,85560,33977,6801,46071,0
146,3596,77,34,69,0,0,8,77,3,24,16,29,27,45,114,213,1,387,21,0,2,28,14,85560,33977,6801,46072,0
146,3596,712,438,573,51,9,84,763,14,102,71,128,116,199,733,1364,8,11988,666,0,2,28,14,85570,33978,6801,46073,0
226,5756,722,423,573,19,0,135,741,12,172,101,199,184,300,1320,2257,6,15668,870,0,2,5,6,85570,33980,6801,46075,0
226,5756,1508,847,911,44,250,301,1552,14,148,88,169,162,257,1120,1886,7,15077,837,0,2,5,6,85570,33981,6802,46076,0
280,5857,1943,715,1694,26,18,214,1969,12,185,120,237,197,357,1436,2721,7,20915,1161,0,2,7,11,85570,33983,6802,46077,0
280,5857,1168,838,957,57,25,144,1225,19,348,224,416,367,640,3018,5452,11,61921,3440,1,2,7,11,85580,33985,6802,46078,0
104,4414,1289,550,1043,56,32,155,1345,10,167,93,185,177,278,1266,2075,5,11498,638,0,2,14,15,85580,33987,6803,46079,0
90,3963,1338,495,1086,10,64,173,1348,11,122,82,157,133,239,883,1686,7,11934,663,0,2,3,3,85580,33989,6803,46080,0
168,4914,1660,832,1314,41,38,274,1701,20,312,209,395,332,604,2671,5058,12,64042,3557,1,2,3,3,85580,33991,6804,46082,0
49,3782,996,429,845,24,10,117,1020,7,76,50,88,83,138,494,879,4,3565,198,0,2,2,2,85580,33993,6804,46083,0
120,5085,1513,682,1277,25,13,200,1538,11,199,116,219,210,335,1557,2584,6,15641,868,0,2,2,2,85580,33995,6804,46084,0
84,4875,1296,573,1062,40,33,157,1336,8,201,118,231,209,349,1561,2689,4,12365,686,0,2,6,7,85580,33995,6804,46085,0
101,5249,1457,730,1242,11,6,188,1468,10,292,166,329,302,495,2424,4078,5,22973,1276,1,2,11,14,85580,33997,6804,46086,0
43,2669,652,304,544,16,6,88,668,6,89,51,101,95,152,591,998,3,3399,188,0,2,7,9,85580,33998,6804,46087,0
8,269,74,35,59,1,0,14,75,3,14,7,14,17,21,58,85,1,128,7,0,2,4,4,85580,33999,6804,46088,0
70,3179,1020,354,843,12,15,144,1032,8,134,77,144,142,221,970,1580,4,6792,377,0,2,2,2,85580,33999,6804,46089,0
29,1875,384,251,317,7,8,52,391,11,70,44,84,81,128,467,811,6,5355,297,0,2,2,2,85580,33999,6804,46090,0
55,2829,722,423,573,19,0,135,741,12,172,101,199,184,300,1320,2257,6,15668,870,0,2,6,8,85580,34001,6804,46092,0
85,3346,1043,504,840,53,9,147,1096,9,180,112,198,189,310,1377,2344,4,11604,644,0,2,3,3,85580,34003,6804,46093,0
30,1424,373,158,315,8,0,51,381,5,76,44,79,81,123,486,779,2,2026,112,0,2,2,2,85580,34003,6804,46094,0
111,6050,1943,715,1694,26,18,214,1969,12,185,120,237,197,357,1436,2721,7,20915,1161,0,2,2,2,85580,34005,6804,46095,0
49,1968,1098,241,925,5,10,155,1103,7,46,25,49,53,74,273,423,3,1580,87,0,2,3,3,85590,34007,6804,46096,0
2,183,37,13,25,0,6,6,37,1,2,1,2,3,3,2,4,0,2,0,0,2,20,0,85590,34007,6804,46097,0
2,183,133,47,40,1,43,49,134,0,0,0,0,0,0,0,0,0,0,0,0,2,20,0,85590,34007,6804,46098,0
2,103,37,13,25,0,6,6,37,1,2,1,2,3,3,2,4,0,2,0,0,0,37,0,85590,34007,6804,46099,0
111,2037,477,336,357,30,23,73,507,16,194,134,250,210,384,1538,2962,10,30538,1696,0,2,3,11,85600,34008,6804,46100,0
58,1091,207,111,150,11,0,50,218,5,26,19,36,31,55,133,272,3,943,52,0,2,15,14,85600,34008,6804,46101,0
58,1091,410,198,237,31,55,97,441,11,63,38,72,74,110,414,683,6,4293,238,0,2,15,14,85610,34009,6805,46102,0
251,5809,4293,999,3693,19,54,507,4312,9,155,88,170,164,258,1156,1898,4,9368,520,0,2,1,7,85610,34011,6805,46103,0
251,5809,1482,859,1002,125,135,219,1607,16,219,134,251,235,385,1766,3032,9,27804,1544,1,2,1,7,85620,34012,6805,46104,0
105,2754,773,422,505,30,103,129,803,14,77,46,83,91,129,535,839,7,6334,351,0,2,3,3,85630,34013,6806,46105,0
314,6853,72,33,56,0,4,12,72,1,1,1,1,2,2,0,2,0,1,0,0,2,2,6,85630,34013,6806,46106,0
314,6853,1454,835,1044,76,110,219,1530,17,275,158,296,292,454,2297,3718,9,34017,1889,1,2,2,6,85640,34014,6806,46107,0
88,1782,757,253,292,73,244,162,830,13,61,38,67,74,105,409,651,7,4654,258,0,2,4,16,85640,34015,6806,46108,0
144,5870,1782,648,1425,9,47,279,1791,8,171,97,189,179,286,1292,2140,4,9462,525,0,2,1,1,85640,34016,6807,46109,0
26,435,219,78,157,11,5,46,230,3,24,20,34,27,54,114,256,2,545,30,0,2,2,7,85640,34017,6807,46110,0
26,435,108,64,79,9,0,20,117,5,15,11,19,20,30,70,129,3,410,22,0,2,2,7,85640,34017,6807,46111,0
10,475,219,78,157,11,5,46,230,3,24,20,34,27,54,114,256,2,545,30,0,2,9,11,85640,34018,6807,46112,0
146,3596,77,34,69,0,0,8,77,3,24,16,29,27,45,114,213,1,387,21,0,2,2,2,85640,34018,6807,46113,0
146,3596,712,438,573,51,9,84,763,14,102,71,128,116,199,733,1364,8,11988,666,0,2,2,2,85650,34019,6807,46114,0
226,5756,722,423,573,19,0,135,741,12,172,101,199,184,300,1320,2257,6,15668,870,0,2,1,1,85650,34021,6807,46116,0
226,5756,1508,847,911,44,250,301,1552,14,148,88,169,162,257,1120,1886,7,15077,837,0,2,1,1,85650,34022,6808,46117,0
146,3596,77,34,69,0,0,8,77,3,24,16,29,27,45,114,213,1,387,21,0,2,2,2,85650,34022,6808,46118,0
146,3596,712,438,573,51,9,84,763,14,102,71,128,116,199,733,1364,8,11988,666,0,2,2,2,85660,34023,6808,46119,0
226,5756,722,423,573,19,0,135,741,12,172,101,199,184,300,1320,2257,6,15668,870,0,2,1,1,85660,34025,6808,46121,0
226,5756,1508,847,911,44,250,301,1552,14,148,88,169,162,257,1120,1886,7,15077,837,0,2,1,1,85660,34026,6809,46122,0
236,4874,2,2,2,0,0,0,2,0,0,0,0,0,0,0,0,0,0,0,0,2,2,1,85660,34026,6809,46122,1
236,4874,99,48,90,1,3,5,100,0,0,0,0,0,0,0,0,0,0,0,0,2,2,1,85660,34027,6809,46123,1
236,4874,8,5,5,2,0,1,10,0,0,0,0,0,0,0,0,0,0,0,0,2,2,1,85660,34027,6809,46124,1
236,4874,1217,716,841,84,126,174,1301,14,185,118,215,199,333,1446,2542,8,20687,1149,0,2,2,1,85670,34029,6809,46125,1
236,4874,160,89,115,0,13,31,160,7,15,11,17,22,28,78,124,3,495,27,0,2,2,1,85670,34029,6809,46126,1
236,4874,10,10,9,9,0,0,19,0,0,0,0,0,0,0,0,0,0,0,0,2,2,1,85670,34029,6810,46127,1
236,4874,173,84,99,8,29,36,181,5,12,7,13,17,20,54,81,2,221,12,0,2,2,1,85670,34030,6810,46128,1
236,4874,3,1,1,3,0,0,6,0,0,0,0,0,0,0,0,0,0,0,0,2,2,1,85670,34030,6810,46129,1
15,340,103,47,73,2,12,15,105,5,16,9,17,21,26,75,114,2,303,16,0,0,102,0,85670,34031,6810,46131,1
15,340,86,50,52,8,5,21,94,3,5,3,6,8,9,16,27,1,48,2,0,0,102,0,85670,34032,6810,46132,1
14,833,75,38,59,1,3,12,76,2,4,2,4,6,6,10,15,1,15,0,0,2,8,15,85670,34032,6810,46133,1
8,304,103,47,73,2,12,15,105,5,16,9,17,21,26,75,114,2,303,16,0,0,99,0,85670,34033,6810,46134,1
13,278,103,47,73,2,12,15,105,5,16,9,17,21,26,75,114,2,303,16,0,2,24,40,85670,34034,6810,46135,0
13,278,86,50,52,8,5,21,94,3,5,3,6,8,9,16,27,1,48,2,0,2,24,40,85670,34035,6810,46136,0
8,310,103,47,73,2,12,15,105,5,16,9,17,21,26,75,114,2,303,16,0,2,8,4,85670,34036,6810,46137,0
280,5856,1943,715,1694,26,18,214,1969,12,185,120,237,197,357,1436,2721,7,20915,1161,0,2,1,2,85670,34038,6810,46138,0
280,5856,1168,838,957,57,25,144,1225,19,348,224,416,367,640,3018,5452,11,61921,3440,1,2,1,2,85680,34040,6810,46139,0
1,94,42,7,35,4,0,5,46,1,2,1,2,3,3,2,4,0,2,0,0,2,1,0,85680,34040,6810,46140,1
1,94,11,6,10,0,0,1,11,2,4,2,4,6,6,10,15,1,15,0,0,2,1,0,85680,34040,6810,46141,1
27,542,2,2,2,0,0,0,2,0,0,0,0,0,0,0,0,0,0,0,0,2,7,1,85680,34040,6810,46141,1
27,542,99,48,90,1,3,5,100,0,0,0,0,0,0,0,0,0,0,0,0,2,7,1,85680,34041,6810,46142,1
27,542,8,5,5,2,0,1,10,0,0,0,0,0,0,0,0,0,0,0,0,2,7,1,85680,34041,6810,46143,1
27,542,1217,716,841,84,126,174,1301,14,185,118,215,199,333,1446,2542,8,20687,1149,0,2,7,1,85690,34043,6810,46144,1
27,542,160,89,115,0,13,31,160,7,15,11,17,22,28,78,124,3,495,27,0,2,7,1,85690,34043,6810,46145,1
27,542,10,10,9,9,0,0,19,0,0,0,0,0,0,0,0,0,0,0,0,2,7,1,85690,34043,6811,46146,1
27,542,173,84,99,8,29,36,181,5,12,7,13,17,20,54,81,2,221,12,0,2,7,1,85690,34044,6811,46147,1
27,542,3,1,1,3,0,0,6,0,0,0,0,0,0,0,0,0,0,0,0,2,7,1,85690,34044,6811,46148,1
170,5244,1660,832,1314,41,38,274,1701,20,312,209,395,332,604,2671,5058,12,64042,3557,1,2,66,23,85690,34046,6812,46150,1
170,5244,1057,646,719,113,100,145,1170,18,215,134,248,233,382,1740,3004,10,31186,1732,1,2,66,23,85700,34047,6813,46151,1
111,2040,477,336,357,30,23,73,507,16,194,134,250,210,384,1538,2962,10,30538,1696,0,2,4,0,85710,34048,6813,46152,1
55,670,647,139,84,35,284,233,682,0,0,0,0,0,0,0,0,0,0,0,0,2,15,0,85710,34048,6813,46153,1
103,4384,1289,550,1043,56,32,155,1345,10,167,93,185,177,278,1266,2075,5,11498,638,0,2,0,45,85710,34050,6814,46154,1
32,968,256,139,192,9,7,47,265,4,23,12,24,27,36,112,171,2,357,19,0,2,3,0,85710,34051,6814,46155,1
171,5019,1660,832,1314,41,38,274,1701,20,312,209,395,332,604,2671,5058,12,64042,3557,1,2,51,0,85710,34053,6815,46157,1
170,5218,1660,832,1314,41,38,274,1701,20,312,209,395,332,604,2671,5058,12,64042,3557,1,2,0,5,85710,34055,6816,46159,0
170,5218,1057,646,719,113,100,145,1170,18,215,134,248,233,382,1740,3004,10,31186,1732,1,2,0,5,85720,34056,6817,46160,0
148,4602,1660,832,1314,41,38,274,1701,20,312,209,395,332,604,2671,5058,12,64042,3557,1,2,78,159,85720,34058,6818,46162,1
148,4602,1057,646,719,113,100,145,1170,18,215,134,248,233,382,1740,3004,10,31186,1732,1,2,78,159,85730,34059,6819,46163,1
146,3588,77,34,69,0,0,8,77,3,24,16,29,27,45,114,213,1,387,21,0,2,8,14,85730,34059,6819,46164,1
146,3588,712,438,573,51,9,84,763,14,102,71,128,116,199,733,1364,8,11988,666,0,2,8,14,85740,34060,6819,46165,1
59,1205,91,45,69,0,3,18,91,3,9,6,10,12,16,33,57,1,95,5,0,2,2,0,85740,34062,6819,46166,1
59,1205,367,234,237,17,34,68,384,16,55,34,61,71,95,381,584,8,5183,287,0,2,2,0,85740,34063,6819,46167,1
225,5725,722,423,573,19,0,135,741,12,172,101,199,184,300,1320,2257,6,15668,870,0,2,6,13,85740,34065,6819,46169,1
225,5725,1508,847,911,44,250,301,1552,14,148,88,169,162,257,1120,1886,7,15077,837,0,2,6,13,85740,34066,6820,46170,1
105,4490,1289,550,1043,56,32,155,1345,10,167,93,185,177,278,1266,2075,5,11498,638,0,2,13,0,85740,34068,6821,46171,1
119,4854,1450,624,1228,12,26,181,1462,14,306,186,354,320,540,2580,4493,8,36391,2021,1,2,2,2,85740,34070,6822,46172,1
168,5033,1660,832,1314,41,38,274,1701,20,312,209,395,332,604,2671,5058,12,64042,3557,1,2,62,53,85740,34072,6823,46174,1
9,413,91,45,69,0,3,18,91,3,9,6,10,12,16,33,57,1,95,5,0,2,5,0,85740,34074,6823,46175,1
148,4602,1660,832,1314,41,38,274,1701,20,312,209,395,332,604,2671,5058,12,64042,3557,1,2,78,159,85740,34076,6824,46177,0
148,4602,1057,646,719,113,100,145,1170,18,215,134,248,233,382,1740,3004,10,31186,1732,1,2,78,159,85750,34077,6825,46178,0
146,3588,77,34,69,0,0,8,77,3,24,16,29,27,45,114,213,1,387,21,0,2,8,14,85750,34077,6825,46179,0
146,3588,712,438,573,51,9,84,763,14,102,71,128,116,199,733,1364,8,11988,666,0,2,8,14,85760,34078,6825,46180,0
59,1205,91,45,69,0,3,18,91,3,9,6,10,12,16,33,57,1,95,5,0,2,2,0,85760,34080,6825,46181,0
59,1205,367,234,237,17,34,68,384,16,55,34,61,71,95,381,584,8,5183,287,0,2,2,0,85760,34081,6825,46182,0
225,5725,722,423,573,19,0,135,741,12,172,101,199,184,300,1320,2257,6,15668,870,0,2,6,13,85760,34083,6825,46184,0
225,5725,1508,847,911,44,250,301,1552,14,148,88,169,162,257,1120,1886,7,15077,837,0,2,6,13,85760,34084,6826,46185,0
105,4490,1289,550,1043,56,32,155,1345,10,167,93,185,177,278,1266,2075,5,11498,638,0,2,13,0,85760,34086,6827,46186,0
119,4854,1450,624,1228,12,26,181,1462,14,306,186,354,320,540,2580,4493,8,36391,2021,1,2,2,2,85760,34088,6828,46187,0
168,5033,1660,832,1314,41,38,274,1701,20,312,209,395,332,604,2671,5058,12,64042,3557,1,2,62,53,85760,34090,6829,46189,0
9,413,91,45,69,0,3,18,91,3,9,6,10,12,16,33,57,1,95,5,0,2,5,0,85760,34092,6829,46190,0
17,467,205,80,86,16,53,53,221,7,18,10,19,25,29,94,134,3,497,27,0,2,3,7,85770,34092,6830,46191,0
17,467,205,80,86,16,53,53,221,7,18,10,19,25,29,94,134,3,497,27,0,2,3,7,85780,34092,6831,46192,0
280,5856,1943,715,1694,26,18,214,1969,12,185,120,237,197,357,1436,2721,7,20915,1161,0,2,1,2,85780,34094,6831,46193,0
280,5856,1168,838,957,57,25,144,1225,19,348,224,416,367,640,3018,5452,11,61921,3440,1,2,1,2,85790,34096,6831,46194,0
235,4844,2,2,2,0,0,0,2,0,0,0,0,0,0,0,0,0,0,0,0,2,2,1,85790,34096,6831,46194,0
235,4844,99,48,90,1,3,5,100,0,0,0,0,0,0,0,0,0,0,0,0,2,2,1,85790,34097,6831,46195,0
235,4844,8,5,5,2,0,1,10,0,0,0,0,0,0,0,0,0,0,0,0,2,2,1,85790,34097,6831,46196,0
235,4844,1217,716,841,84,126,174,1301,14,185,118,215,199,333,1446,2542,8,20687,1149,0,2,2,1,85800,34099,6831,46197,0
235,4844,160,89,115,0,13,31,160,7,15,11,17,22,28,78,124,3,495,27,0,2,2,1,85800,34099,6831,46198,0
235,4844,10,10,9,9,0,0,19,0,0,0,0,0,0,0,0,0,0,0,0,2,2,1,85800,34099,6832,46199,0
235,4844,173,84,99,8,29,36,181,5,12,7,13,17,20,54,81,2,221,12,0,2,2,1,85800,34100,6832,46200,0
235,4844,3,1,1,3,0,0,6,0,0,0,0,0,0,0,0,0,0,0,0,2,2,1,85800,34100,6832,46201,0
13,278,103,47,73,2,12,15,105,5,16,9,17,21,26,75,114,2,303,16,0,0,86,0,85800,34101,6832,46203,0
13,278,86,50,52,8,5,21,94,3,5,3,6,8,9,16,27,1,48,2,0,0,86,0,85800,34102,6832,46204,0
14,833,75,38,59,1,3,12,76,2,4,2,4,6,6,10,15,1,15,0,0,2,8,15,85800,34102,6832,46205,0
8,310,103,47,73,2,12,15,105,5,16,9,17,21,26,75,114,2,303,16,0,0,103,0,85800,34103,6832,46206,0
148,4610,1660,832,1314,41,38,274,1701,20,312,209,395,332,604,2671,5058,12,64042,3557,1,2,2,1,85800,34105,6833,46208,0
148,4610,1057,646,719,113,100,145,1170,18,215,134,248,233,382,1740,3004,10,31186,1732,1,2,2,1,85810,34106,6834,46209,0
169,5104,1660,832,1314,41,38,274,1701,20,312,209,395,332,604,2671,5058,12,64042,3557,1,2,18,0,85810,34108,6835,46211,0
71,1562,402,202,227,24,74,80,426,12,52,33,61,64,94,339,564,7,3969,220,0,2,1,4,85810,34109,6835,46212,0
145,5899,1782,648,1425,9,47,279,1791,8,171,97,189,179,286,1292,2140,4,9462,525,0,2,13,0,85810,34110,6836,46213,0
71,1562,402,202,227,24,74,80,426,12,52,33,61,64,94,339,564,7,3969,220,0,2,1,4,85810,34111,6836,46214,0
145,5899,1782,648,1425,9,47,279,1791,8,171,97,189,179,286,1292,2140,4,9462,525,0,2,13,0,85810,34112,6837,46215,0
17,382,85,59,61,8,0,16,93,5,18,10,18,23,28,86,126,2,316,17,0,2,1,1,85810,34112,6837,46216,1
12,518,124,78,88,2,3,26,126,4,13,7,13,17,20,56,81,2,163,9,0,2,1,1,85810,34112,6837,46217,1
113,2243,463,295,324,28,62,57,491,12,134,82,154,146,236,989,1696,6,11700,650,0,2,39,0,85820,34113,6837,46218,1
104,4398,1289,550,1043,56,32,155,1345,10,167,93,185,177,278,1266,2075,5,11498,638,0,2,1,1,85820,34115,6838,46219,1
4,166,27,21,21,0,0,6,27,3,6,3,6,9,9,20,28,1,42,2,0,2,1,1,85820,34115,6838,46220,1
120,5083,1513,682,1277,25,13,200,1538,11,199,116,219,210,335,1557,2584,6,15641,868,0,2,1,1,85820,34117,6838,46221,1
38,2301,334,251,279,10,4,40,344,5,127,74,143,132,217,899,1528,2,4303,239,0,2,3,5,85820,34118,6838,46222,1
9,423,184,100,137,2,15,30,186,6,38,20,39,44,59,214,322,3,991,55,0,2,1,1,85820,34119,6838,46223,1
55,670,647,139,84,35,284,233,682,0,0,0,0,0,0,0,0,0,0,0,0,2,7,0,85820,34119,6838,46224,0
169,5193,1660,832,1314,41,38,274,1701,20,312,209,395,332,604,2671,5058,12,64042,3557,1,2,2,7,85820,34121,6839,46226,0
169,5193,1057,646,719,113,100,145,1170,18,215,134,248,233,382,1740,3004,10,31186,1732,1,2,2,7,85830,34122,6840,46227,0
27,542,2,2,2,0,0,0,2,0,0,0,0,0,0,0,0,0,0,0,0,2,5,1,85830,34122,6840,46227,0
27,542,99,48,90,1,3,5,100,0,0,0,0,0,0,0,0,0,0,0,0,2,5,1,85830,34123,6840,46228,0
27,542,8,5,5,2,0,1,10,0,0,0,0,0,0,0,0,0,0,0,0,2,5,1,85830,34123,6840,46229,0
27,542,1217,716,841,84,126,174,1301,14,185,118,215,199,333,1446,2542,8,20687,1149,0,2,5,1,85840,34125,6840,46230,0
27,542,160,89,115,0,13,31,160,7,15,11,17,22,28,78,124,3,495,27,0,2,5,1,85840,34125,6840,46231,0
27,542,10,10,9,9,0,0,19,0,0,0,0,0,0,0,0,0,0,0,0,2,5,1,85840,34125,6841,46232,0
27,542,173,84,99,8,29,36,181,5,12,7,13,17,20,54,81,2,221,12,0,2,5,1,85840,34126,6841,46233,0
27,542,3,1,1,3,0,0,6,0,0,0,0,0,0,0,0,0,0,0,0,2,5,1,85840,34126,6841,46234,0
171,5019,1660,832,1314,41,38,274,1701,20,312,209,395,332,604,2671,5058,12,64042,3557,1,2,3,3,85840,34128,6842,46236,0
17,382,85,59,61,8,0,16,93,5,18,10,18,23,28,86,126,2,316,17,0,2,1,1,85840,34128,6842,46237,0
12,518,124,78,88,2,3,26,126,4,13,7,13,17,20,56,81,2,163,9,0,2,1,1,85840,34128,6842,46238,0
113,2243,463,295,324,28,62,57,491,12,134,82,154,146,236,989,1696,6,11700,650,0,2,39,0,85850,34129,6842,46239,0
104,4398,1289,550,1043,56,32,155,1345,10,167,93,185,177,278,1266,2075,5,11498,638,0,2,1,1,85850,34131,6843,46240,0
4,166,27,21,21,0,0,6,27,3,6,3,6,9,9,20,28,1,42,2,0,2,1,1,85850,34131,6843,46241,0
120,5083,1513,682,1277,25,13,200,1538,11,199,116,219,210,335,1557,2584,6,15641,868,0,2,1,1,85850,34133,6843,46242,0
38,2301,334,251,279,10,4,40,344,5,127,74,143,132,217,899,1528,2,4303,239,0,2,3,5,85850,34134,6843,46243,0
9,423,184,100,137,2,15,30,186,6,38,20,39,44,59,214,322,3,991,55,0,2,1,1,85850,34135,6843,46244,0
149,4616,1660,832,1314,41,38,274,1701,20,312,209,395,332,604,2671,5058,12,64042,3557,1,2,2,0,85850,34137,6844,46246,0
149,4616,1057,646,719,113,100,145,1170,18,215,134,248,233,382,1740,3004,10,31186,1732,1,2,2,0,85860,34138,6845,46247,0
148,4610,1660,832,1314,41,38,274,1701,20,312,209,395,332,604,2671,5058,12,64042,3557,1,2,2,1,85860,34140,6846,46249,0
148,4610,1057,646,719,113,100,145,1170,18,215,134,248,233,382,1740,3004,10,31186,1732,1,2,2,1,85870,34141,6847,46250,0
169,5104,1660,832,1314,41,38,274,1701,20,312,209,395,332,604,2671,5058,12,64042,3557,1,2,18,0,85870,34143,6848,46252,0
17,382,85,59,61,8,0,16,93,5,18,10,18,23,28,86,126,2,316,17,0,2,1,1,85870,34143,6848,46253,0
12,518,124,78,88,2,3,26,126,4,13,7,13,17,20,56,81,2,163,9,0,2,1,1,85870,34143,6848,46254,0
113,2243,463,295,324,28,62,57,491,12,134,82,154,146,236,989,1696,6,11700,650,0,2,39,0,85880,34144,6848,46255,0
105,4490,1289,550,1043,56,32,155,1345,10,167,93,185,177,278,1266,2075,5,11498,638,0,2,1,1,85880,34146,6849,46256,0
4,166,27,21,21,0,0,6,27,3,6,3,6,9,9,20,28,1,42,2,0,2,1,1,85880,34146,6849,46257,0
120,5085,1513,682,1277,25,13,200,1538,11,199,116,219,210,335,1557,2584,6,15641,868,0,2,1,1,85880,34148,6849,46258,0
38,2301,334,251,279,10,4,40,344,5,127,74,143,132,217,899,1528,2,4303,239,0,2,3,5,85880,34149,6849,46259,0
9,423,184,100,137,2,15,30,186,6,38,20,39,44,59,214,322,3,991,55,0,2,1,1,85880,34150,6849,46260,0
104,4414,1289,550,1043,56,32,155,1345,10,167,93,185,177,278,1266,2075,5,11498,638,0,2,45,0,85880,34152,6850,46261,0
104,4414,1289,550,1043,56,32,155,1345,10,167,93,185,177,278,1266,2075,5,11498,638,0,2,4,1,85880,34154,6851,46262,0
27,566,2,2,2,0,0,0,2,0,0,0,0,0,0,0,0,0,0,0,0,2,8,0,85880,34154,6851,46262,1
27,566,99,48,90,1,3,5,100,0,0,0,0,0,0,0,0,0,0,0,0,2,8,0,85880,34155,6851,46263,1
27,566,8,5,5,2,0,1,10,0,0,0,0,0,0,0,0,0,0,0,0,2,8,0,85880,34155,6851,46264,1
27,566,1217,716,841,84,126,174,1301,14,185,118,215,199,333,1446,2542,8,20687,1149,0,2,8,0,85890,34157,6851,46265,1
27,566,160,89,115,0,13,31,160,7,15,11,17,22,28,78,124,3,495,27,0,2,8,0,85890,34157,6851,46266,1
27,566,10,10,9,9,0,0,19,0,0,0,0,0,0,0,0,0,0,0,0,2,8,0,85890,34157,6852,46267,1
27,566,173,84,99,8,29,36,181,5,12,7,13,17,20,54,81,2,221,12,0,2,8,0,85890,34158,6852,46268,1
27,566,3,1,1,3,0,0,6,0,0,0,0,0,0,0,0,0,0,0,0,2,8,0,85890,34158,6852,46269,1
173,5396,1660,832,1314,41,38,274,1701,20,312,209,395,332,604,2671,5058,12,64042,3557,1,2,66,35,85890,34160,6853,46271,1
173,5396,1057,646,719,113,100,145,1170,18,215,134,248,233,382,1740,3004,10,31186,1732,1,2,66,35,85900,34161,6854,46272,1
235,4848,2,2,2,0,0,0,2,0,0,0,0,0,0,0,0,0,0,0,0,2,4,2,85900,34161,6854,46272,1
235,4848,99,48,90,1,3,5,100,0,0,0,0,0,0,0,0,0,0,0,0,2,4,2,85900,34162,6854,46273,1
235,4848,8,5,5,2,0,1,10,0,0,0,0,0,0,0,0,0,0,0,0,2,4,2,85900,34162,6854,46274,1
235,4848,1217,716,841,84,126,174,1301,14,185,118,215,199,333,1446,2542,8,20687,1149,0,2,4,2,85910,34164,6854,46275,1
235,4848,160,89,115,0,13,31,160,7,15,11,17,22,28,78,124,3,495,27,0,2,4,2,85910,34164,6854,46276,1
235,4848,10,10,9,9,0,0,19,0,0,0,0,0,0,0,0,0,0,0,0,2,4,2,85910,34164,6855,46277,1
235,4848,173,84,99,8,29,36,181,5,12,7,13,17,20,54,81,2,221,12,0,2,4,2,85910,34165,6855,46278,1
235,4848,3,1,1,3,0,0,6,0,0,0,0,0,0,0,0,0,0,0,0,2,4,2,85910,34165,6855,46279,1
55,670,647,139,84,35,284,233,682,0,0,0,0,0,0,0,0,0,0,0,0,2,2,0,85910,34165,6855,46280,1
173,5082,1660,832,1314,41,38,274,1701,20,312,209,395,332,604,2671,5058,12,64042,3557,1,2,33,2,85910,34167,6856,46282,1
55,670,647,139,84,35,284,233,682,0,0,0,0,0,0,0,0,0,0,0,0,2,1,0,85910,34167,6856,46283,0
17,378,85,59,61,8,0,16,93,5,18,10,18,23,28,86,126,2,316,17,0,2,1,1,85910,34167,6856,46284,0
12,515,124,78,88,2,3,26,126,4,13,7,13,17,20,56,81,2,163,9,0,2,1,1,85910,34167,6856,46285,0
4,163,27,21,21,0,0,6,27,3,6,3,6,9,9,20,28,1,42,2,0,2,1,1,85910,34167,6856,46286,0
58,1109,207,111,150,11,0,50,218,5,26,19,36,31,55,133,272,3,943,52,0,2,4,0,85910,34167,6856,46287,0
58,1109,410,198,237,31,55,97,441,11,63,38,72,74,110,414,683,6,4293,238,0,2,4,0,85920,34168,6857,46288,0
251,5809,4293,999,3693,19,54,507,4312,9,155,88,170,164,258,1156,1898,4,9368,520,0,2,1,1,85920,34170,6857,46290,0
251,5809,1482,859,1002,125,135,219,1607,16,219,134,251,235,385,1766,3032,9,27804,1544,1,2,1,1,85930,34171,6857,46291,0
172,7582,4293,999,3693,19,54,507,4312,9,155,88,170,164,258,1156,1898,4,9368,520,0,2,7,4,85930,34173,6857,46292,0
172,7582,1482,859,1002,125,135,219,1607,16,219,134,251,235,385,1766,3032,9,27804,1544,1,2,7,4,85940,34174,6857,46293,0
145,5899,1782,648,1425,9,47,279,1791,8,171,97,189,179,286,1292,2140,4,9462,525,0,2,1,1,85940,34175,6858,46294,0
113,2243,463,295,324,28,62,57,491,12,134,82,154,146,236,989,1696,6,11700,650,0,2,39,0,85950,34176,6858,46295,0
105,4490,1289,550,1043,56,32,155,1345,10,167,93,185,177,278,1266,2075,5,11498,638,0,2,1,1,85950,34178,6859,46296,0
120,5085,1513,682,1277,25,13,200,1538,11,199,116,219,210,335,1557,2584,6,15641,868,0,2,1,1,85950,34180,6859,46297,0
38,2301,334,251,279,10,4,40,344,5,127,74,143,132,217,899,1528,2,4303,239,0,2,3,5,85950,34181,6859,46298,0
9,423,184,100,137,2,15,30,186,6,38,20,39,44,59,214,322,3,991,55,0,2,1,1,85950,34182,6859,46299,0
112,2047,477,336,357,30,23,73,507,16,194,134,250,210,384,1538,2962,10,30538,1696,0,2,4,1,85960,34183,6859,46300,0
121,4896,1450,624,1228,12,26,181,1462,14,306,186,354,320,540,2580,4493,8,36391,2021,1,2,12,0,85960,34185,6860,46301,0
114,2088,477,336,357,30,23,73,507,16,194,134,250,210,384,1538,2962,10,30538,1696,0,2,20,2,85970,34186,6860,46302,0
121,4918,1450,624,1228,12,26,181,1462,14,306,186,354,320,540,2580,4493,8,36391,2021,1,2,19,10,85970,34188,6861,46303,0
149,4624,1660,832,1314,41,38,274,1701,20,312,209,395,332,604,2671,5058,12,64042,3557,1,2,2,0,85970,34190,6862,46305,0
149,4624,1057,646,719,113,100,145,1170,18,215,134,248,233,382,1740,3004,10,31186,1732,1,2,2,0,85980,34191,6863,46306,0
114,2088,477,336,357,30,23,73,507,16,194,134,250,210,384,1538,2962,10,30538,1696,0,2,23,2,85990,34192,6863,46307,0
121,4918,1450,624,1228,12,26,181,1462,14,306,186,354,320,540,2580,4493,8,36391,2021,1,2,21,0,85990,34194,6864,46308,0
173,5396,1660,832,1314,41,38,274,1701,20,312,209,395,332,604,2671,5058,12,64042,3557,1,2,1,1,85990,34196,6865,46310,0
173,5396,1057,646,719,113,100,145,1170,18,215,134,248,233,382,1740,3004,10,31186,1732,1,2,1,1,86000,34197,6866,46311,0
148,4610,1660,832,1314,41,38,274,1701,20,312,209,395,332,604,2671,5058,12,64042,3557,1,2,1,1,86000,34199,6867,46313,0
148,4610,1057,646,719,113,100,145,1170,18,215,134,248,233,382,1740,3004,10,31186,1732,1,2,1,1,86010,34200,6868,46314,0
149,4624,1660,832,1314,41,38,274,1701,20,312,209,395,332,604,2671,5058,12,64042,3557,1,2,1,1,86010,34202,6869,46316,0
149,4624,1057,646,719,113,100,145,1170,18,215,134,248,233,382,1740,3004,10,31186,1732,1,2,1,1,86020,34203,6870,46317,0
235,4842,2,2,2,0,0,0,2,0,0,0,0,0,0,0,0,0,0,0,0,2,2,2,86020,34203,6870,46317,0
235,4842,99,48,90,1,3,5,100,0,0,0,0,0,0,0,0,0,0,0,0,2,2,2,86020,34204,6870,46318,0
235,4842,8,5,5,2,0,1,10,0,0,0,0,0,0,0,0,0,0,0,0,2,2,2,86020,34204,6870,46319,0
235,4842,1217,716,841,84,126,174,1301,14,185,118,215,199,333,1446,2542,8,20687,1149,0,2,2,2,86030,34206,6870,46320,0
235,4842,160,89,115,0,13,31,160,7,15,11,17,22,28,78,124,3,495,27,0,2,2,2,86030,34206,6870,46321,0
235,4842,10,10,9,9,0,0,19,0,0,0,0,0,0,0,0,0,0,0,0,2,2,2,86030,34206,6871,46322,0
235,4842,173,84,99,8,29,36,181,5,12,7,13,17,20,54,81,2,221,12,0,2,2,2,86030,34207,6871,46323,0
235,4842,3,1,1,3,0,0,6,0,0,0,0,0,0,0,0,0,0,0,0,2,2,2,86030,34207,6871,46324,0
27,562,2,2,2,0,0,0,2,0,0,0,0,0,0,0,0,0,0,0,0,2,4,5,86030,34207,6871,46324,0
27,562,99,48,90,1,3,5,100,0,0,0,0,0,0,0,0,0,0,0,0,2,4,5,86030,34208,6871,46325,0
27,562,8,5,5,2,0,1,10,0,0,0,0,0,0,0,0,0,0,0,0,2,4,5,86030,34208,6871,46326,0
27,562,1217,716,841,84,126,174,1301,14,185,118,215,199,333,1446,2542,8,20687,1149,0,2,4,5,86040,34210,6871,46327,0
27,562,160,89,115,0,13,31,160,7,15,11,17,22,28,78,124,3,495,27,0,2,4,5,86040,34210,6871,46328,0
27,562,10,10,9,9,0,0,19,0,0,0,0,0,0,0,0,0,0,0,0,2,4,5,86040,34210,6872,46329,0
27,562,173,84,99,8,29,36,181,5,12,7,13,17,20,54,81,2,221,12,0,2,4,5,86040,34211,6872,46330,0
27,562,3,1,1,3,0,0,6,0,0,0,0,0,0,0,0,0,0,0,0,2,4,5,86040,34211,6872,46331,0
174,5392,1660,832,1314,41,38,274,1701,20,312,209,395,332,604,2671,5058,12,64042,3557,1,2,7,3,86040,34213,6873,46333,0
174,5392,1057,646,719,113,100,145,1170,18,215,134,248,233,382,1740,3004,10,31186,1732,1,2,7,3,86050,34214,6874,46334,0
55,670,647,139,84,35,284,233,682,0,0,0,0,0,0,0,0,0,0,0,0,2,1,1,86050,34214,6874,46335,0
173,5098,1660,832,1314,41,38,274,1701,20,312,209,395,332,604,2671,5058,12,64042,3557,1,2,19,2,86050,34216,6875,46337,0
174,5392,1660,832,1314,41,38,274,1701,20,312,209,395,332,604,2671,5058,12,64042,3557,1,2,3,1,86050,34218,6876,46339,0
174,5392,1057,646,719,113,100,145,1170,18,215,134,248,233,382,1740,3004,10,31186,1732,1,2,3,1,86060,34219,6877,46340,0
173,5098,1660,832,1314,41,38,274,1701,20,312,209,395,332,604,2671,5058,12,64042,3557,1,2,12,7,86060,34221,6878,46342,0
235,4842,2,2,2,0,0,0,2,0,0,0,0,0,0,0,0,0,0,0,0,2,2,4,86060,34221,6878,46342,0
235,4842,99,48,90,1,3,5,100,0,0,0,0,0,0,0,0,0,0,0,0,2,2,4,86060,34222,6878,46343,0
235,4842,8,5,5,2,0,1,10,0,0,0,0,0,0,0,0,0,0,0,0,2,2,4,86060,34222,6878,46344,0
235,4842,1217,716,841,84,126,174,1301,14,185,118,215,199,333,1446,2542,8,20687,1149,0,2,2,4,86070,34224,6878,46345,0
235,4842,160,89,115,0,13,31,160,7,15,11,17,22,28,78,124,3,495,27,0,2,2,4,86070,34224,6878,46346,0
235,4842,10,10,9,9,0,0,19,0,0,0,0,0,0,0,0,0,0,0,0,2,2,4,86070,34224,6879,46347,0
235,4842,173,84,99,8,29,36,181,5,12,7,13,17,20,54,81,2,221,12,0,2,2,4,86070,34225,6879,46348,0
235,4842,3,1,1,3,0,0,6,0,0,0,0,0,0,0,0,0,0,0,0,2,2,4,86070,34225,6879,46349,0
174,5414,1660,832,1314,41,38,274,1701,20,312,209,395,332,604,2671,5058,12,64042,3557,1,2,18,9,86070,34227,6880,46351,0
174,5414,1057,646,719,113,100,145,1170,18,215,134,248,233,382,1740,3004,10,31186,1732,1,2,18,9,86080,34228,6881,46352,0
160,5064,1660,832,1314,41,38,274,1701,20,312,209,395,332,604,2671,5058,12,64042,3557,1,2,82,159,86080,34230,6882,46354,0
160,5064,1057,646,719,113,100,145,1170,18,215,134,248,233,382,1740,3004,10,31186,1732,1,2,82,159,86090,34231,6883,46355,0
114,2091,477,336,357,30,23,73,507,16,194,134,250,210,384,1538,2962,10,30538,1696,0,2,23,2,86100,34232,6883,46356,0
235,4844,2,2,2,0,0,0,2,0,0,0,0,0,0,0,0,0,0,0,0,2,2,1,86100,34232,6883,46356,0
235,4844,99,48,90,1,3,5,100,0,0,0,0,0,0,0,0,0,0,0,0,2,2,1,86100,34233,6883,46357,0
235,4844,8,5,5,2,0,1,10,0,0,0,0,0,0,0,0,0,0,0,0,2,2,1,86100,34233,6883,46358,0
235,4844,1217,716,841,84,126,174,1301,14,185,118,215,199,333,1446,2542,8,20687,1149,0,2,2,1,86110,34235,6883,46359,0
235,4844,160,89,115,0,13,31,160,7,15,11,17,22,28,78,124,3,495,27,0,2,2,1,86110,34235,6883,46360,0
235,4844,10,10,9,9,0,0,19,0,0,0,0,0,0,0,0,0,0,0,0,2,2,1,86110,34235,6884,46361,0
235,4844,173,84,99,8,29,36,181,5,12,7,13,17,20,54,81,2,221,12,0,2,2,1,86110,34236,6884,46362,0
235,4844,3,1,1,3,0,0,6,0,0,0,0,0,0,0,0,0,0,0,0,2,2,1,86110,34236,6884,46363,0
113,2243,463,295,324,28,62,57,491,12,134,82,154,146,236,989,1696,6,11700,650,0,2,39,0,86120,34237,6884,46364,0
13,278,103,47,73,2,12,15,105,5,16,9,17,21,26,75,114,2,303,16,0,0,86,0,86120,34238,6884,46366,0
13,278,86,50,52,8,5,21,94,3,5,3,6,8,9,16,27,1,48,2,0,0,86,0,86120,34239,6884,46367,0
146,3588,77,34,69,0,0,8,77,3,24,16,29,27,45,114,213,1,387,21,0,2,8,14,86120,34239,6884,46368,0
146,3588,712,438,573,51,9,84,763,14,102,71,128,116,199,733,1364,8,11988,666,0,2,8,14,86130,34240,6884,46369,0
71,1562,402,202,227,24,74,80,426,12,52,33,61,64,94,339,564,7,3969,220,0,2,1,4,86130,34241,6884,46370,0
17,467,205,80,86,16,53,53,221,7,18,10,19,25,29,94,134,3,497,27,0,2,3,7,86140,34241,6885,46371,0
59,1205,91,45,69,0,3,18,91,3,9,6,10,12,16,33,57,1,95,5,0,2,2,0,86140,34243,6885,46372,0
59,1205,367,234,237,17,34,68,384,16,55,34,61,71,95,381,584,8,5183,287,0,2,2,0,86140,34244,6885,46373,0
225,5725,722,423,573,19,0,135,741,12,172,101,199,184,300,1320,2257,6,15668,870,0,2,6,13,86140,34246,6885,46375,0
225,5725,1508,847,911,44,250,301,1552,14,148,88,169,162,257,1120,1886,7,15077,837,0,2,6,13,86140,34247,6886,46376,0
280,5856,1943,715,1694,26,18,214,1969,12,185,120,237,197,357,1436,2721,7,20915,1161,0,2,1,2,86140,34249,6886,46377,0
280,5856,1168,838,957,57,25,144,1225,19,348,224,416,367,640,3018,5452,11,61921,3440,1,2,1,2,86150,34251,6886,46378,0
105,4490,1289,550,1043,56,32,155,1345,10,167,93,185,177,278,1266,2075,5,11498,638,0,2,14,1,86150,34253,6887,46379,0
14,833,75,38,59,1,3,12,76,2,4,2,4,6,6,10,15,1,15,0,0,2,8,15,86150,34253,6887,46380,0
145,5899,1782,648,1425,9,47,279,1791,8,171,97,189,179,286,1292,2140,4,9462,525,0,2,13,0,86150,34254,6888,46381,0
121,4918,1450,624,1228,12,26,181,1462,14,306,186,354,320,540,2580,4493,8,36391,2021,1,2,23,2,86150,34256,6889,46382,0
174,5288,1660,832,1314,41,38,274,1701,20,312,209,395,332,604,2671,5058,12,64042,3557,1,2,80,53,86150,34258,6890,46384,0
120,5085,1513,682,1277,25,13,200,1538,11,199,116,219,210,335,1557,2584,6,15641,868,0,2,1,1,86150,34260,6890,46385,0
8,310,103,47,73,2,12,15,105,5,16,9,17,21,26,75,114,2,303,16,0,0,103,0,86150,34261,6890,46386,0
38,2301,334,251,279,10,4,40,344,5,127,74,143,132,217,899,1528,2,4303,239,0,2,3,5,86150,34262,6890,46387,0
9,423,184,100,137,2,15,30,186,6,38,20,39,44,59,214,322,3,991,55,0,2,1,1,86150,34263,6890,46388,0
9,413,91,45,69,0,3,18,91,3,9,6,10,12,16,33,57,1,95,5,0,2,5,0,86150,34265,6890,46389,0
160,5080,1660,832,1314,41,38,274,1701,20,312,209,395,332,604,2671,5058,12,64042,3557,1,2,7,7,86150,34267,6891,46391,0
160,5080,1057,646,719,113,100,145,1170,18,215,134,248,233,382,1740,3004,10,31186,1732,1,2,7,7,86160,34268,6892,46392,0
160,5080,1660,832,1314,41,38,274,1701,20,312,209,395,332,604,2671,5058,12,64042,3557,1,2,1,1,86160,34270,6893,46394,0
160,5080,1057,646,719,113,100,145,1170,18,215,134,248,233,382,1740,3004,10,31186,1732,1,2,1,1,86170,34271,6894,46395,0
27,562,2,2,2,0,0,0,2,0,0,0,0,0,0,0,0,0,0,0,0,2,1,1,86170,34271,6894,46395,0
27,562,99,48,90,1,3,5,100,0,0,0,0,0,0,0,0,0,0,0,0,2,1,1,86170,34272,6894,46396,0
27,562,8,5,5,2,0,1,10,0,0,0,0,0,0,0,0,0,0,0,0,2,1,1,86170,34272,6894,46397,0
27,562,1217,716,841,84,126,174,1301,14,185,118,215,199,333,1446,2542,8,20687,1149,0,2,1,1,86180,34274,6894,46398,0
27,562,160,89,115,0,13,31,160,7,15,11,17,22,28,78,124,3,495,27,0,2,1,1,86180,34274,6894,46399,0
27,562,10,10,9,9,0,0,19,0,0,0,0,0,0,0,0,0,0,0,0,2,1,1,86180,34274,6895,46400,0
27,562,173,84,99,8,29,36,181,5,12,7,13,17,20,54,81,2,221,12,0,2,1,1,86180,34275,6895,46401,0
27,562,3,1,1,3,0,0,6,0,0,0,0,0,0,0,0,0,0,0,0,2,1,1,86180,34275,6895,46402,0
175,5312,1660,832,1314,41,38,274,1701,20,312,209,395,332,604,2671,5058,12,64042,3557,1,2,4,0,86180,34277,6896,46404,0
160,5086,1660,832,1314,41,38,274,1701,20,312,209,395,332,604,2671,5058,12,64042,3557,1,2,1,1,86180,34279,6897,46406,0
160,5086,1057,646,719,113,100,145,1170,18,215,134,248,233,382,1740,3004,10,31186,1732,1,2,1,1,86190,34280,6898,46407,0
55,670,647,139,84,35,284,233,682,0,0,0,0,0,0,0,0,0,0,0,0,2,18,7,86190,34280,6898,46408,0
160,5078,1660,832,1314,41,38,274,1701,20,312,209,395,332,604,2671,5058,12,64042,3557,1,2,4,4,86190,34282,6899,46410,0
160,5078,1057,646,719,113,100,145,1170,18,215,134,248,233,382,1740,3004,10,31186,1732,1,2,4,4,86200,34283,6900,46411,0
175,5312,1660,832,1314,41,38,274,1701,20,312,209,395,332,604,2671,5058,12,64042,3557,1,2,4,0,86200,34285,6901,46413,0
58,1109,207,111,150,11,0,50,218,5,26,19,36,31,55,133,272,3,943,52,0,2,4,0,86200,34285,6901,46414,0
58,1109,410,198,237,31,55,97,441,11,63,38,72,74,110,414,683,6,4293,238,0,2,4,0,86210,34286,6902,46415,0
251,5809,4293,999,3693,19,54,507,4312,9,155,88,170,164,258,1156,1898,4,9368,520,0,2,1,1,86210,34288,6902,46417,0
251,5809,1482,859,1002,125,135,219,1607,16,219,134,251,235,385,1766,3032,9,27804,1544,1,2,1,1,86220,34289,6902,46418,0
172,7582,4293,999,3693,19,54,507,4312,9,155,88,170,164,258,1156,1898,4,9368,520,0,2,7,4,86220,34291,6902,46419,0
172,7582,1482,859,1002,125,135,219,1607,16,219,134,251,235,385,1766,3032,9,27804,1544,1,2,7,4,86230,34292,6902,46420,0
145,5899,1782,648,1425,9,47,279,1791,8,171,97,189,179,286,1292,2140,4,9462,525,0,2,1,1,86230,34293,6903,46421,0
1,94,42,7,35,4,0,5,46,1,2,1,2,3,3,2,4,0,2,0,0,2,1,0,86230,34293,6903,46422,0
1,94,11,6,10,0,0,1,11,2,4,2,4,6,6,10,15,1,15,0,0,2,1,0,86230,34293,6903,46423,0
27,562,2,2,2,0,0,0,2,0,0,0,0,0,0,0,0,0,0,0,0,2,18,1,86230,34293,6903,46423,0
27,562,99,48,90,1,3,5,100,0,0,0,0,0,0,0,0,0,0,0,0,2,18,1,86230,34294,6903,46424,0
27,562,8,5,5,2,0,1,10,0,0,0,0,0,0,0,0,0,0,0,0,2,18,1,86230,34294,6903,46425,0
27,562,1217,716,841,84,126,174,1301,14,185,118,215,199,333,1446,2542,8,20687,1149,0,2,18,1,86240,34296,6903,46426,0
27,562,160,89,115,0,13,31,160,7,15,11,17,22,28,78,124,3,495,27,0,2,18,1,86240,34296,6903,46427,0
27,562,10,10,9,9,0,0,19,0,0,0,0,0,0,0,0,0,0,0,0,2,18,1,86240,34296,6904,46428,0
27,562,173,84,99,8,29,36,181,5,12,7,13,17,20,54,81,2,221,12,0,2,18,1,86240,34297,6904,46429,0
27,562,3,1,1,3,0,0,6,0,0,0,0,0,0,0,0,0,0,0,0,2,18,1,86240,34297,6904,46430,0
160,5078,1660,832,1314,41,38,274,1701,20,312,209,395,332,604,2671,5058,12,64042,3557,1,2,116,36,86240,34299,6905,46432,0
160,5078,1057,646,719,113,100,145,1170,18,215,134,248,233,382,1740,3004,10,31186,1732,1,2,116,36,86250,34300,6906,46433,0
114,2091,477,336,357,30,23,73,507,16,194,134,250,210,384,1538,2962,10,30538,1696,0,2,4,0,86260,34301,6906,46434,0
55,670,647,139,84,35,284,233,682,0,0,0,0,0,0,0,0,0,0,0,0,2,36,0,86260,34301,6906,46435,0
105,4490,1289,550,1043,56,32,155,1345,10,167,93,185,177,278,1266,2075,5,11498,638,0,2,4,1,86260,34303,6907,46436,0
32,968,256,139,192,9,7,47,265,4,23,12,24,27,36,112,171,2,357,19,0,2,3,0,86260,34304,6907,46437,0
175,5312,1660,832,1314,41,38,274,1701,20,312,209,395,332,604,2671,5058,12,64042,3557,1,2,112,0,86260,34306,6908,46439,0
159,5037,1660,832,1314,41,38,274,1701,20,312,209,395,332,604,2671,5058,12,64042,3557,1,2,8,20,86260,34308,6909,46441,0
159,5037,1057,646,719,113,100,145,1170,18,215,134,248,233,382,1740,3004,10,31186,1732,1,2,8,20,86270,34309,6910,46442,0
159,5037,1660,832,1314,41,38,274,1701,20,312,209,395,332,604,2671,5058,12,64042,3557,1,2,8,20,86270,34311,6911,46444,0
159,5037,1057,646,719,113,100,145,1170,18,215,134,248,233,382,1740,3004,10,31186,1732,1,2,8,20,86280,34312,6912,46445,0
146,3590,77,34,69,0,0,8,77,3,24,16,29,27,45,114,213,1,387,21,0,2,4,1,86280,34312,6912,46446,0
146,3590,712,438,573,51,9,84,763,14,102,71,128,116,199,733,1364,8,11988,666,0,2,4,1,86290,34313,6912,46447,0
106,4541,1289,550,1043,56,32,155,1345,10,167,93,185,177,278,1266,2075,5,11498,638,0,2,6,0,86290,34315,6913,46448,0
146,3590,77,34,69,0,0,8,77,3,24,16,29,27,45,114,213,1,387,21,0,2,4,1,86290,34315,6913,46449,0
146,3590,712,438,573,51,9,84,763,14,102,71,128,116,199,733,1364,8,11988,666,0,2,4,1,86300,34316,6913,46450,0
106,4541,1289,550,1043,56,32,155,1345,10,167,93,185,177,278,1266,2075,5,11498,638,0,2,6,0,86300,34318,6914,46451,0
75,1605,53,23,39,0,0,13,53,2,8,4,8,10,12,26,39,1,39,2,0,2,1,1,86300,34318,6914,46452,0
75,1605,515,298,307,33,80,99,548,12,63,44,77,75,121,419,753,7,5527,307,0,2,1,1,86310,34318,6914,46453,0
102,5281,1457,730,1242,11,6,188,1468,10,292,166,329,302,495,2424,4078,5,22973,1276,1,2,8,2,86310,34320,6914,46454,0
75,1605,53,23,39,0,0,13,53,2,8,4,8,10,12,26,39,1,39,2,0,2,1,1,86310,34320,6914,46455,0
75,1605,515,298,307,33,80,99,548,12,63,44,77,75,121,419,753,7,5527,307,0,2,1,1,86320,34320,6914,46456,0
102,5281,1457,730,1242,11,6,188,1468,10,292,166,329,302,495,2424,4078,5,22973,1276,1,2,8,2,86320,34322,6914,46457,0
91,2310,1455,414,1257,16,76,112,1471,5,41,23,46,46,69,231,381,2,1069,59,0,2,19,22,86320,34323,6914,46458,0
91,2310,669,365,481,22,61,110,691,15,103,63,122,118,185,747,1273,8,11311,628,0,2,19,22,86330,34323,6915,46459,0
1,92,42,7,35,4,0,5,46,1,2,1,2,3,3,2,4,0,2,0,0,2,0,1,86330,34323,6915,46460,1
1,92,11,6,10,0,0,1,11,2,4,2,4,6,6,10,15,1,15,0,0,2,0,1,86330,34323,6915,46461,1
180,5373,1660,832,1314,41,38,274,1701,20,312,209,395,332,604,2671,5058,12,64042,3557,1,2,66,6,86330,34325,6916,46463,1
180,5373,1057,646,719,113,100,145,1170,18,215,134,248,233,382,1740,3004,10,31186,1732,1,2,66,6,86340,34326,6917,46464,1
179,5679,1660,832,1314,41,38,274,1701,20,312,209,395,332,604,2671,5058,12,64042,3557,1,2,131,47,86340,34328,6918,46466,1
1,92,42,7,35,4,0,5,46,1,2,1,2,3,3,2,4,0,2,0,0,2,0,1,86340,34328,6918,46467,0
1,92,11,6,10,0,0,1,11,2,4,2,4,6,6,10,15,1,15,0,0,2,0,1,86340,34328,6918,46468,0
180,5373,1660,832,1314,41,38,274,1701,20,312,209,395,332,604,2671,5058,12,64042,3557,1,2,66,6,86340,34330,6919,46470,0
180,5373,1057,646,719,113,100,145,1170,18,215,134,248,233,382,1740,3004,10,31186,1732,1,2,66,6,86350,34331,6920,46471,0
179,5679,1660,832,1314,41,38,274,1701,20,312,209,395,332,604,2671,5058,12,64042,3557,1,2,131,47,86350,34333,6921,46473,0
60,1136,282,196,195,3,0,86,285,8,130,71,141,138,212,936,1507,4,6538,363,0,2,3,2,86350,34333,6922,46474,0
7,289,72,33,56,0,4,12,72,1,1,1,1,2,2,0,2,0,1,0,0,2,2,2,86350,34333,6922,46475,0
91,2310,1455,414,1257,16,76,112,1471,5,41,23,46,46,69,231,381,2,1069,59,0,2,19,22,86350,34334,6922,46476,0
91,2310,669,365,481,22,61,110,691,15,103,63,122,118,185,747,1273,8,11311,628,0,2,19,22,86360,34334,6923,46477,0
60,1136,282,196,195,3,0,86,285,8,130,71,141,138,212,936,1507,4,6538,363,0,2,3,2,86360,34334,6924,46478,0
7,289,72,33,56,0,4,12,72,1,1,1,1,2,2,0,2,0,1,0,0,2,2,2,86360,34334,6924,46479,0
60,1136,282,196,195,3,0,86,285,8,130,71,141,138,212,936,1507,4,6538,363,0,2,3,2,86360,34334,6925,46480,0
7,289,72,33,56,0,4,12,72,1,1,1,1,2,2,0,2,0,1,0,0,2,2,2,86360,34334,6925,46481,0
17,378,85,59,61,8,0,16,93,5,18,10,18,23,28,86,126,2,316,17,0,2,1,1,86360,34334,6925,46482,0
12,515,124,78,88,2,3,26,126,4,13,7,13,17,20,56,81,2,163,9,0,2,1,1,86360,34334,6925,46483,0
219,4666,182,127,129,0,0,53,182,5,39,21,42,44,63,217,343,2,926,51,0,2,0,8,86360,34334,6926,46484,0
219,4666,1165,710,800,67,119,181,1232,18,243,153,282,261,435,2000,3492,10,36473,2026,1,2,0,8,86370,34334,6927,46485,0
27,562,2,2,2,0,0,0,2,0,0,0,0,0,0,0,0,0,0,0,0,2,18,1,86370,34334,6927,46485,0
27,562,99,48,90,1,3,5,100,0,0,0,0,0,0,0,0,0,0,0,0,2,18,1,86370,34335,6927,46486,0
27,562,8,5,5,2,0,1,10,0,0,0,0,0,0,0,0,0,0,0,0,2,18,1,86370,34335,6927,46487,0
27,562,1217,716,841,84,126,174,1301,14,185,118,215,199,333,1446,2542,8,20687,1149,0,2,18,1,86380,34337,6927,46488,0
27,562,160,89,115,0,13,31,160,7,15,11,17,22,28,78,124,3,495,27,0,2,18,1,86380,34337,6927,46489,0
27,562,10,10,9,9,0,0,19,0,0,0,0,0,0,0,0,0,0,0,0,2,18,1,86380,34337,6928,46490,0
27,562,173,84,99,8,29,36,181,5,12,7,13,17,20,54,81,2,221,12,0,2,18,1,86380,34338,6928,46491,0
27,562,3,1,1,3,0,0,6,0,0,0,0,0,0,0,0,0,0,0,0,2,18,1,86380,34338,6928,46492,0
180,5373,1660,832,1314,41,38,274,1701,20,312,209,395,332,604,2671,5058,12,64042,3557,1,2,259,252,86380,34340,6929,46494,0
180,5373,1057,646,719,113,100,145,1170,18,215,134,248,233,382,1740,3004,10,31186,1732,1,2,259,252,86390,34341,6930,46495,0
114,2091,477,336,357,30,23,73,507,16,194,134,250,210,384,1538,2962,10,30538,1696,0,2,33,32,86400,34342,6930,46496,0
58,1109,207,111,150,11,0,50,218,5,26,19,36,31,55,133,272,3,943,52,0,2,20,15,86400,34342,6930,46497,0
58,1109,410,198,237,31,55,97,441,11,63,38,72,74,110,414,683,6,4293,238,0,2,20,15,86410,34343,6931,46498,0
235,4844,2,2,2,0,0,0,2,0,0,0,0,0,0,0,0,0,0,0,0,2,5,15,86410,34343,6931,46498,0
235,4844,99,48,90,1,3,5,100,0,0,0,0,0,0,0,0,0,0,0,0,2,5,15,86410,34344,6931,46499,0
235,4844,8,5,5,2,0,1,10,0,0,0,0,0,0,0,0,0,0,0,0,2,5,15,86410,34344,6931,46500,0
235,4844,1217,716,841,84,126,174,1301,14,185,118,215,199,333,1446,2542,8,20687,1149,0,2,5,15,86420,34346,6931,46501,0
235,4844,160,89,115,0,13,31,160,7,15,11,17,22,28,78,124,3,495,27,0,2,5,15,86420,34346,6931,46502,0
235,4844,10,10,9,9,0,0,19,0,0,0,0,0,0,0,0,0,0,0,0,2,5,15,86420,34346,6932,46503,0
235,4844,173,84,99,8,29,36,181,5,12,7,13,17,20,54,81,2,221,12,0,2,5,15,86420,34347,6932,46504,0
235,4844,3,1,1,3,0,0,6,0,0,0,0,0,0,0,0,0,0,0,0,2,5,15,86420,34347,6932,46505,0
91,2310,1455,414,1257,16,76,112,1471,5,41,23,46,46,69,231,381,2,1069,59,0,2,20,13,86420,34348,6932,46507,0
91,2310,669,365,481,22,61,110,691,15,103,63,122,118,185,747,1273,8,11311,628,0,2,20,13,86430,34348,6933,46508,0
13,278,103,47,73,2,12,15,105,5,16,9,17,21,26,75,114,2,303,16,0,0,86,0,86430,34349,6933,46509,0
13,278,86,50,52,8,5,21,94,3,5,3,6,8,9,16,27,1,48,2,0,0,86,0,86430,34350,6933,46510,0
251,5809,4293,999,3693,19,54,507,4312,9,155,88,170,164,258,1156,1898,4,9368,520,0,2,2,8,86430,34352,6933,46511,0
251,5809,1482,859,1002,125,135,219,1607,16,219,134,251,235,385,1766,3032,9,27804,1544,1,2,2,8,86440,34353,6933,46512,0
55,670,647,139,84,35,284,233,682,0,0,0,0,0,0,0,0,0,0,0,0,2,36,0,86440,34353,6933,46513,0
105,2754,773,422,505,30,103,129,803,14,77,46,83,91,129,535,839,7,6334,351,0,2,12,7,86450,34354,6934,46514,0
146,3590,77,34,69,0,0,8,77,3,24,16,29,27,45,114,213,1,387,21,0,2,39,28,86450,34354,6934,46515,0
146,3590,712,438,573,51,9,84,763,14,102,71,128,116,199,733,1364,8,11988,666,0,2,39,28,86460,34355,6934,46516,0
71,1562,402,202,227,24,74,80,426,12,52,33,61,64,94,339,564,7,3969,220,0,2,1,4,86460,34356,6934,46517,0
75,1605,53,23,39,0,0,13,53,2,8,4,8,10,12,26,39,1,39,2,0,2,1,1,86460,34356,6934,46518,0
75,1605,515,298,307,33,80,99,548,12,63,44,77,75,121,419,753,7,5527,307,0,2,1,1,86470,34356,6934,46519,0
17,467,205,80,86,16,53,53,221,7,18,10,19,25,29,94,134,3,497,27,0,2,5,12,86480,34356,6935,46520,0
59,1205,91,45,69,0,3,18,91,3,9,6,10,12,16,33,57,1,95,5,0,2,3,3,86480,34358,6935,46521,0
59,1205,367,234,237,17,34,68,384,16,55,34,61,71,95,381,584,8,5183,287,0,2,3,3,86480,34359,6935,46522,0
225,5725,722,423,573,19,0,135,741,12,172,101,199,184,300,1320,2257,6,15668,870,0,2,19,43,86480,34361,6935,46524,0
225,5725,1508,847,911,44,250,301,1552,14,148,88,169,162,257,1120,1886,7,15077,837,0,2,19,43,86480,34362,6936,46525,0
314,6853,72,33,56,0,4,12,72,1,1,1,1,2,2,0,2,0,1,0,0,2,2,6,86480,34362,6936,46526,0
314,6853,1454,835,1044,76,110,219,1530,17,275,158,296,292,454,2297,3718,9,34017,1889,1,2,2,6,86490,34363,6936,46527,0
88,1782,757,253,292,73,244,162,830,13,61,38,67,74,105,409,651,7,4654,258,0,2,4,16,86490,34364,6936,46528,0
26,435,219,78,157,11,5,46,230,3,24,20,34,27,54,114,256,2,545,30,0,2,2,7,86490,34365,6936,46529,0
26,435,108,64,79,9,0,20,117,5,15,11,19,20,30,70,129,3,410,22,0,2,2,7,86490,34365,6936,46530,0
280,5856,1943,715,1694,26,18,214,1969,12,185,120,237,197,357,1436,2721,7,20915,1161,0,2,8,13,86490,34367,6936,46531,0
280,5856,1168,838,957,57,25,144,1225,19,348,224,416,367,640,3018,5452,11,61921,3440,1,2,8,13,86500,34369,6936,46532,0
65,1270,1098,241,925,5,10,155,1103,7,46,25,49,53,74,273,423,3,1580,87,0,2,2,0,86510,34371,6936,46533,0
65,1270,282,202,222,14,2,44,296,8,42,24,43,50,67,250,378,4,1548,86,0,2,2,0,86510,34372,6936,46534,0
2,183,37,13,25,0,6,6,37,1,2,1,2,3,3,2,4,0,2,0,0,2,20,0,86510,34372,6936,46535,0
2,183,133,47,40,1,43,49,134,0,0,0,0,0,0,0,0,0,0,0,0,2,20,0,86510,34372,6936,46536,0
23,642,601,196,481,2,23,85,603,8,63,36,72,71,108,400,664,4,3036,168,0,2,1,0,86510,34372,6936,46537,0
23,642,156,79,106,5,16,28,161,5,14,8,15,19,23,64,97,2,261,14,0,2,1,0,86510,34372,6936,46538,0
106,4541,1289,550,1043,56,32,155,1345,10,167,93,185,177,278,1266,2075,5,11498,638,0,2,40,27,86510,34374,6937,46539,0
150,7150,1392,870,1177,35,17,170,1427,14,494,280,531,508,811,4473,7289,7,54850,3047,2,2,3,11,86510,34377,6938,46540,0
95,2843,773,419,590,28,0,166,801,10,204,113,217,214,330,1598,2554,5,13587,754,0,2,1,1,86510,34377,6939,46541,0
8,210,127,75,83,2,11,30,129,4,14,7,14,18,21,61,87,2,175,9,0,2,15,0,86510,34377,6939,46542,0
8,210,652,304,544,16,6,88,668,6,89,51,101,95,152,591,998,3,3399,188,0,2,15,0,86510,34378,6939,46543,0
8,210,2,2,2,0,0,0,2,0,0,0,0,0,0,0,0,0,0,0,0,2,15,0,86510,34378,6939,46543,0
8,210,8,5,5,0,0,3,8,0,0,0,0,0,0,0,0,0,0,0,0,2,15,0,86510,34378,6939,46544,0
8,210,2,2,2,0,0,0,2,0,0,0,0,0,0,0,0,0,0,0,0,2,15,0,86510,34378,6939,46544,0
8,210,14,8,8,0,0,6,14,0,0,0,0,0,0,0,0,0,0,0,0,2,15,0,86510,34378,6939,46545,0
8,210,6,4,4,0,0,2,6,0,0,0,0,0,0,0,0,0,0,0,0,2,15,0,86510,34378,6939,46546,0
8,210,6,4,4,0,0,2,6,1,2,1,2,3,3,2,4,0,2,0,0,2,15,0,86510,34378,6939,46547,0
8,210,6,4,4,0,0,2,6,0,0,0,0,0,0,0,0,0,0,0,0,2,15,0,86510,34378,6939,46548,0
8,210,7,5,5,0,0,2,7,0,0,0,0,0,0,0,0,0,0,0,0,2,15,0,86510,34378,6939,46549,0
8,210,6,4,4,0,0,2,6,0,0,0,0,0,0,0,0,0,0,0,0,2,15,0,86510,34378,6939,46550,0
8,210,10,6,6,0,0,4,10,0,0,0,0,0,0,0,0,0,0,0,0,2,15,0,86510,34378,6939,46551,0
8,210,1,1,1,0,0,0,1,0,0,0,0,0,0,0,0,0,0,0,0,2,15,0,86510,34378,6939,46551,0
8,210,14,10,10,0,0,4,14,1,1,1,1,2,2,0,2,0,1,0,0,2,15,0,86510,34378,6939,46552,0
8,210,46,26,30,3,0,12,49,3,6,3,6,9,9,20,28,1,42,2,0,2,15,0,86520,34378,6939,46553,0
14,833,75,38,59,1,3,12,76,2,4,2,4,6,6,10,15,1,15,0,0,2,9,16,86520,34378,6939,46554,0
4,163,27,21,21,0,0,6,27,3,6,3,6,9,9,20,28,1,42,2,0,2,1,1,86520,34378,6939,46555,0
12,314,149,95,105,2,0,41,151,8,54,28,55,62,83,334,494,4,2013,111,0,2,1,1,86520,34378,6939,46556,0
42,2613,1157,318,931,29,22,177,1186,6,104,63,125,110,188,712,1274,3,4596,255,0,2,37,6,86520,34378,6939,46557,0
90,3963,1338,495,1086,10,64,173,1348,11,122,82,157,133,239,883,1686,7,11934,663,0,2,4,4,86520,34380,6939,46558,0
172,7582,4293,999,3693,19,54,507,4312,9,155,88,170,164,258,1156,1898,4,9368,520,0,2,10,8,86520,34382,6939,46559,0
172,7582,1482,859,1002,125,135,219,1607,16,219,134,251,235,385,1766,3032,9,27804,1544,1,2,10,8,86530,34383,6939,46560,0
145,5899,1782,648,1425,9,47,279,1791,8,171,97,189,179,286,1292,2140,4,9462,525,0,2,15,2,86530,34384,6940,46561,0
32,968,256,139,192,9,7,47,265,4,23,12,24,27,36,112,171,2,357,19,0,2,4,1,86530,34385,6940,46562,0
121,4918,1450,624,1228,12,26,181,1462,14,306,186,354,320,540,2580,4493,8,36391,2021,1,2,24,3,86530,34387,6941,46563,0
179,5679,1660,832,1314,41,38,274,1701,20,312,209,395,332,604,2671,5058,12,64042,3557,1,2,297,152,86530,34389,6942,46565,0
49,3782,996,429,845,24,10,117,1020,7,76,50,88,83,138,494,879,4,3565,198,0,2,2,2,86530,34391,6942,46566,0
120,5085,1513,682,1277,25,13,200,1538,11,199,116,219,210,335,1557,2584,6,15641,868,0,2,9,9,86530,34393,6942,46567,0
84,4875,1296,573,1062,40,33,157,1336,8,201,118,231,209,349,1561,2689,4,12365,686,0,2,6,7,86530,34393,6942,46568,0
102,5281,1457,730,1242,11,6,188,1468,10,292,166,329,302,495,2424,4078,5,22973,1276,1,2,42,16,86530,34395,6942,46569,0
43,2669,652,304,544,16,6,88,668,6,89,51,101,95,152,591,998,3,3399,188,0,2,7,9,86530,34396,6942,46570,0
74,3363,1455,414,1257,16,76,112,1471,5,41,23,46,46,69,231,381,2,1069,59,0,2,26,2,86530,34397,6942,46571,0
8,310,103,47,73,2,12,15,105,5,16,9,17,21,26,75,114,2,303,16,0,0,103,0,86530,34398,6942,46572,0
8,269,74,35,59,1,0,14,75,3,14,7,14,17,21,58,85,1,128,7,0,2,4,4,86530,34399,6942,46573,0
107,5128,1523,757,1297,19,12,193,1542,12,193,117,230,205,347,1508,2664,7,19053,1058,0,2,3,3,86540,34401,6942,46574,0
70,3179,1020,354,843,12,15,144,1032,8,134,77,144,142,221,970,1580,4,6792,377,0,2,2,2,86540,34401,6942,46575,0
21,637,424,94,331,4,0,89,428,1,5,5,5,6,10,11,25,0,12,0,0,2,1,1,86540,34402,6942,46576,0
9,413,91,45,69,0,3,18,91,3,9,6,10,12,16,33,57,1,95,5,0,2,5,0,86540,34404,6942,46577,0
29,1875,384,251,317,7,8,52,391,11,70,44,84,81,128,467,811,6,5355,297,0,2,2,2,86540,34404,6942,46578,0
55,2829,722,423,573,19,0,135,741,12,172,101,199,184,300,1320,2257,6,15668,870,0,2,10,19,86540,34406,6942,46580,0
85,3346,1043,504,840,53,9,147,1096,9,180,112,198,189,310,1377,2344,4,11604,644,0,2,6,8,86540,34408,6942,46581,0
30,1424,373,158,315,8,0,51,381,5,76,44,79,81,123,486,779,2,2026,112,0,2,2,2,86540,34408,6942,46582,0
10,475,219,78,157,11,5,46,230,3,24,20,34,27,54,114,256,2,545,30,0,2,9,11,86540,34409,6942,46583,0
111,6050,1943,715,1694,26,18,214,1969,12,185,120,237,197,357,1436,2721,7,20915,1161,0,2,2,3,86540,34411,6942,46584,0
35,1463,442,244,305,14,16,103,456,11,68,45,75,79,120,452,756,6,4588,254,0,2,0,1,86540,34413,6942,46585,0
49,1968,1098,241,925,5,10,155,1103,7,46,25,49,53,74,273,423,3,1580,87,0,2,26,3,86550,34415,6942,46586,0
2,103,37,13,25,0,6,6,37,1,2,1,2,3,3,2,4,0,2,0,0,0,37,0,86550,34415,6942,46587,0
52,1740,601,196,481,2,23,85,603,8,63,36,72,71,108,400,664,4,3036,168,0,2,35,4,86550,34415,6942,46588,0
113,2243,463,295,324,28,62,57,491,12,134,82,154,146,236,989,1696,6,11700,650,0,2,1,1,86560,34416,6942,46589,0
113,2243,463,295,324,28,62,57,491,12,134,82,154,146,236,989,1696,6,11700,650,0,2,1,1,86570,34417,6942,46590,0
250,5777,4293,999,3693,19,54,507,4312,9,155,88,170,164,258,1156,1898,4,9368,520,0,2,0,7,86570,34419,6942,46592,0
250,5777,1482,859,1002,125,135,219,1607,16,219,134,251,235,385,1766,3032,9,27804,1544,1,2,0,7,86580,34420,6942,46593,0
13,817,75,38,59,1,3,12,76,2,4,2,4,6,6,10,15,1,15,0,0,2,0,4,86580,34420,6942,46594,0
170,7532,4293,999,3693,19,54,507,4312,9,155,88,170,164,258,1156,1898,4,9368,520,0,2,16,30,86580,34422,6942,46595,0
170,7532,1482,859,1002,125,135,219,1607,16,219,134,251,235,385,1766,3032,9,27804,1544,1,2,16,30,86590,34423,6942,46596,0
87,1703,757,253,292,73,244,162,830,13,61,38,67,74,105,409,651,7,4654,258,0,2,4,16,86590,34424,6942,46598,1
38,712,386,256,301,16,9,68,402,4,59,35,69,63,104,355,621,2,1453,80,0,2,4,14,86590,34424,6942,46599,1
38,712,264,131,164,11,41,46,275,6,38,22,40,44,62,214,338,3,1068,59,0,2,4,14,86600,34424,6943,46600,1
30,879,256,139,192,9,7,47,265,4,23,12,24,27,36,112,171,2,357,19,0,2,8,22,86600,34425,6943,46601,1
70,3178,1020,354,843,12,15,144,1032,8,134,77,144,142,221,970,1580,4,6792,377,0,2,2,1,86600,34425,6943,46602,1
45,1930,386,256,301,16,9,68,402,4,59,35,69,63,104,355,621,2,1453,80,0,2,10,16,86600,34425,6943,46603,1
86,1672,757,253,292,73,244,162,830,13,61,38,67,74,105,409,651,7,4654,258,0,2,0,7,86600,34426,6943,46605,0
12,788,75,38,59,1,3,12,76,2,4,2,4,6,6,10,15,1,15,0,0,2,0,6,86600,34426,6943,46606,0
28,820,256,139,192,9,7,47,265,4,23,12,24,27,36,112,171,2,357,19,0,2,0,12,86600,34427,6943,46607,0
70,1518,402,202,227,24,74,80,426,12,52,33,61,64,94,339,564,7,3969,220,0,2,6,14,86600,34428,6943,46609,0
85,1663,757,253,292,73,244,162,830,13,61,38,67,74,105,409,651,7,4654,258,0,2,3,5,86600,34429,6943,46610,0
38,702,386,256,301,16,9,68,402,4,59,35,69,63,104,355,621,2,1453,80,0,2,6,7,86600,34429,6943,46611,0
38,702,264,131,164,11,41,46,275,6,38,22,40,44,62,214,338,3,1068,59,0,2,6,7,86610,34429,6944,46612,0
11,753,75,38,59,1,3,12,76,2,4,2,4,6,6,10,15,1,15,0,0,2,0,9,86610,34429,6944,46613,0
69,3112,1020,354,843,12,15,144,1032,8,134,77,144,142,221,970,1580,4,6792,377,0,2,0,13,86610,34429,6944,46614,0
236,4859,2,2,2,0,0,0,2,0,0,0,0,0,0,0,0,0,0,0,0,2,14,10,86610,34429,6944,46614,0
236,4859,99,48,90,1,3,5,100,0,0,0,0,0,0,0,0,0,0,0,0,2,14,10,86610,34430,6944,46615,0
236,4859,8,5,5,2,0,1,10,0,0,0,0,0,0,0,0,0,0,0,0,2,14,10,86610,34430,6944,46616,0
236,4859,1217,716,841,84,126,174,1301,14,185,118,215,199,333,1446,2542,8,20687,1149,0,2,14,10,86620,34432,6944,46617,0
236,4859,160,89,115,0,13,31,160,7,15,11,17,22,28,78,124,3,495,27,0,2,14,10,86620,34432,6944,46618,0
236,4859,10,10,9,9,0,0,19,0,0,0,0,0,0,0,0,0,0,0,0,2,14,10,86620,34432,6945,46619,0
236,4859,173,84,99,8,29,36,181,5,12,7,13,17,20,54,81,2,221,12,0,2,14,10,86620,34433,6945,46620,0
236,4859,3,1,1,3,0,0,6,0,0,0,0,0,0,0,0,0,0,0,0,2,14,10,86620,34433,6945,46621,0
7,287,75,38,59,1,3,12,76,2,4,2,4,6,6,10,15,1,15,0,0,2,0,118,86620,34433,6945,46623,0
106,5687,1457,730,1242,11,6,188,1468,10,292,166,329,302,495,2424,4078,5,22973,1276,1,2,114,0,86620,34435,6945,46624,0
55,761,167,116,138,4,5,22,171,8,48,30,56,56,86,292,499,4,2330,129,0,2,3,4,86620,34435,6945,46625,0
5,216,75,38,59,1,3,12,76,2,4,2,4,6,6,10,15,1,15,0,0,2,0,24,86620,34435,6945,46627,0
108,5765,1457,730,1242,11,6,188,1468,10,292,166,329,302,495,2424,4078,5,22973,1276,1,2,24,0,86620,34437,6945,46628,0
141,3466,77,34,69,0,0,8,77,3,24,16,29,27,45,114,213,1,387,21,0,2,0,22,86620,34437,6945,46630,0
141,3466,712,438,573,51,9,84,763,14,102,71,128,116,199,733,1364,8,11988,666,0,2,0,22,86630,34438,6945,46631,0
55,2824,722,423,573,19,0,135,741,12,172,101,199,184,300,1320,2257,6,15668,870,0,2,1,2,86630,34440,6945,46633,0
18,638,442,244,305,14,16,103,456,11,68,45,75,79,120,452,756,6,4588,254,0,2,0,15,86630,34442,6945,46635,0
18,638,182,102,99,11,40,35,193,3,11,6,11,14,17,42,64,1,97,5,0,2,0,15,86630,34443,6945,46636,0
34,1434,442,244,305,14,16,103,456,11,68,45,75,79,120,452,756,6,4588,254,0,2,6,10,86630,34445,6945,46637,0
314,6847,72,33,56,0,4,12,72,1,1,1,1,2,2,0,2,0,1,0,0,2,3,2,86630,34445,6945,46639,0
314,6847,1454,835,1044,76,110,219,1530,17,275,158,296,292,454,2297,3718,9,34017,1889,1,2,3,2,86640,34446,6945,46640,0
54,640,647,139,84,35,284,233,682,0,0,0,0,0,0,0,0,0,0,0,0,2,0,22,86640,34446,6945,46642,0
2,173,37,13,25,0,6,6,37,1,2,1,2,3,3,2,4,0,2,0,0,2,0,10,86640,34446,6945,46643,0
2,173,133,47,40,1,43,49,134,0,0,0,0,0,0,0,0,0,0,0,0,2,0,10,86640,34446,6945,46644,0
23,615,601,196,481,2,23,85,603,8,63,36,72,71,108,400,664,4,3036,168,0,2,0,5,86640,34446,6945,46645,0
23,615,156,79,106,5,16,28,161,5,14,8,15,19,23,64,97,2,261,14,0,2,0,5,86640,34446,6945,46646,0
106,4531,1289,550,1043,56,32,155,1345,10,167,93,185,177,278,1266,2075,5,11498,638,0,2,2,5,86640,34448,6946,46647,0
170,7525,4293,999,3693,19,54,507,4312,9,155,88,170,164,258,1156,1898,4,9368,520,0,2,1,2,86640,34450,6946,46648,0
170,7525,1482,859,1002,125,135,219,1607,16,219,134,251,235,385,1766,3032,9,27804,1544,1,2,1,2,86650,34451,6946,46649,0
145,5874,1782,648,1425,9,47,279,1791,8,171,97,189,179,286,1292,2140,4,9462,525,0,2,13,14,86650,34452,6947,46650,0
69,3090,1020,354,843,12,15,144,1032,8,134,77,144,142,221,970,1580,4,6792,377,0,2,3,9,86650,34452,6947,46651,0
34,1424,442,244,305,14,16,103,456,11,68,45,75,79,120,452,756,6,4588,254,0,2,1,4,86650,34454,6947,46652,0
48,1651,601,196,481,2,23,85,603,8,63,36,72,71,108,400,664,4,3036,168,0,2,8,31,86650,34454,6947,46653,0
250,5776,4293,999,3693,19,54,507,4312,9,155,88,170,164,258,1156,1898,4,9368,520,0,2,6,4,86650,34456,6947,46655,0
250,5776,1482,859,1002,125,135,219,1607,16,219,134,251,235,385,1766,3032,9,27804,1544,1,2,6,4,86660,34457,6947,46656,0
59,1116,207,111,150,11,0,50,218,5,26,19,36,31,55,133,272,3,943,52,0,2,2,2,86660,34457,6947,46657,1
59,1116,410,198,237,31,55,97,441,11,63,38,72,74,110,414,683,6,4293,238,0,2,2,2,86670,34458,6948,46658,1
236,4863,2,2,2,0,0,0,2,0,0,0,0,0,0,0,0,0,0,0,0,2,1,0,86670,34458,6948,46658,1
236,4863,99,48,90,1,3,5,100,0,0,0,0,0,0,0,0,0,0,0,0,2,1,0,86670,34459,6948,46659,1
236,4863,8,5,5,2,0,1,10,0,0,0,0,0,0,0,0,0,0,0,0,2,1,0,86670,34459,6948,46660,1
236,4863,1217,716,841,84,126,174,1301,14,185,118,215,199,333,1446,2542,8,20687,1149,0,2,1,0,86680,34461,6948,46661,1
236,4863,160,89,115,0,13,31,160,7,15,11,17,22,28,78,124,3,495,27,0,2,1,0,86680,34461,6948,46662,1
236,4863,10,10,9,9,0,0,19,0,0,0,0,0,0,0,0,0,0,0,0,2,1,0,86680,34461,6949,46663,1
236,4863,173,84,99,8,29,36,181,5,12,7,13,17,20,54,81,2,221,12,0,2,1,0,86680,34462,6949,46664,1
236,4863,3,1,1,3,0,0,6,0,0,0,0,0,0,0,0,0,0,0,0,2,1,0,86680,34462,6949,46665,1
250,5782,4293,999,3693,19,54,507,4312,9,155,88,170,164,258,1156,1898,4,9368,520,0,2,7,3,86680,34464,6949,46667,1
250,5782,1482,859,1002,125,135,219,1607,16,219,134,251,235,385,1766,3032,9,27804,1544,1,2,7,3,86690,34465,6949,46668,1
4,178,75,38,59,1,3,12,76,2,4,2,4,6,6,10,15,1,15,0,0,2,0,12,86690,34465,6949,46669,1
170,7527,4293,999,3693,19,54,507,4312,9,155,88,170,164,258,1156,1898,4,9368,520,0,2,11,15,86690,34467,6949,46671,1
170,7527,1482,859,1002,125,135,219,1607,16,219,134,251,235,385,1766,3032,9,27804,1544,1,2,11,15,86700,34468,6949,46672,1
12,226,127,75,83,2,11,30,129,4,14,7,14,18,21,61,87,2,175,9,0,2,1,1,86700,34468,6949,46673,0
12,226,652,304,544,16,6,88,668,6,89,51,101,95,152,591,998,3,3399,188,0,2,1,1,86700,34469,6949,46674,0
12,226,2,2,2,0,0,0,2,0,0,0,0,0,0,0,0,0,0,0,0,2,1,1,86700,34469,6949,46674,0
12,226,8,5,5,0,0,3,8,0,0,0,0,0,0,0,0,0,0,0,0,2,1,1,86700,34469,6949,46675,0
12,226,2,2,2,0,0,0,2,0,0,0,0,0,0,0,0,0,0,0,0,2,1,1,86700,34469,6949,46675,0
12,226,14,8,8,0,0,6,14,0,0,0,0,0,0,0,0,0,0,0,0,2,1,1,86700,34469,6949,46676,0
12,226,6,4,4,0,0,2,6,0,0,0,0,0,0,0,0,0,0,0,0,2,1,1,86700,34469,6949,46677,0
12,226,6,4,4,0,0,2,6,1,2,1,2,3,3,2,4,0,2,0,0,2,1,1,86700,34469,6949,46678,0
12,226,6,4,4,0,0,2,6,0,0,0,0,0,0,0,0,0,0,0,0,2,1,1,86700,34469,6949,46679,0
12,226,7,5,5,0,0,2,7,0,0,0,0,0,0,0,0,0,0,0,0,2,1,1,86700,34469,6949,46680,0
12,226,6,4,4,0,0,2,6,0,0,0,0,0,0,0,0,0,0,0,0,2,1,1,86700,34469,6949,46681,0
12,226,10,6,6,0,0,4,10,0,0,0,0,0,0,0,0,0,0,0,0,2,1,1,86700,34469,6949,46682,0
12,226,1,1,1,0,0,0,1,0,0,0,0,0,0,0,0,0,0,0,0,2,1,1,86700,34469,6949,46682,0
12,226,14,10,10,0,0,4,14,1,1,1,1,2,2,0,2,0,1,0,0,2,1,1,86700,34469,6949,46683,0
12,226,46,26,30,3,0,12,49,3,6,3,6,9,9,20,28,1,42,2,0,2,1,1,86710,34469,6949,46684,0
84,1645,757,253,292,73,244,162,830,13,61,38,67,74,105,409,651,7,4654,258,0,2,3,6,86710,34470,6949,46685,0
37,680,386,256,301,16,9,68,402,4,59,35,69,63,104,355,621,2,1453,80,0,2,1,6,86710,34470,6949,46686,0
37,680,264,131,164,11,41,46,275,6,38,22,40,44,62,214,338,3,1068,59,0,2,1,6,86720,34470,6950,46687,0
12,226,127,75,83,2,11,30,129,4,14,7,14,18,21,61,87,2,175,9,0,2,1,1,86720,34470,6950,46688,0
12,226,652,304,544,16,6,88,668,6,89,51,101,95,152,591,998,3,3399,188,0,2,1,1,86720,34471,6950,46689,0
12,226,2,2,2,0,0,0,2,0,0,0,0,0,0,0,0,0,0,0,0,2,1,1,86720,34471,6950,46689,0
12,226,8,5,5,0,0,3,8,0,0,0,0,0,0,0,0,0,0,0,0,2,1,1,86720,34471,6950,46690,0
12,226,2,2,2,0,0,0,2,0,0,0,0,0,0,0,0,0,0,0,0,2,1,1,86720,34471,6950,46690,0
12,226,14,8,8,0,0,6,14,0,0,0,0,0,0,0,0,0,0,0,0,2,1,1,86720,34471,6950,46691,0
12,226,6,4,4,0,0,2,6,0,0,0,0,0,0,0,0,0,0,0,0,2,1,1,86720,34471,6950,46692,0
12,226,6,4,4,0,0,2,6,1,2,1,2,3,3,2,4,0,2,0,0,2,1,1,86720,34471,6950,46693,0
12,226,6,4,4,0,0,2,6,0,0,0,0,0,0,0,0,0,0,0,0,2,1,1,86720,34471,6950,46694,0
12,226,7,5,5,0,0,2,7,0,0,0,0,0,0,0,0,0,0,0,0,2,1,1,86720,34471,6950,46695,0
12,226,6,4,4,0,0,2,6,0,0,0,0,0,0,0,0,0,0,0,0,2,1,1,86720,34471,6950,46696,0
12,226,10,6,6,0,0,4,10,0,0,0,0,0,0,0,0,0,0,0,0,2,1,1,86720,34471,6950,46697,0
12,226,1,1,1,0,0,0,1,0,0,0,0,0,0,0,0,0,0,0,0,2,1,1,86720,34471,6950,46697,0
12,226,14,10,10,0,0,4,14,1,1,1,1,2,2,0,2,0,1,0,0,2,1,1,86720,34471,6950,46698,0
12,226,46,26,30,3,0,12,49,3,6,3,6,9,9,20,28,1,42,2,0,2,1,1,86730,34471,6950,46699,0
219,4669,182,127,129,0,0,53,182,5,39,21,42,44,63,217,343,2,926,51,0,2,1,1,86730,34471,6951,46700,0
219,4669,1165,710,800,67,119,181,1232,18,243,153,282,261,435,2000,3492,10,36473,2026,1,2,1,1,86740,34471,6952,46701,0
33,1013,256,139,192,9,7,47,265,4,23,12,24,27,36,112,171,2,357,19,0,2,8,1,86740,34472,6952,46702,0
113,2243,463,295,324,28,62,57,491,12,134,82,154,146,236,989,1696,6,11700,650,0,2,1,1,86750,34473,6952,46703,0
1,92,42,7,35,4,0,5,46,1,2,1,2,3,3,2,4,0,2,0,0,2,1,1,86750,34473,6952,46704,0
1,92,11,6,10,0,0,1,11,2,4,2,4,6,6,10,15,1,15,0,0,2,1,1,86750,34473,6952,46705,0
58,1130,207,111,150,11,0,50,218,5,26,19,36,31,55,133,272,3,943,52,0,2,6,0,86750,34473,6952,46706,0
58,1130,410,198,237,31,55,97,441,11,63,38,72,74,110,414,683,6,4293,238,0,2,6,0,86760,34474,6953,46707,0
235,4848,2,2,2,0,0,0,2,0,0,0,0,0,0,0,0,0,0,0,0,2,1,1,86760,34474,6953,46707,0
235,4848,99,48,90,1,3,5,100,0,0,0,0,0,0,0,0,0,0,0,0,2,1,1,86760,34475,6953,46708,0
235,4848,8,5,5,2,0,1,10,0,0,0,0,0,0,0,0,0,0,0,0,2,1,1,86760,34475,6953,46709,0
235,4848,1217,716,841,84,126,174,1301,14,185,118,215,199,333,1446,2542,8,20687,1149,0,2,1,1,86770,34477,6953,46710,0
235,4848,160,89,115,0,13,31,160,7,15,11,17,22,28,78,124,3,495,27,0,2,1,1,86770,34477,6953,46711,0
235,4848,10,10,9,9,0,0,19,0,0,0,0,0,0,0,0,0,0,0,0,2,1,1,86770,34477,6954,46712,0
235,4848,173,84,99,8,29,36,181,5,12,7,13,17,20,54,81,2,221,12,0,2,1,1,86770,34478,6954,46713,0
235,4848,3,1,1,3,0,0,6,0,0,0,0,0,0,0,0,0,0,0,0,2,1,1,86770,34478,6954,46714,0
106,4545,1289,550,1043,56,32,155,1345,10,167,93,185,177,278,1266,2075,5,11498,638,0,2,1,1,86770,34480,6955,46715,0
121,4918,1450,624,1228,12,26,181,1462,14,306,186,354,320,540,2580,4493,8,36391,2021,1,2,2,1,86770,34482,6956,46716,0
102,5285,1457,730,1242,11,6,188,1468,10,292,166,329,302,495,2424,4078,5,22973,1276,1,2,1,2,86770,34484,6956,46717,0
2,48,7,6,5,0,0,2,7,1,1,1,2,2,3,0,3,1,3,0,0,2,1,1,86770,34484,6956,46718,0
219,4669,182,127,129,0,0,53,182,5,39,21,42,44,63,217,343,2,926,51,0,2,1,1,86770,34484,6957,46719,0
219,4669,1165,710,800,67,119,181,1232,18,243,153,282,261,435,2000,3492,10,36473,2026,1,2,1,1,86780,34484,6958,46720,0
33,1013,256,139,192,9,7,47,265,4,23,12,24,27,36,112,171,2,357,19,0,2,8,1,86780,34485,6958,46721,0
25,429,219,78,157,11,5,46,230,3,24,20,34,27,54,114,256,2,545,30,0,2,1,1,86780,34486,6958,46722,1
25,429,108,64,79,9,0,20,117,5,15,11,19,20,30,70,129,3,410,22,0,2,1,1,86780,34486,6958,46723,1
11,631,219,78,157,11,5,46,230,3,24,20,34,27,54,114,256,2,545,30,0,2,53,0,86780,34487,6958,46724,1
25,429,219,78,157,11,5,46,230,3,24,20,34,27,54,114,256,2,545,30,0,2,1,1,86780,34488,6958,46725,0
25,429,108,64,79,9,0,20,117,5,15,11,19,20,30,70,129,3,410,22,0,2,1,1,86780,34488,6958,46726,0
11,631,219,78,157,11,5,46,230,3,24,20,34,27,54,114,256,2,545,30,0,2,53,0,86780,34489,6958,46727,0
1,92,42,7,35,4,0,5,46,1,2,1,2,3,3,2,4,0,2,0,0,2,1,1,86780,34489,6958,46728,0
1,92,11,6,10,0,0,1,11,2,4,2,4,6,6,10,15,1,15,0,0,2,1,1,86780,34489,6958,46729,0
58,1130,207,111,150,11,0,50,218,5,26,19,36,31,55,133,272,3,943,52,0,2,6,0,86780,34489,6958,46730,0
58,1130,410,198,237,31,55,97,441,11,63,38,72,74,110,414,683,6,4293,238,0,2,6,0,86790,34490,6959,46731,0
235,4848,2,2,2,0,0,0,2,0,0,0,0,0,0,0,0,0,0,0,0,2,1,1,86790,34490,6959,46731,0
235,4848,99,48,90,1,3,5,100,0,0,0,0,0,0,0,0,0,0,0,0,2,1,1,86790,34491,6959,46732,0
235,4848,8,5,5,2,0,1,10,0,0,0,0,0,0,0,0,0,0,0,0,2,1,1,86790,34491,6959,46733,0
235,4848,1217,716,841,84,126,174,1301,14,185,118,215,199,333,1446,2542,8,20687,1149,0,2,1,1,86800,34493,6959,46734,0
235,4848,160,89,115,0,13,31,160,7,15,11,17,22,28,78,124,3,495,27,0,2,1,1,86800,34493,6959,46735,0
235,4848,10,10,9,9,0,0,19,0,0,0,0,0,0,0,0,0,0,0,0,2,1,1,86800,34493,6960,46736,0
235,4848,173,84,99,8,29,36,181,5,12,7,13,17,20,54,81,2,221,12,0,2,1,1,86800,34494,6960,46737,0
235,4848,3,1,1,3,0,0,6,0,0,0,0,0,0,0,0,0,0,0,0,2,1,1,86800,34494,6960,46738,0
113,2243,463,295,324,28,62,57,491,12,134,82,154,146,236,989,1696,6,11700,650,0,2,1,1,86810,34495,6960,46739,0
106,4545,1289,550,1043,56,32,155,1345,10,167,93,185,177,278,1266,2075,5,11498,638,0,2,1,1,86810,34497,6961,46740,0
121,4918,1450,624,1228,12,26,181,1462,14,306,186,354,320,540,2580,4493,8,36391,2021,1,2,2,1,86810,34499,6962,46741,0
102,5285,1457,730,1242,11,6,188,1468,10,292,166,329,302,495,2424,4078,5,22973,1276,1,2,1,2,86810,34501,6962,46742,0
2,48,7,6,5,0,0,2,7,1,1,1,2,2,3,0,3,1,3,0,0,2,1,1,86810,34501,6962,46743,0
12,226,127,75,83,2,11,30,129,4,14,7,14,18,21,61,87,2,175,9,0,2,1,1,86810,34501,6962,46744,0
12,226,652,304,544,16,6,88,668,6,89,51,101,95,152,591,998,3,3399,188,0,2,1,1,86810,34502,6962,46745,0
12,226,2,2,2,0,0,0,2,0,0,0,0,0,0,0,0,0,0,0,0,2,1,1,86810,34502,6962,46745,0
12,226,8,5,5,0,0,3,8,0,0,0,0,0,0,0,0,0,0,0,0,2,1,1,86810,34502,6962,46746,0
12,226,2,2,2,0,0,0,2,0,0,0,0,0,0,0,0,0,0,0,0,2,1,1,86810,34502,6962,46746,0
12,226,14,8,8,0,0,6,14,0,0,0,0,0,0,0,0,0,0,0,0,2,1,1,86810,34502,6962,46747,0
12,226,6,4,4,0,0,2,6,0,0,0,0,0,0,0,0,0,0,0,0,2,1,1,86810,34502,6962,46748,0
12,226,6,4,4,0,0,2,6,1,2,1,2,3,3,2,4,0,2,0,0,2,1,1,86810,34502,6962,46749,0
12,226,6,4,4,0,0,2,6,0,0,0,0,0,0,0,0,0,0,0,0,2,1,1,86810,34502,6962,46750,0
12,226,7,5,5,0,0,2,7,0,0,0,0,0,0,0,0,0,0,0,0,2,1,1,86810,34502,6962,46751,0
12,226,6,4,4,0,0,2,6,0,0,0,0,0,0,0,0,0,0,0,0,2,1,1,86810,34502,6962,46752,0
12,226,10,6,6,0,0,4,10,0,0,0,0,0,0,0,0,0,0,0,0,2,1,1,86810,34502,6962,46753,0
12,226,1,1,1,0,0,0,1,0,0,0,0,0,0,0,0,0,0,0,0,2,1,1,86810,34502,6962,46753,0
12,226,14,10,10,0,0,4,14,1,1,1,1,2,2,0,2,0,1,0,0,2,1,1,86810,34502,6962,46754,0
12,226,46,26,30,3,0,12,49,3,6,3,6,9,9,20,28,1,42,2,0,2,1,1,86820,34502,6962,46755,0
219,4669,182,127,129,0,0,53,182,5,39,21,42,44,63,217,343,2,926,51,0,2,1,1,86820,34502,6963,46756,0
219,4669,1165,710,800,67,119,181,1232,18,243,153,282,261,435,2000,3492,10,36473,2026,1,2,1,1,86830,34502,6964,46757,0
25,429,219,78,157,11,5,46,230,3,24,20,34,27,54,114,256,2,545,30,0,2,1,1,86830,34503,6964,46758,0
25,429,108,64,79,9,0,20,117,5,15,11,19,20,30,70,129,3,410,22,0,2,1,1,86830,34503,6964,46759,0
33,1013,256,139,192,9,7,47,265,4,23,12,24,27,36,112,171,2,357,19,0,2,8,1,86830,34504,6964,46760,0
11,631,219,78,157,11,5,46,230,3,24,20,34,27,54,114,256,2,545,30,0,2,53,0,86830,34505,6964,46761,0
25,429,219,78,157,11,5,46,230,3,24,20,34,27,54,114,256,2,545,30,0,2,0,1,86830,34506,6964,46762,0
25,429,108,64,79,9,0,20,117,5,15,11,19,20,30,70,129,3,410,22,0,2,0,1,86830,34506,6964,46763,0
25,429,219,78,157,11,5,46,230,3,24,20,34,27,54,114,256,2,545,30,0,2,0,1,86830,34507,6964,46764,0
25,429,108,64,79,9,0,20,117,5,15,11,19,20,30,70,129,3,410,22,0,2,0,1,86830,34507,6964,46765,0
117,3137,1523,757,1297,19,12,193,1542,12,193,117,230,205,347,1508,2664,7,19053,1058,0,2,10,11,86840,34509,6964,46766,0
117,3137,701,378,504,33,58,109,734,13,110,68,126,123,194,794,1346,7,10027,557,0,2,10,11,86840,34510,6965,46767,0
111,5221,1523,757,1297,19,12,193,1542,12,193,117,230,205,347,1508,2664,7,19053,1058,0,2,27,3,86850,34512,6965,46768,0
14,836,75,38,59,1,3,12,76,2,4,2,4,6,6,10,15,1,15,0,0,2,1,1,86850,34512,6965,46769,0
235,4868,2,2,2,0,0,0,2,0,0,0,0,0,0,0,0,0,0,0,0,2,20,6,86850,34512,6965,46769,0
235,4868,99,48,90,1,3,5,100,0,0,0,0,0,0,0,0,0,0,0,0,2,20,6,86850,34513,6965,46770,0
235,4868,8,5,5,2,0,1,10,0,0,0,0,0,0,0,0,0,0,0,0,2,20,6,86850,34513,6965,46771,0
235,4868,1217,716,841,84,126,174,1301,14,185,118,215,199,333,1446,2542,8,20687,1149,0,2,20,6,86860,34515,6965,46772,0
235,4868,160,89,115,0,13,31,160,7,15,11,17,22,28,78,124,3,495,27,0,2,20,6,86860,34515,6965,46773,0
235,4868,10,10,9,9,0,0,19,0,0,0,0,0,0,0,0,0,0,0,0,2,20,6,86860,34515,6966,46774,0
235,4868,173,84,99,8,29,36,181,5,12,7,13,17,20,54,81,2,221,12,0,2,20,6,86860,34516,6966,46775,0
235,4868,3,1,1,3,0,0,6,0,0,0,0,0,0,0,0,0,0,0,0,2,20,6,86860,34516,6966,46776,0
103,5394,1457,730,1242,11,6,188,1468,10,292,166,329,302,495,2424,4078,5,22973,1276,1,2,22,0,86860,34518,6966,46777,0
237,4975,2,2,2,0,0,0,2,0,0,0,0,0,0,0,0,0,0,0,0,2,38,12,86860,34518,6966,46777,0
237,4975,99,48,90,1,3,5,100,0,0,0,0,0,0,0,0,0,0,0,0,2,38,12,86860,34519,6966,46778,0
237,4975,8,5,5,2,0,1,10,0,0,0,0,0,0,0,0,0,0,0,0,2,38,12,86860,34519,6966,46779,0
237,4975,1217,716,841,84,126,174,1301,14,185,118,215,199,333,1446,2542,8,20687,1149,0,2,38,12,86870,34521,6966,46780,0
237,4975,160,89,115,0,13,31,160,7,15,11,17,22,28,78,124,3,495,27,0,2,38,12,86870,34521,6966,46781,0
237,4975,10,10,9,9,0,0,19,0,0,0,0,0,0,0,0,0,0,0,0,2,38,12,86870,34521,6967,46782,0
237,4975,173,84,99,8,29,36,181,5,12,7,13,17,20,54,81,2,221,12,0,2,38,12,86870,34522,6967,46783,0
237,4975,3,1,1,3,0,0,6,0,0,0,0,0,0,0,0,0,0,0,0,2,38,12,86870,34522,6967,46784,0
103,5415,1457,730,1242,11,6,188,1468,10,292,166,329,302,495,2424,4078,5,22973,1276,1,2,4,2,86870,34524,6967,46785,0
237,4975,2,2,2,0,0,0,2,0,0,0,0,0,0,0,0,0,0,0,0,2,9,1,86870,34524,6967,46785,0
237,4975,99,48,90,1,3,5,100,0,0,0,0,0,0,0,0,0,0,0,0,2,9,1,86870,34525,6967,46786,0
237,4975,8,5,5,2,0,1,10,0,0,0,0,0,0,0,0,0,0,0,0,2,9,1,86870,34525,6967,46787,0
237,4975,1217,716,841,84,126,174,1301,14,185,118,215,199,333,1446,2542,8,20687,1149,0,2,9,1,86880,34527,6967,46788,0
237,4975,160,89,115,0,13,31,160,7,15,11,17,22,28,78,124,3,495,27,0,2,9,1,86880,34527,6967,46789,0
237,4975,10,10,9,9,0,0,19,0,0,0,0,0,0,0,0,0,0,0,0,2,9,1,86880,34527,6968,46790,0
237,4975,173,84,99,8,29,36,181,5,12,7,13,17,20,54,81,2,221,12,0,2,9,1,86880,34528,6968,46791,0
237,4975,3,1,1,3,0,0,6,0,0,0,0,0,0,0,0,0,0,0,0,2,9,1,86880,34528,6968,46792,0
103,5418,1457,730,1242,11,6,188,1468,10,292,166,329,302,495,2424,4078,5,22973,1276,1,2,2,2,86880,34530,6968,46793,0
1,302,382,65,130,157,2,92,539,4,10,5,10,14,15,41,57,2,114,6,0,2,1,2,86880,34531,6969,46794,0
1,313,382,65,130,157,2,92,539,4,10,5,10,14,15,41,57,2,114,6,0,2,2,2,86880,34532,6970,46795,0
101,2578,1455,414,1257,16,76,112,1471,5,41,23,46,46,69,231,381,2,1069,59,0,2,91,24,86880,34533,6970,46796,1
101,2578,669,365,481,22,61,110,691,15,103,63,122,118,185,747,1273,8,11311,628,0,2,91,24,86890,34533,6971,46797,1
81,3701,1455,414,1257,16,76,112,1471,5,41,23,46,46,69,231,381,2,1069,59,0,2,144,0,86890,34534,6971,46798,1
12,226,127,75,83,2,11,30,129,4,14,7,14,18,21,61,87,2,175,9,0,2,1,1,86890,34534,6971,46799,0
12,226,652,304,544,16,6,88,668,6,89,51,101,95,152,591,998,3,3399,188,0,2,1,1,86890,34535,6971,46800,0
12,226,2,2,2,0,0,0,2,0,0,0,0,0,0,0,0,0,0,0,0,2,1,1,86890,34535,6971,46800,0
12,226,8,5,5,0,0,3,8,0,0,0,0,0,0,0,0,0,0,0,0,2,1,1,86890,34535,6971,46801,0
12,226,2,2,2,0,0,0,2,0,0,0,0,0,0,0,0,0,0,0,0,2,1,1,86890,34535,6971,46801,0
12,226,14,8,8,0,0,6,14,0,0,0,0,0,0,0,0,0,0,0,0,2,1,1,86890,34535,6971,46802,0
12,226,6,4,4,0,0,2,6,0,0,0,0,0,0,0,0,0,0,0,0,2,1,1,86890,34535,6971,46803,0
12,226,6,4,4,0,0,2,6,1,2,1,2,3,3,2,4,0,2,0,0,2,1,1,86890,34535,6971,46804,0
12,226,6,4,4,0,0,2,6,0,0,0,0,0,0,0,0,0,0,0,0,2,1,1,86890,34535,6971,46805,0
12,226,7,5,5,0,0,2,7,0,0,0,0,0,0,0,0,0,0,0,0,2,1,1,86890,34535,6971,46806,0
12,226,6,4,4,0,0,2,6,0,0,0,0,0,0,0,0,0,0,0,0,2,1,1,86890,34535,6971,46807,0
12,226,10,6,6,0,0,4,10,0,0,0,0,0,0,0,0,0,0,0,0,2,1,1,86890,34535,6971,46808,0
12,226,1,1,1,0,0,0,1,0,0,0,0,0,0,0,0,0,0,0,0,2,1,1,86890,34535,6971,46808,0
12,226,14,10,10,0,0,4,14,1,1,1,1,2,2,0,2,0,1,0,0,2,1,1,86890,34535,6971,46809,0
12,226,46,26,30,3,0,12,49,3,6,3,6,9,9,20,28,1,42,2,0,2,1,1,86900,34535,6971,46810,0
219,4669,182,127,129,0,0,53,182,5,39,21,42,44,63,217,343,2,926,51,0,2,1,1,86900,34535,6972,46811,0
219,4669,1165,710,800,67,119,181,1232,18,243,153,282,261,435,2000,3492,10,36473,2026,1,2,1,1,86910,34535,6973,46812,0
25,429,219,78,157,11,5,46,230,3,24,20,34,27,54,114,256,2,545,30,0,2,1,1,86910,34536,6973,46813,0
25,429,108,64,79,9,0,20,117,5,15,11,19,20,30,70,129,3,410,22,0,2,1,1,86910,34536,6973,46814,0
33,1013,256,139,192,9,7,47,265,4,23,12,24,27,36,112,171,2,357,19,0,2,8,1,86910,34537,6973,46815,0
11,631,219,78,157,11,5,46,230,3,24,20,34,27,54,114,256,2,545,30,0,2,53,0,86910,34538,6973,46816,0
1,300,382,65,130,157,2,92,539,4,10,5,10,14,15,41,57,2,114,6,0,2,0,1,86910,34539,6974,46817,0
14,836,75,38,59,1,3,12,76,2,4,2,4,6,6,10,15,1,15,0,0,2,1,1,86910,34539,6974,46818,0
1,300,382,65,130,157,2,92,539,4,10,5,10,14,15,41,57,2,114,6,0,2,1,3,86910,34540,6975,46819,0
1,300,382,65,130,157,2,92,539,4,10,5,10,14,15,41,57,2,114,6,0,2,2,2,86910,34541,6976,46820,0
11,231,19,8,11,5,0,4,24,2,5,3,6,7,9,13,25,1,30,1,0,2,2,1,86910,34541,6976,46822,1
11,231,102,59,69,5,3,24,107,6,22,15,28,28,43,113,206,3,789,43,0,2,2,1,86910,34541,6976,46823,1
11,231,106,40,36,3,49,17,109,8,17,13,23,25,36,93,167,5,904,50,0,2,2,1,86910,34541,6976,46824,1
219,4648,182,127,129,0,0,53,182,5,39,21,42,44,63,217,343,2,926,51,0,2,7,6,86910,34541,6977,46825,1
219,4648,1165,710,800,67,119,181,1232,18,243,153,282,261,435,2000,3492,10,36473,2026,1,2,7,6,86920,34541,6978,46826,1
67,1551,773,419,590,28,0,166,801,10,204,113,217,214,330,1598,2554,5,13587,754,0,2,2,1,86920,34541,6979,46827,1
67,1551,421,273,302,44,34,57,465,17,81,59,107,98,166,583,1098,11,12329,684,0,2,2,1,86920,34541,6980,46828,1
180,5401,1660,832,1314,41,38,274,1701,20,312,209,395,332,604,2671,5058,12,64042,3557,1,2,15,10,86920,34543,6981,46830,1
180,5401,1057,646,719,113,100,145,1170,18,215,134,248,233,382,1740,3004,10,31186,1732,1,2,15,10,86930,34544,6982,46831,1
160,3425,1513,682,1277,25,13,200,1538,11,199,116,219,210,335,1557,2584,6,15641,868,0,2,8,4,86930,34546,6982,46832,1
160,3425,819,519,539,24,98,155,843,15,96,57,106,111,163,690,1107,8,9171,509,0,2,8,4,86940,34548,6982,46833,1
57,1484,339,213,244,17,9,65,356,10,42,26,48,52,74,259,421,5,2410,133,0,2,1,1,86950,34548,6982,46834,1
251,5824,4293,999,3693,19,54,507,4312,9,155,88,170,164,258,1156,1898,4,9368,520,0,2,9,3,86950,34550,6982,46835,1
251,5824,1482,859,1002,125,135,219,1607,16,219,134,251,235,385,1766,3032,9,27804,1544,1,2,9,3,86960,34551,6982,46836,1
24,600,2,2,2,0,0,0,2,0,0,0,0,0,0,0,0,0,0,0,0,2,2,1,86960,34551,6982,46836,1
24,600,99,48,90,1,3,5,100,0,0,0,0,0,0,0,0,0,0,0,0,2,2,1,86960,34552,6982,46837,1
24,600,8,5,5,2,0,1,10,0,0,0,0,0,0,0,0,0,0,0,0,2,2,1,86960,34552,6982,46838,1
24,600,1217,716,841,84,126,174,1301,14,185,118,215,199,333,1446,2542,8,20687,1149,0,2,2,1,86970,34554,6982,46839,1
24,600,160,89,115,0,13,31,160,7,15,11,17,22,28,78,124,3,495,27,0,2,2,1,86970,34554,6982,46840,1
24,600,10,10,9,9,0,0,19,0,0,0,0,0,0,0,0,0,0,0,0,2,2,1,86970,34554,6983,46841,1
24,600,173,84,99,8,29,36,181,5,12,7,13,17,20,54,81,2,221,12,0,2,2,1,86970,34555,6983,46842,1
24,600,3,1,1,3,0,0,6,0,0,0,0,0,0,0,0,0,0,0,0,2,2,1,86970,34555,6983,46843,1
71,1566,402,202,227,24,74,80,426,12,52,33,61,64,94,339,564,7,3969,220,0,2,2,1,86970,34556,6983,46844,1
76,1623,53,23,39,0,0,13,53,2,8,4,8,10,12,26,39,1,39,2,0,2,2,1,86970,34556,6983,46845,1
76,1623,515,298,307,33,80,99,548,12,63,44,77,75,121,419,753,7,5527,307,0,2,2,1,86980,34556,6983,46846,1
17,467,205,80,86,16,53,53,221,7,18,10,19,25,29,94,134,3,497,27,0,2,8,4,86990,34556,6984,46847,1
88,1786,757,253,292,73,244,162,830,13,61,38,67,74,105,409,651,7,4654,258,0,2,10,5,86990,34557,6984,46848,1
67,1751,466,257,367,18,25,50,484,7,126,86,171,133,257,898,1813,4,8612,478,0,2,2,1,86990,34557,6984,46849,1
67,1751,507,281,342,29,59,88,536,10,53,29,57,63,86,336,514,5,2764,153,0,2,2,1,86990,34557,6984,46850,1
19,699,442,244,305,14,16,103,456,11,68,45,75,79,120,452,756,6,4588,254,0,2,4,1,86990,34559,6984,46851,1
19,699,182,102,99,11,40,35,193,3,11,6,11,14,17,42,64,1,97,5,0,2,4,1,86990,34560,6984,46852,1
150,7150,1392,870,1177,35,17,170,1427,14,494,280,531,508,811,4473,7289,7,54850,3047,2,2,2,1,86990,34563,6985,46853,1
32,968,256,139,192,9,7,47,265,4,23,12,24,27,36,112,171,2,357,19,0,2,2,1,86990,34564,6985,46854,1
20,449,207,111,150,11,0,50,218,5,26,19,36,31,55,133,272,3,943,52,0,2,2,1,86990,34564,6985,46855,1
75,3937,1293,570,1093,25,15,163,1318,10,195,123,241,205,364,1516,2795,6,17273,959,0,2,2,1,87000,34566,6985,46856,1
11,231,19,8,11,5,0,4,24,2,5,3,6,7,9,13,25,1,30,1,0,2,2,1,87000,34566,6985,46858,0
11,231,102,59,69,5,3,24,107,6,22,15,28,28,43,113,206,3,789,43,0,2,2,1,87000,34566,6985,46859,0
11,231,106,40,36,3,49,17,109,8,17,13,23,25,36,93,167,5,904,50,0,2,2,1,87000,34566,6985,46860,0
219,4651,182,127,129,0,0,53,182,5,39,21,42,44,63,217,343,2,926,51,0,2,7,6,87000,34566,6986,46861,0
219,4651,1165,710,800,67,119,181,1232,18,243,153,282,261,435,2000,3492,10,36473,2026,1,2,7,6,87010,34566,6987,46862,0
67,1551,773,419,590,28,0,166,801,10,204,113,217,214,330,1598,2554,5,13587,754,0,2,2,1,87010,34566,6988,46863,0
67,1551,421,273,302,44,34,57,465,17,81,59,107,98,166,583,1098,11,12329,684,0,2,2,1,87010,34566,6989,46864,0
180,5401,1660,832,1314,41,38,274,1701,20,312,209,395,332,604,2671,5058,12,64042,3557,1,2,15,10,87010,34568,6990,46866,0
180,5401,1057,646,719,113,100,145,1170,18,215,134,248,233,382,1740,3004,10,31186,1732,1,2,15,10,87020,34569,6991,46867,0
160,3425,1513,682,1277,25,13,200,1538,11,199,116,219,210,335,1557,2584,6,15641,868,0,2,8,4,87020,34571,6991,46868,0
160,3425,819,519,539,24,98,155,843,15,96,57,106,111,163,690,1107,8,9171,509,0,2,8,4,87030,34573,6991,46869,0
57,1484,339,213,244,17,9,65,356,10,42,26,48,52,74,259,421,5,2410,133,0,2,1,1,87040,34573,6991,46870,0
251,5824,4293,999,3693,19,54,507,4312,9,155,88,170,164,258,1156,1898,4,9368,520,0,2,9,3,87040,34575,6991,46871,0
251,5824,1482,859,1002,125,135,219,1607,16,219,134,251,235,385,1766,3032,9,27804,1544,1,2,9,3,87050,34576,6991,46872,0
24,600,2,2,2,0,0,0,2,0,0,0,0,0,0,0,0,0,0,0,0,2,2,1,87050,34576,6991,46872,0
24,600,99,48,90,1,3,5,100,0,0,0,0,0,0,0,0,0,0,0,0,2,2,1,87050,34577,6991,46873,0
24,600,8,5,5,2,0,1,10,0,0,0,0,0,0,0,0,0,0,0,0,2,2,1,87050,34577,6991,46874,0
24,600,1217,716,841,84,126,174,1301,14,185,118,215,199,333,1446,2542,8,20687,1149,0,2,2,1,87060,34579,6991,46875,0
24,600,160,89,115,0,13,31,160,7,15,11,17,22,28,78,124,3,495,27,0,2,2,1,87060,34579,6991,46876,0
24,600,10,10,9,9,0,0,19,0,0,0,0,0,0,0,0,0,0,0,0,2,2,1,87060,34579,6992,46877,0
24,600,173,84,99,8,29,36,181,5,12,7,13,17,20,54,81,2,221,12,0,2,2,1,87060,34580,6992,46878,0
24,600,3,1,1,3,0,0,6,0,0,0,0,0,0,0,0,0,0,0,0,2,2,1,87060,34580,6992,46879,0
71,1566,402,202,227,24,74,80,426,12,52,33,61,64,94,339,564,7,3969,220,0,2,2,1,87060,34581,6992,46880,0
76,1623,53,23,39,0,0,13,53,2,8,4,8,10,12,26,39,1,39,2,0,2,2,1,87060,34581,6992,46881,0
76,1623,515,298,307,33,80,99,548,12,63,44,77,75,121,419,753,7,5527,307,0,2,2,1,87070,34581,6992,46882,0
17,467,205,80,86,16,53,53,221,7,18,10,19,25,29,94,134,3,497,27,0,2,8,4,87080,34581,6993,46883,0
88,1786,757,253,292,73,244,162,830,13,61,38,67,74,105,409,651,7,4654,258,0,2,10,5,87080,34582,6993,46884,0
67,1751,466,257,367,18,25,50,484,7,126,86,171,133,257,898,1813,4,8612,478,0,2,2,1,87080,34582,6993,46885,0
67,1751,507,281,342,29,59,88,536,10,53,29,57,63,86,336,514,5,2764,153,0,2,2,1,87080,34582,6993,46886,0
19,699,442,244,305,14,16,103,456,11,68,45,75,79,120,452,756,6,4588,254,0,2,4,1,87080,34584,6993,46887,0
19,699,182,102,99,11,40,35,193,3,11,6,11,14,17,42,64,1,97,5,0,2,4,1,87080,34585,6993,46888,0
150,7150,1392,870,1177,35,17,170,1427,14,494,280,531,508,811,4473,7289,7,54850,3047,2,2,2,1,87080,34588,6994,46889,0
33,1013,256,139,192,9,7,47,265,4,23,12,24,27,36,112,171,2,357,19,0,2,2,1,87080,34589,6994,46890,0
20,449,207,111,150,11,0,50,218,5,26,19,36,31,55,133,272,3,943,52,0,2,2,1,87080,34589,6994,46891,0
75,3937,1293,570,1093,25,15,163,1318,10,195,123,241,205,364,1516,2795,6,17273,959,0,2,2,1,87090,34591,6994,46892,0
11,231,19,8,11,5,0,4,24,2,5,3,6,7,9,13,25,1,30,1,0,2,2,1,87090,34591,6994,46894,0
11,231,102,59,69,5,3,24,107,6,22,15,28,28,43,113,206,3,789,43,0,2,2,1,87090,34591,6994,46895,0
11,231,106,40,36,3,49,17,109,8,17,13,23,25,36,93,167,5,904,50,0,2,2,1,87090,34591,6994,46896,0
219,4651,182,127,129,0,0,53,182,5,39,21,42,44,63,217,343,2,926,51,0,2,7,6,87090,34591,6995,46897,0
219,4651,1165,710,800,67,119,181,1232,18,243,153,282,261,435,2000,3492,10,36473,2026,1,2,7,6,87100,34591,6996,46898,0
67,1551,773,419,590,28,0,166,801,10,204,113,217,214,330,1598,2554,5,13587,754,0,2,2,1,87100,34591,6997,46899,0
67,1551,421,273,302,44,34,57,465,17,81,59,107,98,166,583,1098,11,12329,684,0,2,2,1,87100,34591,6998,46900,0
180,5401,1660,832,1314,41,38,274,1701,20,312,209,395,332,604,2671,5058,12,64042,3557,1,2,15,10,87100,34593,6999,46902,0
180,5401,1057,646,719,113,100,145,1170,18,215,134,248,233,382,1740,3004,10,31186,1732,1,2,15,10,87110,34594,7000,46903,0
160,3425,1513,682,1277,25,13,200,1538,11,199,116,219,210,335,1557,2584,6,15641,868,0,2,8,4,87110,34596,7000,46904,0
160,3425,819,519,539,24,98,155,843,15,96,57,106,111,163,690,1107,8,9171,509,0,2,8,4,87120,34598,7000,46905,0
57,1484,339,213,244,17,9,65,356,10,42,26,48,52,74,259,421,5,2410,133,0,2,1,1,87130,34598,7000,46906,0
251,5824,4293,999,3693,19,54,507,4312,9,155,88,170,164,258,1156,1898,4,9368,520,0,2,9,3,87130,34600,7000,46907,0
251,5824,1482,859,1002,125,135,219,1607,16,219,134,251,235,385,1766,3032,9,27804,1544,1,2,9,3,87140,34601,7000,46908,0
24,600,2,2,2,0,0,0,2,0,0,0,0,0,0,0,0,0,0,0,0,2,2,1,87140,34601,7000,46908,0
24,600,99,48,90,1,3,5,100,0,0,0,0,0,0,0,0,0,0,0,0,2,2,1,87140,34602,7000,46909,0
24,600,8,5,5,2,0,1,10,0,0,0,0,0,0,0,0,0,0,0,0,2,2,1,87140,34602,7000,46910,0
24,600,1217,716,841,84,126,174,1301,14,185,118,215,199,333,1446,2542,8,20687,1149,0,2,2,1,87150,34604,7000,46911,0
24,600,160,89,115,0,13,31,160,7,15,11,17,22,28,78,124,3,495,27,0,2,2,1,87150,34604,7000,46912,0
24,600,10,10,9,9,0,0,19,0,0,0,0,0,0,0,0,0,0,0,0,2,2,1,87150,34604,7001,46913,0
24,600,173,84,99,8,29,36,181,5,12,7,13,17,20,54,81,2,221,12,0,2,2,1,87150,34605,7001,46914,0
24,600,3,1,1,3,0,0,6,0,0,0,0,0,0,0,0,0,0,0,0,2,2,1,87150,34605,7001,46915,0
71,1566,402,202,227,24,74,80,426,12,52,33,61,64,94,339,564,7,3969,220,0,2,2,1,87150,34606,7001,46916,0
76,1623,53,23,39,0,0,13,53,2,8,4,8,10,12,26,39,1,39,2,0,2,2,1,87150,34606,7001,46917,0
76,1623,515,298,307,33,80,99,548,12,63,44,77,75,121,419,753,7,5527,307,0,2,2,1,87160,34606,7001,46918,0
17,467,205,80,86,16,53,53,221,7,18,10,19,25,29,94,134,3,497,27,0,2,8,4,87170,34606,7002,46919,0
88,1786,757,253,292,73,244,162,830,13,61,38,67,74,105,409,651,7,4654,258,0,2,10,5,87170,34607,7002,46920,0
67,1751,466,257,367,18,25,50,484,7,126,86,171,133,257,898,1813,4,8612,478,0,2,2,1,87170,34607,7002,46921,0
67,1751,507,281,342,29,59,88,536,10,53,29,57,63,86,336,514,5,2764,153,0,2,2,1,87170,34607,7002,46922,0
19,699,442,244,305,14,16,103,456,11,68,45,75,79,120,452,756,6,4588,254,0,2,4,1,87170,34609,7002,46923,0
19,699,182,102,99,11,40,35,193,3,11,6,11,14,17,42,64,1,97,5,0,2,4,1,87170,34610,7002,46924,0
150,7150,1392,870,1177,35,17,170,1427,14,494,280,531,508,811,4473,7289,7,54850,3047,2,2,2,1,87170,34613,7003,46925,0
33,1013,256,139,192,9,7,47,265,4,23,12,24,27,36,112,171,2,357,19,0,2,2,1,87170,34614,7003,46926,0
20,449,207,111,150,11,0,50,218,5,26,19,36,31,55,133,272,3,943,52,0,2,2,1,87170,34614,7003,46927,0
75,3937,1293,570,1093,25,15,163,1318,10,195,123,241,205,364,1516,2795,6,17273,959,0,2,2,1,87180,34616,7003,46928,0
18,486,205,80,86,16,53,53,221,7,18,10,19,25,29,94,134,3,497,27,0,2,7,4,87190,34616,7004,46929,1
87,3393,1043,504,840,53,9,147,1096,9,180,112,198,189,310,1377,2344,4,11604,644,0,2,16,0,87190,34618,7004,46930,1
79,3071,1178,367,1042,6,15,115,1184,9,94,51,95,103,146,644,976,4,4439,246,0,2,2,1,87190,34618,7004,46931,1
59,1137,207,111,150,11,0,50,218,5,26,19,36,31,55,133,272,3,943,52,0,2,2,2,87190,34618,7004,46932,0
59,1137,410,198,237,31,55,97,441,11,63,38,72,74,110,414,683,6,4293,238,0,2,2,2,87200,34619,7005,46933,0
236,4867,2,2,2,0,0,0,2,0,0,0,0,0,0,0,0,0,0,0,0,2,15,10,87200,34619,7005,46933,0
236,4867,99,48,90,1,3,5,100,0,0,0,0,0,0,0,0,0,0,0,0,2,15,10,87200,34620,7005,46934,0
236,4867,8,5,5,2,0,1,10,0,0,0,0,0,0,0,0,0,0,0,0,2,15,10,87200,34620,7005,46935,0
236,4867,1217,716,841,84,126,174,1301,14,185,118,215,199,333,1446,2542,8,20687,1149,0,2,15,10,87210,34622,7005,46936,0
236,4867,160,89,115,0,13,31,160,7,15,11,17,22,28,78,124,3,495,27,0,2,15,10,87210,34622,7005,46937,0
236,4867,10,10,9,9,0,0,19,0,0,0,0,0,0,0,0,0,0,0,0,2,15,10,87210,34622,7006,46938,0
236,4867,173,84,99,8,29,36,181,5,12,7,13,17,20,54,81,2,221,12,0,2,15,10,87210,34623,7006,46939,0
236,4867,3,1,1,3,0,0,6,0,0,0,0,0,0,0,0,0,0,0,0,2,15,10,87210,34623,7006,46940,0
55,761,167,116,138,4,5,22,171,8,48,30,56,56,86,292,499,4,2330,129,0,2,3,4,87210,34623,7006,46941,0
250,5797,4293,999,3693,19,54,507,4312,9,155,88,170,164,258,1156,1898,4,9368,520,0,2,13,14,87210,34625,7006,46943,0
250,5797,1482,859,1002,125,135,219,1607,16,219,134,251,235,385,1766,3032,9,27804,1544,1,2,13,14,87220,34626,7006,46944,0
54,640,647,139,84,35,284,233,682,0,0,0,0,0,0,0,0,0,0,0,0,2,0,22,87220,34626,7006,46945,0
141,3466,77,34,69,0,0,8,77,3,24,16,29,27,45,114,213,1,387,21,0,2,0,22,87220,34626,7006,46946,0
141,3466,712,438,573,51,9,84,763,14,102,71,128,116,199,733,1364,8,11988,666,0,2,0,22,87230,34627,7006,46947,0
70,1522,402,202,227,24,74,80,426,12,52,33,61,64,94,339,564,7,3969,220,0,2,6,14,87230,34628,7006,46948,0
314,6847,72,33,56,0,4,12,72,1,1,1,1,2,2,0,2,0,1,0,0,2,3,2,87230,34628,7006,46949,0
314,6847,1454,835,1044,76,110,219,1530,17,275,158,296,292,454,2297,3718,9,34017,1889,1,2,3,2,87240,34629,7006,46950,0
84,1649,757,253,292,73,244,162,830,13,61,38,67,74,105,409,651,7,4654,258,0,2,8,32,87240,34630,7006,46951,0
37,680,386,256,301,16,9,68,402,4,59,35,69,63,104,355,621,2,1453,80,0,2,6,22,87240,34630,7006,46952,0
37,680,264,131,164,11,41,46,275,6,38,22,40,44,62,214,338,3,1068,59,0,2,6,22,87250,34630,7007,46953,0
18,638,442,244,305,14,16,103,456,11,68,45,75,79,120,452,756,6,4588,254,0,2,0,15,87250,34632,7007,46954,0
18,638,182,102,99,11,40,35,193,3,11,6,11,14,17,42,64,1,97,5,0,2,0,15,87250,34633,7007,46955,0
2,173,37,13,25,0,6,6,37,1,2,1,2,3,3,2,4,0,2,0,0,2,0,10,87250,34633,7007,46956,0
2,173,133,47,40,1,43,49,134,0,0,0,0,0,0,0,0,0,0,0,0,2,0,10,87250,34633,7007,46957,0
23,615,601,196,481,2,23,85,603,8,63,36,72,71,108,400,664,4,3036,168,0,2,0,5,87250,34633,7007,46958,0
23,615,156,79,106,5,16,28,161,5,14,8,15,19,23,64,97,2,261,14,0,2,0,5,87250,34633,7007,46959,0
106,4535,1289,550,1043,56,32,155,1345,10,167,93,185,177,278,1266,2075,5,11498,638,0,2,2,5,87250,34635,7008,46960,0
4,178,75,38,59,1,3,12,76,2,4,2,4,6,6,10,15,1,15,0,0,2,0,173,87250,34635,7008,46961,0
170,7527,4293,999,3693,19,54,507,4312,9,155,88,170,164,258,1156,1898,4,9368,520,0,2,28,47,87250,34637,7008,46963,0
170,7527,1482,859,1002,125,135,219,1607,16,219,134,251,235,385,1766,3032,9,27804,1544,1,2,28,47,87260,34638,7008,46964,0
145,5874,1782,648,1425,9,47,279,1791,8,171,97,189,179,286,1292,2140,4,9462,525,0,2,13,14,87260,34639,7009,46965,0
29,865,256,139,192,9,7,47,265,4,23,12,24,27,36,112,171,2,357,19,0,2,8,34,87260,34640,7009,46966,0
108,5769,1457,730,1242,11,6,188,1468,10,292,166,329,302,495,2424,4078,5,22973,1276,1,2,138,0,87260,34642,7009,46967,0
69,3090,1020,354,843,12,15,144,1032,8,134,77,144,142,221,970,1580,4,6792,377,0,2,5,23,87260,34642,7009,46968,0
55,2824,722,423,573,19,0,135,741,12,172,101,199,184,300,1320,2257,6,15668,870,0,2,1,2,87260,34644,7009,46970,0
45,1930,386,256,301,16,9,68,402,4,59,35,69,63,104,355,621,2,1453,80,0,2,10,16,87260,34644,7009,46971,0
34,1424,442,244,305,14,16,103,456,11,68,45,75,79,120,452,756,6,4588,254,0,2,4,11,87260,34646,7009,46972,0
48,1651,601,196,481,2,23,85,603,8,63,36,72,71,108,400,664,4,3036,168,0,2,8,31,87260,34646,7009,46973,0
18,486,205,80,86,16,53,53,221,7,18,10,19,25,29,94,134,3,497,27,0,2,7,4,87270,34646,7010,46974,0
87,3393,1043,504,840,53,9,147,1096,9,180,112,198,189,310,1377,2344,4,11604,644,0,2,16,0,87270,34648,7010,46975,0
79,3071,1178,367,1042,6,15,115,1184,9,94,51,95,103,146,644,976,4,4439,246,0,2,2,1,87270,34648,7010,46976,0
238,4994,2,2,2,0,0,0,2,0,0,0,0,0,0,0,0,0,0,0,0,2,58,10,87270,34648,7010,46976,0
238,4994,99,48,90,1,3,5,100,0,0,0,0,0,0,0,0,0,0,0,0,2,58,10,87270,34649,7010,46977,0
238,4994,8,5,5,2,0,1,10,0,0,0,0,0,0,0,0,0,0,0,0,2,58,10,87270,34649,7010,46978,0
238,4994,1217,716,841,84,126,174,1301,14,185,118,215,199,333,1446,2542,8,20687,1149,0,2,58,10,87280,34651,7010,46979,0
238,4994,160,89,115,0,13,31,160,7,15,11,17,22,28,78,124,3,495,27,0,2,58,10,87280,34651,7010,46980,0
238,4994,10,10,9,9,0,0,19,0,0,0,0,0,0,0,0,0,0,0,0,2,58,10,87280,34651,7011,46981,0
238,4994,173,84,99,8,29,36,181,5,12,7,13,17,20,54,81,2,221,12,0,2,58,10,87280,34652,7011,46982,0
238,4994,3,1,1,3,0,0,6,0,0,0,0,0,0,0,0,0,0,0,0,2,58,10,87280,34652,7011,46983,0
109,5902,1457,730,1242,11,6,188,1468,10,292,166,329,302,495,2424,4078,5,22973,1276,1,2,24,0,87280,34654,7011,46984,0
11,231,19,8,11,5,0,4,24,2,5,3,6,7,9,13,25,1,30,1,0,2,2,1,87280,34654,7011,46986,0
11,231,102,59,69,5,3,24,107,6,22,15,28,28,43,113,206,3,789,43,0,2,2,1,87280,34654,7011,46987,0
11,231,106,40,36,3,49,17,109,8,17,13,23,25,36,93,167,5,904,50,0,2,2,1,87280,34654,7011,46988,0
219,4651,182,127,129,0,0,53,182,5,39,21,42,44,63,217,343,2,926,51,0,2,7,6,87280,34654,7012,46989,0
219,4651,1165,710,800,67,119,181,1232,18,243,153,282,261,435,2000,3492,10,36473,2026,1,2,7,6,87290,34654,7013,46990,0
67,1551,773,419,590,28,0,166,801,10,204,113,217,214,330,1598,2554,5,13587,754,0,2,2,1,87290,34654,7014,46991,0
67,1551,421,273,302,44,34,57,465,17,81,59,107,98,166,583,1098,11,12329,684,0,2,2,1,87290,34654,7015,46992,0
180,5401,1660,832,1314,41,38,274,1701,20,312,209,395,332,604,2671,5058,12,64042,3557,1,2,15,10,87290,34656,7016,46994,0
180,5401,1057,646,719,113,100,145,1170,18,215,134,248,233,382,1740,3004,10,31186,1732,1,2,15,10,87300,34657,7017,46995,0
160,3425,1513,682,1277,25,13,200,1538,11,199,116,219,210,335,1557,2584,6,15641,868,0,2,8,4,87300,34659,7017,46996,0
160,3425,819,519,539,24,98,155,843,15,96,57,106,111,163,690,1107,8,9171,509,0,2,8,4,87310,34661,7017,46997,0
57,1484,339,213,244,17,9,65,356,10,42,26,48,52,74,259,421,5,2410,133,0,2,1,1,87320,34661,7017,46998,0
251,5824,4293,999,3693,19,54,507,4312,9,155,88,170,164,258,1156,1898,4,9368,520,0,2,9,3,87320,34663,7017,46999,0
251,5824,1482,859,1002,125,135,219,1607,16,219,134,251,235,385,1766,3032,9,27804,1544,1,2,9,3,87330,34664,7017,47000,0
24,600,2,2,2,0,0,0,2,0,0,0,0,0,0,0,0,0,0,0,0,2,2,1,87330,34664,7017,47000,0
24,600,99,48,90,1,3,5,100,0,0,0,0,0,0,0,0,0,0,0,0,2,2,1,87330,34665,7017,47001,0
24,600,8,5,5,2,0,1,10,0,0,0,0,0,0,0,0,0,0,0,0,2,2,1,87330,34665,7017,47002,0
24,600,1217,716,841,84,126,174,1301,14,185,118,215,199,333,1446,2542,8,20687,1149,0,2,2,1,87340,34667,7017,47003,0
24,600,160,89,115,0,13,31,160,7,15,11,17,22,28,78,124,3,495,27,0,2,2,1,87340,34667,7017,47004,0
24,600,10,10,9,9,0,0,19,0,0,0,0,0,0,0,0,0,0,0,0,2,2,1,87340,34667,7018,47005,0
24,600,173,84,99,8,29,36,181,5,12,7,13,17,20,54,81,2,221,12,0,2,2,1,87340,34668,7018,47006,0
24,600,3,1,1,3,0,0,6,0,0,0,0,0,0,0,0,0,0,0,0,2,2,1,87340,34668,7018,47007,0
71,1566,402,202,227,24,74,80,426,12,52,33,61,64,94,339,564,7,3969,220,0,2,2,1,87340,34669,7018,47008,0
76,1623,53,23,39,0,0,13,53,2,8,4,8,10,12,26,39,1,39,2,0,2,2,1,87340,34669,7018,47009,0
76,1623,515,298,307,33,80,99,548,12,63,44,77,75,121,419,753,7,5527,307,0,2,2,1,87350,34669,7018,47010,0
18,486,205,80,86,16,53,53,221,7,18,10,19,25,29,94,134,3,497,27,0,2,8,4,87360,34669,7019,47011,0
88,1786,757,253,292,73,244,162,830,13,61,38,67,74,105,409,651,7,4654,258,0,2,10,5,87360,34670,7019,47012,0
67,1751,466,257,367,18,25,50,484,7,126,86,171,133,257,898,1813,4,8612,478,0,2,2,1,87360,34670,7019,47013,0
67,1751,507,281,342,29,59,88,536,10,53,29,57,63,86,336,514,5,2764,153,0,2,2,1,87360,34670,7019,47014,0
19,699,442,244,305,14,16,103,456,11,68,45,75,79,120,452,756,6,4588,254,0,2,4,1,87360,34672,7019,47015,0
19,699,182,102,99,11,40,35,193,3,11,6,11,14,17,42,64,1,97,5,0,2,4,1,87360,34673,7019,47016,0
150,7150,1392,870,1177,35,17,170,1427,14,494,280,531,508,811,4473,7289,7,54850,3047,2,2,2,1,87360,34676,7020,47017,0
33,1013,256,139,192,9,7,47,265,4,23,12,24,27,36,112,171,2,357,19,0,2,2,1,87360,34677,7020,47018,0
20,449,207,111,150,11,0,50,218,5,26,19,36,31,55,133,272,3,943,52,0,2,2,1,87360,34677,7020,47019,0
75,3937,1293,570,1093,25,15,163,1318,10,195,123,241,205,364,1516,2795,6,17273,959,0,2,2,1,87370,34679,7020,47020,0
84,1646,757,253,292,73,244,162,830,13,61,38,67,74,105,409,651,7,4654,258,0,2,1,4,87370,34680,7020,47021,0
37,680,386,256,301,16,9,68,402,4,59,35,69,63,104,355,621,2,1453,80,0,2,1,1,87370,34680,7020,47022,0
37,680,264,131,164,11,41,46,275,6,38,22,40,44,62,214,338,3,1068,59,0,2,1,1,87380,34680,7021,47023,0
81,3712,1455,414,1257,16,76,112,1471,5,41,23,46,46,69,231,381,2,1069,59,0,2,4,2,87380,34681,7021,47024,0
81,3729,1455,414,1257,16,76,112,1471,5,41,23,46,46,69,231,381,2,1069,59,0,2,3,0,87380,34682,7021,47025,0
101,2578,1455,414,1257,16,76,112,1471,5,41,23,46,46,69,231,381,2,1069,59,0,2,91,24,87380,34683,7021,47026,0
101,2578,669,365,481,22,61,110,691,15,103,63,122,118,185,747,1273,8,11311,628,0,2,91,24,87390,34683,7022,47027,0
81,3729,1455,414,1257,16,76,112,1471,5,41,23,46,46,69,231,381,2,1069,59,0,2,149,0,87390,34684,7022,47028,0
90,2013,996,429,845,24,10,117,1020,7,76,50,88,83,138,494,879,4,3565,198,0,2,2,2,87390,34686,7022,47029,0
90,2013,456,277,329,12,42,72,468,13,85,50,97,98,147,592,972,7,7212,400,0,2,2,2,87390,34686,7022,47030,0
64,1298,91,45,69,0,3,18,91,3,9,6,10,12,16,33,57,1,95,5,0,2,36,9,87390,34688,7022,47031,0
64,1298,367,234,237,17,34,68,384,16,55,34,61,71,95,381,584,8,5183,287,0,2,36,9,87390,34689,7022,47032,0
38,1654,442,244,305,14,16,103,456,11,68,45,75,79,120,452,756,6,4588,254,0,2,57,3,87390,34691,7022,47033,0
90,2013,996,429,845,24,10,117,1020,7,76,50,88,83,138,494,879,4,3565,198,0,2,2,2,87390,34693,7022,47034,0
90,2013,456,277,329,12,42,72,468,13,85,50,97,98,147,592,972,7,7212,400,0,2,2,2,87390,34693,7022,47035,0
64,1298,91,45,69,0,3,18,91,3,9,6,10,12,16,33,57,1,95,5,0,2,36,9,87390,34695,7022,47036,0
64,1298,367,234,237,17,34,68,384,16,55,34,61,71,95,381,584,8,5183,287,0,2,36,9,87390,34696,7022,47037,0
38,1654,442,244,305,14,16,103,456,11,68,45,75,79,120,452,756,6,4588,254,0,2,57,3,87390,34698,7022,47038,0
12,177,424,94,331,4,0,89,428,1,5,5,5,6,10,11,25,0,12,0,0,2,0,25,87390,34699,7022,47039,0
12,177,38,23,23,6,0,8,44,3,11,7,11,14,18,42,68,1,102,5,0,2,0,25,87390,34699,7022,47040,0
90,1912,1043,504,840,53,9,147,1096,9,180,112,198,189,310,1377,2344,4,11604,644,0,2,5,4,87390,34701,7022,47041,0
90,1912,383,288,292,26,6,62,409,11,65,38,67,76,105,429,656,5,3719,206,0,2,5,4,87390,34702,7022,47042,0
68,1337,1098,241,925,5,10,155,1103,7,46,25,49,53,74,273,423,3,1580,87,0,2,9,0,87400,34704,7022,47043,0
68,1337,282,202,222,14,2,44,296,8,42,24,43,50,67,250,378,4,1548,86,0,2,9,0,87400,34705,7022,47044,0
49,1966,1098,241,925,5,10,155,1103,7,46,25,49,53,74,273,423,3,1580,87,0,2,1,3,87410,34707,7022,47045,0
64,1298,91,45,69,0,3,18,91,3,9,6,10,12,16,33,57,1,95,5,0,2,2,2,87410,34709,7022,47046,0
64,1298,367,234,237,17,34,68,384,16,55,34,61,71,95,381,584,8,5183,287,0,2,2,2,87410,34710,7022,47047,0
313,6823,72,33,56,0,4,12,72,1,1,1,1,2,2,0,2,0,1,0,0,2,0,3,87410,34710,7022,47048,0
313,6823,1454,835,1044,76,110,219,1530,17,275,158,296,292,454,2297,3718,9,34017,1889,1,2,0,3,87420,34711,7022,47049,0
313,6817,72,33,56,0,4,12,72,1,1,1,1,2,2,0,2,0,1,0,0,2,5,8,87420,34711,7022,47050,0
313,6817,1454,835,1044,76,110,219,1530,17,275,158,296,292,454,2297,3718,9,34017,1889,1,2,5,8,87430,34712,7022,47051,0
64,1298,91,45,69,0,3,18,91,3,9,6,10,12,16,33,57,1,95,5,0,2,2,2,87430,34714,7022,47052,0
64,1298,367,234,237,17,34,68,384,16,55,34,61,71,95,381,584,8,5183,287,0,2,2,2,87430,34715,7022,47053,0
12,177,424,94,331,4,0,89,428,1,5,5,5,6,10,11,25,0,12,0,0,2,0,25,87430,34716,7022,47054,0
12,177,38,23,23,6,0,8,44,3,11,7,11,14,18,42,68,1,102,5,0,2,0,25,87430,34716,7022,47055,0
90,1912,1043,504,840,53,9,147,1096,9,180,112,198,189,310,1377,2344,4,11604,644,0,2,5,4,87430,34718,7022,47056,0
90,1912,383,288,292,26,6,62,409,11,65,38,67,76,105,429,656,5,3719,206,0,2,5,4,87430,34719,7022,47057,0
68,1337,1098,241,925,5,10,155,1103,7,46,25,49,53,74,273,423,3,1580,87,0,2,9,0,87440,34721,7022,47058,0
68,1337,282,202,222,14,2,44,296,8,42,24,43,50,67,250,378,4,1548,86,0,2,9,0,87440,34722,7022,47059,0
49,1966,1098,241,925,5,10,155,1103,7,46,25,49,53,74,273,423,3,1580,87,0,2,1,3,87450,34724,7022,47060,0
312,6802,72,33,56,0,4,12,72,1,1,1,1,2,2,0,2,0,1,0,0,2,2,6,87450,34724,7022,47061,0
312,6802,1454,835,1044,76,110,219,1530,17,275,158,296,292,454,2297,3718,9,34017,1889,1,2,2,6,87460,34725,7022,47062,0
307,6733,72,33,56,0,4,12,72,1,1,1,1,2,2,0,2,0,1,0,0,2,0,21,87460,34725,7022,47063,0
307,6733,1454,835,1044,76,110,219,1530,17,275,158,296,292,454,2297,3718,9,34017,1889,1,2,0,21,87470,34726,7022,47064,0
117,3137,1523,757,1297,19,12,193,1542,12,193,117,230,205,347,1508,2664,7,19053,1058,0,2,10,11,87480,34728,7022,47065,0
117,3137,701,378,504,33,58,109,734,13,110,68,126,123,194,794,1346,7,10027,557,0,2,10,11,87480,34729,7023,47066,0
111,5221,1523,757,1297,19,12,193,1542,12,193,117,230,205,347,1508,2664,7,19053,1058,0,2,27,3,87490,34731,7023,47067,0
307,6751,72,33,56,0,4,12,72,1,1,1,1,2,2,0,2,0,1,0,0,2,13,8,87490,34731,7023,47068,0
307,6751,1454,835,1044,76,110,219,1530,17,275,158,296,292,454,2297,3718,9,34017,1889,1,2,13,8,87500,34732,7023,47069,0
147,5933,1782,648,1425,9,47,279,1791,8,171,97,189,179,286,1292,2140,4,9462,525,0,2,11,0,87500,34733,7024,47070,0
305,6729,72,33,56,0,4,12,72,1,1,1,1,2,2,0,2,0,1,0,0,2,23,21,87500,34733,7024,47071,0
305,6729,1454,835,1044,76,110,219,1530,17,275,158,296,292,454,2297,3718,9,34017,1889,1,2,23,21,87510,34734,7024,47072,0
7,140,38,22,22,1,0,15,39,1,2,1,2,3,3,2,4,0,2,0,0,0,38,0,87510,34734,7024,47073,1
7,140,38,22,22,1,0,15,39,1,2,1,2,3,3,2,4,0,2,0,0,0,38,0,87510,34734,7024,47074,0
85,1664,757,253,292,73,244,162,830,13,61,38,67,74,105,409,651,7,4654,258,0,2,6,3,87510,34735,7024,47075,1
38,702,386,256,301,16,9,68,402,4,59,35,69,63,104,355,621,2,1453,80,0,2,6,1,87510,34735,7024,47076,1
38,702,264,131,164,11,41,46,275,6,38,22,40,44,62,214,338,3,1068,59,0,2,6,1,87520,34735,7025,47077,1
30,903,256,139,192,9,7,47,265,4,23,12,24,27,36,112,171,2,357,19,0,2,6,0,87520,34736,7025,47078,1
46,1968,386,256,301,16,9,68,402,4,59,35,69,63,104,355,621,2,1453,80,0,2,6,0,87520,34736,7025,47079,1
11,553,205,80,86,16,53,53,221,7,18,10,19,25,29,94,134,3,497,27,0,2,23,9,87530,34736,7026,47080,0
20,993,386,256,301,16,9,68,402,4,59,35,69,63,104,355,621,2,1453,80,0,2,87,23,87530,34736,7026,47081,1
20,993,264,131,164,11,41,46,275,6,38,22,40,44,62,214,338,3,1068,59,0,2,87,23,87540,34736,7027,47082,1
219,4842,182,127,129,0,0,53,182,5,39,21,42,44,63,217,343,2,926,51,0,2,50,25,87540,34736,7028,47083,1
219,4842,1165,710,800,67,119,181,1232,18,243,153,282,261,435,2000,3492,10,36473,2026,1,2,50,25,87550,34736,7029,47084,1
79,1897,757,253,292,73,244,162,830,13,61,38,67,74,105,409,651,7,4654,258,0,2,56,7,87550,34737,7029,47085,1
214,4866,182,127,129,0,0,53,182,5,39,21,42,44,63,217,343,2,926,51,0,2,13,8,87550,34737,7030,47086,0
214,4866,1165,710,800,67,119,181,1232,18,243,153,282,261,435,2000,3492,10,36473,2026,1,2,13,8,87560,34737,7031,47087,0
79,1947,757,253,292,73,244,162,830,13,61,38,67,74,105,409,651,7,4654,258,0,2,20,13,87560,34738,7031,47088,0
215,4899,182,127,129,0,0,53,182,5,39,21,42,44,63,217,343,2,926,51,0,2,5,0,87560,34738,7032,47089,0
215,4899,1165,710,800,67,119,181,1232,18,243,153,282,261,435,2000,3492,10,36473,2026,1,2,5,0,87570,34738,7033,47090,0
79,1959,757,253,292,73,244,162,830,13,61,38,67,74,105,409,651,7,4654,258,0,2,9,5,87570,34739,7033,47091,0
216,4938,182,127,129,0,0,53,182,5,39,21,42,44,63,217,343,2,926,51,0,2,32,13,87570,34739,7034,47092,0
216,4938,1165,710,800,67,119,181,1232,18,243,153,282,261,435,2000,3492,10,36473,2026,1,2,32,13,87580,34739,7035,47093,0
79,1967,757,253,292,73,244,162,830,13,61,38,67,74,105,409,651,7,4654,258,0,2,5,5,87580,34740,7035,47094,0
152,7195,1392,870,1177,35,17,170,1427,14,494,280,531,508,811,4473,7289,7,54850,3047,2,2,9,1,87580,34743,7036,47095,0
9,261,149,95,105,2,0,41,151,8,54,28,55,62,83,334,494,4,2013,111,0,2,0,18,87580,34743,7036,47096,0
9,261,82,56,54,0,13,15,82,4,13,8,16,17,24,56,98,2,241,13,0,2,0,18,87590,34743,7036,47097,0
10,274,149,95,105,2,0,41,151,8,54,28,55,62,83,334,494,4,2013,111,0,2,7,6,87590,34743,7036,47098,0
10,274,82,56,54,0,13,15,82,4,13,8,16,17,24,56,98,2,241,13,0,2,7,6,87600,34743,7036,47099,0
12,315,149,95,105,2,0,41,151,8,54,28,55,62,83,334,494,4,2013,111,0,2,1,1,87600,34743,7036,47100,0
10,269,149,95,105,2,0,41,151,8,54,28,55,62,83,334,494,4,2013,111,0,2,0,1,87600,34743,7036,47101,0
10,269,82,56,54,0,13,15,82,4,13,8,16,17,24,56,98,2,241,13,0,2,0,1,87610,34743,7036,47102,0
305,6729,72,33,56,0,4,12,72,1,1,1,1,2,2,0,2,0,1,0,0,2,43,67,87610,34743,7036,47103,0
305,6729,1454,835,1044,76,110,219,1530,17,275,158,296,292,454,2297,3718,9,34017,1889,1,2,43,67,87620,34744,7036,47104,0
147,5933,1782,648,1425,9,47,279,1791,8,171,97,189,179,286,1292,2140,4,9462,525,0,2,11,0,87620,34745,7037,47105,0
12,280,149,95,105,2,0,41,151,8,54,28,55,62,83,334,494,4,2013,111,0,2,30,23,87620,34745,7037,47106,0
12,280,82,56,54,0,13,15,82,4,13,8,16,17,24,56,98,2,241,13,0,2,30,23,87630,34745,7037,47107,0
14,343,149,95,105,2,0,41,151,8,54,28,55,62,83,334,494,4,2013,111,0,2,11,0,87630,34745,7037,47108,0
71,1566,402,202,227,24,74,80,426,12,52,33,61,64,94,339,564,7,3969,220,0,2,12,11,87630,34746,7037,47109,0
88,1786,757,253,292,73,244,162,830,13,61,38,67,74,105,409,651,7,4654,258,0,2,1,1,87630,34747,7037,47110,0
33,966,465,148,393,5,8,60,470,4,31,20,31,35,51,161,261,2,523,29,0,2,0,3,87630,34748,7037,47111,0
33,966,16,12,9,0,0,6,16,1,2,1,2,3,3,2,4,0,2,0,0,2,0,3,87630,34748,7037,47112,0
32,954,465,148,393,5,8,60,470,4,31,20,31,35,51,161,261,2,523,29,0,2,5,11,87630,34749,7037,47113,0
32,954,16,12,9,0,0,6,16,1,2,1,2,3,3,2,4,0,2,0,0,2,5,11,87630,34749,7037,47114,0
32,954,465,148,393,5,8,60,470,4,31,20,31,35,51,161,261,2,523,29,0,2,5,14,87630,34750,7037,47115,0
32,954,16,12,9,0,0,6,16,1,2,1,2,3,3,2,4,0,2,0,0,2,5,14,87630,34750,7037,47116,0
12,280,149,95,105,2,0,41,151,8,54,28,55,62,83,334,494,4,2013,111,0,2,36,47,87630,34750,7037,47117,0
12,280,82,56,54,0,13,15,82,4,13,8,16,17,24,56,98,2,241,13,0,2,36,47,87640,34750,7037,47118,0
14,343,149,95,105,2,0,41,151,8,54,28,55,62,83,334,494,4,2013,111,0,2,12,1,87640,34750,7037,47119,0
216,4938,182,127,129,0,0,53,182,5,39,21,42,44,63,217,343,2,926,51,0,2,85,31,87640,34750,7038,47120,0
216,4938,1165,710,800,67,119,181,1232,18,243,153,282,261,435,2000,3492,10,36473,2026,1,2,85,31,87650,34750,7039,47121,0
11,553,205,80,86,16,53,53,221,7,18,10,19,25,29,94,134,3,497,27,0,2,23,9,87660,34750,7040,47122,0
79,1967,757,253,292,73,244,162,830,13,61,38,67,74,105,409,651,7,4654,258,0,2,80,20,87660,34751,7040,47123,0
20,993,386,256,301,16,9,68,402,4,59,35,69,63,104,355,621,2,1453,80,0,2,94,25,87660,34751,7040,47124,0
20,993,264,131,164,11,41,46,275,6,38,22,40,44,62,214,338,3,1068,59,0,2,94,25,87670,34751,7041,47125,0
152,7195,1392,870,1177,35,17,170,1427,14,494,280,531,508,811,4473,7289,7,54850,3047,2,2,9,1,87670,34754,7042,47126,0
30,903,256,139,192,9,7,47,265,4,23,12,24,27,36,112,171,2,357,19,0,2,6,0,87670,34755,7042,47127,0
46,1968,386,256,301,16,9,68,402,4,59,35,69,63,104,355,621,2,1453,80,0,2,6,0,87670,34755,7042,47128,0
71,1566,402,202,227,24,74,80,426,12,52,33,61,64,94,339,564,7,3969,220,0,2,12,11,87670,34756,7042,47129,0
88,1786,757,253,292,73,244,162,830,13,61,38,67,74,105,409,651,7,4654,258,0,2,1,1,87670,34757,7042,47130,0
216,4948,182,127,129,0,0,53,182,5,39,21,42,44,63,217,343,2,926,51,0,2,3,1,87670,34757,7043,47131,0
216,4948,1165,710,800,67,119,181,1232,18,243,153,282,261,435,2000,3492,10,36473,2026,1,2,3,1,87680,34757,7044,47132,0
11,562,205,80,86,16,53,53,221,7,18,10,19,25,29,94,134,3,497,27,0,2,4,1,87690,34757,7045,47133,1
304,6724,72,33,56,0,4,12,72,1,1,1,1,2,2,0,2,0,1,0,0,2,1,1,87690,34757,7045,47134,0
304,6724,1454,835,1044,76,110,219,1530,17,275,158,296,292,454,2297,3718,9,34017,1889,1,2,1,1,87700,34758,7045,47135,0
87,1891,1043,504,840,53,9,147,1096,9,180,112,198,189,310,1377,2344,4,11604,644,0,2,3,9,87700,34760,7045,47136,0
87,1891,383,288,292,26,6,62,409,11,65,38,67,76,105,429,656,5,3719,206,0,2,3,9,87700,34761,7045,47137,0
10,530,205,80,86,16,53,53,221,7,18,10,19,25,29,94,134,3,497,27,0,2,2,8,87710,34761,7046,47138,0
102,2603,1455,414,1257,16,76,112,1471,5,41,23,46,46,69,231,381,2,1069,59,0,2,4,0,87710,34762,7046,47139,1
102,2603,669,365,481,22,61,110,691,15,103,63,122,118,185,747,1273,8,11311,628,0,2,4,0,87720,34762,7047,47140,1
76,4016,1293,570,1093,25,15,163,1318,10,195,123,241,205,364,1516,2795,6,17273,959,0,2,23,1,87730,34764,7047,47141,1
216,4948,182,127,129,0,0,53,182,5,39,21,42,44,63,217,343,2,926,51,0,2,3,1,87730,34764,7048,47142,0
216,4948,1165,710,800,67,119,181,1232,18,243,153,282,261,435,2000,3492,10,36473,2026,1,2,3,1,87740,34764,7049,47143,0
10,530,205,80,86,16,53,53,221,7,18,10,19,25,29,94,134,3,497,27,0,2,1,4,87750,34764,7050,47144,0
304,6724,72,33,56,0,4,12,72,1,1,1,1,2,2,0,2,0,1,0,0,2,1,1,87750,34764,7050,47145,0
304,6724,1454,835,1044,76,110,219,1530,17,275,158,296,292,454,2297,3718,9,34017,1889,1,2,1,1,87760,34765,7050,47146,0
87,1891,1043,504,840,53,9,147,1096,9,180,112,198,189,310,1377,2344,4,11604,644,0,2,3,9,87760,34767,7050,47147,0
87,1891,383,288,292,26,6,62,409,11,65,38,67,76,105,429,656,5,3719,206,0,2,3,9,87760,34768,7050,47148,0
67,1304,1098,241,925,5,10,155,1103,7,46,25,49,53,74,273,423,3,1580,87,0,2,6,0,87770,34770,7050,47149,0
67,1304,282,202,222,14,2,44,296,8,42,24,43,50,67,250,378,4,1548,86,0,2,6,0,87770,34771,7050,47150,0
51,2027,1098,241,925,5,10,155,1103,7,46,25,49,53,74,273,423,3,1580,87,0,2,36,0,87780,34773,7050,47151,0
55,2829,722,423,573,19,0,135,741,12,172,101,199,184,300,1320,2257,6,15668,870,0,2,1,1,87780,34775,7050,47153,0
33,992,465,148,393,5,8,60,470,4,31,20,31,35,51,161,261,2,523,29,0,2,28,0,87780,34776,7050,47154,0
33,992,16,12,9,0,0,6,16,1,2,1,2,3,3,2,4,0,2,0,0,2,28,0,87780,34776,7050,47155,0
56,1107,207,111,150,11,0,50,218,5,26,19,36,31,55,133,272,3,943,52,0,2,12,7,87780,34776,7050,47156,0
56,1107,410,198,237,31,55,97,441,11,63,38,72,74,110,414,683,6,4293,238,0,2,12,7,87790,34777,7051,47157,0
55,2829,722,423,573,19,0,135,741,12,172,101,199,184,300,1320,2257,6,15668,870,0,2,1,1,87790,34779,7051,47159,0
238,4997,2,2,2,0,0,0,2,0,0,0,0,0,0,0,0,0,0,0,0,2,3,3,87790,34779,7051,47159,0
238,4997,99,48,90,1,3,5,100,0,0,0,0,0,0,0,0,0,0,0,0,2,3,3,87790,34780,7051,47160,0
238,4997,8,5,5,2,0,1,10,0,0,0,0,0,0,0,0,0,0,0,0,2,3,3,87790,34780,7051,47161,0
238,4997,1217,716,841,84,126,174,1301,14,185,118,215,199,333,1446,2542,8,20687,1149,0,2,3,3,87800,34782,7051,47162,0
238,4997,160,89,115,0,13,31,160,7,15,11,17,22,28,78,124,3,495,27,0,2,3,3,87800,34782,7051,47163,0
238,4997,10,10,9,9,0,0,19,0,0,0,0,0,0,0,0,0,0,0,0,2,3,3,87800,34782,7052,47164,0
238,4997,173,84,99,8,29,36,181,5,12,7,13,17,20,54,81,2,221,12,0,2,3,3,87800,34783,7052,47165,0
238,4997,3,1,1,3,0,0,6,0,0,0,0,0,0,0,0,0,0,0,0,2,3,3,87800,34783,7052,47166,0
31,1080,74,35,59,1,0,14,75,3,14,7,14,17,21,58,85,1,128,7,0,2,1,1,87800,34784,7052,47167,0
31,1080,245,125,200,5,7,34,250,7,30,17,34,37,51,166,265,3,1053,58,0,2,1,1,87810,34785,7052,47168,0
109,5904,1457,730,1242,11,6,188,1468,10,292,166,329,302,495,2424,4078,5,22973,1276,1,2,2,2,87810,34787,7052,47169,0
71,1566,402,202,227,24,74,80,426,12,52,33,61,64,94,339,564,7,3969,220,0,2,1,3,87810,34788,7052,47170,0
56,1107,207,111,150,11,0,50,218,5,26,19,36,31,55,133,272,3,943,52,0,2,12,7,87810,34788,7052,47171,0
56,1107,410,198,237,31,55,97,441,11,63,38,72,74,110,414,683,6,4293,238,0,2,12,7,87820,34789,7053,47172,0
33,992,465,148,393,5,8,60,470,4,31,20,31,35,51,161,261,2,523,29,0,2,28,0,87820,34790,7053,47173,0
33,992,16,12,9,0,0,6,16,1,2,1,2,3,3,2,4,0,2,0,0,2,28,0,87820,34790,7053,47174,0
51,2030,1098,241,925,5,10,155,1103,7,46,25,49,53,74,273,423,3,1580,87,0,2,3,3,87830,34792,7053,47175,1
67,1304,1098,241,925,5,10,155,1103,7,46,25,49,53,74,273,423,3,1580,87,0,2,6,0,87840,34794,7053,47176,0
67,1304,282,202,222,14,2,44,296,8,42,24,43,50,67,250,378,4,1548,86,0,2,6,0,87840,34795,7053,47177,0
51,2030,1098,241,925,5,10,155,1103,7,46,25,49,53,74,273,423,3,1580,87,0,2,36,0,87850,34797,7053,47178,0
56,789,167,116,138,4,5,22,171,8,48,30,56,56,86,292,499,4,2330,129,0,2,5,1,87850,34797,7053,47179,0
103,5325,1457,730,1242,11,6,188,1468,10,292,166,329,302,495,2424,4078,5,22973,1276,1,2,8,0,87850,34799,7053,47180,0
103,5325,1457,730,1242,11,6,188,1468,10,292,166,329,302,495,2424,4078,5,22973,1276,1,2,2,4,87850,34801,7053,47181,0
238,4997,2,2,2,0,0,0,2,0,0,0,0,0,0,0,0,0,0,0,0,2,3,3,87850,34801,7053,47181,0
238,4997,99,48,90,1,3,5,100,0,0,0,0,0,0,0,0,0,0,0,0,2,3,3,87850,34802,7053,47182,0
238,4997,8,5,5,2,0,1,10,0,0,0,0,0,0,0,0,0,0,0,0,2,3,3,87850,34802,7053,47183,0
238,4997,1217,716,841,84,126,174,1301,14,185,118,215,199,333,1446,2542,8,20687,1149,0,2,3,3,87860,34804,7053,47184,0
238,4997,160,89,115,0,13,31,160,7,15,11,17,22,28,78,124,3,495,27,0,2,3,3,87860,34804,7053,47185,0
238,4997,10,10,9,9,0,0,19,0,0,0,0,0,0,0,0,0,0,0,0,2,3,3,87860,34804,7054,47186,0
238,4997,173,84,99,8,29,36,181,5,12,7,13,17,20,54,81,2,221,12,0,2,3,3,87860,34805,7054,47187,0
238,4997,3,1,1,3,0,0,6,0,0,0,0,0,0,0,0,0,0,0,0,2,3,3,87860,34805,7054,47188,0
31,1080,74,35,59,1,0,14,75,3,14,7,14,17,21,58,85,1,128,7,0,2,1,1,87860,34806,7054,47189,0
31,1080,245,125,200,5,7,34,250,7,30,17,34,37,51,166,265,3,1053,58,0,2,1,1,87870,34807,7054,47190,0
109,5904,1457,730,1242,11,6,188,1468,10,292,166,329,302,495,2424,4078,5,22973,1276,1,2,2,2,87870,34809,7054,47191,0
56,789,167,116,138,4,5,22,171,8,48,30,56,56,86,292,499,4,2330,129,0,2,5,1,87870,34809,7054,47192,0
103,5325,1457,730,1242,11,6,188,1468,10,292,166,329,302,495,2424,4078,5,22973,1276,1,2,6,0,87870,34811,7054,47193,0
51,2034,1098,241,925,5,10,155,1103,7,46,25,49,53,74,273,423,3,1580,87,0,2,1,1,87880,34813,7054,47194,0
51,2034,1098,241,925,5,10,155,1103,7,46,25,49,53,74,273,423,3,1580,87,0,2,1,1,87890,34815,7054,47195,0
71,1566,402,202,227,24,74,80,426,12,52,33,61,64,94,339,564,7,3969,220,0,2,1,3,87890,34816,7054,47196,0
56,1107,207,111,150,11,0,50,218,5,26,19,36,31,55,133,272,3,943,52,0,2,12,7,87890,34816,7054,47197,0
56,1107,410,198,237,31,55,97,441,11,63,38,72,74,110,414,683,6,4293,238,0,2,12,7,87900,34817,7055,47198,0
56,789,167,116,138,4,5,22,171,8,48,30,56,56,86,292,499,4,2330,129,0,2,5,1,87900,34817,7055,47199,0
71,1566,402,202,227,24,74,80,426,12,52,33,61,64,94,339,564,7,3969,220,0,2,13,14,87900,34818,7055,47200,0
88,1786,757,253,292,73,244,162,830,13,61,38,67,74,105,409,651,7,4654,258,0,2,1,1,87900,34819,7055,47201,0
67,1304,1098,241,925,5,10,155,1103,7,46,25,49,53,74,273,423,3,1580,87,0,2,6,0,87910,34821,7055,47202,0
67,1304,282,202,222,14,2,44,296,8,42,24,43,50,67,250,378,4,1548,86,0,2,6,0,87910,34822,7055,47203,0
33,992,465,148,393,5,8,60,470,4,31,20,31,35,51,161,261,2,523,29,0,2,33,14,87910,34823,7055,47204,0
33,992,16,12,9,0,0,6,16,1,2,1,2,3,3,2,4,0,2,0,0,2,33,14,87910,34823,7055,47205,0
103,5325,1457,730,1242,11,6,188,1468,10,292,166,329,302,495,2424,4078,5,22973,1276,1,2,6,0,87910,34825,7055,47206,0
55,2829,722,423,573,19,0,135,741,12,172,101,199,184,300,1320,2257,6,15668,870,0,2,1,1,87910,34827,7055,47208,0
51,2034,1098,241,925,5,10,155,1103,7,46,25,49,53,74,273,423,3,1580,87,0,2,36,0,87920,34829,7055,47209,0
12,645,219,78,157,11,5,46,230,3,24,20,34,27,54,114,256,2,545,30,0,2,2,1,87920,34830,7055,47210,1
12,645,219,78,157,11,5,46,230,3,24,20,34,27,54,114,256,2,545,30,0,2,2,1,87920,34831,7055,47211,0
280,5856,1943,715,1694,26,18,214,1969,12,185,120,237,197,357,1436,2721,7,20915,1161,0,2,1,1,87920,34833,7055,47212,0
280,5856,1168,838,957,57,25,144,1225,19,348,224,416,367,640,3018,5452,11,61921,3440,1,2,1,1,87930,34835,7055,47213,0
280,5856,1943,715,1694,26,18,214,1969,12,185,120,237,197,357,1436,2721,7,20915,1161,0,2,2,2,87930,34837,7055,47214,0
280,5856,1168,838,957,57,25,144,1225,19,348,224,416,367,640,3018,5452,11,61921,3440,1,2,2,2,87940,34839,7055,47215,0
111,6050,1943,715,1694,26,18,214,1969,12,185,120,237,197,357,1436,2721,7,20915,1161,0,2,1,1,87940,34841,7055,47216,0
150,7150,1392,870,1177,35,17,170,1427,14,494,280,531,508,811,4473,7289,7,54850,3047,2,2,1,1,87940,34844,7056,47217,0
107,5128,1523,757,1297,19,12,193,1542,12,193,117,230,205,347,1508,2664,7,19053,1058,0,2,1,1,87950,34846,7056,47218,0
107,5128,1523,757,1297,19,12,193,1542,12,193,117,230,205,347,1508,2664,7,19053,1058,0,2,1,1,87960,34848,7056,47219,0
70,3179,1020,354,843,12,15,144,1032,8,134,77,144,142,221,970,1580,4,6792,377,0,2,1,1,87960,34848,7056,47220,0
21,637,424,94,331,4,0,89,428,1,5,5,5,6,10,11,25,0,12,0,0,2,1,1,87960,34849,7056,47221,0
113,2243,463,295,324,28,62,57,491,12,134,82,154,146,236,989,1696,6,11700,650,0,2,1,1,87970,34850,7056,47222,0
280,5856,1943,715,1694,26,18,214,1969,12,185,120,237,197,357,1436,2721,7,20915,1161,0,2,1,1,87970,34852,7056,47223,0
280,5856,1168,838,957,57,25,144,1225,19,348,224,416,367,640,3018,5452,11,61921,3440,1,2,1,1,87980,34854,7056,47224,0
111,6050,1943,715,1694,26,18,214,1969,12,185,120,237,197,357,1436,2721,7,20915,1161,0,2,1,1,87980,34856,7056,47225,0
113,2243,463,295,324,28,62,57,491,12,134,82,154,146,236,989,1696,6,11700,650,0,2,1,1,87990,34857,7056,47226,0
150,7150,1392,870,1177,35,17,170,1427,14,494,280,531,508,811,4473,7289,7,54850,3047,2,2,1,1,87990,34860,7057,47227,0
107,5128,1523,757,1297,19,12,193,1542,12,193,117,230,205,347,1508,2664,7,19053,1058,0,2,2,2,88000,34862,7057,47228,0
70,3179,1020,354,843,12,15,144,1032,8,134,77,144,142,221,970,1580,4,6792,377,0,2,1,1,88000,34862,7057,47229,0
21,637,424,94,331,4,0,89,428,1,5,5,5,6,10,11,25,0,12,0,0,2,1,1,88000,34863,7057,47230,0
76,1637,53,23,39,0,0,13,53,2,8,4,8,10,12,26,39,1,39,2,0,2,5,2,88000,34863,7057,47231,0
76,1637,515,298,307,33,80,99,548,12,63,44,77,75,121,419,753,7,5527,307,0,2,5,2,88010,34863,7057,47232,0
76,1637,53,23,39,0,0,13,53,2,8,4,8,10,12,26,39,1,39,2,0,2,5,2,88010,34863,7057,47233,0
76,1637,515,298,307,33,80,99,548,12,63,44,77,75,121,419,753,7,5527,307,0,2,5,2,88020,34863,7057,47234,0
65,1368,91,45,69,0,3,18,91,3,9,6,10,12,16,33,57,1,95,5,0,2,38,26,88020,34865,7057,47235,0
65,1368,367,234,237,17,34,68,384,16,55,34,61,71,95,381,584,8,5183,287,0,2,38,26,88020,34866,7057,47236,0
40,1809,442,244,305,14,16,103,456,11,68,45,75,79,120,452,756,6,4588,254,0,2,46,16,88020,34868,7057,47237,0
65,1368,91,45,69,0,3,18,91,3,9,6,10,12,16,33,57,1,95,5,0,2,38,26,88020,34870,7057,47238,0
65,1368,367,234,237,17,34,68,384,16,55,34,61,71,95,381,584,8,5183,287,0,2,38,26,88020,34871,7057,47239,0
40,1809,442,244,305,14,16,103,456,11,68,45,75,79,120,452,756,6,4588,254,0,2,46,16,88020,34873,7057,47240,0
1,300,382,65,130,157,2,92,539,4,10,5,10,14,15,41,57,2,114,6,0,2,3,5,88020,34874,7058,47241,0
7,140,38,22,22,1,0,15,39,1,2,1,2,3,3,2,4,0,2,0,0,0,38,0,88020,34874,7058,47242,0
90,2013,996,429,845,24,10,117,1020,7,76,50,88,83,138,494,879,4,3565,198,0,2,2,2,88020,34876,7058,47243,0
90,2013,456,277,329,12,42,72,468,13,85,50,97,98,147,592,972,7,7212,400,0,2,2,2,88020,34876,7058,47244,0
57,1135,207,111,150,11,0,50,218,5,26,19,36,31,55,133,272,3,943,52,0,2,12,7,88020,34876,7058,47245,0
57,1135,410,198,237,31,55,97,441,11,63,38,72,74,110,414,683,6,4293,238,0,2,12,7,88030,34877,7059,47246,0
113,2243,463,295,324,28,62,57,491,12,134,82,154,146,236,989,1696,6,11700,650,0,2,1,1,88040,34878,7059,47247,0
56,780,167,116,138,4,5,22,171,8,48,30,56,56,86,292,499,4,2330,129,0,2,5,1,88040,34878,7059,47248,0
70,1522,402,202,227,24,74,80,426,12,52,33,61,64,94,339,564,7,3969,220,0,2,13,14,88040,34879,7059,47249,0
76,1637,53,23,39,0,0,13,53,2,8,4,8,10,12,26,39,1,39,2,0,2,5,2,88040,34879,7059,47250,0
76,1637,515,298,307,33,80,99,548,12,63,44,77,75,121,419,753,7,5527,307,0,2,5,2,88050,34879,7059,47251,0
12,572,205,80,86,16,53,53,221,7,18,10,19,25,29,94,134,3,497,27,0,2,6,0,88060,34879,7060,47252,0
65,1368,91,45,69,0,3,18,91,3,9,6,10,12,16,33,57,1,95,5,0,2,50,11,88060,34881,7060,47253,0
65,1368,367,234,237,17,34,68,384,16,55,34,61,71,95,381,584,8,5183,287,0,2,50,11,88060,34882,7060,47254,0
79,1967,757,253,292,73,244,162,830,13,61,38,67,74,105,409,651,7,4654,258,0,2,1,1,88060,34883,7060,47255,0
25,429,219,78,157,11,5,46,230,3,24,20,34,27,54,114,256,2,545,30,0,2,0,1,88060,34884,7060,47256,0
25,429,108,64,79,9,0,20,117,5,15,11,19,20,30,70,129,3,410,22,0,2,0,1,88060,34884,7060,47257,0
280,5856,1943,715,1694,26,18,214,1969,12,185,120,237,197,357,1436,2721,7,20915,1161,0,2,1,1,88060,34886,7060,47258,0
280,5856,1168,838,957,57,25,144,1225,19,348,224,416,367,640,3018,5452,11,61921,3440,1,2,1,1,88070,34888,7060,47259,0
70,1371,1098,241,925,5,10,155,1103,7,46,25,49,53,74,273,423,3,1580,87,0,2,6,0,88080,34890,7060,47260,0
70,1371,282,202,222,14,2,44,296,8,42,24,43,50,67,250,378,4,1548,86,0,2,6,0,88080,34891,7060,47261,0
152,7195,1392,870,1177,35,17,170,1427,14,494,280,531,508,811,4473,7289,7,54850,3047,2,2,1,1,88080,34894,7061,47262,0
4,181,75,38,59,1,3,12,76,2,4,2,4,6,6,10,15,1,15,0,0,2,1,1,88080,34894,7061,47263,0
33,992,465,148,393,5,8,60,470,4,31,20,31,35,51,161,261,2,523,29,0,2,33,14,88080,34895,7061,47264,0
33,992,16,12,9,0,0,6,16,1,2,1,2,3,3,2,4,0,2,0,0,2,33,14,88080,34895,7061,47265,0
110,5948,1457,730,1242,11,6,188,1468,10,292,166,329,302,495,2424,4078,5,22973,1276,1,2,6,0,88080,34897,7061,47266,0
111,5221,1523,757,1297,19,12,193,1542,12,193,117,230,205,347,1508,2664,7,19053,1058,0,2,2,2,88090,34899,7061,47267,0
69,3090,1020,354,843,12,15,144,1032,8,134,77,144,142,221,970,1580,4,6792,377,0,2,1,1,88090,34899,7061,47268,0
21,637,424,94,331,4,0,89,428,1,5,5,5,6,10,11,25,0,12,0,0,2,1,1,88090,34900,7061,47269,0
55,2824,722,423,573,19,0,135,741,12,172,101,199,184,300,1320,2257,6,15668,870,0,2,1,1,88090,34902,7061,47271,0
87,3393,1043,504,840,53,9,147,1096,9,180,112,198,189,310,1377,2344,4,11604,644,0,2,16,0,88090,34904,7061,47272,0
79,3071,1178,367,1042,6,15,115,1184,9,94,51,95,103,146,644,976,4,4439,246,0,2,2,1,88090,34904,7061,47273,0
12,645,219,78,157,11,5,46,230,3,24,20,34,27,54,114,256,2,545,30,0,2,2,1,88090,34905,7061,47274,0
111,6050,1943,715,1694,26,18,214,1969,12,185,120,237,197,357,1436,2721,7,20915,1161,0,2,1,1,88090,34907,7061,47275,0
39,1770,442,244,305,14,16,103,456,11,68,45,75,79,120,452,756,6,4588,254,0,2,97,13,88090,34909,7061,47276,0
51,2032,1098,241,925,5,10,155,1103,7,46,25,49,53,74,273,423,3,1580,87,0,2,36,0,88100,34911,7061,47277,0
183,5400,1660,832,1314,41,38,274,1701,20,312,209,395,332,604,2671,5058,12,64042,3557,1,2,28,18,88100,34913,7062,47279,1
183,5400,1057,646,719,113,100,145,1170,18,215,134,248,233,382,1740,3004,10,31186,1732,1,2,28,18,88110,34914,7063,47280,1
63,1284,91,45,69,0,3,18,91,3,9,6,10,12,16,33,57,1,95,5,0,2,2,9,88110,34916,7063,47281,1
63,1284,367,234,237,17,34,68,384,16,55,34,61,71,95,381,584,8,5183,287,0,2,2,9,88110,34917,7063,47282,1
181,5925,1660,832,1314,41,38,274,1701,20,312,209,395,332,604,2671,5058,12,64042,3557,1,2,42,0,88110,34919,7064,47284,1
1,300,382,65,130,157,2,92,539,4,10,5,10,14,15,41,57,2,114,6,0,2,3,5,88110,34920,7065,47285,0
7,140,38,22,22,1,0,15,39,1,2,1,2,3,3,2,4,0,2,0,0,0,38,0,88110,34920,7065,47286,0
90,2013,996,429,845,24,10,117,1020,7,76,50,88,83,138,494,879,4,3565,198,0,2,2,2,88110,34922,7065,47287,0
90,2013,456,277,329,12,42,72,468,13,85,50,97,98,147,592,972,7,7212,400,0,2,2,2,88110,34922,7065,47288,0
57,1135,207,111,150,11,0,50,218,5,26,19,36,31,55,133,272,3,943,52,0,2,12,7,88110,34922,7065,47289,0
57,1135,410,198,237,31,55,97,441,11,63,38,72,74,110,414,683,6,4293,238,0,2,12,7,88120,34923,7066,47290,0
113,2243,463,295,324,28,62,57,491,12,134,82,154,146,236,989,1696,6,11700,650,0,2,1,1,88130,34924,7066,47291,0
56,780,167,116,138,4,5,22,171,8,48,30,56,56,86,292,499,4,2330,129,0,2,5,1,88130,34924,7066,47292,0
70,1522,402,202,227,24,74,80,426,12,52,33,61,64,94,339,564,7,3969,220,0,2,13,14,88130,34925,7066,47293,0
76,1637,53,23,39,0,0,13,53,2,8,4,8,10,12,26,39,1,39,2,0,2,5,2,88130,34925,7066,47294,0
76,1637,515,298,307,33,80,99,548,12,63,44,77,75,121,419,753,7,5527,307,0,2,5,2,88140,34925,7066,47295,0
12,572,205,80,86,16,53,53,221,7,18,10,19,25,29,94,134,3,497,27,0,2,6,0,88150,34925,7067,47296,0
65,1368,91,45,69,0,3,18,91,3,9,6,10,12,16,33,57,1,95,5,0,2,50,11,88150,34927,7067,47297,0
65,1368,367,234,237,17,34,68,384,16,55,34,61,71,95,381,584,8,5183,287,0,2,50,11,88150,34928,7067,47298,0
79,1967,757,253,292,73,244,162,830,13,61,38,67,74,105,409,651,7,4654,258,0,2,1,1,88150,34929,7067,47299,0
25,429,219,78,157,11,5,46,230,3,24,20,34,27,54,114,256,2,545,30,0,2,0,1,88150,34930,7067,47300,0
25,429,108,64,79,9,0,20,117,5,15,11,19,20,30,70,129,3,410,22,0,2,0,1,88150,34930,7067,47301,0
280,5856,1943,715,1694,26,18,214,1969,12,185,120,237,197,357,1436,2721,7,20915,1161,0,2,1,1,88150,34932,7067,47302,0
280,5856,1168,838,957,57,25,144,1225,19,348,224,416,367,640,3018,5452,11,61921,3440,1,2,1,1,88160,34934,7067,47303,0
70,1371,1098,241,925,5,10,155,1103,7,46,25,49,53,74,273,423,3,1580,87,0,2,6,0,88170,34936,7067,47304,0
70,1371,282,202,222,14,2,44,296,8,42,24,43,50,67,250,378,4,1548,86,0,2,6,0,88170,34937,7067,47305,0
152,7195,1392,870,1177,35,17,170,1427,14,494,280,531,508,811,4473,7289,7,54850,3047,2,2,1,1,88170,34940,7068,47306,0
4,181,75,38,59,1,3,12,76,2,4,2,4,6,6,10,15,1,15,0,0,2,1,1,88170,34940,7068,47307,0
33,992,465,148,393,5,8,60,470,4,31,20,31,35,51,161,261,2,523,29,0,2,33,14,88170,34941,7068,47308,0
33,992,16,12,9,0,0,6,16,1,2,1,2,3,3,2,4,0,2,0,0,2,33,14,88170,34941,7068,47309,0
110,5948,1457,730,1242,11,6,188,1468,10,292,166,329,302,495,2424,4078,5,22973,1276,1,2,6,0,88170,34943,7068,47310,0
111,5221,1523,757,1297,19,12,193,1542,12,193,117,230,205,347,1508,2664,7,19053,1058,0,2,2,2,88180,34945,7068,47311,0
69,3090,1020,354,843,12,15,144,1032,8,134,77,144,142,221,970,1580,4,6792,377,0,2,1,1,88180,34945,7068,47312,0
21,637,424,94,331,4,0,89,428,1,5,5,5,6,10,11,25,0,12,0,0,2,1,1,88180,34946,7068,47313,0
55,2824,722,423,573,19,0,135,741,12,172,101,199,184,300,1320,2257,6,15668,870,0,2,1,1,88180,34948,7068,47315,0
87,3393,1043,504,840,53,9,147,1096,9,180,112,198,189,310,1377,2344,4,11604,644,0,2,16,0,88180,34950,7068,47316,0
79,3071,1178,367,1042,6,15,115,1184,9,94,51,95,103,146,644,976,4,4439,246,0,2,2,1,88180,34950,7068,47317,0
12,645,219,78,157,11,5,46,230,3,24,20,34,27,54,114,256,2,545,30,0,2,2,1,88180,34951,7068,47318,0
111,6050,1943,715,1694,26,18,214,1969,12,185,120,237,197,357,1436,2721,7,20915,1161,0,2,1,1,88180,34953,7068,47319,0
39,1770,442,244,305,14,16,103,456,11,68,45,75,79,120,452,756,6,4588,254,0,2,97,13,88180,34955,7068,47320,0
51,2032,1098,241,925,5,10,155,1103,7,46,25,49,53,74,273,423,3,1580,87,0,2,36,0,88190,34957,7068,47321,0
117,3166,1523,757,1297,19,12,193,1542,12,193,117,230,205,347,1508,2664,7,19053,1058,0,2,4,0,88200,34959,7068,47322,0
117,3166,701,378,504,33,58,109,734,13,110,68,126,123,194,794,1346,7,10027,557,0,2,4,0,88200,34960,7069,47323,0
113,5329,1523,757,1297,19,12,193,1542,12,193,117,230,205,347,1508,2664,7,19053,1058,0,2,26,0,88210,34962,7069,47324,0
183,5400,1660,832,1314,41,38,274,1701,20,312,209,395,332,604,2671,5058,12,64042,3557,1,2,28,18,88210,34964,7070,47326,0
183,5400,1057,646,719,113,100,145,1170,18,215,134,248,233,382,1740,3004,10,31186,1732,1,2,28,18,88220,34965,7071,47327,0
64,1354,91,45,69,0,3,18,91,3,9,6,10,12,16,33,57,1,95,5,0,2,2,9,88220,34967,7071,47328,0
64,1354,367,234,237,17,34,68,384,16,55,34,61,71,95,381,584,8,5183,287,0,2,2,9,88220,34968,7071,47329,0
181,5925,1660,832,1314,41,38,274,1701,20,312,209,395,332,604,2671,5058,12,64042,3557,1,2,42,0,88220,34970,7072,47331,0
117,3166,1523,757,1297,19,12,193,1542,12,193,117,230,205,347,1508,2664,7,19053,1058,0,2,4,0,88230,34972,7072,47332,0
117,3166,701,378,504,33,58,109,734,13,110,68,126,123,194,794,1346,7,10027,557,0,2,4,0,88230,34973,7073,47333,0
113,5329,1523,757,1297,19,12,193,1542,12,193,117,230,205,347,1508,2664,7,19053,1058,0,2,26,0,88240,34975,7073,47334,0
147,3596,77,34,69,0,0,8,77,3,24,16,29,27,45,114,213,1,387,21,0,2,7,1,88240,34975,7073,47335,0
147,3596,712,438,573,51,9,84,763,14,102,71,128,116,199,733,1364,8,11988,666,0,2,7,1,88250,34976,7073,47336,0
85,4953,1296,573,1062,40,33,157,1336,8,201,118,231,209,349,1561,2689,4,12365,686,0,2,12,0,88250,34976,7073,47337,0
147,3596,77,34,69,0,0,8,77,3,24,16,29,27,45,114,213,1,387,21,0,2,7,1,88250,34976,7073,47338,0
147,3596,712,438,573,51,9,84,763,14,102,71,128,116,199,733,1364,8,11988,666,0,2,7,1,88260,34977,7073,47339,0
85,4953,1296,573,1062,40,33,157,1336,8,201,118,231,209,349,1561,2689,4,12365,686,0,2,12,0,88260,34977,7073,47340,0
183,5400,1660,832,1314,41,38,274,1701,20,312,209,395,332,604,2671,5058,12,64042,3557,1,2,28,18,88260,34979,7074,47342,0
183,5400,1057,646,719,113,100,145,1170,18,215,134,248,233,382,1740,3004,10,31186,1732,1,2,28,18,88270,34980,7075,47343,0
142,3472,77,34,69,0,0,8,77,3,24,16,29,27,45,114,213,1,387,21,0,2,7,1,88270,34980,7075,47344,0
142,3472,712,438,573,51,9,84,763,14,102,71,128,116,199,733,1364,8,11988,666,0,2,7,1,88280,34981,7075,47345,0
64,1354,91,45,69,0,3,18,91,3,9,6,10,12,16,33,57,1,95,5,0,2,2,9,88280,34983,7075,47346,0
64,1354,367,234,237,17,34,68,384,16,55,34,61,71,95,381,584,8,5183,287,0,2,2,9,88280,34984,7075,47347,0
181,5925,1660,832,1314,41,38,274,1701,20,312,209,395,332,604,2671,5058,12,64042,3557,1,2,42,0,88280,34986,7076,47349,0
85,4953,1296,573,1062,40,33,157,1336,8,201,118,231,209,349,1561,2689,4,12365,686,0,2,12,0,88280,34986,7076,47350,0
183,5400,1660,832,1314,41,38,274,1701,20,312,209,395,332,604,2671,5058,12,64042,3557,1,2,28,18,88280,34988,7077,47352,0
183,5400,1057,646,719,113,100,145,1170,18,215,134,248,233,382,1740,3004,10,31186,1732,1,2,28,18,88290,34989,7078,47353,0
142,3472,77,34,69,0,0,8,77,3,24,16,29,27,45,114,213,1,387,21,0,2,7,1,88290,34989,7078,47354,0
142,3472,712,438,573,51,9,84,763,14,102,71,128,116,199,733,1364,8,11988,666,0,2,7,1,88300,34990,7078,47355,0
64,1354,91,45,69,0,3,18,91,3,9,6,10,12,16,33,57,1,95,5,0,2,2,9,88300,34992,7078,47356,0
64,1354,367,234,237,17,34,68,384,16,55,34,61,71,95,381,584,8,5183,287,0,2,2,9,88300,34993,7078,47357,0
181,5925,1660,832,1314,41,38,274,1701,20,312,209,395,332,604,2671,5058,12,64042,3557,1,2,42,0,88300,34995,7079,47359,0
85,4953,1296,573,1062,40,33,157,1336,8,201,118,231,209,349,1561,2689,4,12365,686,0,2,12,0,88300,34995,7079,47360,0
90,3963,1338,495,1086,10,64,173,1348,11,122,82,157,133,239,883,1686,7,11934,663,0,2,1,1,88300,34997,7079,47361,0
90,3963,1338,495,1086,10,64,173,1348,11,122,82,157,133,239,883,1686,7,11934,663,0,2,1,1,88300,34999,7079,47362,0
1,93,42,7,35,4,0,5,46,1,2,1,2,3,3,2,4,0,2,0,0,2,2,3,88300,34999,7079,47363,1
1,93,11,6,10,0,0,1,11,2,4,2,4,6,6,10,15,1,15,0,0,2,2,3,88300,34999,7079,47364,1
113,5706,1523,757,1297,19,12,193,1542,12,193,117,230,205,347,1508,2664,7,19053,1058,0,2,189,116,88310,35001,7079,47365,1
113,5691,1523,757,1297,19,12,193,1542,12,193,117,230,205,347,1508,2664,7,19053,1058,0,2,0,1,88320,35003,7079,47366,0
299,6647,72,33,56,0,4,12,72,1,1,1,1,2,2,0,2,0,1,0,0,2,0,12,88320,35003,7079,47367,0
299,6647,1454,835,1044,76,110,219,1530,17,275,158,296,292,454,2297,3718,9,34017,1889,1,2,0,12,88330,35004,7079,47368,0
1,93,42,7,35,4,0,5,46,1,2,1,2,3,3,2,4,0,2,0,0,2,2,3,88330,35004,7079,47369,0
1,93,11,6,10,0,0,1,11,2,4,2,4,6,6,10,15,1,15,0,0,2,2,3,88330,35004,7079,47370,0
113,5691,1523,757,1297,19,12,193,1542,12,193,117,230,205,347,1508,2664,7,19053,1058,0,2,189,117,88340,35006,7079,47371,0
299,6647,72,33,56,0,4,12,72,1,1,1,1,2,2,0,2,0,1,0,0,2,0,12,88340,35006,7079,47372,0
299,6647,1454,835,1044,76,110,219,1530,17,275,158,296,292,454,2297,3718,9,34017,1889,1,2,0,12,88350,35007,7079,47373,0
90,3963,1338,495,1086,10,64,173,1348,11,122,82,157,133,239,883,1686,7,11934,663,0,2,1,1,88350,35009,7079,47374,0
18,486,205,80,86,16,53,53,221,7,18,10,19,25,29,94,134,3,497,27,0,2,13,6,88360,35009,7080,47375,0
18,486,205,80,86,16,53,53,221,7,18,10,19,25,29,94,134,3,497,27,0,2,13,6,88370,35009,7081,47376,0
225,5726,722,423,573,19,0,135,741,12,172,101,199,184,300,1320,2257,6,15668,870,0,2,6,0,88370,35011,7081,47378,1
225,5726,1508,847,911,44,250,301,1552,14,148,88,169,162,257,1120,1886,7,15077,837,0,2,6,0,88370,35012,7082,47379,1
225,5726,722,423,573,19,0,135,741,12,172,101,199,184,300,1320,2257,6,15668,870,0,2,1,1,88370,35014,7082,47381,0
225,5726,1508,847,911,44,250,301,1552,14,148,88,169,162,257,1120,1886,7,15077,837,0,2,1,1,88370,35015,7083,47382,0
225,5726,722,423,573,19,0,135,741,12,172,101,199,184,300,1320,2257,6,15668,870,0,2,6,0,88370,35017,7083,47384,0
225,5726,1508,847,911,44,250,301,1552,14,148,88,169,162,257,1120,1886,7,15077,837,0,2,6,0,88370,35018,7084,47385,0
224,5729,722,423,573,19,0,135,741,12,172,101,199,184,300,1320,2257,6,15668,870,0,2,8,8,88370,35020,7084,47387,1
224,5729,1508,847,911,44,250,301,1552,14,148,88,169,162,257,1120,1886,7,15077,837,0,2,8,8,88370,35021,7085,47388,1
282,5904,1943,715,1694,26,18,214,1969,12,185,120,237,197,357,1436,2721,7,20915,1161,0,2,11,1,88370,35023,7085,47389,1
282,5904,1168,838,957,57,25,144,1225,19,348,224,416,367,640,3018,5452,11,61921,3440,1,2,11,1,88380,35025,7085,47390,1
42,2613,1157,318,931,29,22,177,1186,6,104,63,125,110,188,712,1274,3,4596,255,0,2,1,1,88380,35025,7085,47391,1
55,2824,722,423,573,19,0,135,741,12,172,101,199,184,300,1320,2257,6,15668,870,0,2,1,1,88380,35027,7085,47393,1
112,6136,1943,715,1694,26,18,214,1969,12,185,120,237,197,357,1436,2721,7,20915,1161,0,2,18,1,88380,35029,7085,47394,1
90,3963,1338,495,1086,10,64,173,1348,11,122,82,157,133,239,883,1686,7,11934,663,0,2,1,1,88380,35031,7085,47395,0
9,432,184,100,137,2,15,30,186,6,38,20,39,44,59,214,322,3,991,55,0,2,2,1,88380,35032,7085,47396,0
224,5729,722,423,573,19,0,135,741,12,172,101,199,184,300,1320,2257,6,15668,870,0,2,8,8,88380,35034,7085,47398,0
224,5729,1508,847,911,44,250,301,1552,14,148,88,169,162,257,1120,1886,7,15077,837,0,2,8,8,88380,35035,7086,47399,0
282,5904,1943,715,1694,26,18,214,1969,12,185,120,237,197,357,1436,2721,7,20915,1161,0,2,11,1,88380,35037,7086,47400,0
282,5904,1168,838,957,57,25,144,1225,19,348,224,416,367,640,3018,5452,11,61921,3440,1,2,11,1,88390,35039,7086,47401,0
42,2613,1157,318,931,29,22,177,1186,6,104,63,125,110,188,712,1274,3,4596,255,0,2,1,1,88390,35039,7086,47402,0
55,2824,722,423,573,19,0,135,741,12,172,101,199,184,300,1320,2257,6,15668,870,0,2,1,1,88390,35041,7086,47404,0
112,6136,1943,715,1694,26,18,214,1969,12,185,120,237,197,357,1436,2721,7,20915,1161,0,2,18,1,88390,35043,7086,47405,0
114,2087,477,336,357,30,23,73,507,16,194,134,250,210,384,1538,2962,10,30538,1696,0,2,3,3,88400,35044,7086,47406,0
183,5967,1660,832,1314,41,38,274,1701,20,312,209,395,332,604,2671,5058,12,64042,3557,1,2,10,0,88400,35046,7087,47408,0
183,5396,1660,832,1314,41,38,274,1701,20,312,209,395,332,604,2671,5058,12,64042,3557,1,2,4,4,88400,35048,7088,47410,1
183,5396,1057,646,719,113,100,145,1170,18,215,134,248,233,382,1740,3004,10,31186,1732,1,2,4,4,88410,35049,7089,47411,1
60,1139,282,196,195,3,0,86,285,8,130,71,141,138,212,936,1507,4,6538,363,0,2,1,1,88410,35049,7090,47412,0
7,292,72,33,56,0,4,12,72,1,1,1,1,2,2,0,2,0,1,0,0,2,1,1,88410,35049,7090,47413,0
12,228,127,75,83,2,11,30,129,4,14,7,14,18,21,61,87,2,175,9,0,2,2,2,88410,35049,7090,47414,0
12,228,652,304,544,16,6,88,668,6,89,51,101,95,152,591,998,3,3399,188,0,2,2,2,88410,35050,7090,47415,0
12,228,2,2,2,0,0,0,2,0,0,0,0,0,0,0,0,0,0,0,0,2,2,2,88410,35050,7090,47415,0
12,228,8,5,5,0,0,3,8,0,0,0,0,0,0,0,0,0,0,0,0,2,2,2,88410,35050,7090,47416,0
12,228,2,2,2,0,0,0,2,0,0,0,0,0,0,0,0,0,0,0,0,2,2,2,88410,35050,7090,47416,0
12,228,14,8,8,0,0,6,14,0,0,0,0,0,0,0,0,0,0,0,0,2,2,2,88410,35050,7090,47417,0
12,228,6,4,4,0,0,2,6,0,0,0,0,0,0,0,0,0,0,0,0,2,2,2,88410,35050,7090,47418,0
12,228,6,4,4,0,0,2,6,1,2,1,2,3,3,2,4,0,2,0,0,2,2,2,88410,35050,7090,47419,0
12,228,6,4,4,0,0,2,6,0,0,0,0,0,0,0,0,0,0,0,0,2,2,2,88410,35050,7090,47420,0
12,228,7,5,5,0,0,2,7,0,0,0,0,0,0,0,0,0,0,0,0,2,2,2,88410,35050,7090,47421,0
12,228,6,4,4,0,0,2,6,0,0,0,0,0,0,0,0,0,0,0,0,2,2,2,88410,35050,7090,47422,0
12,228,10,6,6,0,0,4,10,0,0,0,0,0,0,0,0,0,0,0,0,2,2,2,88410,35050,7090,47423,0
12,228,1,1,1,0,0,0,1,0,0,0,0,0,0,0,0,0,0,0,0,2,2,2,88410,35050,7090,47423,0
12,228,14,10,10,0,0,4,14,1,1,1,1,2,2,0,2,0,1,0,0,2,2,2,88410,35050,7090,47424,0
12,228,46,26,30,3,0,12,49,3,6,3,6,9,9,20,28,1,42,2,0,2,2,2,88420,35050,7090,47425,0
183,5396,1660,832,1314,41,38,274,1701,20,312,209,395,332,604,2671,5058,12,64042,3557,1,2,4,4,88420,35052,7091,47427,0
183,5396,1057,646,719,113,100,145,1170,18,215,134,248,233,382,1740,3004,10,31186,1732,1,2,4,4,88430,35053,7092,47428,0
60,1139,282,196,195,3,0,86,285,8,130,71,141,138,212,936,1507,4,6538,363,0,2,1,1,88430,35053,7093,47429,0
7,292,72,33,56,0,4,12,72,1,1,1,1,2,2,0,2,0,1,0,0,2,1,1,88430,35053,7093,47430,0
12,228,127,75,83,2,11,30,129,4,14,7,14,18,21,61,87,2,175,9,0,2,2,2,88430,35053,7093,47431,0
12,228,652,304,544,16,6,88,668,6,89,51,101,95,152,591,998,3,3399,188,0,2,2,2,88430,35054,7093,47432,0
12,228,2,2,2,0,0,0,2,0,0,0,0,0,0,0,0,0,0,0,0,2,2,2,88430,35054,7093,47432,0
12,228,8,5,5,0,0,3,8,0,0,0,0,0,0,0,0,0,0,0,0,2,2,2,88430,35054,7093,47433,0
12,228,2,2,2,0,0,0,2,0,0,0,0,0,0,0,0,0,0,0,0,2,2,2,88430,35054,7093,47433,0
12,228,14,8,8,0,0,6,14,0,0,0,0,0,0,0,0,0,0,0,0,2,2,2,88430,35054,7093,47434,0
12,228,6,4,4,0,0,2,6,0,0,0,0,0,0,0,0,0,0,0,0,2,2,2,88430,35054,7093,47435,0
12,228,6,4,4,0,0,2,6,1,2,1,2,3,3,2,4,0,2,0,0,2,2,2,88430,35054,7093,47436,0
12,228,6,4,4,0,0,2,6,0,0,0,0,0,0,0,0,0,0,0,0,2,2,2,88430,35054,7093,47437,0
12,228,7,5,5,0,0,2,7,0,0,0,0,0,0,0,0,0,0,0,0,2,2,2,88430,35054,7093,47438,0
12,228,6,4,4,0,0,2,6,0,0,0,0,0,0,0,0,0,0,0,0,2,2,2,88430,35054,7093,47439,0
12,228,10,6,6,0,0,4,10,0,0,0,0,0,0,0,0,0,0,0,0,2,2,2,88430,35054,7093,47440,0
12,228,1,1,1,0,0,0,1,0,0,0,0,0,0,0,0,0,0,0,0,2,2,2,88430,35054,7093,47440,0
12,228,14,10,10,0,0,4,14,1,1,1,1,2,2,0,2,0,1,0,0,2,2,2,88430,35054,7093,47441,0
12,228,46,26,30,3,0,12,49,3,6,3,6,9,9,20,28,1,42,2,0,2,2,2,88440,35054,7093,47442,0
9,432,184,100,137,2,15,30,186,6,38,20,39,44,59,214,322,3,991,55,0,2,2,1,88440,35055,7093,47443,0
114,2087,477,336,357,30,23,73,507,16,194,134,250,210,384,1538,2962,10,30538,1696,0,2,3,3,88450,35056,7093,47444,0
183,5967,1660,832,1314,41,38,274,1701,20,312,209,395,332,604,2671,5058,12,64042,3557,1,2,10,0,88450,35058,7094,47446,0
225,5744,722,423,573,19,0,135,741,12,172,101,199,184,300,1320,2257,6,15668,870,0,2,2,0,88450,35060,7094,47448,0
225,5744,1508,847,911,44,250,301,1552,14,148,88,169,162,257,1120,1886,7,15077,837,0,2,2,0,88450,35061,7095,47449,0
225,5744,722,423,573,19,0,135,741,12,172,101,199,184,300,1320,2257,6,15668,870,0,2,2,0,88450,35063,7095,47451,0
225,5744,1508,847,911,44,250,301,1552,14,148,88,169,162,257,1120,1886,7,15077,837,0,2,2,0,88450,35064,7096,47452,0
235,4857,2,2,2,0,0,0,2,0,0,0,0,0,0,0,0,0,0,0,0,2,3,1,88450,35064,7096,47452,0
235,4857,99,48,90,1,3,5,100,0,0,0,0,0,0,0,0,0,0,0,0,2,3,1,88450,35065,7096,47453,0
235,4857,8,5,5,2,0,1,10,0,0,0,0,0,0,0,0,0,0,0,0,2,3,1,88450,35065,7096,47454,0
235,4857,1217,716,841,84,126,174,1301,14,185,118,215,199,333,1446,2542,8,20687,1149,0,2,3,1,88460,35067,7096,47455,0
235,4857,160,89,115,0,13,31,160,7,15,11,17,22,28,78,124,3,495,27,0,2,3,1,88460,35067,7096,47456,0
235,4857,10,10,9,9,0,0,19,0,0,0,0,0,0,0,0,0,0,0,0,2,3,1,88460,35067,7097,47457,0
235,4857,173,84,99,8,29,36,181,5,12,7,13,17,20,54,81,2,221,12,0,2,3,1,88460,35068,7097,47458,0
235,4857,3,1,1,3,0,0,6,0,0,0,0,0,0,0,0,0,0,0,0,2,3,1,88460,35068,7097,47459,0
53,1795,601,196,481,2,23,85,603,8,63,36,72,71,108,400,664,4,3036,168,0,2,18,0,88460,35068,7097,47460,0
55,1098,207,111,150,11,0,50,218,5,26,19,36,31,55,133,272,3,943,52,0,2,8,6,88460,35068,7097,47461,0
55,1098,410,198,237,31,55,97,441,11,63,38,72,74,110,414,683,6,4293,238,0,2,8,6,88470,35069,7098,47462,0
315,6863,72,33,56,0,4,12,72,1,1,1,1,2,2,0,2,0,1,0,0,2,6,4,88470,35069,7098,47463,0
315,6863,1454,835,1044,76,110,219,1530,17,275,158,296,292,454,2297,3718,9,34017,1889,1,2,6,4,88480,35070,7098,47464,0
107,4626,1289,550,1043,56,32,155,1345,10,167,93,185,177,278,1266,2075,5,11498,638,0,2,30,2,88480,35072,7099,47465,0
21,478,207,111,150,11,0,50,218,5,26,19,36,31,55,133,272,3,943,52,0,2,23,3,88480,35072,7099,47466,0
57,1122,207,111,150,11,0,50,218,5,26,19,36,31,55,133,272,3,943,52,0,2,8,4,88480,35072,7099,47467,1
57,1122,410,198,237,31,55,97,441,11,63,38,72,74,110,414,683,6,4293,238,0,2,8,4,88490,35073,7100,47468,1
251,5834,4293,999,3693,19,54,507,4312,9,155,88,170,164,258,1156,1898,4,9368,520,0,2,2,2,88490,35075,7100,47469,1
251,5834,1482,859,1002,125,135,219,1607,16,219,134,251,235,385,1766,3032,9,27804,1544,1,2,2,2,88500,35076,7100,47470,1
89,3931,1338,495,1086,10,64,173,1348,11,122,82,157,133,239,883,1686,7,11934,663,0,2,0,46,88500,35078,7100,47471,1
178,7721,4293,999,3693,19,54,507,4312,9,155,88,170,164,258,1156,1898,4,9368,520,0,2,43,3,88500,35080,7100,47472,1
178,7721,1482,859,1002,125,135,219,1607,16,219,134,251,235,385,1766,3032,9,27804,1544,1,2,43,3,88510,35081,7100,47473,1
22,484,207,111,150,11,0,50,218,5,26,19,36,31,55,133,272,3,943,52,0,2,11,0,88510,35081,7100,47474,1
235,4857,2,2,2,0,0,0,2,0,0,0,0,0,0,0,0,0,0,0,0,2,3,1,88510,35081,7100,47474,0
235,4857,99,48,90,1,3,5,100,0,0,0,0,0,0,0,0,0,0,0,0,2,3,1,88510,35082,7100,47475,0
235,4857,8,5,5,2,0,1,10,0,0,0,0,0,0,0,0,0,0,0,0,2,3,1,88510,35082,7100,47476,0
235,4857,1217,716,841,84,126,174,1301,14,185,118,215,199,333,1446,2542,8,20687,1149,0,2,3,1,88520,35084,7100,47477,0
235,4857,160,89,115,0,13,31,160,7,15,11,17,22,28,78,124,3,495,27,0,2,3,1,88520,35084,7100,47478,0
235,4857,10,10,9,9,0,0,19,0,0,0,0,0,0,0,0,0,0,0,0,2,3,1,88520,35084,7101,47479,0
235,4857,173,84,99,8,29,36,181,5,12,7,13,17,20,54,81,2,221,12,0,2,3,1,88520,35085,7101,47480,0
235,4857,3,1,1,3,0,0,6,0,0,0,0,0,0,0,0,0,0,0,0,2,3,1,88520,35085,7101,47481,0
53,1795,601,196,481,2,23,85,603,8,63,36,72,71,108,400,664,4,3036,168,0,2,18,0,88520,35085,7101,47482,0
55,1098,207,111,150,11,0,50,218,5,26,19,36,31,55,133,272,3,943,52,0,2,8,6,88520,35085,7101,47483,0
55,1098,410,198,237,31,55,97,441,11,63,38,72,74,110,414,683,6,4293,238,0,2,8,6,88530,35086,7102,47484,0
315,6863,72,33,56,0,4,12,72,1,1,1,1,2,2,0,2,0,1,0,0,2,6,4,88530,35086,7102,47485,0
315,6863,1454,835,1044,76,110,219,1530,17,275,158,296,292,454,2297,3718,9,34017,1889,1,2,6,4,88540,35087,7102,47486,0
107,4626,1289,550,1043,56,32,155,1345,10,167,93,185,177,278,1266,2075,5,11498,638,0,2,30,2,88540,35089,7103,47487,0
21,478,207,111,150,11,0,50,218,5,26,19,36,31,55,133,272,3,943,52,0,2,23,3,88540,35089,7103,47488,0
318,6891,72,33,56,0,4,12,72,1,1,1,1,2,2,0,2,0,1,0,0,2,10,5,88540,35089,7103,47489,0
318,6891,1454,835,1044,76,110,219,1530,17,275,158,296,292,454,2297,3718,9,34017,1889,1,2,10,5,88550,35090,7103,47490,0
107,4630,1289,550,1043,56,32,155,1345,10,167,93,185,177,278,1266,2075,5,11498,638,0,2,8,2,88550,35092,7104,47491,0
56,1113,207,111,150,11,0,50,218,5,26,19,36,31,55,133,272,3,943,52,0,2,8,4,88550,35092,7104,47492,0
56,1113,410,198,237,31,55,97,441,11,63,38,72,74,110,414,683,6,4293,238,0,2,8,4,88560,35093,7105,47493,0
251,5834,4293,999,3693,19,54,507,4312,9,155,88,170,164,258,1156,1898,4,9368,520,0,2,2,2,88560,35095,7105,47494,0
251,5834,1482,859,1002,125,135,219,1607,16,219,134,251,235,385,1766,3032,9,27804,1544,1,2,2,2,88570,35096,7105,47495,0
89,3931,1338,495,1086,10,64,173,1348,11,122,82,157,133,239,883,1686,7,11934,663,0,2,0,46,88570,35098,7105,47496,0
178,7721,4293,999,3693,19,54,507,4312,9,155,88,170,164,258,1156,1898,4,9368,520,0,2,43,3,88570,35100,7105,47497,0
178,7721,1482,859,1002,125,135,219,1607,16,219,134,251,235,385,1766,3032,9,27804,1544,1,2,43,3,88580,35101,7105,47498,0
23,513,207,111,150,11,0,50,218,5,26,19,36,31,55,133,272,3,943,52,0,2,11,0,88580,35101,7105,47499,0
318,6891,72,33,56,0,4,12,72,1,1,1,1,2,2,0,2,0,1,0,0,2,10,5,88580,35101,7105,47500,0
318,6891,1454,835,1044,76,110,219,1530,17,275,158,296,292,454,2297,3718,9,34017,1889,1,2,10,5,88590,35102,7105,47501,0
107,4630,1289,550,1043,56,32,155,1345,10,167,93,185,177,278,1266,2075,5,11498,638,0,2,8,2,88590,35104,7106,47502,0
60,1139,282,196,195,3,0,86,285,8,130,71,141,138,212,936,1507,4,6538,363,0,2,1,1,88590,35104,7107,47503,0
7,292,72,33,56,0,4,12,72,1,1,1,1,2,2,0,2,0,1,0,0,2,1,1,88590,35104,7107,47504,0
12,228,127,75,83,2,11,30,129,4,14,7,14,18,21,61,87,2,175,9,0,2,2,2,88590,35104,7107,47505,0
12,228,652,304,544,16,6,88,668,6,89,51,101,95,152,591,998,3,3399,188,0,2,2,2,88590,35105,7107,47506,0
12,228,2,2,2,0,0,0,2,0,0,0,0,0,0,0,0,0,0,0,0,2,2,2,88590,35105,7107,47506,0
12,228,8,5,5,0,0,3,8,0,0,0,0,0,0,0,0,0,0,0,0,2,2,2,88590,35105,7107,47507,0
12,228,2,2,2,0,0,0,2,0,0,0,0,0,0,0,0,0,0,0,0,2,2,2,88590,35105,7107,47507,0
12,228,14,8,8,0,0,6,14,0,0,0,0,0,0,0,0,0,0,0,0,2,2,2,88590,35105,7107,47508,0
12,228,6,4,4,0,0,2,6,0,0,0,0,0,0,0,0,0,0,0,0,2,2,2,88590,35105,7107,47509,0
12,228,6,4,4,0,0,2,6,1,2,1,2,3,3,2,4,0,2,0,0,2,2,2,88590,35105,7107,47510,0
12,228,6,4,4,0,0,2,6,0,0,0,0,0,0,0,0,0,0,0,0,2,2,2,88590,35105,7107,47511,0
12,228,7,5,5,0,0,2,7,0,0,0,0,0,0,0,0,0,0,0,0,2,2,2,88590,35105,7107,47512,0
12,228,6,4,4,0,0,2,6,0,0,0,0,0,0,0,0,0,0,0,0,2,2,2,88590,35105,7107,47513,0
12,228,10,6,6,0,0,4,10,0,0,0,0,0,0,0,0,0,0,0,0,2,2,2,88590,35105,7107,47514,0
12,228,1,1,1,0,0,0,1,0,0,0,0,0,0,0,0,0,0,0,0,2,2,2,88590,35105,7107,47514,0
12,228,14,10,10,0,0,4,14,1,1,1,1,2,2,0,2,0,1,0,0,2,2,2,88590,35105,7107,47515,0
12,228,46,26,30,3,0,12,49,3,6,3,6,9,9,20,28,1,42,2,0,2,2,2,88600,35105,7107,47516,0
57,1141,207,111,150,11,0,50,218,5,26,19,36,31,55,133,272,3,943,52,0,2,16,10,88600,35105,7107,47517,0
57,1141,410,198,237,31,55,97,441,11,63,38,72,74,110,414,683,6,4293,238,0,2,16,10,88610,35106,7108,47518,0
238,5010,2,2,2,0,0,0,2,0,0,0,0,0,0,0,0,0,0,0,0,2,3,1,88610,35106,7108,47518,0
238,5010,99,48,90,1,3,5,100,0,0,0,0,0,0,0,0,0,0,0,0,2,3,1,88610,35107,7108,47519,0
238,5010,8,5,5,2,0,1,10,0,0,0,0,0,0,0,0,0,0,0,0,2,3,1,88610,35107,7108,47520,0
238,5010,1217,716,841,84,126,174,1301,14,185,118,215,199,333,1446,2542,8,20687,1149,0,2,3,1,88620,35109,7108,47521,0
238,5010,160,89,115,0,13,31,160,7,15,11,17,22,28,78,124,3,495,27,0,2,3,1,88620,35109,7108,47522,0
238,5010,10,10,9,9,0,0,19,0,0,0,0,0,0,0,0,0,0,0,0,2,3,1,88620,35109,7109,47523,0
238,5010,173,84,99,8,29,36,181,5,12,7,13,17,20,54,81,2,221,12,0,2,3,1,88620,35110,7109,47524,0
238,5010,3,1,1,3,0,0,6,0,0,0,0,0,0,0,0,0,0,0,0,2,3,1,88620,35110,7109,47525,0
250,5807,4293,999,3693,19,54,507,4312,9,155,88,170,164,258,1156,1898,4,9368,520,0,2,2,2,88620,35112,7109,47526,0
250,5807,1482,859,1002,125,135,219,1607,16,219,134,251,235,385,1766,3032,9,27804,1544,1,2,2,2,88630,35113,7109,47527,0
12,572,205,80,86,16,53,53,221,7,18,10,19,25,29,94,134,3,497,27,0,2,13,6,88640,35113,7110,47528,0
225,5745,722,423,573,19,0,135,741,12,172,101,199,184,300,1320,2257,6,15668,870,0,2,6,0,88640,35115,7110,47530,0
225,5745,1508,847,911,44,250,301,1552,14,148,88,169,162,257,1120,1886,7,15077,837,0,2,6,0,88640,35116,7111,47531,0
303,6685,72,33,56,0,4,12,72,1,1,1,1,2,2,0,2,0,1,0,0,2,13,6,88640,35116,7111,47532,0
303,6685,1454,835,1044,76,110,219,1530,17,275,158,296,292,454,2297,3718,9,34017,1889,1,2,13,6,88650,35117,7111,47533,0
107,4624,1289,550,1043,56,32,155,1345,10,167,93,185,177,278,1266,2075,5,11498,638,0,2,37,3,88650,35119,7112,47534,0
89,3931,1338,495,1086,10,64,173,1348,11,122,82,157,133,239,883,1686,7,11934,663,0,2,0,46,88650,35121,7112,47535,0
176,7666,4293,999,3693,19,54,507,4312,9,155,88,170,164,258,1156,1898,4,9368,520,0,2,43,3,88650,35123,7112,47536,0
176,7666,1482,859,1002,125,135,219,1607,16,219,134,251,235,385,1766,3032,9,27804,1544,1,2,43,3,88660,35124,7112,47537,0
23,513,207,111,150,11,0,50,218,5,26,19,36,31,55,133,272,3,943,52,0,2,34,3,88660,35124,7112,47538,0
9,432,184,100,137,2,15,30,186,6,38,20,39,44,59,214,322,3,991,55,0,2,2,1,88660,35125,7112,47539,0
49,1706,601,196,481,2,23,85,603,8,63,36,72,71,108,400,664,4,3036,168,0,2,18,0,88660,35125,7112,47540,0
12,572,205,80,86,16,53,53,221,7,18,10,19,25,29,94,134,3,497,27,0,2,1,1,88670,35125,7113,47541,0
225,5745,722,423,573,19,0,135,741,12,172,101,199,184,300,1320,2257,6,15668,870,0,2,1,1,88670,35127,7113,47543,0
225,5745,1508,847,911,44,250,301,1552,14,148,88,169,162,257,1120,1886,7,15077,837,0,2,1,1,88670,35128,7114,47544,0
60,1139,282,196,195,3,0,86,285,8,130,71,141,138,212,936,1507,4,6538,363,0,2,1,1,88670,35128,7115,47545,0
7,292,72,33,56,0,4,12,72,1,1,1,1,2,2,0,2,0,1,0,0,2,1,1,88670,35128,7115,47546,0
12,228,127,75,83,2,11,30,129,4,14,7,14,18,21,61,87,2,175,9,0,2,2,2,88670,35128,7115,47547,0
12,228,652,304,544,16,6,88,668,6,89,51,101,95,152,591,998,3,3399,188,0,2,2,2,88670,35129,7115,47548,0
12,228,2,2,2,0,0,0,2,0,0,0,0,0,0,0,0,0,0,0,0,2,2,2,88670,35129,7115,47548,0
12,228,8,5,5,0,0,3,8,0,0,0,0,0,0,0,0,0,0,0,0,2,2,2,88670,35129,7115,47549,0
12,228,2,2,2,0,0,0,2,0,0,0,0,0,0,0,0,0,0,0,0,2,2,2,88670,35129,7115,47549,0
12,228,14,8,8,0,0,6,14,0,0,0,0,0,0,0,0,0,0,0,0,2,2,2,88670,35129,7115,47550,0
12,228,6,4,4,0,0,2,6,0,0,0,0,0,0,0,0,0,0,0,0,2,2,2,88670,35129,7115,47551,0
12,228,6,4,4,0,0,2,6,1,2,1,2,3,3,2,4,0,2,0,0,2,2,2,88670,35129,7115,47552,0
12,228,6,4,4,0,0,2,6,0,0,0,0,0,0,0,0,0,0,0,0,2,2,2,88670,35129,7115,47553,0
12,228,7,5,5,0,0,2,7,0,0,0,0,0,0,0,0,0,0,0,0,2,2,2,88670,35129,7115,47554,0
12,228,6,4,4,0,0,2,6,0,0,0,0,0,0,0,0,0,0,0,0,2,2,2,88670,35129,7115,47555,0
12,228,10,6,6,0,0,4,10,0,0,0,0,0,0,0,0,0,0,0,0,2,2,2,88670,35129,7115,47556,0
12,228,1,1,1,0,0,0,1,0,0,0,0,0,0,0,0,0,0,0,0,2,2,2,88670,35129,7115,47556,0
12,228,14,10,10,0,0,4,14,1,1,1,1,2,2,0,2,0,1,0,0,2,2,2,88670,35129,7115,47557,0
12,228,46,26,30,3,0,12,49,3,6,3,6,9,9,20,28,1,42,2,0,2,2,2,88680,35129,7115,47558,0
57,1141,207,111,150,11,0,50,218,5,26,19,36,31,55,133,272,3,943,52,0,2,16,10,88680,35129,7115,47559,0
57,1141,410,198,237,31,55,97,441,11,63,38,72,74,110,414,683,6,4293,238,0,2,16,10,88690,35130,7116,47560,0
238,5010,2,2,2,0,0,0,2,0,0,0,0,0,0,0,0,0,0,0,0,2,3,1,88690,35130,7116,47560,0
238,5010,99,48,90,1,3,5,100,0,0,0,0,0,0,0,0,0,0,0,0,2,3,1,88690,35131,7116,47561,0
238,5010,8,5,5,2,0,1,10,0,0,0,0,0,0,0,0,0,0,0,0,2,3,1,88690,35131,7116,47562,0
238,5010,1217,716,841,84,126,174,1301,14,185,118,215,199,333,1446,2542,8,20687,1149,0,2,3,1,88700,35133,7116,47563,0
238,5010,160,89,115,0,13,31,160,7,15,11,17,22,28,78,124,3,495,27,0,2,3,1,88700,35133,7116,47564,0
238,5010,10,10,9,9,0,0,19,0,0,0,0,0,0,0,0,0,0,0,0,2,3,1,88700,35133,7117,47565,0
238,5010,173,84,99,8,29,36,181,5,12,7,13,17,20,54,81,2,221,12,0,2,3,1,88700,35134,7117,47566,0
238,5010,3,1,1,3,0,0,6,0,0,0,0,0,0,0,0,0,0,0,0,2,3,1,88700,35134,7117,47567,0
250,5807,4293,999,3693,19,54,507,4312,9,155,88,170,164,258,1156,1898,4,9368,520,0,2,2,2,88700,35136,7117,47568,0
250,5807,1482,859,1002,125,135,219,1607,16,219,134,251,235,385,1766,3032,9,27804,1544,1,2,2,2,88710,35137,7117,47569,0
12,572,205,80,86,16,53,53,221,7,18,10,19,25,29,94,134,3,497,27,0,2,13,6,88720,35137,7118,47570,0
225,5745,722,423,573,19,0,135,741,12,172,101,199,184,300,1320,2257,6,15668,870,0,2,6,0,88720,35139,7118,47572,0
225,5745,1508,847,911,44,250,301,1552,14,148,88,169,162,257,1120,1886,7,15077,837,0,2,6,0,88720,35140,7119,47573,0
303,6685,72,33,56,0,4,12,72,1,1,1,1,2,2,0,2,0,1,0,0,2,13,6,88720,35140,7119,47574,0
303,6685,1454,835,1044,76,110,219,1530,17,275,158,296,292,454,2297,3718,9,34017,1889,1,2,13,6,88730,35141,7119,47575,0
107,4624,1289,550,1043,56,32,155,1345,10,167,93,185,177,278,1266,2075,5,11498,638,0,2,37,3,88730,35143,7120,47576,0
89,3931,1338,495,1086,10,64,173,1348,11,122,82,157,133,239,883,1686,7,11934,663,0,2,0,46,88730,35145,7120,47577,0
176,7666,4293,999,3693,19,54,507,4312,9,155,88,170,164,258,1156,1898,4,9368,520,0,2,43,3,88730,35147,7120,47578,0
176,7666,1482,859,1002,125,135,219,1607,16,219,134,251,235,385,1766,3032,9,27804,1544,1,2,43,3,88740,35148,7120,47579,0
23,513,207,111,150,11,0,50,218,5,26,19,36,31,55,133,272,3,943,52,0,2,34,3,88740,35148,7120,47580,0
9,432,184,100,137,2,15,30,186,6,38,20,39,44,59,214,322,3,991,55,0,2,2,1,88740,35149,7120,47581,0
49,1706,601,196,481,2,23,85,603,8,63,36,72,71,108,400,664,4,3036,168,0,2,18,0,88740,35149,7120,47582,0
178,7750,4293,999,3693,19,54,507,4312,9,155,88,170,164,258,1156,1898,4,9368,520,0,2,10,10,88740,35151,7120,47583,0
178,7750,1482,859,1002,125,135,219,1607,16,219,134,251,235,385,1766,3032,9,27804,1544,1,2,10,10,88750,35152,7120,47584,0
178,7750,4293,999,3693,19,54,507,4312,9,155,88,170,164,258,1156,1898,4,9368,520,0,2,10,10,88750,35154,7120,47585,0
178,7750,1482,859,1002,125,135,219,1607,16,219,134,251,235,385,1766,3032,9,27804,1544,1,2,10,10,88760,35155,7120,47586,0
1,93,42,7,35,4,0,5,46,1,2,1,2,3,3,2,4,0,2,0,0,2,3,4,88760,35155,7120,47587,0
1,93,11,6,10,0,0,1,11,2,4,2,4,6,6,10,15,1,15,0,0,2,3,4,88760,35155,7120,47588,0
216,4948,182,127,129,0,0,53,182,5,39,21,42,44,63,217,343,2,926,51,0,2,87,31,88760,35155,7121,47589,0
216,4948,1165,710,800,67,119,181,1232,18,243,153,282,261,435,2000,3492,10,36473,2026,1,2,87,31,88770,35155,7122,47590,0
12,280,149,95,105,2,0,41,151,8,54,28,55,62,83,334,494,4,2013,111,0,2,36,47,88770,35155,7122,47591,0
12,280,82,56,54,0,13,15,82,4,13,8,16,17,24,56,98,2,241,13,0,2,36,47,88780,35155,7122,47592,0
183,5396,1660,832,1314,41,38,274,1701,20,312,209,395,332,604,2671,5058,12,64042,3557,1,2,4,4,88780,35157,7123,47594,0
183,5396,1057,646,719,113,100,145,1170,18,215,134,248,233,382,1740,3004,10,31186,1732,1,2,4,4,88790,35158,7124,47595,0
114,2087,477,336,357,30,23,73,507,16,194,134,250,210,384,1538,2962,10,30538,1696,0,2,3,3,88800,35159,7124,47596,0
57,1141,207,111,150,11,0,50,218,5,26,19,36,31,55,133,272,3,943,52,0,2,8,2,88800,35159,7124,47597,0
57,1141,410,198,237,31,55,97,441,11,63,38,72,74,110,414,683,6,4293,238,0,2,8,2,88810,35160,7125,47598,0
238,5010,2,2,2,0,0,0,2,0,0,0,0,0,0,0,0,0,0,0,0,2,75,22,88810,35160,7125,47598,0
238,5010,99,48,90,1,3,5,100,0,0,0,0,0,0,0,0,0,0,0,0,2,75,22,88810,35161,7125,47599,0
238,5010,8,5,5,2,0,1,10,0,0,0,0,0,0,0,0,0,0,0,0,2,75,22,88810,35161,7125,47600,0
238,5010,1217,716,841,84,126,174,1301,14,185,118,215,199,333,1446,2542,8,20687,1149,0,2,75,22,88820,35163,7125,47601,0
238,5010,160,89,115,0,13,31,160,7,15,11,17,22,28,78,124,3,495,27,0,2,75,22,88820,35163,7125,47602,0
238,5010,10,10,9,9,0,0,19,0,0,0,0,0,0,0,0,0,0,0,0,2,75,22,88820,35163,7126,47603,0
238,5010,173,84,99,8,29,36,181,5,12,7,13,17,20,54,81,2,221,12,0,2,75,22,88820,35164,7126,47604,0
238,5010,3,1,1,3,0,0,6,0,0,0,0,0,0,0,0,0,0,0,0,2,75,22,88820,35164,7126,47605,0
56,780,167,116,138,4,5,22,171,8,48,30,56,56,86,292,499,4,2330,129,0,2,3,4,88820,35164,7126,47606,0
101,2578,1455,414,1257,16,76,112,1471,5,41,23,46,46,69,231,381,2,1069,59,0,2,91,24,88820,35165,7126,47608,0
101,2578,669,365,481,22,61,110,691,15,103,63,122,118,185,747,1273,8,11311,628,0,2,91,24,88830,35165,7127,47609,0
250,5807,4293,999,3693,19,54,507,4312,9,155,88,170,164,258,1156,1898,4,9368,520,0,2,13,14,88830,35167,7127,47610,0
250,5807,1482,859,1002,125,135,219,1607,16,219,134,251,235,385,1766,3032,9,27804,1544,1,2,13,14,88840,35168,7127,47611,0
31,1080,74,35,59,1,0,14,75,3,14,7,14,17,21,58,85,1,128,7,0,2,1,1,88840,35169,7127,47612,0
31,1080,245,125,200,5,7,34,250,7,30,17,34,37,51,166,265,3,1053,58,0,2,1,1,88850,35170,7127,47613,0
54,640,647,139,84,35,284,233,682,0,0,0,0,0,0,0,0,0,0,0,0,2,0,22,88850,35170,7127,47614,0
117,3166,1523,757,1297,19,12,193,1542,12,193,117,230,205,347,1508,2664,7,19053,1058,0,2,14,11,88860,35172,7127,47615,0
117,3166,701,378,504,33,58,109,734,13,110,68,126,123,194,794,1346,7,10027,557,0,2,14,11,88860,35173,7128,47616,0
142,3472,77,34,69,0,0,8,77,3,24,16,29,27,45,114,213,1,387,21,0,2,0,22,88860,35173,7128,47617,0
142,3472,712,438,573,51,9,84,763,14,102,71,128,116,199,733,1364,8,11988,666,0,2,0,22,88870,35174,7128,47618,0
70,1522,402,202,227,24,74,80,426,12,52,33,61,64,94,339,564,7,3969,220,0,2,6,14,88870,35175,7128,47619,0
12,177,424,94,331,4,0,89,428,1,5,5,5,6,10,11,25,0,12,0,0,2,0,25,88870,35176,7128,47620,0
12,177,38,23,23,6,0,8,44,3,11,7,11,14,18,42,68,1,102,5,0,2,0,25,88870,35176,7128,47621,0
12,572,205,80,86,16,53,53,221,7,18,10,19,25,29,94,134,3,497,27,0,2,24,10,88880,35176,7129,47622,0
225,5745,722,423,573,19,0,135,741,12,172,101,199,184,300,1320,2257,6,15668,870,0,2,11,9,88880,35178,7129,47624,0
225,5745,1508,847,911,44,250,301,1552,14,148,88,169,162,257,1120,1886,7,15077,837,0,2,11,9,88880,35179,7130,47625,0
303,6685,72,33,56,0,4,12,72,1,1,1,1,2,2,0,2,0,1,0,0,2,47,82,88880,35179,7130,47626,0
303,6685,1454,835,1044,76,110,219,1530,17,275,158,296,292,454,2297,3718,9,34017,1889,1,2,47,82,88890,35180,7130,47627,0
79,1967,757,253,292,73,244,162,830,13,61,38,67,74,105,409,651,7,4654,258,0,2,80,44,88890,35181,7130,47628,0
20,993,386,256,301,16,9,68,402,4,59,35,69,63,104,355,621,2,1453,80,0,2,97,44,88890,35181,7130,47629,0
20,993,264,131,164,11,41,46,275,6,38,22,40,44,62,214,338,3,1068,59,0,2,97,44,88900,35181,7131,47630,0
87,1891,1043,504,840,53,9,147,1096,9,180,112,198,189,310,1377,2344,4,11604,644,0,2,8,13,88900,35183,7131,47631,0
87,1891,383,288,292,26,6,62,409,11,65,38,67,76,105,429,656,5,3719,206,0,2,8,13,88900,35184,7131,47632,0
282,5904,1943,715,1694,26,18,214,1969,12,185,120,237,197,357,1436,2721,7,20915,1161,0,2,11,1,88900,35186,7131,47633,0
282,5904,1168,838,957,57,25,144,1225,19,348,224,416,367,640,3018,5452,11,61921,3440,1,2,11,1,88910,35188,7131,47634,0
18,638,442,244,305,14,16,103,456,11,68,45,75,79,120,452,756,6,4588,254,0,2,0,15,88910,35190,7131,47635,0
18,638,182,102,99,11,40,35,193,3,11,6,11,14,17,42,64,1,97,5,0,2,0,15,88910,35191,7131,47636,0
70,1371,1098,241,925,5,10,155,1103,7,46,25,49,53,74,273,423,3,1580,87,0,2,9,0,88920,35193,7131,47637,0
70,1371,282,202,222,14,2,44,296,8,42,24,43,50,67,250,378,4,1548,86,0,2,9,0,88920,35194,7131,47638,0
2,173,37,13,25,0,6,6,37,1,2,1,2,3,3,2,4,0,2,0,0,2,0,10,88920,35194,7131,47639,0
2,173,133,47,40,1,43,49,134,0,0,0,0,0,0,0,0,0,0,0,0,2,0,10,88920,35194,7131,47640,0
23,615,601,196,481,2,23,85,603,8,63,36,72,71,108,400,664,4,3036,168,0,2,0,5,88920,35194,7131,47641,0
23,615,156,79,106,5,16,28,161,5,14,8,15,19,23,64,97,2,261,14,0,2,0,5,88920,35194,7131,47642,0
107,4624,1289,550,1043,56,32,155,1345,10,167,93,185,177,278,1266,2075,5,11498,638,0,2,3,6,88920,35196,7132,47643,0
152,7195,1392,870,1177,35,17,170,1427,14,494,280,531,508,811,4473,7289,7,54850,3047,2,2,9,1,88920,35199,7133,47644,0
4,181,75,38,59,1,3,12,76,2,4,2,4,6,6,10,15,1,15,0,0,2,0,173,88920,35199,7133,47645,0
14,343,149,95,105,2,0,41,151,8,54,28,55,62,83,334,494,4,2013,111,0,2,12,1,88920,35199,7133,47647,0
42,2613,1157,318,931,29,22,177,1186,6,104,63,125,110,188,712,1274,3,4596,255,0,2,1,1,88920,35199,7133,47648,0
176,7695,4293,999,3693,19,54,507,4312,9,155,88,170,164,258,1156,1898,4,9368,520,0,2,28,47,88920,35201,7133,47649,0
176,7695,1482,859,1002,125,135,219,1607,16,219,134,251,235,385,1766,3032,9,27804,1544,1,2,28,47,88930,35202,7133,47650,0
147,5933,1782,648,1425,9,47,279,1791,8,171,97,189,179,286,1292,2140,4,9462,525,0,2,24,14,88930,35203,7134,47651,0
30,903,256,139,192,9,7,47,265,4,23,12,24,27,36,112,171,2,357,19,0,2,14,34,88930,35204,7134,47652,0
121,4918,1450,624,1228,12,26,181,1462,14,306,186,354,320,540,2580,4493,8,36391,2021,1,2,2,1,88930,35206,7135,47653,0
183,5967,1660,832,1314,41,38,274,1701,20,312,209,395,332,604,2671,5058,12,64042,3557,1,2,10,0,88930,35208,7136,47655,0
110,5948,1457,730,1242,11,6,188,1468,10,292,166,329,302,495,2424,4078,5,22973,1276,1,2,165,4,88930,35210,7136,47656,0
81,3729,1455,414,1257,16,76,112,1471,5,41,23,46,46,69,231,381,2,1069,59,0,2,149,0,88930,35211,7136,47657,0
2,48,7,6,5,0,0,2,7,1,1,1,2,2,3,0,3,1,3,0,0,2,1,1,88930,35211,7136,47658,0
113,5691,1523,757,1297,19,12,193,1542,12,193,117,230,205,347,1508,2664,7,19053,1058,0,2,236,114,88940,35213,7136,47659,0
69,3090,1020,354,843,12,15,144,1032,8,134,77,144,142,221,970,1580,4,6792,377,0,2,5,23,88940,35213,7136,47660,0
55,2824,722,423,573,19,0,135,741,12,172,101,199,184,300,1320,2257,6,15668,870,0,2,2,3,88940,35215,7136,47662,0
46,1968,386,256,301,16,9,68,402,4,59,35,69,63,104,355,621,2,1453,80,0,2,16,16,88940,35215,7136,47663,0
112,6136,1943,715,1694,26,18,214,1969,12,185,120,237,197,357,1436,2721,7,20915,1161,0,2,18,1,88940,35217,7136,47664,0
39,1770,442,244,305,14,16,103,456,11,68,45,75,79,120,452,756,6,4588,254,0,2,4,11,88940,35219,7136,47665,0
51,2032,1098,241,925,5,10,155,1103,7,46,25,49,53,74,273,423,3,1580,87,0,2,1,3,88950,35221,7136,47666,0
49,1706,601,196,481,2,23,85,603,8,63,36,72,71,108,400,664,4,3036,168,0,2,8,31,88950,35221,7136,47667,0
183,5407,1660,832,1314,41,38,274,1701,20,312,209,395,332,604,2671,5058,12,64042,3557,1,2,2,1,88950,35223,7137,47669,0
183,5407,1057,646,719,113,100,145,1170,18,215,134,248,233,382,1740,3004,10,31186,1732,1,2,2,1,88960,35224,7138,47670,0
216,4979,182,127,129,0,0,53,182,5,39,21,42,44,63,217,343,2,926,51,0,2,17,10,88960,35224,7139,47671,1
216,4979,1165,710,800,67,119,181,1232,18,243,153,282,261,435,2000,3492,10,36473,2026,1,2,17,10,88970,35224,7140,47672,1
67,1549,773,419,590,28,0,166,801,10,204,113,217,214,330,1598,2554,5,13587,754,0,2,7,6,88970,35224,7141,47673,1
67,1549,421,273,302,44,34,57,465,17,81,59,107,98,166,583,1098,11,12329,684,0,2,7,6,88970,35224,7142,47674,1
27,568,2,2,2,0,0,0,2,0,0,0,0,0,0,0,0,0,0,0,0,2,8,3,88970,35224,7142,47674,1
27,568,99,48,90,1,3,5,100,0,0,0,0,0,0,0,0,0,0,0,0,2,8,3,88970,35225,7142,47675,1
27,568,8,5,5,2,0,1,10,0,0,0,0,0,0,0,0,0,0,0,0,2,8,3,88970,35225,7142,47676,1
27,568,1217,716,841,84,126,174,1301,14,185,118,215,199,333,1446,2542,8,20687,1149,0,2,8,3,88980,35227,7142,47677,1
27,568,160,89,115,0,13,31,160,7,15,11,17,22,28,78,124,3,495,27,0,2,8,3,88980,35227,7142,47678,1
27,568,10,10,9,9,0,0,19,0,0,0,0,0,0,0,0,0,0,0,0,2,8,3,88980,35227,7143,47679,1
27,568,173,84,99,8,29,36,181,5,12,7,13,17,20,54,81,2,221,12,0,2,8,3,88980,35228,7143,47680,1
27,568,3,1,1,3,0,0,6,0,0,0,0,0,0,0,0,0,0,0,0,2,8,3,88980,35228,7143,47681,1
183,5421,1660,832,1314,41,38,274,1701,20,312,209,395,332,604,2671,5058,12,64042,3557,1,2,26,21,88980,35230,7144,47683,1
183,5421,1057,646,719,113,100,145,1170,18,215,134,248,233,382,1740,3004,10,31186,1732,1,2,26,21,88990,35231,7145,47684,1
114,2099,477,336,357,30,23,73,507,16,194,134,250,210,384,1538,2962,10,30538,1696,0,2,9,6,89000,35232,7145,47685,1
238,5067,2,2,2,0,0,0,2,0,0,0,0,0,0,0,0,0,0,0,0,2,33,17,89000,35232,7145,47685,1
238,5067,99,48,90,1,3,5,100,0,0,0,0,0,0,0,0,0,0,0,0,2,33,17,89000,35233,7145,47686,1
238,5067,8,5,5,2,0,1,10,0,0,0,0,0,0,0,0,0,0,0,0,2,33,17,89000,35233,7145,47687,1
238,5067,1217,716,841,84,126,174,1301,14,185,118,215,199,333,1446,2542,8,20687,1149,0,2,33,17,89010,35235,7145,47688,1
238,5067,160,89,115,0,13,31,160,7,15,11,17,22,28,78,124,3,495,27,0,2,33,17,89010,35235,7145,47689,1
238,5067,10,10,9,9,0,0,19,0,0,0,0,0,0,0,0,0,0,0,0,2,33,17,89010,35235,7146,47690,1
238,5067,173,84,99,8,29,36,181,5,12,7,13,17,20,54,81,2,221,12,0,2,33,17,89010,35236,7146,47691,1
238,5067,3,1,1,3,0,0,6,0,0,0,0,0,0,0,0,0,0,0,0,2,33,17,89010,35236,7146,47692,1
111,2283,463,295,324,28,62,57,491,12,134,82,154,146,236,989,1696,6,11700,650,0,2,24,14,89020,35237,7146,47693,1
37,813,167,116,138,4,5,22,171,8,48,30,56,56,86,292,499,4,2330,129,0,2,11,1,89020,35237,7146,47694,1
30,669,125,97,103,3,0,19,128,9,25,17,27,34,44,144,223,4,1087,60,0,2,2,0,89020,35237,7147,47695,1
70,1526,402,202,227,24,74,80,426,12,52,33,61,64,94,339,564,7,3969,220,0,2,1,1,89020,35238,7147,47696,1
73,1707,53,23,39,0,0,13,53,2,8,4,8,10,12,26,39,1,39,2,0,2,35,17,89020,35238,7147,47697,1
73,1707,515,298,307,33,80,99,548,12,63,44,77,75,121,419,753,7,5527,307,0,2,35,17,89030,35238,7147,47698,1
67,1752,466,257,367,18,25,50,484,7,126,86,171,133,257,898,1813,4,8612,478,0,2,4,3,89030,35238,7147,47699,1
67,1752,507,281,342,29,59,88,536,10,53,29,57,63,86,336,514,5,2764,153,0,2,4,3,89030,35238,7147,47700,1
87,1935,1043,504,840,53,9,147,1096,9,180,112,198,189,310,1377,2344,4,11604,644,0,2,17,5,89030,35240,7147,47701,1
87,1935,383,288,292,26,6,62,409,11,65,38,67,76,105,429,656,5,3719,206,0,2,17,5,89030,35241,7147,47702,1
216,4943,182,127,129,0,0,53,182,5,39,21,42,44,63,217,343,2,926,51,0,2,1,1,89030,35241,7148,47703,0
216,4943,1165,710,800,67,119,181,1232,18,243,153,282,261,435,2000,3492,10,36473,2026,1,2,1,1,89040,35241,7149,47704,0
80,1982,757,253,292,73,244,162,830,13,61,38,67,74,105,409,651,7,4654,258,0,2,12,5,89040,35242,7149,47705,0
21,1008,386,256,301,16,9,68,402,4,59,35,69,63,104,355,621,2,1453,80,0,2,12,6,89040,35242,7149,47706,0
21,1008,264,131,164,11,41,46,275,6,38,22,40,44,62,214,338,3,1068,59,0,2,12,6,89050,35242,7150,47707,0
115,2286,463,295,324,28,62,57,491,12,134,82,154,146,236,989,1696,6,11700,650,0,2,6,0,89060,35243,7150,47708,1
111,6022,1457,730,1242,11,6,188,1468,10,292,166,329,302,495,2424,4078,5,22973,1276,1,2,15,0,89060,35245,7150,47709,1
183,5390,1660,832,1314,41,38,274,1701,20,312,209,395,332,604,2671,5058,12,64042,3557,1,2,1,4,89060,35247,7151,47711,0
183,5390,1057,646,719,113,100,145,1170,18,215,134,248,233,382,1740,3004,10,31186,1732,1,2,1,4,89070,35248,7152,47712,0
122,4961,1450,624,1228,12,26,181,1462,14,306,186,354,320,540,2580,4493,8,36391,2021,1,2,20,0,89070,35250,7153,47713,0
122,4963,1450,624,1228,12,26,181,1462,14,306,186,354,320,540,2580,4493,8,36391,2021,1,2,7,5,89070,35252,7154,47714,0
115,2286,463,295,324,28,62,57,491,12,134,82,154,146,236,989,1696,6,11700,650,0,2,6,0,89080,35253,7154,47715,0
111,6022,1457,730,1242,11,6,188,1468,10,292,166,329,302,495,2424,4078,5,22973,1276,1,2,15,0,89080,35255,7154,47716,0
183,5390,1660,832,1314,41,38,274,1701,20,312,209,395,332,604,2671,5058,12,64042,3557,1,2,1,4,89080,35257,7155,47718,0
183,5390,1057,646,719,113,100,145,1170,18,215,134,248,233,382,1740,3004,10,31186,1732,1,2,1,4,89090,35258,7156,47719,0
122,4963,1450,624,1228,12,26,181,1462,14,306,186,354,320,540,2580,4493,8,36391,2021,1,2,27,5,89090,35260,7157,47720,0
57,1141,207,111,150,11,0,50,218,5,26,19,36,31,55,133,272,3,943,52,0,2,2,2,89090,35260,7157,47721,1
57,1141,410,198,237,31,55,97,441,11,63,38,72,74,110,414,683,6,4293,238,0,2,2,2,89100,35261,7158,47722,1
57,1141,207,111,150,11,0,50,218,5,26,19,36,31,55,133,272,3,943,52,0,2,2,2,89100,35261,7158,47723,0
57,1141,410,198,237,31,55,97,441,11,63,38,72,74,110,414,683,6,4293,238,0,2,2,2,89110,35262,7159,47724,0
58,1166,207,111,150,11,0,50,218,5,26,19,36,31,55,133,272,3,943,52,0,2,7,0,89110,35262,7159,47725,0
58,1166,410,198,237,31,55,97,441,11,63,38,72,74,110,414,683,6,4293,238,0,2,7,0,89120,35263,7160,47726,0
79,1961,757,253,292,73,244,162,830,13,61,38,67,74,105,409,651,7,4654,258,0,2,1,7,89120,35264,7160,47727,0
20,987,386,256,301,16,9,68,402,4,59,35,69,63,104,355,621,2,1453,80,0,2,1,7,89120,35264,7160,47728,0
20,987,264,131,164,11,41,46,275,6,38,22,40,44,62,214,338,3,1068,59,0,2,1,7,89130,35264,7161,47729,0
252,5831,4293,999,3693,19,54,507,4312,9,155,88,170,164,258,1156,1898,4,9368,520,0,2,4,0,89130,35266,7161,47730,0
252,5831,1482,859,1002,125,135,219,1607,16,219,134,251,235,385,1766,3032,9,27804,1544,1,2,4,0,89140,35267,7161,47731,0
177,7730,4293,999,3693,19,54,507,4312,9,155,88,170,164,258,1156,1898,4,9368,520,0,2,29,0,89140,35269,7161,47732,0
177,7730,1482,859,1002,125,135,219,1607,16,219,134,251,235,385,1766,3032,9,27804,1544,1,2,29,0,89150,35270,7161,47733,0
30,911,256,139,192,9,7,47,265,4,23,12,24,27,36,112,171,2,357,19,0,2,8,9,89150,35271,7161,47734,0
30,919,256,139,192,9,7,47,265,4,23,12,24,27,36,112,171,2,357,19,0,2,3,2,89150,35272,7161,47735,0
58,1166,207,111,150,11,0,50,218,5,26,19,36,31,55,133,272,3,943,52,0,2,1,1,89150,35272,7161,47736,0
58,1166,410,198,237,31,55,97,441,11,63,38,72,74,110,414,683,6,4293,238,0,2,1,1,89160,35273,7162,47737,0
30,919,256,139,192,9,7,47,265,4,23,12,24,27,36,112,171,2,357,19,0,2,1,1,89160,35274,7162,47738,0
216,4979,182,127,129,0,0,53,182,5,39,21,42,44,63,217,343,2,926,51,0,2,17,10,89160,35274,7163,47739,0
216,4979,1165,710,800,67,119,181,1232,18,243,153,282,261,435,2000,3492,10,36473,2026,1,2,17,10,89170,35274,7164,47740,0
67,1549,773,419,590,28,0,166,801,10,204,113,217,214,330,1598,2554,5,13587,754,0,2,7,6,89170,35274,7165,47741,0
67,1549,421,273,302,44,34,57,465,17,81,59,107,98,166,583,1098,11,12329,684,0,2,7,6,89170,35274,7166,47742,0
27,568,2,2,2,0,0,0,2,0,0,0,0,0,0,0,0,0,0,0,0,2,8,3,89170,35274,7166,47742,0
27,568,99,48,90,1,3,5,100,0,0,0,0,0,0,0,0,0,0,0,0,2,8,3,89170,35275,7166,47743,0
27,568,8,5,5,2,0,1,10,0,0,0,0,0,0,0,0,0,0,0,0,2,8,3,89170,35275,7166,47744,0
27,568,1217,716,841,84,126,174,1301,14,185,118,215,199,333,1446,2542,8,20687,1149,0,2,8,3,89180,35277,7166,47745,0
27,568,160,89,115,0,13,31,160,7,15,11,17,22,28,78,124,3,495,27,0,2,8,3,89180,35277,7166,47746,0
27,568,10,10,9,9,0,0,19,0,0,0,0,0,0,0,0,0,0,0,0,2,8,3,89180,35277,7167,47747,0
27,568,173,84,99,8,29,36,181,5,12,7,13,17,20,54,81,2,221,12,0,2,8,3,89180,35278,7167,47748,0
27,568,3,1,1,3,0,0,6,0,0,0,0,0,0,0,0,0,0,0,0,2,8,3,89180,35278,7167,47749,0
183,5421,1660,832,1314,41,38,274,1701,20,312,209,395,332,604,2671,5058,12,64042,3557,1,2,28,22,89180,35280,7168,47751,0
183,5421,1057,646,719,113,100,145,1170,18,215,134,248,233,382,1740,3004,10,31186,1732,1,2,28,22,89190,35281,7169,47752,0
114,2099,477,336,357,30,23,73,507,16,194,134,250,210,384,1538,2962,10,30538,1696,0,2,9,6,89200,35282,7169,47753,0
238,5067,2,2,2,0,0,0,2,0,0,0,0,0,0,0,0,0,0,0,0,2,33,17,89200,35282,7169,47753,0
238,5067,99,48,90,1,3,5,100,0,0,0,0,0,0,0,0,0,0,0,0,2,33,17,89200,35283,7169,47754,0
238,5067,8,5,5,2,0,1,10,0,0,0,0,0,0,0,0,0,0,0,0,2,33,17,89200,35283,7169,47755,0
238,5067,1217,716,841,84,126,174,1301,14,185,118,215,199,333,1446,2542,8,20687,1149,0,2,33,17,89210,35285,7169,47756,0
238,5067,160,89,115,0,13,31,160,7,15,11,17,22,28,78,124,3,495,27,0,2,33,17,89210,35285,7169,47757,0
238,5067,10,10,9,9,0,0,19,0,0,0,0,0,0,0,0,0,0,0,0,2,33,17,89210,35285,7170,47758,0
238,5067,173,84,99,8,29,36,181,5,12,7,13,17,20,54,81,2,221,12,0,2,33,17,89210,35286,7170,47759,0
238,5067,3,1,1,3,0,0,6,0,0,0,0,0,0,0,0,0,0,0,0,2,33,17,89210,35286,7170,47760,0
113,2326,463,295,324,28,62,57,491,12,134,82,154,146,236,989,1696,6,11700,650,0,2,24,14,89220,35287,7170,47761,0
37,813,167,116,138,4,5,22,171,8,48,30,56,56,86,292,499,4,2330,129,0,2,11,1,89220,35287,7170,47762,0
30,669,125,97,103,3,0,19,128,9,25,17,27,34,44,144,223,4,1087,60,0,2,2,0,89220,35287,7171,47763,0
70,1526,402,202,227,24,74,80,426,12,52,33,61,64,94,339,564,7,3969,220,0,2,1,1,89220,35288,7171,47764,0
73,1707,53,23,39,0,0,13,53,2,8,4,8,10,12,26,39,1,39,2,0,2,35,17,89220,35288,7171,47765,0
73,1707,515,298,307,33,80,99,548,12,63,44,77,75,121,419,753,7,5527,307,0,2,35,17,89230,35288,7171,47766,0
67,1752,466,257,367,18,25,50,484,7,126,86,171,133,257,898,1813,4,8612,478,0,2,4,3,89230,35288,7171,47767,0
67,1752,507,281,342,29,59,88,536,10,53,29,57,63,86,336,514,5,2764,153,0,2,4,3,89230,35288,7171,47768,0
87,1935,1043,504,840,53,9,147,1096,9,180,112,198,189,310,1377,2344,4,11604,644,0,2,17,5,89230,35290,7171,47769,0
87,1935,383,288,292,26,6,62,409,11,65,38,67,76,105,429,656,5,3719,206,0,2,17,5,89230,35291,7171,47770,0
216,4943,182,127,129,0,0,53,182,5,39,21,42,44,63,217,343,2,926,51,0,2,1,1,89230,35291,7172,47771,0
216,4943,1165,710,800,67,119,181,1232,18,243,153,282,261,435,2000,3492,10,36473,2026,1,2,1,1,89240,35291,7173,47772,0
58,1166,207,111,150,11,0,50,218,5,26,19,36,31,55,133,272,3,943,52,0,2,7,0,89240,35291,7173,47773,0
58,1166,410,198,237,31,55,97,441,11,63,38,72,74,110,414,683,6,4293,238,0,2,7,0,89250,35292,7174,47774,0
79,1961,757,253,292,73,244,162,830,13,61,38,67,74,105,409,651,7,4654,258,0,2,7,6,89250,35293,7174,47775,0
20,987,386,256,301,16,9,68,402,4,59,35,69,63,104,355,621,2,1453,80,0,2,7,7,89250,35293,7174,47776,0
20,987,264,131,164,11,41,46,275,6,38,22,40,44,62,214,338,3,1068,59,0,2,7,7,89260,35293,7175,47777,0
30,919,256,139,192,9,7,47,265,4,23,12,24,27,36,112,171,2,357,19,0,2,8,8,89260,35294,7175,47778,0
15,481,184,100,137,2,15,30,186,6,38,20,39,44,59,214,322,3,991,55,0,2,1,1,89260,35295,7175,47779,0
15,481,103,65,74,8,5,16,111,7,17,9,17,24,26,89,119,3,417,23,0,2,1,1,89260,35296,7175,47780,0
11,492,184,100,137,2,15,30,186,6,38,20,39,44,59,214,322,3,991,55,0,2,12,0,89260,35297,7175,47781,0
15,481,184,100,137,2,15,30,186,6,38,20,39,44,59,214,322,3,991,55,0,2,1,1,89260,35298,7175,47782,0
15,481,103,65,74,8,5,16,111,7,17,9,17,24,26,89,119,3,417,23,0,2,1,1,89260,35299,7175,47783,0
11,492,184,100,137,2,15,30,186,6,38,20,39,44,59,214,322,3,991,55,0,2,12,0,89260,35300,7175,47784,0
75,1811,466,257,367,18,25,50,484,7,126,86,171,133,257,898,1813,4,8612,478,0,2,116,89,89260,35300,7175,47785,0
75,1811,507,281,342,29,59,88,536,10,53,29,57,63,86,336,514,5,2764,153,0,2,116,89,89260,35300,7175,47786,0
31,956,182,127,129,0,0,53,182,5,39,21,42,44,63,217,343,2,926,51,0,2,3,7,89260,35300,7176,47787,0
146,7027,1392,870,1177,35,17,170,1427,14,494,280,531,508,811,4473,7289,7,54850,3047,2,2,158,196,89260,35303,7177,47788,0
15,359,127,75,83,2,11,30,129,4,14,7,14,18,21,61,87,2,175,9,0,2,33,0,89260,35303,7177,47789,0
15,359,652,304,544,16,6,88,668,6,89,51,101,95,152,591,998,3,3399,188,0,2,33,0,89260,35304,7177,47790,0
15,359,2,2,2,0,0,0,2,0,0,0,0,0,0,0,0,0,0,0,0,2,33,0,89260,35304,7177,47790,0
15,359,8,5,5,0,0,3,8,0,0,0,0,0,0,0,0,0,0,0,0,2,33,0,89260,35304,7177,47791,0
15,359,2,2,2,0,0,0,2,0,0,0,0,0,0,0,0,0,0,0,0,2,33,0,89260,35304,7177,47791,0
15,359,14,8,8,0,0,6,14,0,0,0,0,0,0,0,0,0,0,0,0,2,33,0,89260,35304,7177,47792,0
15,359,6,4,4,0,0,2,6,0,0,0,0,0,0,0,0,0,0,0,0,2,33,0,89260,35304,7177,47793,0
15,359,6,4,4,0,0,2,6,1,2,1,2,3,3,2,4,0,2,0,0,2,33,0,89260,35304,7177,47794,0
15,359,6,4,4,0,0,2,6,0,0,0,0,0,0,0,0,0,0,0,0,2,33,0,89260,35304,7177,47795,0
15,359,7,5,5,0,0,2,7,0,0,0,0,0,0,0,0,0,0,0,0,2,33,0,89260,35304,7177,47796,0
15,359,6,4,4,0,0,2,6,0,0,0,0,0,0,0,0,0,0,0,0,2,33,0,89260,35304,7177,47797,0
15,359,10,6,6,0,0,4,10,0,0,0,0,0,0,0,0,0,0,0,0,2,33,0,89260,35304,7177,47798,0
15,359,1,1,1,0,0,0,1,0,0,0,0,0,0,0,0,0,0,0,0,2,33,0,89260,35304,7177,47798,0
15,359,14,10,10,0,0,4,14,1,1,1,1,2,2,0,2,0,1,0,0,2,33,0,89260,35304,7177,47799,0
15,359,46,26,30,3,0,12,49,3,6,3,6,9,9,20,28,1,42,2,0,2,33,0,89270,35304,7177,47800,0
239,5045,2,2,2,0,0,0,2,0,0,0,0,0,0,0,0,0,0,0,0,2,13,6,89270,35304,7177,47800,1
239,5045,99,48,90,1,3,5,100,0,0,0,0,0,0,0,0,0,0,0,0,2,13,6,89270,35305,7177,47801,1
239,5045,8,5,5,2,0,1,10,0,0,0,0,0,0,0,0,0,0,0,0,2,13,6,89270,35305,7177,47802,1
239,5045,1217,716,841,84,126,174,1301,14,185,118,215,199,333,1446,2542,8,20687,1149,0,2,13,6,89280,35307,7177,47803,1
239,5045,160,89,115,0,13,31,160,7,15,11,17,22,28,78,124,3,495,27,0,2,13,6,89280,35307,7177,47804,1
239,5045,10,10,9,9,0,0,19,0,0,0,0,0,0,0,0,0,0,0,0,2,13,6,89280,35307,7178,47805,1
239,5045,173,84,99,8,29,36,181,5,12,7,13,17,20,54,81,2,221,12,0,2,13,6,89280,35308,7178,47806,1
239,5045,3,1,1,3,0,0,6,0,0,0,0,0,0,0,0,0,0,0,0,2,13,6,89280,35308,7178,47807,1
45,2802,652,304,544,16,6,88,668,6,89,51,101,95,152,591,998,3,3399,188,0,2,24,5,89280,35309,7178,47808,1
216,4974,182,127,129,0,0,53,182,5,39,21,42,44,63,217,343,2,926,51,0,2,1,1,89280,35309,7179,47809,0
216,4974,1165,710,800,67,119,181,1232,18,243,153,282,261,435,2000,3492,10,36473,2026,1,2,1,1,89290,35309,7180,47810,0
183,5415,1660,832,1314,41,38,274,1701,20,312,209,395,332,604,2671,5058,12,64042,3557,1,2,1,4,89290,35311,7181,47812,0
183,5415,1057,646,719,113,100,145,1170,18,215,134,248,233,382,1740,3004,10,31186,1732,1,2,1,4,89300,35312,7182,47813,0
58,1166,207,111,150,11,0,50,218,5,26,19,36,31,55,133,272,3,943,52,0,2,9,2,89300,35312,7182,47814,0
58,1166,410,198,237,31,55,97,441,11,63,38,72,74,110,414,683,6,4293,238,0,2,9,2,89310,35313,7183,47815,0
15,481,184,100,137,2,15,30,186,6,38,20,39,44,59,214,322,3,991,55,0,2,1,1,89310,35314,7183,47816,0
15,481,103,65,74,8,5,16,111,7,17,9,17,24,26,89,119,3,417,23,0,2,1,1,89310,35315,7183,47817,0
79,1961,757,253,292,73,244,162,830,13,61,38,67,74,105,409,651,7,4654,258,0,2,7,6,89310,35316,7183,47818,0
20,987,386,256,301,16,9,68,402,4,59,35,69,63,104,355,621,2,1453,80,0,2,7,7,89310,35316,7183,47819,0
20,987,264,131,164,11,41,46,275,6,38,22,40,44,62,214,338,3,1068,59,0,2,7,7,89320,35316,7184,47820,0
176,7695,4293,999,3693,19,54,507,4312,9,155,88,170,164,258,1156,1898,4,9368,520,0,2,10,10,89320,35318,7184,47821,0
176,7695,1482,859,1002,125,135,219,1607,16,219,134,251,235,385,1766,3032,9,27804,1544,1,2,10,10,89330,35319,7184,47822,0
30,919,256,139,192,9,7,47,265,4,23,12,24,27,36,112,171,2,357,19,0,2,8,8,89330,35320,7184,47823,0
122,4963,1450,624,1228,12,26,181,1462,14,306,186,354,320,540,2580,4493,8,36391,2021,1,2,27,5,89330,35322,7185,47824,0
11,492,184,100,137,2,15,30,186,6,38,20,39,44,59,214,322,3,991,55,0,2,12,0,89330,35323,7185,47825,0
216,4974,182,127,129,0,0,53,182,5,39,21,42,44,63,217,343,2,926,51,0,2,1,1,89330,35323,7186,47826,0
216,4974,1165,710,800,67,119,181,1232,18,243,153,282,261,435,2000,3492,10,36473,2026,1,2,1,1,89340,35323,7187,47827,0
183,5415,1660,832,1314,41,38,274,1701,20,312,209,395,332,604,2671,5058,12,64042,3557,1,2,1,4,89340,35325,7188,47829,0
183,5415,1057,646,719,113,100,145,1170,18,215,134,248,233,382,1740,3004,10,31186,1732,1,2,1,4,89350,35326,7189,47830,0
58,1166,207,111,150,11,0,50,218,5,26,19,36,31,55,133,272,3,943,52,0,2,9,2,89350,35326,7189,47831,0
58,1166,410,198,237,31,55,97,441,11,63,38,72,74,110,414,683,6,4293,238,0,2,9,2,89360,35327,7190,47832,0
15,481,184,100,137,2,15,30,186,6,38,20,39,44,59,214,322,3,991,55,0,2,1,1,89360,35328,7190,47833,0
15,481,103,65,74,8,5,16,111,7,17,9,17,24,26,89,119,3,417,23,0,2,1,1,89360,35329,7190,47834,0
79,1961,757,253,292,73,244,162,830,13,61,38,67,74,105,409,651,7,4654,258,0,2,7,6,89360,35330,7190,47835,0
20,987,386,256,301,16,9,68,402,4,59,35,69,63,104,355,621,2,1453,80,0,2,7,7,89360,35330,7190,47836,0
20,987,264,131,164,11,41,46,275,6,38,22,40,44,62,214,338,3,1068,59,0,2,7,7,89370,35330,7191,47837,0
176,7695,4293,999,3693,19,54,507,4312,9,155,88,170,164,258,1156,1898,4,9368,520,0,2,10,10,89370,35332,7191,47838,0
176,7695,1482,859,1002,125,135,219,1607,16,219,134,251,235,385,1766,3032,9,27804,1544,1,2,10,10,89380,35333,7191,47839,0
30,919,256,139,192,9,7,47,265,4,23,12,24,27,36,112,171,2,357,19,0,2,8,8,89380,35334,7191,47840,0
122,4963,1450,624,1228,12,26,181,1462,14,306,186,354,320,540,2580,4493,8,36391,2021,1,2,27,5,89380,35336,7192,47841,0
11,492,184,100,137,2,15,30,186,6,38,20,39,44,59,214,322,3,991,55,0,2,12,0,89380,35337,7192,47842,0
16,491,184,100,137,2,15,30,186,6,38,20,39,44,59,214,322,3,991,55,0,2,9,4,89380,35338,7192,47843,0
16,491,103,65,74,8,5,16,111,7,17,9,17,24,26,89,119,3,417,23,0,2,9,4,89380,35339,7192,47844,0
18,697,184,100,137,2,15,30,186,6,38,20,39,44,59,214,322,3,991,55,0,2,55,1,89380,35340,7192,47845,0
45,2806,652,304,544,16,6,88,668,6,89,51,101,95,152,591,998,3,3399,188,0,2,6,8,89380,35341,7192,47846,1
238,5023,2,2,2,0,0,0,2,0,0,0,0,0,0,0,0,0,0,0,0,2,4,7,89380,35341,7192,47846,1
238,5023,99,48,90,1,3,5,100,0,0,0,0,0,0,0,0,0,0,0,0,2,4,7,89380,35342,7192,47847,1
238,5023,8,5,5,2,0,1,10,0,0,0,0,0,0,0,0,0,0,0,0,2,4,7,89380,35342,7192,47848,1
238,5023,1217,716,841,84,126,174,1301,14,185,118,215,199,333,1446,2542,8,20687,1149,0,2,4,7,89390,35344,7192,47849,1
238,5023,160,89,115,0,13,31,160,7,15,11,17,22,28,78,124,3,495,27,0,2,4,7,89390,35344,7192,47850,1
238,5023,10,10,9,9,0,0,19,0,0,0,0,0,0,0,0,0,0,0,0,2,4,7,89390,35344,7193,47851,1
238,5023,173,84,99,8,29,36,181,5,12,7,13,17,20,54,81,2,221,12,0,2,4,7,89390,35345,7193,47852,1
238,5023,3,1,1,3,0,0,6,0,0,0,0,0,0,0,0,0,0,0,0,2,4,7,89390,35345,7193,47853,1
65,1385,91,45,69,0,3,18,91,3,9,6,10,12,16,33,57,1,95,5,0,2,10,0,89390,35347,7193,47854,1
65,1385,367,234,237,17,34,68,384,16,55,34,61,71,95,381,584,8,5183,287,0,2,10,0,89390,35348,7193,47855,1
45,2806,652,304,544,16,6,88,668,6,89,51,101,95,152,591,998,3,3399,188,0,2,5,5,89390,35349,7193,47856,1
238,5023,2,2,2,0,0,0,2,0,0,0,0,0,0,0,0,0,0,0,0,2,10,6,89390,35349,7193,47856,0
238,5023,99,48,90,1,3,5,100,0,0,0,0,0,0,0,0,0,0,0,0,2,10,6,89390,35350,7193,47857,0
238,5023,8,5,5,2,0,1,10,0,0,0,0,0,0,0,0,0,0,0,0,2,10,6,89390,35350,7193,47858,0
238,5023,1217,716,841,84,126,174,1301,14,185,118,215,199,333,1446,2542,8,20687,1149,0,2,10,6,89400,35352,7193,47859,0
238,5023,160,89,115,0,13,31,160,7,15,11,17,22,28,78,124,3,495,27,0,2,10,6,89400,35352,7193,47860,0
238,5023,10,10,9,9,0,0,19,0,0,0,0,0,0,0,0,0,0,0,0,2,10,6,89400,35352,7194,47861,0
238,5023,173,84,99,8,29,36,181,5,12,7,13,17,20,54,81,2,221,12,0,2,10,6,89400,35353,7194,47862,0
238,5023,3,1,1,3,0,0,6,0,0,0,0,0,0,0,0,0,0,0,0,2,10,6,89400,35353,7194,47863,0
65,1385,91,45,69,0,3,18,91,3,9,6,10,12,16,33,57,1,95,5,0,2,10,0,89400,35355,7194,47864,0
65,1385,367,234,237,17,34,68,384,16,55,34,61,71,95,381,584,8,5183,287,0,2,10,0,89400,35356,7194,47865,0
45,2806,652,304,544,16,6,88,668,6,89,51,101,95,152,591,998,3,3399,188,0,2,21,4,89400,35357,7194,47866,0
252,5837,4293,999,3693,19,54,507,4312,9,155,88,170,164,258,1156,1898,4,9368,520,0,2,5,2,89400,35359,7194,47867,0
252,5837,1482,859,1002,125,135,219,1607,16,219,134,251,235,385,1766,3032,9,27804,1544,1,2,5,2,89410,35360,7194,47868,0
177,7722,4293,999,3693,19,54,507,4312,9,155,88,170,164,258,1156,1898,4,9368,520,0,2,44,1,89410,35362,7194,47869,0
177,7722,1482,859,1002,125,135,219,1607,16,219,134,251,235,385,1766,3032,9,27804,1544,1,2,44,1,89420,35363,7194,47870,0
79,1938,466,257,367,18,25,50,484,7,126,86,171,133,257,898,1813,4,8612,478,0,2,46,19,89420,35363,7194,47871,0
79,1938,507,281,342,29,59,88,536,10,53,29,57,63,86,336,514,5,2764,153,0,2,46,19,89420,35363,7194,47872,0
31,1843,466,257,367,18,25,50,484,7,126,86,171,133,257,898,1813,4,8612,478,0,2,72,2,89420,35363,7194,47873,0
16,491,184,100,137,2,15,30,186,6,38,20,39,44,59,214,322,3,991,55,0,2,9,4,89420,35364,7194,47874,0
16,491,103,65,74,8,5,16,111,7,17,9,17,24,26,89,119,3,417,23,0,2,9,4,89420,35365,7194,47875,0
18,697,184,100,137,2,15,30,186,6,38,20,39,44,59,214,322,3,991,55,0,2,55,1,89420,35366,7194,47876,0
79,1938,466,257,367,18,25,50,484,7,126,86,171,133,257,898,1813,4,8612,478,0,2,143,89,89420,35366,7194,47877,0
79,1938,507,281,342,29,59,88,536,10,53,29,57,63,86,336,514,5,2764,153,0,2,143,89,89420,35366,7194,47878,0
31,956,182,127,129,0,0,53,182,5,39,21,42,44,63,217,343,2,926,51,0,2,3,7,89420,35366,7195,47879,0
146,7027,1392,870,1177,35,17,170,1427,14,494,280,531,508,811,4473,7289,7,54850,3047,2,2,158,196,89420,35369,7196,47880,0
15,359,127,75,83,2,11,30,129,4,14,7,14,18,21,61,87,2,175,9,0,2,33,0,89420,35369,7196,47881,0
15,359,652,304,544,16,6,88,668,6,89,51,101,95,152,591,998,3,3399,188,0,2,33,0,89420,35370,7196,47882,0
15,359,2,2,2,0,0,0,2,0,0,0,0,0,0,0,0,0,0,0,0,2,33,0,89420,35370,7196,47882,0
15,359,8,5,5,0,0,3,8,0,0,0,0,0,0,0,0,0,0,0,0,2,33,0,89420,35370,7196,47883,0
15,359,2,2,2,0,0,0,2,0,0,0,0,0,0,0,0,0,0,0,0,2,33,0,89420,35370,7196,47883,0
15,359,14,8,8,0,0,6,14,0,0,0,0,0,0,0,0,0,0,0,0,2,33,0,89420,35370,7196,47884,0
15,359,6,4,4,0,0,2,6,0,0,0,0,0,0,0,0,0,0,0,0,2,33,0,89420,35370,7196,47885,0
15,359,6,4,4,0,0,2,6,1,2,1,2,3,3,2,4,0,2,0,0,2,33,0,89420,35370,7196,47886,0
15,359,6,4,4,0,0,2,6,0,0,0,0,0,0,0,0,0,0,0,0,2,33,0,89420,35370,7196,47887,0
15,359,7,5,5,0,0,2,7,0,0,0,0,0,0,0,0,0,0,0,0,2,33,0,89420,35370,7196,47888,0
15,359,6,4,4,0,0,2,6,0,0,0,0,0,0,0,0,0,0,0,0,2,33,0,89420,35370,7196,47889,0
15,359,10,6,6,0,0,4,10,0,0,0,0,0,0,0,0,0,0,0,0,2,33,0,89420,35370,7196,47890,0
15,359,1,1,1,0,0,0,1,0,0,0,0,0,0,0,0,0,0,0,0,2,33,0,89420,35370,7196,47890,0
15,359,14,10,10,0,0,4,14,1,1,1,1,2,2,0,2,0,1,0,0,2,33,0,89420,35370,7196,47891,0
15,359,46,26,30,3,0,12,49,3,6,3,6,9,9,20,28,1,42,2,0,2,33,0,89430,35370,7196,47892,0
31,1843,466,257,367,18,25,50,484,7,126,86,171,133,257,898,1813,4,8612,478,0,2,72,2,89430,35370,7196,47893,0
177,7723,4293,999,3693,19,54,507,4312,9,155,88,170,164,258,1156,1898,4,9368,520,0,2,28,18,89430,35372,7196,47894,0
177,7723,1482,859,1002,125,135,219,1607,16,219,134,251,235,385,1766,3032,9,27804,1544,1,2,28,18,89440,35373,7196,47895,0
252,5831,4293,999,3693,19,54,507,4312,9,155,88,170,164,258,1156,1898,4,9368,520,0,2,2,0,89440,35375,7196,47896,0
252,5831,1482,859,1002,125,135,219,1607,16,219,134,251,235,385,1766,3032,9,27804,1544,1,2,2,0,89450,35376,7196,47897,0
177,7731,4293,999,3693,19,54,507,4312,9,155,88,170,164,258,1156,1898,4,9368,520,0,2,3,0,89450,35378,7196,47898,0
177,7731,1482,859,1002,125,135,219,1607,16,219,134,251,235,385,1766,3032,9,27804,1544,1,2,3,0,89460,35379,7196,47899,0
216,4943,182,127,129,0,0,53,182,5,39,21,42,44,63,217,343,2,926,51,0,2,1,1,89460,35379,7197,47900,0
216,4943,1165,710,800,67,119,181,1232,18,243,153,282,261,435,2000,3492,10,36473,2026,1,2,1,1,89470,35379,7198,47901,0
58,1166,207,111,150,11,0,50,218,5,26,19,36,31,55,133,272,3,943,52,0,2,7,0,89470,35379,7198,47902,0
58,1166,410,198,237,31,55,97,441,11,63,38,72,74,110,414,683,6,4293,238,0,2,7,0,89480,35380,7199,47903,0
238,5023,2,2,2,0,0,0,2,0,0,0,0,0,0,0,0,0,0,0,0,2,10,6,89480,35380,7199,47903,0
238,5023,99,48,90,1,3,5,100,0,0,0,0,0,0,0,0,0,0,0,0,2,10,6,89480,35381,7199,47904,0
238,5023,8,5,5,2,0,1,10,0,0,0,0,0,0,0,0,0,0,0,0,2,10,6,89480,35381,7199,47905,0
238,5023,1217,716,841,84,126,174,1301,14,185,118,215,199,333,1446,2542,8,20687,1149,0,2,10,6,89490,35383,7199,47906,0
238,5023,160,89,115,0,13,31,160,7,15,11,17,22,28,78,124,3,495,27,0,2,10,6,89490,35383,7199,47907,0
238,5023,10,10,9,9,0,0,19,0,0,0,0,0,0,0,0,0,0,0,0,2,10,6,89490,35383,7200,47908,0
238,5023,173,84,99,8,29,36,181,5,12,7,13,17,20,54,81,2,221,12,0,2,10,6,89490,35384,7200,47909,0
238,5023,3,1,1,3,0,0,6,0,0,0,0,0,0,0,0,0,0,0,0,2,10,6,89490,35384,7200,47910,0
15,481,184,100,137,2,15,30,186,6,38,20,39,44,59,214,322,3,991,55,0,2,1,1,89490,35385,7200,47911,0
15,481,103,65,74,8,5,16,111,7,17,9,17,24,26,89,119,3,417,23,0,2,1,1,89490,35386,7200,47912,0
65,1385,91,45,69,0,3,18,91,3,9,6,10,12,16,33,57,1,95,5,0,2,10,0,89490,35388,7200,47913,0
65,1385,367,234,237,17,34,68,384,16,55,34,61,71,95,381,584,8,5183,287,0,2,10,0,89490,35389,7200,47914,0
79,1961,757,253,292,73,244,162,830,13,61,38,67,74,105,409,651,7,4654,258,0,2,7,6,89490,35390,7200,47915,0
20,987,386,256,301,16,9,68,402,4,59,35,69,63,104,355,621,2,1453,80,0,2,7,7,89490,35390,7200,47916,0
20,987,264,131,164,11,41,46,275,6,38,22,40,44,62,214,338,3,1068,59,0,2,7,7,89500,35390,7201,47917,0
79,1938,466,257,367,18,25,50,484,7,126,86,171,133,257,898,1813,4,8612,478,0,2,143,89,89500,35390,7201,47918,0
79,1938,507,281,342,29,59,88,536,10,53,29,57,63,86,336,514,5,2764,153,0,2,143,89,89500,35390,7201,47919,0
31,956,182,127,129,0,0,53,182,5,39,21,42,44,63,217,343,2,926,51,0,2,3,7,89500,35390,7202,47920,0
146,7027,1392,870,1177,35,17,170,1427,14,494,280,531,508,811,4473,7289,7,54850,3047,2,2,158,196,89500,35393,7203,47921,0
15,359,127,75,83,2,11,30,129,4,14,7,14,18,21,61,87,2,175,9,0,2,33,0,89500,35393,7203,47922,0
15,359,652,304,544,16,6,88,668,6,89,51,101,95,152,591,998,3,3399,188,0,2,33,0,89500,35394,7203,47923,0
15,359,2,2,2,0,0,0,2,0,0,0,0,0,0,0,0,0,0,0,0,2,33,0,89500,35394,7203,47923,0
15,359,8,5,5,0,0,3,8,0,0,0,0,0,0,0,0,0,0,0,0,2,33,0,89500,35394,7203,47924,0
15,359,2,2,2,0,0,0,2,0,0,0,0,0,0,0,0,0,0,0,0,2,33,0,89500,35394,7203,47924,0
15,359,14,8,8,0,0,6,14,0,0,0,0,0,0,0,0,0,0,0,0,2,33,0,89500,35394,7203,47925,0
15,359,6,4,4,0,0,2,6,0,0,0,0,0,0,0,0,0,0,0,0,2,33,0,89500,35394,7203,47926,0
15,359,6,4,4,0,0,2,6,1,2,1,2,3,3,2,4,0,2,0,0,2,33,0,89500,35394,7203,47927,0
15,359,6,4,4,0,0,2,6,0,0,0,0,0,0,0,0,0,0,0,0,2,33,0,89500,35394,7203,47928,0
15,359,7,5,5,0,0,2,7,0,0,0,0,0,0,0,0,0,0,0,0,2,33,0,89500,35394,7203,47929,0
15,359,6,4,4,0,0,2,6,0,0,0,0,0,0,0,0,0,0,0,0,2,33,0,89500,35394,7203,47930,0
15,359,10,6,6,0,0,4,10,0,0,0,0,0,0,0,0,0,0,0,0,2,33,0,89500,35394,7203,47931,0
15,359,1,1,1,0,0,0,1,0,0,0,0,0,0,0,0,0,0,0,0,2,33,0,89500,35394,7203,47931,0
15,359,14,10,10,0,0,4,14,1,1,1,1,2,2,0,2,0,1,0,0,2,33,0,89500,35394,7203,47932,0
15,359,46,26,30,3,0,12,49,3,6,3,6,9,9,20,28,1,42,2,0,2,33,0,89510,35394,7203,47933,0
30,919,256,139,192,9,7,47,265,4,23,12,24,27,36,112,171,2,357,19,0,2,8,8,89510,35395,7203,47934,0
45,2806,652,304,544,16,6,88,668,6,89,51,101,95,152,591,998,3,3399,188,0,2,21,4,89510,35396,7203,47935,0
11,492,184,100,137,2,15,30,186,6,38,20,39,44,59,214,322,3,991,55,0,2,12,0,89510,35397,7203,47936,0
31,1843,466,257,367,18,25,50,484,7,126,86,171,133,257,898,1813,4,8612,478,0,2,72,2,89510,35397,7203,47937,0
252,5837,4293,999,3693,19,54,507,4312,9,155,88,170,164,258,1156,1898,4,9368,520,0,2,5,2,89510,35399,7203,47938,0
252,5837,1482,859,1002,125,135,219,1607,16,219,134,251,235,385,1766,3032,9,27804,1544,1,2,5,2,89520,35400,7203,47939,0
177,7723,4293,999,3693,19,54,507,4312,9,155,88,170,164,258,1156,1898,4,9368,520,0,2,54,1,89520,35402,7203,47940,0
177,7723,1482,859,1002,125,135,219,1607,16,219,134,251,235,385,1766,3032,9,27804,1544,1,2,54,1,89530,35403,7203,47941,0
254,5861,4293,999,3693,19,54,507,4312,9,155,88,170,164,258,1156,1898,4,9368,520,0,2,6,0,89530,35405,7203,47942,0
254,5861,1482,859,1002,125,135,219,1607,16,219,134,251,235,385,1766,3032,9,27804,1544,1,2,6,0,89540,35406,7203,47943,0
178,7759,4293,999,3693,19,54,507,4312,9,155,88,170,164,258,1156,1898,4,9368,520,0,2,32,0,89540,35408,7203,47944,0
178,7759,1482,859,1002,125,135,219,1607,16,219,134,251,235,385,1766,3032,9,27804,1544,1,2,32,0,89550,35409,7203,47945,0
16,491,184,100,137,2,15,30,186,6,38,20,39,44,59,214,322,3,991,55,0,2,1,1,89550,35410,7203,47946,0
16,491,103,65,74,8,5,16,111,7,17,9,17,24,26,89,119,3,417,23,0,2,1,1,89550,35411,7203,47947,0
18,697,184,100,137,2,15,30,186,6,38,20,39,44,59,214,322,3,991,55,0,2,1,1,89550,35412,7203,47948,0
3,65,127,75,83,2,11,30,129,4,14,7,14,18,21,61,87,2,175,9,0,2,1,1,89550,35412,7203,47949,1
3,65,652,304,544,16,6,88,668,6,89,51,101,95,152,591,998,3,3399,188,0,2,1,1,89550,35413,7203,47950,1
3,65,2,2,2,0,0,0,2,0,0,0,0,0,0,0,0,0,0,0,0,2,1,1,89550,35413,7203,47950,1
3,65,8,5,5,0,0,3,8,0,0,0,0,0,0,0,0,0,0,0,0,2,1,1,89550,35413,7203,47951,1
3,65,2,2,2,0,0,0,2,0,0,0,0,0,0,0,0,0,0,0,0,2,1,1,89550,35413,7203,47951,1
3,65,14,8,8,0,0,6,14,0,0,0,0,0,0,0,0,0,0,0,0,2,1,1,89550,35413,7203,47952,1
3,65,6,4,4,0,0,2,6,0,0,0,0,0,0,0,0,0,0,0,0,2,1,1,89550,35413,7203,47953,1
3,65,6,4,4,0,0,2,6,1,2,1,2,3,3,2,4,0,2,0,0,2,1,1,89550,35413,7203,47954,1
3,65,6,4,4,0,0,2,6,0,0,0,0,0,0,0,0,0,0,0,0,2,1,1,89550,35413,7203,47955,1
3,65,7,5,5,0,0,2,7,0,0,0,0,0,0,0,0,0,0,0,0,2,1,1,89550,35413,7203,47956,1
3,65,6,4,4,0,0,2,6,0,0,0,0,0,0,0,0,0,0,0,0,2,1,1,89550,35413,7203,47957,1
3,65,10,6,6,0,0,4,10,0,0,0,0,0,0,0,0,0,0,0,0,2,1,1,89550,35413,7203,47958,1
3,65,1,1,1,0,0,0,1,0,0,0,0,0,0,0,0,0,0,0,0,2,1,1,89550,35413,7203,47958,1
3,65,14,10,10,0,0,4,14,1,1,1,1,2,2,0,2,0,1,0,0,2,1,1,89550,35413,7203,47959,1
3,65,46,26,30,3,0,12,49,3,6,3,6,9,9,20,28,1,42,2,0,2,1,1,89560,35413,7203,47960,1
260,6091,4293,999,3693,19,54,507,4312,9,155,88,170,164,258,1156,1898,4,9368,520,0,2,73,6,89560,35415,7203,47962,1
260,6091,1482,859,1002,125,135,219,1607,16,219,134,251,235,385,1766,3032,9,27804,1544,1,2,73,6,89570,35416,7203,47963,1
180,7835,4293,999,3693,19,54,507,4312,9,155,88,170,164,258,1156,1898,4,9368,520,0,2,113,0,89570,35418,7203,47964,1
180,7835,1482,859,1002,125,135,219,1607,16,219,134,251,235,385,1766,3032,9,27804,1544,1,2,113,0,89580,35419,7203,47965,1
16,491,184,100,137,2,15,30,186,6,38,20,39,44,59,214,322,3,991,55,0,2,1,1,89580,35420,7203,47966,0
16,491,103,65,74,8,5,16,111,7,17,9,17,24,26,89,119,3,417,23,0,2,1,1,89580,35421,7203,47967,0
18,697,184,100,137,2,15,30,186,6,38,20,39,44,59,214,322,3,991,55,0,2,1,1,89580,35422,7203,47968,0
74,3931,1293,570,1093,25,15,163,1318,10,195,123,241,205,364,1516,2795,6,17273,959,0,2,1,1,89590,35424,7203,47969,0
74,3931,1293,570,1093,25,15,163,1318,10,195,123,241,205,364,1516,2795,6,17273,959,0,2,1,1,89600,35426,7203,47970,0
161,3434,1513,682,1277,25,13,200,1538,11,199,116,219,210,335,1557,2584,6,15641,868,0,2,5,1,89600,35428,7203,47971,0
161,3434,819,519,539,24,98,155,843,15,96,57,106,111,163,690,1107,8,9171,509,0,2,5,1,89610,35430,7203,47972,0
161,3434,1513,682,1277,25,13,200,1538,11,199,116,219,210,335,1557,2584,6,15641,868,0,2,5,1,89610,35432,7203,47973,0
161,3434,819,519,539,24,98,155,843,15,96,57,106,111,163,690,1107,8,9171,509,0,2,5,1,89620,35434,7203,47974,0
257,6183,4293,999,3693,19,54,507,4312,9,155,88,170,164,258,1156,1898,4,9368,520,0,2,44,5,89620,35436,7203,47975,0
257,6183,1482,859,1002,125,135,219,1607,16,219,134,251,235,385,1766,3032,9,27804,1544,1,2,44,5,89630,35437,7203,47976,0
238,5010,2,2,2,0,0,0,2,0,0,0,0,0,0,0,0,0,0,0,0,2,6,10,89630,35437,7203,47976,0
238,5010,99,48,90,1,3,5,100,0,0,0,0,0,0,0,0,0,0,0,0,2,6,10,89630,35438,7203,47977,0
238,5010,8,5,5,2,0,1,10,0,0,0,0,0,0,0,0,0,0,0,0,2,6,10,89630,35438,7203,47978,0
238,5010,1217,716,841,84,126,174,1301,14,185,118,215,199,333,1446,2542,8,20687,1149,0,2,6,10,89640,35440,7203,47979,0
238,5010,160,89,115,0,13,31,160,7,15,11,17,22,28,78,124,3,495,27,0,2,6,10,89640,35440,7203,47980,0
238,5010,10,10,9,9,0,0,19,0,0,0,0,0,0,0,0,0,0,0,0,2,6,10,89640,35440,7204,47981,0
238,5010,173,84,99,8,29,36,181,5,12,7,13,17,20,54,81,2,221,12,0,2,6,10,89640,35441,7204,47982,0
238,5010,3,1,1,3,0,0,6,0,0,0,0,0,0,0,0,0,0,0,0,2,6,10,89640,35441,7204,47983,0
64,1354,91,45,69,0,3,18,91,3,9,6,10,12,16,33,57,1,95,5,0,2,0,10,89640,35443,7204,47984,0
64,1354,367,234,237,17,34,68,384,16,55,34,61,71,95,381,584,8,5183,287,0,2,0,10,89640,35444,7204,47985,0
43,2669,652,304,544,16,6,88,668,6,89,51,101,95,152,591,998,3,3399,188,0,2,4,21,89640,35445,7204,47986,0
238,5019,2,2,2,0,0,0,2,0,0,0,0,0,0,0,0,0,0,0,0,2,9,6,89640,35445,7204,47986,0
238,5019,99,48,90,1,3,5,100,0,0,0,0,0,0,0,0,0,0,0,0,2,9,6,89640,35446,7204,47987,0
238,5019,8,5,5,2,0,1,10,0,0,0,0,0,0,0,0,0,0,0,0,2,9,6,89640,35446,7204,47988,0
238,5019,1217,716,841,84,126,174,1301,14,185,118,215,199,333,1446,2542,8,20687,1149,0,2,9,6,89650,35448,7204,47989,0
238,5019,160,89,115,0,13,31,160,7,15,11,17,22,28,78,124,3,495,27,0,2,9,6,89650,35448,7204,47990,0
238,5019,10,10,9,9,0,0,19,0,0,0,0,0,0,0,0,0,0,0,0,2,9,6,89650,35448,7205,47991,0
238,5019,173,84,99,8,29,36,181,5,12,7,13,17,20,54,81,2,221,12,0,2,9,6,89650,35449,7205,47992,0
238,5019,3,1,1,3,0,0,6,0,0,0,0,0,0,0,0,0,0,0,0,2,9,6,89650,35449,7205,47993,0
46,2854,652,304,544,16,6,88,668,6,89,51,101,95,152,591,998,3,3399,188,0,2,30,2,89650,35450,7205,47994,0
238,5019,2,2,2,0,0,0,2,0,0,0,0,0,0,0,0,0,0,0,0,2,8,9,89650,35450,7205,47994,0
238,5019,99,48,90,1,3,5,100,0,0,0,0,0,0,0,0,0,0,0,0,2,8,9,89650,35451,7205,47995,0
238,5019,8,5,5,2,0,1,10,0,0,0,0,0,0,0,0,0,0,0,0,2,8,9,89650,35451,7205,47996,0
238,5019,1217,716,841,84,126,174,1301,14,185,118,215,199,333,1446,2542,8,20687,1149,0,2,8,9,89660,35453,7205,47997,0
238,5019,160,89,115,0,13,31,160,7,15,11,17,22,28,78,124,3,495,27,0,2,8,9,89660,35453,7205,47998,0
238,5019,10,10,9,9,0,0,19,0,0,0,0,0,0,0,0,0,0,0,0,2,8,9,89660,35453,7206,47999,0
238,5019,173,84,99,8,29,36,181,5,12,7,13,17,20,54,81,2,221,12,0,2,8,9,89660,35454,7206,48000,0
238,5019,3,1,1,3,0,0,6,0,0,0,0,0,0,0,0,0,0,0,0,2,8,9,89660,35454,7206,48001,0
64,1354,91,45,69,0,3,18,91,3,9,6,10,12,16,33,57,1,95,5,0,2,0,10,89660,35456,7206,48002,0
64,1354,367,234,237,17,34,68,384,16,55,34,61,71,95,381,584,8,5183,287,0,2,0,10,89660,35457,7206,48003,0
46,2854,652,304,544,16,6,88,668,6,89,51,101,95,152,591,998,3,3399,188,0,2,19,8,89660,35458,7206,48004,0
76,1631,53,23,39,0,0,13,53,2,8,4,8,10,12,26,39,1,39,2,0,2,1,3,89660,35458,7206,48005,0
76,1631,515,298,307,33,80,99,548,12,63,44,77,75,121,419,753,7,5527,307,0,2,1,3,89670,35458,7206,48006,0
146,7064,1392,870,1177,35,17,170,1427,14,494,280,531,508,811,4473,7289,7,54850,3047,2,2,7,0,89670,35461,7207,48007,0
76,1631,53,23,39,0,0,13,53,2,8,4,8,10,12,26,39,1,39,2,0,2,1,3,89670,35461,7207,48008,0
76,1631,515,298,307,33,80,99,548,12,63,44,77,75,121,419,753,7,5527,307,0,2,1,3,89680,35461,7207,48009,0
146,7064,1392,870,1177,35,17,170,1427,14,494,280,531,508,811,4473,7289,7,54850,3047,2,2,7,0,89680,35464,7208,48010,0
161,3434,1513,682,1277,25,13,200,1538,11,199,116,219,210,335,1557,2584,6,15641,868,0,2,5,1,89680,35466,7208,48011,0
161,3434,819,519,539,24,98,155,843,15,96,57,106,111,163,690,1107,8,9171,509,0,2,5,1,89690,35468,7208,48012,0
238,5076,2,2,2,0,0,0,2,0,0,0,0,0,0,0,0,0,0,0,0,2,9,6,89690,35468,7208,48012,0
238,5076,99,48,90,1,3,5,100,0,0,0,0,0,0,0,0,0,0,0,0,2,9,6,89690,35469,7208,48013,0
238,5076,8,5,5,2,0,1,10,0,0,0,0,0,0,0,0,0,0,0,0,2,9,6,89690,35469,7208,48014,0
238,5076,1217,716,841,84,126,174,1301,14,185,118,215,199,333,1446,2542,8,20687,1149,0,2,9,6,89700,35471,7208,48015,0
238,5076,160,89,115,0,13,31,160,7,15,11,17,22,28,78,124,3,495,27,0,2,9,6,89700,35471,7208,48016,0
238,5076,10,10,9,9,0,0,19,0,0,0,0,0,0,0,0,0,0,0,0,2,9,6,89700,35471,7209,48017,0
238,5076,173,84,99,8,29,36,181,5,12,7,13,17,20,54,81,2,221,12,0,2,9,6,89700,35472,7209,48018,0
238,5076,3,1,1,3,0,0,6,0,0,0,0,0,0,0,0,0,0,0,0,2,9,6,89700,35472,7209,48019,0
254,5861,4293,999,3693,19,54,507,4312,9,155,88,170,164,258,1156,1898,4,9368,520,0,2,11,2,89700,35474,7209,48020,0
254,5861,1482,859,1002,125,135,219,1607,16,219,134,251,235,385,1766,3032,9,27804,1544,1,2,11,2,89710,35475,7209,48021,0
73,1701,53,23,39,0,0,13,53,2,8,4,8,10,12,26,39,1,39,2,0,2,1,3,89710,35475,7209,48022,0
73,1701,515,298,307,33,80,99,548,12,63,44,77,75,121,419,753,7,5527,307,0,2,1,3,89720,35475,7209,48023,0
79,1942,466,257,367,18,25,50,484,7,126,86,171,133,257,898,1813,4,8612,478,0,2,143,88,89720,35475,7209,48024,0
79,1942,507,281,342,29,59,88,536,10,53,29,57,63,86,336,514,5,2764,153,0,2,143,88,89720,35475,7209,48025,0
31,956,182,127,129,0,0,53,182,5,39,21,42,44,63,217,343,2,926,51,0,2,3,7,89720,35475,7210,48026,0
146,7064,1392,870,1177,35,17,170,1427,14,494,280,531,508,811,4473,7289,7,54850,3047,2,2,165,196,89720,35478,7211,48027,0
15,359,127,75,83,2,11,30,129,4,14,7,14,18,21,61,87,2,175,9,0,2,33,0,89720,35478,7211,48028,0
15,359,652,304,544,16,6,88,668,6,89,51,101,95,152,591,998,3,3399,188,0,2,33,0,89720,35479,7211,48029,0
15,359,2,2,2,0,0,0,2,0,0,0,0,0,0,0,0,0,0,0,0,2,33,0,89720,35479,7211,48029,0
15,359,8,5,5,0,0,3,8,0,0,0,0,0,0,0,0,0,0,0,0,2,33,0,89720,35479,7211,48030,0
15,359,2,2,2,0,0,0,2,0,0,0,0,0,0,0,0,0,0,0,0,2,33,0,89720,35479,7211,48030,0
15,359,14,8,8,0,0,6,14,0,0,0,0,0,0,0,0,0,0,0,0,2,33,0,89720,35479,7211,48031,0
15,359,6,4,4,0,0,2,6,0,0,0,0,0,0,0,0,0,0,0,0,2,33,0,89720,35479,7211,48032,0
15,359,6,4,4,0,0,2,6,1,2,1,2,3,3,2,4,0,2,0,0,2,33,0,89720,35479,7211,48033,0
15,359,6,4,4,0,0,2,6,0,0,0,0,0,0,0,0,0,0,0,0,2,33,0,89720,35479,7211,48034,0
15,359,7,5,5,0,0,2,7,0,0,0,0,0,0,0,0,0,0,0,0,2,33,0,89720,35479,7211,48035,0
15,359,6,4,4,0,0,2,6,0,0,0,0,0,0,0,0,0,0,0,0,2,33,0,89720,35479,7211,48036,0
15,359,10,6,6,0,0,4,10,0,0,0,0,0,0,0,0,0,0,0,0,2,33,0,89720,35479,7211,48037,0
15,359,1,1,1,0,0,0,1,0,0,0,0,0,0,0,0,0,0,0,0,2,33,0,89720,35479,7211,48037,0
15,359,14,10,10,0,0,4,14,1,1,1,1,2,2,0,2,0,1,0,0,2,33,0,89720,35479,7211,48038,0
15,359,46,26,30,3,0,12,49,3,6,3,6,9,9,20,28,1,42,2,0,2,33,0,89730,35479,7211,48039,0
178,7759,4293,999,3693,19,54,507,4312,9,155,88,170,164,258,1156,1898,4,9368,520,0,2,86,1,89730,35481,7211,48040,0
178,7759,1482,859,1002,125,135,219,1607,16,219,134,251,235,385,1766,3032,9,27804,1544,1,2,86,1,89740,35482,7211,48041,0
46,2854,652,304,544,16,6,88,668,6,89,51,101,95,152,591,998,3,3399,188,0,2,30,2,89740,35483,7211,48042,0
74,3931,1293,570,1093,25,15,163,1318,10,195,123,241,205,364,1516,2795,6,17273,959,0,2,1,1,89750,35485,7211,48043,0
31,1843,466,257,367,18,25,50,484,7,126,86,171,133,257,898,1813,4,8612,478,0,2,72,2,89750,35485,7211,48044,0
161,3434,1513,682,1277,25,13,200,1538,11,199,116,219,210,335,1557,2584,6,15641,868,0,2,5,1,89750,35487,7211,48045,0
161,3434,819,519,539,24,98,155,843,15,96,57,106,111,163,690,1107,8,9171,509,0,2,5,1,89760,35489,7211,48046,0
238,5076,2,2,2,0,0,0,2,0,0,0,0,0,0,0,0,0,0,0,0,2,9,6,89760,35489,7211,48046,0
238,5076,99,48,90,1,3,5,100,0,0,0,0,0,0,0,0,0,0,0,0,2,9,6,89760,35490,7211,48047,0
238,5076,8,5,5,2,0,1,10,0,0,0,0,0,0,0,0,0,0,0,0,2,9,6,89760,35490,7211,48048,0
238,5076,1217,716,841,84,126,174,1301,14,185,118,215,199,333,1446,2542,8,20687,1149,0,2,9,6,89770,35492,7211,48049,0
238,5076,160,89,115,0,13,31,160,7,15,11,17,22,28,78,124,3,495,27,0,2,9,6,89770,35492,7211,48050,0
238,5076,10,10,9,9,0,0,19,0,0,0,0,0,0,0,0,0,0,0,0,2,9,6,89770,35492,7212,48051,0
238,5076,173,84,99,8,29,36,181,5,12,7,13,17,20,54,81,2,221,12,0,2,9,6,89770,35493,7212,48052,0
238,5076,3,1,1,3,0,0,6,0,0,0,0,0,0,0,0,0,0,0,0,2,9,6,89770,35493,7212,48053,0
254,5861,4293,999,3693,19,54,507,4312,9,155,88,170,164,258,1156,1898,4,9368,520,0,2,11,2,89770,35495,7212,48054,0
254,5861,1482,859,1002,125,135,219,1607,16,219,134,251,235,385,1766,3032,9,27804,1544,1,2,11,2,89780,35496,7212,48055,0
73,1701,53,23,39,0,0,13,53,2,8,4,8,10,12,26,39,1,39,2,0,2,1,3,89780,35496,7212,48056,0
73,1701,515,298,307,33,80,99,548,12,63,44,77,75,121,419,753,7,5527,307,0,2,1,3,89790,35496,7212,48057,0
79,1942,466,257,367,18,25,50,484,7,126,86,171,133,257,898,1813,4,8612,478,0,2,143,88,89790,35496,7212,48058,0
79,1942,507,281,342,29,59,88,536,10,53,29,57,63,86,336,514,5,2764,153,0,2,143,88,89790,35496,7212,48059,0
31,956,182,127,129,0,0,53,182,5,39,21,42,44,63,217,343,2,926,51,0,2,3,7,89790,35496,7213,48060,0
146,7064,1392,870,1177,35,17,170,1427,14,494,280,531,508,811,4473,7289,7,54850,3047,2,2,165,196,89790,35499,7214,48061,0
15,359,127,75,83,2,11,30,129,4,14,7,14,18,21,61,87,2,175,9,0,2,33,0,89790,35499,7214,48062,0
15,359,652,304,544,16,6,88,668,6,89,51,101,95,152,591,998,3,3399,188,0,2,33,0,89790,35500,7214,48063,0
15,359,2,2,2,0,0,0,2,0,0,0,0,0,0,0,0,0,0,0,0,2,33,0,89790,35500,7214,48063,0
15,359,8,5,5,0,0,3,8,0,0,0,0,0,0,0,0,0,0,0,0,2,33,0,89790,35500,7214,48064,0
15,359,2,2,2,0,0,0,2,0,0,0,0,0,0,0,0,0,0,0,0,2,33,0,89790,35500,7214,48064,0
15,359,14,8,8,0,0,6,14,0,0,0,0,0,0,0,0,0,0,0,0,2,33,0,89790,35500,7214,48065,0
15,359,6,4,4,0,0,2,6,0,0,0,0,0,0,0,0,0,0,0,0,2,33,0,89790,35500,7214,48066,0
15,359,6,4,4,0,0,2,6,1,2,1,2,3,3,2,4,0,2,0,0,2,33,0,89790,35500,7214,48067,0
15,359,6,4,4,0,0,2,6,0,0,0,0,0,0,0,0,0,0,0,0,2,33,0,89790,35500,7214,48068,0
15,359,7,5,5,0,0,2,7,0,0,0,0,0,0,0,0,0,0,0,0,2,33,0,89790,35500,7214,48069,0
15,359,6,4,4,0,0,2,6,0,0,0,0,0,0,0,0,0,0,0,0,2,33,0,89790,35500,7214,48070,0
15,359,10,6,6,0,0,4,10,0,0,0,0,0,0,0,0,0,0,0,0,2,33,0,89790,35500,7214,48071,0
15,359,1,1,1,0,0,0,1,0,0,0,0,0,0,0,0,0,0,0,0,2,33,0,89790,35500,7214,48071,0
15,359,14,10,10,0,0,4,14,1,1,1,1,2,2,0,2,0,1,0,0,2,33,0,89790,35500,7214,48072,0
15,359,46,26,30,3,0,12,49,3,6,3,6,9,9,20,28,1,42,2,0,2,33,0,89800,35500,7214,48073,0
178,7759,4293,999,3693,19,54,507,4312,9,155,88,170,164,258,1156,1898,4,9368,520,0,2,86,1,89800,35502,7214,48074,0
178,7759,1482,859,1002,125,135,219,1607,16,219,134,251,235,385,1766,3032,9,27804,1544,1,2,86,1,89810,35503,7214,48075,0
46,2854,652,304,544,16,6,88,668,6,89,51,101,95,152,591,998,3,3399,188,0,2,30,2,89810,35504,7214,48076,0
74,3931,1293,570,1093,25,15,163,1318,10,195,123,241,205,364,1516,2795,6,17273,959,0,2,1,1,89820,35506,7214,48077,0
31,1843,466,257,367,18,25,50,484,7,126,86,171,133,257,898,1813,4,8612,478,0,2,72,2,89820,35506,7214,48078,0
161,3434,1513,682,1277,25,13,200,1538,11,199,116,219,210,335,1557,2584,6,15641,868,0,2,5,1,89820,35508,7214,48079,0
161,3434,819,519,539,24,98,155,843,15,96,57,106,111,163,690,1107,8,9171,509,0,2,5,1,89830,35510,7214,48080,0
238,5076,2,2,2,0,0,0,2,0,0,0,0,0,0,0,0,0,0,0,0,2,9,6,89830,35510,7214,48080,0
238,5076,99,48,90,1,3,5,100,0,0,0,0,0,0,0,0,0,0,0,0,2,9,6,89830,35511,7214,48081,0
238,5076,8,5,5,2,0,1,10,0,0,0,0,0,0,0,0,0,0,0,0,2,9,6,89830,35511,7214,48082,0
238,5076,1217,716,841,84,126,174,1301,14,185,118,215,199,333,1446,2542,8,20687,1149,0,2,9,6,89840,35513,7214,48083,0
238,5076,160,89,115,0,13,31,160,7,15,11,17,22,28,78,124,3,495,27,0,2,9,6,89840,35513,7214,48084,0
238,5076,10,10,9,9,0,0,19,0,0,0,0,0,0,0,0,0,0,0,0,2,9,6,89840,35513,7215,48085,0
238,5076,173,84,99,8,29,36,181,5,12,7,13,17,20,54,81,2,221,12,0,2,9,6,89840,35514,7215,48086,0
238,5076,3,1,1,3,0,0,6,0,0,0,0,0,0,0,0,0,0,0,0,2,9,6,89840,35514,7215,48087,0
261,6237,4293,999,3693,19,54,507,4312,9,155,88,170,164,258,1156,1898,4,9368,520,0,2,11,2,89840,35516,7215,48088,0
261,6237,1482,859,1002,125,135,219,1607,16,219,134,251,235,385,1766,3032,9,27804,1544,1,2,11,2,89850,35517,7215,48089,0
73,1701,53,23,39,0,0,13,53,2,8,4,8,10,12,26,39,1,39,2,0,2,1,3,89850,35517,7215,48090,0
73,1701,515,298,307,33,80,99,548,12,63,44,77,75,121,419,753,7,5527,307,0,2,1,3,89860,35517,7215,48091,0
16,491,184,100,137,2,15,30,186,6,38,20,39,44,59,214,322,3,991,55,0,2,1,1,89860,35518,7215,48092,0
16,491,103,65,74,8,5,16,111,7,17,9,17,24,26,89,119,3,417,23,0,2,1,1,89860,35519,7215,48093,0
79,1942,466,257,367,18,25,50,484,7,126,86,171,133,257,898,1813,4,8612,478,0,2,143,88,89860,35519,7215,48094,0
79,1942,507,281,342,29,59,88,536,10,53,29,57,63,86,336,514,5,2764,153,0,2,143,88,89860,35519,7215,48095,0
31,956,182,127,129,0,0,53,182,5,39,21,42,44,63,217,343,2,926,51,0,2,3,7,89860,35519,7216,48096,0
146,7064,1392,870,1177,35,17,170,1427,14,494,280,531,508,811,4473,7289,7,54850,3047,2,2,165,196,89860,35522,7217,48097,0
15,359,127,75,83,2,11,30,129,4,14,7,14,18,21,61,87,2,175,9,0,2,33,0,89860,35522,7217,48098,0
15,359,652,304,544,16,6,88,668,6,89,51,101,95,152,591,998,3,3399,188,0,2,33,0,89860,35523,7217,48099,0
15,359,2,2,2,0,0,0,2,0,0,0,0,0,0,0,0,0,0,0,0,2,33,0,89860,35523,7217,48099,0
15,359,8,5,5,0,0,3,8,0,0,0,0,0,0,0,0,0,0,0,0,2,33,0,89860,35523,7217,48100,0
15,359,2,2,2,0,0,0,2,0,0,0,0,0,0,0,0,0,0,0,0,2,33,0,89860,35523,7217,48100,0
15,359,14,8,8,0,0,6,14,0,0,0,0,0,0,0,0,0,0,0,0,2,33,0,89860,35523,7217,48101,0
15,359,6,4,4,0,0,2,6,0,0,0,0,0,0,0,0,0,0,0,0,2,33,0,89860,35523,7217,48102,0
15,359,6,4,4,0,0,2,6,1,2,1,2,3,3,2,4,0,2,0,0,2,33,0,89860,35523,7217,48103,0
15,359,6,4,4,0,0,2,6,0,0,0,0,0,0,0,0,0,0,0,0,2,33,0,89860,35523,7217,48104,0
15,359,7,5,5,0,0,2,7,0,0,0,0,0,0,0,0,0,0,0,0,2,33,0,89860,35523,7217,48105,0
15,359,6,4,4,0,0,2,6,0,0,0,0,0,0,0,0,0,0,0,0,2,33,0,89860,35523,7217,48106,0
15,359,10,6,6,0,0,4,10,0,0,0,0,0,0,0,0,0,0,0,0,2,33,0,89860,35523,7217,48107,0
15,359,1,1,1,0,0,0,1,0,0,0,0,0,0,0,0,0,0,0,0,2,33,0,89860,35523,7217,48107,0
15,359,14,10,10,0,0,4,14,1,1,1,1,2,2,0,2,0,1,0,0,2,33,0,89860,35523,7217,48108,0
15,359,46,26,30,3,0,12,49,3,6,3,6,9,9,20,28,1,42,2,0,2,33,0,89870,35523,7217,48109,0
182,7900,4293,999,3693,19,54,507,4312,9,155,88,170,164,258,1156,1898,4,9368,520,0,2,87,2,89870,35525,7217,48110,0
182,7900,1482,859,1002,125,135,219,1607,16,219,134,251,235,385,1766,3032,9,27804,1544,1,2,87,2,89880,35526,7217,48111,0
46,2854,652,304,544,16,6,88,668,6,89,51,101,95,152,591,998,3,3399,188,0,2,30,2,89880,35527,7217,48112,0
18,697,184,100,137,2,15,30,186,6,38,20,39,44,59,214,322,3,991,55,0,2,1,1,89880,35528,7217,48113,0
74,3931,1293,570,1093,25,15,163,1318,10,195,123,241,205,364,1516,2795,6,17273,959,0,2,1,1,89890,35530,7217,48114,0
31,1843,466,257,367,18,25,50,484,7,126,86,171,133,257,898,1813,4,8612,478,0,2,72,2,89890,35530,7217,48115,0
184,7983,4293,999,3693,19,54,507,4312,9,155,88,170,164,258,1156,1898,4,9368,520,0,2,17,37,89890,35532,7217,48116,0
184,7983,1482,859,1002,125,135,219,1607,16,219,134,251,235,385,1766,3032,9,27804,1544,1,2,17,37,89900,35533,7217,48117,0
184,7975,4293,999,3693,19,54,507,4312,9,155,88,170,164,258,1156,1898,4,9368,520,0,2,5,5,89900,35535,7217,48118,0
184,7975,1482,859,1002,125,135,219,1607,16,219,134,251,235,385,1766,3032,9,27804,1544,1,2,5,5,89910,35536,7217,48119,0
3,65,127,75,83,2,11,30,129,4,14,7,14,18,21,61,87,2,175,9,0,2,1,1,89910,35536,7217,48120,0
3,65,652,304,544,16,6,88,668,6,89,51,101,95,152,591,998,3,3399,188,0,2,1,1,89910,35537,7217,48121,0
3,65,2,2,2,0,0,0,2,0,0,0,0,0,0,0,0,0,0,0,0,2,1,1,89910,35537,7217,48121,0
3,65,8,5,5,0,0,3,8,0,0,0,0,0,0,0,0,0,0,0,0,2,1,1,89910,35537,7217,48122,0
3,65,2,2,2,0,0,0,2,0,0,0,0,0,0,0,0,0,0,0,0,2,1,1,89910,35537,7217,48122,0
3,65,14,8,8,0,0,6,14,0,0,0,0,0,0,0,0,0,0,0,0,2,1,1,89910,35537,7217,48123,0
3,65,6,4,4,0,0,2,6,0,0,0,0,0,0,0,0,0,0,0,0,2,1,1,89910,35537,7217,48124,0
3,65,6,4,4,0,0,2,6,1,2,1,2,3,3,2,4,0,2,0,0,2,1,1,89910,35537,7217,48125,0
3,65,6,4,4,0,0,2,6,0,0,0,0,0,0,0,0,0,0,0,0,2,1,1,89910,35537,7217,48126,0
3,65,7,5,5,0,0,2,7,0,0,0,0,0,0,0,0,0,0,0,0,2,1,1,89910,35537,7217,48127,0
3,65,6,4,4,0,0,2,6,0,0,0,0,0,0,0,0,0,0,0,0,2,1,1,89910,35537,7217,48128,0
3,65,10,6,6,0,0,4,10,0,0,0,0,0,0,0,0,0,0,0,0,2,1,1,89910,35537,7217,48129,0
3,65,1,1,1,0,0,0,1,0,0,0,0,0,0,0,0,0,0,0,0,2,1,1,89910,35537,7217,48129,0
3,65,14,10,10,0,0,4,14,1,1,1,1,2,2,0,2,0,1,0,0,2,1,1,89910,35537,7217,48130,0
3,65,46,26,30,3,0,12,49,3,6,3,6,9,9,20,28,1,42,2,0,2,1,1,89920,35537,7217,48131,0
261,6237,4293,999,3693,19,54,507,4312,9,155,88,170,164,258,1156,1898,4,9368,520,0,2,112,6,89920,35539,7217,48133,0
261,6237,1482,859,1002,125,135,219,1607,16,219,134,251,235,385,1766,3032,9,27804,1544,1,2,112,6,89930,35540,7217,48134,0
184,7975,4293,999,3693,19,54,507,4312,9,155,88,170,164,258,1156,1898,4,9368,520,0,2,94,1,89930,35542,7217,48135,0
184,7975,1482,859,1002,125,135,219,1607,16,219,134,251,235,385,1766,3032,9,27804,1544,1,2,94,1,89940,35543,7217,48136,0
38,2308,334,251,279,10,4,40,344,5,127,74,143,132,217,899,1528,2,4303,239,0,2,5,1,89940,35544,7217,48137,0
38,2308,334,251,279,10,4,40,344,5,127,74,143,132,217,899,1528,2,4303,239,0,2,5,1,89940,35545,7217,48138,0
3,65,127,75,83,2,11,30,129,4,14,7,14,18,21,61,87,2,175,9,0,2,1,1,89940,35545,7217,48139,0
3,65,652,304,544,16,6,88,668,6,89,51,101,95,152,591,998,3,3399,188,0,2,1,1,89940,35546,7217,48140,0
3,65,2,2,2,0,0,0,2,0,0,0,0,0,0,0,0,0,0,0,0,2,1,1,89940,35546,7217,48140,0
3,65,8,5,5,0,0,3,8,0,0,0,0,0,0,0,0,0,0,0,0,2,1,1,89940,35546,7217,48141,0
3,65,2,2,2,0,0,0,2,0,0,0,0,0,0,0,0,0,0,0,0,2,1,1,89940,35546,7217,48141,0
3,65,14,8,8,0,0,6,14,0,0,0,0,0,0,0,0,0,0,0,0,2,1,1,89940,35546,7217,48142,0
3,65,6,4,4,0,0,2,6,0,0,0,0,0,0,0,0,0,0,0,0,2,1,1,89940,35546,7217,48143,0
3,65,6,4,4,0,0,2,6,1,2,1,2,3,3,2,4,0,2,0,0,2,1,1,89940,35546,7217,48144,0
3,65,6,4,4,0,0,2,6,0,0,0,0,0,0,0,0,0,0,0,0,2,1,1,89940,35546,7217,48145,0
3,65,7,5,5,0,0,2,7,0,0,0,0,0,0,0,0,0,0,0,0,2,1,1,89940,35546,7217,48146,0
3,65,6,4,4,0,0,2,6,0,0,0,0,0,0,0,0,0,0,0,0,2,1,1,89940,35546,7217,48147,0
3,65,10,6,6,0,0,4,10,0,0,0,0,0,0,0,0,0,0,0,0,2,1,1,89940,35546,7217,48148,0
3,65,1,1,1,0,0,0,1,0,0,0,0,0,0,0,0,0,0,0,0,2,1,1,89940,35546,7217,48148,0
3,65,14,10,10,0,0,4,14,1,1,1,1,2,2,0,2,0,1,0,0,2,1,1,89940,35546,7217,48149,0
3,65,46,26,30,3,0,12,49,3,6,3,6,9,9,20,28,1,42,2,0,2,1,1,89950,35546,7217,48150,0
216,4974,182,127,129,0,0,53,182,5,39,21,42,44,63,217,343,2,926,51,0,2,17,10,89950,35546,7218,48151,0
216,4974,1165,710,800,67,119,181,1232,18,243,153,282,261,435,2000,3492,10,36473,2026,1,2,17,10,89960,35546,7219,48152,0
67,1549,773,419,590,28,0,166,801,10,204,113,217,214,330,1598,2554,5,13587,754,0,2,7,6,89960,35546,7220,48153,0
67,1549,421,273,302,44,34,57,465,17,81,59,107,98,166,583,1098,11,12329,684,0,2,7,6,89960,35546,7221,48154,0
27,568,2,2,2,0,0,0,2,0,0,0,0,0,0,0,0,0,0,0,0,2,8,3,89960,35546,7221,48154,0
27,568,99,48,90,1,3,5,100,0,0,0,0,0,0,0,0,0,0,0,0,2,8,3,89960,35547,7221,48155,0
27,568,8,5,5,2,0,1,10,0,0,0,0,0,0,0,0,0,0,0,0,2,8,3,89960,35547,7221,48156,0
27,568,1217,716,841,84,126,174,1301,14,185,118,215,199,333,1446,2542,8,20687,1149,0,2,8,3,89970,35549,7221,48157,0
27,568,160,89,115,0,13,31,160,7,15,11,17,22,28,78,124,3,495,27,0,2,8,3,89970,35549,7221,48158,0
27,568,10,10,9,9,0,0,19,0,0,0,0,0,0,0,0,0,0,0,0,2,8,3,89970,35549,7222,48159,0
27,568,173,84,99,8,29,36,181,5,12,7,13,17,20,54,81,2,221,12,0,2,8,3,89970,35550,7222,48160,0
27,568,3,1,1,3,0,0,6,0,0,0,0,0,0,0,0,0,0,0,0,2,8,3,89970,35550,7222,48161,0
183,5415,1660,832,1314,41,38,274,1701,20,312,209,395,332,604,2671,5058,12,64042,3557,1,2,28,22,89970,35552,7223,48163,0
183,5415,1057,646,719,113,100,145,1170,18,215,134,248,233,382,1740,3004,10,31186,1732,1,2,28,22,89980,35553,7224,48164,0
114,2099,477,336,357,30,23,73,507,16,194,134,250,210,384,1538,2962,10,30538,1696,0,2,9,6,89990,35554,7224,48165,0
238,5076,2,2,2,0,0,0,2,0,0,0,0,0,0,0,0,0,0,0,0,2,33,17,89990,35554,7224,48165,0
238,5076,99,48,90,1,3,5,100,0,0,0,0,0,0,0,0,0,0,0,0,2,33,17,89990,35555,7224,48166,0
238,5076,8,5,5,2,0,1,10,0,0,0,0,0,0,0,0,0,0,0,0,2,33,17,89990,35555,7224,48167,0
238,5076,1217,716,841,84,126,174,1301,14,185,118,215,199,333,1446,2542,8,20687,1149,0,2,33,17,90000,35557,7224,48168,0
238,5076,160,89,115,0,13,31,160,7,15,11,17,22,28,78,124,3,495,27,0,2,33,17,90000,35557,7224,48169,0
238,5076,10,10,9,9,0,0,19,0,0,0,0,0,0,0,0,0,0,0,0,2,33,17,90000,35557,7225,48170,0
238,5076,173,84,99,8,29,36,181,5,12,7,13,17,20,54,81,2,221,12,0,2,33,17,90000,35558,7225,48171,0
238,5076,3,1,1,3,0,0,6,0,0,0,0,0,0,0,0,0,0,0,0,2,33,17,90000,35558,7225,48172,0
113,2326,463,295,324,28,62,57,491,12,134,82,154,146,236,989,1696,6,11700,650,0,2,30,14,90010,35559,7225,48173,0
37,813,167,116,138,4,5,22,171,8,48,30,56,56,86,292,499,4,2330,129,0,2,11,1,90010,35559,7225,48174,0
261,6237,4293,999,3693,19,54,507,4312,9,155,88,170,164,258,1156,1898,4,9368,520,0,2,112,6,90010,35561,7225,48176,0
261,6237,1482,859,1002,125,135,219,1607,16,219,134,251,235,385,1766,3032,9,27804,1544,1,2,112,6,90020,35562,7225,48177,0
30,669,125,97,103,3,0,19,128,9,25,17,27,34,44,144,223,4,1087,60,0,2,2,0,90020,35562,7226,48178,0
70,1526,402,202,227,24,74,80,426,12,52,33,61,64,94,339,564,7,3969,220,0,2,1,1,90020,35563,7226,48179,0
73,1701,53,23,39,0,0,13,53,2,8,4,8,10,12,26,39,1,39,2,0,2,35,17,90020,35563,7226,48180,0
73,1701,515,298,307,33,80,99,548,12,63,44,77,75,121,419,753,7,5527,307,0,2,35,17,90030,35563,7226,48181,0
16,491,184,100,137,2,15,30,186,6,38,20,39,44,59,214,322,3,991,55,0,2,10,5,90030,35564,7226,48182,0
16,491,103,65,74,8,5,16,111,7,17,9,17,24,26,89,119,3,417,23,0,2,10,5,90030,35565,7226,48183,0
79,1942,466,257,367,18,25,50,484,7,126,86,171,133,257,898,1813,4,8612,478,0,2,4,2,90030,35565,7226,48184,0
79,1942,507,281,342,29,59,88,536,10,53,29,57,63,86,336,514,5,2764,153,0,2,4,2,90030,35565,7226,48185,0
87,1935,1043,504,840,53,9,147,1096,9,180,112,198,189,310,1377,2344,4,11604,644,0,2,17,5,90030,35567,7226,48186,0
87,1935,383,288,292,26,6,62,409,11,65,38,67,76,105,429,656,5,3719,206,0,2,17,5,90030,35568,7226,48187,0
184,7975,4293,999,3693,19,54,507,4312,9,155,88,170,164,258,1156,1898,4,9368,520,0,2,94,1,90030,35570,7226,48188,0
184,7975,1482,859,1002,125,135,219,1607,16,219,134,251,235,385,1766,3032,9,27804,1544,1,2,94,1,90040,35571,7226,48189,0
111,6022,1457,730,1242,11,6,188,1468,10,292,166,329,302,495,2424,4078,5,22973,1276,1,2,15,0,90040,35573,7226,48190,0
18,697,184,100,137,2,15,30,186,6,38,20,39,44,59,214,322,3,991,55,0,2,56,2,90040,35574,7226,48191,0
38,2315,334,251,279,10,4,40,344,5,127,74,143,132,217,899,1528,2,4303,239,0,2,2,1,90040,35575,7226,48192,0
38,2315,334,251,279,10,4,40,344,5,127,74,143,132,217,899,1528,2,4303,239,0,2,2,1,90040,35576,7226,48193,0
87,1935,1043,504,840,53,9,147,1096,9,180,112,198,189,310,1377,2344,4,11604,644,0,2,2,2,90040,35578,7226,48194,0
87,1935,383,288,292,26,6,62,409,11,65,38,67,76,105,429,656,5,3719,206,0,2,2,2,90040,35579,7226,48195,0
16,386,127,75,83,2,11,30,129,4,14,7,14,18,21,61,87,2,175,9,0,2,27,0,90040,35579,7226,48196,0
16,386,652,304,544,16,6,88,668,6,89,51,101,95,152,591,998,3,3399,188,0,2,27,0,90040,35580,7226,48197,0
16,386,2,2,2,0,0,0,2,0,0,0,0,0,0,0,0,0,0,0,0,2,27,0,90040,35580,7226,48197,0
16,386,8,5,5,0,0,3,8,0,0,0,0,0,0,0,0,0,0,0,0,2,27,0,90040,35580,7226,48198,0
16,386,2,2,2,0,0,0,2,0,0,0,0,0,0,0,0,0,0,0,0,2,27,0,90040,35580,7226,48198,0
16,386,14,8,8,0,0,6,14,0,0,0,0,0,0,0,0,0,0,0,0,2,27,0,90040,35580,7226,48199,0
16,386,6,4,4,0,0,2,6,0,0,0,0,0,0,0,0,0,0,0,0,2,27,0,90040,35580,7226,48200,0
16,386,6,4,4,0,0,2,6,1,2,1,2,3,3,2,4,0,2,0,0,2,27,0,90040,35580,7226,48201,0
16,386,6,4,4,0,0,2,6,0,0,0,0,0,0,0,0,0,0,0,0,2,27,0,90040,35580,7226,48202,0
16,386,7,5,5,0,0,2,7,0,0,0,0,0,0,0,0,0,0,0,0,2,27,0,90040,35580,7226,48203,0
16,386,6,4,4,0,0,2,6,0,0,0,0,0,0,0,0,0,0,0,0,2,27,0,90040,35580,7226,48204,0
16,386,10,6,6,0,0,4,10,0,0,0,0,0,0,0,0,0,0,0,0,2,27,0,90040,35580,7226,48205,0
16,386,1,1,1,0,0,0,1,0,0,0,0,0,0,0,0,0,0,0,0,2,27,0,90040,35580,7226,48205,0
16,386,14,10,10,0,0,4,14,1,1,1,1,2,2,0,2,0,1,0,0,2,27,0,90040,35580,7226,48206,0
16,386,46,26,30,3,0,12,49,3,6,3,6,9,9,20,28,1,42,2,0,2,27,0,90050,35580,7226,48207,0
87,1935,1043,504,840,53,9,147,1096,9,180,112,198,189,310,1377,2344,4,11604,644,0,2,2,2,90050,35582,7226,48208,0
87,1935,383,288,292,26,6,62,409,11,65,38,67,76,105,429,656,5,3719,206,0,2,2,2,90050,35583,7226,48209,0
16,386,127,75,83,2,11,30,129,4,14,7,14,18,21,61,87,2,175,9,0,2,27,0,90050,35583,7226,48210,0
16,386,652,304,544,16,6,88,668,6,89,51,101,95,152,591,998,3,3399,188,0,2,27,0,90050,35584,7226,48211,0
16,386,2,2,2,0,0,0,2,0,0,0,0,0,0,0,0,0,0,0,0,2,27,0,90050,35584,7226,48211,0
16,386,8,5,5,0,0,3,8,0,0,0,0,0,0,0,0,0,0,0,0,2,27,0,90050,35584,7226,48212,0
16,386,2,2,2,0,0,0,2,0,0,0,0,0,0,0,0,0,0,0,0,2,27,0,90050,35584,7226,48212,0
16,386,14,8,8,0,0,6,14,0,0,0,0,0,0,0,0,0,0,0,0,2,27,0,90050,35584,7226,48213,0
16,386,6,4,4,0,0,2,6,0,0,0,0,0,0,0,0,0,0,0,0,2,27,0,90050,35584,7226,48214,0
16,386,6,4,4,0,0,2,6,1,2,1,2,3,3,2,4,0,2,0,0,2,27,0,90050,35584,7226,48215,0
16,386,6,4,4,0,0,2,6,0,0,0,0,0,0,0,0,0,0,0,0,2,27,0,90050,35584,7226,48216,0
16,386,7,5,5,0,0,2,7,0,0,0,0,0,0,0,0,0,0,0,0,2,27,0,90050,35584,7226,48217,0
16,386,6,4,4,0,0,2,6,0,0,0,0,0,0,0,0,0,0,0,0,2,27,0,90050,35584,7226,48218,0
16,386,10,6,6,0,0,4,10,0,0,0,0,0,0,0,0,0,0,0,0,2,27,0,90050,35584,7226,48219,0
16,386,1,1,1,0,0,0,1,0,0,0,0,0,0,0,0,0,0,0,0,2,27,0,90050,35584,7226,48219,0
16,386,14,10,10,0,0,4,14,1,1,1,1,2,2,0,2,0,1,0,0,2,27,0,90050,35584,7226,48220,0
16,386,46,26,30,3,0,12,49,3,6,3,6,9,9,20,28,1,42,2,0,2,27,0,90060,35584,7226,48221,0
225,5745,722,423,573,19,0,135,741,12,172,101,199,184,300,1320,2257,6,15668,870,0,2,8,9,90060,35586,7226,48223,0
225,5745,1508,847,911,44,250,301,1552,14,148,88,169,162,257,1120,1886,7,15077,837,0,2,8,9,90060,35587,7227,48224,0
225,5745,722,423,573,19,0,135,741,12,172,101,199,184,300,1320,2257,6,15668,870,0,2,8,9,90060,35589,7227,48226,0
225,5745,1508,847,911,44,250,301,1552,14,148,88,169,162,257,1120,1886,7,15077,837,0,2,8,9,90060,35590,7228,48227,0
116,2131,477,336,357,30,23,73,507,16,194,134,250,210,384,1538,2962,10,30538,1696,0,2,14,1,90070,35591,7228,48228,0
58,1205,207,111,150,11,0,50,218,5,26,19,36,31,55,133,272,3,943,52,0,2,7,0,90070,35591,7228,48229,0
58,1205,410,198,237,31,55,97,441,11,63,38,72,74,110,414,683,6,4293,238,0,2,7,0,90080,35592,7229,48230,0
70,1531,402,202,227,24,74,80,426,12,52,33,61,64,94,339,564,7,3969,220,0,2,2,1,90080,35593,7229,48231,0
122,4968,1450,624,1228,12,26,181,1462,14,306,186,354,320,540,2580,4493,8,36391,2021,1,2,2,1,90080,35595,7230,48232,0
114,2108,477,336,357,30,23,73,507,16,194,134,250,210,384,1538,2962,10,30538,1696,0,2,4,14,90090,35596,7230,48233,0
58,1191,207,111,150,11,0,50,218,5,26,19,36,31,55,133,272,3,943,52,0,2,3,4,90090,35596,7230,48234,0
58,1191,410,198,237,31,55,97,441,11,63,38,72,74,110,414,683,6,4293,238,0,2,3,4,90100,35597,7231,48235,0
70,1535,402,202,227,24,74,80,426,12,52,33,61,64,94,339,564,7,3969,220,0,2,3,2,90100,35598,7231,48236,0
122,4972,1450,624,1228,12,26,181,1462,14,306,186,354,320,540,2580,4493,8,36391,2021,1,2,2,2,90100,35600,7232,48237,0
114,2108,477,336,357,30,23,73,507,16,194,134,250,210,384,1538,2962,10,30538,1696,0,2,4,1,90110,35601,7232,48238,0
58,1191,207,111,150,11,0,50,218,5,26,19,36,31,55,133,272,3,943,52,0,2,6,0,90110,35601,7232,48239,0
58,1191,410,198,237,31,55,97,441,11,63,38,72,74,110,414,683,6,4293,238,0,2,6,0,90120,35602,7233,48240,0
70,1535,402,202,227,24,74,80,426,12,52,33,61,64,94,339,564,7,3969,220,0,2,3,1,90120,35603,7233,48241,0
122,4972,1450,624,1228,12,26,181,1462,14,306,186,354,320,540,2580,4493,8,36391,2021,1,2,2,1,90120,35605,7234,48242,0
1,93,42,7,35,4,0,5,46,1,2,1,2,3,3,2,4,0,2,0,0,2,1,1,90120,35605,7234,48243,0
1,93,11,6,10,0,0,1,11,2,4,2,4,6,6,10,15,1,15,0,0,2,1,1,90120,35605,7234,48244,0
1,93,42,7,35,4,0,5,46,1,2,1,2,3,3,2,4,0,2,0,0,2,1,1,90120,35605,7234,48245,0
1,93,11,6,10,0,0,1,11,2,4,2,4,6,6,10,15,1,15,0,0,2,1,1,90120,35605,7234,48246,0
1,93,42,7,35,4,0,5,46,1,2,1,2,3,3,2,4,0,2,0,0,2,1,1,90120,35605,7234,48247,0
1,93,11,6,10,0,0,1,11,2,4,2,4,6,6,10,15,1,15,0,0,2,1,1,90120,35605,7234,48248,0
114,2108,477,336,357,30,23,73,507,16,194,134,250,210,384,1538,2962,10,30538,1696,0,2,4,1,90130,35606,7234,48249,0
58,1191,207,111,150,11,0,50,218,5,26,19,36,31,55,133,272,3,943,52,0,2,6,0,90130,35606,7234,48250,0
58,1191,410,198,237,31,55,97,441,11,63,38,72,74,110,414,683,6,4293,238,0,2,6,0,90140,35607,7235,48251,0
70,1535,402,202,227,24,74,80,426,12,52,33,61,64,94,339,564,7,3969,220,0,2,3,1,90140,35608,7235,48252,0
225,5745,722,423,573,19,0,135,741,12,172,101,199,184,300,1320,2257,6,15668,870,0,2,8,9,90140,35610,7235,48254,0
225,5745,1508,847,911,44,250,301,1552,14,148,88,169,162,257,1120,1886,7,15077,837,0,2,8,9,90140,35611,7236,48255,0
87,1935,1043,504,840,53,9,147,1096,9,180,112,198,189,310,1377,2344,4,11604,644,0,2,2,2,90140,35613,7236,48256,0
87,1935,383,288,292,26,6,62,409,11,65,38,67,76,105,429,656,5,3719,206,0,2,2,2,90140,35614,7236,48257,0
16,386,127,75,83,2,11,30,129,4,14,7,14,18,21,61,87,2,175,9,0,2,27,0,90140,35614,7236,48258,0
16,386,652,304,544,16,6,88,668,6,89,51,101,95,152,591,998,3,3399,188,0,2,27,0,90140,35615,7236,48259,0
16,386,2,2,2,0,0,0,2,0,0,0,0,0,0,0,0,0,0,0,0,2,27,0,90140,35615,7236,48259,0
16,386,8,5,5,0,0,3,8,0,0,0,0,0,0,0,0,0,0,0,0,2,27,0,90140,35615,7236,48260,0
16,386,2,2,2,0,0,0,2,0,0,0,0,0,0,0,0,0,0,0,0,2,27,0,90140,35615,7236,48260,0
16,386,14,8,8,0,0,6,14,0,0,0,0,0,0,0,0,0,0,0,0,2,27,0,90140,35615,7236,48261,0
16,386,6,4,4,0,0,2,6,0,0,0,0,0,0,0,0,0,0,0,0,2,27,0,90140,35615,7236,48262,0
16,386,6,4,4,0,0,2,6,1,2,1,2,3,3,2,4,0,2,0,0,2,27,0,90140,35615,7236,48263,0
16,386,6,4,4,0,0,2,6,0,0,0,0,0,0,0,0,0,0,0,0,2,27,0,90140,35615,7236,48264,0
16,386,7,5,5,0,0,2,7,0,0,0,0,0,0,0,0,0,0,0,0,2,27,0,90140,35615,7236,48265,0
16,386,6,4,4,0,0,2,6,0,0,0,0,0,0,0,0,0,0,0,0,2,27,0,90140,35615,7236,48266,0
16,386,10,6,6,0,0,4,10,0,0,0,0,0,0,0,0,0,0,0,0,2,27,0,90140,35615,7236,48267,0
16,386,1,1,1,0,0,0,1,0,0,0,0,0,0,0,0,0,0,0,0,2,27,0,90140,35615,7236,48267,0
16,386,14,10,10,0,0,4,14,1,1,1,1,2,2,0,2,0,1,0,0,2,27,0,90140,35615,7236,48268,0
16,386,46,26,30,3,0,12,49,3,6,3,6,9,9,20,28,1,42,2,0,2,27,0,90150,35615,7236,48269,0
122,4972,1450,624,1228,12,26,181,1462,14,306,186,354,320,540,2580,4493,8,36391,2021,1,2,2,1,90150,35617,7237,48270,0
38,2315,334,251,279,10,4,40,344,5,127,74,143,132,217,899,1528,2,4303,239,0,2,6,1,90150,35618,7237,48271,0
57,1488,339,213,244,17,9,65,356,10,42,26,48,52,74,259,421,5,2410,133,0,2,8,2,90160,35618,7237,48272,0
108,4697,1289,550,1043,56,32,155,1345,10,167,93,185,177,278,1266,2075,5,11498,638,0,2,37,0,90160,35620,7238,48273,0
232,5908,722,423,573,19,0,135,741,12,172,101,199,184,300,1320,2257,6,15668,870,0,2,39,4,90160,35622,7238,48275,1
232,5908,1508,847,911,44,250,301,1552,14,148,88,169,162,257,1120,1886,7,15077,837,0,2,39,4,90160,35623,7239,48276,1
59,2994,722,423,573,19,0,135,741,12,172,101,199,184,300,1320,2257,6,15668,870,0,2,46,0,90160,35625,7239,48278,1
107,4615,1289,550,1043,56,32,155,1345,10,167,93,185,177,278,1266,2075,5,11498,638,0,2,3,3,90160,35627,7240,48279,0
146,7058,1392,870,1177,35,17,170,1427,14,494,280,531,508,811,4473,7289,7,54850,3047,2,2,3,2,90160,35630,7241,48280,0
15,696,139,89,101,2,0,35,141,7,54,34,62,61,96,330,569,4,2287,127,0,2,1,1,90160,35630,7241,48281,0
42,2589,1157,318,931,29,22,177,1186,6,104,63,125,110,188,712,1274,3,4596,255,0,2,8,8,90160,35630,7241,48282,0
89,3928,1338,495,1086,10,64,173,1348,11,122,82,157,133,239,883,1686,7,11934,663,0,2,1,1,90160,35632,7241,48283,0
184,7966,4293,999,3693,19,54,507,4312,9,155,88,170,164,258,1156,1898,4,9368,520,0,2,3,3,90160,35634,7241,48284,0
184,7966,1482,859,1002,125,135,219,1607,16,219,134,251,235,385,1766,3032,9,27804,1544,1,2,3,3,90170,35635,7241,48285,0
6,322,180,34,164,0,0,16,180,1,12,6,12,13,18,43,66,0,33,1,0,2,2,2,90170,35635,7241,48286,0
122,4966,1450,624,1228,12,26,181,1462,14,306,186,354,320,540,2580,4493,8,36391,2021,1,2,2,2,90170,35637,7242,48287,0
183,5958,1660,832,1314,41,38,274,1701,20,312,209,395,332,604,2671,5058,12,64042,3557,1,2,3,3,90170,35639,7243,48289,0
49,3773,996,429,845,24,10,117,1020,7,76,50,88,83,138,494,879,4,3565,198,0,2,3,3,90170,35641,7243,48290,0
120,5064,1513,682,1277,25,13,200,1538,11,199,116,219,210,335,1557,2584,6,15641,868,0,2,7,7,90170,35643,7243,48291,0
85,4935,1296,573,1062,40,33,157,1336,8,201,118,231,209,349,1561,2689,4,12365,686,0,2,6,6,90170,35643,7243,48292,0
46,2848,652,304,544,16,6,88,668,6,89,51,101,95,152,591,998,3,3399,188,0,2,2,2,90170,35644,7243,48293,0
81,3714,1455,414,1257,16,76,112,1471,5,41,23,46,46,69,231,381,2,1069,59,0,2,4,4,90170,35645,7243,48294,0
113,5682,1523,757,1297,19,12,193,1542,12,193,117,230,205,347,1508,2664,7,19053,1058,0,2,3,3,90180,35647,7243,48295,0
87,3375,1043,504,840,53,9,147,1096,9,180,112,198,189,310,1377,2344,4,11604,644,0,2,6,6,90180,35649,7243,48296,0
12,463,295,56,236,0,4,54,295,2,9,5,10,11,15,30,51,1,57,3,0,2,1,1,90180,35651,7243,48297,0
79,3068,1178,367,1042,6,15,115,1184,9,94,51,95,103,146,644,976,4,4439,246,0,2,1,1,90180,35651,7243,48298,0
112,6100,1943,715,1694,26,18,214,1969,12,185,120,237,197,357,1436,2721,7,20915,1161,0,2,12,12,90180,35653,7243,48299,0
51,2017,1098,241,925,5,10,155,1103,7,46,25,49,53,74,273,423,3,1580,87,0,2,5,5,90190,35655,7243,48300,0
3,90,35,12,22,4,5,6,39,1,2,1,2,3,3,2,4,0,2,0,0,0,28,0,90190,35655,7243,48301,0
57,1488,339,213,244,17,9,65,356,10,42,26,48,52,74,259,421,5,2410,133,0,2,8,2,90200,35655,7243,48302,0
108,4697,1289,550,1043,56,32,155,1345,10,167,93,185,177,278,1266,2075,5,11498,638,0,2,37,0,90200,35657,7244,48303,0
232,5908,722,423,573,19,0,135,741,12,172,101,199,184,300,1320,2257,6,15668,870,0,2,39,4,90200,35659,7244,48305,0
232,5908,1508,847,911,44,250,301,1552,14,148,88,169,162,257,1120,1886,7,15077,837,0,2,39,4,90200,35660,7245,48306,0
108,4688,1289,550,1043,56,32,155,1345,10,167,93,185,177,278,1266,2075,5,11498,638,0,2,3,3,90200,35662,7246,48307,0
146,7058,1392,870,1177,35,17,170,1427,14,494,280,531,508,811,4473,7289,7,54850,3047,2,2,3,2,90200,35665,7247,48308,0
15,696,139,89,101,2,0,35,141,7,54,34,62,61,96,330,569,4,2287,127,0,2,1,1,90200,35665,7247,48309,0
42,2589,1157,318,931,29,22,177,1186,6,104,63,125,110,188,712,1274,3,4596,255,0,2,8,8,90200,35665,7247,48310,0
89,3928,1338,495,1086,10,64,173,1348,11,122,82,157,133,239,883,1686,7,11934,663,0,2,1,1,90200,35667,7247,48311,0
184,7966,4293,999,3693,19,54,507,4312,9,155,88,170,164,258,1156,1898,4,9368,520,0,2,3,3,90200,35669,7247,48312,0
184,7966,1482,859,1002,125,135,219,1607,16,219,134,251,235,385,1766,3032,9,27804,1544,1,2,3,3,90210,35670,7247,48313,0
6,322,180,34,164,0,0,16,180,1,12,6,12,13,18,43,66,0,33,1,0,2,2,2,90210,35670,7247,48314,0
122,4966,1450,624,1228,12,26,181,1462,14,306,186,354,320,540,2580,4493,8,36391,2021,1,2,2,2,90210,35672,7248,48315,0
183,5958,1660,832,1314,41,38,274,1701,20,312,209,395,332,604,2671,5058,12,64042,3557,1,2,3,3,90210,35674,7249,48317,0
49,3773,996,429,845,24,10,117,1020,7,76,50,88,83,138,494,879,4,3565,198,0,2,3,3,90210,35676,7249,48318,0
120,5064,1513,682,1277,25,13,200,1538,11,199,116,219,210,335,1557,2584,6,15641,868,0,2,7,7,90210,35678,7249,48319,0
85,4935,1296,573,1062,40,33,157,1336,8,201,118,231,209,349,1561,2689,4,12365,686,0,2,6,6,90210,35678,7249,48320,0
46,2848,652,304,544,16,6,88,668,6,89,51,101,95,152,591,998,3,3399,188,0,2,2,2,90210,35679,7249,48321,0
81,3714,1455,414,1257,16,76,112,1471,5,41,23,46,46,69,231,381,2,1069,59,0,2,4,4,90210,35680,7249,48322,0
113,5682,1523,757,1297,19,12,193,1542,12,193,117,230,205,347,1508,2664,7,19053,1058,0,2,3,3,90220,35682,7249,48323,0
59,2994,722,423,573,19,0,135,741,12,172,101,199,184,300,1320,2257,6,15668,870,0,2,46,0,90220,35684,7249,48325,0
87,3375,1043,504,840,53,9,147,1096,9,180,112,198,189,310,1377,2344,4,11604,644,0,2,6,6,90220,35686,7249,48326,0
12,463,295,56,236,0,4,54,295,2,9,5,10,11,15,30,51,1,57,3,0,2,1,1,90220,35688,7249,48327,0
79,3068,1178,367,1042,6,15,115,1184,9,94,51,95,103,146,644,976,4,4439,246,0,2,1,1,90220,35688,7249,48328,0
112,6100,1943,715,1694,26,18,214,1969,12,185,120,237,197,357,1436,2721,7,20915,1161,0,2,12,12,90220,35690,7249,48329,0
51,2017,1098,241,925,5,10,155,1103,7,46,25,49,53,74,273,423,3,1580,87,0,2,5,5,90230,35692,7249,48330,0
87,3404,1043,504,840,53,9,147,1096,9,180,112,198,189,310,1377,2344,4,11604,644,0,2,18,11,90230,35694,7249,48331,0
3,90,35,12,22,4,5,6,39,1,2,1,2,3,3,2,4,0,2,0,0,0,28,0,90230,35694,7249,48332,0
87,3404,1043,504,840,53,9,147,1096,9,180,112,198,189,310,1377,2344,4,11604,644,0,2,18,11,90230,35696,7249,48333,0
123,2323,477,336,357,30,23,73,507,16,194,134,250,210,384,1538,2962,10,30538,1696,0,2,31,1,90240,35697,7249,48334,1
124,5157,1450,624,1228,12,26,181,1462,14,306,186,354,320,540,2580,4493,8,36391,2021,1,2,49,0,90240,35699,7250,48335,1
123,2323,477,336,357,30,23,73,507,16,194,134,250,210,384,1538,2962,10,30538,1696,0,2,31,1,90250,35700,7250,48336,0
124,5157,1450,624,1228,12,26,181,1462,14,306,186,354,320,540,2580,4493,8,36391,2021,1,2,49,0,90250,35702,7251,48337,0
3,90,35,12,22,4,5,6,39,1,2,1,2,3,3,2,4,0,2,0,0,0,28,0,90250,35702,7251,48338,0
87,3386,1043,504,840,53,9,147,1096,9,180,112,198,189,310,1377,2344,4,11604,644,0,2,18,11,90250,35704,7251,48339,0
3,90,35,12,22,4,5,6,39,1,2,1,2,3,3,2,4,0,2,0,0,0,28,0,90250,35704,7251,48340,0
87,3386,1043,504,840,53,9,147,1096,9,180,112,198,189,310,1377,2344,4,11604,644,0,2,18,11,90250,35706,7251,48341,0
216,4987,182,127,129,0,0,53,182,5,39,21,42,44,63,217,343,2,926,51,0,2,3,1,90250,35706,7252,48342,0
216,4987,1165,710,800,67,119,181,1232,18,243,153,282,261,435,2000,3492,10,36473,2026,1,2,3,1,90260,35706,7253,48343,0
148,7105,1392,870,1177,35,17,170,1427,14,494,280,531,508,811,4473,7289,7,54850,3047,2,2,13,2,90260,35709,7254,48344,0
216,4987,182,127,129,0,0,53,182,5,39,21,42,44,63,217,343,2,926,51,0,2,3,1,90260,35709,7255,48345,0
216,4987,1165,710,800,67,119,181,1232,18,243,153,282,261,435,2000,3492,10,36473,2026,1,2,3,1,90270,35709,7256,48346,0
148,7105,1392,870,1177,35,17,170,1427,14,494,280,531,508,811,4473,7289,7,54850,3047,2,2,13,2,90270,35712,7257,48347,0
124,5153,1450,624,1228,12,26,181,1462,14,306,186,354,320,540,2580,4493,8,36391,2021,1,2,8,11,90270,35714,7258,48348,0
124,5153,1450,624,1228,12,26,181,1462,14,306,186,354,320,540,2580,4493,8,36391,2021,1,2,8,11,90270,35716,7259,48349,0
1,95,42,7,35,4,0,5,46,1,2,1,2,3,3,2,4,0,2,0,0,2,1,0,90270,35716,7259,48350,0
1,95,11,6,10,0,0,1,11,2,4,2,4,6,6,10,15,1,15,0,0,2,1,0,90270,35716,7259,48351,0
261,6237,4293,999,3693,19,54,507,4312,9,155,88,170,164,258,1156,1898,4,9368,520,0,2,3,2,90270,35718,7259,48352,0
261,6237,1482,859,1002,125,135,219,1607,16,219,134,251,235,385,1766,3032,9,27804,1544,1,2,3,2,90280,35719,7259,48353,0
185,8002,4293,999,3693,19,54,507,4312,9,155,88,170,164,258,1156,1898,4,9368,520,0,2,18,0,90280,35721,7259,48354,0
185,8002,1482,859,1002,125,135,219,1607,16,219,134,251,235,385,1766,3032,9,27804,1544,1,2,18,0,90290,35722,7259,48355,0
185,8002,4293,999,3693,19,54,507,4312,9,155,88,170,164,258,1156,1898,4,9368,520,0,2,1,1,90290,35724,7259,48356,0
185,8002,1482,859,1002,125,135,219,1607,16,219,134,251,235,385,1766,3032,9,27804,1544,1,2,1,1,90300,35725,7259,48357,0
261,6225,4293,999,3693,19,54,507,4312,9,155,88,170,164,258,1156,1898,4,9368,520,0,2,1,1,90300,35727,7259,48358,0
261,6225,1482,859,1002,125,135,219,1607,16,219,134,251,235,385,1766,3032,9,27804,1544,1,2,1,1,90310,35728,7259,48359,0
1,95,42,7,35,4,0,5,46,1,2,1,2,3,3,2,4,0,2,0,0,2,1,0,90310,35728,7259,48360,0
1,95,11,6,10,0,0,1,11,2,4,2,4,6,6,10,15,1,15,0,0,2,1,0,90310,35728,7259,48361,0
261,6225,4293,999,3693,19,54,507,4312,9,155,88,170,164,258,1156,1898,4,9368,520,0,2,3,2,90310,35730,7259,48362,0
261,6225,1482,859,1002,125,135,219,1607,16,219,134,251,235,385,1766,3032,9,27804,1544,1,2,3,2,90320,35731,7259,48363,0
185,8002,4293,999,3693,19,54,507,4312,9,155,88,170,164,258,1156,1898,4,9368,520,0,2,18,0,90320,35733,7259,48364,0
185,8002,1482,859,1002,125,135,219,1607,16,219,134,251,235,385,1766,3032,9,27804,1544,1,2,18,0,90330,35734,7259,48365,0
113,5657,1523,757,1297,19,12,193,1542,12,193,117,230,205,347,1508,2664,7,19053,1058,0,2,14,11,90340,35736,7259,48366,0
105,2754,773,422,505,30,103,129,803,14,77,46,83,91,129,535,839,7,6334,351,0,2,1,0,90350,35737,7260,48369,0
105,2754,773,422,505,30,103,129,803,14,77,46,83,91,129,535,839,7,6334,351,0,2,1,0,90360,35738,7261,48370,0
238,5076,2,2,2,0,0,0,2,0,0,0,0,0,0,0,0,0,0,0,0,2,2,0,90360,35738,7261,48370,0
238,5076,99,48,90,1,3,5,100,0,0,0,0,0,0,0,0,0,0,0,0,2,2,0,90360,35739,7261,48371,0
238,5076,8,5,5,2,0,1,10,0,0,0,0,0,0,0,0,0,0,0,0,2,2,0,90360,35739,7261,48372,0
238,5076,1217,716,841,84,126,174,1301,14,185,118,215,199,333,1446,2542,8,20687,1149,0,2,2,0,90370,35741,7261,48373,0
238,5076,160,89,115,0,13,31,160,7,15,11,17,22,28,78,124,3,495,27,0,2,2,0,90370,35741,7261,48374,0
238,5076,10,10,9,9,0,0,19,0,0,0,0,0,0,0,0,0,0,0,0,2,2,0,90370,35741,7262,48375,0
238,5076,173,84,99,8,29,36,181,5,12,7,13,17,20,54,81,2,221,12,0,2,2,0,90370,35742,7262,48376,0
238,5076,3,1,1,3,0,0,6,0,0,0,0,0,0,0,0,0,0,0,0,2,2,0,90370,35742,7262,48377,0
261,6225,4293,999,3693,19,54,507,4312,9,155,88,170,164,258,1156,1898,4,9368,520,0,2,6,2,90370,35744,7262,48378,0
261,6225,1482,859,1002,125,135,219,1607,16,219,134,251,235,385,1766,3032,9,27804,1544,1,2,6,2,90380,35745,7262,48379,0
54,640,647,139,84,35,284,233,682,0,0,0,0,0,0,0,0,0,0,0,0,2,2,0,90380,35745,7262,48380,0
142,3472,77,34,69,0,0,8,77,3,24,16,29,27,45,114,213,1,387,21,0,2,2,0,90380,35745,7262,48381,0
142,3472,712,438,573,51,9,84,763,14,102,71,128,116,199,733,1364,8,11988,666,0,2,2,0,90390,35746,7262,48382,0
113,5657,1523,757,1297,19,12,193,1542,12,193,117,230,205,347,1508,2664,7,19053,1058,0,2,14,11,90400,35748,7262,48383,0
238,5076,2,2,2,0,0,0,2,0,0,0,0,0,0,0,0,0,0,0,0,2,2,0,90400,35748,7262,48385,0
238,5076,99,48,90,1,3,5,100,0,0,0,0,0,0,0,0,0,0,0,0,2,2,0,90400,35749,7262,48386,0
238,5076,8,5,5,2,0,1,10,0,0,0,0,0,0,0,0,0,0,0,0,2,2,0,90400,35749,7262,48387,0
238,5076,1217,716,841,84,126,174,1301,14,185,118,215,199,333,1446,2542,8,20687,1149,0,2,2,0,90410,35751,7262,48388,0
238,5076,160,89,115,0,13,31,160,7,15,11,17,22,28,78,124,3,495,27,0,2,2,0,90410,35751,7262,48389,0
238,5076,10,10,9,9,0,0,19,0,0,0,0,0,0,0,0,0,0,0,0,2,2,0,90410,35751,7263,48390,0
238,5076,173,84,99,8,29,36,181,5,12,7,13,17,20,54,81,2,221,12,0,2,2,0,90410,35752,7263,48391,0
238,5076,3,1,1,3,0,0,6,0,0,0,0,0,0,0,0,0,0,0,0,2,2,0,90410,35752,7263,48392,0
261,6225,4293,999,3693,19,54,507,4312,9,155,88,170,164,258,1156,1898,4,9368,520,0,2,6,2,90410,35754,7263,48393,0
261,6225,1482,859,1002,125,135,219,1607,16,219,134,251,235,385,1766,3032,9,27804,1544,1,2,6,2,90420,35755,7263,48394,0
54,640,647,139,84,35,284,233,682,0,0,0,0,0,0,0,0,0,0,0,0,2,2,0,90420,35755,7263,48395,0
142,3472,77,34,69,0,0,8,77,3,24,16,29,27,45,114,213,1,387,21,0,2,2,0,90420,35755,7263,48396,0
142,3472,712,438,573,51,9,84,763,14,102,71,128,116,199,733,1364,8,11988,666,0,2,2,0,90430,35756,7263,48397,0
1,93,42,7,35,4,0,5,46,1,2,1,2,3,3,2,4,0,2,0,0,2,0,1,90430,35756,7263,48398,0
1,93,11,6,10,0,0,1,11,2,4,2,4,6,6,10,15,1,15,0,0,2,0,1,90430,35756,7263,48399,0
185,8008,4293,999,3693,19,54,507,4312,9,155,88,170,164,258,1156,1898,4,9368,520,0,2,2,0,90430,35758,7263,48400,0
185,8008,1482,859,1002,125,135,219,1607,16,219,134,251,235,385,1766,3032,9,27804,1544,1,2,2,0,90440,35759,7263,48401,0
1,93,42,7,35,4,0,5,46,1,2,1,2,3,3,2,4,0,2,0,0,2,0,1,90440,35759,7263,48402,0
1,93,11,6,10,0,0,1,11,2,4,2,4,6,6,10,15,1,15,0,0,2,0,1,90440,35759,7263,48403,0
185,8008,4293,999,3693,19,54,507,4312,9,155,88,170,164,258,1156,1898,4,9368,520,0,2,2,0,90440,35761,7263,48404,0
185,8008,1482,859,1002,125,135,219,1607,16,219,134,251,235,385,1766,3032,9,27804,1544,1,2,2,0,90450,35762,7263,48405,0
76,3969,1293,570,1093,25,15,163,1318,10,195,123,241,205,364,1516,2795,6,17273,959,0,2,8,0,90460,35764,7263,48406,0
76,3969,1293,570,1093,25,15,163,1318,10,195,123,241,205,364,1516,2795,6,17273,959,0,2,8,0,90470,35766,7263,48407,0
238,5076,2,2,2,0,0,0,2,0,0,0,0,0,0,0,0,0,0,0,0,2,2,0,90470,35766,7263,48407,0
238,5076,99,48,90,1,3,5,100,0,0,0,0,0,0,0,0,0,0,0,0,2,2,0,90470,35767,7263,48408,0
238,5076,8,5,5,2,0,1,10,0,0,0,0,0,0,0,0,0,0,0,0,2,2,0,90470,35767,7263,48409,0
238,5076,1217,716,841,84,126,174,1301,14,185,118,215,199,333,1446,2542,8,20687,1149,0,2,2,0,90480,35769,7263,48410,0
238,5076,160,89,115,0,13,31,160,7,15,11,17,22,28,78,124,3,495,27,0,2,2,0,90480,35769,7263,48411,0
238,5076,10,10,9,9,0,0,19,0,0,0,0,0,0,0,0,0,0,0,0,2,2,0,90480,35769,7264,48412,0
238,5076,173,84,99,8,29,36,181,5,12,7,13,17,20,54,81,2,221,12,0,2,2,0,90480,35770,7264,48413,0
238,5076,3,1,1,3,0,0,6,0,0,0,0,0,0,0,0,0,0,0,0,2,2,0,90480,35770,7264,48414,0
261,6225,4293,999,3693,19,54,507,4312,9,155,88,170,164,258,1156,1898,4,9368,520,0,2,9,4,90480,35772,7264,48415,0
261,6225,1482,859,1002,125,135,219,1607,16,219,134,251,235,385,1766,3032,9,27804,1544,1,2,9,4,90490,35773,7264,48416,0
54,640,647,139,84,35,284,233,682,0,0,0,0,0,0,0,0,0,0,0,0,2,2,0,90490,35773,7264,48417,0
105,2754,773,422,505,30,103,129,803,14,77,46,83,91,129,535,839,7,6334,351,0,2,1,0,90500,35774,7265,48418,0
142,3472,77,34,69,0,0,8,77,3,24,16,29,27,45,114,213,1,387,21,0,2,2,0,90500,35774,7265,48419,0
142,3472,712,438,573,51,9,84,763,14,102,71,128,116,199,733,1364,8,11988,666,0,2,2,0,90510,35775,7265,48420,0
185,7999,4293,999,3693,19,54,507,4312,9,155,88,170,164,258,1156,1898,4,9368,520,0,2,20,0,90510,35777,7265,48421,0
185,7999,1482,859,1002,125,135,219,1607,16,219,134,251,235,385,1766,3032,9,27804,1544,1,2,20,0,90520,35778,7265,48422,0
76,3969,1293,570,1093,25,15,163,1318,10,195,123,241,205,364,1516,2795,6,17273,959,0,2,8,0,90530,35780,7265,48423,0
238,5076,2,2,2,0,0,0,2,0,0,0,0,0,0,0,0,0,0,0,0,2,2,0,90530,35780,7265,48423,0
238,5076,99,48,90,1,3,5,100,0,0,0,0,0,0,0,0,0,0,0,0,2,2,0,90530,35781,7265,48424,0
238,5076,8,5,5,2,0,1,10,0,0,0,0,0,0,0,0,0,0,0,0,2,2,0,90530,35781,7265,48425,0
238,5076,1217,716,841,84,126,174,1301,14,185,118,215,199,333,1446,2542,8,20687,1149,0,2,2,0,90540,35783,7265,48426,0
238,5076,160,89,115,0,13,31,160,7,15,11,17,22,28,78,124,3,495,27,0,2,2,0,90540,35783,7265,48427,0
238,5076,10,10,9,9,0,0,19,0,0,0,0,0,0,0,0,0,0,0,0,2,2,0,90540,35783,7266,48428,0
238,5076,173,84,99,8,29,36,181,5,12,7,13,17,20,54,81,2,221,12,0,2,2,0,90540,35784,7266,48429,0
238,5076,3,1,1,3,0,0,6,0,0,0,0,0,0,0,0,0,0,0,0,2,2,0,90540,35784,7266,48430,0
261,6225,4293,999,3693,19,54,507,4312,9,155,88,170,164,258,1156,1898,4,9368,520,0,2,9,4,90540,35786,7266,48431,0
261,6225,1482,859,1002,125,135,219,1607,16,219,134,251,235,385,1766,3032,9,27804,1544,1,2,9,4,90550,35787,7266,48432,0
54,640,647,139,84,35,284,233,682,0,0,0,0,0,0,0,0,0,0,0,0,2,2,0,90550,35787,7266,48433,0
105,2754,773,422,505,30,103,129,803,14,77,46,83,91,129,535,839,7,6334,351,0,2,1,0,90560,35788,7267,48434,0
142,3472,77,34,69,0,0,8,77,3,24,16,29,27,45,114,213,1,387,21,0,2,2,0,90560,35788,7267,48435,0
142,3472,712,438,573,51,9,84,763,14,102,71,128,116,199,733,1364,8,11988,666,0,2,2,0,90570,35789,7267,48436,0
185,7999,4293,999,3693,19,54,507,4312,9,155,88,170,164,258,1156,1898,4,9368,520,0,2,20,0,90570,35791,7267,48437,0
185,7999,1482,859,1002,125,135,219,1607,16,219,134,251,235,385,1766,3032,9,27804,1544,1,2,20,0,90580,35792,7267,48438,0
76,3969,1293,570,1093,25,15,163,1318,10,195,123,241,205,364,1516,2795,6,17273,959,0,2,8,0,90590,35794,7267,48439,0
282,5905,1943,715,1694,26,18,214,1969,12,185,120,237,197,357,1436,2721,7,20915,1161,0,2,5,1,90590,35796,7267,48440,0
282,5905,1168,838,957,57,25,144,1225,19,348,224,416,367,640,3018,5452,11,61921,3440,1,2,5,1,90600,35798,7267,48441,0
237,5050,2,2,2,0,0,0,2,0,0,0,0,0,0,0,0,0,0,0,0,2,0,5,90600,35798,7267,48441,0
237,5050,99,48,90,1,3,5,100,0,0,0,0,0,0,0,0,0,0,0,0,2,0,5,90600,35799,7267,48442,0
237,5050,8,5,5,2,0,1,10,0,0,0,0,0,0,0,0,0,0,0,0,2,0,5,90600,35799,7267,48443,0
237,5050,1217,716,841,84,126,174,1301,14,185,118,215,199,333,1446,2542,8,20687,1149,0,2,0,5,90610,35801,7267,48444,0
237,5050,160,89,115,0,13,31,160,7,15,11,17,22,28,78,124,3,495,27,0,2,0,5,90610,35801,7267,48445,0
237,5050,10,10,9,9,0,0,19,0,0,0,0,0,0,0,0,0,0,0,0,2,0,5,90610,35801,7268,48446,0
237,5050,173,84,99,8,29,36,181,5,12,7,13,17,20,54,81,2,221,12,0,2,0,5,90610,35802,7268,48447,0
237,5050,3,1,1,3,0,0,6,0,0,0,0,0,0,0,0,0,0,0,0,2,0,5,90610,35802,7268,48448,0
282,5905,1943,715,1694,26,18,214,1969,12,185,120,237,197,357,1436,2721,7,20915,1161,0,2,5,1,90610,35804,7268,48449,0
282,5905,1168,838,957,57,25,144,1225,19,348,224,416,367,640,3018,5452,11,61921,3440,1,2,5,1,90620,35806,7268,48450,0
237,5050,2,2,2,0,0,0,2,0,0,0,0,0,0,0,0,0,0,0,0,2,0,5,90620,35806,7268,48450,0
237,5050,99,48,90,1,3,5,100,0,0,0,0,0,0,0,0,0,0,0,0,2,0,5,90620,35807,7268,48451,0
237,5050,8,5,5,2,0,1,10,0,0,0,0,0,0,0,0,0,0,0,0,2,0,5,90620,35807,7268,48452,0
237,5050,1217,716,841,84,126,174,1301,14,185,118,215,199,333,1446,2542,8,20687,1149,0,2,0,5,90630,35809,7268,48453,0
237,5050,160,89,115,0,13,31,160,7,15,11,17,22,28,78,124,3,495,27,0,2,0,5,90630,35809,7268,48454,0
237,5050,10,10,9,9,0,0,19,0,0,0,0,0,0,0,0,0,0,0,0,2,0,5,90630,35809,7269,48455,0
237,5050,173,84,99,8,29,36,181,5,12,7,13,17,20,54,81,2,221,12,0,2,0,5,90630,35810,7269,48456,0
237,5050,3,1,1,3,0,0,6,0,0,0,0,0,0,0,0,0,0,0,0,2,0,5,90630,35810,7269,48457,0
216,4989,182,127,129,0,0,53,182,5,39,21,42,44,63,217,343,2,926,51,0,2,1,1,90630,35810,7270,48458,0
216,4989,1165,710,800,67,119,181,1232,18,243,153,282,261,435,2000,3492,10,36473,2026,1,2,1,1,90640,35810,7271,48459,0
90,2024,996,429,845,24,10,117,1020,7,76,50,88,83,138,494,879,4,3565,198,0,2,6,2,90640,35812,7271,48460,0
90,2024,456,277,329,12,42,72,468,13,85,50,97,98,147,592,972,7,7212,400,0,2,6,2,90640,35812,7271,48461,0
49,3806,996,429,845,24,10,117,1020,7,76,50,88,83,138,494,879,4,3565,198,0,2,6,1,90640,35814,7271,48462,0
51,2040,1098,241,925,5,10,155,1103,7,46,25,49,53,74,273,423,3,1580,87,0,2,19,7,90650,35816,7271,48463,0
87,1918,1043,504,840,53,9,147,1096,9,180,112,198,189,310,1377,2344,4,11604,644,0,2,3,10,90650,35818,7271,48464,0
87,1918,383,288,292,26,6,62,409,11,65,38,67,76,105,429,656,5,3719,206,0,2,3,10,90650,35819,7271,48465,0
88,3446,1043,504,840,53,9,147,1096,9,180,112,198,189,310,1377,2344,4,11604,644,0,2,11,2,90650,35821,7271,48466,0
216,4989,182,127,129,0,0,53,182,5,39,21,42,44,63,217,343,2,926,51,0,2,1,1,90650,35821,7272,48467,0
216,4989,1165,710,800,67,119,181,1232,18,243,153,282,261,435,2000,3492,10,36473,2026,1,2,1,1,90660,35821,7273,48468,0
20,381,294,64,250,0,0,43,294,1,20,10,20,21,30,86,131,0,65,3,0,2,0,5,90660,35821,7273,48469,0
20,381,78,46,62,3,0,14,81,3,8,4,8,11,12,28,41,1,62,3,0,2,0,5,90660,35822,7273,48470,0
239,5074,2,2,2,0,0,0,2,0,0,0,0,0,0,0,0,0,0,0,0,2,5,6,90660,35822,7273,48470,0
239,5074,99,48,90,1,3,5,100,0,0,0,0,0,0,0,0,0,0,0,0,2,5,6,90660,35823,7273,48471,0
239,5074,8,5,5,2,0,1,10,0,0,0,0,0,0,0,0,0,0,0,0,2,5,6,90660,35823,7273,48472,0
239,5074,1217,716,841,84,126,174,1301,14,185,118,215,199,333,1446,2542,8,20687,1149,0,2,5,6,90670,35825,7273,48473,0
239,5074,160,89,115,0,13,31,160,7,15,11,17,22,28,78,124,3,495,27,0,2,5,6,90670,35825,7273,48474,0
239,5074,10,10,9,9,0,0,19,0,0,0,0,0,0,0,0,0,0,0,0,2,5,6,90670,35825,7274,48475,0
239,5074,173,84,99,8,29,36,181,5,12,7,13,17,20,54,81,2,221,12,0,2,5,6,90670,35826,7274,48476,0
239,5074,3,1,1,3,0,0,6,0,0,0,0,0,0,0,0,0,0,0,0,2,5,6,90670,35826,7274,48477,0
111,6057,1457,730,1242,11,6,188,1468,10,292,166,329,302,495,2424,4078,5,22973,1276,1,2,7,2,90670,35828,7274,48478,0
87,1918,1043,504,840,53,9,147,1096,9,180,112,198,189,310,1377,2344,4,11604,644,0,2,3,10,90670,35830,7274,48479,0
87,1918,383,288,292,26,6,62,409,11,65,38,67,76,105,429,656,5,3719,206,0,2,3,10,90670,35831,7274,48480,0
88,3446,1043,504,840,53,9,147,1096,9,180,112,198,189,310,1377,2344,4,11604,644,0,2,11,2,90670,35833,7274,48481,0
239,5074,2,2,2,0,0,0,2,0,0,0,0,0,0,0,0,0,0,0,0,2,5,6,90670,35833,7274,48481,0
239,5074,99,48,90,1,3,5,100,0,0,0,0,0,0,0,0,0,0,0,0,2,5,6,90670,35834,7274,48482,0
239,5074,8,5,5,2,0,1,10,0,0,0,0,0,0,0,0,0,0,0,0,2,5,6,90670,35834,7274,48483,0
239,5074,1217,716,841,84,126,174,1301,14,185,118,215,199,333,1446,2542,8,20687,1149,0,2,5,6,90680,35836,7274,48484,0
239,5074,160,89,115,0,13,31,160,7,15,11,17,22,28,78,124,3,495,27,0,2,5,6,90680,35836,7274,48485,0
239,5074,10,10,9,9,0,0,19,0,0,0,0,0,0,0,0,0,0,0,0,2,5,6,90680,35836,7275,48486,0
239,5074,173,84,99,8,29,36,181,5,12,7,13,17,20,54,81,2,221,12,0,2,5,6,90680,35837,7275,48487,0
239,5074,3,1,1,3,0,0,6,0,0,0,0,0,0,0,0,0,0,0,0,2,5,6,90680,35837,7275,48488,0
111,6057,1457,730,1242,11,6,188,1468,10,292,166,329,302,495,2424,4078,5,22973,1276,1,2,7,2,90680,35839,7275,48489,0
90,2013,996,429,845,24,10,117,1020,7,76,50,88,83,138,494,879,4,3565,198,0,2,1,1,90680,35841,7275,48490,0
90,2013,456,277,329,12,42,72,468,13,85,50,97,98,147,592,972,7,7212,400,0,2,1,1,90680,35841,7275,48491,0
49,3782,996,429,845,24,10,117,1020,7,76,50,88,83,138,494,879,4,3565,198,0,2,1,1,90680,35843,7275,48492,0
90,2013,996,429,845,24,10,117,1020,7,76,50,88,83,138,494,879,4,3565,198,0,2,1,1,90680,35845,7275,48493,0
90,2013,456,277,329,12,42,72,468,13,85,50,97,98,147,592,972,7,7212,400,0,2,1,1,90680,35845,7275,48494,0
49,3782,996,429,845,24,10,117,1020,7,76,50,88,83,138,494,879,4,3565,198,0,2,1,1,90680,35847,7275,48495,0
51,2040,1098,241,925,5,10,155,1103,7,46,25,49,53,74,273,423,3,1580,87,0,2,19,7,90690,35849,7275,48496,0
23,615,601,196,481,2,23,85,603,8,63,36,72,71,108,400,664,4,3036,168,0,2,1,1,90690,35849,7275,48497,0
23,615,156,79,106,5,16,28,161,5,14,8,15,19,23,64,97,2,261,14,0,2,1,1,90690,35849,7275,48498,0
20,405,294,64,250,0,0,43,294,1,20,10,20,21,30,86,131,0,65,3,0,2,1,2,90690,35849,7275,48499,0
20,405,78,46,62,3,0,14,81,3,8,4,8,11,12,28,41,1,62,3,0,2,1,2,90690,35850,7275,48500,0
20,381,294,64,250,0,0,43,294,1,20,10,20,21,30,86,131,0,65,3,0,2,0,5,90690,35850,7275,48501,0
20,381,78,46,62,3,0,14,81,3,8,4,8,11,12,28,41,1,62,3,0,2,0,5,90690,35851,7275,48502,0
124,2350,477,336,357,30,23,73,507,16,194,134,250,210,384,1538,2962,10,30538,1696,0,2,13,4,90700,35852,7275,48503,0
185,6013,1660,832,1314,41,38,274,1701,20,312,209,395,332,604,2671,5058,12,64042,3557,1,2,15,6,90700,35854,7276,48505,0
90,2013,996,429,845,24,10,117,1020,7,76,50,88,83,138,494,879,4,3565,198,0,2,1,1,90700,35856,7276,48506,0
90,2013,456,277,329,12,42,72,468,13,85,50,97,98,147,592,972,7,7212,400,0,2,1,1,90700,35856,7276,48507,0
238,5048,2,2,2,0,0,0,2,0,0,0,0,0,0,0,0,0,0,0,0,2,0,5,90700,35856,7276,48507,0
238,5048,99,48,90,1,3,5,100,0,0,0,0,0,0,0,0,0,0,0,0,2,0,5,90700,35857,7276,48508,0
238,5048,8,5,5,2,0,1,10,0,0,0,0,0,0,0,0,0,0,0,0,2,0,5,90700,35857,7276,48509,0
238,5048,1217,716,841,84,126,174,1301,14,185,118,215,199,333,1446,2542,8,20687,1149,0,2,0,5,90710,35859,7276,48510,0
238,5048,160,89,115,0,13,31,160,7,15,11,17,22,28,78,124,3,495,27,0,2,0,5,90710,35859,7276,48511,0
238,5048,10,10,9,9,0,0,19,0,0,0,0,0,0,0,0,0,0,0,0,2,0,5,90710,35859,7277,48512,0
238,5048,173,84,99,8,29,36,181,5,12,7,13,17,20,54,81,2,221,12,0,2,0,5,90710,35860,7277,48513,0
238,5048,3,1,1,3,0,0,6,0,0,0,0,0,0,0,0,0,0,0,0,2,0,5,90710,35860,7277,48514,0
20,381,294,64,250,0,0,43,294,1,20,10,20,21,30,86,131,0,65,3,0,2,0,5,90710,35860,7277,48515,0
20,381,78,46,62,3,0,14,81,3,8,4,8,11,12,28,41,1,62,3,0,2,0,5,90710,35861,7277,48516,0
49,3773,996,429,845,24,10,117,1020,7,76,50,88,83,138,494,879,4,3565,198,0,2,1,1,90710,35863,7277,48517,0
12,572,294,64,250,0,0,43,294,1,20,10,20,21,30,86,131,0,65,3,0,2,25,0,90710,35863,7277,48518,0
304,6701,72,33,56,0,4,12,72,1,1,1,1,2,2,0,2,0,1,0,0,2,10,6,90710,35863,7277,48519,1
304,6701,1454,835,1044,76,110,219,1530,17,275,158,296,292,454,2297,3718,9,34017,1889,1,2,10,6,90720,35864,7277,48520,1
80,3116,1178,367,1042,6,15,115,1184,9,94,51,95,103,146,644,976,4,4439,246,0,2,23,0,90720,35864,7277,48521,1
306,6750,72,33,56,0,4,12,72,1,1,1,1,2,2,0,2,0,1,0,0,2,10,1,90720,35864,7277,48522,0
306,6750,1454,835,1044,76,110,219,1530,17,275,158,296,292,454,2297,3718,9,34017,1889,1,2,10,1,90730,35865,7277,48523,0
306,6763,72,33,56,0,4,12,72,1,1,1,1,2,2,0,2,0,1,0,0,2,9,10,90730,35865,7277,48524,1
306,6763,1454,835,1044,76,110,219,1530,17,275,158,296,292,454,2297,3718,9,34017,1889,1,2,9,10,90740,35866,7277,48525,1
232,5898,722,423,573,19,0,135,741,12,172,101,199,184,300,1320,2257,6,15668,870,0,2,0,2,90740,35868,7277,48527,0
232,5898,1508,847,911,44,250,301,1552,14,148,88,169,162,257,1120,1886,7,15077,837,0,2,0,2,90740,35869,7278,48528,0
161,3433,1513,682,1277,25,13,200,1538,11,199,116,219,210,335,1557,2584,6,15641,868,0,2,0,7,90740,35871,7278,48529,0
161,3433,819,519,539,24,98,155,843,15,96,57,106,111,163,690,1107,8,9171,509,0,2,0,7,90750,35873,7278,48530,0
288,6093,1943,715,1694,26,18,214,1969,12,185,120,237,197,357,1436,2721,7,20915,1161,0,2,60,23,90750,35875,7278,48531,0
288,6093,1168,838,957,57,25,144,1225,19,348,224,416,367,640,3018,5452,11,61921,3440,1,2,60,23,90760,35877,7278,48532,0
76,3969,1293,570,1093,25,15,163,1318,10,195,123,241,205,364,1516,2795,6,17273,959,0,2,5,5,90770,35879,7278,48533,0
112,6632,1943,715,1694,26,18,214,1969,12,185,120,237,197,357,1436,2721,7,20915,1161,0,2,106,25,90770,35881,7278,48534,0
90,2013,996,429,845,24,10,117,1020,7,76,50,88,83,138,494,879,4,3565,198,0,2,1,1,90770,35883,7278,48535,0
90,2013,456,277,329,12,42,72,468,13,85,50,97,98,147,592,972,7,7212,400,0,2,1,1,90770,35883,7278,48536,0
238,5048,2,2,2,0,0,0,2,0,0,0,0,0,0,0,0,0,0,0,0,2,0,5,90770,35883,7278,48536,0
238,5048,99,48,90,1,3,5,100,0,0,0,0,0,0,0,0,0,0,0,0,2,0,5,90770,35884,7278,48537,0
238,5048,8,5,5,2,0,1,10,0,0,0,0,0,0,0,0,0,0,0,0,2,0,5,90770,35884,7278,48538,0
238,5048,1217,716,841,84,126,174,1301,14,185,118,215,199,333,1446,2542,8,20687,1149,0,2,0,5,90780,35886,7278,48539,0
238,5048,160,89,115,0,13,31,160,7,15,11,17,22,28,78,124,3,495,27,0,2,0,5,90780,35886,7278,48540,0
238,5048,10,10,9,9,0,0,19,0,0,0,0,0,0,0,0,0,0,0,0,2,0,5,90780,35886,7279,48541,0
238,5048,173,84,99,8,29,36,181,5,12,7,13,17,20,54,81,2,221,12,0,2,0,5,90780,35887,7279,48542,0
238,5048,3,1,1,3,0,0,6,0,0,0,0,0,0,0,0,0,0,0,0,2,0,5,90780,35887,7279,48543,0
20,381,294,64,250,0,0,43,294,1,20,10,20,21,30,86,131,0,65,3,0,2,0,5,90780,35887,7279,48544,0
20,381,78,46,62,3,0,14,81,3,8,4,8,11,12,28,41,1,62,3,0,2,0,5,90780,35888,7279,48545,0
49,3773,996,429,845,24,10,117,1020,7,76,50,88,83,138,494,879,4,3565,198,0,2,1,1,90780,35890,7279,48546,0
12,572,294,64,250,0,0,43,294,1,20,10,20,21,30,86,131,0,65,3,0,2,25,0,90780,35890,7279,48547,0
161,3434,1513,682,1277,25,13,200,1538,11,199,116,219,210,335,1557,2584,6,15641,868,0,2,3,1,90780,35892,7279,48548,0
161,3434,819,519,539,24,98,155,843,15,96,57,106,111,163,690,1107,8,9171,509,0,2,3,1,90790,35894,7279,48549,0
3,96,35,12,22,4,5,6,39,1,2,1,2,3,3,2,4,0,2,0,0,2,1,0,90790,35894,7279,48550,0
1,300,382,65,130,157,2,92,539,4,10,5,10,14,15,41,57,2,114,6,0,2,3,5,90790,35895,7280,48551,0
60,1139,282,196,195,3,0,86,285,8,130,71,141,138,212,936,1507,4,6538,363,0,2,1,1,90790,35895,7281,48552,0
3,65,127,75,83,2,11,30,129,4,14,7,14,18,21,61,87,2,175,9,0,2,1,1,90790,35895,7281,48553,0
3,65,652,304,544,16,6,88,668,6,89,51,101,95,152,591,998,3,3399,188,0,2,1,1,90790,35896,7281,48554,0
3,65,2,2,2,0,0,0,2,0,0,0,0,0,0,0,0,0,0,0,0,2,1,1,90790,35896,7281,48554,0
3,65,8,5,5,0,0,3,8,0,0,0,0,0,0,0,0,0,0,0,0,2,1,1,90790,35896,7281,48555,0
3,65,2,2,2,0,0,0,2,0,0,0,0,0,0,0,0,0,0,0,0,2,1,1,90790,35896,7281,48555,0
3,65,14,8,8,0,0,6,14,0,0,0,0,0,0,0,0,0,0,0,0,2,1,1,90790,35896,7281,48556,0
3,65,6,4,4,0,0,2,6,0,0,0,0,0,0,0,0,0,0,0,0,2,1,1,90790,35896,7281,48557,0
3,65,6,4,4,0,0,2,6,1,2,1,2,3,3,2,4,0,2,0,0,2,1,1,90790,35896,7281,48558,0
3,65,6,4,4,0,0,2,6,0,0,0,0,0,0,0,0,0,0,0,0,2,1,1,90790,35896,7281,48559,0
3,65,7,5,5,0,0,2,7,0,0,0,0,0,0,0,0,0,0,0,0,2,1,1,90790,35896,7281,48560,0
3,65,6,4,4,0,0,2,6,0,0,0,0,0,0,0,0,0,0,0,0,2,1,1,90790,35896,7281,48561,0
3,65,10,6,6,0,0,4,10,0,0,0,0,0,0,0,0,0,0,0,0,2,1,1,90790,35896,7281,48562,0
3,65,1,1,1,0,0,0,1,0,0,0,0,0,0,0,0,0,0,0,0,2,1,1,90790,35896,7281,48562,0
3,65,14,10,10,0,0,4,14,1,1,1,1,2,2,0,2,0,1,0,0,2,1,1,90790,35896,7281,48563,0
3,65,46,26,30,3,0,12,49,3,6,3,6,9,9,20,28,1,42,2,0,2,1,1,90800,35896,7281,48564,0
7,140,38,22,22,1,0,15,39,1,2,1,2,3,3,2,4,0,2,0,0,0,38,0,90800,35896,7281,48565,0
7,292,72,33,56,0,4,12,72,1,1,1,1,2,2,0,2,0,1,0,0,2,1,1,90800,35896,7281,48566,0
12,228,127,75,83,2,11,30,129,4,14,7,14,18,21,61,87,2,175,9,0,2,2,2,90800,35896,7281,48567,0
12,228,652,304,544,16,6,88,668,6,89,51,101,95,152,591,998,3,3399,188,0,2,2,2,90800,35897,7281,48568,0
12,228,2,2,2,0,0,0,2,0,0,0,0,0,0,0,0,0,0,0,0,2,2,2,90800,35897,7281,48568,0
12,228,8,5,5,0,0,3,8,0,0,0,0,0,0,0,0,0,0,0,0,2,2,2,90800,35897,7281,48569,0
12,228,2,2,2,0,0,0,2,0,0,0,0,0,0,0,0,0,0,0,0,2,2,2,90800,35897,7281,48569,0
12,228,14,8,8,0,0,6,14,0,0,0,0,0,0,0,0,0,0,0,0,2,2,2,90800,35897,7281,48570,0
12,228,6,4,4,0,0,2,6,0,0,0,0,0,0,0,0,0,0,0,0,2,2,2,90800,35897,7281,48571,0
12,228,6,4,4,0,0,2,6,1,2,1,2,3,3,2,4,0,2,0,0,2,2,2,90800,35897,7281,48572,0
12,228,6,4,4,0,0,2,6,0,0,0,0,0,0,0,0,0,0,0,0,2,2,2,90800,35897,7281,48573,0
12,228,7,5,5,0,0,2,7,0,0,0,0,0,0,0,0,0,0,0,0,2,2,2,90800,35897,7281,48574,0
12,228,6,4,4,0,0,2,6,0,0,0,0,0,0,0,0,0,0,0,0,2,2,2,90800,35897,7281,48575,0
12,228,10,6,6,0,0,4,10,0,0,0,0,0,0,0,0,0,0,0,0,2,2,2,90800,35897,7281,48576,0
12,228,1,1,1,0,0,0,1,0,0,0,0,0,0,0,0,0,0,0,0,2,2,2,90800,35897,7281,48576,0
12,228,14,10,10,0,0,4,14,1,1,1,1,2,2,0,2,0,1,0,0,2,2,2,90800,35897,7281,48577,0
12,228,46,26,30,3,0,12,49,3,6,3,6,9,9,20,28,1,42,2,0,2,2,2,90810,35897,7281,48578,0
1,93,42,7,35,4,0,5,46,1,2,1,2,3,3,2,4,0,2,0,0,2,3,4,90810,35897,7281,48579,0
1,93,11,6,10,0,0,1,11,2,4,2,4,6,6,10,15,1,15,0,0,2,3,4,90810,35897,7281,48580,0
216,4989,182,127,129,0,0,53,182,5,39,21,42,44,63,217,343,2,926,51,0,2,25,14,90810,35897,7282,48581,0
216,4989,1165,710,800,67,119,181,1232,18,243,153,282,261,435,2000,3492,10,36473,2026,1,2,25,14,90820,35897,7283,48582,0
67,1549,773,419,590,28,0,166,801,10,204,113,217,214,330,1598,2554,5,13587,754,0,2,7,6,90820,35897,7284,48583,0
67,1549,421,273,302,44,34,57,465,17,81,59,107,98,166,583,1098,11,12329,684,0,2,7,6,90820,35897,7285,48584,0
27,568,2,2,2,0,0,0,2,0,0,0,0,0,0,0,0,0,0,0,0,2,8,3,90820,35897,7285,48584,0
27,568,99,48,90,1,3,5,100,0,0,0,0,0,0,0,0,0,0,0,0,2,8,3,90820,35898,7285,48585,0
27,568,8,5,5,2,0,1,10,0,0,0,0,0,0,0,0,0,0,0,0,2,8,3,90820,35898,7285,48586,0
27,568,1217,716,841,84,126,174,1301,14,185,118,215,199,333,1446,2542,8,20687,1149,0,2,8,3,90830,35900,7285,48587,0
27,568,160,89,115,0,13,31,160,7,15,11,17,22,28,78,124,3,495,27,0,2,8,3,90830,35900,7285,48588,0
27,568,10,10,9,9,0,0,19,0,0,0,0,0,0,0,0,0,0,0,0,2,8,3,90830,35900,7286,48589,0
27,568,173,84,99,8,29,36,181,5,12,7,13,17,20,54,81,2,221,12,0,2,8,3,90830,35901,7286,48590,0
27,568,3,1,1,3,0,0,6,0,0,0,0,0,0,0,0,0,0,0,0,2,8,3,90830,35901,7286,48591,0
183,5415,1660,832,1314,41,38,274,1701,20,312,209,395,332,604,2671,5058,12,64042,3557,1,2,57,44,90830,35903,7287,48593,0
183,5415,1057,646,719,113,100,145,1170,18,215,134,248,233,382,1740,3004,10,31186,1732,1,2,57,44,90840,35904,7288,48594,0
123,2323,477,336,357,30,23,73,507,16,194,134,250,210,384,1538,2962,10,30538,1696,0,2,47,11,90850,35905,7288,48595,0
90,2013,996,429,845,24,10,117,1020,7,76,50,88,83,138,494,879,4,3565,198,0,2,3,3,90850,35907,7288,48596,0
90,2013,456,277,329,12,42,72,468,13,85,50,97,98,147,592,972,7,7212,400,0,2,3,3,90850,35907,7288,48597,0
161,3434,1513,682,1277,25,13,200,1538,11,199,116,219,210,335,1557,2584,6,15641,868,0,2,5,1,90850,35909,7288,48598,0
161,3434,819,519,539,24,98,155,843,15,96,57,106,111,163,690,1107,8,9171,509,0,2,5,1,90860,35911,7288,48599,0
58,1191,207,111,150,11,0,50,218,5,26,19,36,31,55,133,272,3,943,52,0,2,43,19,90860,35911,7288,48600,0
58,1191,410,198,237,31,55,97,441,11,63,38,72,74,110,414,683,6,4293,238,0,2,43,19,90870,35912,7289,48601,0
238,5048,2,2,2,0,0,0,2,0,0,0,0,0,0,0,0,0,0,0,0,2,54,37,90870,35912,7289,48601,0
238,5048,99,48,90,1,3,5,100,0,0,0,0,0,0,0,0,0,0,0,0,2,54,37,90870,35913,7289,48602,0
238,5048,8,5,5,2,0,1,10,0,0,0,0,0,0,0,0,0,0,0,0,2,54,37,90870,35913,7289,48603,0
238,5048,1217,716,841,84,126,174,1301,14,185,118,215,199,333,1446,2542,8,20687,1149,0,2,54,37,90880,35915,7289,48604,0
238,5048,160,89,115,0,13,31,160,7,15,11,17,22,28,78,124,3,495,27,0,2,54,37,90880,35915,7289,48605,0
238,5048,10,10,9,9,0,0,19,0,0,0,0,0,0,0,0,0,0,0,0,2,54,37,90880,35915,7290,48606,0
238,5048,173,84,99,8,29,36,181,5,12,7,13,17,20,54,81,2,221,12,0,2,54,37,90880,35916,7290,48607,0
238,5048,3,1,1,3,0,0,6,0,0,0,0,0,0,0,0,0,0,0,0,2,54,37,90880,35916,7290,48608,0
113,2326,463,295,324,28,62,57,491,12,134,82,154,146,236,989,1696,6,11700,650,0,2,31,15,90890,35917,7290,48609,0
37,813,167,116,138,4,5,22,171,8,48,30,56,56,86,292,499,4,2330,129,0,2,16,2,90890,35917,7290,48610,0
57,1488,339,213,244,17,9,65,356,10,42,26,48,52,74,259,421,5,2410,133,0,2,8,2,90900,35917,7290,48611,0
261,6225,4293,999,3693,19,54,507,4312,9,155,88,170,164,258,1156,1898,4,9368,520,0,2,134,14,90900,35919,7290,48613,0
261,6225,1482,859,1002,125,135,219,1607,16,219,134,251,235,385,1766,3032,9,27804,1544,1,2,134,14,90910,35920,7290,48614,0
31,1080,74,35,59,1,0,14,75,3,14,7,14,17,21,58,85,1,128,7,0,2,1,1,90910,35921,7290,48615,0
31,1080,245,125,200,5,7,34,250,7,30,17,34,37,51,166,265,3,1053,58,0,2,1,1,90920,35922,7290,48616,0
54,640,647,139,84,35,284,233,682,0,0,0,0,0,0,0,0,0,0,0,0,2,2,0,90920,35922,7290,48617,0
117,3166,1523,757,1297,19,12,193,1542,12,193,117,230,205,347,1508,2664,7,19053,1058,0,2,4,0,90930,35924,7290,48618,0
117,3166,701,378,504,33,58,109,734,13,110,68,126,123,194,794,1346,7,10027,557,0,2,4,0,90930,35925,7291,48619,0
105,2754,773,422,505,30,103,129,803,14,77,46,83,91,129,535,839,7,6334,351,0,2,1,0,90940,35926,7292,48620,0
142,3472,77,34,69,0,0,8,77,3,24,16,29,27,45,114,213,1,387,21,0,2,9,1,90940,35926,7292,48621,0
142,3472,712,438,573,51,9,84,763,14,102,71,128,116,199,733,1364,8,11988,666,0,2,9,1,90950,35927,7292,48622,0
30,669,125,97,103,3,0,19,128,9,25,17,27,34,44,144,223,4,1087,60,0,2,2,0,90950,35927,7293,48623,0
70,1535,402,202,227,24,74,80,426,12,52,33,61,64,94,339,564,7,3969,220,0,2,17,16,90950,35928,7293,48624,0
73,1701,53,23,39,0,0,13,53,2,8,4,8,10,12,26,39,1,39,2,0,2,41,22,90950,35928,7293,48625,0
73,1701,515,298,307,33,80,99,548,12,63,44,77,75,121,419,753,7,5527,307,0,2,41,22,90960,35928,7293,48626,0
12,572,205,80,86,16,53,53,221,7,18,10,19,25,29,94,134,3,497,27,0,2,20,10,90970,35928,7294,48627,0
16,491,184,100,137,2,15,30,186,6,38,20,39,44,59,214,322,3,991,55,0,2,10,5,90970,35929,7294,48628,0
16,491,103,65,74,8,5,16,111,7,17,9,17,24,26,89,119,3,417,23,0,2,10,5,90970,35930,7294,48629,0
64,1354,91,45,69,0,3,18,91,3,9,6,10,12,16,33,57,1,95,5,0,2,52,20,90970,35932,7294,48630,0
64,1354,367,234,237,17,34,68,384,16,55,34,61,71,95,381,584,8,5183,287,0,2,52,20,90970,35933,7294,48631,0
232,5908,722,423,573,19,0,135,741,12,172,101,199,184,300,1320,2257,6,15668,870,0,2,63,21,90970,35935,7294,48633,0
232,5908,1508,847,911,44,250,301,1552,14,148,88,169,162,257,1120,1886,7,15077,837,0,2,63,21,90970,35936,7295,48634,0
303,6685,72,33,56,0,4,12,72,1,1,1,1,2,2,0,2,0,1,0,0,2,14,19,90970,35936,7295,48635,0
303,6685,1454,835,1044,76,110,219,1530,17,275,158,296,292,454,2297,3718,9,34017,1889,1,2,14,19,90980,35937,7295,48636,0
79,1961,757,253,292,73,244,162,830,13,61,38,67,74,105,409,651,7,4654,258,0,2,8,7,90980,35938,7295,48637,0
20,987,386,256,301,16,9,68,402,4,59,35,69,63,104,355,621,2,1453,80,0,2,7,7,90980,35938,7295,48638,0
20,987,264,131,164,11,41,46,275,6,38,22,40,44,62,214,338,3,1068,59,0,2,7,7,90990,35938,7296,48639,0
79,1942,466,257,367,18,25,50,484,7,126,86,171,133,257,898,1813,4,8612,478,0,2,146,90,90990,35938,7296,48640,0
79,1942,507,281,342,29,59,88,536,10,53,29,57,63,86,336,514,5,2764,153,0,2,146,90,90990,35938,7296,48641,0
87,1918,1043,504,840,53,9,147,1096,9,180,112,198,189,310,1377,2344,4,11604,644,0,2,25,26,90990,35940,7296,48642,0
87,1918,383,288,292,26,6,62,409,11,65,38,67,76,105,429,656,5,3719,206,0,2,25,26,90990,35941,7296,48643,0
20,381,294,64,250,0,0,43,294,1,20,10,20,21,30,86,131,0,65,3,0,2,0,5,90990,35941,7296,48644,0
20,381,78,46,62,3,0,14,81,3,8,4,8,11,12,28,41,1,62,3,0,2,0,5,90990,35942,7296,48645,0
25,429,219,78,157,11,5,46,230,3,24,20,34,27,54,114,256,2,545,30,0,2,0,1,90990,35943,7296,48646,0
25,429,108,64,79,9,0,20,117,5,15,11,19,20,30,70,129,3,410,22,0,2,0,1,90990,35943,7296,48647,0
282,5905,1943,715,1694,26,18,214,1969,12,185,120,237,197,357,1436,2721,7,20915,1161,0,2,17,3,90990,35945,7296,48648,0
282,5905,1168,838,957,57,25,144,1225,19,348,224,416,367,640,3018,5452,11,61921,3440,1,2,17,3,91000,35947,7296,48649,0
70,1371,1098,241,925,5,10,155,1103,7,46,25,49,53,74,273,423,3,1580,87,0,2,6,0,91010,35949,7296,48650,0
70,1371,282,202,222,14,2,44,296,8,42,24,43,50,67,250,378,4,1548,86,0,2,6,0,91010,35950,7296,48651,0
108,4688,1289,550,1043,56,32,155,1345,10,167,93,185,177,278,1266,2075,5,11498,638,0,2,77,6,91010,35952,7297,48652,0
31,956,182,127,129,0,0,53,182,5,39,21,42,44,63,217,343,2,926,51,0,2,3,7,91010,35952,7298,48653,0
148,7105,1392,870,1177,35,17,170,1427,14,494,280,531,508,811,4473,7289,7,54850,3047,2,2,181,200,91010,35955,7299,48654,0
16,386,127,75,83,2,11,30,129,4,14,7,14,18,21,61,87,2,175,9,0,2,60,0,91010,35955,7299,48655,0
16,386,652,304,544,16,6,88,668,6,89,51,101,95,152,591,998,3,3399,188,0,2,60,0,91010,35956,7299,48656,0
16,386,2,2,2,0,0,0,2,0,0,0,0,0,0,0,0,0,0,0,0,2,60,0,91010,35956,7299,48656,0
16,386,8,5,5,0,0,3,8,0,0,0,0,0,0,0,0,0,0,0,0,2,60,0,91010,35956,7299,48657,0
16,386,2,2,2,0,0,0,2,0,0,0,0,0,0,0,0,0,0,0,0,2,60,0,91010,35956,7299,48657,0
16,386,14,8,8,0,0,6,14,0,0,0,0,0,0,0,0,0,0,0,0,2,60,0,91010,35956,7299,48658,0
16,386,6,4,4,0,0,2,6,0,0,0,0,0,0,0,0,0,0,0,0,2,60,0,91010,35956,7299,48659,0
16,386,6,4,4,0,0,2,6,1,2,1,2,3,3,2,4,0,2,0,0,2,60,0,91010,35956,7299,48660,0
16,386,6,4,4,0,0,2,6,0,0,0,0,0,0,0,0,0,0,0,0,2,60,0,91010,35956,7299,48661,0
16,386,7,5,5,0,0,2,7,0,0,0,0,0,0,0,0,0,0,0,0,2,60,0,91010,35956,7299,48662,0
16,386,6,4,4,0,0,2,6,0,0,0,0,0,0,0,0,0,0,0,0,2,60,0,91010,35956,7299,48663,0
16,386,10,6,6,0,0,4,10,0,0,0,0,0,0,0,0,0,0,0,0,2,60,0,91010,35956,7299,48664,0
16,386,1,1,1,0,0,0,1,0,0,0,0,0,0,0,0,0,0,0,0,2,60,0,91010,35956,7299,48664,0
16,386,14,10,10,0,0,4,14,1,1,1,1,2,2,0,2,0,1,0,0,2,60,0,91010,35956,7299,48665,0
16,386,46,26,30,3,0,12,49,3,6,3,6,9,9,20,28,1,42,2,0,2,60,0,91020,35956,7299,48666,0
4,181,75,38,59,1,3,12,76,2,4,2,4,6,6,10,15,1,15,0,0,2,1,1,91020,35956,7299,48667,0
15,696,139,89,101,2,0,35,141,7,54,34,62,61,96,330,569,4,2287,127,0,2,1,1,91020,35956,7299,48668,0
42,2589,1157,318,931,29,22,177,1186,6,104,63,125,110,188,712,1274,3,4596,255,0,2,9,9,91020,35956,7299,48669,0
89,3928,1338,495,1086,10,64,173,1348,11,122,82,157,133,239,883,1686,7,11934,663,0,2,1,47,91020,35958,7299,48670,0
185,7999,4293,999,3693,19,54,507,4312,9,155,88,170,164,258,1156,1898,4,9368,520,0,2,253,15,91020,35960,7299,48671,0
185,7999,1482,859,1002,125,135,219,1607,16,219,134,251,235,385,1766,3032,9,27804,1544,1,2,253,15,91030,35961,7299,48672,0
33,992,465,148,393,5,8,60,470,4,31,20,31,35,51,161,261,2,523,29,0,2,33,14,91030,35962,7299,48673,0
33,992,16,12,9,0,0,6,16,1,2,1,2,3,3,2,4,0,2,0,0,2,33,14,91030,35962,7299,48674,0
30,919,256,139,192,9,7,47,265,4,23,12,24,27,36,112,171,2,357,19,0,2,8,8,91030,35963,7299,48675,0
6,322,180,34,164,0,0,16,180,1,12,6,12,13,18,43,66,0,33,1,0,2,2,2,91030,35963,7299,48676,0
124,5153,1450,624,1228,12,26,181,1462,14,306,186,354,320,540,2580,4493,8,36391,2021,1,2,88,19,91030,35965,7300,48677,0
183,5958,1660,832,1314,41,38,274,1701,20,312,209,395,332,604,2671,5058,12,64042,3557,1,2,55,3,91030,35967,7301,48679,0
49,3773,996,429,845,24,10,117,1020,7,76,50,88,83,138,494,879,4,3565,198,0,2,4,4,91030,35969,7301,48680,0
120,5064,1513,682,1277,25,13,200,1538,11,199,116,219,210,335,1557,2584,6,15641,868,0,2,7,7,91030,35971,7301,48681,0
85,4935,1296,573,1062,40,33,157,1336,8,201,118,231,209,349,1561,2689,4,12365,686,0,2,18,6,91030,35971,7301,48682,0
23,513,207,111,150,11,0,50,218,5,26,19,36,31,55,133,272,3,943,52,0,2,34,3,91030,35971,7301,48683,0
111,6057,1457,730,1242,11,6,188,1468,10,292,166,329,302,495,2424,4078,5,22973,1276,1,2,29,3,91030,35973,7301,48684,0
46,2848,652,304,544,16,6,88,668,6,89,51,101,95,152,591,998,3,3399,188,0,2,32,4,91030,35974,7301,48685,0
81,3714,1455,414,1257,16,76,112,1471,5,41,23,46,46,69,231,381,2,1069,59,0,2,4,4,91030,35975,7301,48686,0
113,5657,1523,757,1297,19,12,193,1542,12,193,117,230,205,347,1508,2664,7,19053,1058,0,2,228,127,91040,35977,7301,48687,0
69,3090,1020,354,843,12,15,144,1032,8,134,77,144,142,221,970,1580,4,6792,377,0,2,1,1,91040,35977,7301,48688,0
3,90,35,12,22,4,5,6,39,1,2,1,2,3,3,2,4,0,2,0,0,0,28,0,91040,35977,7301,48689,0
21,637,424,94,331,4,0,89,428,1,5,5,5,6,10,11,25,0,12,0,0,2,1,1,91040,35978,7301,48690,0
38,2315,334,251,279,10,4,40,344,5,127,74,143,132,217,899,1528,2,4303,239,0,2,6,1,91040,35979,7301,48691,0
18,697,184,100,137,2,15,30,186,6,38,20,39,44,59,214,322,3,991,55,0,2,69,2,91040,35980,7301,48692,0
77,4048,1293,570,1093,25,15,163,1318,10,195,123,241,205,364,1516,2795,6,17273,959,0,2,9,1,91050,35982,7301,48693,0
59,2994,722,423,573,19,0,135,741,12,172,101,199,184,300,1320,2257,6,15668,870,0,2,48,2,91050,35984,7301,48695,0
31,1843,466,257,367,18,25,50,484,7,126,86,171,133,257,898,1813,4,8612,478,0,2,72,2,91050,35984,7301,48696,0
88,3446,1043,504,840,53,9,147,1096,9,180,112,198,189,310,1377,2344,4,11604,644,0,2,51,19,91050,35986,7301,48697,0
12,463,295,56,236,0,4,54,295,2,9,5,10,11,15,30,51,1,57,3,0,2,1,1,91050,35988,7301,48698,0
12,572,294,64,250,0,0,43,294,1,20,10,20,21,30,86,131,0,65,3,0,3,29,4,91050,35988,7301,48699,0
1,43,110,30,77,3,13,16,113,4,21,15,30,25,45,100,208,2,597,33,0,3,3,3,91050,35988,7301,48700,0
79,3068,1178,367,1042,6,15,115,1184,9,94,51,95,103,146,644,976,4,4439,246,0,2,3,2,91050,35988,7301,48701,0
12,645,219,78,157,11,5,46,230,3,24,20,34,27,54,114,256,2,545,30,0,2,2,1,91050,35989,7301,48702,0
112,6100,1943,715,1694,26,18,214,1969,12,185,120,237,197,357,1436,2721,7,20915,1161,0,2,31,14,91050,35991,7301,48703,0
39,1770,442,244,305,14,16,103,456,11,68,45,75,79,120,452,756,6,4588,254,0,2,97,13,91050,35993,7301,48704,0
51,2040,1098,241,925,5,10,155,1103,7,46,25,49,53,74,273,423,3,1580,87,0,2,60,12,91060,35995,7301,48705,0
49,1706,601,196,481,2,23,85,603,8,63,36,72,71,108,400,664,4,3036,168,0,2,18,0,91060,35995,7301,48706,0
90,2024,996,429,845,24,10,117,1020,7,76,50,88,83,138,494,879,4,3565,198,0,2,6,2,91060,35997,7301,48707,0
90,2024,456,277,329,12,42,72,468,13,85,50,97,98,147,592,972,7,7212,400,0,2,6,2,91060,35997,7301,48708,0
49,3806,996,429,845,24,10,117,1020,7,76,50,88,83,138,494,879,4,3565,198,0,2,6,1,91060,35999,7301,48709,0
161,3433,1513,682,1277,25,13,200,1538,11,199,116,219,210,335,1557,2584,6,15641,868,0,2,0,7,91060,36001,7301,48710,0
161,3433,819,519,539,24,98,155,843,15,96,57,106,111,163,690,1107,8,9171,509,0,2,0,7,91070,36003,7301,48711,0
102,2603,1455,414,1257,16,76,112,1471,5,41,23,46,46,69,231,381,2,1069,59,0,2,4,0,91070,36004,7301,48712,0
102,2603,669,365,481,22,61,110,691,15,103,63,122,118,185,747,1273,8,11311,628,0,2,4,0,91080,36004,7302,48713,0
77,4048,1293,570,1093,25,15,163,1318,10,195,123,241,205,364,1516,2795,6,17273,959,0,2,23,1,91090,36006,7302,48714,0
20,378,294,64,250,0,0,43,294,1,20,10,20,21,30,86,131,0,65,3,0,2,1,2,91090,36006,7302,48715,0
20,378,78,46,62,3,0,14,81,3,8,4,8,11,12,28,41,1,62,3,0,2,1,2,91090,36007,7302,48716,0
23,615,601,196,481,2,23,85,603,8,63,36,72,71,108,400,664,4,3036,168,0,2,1,1,91090,36007,7302,48717,0
23,615,156,79,106,5,16,28,161,5,14,8,15,19,23,64,97,2,261,14,0,2,1,1,91090,36007,7302,48718,0
232,5898,722,423,573,19,0,135,741,12,172,101,199,184,300,1320,2257,6,15668,870,0,2,0,2,91090,36009,7302,48720,0
232,5898,1508,847,911,44,250,301,1552,14,148,88,169,162,257,1120,1886,7,15077,837,0,2,0,2,91090,36010,7303,48721,0
103,2613,1455,414,1257,16,76,112,1471,5,41,23,46,46,69,231,381,2,1069,59,0,2,6,0,91090,36011,7303,48722,0
103,2613,669,365,481,22,61,110,691,15,103,63,122,118,185,747,1273,8,11311,628,0,2,6,0,91100,36011,7304,48723,0
106,4670,1289,550,1043,56,32,155,1345,10,167,93,185,177,278,1266,2075,5,11498,638,0,2,15,10,91100,36013,7305,48724,0
288,6093,1943,715,1694,26,18,214,1969,12,185,120,237,197,357,1436,2721,7,20915,1161,0,2,60,23,91100,36015,7305,48725,0
288,6093,1168,838,957,57,25,144,1225,19,348,224,416,367,640,3018,5452,11,61921,3440,1,2,60,23,91110,36017,7305,48726,0
77,4048,1293,570,1093,25,15,163,1318,10,195,123,241,205,364,1516,2795,6,17273,959,0,2,5,5,91120,36019,7305,48727,0
112,6632,1943,715,1694,26,18,214,1969,12,185,120,237,197,357,1436,2721,7,20915,1161,0,2,106,25,91120,36021,7305,48728,0
77,4048,1293,570,1093,25,15,163,1318,10,195,123,241,205,364,1516,2795,6,17273,959,0,2,1,1,91130,36023,7305,48729,0
77,4048,1293,570,1093,25,15,163,1318,10,195,123,241,205,364,1516,2795,6,17273,959,0,2,1,1,91140,36025,7305,48730,0
239,5069,2,2,2,0,0,0,2,0,0,0,0,0,0,0,0,0,0,0,0,2,10,3,91140,36025,7305,48730,0
239,5069,99,48,90,1,3,5,100,0,0,0,0,0,0,0,0,0,0,0,0,2,10,3,91140,36026,7305,48731,0
239,5069,8,5,5,2,0,1,10,0,0,0,0,0,0,0,0,0,0,0,0,2,10,3,91140,36026,7305,48732,0
239,5069,1217,716,841,84,126,174,1301,14,185,118,215,199,333,1446,2542,8,20687,1149,0,2,10,3,91150,36028,7305,48733,0
239,5069,160,89,115,0,13,31,160,7,15,11,17,22,28,78,124,3,495,27,0,2,10,3,91150,36028,7305,48734,0
239,5069,10,10,9,9,0,0,19,0,0,0,0,0,0,0,0,0,0,0,0,2,10,3,91150,36028,7306,48735,0
239,5069,173,84,99,8,29,36,181,5,12,7,13,17,20,54,81,2,221,12,0,2,10,3,91150,36029,7306,48736,0
239,5069,3,1,1,3,0,0,6,0,0,0,0,0,0,0,0,0,0,0,0,2,10,3,91150,36029,7306,48737,0
232,5896,722,423,573,19,0,135,741,12,172,101,199,184,300,1320,2257,6,15668,870,0,2,3,1,91150,36031,7306,48739,0
232,5896,1508,847,911,44,250,301,1552,14,148,88,169,162,257,1120,1886,7,15077,837,0,2,3,1,91150,36032,7307,48740,0
111,6056,1457,730,1242,11,6,188,1468,10,292,166,329,302,495,2424,4078,5,22973,1276,1,2,1,1,91150,36034,7307,48741,0
88,3442,1043,504,840,53,9,147,1096,9,180,112,198,189,310,1377,2344,4,11604,644,0,2,2,3,91150,36036,7307,48742,0
239,5069,2,2,2,0,0,0,2,0,0,0,0,0,0,0,0,0,0,0,0,2,10,3,91150,36036,7307,48742,0
239,5069,99,48,90,1,3,5,100,0,0,0,0,0,0,0,0,0,0,0,0,2,10,3,91150,36037,7307,48743,0
239,5069,8,5,5,2,0,1,10,0,0,0,0,0,0,0,0,0,0,0,0,2,10,3,91150,36037,7307,48744,0
239,5069,1217,716,841,84,126,174,1301,14,185,118,215,199,333,1446,2542,8,20687,1149,0,2,10,3,91160,36039,7307,48745,0
239,5069,160,89,115,0,13,31,160,7,15,11,17,22,28,78,124,3,495,27,0,2,10,3,91160,36039,7307,48746,0
239,5069,10,10,9,9,0,0,19,0,0,0,0,0,0,0,0,0,0,0,0,2,10,3,91160,36039,7308,48747,0
239,5069,173,84,99,8,29,36,181,5,12,7,13,17,20,54,81,2,221,12,0,2,10,3,91160,36040,7308,48748,0
239,5069,3,1,1,3,0,0,6,0,0,0,0,0,0,0,0,0,0,0,0,2,10,3,91160,36040,7308,48749,0
20,983,386,256,301,16,9,68,402,4,59,35,69,63,104,355,621,2,1453,80,0,2,2,5,91160,36040,7308,48750,0
20,983,264,131,164,11,41,46,275,6,38,22,40,44,62,214,338,3,1068,59,0,2,2,5,91170,36040,7309,48751,0
102,2626,1455,414,1257,16,76,112,1471,5,41,23,46,46,69,231,381,2,1069,59,0,2,6,3,91170,36041,7309,48752,0
102,2626,669,365,481,22,61,110,691,15,103,63,122,118,185,747,1273,8,11311,628,0,2,6,3,91180,36041,7310,48753,0
103,2613,1455,414,1257,16,76,112,1471,5,41,23,46,46,69,231,381,2,1069,59,0,2,6,0,91180,36042,7310,48754,0
103,2613,669,365,481,22,61,110,691,15,103,63,122,118,185,747,1273,8,11311,628,0,2,6,0,91190,36042,7311,48755,0
106,4670,1289,550,1043,56,32,155,1345,10,167,93,185,177,278,1266,2075,5,11498,638,0,2,15,10,91190,36044,7312,48756,0
103,2636,1455,414,1257,16,76,112,1471,5,41,23,46,46,69,231,381,2,1069,59,0,2,6,3,91190,36045,7312,48757,0
103,2636,669,365,481,22,61,110,691,15,103,63,122,118,185,747,1273,8,11311,628,0,2,6,3,91200,36045,7313,48758,0
20,983,386,256,301,16,9,68,402,4,59,35,69,63,104,355,621,2,1453,80,0,2,2,5,91200,36045,7313,48759,0
20,983,264,131,164,11,41,46,275,6,38,22,40,44,62,214,338,3,1068,59,0,2,2,5,91210,36045,7314,48760,0
103,2720,1455,414,1257,16,76,112,1471,5,41,23,46,46,69,231,381,2,1069,59,0,2,61,34,91210,36046,7314,48761,1
103,2720,669,365,481,22,61,110,691,15,103,63,122,118,185,747,1273,8,11311,628,0,2,61,34,91220,36046,7315,48762,1
81,3715,1455,414,1257,16,76,112,1471,5,41,23,46,46,69,231,381,2,1069,59,0,2,4,3,91220,36047,7315,48763,1
105,2793,773,422,505,30,103,129,803,14,77,46,83,91,129,535,839,7,6334,351,0,2,16,11,91230,36048,7316,48764,0
23,625,601,196,481,2,23,85,603,8,63,36,72,71,108,400,664,4,3036,168,0,2,4,0,91230,36048,7316,48765,0
23,625,156,79,106,5,16,28,161,5,14,8,15,19,23,64,97,2,261,14,0,2,4,0,91230,36048,7316,48766,0
85,2046,996,429,845,24,10,117,1020,7,76,50,88,83,138,494,879,4,3565,198,0,2,9,3,91230,36050,7316,48767,0
85,2046,456,277,329,12,42,72,468,13,85,50,97,98,147,592,972,7,7212,400,0,2,9,3,91230,36050,7316,48768,0
288,6168,1943,715,1694,26,18,214,1969,12,185,120,237,197,357,1436,2721,7,20915,1161,0,2,26,16,91230,36052,7316,48769,0
288,6168,1168,838,957,57,25,144,1225,19,348,224,416,367,640,3018,5452,11,61921,3440,1,2,26,16,91240,36054,7316,48770,0
161,3438,1513,682,1277,25,13,200,1538,11,199,116,219,210,335,1557,2584,6,15641,868,0,2,5,5,91240,36056,7316,48771,0
161,3438,819,519,539,24,98,155,843,15,96,57,106,111,163,690,1107,8,9171,509,0,2,5,5,91250,36058,7316,48772,0
120,5074,1513,682,1277,25,13,200,1538,11,199,116,219,210,335,1557,2584,6,15641,868,0,2,4,2,91250,36060,7316,48773,0
65,1379,91,45,69,0,3,18,91,3,9,6,10,12,16,33,57,1,95,5,0,2,22,7,91250,36062,7316,48774,0
65,1379,367,234,237,17,34,68,384,16,55,34,61,71,95,381,584,8,5183,287,0,2,22,7,91250,36063,7316,48775,0
39,1798,442,244,305,14,16,103,456,11,68,45,75,79,120,452,756,6,4588,254,0,2,4,0,91250,36065,7316,48776,0
184,5417,1660,832,1314,41,38,274,1701,20,312,209,395,332,604,2671,5058,12,64042,3557,1,2,3,3,91250,36067,7317,48778,0
184,5417,1057,646,719,113,100,145,1170,18,215,134,248,233,382,1740,3004,10,31186,1732,1,2,3,3,91260,36068,7318,48779,0
103,2720,1455,414,1257,16,76,112,1471,5,41,23,46,46,69,231,381,2,1069,59,0,2,1,3,91260,36069,7318,48780,0
103,2720,669,365,481,22,61,110,691,15,103,63,122,118,185,747,1273,8,11311,628,0,2,1,3,91270,36069,7319,48781,0
73,1701,53,23,39,0,0,13,53,2,8,4,8,10,12,26,39,1,39,2,0,2,1,2,91270,36069,7319,48782,0
73,1701,515,298,307,33,80,99,548,12,63,44,77,75,121,419,753,7,5527,307,0,2,1,2,91280,36069,7319,48783,0
233,5923,722,423,573,19,0,135,741,12,172,101,199,184,300,1320,2257,6,15668,870,0,2,5,2,91280,36071,7319,48785,1
233,5923,1508,847,911,44,250,301,1552,14,148,88,169,162,257,1120,1886,7,15077,837,0,2,5,2,91280,36072,7320,48786,1
59,3032,722,423,573,19,0,135,741,12,172,101,199,184,300,1320,2257,6,15668,870,0,2,19,11,91280,36074,7320,48788,1
233,5913,722,423,573,19,0,135,741,12,172,101,199,184,300,1320,2257,6,15668,870,0,2,5,2,91280,36076,7320,48790,0
233,5913,1508,847,911,44,250,301,1552,14,148,88,169,162,257,1120,1886,7,15077,837,0,2,5,2,91280,36077,7321,48791,0
59,3032,722,423,573,19,0,135,741,12,172,101,199,184,300,1320,2257,6,15668,870,0,2,19,11,91280,36079,7321,48793,0
233,5911,722,423,573,19,0,135,741,12,172,101,199,184,300,1320,2257,6,15668,870,0,2,3,1,91280,36081,7321,48795,0
233,5911,1508,847,911,44,250,301,1552,14,148,88,169,162,257,1120,1886,7,15077,837,0,2,3,1,91280,36082,7322,48796,0
111,6056,1457,730,1242,11,6,188,1468,10,292,166,329,302,495,2424,4078,5,22973,1276,1,2,1,1,91280,36084,7322,48797,0
88,3442,1043,504,840,53,9,147,1096,9,180,112,198,189,310,1377,2344,4,11604,644,0,2,2,3,91280,36086,7322,48798,0
184,5417,1660,832,1314,41,38,274,1701,20,312,209,395,332,604,2671,5058,12,64042,3557,1,2,3,3,91280,36088,7323,48800,0
184,5417,1057,646,719,113,100,145,1170,18,215,134,248,233,382,1740,3004,10,31186,1732,1,2,3,3,91290,36089,7324,48801,0
85,2046,996,429,845,24,10,117,1020,7,76,50,88,83,138,494,879,4,3565,198,0,2,9,3,91290,36091,7324,48802,0
85,2046,456,277,329,12,42,72,468,13,85,50,97,98,147,592,972,7,7212,400,0,2,9,3,91290,36091,7324,48803,0
161,3438,1513,682,1277,25,13,200,1538,11,199,116,219,210,335,1557,2584,6,15641,868,0,2,5,5,91290,36093,7324,48804,0
161,3438,819,519,539,24,98,155,843,15,96,57,106,111,163,690,1107,8,9171,509,0,2,5,5,91300,36095,7324,48805,0
103,2720,1455,414,1257,16,76,112,1471,5,41,23,46,46,69,231,381,2,1069,59,0,2,58,33,91300,36096,7324,48806,0
103,2720,669,365,481,22,61,110,691,15,103,63,122,118,185,747,1273,8,11311,628,0,2,58,33,91310,36096,7325,48807,0
105,2793,773,422,505,30,103,129,803,14,77,46,83,91,129,535,839,7,6334,351,0,2,16,11,91320,36097,7326,48808,0
73,1701,53,23,39,0,0,13,53,2,8,4,8,10,12,26,39,1,39,2,0,2,1,2,91320,36097,7326,48809,0
73,1701,515,298,307,33,80,99,548,12,63,44,77,75,121,419,753,7,5527,307,0,2,1,2,91330,36097,7326,48810,0
288,6168,1943,715,1694,26,18,214,1969,12,185,120,237,197,357,1436,2721,7,20915,1161,0,2,26,16,91330,36099,7326,48811,0
288,6168,1168,838,957,57,25,144,1225,19,348,224,416,367,640,3018,5452,11,61921,3440,1,2,26,16,91340,36101,7326,48812,0
23,625,601,196,481,2,23,85,603,8,63,36,72,71,108,400,664,4,3036,168,0,2,4,0,91340,36101,7326,48813,0
23,625,156,79,106,5,16,28,161,5,14,8,15,19,23,64,97,2,261,14,0,2,4,0,91340,36101,7326,48814,0
120,5074,1513,682,1277,25,13,200,1538,11,199,116,219,210,335,1557,2584,6,15641,868,0,2,4,2,91340,36103,7326,48815,0
81,3715,1455,414,1257,16,76,112,1471,5,41,23,46,46,69,231,381,2,1069,59,0,2,4,3,91340,36104,7326,48816,0
161,3438,1513,682,1277,25,13,200,1538,11,199,116,219,210,335,1557,2584,6,15641,868,0,2,3,1,91340,36106,7326,48817,0
161,3438,819,519,539,24,98,155,843,15,96,57,106,111,163,690,1107,8,9171,509,0,2,3,1,91350,36108,7326,48818,0
65,1379,91,45,69,0,3,18,91,3,9,6,10,12,16,33,57,1,95,5,0,2,22,7,91350,36110,7326,48819,0
65,1379,367,234,237,17,34,68,384,16,55,34,61,71,95,381,584,8,5183,287,0,2,22,7,91350,36111,7326,48820,0
39,1798,442,244,305,14,16,103,456,11,68,45,75,79,120,452,756,6,4588,254,0,2,4,0,91350,36113,7326,48821,0
124,2350,477,336,357,30,23,73,507,16,194,134,250,210,384,1538,2962,10,30538,1696,0,2,13,4,91360,36114,7326,48822,0
185,6013,1660,832,1314,41,38,274,1701,20,312,209,395,332,604,2671,5058,12,64042,3557,1,2,15,6,91360,36116,7327,48824,0
3,96,35,12,22,4,5,6,39,1,2,1,2,3,3,2,4,0,2,0,0,2,1,0,91360,36116,7327,48825,0
232,5986,722,423,573,19,0,135,741,12,172,101,199,184,300,1320,2257,6,15668,870,0,2,16,9,91360,36118,7327,48827,1
232,5986,1508,847,911,44,250,301,1552,14,148,88,169,162,257,1120,1886,7,15077,837,0,2,16,9,91360,36119,7328,48828,1
60,3137,722,423,573,19,0,135,741,12,172,101,199,184,300,1320,2257,6,15668,870,0,2,44,15,91360,36121,7328,48830,1
233,5989,722,423,573,19,0,135,741,12,172,101,199,184,300,1320,2257,6,15668,870,0,2,16,9,91360,36123,7328,48832,0
233,5989,1508,847,911,44,250,301,1552,14,148,88,169,162,257,1120,1886,7,15077,837,0,2,16,9,91360,36124,7329,48833,0
60,3175,722,423,573,19,0,135,741,12,172,101,199,184,300,1320,2257,6,15668,870,0,2,44,15,91360,36126,7329,48835,0
85,2057,996,429,845,24,10,117,1020,7,76,50,88,83,138,494,879,4,3565,198,0,2,6,2,91360,36128,7329,48836,0
85,2057,456,277,329,12,42,72,468,13,85,50,97,98,147,592,972,7,7212,400,0,2,6,2,91360,36128,7329,48837,0
65,1379,91,45,69,0,3,18,91,3,9,6,10,12,16,33,57,1,95,5,0,2,22,7,91360,36130,7329,48838,0
65,1379,367,234,237,17,34,68,384,16,55,34,61,71,95,381,584,8,5183,287,0,2,22,7,91360,36131,7329,48839,0
49,3797,996,429,845,24,10,117,1020,7,76,50,88,83,138,494,879,4,3565,198,0,2,6,1,91360,36133,7329,48840,0
39,1798,442,244,305,14,16,103,456,11,68,45,75,79,120,452,756,6,4588,254,0,2,4,0,91360,36135,7329,48841,0
80,1970,757,253,292,73,244,162,830,13,61,38,67,74,105,409,651,7,4654,258,0,2,5,7,91360,36136,7329,48842,0
66,4451,520,294,400,33,13,81,553,10,261,204,367,271,571,2128,4614,7,32445,1802,1,2,15,1,91360,36137,7329,48843,0
65,4328,520,294,400,33,13,81,553,10,261,204,367,271,571,2128,4614,7,32445,1802,1,2,16,35,91360,36138,7329,48844,0
290,6183,1943,715,1694,26,18,214,1969,12,185,120,237,197,357,1436,2721,7,20915,1161,0,2,7,1,91360,36140,7329,48845,0
290,6183,1168,838,957,57,25,144,1225,19,348,224,416,367,640,3018,5452,11,61921,3440,1,2,7,1,91370,36142,7329,48846,0
113,6684,1943,715,1694,26,18,214,1969,12,185,120,237,197,357,1436,2721,7,20915,1161,0,2,17,0,91370,36144,7329,48847,0
117,2936,773,422,505,30,103,129,803,14,77,46,83,91,129,535,839,7,6334,351,0,2,87,12,91380,36145,7330,48848,0
3,501,149,67,118,4,0,27,153,1,17,14,28,18,42,69,175,0,144,8,0,2,66,2,91380,36145,7330,48849,0
80,1970,757,253,292,73,244,162,830,13,61,38,67,74,105,409,651,7,4654,258,0,2,1,1,91380,36146,7330,48850,0
85,2057,996,429,845,24,10,117,1020,7,76,50,88,83,138,494,879,4,3565,198,0,2,6,2,91380,36148,7330,48851,0
85,2057,456,277,329,12,42,72,468,13,85,50,97,98,147,592,972,7,7212,400,0,2,6,2,91380,36148,7330,48852,0
65,1379,91,45,69,0,3,18,91,3,9,6,10,12,16,33,57,1,95,5,0,2,22,7,91380,36150,7330,48853,0
65,1379,367,234,237,17,34,68,384,16,55,34,61,71,95,381,584,8,5183,287,0,2,22,7,91380,36151,7330,48854,0
49,3797,996,429,845,24,10,117,1020,7,76,50,88,83,138,494,879,4,3565,198,0,2,6,1,91380,36153,7330,48855,0
39,1798,442,244,305,14,16,103,456,11,68,45,75,79,120,452,756,6,4588,254,0,2,4,0,91380,36155,7330,48856,0
80,1970,757,253,292,73,244,162,830,13,61,38,67,74,105,409,651,7,4654,258,0,2,6,8,91380,36156,7330,48857,0
65,4328,520,294,400,33,13,81,553,10,261,204,367,271,571,2128,4614,7,32445,1802,1,2,31,36,91380,36157,7330,48858,0
187,5471,1660,832,1314,41,38,274,1701,20,312,209,395,332,604,2671,5058,12,64042,3557,1,2,31,15,91380,36159,7331,48860,1
187,5471,1057,646,719,113,100,145,1170,18,215,134,248,233,382,1740,3004,10,31186,1732,1,2,31,15,91390,36160,7332,48861,1
189,6306,1660,832,1314,41,38,274,1701,20,312,209,395,332,604,2671,5058,12,64042,3557,1,2,60,1,91390,36162,7333,48863,1
89,3931,1338,495,1086,10,64,173,1348,11,122,82,157,133,239,883,1686,7,11934,663,0,2,1,1,91390,36164,7333,48865,0
31,1843,466,257,367,18,25,50,484,7,126,86,171,133,257,898,1813,4,8612,478,0,2,5,5,91390,36164,7333,48866,0
216,4974,182,127,129,0,0,53,182,5,39,21,42,44,63,217,343,2,926,51,0,2,2,1,91390,36164,7334,48867,0
216,4974,1165,710,800,67,119,181,1232,18,243,153,282,261,435,2000,3492,10,36473,2026,1,2,2,1,91400,36164,7335,48868,0
105,2748,773,422,505,30,103,129,803,14,77,46,83,91,129,535,839,7,6334,351,0,2,3,4,91410,36165,7336,48869,0
225,5745,722,423,573,19,0,135,741,12,172,101,199,184,300,1320,2257,6,15668,870,0,2,2,1,91410,36167,7336,48871,0
225,5745,1508,847,911,44,250,301,1552,14,148,88,169,162,257,1120,1886,7,15077,837,0,2,2,1,91410,36168,7337,48872,0
79,1942,466,257,367,18,25,50,484,7,126,86,171,133,257,898,1813,4,8612,478,0,2,2,1,91410,36168,7337,48873,0
79,1942,507,281,342,29,59,88,536,10,53,29,57,63,86,336,514,5,2764,153,0,2,2,1,91410,36168,7337,48874,0
120,5083,1513,682,1277,25,13,200,1538,11,199,116,219,210,335,1557,2584,6,15641,868,0,2,4,5,91410,36170,7337,48875,0
15,1033,215,129,180,6,0,29,221,8,65,43,72,73,115,415,711,4,3153,175,0,2,6,7,91410,36170,7337,48876,0
112,6136,1943,715,1694,26,18,214,1969,12,185,120,237,197,357,1436,2721,7,20915,1161,0,2,2,1,91410,36172,7337,48877,0
186,5480,1660,832,1314,41,38,274,1701,20,312,209,395,332,604,2671,5058,12,64042,3557,1,2,16,18,91410,36174,7338,48879,0
186,5480,1057,646,719,113,100,145,1170,18,215,134,248,233,382,1740,3004,10,31186,1732,1,2,16,18,91420,36175,7339,48880,0
59,1223,207,111,150,11,0,50,218,5,26,19,36,31,55,133,272,3,943,52,0,2,14,0,91420,36175,7339,48881,0
59,1223,410,198,237,31,55,97,441,11,63,38,72,74,110,414,683,6,4293,238,0,2,14,0,91430,36176,7340,48882,0
189,6308,1660,832,1314,41,38,274,1701,20,312,209,395,332,604,2671,5058,12,64042,3557,1,2,15,15,91430,36178,7341,48884,0
186,5480,1660,832,1314,41,38,274,1701,20,312,209,395,332,604,2671,5058,12,64042,3557,1,2,39,25,91430,36180,7342,48886,0
186,5480,1057,646,719,113,100,145,1170,18,215,134,248,233,382,1740,3004,10,31186,1732,1,2,39,25,91440,36181,7343,48887,0
59,1223,207,111,150,11,0,50,218,5,26,19,36,31,55,133,272,3,943,52,0,2,14,0,91440,36181,7343,48888,0
59,1223,410,198,237,31,55,97,441,11,63,38,72,74,110,414,683,6,4293,238,0,2,14,0,91450,36182,7344,48889,0
189,6308,1660,832,1314,41,38,274,1701,20,312,209,395,332,604,2671,5058,12,64042,3557,1,2,74,15,91450,36184,7345,48891,0
216,4974,182,127,129,0,0,53,182,5,39,21,42,44,63,217,343,2,926,51,0,2,2,1,91450,36184,7346,48892,0
216,4974,1165,710,800,67,119,181,1232,18,243,153,282,261,435,2000,3492,10,36473,2026,1,2,2,1,91460,36184,7347,48893,0
105,2748,773,422,505,30,103,129,803,14,77,46,83,91,129,535,839,7,6334,351,0,2,3,4,91470,36185,7348,48894,0
225,5745,722,423,573,19,0,135,741,12,172,101,199,184,300,1320,2257,6,15668,870,0,2,2,1,91470,36187,7348,48896,0
225,5745,1508,847,911,44,250,301,1552,14,148,88,169,162,257,1120,1886,7,15077,837,0,2,2,1,91470,36188,7349,48897,0
79,1942,466,257,367,18,25,50,484,7,126,86,171,133,257,898,1813,4,8612,478,0,2,2,1,91470,36188,7349,48898,0
79,1942,507,281,342,29,59,88,536,10,53,29,57,63,86,336,514,5,2764,153,0,2,2,1,91470,36188,7349,48899,0
120,5083,1513,682,1277,25,13,200,1538,11,199,116,219,210,335,1557,2584,6,15641,868,0,2,4,5,91470,36190,7349,48900,0
15,1033,215,129,180,6,0,29,221,8,65,43,72,73,115,415,711,4,3153,175,0,2,6,7,91470,36190,7349,48901,0
112,6136,1943,715,1694,26,18,214,1969,12,185,120,237,197,357,1436,2721,7,20915,1161,0,2,2,1,91470,36192,7349,48902,0
89,3931,1338,495,1086,10,64,173,1348,11,122,82,157,133,239,883,1686,7,11934,663,0,2,1,1,91470,36194,7349,48904,0
31,1843,466,257,367,18,25,50,484,7,126,86,171,133,257,898,1813,4,8612,478,0,2,5,5,91470,36194,7349,48905,0
60,1550,91,45,69,0,3,18,91,3,9,6,10,12,16,33,57,1,95,5,0,2,38,23,91470,36196,7349,48906,0
60,1550,367,234,237,17,34,68,384,16,55,34,61,71,95,381,584,8,5183,287,0,2,38,23,91470,36197,7349,48907,0
18,704,442,244,305,14,16,103,456,11,68,45,75,79,120,452,756,6,4588,254,0,2,20,15,91470,36199,7349,48908,0
18,704,182,102,99,11,40,35,193,3,11,6,11,14,17,42,64,1,97,5,0,2,20,15,91470,36200,7349,48909,0
232,5973,722,423,573,19,0,135,741,12,172,101,199,184,300,1320,2257,6,15668,870,0,2,0,2,91470,36202,7349,48911,0
232,5973,1508,847,911,44,250,301,1552,14,148,88,169,162,257,1120,1886,7,15077,837,0,2,0,2,91470,36203,7350,48912,0
216,4989,182,127,129,0,0,53,182,5,39,21,42,44,63,217,343,2,926,51,0,2,2,1,91470,36203,7351,48913,0
216,4989,1165,710,800,67,119,181,1232,18,243,153,282,261,435,2000,3492,10,36473,2026,1,2,2,1,91480,36203,7352,48914,0
105,2787,773,422,505,30,103,129,803,14,77,46,83,91,129,535,839,7,6334,351,0,2,3,4,91490,36204,7353,48915,0
233,5989,722,423,573,19,0,135,741,12,172,101,199,184,300,1320,2257,6,15668,870,0,2,2,1,91490,36206,7353,48917,0
233,5989,1508,847,911,44,250,301,1552,14,148,88,169,162,257,1120,1886,7,15077,837,0,2,2,1,91490,36207,7354,48918,0
79,1942,466,257,367,18,25,50,484,7,126,86,171,133,257,898,1813,4,8612,478,0,2,2,1,91490,36207,7354,48919,0
79,1942,507,281,342,29,59,88,536,10,53,29,57,63,86,336,514,5,2764,153,0,2,2,1,91490,36207,7354,48920,0
89,3928,1338,495,1086,10,64,173,1348,11,122,82,157,133,239,883,1686,7,11934,663,0,2,1,1,91490,36209,7354,48922,0
120,5072,1513,682,1277,25,13,200,1538,11,199,116,219,210,335,1557,2584,6,15641,868,0,2,4,5,91490,36211,7354,48923,0
31,1843,466,257,367,18,25,50,484,7,126,86,171,133,257,898,1813,4,8612,478,0,2,5,5,91490,36211,7354,48924,0
15,1033,215,129,180,6,0,29,221,8,65,43,72,73,115,415,711,4,3153,175,0,2,6,7,91490,36211,7354,48925,0
112,6632,1943,715,1694,26,18,214,1969,12,185,120,237,197,357,1436,2721,7,20915,1161,0,2,2,1,91490,36213,7354,48926,0
216,4989,182,127,129,0,0,53,182,5,39,21,42,44,63,217,343,2,926,51,0,2,2,1,91490,36213,7355,48927,0
216,4989,1165,710,800,67,119,181,1232,18,243,153,282,261,435,2000,3492,10,36473,2026,1,2,2,1,91500,36213,7356,48928,0
105,2787,773,422,505,30,103,129,803,14,77,46,83,91,129,535,839,7,6334,351,0,2,3,4,91510,36214,7357,48929,0
233,5989,722,423,573,19,0,135,741,12,172,101,199,184,300,1320,2257,6,15668,870,0,2,2,1,91510,36216,7357,48931,0
233,5989,1508,847,911,44,250,301,1552,14,148,88,169,162,257,1120,1886,7,15077,837,0,2,2,1,91510,36217,7358,48932,0
79,1942,466,257,367,18,25,50,484,7,126,86,171,133,257,898,1813,4,8612,478,0,2,2,1,91510,36217,7358,48933,0
79,1942,507,281,342,29,59,88,536,10,53,29,57,63,86,336,514,5,2764,153,0,2,2,1,91510,36217,7358,48934,0
89,3928,1338,495,1086,10,64,173,1348,11,122,82,157,133,239,883,1686,7,11934,663,0,2,1,1,91510,36219,7358,48936,0
120,5072,1513,682,1277,25,13,200,1538,11,199,116,219,210,335,1557,2584,6,15641,868,0,2,4,5,91510,36221,7358,48937,0
31,1843,466,257,367,18,25,50,484,7,126,86,171,133,257,898,1813,4,8612,478,0,2,5,5,91510,36221,7358,48938,0
15,1033,215,129,180,6,0,29,221,8,65,43,72,73,115,415,711,4,3153,175,0,2,6,7,91510,36221,7358,48939,0
112,6632,1943,715,1694,26,18,214,1969,12,185,120,237,197,357,1436,2721,7,20915,1161,0,2,2,1,91510,36223,7358,48940,0
120,5076,1513,682,1277,25,13,200,1538,11,199,116,219,210,335,1557,2584,6,15641,868,0,2,1,5,91510,36225,7358,48941,0
24,608,2,2,2,0,0,0,2,0,0,0,0,0,0,0,0,0,0,0,0,2,2,4,91510,36225,7358,48941,0
24,608,99,48,90,1,3,5,100,0,0,0,0,0,0,0,0,0,0,0,0,2,2,4,91510,36226,7358,48942,0
24,608,8,5,5,2,0,1,10,0,0,0,0,0,0,0,0,0,0,0,0,2,2,4,91510,36226,7358,48943,0
24,608,1217,716,841,84,126,174,1301,14,185,118,215,199,333,1446,2542,8,20687,1149,0,2,2,4,91520,36228,7358,48944,0
24,608,160,89,115,0,13,31,160,7,15,11,17,22,28,78,124,3,495,27,0,2,2,4,91520,36228,7358,48945,0
24,608,10,10,9,9,0,0,19,0,0,0,0,0,0,0,0,0,0,0,0,2,2,4,91520,36228,7359,48946,0
24,608,173,84,99,8,29,36,181,5,12,7,13,17,20,54,81,2,221,12,0,2,2,4,91520,36229,7359,48947,0
24,608,3,1,1,3,0,0,6,0,0,0,0,0,0,0,0,0,0,0,0,2,2,4,91520,36229,7359,48948,0
24,608,2,2,2,0,0,0,2,0,0,0,0,0,0,0,0,0,0,0,0,2,2,4,91520,36229,7359,48948,0
24,608,99,48,90,1,3,5,100,0,0,0,0,0,0,0,0,0,0,0,0,2,2,4,91520,36230,7359,48949,0
24,608,8,5,5,2,0,1,10,0,0,0,0,0,0,0,0,0,0,0,0,2,2,4,91520,36230,7359,48950,0
24,608,1217,716,841,84,126,174,1301,14,185,118,215,199,333,1446,2542,8,20687,1149,0,2,2,4,91530,36232,7359,48951,0
24,608,160,89,115,0,13,31,160,7,15,11,17,22,28,78,124,3,495,27,0,2,2,4,91530,36232,7359,48952,0
24,608,10,10,9,9,0,0,19,0,0,0,0,0,0,0,0,0,0,0,0,2,2,4,91530,36232,7360,48953,0
24,608,173,84,99,8,29,36,181,5,12,7,13,17,20,54,81,2,221,12,0,2,2,4,91530,36233,7360,48954,0
24,608,3,1,1,3,0,0,6,0,0,0,0,0,0,0,0,0,0,0,0,2,2,4,91530,36233,7360,48955,0
235,6063,722,423,573,19,0,135,741,12,172,101,199,184,300,1320,2257,6,15668,870,0,2,31,21,91530,36235,7360,48957,0
235,6063,1508,847,911,44,250,301,1552,14,148,88,169,162,257,1120,1886,7,15077,837,0,2,31,21,91530,36236,7361,48958,0
62,3231,722,423,573,19,0,135,741,12,172,101,199,184,300,1320,2257,6,15668,870,0,2,21,0,91530,36238,7361,48960,0
143,3484,77,34,69,0,0,8,77,3,24,16,29,27,45,114,213,1,387,21,0,2,4,1,91530,36238,7361,48961,0
143,3484,712,438,573,51,9,84,763,14,102,71,128,116,199,733,1364,8,11988,666,0,2,4,1,91540,36239,7361,48962,0
292,6223,1943,715,1694,26,18,214,1969,12,185,120,237,197,357,1436,2721,7,20915,1161,0,2,15,2,91540,36241,7361,48963,0
292,6223,1168,838,957,57,25,144,1225,19,348,224,416,367,640,3018,5452,11,61921,3440,1,2,15,2,91550,36243,7361,48964,0
106,4670,1289,550,1043,56,32,155,1345,10,167,93,185,177,278,1266,2075,5,11498,638,0,2,2,2,91550,36245,7362,48965,0
89,3928,1338,495,1086,10,64,173,1348,11,122,82,157,133,239,883,1686,7,11934,663,0,2,1,1,91550,36247,7362,48966,0
185,7999,4293,999,3693,19,54,507,4312,9,155,88,170,164,258,1156,1898,4,9368,520,0,2,1,1,91550,36249,7362,48967,0
185,7999,1482,859,1002,125,135,219,1607,16,219,134,251,235,385,1766,3032,9,27804,1544,1,2,1,1,91560,36250,7362,48968,0
189,6308,1660,832,1314,41,38,274,1701,20,312,209,395,332,604,2671,5058,12,64042,3557,1,2,1,1,91560,36252,7363,48970,0
120,5072,1513,682,1277,25,13,200,1538,11,199,116,219,210,335,1557,2584,6,15641,868,0,2,1,1,91560,36254,7363,48971,0
85,4935,1296,573,1062,40,33,157,1336,8,201,118,231,209,349,1561,2689,4,12365,686,0,2,3,3,91560,36254,7363,48972,0
81,3715,1455,414,1257,16,76,112,1471,5,41,23,46,46,69,231,381,2,1069,59,0,2,1,1,91560,36255,7363,48973,0
69,3090,1020,354,843,12,15,144,1032,8,134,77,144,142,221,970,1580,4,6792,377,0,2,1,1,91560,36255,7363,48974,0
12,463,295,56,236,0,4,54,295,2,9,5,10,11,15,30,51,1,57,3,0,2,1,1,91560,36257,7363,48975,0
79,3068,1178,367,1042,6,15,115,1184,9,94,51,95,103,146,644,976,4,4439,246,0,2,1,1,91560,36257,7363,48976,0
12,645,219,78,157,11,5,46,230,3,24,20,34,27,54,114,256,2,545,30,0,2,1,1,91560,36258,7363,48977,0
112,6661,1943,715,1694,26,18,214,1969,12,185,120,237,197,357,1436,2721,7,20915,1161,0,2,4,7,91560,36260,7363,48978,0
49,1706,601,196,481,2,23,85,603,8,63,36,72,71,108,400,664,4,3036,168,0,2,6,6,91560,36260,7363,48979,0
119,4999,1513,682,1277,25,13,200,1538,11,199,116,219,210,335,1557,2584,6,15641,868,0,2,1,14,91560,36262,7363,48980,0
232,5973,722,423,573,19,0,135,741,12,172,101,199,184,300,1320,2257,6,15668,870,0,2,0,2,91560,36264,7363,48982,0
232,5973,1508,847,911,44,250,301,1552,14,148,88,169,162,257,1120,1886,7,15077,837,0,2,0,2,91560,36265,7364,48983,0
234,6047,722,423,573,19,0,135,741,12,172,101,199,184,300,1320,2257,6,15668,870,0,2,31,21,91560,36267,7364,48985,0
234,6047,1508,847,911,44,250,301,1552,14,148,88,169,162,257,1120,1886,7,15077,837,0,2,31,21,91560,36268,7365,48986,0
62,3231,722,423,573,19,0,135,741,12,172,101,199,184,300,1320,2257,6,15668,870,0,2,21,0,91560,36270,7365,48988,0
69,4366,520,294,400,33,13,81,553,10,261,204,367,271,571,2128,4614,7,32445,1802,1,2,27,12,91560,36271,7365,48989,0
69,4372,520,294,400,33,13,81,553,10,261,204,367,271,571,2128,4614,7,32445,1802,1,2,5,2,91560,36272,7365,48990,0
17,400,127,75,83,2,11,30,129,4,14,7,14,18,21,61,87,2,175,9,0,2,4,1,91560,36272,7365,48991,0
17,400,652,304,544,16,6,88,668,6,89,51,101,95,152,591,998,3,3399,188,0,2,4,1,91560,36273,7365,48992,0
17,400,2,2,2,0,0,0,2,0,0,0,0,0,0,0,0,0,0,0,0,2,4,1,91560,36273,7365,48992,0
17,400,8,5,5,0,0,3,8,0,0,0,0,0,0,0,0,0,0,0,0,2,4,1,91560,36273,7365,48993,0
17,400,2,2,2,0,0,0,2,0,0,0,0,0,0,0,0,0,0,0,0,2,4,1,91560,36273,7365,48993,0
17,400,14,8,8,0,0,6,14,0,0,0,0,0,0,0,0,0,0,0,0,2,4,1,91560,36273,7365,48994,0
17,400,6,4,4,0,0,2,6,0,0,0,0,0,0,0,0,0,0,0,0,2,4,1,91560,36273,7365,48995,0
17,400,6,4,4,0,0,2,6,1,2,1,2,3,3,2,4,0,2,0,0,2,4,1,91560,36273,7365,48996,0
17,400,6,4,4,0,0,2,6,0,0,0,0,0,0,0,0,0,0,0,0,2,4,1,91560,36273,7365,48997,0
17,400,7,5,5,0,0,2,7,0,0,0,0,0,0,0,0,0,0,0,0,2,4,1,91560,36273,7365,48998,0
17,400,6,4,4,0,0,2,6,0,0,0,0,0,0,0,0,0,0,0,0,2,4,1,91560,36273,7365,48999,0
17,400,10,6,6,0,0,4,10,0,0,0,0,0,0,0,0,0,0,0,0,2,4,1,91560,36273,7365,49000,0
17,400,1,1,1,0,0,0,1,0,0,0,0,0,0,0,0,0,0,0,0,2,4,1,91560,36273,7365,49000,0
17,400,14,10,10,0,0,4,14,1,1,1,1,2,2,0,2,0,1,0,0,2,4,1,91560,36273,7365,49001,0
17,400,46,26,30,3,0,12,49,3,6,3,6,9,9,20,28,1,42,2,0,2,4,1,91570,36273,7365,49002,0
8,310,103,47,73,2,12,15,105,5,16,9,17,21,26,75,114,2,303,16,0,2,2,2,91570,36274,7365,49003,0
60,1550,91,45,69,0,3,18,91,3,9,6,10,12,16,33,57,1,95,5,0,2,38,23,91570,36276,7365,49004,0
60,1550,367,234,237,17,34,68,384,16,55,34,61,71,95,381,584,8,5183,287,0,2,38,23,91570,36277,7365,49005,0
18,704,442,244,305,14,16,103,456,11,68,45,75,79,120,452,756,6,4588,254,0,2,20,15,91570,36279,7365,49006,0
18,704,182,102,99,11,40,35,193,3,11,6,11,14,17,42,64,1,97,5,0,2,20,15,91570,36280,7365,49007,0
120,5072,1513,682,1277,25,13,200,1538,11,199,116,219,210,335,1557,2584,6,15641,868,0,2,1,3,91570,36282,7365,49008,0
17,400,127,75,83,2,11,30,129,4,14,7,14,18,21,61,87,2,175,9,0,2,4,1,91570,36282,7365,49009,0
17,400,652,304,544,16,6,88,668,6,89,51,101,95,152,591,998,3,3399,188,0,2,4,1,91570,36283,7365,49010,0
17,400,2,2,2,0,0,0,2,0,0,0,0,0,0,0,0,0,0,0,0,2,4,1,91570,36283,7365,49010,0
17,400,8,5,5,0,0,3,8,0,0,0,0,0,0,0,0,0,0,0,0,2,4,1,91570,36283,7365,49011,0
17,400,2,2,2,0,0,0,2,0,0,0,0,0,0,0,0,0,0,0,0,2,4,1,91570,36283,7365,49011,0
17,400,14,8,8,0,0,6,14,0,0,0,0,0,0,0,0,0,0,0,0,2,4,1,91570,36283,7365,49012,0
17,400,6,4,4,0,0,2,6,0,0,0,0,0,0,0,0,0,0,0,0,2,4,1,91570,36283,7365,49013,0
17,400,6,4,4,0,0,2,6,1,2,1,2,3,3,2,4,0,2,0,0,2,4,1,91570,36283,7365,49014,0
17,400,6,4,4,0,0,2,6,0,0,0,0,0,0,0,0,0,0,0,0,2,4,1,91570,36283,7365,49015,0
17,400,7,5,5,0,0,2,7,0,0,0,0,0,0,0,0,0,0,0,0,2,4,1,91570,36283,7365,49016,0
17,400,6,4,4,0,0,2,6,0,0,0,0,0,0,0,0,0,0,0,0,2,4,1,91570,36283,7365,49017,0
17,400,10,6,6,0,0,4,10,0,0,0,0,0,0,0,0,0,0,0,0,2,4,1,91570,36283,7365,49018,0
17,400,1,1,1,0,0,0,1,0,0,0,0,0,0,0,0,0,0,0,0,2,4,1,91570,36283,7365,49018,0
17,400,14,10,10,0,0,4,14,1,1,1,1,2,2,0,2,0,1,0,0,2,4,1,91570,36283,7365,49019,0
17,400,46,26,30,3,0,12,49,3,6,3,6,9,9,20,28,1,42,2,0,2,4,1,91580,36283,7365,49020,0
120,5072,1513,682,1277,25,13,200,1538,11,199,116,219,210,335,1557,2584,6,15641,868,0,2,1,3,91580,36285,7365,49021,0
143,3484,77,34,69,0,0,8,77,3,24,16,29,27,45,114,213,1,387,21,0,2,4,1,91580,36285,7365,49022,0
143,3484,712,438,573,51,9,84,763,14,102,71,128,116,199,733,1364,8,11988,666,0,2,4,1,91590,36286,7365,49023,0
292,6223,1943,715,1694,26,18,214,1969,12,185,120,237,197,357,1436,2721,7,20915,1161,0,2,15,2,91590,36288,7365,49024,0
292,6223,1168,838,957,57,25,144,1225,19,348,224,416,367,640,3018,5452,11,61921,3440,1,2,15,2,91600,36290,7365,49025,0
106,4670,1289,550,1043,56,32,155,1345,10,167,93,185,177,278,1266,2075,5,11498,638,0,2,2,2,91600,36292,7366,49026,0
89,3928,1338,495,1086,10,64,173,1348,11,122,82,157,133,239,883,1686,7,11934,663,0,2,1,1,91600,36294,7366,49027,0
185,7999,4293,999,3693,19,54,507,4312,9,155,88,170,164,258,1156,1898,4,9368,520,0,2,1,1,91600,36296,7366,49028,0
185,7999,1482,859,1002,125,135,219,1607,16,219,134,251,235,385,1766,3032,9,27804,1544,1,2,1,1,91610,36297,7366,49029,0
189,6308,1660,832,1314,41,38,274,1701,20,312,209,395,332,604,2671,5058,12,64042,3557,1,2,1,1,91610,36299,7367,49031,0
120,5072,1513,682,1277,25,13,200,1538,11,199,116,219,210,335,1557,2584,6,15641,868,0,2,1,1,91610,36301,7367,49032,0
85,4935,1296,573,1062,40,33,157,1336,8,201,118,231,209,349,1561,2689,4,12365,686,0,2,3,3,91610,36301,7367,49033,0
81,3715,1455,414,1257,16,76,112,1471,5,41,23,46,46,69,231,381,2,1069,59,0,2,1,1,91610,36302,7367,49034,0
69,3090,1020,354,843,12,15,144,1032,8,134,77,144,142,221,970,1580,4,6792,377,0,2,1,1,91610,36302,7367,49035,0
12,463,295,56,236,0,4,54,295,2,9,5,10,11,15,30,51,1,57,3,0,2,1,1,91610,36304,7367,49036,0
79,3068,1178,367,1042,6,15,115,1184,9,94,51,95,103,146,644,976,4,4439,246,0,2,1,1,91610,36304,7367,49037,0
12,645,219,78,157,11,5,46,230,3,24,20,34,27,54,114,256,2,545,30,0,2,1,1,91610,36305,7367,49038,0
112,6661,1943,715,1694,26,18,214,1969,12,185,120,237,197,357,1436,2721,7,20915,1161,0,2,4,7,91610,36307,7367,49039,0
49,1706,601,196,481,2,23,85,603,8,63,36,72,71,108,400,664,4,3036,168,0,2,6,6,91610,36307,7367,49040,0
40,786,1178,367,1042,6,15,115,1184,9,94,51,95,103,146,644,976,4,4439,246,0,2,2,2,91610,36307,7367,49041,0
40,786,177,108,140,8,0,27,185,6,30,16,32,36,48,162,248,3,794,44,0,2,2,2,91610,36309,7367,49042,0
292,6221,1943,715,1694,26,18,214,1969,12,185,120,237,197,357,1436,2721,7,20915,1161,0,2,1,1,91610,36311,7367,49043,0
292,6221,1168,838,957,57,25,144,1225,19,348,224,416,367,640,3018,5452,11,61921,3440,1,2,1,1,91620,36313,7367,49044,0
79,3071,1178,367,1042,6,15,115,1184,9,94,51,95,103,146,644,976,4,4439,246,0,2,17,3,91620,36313,7367,49045,0
120,5079,1513,682,1277,25,13,200,1538,11,199,116,219,210,335,1557,2584,6,15641,868,0,2,2,2,91620,36315,7367,49046,0
239,5071,2,2,2,0,0,0,2,0,0,0,0,0,0,0,0,0,0,0,0,2,1,0,91620,36315,7367,49046,0
239,5071,99,48,90,1,3,5,100,0,0,0,0,0,0,0,0,0,0,0,0,2,1,0,91620,36316,7367,49047,0
239,5071,8,5,5,2,0,1,10,0,0,0,0,0,0,0,0,0,0,0,0,2,1,0,91620,36316,7367,49048,0
239,5071,1217,716,841,84,126,174,1301,14,185,118,215,199,333,1446,2542,8,20687,1149,0,2,1,0,91630,36318,7367,49049,0
239,5071,160,89,115,0,13,31,160,7,15,11,17,22,28,78,124,3,495,27,0,2,1,0,91630,36318,7367,49050,0
239,5071,10,10,9,9,0,0,19,0,0,0,0,0,0,0,0,0,0,0,0,2,1,0,91630,36318,7368,49051,0
239,5071,173,84,99,8,29,36,181,5,12,7,13,17,20,54,81,2,221,12,0,2,1,0,91630,36319,7368,49052,0
239,5071,3,1,1,3,0,0,6,0,0,0,0,0,0,0,0,0,0,0,0,2,1,0,91630,36319,7368,49053,0
79,1942,466,257,367,18,25,50,484,7,126,86,171,133,257,898,1813,4,8612,478,0,2,5,5,91630,36319,7368,49054,0
79,1942,507,281,342,29,59,88,536,10,53,29,57,63,86,336,514,5,2764,153,0,2,5,5,91630,36319,7368,49055,0
31,1843,466,257,367,18,25,50,484,7,126,86,171,133,257,898,1813,4,8612,478,0,2,3,3,91630,36319,7368,49056,0
54,640,647,139,84,35,284,233,682,0,0,0,0,0,0,0,0,0,0,0,0,2,0,20,91630,36319,7368,49057,0
239,5071,2,2,2,0,0,0,2,0,0,0,0,0,0,0,0,0,0,0,0,2,1,0,91630,36319,7368,49057,0
239,5071,99,48,90,1,3,5,100,0,0,0,0,0,0,0,0,0,0,0,0,2,1,0,91630,36320,7368,49058,0
239,5071,8,5,5,2,0,1,10,0,0,0,0,0,0,0,0,0,0,0,0,2,1,0,91630,36320,7368,49059,0
239,5071,1217,716,841,84,126,174,1301,14,185,118,215,199,333,1446,2542,8,20687,1149,0,2,1,0,91640,36322,7368,49060,0
239,5071,160,89,115,0,13,31,160,7,15,11,17,22,28,78,124,3,495,27,0,2,1,0,91640,36322,7368,49061,0
239,5071,10,10,9,9,0,0,19,0,0,0,0,0,0,0,0,0,0,0,0,2,1,0,91640,36322,7369,49062,0
239,5071,173,84,99,8,29,36,181,5,12,7,13,17,20,54,81,2,221,12,0,2,1,0,91640,36323,7369,49063,0
239,5071,3,1,1,3,0,0,6,0,0,0,0,0,0,0,0,0,0,0,0,2,1,0,91640,36323,7369,49064,0
54,640,647,139,84,35,284,233,682,0,0,0,0,0,0,0,0,0,0,0,0,2,0,20,91640,36323,7369,49065,0
79,1942,466,257,367,18,25,50,484,7,126,86,171,133,257,898,1813,4,8612,478,0,2,5,5,91640,36323,7369,49066,0
79,1942,507,281,342,29,59,88,536,10,53,29,57,63,86,336,514,5,2764,153,0,2,5,5,91640,36323,7369,49067,0
31,1843,466,257,367,18,25,50,484,7,126,86,171,133,257,898,1813,4,8612,478,0,2,3,3,91640,36323,7369,49068,0
237,5056,2,2,2,0,0,0,2,0,0,0,0,0,0,0,0,0,0,0,0,2,3,1,91640,36323,7369,49068,0
237,5056,99,48,90,1,3,5,100,0,0,0,0,0,0,0,0,0,0,0,0,2,3,1,91640,36324,7369,49069,0
237,5056,8,5,5,2,0,1,10,0,0,0,0,0,0,0,0,0,0,0,0,2,3,1,91640,36324,7369,49070,0
237,5056,1217,716,841,84,126,174,1301,14,185,118,215,199,333,1446,2542,8,20687,1149,0,2,3,1,91650,36326,7369,49071,0
237,5056,160,89,115,0,13,31,160,7,15,11,17,22,28,78,124,3,495,27,0,2,3,1,91650,36326,7369,49072,0
237,5056,10,10,9,9,0,0,19,0,0,0,0,0,0,0,0,0,0,0,0,2,3,1,91650,36326,7370,49073,0
237,5056,173,84,99,8,29,36,181,5,12,7,13,17,20,54,81,2,221,12,0,2,3,1,91650,36327,7370,49074,0
237,5056,3,1,1,3,0,0,6,0,0,0,0,0,0,0,0,0,0,0,0,2,3,1,91650,36327,7370,49075,0
54,642,647,139,84,35,284,233,682,0,0,0,0,0,0,0,0,0,0,0,0,2,6,1,91650,36327,7370,49076,0
30,1924,384,251,317,7,8,52,391,11,70,44,84,81,128,467,811,6,5355,297,0,2,30,0,91650,36327,7370,49077,0
57,1473,339,213,244,17,9,65,356,10,42,26,48,52,74,259,421,5,2410,133,0,2,11,7,91660,36327,7370,49078,1
78,4151,1293,570,1093,25,15,163,1318,10,195,123,241,205,364,1516,2795,6,17273,959,0,2,45,1,91670,36329,7370,49079,1
57,1473,339,213,244,17,9,65,356,10,42,26,48,52,74,259,421,5,2410,133,0,2,11,7,91680,36329,7370,49080,0
78,4151,1293,570,1093,25,15,163,1318,10,195,123,241,205,364,1516,2795,6,17273,959,0,2,45,1,91690,36331,7370,49081,0
216,4974,182,127,129,0,0,53,182,5,39,21,42,44,63,217,343,2,926,51,0,2,5,5,91690,36331,7371,49082,0
216,4974,1165,710,800,67,119,181,1232,18,243,153,282,261,435,2000,3492,10,36473,2026,1,2,5,5,91700,36331,7372,49083,0
117,3166,1523,757,1297,19,12,193,1542,12,193,117,230,205,347,1508,2664,7,19053,1058,0,2,1,1,91710,36333,7372,49084,0
117,3166,701,378,504,33,58,109,734,13,110,68,126,123,194,794,1346,7,10027,557,0,2,1,1,91710,36334,7373,49085,0
142,3472,77,34,69,0,0,8,77,3,24,16,29,27,45,114,213,1,387,21,0,2,1,1,91710,36334,7373,49086,0
142,3472,712,438,573,51,9,84,763,14,102,71,128,116,199,733,1364,8,11988,666,0,2,1,1,91720,36335,7373,49087,0
30,669,125,97,103,3,0,19,128,9,25,17,27,34,44,144,223,4,1087,60,0,2,1,1,91720,36335,7374,49088,0
22,367,102,57,55,5,16,25,107,5,17,10,18,22,28,81,124,2,330,18,0,2,1,1,91720,36335,7374,49089,0
303,6685,72,33,56,0,4,12,72,1,1,1,1,2,2,0,2,0,1,0,0,2,3,3,91720,36335,7374,49090,0
303,6685,1454,835,1044,76,110,219,1530,17,275,158,296,292,454,2297,3718,9,34017,1889,1,2,3,3,91730,36336,7374,49091,0
40,784,1178,367,1042,6,15,115,1184,9,94,51,95,103,146,644,976,4,4439,246,0,2,2,2,91730,36336,7374,49092,0
40,784,177,108,140,8,0,27,185,6,30,16,32,36,48,162,248,3,794,44,0,2,2,2,91730,36338,7374,49093,0
147,5933,1782,648,1425,9,47,279,1791,8,171,97,189,179,286,1292,2140,4,9462,525,0,2,1,1,91730,36339,7375,49094,0
69,3090,1020,354,843,12,15,144,1032,8,134,77,144,142,221,970,1580,4,6792,377,0,2,1,1,91730,36339,7375,49095,0
21,637,424,94,331,4,0,89,428,1,5,5,5,6,10,11,25,0,12,0,0,2,1,1,91730,36340,7375,49096,0
38,2315,334,251,279,10,4,40,344,5,127,74,143,132,217,899,1528,2,4303,239,0,2,1,1,91730,36341,7375,49097,0
76,3969,1293,570,1093,25,15,163,1318,10,195,123,241,205,364,1516,2795,6,17273,959,0,2,1,1,91740,36343,7375,49098,0
12,645,219,78,157,11,5,46,230,3,24,20,34,27,54,114,256,2,545,30,0,2,1,1,91740,36344,7375,49099,0
216,4974,182,127,129,0,0,53,182,5,39,21,42,44,63,217,343,2,926,51,0,2,5,5,91740,36344,7376,49100,0
216,4974,1165,710,800,67,119,181,1232,18,243,153,282,261,435,2000,3492,10,36473,2026,1,2,5,5,91750,36344,7377,49101,0
117,3166,1523,757,1297,19,12,193,1542,12,193,117,230,205,347,1508,2664,7,19053,1058,0,2,1,1,91760,36346,7377,49102,0
117,3166,701,378,504,33,58,109,734,13,110,68,126,123,194,794,1346,7,10027,557,0,2,1,1,91760,36347,7378,49103,0
142,3472,77,34,69,0,0,8,77,3,24,16,29,27,45,114,213,1,387,21,0,2,1,1,91760,36347,7378,49104,0
142,3472,712,438,573,51,9,84,763,14,102,71,128,116,199,733,1364,8,11988,666,0,2,1,1,91770,36348,7378,49105,0
30,669,125,97,103,3,0,19,128,9,25,17,27,34,44,144,223,4,1087,60,0,2,1,1,91770,36348,7379,49106,0
22,367,102,57,55,5,16,25,107,5,17,10,18,22,28,81,124,2,330,18,0,2,1,1,91770,36348,7379,49107,0
303,6685,72,33,56,0,4,12,72,1,1,1,1,2,2,0,2,0,1,0,0,2,3,3,91770,36348,7379,49108,0
303,6685,1454,835,1044,76,110,219,1530,17,275,158,296,292,454,2297,3718,9,34017,1889,1,2,3,3,91780,36349,7379,49109,0
40,784,1178,367,1042,6,15,115,1184,9,94,51,95,103,146,644,976,4,4439,246,0,2,2,2,91780,36349,7379,49110,0
40,784,177,108,140,8,0,27,185,6,30,16,32,36,48,162,248,3,794,44,0,2,2,2,91780,36351,7379,49111,0
147,5933,1782,648,1425,9,47,279,1791,8,171,97,189,179,286,1292,2140,4,9462,525,0,2,1,1,91780,36352,7380,49112,0
69,3090,1020,354,843,12,15,144,1032,8,134,77,144,142,221,970,1580,4,6792,377,0,2,1,1,91780,36352,7380,49113,0
21,637,424,94,331,4,0,89,428,1,5,5,5,6,10,11,25,0,12,0,0,2,1,1,91780,36353,7380,49114,0
38,2315,334,251,279,10,4,40,344,5,127,74,143,132,217,899,1528,2,4303,239,0,2,1,1,91780,36354,7380,49115,0
78,4151,1293,570,1093,25,15,163,1318,10,195,123,241,205,364,1516,2795,6,17273,959,0,2,1,1,91790,36356,7380,49116,0
12,645,219,78,157,11,5,46,230,3,24,20,34,27,54,114,256,2,545,30,0,2,1,1,91790,36357,7380,49117,0
66,1699,53,23,39,0,0,13,53,2,8,4,8,10,12,26,39,1,39,2,0,2,3,2,91790,36357,7380,49118,0
66,1699,515,298,307,33,80,99,548,12,63,44,77,75,121,419,753,7,5527,307,0,2,3,2,91800,36357,7380,49119,0
120,5076,1513,682,1277,25,13,200,1538,11,199,116,219,210,335,1557,2584,6,15641,868,0,2,1,5,91800,36359,7380,49120,0
294,6238,1943,715,1694,26,18,214,1969,12,185,120,237,197,357,1436,2721,7,20915,1161,0,2,7,1,91800,36361,7380,49121,0
294,6238,1168,838,957,57,25,144,1225,19,348,224,416,367,640,3018,5452,11,61921,3440,1,2,7,1,91810,36363,7380,49122,0
113,6713,1943,715,1694,26,18,214,1969,12,185,120,237,197,357,1436,2721,7,20915,1161,0,2,17,0,91810,36365,7380,49123,0
113,6713,1943,715,1694,26,18,214,1969,12,185,120,237,197,357,1436,2721,7,20915,1161,0,2,2,2,91810,36367,7380,49124,0
12,320,149,95,105,2,0,41,151,8,54,28,55,62,83,334,494,4,2013,111,0,2,8,7,91810,36367,7380,49125,0
12,320,82,56,54,0,13,15,82,4,13,8,16,17,24,56,98,2,241,13,0,2,8,7,91820,36367,7380,49126,0
121,2276,477,336,357,30,23,73,507,16,194,134,250,210,384,1538,2962,10,30538,1696,0,2,1,18,91830,36368,7380,49127,0
73,2511,477,336,357,30,23,73,507,16,194,134,250,210,384,1538,2962,10,30538,1696,0,2,42,23,91840,36369,7380,49128,0
49,1715,601,196,481,2,23,85,603,8,63,36,72,71,108,400,664,4,3036,168,0,2,1,0,91840,36369,7380,49129,0
112,6693,1943,715,1694,26,18,214,1969,12,185,120,237,197,357,1436,2721,7,20915,1161,0,2,7,14,91840,36371,7380,49130,0
12,320,149,95,105,2,0,41,151,8,54,28,55,62,83,334,494,4,2013,111,0,2,8,7,91840,36371,7380,49131,0
12,320,82,56,54,0,13,15,82,4,13,8,16,17,24,56,98,2,241,13,0,2,8,7,91850,36371,7380,49132,0
73,2511,477,336,357,30,23,73,507,16,194,134,250,210,384,1538,2962,10,30538,1696,0,2,43,41,91860,36372,7380,49133,0
112,6693,1943,715,1694,26,18,214,1969,12,185,120,237,197,357,1436,2721,7,20915,1161,0,2,7,14,91860,36374,7380,49134,0
296,6307,1943,715,1694,26,18,214,1969,12,185,120,237,197,357,1436,2721,7,20915,1161,0,2,16,5,91860,36376,7380,49135,0
296,6307,1168,838,957,57,25,144,1225,19,348,224,416,367,640,3018,5452,11,61921,3440,1,2,16,5,91870,36378,7380,49136,0
114,6826,1943,715,1694,26,18,214,1969,12,185,120,237,197,357,1436,2721,7,20915,1161,0,2,43,2,91870,36380,7380,49137,0
114,2105,477,336,357,30,23,73,507,16,194,134,250,210,384,1538,2962,10,30538,1696,0,2,0,1,91880,36381,7380,49138,0
114,2105,477,336,357,30,23,73,507,16,194,134,250,210,384,1538,2962,10,30538,1696,0,2,0,1,91890,36382,7380,49139,0
217,5035,182,127,129,0,0,53,182,5,39,21,42,44,63,217,343,2,926,51,0,2,20,17,91890,36382,7381,49140,1
217,5035,1165,710,800,67,119,181,1232,18,243,153,282,261,435,2000,3492,10,36473,2026,1,2,20,17,91900,36382,7382,49141,1
103,2729,1455,414,1257,16,76,112,1471,5,41,23,46,46,69,231,381,2,1069,59,0,2,1,1,91900,36383,7382,49142,1
103,2729,669,365,481,22,61,110,691,15,103,63,122,118,185,747,1273,8,11311,628,0,2,1,1,91910,36383,7383,49143,1
261,6241,4293,999,3693,19,54,507,4312,9,155,88,170,164,258,1156,1898,4,9368,520,0,2,10,4,91910,36385,7383,49144,1
261,6241,1482,859,1002,125,135,219,1607,16,219,134,251,235,385,1766,3032,9,27804,1544,1,2,10,4,91920,36386,7383,49145,1
143,3505,77,34,69,0,0,8,77,3,24,16,29,27,45,114,213,1,387,21,0,2,9,4,91920,36386,7383,49146,1
143,3505,712,438,573,51,9,84,763,14,102,71,128,116,199,733,1364,8,11988,666,0,2,9,4,91930,36387,7383,49147,1
63,1828,53,23,39,0,0,13,53,2,8,4,8,10,12,26,39,1,39,2,0,2,39,16,91930,36387,7383,49148,1
63,1828,515,298,307,33,80,99,548,12,63,44,77,75,121,419,753,7,5527,307,0,2,39,16,91940,36387,7383,49149,1
303,6698,72,33,56,0,4,12,72,1,1,1,1,2,2,0,2,0,1,0,0,2,2,1,91940,36387,7383,49150,1
303,6698,1454,835,1044,76,110,219,1530,17,275,158,296,292,454,2297,3718,9,34017,1889,1,2,2,1,91950,36388,7383,49151,1
78,1979,466,257,367,18,25,50,484,7,126,86,171,133,257,898,1813,4,8612,478,0,2,15,5,91950,36388,7383,49152,1
78,1979,507,281,342,29,59,88,536,10,53,29,57,63,86,336,514,5,2764,153,0,2,15,5,91950,36388,7383,49153,1
87,1930,1043,504,840,53,9,147,1096,9,180,112,198,189,310,1377,2344,4,11604,644,0,2,3,3,91950,36390,7383,49154,1
87,1930,383,288,292,26,6,62,409,11,65,38,67,76,105,429,656,5,3719,206,0,2,3,3,91950,36391,7383,49155,1
148,7107,1392,870,1177,35,17,170,1427,14,494,280,531,508,811,4473,7289,7,54850,3047,2,2,1,1,91950,36394,7384,49156,1
49,1715,601,196,481,2,23,85,603,8,63,36,72,71,108,400,664,4,3036,168,0,2,1,0,91950,36394,7384,49157,0
217,5035,182,127,129,0,0,53,182,5,39,21,42,44,63,217,343,2,926,51,0,2,20,17,91950,36394,7385,49158,0
217,5035,1165,710,800,67,119,181,1232,18,243,153,282,261,435,2000,3492,10,36473,2026,1,2,20,17,91960,36394,7386,49159,0
103,2729,1455,414,1257,16,76,112,1471,5,41,23,46,46,69,231,381,2,1069,59,0,2,1,1,91960,36395,7386,49160,0
103,2729,669,365,481,22,61,110,691,15,103,63,122,118,185,747,1273,8,11311,628,0,2,1,1,91970,36395,7387,49161,0
261,6241,4293,999,3693,19,54,507,4312,9,155,88,170,164,258,1156,1898,4,9368,520,0,2,10,4,91970,36397,7387,49162,0
261,6241,1482,859,1002,125,135,219,1607,16,219,134,251,235,385,1766,3032,9,27804,1544,1,2,10,4,91980,36398,7387,49163,0
143,3505,77,34,69,0,0,8,77,3,24,16,29,27,45,114,213,1,387,21,0,2,9,4,91980,36398,7387,49164,0
143,3505,712,438,573,51,9,84,763,14,102,71,128,116,199,733,1364,8,11988,666,0,2,9,4,91990,36399,7387,49165,0
63,1828,53,23,39,0,0,13,53,2,8,4,8,10,12,26,39,1,39,2,0,2,39,16,91990,36399,7387,49166,0
63,1828,515,298,307,33,80,99,548,12,63,44,77,75,121,419,753,7,5527,307,0,2,39,16,92000,36399,7387,49167,0
303,6698,72,33,56,0,4,12,72,1,1,1,1,2,2,0,2,0,1,0,0,2,2,1,92000,36399,7387,49168,0
303,6698,1454,835,1044,76,110,219,1530,17,275,158,296,292,454,2297,3718,9,34017,1889,1,2,2,1,92010,36400,7387,49169,0
78,1979,466,257,367,18,25,50,484,7,126,86,171,133,257,898,1813,4,8612,478,0,2,15,5,92010,36400,7387,49170,0
78,1979,507,281,342,29,59,88,536,10,53,29,57,63,86,336,514,5,2764,153,0,2,15,5,92010,36400,7387,49171,0
87,1930,1043,504,840,53,9,147,1096,9,180,112,198,189,310,1377,2344,4,11604,644,0,2,3,3,92010,36402,7387,49172,0
87,1930,383,288,292,26,6,62,409,11,65,38,67,76,105,429,656,5,3719,206,0,2,3,3,92010,36403,7387,49173,0
148,7107,1392,870,1177,35,17,170,1427,14,494,280,531,508,811,4473,7289,7,54850,3047,2,2,1,1,92010,36406,7388,49174,0
49,3865,996,429,845,24,10,117,1020,7,76,50,88,83,138,494,879,4,3565,198,0,2,5,0,92010,36408,7388,49175,0
51,3873,996,429,845,24,10,117,1020,7,76,50,88,83,138,494,879,4,3565,198,0,2,24,16,92010,36410,7388,49176,0
51,3885,996,429,845,24,10,117,1020,7,76,50,88,83,138,494,879,4,3565,198,0,2,4,2,92010,36412,7388,49177,0
296,6307,1943,715,1694,26,18,214,1969,12,185,120,237,197,357,1436,2721,7,20915,1161,0,2,16,5,92010,36414,7388,49178,0
296,6307,1168,838,957,57,25,144,1225,19,348,224,416,367,640,3018,5452,11,61921,3440,1,2,16,5,92020,36416,7388,49179,0
113,6806,1943,715,1694,26,18,214,1969,12,185,120,237,197,357,1436,2721,7,20915,1161,0,2,41,0,92020,36418,7388,49180,0
117,2969,773,422,505,30,103,129,803,14,77,46,83,91,129,535,839,7,6334,351,0,2,87,12,92030,36419,7389,49181,0
3,501,149,67,118,4,0,27,153,1,17,14,28,18,42,69,175,0,144,8,0,2,66,2,92030,36419,7389,49182,0
73,2511,477,336,357,30,23,73,507,16,194,134,250,210,384,1538,2962,10,30538,1696,0,2,5,4,92040,36420,7389,49183,1
125,5319,1450,624,1228,12,26,181,1462,14,306,186,354,320,540,2580,4493,8,36391,2021,1,2,37,0,92040,36422,7390,49184,1
56,1826,53,23,39,0,0,13,53,2,8,4,8,10,12,26,39,1,39,2,0,2,3,2,92040,36422,7390,49185,0
56,1826,515,298,307,33,80,99,548,12,63,44,77,75,121,419,753,7,5527,307,0,2,3,2,92050,36422,7390,49186,0
119,5003,1513,682,1277,25,13,200,1538,11,199,116,219,210,335,1557,2584,6,15641,868,0,2,1,14,92050,36424,7390,49187,0
69,4372,520,294,400,33,13,81,553,10,261,204,367,271,571,2128,4614,7,32445,1802,1,2,30,12,92050,36425,7390,49188,0
40,786,1178,367,1042,6,15,115,1184,9,94,51,95,103,146,644,976,4,4439,246,0,2,2,2,92050,36425,7390,49189,0
40,786,177,108,140,8,0,27,185,6,30,16,32,36,48,162,248,3,794,44,0,2,2,2,92050,36427,7390,49190,0
296,6305,1943,715,1694,26,18,214,1969,12,185,120,237,197,357,1436,2721,7,20915,1161,0,2,1,1,92050,36429,7390,49191,0
296,6305,1168,838,957,57,25,144,1225,19,348,224,416,367,640,3018,5452,11,61921,3440,1,2,1,1,92060,36431,7390,49192,0
79,3071,1178,367,1042,6,15,115,1184,9,94,51,95,103,146,644,976,4,4439,246,0,2,17,3,92060,36431,7390,49193,0
51,3885,996,429,845,24,10,117,1020,7,76,50,88,83,138,494,879,4,3565,198,0,2,29,14,92060,36433,7390,49194,0
217,5035,182,127,129,0,0,53,182,5,39,21,42,44,63,217,343,2,926,51,0,2,5,5,92060,36433,7391,49195,0
217,5035,1165,710,800,67,119,181,1232,18,243,153,282,261,435,2000,3492,10,36473,2026,1,2,5,5,92070,36433,7392,49196,0
73,2508,477,336,357,30,23,73,507,16,194,134,250,210,384,1538,2962,10,30538,1696,0,2,0,1,92080,36434,7392,49197,0
57,1477,339,213,244,17,9,65,356,10,42,26,48,52,74,259,421,5,2410,133,0,2,11,7,92090,36434,7392,49198,0
117,3166,1523,757,1297,19,12,193,1542,12,193,117,230,205,347,1508,2664,7,19053,1058,0,2,1,1,92100,36436,7392,49199,0
117,3166,701,378,504,33,58,109,734,13,110,68,126,123,194,794,1346,7,10027,557,0,2,1,1,92100,36437,7393,49200,0
143,3505,77,34,69,0,0,8,77,3,24,16,29,27,45,114,213,1,387,21,0,2,1,1,92100,36437,7393,49201,0
143,3505,712,438,573,51,9,84,763,14,102,71,128,116,199,733,1364,8,11988,666,0,2,1,1,92110,36438,7393,49202,0
30,669,125,97,103,3,0,19,128,9,25,17,27,34,44,144,223,4,1087,60,0,2,1,1,92110,36438,7394,49203,0
22,367,102,57,55,5,16,25,107,5,17,10,18,22,28,81,124,2,330,18,0,2,1,1,92110,36438,7394,49204,0
303,6698,72,33,56,0,4,12,72,1,1,1,1,2,2,0,2,0,1,0,0,2,3,3,92110,36438,7394,49205,0
303,6698,1454,835,1044,76,110,219,1530,17,275,158,296,292,454,2297,3718,9,34017,1889,1,2,3,3,92120,36439,7394,49206,0
40,786,1178,367,1042,6,15,115,1184,9,94,51,95,103,146,644,976,4,4439,246,0,2,2,2,92120,36439,7394,49207,0
40,786,177,108,140,8,0,27,185,6,30,16,32,36,48,162,248,3,794,44,0,2,2,2,92120,36441,7394,49208,0
147,5933,1782,648,1425,9,47,279,1791,8,171,97,189,179,286,1292,2140,4,9462,525,0,2,1,1,92120,36442,7395,49209,0
69,3090,1020,354,843,12,15,144,1032,8,134,77,144,142,221,970,1580,4,6792,377,0,2,1,1,92120,36442,7395,49210,0
21,637,424,94,331,4,0,89,428,1,5,5,5,6,10,11,25,0,12,0,0,2,1,1,92120,36443,7395,49211,0
38,2315,334,251,279,10,4,40,344,5,127,74,143,132,217,899,1528,2,4303,239,0,2,1,1,92120,36444,7395,49212,0
79,4230,1293,570,1093,25,15,163,1318,10,195,123,241,205,364,1516,2795,6,17273,959,0,2,46,2,92130,36446,7395,49213,0
12,645,219,78,157,11,5,46,230,3,24,20,34,27,54,114,256,2,545,30,0,2,1,1,92130,36447,7395,49214,0
119,5010,1513,682,1277,25,13,200,1538,11,199,116,219,210,335,1557,2584,6,15641,868,0,2,2,2,92130,36449,7395,49215,0
239,5077,2,2,2,0,0,0,2,0,0,0,0,0,0,0,0,0,0,0,0,2,3,1,92130,36449,7395,49215,0
239,5077,99,48,90,1,3,5,100,0,0,0,0,0,0,0,0,0,0,0,0,2,3,1,92130,36450,7395,49216,0
239,5077,8,5,5,2,0,1,10,0,0,0,0,0,0,0,0,0,0,0,0,2,3,1,92130,36450,7395,49217,0
239,5077,1217,716,841,84,126,174,1301,14,185,118,215,199,333,1446,2542,8,20687,1149,0,2,3,1,92140,36452,7395,49218,0
239,5077,160,89,115,0,13,31,160,7,15,11,17,22,28,78,124,3,495,27,0,2,3,1,92140,36452,7395,49219,0
239,5077,10,10,9,9,0,0,19,0,0,0,0,0,0,0,0,0,0,0,0,2,3,1,92140,36452,7396,49220,0
239,5077,173,84,99,8,29,36,181,5,12,7,13,17,20,54,81,2,221,12,0,2,3,1,92140,36453,7396,49221,0
239,5077,3,1,1,3,0,0,6,0,0,0,0,0,0,0,0,0,0,0,0,2,3,1,92140,36453,7396,49222,0
54,642,647,139,84,35,284,233,682,0,0,0,0,0,0,0,0,0,0,0,0,2,6,1,92140,36453,7396,49223,0
30,1924,384,251,317,7,8,52,391,11,70,44,84,81,128,467,811,6,5355,297,0,2,30,0,92140,36453,7396,49224,0
306,6763,72,33,56,0,4,12,72,1,1,1,1,2,2,0,2,0,1,0,0,2,18,6,92140,36453,7396,49225,0
306,6763,1454,835,1044,76,110,219,1530,17,275,158,296,292,454,2297,3718,9,34017,1889,1,2,18,6,92150,36454,7396,49226,0
80,3116,1178,367,1042,6,15,115,1184,9,94,51,95,103,146,644,976,4,4439,246,0,2,23,0,92150,36454,7396,49227,0
1,319,382,65,130,157,2,92,539,4,10,5,10,14,15,41,57,2,114,6,0,2,13,0,92150,36455,7397,49228,0
13,539,124,78,88,2,3,26,126,4,13,7,13,17,20,56,81,2,163,9,0,2,7,0,92150,36455,7397,49229,0
73,2511,477,336,357,30,23,73,507,16,194,134,250,210,384,1538,2962,10,30538,1696,0,2,5,4,92160,36456,7397,49230,0
125,5319,1450,624,1228,12,26,181,1462,14,306,186,354,320,540,2580,4493,8,36391,2021,1,2,37,0,92160,36458,7398,49231,0
8,310,103,47,73,2,12,15,105,5,16,9,17,21,26,75,114,2,303,16,0,2,2,2,92160,36459,7398,49232,0
18,382,149,95,105,2,0,41,151,8,54,28,55,62,83,334,494,4,2013,111,0,2,23,9,92160,36459,7398,49233,0
18,382,82,56,54,0,13,15,82,4,13,8,16,17,24,56,98,2,241,13,0,2,23,9,92170,36459,7398,49234,0
148,7107,1392,870,1177,35,17,170,1427,14,494,280,531,508,811,4473,7289,7,54850,3047,2,2,2,2,92170,36462,7399,49235,0
24,691,149,95,105,2,0,41,151,8,54,28,55,62,83,334,494,4,2013,111,0,2,75,3,92170,36462,7399,49236,0
30,1422,373,158,315,8,0,51,381,5,76,44,79,81,123,486,779,2,2026,112,0,2,9,9,92170,36462,7399,49237,0
24,694,149,95,105,2,0,41,151,8,54,28,55,62,83,334,494,4,2013,111,0,2,3,2,92170,36462,7399,49238,0
143,3503,77,34,69,0,0,8,77,3,24,16,29,27,45,114,213,1,387,21,0,2,5,5,92170,36462,7399,49239,0
143,3503,712,438,573,51,9,84,763,14,102,71,128,116,199,733,1364,8,11988,666,0,2,5,5,92180,36463,7399,49240,0
143,3503,77,34,69,0,0,8,77,3,24,16,29,27,45,114,213,1,387,21,0,2,5,5,92180,36463,7399,49241,0
143,3503,712,438,573,51,9,84,763,14,102,71,128,116,199,733,1364,8,11988,666,0,2,5,5,92190,36464,7399,49242,0
100,2883,773,419,590,28,0,166,801,10,204,113,217,214,330,1598,2554,5,13587,754,0,2,24,19,92190,36464,7400,49243,0
79,4230,1293,570,1093,25,15,163,1318,10,195,123,241,205,364,1516,2795,6,17273,959,0,2,1,1,92200,36466,7400,49244,0
125,5340,1450,624,1228,12,26,181,1462,14,306,186,354,320,540,2580,4493,8,36391,2021,1,2,6,3,92200,36468,7401,49245,0
148,7121,1392,870,1177,35,17,170,1427,14,494,280,531,508,811,4473,7289,7,54850,3047,2,2,4,2,92200,36471,7402,49246,0
143,3505,77,34,69,0,0,8,77,3,24,16,29,27,45,114,213,1,387,21,0,2,0,1,92200,36471,7402,49247,0
143,3505,712,438,573,51,9,84,763,14,102,71,128,116,199,733,1364,8,11988,666,0,2,0,1,92210,36472,7402,49248,0
106,4685,1289,550,1043,56,32,155,1345,10,167,93,185,177,278,1266,2075,5,11498,638,0,2,8,2,92210,36474,7403,49249,0
217,5035,182,127,129,0,0,53,182,5,39,21,42,44,63,217,343,2,926,51,0,2,5,5,92210,36474,7404,49250,0
217,5035,1165,710,800,67,119,181,1232,18,243,153,282,261,435,2000,3492,10,36473,2026,1,2,5,5,92220,36474,7405,49251,0
73,2508,477,336,357,30,23,73,507,16,194,134,250,210,384,1538,2962,10,30538,1696,0,2,0,1,92230,36475,7405,49252,0
57,1477,339,213,244,17,9,65,356,10,42,26,48,52,74,259,421,5,2410,133,0,2,11,7,92240,36475,7405,49253,0
117,3166,1523,757,1297,19,12,193,1542,12,193,117,230,205,347,1508,2664,7,19053,1058,0,2,1,1,92250,36477,7405,49254,0
117,3166,701,378,504,33,58,109,734,13,110,68,126,123,194,794,1346,7,10027,557,0,2,1,1,92250,36478,7406,49255,0
143,3503,77,34,69,0,0,8,77,3,24,16,29,27,45,114,213,1,387,21,0,2,1,1,92250,36478,7406,49256,0
143,3503,712,438,573,51,9,84,763,14,102,71,128,116,199,733,1364,8,11988,666,0,2,1,1,92260,36479,7406,49257,0
30,669,125,97,103,3,0,19,128,9,25,17,27,34,44,144,223,4,1087,60,0,2,1,1,92260,36479,7407,49258,0
22,367,102,57,55,5,16,25,107,5,17,10,18,22,28,81,124,2,330,18,0,2,1,1,92260,36479,7407,49259,0
303,6698,72,33,56,0,4,12,72,1,1,1,1,2,2,0,2,0,1,0,0,2,3,3,92260,36479,7407,49260,0
303,6698,1454,835,1044,76,110,219,1530,17,275,158,296,292,454,2297,3718,9,34017,1889,1,2,3,3,92270,36480,7407,49261,0
40,786,1178,367,1042,6,15,115,1184,9,94,51,95,103,146,644,976,4,4439,246,0,2,2,2,92270,36480,7407,49262,0
40,786,177,108,140,8,0,27,185,6,30,16,32,36,48,162,248,3,794,44,0,2,2,2,92270,36482,7407,49263,0
147,5933,1782,648,1425,9,47,279,1791,8,171,97,189,179,286,1292,2140,4,9462,525,0,2,1,1,92270,36483,7408,49264,0
69,3090,1020,354,843,12,15,144,1032,8,134,77,144,142,221,970,1580,4,6792,377,0,2,1,1,92270,36483,7408,49265,0
21,637,424,94,331,4,0,89,428,1,5,5,5,6,10,11,25,0,12,0,0,2,1,1,92270,36484,7408,49266,0
38,2315,334,251,279,10,4,40,344,5,127,74,143,132,217,899,1528,2,4303,239,0,2,1,1,92270,36485,7408,49267,0
79,4230,1293,570,1093,25,15,163,1318,10,195,123,241,205,364,1516,2795,6,17273,959,0,2,46,2,92280,36487,7408,49268,0
12,645,219,78,157,11,5,46,230,3,24,20,34,27,54,114,256,2,545,30,0,2,1,1,92280,36488,7408,49269,0
18,382,149,95,105,2,0,41,151,8,54,28,55,62,83,334,494,4,2013,111,0,2,23,9,92280,36488,7408,49270,0
18,382,82,56,54,0,13,15,82,4,13,8,16,17,24,56,98,2,241,13,0,2,23,9,92290,36488,7408,49271,0
148,7107,1392,870,1177,35,17,170,1427,14,494,280,531,508,811,4473,7289,7,54850,3047,2,2,2,2,92290,36491,7409,49272,0
24,694,149,95,105,2,0,41,151,8,54,28,55,62,83,334,494,4,2013,111,0,2,76,3,92290,36491,7409,49273,0
30,1422,373,158,315,8,0,51,381,5,76,44,79,81,123,486,779,2,2026,112,0,2,9,9,92290,36491,7409,49274,0
61,1561,91,45,69,0,3,18,91,3,9,6,10,12,16,33,57,1,95,5,0,2,6,5,92290,36493,7409,49275,0
61,1561,367,234,237,17,34,68,384,16,55,34,61,71,95,381,584,8,5183,287,0,2,6,5,92290,36494,7409,49276,0
40,1853,442,244,305,14,16,103,456,11,68,45,75,79,120,452,756,6,4588,254,0,2,7,0,92290,36496,7409,49277,0
61,1561,91,45,69,0,3,18,91,3,9,6,10,12,16,33,57,1,95,5,0,2,1,1,92290,36498,7409,49278,0
61,1561,367,234,237,17,34,68,384,16,55,34,61,71,95,381,584,8,5183,287,0,2,1,1,92290,36499,7409,49279,0
40,1859,442,244,305,14,16,103,456,11,68,45,75,79,120,452,756,6,4588,254,0,2,4,1,92290,36501,7409,49280,0
2,222,37,13,25,0,6,6,37,1,2,1,2,3,3,2,4,0,2,0,0,2,16,5,92290,36501,7409,49281,0
2,222,133,47,40,1,43,49,134,0,0,0,0,0,0,0,0,0,0,0,0,2,16,5,92290,36501,7409,49282,0
58,1732,773,419,590,28,0,166,801,10,204,113,217,214,330,1598,2554,5,13587,754,0,2,50,23,92290,36501,7410,49283,1
58,1732,421,273,302,44,34,57,465,17,81,59,107,98,166,583,1098,11,12329,684,0,2,50,23,92290,36501,7411,49284,1
227,6311,722,423,573,19,0,135,741,12,172,101,199,184,300,1320,2257,6,15668,870,0,2,81,37,92290,36503,7411,49286,0
227,6311,1508,847,911,44,250,301,1552,14,148,88,169,162,257,1120,1886,7,15077,837,0,2,81,37,92290,36504,7412,49287,0
100,2883,773,419,590,28,0,166,801,10,204,113,217,214,330,1598,2554,5,13587,754,0,2,24,19,92290,36504,7413,49288,0
143,3503,77,34,69,0,0,8,77,3,24,16,29,27,45,114,213,1,387,21,0,2,0,1,92290,36504,7413,49289,0
143,3503,712,438,573,51,9,84,763,14,102,71,128,116,199,733,1364,8,11988,666,0,2,0,1,92300,36505,7413,49290,0
106,4685,1289,550,1043,56,32,155,1345,10,167,93,185,177,278,1266,2075,5,11498,638,0,2,8,2,92300,36507,7414,49291,0
148,7121,1392,870,1177,35,17,170,1427,14,494,280,531,508,811,4473,7289,7,54850,3047,2,2,4,2,92300,36510,7415,49292,0
125,5340,1450,624,1228,12,26,181,1462,14,306,186,354,320,540,2580,4493,8,36391,2021,1,2,6,3,92300,36512,7416,49293,0
58,1732,773,419,590,28,0,166,801,10,204,113,217,214,330,1598,2554,5,13587,754,0,2,50,23,92300,36512,7417,49294,0
58,1732,421,273,302,44,34,57,465,17,81,59,107,98,166,583,1098,11,12329,684,0,2,50,23,92300,36512,7418,49295,0
227,6311,722,423,573,19,0,135,741,12,172,101,199,184,300,1320,2257,6,15668,870,0,2,81,37,92300,36514,7418,49297,0
227,6311,1508,847,911,44,250,301,1552,14,148,88,169,162,257,1120,1886,7,15077,837,0,2,81,37,92300,36515,7419,49298,0
2,222,37,13,25,0,6,6,37,1,2,1,2,3,3,2,4,0,2,0,0,2,16,5,92300,36515,7419,49299,0
2,222,133,47,40,1,43,49,134,0,0,0,0,0,0,0,0,0,0,0,0,2,16,5,92300,36515,7419,49300,0
1,93,42,7,35,4,0,5,46,1,2,1,2,3,3,2,4,0,2,0,0,2,1,1,92300,36515,7419,49301,0
1,93,11,6,10,0,0,1,11,2,4,2,4,6,6,10,15,1,15,0,0,2,1,1,92300,36515,7419,49302,0
191,5617,1660,832,1314,41,38,274,1701,20,312,209,395,332,604,2671,5058,12,64042,3557,1,2,50,19,92300,36517,7420,49304,0
191,5617,1057,646,719,113,100,145,1170,18,215,134,248,233,382,1740,3004,10,31186,1732,1,2,50,19,92310,36518,7421,49305,0
191,6340,1660,832,1314,41,38,274,1701,20,312,209,395,332,604,2671,5058,12,64042,3557,1,2,22,12,92310,36520,7422,49307,0
143,3505,77,34,69,0,0,8,77,3,24,16,29,27,45,114,213,1,387,21,0,2,1,0,92310,36520,7422,49308,0
143,3505,712,438,573,51,9,84,763,14,102,71,128,116,199,733,1364,8,11988,666,0,2,1,0,92320,36521,7422,49309,0
85,4935,1296,573,1062,40,33,157,1336,8,201,118,231,209,349,1561,2689,4,12365,686,0,2,2,2,92320,36521,7422,49310,0
28,596,2,2,2,0,0,0,2,0,0,0,0,0,0,0,0,0,0,0,0,2,2,2,92320,36521,7422,49310,0
28,596,99,48,90,1,3,5,100,0,0,0,0,0,0,0,0,0,0,0,0,2,2,2,92320,36522,7422,49311,0
28,596,8,5,5,2,0,1,10,0,0,0,0,0,0,0,0,0,0,0,0,2,2,2,92320,36522,7422,49312,0
28,596,1217,716,841,84,126,174,1301,14,185,118,215,199,333,1446,2542,8,20687,1149,0,2,2,2,92330,36524,7422,49313,0
28,596,160,89,115,0,13,31,160,7,15,11,17,22,28,78,124,3,495,27,0,2,2,2,92330,36524,7422,49314,0
28,596,10,10,9,9,0,0,19,0,0,0,0,0,0,0,0,0,0,0,0,2,2,2,92330,36524,7423,49315,0
28,596,173,84,99,8,29,36,181,5,12,7,13,17,20,54,81,2,221,12,0,2,2,2,92330,36525,7423,49316,0
28,596,3,1,1,3,0,0,6,0,0,0,0,0,0,0,0,0,0,0,0,2,2,2,92330,36525,7423,49317,0
61,1561,91,45,69,0,3,18,91,3,9,6,10,12,16,33,57,1,95,5,0,2,6,5,92330,36527,7423,49318,0
61,1561,367,234,237,17,34,68,384,16,55,34,61,71,95,381,584,8,5183,287,0,2,6,5,92330,36528,7423,49319,0
40,1859,442,244,305,14,16,103,456,11,68,45,75,79,120,452,756,6,4588,254,0,2,11,1,92330,36530,7423,49320,0
1,93,42,7,35,4,0,5,46,1,2,1,2,3,3,2,4,0,2,0,0,2,1,1,92330,36530,7423,49321,0
1,93,11,6,10,0,0,1,11,2,4,2,4,6,6,10,15,1,15,0,0,2,1,1,92330,36530,7423,49322,0
191,5617,1660,832,1314,41,38,274,1701,20,312,209,395,332,604,2671,5058,12,64042,3557,1,2,50,19,92330,36532,7424,49324,0
191,5617,1057,646,719,113,100,145,1170,18,215,134,248,233,382,1740,3004,10,31186,1732,1,2,50,19,92340,36533,7425,49325,0
191,6340,1660,832,1314,41,38,274,1701,20,312,209,395,332,604,2671,5058,12,64042,3557,1,2,22,12,92340,36535,7426,49327,0
28,596,2,2,2,0,0,0,2,0,0,0,0,0,0,0,0,0,0,0,0,2,2,2,92340,36535,7426,49327,0
28,596,99,48,90,1,3,5,100,0,0,0,0,0,0,0,0,0,0,0,0,2,2,2,92340,36536,7426,49328,0
28,596,8,5,5,2,0,1,10,0,0,0,0,0,0,0,0,0,0,0,0,2,2,2,92340,36536,7426,49329,0
28,596,1217,716,841,84,126,174,1301,14,185,118,215,199,333,1446,2542,8,20687,1149,0,2,2,2,92350,36538,7426,49330,0
28,596,160,89,115,0,13,31,160,7,15,11,17,22,28,78,124,3,495,27,0,2,2,2,92350,36538,7426,49331,0
28,596,10,10,9,9,0,0,19,0,0,0,0,0,0,0,0,0,0,0,0,2,2,2,92350,36538,7427,49332,0
28,596,173,84,99,8,29,36,181,5,12,7,13,17,20,54,81,2,221,12,0,2,2,2,92350,36539,7427,49333,0
28,596,3,1,1,3,0,0,6,0,0,0,0,0,0,0,0,0,0,0,0,2,2,2,92350,36539,7427,49334,0
143,3505,77,34,69,0,0,8,77,3,24,16,29,27,45,114,213,1,387,21,0,2,1,0,92350,36539,7427,49335,0
143,3505,712,438,573,51,9,84,763,14,102,71,128,116,199,733,1364,8,11988,666,0,2,1,0,92360,36540,7427,49336,0
85,4935,1296,573,1062,40,33,157,1336,8,201,118,231,209,349,1561,2689,4,12365,686,0,2,2,2,92360,36540,7427,49337,0
77,2606,477,336,357,30,23,73,507,16,194,134,250,210,384,1538,2962,10,30538,1696,0,2,23,9,92370,36541,7427,49338,0
127,5419,1450,624,1228,12,26,181,1462,14,306,186,354,320,540,2580,4493,8,36391,2021,1,2,27,6,92370,36543,7428,49339,0
302,6691,72,33,56,0,4,12,72,1,1,1,1,2,2,0,2,0,1,0,0,2,2,1,92370,36543,7428,49340,0
302,6691,1454,835,1044,76,110,219,1530,17,275,158,296,292,454,2297,3718,9,34017,1889,1,2,2,1,92380,36544,7428,49341,0
70,3147,1020,354,843,12,15,144,1032,8,134,77,144,142,221,970,1580,4,6792,377,0,2,15,0,92380,36544,7428,49342,0
68,1510,402,202,227,24,74,80,426,12,52,33,61,64,94,339,564,7,3969,220,0,2,0,3,92380,36545,7428,49343,0
68,1479,402,202,227,24,74,80,426,12,52,33,61,64,94,339,564,7,3969,220,0,2,14,14,92380,36546,7428,49344,0
70,3140,1020,354,843,12,15,144,1032,8,134,77,144,142,221,970,1580,4,6792,377,0,2,6,0,92380,36546,7428,49345,0
68,1479,402,202,227,24,74,80,426,12,52,33,61,64,94,339,564,7,3969,220,0,2,14,17,92380,36547,7428,49346,0
70,3140,1020,354,843,12,15,144,1032,8,134,77,144,142,221,970,1580,4,6792,377,0,2,6,0,92380,36547,7428,49347,0
302,6691,72,33,56,0,4,12,72,1,1,1,1,2,2,0,2,0,1,0,0,2,2,1,92380,36547,7428,49348,0
302,6691,1454,835,1044,76,110,219,1530,17,275,158,296,292,454,2297,3718,9,34017,1889,1,2,2,1,92390,36548,7428,49349,0
71,3197,1020,354,843,12,15,144,1032,8,134,77,144,142,221,970,1580,4,6792,377,0,2,15,0,92390,36548,7428,49350,0
31,1070,74,35,59,1,0,14,75,3,14,7,14,17,21,58,85,1,128,7,0,2,3,2,92390,36549,7428,49351,0
31,1070,245,125,200,5,7,34,250,7,30,17,34,37,51,166,265,3,1053,58,0,2,3,2,92400,36550,7428,49352,0
31,1070,74,35,59,1,0,14,75,3,14,7,14,17,21,58,85,1,128,7,0,2,3,2,92400,36551,7428,49353,0
31,1070,245,125,200,5,7,34,250,7,30,17,34,37,51,166,265,3,1053,58,0,2,3,2,92410,36552,7428,49354,0
78,1993,466,257,367,18,25,50,484,7,126,86,171,133,257,898,1813,4,8612,478,0,2,4,4,92410,36552,7428,49355,1
78,1993,507,281,342,29,59,88,536,10,53,29,57,63,86,336,514,5,2764,153,0,2,4,4,92410,36552,7428,49356,1
296,6372,1943,715,1694,26,18,214,1969,12,185,120,237,197,357,1436,2721,7,20915,1161,0,2,30,20,92410,36554,7428,49357,1
296,6372,1168,838,957,57,25,144,1225,19,348,224,416,367,640,3018,5452,11,61921,3440,1,2,30,20,92420,36556,7428,49358,1
78,1993,466,257,367,18,25,50,484,7,126,86,171,133,257,898,1813,4,8612,478,0,2,4,4,92420,36556,7428,49359,0
78,1993,507,281,342,29,59,88,536,10,53,29,57,63,86,336,514,5,2764,153,0,2,4,4,92420,36556,7428,49360,0
296,6372,1943,715,1694,26,18,214,1969,12,185,120,237,197,357,1436,2721,7,20915,1161,0,2,30,20,92420,36558,7428,49361,0
296,6372,1168,838,957,57,25,144,1225,19,348,224,416,367,640,3018,5452,11,61921,3440,1,2,30,20,92430,36560,7428,49362,0
64,1418,207,111,150,11,0,50,218,5,26,19,36,31,55,133,272,3,943,52,0,2,41,0,92430,36560,7428,49363,1
64,1418,410,198,237,31,55,97,441,11,63,38,72,74,110,414,683,6,4293,238,0,2,41,0,92440,36561,7429,49364,1
55,1815,53,23,39,0,0,13,53,2,8,4,8,10,12,26,39,1,39,2,0,2,6,13,92440,36561,7429,49365,1
55,1815,515,298,307,33,80,99,548,12,63,44,77,75,121,419,753,7,5527,307,0,2,6,13,92450,36561,7429,49366,1
25,591,207,111,150,11,0,50,218,5,26,19,36,31,55,133,272,3,943,52,0,2,21,0,92450,36561,7429,49367,1
77,2606,477,336,357,30,23,73,507,16,194,134,250,210,384,1538,2962,10,30538,1696,0,2,23,9,92460,36562,7429,49368,0
127,5419,1450,624,1228,12,26,181,1462,14,306,186,354,320,540,2580,4493,8,36391,2021,1,2,27,6,92460,36564,7430,49369,0
56,1884,53,23,39,0,0,13,53,2,8,4,8,10,12,26,39,1,39,2,0,2,20,11,92460,36564,7430,49370,0
56,1884,515,298,307,33,80,99,548,12,63,44,77,75,121,419,753,7,5527,307,0,2,20,11,92470,36564,7430,49371,0
64,1418,207,111,150,11,0,50,218,5,26,19,36,31,55,133,272,3,943,52,0,2,41,0,92470,36564,7430,49372,0
64,1418,410,198,237,31,55,97,441,11,63,38,72,74,110,414,683,6,4293,238,0,2,41,0,92480,36565,7431,49373,0
55,1815,53,23,39,0,0,13,53,2,8,4,8,10,12,26,39,1,39,2,0,2,6,13,92480,36565,7431,49374,0
55,1815,515,298,307,33,80,99,548,12,63,44,77,75,121,419,753,7,5527,307,0,2,6,13,92490,36565,7431,49375,0
25,591,207,111,150,11,0,50,218,5,26,19,36,31,55,133,272,3,943,52,0,2,21,0,92490,36565,7431,49376,0
145,5858,1782,648,1425,9,47,279,1791,8,171,97,189,179,286,1292,2140,4,9462,525,0,2,0,21,92490,36566,7432,49377,0
55,1873,53,23,39,0,0,13,53,2,8,4,8,10,12,26,39,1,39,2,0,2,20,11,92490,36566,7432,49378,0
55,1873,515,298,307,33,80,99,548,12,63,44,77,75,121,419,753,7,5527,307,0,2,20,11,92500,36566,7432,49379,0
227,6314,722,423,573,19,0,135,741,12,172,101,199,184,300,1320,2257,6,15668,870,0,2,2,1,92500,36568,7432,49381,0
227,6314,1508,847,911,44,250,301,1552,14,148,88,169,162,257,1120,1886,7,15077,837,0,2,2,1,92500,36569,7433,49382,0
227,6314,722,423,573,19,0,135,741,12,172,101,199,184,300,1320,2257,6,15668,870,0,2,2,1,92500,36571,7433,49384,0
227,6314,1508,847,911,44,250,301,1552,14,148,88,169,162,257,1120,1886,7,15077,837,0,2,2,1,92500,36572,7434,49385,0
227,6345,722,423,573,19,0,135,741,12,172,101,199,184,300,1320,2257,6,15668,870,0,2,11,4,92500,36574,7434,49387,0
227,6345,1508,847,911,44,250,301,1552,14,148,88,169,162,257,1120,1886,7,15077,837,0,2,11,4,92500,36575,7435,49388,0
127,5424,1450,624,1228,12,26,181,1462,14,306,186,354,320,540,2580,4493,8,36391,2021,1,2,8,1,92500,36577,7436,49389,0
298,6416,1943,715,1694,26,18,214,1969,12,185,120,237,197,357,1436,2721,7,20915,1161,0,2,5,1,92500,36579,7436,49390,0
298,6416,1168,838,957,57,25,144,1225,19,348,224,416,367,640,3018,5452,11,61921,3440,1,2,5,1,92510,36581,7436,49391,0
85,4946,1296,573,1062,40,33,157,1336,8,201,118,231,209,349,1561,2689,4,12365,686,0,2,9,4,92510,36581,7436,49392,0
114,6852,1943,715,1694,26,18,214,1969,12,185,120,237,197,357,1436,2721,7,20915,1161,0,2,25,1,92510,36583,7436,49393,0
145,5858,1782,648,1425,9,47,279,1791,8,171,97,189,179,286,1292,2140,4,9462,525,0,2,0,21,92510,36584,7437,49394,0
298,6416,1943,715,1694,26,18,214,1969,12,185,120,237,197,357,1436,2721,7,20915,1161,0,2,5,1,92510,36586,7437,49395,0
298,6416,1168,838,957,57,25,144,1225,19,348,224,416,367,640,3018,5452,11,61921,3440,1,2,5,1,92520,36588,7437,49396,0
85,4946,1296,573,1062,40,33,157,1336,8,201,118,231,209,349,1561,2689,4,12365,686,0,2,9,4,92520,36588,7437,49397,0
114,6852,1943,715,1694,26,18,214,1969,12,185,120,237,197,357,1436,2721,7,20915,1161,0,2,25,1,92520,36590,7437,49398,0
227,6345,722,423,573,19,0,135,741,12,172,101,199,184,300,1320,2257,6,15668,870,0,2,11,4,92520,36592,7437,49400,0
227,6345,1508,847,911,44,250,301,1552,14,148,88,169,162,257,1120,1886,7,15077,837,0,2,11,4,92520,36593,7438,49401,0
127,5424,1450,624,1228,12,26,181,1462,14,306,186,354,320,540,2580,4493,8,36391,2021,1,2,8,1,92520,36595,7439,49402,0
23,625,601,196,481,2,23,85,603,8,63,36,72,71,108,400,664,4,3036,168,0,2,1,1,92520,36595,7439,49403,0
23,625,156,79,106,5,16,28,161,5,14,8,15,19,23,64,97,2,261,14,0,2,1,1,92520,36595,7439,49404,0
239,5077,2,2,2,0,0,0,2,0,0,0,0,0,0,0,0,0,0,0,0,2,1,1,92520,36595,7439,49404,0
239,5077,99,48,90,1,3,5,100,0,0,0,0,0,0,0,0,0,0,0,0,2,1,1,92520,36596,7439,49405,0
239,5077,8,5,5,2,0,1,10,0,0,0,0,0,0,0,0,0,0,0,0,2,1,1,92520,36596,7439,49406,0
239,5077,1217,716,841,84,126,174,1301,14,185,118,215,199,333,1446,2542,8,20687,1149,0,2,1,1,92530,36598,7439,49407,0
239,5077,160,89,115,0,13,31,160,7,15,11,17,22,28,78,124,3,495,27,0,2,1,1,92530,36598,7439,49408,0
239,5077,10,10,9,9,0,0,19,0,0,0,0,0,0,0,0,0,0,0,0,2,1,1,92530,36598,7440,49409,0
239,5077,173,84,99,8,29,36,181,5,12,7,13,17,20,54,81,2,221,12,0,2,1,1,92530,36599,7440,49410,0
239,5077,3,1,1,3,0,0,6,0,0,0,0,0,0,0,0,0,0,0,0,2,1,1,92530,36599,7440,49411,0
113,2326,463,295,324,28,62,57,491,12,134,82,154,146,236,989,1696,6,11700,650,0,2,1,1,92540,36600,7440,49412,0
54,642,647,139,84,35,284,233,682,0,0,0,0,0,0,0,0,0,0,0,0,2,4,4,92540,36600,7440,49413,0
296,6372,1943,715,1694,26,18,214,1969,12,185,120,237,197,357,1436,2721,7,20915,1161,0,2,1,1,92540,36602,7440,49414,0
296,6372,1168,838,957,57,25,144,1225,19,348,224,416,367,640,3018,5452,11,61921,3440,1,2,1,1,92550,36604,7440,49415,0
118,3197,1523,757,1297,19,12,193,1542,12,193,117,230,205,347,1508,2664,7,19053,1058,0,2,8,4,92560,36606,7440,49417,0
118,3197,701,378,504,33,58,109,734,13,110,68,126,123,194,794,1346,7,10027,557,0,2,8,4,92560,36607,7441,49418,0
7,265,75,38,59,1,3,12,76,2,4,2,4,6,6,10,15,1,15,0,0,2,29,0,92560,36607,7441,49419,0
307,6777,72,33,56,0,4,12,72,1,1,1,1,2,2,0,2,0,1,0,0,2,6,0,92560,36607,7441,49420,0
307,6777,1454,835,1044,76,110,219,1530,17,275,158,296,292,454,2297,3718,9,34017,1889,1,2,6,0,92570,36608,7441,49421,0
149,5988,1782,648,1425,9,47,279,1791,8,171,97,189,179,286,1292,2140,4,9462,525,0,2,13,0,92570,36609,7442,49422,0
307,6777,72,33,56,0,4,12,72,1,1,1,1,2,2,0,2,0,1,0,0,2,6,0,92570,36609,7442,49423,0
307,6777,1454,835,1044,76,110,219,1530,17,275,158,296,292,454,2297,3718,9,34017,1889,1,2,6,0,92580,36610,7442,49424,0
149,5988,1782,648,1425,9,47,279,1791,8,171,97,189,179,286,1292,2140,4,9462,525,0,2,13,0,92580,36611,7443,49425,0
239,5077,2,2,2,0,0,0,2,0,0,0,0,0,0,0,0,0,0,0,0,2,1,1,92580,36611,7443,49425,0
239,5077,99,48,90,1,3,5,100,0,0,0,0,0,0,0,0,0,0,0,0,2,1,1,92580,36612,7443,49426,0
239,5077,8,5,5,2,0,1,10,0,0,0,0,0,0,0,0,0,0,0,0,2,1,1,92580,36612,7443,49427,0
239,5077,1217,716,841,84,126,174,1301,14,185,118,215,199,333,1446,2542,8,20687,1149,0,2,1,1,92590,36614,7443,49428,0
239,5077,160,89,115,0,13,31,160,7,15,11,17,22,28,78,124,3,495,27,0,2,1,1,92590,36614,7443,49429,0
239,5077,10,10,9,9,0,0,19,0,0,0,0,0,0,0,0,0,0,0,0,2,1,1,92590,36614,7444,49430,0
239,5077,173,84,99,8,29,36,181,5,12,7,13,17,20,54,81,2,221,12,0,2,1,1,92590,36615,7444,49431,0
239,5077,3,1,1,3,0,0,6,0,0,0,0,0,0,0,0,0,0,0,0,2,1,1,92590,36615,7444,49432,0
113,2326,463,295,324,28,62,57,491,12,134,82,154,146,236,989,1696,6,11700,650,0,2,1,1,92600,36616,7444,49433,0
54,642,647,139,84,35,284,233,682,0,0,0,0,0,0,0,0,0,0,0,0,2,4,4,92600,36616,7444,49434,0
298,6416,1943,715,1694,26,18,214,1969,12,185,120,237,197,357,1436,2721,7,20915,1161,0,2,1,1,92600,36618,7444,49435,0
298,6416,1168,838,957,57,25,144,1225,19,348,224,416,367,640,3018,5452,11,61921,3440,1,2,1,1,92610,36620,7444,49436,0
23,625,601,196,481,2,23,85,603,8,63,36,72,71,108,400,664,4,3036,168,0,2,1,1,92610,36620,7444,49437,0
23,625,156,79,106,5,16,28,161,5,14,8,15,19,23,64,97,2,261,14,0,2,1,1,92610,36620,7444,49438,0
118,3197,1523,757,1297,19,12,193,1542,12,193,117,230,205,347,1508,2664,7,19053,1058,0,2,8,4,92620,36622,7444,49440,0
118,3197,701,378,504,33,58,109,734,13,110,68,126,123,194,794,1346,7,10027,557,0,2,8,4,92620,36623,7445,49441,0
7,265,75,38,59,1,3,12,76,2,4,2,4,6,6,10,15,1,15,0,0,2,29,0,92620,36623,7445,49442,0
239,5075,2,2,2,0,0,0,2,0,0,0,0,0,0,0,0,0,0,0,0,2,0,1,92620,36623,7445,49442,0
239,5075,99,48,90,1,3,5,100,0,0,0,0,0,0,0,0,0,0,0,0,2,0,1,92620,36624,7445,49443,0
239,5075,8,5,5,2,0,1,10,0,0,0,0,0,0,0,0,0,0,0,0,2,0,1,92620,36624,7445,49444,0
239,5075,1217,716,841,84,126,174,1301,14,185,118,215,199,333,1446,2542,8,20687,1149,0,2,0,1,92630,36626,7445,49445,0
239,5075,160,89,115,0,13,31,160,7,15,11,17,22,28,78,124,3,495,27,0,2,0,1,92630,36626,7445,49446,0
239,5075,10,10,9,9,0,0,19,0,0,0,0,0,0,0,0,0,0,0,0,2,0,1,92630,36626,7446,49447,0
239,5075,173,84,99,8,29,36,181,5,12,7,13,17,20,54,81,2,221,12,0,2,0,1,92630,36627,7446,49448,0
239,5075,3,1,1,3,0,0,6,0,0,0,0,0,0,0,0,0,0,0,0,2,0,1,92630,36627,7446,49449,0
7,265,75,38,59,1,3,12,76,2,4,2,4,6,6,10,15,1,15,0,0,2,1,1,92630,36627,7446,49451,0
304,6699,72,33,56,0,4,12,72,1,1,1,1,2,2,0,2,0,1,0,0,2,6,18,92630,36627,7446,49452,0
304,6699,1454,835,1044,76,110,219,1530,17,275,158,296,292,454,2297,3718,9,34017,1889,1,2,6,18,92640,36628,7446,49453,0
79,3071,1178,367,1042,6,15,115,1184,9,94,51,95,103,146,644,976,4,4439,246,0,2,0,23,92640,36628,7446,49454,0
87,5041,1296,573,1062,40,33,157,1336,8,201,118,231,209,349,1561,2689,4,12365,686,0,2,21,0,92640,36628,7446,49455,0
304,6699,72,33,56,0,4,12,72,1,1,1,1,2,2,0,2,0,1,0,0,2,6,18,92640,36628,7446,49456,0
304,6699,1454,835,1044,76,110,219,1530,17,275,158,296,292,454,2297,3718,9,34017,1889,1,2,6,18,92650,36629,7446,49457,0
87,5041,1296,573,1062,40,33,157,1336,8,201,118,231,209,349,1561,2689,4,12365,686,0,2,21,0,92650,36629,7446,49458,0
79,3071,1178,367,1042,6,15,115,1184,9,94,51,95,103,146,644,976,4,4439,246,0,2,0,23,92650,36629,7446,49459,0
191,5619,1660,832,1314,41,38,274,1701,20,312,209,395,332,604,2671,5058,12,64042,3557,1,2,1,1,92650,36631,7447,49461,0
191,5619,1057,646,719,113,100,145,1170,18,215,134,248,233,382,1740,3004,10,31186,1732,1,2,1,1,92660,36632,7448,49462,0
239,5079,2,2,2,0,0,0,2,0,0,0,0,0,0,0,0,0,0,0,0,2,1,1,92660,36632,7448,49462,0
239,5079,99,48,90,1,3,5,100,0,0,0,0,0,0,0,0,0,0,0,0,2,1,1,92660,36633,7448,49463,0
239,5079,8,5,5,2,0,1,10,0,0,0,0,0,0,0,0,0,0,0,0,2,1,1,92660,36633,7448,49464,0
239,5079,1217,716,841,84,126,174,1301,14,185,118,215,199,333,1446,2542,8,20687,1149,0,2,1,1,92670,36635,7448,49465,0
239,5079,160,89,115,0,13,31,160,7,15,11,17,22,28,78,124,3,495,27,0,2,1,1,92670,36635,7448,49466,0
239,5079,10,10,9,9,0,0,19,0,0,0,0,0,0,0,0,0,0,0,0,2,1,1,92670,36635,7449,49467,0
239,5079,173,84,99,8,29,36,181,5,12,7,13,17,20,54,81,2,221,12,0,2,1,1,92670,36636,7449,49468,0
239,5079,3,1,1,3,0,0,6,0,0,0,0,0,0,0,0,0,0,0,0,2,1,1,92670,36636,7449,49469,0
191,6342,1660,832,1314,41,38,274,1701,20,312,209,395,332,604,2671,5058,12,64042,3557,1,2,1,1,92670,36638,7450,49471,0
111,6058,1457,730,1242,11,6,188,1468,10,292,166,329,302,495,2424,4078,5,22973,1276,1,2,1,1,92670,36640,7450,49472,0
46,2850,652,304,544,16,6,88,668,6,89,51,101,95,152,591,998,3,3399,188,0,2,1,1,92670,36641,7450,49473,0
113,5659,1523,757,1297,19,12,193,1542,12,193,117,230,205,347,1508,2664,7,19053,1058,0,2,1,1,92680,36643,7450,49474,0
51,3885,996,429,845,24,10,117,1020,7,76,50,88,83,138,494,879,4,3565,198,0,2,3,3,92680,36645,7450,49475,0
191,5619,1660,832,1314,41,38,274,1701,20,312,209,395,332,604,2671,5058,12,64042,3557,1,2,1,1,92680,36647,7451,49477,0
191,5619,1057,646,719,113,100,145,1170,18,215,134,248,233,382,1740,3004,10,31186,1732,1,2,1,1,92690,36648,7452,49478,0
239,5079,2,2,2,0,0,0,2,0,0,0,0,0,0,0,0,0,0,0,0,2,1,1,92690,36648,7452,49478,0
239,5079,99,48,90,1,3,5,100,0,0,0,0,0,0,0,0,0,0,0,0,2,1,1,92690,36649,7452,49479,0
239,5079,8,5,5,2,0,1,10,0,0,0,0,0,0,0,0,0,0,0,0,2,1,1,92690,36649,7452,49480,0
239,5079,1217,716,841,84,126,174,1301,14,185,118,215,199,333,1446,2542,8,20687,1149,0,2,1,1,92700,36651,7452,49481,0
239,5079,160,89,115,0,13,31,160,7,15,11,17,22,28,78,124,3,495,27,0,2,1,1,92700,36651,7452,49482,0
239,5079,10,10,9,9,0,0,19,0,0,0,0,0,0,0,0,0,0,0,0,2,1,1,92700,36651,7453,49483,0
239,5079,173,84,99,8,29,36,181,5,12,7,13,17,20,54,81,2,221,12,0,2,1,1,92700,36652,7453,49484,0
239,5079,3,1,1,3,0,0,6,0,0,0,0,0,0,0,0,0,0,0,0,2,1,1,92700,36652,7453,49485,0
191,6342,1660,832,1314,41,38,274,1701,20,312,209,395,332,604,2671,5058,12,64042,3557,1,2,1,1,92700,36654,7454,49487,0
111,6058,1457,730,1242,11,6,188,1468,10,292,166,329,302,495,2424,4078,5,22973,1276,1,2,1,1,92700,36656,7454,49488,0
46,2850,652,304,544,16,6,88,668,6,89,51,101,95,152,591,998,3,3399,188,0,2,1,1,92700,36657,7454,49489,0
113,5659,1523,757,1297,19,12,193,1542,12,193,117,230,205,347,1508,2664,7,19053,1058,0,2,1,1,92710,36659,7454,49490,0
303,6705,72,33,56,0,4,12,72,1,1,1,1,2,2,0,2,0,1,0,0,2,6,0,92710,36659,7454,49491,0
303,6705,1454,835,1044,76,110,219,1530,17,275,158,296,292,454,2297,3718,9,34017,1889,1,2,6,0,92720,36660,7454,49492,0
147,5913,1782,648,1425,9,47,279,1791,8,171,97,189,179,286,1292,2140,4,9462,525,0,2,13,0,92720,36661,7455,49493,0
87,5034,1296,573,1062,40,33,157,1336,8,201,118,231,209,349,1561,2689,4,12365,686,0,2,21,0,92720,36661,7455,49494,0
304,6689,72,33,56,0,4,12,72,1,1,1,1,2,2,0,2,0,1,0,0,2,1,2,92720,36661,7455,49495,0
304,6689,1454,835,1044,76,110,219,1530,17,275,158,296,292,454,2297,3718,9,34017,1889,1,2,1,2,92730,36662,7455,49496,0
58,1732,773,419,590,28,0,166,801,10,204,113,217,214,330,1598,2554,5,13587,754,0,2,1,1,92730,36662,7456,49497,0
58,1732,421,273,302,44,34,57,465,17,81,59,107,98,166,583,1098,11,12329,684,0,2,1,1,92730,36662,7457,49498,0
191,5619,1660,832,1314,41,38,274,1701,20,312,209,395,332,604,2671,5058,12,64042,3557,1,2,3,2,92730,36664,7458,49500,0
191,5619,1057,646,719,113,100,145,1170,18,215,134,248,233,382,1740,3004,10,31186,1732,1,2,3,2,92740,36665,7459,49501,0
64,1418,207,111,150,11,0,50,218,5,26,19,36,31,55,133,272,3,943,52,0,2,5,2,92740,36665,7459,49502,0
64,1418,410,198,237,31,55,97,441,11,63,38,72,74,110,414,683,6,4293,238,0,2,5,2,92750,36666,7460,49503,0
80,1970,757,253,292,73,244,162,830,13,61,38,67,74,105,409,651,7,4654,258,0,2,1,1,92750,36667,7460,49504,0
20,989,386,256,301,16,9,68,402,4,59,35,69,63,104,355,621,2,1453,80,0,2,3,3,92750,36667,7460,49505,0
20,989,264,131,164,11,41,46,275,6,38,22,40,44,62,214,338,3,1068,59,0,2,3,3,92760,36667,7461,49506,0
117,4986,1513,682,1277,25,13,200,1538,11,199,116,219,210,335,1557,2584,6,15641,868,0,2,0,2,92760,36669,7461,49507,0
217,5015,182,127,129,0,0,53,182,5,39,21,42,44,63,217,343,2,926,51,0,2,0,2,92760,36669,7462,49508,0
217,5015,1165,710,800,67,119,181,1232,18,243,153,282,261,435,2000,3492,10,36473,2026,1,2,0,2,92770,36669,7463,49509,0
148,7106,1392,870,1177,35,17,170,1427,14,494,280,531,508,811,4473,7289,7,54850,3047,2,2,3,3,92770,36672,7464,49510,0
100,2878,773,419,590,28,0,166,801,10,204,113,217,214,330,1598,2554,5,13587,754,0,2,1,1,92770,36672,7465,49511,0
63,1383,207,111,150,11,0,50,218,5,26,19,36,31,55,133,272,3,943,52,0,2,0,15,92770,36672,7465,49512,0
63,1383,410,198,237,31,55,97,441,11,63,38,72,74,110,414,683,6,4293,238,0,2,0,15,92780,36673,7466,49513,0
262,6261,4293,999,3693,19,54,507,4312,9,155,88,170,164,258,1156,1898,4,9368,520,0,2,8,2,92780,36675,7466,49514,0
262,6261,1482,859,1002,125,135,219,1607,16,219,134,251,235,385,1766,3032,9,27804,1544,1,2,8,2,92790,36676,7466,49515,0
304,6734,72,33,56,0,4,12,72,1,1,1,1,2,2,0,2,0,1,0,0,2,15,2,92790,36676,7466,49516,0
304,6734,1454,835,1044,76,110,219,1530,17,275,158,296,292,454,2297,3718,9,34017,1889,1,2,15,2,92800,36677,7466,49517,0
217,5010,182,127,129,0,0,53,182,5,39,21,42,44,63,217,343,2,926,51,0,2,1,3,92800,36677,7467,49518,0
217,5010,1165,710,800,67,119,181,1232,18,243,153,282,261,435,2000,3492,10,36473,2026,1,2,1,3,92810,36677,7468,49519,0
143,6926,1392,870,1177,35,17,170,1427,14,494,280,531,508,811,4473,7289,7,54850,3047,2,2,8,55,92810,36680,7469,49520,0
59,1754,773,419,590,28,0,166,801,10,204,113,217,214,330,1598,2554,5,13587,754,0,2,4,0,92810,36680,7470,49521,0
59,1754,421,273,302,44,34,57,465,17,81,59,107,98,166,583,1098,11,12329,684,0,2,4,0,92810,36680,7471,49522,0
53,1495,207,111,150,11,0,50,218,5,26,19,36,31,55,133,272,3,943,52,0,2,29,18,92810,36680,7471,49523,0
53,1495,410,198,237,31,55,97,441,11,63,38,72,74,110,414,683,6,4293,238,0,2,29,18,92820,36681,7472,49524,0
85,2063,996,429,845,24,10,117,1020,7,76,50,88,83,138,494,879,4,3565,198,0,2,2,1,92820,36683,7472,49525,0
85,2063,456,277,329,12,42,72,468,13,85,50,97,98,147,592,972,7,7212,400,0,2,2,1,92820,36683,7472,49526,0
85,2063,996,429,845,24,10,117,1020,7,76,50,88,83,138,494,879,4,3565,198,0,2,2,1,92820,36685,7472,49527,0
85,2063,456,277,329,12,42,72,468,13,85,50,97,98,147,592,972,7,7212,400,0,2,2,1,92820,36685,7472,49528,0
239,5079,2,2,2,0,0,0,2,0,0,0,0,0,0,0,0,0,0,0,0,2,2,2,92820,36685,7472,49528,0
239,5079,99,48,90,1,3,5,100,0,0,0,0,0,0,0,0,0,0,0,0,2,2,2,92820,36686,7472,49529,0
239,5079,8,5,5,2,0,1,10,0,0,0,0,0,0,0,0,0,0,0,0,2,2,2,92820,36686,7472,49530,0
239,5079,1217,716,841,84,126,174,1301,14,185,118,215,199,333,1446,2542,8,20687,1149,0,2,2,2,92830,36688,7472,49531,0
239,5079,160,89,115,0,13,31,160,7,15,11,17,22,28,78,124,3,495,27,0,2,2,2,92830,36688,7472,49532,0
239,5079,10,10,9,9,0,0,19,0,0,0,0,0,0,0,0,0,0,0,0,2,2,2,92830,36688,7473,49533,0
239,5079,173,84,99,8,29,36,181,5,12,7,13,17,20,54,81,2,221,12,0,2,2,2,92830,36689,7473,49534,0
239,5079,3,1,1,3,0,0,6,0,0,0,0,0,0,0,0,0,0,0,0,2,2,2,92830,36689,7473,49535,0
113,2328,463,295,324,28,62,57,491,12,134,82,154,146,236,989,1696,6,11700,650,0,2,1,1,92840,36690,7473,49536,0
227,6346,722,423,573,19,0,135,741,12,172,101,199,184,300,1320,2257,6,15668,870,0,2,1,1,92840,36692,7473,49538,0
227,6346,1508,847,911,44,250,301,1552,14,148,88,169,162,257,1120,1886,7,15077,837,0,2,1,1,92840,36693,7474,49539,0
185,8005,4293,999,3693,19,54,507,4312,9,155,88,170,164,258,1156,1898,4,9368,520,0,2,3,3,92840,36695,7474,49540,0
185,8005,1482,859,1002,125,135,219,1607,16,219,134,251,235,385,1766,3032,9,27804,1544,1,2,3,3,92850,36696,7474,49541,0
30,921,256,139,192,9,7,47,265,4,23,12,24,27,36,112,171,2,357,19,0,2,1,1,92850,36697,7474,49542,0
85,4954,1296,573,1062,40,33,157,1336,8,201,118,231,209,349,1561,2689,4,12365,686,0,2,4,4,92850,36697,7474,49543,0
71,3199,1020,354,843,12,15,144,1032,8,134,77,144,142,221,970,1580,4,6792,377,0,2,1,1,92850,36697,7474,49544,0
79,3073,1178,367,1042,6,15,115,1184,9,94,51,95,103,146,644,976,4,4439,246,0,2,1,1,92850,36697,7474,49545,0
40,1861,442,244,305,14,16,103,456,11,68,45,75,79,120,452,756,6,4588,254,0,2,1,1,92850,36699,7474,49546,0
51,2042,1098,241,925,5,10,155,1103,7,46,25,49,53,74,273,423,3,1580,87,0,2,1,1,92860,36701,7474,49547,0
239,5079,2,2,2,0,0,0,2,0,0,0,0,0,0,0,0,0,0,0,0,2,2,2,92860,36701,7474,49547,0
239,5079,99,48,90,1,3,5,100,0,0,0,0,0,0,0,0,0,0,0,0,2,2,2,92860,36702,7474,49548,0
239,5079,8,5,5,2,0,1,10,0,0,0,0,0,0,0,0,0,0,0,0,2,2,2,92860,36702,7474,49549,0
239,5079,1217,716,841,84,126,174,1301,14,185,118,215,199,333,1446,2542,8,20687,1149,0,2,2,2,92870,36704,7474,49550,0
239,5079,160,89,115,0,13,31,160,7,15,11,17,22,28,78,124,3,495,27,0,2,2,2,92870,36704,7474,49551,0
239,5079,10,10,9,9,0,0,19,0,0,0,0,0,0,0,0,0,0,0,0,2,2,2,92870,36704,7475,49552,0
239,5079,173,84,99,8,29,36,181,5,12,7,13,17,20,54,81,2,221,12,0,2,2,2,92870,36705,7475,49553,0
239,5079,3,1,1,3,0,0,6,0,0,0,0,0,0,0,0,0,0,0,0,2,2,2,92870,36705,7475,49554,0
113,2328,463,295,324,28,62,57,491,12,134,82,154,146,236,989,1696,6,11700,650,0,2,1,1,92880,36706,7475,49555,0
227,6346,722,423,573,19,0,135,741,12,172,101,199,184,300,1320,2257,6,15668,870,0,2,1,1,92880,36708,7475,49557,0
227,6346,1508,847,911,44,250,301,1552,14,148,88,169,162,257,1120,1886,7,15077,837,0,2,1,1,92880,36709,7476,49558,0
185,8005,4293,999,3693,19,54,507,4312,9,155,88,170,164,258,1156,1898,4,9368,520,0,2,3,3,92880,36711,7476,49559,0
185,8005,1482,859,1002,125,135,219,1607,16,219,134,251,235,385,1766,3032,9,27804,1544,1,2,3,3,92890,36712,7476,49560,0
30,921,256,139,192,9,7,47,265,4,23,12,24,27,36,112,171,2,357,19,0,2,1,1,92890,36713,7476,49561,0
85,4954,1296,573,1062,40,33,157,1336,8,201,118,231,209,349,1561,2689,4,12365,686,0,2,4,4,92890,36713,7476,49562,0
71,3199,1020,354,843,12,15,144,1032,8,134,77,144,142,221,970,1580,4,6792,377,0,2,1,1,92890,36713,7476,49563,0
79,3073,1178,367,1042,6,15,115,1184,9,94,51,95,103,146,644,976,4,4439,246,0,2,1,1,92890,36713,7476,49564,0
40,1861,442,244,305,14,16,103,456,11,68,45,75,79,120,452,756,6,4588,254,0,2,1,1,92890,36715,7476,49565,0
51,2042,1098,241,925,5,10,155,1103,7,46,25,49,53,74,273,423,3,1580,87,0,2,1,1,92900,36717,7476,49566,0
186,5483,182,127,129,0,0,53,182,5,39,21,42,44,63,217,343,2,926,51,0,2,153,87,92900,36717,7477,49567,1
186,5483,1165,710,800,67,119,181,1232,18,243,153,282,261,435,2000,3492,10,36473,2026,1,2,153,87,92910,36717,7478,49568,1
31,1010,182,127,129,0,0,53,182,5,39,21,42,44,63,217,343,2,926,51,0,2,29,28,92910,36717,7479,49569,1
143,6943,1392,870,1177,35,17,170,1427,14,494,280,531,508,811,4473,7289,7,54850,3047,2,2,11,8,92910,36720,7480,49570,1
100,3088,773,419,590,28,0,166,801,10,204,113,217,214,330,1598,2554,5,13587,754,0,2,106,91,92910,36720,7481,49571,1
51,3863,996,429,845,24,10,117,1020,7,76,50,88,83,138,494,879,4,3565,198,0,2,53,150,92910,36722,7481,49572,0
51,3873,996,429,845,24,10,117,1020,7,76,50,88,83,138,494,879,4,3565,198,0,2,2,1,92910,36724,7481,49573,0
186,5483,182,127,129,0,0,53,182,5,39,21,42,44,63,217,343,2,926,51,0,2,153,91,92910,36724,7482,49574,0
186,5483,1165,710,800,67,119,181,1232,18,243,153,282,261,435,2000,3492,10,36473,2026,1,2,153,91,92920,36724,7483,49575,0
59,1754,773,419,590,28,0,166,801,10,204,113,217,214,330,1598,2554,5,13587,754,0,2,5,1,92920,36724,7484,49576,0
59,1754,421,273,302,44,34,57,465,17,81,59,107,98,166,583,1098,11,12329,684,0,2,5,1,92920,36724,7485,49577,0
191,5619,1660,832,1314,41,38,274,1701,20,312,209,395,332,604,2671,5058,12,64042,3557,1,2,3,2,92920,36726,7486,49579,0
191,5619,1057,646,719,113,100,145,1170,18,215,134,248,233,382,1740,3004,10,31186,1732,1,2,3,2,92930,36727,7487,49580,0
53,1495,207,111,150,11,0,50,218,5,26,19,36,31,55,133,272,3,943,52,0,2,34,35,92930,36727,7487,49581,0
53,1495,410,198,237,31,55,97,441,11,63,38,72,74,110,414,683,6,4293,238,0,2,34,35,92940,36728,7488,49582,0
262,6261,4293,999,3693,19,54,507,4312,9,155,88,170,164,258,1156,1898,4,9368,520,0,2,8,2,92940,36730,7488,49583,0
262,6261,1482,859,1002,125,135,219,1607,16,219,134,251,235,385,1766,3032,9,27804,1544,1,2,8,2,92950,36731,7488,49584,0
304,6734,72,33,56,0,4,12,72,1,1,1,1,2,2,0,2,0,1,0,0,2,15,2,92950,36731,7488,49585,0
304,6734,1454,835,1044,76,110,219,1530,17,275,158,296,292,454,2297,3718,9,34017,1889,1,2,15,2,92960,36732,7488,49586,0
80,1970,757,253,292,73,244,162,830,13,61,38,67,74,105,409,651,7,4654,258,0,2,1,1,92960,36733,7488,49587,0
20,989,386,256,301,16,9,68,402,4,59,35,69,63,104,355,621,2,1453,80,0,2,3,3,92960,36733,7488,49588,0
20,989,264,131,164,11,41,46,275,6,38,22,40,44,62,214,338,3,1068,59,0,2,3,3,92970,36733,7489,49589,0
31,1010,182,127,129,0,0,53,182,5,39,21,42,44,63,217,343,2,926,51,0,2,29,28,92970,36733,7490,49590,0
143,6943,1392,870,1177,35,17,170,1427,14,494,280,531,508,811,4473,7289,7,54850,3047,2,2,22,66,92970,36736,7491,49591,0
100,3088,773,419,590,28,0,166,801,10,204,113,217,214,330,1598,2554,5,13587,754,0,2,107,92,92970,36736,7492,49592,0
117,4986,1513,682,1277,25,13,200,1538,11,199,116,219,210,335,1557,2584,6,15641,868,0,2,0,2,92970,36738,7492,49593,0
51,3873,996,429,845,24,10,117,1020,7,76,50,88,83,138,494,879,4,3565,198,0,2,58,154,92970,36740,7492,49594,0
305,6748,72,33,56,0,4,12,72,1,1,1,1,2,2,0,2,0,1,0,0,2,6,0,92970,36740,7492,49595,0
305,6748,1454,835,1044,76,110,219,1530,17,275,158,296,292,454,2297,3718,9,34017,1889,1,2,6,0,92980,36741,7492,49596,0
147,5913,1782,648,1425,9,47,279,1791,8,171,97,189,179,286,1292,2140,4,9462,525,0,2,13,0,92980,36742,7493,49597,0
87,5042,1296,573,1062,40,33,157,1336,8,201,118,231,209,349,1561,2689,4,12365,686,0,2,21,0,92980,36742,7493,49598,0
5,119,110,30,77,3,13,16,113,4,21,15,30,25,45,100,208,2,597,33,0,2,2,1,92980,36742,7493,49599,0
5,119,28,15,21,1,0,6,29,0,0,0,0,0,0,0,0,0,0,0,0,2,2,1,92980,36742,7493,49600,0
305,6741,72,33,56,0,4,12,72,1,1,1,1,2,2,0,2,0,1,0,0,2,0,1,92980,36742,7493,49601,0
305,6741,1454,835,1044,76,110,219,1530,17,275,158,296,292,454,2297,3718,9,34017,1889,1,2,0,1,92990,36743,7493,49602,0
306,6756,72,33,56,0,4,12,72,1,1,1,1,2,2,0,2,0,1,0,0,2,8,5,92990,36743,7493,49603,0
306,6756,1454,835,1044,76,110,219,1530,17,275,158,296,292,454,2297,3718,9,34017,1889,1,2,8,5,93000,36744,7493,49604,0
87,5061,1296,573,1062,40,33,157,1336,8,201,118,231,209,349,1561,2689,4,12365,686,0,2,9,2,93000,36744,7493,49605,0
306,6756,72,33,56,0,4,12,72,1,1,1,1,2,2,0,2,0,1,0,0,2,8,5,93000,36744,7493,49606,0
306,6756,1454,835,1044,76,110,219,1530,17,275,158,296,292,454,2297,3718,9,34017,1889,1,2,8,5,93010,36745,7493,49607,0
306,6749,72,33,56,0,4,12,72,1,1,1,1,2,2,0,2,0,1,0,0,2,0,1,93010,36745,7493,49608,0
306,6749,1454,835,1044,76,110,219,1530,17,275,158,296,292,454,2297,3718,9,34017,1889,1,2,0,1,93020,36746,7493,49609,0
305,6740,72,33,56,0,4,12,72,1,1,1,1,2,2,0,2,0,1,0,0,2,10,6,93020,36746,7493,49610,0
305,6740,1454,835,1044,76,110,219,1530,17,275,158,296,292,454,2297,3718,9,34017,1889,1,2,10,6,93030,36747,7493,49611,0
147,5922,1782,648,1425,9,47,279,1791,8,171,97,189,179,286,1292,2140,4,9462,525,0,2,2,2,93030,36748,7494,49612,0
305,6740,72,33,56,0,4,12,72,1,1,1,1,2,2,0,2,0,1,0,0,2,10,6,93030,36748,7494,49613,0
305,6740,1454,835,1044,76,110,219,1530,17,275,158,296,292,454,2297,3718,9,34017,1889,1,2,10,6,93040,36749,7494,49614,0
147,5922,1782,648,1425,9,47,279,1791,8,171,97,189,179,286,1292,2140,4,9462,525,0,2,2,2,93040,36750,7495,49615,0
239,5077,2,2,2,0,0,0,2,0,0,0,0,0,0,0,0,0,0,0,0,2,0,1,93040,36750,7495,49615,0
239,5077,99,48,90,1,3,5,100,0,0,0,0,0,0,0,0,0,0,0,0,2,0,1,93040,36751,7495,49616,0
239,5077,8,5,5,2,0,1,10,0,0,0,0,0,0,0,0,0,0,0,0,2,0,1,93040,36751,7495,49617,0
239,5077,1217,716,841,84,126,174,1301,14,185,118,215,199,333,1446,2542,8,20687,1149,0,2,0,1,93050,36753,7495,49618,0
239,5077,160,89,115,0,13,31,160,7,15,11,17,22,28,78,124,3,495,27,0,2,0,1,93050,36753,7495,49619,0
239,5077,10,10,9,9,0,0,19,0,0,0,0,0,0,0,0,0,0,0,0,2,0,1,93050,36753,7496,49620,0
239,5077,173,84,99,8,29,36,181,5,12,7,13,17,20,54,81,2,221,12,0,2,0,1,93050,36754,7496,49621,0
239,5077,3,1,1,3,0,0,6,0,0,0,0,0,0,0,0,0,0,0,0,2,0,1,93050,36754,7496,49622,0
7,265,75,38,59,1,3,12,76,2,4,2,4,6,6,10,15,1,15,0,0,2,1,1,93050,36754,7496,49624,0
191,5605,1660,832,1314,41,38,274,1701,20,312,209,395,332,604,2671,5058,12,64042,3557,1,2,2,2,93050,36756,7497,49626,0
191,5605,1057,646,719,113,100,145,1170,18,215,134,248,233,382,1740,3004,10,31186,1732,1,2,2,2,93060,36757,7498,49627,0
5,119,110,30,77,3,13,16,113,4,21,15,30,25,45,100,208,2,597,33,0,2,2,1,93060,36757,7498,49628,0
5,119,28,15,21,1,0,6,29,0,0,0,0,0,0,0,0,0,0,0,0,2,2,1,93060,36757,7498,49629,0
304,6689,72,33,56,0,4,12,72,1,1,1,1,2,2,0,2,0,1,0,0,2,1,2,93060,36757,7498,49630,0
304,6689,1454,835,1044,76,110,219,1530,17,275,158,296,292,454,2297,3718,9,34017,1889,1,2,1,2,93070,36758,7498,49631,0
87,5061,1296,573,1062,40,33,157,1336,8,201,118,231,209,349,1561,2689,4,12365,686,0,2,9,2,93070,36758,7498,49632,0
107,4605,1289,550,1043,56,32,155,1345,10,167,93,185,177,278,1266,2075,5,11498,638,0,2,0,1,93070,36760,7499,49633,0
191,5605,1660,832,1314,41,38,274,1701,20,312,209,395,332,604,2671,5058,12,64042,3557,1,2,2,2,93070,36762,7500,49635,0
191,5605,1057,646,719,113,100,145,1170,18,215,134,248,233,382,1740,3004,10,31186,1732,1,2,2,2,93080,36763,7501,49636,0
304,6726,72,33,56,0,4,12,72,1,1,1,1,2,2,0,2,0,1,0,0,2,0,4,93080,36763,7501,49637,0
304,6726,1454,835,1044,76,110,219,1530,17,275,158,296,292,454,2297,3718,9,34017,1889,1,2,0,4,93090,36764,7501,49638,0
107,4605,1289,550,1043,56,32,155,1345,10,167,93,185,177,278,1266,2075,5,11498,638,0,2,0,1,93090,36766,7502,49639,0
304,6726,72,33,56,0,4,12,72,1,1,1,1,2,2,0,2,0,1,0,0,2,0,4,93090,36766,7502,49640,0
304,6726,1454,835,1044,76,110,219,1530,17,275,158,296,292,454,2297,3718,9,34017,1889,1,2,0,4,93100,36767,7502,49641,0
69,1500,402,202,227,24,74,80,426,12,52,33,61,64,94,339,564,7,3969,220,0,2,12,7,93100,36768,7502,49642,0
302,6686,72,33,56,0,4,12,72,1,1,1,1,2,2,0,2,0,1,0,0,2,0,10,93100,36768,7502,49643,0
302,6686,1454,835,1044,76,110,219,1530,17,275,158,296,292,454,2297,3718,9,34017,1889,1,2,0,10,93110,36769,7502,49644,0
147,5907,1782,648,1425,9,47,279,1791,8,171,97,189,179,286,1292,2140,4,9462,525,0,2,12,8,93110,36770,7503,49645,0
304,6716,72,33,56,0,4,12,72,1,1,1,1,2,2,0,2,0,1,0,0,2,1,2,93110,36770,7503,49646,0
304,6716,1454,835,1044,76,110,219,1530,17,275,158,296,292,454,2297,3718,9,34017,1889,1,2,1,2,93120,36771,7503,49647,0
5,119,110,30,77,3,13,16,113,4,21,15,30,25,45,100,208,2,597,33,0,2,2,1,93120,36771,7503,49648,0
5,119,28,15,21,1,0,6,29,0,0,0,0,0,0,0,0,0,0,0,0,2,2,1,93120,36771,7503,49649,0
106,4666,1289,550,1043,56,32,155,1345,10,167,93,185,177,278,1266,2075,5,11498,638,0,2,0,1,93120,36773,7504,49650,0
87,5062,1296,573,1062,40,33,157,1336,8,201,118,231,209,349,1561,2689,4,12365,686,0,2,9,2,93120,36773,7504,49651,0
12,190,110,30,77,3,13,16,113,4,21,15,30,25,45,100,208,2,597,33,0,2,91,0,93120,36773,7504,49652,0
189,5498,1660,832,1314,41,38,274,1701,20,312,209,395,332,604,2671,5058,12,64042,3557,1,2,0,31,93120,36775,7505,49654,0
189,5498,1057,646,719,113,100,145,1170,18,215,134,248,233,382,1740,3004,10,31186,1732,1,2,0,31,93130,36776,7506,49655,0
45,1597,601,196,481,2,23,85,603,8,63,36,72,71,108,400,664,4,3036,168,0,2,1,43,93130,36776,7506,49656,0
69,1500,402,202,227,24,74,80,426,12,52,33,61,64,94,339,564,7,3969,220,0,2,12,7,93130,36777,7506,49657,0
301,6672,72,33,56,0,4,12,72,1,1,1,1,2,2,0,2,0,1,0,0,2,0,10,93130,36777,7506,49658,0
301,6672,1454,835,1044,76,110,219,1530,17,275,158,296,292,454,2297,3718,9,34017,1889,1,2,0,10,93140,36778,7506,49659,0
147,5907,1782,648,1425,9,47,279,1791,8,171,97,189,179,286,1292,2140,4,9462,525,0,2,12,8,93140,36779,7507,49660,0
301,6662,72,33,56,0,4,12,72,1,1,1,1,2,2,0,2,0,1,0,0,2,1,2,93140,36779,7507,49661,0
301,6662,1454,835,1044,76,110,219,1530,17,275,158,296,292,454,2297,3718,9,34017,1889,1,2,1,2,93150,36780,7507,49662,0
5,119,110,30,77,3,13,16,113,4,21,15,30,25,45,100,208,2,597,33,0,2,2,1,93150,36780,7507,49663,0
5,119,28,15,21,1,0,6,29,0,0,0,0,0,0,0,0,0,0,0,0,2,2,1,93150,36780,7507,49664,0
106,4666,1289,550,1043,56,32,155,1345,10,167,93,185,177,278,1266,2075,5,11498,638,0,2,0,1,93150,36782,7508,49665,0
87,5062,1296,573,1062,40,33,157,1336,8,201,118,231,209,349,1561,2689,4,12365,686,0,2,9,2,93150,36782,7508,49666,0
12,190,110,30,77,3,13,16,113,4,21,15,30,25,45,100,208,2,597,33,0,2,91,0,93150,36782,7508,49667,0
1,93,42,7,35,4,0,5,46,1,2,1,2,3,3,2,4,0,2,0,0,2,1,1,93150,36782,7508,49668,0
1,93,11,6,10,0,0,1,11,2,4,2,4,6,6,10,15,1,15,0,0,2,1,1,93150,36782,7508,49669,0
186,5483,182,127,129,0,0,53,182,5,39,21,42,44,63,217,343,2,926,51,0,2,177,110,93150,36782,7509,49670,0
186,5483,1165,710,800,67,119,181,1232,18,243,153,282,261,435,2000,3492,10,36473,2026,1,2,177,110,93160,36782,7510,49671,0
59,1754,773,419,590,28,0,166,801,10,204,113,217,214,330,1598,2554,5,13587,754,0,2,54,23,93160,36782,7511,49672,0
59,1754,421,273,302,44,34,57,465,17,81,59,107,98,166,583,1098,11,12329,684,0,2,54,23,93160,36782,7512,49673,0
18,382,149,95,105,2,0,41,151,8,54,28,55,62,83,334,494,4,2013,111,0,2,30,15,93160,36782,7512,49674,0
18,382,82,56,54,0,13,15,82,4,13,8,16,17,24,56,98,2,241,13,0,2,30,15,93170,36782,7512,49675,0
28,596,2,2,2,0,0,0,2,0,0,0,0,0,0,0,0,0,0,0,0,2,2,2,93170,36782,7512,49675,0
28,596,99,48,90,1,3,5,100,0,0,0,0,0,0,0,0,0,0,0,0,2,2,2,93170,36783,7512,49676,0
28,596,8,5,5,2,0,1,10,0,0,0,0,0,0,0,0,0,0,0,0,2,2,2,93170,36783,7512,49677,0
28,596,1217,716,841,84,126,174,1301,14,185,118,215,199,333,1446,2542,8,20687,1149,0,2,2,2,93180,36785,7512,49678,0
28,596,160,89,115,0,13,31,160,7,15,11,17,22,28,78,124,3,495,27,0,2,2,2,93180,36785,7512,49679,0
28,596,10,10,9,9,0,0,19,0,0,0,0,0,0,0,0,0,0,0,0,2,2,2,93180,36785,7513,49680,0
28,596,173,84,99,8,29,36,181,5,12,7,13,17,20,54,81,2,221,12,0,2,2,2,93180,36786,7513,49681,0
28,596,3,1,1,3,0,0,6,0,0,0,0,0,0,0,0,0,0,0,0,2,2,2,93180,36786,7513,49682,0
191,5605,1660,832,1314,41,38,274,1701,20,312,209,395,332,604,2671,5058,12,64042,3557,1,2,93,47,93180,36788,7514,49684,0
191,5605,1057,646,719,113,100,145,1170,18,215,134,248,233,382,1740,3004,10,31186,1732,1,2,93,47,93190,36789,7515,49685,0
77,2606,477,336,357,30,23,73,507,16,194,134,250,210,384,1538,2962,10,30538,1696,0,2,101,45,93200,36790,7515,49686,0
85,2063,996,429,845,24,10,117,1020,7,76,50,88,83,138,494,879,4,3565,198,0,2,11,4,93200,36792,7515,49687,0
85,2063,456,277,329,12,42,72,468,13,85,50,97,98,147,592,972,7,7212,400,0,2,11,4,93200,36792,7515,49688,0
161,3438,1513,682,1277,25,13,200,1538,11,199,116,219,210,335,1557,2584,6,15641,868,0,2,8,13,93200,36794,7515,49689,0
161,3438,819,519,539,24,98,155,843,15,96,57,106,111,163,690,1107,8,9171,509,0,2,8,13,93210,36796,7515,49690,0
53,1495,207,111,150,11,0,50,218,5,26,19,36,31,55,133,272,3,943,52,0,2,88,34,93210,36796,7515,49691,0
53,1495,410,198,237,31,55,97,441,11,63,38,72,74,110,414,683,6,4293,238,0,2,88,34,93220,36797,7516,49692,0
239,5077,2,2,2,0,0,0,2,0,0,0,0,0,0,0,0,0,0,0,0,2,22,14,93220,36797,7516,49692,0
239,5077,99,48,90,1,3,5,100,0,0,0,0,0,0,0,0,0,0,0,0,2,22,14,93220,36798,7516,49693,0
239,5077,8,5,5,2,0,1,10,0,0,0,0,0,0,0,0,0,0,0,0,2,22,14,93220,36798,7516,49694,0
239,5077,1217,716,841,84,126,174,1301,14,185,118,215,199,333,1446,2542,8,20687,1149,0,2,22,14,93230,36800,7516,49695,0
239,5077,160,89,115,0,13,31,160,7,15,11,17,22,28,78,124,3,495,27,0,2,22,14,93230,36800,7516,49696,0
239,5077,10,10,9,9,0,0,19,0,0,0,0,0,0,0,0,0,0,0,0,2,22,14,93230,36800,7517,49697,0
239,5077,173,84,99,8,29,36,181,5,12,7,13,17,20,54,81,2,221,12,0,2,22,14,93230,36801,7517,49698,0
239,5077,3,1,1,3,0,0,6,0,0,0,0,0,0,0,0,0,0,0,0,2,22,14,93230,36801,7517,49699,0
113,2328,463,295,324,28,62,57,491,12,134,82,154,146,236,989,1696,6,11700,650,0,2,2,2,93240,36802,7517,49700,0
57,1477,339,213,244,17,9,65,356,10,42,26,48,52,74,259,421,5,2410,133,0,2,8,2,93250,36802,7517,49701,0
103,2729,1455,414,1257,16,76,112,1471,5,41,23,46,46,69,231,381,2,1069,59,0,2,75,37,93250,36803,7517,49703,0
103,2729,669,365,481,22,61,110,691,15,103,63,122,118,185,747,1273,8,11311,628,0,2,75,37,93260,36803,7518,49704,0
262,6261,4293,999,3693,19,54,507,4312,9,155,88,170,164,258,1156,1898,4,9368,520,0,2,18,6,93260,36805,7518,49705,0
262,6261,1482,859,1002,125,135,219,1607,16,219,134,251,235,385,1766,3032,9,27804,1544,1,2,18,6,93270,36806,7518,49706,0
31,1070,74,35,59,1,0,14,75,3,14,7,14,17,21,58,85,1,128,7,0,2,3,2,93270,36807,7518,49707,0
31,1070,245,125,200,5,7,34,250,7,30,17,34,37,51,166,265,3,1053,58,0,2,3,2,93280,36808,7518,49708,0
54,642,647,139,84,35,284,233,682,0,0,0,0,0,0,0,0,0,0,0,0,2,10,25,93280,36808,7518,49709,0
118,3197,1523,757,1297,19,12,193,1542,12,193,117,230,205,347,1508,2664,7,19053,1058,0,2,8,4,93290,36810,7518,49710,0
118,3197,701,378,504,33,58,109,734,13,110,68,126,123,194,794,1346,7,10027,557,0,2,8,4,93290,36811,7519,49711,0
117,2969,773,422,505,30,103,129,803,14,77,46,83,91,129,535,839,7,6334,351,0,2,103,23,93300,36812,7520,49712,0
143,3505,77,34,69,0,0,8,77,3,24,16,29,27,45,114,213,1,387,21,0,2,19,11,93300,36812,7520,49713,0
143,3505,712,438,573,51,9,84,763,14,102,71,128,116,199,733,1364,8,11988,666,0,2,19,11,93310,36813,7520,49714,0
24,608,2,2,2,0,0,0,2,0,0,0,0,0,0,0,0,0,0,0,0,2,2,4,93310,36813,7520,49714,0
24,608,99,48,90,1,3,5,100,0,0,0,0,0,0,0,0,0,0,0,0,2,2,4,93310,36814,7520,49715,0
24,608,8,5,5,2,0,1,10,0,0,0,0,0,0,0,0,0,0,0,0,2,2,4,93310,36814,7520,49716,0
24,608,1217,716,841,84,126,174,1301,14,185,118,215,199,333,1446,2542,8,20687,1149,0,2,2,4,93320,36816,7520,49717,0
24,608,160,89,115,0,13,31,160,7,15,11,17,22,28,78,124,3,495,27,0,2,2,4,93320,36816,7520,49718,0
24,608,10,10,9,9,0,0,19,0,0,0,0,0,0,0,0,0,0,0,0,2,2,4,93320,36816,7521,49719,0
24,608,173,84,99,8,29,36,181,5,12,7,13,17,20,54,81,2,221,12,0,2,2,4,93320,36817,7521,49720,0
24,608,3,1,1,3,0,0,6,0,0,0,0,0,0,0,0,0,0,0,0,2,2,4,93320,36817,7521,49721,0
69,1500,402,202,227,24,74,80,426,12,52,33,61,64,94,339,564,7,3969,220,0,2,26,24,93320,36818,7521,49722,0
55,1873,53,23,39,0,0,13,53,2,8,4,8,10,12,26,39,1,39,2,0,2,54,29,93320,36818,7521,49723,0
55,1873,515,298,307,33,80,99,548,12,63,44,77,75,121,419,753,7,5527,307,0,2,54,29,93330,36818,7521,49724,0
61,1561,91,45,69,0,3,18,91,3,9,6,10,12,16,33,57,1,95,5,0,2,44,28,93330,36820,7521,49725,0
61,1561,367,234,237,17,34,68,384,16,55,34,61,71,95,381,584,8,5183,287,0,2,44,28,93330,36821,7521,49726,0
227,6346,722,423,573,19,0,135,741,12,172,101,199,184,300,1320,2257,6,15668,870,0,2,182,77,93330,36823,7521,49728,0
227,6346,1508,847,911,44,250,301,1552,14,148,88,169,162,257,1120,1886,7,15077,837,0,2,182,77,93330,36824,7522,49729,0
301,6662,72,33,56,0,4,12,72,1,1,1,1,2,2,0,2,0,1,0,0,2,29,22,93330,36824,7522,49730,0
301,6662,1454,835,1044,76,110,219,1530,17,275,158,296,292,454,2297,3718,9,34017,1889,1,2,29,22,93340,36825,7522,49731,0
80,1970,757,253,292,73,244,162,830,13,61,38,67,74,105,409,651,7,4654,258,0,2,7,9,93340,36826,7522,49732,0
20,989,386,256,301,16,9,68,402,4,59,35,69,63,104,355,621,2,1453,80,0,2,5,8,93340,36826,7522,49733,0
20,989,264,131,164,11,41,46,275,6,38,22,40,44,62,214,338,3,1068,59,0,2,5,8,93350,36826,7523,49734,0
78,1993,466,257,367,18,25,50,484,7,126,86,171,133,257,898,1813,4,8612,478,0,2,24,14,93350,36826,7523,49735,0
78,1993,507,281,342,29,59,88,536,10,53,29,57,63,86,336,514,5,2764,153,0,2,24,14,93350,36826,7523,49736,0
87,1930,1043,504,840,53,9,147,1096,9,180,112,198,189,310,1377,2344,4,11604,644,0,2,6,13,93350,36828,7523,49737,0
87,1930,383,288,292,26,6,62,409,11,65,38,67,76,105,429,656,5,3719,206,0,2,6,13,93350,36829,7523,49738,0
20,378,294,64,250,0,0,43,294,1,20,10,20,21,30,86,131,0,65,3,0,2,1,2,93350,36829,7523,49739,0
20,378,78,46,62,3,0,14,81,3,8,4,8,11,12,28,41,1,62,3,0,2,1,2,93350,36830,7523,49740,0
40,786,1178,367,1042,6,15,115,1184,9,94,51,95,103,146,644,976,4,4439,246,0,2,2,2,93350,36830,7523,49741,0
40,786,177,108,140,8,0,27,185,6,30,16,32,36,48,162,248,3,794,44,0,2,2,2,93350,36832,7523,49742,0
298,6416,1943,715,1694,26,18,214,1969,12,185,120,237,197,357,1436,2721,7,20915,1161,0,2,164,69,93350,36834,7523,49743,0
298,6416,1168,838,957,57,25,144,1225,19,348,224,416,367,640,3018,5452,11,61921,3440,1,2,164,69,93360,36836,7523,49744,0
18,704,442,244,305,14,16,103,456,11,68,45,75,79,120,452,756,6,4588,254,0,2,20,15,93360,36838,7523,49745,0
18,704,182,102,99,11,40,35,193,3,11,6,11,14,17,42,64,1,97,5,0,2,20,15,93360,36839,7523,49746,0
2,222,37,13,25,0,6,6,37,1,2,1,2,3,3,2,4,0,2,0,0,2,16,5,93360,36839,7523,49747,0
2,222,133,47,40,1,43,49,134,0,0,0,0,0,0,0,0,0,0,0,0,2,16,5,93360,36839,7523,49748,0
23,625,601,196,481,2,23,85,603,8,63,36,72,71,108,400,664,4,3036,168,0,2,6,2,93360,36839,7523,49749,0
23,625,156,79,106,5,16,28,161,5,14,8,15,19,23,64,97,2,261,14,0,2,6,2,93360,36839,7523,49750,0
106,4666,1289,550,1043,56,32,155,1345,10,167,93,185,177,278,1266,2075,5,11498,638,0,2,65,17,93360,36841,7524,49751,0
31,1010,182,127,129,0,0,53,182,5,39,21,42,44,63,217,343,2,926,51,0,2,29,28,93360,36841,7525,49752,0
143,6943,1392,870,1177,35,17,170,1427,14,494,280,531,508,811,4473,7289,7,54850,3047,2,2,45,75,93360,36844,7526,49753,0
100,3088,773,419,590,28,0,166,801,10,204,113,217,214,330,1598,2554,5,13587,754,0,2,126,106,93360,36844,7527,49754,0
17,400,127,75,83,2,11,30,129,4,14,7,14,18,21,61,87,2,175,9,0,2,4,1,93360,36844,7527,49755,0
17,400,652,304,544,16,6,88,668,6,89,51,101,95,152,591,998,3,3399,188,0,2,4,1,93360,36845,7527,49756,0
17,400,2,2,2,0,0,0,2,0,0,0,0,0,0,0,0,0,0,0,0,2,4,1,93360,36845,7527,49756,0
17,400,8,5,5,0,0,3,8,0,0,0,0,0,0,0,0,0,0,0,0,2,4,1,93360,36845,7527,49757,0
17,400,2,2,2,0,0,0,2,0,0,0,0,0,0,0,0,0,0,0,0,2,4,1,93360,36845,7527,49757,0
17,400,14,8,8,0,0,6,14,0,0,0,0,0,0,0,0,0,0,0,0,2,4,1,93360,36845,7527,49758,0
17,400,6,4,4,0,0,2,6,0,0,0,0,0,0,0,0,0,0,0,0,2,4,1,93360,36845,7527,49759,0
17,400,6,4,4,0,0,2,6,1,2,1,2,3,3,2,4,0,2,0,0,2,4,1,93360,36845,7527,49760,0
17,400,6,4,4,0,0,2,6,0,0,0,0,0,0,0,0,0,0,0,0,2,4,1,93360,36845,7527,49761,0
17,400,7,5,5,0,0,2,7,0,0,0,0,0,0,0,0,0,0,0,0,2,4,1,93360,36845,7527,49762,0
17,400,6,4,4,0,0,2,6,0,0,0,0,0,0,0,0,0,0,0,0,2,4,1,93360,36845,7527,49763,0
17,400,10,6,6,0,0,4,10,0,0,0,0,0,0,0,0,0,0,0,0,2,4,1,93360,36845,7527,49764,0
17,400,1,1,1,0,0,0,1,0,0,0,0,0,0,0,0,0,0,0,0,2,4,1,93360,36845,7527,49764,0
17,400,14,10,10,0,0,4,14,1,1,1,1,2,2,0,2,0,1,0,0,2,4,1,93360,36845,7527,49765,0
17,400,46,26,30,3,0,12,49,3,6,3,6,9,9,20,28,1,42,2,0,2,4,1,93370,36845,7527,49766,0
7,265,75,38,59,1,3,12,76,2,4,2,4,6,6,10,15,1,15,0,0,2,30,1,93370,36845,7527,49767,0
24,694,149,95,105,2,0,41,151,8,54,28,55,62,83,334,494,4,2013,111,0,2,76,3,93370,36845,7527,49768,0
15,696,139,89,101,2,0,35,141,7,54,34,62,61,96,330,569,4,2287,127,0,2,1,1,93370,36845,7527,49769,0
3,501,149,67,118,4,0,27,153,1,17,14,28,18,42,69,175,0,144,8,0,2,66,2,93370,36845,7527,49770,0
42,2589,1157,318,931,29,22,177,1186,6,104,63,125,110,188,712,1274,3,4596,255,0,2,8,8,93370,36845,7527,49771,0
69,4372,520,294,400,33,13,81,553,10,261,204,367,271,571,2128,4614,7,32445,1802,1,2,61,48,93370,36846,7527,49772,0
89,3928,1338,495,1086,10,64,173,1348,11,122,82,157,133,239,883,1686,7,11934,663,0,2,2,2,93370,36848,7527,49773,0
185,8005,4293,999,3693,19,54,507,4312,9,155,88,170,164,258,1156,1898,4,9368,520,0,2,7,7,93370,36850,7527,49774,0
185,8005,1482,859,1002,125,135,219,1607,16,219,134,251,235,385,1766,3032,9,27804,1544,1,2,7,7,93380,36851,7527,49775,0
147,5907,1782,648,1425,9,47,279,1791,8,171,97,189,179,286,1292,2140,4,9462,525,0,2,14,31,93380,36852,7528,49776,0
30,921,256,139,192,9,7,47,265,4,23,12,24,27,36,112,171,2,357,19,0,2,1,1,93380,36853,7528,49777,0
6,322,180,34,164,0,0,16,180,1,12,6,12,13,18,43,66,0,33,1,0,2,2,2,93380,36853,7528,49778,0
127,5424,1450,624,1228,12,26,181,1462,14,306,186,354,320,540,2580,4493,8,36391,2021,1,2,131,17,93380,36855,7529,49779,0
191,6342,1660,832,1314,41,38,274,1701,20,312,209,395,332,604,2671,5058,12,64042,3557,1,2,115,37,93380,36857,7530,49781,0
51,3873,996,429,845,24,10,117,1020,7,76,50,88,83,138,494,879,4,3565,198,0,2,84,165,93380,36859,7530,49782,0
117,4986,1513,682,1277,25,13,200,1538,11,199,116,219,210,335,1557,2584,6,15641,868,0,2,17,36,93380,36861,7530,49783,0
87,5062,1296,573,1062,40,33,157,1336,8,201,118,231,209,349,1561,2689,4,12365,686,0,2,24,19,93380,36861,7530,49784,0
25,591,207,111,150,11,0,50,218,5,26,19,36,31,55,133,272,3,943,52,0,2,21,0,93380,36861,7530,49785,0
111,6058,1457,730,1242,11,6,188,1468,10,292,166,329,302,495,2424,4078,5,22973,1276,1,2,9,4,93380,36863,7530,49786,0
46,2850,652,304,544,16,6,88,668,6,89,51,101,95,152,591,998,3,3399,188,0,2,3,3,93380,36864,7530,49787,0
81,3715,1455,414,1257,16,76,112,1471,5,41,23,46,46,69,231,381,2,1069,59,0,2,9,8,93380,36865,7530,49788,0
8,310,103,47,73,2,12,15,105,5,16,9,17,21,26,75,114,2,303,16,0,2,2,2,93380,36866,7530,49789,0
113,5659,1523,757,1297,19,12,193,1542,12,193,117,230,205,347,1508,2664,7,19053,1058,0,2,18,15,93390,36868,7530,49790,0
71,3199,1020,354,843,12,15,144,1032,8,134,77,144,142,221,970,1580,4,6792,377,0,2,23,2,93390,36868,7530,49791,0
3,96,35,12,22,4,5,6,39,1,2,1,2,3,3,2,4,0,2,0,0,2,1,0,93390,36868,7530,49792,0
79,4230,1293,570,1093,25,15,163,1318,10,195,123,241,205,364,1516,2795,6,17273,959,0,2,29,7,93400,36870,7530,49793,0
30,1924,384,251,317,7,8,52,391,11,70,44,84,81,128,467,811,6,5355,297,0,2,30,0,93400,36870,7530,49794,0
62,3231,722,423,573,19,0,135,741,12,172,101,199,184,300,1320,2257,6,15668,870,0,2,115,11,93400,36872,7530,49796,0
31,1843,466,257,367,18,25,50,484,7,126,86,171,133,257,898,1813,4,8612,478,0,2,3,3,93400,36872,7530,49797,0
88,3442,1043,504,840,53,9,147,1096,9,180,112,198,189,310,1377,2344,4,11604,644,0,2,19,11,93400,36874,7530,49798,0
12,463,295,56,236,0,4,54,295,2,9,5,10,11,15,30,51,1,57,3,0,2,2,2,93400,36876,7530,49799,0
30,1422,373,158,315,8,0,51,381,5,76,44,79,81,123,486,779,2,2026,112,0,2,9,9,93400,36876,7530,49800,0
12,572,294,64,250,0,0,43,294,1,20,10,20,21,30,86,131,0,65,3,0,3,1,1,93400,36876,7530,49801,0
79,3073,1178,367,1042,6,15,115,1184,9,94,51,95,103,146,644,976,4,4439,246,0,2,20,6,93400,36876,7530,49803,0
12,645,219,78,157,11,5,46,230,3,24,20,34,27,54,114,256,2,545,30,0,2,1,1,93400,36877,7530,49804,0
114,6852,1943,715,1694,26,18,214,1969,12,185,120,237,197,357,1436,2721,7,20915,1161,0,2,206,53,93400,36879,7530,49805,0
40,1861,442,244,305,14,16,103,456,11,68,45,75,79,120,452,756,6,4588,254,0,2,12,2,93400,36881,7530,49806,0
51,2042,1098,241,925,5,10,155,1103,7,46,25,49,53,74,273,423,3,1580,87,0,2,25,13,93410,36883,7530,49807,0
49,1715,601,196,481,2,23,85,603,8,63,36,72,71,108,400,664,4,3036,168,0,2,7,6,93410,36883,7530,49808,0
227,6367,722,423,573,19,0,135,741,12,172,101,199,184,300,1320,2257,6,15668,870,0,2,21,17,93410,36885,7530,49810,1
227,6367,1508,847,911,44,250,301,1552,14,148,88,169,162,257,1120,1886,7,15077,837,0,2,21,17,93410,36886,7531,49811,1
63,3295,722,423,573,19,0,135,741,12,172,101,199,184,300,1320,2257,6,15668,870,0,2,9,1,93410,36888,7531,49813,1
227,6367,722,423,573,19,0,135,741,12,172,101,199,184,300,1320,2257,6,15668,870,0,2,21,17,93410,36890,7531,49815,0
227,6367,1508,847,911,44,250,301,1552,14,148,88,169,162,257,1120,1886,7,15077,837,0,2,21,17,93410,36891,7532,49816,0
63,3295,722,423,573,19,0,135,741,12,172,101,199,184,300,1320,2257,6,15668,870,0,2,9,1,93410,36893,7532,49818,0
1,303,382,65,130,157,2,92,539,4,10,5,10,14,15,41,57,2,114,6,0,2,1,1,93410,36894,7533,49819,0
227,6370,722,423,573,19,0,135,741,12,172,101,199,184,300,1320,2257,6,15668,870,0,2,1,0,93410,36896,7533,49821,0
227,6370,1508,847,911,44,250,301,1552,14,148,88,169,162,257,1120,1886,7,15077,837,0,2,1,0,93410,36897,7534,49822,0
227,6370,722,423,573,19,0,135,741,12,172,101,199,184,300,1320,2257,6,15668,870,0,2,1,0,93410,36899,7534,49824,0
227,6370,1508,847,911,44,250,301,1552,14,148,88,169,162,257,1120,1886,7,15077,837,0,2,1,0,93410,36900,7535,49825,0
1,319,382,65,130,157,2,92,539,4,10,5,10,14,15,41,57,2,114,6,0,2,13,0,93410,36901,7536,49826,0
13,539,124,78,88,2,3,26,126,4,13,7,13,17,20,56,81,2,163,9,0,2,7,0,93410,36901,7536,49827,0
88,3448,1043,504,840,53,9,147,1096,9,180,112,198,189,310,1377,2344,4,11604,644,0,2,3,3,93410,36903,7536,49828,0
88,1929,1043,504,840,53,9,147,1096,9,180,112,198,189,310,1377,2344,4,11604,644,0,2,6,1,93410,36905,7536,49829,0
88,1929,383,288,292,26,6,62,409,11,65,38,67,76,105,429,656,5,3719,206,0,2,6,1,93410,36906,7536,49830,0
88,1929,1043,504,840,53,9,147,1096,9,180,112,198,189,310,1377,2344,4,11604,644,0,2,6,1,93410,36908,7536,49831,0
88,1929,383,288,292,26,6,62,409,11,65,38,67,76,105,429,656,5,3719,206,0,2,6,1,93410,36909,7536,49832,0
88,3448,1043,504,840,53,9,147,1096,9,180,112,198,189,310,1377,2344,4,11604,644,0,2,3,3,93410,36911,7536,49833,0
1,322,382,65,130,157,2,92,539,4,10,5,10,14,15,41,57,2,114,6,0,2,1,1,93410,36912,7537,49834,0
145,3551,77,34,69,0,0,8,77,3,24,16,29,27,45,114,213,1,387,21,0,2,10,4,93410,36912,7537,49835,0
145,3551,712,438,573,51,9,84,763,14,102,71,128,116,199,733,1364,8,11988,666,0,2,10,4,93420,36913,7537,49836,0
4,216,77,34,69,0,0,8,77,3,24,16,29,27,45,114,213,1,387,21,0,0,52,0,93420,36913,7537,49837,0
298,6420,1943,715,1694,26,18,214,1969,12,185,120,237,197,357,1436,2721,7,20915,1161,0,2,1,1,93420,36915,7537,49838,0
298,6420,1168,838,957,57,25,144,1225,19,348,224,416,367,640,3018,5452,11,61921,3440,1,2,1,1,93430,36917,7537,49839,0
145,3551,77,34,69,0,0,8,77,3,24,16,29,27,45,114,213,1,387,21,0,2,10,4,93430,36917,7537,49840,0
145,3551,712,438,573,51,9,84,763,14,102,71,128,116,199,733,1364,8,11988,666,0,2,10,4,93440,36918,7537,49841,0
4,216,77,34,69,0,0,8,77,3,24,16,29,27,45,114,213,1,387,21,0,0,52,0,93440,36918,7537,49842,0
298,6420,1943,715,1694,26,18,214,1969,12,185,120,237,197,357,1436,2721,7,20915,1161,0,2,1,1,93440,36920,7537,49843,0
298,6420,1168,838,957,57,25,144,1225,19,348,224,416,367,640,3018,5452,11,61921,3440,1,2,1,1,93450,36922,7537,49844,0
105,2771,1455,414,1257,16,76,112,1471,5,41,23,46,46,69,231,381,2,1069,59,0,2,10,0,93450,36923,7537,49845,0
105,2771,669,365,481,22,61,110,691,15,103,63,122,118,185,747,1273,8,11311,628,0,2,10,0,93460,36923,7538,49846,0
83,3818,1455,414,1257,16,76,112,1471,5,41,23,46,46,69,231,381,2,1069,59,0,2,60,5,93460,36924,7538,49847,0
105,2771,1455,414,1257,16,76,112,1471,5,41,23,46,46,69,231,381,2,1069,59,0,2,10,0,93460,36925,7538,49848,0
105,2771,669,365,481,22,61,110,691,15,103,63,122,118,185,747,1273,8,11311,628,0,2,10,0,93470,36925,7539,49849,0
83,3818,1455,414,1257,16,76,112,1471,5,41,23,46,46,69,231,381,2,1069,59,0,2,60,5,93470,36926,7539,49850,0
239,5077,2,2,2,0,0,0,2,0,0,0,0,0,0,0,0,0,0,0,0,2,1,1,93470,36926,7539,49850,0
239,5077,99,48,90,1,3,5,100,0,0,0,0,0,0,0,0,0,0,0,0,2,1,1,93470,36927,7539,49851,0
239,5077,8,5,5,2,0,1,10,0,0,0,0,0,0,0,0,0,0,0,0,2,1,1,93470,36927,7539,49852,0
239,5077,1217,716,841,84,126,174,1301,14,185,118,215,199,333,1446,2542,8,20687,1149,0,2,1,1,93480,36929,7539,49853,0
239,5077,160,89,115,0,13,31,160,7,15,11,17,22,28,78,124,3,495,27,0,2,1,1,93480,36929,7539,49854,0
239,5077,10,10,9,9,0,0,19,0,0,0,0,0,0,0,0,0,0,0,0,2,1,1,93480,36929,7540,49855,0
239,5077,173,84,99,8,29,36,181,5,12,7,13,17,20,54,81,2,221,12,0,2,1,1,93480,36930,7540,49856,0
239,5077,3,1,1,3,0,0,6,0,0,0,0,0,0,0,0,0,0,0,0,2,1,1,93480,36930,7540,49857,0
118,3203,1523,757,1297,19,12,193,1542,12,193,117,230,205,347,1508,2664,7,19053,1058,0,2,1,0,93490,36932,7540,49858,0
118,3203,701,378,504,33,58,109,734,13,110,68,126,123,194,794,1346,7,10027,557,0,2,1,0,93490,36933,7541,49859,0
114,5827,1523,757,1297,19,12,193,1542,12,193,117,230,205,347,1508,2664,7,19053,1058,0,2,42,0,93500,36935,7541,49860,0
119,3209,1523,757,1297,19,12,193,1542,12,193,117,230,205,347,1508,2664,7,19053,1058,0,2,2,1,93510,36937,7541,49861,0
119,3209,701,378,504,33,58,109,734,13,110,68,126,123,194,794,1346,7,10027,557,0,2,2,1,93510,36938,7542,49862,0
239,5077,2,2,2,0,0,0,2,0,0,0,0,0,0,0,0,0,0,0,0,2,1,1,93510,36938,7542,49862,0
239,5077,99,48,90,1,3,5,100,0,0,0,0,0,0,0,0,0,0,0,0,2,1,1,93510,36939,7542,49863,0
239,5077,8,5,5,2,0,1,10,0,0,0,0,0,0,0,0,0,0,0,0,2,1,1,93510,36939,7542,49864,0
239,5077,1217,716,841,84,126,174,1301,14,185,118,215,199,333,1446,2542,8,20687,1149,0,2,1,1,93520,36941,7542,49865,0
239,5077,160,89,115,0,13,31,160,7,15,11,17,22,28,78,124,3,495,27,0,2,1,1,93520,36941,7542,49866,0
239,5077,10,10,9,9,0,0,19,0,0,0,0,0,0,0,0,0,0,0,0,2,1,1,93520,36941,7543,49867,0
239,5077,173,84,99,8,29,36,181,5,12,7,13,17,20,54,81,2,221,12,0,2,1,1,93520,36942,7543,49868,0
239,5077,3,1,1,3,0,0,6,0,0,0,0,0,0,0,0,0,0,0,0,2,1,1,93520,36942,7543,49869,0
239,5077,2,2,2,0,0,0,2,0,0,0,0,0,0,0,0,0,0,0,0,2,1,1,93520,36942,7543,49869,0
239,5077,99,48,90,1,3,5,100,0,0,0,0,0,0,0,0,0,0,0,0,2,1,1,93520,36943,7543,49870,0
239,5077,8,5,5,2,0,1,10,0,0,0,0,0,0,0,0,0,0,0,0,2,1,1,93520,36943,7543,49871,0
239,5077,1217,716,841,84,126,174,1301,14,185,118,215,199,333,1446,2542,8,20687,1149,0,2,1,1,93530,36945,7543,49872,0
239,5077,160,89,115,0,13,31,160,7,15,11,17,22,28,78,124,3,495,27,0,2,1,1,93530,36945,7543,49873,0
239,5077,10,10,9,9,0,0,19,0,0,0,0,0,0,0,0,0,0,0,0,2,1,1,93530,36945,7544,49874,0
239,5077,173,84,99,8,29,36,181,5,12,7,13,17,20,54,81,2,221,12,0,2,1,1,93530,36946,7544,49875,0
239,5077,3,1,1,3,0,0,6,0,0,0,0,0,0,0,0,0,0,0,0,2,1,1,93530,36946,7544,49876,0
105,2771,1455,414,1257,16,76,112,1471,5,41,23,46,46,69,231,381,2,1069,59,0,2,10,0,93530,36947,7544,49877,0
105,2771,669,365,481,22,61,110,691,15,103,63,122,118,185,747,1273,8,11311,628,0,2,10,0,93540,36947,7545,49878,0
298,6420,1943,715,1694,26,18,214,1969,12,185,120,237,197,357,1436,2721,7,20915,1161,0,2,1,1,93540,36949,7545,49879,0
298,6420,1168,838,957,57,25,144,1225,19,348,224,416,367,640,3018,5452,11,61921,3440,1,2,1,1,93550,36951,7545,49880,0
83,3818,1455,414,1257,16,76,112,1471,5,41,23,46,46,69,231,381,2,1069,59,0,2,60,5,93550,36952,7545,49881,0
118,3203,1523,757,1297,19,12,193,1542,12,193,117,230,205,347,1508,2664,7,19053,1058,0,2,1,0,93560,36954,7545,49882,0
118,3203,701,378,504,33,58,109,734,13,110,68,126,123,194,794,1346,7,10027,557,0,2,1,0,93560,36955,7546,49883,0
114,5827,1523,757,1297,19,12,193,1542,12,193,117,230,205,347,1508,2664,7,19053,1058,0,2,42,0,93570,36957,7546,49884,0
119,3209,1523,757,1297,19,12,193,1542,12,193,117,230,205,347,1508,2664,7,19053,1058,0,2,2,1,93580,36959,7546,49885,0
119,3209,701,378,504,33,58,109,734,13,110,68,126,123,194,794,1346,7,10027,557,0,2,2,1,93580,36960,7547,49886,0
189,5498,1660,832,1314,41,38,274,1701,20,312,209,395,332,604,2671,5058,12,64042,3557,1,2,0,31,93580,36962,7548,49888,0
189,5498,1057,646,719,113,100,145,1170,18,215,134,248,233,382,1740,3004,10,31186,1732,1,2,0,31,93590,36963,7549,49889,0
45,1597,601,196,481,2,23,85,603,8,63,36,72,71,108,400,664,4,3036,168,0,2,1,43,93590,36963,7549,49890,0
7,458,382,65,130,157,2,92,539,4,10,5,10,14,15,41,57,2,114,6,0,2,29,1,93590,36964,7550,49891,0
14,567,124,78,88,2,3,26,126,4,13,7,13,17,20,56,81,2,163,9,0,2,5,3,93590,36964,7550,49892,0
7,458,382,65,130,157,2,92,539,4,10,5,10,14,15,41,57,2,114,6,0,2,29,1,93590,36965,7551,49893,0
14,567,124,78,88,2,3,26,126,4,13,7,13,17,20,56,81,2,163,9,0,2,5,3,93590,36965,7551,49894,0
88,2116,996,429,845,24,10,117,1020,7,76,50,88,83,138,494,879,4,3565,198,0,2,20,7,93590,36967,7551,49895,0
88,2116,456,277,329,12,42,72,468,13,85,50,97,98,147,592,972,7,7212,400,0,2,20,7,93590,36967,7551,49896,0
51,3888,996,429,845,24,10,117,1020,7,76,50,88,83,138,494,879,4,3565,198,0,2,1,0,93590,36969,7551,49897,0
88,2116,996,429,845,24,10,117,1020,7,76,50,88,83,138,494,879,4,3565,198,0,2,20,7,93590,36971,7551,49898,0
88,2116,456,277,329,12,42,72,468,13,85,50,97,98,147,592,972,7,7212,400,0,2,20,7,93590,36971,7551,49899,0
51,3888,996,429,845,24,10,117,1020,7,76,50,88,83,138,494,879,4,3565,198,0,2,1,0,93590,36973,7551,49900,0
244,5149,2,2,2,0,0,0,2,0,0,0,0,0,0,0,0,0,0,0,0,2,52,1,93630,36983,7553,49940,0
244,5149,99,48,90,1,3,5,100,0,0,0,0,0,0,0,0,0,0,0,0,2,52,1,93630,36984,7553,49941,0
244,5149,8,5,5,2,0,1,10,0,0,0,0,0,0,0,0,0,0,0,0,2,52,1,93630,36984,7553,49942,0
244,5149,1217,716,841,84,126,174,1301,14,185,118,215,199,333,1446,2542,8,20687,1149,0,2,52,1,93640,36986,7553,49943,0
244,5149,160,89,115,0,13,31,160,7,15,11,17,22,28,78,124,3,495,27,0,2,52,1,93640,36986,7553,49944,0
244,5149,10,10,9,9,0,0,19,0,0,0,0,0,0,0,0,0,0,0,0,2,52,1,93640,36986,7554,49945,0
244,5149,173,84,99,8,29,36,181,5,12,7,13,17,20,54,81,2,221,12,0,2,52,1,93640,36987,7554,49946,0
244,5149,3,1,1,3,0,0,6,0,0,0,0,0,0,0,0,0,0,0,0,2,52,1,93640,36987,7554,49947,0
111,6090,1457,730,1242,11,6,188,1468,10,292,166,329,302,495,2424,4078,5,22973,1276,1,2,11,5,93640,36989,7554,49948,0
244,5149,2,2,2,0,0,0,2,0,0,0,0,0,0,0,0,0,0,0,0,2,52,1,93640,36989,7554,49948,0
244,5149,99,48,90,1,3,5,100,0,0,0,0,0,0,0,0,0,0,0,0,2,52,1,93640,36990,7554,49949,0
244,5149,8,5,5,2,0,1,10,0,0,0,0,0,0,0,0,0,0,0,0,2,52,1,93640,36990,7554,49950,0
244,5149,1217,716,841,84,126,174,1301,14,185,118,215,199,333,1446,2542,8,20687,1149,0,2,52,1,93650,36992,7554,49951,0
244,5149,160,89,115,0,13,31,160,7,15,11,17,22,28,78,124,3,495,27,0,2,52,1,93650,36992,7554,49952,0
244,5149,10,10,9,9,0,0,19,0,0,0,0,0,0,0,0,0,0,0,0,2,52,1,93650,36992,7555,49953,0
244,5149,173,84,99,8,29,36,181,5,12,7,13,17,20,54,81,2,221,12,0,2,52,1,93650,36993,7555,49954,0
244,5149,3,1,1,3,0,0,6,0,0,0,0,0,0,0,0,0,0,0,0,2,52,1,93650,36993,7555,49955,0
111,6090,1457,730,1242,11,6,188,1468,10,292,166,329,302,495,2424,4078,5,22973,1276,1,2,11,5,93650,36995,7555,49956,0
119,3209,1523,757,1297,19,12,193,1542,12,193,117,230,205,347,1508,2664,7,19053,1058,0,2,2,0,93660,36997,7555,49957,0
119,3209,701,378,504,33,58,109,734,13,110,68,126,123,194,794,1346,7,10027,557,0,2,2,0,93660,36998,7556,49958,0
114,5827,1523,757,1297,19,12,193,1542,12,193,117,230,205,347,1508,2664,7,19053,1058,0,2,42,0,93670,37000,7556,49959,0
87,3421,1043,504,840,53,9,147,1096,9,180,112,198,189,310,1377,2344,4,11604,644,0,2,1,4,93670,37002,7556,49962,0
299,6663,72,33,56,0,4,12,72,1,1,1,1,2,2,0,2,0,1,0,0,2,18,8,93670,37002,7556,49963,0
299,6663,1454,835,1044,76,110,219,1530,17,275,158,296,292,454,2297,3718,9,34017,1889,1,2,18,8,93680,37003,7556,49964,0
299,6663,72,33,56,0,4,12,72,1,1,1,1,2,2,0,2,0,1,0,0,2,18,8,93680,37003,7556,49965,0
299,6663,1454,835,1044,76,110,219,1530,17,275,158,296,292,454,2297,3718,9,34017,1889,1,2,18,8,93690,37004,7556,49966,0
227,6379,722,423,573,19,0,135,741,12,172,101,199,184,300,1320,2257,6,15668,870,0,2,1,1,93690,37006,7556,49968,1
227,6379,1508,847,911,44,250,301,1552,14,148,88,169,162,257,1120,1886,7,15077,837,0,2,1,1,93690,37007,7557,49969,1
64,3325,722,423,573,19,0,135,741,12,172,101,199,184,300,1320,2257,6,15668,870,0,2,20,0,93690,37009,7557,49971,1
14,367,105,62,62,2,14,27,107,4,12,8,12,16,20,51,80,2,160,8,0,3,8,2,93690,37009,7558,49972,0
14,367,105,62,62,2,14,27,107,4,12,8,12,16,20,51,80,2,160,8,0,3,8,2,93690,37009,7559,49973,0
87,3421,1043,504,840,53,9,147,1096,9,180,112,198,189,310,1377,2344,4,11604,644,0,2,1,4,93690,37011,7559,49974,0
227,6379,722,423,573,19,0,135,741,12,172,101,199,184,300,1320,2257,6,15668,870,0,2,1,1,93690,37013,7559,49976,0
227,6379,1508,847,911,44,250,301,1552,14,148,88,169,162,257,1120,1886,7,15077,837,0,2,1,1,93690,37014,7560,49977,0
64,3325,722,423,573,19,0,135,741,12,172,101,199,184,300,1320,2257,6,15668,870,0,2,20,0,93690,37016,7560,49979,0
189,5498,1660,832,1314,41,38,274,1701,20,312,209,395,332,604,2671,5058,12,64042,3557,1,2,6,4,93690,37018,7561,49981,0
189,5498,1057,646,719,113,100,145,1170,18,215,134,248,233,382,1740,3004,10,31186,1732,1,2,6,4,93700,37019,7562,49982,0
228,6397,722,423,573,19,0,135,741,12,172,101,199,184,300,1320,2257,6,15668,870,0,2,9,4,93700,37021,7562,49984,0
228,6397,1508,847,911,44,250,301,1552,14,148,88,169,162,257,1120,1886,7,15077,837,0,2,9,4,93700,37022,7563,49985,0
64,3340,722,423,573,19,0,135,741,12,172,101,199,184,300,1320,2257,6,15668,870,0,2,7,5,93700,37024,7563,49987,0
189,5498,1660,832,1314,41,38,274,1701,20,312,209,395,332,604,2671,5058,12,64042,3557,1,2,6,4,93700,37026,7564,49989,0
189,5498,1057,646,719,113,100,145,1170,18,215,134,248,233,382,1740,3004,10,31186,1732,1,2,6,4,93710,37027,7565,49990,0
228,6397,722,423,573,19,0,135,741,12,172,101,199,184,300,1320,2257,6,15668,870,0,2,9,4,93710,37029,7565,49992,0
228,6397,1508,847,911,44,250,301,1552,14,148,88,169,162,257,1120,1886,7,15077,837,0,2,9,4,93710,37030,7566,49993,0
64,3340,722,423,573,19,0,135,741,12,172,101,199,184,300,1320,2257,6,15668,870,0,2,7,5,93710,37032,7566,49995,0
7,458,382,65,130,157,2,92,539,4,10,5,10,14,15,41,57,2,114,6,0,2,2,2,93710,37033,7567,49996,0
7,458,382,65,130,157,2,92,539,4,10,5,10,14,15,41,57,2,114,6,0,2,2,2,93710,37034,7568,49997,0
80,2023,466,257,367,18,25,50,484,7,126,86,171,133,257,898,1813,4,8612,478,0,2,10,4,93710,37034,7568,49998,1
80,2023,507,281,342,29,59,88,536,10,53,29,57,63,86,336,514,5,2764,153,0,2,10,4,93710,37034,7568,49999,1
33,2003,466,257,367,18,25,50,484,7,126,86,171,133,257,898,1813,4,8612,478,0,2,62,0,93710,37034,7568,50000,1
33,2003,466,257,367,18,25,50,484,7,126,86,171,133,257,898,1813,4,8612,478,0,2,9,15,93710,37034,7568,50001,1
80,2023,466,257,367,18,25,50,484,7,126,86,171,133,257,898,1813,4,8612,478,0,2,10,4,93710,37034,7568,50002,0
80,2023,507,281,342,29,59,88,536,10,53,29,57,63,86,336,514,5,2764,153,0,2,10,4,93710,37034,7568,50003,0
33,2003,466,257,367,18,25,50,484,7,126,86,171,133,257,898,1813,4,8612,478,0,2,56,0,93710,37034,7568,50004,0
301,6450,1943,715,1694,26,18,214,1969,12,185,120,237,197,357,1436,2721,7,20915,1161,0,2,14,8,93710,37036,7568,50005,0
301,6450,1168,838,957,57,25,144,1225,19,348,224,416,367,640,3018,5452,11,61921,3440,1,2,14,8,93720,37038,7568,50006,0
114,6860,1943,715,1694,26,18,214,1969,12,185,120,237,197,357,1436,2721,7,20915,1161,0,2,11,0,93720,37040,7568,50007,0
11,629,219,78,157,11,5,46,230,3,24,20,34,27,54,114,256,2,545,30,0,2,3,5,93720,37041,7568,50008,0
37,816,167,116,138,4,5,22,171,8,48,30,56,56,86,292,499,4,2330,129,0,2,1,1,93720,37041,7568,50009,0
111,6108,1457,730,1242,11,6,188,1468,10,292,166,329,302,495,2424,4078,5,22973,1276,1,2,9,9,93720,37043,7568,50010,0
186,5483,182,127,129,0,0,53,182,5,39,21,42,44,63,217,343,2,926,51,0,2,1,1,93720,37043,7569,50011,1
186,5483,1165,710,800,67,119,181,1232,18,243,153,282,261,435,2000,3492,10,36473,2026,1,2,1,1,93730,37043,7570,50012,1
28,598,2,2,2,0,0,0,2,0,0,0,0,0,0,0,0,0,0,0,0,2,1,1,93730,37043,7570,50012,1
28,598,99,48,90,1,3,5,100,0,0,0,0,0,0,0,0,0,0,0,0,2,1,1,93730,37044,7570,50013,1
28,598,8,5,5,2,0,1,10,0,0,0,0,0,0,0,0,0,0,0,0,2,1,1,93730,37044,7570,50014,1
28,598,1217,716,841,84,126,174,1301,14,185,118,215,199,333,1446,2542,8,20687,1149,0,2,1,1,93740,37046,7570,50015,1
28,598,160,89,115,0,13,31,160,7,15,11,17,22,28,78,124,3,495,27,0,2,1,1,93740,37046,7570,50016,1
28,598,10,10,9,9,0,0,19,0,0,0,0,0,0,0,0,0,0,0,0,2,1,1,93740,37046,7571,50017,1
28,598,173,84,99,8,29,36,181,5,12,7,13,17,20,54,81,2,221,12,0,2,1,1,93740,37047,7571,50018,1
28,598,3,1,1,3,0,0,6,0,0,0,0,0,0,0,0,0,0,0,0,2,1,1,93740,37047,7571,50019,1
189,5498,1660,832,1314,41,38,274,1701,20,312,209,395,332,604,2671,5058,12,64042,3557,1,2,2,3,93740,37049,7572,50021,1
189,5498,1057,646,719,113,100,145,1170,18,215,134,248,233,382,1740,3004,10,31186,1732,1,2,2,3,93750,37050,7573,50022,1
53,1495,207,111,150,11,0,50,218,5,26,19,36,31,55,133,272,3,943,52,0,2,2,5,93750,37050,7573,50023,1
53,1495,410,198,237,31,55,97,441,11,63,38,72,74,110,414,683,6,4293,238,0,2,2,5,93760,37051,7574,50024,1
105,2773,1455,414,1257,16,76,112,1471,5,41,23,46,46,69,231,381,2,1069,59,0,2,3,1,93760,37052,7574,50025,1
105,2773,669,365,481,22,61,110,691,15,103,63,122,118,185,747,1273,8,11311,628,0,2,3,1,93770,37052,7575,50026,1
228,6399,722,423,573,19,0,135,741,12,172,101,199,184,300,1320,2257,6,15668,870,0,2,1,1,93770,37054,7575,50028,1
228,6399,1508,847,911,44,250,301,1552,14,148,88,169,162,257,1120,1886,7,15077,837,0,2,1,1,93770,37055,7576,50029,1
80,2025,466,257,367,18,25,50,484,7,126,86,171,133,257,898,1813,4,8612,478,0,2,1,1,93770,37055,7576,50030,1
80,2025,507,281,342,29,59,88,536,10,53,29,57,63,86,336,514,5,2764,153,0,2,1,1,93770,37055,7576,50031,1
88,1931,1043,504,840,53,9,147,1096,9,180,112,198,189,310,1377,2344,4,11604,644,0,2,1,1,93770,37057,7576,50032,1
88,1931,383,288,292,26,6,62,409,11,65,38,67,76,105,429,656,5,3719,206,0,2,1,1,93770,37058,7576,50033,1
100,3089,773,419,590,28,0,166,801,10,204,113,217,214,330,1598,2554,5,13587,754,0,2,2,6,93770,37058,7577,50034,1
37,816,167,116,138,4,5,22,171,8,48,30,56,56,86,292,499,4,2330,129,0,2,1,1,93770,37058,7577,50035,0
111,6108,1457,730,1242,11,6,188,1468,10,292,166,329,302,495,2424,4078,5,22973,1276,1,2,9,9,93770,37060,7577,50036,0
186,5483,182,127,129,0,0,53,182,5,39,21,42,44,63,217,343,2,926,51,0,2,1,1,93770,37060,7578,50037,0
186,5483,1165,710,800,67,119,181,1232,18,243,153,282,261,435,2000,3492,10,36473,2026,1,2,1,1,93780,37060,7579,50038,0
28,598,2,2,2,0,0,0,2,0,0,0,0,0,0,0,0,0,0,0,0,2,1,1,93780,37060,7579,50038,0
28,598,99,48,90,1,3,5,100,0,0,0,0,0,0,0,0,0,0,0,0,2,1,1,93780,37061,7579,50039,0
28,598,8,5,5,2,0,1,10,0,0,0,0,0,0,0,0,0,0,0,0,2,1,1,93780,37061,7579,50040,0
28,598,1217,716,841,84,126,174,1301,14,185,118,215,199,333,1446,2542,8,20687,1149,0,2,1,1,93790,37063,7579,50041,0
28,598,160,89,115,0,13,31,160,7,15,11,17,22,28,78,124,3,495,27,0,2,1,1,93790,37063,7579,50042,0
28,598,10,10,9,9,0,0,19,0,0,0,0,0,0,0,0,0,0,0,0,2,1,1,93790,37063,7580,50043,0
28,598,173,84,99,8,29,36,181,5,12,7,13,17,20,54,81,2,221,12,0,2,1,1,93790,37064,7580,50044,0
28,598,3,1,1,3,0,0,6,0,0,0,0,0,0,0,0,0,0,0,0,2,1,1,93790,37064,7580,50045,0
189,5498,1660,832,1314,41,38,274,1701,20,312,209,395,332,604,2671,5058,12,64042,3557,1,2,2,3,93790,37066,7581,50047,0
189,5498,1057,646,719,113,100,145,1170,18,215,134,248,233,382,1740,3004,10,31186,1732,1,2,2,3,93800,37067,7582,50048,0
53,1495,207,111,150,11,0,50,218,5,26,19,36,31,55,133,272,3,943,52,0,2,2,5,93800,37067,7582,50049,0
53,1495,410,198,237,31,55,97,441,11,63,38,72,74,110,414,683,6,4293,238,0,2,2,5,93810,37068,7583,50050,0
105,2773,1455,414,1257,16,76,112,1471,5,41,23,46,46,69,231,381,2,1069,59,0,2,3,1,93810,37069,7583,50051,0
105,2773,669,365,481,22,61,110,691,15,103,63,122,118,185,747,1273,8,11311,628,0,2,3,1,93820,37069,7584,50052,0
228,6399,722,423,573,19,0,135,741,12,172,101,199,184,300,1320,2257,6,15668,870,0,2,1,1,93820,37071,7584,50054,0
228,6399,1508,847,911,44,250,301,1552,14,148,88,169,162,257,1120,1886,7,15077,837,0,2,1,1,93820,37072,7585,50055,0
80,2025,466,257,367,18,25,50,484,7,126,86,171,133,257,898,1813,4,8612,478,0,2,1,1,93820,37072,7585,50056,0
80,2025,507,281,342,29,59,88,536,10,53,29,57,63,86,336,514,5,2764,153,0,2,1,1,93820,37072,7585,50057,0
88,1931,1043,504,840,53,9,147,1096,9,180,112,198,189,310,1377,2344,4,11604,644,0,2,1,1,93820,37074,7585,50058,0
88,1931,383,288,292,26,6,62,409,11,65,38,67,76,105,429,656,5,3719,206,0,2,1,1,93820,37075,7585,50059,0
100,3089,773,419,590,28,0,166,801,10,204,113,217,214,330,1598,2554,5,13587,754,0,2,2,6,93820,37075,7586,50060,0
1,101,42,7,35,4,0,5,46,1,2,1,2,3,3,2,4,0,2,0,0,2,4,1,93820,37075,7586,50061,0
1,101,11,6,10,0,0,1,11,2,4,2,4,6,6,10,15,1,15,0,0,2,4,1,93820,37075,7586,50062,0
53,1495,207,111,150,11,0,50,218,5,26,19,36,31,55,133,272,3,943,52,0,2,1,1,93820,37075,7586,50063,0
53,1495,410,198,237,31,55,97,441,11,63,38,72,74,110,414,683,6,4293,238,0,2,1,1,93830,37076,7587,50064,0
30,921,256,139,192,9,7,47,265,4,23,12,24,27,36,112,171,2,357,19,0,2,1,1,93830,37077,7587,50065,0
1,92,36,13,19,2,6,9,38,1,2,1,2,3,3,2,4,0,2,0,0,0,36,0,93830,37077,7587,50066,0
55,1873,53,23,39,0,0,13,53,2,8,4,8,10,12,26,39,1,39,2,0,2,1,1,93830,37077,7587,50067,0
55,1873,515,298,307,33,80,99,548,12,63,44,77,75,121,419,753,7,5527,307,0,2,1,1,93840,37077,7587,50068,0
53,1495,207,111,150,11,0,50,218,5,26,19,36,31,55,133,272,3,943,52,0,2,1,1,93840,37077,7587,50069,0
53,1495,410,198,237,31,55,97,441,11,63,38,72,74,110,414,683,6,4293,238,0,2,1,1,93850,37078,7588,50070,0
30,921,256,139,192,9,7,47,265,4,23,12,24,27,36,112,171,2,357,19,0,2,1,1,93850,37079,7588,50071,0
1,92,36,13,19,2,6,9,38,1,2,1,2,3,3,2,4,0,2,0,0,0,36,0,93850,37079,7588,50072,0
55,1873,53,23,39,0,0,13,53,2,8,4,8,10,12,26,39,1,39,2,0,2,1,1,93850,37079,7588,50073,0
55,1873,515,298,307,33,80,99,548,12,63,44,77,75,121,419,753,7,5527,307,0,2,1,1,93860,37079,7588,50074,0
1,101,42,7,35,4,0,5,46,1,2,1,2,3,3,2,4,0,2,0,0,2,4,1,93860,37079,7588,50075,0
1,101,11,6,10,0,0,1,11,2,4,2,4,6,6,10,15,1,15,0,0,2,4,1,93860,37079,7588,50076,0
301,6450,1943,715,1694,26,18,214,1969,12,185,120,237,197,357,1436,2721,7,20915,1161,0,2,14,8,93860,37081,7588,50077,0
301,6450,1168,838,957,57,25,144,1225,19,348,224,416,367,640,3018,5452,11,61921,3440,1,2,14,8,93870,37083,7588,50078,0
114,6860,1943,715,1694,26,18,214,1969,12,185,120,237,197,357,1436,2721,7,20915,1161,0,2,11,0,93870,37085,7588,50079,0
26,621,207,111,150,11,0,50,218,5,26,19,36,31,55,133,272,3,943,52,0,2,9,3,93870,37085,7588,50080,0
26,621,207,111,150,11,0,50,218,5,26,19,36,31,55,133,272,3,943,52,0,2,9,3,93870,37085,7588,50081,0
15,385,105,62,62,2,14,27,107,4,12,8,12,16,20,51,80,2,160,8,0,2,6,4,93870,37085,7589,50082,0
15,385,105,62,62,2,14,27,107,4,12,8,12,16,20,51,80,2,160,8,0,2,6,4,93870,37085,7590,50083,0
267,6383,4293,999,3693,19,54,507,4312,9,155,88,170,164,258,1156,1898,4,9368,520,0,2,56,3,93870,37087,7590,50084,1
267,6383,1482,859,1002,125,135,219,1607,16,219,134,251,235,385,1766,3032,9,27804,1544,1,2,56,3,93880,37088,7590,50085,1
186,8051,4293,999,3693,19,54,507,4312,9,155,88,170,164,258,1156,1898,4,9368,520,0,2,132,0,93880,37090,7590,50086,1
186,8051,1482,859,1002,125,135,219,1607,16,219,134,251,235,385,1766,3032,9,27804,1544,1,2,132,0,93890,37091,7590,50087,1
267,6383,4293,999,3693,19,54,507,4312,9,155,88,170,164,258,1156,1898,4,9368,520,0,2,56,3,93890,37093,7590,50088,0
267,6383,1482,859,1002,125,135,219,1607,16,219,134,251,235,385,1766,3032,9,27804,1544,1,2,56,3,93900,37094,7590,50089,0
186,8051,4293,999,3693,19,54,507,4312,9,155,88,170,164,258,1156,1898,4,9368,520,0,2,132,0,93900,37096,7590,50090,0
186,8051,1482,859,1002,125,135,219,1607,16,219,134,251,235,385,1766,3032,9,27804,1544,1,2,132,0,93910,37097,7590,50091,0
7,464,382,65,130,157,2,92,539,4,10,5,10,14,15,41,57,2,114,6,0,2,2,1,93910,37098,7591,50092,0
186,5489,182,127,129,0,0,53,182,5,39,21,42,44,63,217,343,2,926,51,0,2,2,1,93910,37098,7592,50093,0
186,5489,1165,710,800,67,119,181,1232,18,243,153,282,261,435,2000,3492,10,36473,2026,1,2,2,1,93920,37098,7593,50094,0
53,1517,207,111,150,11,0,50,218,5,26,19,36,31,55,133,272,3,943,52,0,2,7,1,93920,37098,7593,50095,0
53,1517,410,198,237,31,55,97,441,11,63,38,72,74,110,414,683,6,4293,238,0,2,7,1,93930,37099,7594,50096,0
244,5155,2,2,2,0,0,0,2,0,0,0,0,0,0,0,0,0,0,0,0,2,2,1,93930,37099,7594,50096,0
244,5155,99,48,90,1,3,5,100,0,0,0,0,0,0,0,0,0,0,0,0,2,2,1,93930,37100,7594,50097,0
244,5155,8,5,5,2,0,1,10,0,0,0,0,0,0,0,0,0,0,0,0,2,2,1,93930,37100,7594,50098,0
244,5155,1217,716,841,84,126,174,1301,14,185,118,215,199,333,1446,2542,8,20687,1149,0,2,2,1,93940,37102,7594,50099,0
244,5155,160,89,115,0,13,31,160,7,15,11,17,22,28,78,124,3,495,27,0,2,2,1,93940,37102,7594,50100,0
244,5155,10,10,9,9,0,0,19,0,0,0,0,0,0,0,0,0,0,0,0,2,2,1,93940,37102,7595,50101,0
244,5155,173,84,99,8,29,36,181,5,12,7,13,17,20,54,81,2,221,12,0,2,2,1,93940,37103,7595,50102,0
244,5155,3,1,1,3,0,0,6,0,0,0,0,0,0,0,0,0,0,0,0,2,2,1,93940,37103,7595,50103,0
37,822,167,116,138,4,5,22,171,8,48,30,56,56,86,292,499,4,2330,129,0,2,2,1,93940,37103,7595,50104,0
105,2779,1455,414,1257,16,76,112,1471,5,41,23,46,46,69,231,381,2,1069,59,0,2,2,1,93940,37104,7595,50105,0
105,2779,669,365,481,22,61,110,691,15,103,63,122,118,185,747,1273,8,11311,628,0,2,2,1,93950,37104,7596,50106,0
267,6389,4293,999,3693,19,54,507,4312,9,155,88,170,164,258,1156,1898,4,9368,520,0,2,2,1,93950,37106,7596,50107,0
267,6389,1482,859,1002,125,135,219,1607,16,219,134,251,235,385,1766,3032,9,27804,1544,1,2,2,1,93960,37107,7596,50108,0
55,1879,53,23,39,0,0,13,53,2,8,4,8,10,12,26,39,1,39,2,0,2,2,1,93960,37107,7596,50109,0
55,1879,515,298,307,33,80,99,548,12,63,44,77,75,121,419,753,7,5527,307,0,2,2,1,93970,37107,7596,50110,0
12,575,205,80,86,16,53,53,221,7,18,10,19,25,29,94,134,3,497,27,0,2,3,1,93980,37107,7597,50111,0
228,6405,722,423,573,19,0,135,741,12,172,101,199,184,300,1320,2257,6,15668,870,0,2,3,2,93980,37109,7597,50113,0
228,6405,1508,847,911,44,250,301,1552,14,148,88,169,162,257,1120,1886,7,15077,837,0,2,3,2,93980,37110,7598,50114,0
80,1976,757,253,292,73,244,162,830,13,61,38,67,74,105,409,651,7,4654,258,0,2,2,1,93980,37111,7598,50115,0
20,995,386,256,301,16,9,68,402,4,59,35,69,63,104,355,621,2,1453,80,0,2,2,1,93980,37111,7598,50116,0
20,995,264,131,164,11,41,46,275,6,38,22,40,44,62,214,338,3,1068,59,0,2,2,1,93990,37111,7599,50117,0
88,1937,1043,504,840,53,9,147,1096,9,180,112,198,189,310,1377,2344,4,11604,644,0,2,2,1,93990,37113,7599,50118,0
88,1937,383,288,292,26,6,62,409,11,65,38,67,76,105,429,656,5,3719,206,0,2,2,1,93990,37114,7599,50119,0
2,228,37,13,25,0,6,6,37,1,2,1,2,3,3,2,4,0,2,0,0,2,2,1,93990,37114,7599,50120,0
2,228,133,47,40,1,43,49,134,0,0,0,0,0,0,0,0,0,0,0,0,2,2,1,93990,37114,7599,50121,0
111,6082,1457,730,1242,11,6,188,1468,10,292,166,329,302,495,2424,4078,5,22973,1276,1,2,19,25,93990,37116,7599,50122,0
7,464,382,65,130,157,2,92,539,4,10,5,10,14,15,41,57,2,114,6,0,2,2,1,93990,37117,7600,50123,0
186,5489,182,127,129,0,0,53,182,5,39,21,42,44,63,217,343,2,926,51,0,2,2,1,93990,37117,7601,50124,0
186,5489,1165,710,800,67,119,181,1232,18,243,153,282,261,435,2000,3492,10,36473,2026,1,2,2,1,94000,37117,7602,50125,0
53,1517,207,111,150,11,0,50,218,5,26,19,36,31,55,133,272,3,943,52,0,2,7,1,94000,37117,7602,50126,0
53,1517,410,198,237,31,55,97,441,11,63,38,72,74,110,414,683,6,4293,238,0,2,7,1,94010,37118,7603,50127,0
244,5155,2,2,2,0,0,0,2,0,0,0,0,0,0,0,0,0,0,0,0,2,2,1,94010,37118,7603,50127,0
244,5155,99,48,90,1,3,5,100,0,0,0,0,0,0,0,0,0,0,0,0,2,2,1,94010,37119,7603,50128,0
244,5155,8,5,5,2,0,1,10,0,0,0,0,0,0,0,0,0,0,0,0,2,2,1,94010,37119,7603,50129,0
244,5155,1217,716,841,84,126,174,1301,14,185,118,215,199,333,1446,2542,8,20687,1149,0,2,2,1,94020,37121,7603,50130,0
244,5155,160,89,115,0,13,31,160,7,15,11,17,22,28,78,124,3,495,27,0,2,2,1,94020,37121,7603,50131,0
244,5155,10,10,9,9,0,0,19,0,0,0,0,0,0,0,0,0,0,0,0,2,2,1,94020,37121,7604,50132,0
244,5155,173,84,99,8,29,36,181,5,12,7,13,17,20,54,81,2,221,12,0,2,2,1,94020,37122,7604,50133,0
244,5155,3,1,1,3,0,0,6,0,0,0,0,0,0,0,0,0,0,0,0,2,2,1,94020,37122,7604,50134,0
37,822,167,116,138,4,5,22,171,8,48,30,56,56,86,292,499,4,2330,129,0,2,2,1,94020,37122,7604,50135,0
105,2779,1455,414,1257,16,76,112,1471,5,41,23,46,46,69,231,381,2,1069,59,0,2,2,1,94020,37123,7604,50136,0
105,2779,669,365,481,22,61,110,691,15,103,63,122,118,185,747,1273,8,11311,628,0,2,2,1,94030,37123,7605,50137,0
267,6389,4293,999,3693,19,54,507,4312,9,155,88,170,164,258,1156,1898,4,9368,520,0,2,2,1,94030,37125,7605,50138,0
267,6389,1482,859,1002,125,135,219,1607,16,219,134,251,235,385,1766,3032,9,27804,1544,1,2,2,1,94040,37126,7605,50139,0
55,1879,53,23,39,0,0,13,53,2,8,4,8,10,12,26,39,1,39,2,0,2,2,1,94040,37126,7605,50140,0
55,1879,515,298,307,33,80,99,548,12,63,44,77,75,121,419,753,7,5527,307,0,2,2,1,94050,37126,7605,50141,0
12,575,205,80,86,16,53,53,221,7,18,10,19,25,29,94,134,3,497,27,0,2,3,1,94060,37126,7606,50142,0
228,6405,722,423,573,19,0,135,741,12,172,101,199,184,300,1320,2257,6,15668,870,0,2,3,2,94060,37128,7606,50144,0
228,6405,1508,847,911,44,250,301,1552,14,148,88,169,162,257,1120,1886,7,15077,837,0,2,3,2,94060,37129,7607,50145,0
80,1976,757,253,292,73,244,162,830,13,61,38,67,74,105,409,651,7,4654,258,0,2,2,1,94060,37130,7607,50146,0
20,995,386,256,301,16,9,68,402,4,59,35,69,63,104,355,621,2,1453,80,0,2,2,1,94060,37130,7607,50147,0
20,995,264,131,164,11,41,46,275,6,38,22,40,44,62,214,338,3,1068,59,0,2,2,1,94070,37130,7608,50148,0
88,1937,1043,504,840,53,9,147,1096,9,180,112,198,189,310,1377,2344,4,11604,644,0,2,2,1,94070,37132,7608,50149,0
88,1937,383,288,292,26,6,62,409,11,65,38,67,76,105,429,656,5,3719,206,0,2,2,1,94070,37133,7608,50150,0
2,228,37,13,25,0,6,6,37,1,2,1,2,3,3,2,4,0,2,0,0,2,2,1,94070,37133,7608,50151,0
2,228,133,47,40,1,43,49,134,0,0,0,0,0,0,0,0,0,0,0,0,2,2,1,94070,37133,7608,50152,0
35,2036,466,257,367,18,25,50,484,7,126,86,171,133,257,898,1813,4,8612,478,0,2,39,12,94070,37133,7608,50153,0
35,2036,466,257,367,18,25,50,484,7,126,86,171,133,257,898,1813,4,8612,478,0,2,39,12,94070,37133,7608,50154,0
106,4662,1289,550,1043,56,32,155,1345,10,167,93,185,177,278,1266,2075,5,11498,638,0,2,2,2,94070,37135,7609,50155,0
17,398,127,75,83,2,11,30,129,4,14,7,14,18,21,61,87,2,175,9,0,2,1,1,94070,37135,7609,50156,0
17,398,652,304,544,16,6,88,668,6,89,51,101,95,152,591,998,3,3399,188,0,2,1,1,94070,37136,7609,50157,0
17,398,2,2,2,0,0,0,2,0,0,0,0,0,0,0,0,0,0,0,0,2,1,1,94070,37136,7609,50157,0
17,398,8,5,5,0,0,3,8,0,0,0,0,0,0,0,0,0,0,0,0,2,1,1,94070,37136,7609,50158,0
17,398,2,2,2,0,0,0,2,0,0,0,0,0,0,0,0,0,0,0,0,2,1,1,94070,37136,7609,50158,0
17,398,14,8,8,0,0,6,14,0,0,0,0,0,0,0,0,0,0,0,0,2,1,1,94070,37136,7609,50159,0
17,398,6,4,4,0,0,2,6,0,0,0,0,0,0,0,0,0,0,0,0,2,1,1,94070,37136,7609,50160,0
17,398,6,4,4,0,0,2,6,1,2,1,2,3,3,2,4,0,2,0,0,2,1,1,94070,37136,7609,50161,0
17,398,6,4,4,0,0,2,6,0,0,0,0,0,0,0,0,0,0,0,0,2,1,1,94070,37136,7609,50162,0
17,398,7,5,5,0,0,2,7,0,0,0,0,0,0,0,0,0,0,0,0,2,1,1,94070,37136,7609,50163,0
17,398,6,4,4,0,0,2,6,0,0,0,0,0,0,0,0,0,0,0,0,2,1,1,94070,37136,7609,50164,0
17,398,10,6,6,0,0,4,10,0,0,0,0,0,0,0,0,0,0,0,0,2,1,1,94070,37136,7609,50165,0
17,398,1,1,1,0,0,0,1,0,0,0,0,0,0,0,0,0,0,0,0,2,1,1,94070,37136,7609,50165,0
17,398,14,10,10,0,0,4,14,1,1,1,1,2,2,0,2,0,1,0,0,2,1,1,94070,37136,7609,50166,0
17,398,46,26,30,3,0,12,49,3,6,3,6,9,9,20,28,1,42,2,0,2,1,1,94080,37136,7609,50167,0
42,2587,1157,318,931,29,22,177,1186,6,104,63,125,110,188,712,1274,3,4596,255,0,2,1,1,94080,37136,7609,50168,0
89,3918,1338,495,1086,10,64,173,1348,11,122,82,157,133,239,883,1686,7,11934,663,0,2,5,5,94080,37138,7609,50169,0
186,8049,4293,999,3693,19,54,507,4312,9,155,88,170,164,258,1156,1898,4,9368,520,0,2,2,2,94080,37140,7609,50170,0
186,8049,1482,859,1002,125,135,219,1607,16,219,134,251,235,385,1766,3032,9,27804,1544,1,2,2,2,94090,37141,7609,50171,0
147,5899,1782,648,1425,9,47,279,1791,8,171,97,189,179,286,1292,2140,4,9462,525,0,2,4,4,94090,37142,7610,50172,0
127,5420,1450,624,1228,12,26,181,1462,14,306,186,354,320,540,2580,4493,8,36391,2021,1,2,2,2,94090,37144,7611,50173,0
117,4982,1513,682,1277,25,13,200,1538,11,199,116,219,210,335,1557,2584,6,15641,868,0,2,2,2,94090,37146,7611,50174,0
87,5056,1296,573,1062,40,33,157,1336,8,201,118,231,209,349,1561,2689,4,12365,686,0,2,3,3,94090,37146,7611,50175,0
46,2848,652,304,544,16,6,88,668,6,89,51,101,95,152,591,998,3,3399,188,0,2,1,1,94090,37147,7611,50176,0
8,308,103,47,73,2,12,15,105,5,16,9,17,21,26,75,114,2,303,16,0,2,1,1,94090,37148,7611,50177,0
8,267,74,35,59,1,0,14,75,3,14,7,14,17,21,58,85,1,128,7,0,2,1,1,94090,37149,7611,50178,0
71,3197,1020,354,843,12,15,144,1032,8,134,77,144,142,221,970,1580,4,6792,377,0,2,1,1,94090,37149,7611,50179,0
38,2311,334,251,279,10,4,40,344,5,127,74,143,132,217,899,1528,2,4303,239,0,2,2,2,94090,37150,7611,50180,0
79,4224,1293,570,1093,25,15,163,1318,10,195,123,241,205,364,1516,2795,6,17273,959,0,2,3,3,94100,37152,7611,50181,0
30,1922,384,251,317,7,8,52,391,11,70,44,84,81,128,467,811,6,5355,297,0,2,1,1,94100,37152,7611,50182,0
114,6854,1943,715,1694,26,18,214,1969,12,185,120,237,197,357,1436,2721,7,20915,1161,0,2,3,3,94100,37154,7611,50183,0
106,4662,1289,550,1043,56,32,155,1345,10,167,93,185,177,278,1266,2075,5,11498,638,0,2,2,2,94100,37156,7612,50184,0
17,398,127,75,83,2,11,30,129,4,14,7,14,18,21,61,87,2,175,9,0,2,1,1,94100,37156,7612,50185,0
17,398,652,304,544,16,6,88,668,6,89,51,101,95,152,591,998,3,3399,188,0,2,1,1,94100,37157,7612,50186,0
17,398,2,2,2,0,0,0,2,0,0,0,0,0,0,0,0,0,0,0,0,2,1,1,94100,37157,7612,50186,0
17,398,8,5,5,0,0,3,8,0,0,0,0,0,0,0,0,0,0,0,0,2,1,1,94100,37157,7612,50187,0
17,398,2,2,2,0,0,0,2,0,0,0,0,0,0,0,0,0,0,0,0,2,1,1,94100,37157,7612,50187,0
17,398,14,8,8,0,0,6,14,0,0,0,0,0,0,0,0,0,0,0,0,2,1,1,94100,37157,7612,50188,0
17,398,6,4,4,0,0,2,6,0,0,0,0,0,0,0,0,0,0,0,0,2,1,1,94100,37157,7612,50189,0
17,398,6,4,4,0,0,2,6,1,2,1,2,3,3,2,4,0,2,0,0,2,1,1,94100,37157,7612,50190,0
17,398,6,4,4,0,0,2,6,0,0,0,0,0,0,0,0,0,0,0,0,2,1,1,94100,37157,7612,50191,0
17,398,7,5,5,0,0,2,7,0,0,0,0,0,0,0,0,0,0,0,0,2,1,1,94100,37157,7612,50192,0
17,398,6,4,4,0,0,2,6,0,0,0,0,0,0,0,0,0,0,0,0,2,1,1,94100,37157,7612,50193,0
17,398,10,6,6,0,0,4,10,0,0,0,0,0,0,0,0,0,0,0,0,2,1,1,94100,37157,7612,50194,0
17,398,1,1,1,0,0,0,1,0,0,0,0,0,0,0,0,0,0,0,0,2,1,1,94100,37157,7612,50194,0
17,398,14,10,10,0,0,4,14,1,1,1,1,2,2,0,2,0,1,0,0,2,1,1,94100,37157,7612,50195,0
17,398,46,26,30,3,0,12,49,3,6,3,6,9,9,20,28,1,42,2,0,2,1,1,94110,37157,7612,50196,0
42,2587,1157,318,931,29,22,177,1186,6,104,63,125,110,188,712,1274,3,4596,255,0,2,1,1,94110,37157,7612,50197,0
89,3918,1338,495,1086,10,64,173,1348,11,122,82,157,133,239,883,1686,7,11934,663,0,2,5,5,94110,37159,7612,50198,0
186,8049,4293,999,3693,19,54,507,4312,9,155,88,170,164,258,1156,1898,4,9368,520,0,2,2,2,94110,37161,7612,50199,0
186,8049,1482,859,1002,125,135,219,1607,16,219,134,251,235,385,1766,3032,9,27804,1544,1,2,2,2,94120,37162,7612,50200,0
147,5899,1782,648,1425,9,47,279,1791,8,171,97,189,179,286,1292,2140,4,9462,525,0,2,4,4,94120,37163,7613,50201,0
127,5420,1450,624,1228,12,26,181,1462,14,306,186,354,320,540,2580,4493,8,36391,2021,1,2,2,2,94120,37165,7614,50202,0
117,4982,1513,682,1277,25,13,200,1538,11,199,116,219,210,335,1557,2584,6,15641,868,0,2,2,2,94120,37167,7614,50203,0
87,5056,1296,573,1062,40,33,157,1336,8,201,118,231,209,349,1561,2689,4,12365,686,0,2,3,3,94120,37167,7614,50204,0
46,2848,652,304,544,16,6,88,668,6,89,51,101,95,152,591,998,3,3399,188,0,2,1,1,94120,37168,7614,50205,0
8,308,103,47,73,2,12,15,105,5,16,9,17,21,26,75,114,2,303,16,0,2,1,1,94120,37169,7614,50206,0
8,267,74,35,59,1,0,14,75,3,14,7,14,17,21,58,85,1,128,7,0,2,1,1,94120,37170,7614,50207,0
71,3197,1020,354,843,12,15,144,1032,8,134,77,144,142,221,970,1580,4,6792,377,0,2,1,1,94120,37170,7614,50208,0
38,2311,334,251,279,10,4,40,344,5,127,74,143,132,217,899,1528,2,4303,239,0,2,2,2,94120,37171,7614,50209,0
79,4224,1293,570,1093,25,15,163,1318,10,195,123,241,205,364,1516,2795,6,17273,959,0,2,3,3,94130,37173,7614,50210,0
30,1922,384,251,317,7,8,52,391,11,70,44,84,81,128,467,811,6,5355,297,0,2,1,1,94130,37173,7614,50211,0
114,6854,1943,715,1694,26,18,214,1969,12,185,120,237,197,357,1436,2721,7,20915,1161,0,2,3,3,94130,37175,7614,50212,0
14,566,124,78,88,2,3,26,126,4,13,7,13,17,20,56,81,2,163,9,0,2,1,1,94130,37175,7614,50213,0
228,6419,722,423,573,19,0,135,741,12,172,101,199,184,300,1320,2257,6,15668,870,0,2,6,2,94130,37177,7614,50215,0
228,6419,1508,847,911,44,250,301,1552,14,148,88,169,162,257,1120,1886,7,15077,837,0,2,6,2,94130,37178,7615,50216,0
228,6419,722,423,573,19,0,135,741,12,172,101,199,184,300,1320,2257,6,15668,870,0,2,6,2,94130,37180,7615,50218,0
228,6419,1508,847,911,44,250,301,1552,14,148,88,169,162,257,1120,1886,7,15077,837,0,2,6,2,94130,37181,7616,50219,0
14,566,124,78,88,2,3,26,126,4,13,7,13,17,20,56,81,2,163,9,0,2,1,1,94130,37181,7616,50220,0
11,629,219,78,157,11,5,46,230,3,24,20,34,27,54,114,256,2,545,30,0,2,3,5,94130,37182,7616,50221,0
111,6082,1457,730,1242,11,6,188,1468,10,292,166,329,302,495,2424,4078,5,22973,1276,1,2,19,25,94130,37184,7616,50222,0
267,6395,4293,999,3693,19,54,507,4312,9,155,88,170,164,258,1156,1898,4,9368,520,0,2,1,1,94130,37186,7616,50223,0
267,6395,1482,859,1002,125,135,219,1607,16,219,134,251,235,385,1766,3032,9,27804,1544,1,2,1,1,94140,37187,7616,50224,0
55,1888,53,23,39,0,0,13,53,2,8,4,8,10,12,26,39,1,39,2,0,2,1,1,94140,37187,7616,50225,0
55,1888,515,298,307,33,80,99,548,12,63,44,77,75,121,419,753,7,5527,307,0,2,1,1,94150,37187,7616,50226,0
80,2027,466,257,367,18,25,50,484,7,126,86,171,133,257,898,1813,4,8612,478,0,2,1,1,94150,37187,7616,50227,0
80,2027,507,281,342,29,59,88,536,10,53,29,57,63,86,336,514,5,2764,153,0,2,1,1,94150,37187,7616,50228,0
267,6395,4293,999,3693,19,54,507,4312,9,155,88,170,164,258,1156,1898,4,9368,520,0,2,1,1,94150,37189,7616,50229,0
267,6395,1482,859,1002,125,135,219,1607,16,219,134,251,235,385,1766,3032,9,27804,1544,1,2,1,1,94160,37190,7616,50230,0
55,1888,53,23,39,0,0,13,53,2,8,4,8,10,12,26,39,1,39,2,0,2,1,1,94160,37190,7616,50231,0
55,1888,515,298,307,33,80,99,548,12,63,44,77,75,121,419,753,7,5527,307,0,2,1,1,94170,37190,7616,50232,0
80,2027,466,257,367,18,25,50,484,7,126,86,171,133,257,898,1813,4,8612,478,0,2,1,1,94170,37190,7616,50233,0
80,2027,507,281,342,29,59,88,536,10,53,29,57,63,86,336,514,5,2764,153,0,2,1,1,94170,37190,7616,50234,0
262,6273,4293,999,3693,19,54,507,4312,9,155,88,170,164,258,1156,1898,4,9368,520,0,2,3,56,94170,37192,7616,50235,0
262,6273,1482,859,1002,125,135,219,1607,16,219,134,251,235,385,1766,3032,9,27804,1544,1,2,3,56,94180,37193,7616,50236,0
185,8003,4293,999,3693,19,54,507,4312,9,155,88,170,164,258,1156,1898,4,9368,520,0,2,0,132,94180,37195,7616,50237,0
185,8003,1482,859,1002,125,135,219,1607,16,219,134,251,235,385,1766,3032,9,27804,1544,1,2,0,132,94190,37196,7616,50238,0
117,4992,1513,682,1277,25,13,200,1538,11,199,116,219,210,335,1557,2584,6,15641,868,0,2,2,0,94190,37198,7616,50239,0
115,6857,1943,715,1694,26,18,214,1969,12,185,120,237,197,357,1436,2721,7,20915,1161,0,2,17,15,94190,37200,7616,50240,0
117,4992,1513,682,1277,25,13,200,1538,11,199,116,219,210,335,1557,2584,6,15641,868,0,2,2,0,94190,37202,7616,50241,0
115,6857,1943,715,1694,26,18,214,1969,12,185,120,237,197,357,1436,2721,7,20915,1161,0,2,17,15,94190,37204,7616,50242,0
118,7014,1943,715,1694,26,18,214,1969,12,185,120,237,197,357,1436,2721,7,20915,1161,0,2,65,4,94190,37206,7616,50243,0
118,7014,1943,715,1694,26,18,214,1969,12,185,120,237,197,357,1436,2721,7,20915,1161,0,2,65,4,94190,37208,7616,50244,0
143,6921,1392,870,1177,35,17,170,1427,14,494,280,531,508,811,4473,7289,7,54850,3047,2,2,0,2,94190,37211,7617,50245,0
145,3560,77,34,69,0,0,8,77,3,24,16,29,27,45,114,213,1,387,21,0,2,4,0,94190,37211,7617,50246,0
145,3560,712,438,573,51,9,84,763,14,102,71,128,116,199,733,1364,8,11988,666,0,2,4,0,94200,37212,7617,50247,0
55,1890,53,23,39,0,0,13,53,2,8,4,8,10,12,26,39,1,39,2,0,2,1,1,94200,37212,7617,50248,0
55,1890,515,298,307,33,80,99,548,12,63,44,77,75,121,419,753,7,5527,307,0,2,1,1,94210,37212,7617,50249,0
186,5549,182,127,129,0,0,53,182,5,39,21,42,44,63,217,343,2,926,51,0,2,10,10,94210,37212,7618,50250,0
186,5549,1165,710,800,67,119,181,1232,18,243,153,282,261,435,2000,3492,10,36473,2026,1,2,10,10,94220,37212,7619,50251,0
105,2787,1455,414,1257,16,76,112,1471,5,41,23,46,46,69,231,381,2,1069,59,0,2,3,1,94220,37213,7619,50252,0
105,2787,669,365,481,22,61,110,691,15,103,63,122,118,185,747,1273,8,11311,628,0,2,3,1,94230,37213,7620,50253,0
267,6401,4293,999,3693,19,54,507,4312,9,155,88,170,164,258,1156,1898,4,9368,520,0,2,1,1,94230,37215,7620,50254,0
267,6401,1482,859,1002,125,135,219,1607,16,219,134,251,235,385,1766,3032,9,27804,1544,1,2,1,1,94240,37216,7620,50255,0
143,6949,1392,870,1177,35,17,170,1427,14,494,280,531,508,811,4473,7289,7,54850,3047,2,2,1,1,94240,37219,7621,50256,0
143,6921,1392,870,1177,35,17,170,1427,14,494,280,531,508,811,4473,7289,7,54850,3047,2,2,0,2,94240,37222,7622,50257,0
186,5491,182,127,129,0,0,53,182,5,39,21,42,44,63,217,343,2,926,51,0,2,1,1,94240,37222,7623,50258,0
186,5491,1165,710,800,67,119,181,1232,18,243,153,282,261,435,2000,3492,10,36473,2026,1,2,1,1,94250,37222,7624,50259,0
88,1967,1043,504,840,53,9,147,1096,9,180,112,198,189,310,1377,2344,4,11604,644,0,2,7,2,94250,37224,7624,50260,0
88,1967,383,288,292,26,6,62,409,11,65,38,67,76,105,429,656,5,3719,206,0,2,7,2,94250,37225,7624,50261,0
186,5491,182,127,129,0,0,53,182,5,39,21,42,44,63,217,343,2,926,51,0,2,1,1,94250,37225,7625,50262,0
186,5491,1165,710,800,67,119,181,1232,18,243,153,282,261,435,2000,3492,10,36473,2026,1,2,1,1,94260,37225,7626,50263,0
88,1967,1043,504,840,53,9,147,1096,9,180,112,198,189,310,1377,2344,4,11604,644,0,2,7,2,94260,37227,7626,50264,0
88,1967,383,288,292,26,6,62,409,11,65,38,67,76,105,429,656,5,3719,206,0,2,7,2,94260,37228,7626,50265,0
53,1523,207,111,150,11,0,50,218,5,26,19,36,31,55,133,272,3,943,52,0,2,4,2,94260,37228,7626,50266,0
53,1523,410,198,237,31,55,97,441,11,63,38,72,74,110,414,683,6,4293,238,0,2,4,2,94270,37229,7627,50267,0
37,822,167,116,138,4,5,22,171,8,48,30,56,56,86,292,499,4,2330,129,0,2,3,1,94270,37229,7627,50268,0
186,5551,182,127,129,0,0,53,182,5,39,21,42,44,63,217,343,2,926,51,0,2,10,10,94270,37229,7628,50269,0
186,5551,1165,710,800,67,119,181,1232,18,243,153,282,261,435,2000,3492,10,36473,2026,1,2,10,10,94280,37229,7629,50270,0
105,2787,1455,414,1257,16,76,112,1471,5,41,23,46,46,69,231,381,2,1069,59,0,2,3,1,94280,37230,7629,50271,0
105,2787,669,365,481,22,61,110,691,15,103,63,122,118,185,747,1273,8,11311,628,0,2,3,1,94290,37230,7630,50272,0
267,6401,4293,999,3693,19,54,507,4312,9,155,88,170,164,258,1156,1898,4,9368,520,0,2,1,1,94290,37232,7630,50273,0
267,6401,1482,859,1002,125,135,219,1607,16,219,134,251,235,385,1766,3032,9,27804,1544,1,2,1,1,94300,37233,7630,50274,0
145,3560,77,34,69,0,0,8,77,3,24,16,29,27,45,114,213,1,387,21,0,2,4,0,94300,37233,7630,50275,0
145,3560,712,438,573,51,9,84,763,14,102,71,128,116,199,733,1364,8,11988,666,0,2,4,0,94310,37234,7630,50276,0
55,1890,53,23,39,0,0,13,53,2,8,4,8,10,12,26,39,1,39,2,0,2,1,1,94310,37234,7630,50277,0
55,1890,515,298,307,33,80,99,548,12,63,44,77,75,121,419,753,7,5527,307,0,2,1,1,94320,37234,7630,50278,0
143,6927,1392,870,1177,35,17,170,1427,14,494,280,531,508,811,4473,7289,7,54850,3047,2,2,1,1,94320,37237,7631,50279,0
53,1523,207,111,150,11,0,50,218,5,26,19,36,31,55,133,272,3,943,52,0,2,4,2,94320,37237,7631,50280,0
53,1523,410,198,237,31,55,97,441,11,63,38,72,74,110,414,683,6,4293,238,0,2,4,2,94330,37238,7632,50281,0
37,822,167,116,138,4,5,22,171,8,48,30,56,56,86,292,499,4,2330,129,0,2,3,1,94330,37238,7632,50282,0
113,2328,463,295,324,28,62,57,491,12,134,82,154,146,236,989,1696,6,11700,650,0,2,4,4,94340,37239,7632,50283,1
37,865,167,116,138,4,5,22,171,8,48,30,56,56,86,292,499,4,2330,129,0,2,5,2,94340,37239,7632,50284,1
105,2791,1455,414,1257,16,76,112,1471,5,41,23,46,46,69,231,381,2,1069,59,0,2,1,1,94340,37240,7632,50285,1
105,2791,669,365,481,22,61,110,691,15,103,63,122,118,185,747,1273,8,11311,628,0,2,1,1,94350,37240,7633,50286,1
267,6409,4293,999,3693,19,54,507,4312,9,155,88,170,164,258,1156,1898,4,9368,520,0,2,7,4,94350,37242,7633,50287,1
267,6409,1482,859,1002,125,135,219,1607,16,219,134,251,235,385,1766,3032,9,27804,1544,1,2,7,4,94360,37243,7633,50288,1
145,3575,77,34,69,0,0,8,77,3,24,16,29,27,45,114,213,1,387,21,0,2,4,4,94360,37243,7633,50289,1
145,3575,712,438,573,51,9,84,763,14,102,71,128,116,199,733,1364,8,11988,666,0,2,4,4,94370,37244,7633,50290,1
55,1909,53,23,39,0,0,13,53,2,8,4,8,10,12,26,39,1,39,2,0,2,1,0,94370,37244,7633,50291,1
55,1909,515,298,307,33,80,99,548,12,63,44,77,75,121,419,753,7,5527,307,0,2,1,0,94380,37244,7633,50292,1
89,3918,1338,495,1086,10,64,173,1348,11,122,82,157,133,239,883,1686,7,11934,663,0,2,3,3,94380,37246,7633,50293,1
113,2328,463,295,324,28,62,57,491,12,134,82,154,146,236,989,1696,6,11700,650,0,2,4,4,94390,37247,7633,50294,0
37,865,167,116,138,4,5,22,171,8,48,30,56,56,86,292,499,4,2330,129,0,2,5,2,94390,37247,7633,50295,0
105,2791,1455,414,1257,16,76,112,1471,5,41,23,46,46,69,231,381,2,1069,59,0,2,1,1,94390,37248,7633,50296,0
105,2791,669,365,481,22,61,110,691,15,103,63,122,118,185,747,1273,8,11311,628,0,2,1,1,94400,37248,7634,50297,0
267,6409,4293,999,3693,19,54,507,4312,9,155,88,170,164,258,1156,1898,4,9368,520,0,2,7,4,94400,37250,7634,50298,0
267,6409,1482,859,1002,125,135,219,1607,16,219,134,251,235,385,1766,3032,9,27804,1544,1,2,7,4,94410,37251,7634,50299,0
145,3575,77,34,69,0,0,8,77,3,24,16,29,27,45,114,213,1,387,21,0,2,4,4,94410,37251,7634,50300,0
145,3575,712,438,573,51,9,84,763,14,102,71,128,116,199,733,1364,8,11988,666,0,2,4,4,94420,37252,7634,50301,0
55,1909,53,23,39,0,0,13,53,2,8,4,8,10,12,26,39,1,39,2,0,2,1,0,94420,37252,7634,50302,0
55,1909,515,298,307,33,80,99,548,12,63,44,77,75,121,419,753,7,5527,307,0,2,1,0,94430,37252,7634,50303,0
89,3918,1338,495,1086,10,64,173,1348,11,122,82,157,133,239,883,1686,7,11934,663,0,2,3,3,94430,37254,7634,50304,0
59,1750,773,419,590,28,0,166,801,10,204,113,217,214,330,1598,2554,5,13587,754,0,2,2,3,94430,37254,7635,50305,0
59,1750,421,273,302,44,34,57,465,17,81,59,107,98,166,583,1098,11,12329,684,0,2,2,3,94430,37254,7636,50306,0
186,5566,182,127,129,0,0,53,182,5,39,21,42,44,63,217,343,2,926,51,0,2,2,2,94430,37254,7637,50307,1
186,5566,1165,710,800,67,119,181,1232,18,243,153,282,261,435,2000,3492,10,36473,2026,1,2,2,2,94440,37254,7638,50308,1
62,2102,773,419,590,28,0,166,801,10,204,113,217,214,330,1598,2554,5,13587,754,0,2,68,9,94440,37254,7639,50309,1
62,2102,421,273,302,44,34,57,465,17,81,59,107,98,166,583,1098,11,12329,684,0,2,68,9,94440,37254,7640,50310,1
102,3170,773,419,590,28,0,166,801,10,204,113,217,214,330,1598,2554,5,13587,754,0,2,16,0,94440,37254,7641,50311,1
64,3430,722,423,573,19,0,135,741,12,172,101,199,184,300,1320,2257,6,15668,870,0,2,69,65,94440,37256,7641,50313,1
20,1004,386,256,301,16,9,68,402,4,59,35,69,63,104,355,621,2,1453,80,0,2,3,3,94440,37256,7641,50314,0
20,1004,264,131,164,11,41,46,275,6,38,22,40,44,62,214,338,3,1068,59,0,2,3,3,94450,37256,7642,50315,0
46,1995,386,256,301,16,9,68,402,4,59,35,69,63,104,355,621,2,1453,80,0,2,61,57,94450,37256,7642,50316,0
81,2060,466,257,367,18,25,50,484,7,126,86,171,133,257,898,1813,4,8612,478,0,2,8,1,94450,37256,7642,50317,0
81,2060,507,281,342,29,59,88,536,10,53,29,57,63,86,336,514,5,2764,153,0,2,8,1,94450,37256,7642,50318,0
87,3572,1043,504,840,53,9,147,1096,9,180,112,198,189,310,1377,2344,4,11604,644,0,2,95,74,94450,37258,7642,50319,0
186,5566,182,127,129,0,0,53,182,5,39,21,42,44,63,217,343,2,926,51,0,2,2,2,94450,37258,7643,50320,0
186,5566,1165,710,800,67,119,181,1232,18,243,153,282,261,435,2000,3492,10,36473,2026,1,2,2,2,94460,37258,7644,50321,0
62,2102,773,419,590,28,0,166,801,10,204,113,217,214,330,1598,2554,5,13587,754,0,2,70,12,94460,37258,7645,50322,0
62,2102,421,273,302,44,34,57,465,17,81,59,107,98,166,583,1098,11,12329,684,0,2,70,12,94460,37258,7646,50323,0
20,1004,386,256,301,16,9,68,402,4,59,35,69,63,104,355,621,2,1453,80,0,2,3,3,94460,37258,7646,50324,0
20,1004,264,131,164,11,41,46,275,6,38,22,40,44,62,214,338,3,1068,59,0,2,3,3,94470,37258,7647,50325,0
81,2060,466,257,367,18,25,50,484,7,126,86,171,133,257,898,1813,4,8612,478,0,2,8,1,94470,37258,7647,50326,0
81,2060,507,281,342,29,59,88,536,10,53,29,57,63,86,336,514,5,2764,153,0,2,8,1,94470,37258,7647,50327,0
102,3170,773,419,590,28,0,166,801,10,204,113,217,214,330,1598,2554,5,13587,754,0,2,16,0,94470,37258,7648,50328,0
64,3430,722,423,573,19,0,135,741,12,172,101,199,184,300,1320,2257,6,15668,870,0,2,69,65,94470,37260,7648,50330,0
46,1995,386,256,301,16,9,68,402,4,59,35,69,63,104,355,621,2,1453,80,0,2,61,57,94470,37260,7648,50331,0
87,3572,1043,504,840,53,9,147,1096,9,180,112,198,189,310,1377,2344,4,11604,644,0,2,95,74,94470,37262,7648,50332,0
262,6287,4293,999,3693,19,54,507,4312,9,155,88,170,164,258,1156,1898,4,9368,520,0,2,3,56,94470,37264,7648,50333,0
262,6287,1482,859,1002,125,135,219,1607,16,219,134,251,235,385,1766,3032,9,27804,1544,1,2,3,56,94480,37265,7648,50334,0
185,8003,4293,999,3693,19,54,507,4312,9,155,88,170,164,258,1156,1898,4,9368,520,0,2,0,132,94480,37267,7648,50335,0
185,8003,1482,859,1002,125,135,219,1607,16,219,134,251,235,385,1766,3032,9,27804,1544,1,2,0,132,94490,37268,7648,50336,0
113,2328,463,295,324,28,62,57,491,12,134,82,154,146,236,989,1696,6,11700,650,0,2,4,4,94500,37269,7648,50337,0
37,822,167,116,138,4,5,22,171,8,48,30,56,56,86,292,499,4,2330,129,0,2,2,5,94500,37269,7648,50338,0
105,2787,1455,414,1257,16,76,112,1471,5,41,23,46,46,69,231,381,2,1069,59,0,2,1,1,94500,37270,7648,50339,0
105,2787,669,365,481,22,61,110,691,15,103,63,122,118,185,747,1273,8,11311,628,0,2,1,1,94510,37270,7649,50340,0
262,6279,4293,999,3693,19,54,507,4312,9,155,88,170,164,258,1156,1898,4,9368,520,0,2,4,7,94510,37272,7649,50341,0
262,6279,1482,859,1002,125,135,219,1607,16,219,134,251,235,385,1766,3032,9,27804,1544,1,2,4,7,94520,37273,7649,50342,0
145,3560,77,34,69,0,0,8,77,3,24,16,29,27,45,114,213,1,387,21,0,2,4,4,94520,37273,7649,50343,0
145,3560,712,438,573,51,9,84,763,14,102,71,128,116,199,733,1364,8,11988,666,0,2,4,4,94530,37274,7649,50344,0
55,1890,53,23,39,0,0,13,53,2,8,4,8,10,12,26,39,1,39,2,0,2,0,1,94530,37274,7649,50345,0
55,1890,515,298,307,33,80,99,548,12,63,44,77,75,121,419,753,7,5527,307,0,2,0,1,94540,37274,7649,50346,0
89,3918,1338,495,1086,10,64,173,1348,11,122,82,157,133,239,883,1686,7,11934,663,0,2,3,3,94540,37276,7649,50347,0
22,666,424,94,331,4,0,89,428,1,5,5,5,6,10,11,25,0,12,0,0,2,14,0,94540,37277,7649,50348,0
113,2328,463,295,324,28,62,57,491,12,134,82,154,146,236,989,1696,6,11700,650,0,2,4,4,94550,37278,7649,50349,0
37,822,167,116,138,4,5,22,171,8,48,30,56,56,86,292,499,4,2330,129,0,2,2,5,94550,37278,7649,50350,0
105,2787,1455,414,1257,16,76,112,1471,5,41,23,46,46,69,231,381,2,1069,59,0,2,1,1,94550,37279,7649,50351,0
105,2787,669,365,481,22,61,110,691,15,103,63,122,118,185,747,1273,8,11311,628,0,2,1,1,94560,37279,7650,50352,0
262,6279,4293,999,3693,19,54,507,4312,9,155,88,170,164,258,1156,1898,4,9368,520,0,2,4,7,94560,37281,7650,50353,0
262,6279,1482,859,1002,125,135,219,1607,16,219,134,251,235,385,1766,3032,9,27804,1544,1,2,4,7,94570,37282,7650,50354,0
145,3560,77,34,69,0,0,8,77,3,24,16,29,27,45,114,213,1,387,21,0,2,4,4,94570,37282,7650,50355,0
145,3560,712,438,573,51,9,84,763,14,102,71,128,116,199,733,1364,8,11988,666,0,2,4,4,94580,37283,7650,50356,0
55,1890,53,23,39,0,0,13,53,2,8,4,8,10,12,26,39,1,39,2,0,2,0,1,94580,37283,7650,50357,0
55,1890,515,298,307,33,80,99,548,12,63,44,77,75,121,419,753,7,5527,307,0,2,0,1,94590,37283,7650,50358,0
89,3918,1338,495,1086,10,64,173,1348,11,122,82,157,133,239,883,1686,7,11934,663,0,2,3,3,94590,37285,7650,50359,0
22,666,424,94,331,4,0,89,428,1,5,5,5,6,10,11,25,0,12,0,0,2,14,0,94590,37286,7650,50360,0
186,5566,182,127,129,0,0,53,182,5,39,21,42,44,63,217,343,2,926,51,0,2,3,2,94590,37286,7651,50361,0
186,5566,1165,710,800,67,119,181,1232,18,243,153,282,261,435,2000,3492,10,36473,2026,1,2,3,2,94600,37286,7652,50362,0
62,2105,773,419,590,28,0,166,801,10,204,113,217,214,330,1598,2554,5,13587,754,0,2,1,1,94600,37286,7653,50363,1
62,2105,421,273,302,44,34,57,465,17,81,59,107,98,166,583,1098,11,12329,684,0,2,1,1,94600,37286,7654,50364,1
186,5566,182,127,129,0,0,53,182,5,39,21,42,44,63,217,343,2,926,51,0,2,3,2,94600,37286,7655,50365,0
186,5566,1165,710,800,67,119,181,1232,18,243,153,282,261,435,2000,3492,10,36473,2026,1,2,3,2,94610,37286,7656,50366,0
51,3916,996,429,845,24,10,117,1020,7,76,50,88,83,138,494,879,4,3565,198,0,2,2,0,94610,37288,7656,50367,0
51,3916,996,429,845,24,10,117,1020,7,76,50,88,83,138,494,879,4,3565,198,0,2,2,0,94610,37290,7656,50368,0
228,6422,722,423,573,19,0,135,741,12,172,101,199,184,300,1320,2257,6,15668,870,0,2,2,0,94610,37292,7656,50370,0
228,6422,1508,847,911,44,250,301,1552,14,148,88,169,162,257,1120,1886,7,15077,837,0,2,2,0,94610,37293,7657,50371,0
64,3443,722,423,573,19,0,135,741,12,172,101,199,184,300,1320,2257,6,15668,870,0,2,3,1,94610,37295,7657,50373,0
87,3578,1043,504,840,53,9,147,1096,9,180,112,198,189,310,1377,2344,4,11604,644,0,2,8,6,94610,37297,7657,50374,0
87,3578,1043,504,840,53,9,147,1096,9,180,112,198,189,310,1377,2344,4,11604,644,0,2,8,6,94610,37299,7657,50375,0
228,6422,722,423,573,19,0,135,741,12,172,101,199,184,300,1320,2257,6,15668,870,0,2,2,0,94610,37301,7657,50377,0
228,6422,1508,847,911,44,250,301,1552,14,148,88,169,162,257,1120,1886,7,15077,837,0,2,2,0,94610,37302,7658,50378,0
64,3443,722,423,573,19,0,135,741,12,172,101,199,184,300,1320,2257,6,15668,870,0,2,3,1,94610,37304,7658,50380,0
145,3599,77,34,69,0,0,8,77,3,24,16,29,27,45,114,213,1,387,21,0,2,16,5,94610,37304,7658,50381,0
145,3599,712,438,573,51,9,84,763,14,102,71,128,116,199,733,1364,8,11988,666,0,2,16,5,94620,37305,7658,50382,0
145,3599,77,34,69,0,0,8,77,3,24,16,29,27,45,114,213,1,387,21,0,2,16,5,94620,37305,7658,50383,0
145,3599,712,438,573,51,9,84,763,14,102,71,128,116,199,733,1364,8,11988,666,0,2,16,5,94630,37306,7658,50384,0
22,703,424,94,331,4,0,89,428,1,5,5,5,6,10,11,25,0,12,0,0,2,33,3,94630,37307,7658,50385,0
113,2328,463,295,324,28,62,57,491,12,134,82,154,146,236,989,1696,6,11700,650,0,2,4,4,94640,37308,7658,50386,1
37,865,167,116,138,4,5,22,171,8,48,30,56,56,86,292,499,4,2330,129,0,2,5,2,94640,37308,7658,50387,1
105,2791,1455,414,1257,16,76,112,1471,5,41,23,46,46,69,231,381,2,1069,59,0,2,1,1,94640,37309,7658,50388,1
105,2791,669,365,481,22,61,110,691,15,103,63,122,118,185,747,1273,8,11311,628,0,2,1,1,94650,37309,7659,50389,1
262,6287,4293,999,3693,19,54,507,4312,9,155,88,170,164,258,1156,1898,4,9368,520,0,2,7,4,94650,37311,7659,50390,1
262,6287,1482,859,1002,125,135,219,1607,16,219,134,251,235,385,1766,3032,9,27804,1544,1,2,7,4,94660,37312,7659,50391,1
145,3614,77,34,69,0,0,8,77,3,24,16,29,27,45,114,213,1,387,21,0,2,4,4,94660,37312,7659,50392,1
145,3614,712,438,573,51,9,84,763,14,102,71,128,116,199,733,1364,8,11988,666,0,2,4,4,94670,37313,7659,50393,1
55,1909,53,23,39,0,0,13,53,2,8,4,8,10,12,26,39,1,39,2,0,2,1,0,94670,37313,7659,50394,1
55,1909,515,298,307,33,80,99,548,12,63,44,77,75,121,419,753,7,5527,307,0,2,1,0,94680,37313,7659,50395,1
56,1916,53,23,39,0,0,13,53,2,8,4,8,10,12,26,39,1,39,2,0,2,4,2,94680,37313,7659,50396,0
56,1916,515,298,307,33,80,99,548,12,63,44,77,75,121,419,753,7,5527,307,0,2,4,2,94690,37313,7659,50397,0
22,710,424,94,331,4,0,89,428,1,5,5,5,6,10,11,25,0,12,0,0,2,4,1,94690,37314,7659,50398,0
53,1539,207,111,150,11,0,50,218,5,26,19,36,31,55,133,272,3,943,52,0,2,1,1,94690,37314,7659,50399,0
53,1539,410,198,237,31,55,97,441,11,63,38,72,74,110,414,683,6,4293,238,0,2,1,1,94700,37315,7660,50400,0
299,6679,72,33,56,0,4,12,72,1,1,1,1,2,2,0,2,0,1,0,0,2,6,4,94700,37315,7660,50401,0
299,6679,1454,835,1044,76,110,219,1530,17,275,158,296,292,454,2297,3718,9,34017,1889,1,2,6,4,94710,37316,7660,50402,0
114,5837,1523,757,1297,19,12,193,1542,12,193,117,230,205,347,1508,2664,7,19053,1058,0,2,2,1,94720,37318,7660,50403,0
114,5837,1523,757,1297,19,12,193,1542,12,193,117,230,205,347,1508,2664,7,19053,1058,0,2,2,1,94730,37320,7660,50404,0
89,3913,1338,495,1086,10,64,173,1348,11,122,82,157,133,239,883,1686,7,11934,663,0,2,5,5,94730,37322,7660,50405,0
127,5419,1450,624,1228,12,26,181,1462,14,306,186,354,320,540,2580,4493,8,36391,2021,1,2,1,1,94730,37324,7661,50406,0
51,3915,996,429,845,24,10,117,1020,7,76,50,88,83,138,494,879,4,3565,198,0,2,1,1,94730,37326,7661,50407,0
114,5832,1523,757,1297,19,12,193,1542,12,193,117,230,205,347,1508,2664,7,19053,1058,0,2,4,4,94740,37328,7661,50408,0
30,1920,384,251,317,7,8,52,391,11,70,44,84,81,128,467,811,6,5355,297,0,2,1,1,94740,37328,7661,50409,0
89,3913,1338,495,1086,10,64,173,1348,11,122,82,157,133,239,883,1686,7,11934,663,0,2,5,5,94740,37330,7661,50410,0
127,5419,1450,624,1228,12,26,181,1462,14,306,186,354,320,540,2580,4493,8,36391,2021,1,2,1,1,94740,37332,7662,50411,0
51,3915,996,429,845,24,10,117,1020,7,76,50,88,83,138,494,879,4,3565,198,0,2,1,1,94740,37334,7662,50412,0
114,5832,1523,757,1297,19,12,193,1542,12,193,117,230,205,347,1508,2664,7,19053,1058,0,2,4,4,94750,37336,7662,50413,0
30,1920,384,251,317,7,8,52,391,11,70,44,84,81,128,467,811,6,5355,297,0,2,1,1,94750,37336,7662,50414,0
112,6130,1457,730,1242,11,6,188,1468,10,292,166,329,302,495,2424,4078,5,22973,1276,1,2,26,0,94750,37338,7662,50415,0
300,6694,72,33,56,0,4,12,72,1,1,1,1,2,2,0,2,0,1,0,0,2,6,1,94780,37347,7664,50442,0
300,6694,1454,835,1044,76,110,219,1530,17,275,158,296,292,454,2297,3718,9,34017,1889,1,2,6,1,94790,37348,7664,50443,0
62,2105,773,419,590,28,0,166,801,10,204,113,217,214,330,1598,2554,5,13587,754,0,2,1,1,94790,37348,7665,50444,0
62,2105,421,273,302,44,34,57,465,17,81,59,107,98,166,583,1098,11,12329,684,0,2,1,1,94790,37348,7666,50445,0
56,1923,53,23,39,0,0,13,53,2,8,4,8,10,12,26,39,1,39,2,0,2,6,5,94820,37357,7668,50472,0
56,1923,515,298,307,33,80,99,548,12,63,44,77,75,121,419,753,7,5527,307,0,2,6,5,94830,37357,7668,50473,0
53,1539,207,111,150,11,0,50,218,5,26,19,36,31,55,133,272,3,943,52,0,2,1,1,94830,37357,7668,50474,0
53,1539,410,198,237,31,55,97,441,11,63,38,72,74,110,414,683,6,4293,238,0,2,1,1,94840,37358,7669,50475,0
113,2328,463,295,324,28,62,57,491,12,134,82,154,146,236,989,1696,6,11700,650,0,2,4,4,94850,37359,7669,50476,0
37,865,167,116,138,4,5,22,171,8,48,30,56,56,86,292,499,4,2330,129,0,2,5,2,94850,37359,7669,50477,0
105,2791,1455,414,1257,16,76,112,1471,5,41,23,46,46,69,231,381,2,1069,59,0,2,1,1,94850,37360,7669,50478,0
105,2791,669,365,481,22,61,110,691,15,103,63,122,118,185,747,1273,8,11311,628,0,2,1,1,94860,37360,7670,50479,0
262,6287,4293,999,3693,19,54,507,4312,9,155,88,170,164,258,1156,1898,4,9368,520,0,2,7,4,94860,37362,7670,50480,0
262,6287,1482,859,1002,125,135,219,1607,16,219,134,251,235,385,1766,3032,9,27804,1544,1,2,7,4,94870,37363,7670,50481,0
145,3614,77,34,69,0,0,8,77,3,24,16,29,27,45,114,213,1,387,21,0,2,4,4,94870,37363,7670,50482,0
145,3614,712,438,573,51,9,84,763,14,102,71,128,116,199,733,1364,8,11988,666,0,2,4,4,94880,37364,7670,50483,0
56,1923,53,23,39,0,0,13,53,2,8,4,8,10,12,26,39,1,39,2,0,2,6,2,94880,37364,7670,50484,0
56,1923,515,298,307,33,80,99,548,12,63,44,77,75,121,419,753,7,5527,307,0,2,6,2,94890,37364,7670,50485,0
300,6694,72,33,56,0,4,12,72,1,1,1,1,2,2,0,2,0,1,0,0,2,12,5,94890,37364,7670,50486,0
300,6694,1454,835,1044,76,110,219,1530,17,275,158,296,292,454,2297,3718,9,34017,1889,1,2,12,5,94900,37365,7670,50487,0
22,710,424,94,331,4,0,89,428,1,5,5,5,6,10,11,25,0,12,0,0,2,37,4,94900,37366,7670,50488,0
186,5528,182,127,129,0,0,53,182,5,39,21,42,44,63,217,343,2,926,51,0,2,12,11,94900,37366,7671,50489,0
186,5528,1165,710,800,67,119,181,1232,18,243,153,282,261,435,2000,3492,10,36473,2026,1,2,12,11,94910,37366,7672,50490,0
88,2118,996,429,845,24,10,117,1020,7,76,50,88,83,138,494,879,4,3565,198,0,2,2,1,94920,37372,7673,50498,0
88,2118,456,277,329,12,42,72,468,13,85,50,97,98,147,592,972,7,7212,400,0,2,2,1,94920,37372,7673,50499,0
244,5153,2,2,2,0,0,0,2,0,0,0,0,0,0,0,0,0,0,0,0,2,5,4,94920,37372,7673,50499,0
244,5153,99,48,90,1,3,5,100,0,0,0,0,0,0,0,0,0,0,0,0,2,5,4,94920,37373,7673,50500,0
244,5153,8,5,5,2,0,1,10,0,0,0,0,0,0,0,0,0,0,0,0,2,5,4,94920,37373,7673,50501,0
244,5153,1217,716,841,84,126,174,1301,14,185,118,215,199,333,1446,2542,8,20687,1149,0,2,5,4,94930,37375,7673,50502,0
244,5153,160,89,115,0,13,31,160,7,15,11,17,22,28,78,124,3,495,27,0,2,5,4,94930,37375,7673,50503,0
244,5153,10,10,9,9,0,0,19,0,0,0,0,0,0,0,0,0,0,0,0,2,5,4,94930,37375,7674,50504,0
244,5153,173,84,99,8,29,36,181,5,12,7,13,17,20,54,81,2,221,12,0,2,5,4,94930,37376,7674,50505,0
244,5153,3,1,1,3,0,0,6,0,0,0,0,0,0,0,0,0,0,0,0,2,5,4,94930,37376,7674,50506,0
105,2795,1455,414,1257,16,76,112,1471,5,41,23,46,46,69,231,381,2,1069,59,0,2,3,2,94930,37377,7674,50507,0
105,2795,669,365,481,22,61,110,691,15,103,63,122,118,185,747,1273,8,11311,628,0,2,3,2,94940,37377,7675,50508,0
262,6289,4293,999,3693,19,54,507,4312,9,155,88,170,164,258,1156,1898,4,9368,520,0,2,2,1,94940,37379,7675,50509,0
262,6289,1482,859,1002,125,135,219,1607,16,219,134,251,235,385,1766,3032,9,27804,1544,1,2,2,1,94950,37380,7675,50510,0
81,2062,466,257,367,18,25,50,484,7,126,86,171,133,257,898,1813,4,8612,478,0,2,2,1,94950,37380,7675,50511,0
81,2062,507,281,342,29,59,88,536,10,53,29,57,63,86,336,514,5,2764,153,0,2,2,1,94950,37380,7675,50512,0
143,6921,1392,870,1177,35,17,170,1427,14,494,280,531,508,811,4473,7289,7,54850,3047,2,2,4,3,94950,37383,7676,50513,0
3,495,149,67,118,4,0,27,153,1,17,14,28,18,42,69,175,0,144,8,0,2,3,4,94950,37383,7676,50514,0
186,5528,182,127,129,0,0,53,182,5,39,21,42,44,63,217,343,2,926,51,0,2,12,11,94950,37383,7677,50515,0
186,5528,1165,710,800,67,119,181,1232,18,243,153,282,261,435,2000,3492,10,36473,2026,1,2,12,11,94960,37383,7678,50516,0
88,2118,996,429,845,24,10,117,1020,7,76,50,88,83,138,494,879,4,3565,198,0,2,2,1,94970,37389,7679,50524,0
88,2118,456,277,329,12,42,72,468,13,85,50,97,98,147,592,972,7,7212,400,0,2,2,1,94970,37389,7679,50525,0
244,5153,2,2,2,0,0,0,2,0,0,0,0,0,0,0,0,0,0,0,0,2,5,4,94970,37389,7679,50525,0
244,5153,99,48,90,1,3,5,100,0,0,0,0,0,0,0,0,0,0,0,0,2,5,4,94970,37390,7679,50526,0
244,5153,8,5,5,2,0,1,10,0,0,0,0,0,0,0,0,0,0,0,0,2,5,4,94970,37390,7679,50527,0
244,5153,1217,716,841,84,126,174,1301,14,185,118,215,199,333,1446,2542,8,20687,1149,0,2,5,4,94980,37392,7679,50528,0
244,5153,160,89,115,0,13,31,160,7,15,11,17,22,28,78,124,3,495,27,0,2,5,4,94980,37392,7679,50529,0
244,5153,10,10,9,9,0,0,19,0,0,0,0,0,0,0,0,0,0,0,0,2,5,4,94980,37392,7680,50530,0
244,5153,173,84,99,8,29,36,181,5,12,7,13,17,20,54,81,2,221,12,0,2,5,4,94980,37393,7680,50531,0
244,5153,3,1,1,3,0,0,6,0,0,0,0,0,0,0,0,0,0,0,0,2,5,4,94980,37393,7680,50532,0
105,2795,1455,414,1257,16,76,112,1471,5,41,23,46,46,69,231,381,2,1069,59,0,2,3,2,94980,37394,7680,50533,0
105,2795,669,365,481,22,61,110,691,15,103,63,122,118,185,747,1273,8,11311,628,0,2,3,2,94990,37394,7681,50534,0
262,6289,4293,999,3693,19,54,507,4312,9,155,88,170,164,258,1156,1898,4,9368,520,0,2,2,1,94990,37396,7681,50535,0
262,6289,1482,859,1002,125,135,219,1607,16,219,134,251,235,385,1766,3032,9,27804,1544,1,2,2,1,95000,37397,7681,50536,0
81,2062,466,257,367,18,25,50,484,7,126,86,171,133,257,898,1813,4,8612,478,0,2,2,1,95000,37397,7681,50537,0
81,2062,507,281,342,29,59,88,536,10,53,29,57,63,86,336,514,5,2764,153,0,2,2,1,95000,37397,7681,50538,0
143,6921,1392,870,1177,35,17,170,1427,14,494,280,531,508,811,4473,7289,7,54850,3047,2,2,4,3,95000,37400,7682,50539,0
3,495,149,67,118,4,0,27,153,1,17,14,28,18,42,69,175,0,144,8,0,2,3,4,95000,37400,7682,50540,0
144,7018,1392,870,1177,35,17,170,1427,14,494,280,531,508,811,4473,7289,7,54850,3047,2,2,33,7,95000,37403,7683,50541,0
186,8037,4293,999,3693,19,54,507,4312,9,155,88,170,164,258,1156,1898,4,9368,520,0,2,35,0,95000,37405,7683,50542,0
186,8037,1482,859,1002,125,135,219,1607,16,219,134,251,235,385,1766,3032,9,27804,1544,1,2,35,0,95010,37406,7683,50543,0
186,8037,4293,999,3693,19,54,507,4312,9,155,88,170,164,258,1156,1898,4,9368,520,0,2,35,0,95010,37408,7683,50544,0
186,8037,1482,859,1002,125,135,219,1607,16,219,134,251,235,385,1766,3032,9,27804,1544,1,2,35,0,95020,37409,7683,50545,0
144,7018,1392,870,1177,35,17,170,1427,14,494,280,531,508,811,4473,7289,7,54850,3047,2,2,33,7,95020,37412,7684,50546,0
161,3439,1513,682,1277,25,13,200,1538,11,199,116,219,210,335,1557,2584,6,15641,868,0,2,1,1,95020,37414,7684,50547,0
161,3439,819,519,539,24,98,155,843,15,96,57,106,111,163,690,1107,8,9171,509,0,2,1,1,95030,37416,7684,50548,0
118,5010,1513,682,1277,25,13,200,1538,11,199,116,219,210,335,1557,2584,6,15641,868,0,2,5,0,95030,37418,7684,50549,0
161,3439,1513,682,1277,25,13,200,1538,11,199,116,219,210,335,1557,2584,6,15641,868,0,2,1,1,95030,37420,7684,50550,0
161,3439,819,519,539,24,98,155,843,15,96,57,106,111,163,690,1107,8,9171,509,0,2,1,1,95040,37422,7684,50551,0
118,5010,1513,682,1277,25,13,200,1538,11,199,116,219,210,335,1557,2584,6,15641,868,0,2,5,0,95040,37424,7684,50552,0
145,3612,77,34,69,0,0,8,77,3,24,16,29,27,45,114,213,1,387,21,0,2,2,2,95040,37424,7684,50553,0
145,3612,712,438,573,51,9,84,763,14,102,71,128,116,199,733,1364,8,11988,666,0,2,2,2,95050,37425,7684,50554,0
145,3612,77,34,69,0,0,8,77,3,24,16,29,27,45,114,213,1,387,21,0,2,2,2,95050,37425,7684,50555,0
145,3612,712,438,573,51,9,84,763,14,102,71,128,116,199,733,1364,8,11988,666,0,2,2,2,95060,37426,7684,50556,0
112,6130,1457,730,1242,11,6,188,1468,10,292,166,329,302,495,2424,4078,5,22973,1276,1,2,26,0,95060,37428,7684,50557,0
145,3620,77,34,69,0,0,8,77,3,24,16,29,27,45,114,213,1,387,21,0,2,1,1,95060,37428,7684,50558,0
145,3620,712,438,573,51,9,84,763,14,102,71,128,116,199,733,1364,8,11988,666,0,2,1,1,95070,37429,7684,50559,0
300,6703,72,33,56,0,4,12,72,1,1,1,1,2,2,0,2,0,1,0,0,2,2,2,95070,37429,7684,50560,0
300,6703,1454,835,1044,76,110,219,1530,17,275,158,296,292,454,2297,3718,9,34017,1889,1,2,2,2,95080,37430,7684,50561,0
162,3459,1513,682,1277,25,13,200,1538,11,199,116,219,210,335,1557,2584,6,15641,868,0,2,3,3,95080,37432,7684,50562,1
162,3459,819,519,539,24,98,155,843,15,96,57,106,111,163,690,1107,8,9171,509,0,2,3,3,95090,37434,7684,50563,1
119,5094,1513,682,1277,25,13,200,1538,11,199,116,219,210,335,1557,2584,6,15641,868,0,2,12,0,95090,37436,7684,50564,1
42,2587,1157,318,931,29,22,177,1186,6,104,63,125,110,188,712,1274,3,4596,255,0,2,1,1,95090,37436,7684,50565,0
300,6695,72,33,56,0,4,12,72,1,1,1,1,2,2,0,2,0,1,0,0,2,12,4,95090,37436,7684,50566,0
300,6695,1454,835,1044,76,110,219,1530,17,275,158,296,292,454,2297,3718,9,34017,1889,1,2,12,4,95100,37437,7684,50567,0
300,6695,72,33,56,0,4,12,72,1,1,1,1,2,2,0,2,0,1,0,0,2,1,1,95100,37437,7684,50568,0
300,6695,1454,835,1044,76,110,219,1530,17,275,158,296,292,454,2297,3718,9,34017,1889,1,2,1,1,95110,37438,7684,50569,0
137,3410,77,34,69,0,0,8,77,3,24,16,29,27,45,114,213,1,387,21,0,2,1,38,95110,37438,7684,50570,0
137,3410,712,438,573,51,9,84,763,14,102,71,128,116,199,733,1364,8,11988,666,0,2,1,38,95120,37439,7684,50571,0
65,2152,53,23,39,0,0,13,53,2,8,4,8,10,12,26,39,1,39,2,0,2,41,0,95120,37439,7684,50572,0
65,2152,515,298,307,33,80,99,548,12,63,44,77,75,121,419,753,7,5527,307,0,2,41,0,95130,37439,7684,50573,0
294,6553,72,33,56,0,4,12,72,1,1,1,1,2,2,0,2,0,1,0,0,2,1,26,95130,37439,7684,50574,0
294,6553,1454,835,1044,76,110,219,1530,17,275,158,296,292,454,2297,3718,9,34017,1889,1,2,1,26,95140,37440,7684,50575,0
42,2587,1157,318,931,29,22,177,1186,6,104,63,125,110,188,712,1274,3,4596,255,0,2,1,1,95140,37440,7684,50576,0
162,3473,1513,682,1277,25,13,200,1538,11,199,116,219,210,335,1557,2584,6,15641,868,0,2,7,8,95140,37442,7684,50577,1
162,3473,819,519,539,24,98,155,843,15,96,57,106,111,163,690,1107,8,9171,509,0,2,7,8,95150,37444,7684,50578,1
119,5100,1513,682,1277,25,13,200,1538,11,199,116,219,210,335,1557,2584,6,15641,868,0,2,2,1,95150,37446,7684,50579,1
119,5113,1513,682,1277,25,13,200,1538,11,199,116,219,210,335,1557,2584,6,15641,868,0,2,2,1,95150,37448,7684,50580,0
119,7063,1943,715,1694,26,18,214,1969,12,185,120,237,197,357,1436,2721,7,20915,1161,0,2,9,0,95150,37450,7684,50581,0
162,3471,1513,682,1277,25,13,200,1538,11,199,116,219,210,335,1557,2584,6,15641,868,0,2,7,7,95150,37452,7684,50582,0
162,3471,819,519,539,24,98,155,843,15,96,57,106,111,163,690,1107,8,9171,509,0,2,7,7,95160,37454,7684,50583,0
66,3522,722,423,573,19,0,135,741,12,172,101,199,184,300,1320,2257,6,15668,870,0,2,10,0,95160,37456,7684,50585,0
119,7063,1943,715,1694,26,18,214,1969,12,185,120,237,197,357,1436,2721,7,20915,1161,0,2,9,0,95160,37458,7684,50586,0
137,3416,77,34,69,0,0,8,77,3,24,16,29,27,45,114,213,1,387,21,0,2,1,1,95160,37458,7684,50587,0
137,3416,712,438,573,51,9,84,763,14,102,71,128,116,199,733,1364,8,11988,666,0,2,1,1,95170,37459,7684,50588,0
65,2176,53,23,39,0,0,13,53,2,8,4,8,10,12,26,39,1,39,2,0,2,6,3,95170,37459,7684,50589,0
65,2176,515,298,307,33,80,99,548,12,63,44,77,75,121,419,753,7,5527,307,0,2,6,3,95180,37459,7684,50590,0
294,6559,72,33,56,0,4,12,72,1,1,1,1,2,2,0,2,0,1,0,0,2,1,1,95180,37459,7684,50591,0
294,6559,1454,835,1044,76,110,219,1530,17,275,158,296,292,454,2297,3718,9,34017,1889,1,2,1,1,95190,37460,7684,50592,0
162,3471,1513,682,1277,25,13,200,1538,11,199,116,219,210,335,1557,2584,6,15641,868,0,2,11,12,95190,37462,7684,50593,0
162,3471,819,519,539,24,98,155,843,15,96,57,106,111,163,690,1107,8,9171,509,0,2,11,12,95200,37464,7684,50594,0
119,5113,1513,682,1277,25,13,200,1538,11,199,116,219,210,335,1557,2584,6,15641,868,0,2,15,1,95200,37466,7684,50595,0
228,6434,722,423,573,19,0,135,741,12,172,101,199,184,300,1320,2257,6,15668,870,0,2,4,3,95200,37468,7684,50597,0
228,6434,1508,847,911,44,250,301,1552,14,148,88,169,162,257,1120,1886,7,15077,837,0,2,4,3,95200,37469,7685,50598,0
225,6470,722,423,573,19,0,135,741,12,172,101,199,184,300,1320,2257,6,15668,870,0,2,10,3,95200,37471,7685,50600,0
225,6470,1508,847,911,44,250,301,1552,14,148,88,169,162,257,1120,1886,7,15077,837,0,2,10,3,95200,37472,7686,50601,0
244,5157,2,2,2,0,0,0,2,0,0,0,0,0,0,0,0,0,0,0,0,2,7,0,95200,37472,7686,50601,0
244,5157,99,48,90,1,3,5,100,0,0,0,0,0,0,0,0,0,0,0,0,2,7,0,95200,37473,7686,50602,0
244,5157,8,5,5,2,0,1,10,0,0,0,0,0,0,0,0,0,0,0,0,2,7,0,95200,37473,7686,50603,0
244,5157,1217,716,841,84,126,174,1301,14,185,118,215,199,333,1446,2542,8,20687,1149,0,2,7,0,95210,37475,7686,50604,0
244,5157,160,89,115,0,13,31,160,7,15,11,17,22,28,78,124,3,495,27,0,2,7,0,95210,37475,7686,50605,0
244,5157,10,10,9,9,0,0,19,0,0,0,0,0,0,0,0,0,0,0,0,2,7,0,95210,37475,7687,50606,0
244,5157,173,84,99,8,29,36,181,5,12,7,13,17,20,54,81,2,221,12,0,2,7,0,95210,37476,7687,50607,0
244,5157,3,1,1,3,0,0,6,0,0,0,0,0,0,0,0,0,0,0,0,2,7,0,95210,37476,7687,50608,0
225,6476,722,423,573,19,0,135,741,12,172,101,199,184,300,1320,2257,6,15668,870,0,2,2,1,95210,37478,7687,50610,0
225,6476,1508,847,911,44,250,301,1552,14,148,88,169,162,257,1120,1886,7,15077,837,0,2,2,1,95210,37479,7688,50611,0
87,5086,1296,573,1062,40,33,157,1336,8,201,118,231,209,349,1561,2689,4,12365,686,0,2,8,4,95210,37479,7688,50612,0
244,5157,2,2,2,0,0,0,2,0,0,0,0,0,0,0,0,0,0,0,0,2,7,0,95210,37479,7688,50612,0
244,5157,99,48,90,1,3,5,100,0,0,0,0,0,0,0,0,0,0,0,0,2,7,0,95210,37480,7688,50613,0
244,5157,8,5,5,2,0,1,10,0,0,0,0,0,0,0,0,0,0,0,0,2,7,0,95210,37480,7688,50614,0
244,5157,1217,716,841,84,126,174,1301,14,185,118,215,199,333,1446,2542,8,20687,1149,0,2,7,0,95220,37482,7688,50615,0
244,5157,160,89,115,0,13,31,160,7,15,11,17,22,28,78,124,3,495,27,0,2,7,0,95220,37482,7688,50616,0
244,5157,10,10,9,9,0,0,19,0,0,0,0,0,0,0,0,0,0,0,0,2,7,0,95220,37482,7689,50617,0
244,5157,173,84,99,8,29,36,181,5,12,7,13,17,20,54,81,2,221,12,0,2,7,0,95220,37483,7689,50618,0
244,5157,3,1,1,3,0,0,6,0,0,0,0,0,0,0,0,0,0,0,0,2,7,0,95220,37483,7689,50619,0
225,6476,722,423,573,19,0,135,741,12,172,101,199,184,300,1320,2257,6,15668,870,0,2,14,5,95220,37485,7689,50621,0
225,6476,1508,847,911,44,250,301,1552,14,148,88,169,162,257,1120,1886,7,15077,837,0,2,14,5,95220,37486,7690,50622,0
87,5086,1296,573,1062,40,33,157,1336,8,201,118,231,209,349,1561,2689,4,12365,686,0,2,8,4,95220,37486,7690,50623,0
80,1976,757,253,292,73,244,162,830,13,61,38,67,74,105,409,651,7,4654,258,0,2,1,1,95220,37487,7690,50624,0
186,5527,182,127,129,0,0,53,182,5,39,21,42,44,63,217,343,2,926,51,0,2,2,3,95220,37487,7691,50625,0
186,5527,1165,710,800,67,119,181,1232,18,243,153,282,261,435,2000,3492,10,36473,2026,1,2,2,3,95230,37487,7692,50626,0
186,5527,182,127,129,0,0,53,182,5,39,21,42,44,63,217,343,2,926,51,0,2,2,3,95230,37487,7693,50627,0
186,5527,1165,710,800,67,119,181,1232,18,243,153,282,261,435,2000,3492,10,36473,2026,1,2,2,3,95240,37487,7694,50628,0
80,1976,757,253,292,73,244,162,830,13,61,38,67,74,105,409,651,7,4654,258,0,2,1,1,95240,37488,7694,50629,0
120,7094,1943,715,1694,26,18,214,1969,12,185,120,237,197,357,1436,2721,7,20915,1161,0,2,14,7,95240,37490,7694,50630,0
262,6283,4293,999,3693,19,54,507,4312,9,155,88,170,164,258,1156,1898,4,9368,520,0,2,3,2,95240,37492,7694,50631,0
262,6283,1482,859,1002,125,135,219,1607,16,219,134,251,235,385,1766,3032,9,27804,1544,1,2,3,2,95250,37493,7694,50632,0
186,8102,4293,999,3693,19,54,507,4312,9,155,88,170,164,258,1156,1898,4,9368,520,0,2,18,1,95250,37495,7694,50633,0
186,8102,1482,859,1002,125,135,219,1607,16,219,134,251,235,385,1766,3032,9,27804,1544,1,2,18,1,95260,37496,7694,50634,0
262,6280,4293,999,3693,19,54,507,4312,9,155,88,170,164,258,1156,1898,4,9368,520,0,2,1,2,95260,37498,7694,50635,0
262,6280,1482,859,1002,125,135,219,1607,16,219,134,251,235,385,1766,3032,9,27804,1544,1,2,1,2,95270,37499,7694,50636,0
51,1103,447,308,343,6,5,95,453,7,96,59,111,103,170,651,1136,4,4600,255,0,2,2,1,95270,37502,7694,50637,0
51,1103,322,174,179,16,74,51,338,10,41,26,46,51,72,252,408,5,2291,127,0,2,2,1,95270,37505,7695,50638,0
262,6289,4293,999,3693,19,54,507,4312,9,155,88,170,164,258,1156,1898,4,9368,520,0,2,3,1,95270,37507,7695,50639,0
262,6289,1482,859,1002,125,135,219,1607,16,219,134,251,235,385,1766,3032,9,27804,1544,1,2,3,1,95280,37508,7695,50640,0
187,8092,4293,999,3693,19,54,507,4312,9,155,88,170,164,258,1156,1898,4,9368,520,0,2,32,0,95280,37510,7695,50641,0
187,8092,1482,859,1002,125,135,219,1607,16,219,134,251,235,385,1766,3032,9,27804,1544,1,2,32,0,95290,37511,7695,50642,0
262,6280,4293,999,3693,19,54,507,4312,9,155,88,170,164,258,1156,1898,4,9368,520,0,2,4,4,95290,37513,7695,50643,0
262,6280,1482,859,1002,125,135,219,1607,16,219,134,251,235,385,1766,3032,9,27804,1544,1,2,4,4,95300,37514,7695,50644,0
186,8102,4293,999,3693,19,54,507,4312,9,155,88,170,164,258,1156,1898,4,9368,520,0,2,18,1,95300,37516,7695,50645,0
186,8102,1482,859,1002,125,135,219,1607,16,219,134,251,235,385,1766,3032,9,27804,1544,1,2,18,1,95310,37517,7695,50646,0
51,1103,447,308,343,6,5,95,453,7,96,59,111,103,170,651,1136,4,4600,255,0,2,2,1,95310,37520,7695,50647,0
51,1103,322,174,179,16,74,51,338,10,41,26,46,51,72,252,408,5,2291,127,0,2,2,1,95310,37523,7696,50648,0
262,6280,4293,999,3693,19,54,507,4312,9,155,88,170,164,258,1156,1898,4,9368,520,0,2,3,1,95310,37525,7696,50649,0
262,6280,1482,859,1002,125,135,219,1607,16,219,134,251,235,385,1766,3032,9,27804,1544,1,2,3,1,95320,37526,7696,50650,0
187,8157,4293,999,3693,19,54,507,4312,9,155,88,170,164,258,1156,1898,4,9368,520,0,2,32,0,95320,37528,7696,50651,0
187,8157,1482,859,1002,125,135,219,1607,16,219,134,251,235,385,1766,3032,9,27804,1544,1,2,32,0,95330,37529,7696,50652,0
66,3522,722,423,573,19,0,135,741,12,172,101,199,184,300,1320,2257,6,15668,870,0,2,10,0,95330,37531,7696,50654,0
33,1148,182,127,129,0,0,53,182,5,39,21,42,44,63,217,343,2,926,51,0,2,33,0,95330,37531,7697,50655,0
100,3049,773,419,590,28,0,166,801,10,204,113,217,214,330,1598,2554,5,13587,754,0,2,0,30,95330,37531,7698,50656,0
33,1151,182,127,129,0,0,53,182,5,39,21,42,44,63,217,343,2,926,51,0,2,1,1,95330,37531,7699,50657,0
120,7094,1943,715,1694,26,18,214,1969,12,185,120,237,197,357,1436,2721,7,20915,1161,0,2,14,7,95330,37533,7699,50658,0
33,1151,182,127,129,0,0,53,182,5,39,21,42,44,63,217,343,2,926,51,0,2,33,0,95330,37533,7700,50659,0
100,3049,773,419,590,28,0,166,801,10,204,113,217,214,330,1598,2554,5,13587,754,0,2,0,30,95330,37533,7701,50660,0
33,1085,182,127,129,0,0,53,182,5,39,21,42,44,63,217,343,2,926,51,0,2,24,23,95330,37533,7702,50661,0
15,391,105,62,62,2,14,27,107,4,12,8,12,16,20,51,80,2,160,8,0,2,1,1,95330,37533,7703,50662,0
33,1085,182,127,129,0,0,53,182,5,39,21,42,44,63,217,343,2,926,51,0,2,24,23,95330,37533,7704,50663,0
15,391,105,62,62,2,14,27,107,4,12,8,12,16,20,51,80,2,160,8,0,2,1,1,95330,37533,7705,50664,0
31,944,182,127,129,0,0,53,182,5,39,21,42,44,63,217,343,2,926,51,0,2,0,33,95330,37533,7706,50665,0
102,3186,773,419,590,28,0,166,801,10,204,113,217,214,330,1598,2554,5,13587,754,0,2,31,1,95330,37533,7707,50666,0
15,391,105,62,62,2,14,27,107,4,12,8,12,16,20,51,80,2,160,8,0,2,3,1,95330,37533,7708,50667,0
31,944,182,127,129,0,0,53,182,5,39,21,42,44,63,217,343,2,926,51,0,2,0,33,95330,37533,7709,50668,0
102,3186,773,419,590,28,0,166,801,10,204,113,217,214,330,1598,2554,5,13587,754,0,2,31,1,95330,37533,7710,50669,0
15,391,105,62,62,2,14,27,107,4,12,8,12,16,20,51,80,2,160,8,0,2,3,1,95330,37533,7711,50670,0
137,3416,77,34,69,0,0,8,77,3,24,16,29,27,45,114,213,1,387,21,0,2,2,39,95330,37533,7711,50671,0
137,3416,712,438,573,51,9,84,763,14,102,71,128,116,199,733,1364,8,11988,666,0,2,2,39,95340,37534,7711,50672,0
65,2176,53,23,39,0,0,13,53,2,8,4,8,10,12,26,39,1,39,2,0,2,44,0,95340,37534,7711,50673,0
65,2176,515,298,307,33,80,99,548,12,63,44,77,75,121,419,753,7,5527,307,0,2,44,0,95350,37534,7711,50674,0
294,6559,72,33,56,0,4,12,72,1,1,1,1,2,2,0,2,0,1,0,0,2,14,31,95350,37534,7711,50675,0
294,6559,1454,835,1044,76,110,219,1530,17,275,158,296,292,454,2297,3718,9,34017,1889,1,2,14,31,95360,37535,7711,50676,0
28,617,2,2,2,0,0,0,2,0,0,0,0,0,0,0,0,0,0,0,0,2,5,1,95360,37535,7711,50676,0
28,617,99,48,90,1,3,5,100,0,0,0,0,0,0,0,0,0,0,0,0,2,5,1,95360,37536,7711,50677,0
28,617,8,5,5,2,0,1,10,0,0,0,0,0,0,0,0,0,0,0,0,2,5,1,95360,37536,7711,50678,0
28,617,1217,716,841,84,126,174,1301,14,185,118,215,199,333,1446,2542,8,20687,1149,0,2,5,1,95370,37538,7711,50679,0
28,617,160,89,115,0,13,31,160,7,15,11,17,22,28,78,124,3,495,27,0,2,5,1,95370,37538,7711,50680,0
28,617,10,10,9,9,0,0,19,0,0,0,0,0,0,0,0,0,0,0,0,2,5,1,95370,37538,7712,50681,0
28,617,173,84,99,8,29,36,181,5,12,7,13,17,20,54,81,2,221,12,0,2,5,1,95370,37539,7712,50682,0
28,617,3,1,1,3,0,0,6,0,0,0,0,0,0,0,0,0,0,0,0,2,5,1,95370,37539,7712,50683,0
54,672,647,139,84,35,284,233,682,0,0,0,0,0,0,0,0,0,0,0,0,2,9,1,95370,37539,7712,50684,0
117,2982,773,422,505,30,103,129,803,14,77,46,83,91,129,535,839,7,6334,351,0,2,2,1,95380,37540,7713,50685,0
137,3440,77,34,69,0,0,8,77,3,24,16,29,27,45,114,213,1,387,21,0,2,4,1,95380,37540,7713,50686,0
137,3440,712,438,573,51,9,84,763,14,102,71,128,116,199,733,1364,8,11988,666,0,2,4,1,95390,37541,7713,50687,0
301,6452,1943,715,1694,26,18,214,1969,12,185,120,237,197,357,1436,2721,7,20915,1161,0,2,1,1,95390,37543,7713,50688,0
301,6452,1168,838,957,57,25,144,1225,19,348,224,416,367,640,3018,5452,11,61921,3440,1,2,1,1,95400,37545,7713,50689,0
23,646,601,196,481,2,23,85,603,8,63,36,72,71,108,400,664,4,3036,168,0,2,3,1,95400,37545,7713,50690,0
23,646,156,79,106,5,16,28,161,5,14,8,15,19,23,64,97,2,261,14,0,2,3,1,95400,37545,7713,50691,0
28,617,2,2,2,0,0,0,2,0,0,0,0,0,0,0,0,0,0,0,0,2,5,1,95400,37545,7713,50691,0
28,617,99,48,90,1,3,5,100,0,0,0,0,0,0,0,0,0,0,0,0,2,5,1,95400,37546,7713,50692,0
28,617,8,5,5,2,0,1,10,0,0,0,0,0,0,0,0,0,0,0,0,2,5,1,95400,37546,7713,50693,0
28,617,1217,716,841,84,126,174,1301,14,185,118,215,199,333,1446,2542,8,20687,1149,0,2,5,1,95410,37548,7713,50694,0
28,617,160,89,115,0,13,31,160,7,15,11,17,22,28,78,124,3,495,27,0,2,5,1,95410,37548,7713,50695,0
28,617,10,10,9,9,0,0,19,0,0,0,0,0,0,0,0,0,0,0,0,2,5,1,95410,37548,7714,50696,0
28,617,173,84,99,8,29,36,181,5,12,7,13,17,20,54,81,2,221,12,0,2,5,1,95410,37549,7714,50697,0
28,617,3,1,1,3,0,0,6,0,0,0,0,0,0,0,0,0,0,0,0,2,5,1,95410,37549,7714,50698,0
54,672,647,139,84,35,284,233,682,0,0,0,0,0,0,0,0,0,0,0,0,2,9,1,95410,37549,7714,50699,0
117,2982,773,422,505,30,103,129,803,14,77,46,83,91,129,535,839,7,6334,351,0,2,2,1,95420,37550,7715,50700,0
137,3440,77,34,69,0,0,8,77,3,24,16,29,27,45,114,213,1,387,21,0,2,4,1,95420,37550,7715,50701,0
137,3440,712,438,573,51,9,84,763,14,102,71,128,116,199,733,1364,8,11988,666,0,2,4,1,95430,37551,7715,50702,0
301,6452,1943,715,1694,26,18,214,1969,12,185,120,237,197,357,1436,2721,7,20915,1161,0,2,1,1,95430,37553,7715,50703,0
301,6452,1168,838,957,57,25,144,1225,19,348,224,416,367,640,3018,5452,11,61921,3440,1,2,1,1,95440,37555,7715,50704,0
23,646,601,196,481,2,23,85,603,8,63,36,72,71,108,400,664,4,3036,168,0,2,3,1,95440,37555,7715,50705,0
23,646,156,79,106,5,16,28,161,5,14,8,15,19,23,64,97,2,261,14,0,2,3,1,95440,37555,7715,50706,0
294,6572,72,33,56,0,4,12,72,1,1,1,1,2,2,0,2,0,1,0,0,2,15,12,95440,37555,7715,50707,0
294,6572,1454,835,1044,76,110,219,1530,17,275,158,296,292,454,2297,3718,9,34017,1889,1,2,15,12,95450,37556,7715,50708,0
262,6280,4293,999,3693,19,54,507,4312,9,155,88,170,164,258,1156,1898,4,9368,520,0,2,1,2,95450,37558,7715,50709,0
262,6280,1482,859,1002,125,135,219,1607,16,219,134,251,235,385,1766,3032,9,27804,1544,1,2,1,2,95460,37559,7715,50710,0
53,1539,207,111,150,11,0,50,218,5,26,19,36,31,55,133,272,3,943,52,0,2,5,5,95460,37559,7715,50711,0
53,1539,410,198,237,31,55,97,441,11,63,38,72,74,110,414,683,6,4293,238,0,2,5,5,95470,37560,7716,50712,0
262,6280,4293,999,3693,19,54,507,4312,9,155,88,170,164,258,1156,1898,4,9368,520,0,2,1,2,95470,37562,7716,50713,0
262,6280,1482,859,1002,125,135,219,1607,16,219,134,251,235,385,1766,3032,9,27804,1544,1,2,1,2,95480,37563,7716,50714,0
53,1539,207,111,150,11,0,50,218,5,26,19,36,31,55,133,272,3,943,52,0,2,5,5,95480,37563,7716,50715,0
53,1539,410,198,237,31,55,97,441,11,63,38,72,74,110,414,683,6,4293,238,0,2,5,5,95490,37564,7717,50716,0
294,6572,72,33,56,0,4,12,72,1,1,1,1,2,2,0,2,0,1,0,0,2,15,12,95490,37564,7717,50717,0
294,6572,1454,835,1044,76,110,219,1530,17,275,158,296,292,454,2297,3718,9,34017,1889,1,2,15,12,95500,37565,7717,50718,0
7,464,382,65,130,157,2,92,539,4,10,5,10,14,15,41,57,2,114,6,0,2,1,1,95500,37566,7718,50719,0
294,6565,72,33,56,0,4,12,72,1,1,1,1,2,2,0,2,0,1,0,0,2,1,1,95500,37566,7718,50720,0
294,6565,1454,835,1044,76,110,219,1530,17,275,158,296,292,454,2297,3718,9,34017,1889,1,2,1,1,95510,37567,7718,50721,0
124,3469,77,34,69,0,0,8,77,3,24,16,29,27,45,114,213,1,387,21,0,2,12,7,95510,37567,7718,50722,0
124,3469,712,438,573,51,9,84,763,14,102,71,128,116,199,733,1364,8,11988,666,0,2,12,7,95520,37568,7718,50723,0
124,3511,77,34,69,0,0,8,77,3,24,16,29,27,45,114,213,1,387,21,0,2,8,3,95520,37568,7718,50724,0
124,3511,712,438,573,51,9,84,763,14,102,71,128,116,199,733,1364,8,11988,666,0,2,8,3,95530,37569,7718,50725,0
5,319,77,34,69,0,0,8,77,3,24,16,29,27,45,114,213,1,387,21,0,2,25,0,95530,37569,7718,50726,0
3,97,35,12,22,4,5,6,39,1,2,1,2,3,3,2,4,0,2,0,0,2,6,0,95530,37569,7718,50727,0
63,2130,773,419,590,28,0,166,801,10,204,113,217,214,330,1598,2554,5,13587,754,0,2,8,0,95530,37569,7719,50728,1
63,2130,421,273,302,44,34,57,465,17,81,59,107,98,166,583,1098,11,12329,684,0,2,8,0,95530,37569,7720,50729,1
52,1508,207,111,150,11,0,50,218,5,26,19,36,31,55,133,272,3,943,52,0,2,4,8,95530,37569,7720,50730,1
52,1508,410,198,237,31,55,97,441,11,63,38,72,74,110,414,683,6,4293,238,0,2,4,8,95540,37570,7721,50731,1
262,6282,4293,999,3693,19,54,507,4312,9,155,88,170,164,258,1156,1898,4,9368,520,0,2,1,1,95540,37572,7721,50732,1
262,6282,1482,859,1002,125,135,219,1607,16,219,134,251,235,385,1766,3032,9,27804,1544,1,2,1,1,95550,37573,7721,50733,1
69,1502,402,202,227,24,74,80,426,12,52,33,61,64,94,339,564,7,3969,220,0,2,1,1,95550,37574,7721,50734,1
65,2178,53,23,39,0,0,13,53,2,8,4,8,10,12,26,39,1,39,2,0,2,1,1,95550,37574,7721,50735,1
65,2178,515,298,307,33,80,99,548,12,63,44,77,75,121,419,753,7,5527,307,0,2,1,1,95560,37574,7721,50736,1
294,6567,72,33,56,0,4,12,72,1,1,1,1,2,2,0,2,0,1,0,0,2,1,1,95560,37574,7721,50737,1
294,6567,1454,835,1044,76,110,219,1530,17,275,158,296,292,454,2297,3718,9,34017,1889,1,2,1,1,95570,37575,7721,50738,1
187,5537,182,127,129,0,0,53,182,5,39,21,42,44,63,217,343,2,926,51,0,2,2,0,95570,37575,7722,50739,0
187,5537,1165,710,800,67,119,181,1232,18,243,153,282,261,435,2000,3492,10,36473,2026,1,2,2,0,95580,37575,7723,50740,0
103,3235,773,419,590,28,0,166,801,10,204,113,217,214,330,1598,2554,5,13587,754,0,2,8,0,95580,37575,7724,50741,0
63,2124,773,419,590,28,0,166,801,10,204,113,217,214,330,1598,2554,5,13587,754,0,2,5,6,95580,37575,7725,50742,0
63,2124,421,273,302,44,34,57,465,17,81,59,107,98,166,583,1098,11,12329,684,0,2,5,6,95580,37575,7726,50743,0
52,1512,207,111,150,11,0,50,218,5,26,19,36,31,55,133,272,3,943,52,0,2,2,2,95580,37575,7726,50744,0
52,1512,410,198,237,31,55,97,441,11,63,38,72,74,110,414,683,6,4293,238,0,2,2,2,95590,37576,7727,50745,0
51,1472,207,111,150,11,0,50,218,5,26,19,36,31,55,133,272,3,943,52,0,2,0,7,95590,37576,7727,50746,0
51,1472,410,198,237,31,55,97,441,11,63,38,72,74,110,414,683,6,4293,238,0,2,0,7,95600,37577,7728,50747,0
27,637,2,2,2,0,0,0,2,0,0,0,0,0,0,0,0,0,0,0,0,2,6,4,95600,37577,7728,50747,0
27,637,99,48,90,1,3,5,100,0,0,0,0,0,0,0,0,0,0,0,0,2,6,4,95600,37578,7728,50748,0
27,637,8,5,5,2,0,1,10,0,0,0,0,0,0,0,0,0,0,0,0,2,6,4,95600,37578,7728,50749,0
27,637,1217,716,841,84,126,174,1301,14,185,118,215,199,333,1446,2542,8,20687,1149,0,2,6,4,95610,37580,7728,50750,0
27,637,160,89,115,0,13,31,160,7,15,11,17,22,28,78,124,3,495,27,0,2,6,4,95610,37580,7728,50751,0
27,637,10,10,9,9,0,0,19,0,0,0,0,0,0,0,0,0,0,0,0,2,6,4,95610,37580,7729,50752,0
27,637,173,84,99,8,29,36,181,5,12,7,13,17,20,54,81,2,221,12,0,2,6,4,95610,37581,7729,50753,0
27,637,3,1,1,3,0,0,6,0,0,0,0,0,0,0,0,0,0,0,0,2,6,4,95610,37581,7729,50754,0
244,5161,2,2,2,0,0,0,2,0,0,0,0,0,0,0,0,0,0,0,0,2,4,1,95610,37581,7729,50754,0
244,5161,99,48,90,1,3,5,100,0,0,0,0,0,0,0,0,0,0,0,0,2,4,1,95610,37582,7729,50755,0
244,5161,8,5,5,2,0,1,10,0,0,0,0,0,0,0,0,0,0,0,0,2,4,1,95610,37582,7729,50756,0
244,5161,1217,716,841,84,126,174,1301,14,185,118,215,199,333,1446,2542,8,20687,1149,0,2,4,1,95620,37584,7729,50757,0
244,5161,160,89,115,0,13,31,160,7,15,11,17,22,28,78,124,3,495,27,0,2,4,1,95620,37584,7729,50758,0
244,5161,10,10,9,9,0,0,19,0,0,0,0,0,0,0,0,0,0,0,0,2,4,1,95620,37584,7730,50759,0
244,5161,173,84,99,8,29,36,181,5,12,7,13,17,20,54,81,2,221,12,0,2,4,1,95620,37585,7730,50760,0
244,5161,3,1,1,3,0,0,6,0,0,0,0,0,0,0,0,0,0,0,0,2,4,1,95620,37585,7730,50761,0
127,5438,1450,624,1228,12,26,181,1462,14,306,186,354,320,540,2580,4493,8,36391,2021,1,2,13,4,95620,37587,7731,50762,0
106,4668,1289,550,1043,56,32,155,1345,10,167,93,185,177,278,1266,2075,5,11498,638,0,2,2,0,95620,37589,7732,50763,0
18,430,127,75,83,2,11,30,129,4,14,7,14,18,21,61,87,2,175,9,0,2,7,0,95620,37589,7732,50764,0
18,430,652,304,544,16,6,88,668,6,89,51,101,95,152,591,998,3,3399,188,0,2,7,0,95620,37590,7732,50765,0
18,430,2,2,2,0,0,0,2,0,0,0,0,0,0,0,0,0,0,0,0,2,7,0,95620,37590,7732,50765,0
18,430,8,5,5,0,0,3,8,0,0,0,0,0,0,0,0,0,0,0,0,2,7,0,95620,37590,7732,50766,0
18,430,2,2,2,0,0,0,2,0,0,0,0,0,0,0,0,0,0,0,0,2,7,0,95620,37590,7732,50766,0
18,430,14,8,8,0,0,6,14,0,0,0,0,0,0,0,0,0,0,0,0,2,7,0,95620,37590,7732,50767,0
18,430,6,4,4,0,0,2,6,0,0,0,0,0,0,0,0,0,0,0,0,2,7,0,95620,37590,7732,50768,0
18,430,6,4,4,0,0,2,6,1,2,1,2,3,3,2,4,0,2,0,0,2,7,0,95620,37590,7732,50769,0
18,430,6,4,4,0,0,2,6,0,0,0,0,0,0,0,0,0,0,0,0,2,7,0,95620,37590,7732,50770,0
18,430,7,5,5,0,0,2,7,0,0,0,0,0,0,0,0,0,0,0,0,2,7,0,95620,37590,7732,50771,0
18,430,6,4,4,0,0,2,6,0,0,0,0,0,0,0,0,0,0,0,0,2,7,0,95620,37590,7732,50772,0
18,430,10,6,6,0,0,4,10,0,0,0,0,0,0,0,0,0,0,0,0,2,7,0,95620,37590,7732,50773,0
18,430,1,1,1,0,0,0,1,0,0,0,0,0,0,0,0,0,0,0,0,2,7,0,95620,37590,7732,50773,0
18,430,14,10,10,0,0,4,14,1,1,1,1,2,2,0,2,0,1,0,0,2,7,0,95620,37590,7732,50774,0
18,430,46,26,30,3,0,12,49,3,6,3,6,9,9,20,28,1,42,2,0,2,7,0,95630,37590,7732,50775,0
8,275,74,35,59,1,0,14,75,3,14,7,14,17,21,58,85,1,128,7,0,2,1,0,95630,37591,7732,50776,0
114,5840,1523,757,1297,19,12,193,1542,12,193,117,230,205,347,1508,2664,7,19053,1058,0,2,1,0,95640,37593,7732,50777,0
120,7110,1943,715,1694,26,18,214,1969,12,185,120,237,197,357,1436,2721,7,20915,1161,0,2,2,0,95640,37595,7732,50778,0
3,97,35,12,22,4,5,6,39,1,2,1,2,3,3,2,4,0,2,0,0,2,6,0,95640,37595,7732,50779,0
187,5537,182,127,129,0,0,53,182,5,39,21,42,44,63,217,343,2,926,51,0,2,2,0,95640,37595,7733,50780,0
187,5537,1165,710,800,67,119,181,1232,18,243,153,282,261,435,2000,3492,10,36473,2026,1,2,2,0,95650,37595,7734,50781,0
63,2124,773,419,590,28,0,166,801,10,204,113,217,214,330,1598,2554,5,13587,754,0,2,13,6,95650,37595,7735,50782,0
63,2124,421,273,302,44,34,57,465,17,81,59,107,98,166,583,1098,11,12329,684,0,2,13,6,95650,37595,7736,50783,0
51,1472,207,111,150,11,0,50,218,5,26,19,36,31,55,133,272,3,943,52,0,2,0,11,95650,37595,7736,50784,0
51,1472,410,198,237,31,55,97,441,11,63,38,72,74,110,414,683,6,4293,238,0,2,0,11,95660,37596,7737,50785,0
262,6282,4293,999,3693,19,54,507,4312,9,155,88,170,164,258,1156,1898,4,9368,520,0,2,1,1,95660,37598,7737,50786,0
262,6282,1482,859,1002,125,135,219,1607,16,219,134,251,235,385,1766,3032,9,27804,1544,1,2,1,1,95670,37599,7737,50787,0
69,1502,402,202,227,24,74,80,426,12,52,33,61,64,94,339,564,7,3969,220,0,2,1,1,95670,37600,7737,50788,0
65,2178,53,23,39,0,0,13,53,2,8,4,8,10,12,26,39,1,39,2,0,2,1,1,95670,37600,7737,50789,0
65,2178,515,298,307,33,80,99,548,12,63,44,77,75,121,419,753,7,5527,307,0,2,1,1,95680,37600,7737,50790,0
294,6567,72,33,56,0,4,12,72,1,1,1,1,2,2,0,2,0,1,0,0,2,1,1,95680,37600,7737,50791,0
294,6567,1454,835,1044,76,110,219,1530,17,275,158,296,292,454,2297,3718,9,34017,1889,1,2,1,1,95690,37601,7737,50792,0
103,3235,773,419,590,28,0,166,801,10,204,113,217,214,330,1598,2554,5,13587,754,0,2,8,0,95690,37601,7738,50793,0
225,6476,722,423,573,19,0,135,741,12,172,101,199,184,300,1320,2257,6,15668,870,0,2,4,4,95690,37603,7738,50795,0
225,6476,1508,847,911,44,250,301,1552,14,148,88,169,162,257,1120,1886,7,15077,837,0,2,4,4,95690,37604,7739,50796,0
119,3209,1523,757,1297,19,12,193,1542,12,193,117,230,205,347,1508,2664,7,19053,1058,0,2,1,1,95700,37606,7739,50797,0
119,3209,701,378,504,33,58,109,734,13,110,68,126,123,194,794,1346,7,10027,557,0,2,1,1,95700,37607,7740,50798,0
124,3511,77,34,69,0,0,8,77,3,24,16,29,27,45,114,213,1,387,21,0,2,20,10,95700,37607,7740,50799,0
124,3511,712,438,573,51,9,84,763,14,102,71,128,116,199,733,1364,8,11988,666,0,2,20,10,95710,37608,7740,50800,0
5,319,77,34,69,0,0,8,77,3,24,16,29,27,45,114,213,1,387,21,0,2,25,0,95710,37608,7740,50801,0
