complexity,token_count,loc,lloc,sloc,comments,multi,blank,code_comment,h1,h2,N1,N2,vocabulary,length,calculated_length,volume,difficulty,effort,time,bugs,defect
19,473,182,127,129,0,0,53,182,5,39,21,42,44,63,217,343,2,926,51,0,1
19,473,1165,710,800,67,119,181,1232,18,243,153,282,261,435,2000,3492,10,36473,2026,1,1
12,234,1392,870,1177,35,17,170,1427,14,494,280,531,508,811,4473,7289,7,54850,3047,2,1
62,1372,773,419,590,28,0,166,801,10,204,113,217,214,330,1598,2554,5,13587,754,0,1
62,1372,421,273,302,44,34,57,465,17,81,59,107,98,166,583,1098,11,12329,684,0,1
9,297,182,127,129,0,0,53,182,5,39,21,42,44,63,217,343,2,926,51,0,1
43,971,1392,870,1177,35,17,170,1427,14,494,280,531,508,811,4473,7289,7,54850,3047,2,1
40,1319,773,419,590,28,0,166,801,10,204,113,217,214,330,1598,2554,5,13587,754,0,1
1,28,127,75,83,2,11,30,129,4,14,7,14,18,21,61,87,2,175,9,0,1
1,28,652,304,544,16,6,88,668,6,89,51,101,95,152,591,998,3,3399,188,0,1
1,28,2,2,2,0,0,0,2,0,0,0,0,0,0,0,0,0,0,0,0,1
1,28,8,5,5,0,0,3,8,0,0,0,0,0,0,0,0,0,0,0,0,1
1,28,14,8,8,0,0,6,14,0,0,0,0,0,0,0,0,0,0,0,0,1
1,28,6,4,4,0,0,2,6,0,0,0,0,0,0,0,0,0,0,0,0,1
1,28,6,4,4,0,0,2,6,1,2,1,2,3,3,2,4,0,2,0,0,1
1,28,7,5,5,0,0,2,7,0,0,0,0,0,0,0,0,0,0,0,0,1
1,28,10,6,6,0,0,4,10,0,0,0,0,0,0,0,0,0,0,0,0,1
1,28,1,1,1,0,0,0,1,0,0,0,0,0,0,0,0,0,0,0,0,1
1,28,14,10,10,0,0,4,14,1,1,1,1,2,2,0,2,0,1,0,0,1
1,28,46,26,30,3,0,12,49,3,6,3,6,9,9,20,28,1,42,2,0,1
307,7640,1455,414,1257,16,76,112,1471,5,41,23,46,46,69,231,381,2,1069,59,0,1
307,7640,669,365,481,22,61,110,691,15,103,63,122,118,185,747,1273,8,11311,628,0,1
25,593,1455,414,1257,16,76,112,1471,5,41,23,46,46,69,231,381,2,1069,59,0,1
71,1529,127,75,83,2,11,30,129,4,14,7,14,18,21,61,87,2,175,9,0,1
71,1529,652,304,544,16,6,88,668,6,89,51,101,95,152,591,998,3,3399,188,0,1
71,1529,2,2,2,0,0,0,2,0,0,0,0,0,0,0,0,0,0,0,0,1
71,1529,8,5,5,0,0,3,8,0,0,0,0,0,0,0,0,0,0,0,0,1
71,1529,14,8,8,0,0,6,14,0,0,0,0,0,0,0,0,0,0,0,0,1
71,1529,6,4,4,0,0,2,6,0,0,0,0,0,0,0,0,0,0,0,0,1
71,1529,6,4,4,0,0,2,6,1,2,1,2,3,3,2,4,0,2,0,0,1
71,1529,7,5,5,0,0,2,7,0,0,0,0,0,0,0,0,0,0,0,0,1
71,1529,10,6,6,0,0,4,10,0,0,0,0,0,0,0,0,0,0,0,0,1
71,1529,1,1,1,0,0,0,1,0,0,0,0,0,0,0,0,0,0,0,0,1
71,1529,14,10,10,0,0,4,14,1,1,1,1,2,2,0,2,0,1,0,0,1
71,1529,46,26,30,3,0,12,49,3,6,3,6,9,9,20,28,1,42,2,0,1
35,478,282,196,195,3,0,86,285,8,130,71,141,138,212,936,1507,4,6538,363,0,1
1,96,13,10,10,0,0,3,13,1,2,1,2,3,3,2,4,0,2,0,0,1
7,111,44,19,17,0,16,11,44,3,14,7,14,17,21,58,85,1,128,7,0,1
4,431,652,304,544,16,6,88,668,6,89,51,101,95,152,591,998,3,3399,188,0,1
19,557,14,9,9,0,0,5,14,0,0,0,0,0,0,0,0,0,0,0,0,1
19,557,16,9,9,0,0,7,16,0,0,0,0,0,0,0,0,0,0,0,0,1
17,403,1513,682,1277,25,13,200,1538,11,199,116,219,210,335,1557,2584,6,15641,868,0,1
17,403,819,519,539,24,98,155,843,15,96,57,106,111,163,690,1107,8,9171,509,0,1
14,747,1513,682,1277,25,13,200,1538,11,199,116,219,210,335,1557,2584,6,15641,868,0,1
7,179,1450,624,1228,12,26,181,1462,14,306,186,354,320,540,2580,4493,8,36391,2021,1,1
4,116,447,308,343,6,5,95,453,7,96,59,111,103,170,651,1136,4,4600,255,0,1
4,116,322,174,179,16,74,51,338,10,41,26,46,51,72,252,408,5,2291,127,0,1
23,383,1450,624,1228,12,26,181,1462,14,306,186,354,320,540,2580,4493,8,36391,2021,1,1
7,305,1513,682,1277,25,13,200,1538,11,199,116,219,210,335,1557,2584,6,15641,868,0,1
7,305,819,519,539,24,98,155,843,15,96,57,106,111,163,690,1107,8,9171,509,0,1
9,378,15,9,9,0,0,6,15,0,0,0,0,0,0,0,0,0,0,0,0,1
158,2888,1338,495,1086,10,64,173,1348,11,122,82,157,133,239,883,1686,7,11934,663,0,1
6,264,207,111,150,11,0,50,218,5,26,19,36,31,55,133,272,3,943,52,0,1
6,264,410,198,237,31,55,97,441,11,63,38,72,74,110,414,683,6,4293,238,0,1
30,664,1457,730,1242,11,6,188,1468,10,292,166,329,302,495,2424,4078,5,22973,1276,1,1
30,664,74,35,59,1,0,14,75,3,14,7,14,17,21,58,85,1,128,7,0,1
30,664,245,125,200,5,7,34,250,7,30,17,34,37,51,166,265,3,1053,58,0,1
4,109,1455,414,1257,16,76,112,1471,5,41,23,46,46,69,231,381,2,1069,59,0,1
4,109,669,365,481,22,61,110,691,15,103,63,122,118,185,747,1273,8,11311,628,0,1
6,202,256,139,192,9,7,47,265,4,23,12,24,27,36,112,171,2,357,19,0,1
1,129,1457,730,1242,11,6,188,1468,10,292,166,329,302,495,2424,4078,5,22973,1276,1,1
53,870,373,158,315,8,0,51,381,5,76,44,79,81,123,486,779,2,2026,112,0,1
126,3063,1943,715,1694,26,18,214,1969,12,185,120,237,197,357,1436,2721,7,20915,1161,0,1
126,3063,1168,838,957,57,25,144,1225,19,348,224,416,367,640,3018,5452,11,61921,3440,1,1
4,217,207,111,150,11,0,50,218,5,26,19,36,31,55,133,272,3,943,52,0,1
7,467,1457,730,1242,11,6,188,1468,10,292,166,329,302,495,2424,4078,5,22973,1276,1,1
4,184,1455,414,1257,16,76,112,1471,5,41,23,46,46,69,231,381,2,1069,59,0,1
35,2376,373,158,315,8,0,51,381,5,76,44,79,81,123,486,779,2,2026,112,0,1
67,1751,477,336,357,30,23,73,507,16,194,134,250,210,384,1538,2962,10,30538,1696,0,1
12,285,1523,757,1297,19,12,193,1542,12,193,117,230,205,347,1508,2664,7,19053,1058,0,1
12,285,701,378,504,33,58,109,734,13,110,68,126,123,194,794,1346,7,10027,557,0,1
1,85,13,10,10,0,0,3,13,1,2,1,2,3,3,2,4,0,2,0,0,1
4,403,652,304,544,16,6,88,668,6,89,51,101,95,152,591,998,3,3399,188,0,1
4,89,1943,715,1694,26,18,214,1969,12,185,120,237,197,357,1436,2721,7,20915,1161,0,1
153,2747,1338,495,1086,10,64,173,1348,11,122,82,157,133,239,883,1686,7,11934,663,0,1
69,1398,1457,730,1242,11,6,188,1468,10,292,166,329,302,495,2424,4078,5,22973,1276,1,1
69,1398,74,35,59,1,0,14,75,3,14,7,14,17,21,58,85,1,128,7,0,1
69,1398,245,125,200,5,7,34,250,7,30,17,34,37,51,166,265,3,1053,58,0,1
40,618,373,158,315,8,0,51,381,5,76,44,79,81,123,486,779,2,2026,112,0,1
74,1856,1943,715,1694,26,18,214,1969,12,185,120,237,197,357,1436,2721,7,20915,1161,0,1
74,1856,1168,838,957,57,25,144,1225,19,348,224,416,367,640,3018,5452,11,61921,3440,1,1
42,2602,1457,730,1242,11,6,188,1468,10,292,166,329,302,495,2424,4078,5,22973,1276,1,1
4,190,1455,414,1257,16,76,112,1471,5,41,23,46,46,69,231,381,2,1069,59,0,1
34,2129,373,158,315,8,0,51,381,5,76,44,79,81,123,486,779,2,2026,112,0,1
40,612,373,158,315,8,0,51,381,5,76,44,79,81,123,486,779,2,2026,112,0,0
73,1454,1457,730,1242,11,6,188,1468,10,292,166,329,302,495,2424,4078,5,22973,1276,1,0
73,1454,74,35,59,1,0,14,75,3,14,7,14,17,21,58,85,1,128,7,0,0
73,1454,245,125,200,5,7,34,250,7,30,17,34,37,51,166,265,3,1053,58,0,0
44,2661,1457,730,1242,11,6,188,1468,10,292,166,329,302,495,2424,4078,5,22973,1276,1,0
74,1467,1457,730,1242,11,6,188,1468,10,292,166,329,302,495,2424,4078,5,22973,1276,1,1
74,1467,74,35,59,1,0,14,75,3,14,7,14,17,21,58,85,1,128,7,0,1
74,1467,245,125,200,5,7,34,250,7,30,17,34,37,51,166,265,3,1053,58,0,1
153,2741,1338,495,1086,10,64,173,1348,11,122,82,157,133,239,883,1686,7,11934,663,0,0
17,403,1513,682,1277,25,13,200,1538,11,199,116,219,210,335,1557,2584,6,15641,868,0,0
17,403,819,519,539,24,98,155,843,15,96,57,106,111,163,690,1107,8,9171,509,0,0
5,104,1943,715,1694,26,18,214,1969,12,185,120,237,197,357,1436,2721,7,20915,1161,0,0
44,2697,1457,730,1242,11,6,188,1468,10,292,166,329,302,495,2424,4078,5,22973,1276,1,0
74,1599,127,75,83,2,11,30,129,4,14,7,14,18,21,61,87,2,175,9,0,0
74,1599,652,304,544,16,6,88,668,6,89,51,101,95,152,591,998,3,3399,188,0,0
74,1599,2,2,2,0,0,0,2,0,0,0,0,0,0,0,0,0,0,0,0,0
74,1599,8,5,5,0,0,3,8,0,0,0,0,0,0,0,0,0,0,0,0,0
74,1599,14,8,8,0,0,6,14,0,0,0,0,0,0,0,0,0,0,0,0,0
74,1599,6,4,4,0,0,2,6,0,0,0,0,0,0,0,0,0,0,0,0,0
74,1599,6,4,4,0,0,2,6,1,2,1,2,3,3,2,4,0,2,0,0,0
74,1599,7,5,5,0,0,2,7,0,0,0,0,0,0,0,0,0,0,0,0,0
74,1599,10,6,6,0,0,4,10,0,0,0,0,0,0,0,0,0,0,0,0,0
74,1599,1,1,1,0,0,0,1,0,0,0,0,0,0,0,0,0,0,0,0,0
74,1599,14,10,10,0,0,4,14,1,1,1,1,2,2,0,2,0,1,0,0,0
74,1599,46,26,30,3,0,12,49,3,6,3,6,9,9,20,28,1,42,2,0,0
5,535,652,304,544,16,6,88,668,6,89,51,101,95,152,591,998,3,3399,188,0,0
74,1848,1943,715,1694,26,18,214,1969,12,185,120,237,197,357,1436,2721,7,20915,1161,0,0
74,1848,1168,838,957,57,25,144,1225,19,348,224,416,367,640,3018,5452,11,61921,3440,1,0
20,484,182,127,129,0,0,53,182,5,39,21,42,44,63,217,343,2,926,51,0,0
20,484,1165,710,800,67,119,181,1232,18,243,153,282,261,435,2000,3492,10,36473,2026,1,0
154,2757,1338,495,1086,10,64,173,1348,11,122,82,157,133,239,883,1686,7,11934,663,0,0
20,486,182,127,129,0,0,53,182,5,39,21,42,44,63,217,343,2,926,51,0,0
20,486,1165,710,800,67,119,181,1232,18,243,153,282,261,435,2000,3492,10,36473,2026,1,0
10,344,182,127,129,0,0,53,182,5,39,21,42,44,63,217,343,2,926,51,0,0
75,1511,1457,730,1242,11,6,188,1468,10,292,166,329,302,495,2424,4078,5,22973,1276,1,0
75,1511,74,35,59,1,0,14,75,3,14,7,14,17,21,58,85,1,128,7,0,0
75,1511,245,125,200,5,7,34,250,7,30,17,34,37,51,166,265,3,1053,58,0,0
75,1611,127,75,83,2,11,30,129,4,14,7,14,18,21,61,87,2,175,9,0,1
75,1611,652,304,544,16,6,88,668,6,89,51,101,95,152,591,998,3,3399,188,0,1
75,1611,2,2,2,0,0,0,2,0,0,0,0,0,0,0,0,0,0,0,0,1
75,1611,8,5,5,0,0,3,8,0,0,0,0,0,0,0,0,0,0,0,0,1
75,1611,14,8,8,0,0,6,14,0,0,0,0,0,0,0,0,0,0,0,0,1
75,1611,6,4,4,0,0,2,6,0,0,0,0,0,0,0,0,0,0,0,0,1
75,1611,6,4,4,0,0,2,6,1,2,1,2,3,3,2,4,0,2,0,0,1
75,1611,7,5,5,0,0,2,7,0,0,0,0,0,0,0,0,0,0,0,0,1
75,1611,10,6,6,0,0,4,10,0,0,0,0,0,0,0,0,0,0,0,0,1
75,1611,1,1,1,0,0,0,1,0,0,0,0,0,0,0,0,0,0,0,0,1
75,1611,14,10,10,0,0,4,14,1,1,1,1,2,2,0,2,0,1,0,0,1
75,1611,46,26,30,3,0,12,49,3,6,3,6,9,9,20,28,1,42,2,0,1
75,1516,1457,730,1242,11,6,188,1468,10,292,166,329,302,495,2424,4078,5,22973,1276,1,0
75,1516,74,35,59,1,0,14,75,3,14,7,14,17,21,58,85,1,128,7,0,0
75,1516,245,125,200,5,7,34,250,7,30,17,34,37,51,166,265,3,1053,58,0,0
63,1425,1457,730,1242,11,6,188,1468,10,292,166,329,302,495,2424,4078,5,22973,1276,1,1
63,1425,74,35,59,1,0,14,75,3,14,7,14,17,21,58,85,1,128,7,0,1
63,1425,245,125,200,5,7,34,250,7,30,17,34,37,51,166,265,3,1053,58,0,1
49,681,373,158,315,8,0,51,381,5,76,44,79,81,123,486,779,2,2026,112,0,1
44,2697,1457,730,1242,11,6,188,1468,10,292,166,329,302,495,2424,4078,5,22973,1276,1,1
28,1795,373,158,315,8,0,51,381,5,76,44,79,81,123,486,779,2,2026,112,0,1
63,1425,1457,730,1242,11,6,188,1468,10,292,166,329,302,495,2424,4078,5,22973,1276,1,0
63,1425,74,35,59,1,0,14,75,3,14,7,14,17,21,58,85,1,128,7,0,0
63,1425,245,125,200,5,7,34,250,7,30,17,34,37,51,166,265,3,1053,58,0,0
62,1381,1457,730,1242,11,6,188,1468,10,292,166,329,302,495,2424,4078,5,22973,1276,1,0
62,1381,74,35,59,1,0,14,75,3,14,7,14,17,21,58,85,1,128,7,0,0
62,1381,245,125,200,5,7,34,250,7,30,17,34,37,51,166,265,3,1053,58,0,0
64,1421,1457,730,1242,11,6,188,1468,10,292,166,329,302,495,2424,4078,5,22973,1276,1,0
64,1421,74,35,59,1,0,14,75,3,14,7,14,17,21,58,85,1,128,7,0,0
64,1421,245,125,200,5,7,34,250,7,30,17,34,37,51,166,265,3,1053,58,0,0
63,1405,1457,730,1242,11,6,188,1468,10,292,166,329,302,495,2424,4078,5,22973,1276,1,0
63,1405,74,35,59,1,0,14,75,3,14,7,14,17,21,58,85,1,128,7,0,0
63,1405,245,125,200,5,7,34,250,7,30,17,34,37,51,166,265,3,1053,58,0,0
43,2647,1457,730,1242,11,6,188,1468,10,292,166,329,302,495,2424,4078,5,22973,1276,1,0
307,7644,1455,414,1257,16,76,112,1471,5,41,23,46,46,69,231,381,2,1069,59,0,0
307,7644,669,365,481,22,61,110,691,15,103,63,122,118,185,747,1273,8,11311,628,0,0
75,1589,127,75,83,2,11,30,129,4,14,7,14,18,21,61,87,2,175,9,0,0
75,1589,652,304,544,16,6,88,668,6,89,51,101,95,152,591,998,3,3399,188,0,0
75,1589,2,2,2,0,0,0,2,0,0,0,0,0,0,0,0,0,0,0,0,0
75,1589,8,5,5,0,0,3,8,0,0,0,0,0,0,0,0,0,0,0,0,0
75,1589,14,8,8,0,0,6,14,0,0,0,0,0,0,0,0,0,0,0,0,0
75,1589,6,4,4,0,0,2,6,0,0,0,0,0,0,0,0,0,0,0,0,0
75,1589,6,4,4,0,0,2,6,1,2,1,2,3,3,2,4,0,2,0,0,0
75,1589,7,5,5,0,0,2,7,0,0,0,0,0,0,0,0,0,0,0,0,0
75,1589,10,6,6,0,0,4,10,0,0,0,0,0,0,0,0,0,0,0,0,0
75,1589,1,1,1,0,0,0,1,0,0,0,0,0,0,0,0,0,0,0,0,0
75,1589,14,10,10,0,0,4,14,1,1,1,1,2,2,0,2,0,1,0,0,0
75,1589,46,26,30,3,0,12,49,3,6,3,6,9,9,20,28,1,42,2,0,0
20,491,182,127,129,0,0,53,182,5,39,21,42,44,63,217,343,2,926,51,0,0
20,491,1165,710,800,67,119,181,1232,18,243,153,282,261,435,2000,3492,10,36473,2026,1,0
12,236,1392,870,1177,35,17,170,1427,14,494,280,531,508,811,4473,7289,7,54850,3047,2,0
23,517,1513,682,1277,25,13,200,1538,11,199,116,219,210,335,1557,2584,6,15641,868,0,0
23,517,819,519,539,24,98,155,843,15,96,57,106,111,163,690,1107,8,9171,509,0,0
18,917,1513,682,1277,25,13,200,1538,11,199,116,219,210,335,1557,2584,6,15641,868,0,0
19,455,1513,682,1277,25,13,200,1538,11,199,116,219,210,335,1557,2584,6,15641,868,0,0
19,455,819,519,539,24,98,155,843,15,96,57,106,111,163,690,1107,8,9171,509,0,0
18,919,1513,682,1277,25,13,200,1538,11,199,116,219,210,335,1557,2584,6,15641,868,0,1
154,2757,1338,495,1086,10,64,173,1348,11,122,82,157,133,239,883,1686,7,11934,663,0,1
22,1090,1513,682,1277,25,13,200,1538,11,199,116,219,210,335,1557,2584,6,15641,868,0,1
23,1138,1513,682,1277,25,13,200,1538,11,199,116,219,210,335,1557,2584,6,15641,868,0,0
78,1665,127,75,83,2,11,30,129,4,14,7,14,18,21,61,87,2,175,9,0,1
78,1665,652,304,544,16,6,88,668,6,89,51,101,95,152,591,998,3,3399,188,0,1
78,1665,2,2,2,0,0,0,2,0,0,0,0,0,0,0,0,0,0,0,0,1
78,1665,8,5,5,0,0,3,8,0,0,0,0,0,0,0,0,0,0,0,0,1
78,1665,14,8,8,0,0,6,14,0,0,0,0,0,0,0,0,0,0,0,0,1
78,1665,6,4,4,0,0,2,6,0,0,0,0,0,0,0,0,0,0,0,0,1
78,1665,6,4,4,0,0,2,6,1,2,1,2,3,3,2,4,0,2,0,0,1
78,1665,7,5,5,0,0,2,7,0,0,0,0,0,0,0,0,0,0,0,0,1
78,1665,10,6,6,0,0,4,10,0,0,0,0,0,0,0,0,0,0,0,0,1
78,1665,1,1,1,0,0,0,1,0,0,0,0,0,0,0,0,0,0,0,0,1
78,1665,14,10,10,0,0,4,14,1,1,1,1,2,2,0,2,0,1,0,0,1
78,1665,46,26,30,3,0,12,49,3,6,3,6,9,9,20,28,1,42,2,0,1
6,609,652,304,544,16,6,88,668,6,89,51,101,95,152,591,998,3,3399,188,0,1
78,1680,127,75,83,2,11,30,129,4,14,7,14,18,21,61,87,2,175,9,0,0
78,1680,652,304,544,16,6,88,668,6,89,51,101,95,152,591,998,3,3399,188,0,0
78,1680,2,2,2,0,0,0,2,0,0,0,0,0,0,0,0,0,0,0,0,0
78,1680,8,5,5,0,0,3,8,0,0,0,0,0,0,0,0,0,0,0,0,0
78,1680,14,8,8,0,0,6,14,0,0,0,0,0,0,0,0,0,0,0,0,0
78,1680,6,4,4,0,0,2,6,0,0,0,0,0,0,0,0,0,0,0,0,0
78,1680,6,4,4,0,0,2,6,1,2,1,2,3,3,2,4,0,2,0,0,0
78,1680,7,5,5,0,0,2,7,0,0,0,0,0,0,0,0,0,0,0,0,0
78,1680,10,6,6,0,0,4,10,0,0,0,0,0,0,0,0,0,0,0,0,0
78,1680,1,1,1,0,0,0,1,0,0,0,0,0,0,0,0,0,0,0,0,0
78,1680,14,10,10,0,0,4,14,1,1,1,1,2,2,0,2,0,1,0,0,0
78,1680,46,26,30,3,0,12,49,3,6,3,6,9,9,20,28,1,42,2,0,0
79,1683,127,75,83,2,11,30,129,4,14,7,14,18,21,61,87,2,175,9,0,0
79,1683,652,304,544,16,6,88,668,6,89,51,101,95,152,591,998,3,3399,188,0,0
79,1683,2,2,2,0,0,0,2,0,0,0,0,0,0,0,0,0,0,0,0,0
79,1683,8,5,5,0,0,3,8,0,0,0,0,0,0,0,0,0,0,0,0,0
79,1683,14,8,8,0,0,6,14,0,0,0,0,0,0,0,0,0,0,0,0,0
79,1683,6,4,4,0,0,2,6,0,0,0,0,0,0,0,0,0,0,0,0,0
79,1683,6,4,4,0,0,2,6,1,2,1,2,3,3,2,4,0,2,0,0,0
79,1683,7,5,5,0,0,2,7,0,0,0,0,0,0,0,0,0,0,0,0,0
79,1683,10,6,6,0,0,4,10,0,0,0,0,0,0,0,0,0,0,0,0,0
79,1683,1,1,1,0,0,0,1,0,0,0,0,0,0,0,0,0,0,0,0,0
79,1683,14,10,10,0,0,4,14,1,1,1,1,2,2,0,2,0,1,0,0,0
79,1683,46,26,30,3,0,12,49,3,6,3,6,9,9,20,28,1,42,2,0,0
7,611,652,304,544,16,6,88,668,6,89,51,101,95,152,591,998,3,3399,188,0,0
1,85,13,10,10,0,0,3,13,1,2,1,2,3,3,2,4,0,2,0,0,0
7,571,652,304,544,16,6,88,668,6,89,51,101,95,152,591,998,3,3399,188,0,0
150,2630,1338,495,1086,10,64,173,1348,11,122,82,157,133,239,883,1686,7,11934,663,0,0
6,203,256,139,192,9,7,47,265,4,23,12,24,27,36,112,171,2,357,19,0,0
49,683,373,158,315,8,0,51,381,5,76,44,79,81,123,486,779,2,2026,112,0,0
74,1822,1943,715,1694,26,18,214,1969,12,185,120,237,197,357,1436,2721,7,20915,1161,0,0
74,1822,1168,838,957,57,25,144,1225,19,348,224,416,367,640,3018,5452,11,61921,3440,1,0
4,200,1455,414,1257,16,76,112,1471,5,41,23,46,46,69,231,381,2,1069,59,0,0
28,1715,373,158,315,8,0,51,381,5,76,44,79,81,123,486,779,2,2026,112,0,0
152,2651,1338,495,1086,10,64,173,1348,11,122,82,157,133,239,883,1686,7,11934,663,0,0
152,2651,1338,495,1086,10,64,173,1348,11,122,82,157,133,239,883,1686,7,11934,663,0,1
74,1822,1943,715,1694,26,18,214,1969,12,185,120,237,197,357,1436,2721,7,20915,1161,0,1
74,1822,1168,838,957,57,25,144,1225,19,348,224,416,367,640,3018,5452,11,61921,3440,1,1
4,200,1455,414,1257,16,76,112,1471,5,41,23,46,46,69,231,381,2,1069,59,0,1
61,1365,1457,730,1242,11,6,188,1468,10,292,166,329,302,495,2424,4078,5,22973,1276,1,0
61,1365,74,35,59,1,0,14,75,3,14,7,14,17,21,58,85,1,128,7,0,0
61,1365,245,125,200,5,7,34,250,7,30,17,34,37,51,166,265,3,1053,58,0,0
49,683,373,158,315,8,0,51,381,5,76,44,79,81,123,486,779,2,2026,112,0,1
74,1813,1943,715,1694,26,18,214,1969,12,185,120,237,197,357,1436,2721,7,20915,1161,0,1
74,1813,1168,838,957,57,25,144,1225,19,348,224,416,367,640,3018,5452,11,61921,3440,1,1
152,2659,1338,495,1086,10,64,173,1348,11,122,82,157,133,239,883,1686,7,11934,663,0,0
152,2655,1338,495,1086,10,64,173,1348,11,122,82,157,133,239,883,1686,7,11934,663,0,0
64,1432,1457,730,1242,11,6,188,1468,10,292,166,329,302,495,2424,4078,5,22973,1276,1,1
64,1432,74,35,59,1,0,14,75,3,14,7,14,17,21,58,85,1,128,7,0,1
64,1432,245,125,200,5,7,34,250,7,30,17,34,37,51,166,265,3,1053,58,0,1
44,2743,1457,730,1242,11,6,188,1468,10,292,166,329,302,495,2424,4078,5,22973,1276,1,1
62,1413,1457,730,1242,11,6,188,1468,10,292,166,329,302,495,2424,4078,5,22973,1276,1,0
62,1413,74,35,59,1,0,14,75,3,14,7,14,17,21,58,85,1,128,7,0,0
62,1413,245,125,200,5,7,34,250,7,30,17,34,37,51,166,265,3,1053,58,0,0
44,2833,1457,730,1242,11,6,188,1468,10,292,166,329,302,495,2424,4078,5,22973,1276,1,0
29,1741,373,158,315,8,0,51,381,5,76,44,79,81,123,486,779,2,2026,112,0,0
44,2848,1457,730,1242,11,6,188,1468,10,292,166,329,302,495,2424,4078,5,22973,1276,1,0
44,2906,1457,730,1242,11,6,188,1468,10,292,166,329,302,495,2424,4078,5,22973,1276,1,0
79,1690,127,75,83,2,11,30,129,4,14,7,14,18,21,61,87,2,175,9,0,0
79,1690,652,304,544,16,6,88,668,6,89,51,101,95,152,591,998,3,3399,188,0,0
79,1690,2,2,2,0,0,0,2,0,0,0,0,0,0,0,0,0,0,0,0,0
79,1690,8,5,5,0,0,3,8,0,0,0,0,0,0,0,0,0,0,0,0,0
79,1690,14,8,8,0,0,6,14,0,0,0,0,0,0,0,0,0,0,0,0,0
79,1690,6,4,4,0,0,2,6,0,0,0,0,0,0,0,0,0,0,0,0,0
79,1690,6,4,4,0,0,2,6,1,2,1,2,3,3,2,4,0,2,0,0,0
79,1690,7,5,5,0,0,2,7,0,0,0,0,0,0,0,0,0,0,0,0,0
79,1690,10,6,6,0,0,4,10,0,0,0,0,0,0,0,0,0,0,0,0,0
79,1690,1,1,1,0,0,0,1,0,0,0,0,0,0,0,0,0,0,0,0,0
79,1690,14,10,10,0,0,4,14,1,1,1,1,2,2,0,2,0,1,0,0,0
79,1690,46,26,30,3,0,12,49,3,6,3,6,9,9,20,28,1,42,2,0,0
8,660,652,304,544,16,6,88,668,6,89,51,101,95,152,591,998,3,3399,188,0,0
47,2925,1457,730,1242,11,6,188,1468,10,292,166,329,302,495,2424,4078,5,22973,1276,1,0
87,1812,127,75,83,2,11,30,129,4,14,7,14,18,21,61,87,2,175,9,0,0
87,1812,652,304,544,16,6,88,668,6,89,51,101,95,152,591,998,3,3399,188,0,0
87,1812,2,2,2,0,0,0,2,0,0,0,0,0,0,0,0,0,0,0,0,0
87,1812,8,5,5,0,0,3,8,0,0,0,0,0,0,0,0,0,0,0,0,0
87,1812,14,8,8,0,0,6,14,0,0,0,0,0,0,0,0,0,0,0,0,0
87,1812,6,4,4,0,0,2,6,0,0,0,0,0,0,0,0,0,0,0,0,0
87,1812,6,4,4,0,0,2,6,1,2,1,2,3,3,2,4,0,2,0,0,0
87,1812,7,5,5,0,0,2,7,0,0,0,0,0,0,0,0,0,0,0,0,0
87,1812,10,6,6,0,0,4,10,0,0,0,0,0,0,0,0,0,0,0,0,0
87,1812,1,1,1,0,0,0,1,0,0,0,0,0,0,0,0,0,0,0,0,0
87,1812,14,10,10,0,0,4,14,1,1,1,1,2,2,0,2,0,1,0,0,0
87,1812,46,26,30,3,0,12,49,3,6,3,6,9,9,20,28,1,42,2,0,0
10,824,652,304,544,16,6,88,668,6,89,51,101,95,152,591,998,3,3399,188,0,0
63,1436,1457,730,1242,11,6,188,1468,10,292,166,329,302,495,2424,4078,5,22973,1276,1,0
63,1436,74,35,59,1,0,14,75,3,14,7,14,17,21,58,85,1,128,7,0,0
63,1436,245,125,200,5,7,34,250,7,30,17,34,37,51,166,265,3,1053,58,0,0
50,2993,1457,730,1242,11,6,188,1468,10,292,166,329,302,495,2424,4078,5,22973,1276,1,0
62,1440,1457,730,1242,11,6,188,1468,10,292,166,329,302,495,2424,4078,5,22973,1276,1,0
62,1440,74,35,59,1,0,14,75,3,14,7,14,17,21,58,85,1,128,7,0,0
62,1440,245,125,200,5,7,34,250,7,30,17,34,37,51,166,265,3,1053,58,0,0
63,1428,1457,730,1242,11,6,188,1468,10,292,166,329,302,495,2424,4078,5,22973,1276,1,0
63,1428,74,35,59,1,0,14,75,3,14,7,14,17,21,58,85,1,128,7,0,0
63,1428,245,125,200,5,7,34,250,7,30,17,34,37,51,166,265,3,1053,58,0,0
150,2618,1338,495,1086,10,64,173,1348,11,122,82,157,133,239,883,1686,7,11934,663,0,0
69,1548,1457,730,1242,11,6,188,1468,10,292,166,329,302,495,2424,4078,5,22973,1276,1,0
69,1548,74,35,59,1,0,14,75,3,14,7,14,17,21,58,85,1,128,7,0,0
69,1548,245,125,200,5,7,34,250,7,30,17,34,37,51,166,265,3,1053,58,0,0
48,3110,1457,730,1242,11,6,188,1468,10,292,166,329,302,495,2424,4078,5,22973,1276,1,0
29,1712,373,158,315,8,0,51,381,5,76,44,79,81,123,486,779,2,2026,112,0,0
68,1525,1457,730,1242,11,6,188,1468,10,292,166,329,302,495,2424,4078,5,22973,1276,1,0
68,1525,74,35,59,1,0,14,75,3,14,7,14,17,21,58,85,1,128,7,0,0
68,1525,245,125,200,5,7,34,250,7,30,17,34,37,51,166,265,3,1053,58,0,0
48,3109,1457,730,1242,11,6,188,1468,10,292,166,329,302,495,2424,4078,5,22973,1276,1,0
74,1795,1943,715,1694,26,18,214,1969,12,185,120,237,197,357,1436,2721,7,20915,1161,0,0
74,1795,1168,838,957,57,25,144,1225,19,348,224,416,367,640,3018,5452,11,61921,3440,1,0
69,1539,1457,730,1242,11,6,188,1468,10,292,166,329,302,495,2424,4078,5,22973,1276,1,0
69,1539,74,35,59,1,0,14,75,3,14,7,14,17,21,58,85,1,128,7,0,0
69,1539,245,125,200,5,7,34,250,7,30,17,34,37,51,166,265,3,1053,58,0,0
48,3144,1457,730,1242,11,6,188,1468,10,292,166,329,302,495,2424,4078,5,22973,1276,1,0
88,1867,127,75,83,2,11,30,129,4,14,7,14,18,21,61,87,2,175,9,0,1
88,1867,652,304,544,16,6,88,668,6,89,51,101,95,152,591,998,3,3399,188,0,1
88,1867,2,2,2,0,0,0,2,0,0,0,0,0,0,0,0,0,0,0,0,1
88,1867,8,5,5,0,0,3,8,0,0,0,0,0,0,0,0,0,0,0,0,1
88,1867,14,8,8,0,0,6,14,0,0,0,0,0,0,0,0,0,0,0,0,1
88,1867,6,4,4,0,0,2,6,0,0,0,0,0,0,0,0,0,0,0,0,1
88,1867,6,4,4,0,0,2,6,1,2,1,2,3,3,2,4,0,2,0,0,1
88,1867,7,5,5,0,0,2,7,0,0,0,0,0,0,0,0,0,0,0,0,1
88,1867,10,6,6,0,0,4,10,0,0,0,0,0,0,0,0,0,0,0,0,1
88,1867,1,1,1,0,0,0,1,0,0,0,0,0,0,0,0,0,0,0,0,1
88,1867,14,10,10,0,0,4,14,1,1,1,1,2,2,0,2,0,1,0,0,1
88,1867,46,26,30,3,0,12,49,3,6,3,6,9,9,20,28,1,42,2,0,1
10,851,652,304,544,16,6,88,668,6,89,51,101,95,152,591,998,3,3399,188,0,1
88,1870,127,75,83,2,11,30,129,4,14,7,14,18,21,61,87,2,175,9,0,1
88,1870,652,304,544,16,6,88,668,6,89,51,101,95,152,591,998,3,3399,188,0,1
88,1870,2,2,2,0,0,0,2,0,0,0,0,0,0,0,0,0,0,0,0,1
88,1870,8,5,5,0,0,3,8,0,0,0,0,0,0,0,0,0,0,0,0,1
88,1870,14,8,8,0,0,6,14,0,0,0,0,0,0,0,0,0,0,0,0,1
88,1870,6,4,4,0,0,2,6,0,0,0,0,0,0,0,0,0,0,0,0,1
88,1870,6,4,4,0,0,2,6,1,2,1,2,3,3,2,4,0,2,0,0,1
88,1870,7,5,5,0,0,2,7,0,0,0,0,0,0,0,0,0,0,0,0,1
88,1870,10,6,6,0,0,4,10,0,0,0,0,0,0,0,0,0,0,0,0,1
88,1870,1,1,1,0,0,0,1,0,0,0,0,0,0,0,0,0,0,0,0,1
88,1870,14,10,10,0,0,4,14,1,1,1,1,2,2,0,2,0,1,0,0,1
88,1870,46,26,30,3,0,12,49,3,6,3,6,9,9,20,28,1,42,2,0,1
148,2598,1338,495,1086,10,64,173,1348,11,122,82,157,133,239,883,1686,7,11934,663,0,0
50,3161,1457,730,1242,11,6,188,1468,10,292,166,329,302,495,2424,4078,5,22973,1276,1,0
148,2599,1338,495,1086,10,64,173,1348,11,122,82,157,133,239,883,1686,7,11934,663,0,0
88,1875,127,75,83,2,11,30,129,4,14,7,14,18,21,61,87,2,175,9,0,1
88,1875,652,304,544,16,6,88,668,6,89,51,101,95,152,591,998,3,3399,188,0,1
88,1875,2,2,2,0,0,0,2,0,0,0,0,0,0,0,0,0,0,0,0,1
88,1875,8,5,5,0,0,3,8,0,0,0,0,0,0,0,0,0,0,0,0,1
88,1875,14,8,8,0,0,6,14,0,0,0,0,0,0,0,0,0,0,0,0,1
88,1875,6,4,4,0,0,2,6,0,0,0,0,0,0,0,0,0,0,0,0,1
88,1875,6,4,4,0,0,2,6,1,2,1,2,3,3,2,4,0,2,0,0,1
88,1875,7,5,5,0,0,2,7,0,0,0,0,0,0,0,0,0,0,0,0,1
88,1875,10,6,6,0,0,4,10,0,0,0,0,0,0,0,0,0,0,0,0,1
88,1875,1,1,1,0,0,0,1,0,0,0,0,0,0,0,0,0,0,0,0,1
88,1875,14,10,10,0,0,4,14,1,1,1,1,2,2,0,2,0,1,0,0,1
88,1875,46,26,30,3,0,12,49,3,6,3,6,9,9,20,28,1,42,2,0,1
88,1881,127,75,83,2,11,30,129,4,14,7,14,18,21,61,87,2,175,9,0,1
88,1881,652,304,544,16,6,88,668,6,89,51,101,95,152,591,998,3,3399,188,0,1
88,1881,2,2,2,0,0,0,2,0,0,0,0,0,0,0,0,0,0,0,0,1
88,1881,8,5,5,0,0,3,8,0,0,0,0,0,0,0,0,0,0,0,0,1
88,1881,14,8,8,0,0,6,14,0,0,0,0,0,0,0,0,0,0,0,0,1
88,1881,6,4,4,0,0,2,6,0,0,0,0,0,0,0,0,0,0,0,0,1
88,1881,6,4,4,0,0,2,6,1,2,1,2,3,3,2,4,0,2,0,0,1
88,1881,7,5,5,0,0,2,7,0,0,0,0,0,0,0,0,0,0,0,0,1
88,1881,10,6,6,0,0,4,10,0,0,0,0,0,0,0,0,0,0,0,0,1
88,1881,1,1,1,0,0,0,1,0,0,0,0,0,0,0,0,0,0,0,0,1
88,1881,14,10,10,0,0,4,14,1,1,1,1,2,2,0,2,0,1,0,0,1
88,1881,46,26,30,3,0,12,49,3,6,3,6,9,9,20,28,1,42,2,0,1
148,2605,1338,495,1086,10,64,173,1348,11,122,82,157,133,239,883,1686,7,11934,663,0,1
4,111,1455,414,1257,16,76,112,1471,5,41,23,46,46,69,231,381,2,1069,59,0,1
4,111,669,365,481,22,61,110,691,15,103,63,122,118,185,747,1273,8,11311,628,0,1
49,689,373,158,315,8,0,51,381,5,76,44,79,81,123,486,779,2,2026,112,0,1
74,1799,1943,715,1694,26,18,214,1969,12,185,120,237,197,357,1436,2721,7,20915,1161,0,1
74,1799,1168,838,957,57,25,144,1225,19,348,224,416,367,640,3018,5452,11,61921,3440,1,1
4,202,1455,414,1257,16,76,112,1471,5,41,23,46,46,69,231,381,2,1069,59,0,1
29,1712,373,158,315,8,0,51,381,5,76,44,79,81,123,486,779,2,2026,112,0,1
92,1971,127,75,83,2,11,30,129,4,14,7,14,18,21,61,87,2,175,9,0,0
92,1971,652,304,544,16,6,88,668,6,89,51,101,95,152,591,998,3,3399,188,0,0
92,1971,2,2,2,0,0,0,2,0,0,0,0,0,0,0,0,0,0,0,0,0
92,1971,8,5,5,0,0,3,8,0,0,0,0,0,0,0,0,0,0,0,0,0
92,1971,14,8,8,0,0,6,14,0,0,0,0,0,0,0,0,0,0,0,0,0
92,1971,6,4,4,0,0,2,6,0,0,0,0,0,0,0,0,0,0,0,0,0
92,1971,6,4,4,0,0,2,6,1,2,1,2,3,3,2,4,0,2,0,0,0
92,1971,7,5,5,0,0,2,7,0,0,0,0,0,0,0,0,0,0,0,0,0
92,1971,10,6,6,0,0,4,10,0,0,0,0,0,0,0,0,0,0,0,0,0
92,1971,1,1,1,0,0,0,1,0,0,0,0,0,0,0,0,0,0,0,0,0
92,1971,14,10,10,0,0,4,14,1,1,1,1,2,2,0,2,0,1,0,0,0
92,1971,46,26,30,3,0,12,49,3,6,3,6,9,9,20,28,1,42,2,0,0
92,1991,127,75,83,2,11,30,129,4,14,7,14,18,21,61,87,2,175,9,0,0
92,1991,652,304,544,16,6,88,668,6,89,51,101,95,152,591,998,3,3399,188,0,0
92,1991,2,2,2,0,0,0,2,0,0,0,0,0,0,0,0,0,0,0,0,0
92,1991,8,5,5,0,0,3,8,0,0,0,0,0,0,0,0,0,0,0,0,0
92,1991,14,8,8,0,0,6,14,0,0,0,0,0,0,0,0,0,0,0,0,0
92,1991,6,4,4,0,0,2,6,0,0,0,0,0,0,0,0,0,0,0,0,0
92,1991,6,4,4,0,0,2,6,1,2,1,2,3,3,2,4,0,2,0,0,0
92,1991,7,5,5,0,0,2,7,0,0,0,0,0,0,0,0,0,0,0,0,0
92,1991,10,6,6,0,0,4,10,0,0,0,0,0,0,0,0,0,0,0,0,0
92,1991,1,1,1,0,0,0,1,0,0,0,0,0,0,0,0,0,0,0,0,0
92,1991,14,10,10,0,0,4,14,1,1,1,1,2,2,0,2,0,1,0,0,0
92,1991,46,26,30,3,0,12,49,3,6,3,6,9,9,20,28,1,42,2,0,0
92,1995,127,75,83,2,11,30,129,4,14,7,14,18,21,61,87,2,175,9,0,0
92,1995,652,304,544,16,6,88,668,6,89,51,101,95,152,591,998,3,3399,188,0,0
92,1995,2,2,2,0,0,0,2,0,0,0,0,0,0,0,0,0,0,0,0,0
92,1995,8,5,5,0,0,3,8,0,0,0,0,0,0,0,0,0,0,0,0,0
92,1995,14,8,8,0,0,6,14,0,0,0,0,0,0,0,0,0,0,0,0,0
92,1995,6,4,4,0,0,2,6,0,0,0,0,0,0,0,0,0,0,0,0,0
92,1995,6,4,4,0,0,2,6,1,2,1,2,3,3,2,4,0,2,0,0,0
92,1995,7,5,5,0,0,2,7,0,0,0,0,0,0,0,0,0,0,0,0,0
92,1995,10,6,6,0,0,4,10,0,0,0,0,0,0,0,0,0,0,0,0,0
92,1995,1,1,1,0,0,0,1,0,0,0,0,0,0,0,0,0,0,0,0,0
92,1995,14,10,10,0,0,4,14,1,1,1,1,2,2,0,2,0,1,0,0,0
92,1995,46,26,30,3,0,12,49,3,6,3,6,9,9,20,28,1,42,2,0,0
93,1999,127,75,83,2,11,30,129,4,14,7,14,18,21,61,87,2,175,9,0,0
93,1999,652,304,544,16,6,88,668,6,89,51,101,95,152,591,998,3,3399,188,0,0
93,1999,2,2,2,0,0,0,2,0,0,0,0,0,0,0,0,0,0,0,0,0
93,1999,8,5,5,0,0,3,8,0,0,0,0,0,0,0,0,0,0,0,0,0
93,1999,14,8,8,0,0,6,14,0,0,0,0,0,0,0,0,0,0,0,0,0
93,1999,6,4,4,0,0,2,6,0,0,0,0,0,0,0,0,0,0,0,0,0
93,1999,6,4,4,0,0,2,6,1,2,1,2,3,3,2,4,0,2,0,0,0
93,1999,7,5,5,0,0,2,7,0,0,0,0,0,0,0,0,0,0,0,0,0
93,1999,10,6,6,0,0,4,10,0,0,0,0,0,0,0,0,0,0,0,0,0
93,1999,1,1,1,0,0,0,1,0,0,0,0,0,0,0,0,0,0,0,0,0
93,1999,14,10,10,0,0,4,14,1,1,1,1,2,2,0,2,0,1,0,0,0
93,1999,46,26,30,3,0,12,49,3,6,3,6,9,9,20,28,1,42,2,0,0
94,2025,127,75,83,2,11,30,129,4,14,7,14,18,21,61,87,2,175,9,0,0
94,2025,652,304,544,16,6,88,668,6,89,51,101,95,152,591,998,3,3399,188,0,0
94,2025,2,2,2,0,0,0,2,0,0,0,0,0,0,0,0,0,0,0,0,0
94,2025,8,5,5,0,0,3,8,0,0,0,0,0,0,0,0,0,0,0,0,0
94,2025,14,8,8,0,0,6,14,0,0,0,0,0,0,0,0,0,0,0,0,0
94,2025,6,4,4,0,0,2,6,0,0,0,0,0,0,0,0,0,0,0,0,0
94,2025,6,4,4,0,0,2,6,1,2,1,2,3,3,2,4,0,2,0,0,0
94,2025,7,5,5,0,0,2,7,0,0,0,0,0,0,0,0,0,0,0,0,0
94,2025,10,6,6,0,0,4,10,0,0,0,0,0,0,0,0,0,0,0,0,0
94,2025,1,1,1,0,0,0,1,0,0,0,0,0,0,0,0,0,0,0,0,0
94,2025,14,10,10,0,0,4,14,1,1,1,1,2,2,0,2,0,1,0,0,0
94,2025,46,26,30,3,0,12,49,3,6,3,6,9,9,20,28,1,42,2,0,0
74,1803,1943,715,1694,26,18,214,1969,12,185,120,237,197,357,1436,2721,7,20915,1161,0,0
74,1803,1168,838,957,57,25,144,1225,19,348,224,416,367,640,3018,5452,11,61921,3440,1,0
146,2579,1338,495,1086,10,64,173,1348,11,122,82,157,133,239,883,1686,7,11934,663,0,0
41,1388,773,419,590,28,0,166,801,10,204,113,217,214,330,1598,2554,5,13587,754,0,0
154,2728,1338,495,1086,10,64,173,1348,11,122,82,157,133,239,883,1686,7,11934,663,0,0
54,751,373,158,315,8,0,51,381,5,76,44,79,81,123,486,779,2,2026,112,0,0
30,1793,373,158,315,8,0,51,381,5,76,44,79,81,123,486,779,2,2026,112,0,0
52,722,373,158,315,8,0,51,381,5,76,44,79,81,123,486,779,2,2026,112,0,0
6,265,207,111,150,11,0,50,218,5,26,19,36,31,55,133,272,3,943,52,0,0
6,265,410,198,237,31,55,97,441,11,63,38,72,74,110,414,683,6,4293,238,0,0
4,225,207,111,150,11,0,50,218,5,26,19,36,31,55,133,272,3,943,52,0,0
154,2732,1338,495,1086,10,64,173,1348,11,122,82,157,133,239,883,1686,7,11934,663,0,0
13,259,1392,870,1177,35,17,170,1427,14,494,280,531,508,811,4473,7289,7,54850,3047,2,0
12,243,1392,870,1177,35,17,170,1427,14,494,280,531,508,811,4473,7289,7,54850,3047,2,0
31,1899,373,158,315,8,0,51,381,5,76,44,79,81,123,486,779,2,2026,112,0,1
152,2711,1338,495,1086,10,64,173,1348,11,122,82,157,133,239,883,1686,7,11934,663,0,0
148,2629,1338,495,1086,10,64,173,1348,11,122,82,157,133,239,883,1686,7,11934,663,0,0
59,833,373,158,315,8,0,51,381,5,76,44,79,81,123,486,779,2,2026,112,0,0
48,3132,1457,730,1242,11,6,188,1468,10,292,166,329,302,495,2424,4078,5,22973,1276,1,0
74,1813,1943,715,1694,26,18,214,1969,12,185,120,237,197,357,1436,2721,7,20915,1161,0,0
74,1813,1168,838,957,57,25,144,1225,19,348,224,416,367,640,3018,5452,11,61921,3440,1,0
74,1815,1943,715,1694,26,18,214,1969,12,185,120,237,197,357,1436,2721,7,20915,1161,0,0
74,1815,1168,838,957,57,25,144,1225,19,348,224,416,367,640,3018,5452,11,61921,3440,1,0
157,2724,1338,495,1086,10,64,173,1348,11,122,82,157,133,239,883,1686,7,11934,663,0,0
32,1923,373,158,315,8,0,51,381,5,76,44,79,81,123,486,779,2,2026,112,0,0
59,840,373,158,315,8,0,51,381,5,76,44,79,81,123,486,779,2,2026,112,0,0
95,2040,127,75,83,2,11,30,129,4,14,7,14,18,21,61,87,2,175,9,0,0
95,2040,652,304,544,16,6,88,668,6,89,51,101,95,152,591,998,3,3399,188,0,0
95,2040,2,2,2,0,0,0,2,0,0,0,0,0,0,0,0,0,0,0,0,0
95,2040,8,5,5,0,0,3,8,0,0,0,0,0,0,0,0,0,0,0,0,0
95,2040,14,8,8,0,0,6,14,0,0,0,0,0,0,0,0,0,0,0,0,0
95,2040,6,4,4,0,0,2,6,0,0,0,0,0,0,0,0,0,0,0,0,0
95,2040,6,4,4,0,0,2,6,1,2,1,2,3,3,2,4,0,2,0,0,0
95,2040,7,5,5,0,0,2,7,0,0,0,0,0,0,0,0,0,0,0,0,0
95,2040,10,6,6,0,0,4,10,0,0,0,0,0,0,0,0,0,0,0,0,0
95,2040,1,1,1,0,0,0,1,0,0,0,0,0,0,0,0,0,0,0,0,0
95,2040,14,10,10,0,0,4,14,1,1,1,1,2,2,0,2,0,1,0,0,0
95,2040,46,26,30,3,0,12,49,3,6,3,6,9,9,20,28,1,42,2,0,0
62,1372,773,419,590,28,0,166,801,10,204,113,217,214,330,1598,2554,5,13587,754,0,0
62,1372,421,273,302,44,34,57,465,17,81,59,107,98,166,583,1098,11,12329,684,0,0
1,70,13,10,10,0,0,3,13,1,2,1,2,3,3,2,4,0,2,0,0,1
16,823,652,304,544,16,6,88,668,6,89,51,101,95,152,591,998,3,3399,188,0,1
157,2724,1338,495,1086,10,64,173,1348,11,122,82,157,133,239,883,1686,7,11934,663,0,1
67,1507,1457,730,1242,11,6,188,1468,10,292,166,329,302,495,2424,4078,5,22973,1276,1,1
67,1507,74,35,59,1,0,14,75,3,14,7,14,17,21,58,85,1,128,7,0,1
67,1507,245,125,200,5,7,34,250,7,30,17,34,37,51,166,265,3,1053,58,0,1
47,906,373,158,315,8,0,51,381,5,76,44,79,81,123,486,779,2,2026,112,0,1
47,3118,1457,730,1242,11,6,188,1468,10,292,166,329,302,495,2424,4078,5,22973,1276,1,1
48,1730,373,158,315,8,0,51,381,5,76,44,79,81,123,486,779,2,2026,112,0,1
2,50,127,75,83,2,11,30,129,4,14,7,14,18,21,61,87,2,175,9,0,1
2,50,652,304,544,16,6,88,668,6,89,51,101,95,152,591,998,3,3399,188,0,1
2,50,2,2,2,0,0,0,2,0,0,0,0,0,0,0,0,0,0,0,0,1
2,50,8,5,5,0,0,3,8,0,0,0,0,0,0,0,0,0,0,0,0,1
2,50,14,8,8,0,0,6,14,0,0,0,0,0,0,0,0,0,0,0,0,1
2,50,6,4,4,0,0,2,6,0,0,0,0,0,0,0,0,0,0,0,0,1
2,50,6,4,4,0,0,2,6,1,2,1,2,3,3,2,4,0,2,0,0,1
2,50,7,5,5,0,0,2,7,0,0,0,0,0,0,0,0,0,0,0,0,1
2,50,10,6,6,0,0,4,10,0,0,0,0,0,0,0,0,0,0,0,0,1
2,50,1,1,1,0,0,0,1,0,0,0,0,0,0,0,0,0,0,0,0,1
2,50,14,10,10,0,0,4,14,1,1,1,1,2,2,0,2,0,1,0,0,1
2,50,46,26,30,3,0,12,49,3,6,3,6,9,9,20,28,1,42,2,0,1
47,906,373,158,315,8,0,51,381,5,76,44,79,81,123,486,779,2,2026,112,0,0
48,908,373,158,315,8,0,51,381,5,76,44,79,81,123,486,779,2,2026,112,0,0
48,1730,373,158,315,8,0,51,381,5,76,44,79,81,123,486,779,2,2026,112,0,0
49,934,373,158,315,8,0,51,381,5,76,44,79,81,123,486,779,2,2026,112,0,0
48,1742,373,158,315,8,0,51,381,5,76,44,79,81,123,486,779,2,2026,112,0,1
157,2702,1338,495,1086,10,64,173,1348,11,122,82,157,133,239,883,1686,7,11934,663,0,0
3,79,1455,414,1257,16,76,112,1471,5,41,23,46,46,69,231,381,2,1069,59,0,0
3,79,669,365,481,22,61,110,691,15,103,63,122,118,185,747,1273,8,11311,628,0,0
5,262,1455,414,1257,16,76,112,1471,5,41,23,46,46,69,231,381,2,1069,59,0,0
41,1405,773,419,590,28,0,166,801,10,204,113,217,214,330,1598,2554,5,13587,754,0,0
22,535,182,127,129,0,0,53,182,5,39,21,42,44,63,217,343,2,926,51,0,1
22,535,1165,710,800,67,119,181,1232,18,243,153,282,261,435,2000,3492,10,36473,2026,1,1
84,1873,1392,870,1177,35,17,170,1427,14,494,280,531,508,811,4473,7289,7,54850,3047,2,1
62,1415,773,419,590,28,0,166,801,10,204,113,217,214,330,1598,2554,5,13587,754,0,1
62,1415,421,273,302,44,34,57,465,17,81,59,107,98,166,583,1098,11,12329,684,0,1
13,518,182,127,129,0,0,53,182,5,39,21,42,44,63,217,343,2,926,51,0,1
88,3213,1392,870,1177,35,17,170,1427,14,494,280,531,508,811,4473,7289,7,54850,3047,2,1
46,1526,773,419,590,28,0,166,801,10,204,113,217,214,330,1598,2554,5,13587,754,0,1
102,2207,127,75,83,2,11,30,129,4,14,7,14,18,21,61,87,2,175,9,0,1
102,2207,652,304,544,16,6,88,668,6,89,51,101,95,152,591,998,3,3399,188,0,1
102,2207,2,2,2,0,0,0,2,0,0,0,0,0,0,0,0,0,0,0,0,1
102,2207,8,5,5,0,0,3,8,0,0,0,0,0,0,0,0,0,0,0,0,1
102,2207,14,8,8,0,0,6,14,0,0,0,0,0,0,0,0,0,0,0,0,1
102,2207,6,4,4,0,0,2,6,0,0,0,0,0,0,0,0,0,0,0,0,1
102,2207,6,4,4,0,0,2,6,1,2,1,2,3,3,2,4,0,2,0,0,1
102,2207,7,5,5,0,0,2,7,0,0,0,0,0,0,0,0,0,0,0,0,1
102,2207,10,6,6,0,0,4,10,0,0,0,0,0,0,0,0,0,0,0,0,1
102,2207,1,1,1,0,0,0,1,0,0,0,0,0,0,0,0,0,0,0,0,1
102,2207,14,10,10,0,0,4,14,1,1,1,1,2,2,0,2,0,1,0,0,1
102,2207,46,26,30,3,0,12,49,3,6,3,6,9,9,20,28,1,42,2,0,1
17,841,652,304,544,16,6,88,668,6,89,51,101,95,152,591,998,3,3399,188,0,1
5,104,1943,715,1694,26,18,214,1969,12,185,120,237,197,357,1436,2721,7,20915,1161,0,1
114,2015,1338,495,1086,10,64,173,1348,11,122,82,157,133,239,883,1686,7,11934,663,0,1
6,254,207,111,150,11,0,50,218,5,26,19,36,31,55,133,272,3,943,52,0,1
6,254,410,198,237,31,55,97,441,11,63,38,72,74,110,414,683,6,4293,238,0,1
58,1278,1457,730,1242,11,6,188,1468,10,292,166,329,302,495,2424,4078,5,22973,1276,1,1
58,1278,74,35,59,1,0,14,75,3,14,7,14,17,21,58,85,1,128,7,0,1
58,1278,245,125,200,5,7,34,250,7,30,17,34,37,51,166,265,3,1053,58,0,1
26,384,477,336,357,30,23,73,507,16,194,134,250,210,384,1538,2962,10,30538,1696,0,1
61,1388,1943,715,1694,26,18,214,1969,12,185,120,237,197,357,1436,2721,7,20915,1161,0,1
61,1388,1168,838,957,57,25,144,1225,19,348,224,416,367,640,3018,5452,11,61921,3440,1,1
13,1034,1943,715,1694,26,18,214,1969,12,185,120,237,197,357,1436,2721,7,20915,1161,0,1
33,845,1043,504,840,53,9,147,1096,9,180,112,198,189,310,1377,2344,4,11604,644,0,1
33,845,383,288,292,26,6,62,409,11,65,38,67,76,105,429,656,5,3719,206,0,1
48,883,373,158,315,8,0,51,381,5,76,44,79,81,123,486,779,2,2026,112,0,1
32,1506,1289,550,1043,56,32,155,1345,10,167,93,185,177,278,1266,2075,5,11498,638,0,1
4,225,207,111,150,11,0,50,218,5,26,19,36,31,55,133,272,3,943,52,0,1
58,3609,1457,730,1242,11,6,188,1468,10,292,166,329,302,495,2424,4078,5,22973,1276,1,1
3,185,1455,414,1257,16,76,112,1471,5,41,23,46,46,69,231,381,2,1069,59,0,1
31,1367,373,158,315,8,0,51,381,5,76,44,79,81,123,486,779,2,2026,112,0,1
1,76,42,7,35,4,0,5,46,1,2,1,2,3,3,2,4,0,2,0,0,1
1,76,11,6,10,0,0,1,11,2,4,2,4,6,6,10,15,1,15,0,0,1
6,596,42,7,35,4,0,5,46,1,2,1,2,3,3,2,4,0,2,0,0,1
6,596,11,6,10,0,0,1,11,2,4,2,4,6,6,10,15,1,15,0,0,1
32,1379,373,158,315,8,0,51,381,5,76,44,79,81,123,486,779,2,2026,112,0,1
32,1517,1289,550,1043,56,32,155,1345,10,167,93,185,177,278,1266,2075,5,11498,638,0,0
21,1028,42,7,35,4,0,5,46,1,2,1,2,3,3,2,4,0,2,0,0,1
21,1028,11,6,10,0,0,1,11,2,4,2,4,6,6,10,15,1,15,0,0,1
84,1873,1392,870,1177,35,17,170,1427,14,494,280,531,508,811,4473,7289,7,54850,3047,2,0
1,485,42,7,35,4,0,5,46,1,2,1,2,3,3,2,4,0,2,0,0,1
1,485,11,6,10,0,0,1,11,2,4,2,4,6,6,10,15,1,15,0,0,1
1,487,42,7,35,4,0,5,46,1,2,1,2,3,3,2,4,0,2,0,0,0
1,487,11,6,10,0,0,1,11,2,4,2,4,6,6,10,15,1,15,0,0,0
9,213,1450,624,1228,12,26,181,1462,14,306,186,354,320,540,2580,4493,8,36391,2021,1,0
25,429,1450,624,1228,12,26,181,1462,14,306,186,354,320,540,2580,4493,8,36391,2021,1,0
35,1582,1289,550,1043,56,32,155,1345,10,167,93,185,177,278,1266,2075,5,11498,638,0,0
60,1308,1457,730,1242,11,6,188,1468,10,292,166,329,302,495,2424,4078,5,22973,1276,1,0
60,1308,74,35,59,1,0,14,75,3,14,7,14,17,21,58,85,1,128,7,0,0
60,1308,245,125,200,5,7,34,250,7,30,17,34,37,51,166,265,3,1053,58,0,0
59,3677,1457,730,1242,11,6,188,1468,10,292,166,329,302,495,2424,4078,5,22973,1276,1,0
68,1461,1457,730,1242,11,6,188,1468,10,292,166,329,302,495,2424,4078,5,22973,1276,1,0
68,1461,74,35,59,1,0,14,75,3,14,7,14,17,21,58,85,1,128,7,0,0
68,1461,245,125,200,5,7,34,250,7,30,17,34,37,51,166,265,3,1053,58,0,0
60,3777,1457,730,1242,11,6,188,1468,10,292,166,329,302,495,2424,4078,5,22973,1276,1,0
1,487,42,7,35,4,0,5,46,1,2,1,2,3,3,2,4,0,2,0,0,1
1,487,11,6,10,0,0,1,11,2,4,2,4,6,6,10,15,1,15,0,0,1
68,1469,1457,730,1242,11,6,188,1468,10,292,166,329,302,495,2424,4078,5,22973,1276,1,0
68,1469,74,35,59,1,0,14,75,3,14,7,14,17,21,58,85,1,128,7,0,0
68,1469,245,125,200,5,7,34,250,7,30,17,34,37,51,166,265,3,1053,58,0,0
60,3773,1457,730,1242,11,6,188,1468,10,292,166,329,302,495,2424,4078,5,22973,1276,1,0
116,2055,1338,495,1086,10,64,173,1348,11,122,82,157,133,239,883,1686,7,11934,663,0,1
68,1487,1457,730,1242,11,6,188,1468,10,292,166,329,302,495,2424,4078,5,22973,1276,1,1
68,1487,74,35,59,1,0,14,75,3,14,7,14,17,21,58,85,1,128,7,0,1
68,1487,245,125,200,5,7,34,250,7,30,17,34,37,51,166,265,3,1053,58,0,1
60,3776,1457,730,1242,11,6,188,1468,10,292,166,329,302,495,2424,4078,5,22973,1276,1,0
142,2436,1338,495,1086,10,64,173,1348,11,122,82,157,133,239,883,1686,7,11934,663,0,1
12,1018,1943,715,1694,26,18,214,1969,12,185,120,237,197,357,1436,2721,7,20915,1161,0,1
32,832,1043,504,840,53,9,147,1096,9,180,112,198,189,310,1377,2344,4,11604,644,0,1
32,832,383,288,292,26,6,62,409,11,65,38,67,76,105,429,656,5,3719,206,0,1
35,1582,1289,550,1043,56,32,155,1345,10,167,93,185,177,278,1266,2075,5,11498,638,0,1
58,3584,1457,730,1242,11,6,188,1468,10,292,166,329,302,495,2424,4078,5,22973,1276,1,1
33,1436,373,158,315,8,0,51,381,5,76,44,79,81,123,486,779,2,2026,112,0,1
88,2029,127,75,83,2,11,30,129,4,14,7,14,18,21,61,87,2,175,9,0,1
88,2029,652,304,544,16,6,88,668,6,89,51,101,95,152,591,998,3,3399,188,0,1
88,2029,2,2,2,0,0,0,2,0,0,0,0,0,0,0,0,0,0,0,0,1
88,2029,8,5,5,0,0,3,8,0,0,0,0,0,0,0,0,0,0,0,0,1
88,2029,14,8,8,0,0,6,14,0,0,0,0,0,0,0,0,0,0,0,0,1
88,2029,6,4,4,0,0,2,6,0,0,0,0,0,0,0,0,0,0,0,0,1
88,2029,6,4,4,0,0,2,6,1,2,1,2,3,3,2,4,0,2,0,0,1
88,2029,7,5,5,0,0,2,7,0,0,0,0,0,0,0,0,0,0,0,0,1
88,2029,10,6,6,0,0,4,10,0,0,0,0,0,0,0,0,0,0,0,0,1
88,2029,1,1,1,0,0,0,1,0,0,0,0,0,0,0,0,0,0,0,0,1
88,2029,14,10,10,0,0,4,14,1,1,1,1,2,2,0,2,0,1,0,0,1
88,2029,46,26,30,3,0,12,49,3,6,3,6,9,9,20,28,1,42,2,0,1
2,98,13,10,10,0,0,3,13,1,2,1,2,3,3,2,4,0,2,0,0,1
11,596,652,304,544,16,6,88,668,6,89,51,101,95,152,591,998,3,3399,188,0,1
144,2476,1338,495,1086,10,64,173,1348,11,122,82,157,133,239,883,1686,7,11934,663,0,1
1,477,42,7,35,4,0,5,46,1,2,1,2,3,3,2,4,0,2,0,0,0
1,477,11,6,10,0,0,1,11,2,4,2,4,6,6,10,15,1,15,0,0,0
2,50,127,75,83,2,11,30,129,4,14,7,14,18,21,61,87,2,175,9,0,0
2,50,652,304,544,16,6,88,668,6,89,51,101,95,152,591,998,3,3399,188,0,0
2,50,2,2,2,0,0,0,2,0,0,0,0,0,0,0,0,0,0,0,0,0
2,50,8,5,5,0,0,3,8,0,0,0,0,0,0,0,0,0,0,0,0,0
2,50,14,8,8,0,0,6,14,0,0,0,0,0,0,0,0,0,0,0,0,0
2,50,6,4,4,0,0,2,6,0,0,0,0,0,0,0,0,0,0,0,0,0
2,50,6,4,4,0,0,2,6,1,2,1,2,3,3,2,4,0,2,0,0,0
2,50,7,5,5,0,0,2,7,0,0,0,0,0,0,0,0,0,0,0,0,0
2,50,10,6,6,0,0,4,10,0,0,0,0,0,0,0,0,0,0,0,0,0
2,50,1,1,1,0,0,0,1,0,0,0,0,0,0,0,0,0,0,0,0,0
2,50,14,10,10,0,0,4,14,1,1,1,1,2,2,0,2,0,1,0,0,0
2,50,46,26,30,3,0,12,49,3,6,3,6,9,9,20,28,1,42,2,0,0
88,3213,1392,870,1177,35,17,170,1427,14,494,280,531,508,811,4473,7289,7,54850,3047,2,0
61,1386,1943,715,1694,26,18,214,1969,12,185,120,237,197,357,1436,2721,7,20915,1161,0,1
61,1386,1168,838,957,57,25,144,1225,19,348,224,416,367,640,3018,5452,11,61921,3440,1,1
57,3573,1457,730,1242,11,6,188,1468,10,292,166,329,302,495,2424,4078,5,22973,1276,1,1
33,1460,373,158,315,8,0,51,381,5,76,44,79,81,123,486,779,2,2026,112,0,1
19,444,127,75,83,2,11,30,129,4,14,7,14,18,21,61,87,2,175,9,0,1
19,444,652,304,544,16,6,88,668,6,89,51,101,95,152,591,998,3,3399,188,0,1
19,444,2,2,2,0,0,0,2,0,0,0,0,0,0,0,0,0,0,0,0,1
19,444,8,5,5,0,0,3,8,0,0,0,0,0,0,0,0,0,0,0,0,1
19,444,14,8,8,0,0,6,14,0,0,0,0,0,0,0,0,0,0,0,0,1
19,444,6,4,4,0,0,2,6,0,0,0,0,0,0,0,0,0,0,0,0,1
19,444,6,4,4,0,0,2,6,1,2,1,2,3,3,2,4,0,2,0,0,1
19,444,7,5,5,0,0,2,7,0,0,0,0,0,0,0,0,0,0,0,0,1
19,444,10,6,6,0,0,4,10,0,0,0,0,0,0,0,0,0,0,0,0,1
19,444,1,1,1,0,0,0,1,0,0,0,0,0,0,0,0,0,0,0,0,1
19,444,14,10,10,0,0,4,14,1,1,1,1,2,2,0,2,0,1,0,0,1
19,444,46,26,30,3,0,12,49,3,6,3,6,9,9,20,28,1,42,2,0,1
5,247,652,304,544,16,6,88,668,6,89,51,101,95,152,591,998,3,3399,188,0,1
84,1874,1392,870,1177,35,17,170,1427,14,494,280,531,508,811,4473,7289,7,54850,3047,2,1
144,2486,1338,495,1086,10,64,173,1348,11,122,82,157,133,239,883,1686,7,11934,663,0,1
62,1396,1943,715,1694,26,18,214,1969,12,185,120,237,197,357,1436,2721,7,20915,1161,0,1
62,1396,1168,838,957,57,25,144,1225,19,348,224,416,367,640,3018,5452,11,61921,3440,1,1
17,1181,1943,715,1694,26,18,214,1969,12,185,120,237,197,357,1436,2721,7,20915,1161,0,1
144,2489,1338,495,1086,10,64,173,1348,11,122,82,157,133,239,883,1686,7,11934,663,0,0
85,1888,1392,870,1177,35,17,170,1427,14,494,280,531,508,811,4473,7289,7,54850,3047,2,1
95,3486,1392,870,1177,35,17,170,1427,14,494,280,531,508,811,4473,7289,7,54850,3047,2,1
95,3490,1392,870,1177,35,17,170,1427,14,494,280,531,508,811,4473,7289,7,54850,3047,2,0
88,2032,127,75,83,2,11,30,129,4,14,7,14,18,21,61,87,2,175,9,0,0
88,2032,652,304,544,16,6,88,668,6,89,51,101,95,152,591,998,3,3399,188,0,0
88,2032,2,2,2,0,0,0,2,0,0,0,0,0,0,0,0,0,0,0,0,0
88,2032,8,5,5,0,0,3,8,0,0,0,0,0,0,0,0,0,0,0,0,0
88,2032,14,8,8,0,0,6,14,0,0,0,0,0,0,0,0,0,0,0,0,0
88,2032,6,4,4,0,0,2,6,0,0,0,0,0,0,0,0,0,0,0,0,0
88,2032,6,4,4,0,0,2,6,1,2,1,2,3,3,2,4,0,2,0,0,0
88,2032,7,5,5,0,0,2,7,0,0,0,0,0,0,0,0,0,0,0,0,0
88,2032,10,6,6,0,0,4,10,0,0,0,0,0,0,0,0,0,0,0,0,0
88,2032,1,1,1,0,0,0,1,0,0,0,0,0,0,0,0,0,0,0,0,0
88,2032,14,10,10,0,0,4,14,1,1,1,1,2,2,0,2,0,1,0,0,0
88,2032,46,26,30,3,0,12,49,3,6,3,6,9,9,20,28,1,42,2,0,0
36,1582,1289,550,1043,56,32,155,1345,10,167,93,185,177,278,1266,2075,5,11498,638,0,0
1,467,42,7,35,4,0,5,46,1,2,1,2,3,3,2,4,0,2,0,0,0
1,467,11,6,10,0,0,1,11,2,4,2,4,6,6,10,15,1,15,0,0,0
37,1615,1289,550,1043,56,32,155,1345,10,167,93,185,177,278,1266,2075,5,11498,638,0,0
38,1647,1289,550,1043,56,32,155,1345,10,167,93,185,177,278,1266,2075,5,11498,638,0,1
96,3511,1392,870,1177,35,17,170,1427,14,494,280,531,508,811,4473,7289,7,54850,3047,2,0
18,419,386,256,301,16,9,68,402,4,59,35,69,63,104,355,621,2,1453,80,0,0
18,419,264,131,164,11,41,46,275,6,38,22,40,44,62,214,338,3,1068,59,0,0
144,2509,1338,495,1086,10,64,173,1348,11,122,82,157,133,239,883,1686,7,11934,663,0,0
145,2522,1338,495,1086,10,64,173,1348,11,122,82,157,133,239,883,1686,7,11934,663,0,0
64,1428,1943,715,1694,26,18,214,1969,12,185,120,237,197,357,1436,2721,7,20915,1161,0,0
64,1428,1168,838,957,57,25,144,1225,19,348,224,416,367,640,3018,5452,11,61921,3440,1,0
64,1445,1943,715,1694,26,18,214,1969,12,185,120,237,197,357,1436,2721,7,20915,1161,0,0
64,1445,1168,838,957,57,25,144,1225,19,348,224,416,367,640,3018,5452,11,61921,3440,1,0
18,1284,1943,715,1694,26,18,214,1969,12,185,120,237,197,357,1436,2721,7,20915,1161,0,0
62,1432,1943,715,1694,26,18,214,1969,12,185,120,237,197,357,1436,2721,7,20915,1161,0,0
62,1432,1168,838,957,57,25,144,1225,19,348,224,416,367,640,3018,5452,11,61921,3440,1,0
20,1426,1943,715,1694,26,18,214,1969,12,185,120,237,197,357,1436,2721,7,20915,1161,0,0
63,1445,1943,715,1694,26,18,214,1969,12,185,120,237,197,357,1436,2721,7,20915,1161,0,0
63,1445,1168,838,957,57,25,144,1225,19,348,224,416,367,640,3018,5452,11,61921,3440,1,0
66,1504,1943,715,1694,26,18,214,1969,12,185,120,237,197,357,1436,2721,7,20915,1161,0,0
66,1504,1168,838,957,57,25,144,1225,19,348,224,416,367,640,3018,5452,11,61921,3440,1,0
23,1499,1943,715,1694,26,18,214,1969,12,185,120,237,197,357,1436,2721,7,20915,1161,0,0
48,907,373,158,315,8,0,51,381,5,76,44,79,81,123,486,779,2,2026,112,0,0
15,361,373,158,315,8,0,51,381,5,76,44,79,81,123,486,779,2,2026,112,0,0
16,406,373,158,315,8,0,51,381,5,76,44,79,81,123,486,779,2,2026,112,0,0
62,1415,773,419,590,28,0,166,801,10,204,113,217,214,330,1598,2554,5,13587,754,0,0
62,1415,421,273,302,44,34,57,465,17,81,59,107,98,166,583,1098,11,12329,684,0,0
19,432,127,75,83,2,11,30,129,4,14,7,14,18,21,61,87,2,175,9,0,0
19,432,652,304,544,16,6,88,668,6,89,51,101,95,152,591,998,3,3399,188,0,0
19,432,2,2,2,0,0,0,2,0,0,0,0,0,0,0,0,0,0,0,0,0
19,432,8,5,5,0,0,3,8,0,0,0,0,0,0,0,0,0,0,0,0,0
19,432,14,8,8,0,0,6,14,0,0,0,0,0,0,0,0,0,0,0,0,0
19,432,6,4,4,0,0,2,6,0,0,0,0,0,0,0,0,0,0,0,0,0
19,432,6,4,4,0,0,2,6,1,2,1,2,3,3,2,4,0,2,0,0,0
19,432,7,5,5,0,0,2,7,0,0,0,0,0,0,0,0,0,0,0,0,0
19,432,10,6,6,0,0,4,10,0,0,0,0,0,0,0,0,0,0,0,0,0
19,432,1,1,1,0,0,0,1,0,0,0,0,0,0,0,0,0,0,0,0,0
19,432,14,10,10,0,0,4,14,1,1,1,1,2,2,0,2,0,1,0,0,0
19,432,46,26,30,3,0,12,49,3,6,3,6,9,9,20,28,1,42,2,0,0
5,247,652,304,544,16,6,88,668,6,89,51,101,95,152,591,998,3,3399,188,0,0
19,438,127,75,83,2,11,30,129,4,14,7,14,18,21,61,87,2,175,9,0,0
19,438,652,304,544,16,6,88,668,6,89,51,101,95,152,591,998,3,3399,188,0,0
19,438,2,2,2,0,0,0,2,0,0,0,0,0,0,0,0,0,0,0,0,0
19,438,8,5,5,0,0,3,8,0,0,0,0,0,0,0,0,0,0,0,0,0
19,438,14,8,8,0,0,6,14,0,0,0,0,0,0,0,0,0,0,0,0,0
19,438,6,4,4,0,0,2,6,0,0,0,0,0,0,0,0,0,0,0,0,0
19,438,6,4,4,0,0,2,6,1,2,1,2,3,3,2,4,0,2,0,0,0
19,438,7,5,5,0,0,2,7,0,0,0,0,0,0,0,0,0,0,0,0,0
19,438,10,6,6,0,0,4,10,0,0,0,0,0,0,0,0,0,0,0,0,0
19,438,1,1,1,0,0,0,1,0,0,0,0,0,0,0,0,0,0,0,0,0
19,438,14,10,10,0,0,4,14,1,1,1,1,2,2,0,2,0,1,0,0,0
19,438,46,26,30,3,0,12,49,3,6,3,6,9,9,20,28,1,42,2,0,0
6,266,652,304,544,16,6,88,668,6,89,51,101,95,152,591,998,3,3399,188,0,0
37,1648,1289,550,1043,56,32,155,1345,10,167,93,185,177,278,1266,2075,5,11498,638,0,0
87,2025,127,75,83,2,11,30,129,4,14,7,14,18,21,61,87,2,175,9,0,1
87,2025,652,304,544,16,6,88,668,6,89,51,101,95,152,591,998,3,3399,188,0,1
87,2025,2,2,2,0,0,0,2,0,0,0,0,0,0,0,0,0,0,0,0,1
87,2025,8,5,5,0,0,3,8,0,0,0,0,0,0,0,0,0,0,0,0,1
87,2025,14,8,8,0,0,6,14,0,0,0,0,0,0,0,0,0,0,0,0,1
87,2025,6,4,4,0,0,2,6,0,0,0,0,0,0,0,0,0,0,0,0,1
87,2025,6,4,4,0,0,2,6,1,2,1,2,3,3,2,4,0,2,0,0,1
87,2025,7,5,5,0,0,2,7,0,0,0,0,0,0,0,0,0,0,0,0,1
87,2025,10,6,6,0,0,4,10,0,0,0,0,0,0,0,0,0,0,0,0,1
87,2025,1,1,1,0,0,0,1,0,0,0,0,0,0,0,0,0,0,0,0,1
87,2025,14,10,10,0,0,4,14,1,1,1,1,2,2,0,2,0,1,0,0,1
87,2025,46,26,30,3,0,12,49,3,6,3,6,9,9,20,28,1,42,2,0,1
37,1642,1289,550,1043,56,32,155,1345,10,167,93,185,177,278,1266,2075,5,11498,638,0,1
144,2506,1338,495,1086,10,64,173,1348,11,122,82,157,133,239,883,1686,7,11934,663,0,0
14,320,215,129,180,6,0,29,221,8,65,43,72,73,115,415,711,4,3153,175,0,0
14,320,97,69,77,3,3,16,100,6,22,13,23,28,36,113,173,3,542,30,0,0
49,956,373,158,315,8,0,51,381,5,76,44,79,81,123,486,779,2,2026,112,0,0
58,3702,1457,730,1242,11,6,188,1468,10,292,166,329,302,495,2424,4078,5,22973,1276,1,0
15,1127,215,129,180,6,0,29,221,8,65,43,72,73,115,415,711,4,3153,175,0,0
1,473,42,7,35,4,0,5,46,1,2,1,2,3,3,2,4,0,2,0,0,0
1,473,11,6,10,0,0,1,11,2,4,2,4,6,6,10,15,1,15,0,0,0
32,845,1043,504,840,53,9,147,1096,9,180,112,198,189,310,1377,2344,4,11604,644,0,0
32,845,383,288,292,26,6,62,409,11,65,38,67,76,105,429,656,5,3719,206,0,0
37,1642,1289,550,1043,56,32,155,1345,10,167,93,185,177,278,1266,2075,5,11498,638,0,0
86,1899,1392,870,1177,35,17,170,1427,14,494,280,531,508,811,4473,7289,7,54850,3047,2,0
97,3521,1392,870,1177,35,17,170,1427,14,494,280,531,508,811,4473,7289,7,54850,3047,2,0
49,951,373,158,315,8,0,51,381,5,76,44,79,81,123,486,779,2,2026,112,0,0
58,3693,1457,730,1242,11,6,188,1468,10,292,166,329,302,495,2424,4078,5,22973,1276,1,0
87,1905,1392,870,1177,35,17,170,1427,14,494,280,531,508,811,4473,7289,7,54850,3047,2,0
16,586,182,127,129,0,0,53,182,5,39,21,42,44,63,217,343,2,926,51,0,0
22,528,182,127,129,0,0,53,182,5,39,21,42,44,63,217,343,2,926,51,0,0
22,528,1165,710,800,67,119,181,1232,18,243,153,282,261,435,2000,3492,10,36473,2026,1,0
20,496,182,127,129,0,0,53,182,5,39,21,42,44,63,217,343,2,926,51,0,1
20,496,1165,710,800,67,119,181,1232,18,243,153,282,261,435,2000,3492,10,36473,2026,1,1
68,1530,773,419,590,28,0,166,801,10,204,113,217,214,330,1598,2554,5,13587,754,0,1
68,1530,421,273,302,44,34,57,465,17,81,59,107,98,166,583,1098,11,12329,684,0,1
97,3521,1392,870,1177,35,17,170,1427,14,494,280,531,508,811,4473,7289,7,54850,3047,2,1
51,1685,773,419,590,28,0,166,801,10,204,113,217,214,330,1598,2554,5,13587,754,0,1
36,1557,373,158,315,8,0,51,381,5,76,44,79,81,123,486,779,2,2026,112,0,1
1,35,127,75,83,2,11,30,129,4,14,7,14,18,21,61,87,2,175,9,0,1
1,35,652,304,544,16,6,88,668,6,89,51,101,95,152,591,998,3,3399,188,0,1
1,35,2,2,2,0,0,0,2,0,0,0,0,0,0,0,0,0,0,0,0,1
1,35,8,5,5,0,0,3,8,0,0,0,0,0,0,0,0,0,0,0,0,1
1,35,14,8,8,0,0,6,14,0,0,0,0,0,0,0,0,0,0,0,0,1
1,35,6,4,4,0,0,2,6,0,0,0,0,0,0,0,0,0,0,0,0,1
1,35,6,4,4,0,0,2,6,1,2,1,2,3,3,2,4,0,2,0,0,1
1,35,7,5,5,0,0,2,7,0,0,0,0,0,0,0,0,0,0,0,0,1
1,35,10,6,6,0,0,4,10,0,0,0,0,0,0,0,0,0,0,0,0,1
1,35,1,1,1,0,0,0,1,0,0,0,0,0,0,0,0,0,0,0,0,1
1,35,14,10,10,0,0,4,14,1,1,1,1,2,2,0,2,0,1,0,0,1
1,35,46,26,30,3,0,12,49,3,6,3,6,9,9,20,28,1,42,2,0,1
1,85,127,75,83,2,11,30,129,4,14,7,14,18,21,61,87,2,175,9,0,1
1,85,652,304,544,16,6,88,668,6,89,51,101,95,152,591,998,3,3399,188,0,1
1,85,2,2,2,0,0,0,2,0,0,0,0,0,0,0,0,0,0,0,0,1
1,85,8,5,5,0,0,3,8,0,0,0,0,0,0,0,0,0,0,0,0,1
1,85,14,8,8,0,0,6,14,0,0,0,0,0,0,0,0,0,0,0,0,1
1,85,6,4,4,0,0,2,6,0,0,0,0,0,0,0,0,0,0,0,0,1
1,85,6,4,4,0,0,2,6,1,2,1,2,3,3,2,4,0,2,0,0,1
1,85,7,5,5,0,0,2,7,0,0,0,0,0,0,0,0,0,0,0,0,1
1,85,10,6,6,0,0,4,10,0,0,0,0,0,0,0,0,0,0,0,0,1
1,85,1,1,1,0,0,0,1,0,0,0,0,0,0,0,0,0,0,0,0,1
1,85,14,10,10,0,0,4,14,1,1,1,1,2,2,0,2,0,1,0,0,1
1,85,46,26,30,3,0,12,49,3,6,3,6,9,9,20,28,1,42,2,0,1
2,80,13,10,10,0,0,3,13,1,2,1,2,3,3,2,4,0,2,0,0,1
15,369,386,256,301,16,9,68,402,4,59,35,69,63,104,355,621,2,1453,80,0,1
15,369,264,131,164,11,41,46,275,6,38,22,40,44,62,214,338,3,1068,59,0,1
151,2585,1338,495,1086,10,64,173,1348,11,122,82,157,133,239,883,1686,7,11934,663,0,1
57,1285,1457,730,1242,11,6,188,1468,10,292,166,329,302,495,2424,4078,5,22973,1276,1,1
57,1285,74,35,59,1,0,14,75,3,14,7,14,17,21,58,85,1,128,7,0,1
57,1285,245,125,200,5,7,34,250,7,30,17,34,37,51,166,265,3,1053,58,0,1
19,284,477,336,357,30,23,73,507,16,194,134,250,210,384,1538,2962,10,30538,1696,0,1
26,496,334,251,279,10,4,40,344,5,127,74,143,132,217,899,1528,2,4303,239,0,1
3,50,127,75,83,2,11,30,129,4,14,7,14,18,21,61,87,2,175,9,0,1
3,50,652,304,544,16,6,88,668,6,89,51,101,95,152,591,998,3,3399,188,0,1
3,50,2,2,2,0,0,0,2,0,0,0,0,0,0,0,0,0,0,0,0,1
3,50,8,5,5,0,0,3,8,0,0,0,0,0,0,0,0,0,0,0,0,1
3,50,14,8,8,0,0,6,14,0,0,0,0,0,0,0,0,0,0,0,0,1
3,50,6,4,4,0,0,2,6,0,0,0,0,0,0,0,0,0,0,0,0,1
3,50,6,4,4,0,0,2,6,1,2,1,2,3,3,2,4,0,2,0,0,1
3,50,7,5,5,0,0,2,7,0,0,0,0,0,0,0,0,0,0,0,0,1
3,50,10,6,6,0,0,4,10,0,0,0,0,0,0,0,0,0,0,0,0,1
3,50,1,1,1,0,0,0,1,0,0,0,0,0,0,0,0,0,0,0,0,1
3,50,14,10,10,0,0,4,14,1,1,1,1,2,2,0,2,0,1,0,0,1
3,50,46,26,30,3,0,12,49,3,6,3,6,9,9,20,28,1,42,2,0,1
25,611,1043,504,840,53,9,147,1096,9,180,112,198,189,310,1377,2344,4,11604,644,0,1
25,611,383,288,292,26,6,62,409,11,65,38,67,76,105,429,656,5,3719,206,0,1
46,833,373,158,315,8,0,51,381,5,76,44,79,81,123,486,779,2,2026,112,0,1
25,1269,1289,550,1043,56,32,155,1345,10,167,93,185,177,278,1266,2075,5,11498,638,0,1
48,3264,1457,730,1242,11,6,188,1468,10,292,166,329,302,495,2424,4078,5,22973,1276,1,1
13,660,334,251,279,10,4,40,344,5,127,74,143,132,217,899,1528,2,4303,239,0,1
23,1008,373,158,315,8,0,51,381,5,76,44,79,81,123,486,779,2,2026,112,0,1
48,3264,1457,730,1242,11,6,188,1468,10,292,166,329,302,495,2424,4078,5,22973,1276,1,0
57,1281,1457,730,1242,11,6,188,1468,10,292,166,329,302,495,2424,4078,5,22973,1276,1,0
57,1281,74,35,59,1,0,14,75,3,14,7,14,17,21,58,85,1,128,7,0,0
57,1281,245,125,200,5,7,34,250,7,30,17,34,37,51,166,265,3,1053,58,0,0
51,1168,1457,730,1242,11,6,188,1468,10,292,166,329,302,495,2424,4078,5,22973,1276,1,1
51,1168,74,35,59,1,0,14,75,3,14,7,14,17,21,58,85,1,128,7,0,1
51,1168,245,125,200,5,7,34,250,7,30,17,34,37,51,166,265,3,1053,58,0,1
44,2896,1457,730,1242,11,6,188,1468,10,292,166,329,302,495,2424,4078,5,22973,1276,1,1
24,1043,373,158,315,8,0,51,381,5,76,44,79,81,123,486,779,2,2026,112,0,1
98,3601,1392,870,1177,35,17,170,1427,14,494,280,531,508,811,4473,7289,7,54850,3047,2,1
52,1181,1457,730,1242,11,6,188,1468,10,292,166,329,302,495,2424,4078,5,22973,1276,1,1
52,1181,74,35,59,1,0,14,75,3,14,7,14,17,21,58,85,1,128,7,0,1
52,1181,245,125,200,5,7,34,250,7,30,17,34,37,51,166,265,3,1053,58,0,1
44,2900,1457,730,1242,11,6,188,1468,10,292,166,329,302,495,2424,4078,5,22973,1276,1,1
61,1328,1457,730,1242,11,6,188,1468,10,292,166,329,302,495,2424,4078,5,22973,1276,1,0
61,1328,74,35,59,1,0,14,75,3,14,7,14,17,21,58,85,1,128,7,0,0
61,1328,245,125,200,5,7,34,250,7,30,17,34,37,51,166,265,3,1053,58,0,0
46,3133,1457,730,1242,11,6,188,1468,10,292,166,329,302,495,2424,4078,5,22973,1276,1,0
150,2573,1338,495,1086,10,64,173,1348,11,122,82,157,133,239,883,1686,7,11934,663,0,1
58,1297,1457,730,1242,11,6,188,1468,10,292,166,329,302,495,2424,4078,5,22973,1276,1,1
58,1297,74,35,59,1,0,14,75,3,14,7,14,17,21,58,85,1,128,7,0,1
58,1297,245,125,200,5,7,34,250,7,30,17,34,37,51,166,265,3,1053,58,0,1
38,2138,1457,730,1242,11,6,188,1468,10,292,166,329,302,495,2424,4078,5,22973,1276,1,1
140,2408,1338,495,1086,10,64,173,1348,11,122,82,157,133,239,883,1686,7,11934,663,0,1
68,1464,1457,730,1242,11,6,188,1468,10,292,166,329,302,495,2424,4078,5,22973,1276,1,1
68,1464,74,35,59,1,0,14,75,3,14,7,14,17,21,58,85,1,128,7,0,1
68,1464,245,125,200,5,7,34,250,7,30,17,34,37,51,166,265,3,1053,58,0,1
25,615,1043,504,840,53,9,147,1096,9,180,112,198,189,310,1377,2344,4,11604,644,0,1
25,615,383,288,292,26,6,62,409,11,65,38,67,76,105,429,656,5,3719,206,0,1
46,829,373,158,315,8,0,51,381,5,76,44,79,81,123,486,779,2,2026,112,0,1
137,2384,1338,495,1086,10,64,173,1348,11,122,82,157,133,239,883,1686,7,11934,663,0,0
139,2411,1338,495,1086,10,64,173,1348,11,122,82,157,133,239,883,1686,7,11934,663,0,0
25,631,1043,504,840,53,9,147,1096,9,180,112,198,189,310,1377,2344,4,11604,644,0,1
25,631,383,288,292,26,6,62,409,11,65,38,67,76,105,429,656,5,3719,206,0,1
1,445,42,7,35,4,0,5,46,1,2,1,2,3,3,2,4,0,2,0,0,0
1,445,11,6,10,0,0,1,11,2,4,2,4,6,6,10,15,1,15,0,0,0
139,2416,1338,495,1086,10,64,173,1348,11,122,82,157,133,239,883,1686,7,11934,663,0,0
87,1898,1392,870,1177,35,17,170,1427,14,494,280,531,508,811,4473,7289,7,54850,3047,2,1
98,3604,1392,870,1177,35,17,170,1427,14,494,280,531,508,811,4473,7289,7,54850,3047,2,0
1,87,127,75,83,2,11,30,129,4,14,7,14,18,21,61,87,2,175,9,0,1
1,87,652,304,544,16,6,88,668,6,89,51,101,95,152,591,998,3,3399,188,0,1
1,87,2,2,2,0,0,0,2,0,0,0,0,0,0,0,0,0,0,0,0,1
1,87,8,5,5,0,0,3,8,0,0,0,0,0,0,0,0,0,0,0,0,1
1,87,14,8,8,0,0,6,14,0,0,0,0,0,0,0,0,0,0,0,0,1
1,87,6,4,4,0,0,2,6,0,0,0,0,0,0,0,0,0,0,0,0,1
1,87,6,4,4,0,0,2,6,1,2,1,2,3,3,2,4,0,2,0,0,1
1,87,7,5,5,0,0,2,7,0,0,0,0,0,0,0,0,0,0,0,0,1
1,87,10,6,6,0,0,4,10,0,0,0,0,0,0,0,0,0,0,0,0,1
1,87,1,1,1,0,0,0,1,0,0,0,0,0,0,0,0,0,0,0,0,1
1,87,14,10,10,0,0,4,14,1,1,1,1,2,2,0,2,0,1,0,0,1
1,87,46,26,30,3,0,12,49,3,6,3,6,9,9,20,28,1,42,2,0,1
1,85,127,75,83,2,11,30,129,4,14,7,14,18,21,61,87,2,175,9,0,0
1,85,652,304,544,16,6,88,668,6,89,51,101,95,152,591,998,3,3399,188,0,0
1,85,2,2,2,0,0,0,2,0,0,0,0,0,0,0,0,0,0,0,0,0
1,85,8,5,5,0,0,3,8,0,0,0,0,0,0,0,0,0,0,0,0,0
1,85,14,8,8,0,0,6,14,0,0,0,0,0,0,0,0,0,0,0,0,0
1,85,6,4,4,0,0,2,6,0,0,0,0,0,0,0,0,0,0,0,0,0
1,85,6,4,4,0,0,2,6,1,2,1,2,3,3,2,4,0,2,0,0,0
1,85,7,5,5,0,0,2,7,0,0,0,0,0,0,0,0,0,0,0,0,0
1,85,10,6,6,0,0,4,10,0,0,0,0,0,0,0,0,0,0,0,0,0
1,85,1,1,1,0,0,0,1,0,0,0,0,0,0,0,0,0,0,0,0,0
1,85,14,10,10,0,0,4,14,1,1,1,1,2,2,0,2,0,1,0,0,0
1,85,46,26,30,3,0,12,49,3,6,3,6,9,9,20,28,1,42,2,0,0
27,503,334,251,279,10,4,40,344,5,127,74,143,132,217,899,1528,2,4303,239,0,0
70,1507,1457,730,1242,11,6,188,1468,10,292,166,329,302,495,2424,4078,5,22973,1276,1,1
70,1507,74,35,59,1,0,14,75,3,14,7,14,17,21,58,85,1,128,7,0,1
70,1507,245,125,200,5,7,34,250,7,30,17,34,37,51,166,265,3,1053,58,0,1
44,814,373,158,315,8,0,51,381,5,76,44,79,81,123,486,779,2,2026,112,0,1
25,1266,1289,550,1043,56,32,155,1345,10,167,93,185,177,278,1266,2075,5,11498,638,0,1
38,2103,1457,730,1242,11,6,188,1468,10,292,166,329,302,495,2424,4078,5,22973,1276,1,1
71,1538,1457,730,1242,11,6,188,1468,10,292,166,329,302,495,2424,4078,5,22973,1276,1,1
71,1538,74,35,59,1,0,14,75,3,14,7,14,17,21,58,85,1,128,7,0,1
71,1538,245,125,200,5,7,34,250,7,30,17,34,37,51,166,265,3,1053,58,0,1
26,1318,1289,550,1043,56,32,155,1345,10,167,93,185,177,278,1266,2075,5,11498,638,0,1
39,2134,1457,730,1242,11,6,188,1468,10,292,166,329,302,495,2424,4078,5,22973,1276,1,1
72,1555,1457,730,1242,11,6,188,1468,10,292,166,329,302,495,2424,4078,5,22973,1276,1,1
72,1555,74,35,59,1,0,14,75,3,14,7,14,17,21,58,85,1,128,7,0,1
72,1555,245,125,200,5,7,34,250,7,30,17,34,37,51,166,265,3,1053,58,0,1
27,1359,1289,550,1043,56,32,155,1345,10,167,93,185,177,278,1266,2075,5,11498,638,0,1
45,820,373,158,315,8,0,51,381,5,76,44,79,81,123,486,779,2,2026,112,0,1
24,1006,373,158,315,8,0,51,381,5,76,44,79,81,123,486,779,2,2026,112,0,1
45,825,373,158,315,8,0,51,381,5,76,44,79,81,123,486,779,2,2026,112,0,1
75,1627,1457,730,1242,11,6,188,1468,10,292,166,329,302,495,2424,4078,5,22973,1276,1,1
75,1627,74,35,59,1,0,14,75,3,14,7,14,17,21,58,85,1,128,7,0,1
75,1627,245,125,200,5,7,34,250,7,30,17,34,37,51,166,265,3,1053,58,0,1
28,1417,1289,550,1043,56,32,155,1345,10,167,93,185,177,278,1266,2075,5,11498,638,0,1
24,1014,373,158,315,8,0,51,381,5,76,44,79,81,123,486,779,2,2026,112,0,1
78,1708,1457,730,1242,11,6,188,1468,10,292,166,329,302,495,2424,4078,5,22973,1276,1,1
78,1708,74,35,59,1,0,14,75,3,14,7,14,17,21,58,85,1,128,7,0,1
78,1708,245,125,200,5,7,34,250,7,30,17,34,37,51,166,265,3,1053,58,0,1
42,2340,1457,730,1242,11,6,188,1468,10,292,166,329,302,495,2424,4078,5,22973,1276,1,1
28,1435,1289,550,1043,56,32,155,1345,10,167,93,185,177,278,1266,2075,5,11498,638,0,1
78,1712,1457,730,1242,11,6,188,1468,10,292,166,329,302,495,2424,4078,5,22973,1276,1,0
78,1712,74,35,59,1,0,14,75,3,14,7,14,17,21,58,85,1,128,7,0,0
78,1712,245,125,200,5,7,34,250,7,30,17,34,37,51,166,265,3,1053,58,0,0
31,1528,1289,550,1043,56,32,155,1345,10,167,93,185,177,278,1266,2075,5,11498,638,0,1
139,2413,1338,495,1086,10,64,173,1348,11,122,82,157,133,239,883,1686,7,11934,663,0,1
31,1536,1289,550,1043,56,32,155,1345,10,167,93,185,177,278,1266,2075,5,11498,638,0,1
51,1713,773,419,590,28,0,166,801,10,204,113,217,214,330,1598,2554,5,13587,754,0,0
140,2422,1338,495,1086,10,64,173,1348,11,122,82,157,133,239,883,1686,7,11934,663,0,1
140,2417,1338,495,1086,10,64,173,1348,11,122,82,157,133,239,883,1686,7,11934,663,0,1
1,90,127,75,83,2,11,30,129,4,14,7,14,18,21,61,87,2,175,9,0,1
1,90,652,304,544,16,6,88,668,6,89,51,101,95,152,591,998,3,3399,188,0,1
1,90,2,2,2,0,0,0,2,0,0,0,0,0,0,0,0,0,0,0,0,1
1,90,8,5,5,0,0,3,8,0,0,0,0,0,0,0,0,0,0,0,0,1
1,90,14,8,8,0,0,6,14,0,0,0,0,0,0,0,0,0,0,0,0,1
1,90,6,4,4,0,0,2,6,0,0,0,0,0,0,0,0,0,0,0,0,1
1,90,6,4,4,0,0,2,6,1,2,1,2,3,3,2,4,0,2,0,0,1
1,90,7,5,5,0,0,2,7,0,0,0,0,0,0,0,0,0,0,0,0,1
1,90,10,6,6,0,0,4,10,0,0,0,0,0,0,0,0,0,0,0,0,1
1,90,1,1,1,0,0,0,1,0,0,0,0,0,0,0,0,0,0,0,0,1
1,90,14,10,10,0,0,4,14,1,1,1,1,2,2,0,2,0,1,0,0,1
1,90,46,26,30,3,0,12,49,3,6,3,6,9,9,20,28,1,42,2,0,1
78,1737,1457,730,1242,11,6,188,1468,10,292,166,329,302,495,2424,4078,5,22973,1276,1,1
78,1737,74,35,59,1,0,14,75,3,14,7,14,17,21,58,85,1,128,7,0,1
78,1737,245,125,200,5,7,34,250,7,30,17,34,37,51,166,265,3,1053,58,0,1
45,825,373,158,315,8,0,51,381,5,76,44,79,81,123,486,779,2,2026,112,0,0
13,255,127,75,83,2,11,30,129,4,14,7,14,18,21,61,87,2,175,9,0,1
13,255,652,304,544,16,6,88,668,6,89,51,101,95,152,591,998,3,3399,188,0,1
13,255,2,2,2,0,0,0,2,0,0,0,0,0,0,0,0,0,0,0,0,1
13,255,8,5,5,0,0,3,8,0,0,0,0,0,0,0,0,0,0,0,0,1
13,255,14,8,8,0,0,6,14,0,0,0,0,0,0,0,0,0,0,0,0,1
13,255,6,4,4,0,0,2,6,0,0,0,0,0,0,0,0,0,0,0,0,1
13,255,6,4,4,0,0,2,6,1,2,1,2,3,3,2,4,0,2,0,0,1
13,255,7,5,5,0,0,2,7,0,0,0,0,0,0,0,0,0,0,0,0,1
13,255,10,6,6,0,0,4,10,0,0,0,0,0,0,0,0,0,0,0,0,1
13,255,1,1,1,0,0,0,1,0,0,0,0,0,0,0,0,0,0,0,0,1
13,255,14,10,10,0,0,4,14,1,1,1,1,2,2,0,2,0,1,0,0,1
13,255,46,26,30,3,0,12,49,3,6,3,6,9,9,20,28,1,42,2,0,1
13,271,127,75,83,2,11,30,129,4,14,7,14,18,21,61,87,2,175,9,0,1
13,271,652,304,544,16,6,88,668,6,89,51,101,95,152,591,998,3,3399,188,0,1
13,271,2,2,2,0,0,0,2,0,0,0,0,0,0,0,0,0,0,0,0,1
13,271,8,5,5,0,0,3,8,0,0,0,0,0,0,0,0,0,0,0,0,1
13,271,14,8,8,0,0,6,14,0,0,0,0,0,0,0,0,0,0,0,0,1
13,271,6,4,4,0,0,2,6,0,0,0,0,0,0,0,0,0,0,0,0,1
13,271,6,4,4,0,0,2,6,1,2,1,2,3,3,2,4,0,2,0,0,1
13,271,7,5,5,0,0,2,7,0,0,0,0,0,0,0,0,0,0,0,0,1
13,271,10,6,6,0,0,4,10,0,0,0,0,0,0,0,0,0,0,0,0,1
13,271,1,1,1,0,0,0,1,0,0,0,0,0,0,0,0,0,0,0,0,1
13,271,14,10,10,0,0,4,14,1,1,1,1,2,2,0,2,0,1,0,0,1
13,271,46,26,30,3,0,12,49,3,6,3,6,9,9,20,28,1,42,2,0,1
31,1539,1289,550,1043,56,32,155,1345,10,167,93,185,177,278,1266,2075,5,11498,638,0,0
45,801,373,158,315,8,0,51,381,5,76,44,79,81,123,486,779,2,2026,112,0,1
42,2324,1457,730,1242,11,6,188,1468,10,292,166,329,302,495,2424,4078,5,22973,1276,1,0
94,1980,1457,730,1242,11,6,188,1468,10,292,166,329,302,495,2424,4078,5,22973,1276,1,1
94,1980,74,35,59,1,0,14,75,3,14,7,14,17,21,58,85,1,128,7,0,1
94,1980,245,125,200,5,7,34,250,7,30,17,34,37,51,166,265,3,1053,58,0,1
31,1539,1289,550,1043,56,32,155,1345,10,167,93,185,177,278,1266,2075,5,11498,638,0,1
42,2324,1457,730,1242,11,6,188,1468,10,292,166,329,302,495,2424,4078,5,22973,1276,1,1
45,796,373,158,315,8,0,51,381,5,76,44,79,81,123,486,779,2,2026,112,0,1
1,449,42,7,35,4,0,5,46,1,2,1,2,3,3,2,4,0,2,0,0,1
1,449,11,6,10,0,0,1,11,2,4,2,4,6,6,10,15,1,15,0,0,1
93,1970,1457,730,1242,11,6,188,1468,10,292,166,329,302,495,2424,4078,5,22973,1276,1,1
93,1970,74,35,59,1,0,14,75,3,14,7,14,17,21,58,85,1,128,7,0,1
93,1970,245,125,200,5,7,34,250,7,30,17,34,37,51,166,265,3,1053,58,0,1
40,756,373,158,315,8,0,51,381,5,76,44,79,81,123,486,779,2,2026,112,0,1
37,2114,1457,730,1242,11,6,188,1468,10,292,166,329,302,495,2424,4078,5,22973,1276,1,1
93,1972,1457,730,1242,11,6,188,1468,10,292,166,329,302,495,2424,4078,5,22973,1276,1,1
93,1972,74,35,59,1,0,14,75,3,14,7,14,17,21,58,85,1,128,7,0,1
93,1972,245,125,200,5,7,34,250,7,30,17,34,37,51,166,265,3,1053,58,0,1
92,1962,1457,730,1242,11,6,188,1468,10,292,166,329,302,495,2424,4078,5,22973,1276,1,0
92,1962,74,35,59,1,0,14,75,3,14,7,14,17,21,58,85,1,128,7,0,0
92,1962,245,125,200,5,7,34,250,7,30,17,34,37,51,166,265,3,1053,58,0,0
93,2003,1457,730,1242,11,6,188,1468,10,292,166,329,302,495,2424,4078,5,22973,1276,1,0
93,2003,74,35,59,1,0,14,75,3,14,7,14,17,21,58,85,1,128,7,0,0
93,2003,245,125,200,5,7,34,250,7,30,17,34,37,51,166,265,3,1053,58,0,0
43,2395,1457,730,1242,11,6,188,1468,10,292,166,329,302,495,2424,4078,5,22973,1276,1,0
92,1980,1457,730,1242,11,6,188,1468,10,292,166,329,302,495,2424,4078,5,22973,1276,1,1
92,1980,74,35,59,1,0,14,75,3,14,7,14,17,21,58,85,1,128,7,0,1
92,1980,245,125,200,5,7,34,250,7,30,17,34,37,51,166,265,3,1053,58,0,1
33,1753,1289,550,1043,56,32,155,1345,10,167,93,185,177,278,1266,2075,5,11498,638,0,1
13,269,127,75,83,2,11,30,129,4,14,7,14,18,21,61,87,2,175,9,0,0
13,269,652,304,544,16,6,88,668,6,89,51,101,95,152,591,998,3,3399,188,0,0
13,269,2,2,2,0,0,0,2,0,0,0,0,0,0,0,0,0,0,0,0,0
13,269,8,5,5,0,0,3,8,0,0,0,0,0,0,0,0,0,0,0,0,0
13,269,14,8,8,0,0,6,14,0,0,0,0,0,0,0,0,0,0,0,0,0
13,269,6,4,4,0,0,2,6,0,0,0,0,0,0,0,0,0,0,0,0,0
13,269,6,4,4,0,0,2,6,1,2,1,2,3,3,2,4,0,2,0,0,0
13,269,7,5,5,0,0,2,7,0,0,0,0,0,0,0,0,0,0,0,0,0
13,269,10,6,6,0,0,4,10,0,0,0,0,0,0,0,0,0,0,0,0,0
13,269,1,1,1,0,0,0,1,0,0,0,0,0,0,0,0,0,0,0,0,0
13,269,14,10,10,0,0,4,14,1,1,1,1,2,2,0,2,0,1,0,0,0
13,269,46,26,30,3,0,12,49,3,6,3,6,9,9,20,28,1,42,2,0,0
33,1781,1289,550,1043,56,32,155,1345,10,167,93,185,177,278,1266,2075,5,11498,638,0,0
1,461,42,7,35,4,0,5,46,1,2,1,2,3,3,2,4,0,2,0,0,1
1,461,11,6,10,0,0,1,11,2,4,2,4,6,6,10,15,1,15,0,0,1
1,459,42,7,35,4,0,5,46,1,2,1,2,3,3,2,4,0,2,0,0,0
1,459,11,6,10,0,0,1,11,2,4,2,4,6,6,10,15,1,15,0,0,0
1,459,42,7,35,4,0,5,46,1,2,1,2,3,3,2,4,0,2,0,0,1
1,459,11,6,10,0,0,1,11,2,4,2,4,6,6,10,15,1,15,0,0,1
1,445,42,7,35,4,0,5,46,1,2,1,2,3,3,2,4,0,2,0,0,1
1,445,11,6,10,0,0,1,11,2,4,2,4,6,6,10,15,1,15,0,0,1
1,433,42,7,35,4,0,5,46,1,2,1,2,3,3,2,4,0,2,0,0,1
1,433,11,6,10,0,0,1,11,2,4,2,4,6,6,10,15,1,15,0,0,1
96,2109,1457,730,1242,11,6,188,1468,10,292,166,329,302,495,2424,4078,5,22973,1276,1,0
96,2109,74,35,59,1,0,14,75,3,14,7,14,17,21,58,85,1,128,7,0,0
96,2109,245,125,200,5,7,34,250,7,30,17,34,37,51,166,265,3,1053,58,0,0
43,2292,1457,730,1242,11,6,188,1468,10,292,166,329,302,495,2424,4078,5,22973,1276,1,0
33,1810,1289,550,1043,56,32,155,1345,10,167,93,185,177,278,1266,2075,5,11498,638,0,1
3,441,42,7,35,4,0,5,46,1,2,1,2,3,3,2,4,0,2,0,0,1
3,441,11,6,10,0,0,1,11,2,4,2,4,6,6,10,15,1,15,0,0,1
13,269,127,75,83,2,11,30,129,4,14,7,14,18,21,61,87,2,175,9,0,1
13,269,652,304,544,16,6,88,668,6,89,51,101,95,152,591,998,3,3399,188,0,1
13,269,2,2,2,0,0,0,2,0,0,0,0,0,0,0,0,0,0,0,0,1
13,269,8,5,5,0,0,3,8,0,0,0,0,0,0,0,0,0,0,0,0,1
13,269,14,8,8,0,0,6,14,0,0,0,0,0,0,0,0,0,0,0,0,1
13,269,6,4,4,0,0,2,6,0,0,0,0,0,0,0,0,0,0,0,0,1
13,269,6,4,4,0,0,2,6,1,2,1,2,3,3,2,4,0,2,0,0,1
13,269,7,5,5,0,0,2,7,0,0,0,0,0,0,0,0,0,0,0,0,1
13,269,10,6,6,0,0,4,10,0,0,0,0,0,0,0,0,0,0,0,0,1
13,269,1,1,1,0,0,0,1,0,0,0,0,0,0,0,0,0,0,0,0,1
13,269,14,10,10,0,0,4,14,1,1,1,1,2,2,0,2,0,1,0,0,1
13,269,46,26,30,3,0,12,49,3,6,3,6,9,9,20,28,1,42,2,0,1
92,1980,1457,730,1242,11,6,188,1468,10,292,166,329,302,495,2424,4078,5,22973,1276,1,0
92,1980,74,35,59,1,0,14,75,3,14,7,14,17,21,58,85,1,128,7,0,0
92,1980,245,125,200,5,7,34,250,7,30,17,34,37,51,166,265,3,1053,58,0,0
37,2114,1457,730,1242,11,6,188,1468,10,292,166,329,302,495,2424,4078,5,22973,1276,1,0
3,399,42,7,35,4,0,5,46,1,2,1,2,3,3,2,4,0,2,0,0,0
3,399,11,6,10,0,0,1,11,2,4,2,4,6,6,10,15,1,15,0,0,0
27,519,334,251,279,10,4,40,344,5,127,74,143,132,217,899,1528,2,4303,239,0,0
13,660,334,251,279,10,4,40,344,5,127,74,143,132,217,899,1528,2,4303,239,0,0
1,383,42,7,35,4,0,5,46,1,2,1,2,3,3,2,4,0,2,0,0,0
1,383,11,6,10,0,0,1,11,2,4,2,4,6,6,10,15,1,15,0,0,0
36,2098,1457,730,1242,11,6,188,1468,10,292,166,329,302,495,2424,4078,5,22973,1276,1,0
13,267,127,75,83,2,11,30,129,4,14,7,14,18,21,61,87,2,175,9,0,1
13,267,652,304,544,16,6,88,668,6,89,51,101,95,152,591,998,3,3399,188,0,1
13,267,2,2,2,0,0,0,2,0,0,0,0,0,0,0,0,0,0,0,0,1
13,267,8,5,5,0,0,3,8,0,0,0,0,0,0,0,0,0,0,0,0,1
13,267,14,8,8,0,0,6,14,0,0,0,0,0,0,0,0,0,0,0,0,1
13,267,6,4,4,0,0,2,6,0,0,0,0,0,0,0,0,0,0,0,0,1
13,267,6,4,4,0,0,2,6,1,2,1,2,3,3,2,4,0,2,0,0,1
13,267,7,5,5,0,0,2,7,0,0,0,0,0,0,0,0,0,0,0,0,1
13,267,10,6,6,0,0,4,10,0,0,0,0,0,0,0,0,0,0,0,0,1
13,267,1,1,1,0,0,0,1,0,0,0,0,0,0,0,0,0,0,0,0,1
13,267,14,10,10,0,0,4,14,1,1,1,1,2,2,0,2,0,1,0,0,1
13,267,46,26,30,3,0,12,49,3,6,3,6,9,9,20,28,1,42,2,0,1
1,319,42,7,35,4,0,5,46,1,2,1,2,3,3,2,4,0,2,0,0,0
1,319,11,6,10,0,0,1,11,2,4,2,4,6,6,10,15,1,15,0,0,0
31,322,757,253,292,73,244,162,830,13,61,38,67,74,105,409,651,7,4654,258,0,0
13,272,127,75,83,2,11,30,129,4,14,7,14,18,21,61,87,2,175,9,0,1
13,272,652,304,544,16,6,88,668,6,89,51,101,95,152,591,998,3,3399,188,0,1
13,272,2,2,2,0,0,0,2,0,0,0,0,0,0,0,0,0,0,0,0,1
13,272,8,5,5,0,0,3,8,0,0,0,0,0,0,0,0,0,0,0,0,1
13,272,14,8,8,0,0,6,14,0,0,0,0,0,0,0,0,0,0,0,0,1
13,272,6,4,4,0,0,2,6,0,0,0,0,0,0,0,0,0,0,0,0,1
13,272,6,4,4,0,0,2,6,1,2,1,2,3,3,2,4,0,2,0,0,1
13,272,7,5,5,0,0,2,7,0,0,0,0,0,0,0,0,0,0,0,0,1
13,272,10,6,6,0,0,4,10,0,0,0,0,0,0,0,0,0,0,0,0,1
13,272,1,1,1,0,0,0,1,0,0,0,0,0,0,0,0,0,0,0,0,1
13,272,14,10,10,0,0,4,14,1,1,1,1,2,2,0,2,0,1,0,0,1
13,272,46,26,30,3,0,12,49,3,6,3,6,9,9,20,28,1,42,2,0,1
31,320,757,253,292,73,244,162,830,13,61,38,67,74,105,409,651,7,4654,258,0,1
40,750,373,158,315,8,0,51,381,5,76,44,79,81,123,486,779,2,2026,112,0,1
24,1016,373,158,315,8,0,51,381,5,76,44,79,81,123,486,779,2,2026,112,0,1
31,324,757,253,292,73,244,162,830,13,61,38,67,74,105,409,651,7,4654,258,0,1
42,753,373,158,315,8,0,51,381,5,76,44,79,81,123,486,779,2,2026,112,0,1
42,748,373,158,315,8,0,51,381,5,76,44,79,81,123,486,779,2,2026,112,0,1
42,737,373,158,315,8,0,51,381,5,76,44,79,81,123,486,779,2,2026,112,0,1
31,326,757,253,292,73,244,162,830,13,61,38,67,74,105,409,651,7,4654,258,0,1
23,632,1043,504,840,53,9,147,1096,9,180,112,198,189,310,1377,2344,4,11604,644,0,0
23,632,383,288,292,26,6,62,409,11,65,38,67,76,105,429,656,5,3719,206,0,0
23,1002,373,158,315,8,0,51,381,5,76,44,79,81,123,486,779,2,2026,112,0,0
19,509,1043,504,840,53,9,147,1096,9,180,112,198,189,310,1377,2344,4,11604,644,0,1
19,509,383,288,292,26,6,62,409,11,65,38,67,76,105,429,656,5,3719,206,0,1
138,2386,1338,495,1086,10,64,173,1348,11,122,82,157,133,239,883,1686,7,11934,663,0,0
32,339,757,253,292,73,244,162,830,13,61,38,67,74,105,409,651,7,4654,258,0,0
42,736,373,158,315,8,0,51,381,5,76,44,79,81,123,486,779,2,2026,112,0,0
42,724,373,158,315,8,0,51,381,5,76,44,79,81,123,486,779,2,2026,112,0,0
17,451,1043,504,840,53,9,147,1096,9,180,112,198,189,310,1377,2344,4,11604,644,0,0
17,451,383,288,292,26,6,62,409,11,65,38,67,76,105,429,656,5,3719,206,0,0
19,276,477,336,357,30,23,73,507,16,194,134,250,210,384,1538,2962,10,30538,1696,0,0
42,722,373,158,315,8,0,51,381,5,76,44,79,81,123,486,779,2,2026,112,0,0
33,872,1043,504,840,53,9,147,1096,9,180,112,198,189,310,1377,2344,4,11604,644,0,1
33,872,383,288,292,26,6,62,409,11,65,38,67,76,105,429,656,5,3719,206,0,1
82,1830,1457,730,1242,11,6,188,1468,10,292,166,329,302,495,2424,4078,5,22973,1276,1,1
82,1830,74,35,59,1,0,14,75,3,14,7,14,17,21,58,85,1,128,7,0,1
82,1830,245,125,200,5,7,34,250,7,30,17,34,37,51,166,265,3,1053,58,0,1
33,348,757,253,292,73,244,162,830,13,61,38,67,74,105,409,651,7,4654,258,0,1
53,1236,1043,504,840,53,9,147,1096,9,180,112,198,189,310,1377,2344,4,11604,644,0,1
53,1236,383,288,292,26,6,62,409,11,65,38,67,76,105,429,656,5,3719,206,0,1
34,361,757,253,292,73,244,162,830,13,61,38,67,74,105,409,651,7,4654,258,0,1
55,1341,1043,504,840,53,9,147,1096,9,180,112,198,189,310,1377,2344,4,11604,644,0,1
55,1341,383,288,292,26,6,62,409,11,65,38,67,76,105,429,656,5,3719,206,0,1
6,416,1043,504,840,53,9,147,1096,9,180,112,198,189,310,1377,2344,4,11604,644,0,1
42,722,373,158,315,8,0,51,381,5,76,44,79,81,123,486,779,2,2026,112,0,1
53,1303,1043,504,840,53,9,147,1096,9,180,112,198,189,310,1377,2344,4,11604,644,0,0
53,1303,383,288,292,26,6,62,409,11,65,38,67,76,105,429,656,5,3719,206,0,0
6,416,1043,504,840,53,9,147,1096,9,180,112,198,189,310,1377,2344,4,11604,644,0,0
35,374,757,253,292,73,244,162,830,13,61,38,67,74,105,409,651,7,4654,258,0,1
53,1303,1043,504,840,53,9,147,1096,9,180,112,198,189,310,1377,2344,4,11604,644,0,1
53,1303,383,288,292,26,6,62,409,11,65,38,67,76,105,429,656,5,3719,206,0,1
23,1002,373,158,315,8,0,51,381,5,76,44,79,81,123,486,779,2,2026,112,0,1
35,374,757,253,292,73,244,162,830,13,61,38,67,74,105,409,651,7,4654,258,0,0
53,1300,1043,504,840,53,9,147,1096,9,180,112,198,189,310,1377,2344,4,11604,644,0,0
53,1300,383,288,292,26,6,62,409,11,65,38,67,76,105,429,656,5,3719,206,0,0
45,1284,2,2,2,0,0,0,2,0,0,0,0,0,0,0,0,0,0,0,0,0
45,1284,99,48,90,1,3,5,100,0,0,0,0,0,0,0,0,0,0,0,0,0
45,1284,8,5,5,2,0,1,10,0,0,0,0,0,0,0,0,0,0,0,0,0
45,1284,1217,716,841,84,126,174,1301,14,185,118,215,199,333,1446,2542,8,20687,1149,0,0
45,1284,160,89,115,0,13,31,160,7,15,11,17,22,28,78,124,3,495,27,0,0
45,1284,10,10,9,9,0,0,19,0,0,0,0,0,0,0,0,0,0,0,0,0
45,1284,173,84,99,8,29,36,181,5,12,7,13,17,20,54,81,2,221,12,0,0
45,1284,3,1,1,3,0,0,6,0,0,0,0,0,0,0,0,0,0,0,0,0
16,393,2,2,2,0,0,0,2,0,0,0,0,0,0,0,0,0,0,0,0,0
16,393,99,48,90,1,3,5,100,0,0,0,0,0,0,0,0,0,0,0,0,0
16,393,8,5,5,2,0,1,10,0,0,0,0,0,0,0,0,0,0,0,0,0
16,393,1217,716,841,84,126,174,1301,14,185,118,215,199,333,1446,2542,8,20687,1149,0,0
16,393,160,89,115,0,13,31,160,7,15,11,17,22,28,78,124,3,495,27,0,0
16,393,10,10,9,9,0,0,19,0,0,0,0,0,0,0,0,0,0,0,0,0
16,393,173,84,99,8,29,36,181,5,12,7,13,17,20,54,81,2,221,12,0,0
16,393,3,1,1,3,0,0,6,0,0,0,0,0,0,0,0,0,0,0,0,0
88,1951,1457,730,1242,11,6,188,1468,10,292,166,329,302,495,2424,4078,5,22973,1276,1,1
88,1951,74,35,59,1,0,14,75,3,14,7,14,17,21,58,85,1,128,7,0,1
88,1951,245,125,200,5,7,34,250,7,30,17,34,37,51,166,265,3,1053,58,0,1
49,1248,1043,504,840,53,9,147,1096,9,180,112,198,189,310,1377,2344,4,11604,644,0,1
49,1248,383,288,292,26,6,62,409,11,65,38,67,76,105,429,656,5,3719,206,0,1
42,2284,1457,730,1242,11,6,188,1468,10,292,166,329,302,495,2424,4078,5,22973,1276,1,1
44,1071,1043,504,840,53,9,147,1096,9,180,112,198,189,310,1377,2344,4,11604,644,0,0
44,1071,383,288,292,26,6,62,409,11,65,38,67,76,105,429,656,5,3719,206,0,0
6,419,1043,504,840,53,9,147,1096,9,180,112,198,189,310,1377,2344,4,11604,644,0,0
88,1960,1457,730,1242,11,6,188,1468,10,292,166,329,302,495,2424,4078,5,22973,1276,1,1
88,1960,74,35,59,1,0,14,75,3,14,7,14,17,21,58,85,1,128,7,0,1
88,1960,245,125,200,5,7,34,250,7,30,17,34,37,51,166,265,3,1053,58,0,1
36,387,757,253,292,73,244,162,830,13,61,38,67,74,105,409,651,7,4654,258,0,1
138,2382,1338,495,1086,10,64,173,1348,11,122,82,157,133,239,883,1686,7,11934,663,0,0
37,416,757,253,292,73,244,162,830,13,61,38,67,74,105,409,651,7,4654,258,0,0
44,1069,1043,504,840,53,9,147,1096,9,180,112,198,189,310,1377,2344,4,11604,644,0,0
44,1069,383,288,292,26,6,62,409,11,65,38,67,76,105,429,656,5,3719,206,0,0
13,274,127,75,83,2,11,30,129,4,14,7,14,18,21,61,87,2,175,9,0,1
13,274,652,304,544,16,6,88,668,6,89,51,101,95,152,591,998,3,3399,188,0,1
13,274,2,2,2,0,0,0,2,0,0,0,0,0,0,0,0,0,0,0,0,1
13,274,8,5,5,0,0,3,8,0,0,0,0,0,0,0,0,0,0,0,0,1
13,274,14,8,8,0,0,6,14,0,0,0,0,0,0,0,0,0,0,0,0,1
13,274,6,4,4,0,0,2,6,0,0,0,0,0,0,0,0,0,0,0,0,1
13,274,6,4,4,0,0,2,6,1,2,1,2,3,3,2,4,0,2,0,0,1
13,274,7,5,5,0,0,2,7,0,0,0,0,0,0,0,0,0,0,0,0,1
13,274,10,6,6,0,0,4,10,0,0,0,0,0,0,0,0,0,0,0,0,1
13,274,1,1,1,0,0,0,1,0,0,0,0,0,0,0,0,0,0,0,0,1
13,274,14,10,10,0,0,4,14,1,1,1,1,2,2,0,2,0,1,0,0,1
13,274,46,26,30,3,0,12,49,3,6,3,6,9,9,20,28,1,42,2,0,1
37,418,757,253,292,73,244,162,830,13,61,38,67,74,105,409,651,7,4654,258,0,1
33,376,757,253,292,73,244,162,830,13,61,38,67,74,105,409,651,7,4654,258,0,1
34,385,757,253,292,73,244,162,830,13,61,38,67,74,105,409,651,7,4654,258,0,1
44,1069,1043,504,840,53,9,147,1096,9,180,112,198,189,310,1377,2344,4,11604,644,0,1
44,1069,383,288,292,26,6,62,409,11,65,38,67,76,105,429,656,5,3719,206,0,1
42,733,373,158,315,8,0,51,381,5,76,44,79,81,123,486,779,2,2026,112,0,1
6,419,1043,504,840,53,9,147,1096,9,180,112,198,189,310,1377,2344,4,11604,644,0,1
33,376,757,253,292,73,244,162,830,13,61,38,67,74,105,409,651,7,4654,258,0,0
42,734,373,158,315,8,0,51,381,5,76,44,79,81,123,486,779,2,2026,112,0,0
42,736,373,158,315,8,0,51,381,5,76,44,79,81,123,486,779,2,2026,112,0,1
88,1958,1457,730,1242,11,6,188,1468,10,292,166,329,302,495,2424,4078,5,22973,1276,1,1
88,1958,74,35,59,1,0,14,75,3,14,7,14,17,21,58,85,1,128,7,0,1
88,1958,245,125,200,5,7,34,250,7,30,17,34,37,51,166,265,3,1053,58,0,1
31,347,757,253,292,73,244,162,830,13,61,38,67,74,105,409,651,7,4654,258,0,1
15,369,386,256,301,16,9,68,402,4,59,35,69,63,104,355,621,2,1453,80,0,0
15,369,264,131,164,11,41,46,275,6,38,22,40,44,62,214,338,3,1068,59,0,0
88,1960,1457,730,1242,11,6,188,1468,10,292,166,329,302,495,2424,4078,5,22973,1276,1,0
88,1960,74,35,59,1,0,14,75,3,14,7,14,17,21,58,85,1,128,7,0,0
88,1960,245,125,200,5,7,34,250,7,30,17,34,37,51,166,265,3,1053,58,0,0
31,347,757,253,292,73,244,162,830,13,61,38,67,74,105,409,651,7,4654,258,0,0
138,2382,1338,495,1086,10,64,173,1348,11,122,82,157,133,239,883,1686,7,11934,663,0,1
88,1953,1457,730,1242,11,6,188,1468,10,292,166,329,302,495,2424,4078,5,22973,1276,1,1
88,1953,74,35,59,1,0,14,75,3,14,7,14,17,21,58,85,1,128,7,0,1
88,1953,245,125,200,5,7,34,250,7,30,17,34,37,51,166,265,3,1053,58,0,1
42,2286,1457,730,1242,11,6,188,1468,10,292,166,329,302,495,2424,4078,5,22973,1276,1,1
42,905,384,251,317,7,8,52,391,11,70,44,84,81,128,467,811,6,5355,297,0,0
33,1623,384,251,317,7,8,52,391,11,70,44,84,81,128,467,811,6,5355,297,0,0
42,906,384,251,317,7,8,52,391,11,70,44,84,81,128,467,811,6,5355,297,0,1
42,924,384,251,317,7,8,52,391,11,70,44,84,81,128,467,811,6,5355,297,0,1
33,1629,384,251,317,7,8,52,391,11,70,44,84,81,128,467,811,6,5355,297,0,1
138,2380,1338,495,1086,10,64,173,1348,11,122,82,157,133,239,883,1686,7,11934,663,0,1
31,352,757,253,292,73,244,162,830,13,61,38,67,74,105,409,651,7,4654,258,0,1
42,944,384,251,317,7,8,52,391,11,70,44,84,81,128,467,811,6,5355,297,0,1
30,1516,384,251,317,7,8,52,391,11,70,44,84,81,128,467,811,6,5355,297,0,1
88,1947,1457,730,1242,11,6,188,1468,10,292,166,329,302,495,2424,4078,5,22973,1276,1,0
88,1947,74,35,59,1,0,14,75,3,14,7,14,17,21,58,85,1,128,7,0,0
88,1947,245,125,200,5,7,34,250,7,30,17,34,37,51,166,265,3,1053,58,0,0
20,481,2,2,2,0,0,0,2,0,0,0,0,0,0,0,0,0,0,0,0,1
20,481,99,48,90,1,3,5,100,0,0,0,0,0,0,0,0,0,0,0,0,1
20,481,8,5,5,2,0,1,10,0,0,0,0,0,0,0,0,0,0,0,0,1
20,481,1217,716,841,84,126,174,1301,14,185,118,215,199,333,1446,2542,8,20687,1149,0,1
20,481,160,89,115,0,13,31,160,7,15,11,17,22,28,78,124,3,495,27,0,1
20,481,10,10,9,9,0,0,19,0,0,0,0,0,0,0,0,0,0,0,0,1
20,481,173,84,99,8,29,36,181,5,12,7,13,17,20,54,81,2,221,12,0,1
20,481,3,1,1,3,0,0,6,0,0,0,0,0,0,0,0,0,0,0,0,1
45,1292,2,2,2,0,0,0,2,0,0,0,0,0,0,0,0,0,0,0,0,0
45,1292,99,48,90,1,3,5,100,0,0,0,0,0,0,0,0,0,0,0,0,0
45,1292,8,5,5,2,0,1,10,0,0,0,0,0,0,0,0,0,0,0,0,0
45,1292,1217,716,841,84,126,174,1301,14,185,118,215,199,333,1446,2542,8,20687,1149,0,0
45,1292,160,89,115,0,13,31,160,7,15,11,17,22,28,78,124,3,495,27,0,0
45,1292,10,10,9,9,0,0,19,0,0,0,0,0,0,0,0,0,0,0,0,0
45,1292,173,84,99,8,29,36,181,5,12,7,13,17,20,54,81,2,221,12,0,0
45,1292,3,1,1,3,0,0,6,0,0,0,0,0,0,0,0,0,0,0,0,0
1,312,42,7,35,4,0,5,46,1,2,1,2,3,3,2,4,0,2,0,0,1
1,312,11,6,10,0,0,1,11,2,4,2,4,6,6,10,15,1,15,0,0,1
27,522,334,251,279,10,4,40,344,5,127,74,143,132,217,899,1528,2,4303,239,0,0
14,695,334,251,279,10,4,40,344,5,127,74,143,132,217,899,1528,2,4303,239,0,0
2,32,127,75,83,2,11,30,129,4,14,7,14,18,21,61,87,2,175,9,0,1
2,32,652,304,544,16,6,88,668,6,89,51,101,95,152,591,998,3,3399,188,0,1
2,32,2,2,2,0,0,0,2,0,0,0,0,0,0,0,0,0,0,0,0,1
2,32,8,5,5,0,0,3,8,0,0,0,0,0,0,0,0,0,0,0,0,1
2,32,14,8,8,0,0,6,14,0,0,0,0,0,0,0,0,0,0,0,0,1
2,32,6,4,4,0,0,2,6,0,0,0,0,0,0,0,0,0,0,0,0,1
2,32,6,4,4,0,0,2,6,1,2,1,2,3,3,2,4,0,2,0,0,1
2,32,7,5,5,0,0,2,7,0,0,0,0,0,0,0,0,0,0,0,0,1
2,32,10,6,6,0,0,4,10,0,0,0,0,0,0,0,0,0,0,0,0,1
2,32,1,1,1,0,0,0,1,0,0,0,0,0,0,0,0,0,0,0,0,1
2,32,14,10,10,0,0,4,14,1,1,1,1,2,2,0,2,0,1,0,0,1
2,32,46,26,30,3,0,12,49,3,6,3,6,9,9,20,28,1,42,2,0,1
42,953,384,251,317,7,8,52,391,11,70,44,84,81,128,467,811,6,5355,297,0,1
42,955,384,251,317,7,8,52,391,11,70,44,84,81,128,467,811,6,5355,297,0,1
2,32,127,75,83,2,11,30,129,4,14,7,14,18,21,61,87,2,175,9,0,0
2,32,652,304,544,16,6,88,668,6,89,51,101,95,152,591,998,3,3399,188,0,0
2,32,2,2,2,0,0,0,2,0,0,0,0,0,0,0,0,0,0,0,0,0
2,32,8,5,5,0,0,3,8,0,0,0,0,0,0,0,0,0,0,0,0,0
2,32,14,8,8,0,0,6,14,0,0,0,0,0,0,0,0,0,0,0,0,0
2,32,6,4,4,0,0,2,6,0,0,0,0,0,0,0,0,0,0,0,0,0
2,32,6,4,4,0,0,2,6,1,2,1,2,3,3,2,4,0,2,0,0,0
2,32,7,5,5,0,0,2,7,0,0,0,0,0,0,0,0,0,0,0,0,0
2,32,10,6,6,0,0,4,10,0,0,0,0,0,0,0,0,0,0,0,0,0
2,32,1,1,1,0,0,0,1,0,0,0,0,0,0,0,0,0,0,0,0,0
2,32,14,10,10,0,0,4,14,1,1,1,1,2,2,0,2,0,1,0,0,0
2,32,46,26,30,3,0,12,49,3,6,3,6,9,9,20,28,1,42,2,0,0
13,274,127,75,83,2,11,30,129,4,14,7,14,18,21,61,87,2,175,9,0,0
13,274,652,304,544,16,6,88,668,6,89,51,101,95,152,591,998,3,3399,188,0,0
13,274,2,2,2,0,0,0,2,0,0,0,0,0,0,0,0,0,0,0,0,0
13,274,8,5,5,0,0,3,8,0,0,0,0,0,0,0,0,0,0,0,0,0
13,274,14,8,8,0,0,6,14,0,0,0,0,0,0,0,0,0,0,0,0,0
13,274,6,4,4,0,0,2,6,0,0,0,0,0,0,0,0,0,0,0,0,0
13,274,6,4,4,0,0,2,6,1,2,1,2,3,3,2,4,0,2,0,0,0
13,274,7,5,5,0,0,2,7,0,0,0,0,0,0,0,0,0,0,0,0,0
13,274,10,6,6,0,0,4,10,0,0,0,0,0,0,0,0,0,0,0,0,0
13,274,1,1,1,0,0,0,1,0,0,0,0,0,0,0,0,0,0,0,0,0
13,274,14,10,10,0,0,4,14,1,1,1,1,2,2,0,2,0,1,0,0,0
13,274,46,26,30,3,0,12,49,3,6,3,6,9,9,20,28,1,42,2,0,0
42,955,384,251,317,7,8,52,391,11,70,44,84,81,128,467,811,6,5355,297,0,0
1,312,42,7,35,4,0,5,46,1,2,1,2,3,3,2,4,0,2,0,0,0
1,312,11,6,10,0,0,1,11,2,4,2,4,6,6,10,15,1,15,0,0,0
30,339,757,253,292,73,244,162,830,13,61,38,67,74,105,409,651,7,4654,258,0,0
44,1063,1043,504,840,53,9,147,1096,9,180,112,198,189,310,1377,2344,4,11604,644,0,0
44,1063,383,288,292,26,6,62,409,11,65,38,67,76,105,429,656,5,3719,206,0,0
30,344,757,253,292,73,244,162,830,13,61,38,67,74,105,409,651,7,4654,258,0,0
18,462,2,2,2,0,0,0,2,0,0,0,0,0,0,0,0,0,0,0,0,0
18,462,99,48,90,1,3,5,100,0,0,0,0,0,0,0,0,0,0,0,0,0
18,462,8,5,5,2,0,1,10,0,0,0,0,0,0,0,0,0,0,0,0,0
18,462,1217,716,841,84,126,174,1301,14,185,118,215,199,333,1446,2542,8,20687,1149,0,0
18,462,160,89,115,0,13,31,160,7,15,11,17,22,28,78,124,3,495,27,0,0
18,462,10,10,9,9,0,0,19,0,0,0,0,0,0,0,0,0,0,0,0,0
18,462,173,84,99,8,29,36,181,5,12,7,13,17,20,54,81,2,221,12,0,0
18,462,3,1,1,3,0,0,6,0,0,0,0,0,0,0,0,0,0,0,0,0
88,1955,1457,730,1242,11,6,188,1468,10,292,166,329,302,495,2424,4078,5,22973,1276,1,1
88,1955,74,35,59,1,0,14,75,3,14,7,14,17,21,58,85,1,128,7,0,1
88,1955,245,125,200,5,7,34,250,7,30,17,34,37,51,166,265,3,1053,58,0,1
45,990,384,251,317,7,8,52,391,11,70,44,84,81,128,467,811,6,5355,297,0,1
34,1864,1289,550,1043,56,32,155,1345,10,167,93,185,177,278,1266,2075,5,11498,638,0,1
31,1539,384,251,317,7,8,52,391,11,70,44,84,81,128,467,811,6,5355,297,0,1
7,97,127,75,83,2,11,30,129,4,14,7,14,18,21,61,87,2,175,9,0,1
7,97,652,304,544,16,6,88,668,6,89,51,101,95,152,591,998,3,3399,188,0,1
7,97,2,2,2,0,0,0,2,0,0,0,0,0,0,0,0,0,0,0,0,1
7,97,8,5,5,0,0,3,8,0,0,0,0,0,0,0,0,0,0,0,0,1
7,97,14,8,8,0,0,6,14,0,0,0,0,0,0,0,0,0,0,0,0,1
7,97,6,4,4,0,0,2,6,0,0,0,0,0,0,0,0,0,0,0,0,1
7,97,6,4,4,0,0,2,6,1,2,1,2,3,3,2,4,0,2,0,0,1
7,97,7,5,5,0,0,2,7,0,0,0,0,0,0,0,0,0,0,0,0,1
7,97,10,6,6,0,0,4,10,0,0,0,0,0,0,0,0,0,0,0,0,1
7,97,1,1,1,0,0,0,1,0,0,0,0,0,0,0,0,0,0,0,0,1
7,97,14,10,10,0,0,4,14,1,1,1,1,2,2,0,2,0,1,0,0,1
7,97,46,26,30,3,0,12,49,3,6,3,6,9,9,20,28,1,42,2,0,1
138,2407,1338,495,1086,10,64,173,1348,11,122,82,157,133,239,883,1686,7,11934,663,0,1
123,2176,1338,495,1086,10,64,173,1348,11,122,82,157,133,239,883,1686,7,11934,663,0,1
45,1069,1043,504,840,53,9,147,1096,9,180,112,198,189,310,1377,2344,4,11604,644,0,0
45,1069,383,288,292,26,6,62,409,11,65,38,67,76,105,429,656,5,3719,206,0,0
30,1650,1289,550,1043,56,32,155,1345,10,167,93,185,177,278,1266,2075,5,11498,638,0,1
124,2190,1338,495,1086,10,64,173,1348,11,122,82,157,133,239,883,1686,7,11934,663,0,1
45,1069,1043,504,840,53,9,147,1096,9,180,112,198,189,310,1377,2344,4,11604,644,0,1
45,1069,383,288,292,26,6,62,409,11,65,38,67,76,105,429,656,5,3719,206,0,1
31,1517,384,251,317,7,8,52,391,11,70,44,84,81,128,467,811,6,5355,297,0,1
31,353,757,253,292,73,244,162,830,13,61,38,67,74,105,409,651,7,4654,258,0,1
75,1630,773,419,590,28,0,166,801,10,204,113,217,214,330,1598,2554,5,13587,754,0,1
75,1630,421,273,302,44,34,57,465,17,81,59,107,98,166,583,1098,11,12329,684,0,1
53,1808,773,419,590,28,0,166,801,10,204,113,217,214,330,1598,2554,5,13587,754,0,1
54,1831,773,419,590,28,0,166,801,10,204,113,217,214,330,1598,2554,5,13587,754,0,1
32,362,757,253,292,73,244,162,830,13,61,38,67,74,105,409,651,7,4654,258,0,0
54,1827,773,419,590,28,0,166,801,10,204,113,217,214,330,1598,2554,5,13587,754,0,0
32,367,757,253,292,73,244,162,830,13,61,38,67,74,105,409,651,7,4654,258,0,1
75,1630,773,419,590,28,0,166,801,10,204,113,217,214,330,1598,2554,5,13587,754,0,0
75,1630,421,273,302,44,34,57,465,17,81,59,107,98,166,583,1098,11,12329,684,0,0
124,2190,1338,495,1086,10,64,173,1348,11,122,82,157,133,239,883,1686,7,11934,663,0,0
32,367,757,253,292,73,244,162,830,13,61,38,67,74,105,409,651,7,4654,258,0,0
3,48,127,75,83,2,11,30,129,4,14,7,14,18,21,61,87,2,175,9,0,1
3,48,652,304,544,16,6,88,668,6,89,51,101,95,152,591,998,3,3399,188,0,1
3,48,2,2,2,0,0,0,2,0,0,0,0,0,0,0,0,0,0,0,0,1
3,48,8,5,5,0,0,3,8,0,0,0,0,0,0,0,0,0,0,0,0,1
3,48,14,8,8,0,0,6,14,0,0,0,0,0,0,0,0,0,0,0,0,1
3,48,6,4,4,0,0,2,6,0,0,0,0,0,0,0,0,0,0,0,0,1
3,48,6,4,4,0,0,2,6,1,2,1,2,3,3,2,4,0,2,0,0,1
3,48,7,5,5,0,0,2,7,0,0,0,0,0,0,0,0,0,0,0,0,1
3,48,10,6,6,0,0,4,10,0,0,0,0,0,0,0,0,0,0,0,0,1
3,48,1,1,1,0,0,0,1,0,0,0,0,0,0,0,0,0,0,0,0,1
3,48,14,10,10,0,0,4,14,1,1,1,1,2,2,0,2,0,1,0,0,1
3,48,46,26,30,3,0,12,49,3,6,3,6,9,9,20,28,1,42,2,0,1
6,113,127,75,83,2,11,30,129,4,14,7,14,18,21,61,87,2,175,9,0,1
6,113,652,304,544,16,6,88,668,6,89,51,101,95,152,591,998,3,3399,188,0,1
6,113,2,2,2,0,0,0,2,0,0,0,0,0,0,0,0,0,0,0,0,1
6,113,8,5,5,0,0,3,8,0,0,0,0,0,0,0,0,0,0,0,0,1
6,113,14,8,8,0,0,6,14,0,0,0,0,0,0,0,0,0,0,0,0,1
6,113,6,4,4,0,0,2,6,0,0,0,0,0,0,0,0,0,0,0,0,1
6,113,6,4,4,0,0,2,6,1,2,1,2,3,3,2,4,0,2,0,0,1
6,113,7,5,5,0,0,2,7,0,0,0,0,0,0,0,0,0,0,0,0,1
6,113,10,6,6,0,0,4,10,0,0,0,0,0,0,0,0,0,0,0,0,1
6,113,1,1,1,0,0,0,1,0,0,0,0,0,0,0,0,0,0,0,0,1
6,113,14,10,10,0,0,4,14,1,1,1,1,2,2,0,2,0,1,0,0,1
6,113,46,26,30,3,0,12,49,3,6,3,6,9,9,20,28,1,42,2,0,1
49,1165,1043,504,840,53,9,147,1096,9,180,112,198,189,310,1377,2344,4,11604,644,0,1
49,1165,383,288,292,26,6,62,409,11,65,38,67,76,105,429,656,5,3719,206,0,1
7,469,1043,504,840,53,9,147,1096,9,180,112,198,189,310,1377,2344,4,11604,644,0,1
13,257,127,75,83,2,11,30,129,4,14,7,14,18,21,61,87,2,175,9,0,1
13,257,652,304,544,16,6,88,668,6,89,51,101,95,152,591,998,3,3399,188,0,1
13,257,2,2,2,0,0,0,2,0,0,0,0,0,0,0,0,0,0,0,0,1
13,257,8,5,5,0,0,3,8,0,0,0,0,0,0,0,0,0,0,0,0,1
13,257,14,8,8,0,0,6,14,0,0,0,0,0,0,0,0,0,0,0,0,1
13,257,6,4,4,0,0,2,6,0,0,0,0,0,0,0,0,0,0,0,0,1
13,257,6,4,4,0,0,2,6,1,2,1,2,3,3,2,4,0,2,0,0,1
13,257,7,5,5,0,0,2,7,0,0,0,0,0,0,0,0,0,0,0,0,1
13,257,10,6,6,0,0,4,10,0,0,0,0,0,0,0,0,0,0,0,0,1
13,257,1,1,1,0,0,0,1,0,0,0,0,0,0,0,0,0,0,0,0,1
13,257,14,10,10,0,0,4,14,1,1,1,1,2,2,0,2,0,1,0,0,1
13,257,46,26,30,3,0,12,49,3,6,3,6,9,9,20,28,1,42,2,0,1
5,100,127,75,83,2,11,30,129,4,14,7,14,18,21,61,87,2,175,9,0,1
5,100,652,304,544,16,6,88,668,6,89,51,101,95,152,591,998,3,3399,188,0,1
5,100,2,2,2,0,0,0,2,0,0,0,0,0,0,0,0,0,0,0,0,1
5,100,8,5,5,0,0,3,8,0,0,0,0,0,0,0,0,0,0,0,0,1
5,100,14,8,8,0,0,6,14,0,0,0,0,0,0,0,0,0,0,0,0,1
5,100,6,4,4,0,0,2,6,0,0,0,0,0,0,0,0,0,0,0,0,1
5,100,6,4,4,0,0,2,6,1,2,1,2,3,3,2,4,0,2,0,0,1
5,100,7,5,5,0,0,2,7,0,0,0,0,0,0,0,0,0,0,0,0,1
5,100,10,6,6,0,0,4,10,0,0,0,0,0,0,0,0,0,0,0,0,1
5,100,1,1,1,0,0,0,1,0,0,0,0,0,0,0,0,0,0,0,0,1
5,100,14,10,10,0,0,4,14,1,1,1,1,2,2,0,2,0,1,0,0,1
5,100,46,26,30,3,0,12,49,3,6,3,6,9,9,20,28,1,42,2,0,1
49,1034,384,251,317,7,8,52,391,11,70,44,84,81,128,467,811,6,5355,297,0,1
25,1340,384,251,317,7,8,52,391,11,70,44,84,81,128,467,811,6,5355,297,0,1
127,2219,1338,495,1086,10,64,173,1348,11,122,82,157,133,239,883,1686,7,11934,663,0,0
124,2168,1338,495,1086,10,64,173,1348,11,122,82,157,133,239,883,1686,7,11934,663,0,1
124,2168,1338,495,1086,10,64,173,1348,11,122,82,157,133,239,883,1686,7,11934,663,0,0
50,1088,384,251,317,7,8,52,391,11,70,44,84,81,128,467,811,6,5355,297,0,1
26,1428,384,251,317,7,8,52,391,11,70,44,84,81,128,467,811,6,5355,297,0,1
32,372,757,253,292,73,244,162,830,13,61,38,67,74,105,409,651,7,4654,258,0,0
49,1061,384,251,317,7,8,52,391,11,70,44,84,81,128,467,811,6,5355,297,0,0
22,1316,384,251,317,7,8,52,391,11,70,44,84,81,128,467,811,6,5355,297,0,0
5,108,127,75,83,2,11,30,129,4,14,7,14,18,21,61,87,2,175,9,0,1
5,108,652,304,544,16,6,88,668,6,89,51,101,95,152,591,998,3,3399,188,0,1
5,108,2,2,2,0,0,0,2,0,0,0,0,0,0,0,0,0,0,0,0,1
5,108,8,5,5,0,0,3,8,0,0,0,0,0,0,0,0,0,0,0,0,1
5,108,14,8,8,0,0,6,14,0,0,0,0,0,0,0,0,0,0,0,0,1
5,108,6,4,4,0,0,2,6,0,0,0,0,0,0,0,0,0,0,0,0,1
5,108,6,4,4,0,0,2,6,1,2,1,2,3,3,2,4,0,2,0,0,1
5,108,7,5,5,0,0,2,7,0,0,0,0,0,0,0,0,0,0,0,0,1
5,108,10,6,6,0,0,4,10,0,0,0,0,0,0,0,0,0,0,0,0,1
5,108,1,1,1,0,0,0,1,0,0,0,0,0,0,0,0,0,0,0,0,1
5,108,14,10,10,0,0,4,14,1,1,1,1,2,2,0,2,0,1,0,0,1
5,108,46,26,30,3,0,12,49,3,6,3,6,9,9,20,28,1,42,2,0,1
14,695,334,251,279,10,4,40,344,5,127,74,143,132,217,899,1528,2,4303,239,0,1
22,1316,384,251,317,7,8,52,391,11,70,44,84,81,128,467,811,6,5355,297,0,1
3,67,127,75,83,2,11,30,129,4,14,7,14,18,21,61,87,2,175,9,0,1
3,67,652,304,544,16,6,88,668,6,89,51,101,95,152,591,998,3,3399,188,0,1
3,67,2,2,2,0,0,0,2,0,0,0,0,0,0,0,0,0,0,0,0,1
3,67,8,5,5,0,0,3,8,0,0,0,0,0,0,0,0,0,0,0,0,1
3,67,14,8,8,0,0,6,14,0,0,0,0,0,0,0,0,0,0,0,0,1
3,67,6,4,4,0,0,2,6,0,0,0,0,0,0,0,0,0,0,0,0,1
3,67,6,4,4,0,0,2,6,1,2,1,2,3,3,2,4,0,2,0,0,1
3,67,7,5,5,0,0,2,7,0,0,0,0,0,0,0,0,0,0,0,0,1
3,67,10,6,6,0,0,4,10,0,0,0,0,0,0,0,0,0,0,0,0,1
3,67,1,1,1,0,0,0,1,0,0,0,0,0,0,0,0,0,0,0,0,1
3,67,14,10,10,0,0,4,14,1,1,1,1,2,2,0,2,0,1,0,0,1
3,67,46,26,30,3,0,12,49,3,6,3,6,9,9,20,28,1,42,2,0,1
2,27,127,75,83,2,11,30,129,4,14,7,14,18,21,61,87,2,175,9,0,1
2,27,652,304,544,16,6,88,668,6,89,51,101,95,152,591,998,3,3399,188,0,1
2,27,2,2,2,0,0,0,2,0,0,0,0,0,0,0,0,0,0,0,0,1
2,27,8,5,5,0,0,3,8,0,0,0,0,0,0,0,0,0,0,0,0,1
2,27,14,8,8,0,0,6,14,0,0,0,0,0,0,0,0,0,0,0,0,1
2,27,6,4,4,0,0,2,6,0,0,0,0,0,0,0,0,0,0,0,0,1
2,27,6,4,4,0,0,2,6,1,2,1,2,3,3,2,4,0,2,0,0,1
2,27,7,5,5,0,0,2,7,0,0,0,0,0,0,0,0,0,0,0,0,1
2,27,10,6,6,0,0,4,10,0,0,0,0,0,0,0,0,0,0,0,0,1
2,27,1,1,1,0,0,0,1,0,0,0,0,0,0,0,0,0,0,0,0,1
2,27,14,10,10,0,0,4,14,1,1,1,1,2,2,0,2,0,1,0,0,1
2,27,46,26,30,3,0,12,49,3,6,3,6,9,9,20,28,1,42,2,0,1
6,106,127,75,83,2,11,30,129,4,14,7,14,18,21,61,87,2,175,9,0,1
6,106,652,304,544,16,6,88,668,6,89,51,101,95,152,591,998,3,3399,188,0,1
6,106,2,2,2,0,0,0,2,0,0,0,0,0,0,0,0,0,0,0,0,1
6,106,8,5,5,0,0,3,8,0,0,0,0,0,0,0,0,0,0,0,0,1
6,106,14,8,8,0,0,6,14,0,0,0,0,0,0,0,0,0,0,0,0,1
6,106,6,4,4,0,0,2,6,0,0,0,0,0,0,0,0,0,0,0,0,1
6,106,6,4,4,0,0,2,6,1,2,1,2,3,3,2,4,0,2,0,0,1
6,106,7,5,5,0,0,2,7,0,0,0,0,0,0,0,0,0,0,0,0,1
6,106,10,6,6,0,0,4,10,0,0,0,0,0,0,0,0,0,0,0,0,1
6,106,1,1,1,0,0,0,1,0,0,0,0,0,0,0,0,0,0,0,0,1
6,106,14,10,10,0,0,4,14,1,1,1,1,2,2,0,2,0,1,0,0,1
6,106,46,26,30,3,0,12,49,3,6,3,6,9,9,20,28,1,42,2,0,1
51,1169,1043,504,840,53,9,147,1096,9,180,112,198,189,310,1377,2344,4,11604,644,0,1
51,1169,383,288,292,26,6,62,409,11,65,38,67,76,105,429,656,5,3719,206,0,1
8,544,1043,504,840,53,9,147,1096,9,180,112,198,189,310,1377,2344,4,11604,644,0,1
1,306,42,7,35,4,0,5,46,1,2,1,2,3,3,2,4,0,2,0,0,0
1,306,11,6,10,0,0,1,11,2,4,2,4,6,6,10,15,1,15,0,0,0
51,1158,1043,504,840,53,9,147,1096,9,180,112,198,189,310,1377,2344,4,11604,644,0,0
51,1158,383,288,292,26,6,62,409,11,65,38,67,76,105,429,656,5,3719,206,0,0
32,372,757,253,292,73,244,162,830,13,61,38,67,74,105,409,651,7,4654,258,0,1
48,1080,1043,504,840,53,9,147,1096,9,180,112,198,189,310,1377,2344,4,11604,644,0,1
48,1080,383,288,292,26,6,62,409,11,65,38,67,76,105,429,656,5,3719,206,0,1
26,913,1043,504,840,53,9,147,1096,9,180,112,198,189,310,1377,2344,4,11604,644,0,1
51,1155,1043,504,840,53,9,147,1096,9,180,112,198,189,310,1377,2344,4,11604,644,0,1
51,1155,383,288,292,26,6,62,409,11,65,38,67,76,105,429,656,5,3719,206,0,1
30,350,757,253,292,73,244,162,830,13,61,38,67,74,105,409,651,7,4654,258,0,1
49,1053,384,251,317,7,8,52,391,11,70,44,84,81,128,467,811,6,5355,297,0,1
49,1106,1043,504,840,53,9,147,1096,9,180,112,198,189,310,1377,2344,4,11604,644,0,1
49,1106,383,288,292,26,6,62,409,11,65,38,67,76,105,429,656,5,3719,206,0,1
38,676,373,158,315,8,0,51,381,5,76,44,79,81,123,486,779,2,2026,112,0,1
28,1589,1289,550,1043,56,32,155,1345,10,167,93,185,177,278,1266,2075,5,11498,638,0,1
24,833,1043,504,840,53,9,147,1096,9,180,112,198,189,310,1377,2344,4,11604,644,0,1
21,888,373,158,315,8,0,51,381,5,76,44,79,81,123,486,779,2,2026,112,0,1
30,354,757,253,292,73,244,162,830,13,61,38,67,74,105,409,651,7,4654,258,0,1
38,683,373,158,315,8,0,51,381,5,76,44,79,81,123,486,779,2,2026,112,0,1
45,1291,2,2,2,0,0,0,2,0,0,0,0,0,0,0,0,0,0,0,0,1
45,1291,99,48,90,1,3,5,100,0,0,0,0,0,0,0,0,0,0,0,0,1
45,1291,8,5,5,2,0,1,10,0,0,0,0,0,0,0,0,0,0,0,0,1
45,1291,1217,716,841,84,126,174,1301,14,185,118,215,199,333,1446,2542,8,20687,1149,0,1
45,1291,160,89,115,0,13,31,160,7,15,11,17,22,28,78,124,3,495,27,0,1
45,1291,10,10,9,9,0,0,19,0,0,0,0,0,0,0,0,0,0,0,0,1
45,1291,173,84,99,8,29,36,181,5,12,7,13,17,20,54,81,2,221,12,0,1
45,1291,3,1,1,3,0,0,6,0,0,0,0,0,0,0,0,0,0,0,0,1
18,449,2,2,2,0,0,0,2,0,0,0,0,0,0,0,0,0,0,0,0,1
18,449,99,48,90,1,3,5,100,0,0,0,0,0,0,0,0,0,0,0,0,1
18,449,8,5,5,2,0,1,10,0,0,0,0,0,0,0,0,0,0,0,0,1
18,449,1217,716,841,84,126,174,1301,14,185,118,215,199,333,1446,2542,8,20687,1149,0,1
18,449,160,89,115,0,13,31,160,7,15,11,17,22,28,78,124,3,495,27,0,1
18,449,10,10,9,9,0,0,19,0,0,0,0,0,0,0,0,0,0,0,0,1
18,449,173,84,99,8,29,36,181,5,12,7,13,17,20,54,81,2,221,12,0,1
18,449,3,1,1,3,0,0,6,0,0,0,0,0,0,0,0,0,0,0,0,1
5,106,127,75,83,2,11,30,129,4,14,7,14,18,21,61,87,2,175,9,0,1
5,106,652,304,544,16,6,88,668,6,89,51,101,95,152,591,998,3,3399,188,0,1
5,106,2,2,2,0,0,0,2,0,0,0,0,0,0,0,0,0,0,0,0,1
5,106,8,5,5,0,0,3,8,0,0,0,0,0,0,0,0,0,0,0,0,1
5,106,14,8,8,0,0,6,14,0,0,0,0,0,0,0,0,0,0,0,0,1
5,106,6,4,4,0,0,2,6,0,0,0,0,0,0,0,0,0,0,0,0,1
5,106,6,4,4,0,0,2,6,1,2,1,2,3,3,2,4,0,2,0,0,1
5,106,7,5,5,0,0,2,7,0,0,0,0,0,0,0,0,0,0,0,0,1
5,106,10,6,6,0,0,4,10,0,0,0,0,0,0,0,0,0,0,0,0,1
5,106,1,1,1,0,0,0,1,0,0,0,0,0,0,0,0,0,0,0,0,1
5,106,14,10,10,0,0,4,14,1,1,1,1,2,2,0,2,0,1,0,0,1
5,106,46,26,30,3,0,12,49,3,6,3,6,9,9,20,28,1,42,2,0,1
70,1433,384,251,317,7,8,52,391,11,70,44,84,81,128,467,811,6,5355,297,0,1
29,1470,384,251,317,7,8,52,391,11,70,44,84,81,128,467,811,6,5355,297,0,1
18,449,2,2,2,0,0,0,2,0,0,0,0,0,0,0,0,0,0,0,0,0
18,449,99,48,90,1,3,5,100,0,0,0,0,0,0,0,0,0,0,0,0,0
18,449,8,5,5,2,0,1,10,0,0,0,0,0,0,0,0,0,0,0,0,0
18,449,1217,716,841,84,126,174,1301,14,185,118,215,199,333,1446,2542,8,20687,1149,0,0
18,449,160,89,115,0,13,31,160,7,15,11,17,22,28,78,124,3,495,27,0,0
18,449,10,10,9,9,0,0,19,0,0,0,0,0,0,0,0,0,0,0,0,0
18,449,173,84,99,8,29,36,181,5,12,7,13,17,20,54,81,2,221,12,0,0
18,449,3,1,1,3,0,0,6,0,0,0,0,0,0,0,0,0,0,0,0,0
19,456,2,2,2,0,0,0,2,0,0,0,0,0,0,0,0,0,0,0,0,0
19,456,99,48,90,1,3,5,100,0,0,0,0,0,0,0,0,0,0,0,0,0
19,456,8,5,5,2,0,1,10,0,0,0,0,0,0,0,0,0,0,0,0,0
19,456,1217,716,841,84,126,174,1301,14,185,118,215,199,333,1446,2542,8,20687,1149,0,0
19,456,160,89,115,0,13,31,160,7,15,11,17,22,28,78,124,3,495,27,0,0
19,456,10,10,9,9,0,0,19,0,0,0,0,0,0,0,0,0,0,0,0,0
19,456,173,84,99,8,29,36,181,5,12,7,13,17,20,54,81,2,221,12,0,0
19,456,3,1,1,3,0,0,6,0,0,0,0,0,0,0,0,0,0,0,0,0
16,369,2,2,2,0,0,0,2,0,0,0,0,0,0,0,0,0,0,0,0,0
16,369,99,48,90,1,3,5,100,0,0,0,0,0,0,0,0,0,0,0,0,0
16,369,8,5,5,2,0,1,10,0,0,0,0,0,0,0,0,0,0,0,0,0
16,369,1217,716,841,84,126,174,1301,14,185,118,215,199,333,1446,2542,8,20687,1149,0,0
16,369,160,89,115,0,13,31,160,7,15,11,17,22,28,78,124,3,495,27,0,0
16,369,10,10,9,9,0,0,19,0,0,0,0,0,0,0,0,0,0,0,0,0
16,369,173,84,99,8,29,36,181,5,12,7,13,17,20,54,81,2,221,12,0,0
16,369,3,1,1,3,0,0,6,0,0,0,0,0,0,0,0,0,0,0,0,0
19,404,2,2,2,0,0,0,2,0,0,0,0,0,0,0,0,0,0,0,0,0
19,404,99,48,90,1,3,5,100,0,0,0,0,0,0,0,0,0,0,0,0,0
19,404,8,5,5,2,0,1,10,0,0,0,0,0,0,0,0,0,0,0,0,0
19,404,1217,716,841,84,126,174,1301,14,185,118,215,199,333,1446,2542,8,20687,1149,0,0
19,404,160,89,115,0,13,31,160,7,15,11,17,22,28,78,124,3,495,27,0,0
19,404,10,10,9,9,0,0,19,0,0,0,0,0,0,0,0,0,0,0,0,0
19,404,173,84,99,8,29,36,181,5,12,7,13,17,20,54,81,2,221,12,0,0
19,404,3,1,1,3,0,0,6,0,0,0,0,0,0,0,0,0,0,0,0,0
88,1938,1457,730,1242,11,6,188,1468,10,292,166,329,302,495,2424,4078,5,22973,1276,1,1
88,1938,74,35,59,1,0,14,75,3,14,7,14,17,21,58,85,1,128,7,0,1
88,1938,245,125,200,5,7,34,250,7,30,17,34,37,51,166,265,3,1053,58,0,1
34,391,757,253,292,73,244,162,830,13,61,38,67,74,105,409,651,7,4654,258,0,1
68,1398,384,251,317,7,8,52,391,11,70,44,84,81,128,467,811,6,5355,297,0,1
38,680,373,158,315,8,0,51,381,5,76,44,79,81,123,486,779,2,2026,112,0,1
34,387,757,253,292,73,244,162,830,13,61,38,67,74,105,409,651,7,4654,258,0,1
34,316,647,139,84,35,284,233,682,0,0,0,0,0,0,0,0,0,0,0,0,1
68,1394,384,251,317,7,8,52,391,11,70,44,84,81,128,467,811,6,5355,297,0,1
66,1372,384,251,317,7,8,52,391,11,70,44,84,81,128,467,811,6,5355,297,0,0
28,1427,384,251,317,7,8,52,391,11,70,44,84,81,128,467,811,6,5355,297,0,0
123,2153,1338,495,1086,10,64,173,1348,11,122,82,157,133,239,883,1686,7,11934,663,0,1
88,1939,1457,730,1242,11,6,188,1468,10,292,166,329,302,495,2424,4078,5,22973,1276,1,1
88,1939,74,35,59,1,0,14,75,3,14,7,14,17,21,58,85,1,128,7,0,1
88,1939,245,125,200,5,7,34,250,7,30,17,34,37,51,166,265,3,1053,58,0,1
5,107,127,75,83,2,11,30,129,4,14,7,14,18,21,61,87,2,175,9,0,1
5,107,652,304,544,16,6,88,668,6,89,51,101,95,152,591,998,3,3399,188,0,1
5,107,2,2,2,0,0,0,2,0,0,0,0,0,0,0,0,0,0,0,0,1
5,107,8,5,5,0,0,3,8,0,0,0,0,0,0,0,0,0,0,0,0,1
5,107,14,8,8,0,0,6,14,0,0,0,0,0,0,0,0,0,0,0,0,1
5,107,6,4,4,0,0,2,6,0,0,0,0,0,0,0,0,0,0,0,0,1
5,107,6,4,4,0,0,2,6,1,2,1,2,3,3,2,4,0,2,0,0,1
5,107,7,5,5,0,0,2,7,0,0,0,0,0,0,0,0,0,0,0,0,1
5,107,10,6,6,0,0,4,10,0,0,0,0,0,0,0,0,0,0,0,0,1
5,107,1,1,1,0,0,0,1,0,0,0,0,0,0,0,0,0,0,0,0,1
5,107,14,10,10,0,0,4,14,1,1,1,1,2,2,0,2,0,1,0,0,1
5,107,46,26,30,3,0,12,49,3,6,3,6,9,9,20,28,1,42,2,0,1
18,389,2,2,2,0,0,0,2,0,0,0,0,0,0,0,0,0,0,0,0,1
18,389,99,48,90,1,3,5,100,0,0,0,0,0,0,0,0,0,0,0,0,1
18,389,8,5,5,2,0,1,10,0,0,0,0,0,0,0,0,0,0,0,0,1
18,389,1217,716,841,84,126,174,1301,14,185,118,215,199,333,1446,2542,8,20687,1149,0,1
18,389,160,89,115,0,13,31,160,7,15,11,17,22,28,78,124,3,495,27,0,1
18,389,10,10,9,9,0,0,19,0,0,0,0,0,0,0,0,0,0,0,0,1
18,389,173,84,99,8,29,36,181,5,12,7,13,17,20,54,81,2,221,12,0,1
18,389,3,1,1,3,0,0,6,0,0,0,0,0,0,0,0,0,0,0,0,1
123,2143,1338,495,1086,10,64,173,1348,11,122,82,157,133,239,883,1686,7,11934,663,0,1
34,312,647,139,84,35,284,233,682,0,0,0,0,0,0,0,0,0,0,0,0,1
124,2163,1338,495,1086,10,64,173,1348,11,122,82,157,133,239,883,1686,7,11934,663,0,1
33,298,647,139,84,35,284,233,682,0,0,0,0,0,0,0,0,0,0,0,0,1
1,319,42,7,35,4,0,5,46,1,2,1,2,3,3,2,4,0,2,0,0,1
1,319,11,6,10,0,0,1,11,2,4,2,4,6,6,10,15,1,15,0,0,1
34,305,647,139,84,35,284,233,682,0,0,0,0,0,0,0,0,0,0,0,0,1
71,1431,384,251,317,7,8,52,391,11,70,44,84,81,128,467,811,6,5355,297,0,1
42,2275,1457,730,1242,11,6,188,1468,10,292,166,329,302,495,2424,4078,5,22973,1276,1,1
29,1463,384,251,317,7,8,52,391,11,70,44,84,81,128,467,811,6,5355,297,0,1
72,1433,384,251,317,7,8,52,391,11,70,44,84,81,128,467,811,6,5355,297,0,0
1,136,42,7,35,4,0,5,46,1,2,1,2,3,3,2,4,0,2,0,0,0
1,136,11,6,10,0,0,1,11,2,4,2,4,6,6,10,15,1,15,0,0,0
124,2163,1338,495,1086,10,64,173,1348,11,122,82,157,133,239,883,1686,7,11934,663,0,0
1,220,42,7,35,4,0,5,46,1,2,1,2,3,3,2,4,0,2,0,0,1
1,220,11,6,10,0,0,1,11,2,4,2,4,6,6,10,15,1,15,0,0,1
1,311,42,7,35,4,0,5,46,1,2,1,2,3,3,2,4,0,2,0,0,1
1,311,11,6,10,0,0,1,11,2,4,2,4,6,6,10,15,1,15,0,0,1
1,311,42,7,35,4,0,5,46,1,2,1,2,3,3,2,4,0,2,0,0,0
1,311,11,6,10,0,0,1,11,2,4,2,4,6,6,10,15,1,15,0,0,0
1,313,42,7,35,4,0,5,46,1,2,1,2,3,3,2,4,0,2,0,0,1
1,313,11,6,10,0,0,1,11,2,4,2,4,6,6,10,15,1,15,0,0,1
29,1465,384,251,317,7,8,52,391,11,70,44,84,81,128,467,811,6,5355,297,0,1
34,305,647,139,84,35,284,233,682,0,0,0,0,0,0,0,0,0,0,0,0,0
29,1465,384,251,317,7,8,52,391,11,70,44,84,81,128,467,811,6,5355,297,0,0
1,306,42,7,35,4,0,5,46,1,2,1,2,3,3,2,4,0,2,0,0,1
1,306,11,6,10,0,0,1,11,2,4,2,4,6,6,10,15,1,15,0,0,1
28,1379,384,251,317,7,8,52,391,11,70,44,84,81,128,467,811,6,5355,297,0,1
75,1676,384,251,317,7,8,52,391,11,70,44,84,81,128,467,811,6,5355,297,0,1
29,1440,384,251,317,7,8,52,391,11,70,44,84,81,128,467,811,6,5355,297,0,1
2,80,13,10,10,0,0,3,13,1,2,1,2,3,3,2,4,0,2,0,0,0
75,1676,384,251,317,7,8,52,391,11,70,44,84,81,128,467,811,6,5355,297,0,0
29,1440,384,251,317,7,8,52,391,11,70,44,84,81,128,467,811,6,5355,297,0,0
2,311,42,7,35,4,0,5,46,1,2,1,2,3,3,2,4,0,2,0,0,0
2,311,11,6,10,0,0,1,11,2,4,2,4,6,6,10,15,1,15,0,0,0
34,304,647,139,84,35,284,233,682,0,0,0,0,0,0,0,0,0,0,0,0,1
75,1673,384,251,317,7,8,52,391,11,70,44,84,81,128,467,811,6,5355,297,0,1
35,307,647,139,84,35,284,233,682,0,0,0,0,0,0,0,0,0,0,0,0,1
36,671,373,158,315,8,0,51,381,5,76,44,79,81,123,486,779,2,2026,112,0,1
35,307,647,139,84,35,284,233,682,0,0,0,0,0,0,0,0,0,0,0,0,0
75,1673,384,251,317,7,8,52,391,11,70,44,84,81,128,467,811,6,5355,297,0,0
36,671,373,158,315,8,0,51,381,5,76,44,79,81,123,486,779,2,2026,112,0,0
122,2141,1338,495,1086,10,64,173,1348,11,122,82,157,133,239,883,1686,7,11934,663,0,1
77,1723,1457,730,1242,11,6,188,1468,10,292,166,329,302,495,2424,4078,5,22973,1276,1,1
77,1723,74,35,59,1,0,14,75,3,14,7,14,17,21,58,85,1,128,7,0,1
77,1723,245,125,200,5,7,34,250,7,30,17,34,37,51,166,265,3,1053,58,0,1
27,1540,1289,550,1043,56,32,155,1345,10,167,93,185,177,278,1266,2075,5,11498,638,0,1
34,1908,1457,730,1242,11,6,188,1468,10,292,166,329,302,495,2424,4078,5,22973,1276,1,1
124,2153,1338,495,1086,10,64,173,1348,11,122,82,157,133,239,883,1686,7,11934,663,0,0
17,320,127,75,83,2,11,30,129,4,14,7,14,18,21,61,87,2,175,9,0,1
17,320,652,304,544,16,6,88,668,6,89,51,101,95,152,591,998,3,3399,188,0,1
17,320,2,2,2,0,0,0,2,0,0,0,0,0,0,0,0,0,0,0,0,1
17,320,8,5,5,0,0,3,8,0,0,0,0,0,0,0,0,0,0,0,0,1
17,320,14,8,8,0,0,6,14,0,0,0,0,0,0,0,0,0,0,0,0,1
17,320,6,4,4,0,0,2,6,0,0,0,0,0,0,0,0,0,0,0,0,1
17,320,6,4,4,0,0,2,6,1,2,1,2,3,3,2,4,0,2,0,0,1
17,320,7,5,5,0,0,2,7,0,0,0,0,0,0,0,0,0,0,0,0,1
17,320,10,6,6,0,0,4,10,0,0,0,0,0,0,0,0,0,0,0,0,1
17,320,1,1,1,0,0,0,1,0,0,0,0,0,0,0,0,0,0,0,0,1
17,320,14,10,10,0,0,4,14,1,1,1,1,2,2,0,2,0,1,0,0,1
17,320,46,26,30,3,0,12,49,3,6,3,6,9,9,20,28,1,42,2,0,1
14,692,334,251,279,10,4,40,344,5,127,74,143,132,217,899,1528,2,4303,239,0,1
37,326,647,139,84,35,284,233,682,0,0,0,0,0,0,0,0,0,0,0,0,1
17,320,127,75,83,2,11,30,129,4,14,7,14,18,21,61,87,2,175,9,0,0
17,320,652,304,544,16,6,88,668,6,89,51,101,95,152,591,998,3,3399,188,0,0
17,320,2,2,2,0,0,0,2,0,0,0,0,0,0,0,0,0,0,0,0,0
17,320,8,5,5,0,0,3,8,0,0,0,0,0,0,0,0,0,0,0,0,0
17,320,14,8,8,0,0,6,14,0,0,0,0,0,0,0,0,0,0,0,0,0
17,320,6,4,4,0,0,2,6,0,0,0,0,0,0,0,0,0,0,0,0,0
17,320,6,4,4,0,0,2,6,1,2,1,2,3,3,2,4,0,2,0,0,0
17,320,7,5,5,0,0,2,7,0,0,0,0,0,0,0,0,0,0,0,0,0
17,320,10,6,6,0,0,4,10,0,0,0,0,0,0,0,0,0,0,0,0,0
17,320,1,1,1,0,0,0,1,0,0,0,0,0,0,0,0,0,0,0,0,0
17,320,14,10,10,0,0,4,14,1,1,1,1,2,2,0,2,0,1,0,0,0
17,320,46,26,30,3,0,12,49,3,6,3,6,9,9,20,28,1,42,2,0,0
77,1723,1457,730,1242,11,6,188,1468,10,292,166,329,302,495,2424,4078,5,22973,1276,1,0
77,1723,74,35,59,1,0,14,75,3,14,7,14,17,21,58,85,1,128,7,0,0
77,1723,245,125,200,5,7,34,250,7,30,17,34,37,51,166,265,3,1053,58,0,0
37,326,647,139,84,35,284,233,682,0,0,0,0,0,0,0,0,0,0,0,0,0
27,1540,1289,550,1043,56,32,155,1345,10,167,93,185,177,278,1266,2075,5,11498,638,0,0
34,1908,1457,730,1242,11,6,188,1468,10,292,166,329,302,495,2424,4078,5,22973,1276,1,0
14,692,334,251,279,10,4,40,344,5,127,74,143,132,217,899,1528,2,4303,239,0,0
25,1394,1289,550,1043,56,32,155,1345,10,167,93,185,177,278,1266,2075,5,11498,638,0,1
16,927,1289,550,1043,56,32,155,1345,10,167,93,185,177,278,1266,2075,5,11498,638,0,1
90,1970,1392,870,1177,35,17,170,1427,14,494,280,531,508,811,4473,7289,7,54850,3047,2,1
100,3732,1392,870,1177,35,17,170,1427,14,494,280,531,508,811,4473,7289,7,54850,3047,2,1
2,311,42,7,35,4,0,5,46,1,2,1,2,3,3,2,4,0,2,0,0,1
2,311,11,6,10,0,0,1,11,2,4,2,4,6,6,10,15,1,15,0,0,1
101,3760,1392,870,1177,35,17,170,1427,14,494,280,531,508,811,4473,7289,7,54850,3047,2,0
9,518,1289,550,1043,56,32,155,1345,10,167,93,185,177,278,1266,2075,5,11498,638,0,1
5,261,1289,550,1043,56,32,155,1345,10,167,93,185,177,278,1266,2075,5,11498,638,0,1
90,1970,1392,870,1177,35,17,170,1427,14,494,280,531,508,811,4473,7289,7,54850,3047,2,0
9,518,1289,550,1043,56,32,155,1345,10,167,93,185,177,278,1266,2075,5,11498,638,0,0
5,261,1289,550,1043,56,32,155,1345,10,167,93,185,177,278,1266,2075,5,11498,638,0,0
127,2226,1338,495,1086,10,64,173,1348,11,122,82,157,133,239,883,1686,7,11934,663,0,1
127,2230,1338,495,1086,10,64,173,1348,11,122,82,157,133,239,883,1686,7,11934,663,0,1
6,319,1289,550,1043,56,32,155,1345,10,167,93,185,177,278,1266,2075,5,11498,638,0,1
127,2230,1338,495,1086,10,64,173,1348,11,122,82,157,133,239,883,1686,7,11934,663,0,0
6,319,1289,550,1043,56,32,155,1345,10,167,93,185,177,278,1266,2075,5,11498,638,0,0
89,1961,1392,870,1177,35,17,170,1427,14,494,280,531,508,811,4473,7289,7,54850,3047,2,1
101,3788,1392,870,1177,35,17,170,1427,14,494,280,531,508,811,4473,7289,7,54850,3047,2,1
54,1827,773,419,590,28,0,166,801,10,204,113,217,214,330,1598,2554,5,13587,754,0,1
75,1669,384,251,317,7,8,52,391,11,70,44,84,81,128,467,811,6,5355,297,0,1
30,1475,384,251,317,7,8,52,391,11,70,44,84,81,128,467,811,6,5355,297,0,1
75,1674,384,251,317,7,8,52,391,11,70,44,84,81,128,467,811,6,5355,297,0,1
29,1457,384,251,317,7,8,52,391,11,70,44,84,81,128,467,811,6,5355,297,0,1
131,2252,1338,495,1086,10,64,173,1348,11,122,82,157,133,239,883,1686,7,11934,663,0,1
7,384,1289,550,1043,56,32,155,1345,10,167,93,185,177,278,1266,2075,5,11498,638,0,1
89,1961,1392,870,1177,35,17,170,1427,14,494,280,531,508,811,4473,7289,7,54850,3047,2,0
101,3788,1392,870,1177,35,17,170,1427,14,494,280,531,508,811,4473,7289,7,54850,3047,2,0
131,2252,1338,495,1086,10,64,173,1348,11,122,82,157,133,239,883,1686,7,11934,663,0,0
5,107,127,75,83,2,11,30,129,4,14,7,14,18,21,61,87,2,175,9,0,0
5,107,652,304,544,16,6,88,668,6,89,51,101,95,152,591,998,3,3399,188,0,0
5,107,2,2,2,0,0,0,2,0,0,0,0,0,0,0,0,0,0,0,0,0
5,107,8,5,5,0,0,3,8,0,0,0,0,0,0,0,0,0,0,0,0,0
5,107,14,8,8,0,0,6,14,0,0,0,0,0,0,0,0,0,0,0,0,0
5,107,6,4,4,0,0,2,6,0,0,0,0,0,0,0,0,0,0,0,0,0
5,107,6,4,4,0,0,2,6,1,2,1,2,3,3,2,4,0,2,0,0,0
5,107,7,5,5,0,0,2,7,0,0,0,0,0,0,0,0,0,0,0,0,0
5,107,10,6,6,0,0,4,10,0,0,0,0,0,0,0,0,0,0,0,0,0
5,107,1,1,1,0,0,0,1,0,0,0,0,0,0,0,0,0,0,0,0,0
5,107,14,10,10,0,0,4,14,1,1,1,1,2,2,0,2,0,1,0,0,0
5,107,46,26,30,3,0,12,49,3,6,3,6,9,9,20,28,1,42,2,0,0
75,1669,384,251,317,7,8,52,391,11,70,44,84,81,128,467,811,6,5355,297,0,0
7,384,1289,550,1043,56,32,155,1345,10,167,93,185,177,278,1266,2075,5,11498,638,0,0
29,1457,384,251,317,7,8,52,391,11,70,44,84,81,128,467,811,6,5355,297,0,0
7,379,1289,550,1043,56,32,155,1345,10,167,93,185,177,278,1266,2075,5,11498,638,0,0
36,504,282,196,195,3,0,86,285,8,130,71,141,138,212,936,1507,4,6538,363,0,1
74,1661,384,251,317,7,8,52,391,11,70,44,84,81,128,467,811,6,5355,297,0,1
6,314,1289,550,1043,56,32,155,1345,10,167,93,185,177,278,1266,2075,5,11498,638,0,1
2,307,42,7,35,4,0,5,46,1,2,1,2,3,3,2,4,0,2,0,0,1
2,307,11,6,10,0,0,1,11,2,4,2,4,6,6,10,15,1,15,0,0,1
36,504,282,196,195,3,0,86,285,8,130,71,141,138,212,936,1507,4,6538,363,0,0
74,1661,384,251,317,7,8,52,391,11,70,44,84,81,128,467,811,6,5355,297,0,0
6,314,1289,550,1043,56,32,155,1345,10,167,93,185,177,278,1266,2075,5,11498,638,0,0
2,307,42,7,35,4,0,5,46,1,2,1,2,3,3,2,4,0,2,0,0,0
2,307,11,6,10,0,0,1,11,2,4,2,4,6,6,10,15,1,15,0,0,0
17,322,127,75,83,2,11,30,129,4,14,7,14,18,21,61,87,2,175,9,0,1
17,322,652,304,544,16,6,88,668,6,89,51,101,95,152,591,998,3,3399,188,0,1
17,322,2,2,2,0,0,0,2,0,0,0,0,0,0,0,0,0,0,0,0,1
17,322,8,5,5,0,0,3,8,0,0,0,0,0,0,0,0,0,0,0,0,1
17,322,14,8,8,0,0,6,14,0,0,0,0,0,0,0,0,0,0,0,0,1
17,322,6,4,4,0,0,2,6,0,0,0,0,0,0,0,0,0,0,0,0,1
17,322,6,4,4,0,0,2,6,1,2,1,2,3,3,2,4,0,2,0,0,1
17,322,7,5,5,0,0,2,7,0,0,0,0,0,0,0,0,0,0,0,0,1
17,322,10,6,6,0,0,4,10,0,0,0,0,0,0,0,0,0,0,0,0,1
17,322,1,1,1,0,0,0,1,0,0,0,0,0,0,0,0,0,0,0,0,1
17,322,14,10,10,0,0,4,14,1,1,1,1,2,2,0,2,0,1,0,0,1
17,322,46,26,30,3,0,12,49,3,6,3,6,9,9,20,28,1,42,2,0,1
57,1511,1513,682,1277,25,13,200,1538,11,199,116,219,210,335,1557,2584,6,15641,868,0,1
57,1511,819,519,539,24,98,155,843,15,96,57,106,111,163,690,1107,8,9171,509,0,1
38,1736,1513,682,1277,25,13,200,1538,11,199,116,219,210,335,1557,2584,6,15641,868,0,1
74,1659,384,251,317,7,8,52,391,11,70,44,84,81,128,467,811,6,5355,297,0,1
43,844,215,129,180,6,0,29,221,8,65,43,72,73,115,415,711,4,3153,175,0,1
43,844,97,69,77,3,3,16,100,6,22,13,23,28,36,113,173,3,542,30,0,1
12,379,15,9,9,0,0,6,15,0,0,0,0,0,0,0,0,0,0,0,0,1
12,380,15,9,9,0,0,6,15,0,0,0,0,0,0,0,0,0,0,0,0,1
2,299,42,7,35,4,0,5,46,1,2,1,2,3,3,2,4,0,2,0,0,1
2,299,11,6,10,0,0,1,11,2,4,2,4,6,6,10,15,1,15,0,0,1
176,3856,182,127,129,0,0,53,182,5,39,21,42,44,63,217,343,2,926,51,0,1
176,3856,1165,710,800,67,119,181,1232,18,243,153,282,261,435,2000,3492,10,36473,2026,1,1
75,1638,773,419,590,28,0,166,801,10,204,113,217,214,330,1598,2554,5,13587,754,0,1
75,1638,421,273,302,44,34,57,465,17,81,59,107,98,166,583,1098,11,12329,684,0,1
31,977,182,127,129,0,0,53,182,5,39,21,42,44,63,217,343,2,926,51,0,1
2,297,42,7,35,4,0,5,46,1,2,1,2,3,3,2,4,0,2,0,0,0
2,297,11,6,10,0,0,1,11,2,4,2,4,6,6,10,15,1,15,0,0,0
125,3182,1450,624,1228,12,26,181,1462,14,306,186,354,320,540,2580,4493,8,36391,2021,1,1
182,3987,182,127,129,0,0,53,182,5,39,21,42,44,63,217,343,2,926,51,0,1
182,3987,1165,710,800,67,119,181,1232,18,243,153,282,261,435,2000,3492,10,36473,2026,1,1
37,828,1450,624,1228,12,26,181,1462,14,306,186,354,320,540,2580,4493,8,36391,2021,1,1
33,1067,182,127,129,0,0,53,182,5,39,21,42,44,63,217,343,2,926,51,0,1
36,799,1450,624,1228,12,26,181,1462,14,306,186,354,320,540,2580,4493,8,36391,2021,1,1
1,73,42,7,35,4,0,5,46,1,2,1,2,3,3,2,4,0,2,0,0,1
1,73,11,6,10,0,0,1,11,2,4,2,4,6,6,10,15,1,15,0,0,1
27,510,334,251,279,10,4,40,344,5,127,74,143,132,217,899,1528,2,4303,239,0,1
14,690,334,251,279,10,4,40,344,5,127,74,143,132,217,899,1528,2,4303,239,0,1
20,854,373,158,315,8,0,51,381,5,76,44,79,81,123,486,779,2,2026,112,0,0
182,3979,182,127,129,0,0,53,182,5,39,21,42,44,63,217,343,2,926,51,0,1
182,3979,1165,710,800,67,119,181,1232,18,243,153,282,261,435,2000,3492,10,36473,2026,1,1
185,4091,182,127,129,0,0,53,182,5,39,21,42,44,63,217,343,2,926,51,0,1
185,4091,1165,710,800,67,119,181,1232,18,243,153,282,261,435,2000,3492,10,36473,2026,1,1
73,1622,773,419,590,28,0,166,801,10,204,113,217,214,330,1598,2554,5,13587,754,0,1
73,1622,421,273,302,44,34,57,465,17,81,59,107,98,166,583,1098,11,12329,684,0,1
37,841,1450,624,1228,12,26,181,1462,14,306,186,354,320,540,2580,4493,8,36391,2021,1,1
34,1106,182,127,129,0,0,53,182,5,39,21,42,44,63,217,343,2,926,51,0,1
101,3798,1392,870,1177,35,17,170,1427,14,494,280,531,508,811,4473,7289,7,54850,3047,2,1
54,1866,773,419,590,28,0,166,801,10,204,113,217,214,330,1598,2554,5,13587,754,0,1
57,1522,1513,682,1277,25,13,200,1538,11,199,116,219,210,335,1557,2584,6,15641,868,0,1
57,1522,819,519,539,24,98,155,843,15,96,57,106,111,163,690,1107,8,9171,509,0,1
131,2259,1338,495,1086,10,64,173,1348,11,122,82,157,133,239,883,1686,7,11934,663,0,1
80,1742,1457,730,1242,11,6,188,1468,10,292,166,329,302,495,2424,4078,5,22973,1276,1,1
80,1742,74,35,59,1,0,14,75,3,14,7,14,17,21,58,85,1,128,7,0,1
80,1742,245,125,200,5,7,34,250,7,30,17,34,37,51,166,265,3,1053,58,0,1
74,1711,384,251,317,7,8,52,391,11,70,44,84,81,128,467,811,6,5355,297,0,1
185,4091,182,127,129,0,0,53,182,5,39,21,42,44,63,217,343,2,926,51,0,0
185,4091,1165,710,800,67,119,181,1232,18,243,153,282,261,435,2000,3492,10,36473,2026,1,0
73,1676,773,419,590,28,0,166,801,10,204,113,217,214,330,1598,2554,5,13587,754,0,0
73,1676,421,273,302,44,34,57,465,17,81,59,107,98,166,583,1098,11,12329,684,0,0
56,1928,773,419,590,28,0,166,801,10,204,113,217,214,330,1598,2554,5,13587,754,0,0
127,3221,1450,624,1228,12,26,181,1462,14,306,186,354,320,540,2580,4493,8,36391,2021,1,1
2,293,42,7,35,4,0,5,46,1,2,1,2,3,3,2,4,0,2,0,0,0
2,293,11,6,10,0,0,1,11,2,4,2,4,6,6,10,15,1,15,0,0,0
15,423,1450,624,1228,12,26,181,1462,14,306,186,354,320,540,2580,4493,8,36391,2021,1,1
39,869,1450,624,1228,12,26,181,1462,14,306,186,354,320,540,2580,4493,8,36391,2021,1,1
43,937,1450,624,1228,12,26,181,1462,14,306,186,354,320,540,2580,4493,8,36391,2021,1,0
58,1569,1513,682,1277,25,13,200,1538,11,199,116,219,210,335,1557,2584,6,15641,868,0,1
58,1569,819,519,539,24,98,155,843,15,96,57,106,111,163,690,1107,8,9171,509,0,1
47,1955,1513,682,1277,25,13,200,1538,11,199,116,219,210,335,1557,2584,6,15641,868,0,1
101,3809,1392,870,1177,35,17,170,1427,14,494,280,531,508,811,4473,7289,7,54850,3047,2,1
15,439,1450,624,1228,12,26,181,1462,14,306,186,354,320,540,2580,4493,8,36391,2021,1,0
102,3827,1392,870,1177,35,17,170,1427,14,494,280,531,508,811,4473,7289,7,54850,3047,2,0
73,1676,773,419,590,28,0,166,801,10,204,113,217,214,330,1598,2554,5,13587,754,0,1
73,1676,421,273,302,44,34,57,465,17,81,59,107,98,166,583,1098,11,12329,684,0,1
6,256,207,111,150,11,0,50,218,5,26,19,36,31,55,133,272,3,943,52,0,1
6,256,410,198,237,31,55,97,441,11,63,38,72,74,110,414,683,6,4293,238,0,1
19,282,477,336,357,30,23,73,507,16,194,134,250,210,384,1538,2962,10,30538,1696,0,1
4,227,207,111,150,11,0,50,218,5,26,19,36,31,55,133,272,3,943,52,0,1
34,1912,1457,730,1242,11,6,188,1468,10,292,166,329,302,495,2424,4078,5,22973,1276,1,1
29,1459,384,251,317,7,8,52,391,11,70,44,84,81,128,467,811,6,5355,297,0,1
20,856,373,158,315,8,0,51,381,5,76,44,79,81,123,486,779,2,2026,112,0,1
12,284,1523,757,1297,19,12,193,1542,12,193,117,230,205,347,1508,2664,7,19053,1058,0,1
12,284,701,378,504,33,58,109,734,13,110,68,126,123,194,794,1346,7,10027,557,0,1
15,432,1450,624,1228,12,26,181,1462,14,306,186,354,320,540,2580,4493,8,36391,2021,1,0
6,282,207,111,150,11,0,50,218,5,26,19,36,31,55,133,272,3,943,52,0,1
6,282,410,198,237,31,55,97,441,11,63,38,72,74,110,414,683,6,4293,238,0,1
11,497,127,75,83,2,11,30,129,4,14,7,14,18,21,61,87,2,175,9,0,1
11,497,652,304,544,16,6,88,668,6,89,51,101,95,152,591,998,3,3399,188,0,1
11,497,2,2,2,0,0,0,2,0,0,0,0,0,0,0,0,0,0,0,0,1
11,497,8,5,5,0,0,3,8,0,0,0,0,0,0,0,0,0,0,0,0,1
11,497,14,8,8,0,0,6,14,0,0,0,0,0,0,0,0,0,0,0,0,1
11,497,6,4,4,0,0,2,6,0,0,0,0,0,0,0,0,0,0,0,0,1
11,497,6,4,4,0,0,2,6,1,2,1,2,3,3,2,4,0,2,0,0,1
11,497,7,5,5,0,0,2,7,0,0,0,0,0,0,0,0,0,0,0,0,1
11,497,10,6,6,0,0,4,10,0,0,0,0,0,0,0,0,0,0,0,0,1
11,497,1,1,1,0,0,0,1,0,0,0,0,0,0,0,0,0,0,0,0,1
11,497,14,10,10,0,0,4,14,1,1,1,1,2,2,0,2,0,1,0,0,1
11,497,46,26,30,3,0,12,49,3,6,3,6,9,9,20,28,1,42,2,0,1
36,512,282,196,195,3,0,86,285,8,130,71,141,138,212,936,1507,4,6538,363,0,0
65,1702,1513,682,1277,25,13,200,1538,11,199,116,219,210,335,1557,2584,6,15641,868,0,1
65,1702,819,519,539,24,98,155,843,15,96,57,106,111,163,690,1107,8,9171,509,0,1
43,852,215,129,180,6,0,29,221,8,65,43,72,73,115,415,711,4,3153,175,0,1
43,852,97,69,77,3,3,16,100,6,22,13,23,28,36,113,173,3,542,30,0,1
133,2262,1338,495,1086,10,64,173,1348,11,122,82,157,133,239,883,1686,7,11934,663,0,1
6,261,207,111,150,11,0,50,218,5,26,19,36,31,55,133,272,3,943,52,0,1
6,261,410,198,237,31,55,97,441,11,63,38,72,74,110,414,683,6,4293,238,0,1
185,4092,182,127,129,0,0,53,182,5,39,21,42,44,63,217,343,2,926,51,0,1
185,4092,1165,710,800,67,119,181,1232,18,243,153,282,261,435,2000,3492,10,36473,2026,1,1
102,3828,1392,870,1177,35,17,170,1427,14,494,280,531,508,811,4473,7289,7,54850,3047,2,1
9,526,1289,550,1043,56,32,155,1345,10,167,93,185,177,278,1266,2075,5,11498,638,0,1
73,1670,773,419,590,28,0,166,801,10,204,113,217,214,330,1598,2554,5,13587,754,0,1
73,1670,421,273,302,44,34,57,465,17,81,59,107,98,166,583,1098,11,12329,684,0,1
11,515,127,75,83,2,11,30,129,4,14,7,14,18,21,61,87,2,175,9,0,1
11,515,652,304,544,16,6,88,668,6,89,51,101,95,152,591,998,3,3399,188,0,1
11,515,2,2,2,0,0,0,2,0,0,0,0,0,0,0,0,0,0,0,0,1
11,515,8,5,5,0,0,3,8,0,0,0,0,0,0,0,0,0,0,0,0,1
11,515,14,8,8,0,0,6,14,0,0,0,0,0,0,0,0,0,0,0,0,1
11,515,6,4,4,0,0,2,6,0,0,0,0,0,0,0,0,0,0,0,0,1
11,515,6,4,4,0,0,2,6,1,2,1,2,3,3,2,4,0,2,0,0,1
11,515,7,5,5,0,0,2,7,0,0,0,0,0,0,0,0,0,0,0,0,1
11,515,10,6,6,0,0,4,10,0,0,0,0,0,0,0,0,0,0,0,0,1
11,515,1,1,1,0,0,0,1,0,0,0,0,0,0,0,0,0,0,0,0,1
11,515,14,10,10,0,0,4,14,1,1,1,1,2,2,0,2,0,1,0,0,1
11,515,46,26,30,3,0,12,49,3,6,3,6,9,9,20,28,1,42,2,0,1
74,1693,773,419,590,28,0,166,801,10,204,113,217,214,330,1598,2554,5,13587,754,0,0
74,1693,421,273,302,44,34,57,465,17,81,59,107,98,166,583,1098,11,12329,684,0,0
17,326,127,75,83,2,11,30,129,4,14,7,14,18,21,61,87,2,175,9,0,1
17,326,652,304,544,16,6,88,668,6,89,51,101,95,152,591,998,3,3399,188,0,1
17,326,2,2,2,0,0,0,2,0,0,0,0,0,0,0,0,0,0,0,0,1
17,326,8,5,5,0,0,3,8,0,0,0,0,0,0,0,0,0,0,0,0,1
17,326,14,8,8,0,0,6,14,0,0,0,0,0,0,0,0,0,0,0,0,1
17,326,6,4,4,0,0,2,6,0,0,0,0,0,0,0,0,0,0,0,0,1
17,326,6,4,4,0,0,2,6,1,2,1,2,3,3,2,4,0,2,0,0,1
17,326,7,5,5,0,0,2,7,0,0,0,0,0,0,0,0,0,0,0,0,1
17,326,10,6,6,0,0,4,10,0,0,0,0,0,0,0,0,0,0,0,0,1
17,326,1,1,1,0,0,0,1,0,0,0,0,0,0,0,0,0,0,0,0,1
17,326,14,10,10,0,0,4,14,1,1,1,1,2,2,0,2,0,1,0,0,1
17,326,46,26,30,3,0,12,49,3,6,3,6,9,9,20,28,1,42,2,0,1
2,29,127,75,83,2,11,30,129,4,14,7,14,18,21,61,87,2,175,9,0,1
2,29,652,304,544,16,6,88,668,6,89,51,101,95,152,591,998,3,3399,188,0,1
2,29,2,2,2,0,0,0,2,0,0,0,0,0,0,0,0,0,0,0,0,1
2,29,8,5,5,0,0,3,8,0,0,0,0,0,0,0,0,0,0,0,0,1
2,29,14,8,8,0,0,6,14,0,0,0,0,0,0,0,0,0,0,0,0,1
2,29,6,4,4,0,0,2,6,0,0,0,0,0,0,0,0,0,0,0,0,1
2,29,6,4,4,0,0,2,6,1,2,1,2,3,3,2,4,0,2,0,0,1
2,29,7,5,5,0,0,2,7,0,0,0,0,0,0,0,0,0,0,0,0,1
2,29,10,6,6,0,0,4,10,0,0,0,0,0,0,0,0,0,0,0,0,1
2,29,1,1,1,0,0,0,1,0,0,0,0,0,0,0,0,0,0,0,0,1
2,29,14,10,10,0,0,4,14,1,1,1,1,2,2,0,2,0,1,0,0,1
2,29,46,26,30,3,0,12,49,3,6,3,6,9,9,20,28,1,42,2,0,1
6,108,127,75,83,2,11,30,129,4,14,7,14,18,21,61,87,2,175,9,0,1
6,108,652,304,544,16,6,88,668,6,89,51,101,95,152,591,998,3,3399,188,0,1
6,108,2,2,2,0,0,0,2,0,0,0,0,0,0,0,0,0,0,0,0,1
6,108,8,5,5,0,0,3,8,0,0,0,0,0,0,0,0,0,0,0,0,1
6,108,14,8,8,0,0,6,14,0,0,0,0,0,0,0,0,0,0,0,0,1
6,108,6,4,4,0,0,2,6,0,0,0,0,0,0,0,0,0,0,0,0,1
6,108,6,4,4,0,0,2,6,1,2,1,2,3,3,2,4,0,2,0,0,1
6,108,7,5,5,0,0,2,7,0,0,0,0,0,0,0,0,0,0,0,0,1
6,108,10,6,6,0,0,4,10,0,0,0,0,0,0,0,0,0,0,0,0,1
6,108,1,1,1,0,0,0,1,0,0,0,0,0,0,0,0,0,0,0,0,1
6,108,14,10,10,0,0,4,14,1,1,1,1,2,2,0,2,0,1,0,0,1
6,108,46,26,30,3,0,12,49,3,6,3,6,9,9,20,28,1,42,2,0,1
7,169,127,75,83,2,11,30,129,4,14,7,14,18,21,61,87,2,175,9,0,1
7,169,652,304,544,16,6,88,668,6,89,51,101,95,152,591,998,3,3399,188,0,1
7,169,2,2,2,0,0,0,2,0,0,0,0,0,0,0,0,0,0,0,0,1
7,169,8,5,5,0,0,3,8,0,0,0,0,0,0,0,0,0,0,0,0,1
7,169,14,8,8,0,0,6,14,0,0,0,0,0,0,0,0,0,0,0,0,1
7,169,6,4,4,0,0,2,6,0,0,0,0,0,0,0,0,0,0,0,0,1
7,169,6,4,4,0,0,2,6,1,2,1,2,3,3,2,4,0,2,0,0,1
7,169,7,5,5,0,0,2,7,0,0,0,0,0,0,0,0,0,0,0,0,1
7,169,10,6,6,0,0,4,10,0,0,0,0,0,0,0,0,0,0,0,0,1
7,169,1,1,1,0,0,0,1,0,0,0,0,0,0,0,0,0,0,0,0,1
7,169,14,10,10,0,0,4,14,1,1,1,1,2,2,0,2,0,1,0,0,1
7,169,46,26,30,3,0,12,49,3,6,3,6,9,9,20,28,1,42,2,0,1
1,71,42,7,35,4,0,5,46,1,2,1,2,3,3,2,4,0,2,0,0,1
1,71,11,6,10,0,0,1,11,2,4,2,4,6,6,10,15,1,15,0,0,1
2,223,42,7,35,4,0,5,46,1,2,1,2,3,3,2,4,0,2,0,0,1
2,223,11,6,10,0,0,1,11,2,4,2,4,6,6,10,15,1,15,0,0,1
186,4149,182,127,129,0,0,53,182,5,39,21,42,44,63,217,343,2,926,51,0,0
186,4149,1165,710,800,67,119,181,1232,18,243,153,282,261,435,2000,3492,10,36473,2026,1,0
34,1110,182,127,129,0,0,53,182,5,39,21,42,44,63,217,343,2,926,51,0,0
11,269,127,75,83,2,11,30,129,4,14,7,14,18,21,61,87,2,175,9,0,0
11,269,652,304,544,16,6,88,668,6,89,51,101,95,152,591,998,3,3399,188,0,0
11,269,2,2,2,0,0,0,2,0,0,0,0,0,0,0,0,0,0,0,0,0
11,269,8,5,5,0,0,3,8,0,0,0,0,0,0,0,0,0,0,0,0,0
11,269,14,8,8,0,0,6,14,0,0,0,0,0,0,0,0,0,0,0,0,0
11,269,6,4,4,0,0,2,6,0,0,0,0,0,0,0,0,0,0,0,0,0
11,269,6,4,4,0,0,2,6,1,2,1,2,3,3,2,4,0,2,0,0,0
11,269,7,5,5,0,0,2,7,0,0,0,0,0,0,0,0,0,0,0,0,0
11,269,10,6,6,0,0,4,10,0,0,0,0,0,0,0,0,0,0,0,0,0
11,269,1,1,1,0,0,0,1,0,0,0,0,0,0,0,0,0,0,0,0,0
11,269,14,10,10,0,0,4,14,1,1,1,1,2,2,0,2,0,1,0,0,0
11,269,46,26,30,3,0,12,49,3,6,3,6,9,9,20,28,1,42,2,0,0
40,353,647,139,84,35,284,233,682,0,0,0,0,0,0,0,0,0,0,0,0,0
11,269,127,75,83,2,11,30,129,4,14,7,14,18,21,61,87,2,175,9,0,1
11,269,652,304,544,16,6,88,668,6,89,51,101,95,152,591,998,3,3399,188,0,1
11,269,2,2,2,0,0,0,2,0,0,0,0,0,0,0,0,0,0,0,0,1
11,269,8,5,5,0,0,3,8,0,0,0,0,0,0,0,0,0,0,0,0,1
11,269,14,8,8,0,0,6,14,0,0,0,0,0,0,0,0,0,0,0,0,1
11,269,6,4,4,0,0,2,6,0,0,0,0,0,0,0,0,0,0,0,0,1
11,269,6,4,4,0,0,2,6,1,2,1,2,3,3,2,4,0,2,0,0,1
11,269,7,5,5,0,0,2,7,0,0,0,0,0,0,0,0,0,0,0,0,1
11,269,10,6,6,0,0,4,10,0,0,0,0,0,0,0,0,0,0,0,0,1
11,269,1,1,1,0,0,0,1,0,0,0,0,0,0,0,0,0,0,0,0,1
11,269,14,10,10,0,0,4,14,1,1,1,1,2,2,0,2,0,1,0,0,1
11,269,46,26,30,3,0,12,49,3,6,3,6,9,9,20,28,1,42,2,0,1
3,58,127,75,83,2,11,30,129,4,14,7,14,18,21,61,87,2,175,9,0,1
3,58,652,304,544,16,6,88,668,6,89,51,101,95,152,591,998,3,3399,188,0,1
3,58,2,2,2,0,0,0,2,0,0,0,0,0,0,0,0,0,0,0,0,1
3,58,8,5,5,0,0,3,8,0,0,0,0,0,0,0,0,0,0,0,0,1
3,58,14,8,8,0,0,6,14,0,0,0,0,0,0,0,0,0,0,0,0,1
3,58,6,4,4,0,0,2,6,0,0,0,0,0,0,0,0,0,0,0,0,1
3,58,6,4,4,0,0,2,6,1,2,1,2,3,3,2,4,0,2,0,0,1
3,58,7,5,5,0,0,2,7,0,0,0,0,0,0,0,0,0,0,0,0,1
3,58,10,6,6,0,0,4,10,0,0,0,0,0,0,0,0,0,0,0,0,1
3,58,1,1,1,0,0,0,1,0,0,0,0,0,0,0,0,0,0,0,0,1
3,58,14,10,10,0,0,4,14,1,1,1,1,2,2,0,2,0,1,0,0,1
3,58,46,26,30,3,0,12,49,3,6,3,6,9,9,20,28,1,42,2,0,1
1,9,2,2,2,0,0,0,2,0,0,0,0,0,0,0,0,0,0,0,0,1
3,65,127,75,83,2,11,30,129,4,14,7,14,18,21,61,87,2,175,9,0,1
3,65,652,304,544,16,6,88,668,6,89,51,101,95,152,591,998,3,3399,188,0,1
3,65,2,2,2,0,0,0,2,0,0,0,0,0,0,0,0,0,0,0,0,1
3,65,8,5,5,0,0,3,8,0,0,0,0,0,0,0,0,0,0,0,0,1
3,65,14,8,8,0,0,6,14,0,0,0,0,0,0,0,0,0,0,0,0,1
3,65,6,4,4,0,0,2,6,0,0,0,0,0,0,0,0,0,0,0,0,1
3,65,6,4,4,0,0,2,6,1,2,1,2,3,3,2,4,0,2,0,0,1
3,65,7,5,5,0,0,2,7,0,0,0,0,0,0,0,0,0,0,0,0,1
3,65,10,6,6,0,0,4,10,0,0,0,0,0,0,0,0,0,0,0,0,1
3,65,1,1,1,0,0,0,1,0,0,0,0,0,0,0,0,0,0,0,0,1
3,65,14,10,10,0,0,4,14,1,1,1,1,2,2,0,2,0,1,0,0,1
3,65,46,26,30,3,0,12,49,3,6,3,6,9,9,20,28,1,42,2,0,1
56,1928,773,419,590,28,0,166,801,10,204,113,217,214,330,1598,2554,5,13587,754,0,1
12,380,15,9,9,0,0,6,15,0,0,0,0,0,0,0,0,0,0,0,0,0
19,349,127,75,83,2,11,30,129,4,14,7,14,18,21,61,87,2,175,9,0,1
19,349,652,304,544,16,6,88,668,6,89,51,101,95,152,591,998,3,3399,188,0,1
19,349,2,2,2,0,0,0,2,0,0,0,0,0,0,0,0,0,0,0,0,1
19,349,8,5,5,0,0,3,8,0,0,0,0,0,0,0,0,0,0,0,0,1
19,349,14,8,8,0,0,6,14,0,0,0,0,0,0,0,0,0,0,0,0,1
19,349,6,4,4,0,0,2,6,0,0,0,0,0,0,0,0,0,0,0,0,1
19,349,6,4,4,0,0,2,6,1,2,1,2,3,3,2,4,0,2,0,0,1
19,349,7,5,5,0,0,2,7,0,0,0,0,0,0,0,0,0,0,0,0,1
19,349,10,6,6,0,0,4,10,0,0,0,0,0,0,0,0,0,0,0,0,1
19,349,1,1,1,0,0,0,1,0,0,0,0,0,0,0,0,0,0,0,0,1
19,349,14,10,10,0,0,4,14,1,1,1,1,2,2,0,2,0,1,0,0,1
19,349,46,26,30,3,0,12,49,3,6,3,6,9,9,20,28,1,42,2,0,1
2,219,42,7,35,4,0,5,46,1,2,1,2,3,3,2,4,0,2,0,0,1
2,219,11,6,10,0,0,1,11,2,4,2,4,6,6,10,15,1,15,0,0,1
28,538,334,251,279,10,4,40,344,5,127,74,143,132,217,899,1528,2,4303,239,0,1
34,1920,1457,730,1242,11,6,188,1468,10,292,166,329,302,495,2424,4078,5,22973,1276,1,1
16,752,334,251,279,10,4,40,344,5,127,74,143,132,217,899,1528,2,4303,239,0,1
15,428,1450,624,1228,12,26,181,1462,14,306,186,354,320,540,2580,4493,8,36391,2021,1,1
186,4143,182,127,129,0,0,53,182,5,39,21,42,44,63,217,343,2,926,51,0,1
186,4143,1165,710,800,67,119,181,1232,18,243,153,282,261,435,2000,3492,10,36473,2026,1,1
133,2264,1338,495,1086,10,64,173,1348,11,122,82,157,133,239,883,1686,7,11934,663,0,1
79,1733,1457,730,1242,11,6,188,1468,10,292,166,329,302,495,2424,4078,5,22973,1276,1,1
79,1733,74,35,59,1,0,14,75,3,14,7,14,17,21,58,85,1,128,7,0,1
79,1733,245,125,200,5,7,34,250,7,30,17,34,37,51,166,265,3,1053,58,0,1
74,1701,384,251,317,7,8,52,391,11,70,44,84,81,128,467,811,6,5355,297,0,1
36,669,373,158,315,8,0,51,381,5,76,44,79,81,123,486,779,2,2026,112,0,1
2,221,42,7,35,4,0,5,46,1,2,1,2,3,3,2,4,0,2,0,0,1
2,221,11,6,10,0,0,1,11,2,4,2,4,6,6,10,15,1,15,0,0,1
43,935,1450,624,1228,12,26,181,1462,14,306,186,354,320,540,2580,4493,8,36391,2021,1,1
56,1918,773,419,590,28,0,166,801,10,204,113,217,214,330,1598,2554,5,13587,754,0,1
47,1953,1513,682,1277,25,13,200,1538,11,199,116,219,210,335,1557,2584,6,15641,868,0,1
11,513,127,75,83,2,11,30,129,4,14,7,14,18,21,61,87,2,175,9,0,1
11,513,652,304,544,16,6,88,668,6,89,51,101,95,152,591,998,3,3399,188,0,1
11,513,2,2,2,0,0,0,2,0,0,0,0,0,0,0,0,0,0,0,0,1
11,513,8,5,5,0,0,3,8,0,0,0,0,0,0,0,0,0,0,0,0,1
11,513,14,8,8,0,0,6,14,0,0,0,0,0,0,0,0,0,0,0,0,1
11,513,6,4,4,0,0,2,6,0,0,0,0,0,0,0,0,0,0,0,0,1
11,513,6,4,4,0,0,2,6,1,2,1,2,3,3,2,4,0,2,0,0,1
11,513,7,5,5,0,0,2,7,0,0,0,0,0,0,0,0,0,0,0,0,1
11,513,10,6,6,0,0,4,10,0,0,0,0,0,0,0,0,0,0,0,0,1
11,513,1,1,1,0,0,0,1,0,0,0,0,0,0,0,0,0,0,0,0,1
11,513,14,10,10,0,0,4,14,1,1,1,1,2,2,0,2,0,1,0,0,1
11,513,46,26,30,3,0,12,49,3,6,3,6,9,9,20,28,1,42,2,0,1
4,223,207,111,150,11,0,50,218,5,26,19,36,31,55,133,272,3,943,52,0,1
34,1914,1457,730,1242,11,6,188,1468,10,292,166,329,302,495,2424,4078,5,22973,1276,1,1
16,750,334,251,279,10,4,40,344,5,127,74,143,132,217,899,1528,2,4303,239,0,1
29,1453,384,251,317,7,8,52,391,11,70,44,84,81,128,467,811,6,5355,297,0,1
16,759,334,251,279,10,4,40,344,5,127,74,143,132,217,899,1528,2,4303,239,0,1
42,923,1450,624,1228,12,26,181,1462,14,306,186,354,320,540,2580,4493,8,36391,2021,1,1
55,1910,773,419,590,28,0,166,801,10,204,113,217,214,330,1598,2554,5,13587,754,0,1
78,1734,384,251,317,7,8,52,391,11,70,44,84,81,128,467,811,6,5355,297,0,1
30,1536,384,251,317,7,8,52,391,11,70,44,84,81,128,467,811,6,5355,297,0,1
28,548,334,251,279,10,4,40,344,5,127,74,143,132,217,899,1528,2,4303,239,0,1
19,842,334,251,279,10,4,40,344,5,127,74,143,132,217,899,1528,2,4303,239,0,1
3,65,127,75,83,2,11,30,129,4,14,7,14,18,21,61,87,2,175,9,0,0
3,65,652,304,544,16,6,88,668,6,89,51,101,95,152,591,998,3,3399,188,0,0
3,65,2,2,2,0,0,0,2,0,0,0,0,0,0,0,0,0,0,0,0,0
3,65,8,5,5,0,0,3,8,0,0,0,0,0,0,0,0,0,0,0,0,0
3,65,14,8,8,0,0,6,14,0,0,0,0,0,0,0,0,0,0,0,0,0
3,65,6,4,4,0,0,2,6,0,0,0,0,0,0,0,0,0,0,0,0,0
3,65,6,4,4,0,0,2,6,1,2,1,2,3,3,2,4,0,2,0,0,0
3,65,7,5,5,0,0,2,7,0,0,0,0,0,0,0,0,0,0,0,0,0
3,65,10,6,6,0,0,4,10,0,0,0,0,0,0,0,0,0,0,0,0,0
3,65,1,1,1,0,0,0,1,0,0,0,0,0,0,0,0,0,0,0,0,0
3,65,14,10,10,0,0,4,14,1,1,1,1,2,2,0,2,0,1,0,0,0
3,65,46,26,30,3,0,12,49,3,6,3,6,9,9,20,28,1,42,2,0,0
34,1914,1457,730,1242,11,6,188,1468,10,292,166,329,302,495,2424,4078,5,22973,1276,1,0
133,2248,1338,495,1086,10,64,173,1348,11,122,82,157,133,239,883,1686,7,11934,663,0,1
78,1725,1457,730,1242,11,6,188,1468,10,292,166,329,302,495,2424,4078,5,22973,1276,1,1
78,1725,74,35,59,1,0,14,75,3,14,7,14,17,21,58,85,1,128,7,0,1
78,1725,245,125,200,5,7,34,250,7,30,17,34,37,51,166,265,3,1053,58,0,1
102,3815,1392,870,1177,35,17,170,1427,14,494,280,531,508,811,4473,7289,7,54850,3047,2,1
7,160,127,75,83,2,11,30,129,4,14,7,14,18,21,61,87,2,175,9,0,1
7,160,652,304,544,16,6,88,668,6,89,51,101,95,152,591,998,3,3399,188,0,1
7,160,2,2,2,0,0,0,2,0,0,0,0,0,0,0,0,0,0,0,0,1
7,160,8,5,5,0,0,3,8,0,0,0,0,0,0,0,0,0,0,0,0,1
7,160,14,8,8,0,0,6,14,0,0,0,0,0,0,0,0,0,0,0,0,1
7,160,6,4,4,0,0,2,6,0,0,0,0,0,0,0,0,0,0,0,0,1
7,160,6,4,4,0,0,2,6,1,2,1,2,3,3,2,4,0,2,0,0,1
7,160,7,5,5,0,0,2,7,0,0,0,0,0,0,0,0,0,0,0,0,1
7,160,10,6,6,0,0,4,10,0,0,0,0,0,0,0,0,0,0,0,0,1
7,160,1,1,1,0,0,0,1,0,0,0,0,0,0,0,0,0,0,0,0,1
7,160,14,10,10,0,0,4,14,1,1,1,1,2,2,0,2,0,1,0,0,1
7,160,46,26,30,3,0,12,49,3,6,3,6,9,9,20,28,1,42,2,0,1
15,439,1450,624,1228,12,26,181,1462,14,306,186,354,320,540,2580,4493,8,36391,2021,1,1
187,4157,182,127,129,0,0,53,182,5,39,21,42,44,63,217,343,2,926,51,0,1
187,4157,1165,710,800,67,119,181,1232,18,243,153,282,261,435,2000,3492,10,36473,2026,1,1
42,935,1450,624,1228,12,26,181,1462,14,306,186,354,320,540,2580,4493,8,36391,2021,1,1
34,1126,182,127,129,0,0,53,182,5,39,21,42,44,63,217,343,2,926,51,0,1
102,3816,1392,870,1177,35,17,170,1427,14,494,280,531,508,811,4473,7289,7,54850,3047,2,1
42,923,1450,624,1228,12,26,181,1462,14,306,186,354,320,540,2580,4493,8,36391,2021,1,0
2,206,42,7,35,4,0,5,46,1,2,1,2,3,3,2,4,0,2,0,0,1
2,206,11,6,10,0,0,1,11,2,4,2,4,6,6,10,15,1,15,0,0,1
2,180,42,7,35,4,0,5,46,1,2,1,2,3,3,2,4,0,2,0,0,1
2,180,11,6,10,0,0,1,11,2,4,2,4,6,6,10,15,1,15,0,0,1
19,385,127,75,83,2,11,30,129,4,14,7,14,18,21,61,87,2,175,9,0,0
19,385,652,304,544,16,6,88,668,6,89,51,101,95,152,591,998,3,3399,188,0,0
19,385,2,2,2,0,0,0,2,0,0,0,0,0,0,0,0,0,0,0,0,0
19,385,8,5,5,0,0,3,8,0,0,0,0,0,0,0,0,0,0,0,0,0
19,385,14,8,8,0,0,6,14,0,0,0,0,0,0,0,0,0,0,0,0,0
19,385,6,4,4,0,0,2,6,0,0,0,0,0,0,0,0,0,0,0,0,0
19,385,6,4,4,0,0,2,6,1,2,1,2,3,3,2,4,0,2,0,0,0
19,385,7,5,5,0,0,2,7,0,0,0,0,0,0,0,0,0,0,0,0,0
19,385,10,6,6,0,0,4,10,0,0,0,0,0,0,0,0,0,0,0,0,0
19,385,1,1,1,0,0,0,1,0,0,0,0,0,0,0,0,0,0,0,0,0
19,385,14,10,10,0,0,4,14,1,1,1,1,2,2,0,2,0,1,0,0,0
19,385,46,26,30,3,0,12,49,3,6,3,6,9,9,20,28,1,42,2,0,0
79,1735,1457,730,1242,11,6,188,1468,10,292,166,329,302,495,2424,4078,5,22973,1276,1,1
79,1735,74,35,59,1,0,14,75,3,14,7,14,17,21,58,85,1,128,7,0,1
79,1735,245,125,200,5,7,34,250,7,30,17,34,37,51,166,265,3,1053,58,0,1
15,443,1450,624,1228,12,26,181,1462,14,306,186,354,320,540,2580,4493,8,36391,2021,1,1
187,4163,182,127,129,0,0,53,182,5,39,21,42,44,63,217,343,2,926,51,0,1
187,4163,1165,710,800,67,119,181,1232,18,243,153,282,261,435,2000,3492,10,36473,2026,1,1
79,1724,1457,730,1242,11,6,188,1468,10,292,166,329,302,495,2424,4078,5,22973,1276,1,1
79,1724,74,35,59,1,0,14,75,3,14,7,14,17,21,58,85,1,128,7,0,1
79,1724,245,125,200,5,7,34,250,7,30,17,34,37,51,166,265,3,1053,58,0,1
78,1724,384,251,317,7,8,52,391,11,70,44,84,81,128,467,811,6,5355,297,0,1
34,1130,182,127,129,0,0,53,182,5,39,21,42,44,63,217,343,2,926,51,0,1
102,3818,1392,870,1177,35,17,170,1427,14,494,280,531,508,811,4473,7289,7,54850,3047,2,1
55,1920,773,419,590,28,0,166,801,10,204,113,217,214,330,1598,2554,5,13587,754,0,1
7,172,127,75,83,2,11,30,129,4,14,7,14,18,21,61,87,2,175,9,0,1
7,172,652,304,544,16,6,88,668,6,89,51,101,95,152,591,998,3,3399,188,0,1
7,172,2,2,2,0,0,0,2,0,0,0,0,0,0,0,0,0,0,0,0,1
7,172,8,5,5,0,0,3,8,0,0,0,0,0,0,0,0,0,0,0,0,1
7,172,14,8,8,0,0,6,14,0,0,0,0,0,0,0,0,0,0,0,0,1
7,172,6,4,4,0,0,2,6,0,0,0,0,0,0,0,0,0,0,0,0,1
7,172,6,4,4,0,0,2,6,1,2,1,2,3,3,2,4,0,2,0,0,1
7,172,7,5,5,0,0,2,7,0,0,0,0,0,0,0,0,0,0,0,0,1
7,172,10,6,6,0,0,4,10,0,0,0,0,0,0,0,0,0,0,0,0,1
7,172,1,1,1,0,0,0,1,0,0,0,0,0,0,0,0,0,0,0,0,1
7,172,14,10,10,0,0,4,14,1,1,1,1,2,2,0,2,0,1,0,0,1
7,172,46,26,30,3,0,12,49,3,6,3,6,9,9,20,28,1,42,2,0,1
19,844,334,251,279,10,4,40,344,5,127,74,143,132,217,899,1528,2,4303,239,0,1
30,1542,384,251,317,7,8,52,391,11,70,44,84,81,128,467,811,6,5355,297,0,1
28,551,334,251,279,10,4,40,344,5,127,74,143,132,217,899,1528,2,4303,239,0,1
2,178,42,7,35,4,0,5,46,1,2,1,2,3,3,2,4,0,2,0,0,1
2,178,11,6,10,0,0,1,11,2,4,2,4,6,6,10,15,1,15,0,0,1
2,178,42,7,35,4,0,5,46,1,2,1,2,3,3,2,4,0,2,0,0,0
2,178,11,6,10,0,0,1,11,2,4,2,4,6,6,10,15,1,15,0,0,0
9,523,1289,550,1043,56,32,155,1345,10,167,93,185,177,278,1266,2075,5,11498,638,0,0
79,1731,1457,730,1242,11,6,188,1468,10,292,166,329,302,495,2424,4078,5,22973,1276,1,1
79,1731,74,35,59,1,0,14,75,3,14,7,14,17,21,58,85,1,128,7,0,1
79,1731,245,125,200,5,7,34,250,7,30,17,34,37,51,166,265,3,1053,58,0,1
81,1771,384,251,317,7,8,52,391,11,70,44,84,81,128,467,811,6,5355,297,0,1
33,1635,384,251,317,7,8,52,391,11,70,44,84,81,128,467,811,6,5355,297,0,1
82,1777,384,251,317,7,8,52,391,11,70,44,84,81,128,467,811,6,5355,297,0,0
34,1678,384,251,317,7,8,52,391,11,70,44,84,81,128,467,811,6,5355,297,0,0
44,869,215,129,180,6,0,29,221,8,65,43,72,73,115,415,711,4,3153,175,0,0
44,869,97,69,77,3,3,16,100,6,22,13,23,28,36,113,173,3,542,30,0,0
4,84,127,75,83,2,11,30,129,4,14,7,14,18,21,61,87,2,175,9,0,1
4,84,652,304,544,16,6,88,668,6,89,51,101,95,152,591,998,3,3399,188,0,1
4,84,2,2,2,0,0,0,2,0,0,0,0,0,0,0,0,0,0,0,0,1
4,84,8,5,5,0,0,3,8,0,0,0,0,0,0,0,0,0,0,0,0,1
4,84,14,8,8,0,0,6,14,0,0,0,0,0,0,0,0,0,0,0,0,1
4,84,6,4,4,0,0,2,6,0,0,0,0,0,0,0,0,0,0,0,0,1
4,84,6,4,4,0,0,2,6,1,2,1,2,3,3,2,4,0,2,0,0,1
4,84,7,5,5,0,0,2,7,0,0,0,0,0,0,0,0,0,0,0,0,1
4,84,10,6,6,0,0,4,10,0,0,0,0,0,0,0,0,0,0,0,0,1
4,84,1,1,1,0,0,0,1,0,0,0,0,0,0,0,0,0,0,0,0,1
4,84,14,10,10,0,0,4,14,1,1,1,1,2,2,0,2,0,1,0,0,1
4,84,46,26,30,3,0,12,49,3,6,3,6,9,9,20,28,1,42,2,0,1
45,961,1450,624,1228,12,26,181,1462,14,306,186,354,320,540,2580,4493,8,36391,2021,1,0
19,392,127,75,83,2,11,30,129,4,14,7,14,18,21,61,87,2,175,9,0,0
19,392,652,304,544,16,6,88,668,6,89,51,101,95,152,591,998,3,3399,188,0,0
19,392,2,2,2,0,0,0,2,0,0,0,0,0,0,0,0,0,0,0,0,0
19,392,8,5,5,0,0,3,8,0,0,0,0,0,0,0,0,0,0,0,0,0
19,392,14,8,8,0,0,6,14,0,0,0,0,0,0,0,0,0,0,0,0,0
19,392,6,4,4,0,0,2,6,0,0,0,0,0,0,0,0,0,0,0,0,0
19,392,6,4,4,0,0,2,6,1,2,1,2,3,3,2,4,0,2,0,0,0
19,392,7,5,5,0,0,2,7,0,0,0,0,0,0,0,0,0,0,0,0,0
19,392,10,6,6,0,0,4,10,0,0,0,0,0,0,0,0,0,0,0,0,0
19,392,1,1,1,0,0,0,1,0,0,0,0,0,0,0,0,0,0,0,0,0
19,392,14,10,10,0,0,4,14,1,1,1,1,2,2,0,2,0,1,0,0,0
19,392,46,26,30,3,0,12,49,3,6,3,6,9,9,20,28,1,42,2,0,0
8,346,42,7,35,4,0,5,46,1,2,1,2,3,3,2,4,0,2,0,0,1
8,346,11,6,10,0,0,1,11,2,4,2,4,6,6,10,15,1,15,0,0,1
8,346,42,7,35,4,0,5,46,1,2,1,2,3,3,2,4,0,2,0,0,0
8,346,11,6,10,0,0,1,11,2,4,2,4,6,6,10,15,1,15,0,0,0
135,2281,1338,495,1086,10,64,173,1348,11,122,82,157,133,239,883,1686,7,11934,663,0,0
11,531,127,75,83,2,11,30,129,4,14,7,14,18,21,61,87,2,175,9,0,0
11,531,652,304,544,16,6,88,668,6,89,51,101,95,152,591,998,3,3399,188,0,0
11,531,2,2,2,0,0,0,2,0,0,0,0,0,0,0,0,0,0,0,0,0
11,531,8,5,5,0,0,3,8,0,0,0,0,0,0,0,0,0,0,0,0,0
11,531,14,8,8,0,0,6,14,0,0,0,0,0,0,0,0,0,0,0,0,0
11,531,6,4,4,0,0,2,6,0,0,0,0,0,0,0,0,0,0,0,0,0
11,531,6,4,4,0,0,2,6,1,2,1,2,3,3,2,4,0,2,0,0,0
11,531,7,5,5,0,0,2,7,0,0,0,0,0,0,0,0,0,0,0,0,0
11,531,10,6,6,0,0,4,10,0,0,0,0,0,0,0,0,0,0,0,0,0
11,531,1,1,1,0,0,0,1,0,0,0,0,0,0,0,0,0,0,0,0,0
11,531,14,10,10,0,0,4,14,1,1,1,1,2,2,0,2,0,1,0,0,0
11,531,46,26,30,3,0,12,49,3,6,3,6,9,9,20,28,1,42,2,0,0
81,1777,1457,730,1242,11,6,188,1468,10,292,166,329,302,495,2424,4078,5,22973,1276,1,0
81,1777,74,35,59,1,0,14,75,3,14,7,14,17,21,58,85,1,128,7,0,0
81,1777,245,125,200,5,7,34,250,7,30,17,34,37,51,166,265,3,1053,58,0,0
80,1795,384,251,317,7,8,52,391,11,70,44,84,81,128,467,811,6,5355,297,0,0
7,170,127,75,83,2,11,30,129,4,14,7,14,18,21,61,87,2,175,9,0,0
7,170,652,304,544,16,6,88,668,6,89,51,101,95,152,591,998,3,3399,188,0,0
7,170,2,2,2,0,0,0,2,0,0,0,0,0,0,0,0,0,0,0,0,0
7,170,8,5,5,0,0,3,8,0,0,0,0,0,0,0,0,0,0,0,0,0
7,170,14,8,8,0,0,6,14,0,0,0,0,0,0,0,0,0,0,0,0,0
7,170,6,4,4,0,0,2,6,0,0,0,0,0,0,0,0,0,0,0,0,0
7,170,6,4,4,0,0,2,6,1,2,1,2,3,3,2,4,0,2,0,0,0
7,170,7,5,5,0,0,2,7,0,0,0,0,0,0,0,0,0,0,0,0,0
7,170,10,6,6,0,0,4,10,0,0,0,0,0,0,0,0,0,0,0,0,0
7,170,1,1,1,0,0,0,1,0,0,0,0,0,0,0,0,0,0,0,0,0
7,170,14,10,10,0,0,4,14,1,1,1,1,2,2,0,2,0,1,0,0,0
7,170,46,26,30,3,0,12,49,3,6,3,6,9,9,20,28,1,42,2,0,0
34,1680,384,251,317,7,8,52,391,11,70,44,84,81,128,467,811,6,5355,297,0,0
60,1259,384,251,317,7,8,52,391,11,70,44,84,81,128,467,811,6,5355,297,0,1
40,355,647,139,84,35,284,233,682,0,0,0,0,0,0,0,0,0,0,0,0,1
31,1596,384,251,317,7,8,52,391,11,70,44,84,81,128,467,811,6,5355,297,0,1
81,1754,1457,730,1242,11,6,188,1468,10,292,166,329,302,495,2424,4078,5,22973,1276,1,1
81,1754,74,35,59,1,0,14,75,3,14,7,14,17,21,58,85,1,128,7,0,1
81,1754,245,125,200,5,7,34,250,7,30,17,34,37,51,166,265,3,1053,58,0,1
93,1908,384,251,317,7,8,52,391,11,70,44,84,81,128,467,811,6,5355,297,0,1
33,1899,1457,730,1242,11,6,188,1468,10,292,166,329,302,495,2424,4078,5,22973,1276,1,1
61,2672,384,251,317,7,8,52,391,11,70,44,84,81,128,467,811,6,5355,297,0,1
80,1713,1457,730,1242,11,6,188,1468,10,292,166,329,302,495,2424,4078,5,22973,1276,1,1
80,1713,74,35,59,1,0,14,75,3,14,7,14,17,21,58,85,1,128,7,0,1
80,1713,245,125,200,5,7,34,250,7,30,17,34,37,51,166,265,3,1053,58,0,1
81,1725,1457,730,1242,11,6,188,1468,10,292,166,329,302,495,2424,4078,5,22973,1276,1,1
81,1725,74,35,59,1,0,14,75,3,14,7,14,17,21,58,85,1,128,7,0,1
81,1725,245,125,200,5,7,34,250,7,30,17,34,37,51,166,265,3,1053,58,0,1
93,1911,384,251,317,7,8,52,391,11,70,44,84,81,128,467,811,6,5355,297,0,1
8,391,1289,550,1043,56,32,155,1345,10,167,93,185,177,278,1266,2075,5,11498,638,0,1
17,360,127,75,83,2,11,30,129,4,14,7,14,18,21,61,87,2,175,9,0,1
17,360,652,304,544,16,6,88,668,6,89,51,101,95,152,591,998,3,3399,188,0,1
17,360,2,2,2,0,0,0,2,0,0,0,0,0,0,0,0,0,0,0,0,1
17,360,8,5,5,0,0,3,8,0,0,0,0,0,0,0,0,0,0,0,0,1
17,360,14,8,8,0,0,6,14,0,0,0,0,0,0,0,0,0,0,0,0,1
17,360,6,4,4,0,0,2,6,0,0,0,0,0,0,0,0,0,0,0,0,1
17,360,6,4,4,0,0,2,6,1,2,1,2,3,3,2,4,0,2,0,0,1
17,360,7,5,5,0,0,2,7,0,0,0,0,0,0,0,0,0,0,0,0,1
17,360,10,6,6,0,0,4,10,0,0,0,0,0,0,0,0,0,0,0,0,1
17,360,1,1,1,0,0,0,1,0,0,0,0,0,0,0,0,0,0,0,0,1
17,360,14,10,10,0,0,4,14,1,1,1,1,2,2,0,2,0,1,0,0,1
17,360,46,26,30,3,0,12,49,3,6,3,6,9,9,20,28,1,42,2,0,1
79,1661,1457,730,1242,11,6,188,1468,10,292,166,329,302,495,2424,4078,5,22973,1276,1,1
79,1661,74,35,59,1,0,14,75,3,14,7,14,17,21,58,85,1,128,7,0,1
79,1661,245,125,200,5,7,34,250,7,30,17,34,37,51,166,265,3,1053,58,0,1
33,1845,1457,730,1242,11,6,188,1468,10,292,166,329,302,495,2424,4078,5,22973,1276,1,1
61,2664,384,251,317,7,8,52,391,11,70,44,84,81,128,467,811,6,5355,297,0,1
20,851,373,158,315,8,0,51,381,5,76,44,79,81,123,486,779,2,2026,112,0,1
32,1814,1457,730,1242,11,6,188,1468,10,292,166,329,302,495,2424,4078,5,22973,1276,1,0
11,552,127,75,83,2,11,30,129,4,14,7,14,18,21,61,87,2,175,9,0,1
11,552,652,304,544,16,6,88,668,6,89,51,101,95,152,591,998,3,3399,188,0,1
11,552,2,2,2,0,0,0,2,0,0,0,0,0,0,0,0,0,0,0,0,1
11,552,8,5,5,0,0,3,8,0,0,0,0,0,0,0,0,0,0,0,0,1
11,552,14,8,8,0,0,6,14,0,0,0,0,0,0,0,0,0,0,0,0,1
11,552,6,4,4,0,0,2,6,0,0,0,0,0,0,0,0,0,0,0,0,1
11,552,6,4,4,0,0,2,6,1,2,1,2,3,3,2,4,0,2,0,0,1
11,552,7,5,5,0,0,2,7,0,0,0,0,0,0,0,0,0,0,0,0,1
11,552,10,6,6,0,0,4,10,0,0,0,0,0,0,0,0,0,0,0,0,1
11,552,1,1,1,0,0,0,1,0,0,0,0,0,0,0,0,0,0,0,0,1
11,552,14,10,10,0,0,4,14,1,1,1,1,2,2,0,2,0,1,0,0,1
11,552,46,26,30,3,0,12,49,3,6,3,6,9,9,20,28,1,42,2,0,1
95,3781,1392,870,1177,35,17,170,1427,14,494,280,531,508,811,4473,7289,7,54850,3047,2,1
55,1911,773,419,590,28,0,166,801,10,204,113,217,214,330,1598,2554,5,13587,754,0,1
8,388,1289,550,1043,56,32,155,1345,10,167,93,185,177,278,1266,2075,5,11498,638,0,1
32,1815,1457,730,1242,11,6,188,1468,10,292,166,329,302,495,2424,4078,5,22973,1276,1,1
139,2371,1338,495,1086,10,64,173,1348,11,122,82,157,133,239,883,1686,7,11934,663,0,1
82,1712,1457,730,1242,11,6,188,1468,10,292,166,329,302,495,2424,4078,5,22973,1276,1,1
82,1712,74,35,59,1,0,14,75,3,14,7,14,17,21,58,85,1,128,7,0,1
82,1712,245,125,200,5,7,34,250,7,30,17,34,37,51,166,265,3,1053,58,0,1
90,1868,384,251,317,7,8,52,391,11,70,44,84,81,128,467,811,6,5355,297,0,1
57,2496,384,251,317,7,8,52,391,11,70,44,84,81,128,467,811,6,5355,297,0,1
140,2381,1338,495,1086,10,64,173,1348,11,122,82,157,133,239,883,1686,7,11934,663,0,1
11,574,127,75,83,2,11,30,129,4,14,7,14,18,21,61,87,2,175,9,0,0
11,574,652,304,544,16,6,88,668,6,89,51,101,95,152,591,998,3,3399,188,0,0
11,574,2,2,2,0,0,0,2,0,0,0,0,0,0,0,0,0,0,0,0,0
11,574,8,5,5,0,0,3,8,0,0,0,0,0,0,0,0,0,0,0,0,0
11,574,14,8,8,0,0,6,14,0,0,0,0,0,0,0,0,0,0,0,0,0
11,574,6,4,4,0,0,2,6,0,0,0,0,0,0,0,0,0,0,0,0,0
11,574,6,4,4,0,0,2,6,1,2,1,2,3,3,2,4,0,2,0,0,0
11,574,7,5,5,0,0,2,7,0,0,0,0,0,0,0,0,0,0,0,0,0
11,574,10,6,6,0,0,4,10,0,0,0,0,0,0,0,0,0,0,0,0,0
11,574,1,1,1,0,0,0,1,0,0,0,0,0,0,0,0,0,0,0,0,0
11,574,14,10,10,0,0,4,14,1,1,1,1,2,2,0,2,0,1,0,0,0
11,574,46,26,30,3,0,12,49,3,6,3,6,9,9,20,28,1,42,2,0,0
82,1712,1457,730,1242,11,6,188,1468,10,292,166,329,302,495,2424,4078,5,22973,1276,1,0
82,1712,74,35,59,1,0,14,75,3,14,7,14,17,21,58,85,1,128,7,0,0
82,1712,245,125,200,5,7,34,250,7,30,17,34,37,51,166,265,3,1053,58,0,0
8,420,1289,550,1043,56,32,155,1345,10,167,93,185,177,278,1266,2075,5,11498,638,0,0
31,1779,1457,730,1242,11,6,188,1468,10,292,166,329,302,495,2424,4078,5,22973,1276,1,0
140,2380,1338,495,1086,10,64,173,1348,11,122,82,157,133,239,883,1686,7,11934,663,0,1
82,1749,1457,730,1242,11,6,188,1468,10,292,166,329,302,495,2424,4078,5,22973,1276,1,1
82,1749,74,35,59,1,0,14,75,3,14,7,14,17,21,58,85,1,128,7,0,1
82,1749,245,125,200,5,7,34,250,7,30,17,34,37,51,166,265,3,1053,58,0,1
40,360,647,139,84,35,284,233,682,0,0,0,0,0,0,0,0,0,0,0,0,1
31,606,127,75,83,2,11,30,129,4,14,7,14,18,21,61,87,2,175,9,0,1
31,606,652,304,544,16,6,88,668,6,89,51,101,95,152,591,998,3,3399,188,0,1
31,606,2,2,2,0,0,0,2,0,0,0,0,0,0,0,0,0,0,0,0,1
31,606,8,5,5,0,0,3,8,0,0,0,0,0,0,0,0,0,0,0,0,1
31,606,14,8,8,0,0,6,14,0,0,0,0,0,0,0,0,0,0,0,0,1
31,606,6,4,4,0,0,2,6,0,0,0,0,0,0,0,0,0,0,0,0,1
31,606,6,4,4,0,0,2,6,1,2,1,2,3,3,2,4,0,2,0,0,1
31,606,7,5,5,0,0,2,7,0,0,0,0,0,0,0,0,0,0,0,0,1
31,606,10,6,6,0,0,4,10,0,0,0,0,0,0,0,0,0,0,0,0,1
31,606,1,1,1,0,0,0,1,0,0,0,0,0,0,0,0,0,0,0,0,1
31,606,14,10,10,0,0,4,14,1,1,1,1,2,2,0,2,0,1,0,0,1
31,606,46,26,30,3,0,12,49,3,6,3,6,9,9,20,28,1,42,2,0,1
30,602,127,75,83,2,11,30,129,4,14,7,14,18,21,61,87,2,175,9,0,0
30,602,652,304,544,16,6,88,668,6,89,51,101,95,152,591,998,3,3399,188,0,0
30,602,2,2,2,0,0,0,2,0,0,0,0,0,0,0,0,0,0,0,0,0
30,602,8,5,5,0,0,3,8,0,0,0,0,0,0,0,0,0,0,0,0,0
30,602,14,8,8,0,0,6,14,0,0,0,0,0,0,0,0,0,0,0,0,0
30,602,6,4,4,0,0,2,6,0,0,0,0,0,0,0,0,0,0,0,0,0
30,602,6,4,4,0,0,2,6,1,2,1,2,3,3,2,4,0,2,0,0,0
30,602,7,5,5,0,0,2,7,0,0,0,0,0,0,0,0,0,0,0,0,0
30,602,10,6,6,0,0,4,10,0,0,0,0,0,0,0,0,0,0,0,0,0
30,602,1,1,1,0,0,0,1,0,0,0,0,0,0,0,0,0,0,0,0,0
30,602,14,10,10,0,0,4,14,1,1,1,1,2,2,0,2,0,1,0,0,0
30,602,46,26,30,3,0,12,49,3,6,3,6,9,9,20,28,1,42,2,0,0
83,1755,1457,730,1242,11,6,188,1468,10,292,166,329,302,495,2424,4078,5,22973,1276,1,1
83,1755,74,35,59,1,0,14,75,3,14,7,14,17,21,58,85,1,128,7,0,1
83,1755,245,125,200,5,7,34,250,7,30,17,34,37,51,166,265,3,1053,58,0,1
187,4173,182,127,129,0,0,53,182,5,39,21,42,44,63,217,343,2,926,51,0,1
187,4173,1165,710,800,67,119,181,1232,18,243,153,282,261,435,2000,3492,10,36473,2026,1,1
90,1869,384,251,317,7,8,52,391,11,70,44,84,81,128,467,811,6,5355,297,0,1
140,2370,1338,495,1086,10,64,173,1348,11,122,82,157,133,239,883,1686,7,11934,663,0,0
90,1873,384,251,317,7,8,52,391,11,70,44,84,81,128,467,811,6,5355,297,0,1
34,1885,1457,730,1242,11,6,188,1468,10,292,166,329,302,495,2424,4078,5,22973,1276,1,1
57,2508,384,251,317,7,8,52,391,11,70,44,84,81,128,467,811,6,5355,297,0,1
83,1769,1457,730,1242,11,6,188,1468,10,292,166,329,302,495,2424,4078,5,22973,1276,1,0
83,1769,74,35,59,1,0,14,75,3,14,7,14,17,21,58,85,1,128,7,0,0
83,1769,245,125,200,5,7,34,250,7,30,17,34,37,51,166,265,3,1053,58,0,0
32,621,334,251,279,10,4,40,344,5,127,74,143,132,217,899,1528,2,4303,239,0,0
92,1901,384,251,317,7,8,52,391,11,70,44,84,81,128,467,811,6,5355,297,0,0
18,815,334,251,279,10,4,40,344,5,127,74,143,132,217,899,1528,2,4303,239,0,0
57,2515,384,251,317,7,8,52,391,11,70,44,84,81,128,467,811,6,5355,297,0,0
92,1901,384,251,317,7,8,52,391,11,70,44,84,81,128,467,811,6,5355,297,0,1
139,2342,1338,495,1086,10,64,173,1348,11,122,82,157,133,239,883,1686,7,11934,663,0,1
79,1704,1457,730,1242,11,6,188,1468,10,292,166,329,302,495,2424,4078,5,22973,1276,1,1
79,1704,74,35,59,1,0,14,75,3,14,7,14,17,21,58,85,1,128,7,0,1
79,1704,245,125,200,5,7,34,250,7,30,17,34,37,51,166,265,3,1053,58,0,1
34,1906,1457,730,1242,11,6,188,1468,10,292,166,329,302,495,2424,4078,5,22973,1276,1,1
11,544,127,75,83,2,11,30,129,4,14,7,14,18,21,61,87,2,175,9,0,1
11,544,652,304,544,16,6,88,668,6,89,51,101,95,152,591,998,3,3399,188,0,1
11,544,2,2,2,0,0,0,2,0,0,0,0,0,0,0,0,0,0,0,0,1
11,544,8,5,5,0,0,3,8,0,0,0,0,0,0,0,0,0,0,0,0,1
11,544,14,8,8,0,0,6,14,0,0,0,0,0,0,0,0,0,0,0,0,1
11,544,6,4,4,0,0,2,6,0,0,0,0,0,0,0,0,0,0,0,0,1
11,544,6,4,4,0,0,2,6,1,2,1,2,3,3,2,4,0,2,0,0,1
11,544,7,5,5,0,0,2,7,0,0,0,0,0,0,0,0,0,0,0,0,1
11,544,10,6,6,0,0,4,10,0,0,0,0,0,0,0,0,0,0,0,0,1
11,544,1,1,1,0,0,0,1,0,0,0,0,0,0,0,0,0,0,0,0,1
11,544,14,10,10,0,0,4,14,1,1,1,1,2,2,0,2,0,1,0,0,1
11,544,46,26,30,3,0,12,49,3,6,3,6,9,9,20,28,1,42,2,0,1
8,348,42,7,35,4,0,5,46,1,2,1,2,3,3,2,4,0,2,0,0,1
8,348,11,6,10,0,0,1,11,2,4,2,4,6,6,10,15,1,15,0,0,1
8,386,1289,550,1043,56,32,155,1345,10,167,93,185,177,278,1266,2075,5,11498,638,0,1
8,376,1289,550,1043,56,32,155,1345,10,167,93,185,177,278,1266,2075,5,11498,638,0,1
135,2241,1338,495,1086,10,64,173,1348,11,122,82,157,133,239,883,1686,7,11934,663,0,1
85,1902,1457,730,1242,11,6,188,1468,10,292,166,329,302,495,2424,4078,5,22973,1276,1,1
85,1902,74,35,59,1,0,14,75,3,14,7,14,17,21,58,85,1,128,7,0,1
85,1902,245,125,200,5,7,34,250,7,30,17,34,37,51,166,265,3,1053,58,0,1
33,626,373,158,315,8,0,51,381,5,76,44,79,81,123,486,779,2,2026,112,0,1
34,1943,1457,730,1242,11,6,188,1468,10,292,166,329,302,495,2424,4078,5,22973,1276,1,1
8,347,42,7,35,4,0,5,46,1,2,1,2,3,3,2,4,0,2,0,0,1
8,347,11,6,10,0,0,1,11,2,4,2,4,6,6,10,15,1,15,0,0,1
81,1873,1457,730,1242,11,6,188,1468,10,292,166,329,302,495,2424,4078,5,22973,1276,1,1
81,1873,74,35,59,1,0,14,75,3,14,7,14,17,21,58,85,1,128,7,0,1
81,1873,245,125,200,5,7,34,250,7,30,17,34,37,51,166,265,3,1053,58,0,1
33,628,373,158,315,8,0,51,381,5,76,44,79,81,123,486,779,2,2026,112,0,1
81,1888,1457,730,1242,11,6,188,1468,10,292,166,329,302,495,2424,4078,5,22973,1276,1,0
81,1888,74,35,59,1,0,14,75,3,14,7,14,17,21,58,85,1,128,7,0,0
81,1888,245,125,200,5,7,34,250,7,30,17,34,37,51,166,265,3,1053,58,0,0
41,367,647,139,84,35,284,233,682,0,0,0,0,0,0,0,0,0,0,0,0,1
20,429,127,75,83,2,11,30,129,4,14,7,14,18,21,61,87,2,175,9,0,1
20,429,652,304,544,16,6,88,668,6,89,51,101,95,152,591,998,3,3399,188,0,1
20,429,2,2,2,0,0,0,2,0,0,0,0,0,0,0,0,0,0,0,0,1
20,429,8,5,5,0,0,3,8,0,0,0,0,0,0,0,0,0,0,0,0,1
20,429,14,8,8,0,0,6,14,0,0,0,0,0,0,0,0,0,0,0,0,1
20,429,6,4,4,0,0,2,6,0,0,0,0,0,0,0,0,0,0,0,0,1
20,429,6,4,4,0,0,2,6,1,2,1,2,3,3,2,4,0,2,0,0,1
20,429,7,5,5,0,0,2,7,0,0,0,0,0,0,0,0,0,0,0,0,1
20,429,10,6,6,0,0,4,10,0,0,0,0,0,0,0,0,0,0,0,0,1
20,429,1,1,1,0,0,0,1,0,0,0,0,0,0,0,0,0,0,0,0,1
20,429,14,10,10,0,0,4,14,1,1,1,1,2,2,0,2,0,1,0,0,1
20,429,46,26,30,3,0,12,49,3,6,3,6,9,9,20,28,1,42,2,0,1
70,1681,1457,730,1242,11,6,188,1468,10,292,166,329,302,495,2424,4078,5,22973,1276,1,1
70,1681,74,35,59,1,0,14,75,3,14,7,14,17,21,58,85,1,128,7,0,1
70,1681,245,125,200,5,7,34,250,7,30,17,34,37,51,166,265,3,1053,58,0,1
96,1953,384,251,317,7,8,52,391,11,70,44,84,81,128,467,811,6,5355,297,0,1
8,343,42,7,35,4,0,5,46,1,2,1,2,3,3,2,4,0,2,0,0,1
8,343,11,6,10,0,0,1,11,2,4,2,4,6,6,10,15,1,15,0,0,1
32,1840,1457,730,1242,11,6,188,1468,10,292,166,329,302,495,2424,4078,5,22973,1276,1,1
187,4167,182,127,129,0,0,53,182,5,39,21,42,44,63,217,343,2,926,51,0,1
187,4167,1165,710,800,67,119,181,1232,18,243,153,282,261,435,2000,3492,10,36473,2026,1,1
70,1671,1457,730,1242,11,6,188,1468,10,292,166,329,302,495,2424,4078,5,22973,1276,1,1
70,1671,74,35,59,1,0,14,75,3,14,7,14,17,21,58,85,1,128,7,0,1
70,1671,245,125,200,5,7,34,250,7,30,17,34,37,51,166,265,3,1053,58,0,1
96,1951,384,251,317,7,8,52,391,11,70,44,84,81,128,467,811,6,5355,297,0,1
8,341,42,7,35,4,0,5,46,1,2,1,2,3,3,2,4,0,2,0,0,1
8,341,11,6,10,0,0,1,11,2,4,2,4,6,6,10,15,1,15,0,0,1
45,961,1450,624,1228,12,26,181,1462,14,306,186,354,320,540,2580,4493,8,36391,2021,1,1
95,3779,1392,870,1177,35,17,170,1427,14,494,280,531,508,811,4473,7289,7,54850,3047,2,1
55,1901,773,419,590,28,0,166,801,10,204,113,217,214,330,1598,2554,5,13587,754,0,1
11,542,127,75,83,2,11,30,129,4,14,7,14,18,21,61,87,2,175,9,0,1
11,542,652,304,544,16,6,88,668,6,89,51,101,95,152,591,998,3,3399,188,0,1
11,542,2,2,2,0,0,0,2,0,0,0,0,0,0,0,0,0,0,0,0,1
11,542,8,5,5,0,0,3,8,0,0,0,0,0,0,0,0,0,0,0,0,1
11,542,14,8,8,0,0,6,14,0,0,0,0,0,0,0,0,0,0,0,0,1
11,542,6,4,4,0,0,2,6,0,0,0,0,0,0,0,0,0,0,0,0,1
11,542,6,4,4,0,0,2,6,1,2,1,2,3,3,2,4,0,2,0,0,1
11,542,7,5,5,0,0,2,7,0,0,0,0,0,0,0,0,0,0,0,0,1
11,542,10,6,6,0,0,4,10,0,0,0,0,0,0,0,0,0,0,0,0,1
11,542,1,1,1,0,0,0,1,0,0,0,0,0,0,0,0,0,0,0,0,1
11,542,14,10,10,0,0,4,14,1,1,1,1,2,2,0,2,0,1,0,0,1
11,542,46,26,30,3,0,12,49,3,6,3,6,9,9,20,28,1,42,2,0,1
7,168,127,75,83,2,11,30,129,4,14,7,14,18,21,61,87,2,175,9,0,1
7,168,652,304,544,16,6,88,668,6,89,51,101,95,152,591,998,3,3399,188,0,1
7,168,2,2,2,0,0,0,2,0,0,0,0,0,0,0,0,0,0,0,0,1
7,168,8,5,5,0,0,3,8,0,0,0,0,0,0,0,0,0,0,0,0,1
7,168,14,8,8,0,0,6,14,0,0,0,0,0,0,0,0,0,0,0,0,1
7,168,6,4,4,0,0,2,6,0,0,0,0,0,0,0,0,0,0,0,0,1
7,168,6,4,4,0,0,2,6,1,2,1,2,3,3,2,4,0,2,0,0,1
7,168,7,5,5,0,0,2,7,0,0,0,0,0,0,0,0,0,0,0,0,1
7,168,10,6,6,0,0,4,10,0,0,0,0,0,0,0,0,0,0,0,0,1
7,168,1,1,1,0,0,0,1,0,0,0,0,0,0,0,0,0,0,0,0,1
7,168,14,10,10,0,0,4,14,1,1,1,1,2,2,0,2,0,1,0,0,1
7,168,46,26,30,3,0,12,49,3,6,3,6,9,9,20,28,1,42,2,0,1
32,1832,1457,730,1242,11,6,188,1468,10,292,166,329,302,495,2424,4078,5,22973,1276,1,1
18,813,334,251,279,10,4,40,344,5,127,74,143,132,217,899,1528,2,4303,239,0,1
57,2507,384,251,317,7,8,52,391,11,70,44,84,81,128,467,811,6,5355,297,0,1
2,81,13,10,10,0,0,3,13,1,2,1,2,3,3,2,4,0,2,0,0,0
136,2272,1338,495,1086,10,64,173,1348,11,122,82,157,133,239,883,1686,7,11934,663,0,1
72,1693,1457,730,1242,11,6,188,1468,10,292,166,329,302,495,2424,4078,5,22973,1276,1,1
72,1693,74,35,59,1,0,14,75,3,14,7,14,17,21,58,85,1,128,7,0,1
72,1693,245,125,200,5,7,34,250,7,30,17,34,37,51,166,265,3,1053,58,0,1
34,635,373,158,315,8,0,51,381,5,76,44,79,81,123,486,779,2,2026,112,0,1
44,2711,1457,730,1242,11,6,188,1468,10,292,166,329,302,495,2424,4078,5,22973,1276,1,1
19,818,373,158,315,8,0,51,381,5,76,44,79,81,123,486,779,2,2026,112,0,1
187,4166,182,127,129,0,0,53,182,5,39,21,42,44,63,217,343,2,926,51,0,0
187,4166,1165,710,800,67,119,181,1232,18,243,153,282,261,435,2000,3492,10,36473,2026,1,0
97,3803,1392,870,1177,35,17,170,1427,14,494,280,531,508,811,4473,7289,7,54850,3047,2,0
187,4169,182,127,129,0,0,53,182,5,39,21,42,44,63,217,343,2,926,51,0,0
187,4169,1165,710,800,67,119,181,1232,18,243,153,282,261,435,2000,3492,10,36473,2026,1,0
98,3979,1392,870,1177,35,17,170,1427,14,494,280,531,508,811,4473,7289,7,54850,3047,2,0
1,83,13,10,10,0,0,3,13,1,2,1,2,3,3,2,4,0,2,0,0,0
2,29,127,75,83,2,11,30,129,4,14,7,14,18,21,61,87,2,175,9,0,0
2,29,652,304,544,16,6,88,668,6,89,51,101,95,152,591,998,3,3399,188,0,0
2,29,2,2,2,0,0,0,2,0,0,0,0,0,0,0,0,0,0,0,0,0
2,29,8,5,5,0,0,3,8,0,0,0,0,0,0,0,0,0,0,0,0,0
2,29,14,8,8,0,0,6,14,0,0,0,0,0,0,0,0,0,0,0,0,0
2,29,6,4,4,0,0,2,6,0,0,0,0,0,0,0,0,0,0,0,0,0
2,29,6,4,4,0,0,2,6,1,2,1,2,3,3,2,4,0,2,0,0,0
2,29,7,5,5,0,0,2,7,0,0,0,0,0,0,0,0,0,0,0,0,0
2,29,10,6,6,0,0,4,10,0,0,0,0,0,0,0,0,0,0,0,0,0
2,29,1,1,1,0,0,0,1,0,0,0,0,0,0,0,0,0,0,0,0,0
2,29,14,10,10,0,0,4,14,1,1,1,1,2,2,0,2,0,1,0,0,0
2,29,46,26,30,3,0,12,49,3,6,3,6,9,9,20,28,1,42,2,0,0
8,341,42,7,35,4,0,5,46,1,2,1,2,3,3,2,4,0,2,0,0,0
8,341,11,6,10,0,0,1,11,2,4,2,4,6,6,10,15,1,15,0,0,0
2,35,127,75,83,2,11,30,129,4,14,7,14,18,21,61,87,2,175,9,0,0
2,35,652,304,544,16,6,88,668,6,89,51,101,95,152,591,998,3,3399,188,0,0
2,35,2,2,2,0,0,0,2,0,0,0,0,0,0,0,0,0,0,0,0,0
2,35,8,5,5,0,0,3,8,0,0,0,0,0,0,0,0,0,0,0,0,0
2,35,14,8,8,0,0,6,14,0,0,0,0,0,0,0,0,0,0,0,0,0
2,35,6,4,4,0,0,2,6,0,0,0,0,0,0,0,0,0,0,0,0,0
2,35,6,4,4,0,0,2,6,1,2,1,2,3,3,2,4,0,2,0,0,0
2,35,7,5,5,0,0,2,7,0,0,0,0,0,0,0,0,0,0,0,0,0
2,35,10,6,6,0,0,4,10,0,0,0,0,0,0,0,0,0,0,0,0,0
2,35,1,1,1,0,0,0,1,0,0,0,0,0,0,0,0,0,0,0,0,0
2,35,14,10,10,0,0,4,14,1,1,1,1,2,2,0,2,0,1,0,0,0
2,35,46,26,30,3,0,12,49,3,6,3,6,9,9,20,28,1,42,2,0,0
8,376,1289,550,1043,56,32,155,1345,10,167,93,185,177,278,1266,2075,5,11498,638,0,0
35,315,647,139,84,35,284,233,682,0,0,0,0,0,0,0,0,0,0,0,0,1
100,2023,384,251,317,7,8,52,391,11,70,44,84,81,128,467,811,6,5355,297,0,1
7,336,42,7,35,4,0,5,46,1,2,1,2,3,3,2,4,0,2,0,0,0
7,336,11,6,10,0,0,1,11,2,4,2,4,6,6,10,15,1,15,0,0,0
47,1977,1513,682,1277,25,13,200,1538,11,199,116,219,210,335,1557,2584,6,15641,868,0,0
98,3995,1392,870,1177,35,17,170,1427,14,494,280,531,508,811,4473,7289,7,54850,3047,2,0
55,1929,773,419,590,28,0,166,801,10,204,113,217,214,330,1598,2554,5,13587,754,0,0
187,4174,182,127,129,0,0,53,182,5,39,21,42,44,63,217,343,2,926,51,0,0
187,4174,1165,710,800,67,119,181,1232,18,243,153,282,261,435,2000,3492,10,36473,2026,1,0
47,1957,1513,682,1277,25,13,200,1538,11,199,116,219,210,335,1557,2584,6,15641,868,0,1
47,1981,1513,682,1277,25,13,200,1538,11,199,116,219,210,335,1557,2584,6,15641,868,0,0
35,663,373,158,315,8,0,51,381,5,76,44,79,81,123,486,779,2,2026,112,0,1
188,4195,182,127,129,0,0,53,182,5,39,21,42,44,63,217,343,2,926,51,0,1
188,4195,1165,710,800,67,119,181,1232,18,243,153,282,261,435,2000,3492,10,36473,2026,1,1
36,1177,182,127,129,0,0,53,182,5,39,21,42,44,63,217,343,2,926,51,0,1
190,4250,182,127,129,0,0,53,182,5,39,21,42,44,63,217,343,2,926,51,0,1
190,4250,1165,710,800,67,119,181,1232,18,243,153,282,261,435,2000,3492,10,36473,2026,1,1
37,1193,182,127,129,0,0,53,182,5,39,21,42,44,63,217,343,2,926,51,0,1
44,2719,1457,730,1242,11,6,188,1468,10,292,166,329,302,495,2424,4078,5,22973,1276,1,1
72,1691,1457,730,1242,11,6,188,1468,10,292,166,329,302,495,2424,4078,5,22973,1276,1,1
72,1691,74,35,59,1,0,14,75,3,14,7,14,17,21,58,85,1,128,7,0,1
72,1691,245,125,200,5,7,34,250,7,30,17,34,37,51,166,265,3,1053,58,0,1
135,2260,1338,495,1086,10,64,173,1348,11,122,82,157,133,239,883,1686,7,11934,663,0,0
100,2021,384,251,317,7,8,52,391,11,70,44,84,81,128,467,811,6,5355,297,0,1
35,660,373,158,315,8,0,51,381,5,76,44,79,81,123,486,779,2,2026,112,0,1
44,2723,1457,730,1242,11,6,188,1468,10,292,166,329,302,495,2424,4078,5,22973,1276,1,1
65,1718,1513,682,1277,25,13,200,1538,11,199,116,219,210,335,1557,2584,6,15641,868,0,1
65,1718,819,519,539,24,98,155,843,15,96,57,106,111,163,690,1107,8,9171,509,0,1
193,4289,182,127,129,0,0,53,182,5,39,21,42,44,63,217,343,2,926,51,0,1
193,4289,1165,710,800,67,119,181,1232,18,243,153,282,261,435,2000,3492,10,36473,2026,1,1
40,1273,182,127,129,0,0,53,182,5,39,21,42,44,63,217,343,2,926,51,0,1
8,369,1289,550,1043,56,32,155,1345,10,167,93,185,177,278,1266,2075,5,11498,638,0,1
18,812,334,251,279,10,4,40,344,5,127,74,143,132,217,899,1528,2,4303,239,0,1
57,2505,384,251,317,7,8,52,391,11,70,44,84,81,128,467,811,6,5355,297,0,1
15,451,1450,624,1228,12,26,181,1462,14,306,186,354,320,540,2580,4493,8,36391,2021,1,0
193,4285,182,127,129,0,0,53,182,5,39,21,42,44,63,217,343,2,926,51,0,0
193,4285,1165,710,800,67,119,181,1232,18,243,153,282,261,435,2000,3492,10,36473,2026,1,0
46,981,1450,624,1228,12,26,181,1462,14,306,186,354,320,540,2580,4493,8,36391,2021,1,0
47,1972,1513,682,1277,25,13,200,1538,11,199,116,219,210,335,1557,2584,6,15641,868,0,0
184,4050,182,127,129,0,0,53,182,5,39,21,42,44,63,217,343,2,926,51,0,1
184,4050,1165,710,800,67,119,181,1232,18,243,153,282,261,435,2000,3492,10,36473,2026,1,1
9,265,149,95,105,2,0,41,151,8,54,28,55,62,83,334,494,4,2013,111,0,1
9,265,82,56,54,0,13,15,82,4,13,8,16,17,24,56,98,2,241,13,0,1
31,1044,182,127,129,0,0,53,182,5,39,21,42,44,63,217,343,2,926,51,0,1
21,588,149,95,105,2,0,41,151,8,54,28,55,62,83,334,494,4,2013,111,0,1
9,270,149,95,105,2,0,41,151,8,54,28,55,62,83,334,494,4,2013,111,0,0
9,270,82,56,54,0,13,15,82,4,13,8,16,17,24,56,98,2,241,13,0,0
36,329,647,139,84,35,284,233,682,0,0,0,0,0,0,0,0,0,0,0,0,0
127,2187,1338,495,1086,10,64,173,1348,11,122,82,157,133,239,883,1686,7,11934,663,0,0
37,343,647,139,84,35,284,233,682,0,0,0,0,0,0,0,0,0,0,0,0,0
66,1725,1513,682,1277,25,13,200,1538,11,199,116,219,210,335,1557,2584,6,15641,868,0,0
66,1725,819,519,539,24,98,155,843,15,96,57,106,111,163,690,1107,8,9171,509,0,0
7,336,42,7,35,4,0,5,46,1,2,1,2,3,3,2,4,0,2,0,0,1
7,336,11,6,10,0,0,1,11,2,4,2,4,6,6,10,15,1,15,0,0,1
37,343,647,139,84,35,284,233,682,0,0,0,0,0,0,0,0,0,0,0,0,1
102,2071,384,251,317,7,8,52,391,11,70,44,84,81,128,467,811,6,5355,297,0,1
61,2680,384,251,317,7,8,52,391,11,70,44,84,81,128,467,811,6,5355,297,0,1
7,338,42,7,35,4,0,5,46,1,2,1,2,3,3,2,4,0,2,0,0,1
7,338,11,6,10,0,0,1,11,2,4,2,4,6,6,10,15,1,15,0,0,1
9,414,1289,550,1043,56,32,155,1345,10,167,93,185,177,278,1266,2075,5,11498,638,0,1
170,3700,182,127,129,0,0,53,182,5,39,21,42,44,63,217,343,2,926,51,0,1
170,3700,1165,710,800,67,119,181,1232,18,243,153,282,261,435,2000,3492,10,36473,2026,1,1
72,1616,773,419,590,28,0,166,801,10,204,113,217,214,330,1598,2554,5,13587,754,0,1
72,1616,421,273,302,44,34,57,465,17,81,59,107,98,166,583,1098,11,12329,684,0,1
20,590,182,127,129,0,0,53,182,5,39,21,42,44,63,217,343,2,926,51,0,1
98,3993,1392,870,1177,35,17,170,1427,14,494,280,531,508,811,4473,7289,7,54850,3047,2,1
55,1917,773,419,590,28,0,166,801,10,204,113,217,214,330,1598,2554,5,13587,754,0,1
7,338,42,7,35,4,0,5,46,1,2,1,2,3,3,2,4,0,2,0,0,0
7,338,11,6,10,0,0,1,11,2,4,2,4,6,6,10,15,1,15,0,0,0
170,3700,182,127,129,0,0,53,182,5,39,21,42,44,63,217,343,2,926,51,0,0
170,3700,1165,710,800,67,119,181,1232,18,243,153,282,261,435,2000,3492,10,36473,2026,1,0
72,1616,773,419,590,28,0,166,801,10,204,113,217,214,330,1598,2554,5,13587,754,0,0
72,1616,421,273,302,44,34,57,465,17,81,59,107,98,166,583,1098,11,12329,684,0,0
9,414,1289,550,1043,56,32,155,1345,10,167,93,185,177,278,1266,2075,5,11498,638,0,0
20,590,182,127,129,0,0,53,182,5,39,21,42,44,63,217,343,2,926,51,0,0
98,3993,1392,870,1177,35,17,170,1427,14,494,280,531,508,811,4473,7289,7,54850,3047,2,0
55,1917,773,419,590,28,0,166,801,10,204,113,217,214,330,1598,2554,5,13587,754,0,0
54,1911,773,419,590,28,0,166,801,10,204,113,217,214,330,1598,2554,5,13587,754,0,1
12,564,1289,550,1043,56,32,155,1345,10,167,93,185,177,278,1266,2075,5,11498,638,0,1
54,1884,773,419,590,28,0,166,801,10,204,113,217,214,330,1598,2554,5,13587,754,0,0
72,1661,773,419,590,28,0,166,801,10,204,113,217,214,330,1598,2554,5,13587,754,0,0
72,1661,421,273,302,44,34,57,465,17,81,59,107,98,166,583,1098,11,12329,684,0,0
87,1695,1513,682,1277,25,13,200,1538,11,199,116,219,210,335,1557,2584,6,15641,868,0,1
87,1695,819,519,539,24,98,155,843,15,96,57,106,111,163,690,1107,8,9171,509,0,1
51,2204,1513,682,1277,25,13,200,1538,11,199,116,219,210,335,1557,2584,6,15641,868,0,1
89,1783,1513,682,1277,25,13,200,1538,11,199,116,219,210,335,1557,2584,6,15641,868,0,0
89,1783,819,519,539,24,98,155,843,15,96,57,106,111,163,690,1107,8,9171,509,0,0
66,2628,1513,682,1277,25,13,200,1538,11,199,116,219,210,335,1557,2584,6,15641,868,0,0
92,1793,1513,682,1277,25,13,200,1538,11,199,116,219,210,335,1557,2584,6,15641,868,0,0
92,1793,819,519,539,24,98,155,843,15,96,57,106,111,163,690,1107,8,9171,509,0,0
67,2673,1513,682,1277,25,13,200,1538,11,199,116,219,210,335,1557,2584,6,15641,868,0,0
91,1781,1513,682,1277,25,13,200,1538,11,199,116,219,210,335,1557,2584,6,15641,868,0,0
91,1781,819,519,539,24,98,155,843,15,96,57,106,111,163,690,1107,8,9171,509,0,0
67,2671,1513,682,1277,25,13,200,1538,11,199,116,219,210,335,1557,2584,6,15641,868,0,0
68,2725,1513,682,1277,25,13,200,1538,11,199,116,219,210,335,1557,2584,6,15641,868,0,0
95,1800,1513,682,1277,25,13,200,1538,11,199,116,219,210,335,1557,2584,6,15641,868,0,0
95,1800,819,519,539,24,98,155,843,15,96,57,106,111,163,690,1107,8,9171,509,0,0
95,1806,1513,682,1277,25,13,200,1538,11,199,116,219,210,335,1557,2584,6,15641,868,0,0
95,1806,819,519,539,24,98,155,843,15,96,57,106,111,163,690,1107,8,9171,509,0,0
105,2122,384,251,317,7,8,52,391,11,70,44,84,81,128,467,811,6,5355,297,0,1
62,2713,384,251,317,7,8,52,391,11,70,44,84,81,128,467,811,6,5355,297,0,1
75,1691,773,419,590,28,0,166,801,10,204,113,217,214,330,1598,2554,5,13587,754,0,1
75,1691,421,273,302,44,34,57,465,17,81,59,107,98,166,583,1098,11,12329,684,0,1
57,1972,773,419,590,28,0,166,801,10,204,113,217,214,330,1598,2554,5,13587,754,0,1
175,3745,182,127,129,0,0,53,182,5,39,21,42,44,63,217,343,2,926,51,0,1
175,3745,1165,710,800,67,119,181,1232,18,243,153,282,261,435,2000,3492,10,36473,2026,1,1
128,2196,1338,495,1086,10,64,173,1348,11,122,82,157,133,239,883,1686,7,11934,663,0,1
98,3995,1392,870,1177,35,17,170,1427,14,494,280,531,508,811,4473,7289,7,54850,3047,2,1
4,68,38,23,23,0,0,15,38,0,0,0,0,0,0,0,0,0,0,0,0,0
29,591,127,75,83,2,11,30,129,4,14,7,14,18,21,61,87,2,175,9,0,0
29,591,652,304,544,16,6,88,668,6,89,51,101,95,152,591,998,3,3399,188,0,0
29,591,2,2,2,0,0,0,2,0,0,0,0,0,0,0,0,0,0,0,0,0
29,591,8,5,5,0,0,3,8,0,0,0,0,0,0,0,0,0,0,0,0,0
29,591,14,8,8,0,0,6,14,0,0,0,0,0,0,0,0,0,0,0,0,0
29,591,6,4,4,0,0,2,6,0,0,0,0,0,0,0,0,0,0,0,0,0
29,591,6,4,4,0,0,2,6,1,2,1,2,3,3,2,4,0,2,0,0,0
29,591,7,5,5,0,0,2,7,0,0,0,0,0,0,0,0,0,0,0,0,0
29,591,10,6,6,0,0,4,10,0,0,0,0,0,0,0,0,0,0,0,0,0
29,591,1,1,1,0,0,0,1,0,0,0,0,0,0,0,0,0,0,0,0,0
29,591,14,10,10,0,0,4,14,1,1,1,1,2,2,0,2,0,1,0,0,0
29,591,46,26,30,3,0,12,49,3,6,3,6,9,9,20,28,1,42,2,0,0
36,699,373,158,315,8,0,51,381,5,76,44,79,81,123,486,779,2,2026,112,0,1
20,857,373,158,315,8,0,51,381,5,76,44,79,81,123,486,779,2,2026,112,0,1
36,702,373,158,315,8,0,51,381,5,76,44,79,81,123,486,779,2,2026,112,0,1
12,386,15,9,9,0,0,6,15,0,0,0,0,0,0,0,0,0,0,0,0,0
75,1712,773,419,590,28,0,166,801,10,204,113,217,214,330,1598,2554,5,13587,754,0,0
75,1712,421,273,302,44,34,57,465,17,81,59,107,98,166,583,1098,11,12329,684,0,0
59,2040,773,419,590,28,0,166,801,10,204,113,217,214,330,1598,2554,5,13587,754,0,0
128,2201,1338,495,1086,10,64,173,1348,11,122,82,157,133,239,883,1686,7,11934,663,0,1
48,1010,1450,624,1228,12,26,181,1462,14,306,186,354,320,540,2580,4493,8,36391,2021,1,1
50,1037,1450,624,1228,12,26,181,1462,14,306,186,354,320,540,2580,4493,8,36391,2021,1,1
50,1037,1450,624,1228,12,26,181,1462,14,306,186,354,320,540,2580,4493,8,36391,2021,1,0
130,2241,1338,495,1086,10,64,173,1348,11,122,82,157,133,239,883,1686,7,11934,663,0,1
59,2043,773,419,590,28,0,166,801,10,204,113,217,214,330,1598,2554,5,13587,754,0,1
29,591,127,75,83,2,11,30,129,4,14,7,14,18,21,61,87,2,175,9,0,1
29,591,652,304,544,16,6,88,668,6,89,51,101,95,152,591,998,3,3399,188,0,1
29,591,2,2,2,0,0,0,2,0,0,0,0,0,0,0,0,0,0,0,0,1
29,591,8,5,5,0,0,3,8,0,0,0,0,0,0,0,0,0,0,0,0,1
29,591,14,8,8,0,0,6,14,0,0,0,0,0,0,0,0,0,0,0,0,1
29,591,6,4,4,0,0,2,6,0,0,0,0,0,0,0,0,0,0,0,0,1
29,591,6,4,4,0,0,2,6,1,2,1,2,3,3,2,4,0,2,0,0,1
29,591,7,5,5,0,0,2,7,0,0,0,0,0,0,0,0,0,0,0,0,1
29,591,10,6,6,0,0,4,10,0,0,0,0,0,0,0,0,0,0,0,0,1
29,591,1,1,1,0,0,0,1,0,0,0,0,0,0,0,0,0,0,0,0,1
29,591,14,10,10,0,0,4,14,1,1,1,1,2,2,0,2,0,1,0,0,1
29,591,46,26,30,3,0,12,49,3,6,3,6,9,9,20,28,1,42,2,0,1
36,512,282,196,195,3,0,86,285,8,130,71,141,138,212,936,1507,4,6538,363,0,1
1,83,13,10,10,0,0,3,13,1,2,1,2,3,3,2,4,0,2,0,0,1
15,451,1450,624,1228,12,26,181,1462,14,306,186,354,320,540,2580,4493,8,36391,2021,1,1
75,1712,773,419,590,28,0,166,801,10,204,113,217,214,330,1598,2554,5,13587,754,0,1
75,1712,421,273,302,44,34,57,465,17,81,59,107,98,166,583,1098,11,12329,684,0,1
12,386,15,9,9,0,0,6,15,0,0,0,0,0,0,0,0,0,0,0,0,1
95,1806,1513,682,1277,25,13,200,1538,11,199,116,219,210,335,1557,2584,6,15641,868,0,1
95,1806,819,519,539,24,98,155,843,15,96,57,106,111,163,690,1107,8,9171,509,0,1
9,270,149,95,105,2,0,41,151,8,54,28,55,62,83,334,494,4,2013,111,0,1
9,270,82,56,54,0,13,15,82,4,13,8,16,17,24,56,98,2,241,13,0,1
44,869,215,129,180,6,0,29,221,8,65,43,72,73,115,415,711,4,3153,175,0,1
44,869,97,69,77,3,3,16,100,6,22,13,23,28,36,113,173,3,542,30,0,1
32,621,334,251,279,10,4,40,344,5,127,74,143,132,217,899,1528,2,4303,239,0,1
67,2671,1513,682,1277,25,13,200,1538,11,199,116,219,210,335,1557,2584,6,15641,868,0,1
60,2071,773,419,590,28,0,166,801,10,204,113,217,214,330,1598,2554,5,13587,754,0,0
13,638,1289,550,1043,56,32,155,1345,10,167,93,185,177,278,1266,2075,5,11498,638,0,1
17,491,1450,624,1228,12,26,181,1462,14,306,186,354,320,540,2580,4493,8,36391,2021,1,0
38,354,647,139,84,35,284,233,682,0,0,0,0,0,0,0,0,0,0,0,0,0
104,2098,384,251,317,7,8,52,391,11,70,44,84,81,128,467,811,6,5355,297,0,0
62,2707,384,251,317,7,8,52,391,11,70,44,84,81,128,467,811,6,5355,297,0,0
175,3780,182,127,129,0,0,53,182,5,39,21,42,44,63,217,343,2,926,51,0,1
175,3780,1165,710,800,67,119,181,1232,18,243,153,282,261,435,2000,3492,10,36473,2026,1,1
99,4033,1392,870,1177,35,17,170,1427,14,494,280,531,508,811,4473,7289,7,54850,3047,2,1
100,4061,1392,870,1177,35,17,170,1427,14,494,280,531,508,811,4473,7289,7,54850,3047,2,0
42,383,647,139,84,35,284,233,682,0,0,0,0,0,0,0,0,0,0,0,0,1
86,1559,1338,495,1086,10,64,173,1348,11,122,82,157,133,239,883,1686,7,11934,663,0,1
46,1093,1457,730,1242,11,6,188,1468,10,292,166,329,302,495,2424,4078,5,22973,1276,1,1
46,1093,74,35,59,1,0,14,75,3,14,7,14,17,21,58,85,1,128,7,0,1
46,1093,245,125,200,5,7,34,250,7,30,17,34,37,51,166,265,3,1053,58,0,1
104,2098,384,251,317,7,8,52,391,11,70,44,84,81,128,467,811,6,5355,297,0,1
75,1481,373,158,315,8,0,51,381,5,76,44,79,81,123,486,779,2,2026,112,0,1
16,756,1289,550,1043,56,32,155,1345,10,167,93,185,177,278,1266,2075,5,11498,638,0,1
28,2004,1296,573,1062,40,33,157,1336,8,201,118,231,209,349,1561,2689,4,12365,686,0,1
17,1070,1457,730,1242,11,6,188,1468,10,292,166,329,302,495,2424,4078,5,22973,1276,1,1
19,830,373,158,315,8,0,51,381,5,76,44,79,81,123,486,779,2,2026,112,0,1
42,626,282,196,195,3,0,86,285,8,130,71,141,138,212,936,1507,4,6538,363,0,0
175,3780,182,127,129,0,0,53,182,5,39,21,42,44,63,217,343,2,926,51,0,0
175,3780,1165,710,800,67,119,181,1232,18,243,153,282,261,435,2000,3492,10,36473,2026,1,0
9,265,149,95,105,2,0,41,151,8,54,28,55,62,83,334,494,4,2013,111,0,0
9,265,82,56,54,0,13,15,82,4,13,8,16,17,24,56,98,2,241,13,0,0
130,2241,1338,495,1086,10,64,173,1348,11,122,82,157,133,239,883,1686,7,11934,663,0,0
43,402,647,139,84,35,284,233,682,0,0,0,0,0,0,0,0,0,0,0,0,1
105,2126,384,251,317,7,8,52,391,11,70,44,84,81,128,467,811,6,5355,297,0,1
68,1433,373,158,315,8,0,51,381,5,76,44,79,81,123,486,779,2,2026,112,0,1
63,2799,384,251,317,7,8,52,391,11,70,44,84,81,128,467,811,6,5355,297,0,1
86,1556,1338,495,1086,10,64,173,1348,11,122,82,157,133,239,883,1686,7,11934,663,0,1
69,1442,373,158,315,8,0,51,381,5,76,44,79,81,123,486,779,2,2026,112,0,1
28,2012,1296,573,1062,40,33,157,1336,8,201,118,231,209,349,1561,2689,4,12365,686,0,1
19,836,373,158,315,8,0,51,381,5,76,44,79,81,123,486,779,2,2026,112,0,1
44,411,647,139,84,35,284,233,682,0,0,0,0,0,0,0,0,0,0,0,0,1
44,415,647,139,84,35,284,233,682,0,0,0,0,0,0,0,0,0,0,0,0,1
68,1426,373,158,315,8,0,51,381,5,76,44,79,81,123,486,779,2,2026,112,0,1
69,1471,373,158,315,8,0,51,381,5,76,44,79,81,123,486,779,2,2026,112,0,1
17,803,1289,550,1043,56,32,155,1345,10,167,93,185,177,278,1266,2075,5,11498,638,0,1
71,1474,373,158,315,8,0,51,381,5,76,44,79,81,123,486,779,2,2026,112,0,0
60,2071,773,419,590,28,0,166,801,10,204,113,217,214,330,1598,2554,5,13587,754,0,1
46,754,282,196,195,3,0,86,285,8,130,71,141,138,212,936,1507,4,6538,363,0,0
45,426,647,139,84,35,284,233,682,0,0,0,0,0,0,0,0,0,0,0,0,0
17,494,1450,624,1228,12,26,181,1462,14,306,186,354,320,540,2580,4493,8,36391,2021,1,1
45,428,647,139,84,35,284,233,682,0,0,0,0,0,0,0,0,0,0,0,0,1
52,1094,1450,624,1228,12,26,181,1462,14,306,186,354,320,540,2580,4493,8,36391,2021,1,1
17,494,1450,624,1228,12,26,181,1462,14,306,186,354,320,540,2580,4493,8,36391,2021,1,0
45,428,647,139,84,35,284,233,682,0,0,0,0,0,0,0,0,0,0,0,0,0
86,1556,1338,495,1086,10,64,173,1348,11,122,82,157,133,239,883,1686,7,11934,663,0,0
46,1093,1457,730,1242,11,6,188,1468,10,292,166,329,302,495,2424,4078,5,22973,1276,1,0
46,1093,74,35,59,1,0,14,75,3,14,7,14,17,21,58,85,1,128,7,0,0
46,1093,245,125,200,5,7,34,250,7,30,17,34,37,51,166,265,3,1053,58,0,0
105,2126,384,251,317,7,8,52,391,11,70,44,84,81,128,467,811,6,5355,297,0,0
17,803,1289,550,1043,56,32,155,1345,10,167,93,185,177,278,1266,2075,5,11498,638,0,0
52,1094,1450,624,1228,12,26,181,1462,14,306,186,354,320,540,2580,4493,8,36391,2021,1,0
28,2012,1296,573,1062,40,33,157,1336,8,201,118,231,209,349,1561,2689,4,12365,686,0,0
17,1070,1457,730,1242,11,6,188,1468,10,292,166,329,302,495,2424,4078,5,22973,1276,1,0
63,2799,384,251,317,7,8,52,391,11,70,44,84,81,128,467,811,6,5355,297,0,0
19,836,373,158,315,8,0,51,381,5,76,44,79,81,123,486,779,2,2026,112,0,0
16,817,1289,550,1043,56,32,155,1345,10,167,93,185,177,278,1266,2075,5,11498,638,0,1
68,1428,373,158,315,8,0,51,381,5,76,44,79,81,123,486,779,2,2026,112,0,1
28,1989,1296,573,1062,40,33,157,1336,8,201,118,231,209,349,1561,2689,4,12365,686,0,1
47,774,282,196,195,3,0,86,285,8,130,71,141,138,212,936,1507,4,6538,363,0,1
107,2170,384,251,317,7,8,52,391,11,70,44,84,81,128,467,811,6,5355,297,0,0
65,2882,384,251,317,7,8,52,391,11,70,44,84,81,128,467,811,6,5355,297,0,0
17,899,1289,550,1043,56,32,155,1345,10,167,93,185,177,278,1266,2075,5,11498,638,0,1
18,929,1289,550,1043,56,32,155,1345,10,167,93,185,177,278,1266,2075,5,11498,638,0,0
52,895,282,196,195,3,0,86,285,8,130,71,141,138,212,936,1507,4,6538,363,0,0
56,1187,1450,624,1228,12,26,181,1462,14,306,186,354,320,540,2580,4493,8,36391,2021,1,0
56,1209,1450,624,1228,12,26,181,1462,14,306,186,354,320,540,2580,4493,8,36391,2021,1,0
175,3785,182,127,129,0,0,53,182,5,39,21,42,44,63,217,343,2,926,51,0,0
175,3785,1165,710,800,67,119,181,1232,18,243,153,282,261,435,2000,3492,10,36473,2026,1,0
83,1749,1457,730,1242,11,6,188,1468,10,292,166,329,302,495,2424,4078,5,22973,1276,1,0
83,1749,74,35,59,1,0,14,75,3,14,7,14,17,21,58,85,1,128,7,0,0
83,1749,245,125,200,5,7,34,250,7,30,17,34,37,51,166,265,3,1053,58,0,0
24,1258,652,304,544,16,6,88,668,6,89,51,101,95,152,591,998,3,3399,188,0,0
115,2359,1457,730,1242,11,6,188,1468,10,292,166,329,302,495,2424,4078,5,22973,1276,1,0
115,2359,74,35,59,1,0,14,75,3,14,7,14,17,21,58,85,1,128,7,0,0
115,2359,245,125,200,5,7,34,250,7,30,17,34,37,51,166,265,3,1053,58,0,0
18,814,334,251,279,10,4,40,344,5,127,74,143,132,217,899,1528,2,4303,239,0,0
1,34,2,2,2,0,0,0,2,0,0,0,0,0,0,0,0,0,0,0,0,1
1,34,99,48,90,1,3,5,100,0,0,0,0,0,0,0,0,0,0,0,0,1
1,34,8,5,5,2,0,1,10,0,0,0,0,0,0,0,0,0,0,0,0,1
1,34,1217,716,841,84,126,174,1301,14,185,118,215,199,333,1446,2542,8,20687,1149,0,1
1,34,160,89,115,0,13,31,160,7,15,11,17,22,28,78,124,3,495,27,0,1
1,34,10,10,9,9,0,0,19,0,0,0,0,0,0,0,0,0,0,0,0,1
1,34,173,84,99,8,29,36,181,5,12,7,13,17,20,54,81,2,221,12,0,1
1,34,3,1,1,3,0,0,6,0,0,0,0,0,0,0,0,0,0,0,0,1
115,2357,1457,730,1242,11,6,188,1468,10,292,166,329,302,495,2424,4078,5,22973,1276,1,1
115,2357,74,35,59,1,0,14,75,3,14,7,14,17,21,58,85,1,128,7,0,1
115,2357,245,125,200,5,7,34,250,7,30,17,34,37,51,166,265,3,1053,58,0,1
110,2181,384,251,317,7,8,52,391,11,70,44,84,81,128,467,811,6,5355,297,0,1
68,1413,373,158,315,8,0,51,381,5,76,44,79,81,123,486,779,2,2026,112,0,1
6,277,42,7,35,4,0,5,46,1,2,1,2,3,3,2,4,0,2,0,0,1
6,277,11,6,10,0,0,1,11,2,4,2,4,6,6,10,15,1,15,0,0,1
17,333,127,75,83,2,11,30,129,4,14,7,14,18,21,61,87,2,175,9,0,1
17,333,652,304,544,16,6,88,668,6,89,51,101,95,152,591,998,3,3399,188,0,1
17,333,2,2,2,0,0,0,2,0,0,0,0,0,0,0,0,0,0,0,0,1
17,333,8,5,5,0,0,3,8,0,0,0,0,0,0,0,0,0,0,0,0,1
17,333,14,8,8,0,0,6,14,0,0,0,0,0,0,0,0,0,0,0,0,1
17,333,6,4,4,0,0,2,6,0,0,0,0,0,0,0,0,0,0,0,0,1
17,333,6,4,4,0,0,2,6,1,2,1,2,3,3,2,4,0,2,0,0,1
17,333,7,5,5,0,0,2,7,0,0,0,0,0,0,0,0,0,0,0,0,1
17,333,10,6,6,0,0,4,10,0,0,0,0,0,0,0,0,0,0,0,0,1
17,333,1,1,1,0,0,0,1,0,0,0,0,0,0,0,0,0,0,0,0,1
17,333,14,10,10,0,0,4,14,1,1,1,1,2,2,0,2,0,1,0,0,1
17,333,46,26,30,3,0,12,49,3,6,3,6,9,9,20,28,1,42,2,0,1
7,166,127,75,83,2,11,30,129,4,14,7,14,18,21,61,87,2,175,9,0,1
7,166,652,304,544,16,6,88,668,6,89,51,101,95,152,591,998,3,3399,188,0,1
7,166,2,2,2,0,0,0,2,0,0,0,0,0,0,0,0,0,0,0,0,1
7,166,8,5,5,0,0,3,8,0,0,0,0,0,0,0,0,0,0,0,0,1
7,166,14,8,8,0,0,6,14,0,0,0,0,0,0,0,0,0,0,0,0,1
7,166,6,4,4,0,0,2,6,0,0,0,0,0,0,0,0,0,0,0,0,1
7,166,6,4,4,0,0,2,6,1,2,1,2,3,3,2,4,0,2,0,0,1
7,166,7,5,5,0,0,2,7,0,0,0,0,0,0,0,0,0,0,0,0,1
7,166,10,6,6,0,0,4,10,0,0,0,0,0,0,0,0,0,0,0,0,1
7,166,1,1,1,0,0,0,1,0,0,0,0,0,0,0,0,0,0,0,0,1
7,166,14,10,10,0,0,4,14,1,1,1,1,2,2,0,2,0,1,0,0,1
7,166,46,26,30,3,0,12,49,3,6,3,6,9,9,20,28,1,42,2,0,1
28,1987,1296,573,1062,40,33,157,1336,8,201,118,231,209,349,1561,2689,4,12365,686,0,1
24,1256,652,304,544,16,6,88,668,6,89,51,101,95,152,591,998,3,3399,188,0,1
65,2872,384,251,317,7,8,52,391,11,70,44,84,81,128,467,811,6,5355,297,0,1
4,122,2,2,2,0,0,0,2,0,0,0,0,0,0,0,0,0,0,0,0,1
4,122,99,48,90,1,3,5,100,0,0,0,0,0,0,0,0,0,0,0,0,1
4,122,8,5,5,2,0,1,10,0,0,0,0,0,0,0,0,0,0,0,0,1
4,122,1217,716,841,84,126,174,1301,14,185,118,215,199,333,1446,2542,8,20687,1149,0,1
4,122,160,89,115,0,13,31,160,7,15,11,17,22,28,78,124,3,495,27,0,1
4,122,10,10,9,9,0,0,19,0,0,0,0,0,0,0,0,0,0,0,0,1
4,122,173,84,99,8,29,36,181,5,12,7,13,17,20,54,81,2,221,12,0,1
4,122,3,1,1,3,0,0,6,0,0,0,0,0,0,0,0,0,0,0,0,1
3,108,77,34,69,0,0,8,77,3,24,16,29,27,45,114,213,1,387,21,0,1
3,108,712,438,573,51,9,84,763,14,102,71,128,116,199,733,1364,8,11988,666,0,1
25,1318,652,304,544,16,6,88,668,6,89,51,101,95,152,591,998,3,3399,188,0,1
4,135,2,2,2,0,0,0,2,0,0,0,0,0,0,0,0,0,0,0,0,1
4,135,99,48,90,1,3,5,100,0,0,0,0,0,0,0,0,0,0,0,0,1
4,135,8,5,5,2,0,1,10,0,0,0,0,0,0,0,0,0,0,0,0,1
4,135,1217,716,841,84,126,174,1301,14,185,118,215,199,333,1446,2542,8,20687,1149,0,1
4,135,160,89,115,0,13,31,160,7,15,11,17,22,28,78,124,3,495,27,0,1
4,135,10,10,9,9,0,0,19,0,0,0,0,0,0,0,0,0,0,0,0,1
4,135,173,84,99,8,29,36,181,5,12,7,13,17,20,54,81,2,221,12,0,1
4,135,3,1,1,3,0,0,6,0,0,0,0,0,0,0,0,0,0,0,0,1
114,2331,1457,730,1242,11,6,188,1468,10,292,166,329,302,495,2424,4078,5,22973,1276,1,1
111,2222,384,251,317,7,8,52,391,11,70,44,84,81,128,467,811,6,5355,297,0,1
16,1031,1457,730,1242,11,6,188,1468,10,292,166,329,302,495,2424,4078,5,22973,1276,1,1
1,50,2,2,2,0,0,0,2,0,0,0,0,0,0,0,0,0,0,0,0,1
1,50,99,48,90,1,3,5,100,0,0,0,0,0,0,0,0,0,0,0,0,1
1,50,8,5,5,2,0,1,10,0,0,0,0,0,0,0,0,0,0,0,0,1
1,50,1217,716,841,84,126,174,1301,14,185,118,215,199,333,1446,2542,8,20687,1149,0,1
1,50,160,89,115,0,13,31,160,7,15,11,17,22,28,78,124,3,495,27,0,1
1,50,10,10,9,9,0,0,19,0,0,0,0,0,0,0,0,0,0,0,0,1
1,50,173,84,99,8,29,36,181,5,12,7,13,17,20,54,81,2,221,12,0,1
1,50,3,1,1,3,0,0,6,0,0,0,0,0,0,0,0,0,0,0,0,1
114,2326,1457,730,1242,11,6,188,1468,10,292,166,329,302,495,2424,4078,5,22973,1276,1,1
86,1567,1338,495,1086,10,64,173,1348,11,122,82,157,133,239,883,1686,7,11934,663,0,1
110,2212,384,251,317,7,8,52,391,11,70,44,84,81,128,467,811,6,5355,297,0,1
6,283,42,7,35,4,0,5,46,1,2,1,2,3,3,2,4,0,2,0,0,1
6,283,11,6,10,0,0,1,11,2,4,2,4,6,6,10,15,1,15,0,0,1
6,283,42,7,35,4,0,5,46,1,2,1,2,3,3,2,4,0,2,0,0,0
6,283,11,6,10,0,0,1,11,2,4,2,4,6,6,10,15,1,15,0,0,0
110,2210,384,251,317,7,8,52,391,11,70,44,84,81,128,467,811,6,5355,297,0,1
17,570,1455,414,1257,16,76,112,1471,5,41,23,46,46,69,231,381,2,1069,59,0,0
17,570,669,365,481,22,61,110,691,15,103,63,122,118,185,747,1273,8,11311,628,0,0
137,3233,722,423,573,19,0,135,741,12,172,101,199,184,300,1320,2257,6,15668,870,0,0
137,3233,1508,847,911,44,250,301,1552,14,148,88,169,162,257,1120,1886,7,15077,837,0,0
194,4278,72,33,56,0,4,12,72,1,1,1,1,2,2,0,2,0,1,0,0,0
194,4278,1454,835,1044,76,110,219,1530,17,275,158,296,292,454,2297,3718,9,34017,1889,1,0
111,2230,384,251,317,7,8,52,391,11,70,44,84,81,128,467,811,6,5355,297,0,0
26,920,1450,624,1228,12,26,181,1462,14,306,186,354,320,540,2580,4493,8,36391,2021,1,0
34,1380,1513,682,1277,25,13,200,1538,11,199,116,219,210,335,1557,2584,6,15641,868,0,0
10,403,1455,414,1257,16,76,112,1471,5,41,23,46,46,69,231,381,2,1069,59,0,0
7,226,74,35,59,1,0,14,75,3,14,7,14,17,21,58,85,1,128,7,0,0
15,734,1020,354,843,12,15,144,1032,8,134,77,144,142,221,970,1580,4,6792,377,0,0
12,820,447,308,343,6,5,95,453,7,96,59,111,103,170,651,1136,4,4600,255,0,0
5,333,722,423,573,19,0,135,741,12,172,101,199,184,300,1320,2257,6,15668,870,0,0
12,418,386,256,301,16,9,68,402,4,59,35,69,63,104,355,621,2,1453,80,0,0
13,1146,215,129,180,6,0,29,221,8,65,43,72,73,115,415,711,4,3153,175,0,0
44,1644,1043,504,840,53,9,147,1096,9,180,112,198,189,310,1377,2344,4,11604,644,0,0
24,1010,373,158,315,8,0,51,381,5,76,44,79,81,123,486,779,2,2026,112,0,0
28,1387,1178,367,1042,6,15,115,1184,9,94,51,95,103,146,644,976,4,4439,246,0,0
50,2500,1943,715,1694,26,18,214,1969,12,185,120,237,197,357,1436,2721,7,20915,1161,0,0
2,103,442,244,305,14,16,103,456,11,68,45,75,79,120,452,756,6,4588,254,0,0
28,1989,1296,573,1062,40,33,157,1336,8,201,118,231,209,349,1561,2689,4,12365,686,0,0
100,2397,1043,504,840,53,9,147,1096,9,180,112,198,189,310,1377,2344,4,11604,644,0,1
100,2397,383,288,292,26,6,62,409,11,65,38,67,76,105,429,656,5,3719,206,0,1
114,2321,1457,730,1242,11,6,188,1468,10,292,166,329,302,495,2424,4078,5,22973,1276,1,1
18,379,1098,241,925,5,10,155,1103,7,46,25,49,53,74,273,423,3,1580,87,0,1
18,379,282,202,222,14,2,44,296,8,42,24,43,50,67,250,378,4,1548,86,0,1
17,587,1455,414,1257,16,76,112,1471,5,41,23,46,46,69,231,381,2,1069,59,0,1
17,587,669,365,481,22,61,110,691,15,103,63,122,118,185,747,1273,8,11311,628,0,1
1,46,2,2,2,0,0,0,2,0,0,0,0,0,0,0,0,0,0,0,0,1
1,46,99,48,90,1,3,5,100,0,0,0,0,0,0,0,0,0,0,0,0,1
1,46,8,5,5,2,0,1,10,0,0,0,0,0,0,0,0,0,0,0,0,1
1,46,1217,716,841,84,126,174,1301,14,185,118,215,199,333,1446,2542,8,20687,1149,0,1
1,46,160,89,115,0,13,31,160,7,15,11,17,22,28,78,124,3,495,27,0,1
1,46,10,10,9,9,0,0,19,0,0,0,0,0,0,0,0,0,0,0,0,1
1,46,173,84,99,8,29,36,181,5,12,7,13,17,20,54,81,2,221,12,0,1
1,46,3,1,1,3,0,0,6,0,0,0,0,0,0,0,0,0,0,0,0,1
194,4280,72,33,56,0,4,12,72,1,1,1,1,2,2,0,2,0,1,0,0,1
194,4280,1454,835,1044,76,110,219,1530,17,275,158,296,292,454,2297,3718,9,34017,1889,1,1
171,3359,373,158,315,8,0,51,381,5,76,44,79,81,123,486,779,2,2026,112,0,1
112,2286,384,251,317,7,8,52,391,11,70,44,84,81,128,467,811,6,5355,297,0,1
66,2902,384,251,317,7,8,52,391,11,70,44,84,81,128,467,811,6,5355,297,0,1
1,42,2,2,2,0,0,0,2,0,0,0,0,0,0,0,0,0,0,0,0,1
1,42,99,48,90,1,3,5,100,0,0,0,0,0,0,0,0,0,0,0,0,1
1,42,8,5,5,2,0,1,10,0,0,0,0,0,0,0,0,0,0,0,0,1
1,42,1217,716,841,84,126,174,1301,14,185,118,215,199,333,1446,2542,8,20687,1149,0,1
1,42,160,89,115,0,13,31,160,7,15,11,17,22,28,78,124,3,495,27,0,1
1,42,10,10,9,9,0,0,19,0,0,0,0,0,0,0,0,0,0,0,0,1
1,42,173,84,99,8,29,36,181,5,12,7,13,17,20,54,81,2,221,12,0,1
1,42,3,1,1,3,0,0,6,0,0,0,0,0,0,0,0,0,0,0,0,1
137,3229,722,423,573,19,0,135,741,12,172,101,199,184,300,1320,2257,6,15668,870,0,1
137,3229,1508,847,911,44,250,301,1552,14,148,88,169,162,257,1120,1886,7,15077,837,0,1
13,1148,215,129,180,6,0,29,221,8,65,43,72,73,115,415,711,4,3153,175,0,1
18,814,334,251,279,10,4,40,344,5,127,74,143,132,217,899,1528,2,4303,239,0,1
66,2890,384,251,317,7,8,52,391,11,70,44,84,81,128,467,811,6,5355,297,0,1
54,886,1020,354,843,12,15,144,1032,8,134,77,144,142,221,970,1580,4,6792,377,0,1
28,1384,1020,354,843,12,15,144,1032,8,134,77,144,142,221,970,1580,4,6792,377,0,1
169,3958,722,423,573,19,0,135,741,12,172,101,199,184,300,1320,2257,6,15668,870,0,1
169,3958,1508,847,911,44,250,301,1552,14,148,88,169,162,257,1120,1886,7,15077,837,0,1
10,500,722,423,573,19,0,135,741,12,172,101,199,184,300,1320,2257,6,15668,870,0,1
1,31,2,2,2,0,0,0,2,0,0,0,0,0,0,0,0,0,0,0,0,1
1,31,99,48,90,1,3,5,100,0,0,0,0,0,0,0,0,0,0,0,0,1
1,31,8,5,5,2,0,1,10,0,0,0,0,0,0,0,0,0,0,0,0,1
1,31,1217,716,841,84,126,174,1301,14,185,118,215,199,333,1446,2542,8,20687,1149,0,1
1,31,160,89,115,0,13,31,160,7,15,11,17,22,28,78,124,3,495,27,0,1
1,31,10,10,9,9,0,0,19,0,0,0,0,0,0,0,0,0,0,0,0,1
1,31,173,84,99,8,29,36,181,5,12,7,13,17,20,54,81,2,221,12,0,1
1,31,3,1,1,3,0,0,6,0,0,0,0,0,0,0,0,0,0,0,0,1
46,442,647,139,84,35,284,233,682,0,0,0,0,0,0,0,0,0,0,0,0,1
115,2361,1457,730,1242,11,6,188,1468,10,292,166,329,302,495,2424,4078,5,22973,1276,1,1
115,2361,74,35,59,1,0,14,75,3,14,7,14,17,21,58,85,1,128,7,0,1
115,2361,245,125,200,5,7,34,250,7,30,17,34,37,51,166,265,3,1053,58,0,1
168,3956,722,423,573,19,0,135,741,12,172,101,199,184,300,1320,2257,6,15668,870,0,1
168,3956,1508,847,911,44,250,301,1552,14,148,88,169,162,257,1120,1886,7,15077,837,0,1
171,3366,373,158,315,8,0,51,381,5,76,44,79,81,123,486,779,2,2026,112,0,1
25,1320,652,304,544,16,6,88,668,6,89,51,101,95,152,591,998,3,3399,188,0,1
18,816,334,251,279,10,4,40,344,5,127,74,143,132,217,899,1528,2,4303,239,0,1
115,2364,1457,730,1242,11,6,188,1468,10,292,166,329,302,495,2424,4078,5,22973,1276,1,1
115,2364,74,35,59,1,0,14,75,3,14,7,14,17,21,58,85,1,128,7,0,1
115,2364,245,125,200,5,7,34,250,7,30,17,34,37,51,166,265,3,1053,58,0,1
68,2956,384,251,317,7,8,52,391,11,70,44,84,81,128,467,811,6,5355,297,0,1
194,4305,72,33,56,0,4,12,72,1,1,1,1,2,2,0,2,0,1,0,0,1
194,4305,1454,835,1044,76,110,219,1530,17,275,158,296,292,454,2297,3718,9,34017,1889,1,1
19,975,1289,550,1043,56,32,155,1345,10,167,93,185,177,278,1266,2075,5,11498,638,0,1
109,2197,1457,730,1242,11,6,188,1468,10,292,166,329,302,495,2424,4078,5,22973,1276,1,1
109,2197,74,35,59,1,0,14,75,3,14,7,14,17,21,58,85,1,128,7,0,1
109,2197,245,125,200,5,7,34,250,7,30,17,34,37,51,166,265,3,1053,58,0,1
16,579,1455,414,1257,16,76,112,1471,5,41,23,46,46,69,231,381,2,1069,59,0,1
16,579,669,365,481,22,61,110,691,15,103,63,122,118,185,747,1273,8,11311,628,0,1
51,842,1020,354,843,12,15,144,1032,8,134,77,144,142,221,970,1580,4,6792,377,0,1
186,4076,72,33,56,0,4,12,72,1,1,1,1,2,2,0,2,0,1,0,0,1
186,4076,1454,835,1044,76,110,219,1530,17,275,158,296,292,454,2297,3718,9,34017,1889,1,1
99,2389,1043,504,840,53,9,147,1096,9,180,112,198,189,310,1377,2344,4,11604,644,0,1
99,2389,383,288,292,26,6,62,409,11,65,38,67,76,105,429,656,5,3719,206,0,1
150,3028,373,158,315,8,0,51,381,5,76,44,79,81,123,486,779,2,2026,112,0,1
27,1358,1020,354,843,12,15,144,1032,8,134,77,144,142,221,970,1580,4,6792,377,0,1
25,1029,373,158,315,8,0,51,381,5,76,44,79,81,123,486,779,2,2026,112,0,1
50,2502,1943,715,1694,26,18,214,1969,12,185,120,237,197,357,1436,2721,7,20915,1161,0,1
17,771,334,251,279,10,4,40,344,5,127,74,143,132,217,899,1528,2,4303,239,0,1
111,2192,1457,730,1242,11,6,188,1468,10,292,166,329,302,495,2424,4078,5,22973,1276,1,1
111,2192,74,35,59,1,0,14,75,3,14,7,14,17,21,58,85,1,128,7,0,1
111,2192,245,125,200,5,7,34,250,7,30,17,34,37,51,166,265,3,1053,58,0,1
26,1354,652,304,544,16,6,88,668,6,89,51,101,95,152,591,998,3,3399,188,0,1
51,843,1020,354,843,12,15,144,1032,8,134,77,144,142,221,970,1580,4,6792,377,0,1
186,4083,72,33,56,0,4,12,72,1,1,1,1,2,2,0,2,0,1,0,0,0
186,4083,1454,835,1044,76,110,219,1530,17,275,158,296,292,454,2297,3718,9,34017,1889,1,0
192,4137,72,33,56,0,4,12,72,1,1,1,1,2,2,0,2,0,1,0,0,0
192,4137,1454,835,1044,76,110,219,1530,17,275,158,296,292,454,2297,3718,9,34017,1889,1,0
3,70,442,244,305,14,16,103,456,11,68,45,75,79,120,452,756,6,4588,254,0,1
3,70,182,102,99,11,40,35,193,3,11,6,11,14,17,42,64,1,97,5,0,1
2,105,442,244,305,14,16,103,456,11,68,45,75,79,120,452,756,6,4588,254,0,1
168,3913,722,423,573,19,0,135,741,12,172,101,199,184,300,1320,2257,6,15668,870,0,1
168,3913,1508,847,911,44,250,301,1552,14,148,88,169,162,257,1120,1886,7,15077,837,0,1
1,31,2,2,2,0,0,0,2,0,0,0,0,0,0,0,0,0,0,0,0,0
1,31,99,48,90,1,3,5,100,0,0,0,0,0,0,0,0,0,0,0,0,0
1,31,8,5,5,2,0,1,10,0,0,0,0,0,0,0,0,0,0,0,0,0
1,31,1217,716,841,84,126,174,1301,14,185,118,215,199,333,1446,2542,8,20687,1149,0,0
1,31,160,89,115,0,13,31,160,7,15,11,17,22,28,78,124,3,495,27,0,0
1,31,10,10,9,9,0,0,19,0,0,0,0,0,0,0,0,0,0,0,0,0
1,31,173,84,99,8,29,36,181,5,12,7,13,17,20,54,81,2,221,12,0,0
1,31,3,1,1,3,0,0,6,0,0,0,0,0,0,0,0,0,0,0,0,0
3,88,442,244,305,14,16,103,456,11,68,45,75,79,120,452,756,6,4588,254,0,1
3,88,182,102,99,11,40,35,193,3,11,6,11,14,17,42,64,1,97,5,0,1
2,139,442,244,305,14,16,103,456,11,68,45,75,79,120,452,756,6,4588,254,0,1
151,3035,373,158,315,8,0,51,381,5,76,44,79,81,123,486,779,2,2026,112,0,1
28,1387,1178,367,1042,6,15,115,1184,9,94,51,95,103,146,644,976,4,4439,246,0,1
151,3041,373,158,315,8,0,51,381,5,76,44,79,81,123,486,779,2,2026,112,0,1
116,2264,1457,730,1242,11,6,188,1468,10,292,166,329,302,495,2424,4078,5,22973,1276,1,1
116,2264,74,35,59,1,0,14,75,3,14,7,14,17,21,58,85,1,128,7,0,1
116,2264,245,125,200,5,7,34,250,7,30,17,34,37,51,166,265,3,1053,58,0,1
20,1004,1289,550,1043,56,32,155,1345,10,167,93,185,177,278,1266,2075,5,11498,638,0,1
20,1015,1289,550,1043,56,32,155,1345,10,167,93,185,177,278,1266,2075,5,11498,638,0,0
169,3918,722,423,573,19,0,135,741,12,172,101,199,184,300,1320,2257,6,15668,870,0,1
169,3918,1508,847,911,44,250,301,1552,14,148,88,169,162,257,1120,1886,7,15077,837,0,1
156,3046,373,158,315,8,0,51,381,5,76,44,79,81,123,486,779,2,2026,112,0,1
18,346,127,75,83,2,11,30,129,4,14,7,14,18,21,61,87,2,175,9,0,1
18,346,652,304,544,16,6,88,668,6,89,51,101,95,152,591,998,3,3399,188,0,1
18,346,2,2,2,0,0,0,2,0,0,0,0,0,0,0,0,0,0,0,0,1
18,346,8,5,5,0,0,3,8,0,0,0,0,0,0,0,0,0,0,0,0,1
18,346,14,8,8,0,0,6,14,0,0,0,0,0,0,0,0,0,0,0,0,1
18,346,6,4,4,0,0,2,6,0,0,0,0,0,0,0,0,0,0,0,0,1
18,346,6,4,4,0,0,2,6,1,2,1,2,3,3,2,4,0,2,0,0,1
18,346,7,5,5,0,0,2,7,0,0,0,0,0,0,0,0,0,0,0,0,1
18,346,10,6,6,0,0,4,10,0,0,0,0,0,0,0,0,0,0,0,0,1
18,346,1,1,1,0,0,0,1,0,0,0,0,0,0,0,0,0,0,0,0,1
18,346,14,10,10,0,0,4,14,1,1,1,1,2,2,0,2,0,1,0,0,1
18,346,46,26,30,3,0,12,49,3,6,3,6,9,9,20,28,1,42,2,0,1
44,777,1020,354,843,12,15,144,1032,8,134,77,144,142,221,970,1580,4,6792,377,0,1
169,3902,722,423,573,19,0,135,741,12,172,101,199,184,300,1320,2257,6,15668,870,0,1
169,3902,1508,847,911,44,250,301,1552,14,148,88,169,162,257,1120,1886,7,15077,837,0,1
191,4128,72,33,56,0,4,12,72,1,1,1,1,2,2,0,2,0,1,0,0,1
191,4128,1454,835,1044,76,110,219,1530,17,275,158,296,292,454,2297,3718,9,34017,1889,1,1
100,2392,1043,504,840,53,9,147,1096,9,180,112,198,189,310,1377,2344,4,11604,644,0,1
100,2392,383,288,292,26,6,62,409,11,65,38,67,76,105,429,656,5,3719,206,0,1
152,3008,373,158,315,8,0,51,381,5,76,44,79,81,123,486,779,2,2026,112,0,1
31,1247,1020,354,843,12,15,144,1032,8,134,77,144,142,221,970,1580,4,6792,377,0,1
6,219,1098,241,925,5,10,155,1103,7,46,25,49,53,74,273,423,3,1580,87,0,1
154,3077,373,158,315,8,0,51,381,5,76,44,79,81,123,486,779,2,2026,112,0,1
64,1168,1513,682,1277,25,13,200,1538,11,199,116,219,210,335,1557,2584,6,15641,868,0,1
64,1168,819,519,539,24,98,155,843,15,96,57,106,111,163,690,1107,8,9171,509,0,1
169,3919,722,423,573,19,0,135,741,12,172,101,199,184,300,1320,2257,6,15668,870,0,1
169,3919,1508,847,911,44,250,301,1552,14,148,88,169,162,257,1120,1886,7,15077,837,0,1
133,2578,1943,715,1694,26,18,214,1969,12,185,120,237,197,357,1436,2721,7,20915,1161,0,1
133,2578,1168,838,957,57,25,144,1225,19,348,224,416,367,640,3018,5452,11,61921,3440,1,1
30,524,127,75,83,2,11,30,129,4,14,7,14,18,21,61,87,2,175,9,0,1
30,524,652,304,544,16,6,88,668,6,89,51,101,95,152,591,998,3,3399,188,0,1
30,524,2,2,2,0,0,0,2,0,0,0,0,0,0,0,0,0,0,0,0,1
30,524,8,5,5,0,0,3,8,0,0,0,0,0,0,0,0,0,0,0,0,1
30,524,14,8,8,0,0,6,14,0,0,0,0,0,0,0,0,0,0,0,0,1
30,524,6,4,4,0,0,2,6,0,0,0,0,0,0,0,0,0,0,0,0,1
30,524,6,4,4,0,0,2,6,1,2,1,2,3,3,2,4,0,2,0,0,1
30,524,7,5,5,0,0,2,7,0,0,0,0,0,0,0,0,0,0,0,0,1
30,524,10,6,6,0,0,4,10,0,0,0,0,0,0,0,0,0,0,0,0,1
30,524,1,1,1,0,0,0,1,0,0,0,0,0,0,0,0,0,0,0,0,1
30,524,14,10,10,0,0,4,14,1,1,1,1,2,2,0,2,0,1,0,0,1
30,524,46,26,30,3,0,12,49,3,6,3,6,9,9,20,28,1,42,2,0,1
12,228,127,75,83,2,11,30,129,4,14,7,14,18,21,61,87,2,175,9,0,1
12,228,652,304,544,16,6,88,668,6,89,51,101,95,152,591,998,3,3399,188,0,1
12,228,2,2,2,0,0,0,2,0,0,0,0,0,0,0,0,0,0,0,0,1
12,228,8,5,5,0,0,3,8,0,0,0,0,0,0,0,0,0,0,0,0,1
12,228,14,8,8,0,0,6,14,0,0,0,0,0,0,0,0,0,0,0,0,1
12,228,6,4,4,0,0,2,6,0,0,0,0,0,0,0,0,0,0,0,0,1
12,228,6,4,4,0,0,2,6,1,2,1,2,3,3,2,4,0,2,0,0,1
12,228,7,5,5,0,0,2,7,0,0,0,0,0,0,0,0,0,0,0,0,1
12,228,10,6,6,0,0,4,10,0,0,0,0,0,0,0,0,0,0,0,0,1
12,228,1,1,1,0,0,0,1,0,0,0,0,0,0,0,0,0,0,0,0,1
12,228,14,10,10,0,0,4,14,1,1,1,1,2,2,0,2,0,1,0,0,1
12,228,46,26,30,3,0,12,49,3,6,3,6,9,9,20,28,1,42,2,0,1
1,149,382,65,130,157,2,92,539,4,10,5,10,14,15,41,57,2,114,6,0,1
1,36,2,2,2,0,0,0,2,0,0,0,0,0,0,0,0,0,0,0,0,1
1,36,99,48,90,1,3,5,100,0,0,0,0,0,0,0,0,0,0,0,0,1
1,36,8,5,5,2,0,1,10,0,0,0,0,0,0,0,0,0,0,0,0,1
1,36,1217,716,841,84,126,174,1301,14,185,118,215,199,333,1446,2542,8,20687,1149,0,1
1,36,160,89,115,0,13,31,160,7,15,11,17,22,28,78,124,3,495,27,0,1
1,36,10,10,9,9,0,0,19,0,0,0,0,0,0,0,0,0,0,0,0,1
1,36,173,84,99,8,29,36,181,5,12,7,13,17,20,54,81,2,221,12,0,1
1,36,3,1,1,3,0,0,6,0,0,0,0,0,0,0,0,0,0,0,0,1
132,2527,1457,730,1242,11,6,188,1468,10,292,166,329,302,495,2424,4078,5,22973,1276,1,1
132,2527,74,35,59,1,0,14,75,3,14,7,14,17,21,58,85,1,128,7,0,1
132,2527,245,125,200,5,7,34,250,7,30,17,34,37,51,166,265,3,1053,58,0,1
154,3069,373,158,315,8,0,51,381,5,76,44,79,81,123,486,779,2,2026,112,0,1
20,1015,1289,550,1043,56,32,155,1345,10,167,93,185,177,278,1266,2075,5,11498,638,0,1
32,554,127,75,83,2,11,30,129,4,14,7,14,18,21,61,87,2,175,9,0,1
32,554,652,304,544,16,6,88,668,6,89,51,101,95,152,591,998,3,3399,188,0,1
32,554,2,2,2,0,0,0,2,0,0,0,0,0,0,0,0,0,0,0,0,1
32,554,8,5,5,0,0,3,8,0,0,0,0,0,0,0,0,0,0,0,0,1
32,554,14,8,8,0,0,6,14,0,0,0,0,0,0,0,0,0,0,0,0,1
32,554,6,4,4,0,0,2,6,0,0,0,0,0,0,0,0,0,0,0,0,1
32,554,6,4,4,0,0,2,6,1,2,1,2,3,3,2,4,0,2,0,0,1
32,554,7,5,5,0,0,2,7,0,0,0,0,0,0,0,0,0,0,0,0,1
32,554,10,6,6,0,0,4,10,0,0,0,0,0,0,0,0,0,0,0,0,1
32,554,1,1,1,0,0,0,1,0,0,0,0,0,0,0,0,0,0,0,0,1
32,554,14,10,10,0,0,4,14,1,1,1,1,2,2,0,2,0,1,0,0,1
32,554,46,26,30,3,0,12,49,3,6,3,6,9,9,20,28,1,42,2,0,1
20,1267,1457,730,1242,11,6,188,1468,10,292,166,329,302,495,2424,4078,5,22973,1276,1,1
124,2402,1457,730,1242,11,6,188,1468,10,292,166,329,302,495,2424,4078,5,22973,1276,1,1
124,2402,74,35,59,1,0,14,75,3,14,7,14,17,21,58,85,1,128,7,0,1
124,2402,245,125,200,5,7,34,250,7,30,17,34,37,51,166,265,3,1053,58,0,1
33,864,74,35,59,1,0,14,75,3,14,7,14,17,21,58,85,1,128,7,0,1
33,864,245,125,200,5,7,34,250,7,30,17,34,37,51,166,265,3,1053,58,0,1
170,3938,722,423,573,19,0,135,741,12,172,101,199,184,300,1320,2257,6,15668,870,0,1
170,3938,1508,847,911,44,250,301,1552,14,148,88,169,162,257,1120,1886,7,15077,837,0,1
7,230,74,35,59,1,0,14,75,3,14,7,14,17,21,58,85,1,128,7,0,1
17,1016,1457,730,1242,11,6,188,1468,10,292,166,329,302,495,2424,4078,5,22973,1276,1,1
128,2500,1457,730,1242,11,6,188,1468,10,292,166,329,302,495,2424,4078,5,22973,1276,1,1
128,2500,74,35,59,1,0,14,75,3,14,7,14,17,21,58,85,1,128,7,0,1
128,2500,245,125,200,5,7,34,250,7,30,17,34,37,51,166,265,3,1053,58,0,1
33,859,74,35,59,1,0,14,75,3,14,7,14,17,21,58,85,1,128,7,0,1
33,859,245,125,200,5,7,34,250,7,30,17,34,37,51,166,265,3,1053,58,0,1
18,834,334,251,279,10,4,40,344,5,127,74,143,132,217,899,1528,2,4303,239,0,1
1,80,13,10,10,0,0,3,13,1,2,1,2,3,3,2,4,0,2,0,0,1
133,2609,1457,730,1242,11,6,188,1468,10,292,166,329,302,495,2424,4078,5,22973,1276,1,1
133,2609,74,35,59,1,0,14,75,3,14,7,14,17,21,58,85,1,128,7,0,1
133,2609,245,125,200,5,7,34,250,7,30,17,34,37,51,166,265,3,1053,58,0,1
33,844,74,35,59,1,0,14,75,3,14,7,14,17,21,58,85,1,128,7,0,1
33,844,245,125,200,5,7,34,250,7,30,17,34,37,51,166,265,3,1053,58,0,1
172,3985,722,423,573,19,0,135,741,12,172,101,199,184,300,1320,2257,6,15668,870,0,1
172,3985,1508,847,911,44,250,301,1552,14,148,88,169,162,257,1120,1886,7,15077,837,0,1
154,3068,373,158,315,8,0,51,381,5,76,44,79,81,123,486,779,2,2026,112,0,1
32,536,127,75,83,2,11,30,129,4,14,7,14,18,21,61,87,2,175,9,0,1
32,536,652,304,544,16,6,88,668,6,89,51,101,95,152,591,998,3,3399,188,0,1
32,536,2,2,2,0,0,0,2,0,0,0,0,0,0,0,0,0,0,0,0,1
32,536,8,5,5,0,0,3,8,0,0,0,0,0,0,0,0,0,0,0,0,1
32,536,14,8,8,0,0,6,14,0,0,0,0,0,0,0,0,0,0,0,0,1
32,536,6,4,4,0,0,2,6,0,0,0,0,0,0,0,0,0,0,0,0,1
32,536,6,4,4,0,0,2,6,1,2,1,2,3,3,2,4,0,2,0,0,1
32,536,7,5,5,0,0,2,7,0,0,0,0,0,0,0,0,0,0,0,0,1
32,536,10,6,6,0,0,4,10,0,0,0,0,0,0,0,0,0,0,0,0,1
32,536,1,1,1,0,0,0,1,0,0,0,0,0,0,0,0,0,0,0,0,1
32,536,14,10,10,0,0,4,14,1,1,1,1,2,2,0,2,0,1,0,0,1
32,536,46,26,30,3,0,12,49,3,6,3,6,9,9,20,28,1,42,2,0,1
7,163,127,75,83,2,11,30,129,4,14,7,14,18,21,61,87,2,175,9,0,1
7,163,652,304,544,16,6,88,668,6,89,51,101,95,152,591,998,3,3399,188,0,1
7,163,2,2,2,0,0,0,2,0,0,0,0,0,0,0,0,0,0,0,0,1
7,163,8,5,5,0,0,3,8,0,0,0,0,0,0,0,0,0,0,0,0,1
7,163,14,8,8,0,0,6,14,0,0,0,0,0,0,0,0,0,0,0,0,1
7,163,6,4,4,0,0,2,6,0,0,0,0,0,0,0,0,0,0,0,0,1
7,163,6,4,4,0,0,2,6,1,2,1,2,3,3,2,4,0,2,0,0,1
7,163,7,5,5,0,0,2,7,0,0,0,0,0,0,0,0,0,0,0,0,1
7,163,10,6,6,0,0,4,10,0,0,0,0,0,0,0,0,0,0,0,0,1
7,163,1,1,1,0,0,0,1,0,0,0,0,0,0,0,0,0,0,0,0,1
7,163,14,10,10,0,0,4,14,1,1,1,1,2,2,0,2,0,1,0,0,1
7,163,46,26,30,3,0,12,49,3,6,3,6,9,9,20,28,1,42,2,0,1
19,1151,1457,730,1242,11,6,188,1468,10,292,166,329,302,495,2424,4078,5,22973,1276,1,1
17,775,334,251,279,10,4,40,344,5,127,74,143,132,217,899,1528,2,4303,239,0,1
133,2600,1457,730,1242,11,6,188,1468,10,292,166,329,302,495,2424,4078,5,22973,1276,1,1
133,2600,74,35,59,1,0,14,75,3,14,7,14,17,21,58,85,1,128,7,0,1
133,2600,245,125,200,5,7,34,250,7,30,17,34,37,51,166,265,3,1053,58,0,1
175,4013,722,423,573,19,0,135,741,12,172,101,199,184,300,1320,2257,6,15668,870,0,1
175,4013,1508,847,911,44,250,301,1552,14,148,88,169,162,257,1120,1886,7,15077,837,0,1
151,3042,373,158,315,8,0,51,381,5,76,44,79,81,123,486,779,2,2026,112,0,1
1,36,2,2,2,0,0,0,2,0,0,0,0,0,0,0,0,0,0,0,0,0
1,36,99,48,90,1,3,5,100,0,0,0,0,0,0,0,0,0,0,0,0,0
1,36,8,5,5,2,0,1,10,0,0,0,0,0,0,0,0,0,0,0,0,0
1,36,1217,716,841,84,126,174,1301,14,185,118,215,199,333,1446,2542,8,20687,1149,0,0
1,36,160,89,115,0,13,31,160,7,15,11,17,22,28,78,124,3,495,27,0,0
1,36,10,10,9,9,0,0,19,0,0,0,0,0,0,0,0,0,0,0,0,0
1,36,173,84,99,8,29,36,181,5,12,7,13,17,20,54,81,2,221,12,0,0
1,36,3,1,1,3,0,0,6,0,0,0,0,0,0,0,0,0,0,0,0,0
1,149,382,65,130,157,2,92,539,4,10,5,10,14,15,41,57,2,114,6,0,0
12,228,127,75,83,2,11,30,129,4,14,7,14,18,21,61,87,2,175,9,0,0
12,228,652,304,544,16,6,88,668,6,89,51,101,95,152,591,998,3,3399,188,0,0
12,228,2,2,2,0,0,0,2,0,0,0,0,0,0,0,0,0,0,0,0,0
12,228,8,5,5,0,0,3,8,0,0,0,0,0,0,0,0,0,0,0,0,0
12,228,14,8,8,0,0,6,14,0,0,0,0,0,0,0,0,0,0,0,0,0
12,228,6,4,4,0,0,2,6,0,0,0,0,0,0,0,0,0,0,0,0,0
12,228,6,4,4,0,0,2,6,1,2,1,2,3,3,2,4,0,2,0,0,0
12,228,7,5,5,0,0,2,7,0,0,0,0,0,0,0,0,0,0,0,0,0
12,228,10,6,6,0,0,4,10,0,0,0,0,0,0,0,0,0,0,0,0,0
12,228,1,1,1,0,0,0,1,0,0,0,0,0,0,0,0,0,0,0,0,0
12,228,14,10,10,0,0,4,14,1,1,1,1,2,2,0,2,0,1,0,0,0
12,228,46,26,30,3,0,12,49,3,6,3,6,9,9,20,28,1,42,2,0,0
1,80,13,10,10,0,0,3,13,1,2,1,2,3,3,2,4,0,2,0,0,0
133,2600,1457,730,1242,11,6,188,1468,10,292,166,329,302,495,2424,4078,5,22973,1276,1,0
133,2600,74,35,59,1,0,14,75,3,14,7,14,17,21,58,85,1,128,7,0,0
133,2600,245,125,200,5,7,34,250,7,30,17,34,37,51,166,265,3,1053,58,0,0
33,844,74,35,59,1,0,14,75,3,14,7,14,17,21,58,85,1,128,7,0,0
33,844,245,125,200,5,7,34,250,7,30,17,34,37,51,166,265,3,1053,58,0,0
175,4013,722,423,573,19,0,135,741,12,172,101,199,184,300,1320,2257,6,15668,870,0,0
175,4013,1508,847,911,44,250,301,1552,14,148,88,169,162,257,1120,1886,7,15077,837,0,0
151,3042,373,158,315,8,0,51,381,5,76,44,79,81,123,486,779,2,2026,112,0,0
32,536,127,75,83,2,11,30,129,4,14,7,14,18,21,61,87,2,175,9,0,0
32,536,652,304,544,16,6,88,668,6,89,51,101,95,152,591,998,3,3399,188,0,0
32,536,2,2,2,0,0,0,2,0,0,0,0,0,0,0,0,0,0,0,0,0
32,536,8,5,5,0,0,3,8,0,0,0,0,0,0,0,0,0,0,0,0,0
32,536,14,8,8,0,0,6,14,0,0,0,0,0,0,0,0,0,0,0,0,0
32,536,6,4,4,0,0,2,6,0,0,0,0,0,0,0,0,0,0,0,0,0
32,536,6,4,4,0,0,2,6,1,2,1,2,3,3,2,4,0,2,0,0,0
32,536,7,5,5,0,0,2,7,0,0,0,0,0,0,0,0,0,0,0,0,0
32,536,10,6,6,0,0,4,10,0,0,0,0,0,0,0,0,0,0,0,0,0
32,536,1,1,1,0,0,0,1,0,0,0,0,0,0,0,0,0,0,0,0,0
32,536,14,10,10,0,0,4,14,1,1,1,1,2,2,0,2,0,1,0,0,0
32,536,46,26,30,3,0,12,49,3,6,3,6,9,9,20,28,1,42,2,0,0
7,163,127,75,83,2,11,30,129,4,14,7,14,18,21,61,87,2,175,9,0,0
7,163,652,304,544,16,6,88,668,6,89,51,101,95,152,591,998,3,3399,188,0,0
7,163,2,2,2,0,0,0,2,0,0,0,0,0,0,0,0,0,0,0,0,0
7,163,8,5,5,0,0,3,8,0,0,0,0,0,0,0,0,0,0,0,0,0
7,163,14,8,8,0,0,6,14,0,0,0,0,0,0,0,0,0,0,0,0,0
7,163,6,4,4,0,0,2,6,0,0,0,0,0,0,0,0,0,0,0,0,0
7,163,6,4,4,0,0,2,6,1,2,1,2,3,3,2,4,0,2,0,0,0
7,163,7,5,5,0,0,2,7,0,0,0,0,0,0,0,0,0,0,0,0,0
7,163,10,6,6,0,0,4,10,0,0,0,0,0,0,0,0,0,0,0,0,0
7,163,1,1,1,0,0,0,1,0,0,0,0,0,0,0,0,0,0,0,0,0
7,163,14,10,10,0,0,4,14,1,1,1,1,2,2,0,2,0,1,0,0,0
7,163,46,26,30,3,0,12,49,3,6,3,6,9,9,20,28,1,42,2,0,0
7,230,74,35,59,1,0,14,75,3,14,7,14,17,21,58,85,1,128,7,0,0
50,2502,1943,715,1694,26,18,214,1969,12,185,120,237,197,357,1436,2721,7,20915,1161,0,0
19,1151,1457,730,1242,11,6,188,1468,10,292,166,329,302,495,2424,4078,5,22973,1276,1,0
17,775,334,251,279,10,4,40,344,5,127,74,143,132,217,899,1528,2,4303,239,0,0
67,2915,384,251,317,7,8,52,391,11,70,44,84,81,128,467,811,6,5355,297,0,0
7,224,74,35,59,1,0,14,75,3,14,7,14,17,21,58,85,1,128,7,0,1
68,2994,384,251,317,7,8,52,391,11,70,44,84,81,128,467,811,6,5355,297,0,1
33,848,74,35,59,1,0,14,75,3,14,7,14,17,21,58,85,1,128,7,0,0
33,848,245,125,200,5,7,34,250,7,30,17,34,37,51,166,265,3,1053,58,0,0
138,2686,1943,715,1694,26,18,214,1969,12,185,120,237,197,357,1436,2721,7,20915,1161,0,1
138,2686,1168,838,957,57,25,144,1225,19,348,224,416,367,640,3018,5452,11,61921,3440,1,1
51,2576,1943,715,1694,26,18,214,1969,12,185,120,237,197,357,1436,2721,7,20915,1161,0,1
191,4124,72,33,56,0,4,12,72,1,1,1,1,2,2,0,2,0,1,0,0,1
191,4124,1454,835,1044,76,110,219,1530,17,275,158,296,292,454,2297,3718,9,34017,1889,1,1
69,1131,1178,367,1042,6,15,115,1184,9,94,51,95,103,146,644,976,4,4439,246,0,1
69,1131,177,108,140,8,0,27,185,6,30,16,32,36,48,162,248,3,794,44,0,1
138,2682,1943,715,1694,26,18,214,1969,12,185,120,237,197,357,1436,2721,7,20915,1161,0,1
138,2682,1168,838,957,57,25,144,1225,19,348,224,416,367,640,3018,5452,11,61921,3440,1,1
50,2539,1943,715,1694,26,18,214,1969,12,185,120,237,197,357,1436,2721,7,20915,1161,0,1
150,3013,373,158,315,8,0,51,381,5,76,44,79,81,123,486,779,2,2026,112,0,1
149,3000,373,158,315,8,0,51,381,5,76,44,79,81,123,486,779,2,2026,112,0,0
68,2994,384,251,317,7,8,52,391,11,70,44,84,81,128,467,811,6,5355,297,0,0
175,4016,722,423,573,19,0,135,741,12,172,101,199,184,300,1320,2257,6,15668,870,0,1
175,4016,1508,847,911,44,250,301,1552,14,148,88,169,162,257,1120,1886,7,15077,837,0,1
149,2995,373,158,315,8,0,51,381,5,76,44,79,81,123,486,779,2,2026,112,0,1
135,2619,1457,730,1242,11,6,188,1468,10,292,166,329,302,495,2424,4078,5,22973,1276,1,0
135,2619,74,35,59,1,0,14,75,3,14,7,14,17,21,58,85,1,128,7,0,0
135,2619,245,125,200,5,7,34,250,7,30,17,34,37,51,166,265,3,1053,58,0,0
21,1047,1289,550,1043,56,32,155,1345,10,167,93,185,177,278,1266,2075,5,11498,638,0,0
20,1175,1457,730,1242,11,6,188,1468,10,292,166,329,302,495,2424,4078,5,22973,1276,1,0
136,2631,1457,730,1242,11,6,188,1468,10,292,166,329,302,495,2424,4078,5,22973,1276,1,1
136,2631,74,35,59,1,0,14,75,3,14,7,14,17,21,58,85,1,128,7,0,1
136,2631,245,125,200,5,7,34,250,7,30,17,34,37,51,166,265,3,1053,58,0,1
20,1203,1457,730,1242,11,6,188,1468,10,292,166,329,302,495,2424,4078,5,22973,1276,1,1
68,2996,384,251,317,7,8,52,391,11,70,44,84,81,128,467,811,6,5355,297,0,0
191,4126,72,33,56,0,4,12,72,1,1,1,1,2,2,0,2,0,1,0,0,1
191,4126,1454,835,1044,76,110,219,1530,17,275,158,296,292,454,2297,3718,9,34017,1889,1,1
17,267,1098,241,925,5,10,155,1103,7,46,25,49,53,74,273,423,3,1580,87,0,1
17,267,282,202,222,14,2,44,296,8,42,24,43,50,67,250,378,4,1548,86,0,1
7,249,1098,241,925,5,10,155,1103,7,46,25,49,53,74,273,423,3,1580,87,0,1
1,151,382,65,130,157,2,92,539,4,10,5,10,14,15,41,57,2,114,6,0,1
50,2531,1943,715,1694,26,18,214,1969,12,185,120,237,197,357,1436,2721,7,20915,1161,0,0
45,430,647,139,84,35,284,233,682,0,0,0,0,0,0,0,0,0,0,0,0,1
17,295,424,94,331,4,0,89,428,1,5,5,5,6,10,11,25,0,12,0,0,1
17,295,38,23,23,6,0,8,44,3,11,7,11,14,18,42,68,1,102,5,0,1
193,4179,72,33,56,0,4,12,72,1,1,1,1,2,2,0,2,0,1,0,0,1
193,4179,1454,835,1044,76,110,219,1530,17,275,158,296,292,454,2297,3718,9,34017,1889,1,1
100,2387,1043,504,840,53,9,147,1096,9,180,112,198,189,310,1377,2344,4,11604,644,0,1
100,2387,383,288,292,26,6,62,409,11,65,38,67,76,105,429,656,5,3719,206,0,1
148,2983,373,158,315,8,0,51,381,5,76,44,79,81,123,486,779,2,2026,112,0,1
23,990,373,158,315,8,0,51,381,5,76,44,79,81,123,486,779,2,2026,112,0,1
50,2526,1943,715,1694,26,18,214,1969,12,185,120,237,197,357,1436,2721,7,20915,1161,0,1
136,2682,1457,730,1242,11,6,188,1468,10,292,166,329,302,495,2424,4078,5,22973,1276,1,1
136,2682,74,35,59,1,0,14,75,3,14,7,14,17,21,58,85,1,128,7,0,1
136,2682,245,125,200,5,7,34,250,7,30,17,34,37,51,166,265,3,1053,58,0,1
34,867,74,35,59,1,0,14,75,3,14,7,14,17,21,58,85,1,128,7,0,1
34,867,245,125,200,5,7,34,250,7,30,17,34,37,51,166,265,3,1053,58,0,1
148,2991,373,158,315,8,0,51,381,5,76,44,79,81,123,486,779,2,2026,112,0,1
21,1272,1457,730,1242,11,6,188,1468,10,292,166,329,302,495,2424,4078,5,22973,1276,1,1
1,148,382,65,130,157,2,92,539,4,10,5,10,14,15,41,57,2,114,6,0,1
12,230,127,75,83,2,11,30,129,4,14,7,14,18,21,61,87,2,175,9,0,1
12,230,652,304,544,16,6,88,668,6,89,51,101,95,152,591,998,3,3399,188,0,1
12,230,2,2,2,0,0,0,2,0,0,0,0,0,0,0,0,0,0,0,0,1
12,230,8,5,5,0,0,3,8,0,0,0,0,0,0,0,0,0,0,0,0,1
12,230,14,8,8,0,0,6,14,0,0,0,0,0,0,0,0,0,0,0,0,1
12,230,6,4,4,0,0,2,6,0,0,0,0,0,0,0,0,0,0,0,0,1
12,230,6,4,4,0,0,2,6,1,2,1,2,3,3,2,4,0,2,0,0,1
12,230,7,5,5,0,0,2,7,0,0,0,0,0,0,0,0,0,0,0,0,1
12,230,10,6,6,0,0,4,10,0,0,0,0,0,0,0,0,0,0,0,0,1
12,230,1,1,1,0,0,0,1,0,0,0,0,0,0,0,0,0,0,0,0,1
12,230,14,10,10,0,0,4,14,1,1,1,1,2,2,0,2,0,1,0,0,1
12,230,46,26,30,3,0,12,49,3,6,3,6,9,9,20,28,1,42,2,0,1
204,4492,72,33,56,0,4,12,72,1,1,1,1,2,2,0,2,0,1,0,0,1
204,4492,1454,835,1044,76,110,219,1530,17,275,158,296,292,454,2297,3718,9,34017,1889,1,1
87,1972,1043,504,840,53,9,147,1096,9,180,112,198,189,310,1377,2344,4,11604,644,0,1
87,1972,383,288,292,26,6,62,409,11,65,38,67,76,105,429,656,5,3719,206,0,1
148,3003,373,158,315,8,0,51,381,5,76,44,79,81,123,486,779,2,2026,112,0,1
71,1178,1178,367,1042,6,15,115,1184,9,94,51,95,103,146,644,976,4,4439,246,0,1
71,1178,177,108,140,8,0,27,185,6,30,16,32,36,48,162,248,3,794,44,0,1
36,1462,1043,504,840,53,9,147,1096,9,180,112,198,189,310,1377,2344,4,11604,644,0,1
138,2702,1457,730,1242,11,6,188,1468,10,292,166,329,302,495,2424,4078,5,22973,1276,1,1
138,2702,74,35,59,1,0,14,75,3,14,7,14,17,21,58,85,1,128,7,0,1
138,2702,245,125,200,5,7,34,250,7,30,17,34,37,51,166,265,3,1053,58,0,1
22,1337,1457,730,1242,11,6,188,1468,10,292,166,329,302,495,2424,4078,5,22973,1276,1,1
138,2713,1457,730,1242,11,6,188,1468,10,292,166,329,302,495,2424,4078,5,22973,1276,1,0
138,2713,74,35,59,1,0,14,75,3,14,7,14,17,21,58,85,1,128,7,0,0
138,2713,245,125,200,5,7,34,250,7,30,17,34,37,51,166,265,3,1053,58,0,0
137,2714,1457,730,1242,11,6,188,1468,10,292,166,329,302,495,2424,4078,5,22973,1276,1,1
137,2714,74,35,59,1,0,14,75,3,14,7,14,17,21,58,85,1,128,7,0,1
137,2714,245,125,200,5,7,34,250,7,30,17,34,37,51,166,265,3,1053,58,0,1
137,2686,1943,715,1694,26,18,214,1969,12,185,120,237,197,357,1436,2721,7,20915,1161,0,1
137,2686,1168,838,957,57,25,144,1225,19,348,224,416,367,640,3018,5452,11,61921,3440,1,1
51,2570,1943,715,1694,26,18,214,1969,12,185,120,237,197,357,1436,2721,7,20915,1161,0,1
23,1388,1457,730,1242,11,6,188,1468,10,292,166,329,302,495,2424,4078,5,22973,1276,1,1
72,3397,384,251,317,7,8,52,391,11,70,44,84,81,128,467,811,6,5355,297,0,1
125,2558,77,34,69,0,0,8,77,3,24,16,29,27,45,114,213,1,387,21,0,1
125,2558,712,438,573,51,9,84,763,14,102,71,128,116,199,733,1364,8,11988,666,0,1
177,4051,722,423,573,19,0,135,741,12,172,101,199,184,300,1320,2257,6,15668,870,0,1
177,4051,1508,847,911,44,250,301,1552,14,148,88,169,162,257,1120,1886,7,15077,837,0,1
28,1309,1289,550,1043,56,32,155,1345,10,167,93,185,177,278,1266,2075,5,11498,638,0,1
72,3397,77,34,69,0,0,8,77,3,24,16,29,27,45,114,213,1,387,21,0,1
126,2604,77,34,69,0,0,8,77,3,24,16,29,27,45,114,213,1,387,21,0,1
126,2604,712,438,573,51,9,84,763,14,102,71,128,116,199,733,1364,8,11988,666,0,1
74,3546,77,34,69,0,0,8,77,3,24,16,29,27,45,114,213,1,387,21,0,1
128,2662,77,34,69,0,0,8,77,3,24,16,29,27,45,114,213,1,387,21,0,1
128,2662,712,438,573,51,9,84,763,14,102,71,128,116,199,733,1364,8,11988,666,0,1
65,1174,1513,682,1277,25,13,200,1538,11,199,116,219,210,335,1557,2584,6,15641,868,0,1
65,1174,819,519,539,24,98,155,843,15,96,57,106,111,163,690,1107,8,9171,509,0,1
137,2716,1457,730,1242,11,6,188,1468,10,292,166,329,302,495,2424,4078,5,22973,1276,1,1
137,2716,74,35,59,1,0,14,75,3,14,7,14,17,21,58,85,1,128,7,0,1
137,2716,245,125,200,5,7,34,250,7,30,17,34,37,51,166,265,3,1053,58,0,1
16,578,1455,414,1257,16,76,112,1471,5,41,23,46,46,69,231,381,2,1069,59,0,1
16,578,669,365,481,22,61,110,691,15,103,63,122,118,185,747,1273,8,11311,628,0,1
37,1041,1523,757,1297,19,12,193,1542,12,193,117,230,205,347,1508,2664,7,19053,1058,0,1
37,1041,701,378,504,33,58,109,734,13,110,68,126,123,194,794,1346,7,10027,557,0,1
177,4149,722,423,573,19,0,135,741,12,172,101,199,184,300,1320,2257,6,15668,870,0,1
177,4149,1508,847,911,44,250,301,1552,14,148,88,169,162,257,1120,1886,7,15077,837,0,1
205,4488,72,33,56,0,4,12,72,1,1,1,1,2,2,0,2,0,1,0,0,1
205,4488,1454,835,1044,76,110,219,1530,17,275,158,296,292,454,2297,3718,9,34017,1889,1,1
84,1800,1043,504,840,53,9,147,1096,9,180,112,198,189,310,1377,2344,4,11604,644,0,1
84,1800,383,288,292,26,6,62,409,11,65,38,67,76,105,429,656,5,3719,206,0,1
125,2880,373,158,315,8,0,51,381,5,76,44,79,81,123,486,779,2,2026,112,0,1
137,2668,1943,715,1694,26,18,214,1969,12,185,120,237,197,357,1436,2721,7,20915,1161,0,1
137,2668,1168,838,957,57,25,144,1225,19,348,224,416,367,640,3018,5452,11,61921,3440,1,1
30,1389,1289,550,1043,56,32,155,1345,10,167,93,185,177,278,1266,2075,5,11498,638,0,1
19,1390,1523,757,1297,19,12,193,1542,12,193,117,230,205,347,1508,2664,7,19053,1058,0,1
36,1466,1043,504,840,53,9,147,1096,9,180,112,198,189,310,1377,2344,4,11604,644,0,1
23,996,373,158,315,8,0,51,381,5,76,44,79,81,123,486,779,2,2026,112,0,1
40,2822,1296,573,1062,40,33,157,1336,8,201,118,231,209,349,1561,2689,4,12365,686,0,1
44,888,1450,624,1228,12,26,181,1462,14,306,186,354,320,540,2580,4493,8,36391,2021,1,1
137,2717,1457,730,1242,11,6,188,1468,10,292,166,329,302,495,2424,4078,5,22973,1276,1,1
137,2717,74,35,59,1,0,14,75,3,14,7,14,17,21,58,85,1,128,7,0,1
137,2717,245,125,200,5,7,34,250,7,30,17,34,37,51,166,265,3,1053,58,0,1
24,514,447,308,343,6,5,95,453,7,96,59,111,103,170,651,1136,4,4600,255,0,1
24,514,322,174,179,16,74,51,338,10,41,26,46,51,72,252,408,5,2291,127,0,1
20,483,1293,570,1093,25,15,163,1318,10,195,123,241,205,364,1516,2795,6,17273,959,0,1
18,462,386,256,301,16,9,68,402,4,59,35,69,63,104,355,621,2,1453,80,0,1
18,462,264,131,164,11,41,46,275,6,38,22,40,44,62,214,338,3,1068,59,0,1
26,554,215,129,180,6,0,29,221,8,65,43,72,73,115,415,711,4,3153,175,0,1
26,554,97,69,77,3,3,16,100,6,22,13,23,28,36,113,173,3,542,30,0,1
129,2662,77,34,69,0,0,8,77,3,24,16,29,27,45,114,213,1,387,21,0,0
129,2662,712,438,573,51,9,84,763,14,102,71,128,116,199,733,1364,8,11988,666,0,0
130,2666,77,34,69,0,0,8,77,3,24,16,29,27,45,114,213,1,387,21,0,0
130,2666,712,438,573,51,9,84,763,14,102,71,128,116,199,733,1364,8,11988,666,0,0
75,3605,77,34,69,0,0,8,77,3,24,16,29,27,45,114,213,1,387,21,0,0
130,2674,77,34,69,0,0,8,77,3,24,16,29,27,45,114,213,1,387,21,0,0
130,2674,712,438,573,51,9,84,763,14,102,71,128,116,199,733,1364,8,11988,666,0,0
130,2988,373,158,315,8,0,51,381,5,76,44,79,81,123,486,779,2,2026,112,0,1
32,1512,1289,550,1043,56,32,155,1345,10,167,93,185,177,278,1266,2075,5,11498,638,0,1
132,2708,77,34,69,0,0,8,77,3,24,16,29,27,45,114,213,1,387,21,0,1
132,2708,712,438,573,51,9,84,763,14,102,71,128,116,199,733,1364,8,11988,666,0,1
43,866,1450,624,1228,12,26,181,1462,14,306,186,354,320,540,2580,4493,8,36391,2021,1,1
206,4499,72,33,56,0,4,12,72,1,1,1,1,2,2,0,2,0,1,0,0,1
206,4499,1454,835,1044,76,110,219,1530,17,275,158,296,292,454,2297,3718,9,34017,1889,1,1
17,270,1098,241,925,5,10,155,1103,7,46,25,49,53,74,273,423,3,1580,87,0,1
17,270,282,202,222,14,2,44,296,8,42,24,43,50,67,250,378,4,1548,86,0,1
33,1559,1289,550,1043,56,32,155,1345,10,167,93,185,177,278,1266,2075,5,11498,638,0,1
27,949,1450,624,1228,12,26,181,1462,14,306,186,354,320,540,2580,4493,8,36391,2021,1,1
131,3030,373,158,315,8,0,51,381,5,76,44,79,81,123,486,779,2,2026,112,0,1
33,1567,1289,550,1043,56,32,155,1345,10,167,93,185,177,278,1266,2075,5,11498,638,0,1
26,920,1450,624,1228,12,26,181,1462,14,306,186,354,320,540,2580,4493,8,36391,2021,1,1
41,2892,1296,573,1062,40,33,157,1336,8,201,118,231,209,349,1561,2689,4,12365,686,0,1
139,2720,1457,730,1242,11,6,188,1468,10,292,166,329,302,495,2424,4078,5,22973,1276,1,0
139,2720,74,35,59,1,0,14,75,3,14,7,14,17,21,58,85,1,128,7,0,0
139,2720,245,125,200,5,7,34,250,7,30,17,34,37,51,166,265,3,1053,58,0,0
33,1569,1289,550,1043,56,32,155,1345,10,167,93,185,177,278,1266,2075,5,11498,638,0,0
132,2720,77,34,69,0,0,8,77,3,24,16,29,27,45,114,213,1,387,21,0,0
132,2720,712,438,573,51,9,84,763,14,102,71,128,116,199,733,1364,8,11988,666,0,0
131,3034,373,158,315,8,0,51,381,5,76,44,79,81,123,486,779,2,2026,112,0,0
19,284,1098,241,925,5,10,155,1103,7,46,25,49,53,74,273,423,3,1580,87,0,0
19,284,282,202,222,14,2,44,296,8,42,24,43,50,67,250,378,4,1548,86,0,0
33,1595,1289,550,1043,56,32,155,1345,10,167,93,185,177,278,1266,2075,5,11498,638,0,0
41,2882,1296,573,1062,40,33,157,1336,8,201,118,231,209,349,1561,2689,4,12365,686,0,0
24,1442,1457,730,1242,11,6,188,1468,10,292,166,329,302,495,2424,4078,5,22973,1276,1,0
131,3031,373,158,315,8,0,51,381,5,76,44,79,81,123,486,779,2,2026,112,0,1
33,1606,1289,550,1043,56,32,155,1345,10,167,93,185,177,278,1266,2075,5,11498,638,0,0
138,3144,373,158,315,8,0,51,381,5,76,44,79,81,123,486,779,2,2026,112,0,1
138,2675,1943,715,1694,26,18,214,1969,12,185,120,237,197,357,1436,2721,7,20915,1161,0,1
138,2675,1168,838,957,57,25,144,1225,19,348,224,416,367,640,3018,5452,11,61921,3440,1,1
41,2894,1296,573,1062,40,33,157,1336,8,201,118,231,209,349,1561,2689,4,12365,686,0,1
37,1039,1523,757,1297,19,12,193,1542,12,193,117,230,205,347,1508,2664,7,19053,1058,0,1
37,1039,701,378,504,33,58,109,734,13,110,68,126,123,194,794,1346,7,10027,557,0,1
130,3030,373,158,315,8,0,51,381,5,76,44,79,81,123,486,779,2,2026,112,0,1
133,2756,77,34,69,0,0,8,77,3,24,16,29,27,45,114,213,1,387,21,0,1
133,2756,712,438,573,51,9,84,763,14,102,71,128,116,199,733,1364,8,11988,666,0,1
141,2754,1457,730,1242,11,6,188,1468,10,292,166,329,302,495,2424,4078,5,22973,1276,1,1
141,2754,74,35,59,1,0,14,75,3,14,7,14,17,21,58,85,1,128,7,0,1
141,2754,245,125,200,5,7,34,250,7,30,17,34,37,51,166,265,3,1053,58,0,1
34,866,74,35,59,1,0,14,75,3,14,7,14,17,21,58,85,1,128,7,0,1
34,866,245,125,200,5,7,34,250,7,30,17,34,37,51,166,265,3,1053,58,0,1
51,2564,1943,715,1694,26,18,214,1969,12,185,120,237,197,357,1436,2721,7,20915,1161,0,1
26,1597,1457,730,1242,11,6,188,1468,10,292,166,329,302,495,2424,4078,5,22973,1276,1,1
133,2758,77,34,69,0,0,8,77,3,24,16,29,27,45,114,213,1,387,21,0,0
133,2758,712,438,573,51,9,84,763,14,102,71,128,116,199,733,1364,8,11988,666,0,0
19,1390,1523,757,1297,19,12,193,1542,12,193,117,230,205,347,1508,2664,7,19053,1058,0,0
177,4157,722,423,573,19,0,135,741,12,172,101,199,184,300,1320,2257,6,15668,870,0,0
177,4157,1508,847,911,44,250,301,1552,14,148,88,169,162,257,1120,1886,7,15077,837,0,0
12,222,127,75,83,2,11,30,129,4,14,7,14,18,21,61,87,2,175,9,0,1
12,222,652,304,544,16,6,88,668,6,89,51,101,95,152,591,998,3,3399,188,0,1
12,222,2,2,2,0,0,0,2,0,0,0,0,0,0,0,0,0,0,0,0,1
12,222,8,5,5,0,0,3,8,0,0,0,0,0,0,0,0,0,0,0,0,1
12,222,14,8,8,0,0,6,14,0,0,0,0,0,0,0,0,0,0,0,0,1
12,222,6,4,4,0,0,2,6,0,0,0,0,0,0,0,0,0,0,0,0,1
12,222,6,4,4,0,0,2,6,1,2,1,2,3,3,2,4,0,2,0,0,1
12,222,7,5,5,0,0,2,7,0,0,0,0,0,0,0,0,0,0,0,0,1
12,222,10,6,6,0,0,4,10,0,0,0,0,0,0,0,0,0,0,0,0,1
12,222,1,1,1,0,0,0,1,0,0,0,0,0,0,0,0,0,0,0,0,1
12,222,14,10,10,0,0,4,14,1,1,1,1,2,2,0,2,0,1,0,0,1
12,222,46,26,30,3,0,12,49,3,6,3,6,9,9,20,28,1,42,2,0,1
4,76,127,75,83,2,11,30,129,4,14,7,14,18,21,61,87,2,175,9,0,1
4,76,652,304,544,16,6,88,668,6,89,51,101,95,152,591,998,3,3399,188,0,1
4,76,2,2,2,0,0,0,2,0,0,0,0,0,0,0,0,0,0,0,0,1
4,76,8,5,5,0,0,3,8,0,0,0,0,0,0,0,0,0,0,0,0,1
4,76,14,8,8,0,0,6,14,0,0,0,0,0,0,0,0,0,0,0,0,1
4,76,6,4,4,0,0,2,6,0,0,0,0,0,0,0,0,0,0,0,0,1
4,76,6,4,4,0,0,2,6,1,2,1,2,3,3,2,4,0,2,0,0,1
4,76,7,5,5,0,0,2,7,0,0,0,0,0,0,0,0,0,0,0,0,1
4,76,10,6,6,0,0,4,10,0,0,0,0,0,0,0,0,0,0,0,0,1
4,76,1,1,1,0,0,0,1,0,0,0,0,0,0,0,0,0,0,0,0,1
4,76,14,10,10,0,0,4,14,1,1,1,1,2,2,0,2,0,1,0,0,1
4,76,46,26,30,3,0,12,49,3,6,3,6,9,9,20,28,1,42,2,0,1
133,2760,77,34,69,0,0,8,77,3,24,16,29,27,45,114,213,1,387,21,0,1
133,2760,712,438,573,51,9,84,763,14,102,71,128,116,199,733,1364,8,11988,666,0,1
16,576,1455,414,1257,16,76,112,1471,5,41,23,46,46,69,231,381,2,1069,59,0,1
16,576,669,365,481,22,61,110,691,15,103,63,122,118,185,747,1273,8,11311,628,0,1
44,767,1020,354,843,12,15,144,1032,8,134,77,144,142,221,970,1580,4,6792,377,0,1
17,277,424,94,331,4,0,89,428,1,5,5,5,6,10,11,25,0,12,0,0,1
17,277,38,23,23,6,0,8,44,3,11,7,11,14,18,42,68,1,102,5,0,1
206,4475,72,33,56,0,4,12,72,1,1,1,1,2,2,0,2,0,1,0,0,1
206,4475,1454,835,1044,76,110,219,1530,17,275,158,296,292,454,2297,3718,9,34017,1889,1,1
130,3020,373,158,315,8,0,51,381,5,76,44,79,81,123,486,779,2,2026,112,0,1
71,1170,1178,367,1042,6,15,115,1184,9,94,51,95,103,146,644,976,4,4439,246,0,1
71,1170,177,108,140,8,0,27,185,6,30,16,32,36,48,162,248,3,794,44,0,1
19,278,1098,241,925,5,10,155,1103,7,46,25,49,53,74,273,423,3,1580,87,0,1
19,278,282,202,222,14,2,44,296,8,42,24,43,50,67,250,378,4,1548,86,0,1
35,1670,1289,550,1043,56,32,155,1345,10,167,93,185,177,278,1266,2075,5,11498,638,0,1
23,994,373,158,315,8,0,51,381,5,76,44,79,81,123,486,779,2,2026,112,0,1
41,2834,1296,573,1062,40,33,157,1336,8,201,118,231,209,349,1561,2689,4,12365,686,0,1
75,3605,77,34,69,0,0,8,77,3,24,16,29,27,45,114,213,1,387,21,0,1
43,864,1450,624,1228,12,26,181,1462,14,306,186,354,320,540,2580,4493,8,36391,2021,1,1
34,862,74,35,59,1,0,14,75,3,14,7,14,17,21,58,85,1,128,7,0,1
34,862,245,125,200,5,7,34,250,7,30,17,34,37,51,166,265,3,1053,58,0,1
177,4162,722,423,573,19,0,135,741,12,172,101,199,184,300,1320,2257,6,15668,870,0,1
177,4162,1508,847,911,44,250,301,1552,14,148,88,169,162,257,1120,1886,7,15077,837,0,1
130,3034,373,158,315,8,0,51,381,5,76,44,79,81,123,486,779,2,2026,112,0,1
6,287,42,7,35,4,0,5,46,1,2,1,2,3,3,2,4,0,2,0,0,1
6,287,11,6,10,0,0,1,11,2,4,2,4,6,6,10,15,1,15,0,0,1
35,1615,1289,550,1043,56,32,155,1345,10,167,93,185,177,278,1266,2075,5,11498,638,0,1
7,159,127,75,83,2,11,30,129,4,14,7,14,18,21,61,87,2,175,9,0,1
7,159,652,304,544,16,6,88,668,6,89,51,101,95,152,591,998,3,3399,188,0,1
7,159,2,2,2,0,0,0,2,0,0,0,0,0,0,0,0,0,0,0,0,1
7,159,8,5,5,0,0,3,8,0,0,0,0,0,0,0,0,0,0,0,0,1
7,159,14,8,8,0,0,6,14,0,0,0,0,0,0,0,0,0,0,0,0,1
7,159,6,4,4,0,0,2,6,0,0,0,0,0,0,0,0,0,0,0,0,1
7,159,6,4,4,0,0,2,6,1,2,1,2,3,3,2,4,0,2,0,0,1
7,159,7,5,5,0,0,2,7,0,0,0,0,0,0,0,0,0,0,0,0,1
7,159,10,6,6,0,0,4,10,0,0,0,0,0,0,0,0,0,0,0,0,1
7,159,1,1,1,0,0,0,1,0,0,0,0,0,0,0,0,0,0,0,0,1
7,159,14,10,10,0,0,4,14,1,1,1,1,2,2,0,2,0,1,0,0,1
7,159,46,26,30,3,0,12,49,3,6,3,6,9,9,20,28,1,42,2,0,1
26,918,1450,624,1228,12,26,181,1462,14,306,186,354,320,540,2580,4493,8,36391,2021,1,1
34,1378,1513,682,1277,25,13,200,1538,11,199,116,219,210,335,1557,2584,6,15641,868,0,1
10,401,1455,414,1257,16,76,112,1471,5,41,23,46,46,69,231,381,2,1069,59,0,1
7,222,74,35,59,1,0,14,75,3,14,7,14,17,21,58,85,1,128,7,0,1
31,1245,1020,354,843,12,15,144,1032,8,134,77,144,142,221,970,1580,4,6792,377,0,1
12,818,447,308,343,6,5,95,453,7,96,59,111,103,170,651,1136,4,4600,255,0,1
10,498,722,423,573,19,0,135,741,12,172,101,199,184,300,1320,2257,6,15668,870,0,1
12,416,386,256,301,16,9,68,402,4,59,35,69,63,104,355,621,2,1453,80,0,1
13,1142,215,129,180,6,0,29,221,8,65,43,72,73,115,415,711,4,3153,175,0,1
36,1464,1043,504,840,53,9,147,1096,9,180,112,198,189,310,1377,2344,4,11604,644,0,1
28,1381,1178,367,1042,6,15,115,1184,9,94,51,95,103,146,644,976,4,4439,246,0,1
51,2560,1943,715,1694,26,18,214,1969,12,185,120,237,197,357,1436,2721,7,20915,1161,0,1
2,135,442,244,305,14,16,103,456,11,68,45,75,79,120,452,756,6,4588,254,0,1
41,2832,1296,573,1062,40,33,157,1336,8,201,118,231,209,349,1561,2689,4,12365,686,0,1
26,1595,1457,730,1242,11,6,188,1468,10,292,166,329,302,495,2424,4078,5,22973,1276,1,1
26,1352,652,304,544,16,6,88,668,6,89,51,101,95,152,591,998,3,3399,188,0,1
17,773,334,251,279,10,4,40,344,5,127,74,143,132,217,899,1528,2,4303,239,0,1
177,4154,722,423,573,19,0,135,741,12,172,101,199,184,300,1320,2257,6,15668,870,0,1
177,4154,1508,847,911,44,250,301,1552,14,148,88,169,162,257,1120,1886,7,15077,837,0,1
176,4145,722,423,573,19,0,135,741,12,172,101,199,184,300,1320,2257,6,15668,870,0,1
176,4145,1508,847,911,44,250,301,1552,14,148,88,169,162,257,1120,1886,7,15077,837,0,1
26,560,215,129,180,6,0,29,221,8,65,43,72,73,115,415,711,4,3153,175,0,1
26,560,97,69,77,3,3,16,100,6,22,13,23,28,36,113,173,3,542,30,0,1
87,1903,1043,504,840,53,9,147,1096,9,180,112,198,189,310,1377,2344,4,11604,644,0,1
87,1903,383,288,292,26,6,62,409,11,65,38,67,76,105,429,656,5,3719,206,0,1
71,1168,1178,367,1042,6,15,115,1184,9,94,51,95,103,146,644,976,4,4439,246,0,1
71,1168,177,108,140,8,0,27,185,6,30,16,32,36,48,162,248,3,794,44,0,1
138,2676,1943,715,1694,26,18,214,1969,12,185,120,237,197,357,1436,2721,7,20915,1161,0,1
138,2676,1168,838,957,57,25,144,1225,19,348,224,416,367,640,3018,5452,11,61921,3440,1,1
37,1499,1043,504,840,53,9,147,1096,9,180,112,198,189,310,1377,2344,4,11604,644,0,1
28,1372,1178,367,1042,6,15,115,1184,9,94,51,95,103,146,644,976,4,4439,246,0,1
130,3043,373,158,315,8,0,51,381,5,76,44,79,81,123,486,779,2,2026,112,0,1
137,2628,1943,715,1694,26,18,214,1969,12,185,120,237,197,357,1436,2721,7,20915,1161,0,1
137,2628,1168,838,957,57,25,144,1225,19,348,224,416,367,640,3018,5452,11,61921,3440,1,1
34,862,74,35,59,1,0,14,75,3,14,7,14,17,21,58,85,1,128,7,0,0
34,862,245,125,200,5,7,34,250,7,30,17,34,37,51,166,265,3,1053,58,0,0
4,78,127,75,83,2,11,30,129,4,14,7,14,18,21,61,87,2,175,9,0,0
4,78,652,304,544,16,6,88,668,6,89,51,101,95,152,591,998,3,3399,188,0,0
4,78,2,2,2,0,0,0,2,0,0,0,0,0,0,0,0,0,0,0,0,0
4,78,8,5,5,0,0,3,8,0,0,0,0,0,0,0,0,0,0,0,0,0
4,78,14,8,8,0,0,6,14,0,0,0,0,0,0,0,0,0,0,0,0,0
4,78,6,4,4,0,0,2,6,0,0,0,0,0,0,0,0,0,0,0,0,0
4,78,6,4,4,0,0,2,6,1,2,1,2,3,3,2,4,0,2,0,0,0
4,78,7,5,5,0,0,2,7,0,0,0,0,0,0,0,0,0,0,0,0,0
4,78,10,6,6,0,0,4,10,0,0,0,0,0,0,0,0,0,0,0,0,0
4,78,1,1,1,0,0,0,1,0,0,0,0,0,0,0,0,0,0,0,0,0
4,78,14,10,10,0,0,4,14,1,1,1,1,2,2,0,2,0,1,0,0,0
4,78,46,26,30,3,0,12,49,3,6,3,6,9,9,20,28,1,42,2,0,0
205,4464,72,33,56,0,4,12,72,1,1,1,1,2,2,0,2,0,1,0,0,0
205,4464,1454,835,1044,76,110,219,1530,17,275,158,296,292,454,2297,3718,9,34017,1889,1,0
6,287,42,7,35,4,0,5,46,1,2,1,2,3,3,2,4,0,2,0,0,0
6,287,11,6,10,0,0,1,11,2,4,2,4,6,6,10,15,1,15,0,0,0
35,1628,1289,550,1043,56,32,155,1345,10,167,93,185,177,278,1266,2075,5,11498,638,0,0
18,598,1455,414,1257,16,76,112,1471,5,41,23,46,46,69,231,381,2,1069,59,0,1
18,598,669,365,481,22,61,110,691,15,103,63,122,118,185,747,1273,8,11311,628,0,1
10,415,1455,414,1257,16,76,112,1471,5,41,23,46,46,69,231,381,2,1069,59,0,1
17,561,1455,414,1257,16,76,112,1471,5,41,23,46,46,69,231,381,2,1069,59,0,1
17,561,669,365,481,22,61,110,691,15,103,63,122,118,185,747,1273,8,11311,628,0,1
131,3044,373,158,315,8,0,51,381,5,76,44,79,81,123,486,779,2,2026,112,0,1
38,1713,1289,550,1043,56,32,155,1345,10,167,93,185,177,278,1266,2075,5,11498,638,0,1
41,2867,1296,573,1062,40,33,157,1336,8,201,118,231,209,349,1561,2689,4,12365,686,0,1
38,1703,1289,550,1043,56,32,155,1345,10,167,93,185,177,278,1266,2075,5,11498,638,0,1
32,534,127,75,83,2,11,30,129,4,14,7,14,18,21,61,87,2,175,9,0,1
32,534,652,304,544,16,6,88,668,6,89,51,101,95,152,591,998,3,3399,188,0,1
32,534,2,2,2,0,0,0,2,0,0,0,0,0,0,0,0,0,0,0,0,1
32,534,8,5,5,0,0,3,8,0,0,0,0,0,0,0,0,0,0,0,0,1
32,534,14,8,8,0,0,6,14,0,0,0,0,0,0,0,0,0,0,0,0,1
32,534,6,4,4,0,0,2,6,0,0,0,0,0,0,0,0,0,0,0,0,1
32,534,6,4,4,0,0,2,6,1,2,1,2,3,3,2,4,0,2,0,0,1
32,534,7,5,5,0,0,2,7,0,0,0,0,0,0,0,0,0,0,0,0,1
32,534,10,6,6,0,0,4,10,0,0,0,0,0,0,0,0,0,0,0,0,1
32,534,1,1,1,0,0,0,1,0,0,0,0,0,0,0,0,0,0,0,0,1
32,534,14,10,10,0,0,4,14,1,1,1,1,2,2,0,2,0,1,0,0,1
32,534,46,26,30,3,0,12,49,3,6,3,6,9,9,20,28,1,42,2,0,1
34,1366,1513,682,1277,25,13,200,1538,11,199,116,219,210,335,1557,2584,6,15641,868,0,1
41,2863,1296,573,1062,40,33,157,1336,8,201,118,231,209,349,1561,2689,4,12365,686,0,1
26,1575,1457,730,1242,11,6,188,1468,10,292,166,329,302,495,2424,4078,5,22973,1276,1,1
26,1350,652,304,544,16,6,88,668,6,89,51,101,95,152,591,998,3,3399,188,0,1
10,417,1455,414,1257,16,76,112,1471,5,41,23,46,46,69,231,381,2,1069,59,0,1
31,1237,1020,354,843,12,15,144,1032,8,134,77,144,142,221,970,1580,4,6792,377,0,1
12,810,447,308,343,6,5,95,453,7,96,59,111,103,170,651,1136,4,4600,255,0,1
9,312,424,94,331,4,0,89,428,1,5,5,5,6,10,11,25,0,12,0,0,1
17,769,334,251,279,10,4,40,344,5,127,74,143,132,217,899,1528,2,4303,239,0,1
5,238,184,100,137,2,15,30,186,6,38,20,39,44,59,214,322,3,991,55,0,1
15,596,1293,570,1093,25,15,163,1318,10,195,123,241,205,364,1516,2795,6,17273,959,0,1
10,494,722,423,573,19,0,135,741,12,172,101,199,184,300,1320,2257,6,15668,870,0,1
12,412,386,256,301,16,9,68,402,4,59,35,69,63,104,355,621,2,1453,80,0,1
13,1144,215,129,180,6,0,29,221,8,65,43,72,73,115,415,711,4,3153,175,0,1
37,1475,1043,504,840,53,9,147,1096,9,180,112,198,189,310,1377,2344,4,11604,644,0,1
10,333,295,56,236,0,4,54,295,2,9,5,10,11,15,30,51,1,57,3,0,1
28,1368,1178,367,1042,6,15,115,1184,9,94,51,95,103,146,644,976,4,4439,246,0,1
51,2556,1943,715,1694,26,18,214,1969,12,185,120,237,197,357,1436,2721,7,20915,1161,0,1
2,137,442,244,305,14,16,103,456,11,68,45,75,79,120,452,756,6,4588,254,0,1
17,579,1455,414,1257,16,76,112,1471,5,41,23,46,46,69,231,381,2,1069,59,0,1
17,579,669,365,481,22,61,110,691,15,103,63,122,118,185,747,1273,8,11311,628,0,1
205,4464,72,33,56,0,4,12,72,1,1,1,1,2,2,0,2,0,1,0,0,1
205,4464,1454,835,1044,76,110,219,1530,17,275,158,296,292,454,2297,3718,9,34017,1889,1,1
131,3070,373,158,315,8,0,51,381,5,76,44,79,81,123,486,779,2,2026,112,0,1
41,2878,1296,573,1062,40,33,157,1336,8,201,118,231,209,349,1561,2689,4,12365,686,0,1
32,1257,1020,354,843,12,15,144,1032,8,134,77,144,142,221,970,1580,4,6792,377,0,1
18,604,1455,414,1257,16,76,112,1471,5,41,23,46,46,69,231,381,2,1069,59,0,0
18,604,669,365,481,22,61,110,691,15,103,63,122,118,185,747,1273,8,11311,628,0,0
1,185,382,65,130,157,2,92,539,4,10,5,10,14,15,41,57,2,114,6,0,0
207,4492,72,33,56,0,4,12,72,1,1,1,1,2,2,0,2,0,1,0,0,1
207,4492,1454,835,1044,76,110,219,1530,17,275,158,296,292,454,2297,3718,9,34017,1889,1,1
46,795,1020,354,843,12,15,144,1032,8,134,77,144,142,221,970,1580,4,6792,377,0,1
35,1360,1020,354,843,12,15,144,1032,8,134,77,144,142,221,970,1580,4,6792,377,0,1
1,84,13,10,10,0,0,3,13,1,2,1,2,3,3,2,4,0,2,0,0,1
3,71,127,75,83,2,11,30,129,4,14,7,14,18,21,61,87,2,175,9,0,1
3,71,652,304,544,16,6,88,668,6,89,51,101,95,152,591,998,3,3399,188,0,1
3,71,2,2,2,0,0,0,2,0,0,0,0,0,0,0,0,0,0,0,0,1
3,71,8,5,5,0,0,3,8,0,0,0,0,0,0,0,0,0,0,0,0,1
3,71,14,8,8,0,0,6,14,0,0,0,0,0,0,0,0,0,0,0,0,1
3,71,6,4,4,0,0,2,6,0,0,0,0,0,0,0,0,0,0,0,0,1
3,71,6,4,4,0,0,2,6,1,2,1,2,3,3,2,4,0,2,0,0,1
3,71,7,5,5,0,0,2,7,0,0,0,0,0,0,0,0,0,0,0,0,1
3,71,10,6,6,0,0,4,10,0,0,0,0,0,0,0,0,0,0,0,0,1
3,71,1,1,1,0,0,0,1,0,0,0,0,0,0,0,0,0,0,0,0,1
3,71,14,10,10,0,0,4,14,1,1,1,1,2,2,0,2,0,1,0,0,1
3,71,46,26,30,3,0,12,49,3,6,3,6,9,9,20,28,1,42,2,0,1
13,380,72,33,56,0,4,12,72,1,1,1,1,2,2,0,2,0,1,0,0,1
5,69,38,23,23,0,0,15,38,0,0,0,0,0,0,0,0,0,0,0,0,1
134,2593,1457,730,1242,11,6,188,1468,10,292,166,329,302,495,2424,4078,5,22973,1276,1,1
134,2593,74,35,59,1,0,14,75,3,14,7,14,17,21,58,85,1,128,7,0,1
134,2593,245,125,200,5,7,34,250,7,30,17,34,37,51,166,265,3,1053,58,0,1
178,4184,722,423,573,19,0,135,741,12,172,101,199,184,300,1320,2257,6,15668,870,0,1
178,4184,1508,847,911,44,250,301,1552,14,148,88,169,162,257,1120,1886,7,15077,837,0,1
12,359,442,244,305,14,16,103,456,11,68,45,75,79,120,452,756,6,4588,254,0,1
12,359,182,102,99,11,40,35,193,3,11,6,11,14,17,42,64,1,97,5,0,1
37,1648,1289,550,1043,56,32,155,1345,10,167,93,185,177,278,1266,2075,5,11498,638,0,1
22,1351,1457,730,1242,11,6,188,1468,10,292,166,329,302,495,2424,4078,5,22973,1276,1,1
7,476,442,244,305,14,16,103,456,11,68,45,75,79,120,452,756,6,4588,254,0,1
65,1200,1513,682,1277,25,13,200,1538,11,199,116,219,210,335,1557,2584,6,15641,868,0,1
65,1200,819,519,539,24,98,155,843,15,96,57,106,111,163,690,1107,8,9171,509,0,1
20,489,1293,570,1093,25,15,163,1318,10,195,123,241,205,364,1516,2795,6,17273,959,0,1
35,1408,1513,682,1277,25,13,200,1538,11,199,116,219,210,335,1557,2584,6,15641,868,0,1
133,2586,1457,730,1242,11,6,188,1468,10,292,166,329,302,495,2424,4078,5,22973,1276,1,1
133,2586,74,35,59,1,0,14,75,3,14,7,14,17,21,58,85,1,128,7,0,1
133,2586,245,125,200,5,7,34,250,7,30,17,34,37,51,166,265,3,1053,58,0,1
44,421,647,139,84,35,284,233,682,0,0,0,0,0,0,0,0,0,0,0,0,1
148,2800,1943,715,1694,26,18,214,1969,12,185,120,237,197,357,1436,2721,7,20915,1161,0,1
148,2800,1168,838,957,57,25,144,1225,19,348,224,416,367,640,3018,5452,11,61921,3440,1,1
4,77,127,75,83,2,11,30,129,4,14,7,14,18,21,61,87,2,175,9,0,1
4,77,652,304,544,16,6,88,668,6,89,51,101,95,152,591,998,3,3399,188,0,1
4,77,2,2,2,0,0,0,2,0,0,0,0,0,0,0,0,0,0,0,0,1
4,77,8,5,5,0,0,3,8,0,0,0,0,0,0,0,0,0,0,0,0,1
4,77,14,8,8,0,0,6,14,0,0,0,0,0,0,0,0,0,0,0,0,1
4,77,6,4,4,0,0,2,6,0,0,0,0,0,0,0,0,0,0,0,0,1
4,77,6,4,4,0,0,2,6,1,2,1,2,3,3,2,4,0,2,0,0,1
4,77,7,5,5,0,0,2,7,0,0,0,0,0,0,0,0,0,0,0,0,1
4,77,10,6,6,0,0,4,10,0,0,0,0,0,0,0,0,0,0,0,0,1
4,77,1,1,1,0,0,0,1,0,0,0,0,0,0,0,0,0,0,0,0,1
4,77,14,10,10,0,0,4,14,1,1,1,1,2,2,0,2,0,1,0,0,1
4,77,46,26,30,3,0,12,49,3,6,3,6,9,9,20,28,1,42,2,0,1
28,1364,1178,367,1042,6,15,115,1184,9,94,51,95,103,146,644,976,4,4439,246,0,1
51,2554,1943,715,1694,26,18,214,1969,12,185,120,237,197,357,1436,2721,7,20915,1161,0,1
178,4184,722,423,573,19,0,135,741,12,172,101,199,184,300,1320,2257,6,15668,870,0,0
178,4184,1508,847,911,44,250,301,1552,14,148,88,169,162,257,1120,1886,7,15077,837,0,0
179,4219,722,423,573,19,0,135,741,12,172,101,199,184,300,1320,2257,6,15668,870,0,1
179,4219,1508,847,911,44,250,301,1552,14,148,88,169,162,257,1120,1886,7,15077,837,0,1
209,4519,72,33,56,0,4,12,72,1,1,1,1,2,2,0,2,0,1,0,0,1
209,4519,1454,835,1044,76,110,219,1530,17,275,158,296,292,454,2297,3718,9,34017,1889,1,1
87,1925,1043,504,840,53,9,147,1096,9,180,112,198,189,310,1377,2344,4,11604,644,0,1
87,1925,383,288,292,26,6,62,409,11,65,38,67,76,105,429,656,5,3719,206,0,1
28,438,1098,241,925,5,10,155,1103,7,46,25,49,53,74,273,423,3,1580,87,0,1
28,438,282,202,222,14,2,44,296,8,42,24,43,50,67,250,378,4,1548,86,0,1
38,1504,1043,504,840,53,9,147,1096,9,180,112,198,189,310,1377,2344,4,11604,644,0,1
10,396,1098,241,925,5,10,155,1103,7,46,25,49,53,74,273,423,3,1580,87,0,1
19,477,1293,570,1093,25,15,163,1318,10,195,123,241,205,364,1516,2795,6,17273,959,0,1
151,2856,1943,715,1694,26,18,214,1969,12,185,120,237,197,357,1436,2721,7,20915,1161,0,1
151,2856,1168,838,957,57,25,144,1225,19,348,224,416,367,640,3018,5452,11,61921,3440,1,1
16,635,1293,570,1093,25,15,163,1318,10,195,123,241,205,364,1516,2795,6,17273,959,0,1
1,192,382,65,130,157,2,92,539,4,10,5,10,14,15,41,57,2,114,6,0,1
28,458,1098,241,925,5,10,155,1103,7,46,25,49,53,74,273,423,3,1580,87,0,1
28,458,282,202,222,14,2,44,296,8,42,24,43,50,67,250,378,4,1548,86,0,1
11,426,1098,241,925,5,10,155,1103,7,46,25,49,53,74,273,423,3,1580,87,0,1
37,1034,1523,757,1297,19,12,193,1542,12,193,117,230,205,347,1508,2664,7,19053,1058,0,1
37,1034,701,378,504,33,58,109,734,13,110,68,126,123,194,794,1346,7,10027,557,0,1
181,4234,722,423,573,19,0,135,741,12,172,101,199,184,300,1320,2257,6,15668,870,0,1
181,4234,1508,847,911,44,250,301,1552,14,148,88,169,162,257,1120,1886,7,15077,837,0,1
19,478,1293,570,1093,25,15,163,1318,10,195,123,241,205,364,1516,2795,6,17273,959,0,1
36,627,1098,241,925,5,10,155,1103,7,46,25,49,53,74,273,423,3,1580,87,0,1
36,627,282,202,222,14,2,44,296,8,42,24,43,50,67,250,378,4,1548,86,0,1
15,570,1098,241,925,5,10,155,1103,7,46,25,49,53,74,273,423,3,1580,87,0,1
37,640,1098,241,925,5,10,155,1103,7,46,25,49,53,74,273,423,3,1580,87,0,1
37,640,282,202,222,14,2,44,296,8,42,24,43,50,67,250,378,4,1548,86,0,1
16,591,1098,241,925,5,10,155,1103,7,46,25,49,53,74,273,423,3,1580,87,0,1
16,591,1098,241,925,5,10,155,1103,7,46,25,49,53,74,273,423,3,1580,87,0,0
38,659,1098,241,925,5,10,155,1103,7,46,25,49,53,74,273,423,3,1580,87,0,1
38,659,282,202,222,14,2,44,296,8,42,24,43,50,67,250,378,4,1548,86,0,1
18,710,1098,241,925,5,10,155,1103,7,46,25,49,53,74,273,423,3,1580,87,0,1
183,4253,722,423,573,19,0,135,741,12,172,101,199,184,300,1320,2257,6,15668,870,0,1
183,4253,1508,847,911,44,250,301,1552,14,148,88,169,162,257,1120,1886,7,15077,837,0,1
39,708,1098,241,925,5,10,155,1103,7,46,25,49,53,74,273,423,3,1580,87,0,1
39,708,282,202,222,14,2,44,296,8,42,24,43,50,67,250,378,4,1548,86,0,1
19,732,1098,241,925,5,10,155,1103,7,46,25,49,53,74,273,423,3,1580,87,0,1
38,1518,1043,504,840,53,9,147,1096,9,180,112,198,189,310,1377,2344,4,11604,644,0,1
135,2629,1457,730,1242,11,6,188,1468,10,292,166,329,302,495,2424,4078,5,22973,1276,1,1
135,2629,74,35,59,1,0,14,75,3,14,7,14,17,21,58,85,1,128,7,0,1
135,2629,245,125,200,5,7,34,250,7,30,17,34,37,51,166,265,3,1053,58,0,1
213,4623,72,33,56,0,4,12,72,1,1,1,1,2,2,0,2,0,1,0,0,1
213,4623,1454,835,1044,76,110,219,1530,17,275,158,296,292,454,2297,3718,9,34017,1889,1,1
210,4583,72,33,56,0,4,12,72,1,1,1,1,2,2,0,2,0,1,0,0,1
210,4583,1454,835,1044,76,110,219,1530,17,275,158,296,292,454,2297,3718,9,34017,1889,1,1
132,3087,373,158,315,8,0,51,381,5,76,44,79,81,123,486,779,2,2026,112,0,1
212,4586,72,33,56,0,4,12,72,1,1,1,1,2,2,0,2,0,1,0,0,0
212,4586,1454,835,1044,76,110,219,1530,17,275,158,296,292,454,2297,3718,9,34017,1889,1,0
34,863,74,35,59,1,0,14,75,3,14,7,14,17,21,58,85,1,128,7,0,1
34,863,245,125,200,5,7,34,250,7,30,17,34,37,51,166,265,3,1053,58,0,1
212,4586,72,33,56,0,4,12,72,1,1,1,1,2,2,0,2,0,1,0,0,1
212,4586,1454,835,1044,76,110,219,1530,17,275,158,296,292,454,2297,3718,9,34017,1889,1,1
52,901,282,196,195,3,0,86,285,8,130,71,141,138,212,936,1507,4,6538,363,0,1
46,860,1098,241,925,5,10,155,1103,7,46,25,49,53,74,273,423,3,1580,87,0,1
46,860,282,202,222,14,2,44,296,8,42,24,43,50,67,250,378,4,1548,86,0,1
19,752,1098,241,925,5,10,155,1103,7,46,25,49,53,74,273,423,3,1580,87,0,1
152,2888,1943,715,1694,26,18,214,1969,12,185,120,237,197,357,1436,2721,7,20915,1161,0,1
152,2888,1168,838,957,57,25,144,1225,19,348,224,416,367,640,3018,5452,11,61921,3440,1,1
35,1417,1513,682,1277,25,13,200,1538,11,199,116,219,210,335,1557,2584,6,15641,868,0,1
153,2910,1943,715,1694,26,18,214,1969,12,185,120,237,197,357,1436,2721,7,20915,1161,0,1
153,2910,1168,838,957,57,25,144,1225,19,348,224,416,367,640,3018,5452,11,61921,3440,1,1
185,4279,722,423,573,19,0,135,741,12,172,101,199,184,300,1320,2257,6,15668,870,0,0
185,4279,1508,847,911,44,250,301,1552,14,148,88,169,162,257,1120,1886,7,15077,837,0,0
35,881,74,35,59,1,0,14,75,3,14,7,14,17,21,58,85,1,128,7,0,1
35,881,245,125,200,5,7,34,250,7,30,17,34,37,51,166,265,3,1053,58,0,1
132,3088,77,34,69,0,0,8,77,3,24,16,29,27,45,114,213,1,387,21,0,1
132,3088,712,438,573,51,9,84,763,14,102,71,128,116,199,733,1364,8,11988,666,0,1
185,4279,722,423,573,19,0,135,741,12,172,101,199,184,300,1320,2257,6,15668,870,0,1
185,4279,1508,847,911,44,250,301,1552,14,148,88,169,162,257,1120,1886,7,15077,837,0,1
26,562,215,129,180,6,0,29,221,8,65,43,72,73,115,415,711,4,3153,175,0,1
26,562,97,69,77,3,3,16,100,6,22,13,23,28,36,113,173,3,542,30,0,1
25,1439,1457,730,1242,11,6,188,1468,10,292,166,329,302,495,2424,4078,5,22973,1276,1,1
36,1475,1513,682,1277,25,13,200,1538,11,199,116,219,210,335,1557,2584,6,15641,868,0,1
71,1174,1178,367,1042,6,15,115,1184,9,94,51,95,103,146,644,976,4,4439,246,0,1
71,1174,177,108,140,8,0,27,185,6,30,16,32,36,48,162,248,3,794,44,0,1
30,1431,1178,367,1042,6,15,115,1184,9,94,51,95,103,146,644,976,4,4439,246,0,1
18,611,1455,414,1257,16,76,112,1471,5,41,23,46,46,69,231,381,2,1069,59,0,1
18,611,669,365,481,22,61,110,691,15,103,63,122,118,185,747,1273,8,11311,628,0,1
10,414,1455,414,1257,16,76,112,1471,5,41,23,46,46,69,231,381,2,1069,59,0,1
136,2646,1457,730,1242,11,6,188,1468,10,292,166,329,302,495,2424,4078,5,22973,1276,1,1
136,2646,74,35,59,1,0,14,75,3,14,7,14,17,21,58,85,1,128,7,0,1
136,2646,245,125,200,5,7,34,250,7,30,17,34,37,51,166,265,3,1053,58,0,1
26,1471,1457,730,1242,11,6,188,1468,10,292,166,329,302,495,2424,4078,5,22973,1276,1,1
136,2649,1457,730,1242,11,6,188,1468,10,292,166,329,302,495,2424,4078,5,22973,1276,1,0
136,2649,74,35,59,1,0,14,75,3,14,7,14,17,21,58,85,1,128,7,0,0
136,2649,245,125,200,5,7,34,250,7,30,17,34,37,51,166,265,3,1053,58,0,0
28,1508,1457,730,1242,11,6,188,1468,10,292,166,329,302,495,2424,4078,5,22973,1276,1,0
136,2649,1457,730,1242,11,6,188,1468,10,292,166,329,302,495,2424,4078,5,22973,1276,1,1
136,2649,74,35,59,1,0,14,75,3,14,7,14,17,21,58,85,1,128,7,0,1
136,2649,245,125,200,5,7,34,250,7,30,17,34,37,51,166,265,3,1053,58,0,1
28,1508,1457,730,1242,11,6,188,1468,10,292,166,329,302,495,2424,4078,5,22973,1276,1,1
43,862,1450,624,1228,12,26,181,1462,14,306,186,354,320,540,2580,4493,8,36391,2021,1,1
40,1688,1289,550,1043,56,32,155,1345,10,167,93,185,177,278,1266,2075,5,11498,638,0,1
27,999,1450,624,1228,12,26,181,1462,14,306,186,354,320,540,2580,4493,8,36391,2021,1,1
47,952,1450,624,1228,12,26,181,1462,14,306,186,354,320,540,2580,4493,8,36391,2021,1,1
56,977,282,196,195,3,0,86,285,8,130,71,141,138,212,936,1507,4,6538,363,0,1
28,1028,1450,624,1228,12,26,181,1462,14,306,186,354,320,540,2580,4493,8,36391,2021,1,1
135,2612,1457,730,1242,11,6,188,1468,10,292,166,329,302,495,2424,4078,5,22973,1276,1,1
135,2612,74,35,59,1,0,14,75,3,14,7,14,17,21,58,85,1,128,7,0,1
135,2612,245,125,200,5,7,34,250,7,30,17,34,37,51,166,265,3,1053,58,0,1
25,1227,652,304,544,16,6,88,668,6,89,51,101,95,152,591,998,3,3399,188,0,1
28,1028,1450,624,1228,12,26,181,1462,14,306,186,354,320,540,2580,4493,8,36391,2021,1,0
41,991,74,35,59,1,0,14,75,3,14,7,14,17,21,58,85,1,128,7,0,1
41,991,245,125,200,5,7,34,250,7,30,17,34,37,51,166,265,3,1053,58,0,1
28,1512,1457,730,1242,11,6,188,1468,10,292,166,329,302,495,2424,4078,5,22973,1276,1,1
9,271,74,35,59,1,0,14,75,3,14,7,14,17,21,58,85,1,128,7,0,1
213,4608,72,33,56,0,4,12,72,1,1,1,1,2,2,0,2,0,1,0,0,1
213,4608,1454,835,1044,76,110,219,1530,17,275,158,296,292,454,2297,3718,9,34017,1889,1,1
132,3094,77,34,69,0,0,8,77,3,24,16,29,27,45,114,213,1,387,21,0,1
132,3094,712,438,573,51,9,84,763,14,102,71,128,116,199,733,1364,8,11988,666,0,1
213,4618,72,33,56,0,4,12,72,1,1,1,1,2,2,0,2,0,1,0,0,1
213,4618,1454,835,1044,76,110,219,1530,17,275,158,296,292,454,2297,3718,9,34017,1889,1,1
69,1220,1513,682,1277,25,13,200,1538,11,199,116,219,210,335,1557,2584,6,15641,868,0,1
69,1220,819,519,539,24,98,155,843,15,96,57,106,111,163,690,1107,8,9171,509,0,1
133,2620,1457,730,1242,11,6,188,1468,10,292,166,329,302,495,2424,4078,5,22973,1276,1,1
133,2620,74,35,59,1,0,14,75,3,14,7,14,17,21,58,85,1,128,7,0,1
133,2620,245,125,200,5,7,34,250,7,30,17,34,37,51,166,265,3,1053,58,0,1
38,1602,1513,682,1277,25,13,200,1538,11,199,116,219,210,335,1557,2584,6,15641,868,0,1
51,1024,1450,624,1228,12,26,181,1462,14,306,186,354,320,540,2580,4493,8,36391,2021,1,0
28,1030,1450,624,1228,12,26,181,1462,14,306,186,354,320,540,2580,4493,8,36391,2021,1,0
132,3097,77,34,69,0,0,8,77,3,24,16,29,27,45,114,213,1,387,21,0,1
132,3097,712,438,573,51,9,84,763,14,102,71,128,116,199,733,1364,8,11988,666,0,1
40,1725,1289,550,1043,56,32,155,1345,10,167,93,185,177,278,1266,2075,5,11498,638,0,1
40,1725,1289,550,1043,56,32,155,1345,10,167,93,185,177,278,1266,2075,5,11498,638,0,0
135,3145,77,34,69,0,0,8,77,3,24,16,29,27,45,114,213,1,387,21,0,1
135,3145,712,438,573,51,9,84,763,14,102,71,128,116,199,733,1364,8,11988,666,0,1
42,2947,1296,573,1062,40,33,157,1336,8,201,118,231,209,349,1561,2689,4,12365,686,0,1
51,1027,1450,624,1228,12,26,181,1462,14,306,186,354,320,540,2580,4493,8,36391,2021,1,1
29,1054,1450,624,1228,12,26,181,1462,14,306,186,354,320,540,2580,4493,8,36391,2021,1,1
153,2910,1943,715,1694,26,18,214,1969,12,185,120,237,197,357,1436,2721,7,20915,1161,0,0
153,2910,1168,838,957,57,25,144,1225,19,348,224,416,367,640,3018,5452,11,61921,3440,1,0
77,1330,1178,367,1042,6,15,115,1184,9,94,51,95,103,146,644,976,4,4439,246,0,1
77,1330,177,108,140,8,0,27,185,6,30,16,32,36,48,162,248,3,794,44,0,1
31,1477,1178,367,1042,6,15,115,1184,9,94,51,95,103,146,644,976,4,4439,246,0,1
79,1379,1178,367,1042,6,15,115,1184,9,94,51,95,103,146,644,976,4,4439,246,0,1
79,1379,177,108,140,8,0,27,185,6,30,16,32,36,48,162,248,3,794,44,0,1
6,81,38,23,23,0,0,15,38,0,0,0,0,0,0,0,0,0,0,0,0,1
33,1542,1178,367,1042,6,15,115,1184,9,94,51,95,103,146,644,976,4,4439,246,0,1
217,4664,72,33,56,0,4,12,72,1,1,1,1,2,2,0,2,0,1,0,0,1
217,4664,1454,835,1044,76,110,219,1530,17,275,158,296,292,454,2297,3718,9,34017,1889,1,1
137,3174,77,34,69,0,0,8,77,3,24,16,29,27,45,114,213,1,387,21,0,1
137,3174,712,438,573,51,9,84,763,14,102,71,128,116,199,733,1364,8,11988,666,0,1
217,4677,72,33,56,0,4,12,72,1,1,1,1,2,2,0,2,0,1,0,0,1
217,4677,1454,835,1044,76,110,219,1530,17,275,158,296,292,454,2297,3718,9,34017,1889,1,1
42,2917,1296,573,1062,40,33,157,1336,8,201,118,231,209,349,1561,2689,4,12365,686,0,1
217,4674,72,33,56,0,4,12,72,1,1,1,1,2,2,0,2,0,1,0,0,0
217,4674,1454,835,1044,76,110,219,1530,17,275,158,296,292,454,2297,3718,9,34017,1889,1,0
33,1551,1178,367,1042,6,15,115,1184,9,94,51,95,103,146,644,976,4,4439,246,0,1
47,903,1098,241,925,5,10,155,1103,7,46,25,49,53,74,273,423,3,1580,87,0,1
47,903,282,202,222,14,2,44,296,8,42,24,43,50,67,250,378,4,1548,86,0,1
20,782,1098,241,925,5,10,155,1103,7,46,25,49,53,74,273,423,3,1580,87,0,1
146,2815,1943,715,1694,26,18,214,1969,12,185,120,237,197,357,1436,2721,7,20915,1161,0,1
146,2815,1168,838,957,57,25,144,1225,19,348,224,416,367,640,3018,5452,11,61921,3440,1,1
43,2933,1296,573,1062,40,33,157,1336,8,201,118,231,209,349,1561,2689,4,12365,686,0,1
51,2363,1943,715,1694,26,18,214,1969,12,185,120,237,197,357,1436,2721,7,20915,1161,0,1
19,483,1293,570,1093,25,15,163,1318,10,195,123,241,205,364,1516,2795,6,17273,959,0,0
38,958,74,35,59,1,0,14,75,3,14,7,14,17,21,58,85,1,128,7,0,1
38,958,245,125,200,5,7,34,250,7,30,17,34,37,51,166,265,3,1053,58,0,1
138,3212,77,34,69,0,0,8,77,3,24,16,29,27,45,114,213,1,387,21,0,1
138,3212,712,438,573,51,9,84,763,14,102,71,128,116,199,733,1364,8,11988,666,0,1
146,2822,1943,715,1694,26,18,214,1969,12,185,120,237,197,357,1436,2721,7,20915,1161,0,1
146,2822,1168,838,957,57,25,144,1225,19,348,224,416,367,640,3018,5452,11,61921,3440,1,1
52,2433,1943,715,1694,26,18,214,1969,12,185,120,237,197,357,1436,2721,7,20915,1161,0,1
141,2820,1943,715,1694,26,18,214,1969,12,185,120,237,197,357,1436,2721,7,20915,1161,0,1
141,2820,1168,838,957,57,25,144,1225,19,348,224,416,367,640,3018,5452,11,61921,3440,1,1
87,1920,1043,504,840,53,9,147,1096,9,180,112,198,189,310,1377,2344,4,11604,644,0,0
87,1920,383,288,292,26,6,62,409,11,65,38,67,76,105,429,656,5,3719,206,0,0
215,4654,72,33,56,0,4,12,72,1,1,1,1,2,2,0,2,0,1,0,0,1
215,4654,1454,835,1044,76,110,219,1530,17,275,158,296,292,454,2297,3718,9,34017,1889,1,1
135,2677,1457,730,1242,11,6,188,1468,10,292,166,329,302,495,2424,4078,5,22973,1276,1,1
135,2677,74,35,59,1,0,14,75,3,14,7,14,17,21,58,85,1,128,7,0,1
135,2677,245,125,200,5,7,34,250,7,30,17,34,37,51,166,265,3,1053,58,0,1
38,1068,1523,757,1297,19,12,193,1542,12,193,117,230,205,347,1508,2664,7,19053,1058,0,1
38,1068,701,378,504,33,58,109,734,13,110,68,126,123,194,794,1346,7,10027,557,0,1
20,1484,1523,757,1297,19,12,193,1542,12,193,117,230,205,347,1508,2664,7,19053,1058,0,1
185,4301,722,423,573,19,0,135,741,12,172,101,199,184,300,1320,2257,6,15668,870,0,1
185,4301,1508,847,911,44,250,301,1552,14,148,88,169,162,257,1120,1886,7,15077,837,0,1
12,529,722,423,573,19,0,135,741,12,172,101,199,184,300,1320,2257,6,15668,870,0,1
40,1244,1523,757,1297,19,12,193,1542,12,193,117,230,205,347,1508,2664,7,19053,1058,0,1
40,1244,701,378,504,33,58,109,734,13,110,68,126,123,194,794,1346,7,10027,557,0,1
28,1749,1523,757,1297,19,12,193,1542,12,193,117,230,205,347,1508,2664,7,19053,1058,0,1
138,3216,77,34,69,0,0,8,77,3,24,16,29,27,45,114,213,1,387,21,0,1
138,3216,712,438,573,51,9,84,763,14,102,71,128,116,199,733,1364,8,11988,666,0,1
41,1799,1289,550,1043,56,32,155,1345,10,167,93,185,177,278,1266,2075,5,11498,638,0,1
50,1020,1450,624,1228,12,26,181,1462,14,306,186,354,320,540,2580,4493,8,36391,2021,1,1
137,2699,1457,730,1242,11,6,188,1468,10,292,166,329,302,495,2424,4078,5,22973,1276,1,1
137,2699,74,35,59,1,0,14,75,3,14,7,14,17,21,58,85,1,128,7,0,1
137,2699,245,125,200,5,7,34,250,7,30,17,34,37,51,166,265,3,1053,58,0,1
11,351,442,244,305,14,16,103,456,11,68,45,75,79,120,452,756,6,4588,254,0,1
11,351,182,102,99,11,40,35,193,3,11,6,11,14,17,42,64,1,97,5,0,1
42,1842,1289,550,1043,56,32,155,1345,10,167,93,185,177,278,1266,2075,5,11498,638,0,1
29,1058,1450,624,1228,12,26,181,1462,14,306,186,354,320,540,2580,4493,8,36391,2021,1,1
1,162,382,65,130,157,2,92,539,4,10,5,10,14,15,41,57,2,114,6,0,0
1,179,382,65,130,157,2,92,539,4,10,5,10,14,15,41,57,2,114,6,0,0
46,437,647,139,84,35,284,233,682,0,0,0,0,0,0,0,0,0,0,0,0,0
216,4677,72,33,56,0,4,12,72,1,1,1,1,2,2,0,2,0,1,0,0,0
216,4677,1454,835,1044,76,110,219,1530,17,275,158,296,292,454,2297,3718,9,34017,1889,1,0
57,2323,1660,832,1314,41,38,274,1701,20,312,209,395,332,604,2671,5058,12,64042,3557,1,1
57,999,1660,832,1314,41,38,274,1701,20,312,209,395,332,604,2671,5058,12,64042,3557,1,1
63,2372,1660,832,1314,41,38,274,1701,20,312,209,395,332,604,2671,5058,12,64042,3557,1,1
62,1194,1660,832,1314,41,38,274,1701,20,312,209,395,332,604,2671,5058,12,64042,3557,1,1
64,2382,1660,832,1314,41,38,274,1701,20,312,209,395,332,604,2671,5058,12,64042,3557,1,0
63,2389,1660,832,1314,41,38,274,1701,20,312,209,395,332,604,2671,5058,12,64042,3557,1,0
63,1225,1660,832,1314,41,38,274,1701,20,312,209,395,332,604,2671,5058,12,64042,3557,1,0
63,2373,1660,832,1314,41,38,274,1701,20,312,209,395,332,604,2671,5058,12,64042,3557,1,0
48,451,647,139,84,35,284,233,682,0,0,0,0,0,0,0,0,0,0,0,0,0
217,4699,72,33,56,0,4,12,72,1,1,1,1,2,2,0,2,0,1,0,0,0
217,4699,1454,835,1044,76,110,219,1530,17,275,158,296,292,454,2297,3718,9,34017,1889,1,0
68,2438,1660,832,1314,41,38,274,1701,20,312,209,395,332,604,2671,5058,12,64042,3557,1,0
60,1255,1450,624,1228,12,26,181,1462,14,306,186,354,320,540,2580,4493,8,36391,2021,1,0
68,2414,1660,832,1314,41,38,274,1701,20,312,209,395,332,604,2671,5058,12,64042,3557,1,0
69,2432,1660,832,1314,41,38,274,1701,20,312,209,395,332,604,2671,5058,12,64042,3557,1,0
63,1270,1660,832,1314,41,38,274,1701,20,312,209,395,332,604,2671,5058,12,64042,3557,1,0
69,2456,1660,832,1314,41,38,274,1701,20,312,209,395,332,604,2671,5058,12,64042,3557,1,1
63,1306,1660,832,1314,41,38,274,1701,20,312,209,395,332,604,2671,5058,12,64042,3557,1,1
69,2456,1660,832,1314,41,38,274,1701,20,312,209,395,332,604,2671,5058,12,64042,3557,1,0
70,2461,1660,832,1314,41,38,274,1701,20,312,209,395,332,604,2671,5058,12,64042,3557,1,1
64,1371,1660,832,1314,41,38,274,1701,20,312,209,395,332,604,2671,5058,12,64042,3557,1,1
61,1266,1450,624,1228,12,26,181,1462,14,306,186,354,320,540,2580,4493,8,36391,2021,1,1
30,1106,1450,624,1228,12,26,181,1462,14,306,186,354,320,540,2580,4493,8,36391,2021,1,0
71,2472,1660,832,1314,41,38,274,1701,20,312,209,395,332,604,2671,5058,12,64042,3557,1,0
70,1443,1660,832,1314,41,38,274,1701,20,312,209,395,332,604,2671,5058,12,64042,3557,1,0
70,1449,1660,832,1314,41,38,274,1701,20,312,209,395,332,604,2671,5058,12,64042,3557,1,1
71,2475,1660,832,1314,41,38,274,1701,20,312,209,395,332,604,2671,5058,12,64042,3557,1,0
70,1452,1660,832,1314,41,38,274,1701,20,312,209,395,332,604,2671,5058,12,64042,3557,1,1
217,4701,72,33,56,0,4,12,72,1,1,1,1,2,2,0,2,0,1,0,0,0
217,4701,1454,835,1044,76,110,219,1530,17,275,158,296,292,454,2297,3718,9,34017,1889,1,0
61,1268,2,2,2,0,0,0,2,0,0,0,0,0,0,0,0,0,0,0,0,0
61,1268,99,48,90,1,3,5,100,0,0,0,0,0,0,0,0,0,0,0,0,0
61,1268,8,5,5,2,0,1,10,0,0,0,0,0,0,0,0,0,0,0,0,0
61,1268,1217,716,841,84,126,174,1301,14,185,118,215,199,333,1446,2542,8,20687,1149,0,0
61,1268,160,89,115,0,13,31,160,7,15,11,17,22,28,78,124,3,495,27,0,0
61,1268,10,10,9,9,0,0,19,0,0,0,0,0,0,0,0,0,0,0,0,0
61,1268,173,84,99,8,29,36,181,5,12,7,13,17,20,54,81,2,221,12,0,0
61,1268,3,1,1,3,0,0,6,0,0,0,0,0,0,0,0,0,0,0,0,0
71,2475,1057,646,719,113,100,145,1170,18,215,134,248,233,382,1740,3004,10,31186,1732,1,0
70,1454,1660,832,1314,41,38,274,1701,20,312,209,395,332,604,2671,5058,12,64042,3557,1,0
71,1528,2,2,2,0,0,0,2,0,0,0,0,0,0,0,0,0,0,0,0,1
71,1528,99,48,90,1,3,5,100,0,0,0,0,0,0,0,0,0,0,0,0,1
71,1528,8,5,5,2,0,1,10,0,0,0,0,0,0,0,0,0,0,0,0,1
71,1528,1217,716,841,84,126,174,1301,14,185,118,215,199,333,1446,2542,8,20687,1149,0,1
71,1528,160,89,115,0,13,31,160,7,15,11,17,22,28,78,124,3,495,27,0,1
71,1528,10,10,9,9,0,0,19,0,0,0,0,0,0,0,0,0,0,0,0,1
71,1528,173,84,99,8,29,36,181,5,12,7,13,17,20,54,81,2,221,12,0,1
71,1528,3,1,1,3,0,0,6,0,0,0,0,0,0,0,0,0,0,0,0,1
71,2478,1660,832,1314,41,38,274,1701,20,312,209,395,332,604,2671,5058,12,64042,3557,1,1
71,2478,1057,646,719,113,100,145,1170,18,215,134,248,233,382,1740,3004,10,31186,1732,1,1
30,1102,1450,624,1228,12,26,181,1462,14,306,186,354,320,540,2580,4493,8,36391,2021,1,1
70,1450,1660,832,1314,41,38,274,1701,20,312,209,395,332,604,2671,5058,12,64042,3557,1,1
20,449,2,2,2,0,0,0,2,0,0,0,0,0,0,0,0,0,0,0,0,1
20,449,99,48,90,1,3,5,100,0,0,0,0,0,0,0,0,0,0,0,0,1
20,449,8,5,5,2,0,1,10,0,0,0,0,0,0,0,0,0,0,0,0,1
20,449,1217,716,841,84,126,174,1301,14,185,118,215,199,333,1446,2542,8,20687,1149,0,1
20,449,160,89,115,0,13,31,160,7,15,11,17,22,28,78,124,3,495,27,0,1
20,449,10,10,9,9,0,0,19,0,0,0,0,0,0,0,0,0,0,0,0,1
20,449,173,84,99,8,29,36,181,5,12,7,13,17,20,54,81,2,221,12,0,1
20,449,3,1,1,3,0,0,6,0,0,0,0,0,0,0,0,0,0,0,0,1
71,2471,1660,832,1314,41,38,274,1701,20,312,209,395,332,604,2671,5058,12,64042,3557,1,1
71,2471,1057,646,719,113,100,145,1170,18,215,134,248,233,382,1740,3004,10,31186,1732,1,1
30,1104,1450,624,1228,12,26,181,1462,14,306,186,354,320,540,2580,4493,8,36391,2021,1,1
20,449,2,2,2,0,0,0,2,0,0,0,0,0,0,0,0,0,0,0,0,0
20,449,99,48,90,1,3,5,100,0,0,0,0,0,0,0,0,0,0,0,0,0
20,449,8,5,5,2,0,1,10,0,0,0,0,0,0,0,0,0,0,0,0,0
20,449,1217,716,841,84,126,174,1301,14,185,118,215,199,333,1446,2542,8,20687,1149,0,0
20,449,160,89,115,0,13,31,160,7,15,11,17,22,28,78,124,3,495,27,0,0
20,449,10,10,9,9,0,0,19,0,0,0,0,0,0,0,0,0,0,0,0,0
20,449,173,84,99,8,29,36,181,5,12,7,13,17,20,54,81,2,221,12,0,0
20,449,3,1,1,3,0,0,6,0,0,0,0,0,0,0,0,0,0,0,0,0
51,1084,477,336,357,30,23,73,507,16,194,134,250,210,384,1538,2962,10,30538,1696,0,1
24,552,2,2,2,0,0,0,2,0,0,0,0,0,0,0,0,0,0,0,0,1
24,552,99,48,90,1,3,5,100,0,0,0,0,0,0,0,0,0,0,0,0,1
24,552,8,5,5,2,0,1,10,0,0,0,0,0,0,0,0,0,0,0,0,1
24,552,1217,716,841,84,126,174,1301,14,185,118,215,199,333,1446,2542,8,20687,1149,0,1
24,552,160,89,115,0,13,31,160,7,15,11,17,22,28,78,124,3,495,27,0,1
24,552,10,10,9,9,0,0,19,0,0,0,0,0,0,0,0,0,0,0,0,1
24,552,173,84,99,8,29,36,181,5,12,7,13,17,20,54,81,2,221,12,0,1
24,552,3,1,1,3,0,0,6,0,0,0,0,0,0,0,0,0,0,0,0,1
38,936,74,35,59,1,0,14,75,3,14,7,14,17,21,58,85,1,128,7,0,1
38,936,245,125,200,5,7,34,250,7,30,17,34,37,51,166,265,3,1053,58,0,1
34,1230,1450,624,1228,12,26,181,1462,14,306,186,354,320,540,2580,4493,8,36391,2021,1,1
25,694,2,2,2,0,0,0,2,0,0,0,0,0,0,0,0,0,0,0,0,0
25,694,99,48,90,1,3,5,100,0,0,0,0,0,0,0,0,0,0,0,0,0
25,694,8,5,5,2,0,1,10,0,0,0,0,0,0,0,0,0,0,0,0,0
25,694,1217,716,841,84,126,174,1301,14,185,118,215,199,333,1446,2542,8,20687,1149,0,0
25,694,160,89,115,0,13,31,160,7,15,11,17,22,28,78,124,3,495,27,0,0
25,694,10,10,9,9,0,0,19,0,0,0,0,0,0,0,0,0,0,0,0,0
25,694,173,84,99,8,29,36,181,5,12,7,13,17,20,54,81,2,221,12,0,0
25,694,3,1,1,3,0,0,6,0,0,0,0,0,0,0,0,0,0,0,0,0
43,2933,1296,573,1062,40,33,157,1336,8,201,118,231,209,349,1561,2689,4,12365,686,0,0
185,4381,722,423,573,19,0,135,741,12,172,101,199,184,300,1320,2257,6,15668,870,0,1
185,4381,1508,847,911,44,250,301,1552,14,148,88,169,162,257,1120,1886,7,15077,837,0,1
217,4703,72,33,56,0,4,12,72,1,1,1,1,2,2,0,2,0,1,0,0,1
217,4703,1454,835,1044,76,110,219,1530,17,275,158,296,292,454,2297,3718,9,34017,1889,1,1
86,1908,1043,504,840,53,9,147,1096,9,180,112,198,189,310,1377,2344,4,11604,644,0,1
86,1908,383,288,292,26,6,62,409,11,65,38,67,76,105,429,656,5,3719,206,0,1
26,708,2,2,2,0,0,0,2,0,0,0,0,0,0,0,0,0,0,0,0,0
26,708,99,48,90,1,3,5,100,0,0,0,0,0,0,0,0,0,0,0,0,0
26,708,8,5,5,2,0,1,10,0,0,0,0,0,0,0,0,0,0,0,0,0
26,708,1217,716,841,84,126,174,1301,14,185,118,215,199,333,1446,2542,8,20687,1149,0,0
26,708,160,89,115,0,13,31,160,7,15,11,17,22,28,78,124,3,495,27,0,0
26,708,10,10,9,9,0,0,19,0,0,0,0,0,0,0,0,0,0,0,0,0
26,708,173,84,99,8,29,36,181,5,12,7,13,17,20,54,81,2,221,12,0,0
26,708,3,1,1,3,0,0,6,0,0,0,0,0,0,0,0,0,0,0,0,0
185,4406,722,423,573,19,0,135,741,12,172,101,199,184,300,1320,2257,6,15668,870,0,0
185,4406,1508,847,911,44,250,301,1552,14,148,88,169,162,257,1120,1886,7,15077,837,0,0
49,458,647,139,84,35,284,233,682,0,0,0,0,0,0,0,0,0,0,0,0,0
218,4722,72,33,56,0,4,12,72,1,1,1,1,2,2,0,2,0,1,0,0,0
218,4722,1454,835,1044,76,110,219,1530,17,275,158,296,292,454,2297,3718,9,34017,1889,1,0
50,465,647,139,84,35,284,233,682,0,0,0,0,0,0,0,0,0,0,0,0,0
139,3230,77,34,69,0,0,8,77,3,24,16,29,27,45,114,213,1,387,21,0,0
139,3230,712,438,573,51,9,84,763,14,102,71,128,116,199,733,1364,8,11988,666,0,0
139,3237,77,34,69,0,0,8,77,3,24,16,29,27,45,114,213,1,387,21,0,1
139,3237,712,438,573,51,9,84,763,14,102,71,128,116,199,733,1364,8,11988,666,0,1
141,3267,77,34,69,0,0,8,77,3,24,16,29,27,45,114,213,1,387,21,0,1
141,3267,712,438,573,51,9,84,763,14,102,71,128,116,199,733,1364,8,11988,666,0,1
219,4731,72,33,56,0,4,12,72,1,1,1,1,2,2,0,2,0,1,0,0,1
219,4731,1454,835,1044,76,110,219,1530,17,275,158,296,292,454,2297,3718,9,34017,1889,1,1
49,458,647,139,84,35,284,233,682,0,0,0,0,0,0,0,0,0,0,0,0,1
140,3253,77,34,69,0,0,8,77,3,24,16,29,27,45,114,213,1,387,21,0,1
140,3253,712,438,573,51,9,84,763,14,102,71,128,116,199,733,1364,8,11988,666,0,1
142,3276,77,34,69,0,0,8,77,3,24,16,29,27,45,114,213,1,387,21,0,1
142,3276,712,438,573,51,9,84,763,14,102,71,128,116,199,733,1364,8,11988,666,0,1
29,742,2,2,2,0,0,0,2,0,0,0,0,0,0,0,0,0,0,0,0,0
29,742,99,48,90,1,3,5,100,0,0,0,0,0,0,0,0,0,0,0,0,0
29,742,8,5,5,2,0,1,10,0,0,0,0,0,0,0,0,0,0,0,0,0
29,742,1217,716,841,84,126,174,1301,14,185,118,215,199,333,1446,2542,8,20687,1149,0,0
29,742,160,89,115,0,13,31,160,7,15,11,17,22,28,78,124,3,495,27,0,0
29,742,10,10,9,9,0,0,19,0,0,0,0,0,0,0,0,0,0,0,0,0
29,742,173,84,99,8,29,36,181,5,12,7,13,17,20,54,81,2,221,12,0,0
29,742,3,1,1,3,0,0,6,0,0,0,0,0,0,0,0,0,0,0,0,0
47,444,647,139,84,35,284,233,682,0,0,0,0,0,0,0,0,0,0,0,0,0
218,4707,72,33,56,0,4,12,72,1,1,1,1,2,2,0,2,0,1,0,0,0
218,4707,1454,835,1044,76,110,219,1530,17,275,158,296,292,454,2297,3718,9,34017,1889,1,0
35,1250,1450,624,1228,12,26,181,1462,14,306,186,354,320,540,2580,4493,8,36391,2021,1,0
29,742,2,2,2,0,0,0,2,0,0,0,0,0,0,0,0,0,0,0,0,1
29,742,99,48,90,1,3,5,100,0,0,0,0,0,0,0,0,0,0,0,0,1
29,742,8,5,5,2,0,1,10,0,0,0,0,0,0,0,0,0,0,0,0,1
29,742,1217,716,841,84,126,174,1301,14,185,118,215,199,333,1446,2542,8,20687,1149,0,1
29,742,160,89,115,0,13,31,160,7,15,11,17,22,28,78,124,3,495,27,0,1
29,742,10,10,9,9,0,0,19,0,0,0,0,0,0,0,0,0,0,0,0,1
29,742,173,84,99,8,29,36,181,5,12,7,13,17,20,54,81,2,221,12,0,1
29,742,3,1,1,3,0,0,6,0,0,0,0,0,0,0,0,0,0,0,0,1
72,2533,1660,832,1314,41,38,274,1701,20,312,209,395,332,604,2671,5058,12,64042,3557,1,1
72,2533,1057,646,719,113,100,145,1170,18,215,134,248,233,382,1740,3004,10,31186,1732,1,1
40,1258,1523,757,1297,19,12,193,1542,12,193,117,230,205,347,1508,2664,7,19053,1058,0,1
40,1258,701,378,504,33,58,109,734,13,110,68,126,123,194,794,1346,7,10027,557,0,1
29,1824,1523,757,1297,19,12,193,1542,12,193,117,230,205,347,1508,2664,7,19053,1058,0,1
40,1252,1523,757,1297,19,12,193,1542,12,193,117,230,205,347,1508,2664,7,19053,1058,0,1
40,1252,701,378,504,33,58,109,734,13,110,68,126,123,194,794,1346,7,10027,557,0,1
30,1887,1523,757,1297,19,12,193,1542,12,193,117,230,205,347,1508,2664,7,19053,1058,0,1
18,628,1455,414,1257,16,76,112,1471,5,41,23,46,46,69,231,381,2,1069,59,0,1
18,628,669,365,481,22,61,110,691,15,103,63,122,118,185,747,1273,8,11311,628,0,1
11,473,1455,414,1257,16,76,112,1471,5,41,23,46,46,69,231,381,2,1069,59,0,1
40,1262,1523,757,1297,19,12,193,1542,12,193,117,230,205,347,1508,2664,7,19053,1058,0,1
40,1262,701,378,504,33,58,109,734,13,110,68,126,123,194,794,1346,7,10027,557,0,1
30,1873,1523,757,1297,19,12,193,1542,12,193,117,230,205,347,1508,2664,7,19053,1058,0,1
30,1880,1523,757,1297,19,12,193,1542,12,193,117,230,205,347,1508,2664,7,19053,1058,0,0
30,1887,1523,757,1297,19,12,193,1542,12,193,117,230,205,347,1508,2664,7,19053,1058,0,0
25,697,2,2,2,0,0,0,2,0,0,0,0,0,0,0,0,0,0,0,0,1
25,697,99,48,90,1,3,5,100,0,0,0,0,0,0,0,0,0,0,0,0,1
25,697,8,5,5,2,0,1,10,0,0,0,0,0,0,0,0,0,0,0,0,1
25,697,1217,716,841,84,126,174,1301,14,185,118,215,199,333,1446,2542,8,20687,1149,0,1
25,697,160,89,115,0,13,31,160,7,15,11,17,22,28,78,124,3,495,27,0,1
25,697,10,10,9,9,0,0,19,0,0,0,0,0,0,0,0,0,0,0,0,1
25,697,173,84,99,8,29,36,181,5,12,7,13,17,20,54,81,2,221,12,0,1
25,697,3,1,1,3,0,0,6,0,0,0,0,0,0,0,0,0,0,0,0,1
46,437,647,139,84,35,284,233,682,0,0,0,0,0,0,0,0,0,0,0,0,1
218,4708,72,33,56,0,4,12,72,1,1,1,1,2,2,0,2,0,1,0,0,1
218,4708,1454,835,1044,76,110,219,1530,17,275,158,296,292,454,2297,3718,9,34017,1889,1,1
11,475,1455,414,1257,16,76,112,1471,5,41,23,46,46,69,231,381,2,1069,59,0,0
185,4406,722,423,573,19,0,135,741,12,172,101,199,184,300,1320,2257,6,15668,870,0,1
185,4406,1508,847,911,44,250,301,1552,14,148,88,169,162,257,1120,1886,7,15077,837,0,1
35,1250,1450,624,1228,12,26,181,1462,14,306,186,354,320,540,2580,4493,8,36391,2021,1,1
218,4708,72,33,56,0,4,12,72,1,1,1,1,2,2,0,2,0,1,0,0,0
218,4708,1454,835,1044,76,110,219,1530,17,275,158,296,292,454,2297,3718,9,34017,1889,1,0
6,288,42,7,35,4,0,5,46,1,2,1,2,3,3,2,4,0,2,0,0,0
6,288,11,6,10,0,0,1,11,2,4,2,4,6,6,10,15,1,15,0,0,0
6,288,42,7,35,4,0,5,46,1,2,1,2,3,3,2,4,0,2,0,0,1
6,288,11,6,10,0,0,1,11,2,4,2,4,6,6,10,15,1,15,0,0,1
36,1391,1020,354,843,12,15,144,1032,8,134,77,144,142,221,970,1580,4,6792,377,0,1
144,3295,77,34,69,0,0,8,77,3,24,16,29,27,45,114,213,1,387,21,0,1
144,3295,712,438,573,51,9,84,763,14,102,71,128,116,199,733,1364,8,11988,666,0,1
43,1893,1289,550,1043,56,32,155,1345,10,167,93,185,177,278,1266,2075,5,11498,638,0,1
217,4685,72,33,56,0,4,12,72,1,1,1,1,2,2,0,2,0,1,0,0,1
217,4685,1454,835,1044,76,110,219,1530,17,275,158,296,292,454,2297,3718,9,34017,1889,1,1
25,697,2,2,2,0,0,0,2,0,0,0,0,0,0,0,0,0,0,0,0,0
25,697,99,48,90,1,3,5,100,0,0,0,0,0,0,0,0,0,0,0,0,0
25,697,8,5,5,2,0,1,10,0,0,0,0,0,0,0,0,0,0,0,0,0
25,697,1217,716,841,84,126,174,1301,14,185,118,215,199,333,1446,2542,8,20687,1149,0,0
25,697,160,89,115,0,13,31,160,7,15,11,17,22,28,78,124,3,495,27,0,0
25,697,10,10,9,9,0,0,19,0,0,0,0,0,0,0,0,0,0,0,0,0
25,697,173,84,99,8,29,36,181,5,12,7,13,17,20,54,81,2,221,12,0,0
25,697,3,1,1,3,0,0,6,0,0,0,0,0,0,0,0,0,0,0,0,0
58,1208,477,336,357,30,23,73,507,16,194,134,250,210,384,1538,2962,10,30538,1696,0,1
71,1508,1660,832,1314,41,38,274,1701,20,312,209,395,332,604,2671,5058,12,64042,3557,1,1
75,2768,1660,832,1314,41,38,274,1701,20,312,209,395,332,604,2671,5058,12,64042,3557,1,1
75,2768,1057,646,719,113,100,145,1170,18,215,134,248,233,382,1740,3004,10,31186,1732,1,1
75,1550,1660,832,1314,41,38,274,1701,20,312,209,395,332,604,2671,5058,12,64042,3557,1,1
75,2763,1660,832,1314,41,38,274,1701,20,312,209,395,332,604,2671,5058,12,64042,3557,1,0
75,2763,1057,646,719,113,100,145,1170,18,215,134,248,233,382,1740,3004,10,31186,1732,1,0
27,581,2,2,2,0,0,0,2,0,0,0,0,0,0,0,0,0,0,0,0,1
27,581,99,48,90,1,3,5,100,0,0,0,0,0,0,0,0,0,0,0,0,1
27,581,8,5,5,2,0,1,10,0,0,0,0,0,0,0,0,0,0,0,0,1
27,581,1217,716,841,84,126,174,1301,14,185,118,215,199,333,1446,2542,8,20687,1149,0,1
27,581,160,89,115,0,13,31,160,7,15,11,17,22,28,78,124,3,495,27,0,1
27,581,10,10,9,9,0,0,19,0,0,0,0,0,0,0,0,0,0,0,0,1
27,581,173,84,99,8,29,36,181,5,12,7,13,17,20,54,81,2,221,12,0,1
27,581,3,1,1,3,0,0,6,0,0,0,0,0,0,0,0,0,0,0,0,1
111,3586,1660,832,1314,41,38,274,1701,20,312,209,395,332,604,2671,5058,12,64042,3557,1,1
111,3586,1057,646,719,113,100,145,1170,18,215,134,248,233,382,1740,3004,10,31186,1732,1,1
216,4665,72,33,56,0,4,12,72,1,1,1,1,2,2,0,2,0,1,0,0,1
216,4665,1454,835,1044,76,110,219,1530,17,275,158,296,292,454,2297,3718,9,34017,1889,1,1
35,1267,1450,624,1228,12,26,181,1462,14,306,186,354,320,540,2580,4493,8,36391,2021,1,1
111,3593,1660,832,1314,41,38,274,1701,20,312,209,395,332,604,2671,5058,12,64042,3557,1,0
111,3593,1057,646,719,113,100,145,1170,18,215,134,248,233,382,1740,3004,10,31186,1732,1,0
35,1267,1450,624,1228,12,26,181,1462,14,306,186,354,320,540,2580,4493,8,36391,2021,1,0
111,3596,1660,832,1314,41,38,274,1701,20,312,209,395,332,604,2671,5058,12,64042,3557,1,0
111,3596,1057,646,719,113,100,145,1170,18,215,134,248,233,382,1740,3004,10,31186,1732,1,0
110,3591,1660,832,1314,41,38,274,1701,20,312,209,395,332,604,2671,5058,12,64042,3557,1,0
110,3591,1057,646,719,113,100,145,1170,18,215,134,248,233,382,1740,3004,10,31186,1732,1,0
35,1269,1450,624,1228,12,26,181,1462,14,306,186,354,320,540,2580,4493,8,36391,2021,1,0
27,578,2,2,2,0,0,0,2,0,0,0,0,0,0,0,0,0,0,0,0,1
27,578,99,48,90,1,3,5,100,0,0,0,0,0,0,0,0,0,0,0,0,1
27,578,8,5,5,2,0,1,10,0,0,0,0,0,0,0,0,0,0,0,0,1
27,578,1217,716,841,84,126,174,1301,14,185,118,215,199,333,1446,2542,8,20687,1149,0,1
27,578,160,89,115,0,13,31,160,7,15,11,17,22,28,78,124,3,495,27,0,1
27,578,10,10,9,9,0,0,19,0,0,0,0,0,0,0,0,0,0,0,0,1
27,578,173,84,99,8,29,36,181,5,12,7,13,17,20,54,81,2,221,12,0,1
27,578,3,1,1,3,0,0,6,0,0,0,0,0,0,0,0,0,0,0,0,1
35,1271,1450,624,1228,12,26,181,1462,14,306,186,354,320,540,2580,4493,8,36391,2021,1,1
25,553,2,2,2,0,0,0,2,0,0,0,0,0,0,0,0,0,0,0,0,1
25,553,99,48,90,1,3,5,100,0,0,0,0,0,0,0,0,0,0,0,0,1
25,553,8,5,5,2,0,1,10,0,0,0,0,0,0,0,0,0,0,0,0,1
25,553,1217,716,841,84,126,174,1301,14,185,118,215,199,333,1446,2542,8,20687,1149,0,1
25,553,160,89,115,0,13,31,160,7,15,11,17,22,28,78,124,3,495,27,0,1
25,553,10,10,9,9,0,0,19,0,0,0,0,0,0,0,0,0,0,0,0,1
25,553,173,84,99,8,29,36,181,5,12,7,13,17,20,54,81,2,221,12,0,1
25,553,3,1,1,3,0,0,6,0,0,0,0,0,0,0,0,0,0,0,0,1
33,1221,1450,624,1228,12,26,181,1462,14,306,186,354,320,540,2580,4493,8,36391,2021,1,1
25,553,2,2,2,0,0,0,2,0,0,0,0,0,0,0,0,0,0,0,0,0
25,553,99,48,90,1,3,5,100,0,0,0,0,0,0,0,0,0,0,0,0,0
25,553,8,5,5,2,0,1,10,0,0,0,0,0,0,0,0,0,0,0,0,0
25,553,1217,716,841,84,126,174,1301,14,185,118,215,199,333,1446,2542,8,20687,1149,0,0
25,553,160,89,115,0,13,31,160,7,15,11,17,22,28,78,124,3,495,27,0,0
25,553,10,10,9,9,0,0,19,0,0,0,0,0,0,0,0,0,0,0,0,0
25,553,173,84,99,8,29,36,181,5,12,7,13,17,20,54,81,2,221,12,0,0
25,553,3,1,1,3,0,0,6,0,0,0,0,0,0,0,0,0,0,0,0,0
111,3633,1660,832,1314,41,38,274,1701,20,312,209,395,332,604,2671,5058,12,64042,3557,1,0
111,3633,1057,646,719,113,100,145,1170,18,215,134,248,233,382,1740,3004,10,31186,1732,1,0
17,283,424,94,331,4,0,89,428,1,5,5,5,6,10,11,25,0,12,0,0,1
17,283,38,23,23,6,0,8,44,3,11,7,11,14,18,42,68,1,102,5,0,1
10,342,424,94,331,4,0,89,428,1,5,5,5,6,10,11,25,0,12,0,0,1
141,2829,1943,715,1694,26,18,214,1969,12,185,120,237,197,357,1436,2721,7,20915,1161,0,0
141,2829,1168,838,957,57,25,144,1225,19,348,224,416,367,640,3018,5452,11,61921,3440,1,0
1,189,382,65,130,157,2,92,539,4,10,5,10,14,15,41,57,2,114,6,0,0
1,187,382,65,130,157,2,92,539,4,10,5,10,14,15,41,57,2,114,6,0,0
1,187,382,65,130,157,2,92,539,4,10,5,10,14,15,41,57,2,114,6,0,1
23,509,2,2,2,0,0,0,2,0,0,0,0,0,0,0,0,0,0,0,0,1
23,509,99,48,90,1,3,5,100,0,0,0,0,0,0,0,0,0,0,0,0,1
23,509,8,5,5,2,0,1,10,0,0,0,0,0,0,0,0,0,0,0,0,1
23,509,1217,716,841,84,126,174,1301,14,185,118,215,199,333,1446,2542,8,20687,1149,0,1
23,509,160,89,115,0,13,31,160,7,15,11,17,22,28,78,124,3,495,27,0,1
23,509,10,10,9,9,0,0,19,0,0,0,0,0,0,0,0,0,0,0,0,1
23,509,173,84,99,8,29,36,181,5,12,7,13,17,20,54,81,2,221,12,0,1
23,509,3,1,1,3,0,0,6,0,0,0,0,0,0,0,0,0,0,0,0,1
109,3599,1660,832,1314,41,38,274,1701,20,312,209,395,332,604,2671,5058,12,64042,3557,1,1
109,3599,1057,646,719,113,100,145,1170,18,215,134,248,233,382,1740,3004,10,31186,1732,1,1
32,1156,1450,624,1228,12,26,181,1462,14,306,186,354,320,540,2580,4493,8,36391,2021,1,1
109,3605,1660,832,1314,41,38,274,1701,20,312,209,395,332,604,2671,5058,12,64042,3557,1,1
109,3605,1057,646,719,113,100,145,1170,18,215,134,248,233,382,1740,3004,10,31186,1732,1,1
10,333,295,56,236,0,4,54,295,2,9,5,10,11,15,30,51,1,57,3,0,0
143,2852,1943,715,1694,26,18,214,1969,12,185,120,237,197,357,1436,2721,7,20915,1161,0,1
143,2852,1168,838,957,57,25,144,1225,19,348,224,416,367,640,3018,5452,11,61921,3440,1,1
53,2478,1943,715,1694,26,18,214,1969,12,185,120,237,197,357,1436,2721,7,20915,1161,0,1
1,184,382,65,130,157,2,92,539,4,10,5,10,14,15,41,57,2,114,6,0,0
110,3625,1660,832,1314,41,38,274,1701,20,312,209,395,332,604,2671,5058,12,64042,3557,1,1
110,3625,1057,646,719,113,100,145,1170,18,215,134,248,233,382,1740,3004,10,31186,1732,1,1
110,3649,1660,832,1314,41,38,274,1701,20,312,209,395,332,604,2671,5058,12,64042,3557,1,0
110,3649,1057,646,719,113,100,145,1170,18,215,134,248,233,382,1740,3004,10,31186,1732,1,0
6,298,42,7,35,4,0,5,46,1,2,1,2,3,3,2,4,0,2,0,0,1
6,298,11,6,10,0,0,1,11,2,4,2,4,6,6,10,15,1,15,0,0,1
6,286,42,7,35,4,0,5,46,1,2,1,2,3,3,2,4,0,2,0,0,0
6,286,11,6,10,0,0,1,11,2,4,2,4,6,6,10,15,1,15,0,0,0
110,3652,1660,832,1314,41,38,274,1701,20,312,209,395,332,604,2671,5058,12,64042,3557,1,0
110,3652,1057,646,719,113,100,145,1170,18,215,134,248,233,382,1740,3004,10,31186,1732,1,0
79,1590,1660,832,1314,41,38,274,1701,20,312,209,395,332,604,2671,5058,12,64042,3557,1,0
78,1584,1660,832,1314,41,38,274,1701,20,312,209,395,332,604,2671,5058,12,64042,3557,1,0
6,286,42,7,35,4,0,5,46,1,2,1,2,3,3,2,4,0,2,0,0,1
6,286,11,6,10,0,0,1,11,2,4,2,4,6,6,10,15,1,15,0,0,1
68,1200,1513,682,1277,25,13,200,1538,11,199,116,219,210,335,1557,2584,6,15641,868,0,1
68,1200,819,519,539,24,98,155,843,15,96,57,106,111,163,690,1107,8,9171,509,0,1
42,1319,1523,757,1297,19,12,193,1542,12,193,117,230,205,347,1508,2664,7,19053,1058,0,1
42,1319,701,378,504,33,58,109,734,13,110,68,126,123,194,794,1346,7,10027,557,0,1
86,1940,1043,504,840,53,9,147,1096,9,180,112,198,189,310,1377,2344,4,11604,644,0,1
86,1940,383,288,292,26,6,62,409,11,65,38,67,76,105,429,656,5,3719,206,0,1
146,2909,1943,715,1694,26,18,214,1969,12,185,120,237,197,357,1436,2721,7,20915,1161,0,1
146,2909,1168,838,957,57,25,144,1225,19,348,224,416,367,640,3018,5452,11,61921,3440,1,1
30,1925,1523,757,1297,19,12,193,1542,12,193,117,230,205,347,1508,2664,7,19053,1058,0,1
54,2487,1943,715,1694,26,18,214,1969,12,185,120,237,197,357,1436,2721,7,20915,1161,0,1
113,3706,1660,832,1314,41,38,274,1701,20,312,209,395,332,604,2671,5058,12,64042,3557,1,1
113,3706,1057,646,719,113,100,145,1170,18,215,134,248,233,382,1740,3004,10,31186,1732,1,1
79,1630,1660,832,1314,41,38,274,1701,20,312,209,395,332,604,2671,5058,12,64042,3557,1,1
42,1306,1523,757,1297,19,12,193,1542,12,193,117,230,205,347,1508,2664,7,19053,1058,0,1
42,1306,701,378,504,33,58,109,734,13,110,68,126,123,194,794,1346,7,10027,557,0,1
114,3710,1660,832,1314,41,38,274,1701,20,312,209,395,332,604,2671,5058,12,64042,3557,1,1
114,3710,1057,646,719,113,100,145,1170,18,215,134,248,233,382,1740,3004,10,31186,1732,1,1
80,1664,1660,832,1314,41,38,274,1701,20,312,209,395,332,604,2671,5058,12,64042,3557,1,1
42,1306,1523,757,1297,19,12,193,1542,12,193,117,230,205,347,1508,2664,7,19053,1058,0,0
42,1306,701,378,504,33,58,109,734,13,110,68,126,123,194,794,1346,7,10027,557,0,0
30,1925,1523,757,1297,19,12,193,1542,12,193,117,230,205,347,1508,2664,7,19053,1058,0,0
81,1691,1660,832,1314,41,38,274,1701,20,312,209,395,332,604,2671,5058,12,64042,3557,1,1
82,1720,1660,832,1314,41,38,274,1701,20,312,209,395,332,604,2671,5058,12,64042,3557,1,0
136,2683,1457,730,1242,11,6,188,1468,10,292,166,329,302,495,2424,4078,5,22973,1276,1,1
136,2683,74,35,59,1,0,14,75,3,14,7,14,17,21,58,85,1,128,7,0,1
136,2683,245,125,200,5,7,34,250,7,30,17,34,37,51,166,265,3,1053,58,0,1
42,1096,74,35,59,1,0,14,75,3,14,7,14,17,21,58,85,1,128,7,0,1
42,1096,245,125,200,5,7,34,250,7,30,17,34,37,51,166,265,3,1053,58,0,1
11,350,74,35,59,1,0,14,75,3,14,7,14,17,21,58,85,1,128,7,0,1
52,2415,1943,715,1694,26,18,214,1969,12,185,120,237,197,357,1436,2721,7,20915,1161,0,1
115,3763,1660,832,1314,41,38,274,1701,20,312,209,395,332,604,2671,5058,12,64042,3557,1,1
115,3763,1057,646,719,113,100,145,1170,18,215,134,248,233,382,1740,3004,10,31186,1732,1,1
1,191,382,65,130,157,2,92,539,4,10,5,10,14,15,41,57,2,114,6,0,0
24,527,2,2,2,0,0,0,2,0,0,0,0,0,0,0,0,0,0,0,0,1
24,527,99,48,90,1,3,5,100,0,0,0,0,0,0,0,0,0,0,0,0,1
24,527,8,5,5,2,0,1,10,0,0,0,0,0,0,0,0,0,0,0,0,1
24,527,1217,716,841,84,126,174,1301,14,185,118,215,199,333,1446,2542,8,20687,1149,0,1
24,527,160,89,115,0,13,31,160,7,15,11,17,22,28,78,124,3,495,27,0,1
24,527,10,10,9,9,0,0,19,0,0,0,0,0,0,0,0,0,0,0,0,1
24,527,173,84,99,8,29,36,181,5,12,7,13,17,20,54,81,2,221,12,0,1
24,527,3,1,1,3,0,0,6,0,0,0,0,0,0,0,0,0,0,0,0,1
84,1745,1660,832,1314,41,38,274,1701,20,312,209,395,332,604,2671,5058,12,64042,3557,1,1
84,1745,1660,832,1314,41,38,274,1701,20,312,209,395,332,604,2671,5058,12,64042,3557,1,0
84,1747,1660,832,1314,41,38,274,1701,20,312,209,395,332,604,2671,5058,12,64042,3557,1,0
84,1759,1660,832,1314,41,38,274,1701,20,312,209,395,332,604,2671,5058,12,64042,3557,1,1
120,3799,1660,832,1314,41,38,274,1701,20,312,209,395,332,604,2671,5058,12,64042,3557,1,1
120,3799,1057,646,719,113,100,145,1170,18,215,134,248,233,382,1740,3004,10,31186,1732,1,1
87,1884,1660,832,1314,41,38,274,1701,20,312,209,395,332,604,2671,5058,12,64042,3557,1,1
120,3797,1660,832,1314,41,38,274,1701,20,312,209,395,332,604,2671,5058,12,64042,3557,1,0
120,3797,1057,646,719,113,100,145,1170,18,215,134,248,233,382,1740,3004,10,31186,1732,1,0
22,519,1293,570,1093,25,15,163,1318,10,195,123,241,205,364,1516,2795,6,17273,959,0,0
17,678,1293,570,1093,25,15,163,1318,10,195,123,241,205,364,1516,2795,6,17273,959,0,0
122,3814,1660,832,1314,41,38,274,1701,20,312,209,395,332,604,2671,5058,12,64042,3557,1,1
122,3814,1057,646,719,113,100,145,1170,18,215,134,248,233,382,1740,3004,10,31186,1732,1,1
124,3828,1660,832,1314,41,38,274,1701,20,312,209,395,332,604,2671,5058,12,64042,3557,1,0
124,3828,1057,646,719,113,100,145,1170,18,215,134,248,233,382,1740,3004,10,31186,1732,1,0
43,1893,1289,550,1043,56,32,155,1345,10,167,93,185,177,278,1266,2075,5,11498,638,0,0
120,3818,1660,832,1314,41,38,274,1701,20,312,209,395,332,604,2671,5058,12,64042,3557,1,1
120,3818,1057,646,719,113,100,145,1170,18,215,134,248,233,382,1740,3004,10,31186,1732,1,1
120,3818,1660,832,1314,41,38,274,1701,20,312,209,395,332,604,2671,5058,12,64042,3557,1,0
120,3818,1057,646,719,113,100,145,1170,18,215,134,248,233,382,1740,3004,10,31186,1732,1,0
33,542,127,75,83,2,11,30,129,4,14,7,14,18,21,61,87,2,175,9,0,1
33,542,652,304,544,16,6,88,668,6,89,51,101,95,152,591,998,3,3399,188,0,1
33,542,2,2,2,0,0,0,2,0,0,0,0,0,0,0,0,0,0,0,0,1
33,542,8,5,5,0,0,3,8,0,0,0,0,0,0,0,0,0,0,0,0,1
33,542,14,8,8,0,0,6,14,0,0,0,0,0,0,0,0,0,0,0,0,1
33,542,6,4,4,0,0,2,6,0,0,0,0,0,0,0,0,0,0,0,0,1
33,542,6,4,4,0,0,2,6,1,2,1,2,3,3,2,4,0,2,0,0,1
33,542,7,5,5,0,0,2,7,0,0,0,0,0,0,0,0,0,0,0,0,1
33,542,10,6,6,0,0,4,10,0,0,0,0,0,0,0,0,0,0,0,0,1
33,542,1,1,1,0,0,0,1,0,0,0,0,0,0,0,0,0,0,0,0,1
33,542,14,10,10,0,0,4,14,1,1,1,1,2,2,0,2,0,1,0,0,1
33,542,46,26,30,3,0,12,49,3,6,3,6,9,9,20,28,1,42,2,0,1
120,3830,1660,832,1314,41,38,274,1701,20,312,209,395,332,604,2671,5058,12,64042,3557,1,1
120,3830,1057,646,719,113,100,145,1170,18,215,134,248,233,382,1740,3004,10,31186,1732,1,1
88,1968,1660,832,1314,41,38,274,1701,20,312,209,395,332,604,2671,5058,12,64042,3557,1,1
120,3838,1660,832,1314,41,38,274,1701,20,312,209,395,332,604,2671,5058,12,64042,3557,1,0
120,3838,1057,646,719,113,100,145,1170,18,215,134,248,233,382,1740,3004,10,31186,1732,1,0
89,2022,1660,832,1314,41,38,274,1701,20,312,209,395,332,604,2671,5058,12,64042,3557,1,0
118,3763,1660,832,1314,41,38,274,1701,20,312,209,395,332,604,2671,5058,12,64042,3557,1,1
118,3763,1057,646,719,113,100,145,1170,18,215,134,248,233,382,1740,3004,10,31186,1732,1,1
117,3766,1660,832,1314,41,38,274,1701,20,312,209,395,332,604,2671,5058,12,64042,3557,1,1
117,3766,1057,646,719,113,100,145,1170,18,215,134,248,233,382,1740,3004,10,31186,1732,1,1
94,2079,1660,832,1314,41,38,274,1701,20,312,209,395,332,604,2671,5058,12,64042,3557,1,1
146,3319,77,34,69,0,0,8,77,3,24,16,29,27,45,114,213,1,387,21,0,1
146,3319,712,438,573,51,9,84,763,14,102,71,128,116,199,733,1364,8,11988,666,0,1
44,1956,1289,550,1043,56,32,155,1345,10,167,93,185,177,278,1266,2075,5,11498,638,0,1
44,1956,1289,550,1043,56,32,155,1345,10,167,93,185,177,278,1266,2075,5,11498,638,0,0
146,3319,77,34,69,0,0,8,77,3,24,16,29,27,45,114,213,1,387,21,0,0
146,3319,712,438,573,51,9,84,763,14,102,71,128,116,199,733,1364,8,11988,666,0,0
118,3822,1660,832,1314,41,38,274,1701,20,312,209,395,332,604,2671,5058,12,64042,3557,1,1
118,3822,1057,646,719,113,100,145,1170,18,215,134,248,233,382,1740,3004,10,31186,1732,1,1
95,2123,1660,832,1314,41,38,274,1701,20,312,209,395,332,604,2671,5058,12,64042,3557,1,1
25,542,2,2,2,0,0,0,2,0,0,0,0,0,0,0,0,0,0,0,0,1
25,542,99,48,90,1,3,5,100,0,0,0,0,0,0,0,0,0,0,0,0,1
25,542,8,5,5,2,0,1,10,0,0,0,0,0,0,0,0,0,0,0,0,1
25,542,1217,716,841,84,126,174,1301,14,185,118,215,199,333,1446,2542,8,20687,1149,0,1
25,542,160,89,115,0,13,31,160,7,15,11,17,22,28,78,124,3,495,27,0,1
25,542,10,10,9,9,0,0,19,0,0,0,0,0,0,0,0,0,0,0,0,1
25,542,173,84,99,8,29,36,181,5,12,7,13,17,20,54,81,2,221,12,0,1
25,542,3,1,1,3,0,0,6,0,0,0,0,0,0,0,0,0,0,0,0,1
44,1965,1289,550,1043,56,32,155,1345,10,167,93,185,177,278,1266,2075,5,11498,638,0,1
95,2139,1660,832,1314,41,38,274,1701,20,312,209,395,332,604,2671,5058,12,64042,3557,1,1
25,1230,652,304,544,16,6,88,668,6,89,51,101,95,152,591,998,3,3399,188,0,1
40,1253,1523,757,1297,19,12,193,1542,12,193,117,230,205,347,1508,2664,7,19053,1058,0,1
40,1253,701,378,504,33,58,109,734,13,110,68,126,123,194,794,1346,7,10027,557,0,1
87,1986,1043,504,840,53,9,147,1096,9,180,112,198,189,310,1377,2344,4,11604,644,0,1
87,1986,383,288,292,26,6,62,409,11,65,38,67,76,105,429,656,5,3719,206,0,1
40,1253,1523,757,1297,19,12,193,1542,12,193,117,230,205,347,1508,2664,7,19053,1058,0,0
40,1253,701,378,504,33,58,109,734,13,110,68,126,123,194,794,1346,7,10027,557,0,0
87,1986,1043,504,840,53,9,147,1096,9,180,112,198,189,310,1377,2344,4,11604,644,0,0
87,1986,383,288,292,26,6,62,409,11,65,38,67,76,105,429,656,5,3719,206,0,0
185,4416,722,423,573,19,0,135,741,12,172,101,199,184,300,1320,2257,6,15668,870,0,0
185,4416,1508,847,911,44,250,301,1552,14,148,88,169,162,257,1120,1886,7,15077,837,0,0
34,1575,1178,367,1042,6,15,115,1184,9,94,51,95,103,146,644,976,4,4439,246,0,0
136,2684,1457,730,1242,11,6,188,1468,10,292,166,329,302,495,2424,4078,5,22973,1276,1,1
136,2684,74,35,59,1,0,14,75,3,14,7,14,17,21,58,85,1,128,7,0,1
136,2684,245,125,200,5,7,34,250,7,30,17,34,37,51,166,265,3,1053,58,0,1
29,1532,1457,730,1242,11,6,188,1468,10,292,166,329,302,495,2424,4078,5,22973,1276,1,1
80,1402,1178,367,1042,6,15,115,1184,9,94,51,95,103,146,644,976,4,4439,246,0,1
80,1402,177,108,140,8,0,27,185,6,30,16,32,36,48,162,248,3,794,44,0,1
35,1612,1178,367,1042,6,15,115,1184,9,94,51,95,103,146,644,976,4,4439,246,0,1
99,2192,1660,832,1314,41,38,274,1701,20,312,209,395,332,604,2671,5058,12,64042,3557,1,1
118,3825,1660,832,1314,41,38,274,1701,20,312,209,395,332,604,2671,5058,12,64042,3557,1,0
118,3825,1057,646,719,113,100,145,1170,18,215,134,248,233,382,1740,3004,10,31186,1732,1,0
27,563,2,2,2,0,0,0,2,0,0,0,0,0,0,0,0,0,0,0,0,1
27,563,99,48,90,1,3,5,100,0,0,0,0,0,0,0,0,0,0,0,0,1
27,563,8,5,5,2,0,1,10,0,0,0,0,0,0,0,0,0,0,0,0,1
27,563,1217,716,841,84,126,174,1301,14,185,118,215,199,333,1446,2542,8,20687,1149,0,1
27,563,160,89,115,0,13,31,160,7,15,11,17,22,28,78,124,3,495,27,0,1
27,563,10,10,9,9,0,0,19,0,0,0,0,0,0,0,0,0,0,0,0,1
27,563,173,84,99,8,29,36,181,5,12,7,13,17,20,54,81,2,221,12,0,1
27,563,3,1,1,3,0,0,6,0,0,0,0,0,0,0,0,0,0,0,0,1
32,1222,1450,624,1228,12,26,181,1462,14,306,186,354,320,540,2580,4493,8,36391,2021,1,1
147,3343,77,34,69,0,0,8,77,3,24,16,29,27,45,114,213,1,387,21,0,1
147,3343,712,438,573,51,9,84,763,14,102,71,128,116,199,733,1364,8,11988,666,0,1
44,1999,1289,550,1043,56,32,155,1345,10,167,93,185,177,278,1266,2075,5,11498,638,0,1
44,1989,1289,550,1043,56,32,155,1345,10,167,93,185,177,278,1266,2075,5,11498,638,0,0
147,3343,77,34,69,0,0,8,77,3,24,16,29,27,45,114,213,1,387,21,0,0
147,3343,712,438,573,51,9,84,763,14,102,71,128,116,199,733,1364,8,11988,666,0,0
187,4460,722,423,573,19,0,135,741,12,172,101,199,184,300,1320,2257,6,15668,870,0,0
187,4460,1508,847,911,44,250,301,1552,14,148,88,169,162,257,1120,1886,7,15077,837,0,0
33,542,127,75,83,2,11,30,129,4,14,7,14,18,21,61,87,2,175,9,0,0
33,542,652,304,544,16,6,88,668,6,89,51,101,95,152,591,998,3,3399,188,0,0
33,542,2,2,2,0,0,0,2,0,0,0,0,0,0,0,0,0,0,0,0,0
33,542,8,5,5,0,0,3,8,0,0,0,0,0,0,0,0,0,0,0,0,0
33,542,14,8,8,0,0,6,14,0,0,0,0,0,0,0,0,0,0,0,0,0
33,542,6,4,4,0,0,2,6,0,0,0,0,0,0,0,0,0,0,0,0,0
33,542,6,4,4,0,0,2,6,1,2,1,2,3,3,2,4,0,2,0,0,0
33,542,7,5,5,0,0,2,7,0,0,0,0,0,0,0,0,0,0,0,0,0
33,542,10,6,6,0,0,4,10,0,0,0,0,0,0,0,0,0,0,0,0,0
33,542,1,1,1,0,0,0,1,0,0,0,0,0,0,0,0,0,0,0,0,0
33,542,14,10,10,0,0,4,14,1,1,1,1,2,2,0,2,0,1,0,0,0
33,542,46,26,30,3,0,12,49,3,6,3,6,9,9,20,28,1,42,2,0,0
11,347,442,244,305,14,16,103,456,11,68,45,75,79,120,452,756,6,4588,254,0,1
11,347,182,102,99,11,40,35,193,3,11,6,11,14,17,42,64,1,97,5,0,1
8,544,442,244,305,14,16,103,456,11,68,45,75,79,120,452,756,6,4588,254,0,1
69,1231,1513,682,1277,25,13,200,1538,11,199,116,219,210,335,1557,2584,6,15641,868,0,1
69,1231,819,519,539,24,98,155,843,15,96,57,106,111,163,690,1107,8,9171,509,0,1
137,2694,1457,730,1242,11,6,188,1468,10,292,166,329,302,495,2424,4078,5,22973,1276,1,1
137,2694,74,35,59,1,0,14,75,3,14,7,14,17,21,58,85,1,128,7,0,1
137,2694,245,125,200,5,7,34,250,7,30,17,34,37,51,166,265,3,1053,58,0,1
42,1104,74,35,59,1,0,14,75,3,14,7,14,17,21,58,85,1,128,7,0,1
42,1104,245,125,200,5,7,34,250,7,30,17,34,37,51,166,265,3,1053,58,0,1
179,4314,722,423,573,19,0,135,741,12,172,101,199,184,300,1320,2257,6,15668,870,0,1
179,4314,1508,847,911,44,250,301,1552,14,148,88,169,162,257,1120,1886,7,15077,837,0,1
144,2897,1943,715,1694,26,18,214,1969,12,185,120,237,197,357,1436,2721,7,20915,1161,0,1
144,2897,1168,838,957,57,25,144,1225,19,348,224,416,367,640,3018,5452,11,61921,3440,1,1
45,2034,1289,550,1043,56,32,155,1345,10,167,93,185,177,278,1266,2075,5,11498,638,0,1
35,613,127,75,83,2,11,30,129,4,14,7,14,18,21,61,87,2,175,9,0,1
35,613,652,304,544,16,6,88,668,6,89,51,101,95,152,591,998,3,3399,188,0,1
35,613,2,2,2,0,0,0,2,0,0,0,0,0,0,0,0,0,0,0,0,1
35,613,8,5,5,0,0,3,8,0,0,0,0,0,0,0,0,0,0,0,0,1
35,613,14,8,8,0,0,6,14,0,0,0,0,0,0,0,0,0,0,0,0,1
35,613,6,4,4,0,0,2,6,0,0,0,0,0,0,0,0,0,0,0,0,1
35,613,6,4,4,0,0,2,6,1,2,1,2,3,3,2,4,0,2,0,0,1
35,613,7,5,5,0,0,2,7,0,0,0,0,0,0,0,0,0,0,0,0,1
35,613,10,6,6,0,0,4,10,0,0,0,0,0,0,0,0,0,0,0,0,1
35,613,1,1,1,0,0,0,1,0,0,0,0,0,0,0,0,0,0,0,0,1
35,613,14,10,10,0,0,4,14,1,1,1,1,2,2,0,2,0,1,0,0,1
35,613,46,26,30,3,0,12,49,3,6,3,6,9,9,20,28,1,42,2,0,1
39,1597,1513,682,1277,25,13,200,1538,11,199,116,219,210,335,1557,2584,6,15641,868,0,1
42,2708,1296,573,1062,40,33,157,1336,8,201,118,231,209,349,1561,2689,4,12365,686,0,1
29,1472,1457,730,1242,11,6,188,1468,10,292,166,329,302,495,2424,4078,5,22973,1276,1,1
30,1144,1020,354,843,12,15,144,1032,8,134,77,144,142,221,970,1580,4,6792,377,0,1
6,462,442,244,305,14,16,103,456,11,68,45,75,79,120,452,756,6,4588,254,0,1
180,4318,722,423,573,19,0,135,741,12,172,101,199,184,300,1320,2257,6,15668,870,0,0
180,4318,1508,847,911,44,250,301,1552,14,148,88,169,162,257,1120,1886,7,15077,837,0,0
6,472,442,244,305,14,16,103,456,11,68,45,75,79,120,452,756,6,4588,254,0,1
6,464,442,244,305,14,16,103,456,11,68,45,75,79,120,452,756,6,4588,254,0,1
184,4339,722,423,573,19,0,135,741,12,172,101,199,184,300,1320,2257,6,15668,870,0,1
184,4339,1508,847,911,44,250,301,1552,14,148,88,169,162,257,1120,1886,7,15077,837,0,1
96,2185,1043,504,840,53,9,147,1096,9,180,112,198,189,310,1377,2344,4,11604,644,0,1
96,2185,383,288,292,26,6,62,409,11,65,38,67,76,105,429,656,5,3719,206,0,1
51,2211,1289,550,1043,56,32,155,1345,10,167,93,185,177,278,1266,2075,5,11498,638,0,1
41,1260,1523,757,1297,19,12,193,1542,12,193,117,230,205,347,1508,2664,7,19053,1058,0,1
41,1260,701,378,504,33,58,109,734,13,110,68,126,123,194,794,1346,7,10027,557,0,1
28,574,215,129,180,6,0,29,221,8,65,43,72,73,115,415,711,4,3153,175,0,1
28,574,97,69,77,3,3,16,100,6,22,13,23,28,36,113,173,3,542,30,0,1
95,2257,1043,504,840,53,9,147,1096,9,180,112,198,189,310,1377,2344,4,11604,644,0,1
95,2257,383,288,292,26,6,62,409,11,65,38,67,76,105,429,656,5,3719,206,0,1
145,2900,1943,715,1694,26,18,214,1969,12,185,120,237,197,357,1436,2721,7,20915,1161,0,1
145,2900,1168,838,957,57,25,144,1225,19,348,224,416,367,640,3018,5452,11,61921,3440,1,1
52,2269,1289,550,1043,56,32,155,1345,10,167,93,185,177,278,1266,2075,5,11498,638,0,1
55,2337,1289,550,1043,56,32,155,1345,10,167,93,185,177,278,1266,2075,5,11498,638,0,1
95,2262,1043,504,840,53,9,147,1096,9,180,112,198,189,310,1377,2344,4,11604,644,0,1
95,2262,383,288,292,26,6,62,409,11,65,38,67,76,105,429,656,5,3719,206,0,1
95,2264,1043,504,840,53,9,147,1096,9,180,112,198,189,310,1377,2344,4,11604,644,0,1
95,2264,383,288,292,26,6,62,409,11,65,38,67,76,105,429,656,5,3719,206,0,1
56,2390,1289,550,1043,56,32,155,1345,10,167,93,185,177,278,1266,2075,5,11498,638,0,1
94,2179,1043,504,840,53,9,147,1096,9,180,112,198,189,310,1377,2344,4,11604,644,0,1
94,2179,383,288,292,26,6,62,409,11,65,38,67,76,105,429,656,5,3719,206,0,1
56,2377,1289,550,1043,56,32,155,1345,10,167,93,185,177,278,1266,2075,5,11498,638,0,1
56,2375,1289,550,1043,56,32,155,1345,10,167,93,185,177,278,1266,2075,5,11498,638,0,0
56,2373,1289,550,1043,56,32,155,1345,10,167,93,185,177,278,1266,2075,5,11498,638,0,1
94,2175,1043,504,840,53,9,147,1096,9,180,112,198,189,310,1377,2344,4,11604,644,0,0
94,2175,383,288,292,26,6,62,409,11,65,38,67,76,105,429,656,5,3719,206,0,0
185,4352,722,423,573,19,0,135,741,12,172,101,199,184,300,1320,2257,6,15668,870,0,0
185,4352,1508,847,911,44,250,301,1552,14,148,88,169,162,257,1120,1886,7,15077,837,0,0
138,2726,1457,730,1242,11,6,188,1468,10,292,166,329,302,495,2424,4078,5,22973,1276,1,1
138,2726,74,35,59,1,0,14,75,3,14,7,14,17,21,58,85,1,128,7,0,1
138,2726,245,125,200,5,7,34,250,7,30,17,34,37,51,166,265,3,1053,58,0,1
31,1642,1457,730,1242,11,6,188,1468,10,292,166,329,302,495,2424,4078,5,22973,1276,1,1
147,3357,77,34,69,0,0,8,77,3,24,16,29,27,45,114,213,1,387,21,0,1
147,3357,712,438,573,51,9,84,763,14,102,71,128,116,199,733,1364,8,11988,666,0,1
57,1036,1020,354,843,12,15,144,1032,8,134,77,144,142,221,970,1580,4,6792,377,0,1
81,1431,1178,367,1042,6,15,115,1184,9,94,51,95,103,146,644,976,4,4439,246,0,1
81,1431,177,108,140,8,0,27,185,6,30,16,32,36,48,162,248,3,794,44,0,1
35,622,127,75,83,2,11,30,129,4,14,7,14,18,21,61,87,2,175,9,0,1
35,622,652,304,544,16,6,88,668,6,89,51,101,95,152,591,998,3,3399,188,0,1
35,622,2,2,2,0,0,0,2,0,0,0,0,0,0,0,0,0,0,0,0,1
35,622,8,5,5,0,0,3,8,0,0,0,0,0,0,0,0,0,0,0,0,1
35,622,14,8,8,0,0,6,14,0,0,0,0,0,0,0,0,0,0,0,0,1
35,622,6,4,4,0,0,2,6,0,0,0,0,0,0,0,0,0,0,0,0,1
35,622,6,4,4,0,0,2,6,1,2,1,2,3,3,2,4,0,2,0,0,1
35,622,7,5,5,0,0,2,7,0,0,0,0,0,0,0,0,0,0,0,0,1
35,622,10,6,6,0,0,4,10,0,0,0,0,0,0,0,0,0,0,0,0,1
35,622,1,1,1,0,0,0,1,0,0,0,0,0,0,0,0,0,0,0,0,1
35,622,14,10,10,0,0,4,14,1,1,1,1,2,2,0,2,0,1,0,0,1
35,622,46,26,30,3,0,12,49,3,6,3,6,9,9,20,28,1,42,2,0,1
33,1248,1020,354,843,12,15,144,1032,8,134,77,144,142,221,970,1580,4,6792,377,0,1
36,1639,1178,367,1042,6,15,115,1184,9,94,51,95,103,146,644,976,4,4439,246,0,1
63,1149,1020,354,843,12,15,144,1032,8,134,77,144,142,221,970,1580,4,6792,377,0,1
147,2943,1943,715,1694,26,18,214,1969,12,185,120,237,197,357,1436,2721,7,20915,1161,0,1
147,2943,1168,838,957,57,25,144,1225,19,348,224,416,367,640,3018,5452,11,61921,3440,1,1
35,1375,1020,354,843,12,15,144,1032,8,134,77,144,142,221,970,1580,4,6792,377,0,1
14,457,184,100,137,2,15,30,186,6,38,20,39,44,59,214,322,3,991,55,0,1
14,457,103,65,74,8,5,16,111,7,17,9,17,24,26,89,119,3,417,23,0,1
7,293,184,100,137,2,15,30,186,6,38,20,39,44,59,214,322,3,991,55,0,1
23,554,1293,570,1093,25,15,163,1318,10,195,123,241,205,364,1516,2795,6,17273,959,0,1
19,756,1293,570,1093,25,15,163,1318,10,195,123,241,205,364,1516,2795,6,17273,959,0,1
14,457,184,100,137,2,15,30,186,6,38,20,39,44,59,214,322,3,991,55,0,0
14,457,103,65,74,8,5,16,111,7,17,9,17,24,26,89,119,3,417,23,0,0
7,293,184,100,137,2,15,30,186,6,38,20,39,44,59,214,322,3,991,55,0,0
247,5301,72,33,56,0,4,12,72,1,1,1,1,2,2,0,2,0,1,0,0,1
247,5301,1454,835,1044,76,110,219,1530,17,275,158,296,292,454,2297,3718,9,34017,1889,1,1
11,347,72,33,56,0,4,12,72,1,1,1,1,2,2,0,2,0,1,0,0,1
66,1174,1513,682,1277,25,13,200,1538,11,199,116,219,210,335,1557,2584,6,15641,868,0,1
66,1174,819,519,539,24,98,155,843,15,96,57,106,111,163,690,1107,8,9171,509,0,1
149,3363,77,34,69,0,0,8,77,3,24,16,29,27,45,114,213,1,387,21,0,1
149,3363,712,438,573,51,9,84,763,14,102,71,128,116,199,733,1364,8,11988,666,0,1
185,4362,722,423,573,19,0,135,741,12,172,101,199,184,300,1320,2257,6,15668,870,0,1
185,4362,1508,847,911,44,250,301,1552,14,148,88,169,162,257,1120,1886,7,15077,837,0,1
98,2209,1043,504,840,53,9,147,1096,9,180,112,198,189,310,1377,2344,4,11604,644,0,1
98,2209,383,288,292,26,6,62,409,11,65,38,67,76,105,429,656,5,3719,206,0,1
42,1675,1043,504,840,53,9,147,1096,9,180,112,198,189,310,1377,2344,4,11604,644,0,1
48,926,1098,241,925,5,10,155,1103,7,46,25,49,53,74,273,423,3,1580,87,0,0
48,926,282,202,222,14,2,44,296,8,42,24,43,50,67,250,378,4,1548,86,0,0
149,3366,77,34,69,0,0,8,77,3,24,16,29,27,45,114,213,1,387,21,0,1
149,3366,712,438,573,51,9,84,763,14,102,71,128,116,199,733,1364,8,11988,666,0,1
97,2199,1043,504,840,53,9,147,1096,9,180,112,198,189,310,1377,2344,4,11604,644,0,1
97,2199,383,288,292,26,6,62,409,11,65,38,67,76,105,429,656,5,3719,206,0,1
97,2191,1043,504,840,53,9,147,1096,9,180,112,198,189,310,1377,2344,4,11604,644,0,1
97,2191,383,288,292,26,6,62,409,11,65,38,67,76,105,429,656,5,3719,206,0,1
97,2193,1043,504,840,53,9,147,1096,9,180,112,198,189,310,1377,2344,4,11604,644,0,1
97,2193,383,288,292,26,6,62,409,11,65,38,67,76,105,429,656,5,3719,206,0,1
63,1148,1020,354,843,12,15,144,1032,8,134,77,144,142,221,970,1580,4,6792,377,0,1
10,326,72,33,56,0,4,12,72,1,1,1,1,2,2,0,2,0,1,0,0,1
148,3361,77,34,69,0,0,8,77,3,24,16,29,27,45,114,213,1,387,21,0,1
148,3361,712,438,573,51,9,84,763,14,102,71,128,116,199,733,1364,8,11988,666,0,1
39,1240,1523,757,1297,19,12,193,1542,12,193,117,230,205,347,1508,2664,7,19053,1058,0,1
39,1240,701,378,504,33,58,109,734,13,110,68,126,123,194,794,1346,7,10027,557,0,1
50,966,1098,241,925,5,10,155,1103,7,46,25,49,53,74,273,423,3,1580,87,0,1
50,966,282,202,222,14,2,44,296,8,42,24,43,50,67,250,378,4,1548,86,0,1
22,846,1098,241,925,5,10,155,1103,7,46,25,49,53,74,273,423,3,1580,87,0,1
45,434,647,139,84,35,284,233,682,0,0,0,0,0,0,0,0,0,0,0,0,1
149,3388,77,34,69,0,0,8,77,3,24,16,29,27,45,114,213,1,387,21,0,1
149,3388,712,438,573,51,9,84,763,14,102,71,128,116,199,733,1364,8,11988,666,0,1
93,2136,1043,504,840,53,9,147,1096,9,180,112,198,189,310,1377,2344,4,11604,644,0,1
93,2136,383,288,292,26,6,62,409,11,65,38,67,76,105,429,656,5,3719,206,0,1
42,1681,1043,504,840,53,9,147,1096,9,180,112,198,189,310,1377,2344,4,11604,644,0,1
43,413,647,139,84,35,284,233,682,0,0,0,0,0,0,0,0,0,0,0,0,1
91,2091,1043,504,840,53,9,147,1096,9,180,112,198,189,310,1377,2344,4,11604,644,0,1
91,2091,383,288,292,26,6,62,409,11,65,38,67,76,105,429,656,5,3719,206,0,1
146,2919,1943,715,1694,26,18,214,1969,12,185,120,237,197,357,1436,2721,7,20915,1161,0,1
146,2919,1168,838,957,57,25,144,1225,19,348,224,416,367,640,3018,5452,11,61921,3440,1,1
29,603,215,129,180,6,0,29,221,8,65,43,72,73,115,415,711,4,3153,175,0,1
29,603,97,69,77,3,3,16,100,6,22,13,23,28,36,113,173,3,542,30,0,1
14,1171,215,129,180,6,0,29,221,8,65,43,72,73,115,415,711,4,3153,175,0,1
247,5322,72,33,56,0,4,12,72,1,1,1,1,2,2,0,2,0,1,0,0,1
247,5322,1454,835,1044,76,110,219,1530,17,275,158,296,292,454,2297,3718,9,34017,1889,1,1
23,882,1098,241,925,5,10,155,1103,7,46,25,49,53,74,273,423,3,1580,87,0,1
24,517,447,308,343,6,5,95,453,7,96,59,111,103,170,651,1136,4,4600,255,0,1
24,517,322,174,179,16,74,51,338,10,41,26,46,51,72,252,408,5,2291,127,0,1
14,877,447,308,343,6,5,95,453,7,96,59,111,103,170,651,1136,4,4600,255,0,1
14,884,447,308,343,6,5,95,453,7,96,59,111,103,170,651,1136,4,4600,255,0,0
51,972,1098,241,925,5,10,155,1103,7,46,25,49,53,74,273,423,3,1580,87,0,1
51,972,282,202,222,14,2,44,296,8,42,24,43,50,67,250,378,4,1548,86,0,1
24,917,1098,241,925,5,10,155,1103,7,46,25,49,53,74,273,423,3,1580,87,0,1
58,2413,1289,550,1043,56,32,155,1345,10,167,93,185,177,278,1266,2075,5,11498,638,0,1
247,5323,72,33,56,0,4,12,72,1,1,1,1,2,2,0,2,0,1,0,0,0
247,5323,1454,835,1044,76,110,219,1530,17,275,158,296,292,454,2297,3718,9,34017,1889,1,0
42,1673,1043,504,840,53,9,147,1096,9,180,112,198,189,310,1377,2344,4,11604,644,0,1
66,1221,1020,354,843,12,15,144,1032,8,134,77,144,142,221,970,1580,4,6792,377,0,1
36,1508,1020,354,843,12,15,144,1032,8,134,77,144,142,221,970,1580,4,6792,377,0,1
58,1088,1020,354,843,12,15,144,1032,8,134,77,144,142,221,970,1580,4,6792,377,0,1
253,5394,72,33,56,0,4,12,72,1,1,1,1,2,2,0,2,0,1,0,0,1
253,5394,1454,835,1044,76,110,219,1530,17,275,158,296,292,454,2297,3718,9,34017,1889,1,1
36,1526,1020,354,843,12,15,144,1032,8,134,77,144,142,221,970,1580,4,6792,377,0,1
25,520,447,308,343,6,5,95,453,7,96,59,111,103,170,651,1136,4,4600,255,0,1
25,520,322,174,179,16,74,51,338,10,41,26,46,51,72,252,408,5,2291,127,0,1
16,935,447,308,343,6,5,95,453,7,96,59,111,103,170,651,1136,4,4600,255,0,1
42,1668,1043,504,840,53,9,147,1096,9,180,112,198,189,310,1377,2344,4,11604,644,0,1
51,1023,1098,241,925,5,10,155,1103,7,46,25,49,53,74,273,423,3,1580,87,0,1
51,1023,282,202,222,14,2,44,296,8,42,24,43,50,67,250,378,4,1548,86,0,1
50,983,1098,241,925,5,10,155,1103,7,46,25,49,53,74,273,423,3,1580,87,0,1
50,983,282,202,222,14,2,44,296,8,42,24,43,50,67,250,378,4,1548,86,0,1
18,1009,447,308,343,6,5,95,453,7,96,59,111,103,170,651,1136,4,4600,255,0,1
25,524,447,308,343,6,5,95,453,7,96,59,111,103,170,651,1136,4,4600,255,0,0
25,524,322,174,179,16,74,51,338,10,41,26,46,51,72,252,408,5,2291,127,0,0
29,595,447,308,343,6,5,95,453,7,96,59,111,103,170,651,1136,4,4600,255,0,0
29,595,322,174,179,16,74,51,338,10,41,26,46,51,72,252,408,5,2291,127,0,0
22,1134,447,308,343,6,5,95,453,7,96,59,111,103,170,651,1136,4,4600,255,0,0
29,596,447,308,343,6,5,95,453,7,96,59,111,103,170,651,1136,4,4600,255,0,0
29,596,322,174,179,16,74,51,338,10,41,26,46,51,72,252,408,5,2291,127,0,0
92,2141,1043,504,840,53,9,147,1096,9,180,112,198,189,310,1377,2344,4,11604,644,0,1
92,2141,383,288,292,26,6,62,409,11,65,38,67,76,105,429,656,5,3719,206,0,1
43,1766,1043,504,840,53,9,147,1096,9,180,112,198,189,310,1377,2344,4,11604,644,0,1
93,2154,1043,504,840,53,9,147,1096,9,180,112,198,189,310,1377,2344,4,11604,644,0,1
93,2154,383,288,292,26,6,62,409,11,65,38,67,76,105,429,656,5,3719,206,0,1
53,2451,1943,715,1694,26,18,214,1969,12,185,120,237,197,357,1436,2721,7,20915,1161,0,1
149,3000,1943,715,1694,26,18,214,1969,12,185,120,237,197,357,1436,2721,7,20915,1161,0,1
149,3000,1168,838,957,57,25,144,1225,19,348,224,416,367,640,3018,5452,11,61921,3440,1,1
55,2523,1943,715,1694,26,18,214,1969,12,185,120,237,197,357,1436,2721,7,20915,1161,0,1
254,5398,72,33,56,0,4,12,72,1,1,1,1,2,2,0,2,0,1,0,0,1
254,5398,1454,835,1044,76,110,219,1530,17,275,158,296,292,454,2297,3718,9,34017,1889,1,1
39,1254,1523,757,1297,19,12,193,1542,12,193,117,230,205,347,1508,2664,7,19053,1058,0,1
39,1254,701,378,504,33,58,109,734,13,110,68,126,123,194,794,1346,7,10027,557,0,1
29,1871,1523,757,1297,19,12,193,1542,12,193,117,230,205,347,1508,2664,7,19053,1058,0,1
118,3823,1660,832,1314,41,38,274,1701,20,312,209,395,332,604,2671,5058,12,64042,3557,1,0
118,3823,1057,646,719,113,100,145,1170,18,215,134,248,233,382,1740,3004,10,31186,1732,1,0
83,1472,1178,367,1042,6,15,115,1184,9,94,51,95,103,146,644,976,4,4439,246,0,1
83,1472,177,108,140,8,0,27,185,6,30,16,32,36,48,162,248,3,794,44,0,1
50,991,1098,241,925,5,10,155,1103,7,46,25,49,53,74,273,423,3,1580,87,0,1
50,991,282,202,222,14,2,44,296,8,42,24,43,50,67,250,378,4,1548,86,0,1
25,961,1098,241,925,5,10,155,1103,7,46,25,49,53,74,273,423,3,1580,87,0,1
58,1217,477,336,357,30,23,73,507,16,194,134,250,210,384,1538,2962,10,30538,1696,0,1
93,2152,1043,504,840,53,9,147,1096,9,180,112,198,189,310,1377,2344,4,11604,644,0,1
93,2152,383,288,292,26,6,62,409,11,65,38,67,76,105,429,656,5,3719,206,0,1
118,3823,1660,832,1314,41,38,274,1701,20,312,209,395,332,604,2671,5058,12,64042,3557,1,1
118,3823,1057,646,719,113,100,145,1170,18,215,134,248,233,382,1740,3004,10,31186,1732,1,1
100,2215,1660,832,1314,41,38,274,1701,20,312,209,395,332,604,2671,5058,12,64042,3557,1,1
27,565,2,2,2,0,0,0,2,0,0,0,0,0,0,0,0,0,0,0,0,1
27,565,99,48,90,1,3,5,100,0,0,0,0,0,0,0,0,0,0,0,0,1
27,565,8,5,5,2,0,1,10,0,0,0,0,0,0,0,0,0,0,0,0,1
27,565,1217,716,841,84,126,174,1301,14,185,118,215,199,333,1446,2542,8,20687,1149,0,1
27,565,160,89,115,0,13,31,160,7,15,11,17,22,28,78,124,3,495,27,0,1
27,565,10,10,9,9,0,0,19,0,0,0,0,0,0,0,0,0,0,0,0,1
27,565,173,84,99,8,29,36,181,5,12,7,13,17,20,54,81,2,221,12,0,1
27,565,3,1,1,3,0,0,6,0,0,0,0,0,0,0,0,0,0,0,0,1
254,5418,72,33,56,0,4,12,72,1,1,1,1,2,2,0,2,0,1,0,0,1
254,5418,1454,835,1044,76,110,219,1530,17,275,158,296,292,454,2297,3718,9,34017,1889,1,1
83,1475,1178,367,1042,6,15,115,1184,9,94,51,95,103,146,644,976,4,4439,246,0,1
83,1475,177,108,140,8,0,27,185,6,30,16,32,36,48,162,248,3,794,44,0,1
150,3427,77,34,69,0,0,8,77,3,24,16,29,27,45,114,213,1,387,21,0,1
150,3427,712,438,573,51,9,84,763,14,102,71,128,116,199,733,1364,8,11988,666,0,1
59,2468,1289,550,1043,56,32,155,1345,10,167,93,185,177,278,1266,2075,5,11498,638,0,1
59,2468,1289,550,1043,56,32,155,1345,10,167,93,185,177,278,1266,2075,5,11498,638,0,0
100,2224,1660,832,1314,41,38,274,1701,20,312,209,395,332,604,2671,5058,12,64042,3557,1,0
40,1265,1523,757,1297,19,12,193,1542,12,193,117,230,205,347,1508,2664,7,19053,1058,0,1
40,1265,701,378,504,33,58,109,734,13,110,68,126,123,194,794,1346,7,10027,557,0,1
30,1909,1523,757,1297,19,12,193,1542,12,193,117,230,205,347,1508,2664,7,19053,1058,0,1
6,71,127,75,83,2,11,30,129,4,14,7,14,18,21,61,87,2,175,9,0,1
6,71,652,304,544,16,6,88,668,6,89,51,101,95,152,591,998,3,3399,188,0,1
6,71,2,2,2,0,0,0,2,0,0,0,0,0,0,0,0,0,0,0,0,1
6,71,8,5,5,0,0,3,8,0,0,0,0,0,0,0,0,0,0,0,0,1
6,71,14,8,8,0,0,6,14,0,0,0,0,0,0,0,0,0,0,0,0,1
6,71,6,4,4,0,0,2,6,0,0,0,0,0,0,0,0,0,0,0,0,1
6,71,6,4,4,0,0,2,6,1,2,1,2,3,3,2,4,0,2,0,0,1
6,71,7,5,5,0,0,2,7,0,0,0,0,0,0,0,0,0,0,0,0,1
6,71,10,6,6,0,0,4,10,0,0,0,0,0,0,0,0,0,0,0,0,1
6,71,1,1,1,0,0,0,1,0,0,0,0,0,0,0,0,0,0,0,0,1
6,71,14,10,10,0,0,4,14,1,1,1,1,2,2,0,2,0,1,0,0,1
6,71,46,26,30,3,0,12,49,3,6,3,6,9,9,20,28,1,42,2,0,1
69,1238,1513,682,1277,25,13,200,1538,11,199,116,219,210,335,1557,2584,6,15641,868,0,1
69,1238,819,519,539,24,98,155,843,15,96,57,106,111,163,690,1107,8,9171,509,0,1
41,1693,1513,682,1277,25,13,200,1538,11,199,116,219,210,335,1557,2584,6,15641,868,0,1
68,1218,1513,682,1277,25,13,200,1538,11,199,116,219,210,335,1557,2584,6,15641,868,0,0
68,1218,819,519,539,24,98,155,843,15,96,57,106,111,163,690,1107,8,9171,509,0,0
1,194,382,65,130,157,2,92,539,4,10,5,10,14,15,41,57,2,114,6,0,1
3,23,14,7,7,2,0,5,16,0,0,0,0,0,0,0,0,0,0,0,0,1
1,170,382,65,130,157,2,92,539,4,10,5,10,14,15,41,57,2,114,6,0,0
1,173,382,65,130,157,2,92,539,4,10,5,10,14,15,41,57,2,114,6,0,0
1,172,382,65,130,157,2,92,539,4,10,5,10,14,15,41,57,2,114,6,0,1
1,175,382,65,130,157,2,92,539,4,10,5,10,14,15,41,57,2,114,6,0,1
83,1481,1178,367,1042,6,15,115,1184,9,94,51,95,103,146,644,976,4,4439,246,0,1
83,1481,177,108,140,8,0,27,185,6,30,16,32,36,48,162,248,3,794,44,0,1
37,1694,1178,367,1042,6,15,115,1184,9,94,51,95,103,146,644,976,4,4439,246,0,1
153,3064,1943,715,1694,26,18,214,1969,12,185,120,237,197,357,1436,2721,7,20915,1161,0,1
153,3064,1168,838,957,57,25,144,1225,19,348,224,416,367,640,3018,5452,11,61921,3440,1,1
56,2543,1943,715,1694,26,18,214,1969,12,185,120,237,197,357,1436,2721,7,20915,1161,0,1
43,415,647,139,84,35,284,233,682,0,0,0,0,0,0,0,0,0,0,0,0,1
154,3083,1943,715,1694,26,18,214,1969,12,185,120,237,197,357,1436,2721,7,20915,1161,0,1
154,3083,1168,838,957,57,25,144,1225,19,348,224,416,367,640,3018,5452,11,61921,3440,1,1
56,2548,1943,715,1694,26,18,214,1969,12,185,120,237,197,357,1436,2721,7,20915,1161,0,1
118,3820,1660,832,1314,41,38,274,1701,20,312,209,395,332,604,2671,5058,12,64042,3557,1,1
118,3820,1057,646,719,113,100,145,1170,18,215,134,248,233,382,1740,3004,10,31186,1732,1,1
150,3428,77,34,69,0,0,8,77,3,24,16,29,27,45,114,213,1,387,21,0,1
150,3428,712,438,573,51,9,84,763,14,102,71,128,116,199,733,1364,8,11988,666,0,1
35,628,127,75,83,2,11,30,129,4,14,7,14,18,21,61,87,2,175,9,0,0
35,628,652,304,544,16,6,88,668,6,89,51,101,95,152,591,998,3,3399,188,0,0
35,628,2,2,2,0,0,0,2,0,0,0,0,0,0,0,0,0,0,0,0,0
35,628,8,5,5,0,0,3,8,0,0,0,0,0,0,0,0,0,0,0,0,0
35,628,14,8,8,0,0,6,14,0,0,0,0,0,0,0,0,0,0,0,0,0
35,628,6,4,4,0,0,2,6,0,0,0,0,0,0,0,0,0,0,0,0,0
35,628,6,4,4,0,0,2,6,1,2,1,2,3,3,2,4,0,2,0,0,0
35,628,7,5,5,0,0,2,7,0,0,0,0,0,0,0,0,0,0,0,0,0
35,628,10,6,6,0,0,4,10,0,0,0,0,0,0,0,0,0,0,0,0,0
35,628,1,1,1,0,0,0,1,0,0,0,0,0,0,0,0,0,0,0,0,0
35,628,14,10,10,0,0,4,14,1,1,1,1,2,2,0,2,0,1,0,0,0
35,628,46,26,30,3,0,12,49,3,6,3,6,9,9,20,28,1,42,2,0,0
40,1264,1523,757,1297,19,12,193,1542,12,193,117,230,205,347,1508,2664,7,19053,1058,0,1
40,1264,701,378,504,33,58,109,734,13,110,68,126,123,194,794,1346,7,10027,557,0,1
150,3423,77,34,69,0,0,8,77,3,24,16,29,27,45,114,213,1,387,21,0,1
150,3423,712,438,573,51,9,84,763,14,102,71,128,116,199,733,1364,8,11988,666,0,1
23,555,1293,570,1093,25,15,163,1318,10,195,123,241,205,364,1516,2795,6,17273,959,0,1
83,1451,1178,367,1042,6,15,115,1184,9,94,51,95,103,146,644,976,4,4439,246,0,1
83,1451,177,108,140,8,0,27,185,6,30,16,32,36,48,162,248,3,794,44,0,1
38,1723,1178,367,1042,6,15,115,1184,9,94,51,95,103,146,644,976,4,4439,246,0,1
94,2157,1043,504,840,53,9,147,1096,9,180,112,198,189,310,1377,2344,4,11604,644,0,1
94,2157,383,288,292,26,6,62,409,11,65,38,67,76,105,429,656,5,3719,206,0,1
154,3088,1943,715,1694,26,18,214,1969,12,185,120,237,197,357,1436,2721,7,20915,1161,0,1
154,3088,1168,838,957,57,25,144,1225,19,348,224,416,367,640,3018,5452,11,61921,3440,1,1
44,1808,1043,504,840,53,9,147,1096,9,180,112,198,189,310,1377,2344,4,11604,644,0,1
68,1215,1513,682,1277,25,13,200,1538,11,199,116,219,210,335,1557,2584,6,15641,868,0,1
68,1215,819,519,539,24,98,155,843,15,96,57,106,111,163,690,1107,8,9171,509,0,1
181,4153,77,34,69,0,0,8,77,3,24,16,29,27,45,114,213,1,387,21,0,1
181,4153,712,438,573,51,9,84,763,14,102,71,128,116,199,733,1364,8,11988,666,0,1
185,4355,722,423,573,19,0,135,741,12,172,101,199,184,300,1320,2257,6,15668,870,0,1
185,4355,1508,847,911,44,250,301,1552,14,148,88,169,162,257,1120,1886,7,15077,837,0,1
233,4981,72,33,56,0,4,12,72,1,1,1,1,2,2,0,2,0,1,0,0,1
233,4981,1454,835,1044,76,110,219,1530,17,275,158,296,292,454,2297,3718,9,34017,1889,1,1
11,345,442,244,305,14,16,103,456,11,68,45,75,79,120,452,756,6,4588,254,0,1
11,345,182,102,99,11,40,35,193,3,11,6,11,14,17,42,64,1,97,5,0,1
1,178,382,65,130,157,2,92,539,4,10,5,10,14,15,41,57,2,114,6,0,1
28,1113,1450,624,1228,12,26,181,1462,14,306,186,354,320,540,2580,4493,8,36391,2021,1,1
6,452,442,244,305,14,16,103,456,11,68,45,75,79,120,452,756,6,4588,254,0,1
233,4981,72,33,56,0,4,12,72,1,1,1,1,2,2,0,2,0,1,0,0,0
233,4981,1454,835,1044,76,110,219,1530,17,275,158,296,292,454,2297,3718,9,34017,1889,1,0
137,2710,1457,730,1242,11,6,188,1468,10,292,166,329,302,495,2424,4078,5,22973,1276,1,0
137,2710,74,35,59,1,0,14,75,3,14,7,14,17,21,58,85,1,128,7,0,0
137,2710,245,125,200,5,7,34,250,7,30,17,34,37,51,166,265,3,1053,58,0,0
139,2729,1457,730,1242,11,6,188,1468,10,292,166,329,302,495,2424,4078,5,22973,1276,1,1
139,2729,74,35,59,1,0,14,75,3,14,7,14,17,21,58,85,1,128,7,0,1
139,2729,245,125,200,5,7,34,250,7,30,17,34,37,51,166,265,3,1053,58,0,1
27,1295,652,304,544,16,6,88,668,6,89,51,101,95,152,591,998,3,3399,188,0,1
29,603,2,2,2,0,0,0,2,0,0,0,0,0,0,0,0,0,0,0,0,1
29,603,99,48,90,1,3,5,100,0,0,0,0,0,0,0,0,0,0,0,0,1
29,603,8,5,5,2,0,1,10,0,0,0,0,0,0,0,0,0,0,0,0,1
29,603,1217,716,841,84,126,174,1301,14,185,118,215,199,333,1446,2542,8,20687,1149,0,1
29,603,160,89,115,0,13,31,160,7,15,11,17,22,28,78,124,3,495,27,0,1
29,603,10,10,9,9,0,0,19,0,0,0,0,0,0,0,0,0,0,0,0,1
29,603,173,84,99,8,29,36,181,5,12,7,13,17,20,54,81,2,221,12,0,1
29,603,3,1,1,3,0,0,6,0,0,0,0,0,0,0,0,0,0,0,0,1
57,1197,477,336,357,30,23,73,507,16,194,134,250,210,384,1538,2962,10,30538,1696,0,1
29,1163,1450,624,1228,12,26,181,1462,14,306,186,354,320,540,2580,4493,8,36391,2021,1,1
118,3822,1660,832,1314,41,38,274,1701,20,312,209,395,332,604,2671,5058,12,64042,3557,1,0
118,3822,1057,646,719,113,100,145,1170,18,215,134,248,233,382,1740,3004,10,31186,1732,1,0
100,2272,1660,832,1314,41,38,274,1701,20,312,209,395,332,604,2671,5058,12,64042,3557,1,0
100,2255,1660,832,1314,41,38,274,1701,20,312,209,395,332,604,2671,5058,12,64042,3557,1,1
68,1224,1513,682,1277,25,13,200,1538,11,199,116,219,210,335,1557,2584,6,15641,868,0,1
68,1224,819,519,539,24,98,155,843,15,96,57,106,111,163,690,1107,8,9171,509,0,1
153,3459,77,34,69,0,0,8,77,3,24,16,29,27,45,114,213,1,387,21,0,1
153,3459,712,438,573,51,9,84,763,14,102,71,128,116,199,733,1364,8,11988,666,0,1
261,5627,72,33,56,0,4,12,72,1,1,1,1,2,2,0,2,0,1,0,0,1
261,5627,1454,835,1044,76,110,219,1530,17,275,158,296,292,454,2297,3718,9,34017,1889,1,1
154,3478,77,34,69,0,0,8,77,3,24,16,29,27,45,114,213,1,387,21,0,0
154,3478,712,438,573,51,9,84,763,14,102,71,128,116,199,733,1364,8,11988,666,0,0
154,3478,77,34,69,0,0,8,77,3,24,16,29,27,45,114,213,1,387,21,0,1
154,3478,712,438,573,51,9,84,763,14,102,71,128,116,199,733,1364,8,11988,666,0,1
1,181,382,65,130,157,2,92,539,4,10,5,10,14,15,41,57,2,114,6,0,1
153,3466,77,34,69,0,0,8,77,3,24,16,29,27,45,114,213,1,387,21,0,1
153,3466,712,438,573,51,9,84,763,14,102,71,128,116,199,733,1364,8,11988,666,0,1
277,5802,72,33,56,0,4,12,72,1,1,1,1,2,2,0,2,0,1,0,0,1
277,5802,1454,835,1044,76,110,219,1530,17,275,158,296,292,454,2297,3718,9,34017,1889,1,1
68,1223,1513,682,1277,25,13,200,1538,11,199,116,219,210,335,1557,2584,6,15641,868,0,1
68,1223,819,519,539,24,98,155,843,15,96,57,106,111,163,690,1107,8,9171,509,0,1
175,4097,77,34,69,0,0,8,77,3,24,16,29,27,45,114,213,1,387,21,0,1
175,4097,712,438,573,51,9,84,763,14,102,71,128,116,199,733,1364,8,11988,666,0,1
258,5343,72,33,56,0,4,12,72,1,1,1,1,2,2,0,2,0,1,0,0,1
258,5343,1454,835,1044,76,110,219,1530,17,275,158,296,292,454,2297,3718,9,34017,1889,1,1
23,970,373,158,315,8,0,51,381,5,76,44,79,81,123,486,779,2,2026,112,0,1
182,4179,77,34,69,0,0,8,77,3,24,16,29,27,45,114,213,1,387,21,0,1
182,4179,712,438,573,51,9,84,763,14,102,71,128,116,199,733,1364,8,11988,666,0,1
185,4360,722,423,573,19,0,135,741,12,172,101,199,184,300,1320,2257,6,15668,870,0,1
185,4360,1508,847,911,44,250,301,1552,14,148,88,169,162,257,1120,1886,7,15077,837,0,1
260,5490,72,33,56,0,4,12,72,1,1,1,1,2,2,0,2,0,1,0,0,1
260,5490,1454,835,1044,76,110,219,1530,17,275,158,296,292,454,2297,3718,9,34017,1889,1,1
23,946,373,158,315,8,0,51,381,5,76,44,79,81,123,486,779,2,2026,112,0,1
6,484,442,244,305,14,16,103,456,11,68,45,75,79,120,452,756,6,4588,254,0,1
189,4278,77,34,69,0,0,8,77,3,24,16,29,27,45,114,213,1,387,21,0,1
189,4278,712,438,573,51,9,84,763,14,102,71,128,116,199,733,1364,8,11988,666,0,1
257,5478,72,33,56,0,4,12,72,1,1,1,1,2,2,0,2,0,1,0,0,1
257,5478,1454,835,1044,76,110,219,1530,17,275,158,296,292,454,2297,3718,9,34017,1889,1,1
260,5629,72,33,56,0,4,12,72,1,1,1,1,2,2,0,2,0,1,0,0,1
260,5629,1454,835,1044,76,110,219,1530,17,275,158,296,292,454,2297,3718,9,34017,1889,1,1
191,4316,77,34,69,0,0,8,77,3,24,16,29,27,45,114,213,1,387,21,0,0
191,4316,712,438,573,51,9,84,763,14,102,71,128,116,199,733,1364,8,11988,666,0,0
261,5650,72,33,56,0,4,12,72,1,1,1,1,2,2,0,2,0,1,0,0,1
261,5650,1454,835,1044,76,110,219,1530,17,275,158,296,292,454,2297,3718,9,34017,1889,1,1
198,4459,77,34,69,0,0,8,77,3,24,16,29,27,45,114,213,1,387,21,0,1
198,4459,712,438,573,51,9,84,763,14,102,71,128,116,199,733,1364,8,11988,666,0,1
263,5769,72,33,56,0,4,12,72,1,1,1,1,2,2,0,2,0,1,0,0,1
263,5769,1454,835,1044,76,110,219,1530,17,275,158,296,292,454,2297,3718,9,34017,1889,1,1
203,4578,77,34,69,0,0,8,77,3,24,16,29,27,45,114,213,1,387,21,0,1
203,4578,712,438,573,51,9,84,763,14,102,71,128,116,199,733,1364,8,11988,666,0,1
270,5894,72,33,56,0,4,12,72,1,1,1,1,2,2,0,2,0,1,0,0,1
270,5894,1454,835,1044,76,110,219,1530,17,275,158,296,292,454,2297,3718,9,34017,1889,1,1
215,4791,77,34,69,0,0,8,77,3,24,16,29,27,45,114,213,1,387,21,0,1
215,4791,712,438,573,51,9,84,763,14,102,71,128,116,199,733,1364,8,11988,666,0,1
273,5991,72,33,56,0,4,12,72,1,1,1,1,2,2,0,2,0,1,0,0,1
273,5991,1454,835,1044,76,110,219,1530,17,275,158,296,292,454,2297,3718,9,34017,1889,1,1
96,2180,1043,504,840,53,9,147,1096,9,180,112,198,189,310,1377,2344,4,11604,644,0,1
96,2180,383,288,292,26,6,62,409,11,65,38,67,76,105,429,656,5,3719,206,0,1
220,4925,77,34,69,0,0,8,77,3,24,16,29,27,45,114,213,1,387,21,0,1
220,4925,712,438,573,51,9,84,763,14,102,71,128,116,199,733,1364,8,11988,666,0,1
271,5960,72,33,56,0,4,12,72,1,1,1,1,2,2,0,2,0,1,0,0,1
271,5960,1454,835,1044,76,110,219,1530,17,275,158,296,292,454,2297,3718,9,34017,1889,1,1
223,5008,77,34,69,0,0,8,77,3,24,16,29,27,45,114,213,1,387,21,0,1
223,5008,712,438,573,51,9,84,763,14,102,71,128,116,199,733,1364,8,11988,666,0,1
272,5978,72,33,56,0,4,12,72,1,1,1,1,2,2,0,2,0,1,0,0,1
272,5978,1454,835,1044,76,110,219,1530,17,275,158,296,292,454,2297,3718,9,34017,1889,1,1
259,5695,77,34,69,0,0,8,77,3,24,16,29,27,45,114,213,1,387,21,0,1
259,5695,712,438,573,51,9,84,763,14,102,71,128,116,199,733,1364,8,11988,666,0,1
267,5870,72,33,56,0,4,12,72,1,1,1,1,2,2,0,2,0,1,0,0,1
267,5870,1454,835,1044,76,110,219,1530,17,275,158,296,292,454,2297,3718,9,34017,1889,1,1
29,1172,1450,624,1228,12,26,181,1462,14,306,186,354,320,540,2580,4493,8,36391,2021,1,0
158,3594,77,34,69,0,0,8,77,3,24,16,29,27,45,114,213,1,387,21,0,1
158,3594,712,438,573,51,9,84,763,14,102,71,128,116,199,733,1364,8,11988,666,0,1
366,7926,72,33,56,0,4,12,72,1,1,1,1,2,2,0,2,0,1,0,0,1
366,7926,1454,835,1044,76,110,219,1530,17,275,158,296,292,454,2297,3718,9,34017,1889,1,1
379,8210,72,33,56,0,4,12,72,1,1,1,1,2,2,0,2,0,1,0,0,1
379,8210,1454,835,1044,76,110,219,1530,17,275,158,296,292,454,2297,3718,9,34017,1889,1,1
379,8214,72,33,56,0,4,12,72,1,1,1,1,2,2,0,2,0,1,0,0,1
379,8214,1454,835,1044,76,110,219,1530,17,275,158,296,292,454,2297,3718,9,34017,1889,1,1
383,8290,72,33,56,0,4,12,72,1,1,1,1,2,2,0,2,0,1,0,0,1
383,8290,1454,835,1044,76,110,219,1530,17,275,158,296,292,454,2297,3718,9,34017,1889,1,1
40,1271,1523,757,1297,19,12,193,1542,12,193,117,230,205,347,1508,2664,7,19053,1058,0,1
40,1271,701,378,504,33,58,109,734,13,110,68,126,123,194,794,1346,7,10027,557,0,1
31,1956,1523,757,1297,19,12,193,1542,12,193,117,230,205,347,1508,2664,7,19053,1058,0,1
158,3603,77,34,69,0,0,8,77,3,24,16,29,27,45,114,213,1,387,21,0,1
158,3603,712,438,573,51,9,84,763,14,102,71,128,116,199,733,1364,8,11988,666,0,1
388,8375,72,33,56,0,4,12,72,1,1,1,1,2,2,0,2,0,1,0,0,1
388,8375,1454,835,1044,76,110,219,1530,17,275,158,296,292,454,2297,3718,9,34017,1889,1,1
390,8417,72,33,56,0,4,12,72,1,1,1,1,2,2,0,2,0,1,0,0,1
390,8417,1454,835,1044,76,110,219,1530,17,275,158,296,292,454,2297,3718,9,34017,1889,1,1
3,66,127,75,83,2,11,30,129,4,14,7,14,18,21,61,87,2,175,9,0,1
3,66,652,304,544,16,6,88,668,6,89,51,101,95,152,591,998,3,3399,188,0,1
3,66,2,2,2,0,0,0,2,0,0,0,0,0,0,0,0,0,0,0,0,1
3,66,8,5,5,0,0,3,8,0,0,0,0,0,0,0,0,0,0,0,0,1
3,66,14,8,8,0,0,6,14,0,0,0,0,0,0,0,0,0,0,0,0,1
3,66,6,4,4,0,0,2,6,0,0,0,0,0,0,0,0,0,0,0,0,1
3,66,6,4,4,0,0,2,6,1,2,1,2,3,3,2,4,0,2,0,0,1
3,66,7,5,5,0,0,2,7,0,0,0,0,0,0,0,0,0,0,0,0,1
3,66,10,6,6,0,0,4,10,0,0,0,0,0,0,0,0,0,0,0,0,1
3,66,1,1,1,0,0,0,1,0,0,0,0,0,0,0,0,0,0,0,0,1
3,66,14,10,10,0,0,4,14,1,1,1,1,2,2,0,2,0,1,0,0,1
3,66,46,26,30,3,0,12,49,3,6,3,6,9,9,20,28,1,42,2,0,1
7,298,72,33,56,0,4,12,72,1,1,1,1,2,2,0,2,0,1,0,0,1
393,8455,72,33,56,0,4,12,72,1,1,1,1,2,2,0,2,0,1,0,0,1
393,8455,1454,835,1044,76,110,219,1530,17,275,158,296,292,454,2297,3718,9,34017,1889,1,1
40,1278,1523,757,1297,19,12,193,1542,12,193,117,230,205,347,1508,2664,7,19053,1058,0,1
40,1278,701,378,504,33,58,109,734,13,110,68,126,123,194,794,1346,7,10027,557,0,1
32,1972,1523,757,1297,19,12,193,1542,12,193,117,230,205,347,1508,2664,7,19053,1058,0,1
393,8467,72,33,56,0,4,12,72,1,1,1,1,2,2,0,2,0,1,0,0,1
393,8467,1454,835,1044,76,110,219,1530,17,275,158,296,292,454,2297,3718,9,34017,1889,1,1
394,8478,72,33,56,0,4,12,72,1,1,1,1,2,2,0,2,0,1,0,0,1
394,8478,1454,835,1044,76,110,219,1530,17,275,158,296,292,454,2297,3718,9,34017,1889,1,1
394,8468,72,33,56,0,4,12,72,1,1,1,1,2,2,0,2,0,1,0,0,1
394,8468,1454,835,1044,76,110,219,1530,17,275,158,296,292,454,2297,3718,9,34017,1889,1,1
394,8492,72,33,56,0,4,12,72,1,1,1,1,2,2,0,2,0,1,0,0,1
394,8492,1454,835,1044,76,110,219,1530,17,275,158,296,292,454,2297,3718,9,34017,1889,1,1
394,8496,72,33,56,0,4,12,72,1,1,1,1,2,2,0,2,0,1,0,0,1
394,8496,1454,835,1044,76,110,219,1530,17,275,158,296,292,454,2297,3718,9,34017,1889,1,1
32,1972,1523,757,1297,19,12,193,1542,12,193,117,230,205,347,1508,2664,7,19053,1058,0,0
394,8496,72,33,56,0,4,12,72,1,1,1,1,2,2,0,2,0,1,0,0,0
394,8496,1454,835,1044,76,110,219,1530,17,275,158,296,292,454,2297,3718,9,34017,1889,1,0
96,2178,1043,504,840,53,9,147,1096,9,180,112,198,189,310,1377,2344,4,11604,644,0,1
96,2178,383,288,292,26,6,62,409,11,65,38,67,76,105,429,656,5,3719,206,0,1
23,1161,447,308,343,6,5,95,453,7,96,59,111,103,170,651,1136,4,4600,255,0,1
32,1976,1523,757,1297,19,12,193,1542,12,193,117,230,205,347,1508,2664,7,19053,1058,0,0
185,4356,722,423,573,19,0,135,741,12,172,101,199,184,300,1320,2257,6,15668,870,0,0
185,4356,1508,847,911,44,250,301,1552,14,148,88,169,162,257,1120,1886,7,15077,837,0,0
14,577,722,423,573,19,0,135,741,12,172,101,199,184,300,1320,2257,6,15668,870,0,0
395,8517,72,33,56,0,4,12,72,1,1,1,1,2,2,0,2,0,1,0,0,1
395,8517,1454,835,1044,76,110,219,1530,17,275,158,296,292,454,2297,3718,9,34017,1889,1,1
159,3613,77,34,69,0,0,8,77,3,24,16,29,27,45,114,213,1,387,21,0,0
159,3613,712,438,573,51,9,84,763,14,102,71,128,116,199,733,1364,8,11988,666,0,0
44,1808,1043,504,840,53,9,147,1096,9,180,112,198,189,310,1377,2344,4,11604,644,0,0
384,8296,72,33,56,0,4,12,72,1,1,1,1,2,2,0,2,0,1,0,0,1
384,8296,1454,835,1044,76,110,219,1530,17,275,158,296,292,454,2297,3718,9,34017,1889,1,1
162,3649,77,34,69,0,0,8,77,3,24,16,29,27,45,114,213,1,387,21,0,1
162,3649,712,438,573,51,9,84,763,14,102,71,128,116,199,733,1364,8,11988,666,0,1
385,8343,72,33,56,0,4,12,72,1,1,1,1,2,2,0,2,0,1,0,0,1
385,8343,1454,835,1044,76,110,219,1530,17,275,158,296,292,454,2297,3718,9,34017,1889,1,1
385,8344,72,33,56,0,4,12,72,1,1,1,1,2,2,0,2,0,1,0,0,1
385,8344,1454,835,1044,76,110,219,1530,17,275,158,296,292,454,2297,3718,9,34017,1889,1,1
385,8329,72,33,56,0,4,12,72,1,1,1,1,2,2,0,2,0,1,0,0,1
385,8329,1454,835,1044,76,110,219,1530,17,275,158,296,292,454,2297,3718,9,34017,1889,1,1
387,8382,72,33,56,0,4,12,72,1,1,1,1,2,2,0,2,0,1,0,0,1
387,8382,1454,835,1044,76,110,219,1530,17,275,158,296,292,454,2297,3718,9,34017,1889,1,1
51,1026,1098,241,925,5,10,155,1103,7,46,25,49,53,74,273,423,3,1580,87,0,1
51,1026,282,202,222,14,2,44,296,8,42,24,43,50,67,250,378,4,1548,86,0,1
26,988,1098,241,925,5,10,155,1103,7,46,25,49,53,74,273,423,3,1580,87,0,1
389,8386,72,33,56,0,4,12,72,1,1,1,1,2,2,0,2,0,1,0,0,1
389,8386,1454,835,1044,76,110,219,1530,17,275,158,296,292,454,2297,3718,9,34017,1889,1,1
390,8394,72,33,56,0,4,12,72,1,1,1,1,2,2,0,2,0,1,0,0,1
390,8394,1454,835,1044,76,110,219,1530,17,275,158,296,292,454,2297,3718,9,34017,1889,1,1
187,4423,722,423,573,19,0,135,741,12,172,101,199,184,300,1320,2257,6,15668,870,0,1
187,4423,1508,847,911,44,250,301,1552,14,148,88,169,162,257,1120,1886,7,15077,837,0,1
391,8407,72,33,56,0,4,12,72,1,1,1,1,2,2,0,2,0,1,0,0,1
391,8407,1454,835,1044,76,110,219,1530,17,275,158,296,292,454,2297,3718,9,34017,1889,1,1
18,294,424,94,331,4,0,89,428,1,5,5,5,6,10,11,25,0,12,0,0,1
18,294,38,23,23,6,0,8,44,3,11,7,11,14,18,42,68,1,102,5,0,1
12,389,424,94,331,4,0,89,428,1,5,5,5,6,10,11,25,0,12,0,0,1
42,1116,74,35,59,1,0,14,75,3,14,7,14,17,21,58,85,1,128,7,0,1
42,1116,245,125,200,5,7,34,250,7,30,17,34,37,51,166,265,3,1053,58,0,1
11,343,74,35,59,1,0,14,75,3,14,7,14,17,21,58,85,1,128,7,0,1
52,1050,1098,241,925,5,10,155,1103,7,46,25,49,53,74,273,423,3,1580,87,0,1
52,1050,282,202,222,14,2,44,296,8,42,24,43,50,67,250,378,4,1548,86,0,1
27,1019,1098,241,925,5,10,155,1103,7,46,25,49,53,74,273,423,3,1580,87,0,1
52,1050,1098,241,925,5,10,155,1103,7,46,25,49,53,74,273,423,3,1580,87,0,0
52,1050,282,202,222,14,2,44,296,8,42,24,43,50,67,250,378,4,1548,86,0,0
27,1019,1098,241,925,5,10,155,1103,7,46,25,49,53,74,273,423,3,1580,87,0,0
156,3510,77,34,69,0,0,8,77,3,24,16,29,27,45,114,213,1,387,21,0,0
156,3510,712,438,573,51,9,84,763,14,102,71,128,116,199,733,1364,8,11988,666,0,0
392,8417,72,33,56,0,4,12,72,1,1,1,1,2,2,0,2,0,1,0,0,0
392,8417,1454,835,1044,76,110,219,1530,17,275,158,296,292,454,2297,3718,9,34017,1889,1,0
96,2185,1043,504,840,53,9,147,1096,9,180,112,198,189,310,1377,2344,4,11604,644,0,0
96,2185,383,288,292,26,6,62,409,11,65,38,67,76,105,429,656,5,3719,206,0,0
398,8516,72,33,56,0,4,12,72,1,1,1,1,2,2,0,2,0,1,0,0,1
398,8516,1454,835,1044,76,110,219,1530,17,275,158,296,292,454,2297,3718,9,34017,1889,1,1
398,8529,72,33,56,0,4,12,72,1,1,1,1,2,2,0,2,0,1,0,0,1
398,8529,1454,835,1044,76,110,219,1530,17,275,158,296,292,454,2297,3718,9,34017,1889,1,1
30,618,447,308,343,6,5,95,453,7,96,59,111,103,170,651,1136,4,4600,255,0,1
30,618,322,174,179,16,74,51,338,10,41,26,46,51,72,252,408,5,2291,127,0,1
26,1272,447,308,343,6,5,95,453,7,96,59,111,103,170,651,1136,4,4600,255,0,1
399,8544,72,33,56,0,4,12,72,1,1,1,1,2,2,0,2,0,1,0,0,1
399,8544,1454,835,1044,76,110,219,1530,17,275,158,296,292,454,2297,3718,9,34017,1889,1,1
162,3651,77,34,69,0,0,8,77,3,24,16,29,27,45,114,213,1,387,21,0,0
162,3651,712,438,573,51,9,84,763,14,102,71,128,116,199,733,1364,8,11988,666,0,0
398,8516,72,33,56,0,4,12,72,1,1,1,1,2,2,0,2,0,1,0,0,0
398,8516,1454,835,1044,76,110,219,1530,17,275,158,296,292,454,2297,3718,9,34017,1889,1,0
397,8484,72,33,56,0,4,12,72,1,1,1,1,2,2,0,2,0,1,0,0,1
397,8484,1454,835,1044,76,110,219,1530,17,275,158,296,292,454,2297,3718,9,34017,1889,1,1
399,8494,72,33,56,0,4,12,72,1,1,1,1,2,2,0,2,0,1,0,0,1
399,8494,1454,835,1044,76,110,219,1530,17,275,158,296,292,454,2297,3718,9,34017,1889,1,1
40,1699,1513,682,1277,25,13,200,1538,11,199,116,219,210,335,1557,2584,6,15641,868,0,0
1,197,382,65,130,157,2,92,539,4,10,5,10,14,15,41,57,2,114,6,0,1
386,8241,72,33,56,0,4,12,72,1,1,1,1,2,2,0,2,0,1,0,0,1
386,8241,1454,835,1044,76,110,219,1530,17,275,158,296,292,454,2297,3718,9,34017,1889,1,1
53,1067,1098,241,925,5,10,155,1103,7,46,25,49,53,74,273,423,3,1580,87,0,1
53,1067,282,202,222,14,2,44,296,8,42,24,43,50,67,250,378,4,1548,86,0,1
162,3651,77,34,69,0,0,8,77,3,24,16,29,27,45,114,213,1,387,21,0,1
162,3651,712,438,573,51,9,84,763,14,102,71,128,116,199,733,1364,8,11988,666,0,1
387,8271,72,33,56,0,4,12,72,1,1,1,1,2,2,0,2,0,1,0,0,1
387,8271,1454,835,1044,76,110,219,1530,17,275,158,296,292,454,2297,3718,9,34017,1889,1,1
35,628,127,75,83,2,11,30,129,4,14,7,14,18,21,61,87,2,175,9,0,1
35,628,652,304,544,16,6,88,668,6,89,51,101,95,152,591,998,3,3399,188,0,1
35,628,2,2,2,0,0,0,2,0,0,0,0,0,0,0,0,0,0,0,0,1
35,628,8,5,5,0,0,3,8,0,0,0,0,0,0,0,0,0,0,0,0,1
35,628,14,8,8,0,0,6,14,0,0,0,0,0,0,0,0,0,0,0,0,1
35,628,6,4,4,0,0,2,6,0,0,0,0,0,0,0,0,0,0,0,0,1
35,628,6,4,4,0,0,2,6,1,2,1,2,3,3,2,4,0,2,0,0,1
35,628,7,5,5,0,0,2,7,0,0,0,0,0,0,0,0,0,0,0,0,1
35,628,10,6,6,0,0,4,10,0,0,0,0,0,0,0,0,0,0,0,0,1
35,628,1,1,1,0,0,0,1,0,0,0,0,0,0,0,0,0,0,0,0,1
35,628,14,10,10,0,0,4,14,1,1,1,1,2,2,0,2,0,1,0,0,1
35,628,46,26,30,3,0,12,49,3,6,3,6,9,9,20,28,1,42,2,0,1
40,1699,1513,682,1277,25,13,200,1538,11,199,116,219,210,335,1557,2584,6,15641,868,0,1
159,3571,77,34,69,0,0,8,77,3,24,16,29,27,45,114,213,1,387,21,0,1
159,3571,712,438,573,51,9,84,763,14,102,71,128,116,199,733,1364,8,11988,666,0,1
387,8323,72,33,56,0,4,12,72,1,1,1,1,2,2,0,2,0,1,0,0,1
387,8323,1454,835,1044,76,110,219,1530,17,275,158,296,292,454,2297,3718,9,34017,1889,1,1
390,8430,72,33,56,0,4,12,72,1,1,1,1,2,2,0,2,0,1,0,0,1
390,8430,1454,835,1044,76,110,219,1530,17,275,158,296,292,454,2297,3718,9,34017,1889,1,1
53,1059,1098,241,925,5,10,155,1103,7,46,25,49,53,74,273,423,3,1580,87,0,1
53,1059,282,202,222,14,2,44,296,8,42,24,43,50,67,250,378,4,1548,86,0,1
393,8487,72,33,56,0,4,12,72,1,1,1,1,2,2,0,2,0,1,0,0,1
393,8487,1454,835,1044,76,110,219,1530,17,275,158,296,292,454,2297,3718,9,34017,1889,1,1
395,8521,72,33,56,0,4,12,72,1,1,1,1,2,2,0,2,0,1,0,0,1
395,8521,1454,835,1044,76,110,219,1530,17,275,158,296,292,454,2297,3718,9,34017,1889,1,1
398,8551,72,33,56,0,4,12,72,1,1,1,1,2,2,0,2,0,1,0,0,1
398,8551,1454,835,1044,76,110,219,1530,17,275,158,296,292,454,2297,3718,9,34017,1889,1,1
156,3098,1943,715,1694,26,18,214,1969,12,185,120,237,197,357,1436,2721,7,20915,1161,0,1
156,3098,1168,838,957,57,25,144,1225,19,348,224,416,367,640,3018,5452,11,61921,3440,1,1
1,191,382,65,130,157,2,92,539,4,10,5,10,14,15,41,57,2,114,6,0,1
397,8525,72,33,56,0,4,12,72,1,1,1,1,2,2,0,2,0,1,0,0,1
397,8525,1454,835,1044,76,110,219,1530,17,275,158,296,292,454,2297,3718,9,34017,1889,1,1
12,392,424,94,331,4,0,89,428,1,5,5,5,6,10,11,25,0,12,0,0,1
397,8524,72,33,56,0,4,12,72,1,1,1,1,2,2,0,2,0,1,0,0,1
397,8524,1454,835,1044,76,110,219,1530,17,275,158,296,292,454,2297,3718,9,34017,1889,1,1
32,1987,1523,757,1297,19,12,193,1542,12,193,117,230,205,347,1508,2664,7,19053,1058,0,0
397,8526,72,33,56,0,4,12,72,1,1,1,1,2,2,0,2,0,1,0,0,1
397,8526,1454,835,1044,76,110,219,1530,17,275,158,296,292,454,2297,3718,9,34017,1889,1,1
1,199,382,65,130,157,2,92,539,4,10,5,10,14,15,41,57,2,114,6,0,1
394,8574,72,33,56,0,4,12,72,1,1,1,1,2,2,0,2,0,1,0,0,1
394,8574,1454,835,1044,76,110,219,1530,17,275,158,296,292,454,2297,3718,9,34017,1889,1,1
19,299,424,94,331,4,0,89,428,1,5,5,5,6,10,11,25,0,12,0,0,1
19,299,38,23,23,6,0,8,44,3,11,7,11,14,18,42,68,1,102,5,0,1
395,8545,72,33,56,0,4,12,72,1,1,1,1,2,2,0,2,0,1,0,0,1
395,8545,1454,835,1044,76,110,219,1530,17,275,158,296,292,454,2297,3718,9,34017,1889,1,1
400,8685,72,33,56,0,4,12,72,1,1,1,1,2,2,0,2,0,1,0,0,1
400,8685,1454,835,1044,76,110,219,1530,17,275,158,296,292,454,2297,3718,9,34017,1889,1,1
404,8730,72,33,56,0,4,12,72,1,1,1,1,2,2,0,2,0,1,0,0,1
404,8730,1454,835,1044,76,110,219,1530,17,275,158,296,292,454,2297,3718,9,34017,1889,1,1
407,8793,72,33,56,0,4,12,72,1,1,1,1,2,2,0,2,0,1,0,0,1
407,8793,1454,835,1044,76,110,219,1530,17,275,158,296,292,454,2297,3718,9,34017,1889,1,1
405,8783,72,33,56,0,4,12,72,1,1,1,1,2,2,0,2,0,1,0,0,1
405,8783,1454,835,1044,76,110,219,1530,17,275,158,296,292,454,2297,3718,9,34017,1889,1,1
400,8717,72,33,56,0,4,12,72,1,1,1,1,2,2,0,2,0,1,0,0,1
400,8717,1454,835,1044,76,110,219,1530,17,275,158,296,292,454,2297,3718,9,34017,1889,1,1
405,8765,72,33,56,0,4,12,72,1,1,1,1,2,2,0,2,0,1,0,0,1
405,8765,1454,835,1044,76,110,219,1530,17,275,158,296,292,454,2297,3718,9,34017,1889,1,1
52,1044,1098,241,925,5,10,155,1103,7,46,25,49,53,74,273,423,3,1580,87,0,1
52,1044,282,202,222,14,2,44,296,8,42,24,43,50,67,250,378,4,1548,86,0,1
405,8766,72,33,56,0,4,12,72,1,1,1,1,2,2,0,2,0,1,0,0,1
405,8766,1454,835,1044,76,110,219,1530,17,275,158,296,292,454,2297,3718,9,34017,1889,1,1
405,8764,72,33,56,0,4,12,72,1,1,1,1,2,2,0,2,0,1,0,0,1
405,8764,1454,835,1044,76,110,219,1530,17,275,158,296,292,454,2297,3718,9,34017,1889,1,1
401,8727,72,33,56,0,4,12,72,1,1,1,1,2,2,0,2,0,1,0,0,1
401,8727,1454,835,1044,76,110,219,1530,17,275,158,296,292,454,2297,3718,9,34017,1889,1,1
52,1047,1098,241,925,5,10,155,1103,7,46,25,49,53,74,273,423,3,1580,87,0,1
52,1047,282,202,222,14,2,44,296,8,42,24,43,50,67,250,378,4,1548,86,0,1
397,8658,72,33,56,0,4,12,72,1,1,1,1,2,2,0,2,0,1,0,0,0
397,8658,1454,835,1044,76,110,219,1530,17,275,158,296,292,454,2297,3718,9,34017,1889,1,0
401,8717,72,33,56,0,4,12,72,1,1,1,1,2,2,0,2,0,1,0,0,1
401,8717,1454,835,1044,76,110,219,1530,17,275,158,296,292,454,2297,3718,9,34017,1889,1,1
402,8746,72,33,56,0,4,12,72,1,1,1,1,2,2,0,2,0,1,0,0,1
402,8746,1454,835,1044,76,110,219,1530,17,275,158,296,292,454,2297,3718,9,34017,1889,1,1
402,8748,72,33,56,0,4,12,72,1,1,1,1,2,2,0,2,0,1,0,0,1
402,8748,1454,835,1044,76,110,219,1530,17,275,158,296,292,454,2297,3718,9,34017,1889,1,1
164,3666,77,34,69,0,0,8,77,3,24,16,29,27,45,114,213,1,387,21,0,1
164,3666,712,438,573,51,9,84,763,14,102,71,128,116,199,733,1364,8,11988,666,0,1
56,1056,1020,354,843,12,15,144,1032,8,134,77,144,142,221,970,1580,4,6792,377,0,1
403,8758,72,33,56,0,4,12,72,1,1,1,1,2,2,0,2,0,1,0,0,1
403,8758,1454,835,1044,76,110,219,1530,17,275,158,296,292,454,2297,3718,9,34017,1889,1,1
35,1533,1020,354,843,12,15,144,1032,8,134,77,144,142,221,970,1580,4,6792,377,0,1
403,8760,72,33,56,0,4,12,72,1,1,1,1,2,2,0,2,0,1,0,0,1
403,8760,1454,835,1044,76,110,219,1530,17,275,158,296,292,454,2297,3718,9,34017,1889,1,1
36,1564,1020,354,843,12,15,144,1032,8,134,77,144,142,221,970,1580,4,6792,377,0,1
403,8762,72,33,56,0,4,12,72,1,1,1,1,2,2,0,2,0,1,0,0,1
403,8762,1454,835,1044,76,110,219,1530,17,275,158,296,292,454,2297,3718,9,34017,1889,1,1
403,8761,72,33,56,0,4,12,72,1,1,1,1,2,2,0,2,0,1,0,0,1
403,8761,1454,835,1044,76,110,219,1530,17,275,158,296,292,454,2297,3718,9,34017,1889,1,1
403,8767,72,33,56,0,4,12,72,1,1,1,1,2,2,0,2,0,1,0,0,1
403,8767,1454,835,1044,76,110,219,1530,17,275,158,296,292,454,2297,3718,9,34017,1889,1,1
403,8776,72,33,56,0,4,12,72,1,1,1,1,2,2,0,2,0,1,0,0,1
403,8776,1454,835,1044,76,110,219,1530,17,275,158,296,292,454,2297,3718,9,34017,1889,1,1
32,1987,1523,757,1297,19,12,193,1542,12,193,117,230,205,347,1508,2664,7,19053,1058,0,1
188,4439,722,423,573,19,0,135,741,12,172,101,199,184,300,1320,2257,6,15668,870,0,0
188,4439,1508,847,911,44,250,301,1552,14,148,88,169,162,257,1120,1886,7,15077,837,0,0
409,8844,72,33,56,0,4,12,72,1,1,1,1,2,2,0,2,0,1,0,0,1
409,8844,1454,835,1044,76,110,219,1530,17,275,158,296,292,454,2297,3718,9,34017,1889,1,1
409,8846,72,33,56,0,4,12,72,1,1,1,1,2,2,0,2,0,1,0,0,1
409,8846,1454,835,1044,76,110,219,1530,17,275,158,296,292,454,2297,3718,9,34017,1889,1,1
83,1453,1178,367,1042,6,15,115,1184,9,94,51,95,103,146,644,976,4,4439,246,0,1
83,1453,177,108,140,8,0,27,185,6,30,16,32,36,48,162,248,3,794,44,0,1
83,1452,1178,367,1042,6,15,115,1184,9,94,51,95,103,146,644,976,4,4439,246,0,1
83,1452,177,108,140,8,0,27,185,6,30,16,32,36,48,162,248,3,794,44,0,1
9,372,42,7,35,4,0,5,46,1,2,1,2,3,3,2,4,0,2,0,0,1
9,372,11,6,10,0,0,1,11,2,4,2,4,6,6,10,15,1,15,0,0,1
11,401,42,7,35,4,0,5,46,1,2,1,2,3,3,2,4,0,2,0,0,1
11,401,11,6,10,0,0,1,11,2,4,2,4,6,6,10,15,1,15,0,0,1
409,8854,72,33,56,0,4,12,72,1,1,1,1,2,2,0,2,0,1,0,0,1
409,8854,1454,835,1044,76,110,219,1530,17,275,158,296,292,454,2297,3718,9,34017,1889,1,1
100,2275,1660,832,1314,41,38,274,1701,20,312,209,395,332,604,2671,5058,12,64042,3557,1,1
409,8857,72,33,56,0,4,12,72,1,1,1,1,2,2,0,2,0,1,0,0,1
409,8857,1454,835,1044,76,110,219,1530,17,275,158,296,292,454,2297,3718,9,34017,1889,1,1
165,3672,77,34,69,0,0,8,77,3,24,16,29,27,45,114,213,1,387,21,0,1
165,3672,712,438,573,51,9,84,763,14,102,71,128,116,199,733,1364,8,11988,666,0,1
53,1057,1098,241,925,5,10,155,1103,7,46,25,49,53,74,273,423,3,1580,87,0,1
53,1057,282,202,222,14,2,44,296,8,42,24,43,50,67,250,378,4,1548,86,0,1
27,1018,1098,241,925,5,10,155,1103,7,46,25,49,53,74,273,423,3,1580,87,0,1
55,1085,1098,241,925,5,10,155,1103,7,46,25,49,53,74,273,423,3,1580,87,0,1
55,1085,282,202,222,14,2,44,296,8,42,24,43,50,67,250,378,4,1548,86,0,1
28,1072,1098,241,925,5,10,155,1103,7,46,25,49,53,74,273,423,3,1580,87,0,1
135,2675,1457,730,1242,11,6,188,1468,10,292,166,329,302,495,2424,4078,5,22973,1276,1,0
135,2675,74,35,59,1,0,14,75,3,14,7,14,17,21,58,85,1,128,7,0,0
135,2675,245,125,200,5,7,34,250,7,30,17,34,37,51,166,265,3,1053,58,0,0
1,199,382,65,130,157,2,92,539,4,10,5,10,14,15,41,57,2,114,6,0,0
410,8865,72,33,56,0,4,12,72,1,1,1,1,2,2,0,2,0,1,0,0,1
410,8865,1454,835,1044,76,110,219,1530,17,275,158,296,292,454,2297,3718,9,34017,1889,1,1
410,8865,72,33,56,0,4,12,72,1,1,1,1,2,2,0,2,0,1,0,0,0
410,8865,1454,835,1044,76,110,219,1530,17,275,158,296,292,454,2297,3718,9,34017,1889,1,0
411,8864,72,33,56,0,4,12,72,1,1,1,1,2,2,0,2,0,1,0,0,1
411,8864,1454,835,1044,76,110,219,1530,17,275,158,296,292,454,2297,3718,9,34017,1889,1,1
409,8836,72,33,56,0,4,12,72,1,1,1,1,2,2,0,2,0,1,0,0,0
409,8836,1454,835,1044,76,110,219,1530,17,275,158,296,292,454,2297,3718,9,34017,1889,1,0
51,2762,1338,495,1086,10,64,173,1348,11,122,82,157,133,239,883,1686,7,11934,663,0,1
97,4106,139,89,101,2,0,35,141,7,54,34,62,61,96,330,569,4,2287,127,0,1
97,4106,7,5,5,0,0,2,7,1,2,1,2,3,3,2,4,0,2,0,0,1
39,2430,1782,648,1425,9,47,279,1791,8,171,97,189,179,286,1292,2140,4,9462,525,0,1
9,192,256,139,192,9,7,47,265,4,23,12,24,27,36,112,171,2,357,19,0,1
57,1111,1098,241,925,5,10,155,1103,7,46,25,49,53,74,273,423,3,1580,87,0,1
57,1111,282,202,222,14,2,44,296,8,42,24,43,50,67,250,378,4,1548,86,0,1
29,1111,1098,241,925,5,10,155,1103,7,46,25,49,53,74,273,423,3,1580,87,0,1
11,401,42,7,35,4,0,5,46,1,2,1,2,3,3,2,4,0,2,0,0,0
11,401,11,6,10,0,0,1,11,2,4,2,4,6,6,10,15,1,15,0,0,0
13,417,424,94,331,4,0,89,428,1,5,5,5,6,10,11,25,0,12,0,0,1
19,299,424,94,331,4,0,89,428,1,5,5,5,6,10,11,25,0,12,0,0,0
19,299,38,23,23,6,0,8,44,3,11,7,11,14,18,42,68,1,102,5,0,0
13,417,424,94,331,4,0,89,428,1,5,5,5,6,10,11,25,0,12,0,0,0
38,1618,1020,354,843,12,15,144,1032,8,134,77,144,142,221,970,1580,4,6792,377,0,1
12,417,42,7,35,4,0,5,46,1,2,1,2,3,3,2,4,0,2,0,0,0
12,417,11,6,10,0,0,1,11,2,4,2,4,6,6,10,15,1,15,0,0,0
12,417,42,7,35,4,0,5,46,1,2,1,2,3,3,2,4,0,2,0,0,1
12,417,11,6,10,0,0,1,11,2,4,2,4,6,6,10,15,1,15,0,0,1
411,8874,72,33,56,0,4,12,72,1,1,1,1,2,2,0,2,0,1,0,0,1
411,8874,1454,835,1044,76,110,219,1530,17,275,158,296,292,454,2297,3718,9,34017,1889,1,1
95,3966,139,89,101,2,0,35,141,7,54,34,62,61,96,330,569,4,2287,127,0,1
95,3966,7,5,5,0,0,2,7,1,2,1,2,3,3,2,4,0,2,0,0,1
12,339,465,148,393,5,8,60,470,4,31,20,31,35,51,161,261,2,523,29,0,1
12,339,16,12,9,0,0,6,16,1,2,1,2,3,3,2,4,0,2,0,0,1
38,1620,1020,354,843,12,15,144,1032,8,134,77,144,142,221,970,1580,4,6792,377,0,1
13,410,424,94,331,4,0,89,428,1,5,5,5,6,10,11,25,0,12,0,0,1
138,2747,1457,730,1242,11,6,188,1468,10,292,166,329,302,495,2424,4078,5,22973,1276,1,1
138,2747,74,35,59,1,0,14,75,3,14,7,14,17,21,58,85,1,128,7,0,1
138,2747,245,125,200,5,7,34,250,7,30,17,34,37,51,166,265,3,1053,58,0,1
33,1692,1457,730,1242,11,6,188,1468,10,292,166,329,302,495,2424,4078,5,22973,1276,1,1
19,303,424,94,331,4,0,89,428,1,5,5,5,6,10,11,25,0,12,0,0,1
19,303,38,23,23,6,0,8,44,3,11,7,11,14,18,42,68,1,102,5,0,1
56,1054,1020,354,843,12,15,144,1032,8,134,77,144,142,221,970,1580,4,6792,377,0,1
40,1736,1020,354,843,12,15,144,1032,8,134,77,144,142,221,970,1580,4,6792,377,0,1
52,1026,1020,354,843,12,15,144,1032,8,134,77,144,142,221,970,1580,4,6792,377,0,1
42,1846,1020,354,843,12,15,144,1032,8,134,77,144,142,221,970,1580,4,6792,377,0,1
140,2768,1457,730,1242,11,6,188,1468,10,292,166,329,302,495,2424,4078,5,22973,1276,1,1
140,2768,74,35,59,1,0,14,75,3,14,7,14,17,21,58,85,1,128,7,0,1
140,2768,245,125,200,5,7,34,250,7,30,17,34,37,51,166,265,3,1053,58,0,1
34,1716,1457,730,1242,11,6,188,1468,10,292,166,329,302,495,2424,4078,5,22973,1276,1,1
411,8876,72,33,56,0,4,12,72,1,1,1,1,2,2,0,2,0,1,0,0,1
411,8876,1454,835,1044,76,110,219,1530,17,275,158,296,292,454,2297,3718,9,34017,1889,1,1
96,4040,139,89,101,2,0,35,141,7,54,34,62,61,96,330,569,4,2287,127,0,1
96,4040,7,5,5,0,0,2,7,1,2,1,2,3,3,2,4,0,2,0,0,1
412,8880,72,33,56,0,4,12,72,1,1,1,1,2,2,0,2,0,1,0,0,1
412,8880,1454,835,1044,76,110,219,1530,17,275,158,296,292,454,2297,3718,9,34017,1889,1,1
11,355,442,244,305,14,16,103,456,11,68,45,75,79,120,452,756,6,4588,254,0,1
11,355,182,102,99,11,40,35,193,3,11,6,11,14,17,42,64,1,97,5,0,1
6,488,442,244,305,14,16,103,456,11,68,45,75,79,120,452,756,6,4588,254,0,1
412,8878,72,33,56,0,4,12,72,1,1,1,1,2,2,0,2,0,1,0,0,1
412,8878,1454,835,1044,76,110,219,1530,17,275,158,296,292,454,2297,3718,9,34017,1889,1,1
97,4113,139,89,101,2,0,35,141,7,54,34,62,61,96,330,569,4,2287,127,0,1
97,4113,7,5,5,0,0,2,7,1,2,1,2,3,3,2,4,0,2,0,0,1
414,8900,72,33,56,0,4,12,72,1,1,1,1,2,2,0,2,0,1,0,0,1
414,8900,1454,835,1044,76,110,219,1530,17,275,158,296,292,454,2297,3718,9,34017,1889,1,1
98,4142,139,89,101,2,0,35,141,7,54,34,62,61,96,330,569,4,2287,127,0,1
98,4142,7,5,5,0,0,2,7,1,2,1,2,3,3,2,4,0,2,0,0,1
34,1725,1457,730,1242,11,6,188,1468,10,292,166,329,302,495,2424,4078,5,22973,1276,1,0
52,1027,1020,354,843,12,15,144,1032,8,134,77,144,142,221,970,1580,4,6792,377,0,1
12,424,42,7,35,4,0,5,46,1,2,1,2,3,3,2,4,0,2,0,0,0
12,424,11,6,10,0,0,1,11,2,4,2,4,6,6,10,15,1,15,0,0,0
12,424,42,7,35,4,0,5,46,1,2,1,2,3,3,2,4,0,2,0,0,1
12,424,11,6,10,0,0,1,11,2,4,2,4,6,6,10,15,1,15,0,0,1
69,1236,1513,682,1277,25,13,200,1538,11,199,116,219,210,335,1557,2584,6,15641,868,0,1
69,1236,819,519,539,24,98,155,843,15,96,57,106,111,163,690,1107,8,9171,509,0,1
21,825,1293,570,1093,25,15,163,1318,10,195,123,241,205,364,1516,2795,6,17273,959,0,1
413,8892,72,33,56,0,4,12,72,1,1,1,1,2,2,0,2,0,1,0,0,1
413,8892,1454,835,1044,76,110,219,1530,17,275,158,296,292,454,2297,3718,9,34017,1889,1,1
52,2827,1338,495,1086,10,64,173,1348,11,122,82,157,133,239,883,1686,7,11934,663,0,1
29,1172,1450,624,1228,12,26,181,1462,14,306,186,354,320,540,2580,4493,8,36391,2021,1,1
11,345,74,35,59,1,0,14,75,3,14,7,14,17,21,58,85,1,128,7,0,0
120,3840,1660,832,1314,41,38,274,1701,20,312,209,395,332,604,2671,5058,12,64042,3557,1,1
120,3840,1057,646,719,113,100,145,1170,18,215,134,248,233,382,1740,3004,10,31186,1732,1,1
102,2320,1660,832,1314,41,38,274,1701,20,312,209,395,332,604,2671,5058,12,64042,3557,1,1
96,2189,1043,504,840,53,9,147,1096,9,180,112,198,189,310,1377,2344,4,11604,644,0,1
96,2189,383,288,292,26,6,62,409,11,65,38,67,76,105,429,656,5,3719,206,0,1
45,1829,1043,504,840,53,9,147,1096,9,180,112,198,189,310,1377,2344,4,11604,644,0,1
18,678,1455,414,1257,16,76,112,1471,5,41,23,46,46,69,231,381,2,1069,59,0,1
18,678,669,365,481,22,61,110,691,15,103,63,122,118,185,747,1273,8,11311,628,0,1
188,4434,722,423,573,19,0,135,741,12,172,101,199,184,300,1320,2257,6,15668,870,0,1
188,4434,1508,847,911,44,250,301,1552,14,148,88,169,162,257,1120,1886,7,15077,837,0,1
45,1832,1043,504,840,53,9,147,1096,9,180,112,198,189,310,1377,2344,4,11604,644,0,1
98,4158,139,89,101,2,0,35,141,7,54,34,62,61,96,330,569,4,2287,127,0,1
98,4158,7,5,5,0,0,2,7,1,2,1,2,3,3,2,4,0,2,0,0,1
19,306,424,94,331,4,0,89,428,1,5,5,5,6,10,11,25,0,12,0,0,1
19,306,38,23,23,6,0,8,44,3,11,7,11,14,18,42,68,1,102,5,0,1
21,326,424,94,331,4,0,89,428,1,5,5,5,6,10,11,25,0,12,0,0,1
21,326,38,23,23,6,0,8,44,3,11,7,11,14,18,42,68,1,102,5,0,1
14,437,424,94,331,4,0,89,428,1,5,5,5,6,10,11,25,0,12,0,0,1
21,326,424,94,331,4,0,89,428,1,5,5,5,6,10,11,25,0,12,0,0,0
21,326,38,23,23,6,0,8,44,3,11,7,11,14,18,42,68,1,102,5,0,0
14,437,424,94,331,4,0,89,428,1,5,5,5,6,10,11,25,0,12,0,0,0
30,1205,1450,624,1228,12,26,181,1462,14,306,186,354,320,540,2580,4493,8,36391,2021,1,1
35,630,127,75,83,2,11,30,129,4,14,7,14,18,21,61,87,2,175,9,0,0
35,630,652,304,544,16,6,88,668,6,89,51,101,95,152,591,998,3,3399,188,0,0
35,630,2,2,2,0,0,0,2,0,0,0,0,0,0,0,0,0,0,0,0,0
35,630,8,5,5,0,0,3,8,0,0,0,0,0,0,0,0,0,0,0,0,0
35,630,14,8,8,0,0,6,14,0,0,0,0,0,0,0,0,0,0,0,0,0
35,630,6,4,4,0,0,2,6,0,0,0,0,0,0,0,0,0,0,0,0,0
35,630,6,4,4,0,0,2,6,1,2,1,2,3,3,2,4,0,2,0,0,0
35,630,7,5,5,0,0,2,7,0,0,0,0,0,0,0,0,0,0,0,0,0
35,630,10,6,6,0,0,4,10,0,0,0,0,0,0,0,0,0,0,0,0,0
35,630,1,1,1,0,0,0,1,0,0,0,0,0,0,0,0,0,0,0,0,0
35,630,14,10,10,0,0,4,14,1,1,1,1,2,2,0,2,0,1,0,0,0
35,630,46,26,30,3,0,12,49,3,6,3,6,9,9,20,28,1,42,2,0,0
413,8895,72,33,56,0,4,12,72,1,1,1,1,2,2,0,2,0,1,0,0,1
413,8895,1454,835,1044,76,110,219,1530,17,275,158,296,292,454,2297,3718,9,34017,1889,1,1
39,2462,1782,648,1425,9,47,279,1791,8,171,97,189,179,286,1292,2140,4,9462,525,0,1
39,2468,1782,648,1425,9,47,279,1791,8,171,97,189,179,286,1292,2140,4,9462,525,0,0
162,3661,77,34,69,0,0,8,77,3,24,16,29,27,45,114,213,1,387,21,0,0
162,3661,712,438,573,51,9,84,763,14,102,71,128,116,199,733,1364,8,11988,666,0,0
156,3100,1943,715,1694,26,18,214,1969,12,185,120,237,197,357,1436,2721,7,20915,1161,0,1
156,3100,1168,838,957,57,25,144,1225,19,348,224,416,367,640,3018,5452,11,61921,3440,1,1
61,2541,1289,550,1043,56,32,155,1345,10,167,93,185,177,278,1266,2075,5,11498,638,0,1
413,8917,72,33,56,0,4,12,72,1,1,1,1,2,2,0,2,0,1,0,0,0
413,8917,1454,835,1044,76,110,219,1530,17,275,158,296,292,454,2297,3718,9,34017,1889,1,0
53,2846,1338,495,1086,10,64,173,1348,11,122,82,157,133,239,883,1686,7,11934,663,0,0
83,1463,1178,367,1042,6,15,115,1184,9,94,51,95,103,146,644,976,4,4439,246,0,0
83,1463,177,108,140,8,0,27,185,6,30,16,32,36,48,162,248,3,794,44,0,0
39,1775,1178,367,1042,6,15,115,1184,9,94,51,95,103,146,644,976,4,4439,246,0,0
83,1456,1178,367,1042,6,15,115,1184,9,94,51,95,103,146,644,976,4,4439,246,0,0
83,1456,177,108,140,8,0,27,185,6,30,16,32,36,48,162,248,3,794,44,0,0
125,3938,1660,832,1314,41,38,274,1701,20,312,209,395,332,604,2671,5058,12,64042,3557,1,1
125,3938,1057,646,719,113,100,145,1170,18,215,134,248,233,382,1740,3004,10,31186,1732,1,1
103,2378,1660,832,1314,41,38,274,1701,20,312,209,395,332,604,2671,5058,12,64042,3557,1,1
1,224,382,65,130,157,2,92,539,4,10,5,10,14,15,41,57,2,114,6,0,1
1,200,382,65,130,157,2,92,539,4,10,5,10,14,15,41,57,2,114,6,0,1
165,3711,77,34,69,0,0,8,77,3,24,16,29,27,45,114,213,1,387,21,0,0
165,3711,712,438,573,51,9,84,763,14,102,71,128,116,199,733,1364,8,11988,666,0,0
21,343,424,94,331,4,0,89,428,1,5,5,5,6,10,11,25,0,12,0,0,0
21,343,38,23,23,6,0,8,44,3,11,7,11,14,18,42,68,1,102,5,0,0
15,464,424,94,331,4,0,89,428,1,5,5,5,6,10,11,25,0,12,0,0,0
162,3675,77,34,69,0,0,8,77,3,24,16,29,27,45,114,213,1,387,21,0,1
162,3675,712,438,573,51,9,84,763,14,102,71,128,116,199,733,1364,8,11988,666,0,1
96,2186,1043,504,840,53,9,147,1096,9,180,112,198,189,310,1377,2344,4,11604,644,0,1
96,2186,383,288,292,26,6,62,409,11,65,38,67,76,105,429,656,5,3719,206,0,1
18,674,1455,414,1257,16,76,112,1471,5,41,23,46,46,69,231,381,2,1069,59,0,1
18,674,669,365,481,22,61,110,691,15,103,63,122,118,185,747,1273,8,11311,628,0,1
12,510,1455,414,1257,16,76,112,1471,5,41,23,46,46,69,231,381,2,1069,59,0,1
18,712,1455,414,1257,16,76,112,1471,5,41,23,46,46,69,231,381,2,1069,59,0,1
18,712,669,365,481,22,61,110,691,15,103,63,122,118,185,747,1273,8,11311,628,0,1
13,546,1455,414,1257,16,76,112,1471,5,41,23,46,46,69,231,381,2,1069,59,0,1
13,542,1455,414,1257,16,76,112,1471,5,41,23,46,46,69,231,381,2,1069,59,0,0
13,542,1455,414,1257,16,76,112,1471,5,41,23,46,46,69,231,381,2,1069,59,0,1
18,712,1455,414,1257,16,76,112,1471,5,41,23,46,46,69,231,381,2,1069,59,0,0
18,712,669,365,481,22,61,110,691,15,103,63,122,118,185,747,1273,8,11311,628,0,0
30,621,2,2,2,0,0,0,2,0,0,0,0,0,0,0,0,0,0,0,0,1
30,621,99,48,90,1,3,5,100,0,0,0,0,0,0,0,0,0,0,0,0,1
30,621,8,5,5,2,0,1,10,0,0,0,0,0,0,0,0,0,0,0,0,1
30,621,1217,716,841,84,126,174,1301,14,185,118,215,199,333,1446,2542,8,20687,1149,0,1
30,621,160,89,115,0,13,31,160,7,15,11,17,22,28,78,124,3,495,27,0,1
30,621,10,10,9,9,0,0,19,0,0,0,0,0,0,0,0,0,0,0,0,1
30,621,173,84,99,8,29,36,181,5,12,7,13,17,20,54,81,2,221,12,0,1
30,621,3,1,1,3,0,0,6,0,0,0,0,0,0,0,0,0,0,0,0,1
21,767,1455,414,1257,16,76,112,1471,5,41,23,46,46,69,231,381,2,1069,59,0,1
21,767,669,365,481,22,61,110,691,15,103,63,122,118,185,747,1273,8,11311,628,0,1
14,597,1455,414,1257,16,76,112,1471,5,41,23,46,46,69,231,381,2,1069,59,0,1
41,1286,1523,757,1297,19,12,193,1542,12,193,117,230,205,347,1508,2664,7,19053,1058,0,1
41,1286,701,378,504,33,58,109,734,13,110,68,126,123,194,794,1346,7,10027,557,0,1
34,2075,1523,757,1297,19,12,193,1542,12,193,117,230,205,347,1508,2664,7,19053,1058,0,1
41,1749,1513,682,1277,25,13,200,1538,11,199,116,219,210,335,1557,2584,6,15641,868,0,1
21,345,424,94,331,4,0,89,428,1,5,5,5,6,10,11,25,0,12,0,0,1
21,345,38,23,23,6,0,8,44,3,11,7,11,14,18,42,68,1,102,5,0,1
15,464,424,94,331,4,0,89,428,1,5,5,5,6,10,11,25,0,12,0,0,1
72,1496,477,336,357,30,23,73,507,16,194,134,250,210,384,1538,2962,10,30538,1696,0,1
56,985,282,196,195,3,0,86,285,8,130,71,141,138,212,936,1507,4,6538,363,0,1
36,1357,1450,624,1228,12,26,181,1462,14,306,186,354,320,540,2580,4493,8,36391,2021,1,1
68,1230,1513,682,1277,25,13,200,1538,11,199,116,219,210,335,1557,2584,6,15641,868,0,1
68,1230,819,519,539,24,98,155,843,15,96,57,106,111,163,690,1107,8,9171,509,0,1
42,1312,1523,757,1297,19,12,193,1542,12,193,117,230,205,347,1508,2664,7,19053,1058,0,1
42,1312,701,378,504,33,58,109,734,13,110,68,126,123,194,794,1346,7,10027,557,0,1
36,2201,1523,757,1297,19,12,193,1542,12,193,117,230,205,347,1508,2664,7,19053,1058,0,1
24,565,1293,570,1093,25,15,163,1318,10,195,123,241,205,364,1516,2795,6,17273,959,0,0
68,1230,1513,682,1277,25,13,200,1538,11,199,116,219,210,335,1557,2584,6,15641,868,0,0
68,1230,819,519,539,24,98,155,843,15,96,57,106,111,163,690,1107,8,9171,509,0,0
42,1312,1523,757,1297,19,12,193,1542,12,193,117,230,205,347,1508,2664,7,19053,1058,0,0
42,1312,701,378,504,33,58,109,734,13,110,68,126,123,194,794,1346,7,10027,557,0,0
36,2201,1523,757,1297,19,12,193,1542,12,193,117,230,205,347,1508,2664,7,19053,1058,0,0
15,473,424,94,331,4,0,89,428,1,5,5,5,6,10,11,25,0,12,0,0,1
24,561,1293,570,1093,25,15,163,1318,10,195,123,241,205,364,1516,2795,6,17273,959,0,0
25,575,1293,570,1093,25,15,163,1318,10,195,123,241,205,364,1516,2795,6,17273,959,0,0
26,594,1293,570,1093,25,15,163,1318,10,195,123,241,205,364,1516,2795,6,17273,959,0,1
139,2741,1457,730,1242,11,6,188,1468,10,292,166,329,302,495,2424,4078,5,22973,1276,1,1
139,2741,74,35,59,1,0,14,75,3,14,7,14,17,21,58,85,1,128,7,0,1
139,2741,245,125,200,5,7,34,250,7,30,17,34,37,51,166,265,3,1053,58,0,1
101,4362,139,89,101,2,0,35,141,7,54,34,62,61,96,330,569,4,2287,127,0,1
101,4362,7,5,5,0,0,2,7,1,2,1,2,3,3,2,4,0,2,0,0,1
29,1371,652,304,544,16,6,88,668,6,89,51,101,95,152,591,998,3,3399,188,0,1
417,8949,72,33,56,0,4,12,72,1,1,1,1,2,2,0,2,0,1,0,0,1
417,8949,1454,835,1044,76,110,219,1530,17,275,158,296,292,454,2297,3718,9,34017,1889,1,1
99,2220,1043,504,840,53,9,147,1096,9,180,112,198,189,310,1377,2344,4,11604,644,0,1
99,2220,383,288,292,26,6,62,409,11,65,38,67,76,105,429,656,5,3719,206,0,1
13,386,465,148,393,5,8,60,470,4,31,20,31,35,51,161,261,2,523,29,0,1
13,386,16,12,9,0,0,6,16,1,2,1,2,3,3,2,4,0,2,0,0,1
6,493,442,244,305,14,16,103,456,11,68,45,75,79,120,452,756,6,4588,254,0,1
72,1494,477,336,357,30,23,73,507,16,194,134,250,210,384,1538,2962,10,30538,1696,0,1
72,1498,477,336,357,30,23,73,507,16,194,134,250,210,384,1538,2962,10,30538,1696,0,1
37,1394,1450,624,1228,12,26,181,1462,14,306,186,354,320,540,2580,4493,8,36391,2021,1,1
418,8966,72,33,56,0,4,12,72,1,1,1,1,2,2,0,2,0,1,0,0,1
418,8966,1454,835,1044,76,110,219,1530,17,275,158,296,292,454,2297,3718,9,34017,1889,1,1
99,4187,139,89,101,2,0,35,141,7,54,34,62,61,96,330,569,4,2287,127,0,1
99,4187,7,5,5,0,0,2,7,1,2,1,2,3,3,2,4,0,2,0,0,1
37,1396,1450,624,1228,12,26,181,1462,14,306,186,354,320,540,2580,4493,8,36391,2021,1,1
127,3961,1660,832,1314,41,38,274,1701,20,312,209,395,332,604,2671,5058,12,64042,3557,1,0
127,3961,1057,646,719,113,100,145,1170,18,215,134,248,233,382,1740,3004,10,31186,1732,1,0
38,1430,1450,624,1228,12,26,181,1462,14,306,186,354,320,540,2580,4493,8,36391,2021,1,0
1,224,382,65,130,157,2,92,539,4,10,5,10,14,15,41,57,2,114,6,0,0
423,9090,72,33,56,0,4,12,72,1,1,1,1,2,2,0,2,0,1,0,0,1
423,9090,1454,835,1044,76,110,219,1530,17,275,158,296,292,454,2297,3718,9,34017,1889,1,1
104,4340,139,89,101,2,0,35,141,7,54,34,62,61,96,330,569,4,2287,127,0,1
104,4340,7,5,5,0,0,2,7,1,2,1,2,3,3,2,4,0,2,0,0,1
99,2230,1043,504,840,53,9,147,1096,9,180,112,198,189,310,1377,2344,4,11604,644,0,0
99,2230,383,288,292,26,6,62,409,11,65,38,67,76,105,429,656,5,3719,206,0,0
84,1473,1178,367,1042,6,15,115,1184,9,94,51,95,103,146,644,976,4,4439,246,0,1
84,1473,177,108,140,8,0,27,185,6,30,16,32,36,48,162,248,3,794,44,0,1
42,1867,1178,367,1042,6,15,115,1184,9,94,51,95,103,146,644,976,4,4439,246,0,1
42,1321,1523,757,1297,19,12,193,1542,12,193,117,230,205,347,1508,2664,7,19053,1058,0,1
42,1321,701,378,504,33,58,109,734,13,110,68,126,123,194,794,1346,7,10027,557,0,1
99,2230,1043,504,840,53,9,147,1096,9,180,112,198,189,310,1377,2344,4,11604,644,0,1
99,2230,383,288,292,26,6,62,409,11,65,38,67,76,105,429,656,5,3719,206,0,1
57,2580,1943,715,1694,26,18,214,1969,12,185,120,237,197,357,1436,2721,7,20915,1161,0,1
57,2580,1943,715,1694,26,18,214,1969,12,185,120,237,197,357,1436,2721,7,20915,1161,0,0
37,2246,1523,757,1297,19,12,193,1542,12,193,117,230,205,347,1508,2664,7,19053,1058,0,1
42,1321,1523,757,1297,19,12,193,1542,12,193,117,230,205,347,1508,2664,7,19053,1058,0,0
42,1321,701,378,504,33,58,109,734,13,110,68,126,123,194,794,1346,7,10027,557,0,0
37,2246,1523,757,1297,19,12,193,1542,12,193,117,230,205,347,1508,2664,7,19053,1058,0,0
12,222,127,75,83,2,11,30,129,4,14,7,14,18,21,61,87,2,175,9,0,0
12,222,652,304,544,16,6,88,668,6,89,51,101,95,152,591,998,3,3399,188,0,0
12,222,2,2,2,0,0,0,2,0,0,0,0,0,0,0,0,0,0,0,0,0
12,222,8,5,5,0,0,3,8,0,0,0,0,0,0,0,0,0,0,0,0,0
12,222,14,8,8,0,0,6,14,0,0,0,0,0,0,0,0,0,0,0,0,0
12,222,6,4,4,0,0,2,6,0,0,0,0,0,0,0,0,0,0,0,0,0
12,222,6,4,4,0,0,2,6,1,2,1,2,3,3,2,4,0,2,0,0,0
12,222,7,5,5,0,0,2,7,0,0,0,0,0,0,0,0,0,0,0,0,0
12,222,10,6,6,0,0,4,10,0,0,0,0,0,0,0,0,0,0,0,0,0
12,222,1,1,1,0,0,0,1,0,0,0,0,0,0,0,0,0,0,0,0,0
12,222,14,10,10,0,0,4,14,1,1,1,1,2,2,0,2,0,1,0,0,0
12,222,46,26,30,3,0,12,49,3,6,3,6,9,9,20,28,1,42,2,0,0
427,9239,72,33,56,0,4,12,72,1,1,1,1,2,2,0,2,0,1,0,0,1
427,9239,1454,835,1044,76,110,219,1530,17,275,158,296,292,454,2297,3718,9,34017,1889,1,1
51,2975,1782,648,1425,9,47,279,1791,8,171,97,189,179,286,1292,2140,4,9462,525,0,1
25,860,1455,414,1257,16,76,112,1471,5,41,23,46,46,69,231,381,2,1069,59,0,1
25,860,669,365,481,22,61,110,691,15,103,63,122,118,185,747,1273,8,11311,628,0,1
22,919,1455,414,1257,16,76,112,1471,5,41,23,46,46,69,231,381,2,1069,59,0,1
425,9242,72,33,56,0,4,12,72,1,1,1,1,2,2,0,2,0,1,0,0,1
425,9242,1454,835,1044,76,110,219,1530,17,275,158,296,292,454,2297,3718,9,34017,1889,1,1
51,2929,1782,648,1425,9,47,279,1791,8,171,97,189,179,286,1292,2140,4,9462,525,0,1
164,3702,77,34,69,0,0,8,77,3,24,16,29,27,45,114,213,1,387,21,0,1
164,3702,712,438,573,51,9,84,763,14,102,71,128,116,199,733,1364,8,11988,666,0,1
60,1138,1020,354,843,12,15,144,1032,8,134,77,144,142,221,970,1580,4,6792,377,0,1
25,860,1455,414,1257,16,76,112,1471,5,41,23,46,46,69,231,381,2,1069,59,0,0
25,860,669,365,481,22,61,110,691,15,103,63,122,118,185,747,1273,8,11311,628,0,0
22,919,1455,414,1257,16,76,112,1471,5,41,23,46,46,69,231,381,2,1069,59,0,0
425,9242,72,33,56,0,4,12,72,1,1,1,1,2,2,0,2,0,1,0,0,0
425,9242,1454,835,1044,76,110,219,1530,17,275,158,296,292,454,2297,3718,9,34017,1889,1,0
51,2929,1782,648,1425,9,47,279,1791,8,171,97,189,179,286,1292,2140,4,9462,525,0,0
425,9235,72,33,56,0,4,12,72,1,1,1,1,2,2,0,2,0,1,0,0,1
425,9235,1454,835,1044,76,110,219,1530,17,275,158,296,292,454,2297,3718,9,34017,1889,1,1
51,2930,1782,648,1425,9,47,279,1791,8,171,97,189,179,286,1292,2140,4,9462,525,0,1
44,1923,1020,354,843,12,15,144,1032,8,134,77,144,142,221,970,1580,4,6792,377,0,0
45,2010,1020,354,843,12,15,144,1032,8,134,77,144,142,221,970,1580,4,6792,377,0,0
59,1130,1020,354,843,12,15,144,1032,8,134,77,144,142,221,970,1580,4,6792,377,0,1
59,1132,1020,354,843,12,15,144,1032,8,134,77,144,142,221,970,1580,4,6792,377,0,1
45,2010,1020,354,843,12,15,144,1032,8,134,77,144,142,221,970,1580,4,6792,377,0,1
164,3702,77,34,69,0,0,8,77,3,24,16,29,27,45,114,213,1,387,21,0,0
164,3702,712,438,573,51,9,84,763,14,102,71,128,116,199,733,1364,8,11988,666,0,0
59,1132,1020,354,843,12,15,144,1032,8,134,77,144,142,221,970,1580,4,6792,377,0,0
428,9261,72,33,56,0,4,12,72,1,1,1,1,2,2,0,2,0,1,0,0,1
428,9261,1454,835,1044,76,110,219,1530,17,275,158,296,292,454,2297,3718,9,34017,1889,1,1
52,2959,1782,648,1425,9,47,279,1791,8,171,97,189,179,286,1292,2140,4,9462,525,0,1
128,3970,1660,832,1314,41,38,274,1701,20,312,209,395,332,604,2671,5058,12,64042,3557,1,1
128,3970,1057,646,719,113,100,145,1170,18,215,134,248,233,382,1740,3004,10,31186,1732,1,1
106,2462,1660,832,1314,41,38,274,1701,20,312,209,395,332,604,2671,5058,12,64042,3557,1,1
430,9299,72,33,56,0,4,12,72,1,1,1,1,2,2,0,2,0,1,0,0,1
430,9299,1454,835,1044,76,110,219,1530,17,275,158,296,292,454,2297,3718,9,34017,1889,1,1
55,3168,1782,648,1425,9,47,279,1791,8,171,97,189,179,286,1292,2140,4,9462,525,0,1
106,2462,1660,832,1314,41,38,274,1701,20,312,209,395,332,604,2671,5058,12,64042,3557,1,0
128,3970,1660,832,1314,41,38,274,1701,20,312,209,395,332,604,2671,5058,12,64042,3557,1,0
128,3970,1057,646,719,113,100,145,1170,18,215,134,248,233,382,1740,3004,10,31186,1732,1,0
164,3720,77,34,69,0,0,8,77,3,24,16,29,27,45,114,213,1,387,21,0,1
164,3720,712,438,573,51,9,84,763,14,102,71,128,116,199,733,1364,8,11988,666,0,1
24,972,373,158,315,8,0,51,381,5,76,44,79,81,123,486,779,2,2026,112,0,1
430,9291,72,33,56,0,4,12,72,1,1,1,1,2,2,0,2,0,1,0,0,1
430,9291,1454,835,1044,76,110,219,1530,17,275,158,296,292,454,2297,3718,9,34017,1889,1,1
30,1144,1098,241,925,5,10,155,1103,7,46,25,49,53,74,273,423,3,1580,87,0,1
30,1144,1098,241,925,5,10,155,1103,7,46,25,49,53,74,273,423,3,1580,87,0,0
430,9303,72,33,56,0,4,12,72,1,1,1,1,2,2,0,2,0,1,0,0,1
430,9303,1454,835,1044,76,110,219,1530,17,275,158,296,292,454,2297,3718,9,34017,1889,1,1
53,2989,1782,648,1425,9,47,279,1791,8,171,97,189,179,286,1292,2140,4,9462,525,0,1
157,3128,1943,715,1694,26,18,214,1969,12,185,120,237,197,357,1436,2721,7,20915,1161,0,0
157,3128,1168,838,957,57,25,144,1225,19,348,224,416,367,640,3018,5452,11,61921,3440,1,0
72,1498,477,336,357,30,23,73,507,16,194,134,250,210,384,1538,2962,10,30538,1696,0,0
164,3720,77,34,69,0,0,8,77,3,24,16,29,27,45,114,213,1,387,21,0,0
164,3720,712,438,573,51,9,84,763,14,102,71,128,116,199,733,1364,8,11988,666,0,0
430,9303,72,33,56,0,4,12,72,1,1,1,1,2,2,0,2,0,1,0,0,0
430,9303,1454,835,1044,76,110,219,1530,17,275,158,296,292,454,2297,3718,9,34017,1889,1,0
84,1473,1178,367,1042,6,15,115,1184,9,94,51,95,103,146,644,976,4,4439,246,0,0
84,1473,177,108,140,8,0,27,185,6,30,16,32,36,48,162,248,3,794,44,0,0
107,4544,139,89,101,2,0,35,141,7,54,34,62,61,96,330,569,4,2287,127,0,0
107,4544,7,5,5,0,0,2,7,1,2,1,2,3,3,2,4,0,2,0,0,0
13,386,465,148,393,5,8,60,470,4,31,20,31,35,51,161,261,2,523,29,0,0
13,386,16,12,9,0,0,6,16,1,2,1,2,3,3,2,4,0,2,0,0,0
53,2989,1782,648,1425,9,47,279,1791,8,171,97,189,179,286,1292,2140,4,9462,525,0,0
24,972,373,158,315,8,0,51,381,5,76,44,79,81,123,486,779,2,2026,112,0,0
42,1867,1178,367,1042,6,15,115,1184,9,94,51,95,103,146,644,976,4,4439,246,0,0
6,493,442,244,305,14,16,103,456,11,68,45,75,79,120,452,756,6,4588,254,0,0
29,1369,652,304,544,16,6,88,668,6,89,51,101,95,152,591,998,3,3399,188,0,0
159,3155,1943,715,1694,26,18,214,1969,12,185,120,237,197,357,1436,2721,7,20915,1161,0,1
159,3155,1168,838,957,57,25,144,1225,19,348,224,416,367,640,3018,5452,11,61921,3440,1,1
58,2641,1943,715,1694,26,18,214,1969,12,185,120,237,197,357,1436,2721,7,20915,1161,0,1
139,2741,1457,730,1242,11,6,188,1468,10,292,166,329,302,495,2424,4078,5,22973,1276,1,0
139,2741,74,35,59,1,0,14,75,3,14,7,14,17,21,58,85,1,128,7,0,0
139,2741,245,125,200,5,7,34,250,7,30,17,34,37,51,166,265,3,1053,58,0,0
58,2641,1943,715,1694,26,18,214,1969,12,185,120,237,197,357,1436,2721,7,20915,1161,0,0
159,3155,1943,715,1694,26,18,214,1969,12,185,120,237,197,357,1436,2721,7,20915,1161,0,0
159,3155,1168,838,957,57,25,144,1225,19,348,224,416,367,640,3018,5452,11,61921,3440,1,0
432,9349,72,33,56,0,4,12,72,1,1,1,1,2,2,0,2,0,1,0,0,1
432,9349,1454,835,1044,76,110,219,1530,17,275,158,296,292,454,2297,3718,9,34017,1889,1,1
108,4591,139,89,101,2,0,35,141,7,54,34,62,61,96,330,569,4,2287,127,0,1
108,4591,7,5,5,0,0,2,7,1,2,1,2,3,3,2,4,0,2,0,0,1
128,3964,1660,832,1314,41,38,274,1701,20,312,209,395,332,604,2671,5058,12,64042,3557,1,1
128,3964,1057,646,719,113,100,145,1170,18,215,134,248,233,382,1740,3004,10,31186,1732,1,1
43,1919,1178,367,1042,6,15,115,1184,9,94,51,95,103,146,644,976,4,4439,246,0,1
43,1919,1178,367,1042,6,15,115,1184,9,94,51,95,103,146,644,976,4,4439,246,0,0
432,9350,72,33,56,0,4,12,72,1,1,1,1,2,2,0,2,0,1,0,0,1
432,9350,1454,835,1044,76,110,219,1530,17,275,158,296,292,454,2297,3718,9,34017,1889,1,1
432,9350,72,33,56,0,4,12,72,1,1,1,1,2,2,0,2,0,1,0,0,0
432,9350,1454,835,1044,76,110,219,1530,17,275,158,296,292,454,2297,3718,9,34017,1889,1,0
108,4591,139,89,101,2,0,35,141,7,54,34,62,61,96,330,569,4,2287,127,0,0
108,4591,7,5,5,0,0,2,7,1,2,1,2,3,3,2,4,0,2,0,0,0
43,1913,1178,367,1042,6,15,115,1184,9,94,51,95,103,146,644,976,4,4439,246,0,1
43,1913,1178,367,1042,6,15,115,1184,9,94,51,95,103,146,644,976,4,4439,246,0,0
434,9388,72,33,56,0,4,12,72,1,1,1,1,2,2,0,2,0,1,0,0,0
434,9388,1454,835,1044,76,110,219,1530,17,275,158,296,292,454,2297,3718,9,34017,1889,1,0
56,3198,1782,648,1425,9,47,279,1791,8,171,97,189,179,286,1292,2140,4,9462,525,0,0
434,9390,72,33,56,0,4,12,72,1,1,1,1,2,2,0,2,0,1,0,0,1
434,9390,1454,835,1044,76,110,219,1530,17,275,158,296,292,454,2297,3718,9,34017,1889,1,1
56,3203,1782,648,1425,9,47,279,1791,8,171,97,189,179,286,1292,2140,4,9462,525,0,1
160,3161,1943,715,1694,26,18,214,1969,12,185,120,237,197,357,1436,2721,7,20915,1161,0,0
160,3161,1168,838,957,57,25,144,1225,19,348,224,416,367,640,3018,5452,11,61921,3440,1,0
435,9394,72,33,56,0,4,12,72,1,1,1,1,2,2,0,2,0,1,0,0,1
435,9394,1454,835,1044,76,110,219,1530,17,275,158,296,292,454,2297,3718,9,34017,1889,1,1
110,4667,139,89,101,2,0,35,141,7,54,34,62,61,96,330,569,4,2287,127,0,1
110,4667,7,5,5,0,0,2,7,1,2,1,2,3,3,2,4,0,2,0,0,1
68,1226,1513,682,1277,25,13,200,1538,11,199,116,219,210,335,1557,2584,6,15641,868,0,1
68,1226,819,519,539,24,98,155,843,15,96,57,106,111,163,690,1107,8,9171,509,0,1
172,3366,1457,730,1242,11,6,188,1468,10,292,166,329,302,495,2424,4078,5,22973,1276,1,1
172,3366,74,35,59,1,0,14,75,3,14,7,14,17,21,58,85,1,128,7,0,1
172,3366,245,125,200,5,7,34,250,7,30,17,34,37,51,166,265,3,1053,58,0,1
42,1131,74,35,59,1,0,14,75,3,14,7,14,17,21,58,85,1,128,7,0,1
42,1131,245,125,200,5,7,34,250,7,30,17,34,37,51,166,265,3,1053,58,0,1
14,453,184,100,137,2,15,30,186,6,38,20,39,44,59,214,322,3,991,55,0,1
14,453,103,65,74,8,5,16,111,7,17,9,17,24,26,89,119,3,417,23,0,1
160,3157,1943,715,1694,26,18,214,1969,12,185,120,237,197,357,1436,2721,7,20915,1161,0,1
160,3157,1168,838,957,57,25,144,1225,19,348,224,416,367,640,3018,5452,11,61921,3440,1,1
46,2032,1020,354,843,12,15,144,1032,8,134,77,144,142,221,970,1580,4,6792,377,0,1
22,1115,334,251,279,10,4,40,344,5,127,74,143,132,217,899,1528,2,4303,239,0,1
178,3490,1457,730,1242,11,6,188,1468,10,292,166,329,302,495,2424,4078,5,22973,1276,1,1
178,3490,74,35,59,1,0,14,75,3,14,7,14,17,21,58,85,1,128,7,0,1
178,3490,245,125,200,5,7,34,250,7,30,17,34,37,51,166,265,3,1053,58,0,1
68,1226,1513,682,1277,25,13,200,1538,11,199,116,219,210,335,1557,2584,6,15641,868,0,0
68,1226,819,519,539,24,98,155,843,15,96,57,106,111,163,690,1107,8,9171,509,0,0
178,3490,1457,730,1242,11,6,188,1468,10,292,166,329,302,495,2424,4078,5,22973,1276,1,0
178,3490,74,35,59,1,0,14,75,3,14,7,14,17,21,58,85,1,128,7,0,0
178,3490,245,125,200,5,7,34,250,7,30,17,34,37,51,166,265,3,1053,58,0,0
42,1131,74,35,59,1,0,14,75,3,14,7,14,17,21,58,85,1,128,7,0,0
42,1131,245,125,200,5,7,34,250,7,30,17,34,37,51,166,265,3,1053,58,0,0
43,415,647,139,84,35,284,233,682,0,0,0,0,0,0,0,0,0,0,0,0,0
14,453,184,100,137,2,15,30,186,6,38,20,39,44,59,214,322,3,991,55,0,0
14,453,103,65,74,8,5,16,111,7,17,9,17,24,26,89,119,3,417,23,0,0
160,3157,1943,715,1694,26,18,214,1969,12,185,120,237,197,357,1436,2721,7,20915,1161,0,0
160,3157,1168,838,957,57,25,144,1225,19,348,224,416,367,640,3018,5452,11,61921,3440,1,0
46,2032,1020,354,843,12,15,144,1032,8,134,77,144,142,221,970,1580,4,6792,377,0,0
22,1115,334,251,279,10,4,40,344,5,127,74,143,132,217,899,1528,2,4303,239,0,0
13,444,42,7,35,4,0,5,46,1,2,1,2,3,3,2,4,0,2,0,0,1
13,444,11,6,10,0,0,1,11,2,4,2,4,6,6,10,15,1,15,0,0,1
35,645,127,75,83,2,11,30,129,4,14,7,14,18,21,61,87,2,175,9,0,1
35,645,652,304,544,16,6,88,668,6,89,51,101,95,152,591,998,3,3399,188,0,1
35,645,2,2,2,0,0,0,2,0,0,0,0,0,0,0,0,0,0,0,0,1
35,645,8,5,5,0,0,3,8,0,0,0,0,0,0,0,0,0,0,0,0,1
35,645,14,8,8,0,0,6,14,0,0,0,0,0,0,0,0,0,0,0,0,1
35,645,6,4,4,0,0,2,6,0,0,0,0,0,0,0,0,0,0,0,0,1
35,645,6,4,4,0,0,2,6,1,2,1,2,3,3,2,4,0,2,0,0,1
35,645,7,5,5,0,0,2,7,0,0,0,0,0,0,0,0,0,0,0,0,1
35,645,10,6,6,0,0,4,10,0,0,0,0,0,0,0,0,0,0,0,0,1
35,645,1,1,1,0,0,0,1,0,0,0,0,0,0,0,0,0,0,0,0,1
35,645,14,10,10,0,0,4,14,1,1,1,1,2,2,0,2,0,1,0,0,1
35,645,46,26,30,3,0,12,49,3,6,3,6,9,9,20,28,1,42,2,0,1
22,1119,334,251,279,10,4,40,344,5,127,74,143,132,217,899,1528,2,4303,239,0,1
35,645,127,75,83,2,11,30,129,4,14,7,14,18,21,61,87,2,175,9,0,0
35,645,652,304,544,16,6,88,668,6,89,51,101,95,152,591,998,3,3399,188,0,0
35,645,2,2,2,0,0,0,2,0,0,0,0,0,0,0,0,0,0,0,0,0
35,645,8,5,5,0,0,3,8,0,0,0,0,0,0,0,0,0,0,0,0,0
35,645,14,8,8,0,0,6,14,0,0,0,0,0,0,0,0,0,0,0,0,0
35,645,6,4,4,0,0,2,6,0,0,0,0,0,0,0,0,0,0,0,0,0
35,645,6,4,4,0,0,2,6,1,2,1,2,3,3,2,4,0,2,0,0,0
35,645,7,5,5,0,0,2,7,0,0,0,0,0,0,0,0,0,0,0,0,0
35,645,10,6,6,0,0,4,10,0,0,0,0,0,0,0,0,0,0,0,0,0
35,645,1,1,1,0,0,0,1,0,0,0,0,0,0,0,0,0,0,0,0,0
35,645,14,10,10,0,0,4,14,1,1,1,1,2,2,0,2,0,1,0,0,0
35,645,46,26,30,3,0,12,49,3,6,3,6,9,9,20,28,1,42,2,0,0
1,87,19,8,11,5,0,4,24,2,5,3,6,7,9,13,25,1,30,1,0,1
1,87,102,59,69,5,3,24,107,6,22,15,28,28,43,113,206,3,789,43,0,1
1,87,106,40,36,3,49,17,109,8,17,13,23,25,36,93,167,5,904,50,0,1
181,3563,1457,730,1242,11,6,188,1468,10,292,166,329,302,495,2424,4078,5,22973,1276,1,1
181,3563,74,35,59,1,0,14,75,3,14,7,14,17,21,58,85,1,128,7,0,1
181,3563,245,125,200,5,7,34,250,7,30,17,34,37,51,166,265,3,1053,58,0,1
25,1433,334,251,279,10,4,40,344,5,127,74,143,132,217,899,1528,2,4303,239,0,1
1,85,19,8,11,5,0,4,24,2,5,3,6,7,9,13,25,1,30,1,0,1
1,85,102,59,69,5,3,24,107,6,22,15,28,28,43,113,206,3,789,43,0,1
1,85,106,40,36,3,49,17,109,8,17,13,23,25,36,93,167,5,904,50,0,1
26,1521,334,251,279,10,4,40,344,5,127,74,143,132,217,899,1528,2,4303,239,0,1
1,85,19,8,11,5,0,4,24,2,5,3,6,7,9,13,25,1,30,1,0,0
1,85,102,59,69,5,3,24,107,6,22,15,28,28,43,113,206,3,789,43,0,0
1,85,106,40,36,3,49,17,109,8,17,13,23,25,36,93,167,5,904,50,0,0
181,3563,1457,730,1242,11,6,188,1468,10,292,166,329,302,495,2424,4078,5,22973,1276,1,0
181,3563,74,35,59,1,0,14,75,3,14,7,14,17,21,58,85,1,128,7,0,0
181,3563,245,125,200,5,7,34,250,7,30,17,34,37,51,166,265,3,1053,58,0,0
26,1521,334,251,279,10,4,40,344,5,127,74,143,132,217,899,1528,2,4303,239,0,0
26,1539,334,251,279,10,4,40,344,5,127,74,143,132,217,899,1528,2,4303,239,0,0
26,1517,334,251,279,10,4,40,344,5,127,74,143,132,217,899,1528,2,4303,239,0,1
13,426,42,7,35,4,0,5,46,1,2,1,2,3,3,2,4,0,2,0,0,0
13,426,11,6,10,0,0,1,11,2,4,2,4,6,6,10,15,1,15,0,0,0
26,1517,334,251,279,10,4,40,344,5,127,74,143,132,217,899,1528,2,4303,239,0,0
435,9394,72,33,56,0,4,12,72,1,1,1,1,2,2,0,2,0,1,0,0,0
435,9394,1454,835,1044,76,110,219,1530,17,275,158,296,292,454,2297,3718,9,34017,1889,1,0
181,3565,1457,730,1242,11,6,188,1468,10,292,166,329,302,495,2424,4078,5,22973,1276,1,0
181,3565,74,35,59,1,0,14,75,3,14,7,14,17,21,58,85,1,128,7,0,0
181,3565,245,125,200,5,7,34,250,7,30,17,34,37,51,166,265,3,1053,58,0,0
26,1508,334,251,279,10,4,40,344,5,127,74,143,132,217,899,1528,2,4303,239,0,0
73,1525,477,336,357,30,23,73,507,16,194,134,250,210,384,1538,2962,10,30538,1696,0,1
48,1675,1450,624,1228,12,26,181,1462,14,306,186,354,320,540,2580,4493,8,36391,2021,1,1
73,1533,477,336,357,30,23,73,507,16,194,134,250,210,384,1538,2962,10,30538,1696,0,1
35,643,127,75,83,2,11,30,129,4,14,7,14,18,21,61,87,2,175,9,0,1
35,643,652,304,544,16,6,88,668,6,89,51,101,95,152,591,998,3,3399,188,0,1
35,643,2,2,2,0,0,0,2,0,0,0,0,0,0,0,0,0,0,0,0,1
35,643,8,5,5,0,0,3,8,0,0,0,0,0,0,0,0,0,0,0,0,1
35,643,14,8,8,0,0,6,14,0,0,0,0,0,0,0,0,0,0,0,0,1
35,643,6,4,4,0,0,2,6,0,0,0,0,0,0,0,0,0,0,0,0,1
35,643,6,4,4,0,0,2,6,1,2,1,2,3,3,2,4,0,2,0,0,1
35,643,7,5,5,0,0,2,7,0,0,0,0,0,0,0,0,0,0,0,0,1
35,643,10,6,6,0,0,4,10,0,0,0,0,0,0,0,0,0,0,0,0,1
35,643,1,1,1,0,0,0,1,0,0,0,0,0,0,0,0,0,0,0,0,1
35,643,14,10,10,0,0,4,14,1,1,1,1,2,2,0,2,0,1,0,0,1
35,643,46,26,30,3,0,12,49,3,6,3,6,9,9,20,28,1,42,2,0,1
49,1694,1450,624,1228,12,26,181,1462,14,306,186,354,320,540,2580,4493,8,36391,2021,1,1
126,3959,1660,832,1314,41,38,274,1701,20,312,209,395,332,604,2671,5058,12,64042,3557,1,1
126,3959,1057,646,719,113,100,145,1170,18,215,134,248,233,382,1740,3004,10,31186,1732,1,1
109,2592,1660,832,1314,41,38,274,1701,20,312,209,395,332,604,2671,5058,12,64042,3557,1,1
200,3870,1457,730,1242,11,6,188,1468,10,292,166,329,302,495,2424,4078,5,22973,1276,1,1
200,3870,74,35,59,1,0,14,75,3,14,7,14,17,21,58,85,1,128,7,0,1
200,3870,245,125,200,5,7,34,250,7,30,17,34,37,51,166,265,3,1053,58,0,1
35,2151,334,251,279,10,4,40,344,5,127,74,143,132,217,899,1528,2,4303,239,0,1
35,2147,334,251,279,10,4,40,344,5,127,74,143,132,217,899,1528,2,4303,239,0,0
200,3870,1457,730,1242,11,6,188,1468,10,292,166,329,302,495,2424,4078,5,22973,1276,1,0
200,3870,74,35,59,1,0,14,75,3,14,7,14,17,21,58,85,1,128,7,0,0
200,3870,245,125,200,5,7,34,250,7,30,17,34,37,51,166,265,3,1053,58,0,0
30,619,2,2,2,0,0,0,2,0,0,0,0,0,0,0,0,0,0,0,0,1
30,619,99,48,90,1,3,5,100,0,0,0,0,0,0,0,0,0,0,0,0,1
30,619,8,5,5,2,0,1,10,0,0,0,0,0,0,0,0,0,0,0,0,1
30,619,1217,716,841,84,126,174,1301,14,185,118,215,199,333,1446,2542,8,20687,1149,0,1
30,619,160,89,115,0,13,31,160,7,15,11,17,22,28,78,124,3,495,27,0,1
30,619,10,10,9,9,0,0,19,0,0,0,0,0,0,0,0,0,0,0,0,1
30,619,173,84,99,8,29,36,181,5,12,7,13,17,20,54,81,2,221,12,0,1
30,619,3,1,1,3,0,0,6,0,0,0,0,0,0,0,0,0,0,0,0,1
42,1129,74,35,59,1,0,14,75,3,14,7,14,17,21,58,85,1,128,7,0,1
42,1129,245,125,200,5,7,34,250,7,30,17,34,37,51,166,265,3,1053,58,0,1
164,3718,77,34,69,0,0,8,77,3,24,16,29,27,45,114,213,1,387,21,0,1
164,3718,712,438,573,51,9,84,763,14,102,71,128,116,199,733,1364,8,11988,666,0,1
29,601,215,129,180,6,0,29,221,8,65,43,72,73,115,415,711,4,3153,175,0,1
29,601,97,69,77,3,3,16,100,6,22,13,23,28,36,113,173,3,542,30,0,1
160,3155,1943,715,1694,26,18,214,1969,12,185,120,237,197,357,1436,2721,7,20915,1161,0,1
160,3155,1168,838,957,57,25,144,1225,19,348,224,416,367,640,3018,5452,11,61921,3440,1,1
35,2147,334,251,279,10,4,40,344,5,127,74,143,132,217,899,1528,2,4303,239,0,1
30,619,2,2,2,0,0,0,2,0,0,0,0,0,0,0,0,0,0,0,0,0
30,619,99,48,90,1,3,5,100,0,0,0,0,0,0,0,0,0,0,0,0,0
30,619,8,5,5,2,0,1,10,0,0,0,0,0,0,0,0,0,0,0,0,0
30,619,1217,716,841,84,126,174,1301,14,185,118,215,199,333,1446,2542,8,20687,1149,0,0
30,619,160,89,115,0,13,31,160,7,15,11,17,22,28,78,124,3,495,27,0,0
30,619,10,10,9,9,0,0,19,0,0,0,0,0,0,0,0,0,0,0,0,0
30,619,173,84,99,8,29,36,181,5,12,7,13,17,20,54,81,2,221,12,0,0
30,619,3,1,1,3,0,0,6,0,0,0,0,0,0,0,0,0,0,0,0,0
42,1129,74,35,59,1,0,14,75,3,14,7,14,17,21,58,85,1,128,7,0,0
42,1129,245,125,200,5,7,34,250,7,30,17,34,37,51,166,265,3,1053,58,0,0
164,3718,77,34,69,0,0,8,77,3,24,16,29,27,45,114,213,1,387,21,0,0
164,3718,712,438,573,51,9,84,763,14,102,71,128,116,199,733,1364,8,11988,666,0,0
29,601,215,129,180,6,0,29,221,8,65,43,72,73,115,415,711,4,3153,175,0,0
29,601,97,69,77,3,3,16,100,6,22,13,23,28,36,113,173,3,542,30,0,0
160,3155,1943,715,1694,26,18,214,1969,12,185,120,237,197,357,1436,2721,7,20915,1161,0,0
160,3155,1168,838,957,57,25,144,1225,19,348,224,416,367,640,3018,5452,11,61921,3440,1,0
53,2846,1338,495,1086,10,64,173,1348,11,122,82,157,133,239,883,1686,7,11934,663,0,1
438,9405,72,33,56,0,4,12,72,1,1,1,1,2,2,0,2,0,1,0,0,1
438,9405,1454,835,1044,76,110,219,1530,17,275,158,296,292,454,2297,3718,9,34017,1889,1,1
112,4755,139,89,101,2,0,35,141,7,54,34,62,61,96,330,569,4,2287,127,0,1
112,4755,7,5,5,0,0,2,7,1,2,1,2,3,3,2,4,0,2,0,0,1
129,4014,1660,832,1314,41,38,274,1701,20,312,209,395,332,604,2671,5058,12,64042,3557,1,1
129,4014,1057,646,719,113,100,145,1170,18,215,134,248,233,382,1740,3004,10,31186,1732,1,1
111,2674,1660,832,1314,41,38,274,1701,20,312,209,395,332,604,2671,5058,12,64042,3557,1,1
438,9405,72,33,56,0,4,12,72,1,1,1,1,2,2,0,2,0,1,0,0,0
438,9405,1454,835,1044,76,110,219,1530,17,275,158,296,292,454,2297,3718,9,34017,1889,1,0
112,4755,139,89,101,2,0,35,141,7,54,34,62,61,96,330,569,4,2287,127,0,0
112,4755,7,5,5,0,0,2,7,1,2,1,2,3,3,2,4,0,2,0,0,0
191,4456,722,423,573,19,0,135,741,12,172,101,199,184,300,1320,2257,6,15668,870,0,1
191,4456,1508,847,911,44,250,301,1552,14,148,88,169,162,257,1120,1886,7,15077,837,0,1
56,1100,1098,241,925,5,10,155,1103,7,46,25,49,53,74,273,423,3,1580,87,0,1
56,1100,282,202,222,14,2,44,296,8,42,24,43,50,67,250,378,4,1548,86,0,1
112,4779,139,89,101,2,0,35,141,7,54,34,62,61,96,330,569,4,2287,127,0,1
112,4779,7,5,5,0,0,2,7,1,2,1,2,3,3,2,4,0,2,0,0,1
32,1208,1098,241,925,5,10,155,1103,7,46,25,49,53,74,273,423,3,1580,87,0,1
57,1106,1098,241,925,5,10,155,1103,7,46,25,49,53,74,273,423,3,1580,87,0,1
57,1106,282,202,222,14,2,44,296,8,42,24,43,50,67,250,378,4,1548,86,0,1
165,3739,77,34,69,0,0,8,77,3,24,16,29,27,45,114,213,1,387,21,0,1
165,3739,712,438,573,51,9,84,763,14,102,71,128,116,199,733,1364,8,11988,666,0,1
434,9399,72,33,56,0,4,12,72,1,1,1,1,2,2,0,2,0,1,0,0,1
434,9399,1454,835,1044,76,110,219,1530,17,275,158,296,292,454,2297,3718,9,34017,1889,1,1
56,1091,1098,241,925,5,10,155,1103,7,46,25,49,53,74,273,423,3,1580,87,0,1
56,1091,282,202,222,14,2,44,296,8,42,24,43,50,67,250,378,4,1548,86,0,1
13,426,42,7,35,4,0,5,46,1,2,1,2,3,3,2,4,0,2,0,0,1
13,426,11,6,10,0,0,1,11,2,4,2,4,6,6,10,15,1,15,0,0,1
112,4767,139,89,101,2,0,35,141,7,54,34,62,61,96,330,569,4,2287,127,0,1
112,4767,7,5,5,0,0,2,7,1,2,1,2,3,3,2,4,0,2,0,0,1
13,413,295,56,236,0,4,54,295,2,9,5,10,11,15,30,51,1,57,3,0,1
33,1262,1098,241,925,5,10,155,1103,7,46,25,49,53,74,273,423,3,1580,87,0,1
159,3154,1943,715,1694,26,18,214,1969,12,185,120,237,197,357,1436,2721,7,20915,1161,0,0
159,3154,1168,838,957,57,25,144,1225,19,348,224,416,367,640,3018,5452,11,61921,3440,1,0
8,207,19,8,11,5,0,4,24,2,5,3,6,7,9,13,25,1,30,1,0,1
8,207,102,59,69,5,3,24,107,6,22,15,28,28,43,113,206,3,789,43,0,1
8,207,106,40,36,3,49,17,109,8,17,13,23,25,36,93,167,5,904,50,0,1
23,594,102,59,69,5,3,24,107,6,22,15,28,28,43,113,206,3,789,43,0,1
8,207,19,8,11,5,0,4,24,2,5,3,6,7,9,13,25,1,30,1,0,0
8,207,102,59,69,5,3,24,107,6,22,15,28,28,43,113,206,3,789,43,0,0
8,207,106,40,36,3,49,17,109,8,17,13,23,25,36,93,167,5,904,50,0,0
23,594,102,59,69,5,3,24,107,6,22,15,28,28,43,113,206,3,789,43,0,0
43,912,447,308,343,6,5,95,453,7,96,59,111,103,170,651,1136,4,4600,255,0,0
43,912,322,174,179,16,74,51,338,10,41,26,46,51,72,252,408,5,2291,127,0,0
33,1460,447,308,343,6,5,95,453,7,96,59,111,103,170,651,1136,4,4600,255,0,0
38,787,447,308,343,6,5,95,453,7,96,59,111,103,170,651,1136,4,4600,255,0,1
38,787,322,174,179,16,74,51,338,10,41,26,46,51,72,252,408,5,2291,127,0,1
31,1414,447,308,343,6,5,95,453,7,96,59,111,103,170,651,1136,4,4600,255,0,1
165,3753,77,34,69,0,0,8,77,3,24,16,29,27,45,114,213,1,387,21,0,1
165,3753,712,438,573,51,9,84,763,14,102,71,128,116,199,733,1364,8,11988,666,0,1
22,372,424,94,331,4,0,89,428,1,5,5,5,6,10,11,25,0,12,0,0,1
22,372,38,23,23,6,0,8,44,3,11,7,11,14,18,42,68,1,102,5,0,1
191,4461,722,423,573,19,0,135,741,12,172,101,199,184,300,1320,2257,6,15668,870,0,1
191,4461,1508,847,911,44,250,301,1552,14,148,88,169,162,257,1120,1886,7,15077,837,0,1
99,2226,1043,504,840,53,9,147,1096,9,180,112,198,189,310,1377,2344,4,11604,644,0,1
99,2226,383,288,292,26,6,62,409,11,65,38,67,76,105,429,656,5,3719,206,0,1
16,504,424,94,331,4,0,89,428,1,5,5,5,6,10,11,25,0,12,0,0,1
57,3243,1782,648,1425,9,47,279,1791,8,171,97,189,179,286,1292,2140,4,9462,525,0,1
46,1863,1043,504,840,53,9,147,1096,9,180,112,198,189,310,1377,2344,4,11604,644,0,1
46,1863,1043,504,840,53,9,147,1096,9,180,112,198,189,310,1377,2344,4,11604,644,0,0
36,2163,334,251,279,10,4,40,344,5,127,74,143,132,217,899,1528,2,4303,239,0,1
22,950,1455,414,1257,16,76,112,1471,5,41,23,46,46,69,231,381,2,1069,59,0,1
44,428,647,139,84,35,284,233,682,0,0,0,0,0,0,0,0,0,0,0,0,1
165,3705,77,34,69,0,0,8,77,3,24,16,29,27,45,114,213,1,387,21,0,1
165,3705,712,438,573,51,9,84,763,14,102,71,128,116,199,733,1364,8,11988,666,0,1
24,583,1293,570,1093,25,15,163,1318,10,195,123,241,205,364,1516,2795,6,17273,959,0,1
107,2375,1043,504,840,53,9,147,1096,9,180,112,198,189,310,1377,2344,4,11604,644,0,1
107,2375,383,288,292,26,6,62,409,11,65,38,67,76,105,429,656,5,3719,206,0,1
13,384,465,148,393,5,8,60,470,4,31,20,31,35,51,161,261,2,523,29,0,1
13,384,16,12,9,0,0,6,16,1,2,1,2,3,3,2,4,0,2,0,0,1
25,941,1293,570,1093,25,15,163,1318,10,195,123,241,205,364,1516,2795,6,17273,959,0,1
46,1865,1043,504,840,53,9,147,1096,9,180,112,198,189,310,1377,2344,4,11604,644,0,1
23,383,424,94,331,4,0,89,428,1,5,5,5,6,10,11,25,0,12,0,0,0
23,383,38,23,23,6,0,8,44,3,11,7,11,14,18,42,68,1,102,5,0,0
23,409,424,94,331,4,0,89,428,1,5,5,5,6,10,11,25,0,12,0,0,0
23,409,38,23,23,6,0,8,44,3,11,7,11,14,18,42,68,1,102,5,0,0
25,625,1293,570,1093,25,15,163,1318,10,195,123,241,205,364,1516,2795,6,17273,959,0,1
27,1013,1293,570,1093,25,15,163,1318,10,195,123,241,205,364,1516,2795,6,17273,959,0,1
54,2876,1338,495,1086,10,64,173,1348,11,122,82,157,133,239,883,1686,7,11934,663,0,0
166,3708,77,34,69,0,0,8,77,3,24,16,29,27,45,114,213,1,387,21,0,1
166,3708,712,438,573,51,9,84,763,14,102,71,128,116,199,733,1364,8,11988,666,0,1
62,2584,1289,550,1043,56,32,155,1345,10,167,93,185,177,278,1266,2075,5,11498,638,0,1
57,1097,1098,241,925,5,10,155,1103,7,46,25,49,53,74,273,423,3,1580,87,0,1
57,1097,282,202,222,14,2,44,296,8,42,24,43,50,67,250,378,4,1548,86,0,1
34,1295,1098,241,925,5,10,155,1103,7,46,25,49,53,74,273,423,3,1580,87,0,1
23,612,102,59,69,5,3,24,107,6,22,15,28,28,43,113,206,3,789,43,0,0
37,2250,1523,757,1297,19,12,193,1542,12,193,117,230,205,347,1508,2664,7,19053,1058,0,1
436,9474,72,33,56,0,4,12,72,1,1,1,1,2,2,0,2,0,1,0,0,1
436,9474,1454,835,1044,76,110,219,1530,17,275,158,296,292,454,2297,3718,9,34017,1889,1,1
113,4797,139,89,101,2,0,35,141,7,54,34,62,61,96,330,569,4,2287,127,0,1
113,4797,7,5,5,0,0,2,7,1,2,1,2,3,3,2,4,0,2,0,0,1
160,3165,1943,715,1694,26,18,214,1969,12,185,120,237,197,357,1436,2721,7,20915,1161,0,1
160,3165,1168,838,957,57,25,144,1225,19,348,224,416,367,640,3018,5452,11,61921,3440,1,1
59,2688,1943,715,1694,26,18,214,1969,12,185,120,237,197,357,1436,2721,7,20915,1161,0,1
436,9476,72,33,56,0,4,12,72,1,1,1,1,2,2,0,2,0,1,0,0,1
436,9476,1454,835,1044,76,110,219,1530,17,275,158,296,292,454,2297,3718,9,34017,1889,1,1
59,2687,1943,715,1694,26,18,214,1969,12,185,120,237,197,357,1436,2721,7,20915,1161,0,1
42,846,447,308,343,6,5,95,453,7,96,59,111,103,170,651,1136,4,4600,255,0,1
42,846,322,174,179,16,74,51,338,10,41,26,46,51,72,252,408,5,2291,127,0,1
32,1449,447,308,343,6,5,95,453,7,96,59,111,103,170,651,1136,4,4600,255,0,1
162,3224,1943,715,1694,26,18,214,1969,12,185,120,237,197,357,1436,2721,7,20915,1161,0,1
162,3224,1168,838,957,57,25,144,1225,19,348,224,416,367,640,3018,5452,11,61921,3440,1,1
60,2714,1943,715,1694,26,18,214,1969,12,185,120,237,197,357,1436,2721,7,20915,1161,0,1
200,3862,1457,730,1242,11,6,188,1468,10,292,166,329,302,495,2424,4078,5,22973,1276,1,1
200,3862,74,35,59,1,0,14,75,3,14,7,14,17,21,58,85,1,128,7,0,1
200,3862,245,125,200,5,7,34,250,7,30,17,34,37,51,166,265,3,1053,58,0,1
36,2153,334,251,279,10,4,40,344,5,127,74,143,132,217,899,1528,2,4303,239,0,1
199,3859,1457,730,1242,11,6,188,1468,10,292,166,329,302,495,2424,4078,5,22973,1276,1,1
199,3859,74,35,59,1,0,14,75,3,14,7,14,17,21,58,85,1,128,7,0,1
199,3859,245,125,200,5,7,34,250,7,30,17,34,37,51,166,265,3,1053,58,0,1
34,1725,1457,730,1242,11,6,188,1468,10,292,166,329,302,495,2424,4078,5,22973,1276,1,1
199,3865,1457,730,1242,11,6,188,1468,10,292,166,329,302,495,2424,4078,5,22973,1276,1,0
199,3865,74,35,59,1,0,14,75,3,14,7,14,17,21,58,85,1,128,7,0,0
199,3865,245,125,200,5,7,34,250,7,30,17,34,37,51,166,265,3,1053,58,0,0
43,421,647,139,84,35,284,233,682,0,0,0,0,0,0,0,0,0,0,0,0,0
70,1248,1513,682,1277,25,13,200,1538,11,199,116,219,210,335,1557,2584,6,15641,868,0,1
70,1248,819,519,539,24,98,155,843,15,96,57,106,111,163,690,1107,8,9171,509,0,1
165,3712,77,34,69,0,0,8,77,3,24,16,29,27,45,114,213,1,387,21,0,1
165,3712,712,438,573,51,9,84,763,14,102,71,128,116,199,733,1364,8,11988,666,0,1
192,4394,722,423,573,19,0,135,741,12,172,101,199,184,300,1320,2257,6,15668,870,0,1
192,4394,1508,847,911,44,250,301,1552,14,148,88,169,162,257,1120,1886,7,15077,837,0,1
61,2537,1289,550,1043,56,32,155,1345,10,167,93,185,177,278,1266,2075,5,11498,638,0,1
22,954,1455,414,1257,16,76,112,1471,5,41,23,46,46,69,231,381,2,1069,59,0,1
36,2150,334,251,279,10,4,40,344,5,127,74,143,132,217,899,1528,2,4303,239,0,0
199,3872,1457,730,1242,11,6,188,1468,10,292,166,329,302,495,2424,4078,5,22973,1276,1,1
199,3872,74,35,59,1,0,14,75,3,14,7,14,17,21,58,85,1,128,7,0,1
199,3872,245,125,200,5,7,34,250,7,30,17,34,37,51,166,265,3,1053,58,0,1
208,4134,1457,730,1242,11,6,188,1468,10,292,166,329,302,495,2424,4078,5,22973,1276,1,1
208,4134,74,35,59,1,0,14,75,3,14,7,14,17,21,58,85,1,128,7,0,1
208,4134,245,125,200,5,7,34,250,7,30,17,34,37,51,166,265,3,1053,58,0,1
42,1123,74,35,59,1,0,14,75,3,14,7,14,17,21,58,85,1,128,7,0,1
42,1123,245,125,200,5,7,34,250,7,30,17,34,37,51,166,265,3,1053,58,0,1
165,3706,77,34,69,0,0,8,77,3,24,16,29,27,45,114,213,1,387,21,0,1
165,3706,712,438,573,51,9,84,763,14,102,71,128,116,199,733,1364,8,11988,666,0,1
59,1128,1020,354,843,12,15,144,1032,8,134,77,144,142,221,970,1580,4,6792,377,0,1
192,4388,722,423,573,19,0,135,741,12,172,101,199,184,300,1320,2257,6,15668,870,0,1
192,4388,1508,847,911,44,250,301,1552,14,148,88,169,162,257,1120,1886,7,15077,837,0,1
24,974,373,158,315,8,0,51,381,5,76,44,79,81,123,486,779,2,2026,112,0,1
229,4659,1457,730,1242,11,6,188,1468,10,292,166,329,302,495,2424,4078,5,22973,1276,1,1
229,4659,74,35,59,1,0,14,75,3,14,7,14,17,21,58,85,1,128,7,0,1
229,4659,245,125,200,5,7,34,250,7,30,17,34,37,51,166,265,3,1053,58,0,1
165,3704,77,34,69,0,0,8,77,3,24,16,29,27,45,114,213,1,387,21,0,1
165,3704,712,438,573,51,9,84,763,14,102,71,128,116,199,733,1364,8,11988,666,0,1
165,3265,1943,715,1694,26,18,214,1969,12,185,120,237,197,357,1436,2721,7,20915,1161,0,1
165,3265,1168,838,957,57,25,144,1225,19,348,224,416,367,640,3018,5452,11,61921,3440,1,1
36,1810,1457,730,1242,11,6,188,1468,10,292,166,329,302,495,2424,4078,5,22973,1276,1,1
14,577,722,423,573,19,0,135,741,12,172,101,199,184,300,1320,2257,6,15668,870,0,1
71,1306,1513,682,1277,25,13,200,1538,11,199,116,219,210,335,1557,2584,6,15641,868,0,1
71,1306,819,519,539,24,98,155,843,15,96,57,106,111,163,690,1107,8,9171,509,0,1
229,4666,1457,730,1242,11,6,188,1468,10,292,166,329,302,495,2424,4078,5,22973,1276,1,1
229,4666,74,35,59,1,0,14,75,3,14,7,14,17,21,58,85,1,128,7,0,1
229,4666,245,125,200,5,7,34,250,7,30,17,34,37,51,166,265,3,1053,58,0,1
44,432,647,139,84,35,284,233,682,0,0,0,0,0,0,0,0,0,0,0,0,1
42,1791,1513,682,1277,25,13,200,1538,11,199,116,219,210,335,1557,2584,6,15641,868,0,1
38,1886,1457,730,1242,11,6,188,1468,10,292,166,329,302,495,2424,4078,5,22973,1276,1,1
37,2204,334,251,279,10,4,40,344,5,127,74,143,132,217,899,1528,2,4303,239,0,1
440,9534,72,33,56,0,4,12,72,1,1,1,1,2,2,0,2,0,1,0,0,1
440,9534,1454,835,1044,76,110,219,1530,17,275,158,296,292,454,2297,3718,9,34017,1889,1,1
441,9550,72,33,56,0,4,12,72,1,1,1,1,2,2,0,2,0,1,0,0,1
441,9550,1454,835,1044,76,110,219,1530,17,275,158,296,292,454,2297,3718,9,34017,1889,1,1
114,4827,139,89,101,2,0,35,141,7,54,34,62,61,96,330,569,4,2287,127,0,1
114,4827,7,5,5,0,0,2,7,1,2,1,2,3,3,2,4,0,2,0,0,1
73,1336,1513,682,1277,25,13,200,1538,11,199,116,219,210,335,1557,2584,6,15641,868,0,1
73,1336,819,519,539,24,98,155,843,15,96,57,106,111,163,690,1107,8,9171,509,0,1
61,2530,1289,550,1043,56,32,155,1345,10,167,93,185,177,278,1266,2075,5,11498,638,0,1
42,1782,1513,682,1277,25,13,200,1538,11,199,116,219,210,335,1557,2584,6,15641,868,0,1
196,4437,722,423,573,19,0,135,741,12,172,101,199,184,300,1320,2257,6,15668,870,0,1
196,4437,1508,847,911,44,250,301,1552,14,148,88,169,162,257,1120,1886,7,15077,837,0,1
61,2521,1289,550,1043,56,32,155,1345,10,167,93,185,177,278,1266,2075,5,11498,638,0,1
37,2265,1523,757,1297,19,12,193,1542,12,193,117,230,205,347,1508,2664,7,19053,1058,0,1
229,4670,1457,730,1242,11,6,188,1468,10,292,166,329,302,495,2424,4078,5,22973,1276,1,1
229,4670,74,35,59,1,0,14,75,3,14,7,14,17,21,58,85,1,128,7,0,1
229,4670,245,125,200,5,7,34,250,7,30,17,34,37,51,166,265,3,1053,58,0,1
39,1926,1457,730,1242,11,6,188,1468,10,292,166,329,302,495,2424,4078,5,22973,1276,1,1
9,241,19,8,11,5,0,4,24,2,5,3,6,7,9,13,25,1,30,1,0,1
9,241,102,59,69,5,3,24,107,6,22,15,28,28,43,113,206,3,789,43,0,1
9,241,106,40,36,3,49,17,109,8,17,13,23,25,36,93,167,5,904,50,0,1
9,241,19,8,11,5,0,4,24,2,5,3,6,7,9,13,25,1,30,1,0,0
9,241,102,59,69,5,3,24,107,6,22,15,28,28,43,113,206,3,789,43,0,0
9,241,106,40,36,3,49,17,109,8,17,13,23,25,36,93,167,5,904,50,0,0
55,2905,1338,495,1086,10,64,173,1348,11,122,82,157,133,239,883,1686,7,11934,663,0,1
1,225,382,65,130,157,2,92,539,4,10,5,10,14,15,41,57,2,114,6,0,1
164,3237,1943,715,1694,26,18,214,1969,12,185,120,237,197,357,1436,2721,7,20915,1161,0,1
164,3237,1168,838,957,57,25,144,1225,19,348,224,416,367,640,3018,5452,11,61921,3440,1,1
30,617,2,2,2,0,0,0,2,0,0,0,0,0,0,0,0,0,0,0,0,1
30,617,99,48,90,1,3,5,100,0,0,0,0,0,0,0,0,0,0,0,0,1
30,617,8,5,5,2,0,1,10,0,0,0,0,0,0,0,0,0,0,0,0,1
30,617,1217,716,841,84,126,174,1301,14,185,118,215,199,333,1446,2542,8,20687,1149,0,1
30,617,160,89,115,0,13,31,160,7,15,11,17,22,28,78,124,3,495,27,0,1
30,617,10,10,9,9,0,0,19,0,0,0,0,0,0,0,0,0,0,0,0,1
30,617,173,84,99,8,29,36,181,5,12,7,13,17,20,54,81,2,221,12,0,1
30,617,3,1,1,3,0,0,6,0,0,0,0,0,0,0,0,0,0,0,0,1
165,3696,77,34,69,0,0,8,77,3,24,16,29,27,45,114,213,1,387,21,0,1
165,3696,712,438,573,51,9,84,763,14,102,71,128,116,199,733,1364,8,11988,666,0,1
23,407,424,94,331,4,0,89,428,1,5,5,5,6,10,11,25,0,12,0,0,1
23,407,38,23,23,6,0,8,44,3,11,7,11,14,18,42,68,1,102,5,0,1
196,4435,722,423,573,19,0,135,741,12,172,101,199,184,300,1320,2257,6,15668,870,0,1
196,4435,1508,847,911,44,250,301,1552,14,148,88,169,162,257,1120,1886,7,15077,837,0,1
18,460,386,256,301,16,9,68,402,4,59,35,69,63,104,355,621,2,1453,80,0,1
18,460,264,131,164,11,41,46,275,6,38,22,40,44,62,214,338,3,1068,59,0,1
57,1095,1098,241,925,5,10,155,1103,7,46,25,49,53,74,273,423,3,1580,87,0,1
57,1095,282,202,222,14,2,44,296,8,42,24,43,50,67,250,378,4,1548,86,0,1
60,1136,1020,354,843,12,15,144,1032,8,134,77,144,142,221,970,1580,4,6792,377,0,1
166,3721,77,34,69,0,0,8,77,3,24,16,29,27,45,114,213,1,387,21,0,1
166,3721,712,438,573,51,9,84,763,14,102,71,128,116,199,733,1364,8,11988,666,0,1
45,2799,1296,573,1062,40,33,157,1336,8,201,118,231,209,349,1561,2689,4,12365,686,0,1
12,373,442,244,305,14,16,103,456,11,68,45,75,79,120,452,756,6,4588,254,0,0
12,373,182,102,99,11,40,35,193,3,11,6,11,14,17,42,64,1,97,5,0,0
7,520,442,244,305,14,16,103,456,11,68,45,75,79,120,452,756,6,4588,254,0,0
172,3827,77,34,69,0,0,8,77,3,24,16,29,27,45,114,213,1,387,21,0,1
172,3827,712,438,573,51,9,84,763,14,102,71,128,116,199,733,1364,8,11988,666,0,1
61,1148,1020,354,843,12,15,144,1032,8,134,77,144,142,221,970,1580,4,6792,377,0,1
47,2070,1020,354,843,12,15,144,1032,8,134,77,144,142,221,970,1580,4,6792,377,0,1
163,3229,1943,715,1694,26,18,214,1969,12,185,120,237,197,357,1436,2721,7,20915,1161,0,1
163,3229,1168,838,957,57,25,144,1225,19,348,224,416,367,640,3018,5452,11,61921,3440,1,1
60,2704,1943,715,1694,26,18,214,1969,12,185,120,237,197,357,1436,2721,7,20915,1161,0,1
14,439,42,7,35,4,0,5,46,1,2,1,2,3,3,2,4,0,2,0,0,0
14,439,11,6,10,0,0,1,11,2,4,2,4,6,6,10,15,1,15,0,0,0
38,2239,334,251,279,10,4,40,344,5,127,74,143,132,217,899,1528,2,4303,239,0,1
164,3240,1943,715,1694,26,18,214,1969,12,185,120,237,197,357,1436,2721,7,20915,1161,0,1
164,3240,1168,838,957,57,25,144,1225,19,348,224,416,367,640,3018,5452,11,61921,3440,1,1
161,3179,1943,715,1694,26,18,214,1969,12,185,120,237,197,357,1436,2721,7,20915,1161,0,0
161,3179,1168,838,957,57,25,144,1225,19,348,224,416,367,640,3018,5452,11,61921,3440,1,0
59,2667,1943,715,1694,26,18,214,1969,12,185,120,237,197,357,1436,2721,7,20915,1161,0,0
14,439,42,7,35,4,0,5,46,1,2,1,2,3,3,2,4,0,2,0,0,1
14,439,11,6,10,0,0,1,11,2,4,2,4,6,6,10,15,1,15,0,0,1
129,4015,1660,832,1314,41,38,274,1701,20,312,209,395,332,604,2671,5058,12,64042,3557,1,1
129,4015,1057,646,719,113,100,145,1170,18,215,134,248,233,382,1740,3004,10,31186,1732,1,1
112,2716,1660,832,1314,41,38,274,1701,20,312,209,395,332,604,2671,5058,12,64042,3557,1,1
129,4017,1660,832,1314,41,38,274,1701,20,312,209,395,332,604,2671,5058,12,64042,3557,1,1
129,4017,1057,646,719,113,100,145,1170,18,215,134,248,233,382,1740,3004,10,31186,1732,1,1
113,2758,1660,832,1314,41,38,274,1701,20,312,209,395,332,604,2671,5058,12,64042,3557,1,1
114,2807,1660,832,1314,41,38,274,1701,20,312,209,395,332,604,2671,5058,12,64042,3557,1,0
86,1526,1178,367,1042,6,15,115,1184,9,94,51,95,103,146,644,976,4,4439,246,0,1
86,1526,177,108,140,8,0,27,185,6,30,16,32,36,48,162,248,3,794,44,0,1
13,442,42,7,35,4,0,5,46,1,2,1,2,3,3,2,4,0,2,0,0,1
13,442,11,6,10,0,0,1,11,2,4,2,4,6,6,10,15,1,15,0,0,1
43,1897,1178,367,1042,6,15,115,1184,9,94,51,95,103,146,644,976,4,4439,246,0,1
115,2872,1660,832,1314,41,38,274,1701,20,312,209,395,332,604,2671,5058,12,64042,3557,1,0
131,4056,1660,832,1314,41,38,274,1701,20,312,209,395,332,604,2671,5058,12,64042,3557,1,0
131,4056,1057,646,719,113,100,145,1170,18,215,134,248,233,382,1740,3004,10,31186,1732,1,0
131,4052,1660,832,1314,41,38,274,1701,20,312,209,395,332,604,2671,5058,12,64042,3557,1,0
131,4052,1057,646,719,113,100,145,1170,18,215,134,248,233,382,1740,3004,10,31186,1732,1,0
63,1172,1020,354,843,12,15,144,1032,8,134,77,144,142,221,970,1580,4,6792,377,0,1
48,2097,1020,354,843,12,15,144,1032,8,134,77,144,142,221,970,1580,4,6792,377,0,1
131,4052,1660,832,1314,41,38,274,1701,20,312,209,395,332,604,2671,5058,12,64042,3557,1,1
131,4052,1057,646,719,113,100,145,1170,18,215,134,248,233,382,1740,3004,10,31186,1732,1,1
229,4668,1457,730,1242,11,6,188,1468,10,292,166,329,302,495,2424,4078,5,22973,1276,1,1
229,4668,74,35,59,1,0,14,75,3,14,7,14,17,21,58,85,1,128,7,0,1
229,4668,245,125,200,5,7,34,250,7,30,17,34,37,51,166,265,3,1053,58,0,1
42,1119,74,35,59,1,0,14,75,3,14,7,14,17,21,58,85,1,128,7,0,1
42,1119,245,125,200,5,7,34,250,7,30,17,34,37,51,166,265,3,1053,58,0,1
172,3822,77,34,69,0,0,8,77,3,24,16,29,27,45,114,213,1,387,21,0,1
172,3822,712,438,573,51,9,84,763,14,102,71,128,116,199,733,1364,8,11988,666,0,1
195,4408,722,423,573,19,0,135,741,12,172,101,199,184,300,1320,2257,6,15668,870,0,1
195,4408,1508,847,911,44,250,301,1552,14,148,88,169,162,257,1120,1886,7,15077,837,0,1
439,9488,72,33,56,0,4,12,72,1,1,1,1,2,2,0,2,0,1,0,0,1
439,9488,1454,835,1044,76,110,219,1530,17,275,158,296,292,454,2297,3718,9,34017,1889,1,1
86,1521,1178,367,1042,6,15,115,1184,9,94,51,95,103,146,644,976,4,4439,246,0,1
86,1521,177,108,140,8,0,27,185,6,30,16,32,36,48,162,248,3,794,44,0,1
161,3177,1943,715,1694,26,18,214,1969,12,185,120,237,197,357,1436,2721,7,20915,1161,0,1
161,3177,1168,838,957,57,25,144,1225,19,348,224,416,367,640,3018,5452,11,61921,3440,1,1
61,2511,1289,550,1043,56,32,155,1345,10,167,93,185,177,278,1266,2075,5,11498,638,0,1
55,2891,1338,495,1086,10,64,173,1348,11,122,82,157,133,239,883,1686,7,11934,663,0,1
114,4817,139,89,101,2,0,35,141,7,54,34,62,61,96,330,569,4,2287,127,0,1
114,4817,7,5,5,0,0,2,7,1,2,1,2,3,3,2,4,0,2,0,0,1
13,380,465,148,393,5,8,60,470,4,31,20,31,35,51,161,261,2,523,29,0,1
13,380,16,12,9,0,0,6,16,1,2,1,2,3,3,2,4,0,2,0,0,1
57,3235,1782,648,1425,9,47,279,1791,8,171,97,189,179,286,1292,2140,4,9462,525,0,1
49,1690,1450,624,1228,12,26,181,1462,14,306,186,354,320,540,2580,4493,8,36391,2021,1,1
115,2864,1660,832,1314,41,38,274,1701,20,312,209,395,332,604,2671,5058,12,64042,3557,1,1
45,2786,1296,573,1062,40,33,157,1336,8,201,118,231,209,349,1561,2689,4,12365,686,0,1
39,1924,1457,730,1242,11,6,188,1468,10,292,166,329,302,495,2424,4078,5,22973,1276,1,1
29,1370,652,304,544,16,6,88,668,6,89,51,101,95,152,591,998,3,3399,188,0,1
37,2252,1523,757,1297,19,12,193,1542,12,193,117,230,205,347,1508,2664,7,19053,1058,0,1
48,2093,1020,354,843,12,15,144,1032,8,134,77,144,142,221,970,1580,4,6792,377,0,1
16,502,424,94,331,4,0,89,428,1,5,5,5,6,10,11,25,0,12,0,0,1
38,2232,334,251,279,10,4,40,344,5,127,74,143,132,217,899,1528,2,4303,239,0,1
7,291,184,100,137,2,15,30,186,6,38,20,39,44,59,214,322,3,991,55,0,1
27,1009,1293,570,1093,25,15,163,1318,10,195,123,241,205,364,1516,2795,6,17273,959,0,1
14,569,722,423,573,19,0,135,741,12,172,101,199,184,300,1320,2257,6,15668,870,0,1
46,1867,1043,504,840,53,9,147,1096,9,180,112,198,189,310,1377,2344,4,11604,644,0,1
43,1898,1178,367,1042,6,15,115,1184,9,94,51,95,103,146,644,976,4,4439,246,0,1
59,2593,1943,715,1694,26,18,214,1969,12,185,120,237,197,357,1436,2721,7,20915,1161,0,1
7,518,442,244,305,14,16,103,456,11,68,45,75,79,120,452,756,6,4588,254,0,1
34,1293,1098,241,925,5,10,155,1103,7,46,25,49,53,74,273,423,3,1580,87,0,1
439,9491,72,33,56,0,4,12,72,1,1,1,1,2,2,0,2,0,1,0,0,1
439,9491,1454,835,1044,76,110,219,1530,17,275,158,296,292,454,2297,3718,9,34017,1889,1,1
14,399,465,148,393,5,8,60,470,4,31,20,31,35,51,161,261,2,523,29,0,1
14,399,16,12,9,0,0,6,16,1,2,1,2,3,3,2,4,0,2,0,0,1
42,852,447,308,343,6,5,95,453,7,96,59,111,103,170,651,1136,4,4600,255,0,1
42,852,322,174,179,16,74,51,338,10,41,26,46,51,72,252,408,5,2291,127,0,1
33,1483,447,308,343,6,5,95,453,7,96,59,111,103,170,651,1136,4,4600,255,0,1
42,1313,1523,757,1297,19,12,193,1542,12,193,117,230,205,347,1508,2664,7,19053,1058,0,1
42,1313,701,378,504,33,58,109,734,13,110,68,126,123,194,794,1346,7,10027,557,0,1
38,2361,1523,757,1297,19,12,193,1542,12,193,117,230,205,347,1508,2664,7,19053,1058,0,1
38,2370,1523,757,1297,19,12,193,1542,12,193,117,230,205,347,1508,2664,7,19053,1058,0,1
13,442,42,7,35,4,0,5,46,1,2,1,2,3,3,2,4,0,2,0,0,0
13,442,11,6,10,0,0,1,11,2,4,2,4,6,6,10,15,1,15,0,0,0
439,9498,72,33,56,0,4,12,72,1,1,1,1,2,2,0,2,0,1,0,0,1
439,9498,1454,835,1044,76,110,219,1530,17,275,158,296,292,454,2297,3718,9,34017,1889,1,1
61,2962,1338,495,1086,10,64,173,1348,11,122,82,157,133,239,883,1686,7,11934,663,0,1
439,9498,72,33,56,0,4,12,72,1,1,1,1,2,2,0,2,0,1,0,0,0
439,9498,1454,835,1044,76,110,219,1530,17,275,158,296,292,454,2297,3718,9,34017,1889,1,0
61,2962,1338,495,1086,10,64,173,1348,11,122,82,157,133,239,883,1686,7,11934,663,0,0
132,4066,1660,832,1314,41,38,274,1701,20,312,209,395,332,604,2671,5058,12,64042,3557,1,1
132,4066,1057,646,719,113,100,145,1170,18,215,134,248,233,382,1740,3004,10,31186,1732,1,1
438,9497,72,33,56,0,4,12,72,1,1,1,1,2,2,0,2,0,1,0,0,1
438,9497,1454,835,1044,76,110,219,1530,17,275,158,296,292,454,2297,3718,9,34017,1889,1,1
30,1496,652,304,544,16,6,88,668,6,89,51,101,95,152,591,998,3,3399,188,0,1
33,1481,447,308,343,6,5,95,453,7,96,59,111,103,170,651,1136,4,4600,255,0,0
438,9497,72,33,56,0,4,12,72,1,1,1,1,2,2,0,2,0,1,0,0,0
438,9497,1454,835,1044,76,110,219,1530,17,275,158,296,292,454,2297,3718,9,34017,1889,1,0
30,1496,652,304,544,16,6,88,668,6,89,51,101,95,152,591,998,3,3399,188,0,0
438,9494,72,33,56,0,4,12,72,1,1,1,1,2,2,0,2,0,1,0,0,1
438,9494,1454,835,1044,76,110,219,1530,17,275,158,296,292,454,2297,3718,9,34017,1889,1,1
438,9494,72,33,56,0,4,12,72,1,1,1,1,2,2,0,2,0,1,0,0,0
438,9494,1454,835,1044,76,110,219,1530,17,275,158,296,292,454,2297,3718,9,34017,1889,1,0
131,4059,1660,832,1314,41,38,274,1701,20,312,209,395,332,604,2671,5058,12,64042,3557,1,0
131,4059,1057,646,719,113,100,145,1170,18,215,134,248,233,382,1740,3004,10,31186,1732,1,0
62,2549,1289,550,1043,56,32,155,1345,10,167,93,185,177,278,1266,2075,5,11498,638,0,0
11,366,85,59,61,8,0,16,93,5,18,10,18,23,28,86,126,2,316,17,0,1
11,366,85,59,61,8,0,16,93,5,18,10,18,23,28,86,126,2,316,17,0,0
195,4418,722,423,573,19,0,135,741,12,172,101,199,184,300,1320,2257,6,15668,870,0,0
195,4418,1508,847,911,44,250,301,1552,14,148,88,169,162,257,1120,1886,7,15077,837,0,0
27,1034,1293,570,1093,25,15,163,1318,10,195,123,241,205,364,1516,2795,6,17273,959,0,0
54,1029,1098,241,925,5,10,155,1103,7,46,25,49,53,74,273,423,3,1580,87,0,1
54,1029,282,202,222,14,2,44,296,8,42,24,43,50,67,250,378,4,1548,86,0,1
36,1369,1098,241,925,5,10,155,1103,7,46,25,49,53,74,273,423,3,1580,87,0,1
115,2873,1660,832,1314,41,38,274,1701,20,312,209,395,332,604,2671,5058,12,64042,3557,1,0
36,1381,1098,241,925,5,10,155,1103,7,46,25,49,53,74,273,423,3,1580,87,0,1
29,599,215,129,180,6,0,29,221,8,65,43,72,73,115,415,711,4,3153,175,0,0
29,599,97,69,77,3,3,16,100,6,22,13,23,28,36,113,173,3,542,30,0,0
15,1203,215,129,180,6,0,29,221,8,65,43,72,73,115,415,711,4,3153,175,0,0
110,2409,1043,504,840,53,9,147,1096,9,180,112,198,189,310,1377,2344,4,11604,644,0,1
110,2409,383,288,292,26,6,62,409,11,65,38,67,76,105,429,656,5,3719,206,0,1
48,1985,1043,504,840,53,9,147,1096,9,180,112,198,189,310,1377,2344,4,11604,644,0,1
170,3779,77,34,69,0,0,8,77,3,24,16,29,27,45,114,213,1,387,21,0,1
170,3779,712,438,573,51,9,84,763,14,102,71,128,116,199,733,1364,8,11988,666,0,1
441,9544,72,33,56,0,4,12,72,1,1,1,1,2,2,0,2,0,1,0,0,1
441,9544,1454,835,1044,76,110,219,1530,17,275,158,296,292,454,2297,3718,9,34017,1889,1,1
22,555,465,148,393,5,8,60,470,4,31,20,31,35,51,161,261,2,523,29,0,1
22,555,16,12,9,0,0,6,16,1,2,1,2,3,3,2,4,0,2,0,0,1
11,370,85,59,61,8,0,16,93,5,18,10,18,23,28,86,126,2,316,17,0,0
110,2406,1043,504,840,53,9,147,1096,9,180,112,198,189,310,1377,2344,4,11604,644,0,1
110,2406,383,288,292,26,6,62,409,11,65,38,67,76,105,429,656,5,3719,206,0,1
50,2071,1043,504,840,53,9,147,1096,9,180,112,198,189,310,1377,2344,4,11604,644,0,1
170,3779,77,34,69,0,0,8,77,3,24,16,29,27,45,114,213,1,387,21,0,0
170,3779,712,438,573,51,9,84,763,14,102,71,128,116,199,733,1364,8,11988,666,0,0
441,9544,72,33,56,0,4,12,72,1,1,1,1,2,2,0,2,0,1,0,0,0
441,9544,1454,835,1044,76,110,219,1530,17,275,158,296,292,454,2297,3718,9,34017,1889,1,0
22,555,465,148,393,5,8,60,470,4,31,20,31,35,51,161,261,2,523,29,0,0
22,555,16,12,9,0,0,6,16,1,2,1,2,3,3,2,4,0,2,0,0,0
118,4924,139,89,101,2,0,35,141,7,54,34,62,61,96,330,569,4,2287,127,0,1
118,4924,7,5,5,0,0,2,7,1,2,1,2,3,3,2,4,0,2,0,0,1
119,5017,139,89,101,2,0,35,141,7,54,34,62,61,96,330,569,4,2287,127,0,1
119,5017,7,5,5,0,0,2,7,1,2,1,2,3,3,2,4,0,2,0,0,1
444,9618,72,33,56,0,4,12,72,1,1,1,1,2,2,0,2,0,1,0,0,1
444,9618,1454,835,1044,76,110,219,1530,17,275,158,296,292,454,2297,3718,9,34017,1889,1,1
120,5065,139,89,101,2,0,35,141,7,54,34,62,61,96,330,569,4,2287,127,0,1
120,5065,7,5,5,0,0,2,7,1,2,1,2,3,3,2,4,0,2,0,0,1
50,2075,1043,504,840,53,9,147,1096,9,180,112,198,189,310,1377,2344,4,11604,644,0,1
444,9616,72,33,56,0,4,12,72,1,1,1,1,2,2,0,2,0,1,0,0,1
444,9616,1454,835,1044,76,110,219,1530,17,275,158,296,292,454,2297,3718,9,34017,1889,1,1
446,9627,72,33,56,0,4,12,72,1,1,1,1,2,2,0,2,0,1,0,0,1
446,9627,1454,835,1044,76,110,219,1530,17,275,158,296,292,454,2297,3718,9,34017,1889,1,1
111,2398,1043,504,840,53,9,147,1096,9,180,112,198,189,310,1377,2344,4,11604,644,0,1
111,2398,383,288,292,26,6,62,409,11,65,38,67,76,105,429,656,5,3719,206,0,1
50,2070,1043,504,840,53,9,147,1096,9,180,112,198,189,310,1377,2344,4,11604,644,0,1
446,9641,72,33,56,0,4,12,72,1,1,1,1,2,2,0,2,0,1,0,0,1
446,9641,1454,835,1044,76,110,219,1530,17,275,158,296,292,454,2297,3718,9,34017,1889,1,1
120,5027,139,89,101,2,0,35,141,7,54,34,62,61,96,330,569,4,2287,127,0,1
120,5027,7,5,5,0,0,2,7,1,2,1,2,3,3,2,4,0,2,0,0,1
29,556,127,75,83,2,11,30,129,4,14,7,14,18,21,61,87,2,175,9,0,0
29,556,652,304,544,16,6,88,668,6,89,51,101,95,152,591,998,3,3399,188,0,0
29,556,2,2,2,0,0,0,2,0,0,0,0,0,0,0,0,0,0,0,0,0
29,556,8,5,5,0,0,3,8,0,0,0,0,0,0,0,0,0,0,0,0,0
29,556,14,8,8,0,0,6,14,0,0,0,0,0,0,0,0,0,0,0,0,0
29,556,6,4,4,0,0,2,6,0,0,0,0,0,0,0,0,0,0,0,0,0
29,556,6,4,4,0,0,2,6,1,2,1,2,3,3,2,4,0,2,0,0,0
29,556,7,5,5,0,0,2,7,0,0,0,0,0,0,0,0,0,0,0,0,0
29,556,10,6,6,0,0,4,10,0,0,0,0,0,0,0,0,0,0,0,0,0
29,556,1,1,1,0,0,0,1,0,0,0,0,0,0,0,0,0,0,0,0,0
29,556,14,10,10,0,0,4,14,1,1,1,1,2,2,0,2,0,1,0,0,0
29,556,46,26,30,3,0,12,49,3,6,3,6,9,9,20,28,1,42,2,0,0
42,1782,1513,682,1277,25,13,200,1538,11,199,116,219,210,335,1557,2584,6,15641,868,0,0
39,1924,1457,730,1242,11,6,188,1468,10,292,166,329,302,495,2424,4078,5,22973,1276,1,0
48,2093,1020,354,843,12,15,144,1032,8,134,77,144,142,221,970,1580,4,6792,377,0,0
36,1381,1098,241,925,5,10,155,1103,7,46,25,49,53,74,273,423,3,1580,87,0,0
28,546,127,75,83,2,11,30,129,4,14,7,14,18,21,61,87,2,175,9,0,0
28,546,652,304,544,16,6,88,668,6,89,51,101,95,152,591,998,3,3399,188,0,0
28,546,2,2,2,0,0,0,2,0,0,0,0,0,0,0,0,0,0,0,0,0
28,546,8,5,5,0,0,3,8,0,0,0,0,0,0,0,0,0,0,0,0,0
28,546,14,8,8,0,0,6,14,0,0,0,0,0,0,0,0,0,0,0,0,0
28,546,6,4,4,0,0,2,6,0,0,0,0,0,0,0,0,0,0,0,0,0
28,546,6,4,4,0,0,2,6,1,2,1,2,3,3,2,4,0,2,0,0,0
28,546,7,5,5,0,0,2,7,0,0,0,0,0,0,0,0,0,0,0,0,0
28,546,10,6,6,0,0,4,10,0,0,0,0,0,0,0,0,0,0,0,0,0
28,546,1,1,1,0,0,0,1,0,0,0,0,0,0,0,0,0,0,0,0,0
28,546,14,10,10,0,0,4,14,1,1,1,1,2,2,0,2,0,1,0,0,0
28,546,46,26,30,3,0,12,49,3,6,3,6,9,9,20,28,1,42,2,0,0
66,1213,1020,354,843,12,15,144,1032,8,134,77,144,142,221,970,1580,4,6792,377,0,1
50,2222,1020,354,843,12,15,144,1032,8,134,77,144,142,221,970,1580,4,6792,377,0,1
30,640,2,2,2,0,0,0,2,0,0,0,0,0,0,0,0,0,0,0,0,1
30,640,99,48,90,1,3,5,100,0,0,0,0,0,0,0,0,0,0,0,0,1
30,640,8,5,5,2,0,1,10,0,0,0,0,0,0,0,0,0,0,0,0,1
30,640,1217,716,841,84,126,174,1301,14,185,118,215,199,333,1446,2542,8,20687,1149,0,1
30,640,160,89,115,0,13,31,160,7,15,11,17,22,28,78,124,3,495,27,0,1
30,640,10,10,9,9,0,0,19,0,0,0,0,0,0,0,0,0,0,0,0,1
30,640,173,84,99,8,29,36,181,5,12,7,13,17,20,54,81,2,221,12,0,1
30,640,3,1,1,3,0,0,6,0,0,0,0,0,0,0,0,0,0,0,0,1
75,1656,477,336,357,30,23,73,507,16,194,134,250,210,384,1538,2962,10,30538,1696,0,1
74,1566,477,336,357,30,23,73,507,16,194,134,250,210,384,1538,2962,10,30538,1696,0,0
26,887,1455,414,1257,16,76,112,1471,5,41,23,46,46,69,231,381,2,1069,59,0,1
26,887,669,365,481,22,61,110,691,15,103,63,122,118,185,747,1273,8,11311,628,0,1
23,997,1455,414,1257,16,76,112,1471,5,41,23,46,46,69,231,381,2,1069,59,0,1
50,1776,1450,624,1228,12,26,181,1462,14,306,186,354,320,540,2580,4493,8,36391,2021,1,1
50,2082,1043,504,840,53,9,147,1096,9,180,112,198,189,310,1377,2344,4,11604,644,0,1
446,9636,72,33,56,0,4,12,72,1,1,1,1,2,2,0,2,0,1,0,0,1
446,9636,1454,835,1044,76,110,219,1530,17,275,158,296,292,454,2297,3718,9,34017,1889,1,1
24,595,465,148,393,5,8,60,470,4,31,20,31,35,51,161,261,2,523,29,0,1
24,595,16,12,9,0,0,6,16,1,2,1,2,3,3,2,4,0,2,0,0,1
443,9662,72,33,56,0,4,12,72,1,1,1,1,2,2,0,2,0,1,0,0,1
443,9662,1454,835,1044,76,110,219,1530,17,275,158,296,292,454,2297,3718,9,34017,1889,1,1
62,2992,1338,495,1086,10,64,173,1348,11,122,82,157,133,239,883,1686,7,11934,663,0,1
443,9662,72,33,56,0,4,12,72,1,1,1,1,2,2,0,2,0,1,0,0,0
443,9662,1454,835,1044,76,110,219,1530,17,275,158,296,292,454,2297,3718,9,34017,1889,1,0
62,2992,1338,495,1086,10,64,173,1348,11,122,82,157,133,239,883,1686,7,11934,663,0,0
444,9672,72,33,56,0,4,12,72,1,1,1,1,2,2,0,2,0,1,0,0,1
444,9672,1454,835,1044,76,110,219,1530,17,275,158,296,292,454,2297,3718,9,34017,1889,1,1
25,622,465,148,393,5,8,60,470,4,31,20,31,35,51,161,261,2,523,29,0,1
25,622,16,12,9,0,0,6,16,1,2,1,2,3,3,2,4,0,2,0,0,1
120,5034,139,89,101,2,0,35,141,7,54,34,62,61,96,330,569,4,2287,127,0,1
120,5034,7,5,5,0,0,2,7,1,2,1,2,3,3,2,4,0,2,0,0,1
440,9611,72,33,56,0,4,12,72,1,1,1,1,2,2,0,2,0,1,0,0,1
440,9611,1454,835,1044,76,110,219,1530,17,275,158,296,292,454,2297,3718,9,34017,1889,1,1
439,9596,72,33,56,0,4,12,72,1,1,1,1,2,2,0,2,0,1,0,0,0
439,9596,1454,835,1044,76,110,219,1530,17,275,158,296,292,454,2297,3718,9,34017,1889,1,0
163,3249,1943,715,1694,26,18,214,1969,12,185,120,237,197,357,1436,2721,7,20915,1161,0,1
163,3249,1168,838,957,57,25,144,1225,19,348,224,416,367,640,3018,5452,11,61921,3440,1,1
61,2682,1943,715,1694,26,18,214,1969,12,185,120,237,197,357,1436,2721,7,20915,1161,0,1
61,2680,1943,715,1694,26,18,214,1969,12,185,120,237,197,357,1436,2721,7,20915,1161,0,0
170,3786,77,34,69,0,0,8,77,3,24,16,29,27,45,114,213,1,387,21,0,1
170,3786,712,438,573,51,9,84,763,14,102,71,128,116,199,733,1364,8,11988,666,0,1
439,9723,72,33,56,0,4,12,72,1,1,1,1,2,2,0,2,0,1,0,0,1
439,9723,1454,835,1044,76,110,219,1530,17,275,158,296,292,454,2297,3718,9,34017,1889,1,1
62,2993,1338,495,1086,10,64,173,1348,11,122,82,157,133,239,883,1686,7,11934,663,0,1
120,5138,139,89,101,2,0,35,141,7,54,34,62,61,96,330,569,4,2287,127,0,1
120,5138,7,5,5,0,0,2,7,1,2,1,2,3,3,2,4,0,2,0,0,1
165,3722,77,34,69,0,0,8,77,3,24,16,29,27,45,114,213,1,387,21,0,1
165,3722,712,438,573,51,9,84,763,14,102,71,128,116,199,733,1364,8,11988,666,0,1
431,9623,72,33,56,0,4,12,72,1,1,1,1,2,2,0,2,0,1,0,0,1
431,9623,1454,835,1044,76,110,219,1530,17,275,158,296,292,454,2297,3718,9,34017,1889,1,1
62,2899,1338,495,1086,10,64,173,1348,11,122,82,157,133,239,883,1686,7,11934,663,0,1
111,2393,1043,504,840,53,9,147,1096,9,180,112,198,189,310,1377,2344,4,11604,644,0,0
111,2393,383,288,292,26,6,62,409,11,65,38,67,76,105,429,656,5,3719,206,0,0
2,34,9,6,6,0,0,3,9,0,0,0,0,0,0,0,0,0,0,0,0,0
2,34,13,9,8,0,0,4,13,0,0,0,0,0,0,0,0,0,0,0,0,0
57,3230,1782,648,1425,9,47,279,1791,8,171,97,189,179,286,1292,2140,4,9462,525,0,0
433,9667,72,33,56,0,4,12,72,1,1,1,1,2,2,0,2,0,1,0,0,1
433,9667,1454,835,1044,76,110,219,1530,17,275,158,296,292,454,2297,3718,9,34017,1889,1,1
121,5214,139,89,101,2,0,35,141,7,54,34,62,61,96,330,569,4,2287,127,0,1
121,5214,7,5,5,0,0,2,7,1,2,1,2,3,3,2,4,0,2,0,0,1
57,3230,1782,648,1425,9,47,279,1791,8,171,97,189,179,286,1292,2140,4,9462,525,0,1
432,9610,72,33,56,0,4,12,72,1,1,1,1,2,2,0,2,0,1,0,0,0
432,9610,1454,835,1044,76,110,219,1530,17,275,158,296,292,454,2297,3718,9,34017,1889,1,0
61,2678,1943,715,1694,26,18,214,1969,12,185,120,237,197,357,1436,2721,7,20915,1161,0,0
163,3249,1943,715,1694,26,18,214,1969,12,185,120,237,197,357,1436,2721,7,20915,1161,0,0
163,3249,1168,838,957,57,25,144,1225,19,348,224,416,367,640,3018,5452,11,61921,3440,1,0
61,2676,1943,715,1694,26,18,214,1969,12,185,120,237,197,357,1436,2721,7,20915,1161,0,0
431,9600,72,33,56,0,4,12,72,1,1,1,1,2,2,0,2,0,1,0,0,1
431,9600,1454,835,1044,76,110,219,1530,17,275,158,296,292,454,2297,3718,9,34017,1889,1,1
3,42,14,8,8,0,0,6,14,0,0,0,0,0,0,0,0,0,0,0,0,0
437,9678,72,33,56,0,4,12,72,1,1,1,1,2,2,0,2,0,1,0,0,1
437,9678,1454,835,1044,76,110,219,1530,17,275,158,296,292,454,2297,3718,9,34017,1889,1,1
229,4665,1457,730,1242,11,6,188,1468,10,292,166,329,302,495,2424,4078,5,22973,1276,1,1
229,4665,74,35,59,1,0,14,75,3,14,7,14,17,21,58,85,1,128,7,0,1
229,4665,245,125,200,5,7,34,250,7,30,17,34,37,51,166,265,3,1053,58,0,1
437,9677,72,33,56,0,4,12,72,1,1,1,1,2,2,0,2,0,1,0,0,1
437,9677,1454,835,1044,76,110,219,1530,17,275,158,296,292,454,2297,3718,9,34017,1889,1,1
439,9699,72,33,56,0,4,12,72,1,1,1,1,2,2,0,2,0,1,0,0,1
439,9699,1454,835,1044,76,110,219,1530,17,275,158,296,292,454,2297,3718,9,34017,1889,1,1
122,5273,139,89,101,2,0,35,141,7,54,34,62,61,96,330,569,4,2287,127,0,1
122,5273,7,5,5,0,0,2,7,1,2,1,2,3,3,2,4,0,2,0,0,1
439,9701,72,33,56,0,4,12,72,1,1,1,1,2,2,0,2,0,1,0,0,1
439,9701,1454,835,1044,76,110,219,1530,17,275,158,296,292,454,2297,3718,9,34017,1889,1,1
439,9685,72,33,56,0,4,12,72,1,1,1,1,2,2,0,2,0,1,0,0,1
439,9685,1454,835,1044,76,110,219,1530,17,275,158,296,292,454,2297,3718,9,34017,1889,1,1
63,2929,1338,495,1086,10,64,173,1348,11,122,82,157,133,239,883,1686,7,11934,663,0,1
439,9685,72,33,56,0,4,12,72,1,1,1,1,2,2,0,2,0,1,0,0,0
439,9685,1454,835,1044,76,110,219,1530,17,275,158,296,292,454,2297,3718,9,34017,1889,1,0
63,2929,1338,495,1086,10,64,173,1348,11,122,82,157,133,239,883,1686,7,11934,663,0,0
131,4059,1660,832,1314,41,38,274,1701,20,312,209,395,332,604,2671,5058,12,64042,3557,1,1
131,4059,1057,646,719,113,100,145,1170,18,215,134,248,233,382,1740,3004,10,31186,1732,1,1
51,1803,1450,624,1228,12,26,181,1462,14,306,186,354,320,540,2580,4493,8,36391,2021,1,1
61,2674,1943,715,1694,26,18,214,1969,12,185,120,237,197,357,1436,2721,7,20915,1161,0,0
1,225,382,65,130,157,2,92,539,4,10,5,10,14,15,41,57,2,114,6,0,0
1,245,382,65,130,157,2,92,539,4,10,5,10,14,15,41,57,2,114,6,0,0
1,270,382,65,130,157,2,92,539,4,10,5,10,14,15,41,57,2,114,6,0,0
1,272,382,65,130,157,2,92,539,4,10,5,10,14,15,41,57,2,114,6,0,0
1,274,382,65,130,157,2,92,539,4,10,5,10,14,15,41,57,2,114,6,0,0
1,276,382,65,130,157,2,92,539,4,10,5,10,14,15,41,57,2,114,6,0,1
1,279,382,65,130,157,2,92,539,4,10,5,10,14,15,41,57,2,114,6,0,0
39,2399,1523,757,1297,19,12,193,1542,12,193,117,230,205,347,1508,2664,7,19053,1058,0,1
439,9687,72,33,56,0,4,12,72,1,1,1,1,2,2,0,2,0,1,0,0,1
439,9687,1454,835,1044,76,110,219,1530,17,275,158,296,292,454,2297,3718,9,34017,1889,1,1
39,2393,1523,757,1297,19,12,193,1542,12,193,117,230,205,347,1508,2664,7,19053,1058,0,0
435,9731,72,33,56,0,4,12,72,1,1,1,1,2,2,0,2,0,1,0,0,1
435,9731,1454,835,1044,76,110,219,1530,17,275,158,296,292,454,2297,3718,9,34017,1889,1,1
124,5341,139,89,101,2,0,35,141,7,54,34,62,61,96,330,569,4,2287,127,0,1
124,5341,7,5,5,0,0,2,7,1,2,1,2,3,3,2,4,0,2,0,0,1
435,9733,72,33,56,0,4,12,72,1,1,1,1,2,2,0,2,0,1,0,0,0
435,9733,1454,835,1044,76,110,219,1530,17,275,158,296,292,454,2297,3718,9,34017,1889,1,0
124,5341,139,89,101,2,0,35,141,7,54,34,62,61,96,330,569,4,2287,127,0,0
124,5341,7,5,5,0,0,2,7,1,2,1,2,3,3,2,4,0,2,0,0,0
435,9731,72,33,56,0,4,12,72,1,1,1,1,2,2,0,2,0,1,0,0,0
435,9731,1454,835,1044,76,110,219,1530,17,275,158,296,292,454,2297,3718,9,34017,1889,1,0
435,9729,72,33,56,0,4,12,72,1,1,1,1,2,2,0,2,0,1,0,0,1
435,9729,1454,835,1044,76,110,219,1530,17,275,158,296,292,454,2297,3718,9,34017,1889,1,1
58,3261,1782,648,1425,9,47,279,1791,8,171,97,189,179,286,1292,2140,4,9462,525,0,1
39,2401,1523,757,1297,19,12,193,1542,12,193,117,230,205,347,1508,2664,7,19053,1058,0,0
58,3259,1782,648,1425,9,47,279,1791,8,171,97,189,179,286,1292,2140,4,9462,525,0,0
75,1645,477,336,357,30,23,73,507,16,194,134,250,210,384,1538,2962,10,30538,1696,0,1
51,2245,1020,354,843,12,15,144,1032,8,134,77,144,142,221,970,1580,4,6792,377,0,1
66,1213,1020,354,843,12,15,144,1032,8,134,77,144,142,221,970,1580,4,6792,377,0,0
51,2245,1020,354,843,12,15,144,1032,8,134,77,144,142,221,970,1580,4,6792,377,0,0
165,3720,77,34,69,0,0,8,77,3,24,16,29,27,45,114,213,1,387,21,0,1
165,3720,712,438,573,51,9,84,763,14,102,71,128,116,199,733,1364,8,11988,666,0,1
195,4406,722,423,573,19,0,135,741,12,172,101,199,184,300,1320,2257,6,15668,870,0,1
195,4406,1508,847,911,44,250,301,1552,14,148,88,169,162,257,1120,1886,7,15077,837,0,1
111,2393,1043,504,840,53,9,147,1096,9,180,112,198,189,310,1377,2344,4,11604,644,0,1
111,2393,383,288,292,26,6,62,409,11,65,38,67,76,105,429,656,5,3719,206,0,1
86,1513,1178,367,1042,6,15,115,1184,9,94,51,95,103,146,644,976,4,4439,246,0,1
86,1513,177,108,140,8,0,27,185,6,30,16,32,36,48,162,248,3,794,44,0,1
163,3247,1943,715,1694,26,18,214,1969,12,185,120,237,197,357,1436,2721,7,20915,1161,0,1
163,3247,1168,838,957,57,25,144,1225,19,348,224,416,367,640,3018,5452,11,61921,3440,1,1
56,983,282,196,195,3,0,86,285,8,130,71,141,138,212,936,1507,4,6538,363,0,1
7,296,72,33,56,0,4,12,72,1,1,1,1,2,2,0,2,0,1,0,0,1
39,1920,1457,730,1242,11,6,188,1468,10,292,166,329,302,495,2424,4078,5,22973,1276,1,1
16,498,424,94,331,4,0,89,428,1,5,5,5,6,10,11,25,0,12,0,0,1
14,567,722,423,573,19,0,135,741,12,172,101,199,184,300,1320,2257,6,15668,870,0,1
12,404,386,256,301,16,9,68,402,4,59,35,69,63,104,355,621,2,1453,80,0,1
50,2058,1043,504,840,53,9,147,1096,9,180,112,198,189,310,1377,2344,4,11604,644,0,1
24,968,373,158,315,8,0,51,381,5,76,44,79,81,123,486,779,2,2026,112,0,1
7,514,442,244,305,14,16,103,456,11,68,45,75,79,120,452,756,6,4588,254,0,1
195,4406,722,423,573,19,0,135,741,12,172,101,199,184,300,1320,2257,6,15668,870,0,0
195,4406,1508,847,911,44,250,301,1552,14,148,88,169,162,257,1120,1886,7,15077,837,0,0
435,9729,72,33,56,0,4,12,72,1,1,1,1,2,2,0,2,0,1,0,0,0
435,9729,1454,835,1044,76,110,219,1530,17,275,158,296,292,454,2297,3718,9,34017,1889,1,0
39,1920,1457,730,1242,11,6,188,1468,10,292,166,329,302,495,2424,4078,5,22973,1276,1,0
42,1121,74,35,59,1,0,14,75,3,14,7,14,17,21,58,85,1,128,7,0,1
42,1121,245,125,200,5,7,34,250,7,30,17,34,37,51,166,265,3,1053,58,0,1
67,1216,1020,354,843,12,15,144,1032,8,134,77,144,142,221,970,1580,4,6792,377,0,0
54,2310,1020,354,843,12,15,144,1032,8,134,77,144,142,221,970,1580,4,6792,377,0,0
42,1121,74,35,59,1,0,14,75,3,14,7,14,17,21,58,85,1,128,7,0,0
42,1121,245,125,200,5,7,34,250,7,30,17,34,37,51,166,265,3,1053,58,0,0
42,1128,74,35,59,1,0,14,75,3,14,7,14,17,21,58,85,1,128,7,0,1
42,1128,245,125,200,5,7,34,250,7,30,17,34,37,51,166,265,3,1053,58,0,1
229,4667,1457,730,1242,11,6,188,1468,10,292,166,329,302,495,2424,4078,5,22973,1276,1,0
229,4667,74,35,59,1,0,14,75,3,14,7,14,17,21,58,85,1,128,7,0,0
229,4667,245,125,200,5,7,34,250,7,30,17,34,37,51,166,265,3,1053,58,0,0
163,3251,1943,715,1694,26,18,214,1969,12,185,120,237,197,357,1436,2721,7,20915,1161,0,1
163,3251,1168,838,957,57,25,144,1225,19,348,224,416,367,640,3018,5452,11,61921,3440,1,1
229,4665,1457,730,1242,11,6,188,1468,10,292,166,329,302,495,2424,4078,5,22973,1276,1,0
229,4665,74,35,59,1,0,14,75,3,14,7,14,17,21,58,85,1,128,7,0,0
229,4665,245,125,200,5,7,34,250,7,30,17,34,37,51,166,265,3,1053,58,0,0
55,2354,1020,354,843,12,15,144,1032,8,134,77,144,142,221,970,1580,4,6792,377,0,0
116,2937,1660,832,1314,41,38,274,1701,20,312,209,395,332,604,2671,5058,12,64042,3557,1,1
116,2937,1660,832,1314,41,38,274,1701,20,312,209,395,332,604,2671,5058,12,64042,3557,1,0
43,1834,1513,682,1277,25,13,200,1538,11,199,116,219,210,335,1557,2584,6,15641,868,0,0
171,3239,1513,682,1277,25,13,200,1538,11,199,116,219,210,335,1557,2584,6,15641,868,0,0
171,3239,819,519,539,24,98,155,843,15,96,57,106,111,163,690,1107,8,9171,509,0,0
118,4709,1513,682,1277,25,13,200,1538,11,199,116,219,210,335,1557,2584,6,15641,868,0,0
118,4607,1513,682,1277,25,13,200,1538,11,199,116,219,210,335,1557,2584,6,15641,868,0,0
170,3212,1513,682,1277,25,13,200,1538,11,199,116,219,210,335,1557,2584,6,15641,868,0,0
170,3212,819,519,539,24,98,155,843,15,96,57,106,111,163,690,1107,8,9171,509,0,0
169,3198,1513,682,1277,25,13,200,1538,11,199,116,219,210,335,1557,2584,6,15641,868,0,0
169,3198,819,519,539,24,98,155,843,15,96,57,106,111,163,690,1107,8,9171,509,0,0
168,3181,1513,682,1277,25,13,200,1538,11,199,116,219,210,335,1557,2584,6,15641,868,0,0
168,3181,819,519,539,24,98,155,843,15,96,57,106,111,163,690,1107,8,9171,509,0,0
168,3179,1513,682,1277,25,13,200,1538,11,199,116,219,210,335,1557,2584,6,15641,868,0,0
168,3179,819,519,539,24,98,155,843,15,96,57,106,111,163,690,1107,8,9171,509,0,0
168,3156,1513,682,1277,25,13,200,1538,11,199,116,219,210,335,1557,2584,6,15641,868,0,0
168,3156,819,519,539,24,98,155,843,15,96,57,106,111,163,690,1107,8,9171,509,0,0
118,4597,1513,682,1277,25,13,200,1538,11,199,116,219,210,335,1557,2584,6,15641,868,0,0
73,1336,1513,682,1277,25,13,200,1538,11,199,116,219,210,335,1557,2584,6,15641,868,0,0
73,1336,819,519,539,24,98,155,843,15,96,57,106,111,163,690,1107,8,9171,509,0,0
43,1824,1513,682,1277,25,13,200,1538,11,199,116,219,210,335,1557,2584,6,15641,868,0,0
168,3156,1513,682,1277,25,13,200,1538,11,199,116,219,210,335,1557,2584,6,15641,868,0,1
168,3156,819,519,539,24,98,155,843,15,96,57,106,111,163,690,1107,8,9171,509,0,1
121,4624,1513,682,1277,25,13,200,1538,11,199,116,219,210,335,1557,2584,6,15641,868,0,1
30,640,2,2,2,0,0,0,2,0,0,0,0,0,0,0,0,0,0,0,0,0
30,640,99,48,90,1,3,5,100,0,0,0,0,0,0,0,0,0,0,0,0,0
30,640,8,5,5,2,0,1,10,0,0,0,0,0,0,0,0,0,0,0,0,0
30,640,1217,716,841,84,126,174,1301,14,185,118,215,199,333,1446,2542,8,20687,1149,0,0
30,640,160,89,115,0,13,31,160,7,15,11,17,22,28,78,124,3,495,27,0,0
30,640,10,10,9,9,0,0,19,0,0,0,0,0,0,0,0,0,0,0,0,0
30,640,173,84,99,8,29,36,181,5,12,7,13,17,20,54,81,2,221,12,0,0
30,640,3,1,1,3,0,0,6,0,0,0,0,0,0,0,0,0,0,0,0,0
75,1645,477,336,357,30,23,73,507,16,194,134,250,210,384,1538,2962,10,30538,1696,0,0
26,887,1455,414,1257,16,76,112,1471,5,41,23,46,46,69,231,381,2,1069,59,0,0
26,887,669,365,481,22,61,110,691,15,103,63,122,118,185,747,1273,8,11311,628,0,0
42,1128,74,35,59,1,0,14,75,3,14,7,14,17,21,58,85,1,128,7,0,0
42,1128,245,125,200,5,7,34,250,7,30,17,34,37,51,166,265,3,1053,58,0,0
44,432,647,139,84,35,284,233,682,0,0,0,0,0,0,0,0,0,0,0,0,0
166,3723,77,34,69,0,0,8,77,3,24,16,29,27,45,114,213,1,387,21,0,0
166,3723,712,438,573,51,9,84,763,14,102,71,128,116,199,733,1364,8,11988,666,0,0
42,852,447,308,343,6,5,95,453,7,96,59,111,103,170,651,1136,4,4600,255,0,0
42,852,322,174,179,16,74,51,338,10,41,26,46,51,72,252,408,5,2291,127,0,0
23,407,424,94,331,4,0,89,428,1,5,5,5,6,10,11,25,0,12,0,0,0
23,407,38,23,23,6,0,8,44,3,11,7,11,14,18,42,68,1,102,5,0,0
18,460,386,256,301,16,9,68,402,4,59,35,69,63,104,355,621,2,1453,80,0,0
18,460,264,131,164,11,41,46,275,6,38,22,40,44,62,214,338,3,1068,59,0,0
86,1513,1178,367,1042,6,15,115,1184,9,94,51,95,103,146,644,976,4,4439,246,0,0
86,1513,177,108,140,8,0,27,185,6,30,16,32,36,48,162,248,3,794,44,0,0
163,3251,1943,715,1694,26,18,214,1969,12,185,120,237,197,357,1436,2721,7,20915,1161,0,0
163,3251,1168,838,957,57,25,144,1225,19,348,224,416,367,640,3018,5452,11,61921,3440,1,0
54,1029,1098,241,925,5,10,155,1103,7,46,25,49,53,74,273,423,3,1580,87,0,0
54,1029,282,202,222,14,2,44,296,8,42,24,43,50,67,250,378,4,1548,86,0,0
56,983,282,196,195,3,0,86,285,8,130,71,141,138,212,936,1507,4,6538,363,0,0
7,296,72,33,56,0,4,12,72,1,1,1,1,2,2,0,2,0,1,0,0,0
63,2592,1289,550,1043,56,32,155,1345,10,167,93,185,177,278,1266,2075,5,11498,638,0,0
24,595,465,148,393,5,8,60,470,4,31,20,31,35,51,161,261,2,523,29,0,0
24,595,16,12,9,0,0,6,16,1,2,1,2,3,3,2,4,0,2,0,0,0
9,192,256,139,192,9,7,47,265,4,23,12,24,27,36,112,171,2,357,19,0,0
51,1803,1450,624,1228,12,26,181,1462,14,306,186,354,320,540,2580,4493,8,36391,2021,1,0
121,4624,1513,682,1277,25,13,200,1538,11,199,116,219,210,335,1557,2584,6,15641,868,0,0
45,2786,1296,573,1062,40,33,157,1336,8,201,118,231,209,349,1561,2689,4,12365,686,0,0
23,997,1455,414,1257,16,76,112,1471,5,41,23,46,46,69,231,381,2,1069,59,0,0
11,343,74,35,59,1,0,14,75,3,14,7,14,17,21,58,85,1,128,7,0,0
16,498,424,94,331,4,0,89,428,1,5,5,5,6,10,11,25,0,12,0,0,0
38,2232,334,251,279,10,4,40,344,5,127,74,143,132,217,899,1528,2,4303,239,0,0
7,291,184,100,137,2,15,30,186,6,38,20,39,44,59,214,322,3,991,55,0,0
14,567,722,423,573,19,0,135,741,12,172,101,199,184,300,1320,2257,6,15668,870,0,0
12,404,386,256,301,16,9,68,402,4,59,35,69,63,104,355,621,2,1453,80,0,0
50,2058,1043,504,840,53,9,147,1096,9,180,112,198,189,310,1377,2344,4,11604,644,0,0
24,968,373,158,315,8,0,51,381,5,76,44,79,81,123,486,779,2,2026,112,0,0
43,1898,1178,367,1042,6,15,115,1184,9,94,51,95,103,146,644,976,4,4439,246,0,0
61,2682,1943,715,1694,26,18,214,1969,12,185,120,237,197,357,1436,2721,7,20915,1161,0,0
7,514,442,244,305,14,16,103,456,11,68,45,75,79,120,452,756,6,4588,254,0,0
166,3098,1513,682,1277,25,13,200,1538,11,199,116,219,210,335,1557,2584,6,15641,868,0,1
166,3098,819,519,539,24,98,155,843,15,96,57,106,111,163,690,1107,8,9171,509,0,1
118,4513,1513,682,1277,25,13,200,1538,11,199,116,219,210,335,1557,2584,6,15641,868,0,1
164,3038,1513,682,1277,25,13,200,1538,11,199,116,219,210,335,1557,2584,6,15641,868,0,0
164,3038,819,519,539,24,98,155,843,15,96,57,106,111,163,690,1107,8,9171,509,0,0
113,4338,1513,682,1277,25,13,200,1538,11,199,116,219,210,335,1557,2584,6,15641,868,0,0
161,3000,1513,682,1277,25,13,200,1538,11,199,116,219,210,335,1557,2584,6,15641,868,0,0
161,3000,819,519,539,24,98,155,843,15,96,57,106,111,163,690,1107,8,9171,509,0,0
112,4278,1513,682,1277,25,13,200,1538,11,199,116,219,210,335,1557,2584,6,15641,868,0,0
112,2401,1043,504,840,53,9,147,1096,9,180,112,198,189,310,1377,2344,4,11604,644,0,1
112,2401,383,288,292,26,6,62,409,11,65,38,67,76,105,429,656,5,3719,206,0,1
49,1988,1043,504,840,53,9,147,1096,9,180,112,198,189,310,1377,2344,4,11604,644,0,1
434,9721,72,33,56,0,4,12,72,1,1,1,1,2,2,0,2,0,1,0,0,1
434,9721,1454,835,1044,76,110,219,1530,17,275,158,296,292,454,2297,3718,9,34017,1889,1,1
31,635,2,2,2,0,0,0,2,0,0,0,0,0,0,0,0,0,0,0,0,1
31,635,99,48,90,1,3,5,100,0,0,0,0,0,0,0,0,0,0,0,0,1
31,635,8,5,5,2,0,1,10,0,0,0,0,0,0,0,0,0,0,0,0,1
31,635,1217,716,841,84,126,174,1301,14,185,118,215,199,333,1446,2542,8,20687,1149,0,1
31,635,160,89,115,0,13,31,160,7,15,11,17,22,28,78,124,3,495,27,0,1
31,635,10,10,9,9,0,0,19,0,0,0,0,0,0,0,0,0,0,0,0,1
31,635,173,84,99,8,29,36,181,5,12,7,13,17,20,54,81,2,221,12,0,1
31,635,3,1,1,3,0,0,6,0,0,0,0,0,0,0,0,0,0,0,0,1
77,1715,477,336,357,30,23,73,507,16,194,134,250,210,384,1538,2962,10,30538,1696,0,1
54,1893,1450,624,1228,12,26,181,1462,14,306,186,354,320,540,2580,4493,8,36391,2021,1,1
116,2935,1660,832,1314,41,38,274,1701,20,312,209,395,332,604,2671,5058,12,64042,3557,1,0
16,496,424,94,331,4,0,89,428,1,5,5,5,6,10,11,25,0,12,0,0,0
14,565,722,423,573,19,0,135,741,12,172,101,199,184,300,1320,2257,6,15668,870,0,0
24,966,373,158,315,8,0,51,381,5,76,44,79,81,123,486,779,2,2026,112,0,0
7,512,442,244,305,14,16,103,456,11,68,45,75,79,120,452,756,6,4588,254,0,0
114,4316,1513,682,1277,25,13,200,1538,11,199,116,219,210,335,1557,2584,6,15641,868,0,1
63,2606,1289,550,1043,56,32,155,1345,10,167,93,185,177,278,1266,2075,5,11498,638,0,1
7,528,442,244,305,14,16,103,456,11,68,45,75,79,120,452,756,6,4588,254,0,1
116,2936,1660,832,1314,41,38,274,1701,20,312,209,395,332,604,2671,5058,12,64042,3557,1,1
1,279,382,65,130,157,2,92,539,4,10,5,10,14,15,41,57,2,114,6,0,1
114,4337,1513,682,1277,25,13,200,1538,11,199,116,219,210,335,1557,2584,6,15641,868,0,1
114,4342,1513,682,1277,25,13,200,1538,11,199,116,219,210,335,1557,2584,6,15641,868,0,0
438,9758,72,33,56,0,4,12,72,1,1,1,1,2,2,0,2,0,1,0,0,1
438,9758,1454,835,1044,76,110,219,1530,17,275,158,296,292,454,2297,3718,9,34017,1889,1,1
230,4698,1457,730,1242,11,6,188,1468,10,292,166,329,302,495,2424,4078,5,22973,1276,1,1
230,4698,74,35,59,1,0,14,75,3,14,7,14,17,21,58,85,1,128,7,0,1
230,4698,245,125,200,5,7,34,250,7,30,17,34,37,51,166,265,3,1053,58,0,1
45,445,647,139,84,35,284,233,682,0,0,0,0,0,0,0,0,0,0,0,0,1
168,3801,77,34,69,0,0,8,77,3,24,16,29,27,45,114,213,1,387,21,0,1
168,3801,712,438,573,51,9,84,763,14,102,71,128,116,199,733,1364,8,11988,666,0,1
169,3417,1943,715,1694,26,18,214,1969,12,185,120,237,197,357,1436,2721,7,20915,1161,0,1
169,3417,1168,838,957,57,25,144,1225,19,348,224,416,367,640,3018,5452,11,61921,3440,1,1
41,2014,1457,730,1242,11,6,188,1468,10,292,166,329,302,495,2424,4078,5,22973,1276,1,1
435,9747,72,33,56,0,4,12,72,1,1,1,1,2,2,0,2,0,1,0,0,1
435,9747,1454,835,1044,76,110,219,1530,17,275,158,296,292,454,2297,3718,9,34017,1889,1,1
63,2938,1338,495,1086,10,64,173,1348,11,122,82,157,133,239,883,1686,7,11934,663,0,1
228,4658,1457,730,1242,11,6,188,1468,10,292,166,329,302,495,2424,4078,5,22973,1276,1,1
228,4658,74,35,59,1,0,14,75,3,14,7,14,17,21,58,85,1,128,7,0,1
228,4658,245,125,200,5,7,34,250,7,30,17,34,37,51,166,265,3,1053,58,0,1
43,1133,74,35,59,1,0,14,75,3,14,7,14,17,21,58,85,1,128,7,0,1
43,1133,245,125,200,5,7,34,250,7,30,17,34,37,51,166,265,3,1053,58,0,1
166,3376,1943,715,1694,26,18,214,1969,12,185,120,237,197,357,1436,2721,7,20915,1161,0,1
166,3376,1168,838,957,57,25,144,1225,19,348,224,416,367,640,3018,5452,11,61921,3440,1,1
37,2191,334,251,279,10,4,40,344,5,127,74,143,132,217,899,1528,2,4303,239,0,1
160,2985,1513,682,1277,25,13,200,1538,11,199,116,219,210,335,1557,2584,6,15641,868,0,0
160,2985,819,519,539,24,98,155,843,15,96,57,106,111,163,690,1107,8,9171,509,0,0
155,2896,1513,682,1277,25,13,200,1538,11,199,116,219,210,335,1557,2584,6,15641,868,0,1
155,2896,819,519,539,24,98,155,843,15,96,57,106,111,163,690,1107,8,9171,509,0,1
43,1314,1523,757,1297,19,12,193,1542,12,193,117,230,205,347,1508,2664,7,19053,1058,0,1
43,1314,701,378,504,33,58,109,734,13,110,68,126,123,194,794,1346,7,10027,557,0,1
171,3873,77,34,69,0,0,8,77,3,24,16,29,27,45,114,213,1,387,21,0,1
171,3873,712,438,573,51,9,84,763,14,102,71,128,116,199,733,1364,8,11988,666,0,1
24,594,1293,570,1093,25,15,163,1318,10,195,123,241,205,364,1516,2795,6,17273,959,0,1
116,2461,1043,504,840,53,9,147,1096,9,180,112,198,189,310,1377,2344,4,11604,644,0,1
116,2461,383,288,292,26,6,62,409,11,65,38,67,76,105,429,656,5,3719,206,0,1
114,4342,1513,682,1277,25,13,200,1538,11,199,116,219,210,335,1557,2584,6,15641,868,0,1
39,2415,1523,757,1297,19,12,193,1542,12,193,117,230,205,347,1508,2664,7,19053,1058,0,1
161,3047,1513,682,1277,25,13,200,1538,11,199,116,219,210,335,1557,2584,6,15641,868,0,1
161,3047,819,519,539,24,98,155,843,15,96,57,106,111,163,690,1107,8,9171,509,0,1
230,4686,1457,730,1242,11,6,188,1468,10,292,166,329,302,495,2424,4078,5,22973,1276,1,1
230,4686,74,35,59,1,0,14,75,3,14,7,14,17,21,58,85,1,128,7,0,1
230,4686,245,125,200,5,7,34,250,7,30,17,34,37,51,166,265,3,1053,58,0,1
43,1146,74,35,59,1,0,14,75,3,14,7,14,17,21,58,85,1,128,7,0,1
43,1146,245,125,200,5,7,34,250,7,30,17,34,37,51,166,265,3,1053,58,0,1
67,1214,1020,354,843,12,15,144,1032,8,134,77,144,142,221,970,1580,4,6792,377,0,1
25,602,1293,570,1093,25,15,163,1318,10,195,123,241,205,364,1516,2795,6,17273,959,0,1
435,9745,72,33,56,0,4,12,72,1,1,1,1,2,2,0,2,0,1,0,0,1
435,9745,1454,835,1044,76,110,219,1530,17,275,158,296,292,454,2297,3718,9,34017,1889,1,1
114,2464,1043,504,840,53,9,147,1096,9,180,112,198,189,310,1377,2344,4,11604,644,0,1
114,2464,383,288,292,26,6,62,409,11,65,38,67,76,105,429,656,5,3719,206,0,1
167,3404,1943,715,1694,26,18,214,1969,12,185,120,237,197,357,1436,2721,7,20915,1161,0,1
167,3404,1168,838,957,57,25,144,1225,19,348,224,416,367,640,3018,5452,11,61921,3440,1,1
114,4350,1513,682,1277,25,13,200,1538,11,199,116,219,210,335,1557,2584,6,15641,868,0,1
21,559,1293,570,1093,25,15,163,1318,10,195,123,241,205,364,1516,2795,6,17273,959,0,1
168,3795,77,34,69,0,0,8,77,3,24,16,29,27,45,114,213,1,387,21,0,1
168,3795,712,438,573,51,9,84,763,14,102,71,128,116,199,733,1364,8,11988,666,0,1
24,382,424,94,331,4,0,89,428,1,5,5,5,6,10,11,25,0,12,0,0,1
24,382,38,23,23,6,0,8,44,3,11,7,11,14,18,42,68,1,102,5,0,1
112,2415,1043,504,840,53,9,147,1096,9,180,112,198,189,310,1377,2344,4,11604,644,0,1
112,2415,383,288,292,26,6,62,409,11,65,38,67,76,105,429,656,5,3719,206,0,1
17,540,424,94,331,4,0,89,428,1,5,5,5,6,10,11,25,0,12,0,0,1
168,3793,77,34,69,0,0,8,77,3,24,16,29,27,45,114,213,1,387,21,0,1
168,3793,712,438,573,51,9,84,763,14,102,71,128,116,199,733,1364,8,11988,666,0,1
63,2936,1338,495,1086,10,64,173,1348,11,122,82,157,133,239,883,1686,7,11934,663,0,1
23,373,424,94,331,4,0,89,428,1,5,5,5,6,10,11,25,0,12,0,0,1
23,373,38,23,23,6,0,8,44,3,11,7,11,14,18,42,68,1,102,5,0,1
168,3793,77,34,69,0,0,8,77,3,24,16,29,27,45,114,213,1,387,21,0,0
168,3793,712,438,573,51,9,84,763,14,102,71,128,116,199,733,1364,8,11988,666,0,0
23,373,424,94,331,4,0,89,428,1,5,5,5,6,10,11,25,0,12,0,0,0
23,373,38,23,23,6,0,8,44,3,11,7,11,14,18,42,68,1,102,5,0,0
112,2415,1043,504,840,53,9,147,1096,9,180,112,198,189,310,1377,2344,4,11604,644,0,0
112,2415,383,288,292,26,6,62,409,11,65,38,67,76,105,429,656,5,3719,206,0,0
63,2936,1338,495,1086,10,64,173,1348,11,122,82,157,133,239,883,1686,7,11934,663,0,0
17,540,424,94,331,4,0,89,428,1,5,5,5,6,10,11,25,0,12,0,0,0
161,3043,1513,682,1277,25,13,200,1538,11,199,116,219,210,335,1557,2584,6,15641,868,0,1
161,3043,819,519,539,24,98,155,843,15,96,57,106,111,163,690,1107,8,9171,509,0,1
438,9764,72,33,56,0,4,12,72,1,1,1,1,2,2,0,2,0,1,0,0,1
438,9764,1454,835,1044,76,110,219,1530,17,275,158,296,292,454,2297,3718,9,34017,1889,1,1
438,9769,72,33,56,0,4,12,72,1,1,1,1,2,2,0,2,0,1,0,0,1
438,9769,1454,835,1044,76,110,219,1530,17,275,158,296,292,454,2297,3718,9,34017,1889,1,1
228,4665,1457,730,1242,11,6,188,1468,10,292,166,329,302,495,2424,4078,5,22973,1276,1,1
228,4665,74,35,59,1,0,14,75,3,14,7,14,17,21,58,85,1,128,7,0,1
228,4665,245,125,200,5,7,34,250,7,30,17,34,37,51,166,265,3,1053,58,0,1
228,4665,1457,730,1242,11,6,188,1468,10,292,166,329,302,495,2424,4078,5,22973,1276,1,0
228,4665,74,35,59,1,0,14,75,3,14,7,14,17,21,58,85,1,128,7,0,0
228,4665,245,125,200,5,7,34,250,7,30,17,34,37,51,166,265,3,1053,58,0,0
439,9795,72,33,56,0,4,12,72,1,1,1,1,2,2,0,2,0,1,0,0,0
439,9795,1454,835,1044,76,110,219,1530,17,275,158,296,292,454,2297,3718,9,34017,1889,1,0
115,4390,1513,682,1277,25,13,200,1538,11,199,116,219,210,335,1557,2584,6,15641,868,0,0
230,4693,1457,730,1242,11,6,188,1468,10,292,166,329,302,495,2424,4078,5,22973,1276,1,0
230,4693,74,35,59,1,0,14,75,3,14,7,14,17,21,58,85,1,128,7,0,0
230,4693,245,125,200,5,7,34,250,7,30,17,34,37,51,166,265,3,1053,58,0,0
45,445,647,139,84,35,284,233,682,0,0,0,0,0,0,0,0,0,0,0,0,0
171,3865,77,34,69,0,0,8,77,3,24,16,29,27,45,114,213,1,387,21,0,0
171,3865,712,438,573,51,9,84,763,14,102,71,128,116,199,733,1364,8,11988,666,0,0
439,9793,72,33,56,0,4,12,72,1,1,1,1,2,2,0,2,0,1,0,0,0
439,9793,1454,835,1044,76,110,219,1530,17,275,158,296,292,454,2297,3718,9,34017,1889,1,0
114,2478,1043,504,840,53,9,147,1096,9,180,112,198,189,310,1377,2344,4,11604,644,0,0
114,2478,383,288,292,26,6,62,409,11,65,38,67,76,105,429,656,5,3719,206,0,0
115,4398,1513,682,1277,25,13,200,1538,11,199,116,219,210,335,1557,2584,6,15641,868,0,0
115,4399,1513,682,1277,25,13,200,1538,11,199,116,219,210,335,1557,2584,6,15641,868,0,0
54,1027,1098,241,925,5,10,155,1103,7,46,25,49,53,74,273,423,3,1580,87,0,0
54,1027,282,202,222,14,2,44,296,8,42,24,43,50,67,250,378,4,1548,86,0,0
159,2935,1513,682,1277,25,13,200,1538,11,199,116,219,210,335,1557,2584,6,15641,868,0,1
159,2935,819,519,539,24,98,155,843,15,96,57,106,111,163,690,1107,8,9171,509,0,1
112,4283,1513,682,1277,25,13,200,1538,11,199,116,219,210,335,1557,2584,6,15641,868,0,1
133,2539,1513,682,1277,25,13,200,1538,11,199,116,219,210,335,1557,2584,6,15641,868,0,1
133,2539,819,519,539,24,98,155,843,15,96,57,106,111,163,690,1107,8,9171,509,0,1
111,4191,1513,682,1277,25,13,200,1538,11,199,116,219,210,335,1557,2584,6,15641,868,0,1
127,2479,1513,682,1277,25,13,200,1538,11,199,116,219,210,335,1557,2584,6,15641,868,0,1
127,2479,819,519,539,24,98,155,843,15,96,57,106,111,163,690,1107,8,9171,509,0,1
112,4213,1513,682,1277,25,13,200,1538,11,199,116,219,210,335,1557,2584,6,15641,868,0,1
122,2423,1513,682,1277,25,13,200,1538,11,199,116,219,210,335,1557,2584,6,15641,868,0,1
122,2423,819,519,539,24,98,155,843,15,96,57,106,111,163,690,1107,8,9171,509,0,1
110,4169,1513,682,1277,25,13,200,1538,11,199,116,219,210,335,1557,2584,6,15641,868,0,1
32,641,2,2,2,0,0,0,2,0,0,0,0,0,0,0,0,0,0,0,0,0
32,641,99,48,90,1,3,5,100,0,0,0,0,0,0,0,0,0,0,0,0,0
32,641,8,5,5,2,0,1,10,0,0,0,0,0,0,0,0,0,0,0,0,0
32,641,1217,716,841,84,126,174,1301,14,185,118,215,199,333,1446,2542,8,20687,1149,0,0
32,641,160,89,115,0,13,31,160,7,15,11,17,22,28,78,124,3,495,27,0,0
32,641,10,10,9,9,0,0,19,0,0,0,0,0,0,0,0,0,0,0,0,0
32,641,173,84,99,8,29,36,181,5,12,7,13,17,20,54,81,2,221,12,0,0
32,641,3,1,1,3,0,0,6,0,0,0,0,0,0,0,0,0,0,0,0,0
117,2976,1660,832,1314,41,38,274,1701,20,312,209,395,332,604,2671,5058,12,64042,3557,1,0
117,2960,1660,832,1314,41,38,274,1701,20,312,209,395,332,604,2671,5058,12,64042,3557,1,0
122,2423,1513,682,1277,25,13,200,1538,11,199,116,219,210,335,1557,2584,6,15641,868,0,0
122,2423,819,519,539,24,98,155,843,15,96,57,106,111,163,690,1107,8,9171,509,0,0
43,1146,74,35,59,1,0,14,75,3,14,7,14,17,21,58,85,1,128,7,0,0
43,1146,245,125,200,5,7,34,250,7,30,17,34,37,51,166,265,3,1053,58,0,0
43,1314,1523,757,1297,19,12,193,1542,12,193,117,230,205,347,1508,2664,7,19053,1058,0,0
43,1314,701,378,504,33,58,109,734,13,110,68,126,123,194,794,1346,7,10027,557,0,0
67,1214,1020,354,843,12,15,144,1032,8,134,77,144,142,221,970,1580,4,6792,377,0,0
21,559,1293,570,1093,25,15,163,1318,10,195,123,241,205,364,1516,2795,6,17273,959,0,0
167,3404,1943,715,1694,26,18,214,1969,12,185,120,237,197,357,1436,2721,7,20915,1161,0,0
167,3404,1168,838,957,57,25,144,1225,19,348,224,416,367,640,3018,5452,11,61921,3440,1,0
110,4178,1513,682,1277,25,13,200,1538,11,199,116,219,210,335,1557,2584,6,15641,868,0,0
39,2415,1523,757,1297,19,12,193,1542,12,193,117,230,205,347,1508,2664,7,19053,1058,0,0
118,2308,1513,682,1277,25,13,200,1538,11,199,116,219,210,335,1557,2584,6,15641,868,0,1
118,2308,819,519,539,24,98,155,843,15,96,57,106,111,163,690,1107,8,9171,509,0,1
110,4160,1513,682,1277,25,13,200,1538,11,199,116,219,210,335,1557,2584,6,15641,868,0,1
116,2252,1513,682,1277,25,13,200,1538,11,199,116,219,210,335,1557,2584,6,15641,868,0,1
116,2252,819,519,539,24,98,155,843,15,96,57,106,111,163,690,1107,8,9171,509,0,1
168,3427,1943,715,1694,26,18,214,1969,12,185,120,237,197,357,1436,2721,7,20915,1161,0,1
168,3427,1168,838,957,57,25,144,1225,19,348,224,416,367,640,3018,5452,11,61921,3440,1,1
110,4131,1513,682,1277,25,13,200,1538,11,199,116,219,210,335,1557,2584,6,15641,868,0,1
198,4464,722,423,573,19,0,135,741,12,172,101,199,184,300,1320,2257,6,15668,870,0,1
198,4464,1508,847,911,44,250,301,1552,14,148,88,169,162,257,1120,1886,7,15077,837,0,1
117,2950,1660,832,1314,41,38,274,1701,20,312,209,395,332,604,2671,5058,12,64042,3557,1,1
117,2932,1660,832,1314,41,38,274,1701,20,312,209,395,332,604,2671,5058,12,64042,3557,1,0
115,4404,1513,682,1277,25,13,200,1538,11,199,116,219,210,335,1557,2584,6,15641,868,0,0
116,2252,1513,682,1277,25,13,200,1538,11,199,116,219,210,335,1557,2584,6,15641,868,0,0
116,2252,819,519,539,24,98,155,843,15,96,57,106,111,163,690,1107,8,9171,509,0,0
111,4160,1513,682,1277,25,13,200,1538,11,199,116,219,210,335,1557,2584,6,15641,868,0,0
118,2356,1513,682,1277,25,13,200,1538,11,199,116,219,210,335,1557,2584,6,15641,868,0,1
118,2356,819,519,539,24,98,155,843,15,96,57,106,111,163,690,1107,8,9171,509,0,1
114,4320,1513,682,1277,25,13,200,1538,11,199,116,219,210,335,1557,2584,6,15641,868,0,1
122,2415,1513,682,1277,25,13,200,1538,11,199,116,219,210,335,1557,2584,6,15641,868,0,0
122,2415,819,519,539,24,98,155,843,15,96,57,106,111,163,690,1107,8,9171,509,0,0
64,2630,1289,550,1043,56,32,155,1345,10,167,93,185,177,278,1266,2075,5,11498,638,0,0
114,2276,1513,682,1277,25,13,200,1538,11,199,116,219,210,335,1557,2584,6,15641,868,0,1
114,2276,819,519,539,24,98,155,843,15,96,57,106,111,163,690,1107,8,9171,509,0,1
21,564,1293,570,1093,25,15,163,1318,10,195,123,241,205,364,1516,2795,6,17273,959,0,1
109,4150,1513,682,1277,25,13,200,1538,11,199,116,219,210,335,1557,2584,6,15641,868,0,1
29,1113,1293,570,1093,25,15,163,1318,10,195,123,241,205,364,1516,2795,6,17273,959,0,1
114,2255,1513,682,1277,25,13,200,1538,11,199,116,219,210,335,1557,2584,6,15641,868,0,1
114,2255,819,519,539,24,98,155,843,15,96,57,106,111,163,690,1107,8,9171,509,0,1
67,1216,1020,354,843,12,15,144,1032,8,134,77,144,142,221,970,1580,4,6792,377,0,1
439,9795,72,33,56,0,4,12,72,1,1,1,1,2,2,0,2,0,1,0,0,1
439,9795,1454,835,1044,76,110,219,1530,17,275,158,296,292,454,2297,3718,9,34017,1889,1,1
167,3399,1943,715,1694,26,18,214,1969,12,185,120,237,197,357,1436,2721,7,20915,1161,0,1
167,3399,1168,838,957,57,25,144,1225,19,348,224,416,367,640,3018,5452,11,61921,3440,1,1
38,647,127,75,83,2,11,30,129,4,14,7,14,18,21,61,87,2,175,9,0,0
38,647,652,304,544,16,6,88,668,6,89,51,101,95,152,591,998,3,3399,188,0,0
38,647,2,2,2,0,0,0,2,0,0,0,0,0,0,0,0,0,0,0,0,0
38,647,8,5,5,0,0,3,8,0,0,0,0,0,0,0,0,0,0,0,0,0
38,647,14,8,8,0,0,6,14,0,0,0,0,0,0,0,0,0,0,0,0,0
38,647,6,4,4,0,0,2,6,0,0,0,0,0,0,0,0,0,0,0,0,0
38,647,6,4,4,0,0,2,6,1,2,1,2,3,3,2,4,0,2,0,0,0
38,647,7,5,5,0,0,2,7,0,0,0,0,0,0,0,0,0,0,0,0,0
38,647,10,6,6,0,0,4,10,0,0,0,0,0,0,0,0,0,0,0,0,0
38,647,1,1,1,0,0,0,1,0,0,0,0,0,0,0,0,0,0,0,0,0
38,647,14,10,10,0,0,4,14,1,1,1,1,2,2,0,2,0,1,0,0,0
38,647,46,26,30,3,0,12,49,3,6,3,6,9,9,20,28,1,42,2,0,0
46,790,127,75,83,2,11,30,129,4,14,7,14,18,21,61,87,2,175,9,0,0
46,790,652,304,544,16,6,88,668,6,89,51,101,95,152,591,998,3,3399,188,0,0
46,790,2,2,2,0,0,0,2,0,0,0,0,0,0,0,0,0,0,0,0,0
46,790,8,5,5,0,0,3,8,0,0,0,0,0,0,0,0,0,0,0,0,0
46,790,14,8,8,0,0,6,14,0,0,0,0,0,0,0,0,0,0,0,0,0
46,790,6,4,4,0,0,2,6,0,0,0,0,0,0,0,0,0,0,0,0,0
46,790,6,4,4,0,0,2,6,1,2,1,2,3,3,2,4,0,2,0,0,0
46,790,7,5,5,0,0,2,7,0,0,0,0,0,0,0,0,0,0,0,0,0
46,790,10,6,6,0,0,4,10,0,0,0,0,0,0,0,0,0,0,0,0,0
46,790,1,1,1,0,0,0,1,0,0,0,0,0,0,0,0,0,0,0,0,0
46,790,14,10,10,0,0,4,14,1,1,1,1,2,2,0,2,0,1,0,0,0
46,790,46,26,30,3,0,12,49,3,6,3,6,9,9,20,28,1,42,2,0,0
38,718,127,75,83,2,11,30,129,4,14,7,14,18,21,61,87,2,175,9,0,0
38,718,652,304,544,16,6,88,668,6,89,51,101,95,152,591,998,3,3399,188,0,0
38,718,2,2,2,0,0,0,2,0,0,0,0,0,0,0,0,0,0,0,0,0
38,718,8,5,5,0,0,3,8,0,0,0,0,0,0,0,0,0,0,0,0,0
38,718,14,8,8,0,0,6,14,0,0,0,0,0,0,0,0,0,0,0,0,0
38,718,6,4,4,0,0,2,6,0,0,0,0,0,0,0,0,0,0,0,0,0
38,718,6,4,4,0,0,2,6,1,2,1,2,3,3,2,4,0,2,0,0,0
38,718,7,5,5,0,0,2,7,0,0,0,0,0,0,0,0,0,0,0,0,0
38,718,10,6,6,0,0,4,10,0,0,0,0,0,0,0,0,0,0,0,0,0
38,718,1,1,1,0,0,0,1,0,0,0,0,0,0,0,0,0,0,0,0,0
38,718,14,10,10,0,0,4,14,1,1,1,1,2,2,0,2,0,1,0,0,0
38,718,46,26,30,3,0,12,49,3,6,3,6,9,9,20,28,1,42,2,0,0
38,712,127,75,83,2,11,30,129,4,14,7,14,18,21,61,87,2,175,9,0,0
38,712,652,304,544,16,6,88,668,6,89,51,101,95,152,591,998,3,3399,188,0,0
38,712,2,2,2,0,0,0,2,0,0,0,0,0,0,0,0,0,0,0,0,0
38,712,8,5,5,0,0,3,8,0,0,0,0,0,0,0,0,0,0,0,0,0
38,712,14,8,8,0,0,6,14,0,0,0,0,0,0,0,0,0,0,0,0,0
38,712,6,4,4,0,0,2,6,0,0,0,0,0,0,0,0,0,0,0,0,0
38,712,6,4,4,0,0,2,6,1,2,1,2,3,3,2,4,0,2,0,0,0
38,712,7,5,5,0,0,2,7,0,0,0,0,0,0,0,0,0,0,0,0,0
38,712,10,6,6,0,0,4,10,0,0,0,0,0,0,0,0,0,0,0,0,0
38,712,1,1,1,0,0,0,1,0,0,0,0,0,0,0,0,0,0,0,0,0
38,712,14,10,10,0,0,4,14,1,1,1,1,2,2,0,2,0,1,0,0,0
38,712,46,26,30,3,0,12,49,3,6,3,6,9,9,20,28,1,42,2,0,0
109,4155,1513,682,1277,25,13,200,1538,11,199,116,219,210,335,1557,2584,6,15641,868,0,0
114,2252,1513,682,1277,25,13,200,1538,11,199,116,219,210,335,1557,2584,6,15641,868,0,1
114,2252,819,519,539,24,98,155,843,15,96,57,106,111,163,690,1107,8,9171,509,0,1
224,4615,1457,730,1242,11,6,188,1468,10,292,166,329,302,495,2424,4078,5,22973,1276,1,1
224,4615,74,35,59,1,0,14,75,3,14,7,14,17,21,58,85,1,128,7,0,1
224,4615,245,125,200,5,7,34,250,7,30,17,34,37,51,166,265,3,1053,58,0,1
41,2012,1457,730,1242,11,6,188,1468,10,292,166,329,302,495,2424,4078,5,22973,1276,1,1
32,1557,652,304,544,16,6,88,668,6,89,51,101,95,152,591,998,3,3399,188,0,1
108,4151,1513,682,1277,25,13,200,1538,11,199,116,219,210,335,1557,2584,6,15641,868,0,0
13,444,42,7,35,4,0,5,46,1,2,1,2,3,3,2,4,0,2,0,0,0
13,444,11,6,10,0,0,1,11,2,4,2,4,6,6,10,15,1,15,0,0,0
77,1712,477,336,357,30,23,73,507,16,194,134,250,210,384,1538,2962,10,30538,1696,0,0
171,3868,77,34,69,0,0,8,77,3,24,16,29,27,45,114,213,1,387,21,0,0
171,3868,712,438,573,51,9,84,763,14,102,71,128,116,199,733,1364,8,11988,666,0,0
439,9792,72,33,56,0,4,12,72,1,1,1,1,2,2,0,2,0,1,0,0,0
439,9792,1454,835,1044,76,110,219,1530,17,275,158,296,292,454,2297,3718,9,34017,1889,1,0
108,4149,1513,682,1277,25,13,200,1538,11,199,116,219,210,335,1557,2584,6,15641,868,0,0
32,641,2,2,2,0,0,0,2,0,0,0,0,0,0,0,0,0,0,0,0,1
32,641,99,48,90,1,3,5,100,0,0,0,0,0,0,0,0,0,0,0,0,1
32,641,8,5,5,2,0,1,10,0,0,0,0,0,0,0,0,0,0,0,0,1
32,641,1217,716,841,84,126,174,1301,14,185,118,215,199,333,1446,2542,8,20687,1149,0,1
32,641,160,89,115,0,13,31,160,7,15,11,17,22,28,78,124,3,495,27,0,1
32,641,10,10,9,9,0,0,19,0,0,0,0,0,0,0,0,0,0,0,0,1
32,641,173,84,99,8,29,36,181,5,12,7,13,17,20,54,81,2,221,12,0,1
32,641,3,1,1,3,0,0,6,0,0,0,0,0,0,0,0,0,0,0,0,1
33,659,2,2,2,0,0,0,2,0,0,0,0,0,0,0,0,0,0,0,0,1
33,659,99,48,90,1,3,5,100,0,0,0,0,0,0,0,0,0,0,0,0,1
33,659,8,5,5,2,0,1,10,0,0,0,0,0,0,0,0,0,0,0,0,1
33,659,1217,716,841,84,126,174,1301,14,185,118,215,199,333,1446,2542,8,20687,1149,0,1
33,659,160,89,115,0,13,31,160,7,15,11,17,22,28,78,124,3,495,27,0,1
33,659,10,10,9,9,0,0,19,0,0,0,0,0,0,0,0,0,0,0,0,1
33,659,173,84,99,8,29,36,181,5,12,7,13,17,20,54,81,2,221,12,0,1
33,659,3,1,1,3,0,0,6,0,0,0,0,0,0,0,0,0,0,0,0,1
55,1940,1450,624,1228,12,26,181,1462,14,306,186,354,320,540,2580,4493,8,36391,2021,1,1
108,4145,1513,682,1277,25,13,200,1538,11,199,116,219,210,335,1557,2584,6,15641,868,0,0
109,4172,1513,682,1277,25,13,200,1538,11,199,116,219,210,335,1557,2584,6,15641,868,0,1
231,4784,1457,730,1242,11,6,188,1468,10,292,166,329,302,495,2424,4078,5,22973,1276,1,1
231,4784,74,35,59,1,0,14,75,3,14,7,14,17,21,58,85,1,128,7,0,1
231,4784,245,125,200,5,7,34,250,7,30,17,34,37,51,166,265,3,1053,58,0,1
42,1077,74,35,59,1,0,14,75,3,14,7,14,17,21,58,85,1,128,7,0,1
42,1077,245,125,200,5,7,34,250,7,30,17,34,37,51,166,265,3,1053,58,0,1
65,2681,1289,550,1043,56,32,155,1345,10,167,93,185,177,278,1266,2075,5,11498,638,0,1
218,4490,1457,730,1242,11,6,188,1468,10,292,166,329,302,495,2424,4078,5,22973,1276,1,1
218,4490,74,35,59,1,0,14,75,3,14,7,14,17,21,58,85,1,128,7,0,1
218,4490,245,125,200,5,7,34,250,7,30,17,34,37,51,166,265,3,1053,58,0,1
171,3865,77,34,69,0,0,8,77,3,24,16,29,27,45,114,213,1,387,21,0,1
171,3865,712,438,573,51,9,84,763,14,102,71,128,116,199,733,1364,8,11988,666,0,1
38,1794,1457,730,1242,11,6,188,1468,10,292,166,329,302,495,2424,4078,5,22973,1276,1,1
26,1455,652,304,544,16,6,88,668,6,89,51,101,95,152,591,998,3,3399,188,0,1
231,4784,1457,730,1242,11,6,188,1468,10,292,166,329,302,495,2424,4078,5,22973,1276,1,0
231,4784,74,35,59,1,0,14,75,3,14,7,14,17,21,58,85,1,128,7,0,0
231,4784,245,125,200,5,7,34,250,7,30,17,34,37,51,166,265,3,1053,58,0,0
42,1077,74,35,59,1,0,14,75,3,14,7,14,17,21,58,85,1,128,7,0,0
42,1077,245,125,200,5,7,34,250,7,30,17,34,37,51,166,265,3,1053,58,0,0
65,2681,1289,550,1043,56,32,155,1345,10,167,93,185,177,278,1266,2075,5,11498,638,0,0
225,4659,1457,730,1242,11,6,188,1468,10,292,166,329,302,495,2424,4078,5,22973,1276,1,0
225,4659,74,35,59,1,0,14,75,3,14,7,14,17,21,58,85,1,128,7,0,0
225,4659,245,125,200,5,7,34,250,7,30,17,34,37,51,166,265,3,1053,58,0,0
38,1794,1457,730,1242,11,6,188,1468,10,292,166,329,302,495,2424,4078,5,22973,1276,1,0
26,1455,652,304,544,16,6,88,668,6,89,51,101,95,152,591,998,3,3399,188,0,0
198,4464,722,423,573,19,0,135,741,12,172,101,199,184,300,1320,2257,6,15668,870,0,0
198,4464,1508,847,911,44,250,301,1552,14,148,88,169,162,257,1120,1886,7,15077,837,0,0
114,2252,1513,682,1277,25,13,200,1538,11,199,116,219,210,335,1557,2584,6,15641,868,0,0
114,2252,819,519,539,24,98,155,843,15,96,57,106,111,163,690,1107,8,9171,509,0,0
440,9798,72,33,56,0,4,12,72,1,1,1,1,2,2,0,2,0,1,0,0,1
440,9798,1454,835,1044,76,110,219,1530,17,275,158,296,292,454,2297,3718,9,34017,1889,1,1
125,5370,139,89,101,2,0,35,141,7,54,34,62,61,96,330,569,4,2287,127,0,1
125,5370,7,5,5,0,0,2,7,1,2,1,2,3,3,2,4,0,2,0,0,1
440,9798,72,33,56,0,4,12,72,1,1,1,1,2,2,0,2,0,1,0,0,0
440,9798,1454,835,1044,76,110,219,1530,17,275,158,296,292,454,2297,3718,9,34017,1889,1,0
125,5370,139,89,101,2,0,35,141,7,54,34,62,61,96,330,569,4,2287,127,0,0
125,5370,7,5,5,0,0,2,7,1,2,1,2,3,3,2,4,0,2,0,0,0
440,9808,72,33,56,0,4,12,72,1,1,1,1,2,2,0,2,0,1,0,0,1
440,9808,1454,835,1044,76,110,219,1530,17,275,158,296,292,454,2297,3718,9,34017,1889,1,1
25,624,465,148,393,5,8,60,470,4,31,20,31,35,51,161,261,2,523,29,0,1
25,624,16,12,9,0,0,6,16,1,2,1,2,3,3,2,4,0,2,0,0,1
440,9808,72,33,56,0,4,12,72,1,1,1,1,2,2,0,2,0,1,0,0,0
440,9808,1454,835,1044,76,110,219,1530,17,275,158,296,292,454,2297,3718,9,34017,1889,1,0
25,624,465,148,393,5,8,60,470,4,31,20,31,35,51,161,261,2,523,29,0,0
25,624,16,12,9,0,0,6,16,1,2,1,2,3,3,2,4,0,2,0,0,0
441,9824,72,33,56,0,4,12,72,1,1,1,1,2,2,0,2,0,1,0,0,1
441,9824,1454,835,1044,76,110,219,1530,17,275,158,296,292,454,2297,3718,9,34017,1889,1,1
55,1039,1098,241,925,5,10,155,1103,7,46,25,49,53,74,273,423,3,1580,87,0,1
55,1039,282,202,222,14,2,44,296,8,42,24,43,50,67,250,378,4,1548,86,0,1
28,753,465,148,393,5,8,60,470,4,31,20,31,35,51,161,261,2,523,29,0,1
28,753,16,12,9,0,0,6,16,1,2,1,2,3,3,2,4,0,2,0,0,1
28,753,465,148,393,5,8,60,470,4,31,20,31,35,51,161,261,2,523,29,0,0
28,753,16,12,9,0,0,6,16,1,2,1,2,3,3,2,4,0,2,0,0,0
442,9834,72,33,56,0,4,12,72,1,1,1,1,2,2,0,2,0,1,0,0,1
442,9834,1454,835,1044,76,110,219,1530,17,275,158,296,292,454,2297,3718,9,34017,1889,1,1
28,774,465,148,393,5,8,60,470,4,31,20,31,35,51,161,261,2,523,29,0,1
28,774,16,12,9,0,0,6,16,1,2,1,2,3,3,2,4,0,2,0,0,1
442,9834,72,33,56,0,4,12,72,1,1,1,1,2,2,0,2,0,1,0,0,0
442,9834,1454,835,1044,76,110,219,1530,17,275,158,296,292,454,2297,3718,9,34017,1889,1,0
55,1039,1098,241,925,5,10,155,1103,7,46,25,49,53,74,273,423,3,1580,87,0,0
55,1039,282,202,222,14,2,44,296,8,42,24,43,50,67,250,378,4,1548,86,0,0
28,774,465,148,393,5,8,60,470,4,31,20,31,35,51,161,261,2,523,29,0,0
28,774,16,12,9,0,0,6,16,1,2,1,2,3,3,2,4,0,2,0,0,0
86,1521,1178,367,1042,6,15,115,1184,9,94,51,95,103,146,644,976,4,4439,246,0,0
86,1521,177,108,140,8,0,27,185,6,30,16,32,36,48,162,248,3,794,44,0,0
226,4706,1457,730,1242,11,6,188,1468,10,292,166,329,302,495,2424,4078,5,22973,1276,1,1
226,4706,74,35,59,1,0,14,75,3,14,7,14,17,21,58,85,1,128,7,0,1
226,4706,245,125,200,5,7,34,250,7,30,17,34,37,51,166,265,3,1053,58,0,1
167,3428,1943,715,1694,26,18,214,1969,12,185,120,237,197,357,1436,2721,7,20915,1161,0,1
167,3428,1168,838,957,57,25,144,1225,19,348,224,416,367,640,3018,5452,11,61921,3440,1,1
38,2226,334,251,279,10,4,40,344,5,127,74,143,132,217,899,1528,2,4303,239,0,1
446,9892,72,33,56,0,4,12,72,1,1,1,1,2,2,0,2,0,1,0,0,1
446,9892,1454,835,1044,76,110,219,1530,17,275,158,296,292,454,2297,3718,9,34017,1889,1,1
11,239,256,139,192,9,7,47,265,4,23,12,24,27,36,112,171,2,357,19,0,1
226,4706,1457,730,1242,11,6,188,1468,10,292,166,329,302,495,2424,4078,5,22973,1276,1,0
226,4706,74,35,59,1,0,14,75,3,14,7,14,17,21,58,85,1,128,7,0,0
226,4706,245,125,200,5,7,34,250,7,30,17,34,37,51,166,265,3,1053,58,0,0
167,3428,1943,715,1694,26,18,214,1969,12,185,120,237,197,357,1436,2721,7,20915,1161,0,0
167,3428,1168,838,957,57,25,144,1225,19,348,224,416,367,640,3018,5452,11,61921,3440,1,0
38,2226,334,251,279,10,4,40,344,5,127,74,143,132,217,899,1528,2,4303,239,0,0
448,9938,72,33,56,0,4,12,72,1,1,1,1,2,2,0,2,0,1,0,0,1
448,9938,1454,835,1044,76,110,219,1530,17,275,158,296,292,454,2297,3718,9,34017,1889,1,1
126,5403,139,89,101,2,0,35,141,7,54,34,62,61,96,330,569,4,2287,127,0,1
126,5403,7,5,5,0,0,2,7,1,2,1,2,3,3,2,4,0,2,0,0,1
454,9994,72,33,56,0,4,12,72,1,1,1,1,2,2,0,2,0,1,0,0,1
454,9994,1454,835,1044,76,110,219,1530,17,275,158,296,292,454,2297,3718,9,34017,1889,1,1
65,3525,1782,648,1425,9,47,279,1791,8,171,97,189,179,286,1292,2140,4,9462,525,0,1
43,1323,1523,757,1297,19,12,193,1542,12,193,117,230,205,347,1508,2664,7,19053,1058,0,0
43,1323,701,378,504,33,58,109,734,13,110,68,126,123,194,794,1346,7,10027,557,0,0
43,1318,1523,757,1297,19,12,193,1542,12,193,117,230,205,347,1508,2664,7,19053,1058,0,0
43,1318,701,378,504,33,58,109,734,13,110,68,126,123,194,794,1346,7,10027,557,0,0
39,2430,1523,757,1297,19,12,193,1542,12,193,117,230,205,347,1508,2664,7,19053,1058,0,1
15,465,42,7,35,4,0,5,46,1,2,1,2,3,3,2,4,0,2,0,0,0
15,465,11,6,10,0,0,1,11,2,4,2,4,6,6,10,15,1,15,0,0,0
43,863,447,308,343,6,5,95,453,7,96,59,111,103,170,651,1136,4,4600,255,0,1
43,863,322,174,179,16,74,51,338,10,41,26,46,51,72,252,408,5,2291,127,0,1
14,452,42,7,35,4,0,5,46,1,2,1,2,3,3,2,4,0,2,0,0,1
14,452,11,6,10,0,0,1,11,2,4,2,4,6,6,10,15,1,15,0,0,1
14,452,42,7,35,4,0,5,46,1,2,1,2,3,3,2,4,0,2,0,0,0
14,452,11,6,10,0,0,1,11,2,4,2,4,6,6,10,15,1,15,0,0,0
114,2482,1043,504,840,53,9,147,1096,9,180,112,198,189,310,1377,2344,4,11604,644,0,1
114,2482,383,288,292,26,6,62,409,11,65,38,67,76,105,429,656,5,3719,206,0,1
114,2482,1043,504,840,53,9,147,1096,9,180,112,198,189,310,1377,2344,4,11604,644,0,0
114,2482,383,288,292,26,6,62,409,11,65,38,67,76,105,429,656,5,3719,206,0,0
229,4732,1457,730,1242,11,6,188,1468,10,292,166,329,302,495,2424,4078,5,22973,1276,1,1
229,4732,74,35,59,1,0,14,75,3,14,7,14,17,21,58,85,1,128,7,0,1
229,4732,245,125,200,5,7,34,250,7,30,17,34,37,51,166,265,3,1053,58,0,1
39,1827,1457,730,1242,11,6,188,1468,10,292,166,329,302,495,2424,4078,5,22973,1276,1,1
55,1940,1450,624,1228,12,26,181,1462,14,306,186,354,320,540,2580,4493,8,36391,2021,1,0
1,282,382,65,130,157,2,92,539,4,10,5,10,14,15,41,57,2,114,6,0,0
1,285,382,65,130,157,2,92,539,4,10,5,10,14,15,41,57,2,114,6,0,0
127,5436,139,89,101,2,0,35,141,7,54,34,62,61,96,330,569,4,2287,127,0,1
127,5436,7,5,5,0,0,2,7,1,2,1,2,3,3,2,4,0,2,0,0,1
55,1934,1450,624,1228,12,26,181,1462,14,306,186,354,320,540,2580,4493,8,36391,2021,1,0
39,1833,1457,730,1242,11,6,188,1468,10,292,166,329,302,495,2424,4078,5,22973,1276,1,0
234,4805,1457,730,1242,11,6,188,1468,10,292,166,329,302,495,2424,4078,5,22973,1276,1,1
234,4805,74,35,59,1,0,14,75,3,14,7,14,17,21,58,85,1,128,7,0,1
234,4805,245,125,200,5,7,34,250,7,30,17,34,37,51,166,265,3,1053,58,0,1
171,3890,77,34,69,0,0,8,77,3,24,16,29,27,45,114,213,1,387,21,0,1
171,3890,712,438,573,51,9,84,763,14,102,71,128,116,199,733,1364,8,11988,666,0,1
40,1882,1457,730,1242,11,6,188,1468,10,292,166,329,302,495,2424,4078,5,22973,1276,1,1
171,3890,77,34,69,0,0,8,77,3,24,16,29,27,45,114,213,1,387,21,0,0
171,3890,712,438,573,51,9,84,763,14,102,71,128,116,199,733,1364,8,11988,666,0,0
40,1882,1457,730,1242,11,6,188,1468,10,292,166,329,302,495,2424,4078,5,22973,1276,1,0
172,3908,77,34,69,0,0,8,77,3,24,16,29,27,45,114,213,1,387,21,0,1
172,3908,712,438,573,51,9,84,763,14,102,71,128,116,199,733,1364,8,11988,666,0,1
450,9943,72,33,56,0,4,12,72,1,1,1,1,2,2,0,2,0,1,0,0,1
450,9943,1454,835,1044,76,110,219,1530,17,275,158,296,292,454,2297,3718,9,34017,1889,1,1
167,3430,1943,715,1694,26,18,214,1969,12,185,120,237,197,357,1436,2721,7,20915,1161,0,1
167,3430,1168,838,957,57,25,144,1225,19,348,224,416,367,640,3018,5452,11,61921,3440,1,1
55,1982,1450,624,1228,12,26,181,1462,14,306,186,354,320,540,2580,4493,8,36391,2021,1,1
171,3870,77,34,69,0,0,8,77,3,24,16,29,27,45,114,213,1,387,21,0,1
171,3870,712,438,573,51,9,84,763,14,102,71,128,116,199,733,1364,8,11988,666,0,1
172,3910,77,34,69,0,0,8,77,3,24,16,29,27,45,114,213,1,387,21,0,0
172,3910,712,438,573,51,9,84,763,14,102,71,128,116,199,733,1364,8,11988,666,0,0
23,1010,1455,414,1257,16,76,112,1471,5,41,23,46,46,69,231,381,2,1069,59,0,0
39,2430,1523,757,1297,19,12,193,1542,12,193,117,230,205,347,1508,2664,7,19053,1058,0,0
1,285,382,65,130,157,2,92,539,4,10,5,10,14,15,41,57,2,114,6,0,1
128,5483,139,89,101,2,0,35,141,7,54,34,62,61,96,330,569,4,2287,127,0,0
128,5483,7,5,5,0,0,2,7,1,2,1,2,3,3,2,4,0,2,0,0,0
452,9989,72,33,56,0,4,12,72,1,1,1,1,2,2,0,2,0,1,0,0,0
452,9989,1454,835,1044,76,110,219,1530,17,275,158,296,292,454,2297,3718,9,34017,1889,1,0
167,3430,1943,715,1694,26,18,214,1969,12,185,120,237,197,357,1436,2721,7,20915,1161,0,0
167,3430,1168,838,957,57,25,144,1225,19,348,224,416,367,640,3018,5452,11,61921,3440,1,0
55,1982,1450,624,1228,12,26,181,1462,14,306,186,354,320,540,2580,4493,8,36391,2021,1,0
90,1584,1178,367,1042,6,15,115,1184,9,94,51,95,103,146,644,976,4,4439,246,0,1
90,1584,177,108,140,8,0,27,185,6,30,16,32,36,48,162,248,3,794,44,0,1
47,2038,1178,367,1042,6,15,115,1184,9,94,51,95,103,146,644,976,4,4439,246,0,1
29,809,465,148,393,5,8,60,470,4,31,20,31,35,51,161,261,2,523,29,0,0
29,809,16,12,9,0,0,6,16,1,2,1,2,3,3,2,4,0,2,0,0,0
89,1573,1178,367,1042,6,15,115,1184,9,94,51,95,103,146,644,976,4,4439,246,0,1
89,1573,177,108,140,8,0,27,185,6,30,16,32,36,48,162,248,3,794,44,0,1
44,1992,1178,367,1042,6,15,115,1184,9,94,51,95,103,146,644,976,4,4439,246,0,1
7,103,38,23,23,0,0,15,38,0,0,0,0,0,0,0,0,0,0,0,0,0
44,1989,1178,367,1042,6,15,115,1184,9,94,51,95,103,146,644,976,4,4439,246,0,0
7,102,38,23,23,0,0,15,38,0,0,0,0,0,0,0,0,0,0,0,0,0
454,10020,72,33,56,0,4,12,72,1,1,1,1,2,2,0,2,0,1,0,0,1
454,10020,1454,835,1044,76,110,219,1530,17,275,158,296,292,454,2297,3718,9,34017,1889,1,1
89,1573,1178,367,1042,6,15,115,1184,9,94,51,95,103,146,644,976,4,4439,246,0,0
89,1573,177,108,140,8,0,27,185,6,30,16,32,36,48,162,248,3,794,44,0,0
454,10020,72,33,56,0,4,12,72,1,1,1,1,2,2,0,2,0,1,0,0,0
454,10020,1454,835,1044,76,110,219,1530,17,275,158,296,292,454,2297,3718,9,34017,1889,1,0
454,10012,72,33,56,0,4,12,72,1,1,1,1,2,2,0,2,0,1,0,0,1
454,10012,1454,835,1044,76,110,219,1530,17,275,158,296,292,454,2297,3718,9,34017,1889,1,1
232,4811,1457,730,1242,11,6,188,1468,10,292,166,329,302,495,2424,4078,5,22973,1276,1,1
232,4811,74,35,59,1,0,14,75,3,14,7,14,17,21,58,85,1,128,7,0,1
232,4811,245,125,200,5,7,34,250,7,30,17,34,37,51,166,265,3,1053,58,0,1
27,1535,652,304,544,16,6,88,668,6,89,51,101,95,152,591,998,3,3399,188,0,1
234,4833,1457,730,1242,11,6,188,1468,10,292,166,329,302,495,2424,4078,5,22973,1276,1,1
234,4833,74,35,59,1,0,14,75,3,14,7,14,17,21,58,85,1,128,7,0,1
234,4833,245,125,200,5,7,34,250,7,30,17,34,37,51,166,265,3,1053,58,0,1
38,2236,334,251,279,10,4,40,344,5,127,74,143,132,217,899,1528,2,4303,239,0,1
113,2244,1513,682,1277,25,13,200,1538,11,199,116,219,210,335,1557,2584,6,15641,868,0,0
113,2244,819,519,539,24,98,155,843,15,96,57,106,111,163,690,1107,8,9171,509,0,0
108,4168,1513,682,1277,25,13,200,1538,11,199,116,219,210,335,1557,2584,6,15641,868,0,0
233,4817,1457,730,1242,11,6,188,1468,10,292,166,329,302,495,2424,4078,5,22973,1276,1,0
233,4817,74,35,59,1,0,14,75,3,14,7,14,17,21,58,85,1,128,7,0,0
233,4817,245,125,200,5,7,34,250,7,30,17,34,37,51,166,265,3,1053,58,0,0
38,2236,334,251,279,10,4,40,344,5,127,74,143,132,217,899,1528,2,4303,239,0,0
27,1535,652,304,544,16,6,88,668,6,89,51,101,95,152,591,998,3,3399,188,0,0
2,26,6,4,4,0,0,2,6,1,4,2,4,5,6,8,13,0,6,0,0,1
77,1700,477,336,357,30,23,73,507,16,194,134,250,210,384,1538,2962,10,30538,1696,0,1
233,4771,1457,730,1242,11,6,188,1468,10,292,166,329,302,495,2424,4078,5,22973,1276,1,1
233,4771,74,35,59,1,0,14,75,3,14,7,14,17,21,58,85,1,128,7,0,1
233,4771,245,125,200,5,7,34,250,7,30,17,34,37,51,166,265,3,1053,58,0,1
26,866,1455,414,1257,16,76,112,1471,5,41,23,46,46,69,231,381,2,1069,59,0,1
26,866,669,365,481,22,61,110,691,15,103,63,122,118,185,747,1273,8,11311,628,0,1
43,1312,1523,757,1297,19,12,193,1542,12,193,117,230,205,347,1508,2664,7,19053,1058,0,1
43,1312,701,378,504,33,58,109,734,13,110,68,126,123,194,794,1346,7,10027,557,0,1
172,3904,77,34,69,0,0,8,77,3,24,16,29,27,45,114,213,1,387,21,0,1
172,3904,712,438,573,51,9,84,763,14,102,71,128,116,199,733,1364,8,11988,666,0,1
21,545,1293,570,1093,25,15,163,1318,10,195,123,241,205,364,1516,2795,6,17273,959,0,1
198,4430,722,423,573,19,0,135,741,12,172,101,199,184,300,1320,2257,6,15668,870,0,1
198,4430,1508,847,911,44,250,301,1552,14,148,88,169,162,257,1120,1886,7,15077,837,0,1
18,440,386,256,301,16,9,68,402,4,59,35,69,63,104,355,621,2,1453,80,0,1
18,440,264,131,164,11,41,46,275,6,38,22,40,44,62,214,338,3,1068,59,0,1
114,2480,1043,504,840,53,9,147,1096,9,180,112,198,189,310,1377,2344,4,11604,644,0,1
114,2480,383,288,292,26,6,62,409,11,65,38,67,76,105,429,656,5,3719,206,0,1
89,1565,1178,367,1042,6,15,115,1184,9,94,51,95,103,146,644,976,4,4439,246,0,1
89,1565,177,108,140,8,0,27,185,6,30,16,32,36,48,162,248,3,794,44,0,1
167,3416,1943,715,1694,26,18,214,1969,12,185,120,237,197,357,1436,2721,7,20915,1161,0,1
167,3416,1168,838,957,57,25,144,1225,19,348,224,416,367,640,3018,5452,11,61921,3440,1,1
12,371,442,244,305,14,16,103,456,11,68,45,75,79,120,452,756,6,4588,254,0,1
12,371,182,102,99,11,40,35,193,3,11,6,11,14,17,42,64,1,97,5,0,1
231,4764,1457,730,1242,11,6,188,1468,10,292,166,329,302,495,2424,4078,5,22973,1276,1,1
231,4764,74,35,59,1,0,14,75,3,14,7,14,17,21,58,85,1,128,7,0,1
231,4764,245,125,200,5,7,34,250,7,30,17,34,37,51,166,265,3,1053,58,0,1
166,3413,1943,715,1694,26,18,214,1969,12,185,120,237,197,357,1436,2721,7,20915,1161,0,1
166,3413,1168,838,957,57,25,144,1225,19,348,224,416,367,640,3018,5452,11,61921,3440,1,1
128,5483,139,89,101,2,0,35,141,7,54,34,62,61,96,330,569,4,2287,127,0,1
128,5483,7,5,5,0,0,2,7,1,2,1,2,3,3,2,4,0,2,0,0,1
42,1271,1523,757,1297,19,12,193,1542,12,193,117,230,205,347,1508,2664,7,19053,1058,0,1
42,1271,701,378,504,33,58,109,734,13,110,68,126,123,194,794,1346,7,10027,557,0,1
52,1014,1098,241,925,5,10,155,1103,7,46,25,49,53,74,273,423,3,1580,87,0,1
52,1014,282,202,222,14,2,44,296,8,42,24,43,50,67,250,378,4,1548,86,0,1
77,1700,477,336,357,30,23,73,507,16,194,134,250,210,384,1538,2962,10,30538,1696,0,0
231,4718,1457,730,1242,11,6,188,1468,10,292,166,329,302,495,2424,4078,5,22973,1276,1,0
231,4718,74,35,59,1,0,14,75,3,14,7,14,17,21,58,85,1,128,7,0,0
231,4718,245,125,200,5,7,34,250,7,30,17,34,37,51,166,265,3,1053,58,0,0
26,866,1455,414,1257,16,76,112,1471,5,41,23,46,46,69,231,381,2,1069,59,0,0
26,866,669,365,481,22,61,110,691,15,103,63,122,118,185,747,1273,8,11311,628,0,0
42,1271,1523,757,1297,19,12,193,1542,12,193,117,230,205,347,1508,2664,7,19053,1058,0,0
42,1271,701,378,504,33,58,109,734,13,110,68,126,123,194,794,1346,7,10027,557,0,0
172,3904,77,34,69,0,0,8,77,3,24,16,29,27,45,114,213,1,387,21,0,0
172,3904,712,438,573,51,9,84,763,14,102,71,128,116,199,733,1364,8,11988,666,0,0
21,545,1293,570,1093,25,15,163,1318,10,195,123,241,205,364,1516,2795,6,17273,959,0,0
198,4430,722,423,573,19,0,135,741,12,172,101,199,184,300,1320,2257,6,15668,870,0,0
198,4430,1508,847,911,44,250,301,1552,14,148,88,169,162,257,1120,1886,7,15077,837,0,0
18,440,386,256,301,16,9,68,402,4,59,35,69,63,104,355,621,2,1453,80,0,0
18,440,264,131,164,11,41,46,275,6,38,22,40,44,62,214,338,3,1068,59,0,0
114,2480,1043,504,840,53,9,147,1096,9,180,112,198,189,310,1377,2344,4,11604,644,0,0
114,2480,383,288,292,26,6,62,409,11,65,38,67,76,105,429,656,5,3719,206,0,0
89,1565,1178,367,1042,6,15,115,1184,9,94,51,95,103,146,644,976,4,4439,246,0,0
89,1565,177,108,140,8,0,27,185,6,30,16,32,36,48,162,248,3,794,44,0,0
166,3399,1943,715,1694,26,18,214,1969,12,185,120,237,197,357,1436,2721,7,20915,1161,0,0
166,3399,1168,838,957,57,25,144,1225,19,348,224,416,367,640,3018,5452,11,61921,3440,1,0
12,371,442,244,305,14,16,103,456,11,68,45,75,79,120,452,756,6,4588,254,0,0
12,371,182,102,99,11,40,35,193,3,11,6,11,14,17,42,64,1,97,5,0,0
52,1014,1098,241,925,5,10,155,1103,7,46,25,49,53,74,273,423,3,1580,87,0,0
52,1014,282,202,222,14,2,44,296,8,42,24,43,50,67,250,378,4,1548,86,0,0
132,4072,1660,832,1314,41,38,274,1701,20,312,209,395,332,604,2671,5058,12,64042,3557,1,1
132,4072,1057,646,719,113,100,145,1170,18,215,134,248,233,382,1740,3004,10,31186,1732,1,1
118,3030,1660,832,1314,41,38,274,1701,20,312,209,395,332,604,2671,5058,12,64042,3557,1,1
133,4121,1660,832,1314,41,38,274,1701,20,312,209,395,332,604,2671,5058,12,64042,3557,1,0
133,4121,1057,646,719,113,100,145,1170,18,215,134,248,233,382,1740,3004,10,31186,1732,1,0
131,4107,1660,832,1314,41,38,274,1701,20,312,209,395,332,604,2671,5058,12,64042,3557,1,0
131,4107,1057,646,719,113,100,145,1170,18,215,134,248,233,382,1740,3004,10,31186,1732,1,0
118,3030,1660,832,1314,41,38,274,1701,20,312,209,395,332,604,2671,5058,12,64042,3557,1,0
113,2247,1513,682,1277,25,13,200,1538,11,199,116,219,210,335,1557,2584,6,15641,868,0,0
113,2247,819,519,539,24,98,155,843,15,96,57,106,111,163,690,1107,8,9171,509,0,0
109,4195,1513,682,1277,25,13,200,1538,11,199,116,219,210,335,1557,2584,6,15641,868,0,0
114,2261,1513,682,1277,25,13,200,1538,11,199,116,219,210,335,1557,2584,6,15641,868,0,1
114,2261,819,519,539,24,98,155,843,15,96,57,106,111,163,690,1107,8,9171,509,0,1
7,103,38,23,23,0,0,15,38,0,0,0,0,0,0,0,0,0,0,0,0,1
1,288,382,65,130,157,2,92,539,4,10,5,10,14,15,41,57,2,114,6,0,0
114,2255,1513,682,1277,25,13,200,1538,11,199,116,219,210,335,1557,2584,6,15641,868,0,0
114,2255,819,519,539,24,98,155,843,15,96,57,106,111,163,690,1107,8,9171,509,0,0
114,2264,1513,682,1277,25,13,200,1538,11,199,116,219,210,335,1557,2584,6,15641,868,0,0
114,2264,819,519,539,24,98,155,843,15,96,57,106,111,163,690,1107,8,9171,509,0,0
173,3920,77,34,69,0,0,8,77,3,24,16,29,27,45,114,213,1,387,21,0,0
173,3920,712,438,573,51,9,84,763,14,102,71,128,116,199,733,1364,8,11988,666,0,0
37,2191,334,251,279,10,4,40,344,5,127,74,143,132,217,899,1528,2,4303,239,0,0
50,2018,1043,504,840,53,9,147,1096,9,180,112,198,189,310,1377,2344,4,11604,644,0,1
133,4157,1660,832,1314,41,38,274,1701,20,312,209,395,332,604,2671,5058,12,64042,3557,1,1
133,4157,1057,646,719,113,100,145,1170,18,215,134,248,233,382,1740,3004,10,31186,1732,1,1
121,3087,1660,832,1314,41,38,274,1701,20,312,209,395,332,604,2671,5058,12,64042,3557,1,1
110,4226,1513,682,1277,25,13,200,1538,11,199,116,219,210,335,1557,2584,6,15641,868,0,1
133,4158,1660,832,1314,41,38,274,1701,20,312,209,395,332,604,2671,5058,12,64042,3557,1,0
133,4158,1057,646,719,113,100,145,1170,18,215,134,248,233,382,1740,3004,10,31186,1732,1,0
136,4252,1660,832,1314,41,38,274,1701,20,312,209,395,332,604,2671,5058,12,64042,3557,1,1
136,4252,1057,646,719,113,100,145,1170,18,215,134,248,233,382,1740,3004,10,31186,1732,1,1
77,1717,477,336,357,30,23,73,507,16,194,134,250,210,384,1538,2962,10,30538,1696,0,1
60,1070,282,196,195,3,0,86,285,8,130,71,141,138,212,936,1507,4,6538,363,0,1
63,2320,1450,624,1228,12,26,181,1462,14,306,186,354,320,540,2580,4493,8,36391,2021,1,1
122,3201,1660,832,1314,41,38,274,1701,20,312,209,395,332,604,2671,5058,12,64042,3557,1,1
1,84,13,10,10,0,0,3,13,1,2,1,2,3,3,2,4,0,2,0,0,0
121,3087,1660,832,1314,41,38,274,1701,20,312,209,395,332,604,2671,5058,12,64042,3557,1,0
50,2028,1043,504,840,53,9,147,1096,9,180,112,198,189,310,1377,2344,4,11604,644,0,0
133,4206,1660,832,1314,41,38,274,1701,20,312,209,395,332,604,2671,5058,12,64042,3557,1,1
133,4206,1057,646,719,113,100,145,1170,18,215,134,248,233,382,1740,3004,10,31186,1732,1,1
121,3095,1660,832,1314,41,38,274,1701,20,312,209,395,332,604,2671,5058,12,64042,3557,1,1
133,4194,1660,832,1314,41,38,274,1701,20,312,209,395,332,604,2671,5058,12,64042,3557,1,0
133,4194,1057,646,719,113,100,145,1170,18,215,134,248,233,382,1740,3004,10,31186,1732,1,0
2,26,6,4,4,0,0,2,6,1,4,2,4,5,6,8,13,0,6,0,0,0
7,292,72,33,56,0,4,12,72,1,1,1,1,2,2,0,2,0,1,0,0,1
38,707,127,75,83,2,11,30,129,4,14,7,14,18,21,61,87,2,175,9,0,1
38,707,652,304,544,16,6,88,668,6,89,51,101,95,152,591,998,3,3399,188,0,1
38,707,2,2,2,0,0,0,2,0,0,0,0,0,0,0,0,0,0,0,0,1
38,707,8,5,5,0,0,3,8,0,0,0,0,0,0,0,0,0,0,0,0,1
38,707,14,8,8,0,0,6,14,0,0,0,0,0,0,0,0,0,0,0,0,1
38,707,6,4,4,0,0,2,6,0,0,0,0,0,0,0,0,0,0,0,0,1
38,707,6,4,4,0,0,2,6,1,2,1,2,3,3,2,4,0,2,0,0,1
38,707,7,5,5,0,0,2,7,0,0,0,0,0,0,0,0,0,0,0,0,1
38,707,10,6,6,0,0,4,10,0,0,0,0,0,0,0,0,0,0,0,0,1
38,707,1,1,1,0,0,0,1,0,0,0,0,0,0,0,0,0,0,0,0,1
38,707,14,10,10,0,0,4,14,1,1,1,1,2,2,0,2,0,1,0,0,1
38,707,46,26,30,3,0,12,49,3,6,3,6,9,9,20,28,1,42,2,0,1
1,288,382,65,130,157,2,92,539,4,10,5,10,14,15,41,57,2,114,6,0,1
113,2252,1513,682,1277,25,13,200,1538,11,199,116,219,210,335,1557,2584,6,15641,868,0,0
113,2252,819,519,539,24,98,155,843,15,96,57,106,111,163,690,1107,8,9171,509,0,0
172,3915,77,34,69,0,0,8,77,3,24,16,29,27,45,114,213,1,387,21,0,0
172,3915,712,438,573,51,9,84,763,14,102,71,128,116,199,733,1364,8,11988,666,0,0
110,4226,1513,682,1277,25,13,200,1538,11,199,116,219,210,335,1557,2584,6,15641,868,0,0
38,705,127,75,83,2,11,30,129,4,14,7,14,18,21,61,87,2,175,9,0,0
38,705,652,304,544,16,6,88,668,6,89,51,101,95,152,591,998,3,3399,188,0,0
38,705,2,2,2,0,0,0,2,0,0,0,0,0,0,0,0,0,0,0,0,0
38,705,8,5,5,0,0,3,8,0,0,0,0,0,0,0,0,0,0,0,0,0
38,705,14,8,8,0,0,6,14,0,0,0,0,0,0,0,0,0,0,0,0,0
38,705,6,4,4,0,0,2,6,0,0,0,0,0,0,0,0,0,0,0,0,0
38,705,6,4,4,0,0,2,6,1,2,1,2,3,3,2,4,0,2,0,0,0
38,705,7,5,5,0,0,2,7,0,0,0,0,0,0,0,0,0,0,0,0,0
38,705,10,6,6,0,0,4,10,0,0,0,0,0,0,0,0,0,0,0,0,0
38,705,1,1,1,0,0,0,1,0,0,0,0,0,0,0,0,0,0,0,0,0
38,705,14,10,10,0,0,4,14,1,1,1,1,2,2,0,2,0,1,0,0,0
38,705,46,26,30,3,0,12,49,3,6,3,6,9,9,20,28,1,42,2,0,0
455,10020,72,33,56,0,4,12,72,1,1,1,1,2,2,0,2,0,1,0,0,1
455,10020,1454,835,1044,76,110,219,1530,17,275,158,296,292,454,2297,3718,9,34017,1889,1,1
129,5619,139,89,101,2,0,35,141,7,54,34,62,61,96,330,569,4,2287,127,0,1
129,5619,7,5,5,0,0,2,7,1,2,1,2,3,3,2,4,0,2,0,0,1
455,10020,72,33,56,0,4,12,72,1,1,1,1,2,2,0,2,0,1,0,0,0
455,10020,1454,835,1044,76,110,219,1530,17,275,158,296,292,454,2297,3718,9,34017,1889,1,0
129,5619,139,89,101,2,0,35,141,7,54,34,62,61,96,330,569,4,2287,127,0,0
129,5619,7,5,5,0,0,2,7,1,2,1,2,3,3,2,4,0,2,0,0,0
46,451,647,139,84,35,284,233,682,0,0,0,0,0,0,0,0,0,0,0,0,1
21,554,1293,570,1093,25,15,163,1318,10,195,123,241,205,364,1516,2795,6,17273,959,0,1
31,1175,1293,570,1093,25,15,163,1318,10,195,123,241,205,364,1516,2795,6,17273,959,0,1
113,2255,1513,682,1277,25,13,200,1538,11,199,116,219,210,335,1557,2584,6,15641,868,0,0
113,2255,819,519,539,24,98,155,843,15,96,57,106,111,163,690,1107,8,9171,509,0,0
111,4253,1513,682,1277,25,13,200,1538,11,199,116,219,210,335,1557,2584,6,15641,868,0,0
111,4259,1513,682,1277,25,13,200,1538,11,199,116,219,210,335,1557,2584,6,15641,868,0,0
138,4339,1660,832,1314,41,38,274,1701,20,312,209,395,332,604,2671,5058,12,64042,3557,1,0
138,4339,1057,646,719,113,100,145,1170,18,215,134,248,233,382,1740,3004,10,31186,1732,1,0
77,1717,477,336,357,30,23,73,507,16,194,134,250,210,384,1538,2962,10,30538,1696,0,0
60,1070,282,196,195,3,0,86,285,8,130,71,141,138,212,936,1507,4,6538,363,0,0
63,2320,1450,624,1228,12,26,181,1462,14,306,186,354,320,540,2580,4493,8,36391,2021,1,0
125,3266,1660,832,1314,41,38,274,1701,20,312,209,395,332,604,2671,5058,12,64042,3557,1,0
46,451,647,139,84,35,284,233,682,0,0,0,0,0,0,0,0,0,0,0,0,0
21,554,1293,570,1093,25,15,163,1318,10,195,123,241,205,364,1516,2795,6,17273,959,0,0
31,1175,1293,570,1093,25,15,163,1318,10,195,123,241,205,364,1516,2795,6,17273,959,0,0
87,1541,1178,367,1042,6,15,115,1184,9,94,51,95,103,146,644,976,4,4439,246,0,0
87,1541,177,108,140,8,0,27,185,6,30,16,32,36,48,162,248,3,794,44,0,0
47,2040,1178,367,1042,6,15,115,1184,9,94,51,95,103,146,644,976,4,4439,246,0,0
85,1860,477,336,357,30,23,73,507,16,194,134,250,210,384,1538,2962,10,30538,1696,0,0
64,2475,1450,624,1228,12,26,181,1462,14,306,186,354,320,540,2580,4493,8,36391,2021,1,0
85,1860,477,336,357,30,23,73,507,16,194,134,250,210,384,1538,2962,10,30538,1696,0,1
64,2475,1450,624,1228,12,26,181,1462,14,306,186,354,320,540,2580,4493,8,36391,2021,1,1
229,4691,1457,730,1242,11,6,188,1468,10,292,166,329,302,495,2424,4078,5,22973,1276,1,0
229,4691,74,35,59,1,0,14,75,3,14,7,14,17,21,58,85,1,128,7,0,0
229,4691,245,125,200,5,7,34,250,7,30,17,34,37,51,166,265,3,1053,58,0,0
176,4053,77,34,69,0,0,8,77,3,24,16,29,27,45,114,213,1,387,21,0,0
176,4053,712,438,573,51,9,84,763,14,102,71,128,116,199,733,1364,8,11988,666,0,0
456,10021,72,33,56,0,4,12,72,1,1,1,1,2,2,0,2,0,1,0,0,0
456,10021,1454,835,1044,76,110,219,1530,17,275,158,296,292,454,2297,3718,9,34017,1889,1,0
229,4691,1457,730,1242,11,6,188,1468,10,292,166,329,302,495,2424,4078,5,22973,1276,1,1
229,4691,74,35,59,1,0,14,75,3,14,7,14,17,21,58,85,1,128,7,0,1
229,4691,245,125,200,5,7,34,250,7,30,17,34,37,51,166,265,3,1053,58,0,1
176,4053,77,34,69,0,0,8,77,3,24,16,29,27,45,114,213,1,387,21,0,1
176,4053,712,438,573,51,9,84,763,14,102,71,128,116,199,733,1364,8,11988,666,0,1
456,10021,72,33,56,0,4,12,72,1,1,1,1,2,2,0,2,0,1,0,0,1
456,10021,1454,835,1044,76,110,219,1530,17,275,158,296,292,454,2297,3718,9,34017,1889,1,1
24,753,74,35,59,1,0,14,75,3,14,7,14,17,21,58,85,1,128,7,0,0
24,753,245,125,200,5,7,34,250,7,30,17,34,37,51,166,265,3,1053,58,0,0
172,3928,77,34,69,0,0,8,77,3,24,16,29,27,45,114,213,1,387,21,0,0
172,3928,712,438,573,51,9,84,763,14,102,71,128,116,199,733,1364,8,11988,666,0,0
196,4405,722,423,573,19,0,135,741,12,172,101,199,184,300,1320,2257,6,15668,870,0,0
196,4405,1508,847,911,44,250,301,1552,14,148,88,169,162,257,1120,1886,7,15077,837,0,0
16,595,722,423,573,19,0,135,741,12,172,101,199,184,300,1320,2257,6,15668,870,0,0
24,753,74,35,59,1,0,14,75,3,14,7,14,17,21,58,85,1,128,7,0,1
24,753,245,125,200,5,7,34,250,7,30,17,34,37,51,166,265,3,1053,58,0,1
172,3928,77,34,69,0,0,8,77,3,24,16,29,27,45,114,213,1,387,21,0,1
172,3928,712,438,573,51,9,84,763,14,102,71,128,116,199,733,1364,8,11988,666,0,1
196,4405,722,423,573,19,0,135,741,12,172,101,199,184,300,1320,2257,6,15668,870,0,1
196,4405,1508,847,911,44,250,301,1552,14,148,88,169,162,257,1120,1886,7,15077,837,0,1
16,595,722,423,573,19,0,135,741,12,172,101,199,184,300,1320,2257,6,15668,870,0,1
46,449,647,139,84,35,284,233,682,0,0,0,0,0,0,0,0,0,0,0,0,0
229,4687,1457,730,1242,11,6,188,1468,10,292,166,329,302,495,2424,4078,5,22973,1276,1,0
229,4687,74,35,59,1,0,14,75,3,14,7,14,17,21,58,85,1,128,7,0,0
229,4687,245,125,200,5,7,34,250,7,30,17,34,37,51,166,265,3,1053,58,0,0
24,743,74,35,59,1,0,14,75,3,14,7,14,17,21,58,85,1,128,7,0,0
24,743,245,125,200,5,7,34,250,7,30,17,34,37,51,166,265,3,1053,58,0,0
8,257,74,35,59,1,0,14,75,3,14,7,14,17,21,58,85,1,128,7,0,0
229,4687,1457,730,1242,11,6,188,1468,10,292,166,329,302,495,2424,4078,5,22973,1276,1,1
229,4687,74,35,59,1,0,14,75,3,14,7,14,17,21,58,85,1,128,7,0,1
229,4687,245,125,200,5,7,34,250,7,30,17,34,37,51,166,265,3,1053,58,0,1
24,743,74,35,59,1,0,14,75,3,14,7,14,17,21,58,85,1,128,7,0,1
24,743,245,125,200,5,7,34,250,7,30,17,34,37,51,166,265,3,1053,58,0,1
8,257,74,35,59,1,0,14,75,3,14,7,14,17,21,58,85,1,128,7,0,1
186,4159,722,423,573,19,0,135,741,12,172,101,199,184,300,1320,2257,6,15668,870,0,0
186,4159,1508,847,911,44,250,301,1552,14,148,88,169,162,257,1120,1886,7,15077,837,0,0
68,1223,1020,354,843,12,15,144,1032,8,134,77,144,142,221,970,1580,4,6792,377,0,0
55,2363,1020,354,843,12,15,144,1032,8,134,77,144,142,221,970,1580,4,6792,377,0,0
68,1223,1020,354,843,12,15,144,1032,8,134,77,144,142,221,970,1580,4,6792,377,0,1
55,2363,1020,354,843,12,15,144,1032,8,134,77,144,142,221,970,1580,4,6792,377,0,1
173,3969,722,423,573,19,0,135,741,12,172,101,199,184,300,1320,2257,6,15668,870,0,1
173,3969,1508,847,911,44,250,301,1552,14,148,88,169,162,257,1120,1886,7,15077,837,0,1
45,2770,1296,573,1062,40,33,157,1336,8,201,118,231,209,349,1561,2689,4,12365,686,0,1
15,573,722,423,573,19,0,135,741,12,172,101,199,184,300,1320,2257,6,15668,870,0,1
455,9950,72,33,56,0,4,12,72,1,1,1,1,2,2,0,2,0,1,0,0,0
455,9950,1454,835,1044,76,110,219,1530,17,275,158,296,292,454,2297,3718,9,34017,1889,1,0
455,9950,72,33,56,0,4,12,72,1,1,1,1,2,2,0,2,0,1,0,0,1
455,9950,1454,835,1044,76,110,219,1530,17,275,158,296,292,454,2297,3718,9,34017,1889,1,1
138,4352,1660,832,1314,41,38,274,1701,20,312,209,395,332,604,2671,5058,12,64042,3557,1,1
138,4352,1057,646,719,113,100,145,1170,18,215,134,248,233,382,1740,3004,10,31186,1732,1,1
126,3306,1660,832,1314,41,38,274,1701,20,312,209,395,332,604,2671,5058,12,64042,3557,1,1
138,4352,1660,832,1314,41,38,274,1701,20,312,209,395,332,604,2671,5058,12,64042,3557,1,0
138,4352,1057,646,719,113,100,145,1170,18,215,134,248,233,382,1740,3004,10,31186,1732,1,0
126,3306,1660,832,1314,41,38,274,1701,20,312,209,395,332,604,2671,5058,12,64042,3557,1,0
173,3969,722,423,573,19,0,135,741,12,172,101,199,184,300,1320,2257,6,15668,870,0,0
173,3969,1508,847,911,44,250,301,1552,14,148,88,169,162,257,1120,1886,7,15077,837,0,0
45,2770,1296,573,1062,40,33,157,1336,8,201,118,231,209,349,1561,2689,4,12365,686,0,0
15,573,722,423,573,19,0,135,741,12,172,101,199,184,300,1320,2257,6,15668,870,0,0
30,853,465,148,393,5,8,60,470,4,31,20,31,35,51,161,261,2,523,29,0,1
30,853,16,12,9,0,0,6,16,1,2,1,2,3,3,2,4,0,2,0,0,1
30,982,1455,414,1257,16,76,112,1471,5,41,23,46,46,69,231,381,2,1069,59,0,0
30,982,669,365,481,22,61,110,691,15,103,63,122,118,185,747,1273,8,11311,628,0,0
25,1094,1455,414,1257,16,76,112,1471,5,41,23,46,46,69,231,381,2,1069,59,0,0
30,982,1455,414,1257,16,76,112,1471,5,41,23,46,46,69,231,381,2,1069,59,0,1
30,982,669,365,481,22,61,110,691,15,103,63,122,118,185,747,1273,8,11311,628,0,1
25,1094,1455,414,1257,16,76,112,1471,5,41,23,46,46,69,231,381,2,1069,59,0,1
29,974,1455,414,1257,16,76,112,1471,5,41,23,46,46,69,231,381,2,1069,59,0,0
29,974,669,365,481,22,61,110,691,15,103,63,122,118,185,747,1273,8,11311,628,0,0
29,974,1455,414,1257,16,76,112,1471,5,41,23,46,46,69,231,381,2,1069,59,0,1
29,974,669,365,481,22,61,110,691,15,103,63,122,118,185,747,1273,8,11311,628,0,1
27,1182,1455,414,1257,16,76,112,1471,5,41,23,46,46,69,231,381,2,1069,59,0,0
111,2245,1513,682,1277,25,13,200,1538,11,199,116,219,210,335,1557,2584,6,15641,868,0,0
111,2245,819,519,539,24,98,155,843,15,96,57,106,111,163,690,1107,8,9171,509,0,0
24,750,74,35,59,1,0,14,75,3,14,7,14,17,21,58,85,1,128,7,0,0
24,750,245,125,200,5,7,34,250,7,30,17,34,37,51,166,265,3,1053,58,0,0
23,371,424,94,331,4,0,89,428,1,5,5,5,6,10,11,25,0,12,0,0,0
23,371,38,23,23,6,0,8,44,3,11,7,11,14,18,42,68,1,102,5,0,0
14,454,184,100,137,2,15,30,186,6,38,20,39,44,59,214,322,3,991,55,0,0
14,454,103,65,74,8,5,16,111,7,17,9,17,24,26,89,119,3,417,23,0,0
454,9966,72,33,56,0,4,12,72,1,1,1,1,2,2,0,2,0,1,0,0,0
454,9966,1454,835,1044,76,110,219,1530,17,275,158,296,292,454,2297,3718,9,34017,1889,1,0
83,1483,1178,367,1042,6,15,115,1184,9,94,51,95,103,146,644,976,4,4439,246,0,0
83,1483,177,108,140,8,0,27,185,6,30,16,32,36,48,162,248,3,794,44,0,0
166,3406,1943,715,1694,26,18,214,1969,12,185,120,237,197,357,1436,2721,7,20915,1161,0,0
166,3406,1168,838,957,57,25,144,1225,19,348,224,416,367,640,3018,5452,11,61921,3440,1,0
51,1012,1098,241,925,5,10,155,1103,7,46,25,49,53,74,273,423,3,1580,87,0,0
51,1012,282,202,222,14,2,44,296,8,42,24,43,50,67,250,378,4,1548,86,0,0
111,2245,1513,682,1277,25,13,200,1538,11,199,116,219,210,335,1557,2584,6,15641,868,0,1
111,2245,819,519,539,24,98,155,843,15,96,57,106,111,163,690,1107,8,9171,509,0,1
24,750,74,35,59,1,0,14,75,3,14,7,14,17,21,58,85,1,128,7,0,1
24,750,245,125,200,5,7,34,250,7,30,17,34,37,51,166,265,3,1053,58,0,1
23,371,424,94,331,4,0,89,428,1,5,5,5,6,10,11,25,0,12,0,0,1
23,371,38,23,23,6,0,8,44,3,11,7,11,14,18,42,68,1,102,5,0,1
14,454,184,100,137,2,15,30,186,6,38,20,39,44,59,214,322,3,991,55,0,1
14,454,103,65,74,8,5,16,111,7,17,9,17,24,26,89,119,3,417,23,0,1
454,9966,72,33,56,0,4,12,72,1,1,1,1,2,2,0,2,0,1,0,0,1
454,9966,1454,835,1044,76,110,219,1530,17,275,158,296,292,454,2297,3718,9,34017,1889,1,1
83,1483,1178,367,1042,6,15,115,1184,9,94,51,95,103,146,644,976,4,4439,246,0,1
83,1483,177,108,140,8,0,27,185,6,30,16,32,36,48,162,248,3,794,44,0,1
166,3406,1943,715,1694,26,18,214,1969,12,185,120,237,197,357,1436,2721,7,20915,1161,0,1
166,3406,1168,838,957,57,25,144,1225,19,348,224,416,367,640,3018,5452,11,61921,3440,1,1
51,1012,1098,241,925,5,10,155,1103,7,46,25,49,53,74,273,423,3,1580,87,0,1
51,1012,282,202,222,14,2,44,296,8,42,24,43,50,67,250,378,4,1548,86,0,1
29,972,1455,414,1257,16,76,112,1471,5,41,23,46,46,69,231,381,2,1069,59,0,0
29,972,669,365,481,22,61,110,691,15,103,63,122,118,185,747,1273,8,11311,628,0,0
131,3359,1660,832,1314,41,38,274,1701,20,312,209,395,332,604,2671,5058,12,64042,3557,1,1
131,3359,1660,832,1314,41,38,274,1701,20,312,209,395,332,604,2671,5058,12,64042,3557,1,0
454,9990,72,33,56,0,4,12,72,1,1,1,1,2,2,0,2,0,1,0,0,1
454,9990,1454,835,1044,76,110,219,1530,17,275,158,296,292,454,2297,3718,9,34017,1889,1,1
47,2824,1296,573,1062,40,33,157,1336,8,201,118,231,209,349,1561,2689,4,12365,686,0,1
138,4358,1660,832,1314,41,38,274,1701,20,312,209,395,332,604,2671,5058,12,64042,3557,1,0
138,4358,1057,646,719,113,100,145,1170,18,215,134,248,233,382,1740,3004,10,31186,1732,1,0
457,10005,72,33,56,0,4,12,72,1,1,1,1,2,2,0,2,0,1,0,0,0
457,10005,1454,835,1044,76,110,219,1530,17,275,158,296,292,454,2297,3718,9,34017,1889,1,0
47,2824,1296,573,1062,40,33,157,1336,8,201,118,231,209,349,1561,2689,4,12365,686,0,0
465,10107,72,33,56,0,4,12,72,1,1,1,1,2,2,0,2,0,1,0,0,0
465,10107,1454,835,1044,76,110,219,1530,17,275,158,296,292,454,2297,3718,9,34017,1889,1,0
31,888,465,148,393,5,8,60,470,4,31,20,31,35,51,161,261,2,523,29,0,0
31,888,16,12,9,0,0,6,16,1,2,1,2,3,3,2,4,0,2,0,0,0
65,3525,1782,648,1425,9,47,279,1791,8,171,97,189,179,286,1292,2140,4,9462,525,0,0
15,468,184,100,137,2,15,30,186,6,38,20,39,44,59,214,322,3,991,55,0,1
15,468,103,65,74,8,5,16,111,7,17,9,17,24,26,89,119,3,417,23,0,1
11,374,184,100,137,2,15,30,186,6,38,20,39,44,59,214,322,3,991,55,0,1
15,468,184,100,137,2,15,30,186,6,38,20,39,44,59,214,322,3,991,55,0,0
15,468,103,65,74,8,5,16,111,7,17,9,17,24,26,89,119,3,417,23,0,0
11,374,184,100,137,2,15,30,186,6,38,20,39,44,59,214,322,3,991,55,0,0
15,467,184,100,137,2,15,30,186,6,38,20,39,44,59,214,322,3,991,55,0,0
15,467,103,65,74,8,5,16,111,7,17,9,17,24,26,89,119,3,417,23,0,0
139,4400,1660,832,1314,41,38,274,1701,20,312,209,395,332,604,2671,5058,12,64042,3557,1,1
139,4400,1057,646,719,113,100,145,1170,18,215,134,248,233,382,1740,3004,10,31186,1732,1,1
131,3348,1660,832,1314,41,38,274,1701,20,312,209,395,332,604,2671,5058,12,64042,3557,1,1
465,10105,72,33,56,0,4,12,72,1,1,1,1,2,2,0,2,0,1,0,0,0
465,10105,1454,835,1044,76,110,219,1530,17,275,158,296,292,454,2297,3718,9,34017,1889,1,0
139,4400,1660,832,1314,41,38,274,1701,20,312,209,395,332,604,2671,5058,12,64042,3557,1,0
139,4400,1057,646,719,113,100,145,1170,18,215,134,248,233,382,1740,3004,10,31186,1732,1,0
131,3348,1660,832,1314,41,38,274,1701,20,312,209,395,332,604,2671,5058,12,64042,3557,1,0
465,10120,72,33,56,0,4,12,72,1,1,1,1,2,2,0,2,0,1,0,0,1
465,10120,1454,835,1044,76,110,219,1530,17,275,158,296,292,454,2297,3718,9,34017,1889,1,1
130,5646,139,89,101,2,0,35,141,7,54,34,62,61,96,330,569,4,2287,127,0,1
130,5646,7,5,5,0,0,2,7,1,2,1,2,3,3,2,4,0,2,0,0,1
16,474,184,100,137,2,15,30,186,6,38,20,39,44,59,214,322,3,991,55,0,1
16,474,103,65,74,8,5,16,111,7,17,9,17,24,26,89,119,3,417,23,0,1
16,474,184,100,137,2,15,30,186,6,38,20,39,44,59,214,322,3,991,55,0,0
16,474,103,65,74,8,5,16,111,7,17,9,17,24,26,89,119,3,417,23,0,0
43,1307,1523,757,1297,19,12,193,1542,12,193,117,230,205,347,1508,2664,7,19053,1058,0,1
43,1307,701,378,504,33,58,109,734,13,110,68,126,123,194,794,1346,7,10027,557,0,1
40,2493,1523,757,1297,19,12,193,1542,12,193,117,230,205,347,1508,2664,7,19053,1058,0,1
229,4718,1457,730,1242,11,6,188,1468,10,292,166,329,302,495,2424,4078,5,22973,1276,1,0
229,4718,74,35,59,1,0,14,75,3,14,7,14,17,21,58,85,1,128,7,0,0
229,4718,245,125,200,5,7,34,250,7,30,17,34,37,51,166,265,3,1053,58,0,0
40,1923,1457,730,1242,11,6,188,1468,10,292,166,329,302,495,2424,4078,5,22973,1276,1,0
229,4709,1457,730,1242,11,6,188,1468,10,292,166,329,302,495,2424,4078,5,22973,1276,1,0
229,4709,74,35,59,1,0,14,75,3,14,7,14,17,21,58,85,1,128,7,0,0
229,4709,245,125,200,5,7,34,250,7,30,17,34,37,51,166,265,3,1053,58,0,0
40,1916,1457,730,1242,11,6,188,1468,10,292,166,329,302,495,2424,4078,5,22973,1276,1,0
31,1022,1455,414,1257,16,76,112,1471,5,41,23,46,46,69,231,381,2,1069,59,0,1
31,1022,669,365,481,22,61,110,691,15,103,63,122,118,185,747,1273,8,11311,628,0,1
27,1147,1455,414,1257,16,76,112,1471,5,41,23,46,46,69,231,381,2,1069,59,0,0
31,1169,1293,570,1093,25,15,163,1318,10,195,123,241,205,364,1516,2795,6,17273,959,0,0
43,1307,1523,757,1297,19,12,193,1542,12,193,117,230,205,347,1508,2664,7,19053,1058,0,0
43,1307,701,378,504,33,58,109,734,13,110,68,126,123,194,794,1346,7,10027,557,0,0
40,2493,1523,757,1297,19,12,193,1542,12,193,117,230,205,347,1508,2664,7,19053,1058,0,0
28,1226,1455,414,1257,16,76,112,1471,5,41,23,46,46,69,231,381,2,1069,59,0,0
247,4978,1457,730,1242,11,6,188,1468,10,292,166,329,302,495,2424,4078,5,22973,1276,1,1
247,4978,74,35,59,1,0,14,75,3,14,7,14,17,21,58,85,1,128,7,0,1
247,4978,245,125,200,5,7,34,250,7,30,17,34,37,51,166,265,3,1053,58,0,1
172,3925,77,34,69,0,0,8,77,3,24,16,29,27,45,114,213,1,387,21,0,1
172,3925,712,438,573,51,9,84,763,14,102,71,128,116,199,733,1364,8,11988,666,0,1
173,3958,722,423,573,19,0,135,741,12,172,101,199,184,300,1320,2257,6,15668,870,0,1
173,3958,1508,847,911,44,250,301,1552,14,148,88,169,162,257,1120,1886,7,15077,837,0,1
464,10112,72,33,56,0,4,12,72,1,1,1,1,2,2,0,2,0,1,0,0,1
464,10112,1454,835,1044,76,110,219,1530,17,275,158,296,292,454,2297,3718,9,34017,1889,1,1
83,1504,1178,367,1042,6,15,115,1184,9,94,51,95,103,146,644,976,4,4439,246,0,1
83,1504,177,108,140,8,0,27,185,6,30,16,32,36,48,162,248,3,794,44,0,1
168,3515,1943,715,1694,26,18,214,1969,12,185,120,237,197,357,1436,2721,7,20915,1161,0,1
168,3515,1168,838,957,57,25,144,1225,19,348,224,416,367,640,3018,5452,11,61921,3440,1,1
47,2300,1457,730,1242,11,6,188,1468,10,292,166,329,302,495,2424,4078,5,22973,1276,1,1
30,1941,652,304,544,16,6,88,668,6,89,51,101,95,152,591,998,3,3399,188,0,1
27,1145,1455,414,1257,16,76,112,1471,5,41,23,46,46,69,231,381,2,1069,59,0,1
61,2681,1943,715,1694,26,18,214,1969,12,185,120,237,197,357,1436,2721,7,20915,1161,0,1
31,1022,1455,414,1257,16,76,112,1471,5,41,23,46,46,69,231,381,2,1069,59,0,0
31,1022,669,365,481,22,61,110,691,15,103,63,122,118,185,747,1273,8,11311,628,0,0
28,1191,1455,414,1257,16,76,112,1471,5,41,23,46,46,69,231,381,2,1069,59,0,0
30,1950,652,304,544,16,6,88,668,6,89,51,101,95,152,591,998,3,3399,188,0,1
11,370,85,59,61,8,0,16,93,5,18,10,18,23,28,86,126,2,316,17,0,1
111,4259,1513,682,1277,25,13,200,1538,11,199,116,219,210,335,1557,2584,6,15641,868,0,1
465,10120,72,33,56,0,4,12,72,1,1,1,1,2,2,0,2,0,1,0,0,0
465,10120,1454,835,1044,76,110,219,1530,17,275,158,296,292,454,2297,3718,9,34017,1889,1,0
247,4978,1457,730,1242,11,6,188,1468,10,292,166,329,302,495,2424,4078,5,22973,1276,1,0
247,4978,74,35,59,1,0,14,75,3,14,7,14,17,21,58,85,1,128,7,0,0
247,4978,245,125,200,5,7,34,250,7,30,17,34,37,51,166,265,3,1053,58,0,0
172,3925,77,34,69,0,0,8,77,3,24,16,29,27,45,114,213,1,387,21,0,0
172,3925,712,438,573,51,9,84,763,14,102,71,128,116,199,733,1364,8,11988,666,0,0
173,3958,722,423,573,19,0,135,741,12,172,101,199,184,300,1320,2257,6,15668,870,0,0
173,3958,1508,847,911,44,250,301,1552,14,148,88,169,162,257,1120,1886,7,15077,837,0,0
464,10112,72,33,56,0,4,12,72,1,1,1,1,2,2,0,2,0,1,0,0,0
464,10112,1454,835,1044,76,110,219,1530,17,275,158,296,292,454,2297,3718,9,34017,1889,1,0
83,1504,1178,367,1042,6,15,115,1184,9,94,51,95,103,146,644,976,4,4439,246,0,0
83,1504,177,108,140,8,0,27,185,6,30,16,32,36,48,162,248,3,794,44,0,0
168,3515,1943,715,1694,26,18,214,1969,12,185,120,237,197,357,1436,2721,7,20915,1161,0,0
168,3515,1168,838,957,57,25,144,1225,19,348,224,416,367,640,3018,5452,11,61921,3440,1,0
47,2300,1457,730,1242,11,6,188,1468,10,292,166,329,302,495,2424,4078,5,22973,1276,1,0
30,1950,652,304,544,16,6,88,668,6,89,51,101,95,152,591,998,3,3399,188,0,0
28,1189,1455,414,1257,16,76,112,1471,5,41,23,46,46,69,231,381,2,1069,59,0,0
61,2681,1943,715,1694,26,18,214,1969,12,185,120,237,197,357,1436,2721,7,20915,1161,0,0
464,10117,72,33,56,0,4,12,72,1,1,1,1,2,2,0,2,0,1,0,0,1
464,10117,1454,835,1044,76,110,219,1530,17,275,158,296,292,454,2297,3718,9,34017,1889,1,1
14,457,42,7,35,4,0,5,46,1,2,1,2,3,3,2,4,0,2,0,0,1
14,457,11,6,10,0,0,1,11,2,4,2,4,6,6,10,15,1,15,0,0,1
134,5956,139,89,101,2,0,35,141,7,54,34,62,61,96,330,569,4,2287,127,0,1
134,5956,7,5,5,0,0,2,7,1,2,1,2,3,3,2,4,0,2,0,0,1
466,10154,72,33,56,0,4,12,72,1,1,1,1,2,2,0,2,0,1,0,0,1
466,10154,1454,835,1044,76,110,219,1530,17,275,158,296,292,454,2297,3718,9,34017,1889,1,1
64,2966,1338,495,1086,10,64,173,1348,11,122,82,157,133,239,883,1686,7,11934,663,0,1
465,10151,72,33,56,0,4,12,72,1,1,1,1,2,2,0,2,0,1,0,0,1
465,10151,1454,835,1044,76,110,219,1530,17,275,158,296,292,454,2297,3718,9,34017,1889,1,1
64,2966,1338,495,1086,10,64,173,1348,11,122,82,157,133,239,883,1686,7,11934,663,0,0
465,10151,72,33,56,0,4,12,72,1,1,1,1,2,2,0,2,0,1,0,0,0
465,10151,1454,835,1044,76,110,219,1530,17,275,158,296,292,454,2297,3718,9,34017,1889,1,0
140,4414,1660,832,1314,41,38,274,1701,20,312,209,395,332,604,2671,5058,12,64042,3557,1,1
140,4414,1057,646,719,113,100,145,1170,18,215,134,248,233,382,1740,3004,10,31186,1732,1,1
132,3417,1660,832,1314,41,38,274,1701,20,312,209,395,332,604,2671,5058,12,64042,3557,1,1
464,10116,72,33,56,0,4,12,72,1,1,1,1,2,2,0,2,0,1,0,0,1
464,10116,1454,835,1044,76,110,219,1530,17,275,158,296,292,454,2297,3718,9,34017,1889,1,1
131,5688,139,89,101,2,0,35,141,7,54,34,62,61,96,330,569,4,2287,127,0,1
131,5688,7,5,5,0,0,2,7,1,2,1,2,3,3,2,4,0,2,0,0,1
464,10116,72,33,56,0,4,12,72,1,1,1,1,2,2,0,2,0,1,0,0,0
464,10116,1454,835,1044,76,110,219,1530,17,275,158,296,292,454,2297,3718,9,34017,1889,1,0
131,5688,139,89,101,2,0,35,141,7,54,34,62,61,96,330,569,4,2287,127,0,0
131,5688,7,5,5,0,0,2,7,1,2,1,2,3,3,2,4,0,2,0,0,0
465,10155,72,33,56,0,4,12,72,1,1,1,1,2,2,0,2,0,1,0,0,0
465,10155,1454,835,1044,76,110,219,1530,17,275,158,296,292,454,2297,3718,9,34017,1889,1,0
14,457,42,7,35,4,0,5,46,1,2,1,2,3,3,2,4,0,2,0,0,0
14,457,11,6,10,0,0,1,11,2,4,2,4,6,6,10,15,1,15,0,0,0
135,5998,139,89,101,2,0,35,141,7,54,34,62,61,96,330,569,4,2287,127,0,0
135,5998,7,5,5,0,0,2,7,1,2,1,2,3,3,2,4,0,2,0,0,0
115,2519,1043,504,840,53,9,147,1096,9,180,112,198,189,310,1377,2344,4,11604,644,0,0
115,2519,383,288,292,26,6,62,409,11,65,38,67,76,105,429,656,5,3719,206,0,0
53,2083,1043,504,840,53,9,147,1096,9,180,112,198,189,310,1377,2344,4,11604,644,0,1
466,10185,72,33,56,0,4,12,72,1,1,1,1,2,2,0,2,0,1,0,0,0
466,10185,1454,835,1044,76,110,219,1530,17,275,158,296,292,454,2297,3718,9,34017,1889,1,0
66,3583,1782,648,1425,9,47,279,1791,8,171,97,189,179,286,1292,2140,4,9462,525,0,0
466,10182,72,33,56,0,4,12,72,1,1,1,1,2,2,0,2,0,1,0,0,0
466,10182,1454,835,1044,76,110,219,1530,17,275,158,296,292,454,2297,3718,9,34017,1889,1,0
140,4414,1660,832,1314,41,38,274,1701,20,312,209,395,332,604,2671,5058,12,64042,3557,1,0
140,4414,1057,646,719,113,100,145,1170,18,215,134,248,233,382,1740,3004,10,31186,1732,1,0
132,3417,1660,832,1314,41,38,274,1701,20,312,209,395,332,604,2671,5058,12,64042,3557,1,0
465,10150,72,33,56,0,4,12,72,1,1,1,1,2,2,0,2,0,1,0,0,0
465,10150,1454,835,1044,76,110,219,1530,17,275,158,296,292,454,2297,3718,9,34017,1889,1,0
68,1230,1020,354,843,12,15,144,1032,8,134,77,144,142,221,970,1580,4,6792,377,0,1
466,10184,72,33,56,0,4,12,72,1,1,1,1,2,2,0,2,0,1,0,0,1
466,10184,1454,835,1044,76,110,219,1530,17,275,158,296,292,454,2297,3718,9,34017,1889,1,1
66,3583,1782,648,1425,9,47,279,1791,8,171,97,189,179,286,1292,2140,4,9462,525,0,1
466,10179,72,33,56,0,4,12,72,1,1,1,1,2,2,0,2,0,1,0,0,0
466,10179,1454,835,1044,76,110,219,1530,17,275,158,296,292,454,2297,3718,9,34017,1889,1,0
68,1230,1020,354,843,12,15,144,1032,8,134,77,144,142,221,970,1580,4,6792,377,0,0
53,2083,1043,504,840,53,9,147,1096,9,180,112,198,189,310,1377,2344,4,11604,644,0,0
135,5990,139,89,101,2,0,35,141,7,54,34,62,61,96,330,569,4,2287,127,0,1
135,5990,7,5,5,0,0,2,7,1,2,1,2,3,3,2,4,0,2,0,0,1
466,10197,72,33,56,0,4,12,72,1,1,1,1,2,2,0,2,0,1,0,0,1
466,10197,1454,835,1044,76,110,219,1530,17,275,158,296,292,454,2297,3718,9,34017,1889,1,1
136,6025,139,89,101,2,0,35,141,7,54,34,62,61,96,330,569,4,2287,127,0,1
136,6025,7,5,5,0,0,2,7,1,2,1,2,3,3,2,4,0,2,0,0,1
1,315,382,65,130,157,2,92,539,4,10,5,10,14,15,41,57,2,114,6,0,1
17,539,42,7,35,4,0,5,46,1,2,1,2,3,3,2,4,0,2,0,0,1
17,539,11,6,10,0,0,1,11,2,4,2,4,6,6,10,15,1,15,0,0,1
1,315,382,65,130,157,2,92,539,4,10,5,10,14,15,41,57,2,114,6,0,0
17,539,42,7,35,4,0,5,46,1,2,1,2,3,3,2,4,0,2,0,0,0
17,539,11,6,10,0,0,1,11,2,4,2,4,6,6,10,15,1,15,0,0,0
21,612,42,7,35,4,0,5,46,1,2,1,2,3,3,2,4,0,2,0,0,1
21,612,11,6,10,0,0,1,11,2,4,2,4,6,6,10,15,1,15,0,0,1
20,614,42,7,35,4,0,5,46,1,2,1,2,3,3,2,4,0,2,0,0,0
20,614,11,6,10,0,0,1,11,2,4,2,4,6,6,10,15,1,15,0,0,0
20,614,42,7,35,4,0,5,46,1,2,1,2,3,3,2,4,0,2,0,0,1
20,614,11,6,10,0,0,1,11,2,4,2,4,6,6,10,15,1,15,0,0,1
20,615,42,7,35,4,0,5,46,1,2,1,2,3,3,2,4,0,2,0,0,1
20,615,11,6,10,0,0,1,11,2,4,2,4,6,6,10,15,1,15,0,0,1
173,4001,722,423,573,19,0,135,741,12,172,101,199,184,300,1320,2257,6,15668,870,0,1
173,4001,1508,847,911,44,250,301,1552,14,148,88,169,162,257,1120,1886,7,15077,837,0,1
20,615,42,7,35,4,0,5,46,1,2,1,2,3,3,2,4,0,2,0,0,0
20,615,11,6,10,0,0,1,11,2,4,2,4,6,6,10,15,1,15,0,0,0
466,10197,72,33,56,0,4,12,72,1,1,1,1,2,2,0,2,0,1,0,0,0
466,10197,1454,835,1044,76,110,219,1530,17,275,158,296,292,454,2297,3718,9,34017,1889,1,0
136,6025,139,89,101,2,0,35,141,7,54,34,62,61,96,330,569,4,2287,127,0,0
136,6025,7,5,5,0,0,2,7,1,2,1,2,3,3,2,4,0,2,0,0,0
467,10219,72,33,56,0,4,12,72,1,1,1,1,2,2,0,2,0,1,0,0,1
467,10219,1454,835,1044,76,110,219,1530,17,275,158,296,292,454,2297,3718,9,34017,1889,1,1
66,2718,1289,550,1043,56,32,155,1345,10,167,93,185,177,278,1266,2075,5,11498,638,0,1
172,3989,722,423,573,19,0,135,741,12,172,101,199,184,300,1320,2257,6,15668,870,0,1
172,3989,1508,847,911,44,250,301,1552,14,148,88,169,162,257,1120,1886,7,15077,837,0,1
65,3083,1338,495,1086,10,64,173,1348,11,122,82,157,133,239,883,1686,7,11934,663,0,1
31,888,465,148,393,5,8,60,470,4,31,20,31,35,51,161,261,2,523,29,0,1
31,888,16,12,9,0,0,6,16,1,2,1,2,3,3,2,4,0,2,0,0,1
467,10219,72,33,56,0,4,12,72,1,1,1,1,2,2,0,2,0,1,0,0,0
467,10219,1454,835,1044,76,110,219,1530,17,275,158,296,292,454,2297,3718,9,34017,1889,1,0
66,2718,1289,550,1043,56,32,155,1345,10,167,93,185,177,278,1266,2075,5,11498,638,0,0
174,4018,722,423,573,19,0,135,741,12,172,101,199,184,300,1320,2257,6,15668,870,0,1
174,4018,1508,847,911,44,250,301,1552,14,148,88,169,162,257,1120,1886,7,15077,837,0,1
16,635,722,423,573,19,0,135,741,12,172,101,199,184,300,1320,2257,6,15668,870,0,1
172,3989,722,423,573,19,0,135,741,12,172,101,199,184,300,1320,2257,6,15668,870,0,0
172,3989,1508,847,911,44,250,301,1552,14,148,88,169,162,257,1120,1886,7,15077,837,0,0
65,3083,1338,495,1086,10,64,173,1348,11,122,82,157,133,239,883,1686,7,11934,663,0,0
173,4006,722,423,573,19,0,135,741,12,172,101,199,184,300,1320,2257,6,15668,870,0,0
173,4006,1508,847,911,44,250,301,1552,14,148,88,169,162,257,1120,1886,7,15077,837,0,0
16,635,722,423,573,19,0,135,741,12,172,101,199,184,300,1320,2257,6,15668,870,0,0
287,5589,1457,730,1242,11,6,188,1468,10,292,166,329,302,495,2424,4078,5,22973,1276,1,1
287,5589,74,35,59,1,0,14,75,3,14,7,14,17,21,58,85,1,128,7,0,1
287,5589,245,125,200,5,7,34,250,7,30,17,34,37,51,166,265,3,1053,58,0,1
46,449,647,139,84,35,284,233,682,0,0,0,0,0,0,0,0,0,0,0,0,1
16,631,722,423,573,19,0,135,741,12,172,101,199,184,300,1320,2257,6,15668,870,0,1
62,2690,1943,715,1694,26,18,214,1969,12,185,120,237,197,357,1436,2721,7,20915,1161,0,1
172,3933,77,34,69,0,0,8,77,3,24,16,29,27,45,114,213,1,387,21,0,0
172,3933,712,438,573,51,9,84,763,14,102,71,128,116,199,733,1364,8,11988,666,0,0
292,5675,1457,730,1242,11,6,188,1468,10,292,166,329,302,495,2424,4078,5,22973,1276,1,1
292,5675,74,35,59,1,0,14,75,3,14,7,14,17,21,58,85,1,128,7,0,1
292,5675,245,125,200,5,7,34,250,7,30,17,34,37,51,166,265,3,1053,58,0,1
291,5664,1457,730,1242,11,6,188,1468,10,292,166,329,302,495,2424,4078,5,22973,1276,1,1
291,5664,74,35,59,1,0,14,75,3,14,7,14,17,21,58,85,1,128,7,0,1
291,5664,245,125,200,5,7,34,250,7,30,17,34,37,51,166,265,3,1053,58,0,1
290,5645,1457,730,1242,11,6,188,1468,10,292,166,329,302,495,2424,4078,5,22973,1276,1,0
290,5645,74,35,59,1,0,14,75,3,14,7,14,17,21,58,85,1,128,7,0,0
290,5645,245,125,200,5,7,34,250,7,30,17,34,37,51,166,265,3,1053,58,0,0
16,631,722,423,573,19,0,135,741,12,172,101,199,184,300,1320,2257,6,15668,870,0,0
29,1861,652,304,544,16,6,88,668,6,89,51,101,95,152,591,998,3,3399,188,0,1
289,5621,1457,730,1242,11,6,188,1468,10,292,166,329,302,495,2424,4078,5,22973,1276,1,0
289,5621,74,35,59,1,0,14,75,3,14,7,14,17,21,58,85,1,128,7,0,0
289,5621,245,125,200,5,7,34,250,7,30,17,34,37,51,166,265,3,1053,58,0,0
33,664,2,2,2,0,0,0,2,0,0,0,0,0,0,0,0,0,0,0,0,1
33,664,99,48,90,1,3,5,100,0,0,0,0,0,0,0,0,0,0,0,0,1
33,664,8,5,5,2,0,1,10,0,0,0,0,0,0,0,0,0,0,0,0,1
33,664,1217,716,841,84,126,174,1301,14,185,118,215,199,333,1446,2542,8,20687,1149,0,1
33,664,160,89,115,0,13,31,160,7,15,11,17,22,28,78,124,3,495,27,0,1
33,664,10,10,9,9,0,0,19,0,0,0,0,0,0,0,0,0,0,0,0,1
33,664,173,84,99,8,29,36,181,5,12,7,13,17,20,54,81,2,221,12,0,1
33,664,3,1,1,3,0,0,6,0,0,0,0,0,0,0,0,0,0,0,0,1
289,5615,1457,730,1242,11,6,188,1468,10,292,166,329,302,495,2424,4078,5,22973,1276,1,1
289,5615,74,35,59,1,0,14,75,3,14,7,14,17,21,58,85,1,128,7,0,1
289,5615,245,125,200,5,7,34,250,7,30,17,34,37,51,166,265,3,1053,58,0,1
23,732,74,35,59,1,0,14,75,3,14,7,14,17,21,58,85,1,128,7,0,1
23,732,245,125,200,5,7,34,250,7,30,17,34,37,51,166,265,3,1053,58,0,1
171,3921,77,34,69,0,0,8,77,3,24,16,29,27,45,114,213,1,387,21,0,1
171,3921,712,438,573,51,9,84,763,14,102,71,128,116,199,733,1364,8,11988,666,0,1
171,3970,722,423,573,19,0,135,741,12,172,101,199,184,300,1320,2257,6,15668,870,0,1
171,3970,1508,847,911,44,250,301,1552,14,148,88,169,162,257,1120,1886,7,15077,837,0,1
38,711,127,75,83,2,11,30,129,4,14,7,14,18,21,61,87,2,175,9,0,1
38,711,652,304,544,16,6,88,668,6,89,51,101,95,152,591,998,3,3399,188,0,1
38,711,2,2,2,0,0,0,2,0,0,0,0,0,0,0,0,0,0,0,0,1
38,711,8,5,5,0,0,3,8,0,0,0,0,0,0,0,0,0,0,0,0,1
38,711,14,8,8,0,0,6,14,0,0,0,0,0,0,0,0,0,0,0,0,1
38,711,6,4,4,0,0,2,6,0,0,0,0,0,0,0,0,0,0,0,0,1
38,711,6,4,4,0,0,2,6,1,2,1,2,3,3,2,4,0,2,0,0,1
38,711,7,5,5,0,0,2,7,0,0,0,0,0,0,0,0,0,0,0,0,1
38,711,10,6,6,0,0,4,10,0,0,0,0,0,0,0,0,0,0,0,0,1
38,711,1,1,1,0,0,0,1,0,0,0,0,0,0,0,0,0,0,0,0,1
38,711,14,10,10,0,0,4,14,1,1,1,1,2,2,0,2,0,1,0,0,1
38,711,46,26,30,3,0,12,49,3,6,3,6,9,9,20,28,1,42,2,0,1
24,966,373,158,315,8,0,51,381,5,76,44,79,81,123,486,779,2,2026,112,0,1
176,4013,722,423,573,19,0,135,741,12,172,101,199,184,300,1320,2257,6,15668,870,0,1
176,4013,1508,847,911,44,250,301,1552,14,148,88,169,162,257,1120,1886,7,15077,837,0,1
176,4018,722,423,573,19,0,135,741,12,172,101,199,184,300,1320,2257,6,15668,870,0,1
176,4018,1508,847,911,44,250,301,1552,14,148,88,169,162,257,1120,1886,7,15077,837,0,1
176,4018,722,423,573,19,0,135,741,12,172,101,199,184,300,1320,2257,6,15668,870,0,0
176,4018,1508,847,911,44,250,301,1552,14,148,88,169,162,257,1120,1886,7,15077,837,0,0
176,4066,722,423,573,19,0,135,741,12,172,101,199,184,300,1320,2257,6,15668,870,0,0
176,4066,1508,847,911,44,250,301,1552,14,148,88,169,162,257,1120,1886,7,15077,837,0,0
174,4030,722,423,573,19,0,135,741,12,172,101,199,184,300,1320,2257,6,15668,870,0,0
174,4030,1508,847,911,44,250,301,1552,14,148,88,169,162,257,1120,1886,7,15077,837,0,0
285,5557,1457,730,1242,11,6,188,1468,10,292,166,329,302,495,2424,4078,5,22973,1276,1,0
285,5557,74,35,59,1,0,14,75,3,14,7,14,17,21,58,85,1,128,7,0,0
285,5557,245,125,200,5,7,34,250,7,30,17,34,37,51,166,265,3,1053,58,0,0
283,5525,1457,730,1242,11,6,188,1468,10,292,166,329,302,495,2424,4078,5,22973,1276,1,1
283,5525,74,35,59,1,0,14,75,3,14,7,14,17,21,58,85,1,128,7,0,1
283,5525,245,125,200,5,7,34,250,7,30,17,34,37,51,166,265,3,1053,58,0,1
33,664,2,2,2,0,0,0,2,0,0,0,0,0,0,0,0,0,0,0,0,0
33,664,99,48,90,1,3,5,100,0,0,0,0,0,0,0,0,0,0,0,0,0
33,664,8,5,5,2,0,1,10,0,0,0,0,0,0,0,0,0,0,0,0,0
33,664,1217,716,841,84,126,174,1301,14,185,118,215,199,333,1446,2542,8,20687,1149,0,0
33,664,160,89,115,0,13,31,160,7,15,11,17,22,28,78,124,3,495,27,0,0
33,664,10,10,9,9,0,0,19,0,0,0,0,0,0,0,0,0,0,0,0,0
33,664,173,84,99,8,29,36,181,5,12,7,13,17,20,54,81,2,221,12,0,0
33,664,3,1,1,3,0,0,6,0,0,0,0,0,0,0,0,0,0,0,0,0
283,5525,1457,730,1242,11,6,188,1468,10,292,166,329,302,495,2424,4078,5,22973,1276,1,0
283,5525,74,35,59,1,0,14,75,3,14,7,14,17,21,58,85,1,128,7,0,0
283,5525,245,125,200,5,7,34,250,7,30,17,34,37,51,166,265,3,1053,58,0,0
23,732,74,35,59,1,0,14,75,3,14,7,14,17,21,58,85,1,128,7,0,0
23,732,245,125,200,5,7,34,250,7,30,17,34,37,51,166,265,3,1053,58,0,0
171,3921,77,34,69,0,0,8,77,3,24,16,29,27,45,114,213,1,387,21,0,0
171,3921,712,438,573,51,9,84,763,14,102,71,128,116,199,733,1364,8,11988,666,0,0
38,711,127,75,83,2,11,30,129,4,14,7,14,18,21,61,87,2,175,9,0,0
38,711,652,304,544,16,6,88,668,6,89,51,101,95,152,591,998,3,3399,188,0,0
38,711,2,2,2,0,0,0,2,0,0,0,0,0,0,0,0,0,0,0,0,0
38,711,8,5,5,0,0,3,8,0,0,0,0,0,0,0,0,0,0,0,0,0
38,711,14,8,8,0,0,6,14,0,0,0,0,0,0,0,0,0,0,0,0,0
38,711,6,4,4,0,0,2,6,0,0,0,0,0,0,0,0,0,0,0,0,0
38,711,6,4,4,0,0,2,6,1,2,1,2,3,3,2,4,0,2,0,0,0
38,711,7,5,5,0,0,2,7,0,0,0,0,0,0,0,0,0,0,0,0,0
38,711,10,6,6,0,0,4,10,0,0,0,0,0,0,0,0,0,0,0,0,0
38,711,1,1,1,0,0,0,1,0,0,0,0,0,0,0,0,0,0,0,0,0
38,711,14,10,10,0,0,4,14,1,1,1,1,2,2,0,2,0,1,0,0,0
38,711,46,26,30,3,0,12,49,3,6,3,6,9,9,20,28,1,42,2,0,0
29,1861,652,304,544,16,6,88,668,6,89,51,101,95,152,591,998,3,3399,188,0,0
62,2690,1943,715,1694,26,18,214,1969,12,185,120,237,197,357,1436,2721,7,20915,1161,0,0
283,5532,1457,730,1242,11,6,188,1468,10,292,166,329,302,495,2424,4078,5,22973,1276,1,1
283,5532,74,35,59,1,0,14,75,3,14,7,14,17,21,58,85,1,128,7,0,1
283,5532,245,125,200,5,7,34,250,7,30,17,34,37,51,166,265,3,1053,58,0,1
47,2308,1457,730,1242,11,6,188,1468,10,292,166,329,302,495,2424,4078,5,22973,1276,1,0
282,5509,1457,730,1242,11,6,188,1468,10,292,166,329,302,495,2424,4078,5,22973,1276,1,0
282,5509,74,35,59,1,0,14,75,3,14,7,14,17,21,58,85,1,128,7,0,0
282,5509,245,125,200,5,7,34,250,7,30,17,34,37,51,166,265,3,1053,58,0,0
111,2266,1513,682,1277,25,13,200,1538,11,199,116,219,210,335,1557,2584,6,15641,868,0,0
111,2266,819,519,539,24,98,155,843,15,96,57,106,111,163,690,1107,8,9171,509,0,0
23,735,74,35,59,1,0,14,75,3,14,7,14,17,21,58,85,1,128,7,0,0
23,735,245,125,200,5,7,34,250,7,30,17,34,37,51,166,265,3,1053,58,0,0
46,483,647,139,84,35,284,233,682,0,0,0,0,0,0,0,0,0,0,0,0,0
171,3927,77,34,69,0,0,8,77,3,24,16,29,27,45,114,213,1,387,21,0,0
171,3927,712,438,573,51,9,84,763,14,102,71,128,116,199,733,1364,8,11988,666,0,0
23,374,424,94,331,4,0,89,428,1,5,5,5,6,10,11,25,0,12,0,0,0
23,374,38,23,23,6,0,8,44,3,11,7,11,14,18,42,68,1,102,5,0,0
16,477,184,100,137,2,15,30,186,6,38,20,39,44,59,214,322,3,991,55,0,0
16,477,103,65,74,8,5,16,111,7,17,9,17,24,26,89,119,3,417,23,0,0
467,10231,72,33,56,0,4,12,72,1,1,1,1,2,2,0,2,0,1,0,0,0
467,10231,1454,835,1044,76,110,219,1530,17,275,158,296,292,454,2297,3718,9,34017,1889,1,0
83,1510,1178,367,1042,6,15,115,1184,9,94,51,95,103,146,644,976,4,4439,246,0,0
83,1510,177,108,140,8,0,27,185,6,30,16,32,36,48,162,248,3,794,44,0,0
168,3521,1943,715,1694,26,18,214,1969,12,185,120,237,197,357,1436,2721,7,20915,1161,0,0
168,3521,1168,838,957,57,25,144,1225,19,348,224,416,367,640,3018,5452,11,61921,3440,1,0
51,1018,1098,241,925,5,10,155,1103,7,46,25,49,53,74,273,423,3,1580,87,0,0
51,1018,282,202,222,14,2,44,296,8,42,24,43,50,67,250,378,4,1548,86,0,0
38,714,127,75,83,2,11,30,129,4,14,7,14,18,21,61,87,2,175,9,0,0
38,714,652,304,544,16,6,88,668,6,89,51,101,95,152,591,998,3,3399,188,0,0
38,714,2,2,2,0,0,0,2,0,0,0,0,0,0,0,0,0,0,0,0,0
38,714,8,5,5,0,0,3,8,0,0,0,0,0,0,0,0,0,0,0,0,0
38,714,14,8,8,0,0,6,14,0,0,0,0,0,0,0,0,0,0,0,0,0
38,714,6,4,4,0,0,2,6,0,0,0,0,0,0,0,0,0,0,0,0,0
38,714,6,4,4,0,0,2,6,1,2,1,2,3,3,2,4,0,2,0,0,0
38,714,7,5,5,0,0,2,7,0,0,0,0,0,0,0,0,0,0,0,0,0
38,714,10,6,6,0,0,4,10,0,0,0,0,0,0,0,0,0,0,0,0,0
38,714,1,1,1,0,0,0,1,0,0,0,0,0,0,0,0,0,0,0,0,0
38,714,14,10,10,0,0,4,14,1,1,1,1,2,2,0,2,0,1,0,0,0
38,714,46,26,30,3,0,12,49,3,6,3,6,9,9,20,28,1,42,2,0,0
278,5480,1457,730,1242,11,6,188,1468,10,292,166,329,302,495,2424,4078,5,22973,1276,1,1
278,5480,74,35,59,1,0,14,75,3,14,7,14,17,21,58,85,1,128,7,0,1
278,5480,245,125,200,5,7,34,250,7,30,17,34,37,51,166,265,3,1053,58,0,1
46,511,647,139,84,35,284,233,682,0,0,0,0,0,0,0,0,0,0,0,0,1
468,10250,72,33,56,0,4,12,72,1,1,1,1,2,2,0,2,0,1,0,0,1
468,10250,1454,835,1044,76,110,219,1530,17,275,158,296,292,454,2297,3718,9,34017,1889,1,1
47,2308,1457,730,1242,11,6,188,1468,10,292,166,329,302,495,2424,4078,5,22973,1276,1,1
278,5491,1457,730,1242,11,6,188,1468,10,292,166,329,302,495,2424,4078,5,22973,1276,1,1
278,5491,74,35,59,1,0,14,75,3,14,7,14,17,21,58,85,1,128,7,0,1
278,5491,245,125,200,5,7,34,250,7,30,17,34,37,51,166,265,3,1053,58,0,1
46,518,647,139,84,35,284,233,682,0,0,0,0,0,0,0,0,0,0,0,0,1
465,10193,72,33,56,0,4,12,72,1,1,1,1,2,2,0,2,0,1,0,0,1
465,10193,1454,835,1044,76,110,219,1530,17,275,158,296,292,454,2297,3718,9,34017,1889,1,1
278,5472,1457,730,1242,11,6,188,1468,10,292,166,329,302,495,2424,4078,5,22973,1276,1,1
278,5472,74,35,59,1,0,14,75,3,14,7,14,17,21,58,85,1,128,7,0,1
278,5472,245,125,200,5,7,34,250,7,30,17,34,37,51,166,265,3,1053,58,0,1
47,2310,1457,730,1242,11,6,188,1468,10,292,166,329,302,495,2424,4078,5,22973,1276,1,1
278,5481,1457,730,1242,11,6,188,1468,10,292,166,329,302,495,2424,4078,5,22973,1276,1,0
278,5481,74,35,59,1,0,14,75,3,14,7,14,17,21,58,85,1,128,7,0,0
278,5481,245,125,200,5,7,34,250,7,30,17,34,37,51,166,265,3,1053,58,0,0
23,749,74,35,59,1,0,14,75,3,14,7,14,17,21,58,85,1,128,7,0,0
23,749,245,125,200,5,7,34,250,7,30,17,34,37,51,166,265,3,1053,58,0,0
175,4049,722,423,573,19,0,135,741,12,172,101,199,184,300,1320,2257,6,15668,870,0,0
175,4049,1508,847,911,44,250,301,1552,14,148,88,169,162,257,1120,1886,7,15077,837,0,0
276,5455,1457,730,1242,11,6,188,1468,10,292,166,329,302,495,2424,4078,5,22973,1276,1,1
276,5455,74,35,59,1,0,14,75,3,14,7,14,17,21,58,85,1,128,7,0,1
276,5455,245,125,200,5,7,34,250,7,30,17,34,37,51,166,265,3,1053,58,0,1
175,4047,722,423,573,19,0,135,741,12,172,101,199,184,300,1320,2257,6,15668,870,0,1
175,4047,1508,847,911,44,250,301,1552,14,148,88,169,162,257,1120,1886,7,15077,837,0,1
47,2309,1457,730,1242,11,6,188,1468,10,292,166,329,302,495,2424,4078,5,22973,1276,1,1
276,5455,1457,730,1242,11,6,188,1468,10,292,166,329,302,495,2424,4078,5,22973,1276,1,0
276,5455,74,35,59,1,0,14,75,3,14,7,14,17,21,58,85,1,128,7,0,0
276,5455,245,125,200,5,7,34,250,7,30,17,34,37,51,166,265,3,1053,58,0,0
170,3910,77,34,69,0,0,8,77,3,24,16,29,27,45,114,213,1,387,21,0,0
170,3910,712,438,573,51,9,84,763,14,102,71,128,116,199,733,1364,8,11988,666,0,0
273,5403,1457,730,1242,11,6,188,1468,10,292,166,329,302,495,2424,4078,5,22973,1276,1,1
273,5403,74,35,59,1,0,14,75,3,14,7,14,17,21,58,85,1,128,7,0,1
273,5403,245,125,200,5,7,34,250,7,30,17,34,37,51,166,265,3,1053,58,0,1
171,3942,77,34,69,0,0,8,77,3,24,16,29,27,45,114,213,1,387,21,0,1
171,3942,712,438,573,51,9,84,763,14,102,71,128,116,199,733,1364,8,11988,666,0,1
273,5395,1457,730,1242,11,6,188,1468,10,292,166,329,302,495,2424,4078,5,22973,1276,1,1
273,5395,74,35,59,1,0,14,75,3,14,7,14,17,21,58,85,1,128,7,0,1
273,5395,245,125,200,5,7,34,250,7,30,17,34,37,51,166,265,3,1053,58,0,1
267,5292,1457,730,1242,11,6,188,1468,10,292,166,329,302,495,2424,4078,5,22973,1276,1,0
267,5292,74,35,59,1,0,14,75,3,14,7,14,17,21,58,85,1,128,7,0,0
267,5292,245,125,200,5,7,34,250,7,30,17,34,37,51,166,265,3,1053,58,0,0
267,5310,1457,730,1242,11,6,188,1468,10,292,166,329,302,495,2424,4078,5,22973,1276,1,1
267,5310,74,35,59,1,0,14,75,3,14,7,14,17,21,58,85,1,128,7,0,1
267,5310,245,125,200,5,7,34,250,7,30,17,34,37,51,166,265,3,1053,58,0,1
270,5415,1457,730,1242,11,6,188,1468,10,292,166,329,302,495,2424,4078,5,22973,1276,1,1
270,5415,74,35,59,1,0,14,75,3,14,7,14,17,21,58,85,1,128,7,0,1
270,5415,245,125,200,5,7,34,250,7,30,17,34,37,51,166,265,3,1053,58,0,1
169,3534,1943,715,1694,26,18,214,1969,12,185,120,237,197,357,1436,2721,7,20915,1161,0,1
169,3534,1168,838,957,57,25,144,1225,19,348,224,416,367,640,3018,5452,11,61921,3440,1,1
38,708,127,75,83,2,11,30,129,4,14,7,14,18,21,61,87,2,175,9,0,1
38,708,652,304,544,16,6,88,668,6,89,51,101,95,152,591,998,3,3399,188,0,1
38,708,2,2,2,0,0,0,2,0,0,0,0,0,0,0,0,0,0,0,0,1
38,708,8,5,5,0,0,3,8,0,0,0,0,0,0,0,0,0,0,0,0,1
38,708,14,8,8,0,0,6,14,0,0,0,0,0,0,0,0,0,0,0,0,1
38,708,6,4,4,0,0,2,6,0,0,0,0,0,0,0,0,0,0,0,0,1
38,708,6,4,4,0,0,2,6,1,2,1,2,3,3,2,4,0,2,0,0,1
38,708,7,5,5,0,0,2,7,0,0,0,0,0,0,0,0,0,0,0,0,1
38,708,10,6,6,0,0,4,10,0,0,0,0,0,0,0,0,0,0,0,0,1
38,708,1,1,1,0,0,0,1,0,0,0,0,0,0,0,0,0,0,0,0,1
38,708,14,10,10,0,0,4,14,1,1,1,1,2,2,0,2,0,1,0,0,1
38,708,46,26,30,3,0,12,49,3,6,3,6,9,9,20,28,1,42,2,0,1
271,5435,1457,730,1242,11,6,188,1468,10,292,166,329,302,495,2424,4078,5,22973,1276,1,0
271,5435,74,35,59,1,0,14,75,3,14,7,14,17,21,58,85,1,128,7,0,0
271,5435,245,125,200,5,7,34,250,7,30,17,34,37,51,166,265,3,1053,58,0,0
46,518,647,139,84,35,284,233,682,0,0,0,0,0,0,0,0,0,0,0,0,0
171,3942,77,34,69,0,0,8,77,3,24,16,29,27,45,114,213,1,387,21,0,0
171,3942,712,438,573,51,9,84,763,14,102,71,128,116,199,733,1364,8,11988,666,0,0
175,4047,722,423,573,19,0,135,741,12,172,101,199,184,300,1320,2257,6,15668,870,0,0
175,4047,1508,847,911,44,250,301,1552,14,148,88,169,162,257,1120,1886,7,15077,837,0,0
465,10193,72,33,56,0,4,12,72,1,1,1,1,2,2,0,2,0,1,0,0,0
465,10193,1454,835,1044,76,110,219,1530,17,275,158,296,292,454,2297,3718,9,34017,1889,1,0
169,3534,1943,715,1694,26,18,214,1969,12,185,120,237,197,357,1436,2721,7,20915,1161,0,0
169,3534,1168,838,957,57,25,144,1225,19,348,224,416,367,640,3018,5452,11,61921,3440,1,0
38,708,127,75,83,2,11,30,129,4,14,7,14,18,21,61,87,2,175,9,0,0
38,708,652,304,544,16,6,88,668,6,89,51,101,95,152,591,998,3,3399,188,0,0
38,708,2,2,2,0,0,0,2,0,0,0,0,0,0,0,0,0,0,0,0,0
38,708,8,5,5,0,0,3,8,0,0,0,0,0,0,0,0,0,0,0,0,0
38,708,14,8,8,0,0,6,14,0,0,0,0,0,0,0,0,0,0,0,0,0
38,708,6,4,4,0,0,2,6,0,0,0,0,0,0,0,0,0,0,0,0,0
38,708,6,4,4,0,0,2,6,1,2,1,2,3,3,2,4,0,2,0,0,0
38,708,7,5,5,0,0,2,7,0,0,0,0,0,0,0,0,0,0,0,0,0
38,708,10,6,6,0,0,4,10,0,0,0,0,0,0,0,0,0,0,0,0,0
38,708,1,1,1,0,0,0,1,0,0,0,0,0,0,0,0,0,0,0,0,0
38,708,14,10,10,0,0,4,14,1,1,1,1,2,2,0,2,0,1,0,0,0
38,708,46,26,30,3,0,12,49,3,6,3,6,9,9,20,28,1,42,2,0,0
47,2309,1457,730,1242,11,6,188,1468,10,292,166,329,302,495,2424,4078,5,22973,1276,1,0
176,4105,722,423,573,19,0,135,741,12,172,101,199,184,300,1320,2257,6,15668,870,0,1
176,4105,1508,847,911,44,250,301,1552,14,148,88,169,162,257,1120,1886,7,15077,837,0,1
66,3580,1782,648,1425,9,47,279,1791,8,171,97,189,179,286,1292,2140,4,9462,525,0,1
47,2312,1457,730,1242,11,6,188,1468,10,292,166,329,302,495,2424,4078,5,22973,1276,1,1
17,526,424,94,331,4,0,89,428,1,5,5,5,6,10,11,25,0,12,0,0,1
176,4105,722,423,573,19,0,135,741,12,172,101,199,184,300,1320,2257,6,15668,870,0,0
176,4105,1508,847,911,44,250,301,1552,14,148,88,169,162,257,1120,1886,7,15077,837,0,0
66,3580,1782,648,1425,9,47,279,1791,8,171,97,189,179,286,1292,2140,4,9462,525,0,0
47,2312,1457,730,1242,11,6,188,1468,10,292,166,329,302,495,2424,4078,5,22973,1276,1,0
17,526,424,94,331,4,0,89,428,1,5,5,5,6,10,11,25,0,12,0,0,0
273,5456,1457,730,1242,11,6,188,1468,10,292,166,329,302,495,2424,4078,5,22973,1276,1,1
273,5456,74,35,59,1,0,14,75,3,14,7,14,17,21,58,85,1,128,7,0,1
273,5456,245,125,200,5,7,34,250,7,30,17,34,37,51,166,265,3,1053,58,0,1
170,3908,77,34,69,0,0,8,77,3,24,16,29,27,45,114,213,1,387,21,0,1
170,3908,712,438,573,51,9,84,763,14,102,71,128,116,199,733,1364,8,11988,666,0,1
180,4204,722,423,573,19,0,135,741,12,172,101,199,184,300,1320,2257,6,15668,870,0,1
180,4204,1508,847,911,44,250,301,1552,14,148,88,169,162,257,1120,1886,7,15077,837,0,1
66,3569,1782,648,1425,9,47,279,1791,8,171,97,189,179,286,1292,2140,4,9462,525,0,1
17,522,424,94,331,4,0,89,428,1,5,5,5,6,10,11,25,0,12,0,0,1
276,5499,1457,730,1242,11,6,188,1468,10,292,166,329,302,495,2424,4078,5,22973,1276,1,1
276,5499,74,35,59,1,0,14,75,3,14,7,14,17,21,58,85,1,128,7,0,1
276,5499,245,125,200,5,7,34,250,7,30,17,34,37,51,166,265,3,1053,58,0,1
181,4293,722,423,573,19,0,135,741,12,172,101,199,184,300,1320,2257,6,15668,870,0,1
181,4293,1508,847,911,44,250,301,1552,14,148,88,169,162,257,1120,1886,7,15077,837,0,1
1,88,13,10,10,0,0,3,13,1,2,1,2,3,3,2,4,0,2,0,0,1
66,2732,1289,550,1043,56,32,155,1345,10,167,93,185,177,278,1266,2075,5,11498,638,0,1
39,715,127,75,83,2,11,30,129,4,14,7,14,18,21,61,87,2,175,9,0,1
39,715,652,304,544,16,6,88,668,6,89,51,101,95,152,591,998,3,3399,188,0,1
39,715,2,2,2,0,0,0,2,0,0,0,0,0,0,0,0,0,0,0,0,1
39,715,8,5,5,0,0,3,8,0,0,0,0,0,0,0,0,0,0,0,0,1
39,715,14,8,8,0,0,6,14,0,0,0,0,0,0,0,0,0,0,0,0,1
39,715,6,4,4,0,0,2,6,0,0,0,0,0,0,0,0,0,0,0,0,1
39,715,6,4,4,0,0,2,6,1,2,1,2,3,3,2,4,0,2,0,0,1
39,715,7,5,5,0,0,2,7,0,0,0,0,0,0,0,0,0,0,0,0,1
39,715,10,6,6,0,0,4,10,0,0,0,0,0,0,0,0,0,0,0,0,1
39,715,1,1,1,0,0,0,1,0,0,0,0,0,0,0,0,0,0,0,0,1
39,715,14,10,10,0,0,4,14,1,1,1,1,2,2,0,2,0,1,0,0,1
39,715,46,26,30,3,0,12,49,3,6,3,6,9,9,20,28,1,42,2,0,1
65,3081,1338,495,1086,10,64,173,1348,11,122,82,157,133,239,883,1686,7,11934,663,0,1
136,6023,139,89,101,2,0,35,141,7,54,34,62,61,96,330,569,4,2287,127,0,1
136,6023,7,5,5,0,0,2,7,1,2,1,2,3,3,2,4,0,2,0,0,1
132,3414,1660,832,1314,41,38,274,1701,20,312,209,395,332,604,2671,5058,12,64042,3557,1,1
47,2814,1296,573,1062,40,33,157,1336,8,201,118,231,209,349,1561,2689,4,12365,686,0,1
28,1176,1455,414,1257,16,76,112,1471,5,41,23,46,46,69,231,381,2,1069,59,0,1
31,1169,1293,570,1093,25,15,163,1318,10,195,123,241,205,364,1516,2795,6,17273,959,0,1
24,961,373,158,315,8,0,51,381,5,76,44,79,81,123,486,779,2,2026,112,0,1
211,4765,722,423,573,19,0,135,741,12,172,101,199,184,300,1320,2257,6,15668,870,0,1
211,4765,1508,847,911,44,250,301,1552,14,148,88,169,162,257,1120,1886,7,15077,837,0,1
66,2728,1289,550,1043,56,32,155,1345,10,167,93,185,177,278,1266,2075,5,11498,638,0,1
132,3410,1660,832,1314,41,38,274,1701,20,312,209,395,332,604,2671,5058,12,64042,3557,1,1
111,4256,1513,682,1277,25,13,200,1538,11,199,116,219,210,335,1557,2584,6,15641,868,0,1
28,1174,1455,414,1257,16,76,112,1471,5,41,23,46,46,69,231,381,2,1069,59,0,1
32,1211,1293,570,1093,25,15,163,1318,10,195,123,241,205,364,1516,2795,6,17273,959,0,1
14,581,722,423,573,19,0,135,741,12,172,101,199,184,300,1320,2257,6,15668,870,0,1
276,5499,1457,730,1242,11,6,188,1468,10,292,166,329,302,495,2424,4078,5,22973,1276,1,0
276,5499,74,35,59,1,0,14,75,3,14,7,14,17,21,58,85,1,128,7,0,0
276,5499,245,125,200,5,7,34,250,7,30,17,34,37,51,166,265,3,1053,58,0,0
170,3908,77,34,69,0,0,8,77,3,24,16,29,27,45,114,213,1,387,21,0,0
170,3908,712,438,573,51,9,84,763,14,102,71,128,116,199,733,1364,8,11988,666,0,0
211,4765,722,423,573,19,0,135,741,12,172,101,199,184,300,1320,2257,6,15668,870,0,0
211,4765,1508,847,911,44,250,301,1552,14,148,88,169,162,257,1120,1886,7,15077,837,0,0
1,88,13,10,10,0,0,3,13,1,2,1,2,3,3,2,4,0,2,0,0,0
66,2728,1289,550,1043,56,32,155,1345,10,167,93,185,177,278,1266,2075,5,11498,638,0,0
65,3081,1338,495,1086,10,64,173,1348,11,122,82,157,133,239,883,1686,7,11934,663,0,0
136,6023,139,89,101,2,0,35,141,7,54,34,62,61,96,330,569,4,2287,127,0,0
136,6023,7,5,5,0,0,2,7,1,2,1,2,3,3,2,4,0,2,0,0,0
66,3569,1782,648,1425,9,47,279,1791,8,171,97,189,179,286,1292,2140,4,9462,525,0,0
132,3410,1660,832,1314,41,38,274,1701,20,312,209,395,332,604,2671,5058,12,64042,3557,1,0
111,4256,1513,682,1277,25,13,200,1538,11,199,116,219,210,335,1557,2584,6,15641,868,0,0
47,2814,1296,573,1062,40,33,157,1336,8,201,118,231,209,349,1561,2689,4,12365,686,0,0
28,1174,1455,414,1257,16,76,112,1471,5,41,23,46,46,69,231,381,2,1069,59,0,0
17,522,424,94,331,4,0,89,428,1,5,5,5,6,10,11,25,0,12,0,0,0
32,1211,1293,570,1093,25,15,163,1318,10,195,123,241,205,364,1516,2795,6,17273,959,0,0
14,581,722,423,573,19,0,135,741,12,172,101,199,184,300,1320,2257,6,15668,870,0,0
24,961,373,158,315,8,0,51,381,5,76,44,79,81,123,486,779,2,2026,112,0,0
276,5497,1457,730,1242,11,6,188,1468,10,292,166,329,302,495,2424,4078,5,22973,1276,1,1
276,5497,74,35,59,1,0,14,75,3,14,7,14,17,21,58,85,1,128,7,0,1
276,5497,245,125,200,5,7,34,250,7,30,17,34,37,51,166,265,3,1053,58,0,1
46,516,647,139,84,35,284,233,682,0,0,0,0,0,0,0,0,0,0,0,0,1
211,4763,722,423,573,19,0,135,741,12,172,101,199,184,300,1320,2257,6,15668,870,0,1
211,4763,1508,847,911,44,250,301,1552,14,148,88,169,162,257,1120,1886,7,15077,837,0,1
468,10239,72,33,56,0,4,12,72,1,1,1,1,2,2,0,2,0,1,0,0,1
468,10239,1454,835,1044,76,110,219,1530,17,275,158,296,292,454,2297,3718,9,34017,1889,1,1
20,617,42,7,35,4,0,5,46,1,2,1,2,3,3,2,4,0,2,0,0,1
20,617,11,6,10,0,0,1,11,2,4,2,4,6,6,10,15,1,15,0,0,1
31,1709,384,251,317,7,8,52,391,11,70,44,84,81,128,467,811,6,5355,297,0,1
283,5665,1457,730,1242,11,6,188,1468,10,292,166,329,302,495,2424,4078,5,22973,1276,1,1
283,5665,74,35,59,1,0,14,75,3,14,7,14,17,21,58,85,1,128,7,0,1
283,5665,245,125,200,5,7,34,250,7,30,17,34,37,51,166,265,3,1053,58,0,1
46,522,647,139,84,35,284,233,682,0,0,0,0,0,0,0,0,0,0,0,0,1
47,2318,1457,730,1242,11,6,188,1468,10,292,166,329,302,495,2424,4078,5,22973,1276,1,1
85,1873,477,336,357,30,23,73,507,16,194,134,250,210,384,1538,2962,10,30538,1696,0,0
134,3458,1660,832,1314,41,38,274,1701,20,312,209,395,332,604,2671,5058,12,64042,3557,1,0
134,3451,1660,832,1314,41,38,274,1701,20,312,209,395,332,604,2671,5058,12,64042,3557,1,0
43,863,447,308,343,6,5,95,453,7,96,59,111,103,170,651,1136,4,4600,255,0,0
43,863,322,174,179,16,74,51,338,10,41,26,46,51,72,252,408,5,2291,127,0,0
44,1315,1523,757,1297,19,12,193,1542,12,193,117,230,205,347,1508,2664,7,19053,1058,0,0
44,1315,701,378,504,33,58,109,734,13,110,68,126,123,194,794,1346,7,10027,557,0,0
284,5669,1457,730,1242,11,6,188,1468,10,292,166,329,302,495,2424,4078,5,22973,1276,1,0
284,5669,74,35,59,1,0,14,75,3,14,7,14,17,21,58,85,1,128,7,0,0
284,5669,245,125,200,5,7,34,250,7,30,17,34,37,51,166,265,3,1053,58,0,0
284,5694,1457,730,1242,11,6,188,1468,10,292,166,329,302,495,2424,4078,5,22973,1276,1,1
284,5694,74,35,59,1,0,14,75,3,14,7,14,17,21,58,85,1,128,7,0,1
284,5694,245,125,200,5,7,34,250,7,30,17,34,37,51,166,265,3,1053,58,0,1
23,749,74,35,59,1,0,14,75,3,14,7,14,17,21,58,85,1,128,7,0,1
23,749,245,125,200,5,7,34,250,7,30,17,34,37,51,166,265,3,1053,58,0,1
169,3542,1943,715,1694,26,18,214,1969,12,185,120,237,197,357,1436,2721,7,20915,1161,0,1
169,3542,1168,838,957,57,25,144,1225,19,348,224,416,367,640,3018,5452,11,61921,3440,1,1
8,259,74,35,59,1,0,14,75,3,14,7,14,17,21,58,85,1,128,7,0,1
62,2698,1943,715,1694,26,18,214,1969,12,185,120,237,197,357,1436,2721,7,20915,1161,0,1
111,2266,1513,682,1277,25,13,200,1538,11,199,116,219,210,335,1557,2584,6,15641,868,0,1
111,2266,819,519,539,24,98,155,843,15,96,57,106,111,163,690,1107,8,9171,509,0,1
284,5696,1457,730,1242,11,6,188,1468,10,292,166,329,302,495,2424,4078,5,22973,1276,1,1
284,5696,74,35,59,1,0,14,75,3,14,7,14,17,21,58,85,1,128,7,0,1
284,5696,245,125,200,5,7,34,250,7,30,17,34,37,51,166,265,3,1053,58,0,1
23,374,424,94,331,4,0,89,428,1,5,5,5,6,10,11,25,0,12,0,0,1
23,374,38,23,23,6,0,8,44,3,11,7,11,14,18,42,68,1,102,5,0,1
16,477,184,100,137,2,15,30,186,6,38,20,39,44,59,214,322,3,991,55,0,1
16,477,103,65,74,8,5,16,111,7,17,9,17,24,26,89,119,3,417,23,0,1
83,1510,1178,367,1042,6,15,115,1184,9,94,51,95,103,146,644,976,4,4439,246,0,1
83,1510,177,108,140,8,0,27,185,6,30,16,32,36,48,162,248,3,794,44,0,1
51,1018,1098,241,925,5,10,155,1103,7,46,25,49,53,74,273,423,3,1580,87,0,1
51,1018,282,202,222,14,2,44,296,8,42,24,43,50,67,250,378,4,1548,86,0,1
212,4789,722,423,573,19,0,135,741,12,172,101,199,184,300,1320,2257,6,15668,870,0,1
212,4789,1508,847,911,44,250,301,1552,14,148,88,169,162,257,1120,1886,7,15077,837,0,1
284,5696,1457,730,1242,11,6,188,1468,10,292,166,329,302,495,2424,4078,5,22973,1276,1,0
284,5696,74,35,59,1,0,14,75,3,14,7,14,17,21,58,85,1,128,7,0,0
284,5696,245,125,200,5,7,34,250,7,30,17,34,37,51,166,265,3,1053,58,0,0
46,522,647,139,84,35,284,233,682,0,0,0,0,0,0,0,0,0,0,0,0,0
212,4789,722,423,573,19,0,135,741,12,172,101,199,184,300,1320,2257,6,15668,870,0,0
212,4789,1508,847,911,44,250,301,1552,14,148,88,169,162,257,1120,1886,7,15077,837,0,0
468,10239,72,33,56,0,4,12,72,1,1,1,1,2,2,0,2,0,1,0,0,0
468,10239,1454,835,1044,76,110,219,1530,17,275,158,296,292,454,2297,3718,9,34017,1889,1,0
169,3542,1943,715,1694,26,18,214,1969,12,185,120,237,197,357,1436,2721,7,20915,1161,0,0
169,3542,1168,838,957,57,25,144,1225,19,348,224,416,367,640,3018,5452,11,61921,3440,1,0
20,617,42,7,35,4,0,5,46,1,2,1,2,3,3,2,4,0,2,0,0,0
20,617,11,6,10,0,0,1,11,2,4,2,4,6,6,10,15,1,15,0,0,0
47,2318,1457,730,1242,11,6,188,1468,10,292,166,329,302,495,2424,4078,5,22973,1276,1,0
8,259,74,35,59,1,0,14,75,3,14,7,14,17,21,58,85,1,128,7,0,0
31,1709,384,251,317,7,8,52,391,11,70,44,84,81,128,467,811,6,5355,297,0,0
62,2698,1943,715,1694,26,18,214,1969,12,185,120,237,197,357,1436,2721,7,20915,1161,0,0
216,4821,722,423,573,19,0,135,741,12,172,101,199,184,300,1320,2257,6,15668,870,0,1
216,4821,1508,847,911,44,250,301,1552,14,148,88,169,162,257,1120,1886,7,15077,837,0,1
62,2705,1943,715,1694,26,18,214,1969,12,185,120,237,197,357,1436,2721,7,20915,1161,0,1
216,4821,722,423,573,19,0,135,741,12,172,101,199,184,300,1320,2257,6,15668,870,0,0
216,4821,1508,847,911,44,250,301,1552,14,148,88,169,162,257,1120,1886,7,15077,837,0,0
62,2705,1943,715,1694,26,18,214,1969,12,185,120,237,197,357,1436,2721,7,20915,1161,0,0
216,4831,722,423,573,19,0,135,741,12,172,101,199,184,300,1320,2257,6,15668,870,0,1
216,4831,1508,847,911,44,250,301,1552,14,148,88,169,162,257,1120,1886,7,15077,837,0,1
44,872,447,308,343,6,5,95,453,7,96,59,111,103,170,651,1136,4,4600,255,0,1
44,872,322,174,179,16,74,51,338,10,41,26,46,51,72,252,408,5,2291,127,0,1
34,1509,447,308,343,6,5,95,453,7,96,59,111,103,170,651,1136,4,4600,255,0,1
169,3532,1943,715,1694,26,18,214,1969,12,185,120,237,197,357,1436,2721,7,20915,1161,0,1
169,3532,1168,838,957,57,25,144,1225,19,348,224,416,367,640,3018,5452,11,61921,3440,1,1
44,872,447,308,343,6,5,95,453,7,96,59,111,103,170,651,1136,4,4600,255,0,0
44,872,322,174,179,16,74,51,338,10,41,26,46,51,72,252,408,5,2291,127,0,0
34,1509,447,308,343,6,5,95,453,7,96,59,111,103,170,651,1136,4,4600,255,0,0
216,4831,722,423,573,19,0,135,741,12,172,101,199,184,300,1320,2257,6,15668,870,0,0
216,4831,1508,847,911,44,250,301,1552,14,148,88,169,162,257,1120,1886,7,15077,837,0,0
141,4443,1660,832,1314,41,38,274,1701,20,312,209,395,332,604,2671,5058,12,64042,3557,1,0
141,4443,1057,646,719,113,100,145,1170,18,215,134,248,233,382,1740,3004,10,31186,1732,1,0
45,1333,1523,757,1297,19,12,193,1542,12,193,117,230,205,347,1508,2664,7,19053,1058,0,0
45,1333,701,378,504,33,58,109,734,13,110,68,126,123,194,794,1346,7,10027,557,0,0
29,1210,1455,414,1257,16,76,112,1471,5,41,23,46,46,69,231,381,2,1069,59,0,0
29,1211,1455,414,1257,16,76,112,1471,5,41,23,46,46,69,231,381,2,1069,59,0,0
44,1325,1523,757,1297,19,12,193,1542,12,193,117,230,205,347,1508,2664,7,19053,1058,0,0
44,1325,701,378,504,33,58,109,734,13,110,68,126,123,194,794,1346,7,10027,557,0,0
29,1226,1455,414,1257,16,76,112,1471,5,41,23,46,46,69,231,381,2,1069,59,0,0
44,1343,1523,757,1297,19,12,193,1542,12,193,117,230,205,347,1508,2664,7,19053,1058,0,0
44,1343,701,378,504,33,58,109,734,13,110,68,126,123,194,794,1346,7,10027,557,0,0
30,635,215,129,180,6,0,29,221,8,65,43,72,73,115,415,711,4,3153,175,0,0
30,635,97,69,77,3,3,16,100,6,22,13,23,28,36,113,173,3,542,30,0,0
41,2532,1523,757,1297,19,12,193,1542,12,193,117,230,205,347,1508,2664,7,19053,1058,0,0
16,1260,215,129,180,6,0,29,221,8,65,43,72,73,115,415,711,4,3153,175,0,0
45,1361,1523,757,1297,19,12,193,1542,12,193,117,230,205,347,1508,2664,7,19053,1058,0,0
45,1361,701,378,504,33,58,109,734,13,110,68,126,123,194,794,1346,7,10027,557,0,0
41,2533,1523,757,1297,19,12,193,1542,12,193,117,230,205,347,1508,2664,7,19053,1058,0,0
16,1261,215,129,180,6,0,29,221,8,65,43,72,73,115,415,711,4,3153,175,0,0
46,1369,1523,757,1297,19,12,193,1542,12,193,117,230,205,347,1508,2664,7,19053,1058,0,0
46,1369,701,378,504,33,58,109,734,13,110,68,126,123,194,794,1346,7,10027,557,0,0
86,1567,1178,367,1042,6,15,115,1184,9,94,51,95,103,146,644,976,4,4439,246,0,1
86,1567,177,108,140,8,0,27,185,6,30,16,32,36,48,162,248,3,794,44,0,1
47,2042,1178,367,1042,6,15,115,1184,9,94,51,95,103,146,644,976,4,4439,246,0,1
51,1035,1098,241,925,5,10,155,1103,7,46,25,49,53,74,273,423,3,1580,87,0,1
51,1035,282,202,222,14,2,44,296,8,42,24,43,50,67,250,378,4,1548,86,0,1
37,1422,1098,241,925,5,10,155,1103,7,46,25,49,53,74,273,423,3,1580,87,0,1
86,1567,1178,367,1042,6,15,115,1184,9,94,51,95,103,146,644,976,4,4439,246,0,0
86,1567,177,108,140,8,0,27,185,6,30,16,32,36,48,162,248,3,794,44,0,0
51,1035,1098,241,925,5,10,155,1103,7,46,25,49,53,74,273,423,3,1580,87,0,0
51,1035,282,202,222,14,2,44,296,8,42,24,43,50,67,250,378,4,1548,86,0,0
47,2042,1178,367,1042,6,15,115,1184,9,94,51,95,103,146,644,976,4,4439,246,0,0
37,1422,1098,241,925,5,10,155,1103,7,46,25,49,53,74,273,423,3,1580,87,0,0
86,1573,1178,367,1042,6,15,115,1184,9,94,51,95,103,146,644,976,4,4439,246,0,0
86,1573,177,108,140,8,0,27,185,6,30,16,32,36,48,162,248,3,794,44,0,0
51,1041,1098,241,925,5,10,155,1103,7,46,25,49,53,74,273,423,3,1580,87,0,0
51,1041,282,202,222,14,2,44,296,8,42,24,43,50,67,250,378,4,1548,86,0,0
469,10259,72,33,56,0,4,12,72,1,1,1,1,2,2,0,2,0,1,0,0,1
469,10259,1454,835,1044,76,110,219,1530,17,275,158,296,292,454,2297,3718,9,34017,1889,1,1
88,1912,477,336,357,30,23,73,507,16,194,134,250,210,384,1538,2962,10,30538,1696,0,1
72,2650,1450,624,1228,12,26,181,1462,14,306,186,354,320,540,2580,4493,8,36391,2021,1,1
88,1912,477,336,357,30,23,73,507,16,194,134,250,210,384,1538,2962,10,30538,1696,0,0
72,2650,1450,624,1228,12,26,181,1462,14,306,186,354,320,540,2580,4493,8,36391,2021,1,0
469,10259,72,33,56,0,4,12,72,1,1,1,1,2,2,0,2,0,1,0,0,0
469,10259,1454,835,1044,76,110,219,1530,17,275,158,296,292,454,2297,3718,9,34017,1889,1,0
11,239,256,139,192,9,7,47,265,4,23,12,24,27,36,112,171,2,357,19,0,0
285,5722,1457,730,1242,11,6,188,1468,10,292,166,329,302,495,2424,4078,5,22973,1276,1,1
285,5722,74,35,59,1,0,14,75,3,14,7,14,17,21,58,85,1,128,7,0,1
285,5722,245,125,200,5,7,34,250,7,30,17,34,37,51,166,265,3,1053,58,0,1
170,3930,77,34,69,0,0,8,77,3,24,16,29,27,45,114,213,1,387,21,0,1
170,3930,712,438,573,51,9,84,763,14,102,71,128,116,199,733,1364,8,11988,666,0,1
30,1892,652,304,544,16,6,88,668,6,89,51,101,95,152,591,998,3,3399,188,0,1
30,1961,652,304,544,16,6,88,668,6,89,51,101,95,152,591,998,3,3399,188,0,0
285,5716,1457,730,1242,11,6,188,1468,10,292,166,329,302,495,2424,4078,5,22973,1276,1,0
285,5716,74,35,59,1,0,14,75,3,14,7,14,17,21,58,85,1,128,7,0,0
285,5716,245,125,200,5,7,34,250,7,30,17,34,37,51,166,265,3,1053,58,0,0
38,712,127,75,83,2,11,30,129,4,14,7,14,18,21,61,87,2,175,9,0,1
38,712,652,304,544,16,6,88,668,6,89,51,101,95,152,591,998,3,3399,188,0,1
38,712,2,2,2,0,0,0,2,0,0,0,0,0,0,0,0,0,0,0,0,1
38,712,8,5,5,0,0,3,8,0,0,0,0,0,0,0,0,0,0,0,0,1
38,712,14,8,8,0,0,6,14,0,0,0,0,0,0,0,0,0,0,0,0,1
38,712,6,4,4,0,0,2,6,0,0,0,0,0,0,0,0,0,0,0,0,1
38,712,6,4,4,0,0,2,6,1,2,1,2,3,3,2,4,0,2,0,0,1
38,712,7,5,5,0,0,2,7,0,0,0,0,0,0,0,0,0,0,0,0,1
38,712,10,6,6,0,0,4,10,0,0,0,0,0,0,0,0,0,0,0,0,1
38,712,1,1,1,0,0,0,1,0,0,0,0,0,0,0,0,0,0,0,0,1
38,712,14,10,10,0,0,4,14,1,1,1,1,2,2,0,2,0,1,0,0,1
38,712,46,26,30,3,0,12,49,3,6,3,6,9,9,20,28,1,42,2,0,1
470,10279,72,33,56,0,4,12,72,1,1,1,1,2,2,0,2,0,1,0,0,0
470,10279,1454,835,1044,76,110,219,1530,17,275,158,296,292,454,2297,3718,9,34017,1889,1,0
29,1872,652,304,544,16,6,88,668,6,89,51,101,95,152,591,998,3,3399,188,0,0
170,3930,77,34,69,0,0,8,77,3,24,16,29,27,45,114,213,1,387,21,0,0
170,3930,712,438,573,51,9,84,763,14,102,71,128,116,199,733,1364,8,11988,666,0,0
30,1903,652,304,544,16,6,88,668,6,89,51,101,95,152,591,998,3,3399,188,0,0
286,5730,1457,730,1242,11,6,188,1468,10,292,166,329,302,495,2424,4078,5,22973,1276,1,1
286,5730,74,35,59,1,0,14,75,3,14,7,14,17,21,58,85,1,128,7,0,1
286,5730,245,125,200,5,7,34,250,7,30,17,34,37,51,166,265,3,1053,58,0,1
67,2756,1289,550,1043,56,32,155,1345,10,167,93,185,177,278,1266,2075,5,11498,638,0,1
12,397,386,256,301,16,9,68,402,4,59,35,69,63,104,355,621,2,1453,80,0,0
12,442,386,256,301,16,9,68,402,4,59,35,69,63,104,355,621,2,1453,80,0,0
170,3536,1943,715,1694,26,18,214,1969,12,185,120,237,197,357,1436,2721,7,20915,1161,0,1
170,3536,1168,838,957,57,25,144,1225,19,348,224,416,367,640,3018,5452,11,61921,3440,1,1
63,3152,1943,715,1694,26,18,214,1969,12,185,120,237,197,357,1436,2721,7,20915,1161,0,1
63,3178,1943,715,1694,26,18,214,1969,12,185,120,237,197,357,1436,2721,7,20915,1161,0,0
63,3215,1943,715,1694,26,18,214,1969,12,185,120,237,197,357,1436,2721,7,20915,1161,0,0
172,3552,1943,715,1694,26,18,214,1969,12,185,120,237,197,357,1436,2721,7,20915,1161,0,0
172,3552,1168,838,957,57,25,144,1225,19,348,224,416,367,640,3018,5452,11,61921,3440,1,0
173,3560,1943,715,1694,26,18,214,1969,12,185,120,237,197,357,1436,2721,7,20915,1161,0,0
173,3560,1168,838,957,57,25,144,1225,19,348,224,416,367,640,3018,5452,11,61921,3440,1,0
63,3215,1943,715,1694,26,18,214,1969,12,185,120,237,197,357,1436,2721,7,20915,1161,0,1
47,1407,1523,757,1297,19,12,193,1542,12,193,117,230,205,347,1508,2664,7,19053,1058,0,1
47,1407,701,378,504,33,58,109,734,13,110,68,126,123,194,794,1346,7,10027,557,0,1
41,2655,1523,757,1297,19,12,193,1542,12,193,117,230,205,347,1508,2664,7,19053,1058,0,1
47,1407,1523,757,1297,19,12,193,1542,12,193,117,230,205,347,1508,2664,7,19053,1058,0,0
47,1407,701,378,504,33,58,109,734,13,110,68,126,123,194,794,1346,7,10027,557,0,0
41,2655,1523,757,1297,19,12,193,1542,12,193,117,230,205,347,1508,2664,7,19053,1058,0,0
41,2660,1523,757,1297,19,12,193,1542,12,193,117,230,205,347,1508,2664,7,19053,1058,0,0
286,5730,1457,730,1242,11,6,188,1468,10,292,166,329,302,495,2424,4078,5,22973,1276,1,0
286,5730,74,35,59,1,0,14,75,3,14,7,14,17,21,58,85,1,128,7,0,0
286,5730,245,125,200,5,7,34,250,7,30,17,34,37,51,166,265,3,1053,58,0,0
67,2756,1289,550,1043,56,32,155,1345,10,167,93,185,177,278,1266,2075,5,11498,638,0,0
470,10280,72,33,56,0,4,12,72,1,1,1,1,2,2,0,2,0,1,0,0,1
470,10280,1454,835,1044,76,110,219,1530,17,275,158,296,292,454,2297,3718,9,34017,1889,1,1
470,10280,72,33,56,0,4,12,72,1,1,1,1,2,2,0,2,0,1,0,0,0
470,10280,1454,835,1044,76,110,219,1530,17,275,158,296,292,454,2297,3718,9,34017,1889,1,0
288,5751,1457,730,1242,11,6,188,1468,10,292,166,329,302,495,2424,4078,5,22973,1276,1,1
288,5751,74,35,59,1,0,14,75,3,14,7,14,17,21,58,85,1,128,7,0,1
288,5751,245,125,200,5,7,34,250,7,30,17,34,37,51,166,265,3,1053,58,0,1
170,3947,77,34,69,0,0,8,77,3,24,16,29,27,45,114,213,1,387,21,0,1
170,3947,712,438,573,51,9,84,763,14,102,71,128,116,199,733,1364,8,11988,666,0,1
53,2991,1296,573,1062,40,33,157,1336,8,201,118,231,209,349,1561,2689,4,12365,686,0,1
288,5813,1457,730,1242,11,6,188,1468,10,292,166,329,302,495,2424,4078,5,22973,1276,1,0
288,5813,74,35,59,1,0,14,75,3,14,7,14,17,21,58,85,1,128,7,0,0
288,5813,245,125,200,5,7,34,250,7,30,17,34,37,51,166,265,3,1053,58,0,0
48,2366,1457,730,1242,11,6,188,1468,10,292,166,329,302,495,2424,4078,5,22973,1276,1,0
288,5751,1457,730,1242,11,6,188,1468,10,292,166,329,302,495,2424,4078,5,22973,1276,1,0
288,5751,74,35,59,1,0,14,75,3,14,7,14,17,21,58,85,1,128,7,0,0
288,5751,245,125,200,5,7,34,250,7,30,17,34,37,51,166,265,3,1053,58,0,0
170,3947,77,34,69,0,0,8,77,3,24,16,29,27,45,114,213,1,387,21,0,0
170,3947,712,438,573,51,9,84,763,14,102,71,128,116,199,733,1364,8,11988,666,0,0
53,2991,1296,573,1062,40,33,157,1336,8,201,118,231,209,349,1561,2689,4,12365,686,0,0
290,5834,1457,730,1242,11,6,188,1468,10,292,166,329,302,495,2424,4078,5,22973,1276,1,0
290,5834,74,35,59,1,0,14,75,3,14,7,14,17,21,58,85,1,128,7,0,0
290,5834,245,125,200,5,7,34,250,7,30,17,34,37,51,166,265,3,1053,58,0,0
142,4468,1660,832,1314,41,38,274,1701,20,312,209,395,332,604,2671,5058,12,64042,3557,1,1
142,4468,1057,646,719,113,100,145,1170,18,215,134,248,233,382,1740,3004,10,31186,1732,1,1
135,3512,1660,832,1314,41,38,274,1701,20,312,209,395,332,604,2671,5058,12,64042,3557,1,1
468,10189,72,33,56,0,4,12,72,1,1,1,1,2,2,0,2,0,1,0,0,0
468,10189,1454,835,1044,76,110,219,1530,17,275,158,296,292,454,2297,3718,9,34017,1889,1,0
137,6066,139,89,101,2,0,35,141,7,54,34,62,61,96,330,569,4,2287,127,0,0
137,6066,7,5,5,0,0,2,7,1,2,1,2,3,3,2,4,0,2,0,0,0
142,4468,1660,832,1314,41,38,274,1701,20,312,209,395,332,604,2671,5058,12,64042,3557,1,0
142,4468,1057,646,719,113,100,145,1170,18,215,134,248,233,382,1740,3004,10,31186,1732,1,0
135,3512,1660,832,1314,41,38,274,1701,20,312,209,395,332,604,2671,5058,12,64042,3557,1,0
32,1014,1455,414,1257,16,76,112,1471,5,41,23,46,46,69,231,381,2,1069,59,0,1
32,1014,669,365,481,22,61,110,691,15,103,63,122,118,185,747,1273,8,11311,628,0,1
30,1250,1455,414,1257,16,76,112,1471,5,41,23,46,46,69,231,381,2,1069,59,0,1
32,1014,1455,414,1257,16,76,112,1471,5,41,23,46,46,69,231,381,2,1069,59,0,0
32,1014,669,365,481,22,61,110,691,15,103,63,122,118,185,747,1273,8,11311,628,0,0
30,1250,1455,414,1257,16,76,112,1471,5,41,23,46,46,69,231,381,2,1069,59,0,0
147,4753,1660,832,1314,41,38,274,1701,20,312,209,395,332,604,2671,5058,12,64042,3557,1,1
147,4753,1057,646,719,113,100,145,1170,18,215,134,248,233,382,1740,3004,10,31186,1732,1,1
147,4710,1660,832,1314,41,38,274,1701,20,312,209,395,332,604,2671,5058,12,64042,3557,1,0
147,4710,1057,646,719,113,100,145,1170,18,215,134,248,233,382,1740,3004,10,31186,1732,1,0
170,3950,77,34,69,0,0,8,77,3,24,16,29,27,45,114,213,1,387,21,0,1
170,3950,712,438,573,51,9,84,763,14,102,71,128,116,199,733,1364,8,11988,666,0,1
147,4716,1660,832,1314,41,38,274,1701,20,312,209,395,332,604,2671,5058,12,64042,3557,1,0
147,4716,1057,646,719,113,100,145,1170,18,215,134,248,233,382,1740,3004,10,31186,1732,1,0
216,4838,722,423,573,19,0,135,741,12,172,101,199,184,300,1320,2257,6,15668,870,0,1
216,4838,1508,847,911,44,250,301,1552,14,148,88,169,162,257,1120,1886,7,15077,837,0,1
13,397,442,244,305,14,16,103,456,11,68,45,75,79,120,452,756,6,4588,254,0,1
13,397,182,102,99,11,40,35,193,3,11,6,11,14,17,42,64,1,97,5,0,1
30,1907,652,304,544,16,6,88,668,6,89,51,101,95,152,591,998,3,3399,188,0,1
7,524,442,244,305,14,16,103,456,11,68,45,75,79,120,452,756,6,4588,254,0,1
147,4716,1660,832,1314,41,38,274,1701,20,312,209,395,332,604,2671,5058,12,64042,3557,1,1
147,4716,1057,646,719,113,100,145,1170,18,215,134,248,233,382,1740,3004,10,31186,1732,1,1
62,2551,1020,354,843,12,15,144,1032,8,134,77,144,142,221,970,1580,4,6792,377,0,1
12,410,442,244,305,14,16,103,456,11,68,45,75,79,120,452,756,6,4588,254,0,0
12,410,182,102,99,11,40,35,193,3,11,6,11,14,17,42,64,1,97,5,0,0
216,4838,722,423,573,19,0,135,741,12,172,101,199,184,300,1320,2257,6,15668,870,0,0
216,4838,1508,847,911,44,250,301,1552,14,148,88,169,162,257,1120,1886,7,15077,837,0,0
13,397,442,244,305,14,16,103,456,11,68,45,75,79,120,452,756,6,4588,254,0,0
13,397,182,102,99,11,40,35,193,3,11,6,11,14,17,42,64,1,97,5,0,0
30,1907,652,304,544,16,6,88,668,6,89,51,101,95,152,591,998,3,3399,188,0,0
7,524,442,244,305,14,16,103,456,11,68,45,75,79,120,452,756,6,4588,254,0,0
474,10327,72,33,56,0,4,12,72,1,1,1,1,2,2,0,2,0,1,0,0,1
474,10327,1454,835,1044,76,110,219,1530,17,275,158,296,292,454,2297,3718,9,34017,1889,1,1
65,2998,1338,495,1086,10,64,173,1348,11,122,82,157,133,239,883,1686,7,11934,663,0,1
473,10292,72,33,56,0,4,12,72,1,1,1,1,2,2,0,2,0,1,0,0,1
473,10292,1454,835,1044,76,110,219,1530,17,275,158,296,292,454,2297,3718,9,34017,1889,1,1
170,3950,77,34,69,0,0,8,77,3,24,16,29,27,45,114,213,1,387,21,0,0
170,3950,712,438,573,51,9,84,763,14,102,71,128,116,199,733,1364,8,11988,666,0,0
146,4728,1660,832,1314,41,38,274,1701,20,312,209,395,332,604,2671,5058,12,64042,3557,1,1
146,4728,1057,646,719,113,100,145,1170,18,215,134,248,233,382,1740,3004,10,31186,1732,1,1
146,4685,1660,832,1314,41,38,274,1701,20,312,209,395,332,604,2671,5058,12,64042,3557,1,0
146,4685,1057,646,719,113,100,145,1170,18,215,134,248,233,382,1740,3004,10,31186,1732,1,0
146,4691,1660,832,1314,41,38,274,1701,20,312,209,395,332,604,2671,5058,12,64042,3557,1,0
146,4691,1057,646,719,113,100,145,1170,18,215,134,248,233,382,1740,3004,10,31186,1732,1,0
250,5035,1457,730,1242,11,6,188,1468,10,292,166,329,302,495,2424,4078,5,22973,1276,1,1
250,5035,74,35,59,1,0,14,75,3,14,7,14,17,21,58,85,1,128,7,0,1
250,5035,245,125,200,5,7,34,250,7,30,17,34,37,51,166,265,3,1053,58,0,1
24,755,74,35,59,1,0,14,75,3,14,7,14,17,21,58,85,1,128,7,0,1
24,755,245,125,200,5,7,34,250,7,30,17,34,37,51,166,265,3,1053,58,0,1
68,1235,1020,354,843,12,15,144,1032,8,134,77,144,142,221,970,1580,4,6792,377,0,1
21,574,1293,570,1093,25,15,163,1318,10,195,123,241,205,364,1516,2795,6,17273,959,0,1
473,10297,72,33,56,0,4,12,72,1,1,1,1,2,2,0,2,0,1,0,0,1
473,10297,1454,835,1044,76,110,219,1530,17,275,158,296,292,454,2297,3718,9,34017,1889,1,1
166,3485,1943,715,1694,26,18,214,1969,12,185,120,237,197,357,1436,2721,7,20915,1161,0,1
166,3485,1168,838,957,57,25,144,1225,19,348,224,416,367,640,3018,5452,11,61921,3440,1,1
138,6100,139,89,101,2,0,35,141,7,54,34,62,61,96,330,569,4,2287,127,0,1
138,6100,7,5,5,0,0,2,7,1,2,1,2,3,3,2,4,0,2,0,0,1
90,1642,1178,367,1042,6,15,115,1184,9,94,51,95,103,146,644,976,4,4439,246,0,1
90,1642,177,108,140,8,0,27,185,6,30,16,32,36,48,162,248,3,794,44,0,1
48,2142,1178,367,1042,6,15,115,1184,9,94,51,95,103,146,644,976,4,4439,246,0,1
68,1233,1020,354,843,12,15,144,1032,8,134,77,144,142,221,970,1580,4,6792,377,0,0
21,572,1293,570,1093,25,15,163,1318,10,195,123,241,205,364,1516,2795,6,17273,959,0,0
90,1642,1178,367,1042,6,15,115,1184,9,94,51,95,103,146,644,976,4,4439,246,0,0
90,1642,177,108,140,8,0,27,185,6,30,16,32,36,48,162,248,3,794,44,0,0
48,2142,1178,367,1042,6,15,115,1184,9,94,51,95,103,146,644,976,4,4439,246,0,0
474,10313,72,33,56,0,4,12,72,1,1,1,1,2,2,0,2,0,1,0,0,1
474,10313,1454,835,1044,76,110,219,1530,17,275,158,296,292,454,2297,3718,9,34017,1889,1,1
90,1648,1178,367,1042,6,15,115,1184,9,94,51,95,103,146,644,976,4,4439,246,0,1
90,1648,177,108,140,8,0,27,185,6,30,16,32,36,48,162,248,3,794,44,0,1
13,436,442,244,305,14,16,103,456,11,68,45,75,79,120,452,756,6,4588,254,0,1
13,436,182,102,99,11,40,35,193,3,11,6,11,14,17,42,64,1,97,5,0,1
66,3113,1338,495,1086,10,64,173,1348,11,122,82,157,133,239,883,1686,7,11934,663,0,1
137,6064,139,89,101,2,0,35,141,7,54,34,62,61,96,330,569,4,2287,127,0,1
137,6064,7,5,5,0,0,2,7,1,2,1,2,3,3,2,4,0,2,0,0,1
12,442,386,256,301,16,9,68,402,4,59,35,69,63,104,355,621,2,1453,80,0,1
474,10299,72,33,56,0,4,12,72,1,1,1,1,2,2,0,2,0,1,0,0,1
474,10299,1454,835,1044,76,110,219,1530,17,275,158,296,292,454,2297,3718,9,34017,1889,1,1
37,1461,1098,241,925,5,10,155,1103,7,46,25,49,53,74,273,423,3,1580,87,0,1
16,482,184,100,137,2,15,30,186,6,38,20,39,44,59,214,322,3,991,55,0,0
16,482,103,65,74,8,5,16,111,7,17,9,17,24,26,89,119,3,417,23,0,0
16,480,184,100,137,2,15,30,186,6,38,20,39,44,59,214,322,3,991,55,0,0
16,480,103,65,74,8,5,16,111,7,17,9,17,24,26,89,119,3,417,23,0,0
474,10299,72,33,56,0,4,12,72,1,1,1,1,2,2,0,2,0,1,0,0,0
474,10299,1454,835,1044,76,110,219,1530,17,275,158,296,292,454,2297,3718,9,34017,1889,1,0
37,1461,1098,241,925,5,10,155,1103,7,46,25,49,53,74,273,423,3,1580,87,0,0
250,5035,1457,730,1242,11,6,188,1468,10,292,166,329,302,495,2424,4078,5,22973,1276,1,0
250,5035,74,35,59,1,0,14,75,3,14,7,14,17,21,58,85,1,128,7,0,0
250,5035,245,125,200,5,7,34,250,7,30,17,34,37,51,166,265,3,1053,58,0,0
24,755,74,35,59,1,0,14,75,3,14,7,14,17,21,58,85,1,128,7,0,0
24,755,245,125,200,5,7,34,250,7,30,17,34,37,51,166,265,3,1053,58,0,0
474,10304,72,33,56,0,4,12,72,1,1,1,1,2,2,0,2,0,1,0,0,0
474,10304,1454,835,1044,76,110,219,1530,17,275,158,296,292,454,2297,3718,9,34017,1889,1,0
166,3485,1943,715,1694,26,18,214,1969,12,185,120,237,197,357,1436,2721,7,20915,1161,0,0
166,3485,1168,838,957,57,25,144,1225,19,348,224,416,367,640,3018,5452,11,61921,3440,1,0
138,6100,139,89,101,2,0,35,141,7,54,34,62,61,96,330,569,4,2287,127,0,0
138,6100,7,5,5,0,0,2,7,1,2,1,2,3,3,2,4,0,2,0,0,0
293,5891,1457,730,1242,11,6,188,1468,10,292,166,329,302,495,2424,4078,5,22973,1276,1,0
293,5891,74,35,59,1,0,14,75,3,14,7,14,17,21,58,85,1,128,7,0,0
293,5891,245,125,200,5,7,34,250,7,30,17,34,37,51,166,265,3,1053,58,0,0
23,754,74,35,59,1,0,14,75,3,14,7,14,17,21,58,85,1,128,7,0,0
23,754,245,125,200,5,7,34,250,7,30,17,34,37,51,166,265,3,1053,58,0,0
16,483,184,100,137,2,15,30,186,6,38,20,39,44,59,214,322,3,991,55,0,0
16,483,103,65,74,8,5,16,111,7,17,9,17,24,26,89,119,3,417,23,0,0
475,10325,72,33,56,0,4,12,72,1,1,1,1,2,2,0,2,0,1,0,0,0
475,10325,1454,835,1044,76,110,219,1530,17,275,158,296,292,454,2297,3718,9,34017,1889,1,0
171,3530,1943,715,1694,26,18,214,1969,12,185,120,237,197,357,1436,2721,7,20915,1161,0,0
171,3530,1168,838,957,57,25,144,1225,19,348,224,416,367,640,3018,5452,11,61921,3440,1,0
138,6098,139,89,101,2,0,35,141,7,54,34,62,61,96,330,569,4,2287,127,0,0
138,6098,7,5,5,0,0,2,7,1,2,1,2,3,3,2,4,0,2,0,0,0
295,5925,1457,730,1242,11,6,188,1468,10,292,166,329,302,495,2424,4078,5,22973,1276,1,1
295,5925,74,35,59,1,0,14,75,3,14,7,14,17,21,58,85,1,128,7,0,1
295,5925,245,125,200,5,7,34,250,7,30,17,34,37,51,166,265,3,1053,58,0,1
34,2100,652,304,544,16,6,88,668,6,89,51,101,95,152,591,998,3,3399,188,0,1
251,5055,1457,730,1242,11,6,188,1468,10,292,166,329,302,495,2424,4078,5,22973,1276,1,1
251,5055,74,35,59,1,0,14,75,3,14,7,14,17,21,58,85,1,128,7,0,1
251,5055,245,125,200,5,7,34,250,7,30,17,34,37,51,166,265,3,1053,58,0,1
67,2827,1289,550,1043,56,32,155,1345,10,167,93,185,177,278,1266,2075,5,11498,638,0,1
113,2501,1043,504,840,53,9,147,1096,9,180,112,198,189,310,1377,2344,4,11604,644,0,1
113,2501,383,288,292,26,6,62,409,11,65,38,67,76,105,429,656,5,3719,206,0,1
55,2166,1043,504,840,53,9,147,1096,9,180,112,198,189,310,1377,2344,4,11604,644,0,1
55,2176,1043,504,840,53,9,147,1096,9,180,112,198,189,310,1377,2344,4,11604,644,0,1
113,2501,1043,504,840,53,9,147,1096,9,180,112,198,189,310,1377,2344,4,11604,644,0,0
113,2501,383,288,292,26,6,62,409,11,65,38,67,76,105,429,656,5,3719,206,0,0
55,2176,1043,504,840,53,9,147,1096,9,180,112,198,189,310,1377,2344,4,11604,644,0,0
39,719,127,75,83,2,11,30,129,4,14,7,14,18,21,61,87,2,175,9,0,0
39,719,652,304,544,16,6,88,668,6,89,51,101,95,152,591,998,3,3399,188,0,0
39,719,2,2,2,0,0,0,2,0,0,0,0,0,0,0,0,0,0,0,0,0
39,719,8,5,5,0,0,3,8,0,0,0,0,0,0,0,0,0,0,0,0,0
39,719,14,8,8,0,0,6,14,0,0,0,0,0,0,0,0,0,0,0,0,0
39,719,6,4,4,0,0,2,6,0,0,0,0,0,0,0,0,0,0,0,0,0
39,719,6,4,4,0,0,2,6,1,2,1,2,3,3,2,4,0,2,0,0,0
39,719,7,5,5,0,0,2,7,0,0,0,0,0,0,0,0,0,0,0,0,0
39,719,10,6,6,0,0,4,10,0,0,0,0,0,0,0,0,0,0,0,0,0
39,719,1,1,1,0,0,0,1,0,0,0,0,0,0,0,0,0,0,0,0,0
39,719,14,10,10,0,0,4,14,1,1,1,1,2,2,0,2,0,1,0,0,0
39,719,46,26,30,3,0,12,49,3,6,3,6,9,9,20,28,1,42,2,0,0
111,4263,1513,682,1277,25,13,200,1538,11,199,116,219,210,335,1557,2584,6,15641,868,0,0
251,5055,1457,730,1242,11,6,188,1468,10,292,166,329,302,495,2424,4078,5,22973,1276,1,0
251,5055,74,35,59,1,0,14,75,3,14,7,14,17,21,58,85,1,128,7,0,0
251,5055,245,125,200,5,7,34,250,7,30,17,34,37,51,166,265,3,1053,58,0,0
67,2827,1289,550,1043,56,32,155,1345,10,167,93,185,177,278,1266,2075,5,11498,638,0,0
294,5911,1457,730,1242,11,6,188,1468,10,292,166,329,302,495,2424,4078,5,22973,1276,1,0
294,5911,74,35,59,1,0,14,75,3,14,7,14,17,21,58,85,1,128,7,0,0
294,5911,245,125,200,5,7,34,250,7,30,17,34,37,51,166,265,3,1053,58,0,0
68,2865,1289,550,1043,56,32,155,1345,10,167,93,185,177,278,1266,2075,5,11498,638,0,0
111,4260,1513,682,1277,25,13,200,1538,11,199,116,219,210,335,1557,2584,6,15641,868,0,0
216,4842,722,423,573,19,0,135,741,12,172,101,199,184,300,1320,2257,6,15668,870,0,0
216,4842,1508,847,911,44,250,301,1552,14,148,88,169,162,257,1120,1886,7,15077,837,0,0
20,625,42,7,35,4,0,5,46,1,2,1,2,3,3,2,4,0,2,0,0,0
20,625,11,6,10,0,0,1,11,2,4,2,4,6,6,10,15,1,15,0,0,0
296,5945,1457,730,1242,11,6,188,1468,10,292,166,329,302,495,2424,4078,5,22973,1276,1,0
296,5945,74,35,59,1,0,14,75,3,14,7,14,17,21,58,85,1,128,7,0,0
296,5945,245,125,200,5,7,34,250,7,30,17,34,37,51,166,265,3,1053,58,0,0
34,2100,652,304,544,16,6,88,668,6,89,51,101,95,152,591,998,3,3399,188,0,0
67,3186,1338,495,1086,10,64,173,1348,11,122,82,157,133,239,883,1686,7,11934,663,0,0
68,1237,1020,354,843,12,15,144,1032,8,134,77,144,142,221,970,1580,4,6792,377,0,1
68,1237,1020,354,843,12,15,144,1032,8,134,77,144,142,221,970,1580,4,6792,377,0,0
112,2270,1513,682,1277,25,13,200,1538,11,199,116,219,210,335,1557,2584,6,15641,868,0,1
112,2270,819,519,539,24,98,155,843,15,96,57,106,111,163,690,1107,8,9171,509,0,1
112,4302,1513,682,1277,25,13,200,1538,11,199,116,219,210,335,1557,2584,6,15641,868,0,1
112,4302,1513,682,1277,25,13,200,1538,11,199,116,219,210,335,1557,2584,6,15641,868,0,0
112,2270,1513,682,1277,25,13,200,1538,11,199,116,219,210,335,1557,2584,6,15641,868,0,0
112,2270,819,519,539,24,98,155,843,15,96,57,106,111,163,690,1107,8,9171,509,0,0
112,4306,1513,682,1277,25,13,200,1538,11,199,116,219,210,335,1557,2584,6,15641,868,0,0
480,10385,72,33,56,0,4,12,72,1,1,1,1,2,2,0,2,0,1,0,0,1
480,10385,1454,835,1044,76,110,219,1530,17,275,158,296,292,454,2297,3718,9,34017,1889,1,1
63,2600,1020,354,843,12,15,144,1032,8,134,77,144,142,221,970,1580,4,6792,377,0,1
68,3245,1338,495,1086,10,64,173,1348,11,122,82,157,133,239,883,1686,7,11934,663,0,1
68,3245,1338,495,1086,10,64,173,1348,11,122,82,157,133,239,883,1686,7,11934,663,0,0
8,551,442,244,305,14,16,103,456,11,68,45,75,79,120,452,756,6,4588,254,0,1
13,436,442,244,305,14,16,103,456,11,68,45,75,79,120,452,756,6,4588,254,0,0
13,436,182,102,99,11,40,35,193,3,11,6,11,14,17,42,64,1,97,5,0,0
8,551,442,244,305,14,16,103,456,11,68,45,75,79,120,452,756,6,4588,254,0,0
36,810,386,256,301,16,9,68,402,4,59,35,69,63,104,355,621,2,1453,80,0,1
36,810,264,131,164,11,41,46,275,6,38,22,40,44,62,214,338,3,1068,59,0,1
11,230,256,139,192,9,7,47,265,4,23,12,24,27,36,112,171,2,357,19,0,1
20,938,386,256,301,16,9,68,402,4,59,35,69,63,104,355,621,2,1453,80,0,1
478,10389,72,33,56,0,4,12,72,1,1,1,1,2,2,0,2,0,1,0,0,1
478,10389,1454,835,1044,76,110,219,1530,17,275,158,296,292,454,2297,3718,9,34017,1889,1,1
70,3830,1782,648,1425,9,47,279,1791,8,171,97,189,179,286,1292,2140,4,9462,525,0,1
476,10387,72,33,56,0,4,12,72,1,1,1,1,2,2,0,2,0,1,0,0,0
476,10387,1454,835,1044,76,110,219,1530,17,275,158,296,292,454,2297,3718,9,34017,1889,1,0
70,3830,1782,648,1425,9,47,279,1791,8,171,97,189,179,286,1292,2140,4,9462,525,0,0
71,3863,1782,648,1425,9,47,279,1791,8,171,97,189,179,286,1292,2140,4,9462,525,0,0
72,3886,1782,648,1425,9,47,279,1791,8,171,97,189,179,286,1292,2140,4,9462,525,0,1
477,10406,72,33,56,0,4,12,72,1,1,1,1,2,2,0,2,0,1,0,0,0
477,10406,1454,835,1044,76,110,219,1530,17,275,158,296,292,454,2297,3718,9,34017,1889,1,0
72,3922,1782,648,1425,9,47,279,1791,8,171,97,189,179,286,1292,2140,4,9462,525,0,0
477,10406,72,33,56,0,4,12,72,1,1,1,1,2,2,0,2,0,1,0,0,1
477,10406,1454,835,1044,76,110,219,1530,17,275,158,296,292,454,2297,3718,9,34017,1889,1,1
480,10385,72,33,56,0,4,12,72,1,1,1,1,2,2,0,2,0,1,0,0,0
480,10385,1454,835,1044,76,110,219,1530,17,275,158,296,292,454,2297,3718,9,34017,1889,1,0
36,810,386,256,301,16,9,68,402,4,59,35,69,63,104,355,621,2,1453,80,0,0
36,810,264,131,164,11,41,46,275,6,38,22,40,44,62,214,338,3,1068,59,0,0
11,230,256,139,192,9,7,47,265,4,23,12,24,27,36,112,171,2,357,19,0,0
20,938,386,256,301,16,9,68,402,4,59,35,69,63,104,355,621,2,1453,80,0,0
20,942,386,256,301,16,9,68,402,4,59,35,69,63,104,355,621,2,1453,80,0,0
36,822,386,256,301,16,9,68,402,4,59,35,69,63,104,355,621,2,1453,80,0,1
36,822,264,131,164,11,41,46,275,6,38,22,40,44,62,214,338,3,1068,59,0,1
21,982,386,256,301,16,9,68,402,4,59,35,69,63,104,355,621,2,1453,80,0,1
21,974,386,256,301,16,9,68,402,4,59,35,69,63,104,355,621,2,1453,80,0,1
486,10456,72,33,56,0,4,12,72,1,1,1,1,2,2,0,2,0,1,0,0,1
486,10456,1454,835,1044,76,110,219,1530,17,275,158,296,292,454,2297,3718,9,34017,1889,1,1
67,3655,1782,648,1425,9,47,279,1791,8,171,97,189,179,286,1292,2140,4,9462,525,0,1
481,10401,72,33,56,0,4,12,72,1,1,1,1,2,2,0,2,0,1,0,0,1
481,10401,1454,835,1044,76,110,219,1530,17,275,158,296,292,454,2297,3718,9,34017,1889,1,1
66,3598,1782,648,1425,9,47,279,1791,8,171,97,189,179,286,1292,2140,4,9462,525,0,1
481,10401,72,33,56,0,4,12,72,1,1,1,1,2,2,0,2,0,1,0,0,0
481,10401,1454,835,1044,76,110,219,1530,17,275,158,296,292,454,2297,3718,9,34017,1889,1,0
66,3598,1782,648,1425,9,47,279,1791,8,171,97,189,179,286,1292,2140,4,9462,525,0,0
486,10459,72,33,56,0,4,12,72,1,1,1,1,2,2,0,2,0,1,0,0,0
486,10459,1454,835,1044,76,110,219,1530,17,275,158,296,292,454,2297,3718,9,34017,1889,1,0
486,10457,72,33,56,0,4,12,72,1,1,1,1,2,2,0,2,0,1,0,0,1
486,10457,1454,835,1044,76,110,219,1530,17,275,158,296,292,454,2297,3718,9,34017,1889,1,1
485,10457,72,33,56,0,4,12,72,1,1,1,1,2,2,0,2,0,1,0,0,1
485,10457,1454,835,1044,76,110,219,1530,17,275,158,296,292,454,2297,3718,9,34017,1889,1,1
483,10482,72,33,56,0,4,12,72,1,1,1,1,2,2,0,2,0,1,0,0,0
483,10482,1454,835,1044,76,110,219,1530,17,275,158,296,292,454,2297,3718,9,34017,1889,1,0
72,3951,1782,648,1425,9,47,279,1791,8,171,97,189,179,286,1292,2140,4,9462,525,0,0
75,4081,1782,648,1425,9,47,279,1791,8,171,97,189,179,286,1292,2140,4,9462,525,0,0
486,10473,72,33,56,0,4,12,72,1,1,1,1,2,2,0,2,0,1,0,0,0
486,10473,1454,835,1044,76,110,219,1530,17,275,158,296,292,454,2297,3718,9,34017,1889,1,0
67,3684,1782,648,1425,9,47,279,1791,8,171,97,189,179,286,1292,2140,4,9462,525,0,0
21,656,424,94,331,4,0,89,428,1,5,5,5,6,10,11,25,0,12,0,0,1
493,10575,72,33,56,0,4,12,72,1,1,1,1,2,2,0,2,0,1,0,0,1
493,10575,1454,835,1044,76,110,219,1530,17,275,158,296,292,454,2297,3718,9,34017,1889,1,1
493,10571,72,33,56,0,4,12,72,1,1,1,1,2,2,0,2,0,1,0,0,1
493,10571,1454,835,1044,76,110,219,1530,17,275,158,296,292,454,2297,3718,9,34017,1889,1,1
493,10571,72,33,56,0,4,12,72,1,1,1,1,2,2,0,2,0,1,0,0,0
493,10571,1454,835,1044,76,110,219,1530,17,275,158,296,292,454,2297,3718,9,34017,1889,1,0
21,656,424,94,331,4,0,89,428,1,5,5,5,6,10,11,25,0,12,0,0,0
297,5964,1457,730,1242,11,6,188,1468,10,292,166,329,302,495,2424,4078,5,22973,1276,1,0
297,5964,74,35,59,1,0,14,75,3,14,7,14,17,21,58,85,1,128,7,0,0
297,5964,245,125,200,5,7,34,250,7,30,17,34,37,51,166,265,3,1053,58,0,0
69,2885,1289,550,1043,56,32,155,1345,10,167,93,185,177,278,1266,2075,5,11498,638,0,0
492,10563,72,33,56,0,4,12,72,1,1,1,1,2,2,0,2,0,1,0,0,1
492,10563,1454,835,1044,76,110,219,1530,17,275,158,296,292,454,2297,3718,9,34017,1889,1,1
139,6127,139,89,101,2,0,35,141,7,54,34,62,61,96,330,569,4,2287,127,0,1
139,6127,7,5,5,0,0,2,7,1,2,1,2,3,3,2,4,0,2,0,0,1
492,10563,72,33,56,0,4,12,72,1,1,1,1,2,2,0,2,0,1,0,0,0
492,10563,1454,835,1044,76,110,219,1530,17,275,158,296,292,454,2297,3718,9,34017,1889,1,0
139,6127,139,89,101,2,0,35,141,7,54,34,62,61,96,330,569,4,2287,127,0,0
139,6127,7,5,5,0,0,2,7,1,2,1,2,3,3,2,4,0,2,0,0,0
40,1253,1455,414,1257,16,76,112,1471,5,41,23,46,46,69,231,381,2,1069,59,0,1
40,1253,669,365,481,22,61,110,691,15,103,63,122,118,185,747,1273,8,11311,628,0,1
33,1397,1455,414,1257,16,76,112,1471,5,41,23,46,46,69,231,381,2,1069,59,0,1
40,1249,1455,414,1257,16,76,112,1471,5,41,23,46,46,69,231,381,2,1069,59,0,0
40,1249,669,365,481,22,61,110,691,15,103,63,122,118,185,747,1273,8,11311,628,0,0
33,1398,1455,414,1257,16,76,112,1471,5,41,23,46,46,69,231,381,2,1069,59,0,0
172,3537,1943,715,1694,26,18,214,1969,12,185,120,237,197,357,1436,2721,7,20915,1161,0,0
172,3537,1168,838,957,57,25,144,1225,19,348,224,416,367,640,3018,5452,11,61921,3440,1,0
172,3541,1943,715,1694,26,18,214,1969,12,185,120,237,197,357,1436,2721,7,20915,1161,0,0
172,3541,1168,838,957,57,25,144,1225,19,348,224,416,367,640,3018,5452,11,61921,3440,1,0
173,3552,1943,715,1694,26,18,214,1969,12,185,120,237,197,357,1436,2721,7,20915,1161,0,1
173,3552,1168,838,957,57,25,144,1225,19,348,224,416,367,640,3018,5452,11,61921,3440,1,1
65,3354,1943,715,1694,26,18,214,1969,12,185,120,237,197,357,1436,2721,7,20915,1161,0,1
171,3978,77,34,69,0,0,8,77,3,24,16,29,27,45,114,213,1,387,21,0,1
171,3978,712,438,573,51,9,84,763,14,102,71,128,116,199,733,1364,8,11988,666,0,1
171,3550,1943,715,1694,26,18,214,1969,12,185,120,237,197,357,1436,2721,7,20915,1161,0,1
171,3550,1168,838,957,57,25,144,1225,19,348,224,416,367,640,3018,5452,11,61921,3440,1,1
69,2894,1289,550,1043,56,32,155,1345,10,167,93,185,177,278,1266,2075,5,11498,638,0,1
68,3251,1338,495,1086,10,64,173,1348,11,122,82,157,133,239,883,1686,7,11934,663,0,1
135,3518,1660,832,1314,41,38,274,1701,20,312,209,395,332,604,2671,5058,12,64042,3557,1,1
112,4312,1513,682,1277,25,13,200,1538,11,199,116,219,210,335,1557,2584,6,15641,868,0,1
53,2988,1296,573,1062,40,33,157,1336,8,201,118,231,209,349,1561,2689,4,12365,686,0,1
48,2372,1457,730,1242,11,6,188,1468,10,292,166,329,302,495,2424,4078,5,22973,1276,1,1
34,2121,652,304,544,16,6,88,668,6,89,51,101,95,152,591,998,3,3399,188,0,1
8,265,74,35,59,1,0,14,75,3,14,7,14,17,21,58,85,1,128,7,0,1
41,2667,1523,757,1297,19,12,193,1542,12,193,117,230,205,347,1508,2664,7,19053,1058,0,1
31,1715,384,251,317,7,8,52,391,11,70,44,84,81,128,467,811,6,5355,297,0,1
56,2276,1043,504,840,53,9,147,1096,9,180,112,198,189,310,1377,2344,4,11604,644,0,1
24,967,373,158,315,8,0,51,381,5,76,44,79,81,123,486,779,2,2026,112,0,1
63,3221,1943,715,1694,26,18,214,1969,12,185,120,237,197,357,1436,2721,7,20915,1161,0,1
37,1467,1098,241,925,5,10,155,1103,7,46,25,49,53,74,273,423,3,1580,87,0,1
171,3978,77,34,69,0,0,8,77,3,24,16,29,27,45,114,213,1,387,21,0,0
171,3978,712,438,573,51,9,84,763,14,102,71,128,116,199,733,1364,8,11988,666,0,0
53,1539,1523,757,1297,19,12,193,1542,12,193,117,230,205,347,1508,2664,7,19053,1058,0,1
53,1539,701,378,504,33,58,109,734,13,110,68,126,123,194,794,1346,7,10027,557,0,1
42,2710,1523,757,1297,19,12,193,1542,12,193,117,230,205,347,1508,2664,7,19053,1058,0,1
56,2276,1043,504,840,53,9,147,1096,9,180,112,198,189,310,1377,2344,4,11604,644,0,0
173,3552,1943,715,1694,26,18,214,1969,12,185,120,237,197,357,1436,2721,7,20915,1161,0,0
173,3552,1168,838,957,57,25,144,1225,19,348,224,416,367,640,3018,5452,11,61921,3440,1,0
65,3354,1943,715,1694,26,18,214,1969,12,185,120,237,197,357,1436,2721,7,20915,1161,0,0
173,3572,1943,715,1694,26,18,214,1969,12,185,120,237,197,357,1436,2721,7,20915,1161,0,0
173,3572,1168,838,957,57,25,144,1225,19,348,224,416,367,640,3018,5452,11,61921,3440,1,0
69,2894,1289,550,1043,56,32,155,1345,10,167,93,185,177,278,1266,2075,5,11498,638,0,0
68,3251,1338,495,1086,10,64,173,1348,11,122,82,157,133,239,883,1686,7,11934,663,0,0
135,3518,1660,832,1314,41,38,274,1701,20,312,209,395,332,604,2671,5058,12,64042,3557,1,0
112,4312,1513,682,1277,25,13,200,1538,11,199,116,219,210,335,1557,2584,6,15641,868,0,0
53,2988,1296,573,1062,40,33,157,1336,8,201,118,231,209,349,1561,2689,4,12365,686,0,0
48,2372,1457,730,1242,11,6,188,1468,10,292,166,329,302,495,2424,4078,5,22973,1276,1,0
34,2121,652,304,544,16,6,88,668,6,89,51,101,95,152,591,998,3,3399,188,0,0
8,265,74,35,59,1,0,14,75,3,14,7,14,17,21,58,85,1,128,7,0,0
41,2667,1523,757,1297,19,12,193,1542,12,193,117,230,205,347,1508,2664,7,19053,1058,0,0
31,1715,384,251,317,7,8,52,391,11,70,44,84,81,128,467,811,6,5355,297,0,0
24,967,373,158,315,8,0,51,381,5,76,44,79,81,123,486,779,2,2026,112,0,0
65,3360,1943,715,1694,26,18,214,1969,12,185,120,237,197,357,1436,2721,7,20915,1161,0,0
37,1467,1098,241,925,5,10,155,1103,7,46,25,49,53,74,273,423,3,1580,87,0,0
52,1519,1523,757,1297,19,12,193,1542,12,193,117,230,205,347,1508,2664,7,19053,1058,0,1
52,1519,701,378,504,33,58,109,734,13,110,68,126,123,194,794,1346,7,10027,557,0,1
72,3900,1782,648,1425,9,47,279,1791,8,171,97,189,179,286,1292,2140,4,9462,525,0,1
52,1550,1523,757,1297,19,12,193,1542,12,193,117,230,205,347,1508,2664,7,19053,1058,0,1
52,1550,701,378,504,33,58,109,734,13,110,68,126,123,194,794,1346,7,10027,557,0,1
42,2720,1523,757,1297,19,12,193,1542,12,193,117,230,205,347,1508,2664,7,19053,1058,0,1
52,1550,1523,757,1297,19,12,193,1542,12,193,117,230,205,347,1508,2664,7,19053,1058,0,0
52,1550,701,378,504,33,58,109,734,13,110,68,126,123,194,794,1346,7,10027,557,0,0
42,2727,1523,757,1297,19,12,193,1542,12,193,117,230,205,347,1508,2664,7,19053,1058,0,0
494,10644,72,33,56,0,4,12,72,1,1,1,1,2,2,0,2,0,1,0,0,0
494,10644,1454,835,1044,76,110,219,1530,17,275,158,296,292,454,2297,3718,9,34017,1889,1,0
36,822,386,256,301,16,9,68,402,4,59,35,69,63,104,355,621,2,1453,80,0,0
36,822,264,131,164,11,41,46,275,6,38,22,40,44,62,214,338,3,1068,59,0,0
73,4015,1782,648,1425,9,47,279,1791,8,171,97,189,179,286,1292,2140,4,9462,525,0,0
63,2600,1020,354,843,12,15,144,1032,8,134,77,144,142,221,970,1580,4,6792,377,0,0
21,974,386,256,301,16,9,68,402,4,59,35,69,63,104,355,621,2,1453,80,0,0
297,5968,1457,730,1242,11,6,188,1468,10,292,166,329,302,495,2424,4078,5,22973,1276,1,1
297,5968,74,35,59,1,0,14,75,3,14,7,14,17,21,58,85,1,128,7,0,1
297,5968,245,125,200,5,7,34,250,7,30,17,34,37,51,166,265,3,1053,58,0,1
52,2502,1457,730,1242,11,6,188,1468,10,292,166,329,302,495,2424,4078,5,22973,1276,1,1
37,2209,334,251,279,10,4,40,344,5,127,74,143,132,217,899,1528,2,4303,239,0,1
297,5968,1457,730,1242,11,6,188,1468,10,292,166,329,302,495,2424,4078,5,22973,1276,1,0
297,5968,74,35,59,1,0,14,75,3,14,7,14,17,21,58,85,1,128,7,0,0
297,5968,245,125,200,5,7,34,250,7,30,17,34,37,51,166,265,3,1053,58,0,0
52,2502,1457,730,1242,11,6,188,1468,10,292,166,329,302,495,2424,4078,5,22973,1276,1,0
37,2209,334,251,279,10,4,40,344,5,127,74,143,132,217,899,1528,2,4303,239,0,0
298,5985,1457,730,1242,11,6,188,1468,10,292,166,329,302,495,2424,4078,5,22973,1276,1,1
298,5985,74,35,59,1,0,14,75,3,14,7,14,17,21,58,85,1,128,7,0,1
298,5985,245,125,200,5,7,34,250,7,30,17,34,37,51,166,265,3,1053,58,0,1
38,2255,334,251,279,10,4,40,344,5,127,74,143,132,217,899,1528,2,4303,239,0,1
216,4842,722,423,573,19,0,135,741,12,172,101,199,184,300,1320,2257,6,15668,870,0,1
216,4842,1508,847,911,44,250,301,1552,14,148,88,169,162,257,1120,1886,7,15077,837,0,1
173,3589,1943,715,1694,26,18,214,1969,12,185,120,237,197,357,1436,2721,7,20915,1161,0,1
173,3589,1168,838,957,57,25,144,1225,19,348,224,416,367,640,3018,5452,11,61921,3440,1,1
65,3360,1943,715,1694,26,18,214,1969,12,185,120,237,197,357,1436,2721,7,20915,1161,0,1
76,4145,1782,648,1425,9,47,279,1791,8,171,97,189,179,286,1292,2140,4,9462,525,0,0
33,678,2,2,2,0,0,0,2,0,0,0,0,0,0,0,0,0,0,0,0,1
33,678,99,48,90,1,3,5,100,0,0,0,0,0,0,0,0,0,0,0,0,1
33,678,8,5,5,2,0,1,10,0,0,0,0,0,0,0,0,0,0,0,0,1
33,678,1217,716,841,84,126,174,1301,14,185,118,215,199,333,1446,2542,8,20687,1149,0,1
33,678,160,89,115,0,13,31,160,7,15,11,17,22,28,78,124,3,495,27,0,1
33,678,10,10,9,9,0,0,19,0,0,0,0,0,0,0,0,0,0,0,0,1
33,678,173,84,99,8,29,36,181,5,12,7,13,17,20,54,81,2,221,12,0,1
33,678,3,1,1,3,0,0,6,0,0,0,0,0,0,0,0,0,0,0,0,1
72,2658,1450,624,1228,12,26,181,1462,14,306,186,354,320,540,2580,4493,8,36391,2021,1,1
33,678,2,2,2,0,0,0,2,0,0,0,0,0,0,0,0,0,0,0,0,0
33,678,99,48,90,1,3,5,100,0,0,0,0,0,0,0,0,0,0,0,0,0
33,678,8,5,5,2,0,1,10,0,0,0,0,0,0,0,0,0,0,0,0,0
33,678,1217,716,841,84,126,174,1301,14,185,118,215,199,333,1446,2542,8,20687,1149,0,0
33,678,160,89,115,0,13,31,160,7,15,11,17,22,28,78,124,3,495,27,0,0
33,678,10,10,9,9,0,0,19,0,0,0,0,0,0,0,0,0,0,0,0,0
33,678,173,84,99,8,29,36,181,5,12,7,13,17,20,54,81,2,221,12,0,0
33,678,3,1,1,3,0,0,6,0,0,0,0,0,0,0,0,0,0,0,0,0
72,2658,1450,624,1228,12,26,181,1462,14,306,186,354,320,540,2580,4493,8,36391,2021,1,0
298,5985,1457,730,1242,11,6,188,1468,10,292,166,329,302,495,2424,4078,5,22973,1276,1,0
298,5985,74,35,59,1,0,14,75,3,14,7,14,17,21,58,85,1,128,7,0,0
298,5985,245,125,200,5,7,34,250,7,30,17,34,37,51,166,265,3,1053,58,0,0
38,2255,334,251,279,10,4,40,344,5,127,74,143,132,217,899,1528,2,4303,239,0,0
498,10692,72,33,56,0,4,12,72,1,1,1,1,2,2,0,2,0,1,0,0,1
498,10692,1454,835,1044,76,110,219,1530,17,275,158,296,292,454,2297,3718,9,34017,1889,1,1
140,6179,139,89,101,2,0,35,141,7,54,34,62,61,96,330,569,4,2287,127,0,1
140,6179,7,5,5,0,0,2,7,1,2,1,2,3,3,2,4,0,2,0,0,1
140,6180,139,89,101,2,0,35,141,7,54,34,62,61,96,330,569,4,2287,127,0,0
140,6180,7,5,5,0,0,2,7,1,2,1,2,3,3,2,4,0,2,0,0,0
498,10692,72,33,56,0,4,12,72,1,1,1,1,2,2,0,2,0,1,0,0,0
498,10692,1454,835,1044,76,110,219,1530,17,275,158,296,292,454,2297,3718,9,34017,1889,1,0
301,6070,1457,730,1242,11,6,188,1468,10,292,166,329,302,495,2424,4078,5,22973,1276,1,1
301,6070,74,35,59,1,0,14,75,3,14,7,14,17,21,58,85,1,128,7,0,1
301,6070,245,125,200,5,7,34,250,7,30,17,34,37,51,166,265,3,1053,58,0,1
23,771,74,35,59,1,0,14,75,3,14,7,14,17,21,58,85,1,128,7,0,1
23,771,245,125,200,5,7,34,250,7,30,17,34,37,51,166,265,3,1053,58,0,1
43,1300,1455,414,1257,16,76,112,1471,5,41,23,46,46,69,231,381,2,1069,59,0,1
43,1300,669,365,481,22,61,110,691,15,103,63,122,118,185,747,1273,8,11311,628,0,1
39,1553,1455,414,1257,16,76,112,1471,5,41,23,46,46,69,231,381,2,1069,59,0,1
173,3589,1943,715,1694,26,18,214,1969,12,185,120,237,197,357,1436,2721,7,20915,1161,0,0
173,3589,1168,838,957,57,25,144,1225,19,348,224,416,367,640,3018,5452,11,61921,3440,1,0
43,1300,1455,414,1257,16,76,112,1471,5,41,23,46,46,69,231,381,2,1069,59,0,0
43,1300,669,365,481,22,61,110,691,15,103,63,122,118,185,747,1273,8,11311,628,0,0
39,1553,1455,414,1257,16,76,112,1471,5,41,23,46,46,69,231,381,2,1069,59,0,0
297,5985,1457,730,1242,11,6,188,1468,10,292,166,329,302,495,2424,4078,5,22973,1276,1,1
297,5985,74,35,59,1,0,14,75,3,14,7,14,17,21,58,85,1,128,7,0,1
297,5985,245,125,200,5,7,34,250,7,30,17,34,37,51,166,265,3,1053,58,0,1
46,529,647,139,84,35,284,233,682,0,0,0,0,0,0,0,0,0,0,0,0,1
171,3985,77,34,69,0,0,8,77,3,24,16,29,27,45,114,213,1,387,21,0,1
171,3985,712,438,573,51,9,84,763,14,102,71,128,116,199,733,1364,8,11988,666,0,1
32,1735,384,251,317,7,8,52,391,11,70,44,84,81,128,467,811,6,5355,297,0,1
298,6002,1457,730,1242,11,6,188,1468,10,292,166,329,302,495,2424,4078,5,22973,1276,1,0
298,6002,74,35,59,1,0,14,75,3,14,7,14,17,21,58,85,1,128,7,0,0
298,6002,245,125,200,5,7,34,250,7,30,17,34,37,51,166,265,3,1053,58,0,0
23,771,74,35,59,1,0,14,75,3,14,7,14,17,21,58,85,1,128,7,0,0
23,771,245,125,200,5,7,34,250,7,30,17,34,37,51,166,265,3,1053,58,0,0
46,529,647,139,84,35,284,233,682,0,0,0,0,0,0,0,0,0,0,0,0,0
171,3985,77,34,69,0,0,8,77,3,24,16,29,27,45,114,213,1,387,21,0,0
171,3985,712,438,573,51,9,84,763,14,102,71,128,116,199,733,1364,8,11988,666,0,0
32,1735,384,251,317,7,8,52,391,11,70,44,84,81,128,467,811,6,5355,297,0,0
298,6004,1457,730,1242,11,6,188,1468,10,292,166,329,302,495,2424,4078,5,22973,1276,1,1
298,6004,74,35,59,1,0,14,75,3,14,7,14,17,21,58,85,1,128,7,0,1
298,6004,245,125,200,5,7,34,250,7,30,17,34,37,51,166,265,3,1053,58,0,1
46,531,647,139,84,35,284,233,682,0,0,0,0,0,0,0,0,0,0,0,0,1
498,10696,72,33,56,0,4,12,72,1,1,1,1,2,2,0,2,0,1,0,0,1
498,10696,1454,835,1044,76,110,219,1530,17,275,158,296,292,454,2297,3718,9,34017,1889,1,1
173,3593,1943,715,1694,26,18,214,1969,12,185,120,237,197,357,1436,2721,7,20915,1161,0,1
173,3593,1168,838,957,57,25,144,1225,19,348,224,416,367,640,3018,5452,11,61921,3440,1,1
20,625,42,7,35,4,0,5,46,1,2,1,2,3,3,2,4,0,2,0,0,1
20,625,11,6,10,0,0,1,11,2,4,2,4,6,6,10,15,1,15,0,0,1
65,3364,1943,715,1694,26,18,214,1969,12,185,120,237,197,357,1436,2721,7,20915,1161,0,1
173,3542,1943,715,1694,26,18,214,1969,12,185,120,237,197,357,1436,2721,7,20915,1161,0,0
173,3542,1168,838,957,57,25,144,1225,19,348,224,416,367,640,3018,5452,11,61921,3440,1,0
173,3542,1943,715,1694,26,18,214,1969,12,185,120,237,197,357,1436,2721,7,20915,1161,0,1
173,3542,1168,838,957,57,25,144,1225,19,348,224,416,367,640,3018,5452,11,61921,3440,1,1
50,2216,1178,367,1042,6,15,115,1184,9,94,51,95,103,146,644,976,4,4439,246,0,1
175,3601,1943,715,1694,26,18,214,1969,12,185,120,237,197,357,1436,2721,7,20915,1161,0,0
175,3601,1168,838,957,57,25,144,1225,19,348,224,416,367,640,3018,5452,11,61921,3440,1,0
50,2216,1178,367,1042,6,15,115,1184,9,94,51,95,103,146,644,976,4,4439,246,0,0
54,1131,996,429,845,24,10,117,1020,7,76,50,88,83,138,494,879,4,3565,198,0,1
54,1131,456,277,329,12,42,72,468,13,85,50,97,98,147,592,972,7,7212,400,0,1
298,6002,1457,730,1242,11,6,188,1468,10,292,166,329,302,495,2424,4078,5,22973,1276,1,1
298,6002,74,35,59,1,0,14,75,3,14,7,14,17,21,58,85,1,128,7,0,1
298,6002,245,125,200,5,7,34,250,7,30,17,34,37,51,166,265,3,1053,58,0,1
54,1134,996,429,845,24,10,117,1020,7,76,50,88,83,138,494,879,4,3565,198,0,0
54,1134,456,277,329,12,42,72,468,13,85,50,97,98,147,592,972,7,7212,400,0,0
55,1150,996,429,845,24,10,117,1020,7,76,50,88,83,138,494,879,4,3565,198,0,1
55,1150,456,277,329,12,42,72,468,13,85,50,97,98,147,592,972,7,7212,400,0,1
172,3983,77,34,69,0,0,8,77,3,24,16,29,27,45,114,213,1,387,21,0,1
172,3983,712,438,573,51,9,84,763,14,102,71,128,116,199,733,1364,8,11988,666,0,1
44,876,447,308,343,6,5,95,453,7,96,59,111,103,170,651,1136,4,4600,255,0,0
44,876,322,174,179,16,74,51,338,10,41,26,46,51,72,252,408,5,2291,127,0,0
175,3605,1943,715,1694,26,18,214,1969,12,185,120,237,197,357,1436,2721,7,20915,1161,0,0
175,3605,1168,838,957,57,25,144,1225,19,348,224,416,367,640,3018,5452,11,61921,3440,1,0
172,3983,77,34,69,0,0,8,77,3,24,16,29,27,45,114,213,1,387,21,0,0
172,3983,712,438,573,51,9,84,763,14,102,71,128,116,199,733,1364,8,11988,666,0,0
298,6004,1457,730,1242,11,6,188,1468,10,292,166,329,302,495,2424,4078,5,22973,1276,1,0
298,6004,74,35,59,1,0,14,75,3,14,7,14,17,21,58,85,1,128,7,0,0
298,6004,245,125,200,5,7,34,250,7,30,17,34,37,51,166,265,3,1053,58,0,0
46,531,647,139,84,35,284,233,682,0,0,0,0,0,0,0,0,0,0,0,0,0
498,10696,72,33,56,0,4,12,72,1,1,1,1,2,2,0,2,0,1,0,0,0
498,10696,1454,835,1044,76,110,219,1530,17,275,158,296,292,454,2297,3718,9,34017,1889,1,0
65,3364,1943,715,1694,26,18,214,1969,12,185,120,237,197,357,1436,2721,7,20915,1161,0,0
115,2526,1043,504,840,53,9,147,1096,9,180,112,198,189,310,1377,2344,4,11604,644,0,1
115,2526,383,288,292,26,6,62,409,11,65,38,67,76,105,429,656,5,3719,206,0,1
115,2524,1043,504,840,53,9,147,1096,9,180,112,198,189,310,1377,2344,4,11604,644,0,0
115,2524,383,288,292,26,6,62,409,11,65,38,67,76,105,429,656,5,3719,206,0,0
503,10795,72,33,56,0,4,12,72,1,1,1,1,2,2,0,2,0,1,0,0,1
503,10795,1454,835,1044,76,110,219,1530,17,275,158,296,292,454,2297,3718,9,34017,1889,1,1
57,2317,1043,504,840,53,9,147,1096,9,180,112,198,189,310,1377,2344,4,11604,644,0,1
503,10792,72,33,56,0,4,12,72,1,1,1,1,2,2,0,2,0,1,0,0,0
503,10792,1454,835,1044,76,110,219,1530,17,275,158,296,292,454,2297,3718,9,34017,1889,1,0
503,10791,72,33,56,0,4,12,72,1,1,1,1,2,2,0,2,0,1,0,0,0
503,10791,1454,835,1044,76,110,219,1530,17,275,158,296,292,454,2297,3718,9,34017,1889,1,0
503,10797,72,33,56,0,4,12,72,1,1,1,1,2,2,0,2,0,1,0,0,0
503,10797,1454,835,1044,76,110,219,1530,17,275,158,296,292,454,2297,3718,9,34017,1889,1,0
76,4181,1782,648,1425,9,47,279,1791,8,171,97,189,179,286,1292,2140,4,9462,525,0,0
501,10735,72,33,56,0,4,12,72,1,1,1,1,2,2,0,2,0,1,0,0,1
501,10735,1454,835,1044,76,110,219,1530,17,275,158,296,292,454,2297,3718,9,34017,1889,1,1
14,449,442,244,305,14,16,103,456,11,68,45,75,79,120,452,756,6,4588,254,0,0
14,449,182,102,99,11,40,35,193,3,11,6,11,14,17,42,64,1,97,5,0,0
9,601,442,244,305,14,16,103,456,11,68,45,75,79,120,452,756,6,4588,254,0,0
15,453,442,244,305,14,16,103,456,11,68,45,75,79,120,452,756,6,4588,254,0,1
15,453,182,102,99,11,40,35,193,3,11,6,11,14,17,42,64,1,97,5,0,1
10,640,442,244,305,14,16,103,456,11,68,45,75,79,120,452,756,6,4588,254,0,1
10,663,442,244,305,14,16,103,456,11,68,45,75,79,120,452,756,6,4588,254,0,0
16,464,442,244,305,14,16,103,456,11,68,45,75,79,120,452,756,6,4588,254,0,0
16,464,182,102,99,11,40,35,193,3,11,6,11,14,17,42,64,1,97,5,0,0
55,1150,996,429,845,24,10,117,1020,7,76,50,88,83,138,494,879,4,3565,198,0,0
55,1150,456,277,329,12,42,72,468,13,85,50,97,98,147,592,972,7,7212,400,0,0
498,10733,72,33,56,0,4,12,72,1,1,1,1,2,2,0,2,0,1,0,0,1
498,10733,1454,835,1044,76,110,219,1530,17,275,158,296,292,454,2297,3718,9,34017,1889,1,1
68,3269,1338,495,1086,10,64,173,1348,11,122,82,157,133,239,883,1686,7,11934,663,0,1
77,4224,1782,648,1425,9,47,279,1791,8,171,97,189,179,286,1292,2140,4,9462,525,0,1
498,10733,72,33,56,0,4,12,72,1,1,1,1,2,2,0,2,0,1,0,0,0
498,10733,1454,835,1044,76,110,219,1530,17,275,158,296,292,454,2297,3718,9,34017,1889,1,0
68,3269,1338,495,1086,10,64,173,1348,11,122,82,157,133,239,883,1686,7,11934,663,0,0
501,10772,72,33,56,0,4,12,72,1,1,1,1,2,2,0,2,0,1,0,0,0
501,10772,1454,835,1044,76,110,219,1530,17,275,158,296,292,454,2297,3718,9,34017,1889,1,0
77,4224,1782,648,1425,9,47,279,1791,8,171,97,189,179,286,1292,2140,4,9462,525,0,0
57,2317,1043,504,840,53,9,147,1096,9,180,112,198,189,310,1377,2344,4,11604,644,0,0
54,1579,1523,757,1297,19,12,193,1542,12,193,117,230,205,347,1508,2664,7,19053,1058,0,1
54,1579,701,378,504,33,58,109,734,13,110,68,126,123,194,794,1346,7,10027,557,0,1
42,2753,1523,757,1297,19,12,193,1542,12,193,117,230,205,347,1508,2664,7,19053,1058,0,1
54,1579,1523,757,1297,19,12,193,1542,12,193,117,230,205,347,1508,2664,7,19053,1058,0,0
54,1579,701,378,504,33,58,109,734,13,110,68,126,123,194,794,1346,7,10027,557,0,0
42,2753,1523,757,1297,19,12,193,1542,12,193,117,230,205,347,1508,2664,7,19053,1058,0,0
88,1927,477,336,357,30,23,73,507,16,194,134,250,210,384,1538,2962,10,30538,1696,0,0
74,2691,1450,624,1228,12,26,181,1462,14,306,186,354,320,540,2580,4493,8,36391,2021,1,0
90,1940,477,336,357,30,23,73,507,16,194,134,250,210,384,1538,2962,10,30538,1696,0,1
16,468,442,244,305,14,16,103,456,11,68,45,75,79,120,452,756,6,4588,254,0,1
16,468,182,102,99,11,40,35,193,3,11,6,11,14,17,42,64,1,97,5,0,1
12,822,442,244,305,14,16,103,456,11,68,45,75,79,120,452,756,6,4588,254,0,1
16,468,442,244,305,14,16,103,456,11,68,45,75,79,120,452,756,6,4588,254,0,0
16,468,182,102,99,11,40,35,193,3,11,6,11,14,17,42,64,1,97,5,0,0
12,822,442,244,305,14,16,103,456,11,68,45,75,79,120,452,756,6,4588,254,0,0
37,841,386,256,301,16,9,68,402,4,59,35,69,63,104,355,621,2,1453,80,0,1
37,841,264,131,164,11,41,46,275,6,38,22,40,44,62,214,338,3,1068,59,0,1
23,1031,386,256,301,16,9,68,402,4,59,35,69,63,104,355,621,2,1453,80,0,1
37,831,386,256,301,16,9,68,402,4,59,35,69,63,104,355,621,2,1453,80,0,1
37,831,264,131,164,11,41,46,275,6,38,22,40,44,62,214,338,3,1068,59,0,1
90,1940,477,336,357,30,23,73,507,16,194,134,250,210,384,1538,2962,10,30538,1696,0,0
37,831,386,256,301,16,9,68,402,4,59,35,69,63,104,355,621,2,1453,80,0,0
37,831,264,131,164,11,41,46,275,6,38,22,40,44,62,214,338,3,1068,59,0,0
23,1031,386,256,301,16,9,68,402,4,59,35,69,63,104,355,621,2,1453,80,0,0
57,1218,996,429,845,24,10,117,1020,7,76,50,88,83,138,494,879,4,3565,198,0,1
57,1218,456,277,329,12,42,72,468,13,85,50,97,98,147,592,972,7,7212,400,0,1
115,2524,1043,504,840,53,9,147,1096,9,180,112,198,189,310,1377,2344,4,11604,644,0,1
115,2524,383,288,292,26,6,62,409,11,65,38,67,76,105,429,656,5,3719,206,0,1
57,1218,996,429,845,24,10,117,1020,7,76,50,88,83,138,494,879,4,3565,198,0,0
57,1218,456,277,329,12,42,72,468,13,85,50,97,98,147,592,972,7,7212,400,0,0
508,10878,72,33,56,0,4,12,72,1,1,1,1,2,2,0,2,0,1,0,0,1
508,10878,1454,835,1044,76,110,219,1530,17,275,158,296,292,454,2297,3718,9,34017,1889,1,1
77,4244,1782,648,1425,9,47,279,1791,8,171,97,189,179,286,1292,2140,4,9462,525,0,1
57,1219,996,429,845,24,10,117,1020,7,76,50,88,83,138,494,879,4,3565,198,0,1
57,1219,456,277,329,12,42,72,468,13,85,50,97,98,147,592,972,7,7212,400,0,1
57,1219,996,429,845,24,10,117,1020,7,76,50,88,83,138,494,879,4,3565,198,0,0
57,1219,456,277,329,12,42,72,468,13,85,50,97,98,147,592,972,7,7212,400,0,0
508,10878,72,33,56,0,4,12,72,1,1,1,1,2,2,0,2,0,1,0,0,0
508,10878,1454,835,1044,76,110,219,1530,17,275,158,296,292,454,2297,3718,9,34017,1889,1,0
77,4244,1782,648,1425,9,47,279,1791,8,171,97,189,179,286,1292,2140,4,9462,525,0,0
56,1686,1523,757,1297,19,12,193,1542,12,193,117,230,205,347,1508,2664,7,19053,1058,0,1
56,1686,701,378,504,33,58,109,734,13,110,68,126,123,194,794,1346,7,10027,557,0,1
45,2836,1523,757,1297,19,12,193,1542,12,193,117,230,205,347,1508,2664,7,19053,1058,0,1
56,1686,1523,757,1297,19,12,193,1542,12,193,117,230,205,347,1508,2664,7,19053,1058,0,0
56,1686,701,378,504,33,58,109,734,13,110,68,126,123,194,794,1346,7,10027,557,0,0
45,2836,1523,757,1297,19,12,193,1542,12,193,117,230,205,347,1508,2664,7,19053,1058,0,0
299,6014,1457,730,1242,11,6,188,1468,10,292,166,329,302,495,2424,4078,5,22973,1276,1,1
299,6014,74,35,59,1,0,14,75,3,14,7,14,17,21,58,85,1,128,7,0,1
299,6014,245,125,200,5,7,34,250,7,30,17,34,37,51,166,265,3,1053,58,0,1
35,2152,652,304,544,16,6,88,668,6,89,51,101,95,152,591,998,3,3399,188,0,1
297,5993,1457,730,1242,11,6,188,1468,10,292,166,329,302,495,2424,4078,5,22973,1276,1,1
297,5993,74,35,59,1,0,14,75,3,14,7,14,17,21,58,85,1,128,7,0,1
297,5993,245,125,200,5,7,34,250,7,30,17,34,37,51,166,265,3,1053,58,0,1
297,5993,1457,730,1242,11,6,188,1468,10,292,166,329,302,495,2424,4078,5,22973,1276,1,0
297,5993,74,35,59,1,0,14,75,3,14,7,14,17,21,58,85,1,128,7,0,0
297,5993,245,125,200,5,7,34,250,7,30,17,34,37,51,166,265,3,1053,58,0,0
35,2152,652,304,544,16,6,88,668,6,89,51,101,95,152,591,998,3,3399,188,0,0
36,829,386,256,301,16,9,68,402,4,59,35,69,63,104,355,621,2,1453,80,0,1
36,829,264,131,164,11,41,46,275,6,38,22,40,44,62,214,338,3,1068,59,0,1
22,1003,386,256,301,16,9,68,402,4,59,35,69,63,104,355,621,2,1453,80,0,1
24,1062,386,256,301,16,9,68,402,4,59,35,69,63,104,355,621,2,1453,80,0,1
36,829,386,256,301,16,9,68,402,4,59,35,69,63,104,355,621,2,1453,80,0,0
36,829,264,131,164,11,41,46,275,6,38,22,40,44,62,214,338,3,1068,59,0,0
24,1062,386,256,301,16,9,68,402,4,59,35,69,63,104,355,621,2,1453,80,0,0
23,760,74,35,59,1,0,14,75,3,14,7,14,17,21,58,85,1,128,7,0,0
23,760,245,125,200,5,7,34,250,7,30,17,34,37,51,166,265,3,1053,58,0,0
24,810,74,35,59,1,0,14,75,3,14,7,14,17,21,58,85,1,128,7,0,0
24,810,245,125,200,5,7,34,250,7,30,17,34,37,51,166,265,3,1053,58,0,0
297,5997,1457,730,1242,11,6,188,1468,10,292,166,329,302,495,2424,4078,5,22973,1276,1,1
297,5997,74,35,59,1,0,14,75,3,14,7,14,17,21,58,85,1,128,7,0,1
297,5997,245,125,200,5,7,34,250,7,30,17,34,37,51,166,265,3,1053,58,0,1
35,1821,384,251,317,7,8,52,391,11,70,44,84,81,128,467,811,6,5355,297,0,1
297,5997,1457,730,1242,11,6,188,1468,10,292,166,329,302,495,2424,4078,5,22973,1276,1,0
297,5997,74,35,59,1,0,14,75,3,14,7,14,17,21,58,85,1,128,7,0,0
297,5997,245,125,200,5,7,34,250,7,30,17,34,37,51,166,265,3,1053,58,0,0
35,1821,384,251,317,7,8,52,391,11,70,44,84,81,128,467,811,6,5355,297,0,0
219,4876,722,423,573,19,0,135,741,12,172,101,199,184,300,1320,2257,6,15668,870,0,1
219,4876,1508,847,911,44,250,301,1552,14,148,88,169,162,257,1120,1886,7,15077,837,0,1
219,4876,722,423,573,19,0,135,741,12,172,101,199,184,300,1320,2257,6,15668,870,0,0
219,4876,1508,847,911,44,250,301,1552,14,148,88,169,162,257,1120,1886,7,15077,837,0,0
37,838,386,256,301,16,9,68,402,4,59,35,69,63,104,355,621,2,1453,80,0,0
37,838,264,131,164,11,41,46,275,6,38,22,40,44,62,214,338,3,1068,59,0,0
26,1119,386,256,301,16,9,68,402,4,59,35,69,63,104,355,621,2,1453,80,0,0
14,811,442,244,305,14,16,103,456,11,68,45,75,79,120,452,756,6,4588,254,0,0
79,4325,1782,648,1425,9,47,279,1791,8,171,97,189,179,286,1292,2140,4,9462,525,0,1
509,10885,72,33,56,0,4,12,72,1,1,1,1,2,2,0,2,0,1,0,0,1
509,10885,1454,835,1044,76,110,219,1530,17,275,158,296,292,454,2297,3718,9,34017,1889,1,1
81,4395,1782,648,1425,9,47,279,1791,8,171,97,189,179,286,1292,2140,4,9462,525,0,1
508,10886,72,33,56,0,4,12,72,1,1,1,1,2,2,0,2,0,1,0,0,0
508,10886,1454,835,1044,76,110,219,1530,17,275,158,296,292,454,2297,3718,9,34017,1889,1,0
71,3403,1338,495,1086,10,64,173,1348,11,122,82,157,133,239,883,1686,7,11934,663,0,0
510,10903,72,33,56,0,4,12,72,1,1,1,1,2,2,0,2,0,1,0,0,0
510,10903,1454,835,1044,76,110,219,1530,17,275,158,296,292,454,2297,3718,9,34017,1889,1,0
71,3404,1338,495,1086,10,64,173,1348,11,122,82,157,133,239,883,1686,7,11934,663,0,0
511,10910,72,33,56,0,4,12,72,1,1,1,1,2,2,0,2,0,1,0,0,0
511,10910,1454,835,1044,76,110,219,1530,17,275,158,296,292,454,2297,3718,9,34017,1889,1,0
81,4395,1782,648,1425,9,47,279,1791,8,171,97,189,179,286,1292,2140,4,9462,525,0,0
511,10910,72,33,56,0,4,12,72,1,1,1,1,2,2,0,2,0,1,0,0,1
511,10910,1454,835,1044,76,110,219,1530,17,275,158,296,292,454,2297,3718,9,34017,1889,1,1
91,1678,1178,367,1042,6,15,115,1184,9,94,51,95,103,146,644,976,4,4439,246,0,0
91,1678,177,108,140,8,0,27,185,6,30,16,32,36,48,162,248,3,794,44,0,0
53,2322,1178,367,1042,6,15,115,1184,9,94,51,95,103,146,644,976,4,4439,246,0,0
92,1699,1178,367,1042,6,15,115,1184,9,94,51,95,103,146,644,976,4,4439,246,0,0
92,1699,177,108,140,8,0,27,185,6,30,16,32,36,48,162,248,3,794,44,0,0
54,2355,1178,367,1042,6,15,115,1184,9,94,51,95,103,146,644,976,4,4439,246,0,0
55,2386,1178,367,1042,6,15,115,1184,9,94,51,95,103,146,644,976,4,4439,246,0,0
92,1702,1178,367,1042,6,15,115,1184,9,94,51,95,103,146,644,976,4,4439,246,0,0
92,1702,177,108,140,8,0,27,185,6,30,16,32,36,48,162,248,3,794,44,0,0
55,2395,1178,367,1042,6,15,115,1184,9,94,51,95,103,146,644,976,4,4439,246,0,0
91,1695,1178,367,1042,6,15,115,1184,9,94,51,95,103,146,644,976,4,4439,246,0,0
91,1695,177,108,140,8,0,27,185,6,30,16,32,36,48,162,248,3,794,44,0,0
55,2401,1178,367,1042,6,15,115,1184,9,94,51,95,103,146,644,976,4,4439,246,0,0
94,1739,1178,367,1042,6,15,115,1184,9,94,51,95,103,146,644,976,4,4439,246,0,1
94,1739,177,108,140,8,0,27,185,6,30,16,32,36,48,162,248,3,794,44,0,1
56,2436,1178,367,1042,6,15,115,1184,9,94,51,95,103,146,644,976,4,4439,246,0,1
94,1739,1178,367,1042,6,15,115,1184,9,94,51,95,103,146,644,976,4,4439,246,0,0
94,1739,177,108,140,8,0,27,185,6,30,16,32,36,48,162,248,3,794,44,0,0
56,2436,1178,367,1042,6,15,115,1184,9,94,51,95,103,146,644,976,4,4439,246,0,0
94,1736,1178,367,1042,6,15,115,1184,9,94,51,95,103,146,644,976,4,4439,246,0,1
94,1736,177,108,140,8,0,27,185,6,30,16,32,36,48,162,248,3,794,44,0,1
56,2424,1178,367,1042,6,15,115,1184,9,94,51,95,103,146,644,976,4,4439,246,0,1
56,2424,1178,367,1042,6,15,115,1184,9,94,51,95,103,146,644,976,4,4439,246,0,0
94,1737,1178,367,1042,6,15,115,1184,9,94,51,95,103,146,644,976,4,4439,246,0,1
94,1737,177,108,140,8,0,27,185,6,30,16,32,36,48,162,248,3,794,44,0,1
56,2421,1178,367,1042,6,15,115,1184,9,94,51,95,103,146,644,976,4,4439,246,0,1
45,1334,1455,414,1257,16,76,112,1471,5,41,23,46,46,69,231,381,2,1069,59,0,1
45,1334,669,365,481,22,61,110,691,15,103,63,122,118,185,747,1273,8,11311,628,0,1
44,1867,1455,414,1257,16,76,112,1471,5,41,23,46,46,69,231,381,2,1069,59,0,1
72,3434,1338,495,1086,10,64,173,1348,11,122,82,157,133,239,883,1686,7,11934,663,0,0
55,2732,1457,730,1242,11,6,188,1468,10,292,166,329,302,495,2424,4078,5,22973,1276,1,1
297,6005,1457,730,1242,11,6,188,1468,10,292,166,329,302,495,2424,4078,5,22973,1276,1,0
297,6005,74,35,59,1,0,14,75,3,14,7,14,17,21,58,85,1,128,7,0,0
297,6005,245,125,200,5,7,34,250,7,30,17,34,37,51,166,265,3,1053,58,0,0
55,2710,1457,730,1242,11,6,188,1468,10,292,166,329,302,495,2424,4078,5,22973,1276,1,0
298,6078,1457,730,1242,11,6,188,1468,10,292,166,329,302,495,2424,4078,5,22973,1276,1,1
298,6078,74,35,59,1,0,14,75,3,14,7,14,17,21,58,85,1,128,7,0,1
298,6078,245,125,200,5,7,34,250,7,30,17,34,37,51,166,265,3,1053,58,0,1
55,2794,1457,730,1242,11,6,188,1468,10,292,166,329,302,495,2424,4078,5,22973,1276,1,1
55,2827,1457,730,1242,11,6,188,1468,10,292,166,329,302,495,2424,4078,5,22973,1276,1,1
298,6078,1457,730,1242,11,6,188,1468,10,292,166,329,302,495,2424,4078,5,22973,1276,1,0
298,6078,74,35,59,1,0,14,75,3,14,7,14,17,21,58,85,1,128,7,0,0
298,6078,245,125,200,5,7,34,250,7,30,17,34,37,51,166,265,3,1053,58,0,0
55,2827,1457,730,1242,11,6,188,1468,10,292,166,329,302,495,2424,4078,5,22973,1276,1,0
512,10947,72,33,56,0,4,12,72,1,1,1,1,2,2,0,2,0,1,0,0,1
512,10947,1454,835,1044,76,110,219,1530,17,275,158,296,292,454,2297,3718,9,34017,1889,1,1
512,10947,72,33,56,0,4,12,72,1,1,1,1,2,2,0,2,0,1,0,0,0
512,10947,1454,835,1044,76,110,219,1530,17,275,158,296,292,454,2297,3718,9,34017,1889,1,0
45,1334,1455,414,1257,16,76,112,1471,5,41,23,46,46,69,231,381,2,1069,59,0,0
45,1334,669,365,481,22,61,110,691,15,103,63,122,118,185,747,1273,8,11311,628,0,0
44,1867,1455,414,1257,16,76,112,1471,5,41,23,46,46,69,231,381,2,1069,59,0,0
513,10957,72,33,56,0,4,12,72,1,1,1,1,2,2,0,2,0,1,0,0,1
513,10957,1454,835,1044,76,110,219,1530,17,275,158,296,292,454,2297,3718,9,34017,1889,1,1
73,3470,1338,495,1086,10,64,173,1348,11,122,82,157,133,239,883,1686,7,11934,663,0,1
513,10957,72,33,56,0,4,12,72,1,1,1,1,2,2,0,2,0,1,0,0,0
513,10957,1454,835,1044,76,110,219,1530,17,275,158,296,292,454,2297,3718,9,34017,1889,1,0
73,3470,1338,495,1086,10,64,173,1348,11,122,82,157,133,239,883,1686,7,11934,663,0,0
513,10965,72,33,56,0,4,12,72,1,1,1,1,2,2,0,2,0,1,0,0,1
513,10965,1454,835,1044,76,110,219,1530,17,275,158,296,292,454,2297,3718,9,34017,1889,1,1
75,3563,1338,495,1086,10,64,173,1348,11,122,82,157,133,239,883,1686,7,11934,663,0,1
513,10965,72,33,56,0,4,12,72,1,1,1,1,2,2,0,2,0,1,0,0,0
513,10965,1454,835,1044,76,110,219,1530,17,275,158,296,292,454,2297,3718,9,34017,1889,1,0
75,3563,1338,495,1086,10,64,173,1348,11,122,82,157,133,239,883,1686,7,11934,663,0,0
147,4720,1660,832,1314,41,38,274,1701,20,312,209,395,332,604,2671,5058,12,64042,3557,1,0
147,4720,1057,646,719,113,100,145,1170,18,215,134,248,233,382,1740,3004,10,31186,1732,1,0
175,3619,1943,715,1694,26,18,214,1969,12,185,120,237,197,357,1436,2721,7,20915,1161,0,0
175,3619,1168,838,957,57,25,144,1225,19,348,224,416,367,640,3018,5452,11,61921,3440,1,0
51,1053,1098,241,925,5,10,155,1103,7,46,25,49,53,74,273,423,3,1580,87,0,1
51,1053,282,202,222,14,2,44,296,8,42,24,43,50,67,250,378,4,1548,86,0,1
38,1499,1098,241,925,5,10,155,1103,7,46,25,49,53,74,273,423,3,1580,87,0,1
38,1508,1098,241,925,5,10,155,1103,7,46,25,49,53,74,273,423,3,1580,87,0,1
53,1075,1098,241,925,5,10,155,1103,7,46,25,49,53,74,273,423,3,1580,87,0,0
53,1075,282,202,222,14,2,44,296,8,42,24,43,50,67,250,378,4,1548,86,0,0
38,1508,1098,241,925,5,10,155,1103,7,46,25,49,53,74,273,423,3,1580,87,0,0
46,532,647,139,84,35,284,233,682,0,0,0,0,0,0,0,0,0,0,0,0,1
46,532,647,139,84,35,284,233,682,0,0,0,0,0,0,0,0,0,0,0,0,0
21,574,1293,570,1093,25,15,163,1318,10,195,123,241,205,364,1516,2795,6,17273,959,0,0
38,889,386,256,301,16,9,68,402,4,59,35,69,63,104,355,621,2,1453,80,0,1
38,889,264,131,164,11,41,46,275,6,38,22,40,44,62,214,338,3,1068,59,0,1
40,935,386,256,301,16,9,68,402,4,59,35,69,63,104,355,621,2,1453,80,0,1
40,935,264,131,164,11,41,46,275,6,38,22,40,44,62,214,338,3,1068,59,0,1
27,1123,386,256,301,16,9,68,402,4,59,35,69,63,104,355,621,2,1453,80,0,1
40,935,386,256,301,16,9,68,402,4,59,35,69,63,104,355,621,2,1453,80,0,0
40,935,264,131,164,11,41,46,275,6,38,22,40,44,62,214,338,3,1068,59,0,0
27,1123,386,256,301,16,9,68,402,4,59,35,69,63,104,355,621,2,1453,80,0,0
16,491,184,100,137,2,15,30,186,6,38,20,39,44,59,214,322,3,991,55,0,1
16,491,103,65,74,8,5,16,111,7,17,9,17,24,26,89,119,3,417,23,0,1
16,487,184,100,137,2,15,30,186,6,38,20,39,44,59,214,322,3,991,55,0,0
16,487,103,65,74,8,5,16,111,7,17,9,17,24,26,89,119,3,417,23,0,0
11,386,184,100,137,2,15,30,186,6,38,20,39,44,59,214,322,3,991,55,0,0
513,10973,72,33,56,0,4,12,72,1,1,1,1,2,2,0,2,0,1,0,0,1
513,10973,1454,835,1044,76,110,219,1530,17,275,158,296,292,454,2297,3718,9,34017,1889,1,1
76,3610,1338,495,1086,10,64,173,1348,11,122,82,157,133,239,883,1686,7,11934,663,0,1
513,10967,72,33,56,0,4,12,72,1,1,1,1,2,2,0,2,0,1,0,0,0
513,10967,1454,835,1044,76,110,219,1530,17,275,158,296,292,454,2297,3718,9,34017,1889,1,0
32,933,465,148,393,5,8,60,470,4,31,20,31,35,51,161,261,2,523,29,0,0
32,933,16,12,9,0,0,6,16,1,2,1,2,3,3,2,4,0,2,0,0,0
513,10973,72,33,56,0,4,12,72,1,1,1,1,2,2,0,2,0,1,0,0,0
513,10973,1454,835,1044,76,110,219,1530,17,275,158,296,292,454,2297,3718,9,34017,1889,1,0
76,3610,1338,495,1086,10,64,173,1348,11,122,82,157,133,239,883,1686,7,11934,663,0,0
513,10975,72,33,56,0,4,12,72,1,1,1,1,2,2,0,2,0,1,0,0,0
513,10975,1454,835,1044,76,110,219,1530,17,275,158,296,292,454,2297,3718,9,34017,1889,1,0
176,3627,1943,715,1694,26,18,214,1969,12,185,120,237,197,357,1436,2721,7,20915,1161,0,0
176,3627,1168,838,957,57,25,144,1225,19,348,224,416,367,640,3018,5452,11,61921,3440,1,0
11,394,184,100,137,2,15,30,186,6,38,20,39,44,59,214,322,3,991,55,0,1
16,491,184,100,137,2,15,30,186,6,38,20,39,44,59,214,322,3,991,55,0,0
16,491,103,65,74,8,5,16,111,7,17,9,17,24,26,89,119,3,417,23,0,0
11,394,184,100,137,2,15,30,186,6,38,20,39,44,59,214,322,3,991,55,0,0
17,510,184,100,137,2,15,30,186,6,38,20,39,44,59,214,322,3,991,55,0,1
17,510,103,65,74,8,5,16,111,7,17,9,17,24,26,89,119,3,417,23,0,1
12,475,184,100,137,2,15,30,186,6,38,20,39,44,59,214,322,3,991,55,0,1
17,510,184,100,137,2,15,30,186,6,38,20,39,44,59,214,322,3,991,55,0,0
17,510,103,65,74,8,5,16,111,7,17,9,17,24,26,89,119,3,417,23,0,0
12,475,184,100,137,2,15,30,186,6,38,20,39,44,59,214,322,3,991,55,0,0
58,2876,1523,757,1297,19,12,193,1542,12,193,117,230,205,347,1508,2664,7,19053,1058,0,1
61,1745,1523,757,1297,19,12,193,1542,12,193,117,230,205,347,1508,2664,7,19053,1058,0,0
61,1745,701,378,504,33,58,109,734,13,110,68,126,123,194,794,1346,7,10027,557,0,0
60,2900,1523,757,1297,19,12,193,1542,12,193,117,230,205,347,1508,2664,7,19053,1058,0,0
61,1734,1523,757,1297,19,12,193,1542,12,193,117,230,205,347,1508,2664,7,19053,1058,0,0
61,1734,701,378,504,33,58,109,734,13,110,68,126,123,194,794,1346,7,10027,557,0,0
64,1801,1523,757,1297,19,12,193,1542,12,193,117,230,205,347,1508,2664,7,19053,1058,0,1
64,1801,701,378,504,33,58,109,734,13,110,68,126,123,194,794,1346,7,10027,557,0,1
64,1790,1523,757,1297,19,12,193,1542,12,193,117,230,205,347,1508,2664,7,19053,1058,0,0
64,1790,701,378,504,33,58,109,734,13,110,68,126,123,194,794,1346,7,10027,557,0,0
65,1814,1523,757,1297,19,12,193,1542,12,193,117,230,205,347,1508,2664,7,19053,1058,0,0
65,1814,701,378,504,33,58,109,734,13,110,68,126,123,194,794,1346,7,10027,557,0,0
61,2932,1523,757,1297,19,12,193,1542,12,193,117,230,205,347,1508,2664,7,19053,1058,0,0
65,1825,1523,757,1297,19,12,193,1542,12,193,117,230,205,347,1508,2664,7,19053,1058,0,1
65,1825,701,378,504,33,58,109,734,13,110,68,126,123,194,794,1346,7,10027,557,0,1
61,2942,1523,757,1297,19,12,193,1542,12,193,117,230,205,347,1508,2664,7,19053,1058,0,1
65,1835,1523,757,1297,19,12,193,1542,12,193,117,230,205,347,1508,2664,7,19053,1058,0,0
65,1835,701,378,504,33,58,109,734,13,110,68,126,123,194,794,1346,7,10027,557,0,0
61,2937,1523,757,1297,19,12,193,1542,12,193,117,230,205,347,1508,2664,7,19053,1058,0,0
67,1895,1523,757,1297,19,12,193,1542,12,193,117,230,205,347,1508,2664,7,19053,1058,0,0
67,1895,701,378,504,33,58,109,734,13,110,68,126,123,194,794,1346,7,10027,557,0,0
62,2941,1523,757,1297,19,12,193,1542,12,193,117,230,205,347,1508,2664,7,19053,1058,0,0
67,1895,1523,757,1297,19,12,193,1542,12,193,117,230,205,347,1508,2664,7,19053,1058,0,1
67,1895,701,378,504,33,58,109,734,13,110,68,126,123,194,794,1346,7,10027,557,0,1
63,2994,1523,757,1297,19,12,193,1542,12,193,117,230,205,347,1508,2664,7,19053,1058,0,1
67,1914,1523,757,1297,19,12,193,1542,12,193,117,230,205,347,1508,2664,7,19053,1058,0,1
67,1914,701,378,504,33,58,109,734,13,110,68,126,123,194,794,1346,7,10027,557,0,1
64,3043,1523,757,1297,19,12,193,1542,12,193,117,230,205,347,1508,2664,7,19053,1058,0,1
67,1914,1523,757,1297,19,12,193,1542,12,193,117,230,205,347,1508,2664,7,19053,1058,0,0
67,1914,701,378,504,33,58,109,734,13,110,68,126,123,194,794,1346,7,10027,557,0,0
64,3043,1523,757,1297,19,12,193,1542,12,193,117,230,205,347,1508,2664,7,19053,1058,0,0
116,2530,1043,504,840,53,9,147,1096,9,180,112,198,189,310,1377,2344,4,11604,644,0,1
116,2530,383,288,292,26,6,62,409,11,65,38,67,76,105,429,656,5,3719,206,0,1
95,1752,1178,367,1042,6,15,115,1184,9,94,51,95,103,146,644,976,4,4439,246,0,1
95,1752,177,108,140,8,0,27,185,6,30,16,32,36,48,162,248,3,794,44,0,1
180,3684,1943,715,1694,26,18,214,1969,12,185,120,237,197,357,1436,2721,7,20915,1161,0,1
180,3684,1168,838,957,57,25,144,1225,19,348,224,416,367,640,3018,5452,11,61921,3440,1,1
41,944,386,256,301,16,9,68,402,4,59,35,69,63,104,355,621,2,1453,80,0,0
41,944,264,131,164,11,41,46,275,6,38,22,40,44,62,214,338,3,1068,59,0,0
29,1180,386,256,301,16,9,68,402,4,59,35,69,63,104,355,621,2,1453,80,0,0
29,1184,386,256,301,16,9,68,402,4,59,35,69,63,104,355,621,2,1453,80,0,1
40,938,386,256,301,16,9,68,402,4,59,35,69,63,104,355,621,2,1453,80,0,1
40,938,264,131,164,11,41,46,275,6,38,22,40,44,62,214,338,3,1068,59,0,1
27,1135,386,256,301,16,9,68,402,4,59,35,69,63,104,355,621,2,1453,80,0,1
68,3477,1943,715,1694,26,18,214,1969,12,185,120,237,197,357,1436,2721,7,20915,1161,0,0
68,3495,1943,715,1694,26,18,214,1969,12,185,120,237,197,357,1436,2721,7,20915,1161,0,0
40,938,386,256,301,16,9,68,402,4,59,35,69,63,104,355,621,2,1453,80,0,0
40,938,264,131,164,11,41,46,275,6,38,22,40,44,62,214,338,3,1068,59,0,0
27,1135,386,256,301,16,9,68,402,4,59,35,69,63,104,355,621,2,1453,80,0,0
116,2530,1043,504,840,53,9,147,1096,9,180,112,198,189,310,1377,2344,4,11604,644,0,0
116,2530,383,288,292,26,6,62,409,11,65,38,67,76,105,429,656,5,3719,206,0,0
95,1752,1178,367,1042,6,15,115,1184,9,94,51,95,103,146,644,976,4,4439,246,0,0
95,1752,177,108,140,8,0,27,185,6,30,16,32,36,48,162,248,3,794,44,0,0
180,3684,1943,715,1694,26,18,214,1969,12,185,120,237,197,357,1436,2721,7,20915,1161,0,0
180,3684,1168,838,957,57,25,144,1225,19,348,224,416,367,640,3018,5452,11,61921,3440,1,0
513,10978,72,33,56,0,4,12,72,1,1,1,1,2,2,0,2,0,1,0,0,0
513,10978,1454,835,1044,76,110,219,1530,17,275,158,296,292,454,2297,3718,9,34017,1889,1,0
181,3706,1943,715,1694,26,18,214,1969,12,185,120,237,197,357,1436,2721,7,20915,1161,0,0
181,3706,1168,838,957,57,25,144,1225,19,348,224,416,367,640,3018,5452,11,61921,3440,1,0
29,1184,386,256,301,16,9,68,402,4,59,35,69,63,104,355,621,2,1453,80,0,0
41,947,386,256,301,16,9,68,402,4,59,35,69,63,104,355,621,2,1453,80,0,0
41,947,264,131,164,11,41,46,275,6,38,22,40,44,62,214,338,3,1068,59,0,0
29,1196,386,256,301,16,9,68,402,4,59,35,69,63,104,355,621,2,1453,80,0,0
77,3648,1338,495,1086,10,64,173,1348,11,122,82,157,133,239,883,1686,7,11934,663,0,1
77,3648,1338,495,1086,10,64,173,1348,11,122,82,157,133,239,883,1686,7,11934,663,0,0
77,3658,1338,495,1086,10,64,173,1348,11,122,82,157,133,239,883,1686,7,11934,663,0,0
77,3659,1338,495,1086,10,64,173,1348,11,122,82,157,133,239,883,1686,7,11934,663,0,0
69,1963,1523,757,1297,19,12,193,1542,12,193,117,230,205,347,1508,2664,7,19053,1058,0,0
69,1963,701,378,504,33,58,109,734,13,110,68,126,123,194,794,1346,7,10027,557,0,0
65,3107,1523,757,1297,19,12,193,1542,12,193,117,230,205,347,1508,2664,7,19053,1058,0,0
9,220,19,8,11,5,0,4,24,2,5,3,6,7,9,13,25,1,30,1,0,1
9,220,102,59,69,5,3,24,107,6,22,15,28,28,43,113,206,3,789,43,0,1
9,220,106,40,36,3,49,17,109,8,17,13,23,25,36,93,167,5,904,50,0,1
69,2867,1289,550,1043,56,32,155,1345,10,167,93,185,177,278,1266,2075,5,11498,638,0,1
74,2661,1450,624,1228,12,26,181,1462,14,306,186,354,320,540,2580,4493,8,36391,2021,1,1
63,2582,1020,354,843,12,15,144,1032,8,134,77,144,142,221,970,1580,4,6792,377,0,1
21,647,424,94,331,4,0,89,428,1,5,5,5,6,10,11,25,0,12,0,0,1
38,2201,334,251,279,10,4,40,344,5,127,74,143,132,217,899,1528,2,4303,239,0,1
9,220,19,8,11,5,0,4,24,2,5,3,6,7,9,13,25,1,30,1,0,0
9,220,102,59,69,5,3,24,107,6,22,15,28,28,43,113,206,3,789,43,0,0
9,220,106,40,36,3,49,17,109,8,17,13,23,25,36,93,167,5,904,50,0,0
69,2867,1289,550,1043,56,32,155,1345,10,167,93,185,177,278,1266,2075,5,11498,638,0,0
74,2661,1450,624,1228,12,26,181,1462,14,306,186,354,320,540,2580,4493,8,36391,2021,1,0
63,2582,1020,354,843,12,15,144,1032,8,134,77,144,142,221,970,1580,4,6792,377,0,0
21,647,424,94,331,4,0,89,428,1,5,5,5,6,10,11,25,0,12,0,0,0
38,2201,334,251,279,10,4,40,344,5,127,74,143,132,217,899,1528,2,4303,239,0,0
68,3173,1523,757,1297,19,12,193,1542,12,193,117,230,205,347,1508,2664,7,19053,1058,0,0
68,3179,1523,757,1297,19,12,193,1542,12,193,117,230,205,347,1508,2664,7,19053,1058,0,0
114,2289,1513,682,1277,25,13,200,1538,11,199,116,219,210,335,1557,2584,6,15641,868,0,0
114,2289,819,519,539,24,98,155,843,15,96,57,106,111,163,690,1107,8,9171,509,0,0
114,2287,1513,682,1277,25,13,200,1538,11,199,116,219,210,335,1557,2584,6,15641,868,0,1
114,2287,819,519,539,24,98,155,843,15,96,57,106,111,163,690,1107,8,9171,509,0,1
115,2299,1513,682,1277,25,13,200,1538,11,199,116,219,210,335,1557,2584,6,15641,868,0,1
115,2299,819,519,539,24,98,155,843,15,96,57,106,111,163,690,1107,8,9171,509,0,1
115,2299,1513,682,1277,25,13,200,1538,11,199,116,219,210,335,1557,2584,6,15641,868,0,0
115,2299,819,519,539,24,98,155,843,15,96,57,106,111,163,690,1107,8,9171,509,0,0
48,975,447,308,343,6,5,95,453,7,96,59,111,103,170,651,1136,4,4600,255,0,1
48,975,322,174,179,16,74,51,338,10,41,26,46,51,72,252,408,5,2291,127,0,1
36,1591,447,308,343,6,5,95,453,7,96,59,111,103,170,651,1136,4,4600,255,0,1
48,975,447,308,343,6,5,95,453,7,96,59,111,103,170,651,1136,4,4600,255,0,0
48,975,322,174,179,16,74,51,338,10,41,26,46,51,72,252,408,5,2291,127,0,0
36,1591,447,308,343,6,5,95,453,7,96,59,111,103,170,651,1136,4,4600,255,0,0
49,1414,1455,414,1257,16,76,112,1471,5,41,23,46,46,69,231,381,2,1069,59,0,1
49,1414,669,365,481,22,61,110,691,15,103,63,122,118,185,747,1273,8,11311,628,0,1
47,2014,1455,414,1257,16,76,112,1471,5,41,23,46,46,69,231,381,2,1069,59,0,1
48,973,447,308,343,6,5,95,453,7,96,59,111,103,170,651,1136,4,4600,255,0,1
48,973,322,174,179,16,74,51,338,10,41,26,46,51,72,252,408,5,2291,127,0,1
48,1368,1455,414,1257,16,76,112,1471,5,41,23,46,46,69,231,381,2,1069,59,0,0
48,1368,669,365,481,22,61,110,691,15,103,63,122,118,185,747,1273,8,11311,628,0,0
49,1371,1455,414,1257,16,76,112,1471,5,41,23,46,46,69,231,381,2,1069,59,0,1
49,1371,669,365,481,22,61,110,691,15,103,63,122,118,185,747,1273,8,11311,628,0,1
46,1984,1455,414,1257,16,76,112,1471,5,41,23,46,46,69,231,381,2,1069,59,0,1
49,1371,1455,414,1257,16,76,112,1471,5,41,23,46,46,69,231,381,2,1069,59,0,0
49,1371,669,365,481,22,61,110,691,15,103,63,122,118,185,747,1273,8,11311,628,0,0
46,1984,1455,414,1257,16,76,112,1471,5,41,23,46,46,69,231,381,2,1069,59,0,0
48,973,447,308,343,6,5,95,453,7,96,59,111,103,170,651,1136,4,4600,255,0,0
48,973,322,174,179,16,74,51,338,10,41,26,46,51,72,252,408,5,2291,127,0,0
53,1451,1455,414,1257,16,76,112,1471,5,41,23,46,46,69,231,381,2,1069,59,0,0
53,1451,669,365,481,22,61,110,691,15,103,63,122,118,185,747,1273,8,11311,628,0,0
49,2131,1455,414,1257,16,76,112,1471,5,41,23,46,46,69,231,381,2,1069,59,0,0
176,3627,1943,715,1694,26,18,214,1969,12,185,120,237,197,357,1436,2721,7,20915,1161,0,1
176,3627,1168,838,957,57,25,144,1225,19,348,224,416,367,640,3018,5452,11,61921,3440,1,1
66,3398,1943,715,1694,26,18,214,1969,12,185,120,237,197,357,1436,2721,7,20915,1161,0,1
66,3398,1943,715,1694,26,18,214,1969,12,185,120,237,197,357,1436,2721,7,20915,1161,0,0
69,3529,1943,715,1694,26,18,214,1969,12,185,120,237,197,357,1436,2721,7,20915,1161,0,0
45,1324,1455,414,1257,16,76,112,1471,5,41,23,46,46,69,231,381,2,1069,59,0,1
45,1324,669,365,481,22,61,110,691,15,103,63,122,118,185,747,1273,8,11311,628,0,1
46,1976,1455,414,1257,16,76,112,1471,5,41,23,46,46,69,231,381,2,1069,59,0,1
21,592,1293,570,1093,25,15,163,1318,10,195,123,241,205,364,1516,2795,6,17273,959,0,1
34,1287,1293,570,1093,25,15,163,1318,10,195,123,241,205,364,1516,2795,6,17273,959,0,1
21,592,1293,570,1093,25,15,163,1318,10,195,123,241,205,364,1516,2795,6,17273,959,0,0
34,1287,1293,570,1093,25,15,163,1318,10,195,123,241,205,364,1516,2795,6,17273,959,0,0
45,1324,1455,414,1257,16,76,112,1471,5,41,23,46,46,69,231,381,2,1069,59,0,0
45,1324,669,365,481,22,61,110,691,15,103,63,122,118,185,747,1273,8,11311,628,0,0
46,1976,1455,414,1257,16,76,112,1471,5,41,23,46,46,69,231,381,2,1069,59,0,0
36,711,2,2,2,0,0,0,2,0,0,0,0,0,0,0,0,0,0,0,0,1
36,711,99,48,90,1,3,5,100,0,0,0,0,0,0,0,0,0,0,0,0,1
36,711,8,5,5,2,0,1,10,0,0,0,0,0,0,0,0,0,0,0,0,1
36,711,1217,716,841,84,126,174,1301,14,185,118,215,199,333,1446,2542,8,20687,1149,0,1
36,711,160,89,115,0,13,31,160,7,15,11,17,22,28,78,124,3,495,27,0,1
36,711,10,10,9,9,0,0,19,0,0,0,0,0,0,0,0,0,0,0,0,1
36,711,173,84,99,8,29,36,181,5,12,7,13,17,20,54,81,2,221,12,0,1
36,711,3,1,1,3,0,0,6,0,0,0,0,0,0,0,0,0,0,0,0,1
74,2699,1450,624,1228,12,26,181,1462,14,306,186,354,320,540,2580,4493,8,36391,2021,1,1
36,711,2,2,2,0,0,0,2,0,0,0,0,0,0,0,0,0,0,0,0,0
36,711,99,48,90,1,3,5,100,0,0,0,0,0,0,0,0,0,0,0,0,0
36,711,8,5,5,2,0,1,10,0,0,0,0,0,0,0,0,0,0,0,0,0
36,711,1217,716,841,84,126,174,1301,14,185,118,215,199,333,1446,2542,8,20687,1149,0,0
36,711,160,89,115,0,13,31,160,7,15,11,17,22,28,78,124,3,495,27,0,0
36,711,10,10,9,9,0,0,19,0,0,0,0,0,0,0,0,0,0,0,0,0
36,711,173,84,99,8,29,36,181,5,12,7,13,17,20,54,81,2,221,12,0,0
36,711,3,1,1,3,0,0,6,0,0,0,0,0,0,0,0,0,0,0,0,0
74,2699,1450,624,1228,12,26,181,1462,14,306,186,354,320,540,2580,4493,8,36391,2021,1,0
513,10978,72,33,56,0,4,12,72,1,1,1,1,2,2,0,2,0,1,0,0,1
513,10978,1454,835,1044,76,110,219,1530,17,275,158,296,292,454,2297,3718,9,34017,1889,1,1
53,1075,1098,241,925,5,10,155,1103,7,46,25,49,53,74,273,423,3,1580,87,0,1
53,1075,282,202,222,14,2,44,296,8,42,24,43,50,67,250,378,4,1548,86,0,1
69,1969,1523,757,1297,19,12,193,1542,12,193,117,230,205,347,1508,2664,7,19053,1058,0,1
69,1969,701,378,504,33,58,109,734,13,110,68,126,123,194,794,1346,7,10027,557,0,1
70,3287,1523,757,1297,19,12,193,1542,12,193,117,230,205,347,1508,2664,7,19053,1058,0,1
69,1969,1523,757,1297,19,12,193,1542,12,193,117,230,205,347,1508,2664,7,19053,1058,0,0
69,1969,701,378,504,33,58,109,734,13,110,68,126,123,194,794,1346,7,10027,557,0,0
70,3287,1523,757,1297,19,12,193,1542,12,193,117,230,205,347,1508,2664,7,19053,1058,0,0
53,1441,1455,414,1257,16,76,112,1471,5,41,23,46,46,69,231,381,2,1069,59,0,1
53,1441,669,365,481,22,61,110,691,15,103,63,122,118,185,747,1273,8,11311,628,0,1
21,594,1293,570,1093,25,15,163,1318,10,195,123,241,205,364,1516,2795,6,17273,959,0,1
51,2240,1455,414,1257,16,76,112,1471,5,41,23,46,46,69,231,381,2,1069,59,0,1
53,1441,1455,414,1257,16,76,112,1471,5,41,23,46,46,69,231,381,2,1069,59,0,0
53,1441,669,365,481,22,61,110,691,15,103,63,122,118,185,747,1273,8,11311,628,0,0
21,594,1293,570,1093,25,15,163,1318,10,195,123,241,205,364,1516,2795,6,17273,959,0,0
51,2240,1455,414,1257,16,76,112,1471,5,41,23,46,46,69,231,381,2,1069,59,0,0
45,912,447,308,343,6,5,95,453,7,96,59,111,103,170,651,1136,4,4600,255,0,1
45,912,322,174,179,16,74,51,338,10,41,26,46,51,72,252,408,5,2291,127,0,1
38,1622,447,308,343,6,5,95,453,7,96,59,111,103,170,651,1136,4,4600,255,0,1
46,940,447,308,343,6,5,95,453,7,96,59,111,103,170,651,1136,4,4600,255,0,1
46,940,322,174,179,16,74,51,338,10,41,26,46,51,72,252,408,5,2291,127,0,1
38,1614,447,308,343,6,5,95,453,7,96,59,111,103,170,651,1136,4,4600,255,0,1
46,938,447,308,343,6,5,95,453,7,96,59,111,103,170,651,1136,4,4600,255,0,0
46,938,322,174,179,16,74,51,338,10,41,26,46,51,72,252,408,5,2291,127,0,0
46,939,447,308,343,6,5,95,453,7,96,59,111,103,170,651,1136,4,4600,255,0,0
46,939,322,174,179,16,74,51,338,10,41,26,46,51,72,252,408,5,2291,127,0,0
46,943,447,308,343,6,5,95,453,7,96,59,111,103,170,651,1136,4,4600,255,0,0
46,943,322,174,179,16,74,51,338,10,41,26,46,51,72,252,408,5,2291,127,0,0
38,1614,447,308,343,6,5,95,453,7,96,59,111,103,170,651,1136,4,4600,255,0,0
19,527,1450,624,1228,12,26,181,1462,14,306,186,354,320,540,2580,4493,8,36391,2021,1,1
199,4191,182,127,129,0,0,53,182,5,39,21,42,44,63,217,343,2,926,51,0,1
199,4191,1165,710,800,67,119,181,1232,18,243,153,282,261,435,2000,3492,10,36473,2026,1,1
100,2140,773,419,590,28,0,166,801,10,204,113,217,214,330,1598,2554,5,13587,754,0,1
100,2140,421,273,302,44,34,57,465,17,81,59,107,98,166,583,1098,11,12329,684,0,1
90,1944,477,336,357,30,23,73,507,16,194,134,250,210,384,1538,2962,10,30538,1696,0,1
298,6082,1457,730,1242,11,6,188,1468,10,292,166,329,302,495,2424,4078,5,22973,1276,1,1
298,6082,74,35,59,1,0,14,75,3,14,7,14,17,21,58,85,1,128,7,0,1
298,6082,245,125,200,5,7,34,250,7,30,17,34,37,51,166,265,3,1053,58,0,1
53,1439,1455,414,1257,16,76,112,1471,5,41,23,46,46,69,231,381,2,1069,59,0,1
53,1439,669,365,481,22,61,110,691,15,103,63,122,118,185,747,1273,8,11311,628,0,1
172,3987,77,34,69,0,0,8,77,3,24,16,29,27,45,114,213,1,387,21,0,1
172,3987,712,438,573,51,9,84,763,14,102,71,128,116,199,733,1364,8,11988,666,0,1
219,4866,722,423,573,19,0,135,741,12,172,101,199,184,300,1320,2257,6,15668,870,0,1
219,4866,1508,847,911,44,250,301,1552,14,148,88,169,162,257,1120,1886,7,15077,837,0,1
41,951,386,256,301,16,9,68,402,4,59,35,69,63,104,355,621,2,1453,80,0,1
41,951,264,131,164,11,41,46,275,6,38,22,40,44,62,214,338,3,1068,59,0,1
116,2524,1043,504,840,53,9,147,1096,9,180,112,198,189,310,1377,2344,4,11604,644,0,1
116,2524,383,288,292,26,6,62,409,11,65,38,67,76,105,429,656,5,3719,206,0,1
95,1756,1178,367,1042,6,15,115,1184,9,94,51,95,103,146,644,976,4,4439,246,0,1
95,1756,177,108,140,8,0,27,185,6,30,16,32,36,48,162,248,3,794,44,0,1
53,1077,1098,241,925,5,10,155,1103,7,46,25,49,53,74,273,423,3,1580,87,0,1
53,1077,282,202,222,14,2,44,296,8,42,24,43,50,67,250,378,4,1548,86,0,1
60,1074,282,196,195,3,0,86,285,8,130,71,141,138,212,936,1507,4,6538,363,0,1
20,619,42,7,35,4,0,5,46,1,2,1,2,3,3,2,4,0,2,0,0,1
20,619,11,6,10,0,0,1,11,2,4,2,4,6,6,10,15,1,15,0,0,1
69,2871,1289,550,1043,56,32,155,1345,10,167,93,185,177,278,1266,2075,5,11498,638,0,1
33,992,182,127,129,0,0,53,182,5,39,21,42,44,63,217,343,2,926,51,0,1
118,5254,1392,870,1177,35,17,170,1427,14,494,280,531,508,811,4473,7289,7,54850,3047,2,1
92,2943,773,419,590,28,0,166,801,10,204,113,217,214,330,1598,2554,5,13587,754,0,1
77,3663,1338,495,1086,10,64,173,1348,11,122,82,157,133,239,883,1686,7,11934,663,0,1
140,6182,139,89,101,2,0,35,141,7,54,34,62,61,96,330,569,4,2287,127,0,1
140,6182,7,5,5,0,0,2,7,1,2,1,2,3,3,2,4,0,2,0,0,1
32,933,465,148,393,5,8,60,470,4,31,20,31,35,51,161,261,2,523,29,0,1
32,933,16,12,9,0,0,6,16,1,2,1,2,3,3,2,4,0,2,0,0,1
81,4399,1782,648,1425,9,47,279,1791,8,171,97,189,179,286,1292,2140,4,9462,525,0,1
74,2703,1450,624,1228,12,26,181,1462,14,306,186,354,320,540,2580,4493,8,36391,2021,1,1
135,3522,1660,832,1314,41,38,274,1701,20,312,209,395,332,604,2671,5058,12,64042,3557,1,1
112,4316,1513,682,1277,25,13,200,1538,11,199,116,219,210,335,1557,2584,6,15641,868,0,1
55,2831,1457,730,1242,11,6,188,1468,10,292,166,329,302,495,2424,4078,5,22973,1276,1,1
35,2156,652,304,544,16,6,88,668,6,89,51,101,95,152,591,998,3,3399,188,0,1
51,2242,1455,414,1257,16,76,112,1471,5,41,23,46,46,69,231,381,2,1069,59,0,1
34,1289,1293,570,1093,25,15,163,1318,10,195,123,241,205,364,1516,2795,6,17273,959,0,1
16,1265,215,129,180,6,0,29,221,8,65,43,72,73,115,415,711,4,3153,175,0,1
57,2321,1043,504,840,53,9,147,1096,9,180,112,198,189,310,1377,2344,4,11604,644,0,1
69,3533,1943,715,1694,26,18,214,1969,12,185,120,237,197,357,1436,2721,7,20915,1161,0,1
199,4197,182,127,129,0,0,53,182,5,39,21,42,44,63,217,343,2,926,51,0,1
199,4197,1165,710,800,67,119,181,1232,18,243,153,282,261,435,2000,3492,10,36473,2026,1,1
92,2961,773,419,590,28,0,166,801,10,204,113,217,214,330,1598,2554,5,13587,754,0,0
53,1437,1455,414,1257,16,76,112,1471,5,41,23,46,46,69,231,381,2,1069,59,0,0
53,1437,669,365,481,22,61,110,691,15,103,63,122,118,185,747,1273,8,11311,628,0,0
199,4197,182,127,129,0,0,53,182,5,39,21,42,44,63,217,343,2,926,51,0,0
199,4197,1165,710,800,67,119,181,1232,18,243,153,282,261,435,2000,3492,10,36473,2026,1,0
100,2140,773,419,590,28,0,166,801,10,204,113,217,214,330,1598,2554,5,13587,754,0,0
100,2140,421,273,302,44,34,57,465,17,81,59,107,98,166,583,1098,11,12329,684,0,0
90,1944,477,336,357,30,23,73,507,16,194,134,250,210,384,1538,2962,10,30538,1696,0,0
298,6082,1457,730,1242,11,6,188,1468,10,292,166,329,302,495,2424,4078,5,22973,1276,1,0
298,6082,74,35,59,1,0,14,75,3,14,7,14,17,21,58,85,1,128,7,0,0
298,6082,245,125,200,5,7,34,250,7,30,17,34,37,51,166,265,3,1053,58,0,0
172,3987,77,34,69,0,0,8,77,3,24,16,29,27,45,114,213,1,387,21,0,0
172,3987,712,438,573,51,9,84,763,14,102,71,128,116,199,733,1364,8,11988,666,0,0
219,4866,722,423,573,19,0,135,741,12,172,101,199,184,300,1320,2257,6,15668,870,0,0
219,4866,1508,847,911,44,250,301,1552,14,148,88,169,162,257,1120,1886,7,15077,837,0,0
41,951,386,256,301,16,9,68,402,4,59,35,69,63,104,355,621,2,1453,80,0,0
41,951,264,131,164,11,41,46,275,6,38,22,40,44,62,214,338,3,1068,59,0,0
116,2524,1043,504,840,53,9,147,1096,9,180,112,198,189,310,1377,2344,4,11604,644,0,0
116,2524,383,288,292,26,6,62,409,11,65,38,67,76,105,429,656,5,3719,206,0,0
95,1756,1178,367,1042,6,15,115,1184,9,94,51,95,103,146,644,976,4,4439,246,0,0
95,1756,177,108,140,8,0,27,185,6,30,16,32,36,48,162,248,3,794,44,0,0
53,1077,1098,241,925,5,10,155,1103,7,46,25,49,53,74,273,423,3,1580,87,0,0
53,1077,282,202,222,14,2,44,296,8,42,24,43,50,67,250,378,4,1548,86,0,0
60,1074,282,196,195,3,0,86,285,8,130,71,141,138,212,936,1507,4,6538,363,0,0
20,619,42,7,35,4,0,5,46,1,2,1,2,3,3,2,4,0,2,0,0,0
20,619,11,6,10,0,0,1,11,2,4,2,4,6,6,10,15,1,15,0,0,0
69,2871,1289,550,1043,56,32,155,1345,10,167,93,185,177,278,1266,2075,5,11498,638,0,0
33,992,182,127,129,0,0,53,182,5,39,21,42,44,63,217,343,2,926,51,0,0
118,5254,1392,870,1177,35,17,170,1427,14,494,280,531,508,811,4473,7289,7,54850,3047,2,0
77,3663,1338,495,1086,10,64,173,1348,11,122,82,157,133,239,883,1686,7,11934,663,0,0
140,6182,139,89,101,2,0,35,141,7,54,34,62,61,96,330,569,4,2287,127,0,0
140,6182,7,5,5,0,0,2,7,1,2,1,2,3,3,2,4,0,2,0,0,0
81,4399,1782,648,1425,9,47,279,1791,8,171,97,189,179,286,1292,2140,4,9462,525,0,0
74,2703,1450,624,1228,12,26,181,1462,14,306,186,354,320,540,2580,4493,8,36391,2021,1,0
135,3522,1660,832,1314,41,38,274,1701,20,312,209,395,332,604,2671,5058,12,64042,3557,1,0
112,4316,1513,682,1277,25,13,200,1538,11,199,116,219,210,335,1557,2584,6,15641,868,0,0
55,2831,1457,730,1242,11,6,188,1468,10,292,166,329,302,495,2424,4078,5,22973,1276,1,0
35,2156,652,304,544,16,6,88,668,6,89,51,101,95,152,591,998,3,3399,188,0,0
51,2242,1455,414,1257,16,76,112,1471,5,41,23,46,46,69,231,381,2,1069,59,0,0
34,1289,1293,570,1093,25,15,163,1318,10,195,123,241,205,364,1516,2795,6,17273,959,0,0
16,1265,215,129,180,6,0,29,221,8,65,43,72,73,115,415,711,4,3153,175,0,0
57,2321,1043,504,840,53,9,147,1096,9,180,112,198,189,310,1377,2344,4,11604,644,0,0
69,3533,1943,715,1694,26,18,214,1969,12,185,120,237,197,357,1436,2721,7,20915,1161,0,0
57,1223,996,429,845,24,10,117,1020,7,76,50,88,83,138,494,879,4,3565,198,0,0
57,1223,456,277,329,12,42,72,468,13,85,50,97,98,147,592,972,7,7212,400,0,0
513,10983,72,33,56,0,4,12,72,1,1,1,1,2,2,0,2,0,1,0,0,0
513,10983,1454,835,1044,76,110,219,1530,17,275,158,296,292,454,2297,3718,9,34017,1889,1,0
13,271,256,139,192,9,7,47,265,4,23,12,24,27,36,112,171,2,357,19,0,0
147,4734,1660,832,1314,41,38,274,1701,20,312,209,395,332,604,2671,5058,12,64042,3557,1,1
147,4734,1057,646,719,113,100,145,1170,18,215,134,248,233,382,1740,3004,10,31186,1732,1,1
136,3553,1660,832,1314,41,38,274,1701,20,312,209,395,332,604,2671,5058,12,64042,3557,1,1
56,2421,1178,367,1042,6,15,115,1184,9,94,51,95,103,146,644,976,4,4439,246,0,0
136,3557,1660,832,1314,41,38,274,1701,20,312,209,395,332,604,2671,5058,12,64042,3557,1,0
147,4734,1660,832,1314,41,38,274,1701,20,312,209,395,332,604,2671,5058,12,64042,3557,1,0
147,4734,1057,646,719,113,100,145,1170,18,215,134,248,233,382,1740,3004,10,31186,1732,1,0
181,3718,1943,715,1694,26,18,214,1969,12,185,120,237,197,357,1436,2721,7,20915,1161,0,1
181,3718,1168,838,957,57,25,144,1225,19,348,224,416,367,640,3018,5452,11,61921,3440,1,1
69,3545,1943,715,1694,26,18,214,1969,12,185,120,237,197,357,1436,2721,7,20915,1161,0,1
181,3718,1943,715,1694,26,18,214,1969,12,185,120,237,197,357,1436,2721,7,20915,1161,0,0
181,3718,1168,838,957,57,25,144,1225,19,348,224,416,367,640,3018,5452,11,61921,3440,1,0
69,3545,1943,715,1694,26,18,214,1969,12,185,120,237,197,357,1436,2721,7,20915,1161,0,0
90,1950,477,336,357,30,23,73,507,16,194,134,250,210,384,1538,2962,10,30538,1696,0,1
75,2716,1450,624,1228,12,26,181,1462,14,306,186,354,320,540,2580,4493,8,36391,2021,1,1
90,1950,477,336,357,30,23,73,507,16,194,134,250,210,384,1538,2962,10,30538,1696,0,0
75,2716,1450,624,1228,12,26,181,1462,14,306,186,354,320,540,2580,4493,8,36391,2021,1,0
302,6165,1457,730,1242,11,6,188,1468,10,292,166,329,302,495,2424,4078,5,22973,1276,1,0
302,6165,74,35,59,1,0,14,75,3,14,7,14,17,21,58,85,1,128,7,0,0
302,6165,245,125,200,5,7,34,250,7,30,17,34,37,51,166,265,3,1053,58,0,0
57,2907,1457,730,1242,11,6,188,1468,10,292,166,329,302,495,2424,4078,5,22973,1276,1,0
98,1843,1178,367,1042,6,15,115,1184,9,94,51,95,103,146,644,976,4,4439,246,0,1
98,1843,177,108,140,8,0,27,185,6,30,16,32,36,48,162,248,3,794,44,0,1
63,2648,1178,367,1042,6,15,115,1184,9,94,51,95,103,146,644,976,4,4439,246,0,1
98,1843,1178,367,1042,6,15,115,1184,9,94,51,95,103,146,644,976,4,4439,246,0,0
98,1843,177,108,140,8,0,27,185,6,30,16,32,36,48,162,248,3,794,44,0,0
63,2648,1178,367,1042,6,15,115,1184,9,94,51,95,103,146,644,976,4,4439,246,0,0
98,1850,1178,367,1042,6,15,115,1184,9,94,51,95,103,146,644,976,4,4439,246,0,1
98,1850,177,108,140,8,0,27,185,6,30,16,32,36,48,162,248,3,794,44,0,1
77,3673,1338,495,1086,10,64,173,1348,11,122,82,157,133,239,883,1686,7,11934,663,0,1
63,2661,1178,367,1042,6,15,115,1184,9,94,51,95,103,146,644,976,4,4439,246,0,1
99,1863,1178,367,1042,6,15,115,1184,9,94,51,95,103,146,644,976,4,4439,246,0,1
99,1863,177,108,140,8,0,27,185,6,30,16,32,36,48,162,248,3,794,44,0,1
64,2726,1178,367,1042,6,15,115,1184,9,94,51,95,103,146,644,976,4,4439,246,0,1
60,1251,996,429,845,24,10,117,1020,7,76,50,88,83,138,494,879,4,3565,198,0,1
60,1251,456,277,329,12,42,72,468,13,85,50,97,98,147,592,972,7,7212,400,0,1
99,1863,1178,367,1042,6,15,115,1184,9,94,51,95,103,146,644,976,4,4439,246,0,0
99,1863,177,108,140,8,0,27,185,6,30,16,32,36,48,162,248,3,794,44,0,0
77,3673,1338,495,1086,10,64,173,1348,11,122,82,157,133,239,883,1686,7,11934,663,0,0
64,2726,1178,367,1042,6,15,115,1184,9,94,51,95,103,146,644,976,4,4439,246,0,0
181,3727,1943,715,1694,26,18,214,1969,12,185,120,237,197,357,1436,2721,7,20915,1161,0,0
181,3727,1168,838,957,57,25,144,1225,19,348,224,416,367,640,3018,5452,11,61921,3440,1,0
72,3652,1943,715,1694,26,18,214,1969,12,185,120,237,197,357,1436,2721,7,20915,1161,0,0
99,1873,1178,367,1042,6,15,115,1184,9,94,51,95,103,146,644,976,4,4439,246,0,1
99,1873,177,108,140,8,0,27,185,6,30,16,32,36,48,162,248,3,794,44,0,1
83,3847,1338,495,1086,10,64,173,1348,11,122,82,157,133,239,883,1686,7,11934,663,0,1
64,2751,1178,367,1042,6,15,115,1184,9,94,51,95,103,146,644,976,4,4439,246,0,0
513,10987,72,33,56,0,4,12,72,1,1,1,1,2,2,0,2,0,1,0,0,1
513,10987,1454,835,1044,76,110,219,1530,17,275,158,296,292,454,2297,3718,9,34017,1889,1,1
58,2427,1043,504,840,53,9,147,1096,9,180,112,198,189,310,1377,2344,4,11604,644,0,1
60,2418,1043,504,840,53,9,147,1096,9,180,112,198,189,310,1377,2344,4,11604,644,0,1
99,1873,1178,367,1042,6,15,115,1184,9,94,51,95,103,146,644,976,4,4439,246,0,0
99,1873,177,108,140,8,0,27,185,6,30,16,32,36,48,162,248,3,794,44,0,0
83,3847,1338,495,1086,10,64,173,1348,11,122,82,157,133,239,883,1686,7,11934,663,0,0
513,10987,72,33,56,0,4,12,72,1,1,1,1,2,2,0,2,0,1,0,0,0
513,10987,1454,835,1044,76,110,219,1530,17,275,158,296,292,454,2297,3718,9,34017,1889,1,0
60,2418,1043,504,840,53,9,147,1096,9,180,112,198,189,310,1377,2344,4,11604,644,0,0
68,1945,1523,757,1297,19,12,193,1542,12,193,117,230,205,347,1508,2664,7,19053,1058,0,1
68,1945,701,378,504,33,58,109,734,13,110,68,126,123,194,794,1346,7,10027,557,0,1
71,3371,1523,757,1297,19,12,193,1542,12,193,117,230,205,347,1508,2664,7,19053,1058,0,1
68,1945,1523,757,1297,19,12,193,1542,12,193,117,230,205,347,1508,2664,7,19053,1058,0,0
68,1945,701,378,504,33,58,109,734,13,110,68,126,123,194,794,1346,7,10027,557,0,0
71,3371,1523,757,1297,19,12,193,1542,12,193,117,230,205,347,1508,2664,7,19053,1058,0,0
56,1502,1455,414,1257,16,76,112,1471,5,41,23,46,46,69,231,381,2,1069,59,0,1
56,1502,669,365,481,22,61,110,691,15,103,63,122,118,185,747,1273,8,11311,628,0,1
53,2376,1455,414,1257,16,76,112,1471,5,41,23,46,46,69,231,381,2,1069,59,0,1
67,1986,1523,757,1297,19,12,193,1542,12,193,117,230,205,347,1508,2664,7,19053,1058,0,0
67,1986,701,378,504,33,58,109,734,13,110,68,126,123,194,794,1346,7,10027,557,0,0
72,3430,1523,757,1297,19,12,193,1542,12,193,117,230,205,347,1508,2664,7,19053,1058,0,0
56,1502,1455,414,1257,16,76,112,1471,5,41,23,46,46,69,231,381,2,1069,59,0,0
56,1502,669,365,481,22,61,110,691,15,103,63,122,118,185,747,1273,8,11311,628,0,0
53,2376,1455,414,1257,16,76,112,1471,5,41,23,46,46,69,231,381,2,1069,59,0,0
73,3480,1523,757,1297,19,12,193,1542,12,193,117,230,205,347,1508,2664,7,19053,1058,0,1
73,3480,1523,757,1297,19,12,193,1542,12,193,117,230,205,347,1508,2664,7,19053,1058,0,0
513,10991,72,33,56,0,4,12,72,1,1,1,1,2,2,0,2,0,1,0,0,1
513,10991,1454,835,1044,76,110,219,1530,17,275,158,296,292,454,2297,3718,9,34017,1889,1,1
116,2528,1043,504,840,53,9,147,1096,9,180,112,198,189,310,1377,2344,4,11604,644,0,1
116,2528,383,288,292,26,6,62,409,11,65,38,67,76,105,429,656,5,3719,206,0,1
62,2486,1043,504,840,53,9,147,1096,9,180,112,198,189,310,1377,2344,4,11604,644,0,1
36,1082,182,127,129,0,0,53,182,5,39,21,42,44,63,217,343,2,926,51,0,0
84,3883,1338,495,1086,10,64,173,1348,11,122,82,157,133,239,883,1686,7,11934,663,0,0
117,2546,1043,504,840,53,9,147,1096,9,180,112,198,189,310,1377,2344,4,11604,644,0,1
117,2546,383,288,292,26,6,62,409,11,65,38,67,76,105,429,656,5,3719,206,0,1
62,2505,1043,504,840,53,9,147,1096,9,180,112,198,189,310,1377,2344,4,11604,644,0,1
514,11003,72,33,56,0,4,12,72,1,1,1,1,2,2,0,2,0,1,0,0,1
514,11003,1454,835,1044,76,110,219,1530,17,275,158,296,292,454,2297,3718,9,34017,1889,1,1
70,2905,1289,550,1043,56,32,155,1345,10,167,93,185,177,278,1266,2075,5,11498,638,0,1
82,4441,1782,648,1425,9,47,279,1791,8,171,97,189,179,286,1292,2140,4,9462,525,0,1
513,10991,72,33,56,0,4,12,72,1,1,1,1,2,2,0,2,0,1,0,0,0
513,10991,1454,835,1044,76,110,219,1530,17,275,158,296,292,454,2297,3718,9,34017,1889,1,0
117,2546,1043,504,840,53,9,147,1096,9,180,112,198,189,310,1377,2344,4,11604,644,0,0
117,2546,383,288,292,26,6,62,409,11,65,38,67,76,105,429,656,5,3719,206,0,0
62,2505,1043,504,840,53,9,147,1096,9,180,112,198,189,310,1377,2344,4,11604,644,0,0
514,11007,72,33,56,0,4,12,72,1,1,1,1,2,2,0,2,0,1,0,0,0
514,11007,1454,835,1044,76,110,219,1530,17,275,158,296,292,454,2297,3718,9,34017,1889,1,0
70,2905,1289,550,1043,56,32,155,1345,10,167,93,185,177,278,1266,2075,5,11498,638,0,0
82,4441,1782,648,1425,9,47,279,1791,8,171,97,189,179,286,1292,2140,4,9462,525,0,0
526,11221,72,33,56,0,4,12,72,1,1,1,1,2,2,0,2,0,1,0,0,1
526,11221,1454,835,1044,76,110,219,1530,17,275,158,296,292,454,2297,3718,9,34017,1889,1,1
3,128,520,294,400,33,13,81,553,10,261,204,367,271,571,2128,4614,7,32445,1802,1,1
526,11222,72,33,56,0,4,12,72,1,1,1,1,2,2,0,2,0,1,0,0,1
526,11222,1454,835,1044,76,110,219,1530,17,275,158,296,292,454,2297,3718,9,34017,1889,1,1
4,159,520,294,400,33,13,81,553,10,261,204,367,271,571,2128,4614,7,32445,1802,1,1
527,11252,72,33,56,0,4,12,72,1,1,1,1,2,2,0,2,0,1,0,0,1
527,11252,1454,835,1044,76,110,219,1530,17,275,158,296,292,454,2297,3718,9,34017,1889,1,1
4,166,520,294,400,33,13,81,553,10,261,204,367,271,571,2128,4614,7,32445,1802,1,1
527,11252,72,33,56,0,4,12,72,1,1,1,1,2,2,0,2,0,1,0,0,0
527,11252,1454,835,1044,76,110,219,1530,17,275,158,296,292,454,2297,3718,9,34017,1889,1,0
527,11253,72,33,56,0,4,12,72,1,1,1,1,2,2,0,2,0,1,0,0,0
527,11253,1454,835,1044,76,110,219,1530,17,275,158,296,292,454,2297,3718,9,34017,1889,1,0
302,6177,1457,730,1242,11,6,188,1468,10,292,166,329,302,495,2424,4078,5,22973,1276,1,1
302,6177,74,35,59,1,0,14,75,3,14,7,14,17,21,58,85,1,128,7,0,1
302,6177,245,125,200,5,7,34,250,7,30,17,34,37,51,166,265,3,1053,58,0,1
35,1824,384,251,317,7,8,52,391,11,70,44,84,81,128,467,811,6,5355,297,0,1
514,11018,72,33,56,0,4,12,72,1,1,1,1,2,2,0,2,0,1,0,0,1
514,11018,1454,835,1044,76,110,219,1530,17,275,158,296,292,454,2297,3718,9,34017,1889,1,1
141,6212,139,89,101,2,0,35,141,7,54,34,62,61,96,330,569,4,2287,127,0,1
141,6212,7,5,5,0,0,2,7,1,2,1,2,3,3,2,4,0,2,0,0,1
304,6210,1457,730,1242,11,6,188,1468,10,292,166,329,302,495,2424,4078,5,22973,1276,1,1
304,6210,74,35,59,1,0,14,75,3,14,7,14,17,21,58,85,1,128,7,0,1
304,6210,245,125,200,5,7,34,250,7,30,17,34,37,51,166,265,3,1053,58,0,1
304,6210,1457,730,1242,11,6,188,1468,10,292,166,329,302,495,2424,4078,5,22973,1276,1,0
304,6210,74,35,59,1,0,14,75,3,14,7,14,17,21,58,85,1,128,7,0,0
304,6210,245,125,200,5,7,34,250,7,30,17,34,37,51,166,265,3,1053,58,0,0
35,1824,384,251,317,7,8,52,391,11,70,44,84,81,128,467,811,6,5355,297,0,0
60,1251,996,429,845,24,10,117,1020,7,76,50,88,83,138,494,879,4,3565,198,0,0
60,1251,456,277,329,12,42,72,468,13,85,50,97,98,147,592,972,7,7212,400,0,0
540,11486,72,33,56,0,4,12,72,1,1,1,1,2,2,0,2,0,1,0,0,1
540,11486,1454,835,1044,76,110,219,1530,17,275,158,296,292,454,2297,3718,9,34017,1889,1,1
43,2254,520,294,400,33,13,81,553,10,261,204,367,271,571,2128,4614,7,32445,1802,1,1
542,11516,72,33,56,0,4,12,72,1,1,1,1,2,2,0,2,0,1,0,0,1
542,11516,1454,835,1044,76,110,219,1530,17,275,158,296,292,454,2297,3718,9,34017,1889,1,1
43,2308,520,294,400,33,13,81,553,10,261,204,367,271,571,2128,4614,7,32445,1802,1,1
173,4001,77,34,69,0,0,8,77,3,24,16,29,27,45,114,213,1,387,21,0,0
173,4001,712,438,573,51,9,84,763,14,102,71,128,116,199,733,1364,8,11988,666,0,0
64,2629,1020,354,843,12,15,144,1032,8,134,77,144,142,221,970,1580,4,6792,377,0,0
514,11018,72,33,56,0,4,12,72,1,1,1,1,2,2,0,2,0,1,0,0,0
514,11018,1454,835,1044,76,110,219,1530,17,275,158,296,292,454,2297,3718,9,34017,1889,1,0
141,6212,139,89,101,2,0,35,141,7,54,34,62,61,96,330,569,4,2287,127,0,0
141,6212,7,5,5,0,0,2,7,1,2,1,2,3,3,2,4,0,2,0,0,0
543,11547,72,33,56,0,4,12,72,1,1,1,1,2,2,0,2,0,1,0,0,0
543,11547,1454,835,1044,76,110,219,1530,17,275,158,296,292,454,2297,3718,9,34017,1889,1,0
43,2308,520,294,400,33,13,81,553,10,261,204,367,271,571,2128,4614,7,32445,1802,1,0
72,2027,1523,757,1297,19,12,193,1542,12,193,117,230,205,347,1508,2664,7,19053,1058,0,1
72,2027,701,378,504,33,58,109,734,13,110,68,126,123,194,794,1346,7,10027,557,0,1
73,3542,1523,757,1297,19,12,193,1542,12,193,117,230,205,347,1508,2664,7,19053,1058,0,1
72,2027,1523,757,1297,19,12,193,1542,12,193,117,230,205,347,1508,2664,7,19053,1058,0,0
72,2027,701,378,504,33,58,109,734,13,110,68,126,123,194,794,1346,7,10027,557,0,0
73,3542,1523,757,1297,19,12,193,1542,12,193,117,230,205,347,1508,2664,7,19053,1058,0,0
71,2068,1523,757,1297,19,12,193,1542,12,193,117,230,205,347,1508,2664,7,19053,1058,0,0
71,2068,701,378,504,33,58,109,734,13,110,68,126,123,194,794,1346,7,10027,557,0,0
544,11567,72,33,56,0,4,12,72,1,1,1,1,2,2,0,2,0,1,0,0,0
544,11567,1454,835,1044,76,110,219,1530,17,275,158,296,292,454,2297,3718,9,34017,1889,1,0
75,3651,1523,757,1297,19,12,193,1542,12,193,117,230,205,347,1508,2664,7,19053,1058,0,0
515,11032,72,33,56,0,4,12,72,1,1,1,1,2,2,0,2,0,1,0,0,1
515,11032,1454,835,1044,76,110,219,1530,17,275,158,296,292,454,2297,3718,9,34017,1889,1,1
83,4493,1782,648,1425,9,47,279,1791,8,171,97,189,179,286,1292,2140,4,9462,525,0,1
84,4536,1782,648,1425,9,47,279,1791,8,171,97,189,179,286,1292,2140,4,9462,525,0,1
86,4628,1782,648,1425,9,47,279,1791,8,171,97,189,179,286,1292,2140,4,9462,525,0,0
209,4494,182,127,129,0,0,53,182,5,39,21,42,44,63,217,343,2,926,51,0,1
209,4494,1165,710,800,67,119,181,1232,18,243,153,282,261,435,2000,3492,10,36473,2026,1,1
117,2533,1043,504,840,53,9,147,1096,9,180,112,198,189,310,1377,2344,4,11604,644,0,1
117,2533,383,288,292,26,6,62,409,11,65,38,67,76,105,429,656,5,3719,206,0,1
128,5981,1392,870,1177,35,17,170,1427,14,494,280,531,508,811,4473,7289,7,54850,3047,2,1
118,2555,1043,504,840,53,9,147,1096,9,180,112,198,189,310,1377,2344,4,11604,644,0,0
118,2555,383,288,292,26,6,62,409,11,65,38,67,76,105,429,656,5,3719,206,0,0
515,11032,72,33,56,0,4,12,72,1,1,1,1,2,2,0,2,0,1,0,0,0
515,11032,1454,835,1044,76,110,219,1530,17,275,158,296,292,454,2297,3718,9,34017,1889,1,0
545,11592,72,33,56,0,4,12,72,1,1,1,1,2,2,0,2,0,1,0,0,0
545,11592,1454,835,1044,76,110,219,1530,17,275,158,296,292,454,2297,3718,9,34017,1889,1,0
545,11597,72,33,56,0,4,12,72,1,1,1,1,2,2,0,2,0,1,0,0,1
545,11597,1454,835,1044,76,110,219,1530,17,275,158,296,292,454,2297,3718,9,34017,1889,1,1
99,1883,1178,367,1042,6,15,115,1184,9,94,51,95,103,146,644,976,4,4439,246,0,1
99,1883,177,108,140,8,0,27,185,6,30,16,32,36,48,162,248,3,794,44,0,1
65,2786,1178,367,1042,6,15,115,1184,9,94,51,95,103,146,644,976,4,4439,246,0,1
99,1883,1178,367,1042,6,15,115,1184,9,94,51,95,103,146,644,976,4,4439,246,0,0
99,1883,177,108,140,8,0,27,185,6,30,16,32,36,48,162,248,3,794,44,0,0
65,2786,1178,367,1042,6,15,115,1184,9,94,51,95,103,146,644,976,4,4439,246,0,0
71,2068,1523,757,1297,19,12,193,1542,12,193,117,230,205,347,1508,2664,7,19053,1058,0,1
71,2068,701,378,504,33,58,109,734,13,110,68,126,123,194,794,1346,7,10027,557,0,1
173,4001,77,34,69,0,0,8,77,3,24,16,29,27,45,114,213,1,387,21,0,1
173,4001,712,438,573,51,9,84,763,14,102,71,128,116,199,733,1364,8,11988,666,0,1
545,11614,72,33,56,0,4,12,72,1,1,1,1,2,2,0,2,0,1,0,0,1
545,11614,1454,835,1044,76,110,219,1530,17,275,158,296,292,454,2297,3718,9,34017,1889,1,1
36,1082,182,127,129,0,0,53,182,5,39,21,42,44,63,217,343,2,926,51,0,1
84,3883,1338,495,1086,10,64,173,1348,11,122,82,157,133,239,883,1686,7,11934,663,0,1
86,4628,1782,648,1425,9,47,279,1791,8,171,97,189,179,286,1292,2140,4,9462,525,0,1
75,3651,1523,757,1297,19,12,193,1542,12,193,117,230,205,347,1508,2664,7,19053,1058,0,1
64,2629,1020,354,843,12,15,144,1032,8,134,77,144,142,221,970,1580,4,6792,377,0,1
548,11627,72,33,56,0,4,12,72,1,1,1,1,2,2,0,2,0,1,0,0,1
548,11627,1454,835,1044,76,110,219,1530,17,275,158,296,292,454,2297,3718,9,34017,1889,1,1
86,4636,1782,648,1425,9,47,279,1791,8,171,97,189,179,286,1292,2140,4,9462,525,0,1
548,11638,72,33,56,0,4,12,72,1,1,1,1,2,2,0,2,0,1,0,0,0
548,11638,1454,835,1044,76,110,219,1530,17,275,158,296,292,454,2297,3718,9,34017,1889,1,0
86,4636,1782,648,1425,9,47,279,1791,8,171,97,189,179,286,1292,2140,4,9462,525,0,0
17,386,85,59,61,8,0,16,93,5,18,10,18,23,28,86,126,2,316,17,0,0
545,11616,72,33,56,0,4,12,72,1,1,1,1,2,2,0,2,0,1,0,0,1
545,11616,1454,835,1044,76,110,219,1530,17,275,158,296,292,454,2297,3718,9,34017,1889,1,1
86,4619,1782,648,1425,9,47,279,1791,8,171,97,189,179,286,1292,2140,4,9462,525,0,1
68,1241,1020,354,843,12,15,144,1032,8,134,77,144,142,221,970,1580,4,6792,377,0,1
71,2935,1289,550,1043,56,32,155,1345,10,167,93,185,177,278,1266,2075,5,11498,638,0,1
68,1241,1020,354,843,12,15,144,1032,8,134,77,144,142,221,970,1580,4,6792,377,0,0
71,2935,1289,550,1043,56,32,155,1345,10,167,93,185,177,278,1266,2075,5,11498,638,0,0
88,4705,1782,648,1425,9,47,279,1791,8,171,97,189,179,286,1292,2140,4,9462,525,0,1
548,11662,72,33,56,0,4,12,72,1,1,1,1,2,2,0,2,0,1,0,0,1
548,11662,1454,835,1044,76,110,219,1530,17,275,158,296,292,454,2297,3718,9,34017,1889,1,1
88,4713,1782,648,1425,9,47,279,1791,8,171,97,189,179,286,1292,2140,4,9462,525,0,1
201,4242,182,127,129,0,0,53,182,5,39,21,42,44,63,217,343,2,926,51,0,1
201,4242,1165,710,800,67,119,181,1232,18,243,153,282,261,435,2000,3492,10,36473,2026,1,1
120,5315,1392,870,1177,35,17,170,1427,14,494,280,531,508,811,4473,7289,7,54850,3047,2,1
201,4242,182,127,129,0,0,53,182,5,39,21,42,44,63,217,343,2,926,51,0,0
201,4242,1165,710,800,67,119,181,1232,18,243,153,282,261,435,2000,3492,10,36473,2026,1,0
120,5315,1392,870,1177,35,17,170,1427,14,494,280,531,508,811,4473,7289,7,54850,3047,2,0
548,11662,72,33,56,0,4,12,72,1,1,1,1,2,2,0,2,0,1,0,0,0
548,11662,1454,835,1044,76,110,219,1530,17,275,158,296,292,454,2297,3718,9,34017,1889,1,0
88,4713,1782,648,1425,9,47,279,1791,8,171,97,189,179,286,1292,2140,4,9462,525,0,0
211,4539,182,127,129,0,0,53,182,5,39,21,42,44,63,217,343,2,926,51,0,0
211,4539,1165,710,800,67,119,181,1232,18,243,153,282,261,435,2000,3492,10,36473,2026,1,0
130,6042,1392,870,1177,35,17,170,1427,14,494,280,531,508,811,4473,7289,7,54850,3047,2,0
202,4248,182,127,129,0,0,53,182,5,39,21,42,44,63,217,343,2,926,51,0,1
202,4248,1165,710,800,67,119,181,1232,18,243,153,282,261,435,2000,3492,10,36473,2026,1,1
121,5350,1392,870,1177,35,17,170,1427,14,494,280,531,508,811,4473,7289,7,54850,3047,2,1
202,4248,182,127,129,0,0,53,182,5,39,21,42,44,63,217,343,2,926,51,0,0
202,4248,1165,710,800,67,119,181,1232,18,243,153,282,261,435,2000,3492,10,36473,2026,1,0
121,5350,1392,870,1177,35,17,170,1427,14,494,280,531,508,811,4473,7289,7,54850,3047,2,0
305,6231,1457,730,1242,11,6,188,1468,10,292,166,329,302,495,2424,4078,5,22973,1276,1,0
305,6231,74,35,59,1,0,14,75,3,14,7,14,17,21,58,85,1,128,7,0,0
305,6231,245,125,200,5,7,34,250,7,30,17,34,37,51,166,265,3,1053,58,0,0
101,1905,1178,367,1042,6,15,115,1184,9,94,51,95,103,146,644,976,4,4439,246,0,1
101,1905,177,108,140,8,0,27,185,6,30,16,32,36,48,162,248,3,794,44,0,1
66,2845,1178,367,1042,6,15,115,1184,9,94,51,95,103,146,644,976,4,4439,246,0,1
304,6218,1457,730,1242,11,6,188,1468,10,292,166,329,302,495,2424,4078,5,22973,1276,1,1
304,6218,74,35,59,1,0,14,75,3,14,7,14,17,21,58,85,1,128,7,0,1
304,6218,245,125,200,5,7,34,250,7,30,17,34,37,51,166,265,3,1053,58,0,1
58,2960,1457,730,1242,11,6,188,1468,10,292,166,329,302,495,2424,4078,5,22973,1276,1,1
217,4674,182,127,129,0,0,53,182,5,39,21,42,44,63,217,343,2,926,51,0,0
217,4674,1165,710,800,67,119,181,1232,18,243,153,282,261,435,2000,3492,10,36473,2026,1,0
135,6195,1392,870,1177,35,17,170,1427,14,494,280,531,508,811,4473,7289,7,54850,3047,2,0
212,4592,182,127,129,0,0,53,182,5,39,21,42,44,63,217,343,2,926,51,0,1
212,4592,1165,710,800,67,119,181,1232,18,243,153,282,261,435,2000,3492,10,36473,2026,1,1
135,6209,1392,870,1177,35,17,170,1427,14,494,280,531,508,811,4473,7289,7,54850,3047,2,1
212,4596,182,127,129,0,0,53,182,5,39,21,42,44,63,217,343,2,926,51,0,1
212,4596,1165,710,800,67,119,181,1232,18,243,153,282,261,435,2000,3492,10,36473,2026,1,1
212,4596,182,127,129,0,0,53,182,5,39,21,42,44,63,217,343,2,926,51,0,0
212,4596,1165,710,800,67,119,181,1232,18,243,153,282,261,435,2000,3492,10,36473,2026,1,0
135,6209,1392,870,1177,35,17,170,1427,14,494,280,531,508,811,4473,7289,7,54850,3047,2,0
304,6218,1457,730,1242,11,6,188,1468,10,292,166,329,302,495,2424,4078,5,22973,1276,1,0
304,6218,74,35,59,1,0,14,75,3,14,7,14,17,21,58,85,1,128,7,0,0
304,6218,245,125,200,5,7,34,250,7,30,17,34,37,51,166,265,3,1053,58,0,0
58,2960,1457,730,1242,11,6,188,1468,10,292,166,329,302,495,2424,4078,5,22973,1276,1,0
550,11695,72,33,56,0,4,12,72,1,1,1,1,2,2,0,2,0,1,0,0,1
550,11695,1454,835,1044,76,110,219,1530,17,275,158,296,292,454,2297,3718,9,34017,1889,1,1
70,2907,1289,550,1043,56,32,155,1345,10,167,93,185,177,278,1266,2075,5,11498,638,0,1
85,3922,1338,495,1086,10,64,173,1348,11,122,82,157,133,239,883,1686,7,11934,663,0,1
72,3652,1943,715,1694,26,18,214,1969,12,185,120,237,197,357,1436,2721,7,20915,1161,0,1
47,546,647,139,84,35,284,233,682,0,0,0,0,0,0,0,0,0,0,0,0,1
551,11706,72,33,56,0,4,12,72,1,1,1,1,2,2,0,2,0,1,0,0,1
551,11706,1454,835,1044,76,110,219,1530,17,275,158,296,292,454,2297,3718,9,34017,1889,1,1
551,11710,72,33,56,0,4,12,72,1,1,1,1,2,2,0,2,0,1,0,0,1
551,11710,1454,835,1044,76,110,219,1530,17,275,158,296,292,454,2297,3718,9,34017,1889,1,1
89,4754,1782,648,1425,9,47,279,1791,8,171,97,189,179,286,1292,2140,4,9462,525,0,1
550,11695,72,33,56,0,4,12,72,1,1,1,1,2,2,0,2,0,1,0,0,0
550,11695,1454,835,1044,76,110,219,1530,17,275,158,296,292,454,2297,3718,9,34017,1889,1,0
70,2907,1289,550,1043,56,32,155,1345,10,167,93,185,177,278,1266,2075,5,11498,638,0,0
85,3922,1338,495,1086,10,64,173,1348,11,122,82,157,133,239,883,1686,7,11934,663,0,0
47,548,647,139,84,35,284,233,682,0,0,0,0,0,0,0,0,0,0,0,0,1
551,11716,72,33,56,0,4,12,72,1,1,1,1,2,2,0,2,0,1,0,0,1
551,11716,1454,835,1044,76,110,219,1530,17,275,158,296,292,454,2297,3718,9,34017,1889,1,1
47,548,647,139,84,35,284,233,682,0,0,0,0,0,0,0,0,0,0,0,0,0
553,11749,72,33,56,0,4,12,72,1,1,1,1,2,2,0,2,0,1,0,0,0
553,11749,1454,835,1044,76,110,219,1530,17,275,158,296,292,454,2297,3718,9,34017,1889,1,0
89,4754,1782,648,1425,9,47,279,1791,8,171,97,189,179,286,1292,2140,4,9462,525,0,0
65,2670,1020,354,843,12,15,144,1032,8,134,77,144,142,221,970,1580,4,6792,377,0,0
65,2675,1020,354,843,12,15,144,1032,8,134,77,144,142,221,970,1580,4,6792,377,0,1
67,1993,1523,757,1297,19,12,193,1542,12,193,117,230,205,347,1508,2664,7,19053,1058,0,1
67,1993,701,378,504,33,58,109,734,13,110,68,126,123,194,794,1346,7,10027,557,0,1
67,1993,1523,757,1297,19,12,193,1542,12,193,117,230,205,347,1508,2664,7,19053,1058,0,0
67,1993,701,378,504,33,58,109,734,13,110,68,126,123,194,794,1346,7,10027,557,0,0
215,4647,182,127,129,0,0,53,182,5,39,21,42,44,63,217,343,2,926,51,0,0
215,4647,1165,710,800,67,119,181,1232,18,243,153,282,261,435,2000,3492,10,36473,2026,1,0
71,2937,1289,550,1043,56,32,155,1345,10,167,93,185,177,278,1266,2075,5,11498,638,0,0
138,6305,1392,870,1177,35,17,170,1427,14,494,280,531,508,811,4473,7289,7,54850,3047,2,0
71,2075,1523,757,1297,19,12,193,1542,12,193,117,230,205,347,1508,2664,7,19053,1058,0,0
71,2075,701,378,504,33,58,109,734,13,110,68,126,123,194,794,1346,7,10027,557,0,0
54,1089,1098,241,925,5,10,155,1103,7,46,25,49,53,74,273,423,3,1580,87,0,1
54,1089,282,202,222,14,2,44,296,8,42,24,43,50,67,250,378,4,1548,86,0,1
39,1537,1098,241,925,5,10,155,1103,7,46,25,49,53,74,273,423,3,1580,87,0,1
65,2675,1020,354,843,12,15,144,1032,8,134,77,144,142,221,970,1580,4,6792,377,0,0
54,1089,1098,241,925,5,10,155,1103,7,46,25,49,53,74,273,423,3,1580,87,0,0
54,1089,282,202,222,14,2,44,296,8,42,24,43,50,67,250,378,4,1548,86,0,0
39,1537,1098,241,925,5,10,155,1103,7,46,25,49,53,74,273,423,3,1580,87,0,0
173,4005,77,34,69,0,0,8,77,3,24,16,29,27,45,114,213,1,387,21,0,1
173,4005,712,438,573,51,9,84,763,14,102,71,128,116,199,733,1364,8,11988,666,0,1
53,3004,1296,573,1062,40,33,157,1336,8,201,118,231,209,349,1561,2689,4,12365,686,0,1
173,4005,77,34,69,0,0,8,77,3,24,16,29,27,45,114,213,1,387,21,0,0
173,4005,712,438,573,51,9,84,763,14,102,71,128,116,199,733,1364,8,11988,666,0,0
53,3007,1296,573,1062,40,33,157,1336,8,201,118,231,209,349,1561,2689,4,12365,686,0,0
514,11040,72,33,56,0,4,12,72,1,1,1,1,2,2,0,2,0,1,0,0,1
514,11040,1454,835,1044,76,110,219,1530,17,275,158,296,292,454,2297,3718,9,34017,1889,1,1
83,4488,1782,648,1425,9,47,279,1791,8,171,97,189,179,286,1292,2140,4,9462,525,0,1
513,11010,72,33,56,0,4,12,72,1,1,1,1,2,2,0,2,0,1,0,0,1
513,11010,1454,835,1044,76,110,219,1530,17,275,158,296,292,454,2297,3718,9,34017,1889,1,1
513,11012,72,33,56,0,4,12,72,1,1,1,1,2,2,0,2,0,1,0,0,1
513,11012,1454,835,1044,76,110,219,1530,17,275,158,296,292,454,2297,3718,9,34017,1889,1,1
513,11012,72,33,56,0,4,12,72,1,1,1,1,2,2,0,2,0,1,0,0,0
513,11012,1454,835,1044,76,110,219,1530,17,275,158,296,292,454,2297,3718,9,34017,1889,1,0
83,4488,1782,648,1425,9,47,279,1791,8,171,97,189,179,286,1292,2140,4,9462,525,0,0
101,1905,1178,367,1042,6,15,115,1184,9,94,51,95,103,146,644,976,4,4439,246,0,0
101,1905,177,108,140,8,0,27,185,6,30,16,32,36,48,162,248,3,794,44,0,0
66,2845,1178,367,1042,6,15,115,1184,9,94,51,95,103,146,644,976,4,4439,246,0,0
514,11010,72,33,56,0,4,12,72,1,1,1,1,2,2,0,2,0,1,0,0,1
514,11010,1454,835,1044,76,110,219,1530,17,275,158,296,292,454,2297,3718,9,34017,1889,1,1
141,6224,139,89,101,2,0,35,141,7,54,34,62,61,96,330,569,4,2287,127,0,0
141,6224,7,5,5,0,0,2,7,1,2,1,2,3,3,2,4,0,2,0,0,0
514,11010,72,33,56,0,4,12,72,1,1,1,1,2,2,0,2,0,1,0,0,0
514,11010,1454,835,1044,76,110,219,1530,17,275,158,296,292,454,2297,3718,9,34017,1889,1,0
553,11752,72,33,56,0,4,12,72,1,1,1,1,2,2,0,2,0,1,0,0,0
553,11752,1454,835,1044,76,110,219,1530,17,275,158,296,292,454,2297,3718,9,34017,1889,1,0
142,6254,139,89,101,2,0,35,141,7,54,34,62,61,96,330,569,4,2287,127,0,0
142,6254,7,5,5,0,0,2,7,1,2,1,2,3,3,2,4,0,2,0,0,0
90,4801,1782,648,1425,9,47,279,1791,8,171,97,189,179,286,1292,2140,4,9462,525,0,0
53,1425,1455,414,1257,16,76,112,1471,5,41,23,46,46,69,231,381,2,1069,59,0,0
53,1425,669,365,481,22,61,110,691,15,103,63,122,118,185,747,1273,8,11311,628,0,0
52,2288,1455,414,1257,16,76,112,1471,5,41,23,46,46,69,231,381,2,1069,59,0,0
203,4258,182,127,129,0,0,53,182,5,39,21,42,44,63,217,343,2,926,51,0,1
203,4258,1165,710,800,67,119,181,1232,18,243,153,282,261,435,2000,3492,10,36473,2026,1,1
174,4021,77,34,69,0,0,8,77,3,24,16,29,27,45,114,213,1,387,21,0,1
174,4021,712,438,573,51,9,84,763,14,102,71,128,116,199,733,1364,8,11988,666,0,1
122,5398,1392,870,1177,35,17,170,1427,14,494,280,531,508,811,4473,7289,7,54850,3047,2,1
553,11758,72,33,56,0,4,12,72,1,1,1,1,2,2,0,2,0,1,0,0,1
553,11758,1454,835,1044,76,110,219,1530,17,275,158,296,292,454,2297,3718,9,34017,1889,1,1
140,6252,139,89,101,2,0,35,141,7,54,34,62,61,96,330,569,4,2287,127,0,1
140,6252,7,5,5,0,0,2,7,1,2,1,2,3,3,2,4,0,2,0,0,1
553,11773,72,33,56,0,4,12,72,1,1,1,1,2,2,0,2,0,1,0,0,1
553,11773,1454,835,1044,76,110,219,1530,17,275,158,296,292,454,2297,3718,9,34017,1889,1,1
140,6263,139,89,101,2,0,35,141,7,54,34,62,61,96,330,569,4,2287,127,0,1
140,6263,7,5,5,0,0,2,7,1,2,1,2,3,3,2,4,0,2,0,0,1
553,11737,72,33,56,0,4,12,72,1,1,1,1,2,2,0,2,0,1,0,0,1
553,11737,1454,835,1044,76,110,219,1530,17,275,158,296,292,454,2297,3718,9,34017,1889,1,1
3,63,127,75,83,2,11,30,129,4,14,7,14,18,21,61,87,2,175,9,0,1
3,63,652,304,544,16,6,88,668,6,89,51,101,95,152,591,998,3,3399,188,0,1
3,63,2,2,2,0,0,0,2,0,0,0,0,0,0,0,0,0,0,0,0,1
3,63,8,5,5,0,0,3,8,0,0,0,0,0,0,0,0,0,0,0,0,1
3,63,14,8,8,0,0,6,14,0,0,0,0,0,0,0,0,0,0,0,0,1
3,63,6,4,4,0,0,2,6,0,0,0,0,0,0,0,0,0,0,0,0,1
3,63,6,4,4,0,0,2,6,1,2,1,2,3,3,2,4,0,2,0,0,1
3,63,7,5,5,0,0,2,7,0,0,0,0,0,0,0,0,0,0,0,0,1
3,63,10,6,6,0,0,4,10,0,0,0,0,0,0,0,0,0,0,0,0,1
3,63,1,1,1,0,0,0,1,0,0,0,0,0,0,0,0,0,0,0,0,1
3,63,14,10,10,0,0,4,14,1,1,1,1,2,2,0,2,0,1,0,0,1
3,63,46,26,30,3,0,12,49,3,6,3,6,9,9,20,28,1,42,2,0,1
550,11685,72,33,56,0,4,12,72,1,1,1,1,2,2,0,2,0,1,0,0,1
550,11685,1454,835,1044,76,110,219,1530,17,275,158,296,292,454,2297,3718,9,34017,1889,1,1
203,4258,182,127,129,0,0,53,182,5,39,21,42,44,63,217,343,2,926,51,0,0
203,4258,1165,710,800,67,119,181,1232,18,243,153,282,261,435,2000,3492,10,36473,2026,1,0
174,4021,77,34,69,0,0,8,77,3,24,16,29,27,45,114,213,1,387,21,0,0
174,4021,712,438,573,51,9,84,763,14,102,71,128,116,199,733,1364,8,11988,666,0,0
122,5398,1392,870,1177,35,17,170,1427,14,494,280,531,508,811,4473,7289,7,54850,3047,2,0
5,280,180,34,164,0,0,16,180,1,12,6,12,13,18,43,66,0,33,1,0,0
568,12095,72,33,56,0,4,12,72,1,1,1,1,2,2,0,2,0,1,0,0,1
568,12095,1454,835,1044,76,110,219,1530,17,275,158,296,292,454,2297,3718,9,34017,1889,1,1
175,4054,77,34,69,0,0,8,77,3,24,16,29,27,45,114,213,1,387,21,0,1
175,4054,712,438,573,51,9,84,763,14,102,71,128,116,199,733,1364,8,11988,666,0,1
63,2641,1043,504,840,53,9,147,1096,9,180,112,198,189,310,1377,2344,4,11604,644,0,1
175,4054,77,34,69,0,0,8,77,3,24,16,29,27,45,114,213,1,387,21,0,0
175,4054,712,438,573,51,9,84,763,14,102,71,128,116,199,733,1364,8,11988,666,0,0
63,2641,1043,504,840,53,9,147,1096,9,180,112,198,189,310,1377,2344,4,11604,644,0,0
5,280,180,34,164,0,0,16,180,1,12,6,12,13,18,43,66,0,33,1,0,1
174,4005,77,34,69,0,0,8,77,3,24,16,29,27,45,114,213,1,387,21,0,1
174,4005,712,438,573,51,9,84,763,14,102,71,128,116,199,733,1364,8,11988,666,0,1
78,3195,1289,550,1043,56,32,155,1345,10,167,93,185,177,278,1266,2075,5,11498,638,0,1
174,4006,77,34,69,0,0,8,77,3,24,16,29,27,45,114,213,1,387,21,0,1
174,4006,712,438,573,51,9,84,763,14,102,71,128,116,199,733,1364,8,11988,666,0,1
77,3168,1289,550,1043,56,32,155,1345,10,167,93,185,177,278,1266,2075,5,11498,638,0,1
550,11685,72,33,56,0,4,12,72,1,1,1,1,2,2,0,2,0,1,0,0,0
550,11685,1454,835,1044,76,110,219,1530,17,275,158,296,292,454,2297,3718,9,34017,1889,1,0
3,63,127,75,83,2,11,30,129,4,14,7,14,18,21,61,87,2,175,9,0,0
3,63,652,304,544,16,6,88,668,6,89,51,101,95,152,591,998,3,3399,188,0,0
3,63,2,2,2,0,0,0,2,0,0,0,0,0,0,0,0,0,0,0,0,0
3,63,8,5,5,0,0,3,8,0,0,0,0,0,0,0,0,0,0,0,0,0
3,63,14,8,8,0,0,6,14,0,0,0,0,0,0,0,0,0,0,0,0,0
3,63,6,4,4,0,0,2,6,0,0,0,0,0,0,0,0,0,0,0,0,0
3,63,6,4,4,0,0,2,6,1,2,1,2,3,3,2,4,0,2,0,0,0
3,63,7,5,5,0,0,2,7,0,0,0,0,0,0,0,0,0,0,0,0,0
3,63,10,6,6,0,0,4,10,0,0,0,0,0,0,0,0,0,0,0,0,0
3,63,1,1,1,0,0,0,1,0,0,0,0,0,0,0,0,0,0,0,0,0
3,63,14,10,10,0,0,4,14,1,1,1,1,2,2,0,2,0,1,0,0,0
3,63,46,26,30,3,0,12,49,3,6,3,6,9,9,20,28,1,42,2,0,0
140,6263,139,89,101,2,0,35,141,7,54,34,62,61,96,330,569,4,2287,127,0,0
140,6263,7,5,5,0,0,2,7,1,2,1,2,3,3,2,4,0,2,0,0,0
565,12028,72,33,56,0,4,12,72,1,1,1,1,2,2,0,2,0,1,0,0,0
565,12028,1454,835,1044,76,110,219,1530,17,275,158,296,292,454,2297,3718,9,34017,1889,1,0
71,3617,1943,715,1694,26,18,214,1969,12,185,120,237,197,357,1436,2721,7,20915,1161,0,0
174,4049,77,34,69,0,0,8,77,3,24,16,29,27,45,114,213,1,387,21,0,1
174,4049,712,438,573,51,9,84,763,14,102,71,128,116,199,733,1364,8,11988,666,0,1
174,4049,77,34,69,0,0,8,77,3,24,16,29,27,45,114,213,1,387,21,0,0
174,4049,712,438,573,51,9,84,763,14,102,71,128,116,199,733,1364,8,11988,666,0,0
566,12057,72,33,56,0,4,12,72,1,1,1,1,2,2,0,2,0,1,0,0,1
566,12057,1454,835,1044,76,110,219,1530,17,275,158,296,292,454,2297,3718,9,34017,1889,1,1
17,373,256,139,192,9,7,47,265,4,23,12,24,27,36,112,171,2,357,19,0,1
17,375,256,139,192,9,7,47,265,4,23,12,24,27,36,112,171,2,357,19,0,0
117,2369,1513,682,1277,25,13,200,1538,11,199,116,219,210,335,1557,2584,6,15641,868,0,1
117,2369,819,519,539,24,98,155,843,15,96,57,106,111,163,690,1107,8,9171,509,0,1
113,4391,1513,682,1277,25,13,200,1538,11,199,116,219,210,335,1557,2584,6,15641,868,0,1
77,3168,1289,550,1043,56,32,155,1345,10,167,93,185,177,278,1266,2075,5,11498,638,0,0
566,12055,72,33,56,0,4,12,72,1,1,1,1,2,2,0,2,0,1,0,0,1
566,12055,1454,835,1044,76,110,219,1530,17,275,158,296,292,454,2297,3718,9,34017,1889,1,1
16,362,256,139,192,9,7,47,265,4,23,12,24,27,36,112,171,2,357,19,0,1
117,2369,1513,682,1277,25,13,200,1538,11,199,116,219,210,335,1557,2584,6,15641,868,0,0
117,2369,819,519,539,24,98,155,843,15,96,57,106,111,163,690,1107,8,9171,509,0,0
113,4391,1513,682,1277,25,13,200,1538,11,199,116,219,210,335,1557,2584,6,15641,868,0,0
566,12055,72,33,56,0,4,12,72,1,1,1,1,2,2,0,2,0,1,0,0,0
566,12055,1454,835,1044,76,110,219,1530,17,275,158,296,292,454,2297,3718,9,34017,1889,1,0
16,362,256,139,192,9,7,47,265,4,23,12,24,27,36,112,171,2,357,19,0,0
54,2999,1296,573,1062,40,33,157,1336,8,201,118,231,209,349,1561,2689,4,12365,686,0,0
37,793,2,2,2,0,0,0,2,0,0,0,0,0,0,0,0,0,0,0,0,1
37,793,99,48,90,1,3,5,100,0,0,0,0,0,0,0,0,0,0,0,0,1
37,793,8,5,5,2,0,1,10,0,0,0,0,0,0,0,0,0,0,0,0,1
37,793,1217,716,841,84,126,174,1301,14,185,118,215,199,333,1446,2542,8,20687,1149,0,1
37,793,160,89,115,0,13,31,160,7,15,11,17,22,28,78,124,3,495,27,0,1
37,793,10,10,9,9,0,0,19,0,0,0,0,0,0,0,0,0,0,0,0,1
37,793,173,84,99,8,29,36,181,5,12,7,13,17,20,54,81,2,221,12,0,1
37,793,3,1,1,3,0,0,6,0,0,0,0,0,0,0,0,0,0,0,0,1
151,4796,1660,832,1314,41,38,274,1701,20,312,209,395,332,604,2671,5058,12,64042,3557,1,1
151,4796,1057,646,719,113,100,145,1170,18,215,134,248,233,382,1740,3004,10,31186,1732,1,1
141,3690,1660,832,1314,41,38,274,1701,20,312,209,395,332,604,2671,5058,12,64042,3557,1,1
59,2950,1457,730,1242,11,6,188,1468,10,292,166,329,302,495,2424,4078,5,22973,1276,1,1
220,4876,722,423,573,19,0,135,741,12,172,101,199,184,300,1320,2257,6,15668,870,0,1
220,4876,1508,847,911,44,250,301,1552,14,148,88,169,162,257,1120,1886,7,15077,837,0,1
37,788,2,2,2,0,0,0,2,0,0,0,0,0,0,0,0,0,0,0,0,1
37,788,99,48,90,1,3,5,100,0,0,0,0,0,0,0,0,0,0,0,0,1
37,788,8,5,5,2,0,1,10,0,0,0,0,0,0,0,0,0,0,0,0,1
37,788,1217,716,841,84,126,174,1301,14,185,118,215,199,333,1446,2542,8,20687,1149,0,1
37,788,160,89,115,0,13,31,160,7,15,11,17,22,28,78,124,3,495,27,0,1
37,788,10,10,9,9,0,0,19,0,0,0,0,0,0,0,0,0,0,0,0,1
37,788,173,84,99,8,29,36,181,5,12,7,13,17,20,54,81,2,221,12,0,1
37,788,3,1,1,3,0,0,6,0,0,0,0,0,0,0,0,0,0,0,0,1
150,4790,1660,832,1314,41,38,274,1701,20,312,209,395,332,604,2671,5058,12,64042,3557,1,1
150,4790,1057,646,719,113,100,145,1170,18,215,134,248,233,382,1740,3004,10,31186,1732,1,1
516,11121,72,33,56,0,4,12,72,1,1,1,1,2,2,0,2,0,1,0,0,1
516,11121,1454,835,1044,76,110,219,1530,17,275,158,296,292,454,2297,3718,9,34017,1889,1,1
145,6464,139,89,101,2,0,35,141,7,54,34,62,61,96,330,569,4,2287,127,0,1
145,6464,7,5,5,0,0,2,7,1,2,1,2,3,3,2,4,0,2,0,0,1
37,784,2,2,2,0,0,0,2,0,0,0,0,0,0,0,0,0,0,0,0,0
37,784,99,48,90,1,3,5,100,0,0,0,0,0,0,0,0,0,0,0,0,0
37,784,8,5,5,2,0,1,10,0,0,0,0,0,0,0,0,0,0,0,0,0
37,784,1217,716,841,84,126,174,1301,14,185,118,215,199,333,1446,2542,8,20687,1149,0,0
37,784,160,89,115,0,13,31,160,7,15,11,17,22,28,78,124,3,495,27,0,0
37,784,10,10,9,9,0,0,19,0,0,0,0,0,0,0,0,0,0,0,0,0
37,784,173,84,99,8,29,36,181,5,12,7,13,17,20,54,81,2,221,12,0,0
37,784,3,1,1,3,0,0,6,0,0,0,0,0,0,0,0,0,0,0,0,0
150,4791,1660,832,1314,41,38,274,1701,20,312,209,395,332,604,2671,5058,12,64042,3557,1,0
150,4791,1057,646,719,113,100,145,1170,18,215,134,248,233,382,1740,3004,10,31186,1732,1,0
71,2946,1289,550,1043,56,32,155,1345,10,167,93,185,177,278,1266,2075,5,11498,638,0,1
58,3261,1296,573,1062,40,33,157,1336,8,201,118,231,209,349,1561,2689,4,12365,686,0,1
54,2412,1455,414,1257,16,76,112,1471,5,41,23,46,46,69,231,381,2,1069,59,0,1
514,11012,72,33,56,0,4,12,72,1,1,1,1,2,2,0,2,0,1,0,0,1
514,11012,1454,835,1044,76,110,219,1530,17,275,158,296,292,454,2297,3718,9,34017,1889,1,1
24,810,74,35,59,1,0,14,75,3,14,7,14,17,21,58,85,1,128,7,0,1
24,810,245,125,200,5,7,34,250,7,30,17,34,37,51,166,265,3,1053,58,0,1
220,4876,722,423,573,19,0,135,741,12,172,101,199,184,300,1320,2257,6,15668,870,0,0
220,4876,1508,847,911,44,250,301,1552,14,148,88,169,162,257,1120,1886,7,15077,837,0,0
71,2946,1289,550,1043,56,32,155,1345,10,167,93,185,177,278,1266,2075,5,11498,638,0,0
58,3261,1296,573,1062,40,33,157,1336,8,201,118,231,209,349,1561,2689,4,12365,686,0,0
54,2412,1455,414,1257,16,76,112,1471,5,41,23,46,46,69,231,381,2,1069,59,0,0
141,3690,1660,832,1314,41,38,274,1701,20,312,209,395,332,604,2671,5058,12,64042,3557,1,0
59,2950,1457,730,1242,11,6,188,1468,10,292,166,329,302,495,2424,4078,5,22973,1276,1,0
514,11012,72,33,56,0,4,12,72,1,1,1,1,2,2,0,2,0,1,0,0,0
514,11012,1454,835,1044,76,110,219,1530,17,275,158,296,292,454,2297,3718,9,34017,1889,1,0
3,23,14,7,7,2,0,5,16,0,0,0,0,0,0,0,0,0,0,0,0,0
516,11123,72,33,56,0,4,12,72,1,1,1,1,2,2,0,2,0,1,0,0,0
516,11123,1454,835,1044,76,110,219,1530,17,275,158,296,292,454,2297,3718,9,34017,1889,1,0
145,6464,139,89,101,2,0,35,141,7,54,34,62,61,96,330,569,4,2287,127,0,0
145,6464,7,5,5,0,0,2,7,1,2,1,2,3,3,2,4,0,2,0,0,0
173,4021,77,34,69,0,0,8,77,3,24,16,29,27,45,114,213,1,387,21,0,1
173,4021,712,438,573,51,9,84,763,14,102,71,128,116,199,733,1364,8,11988,666,0,1
569,12221,72,33,56,0,4,12,72,1,1,1,1,2,2,0,2,0,1,0,0,1
569,12221,1454,835,1044,76,110,219,1530,17,275,158,296,292,454,2297,3718,9,34017,1889,1,1
120,2635,1043,504,840,53,9,147,1096,9,180,112,198,189,310,1377,2344,4,11604,644,0,1
120,2635,383,288,292,26,6,62,409,11,65,38,67,76,105,429,656,5,3719,206,0,1
90,1955,477,336,357,30,23,73,507,16,194,134,250,210,384,1538,2962,10,30538,1696,0,1
76,2747,1450,624,1228,12,26,181,1462,14,306,186,354,320,540,2580,4493,8,36391,2021,1,1
121,2646,1043,504,840,53,9,147,1096,9,180,112,198,189,310,1377,2344,4,11604,644,0,1
121,2646,383,288,292,26,6,62,409,11,65,38,67,76,105,429,656,5,3719,206,0,1
146,6501,139,89,101,2,0,35,141,7,54,34,62,61,96,330,569,4,2287,127,0,1
146,6501,7,5,5,0,0,2,7,1,2,1,2,3,3,2,4,0,2,0,0,1
573,12239,72,33,56,0,4,12,72,1,1,1,1,2,2,0,2,0,1,0,0,1
573,12239,1454,835,1044,76,110,219,1530,17,275,158,296,292,454,2297,3718,9,34017,1889,1,1
121,2646,1043,504,840,53,9,147,1096,9,180,112,198,189,310,1377,2344,4,11604,644,0,0
121,2646,383,288,292,26,6,62,409,11,65,38,67,76,105,429,656,5,3719,206,0,0
575,12268,72,33,56,0,4,12,72,1,1,1,1,2,2,0,2,0,1,0,0,0
575,12268,1454,835,1044,76,110,219,1530,17,275,158,296,292,454,2297,3718,9,34017,1889,1,0
3,147,601,196,481,2,23,85,603,8,63,36,72,71,108,400,664,4,3036,168,0,1
579,12308,72,33,56,0,4,12,72,1,1,1,1,2,2,0,2,0,1,0,0,0
579,12308,1454,835,1044,76,110,219,1530,17,275,158,296,292,454,2297,3718,9,34017,1889,1,0
121,2645,1043,504,840,53,9,147,1096,9,180,112,198,189,310,1377,2344,4,11604,644,0,0
121,2645,383,288,292,26,6,62,409,11,65,38,67,76,105,429,656,5,3719,206,0,0
90,1955,477,336,357,30,23,73,507,16,194,134,250,210,384,1538,2962,10,30538,1696,0,0
76,2747,1450,624,1228,12,26,181,1462,14,306,186,354,320,540,2580,4493,8,36391,2021,1,0
2,67,7,6,5,0,0,2,7,1,1,1,2,2,3,0,3,1,3,0,0,0
216,4657,182,127,129,0,0,53,182,5,39,21,42,44,63,217,343,2,926,51,0,1
216,4657,1165,710,800,67,119,181,1232,18,243,153,282,261,435,2000,3492,10,36473,2026,1,1
55,1468,1455,414,1257,16,76,112,1471,5,41,23,46,46,69,231,381,2,1069,59,0,1
55,1468,669,365,481,22,61,110,691,15,103,63,122,118,185,747,1273,8,11311,628,0,1
568,12168,72,33,56,0,4,12,72,1,1,1,1,2,2,0,2,0,1,0,0,1
568,12168,1454,835,1044,76,110,219,1530,17,275,158,296,292,454,2297,3718,9,34017,1889,1,1
77,3179,1289,550,1043,56,32,155,1345,10,167,93,185,177,278,1266,2075,5,11498,638,0,1
139,6353,1392,870,1177,35,17,170,1427,14,494,280,531,508,811,4473,7289,7,54850,3047,2,1
144,6503,139,89,101,2,0,35,141,7,54,34,62,61,96,330,569,4,2287,127,0,1
144,6503,7,5,5,0,0,2,7,1,2,1,2,3,3,2,4,0,2,0,0,1
59,3272,1296,573,1062,40,33,157,1336,8,201,118,231,209,349,1561,2689,4,12365,686,0,1
55,2458,1455,414,1257,16,76,112,1471,5,41,23,46,46,69,231,381,2,1069,59,0,1
71,3617,1943,715,1694,26,18,214,1969,12,185,120,237,197,357,1436,2721,7,20915,1161,0,1
146,6501,139,89,101,2,0,35,141,7,54,34,62,61,96,330,569,4,2287,127,0,0
146,6501,7,5,5,0,0,2,7,1,2,1,2,3,3,2,4,0,2,0,0,0
145,6540,139,89,101,2,0,35,141,7,54,34,62,61,96,330,569,4,2287,127,0,0
145,6540,7,5,5,0,0,2,7,1,2,1,2,3,3,2,4,0,2,0,0,0
173,4038,77,34,69,0,0,8,77,3,24,16,29,27,45,114,213,1,387,21,0,1
173,4038,712,438,573,51,9,84,763,14,102,71,128,116,199,733,1364,8,11988,666,0,1
582,12336,72,33,56,0,4,12,72,1,1,1,1,2,2,0,2,0,1,0,0,1
582,12336,1454,835,1044,76,110,219,1530,17,275,158,296,292,454,2297,3718,9,34017,1889,1,1
122,2653,1043,504,840,53,9,147,1096,9,180,112,198,189,310,1377,2344,4,11604,644,0,1
122,2653,383,288,292,26,6,62,409,11,65,38,67,76,105,429,656,5,3719,206,0,1
216,4657,182,127,129,0,0,53,182,5,39,21,42,44,63,217,343,2,926,51,0,0
216,4657,1165,710,800,67,119,181,1232,18,243,153,282,261,435,2000,3492,10,36473,2026,1,0
55,1468,1455,414,1257,16,76,112,1471,5,41,23,46,46,69,231,381,2,1069,59,0,0
55,1468,669,365,481,22,61,110,691,15,103,63,122,118,185,747,1273,8,11311,628,0,0
568,12168,72,33,56,0,4,12,72,1,1,1,1,2,2,0,2,0,1,0,0,0
568,12168,1454,835,1044,76,110,219,1530,17,275,158,296,292,454,2297,3718,9,34017,1889,1,0
77,3179,1289,550,1043,56,32,155,1345,10,167,93,185,177,278,1266,2075,5,11498,638,0,0
139,6353,1392,870,1177,35,17,170,1427,14,494,280,531,508,811,4473,7289,7,54850,3047,2,0
59,3272,1296,573,1062,40,33,157,1336,8,201,118,231,209,349,1561,2689,4,12365,686,0,0
55,2458,1455,414,1257,16,76,112,1471,5,41,23,46,46,69,231,381,2,1069,59,0,0
175,4087,77,34,69,0,0,8,77,3,24,16,29,27,45,114,213,1,387,21,0,0
175,4087,712,438,573,51,9,84,763,14,102,71,128,116,199,733,1364,8,11988,666,0,0
584,12449,72,33,56,0,4,12,72,1,1,1,1,2,2,0,2,0,1,0,0,0
584,12449,1454,835,1044,76,110,219,1530,17,275,158,296,292,454,2297,3718,9,34017,1889,1,0
307,6253,1457,730,1242,11,6,188,1468,10,292,166,329,302,495,2424,4078,5,22973,1276,1,0
307,6253,74,35,59,1,0,14,75,3,14,7,14,17,21,58,85,1,128,7,0,0
307,6253,245,125,200,5,7,34,250,7,30,17,34,37,51,166,265,3,1053,58,0,0
39,2266,334,251,279,10,4,40,344,5,127,74,143,132,217,899,1528,2,4303,239,0,0
584,12469,72,33,56,0,4,12,72,1,1,1,1,2,2,0,2,0,1,0,0,0
584,12469,1454,835,1044,76,110,219,1530,17,275,158,296,292,454,2297,3718,9,34017,1889,1,0
122,2648,1043,504,840,53,9,147,1096,9,180,112,198,189,310,1377,2344,4,11604,644,0,0
122,2648,383,288,292,26,6,62,409,11,65,38,67,76,105,429,656,5,3719,206,0,0
585,12481,72,33,56,0,4,12,72,1,1,1,1,2,2,0,2,0,1,0,0,0
585,12481,1454,835,1044,76,110,219,1530,17,275,158,296,292,454,2297,3718,9,34017,1889,1,0
53,1425,1455,414,1257,16,76,112,1471,5,41,23,46,46,69,231,381,2,1069,59,0,1
53,1425,669,365,481,22,61,110,691,15,103,63,122,118,185,747,1273,8,11311,628,0,1
517,11149,72,33,56,0,4,12,72,1,1,1,1,2,2,0,2,0,1,0,0,1
517,11149,1454,835,1044,76,110,219,1530,17,275,158,296,292,454,2297,3718,9,34017,1889,1,1
147,6532,139,89,101,2,0,35,141,7,54,34,62,61,96,330,569,4,2287,127,0,1
147,6532,7,5,5,0,0,2,7,1,2,1,2,3,3,2,4,0,2,0,0,1
517,11149,72,33,56,0,4,12,72,1,1,1,1,2,2,0,2,0,1,0,0,0
517,11149,1454,835,1044,76,110,219,1530,17,275,158,296,292,454,2297,3718,9,34017,1889,1,0
147,6532,139,89,101,2,0,35,141,7,54,34,62,61,96,330,569,4,2287,127,0,0
147,6532,7,5,5,0,0,2,7,1,2,1,2,3,3,2,4,0,2,0,0,0
82,1803,477,336,357,30,23,73,507,16,194,134,250,210,384,1538,2962,10,30538,1696,0,1
135,3546,1660,832,1314,41,38,274,1701,20,312,209,395,332,604,2671,5058,12,64042,3557,1,1
82,1803,477,336,357,30,23,73,507,16,194,134,250,210,384,1538,2962,10,30538,1696,0,0
135,3546,1660,832,1314,41,38,274,1701,20,312,209,395,332,604,2671,5058,12,64042,3557,1,0
569,12184,72,33,56,0,4,12,72,1,1,1,1,2,2,0,2,0,1,0,0,1
569,12184,1454,835,1044,76,110,219,1530,17,275,158,296,292,454,2297,3718,9,34017,1889,1,1
76,3740,1523,757,1297,19,12,193,1542,12,193,117,230,205,347,1508,2664,7,19053,1058,0,1
16,1198,215,129,180,6,0,29,221,8,65,43,72,73,115,415,711,4,3153,175,0,1
62,2603,1043,504,840,53,9,147,1096,9,180,112,198,189,310,1377,2344,4,11604,644,0,1
22,942,373,158,315,8,0,51,381,5,76,44,79,81,123,486,779,2,2026,112,0,1
67,2869,1178,367,1042,6,15,115,1184,9,94,51,95,103,146,644,976,4,4439,246,0,1
71,3615,1943,715,1694,26,18,214,1969,12,185,120,237,197,357,1436,2721,7,20915,1161,0,1
303,6208,1457,730,1242,11,6,188,1468,10,292,166,329,302,495,2424,4078,5,22973,1276,1,0
303,6208,74,35,59,1,0,14,75,3,14,7,14,17,21,58,85,1,128,7,0,0
303,6208,245,125,200,5,7,34,250,7,30,17,34,37,51,166,265,3,1053,58,0,0
38,2210,334,251,279,10,4,40,344,5,127,74,143,132,217,899,1528,2,4303,239,0,0
303,6198,1457,730,1242,11,6,188,1468,10,292,166,329,302,495,2424,4078,5,22973,1276,1,1
303,6198,74,35,59,1,0,14,75,3,14,7,14,17,21,58,85,1,128,7,0,1
303,6198,245,125,200,5,7,34,250,7,30,17,34,37,51,166,265,3,1053,58,0,1
61,3038,1457,730,1242,11,6,188,1468,10,292,166,329,302,495,2424,4078,5,22973,1276,1,1
49,571,647,139,84,35,284,233,682,0,0,0,0,0,0,0,0,0,0,0,0,1
570,12235,72,33,56,0,4,12,72,1,1,1,1,2,2,0,2,0,1,0,0,1
570,12235,1454,835,1044,76,110,219,1530,17,275,158,296,292,454,2297,3718,9,34017,1889,1,1
17,325,294,64,250,0,0,43,294,1,20,10,20,21,30,86,131,0,65,3,0,1
17,325,78,46,62,3,0,14,81,3,8,4,8,11,12,28,41,1,62,3,0,1
4,72,110,30,77,3,13,16,113,4,21,15,30,25,45,100,208,2,597,33,0,1
4,72,28,15,21,1,0,6,29,0,0,0,0,0,0,0,0,0,0,0,0,1
18,355,294,64,250,0,0,43,294,1,20,10,20,21,30,86,131,0,65,3,0,0
18,355,78,46,62,3,0,14,81,3,8,4,8,11,12,28,41,1,62,3,0,0
5,103,110,30,77,3,13,16,113,4,21,15,30,25,45,100,208,2,597,33,0,0
5,103,28,15,21,1,0,6,29,0,0,0,0,0,0,0,0,0,0,0,0,0
15,485,42,7,35,4,0,5,46,1,2,1,2,3,3,2,4,0,2,0,0,1
15,485,11,6,10,0,0,1,11,2,4,2,4,6,6,10,15,1,15,0,0,1
303,6198,1457,730,1242,11,6,188,1468,10,292,166,329,302,495,2424,4078,5,22973,1276,1,0
303,6198,74,35,59,1,0,14,75,3,14,7,14,17,21,58,85,1,128,7,0,0
303,6198,245,125,200,5,7,34,250,7,30,17,34,37,51,166,265,3,1053,58,0,0
61,3038,1457,730,1242,11,6,188,1468,10,292,166,329,302,495,2424,4078,5,22973,1276,1,0
302,6188,1457,730,1242,11,6,188,1468,10,292,166,329,302,495,2424,4078,5,22973,1276,1,0
302,6188,74,35,59,1,0,14,75,3,14,7,14,17,21,58,85,1,128,7,0,0
302,6188,245,125,200,5,7,34,250,7,30,17,34,37,51,166,265,3,1053,58,0,0
569,12184,72,33,56,0,4,12,72,1,1,1,1,2,2,0,2,0,1,0,0,0
569,12184,1454,835,1044,76,110,219,1530,17,275,158,296,292,454,2297,3718,9,34017,1889,1,0
76,3740,1523,757,1297,19,12,193,1542,12,193,117,230,205,347,1508,2664,7,19053,1058,0,0
16,1198,215,129,180,6,0,29,221,8,65,43,72,73,115,415,711,4,3153,175,0,0
62,2603,1043,504,840,53,9,147,1096,9,180,112,198,189,310,1377,2344,4,11604,644,0,0
22,942,373,158,315,8,0,51,381,5,76,44,79,81,123,486,779,2,2026,112,0,0
67,2869,1178,367,1042,6,15,115,1184,9,94,51,95,103,146,644,976,4,4439,246,0,0
71,3615,1943,715,1694,26,18,214,1969,12,185,120,237,197,357,1436,2721,7,20915,1161,0,0
66,2745,1020,354,843,12,15,144,1032,8,134,77,144,142,221,970,1580,4,6792,377,0,1
49,571,647,139,84,35,284,233,682,0,0,0,0,0,0,0,0,0,0,0,0,0
571,12251,72,33,56,0,4,12,72,1,1,1,1,2,2,0,2,0,1,0,0,0
571,12251,1454,835,1044,76,110,219,1530,17,275,158,296,292,454,2297,3718,9,34017,1889,1,0
313,6325,1457,730,1242,11,6,188,1468,10,292,166,329,302,495,2424,4078,5,22973,1276,1,1
313,6325,74,35,59,1,0,14,75,3,14,7,14,17,21,58,85,1,128,7,0,1
313,6325,245,125,200,5,7,34,250,7,30,17,34,37,51,166,265,3,1053,58,0,1
24,834,74,35,59,1,0,14,75,3,14,7,14,17,21,58,85,1,128,7,0,1
24,834,245,125,200,5,7,34,250,7,30,17,34,37,51,166,265,3,1053,58,0,1
62,3185,1457,730,1242,11,6,188,1468,10,292,166,329,302,495,2424,4078,5,22973,1276,1,1
313,6325,1457,730,1242,11,6,188,1468,10,292,166,329,302,495,2424,4078,5,22973,1276,1,0
313,6325,74,35,59,1,0,14,75,3,14,7,14,17,21,58,85,1,128,7,0,0
313,6325,245,125,200,5,7,34,250,7,30,17,34,37,51,166,265,3,1053,58,0,0
24,834,74,35,59,1,0,14,75,3,14,7,14,17,21,58,85,1,128,7,0,0
24,834,245,125,200,5,7,34,250,7,30,17,34,37,51,166,265,3,1053,58,0,0
62,3185,1457,730,1242,11,6,188,1468,10,292,166,329,302,495,2424,4078,5,22973,1276,1,0
149,4786,1660,832,1314,41,38,274,1701,20,312,209,395,332,604,2671,5058,12,64042,3557,1,1
149,4786,1057,646,719,113,100,145,1170,18,215,134,248,233,382,1740,3004,10,31186,1732,1,1
138,3638,1660,832,1314,41,38,274,1701,20,312,209,395,332,604,2671,5058,12,64042,3557,1,1
185,3788,1943,715,1694,26,18,214,1969,12,185,120,237,197,357,1436,2721,7,20915,1161,0,1
185,3788,1168,838,957,57,25,144,1225,19,348,224,416,367,640,3018,5452,11,61921,3440,1,1
58,2959,1457,730,1242,11,6,188,1468,10,292,166,329,302,495,2424,4078,5,22973,1276,1,1
71,3662,1943,715,1694,26,18,214,1969,12,185,120,237,197,357,1436,2721,7,20915,1161,0,1
153,4888,1660,832,1314,41,38,274,1701,20,312,209,395,332,604,2671,5058,12,64042,3557,1,1
153,4888,1057,646,719,113,100,145,1170,18,215,134,248,233,382,1740,3004,10,31186,1732,1,1
77,2775,1450,624,1228,12,26,181,1462,14,306,186,354,320,540,2580,4493,8,36391,2021,1,1
78,2812,1450,624,1228,12,26,181,1462,14,306,186,354,320,540,2580,4493,8,36391,2021,1,0
35,724,2,2,2,0,0,0,2,0,0,0,0,0,0,0,0,0,0,0,0,1
35,724,99,48,90,1,3,5,100,0,0,0,0,0,0,0,0,0,0,0,0,1
35,724,8,5,5,2,0,1,10,0,0,0,0,0,0,0,0,0,0,0,0,1
35,724,1217,716,841,84,126,174,1301,14,185,118,215,199,333,1446,2542,8,20687,1149,0,1
35,724,160,89,115,0,13,31,160,7,15,11,17,22,28,78,124,3,495,27,0,1
35,724,10,10,9,9,0,0,19,0,0,0,0,0,0,0,0,0,0,0,0,1
35,724,173,84,99,8,29,36,181,5,12,7,13,17,20,54,81,2,221,12,0,1
35,724,3,1,1,3,0,0,6,0,0,0,0,0,0,0,0,0,0,0,0,1
176,3641,1943,715,1694,26,18,214,1969,12,185,120,237,197,357,1436,2721,7,20915,1161,0,1
176,3641,1168,838,957,57,25,144,1225,19,348,224,416,367,640,3018,5452,11,61921,3440,1,1
75,2695,1450,624,1228,12,26,181,1462,14,306,186,354,320,540,2580,4493,8,36391,2021,1,1
62,3181,1457,730,1242,11,6,188,1468,10,292,166,329,302,495,2424,4078,5,22973,1276,1,1
71,3566,1943,715,1694,26,18,214,1969,12,185,120,237,197,357,1436,2721,7,20915,1161,0,1
313,6326,1457,730,1242,11,6,188,1468,10,292,166,329,302,495,2424,4078,5,22973,1276,1,1
313,6326,74,35,59,1,0,14,75,3,14,7,14,17,21,58,85,1,128,7,0,1
313,6326,245,125,200,5,7,34,250,7,30,17,34,37,51,166,265,3,1053,58,0,1
7,139,44,22,19,0,19,6,44,2,10,6,12,12,18,35,64,1,77,4,0,1
15,485,42,7,35,4,0,5,46,1,2,1,2,3,3,2,4,0,2,0,0,0
15,485,11,6,10,0,0,1,11,2,4,2,4,6,6,10,15,1,15,0,0,0
35,724,2,2,2,0,0,0,2,0,0,0,0,0,0,0,0,0,0,0,0,0
35,724,99,48,90,1,3,5,100,0,0,0,0,0,0,0,0,0,0,0,0,0
35,724,8,5,5,2,0,1,10,0,0,0,0,0,0,0,0,0,0,0,0,0
35,724,1217,716,841,84,126,174,1301,14,185,118,215,199,333,1446,2542,8,20687,1149,0,0
35,724,160,89,115,0,13,31,160,7,15,11,17,22,28,78,124,3,495,27,0,0
35,724,10,10,9,9,0,0,19,0,0,0,0,0,0,0,0,0,0,0,0,0
35,724,173,84,99,8,29,36,181,5,12,7,13,17,20,54,81,2,221,12,0,0
35,724,3,1,1,3,0,0,6,0,0,0,0,0,0,0,0,0,0,0,0,0
313,6326,1457,730,1242,11,6,188,1468,10,292,166,329,302,495,2424,4078,5,22973,1276,1,0
313,6326,74,35,59,1,0,14,75,3,14,7,14,17,21,58,85,1,128,7,0,0
313,6326,245,125,200,5,7,34,250,7,30,17,34,37,51,166,265,3,1053,58,0,0
7,139,44,22,19,0,19,6,44,2,10,6,12,12,18,35,64,1,77,4,0,0
176,3641,1943,715,1694,26,18,214,1969,12,185,120,237,197,357,1436,2721,7,20915,1161,0,0
176,3641,1168,838,957,57,25,144,1225,19,348,224,416,367,640,3018,5452,11,61921,3440,1,0
75,2695,1450,624,1228,12,26,181,1462,14,306,186,354,320,540,2580,4493,8,36391,2021,1,0
62,3181,1457,730,1242,11,6,188,1468,10,292,166,329,302,495,2424,4078,5,22973,1276,1,0
71,3566,1943,715,1694,26,18,214,1969,12,185,120,237,197,357,1436,2721,7,20915,1161,0,0
153,4888,1660,832,1314,41,38,274,1701,20,312,209,395,332,604,2671,5058,12,64042,3557,1,0
153,4888,1057,646,719,113,100,145,1170,18,215,134,248,233,382,1740,3004,10,31186,1732,1,0
77,2760,1450,624,1228,12,26,181,1462,14,306,186,354,320,540,2580,4493,8,36391,2021,1,0
149,4786,1660,832,1314,41,38,274,1701,20,312,209,395,332,604,2671,5058,12,64042,3557,1,0
149,4786,1057,646,719,113,100,145,1170,18,215,134,248,233,382,1740,3004,10,31186,1732,1,0
138,3638,1660,832,1314,41,38,274,1701,20,312,209,395,332,604,2671,5058,12,64042,3557,1,0
66,2745,1020,354,843,12,15,144,1032,8,134,77,144,142,221,970,1580,4,6792,377,0,0
14,470,42,7,35,4,0,5,46,1,2,1,2,3,3,2,4,0,2,0,0,1
14,470,11,6,10,0,0,1,11,2,4,2,4,6,6,10,15,1,15,0,0,1
92,2960,773,419,590,28,0,166,801,10,204,113,217,214,330,1598,2554,5,13587,754,0,1
14,470,42,7,35,4,0,5,46,1,2,1,2,3,3,2,4,0,2,0,0,0
14,470,11,6,10,0,0,1,11,2,4,2,4,6,6,10,15,1,15,0,0,0
92,2960,773,419,590,28,0,166,801,10,204,113,217,214,330,1598,2554,5,13587,754,0,0
122,2648,1043,504,840,53,9,147,1096,9,180,112,198,189,310,1377,2344,4,11604,644,0,1
122,2648,383,288,292,26,6,62,409,11,65,38,67,76,105,429,656,5,3719,206,0,1
20,400,294,64,250,0,0,43,294,1,20,10,20,21,30,86,131,0,65,3,0,1
20,400,78,46,62,3,0,14,81,3,8,4,8,11,12,28,41,1,62,3,0,1
5,110,110,30,77,3,13,16,113,4,21,15,30,25,45,100,208,2,597,33,0,1
5,110,28,15,21,1,0,6,29,0,0,0,0,0,0,0,0,0,0,0,0,1
314,6367,1457,730,1242,11,6,188,1468,10,292,166,329,302,495,2424,4078,5,22973,1276,1,0
314,6367,74,35,59,1,0,14,75,3,14,7,14,17,21,58,85,1,128,7,0,0
314,6367,245,125,200,5,7,34,250,7,30,17,34,37,51,166,265,3,1053,58,0,0
37,2203,652,304,544,16,6,88,668,6,89,51,101,95,152,591,998,3,3399,188,0,0
20,400,294,64,250,0,0,43,294,1,20,10,20,21,30,86,131,0,65,3,0,0
20,400,78,46,62,3,0,14,81,3,8,4,8,11,12,28,41,1,62,3,0,0
5,110,110,30,77,3,13,16,113,4,21,15,30,25,45,100,208,2,597,33,0,0
5,110,28,15,21,1,0,6,29,0,0,0,0,0,0,0,0,0,0,0,0,0
155,4940,1660,832,1314,41,38,274,1701,20,312,209,395,332,604,2671,5058,12,64042,3557,1,1
155,4940,1057,646,719,113,100,145,1170,18,215,134,248,233,382,1740,3004,10,31186,1732,1,1
311,6296,1457,730,1242,11,6,188,1468,10,292,166,329,302,495,2424,4078,5,22973,1276,1,1
311,6296,74,35,59,1,0,14,75,3,14,7,14,17,21,58,85,1,128,7,0,1
311,6296,245,125,200,5,7,34,250,7,30,17,34,37,51,166,265,3,1053,58,0,1
572,12277,72,33,56,0,4,12,72,1,1,1,1,2,2,0,2,0,1,0,0,1
572,12277,1454,835,1044,76,110,219,1530,17,275,158,296,292,454,2297,3718,9,34017,1889,1,1
146,6571,139,89,101,2,0,35,141,7,54,34,62,61,96,330,569,4,2287,127,0,1
146,6571,7,5,5,0,0,2,7,1,2,1,2,3,3,2,4,0,2,0,0,1
90,4801,1782,648,1425,9,47,279,1791,8,171,97,189,179,286,1292,2140,4,9462,525,0,1
143,3771,1660,832,1314,41,38,274,1701,20,312,209,395,332,604,2671,5058,12,64042,3557,1,1
65,3259,1457,730,1242,11,6,188,1468,10,292,166,329,302,495,2424,4078,5,22973,1276,1,1
39,2275,334,251,279,10,4,40,344,5,127,74,143,132,217,899,1528,2,4303,239,0,1
155,4940,1660,832,1314,41,38,274,1701,20,312,209,395,332,604,2671,5058,12,64042,3557,1,0
155,4940,1057,646,719,113,100,145,1170,18,215,134,248,233,382,1740,3004,10,31186,1732,1,0
311,6296,1457,730,1242,11,6,188,1468,10,292,166,329,302,495,2424,4078,5,22973,1276,1,0
311,6296,74,35,59,1,0,14,75,3,14,7,14,17,21,58,85,1,128,7,0,0
311,6296,245,125,200,5,7,34,250,7,30,17,34,37,51,166,265,3,1053,58,0,0
572,12277,72,33,56,0,4,12,72,1,1,1,1,2,2,0,2,0,1,0,0,0
572,12277,1454,835,1044,76,110,219,1530,17,275,158,296,292,454,2297,3718,9,34017,1889,1,0
146,6571,139,89,101,2,0,35,141,7,54,34,62,61,96,330,569,4,2287,127,0,0
146,6571,7,5,5,0,0,2,7,1,2,1,2,3,3,2,4,0,2,0,0,0
143,3771,1660,832,1314,41,38,274,1701,20,312,209,395,332,604,2671,5058,12,64042,3557,1,0
65,3259,1457,730,1242,11,6,188,1468,10,292,166,329,302,495,2424,4078,5,22973,1276,1,0
39,2275,334,251,279,10,4,40,344,5,127,74,143,132,217,899,1528,2,4303,239,0,0
40,775,207,111,150,11,0,50,218,5,26,19,36,31,55,133,272,3,943,52,0,1
40,775,410,198,237,31,55,97,441,11,63,38,72,74,110,414,683,6,4293,238,0,1
222,4933,4293,999,3693,19,54,507,4312,9,155,88,170,164,258,1156,1898,4,9368,520,0,1
222,4933,1482,859,1002,125,135,219,1607,16,219,134,251,235,385,1766,3032,9,27804,1544,1,1
309,6680,72,33,56,0,4,12,72,1,1,1,1,2,2,0,2,0,1,0,0,1
309,6680,1454,835,1044,76,110,219,1530,17,275,158,296,292,454,2297,3718,9,34017,1889,1,1
146,6569,139,89,101,2,0,35,141,7,54,34,62,61,96,330,569,4,2287,127,0,1
146,6569,7,5,5,0,0,2,7,1,2,1,2,3,3,2,4,0,2,0,0,1
587,12550,72,33,56,0,4,12,72,1,1,1,1,2,2,0,2,0,1,0,0,1
587,12550,1454,835,1044,76,110,219,1530,17,275,158,296,292,454,2297,3718,9,34017,1889,1,1
23,679,339,213,244,17,9,65,356,10,42,26,48,52,74,259,421,5,2410,133,0,1
40,775,207,111,150,11,0,50,218,5,26,19,36,31,55,133,272,3,943,52,0,0
40,775,410,198,237,31,55,97,441,11,63,38,72,74,110,414,683,6,4293,238,0,0
222,4933,4293,999,3693,19,54,507,4312,9,155,88,170,164,258,1156,1898,4,9368,520,0,0
222,4933,1482,859,1002,125,135,219,1607,16,219,134,251,235,385,1766,3032,9,27804,1544,1,0
309,6680,72,33,56,0,4,12,72,1,1,1,1,2,2,0,2,0,1,0,0,0
309,6680,1454,835,1044,76,110,219,1530,17,275,158,296,292,454,2297,3718,9,34017,1889,1,0
146,6569,139,89,101,2,0,35,141,7,54,34,62,61,96,330,569,4,2287,127,0,0
146,6569,7,5,5,0,0,2,7,1,2,1,2,3,3,2,4,0,2,0,0,0
237,5206,4293,999,3693,19,54,507,4312,9,155,88,170,164,258,1156,1898,4,9368,520,0,1
237,5206,1482,859,1002,125,135,219,1607,16,219,134,251,235,385,1766,3032,9,27804,1544,1,1
237,5209,4293,999,3693,19,54,507,4312,9,155,88,170,164,258,1156,1898,4,9368,520,0,1
237,5209,1482,859,1002,125,135,219,1607,16,219,134,251,235,385,1766,3032,9,27804,1544,1,1
114,4432,1513,682,1277,25,13,200,1538,11,199,116,219,210,335,1557,2584,6,15641,868,0,1
309,6699,72,33,56,0,4,12,72,1,1,1,1,2,2,0,2,0,1,0,0,1
309,6699,1454,835,1044,76,110,219,1530,17,275,158,296,292,454,2297,3718,9,34017,1889,1,1
78,3212,1289,550,1043,56,32,155,1345,10,167,93,185,177,278,1266,2075,5,11498,638,0,1
91,2970,773,419,590,28,0,166,801,10,204,113,217,214,330,1598,2554,5,13587,754,0,1
222,4950,4293,999,3693,19,54,507,4312,9,155,88,170,164,258,1156,1898,4,9368,520,0,1
222,4950,1482,859,1002,125,135,219,1607,16,219,134,251,235,385,1766,3032,9,27804,1544,1,1
79,3247,1289,550,1043,56,32,155,1345,10,167,93,185,177,278,1266,2075,5,11498,638,0,1
222,4964,4293,999,3693,19,54,507,4312,9,155,88,170,164,258,1156,1898,4,9368,520,0,1
222,4964,1482,859,1002,125,135,219,1607,16,219,134,251,235,385,1766,3032,9,27804,1544,1,1
46,949,447,308,343,6,5,95,453,7,96,59,111,103,170,651,1136,4,4600,255,0,1
46,949,322,174,179,16,74,51,338,10,41,26,46,51,72,252,408,5,2291,127,0,1
220,4885,722,423,573,19,0,135,741,12,172,101,199,184,300,1320,2257,6,15668,870,0,1
220,4885,1508,847,911,44,250,301,1552,14,148,88,169,162,257,1120,1886,7,15077,837,0,1
139,6357,1392,870,1177,35,17,170,1427,14,494,280,531,508,811,4473,7289,7,54850,3047,2,1
85,3904,1338,495,1086,10,64,173,1348,11,122,82,157,133,239,883,1686,7,11934,663,0,1
146,6582,139,89,101,2,0,35,141,7,54,34,62,61,96,330,569,4,2287,127,0,1
146,6582,7,5,5,0,0,2,7,1,2,1,2,3,3,2,4,0,2,0,0,1
77,2760,1450,624,1228,12,26,181,1462,14,306,186,354,320,540,2580,4493,8,36391,2021,1,1
38,1616,447,308,343,6,5,95,453,7,96,59,111,103,170,651,1136,4,4600,255,0,1
34,1295,1293,570,1093,25,15,163,1318,10,195,123,241,205,364,1516,2795,6,17273,959,0,1
23,680,339,213,244,17,9,65,356,10,42,26,48,52,74,259,421,5,2410,133,0,1
38,1395,1293,570,1093,25,15,163,1318,10,195,123,241,205,364,1516,2795,6,17273,959,0,1
222,4964,4293,999,3693,19,54,507,4312,9,155,88,170,164,258,1156,1898,4,9368,520,0,0
222,4964,1482,859,1002,125,135,219,1607,16,219,134,251,235,385,1766,3032,9,27804,1544,1,0
46,949,447,308,343,6,5,95,453,7,96,59,111,103,170,651,1136,4,4600,255,0,0
46,949,322,174,179,16,74,51,338,10,41,26,46,51,72,252,408,5,2291,127,0,0
220,4885,722,423,573,19,0,135,741,12,172,101,199,184,300,1320,2257,6,15668,870,0,0
220,4885,1508,847,911,44,250,301,1552,14,148,88,169,162,257,1120,1886,7,15077,837,0,0
309,6699,72,33,56,0,4,12,72,1,1,1,1,2,2,0,2,0,1,0,0,0
309,6699,1454,835,1044,76,110,219,1530,17,275,158,296,292,454,2297,3718,9,34017,1889,1,0
79,3247,1289,550,1043,56,32,155,1345,10,167,93,185,177,278,1266,2075,5,11498,638,0,0
139,6357,1392,870,1177,35,17,170,1427,14,494,280,531,508,811,4473,7289,7,54850,3047,2,0
91,2970,773,419,590,28,0,166,801,10,204,113,217,214,330,1598,2554,5,13587,754,0,0
85,3904,1338,495,1086,10,64,173,1348,11,122,82,157,133,239,883,1686,7,11934,663,0,0
146,6582,139,89,101,2,0,35,141,7,54,34,62,61,96,330,569,4,2287,127,0,0
146,6582,7,5,5,0,0,2,7,1,2,1,2,3,3,2,4,0,2,0,0,0
38,1616,447,308,343,6,5,95,453,7,96,59,111,103,170,651,1136,4,4600,255,0,0
34,1295,1293,570,1093,25,15,163,1318,10,195,123,241,205,364,1516,2795,6,17273,959,0,0
13,413,295,56,236,0,4,54,295,2,9,5,10,11,15,30,51,1,57,3,0,0
23,680,339,213,244,17,9,65,356,10,42,26,48,52,74,259,421,5,2410,133,0,0
38,1401,1293,570,1093,25,15,163,1318,10,195,123,241,205,364,1516,2795,6,17273,959,0,0
32,614,2,2,2,0,0,0,2,0,0,0,0,0,0,0,0,0,0,0,0,1
32,614,99,48,90,1,3,5,100,0,0,0,0,0,0,0,0,0,0,0,0,1
32,614,8,5,5,2,0,1,10,0,0,0,0,0,0,0,0,0,0,0,0,1
32,614,1217,716,841,84,126,174,1301,14,185,118,215,199,333,1446,2542,8,20687,1149,0,1
32,614,160,89,115,0,13,31,160,7,15,11,17,22,28,78,124,3,495,27,0,1
32,614,10,10,9,9,0,0,19,0,0,0,0,0,0,0,0,0,0,0,0,1
32,614,173,84,99,8,29,36,181,5,12,7,13,17,20,54,81,2,221,12,0,1
32,614,3,1,1,3,0,0,6,0,0,0,0,0,0,0,0,0,0,0,0,1
160,5038,1660,832,1314,41,38,274,1701,20,312,209,395,332,604,2671,5058,12,64042,3557,1,1
160,5038,1057,646,719,113,100,145,1170,18,215,134,248,233,382,1740,3004,10,31186,1732,1,1
326,6554,1457,730,1242,11,6,188,1468,10,292,166,329,302,495,2424,4078,5,22973,1276,1,1
326,6554,74,35,59,1,0,14,75,3,14,7,14,17,21,58,85,1,128,7,0,1
326,6554,245,125,200,5,7,34,250,7,30,17,34,37,51,166,265,3,1053,58,0,1
86,3024,1450,624,1228,12,26,181,1462,14,306,186,354,320,540,2580,4493,8,36391,2021,1,1
140,3706,1660,832,1314,41,38,274,1701,20,312,209,395,332,604,2671,5058,12,64042,3557,1,1
67,3305,1457,730,1242,11,6,188,1468,10,292,166,329,302,495,2424,4078,5,22973,1276,1,1
159,5043,1660,832,1314,41,38,274,1701,20,312,209,395,332,604,2671,5058,12,64042,3557,1,1
159,5043,1057,646,719,113,100,145,1170,18,215,134,248,233,382,1740,3004,10,31186,1732,1,1
221,4925,722,423,573,19,0,135,741,12,172,101,199,184,300,1320,2257,6,15668,870,0,1
221,4925,1508,847,911,44,250,301,1552,14,148,88,169,162,257,1120,1886,7,15077,837,0,1
37,691,2,2,2,0,0,0,2,0,0,0,0,0,0,0,0,0,0,0,0,1
37,691,99,48,90,1,3,5,100,0,0,0,0,0,0,0,0,0,0,0,0,1
37,691,8,5,5,2,0,1,10,0,0,0,0,0,0,0,0,0,0,0,0,1
37,691,1217,716,841,84,126,174,1301,14,185,118,215,199,333,1446,2542,8,20687,1149,0,1
37,691,160,89,115,0,13,31,160,7,15,11,17,22,28,78,124,3,495,27,0,1
37,691,10,10,9,9,0,0,19,0,0,0,0,0,0,0,0,0,0,0,0,1
37,691,173,84,99,8,29,36,181,5,12,7,13,17,20,54,81,2,221,12,0,1
37,691,3,1,1,3,0,0,6,0,0,0,0,0,0,0,0,0,0,0,0,1
324,6573,1457,730,1242,11,6,188,1468,10,292,166,329,302,495,2424,4078,5,22973,1276,1,1
324,6573,74,35,59,1,0,14,75,3,14,7,14,17,21,58,85,1,128,7,0,1
324,6573,245,125,200,5,7,34,250,7,30,17,34,37,51,166,265,3,1053,58,0,1
91,3201,1450,624,1228,12,26,181,1462,14,306,186,354,320,540,2580,4493,8,36391,2021,1,1
79,3250,1289,550,1043,56,32,155,1345,10,167,93,185,177,278,1266,2075,5,11498,638,0,0
180,3702,1943,715,1694,26,18,214,1969,12,185,120,237,197,357,1436,2721,7,20915,1161,0,0
180,3702,1168,838,957,57,25,144,1225,19,348,224,416,367,640,3018,5452,11,61921,3440,1,0
71,3611,1943,715,1694,26,18,214,1969,12,185,120,237,197,357,1436,2721,7,20915,1161,0,0
312,6316,1457,730,1242,11,6,188,1468,10,292,166,329,302,495,2424,4078,5,22973,1276,1,1
312,6316,74,35,59,1,0,14,75,3,14,7,14,17,21,58,85,1,128,7,0,1
312,6316,245,125,200,5,7,34,250,7,30,17,34,37,51,166,265,3,1053,58,0,1
81,3313,1289,550,1043,56,32,155,1345,10,167,93,185,177,278,1266,2075,5,11498,638,0,1
323,6553,1457,730,1242,11,6,188,1468,10,292,166,329,302,495,2424,4078,5,22973,1276,1,1
323,6553,74,35,59,1,0,14,75,3,14,7,14,17,21,58,85,1,128,7,0,1
323,6553,245,125,200,5,7,34,250,7,30,17,34,37,51,166,265,3,1053,58,0,1
68,3328,1457,730,1242,11,6,188,1468,10,292,166,329,302,495,2424,4078,5,22973,1276,1,1
312,6316,1457,730,1242,11,6,188,1468,10,292,166,329,302,495,2424,4078,5,22973,1276,1,0
312,6316,74,35,59,1,0,14,75,3,14,7,14,17,21,58,85,1,128,7,0,0
312,6316,245,125,200,5,7,34,250,7,30,17,34,37,51,166,265,3,1053,58,0,0
81,3313,1289,550,1043,56,32,155,1345,10,167,93,185,177,278,1266,2075,5,11498,638,0,0
146,6594,139,89,101,2,0,35,141,7,54,34,62,61,96,330,569,4,2287,127,0,1
146,6594,7,5,5,0,0,2,7,1,2,1,2,3,3,2,4,0,2,0,0,1
35,2163,652,304,544,16,6,88,668,6,89,51,101,95,152,591,998,3,3399,188,0,1
37,691,2,2,2,0,0,0,2,0,0,0,0,0,0,0,0,0,0,0,0,0
37,691,99,48,90,1,3,5,100,0,0,0,0,0,0,0,0,0,0,0,0,0
37,691,8,5,5,2,0,1,10,0,0,0,0,0,0,0,0,0,0,0,0,0
37,691,1217,716,841,84,126,174,1301,14,185,118,215,199,333,1446,2542,8,20687,1149,0,0
37,691,160,89,115,0,13,31,160,7,15,11,17,22,28,78,124,3,495,27,0,0
37,691,10,10,9,9,0,0,19,0,0,0,0,0,0,0,0,0,0,0,0,0
37,691,173,84,99,8,29,36,181,5,12,7,13,17,20,54,81,2,221,12,0,0
37,691,3,1,1,3,0,0,6,0,0,0,0,0,0,0,0,0,0,0,0,0
160,5038,1660,832,1314,41,38,274,1701,20,312,209,395,332,604,2671,5058,12,64042,3557,1,0
160,5038,1057,646,719,113,100,145,1170,18,215,134,248,233,382,1740,3004,10,31186,1732,1,0
324,6573,1457,730,1242,11,6,188,1468,10,292,166,329,302,495,2424,4078,5,22973,1276,1,0
324,6573,74,35,59,1,0,14,75,3,14,7,14,17,21,58,85,1,128,7,0,0
324,6573,245,125,200,5,7,34,250,7,30,17,34,37,51,166,265,3,1053,58,0,0
221,4925,722,423,573,19,0,135,741,12,172,101,199,184,300,1320,2257,6,15668,870,0,0
221,4925,1508,847,911,44,250,301,1552,14,148,88,169,162,257,1120,1886,7,15077,837,0,0
91,3201,1450,624,1228,12,26,181,1462,14,306,186,354,320,540,2580,4493,8,36391,2021,1,0
140,3706,1660,832,1314,41,38,274,1701,20,312,209,395,332,604,2671,5058,12,64042,3557,1,0
68,3328,1457,730,1242,11,6,188,1468,10,292,166,329,302,495,2424,4078,5,22973,1276,1,0
146,6594,139,89,101,2,0,35,141,7,54,34,62,61,96,330,569,4,2287,127,0,0
146,6594,7,5,5,0,0,2,7,1,2,1,2,3,3,2,4,0,2,0,0,0
35,2163,652,304,544,16,6,88,668,6,89,51,101,95,152,591,998,3,3399,188,0,0
81,3317,1289,550,1043,56,32,155,1345,10,167,93,185,177,278,1266,2075,5,11498,638,0,0
207,4421,182,127,129,0,0,53,182,5,39,21,42,44,63,217,343,2,926,51,0,1
207,4421,1165,710,800,67,119,181,1232,18,243,153,282,261,435,2000,3492,10,36473,2026,1,1
32,595,2,2,2,0,0,0,2,0,0,0,0,0,0,0,0,0,0,0,0,1
32,595,99,48,90,1,3,5,100,0,0,0,0,0,0,0,0,0,0,0,0,1
32,595,8,5,5,2,0,1,10,0,0,0,0,0,0,0,0,0,0,0,0,1
32,595,1217,716,841,84,126,174,1301,14,185,118,215,199,333,1446,2542,8,20687,1149,0,1
32,595,160,89,115,0,13,31,160,7,15,11,17,22,28,78,124,3,495,27,0,1
32,595,10,10,9,9,0,0,19,0,0,0,0,0,0,0,0,0,0,0,0,1
32,595,173,84,99,8,29,36,181,5,12,7,13,17,20,54,81,2,221,12,0,1
32,595,3,1,1,3,0,0,6,0,0,0,0,0,0,0,0,0,0,0,0,1
324,6577,1457,730,1242,11,6,188,1468,10,292,166,329,302,495,2424,4078,5,22973,1276,1,1
324,6577,74,35,59,1,0,14,75,3,14,7,14,17,21,58,85,1,128,7,0,1
324,6577,245,125,200,5,7,34,250,7,30,17,34,37,51,166,265,3,1053,58,0,1
34,980,182,127,129,0,0,53,182,5,39,21,42,44,63,217,343,2,926,51,0,1
133,6161,1392,870,1177,35,17,170,1427,14,494,280,531,508,811,4473,7289,7,54850,3047,2,1
86,3108,1450,624,1228,12,26,181,1462,14,306,186,354,320,540,2580,4493,8,36391,2021,1,1
311,6718,72,33,56,0,4,12,72,1,1,1,1,2,2,0,2,0,1,0,0,1
311,6718,1454,835,1044,76,110,219,1530,17,275,158,296,292,454,2297,3718,9,34017,1889,1,1
62,2604,1043,504,840,53,9,147,1096,9,180,112,198,189,310,1377,2344,4,11604,644,0,1
14,520,295,56,236,0,4,54,295,2,9,5,10,11,15,30,51,1,57,3,0,1
207,4421,182,127,129,0,0,53,182,5,39,21,42,44,63,217,343,2,926,51,0,0
207,4421,1165,710,800,67,119,181,1232,18,243,153,282,261,435,2000,3492,10,36473,2026,1,0
32,595,2,2,2,0,0,0,2,0,0,0,0,0,0,0,0,0,0,0,0,0
32,595,99,48,90,1,3,5,100,0,0,0,0,0,0,0,0,0,0,0,0,0
32,595,8,5,5,2,0,1,10,0,0,0,0,0,0,0,0,0,0,0,0,0
32,595,1217,716,841,84,126,174,1301,14,185,118,215,199,333,1446,2542,8,20687,1149,0,0
32,595,160,89,115,0,13,31,160,7,15,11,17,22,28,78,124,3,495,27,0,0
32,595,10,10,9,9,0,0,19,0,0,0,0,0,0,0,0,0,0,0,0,0
32,595,173,84,99,8,29,36,181,5,12,7,13,17,20,54,81,2,221,12,0,0
32,595,3,1,1,3,0,0,6,0,0,0,0,0,0,0,0,0,0,0,0,0
324,6577,1457,730,1242,11,6,188,1468,10,292,166,329,302,495,2424,4078,5,22973,1276,1,0
324,6577,74,35,59,1,0,14,75,3,14,7,14,17,21,58,85,1,128,7,0,0
324,6577,245,125,200,5,7,34,250,7,30,17,34,37,51,166,265,3,1053,58,0,0
34,980,182,127,129,0,0,53,182,5,39,21,42,44,63,217,343,2,926,51,0,0
133,6161,1392,870,1177,35,17,170,1427,14,494,280,531,508,811,4473,7289,7,54850,3047,2,0
86,3108,1450,624,1228,12,26,181,1462,14,306,186,354,320,540,2580,4493,8,36391,2021,1,0
311,6718,72,33,56,0,4,12,72,1,1,1,1,2,2,0,2,0,1,0,0,0
311,6718,1454,835,1044,76,110,219,1530,17,275,158,296,292,454,2297,3718,9,34017,1889,1,0
62,2604,1043,504,840,53,9,147,1096,9,180,112,198,189,310,1377,2344,4,11604,644,0,0
14,520,295,56,236,0,4,54,295,2,9,5,10,11,15,30,51,1,57,3,0,0
324,6585,1457,730,1242,11,6,188,1468,10,292,166,329,302,495,2424,4078,5,22973,1276,1,0
324,6585,74,35,59,1,0,14,75,3,14,7,14,17,21,58,85,1,128,7,0,0
324,6585,245,125,200,5,7,34,250,7,30,17,34,37,51,166,265,3,1053,58,0,0
321,6564,1457,730,1242,11,6,188,1468,10,292,166,329,302,495,2424,4078,5,22973,1276,1,1
321,6564,74,35,59,1,0,14,75,3,14,7,14,17,21,58,85,1,128,7,0,1
321,6564,245,125,200,5,7,34,250,7,30,17,34,37,51,166,265,3,1053,58,0,1
321,6564,1457,730,1242,11,6,188,1468,10,292,166,329,302,495,2424,4078,5,22973,1276,1,0
321,6564,74,35,59,1,0,14,75,3,14,7,14,17,21,58,85,1,128,7,0,0
321,6564,245,125,200,5,7,34,250,7,30,17,34,37,51,166,265,3,1053,58,0,0
174,4040,77,34,69,0,0,8,77,3,24,16,29,27,45,114,213,1,387,21,0,1
174,4040,712,438,573,51,9,84,763,14,102,71,128,116,199,733,1364,8,11988,666,0,1
25,1016,373,158,315,8,0,51,381,5,76,44,79,81,123,486,779,2,2026,112,0,1
100,1889,1178,367,1042,6,15,115,1184,9,94,51,95,103,146,644,976,4,4439,246,0,1
100,1889,177,108,140,8,0,27,185,6,30,16,32,36,48,162,248,3,794,44,0,1
100,1889,1178,367,1042,6,15,115,1184,9,94,51,95,103,146,644,976,4,4439,246,0,0
100,1889,177,108,140,8,0,27,185,6,30,16,32,36,48,162,248,3,794,44,0,0
174,4040,77,34,69,0,0,8,77,3,24,16,29,27,45,114,213,1,387,21,0,0
174,4040,712,438,573,51,9,84,763,14,102,71,128,116,199,733,1364,8,11988,666,0,0
25,1016,373,158,315,8,0,51,381,5,76,44,79,81,123,486,779,2,2026,112,0,0
322,6605,1457,730,1242,11,6,188,1468,10,292,166,329,302,495,2424,4078,5,22973,1276,1,0
322,6605,74,35,59,1,0,14,75,3,14,7,14,17,21,58,85,1,128,7,0,0
322,6605,245,125,200,5,7,34,250,7,30,17,34,37,51,166,265,3,1053,58,0,0
37,2210,652,304,544,16,6,88,668,6,89,51,101,95,152,591,998,3,3399,188,0,0
237,5240,4293,999,3693,19,54,507,4312,9,155,88,170,164,258,1156,1898,4,9368,520,0,0
237,5240,1482,859,1002,125,135,219,1607,16,219,134,251,235,385,1766,3032,9,27804,1544,1,0
46,954,447,308,343,6,5,95,453,7,96,59,111,103,170,651,1136,4,4600,255,0,1
46,954,322,174,179,16,74,51,338,10,41,26,46,51,72,252,408,5,2291,127,0,1
39,1661,447,308,343,6,5,95,453,7,96,59,111,103,170,651,1136,4,4600,255,0,1
223,4983,722,423,573,19,0,135,741,12,172,101,199,184,300,1320,2257,6,15668,870,0,1
223,4983,1508,847,911,44,250,301,1552,14,148,88,169,162,257,1120,1886,7,15077,837,0,1
223,4983,722,423,573,19,0,135,741,12,172,101,199,184,300,1320,2257,6,15668,870,0,0
223,4983,1508,847,911,44,250,301,1552,14,148,88,169,162,257,1120,1886,7,15077,837,0,0
46,954,447,308,343,6,5,95,453,7,96,59,111,103,170,651,1136,4,4600,255,0,0
46,954,322,174,179,16,74,51,338,10,41,26,46,51,72,252,408,5,2291,127,0,0
114,4432,1513,682,1277,25,13,200,1538,11,199,116,219,210,335,1557,2584,6,15641,868,0,0
39,1661,447,308,343,6,5,95,453,7,96,59,111,103,170,651,1136,4,4600,255,0,0
46,943,447,308,343,6,5,95,453,7,96,59,111,103,170,651,1136,4,4600,255,0,1
46,943,322,174,179,16,74,51,338,10,41,26,46,51,72,252,408,5,2291,127,0,1
56,1547,1455,414,1257,16,76,112,1471,5,41,23,46,46,69,231,381,2,1069,59,0,1
56,1547,669,365,481,22,61,110,691,15,103,63,122,118,185,747,1273,8,11311,628,0,1
56,1556,1455,414,1257,16,76,112,1471,5,41,23,46,46,69,231,381,2,1069,59,0,1
56,1556,669,365,481,22,61,110,691,15,103,63,122,118,185,747,1273,8,11311,628,0,1
64,2717,1455,414,1257,16,76,112,1471,5,41,23,46,46,69,231,381,2,1069,59,0,1
57,1569,1455,414,1257,16,76,112,1471,5,41,23,46,46,69,231,381,2,1069,59,0,0
57,1569,669,365,481,22,61,110,691,15,103,63,122,118,185,747,1273,8,11311,628,0,0
64,2720,1455,414,1257,16,76,112,1471,5,41,23,46,46,69,231,381,2,1069,59,0,1
57,1571,1455,414,1257,16,76,112,1471,5,41,23,46,46,69,231,381,2,1069,59,0,0
57,1571,669,365,481,22,61,110,691,15,103,63,122,118,185,747,1273,8,11311,628,0,0
62,2710,1455,414,1257,16,76,112,1471,5,41,23,46,46,69,231,381,2,1069,59,0,0
61,2720,1455,414,1257,16,76,112,1471,5,41,23,46,46,69,231,381,2,1069,59,0,0
56,1576,1455,414,1257,16,76,112,1471,5,41,23,46,46,69,231,381,2,1069,59,0,1
56,1576,669,365,481,22,61,110,691,15,103,63,122,118,185,747,1273,8,11311,628,0,1
314,6752,72,33,56,0,4,12,72,1,1,1,1,2,2,0,2,0,1,0,0,1
314,6752,1454,835,1044,76,110,219,1530,17,275,158,296,292,454,2297,3718,9,34017,1889,1,1
91,4840,1782,648,1425,9,47,279,1791,8,171,97,189,179,286,1292,2140,4,9462,525,0,1
148,6629,139,89,101,2,0,35,141,7,54,34,62,61,96,330,569,4,2287,127,0,1
148,6629,7,5,5,0,0,2,7,1,2,1,2,3,3,2,4,0,2,0,0,1
56,1576,1455,414,1257,16,76,112,1471,5,41,23,46,46,69,231,381,2,1069,59,0,0
56,1576,669,365,481,22,61,110,691,15,103,63,122,118,185,747,1273,8,11311,628,0,0
148,6629,139,89,101,2,0,35,141,7,54,34,62,61,96,330,569,4,2287,127,0,0
148,6629,7,5,5,0,0,2,7,1,2,1,2,3,3,2,4,0,2,0,0,0
518,11168,72,33,56,0,4,12,72,1,1,1,1,2,2,0,2,0,1,0,0,1
518,11168,1454,835,1044,76,110,219,1530,17,275,158,296,292,454,2297,3718,9,34017,1889,1,1
68,3327,1457,730,1242,11,6,188,1468,10,292,166,329,302,495,2424,4078,5,22973,1276,1,1
314,6750,72,33,56,0,4,12,72,1,1,1,1,2,2,0,2,0,1,0,0,0
314,6750,1454,835,1044,76,110,219,1530,17,275,158,296,292,454,2297,3718,9,34017,1889,1,0
92,4879,1782,648,1425,9,47,279,1791,8,171,97,189,179,286,1292,2140,4,9462,525,0,0
64,2671,1043,504,840,53,9,147,1096,9,180,112,198,189,310,1377,2344,4,11604,644,0,1
68,3327,1457,730,1242,11,6,188,1468,10,292,166,329,302,495,2424,4078,5,22973,1276,1,0
64,2671,1043,504,840,53,9,147,1096,9,180,112,198,189,310,1377,2344,4,11604,644,0,0
175,4040,77,34,69,0,0,8,77,3,24,16,29,27,45,114,213,1,387,21,0,0
175,4040,712,438,573,51,9,84,763,14,102,71,128,116,199,733,1364,8,11988,666,0,0
519,11194,72,33,56,0,4,12,72,1,1,1,1,2,2,0,2,0,1,0,0,0
519,11194,1454,835,1044,76,110,219,1530,17,275,158,296,292,454,2297,3718,9,34017,1889,1,0
85,3914,1338,495,1086,10,64,173,1348,11,122,82,157,133,239,883,1686,7,11934,663,0,0
322,6612,1457,730,1242,11,6,188,1468,10,292,166,329,302,495,2424,4078,5,22973,1276,1,1
322,6612,74,35,59,1,0,14,75,3,14,7,14,17,21,58,85,1,128,7,0,1
322,6612,245,125,200,5,7,34,250,7,30,17,34,37,51,166,265,3,1053,58,0,1
177,4103,77,34,69,0,0,8,77,3,24,16,29,27,45,114,213,1,387,21,0,1
177,4103,712,438,573,51,9,84,763,14,102,71,128,116,199,733,1364,8,11988,666,0,1
87,4028,1338,495,1086,10,64,173,1348,11,122,82,157,133,239,883,1686,7,11934,663,0,1
92,4881,1782,648,1425,9,47,279,1791,8,171,97,189,179,286,1292,2140,4,9462,525,0,1
523,11235,72,33,56,0,4,12,72,1,1,1,1,2,2,0,2,0,1,0,0,0
523,11235,1454,835,1044,76,110,219,1530,17,275,158,296,292,454,2297,3718,9,34017,1889,1,0
84,4537,1782,648,1425,9,47,279,1791,8,171,97,189,179,286,1292,2140,4,9462,525,0,0
322,6608,1457,730,1242,11,6,188,1468,10,292,166,329,302,495,2424,4078,5,22973,1276,1,1
322,6608,74,35,59,1,0,14,75,3,14,7,14,17,21,58,85,1,128,7,0,1
322,6608,245,125,200,5,7,34,250,7,30,17,34,37,51,166,265,3,1053,58,0,1
237,5245,4293,999,3693,19,54,507,4312,9,155,88,170,164,258,1156,1898,4,9368,520,0,1
237,5245,1482,859,1002,125,135,219,1607,16,219,134,251,235,385,1766,3032,9,27804,1544,1,1
311,6721,72,33,56,0,4,12,72,1,1,1,1,2,2,0,2,0,1,0,0,1
311,6721,1454,835,1044,76,110,219,1530,17,275,158,296,292,454,2297,3718,9,34017,1889,1,1
5,162,75,38,59,1,3,12,76,2,4,2,4,6,6,10,15,1,15,0,0,1
145,6578,139,89,101,2,0,35,141,7,54,34,62,61,96,330,569,4,2287,127,0,1
145,6578,7,5,5,0,0,2,7,1,2,1,2,3,3,2,4,0,2,0,0,1
14,811,442,244,305,14,16,103,456,11,68,45,75,79,120,452,756,6,4588,254,0,1
520,11213,72,33,56,0,4,12,72,1,1,1,1,2,2,0,2,0,1,0,0,0
520,11213,1454,835,1044,76,110,219,1530,17,275,158,296,292,454,2297,3718,9,34017,1889,1,0
524,11254,72,33,56,0,4,12,72,1,1,1,1,2,2,0,2,0,1,0,0,0
524,11254,1454,835,1044,76,110,219,1530,17,275,158,296,292,454,2297,3718,9,34017,1889,1,0
322,6612,1457,730,1242,11,6,188,1468,10,292,166,329,302,495,2424,4078,5,22973,1276,1,0
322,6612,74,35,59,1,0,14,75,3,14,7,14,17,21,58,85,1,128,7,0,0
322,6612,245,125,200,5,7,34,250,7,30,17,34,37,51,166,265,3,1053,58,0,0
177,4103,77,34,69,0,0,8,77,3,24,16,29,27,45,114,213,1,387,21,0,0
177,4103,712,438,573,51,9,84,763,14,102,71,128,116,199,733,1364,8,11988,666,0,0
87,4028,1338,495,1086,10,64,173,1348,11,122,82,157,133,239,883,1686,7,11934,663,0,0
92,4881,1782,648,1425,9,47,279,1791,8,171,97,189,179,286,1292,2140,4,9462,525,0,0
238,5259,4293,999,3693,19,54,507,4312,9,155,88,170,164,258,1156,1898,4,9368,520,0,0
238,5259,1482,859,1002,125,135,219,1607,16,219,134,251,235,385,1766,3032,9,27804,1544,1,0
179,4142,77,34,69,0,0,8,77,3,24,16,29,27,45,114,213,1,387,21,0,0
179,4142,712,438,573,51,9,84,763,14,102,71,128,116,199,733,1364,8,11988,666,0,0
320,6840,72,33,56,0,4,12,72,1,1,1,1,2,2,0,2,0,1,0,0,0
320,6840,1454,835,1044,76,110,219,1530,17,275,158,296,292,454,2297,3718,9,34017,1889,1,0
88,4059,1338,495,1086,10,64,173,1348,11,122,82,157,133,239,883,1686,7,11934,663,0,0
147,6691,139,89,101,2,0,35,141,7,54,34,62,61,96,330,569,4,2287,127,0,0
147,6691,7,5,5,0,0,2,7,1,2,1,2,3,3,2,4,0,2,0,0,0
93,4930,1782,648,1425,9,47,279,1791,8,171,97,189,179,286,1292,2140,4,9462,525,0,0
63,2634,1043,504,840,53,9,147,1096,9,180,112,198,189,310,1377,2344,4,11604,644,0,0
179,4142,77,34,69,0,0,8,77,3,24,16,29,27,45,114,213,1,387,21,0,1
179,4142,712,438,573,51,9,84,763,14,102,71,128,116,199,733,1364,8,11988,666,0,1
322,6615,1457,730,1242,11,6,188,1468,10,292,166,329,302,495,2424,4078,5,22973,1276,1,0
322,6615,74,35,59,1,0,14,75,3,14,7,14,17,21,58,85,1,128,7,0,0
322,6615,245,125,200,5,7,34,250,7,30,17,34,37,51,166,265,3,1053,58,0,0
238,5264,4293,999,3693,19,54,507,4312,9,155,88,170,164,258,1156,1898,4,9368,520,0,0
238,5264,1482,859,1002,125,135,219,1607,16,219,134,251,235,385,1766,3032,9,27804,1544,1,0
320,6843,72,33,56,0,4,12,72,1,1,1,1,2,2,0,2,0,1,0,0,0
320,6843,1454,835,1044,76,110,219,1530,17,275,158,296,292,454,2297,3718,9,34017,1889,1,0
5,162,75,38,59,1,3,12,76,2,4,2,4,6,6,10,15,1,15,0,0,0
146,6675,139,89,101,2,0,35,141,7,54,34,62,61,96,330,569,4,2287,127,0,0
146,6675,7,5,5,0,0,2,7,1,2,1,2,3,3,2,4,0,2,0,0,0
238,5264,4293,999,3693,19,54,507,4312,9,155,88,170,164,258,1156,1898,4,9368,520,0,1
238,5264,1482,859,1002,125,135,219,1607,16,219,134,251,235,385,1766,3032,9,27804,1544,1,1
177,3648,1943,715,1694,26,18,214,1969,12,185,120,237,197,357,1436,2721,7,20915,1161,0,1
177,3648,1168,838,957,57,25,144,1225,19,348,224,416,367,640,3018,5452,11,61921,3440,1,1
207,4433,182,127,129,0,0,53,182,5,39,21,42,44,63,217,343,2,926,51,0,1
207,4433,1165,710,800,67,119,181,1232,18,243,153,282,261,435,2000,3492,10,36473,2026,1,1
135,6349,1392,870,1177,35,17,170,1427,14,494,280,531,508,811,4473,7289,7,54850,3047,2,1
135,6409,1392,870,1177,35,17,170,1427,14,494,280,531,508,811,4473,7289,7,54850,3047,2,1
322,6887,72,33,56,0,4,12,72,1,1,1,1,2,2,0,2,0,1,0,0,1
322,6887,1454,835,1044,76,110,219,1530,17,275,158,296,292,454,2297,3718,9,34017,1889,1,1
147,6711,139,89,101,2,0,35,141,7,54,34,62,61,96,330,569,4,2287,127,0,1
147,6711,7,5,5,0,0,2,7,1,2,1,2,3,3,2,4,0,2,0,0,1
207,4433,182,127,129,0,0,53,182,5,39,21,42,44,63,217,343,2,926,51,0,0
207,4433,1165,710,800,67,119,181,1232,18,243,153,282,261,435,2000,3492,10,36473,2026,1,0
135,6409,1392,870,1177,35,17,170,1427,14,494,280,531,508,811,4473,7289,7,54850,3047,2,0
322,6887,72,33,56,0,4,12,72,1,1,1,1,2,2,0,2,0,1,0,0,0
322,6887,1454,835,1044,76,110,219,1530,17,275,158,296,292,454,2297,3718,9,34017,1889,1,0
147,6711,139,89,101,2,0,35,141,7,54,34,62,61,96,330,569,4,2287,127,0,0
147,6711,7,5,5,0,0,2,7,1,2,1,2,3,3,2,4,0,2,0,0,0
240,5292,4293,999,3693,19,54,507,4312,9,155,88,170,164,258,1156,1898,4,9368,520,0,1
240,5292,1482,859,1002,125,135,219,1607,16,219,134,251,235,385,1766,3032,9,27804,1544,1,1
321,6880,72,33,56,0,4,12,72,1,1,1,1,2,2,0,2,0,1,0,0,1
321,6880,1454,835,1044,76,110,219,1530,17,275,158,296,292,454,2297,3718,9,34017,1889,1,1
147,6722,139,89,101,2,0,35,141,7,54,34,62,61,96,330,569,4,2287,127,0,1
147,6722,7,5,5,0,0,2,7,1,2,1,2,3,3,2,4,0,2,0,0,1
240,5292,4293,999,3693,19,54,507,4312,9,155,88,170,164,258,1156,1898,4,9368,520,0,0
240,5292,1482,859,1002,125,135,219,1607,16,219,134,251,235,385,1766,3032,9,27804,1544,1,0
321,6880,72,33,56,0,4,12,72,1,1,1,1,2,2,0,2,0,1,0,0,0
321,6880,1454,835,1044,76,110,219,1530,17,275,158,296,292,454,2297,3718,9,34017,1889,1,0
147,6722,139,89,101,2,0,35,141,7,54,34,62,61,96,330,569,4,2287,127,0,0
147,6722,7,5,5,0,0,2,7,1,2,1,2,3,3,2,4,0,2,0,0,0
71,3611,1943,715,1694,26,18,214,1969,12,185,120,237,197,357,1436,2721,7,20915,1161,0,1
177,3648,1943,715,1694,26,18,214,1969,12,185,120,237,197,357,1436,2721,7,20915,1161,0,0
177,3648,1168,838,957,57,25,144,1225,19,348,224,416,367,640,3018,5452,11,61921,3440,1,0
240,5295,4293,999,3693,19,54,507,4312,9,155,88,170,164,258,1156,1898,4,9368,520,0,1
240,5295,1482,859,1002,125,135,219,1607,16,219,134,251,235,385,1766,3032,9,27804,1544,1,1
147,6728,139,89,101,2,0,35,141,7,54,34,62,61,96,330,569,4,2287,127,0,1
147,6728,7,5,5,0,0,2,7,1,2,1,2,3,3,2,4,0,2,0,0,1
240,5295,4293,999,3693,19,54,507,4312,9,155,88,170,164,258,1156,1898,4,9368,520,0,0
240,5295,1482,859,1002,125,135,219,1607,16,219,134,251,235,385,1766,3032,9,27804,1544,1,0
147,6728,139,89,101,2,0,35,141,7,54,34,62,61,96,330,569,4,2287,127,0,0
147,6728,7,5,5,0,0,2,7,1,2,1,2,3,3,2,4,0,2,0,0,0
159,5031,1660,832,1314,41,38,274,1701,20,312,209,395,332,604,2671,5058,12,64042,3557,1,1
159,5031,1057,646,719,113,100,145,1170,18,215,134,248,233,382,1740,3004,10,31186,1732,1,1
141,3738,1660,832,1314,41,38,274,1701,20,312,209,395,332,604,2671,5058,12,64042,3557,1,1
159,5031,1660,832,1314,41,38,274,1701,20,312,209,395,332,604,2671,5058,12,64042,3557,1,0
159,5031,1057,646,719,113,100,145,1170,18,215,134,248,233,382,1740,3004,10,31186,1732,1,0
141,3738,1660,832,1314,41,38,274,1701,20,312,209,395,332,604,2671,5058,12,64042,3557,1,0
7,298,72,33,56,0,4,12,72,1,1,1,1,2,2,0,2,0,1,0,0,0
123,2695,1043,504,840,53,9,147,1096,9,180,112,198,189,310,1377,2344,4,11604,644,0,1
123,2695,383,288,292,26,6,62,409,11,65,38,67,76,105,429,656,5,3719,206,0,1
66,2714,1043,504,840,53,9,147,1096,9,180,112,198,189,310,1377,2344,4,11604,644,0,1
70,2065,1523,757,1297,19,12,193,1542,12,193,117,230,205,347,1508,2664,7,19053,1058,0,1
70,2065,701,378,504,33,58,109,734,13,110,68,126,123,194,794,1346,7,10027,557,0,1
127,2753,1043,504,840,53,9,147,1096,9,180,112,198,189,310,1377,2344,4,11604,644,0,1
127,2753,383,288,292,26,6,62,409,11,65,38,67,76,105,429,656,5,3719,206,0,1
68,2807,1043,504,840,53,9,147,1096,9,180,112,198,189,310,1377,2344,4,11604,644,0,1
127,2753,1043,504,840,53,9,147,1096,9,180,112,198,189,310,1377,2344,4,11604,644,0,0
127,2753,383,288,292,26,6,62,409,11,65,38,67,76,105,429,656,5,3719,206,0,0
321,6894,72,33,56,0,4,12,72,1,1,1,1,2,2,0,2,0,1,0,0,1
321,6894,1454,835,1044,76,110,219,1530,17,275,158,296,292,454,2297,3718,9,34017,1889,1,1
90,4091,1338,495,1086,10,64,173,1348,11,122,82,157,133,239,883,1686,7,11934,663,0,1
102,1935,1178,367,1042,6,15,115,1184,9,94,51,95,103,146,644,976,4,4439,246,0,0
102,1935,177,108,140,8,0,27,185,6,30,16,32,36,48,162,248,3,794,44,0,0
310,6308,1457,730,1242,11,6,188,1468,10,292,166,329,302,495,2424,4078,5,22973,1276,1,1
310,6308,74,35,59,1,0,14,75,3,14,7,14,17,21,58,85,1,128,7,0,1
310,6308,245,125,200,5,7,34,250,7,30,17,34,37,51,166,265,3,1053,58,0,1
54,3013,1296,573,1062,40,33,157,1336,8,201,118,231,209,349,1561,2689,4,12365,686,0,1
65,3295,1457,730,1242,11,6,188,1468,10,292,166,329,302,495,2424,4078,5,22973,1276,1,1
310,6308,1457,730,1242,11,6,188,1468,10,292,166,329,302,495,2424,4078,5,22973,1276,1,0
310,6308,74,35,59,1,0,14,75,3,14,7,14,17,21,58,85,1,128,7,0,0
310,6308,245,125,200,5,7,34,250,7,30,17,34,37,51,166,265,3,1053,58,0,0
54,3013,1296,573,1062,40,33,157,1336,8,201,118,231,209,349,1561,2689,4,12365,686,0,0
65,3295,1457,730,1242,11,6,188,1468,10,292,166,329,302,495,2424,4078,5,22973,1276,1,0
330,6735,1457,730,1242,11,6,188,1468,10,292,166,329,302,495,2424,4078,5,22973,1276,1,1
330,6735,74,35,59,1,0,14,75,3,14,7,14,17,21,58,85,1,128,7,0,1
330,6735,245,125,200,5,7,34,250,7,30,17,34,37,51,166,265,3,1053,58,0,1
59,3286,1296,573,1062,40,33,157,1336,8,201,118,231,209,349,1561,2689,4,12365,686,0,1
72,3606,1457,730,1242,11,6,188,1468,10,292,166,329,302,495,2424,4078,5,22973,1276,1,1
330,6735,1457,730,1242,11,6,188,1468,10,292,166,329,302,495,2424,4078,5,22973,1276,1,0
330,6735,74,35,59,1,0,14,75,3,14,7,14,17,21,58,85,1,128,7,0,0
330,6735,245,125,200,5,7,34,250,7,30,17,34,37,51,166,265,3,1053,58,0,0
59,3286,1296,573,1062,40,33,157,1336,8,201,118,231,209,349,1561,2689,4,12365,686,0,0
72,3606,1457,730,1242,11,6,188,1468,10,292,166,329,302,495,2424,4078,5,22973,1276,1,0
70,2065,1523,757,1297,19,12,193,1542,12,193,117,230,205,347,1508,2664,7,19053,1058,0,0
70,2065,701,378,504,33,58,109,734,13,110,68,126,123,194,794,1346,7,10027,557,0,0
321,6894,72,33,56,0,4,12,72,1,1,1,1,2,2,0,2,0,1,0,0,0
321,6894,1454,835,1044,76,110,219,1530,17,275,158,296,292,454,2297,3718,9,34017,1889,1,0
90,4091,1338,495,1086,10,64,173,1348,11,122,82,157,133,239,883,1686,7,11934,663,0,0
68,2807,1043,504,840,53,9,147,1096,9,180,112,198,189,310,1377,2344,4,11604,644,0,0
67,2000,1523,757,1297,19,12,193,1542,12,193,117,230,205,347,1508,2664,7,19053,1058,0,1
67,2000,701,378,504,33,58,109,734,13,110,68,126,123,194,794,1346,7,10027,557,0,1
74,3538,1523,757,1297,19,12,193,1542,12,193,117,230,205,347,1508,2664,7,19053,1058,0,1
67,2000,1523,757,1297,19,12,193,1542,12,193,117,230,205,347,1508,2664,7,19053,1058,0,0
67,2000,701,378,504,33,58,109,734,13,110,68,126,123,194,794,1346,7,10027,557,0,0
74,3538,1523,757,1297,19,12,193,1542,12,193,117,230,205,347,1508,2664,7,19053,1058,0,0
39,1562,1098,241,925,5,10,155,1103,7,46,25,49,53,74,273,423,3,1580,87,0,1
103,1947,1178,367,1042,6,15,115,1184,9,94,51,95,103,146,644,976,4,4439,246,0,0
103,1947,177,108,140,8,0,27,185,6,30,16,32,36,48,162,248,3,794,44,0,0
39,1564,1098,241,925,5,10,155,1103,7,46,25,49,53,74,273,423,3,1580,87,0,0
103,1960,1178,367,1042,6,15,115,1184,9,94,51,95,103,146,644,976,4,4439,246,0,0
103,1960,177,108,140,8,0,27,185,6,30,16,32,36,48,162,248,3,794,44,0,0
49,573,647,139,84,35,284,233,682,0,0,0,0,0,0,0,0,0,0,0,0,0
177,3652,1943,715,1694,26,18,214,1969,12,185,120,237,197,357,1436,2721,7,20915,1161,0,0
177,3652,1168,838,957,57,25,144,1225,19,348,224,416,367,640,3018,5452,11,61921,3440,1,0
175,4048,77,34,69,0,0,8,77,3,24,16,29,27,45,114,213,1,387,21,0,1
175,4048,712,438,573,51,9,84,763,14,102,71,128,116,199,733,1364,8,11988,666,0,1
65,3297,1457,730,1242,11,6,188,1468,10,292,166,329,302,495,2424,4078,5,22973,1276,1,1
524,11280,72,33,56,0,4,12,72,1,1,1,1,2,2,0,2,0,1,0,0,0
524,11280,1454,835,1044,76,110,219,1530,17,275,158,296,292,454,2297,3718,9,34017,1889,1,0
148,6631,139,89,101,2,0,35,141,7,54,34,62,61,96,330,569,4,2287,127,0,0
148,6631,7,5,5,0,0,2,7,1,2,1,2,3,3,2,4,0,2,0,0,0
175,4048,77,34,69,0,0,8,77,3,24,16,29,27,45,114,213,1,387,21,0,0
175,4048,712,438,573,51,9,84,763,14,102,71,128,116,199,733,1364,8,11988,666,0,0
65,3297,1457,730,1242,11,6,188,1468,10,292,166,329,302,495,2424,4078,5,22973,1276,1,0
30,649,215,129,180,6,0,29,221,8,65,43,72,73,115,415,711,4,3153,175,0,1
30,649,97,69,77,3,3,16,100,6,22,13,23,28,36,113,173,3,542,30,0,1
6,219,75,38,59,1,3,12,76,2,4,2,4,6,6,10,15,1,15,0,0,1
30,649,215,129,180,6,0,29,221,8,65,43,72,73,115,415,711,4,3153,175,0,0
30,649,97,69,77,3,3,16,100,6,22,13,23,28,36,113,173,3,542,30,0,0
6,219,75,38,59,1,3,12,76,2,4,2,4,6,6,10,15,1,15,0,0,0
225,5008,4293,999,3693,19,54,507,4312,9,155,88,170,164,258,1156,1898,4,9368,520,0,1
225,5008,1482,859,1002,125,135,219,1607,16,219,134,251,235,385,1766,3032,9,27804,1544,1,1
321,6872,72,33,56,0,4,12,72,1,1,1,1,2,2,0,2,0,1,0,0,1
321,6872,1454,835,1044,76,110,219,1530,17,275,158,296,292,454,2297,3718,9,34017,1889,1,1
146,6681,139,89,101,2,0,35,141,7,54,34,62,61,96,330,569,4,2287,127,0,1
146,6681,7,5,5,0,0,2,7,1,2,1,2,3,3,2,4,0,2,0,0,1
334,6788,1457,730,1242,11,6,188,1468,10,292,166,329,302,495,2424,4078,5,22973,1276,1,1
334,6788,74,35,59,1,0,14,75,3,14,7,14,17,21,58,85,1,128,7,0,1
334,6788,245,125,200,5,7,34,250,7,30,17,34,37,51,166,265,3,1053,58,0,1
6,195,75,38,59,1,3,12,76,2,4,2,4,6,6,10,15,1,15,0,0,1
72,3655,1457,730,1242,11,6,188,1468,10,292,166,329,302,495,2424,4078,5,22973,1276,1,1
225,5008,4293,999,3693,19,54,507,4312,9,155,88,170,164,258,1156,1898,4,9368,520,0,0
225,5008,1482,859,1002,125,135,219,1607,16,219,134,251,235,385,1766,3032,9,27804,1544,1,0
321,6886,72,33,56,0,4,12,72,1,1,1,1,2,2,0,2,0,1,0,0,0
321,6886,1454,835,1044,76,110,219,1530,17,275,158,296,292,454,2297,3718,9,34017,1889,1,0
146,6681,139,89,101,2,0,35,141,7,54,34,62,61,96,330,569,4,2287,127,0,0
146,6681,7,5,5,0,0,2,7,1,2,1,2,3,3,2,4,0,2,0,0,0
334,6788,1457,730,1242,11,6,188,1468,10,292,166,329,302,495,2424,4078,5,22973,1276,1,0
334,6788,74,35,59,1,0,14,75,3,14,7,14,17,21,58,85,1,128,7,0,0
334,6788,245,125,200,5,7,34,250,7,30,17,34,37,51,166,265,3,1053,58,0,0
7,252,75,38,59,1,3,12,76,2,4,2,4,6,6,10,15,1,15,0,0,0
72,3655,1457,730,1242,11,6,188,1468,10,292,166,329,302,495,2424,4078,5,22973,1276,1,0
74,3550,1523,757,1297,19,12,193,1542,12,193,117,230,205,347,1508,2664,7,19053,1058,0,0
67,2902,1178,367,1042,6,15,115,1184,9,94,51,95,103,146,644,976,4,4439,246,0,0
75,3608,1523,757,1297,19,12,193,1542,12,193,117,230,205,347,1508,2664,7,19053,1058,0,0
85,4578,1782,648,1425,9,47,279,1791,8,171,97,189,179,286,1292,2140,4,9462,525,0,0
105,1995,1178,367,1042,6,15,115,1184,9,94,51,95,103,146,644,976,4,4439,246,0,0
105,1995,177,108,140,8,0,27,185,6,30,16,32,36,48,162,248,3,794,44,0,0
45,1696,1098,241,925,5,10,155,1103,7,46,25,49,53,74,273,423,3,1580,87,0,0
65,3307,1457,730,1242,11,6,188,1468,10,292,166,329,302,495,2424,4078,5,22973,1276,1,0
225,5040,4293,999,3693,19,54,507,4312,9,155,88,170,164,258,1156,1898,4,9368,520,0,1
225,5040,1482,859,1002,125,135,219,1607,16,219,134,251,235,385,1766,3032,9,27804,1544,1,1
70,2072,1523,757,1297,19,12,193,1542,12,193,117,230,205,347,1508,2664,7,19053,1058,0,1
70,2072,701,378,504,33,58,109,734,13,110,68,126,123,194,794,1346,7,10027,557,0,1
179,4150,77,34,69,0,0,8,77,3,24,16,29,27,45,114,213,1,387,21,0,1
179,4150,712,438,573,51,9,84,763,14,102,71,128,116,199,733,1364,8,11988,666,0,1
321,6886,72,33,56,0,4,12,72,1,1,1,1,2,2,0,2,0,1,0,0,1
321,6886,1454,835,1044,76,110,219,1530,17,275,158,296,292,454,2297,3718,9,34017,1889,1,1
104,1979,1178,367,1042,6,15,115,1184,9,94,51,95,103,146,644,976,4,4439,246,0,1
104,1979,177,108,140,8,0,27,185,6,30,16,32,36,48,162,248,3,794,44,0,1
146,6683,139,89,101,2,0,35,141,7,54,34,62,61,96,330,569,4,2287,127,0,1
146,6683,7,5,5,0,0,2,7,1,2,1,2,3,3,2,4,0,2,0,0,1
94,4971,1782,648,1425,9,47,279,1791,8,171,97,189,179,286,1292,2140,4,9462,525,0,1
72,3657,1457,730,1242,11,6,188,1468,10,292,166,329,302,495,2424,4078,5,22973,1276,1,1
78,3868,1523,757,1297,19,12,193,1542,12,193,117,230,205,347,1508,2664,7,19053,1058,0,1
68,2926,1178,367,1042,6,15,115,1184,9,94,51,95,103,146,644,976,4,4439,246,0,1
46,1725,1098,241,925,5,10,155,1103,7,46,25,49,53,74,273,423,3,1580,87,0,1
41,791,207,111,150,11,0,50,218,5,26,19,36,31,55,133,272,3,943,52,0,1
41,791,410,198,237,31,55,97,441,11,63,38,72,74,110,414,683,6,4293,238,0,1
103,1969,1178,367,1042,6,15,115,1184,9,94,51,95,103,146,644,976,4,4439,246,0,1
103,1969,177,108,140,8,0,27,185,6,30,16,32,36,48,162,248,3,794,44,0,1
41,791,207,111,150,11,0,50,218,5,26,19,36,31,55,133,272,3,943,52,0,0
41,791,410,198,237,31,55,97,441,11,63,38,72,74,110,414,683,6,4293,238,0,0
225,5040,4293,999,3693,19,54,507,4312,9,155,88,170,164,258,1156,1898,4,9368,520,0,0
225,5040,1482,859,1002,125,135,219,1607,16,219,134,251,235,385,1766,3032,9,27804,1544,1,0
70,2072,1523,757,1297,19,12,193,1542,12,193,117,230,205,347,1508,2664,7,19053,1058,0,0
70,2072,701,378,504,33,58,109,734,13,110,68,126,123,194,794,1346,7,10027,557,0,0
179,4150,77,34,69,0,0,8,77,3,24,16,29,27,45,114,213,1,387,21,0,0
179,4150,712,438,573,51,9,84,763,14,102,71,128,116,199,733,1364,8,11988,666,0,0
103,1969,1178,367,1042,6,15,115,1184,9,94,51,95,103,146,644,976,4,4439,246,0,0
103,1969,177,108,140,8,0,27,185,6,30,16,32,36,48,162,248,3,794,44,0,0
146,6683,139,89,101,2,0,35,141,7,54,34,62,61,96,330,569,4,2287,127,0,0
146,6683,7,5,5,0,0,2,7,1,2,1,2,3,3,2,4,0,2,0,0,0
94,4971,1782,648,1425,9,47,279,1791,8,171,97,189,179,286,1292,2140,4,9462,525,0,0
72,3657,1457,730,1242,11,6,188,1468,10,292,166,329,302,495,2424,4078,5,22973,1276,1,0
78,3868,1523,757,1297,19,12,193,1542,12,193,117,230,205,347,1508,2664,7,19053,1058,0,0
68,2926,1178,367,1042,6,15,115,1184,9,94,51,95,103,146,644,976,4,4439,246,0,0
46,1725,1098,241,925,5,10,155,1103,7,46,25,49,53,74,273,423,3,1580,87,0,0
322,6894,72,33,56,0,4,12,72,1,1,1,1,2,2,0,2,0,1,0,0,1
322,6894,1454,835,1044,76,110,219,1530,17,275,158,296,292,454,2297,3718,9,34017,1889,1,1
128,2805,1043,504,840,53,9,147,1096,9,180,112,198,189,310,1377,2344,4,11604,644,0,1
128,2805,383,288,292,26,6,62,409,11,65,38,67,76,105,429,656,5,3719,206,0,1
69,2837,1043,504,840,53,9,147,1096,9,180,112,198,189,310,1377,2344,4,11604,644,0,1
322,6894,72,33,56,0,4,12,72,1,1,1,1,2,2,0,2,0,1,0,0,0
322,6894,1454,835,1044,76,110,219,1530,17,275,158,296,292,454,2297,3718,9,34017,1889,1,0
128,2805,1043,504,840,53,9,147,1096,9,180,112,198,189,310,1377,2344,4,11604,644,0,0
128,2805,383,288,292,26,6,62,409,11,65,38,67,76,105,429,656,5,3719,206,0,0
69,2837,1043,504,840,53,9,147,1096,9,180,112,198,189,310,1377,2344,4,11604,644,0,0
70,1304,1020,354,843,12,15,144,1032,8,134,77,144,142,221,970,1580,4,6792,377,0,1
321,6850,72,33,56,0,4,12,72,1,1,1,1,2,2,0,2,0,1,0,0,1
321,6850,1454,835,1044,76,110,219,1530,17,275,158,296,292,454,2297,3718,9,34017,1889,1,1
179,4151,77,34,69,0,0,8,77,3,24,16,29,27,45,114,213,1,387,21,0,1
179,4151,712,438,573,51,9,84,763,14,102,71,128,116,199,733,1364,8,11988,666,0,1
70,1304,1020,354,843,12,15,144,1032,8,134,77,144,142,221,970,1580,4,6792,377,0,0
321,6850,72,33,56,0,4,12,72,1,1,1,1,2,2,0,2,0,1,0,0,0
321,6850,1454,835,1044,76,110,219,1530,17,275,158,296,292,454,2297,3718,9,34017,1889,1,0
78,3291,1289,550,1043,56,32,155,1345,10,167,93,185,177,278,1266,2075,5,11498,638,0,0
179,4151,77,34,69,0,0,8,77,3,24,16,29,27,45,114,213,1,387,21,0,0
179,4151,712,438,573,51,9,84,763,14,102,71,128,116,199,733,1364,8,11988,666,0,0
326,6911,72,33,56,0,4,12,72,1,1,1,1,2,2,0,2,0,1,0,0,1
326,6911,1454,835,1044,76,110,219,1530,17,275,158,296,292,454,2297,3718,9,34017,1889,1,1
98,5099,1782,648,1425,9,47,279,1791,8,171,97,189,179,286,1292,2140,4,9462,525,0,1
326,6911,72,33,56,0,4,12,72,1,1,1,1,2,2,0,2,0,1,0,0,0
326,6911,1454,835,1044,76,110,219,1530,17,275,158,296,292,454,2297,3718,9,34017,1889,1,0
98,5099,1782,648,1425,9,47,279,1791,8,171,97,189,179,286,1292,2140,4,9462,525,0,0
327,6920,72,33,56,0,4,12,72,1,1,1,1,2,2,0,2,0,1,0,0,0
327,6920,1454,835,1044,76,110,219,1530,17,275,158,296,292,454,2297,3718,9,34017,1889,1,0
100,5163,1782,648,1425,9,47,279,1791,8,171,97,189,179,286,1292,2140,4,9462,525,0,0
330,6968,72,33,56,0,4,12,72,1,1,1,1,2,2,0,2,0,1,0,0,1
330,6968,1454,835,1044,76,110,219,1530,17,275,158,296,292,454,2297,3718,9,34017,1889,1,1
101,5195,1782,648,1425,9,47,279,1791,8,171,97,189,179,286,1292,2140,4,9462,525,0,1
330,6968,72,33,56,0,4,12,72,1,1,1,1,2,2,0,2,0,1,0,0,0
330,6968,1454,835,1044,76,110,219,1530,17,275,158,296,292,454,2297,3718,9,34017,1889,1,0
101,5195,1782,648,1425,9,47,279,1791,8,171,97,189,179,286,1292,2140,4,9462,525,0,0
119,2397,1513,682,1277,25,13,200,1538,11,199,116,219,210,335,1557,2584,6,15641,868,0,1
119,2397,819,519,539,24,98,155,843,15,96,57,106,111,163,690,1107,8,9171,509,0,1
116,4563,1513,682,1277,25,13,200,1538,11,199,116,219,210,335,1557,2584,6,15641,868,0,1
119,2397,1513,682,1277,25,13,200,1538,11,199,116,219,210,335,1557,2584,6,15641,868,0,0
119,2397,819,519,539,24,98,155,843,15,96,57,106,111,163,690,1107,8,9171,509,0,0
116,4563,1513,682,1277,25,13,200,1538,11,199,116,219,210,335,1557,2584,6,15641,868,0,0
71,2088,1523,757,1297,19,12,193,1542,12,193,117,230,205,347,1508,2664,7,19053,1058,0,0
71,2088,701,378,504,33,58,109,734,13,110,68,126,123,194,794,1346,7,10027,557,0,0
79,3991,1523,757,1297,19,12,193,1542,12,193,117,230,205,347,1508,2664,7,19053,1058,0,0
207,4437,182,127,129,0,0,53,182,5,39,21,42,44,63,217,343,2,926,51,0,1
207,4437,1165,710,800,67,119,181,1232,18,243,153,282,261,435,2000,3492,10,36473,2026,1,1
87,3140,1450,624,1228,12,26,181,1462,14,306,186,354,320,540,2580,4493,8,36391,2021,1,1
207,4437,182,127,129,0,0,53,182,5,39,21,42,44,63,217,343,2,926,51,0,0
207,4437,1165,710,800,67,119,181,1232,18,243,153,282,261,435,2000,3492,10,36473,2026,1,0
87,3140,1450,624,1228,12,26,181,1462,14,306,186,354,320,540,2580,4493,8,36391,2021,1,0
1,310,382,65,130,157,2,92,539,4,10,5,10,14,15,41,57,2,114,6,0,1
1,310,382,65,130,157,2,92,539,4,10,5,10,14,15,41,57,2,114,6,0,0
55,1112,1098,241,925,5,10,155,1103,7,46,25,49,53,74,273,423,3,1580,87,0,0
55,1112,282,202,222,14,2,44,296,8,42,24,43,50,67,250,378,4,1548,86,0,0
34,625,2,2,2,0,0,0,2,0,0,0,0,0,0,0,0,0,0,0,0,1
34,625,99,48,90,1,3,5,100,0,0,0,0,0,0,0,0,0,0,0,0,1
34,625,8,5,5,2,0,1,10,0,0,0,0,0,0,0,0,0,0,0,0,1
34,625,1217,716,841,84,126,174,1301,14,185,118,215,199,333,1446,2542,8,20687,1149,0,1
34,625,160,89,115,0,13,31,160,7,15,11,17,22,28,78,124,3,495,27,0,1
34,625,10,10,9,9,0,0,19,0,0,0,0,0,0,0,0,0,0,0,0,1
34,625,173,84,99,8,29,36,181,5,12,7,13,17,20,54,81,2,221,12,0,1
34,625,3,1,1,3,0,0,6,0,0,0,0,0,0,0,0,0,0,0,0,1
335,6801,1457,730,1242,11,6,188,1468,10,292,166,329,302,495,2424,4078,5,22973,1276,1,1
335,6801,74,35,59,1,0,14,75,3,14,7,14,17,21,58,85,1,128,7,0,1
335,6801,245,125,200,5,7,34,250,7,30,17,34,37,51,166,265,3,1053,58,0,1
90,3249,1450,624,1228,12,26,181,1462,14,306,186,354,320,540,2580,4493,8,36391,2021,1,1
34,625,2,2,2,0,0,0,2,0,0,0,0,0,0,0,0,0,0,0,0,0
34,625,99,48,90,1,3,5,100,0,0,0,0,0,0,0,0,0,0,0,0,0
34,625,8,5,5,2,0,1,10,0,0,0,0,0,0,0,0,0,0,0,0,0
34,625,1217,716,841,84,126,174,1301,14,185,118,215,199,333,1446,2542,8,20687,1149,0,0
34,625,160,89,115,0,13,31,160,7,15,11,17,22,28,78,124,3,495,27,0,0
34,625,10,10,9,9,0,0,19,0,0,0,0,0,0,0,0,0,0,0,0,0
34,625,173,84,99,8,29,36,181,5,12,7,13,17,20,54,81,2,221,12,0,0
34,625,3,1,1,3,0,0,6,0,0,0,0,0,0,0,0,0,0,0,0,0
335,6801,1457,730,1242,11,6,188,1468,10,292,166,329,302,495,2424,4078,5,22973,1276,1,0
335,6801,74,35,59,1,0,14,75,3,14,7,14,17,21,58,85,1,128,7,0,0
335,6801,245,125,200,5,7,34,250,7,30,17,34,37,51,166,265,3,1053,58,0,0
90,3249,1450,624,1228,12,26,181,1462,14,306,186,354,320,540,2580,4493,8,36391,2021,1,0
40,1472,1293,570,1093,25,15,163,1318,10,195,123,241,205,364,1516,2795,6,17273,959,0,0
55,1112,1098,241,925,5,10,155,1103,7,46,25,49,53,74,273,423,3,1580,87,0,1
55,1112,282,202,222,14,2,44,296,8,42,24,43,50,67,250,378,4,1548,86,0,1
40,1472,1293,570,1093,25,15,163,1318,10,195,123,241,205,364,1516,2795,6,17273,959,0,1
330,6972,72,33,56,0,4,12,72,1,1,1,1,2,2,0,2,0,1,0,0,1
330,6972,1454,835,1044,76,110,219,1530,17,275,158,296,292,454,2297,3718,9,34017,1889,1,1
103,5262,1782,648,1425,9,47,279,1791,8,171,97,189,179,286,1292,2140,4,9462,525,0,1
330,6963,72,33,56,0,4,12,72,1,1,1,1,2,2,0,2,0,1,0,0,0
330,6963,1454,835,1044,76,110,219,1530,17,275,158,296,292,454,2297,3718,9,34017,1889,1,0
178,4126,77,34,69,0,0,8,77,3,24,16,29,27,45,114,213,1,387,21,0,1
178,4126,712,438,573,51,9,84,763,14,102,71,128,116,199,733,1364,8,11988,666,0,1
224,5018,722,423,573,19,0,135,741,12,172,101,199,184,300,1320,2257,6,15668,870,0,1
224,5018,1508,847,911,44,250,301,1552,14,148,88,169,162,257,1120,1886,7,15077,837,0,1
128,2812,1043,504,840,53,9,147,1096,9,180,112,198,189,310,1377,2344,4,11604,644,0,1
128,2812,383,288,292,26,6,62,409,11,65,38,67,76,105,429,656,5,3719,206,0,1
330,6972,72,33,56,0,4,12,72,1,1,1,1,2,2,0,2,0,1,0,0,0
330,6972,1454,835,1044,76,110,219,1530,17,275,158,296,292,454,2297,3718,9,34017,1889,1,0
103,5262,1782,648,1425,9,47,279,1791,8,171,97,189,179,286,1292,2140,4,9462,525,0,0
82,1794,477,336,357,30,23,73,507,16,194,134,250,210,384,1538,2962,10,30538,1696,0,0
320,6878,72,33,56,0,4,12,72,1,1,1,1,2,2,0,2,0,1,0,0,0
320,6878,1454,835,1044,76,110,219,1530,17,275,158,296,292,454,2297,3718,9,34017,1889,1,0
15,340,256,139,192,9,7,47,265,4,23,12,24,27,36,112,171,2,357,19,0,0
1,300,382,65,130,157,2,92,539,4,10,5,10,14,15,41,57,2,114,6,0,0
329,6952,72,33,56,0,4,12,72,1,1,1,1,2,2,0,2,0,1,0,0,0
329,6952,1454,835,1044,76,110,219,1530,17,275,158,296,292,454,2297,3718,9,34017,1889,1,0
179,4155,77,34,69,0,0,8,77,3,24,16,29,27,45,114,213,1,387,21,0,1
179,4155,712,438,573,51,9,84,763,14,102,71,128,116,199,733,1364,8,11988,666,0,1
69,1346,1020,354,843,12,15,144,1032,8,134,77,144,142,221,970,1580,4,6792,377,0,1
103,1956,1178,367,1042,6,15,115,1184,9,94,51,95,103,146,644,976,4,4439,246,0,1
103,1956,177,108,140,8,0,27,185,6,30,16,32,36,48,162,248,3,794,44,0,1
66,2750,1020,354,843,12,15,144,1032,8,134,77,144,142,221,970,1580,4,6792,377,0,1
41,798,207,111,150,11,0,50,218,5,26,19,36,31,55,133,272,3,943,52,0,1
41,798,410,198,237,31,55,97,441,11,63,38,72,74,110,414,683,6,4293,238,0,1
69,1347,1020,354,843,12,15,144,1032,8,134,77,144,142,221,970,1580,4,6792,377,0,1
336,6810,1457,730,1242,11,6,188,1468,10,292,166,329,302,495,2424,4078,5,22973,1276,1,1
336,6810,74,35,59,1,0,14,75,3,14,7,14,17,21,58,85,1,128,7,0,1
336,6810,245,125,200,5,7,34,250,7,30,17,34,37,51,166,265,3,1053,58,0,1
90,3273,1450,624,1228,12,26,181,1462,14,306,186,354,320,540,2580,4493,8,36391,2021,1,1
336,6810,1457,730,1242,11,6,188,1468,10,292,166,329,302,495,2424,4078,5,22973,1276,1,0
336,6810,74,35,59,1,0,14,75,3,14,7,14,17,21,58,85,1,128,7,0,0
336,6810,245,125,200,5,7,34,250,7,30,17,34,37,51,166,265,3,1053,58,0,0
90,3273,1450,624,1228,12,26,181,1462,14,306,186,354,320,540,2580,4493,8,36391,2021,1,0
178,4126,77,34,69,0,0,8,77,3,24,16,29,27,45,114,213,1,387,21,0,0
178,4126,712,438,573,51,9,84,763,14,102,71,128,116,199,733,1364,8,11988,666,0,0
224,5018,722,423,573,19,0,135,741,12,172,101,199,184,300,1320,2257,6,15668,870,0,0
224,5018,1508,847,911,44,250,301,1552,14,148,88,169,162,257,1120,1886,7,15077,837,0,0
329,6947,72,33,56,0,4,12,72,1,1,1,1,2,2,0,2,0,1,0,0,0
329,6947,1454,835,1044,76,110,219,1530,17,275,158,296,292,454,2297,3718,9,34017,1889,1,0
128,2812,1043,504,840,53,9,147,1096,9,180,112,198,189,310,1377,2344,4,11604,644,0,0
128,2812,383,288,292,26,6,62,409,11,65,38,67,76,105,429,656,5,3719,206,0,0
82,1795,477,336,357,30,23,73,507,16,194,134,250,210,384,1538,2962,10,30538,1696,0,0
91,3316,1450,624,1228,12,26,181,1462,14,306,186,354,320,540,2580,4493,8,36391,2021,1,0
34,643,2,2,2,0,0,0,2,0,0,0,0,0,0,0,0,0,0,0,0,0
34,643,99,48,90,1,3,5,100,0,0,0,0,0,0,0,0,0,0,0,0,0
34,643,8,5,5,2,0,1,10,0,0,0,0,0,0,0,0,0,0,0,0,0
34,643,1217,716,841,84,126,174,1301,14,185,118,215,199,333,1446,2542,8,20687,1149,0,0
34,643,160,89,115,0,13,31,160,7,15,11,17,22,28,78,124,3,495,27,0,0
34,643,10,10,9,9,0,0,19,0,0,0,0,0,0,0,0,0,0,0,0,0
34,643,173,84,99,8,29,36,181,5,12,7,13,17,20,54,81,2,221,12,0,0
34,643,3,1,1,3,0,0,6,0,0,0,0,0,0,0,0,0,0,0,0,0
41,798,207,111,150,11,0,50,218,5,26,19,36,31,55,133,272,3,943,52,0,0
41,798,410,198,237,31,55,97,441,11,63,38,72,74,110,414,683,6,4293,238,0,0
178,4130,77,34,69,0,0,8,77,3,24,16,29,27,45,114,213,1,387,21,0,0
178,4130,712,438,573,51,9,84,763,14,102,71,128,116,199,733,1364,8,11988,666,0,0
69,1347,1020,354,843,12,15,144,1032,8,134,77,144,142,221,970,1580,4,6792,377,0,0
103,1956,1178,367,1042,6,15,115,1184,9,94,51,95,103,146,644,976,4,4439,246,0,0
103,1956,177,108,140,8,0,27,185,6,30,16,32,36,48,162,248,3,794,44,0,0
66,2750,1020,354,843,12,15,144,1032,8,134,77,144,142,221,970,1580,4,6792,377,0,0
330,6978,72,33,56,0,4,12,72,1,1,1,1,2,2,0,2,0,1,0,0,0
330,6978,1454,835,1044,76,110,219,1530,17,275,158,296,292,454,2297,3718,9,34017,1889,1,0
91,3313,1450,624,1228,12,26,181,1462,14,306,186,354,320,540,2580,4493,8,36391,2021,1,0
22,673,339,213,244,17,9,65,356,10,42,26,48,52,74,259,421,5,2410,133,0,0
42,1533,1293,570,1093,25,15,163,1318,10,195,123,241,205,364,1516,2795,6,17273,959,0,0
44,1603,1293,570,1093,25,15,163,1318,10,195,123,241,205,364,1516,2795,6,17273,959,0,1
228,5101,4293,999,3693,19,54,507,4312,9,155,88,170,164,258,1156,1898,4,9368,520,0,1
228,5101,1482,859,1002,125,135,219,1607,16,219,134,251,235,385,1766,3032,9,27804,1544,1,1
330,6987,72,33,56,0,4,12,72,1,1,1,1,2,2,0,2,0,1,0,0,1
330,6987,1454,835,1044,76,110,219,1530,17,275,158,296,292,454,2297,3718,9,34017,1889,1,1
147,6715,139,89,101,2,0,35,141,7,54,34,62,61,96,330,569,4,2287,127,0,1
147,6715,7,5,5,0,0,2,7,1,2,1,2,3,3,2,4,0,2,0,0,1
106,5313,1782,648,1425,9,47,279,1791,8,171,97,189,179,286,1292,2140,4,9462,525,0,1
228,5101,4293,999,3693,19,54,507,4312,9,155,88,170,164,258,1156,1898,4,9368,520,0,0
228,5101,1482,859,1002,125,135,219,1607,16,219,134,251,235,385,1766,3032,9,27804,1544,1,0
330,6987,72,33,56,0,4,12,72,1,1,1,1,2,2,0,2,0,1,0,0,0
330,6987,1454,835,1044,76,110,219,1530,17,275,158,296,292,454,2297,3718,9,34017,1889,1,0
147,6715,139,89,101,2,0,35,141,7,54,34,62,61,96,330,569,4,2287,127,0,0
147,6715,7,5,5,0,0,2,7,1,2,1,2,3,3,2,4,0,2,0,0,0
106,5313,1782,648,1425,9,47,279,1791,8,171,97,189,179,286,1292,2140,4,9462,525,0,0
208,4450,182,127,129,0,0,53,182,5,39,21,42,44,63,217,343,2,926,51,0,1
208,4450,1165,710,800,67,119,181,1232,18,243,153,282,261,435,2000,3492,10,36473,2026,1,1
101,2153,773,419,590,28,0,166,801,10,204,113,217,214,330,1598,2554,5,13587,754,0,1
101,2153,421,273,302,44,34,57,465,17,81,59,107,98,166,583,1098,11,12329,684,0,1
82,1800,477,336,357,30,23,73,507,16,194,134,250,210,384,1538,2962,10,30538,1696,0,1
332,7010,72,33,56,0,4,12,72,1,1,1,1,2,2,0,2,0,1,0,0,1
332,7010,1454,835,1044,76,110,219,1530,17,275,158,296,292,454,2297,3718,9,34017,1889,1,1
207,4440,182,127,129,0,0,53,182,5,39,21,42,44,63,217,343,2,926,51,0,1
207,4440,1165,710,800,67,119,181,1232,18,243,153,282,261,435,2000,3492,10,36473,2026,1,1
100,2143,773,419,590,28,0,166,801,10,204,113,217,214,330,1598,2554,5,13587,754,0,1
100,2143,421,273,302,44,34,57,465,17,81,59,107,98,166,583,1098,11,12329,684,0,1
330,6984,72,33,56,0,4,12,72,1,1,1,1,2,2,0,2,0,1,0,0,1
330,6984,1454,835,1044,76,110,219,1530,17,275,158,296,292,454,2297,3718,9,34017,1889,1,1
207,4440,182,127,129,0,0,53,182,5,39,21,42,44,63,217,343,2,926,51,0,0
207,4440,1165,710,800,67,119,181,1232,18,243,153,282,261,435,2000,3492,10,36473,2026,1,0
100,2143,773,419,590,28,0,166,801,10,204,113,217,214,330,1598,2554,5,13587,754,0,0
100,2143,421,273,302,44,34,57,465,17,81,59,107,98,166,583,1098,11,12329,684,0,0
82,1800,477,336,357,30,23,73,507,16,194,134,250,210,384,1538,2962,10,30538,1696,0,0
330,6993,72,33,56,0,4,12,72,1,1,1,1,2,2,0,2,0,1,0,0,0
330,6993,1454,835,1044,76,110,219,1530,17,275,158,296,292,454,2297,3718,9,34017,1889,1,0
99,2124,773,419,590,28,0,166,801,10,204,113,217,214,330,1598,2554,5,13587,754,0,0
99,2124,421,273,302,44,34,57,465,17,81,59,107,98,166,583,1098,11,12329,684,0,0
44,1603,1293,570,1093,25,15,163,1318,10,195,123,241,205,364,1516,2795,6,17273,959,0,0
119,2401,1513,682,1277,25,13,200,1538,11,199,116,219,210,335,1557,2584,6,15641,868,0,0
119,2401,819,519,539,24,98,155,843,15,96,57,106,111,163,690,1107,8,9171,509,0,0
119,2402,1513,682,1277,25,13,200,1538,11,199,116,219,210,335,1557,2584,6,15641,868,0,0
119,2402,819,519,539,24,98,155,843,15,96,57,106,111,163,690,1107,8,9171,509,0,0
82,1792,477,336,357,30,23,73,507,16,194,134,250,210,384,1538,2962,10,30538,1696,0,0
329,6972,72,33,56,0,4,12,72,1,1,1,1,2,2,0,2,0,1,0,0,0
329,6972,1454,835,1044,76,110,219,1530,17,275,158,296,292,454,2297,3718,9,34017,1889,1,0
92,3380,1450,624,1228,12,26,181,1462,14,306,186,354,320,540,2580,4493,8,36391,2021,1,0
330,6993,72,33,56,0,4,12,72,1,1,1,1,2,2,0,2,0,1,0,0,1
330,6993,1454,835,1044,76,110,219,1530,17,275,158,296,292,454,2297,3718,9,34017,1889,1,1
329,7012,72,33,56,0,4,12,72,1,1,1,1,2,2,0,2,0,1,0,0,0
329,7012,1454,835,1044,76,110,219,1530,17,275,158,296,292,454,2297,3718,9,34017,1889,1,0
91,4149,1338,495,1086,10,64,173,1348,11,122,82,157,133,239,883,1686,7,11934,663,0,0
58,3234,1296,573,1062,40,33,157,1336,8,201,118,231,209,349,1561,2689,4,12365,686,0,0
332,7078,72,33,56,0,4,12,72,1,1,1,1,2,2,0,2,0,1,0,0,1
332,7078,1454,835,1044,76,110,219,1530,17,275,158,296,292,454,2297,3718,9,34017,1889,1,1
93,4223,1338,495,1086,10,64,173,1348,11,122,82,157,133,239,883,1686,7,11934,663,0,1
332,7078,72,33,56,0,4,12,72,1,1,1,1,2,2,0,2,0,1,0,0,0
332,7078,1454,835,1044,76,110,219,1530,17,275,158,296,292,454,2297,3718,9,34017,1889,1,0
93,4223,1338,495,1086,10,64,173,1348,11,122,82,157,133,239,883,1686,7,11934,663,0,0
28,547,2,2,2,0,0,0,2,0,0,0,0,0,0,0,0,0,0,0,0,1
28,547,99,48,90,1,3,5,100,0,0,0,0,0,0,0,0,0,0,0,0,1
28,547,8,5,5,2,0,1,10,0,0,0,0,0,0,0,0,0,0,0,0,1
28,547,1217,716,841,84,126,174,1301,14,185,118,215,199,333,1446,2542,8,20687,1149,0,1
28,547,160,89,115,0,13,31,160,7,15,11,17,22,28,78,124,3,495,27,0,1
28,547,10,10,9,9,0,0,19,0,0,0,0,0,0,0,0,0,0,0,0,1
28,547,173,84,99,8,29,36,181,5,12,7,13,17,20,54,81,2,221,12,0,1
28,547,3,1,1,3,0,0,6,0,0,0,0,0,0,0,0,0,0,0,0,1
17,341,95,58,50,9,16,20,104,12,33,24,45,45,69,209,378,8,3100,172,0,1
105,3912,1450,624,1228,12,26,181,1462,14,306,186,354,320,540,2580,4493,8,36391,2021,1,1
28,545,2,2,2,0,0,0,2,0,0,0,0,0,0,0,0,0,0,0,0,0
28,545,99,48,90,1,3,5,100,0,0,0,0,0,0,0,0,0,0,0,0,0
28,545,8,5,5,2,0,1,10,0,0,0,0,0,0,0,0,0,0,0,0,0
28,545,1217,716,841,84,126,174,1301,14,185,118,215,199,333,1446,2542,8,20687,1149,0,0
28,545,160,89,115,0,13,31,160,7,15,11,17,22,28,78,124,3,495,27,0,0
28,545,10,10,9,9,0,0,19,0,0,0,0,0,0,0,0,0,0,0,0,0
28,545,173,84,99,8,29,36,181,5,12,7,13,17,20,54,81,2,221,12,0,0
28,545,3,1,1,3,0,0,6,0,0,0,0,0,0,0,0,0,0,0,0,0
105,3912,1450,624,1228,12,26,181,1462,14,306,186,354,320,540,2580,4493,8,36391,2021,1,0
44,837,207,111,150,11,0,50,218,5,26,19,36,31,55,133,272,3,943,52,0,1
44,837,410,198,237,31,55,97,441,11,63,38,72,74,110,414,683,6,4293,238,0,1
336,6824,1457,730,1242,11,6,188,1468,10,292,166,329,302,495,2424,4078,5,22973,1276,1,1
336,6824,74,35,59,1,0,14,75,3,14,7,14,17,21,58,85,1,128,7,0,1
336,6824,245,125,200,5,7,34,250,7,30,17,34,37,51,166,265,3,1053,58,0,1
105,3908,1450,624,1228,12,26,181,1462,14,306,186,354,320,540,2580,4493,8,36391,2021,1,0
44,837,207,111,150,11,0,50,218,5,26,19,36,31,55,133,272,3,943,52,0,0
44,837,410,198,237,31,55,97,441,11,63,38,72,74,110,414,683,6,4293,238,0,0
336,6824,1457,730,1242,11,6,188,1468,10,292,166,329,302,495,2424,4078,5,22973,1276,1,0
336,6824,74,35,59,1,0,14,75,3,14,7,14,17,21,58,85,1,128,7,0,0
336,6824,245,125,200,5,7,34,250,7,30,17,34,37,51,166,265,3,1053,58,0,0
336,6826,1457,730,1242,11,6,188,1468,10,292,166,329,302,495,2424,4078,5,22973,1276,1,1
336,6826,74,35,59,1,0,14,75,3,14,7,14,17,21,58,85,1,128,7,0,1
336,6826,245,125,200,5,7,34,250,7,30,17,34,37,51,166,265,3,1053,58,0,1
40,2349,334,251,279,10,4,40,344,5,127,74,143,132,217,899,1528,2,4303,239,0,1
336,6826,1457,730,1242,11,6,188,1468,10,292,166,329,302,495,2424,4078,5,22973,1276,1,0
336,6826,74,35,59,1,0,14,75,3,14,7,14,17,21,58,85,1,128,7,0,0
336,6826,245,125,200,5,7,34,250,7,30,17,34,37,51,166,265,3,1053,58,0,0
40,2349,334,251,279,10,4,40,344,5,127,74,143,132,217,899,1528,2,4303,239,0,0
161,5059,1660,832,1314,41,38,274,1701,20,312,209,395,332,604,2671,5058,12,64042,3557,1,1
161,5059,1057,646,719,113,100,145,1170,18,215,134,248,233,382,1740,3004,10,31186,1732,1,1
142,3828,1660,832,1314,41,38,274,1701,20,312,209,395,332,604,2671,5058,12,64042,3557,1,1
44,844,207,111,150,11,0,50,218,5,26,19,36,31,55,133,272,3,943,52,0,0
44,844,410,198,237,31,55,97,441,11,63,38,72,74,110,414,683,6,4293,238,0,0
331,7057,72,33,56,0,4,12,72,1,1,1,1,2,2,0,2,0,1,0,0,0
331,7057,1454,835,1044,76,110,219,1530,17,275,158,296,292,454,2297,3718,9,34017,1889,1,0
29,1414,1293,570,1093,25,15,163,1318,10,195,123,241,205,364,1516,2795,6,17273,959,0,0
29,1416,1293,570,1093,25,15,163,1318,10,195,123,241,205,364,1516,2795,6,17273,959,0,0
222,4970,722,423,573,19,0,135,741,12,172,101,199,184,300,1320,2257,6,15668,870,0,1
222,4970,1508,847,911,44,250,301,1552,14,148,88,169,162,257,1120,1886,7,15077,837,0,1
30,1428,1293,570,1093,25,15,163,1318,10,195,123,241,205,364,1516,2795,6,17273,959,0,1
222,4970,722,423,573,19,0,135,741,12,172,101,199,184,300,1320,2257,6,15668,870,0,0
222,4970,1508,847,911,44,250,301,1552,14,148,88,169,162,257,1120,1886,7,15077,837,0,0
30,1428,1293,570,1093,25,15,163,1318,10,195,123,241,205,364,1516,2795,6,17273,959,0,0
9,360,601,196,481,2,23,85,603,8,63,36,72,71,108,400,664,4,3036,168,0,1
9,360,601,196,481,2,23,85,603,8,63,36,72,71,108,400,664,4,3036,168,0,0
161,5059,1660,832,1314,41,38,274,1701,20,312,209,395,332,604,2671,5058,12,64042,3557,1,0
161,5059,1057,646,719,113,100,145,1170,18,215,134,248,233,382,1740,3004,10,31186,1732,1,0
142,3828,1660,832,1314,41,38,274,1701,20,312,209,395,332,604,2671,5058,12,64042,3557,1,0
40,922,386,256,301,16,9,68,402,4,59,35,69,63,104,355,621,2,1453,80,0,0
40,922,264,131,164,11,41,46,275,6,38,22,40,44,62,214,338,3,1068,59,0,0
29,1224,386,256,301,16,9,68,402,4,59,35,69,63,104,355,621,2,1453,80,0,0
184,3741,1943,715,1694,26,18,214,1969,12,185,120,237,197,357,1436,2721,7,20915,1161,0,1
184,3741,1168,838,957,57,25,144,1225,19,348,224,416,367,640,3018,5452,11,61921,3440,1,1
72,3658,1943,715,1694,26,18,214,1969,12,185,120,237,197,357,1436,2721,7,20915,1161,0,1
184,3741,1943,715,1694,26,18,214,1969,12,185,120,237,197,357,1436,2721,7,20915,1161,0,0
184,3741,1168,838,957,57,25,144,1225,19,348,224,416,367,640,3018,5452,11,61921,3440,1,0
72,3658,1943,715,1694,26,18,214,1969,12,185,120,237,197,357,1436,2721,7,20915,1161,0,0
71,2092,1523,757,1297,19,12,193,1542,12,193,117,230,205,347,1508,2664,7,19053,1058,0,1
71,2092,701,378,504,33,58,109,734,13,110,68,126,123,194,794,1346,7,10027,557,0,1
79,3954,1523,757,1297,19,12,193,1542,12,193,117,230,205,347,1508,2664,7,19053,1058,0,1
71,2092,1523,757,1297,19,12,193,1542,12,193,117,230,205,347,1508,2664,7,19053,1058,0,0
71,2092,701,378,504,33,58,109,734,13,110,68,126,123,194,794,1346,7,10027,557,0,0
79,3954,1523,757,1297,19,12,193,1542,12,193,117,230,205,347,1508,2664,7,19053,1058,0,0
210,4482,182,127,129,0,0,53,182,5,39,21,42,44,63,217,343,2,926,51,0,1
210,4482,1165,710,800,67,119,181,1232,18,243,153,282,261,435,2000,3492,10,36473,2026,1,1
137,6580,1392,870,1177,35,17,170,1427,14,494,280,531,508,811,4473,7289,7,54850,3047,2,1
92,3384,1450,624,1228,12,26,181,1462,14,306,186,354,320,540,2580,4493,8,36391,2021,1,1
210,4482,182,127,129,0,0,53,182,5,39,21,42,44,63,217,343,2,926,51,0,0
210,4482,1165,710,800,67,119,181,1232,18,243,153,282,261,435,2000,3492,10,36473,2026,1,0
137,6580,1392,870,1177,35,17,170,1427,14,494,280,531,508,811,4473,7289,7,54850,3047,2,0
92,3384,1450,624,1228,12,26,181,1462,14,306,186,354,320,540,2580,4493,8,36391,2021,1,0
55,1122,1098,241,925,5,10,155,1103,7,46,25,49,53,74,273,423,3,1580,87,0,1
55,1122,282,202,222,14,2,44,296,8,42,24,43,50,67,250,378,4,1548,86,0,1
48,1773,1098,241,925,5,10,155,1103,7,46,25,49,53,74,273,423,3,1580,87,0,1
55,1122,1098,241,925,5,10,155,1103,7,46,25,49,53,74,273,423,3,1580,87,0,0
55,1122,282,202,222,14,2,44,296,8,42,24,43,50,67,250,378,4,1548,86,0,0
48,1773,1098,241,925,5,10,155,1103,7,46,25,49,53,74,273,423,3,1580,87,0,0
211,4499,182,127,129,0,0,53,182,5,39,21,42,44,63,217,343,2,926,51,0,1
211,4499,1165,710,800,67,119,181,1232,18,243,153,282,261,435,2000,3492,10,36473,2026,1,1
19,443,256,139,192,9,7,47,265,4,23,12,24,27,36,112,171,2,357,19,0,0
334,7098,72,33,56,0,4,12,72,1,1,1,1,2,2,0,2,0,1,0,0,1
334,7098,1454,835,1044,76,110,219,1530,17,275,158,296,292,454,2297,3718,9,34017,1889,1,1
20,468,256,139,192,9,7,47,265,4,23,12,24,27,36,112,171,2,357,19,0,1
211,4499,182,127,129,0,0,53,182,5,39,21,42,44,63,217,343,2,926,51,0,0
211,4499,1165,710,800,67,119,181,1232,18,243,153,282,261,435,2000,3492,10,36473,2026,1,0
334,7098,72,33,56,0,4,12,72,1,1,1,1,2,2,0,2,0,1,0,0,0
334,7098,1454,835,1044,76,110,219,1530,17,275,158,296,292,454,2297,3718,9,34017,1889,1,0
20,468,256,139,192,9,7,47,265,4,23,12,24,27,36,112,171,2,357,19,0,0
14,474,42,7,35,4,0,5,46,1,2,1,2,3,3,2,4,0,2,0,0,0
14,474,11,6,10,0,0,1,11,2,4,2,4,6,6,10,15,1,15,0,0,0
72,2108,1523,757,1297,19,12,193,1542,12,193,117,230,205,347,1508,2664,7,19053,1058,0,0
72,2108,701,378,504,33,58,109,734,13,110,68,126,123,194,794,1346,7,10027,557,0,0
223,5005,722,423,573,19,0,135,741,12,172,101,199,184,300,1320,2257,6,15668,870,0,0
223,5005,1508,847,911,44,250,301,1552,14,148,88,169,162,257,1120,1886,7,15077,837,0,0
333,7077,72,33,56,0,4,12,72,1,1,1,1,2,2,0,2,0,1,0,0,0
333,7077,1454,835,1044,76,110,219,1530,17,275,158,296,292,454,2297,3718,9,34017,1889,1,0
19,446,256,139,192,9,7,47,265,4,23,12,24,27,36,112,171,2,357,19,0,0
93,3451,1450,624,1228,12,26,181,1462,14,306,186,354,320,540,2580,4493,8,36391,2021,1,0
80,4077,1523,757,1297,19,12,193,1542,12,193,117,230,205,347,1508,2664,7,19053,1058,0,0
34,1559,1293,570,1093,25,15,163,1318,10,195,123,241,205,364,1516,2795,6,17273,959,0,0
17,341,95,58,50,9,16,20,104,12,33,24,45,45,69,209,378,8,3100,172,0,0
106,3979,1450,624,1228,12,26,181,1462,14,306,186,354,320,540,2580,4493,8,36391,2021,1,0
162,5072,1660,832,1314,41,38,274,1701,20,312,209,395,332,604,2671,5058,12,64042,3557,1,0
162,5072,1057,646,719,113,100,145,1170,18,215,134,248,233,382,1740,3004,10,31186,1732,1,0
146,3937,1660,832,1314,41,38,274,1701,20,312,209,395,332,604,2671,5058,12,64042,3557,1,0
99,2124,773,419,590,28,0,166,801,10,204,113,217,214,330,1598,2554,5,13587,754,0,1
99,2124,421,273,302,44,34,57,465,17,81,59,107,98,166,583,1098,11,12329,684,0,1
58,3234,1296,573,1062,40,33,157,1336,8,201,118,231,209,349,1561,2689,4,12365,686,0,1
37,2210,652,304,544,16,6,88,668,6,89,51,101,95,152,591,998,3,3399,188,0,1
16,476,2,2,2,0,0,0,2,0,0,0,0,0,0,0,0,0,0,0,0,0
16,476,99,48,90,1,3,5,100,0,0,0,0,0,0,0,0,0,0,0,0,0
16,476,8,5,5,2,0,1,10,0,0,0,0,0,0,0,0,0,0,0,0,0
16,476,1217,716,841,84,126,174,1301,14,185,118,215,199,333,1446,2542,8,20687,1149,0,0
16,476,160,89,115,0,13,31,160,7,15,11,17,22,28,78,124,3,495,27,0,0
16,476,10,10,9,9,0,0,19,0,0,0,0,0,0,0,0,0,0,0,0,0
16,476,173,84,99,8,29,36,181,5,12,7,13,17,20,54,81,2,221,12,0,0
16,476,3,1,1,3,0,0,6,0,0,0,0,0,0,0,0,0,0,0,0,0
8,213,601,196,481,2,23,85,603,8,63,36,72,71,108,400,664,4,3036,168,0,1
338,6856,1457,730,1242,11,6,188,1468,10,292,166,329,302,495,2424,4078,5,22973,1276,1,1
338,6856,74,35,59,1,0,14,75,3,14,7,14,17,21,58,85,1,128,7,0,1
338,6856,245,125,200,5,7,34,250,7,30,17,34,37,51,166,265,3,1053,58,0,1
73,3766,1457,730,1242,11,6,188,1468,10,292,166,329,302,495,2424,4078,5,22973,1276,1,1
338,6856,1457,730,1242,11,6,188,1468,10,292,166,329,302,495,2424,4078,5,22973,1276,1,0
338,6856,74,35,59,1,0,14,75,3,14,7,14,17,21,58,85,1,128,7,0,0
338,6856,245,125,200,5,7,34,250,7,30,17,34,37,51,166,265,3,1053,58,0,0
73,3766,1457,730,1242,11,6,188,1468,10,292,166,329,302,495,2424,4078,5,22973,1276,1,0
335,7115,72,33,56,0,4,12,72,1,1,1,1,2,2,0,2,0,1,0,0,1
335,7115,1454,835,1044,76,110,219,1530,17,275,158,296,292,454,2297,3718,9,34017,1889,1,1
43,2321,520,294,400,33,13,81,553,10,261,204,367,271,571,2128,4614,7,32445,1802,1,1
335,7115,72,33,56,0,4,12,72,1,1,1,1,2,2,0,2,0,1,0,0,0
335,7115,1454,835,1044,76,110,219,1530,17,275,158,296,292,454,2297,3718,9,34017,1889,1,0
43,2321,520,294,400,33,13,81,553,10,261,204,367,271,571,2128,4614,7,32445,1802,1,0
179,4156,77,34,69,0,0,8,77,3,24,16,29,27,45,114,213,1,387,21,0,1
179,4156,712,438,573,51,9,84,763,14,102,71,128,116,199,733,1364,8,11988,666,0,1
179,4156,77,34,69,0,0,8,77,3,24,16,29,27,45,114,213,1,387,21,0,0
179,4156,712,438,573,51,9,84,763,14,102,71,128,116,199,733,1364,8,11988,666,0,0
80,3999,1523,757,1297,19,12,193,1542,12,193,117,230,205,347,1508,2664,7,19053,1058,0,0
179,4170,77,34,69,0,0,8,77,3,24,16,29,27,45,114,213,1,387,21,0,1
179,4170,712,438,573,51,9,84,763,14,102,71,128,116,199,733,1364,8,11988,666,0,1
179,4175,77,34,69,0,0,8,77,3,24,16,29,27,45,114,213,1,387,21,0,1
179,4175,712,438,573,51,9,84,763,14,102,71,128,116,199,733,1364,8,11988,666,0,1
179,4175,77,34,69,0,0,8,77,3,24,16,29,27,45,114,213,1,387,21,0,0
179,4175,712,438,573,51,9,84,763,14,102,71,128,116,199,733,1364,8,11988,666,0,0
178,4154,77,34,69,0,0,8,77,3,24,16,29,27,45,114,213,1,387,21,0,0
178,4154,712,438,573,51,9,84,763,14,102,71,128,116,199,733,1364,8,11988,666,0,0
334,7094,72,33,56,0,4,12,72,1,1,1,1,2,2,0,2,0,1,0,0,0
334,7094,1454,835,1044,76,110,219,1530,17,275,158,296,292,454,2297,3718,9,34017,1889,1,0
81,4122,1523,757,1297,19,12,193,1542,12,193,117,230,205,347,1508,2664,7,19053,1058,0,0
340,6900,1457,730,1242,11,6,188,1468,10,292,166,329,302,495,2424,4078,5,22973,1276,1,1
340,6900,74,35,59,1,0,14,75,3,14,7,14,17,21,58,85,1,128,7,0,1
340,6900,245,125,200,5,7,34,250,7,30,17,34,37,51,166,265,3,1053,58,0,1
71,2113,1523,757,1297,19,12,193,1542,12,193,117,230,205,347,1508,2664,7,19053,1058,0,1
71,2113,701,378,504,33,58,109,734,13,110,68,126,123,194,794,1346,7,10027,557,0,1
179,4196,77,34,69,0,0,8,77,3,24,16,29,27,45,114,213,1,387,21,0,1
179,4196,712,438,573,51,9,84,763,14,102,71,128,116,199,733,1364,8,11988,666,0,1
81,4024,1523,757,1297,19,12,193,1542,12,193,117,230,205,347,1508,2664,7,19053,1058,0,1
340,6900,1457,730,1242,11,6,188,1468,10,292,166,329,302,495,2424,4078,5,22973,1276,1,0
340,6900,74,35,59,1,0,14,75,3,14,7,14,17,21,58,85,1,128,7,0,0
340,6900,245,125,200,5,7,34,250,7,30,17,34,37,51,166,265,3,1053,58,0,0
71,2113,1523,757,1297,19,12,193,1542,12,193,117,230,205,347,1508,2664,7,19053,1058,0,0
71,2113,701,378,504,33,58,109,734,13,110,68,126,123,194,794,1346,7,10027,557,0,0
179,4196,77,34,69,0,0,8,77,3,24,16,29,27,45,114,213,1,387,21,0,0
179,4196,712,438,573,51,9,84,763,14,102,71,128,116,199,733,1364,8,11988,666,0,0
81,4024,1523,757,1297,19,12,193,1542,12,193,117,230,205,347,1508,2664,7,19053,1058,0,0
56,1608,1455,414,1257,16,76,112,1471,5,41,23,46,46,69,231,381,2,1069,59,0,0
56,1608,669,365,481,22,61,110,691,15,103,63,122,118,185,747,1273,8,11311,628,0,0
223,5009,722,423,573,19,0,135,741,12,172,101,199,184,300,1320,2257,6,15668,870,0,1
223,5009,1508,847,911,44,250,301,1552,14,148,88,169,162,257,1120,1886,7,15077,837,0,1
64,2862,1455,414,1257,16,76,112,1471,5,41,23,46,46,69,231,381,2,1069,59,0,1
64,2864,1455,414,1257,16,76,112,1471,5,41,23,46,46,69,231,381,2,1069,59,0,0
56,1599,1455,414,1257,16,76,112,1471,5,41,23,46,46,69,231,381,2,1069,59,0,1
56,1599,669,365,481,22,61,110,691,15,103,63,122,118,185,747,1273,8,11311,628,0,1
62,2825,1455,414,1257,16,76,112,1471,5,41,23,46,46,69,231,381,2,1069,59,0,1
62,2825,1455,414,1257,16,76,112,1471,5,41,23,46,46,69,231,381,2,1069,59,0,0
335,7110,72,33,56,0,4,12,72,1,1,1,1,2,2,0,2,0,1,0,0,0
335,7110,1454,835,1044,76,110,219,1530,17,275,158,296,292,454,2297,3718,9,34017,1889,1,0
59,3269,1296,573,1062,40,33,157,1336,8,201,118,231,209,349,1561,2689,4,12365,686,0,0
56,1599,1455,414,1257,16,76,112,1471,5,41,23,46,46,69,231,381,2,1069,59,0,0
56,1599,669,365,481,22,61,110,691,15,103,63,122,118,185,747,1273,8,11311,628,0,0
223,5009,722,423,573,19,0,135,741,12,172,101,199,184,300,1320,2257,6,15668,870,0,0
223,5009,1508,847,911,44,250,301,1552,14,148,88,169,162,257,1120,1886,7,15077,837,0,0
99,2079,773,419,590,28,0,166,801,10,204,113,217,214,330,1598,2554,5,13587,754,0,0
99,2079,421,273,302,44,34,57,465,17,81,59,107,98,166,583,1098,11,12329,684,0,0
99,2075,773,419,590,28,0,166,801,10,204,113,217,214,330,1598,2554,5,13587,754,0,0
99,2075,421,273,302,44,34,57,465,17,81,59,107,98,166,583,1098,11,12329,684,0,0
341,6910,1457,730,1242,11,6,188,1468,10,292,166,329,302,495,2424,4078,5,22973,1276,1,1
341,6910,74,35,59,1,0,14,75,3,14,7,14,17,21,58,85,1,128,7,0,1
341,6910,245,125,200,5,7,34,250,7,30,17,34,37,51,166,265,3,1053,58,0,1
74,3802,1457,730,1242,11,6,188,1468,10,292,166,329,302,495,2424,4078,5,22973,1276,1,1
341,6910,1457,730,1242,11,6,188,1468,10,292,166,329,302,495,2424,4078,5,22973,1276,1,0
341,6910,74,35,59,1,0,14,75,3,14,7,14,17,21,58,85,1,128,7,0,0
341,6910,245,125,200,5,7,34,250,7,30,17,34,37,51,166,265,3,1053,58,0,0
74,3802,1457,730,1242,11,6,188,1468,10,292,166,329,302,495,2424,4078,5,22973,1276,1,0
162,5067,1660,832,1314,41,38,274,1701,20,312,209,395,332,604,2671,5058,12,64042,3557,1,1
162,5067,1057,646,719,113,100,145,1170,18,215,134,248,233,382,1740,3004,10,31186,1732,1,1
147,4008,1660,832,1314,41,38,274,1701,20,312,209,395,332,604,2671,5058,12,64042,3557,1,1
162,5067,1660,832,1314,41,38,274,1701,20,312,209,395,332,604,2671,5058,12,64042,3557,1,0
162,5067,1057,646,719,113,100,145,1170,18,215,134,248,233,382,1740,3004,10,31186,1732,1,0
147,4008,1660,832,1314,41,38,274,1701,20,312,209,395,332,604,2671,5058,12,64042,3557,1,0
178,4170,77,34,69,0,0,8,77,3,24,16,29,27,45,114,213,1,387,21,0,0
178,4170,712,438,573,51,9,84,763,14,102,71,128,116,199,733,1364,8,11988,666,0,0
222,4979,722,423,573,19,0,135,741,12,172,101,199,184,300,1320,2257,6,15668,870,0,0
222,4979,1508,847,911,44,250,301,1552,14,148,88,169,162,257,1120,1886,7,15077,837,0,0
38,2269,652,304,544,16,6,88,668,6,89,51,101,95,152,591,998,3,3399,188,0,0
36,1940,384,251,317,7,8,52,391,11,70,44,84,81,128,467,811,6,5355,297,0,0
335,7116,72,33,56,0,4,12,72,1,1,1,1,2,2,0,2,0,1,0,0,1
335,7116,1454,835,1044,76,110,219,1530,17,275,158,296,292,454,2297,3718,9,34017,1889,1,1
47,2495,520,294,400,33,13,81,553,10,261,204,367,271,571,2128,4614,7,32445,1802,1,1
335,7116,72,33,56,0,4,12,72,1,1,1,1,2,2,0,2,0,1,0,0,0
335,7116,1454,835,1044,76,110,219,1530,17,275,158,296,292,454,2297,3718,9,34017,1889,1,0
47,2495,520,294,400,33,13,81,553,10,261,204,367,271,571,2128,4614,7,32445,1802,1,0
179,4222,77,34,69,0,0,8,77,3,24,16,29,27,45,114,213,1,387,21,0,1
179,4222,712,438,573,51,9,84,763,14,102,71,128,116,199,733,1364,8,11988,666,0,1
228,5105,4293,999,3693,19,54,507,4312,9,155,88,170,164,258,1156,1898,4,9368,520,0,1
228,5105,1482,859,1002,125,135,219,1607,16,219,134,251,235,385,1766,3032,9,27804,1544,1,1
149,6801,139,89,101,2,0,35,141,7,54,34,62,61,96,330,569,4,2287,127,0,1
149,6801,7,5,5,0,0,2,7,1,2,1,2,3,3,2,4,0,2,0,0,1
45,853,207,111,150,11,0,50,218,5,26,19,36,31,55,133,272,3,943,52,0,1
45,853,410,198,237,31,55,97,441,11,63,38,72,74,110,414,683,6,4293,238,0,1
3,34,207,111,150,11,0,50,218,5,26,19,36,31,55,133,272,3,943,52,0,1
5,123,207,111,150,11,0,50,218,5,26,19,36,31,55,133,272,3,943,52,0,1
47,867,207,111,150,11,0,50,218,5,26,19,36,31,55,133,272,3,943,52,0,1
47,867,410,198,237,31,55,97,441,11,63,38,72,74,110,414,683,6,4293,238,0,1
5,138,207,111,150,11,0,50,218,5,26,19,36,31,55,133,272,3,943,52,0,1
14,476,42,7,35,4,0,5,46,1,2,1,2,3,3,2,4,0,2,0,0,1
14,476,11,6,10,0,0,1,11,2,4,2,4,6,6,10,15,1,15,0,0,1
228,5110,4293,999,3693,19,54,507,4312,9,155,88,170,164,258,1156,1898,4,9368,520,0,1
228,5110,1482,859,1002,125,135,219,1607,16,219,134,251,235,385,1766,3032,9,27804,1544,1,1
42,969,386,256,301,16,9,68,402,4,59,35,69,63,104,355,621,2,1453,80,0,1
42,969,264,131,164,11,41,46,275,6,38,22,40,44,62,214,338,3,1068,59,0,1
30,1334,386,256,301,16,9,68,402,4,59,35,69,63,104,355,621,2,1453,80,0,1
42,969,386,256,301,16,9,68,402,4,59,35,69,63,104,355,621,2,1453,80,0,0
42,969,264,131,164,11,41,46,275,6,38,22,40,44,62,214,338,3,1068,59,0,0
30,1334,386,256,301,16,9,68,402,4,59,35,69,63,104,355,621,2,1453,80,0,0
344,6953,1457,730,1242,11,6,188,1468,10,292,166,329,302,495,2424,4078,5,22973,1276,1,0
344,6953,74,35,59,1,0,14,75,3,14,7,14,17,21,58,85,1,128,7,0,0
344,6953,245,125,200,5,7,34,250,7,30,17,34,37,51,166,265,3,1053,58,0,0
75,3862,1457,730,1242,11,6,188,1468,10,292,166,329,302,495,2424,4078,5,22973,1276,1,0
61,2763,1455,414,1257,16,76,112,1471,5,41,23,46,46,69,231,381,2,1069,59,0,0
44,859,207,111,150,11,0,50,218,5,26,19,36,31,55,133,272,3,943,52,0,0
44,859,410,198,237,31,55,97,441,11,63,38,72,74,110,414,683,6,4293,238,0,0
61,2747,1455,414,1257,16,76,112,1471,5,41,23,46,46,69,231,381,2,1069,59,0,0
14,476,42,7,35,4,0,5,46,1,2,1,2,3,3,2,4,0,2,0,0,0
14,476,11,6,10,0,0,1,11,2,4,2,4,6,6,10,15,1,15,0,0,0
47,867,207,111,150,11,0,50,218,5,26,19,36,31,55,133,272,3,943,52,0,0
47,867,410,198,237,31,55,97,441,11,63,38,72,74,110,414,683,6,4293,238,0,0
5,138,207,111,150,11,0,50,218,5,26,19,36,31,55,133,272,3,943,52,0,0
47,889,207,111,150,11,0,50,218,5,26,19,36,31,55,133,272,3,943,52,0,0
47,889,410,198,237,31,55,97,441,11,63,38,72,74,110,414,683,6,4293,238,0,0
47,896,207,111,150,11,0,50,218,5,26,19,36,31,55,133,272,3,943,52,0,0
47,896,410,198,237,31,55,97,441,11,63,38,72,74,110,414,683,6,4293,238,0,0
72,2129,1523,757,1297,19,12,193,1542,12,193,117,230,205,347,1508,2664,7,19053,1058,0,0
72,2129,701,378,504,33,58,109,734,13,110,68,126,123,194,794,1346,7,10027,557,0,0
177,4149,77,34,69,0,0,8,77,3,24,16,29,27,45,114,213,1,387,21,0,0
177,4149,712,438,573,51,9,84,763,14,102,71,128,116,199,733,1364,8,11988,666,0,0
223,5018,722,423,573,19,0,135,741,12,172,101,199,184,300,1320,2257,6,15668,870,0,0
223,5018,1508,847,911,44,250,301,1552,14,148,88,169,162,257,1120,1886,7,15077,837,0,0
335,7111,72,33,56,0,4,12,72,1,1,1,1,2,2,0,2,0,1,0,0,0
335,7111,1454,835,1044,76,110,219,1530,17,275,158,296,292,454,2297,3718,9,34017,1889,1,0
41,940,386,256,301,16,9,68,402,4,59,35,69,63,104,355,621,2,1453,80,0,0
41,940,264,131,164,11,41,46,275,6,38,22,40,44,62,214,338,3,1068,59,0,0
62,2852,1455,414,1257,16,76,112,1471,5,41,23,46,46,69,231,381,2,1069,59,0,0
82,4147,1523,757,1297,19,12,193,1542,12,193,117,230,205,347,1508,2664,7,19053,1058,0,0
30,1362,386,256,301,16,9,68,402,4,59,35,69,63,104,355,621,2,1453,80,0,0
1,300,382,65,130,157,2,92,539,4,10,5,10,14,15,41,57,2,114,6,0,1
335,7133,72,33,56,0,4,12,72,1,1,1,1,2,2,0,2,0,1,0,0,1
335,7133,1454,835,1044,76,110,219,1530,17,275,158,296,292,454,2297,3718,9,34017,1889,1,1
108,5395,1782,648,1425,9,47,279,1791,8,171,97,189,179,286,1292,2140,4,9462,525,0,1
335,7133,72,33,56,0,4,12,72,1,1,1,1,2,2,0,2,0,1,0,0,0
335,7133,1454,835,1044,76,110,219,1530,17,275,158,296,292,454,2297,3718,9,34017,1889,1,0
108,5395,1782,648,1425,9,47,279,1791,8,171,97,189,179,286,1292,2140,4,9462,525,0,0
42,947,386,256,301,16,9,68,402,4,59,35,69,63,104,355,621,2,1453,80,0,1
42,947,264,131,164,11,41,46,275,6,38,22,40,44,62,214,338,3,1068,59,0,1
31,1425,386,256,301,16,9,68,402,4,59,35,69,63,104,355,621,2,1453,80,0,1
31,1500,386,256,301,16,9,68,402,4,59,35,69,63,104,355,621,2,1453,80,0,1
31,1500,386,256,301,16,9,68,402,4,59,35,69,63,104,355,621,2,1453,80,0,0
41,943,386,256,301,16,9,68,402,4,59,35,69,63,104,355,621,2,1453,80,0,0
41,943,264,131,164,11,41,46,275,6,38,22,40,44,62,214,338,3,1068,59,0,0
46,945,447,308,343,6,5,95,453,7,96,59,111,103,170,651,1136,4,4600,255,0,0
46,945,322,174,179,16,74,51,338,10,41,26,46,51,72,252,408,5,2291,127,0,0
37,1604,447,308,343,6,5,95,453,7,96,59,111,103,170,651,1136,4,4600,255,0,0
9,223,19,8,11,5,0,4,24,2,5,3,6,7,9,13,25,1,30,1,0,1
9,223,102,59,69,5,3,24,107,6,22,15,28,28,43,113,206,3,789,43,0,1
9,223,106,40,36,3,49,17,109,8,17,13,23,25,36,93,167,5,904,50,0,1
28,548,2,2,2,0,0,0,2,0,0,0,0,0,0,0,0,0,0,0,0,1
28,548,99,48,90,1,3,5,100,0,0,0,0,0,0,0,0,0,0,0,0,1
28,548,8,5,5,2,0,1,10,0,0,0,0,0,0,0,0,0,0,0,0,1
28,548,1217,716,841,84,126,174,1301,14,185,118,215,199,333,1446,2542,8,20687,1149,0,1
28,548,160,89,115,0,13,31,160,7,15,11,17,22,28,78,124,3,495,27,0,1
28,548,10,10,9,9,0,0,19,0,0,0,0,0,0,0,0,0,0,0,0,1
28,548,173,84,99,8,29,36,181,5,12,7,13,17,20,54,81,2,221,12,0,1
28,548,3,1,1,3,0,0,6,0,0,0,0,0,0,0,0,0,0,0,0,1
60,1254,996,429,845,24,10,117,1020,7,76,50,88,83,138,494,879,4,3565,198,0,1
60,1254,456,277,329,12,42,72,468,13,85,50,97,98,147,592,972,7,7212,400,0,1
119,2420,1513,682,1277,25,13,200,1538,11,199,116,219,210,335,1557,2584,6,15641,868,0,1
119,2420,819,519,539,24,98,155,843,15,96,57,106,111,163,690,1107,8,9171,509,0,1
344,6968,1457,730,1242,11,6,188,1468,10,292,166,329,302,495,2424,4078,5,22973,1276,1,1
344,6968,74,35,59,1,0,14,75,3,14,7,14,17,21,58,85,1,128,7,0,1
344,6968,245,125,200,5,7,34,250,7,30,17,34,37,51,166,265,3,1053,58,0,1
22,679,339,213,244,17,9,65,356,10,42,26,48,52,74,259,421,5,2410,133,0,1
228,5119,4293,999,3693,19,54,507,4312,9,155,88,170,164,258,1156,1898,4,9368,520,0,1
228,5119,1482,859,1002,125,135,219,1607,16,219,134,251,235,385,1766,3032,9,27804,1544,1,1
177,4152,77,34,69,0,0,8,77,3,24,16,29,27,45,114,213,1,387,21,0,1
177,4152,712,438,573,51,9,84,763,14,102,71,128,116,199,733,1364,8,11988,666,0,1
69,1359,1020,354,843,12,15,144,1032,8,134,77,144,142,221,970,1580,4,6792,377,0,1
46,955,447,308,343,6,5,95,453,7,96,59,111,103,170,651,1136,4,4600,255,0,1
46,955,322,174,179,16,74,51,338,10,41,26,46,51,72,252,408,5,2291,127,0,1
223,5051,722,423,573,19,0,135,741,12,172,101,199,184,300,1320,2257,6,15668,870,0,1
223,5051,1508,847,911,44,250,301,1552,14,148,88,169,162,257,1120,1886,7,15077,837,0,1
128,2818,1043,504,840,53,9,147,1096,9,180,112,198,189,310,1377,2344,4,11604,644,0,1
128,2818,383,288,292,26,6,62,409,11,65,38,67,76,105,429,656,5,3719,206,0,1
103,1959,1178,367,1042,6,15,115,1184,9,94,51,95,103,146,644,976,4,4439,246,0,1
103,1959,177,108,140,8,0,27,185,6,30,16,32,36,48,162,248,3,794,44,0,1
184,3747,1943,715,1694,26,18,214,1969,12,185,120,237,197,357,1436,2721,7,20915,1161,0,1
184,3747,1168,838,957,57,25,144,1225,19,348,224,416,367,640,3018,5452,11,61921,3440,1,1
16,471,442,244,305,14,16,103,456,11,68,45,75,79,120,452,756,6,4588,254,0,1
16,471,182,102,99,11,40,35,193,3,11,6,11,14,17,42,64,1,97,5,0,1
9,223,19,8,11,5,0,4,24,2,5,3,6,7,9,13,25,1,30,1,0,0
9,223,102,59,69,5,3,24,107,6,22,15,28,28,43,113,206,3,789,43,0,0
9,223,106,40,36,3,49,17,109,8,17,13,23,25,36,93,167,5,904,50,0,0
28,548,2,2,2,0,0,0,2,0,0,0,0,0,0,0,0,0,0,0,0,0
28,548,99,48,90,1,3,5,100,0,0,0,0,0,0,0,0,0,0,0,0,0
28,548,8,5,5,2,0,1,10,0,0,0,0,0,0,0,0,0,0,0,0,0
28,548,1217,716,841,84,126,174,1301,14,185,118,215,199,333,1446,2542,8,20687,1149,0,0
28,548,160,89,115,0,13,31,160,7,15,11,17,22,28,78,124,3,495,27,0,0
28,548,10,10,9,9,0,0,19,0,0,0,0,0,0,0,0,0,0,0,0,0
28,548,173,84,99,8,29,36,181,5,12,7,13,17,20,54,81,2,221,12,0,0
28,548,3,1,1,3,0,0,6,0,0,0,0,0,0,0,0,0,0,0,0,0
60,1254,996,429,845,24,10,117,1020,7,76,50,88,83,138,494,879,4,3565,198,0,0
60,1254,456,277,329,12,42,72,468,13,85,50,97,98,147,592,972,7,7212,400,0,0
119,2420,1513,682,1277,25,13,200,1538,11,199,116,219,210,335,1557,2584,6,15641,868,0,0
119,2420,819,519,539,24,98,155,843,15,96,57,106,111,163,690,1107,8,9171,509,0,0
344,6968,1457,730,1242,11,6,188,1468,10,292,166,329,302,495,2424,4078,5,22973,1276,1,0
344,6968,74,35,59,1,0,14,75,3,14,7,14,17,21,58,85,1,128,7,0,0
344,6968,245,125,200,5,7,34,250,7,30,17,34,37,51,166,265,3,1053,58,0,0
22,679,339,213,244,17,9,65,356,10,42,26,48,52,74,259,421,5,2410,133,0,0
228,5119,4293,999,3693,19,54,507,4312,9,155,88,170,164,258,1156,1898,4,9368,520,0,0
228,5119,1482,859,1002,125,135,219,1607,16,219,134,251,235,385,1766,3032,9,27804,1544,1,0
177,4152,77,34,69,0,0,8,77,3,24,16,29,27,45,114,213,1,387,21,0,0
177,4152,712,438,573,51,9,84,763,14,102,71,128,116,199,733,1364,8,11988,666,0,0
69,1359,1020,354,843,12,15,144,1032,8,134,77,144,142,221,970,1580,4,6792,377,0,0
46,955,447,308,343,6,5,95,453,7,96,59,111,103,170,651,1136,4,4600,255,0,0
46,955,322,174,179,16,74,51,338,10,41,26,46,51,72,252,408,5,2291,127,0,0
223,5051,722,423,573,19,0,135,741,12,172,101,199,184,300,1320,2257,6,15668,870,0,0
223,5051,1508,847,911,44,250,301,1552,14,148,88,169,162,257,1120,1886,7,15077,837,0,0
128,2818,1043,504,840,53,9,147,1096,9,180,112,198,189,310,1377,2344,4,11604,644,0,0
128,2818,383,288,292,26,6,62,409,11,65,38,67,76,105,429,656,5,3719,206,0,0
103,1959,1178,367,1042,6,15,115,1184,9,94,51,95,103,146,644,976,4,4439,246,0,0
103,1959,177,108,140,8,0,27,185,6,30,16,32,36,48,162,248,3,794,44,0,0
184,3747,1943,715,1694,26,18,214,1969,12,185,120,237,197,357,1436,2721,7,20915,1161,0,0
184,3747,1168,838,957,57,25,144,1225,19,348,224,416,367,640,3018,5452,11,61921,3440,1,0
16,471,442,244,305,14,16,103,456,11,68,45,75,79,120,452,756,6,4588,254,0,0
16,471,182,102,99,11,40,35,193,3,11,6,11,14,17,42,64,1,97,5,0,0
222,4984,722,423,573,19,0,135,741,12,172,101,199,184,300,1320,2257,6,15668,870,0,1
222,4984,1508,847,911,44,250,301,1552,14,148,88,169,162,257,1120,1886,7,15077,837,0,1
15,621,722,423,573,19,0,135,741,12,172,101,199,184,300,1320,2257,6,15668,870,0,1
345,6966,1457,730,1242,11,6,188,1468,10,292,166,329,302,495,2424,4078,5,22973,1276,1,1
345,6966,74,35,59,1,0,14,75,3,14,7,14,17,21,58,85,1,128,7,0,1
345,6966,245,125,200,5,7,34,250,7,30,17,34,37,51,166,265,3,1053,58,0,1
148,4073,1660,832,1314,41,38,274,1701,20,312,209,395,332,604,2671,5058,12,64042,3557,1,1
346,6990,1457,730,1242,11,6,188,1468,10,292,166,329,302,495,2424,4078,5,22973,1276,1,0
346,6990,74,35,59,1,0,14,75,3,14,7,14,17,21,58,85,1,128,7,0,0
346,6990,245,125,200,5,7,34,250,7,30,17,34,37,51,166,265,3,1053,58,0,0
76,3974,1457,730,1242,11,6,188,1468,10,292,166,329,302,495,2424,4078,5,22973,1276,1,0
148,4073,1660,832,1314,41,38,274,1701,20,312,209,395,332,604,2671,5058,12,64042,3557,1,0
48,934,207,111,150,11,0,50,218,5,26,19,36,31,55,133,272,3,943,52,0,1
48,934,410,198,237,31,55,97,441,11,63,38,72,74,110,414,683,6,4293,238,0,1
10,228,207,111,150,11,0,50,218,5,26,19,36,31,55,133,272,3,943,52,0,1
48,948,207,111,150,11,0,50,218,5,26,19,36,31,55,133,272,3,943,52,0,0
48,948,410,198,237,31,55,97,441,11,63,38,72,74,110,414,683,6,4293,238,0,0
222,4983,722,423,573,19,0,135,741,12,172,101,199,184,300,1320,2257,6,15668,870,0,0
222,4983,1508,847,911,44,250,301,1552,14,148,88,169,162,257,1120,1886,7,15077,837,0,0
93,3417,1450,624,1228,12,26,181,1462,14,306,186,354,320,540,2580,4493,8,36391,2021,1,0
10,228,207,111,150,11,0,50,218,5,26,19,36,31,55,133,272,3,943,52,0,0
222,4984,722,423,573,19,0,135,741,12,172,101,199,184,300,1320,2257,6,15668,870,0,0
222,4984,1508,847,911,44,250,301,1552,14,148,88,169,162,257,1120,1886,7,15077,837,0,0
15,621,722,423,573,19,0,135,741,12,172,101,199,184,300,1320,2257,6,15668,870,0,0
179,4178,77,34,69,0,0,8,77,3,24,16,29,27,45,114,213,1,387,21,0,0
179,4178,712,438,573,51,9,84,763,14,102,71,128,116,199,733,1364,8,11988,666,0,0
222,4988,722,423,573,19,0,135,741,12,172,101,199,184,300,1320,2257,6,15668,870,0,0
222,4988,1508,847,911,44,250,301,1552,14,148,88,169,162,257,1120,1886,7,15077,837,0,0
179,4176,77,34,69,0,0,8,77,3,24,16,29,27,45,114,213,1,387,21,0,0
179,4176,712,438,573,51,9,84,763,14,102,71,128,116,199,733,1364,8,11988,666,0,0
49,577,647,139,84,35,284,233,682,0,0,0,0,0,0,0,0,0,0,0,0,0
335,7141,72,33,56,0,4,12,72,1,1,1,1,2,2,0,2,0,1,0,0,0
335,7141,1454,835,1044,76,110,219,1530,17,275,158,296,292,454,2297,3718,9,34017,1889,1,0
109,5438,1782,648,1425,9,47,279,1791,8,171,97,189,179,286,1292,2140,4,9462,525,0,0
49,575,647,139,84,35,284,233,682,0,0,0,0,0,0,0,0,0,0,0,0,0
14,472,42,7,35,4,0,5,46,1,2,1,2,3,3,2,4,0,2,0,0,0
14,472,11,6,10,0,0,1,11,2,4,2,4,6,6,10,15,1,15,0,0,0
346,7005,1457,730,1242,11,6,188,1468,10,292,166,329,302,495,2424,4078,5,22973,1276,1,0
346,7005,74,35,59,1,0,14,75,3,14,7,14,17,21,58,85,1,128,7,0,0
346,7005,245,125,200,5,7,34,250,7,30,17,34,37,51,166,265,3,1053,58,0,0
178,4158,77,34,69,0,0,8,77,3,24,16,29,27,45,114,213,1,387,21,0,0
178,4158,712,438,573,51,9,84,763,14,102,71,128,116,199,733,1364,8,11988,666,0,0
46,951,447,308,343,6,5,95,453,7,96,59,111,103,170,651,1136,4,4600,255,0,0
46,951,322,174,179,16,74,51,338,10,41,26,46,51,72,252,408,5,2291,127,0,0
223,5060,722,423,573,19,0,135,741,12,172,101,199,184,300,1320,2257,6,15668,870,0,0
223,5060,1508,847,911,44,250,301,1552,14,148,88,169,162,257,1120,1886,7,15077,837,0,0
107,4012,1450,624,1228,12,26,181,1462,14,306,186,354,320,540,2580,4493,8,36391,2021,1,0
59,1216,1098,241,925,5,10,155,1103,7,46,25,49,53,74,273,423,3,1580,87,0,1
59,1216,282,202,222,14,2,44,296,8,42,24,43,50,67,250,378,4,1548,86,0,1
31,1477,1293,570,1093,25,15,163,1318,10,195,123,241,205,364,1516,2795,6,17273,959,0,1
59,1216,1098,241,925,5,10,155,1103,7,46,25,49,53,74,273,423,3,1580,87,0,0
59,1216,282,202,222,14,2,44,296,8,42,24,43,50,67,250,378,4,1548,86,0,0
62,1244,1098,241,925,5,10,155,1103,7,46,25,49,53,74,273,423,3,1580,87,0,1
62,1244,282,202,222,14,2,44,296,8,42,24,43,50,67,250,378,4,1548,86,0,1
31,1478,1293,570,1093,25,15,163,1318,10,195,123,241,205,364,1516,2795,6,17273,959,0,1
337,7189,72,33,56,0,4,12,72,1,1,1,1,2,2,0,2,0,1,0,0,0
337,7189,1454,835,1044,76,110,219,1530,17,275,158,296,292,454,2297,3718,9,34017,1889,1,0
20,535,256,139,192,9,7,47,265,4,23,12,24,27,36,112,171,2,357,19,0,0
31,1490,386,256,301,16,9,68,402,4,59,35,69,63,104,355,621,2,1453,80,0,0
71,2977,1178,367,1042,6,15,115,1184,9,94,51,95,103,146,644,976,4,4439,246,0,0
104,1979,1178,367,1042,6,15,115,1184,9,94,51,95,103,146,644,976,4,4439,246,0,0
104,1979,177,108,140,8,0,27,185,6,30,16,32,36,48,162,248,3,794,44,0,0
227,5097,4293,999,3693,19,54,507,4312,9,155,88,170,164,258,1156,1898,4,9368,520,0,0
227,5097,1482,859,1002,125,135,219,1607,16,219,134,251,235,385,1766,3032,9,27804,1544,1,0
227,5099,4293,999,3693,19,54,507,4312,9,155,88,170,164,258,1156,1898,4,9368,520,0,0
227,5099,1482,859,1002,125,135,219,1607,16,219,134,251,235,385,1766,3032,9,27804,1544,1,0
94,4250,1338,495,1086,10,64,173,1348,11,122,82,157,133,239,883,1686,7,11934,663,0,0
62,1244,1098,241,925,5,10,155,1103,7,46,25,49,53,74,273,423,3,1580,87,0,0
62,1244,282,202,222,14,2,44,296,8,42,24,43,50,67,250,378,4,1548,86,0,0
31,1478,1293,570,1093,25,15,163,1318,10,195,123,241,205,364,1516,2795,6,17273,959,0,0
346,6994,1457,730,1242,11,6,188,1468,10,292,166,329,302,495,2424,4078,5,22973,1276,1,1
346,6994,74,35,59,1,0,14,75,3,14,7,14,17,21,58,85,1,128,7,0,1
346,6994,245,125,200,5,7,34,250,7,30,17,34,37,51,166,265,3,1053,58,0,1
78,4037,1457,730,1242,11,6,188,1468,10,292,166,329,302,495,2424,4078,5,22973,1276,1,1
163,5074,1660,832,1314,41,38,274,1701,20,312,209,395,332,604,2671,5058,12,64042,3557,1,0
163,5074,1057,646,719,113,100,145,1170,18,215,134,248,233,382,1740,3004,10,31186,1732,1,0
178,4160,77,34,69,0,0,8,77,3,24,16,29,27,45,114,213,1,387,21,0,1
178,4160,712,438,573,51,9,84,763,14,102,71,128,116,199,733,1364,8,11988,666,0,1
222,4989,722,423,573,19,0,135,741,12,172,101,199,184,300,1320,2257,6,15668,870,0,0
222,4989,1508,847,911,44,250,301,1552,14,148,88,169,162,257,1120,1886,7,15077,837,0,0
16,469,442,244,305,14,16,103,456,11,68,45,75,79,120,452,756,6,4588,254,0,0
16,469,182,102,99,11,40,35,193,3,11,6,11,14,17,42,64,1,97,5,0,0
49,573,647,139,84,35,284,233,682,0,0,0,0,0,0,0,0,0,0,0,0,1
179,4176,77,34,69,0,0,8,77,3,24,16,29,27,45,114,213,1,387,21,0,1
179,4176,712,438,573,51,9,84,763,14,102,71,128,116,199,733,1364,8,11988,666,0,1
222,4988,722,423,573,19,0,135,741,12,172,101,199,184,300,1320,2257,6,15668,870,0,1
222,4988,1508,847,911,44,250,301,1552,14,148,88,169,162,257,1120,1886,7,15077,837,0,1
93,3417,1450,624,1228,12,26,181,1462,14,306,186,354,320,540,2580,4493,8,36391,2021,1,1
178,4160,77,34,69,0,0,8,77,3,24,16,29,27,45,114,213,1,387,21,0,0
178,4160,712,438,573,51,9,84,763,14,102,71,128,116,199,733,1364,8,11988,666,0,0
346,6994,1457,730,1242,11,6,188,1468,10,292,166,329,302,495,2424,4078,5,22973,1276,1,0
346,6994,74,35,59,1,0,14,75,3,14,7,14,17,21,58,85,1,128,7,0,0
346,6994,245,125,200,5,7,34,250,7,30,17,34,37,51,166,265,3,1053,58,0,0
78,4037,1457,730,1242,11,6,188,1468,10,292,166,329,302,495,2424,4078,5,22973,1276,1,0
60,1092,282,196,195,3,0,86,285,8,130,71,141,138,212,936,1507,4,6538,363,0,1
7,114,44,19,17,0,16,11,44,3,14,7,14,17,21,58,85,1,128,7,0,1
7,301,72,33,56,0,4,12,72,1,1,1,1,2,2,0,2,0,1,0,0,1
3,26,14,7,7,2,0,5,16,0,0,0,0,0,0,0,0,0,0,0,0,1
78,3306,1289,550,1043,56,32,155,1345,10,167,93,185,177,278,1266,2075,5,11498,638,0,1
34,989,182,127,129,0,0,53,182,5,39,21,42,44,63,217,343,2,926,51,0,1
137,6592,1392,870,1177,35,17,170,1427,14,494,280,531,508,811,4473,7289,7,54850,3047,2,1
91,3003,773,419,590,28,0,166,801,10,204,113,217,214,330,1598,2554,5,13587,754,0,1
7,255,75,38,59,1,3,12,76,2,4,2,4,6,6,10,15,1,15,0,0,1
47,2498,520,294,400,33,13,81,553,10,261,204,367,271,571,2128,4614,7,32445,1802,1,1
93,4253,1338,495,1086,10,64,173,1348,11,122,82,157,133,239,883,1686,7,11934,663,0,1
147,6760,139,89,101,2,0,35,141,7,54,34,62,61,96,330,569,4,2287,127,0,1
147,6760,7,5,5,0,0,2,7,1,2,1,2,3,3,2,4,0,2,0,0,1
32,948,465,148,393,5,8,60,470,4,31,20,31,35,51,161,261,2,523,29,0,1
32,948,16,12,9,0,0,6,16,1,2,1,2,3,3,2,4,0,2,0,0,1
109,5462,1782,648,1425,9,47,279,1791,8,171,97,189,179,286,1292,2140,4,9462,525,0,1
20,541,256,139,192,9,7,47,265,4,23,12,24,27,36,112,171,2,357,19,0,1
23,597,102,59,69,5,3,24,107,6,22,15,28,28,43,113,206,3,789,43,0,1
107,4030,1450,624,1228,12,26,181,1462,14,306,186,354,320,540,2580,4493,8,36391,2021,1,1
148,4080,1660,832,1314,41,38,274,1701,20,312,209,395,332,604,2671,5058,12,64042,3557,1,1
116,4587,1513,682,1277,25,13,200,1538,11,199,116,219,210,335,1557,2584,6,15641,868,0,1
59,3302,1296,573,1062,40,33,157,1336,8,201,118,231,209,349,1561,2689,4,12365,686,0,1
76,4022,1457,730,1242,11,6,188,1468,10,292,166,329,302,495,2424,4078,5,22973,1276,1,1
38,2278,652,304,544,16,6,88,668,6,89,51,101,95,152,591,998,3,3399,188,0,1
62,2870,1455,414,1257,16,76,112,1471,5,41,23,46,46,69,231,381,2,1069,59,0,1
82,4156,1523,757,1297,19,12,193,1542,12,193,117,230,205,347,1508,2664,7,19053,1058,0,1
66,2759,1020,354,843,12,15,144,1032,8,134,77,144,142,221,970,1580,4,6792,377,0,1
37,1616,447,308,343,6,5,95,453,7,96,59,111,103,170,651,1136,4,4600,255,0,1
21,653,424,94,331,4,0,89,428,1,5,5,5,6,10,11,25,0,12,0,0,1
40,2355,334,251,279,10,4,40,344,5,127,74,143,132,217,899,1528,2,4303,239,0,1
12,484,184,100,137,2,15,30,186,6,38,20,39,44,59,214,322,3,991,55,0,1
34,1565,1293,570,1093,25,15,163,1318,10,195,123,241,205,364,1516,2795,6,17273,959,0,1
36,1970,384,251,317,7,8,52,391,11,70,44,84,81,128,467,811,6,5355,297,0,1
15,630,722,423,573,19,0,135,741,12,172,101,199,184,300,1320,2257,6,15668,870,0,1
16,1201,215,129,180,6,0,29,221,8,65,43,72,73,115,415,711,4,3153,175,0,1
69,2852,1043,504,840,53,9,147,1096,9,180,112,198,189,310,1377,2344,4,11604,644,0,1
25,1019,373,158,315,8,0,51,381,5,76,44,79,81,123,486,779,2,2026,112,0,1
68,2947,1178,367,1042,6,15,115,1184,9,94,51,95,103,146,644,976,4,4439,246,0,1
72,3682,1943,715,1694,26,18,214,1969,12,185,120,237,197,357,1436,2721,7,20915,1161,0,1
14,817,442,244,305,14,16,103,456,11,68,45,75,79,120,452,756,6,4588,254,0,1
48,1776,1098,241,925,5,10,155,1103,7,46,25,49,53,74,273,423,3,1580,87,0,1
60,1092,282,196,195,3,0,86,285,8,130,71,141,138,212,936,1507,4,6538,363,0,0
7,114,44,19,17,0,16,11,44,3,14,7,14,17,21,58,85,1,128,7,0,0
3,66,127,75,83,2,11,30,129,4,14,7,14,18,21,61,87,2,175,9,0,0
3,66,652,304,544,16,6,88,668,6,89,51,101,95,152,591,998,3,3399,188,0,0
3,66,2,2,2,0,0,0,2,0,0,0,0,0,0,0,0,0,0,0,0,0
3,66,8,5,5,0,0,3,8,0,0,0,0,0,0,0,0,0,0,0,0,0
3,66,14,8,8,0,0,6,14,0,0,0,0,0,0,0,0,0,0,0,0,0
3,66,6,4,4,0,0,2,6,0,0,0,0,0,0,0,0,0,0,0,0,0
3,66,6,4,4,0,0,2,6,1,2,1,2,3,3,2,4,0,2,0,0,0
3,66,7,5,5,0,0,2,7,0,0,0,0,0,0,0,0,0,0,0,0,0
3,66,10,6,6,0,0,4,10,0,0,0,0,0,0,0,0,0,0,0,0,0
3,66,1,1,1,0,0,0,1,0,0,0,0,0,0,0,0,0,0,0,0,0
3,66,14,10,10,0,0,4,14,1,1,1,1,2,2,0,2,0,1,0,0,0
3,66,46,26,30,3,0,12,49,3,6,3,6,9,9,20,28,1,42,2,0,0
7,301,72,33,56,0,4,12,72,1,1,1,1,2,2,0,2,0,1,0,0,0
3,26,14,7,7,2,0,5,16,0,0,0,0,0,0,0,0,0,0,0,0,0
78,3306,1289,550,1043,56,32,155,1345,10,167,93,185,177,278,1266,2075,5,11498,638,0,0
34,989,182,127,129,0,0,53,182,5,39,21,42,44,63,217,343,2,926,51,0,0
137,6592,1392,870,1177,35,17,170,1427,14,494,280,531,508,811,4473,7289,7,54850,3047,2,0
91,3003,773,419,590,28,0,166,801,10,204,113,217,214,330,1598,2554,5,13587,754,0,0
7,255,75,38,59,1,3,12,76,2,4,2,4,6,6,10,15,1,15,0,0,0
47,2498,520,294,400,33,13,81,553,10,261,204,367,271,571,2128,4614,7,32445,1802,1,0
93,4253,1338,495,1086,10,64,173,1348,11,122,82,157,133,239,883,1686,7,11934,663,0,0
147,6760,139,89,101,2,0,35,141,7,54,34,62,61,96,330,569,4,2287,127,0,0
147,6760,7,5,5,0,0,2,7,1,2,1,2,3,3,2,4,0,2,0,0,0
32,948,465,148,393,5,8,60,470,4,31,20,31,35,51,161,261,2,523,29,0,0
32,948,16,12,9,0,0,6,16,1,2,1,2,3,3,2,4,0,2,0,0,0
109,5462,1782,648,1425,9,47,279,1791,8,171,97,189,179,286,1292,2140,4,9462,525,0,0
20,541,256,139,192,9,7,47,265,4,23,12,24,27,36,112,171,2,357,19,0,0
23,597,102,59,69,5,3,24,107,6,22,15,28,28,43,113,206,3,789,43,0,0
107,4030,1450,624,1228,12,26,181,1462,14,306,186,354,320,540,2580,4493,8,36391,2021,1,0
148,4080,1660,832,1314,41,38,274,1701,20,312,209,395,332,604,2671,5058,12,64042,3557,1,0
116,4587,1513,682,1277,25,13,200,1538,11,199,116,219,210,335,1557,2584,6,15641,868,0,0
59,3302,1296,573,1062,40,33,157,1336,8,201,118,231,209,349,1561,2689,4,12365,686,0,0
76,4022,1457,730,1242,11,6,188,1468,10,292,166,329,302,495,2424,4078,5,22973,1276,1,0
38,2278,652,304,544,16,6,88,668,6,89,51,101,95,152,591,998,3,3399,188,0,0
62,2870,1455,414,1257,16,76,112,1471,5,41,23,46,46,69,231,381,2,1069,59,0,0
82,4156,1523,757,1297,19,12,193,1542,12,193,117,230,205,347,1508,2664,7,19053,1058,0,0
66,2759,1020,354,843,12,15,144,1032,8,134,77,144,142,221,970,1580,4,6792,377,0,0
37,1616,447,308,343,6,5,95,453,7,96,59,111,103,170,651,1136,4,4600,255,0,0
21,653,424,94,331,4,0,89,428,1,5,5,5,6,10,11,25,0,12,0,0,0
40,2355,334,251,279,10,4,40,344,5,127,74,143,132,217,899,1528,2,4303,239,0,0
12,484,184,100,137,2,15,30,186,6,38,20,39,44,59,214,322,3,991,55,0,0
34,1565,1293,570,1093,25,15,163,1318,10,195,123,241,205,364,1516,2795,6,17273,959,0,0
36,1970,384,251,317,7,8,52,391,11,70,44,84,81,128,467,811,6,5355,297,0,0
15,630,722,423,573,19,0,135,741,12,172,101,199,184,300,1320,2257,6,15668,870,0,0
16,1201,215,129,180,6,0,29,221,8,65,43,72,73,115,415,711,4,3153,175,0,0
69,2852,1043,504,840,53,9,147,1096,9,180,112,198,189,310,1377,2344,4,11604,644,0,0
25,1019,373,158,315,8,0,51,381,5,76,44,79,81,123,486,779,2,2026,112,0,0
68,2947,1178,367,1042,6,15,115,1184,9,94,51,95,103,146,644,976,4,4439,246,0,0
72,3682,1943,715,1694,26,18,214,1969,12,185,120,237,197,357,1436,2721,7,20915,1161,0,0
14,817,442,244,305,14,16,103,456,11,68,45,75,79,120,452,756,6,4588,254,0,0
48,1776,1098,241,925,5,10,155,1103,7,46,25,49,53,74,273,423,3,1580,87,0,0
14,367,601,196,481,2,23,85,603,8,63,36,72,71,108,400,664,4,3036,168,0,1
14,367,156,79,106,5,16,28,161,5,14,8,15,19,23,64,97,2,261,14,0,1
71,2109,1523,757,1297,19,12,193,1542,12,193,117,230,205,347,1508,2664,7,19053,1058,0,0
71,2109,701,378,504,33,58,109,734,13,110,68,126,123,194,794,1346,7,10027,557,0,0
82,4086,1523,757,1297,19,12,193,1542,12,193,117,230,205,347,1508,2664,7,19053,1058,0,0
50,1024,207,111,150,11,0,50,218,5,26,19,36,31,55,133,272,3,943,52,0,1
50,1024,410,198,237,31,55,97,441,11,63,38,72,74,110,414,683,6,4293,238,0,1
117,4639,1513,682,1277,25,13,200,1538,11,199,116,219,210,335,1557,2584,6,15641,868,0,1
223,5077,722,423,573,19,0,135,741,12,172,101,199,184,300,1320,2257,6,15668,870,0,0
223,5077,1508,847,911,44,250,301,1552,14,148,88,169,162,257,1120,1886,7,15077,837,0,0
50,1024,207,111,150,11,0,50,218,5,26,19,36,31,55,133,272,3,943,52,0,0
50,1024,410,198,237,31,55,97,441,11,63,38,72,74,110,414,683,6,4293,238,0,0
117,4639,1513,682,1277,25,13,200,1538,11,199,116,219,210,335,1557,2584,6,15641,868,0,0
83,2325,1523,757,1297,19,12,193,1542,12,193,117,230,205,347,1508,2664,7,19053,1058,0,1
83,2325,701,378,504,33,58,109,734,13,110,68,126,123,194,794,1346,7,10027,557,0,1
86,4261,1523,757,1297,19,12,193,1542,12,193,117,230,205,347,1508,2664,7,19053,1058,0,1
83,2325,1523,757,1297,19,12,193,1542,12,193,117,230,205,347,1508,2664,7,19053,1058,0,0
83,2325,701,378,504,33,58,109,734,13,110,68,126,123,194,794,1346,7,10027,557,0,0
86,4261,1523,757,1297,19,12,193,1542,12,193,117,230,205,347,1508,2664,7,19053,1058,0,0
211,4515,182,127,129,0,0,53,182,5,39,21,42,44,63,217,343,2,926,51,0,1
211,4515,1165,710,800,67,119,181,1232,18,243,153,282,261,435,2000,3492,10,36473,2026,1,1
95,3480,1450,624,1228,12,26,181,1462,14,306,186,354,320,540,2580,4493,8,36391,2021,1,1
211,4515,182,127,129,0,0,53,182,5,39,21,42,44,63,217,343,2,926,51,0,0
211,4515,1165,710,800,67,119,181,1232,18,243,153,282,261,435,2000,3492,10,36473,2026,1,0
95,3480,1450,624,1228,12,26,181,1462,14,306,186,354,320,540,2580,4493,8,36391,2021,1,0
185,3749,1943,715,1694,26,18,214,1969,12,185,120,237,197,357,1436,2721,7,20915,1161,0,1
185,3749,1168,838,957,57,25,144,1225,19,348,224,416,367,640,3018,5452,11,61921,3440,1,1
13,319,601,196,481,2,23,85,603,8,63,36,72,71,108,400,664,4,3036,168,0,1
13,319,156,79,106,5,16,28,161,5,14,8,15,19,23,64,97,2,261,14,0,1
8,214,601,196,481,2,23,85,603,8,63,36,72,71,108,400,664,4,3036,168,0,1
16,383,601,196,481,2,23,85,603,8,63,36,72,71,108,400,664,4,3036,168,0,1
16,383,156,79,106,5,16,28,161,5,14,8,15,19,23,64,97,2,261,14,0,1
9,258,601,196,481,2,23,85,603,8,63,36,72,71,108,400,664,4,3036,168,0,1
185,3749,1943,715,1694,26,18,214,1969,12,185,120,237,197,357,1436,2721,7,20915,1161,0,0
185,3749,1168,838,957,57,25,144,1225,19,348,224,416,367,640,3018,5452,11,61921,3440,1,0
185,3775,1943,715,1694,26,18,214,1969,12,185,120,237,197,357,1436,2721,7,20915,1161,0,1
185,3775,1168,838,957,57,25,144,1225,19,348,224,416,367,640,3018,5452,11,61921,3440,1,1
16,377,601,196,481,2,23,85,603,8,63,36,72,71,108,400,664,4,3036,168,0,1
16,377,156,79,106,5,16,28,161,5,14,8,15,19,23,64,97,2,261,14,0,1
9,317,601,196,481,2,23,85,603,8,63,36,72,71,108,400,664,4,3036,168,0,1
184,3743,1943,715,1694,26,18,214,1969,12,185,120,237,197,357,1436,2721,7,20915,1161,0,0
184,3743,1168,838,957,57,25,144,1225,19,348,224,416,367,640,3018,5452,11,61921,3440,1,0
73,3706,1943,715,1694,26,18,214,1969,12,185,120,237,197,357,1436,2721,7,20915,1161,0,0
346,7009,1457,730,1242,11,6,188,1468,10,292,166,329,302,495,2424,4078,5,22973,1276,1,0
346,7009,74,35,59,1,0,14,75,3,14,7,14,17,21,58,85,1,128,7,0,0
346,7009,245,125,200,5,7,34,250,7,30,17,34,37,51,166,265,3,1053,58,0,0
227,5117,4293,999,3693,19,54,507,4312,9,155,88,170,164,258,1156,1898,4,9368,520,0,0
227,5117,1482,859,1002,125,135,219,1607,16,219,134,251,235,385,1766,3032,9,27804,1544,1,0
83,2321,1523,757,1297,19,12,193,1542,12,193,117,230,205,347,1508,2664,7,19053,1058,0,0
83,2321,701,378,504,33,58,109,734,13,110,68,126,123,194,794,1346,7,10027,557,0,0
223,5078,722,423,573,19,0,135,741,12,172,101,199,184,300,1320,2257,6,15668,870,0,0
223,5078,1508,847,911,44,250,301,1552,14,148,88,169,162,257,1120,1886,7,15077,837,0,0
337,7188,72,33,56,0,4,12,72,1,1,1,1,2,2,0,2,0,1,0,0,0
337,7188,1454,835,1044,76,110,219,1530,17,275,158,296,292,454,2297,3718,9,34017,1889,1,0
104,1969,1178,367,1042,6,15,115,1184,9,94,51,95,103,146,644,976,4,4439,246,0,0
104,1969,177,108,140,8,0,27,185,6,30,16,32,36,48,162,248,3,794,44,0,0
184,3749,1943,715,1694,26,18,214,1969,12,185,120,237,197,357,1436,2721,7,20915,1161,0,0
184,3749,1168,838,957,57,25,144,1225,19,348,224,416,367,640,3018,5452,11,61921,3440,1,0
16,472,442,244,305,14,16,103,456,11,68,45,75,79,120,452,756,6,4588,254,0,0
16,472,182,102,99,11,40,35,193,3,11,6,11,14,17,42,64,1,97,5,0,0
94,4280,1338,495,1086,10,64,173,1348,11,122,82,157,133,239,883,1686,7,11934,663,0,0
109,4093,1450,624,1228,12,26,181,1462,14,306,186,354,320,540,2580,4493,8,36391,2021,1,0
78,4085,1457,730,1242,11,6,188,1468,10,292,166,329,302,495,2424,4078,5,22973,1276,1,0
87,4323,1523,757,1297,19,12,193,1542,12,193,117,230,205,347,1508,2664,7,19053,1058,0,0
35,1615,1293,570,1093,25,15,163,1318,10,195,123,241,205,364,1516,2795,6,17273,959,0,0
71,2998,1178,367,1042,6,15,115,1184,9,94,51,95,103,146,644,976,4,4439,246,0,0
73,3730,1943,715,1694,26,18,214,1969,12,185,120,237,197,357,1436,2721,7,20915,1161,0,0
39,808,386,256,301,16,9,68,402,4,59,35,69,63,104,355,621,2,1453,80,0,1
39,808,264,131,164,11,41,46,275,6,38,22,40,44,62,214,338,3,1068,59,0,1
31,1462,386,256,301,16,9,68,402,4,59,35,69,63,104,355,621,2,1453,80,0,1
31,1431,386,256,301,16,9,68,402,4,59,35,69,63,104,355,621,2,1453,80,0,1
116,4567,1513,682,1277,25,13,200,1538,11,199,116,219,210,335,1557,2584,6,15641,868,0,0
39,808,386,256,301,16,9,68,402,4,59,35,69,63,104,355,621,2,1453,80,0,0
39,808,264,131,164,11,41,46,275,6,38,22,40,44,62,214,338,3,1068,59,0,0
31,1431,386,256,301,16,9,68,402,4,59,35,69,63,104,355,621,2,1453,80,0,0
82,4161,1523,757,1297,19,12,193,1542,12,193,117,230,205,347,1508,2664,7,19053,1058,0,1
185,3777,1943,715,1694,26,18,214,1969,12,185,120,237,197,357,1436,2721,7,20915,1161,0,0
185,3777,1168,838,957,57,25,144,1225,19,348,224,416,367,640,3018,5452,11,61921,3440,1,0
87,4328,1523,757,1297,19,12,193,1542,12,193,117,230,205,347,1508,2664,7,19053,1058,0,0
39,784,386,256,301,16,9,68,402,4,59,35,69,63,104,355,621,2,1453,80,0,0
39,784,264,131,164,11,41,46,275,6,38,22,40,44,62,214,338,3,1068,59,0,0
14,331,601,196,481,2,23,85,603,8,63,36,72,71,108,400,664,4,3036,168,0,0
14,331,156,79,106,5,16,28,161,5,14,8,15,19,23,64,97,2,261,14,0,0
346,7013,1457,730,1242,11,6,188,1468,10,292,166,329,302,495,2424,4078,5,22973,1276,1,1
346,7013,74,35,59,1,0,14,75,3,14,7,14,17,21,58,85,1,128,7,0,1
346,7013,245,125,200,5,7,34,250,7,30,17,34,37,51,166,265,3,1053,58,0,1
227,5121,4293,999,3693,19,54,507,4312,9,155,88,170,164,258,1156,1898,4,9368,520,0,1
227,5121,1482,859,1002,125,135,219,1607,16,219,134,251,235,385,1766,3032,9,27804,1544,1,1
191,3884,1943,715,1694,26,18,214,1969,12,185,120,237,197,357,1436,2721,7,20915,1161,0,1
191,3884,1168,838,957,57,25,144,1225,19,348,224,416,367,640,3018,5452,11,61921,3440,1,1
94,4283,1338,495,1086,10,64,173,1348,11,122,82,157,133,239,883,1686,7,11934,663,0,1
109,4098,1450,624,1228,12,26,181,1462,14,306,186,354,320,540,2580,4493,8,36391,2021,1,1
78,4085,1457,730,1242,11,6,188,1468,10,292,166,329,302,495,2424,4078,5,22973,1276,1,1
87,4328,1523,757,1297,19,12,193,1542,12,193,117,230,205,347,1508,2664,7,19053,1058,0,1
9,231,19,8,11,5,0,4,24,2,5,3,6,7,9,13,25,1,30,1,0,1
9,231,102,59,69,5,3,24,107,6,22,15,28,28,43,113,206,3,789,43,0,1
9,231,106,40,36,3,49,17,109,8,17,13,23,25,36,93,167,5,904,50,0,1
211,4523,182,127,129,0,0,53,182,5,39,21,42,44,63,217,343,2,926,51,0,1
211,4523,1165,710,800,67,119,181,1232,18,243,153,282,261,435,2000,3492,10,36473,2026,1,1
99,2081,773,419,590,28,0,166,801,10,204,113,217,214,330,1598,2554,5,13587,754,0,1
99,2081,421,273,302,44,34,57,465,17,81,59,107,98,166,583,1098,11,12329,684,0,1
28,556,2,2,2,0,0,0,2,0,0,0,0,0,0,0,0,0,0,0,0,1
28,556,99,48,90,1,3,5,100,0,0,0,0,0,0,0,0,0,0,0,0,1
28,556,8,5,5,2,0,1,10,0,0,0,0,0,0,0,0,0,0,0,0,1
28,556,1217,716,841,84,126,174,1301,14,185,118,215,199,333,1446,2542,8,20687,1149,0,1
28,556,160,89,115,0,13,31,160,7,15,11,17,22,28,78,124,3,495,27,0,1
28,556,10,10,9,9,0,0,19,0,0,0,0,0,0,0,0,0,0,0,0,1
28,556,173,84,99,8,29,36,181,5,12,7,13,17,20,54,81,2,221,12,0,1
28,556,3,1,1,3,0,0,6,0,0,0,0,0,0,0,0,0,0,0,0,1
163,5082,1660,832,1314,41,38,274,1701,20,312,209,395,332,604,2671,5058,12,64042,3557,1,1
163,5082,1057,646,719,113,100,145,1170,18,215,134,248,233,382,1740,3004,10,31186,1732,1,1
17,349,95,58,50,9,16,20,104,12,33,24,45,45,69,209,378,8,3100,172,0,1
60,1262,996,429,845,24,10,117,1020,7,76,50,88,83,138,494,879,4,3565,198,0,1
60,1262,456,277,329,12,42,72,468,13,85,50,97,98,147,592,972,7,7212,400,0,1
119,2424,1513,682,1277,25,13,200,1538,11,199,116,219,210,335,1557,2584,6,15641,868,0,1
119,2424,819,519,539,24,98,155,843,15,96,57,106,111,163,690,1107,8,9171,509,0,1
50,1032,207,111,150,11,0,50,218,5,26,19,36,31,55,133,272,3,943,52,0,1
50,1032,410,198,237,31,55,97,441,11,63,38,72,74,110,414,683,6,4293,238,0,1
346,7017,1457,730,1242,11,6,188,1468,10,292,166,329,302,495,2424,4078,5,22973,1276,1,1
346,7017,74,35,59,1,0,14,75,3,14,7,14,17,21,58,85,1,128,7,0,1
346,7017,245,125,200,5,7,34,250,7,30,17,34,37,51,166,265,3,1053,58,0,1
22,683,339,213,244,17,9,65,356,10,42,26,48,52,74,259,421,5,2410,133,0,1
56,1603,1455,414,1257,16,76,112,1471,5,41,23,46,46,69,231,381,2,1069,59,0,1
56,1603,669,365,481,22,61,110,691,15,103,63,122,118,185,747,1273,8,11311,628,0,1
227,5125,4293,999,3693,19,54,507,4312,9,155,88,170,164,258,1156,1898,4,9368,520,0,1
227,5125,1482,859,1002,125,135,219,1607,16,219,134,251,235,385,1766,3032,9,27804,1544,1,1
7,147,44,22,19,0,19,6,44,2,10,6,12,12,18,35,64,1,77,4,0,1
24,842,74,35,59,1,0,14,75,3,14,7,14,17,21,58,85,1,128,7,0,1
24,842,245,125,200,5,7,34,250,7,30,17,34,37,51,166,265,3,1053,58,0,1
83,2329,1523,757,1297,19,12,193,1542,12,193,117,230,205,347,1508,2664,7,19053,1058,0,1
83,2329,701,378,504,33,58,109,734,13,110,68,126,123,194,794,1346,7,10027,557,0,1
178,4168,77,34,69,0,0,8,77,3,24,16,29,27,45,114,213,1,387,21,0,1
178,4168,712,438,573,51,9,84,763,14,102,71,128,116,199,733,1364,8,11988,666,0,1
69,1367,1020,354,843,12,15,144,1032,8,134,77,144,142,221,970,1580,4,6792,377,0,1
46,959,447,308,343,6,5,95,453,7,96,59,111,103,170,651,1136,4,4600,255,0,1
46,959,322,174,179,16,74,51,338,10,41,26,46,51,72,252,408,5,2291,127,0,1
23,382,424,94,331,4,0,89,428,1,5,5,5,6,10,11,25,0,12,0,0,1
23,382,38,23,23,6,0,8,44,3,11,7,11,14,18,42,68,1,102,5,0,1
17,518,184,100,137,2,15,30,186,6,38,20,39,44,59,214,322,3,991,55,0,1
17,518,103,65,74,8,5,16,111,7,17,9,17,24,26,89,119,3,417,23,0,1
223,5086,722,423,573,19,0,135,741,12,172,101,199,184,300,1320,2257,6,15668,870,0,1
223,5086,1508,847,911,44,250,301,1552,14,148,88,169,162,257,1120,1886,7,15077,837,0,1
337,7196,72,33,56,0,4,12,72,1,1,1,1,2,2,0,2,0,1,0,0,1
337,7196,1454,835,1044,76,110,219,1530,17,275,158,296,292,454,2297,3718,9,34017,1889,1,1
39,816,386,256,301,16,9,68,402,4,59,35,69,63,104,355,621,2,1453,80,0,1
39,816,264,131,164,11,41,46,275,6,38,22,40,44,62,214,338,3,1068,59,0,1
30,657,215,129,180,6,0,29,221,8,65,43,72,73,115,415,711,4,3153,175,0,1
30,657,97,69,77,3,3,16,100,6,22,13,23,28,36,113,173,3,542,30,0,1
128,2826,1043,504,840,53,9,147,1096,9,180,112,198,189,310,1377,2344,4,11604,644,0,1
128,2826,383,288,292,26,6,62,409,11,65,38,67,76,105,429,656,5,3719,206,0,1
20,408,294,64,250,0,0,43,294,1,20,10,20,21,30,86,131,0,65,3,0,1
20,408,78,46,62,3,0,14,81,3,8,4,8,11,12,28,41,1,62,3,0,1
5,118,110,30,77,3,13,16,113,4,21,15,30,25,45,100,208,2,597,33,0,1
5,118,28,15,21,1,0,6,29,0,0,0,0,0,0,0,0,0,0,0,0,1
104,1977,1178,367,1042,6,15,115,1184,9,94,51,95,103,146,644,976,4,4439,246,0,1
104,1977,177,108,140,8,0,27,185,6,30,16,32,36,48,162,248,3,794,44,0,1
184,3757,1943,715,1694,26,18,214,1969,12,185,120,237,197,357,1436,2721,7,20915,1161,0,1
184,3757,1168,838,957,57,25,144,1225,19,348,224,416,367,640,3018,5452,11,61921,3440,1,1
16,480,442,244,305,14,16,103,456,11,68,45,75,79,120,452,756,6,4588,254,0,1
16,480,182,102,99,11,40,35,193,3,11,6,11,14,17,42,64,1,97,5,0,1
62,1248,1098,241,925,5,10,155,1103,7,46,25,49,53,74,273,423,3,1580,87,0,1
62,1248,282,202,222,14,2,44,296,8,42,24,43,50,67,250,378,4,1548,86,0,1
78,3314,1289,550,1043,56,32,155,1345,10,167,93,185,177,278,1266,2075,5,11498,638,0,1
34,997,182,127,129,0,0,53,182,5,39,21,42,44,63,217,343,2,926,51,0,1
137,6600,1392,870,1177,35,17,170,1427,14,494,280,531,508,811,4473,7289,7,54850,3047,2,1
91,3011,773,419,590,28,0,166,801,10,204,113,217,214,330,1598,2554,5,13587,754,0,1
7,263,75,38,59,1,3,12,76,2,4,2,4,6,6,10,15,1,15,0,0,1
23,601,102,59,69,5,3,24,107,6,22,15,28,28,43,113,206,3,789,43,0,1
109,4101,1450,624,1228,12,26,181,1462,14,306,186,354,320,540,2580,4493,8,36391,2021,1,1
148,4088,1660,832,1314,41,38,274,1701,20,312,209,395,332,604,2671,5058,12,64042,3557,1,1
117,4647,1513,682,1277,25,13,200,1538,11,199,116,219,210,335,1557,2584,6,15641,868,0,1
59,3310,1296,573,1062,40,33,157,1336,8,201,118,231,209,349,1561,2689,4,12365,686,0,1
10,236,207,111,150,11,0,50,218,5,26,19,36,31,55,133,272,3,943,52,0,1
78,4093,1457,730,1242,11,6,188,1468,10,292,166,329,302,495,2424,4078,5,22973,1276,1,1
38,2286,652,304,544,16,6,88,668,6,89,51,101,95,152,591,998,3,3399,188,0,1
62,2878,1455,414,1257,16,76,112,1471,5,41,23,46,46,69,231,381,2,1069,59,0,1
2,75,7,6,5,0,0,2,7,1,1,1,2,2,3,0,3,1,3,0,0,1
8,273,74,35,59,1,0,14,75,3,14,7,14,17,21,58,85,1,128,7,0,1
87,4331,1523,757,1297,19,12,193,1542,12,193,117,230,205,347,1508,2664,7,19053,1058,0,1
66,2767,1020,354,843,12,15,144,1032,8,134,77,144,142,221,970,1580,4,6792,377,0,1
37,1624,447,308,343,6,5,95,453,7,96,59,111,103,170,651,1136,4,4600,255,0,1
21,661,424,94,331,4,0,89,428,1,5,5,5,6,10,11,25,0,12,0,0,1
40,2359,334,251,279,10,4,40,344,5,127,74,143,132,217,899,1528,2,4303,239,0,1
12,492,184,100,137,2,15,30,186,6,38,20,39,44,59,214,322,3,991,55,0,1
35,1623,1293,570,1093,25,15,163,1318,10,195,123,241,205,364,1516,2795,6,17273,959,0,1
36,1978,384,251,317,7,8,52,391,11,70,44,84,81,128,467,811,6,5355,297,0,1
15,638,722,423,573,19,0,135,741,12,172,101,199,184,300,1320,2257,6,15668,870,0,1
31,1439,386,256,301,16,9,68,402,4,59,35,69,63,104,355,621,2,1453,80,0,1
16,1209,215,129,180,6,0,29,221,8,65,43,72,73,115,415,711,4,3153,175,0,1
69,2856,1043,504,840,53,9,147,1096,9,180,112,198,189,310,1377,2344,4,11604,644,0,1
14,529,295,56,236,0,4,54,295,2,9,5,10,11,15,30,51,1,57,3,0,1
25,1027,373,158,315,8,0,51,381,5,76,44,79,81,123,486,779,2,2026,112,0,1
71,3006,1178,367,1042,6,15,115,1184,9,94,51,95,103,146,644,976,4,4439,246,0,1
73,3738,1943,715,1694,26,18,214,1969,12,185,120,237,197,357,1436,2721,7,20915,1161,0,1
14,825,442,244,305,14,16,103,456,11,68,45,75,79,120,452,756,6,4588,254,0,1
48,1784,1098,241,925,5,10,155,1103,7,46,25,49,53,74,273,423,3,1580,87,0,1
223,5076,722,423,573,19,0,135,741,12,172,101,199,184,300,1320,2257,6,15668,870,0,1
223,5076,1508,847,911,44,250,301,1552,14,148,88,169,162,257,1120,1886,7,15077,837,0,1
94,4280,1338,495,1086,10,64,173,1348,11,122,82,157,133,239,883,1686,7,11934,663,0,1
117,4641,1513,682,1277,25,13,200,1538,11,199,116,219,210,335,1557,2584,6,15641,868,0,1
66,2763,1020,354,843,12,15,144,1032,8,134,77,144,142,221,970,1580,4,6792,377,0,1
137,6599,1392,870,1177,35,17,170,1427,14,494,280,531,508,811,4473,7289,7,54850,3047,2,0
9,231,19,8,11,5,0,4,24,2,5,3,6,7,9,13,25,1,30,1,0,0
9,231,102,59,69,5,3,24,107,6,22,15,28,28,43,113,206,3,789,43,0,0
9,231,106,40,36,3,49,17,109,8,17,13,23,25,36,93,167,5,904,50,0,0
211,4523,182,127,129,0,0,53,182,5,39,21,42,44,63,217,343,2,926,51,0,0
211,4523,1165,710,800,67,119,181,1232,18,243,153,282,261,435,2000,3492,10,36473,2026,1,0
99,2081,773,419,590,28,0,166,801,10,204,113,217,214,330,1598,2554,5,13587,754,0,0
99,2081,421,273,302,44,34,57,465,17,81,59,107,98,166,583,1098,11,12329,684,0,0
28,556,2,2,2,0,0,0,2,0,0,0,0,0,0,0,0,0,0,0,0,0
28,556,99,48,90,1,3,5,100,0,0,0,0,0,0,0,0,0,0,0,0,0
28,556,8,5,5,2,0,1,10,0,0,0,0,0,0,0,0,0,0,0,0,0
28,556,1217,716,841,84,126,174,1301,14,185,118,215,199,333,1446,2542,8,20687,1149,0,0
28,556,160,89,115,0,13,31,160,7,15,11,17,22,28,78,124,3,495,27,0,0
28,556,10,10,9,9,0,0,19,0,0,0,0,0,0,0,0,0,0,0,0,0
28,556,173,84,99,8,29,36,181,5,12,7,13,17,20,54,81,2,221,12,0,0
28,556,3,1,1,3,0,0,6,0,0,0,0,0,0,0,0,0,0,0,0,0
163,5082,1660,832,1314,41,38,274,1701,20,312,209,395,332,604,2671,5058,12,64042,3557,1,0
163,5082,1057,646,719,113,100,145,1170,18,215,134,248,233,382,1740,3004,10,31186,1732,1,0
17,349,95,58,50,9,16,20,104,12,33,24,45,45,69,209,378,8,3100,172,0,0
60,1262,996,429,845,24,10,117,1020,7,76,50,88,83,138,494,879,4,3565,198,0,0
60,1262,456,277,329,12,42,72,468,13,85,50,97,98,147,592,972,7,7212,400,0,0
119,2424,1513,682,1277,25,13,200,1538,11,199,116,219,210,335,1557,2584,6,15641,868,0,0
119,2424,819,519,539,24,98,155,843,15,96,57,106,111,163,690,1107,8,9171,509,0,0
50,1032,207,111,150,11,0,50,218,5,26,19,36,31,55,133,272,3,943,52,0,0
50,1032,410,198,237,31,55,97,441,11,63,38,72,74,110,414,683,6,4293,238,0,0
346,7017,1457,730,1242,11,6,188,1468,10,292,166,329,302,495,2424,4078,5,22973,1276,1,0
346,7017,74,35,59,1,0,14,75,3,14,7,14,17,21,58,85,1,128,7,0,0
346,7017,245,125,200,5,7,34,250,7,30,17,34,37,51,166,265,3,1053,58,0,0
22,683,339,213,244,17,9,65,356,10,42,26,48,52,74,259,421,5,2410,133,0,0
56,1603,1455,414,1257,16,76,112,1471,5,41,23,46,46,69,231,381,2,1069,59,0,0
56,1603,669,365,481,22,61,110,691,15,103,63,122,118,185,747,1273,8,11311,628,0,0
227,5125,4293,999,3693,19,54,507,4312,9,155,88,170,164,258,1156,1898,4,9368,520,0,0
227,5125,1482,859,1002,125,135,219,1607,16,219,134,251,235,385,1766,3032,9,27804,1544,1,0
7,147,44,22,19,0,19,6,44,2,10,6,12,12,18,35,64,1,77,4,0,0
24,842,74,35,59,1,0,14,75,3,14,7,14,17,21,58,85,1,128,7,0,0
24,842,245,125,200,5,7,34,250,7,30,17,34,37,51,166,265,3,1053,58,0,0
83,2329,1523,757,1297,19,12,193,1542,12,193,117,230,205,347,1508,2664,7,19053,1058,0,0
83,2329,701,378,504,33,58,109,734,13,110,68,126,123,194,794,1346,7,10027,557,0,0
178,4168,77,34,69,0,0,8,77,3,24,16,29,27,45,114,213,1,387,21,0,0
178,4168,712,438,573,51,9,84,763,14,102,71,128,116,199,733,1364,8,11988,666,0,0
69,1367,1020,354,843,12,15,144,1032,8,134,77,144,142,221,970,1580,4,6792,377,0,0
46,959,447,308,343,6,5,95,453,7,96,59,111,103,170,651,1136,4,4600,255,0,0
46,959,322,174,179,16,74,51,338,10,41,26,46,51,72,252,408,5,2291,127,0,0
23,382,424,94,331,4,0,89,428,1,5,5,5,6,10,11,25,0,12,0,0,0
23,382,38,23,23,6,0,8,44,3,11,7,11,14,18,42,68,1,102,5,0,0
17,518,184,100,137,2,15,30,186,6,38,20,39,44,59,214,322,3,991,55,0,0
17,518,103,65,74,8,5,16,111,7,17,9,17,24,26,89,119,3,417,23,0,0
223,5076,722,423,573,19,0,135,741,12,172,101,199,184,300,1320,2257,6,15668,870,0,0
223,5076,1508,847,911,44,250,301,1552,14,148,88,169,162,257,1120,1886,7,15077,837,0,0
337,7196,72,33,56,0,4,12,72,1,1,1,1,2,2,0,2,0,1,0,0,0
337,7196,1454,835,1044,76,110,219,1530,17,275,158,296,292,454,2297,3718,9,34017,1889,1,0
39,816,386,256,301,16,9,68,402,4,59,35,69,63,104,355,621,2,1453,80,0,0
39,816,264,131,164,11,41,46,275,6,38,22,40,44,62,214,338,3,1068,59,0,0
128,2826,1043,504,840,53,9,147,1096,9,180,112,198,189,310,1377,2344,4,11604,644,0,0
128,2826,383,288,292,26,6,62,409,11,65,38,67,76,105,429,656,5,3719,206,0,0
20,408,294,64,250,0,0,43,294,1,20,10,20,21,30,86,131,0,65,3,0,0
20,408,78,46,62,3,0,14,81,3,8,4,8,11,12,28,41,1,62,3,0,0
5,118,110,30,77,3,13,16,113,4,21,15,30,25,45,100,208,2,597,33,0,0
5,118,28,15,21,1,0,6,29,0,0,0,0,0,0,0,0,0,0,0,0,0
104,1977,1178,367,1042,6,15,115,1184,9,94,51,95,103,146,644,976,4,4439,246,0,0
104,1977,177,108,140,8,0,27,185,6,30,16,32,36,48,162,248,3,794,44,0,0
184,3757,1943,715,1694,26,18,214,1969,12,185,120,237,197,357,1436,2721,7,20915,1161,0,0
184,3757,1168,838,957,57,25,144,1225,19,348,224,416,367,640,3018,5452,11,61921,3440,1,0
16,480,442,244,305,14,16,103,456,11,68,45,75,79,120,452,756,6,4588,254,0,0
16,480,182,102,99,11,40,35,193,3,11,6,11,14,17,42,64,1,97,5,0,0
62,1248,1098,241,925,5,10,155,1103,7,46,25,49,53,74,273,423,3,1580,87,0,0
62,1248,282,202,222,14,2,44,296,8,42,24,43,50,67,250,378,4,1548,86,0,0
78,3314,1289,550,1043,56,32,155,1345,10,167,93,185,177,278,1266,2075,5,11498,638,0,0
34,997,182,127,129,0,0,53,182,5,39,21,42,44,63,217,343,2,926,51,0,0
91,3011,773,419,590,28,0,166,801,10,204,113,217,214,330,1598,2554,5,13587,754,0,0
7,263,75,38,59,1,3,12,76,2,4,2,4,6,6,10,15,1,15,0,0,0
23,601,102,59,69,5,3,24,107,6,22,15,28,28,43,113,206,3,789,43,0,0
109,4101,1450,624,1228,12,26,181,1462,14,306,186,354,320,540,2580,4493,8,36391,2021,1,0
148,4088,1660,832,1314,41,38,274,1701,20,312,209,395,332,604,2671,5058,12,64042,3557,1,0
117,4641,1513,682,1277,25,13,200,1538,11,199,116,219,210,335,1557,2584,6,15641,868,0,0
59,3310,1296,573,1062,40,33,157,1336,8,201,118,231,209,349,1561,2689,4,12365,686,0,0
10,236,207,111,150,11,0,50,218,5,26,19,36,31,55,133,272,3,943,52,0,0
78,4093,1457,730,1242,11,6,188,1468,10,292,166,329,302,495,2424,4078,5,22973,1276,1,0
38,2286,652,304,544,16,6,88,668,6,89,51,101,95,152,591,998,3,3399,188,0,0
62,2878,1455,414,1257,16,76,112,1471,5,41,23,46,46,69,231,381,2,1069,59,0,0
2,75,7,6,5,0,0,2,7,1,1,1,2,2,3,0,3,1,3,0,0,0
8,273,74,35,59,1,0,14,75,3,14,7,14,17,21,58,85,1,128,7,0,0
87,4331,1523,757,1297,19,12,193,1542,12,193,117,230,205,347,1508,2664,7,19053,1058,0,0
66,2763,1020,354,843,12,15,144,1032,8,134,77,144,142,221,970,1580,4,6792,377,0,0
37,1624,447,308,343,6,5,95,453,7,96,59,111,103,170,651,1136,4,4600,255,0,0
21,661,424,94,331,4,0,89,428,1,5,5,5,6,10,11,25,0,12,0,0,0
40,2359,334,251,279,10,4,40,344,5,127,74,143,132,217,899,1528,2,4303,239,0,0
12,492,184,100,137,2,15,30,186,6,38,20,39,44,59,214,322,3,991,55,0,0
35,1623,1293,570,1093,25,15,163,1318,10,195,123,241,205,364,1516,2795,6,17273,959,0,0
36,1978,384,251,317,7,8,52,391,11,70,44,84,81,128,467,811,6,5355,297,0,0
15,638,722,423,573,19,0,135,741,12,172,101,199,184,300,1320,2257,6,15668,870,0,0
31,1439,386,256,301,16,9,68,402,4,59,35,69,63,104,355,621,2,1453,80,0,0
16,1209,215,129,180,6,0,29,221,8,65,43,72,73,115,415,711,4,3153,175,0,0
69,2856,1043,504,840,53,9,147,1096,9,180,112,198,189,310,1377,2344,4,11604,644,0,0
14,529,295,56,236,0,4,54,295,2,9,5,10,11,15,30,51,1,57,3,0,0
25,1027,373,158,315,8,0,51,381,5,76,44,79,81,123,486,779,2,2026,112,0,0
71,3006,1178,367,1042,6,15,115,1184,9,94,51,95,103,146,644,976,4,4439,246,0,0
73,3738,1943,715,1694,26,18,214,1969,12,185,120,237,197,357,1436,2721,7,20915,1161,0,0
14,825,442,244,305,14,16,103,456,11,68,45,75,79,120,452,756,6,4588,254,0,0
48,1784,1098,241,925,5,10,155,1103,7,46,25,49,53,74,273,423,3,1580,87,0,0
79,1563,1020,354,843,12,15,144,1032,8,134,77,144,142,221,970,1580,4,6792,377,0,1
336,7198,72,33,56,0,4,12,72,1,1,1,1,2,2,0,2,0,1,0,0,1
336,7198,1454,835,1044,76,110,219,1530,17,275,158,296,292,454,2297,3718,9,34017,1889,1,1
112,5702,1782,648,1425,9,47,279,1791,8,171,97,189,179,286,1292,2140,4,9462,525,0,1
67,2928,1020,354,843,12,15,144,1032,8,134,77,144,142,221,970,1580,4,6792,377,0,1
79,1563,1020,354,843,12,15,144,1032,8,134,77,144,142,221,970,1580,4,6792,377,0,0
336,7198,72,33,56,0,4,12,72,1,1,1,1,2,2,0,2,0,1,0,0,0
336,7198,1454,835,1044,76,110,219,1530,17,275,158,296,292,454,2297,3718,9,34017,1889,1,0
112,5702,1782,648,1425,9,47,279,1791,8,171,97,189,179,286,1292,2140,4,9462,525,0,0
67,2928,1020,354,843,12,15,144,1032,8,134,77,144,142,221,970,1580,4,6792,377,0,0
346,7021,1457,730,1242,11,6,188,1468,10,292,166,329,302,495,2424,4078,5,22973,1276,1,0
346,7021,74,35,59,1,0,14,75,3,14,7,14,17,21,58,85,1,128,7,0,0
346,7021,245,125,200,5,7,34,250,7,30,17,34,37,51,166,265,3,1053,58,0,0
227,5129,4293,999,3693,19,54,507,4312,9,155,88,170,164,258,1156,1898,4,9368,520,0,0
227,5129,1482,859,1002,125,135,219,1607,16,219,134,251,235,385,1766,3032,9,27804,1544,1,0
39,792,386,256,301,16,9,68,402,4,59,35,69,63,104,355,621,2,1453,80,0,0
39,792,264,131,164,11,41,46,275,6,38,22,40,44,62,214,338,3,1068,59,0,0
191,3892,1943,715,1694,26,18,214,1969,12,185,120,237,197,357,1436,2721,7,20915,1161,0,0
191,3892,1168,838,957,57,25,144,1225,19,348,224,416,367,640,3018,5452,11,61921,3440,1,0
94,4283,1338,495,1086,10,64,173,1348,11,122,82,157,133,239,883,1686,7,11934,663,0,0
109,4106,1450,624,1228,12,26,181,1462,14,306,186,354,320,540,2580,4493,8,36391,2021,1,0
87,4336,1523,757,1297,19,12,193,1542,12,193,117,230,205,347,1508,2664,7,19053,1058,0,0
14,339,601,196,481,2,23,85,603,8,63,36,72,71,108,400,664,4,3036,168,0,0
14,339,156,79,106,5,16,28,161,5,14,8,15,19,23,64,97,2,261,14,0,0
336,7200,72,33,56,0,4,12,72,1,1,1,1,2,2,0,2,0,1,0,0,1
336,7200,1454,835,1044,76,110,219,1530,17,275,158,296,292,454,2297,3718,9,34017,1889,1,1
78,3324,1289,550,1043,56,32,155,1345,10,167,93,185,177,278,1266,2075,5,11498,638,0,1
147,6797,139,89,101,2,0,35,141,7,54,34,62,61,96,330,569,4,2287,127,0,1
147,6797,7,5,5,0,0,2,7,1,2,1,2,3,3,2,4,0,2,0,0,1
112,5710,1782,648,1425,9,47,279,1791,8,171,97,189,179,286,1292,2140,4,9462,525,0,1
40,2367,334,251,279,10,4,40,344,5,127,74,143,132,217,899,1528,2,4303,239,0,1
128,2841,1043,504,840,53,9,147,1096,9,180,112,198,189,310,1377,2344,4,11604,644,0,1
128,2841,383,288,292,26,6,62,409,11,65,38,67,76,105,429,656,5,3719,206,0,1
78,3341,1289,550,1043,56,32,155,1345,10,167,93,185,177,278,1266,2075,5,11498,638,0,0
336,7200,72,33,56,0,4,12,72,1,1,1,1,2,2,0,2,0,1,0,0,0
336,7200,1454,835,1044,76,110,219,1530,17,275,158,296,292,454,2297,3718,9,34017,1889,1,0
128,2841,1043,504,840,53,9,147,1096,9,180,112,198,189,310,1377,2344,4,11604,644,0,0
128,2841,383,288,292,26,6,62,409,11,65,38,67,76,105,429,656,5,3719,206,0,0
147,6797,139,89,101,2,0,35,141,7,54,34,62,61,96,330,569,4,2287,127,0,0
147,6797,7,5,5,0,0,2,7,1,2,1,2,3,3,2,4,0,2,0,0,0
112,5710,1782,648,1425,9,47,279,1791,8,171,97,189,179,286,1292,2140,4,9462,525,0,0
40,2367,334,251,279,10,4,40,344,5,127,74,143,132,217,899,1528,2,4303,239,0,0
9,317,601,196,481,2,23,85,603,8,63,36,72,71,108,400,664,4,3036,168,0,0
27,545,2,2,2,0,0,0,2,0,0,0,0,0,0,0,0,0,0,0,0,1
27,545,99,48,90,1,3,5,100,0,0,0,0,0,0,0,0,0,0,0,0,1
27,545,8,5,5,2,0,1,10,0,0,0,0,0,0,0,0,0,0,0,0,1
27,545,1217,716,841,84,126,174,1301,14,185,118,215,199,333,1446,2542,8,20687,1149,0,1
27,545,160,89,115,0,13,31,160,7,15,11,17,22,28,78,124,3,495,27,0,1
27,545,10,10,9,9,0,0,19,0,0,0,0,0,0,0,0,0,0,0,0,1
27,545,173,84,99,8,29,36,181,5,12,7,13,17,20,54,81,2,221,12,0,1
27,545,3,1,1,3,0,0,6,0,0,0,0,0,0,0,0,0,0,0,0,1
346,7021,1457,730,1242,11,6,188,1468,10,292,166,329,302,495,2424,4078,5,22973,1276,1,1
346,7021,74,35,59,1,0,14,75,3,14,7,14,17,21,58,85,1,128,7,0,1
346,7021,245,125,200,5,7,34,250,7,30,17,34,37,51,166,265,3,1053,58,0,1
6,136,44,22,19,0,19,6,44,2,10,6,12,12,18,35,64,1,77,4,0,1
21,670,339,213,244,17,9,65,356,10,42,26,48,52,74,259,421,5,2410,133,0,1
38,777,386,256,301,16,9,68,402,4,59,35,69,63,104,355,621,2,1453,80,0,1
38,777,264,131,164,11,41,46,275,6,38,22,40,44,62,214,338,3,1068,59,0,1
127,2817,1043,504,840,53,9,147,1096,9,180,112,198,189,310,1377,2344,4,11604,644,0,1
127,2817,383,288,292,26,6,62,409,11,65,38,67,76,105,429,656,5,3719,206,0,1
80,1581,1020,354,843,12,15,144,1032,8,134,77,144,142,221,970,1580,4,6792,377,0,1
103,1965,1178,367,1042,6,15,115,1184,9,94,51,95,103,146,644,976,4,4439,246,0,1
103,1965,177,108,140,8,0,27,185,6,30,16,32,36,48,162,248,3,794,44,0,1
49,575,647,139,84,35,284,233,682,0,0,0,0,0,0,0,0,0,0,0,0,1
80,1586,1020,354,843,12,15,144,1032,8,134,77,144,142,221,970,1580,4,6792,377,0,1
52,1103,207,111,150,11,0,50,218,5,26,19,36,31,55,133,272,3,943,52,0,1
52,1103,410,198,237,31,55,97,441,11,63,38,72,74,110,414,683,6,4293,238,0,1
227,5114,4293,999,3693,19,54,507,4312,9,155,88,170,164,258,1156,1898,4,9368,520,0,1
227,5114,1482,859,1002,125,135,219,1607,16,219,134,251,235,385,1766,3032,9,27804,1544,1,1
177,4136,77,34,69,0,0,8,77,3,24,16,29,27,45,114,213,1,387,21,0,1
177,4136,712,438,573,51,9,84,763,14,102,71,128,116,199,733,1364,8,11988,666,0,1
335,7153,72,33,56,0,4,12,72,1,1,1,1,2,2,0,2,0,1,0,0,1
335,7153,1454,835,1044,76,110,219,1530,17,275,158,296,292,454,2297,3718,9,34017,1889,1,1
226,5106,4293,999,3693,19,54,507,4312,9,155,88,170,164,258,1156,1898,4,9368,520,0,1
226,5106,1482,859,1002,125,135,219,1607,16,219,134,251,235,385,1766,3032,9,27804,1544,1,1
53,1123,207,111,150,11,0,50,218,5,26,19,36,31,55,133,272,3,943,52,0,1
53,1123,410,198,237,31,55,97,441,11,63,38,72,74,110,414,683,6,4293,238,0,1
21,668,339,213,244,17,9,65,356,10,42,26,48,52,74,259,421,5,2410,133,0,1
225,5104,4293,999,3693,19,54,507,4312,9,155,88,170,164,258,1156,1898,4,9368,520,0,1
225,5104,1482,859,1002,125,135,219,1607,16,219,134,251,235,385,1766,3032,9,27804,1544,1,1
177,4124,77,34,69,0,0,8,77,3,24,16,29,27,45,114,213,1,387,21,0,1
177,4124,712,438,573,51,9,84,763,14,102,71,128,116,199,733,1364,8,11988,666,0,1
46,961,447,308,343,6,5,95,453,7,96,59,111,103,170,651,1136,4,4600,255,0,1
46,961,322,174,179,16,74,51,338,10,41,26,46,51,72,252,408,5,2291,127,0,1
335,7158,72,33,56,0,4,12,72,1,1,1,1,2,2,0,2,0,1,0,0,1
335,7158,1454,835,1044,76,110,219,1530,17,275,158,296,292,454,2297,3718,9,34017,1889,1,1
38,783,386,256,301,16,9,68,402,4,59,35,69,63,104,355,621,2,1453,80,0,1
38,783,264,131,164,11,41,46,275,6,38,22,40,44,62,214,338,3,1068,59,0,1
127,2813,1043,504,840,53,9,147,1096,9,180,112,198,189,310,1377,2344,4,11604,644,0,1
127,2813,383,288,292,26,6,62,409,11,65,38,67,76,105,429,656,5,3719,206,0,1
103,1960,1178,367,1042,6,15,115,1184,9,94,51,95,103,146,644,976,4,4439,246,0,1
103,1960,177,108,140,8,0,27,185,6,30,16,32,36,48,162,248,3,794,44,0,1
225,5102,4293,999,3693,19,54,507,4312,9,155,88,170,164,258,1156,1898,4,9368,520,0,1
225,5102,1482,859,1002,125,135,219,1607,16,219,134,251,235,385,1766,3032,9,27804,1544,1,1
177,4127,77,34,69,0,0,8,77,3,24,16,29,27,45,114,213,1,387,21,0,1
177,4127,712,438,573,51,9,84,763,14,102,71,128,116,199,733,1364,8,11988,666,0,1
225,5106,4293,999,3693,19,54,507,4312,9,155,88,170,164,258,1156,1898,4,9368,520,0,0
225,5106,1482,859,1002,125,135,219,1607,16,219,134,251,235,385,1766,3032,9,27804,1544,1,0
23,388,424,94,331,4,0,89,428,1,5,5,5,6,10,11,25,0,12,0,0,1
23,388,38,23,23,6,0,8,44,3,11,7,11,14,18,42,68,1,102,5,0,1
62,1240,1098,241,925,5,10,155,1103,7,46,25,49,53,74,273,423,3,1580,87,0,1
62,1240,282,202,222,14,2,44,296,8,42,24,43,50,67,250,378,4,1548,86,0,1
335,7154,72,33,56,0,4,12,72,1,1,1,1,2,2,0,2,0,1,0,0,1
335,7154,1454,835,1044,76,110,219,1530,17,275,158,296,292,454,2297,3718,9,34017,1889,1,1
80,1593,1020,354,843,12,15,144,1032,8,134,77,144,142,221,970,1580,4,6792,377,0,1
178,4136,77,34,69,0,0,8,77,3,24,16,29,27,45,114,213,1,387,21,0,1
178,4136,712,438,573,51,9,84,763,14,102,71,128,116,199,733,1364,8,11988,666,0,1
48,904,207,111,150,11,0,50,218,5,26,19,36,31,55,133,272,3,943,52,0,0
48,904,410,198,237,31,55,97,441,11,63,38,72,74,110,414,683,6,4293,238,0,0
335,7113,72,33,56,0,4,12,72,1,1,1,1,2,2,0,2,0,1,0,0,0
335,7113,1454,835,1044,76,110,219,1530,17,275,158,296,292,454,2297,3718,9,34017,1889,1,0
95,4294,1338,495,1086,10,64,173,1348,11,122,82,157,133,239,883,1686,7,11934,663,0,0
346,7035,1457,730,1242,11,6,188,1468,10,292,166,329,302,495,2424,4078,5,22973,1276,1,1
346,7035,74,35,59,1,0,14,75,3,14,7,14,17,21,58,85,1,128,7,0,1
346,7035,245,125,200,5,7,34,250,7,30,17,34,37,51,166,265,3,1053,58,0,1
79,3381,1289,550,1043,56,32,155,1345,10,167,93,185,177,278,1266,2075,5,11498,638,0,1
346,7035,1457,730,1242,11,6,188,1468,10,292,166,329,302,495,2424,4078,5,22973,1276,1,0
346,7035,74,35,59,1,0,14,75,3,14,7,14,17,21,58,85,1,128,7,0,0
346,7035,245,125,200,5,7,34,250,7,30,17,34,37,51,166,265,3,1053,58,0,0
79,3381,1289,550,1043,56,32,155,1345,10,167,93,185,177,278,1266,2075,5,11498,638,0,0
163,5086,1660,832,1314,41,38,274,1701,20,312,209,395,332,604,2671,5058,12,64042,3557,1,0
163,5086,1057,646,719,113,100,145,1170,18,215,134,248,233,382,1740,3004,10,31186,1732,1,0
149,4136,1660,832,1314,41,38,274,1701,20,312,209,395,332,604,2671,5058,12,64042,3557,1,0
99,2075,773,419,590,28,0,166,801,10,204,113,217,214,330,1598,2554,5,13587,754,0,1
99,2075,421,273,302,44,34,57,465,17,81,59,107,98,166,583,1098,11,12329,684,0,1
163,5074,1660,832,1314,41,38,274,1701,20,312,209,395,332,604,2671,5058,12,64042,3557,1,1
163,5074,1057,646,719,113,100,145,1170,18,215,134,248,233,382,1740,3004,10,31186,1732,1,1
119,2401,1513,682,1277,25,13,200,1538,11,199,116,219,210,335,1557,2584,6,15641,868,0,1
119,2401,819,519,539,24,98,155,843,15,96,57,106,111,163,690,1107,8,9171,509,0,1
48,904,207,111,150,11,0,50,218,5,26,19,36,31,55,133,272,3,943,52,0,1
48,904,410,198,237,31,55,97,441,11,63,38,72,74,110,414,683,6,4293,238,0,1
227,5099,4293,999,3693,19,54,507,4312,9,155,88,170,164,258,1156,1898,4,9368,520,0,1
227,5099,1482,859,1002,125,135,219,1607,16,219,134,251,235,385,1766,3032,9,27804,1544,1,1
71,2109,1523,757,1297,19,12,193,1542,12,193,117,230,205,347,1508,2664,7,19053,1058,0,1
71,2109,701,378,504,33,58,109,734,13,110,68,126,123,194,794,1346,7,10027,557,0,1
46,945,447,308,343,6,5,95,453,7,96,59,111,103,170,651,1136,4,4600,255,0,1
46,945,322,174,179,16,74,51,338,10,41,26,46,51,72,252,408,5,2291,127,0,1
222,4989,722,423,573,19,0,135,741,12,172,101,199,184,300,1320,2257,6,15668,870,0,1
222,4989,1508,847,911,44,250,301,1552,14,148,88,169,162,257,1120,1886,7,15077,837,0,1
335,7113,72,33,56,0,4,12,72,1,1,1,1,2,2,0,2,0,1,0,0,1
335,7113,1454,835,1044,76,110,219,1530,17,275,158,296,292,454,2297,3718,9,34017,1889,1,1
184,3743,1943,715,1694,26,18,214,1969,12,185,120,237,197,357,1436,2721,7,20915,1161,0,1
184,3743,1168,838,957,57,25,144,1225,19,348,224,416,367,640,3018,5452,11,61921,3440,1,1
16,469,442,244,305,14,16,103,456,11,68,45,75,79,120,452,756,6,4588,254,0,1
16,469,182,102,99,11,40,35,193,3,11,6,11,14,17,42,64,1,97,5,0,1
14,472,42,7,35,4,0,5,46,1,2,1,2,3,3,2,4,0,2,0,0,1
14,472,11,6,10,0,0,1,11,2,4,2,4,6,6,10,15,1,15,0,0,1
78,3291,1289,550,1043,56,32,155,1345,10,167,93,185,177,278,1266,2075,5,11498,638,0,1
95,4294,1338,495,1086,10,64,173,1348,11,122,82,157,133,239,883,1686,7,11934,663,0,1
116,4567,1513,682,1277,25,13,200,1538,11,199,116,219,210,335,1557,2584,6,15641,868,0,1
38,2269,652,304,544,16,6,88,668,6,89,51,101,95,152,591,998,3,3399,188,0,1
61,2747,1455,414,1257,16,76,112,1471,5,41,23,46,46,69,231,381,2,1069,59,0,1
82,4086,1523,757,1297,19,12,193,1542,12,193,117,230,205,347,1508,2664,7,19053,1058,0,1
37,1604,447,308,343,6,5,95,453,7,96,59,111,103,170,651,1136,4,4600,255,0,1
36,1940,384,251,317,7,8,52,391,11,70,44,84,81,128,467,811,6,5355,297,0,1
71,2977,1178,367,1042,6,15,115,1184,9,94,51,95,103,146,644,976,4,4439,246,0,1
73,3706,1943,715,1694,26,18,214,1969,12,185,120,237,197,357,1436,2721,7,20915,1161,0,1
346,7028,1457,730,1242,11,6,188,1468,10,292,166,329,302,495,2424,4078,5,22973,1276,1,1
346,7028,74,35,59,1,0,14,75,3,14,7,14,17,21,58,85,1,128,7,0,1
346,7028,245,125,200,5,7,34,250,7,30,17,34,37,51,166,265,3,1053,58,0,1
178,4177,77,34,69,0,0,8,77,3,24,16,29,27,45,114,213,1,387,21,0,1
178,4177,712,438,573,51,9,84,763,14,102,71,128,116,199,733,1364,8,11988,666,0,1
80,3429,1289,550,1043,56,32,155,1345,10,167,93,185,177,278,1266,2075,5,11498,638,0,1
211,4485,182,127,129,0,0,53,182,5,39,21,42,44,63,217,343,2,926,51,0,1
211,4485,1165,710,800,67,119,181,1232,18,243,153,282,261,435,2000,3492,10,36473,2026,1,1
48,919,207,111,150,11,0,50,218,5,26,19,36,31,55,133,272,3,943,52,0,1
48,919,410,198,237,31,55,97,441,11,63,38,72,74,110,414,683,6,4293,238,0,1
211,4485,182,127,129,0,0,53,182,5,39,21,42,44,63,217,343,2,926,51,0,0
211,4485,1165,710,800,67,119,181,1232,18,243,153,282,261,435,2000,3492,10,36473,2026,1,0
48,919,207,111,150,11,0,50,218,5,26,19,36,31,55,133,272,3,943,52,0,0
48,919,410,198,237,31,55,97,441,11,63,38,72,74,110,414,683,6,4293,238,0,0
223,5080,722,423,573,19,0,135,741,12,172,101,199,184,300,1320,2257,6,15668,870,0,0
223,5080,1508,847,911,44,250,301,1552,14,148,88,169,162,257,1120,1886,7,15077,837,0,0
191,3896,1943,715,1694,26,18,214,1969,12,185,120,237,197,357,1436,2721,7,20915,1161,0,0
191,3896,1168,838,957,57,25,144,1225,19,348,224,416,367,640,3018,5452,11,61921,3440,1,0
346,7028,1457,730,1242,11,6,188,1468,10,292,166,329,302,495,2424,4078,5,22973,1276,1,0
346,7028,74,35,59,1,0,14,75,3,14,7,14,17,21,58,85,1,128,7,0,0
346,7028,245,125,200,5,7,34,250,7,30,17,34,37,51,166,265,3,1053,58,0,0
80,3429,1289,550,1043,56,32,155,1345,10,167,93,185,177,278,1266,2075,5,11498,638,0,0
11,396,42,7,35,4,0,5,46,1,2,1,2,3,3,2,4,0,2,0,0,1
11,396,11,6,10,0,0,1,11,2,4,2,4,6,6,10,15,1,15,0,0,1
96,4332,1338,495,1086,10,64,173,1348,11,122,82,157,133,239,883,1686,7,11934,663,0,1
96,4332,1338,495,1086,10,64,173,1348,11,122,82,157,133,239,883,1686,7,11934,663,0,0
27,545,2,2,2,0,0,0,2,0,0,0,0,0,0,0,0,0,0,0,0,0
27,545,99,48,90,1,3,5,100,0,0,0,0,0,0,0,0,0,0,0,0,0
27,545,8,5,5,2,0,1,10,0,0,0,0,0,0,0,0,0,0,0,0,0
27,545,1217,716,841,84,126,174,1301,14,185,118,215,199,333,1446,2542,8,20687,1149,0,0
27,545,160,89,115,0,13,31,160,7,15,11,17,22,28,78,124,3,495,27,0,0
27,545,10,10,9,9,0,0,19,0,0,0,0,0,0,0,0,0,0,0,0,0
27,545,173,84,99,8,29,36,181,5,12,7,13,17,20,54,81,2,221,12,0,0
27,545,3,1,1,3,0,0,6,0,0,0,0,0,0,0,0,0,0,0,0,0
53,1123,207,111,150,11,0,50,218,5,26,19,36,31,55,133,272,3,943,52,0,0
53,1123,410,198,237,31,55,97,441,11,63,38,72,74,110,414,683,6,4293,238,0,0
21,668,339,213,244,17,9,65,356,10,42,26,48,52,74,259,421,5,2410,133,0,0
6,136,44,22,19,0,19,6,44,2,10,6,12,12,18,35,64,1,77,4,0,0
80,1593,1020,354,843,12,15,144,1032,8,134,77,144,142,221,970,1580,4,6792,377,0,0
46,961,447,308,343,6,5,95,453,7,96,59,111,103,170,651,1136,4,4600,255,0,0
46,961,322,174,179,16,74,51,338,10,41,26,46,51,72,252,408,5,2291,127,0,0
23,388,424,94,331,4,0,89,428,1,5,5,5,6,10,11,25,0,12,0,0,0
23,388,38,23,23,6,0,8,44,3,11,7,11,14,18,42,68,1,102,5,0,0
335,7154,72,33,56,0,4,12,72,1,1,1,1,2,2,0,2,0,1,0,0,0
335,7154,1454,835,1044,76,110,219,1530,17,275,158,296,292,454,2297,3718,9,34017,1889,1,0
38,783,386,256,301,16,9,68,402,4,59,35,69,63,104,355,621,2,1453,80,0,0
38,783,264,131,164,11,41,46,275,6,38,22,40,44,62,214,338,3,1068,59,0,0
127,2813,1043,504,840,53,9,147,1096,9,180,112,198,189,310,1377,2344,4,11604,644,0,0
127,2813,383,288,292,26,6,62,409,11,65,38,67,76,105,429,656,5,3719,206,0,0
62,1240,1098,241,925,5,10,155,1103,7,46,25,49,53,74,273,423,3,1580,87,0,0
62,1240,282,202,222,14,2,44,296,8,42,24,43,50,67,250,378,4,1548,86,0,0
11,402,42,7,35,4,0,5,46,1,2,1,2,3,3,2,4,0,2,0,0,1
11,402,11,6,10,0,0,1,11,2,4,2,4,6,6,10,15,1,15,0,0,1
11,402,42,7,35,4,0,5,46,1,2,1,2,3,3,2,4,0,2,0,0,0
11,402,11,6,10,0,0,1,11,2,4,2,4,6,6,10,15,1,15,0,0,0
336,7127,72,33,56,0,4,12,72,1,1,1,1,2,2,0,2,0,1,0,0,0
336,7127,1454,835,1044,76,110,219,1530,17,275,158,296,292,454,2297,3718,9,34017,1889,1,0
67,2779,1020,354,843,12,15,144,1032,8,134,77,144,142,221,970,1580,4,6792,377,0,0
211,4493,182,127,129,0,0,53,182,5,39,21,42,44,63,217,343,2,926,51,0,0
211,4493,1165,710,800,67,119,181,1232,18,243,153,282,261,435,2000,3492,10,36473,2026,1,0
54,1153,207,111,150,11,0,50,218,5,26,19,36,31,55,133,272,3,943,52,0,0
54,1153,410,198,237,31,55,97,441,11,63,38,72,74,110,414,683,6,4293,238,0,0
336,7168,72,33,56,0,4,12,72,1,1,1,1,2,2,0,2,0,1,0,0,0
336,7168,1454,835,1044,76,110,219,1530,17,275,158,296,292,454,2297,3718,9,34017,1889,1,0
96,4365,1338,495,1086,10,64,173,1348,11,122,82,157,133,239,883,1686,7,11934,663,0,0
117,4645,1513,682,1277,25,13,200,1538,11,199,116,219,210,335,1557,2584,6,15641,868,0,0
68,2962,1020,354,843,12,15,144,1032,8,134,77,144,142,221,970,1580,4,6792,377,0,0
346,7030,1457,730,1242,11,6,188,1468,10,292,166,329,302,495,2424,4078,5,22973,1276,1,0
346,7030,74,35,59,1,0,14,75,3,14,7,14,17,21,58,85,1,128,7,0,0
346,7030,245,125,200,5,7,34,250,7,30,17,34,37,51,166,265,3,1053,58,0,0
83,2370,1523,757,1297,19,12,193,1542,12,193,117,230,205,347,1508,2664,7,19053,1058,0,1
83,2370,701,378,504,33,58,109,734,13,110,68,126,123,194,794,1346,7,10027,557,0,1
89,4427,1523,757,1297,19,12,193,1542,12,193,117,230,205,347,1508,2664,7,19053,1058,0,1
83,2359,1523,757,1297,19,12,193,1542,12,193,117,230,205,347,1508,2664,7,19053,1058,0,1
83,2359,701,378,504,33,58,109,734,13,110,68,126,123,194,794,1346,7,10027,557,0,1
89,4432,1523,757,1297,19,12,193,1542,12,193,117,230,205,347,1508,2664,7,19053,1058,0,1
90,4427,1523,757,1297,19,12,193,1542,12,193,117,230,205,347,1508,2664,7,19053,1058,0,0
83,2359,1523,757,1297,19,12,193,1542,12,193,117,230,205,347,1508,2664,7,19053,1058,0,0
83,2359,701,378,504,33,58,109,734,13,110,68,126,123,194,794,1346,7,10027,557,0,0
9,228,19,8,11,5,0,4,24,2,5,3,6,7,9,13,25,1,30,1,0,1
9,228,102,59,69,5,3,24,107,6,22,15,28,28,43,113,206,3,789,43,0,1
9,228,106,40,36,3,49,17,109,8,17,13,23,25,36,93,167,5,904,50,0,1
27,542,2,2,2,0,0,0,2,0,0,0,0,0,0,0,0,0,0,0,0,1
27,542,99,48,90,1,3,5,100,0,0,0,0,0,0,0,0,0,0,0,0,1
27,542,8,5,5,2,0,1,10,0,0,0,0,0,0,0,0,0,0,0,0,1
27,542,1217,716,841,84,126,174,1301,14,185,118,215,199,333,1446,2542,8,20687,1149,0,1
27,542,160,89,115,0,13,31,160,7,15,11,17,22,28,78,124,3,495,27,0,1
27,542,10,10,9,9,0,0,19,0,0,0,0,0,0,0,0,0,0,0,0,1
27,542,173,84,99,8,29,36,181,5,12,7,13,17,20,54,81,2,221,12,0,1
27,542,3,1,1,3,0,0,6,0,0,0,0,0,0,0,0,0,0,0,0,1
60,1259,996,429,845,24,10,117,1020,7,76,50,88,83,138,494,879,4,3565,198,0,1
60,1259,456,277,329,12,42,72,468,13,85,50,97,98,147,592,972,7,7212,400,0,1
119,2406,1513,682,1277,25,13,200,1538,11,199,116,219,210,335,1557,2584,6,15641,868,0,1
119,2406,819,519,539,24,98,155,843,15,96,57,106,111,163,690,1107,8,9171,509,0,1
346,7015,1457,730,1242,11,6,188,1468,10,292,166,329,302,495,2424,4078,5,22973,1276,1,1
346,7015,74,35,59,1,0,14,75,3,14,7,14,17,21,58,85,1,128,7,0,1
346,7015,245,125,200,5,7,34,250,7,30,17,34,37,51,166,265,3,1053,58,0,1
21,662,339,213,244,17,9,65,356,10,42,26,48,52,74,259,421,5,2410,133,0,1
225,5091,4293,999,3693,19,54,507,4312,9,155,88,170,164,258,1156,1898,4,9368,520,0,1
225,5091,1482,859,1002,125,135,219,1607,16,219,134,251,235,385,1766,3032,9,27804,1544,1,1
178,4123,77,34,69,0,0,8,77,3,24,16,29,27,45,114,213,1,387,21,0,1
178,4123,712,438,573,51,9,84,763,14,102,71,128,116,199,733,1364,8,11988,666,0,1
223,5047,722,423,573,19,0,135,741,12,172,101,199,184,300,1320,2257,6,15668,870,0,1
223,5047,1508,847,911,44,250,301,1552,14,148,88,169,162,257,1120,1886,7,15077,837,0,1
127,2807,1043,504,840,53,9,147,1096,9,180,112,198,189,310,1377,2344,4,11604,644,0,1
127,2807,383,288,292,26,6,62,409,11,65,38,67,76,105,429,656,5,3719,206,0,1
103,1953,1178,367,1042,6,15,115,1184,9,94,51,95,103,146,644,976,4,4439,246,0,1
103,1953,177,108,140,8,0,27,185,6,30,16,32,36,48,162,248,3,794,44,0,1
191,3890,1943,715,1694,26,18,214,1969,12,185,120,237,197,357,1436,2721,7,20915,1161,0,1
191,3890,1168,838,957,57,25,144,1225,19,348,224,416,367,640,3018,5452,11,61921,3440,1,1
16,477,442,244,305,14,16,103,456,11,68,45,75,79,120,452,756,6,4588,254,0,1
16,477,182,102,99,11,40,35,193,3,11,6,11,14,17,42,64,1,97,5,0,1
9,228,19,8,11,5,0,4,24,2,5,3,6,7,9,13,25,1,30,1,0,0
9,228,102,59,69,5,3,24,107,6,22,15,28,28,43,113,206,3,789,43,0,0
9,228,106,40,36,3,49,17,109,8,17,13,23,25,36,93,167,5,904,50,0,0
27,542,2,2,2,0,0,0,2,0,0,0,0,0,0,0,0,0,0,0,0,0
27,542,99,48,90,1,3,5,100,0,0,0,0,0,0,0,0,0,0,0,0,0
27,542,8,5,5,2,0,1,10,0,0,0,0,0,0,0,0,0,0,0,0,0
27,542,1217,716,841,84,126,174,1301,14,185,118,215,199,333,1446,2542,8,20687,1149,0,0
27,542,160,89,115,0,13,31,160,7,15,11,17,22,28,78,124,3,495,27,0,0
27,542,10,10,9,9,0,0,19,0,0,0,0,0,0,0,0,0,0,0,0,0
27,542,173,84,99,8,29,36,181,5,12,7,13,17,20,54,81,2,221,12,0,0
27,542,3,1,1,3,0,0,6,0,0,0,0,0,0,0,0,0,0,0,0,0
60,1259,996,429,845,24,10,117,1020,7,76,50,88,83,138,494,879,4,3565,198,0,0
60,1259,456,277,329,12,42,72,468,13,85,50,97,98,147,592,972,7,7212,400,0,0
119,2406,1513,682,1277,25,13,200,1538,11,199,116,219,210,335,1557,2584,6,15641,868,0,0
119,2406,819,519,539,24,98,155,843,15,96,57,106,111,163,690,1107,8,9171,509,0,0
346,7015,1457,730,1242,11,6,188,1468,10,292,166,329,302,495,2424,4078,5,22973,1276,1,0
346,7015,74,35,59,1,0,14,75,3,14,7,14,17,21,58,85,1,128,7,0,0
346,7015,245,125,200,5,7,34,250,7,30,17,34,37,51,166,265,3,1053,58,0,0
21,662,339,213,244,17,9,65,356,10,42,26,48,52,74,259,421,5,2410,133,0,0
225,5091,4293,999,3693,19,54,507,4312,9,155,88,170,164,258,1156,1898,4,9368,520,0,0
225,5091,1482,859,1002,125,135,219,1607,16,219,134,251,235,385,1766,3032,9,27804,1544,1,0
178,4123,77,34,69,0,0,8,77,3,24,16,29,27,45,114,213,1,387,21,0,0
178,4123,712,438,573,51,9,84,763,14,102,71,128,116,199,733,1364,8,11988,666,0,0
80,1581,1020,354,843,12,15,144,1032,8,134,77,144,142,221,970,1580,4,6792,377,0,0
223,5047,722,423,573,19,0,135,741,12,172,101,199,184,300,1320,2257,6,15668,870,0,0
223,5047,1508,847,911,44,250,301,1552,14,148,88,169,162,257,1120,1886,7,15077,837,0,0
127,2807,1043,504,840,53,9,147,1096,9,180,112,198,189,310,1377,2344,4,11604,644,0,0
127,2807,383,288,292,26,6,62,409,11,65,38,67,76,105,429,656,5,3719,206,0,0
103,1953,1178,367,1042,6,15,115,1184,9,94,51,95,103,146,644,976,4,4439,246,0,0
103,1953,177,108,140,8,0,27,185,6,30,16,32,36,48,162,248,3,794,44,0,0
191,3890,1943,715,1694,26,18,214,1969,12,185,120,237,197,357,1436,2721,7,20915,1161,0,0
191,3890,1168,838,957,57,25,144,1225,19,348,224,416,367,640,3018,5452,11,61921,3440,1,0
16,477,442,244,305,14,16,103,456,11,68,45,75,79,120,452,756,6,4588,254,0,0
16,477,182,102,99,11,40,35,193,3,11,6,11,14,17,42,64,1,97,5,0,0
347,7008,1457,730,1242,11,6,188,1468,10,292,166,329,302,495,2424,4078,5,22973,1276,1,1
347,7008,74,35,59,1,0,14,75,3,14,7,14,17,21,58,85,1,128,7,0,1
347,7008,245,125,200,5,7,34,250,7,30,17,34,37,51,166,265,3,1053,58,0,1
347,7009,1457,730,1242,11,6,188,1468,10,292,166,329,302,495,2424,4078,5,22973,1276,1,0
347,7009,74,35,59,1,0,14,75,3,14,7,14,17,21,58,85,1,128,7,0,0
347,7009,245,125,200,5,7,34,250,7,30,17,34,37,51,166,265,3,1053,58,0,0
348,7017,1457,730,1242,11,6,188,1468,10,292,166,329,302,495,2424,4078,5,22973,1276,1,0
348,7017,74,35,59,1,0,14,75,3,14,7,14,17,21,58,85,1,128,7,0,0
348,7017,245,125,200,5,7,34,250,7,30,17,34,37,51,166,265,3,1053,58,0,0
348,7017,1457,730,1242,11,6,188,1468,10,292,166,329,302,495,2424,4078,5,22973,1276,1,1
348,7017,74,35,59,1,0,14,75,3,14,7,14,17,21,58,85,1,128,7,0,1
348,7017,245,125,200,5,7,34,250,7,30,17,34,37,51,166,265,3,1053,58,0,1
348,7014,1457,730,1242,11,6,188,1468,10,292,166,329,302,495,2424,4078,5,22973,1276,1,1
348,7014,74,35,59,1,0,14,75,3,14,7,14,17,21,58,85,1,128,7,0,1
348,7014,245,125,200,5,7,34,250,7,30,17,34,37,51,166,265,3,1053,58,0,1
348,7007,1457,730,1242,11,6,188,1468,10,292,166,329,302,495,2424,4078,5,22973,1276,1,0
348,7007,74,35,59,1,0,14,75,3,14,7,14,17,21,58,85,1,128,7,0,0
348,7007,245,125,200,5,7,34,250,7,30,17,34,37,51,166,265,3,1053,58,0,0
348,7028,1457,730,1242,11,6,188,1468,10,292,166,329,302,495,2424,4078,5,22973,1276,1,0
348,7028,74,35,59,1,0,14,75,3,14,7,14,17,21,58,85,1,128,7,0,0
348,7028,245,125,200,5,7,34,250,7,30,17,34,37,51,166,265,3,1053,58,0,0
60,1265,996,429,845,24,10,117,1020,7,76,50,88,83,138,494,879,4,3565,198,0,0
60,1265,456,277,329,12,42,72,468,13,85,50,97,98,147,592,972,7,7212,400,0,0
14,348,601,196,481,2,23,85,603,8,63,36,72,71,108,400,664,4,3036,168,0,1
14,348,156,79,106,5,16,28,161,5,14,8,15,19,23,64,97,2,261,14,0,1
10,361,601,196,481,2,23,85,603,8,63,36,72,71,108,400,664,4,3036,168,0,1
54,1161,207,111,150,11,0,50,218,5,26,19,36,31,55,133,272,3,943,52,0,1
54,1161,410,198,237,31,55,97,441,11,63,38,72,74,110,414,683,6,4293,238,0,1
19,407,601,196,481,2,23,85,603,8,63,36,72,71,108,400,664,4,3036,168,0,1
19,407,156,79,106,5,16,28,161,5,14,8,15,19,23,64,97,2,261,14,0,1
11,447,601,196,481,2,23,85,603,8,63,36,72,71,108,400,664,4,3036,168,0,1
54,1161,207,111,150,11,0,50,218,5,26,19,36,31,55,133,272,3,943,52,0,0
54,1161,410,198,237,31,55,97,441,11,63,38,72,74,110,414,683,6,4293,238,0,0
19,407,601,196,481,2,23,85,603,8,63,36,72,71,108,400,664,4,3036,168,0,0
19,407,156,79,106,5,16,28,161,5,14,8,15,19,23,64,97,2,261,14,0,0
11,447,601,196,481,2,23,85,603,8,63,36,72,71,108,400,664,4,3036,168,0,0
60,1689,1455,414,1257,16,76,112,1471,5,41,23,46,46,69,231,381,2,1069,59,0,1
60,1689,669,365,481,22,61,110,691,15,103,63,122,118,185,747,1273,8,11311,628,0,1
63,2918,1455,414,1257,16,76,112,1471,5,41,23,46,46,69,231,381,2,1069,59,0,1
60,1689,1455,414,1257,16,76,112,1471,5,41,23,46,46,69,231,381,2,1069,59,0,0
60,1689,669,365,481,22,61,110,691,15,103,63,122,118,185,747,1273,8,11311,628,0,0
63,2918,1455,414,1257,16,76,112,1471,5,41,23,46,46,69,231,381,2,1069,59,0,0
38,787,386,256,301,16,9,68,402,4,59,35,69,63,104,355,621,2,1453,80,0,0
38,787,264,131,164,11,41,46,275,6,38,22,40,44,62,214,338,3,1068,59,0,0
31,1467,386,256,301,16,9,68,402,4,59,35,69,63,104,355,621,2,1453,80,0,0
19,401,601,196,481,2,23,85,603,8,63,36,72,71,108,400,664,4,3036,168,0,1
19,401,156,79,106,5,16,28,161,5,14,8,15,19,23,64,97,2,261,14,0,1
32,1464,386,256,301,16,9,68,402,4,59,35,69,63,104,355,621,2,1453,80,0,1
12,476,601,196,481,2,23,85,603,8,63,36,72,71,108,400,664,4,3036,168,0,1
19,401,601,196,481,2,23,85,603,8,63,36,72,71,108,400,664,4,3036,168,0,0
19,401,156,79,106,5,16,28,161,5,14,8,15,19,23,64,97,2,261,14,0,0
32,1492,386,256,301,16,9,68,402,4,59,35,69,63,104,355,621,2,1453,80,0,0
12,476,601,196,481,2,23,85,603,8,63,36,72,71,108,400,664,4,3036,168,0,0
150,4203,1660,832,1314,41,38,274,1701,20,312,209,395,332,604,2671,5058,12,64042,3557,1,1
163,5080,1660,832,1314,41,38,274,1701,20,312,209,395,332,604,2671,5058,12,64042,3557,1,0
163,5080,1057,646,719,113,100,145,1170,18,215,134,248,233,382,1740,3004,10,31186,1732,1,0
150,4203,1660,832,1314,41,38,274,1701,20,312,209,395,332,604,2671,5058,12,64042,3557,1,0
349,7049,1457,730,1242,11,6,188,1468,10,292,166,329,302,495,2424,4078,5,22973,1276,1,1
349,7049,74,35,59,1,0,14,75,3,14,7,14,17,21,58,85,1,128,7,0,1
349,7049,245,125,200,5,7,34,250,7,30,17,34,37,51,166,265,3,1053,58,0,1
27,953,74,35,59,1,0,14,75,3,14,7,14,17,21,58,85,1,128,7,0,1
27,953,245,125,200,5,7,34,250,7,30,17,34,37,51,166,265,3,1053,58,0,1
39,2355,652,304,544,16,6,88,668,6,89,51,101,95,152,591,998,3,3399,188,0,1
27,954,74,35,59,1,0,14,75,3,14,7,14,17,21,58,85,1,128,7,0,0
27,954,245,125,200,5,7,34,250,7,30,17,34,37,51,166,265,3,1053,58,0,0
349,7049,1457,730,1242,11,6,188,1468,10,292,166,329,302,495,2424,4078,5,22973,1276,1,0
349,7049,74,35,59,1,0,14,75,3,14,7,14,17,21,58,85,1,128,7,0,0
349,7049,245,125,200,5,7,34,250,7,30,17,34,37,51,166,265,3,1053,58,0,0
39,2355,652,304,544,16,6,88,668,6,89,51,101,95,152,591,998,3,3399,188,0,0
128,2606,1513,682,1277,25,13,200,1538,11,199,116,219,210,335,1557,2584,6,15641,868,0,1
128,2606,819,519,539,24,98,155,843,15,96,57,106,111,163,690,1107,8,9171,509,0,1
128,2606,1513,682,1277,25,13,200,1538,11,199,116,219,210,335,1557,2584,6,15641,868,0,0
128,2606,819,519,539,24,98,155,843,15,96,57,106,111,163,690,1107,8,9171,509,0,0
178,4125,77,34,69,0,0,8,77,3,24,16,29,27,45,114,213,1,387,21,0,1
178,4125,712,438,573,51,9,84,763,14,102,71,128,116,199,733,1364,8,11988,666,0,1
80,3427,1289,550,1043,56,32,155,1345,10,167,93,185,177,278,1266,2075,5,11498,638,0,1
66,3414,1296,573,1062,40,33,157,1336,8,201,118,231,209,349,1561,2689,4,12365,686,0,1
192,3902,1943,715,1694,26,18,214,1969,12,185,120,237,197,357,1436,2721,7,20915,1161,0,0
192,3902,1168,838,957,57,25,144,1225,19,348,224,416,367,640,3018,5452,11,61921,3440,1,0
74,3770,1943,715,1694,26,18,214,1969,12,185,120,237,197,357,1436,2721,7,20915,1161,0,0
19,408,601,196,481,2,23,85,603,8,63,36,72,71,108,400,664,4,3036,168,0,1
19,408,156,79,106,5,16,28,161,5,14,8,15,19,23,64,97,2,261,14,0,1
40,834,386,256,301,16,9,68,402,4,59,35,69,63,104,355,621,2,1453,80,0,1
40,834,264,131,164,11,41,46,275,6,38,22,40,44,62,214,338,3,1068,59,0,1
38,1637,386,256,301,16,9,68,402,4,59,35,69,63,104,355,621,2,1453,80,0,1
19,408,601,196,481,2,23,85,603,8,63,36,72,71,108,400,664,4,3036,168,0,0
19,408,156,79,106,5,16,28,161,5,14,8,15,19,23,64,97,2,261,14,0,0
212,4584,182,127,129,0,0,53,182,5,39,21,42,44,63,217,343,2,926,51,0,1
212,4584,1165,710,800,67,119,181,1232,18,243,153,282,261,435,2000,3492,10,36473,2026,1,1
143,6718,1392,870,1177,35,17,170,1427,14,494,280,531,508,811,4473,7289,7,54850,3047,2,1
212,4584,182,127,129,0,0,53,182,5,39,21,42,44,63,217,343,2,926,51,0,0
212,4584,1165,710,800,67,119,181,1232,18,243,153,282,261,435,2000,3492,10,36473,2026,1,0
143,6718,1392,870,1177,35,17,170,1427,14,494,280,531,508,811,4473,7289,7,54850,3047,2,0
213,4595,182,127,129,0,0,53,182,5,39,21,42,44,63,217,343,2,926,51,0,1
213,4595,1165,710,800,67,119,181,1232,18,243,153,282,261,435,2000,3492,10,36473,2026,1,1
147,6814,1392,870,1177,35,17,170,1427,14,494,280,531,508,811,4473,7289,7,54850,3047,2,1
306,6621,72,33,56,0,4,12,72,1,1,1,1,2,2,0,2,0,1,0,0,0
306,6621,1454,835,1044,76,110,219,1530,17,275,158,296,292,454,2297,3718,9,34017,1889,1,0
286,6178,72,33,56,0,4,12,72,1,1,1,1,2,2,0,2,0,1,0,0,1
286,6178,1454,835,1044,76,110,219,1530,17,275,158,296,292,454,2297,3718,9,34017,1889,1,1
50,1010,757,253,292,73,244,162,830,13,61,38,67,74,105,409,651,7,4654,258,0,1
286,6178,72,33,56,0,4,12,72,1,1,1,1,2,2,0,2,0,1,0,0,0
286,6178,1454,835,1044,76,110,219,1530,17,275,158,296,292,454,2297,3718,9,34017,1889,1,0
50,1010,757,253,292,73,244,162,830,13,61,38,67,74,105,409,651,7,4654,258,0,0
361,7632,72,33,56,0,4,12,72,1,1,1,1,2,2,0,2,0,1,0,0,1
361,7632,1454,835,1044,76,110,219,1530,17,275,158,296,292,454,2297,3718,9,34017,1889,1,1
56,3288,520,294,400,33,13,81,553,10,261,204,367,271,571,2128,4614,7,32445,1802,1,1
75,1474,757,253,292,73,244,162,830,13,61,38,67,74,105,409,651,7,4654,258,0,1
227,5124,4293,999,3693,19,54,507,4312,9,155,88,170,164,258,1156,1898,4,9368,520,0,1
227,5124,1482,859,1002,125,135,219,1607,16,219,134,251,235,385,1766,3032,9,27804,1544,1,1
148,6830,139,89,101,2,0,35,141,7,54,34,62,61,96,330,569,4,2287,127,0,1
148,6830,7,5,5,0,0,2,7,1,2,1,2,3,3,2,4,0,2,0,0,1
60,1673,1455,414,1257,16,76,112,1471,5,41,23,46,46,69,231,381,2,1069,59,0,1
60,1673,669,365,481,22,61,110,691,15,103,63,122,118,185,747,1273,8,11311,628,0,1
64,2957,1455,414,1257,16,76,112,1471,5,41,23,46,46,69,231,381,2,1069,59,0,1
227,5129,4293,999,3693,19,54,507,4312,9,155,88,170,164,258,1156,1898,4,9368,520,0,1
227,5129,1482,859,1002,125,135,219,1607,16,219,134,251,235,385,1766,3032,9,27804,1544,1,1
148,6832,139,89,101,2,0,35,141,7,54,34,62,61,96,330,569,4,2287,127,0,1
148,6832,7,5,5,0,0,2,7,1,2,1,2,3,3,2,4,0,2,0,0,1
148,6832,139,89,101,2,0,35,141,7,54,34,62,61,96,330,569,4,2287,127,0,0
148,6832,7,5,5,0,0,2,7,1,2,1,2,3,3,2,4,0,2,0,0,0
60,1673,1455,414,1257,16,76,112,1471,5,41,23,46,46,69,231,381,2,1069,59,0,0
60,1673,669,365,481,22,61,110,691,15,103,63,122,118,185,747,1273,8,11311,628,0,0
64,2957,1455,414,1257,16,76,112,1471,5,41,23,46,46,69,231,381,2,1069,59,0,0
178,4125,77,34,69,0,0,8,77,3,24,16,29,27,45,114,213,1,387,21,0,0
178,4125,712,438,573,51,9,84,763,14,102,71,128,116,199,733,1364,8,11988,666,0,0
80,3427,1289,550,1043,56,32,155,1345,10,167,93,185,177,278,1266,2075,5,11498,638,0,0
66,3414,1296,573,1062,40,33,157,1336,8,201,118,231,209,349,1561,2689,4,12365,686,0,0
54,1166,207,111,150,11,0,50,218,5,26,19,36,31,55,133,272,3,943,52,0,1
54,1166,410,198,237,31,55,97,441,11,63,38,72,74,110,414,683,6,4293,238,0,1
74,1464,757,253,292,73,244,162,830,13,61,38,67,74,105,409,651,7,4654,258,0,1
53,3332,520,294,400,33,13,81,553,10,261,204,367,271,571,2128,4614,7,32445,1802,1,1
53,3320,520,294,400,33,13,81,553,10,261,204,367,271,571,2128,4614,7,32445,1802,1,1
74,1467,757,253,292,73,244,162,830,13,61,38,67,74,105,409,651,7,4654,258,0,1
74,1473,757,253,292,73,244,162,830,13,61,38,67,74,105,409,651,7,4654,258,0,0
90,1694,1020,354,843,12,15,144,1032,8,134,77,144,142,221,970,1580,4,6792,377,0,1
276,6071,72,33,56,0,4,12,72,1,1,1,1,2,2,0,2,0,1,0,0,1
276,6071,1454,835,1044,76,110,219,1530,17,275,158,296,292,454,2297,3718,9,34017,1889,1,1
90,1746,1020,354,843,12,15,144,1032,8,134,77,144,142,221,970,1580,4,6792,377,0,1
90,1754,1020,354,843,12,15,144,1032,8,134,77,144,142,221,970,1580,4,6792,377,0,1
70,3035,1020,354,843,12,15,144,1032,8,134,77,144,142,221,970,1580,4,6792,377,0,1
213,4595,182,127,129,0,0,53,182,5,39,21,42,44,63,217,343,2,926,51,0,0
213,4595,1165,710,800,67,119,181,1232,18,243,153,282,261,435,2000,3492,10,36473,2026,1,0
147,6814,1392,870,1177,35,17,170,1427,14,494,280,531,508,811,4473,7289,7,54850,3047,2,0
40,837,386,256,301,16,9,68,402,4,59,35,69,63,104,355,621,2,1453,80,0,0
40,837,264,131,164,11,41,46,275,6,38,22,40,44,62,214,338,3,1068,59,0,0
92,1807,1020,354,843,12,15,144,1032,8,134,77,144,142,221,970,1580,4,6792,377,0,1
38,1637,386,256,301,16,9,68,402,4,59,35,69,63,104,355,621,2,1453,80,0,0
93,1798,1020,354,843,12,15,144,1032,8,134,77,144,142,221,970,1580,4,6792,377,0,1
276,6071,72,33,56,0,4,12,72,1,1,1,1,2,2,0,2,0,1,0,0,0
276,6071,1454,835,1044,76,110,219,1530,17,275,158,296,292,454,2297,3718,9,34017,1889,1,0
93,1798,1020,354,843,12,15,144,1032,8,134,77,144,142,221,970,1580,4,6792,377,0,0
70,3035,1020,354,843,12,15,144,1032,8,134,77,144,142,221,970,1580,4,6792,377,0,0
94,1809,1020,354,843,12,15,144,1032,8,134,77,144,142,221,970,1580,4,6792,377,0,1
94,1809,1020,354,843,12,15,144,1032,8,134,77,144,142,221,970,1580,4,6792,377,0,0
178,4127,77,34,69,0,0,8,77,3,24,16,29,27,45,114,213,1,387,21,0,0
178,4127,712,438,573,51,9,84,763,14,102,71,128,116,199,733,1364,8,11988,666,0,0
278,6113,72,33,56,0,4,12,72,1,1,1,1,2,2,0,2,0,1,0,0,1
278,6113,1454,835,1044,76,110,219,1530,17,275,158,296,292,454,2297,3718,9,34017,1889,1,1
98,4425,1338,495,1086,10,64,173,1348,11,122,82,157,133,239,883,1686,7,11934,663,0,1
278,6113,72,33,56,0,4,12,72,1,1,1,1,2,2,0,2,0,1,0,0,0
278,6113,1454,835,1044,76,110,219,1530,17,275,158,296,292,454,2297,3718,9,34017,1889,1,0
98,4425,1338,495,1086,10,64,173,1348,11,122,82,157,133,239,883,1686,7,11934,663,0,0
178,4129,77,34,69,0,0,8,77,3,24,16,29,27,45,114,213,1,387,21,0,0
178,4129,712,438,573,51,9,84,763,14,102,71,128,116,199,733,1364,8,11988,666,0,0
74,1479,757,253,292,73,244,162,830,13,61,38,67,74,105,409,651,7,4654,258,0,1
76,1520,757,253,292,73,244,162,830,13,61,38,67,74,105,409,651,7,4654,258,0,0
178,4129,77,34,69,0,0,8,77,3,24,16,29,27,45,114,213,1,387,21,0,1
178,4129,712,438,573,51,9,84,763,14,102,71,128,116,199,733,1364,8,11988,666,0,1
54,1166,207,111,150,11,0,50,218,5,26,19,36,31,55,133,272,3,943,52,0,0
54,1166,410,198,237,31,55,97,441,11,63,38,72,74,110,414,683,6,4293,238,0,0
53,3320,520,294,400,33,13,81,553,10,261,204,367,271,571,2128,4614,7,32445,1802,1,0
62,1345,996,429,845,24,10,117,1020,7,76,50,88,83,138,494,879,4,3565,198,0,0
62,1345,456,277,329,12,42,72,468,13,85,50,97,98,147,592,972,7,7212,400,0,0
336,7168,72,33,56,0,4,12,72,1,1,1,1,2,2,0,2,0,1,0,0,1
336,7168,1454,835,1044,76,110,219,1530,17,275,158,296,292,454,2297,3718,9,34017,1889,1,1
336,7160,72,33,56,0,4,12,72,1,1,1,1,2,2,0,2,0,1,0,0,1
336,7160,1454,835,1044,76,110,219,1530,17,275,158,296,292,454,2297,3718,9,34017,1889,1,1
7,278,75,38,59,1,3,12,76,2,4,2,4,6,6,10,15,1,15,0,0,1
180,4191,77,34,69,0,0,8,77,3,24,16,29,27,45,114,213,1,387,21,0,1
180,4191,712,438,573,51,9,84,763,14,102,71,128,116,199,733,1364,8,11988,666,0,1
184,4250,77,34,69,0,0,8,77,3,24,16,29,27,45,114,213,1,387,21,0,0
184,4250,712,438,573,51,9,84,763,14,102,71,128,116,199,733,1364,8,11988,666,0,0
184,4240,77,34,69,0,0,8,77,3,24,16,29,27,45,114,213,1,387,21,0,1
184,4240,712,438,573,51,9,84,763,14,102,71,128,116,199,733,1364,8,11988,666,0,1
72,3755,1296,573,1062,40,33,157,1336,8,201,118,231,209,349,1561,2689,4,12365,686,0,1
184,4240,77,34,69,0,0,8,77,3,24,16,29,27,45,114,213,1,387,21,0,0
184,4240,712,438,573,51,9,84,763,14,102,71,128,116,199,733,1364,8,11988,666,0,0
72,3755,1296,573,1062,40,33,157,1336,8,201,118,231,209,349,1561,2689,4,12365,686,0,0
336,7160,72,33,56,0,4,12,72,1,1,1,1,2,2,0,2,0,1,0,0,0
336,7160,1454,835,1044,76,110,219,1530,17,275,158,296,292,454,2297,3718,9,34017,1889,1,0
7,278,75,38,59,1,3,12,76,2,4,2,4,6,6,10,15,1,15,0,0,0
192,3908,1943,715,1694,26,18,214,1969,12,185,120,237,197,357,1436,2721,7,20915,1161,0,0
192,3908,1168,838,957,57,25,144,1225,19,348,224,416,367,640,3018,5452,11,61921,3440,1,0
339,7202,72,33,56,0,4,12,72,1,1,1,1,2,2,0,2,0,1,0,0,1
339,7202,1454,835,1044,76,110,219,1530,17,275,158,296,292,454,2297,3718,9,34017,1889,1,1
151,6958,139,89,101,2,0,35,141,7,54,34,62,61,96,330,569,4,2287,127,0,1
151,6958,7,5,5,0,0,2,7,1,2,1,2,3,3,2,4,0,2,0,0,1
55,1182,207,111,150,11,0,50,218,5,26,19,36,31,55,133,272,3,943,52,0,1
55,1182,410,198,237,31,55,97,441,11,63,38,72,74,110,414,683,6,4293,238,0,1
118,4686,1513,682,1277,25,13,200,1538,11,199,116,219,210,335,1557,2584,6,15641,868,0,1
91,3010,773,419,590,28,0,166,801,10,204,113,217,214,330,1598,2554,5,13587,754,0,1
90,4427,1523,757,1297,19,12,193,1542,12,193,117,230,205,347,1508,2664,7,19053,1058,0,1
212,5047,722,423,573,19,0,135,741,12,172,101,199,184,300,1320,2257,6,15668,870,0,1
212,5047,1508,847,911,44,250,301,1552,14,148,88,169,162,257,1120,1886,7,15077,837,0,1
310,7160,72,33,56,0,4,12,72,1,1,1,1,2,2,0,2,0,1,0,0,1
310,7160,1454,835,1044,76,110,219,1530,17,275,158,296,292,454,2297,3718,9,34017,1889,1,1
109,4106,1450,624,1228,12,26,181,1462,14,306,186,354,320,540,2580,4493,8,36391,2021,1,1
68,2962,1020,354,843,12,15,144,1032,8,134,77,144,142,221,970,1580,4,6792,377,0,1
163,5080,1660,832,1314,41,38,274,1701,20,312,209,395,332,604,2671,5058,12,64042,3557,1,1
163,5080,1057,646,719,113,100,145,1170,18,215,134,248,233,382,1740,3004,10,31186,1732,1,1
60,1265,996,429,845,24,10,117,1020,7,76,50,88,83,138,494,879,4,3565,198,0,1
60,1265,456,277,329,12,42,72,468,13,85,50,97,98,147,592,972,7,7212,400,0,1
27,954,74,35,59,1,0,14,75,3,14,7,14,17,21,58,85,1,128,7,0,1
27,954,245,125,200,5,7,34,250,7,30,17,34,37,51,166,265,3,1053,58,0,1
178,4130,77,34,69,0,0,8,77,3,24,16,29,27,45,114,213,1,387,21,0,1
178,4130,712,438,573,51,9,84,763,14,102,71,128,116,199,733,1364,8,11988,666,0,1
192,3908,1943,715,1694,26,18,214,1969,12,185,120,237,197,357,1436,2721,7,20915,1161,0,1
192,3908,1168,838,957,57,25,144,1225,19,348,224,416,367,640,3018,5452,11,61921,3440,1,1
96,4365,1338,495,1086,10,64,173,1348,11,122,82,157,133,239,883,1686,7,11934,663,0,1
117,4645,1513,682,1277,25,13,200,1538,11,199,116,219,210,335,1557,2584,6,15641,868,0,1
74,3770,1943,715,1694,26,18,214,1969,12,185,120,237,197,357,1436,2721,7,20915,1161,0,1
40,837,386,256,301,16,9,68,402,4,59,35,69,63,104,355,621,2,1453,80,0,1
40,837,264,131,164,11,41,46,275,6,38,22,40,44,62,214,338,3,1068,59,0,1
212,5047,722,423,573,19,0,135,741,12,172,101,199,184,300,1320,2257,6,15668,870,0,0
212,5047,1508,847,911,44,250,301,1552,14,148,88,169,162,257,1120,1886,7,15077,837,0,0
101,2081,773,419,590,28,0,166,801,10,204,113,217,214,330,1598,2554,5,13587,754,0,0
101,2081,421,273,302,44,34,57,465,17,81,59,107,98,166,583,1098,11,12329,684,0,0
310,7160,72,33,56,0,4,12,72,1,1,1,1,2,2,0,2,0,1,0,0,0
310,7160,1454,835,1044,76,110,219,1530,17,275,158,296,292,454,2297,3718,9,34017,1889,1,0
101,2081,773,419,590,28,0,166,801,10,204,113,217,214,330,1598,2554,5,13587,754,0,1
101,2081,421,273,302,44,34,57,465,17,81,59,107,98,166,583,1098,11,12329,684,0,1
91,3010,773,419,590,28,0,166,801,10,204,113,217,214,330,1598,2554,5,13587,754,0,0
147,6812,1392,870,1177,35,17,170,1427,14,494,280,531,508,811,4473,7289,7,54850,3047,2,0
178,4132,77,34,69,0,0,8,77,3,24,16,29,27,45,114,213,1,387,21,0,1
178,4132,712,438,573,51,9,84,763,14,102,71,128,116,199,733,1364,8,11988,666,0,1
112,5711,1782,648,1425,9,47,279,1791,8,171,97,189,179,286,1292,2140,4,9462,525,0,1
147,6812,1392,870,1177,35,17,170,1427,14,494,280,531,508,811,4473,7289,7,54850,3047,2,1
114,5711,1782,648,1425,9,47,279,1791,8,171,97,189,179,286,1292,2140,4,9462,525,0,1
10,228,19,8,11,5,0,4,24,2,5,3,6,7,9,13,25,1,30,1,0,1
10,228,102,59,69,5,3,24,107,6,22,15,28,28,43,113,206,3,789,43,0,1
10,228,106,40,36,3,49,17,109,8,17,13,23,25,36,93,167,5,904,50,0,1
153,6832,139,89,101,2,0,35,141,7,54,34,62,61,96,330,569,4,2287,127,0,1
153,6832,7,5,5,0,0,2,7,1,2,1,2,3,3,2,4,0,2,0,0,1
132,5711,1782,648,1425,9,47,279,1791,8,171,97,189,179,286,1292,2140,4,9462,525,0,1
72,2856,1043,504,840,53,9,147,1096,9,180,112,198,189,310,1377,2344,4,11604,644,0,1
102,2083,773,419,590,28,0,166,801,10,204,113,217,214,330,1598,2554,5,13587,754,0,0
102,2083,421,273,302,44,34,57,465,17,81,59,107,98,166,583,1098,11,12329,684,0,0
164,5082,1660,832,1314,41,38,274,1701,20,312,209,395,332,604,2671,5058,12,64042,3557,1,0
164,5082,1057,646,719,113,100,145,1170,18,215,134,248,233,382,1740,3004,10,31186,1732,1,0
86,1808,477,336,357,30,23,73,507,16,194,134,250,210,384,1538,2962,10,30538,1696,0,0
312,7164,72,33,56,0,4,12,72,1,1,1,1,2,2,0,2,0,1,0,0,0
312,7164,1454,835,1044,76,110,219,1530,17,275,158,296,292,454,2297,3718,9,34017,1889,1,0
26,1029,373,158,315,8,0,51,381,5,76,44,79,81,123,486,779,2,2026,112,0,0
339,7202,72,33,56,0,4,12,72,1,1,1,1,2,2,0,2,0,1,0,0,0
339,7202,1454,835,1044,76,110,219,1530,17,275,158,296,292,454,2297,3718,9,34017,1889,1,0
151,6958,139,89,101,2,0,35,141,7,54,34,62,61,96,330,569,4,2287,127,0,0
151,6958,7,5,5,0,0,2,7,1,2,1,2,3,3,2,4,0,2,0,0,0
10,228,19,8,11,5,0,4,24,2,5,3,6,7,9,13,25,1,30,1,0,0
10,228,102,59,69,5,3,24,107,6,22,15,28,28,43,113,206,3,789,43,0,0
10,228,106,40,36,3,49,17,109,8,17,13,23,25,36,93,167,5,904,50,0,0
178,4132,77,34,69,0,0,8,77,3,24,16,29,27,45,114,213,1,387,21,0,0
178,4132,712,438,573,51,9,84,763,14,102,71,128,116,199,733,1364,8,11988,666,0,0
304,7099,72,33,56,0,4,12,72,1,1,1,1,2,2,0,2,0,1,0,0,0
304,7099,1454,835,1044,76,110,219,1530,17,275,158,296,292,454,2297,3718,9,34017,1889,1,0
53,3287,520,294,400,33,13,81,553,10,261,204,367,271,571,2128,4614,7,32445,1802,1,0
153,6832,139,89,101,2,0,35,141,7,54,34,62,61,96,330,569,4,2287,127,0,0
153,6832,7,5,5,0,0,2,7,1,2,1,2,3,3,2,4,0,2,0,0,0
132,5711,1782,648,1425,9,47,279,1791,8,171,97,189,179,286,1292,2140,4,9462,525,0,0
72,2856,1043,504,840,53,9,147,1096,9,180,112,198,189,310,1377,2344,4,11604,644,0,0
304,7104,72,33,56,0,4,12,72,1,1,1,1,2,2,0,2,0,1,0,0,1
304,7104,1454,835,1044,76,110,219,1530,17,275,158,296,292,454,2297,3718,9,34017,1889,1,1
77,1522,757,253,292,73,244,162,830,13,61,38,67,74,105,409,651,7,4654,258,0,1
53,3287,520,294,400,33,13,81,553,10,261,204,367,271,571,2128,4614,7,32445,1802,1,1
94,1795,1020,354,843,12,15,144,1032,8,134,77,144,142,221,970,1580,4,6792,377,0,0
129,2875,1043,504,840,53,9,147,1096,9,180,112,198,189,310,1377,2344,4,11604,644,0,1
129,2875,383,288,292,26,6,62,409,11,65,38,67,76,105,429,656,5,3719,206,0,1
70,2942,1043,504,840,53,9,147,1096,9,180,112,198,189,310,1377,2344,4,11604,644,0,1
129,2875,1043,504,840,53,9,147,1096,9,180,112,198,189,310,1377,2344,4,11604,644,0,0
129,2875,383,288,292,26,6,62,409,11,65,38,67,76,105,429,656,5,3719,206,0,0
70,2942,1043,504,840,53,9,147,1096,9,180,112,198,189,310,1377,2344,4,11604,644,0,0
315,7206,72,33,56,0,4,12,72,1,1,1,1,2,2,0,2,0,1,0,0,0
315,7206,1454,835,1044,76,110,219,1530,17,275,158,296,292,454,2297,3718,9,34017,1889,1,0
156,6958,139,89,101,2,0,35,141,7,54,34,62,61,96,330,569,4,2287,127,0,0
156,6958,7,5,5,0,0,2,7,1,2,1,2,3,3,2,4,0,2,0,0,0
184,4243,77,34,69,0,0,8,77,3,24,16,29,27,45,114,213,1,387,21,0,0
184,4243,712,438,573,51,9,84,763,14,102,71,128,116,199,733,1364,8,11988,666,0,0
73,2942,1043,504,840,53,9,147,1096,9,180,112,198,189,310,1377,2344,4,11604,644,0,0
307,7146,72,33,56,0,4,12,72,1,1,1,1,2,2,0,2,0,1,0,0,0
307,7146,1454,835,1044,76,110,219,1530,17,275,158,296,292,454,2297,3718,9,34017,1889,1,0
55,1182,207,111,150,11,0,50,218,5,26,19,36,31,55,133,272,3,943,52,0,0
55,1182,410,198,237,31,55,97,441,11,63,38,72,74,110,414,683,6,4293,238,0,0
118,4686,1513,682,1277,25,13,200,1538,11,199,116,219,210,335,1557,2584,6,15641,868,0,0
77,1522,757,253,292,73,244,162,830,13,61,38,67,74,105,409,651,7,4654,258,0,0
118,4694,1513,682,1277,25,13,200,1538,11,199,116,219,210,335,1557,2584,6,15641,868,0,1
55,1187,207,111,150,11,0,50,218,5,26,19,36,31,55,133,272,3,943,52,0,0
55,1187,410,198,237,31,55,97,441,11,63,38,72,74,110,414,683,6,4293,238,0,0
118,4694,1513,682,1277,25,13,200,1538,11,199,116,219,210,335,1557,2584,6,15641,868,0,0
87,2932,773,419,590,28,0,166,801,10,204,113,217,214,330,1598,2554,5,13587,754,0,1
118,4695,1513,682,1277,25,13,200,1538,11,199,116,219,210,335,1557,2584,6,15641,868,0,1
21,432,601,196,481,2,23,85,603,8,63,36,72,71,108,400,664,4,3036,168,0,1
21,432,156,79,106,5,16,28,161,5,14,8,15,19,23,64,97,2,261,14,0,1
15,541,601,196,481,2,23,85,603,8,63,36,72,71,108,400,664,4,3036,168,0,1
21,432,601,196,481,2,23,85,603,8,63,36,72,71,108,400,664,4,3036,168,0,0
21,432,156,79,106,5,16,28,161,5,14,8,15,19,23,64,97,2,261,14,0,0
15,541,601,196,481,2,23,85,603,8,63,36,72,71,108,400,664,4,3036,168,0,0
87,2932,773,419,590,28,0,166,801,10,204,113,217,214,330,1598,2554,5,13587,754,0,0
118,4695,1513,682,1277,25,13,200,1538,11,199,116,219,210,335,1557,2584,6,15641,868,0,0
349,7042,1457,730,1242,11,6,188,1468,10,292,166,329,302,495,2424,4078,5,22973,1276,1,1
349,7042,74,35,59,1,0,14,75,3,14,7,14,17,21,58,85,1,128,7,0,1
349,7042,245,125,200,5,7,34,250,7,30,17,34,37,51,166,265,3,1053,58,0,1
95,1819,1020,354,843,12,15,144,1032,8,134,77,144,142,221,970,1580,4,6792,377,0,0
72,3105,1020,354,843,12,15,144,1032,8,134,77,144,142,221,970,1580,4,6792,377,0,0
19,409,601,196,481,2,23,85,603,8,63,36,72,71,108,400,664,4,3036,168,0,0
19,409,156,79,106,5,16,28,161,5,14,8,15,19,23,64,97,2,261,14,0,0
212,5063,722,423,573,19,0,135,741,12,172,101,199,184,300,1320,2257,6,15668,870,0,0
212,5063,1508,847,911,44,250,301,1552,14,148,88,169,162,257,1120,1886,7,15077,837,0,0
74,1418,757,253,292,73,244,162,830,13,61,38,67,74,105,409,651,7,4654,258,0,1
255,6154,72,33,56,0,4,12,72,1,1,1,1,2,2,0,2,0,1,0,0,0
255,6154,1454,835,1044,76,110,219,1530,17,275,158,296,292,454,2297,3718,9,34017,1889,1,0
74,1418,757,253,292,73,244,162,830,13,61,38,67,74,105,409,651,7,4654,258,0,0
255,6152,72,33,56,0,4,12,72,1,1,1,1,2,2,0,2,0,1,0,0,0
255,6152,1454,835,1044,76,110,219,1530,17,275,158,296,292,454,2297,3718,9,34017,1889,1,0
98,4449,1338,495,1086,10,64,173,1348,11,122,82,157,133,239,883,1686,7,11934,663,0,1
132,5719,1782,648,1425,9,47,279,1791,8,171,97,189,179,286,1292,2140,4,9462,525,0,1
72,3114,1020,354,843,12,15,144,1032,8,134,77,144,142,221,970,1580,4,6792,377,0,1
36,1591,386,256,301,16,9,68,402,4,59,35,69,63,104,355,621,2,1453,80,0,1
15,568,601,196,481,2,23,85,603,8,63,36,72,71,108,400,664,4,3036,168,0,1
48,1795,1098,241,925,5,10,155,1103,7,46,25,49,53,74,273,423,3,1580,87,0,0
98,4449,1338,495,1086,10,64,173,1348,11,122,82,157,133,239,883,1686,7,11934,663,0,0
132,5719,1782,648,1425,9,47,279,1791,8,171,97,189,179,286,1292,2140,4,9462,525,0,0
72,3114,1020,354,843,12,15,144,1032,8,134,77,144,142,221,970,1580,4,6792,377,0,0
36,1591,386,256,301,16,9,68,402,4,59,35,69,63,104,355,621,2,1453,80,0,0
15,568,601,196,481,2,23,85,603,8,63,36,72,71,108,400,664,4,3036,168,0,0
60,1677,1455,414,1257,16,76,112,1471,5,41,23,46,46,69,231,381,2,1069,59,0,0
60,1677,669,365,481,22,61,110,691,15,103,63,122,118,185,747,1273,8,11311,628,0,0
131,2635,1513,682,1277,25,13,200,1538,11,199,116,219,210,335,1557,2584,6,15641,868,0,1
131,2635,819,519,539,24,98,155,843,15,96,57,106,111,163,690,1107,8,9171,509,0,1
349,7042,1457,730,1242,11,6,188,1468,10,292,166,329,302,495,2424,4078,5,22973,1276,1,0
349,7042,74,35,59,1,0,14,75,3,14,7,14,17,21,58,85,1,128,7,0,0
349,7042,245,125,200,5,7,34,250,7,30,17,34,37,51,166,265,3,1053,58,0,0
131,2635,1513,682,1277,25,13,200,1538,11,199,116,219,210,335,1557,2584,6,15641,868,0,0
131,2635,819,519,539,24,98,155,843,15,96,57,106,111,163,690,1107,8,9171,509,0,0
65,3005,1455,414,1257,16,76,112,1471,5,41,23,46,46,69,231,381,2,1069,59,0,0
21,433,601,196,481,2,23,85,603,8,63,36,72,71,108,400,664,4,3036,168,0,0
21,433,156,79,106,5,16,28,161,5,14,8,15,19,23,64,97,2,261,14,0,0
315,7207,72,33,56,0,4,12,72,1,1,1,1,2,2,0,2,0,1,0,0,0
315,7207,1454,835,1044,76,110,219,1530,17,275,158,296,292,454,2297,3718,9,34017,1889,1,0
103,1955,1178,367,1042,6,15,115,1184,9,94,51,95,103,146,644,976,4,4439,246,0,1
103,1955,177,108,140,8,0,27,185,6,30,16,32,36,48,162,248,3,794,44,0,1
103,1955,1178,367,1042,6,15,115,1184,9,94,51,95,103,146,644,976,4,4439,246,0,0
103,1955,177,108,140,8,0,27,185,6,30,16,32,36,48,162,248,3,794,44,0,0
132,2651,1513,682,1277,25,13,200,1538,11,199,116,219,210,335,1557,2584,6,15641,868,0,0
132,2651,819,519,539,24,98,155,843,15,96,57,106,111,163,690,1107,8,9171,509,0,0
118,4765,1513,682,1277,25,13,200,1538,11,199,116,219,210,335,1557,2584,6,15641,868,0,0
78,1458,757,253,292,73,244,162,830,13,61,38,67,74,105,409,651,7,4654,258,0,0
75,1461,757,253,292,73,244,162,830,13,61,38,67,74,105,409,651,7,4654,258,0,0
54,3424,520,294,400,33,13,81,553,10,261,204,367,271,571,2128,4614,7,32445,1802,1,0
161,7070,139,89,101,2,0,35,141,7,54,34,62,61,96,330,569,4,2287,127,0,1
161,7070,7,5,5,0,0,2,7,1,2,1,2,3,3,2,4,0,2,0,0,1
229,5170,4293,999,3693,19,54,507,4312,9,155,88,170,164,258,1156,1898,4,9368,520,0,1
229,5170,1482,859,1002,125,135,219,1607,16,219,134,251,235,385,1766,3032,9,27804,1544,1,1
161,7059,139,89,101,2,0,35,141,7,54,34,62,61,96,330,569,4,2287,127,0,1
161,7059,7,5,5,0,0,2,7,1,2,1,2,3,3,2,4,0,2,0,0,1
11,410,42,7,35,4,0,5,46,1,2,1,2,3,3,2,4,0,2,0,0,1
11,410,11,6,10,0,0,1,11,2,4,2,4,6,6,10,15,1,15,0,0,1
255,6153,72,33,56,0,4,12,72,1,1,1,1,2,2,0,2,0,1,0,0,0
255,6153,1454,835,1044,76,110,219,1530,17,275,158,296,292,454,2297,3718,9,34017,1889,1,0
50,586,647,139,84,35,284,233,682,0,0,0,0,0,0,0,0,0,0,0,0,0
192,3949,1943,715,1694,26,18,214,1969,12,185,120,237,197,357,1436,2721,7,20915,1161,0,0
192,3949,1168,838,957,57,25,144,1225,19,348,224,416,367,640,3018,5452,11,61921,3440,1,0
75,3810,1943,715,1694,26,18,214,1969,12,185,120,237,197,357,1436,2721,7,20915,1161,0,0
57,1306,996,429,845,24,10,117,1020,7,76,50,88,83,138,494,879,4,3565,198,0,0
57,1306,456,277,329,12,42,72,468,13,85,50,97,98,147,592,972,7,7212,400,0,0
58,1312,996,429,845,24,10,117,1020,7,76,50,88,83,138,494,879,4,3565,198,0,0
58,1312,456,277,329,12,42,72,468,13,85,50,97,98,147,592,972,7,7212,400,0,0
59,1352,996,429,845,24,10,117,1020,7,76,50,88,83,138,494,879,4,3565,198,0,0
59,1352,456,277,329,12,42,72,468,13,85,50,97,98,147,592,972,7,7212,400,0,0
227,5131,4293,999,3693,19,54,507,4312,9,155,88,170,164,258,1156,1898,4,9368,520,0,1
227,5131,1482,859,1002,125,135,219,1607,16,219,134,251,235,385,1766,3032,9,27804,1544,1,1
184,4247,77,34,69,0,0,8,77,3,24,16,29,27,45,114,213,1,387,21,0,1
184,4247,712,438,573,51,9,84,763,14,102,71,128,116,199,733,1364,8,11988,666,0,1
18,466,205,80,86,16,53,53,221,7,18,10,19,25,29,94,134,3,497,27,0,1
255,6153,72,33,56,0,4,12,72,1,1,1,1,2,2,0,2,0,1,0,0,1
255,6153,1454,835,1044,76,110,219,1530,17,275,158,296,292,454,2297,3718,9,34017,1889,1,1
112,2470,1043,504,840,53,9,147,1096,9,180,112,198,189,310,1377,2344,4,11604,644,0,1
112,2470,383,288,292,26,6,62,409,11,65,38,67,76,105,429,656,5,3719,206,0,1
102,1930,1178,367,1042,6,15,115,1184,9,94,51,95,103,146,644,976,4,4439,246,0,1
102,1930,177,108,140,8,0,27,185,6,30,16,32,36,48,162,248,3,794,44,0,1
75,2972,1043,504,840,53,9,147,1096,9,180,112,198,189,310,1377,2344,4,11604,644,0,1
18,466,205,80,86,16,53,53,221,7,18,10,19,25,29,94,134,3,497,27,0,0
112,2470,1043,504,840,53,9,147,1096,9,180,112,198,189,310,1377,2344,4,11604,644,0,0
112,2470,383,288,292,26,6,62,409,11,65,38,67,76,105,429,656,5,3719,206,0,0
102,1930,1178,367,1042,6,15,115,1184,9,94,51,95,103,146,644,976,4,4439,246,0,0
102,1930,177,108,140,8,0,27,185,6,30,16,32,36,48,162,248,3,794,44,0,0
75,2972,1043,504,840,53,9,147,1096,9,180,112,198,189,310,1377,2344,4,11604,644,0,0
214,4602,182,127,129,0,0,53,182,5,39,21,42,44,63,217,343,2,926,51,0,1
214,4602,1165,710,800,67,119,181,1232,18,243,153,282,261,435,2000,3492,10,36473,2026,1,1
149,6984,1392,870,1177,35,17,170,1427,14,494,280,531,508,811,4473,7289,7,54850,3047,2,1
229,5170,4293,999,3693,19,54,507,4312,9,155,88,170,164,258,1156,1898,4,9368,520,0,0
229,5170,1482,859,1002,125,135,219,1607,16,219,134,251,235,385,1766,3032,9,27804,1544,1,0
11,410,42,7,35,4,0,5,46,1,2,1,2,3,3,2,4,0,2,0,0,0
11,410,11,6,10,0,0,1,11,2,4,2,4,6,6,10,15,1,15,0,0,0
161,7059,139,89,101,2,0,35,141,7,54,34,62,61,96,330,569,4,2287,127,0,0
161,7059,7,5,5,0,0,2,7,1,2,1,2,3,3,2,4,0,2,0,0,0
214,4602,182,127,129,0,0,53,182,5,39,21,42,44,63,217,343,2,926,51,0,0
214,4602,1165,710,800,67,119,181,1232,18,243,153,282,261,435,2000,3492,10,36473,2026,1,0
149,6984,1392,870,1177,35,17,170,1427,14,494,280,531,508,811,4473,7289,7,54850,3047,2,0
229,5172,4293,999,3693,19,54,507,4312,9,155,88,170,164,258,1156,1898,4,9368,520,0,0
229,5172,1482,859,1002,125,135,219,1607,16,219,134,251,235,385,1766,3032,9,27804,1544,1,0
184,4247,77,34,69,0,0,8,77,3,24,16,29,27,45,114,213,1,387,21,0,0
184,4247,712,438,573,51,9,84,763,14,102,71,128,116,199,733,1364,8,11988,666,0,0
347,7012,1457,730,1242,11,6,188,1468,10,292,166,329,302,495,2424,4078,5,22973,1276,1,0
347,7012,74,35,59,1,0,14,75,3,14,7,14,17,21,58,85,1,128,7,0,0
347,7012,245,125,200,5,7,34,250,7,30,17,34,37,51,166,265,3,1053,58,0,0
183,4238,77,34,69,0,0,8,77,3,24,16,29,27,45,114,213,1,387,21,0,0
183,4238,712,438,573,51,9,84,763,14,102,71,128,116,199,733,1364,8,11988,666,0,0
179,4137,77,34,69,0,0,8,77,3,24,16,29,27,45,114,213,1,387,21,0,0
179,4137,712,438,573,51,9,84,763,14,102,71,128,116,199,733,1364,8,11988,666,0,0
211,5051,722,423,573,19,0,135,741,12,172,101,199,184,300,1320,2257,6,15668,870,0,0
211,5051,1508,847,911,44,250,301,1552,14,148,88,169,162,257,1120,1886,7,15077,837,0,0
178,4128,77,34,69,0,0,8,77,3,24,16,29,27,45,114,213,1,387,21,0,0
178,4128,712,438,573,51,9,84,763,14,102,71,128,116,199,733,1364,8,11988,666,0,0
212,5103,722,423,573,19,0,135,741,12,172,101,199,184,300,1320,2257,6,15668,870,0,0
212,5103,1508,847,911,44,250,301,1552,14,148,88,169,162,257,1120,1886,7,15077,837,0,0
113,2497,1043,504,840,53,9,147,1096,9,180,112,198,189,310,1377,2344,4,11604,644,0,0
113,2497,383,288,292,26,6,62,409,11,65,38,67,76,105,429,656,5,3719,206,0,0
81,3461,1289,550,1043,56,32,155,1345,10,167,93,185,177,278,1266,2075,5,11498,638,0,0
113,2492,1043,504,840,53,9,147,1096,9,180,112,198,189,310,1377,2344,4,11604,644,0,0
113,2492,383,288,292,26,6,62,409,11,65,38,67,76,105,429,656,5,3719,206,0,0
193,3988,1943,715,1694,26,18,214,1969,12,185,120,237,197,357,1436,2721,7,20915,1161,0,1
193,3988,1168,838,957,57,25,144,1225,19,348,224,416,367,640,3018,5452,11,61921,3440,1,1
76,3899,1943,715,1694,26,18,214,1969,12,185,120,237,197,357,1436,2721,7,20915,1161,0,1
213,4579,182,127,129,0,0,53,182,5,39,21,42,44,63,217,343,2,926,51,0,1
213,4579,1165,710,800,67,119,181,1232,18,243,153,282,261,435,2000,3492,10,36473,2026,1,1
102,2083,773,419,590,28,0,166,801,10,204,113,217,214,330,1598,2554,5,13587,754,0,1
102,2083,421,273,302,44,34,57,465,17,81,59,107,98,166,583,1098,11,12329,684,0,1
27,540,2,2,2,0,0,0,2,0,0,0,0,0,0,0,0,0,0,0,0,1
27,540,99,48,90,1,3,5,100,0,0,0,0,0,0,0,0,0,0,0,0,1
27,540,8,5,5,2,0,1,10,0,0,0,0,0,0,0,0,0,0,0,0,1
27,540,1217,716,841,84,126,174,1301,14,185,118,215,199,333,1446,2542,8,20687,1149,0,1
27,540,160,89,115,0,13,31,160,7,15,11,17,22,28,78,124,3,495,27,0,1
27,540,10,10,9,9,0,0,19,0,0,0,0,0,0,0,0,0,0,0,0,1
27,540,173,84,99,8,29,36,181,5,12,7,13,17,20,54,81,2,221,12,0,1
27,540,3,1,1,3,0,0,6,0,0,0,0,0,0,0,0,0,0,0,0,1
164,5068,1660,832,1314,41,38,274,1701,20,312,209,395,332,604,2671,5058,12,64042,3557,1,1
164,5068,1057,646,719,113,100,145,1170,18,215,134,248,233,382,1740,3004,10,31186,1732,1,1
17,345,95,58,50,9,16,20,104,12,33,24,45,45,69,209,378,8,3100,172,0,1
86,1804,477,336,357,30,23,73,507,16,194,134,250,210,384,1538,2962,10,30538,1696,0,1
132,2644,1513,682,1277,25,13,200,1538,11,199,116,219,210,335,1557,2584,6,15641,868,0,1
132,2644,819,519,539,24,98,155,843,15,96,57,106,111,163,690,1107,8,9171,509,0,1
349,7034,1457,730,1242,11,6,188,1468,10,292,166,329,302,495,2424,4078,5,22973,1276,1,1
349,7034,74,35,59,1,0,14,75,3,14,7,14,17,21,58,85,1,128,7,0,1
349,7034,245,125,200,5,7,34,250,7,30,17,34,37,51,166,265,3,1053,58,0,1
184,4243,77,34,69,0,0,8,77,3,24,16,29,27,45,114,213,1,387,21,0,1
184,4243,712,438,573,51,9,84,763,14,102,71,128,116,199,733,1364,8,11988,666,0,1
46,957,447,308,343,6,5,95,453,7,96,59,111,103,170,651,1136,4,4600,255,0,1
46,957,322,174,179,16,74,51,338,10,41,26,46,51,72,252,408,5,2291,127,0,1
212,5055,722,423,573,19,0,135,741,12,172,101,199,184,300,1320,2257,6,15668,870,0,1
212,5055,1508,847,911,44,250,301,1552,14,148,88,169,162,257,1120,1886,7,15077,837,0,1
255,6147,72,33,56,0,4,12,72,1,1,1,1,2,2,0,2,0,1,0,0,1
255,6147,1454,835,1044,76,110,219,1530,17,275,158,296,292,454,2297,3718,9,34017,1889,1,1
129,2871,1043,504,840,53,9,147,1096,9,180,112,198,189,310,1377,2344,4,11604,644,0,1
129,2871,383,288,292,26,6,62,409,11,65,38,67,76,105,429,656,5,3719,206,0,1
192,3947,1943,715,1694,26,18,214,1969,12,185,120,237,197,357,1436,2721,7,20915,1161,0,1
192,3947,1168,838,957,57,25,144,1225,19,348,224,416,367,640,3018,5452,11,61921,3440,1,1
11,404,42,7,35,4,0,5,46,1,2,1,2,3,3,2,4,0,2,0,0,1
11,404,11,6,10,0,0,1,11,2,4,2,4,6,6,10,15,1,15,0,0,1
214,4586,182,127,129,0,0,53,182,5,39,21,42,44,63,217,343,2,926,51,0,0
214,4586,1165,710,800,67,119,181,1232,18,243,153,282,261,435,2000,3492,10,36473,2026,1,0
27,540,2,2,2,0,0,0,2,0,0,0,0,0,0,0,0,0,0,0,0,0
27,540,99,48,90,1,3,5,100,0,0,0,0,0,0,0,0,0,0,0,0,0
27,540,8,5,5,2,0,1,10,0,0,0,0,0,0,0,0,0,0,0,0,0
27,540,1217,716,841,84,126,174,1301,14,185,118,215,199,333,1446,2542,8,20687,1149,0,0
27,540,160,89,115,0,13,31,160,7,15,11,17,22,28,78,124,3,495,27,0,0
27,540,10,10,9,9,0,0,19,0,0,0,0,0,0,0,0,0,0,0,0,0
27,540,173,84,99,8,29,36,181,5,12,7,13,17,20,54,81,2,221,12,0,0
27,540,3,1,1,3,0,0,6,0,0,0,0,0,0,0,0,0,0,0,0,0
164,5068,1660,832,1314,41,38,274,1701,20,312,209,395,332,604,2671,5058,12,64042,3557,1,0
164,5068,1057,646,719,113,100,145,1170,18,215,134,248,233,382,1740,3004,10,31186,1732,1,0
17,345,95,58,50,9,16,20,104,12,33,24,45,45,69,209,378,8,3100,172,0,0
86,1804,477,336,357,30,23,73,507,16,194,134,250,210,384,1538,2962,10,30538,1696,0,0
132,2644,1513,682,1277,25,13,200,1538,11,199,116,219,210,335,1557,2584,6,15641,868,0,0
132,2644,819,519,539,24,98,155,843,15,96,57,106,111,163,690,1107,8,9171,509,0,0
347,7004,1457,730,1242,11,6,188,1468,10,292,166,329,302,495,2424,4078,5,22973,1276,1,0
347,7004,74,35,59,1,0,14,75,3,14,7,14,17,21,58,85,1,128,7,0,0
347,7004,245,125,200,5,7,34,250,7,30,17,34,37,51,166,265,3,1053,58,0,0
46,957,447,308,343,6,5,95,453,7,96,59,111,103,170,651,1136,4,4600,255,0,0
46,957,322,174,179,16,74,51,338,10,41,26,46,51,72,252,408,5,2291,127,0,0
211,5043,722,423,573,19,0,135,741,12,172,101,199,184,300,1320,2257,6,15668,870,0,0
211,5043,1508,847,911,44,250,301,1552,14,148,88,169,162,257,1120,1886,7,15077,837,0,0
255,6147,72,33,56,0,4,12,72,1,1,1,1,2,2,0,2,0,1,0,0,0
255,6147,1454,835,1044,76,110,219,1530,17,275,158,296,292,454,2297,3718,9,34017,1889,1,0
112,2466,1043,504,840,53,9,147,1096,9,180,112,198,189,310,1377,2344,4,11604,644,0,0
112,2466,383,288,292,26,6,62,409,11,65,38,67,76,105,429,656,5,3719,206,0,0
102,1928,1178,367,1042,6,15,115,1184,9,94,51,95,103,146,644,976,4,4439,246,0,0
102,1928,177,108,140,8,0,27,185,6,30,16,32,36,48,162,248,3,794,44,0,0
192,3947,1943,715,1694,26,18,214,1969,12,185,120,237,197,357,1436,2721,7,20915,1161,0,0
192,3947,1168,838,957,57,25,144,1225,19,348,224,416,367,640,3018,5452,11,61921,3440,1,0
11,412,42,7,35,4,0,5,46,1,2,1,2,3,3,2,4,0,2,0,0,0
11,412,11,6,10,0,0,1,11,2,4,2,4,6,6,10,15,1,15,0,0,0
193,3988,1943,715,1694,26,18,214,1969,12,185,120,237,197,357,1436,2721,7,20915,1161,0,0
193,3988,1168,838,957,57,25,144,1225,19,348,224,416,367,640,3018,5452,11,61921,3440,1,0
76,3899,1943,715,1694,26,18,214,1969,12,185,120,237,197,357,1436,2721,7,20915,1161,0,0
351,7048,1457,730,1242,11,6,188,1468,10,292,166,329,302,495,2424,4078,5,22973,1276,1,0
351,7048,74,35,59,1,0,14,75,3,14,7,14,17,21,58,85,1,128,7,0,0
351,7048,245,125,200,5,7,34,250,7,30,17,34,37,51,166,265,3,1053,58,0,0
79,4191,1457,730,1242,11,6,188,1468,10,292,166,329,302,495,2424,4078,5,22973,1276,1,0
133,2659,1513,682,1277,25,13,200,1538,11,199,116,219,210,335,1557,2584,6,15641,868,0,0
133,2659,819,519,539,24,98,155,843,15,96,57,106,111,163,690,1107,8,9171,509,0,0
120,4833,1513,682,1277,25,13,200,1538,11,199,116,219,210,335,1557,2584,6,15641,868,0,0
93,1794,1020,354,843,12,15,144,1032,8,134,77,144,142,221,970,1580,4,6792,377,0,1
255,6154,72,33,56,0,4,12,72,1,1,1,1,2,2,0,2,0,1,0,0,1
255,6154,1454,835,1044,76,110,219,1530,17,275,158,296,292,454,2297,3718,9,34017,1889,1,1
132,5724,1782,648,1425,9,47,279,1791,8,171,97,189,179,286,1292,2140,4,9462,525,0,1
229,5176,4293,999,3693,19,54,507,4312,9,155,88,170,164,258,1156,1898,4,9368,520,0,0
229,5176,1482,859,1002,125,135,219,1607,16,219,134,251,235,385,1766,3032,9,27804,1544,1,0
106,1993,1178,367,1042,6,15,115,1184,9,94,51,95,103,146,644,976,4,4439,246,0,0
106,1993,177,108,140,8,0,27,185,6,30,16,32,36,48,162,248,3,794,44,0,0
72,3050,1178,367,1042,6,15,115,1184,9,94,51,95,103,146,644,976,4,4439,246,0,0
93,1794,1020,354,843,12,15,144,1032,8,134,77,144,142,221,970,1580,4,6792,377,0,0
132,5724,1782,648,1425,9,47,279,1791,8,171,97,189,179,286,1292,2140,4,9462,525,0,0
58,1227,207,111,150,11,0,50,218,5,26,19,36,31,55,133,272,3,943,52,0,1
58,1227,410,198,237,31,55,97,441,11,63,38,72,74,110,414,683,6,4293,238,0,1
228,5164,4293,999,3693,19,54,507,4312,9,155,88,170,164,258,1156,1898,4,9368,520,0,1
228,5164,1482,859,1002,125,135,219,1607,16,219,134,251,235,385,1766,3032,9,27804,1544,1,1
98,4450,1338,495,1086,10,64,173,1348,11,122,82,157,133,239,883,1686,7,11934,663,0,1
162,7089,139,89,101,2,0,35,141,7,54,34,62,61,96,330,569,4,2287,127,0,1
162,7089,7,5,5,0,0,2,7,1,2,1,2,3,3,2,4,0,2,0,0,1
55,1193,207,111,150,11,0,50,218,5,26,19,36,31,55,133,272,3,943,52,0,1
55,1193,410,198,237,31,55,97,441,11,63,38,72,74,110,414,683,6,4293,238,0,1
14,341,207,111,150,11,0,50,218,5,26,19,36,31,55,133,272,3,943,52,0,1
11,414,42,7,35,4,0,5,46,1,2,1,2,3,3,2,4,0,2,0,0,0
11,414,11,6,10,0,0,1,11,2,4,2,4,6,6,10,15,1,15,0,0,0
347,7002,1457,730,1242,11,6,188,1468,10,292,166,329,302,495,2424,4078,5,22973,1276,1,0
347,7002,74,35,59,1,0,14,75,3,14,7,14,17,21,58,85,1,128,7,0,0
347,7002,245,125,200,5,7,34,250,7,30,17,34,37,51,166,265,3,1053,58,0,0
50,584,647,139,84,35,284,233,682,0,0,0,0,0,0,0,0,0,0,0,0,0
255,6150,72,33,56,0,4,12,72,1,1,1,1,2,2,0,2,0,1,0,0,0
255,6150,1454,835,1044,76,110,219,1530,17,275,158,296,292,454,2297,3718,9,34017,1889,1,0
192,3943,1943,715,1694,26,18,214,1969,12,185,120,237,197,357,1436,2721,7,20915,1161,0,0
192,3943,1168,838,957,57,25,144,1225,19,348,224,416,367,640,3018,5452,11,61921,3440,1,0
75,3806,1943,715,1694,26,18,214,1969,12,185,120,237,197,357,1436,2721,7,20915,1161,0,0
54,1170,207,111,150,11,0,50,218,5,26,19,36,31,55,133,272,3,943,52,0,0
54,1170,410,198,237,31,55,97,441,11,63,38,72,74,110,414,683,6,4293,238,0,0
214,4608,182,127,129,0,0,53,182,5,39,21,42,44,63,217,343,2,926,51,0,1
214,4608,1165,710,800,67,119,181,1232,18,243,153,282,261,435,2000,3492,10,36473,2026,1,1
36,1085,182,127,129,0,0,53,182,5,39,21,42,44,63,217,343,2,926,51,0,1
55,1193,207,111,150,11,0,50,218,5,26,19,36,31,55,133,272,3,943,52,0,0
55,1193,410,198,237,31,55,97,441,11,63,38,72,74,110,414,683,6,4293,238,0,0
14,341,207,111,150,11,0,50,218,5,26,19,36,31,55,133,272,3,943,52,0,0
214,4608,182,127,129,0,0,53,182,5,39,21,42,44,63,217,343,2,926,51,0,0
214,4608,1165,710,800,67,119,181,1232,18,243,153,282,261,435,2000,3492,10,36473,2026,1,0
36,1085,182,127,129,0,0,53,182,5,39,21,42,44,63,217,343,2,926,51,0,0
212,5013,722,423,573,19,0,135,741,12,172,101,199,184,300,1320,2257,6,15668,870,0,1
212,5013,1508,847,911,44,250,301,1552,14,148,88,169,162,257,1120,1886,7,15077,837,0,1
16,677,722,423,573,19,0,135,741,12,172,101,199,184,300,1320,2257,6,15668,870,0,1
7,281,75,38,59,1,3,12,76,2,4,2,4,6,6,10,15,1,15,0,0,0
212,5013,722,423,573,19,0,135,741,12,172,101,199,184,300,1320,2257,6,15668,870,0,0
212,5013,1508,847,911,44,250,301,1552,14,148,88,169,162,257,1120,1886,7,15077,837,0,0
16,677,722,423,573,19,0,135,741,12,172,101,199,184,300,1320,2257,6,15668,870,0,0
345,6927,1457,730,1242,11,6,188,1468,10,292,166,329,302,495,2424,4078,5,22973,1276,1,1
345,6927,74,35,59,1,0,14,75,3,14,7,14,17,21,58,85,1,128,7,0,1
345,6927,245,125,200,5,7,34,250,7,30,17,34,37,51,166,265,3,1053,58,0,1
33,1889,384,251,317,7,8,52,391,11,70,44,84,81,128,467,811,6,5355,297,0,1
48,1795,1098,241,925,5,10,155,1103,7,46,25,49,53,74,273,423,3,1580,87,0,1
39,1758,386,256,301,16,9,68,402,4,59,35,69,63,104,355,621,2,1453,80,0,1
57,1218,207,111,150,11,0,50,218,5,26,19,36,31,55,133,272,3,943,52,0,0
57,1218,410,198,237,31,55,97,441,11,63,38,72,74,110,414,683,6,4293,238,0,0
210,4982,722,423,573,19,0,135,741,12,172,101,199,184,300,1320,2257,6,15668,870,0,0
210,4982,1508,847,911,44,250,301,1552,14,148,88,169,162,257,1120,1886,7,15077,837,0,0
72,3743,1296,573,1062,40,33,157,1336,8,201,118,231,209,349,1561,2689,4,12365,686,0,0
58,1228,207,111,150,11,0,50,218,5,26,19,36,31,55,133,272,3,943,52,0,1
58,1228,410,198,237,31,55,97,441,11,63,38,72,74,110,414,683,6,4293,238,0,1
214,4592,182,127,129,0,0,53,182,5,39,21,42,44,63,217,343,2,926,51,0,0
214,4592,1165,710,800,67,119,181,1232,18,243,153,282,261,435,2000,3492,10,36473,2026,1,0
133,2652,1513,682,1277,25,13,200,1538,11,199,116,219,210,335,1557,2584,6,15641,868,0,0
133,2652,819,519,539,24,98,155,843,15,96,57,106,111,163,690,1107,8,9171,509,0,0
349,7008,1457,730,1242,11,6,188,1468,10,292,166,329,302,495,2424,4078,5,22973,1276,1,0
349,7008,74,35,59,1,0,14,75,3,14,7,14,17,21,58,85,1,128,7,0,0
349,7008,245,125,200,5,7,34,250,7,30,17,34,37,51,166,265,3,1053,58,0,0
210,5022,722,423,573,19,0,135,741,12,172,101,199,184,300,1320,2257,6,15668,870,0,0
210,5022,1508,847,911,44,250,301,1552,14,148,88,169,162,257,1120,1886,7,15077,837,0,0
113,2488,1043,504,840,53,9,147,1096,9,180,112,198,189,310,1377,2344,4,11604,644,0,0
113,2488,383,288,292,26,6,62,409,11,65,38,67,76,105,429,656,5,3719,206,0,0
193,3982,1943,715,1694,26,18,214,1969,12,185,120,237,197,357,1436,2721,7,20915,1161,0,0
193,3982,1168,838,957,57,25,144,1225,19,348,224,416,367,640,3018,5452,11,61921,3440,1,0
76,3895,1943,715,1694,26,18,214,1969,12,185,120,237,197,357,1436,2721,7,20915,1161,0,0
57,1224,207,111,150,11,0,50,218,5,26,19,36,31,55,133,272,3,943,52,0,0
57,1224,410,198,237,31,55,97,441,11,63,38,72,74,110,414,683,6,4293,238,0,0
58,1234,207,111,150,11,0,50,218,5,26,19,36,31,55,133,272,3,943,52,0,0
58,1234,410,198,237,31,55,97,441,11,63,38,72,74,110,414,683,6,4293,238,0,0
228,5164,4293,999,3693,19,54,507,4312,9,155,88,170,164,258,1156,1898,4,9368,520,0,0
228,5164,1482,859,1002,125,135,219,1607,16,219,134,251,235,385,1766,3032,9,27804,1544,1,0
98,4450,1338,495,1086,10,64,173,1348,11,122,82,157,133,239,883,1686,7,11934,663,0,0
162,7089,139,89,101,2,0,35,141,7,54,34,62,61,96,330,569,4,2287,127,0,0
162,7089,7,5,5,0,0,2,7,1,2,1,2,3,3,2,4,0,2,0,0,0
347,6933,1457,730,1242,11,6,188,1468,10,292,166,329,302,495,2424,4078,5,22973,1276,1,0
347,6933,74,35,59,1,0,14,75,3,14,7,14,17,21,58,85,1,128,7,0,0
347,6933,245,125,200,5,7,34,250,7,30,17,34,37,51,166,265,3,1053,58,0,0
33,1889,384,251,317,7,8,52,391,11,70,44,84,81,128,467,811,6,5355,297,0,0
46,954,386,256,301,16,9,68,402,4,59,35,69,63,104,355,621,2,1453,80,0,1
46,954,264,131,164,11,41,46,275,6,38,22,40,44,62,214,338,3,1068,59,0,1
39,1774,386,256,301,16,9,68,402,4,59,35,69,63,104,355,621,2,1453,80,0,1
46,954,386,256,301,16,9,68,402,4,59,35,69,63,104,355,621,2,1453,80,0,0
46,954,264,131,164,11,41,46,275,6,38,22,40,44,62,214,338,3,1068,59,0,0
39,1774,386,256,301,16,9,68,402,4,59,35,69,63,104,355,621,2,1453,80,0,0
11,235,19,8,11,5,0,4,24,2,5,3,6,7,9,13,25,1,30,1,0,0
11,235,102,59,69,5,3,24,107,6,22,15,28,28,43,113,206,3,789,43,0,0
11,235,106,40,36,3,49,17,109,8,17,13,23,25,36,93,167,5,904,50,0,0
23,607,102,59,69,5,3,24,107,6,22,15,28,28,43,113,206,3,789,43,0,0
60,1265,207,111,150,11,0,50,218,5,26,19,36,31,55,133,272,3,943,52,0,0
60,1265,410,198,237,31,55,97,441,11,63,38,72,74,110,414,683,6,4293,238,0,0
96,1828,1020,354,843,12,15,144,1032,8,134,77,144,142,221,970,1580,4,6792,377,0,1
73,3219,1020,354,843,12,15,144,1032,8,134,77,144,142,221,970,1580,4,6792,377,0,1
96,1828,1020,354,843,12,15,144,1032,8,134,77,144,142,221,970,1580,4,6792,377,0,0
73,3219,1020,354,843,12,15,144,1032,8,134,77,144,142,221,970,1580,4,6792,377,0,0
87,2923,773,419,590,28,0,166,801,10,204,113,217,214,330,1598,2554,5,13587,754,0,0
189,4316,77,34,69,0,0,8,77,3,24,16,29,27,45,114,213,1,387,21,0,0
189,4316,712,438,573,51,9,84,763,14,102,71,128,116,199,733,1364,8,11988,666,0,0
81,3472,1289,550,1043,56,32,155,1345,10,167,93,185,177,278,1266,2075,5,11498,638,0,0
94,1803,1020,354,843,12,15,144,1032,8,134,77,144,142,221,970,1580,4,6792,377,0,0
256,6158,72,33,56,0,4,12,72,1,1,1,1,2,2,0,2,0,1,0,0,0
256,6158,1454,835,1044,76,110,219,1530,17,275,158,296,292,454,2297,3718,9,34017,1889,1,0
6,329,180,34,164,0,0,16,180,1,12,6,12,13,18,43,66,0,33,1,0,0
345,6924,1457,730,1242,11,6,188,1468,10,292,166,329,302,495,2424,4078,5,22973,1276,1,0
345,6924,74,35,59,1,0,14,75,3,14,7,14,17,21,58,85,1,128,7,0,0
345,6924,245,125,200,5,7,34,250,7,30,17,34,37,51,166,265,3,1053,58,0,0
33,1914,384,251,317,7,8,52,391,11,70,44,84,81,128,467,811,6,5355,297,0,1
347,6933,1457,730,1242,11,6,188,1468,10,292,166,329,302,495,2424,4078,5,22973,1276,1,1
347,6933,74,35,59,1,0,14,75,3,14,7,14,17,21,58,85,1,128,7,0,1
347,6933,245,125,200,5,7,34,250,7,30,17,34,37,51,166,265,3,1053,58,0,1
67,1798,773,422,505,30,103,129,803,14,77,46,83,91,129,535,839,7,6334,351,0,1
67,1800,773,422,505,30,103,129,803,14,77,46,83,91,129,535,839,7,6334,351,0,0
1,142,127,75,83,2,11,30,129,4,14,7,14,18,21,61,87,2,175,9,0,0
1,142,652,304,544,16,6,88,668,6,89,51,101,95,152,591,998,3,3399,188,0,0
1,142,2,2,2,0,0,0,2,0,0,0,0,0,0,0,0,0,0,0,0,0
1,142,8,5,5,0,0,3,8,0,0,0,0,0,0,0,0,0,0,0,0,0
1,142,14,8,8,0,0,6,14,0,0,0,0,0,0,0,0,0,0,0,0,0
1,142,6,4,4,0,0,2,6,0,0,0,0,0,0,0,0,0,0,0,0,0
1,142,6,4,4,0,0,2,6,1,2,1,2,3,3,2,4,0,2,0,0,0
1,142,7,5,5,0,0,2,7,0,0,0,0,0,0,0,0,0,0,0,0,0
1,142,10,6,6,0,0,4,10,0,0,0,0,0,0,0,0,0,0,0,0,0
1,142,1,1,1,0,0,0,1,0,0,0,0,0,0,0,0,0,0,0,0,0
1,142,14,10,10,0,0,4,14,1,1,1,1,2,2,0,2,0,1,0,0,0
1,142,46,26,30,3,0,12,49,3,6,3,6,9,9,20,28,1,42,2,0,0
3,143,207,111,150,11,0,50,218,5,26,19,36,31,55,133,272,3,943,52,0,0
9,464,139,89,101,2,0,35,141,7,54,34,62,61,96,330,569,4,2287,127,0,0
21,1023,1157,318,931,29,22,177,1186,6,104,63,125,110,188,712,1274,3,4596,255,0,0
67,1769,773,422,505,30,103,129,803,14,77,46,83,91,129,535,839,7,6334,351,0,0
64,1733,773,422,505,30,103,129,803,14,77,46,83,91,129,535,839,7,6334,351,0,0
63,1708,773,422,505,30,103,129,803,14,77,46,83,91,129,535,839,7,6334,351,0,0
63,1707,773,422,505,30,103,129,803,14,77,46,83,91,129,535,839,7,6334,351,0,0
62,1696,773,422,505,30,103,129,803,14,77,46,83,91,129,535,839,7,6334,351,0,1
62,1696,773,422,505,30,103,129,803,14,77,46,83,91,129,535,839,7,6334,351,0,0
62,1692,773,422,505,30,103,129,803,14,77,46,83,91,129,535,839,7,6334,351,0,0
62,1704,773,422,505,30,103,129,803,14,77,46,83,91,129,535,839,7,6334,351,0,0
62,1710,773,422,505,30,103,129,803,14,77,46,83,91,129,535,839,7,6334,351,0,0
62,1694,773,422,505,30,103,129,803,14,77,46,83,91,129,535,839,7,6334,351,0,0
60,1687,773,422,505,30,103,129,803,14,77,46,83,91,129,535,839,7,6334,351,0,0
60,1685,773,422,505,30,103,129,803,14,77,46,83,91,129,535,839,7,6334,351,0,0
48,1364,773,422,505,30,103,129,803,14,77,46,83,91,129,535,839,7,6334,351,0,0
7,392,139,89,101,2,0,35,141,7,54,34,62,61,96,330,569,4,2287,127,0,0
135,2719,1513,682,1277,25,13,200,1538,11,199,116,219,210,335,1557,2584,6,15641,868,0,1
135,2719,819,519,539,24,98,155,843,15,96,57,106,111,163,690,1107,8,9171,509,0,1
121,4909,1513,682,1277,25,13,200,1538,11,199,116,219,210,335,1557,2584,6,15641,868,0,1
135,2721,1513,682,1277,25,13,200,1538,11,199,116,219,210,335,1557,2584,6,15641,868,0,1
135,2721,819,519,539,24,98,155,843,15,96,57,106,111,163,690,1107,8,9171,509,0,1
195,4023,1943,715,1694,26,18,214,1969,12,185,120,237,197,357,1436,2721,7,20915,1161,0,0
195,4023,1168,838,957,57,25,144,1225,19,348,224,416,367,640,3018,5452,11,61921,3440,1,0
188,4296,77,34,69,0,0,8,77,3,24,16,29,27,45,114,213,1,387,21,0,0
188,4296,712,438,573,51,9,84,763,14,102,71,128,116,199,733,1364,8,11988,666,0,0
135,2731,1513,682,1277,25,13,200,1538,11,199,116,219,210,335,1557,2584,6,15641,868,0,1
135,2731,819,519,539,24,98,155,843,15,96,57,106,111,163,690,1107,8,9171,509,0,1
123,4965,1513,682,1277,25,13,200,1538,11,199,116,219,210,335,1557,2584,6,15641,868,0,1
96,1829,1020,354,843,12,15,144,1032,8,134,77,144,142,221,970,1580,4,6792,377,0,0
20,509,205,80,86,16,53,53,221,7,18,10,19,25,29,94,134,3,497,27,0,0
74,3107,1178,367,1042,6,15,115,1184,9,94,51,95,103,146,644,976,4,4439,246,0,0
21,438,601,196,481,2,23,85,603,8,63,36,72,71,108,400,664,4,3036,168,0,0
21,438,156,79,106,5,16,28,161,5,14,8,15,19,23,64,97,2,261,14,0,0
16,610,601,196,481,2,23,85,603,8,63,36,72,71,108,400,664,4,3036,168,0,0
60,1265,207,111,150,11,0,50,218,5,26,19,36,31,55,133,272,3,943,52,0,1
60,1265,410,198,237,31,55,97,441,11,63,38,72,74,110,414,683,6,4293,238,0,1
255,6150,72,33,56,0,4,12,72,1,1,1,1,2,2,0,2,0,1,0,0,1
255,6150,1454,835,1044,76,110,219,1530,17,275,158,296,292,454,2297,3718,9,34017,1889,1,1
21,436,601,196,481,2,23,85,603,8,63,36,72,71,108,400,664,4,3036,168,0,1
21,436,156,79,106,5,16,28,161,5,14,8,15,19,23,64,97,2,261,14,0,1
16,610,601,196,481,2,23,85,603,8,63,36,72,71,108,400,664,4,3036,168,0,1
21,436,601,196,481,2,23,85,603,8,63,36,72,71,108,400,664,4,3036,168,0,0
21,436,156,79,106,5,16,28,161,5,14,8,15,19,23,64,97,2,261,14,0,0
94,1804,1020,354,843,12,15,144,1032,8,134,77,144,142,221,970,1580,4,6792,377,0,0
256,6155,72,33,56,0,4,12,72,1,1,1,1,2,2,0,2,0,1,0,0,0
256,6155,1454,835,1044,76,110,219,1530,17,275,158,296,292,454,2297,3718,9,34017,1889,1,0
106,2001,1178,367,1042,6,15,115,1184,9,94,51,95,103,146,644,976,4,4439,246,0,0
106,2001,177,108,140,8,0,27,185,6,30,16,32,36,48,162,248,3,794,44,0,0
74,3124,1178,367,1042,6,15,115,1184,9,94,51,95,103,146,644,976,4,4439,246,0,0
62,1228,1098,241,925,5,10,155,1103,7,46,25,49,53,74,273,423,3,1580,87,0,0
62,1228,282,202,222,14,2,44,296,8,42,24,43,50,67,250,378,4,1548,86,0,0
62,1222,1098,241,925,5,10,155,1103,7,46,25,49,53,74,273,423,3,1580,87,0,0
62,1222,282,202,222,14,2,44,296,8,42,24,43,50,67,250,378,4,1548,86,0,0
106,1987,1178,367,1042,6,15,115,1184,9,94,51,95,103,146,644,976,4,4439,246,0,1
106,1987,177,108,140,8,0,27,185,6,30,16,32,36,48,162,248,3,794,44,0,1
62,1222,1098,241,925,5,10,155,1103,7,46,25,49,53,74,273,423,3,1580,87,0,1
62,1222,282,202,222,14,2,44,296,8,42,24,43,50,67,250,378,4,1548,86,0,1
110,2074,1178,367,1042,6,15,115,1184,9,94,51,95,103,146,644,976,4,4439,246,0,1
110,2074,177,108,140,8,0,27,185,6,30,16,32,36,48,162,248,3,794,44,0,1
110,2074,1178,367,1042,6,15,115,1184,9,94,51,95,103,146,644,976,4,4439,246,0,0
110,2074,177,108,140,8,0,27,185,6,30,16,32,36,48,162,248,3,794,44,0,0
108,2058,1178,367,1042,6,15,115,1184,9,94,51,95,103,146,644,976,4,4439,246,0,0
108,2058,177,108,140,8,0,27,185,6,30,16,32,36,48,162,248,3,794,44,0,0
229,5184,4293,999,3693,19,54,507,4312,9,155,88,170,164,258,1156,1898,4,9368,520,0,0
229,5184,1482,859,1002,125,135,219,1607,16,219,134,251,235,385,1766,3032,9,27804,1544,1,0
229,5193,4293,999,3693,19,54,507,4312,9,155,88,170,164,258,1156,1898,4,9368,520,0,0
229,5193,1482,859,1002,125,135,219,1607,16,219,134,251,235,385,1766,3032,9,27804,1544,1,0
74,3250,1020,354,843,12,15,144,1032,8,134,77,144,142,221,970,1580,4,6792,377,0,0
135,2731,1513,682,1277,25,13,200,1538,11,199,116,219,210,335,1557,2584,6,15641,868,0,0
135,2731,819,519,539,24,98,155,843,15,96,57,106,111,163,690,1107,8,9171,509,0,0
123,4965,1513,682,1277,25,13,200,1538,11,199,116,219,210,335,1557,2584,6,15641,868,0,0
11,394,42,7,35,4,0,5,46,1,2,1,2,3,3,2,4,0,2,0,0,1
11,394,11,6,10,0,0,1,11,2,4,2,4,6,6,10,15,1,15,0,0,1
58,1219,207,111,150,11,0,50,218,5,26,19,36,31,55,133,272,3,943,52,0,0
58,1219,410,198,237,31,55,97,441,11,63,38,72,74,110,414,683,6,4293,238,0,0
11,394,42,7,35,4,0,5,46,1,2,1,2,3,3,2,4,0,2,0,0,0
11,394,11,6,10,0,0,1,11,2,4,2,4,6,6,10,15,1,15,0,0,0
11,235,19,8,11,5,0,4,24,2,5,3,6,7,9,13,25,1,30,1,0,1
11,235,102,59,69,5,3,24,107,6,22,15,28,28,43,113,206,3,789,43,0,1
11,235,106,40,36,3,49,17,109,8,17,13,23,25,36,93,167,5,904,50,0,1
101,2069,773,419,590,28,0,166,801,10,204,113,217,214,330,1598,2554,5,13587,754,0,1
101,2069,421,273,302,44,34,57,465,17,81,59,107,98,166,583,1098,11,12329,684,0,1
26,524,2,2,2,0,0,0,2,0,0,0,0,0,0,0,0,0,0,0,0,1
26,524,99,48,90,1,3,5,100,0,0,0,0,0,0,0,0,0,0,0,0,1
26,524,8,5,5,2,0,1,10,0,0,0,0,0,0,0,0,0,0,0,0,1
26,524,1217,716,841,84,126,174,1301,14,185,118,215,199,333,1446,2542,8,20687,1149,0,1
26,524,160,89,115,0,13,31,160,7,15,11,17,22,28,78,124,3,495,27,0,1
26,524,10,10,9,9,0,0,19,0,0,0,0,0,0,0,0,0,0,0,0,1
26,524,173,84,99,8,29,36,181,5,12,7,13,17,20,54,81,2,221,12,0,1
26,524,3,1,1,3,0,0,6,0,0,0,0,0,0,0,0,0,0,0,0,1
163,5028,1660,832,1314,41,38,274,1701,20,312,209,395,332,604,2671,5058,12,64042,3557,1,1
163,5028,1057,646,719,113,100,145,1170,18,215,134,248,233,382,1740,3004,10,31186,1732,1,1
228,5143,4293,999,3693,19,54,507,4312,9,155,88,170,164,258,1156,1898,4,9368,520,0,1
228,5143,1482,859,1002,125,135,219,1607,16,219,134,251,235,385,1766,3032,9,27804,1544,1,1
210,5003,722,423,573,19,0,135,741,12,172,101,199,184,300,1320,2257,6,15668,870,0,1
210,5003,1508,847,911,44,250,301,1552,14,148,88,169,162,257,1120,1886,7,15077,837,0,1
73,1421,757,253,292,73,244,162,830,13,61,38,67,74,105,409,651,7,4654,258,0,1
7,299,72,33,56,0,4,12,72,1,1,1,1,2,2,0,2,0,1,0,0,1
81,3461,1289,550,1043,56,32,155,1345,10,167,93,185,177,278,1266,2075,5,11498,638,0,1
147,6935,1392,870,1177,35,17,170,1427,14,494,280,531,508,811,4473,7289,7,54850,3047,2,1
87,2905,773,419,590,28,0,166,801,10,204,113,217,214,330,1598,2554,5,13587,754,0,1
52,3380,520,294,400,33,13,81,553,10,261,204,367,271,571,2128,4614,7,32445,1802,1,1
97,4424,1338,495,1086,10,64,173,1348,11,122,82,157,133,239,883,1686,7,11934,663,0,1
79,4191,1457,730,1242,11,6,188,1468,10,292,166,329,302,495,2424,4078,5,22973,1276,1,1
38,2303,334,251,279,10,4,40,344,5,127,74,143,132,217,899,1528,2,4303,239,0,1
48,1750,1098,241,925,5,10,155,1103,7,46,25,49,53,74,273,423,3,1580,87,0,1
147,6933,1392,870,1177,35,17,170,1427,14,494,280,531,508,811,4473,7289,7,54850,3047,2,0
101,2069,773,419,590,28,0,166,801,10,204,113,217,214,330,1598,2554,5,13587,754,0,0
101,2069,421,273,302,44,34,57,465,17,81,59,107,98,166,583,1098,11,12329,684,0,0
26,524,2,2,2,0,0,0,2,0,0,0,0,0,0,0,0,0,0,0,0,0
26,524,99,48,90,1,3,5,100,0,0,0,0,0,0,0,0,0,0,0,0,0
26,524,8,5,5,2,0,1,10,0,0,0,0,0,0,0,0,0,0,0,0,0
26,524,1217,716,841,84,126,174,1301,14,185,118,215,199,333,1446,2542,8,20687,1149,0,0
26,524,160,89,115,0,13,31,160,7,15,11,17,22,28,78,124,3,495,27,0,0
26,524,10,10,9,9,0,0,19,0,0,0,0,0,0,0,0,0,0,0,0,0
26,524,173,84,99,8,29,36,181,5,12,7,13,17,20,54,81,2,221,12,0,0
26,524,3,1,1,3,0,0,6,0,0,0,0,0,0,0,0,0,0,0,0,0
163,5028,1660,832,1314,41,38,274,1701,20,312,209,395,332,604,2671,5058,12,64042,3557,1,0
163,5028,1057,646,719,113,100,145,1170,18,215,134,248,233,382,1740,3004,10,31186,1732,1,0
228,5143,4293,999,3693,19,54,507,4312,9,155,88,170,164,258,1156,1898,4,9368,520,0,0
228,5143,1482,859,1002,125,135,219,1607,16,219,134,251,235,385,1766,3032,9,27804,1544,1,0
210,5003,722,423,573,19,0,135,741,12,172,101,199,184,300,1320,2257,6,15668,870,0,0
210,5003,1508,847,911,44,250,301,1552,14,148,88,169,162,257,1120,1886,7,15077,837,0,0
73,1421,757,253,292,73,244,162,830,13,61,38,67,74,105,409,651,7,4654,258,0,0
7,299,72,33,56,0,4,12,72,1,1,1,1,2,2,0,2,0,1,0,0,0
87,2905,773,419,590,28,0,166,801,10,204,113,217,214,330,1598,2554,5,13587,754,0,0
52,3380,520,294,400,33,13,81,553,10,261,204,367,271,571,2128,4614,7,32445,1802,1,0
97,4424,1338,495,1086,10,64,173,1348,11,122,82,157,133,239,883,1686,7,11934,663,0,0
38,2303,334,251,279,10,4,40,344,5,127,74,143,132,217,899,1528,2,4303,239,0,0
48,1750,1098,241,925,5,10,155,1103,7,46,25,49,53,74,273,423,3,1580,87,0,0
348,6936,1457,730,1242,11,6,188,1468,10,292,166,329,302,495,2424,4078,5,22973,1276,1,0
348,6936,74,35,59,1,0,14,75,3,14,7,14,17,21,58,85,1,128,7,0,0
348,6936,245,125,200,5,7,34,250,7,30,17,34,37,51,166,265,3,1053,58,0,0
80,4257,1457,730,1242,11,6,188,1468,10,292,166,329,302,495,2424,4078,5,22973,1276,1,0
80,4250,1457,730,1242,11,6,188,1468,10,292,166,329,302,495,2424,4078,5,22973,1276,1,0
47,1325,773,422,505,30,103,129,803,14,77,46,83,91,129,535,839,7,6334,351,0,0
45,1298,773,422,505,30,103,129,803,14,77,46,83,91,129,535,839,7,6334,351,0,0
7,353,139,89,101,2,0,35,141,7,54,34,62,61,96,330,569,4,2287,127,0,0
119,4767,1513,682,1277,25,13,200,1538,11,199,116,219,210,335,1557,2584,6,15641,868,0,0
45,1297,773,422,505,30,103,129,803,14,77,46,83,91,129,535,839,7,6334,351,0,0
108,2066,1178,367,1042,6,15,115,1184,9,94,51,95,103,146,644,976,4,4439,246,0,0
108,2066,177,108,140,8,0,27,185,6,30,16,32,36,48,162,248,3,794,44,0,0
122,4899,1513,682,1277,25,13,200,1538,11,199,116,219,210,335,1557,2584,6,15641,868,0,0
64,1733,1455,414,1257,16,76,112,1471,5,41,23,46,46,69,231,381,2,1069,59,0,0
64,1733,669,365,481,22,61,110,691,15,103,63,122,118,185,747,1273,8,11311,628,0,0
64,1721,1455,414,1257,16,76,112,1471,5,41,23,46,46,69,231,381,2,1069,59,0,0
64,1721,669,365,481,22,61,110,691,15,103,63,122,118,185,747,1273,8,11311,628,0,0
67,3083,1455,414,1257,16,76,112,1471,5,41,23,46,46,69,231,381,2,1069,59,0,0
181,4179,77,34,69,0,0,8,77,3,24,16,29,27,45,114,213,1,387,21,0,0
181,4179,712,438,573,51,9,84,763,14,102,71,128,116,199,733,1364,8,11988,666,0,0
72,3739,1296,573,1062,40,33,157,1336,8,201,118,231,209,349,1561,2689,4,12365,686,0,0
76,3893,1943,715,1694,26,18,214,1969,12,185,120,237,197,357,1436,2721,7,20915,1161,0,0
228,5144,4293,999,3693,19,54,507,4312,9,155,88,170,164,258,1156,1898,4,9368,520,0,0
228,5144,1482,859,1002,125,135,219,1607,16,219,134,251,235,385,1766,3032,9,27804,1544,1,0
52,1094,207,111,150,11,0,50,218,5,26,19,36,31,55,133,272,3,943,52,0,1
52,1094,410,198,237,31,55,97,441,11,63,38,72,74,110,414,683,6,4293,238,0,1
228,5136,4293,999,3693,19,54,507,4312,9,155,88,170,164,258,1156,1898,4,9368,520,0,1
228,5136,1482,859,1002,125,135,219,1607,16,219,134,251,235,385,1766,3032,9,27804,1544,1,1
12,419,42,7,35,4,0,5,46,1,2,1,2,3,3,2,4,0,2,0,0,1
12,419,11,6,10,0,0,1,11,2,4,2,4,6,6,10,15,1,15,0,0,1
161,7064,139,89,101,2,0,35,141,7,54,34,62,61,96,330,569,4,2287,127,0,1
161,7064,7,5,5,0,0,2,7,1,2,1,2,3,3,2,4,0,2,0,0,1
161,7062,139,89,101,2,0,35,141,7,54,34,62,61,96,330,569,4,2287,127,0,0
161,7062,7,5,5,0,0,2,7,1,2,1,2,3,3,2,4,0,2,0,0,0
52,1094,207,111,150,11,0,50,218,5,26,19,36,31,55,133,272,3,943,52,0,0
52,1094,410,198,237,31,55,97,441,11,63,38,72,74,110,414,683,6,4293,238,0,0
228,5136,4293,999,3693,19,54,507,4312,9,155,88,170,164,258,1156,1898,4,9368,520,0,0
228,5136,1482,859,1002,125,135,219,1607,16,219,134,251,235,385,1766,3032,9,27804,1544,1,0
12,419,42,7,35,4,0,5,46,1,2,1,2,3,3,2,4,0,2,0,0,0
12,419,11,6,10,0,0,1,11,2,4,2,4,6,6,10,15,1,15,0,0,0
73,3848,1296,573,1062,40,33,157,1336,8,201,118,231,209,349,1561,2689,4,12365,686,0,1
73,3850,1296,573,1062,40,33,157,1336,8,201,118,231,209,349,1561,2689,4,12365,686,0,0
235,5317,4293,999,3693,19,54,507,4312,9,155,88,170,164,258,1156,1898,4,9368,520,0,1
235,5317,1482,859,1002,125,135,219,1607,16,219,134,251,235,385,1766,3032,9,27804,1544,1,1
234,5311,4293,999,3693,19,54,507,4312,9,155,88,170,164,258,1156,1898,4,9368,520,0,0
234,5311,1482,859,1002,125,135,219,1607,16,219,134,251,235,385,1766,3032,9,27804,1544,1,0
232,5292,4293,999,3693,19,54,507,4312,9,155,88,170,164,258,1156,1898,4,9368,520,0,1
232,5292,1482,859,1002,125,135,219,1607,16,219,134,251,235,385,1766,3032,9,27804,1544,1,1
229,5195,4293,999,3693,19,54,507,4312,9,155,88,170,164,258,1156,1898,4,9368,520,0,1
229,5195,1482,859,1002,125,135,219,1607,16,219,134,251,235,385,1766,3032,9,27804,1544,1,1
4,95,53,23,39,0,0,13,53,2,8,4,8,10,12,26,39,1,39,2,0,1
4,95,515,298,307,33,80,99,548,12,63,44,77,75,121,419,753,7,5527,307,0,1
1,106,53,23,39,0,0,13,53,2,8,4,8,10,12,26,39,1,39,2,0,1
75,1461,757,253,292,73,244,162,830,13,61,38,67,74,105,409,651,7,4654,258,0,1
229,5199,4293,999,3693,19,54,507,4312,9,155,88,170,164,258,1156,1898,4,9368,520,0,0
229,5199,1482,859,1002,125,135,219,1607,16,219,134,251,235,385,1766,3032,9,27804,1544,1,0
83,2365,1523,757,1297,19,12,193,1542,12,193,117,230,205,347,1508,2664,7,19053,1058,0,0
83,2365,701,378,504,33,58,109,734,13,110,68,126,123,194,794,1346,7,10027,557,0,0
184,4257,77,34,69,0,0,8,77,3,24,16,29,27,45,114,213,1,387,21,0,0
184,4257,712,438,573,51,9,84,763,14,102,71,128,116,199,733,1364,8,11988,666,0,0
4,92,53,23,39,0,0,13,53,2,8,4,8,10,12,26,39,1,39,2,0,0
4,92,515,298,307,33,80,99,548,12,63,44,77,75,121,419,753,7,5527,307,0,0
193,3994,1943,715,1694,26,18,214,1969,12,185,120,237,197,357,1436,2721,7,20915,1161,0,0
193,3994,1168,838,957,57,25,144,1225,19,348,224,416,367,640,3018,5452,11,61921,3440,1,0
4,90,53,23,39,0,0,13,53,2,8,4,8,10,12,26,39,1,39,2,0,0
4,90,515,298,307,33,80,99,548,12,63,44,77,75,121,419,753,7,5527,307,0,0
96,1835,1020,354,843,12,15,144,1032,8,134,77,144,142,221,970,1580,4,6792,377,0,1
75,3288,1020,354,843,12,15,144,1032,8,134,77,144,142,221,970,1580,4,6792,377,0,1
1,106,53,23,39,0,0,13,53,2,8,4,8,10,12,26,39,1,39,2,0,0
229,5171,4293,999,3693,19,54,507,4312,9,155,88,170,164,258,1156,1898,4,9368,520,0,0
229,5171,1482,859,1002,125,135,219,1607,16,219,134,251,235,385,1766,3032,9,27804,1544,1,0
181,4189,77,34,69,0,0,8,77,3,24,16,29,27,45,114,213,1,387,21,0,0
181,4189,712,438,573,51,9,84,763,14,102,71,128,116,199,733,1364,8,11988,666,0,0
195,4029,1943,715,1694,26,18,214,1969,12,185,120,237,197,357,1436,2721,7,20915,1161,0,0
195,4029,1168,838,957,57,25,144,1225,19,348,224,416,367,640,3018,5452,11,61921,3440,1,0
73,3834,1296,573,1062,40,33,157,1336,8,201,118,231,209,349,1561,2689,4,12365,686,0,0
96,1835,1020,354,843,12,15,144,1032,8,134,77,144,142,221,970,1580,4,6792,377,0,0
75,3288,1020,354,843,12,15,144,1032,8,134,77,144,142,221,970,1580,4,6792,377,0,0
52,1088,207,111,150,11,0,50,218,5,26,19,36,31,55,133,272,3,943,52,0,0
52,1088,410,198,237,31,55,97,441,11,63,38,72,74,110,414,683,6,4293,238,0,0
52,1082,207,111,150,11,0,50,218,5,26,19,36,31,55,133,272,3,943,52,0,0
52,1082,410,198,237,31,55,97,441,11,63,38,72,74,110,414,683,6,4293,238,0,0
94,1805,1020,354,843,12,15,144,1032,8,134,77,144,142,221,970,1580,4,6792,377,0,0
73,1425,757,253,292,73,244,162,830,13,61,38,67,74,105,409,651,7,4654,258,0,0
346,6927,1457,730,1242,11,6,188,1468,10,292,166,329,302,495,2424,4078,5,22973,1276,1,0
346,6927,74,35,59,1,0,14,75,3,14,7,14,17,21,58,85,1,128,7,0,0
346,6927,245,125,200,5,7,34,250,7,30,17,34,37,51,166,265,3,1053,58,0,0
33,1914,384,251,317,7,8,52,391,11,70,44,84,81,128,467,811,6,5355,297,0,0
167,5123,1660,832,1314,41,38,274,1701,20,312,209,395,332,604,2671,5058,12,64042,3557,1,0
167,5123,1057,646,719,113,100,145,1170,18,215,134,248,233,382,1740,3004,10,31186,1732,1,0
153,4268,1660,832,1314,41,38,274,1701,20,312,209,395,332,604,2671,5058,12,64042,3557,1,0
167,5122,1660,832,1314,41,38,274,1701,20,312,209,395,332,604,2671,5058,12,64042,3557,1,0
167,5122,1057,646,719,113,100,145,1170,18,215,134,248,233,382,1740,3004,10,31186,1732,1,0
155,4372,1660,832,1314,41,38,274,1701,20,312,209,395,332,604,2671,5058,12,64042,3557,1,0
100,1967,1020,354,843,12,15,144,1032,8,134,77,144,142,221,970,1580,4,6792,377,0,1
256,6030,72,33,56,0,4,12,72,1,1,1,1,2,2,0,2,0,1,0,0,1
256,6030,1454,835,1044,76,110,219,1530,17,275,158,296,292,454,2297,3718,9,34017,1889,1,1
135,2748,1513,682,1277,25,13,200,1538,11,199,116,219,210,335,1557,2584,6,15641,868,0,0
135,2748,819,519,539,24,98,155,843,15,96,57,106,111,163,690,1107,8,9171,509,0,0
124,4990,1513,682,1277,25,13,200,1538,11,199,116,219,210,335,1557,2584,6,15641,868,0,0
60,1682,1455,414,1257,16,76,112,1471,5,41,23,46,46,69,231,381,2,1069,59,0,0
60,1682,669,365,481,22,61,110,691,15,103,63,122,118,185,747,1273,8,11311,628,0,0
66,3053,1455,414,1257,16,76,112,1471,5,41,23,46,46,69,231,381,2,1069,59,0,0
257,6191,72,33,56,0,4,12,72,1,1,1,1,2,2,0,2,0,1,0,0,0
257,6191,1454,835,1044,76,110,219,1530,17,275,158,296,292,454,2297,3718,9,34017,1889,1,0
231,5221,4293,999,3693,19,54,507,4312,9,155,88,170,164,258,1156,1898,4,9368,520,0,1
231,5221,1482,859,1002,125,135,219,1607,16,219,134,251,235,385,1766,3032,9,27804,1544,1,1
93,1852,1020,354,843,12,15,144,1032,8,134,77,144,142,221,970,1580,4,6792,377,0,1
12,422,42,7,35,4,0,5,46,1,2,1,2,3,3,2,4,0,2,0,0,1
12,422,11,6,10,0,0,1,11,2,4,2,4,6,6,10,15,1,15,0,0,1
166,5068,1660,832,1314,41,38,274,1701,20,312,209,395,332,604,2671,5058,12,64042,3557,1,1
166,5068,1057,646,719,113,100,145,1170,18,215,134,248,233,382,1740,3004,10,31186,1732,1,1
64,1726,1455,414,1257,16,76,112,1471,5,41,23,46,46,69,231,381,2,1069,59,0,1
64,1726,669,365,481,22,61,110,691,15,103,63,122,118,185,747,1273,8,11311,628,0,1
94,1811,1020,354,843,12,15,144,1032,8,134,77,144,142,221,970,1580,4,6792,377,0,1
155,4372,1660,832,1314,41,38,274,1701,20,312,209,395,332,604,2671,5058,12,64042,3557,1,1
68,3131,1455,414,1257,16,76,112,1471,5,41,23,46,46,69,231,381,2,1069,59,0,1
100,1967,1020,354,843,12,15,144,1032,8,134,77,144,142,221,970,1580,4,6792,377,0,0
256,6030,72,33,56,0,4,12,72,1,1,1,1,2,2,0,2,0,1,0,0,0
256,6030,1454,835,1044,76,110,219,1530,17,275,158,296,292,454,2297,3718,9,34017,1889,1,0
257,6066,72,33,56,0,4,12,72,1,1,1,1,2,2,0,2,0,1,0,0,0
257,6066,1454,835,1044,76,110,219,1530,17,275,158,296,292,454,2297,3718,9,34017,1889,1,0
166,5068,1660,832,1314,41,38,274,1701,20,312,209,395,332,604,2671,5058,12,64042,3557,1,0
166,5068,1057,646,719,113,100,145,1170,18,215,134,248,233,382,1740,3004,10,31186,1732,1,0
64,1726,1455,414,1257,16,76,112,1471,5,41,23,46,46,69,231,381,2,1069,59,0,0
64,1726,669,365,481,22,61,110,691,15,103,63,122,118,185,747,1273,8,11311,628,0,0
100,1973,1020,354,843,12,15,144,1032,8,134,77,144,142,221,970,1580,4,6792,377,0,0
68,3131,1455,414,1257,16,76,112,1471,5,41,23,46,46,69,231,381,2,1069,59,0,0
99,2020,1020,354,843,12,15,144,1032,8,134,77,144,142,221,970,1580,4,6792,377,0,0
86,1808,477,336,357,30,23,73,507,16,194,134,250,210,384,1538,2962,10,30538,1696,0,1
351,7048,1457,730,1242,11,6,188,1468,10,292,166,329,302,495,2424,4078,5,22973,1276,1,1
351,7048,74,35,59,1,0,14,75,3,14,7,14,17,21,58,85,1,128,7,0,1
351,7048,245,125,200,5,7,34,250,7,30,17,34,37,51,166,265,3,1053,58,0,1
229,5199,4293,999,3693,19,54,507,4312,9,155,88,170,164,258,1156,1898,4,9368,520,0,1
229,5199,1482,859,1002,125,135,219,1607,16,219,134,251,235,385,1766,3032,9,27804,1544,1,1
212,5103,722,423,573,19,0,135,741,12,172,101,199,184,300,1320,2257,6,15668,870,0,1
212,5103,1508,847,911,44,250,301,1552,14,148,88,169,162,257,1120,1886,7,15077,837,0,1
256,6158,72,33,56,0,4,12,72,1,1,1,1,2,2,0,2,0,1,0,0,1
256,6158,1454,835,1044,76,110,219,1530,17,275,158,296,292,454,2297,3718,9,34017,1889,1,1
193,3994,1943,715,1694,26,18,214,1969,12,185,120,237,197,357,1436,2721,7,20915,1161,0,1
193,3994,1168,838,957,57,25,144,1225,19,348,224,416,367,640,3018,5452,11,61921,3440,1,1
87,2923,773,419,590,28,0,166,801,10,204,113,217,214,330,1598,2554,5,13587,754,0,1
73,3850,1296,573,1062,40,33,157,1336,8,201,118,231,209,349,1561,2689,4,12365,686,0,1
26,1029,373,158,315,8,0,51,381,5,76,44,79,81,123,486,779,2,2026,112,0,1
167,5122,1660,832,1314,41,38,274,1701,20,312,209,395,332,604,2671,5058,12,64042,3557,1,1
167,5122,1057,646,719,113,100,145,1170,18,215,134,248,233,382,1740,3004,10,31186,1732,1,1
184,4257,77,34,69,0,0,8,77,3,24,16,29,27,45,114,213,1,387,21,0,1
184,4257,712,438,573,51,9,84,763,14,102,71,128,116,199,733,1364,8,11988,666,0,1
113,2492,1043,504,840,53,9,147,1096,9,180,112,198,189,310,1377,2344,4,11604,644,0,1
113,2492,383,288,292,26,6,62,409,11,65,38,67,76,105,429,656,5,3719,206,0,1
231,5221,4293,999,3693,19,54,507,4312,9,155,88,170,164,258,1156,1898,4,9368,520,0,0
231,5221,1482,859,1002,125,135,219,1607,16,219,134,251,235,385,1766,3032,9,27804,1544,1,0
12,422,42,7,35,4,0,5,46,1,2,1,2,3,3,2,4,0,2,0,0,0
12,422,11,6,10,0,0,1,11,2,4,2,4,6,6,10,15,1,15,0,0,0
17,604,601,196,481,2,23,85,603,8,63,36,72,71,108,400,664,4,3036,168,0,0
230,5220,4293,999,3693,19,54,507,4312,9,155,88,170,164,258,1156,1898,4,9368,520,0,0
230,5220,1482,859,1002,125,135,219,1607,16,219,134,251,235,385,1766,3032,9,27804,1544,1,0
112,2476,1043,504,840,53,9,147,1096,9,180,112,198,189,310,1377,2344,4,11604,644,0,0
112,2476,383,288,292,26,6,62,409,11,65,38,67,76,105,429,656,5,3719,206,0,0
18,646,601,196,481,2,23,85,603,8,63,36,72,71,108,400,664,4,3036,168,0,0
230,5208,4293,999,3693,19,54,507,4312,9,155,88,170,164,258,1156,1898,4,9368,520,0,0
230,5208,1482,859,1002,125,135,219,1607,16,219,134,251,235,385,1766,3032,9,27804,1544,1,0
188,4306,77,34,69,0,0,8,77,3,24,16,29,27,45,114,213,1,387,21,0,0
188,4306,712,438,573,51,9,84,763,14,102,71,128,116,199,733,1364,8,11988,666,0,0
230,5217,4293,999,3693,19,54,507,4312,9,155,88,170,164,258,1156,1898,4,9368,520,0,0
230,5217,1482,859,1002,125,135,219,1607,16,219,134,251,235,385,1766,3032,9,27804,1544,1,0
164,7175,139,89,101,2,0,35,141,7,54,34,62,61,96,330,569,4,2287,127,0,0
164,7175,7,5,5,0,0,2,7,1,2,1,2,3,3,2,4,0,2,0,0,0
230,5248,4293,999,3693,19,54,507,4312,9,155,88,170,164,258,1156,1898,4,9368,520,0,0
230,5248,1482,859,1002,125,135,219,1607,16,219,134,251,235,385,1766,3032,9,27804,1544,1,0
50,588,647,139,84,35,284,233,682,0,0,0,0,0,0,0,0,0,0,0,0,0
163,7149,139,89,101,2,0,35,141,7,54,34,62,61,96,330,569,4,2287,127,0,0
163,7149,7,5,5,0,0,2,7,1,2,1,2,3,3,2,4,0,2,0,0,0
231,5269,4293,999,3693,19,54,507,4312,9,155,88,170,164,258,1156,1898,4,9368,520,0,0
231,5269,1482,859,1002,125,135,219,1607,16,219,134,251,235,385,1766,3032,9,27804,1544,1,0
185,4238,77,34,69,0,0,8,77,3,24,16,29,27,45,114,213,1,387,21,0,0
185,4238,712,438,573,51,9,84,763,14,102,71,128,116,199,733,1364,8,11988,666,0,0
112,2472,1043,504,840,53,9,147,1096,9,180,112,198,189,310,1377,2344,4,11604,644,0,0
112,2472,383,288,292,26,6,62,409,11,65,38,67,76,105,429,656,5,3719,206,0,0
162,7122,139,89,101,2,0,35,141,7,54,34,62,61,96,330,569,4,2287,127,0,0
162,7122,7,5,5,0,0,2,7,1,2,1,2,3,3,2,4,0,2,0,0,0
231,5270,4293,999,3693,19,54,507,4312,9,155,88,170,164,258,1156,1898,4,9368,520,0,0
231,5270,1482,859,1002,125,135,219,1607,16,219,134,251,235,385,1766,3032,9,27804,1544,1,0
231,5276,4293,999,3693,19,54,507,4312,9,155,88,170,164,258,1156,1898,4,9368,520,0,0
231,5276,1482,859,1002,125,135,219,1607,16,219,134,251,235,385,1766,3032,9,27804,1544,1,0
231,5276,4293,999,3693,19,54,507,4312,9,155,88,170,164,258,1156,1898,4,9368,520,0,1
231,5276,1482,859,1002,125,135,219,1607,16,219,134,251,235,385,1766,3032,9,27804,1544,1,1
138,2871,1513,682,1277,25,13,200,1538,11,199,116,219,210,335,1557,2584,6,15641,868,0,1
138,2871,819,519,539,24,98,155,843,15,96,57,106,111,163,690,1107,8,9171,509,0,1
126,5054,1513,682,1277,25,13,200,1538,11,199,116,219,210,335,1557,2584,6,15641,868,0,1
12,426,42,7,35,4,0,5,46,1,2,1,2,3,3,2,4,0,2,0,0,0
12,426,11,6,10,0,0,1,11,2,4,2,4,6,6,10,15,1,15,0,0,0
258,6089,72,33,56,0,4,12,72,1,1,1,1,2,2,0,2,0,1,0,0,0
258,6089,1454,835,1044,76,110,219,1530,17,275,158,296,292,454,2297,3718,9,34017,1889,1,0
8,329,75,38,59,1,3,12,76,2,4,2,4,6,6,10,15,1,15,0,0,0
138,2871,1513,682,1277,25,13,200,1538,11,199,116,219,210,335,1557,2584,6,15641,868,0,0
138,2871,819,519,539,24,98,155,843,15,96,57,106,111,163,690,1107,8,9171,509,0,0
126,5054,1513,682,1277,25,13,200,1538,11,199,116,219,210,335,1557,2584,6,15641,868,0,0
141,2959,1513,682,1277,25,13,200,1538,11,199,116,219,210,335,1557,2584,6,15641,868,0,1
141,2959,819,519,539,24,98,155,843,15,96,57,106,111,163,690,1107,8,9171,509,0,1
128,5156,1513,682,1277,25,13,200,1538,11,199,116,219,210,335,1557,2584,6,15641,868,0,1
141,2959,1513,682,1277,25,13,200,1538,11,199,116,219,210,335,1557,2584,6,15641,868,0,0
141,2959,819,519,539,24,98,155,843,15,96,57,106,111,163,690,1107,8,9171,509,0,0
128,5156,1513,682,1277,25,13,200,1538,11,199,116,219,210,335,1557,2584,6,15641,868,0,0
204,4267,1943,715,1694,26,18,214,1969,12,185,120,237,197,357,1436,2721,7,20915,1161,0,1
204,4267,1168,838,957,57,25,144,1225,19,348,224,416,367,640,3018,5452,11,61921,3440,1,1
81,3472,1289,550,1043,56,32,155,1345,10,167,93,185,177,278,1266,2075,5,11498,638,0,1
162,7134,139,89,101,2,0,35,141,7,54,34,62,61,96,330,569,4,2287,127,0,1
162,7134,7,5,5,0,0,2,7,1,2,1,2,3,3,2,4,0,2,0,0,1
132,5730,1782,648,1425,9,47,279,1791,8,171,97,189,179,286,1292,2140,4,9462,525,0,1
76,3893,1943,715,1694,26,18,214,1969,12,185,120,237,197,357,1436,2721,7,20915,1161,0,1
214,5107,722,423,573,19,0,135,741,12,172,101,199,184,300,1320,2257,6,15668,870,0,1
214,5107,1508,847,911,44,250,301,1552,14,148,88,169,162,257,1120,1886,7,15077,837,0,1
203,4282,1943,715,1694,26,18,214,1969,12,185,120,237,197,357,1436,2721,7,20915,1161,0,0
203,4282,1168,838,957,57,25,144,1225,19,348,224,416,367,640,3018,5452,11,61921,3440,1,0
204,4297,1943,715,1694,26,18,214,1969,12,185,120,237,197,357,1436,2721,7,20915,1161,0,0
204,4297,1168,838,957,57,25,144,1225,19,348,224,416,367,640,3018,5452,11,61921,3440,1,0
81,4076,1943,715,1694,26,18,214,1969,12,185,120,237,197,357,1436,2721,7,20915,1161,0,0
168,5128,1660,832,1314,41,38,274,1701,20,312,209,395,332,604,2671,5058,12,64042,3557,1,0
168,5128,1057,646,719,113,100,145,1170,18,215,134,248,233,382,1740,3004,10,31186,1732,1,0
110,4156,1450,624,1228,12,26,181,1462,14,306,186,354,320,540,2580,4493,8,36391,2021,1,0
204,4299,1943,715,1694,26,18,214,1969,12,185,120,237,197,357,1436,2721,7,20915,1161,0,0
204,4299,1168,838,957,57,25,144,1225,19,348,224,416,367,640,3018,5452,11,61921,3440,1,0
97,1855,1020,354,843,12,15,144,1032,8,134,77,144,142,221,970,1580,4,6792,377,0,0
76,3351,1020,354,843,12,15,144,1032,8,134,77,144,142,221,970,1580,4,6792,377,0,0
214,5107,722,423,573,19,0,135,741,12,172,101,199,184,300,1320,2257,6,15668,870,0,0
214,5107,1508,847,911,44,250,301,1552,14,148,88,169,162,257,1120,1886,7,15077,837,0,0
162,7134,139,89,101,2,0,35,141,7,54,34,62,61,96,330,569,4,2287,127,0,0
162,7134,7,5,5,0,0,2,7,1,2,1,2,3,3,2,4,0,2,0,0,0
132,5730,1782,648,1425,9,47,279,1791,8,171,97,189,179,286,1292,2140,4,9462,525,0,0
167,5074,1660,832,1314,41,38,274,1701,20,312,209,395,332,604,2671,5058,12,64042,3557,1,0
167,5074,1057,646,719,113,100,145,1170,18,215,134,248,233,382,1740,3004,10,31186,1732,1,0
100,2040,1020,354,843,12,15,144,1032,8,134,77,144,142,221,970,1580,4,6792,377,0,0
202,4260,1943,715,1694,26,18,214,1969,12,185,120,237,197,357,1436,2721,7,20915,1161,0,0
202,4260,1168,838,957,57,25,144,1225,19,348,224,416,367,640,3018,5452,11,61921,3440,1,0
347,6940,1457,730,1242,11,6,188,1468,10,292,166,329,302,495,2424,4078,5,22973,1276,1,0
347,6940,74,35,59,1,0,14,75,3,14,7,14,17,21,58,85,1,128,7,0,0
347,6940,245,125,200,5,7,34,250,7,30,17,34,37,51,166,265,3,1053,58,0,0
9,367,75,38,59,1,3,12,76,2,4,2,4,6,6,10,15,1,15,0,0,0
22,453,601,196,481,2,23,85,603,8,63,36,72,71,108,400,664,4,3036,168,0,1
22,453,156,79,106,5,16,28,161,5,14,8,15,19,23,64,97,2,261,14,0,1
19,679,601,196,481,2,23,85,603,8,63,36,72,71,108,400,664,4,3036,168,0,1
22,453,601,196,481,2,23,85,603,8,63,36,72,71,108,400,664,4,3036,168,0,0
22,453,156,79,106,5,16,28,161,5,14,8,15,19,23,64,97,2,261,14,0,0
19,679,601,196,481,2,23,85,603,8,63,36,72,71,108,400,664,4,3036,168,0,0
348,6947,1457,730,1242,11,6,188,1468,10,292,166,329,302,495,2424,4078,5,22973,1276,1,0
348,6947,74,35,59,1,0,14,75,3,14,7,14,17,21,58,85,1,128,7,0,0
348,6947,245,125,200,5,7,34,250,7,30,17,34,37,51,166,265,3,1053,58,0,0
80,4253,1457,730,1242,11,6,188,1468,10,292,166,329,302,495,2424,4078,5,22973,1276,1,0
111,2463,1043,504,840,53,9,147,1096,9,180,112,198,189,310,1377,2344,4,11604,644,0,1
111,2463,383,288,292,26,6,62,409,11,65,38,67,76,105,429,656,5,3719,206,0,1
82,4311,1457,730,1242,11,6,188,1468,10,292,166,329,302,495,2424,4078,5,22973,1276,1,0
203,4272,1943,715,1694,26,18,214,1969,12,185,120,237,197,357,1436,2721,7,20915,1161,0,0
203,4272,1168,838,957,57,25,144,1225,19,348,224,416,367,640,3018,5452,11,61921,3440,1,0
82,4120,1943,715,1694,26,18,214,1969,12,185,120,237,197,357,1436,2721,7,20915,1161,0,0
111,2463,1043,504,840,53,9,147,1096,9,180,112,198,189,310,1377,2344,4,11604,644,0,0
111,2463,383,288,292,26,6,62,409,11,65,38,67,76,105,429,656,5,3719,206,0,0
259,6096,72,33,56,0,4,12,72,1,1,1,1,2,2,0,2,0,1,0,0,0
259,6096,1454,835,1044,76,110,219,1530,17,275,158,296,292,454,2297,3718,9,34017,1889,1,0
231,5287,4293,999,3693,19,54,507,4312,9,155,88,170,164,258,1156,1898,4,9368,520,0,0
231,5287,1482,859,1002,125,135,219,1607,16,219,134,251,235,385,1766,3032,9,27804,1544,1,0
135,5789,1782,648,1425,9,47,279,1791,8,171,97,189,179,286,1292,2140,4,9462,525,0,0
202,4267,1943,715,1694,26,18,214,1969,12,185,120,237,197,357,1436,2721,7,20915,1161,0,0
202,4267,1168,838,957,57,25,144,1225,19,348,224,416,367,640,3018,5452,11,61921,3440,1,0
11,406,75,38,59,1,3,12,76,2,4,2,4,6,6,10,15,1,15,0,0,0
203,4279,1943,715,1694,26,18,214,1969,12,185,120,237,197,357,1436,2721,7,20915,1161,0,0
203,4279,1168,838,957,57,25,144,1225,19,348,224,416,367,640,3018,5452,11,61921,3440,1,0
348,6963,1457,730,1242,11,6,188,1468,10,292,166,329,302,495,2424,4078,5,22973,1276,1,0
348,6963,74,35,59,1,0,14,75,3,14,7,14,17,21,58,85,1,128,7,0,0
348,6963,245,125,200,5,7,34,250,7,30,17,34,37,51,166,265,3,1053,58,0,0
11,428,75,38,59,1,3,12,76,2,4,2,4,6,6,10,15,1,15,0,0,0
191,4342,77,34,69,0,0,8,77,3,24,16,29,27,45,114,213,1,387,21,0,1
191,4342,712,438,573,51,9,84,763,14,102,71,128,116,199,733,1364,8,11988,666,0,1
87,3758,1289,550,1043,56,32,155,1345,10,167,93,185,177,278,1266,2075,5,11498,638,0,1
41,1265,773,422,505,30,103,129,803,14,77,46,83,91,129,535,839,7,6334,351,0,0
214,5106,722,423,573,19,0,135,741,12,172,101,199,184,300,1320,2257,6,15668,870,0,0
214,5106,1508,847,911,44,250,301,1552,14,148,88,169,162,257,1120,1886,7,15077,837,0,0
81,3468,1289,550,1043,56,32,155,1345,10,167,93,185,177,278,1266,2075,5,11498,638,0,0
39,2351,652,304,544,16,6,88,668,6,89,51,101,95,152,591,998,3,3399,188,0,0
39,2342,652,304,544,16,6,88,668,6,89,51,101,95,152,591,998,3,3399,188,0,0
100,2053,773,419,590,28,0,166,801,10,204,113,217,214,330,1598,2554,5,13587,754,0,0
100,2053,421,273,302,44,34,57,465,17,81,59,107,98,166,583,1098,11,12329,684,0,0
167,5072,1660,832,1314,41,38,274,1701,20,312,209,395,332,604,2671,5058,12,64042,3557,1,0
167,5072,1057,646,719,113,100,145,1170,18,215,134,248,233,382,1740,3004,10,31186,1732,1,0
87,2883,773,419,590,28,0,166,801,10,204,113,217,214,330,1598,2554,5,13587,754,0,0
86,1796,477,336,357,30,23,73,507,16,194,134,250,210,384,1538,2962,10,30538,1696,0,1
86,1788,477,336,357,30,23,73,507,16,194,134,250,210,384,1538,2962,10,30538,1696,0,0
87,3752,1289,550,1043,56,32,155,1345,10,167,93,185,177,278,1266,2075,5,11498,638,0,0
193,4386,77,34,69,0,0,8,77,3,24,16,29,27,45,114,213,1,387,21,0,0
193,4386,712,438,573,51,9,84,763,14,102,71,128,116,199,733,1364,8,11988,666,0,0
50,586,647,139,84,35,284,233,682,0,0,0,0,0,0,0,0,0,0,0,0,1
167,5087,1660,832,1314,41,38,274,1701,20,312,209,395,332,604,2671,5058,12,64042,3557,1,1
167,5087,1057,646,719,113,100,145,1170,18,215,134,248,233,382,1740,3004,10,31186,1732,1,1
214,5106,722,423,573,19,0,135,741,12,172,101,199,184,300,1320,2257,6,15668,870,0,1
214,5106,1508,847,911,44,250,301,1552,14,148,88,169,162,257,1120,1886,7,15077,837,0,1
156,4422,1660,832,1314,41,38,274,1701,20,312,209,395,332,604,2671,5058,12,64042,3557,1,1
167,5085,1660,832,1314,41,38,274,1701,20,312,209,395,332,604,2671,5058,12,64042,3557,1,0
167,5085,1057,646,719,113,100,145,1170,18,215,134,248,233,382,1740,3004,10,31186,1732,1,0
156,4422,1660,832,1314,41,38,274,1701,20,312,209,395,332,604,2671,5058,12,64042,3557,1,0
87,3748,1289,550,1043,56,32,155,1345,10,167,93,185,177,278,1266,2075,5,11498,638,0,0
45,1258,773,422,505,30,103,129,803,14,77,46,83,91,129,535,839,7,6334,351,0,0
231,5261,4293,999,3693,19,54,507,4312,9,155,88,170,164,258,1156,1898,4,9368,520,0,0
231,5261,1482,859,1002,125,135,219,1607,16,219,134,251,235,385,1766,3032,9,27804,1544,1,0
88,3778,1289,550,1043,56,32,155,1345,10,167,93,185,177,278,1266,2075,5,11498,638,0,0
89,3806,1289,550,1043,56,32,155,1345,10,167,93,185,177,278,1266,2075,5,11498,638,0,0
204,4292,1943,715,1694,26,18,214,1969,12,185,120,237,197,357,1436,2721,7,20915,1161,0,0
204,4292,1168,838,957,57,25,144,1225,19,348,224,416,367,640,3018,5452,11,61921,3440,1,0
83,4156,1943,715,1694,26,18,214,1969,12,185,120,237,197,357,1436,2721,7,20915,1161,0,0
90,3836,1289,550,1043,56,32,155,1345,10,167,93,185,177,278,1266,2075,5,11498,638,0,0
51,1398,773,422,505,30,103,129,803,14,77,46,83,91,129,535,839,7,6334,351,0,0
221,5235,722,423,573,19,0,135,741,12,172,101,199,184,300,1320,2257,6,15668,870,0,1
221,5235,1508,847,911,44,250,301,1552,14,148,88,169,162,257,1120,1886,7,15077,837,0,1
222,5253,722,423,573,19,0,135,741,12,172,101,199,184,300,1320,2257,6,15668,870,0,1
222,5253,1508,847,911,44,250,301,1552,14,148,88,169,162,257,1120,1886,7,15077,837,0,1
88,3790,1289,550,1043,56,32,155,1345,10,167,93,185,177,278,1266,2075,5,11498,638,0,1
11,423,75,38,59,1,3,12,76,2,4,2,4,6,6,10,15,1,15,0,0,1
45,2193,722,423,573,19,0,135,741,12,172,101,199,184,300,1320,2257,6,15668,870,0,1
52,1417,773,422,505,30,103,129,803,14,77,46,83,91,129,535,839,7,6334,351,0,0
231,5265,4293,999,3693,19,54,507,4312,9,155,88,170,164,258,1156,1898,4,9368,520,0,1
231,5265,1482,859,1002,125,135,219,1607,16,219,134,251,235,385,1766,3032,9,27804,1544,1,1
117,2801,77,34,69,0,0,8,77,3,24,16,29,27,45,114,213,1,387,21,0,1
117,2801,712,438,573,51,9,84,763,14,102,71,128,116,199,733,1364,8,11988,666,0,1
80,1686,53,23,39,0,0,13,53,2,8,4,8,10,12,26,39,1,39,2,0,1
80,1686,515,298,307,33,80,99,548,12,63,44,77,75,121,419,753,7,5527,307,0,1
259,6096,72,33,56,0,4,12,72,1,1,1,1,2,2,0,2,0,1,0,0,1
259,6096,1454,835,1044,76,110,219,1530,17,275,158,296,292,454,2297,3718,9,34017,1889,1,1
97,4426,1338,495,1086,10,64,173,1348,11,122,82,157,133,239,883,1686,7,11934,663,0,1
79,1686,53,23,39,0,0,13,53,2,8,4,8,10,12,26,39,1,39,2,0,0
79,1686,515,298,307,33,80,99,548,12,63,44,77,75,121,419,753,7,5527,307,0,0
215,5118,722,423,573,19,0,135,741,12,172,101,199,184,300,1320,2257,6,15668,870,0,0
215,5118,1508,847,911,44,250,301,1552,14,148,88,169,162,257,1120,1886,7,15077,837,0,0
222,5253,722,423,573,19,0,135,741,12,172,101,199,184,300,1320,2257,6,15668,870,0,0
222,5253,1508,847,911,44,250,301,1552,14,148,88,169,162,257,1120,1886,7,15077,837,0,0
88,3790,1289,550,1043,56,32,155,1345,10,167,93,185,177,278,1266,2075,5,11498,638,0,0
11,423,75,38,59,1,3,12,76,2,4,2,4,6,6,10,15,1,15,0,0,0
45,2193,722,423,573,19,0,135,741,12,172,101,199,184,300,1320,2257,6,15668,870,0,0
231,5265,4293,999,3693,19,54,507,4312,9,155,88,170,164,258,1156,1898,4,9368,520,0,0
231,5265,1482,859,1002,125,135,219,1607,16,219,134,251,235,385,1766,3032,9,27804,1544,1,0
117,2801,77,34,69,0,0,8,77,3,24,16,29,27,45,114,213,1,387,21,0,0
117,2801,712,438,573,51,9,84,763,14,102,71,128,116,199,733,1364,8,11988,666,0,0
97,4426,1338,495,1086,10,64,173,1348,11,122,82,157,133,239,883,1686,7,11934,663,0,0
108,2071,1178,367,1042,6,15,115,1184,9,94,51,95,103,146,644,976,4,4439,246,0,0
108,2071,177,108,140,8,0,27,185,6,30,16,32,36,48,162,248,3,794,44,0,0
258,6107,72,33,56,0,4,12,72,1,1,1,1,2,2,0,2,0,1,0,0,0
258,6107,1454,835,1044,76,110,219,1530,17,275,158,296,292,454,2297,3718,9,34017,1889,1,0
15,466,42,7,35,4,0,5,46,1,2,1,2,3,3,2,4,0,2,0,0,0
15,466,11,6,10,0,0,1,11,2,4,2,4,6,6,10,15,1,15,0,0,0
223,5265,722,423,573,19,0,135,741,12,172,101,199,184,300,1320,2257,6,15668,870,0,0
223,5265,1508,847,911,44,250,301,1552,14,148,88,169,162,257,1120,1886,7,15077,837,0,0
259,6114,72,33,56,0,4,12,72,1,1,1,1,2,2,0,2,0,1,0,0,0
259,6114,1454,835,1044,76,110,219,1530,17,275,158,296,292,454,2297,3718,9,34017,1889,1,0
90,3848,1289,550,1043,56,32,155,1345,10,167,93,185,177,278,1266,2075,5,11498,638,0,0
214,4584,182,127,129,0,0,53,182,5,39,21,42,44,63,217,343,2,926,51,0,1
214,4584,1165,710,800,67,119,181,1232,18,243,153,282,261,435,2000,3492,10,36473,2026,1,1
100,2037,773,419,590,28,0,166,801,10,204,113,217,214,330,1598,2554,5,13587,754,0,1
100,2037,421,273,302,44,34,57,465,17,81,59,107,98,166,583,1098,11,12329,684,0,1
60,1084,282,196,195,3,0,86,285,8,130,71,141,138,212,936,1507,4,6538,363,0,1
17,384,85,59,61,8,0,16,93,5,18,10,18,23,28,86,126,2,316,17,0,1
90,3814,1289,550,1043,56,32,155,1345,10,167,93,185,177,278,1266,2075,5,11498,638,0,1
147,6905,1392,870,1177,35,17,170,1427,14,494,280,531,508,811,4473,7289,7,54850,3047,2,1
87,2871,773,419,590,28,0,166,801,10,204,113,217,214,330,1598,2554,5,13587,754,0,1
97,4414,1338,495,1086,10,64,173,1348,11,122,82,157,133,239,883,1686,7,11934,663,0,1
23,577,102,59,69,5,3,24,107,6,22,15,28,28,43,113,206,3,789,43,0,1
156,4416,1660,832,1314,41,38,274,1701,20,312,209,395,332,604,2671,5058,12,64042,3557,1,1
73,3804,1296,573,1062,40,33,157,1336,8,201,118,231,209,349,1561,2689,4,12365,686,0,1
82,4295,1457,730,1242,11,6,188,1468,10,292,166,329,302,495,2424,4078,5,22973,1276,1,1
39,2324,652,304,544,16,6,88,668,6,89,51,101,95,152,591,998,3,3399,188,0,1
38,2301,334,251,279,10,4,40,344,5,127,74,143,132,217,899,1528,2,4303,239,0,1
33,1886,384,251,317,7,8,52,391,11,70,44,84,81,128,467,811,6,5355,297,0,1
39,1724,386,256,301,16,9,68,402,4,59,35,69,63,104,355,621,2,1453,80,0,1
75,2952,1043,504,840,53,9,147,1096,9,180,112,198,189,310,1377,2344,4,11604,644,0,1
82,4108,1943,715,1694,26,18,214,1969,12,185,120,237,197,357,1436,2721,7,20915,1161,0,1
51,595,647,139,84,35,284,233,682,0,0,0,0,0,0,0,0,0,0,0,0,1
111,2482,1043,504,840,53,9,147,1096,9,180,112,198,189,310,1377,2344,4,11604,644,0,1
111,2482,383,288,292,26,6,62,409,11,65,38,67,76,105,429,656,5,3719,206,0,1
78,3035,1043,504,840,53,9,147,1096,9,180,112,198,189,310,1377,2344,4,11604,644,0,1
214,4584,182,127,129,0,0,53,182,5,39,21,42,44,63,217,343,2,926,51,0,0
214,4584,1165,710,800,67,119,181,1232,18,243,153,282,261,435,2000,3492,10,36473,2026,1,0
100,2037,773,419,590,28,0,166,801,10,204,113,217,214,330,1598,2554,5,13587,754,0,0
100,2037,421,273,302,44,34,57,465,17,81,59,107,98,166,583,1098,11,12329,684,0,0
60,1084,282,196,195,3,0,86,285,8,130,71,141,138,212,936,1507,4,6538,363,0,0
17,384,85,59,61,8,0,16,93,5,18,10,18,23,28,86,126,2,316,17,0,0
90,3814,1289,550,1043,56,32,155,1345,10,167,93,185,177,278,1266,2075,5,11498,638,0,0
147,6905,1392,870,1177,35,17,170,1427,14,494,280,531,508,811,4473,7289,7,54850,3047,2,0
87,2871,773,419,590,28,0,166,801,10,204,113,217,214,330,1598,2554,5,13587,754,0,0
97,4414,1338,495,1086,10,64,173,1348,11,122,82,157,133,239,883,1686,7,11934,663,0,0
23,577,102,59,69,5,3,24,107,6,22,15,28,28,43,113,206,3,789,43,0,0
156,4416,1660,832,1314,41,38,274,1701,20,312,209,395,332,604,2671,5058,12,64042,3557,1,0
73,3804,1296,573,1062,40,33,157,1336,8,201,118,231,209,349,1561,2689,4,12365,686,0,0
82,4295,1457,730,1242,11,6,188,1468,10,292,166,329,302,495,2424,4078,5,22973,1276,1,0
39,2324,652,304,544,16,6,88,668,6,89,51,101,95,152,591,998,3,3399,188,0,0
38,2301,334,251,279,10,4,40,344,5,127,74,143,132,217,899,1528,2,4303,239,0,0
33,1886,384,251,317,7,8,52,391,11,70,44,84,81,128,467,811,6,5355,297,0,0
39,1724,386,256,301,16,9,68,402,4,59,35,69,63,104,355,621,2,1453,80,0,0
75,2952,1043,504,840,53,9,147,1096,9,180,112,198,189,310,1377,2344,4,11604,644,0,0
82,4108,1943,715,1694,26,18,214,1969,12,185,120,237,197,357,1436,2721,7,20915,1161,0,0
51,595,647,139,84,35,284,233,682,0,0,0,0,0,0,0,0,0,0,0,0,0
111,2482,1043,504,840,53,9,147,1096,9,180,112,198,189,310,1377,2344,4,11604,644,0,0
111,2482,383,288,292,26,6,62,409,11,65,38,67,76,105,429,656,5,3719,206,0,0
78,3035,1043,504,840,53,9,147,1096,9,180,112,198,189,310,1377,2344,4,11604,644,0,0
227,5227,4293,999,3693,19,54,507,4312,9,155,88,170,164,258,1156,1898,4,9368,520,0,1
227,5227,1482,859,1002,125,135,219,1607,16,219,134,251,235,385,1766,3032,9,27804,1544,1,1
230,5249,4293,999,3693,19,54,507,4312,9,155,88,170,164,258,1156,1898,4,9368,520,0,1
230,5249,1482,859,1002,125,135,219,1607,16,219,134,251,235,385,1766,3032,9,27804,1544,1,1
206,4323,1943,715,1694,26,18,214,1969,12,185,120,237,197,357,1436,2721,7,20915,1161,0,1
206,4323,1168,838,957,57,25,144,1225,19,348,224,416,367,640,3018,5452,11,61921,3440,1,1
90,4382,1943,715,1694,26,18,214,1969,12,185,120,237,197,357,1436,2721,7,20915,1161,0,1
207,4339,1943,715,1694,26,18,214,1969,12,185,120,237,197,357,1436,2721,7,20915,1161,0,0
207,4339,1168,838,957,57,25,144,1225,19,348,224,416,367,640,3018,5452,11,61921,3440,1,0
90,4382,1943,715,1694,26,18,214,1969,12,185,120,237,197,357,1436,2721,7,20915,1161,0,0
34,1617,1293,570,1093,25,15,163,1318,10,195,123,241,205,364,1516,2795,6,17273,959,0,0
103,2142,1020,354,843,12,15,144,1032,8,134,77,144,142,221,970,1580,4,6792,377,0,1
77,3417,1020,354,843,12,15,144,1032,8,134,77,144,142,221,970,1580,4,6792,377,0,1
104,2098,1020,354,843,12,15,144,1032,8,134,77,144,142,221,970,1580,4,6792,377,0,1
104,2104,1020,354,843,12,15,144,1032,8,134,77,144,142,221,970,1580,4,6792,377,0,0
77,3416,1020,354,843,12,15,144,1032,8,134,77,144,142,221,970,1580,4,6792,377,0,0
348,6977,1457,730,1242,11,6,188,1468,10,292,166,329,302,495,2424,4078,5,22973,1276,1,0
348,6977,74,35,59,1,0,14,75,3,14,7,14,17,21,58,85,1,128,7,0,0
348,6977,245,125,200,5,7,34,250,7,30,17,34,37,51,166,265,3,1053,58,0,0
120,2925,77,34,69,0,0,8,77,3,24,16,29,27,45,114,213,1,387,21,0,1
120,2925,712,438,573,51,9,84,763,14,102,71,128,116,199,733,1364,8,11988,666,0,1
28,1220,373,158,315,8,0,51,381,5,76,44,79,81,123,486,779,2,2026,112,0,1
28,1210,373,158,315,8,0,51,381,5,76,44,79,81,123,486,779,2,2026,112,0,0
48,1310,773,422,505,30,103,129,803,14,77,46,83,91,129,535,839,7,6334,351,0,0
12,489,139,89,101,2,0,35,141,7,54,34,62,61,96,330,569,4,2287,127,0,0
50,1354,773,422,505,30,103,129,803,14,77,46,83,91,129,535,839,7,6334,351,0,1
24,1115,1157,318,931,29,22,177,1186,6,104,63,125,110,188,712,1274,3,4596,255,0,1
50,1361,773,422,505,30,103,129,803,14,77,46,83,91,129,535,839,7,6334,351,0,1
23,1137,1157,318,931,29,22,177,1186,6,104,63,125,110,188,712,1274,3,4596,255,0,1
51,1412,773,422,505,30,103,129,803,14,77,46,83,91,129,535,839,7,6334,351,0,0
13,565,139,89,101,2,0,35,141,7,54,34,62,61,96,330,569,4,2287,127,0,0
53,1452,773,422,505,30,103,129,803,14,77,46,83,91,129,535,839,7,6334,351,0,1
23,1145,1157,318,931,29,22,177,1186,6,104,63,125,110,188,712,1274,3,4596,255,0,1
53,1452,773,422,505,30,103,129,803,14,77,46,83,91,129,535,839,7,6334,351,0,0
23,1101,1157,318,931,29,22,177,1186,6,104,63,125,110,188,712,1274,3,4596,255,0,0
57,1539,773,422,505,30,103,129,803,14,77,46,83,91,129,535,839,7,6334,351,0,0
23,1108,1157,318,931,29,22,177,1186,6,104,63,125,110,188,712,1274,3,4596,255,0,0
17,1072,1157,318,931,29,22,177,1186,6,104,63,125,110,188,712,1274,3,4596,255,0,0
63,1639,773,422,505,30,103,129,803,14,77,46,83,91,129,535,839,7,6334,351,0,1
24,1310,1157,318,931,29,22,177,1186,6,104,63,125,110,188,712,1274,3,4596,255,0,1
23,1297,1157,318,931,29,22,177,1186,6,104,63,125,110,188,712,1274,3,4596,255,0,0
13,571,139,89,101,2,0,35,141,7,54,34,62,61,96,330,569,4,2287,127,0,0
63,1639,773,422,505,30,103,129,803,14,77,46,83,91,129,535,839,7,6334,351,0,0
352,7047,1457,730,1242,11,6,188,1468,10,292,166,329,302,495,2424,4078,5,22973,1276,1,1
352,7047,74,35,59,1,0,14,75,3,14,7,14,17,21,58,85,1,128,7,0,1
352,7047,245,125,200,5,7,34,250,7,30,17,34,37,51,166,265,3,1053,58,0,1
117,2821,77,34,69,0,0,8,77,3,24,16,29,27,45,114,213,1,387,21,0,1
117,2821,712,438,573,51,9,84,763,14,102,71,128,116,199,733,1364,8,11988,666,0,1
27,1108,373,158,315,8,0,51,381,5,76,44,79,81,123,486,779,2,2026,112,0,1
67,1738,773,422,505,30,103,129,803,14,77,46,83,91,129,535,839,7,6334,351,0,0
25,1443,1157,318,931,29,22,177,1186,6,104,63,125,110,188,712,1274,3,4596,255,0,0
87,2475,1523,757,1297,19,12,193,1542,12,193,117,230,205,347,1508,2664,7,19053,1058,0,1
87,2475,701,378,504,33,58,109,734,13,110,68,126,123,194,794,1346,7,10027,557,0,1
91,4494,1523,757,1297,19,12,193,1542,12,193,117,230,205,347,1508,2664,7,19053,1058,0,1
69,1729,773,422,505,30,103,129,803,14,77,46,83,91,129,535,839,7,6334,351,0,0
25,1433,1157,318,931,29,22,177,1186,6,104,63,125,110,188,712,1274,3,4596,255,0,0
25,1432,1157,318,931,29,22,177,1186,6,104,63,125,110,188,712,1274,3,4596,255,0,0
68,1718,773,422,505,30,103,129,803,14,77,46,83,91,129,535,839,7,6334,351,0,0
349,6987,1457,730,1242,11,6,188,1468,10,292,166,329,302,495,2424,4078,5,22973,1276,1,0
349,6987,74,35,59,1,0,14,75,3,14,7,14,17,21,58,85,1,128,7,0,0
349,6987,245,125,200,5,7,34,250,7,30,17,34,37,51,166,265,3,1053,58,0,0
84,4398,1457,730,1242,11,6,188,1468,10,292,166,329,302,495,2424,4078,5,22973,1276,1,0
83,4348,1457,730,1242,11,6,188,1468,10,292,166,329,302,495,2424,4078,5,22973,1276,1,0
83,4374,1457,730,1242,11,6,188,1468,10,292,166,329,302,495,2424,4078,5,22973,1276,1,0
347,6972,1457,730,1242,11,6,188,1468,10,292,166,329,302,495,2424,4078,5,22973,1276,1,1
347,6972,74,35,59,1,0,14,75,3,14,7,14,17,21,58,85,1,128,7,0,1
347,6972,245,125,200,5,7,34,250,7,30,17,34,37,51,166,265,3,1053,58,0,1
27,950,74,35,59,1,0,14,75,3,14,7,14,17,21,58,85,1,128,7,0,1
27,950,245,125,200,5,7,34,250,7,30,17,34,37,51,166,265,3,1053,58,0,1
84,4416,1457,730,1242,11,6,188,1468,10,292,166,329,302,495,2424,4078,5,22973,1276,1,1
11,238,19,8,11,5,0,4,24,2,5,3,6,7,9,13,25,1,30,1,0,1
11,238,102,59,69,5,3,24,107,6,22,15,28,28,43,113,206,3,789,43,0,1
11,238,106,40,36,3,49,17,109,8,17,13,23,25,36,93,167,5,904,50,0,1
26,527,2,2,2,0,0,0,2,0,0,0,0,0,0,0,0,0,0,0,0,1
26,527,99,48,90,1,3,5,100,0,0,0,0,0,0,0,0,0,0,0,0,1
26,527,8,5,5,2,0,1,10,0,0,0,0,0,0,0,0,0,0,0,0,1
26,527,1217,716,841,84,126,174,1301,14,185,118,215,199,333,1446,2542,8,20687,1149,0,1
26,527,160,89,115,0,13,31,160,7,15,11,17,22,28,78,124,3,495,27,0,1
26,527,10,10,9,9,0,0,19,0,0,0,0,0,0,0,0,0,0,0,0,1
26,527,173,84,99,8,29,36,181,5,12,7,13,17,20,54,81,2,221,12,0,1
26,527,3,1,1,3,0,0,6,0,0,0,0,0,0,0,0,0,0,0,0,1
59,1355,996,429,845,24,10,117,1020,7,76,50,88,83,138,494,879,4,3565,198,0,1
59,1355,456,277,329,12,42,72,468,13,85,50,97,98,147,592,972,7,7212,400,0,1
141,2977,1513,682,1277,25,13,200,1538,11,199,116,219,210,335,1557,2584,6,15641,868,0,1
141,2977,819,519,539,24,98,155,843,15,96,57,106,111,163,690,1107,8,9171,509,0,1
348,6992,1457,730,1242,11,6,188,1468,10,292,166,329,302,495,2424,4078,5,22973,1276,1,1
348,6992,74,35,59,1,0,14,75,3,14,7,14,17,21,58,85,1,128,7,0,1
348,6992,245,125,200,5,7,34,250,7,30,17,34,37,51,166,265,3,1053,58,0,1
231,5277,4293,999,3693,19,54,507,4312,9,155,88,170,164,258,1156,1898,4,9368,520,0,1
231,5277,1482,859,1002,125,135,219,1607,16,219,134,251,235,385,1766,3032,9,27804,1544,1,1
117,2804,77,34,69,0,0,8,77,3,24,16,29,27,45,114,213,1,387,21,0,1
117,2804,712,438,573,51,9,84,763,14,102,71,128,116,199,733,1364,8,11988,666,0,1
104,2107,1020,354,843,12,15,144,1032,8,134,77,144,142,221,970,1580,4,6792,377,0,1
46,963,447,308,343,6,5,95,453,7,96,59,111,103,170,651,1136,4,4600,255,0,1
46,963,322,174,179,16,74,51,338,10,41,26,46,51,72,252,408,5,2291,127,0,1
223,5307,722,423,573,19,0,135,741,12,172,101,199,184,300,1320,2257,6,15668,870,0,1
223,5307,1508,847,911,44,250,301,1552,14,148,88,169,162,257,1120,1886,7,15077,837,0,1
111,2485,1043,504,840,53,9,147,1096,9,180,112,198,189,310,1377,2344,4,11604,644,0,1
111,2485,383,288,292,26,6,62,409,11,65,38,67,76,105,429,656,5,3719,206,0,1
207,4345,1943,715,1694,26,18,214,1969,12,185,120,237,197,357,1436,2721,7,20915,1161,0,1
207,4345,1168,838,957,57,25,144,1225,19,348,224,416,367,640,3018,5452,11,61921,3440,1,1
90,3848,1289,550,1043,56,32,155,1345,10,167,93,185,177,278,1266,2075,5,11498,638,0,1
135,5792,1782,648,1425,9,47,279,1791,8,171,97,189,179,286,1292,2140,4,9462,525,0,1
128,5159,1513,682,1277,25,13,200,1538,11,199,116,219,210,335,1557,2584,6,15641,868,0,1
45,2208,722,423,573,19,0,135,741,12,172,101,199,184,300,1320,2257,6,15668,870,0,1
90,4388,1943,715,1694,26,18,214,1969,12,185,120,237,197,357,1436,2721,7,20915,1161,0,1
69,1731,773,422,505,30,103,129,803,14,77,46,83,91,129,535,839,7,6334,351,0,0
13,563,139,89,101,2,0,35,141,7,54,34,62,61,96,330,569,4,2287,127,0,0
347,6972,1457,730,1242,11,6,188,1468,10,292,166,329,302,495,2424,4078,5,22973,1276,1,0
347,6972,74,35,59,1,0,14,75,3,14,7,14,17,21,58,85,1,128,7,0,0
347,6972,245,125,200,5,7,34,250,7,30,17,34,37,51,166,265,3,1053,58,0,0
27,950,74,35,59,1,0,14,75,3,14,7,14,17,21,58,85,1,128,7,0,0
27,950,245,125,200,5,7,34,250,7,30,17,34,37,51,166,265,3,1053,58,0,0
84,4416,1457,730,1242,11,6,188,1468,10,292,166,329,302,495,2424,4078,5,22973,1276,1,0
11,238,19,8,11,5,0,4,24,2,5,3,6,7,9,13,25,1,30,1,0,0
11,238,102,59,69,5,3,24,107,6,22,15,28,28,43,113,206,3,789,43,0,0
11,238,106,40,36,3,49,17,109,8,17,13,23,25,36,93,167,5,904,50,0,0
26,527,2,2,2,0,0,0,2,0,0,0,0,0,0,0,0,0,0,0,0,0
26,527,99,48,90,1,3,5,100,0,0,0,0,0,0,0,0,0,0,0,0,0
26,527,8,5,5,2,0,1,10,0,0,0,0,0,0,0,0,0,0,0,0,0
26,527,1217,716,841,84,126,174,1301,14,185,118,215,199,333,1446,2542,8,20687,1149,0,0
26,527,160,89,115,0,13,31,160,7,15,11,17,22,28,78,124,3,495,27,0,0
26,527,10,10,9,9,0,0,19,0,0,0,0,0,0,0,0,0,0,0,0,0
26,527,173,84,99,8,29,36,181,5,12,7,13,17,20,54,81,2,221,12,0,0
26,527,3,1,1,3,0,0,6,0,0,0,0,0,0,0,0,0,0,0,0,0
59,1355,996,429,845,24,10,117,1020,7,76,50,88,83,138,494,879,4,3565,198,0,0
59,1355,456,277,329,12,42,72,468,13,85,50,97,98,147,592,972,7,7212,400,0,0
141,2977,1513,682,1277,25,13,200,1538,11,199,116,219,210,335,1557,2584,6,15641,868,0,0
141,2977,819,519,539,24,98,155,843,15,96,57,106,111,163,690,1107,8,9171,509,0,0
347,6987,1457,730,1242,11,6,188,1468,10,292,166,329,302,495,2424,4078,5,22973,1276,1,0
347,6987,74,35,59,1,0,14,75,3,14,7,14,17,21,58,85,1,128,7,0,0
347,6987,245,125,200,5,7,34,250,7,30,17,34,37,51,166,265,3,1053,58,0,0
231,5277,4293,999,3693,19,54,507,4312,9,155,88,170,164,258,1156,1898,4,9368,520,0,0
231,5277,1482,859,1002,125,135,219,1607,16,219,134,251,235,385,1766,3032,9,27804,1544,1,0
117,2804,77,34,69,0,0,8,77,3,24,16,29,27,45,114,213,1,387,21,0,0
117,2804,712,438,573,51,9,84,763,14,102,71,128,116,199,733,1364,8,11988,666,0,0
104,2107,1020,354,843,12,15,144,1032,8,134,77,144,142,221,970,1580,4,6792,377,0,0
46,963,447,308,343,6,5,95,453,7,96,59,111,103,170,651,1136,4,4600,255,0,0
46,963,322,174,179,16,74,51,338,10,41,26,46,51,72,252,408,5,2291,127,0,0
223,5307,722,423,573,19,0,135,741,12,172,101,199,184,300,1320,2257,6,15668,870,0,0
223,5307,1508,847,911,44,250,301,1552,14,148,88,169,162,257,1120,1886,7,15077,837,0,0
111,2485,1043,504,840,53,9,147,1096,9,180,112,198,189,310,1377,2344,4,11604,644,0,0
111,2485,383,288,292,26,6,62,409,11,65,38,67,76,105,429,656,5,3719,206,0,0
207,4345,1943,715,1694,26,18,214,1969,12,185,120,237,197,357,1436,2721,7,20915,1161,0,0
207,4345,1168,838,957,57,25,144,1225,19,348,224,416,367,640,3018,5452,11,61921,3440,1,0
135,5792,1782,648,1425,9,47,279,1791,8,171,97,189,179,286,1292,2140,4,9462,525,0,0
128,5159,1513,682,1277,25,13,200,1538,11,199,116,219,210,335,1557,2584,6,15641,868,0,0
45,2208,722,423,573,19,0,135,741,12,172,101,199,184,300,1320,2257,6,15668,870,0,0
90,4388,1943,715,1694,26,18,214,1969,12,185,120,237,197,357,1436,2721,7,20915,1161,0,0
28,1141,373,158,315,8,0,51,381,5,76,44,79,81,123,486,779,2,2026,112,0,1
352,7034,1457,730,1242,11,6,188,1468,10,292,166,329,302,495,2424,4078,5,22973,1276,1,0
352,7034,74,35,59,1,0,14,75,3,14,7,14,17,21,58,85,1,128,7,0,0
352,7034,245,125,200,5,7,34,250,7,30,17,34,37,51,166,265,3,1053,58,0,0
22,666,339,213,244,17,9,65,356,10,42,26,48,52,74,259,421,5,2410,133,0,0
105,2128,1020,354,843,12,15,144,1032,8,134,77,144,142,221,970,1580,4,6792,377,0,1
259,6118,72,33,56,0,4,12,72,1,1,1,1,2,2,0,2,0,1,0,0,1
259,6118,1454,835,1044,76,110,219,1530,17,275,158,296,292,454,2297,3718,9,34017,1889,1,1
108,2217,1020,354,843,12,15,144,1032,8,134,77,144,142,221,970,1580,4,6792,377,0,0
82,3538,1020,354,843,12,15,144,1032,8,134,77,144,142,221,970,1580,4,6792,377,0,0
138,5836,1782,648,1425,9,47,279,1791,8,171,97,189,179,286,1292,2140,4,9462,525,0,1
82,3550,1020,354,843,12,15,144,1032,8,134,77,144,142,221,970,1580,4,6792,377,0,0
82,3556,1020,354,843,12,15,144,1032,8,134,77,144,142,221,970,1580,4,6792,377,0,0
108,2218,1020,354,843,12,15,144,1032,8,134,77,144,142,221,970,1580,4,6792,377,0,0
82,3566,1020,354,843,12,15,144,1032,8,134,77,144,142,221,970,1580,4,6792,377,0,0
259,6118,72,33,56,0,4,12,72,1,1,1,1,2,2,0,2,0,1,0,0,0
259,6118,1454,835,1044,76,110,219,1530,17,275,158,296,292,454,2297,3718,9,34017,1889,1,0
138,5836,1782,648,1425,9,47,279,1791,8,171,97,189,179,286,1292,2140,4,9462,525,0,0
90,3826,1289,550,1043,56,32,155,1345,10,167,93,185,177,278,1266,2075,5,11498,638,0,0
97,4416,1338,495,1086,10,64,173,1348,11,122,82,157,133,239,883,1686,7,11934,663,0,0
84,4400,1457,730,1242,11,6,188,1468,10,292,166,329,302,495,2424,4078,5,22973,1276,1,0
78,3015,1043,504,840,53,9,147,1096,9,180,112,198,189,310,1377,2344,4,11604,644,0,0
90,4376,1943,715,1694,26,18,214,1969,12,185,120,237,197,357,1436,2721,7,20915,1161,0,0
230,5261,4293,999,3693,19,54,507,4312,9,155,88,170,164,258,1156,1898,4,9368,520,0,0
230,5261,1482,859,1002,125,135,219,1607,16,219,134,251,235,385,1766,3032,9,27804,1544,1,0
87,2475,1523,757,1297,19,12,193,1542,12,193,117,230,205,347,1508,2664,7,19053,1058,0,0
87,2475,701,378,504,33,58,109,734,13,110,68,126,123,194,794,1346,7,10027,557,0,0
91,4494,1523,757,1297,19,12,193,1542,12,193,117,230,205,347,1508,2664,7,19053,1058,0,0
78,2063,773,422,505,30,103,129,803,14,77,46,83,91,129,535,839,7,6334,351,0,0
1,135,149,67,118,4,0,27,153,1,17,14,28,18,42,69,175,0,144,8,0,0
60,1088,282,196,195,3,0,86,285,8,130,71,141,138,212,936,1507,4,6538,363,0,0
100,2042,1020,354,843,12,15,144,1032,8,134,77,144,142,221,970,1580,4,6792,377,0,0
258,6111,72,33,56,0,4,12,72,1,1,1,1,2,2,0,2,0,1,0,0,0
258,6111,1454,835,1044,76,110,219,1530,17,275,158,296,292,454,2297,3718,9,34017,1889,1,0
32,2401,996,429,845,24,10,117,1020,7,76,50,88,83,138,494,879,4,3565,198,0,0
209,4372,1943,715,1694,26,18,214,1969,12,185,120,237,197,357,1436,2721,7,20915,1161,0,1
209,4372,1168,838,957,57,25,144,1225,19,348,224,416,367,640,3018,5452,11,61921,3440,1,1
91,4435,1943,715,1694,26,18,214,1969,12,185,120,237,197,357,1436,2721,7,20915,1161,0,1
351,7022,1457,730,1242,11,6,188,1468,10,292,166,329,302,495,2424,4078,5,22973,1276,1,0
351,7022,74,35,59,1,0,14,75,3,14,7,14,17,21,58,85,1,128,7,0,0
351,7022,245,125,200,5,7,34,250,7,30,17,34,37,51,166,265,3,1053,58,0,0
30,1214,373,158,315,8,0,51,381,5,76,44,79,81,123,486,779,2,2026,112,0,0
350,7046,1457,730,1242,11,6,188,1468,10,292,166,329,302,495,2424,4078,5,22973,1276,1,0
350,7046,74,35,59,1,0,14,75,3,14,7,14,17,21,58,85,1,128,7,0,0
350,7046,245,125,200,5,7,34,250,7,30,17,34,37,51,166,265,3,1053,58,0,0
117,2824,77,34,69,0,0,8,77,3,24,16,29,27,45,114,213,1,387,21,0,0
117,2824,712,438,573,51,9,84,763,14,102,71,128,116,199,733,1364,8,11988,666,0,0
30,1193,373,158,315,8,0,51,381,5,76,44,79,81,123,486,779,2,2026,112,0,0
28,1170,373,158,315,8,0,51,381,5,76,44,79,81,123,486,779,2,2026,112,0,0
234,5320,4293,999,3693,19,54,507,4312,9,155,88,170,164,258,1156,1898,4,9368,520,0,0
234,5320,1482,859,1002,125,135,219,1607,16,219,134,251,235,385,1766,3032,9,27804,1544,1,0
163,7176,139,89,101,2,0,35,141,7,54,34,62,61,96,330,569,4,2287,127,0,0
163,7176,7,5,5,0,0,2,7,1,2,1,2,3,3,2,4,0,2,0,0,0
97,2643,1523,757,1297,19,12,193,1542,12,193,117,230,205,347,1508,2664,7,19053,1058,0,0
97,2643,701,378,504,33,58,109,734,13,110,68,126,123,194,794,1346,7,10027,557,0,0
113,2514,1043,504,840,53,9,147,1096,9,180,112,198,189,310,1377,2344,4,11604,644,0,0
113,2514,383,288,292,26,6,62,409,11,65,38,67,76,105,429,656,5,3719,206,0,0
94,4604,1523,757,1297,19,12,193,1542,12,193,117,230,205,347,1508,2664,7,19053,1058,0,0
34,1626,1293,570,1093,25,15,163,1318,10,195,123,241,205,364,1516,2795,6,17273,959,0,0
34,1634,1293,570,1093,25,15,163,1318,10,195,123,241,205,364,1516,2795,6,17273,959,0,1
34,1634,1293,570,1093,25,15,163,1318,10,195,123,241,205,364,1516,2795,6,17273,959,0,0
79,2067,773,422,505,30,103,129,803,14,77,46,83,91,129,535,839,7,6334,351,0,0
26,1513,1157,318,931,29,22,177,1186,6,104,63,125,110,188,712,1274,3,4596,255,0,0
80,2120,773,422,505,30,103,129,803,14,77,46,83,91,129,535,839,7,6334,351,0,0
25,1456,1157,318,931,29,22,177,1186,6,104,63,125,110,188,712,1274,3,4596,255,0,0
210,4402,1943,715,1694,26,18,214,1969,12,185,120,237,197,357,1436,2721,7,20915,1161,0,1
210,4402,1168,838,957,57,25,144,1225,19,348,224,416,367,640,3018,5452,11,61921,3440,1,1
91,4486,1943,715,1694,26,18,214,1969,12,185,120,237,197,357,1436,2721,7,20915,1161,0,1
83,2161,773,422,505,30,103,129,803,14,77,46,83,91,129,535,839,7,6334,351,0,1
27,1578,1157,318,931,29,22,177,1186,6,104,63,125,110,188,712,1274,3,4596,255,0,1
82,2143,773,422,505,30,103,129,803,14,77,46,83,91,129,535,839,7,6334,351,0,0
210,4422,1943,715,1694,26,18,214,1969,12,185,120,237,197,357,1436,2721,7,20915,1161,0,0
210,4422,1168,838,957,57,25,144,1225,19,348,224,416,367,640,3018,5452,11,61921,3440,1,0
91,4548,1943,715,1694,26,18,214,1969,12,185,120,237,197,357,1436,2721,7,20915,1161,0,0
27,1578,1157,318,931,29,22,177,1186,6,104,63,125,110,188,712,1274,3,4596,255,0,0
84,2178,773,422,505,30,103,129,803,14,77,46,83,91,129,535,839,7,6334,351,0,0
28,1711,1157,318,931,29,22,177,1186,6,104,63,125,110,188,712,1274,3,4596,255,0,0
210,4412,1943,715,1694,26,18,214,1969,12,185,120,237,197,357,1436,2721,7,20915,1161,0,0
210,4412,1168,838,957,57,25,144,1225,19,348,224,416,367,640,3018,5452,11,61921,3440,1,0
210,4418,1943,715,1694,26,18,214,1969,12,185,120,237,197,357,1436,2721,7,20915,1161,0,0
210,4418,1168,838,957,57,25,144,1225,19,348,224,416,367,640,3018,5452,11,61921,3440,1,0
91,4542,1943,715,1694,26,18,214,1969,12,185,120,237,197,357,1436,2721,7,20915,1161,0,0
54,1096,207,111,150,11,0,50,218,5,26,19,36,31,55,133,272,3,943,52,0,1
54,1096,410,198,237,31,55,97,441,11,63,38,72,74,110,414,683,6,4293,238,0,1
33,991,465,148,393,5,8,60,470,4,31,20,31,35,51,161,261,2,523,29,0,1
33,991,16,12,9,0,0,6,16,1,2,1,2,3,3,2,4,0,2,0,0,1
23,722,339,213,244,17,9,65,356,10,42,26,48,52,74,259,421,5,2410,133,0,1
36,1762,1293,570,1093,25,15,163,1318,10,195,123,241,205,364,1516,2795,6,17273,959,0,1
66,1783,1455,414,1257,16,76,112,1471,5,41,23,46,46,69,231,381,2,1069,59,0,0
66,1783,669,365,481,22,61,110,691,15,103,63,122,118,185,747,1273,8,11311,628,0,0
72,1639,996,429,845,24,10,117,1020,7,76,50,88,83,138,494,879,4,3565,198,0,1
72,1639,456,277,329,12,42,72,468,13,85,50,97,98,147,592,972,7,7212,400,0,1
34,2781,996,429,845,24,10,117,1020,7,76,50,88,83,138,494,879,4,3565,198,0,1
209,4409,1943,715,1694,26,18,214,1969,12,185,120,237,197,357,1436,2721,7,20915,1161,0,0
209,4409,1168,838,957,57,25,144,1225,19,348,224,416,367,640,3018,5452,11,61921,3440,1,0
92,4598,1943,715,1694,26,18,214,1969,12,185,120,237,197,357,1436,2721,7,20915,1161,0,0
67,1795,1455,414,1257,16,76,112,1471,5,41,23,46,46,69,231,381,2,1069,59,0,0
67,1795,669,365,481,22,61,110,691,15,103,63,122,118,185,747,1273,8,11311,628,0,0
73,1417,757,253,292,73,244,162,830,13,61,38,67,74,105,409,651,7,4654,258,0,0
74,1419,757,253,292,73,244,162,830,13,61,38,67,74,105,409,651,7,4654,258,0,0
21,572,256,139,192,9,7,47,265,4,23,12,24,27,36,112,171,2,357,19,0,0
230,5261,4293,999,3693,19,54,507,4312,9,155,88,170,164,258,1156,1898,4,9368,520,0,1
230,5261,1482,859,1002,125,135,219,1607,16,219,134,251,235,385,1766,3032,9,27804,1544,1,1
15,466,42,7,35,4,0,5,46,1,2,1,2,3,3,2,4,0,2,0,0,1
15,466,11,6,10,0,0,1,11,2,4,2,4,6,6,10,15,1,15,0,0,1
54,1096,207,111,150,11,0,50,218,5,26,19,36,31,55,133,272,3,943,52,0,0
54,1096,410,198,237,31,55,97,441,11,63,38,72,74,110,414,683,6,4293,238,0,0
33,991,465,148,393,5,8,60,470,4,31,20,31,35,51,161,261,2,523,29,0,0
33,991,16,12,9,0,0,6,16,1,2,1,2,3,3,2,4,0,2,0,0,0
23,722,339,213,244,17,9,65,356,10,42,26,48,52,74,259,421,5,2410,133,0,0
36,1779,1293,570,1093,25,15,163,1318,10,195,123,241,205,364,1516,2795,6,17273,959,0,0
123,2925,77,34,69,0,0,8,77,3,24,16,29,27,45,114,213,1,387,21,0,0
123,2925,712,438,573,51,9,84,763,14,102,71,128,116,199,733,1364,8,11988,666,0,0
30,1233,373,158,315,8,0,51,381,5,76,44,79,81,123,486,779,2,2026,112,0,0
29,1792,1157,318,931,29,22,177,1186,6,104,63,125,110,188,712,1274,3,4596,255,0,0
85,2182,773,422,505,30,103,129,803,14,77,46,83,91,129,535,839,7,6334,351,0,0
24,749,339,213,244,17,9,65,356,10,42,26,48,52,74,259,421,5,2410,133,0,1
37,1850,1293,570,1093,25,15,163,1318,10,195,123,241,205,364,1516,2795,6,17273,959,0,1
36,1762,1293,570,1093,25,15,163,1318,10,195,123,241,205,364,1516,2795,6,17273,959,0,0
25,753,339,213,244,17,9,65,356,10,42,26,48,52,74,259,421,5,2410,133,0,1
209,4399,1943,715,1694,26,18,214,1969,12,185,120,237,197,357,1436,2721,7,20915,1161,0,1
209,4399,1168,838,957,57,25,144,1225,19,348,224,416,367,640,3018,5452,11,61921,3440,1,1
38,1882,1293,570,1093,25,15,163,1318,10,195,123,241,205,364,1516,2795,6,17273,959,0,1
92,4613,1943,715,1694,26,18,214,1969,12,185,120,237,197,357,1436,2721,7,20915,1161,0,1
84,2139,773,422,505,30,103,129,803,14,77,46,83,91,129,535,839,7,6334,351,0,1
27,1631,1157,318,931,29,22,177,1186,6,104,63,125,110,188,712,1274,3,4596,255,0,1
25,753,339,213,244,17,9,65,356,10,42,26,48,52,74,259,421,5,2410,133,0,0
209,4399,1943,715,1694,26,18,214,1969,12,185,120,237,197,357,1436,2721,7,20915,1161,0,0
209,4399,1168,838,957,57,25,144,1225,19,348,224,416,367,640,3018,5452,11,61921,3440,1,0
38,1882,1293,570,1093,25,15,163,1318,10,195,123,241,205,364,1516,2795,6,17273,959,0,0
92,4613,1943,715,1694,26,18,214,1969,12,185,120,237,197,357,1436,2721,7,20915,1161,0,0
98,2673,1523,757,1297,19,12,193,1542,12,193,117,230,205,347,1508,2664,7,19053,1058,0,1
98,2673,701,378,504,33,58,109,734,13,110,68,126,123,194,794,1346,7,10027,557,0,1
79,1692,53,23,39,0,0,13,53,2,8,4,8,10,12,26,39,1,39,2,0,1
79,1692,515,298,307,33,80,99,548,12,63,44,77,75,121,419,753,7,5527,307,0,1
113,2525,1043,504,840,53,9,147,1096,9,180,112,198,189,310,1377,2344,4,11604,644,0,1
113,2525,383,288,292,26,6,62,409,11,65,38,67,76,105,429,656,5,3719,206,0,1
94,4604,1523,757,1297,19,12,193,1542,12,193,117,230,205,347,1508,2664,7,19053,1058,0,1
38,1865,1293,570,1093,25,15,163,1318,10,195,123,241,205,364,1516,2795,6,17273,959,0,0
91,4587,1943,715,1694,26,18,214,1969,12,185,120,237,197,357,1436,2721,7,20915,1161,0,0
98,2670,1523,757,1297,19,12,193,1542,12,193,117,230,205,347,1508,2664,7,19053,1058,0,0
98,2670,701,378,504,33,58,109,734,13,110,68,126,123,194,794,1346,7,10027,557,0,0
113,2530,1043,504,840,53,9,147,1096,9,180,112,198,189,310,1377,2344,4,11604,644,0,0
113,2530,383,288,292,26,6,62,409,11,65,38,67,76,105,429,656,5,3719,206,0,0
75,1466,757,253,292,73,244,162,830,13,61,38,67,74,105,409,651,7,4654,258,0,1
52,3387,520,294,400,33,13,81,553,10,261,204,367,271,571,2128,4614,7,32445,1802,1,1
234,5333,4293,999,3693,19,54,507,4312,9,155,88,170,164,258,1156,1898,4,9368,520,0,0
234,5333,1482,859,1002,125,135,219,1607,16,219,134,251,235,385,1766,3032,9,27804,1544,1,0
75,1466,757,253,292,73,244,162,830,13,61,38,67,74,105,409,651,7,4654,258,0,0
52,3387,520,294,400,33,13,81,553,10,261,204,367,271,571,2128,4614,7,32445,1802,1,0
79,1692,53,23,39,0,0,13,53,2,8,4,8,10,12,26,39,1,39,2,0,0
79,1692,515,298,307,33,80,99,548,12,63,44,77,75,121,419,753,7,5527,307,0,0
164,7205,139,89,101,2,0,35,141,7,54,34,62,61,96,330,569,4,2287,127,0,1
164,7205,7,5,5,0,0,2,7,1,2,1,2,3,3,2,4,0,2,0,0,1
234,5348,4293,999,3693,19,54,507,4312,9,155,88,170,164,258,1156,1898,4,9368,520,0,0
234,5348,1482,859,1002,125,135,219,1607,16,219,134,251,235,385,1766,3032,9,27804,1544,1,0
108,2220,2,2,2,0,0,0,2,0,0,0,0,0,0,0,0,0,0,0,0,0
108,2220,99,48,90,1,3,5,100,0,0,0,0,0,0,0,0,0,0,0,0,0
108,2220,8,5,5,2,0,1,10,0,0,0,0,0,0,0,0,0,0,0,0,0
108,2220,1217,716,841,84,126,174,1301,14,185,118,215,199,333,1446,2542,8,20687,1149,0,0
108,2220,160,89,115,0,13,31,160,7,15,11,17,22,28,78,124,3,495,27,0,0
108,2220,10,10,9,9,0,0,19,0,0,0,0,0,0,0,0,0,0,0,0,0
108,2220,173,84,99,8,29,36,181,5,12,7,13,17,20,54,81,2,221,12,0,0
108,2220,3,1,1,3,0,0,6,0,0,0,0,0,0,0,0,0,0,0,0,0
33,701,125,97,103,3,0,19,128,9,25,17,27,34,44,144,223,4,1087,60,0,1
75,1390,1178,367,1042,6,15,115,1184,9,94,51,95,103,146,644,976,4,4439,246,0,1
75,1390,177,108,140,8,0,27,185,6,30,16,32,36,48,162,248,3,794,44,0,1
71,1417,1178,367,1042,6,15,115,1184,9,94,51,95,103,146,644,976,4,4439,246,0,0
71,1417,177,108,140,8,0,27,185,6,30,16,32,36,48,162,248,3,794,44,0,0
15,468,42,7,35,4,0,5,46,1,2,1,2,3,3,2,4,0,2,0,0,0
15,468,11,6,10,0,0,1,11,2,4,2,4,6,6,10,15,1,15,0,0,0
85,1879,2,2,2,0,0,0,2,0,0,0,0,0,0,0,0,0,0,0,0,1
85,1879,99,48,90,1,3,5,100,0,0,0,0,0,0,0,0,0,0,0,0,1
85,1879,8,5,5,2,0,1,10,0,0,0,0,0,0,0,0,0,0,0,0,1
85,1879,1217,716,841,84,126,174,1301,14,185,118,215,199,333,1446,2542,8,20687,1149,0,1
85,1879,160,89,115,0,13,31,160,7,15,11,17,22,28,78,124,3,495,27,0,1
85,1879,10,10,9,9,0,0,19,0,0,0,0,0,0,0,0,0,0,0,0,1
85,1879,173,84,99,8,29,36,181,5,12,7,13,17,20,54,81,2,221,12,0,1
85,1879,3,1,1,3,0,0,6,0,0,0,0,0,0,0,0,0,0,0,0,1
23,363,102,57,55,5,16,25,107,5,17,10,18,22,28,81,124,2,330,18,0,1
24,380,102,57,55,5,16,25,107,5,17,10,18,22,28,81,124,2,330,18,0,1
22,528,2,2,2,0,0,0,2,0,0,0,0,0,0,0,0,0,0,0,0,1
22,528,99,48,90,1,3,5,100,0,0,0,0,0,0,0,0,0,0,0,0,1
22,528,8,5,5,2,0,1,10,0,0,0,0,0,0,0,0,0,0,0,0,1
22,528,1217,716,841,84,126,174,1301,14,185,118,215,199,333,1446,2542,8,20687,1149,0,1
22,528,160,89,115,0,13,31,160,7,15,11,17,22,28,78,124,3,495,27,0,1
22,528,10,10,9,9,0,0,19,0,0,0,0,0,0,0,0,0,0,0,0,1
22,528,173,84,99,8,29,36,181,5,12,7,13,17,20,54,81,2,221,12,0,1
22,528,3,1,1,3,0,0,6,0,0,0,0,0,0,0,0,0,0,0,0,1
63,1378,402,202,227,24,74,80,426,12,52,33,61,64,94,339,564,7,3969,220,0,1
259,6120,72,33,56,0,4,12,72,1,1,1,1,2,2,0,2,0,1,0,0,1
259,6120,1454,835,1044,76,110,219,1530,17,275,158,296,292,454,2297,3718,9,34017,1889,1,1
24,588,2,2,2,0,0,0,2,0,0,0,0,0,0,0,0,0,0,0,0,0
24,588,99,48,90,1,3,5,100,0,0,0,0,0,0,0,0,0,0,0,0,0
24,588,8,5,5,2,0,1,10,0,0,0,0,0,0,0,0,0,0,0,0,0
24,588,1217,716,841,84,126,174,1301,14,185,118,215,199,333,1446,2542,8,20687,1149,0,0
24,588,160,89,115,0,13,31,160,7,15,11,17,22,28,78,124,3,495,27,0,0
24,588,10,10,9,9,0,0,19,0,0,0,0,0,0,0,0,0,0,0,0,0
24,588,173,84,99,8,29,36,181,5,12,7,13,17,20,54,81,2,221,12,0,0
24,588,3,1,1,3,0,0,6,0,0,0,0,0,0,0,0,0,0,0,0,0
24,599,2,2,2,0,0,0,2,0,0,0,0,0,0,0,0,0,0,0,0,0
24,599,99,48,90,1,3,5,100,0,0,0,0,0,0,0,0,0,0,0,0,0
24,599,8,5,5,2,0,1,10,0,0,0,0,0,0,0,0,0,0,0,0,0
24,599,1217,716,841,84,126,174,1301,14,185,118,215,199,333,1446,2542,8,20687,1149,0,0
24,599,160,89,115,0,13,31,160,7,15,11,17,22,28,78,124,3,495,27,0,0
24,599,10,10,9,9,0,0,19,0,0,0,0,0,0,0,0,0,0,0,0,0
24,599,173,84,99,8,29,36,181,5,12,7,13,17,20,54,81,2,221,12,0,0
24,599,3,1,1,3,0,0,6,0,0,0,0,0,0,0,0,0,0,0,0,0
259,6120,72,33,56,0,4,12,72,1,1,1,1,2,2,0,2,0,1,0,0,0
259,6120,1454,835,1044,76,110,219,1530,17,275,158,296,292,454,2297,3718,9,34017,1889,1,0
39,1946,1293,570,1093,25,15,163,1318,10,195,123,241,205,364,1516,2795,6,17273,959,0,1
33,701,125,97,103,3,0,19,128,9,25,17,27,34,44,144,223,4,1087,60,0,0
164,7205,139,89,101,2,0,35,141,7,54,34,62,61,96,330,569,4,2287,127,0,0
164,7205,7,5,5,0,0,2,7,1,2,1,2,3,3,2,4,0,2,0,0,0
39,1946,1293,570,1093,25,15,163,1318,10,195,123,241,205,364,1516,2795,6,17273,959,0,0
82,2133,1455,414,1257,16,76,112,1471,5,41,23,46,46,69,231,381,2,1069,59,0,0
82,2133,669,365,481,22,61,110,691,15,103,63,122,118,185,747,1273,8,11311,628,0,0
69,3191,1455,414,1257,16,76,112,1471,5,41,23,46,46,69,231,381,2,1069,59,0,0
70,1621,996,429,845,24,10,117,1020,7,76,50,88,83,138,494,879,4,3565,198,0,1
70,1621,456,277,329,12,42,72,468,13,85,50,97,98,147,592,972,7,7212,400,0,1
34,2709,996,429,845,24,10,117,1020,7,76,50,88,83,138,494,879,4,3565,198,0,1
34,2709,996,429,845,24,10,117,1020,7,76,50,88,83,138,494,879,4,3565,198,0,0
69,3182,1455,414,1257,16,76,112,1471,5,41,23,46,46,69,231,381,2,1069,59,0,0
83,2145,1455,414,1257,16,76,112,1471,5,41,23,46,46,69,231,381,2,1069,59,0,0
83,2145,669,365,481,22,61,110,691,15,103,63,122,118,185,747,1273,8,11311,628,0,0
69,3184,1455,414,1257,16,76,112,1471,5,41,23,46,46,69,231,381,2,1069,59,0,0
24,380,102,57,55,5,16,25,107,5,17,10,18,22,28,81,124,2,330,18,0,0
63,1378,402,202,227,24,74,80,426,12,52,33,61,64,94,339,564,7,3969,220,0,0
33,707,125,97,103,3,0,19,128,9,25,17,27,34,44,144,223,4,1087,60,0,0
75,3157,1178,367,1042,6,15,115,1184,9,94,51,95,103,146,644,976,4,4439,246,0,0
208,4359,1943,715,1694,26,18,214,1969,12,185,120,237,197,357,1436,2721,7,20915,1161,0,0
208,4359,1168,838,957,57,25,144,1225,19,348,224,416,367,640,3018,5452,11,61921,3440,1,0
90,4387,1943,715,1694,26,18,214,1969,12,185,120,237,197,357,1436,2721,7,20915,1161,0,0
90,4395,1943,715,1694,26,18,214,1969,12,185,120,237,197,357,1436,2721,7,20915,1161,0,0
51,597,647,139,84,35,284,233,682,0,0,0,0,0,0,0,0,0,0,0,0,1
71,1415,1178,367,1042,6,15,115,1184,9,94,51,95,103,146,644,976,4,4439,246,0,1
71,1415,177,108,140,8,0,27,185,6,30,16,32,36,48,162,248,3,794,44,0,1
210,4421,1943,715,1694,26,18,214,1969,12,185,120,237,197,357,1436,2721,7,20915,1161,0,1
210,4421,1168,838,957,57,25,144,1225,19,348,224,416,367,640,3018,5452,11,61921,3440,1,1
75,3160,1178,367,1042,6,15,115,1184,9,94,51,95,103,146,644,976,4,4439,246,0,1
76,3201,1178,367,1042,6,15,115,1184,9,94,51,95,103,146,644,976,4,4439,246,0,0
72,1450,757,253,292,73,244,162,830,13,61,38,67,74,105,409,651,7,4654,258,0,1
15,468,42,7,35,4,0,5,46,1,2,1,2,3,3,2,4,0,2,0,0,1
15,468,11,6,10,0,0,1,11,2,4,2,4,6,6,10,15,1,15,0,0,1
210,4415,1943,715,1694,26,18,214,1969,12,185,120,237,197,357,1436,2721,7,20915,1161,0,0
210,4415,1168,838,957,57,25,144,1225,19,348,224,416,367,640,3018,5452,11,61921,3440,1,0
352,7039,1457,730,1242,11,6,188,1468,10,292,166,329,302,495,2424,4078,5,22973,1276,1,0
352,7039,74,35,59,1,0,14,75,3,14,7,14,17,21,58,85,1,128,7,0,0
352,7039,245,125,200,5,7,34,250,7,30,17,34,37,51,166,265,3,1053,58,0,0
84,4429,1457,730,1242,11,6,188,1468,10,292,166,329,302,495,2424,4078,5,22973,1276,1,0
352,7048,1457,730,1242,11,6,188,1468,10,292,166,329,302,495,2424,4078,5,22973,1276,1,0
352,7048,74,35,59,1,0,14,75,3,14,7,14,17,21,58,85,1,128,7,0,0
352,7048,245,125,200,5,7,34,250,7,30,17,34,37,51,166,265,3,1053,58,0,0
349,7017,1457,730,1242,11,6,188,1468,10,292,166,329,302,495,2424,4078,5,22973,1276,1,0
349,7017,74,35,59,1,0,14,75,3,14,7,14,17,21,58,85,1,128,7,0,0
349,7017,245,125,200,5,7,34,250,7,30,17,34,37,51,166,265,3,1053,58,0,0
71,1415,1178,367,1042,6,15,115,1184,9,94,51,95,103,146,644,976,4,4439,246,0,0
71,1415,177,108,140,8,0,27,185,6,30,16,32,36,48,162,248,3,794,44,0,0
77,3237,1178,367,1042,6,15,115,1184,9,94,51,95,103,146,644,976,4,4439,246,0,0
352,7076,1457,730,1242,11,6,188,1468,10,292,166,329,302,495,2424,4078,5,22973,1276,1,0
352,7076,74,35,59,1,0,14,75,3,14,7,14,17,21,58,85,1,128,7,0,0
352,7076,245,125,200,5,7,34,250,7,30,17,34,37,51,166,265,3,1053,58,0,0
211,4429,1943,715,1694,26,18,214,1969,12,185,120,237,197,357,1436,2721,7,20915,1161,0,0
211,4429,1168,838,957,57,25,144,1225,19,348,224,416,367,640,3018,5452,11,61921,3440,1,0
91,4606,1943,715,1694,26,18,214,1969,12,185,120,237,197,357,1436,2721,7,20915,1161,0,0
72,1450,757,253,292,73,244,162,830,13,61,38,67,74,105,409,651,7,4654,258,0,0
355,7107,1457,730,1242,11,6,188,1468,10,292,166,329,302,495,2424,4078,5,22973,1276,1,0
355,7107,74,35,59,1,0,14,75,3,14,7,14,17,21,58,85,1,128,7,0,0
355,7107,245,125,200,5,7,34,250,7,30,17,34,37,51,166,265,3,1053,58,0,0
12,459,75,38,59,1,3,12,76,2,4,2,4,6,6,10,15,1,15,0,0,0
355,7114,1457,730,1242,11,6,188,1468,10,292,166,329,302,495,2424,4078,5,22973,1276,1,0
355,7114,74,35,59,1,0,14,75,3,14,7,14,17,21,58,85,1,128,7,0,0
355,7114,245,125,200,5,7,34,250,7,30,17,34,37,51,166,265,3,1053,58,0,0
70,1621,996,429,845,24,10,117,1020,7,76,50,88,83,138,494,879,4,3565,198,0,0
70,1621,456,277,329,12,42,72,468,13,85,50,97,98,147,592,972,7,7212,400,0,0
79,2068,773,422,505,30,103,129,803,14,77,46,83,91,129,535,839,7,6334,351,0,0
85,2183,773,422,505,30,103,129,803,14,77,46,83,91,129,535,839,7,6334,351,0,0
15,470,42,7,35,4,0,5,46,1,2,1,2,3,3,2,4,0,2,0,0,0
15,470,11,6,10,0,0,1,11,2,4,2,4,6,6,10,15,1,15,0,0,0
353,7096,1457,730,1242,11,6,188,1468,10,292,166,329,302,495,2424,4078,5,22973,1276,1,0
353,7096,74,35,59,1,0,14,75,3,14,7,14,17,21,58,85,1,128,7,0,0
353,7096,245,125,200,5,7,34,250,7,30,17,34,37,51,166,265,3,1053,58,0,0
1,301,382,65,130,157,2,92,539,4,10,5,10,14,15,41,57,2,114,6,0,0
141,2980,1513,682,1277,25,13,200,1538,11,199,116,219,210,335,1557,2584,6,15641,868,0,1
141,2980,819,519,539,24,98,155,843,15,96,57,106,111,163,690,1107,8,9171,509,0,1
234,5348,4293,999,3693,19,54,507,4312,9,155,88,170,164,258,1156,1898,4,9368,520,0,1
234,5348,1482,859,1002,125,135,219,1607,16,219,134,251,235,385,1766,3032,9,27804,1544,1,1
108,2219,1020,354,843,12,15,144,1032,8,134,77,144,142,221,970,1580,4,6792,377,0,0
211,4427,1943,715,1694,26,18,214,1969,12,185,120,237,197,357,1436,2721,7,20915,1161,0,0
211,4427,1168,838,957,57,25,144,1225,19,348,224,416,367,640,3018,5452,11,61921,3440,1,0
79,1689,53,23,39,0,0,13,53,2,8,4,8,10,12,26,39,1,39,2,0,0
79,1689,515,298,307,33,80,99,548,12,63,44,77,75,121,419,753,7,5527,307,0,0
74,1565,402,202,227,24,74,80,426,12,52,33,61,64,94,339,564,7,3969,220,0,1
68,1508,53,23,39,0,0,13,53,2,8,4,8,10,12,26,39,1,39,2,0,1
68,1508,515,298,307,33,80,99,548,12,63,44,77,75,121,419,753,7,5527,307,0,1
122,2921,77,34,69,0,0,8,77,3,24,16,29,27,45,114,213,1,387,21,0,1
122,2921,712,438,573,51,9,84,763,14,102,71,128,116,199,733,1364,8,11988,666,0,1
69,1540,53,23,39,0,0,13,53,2,8,4,8,10,12,26,39,1,39,2,0,1
69,1540,515,298,307,33,80,99,548,12,63,44,77,75,121,419,753,7,5527,307,0,1
16,1213,215,129,180,6,0,29,221,8,65,43,72,73,115,415,711,4,3153,175,0,1
98,2008,773,419,590,28,0,166,801,10,204,113,217,214,330,1598,2554,5,13587,754,0,0
98,2008,421,273,302,44,34,57,465,17,81,59,107,98,166,583,1098,11,12329,684,0,0
213,4606,182,127,129,0,0,53,182,5,39,21,42,44,63,217,343,2,926,51,0,0
213,4606,1165,710,800,67,119,181,1232,18,243,153,282,261,435,2000,3492,10,36473,2026,1,0
74,1569,402,202,227,24,74,80,426,12,52,33,61,64,94,339,564,7,3969,220,0,0
86,1823,773,419,590,28,0,166,801,10,204,113,217,214,330,1598,2554,5,13587,754,0,0
86,1823,421,273,302,44,34,57,465,17,81,59,107,98,166,583,1098,11,12329,684,0,0
85,1818,773,419,590,28,0,166,801,10,204,113,217,214,330,1598,2554,5,13587,754,0,0
85,1818,421,273,302,44,34,57,465,17,81,59,107,98,166,583,1098,11,12329,684,0,0
84,1807,773,419,590,28,0,166,801,10,204,113,217,214,330,1598,2554,5,13587,754,0,0
84,1807,421,273,302,44,34,57,465,17,81,59,107,98,166,583,1098,11,12329,684,0,0
357,7141,1457,730,1242,11,6,188,1468,10,292,166,329,302,495,2424,4078,5,22973,1276,1,0
357,7141,74,35,59,1,0,14,75,3,14,7,14,17,21,58,85,1,128,7,0,0
357,7141,245,125,200,5,7,34,250,7,30,17,34,37,51,166,265,3,1053,58,0,0
15,742,75,38,59,1,3,12,76,2,4,2,4,6,6,10,15,1,15,0,0,0
71,1698,996,429,845,24,10,117,1020,7,76,50,88,83,138,494,879,4,3565,198,0,1
71,1698,456,277,329,12,42,72,468,13,85,50,97,98,147,592,972,7,7212,400,0,1
36,2884,996,429,845,24,10,117,1020,7,76,50,88,83,138,494,879,4,3565,198,0,1
122,2921,77,34,69,0,0,8,77,3,24,16,29,27,45,114,213,1,387,21,0,0
122,2921,712,438,573,51,9,84,763,14,102,71,128,116,199,733,1364,8,11988,666,0,0
69,1540,53,23,39,0,0,13,53,2,8,4,8,10,12,26,39,1,39,2,0,0
69,1540,515,298,307,33,80,99,548,12,63,44,77,75,121,419,753,7,5527,307,0,0
16,1213,215,129,180,6,0,29,221,8,65,43,72,73,115,415,711,4,3153,175,0,0
13,572,139,89,101,2,0,35,141,7,54,34,62,61,96,330,569,4,2287,127,0,0
80,2091,773,422,505,30,103,129,803,14,77,46,83,91,129,535,839,7,6334,351,0,0
213,4560,1943,715,1694,26,18,214,1969,12,185,120,237,197,357,1436,2721,7,20915,1161,0,0
213,4560,1168,838,957,57,25,144,1225,19,348,224,416,367,640,3018,5452,11,61921,3440,1,0
352,7059,1457,730,1242,11,6,188,1468,10,292,166,329,302,495,2424,4078,5,22973,1276,1,0
352,7059,74,35,59,1,0,14,75,3,14,7,14,17,21,58,85,1,128,7,0,0
352,7059,245,125,200,5,7,34,250,7,30,17,34,37,51,166,265,3,1053,58,0,0
144,3005,1513,682,1277,25,13,200,1538,11,199,116,219,210,335,1557,2584,6,15641,868,0,1
144,3005,819,519,539,24,98,155,843,15,96,57,106,111,163,690,1107,8,9171,509,0,1
129,5195,1513,682,1277,25,13,200,1538,11,199,116,219,210,335,1557,2584,6,15641,868,0,1
144,3005,1513,682,1277,25,13,200,1538,11,199,116,219,210,335,1557,2584,6,15641,868,0,0
144,3005,819,519,539,24,98,155,843,15,96,57,106,111,163,690,1107,8,9171,509,0,0
129,5195,1513,682,1277,25,13,200,1538,11,199,116,219,210,335,1557,2584,6,15641,868,0,0
76,1523,757,253,292,73,244,162,830,13,61,38,67,74,105,409,651,7,4654,258,0,1
53,3494,520,294,400,33,13,81,553,10,261,204,367,271,571,2128,4614,7,32445,1802,1,1
80,1573,757,253,292,73,244,162,830,13,61,38,67,74,105,409,651,7,4654,258,0,1
54,3601,520,294,400,33,13,81,553,10,261,204,367,271,571,2128,4614,7,32445,1802,1,1
80,1590,757,253,292,73,244,162,830,13,61,38,67,74,105,409,651,7,4654,258,0,0
144,3008,1513,682,1277,25,13,200,1538,11,199,116,219,210,335,1557,2584,6,15641,868,0,0
144,3008,819,519,539,24,98,155,843,15,96,57,106,111,163,690,1107,8,9171,509,0,0
80,1599,757,253,292,73,244,162,830,13,61,38,67,74,105,409,651,7,4654,258,0,0
129,5207,1513,682,1277,25,13,200,1538,11,199,116,219,210,335,1557,2584,6,15641,868,0,0
145,3016,1513,682,1277,25,13,200,1538,11,199,116,219,210,335,1557,2584,6,15641,868,0,0
145,3016,819,519,539,24,98,155,843,15,96,57,106,111,163,690,1107,8,9171,509,0,0
145,3018,1513,682,1277,25,13,200,1538,11,199,116,219,210,335,1557,2584,6,15641,868,0,0
145,3018,819,519,539,24,98,155,843,15,96,57,106,111,163,690,1107,8,9171,509,0,0
77,1551,757,253,292,73,244,162,830,13,61,38,67,74,105,409,651,7,4654,258,0,1
86,2206,773,422,505,30,103,129,803,14,77,46,83,91,129,535,839,7,6334,351,0,0
24,600,2,2,2,0,0,0,2,0,0,0,0,0,0,0,0,0,0,0,0,0
24,600,99,48,90,1,3,5,100,0,0,0,0,0,0,0,0,0,0,0,0,0
24,600,8,5,5,2,0,1,10,0,0,0,0,0,0,0,0,0,0,0,0,0
24,600,1217,716,841,84,126,174,1301,14,185,118,215,199,333,1446,2542,8,20687,1149,0,0
24,600,160,89,115,0,13,31,160,7,15,11,17,22,28,78,124,3,495,27,0,0
24,600,10,10,9,9,0,0,19,0,0,0,0,0,0,0,0,0,0,0,0,0
24,600,173,84,99,8,29,36,181,5,12,7,13,17,20,54,81,2,221,12,0,0
24,600,3,1,1,3,0,0,6,0,0,0,0,0,0,0,0,0,0,0,0,0
77,1551,757,253,292,73,244,162,830,13,61,38,67,74,105,409,651,7,4654,258,0,0
54,3601,520,294,400,33,13,81,553,10,261,204,367,271,571,2128,4614,7,32445,1802,1,0
71,1698,996,429,845,24,10,117,1020,7,76,50,88,83,138,494,879,4,3565,198,0,0
71,1698,456,277,329,12,42,72,468,13,85,50,97,98,147,592,972,7,7212,400,0,0
36,2884,996,429,845,24,10,117,1020,7,76,50,88,83,138,494,879,4,3565,198,0,0
164,7206,139,89,101,2,0,35,141,7,54,34,62,61,96,330,569,4,2287,127,0,1
164,7206,7,5,5,0,0,2,7,1,2,1,2,3,3,2,4,0,2,0,0,1
236,5368,4293,999,3693,19,54,507,4312,9,155,88,170,164,258,1156,1898,4,9368,520,0,1
236,5368,1482,859,1002,125,135,219,1607,16,219,134,251,235,385,1766,3032,9,27804,1544,1,1
91,3852,1289,550,1043,56,32,155,1345,10,167,93,185,177,278,1266,2075,5,11498,638,0,1
170,7554,139,89,101,2,0,35,141,7,54,34,62,61,96,330,569,4,2287,127,0,1
170,7554,7,5,5,0,0,2,7,1,2,1,2,3,3,2,4,0,2,0,0,1
354,7093,1457,730,1242,11,6,188,1468,10,292,166,329,302,495,2424,4078,5,22973,1276,1,0
354,7093,74,35,59,1,0,14,75,3,14,7,14,17,21,58,85,1,128,7,0,0
354,7093,245,125,200,5,7,34,250,7,30,17,34,37,51,166,265,3,1053,58,0,0
236,5368,4293,999,3693,19,54,507,4312,9,155,88,170,164,258,1156,1898,4,9368,520,0,0
236,5368,1482,859,1002,125,135,219,1607,16,219,134,251,235,385,1766,3032,9,27804,1544,1,0
91,3852,1289,550,1043,56,32,155,1345,10,167,93,185,177,278,1266,2075,5,11498,638,0,0
170,7554,139,89,101,2,0,35,141,7,54,34,62,61,96,330,569,4,2287,127,0,0
170,7554,7,5,5,0,0,2,7,1,2,1,2,3,3,2,4,0,2,0,0,0
209,4527,1943,715,1694,26,18,214,1969,12,185,120,237,197,357,1436,2721,7,20915,1161,0,0
209,4527,1168,838,957,57,25,144,1225,19,348,224,416,367,640,3018,5452,11,61921,3440,1,0
23,737,339,213,244,17,9,65,356,10,42,26,48,52,74,259,421,5,2410,133,0,0
46,1902,1293,570,1093,25,15,163,1318,10,195,123,241,205,364,1516,2795,6,17273,959,0,0
48,2177,1293,570,1093,25,15,163,1318,10,195,123,241,205,364,1516,2795,6,17273,959,0,1
25,773,339,213,244,17,9,65,356,10,42,26,48,52,74,259,421,5,2410,133,0,0
26,776,339,213,244,17,9,65,356,10,42,26,48,52,74,259,421,5,2410,133,0,0
55,2398,1293,570,1093,25,15,163,1318,10,195,123,241,205,364,1516,2795,6,17273,959,0,0
54,2391,1293,570,1093,25,15,163,1318,10,195,123,241,205,364,1516,2795,6,17273,959,0,1
54,2391,1293,570,1093,25,15,163,1318,10,195,123,241,205,364,1516,2795,6,17273,959,0,0
85,2188,773,422,505,30,103,129,803,14,77,46,83,91,129,535,839,7,6334,351,0,0
31,1981,1157,318,931,29,22,177,1186,6,104,63,125,110,188,712,1274,3,4596,255,0,0
54,2368,1293,570,1093,25,15,163,1318,10,195,123,241,205,364,1516,2795,6,17273,959,0,0
86,2211,773,422,505,30,103,129,803,14,77,46,83,91,129,535,839,7,6334,351,0,0
55,2425,1293,570,1093,25,15,163,1318,10,195,123,241,205,364,1516,2795,6,17273,959,0,0
78,1583,757,253,292,73,244,162,830,13,61,38,67,74,105,409,651,7,4654,258,0,0
22,606,256,139,192,9,7,47,265,4,23,12,24,27,36,112,171,2,357,19,0,0
78,1574,757,253,292,73,244,162,830,13,61,38,67,74,105,409,651,7,4654,258,0,0
55,2461,1293,570,1093,25,15,163,1318,10,195,123,241,205,364,1516,2795,6,17273,959,0,0
56,2400,1293,570,1093,25,15,163,1318,10,195,123,241,205,364,1516,2795,6,17273,959,0,0
80,1688,402,202,227,24,74,80,426,12,52,33,61,64,94,339,564,7,3969,220,0,1
68,1556,53,23,39,0,0,13,53,2,8,4,8,10,12,26,39,1,39,2,0,1
68,1556,515,298,307,33,80,99,548,12,63,44,77,75,121,419,753,7,5527,307,0,1
260,6185,72,33,56,0,4,12,72,1,1,1,1,2,2,0,2,0,1,0,0,1
260,6185,1454,835,1044,76,110,219,1530,17,275,158,296,292,454,2297,3718,9,34017,1889,1,1
235,5354,4293,999,3693,19,54,507,4312,9,155,88,170,164,258,1156,1898,4,9368,520,0,0
235,5354,1482,859,1002,125,135,219,1607,16,219,134,251,235,385,1766,3032,9,27804,1544,1,0
30,655,125,97,103,3,0,19,128,9,25,17,27,34,44,144,223,4,1087,60,0,0
82,3555,1020,354,843,12,15,144,1032,8,134,77,144,142,221,970,1580,4,6792,377,0,0
82,3557,1020,354,843,12,15,144,1032,8,134,77,144,142,221,970,1580,4,6792,377,0,0
30,657,125,97,103,3,0,19,128,9,25,17,27,34,44,144,223,4,1087,60,0,0
237,5377,4293,999,3693,19,54,507,4312,9,155,88,170,164,258,1156,1898,4,9368,520,0,1
237,5377,1482,859,1002,125,135,219,1607,16,219,134,251,235,385,1766,3032,9,27804,1544,1,1
80,1706,402,202,227,24,74,80,426,12,52,33,61,64,94,339,564,7,3969,220,0,1
261,6242,72,33,56,0,4,12,72,1,1,1,1,2,2,0,2,0,1,0,0,1
261,6242,1454,835,1044,76,110,219,1530,17,275,158,296,292,454,2297,3718,9,34017,1889,1,1
70,1373,1178,367,1042,6,15,115,1184,9,94,51,95,103,146,644,976,4,4439,246,0,1
70,1373,177,108,140,8,0,27,185,6,30,16,32,36,48,162,248,3,794,44,0,1
170,7555,139,89,101,2,0,35,141,7,54,34,62,61,96,330,569,4,2287,127,0,1
170,7555,7,5,5,0,0,2,7,1,2,1,2,3,3,2,4,0,2,0,0,1
138,5857,1782,648,1425,9,47,279,1791,8,171,97,189,179,286,1292,2140,4,9462,525,0,1
82,3581,1020,354,843,12,15,144,1032,8,134,77,144,142,221,970,1580,4,6792,377,0,1
262,6251,72,33,56,0,4,12,72,1,1,1,1,2,2,0,2,0,1,0,0,0
262,6251,1454,835,1044,76,110,219,1530,17,275,158,296,292,454,2297,3718,9,34017,1889,1,0
138,5861,1782,648,1425,9,47,279,1791,8,171,97,189,179,286,1292,2140,4,9462,525,0,0
262,6251,72,33,56,0,4,12,72,1,1,1,1,2,2,0,2,0,1,0,0,1
262,6251,1454,835,1044,76,110,219,1530,17,275,158,296,292,454,2297,3718,9,34017,1889,1,1
78,1663,402,202,227,24,74,80,426,12,52,33,61,64,94,339,564,7,3969,220,0,0
70,1570,53,23,39,0,0,13,53,2,8,4,8,10,12,26,39,1,39,2,0,0
70,1570,515,298,307,33,80,99,548,12,63,44,77,75,121,419,753,7,5527,307,0,0
78,1664,402,202,227,24,74,80,426,12,52,33,61,64,94,339,564,7,3969,220,0,1
70,1570,53,23,39,0,0,13,53,2,8,4,8,10,12,26,39,1,39,2,0,1
70,1570,515,298,307,33,80,99,548,12,63,44,77,75,121,419,753,7,5527,307,0,1
78,1701,402,202,227,24,74,80,426,12,52,33,61,64,94,339,564,7,3969,220,0,1
71,1575,53,23,39,0,0,13,53,2,8,4,8,10,12,26,39,1,39,2,0,1
71,1575,515,298,307,33,80,99,548,12,63,44,77,75,121,419,753,7,5527,307,0,1
22,452,601,196,481,2,23,85,603,8,63,36,72,71,108,400,664,4,3036,168,0,1
22,452,156,79,106,5,16,28,161,5,14,8,15,19,23,64,97,2,261,14,0,1
82,3585,1020,354,843,12,15,144,1032,8,134,77,144,142,221,970,1580,4,6792,377,0,1
71,1575,53,23,39,0,0,13,53,2,8,4,8,10,12,26,39,1,39,2,0,0
71,1575,515,298,307,33,80,99,548,12,63,44,77,75,121,419,753,7,5527,307,0,0
236,5371,4293,999,3693,19,54,507,4312,9,155,88,170,164,258,1156,1898,4,9368,520,0,1
236,5371,1482,859,1002,125,135,219,1607,16,219,134,251,235,385,1766,3032,9,27804,1544,1,1
79,1714,402,202,227,24,74,80,426,12,52,33,61,64,94,339,564,7,3969,220,0,0
73,1606,53,23,39,0,0,13,53,2,8,4,8,10,12,26,39,1,39,2,0,0
73,1606,515,298,307,33,80,99,548,12,63,44,77,75,121,419,753,7,5527,307,0,0
77,1666,53,23,39,0,0,13,53,2,8,4,8,10,12,26,39,1,39,2,0,0
77,1666,515,298,307,33,80,99,548,12,63,44,77,75,121,419,753,7,5527,307,0,0
237,5376,4293,999,3693,19,54,507,4312,9,155,88,170,164,258,1156,1898,4,9368,520,0,1
237,5376,1482,859,1002,125,135,219,1607,16,219,134,251,235,385,1766,3032,9,27804,1544,1,1
32,665,125,97,103,3,0,19,128,9,25,17,27,34,44,144,223,4,1087,60,0,1
75,1595,53,23,39,0,0,13,53,2,8,4,8,10,12,26,39,1,39,2,0,1
75,1595,515,298,307,33,80,99,548,12,63,44,77,75,121,419,753,7,5527,307,0,1
263,6257,72,33,56,0,4,12,72,1,1,1,1,2,2,0,2,0,1,0,0,1
263,6257,1454,835,1044,76,110,219,1530,17,275,158,296,292,454,2297,3718,9,34017,1889,1,1
71,1380,1178,367,1042,6,15,115,1184,9,94,51,95,103,146,644,976,4,4439,246,0,1
71,1380,177,108,140,8,0,27,185,6,30,16,32,36,48,162,248,3,794,44,0,1
23,458,601,196,481,2,23,85,603,8,63,36,72,71,108,400,664,4,3036,168,0,1
23,458,156,79,106,5,16,28,161,5,14,8,15,19,23,64,97,2,261,14,0,1
84,3593,1020,354,843,12,15,144,1032,8,134,77,144,142,221,970,1580,4,6792,377,0,1
86,1809,477,336,357,30,23,73,507,16,194,134,250,210,384,1538,2962,10,30538,1696,0,1
74,1594,402,202,227,24,74,80,426,12,52,33,61,64,94,339,564,7,3969,220,0,1
86,1790,477,336,357,30,23,73,507,16,194,134,250,210,384,1538,2962,10,30538,1696,0,0
54,1125,207,111,150,11,0,50,218,5,26,19,36,31,55,133,272,3,943,52,0,0
54,1125,410,198,237,31,55,97,441,11,63,38,72,74,110,414,683,6,4293,238,0,0
74,1567,402,202,227,24,74,80,426,12,52,33,61,64,94,339,564,7,3969,220,0,0
263,6260,72,33,56,0,4,12,72,1,1,1,1,2,2,0,2,0,1,0,0,0
263,6260,1454,835,1044,76,110,219,1530,17,275,158,296,292,454,2297,3718,9,34017,1889,1,0
98,2655,1523,757,1297,19,12,193,1542,12,193,117,230,205,347,1508,2664,7,19053,1058,0,0
98,2655,701,378,504,33,58,109,734,13,110,68,126,123,194,794,1346,7,10027,557,0,0
55,2371,1293,570,1093,25,15,163,1318,10,195,123,241,205,364,1516,2795,6,17273,959,0,0
94,4602,1523,757,1297,19,12,193,1542,12,193,117,230,205,347,1508,2664,7,19053,1058,0,0
55,2369,1293,570,1093,25,15,163,1318,10,195,123,241,205,364,1516,2795,6,17273,959,0,0
15,470,42,7,35,4,0,5,46,1,2,1,2,3,3,2,4,0,2,0,0,1
15,470,11,6,10,0,0,1,11,2,4,2,4,6,6,10,15,1,15,0,0,1
113,2553,1043,504,840,53,9,147,1096,9,180,112,198,189,310,1377,2344,4,11604,644,0,1
113,2553,383,288,292,26,6,62,409,11,65,38,67,76,105,429,656,5,3719,206,0,1
79,3054,1043,504,840,53,9,147,1096,9,180,112,198,189,310,1377,2344,4,11604,644,0,1
94,4591,1523,757,1297,19,12,193,1542,12,193,117,230,205,347,1508,2664,7,19053,1058,0,0
79,1724,402,202,227,24,74,80,426,12,52,33,61,64,94,339,564,7,3969,220,0,0
79,1583,757,253,292,73,244,162,830,13,61,38,67,74,105,409,651,7,4654,258,0,1
25,685,256,139,192,9,7,47,265,4,23,12,24,27,36,112,171,2,357,19,0,1
80,1589,757,253,292,73,244,162,830,13,61,38,67,74,105,409,651,7,4654,258,0,0
78,1591,757,253,292,73,244,162,830,13,61,38,67,74,105,409,651,7,4654,258,0,0
25,685,256,139,192,9,7,47,265,4,23,12,24,27,36,112,171,2,357,19,0,0
237,5376,4293,999,3693,19,54,507,4312,9,155,88,170,164,258,1156,1898,4,9368,520,0,0
237,5376,1482,859,1002,125,135,219,1607,16,219,134,251,235,385,1766,3032,9,27804,1544,1,0
32,665,125,97,103,3,0,19,128,9,25,17,27,34,44,144,223,4,1087,60,0,0
75,1595,53,23,39,0,0,13,53,2,8,4,8,10,12,26,39,1,39,2,0,0
75,1595,515,298,307,33,80,99,548,12,63,44,77,75,121,419,753,7,5527,307,0,0
71,1380,1178,367,1042,6,15,115,1184,9,94,51,95,103,146,644,976,4,4439,246,0,0
71,1380,177,108,140,8,0,27,185,6,30,16,32,36,48,162,248,3,794,44,0,0
23,458,601,196,481,2,23,85,603,8,63,36,72,71,108,400,664,4,3036,168,0,0
23,458,156,79,106,5,16,28,161,5,14,8,15,19,23,64,97,2,261,14,0,0
170,7555,139,89,101,2,0,35,141,7,54,34,62,61,96,330,569,4,2287,127,0,0
170,7555,7,5,5,0,0,2,7,1,2,1,2,3,3,2,4,0,2,0,0,0
84,3593,1020,354,843,12,15,144,1032,8,134,77,144,142,221,970,1580,4,6792,377,0,0
28,807,339,213,244,17,9,65,356,10,42,26,48,52,74,259,421,5,2410,133,0,0
58,2553,1293,570,1093,25,15,163,1318,10,195,123,241,205,364,1516,2795,6,17273,959,0,0
92,3882,1289,550,1043,56,32,155,1345,10,167,93,185,177,278,1266,2075,5,11498,638,0,0
48,991,447,308,343,6,5,95,453,7,96,59,111,103,170,651,1136,4,4600,255,0,0
48,991,322,174,179,16,74,51,338,10,41,26,46,51,72,252,408,5,2291,127,0,0
38,1651,447,308,343,6,5,95,453,7,96,59,111,103,170,651,1136,4,4600,255,0,0
79,1722,402,202,227,24,74,80,426,12,52,33,61,64,94,339,564,7,3969,220,0,0
238,5409,4293,999,3693,19,54,507,4312,9,155,88,170,164,258,1156,1898,4,9368,520,0,1
238,5409,1482,859,1002,125,135,219,1607,16,219,134,251,235,385,1766,3032,9,27804,1544,1,1
131,3042,77,34,69,0,0,8,77,3,24,16,29,27,45,114,213,1,387,21,0,1
131,3042,712,438,573,51,9,84,763,14,102,71,128,116,199,733,1364,8,11988,666,0,1
279,6562,72,33,56,0,4,12,72,1,1,1,1,2,2,0,2,0,1,0,0,1
279,6562,1454,835,1044,76,110,219,1530,17,275,158,296,292,454,2297,3718,9,34017,1889,1,1
171,7658,139,89,101,2,0,35,141,7,54,34,62,61,96,330,569,4,2287,127,0,1
171,7658,7,5,5,0,0,2,7,1,2,1,2,3,3,2,4,0,2,0,0,1
30,1233,373,158,315,8,0,51,381,5,76,44,79,81,123,486,779,2,2026,112,0,1
279,6562,72,33,56,0,4,12,72,1,1,1,1,2,2,0,2,0,1,0,0,0
279,6562,1454,835,1044,76,110,219,1530,17,275,158,296,292,454,2297,3718,9,34017,1889,1,0
15,483,42,7,35,4,0,5,46,1,2,1,2,3,3,2,4,0,2,0,0,0
15,483,11,6,10,0,0,1,11,2,4,2,4,6,6,10,15,1,15,0,0,0
113,2553,1043,504,840,53,9,147,1096,9,180,112,198,189,310,1377,2344,4,11604,644,0,0
113,2553,383,288,292,26,6,62,409,11,65,38,67,76,105,429,656,5,3719,206,0,0
79,3054,1043,504,840,53,9,147,1096,9,180,112,198,189,310,1377,2344,4,11604,644,0,0
164,5028,1660,832,1314,41,38,274,1701,20,312,209,395,332,604,2671,5058,12,64042,3557,1,1
164,5028,1057,646,719,113,100,145,1170,18,215,134,248,233,382,1740,3004,10,31186,1732,1,1
15,472,42,7,35,4,0,5,46,1,2,1,2,3,3,2,4,0,2,0,0,1
15,472,11,6,10,0,0,1,11,2,4,2,4,6,6,10,15,1,15,0,0,1
155,4419,1660,832,1314,41,38,274,1701,20,312,209,395,332,604,2671,5058,12,64042,3557,1,1
164,5028,1660,832,1314,41,38,274,1701,20,312,209,395,332,604,2671,5058,12,64042,3557,1,0
164,5028,1057,646,719,113,100,145,1170,18,215,134,248,233,382,1740,3004,10,31186,1732,1,0
15,472,42,7,35,4,0,5,46,1,2,1,2,3,3,2,4,0,2,0,0,0
15,472,11,6,10,0,0,1,11,2,4,2,4,6,6,10,15,1,15,0,0,0
155,4419,1660,832,1314,41,38,274,1701,20,312,209,395,332,604,2671,5058,12,64042,3557,1,0
48,992,447,308,343,6,5,95,453,7,96,59,111,103,170,651,1136,4,4600,255,0,0
48,992,322,174,179,16,74,51,338,10,41,26,46,51,72,252,408,5,2291,127,0,0
38,1676,447,308,343,6,5,95,453,7,96,59,111,103,170,651,1136,4,4600,255,0,0
27,951,74,35,59,1,0,14,75,3,14,7,14,17,21,58,85,1,128,7,0,1
27,951,245,125,200,5,7,34,250,7,30,17,34,37,51,166,265,3,1053,58,0,1
259,6121,72,33,56,0,4,12,72,1,1,1,1,2,2,0,2,0,1,0,0,1
259,6121,1454,835,1044,76,110,219,1530,17,275,158,296,292,454,2297,3718,9,34017,1889,1,1
58,1174,207,111,150,11,0,50,218,5,26,19,36,31,55,133,272,3,943,52,0,0
58,1174,410,198,237,31,55,97,441,11,63,38,72,74,110,414,683,6,4293,238,0,0
259,6152,72,33,56,0,4,12,72,1,1,1,1,2,2,0,2,0,1,0,0,0
259,6152,1454,835,1044,76,110,219,1530,17,275,158,296,292,454,2297,3718,9,34017,1889,1,0
139,5869,1782,648,1425,9,47,279,1791,8,171,97,189,179,286,1292,2140,4,9462,525,0,0
27,951,74,35,59,1,0,14,75,3,14,7,14,17,21,58,85,1,128,7,0,0
27,951,245,125,200,5,7,34,250,7,30,17,34,37,51,166,265,3,1053,58,0,0
259,6121,72,33,56,0,4,12,72,1,1,1,1,2,2,0,2,0,1,0,0,0
259,6121,1454,835,1044,76,110,219,1530,17,275,158,296,292,454,2297,3718,9,34017,1889,1,0
132,3068,77,34,69,0,0,8,77,3,24,16,29,27,45,114,213,1,387,21,0,0
132,3068,712,438,573,51,9,84,763,14,102,71,128,116,199,733,1364,8,11988,666,0,0
73,3806,1296,573,1062,40,33,157,1336,8,201,118,231,209,349,1561,2689,4,12365,686,0,0
243,5487,4293,999,3693,19,54,507,4312,9,155,88,170,164,258,1156,1898,4,9368,520,0,1
243,5487,1482,859,1002,125,135,219,1607,16,219,134,251,235,385,1766,3032,9,27804,1544,1,1
75,1601,53,23,39,0,0,13,53,2,8,4,8,10,12,26,39,1,39,2,0,1
75,1601,515,298,307,33,80,99,548,12,63,44,77,75,121,419,753,7,5527,307,0,1
288,6751,72,33,56,0,4,12,72,1,1,1,1,2,2,0,2,0,1,0,0,1
288,6751,1454,835,1044,76,110,219,1530,17,275,158,296,292,454,2297,3718,9,34017,1889,1,1
244,5496,4293,999,3693,19,54,507,4312,9,155,88,170,164,258,1156,1898,4,9368,520,0,0
244,5496,1482,859,1002,125,135,219,1607,16,219,134,251,235,385,1766,3032,9,27804,1544,1,0
244,5495,4293,999,3693,19,54,507,4312,9,155,88,170,164,258,1156,1898,4,9368,520,0,0
244,5495,1482,859,1002,125,135,219,1607,16,219,134,251,235,385,1766,3032,9,27804,1544,1,0
140,3230,77,34,69,0,0,8,77,3,24,16,29,27,45,114,213,1,387,21,0,1
140,3230,712,438,573,51,9,84,763,14,102,71,128,116,199,733,1364,8,11988,666,0,1
76,1603,53,23,39,0,0,13,53,2,8,4,8,10,12,26,39,1,39,2,0,0
76,1603,515,298,307,33,80,99,548,12,63,44,77,75,121,419,753,7,5527,307,0,0
259,6153,72,33,56,0,4,12,72,1,1,1,1,2,2,0,2,0,1,0,0,0
259,6153,1454,835,1044,76,110,219,1530,17,275,158,296,292,454,2297,3718,9,34017,1889,1,0
150,6861,139,89,101,2,0,35,141,7,54,34,62,61,96,330,569,4,2287,127,0,1
150,6861,7,5,5,0,0,2,7,1,2,1,2,3,3,2,4,0,2,0,0,1
238,5391,4293,999,3693,19,54,507,4312,9,155,88,170,164,258,1156,1898,4,9368,520,0,0
238,5391,1482,859,1002,125,135,219,1607,16,219,134,251,235,385,1766,3032,9,27804,1544,1,0
172,7584,139,89,101,2,0,35,141,7,54,34,62,61,96,330,569,4,2287,127,0,0
172,7584,7,5,5,0,0,2,7,1,2,1,2,3,3,2,4,0,2,0,0,0
172,7751,139,89,101,2,0,35,141,7,54,34,62,61,96,330,569,4,2287,127,0,1
172,7751,7,5,5,0,0,2,7,1,2,1,2,3,3,2,4,0,2,0,0,1
245,5510,4293,999,3693,19,54,507,4312,9,155,88,170,164,258,1156,1898,4,9368,520,0,0
245,5510,1482,859,1002,125,135,219,1607,16,219,134,251,235,385,1766,3032,9,27804,1544,1,0
174,7780,139,89,101,2,0,35,141,7,54,34,62,61,96,330,569,4,2287,127,0,0
174,7780,7,5,5,0,0,2,7,1,2,1,2,3,3,2,4,0,2,0,0,0
263,6293,72,33,56,0,4,12,72,1,1,1,1,2,2,0,2,0,1,0,0,0
263,6293,1454,835,1044,76,110,219,1530,17,275,158,296,292,454,2297,3718,9,34017,1889,1,0
139,5894,1782,648,1425,9,47,279,1791,8,171,97,189,179,286,1292,2140,4,9462,525,0,0
245,5514,4293,999,3693,19,54,507,4312,9,155,88,170,164,258,1156,1898,4,9368,520,0,0
245,5514,1482,859,1002,125,135,219,1607,16,219,134,251,235,385,1766,3032,9,27804,1544,1,0
140,3230,77,34,69,0,0,8,77,3,24,16,29,27,45,114,213,1,387,21,0,0
140,3230,712,438,573,51,9,84,763,14,102,71,128,116,199,733,1364,8,11988,666,0,0
288,6784,72,33,56,0,4,12,72,1,1,1,1,2,2,0,2,0,1,0,0,0
288,6784,1454,835,1044,76,110,219,1530,17,275,158,296,292,454,2297,3718,9,34017,1889,1,0
288,6780,72,33,56,0,4,12,72,1,1,1,1,2,2,0,2,0,1,0,0,0
288,6780,1454,835,1044,76,110,219,1530,17,275,158,296,292,454,2297,3718,9,34017,1889,1,0
245,5516,4293,999,3693,19,54,507,4312,9,155,88,170,164,258,1156,1898,4,9368,520,0,0
245,5516,1482,859,1002,125,135,219,1607,16,219,134,251,235,385,1766,3032,9,27804,1544,1,0
76,1597,53,23,39,0,0,13,53,2,8,4,8,10,12,26,39,1,39,2,0,0
76,1597,515,298,307,33,80,99,548,12,63,44,77,75,121,419,753,7,5527,307,0,0
28,807,339,213,244,17,9,65,356,10,42,26,48,52,74,259,421,5,2410,133,0,1
114,2580,1043,504,840,53,9,147,1096,9,180,112,198,189,310,1377,2344,4,11604,644,0,1
114,2580,383,288,292,26,6,62,409,11,65,38,67,76,105,429,656,5,3719,206,0,1
59,2584,1293,570,1093,25,15,163,1318,10,195,123,241,205,364,1516,2795,6,17273,959,0,1
59,2582,1293,570,1093,25,15,163,1318,10,195,123,241,205,364,1516,2795,6,17273,959,0,0
22,351,102,57,55,5,16,25,107,5,17,10,18,22,28,81,124,2,330,18,0,0
114,2580,1043,504,840,53,9,147,1096,9,180,112,198,189,310,1377,2344,4,11604,644,0,0
114,2580,383,288,292,26,6,62,409,11,65,38,67,76,105,429,656,5,3719,206,0,0
85,3690,1020,354,843,12,15,144,1032,8,134,77,144,142,221,970,1580,4,6792,377,0,0
89,1841,477,336,357,30,23,73,507,16,194,134,250,210,384,1538,2962,10,30538,1696,0,1
111,4196,1450,624,1228,12,26,181,1462,14,306,186,354,320,540,2580,4493,8,36391,2021,1,1
89,1841,477,336,357,30,23,73,507,16,194,134,250,210,384,1538,2962,10,30538,1696,0,0
111,4196,1450,624,1228,12,26,181,1462,14,306,186,354,320,540,2580,4493,8,36391,2021,1,0
237,5388,4293,999,3693,19,54,507,4312,9,155,88,170,164,258,1156,1898,4,9368,520,0,0
237,5388,1482,859,1002,125,135,219,1607,16,219,134,251,235,385,1766,3032,9,27804,1544,1,0
30,659,125,97,103,3,0,19,128,9,25,17,27,34,44,144,223,4,1087,60,0,0
76,1643,53,23,39,0,0,13,53,2,8,4,8,10,12,26,39,1,39,2,0,0
76,1643,515,298,307,33,80,99,548,12,63,44,77,75,121,419,753,7,5527,307,0,0
262,6289,72,33,56,0,4,12,72,1,1,1,1,2,2,0,2,0,1,0,0,0
262,6289,1454,835,1044,76,110,219,1530,17,275,158,296,292,454,2297,3718,9,34017,1889,1,0
70,1375,1178,367,1042,6,15,115,1184,9,94,51,95,103,146,644,976,4,4439,246,0,0
70,1375,177,108,140,8,0,27,185,6,30,16,32,36,48,162,248,3,794,44,0,0
22,454,601,196,481,2,23,85,603,8,63,36,72,71,108,400,664,4,3036,168,0,0
22,454,156,79,106,5,16,28,161,5,14,8,15,19,23,64,97,2,261,14,0,0
87,3808,1020,354,843,12,15,144,1032,8,134,77,144,142,221,970,1580,4,6792,377,0,0
1,319,382,65,130,157,2,92,539,4,10,5,10,14,15,41,57,2,114,6,0,0
139,5880,1782,648,1425,9,47,279,1791,8,171,97,189,179,286,1292,2140,4,9462,525,0,0
356,7105,1457,730,1242,11,6,188,1468,10,292,166,329,302,495,2424,4078,5,22973,1276,1,0
356,7105,74,35,59,1,0,14,75,3,14,7,14,17,21,58,85,1,128,7,0,0
356,7105,245,125,200,5,7,34,250,7,30,17,34,37,51,166,265,3,1053,58,0,0
139,5905,1782,648,1425,9,47,279,1791,8,171,97,189,179,286,1292,2140,4,9462,525,0,0
58,1178,207,111,150,11,0,50,218,5,26,19,36,31,55,133,272,3,943,52,0,0
58,1178,410,198,237,31,55,97,441,11,63,38,72,74,110,414,683,6,4293,238,0,0
78,1593,757,253,292,73,244,162,830,13,61,38,67,74,105,409,651,7,4654,258,0,0
213,4606,182,127,129,0,0,53,182,5,39,21,42,44,63,217,343,2,926,51,0,1
213,4606,1165,710,800,67,119,181,1232,18,243,153,282,261,435,2000,3492,10,36473,2026,1,1
89,1831,477,336,357,30,23,73,507,16,194,134,250,210,384,1538,2962,10,30538,1696,0,1
145,3014,1513,682,1277,25,13,200,1538,11,199,116,219,210,335,1557,2584,6,15641,868,0,1
145,3014,819,519,539,24,98,155,843,15,96,57,106,111,163,690,1107,8,9171,509,0,1
356,7105,1457,730,1242,11,6,188,1468,10,292,166,329,302,495,2424,4078,5,22973,1276,1,1
356,7105,74,35,59,1,0,14,75,3,14,7,14,17,21,58,85,1,128,7,0,1
356,7105,245,125,200,5,7,34,250,7,30,17,34,37,51,166,265,3,1053,58,0,1
237,5388,4293,999,3693,19,54,507,4312,9,155,88,170,164,258,1156,1898,4,9368,520,0,1
237,5388,1482,859,1002,125,135,219,1607,16,219,134,251,235,385,1766,3032,9,27804,1544,1,1
86,2211,773,422,505,30,103,129,803,14,77,46,83,91,129,535,839,7,6334,351,0,1
22,350,102,57,55,5,16,25,107,5,17,10,18,22,28,81,124,2,330,18,0,1
79,1722,402,202,227,24,74,80,426,12,52,33,61,64,94,339,564,7,3969,220,0,1
20,509,205,80,86,16,53,53,221,7,18,10,19,25,29,94,134,3,497,27,0,1
223,5301,722,423,573,19,0,135,741,12,172,101,199,184,300,1320,2257,6,15668,870,0,1
223,5301,1508,847,911,44,250,301,1552,14,148,88,169,162,257,1120,1886,7,15077,837,0,1
262,6289,72,33,56,0,4,12,72,1,1,1,1,2,2,0,2,0,1,0,0,1
262,6289,1454,835,1044,76,110,219,1530,17,275,158,296,292,454,2297,3718,9,34017,1889,1,1
78,1590,757,253,292,73,244,162,830,13,61,38,67,74,105,409,651,7,4654,258,0,1
114,2575,1043,504,840,53,9,147,1096,9,180,112,198,189,310,1377,2344,4,11604,644,0,1
114,2575,383,288,292,26,6,62,409,11,65,38,67,76,105,429,656,5,3719,206,0,1
70,1375,1178,367,1042,6,15,115,1184,9,94,51,95,103,146,644,976,4,4439,246,0,1
70,1375,177,108,140,8,0,27,185,6,30,16,32,36,48,162,248,3,794,44,0,1
60,1082,282,196,195,3,0,86,285,8,130,71,141,138,212,936,1507,4,6538,363,0,1
92,3882,1289,550,1043,56,32,155,1345,10,167,93,185,177,278,1266,2075,5,11498,638,0,1
15,742,75,38,59,1,3,12,76,2,4,2,4,6,6,10,15,1,15,0,0,1
31,1981,1157,318,931,29,22,177,1186,6,104,63,125,110,188,712,1274,3,4596,255,0,1
172,7584,139,89,101,2,0,35,141,7,54,34,62,61,96,330,569,4,2287,127,0,1
172,7584,7,5,5,0,0,2,7,1,2,1,2,3,3,2,4,0,2,0,0,1
139,5902,1782,648,1425,9,47,279,1791,8,171,97,189,179,286,1292,2140,4,9462,525,0,1
111,4179,1450,624,1228,12,26,181,1462,14,306,186,354,320,540,2580,4493,8,36391,2021,1,1
84,4426,1457,730,1242,11,6,188,1468,10,292,166,329,302,495,2424,4078,5,22973,1276,1,1
69,3180,1455,414,1257,16,76,112,1471,5,41,23,46,46,69,231,381,2,1069,59,0,1
94,4585,1523,757,1297,19,12,193,1542,12,193,117,230,205,347,1508,2664,7,19053,1058,0,1
87,3802,1020,354,843,12,15,144,1032,8,134,77,144,142,221,970,1580,4,6792,377,0,1
38,2298,334,251,279,10,4,40,344,5,127,74,143,132,217,899,1528,2,4303,239,0,1
6,71,127,75,83,2,11,30,129,4,14,7,14,18,21,61,87,2,175,9,0,0
6,71,652,304,544,16,6,88,668,6,89,51,101,95,152,591,998,3,3399,188,0,0
6,71,2,2,2,0,0,0,2,0,0,0,0,0,0,0,0,0,0,0,0,0
6,71,8,5,5,0,0,3,8,0,0,0,0,0,0,0,0,0,0,0,0,0
6,71,14,8,8,0,0,6,14,0,0,0,0,0,0,0,0,0,0,0,0,0
6,71,6,4,4,0,0,2,6,0,0,0,0,0,0,0,0,0,0,0,0,0
6,71,6,4,4,0,0,2,6,1,2,1,2,3,3,2,4,0,2,0,0,0
6,71,7,5,5,0,0,2,7,0,0,0,0,0,0,0,0,0,0,0,0,0
6,71,10,6,6,0,0,4,10,0,0,0,0,0,0,0,0,0,0,0,0,0
6,71,1,1,1,0,0,0,1,0,0,0,0,0,0,0,0,0,0,0,0,0
6,71,14,10,10,0,0,4,14,1,1,1,1,2,2,0,2,0,1,0,0,0
6,71,46,26,30,3,0,12,49,3,6,3,6,9,9,20,28,1,42,2,0,0
87,3802,1020,354,843,12,15,144,1032,8,134,77,144,142,221,970,1580,4,6792,377,0,0
213,4611,182,127,129,0,0,53,182,5,39,21,42,44,63,217,343,2,926,51,0,1
213,4611,1165,710,800,67,119,181,1232,18,243,153,282,261,435,2000,3492,10,36473,2026,1,1
83,1808,773,419,590,28,0,166,801,10,204,113,217,214,330,1598,2554,5,13587,754,0,1
83,1808,421,273,302,44,34,57,465,17,81,59,107,98,166,583,1098,11,12329,684,0,1
26,525,2,2,2,0,0,0,2,0,0,0,0,0,0,0,0,0,0,0,0,1
26,525,99,48,90,1,3,5,100,0,0,0,0,0,0,0,0,0,0,0,0,1
26,525,8,5,5,2,0,1,10,0,0,0,0,0,0,0,0,0,0,0,0,1
26,525,1217,716,841,84,126,174,1301,14,185,118,215,199,333,1446,2542,8,20687,1149,0,1
26,525,160,89,115,0,13,31,160,7,15,11,17,22,28,78,124,3,495,27,0,1
26,525,10,10,9,9,0,0,19,0,0,0,0,0,0,0,0,0,0,0,0,1
26,525,173,84,99,8,29,36,181,5,12,7,13,17,20,54,81,2,221,12,0,1
26,525,3,1,1,3,0,0,6,0,0,0,0,0,0,0,0,0,0,0,0,1
164,5032,1660,832,1314,41,38,274,1701,20,312,209,395,332,604,2671,5058,12,64042,3557,1,1
164,5032,1057,646,719,113,100,145,1170,18,215,134,248,233,382,1740,3004,10,31186,1732,1,1
17,344,95,58,50,9,16,20,104,12,33,24,45,45,69,209,378,8,3100,172,0,1
89,1830,477,336,357,30,23,73,507,16,194,134,250,210,384,1538,2962,10,30538,1696,0,1
71,1702,996,429,845,24,10,117,1020,7,76,50,88,83,138,494,879,4,3565,198,0,1
71,1702,456,277,329,12,42,72,468,13,85,50,97,98,147,592,972,7,7212,400,0,1
145,3016,1513,682,1277,25,13,200,1538,11,199,116,219,210,335,1557,2584,6,15641,868,0,1
145,3016,819,519,539,24,98,155,843,15,96,57,106,111,163,690,1107,8,9171,509,0,1
58,1177,207,111,150,11,0,50,218,5,26,19,36,31,55,133,272,3,943,52,0,1
58,1177,410,198,237,31,55,97,441,11,63,38,72,74,110,414,683,6,4293,238,0,1
356,7117,1457,730,1242,11,6,188,1468,10,292,166,329,302,495,2424,4078,5,22973,1276,1,1
356,7117,74,35,59,1,0,14,75,3,14,7,14,17,21,58,85,1,128,7,0,1
356,7117,245,125,200,5,7,34,250,7,30,17,34,37,51,166,265,3,1053,58,0,1
28,809,339,213,244,17,9,65,356,10,42,26,48,52,74,259,421,5,2410,133,0,1
84,2154,1455,414,1257,16,76,112,1471,5,41,23,46,46,69,231,381,2,1069,59,0,1
84,2154,669,365,481,22,61,110,691,15,103,63,122,118,185,747,1273,8,11311,628,0,1
237,5395,4293,999,3693,19,54,507,4312,9,155,88,170,164,258,1156,1898,4,9368,520,0,1
237,5395,1482,859,1002,125,135,219,1607,16,219,134,251,235,385,1766,3032,9,27804,1544,1,1
27,959,74,35,59,1,0,14,75,3,14,7,14,17,21,58,85,1,128,7,0,1
27,959,245,125,200,5,7,34,250,7,30,17,34,37,51,166,265,3,1053,58,0,1
98,2661,1523,757,1297,19,12,193,1542,12,193,117,230,205,347,1508,2664,7,19053,1058,0,1
98,2661,701,378,504,33,58,109,734,13,110,68,126,123,194,794,1346,7,10027,557,0,1
86,2225,773,422,505,30,103,129,803,14,77,46,83,91,129,535,839,7,6334,351,0,1
122,2937,77,34,69,0,0,8,77,3,24,16,29,27,45,114,213,1,387,21,0,1
122,2937,712,438,573,51,9,84,763,14,102,71,128,116,199,733,1364,8,11988,666,0,1
24,605,2,2,2,0,0,0,2,0,0,0,0,0,0,0,0,0,0,0,0,1
24,605,99,48,90,1,3,5,100,0,0,0,0,0,0,0,0,0,0,0,0,1
24,605,8,5,5,2,0,1,10,0,0,0,0,0,0,0,0,0,0,0,0,1
24,605,1217,716,841,84,126,174,1301,14,185,118,215,199,333,1446,2542,8,20687,1149,0,1
24,605,160,89,115,0,13,31,160,7,15,11,17,22,28,78,124,3,495,27,0,1
24,605,10,10,9,9,0,0,19,0,0,0,0,0,0,0,0,0,0,0,0,1
24,605,173,84,99,8,29,36,181,5,12,7,13,17,20,54,81,2,221,12,0,1
24,605,3,1,1,3,0,0,6,0,0,0,0,0,0,0,0,0,0,0,0,1
30,658,125,97,103,3,0,19,128,9,25,17,27,34,44,144,223,4,1087,60,0,1
79,1721,402,202,227,24,74,80,426,12,52,33,61,64,94,339,564,7,3969,220,0,1
48,992,447,308,343,6,5,95,453,7,96,59,111,103,170,651,1136,4,4600,255,0,1
48,992,322,174,179,16,74,51,338,10,41,26,46,51,72,252,408,5,2291,127,0,1
72,1644,53,23,39,0,0,13,53,2,8,4,8,10,12,26,39,1,39,2,0,1
72,1644,515,298,307,33,80,99,548,12,63,44,77,75,121,419,753,7,5527,307,0,1
23,381,424,94,331,4,0,89,428,1,5,5,5,6,10,11,25,0,12,0,0,1
23,381,38,23,23,6,0,8,44,3,11,7,11,14,18,42,68,1,102,5,0,1
20,511,205,80,86,16,53,53,221,7,18,10,19,25,29,94,134,3,497,27,0,1
17,519,184,100,137,2,15,30,186,6,38,20,39,44,59,214,322,3,991,55,0,1
17,519,103,65,74,8,5,16,111,7,17,9,17,24,26,89,119,3,417,23,0,1
226,5309,722,423,573,19,0,135,741,12,172,101,199,184,300,1320,2257,6,15668,870,0,1
226,5309,1508,847,911,44,250,301,1552,14,148,88,169,162,257,1120,1886,7,15077,837,0,1
285,6295,72,33,56,0,4,12,72,1,1,1,1,2,2,0,2,0,1,0,0,1
285,6295,1454,835,1044,76,110,219,1530,17,275,158,296,292,454,2297,3718,9,34017,1889,1,1
46,955,386,256,301,16,9,68,402,4,59,35,69,63,104,355,621,2,1453,80,0,1
46,955,264,131,164,11,41,46,275,6,38,22,40,44,62,214,338,3,1068,59,0,1
30,650,215,129,180,6,0,29,221,8,65,43,72,73,115,415,711,4,3153,175,0,1
30,650,97,69,77,3,3,16,100,6,22,13,23,28,36,113,173,3,542,30,0,1
115,2577,1043,504,840,53,9,147,1096,9,180,112,198,189,310,1377,2344,4,11604,644,0,1
115,2577,383,288,292,26,6,62,409,11,65,38,67,76,105,429,656,5,3719,206,0,1
20,411,294,64,250,0,0,43,294,1,20,10,20,21,30,86,131,0,65,3,0,1
20,411,78,46,62,3,0,14,81,3,8,4,8,11,12,28,41,1,62,3,0,1
5,119,110,30,77,3,13,16,113,4,21,15,30,25,45,100,208,2,597,33,0,1
5,119,28,15,21,1,0,6,29,0,0,0,0,0,0,0,0,0,0,0,0,1
70,1380,1178,367,1042,6,15,115,1184,9,94,51,95,103,146,644,976,4,4439,246,0,1
70,1380,177,108,140,8,0,27,185,6,30,16,32,36,48,162,248,3,794,44,0,1
209,4543,1943,715,1694,26,18,214,1969,12,185,120,237,197,357,1436,2721,7,20915,1161,0,1
209,4543,1168,838,957,57,25,144,1225,19,348,224,416,367,640,3018,5452,11,61921,3440,1,1
62,1223,1098,241,925,5,10,155,1103,7,46,25,49,53,74,273,423,3,1580,87,0,1
62,1223,282,202,222,14,2,44,296,8,42,24,43,50,67,250,378,4,1548,86,0,1
22,460,601,196,481,2,23,85,603,8,63,36,72,71,108,400,664,4,3036,168,0,1
22,460,156,79,106,5,16,28,161,5,14,8,15,19,23,64,97,2,261,14,0,1
3,42,14,8,8,0,0,6,14,0,0,0,0,0,0,0,0,0,0,0,0,1
2,34,9,6,6,0,0,3,9,0,0,0,0,0,0,0,0,0,0,0,0,1
2,34,13,9,8,0,0,4,13,0,0,0,0,0,0,0,0,0,0,0,0,1
1,324,382,65,130,157,2,92,539,4,10,5,10,14,15,41,57,2,114,6,0,1
60,1081,282,196,195,3,0,86,285,8,130,71,141,138,212,936,1507,4,6538,363,0,1
1,9,5,3,3,0,0,2,5,0,0,0,0,0,0,0,0,0,0,0,0,1
12,229,127,75,83,2,11,30,129,4,14,7,14,18,21,61,87,2,175,9,0,1
12,229,652,304,544,16,6,88,668,6,89,51,101,95,152,591,998,3,3399,188,0,1
12,229,2,2,2,0,0,0,2,0,0,0,0,0,0,0,0,0,0,0,0,1
12,229,8,5,5,0,0,3,8,0,0,0,0,0,0,0,0,0,0,0,0,1
12,229,14,8,8,0,0,6,14,0,0,0,0,0,0,0,0,0,0,0,0,1
12,229,6,4,4,0,0,2,6,0,0,0,0,0,0,0,0,0,0,0,0,1
12,229,6,4,4,0,0,2,6,1,2,1,2,3,3,2,4,0,2,0,0,1
12,229,7,5,5,0,0,2,7,0,0,0,0,0,0,0,0,0,0,0,0,1
12,229,10,6,6,0,0,4,10,0,0,0,0,0,0,0,0,0,0,0,0,1
12,229,1,1,1,0,0,0,1,0,0,0,0,0,0,0,0,0,0,0,0,1
12,229,14,10,10,0,0,4,14,1,1,1,1,2,2,0,2,0,1,0,0,1
12,229,46,26,30,3,0,12,49,3,6,3,6,9,9,20,28,1,42,2,0,1
15,484,42,7,35,4,0,5,46,1,2,1,2,3,3,2,4,0,2,0,0,1
15,484,11,6,10,0,0,1,11,2,4,2,4,6,6,10,15,1,15,0,0,1
92,3866,1289,550,1043,56,32,155,1345,10,167,93,185,177,278,1266,2075,5,11498,638,0,1
36,1084,182,127,129,0,0,53,182,5,39,21,42,44,63,217,343,2,926,51,0,1
147,6916,1392,870,1177,35,17,170,1427,14,494,280,531,508,811,4473,7289,7,54850,3047,2,1
88,2881,773,419,590,28,0,166,801,10,204,113,217,214,330,1598,2554,5,13587,754,0,1
13,570,139,89,101,2,0,35,141,7,54,34,62,61,96,330,569,4,2287,127,0,1
1,138,149,67,118,4,0,27,153,1,17,14,28,18,42,69,175,0,144,8,0,1
31,1983,1157,318,931,29,22,177,1186,6,104,63,125,110,188,712,1274,3,4596,255,0,1
54,3598,520,294,400,33,13,81,553,10,261,204,367,271,571,2128,4614,7,32445,1802,1,1
97,4401,1338,495,1086,10,64,173,1348,11,122,82,157,133,239,883,1686,7,11934,663,0,1
172,7590,139,89,101,2,0,35,141,7,54,34,62,61,96,330,569,4,2287,127,0,1
172,7590,7,5,5,0,0,2,7,1,2,1,2,3,3,2,4,0,2,0,0,1
33,989,465,148,393,5,8,60,470,4,31,20,31,35,51,161,261,2,523,29,0,1
33,989,16,12,9,0,0,6,16,1,2,1,2,3,3,2,4,0,2,0,0,1
139,5899,1782,648,1425,9,47,279,1791,8,171,97,189,179,286,1292,2140,4,9462,525,0,1
25,684,256,139,192,9,7,47,265,4,23,12,24,27,36,112,171,2,357,19,0,1
6,328,180,34,164,0,0,16,180,1,12,6,12,13,18,43,66,0,33,1,0,1
23,578,102,59,69,5,3,24,107,6,22,15,28,28,43,113,206,3,789,43,0,1
111,4186,1450,624,1228,12,26,181,1462,14,306,186,354,320,540,2580,4493,8,36391,2021,1,1
155,4437,1660,832,1314,41,38,274,1701,20,312,209,395,332,604,2671,5058,12,64042,3557,1,1
36,2873,996,429,845,24,10,117,1020,7,76,50,88,83,138,494,879,4,3565,198,0,1
129,5198,1513,682,1277,25,13,200,1538,11,199,116,219,210,335,1557,2584,6,15641,868,0,1
73,3803,1296,573,1062,40,33,157,1336,8,201,118,231,209,349,1561,2689,4,12365,686,0,1
84,4433,1457,730,1242,11,6,188,1468,10,292,166,329,302,495,2424,4078,5,22973,1276,1,1
39,2323,652,304,544,16,6,88,668,6,89,51,101,95,152,591,998,3,3399,188,0,1
69,3174,1455,414,1257,16,76,112,1471,5,41,23,46,46,69,231,381,2,1069,59,0,1
8,271,74,35,59,1,0,14,75,3,14,7,14,17,21,58,85,1,128,7,0,1
94,4592,1523,757,1297,19,12,193,1542,12,193,117,230,205,347,1508,2664,7,19053,1058,0,1
87,3811,1020,354,843,12,15,144,1032,8,134,77,144,142,221,970,1580,4,6792,377,0,1
38,1676,447,308,343,6,5,95,453,7,96,59,111,103,170,651,1136,4,4600,255,0,1
1,107,53,23,39,0,0,13,53,2,8,4,8,10,12,26,39,1,39,2,0,1
21,658,424,94,331,4,0,89,428,1,5,5,5,6,10,11,25,0,12,0,0,1
38,2302,334,251,279,10,4,40,344,5,127,74,143,132,217,899,1528,2,4303,239,0,1
12,493,184,100,137,2,15,30,186,6,38,20,39,44,59,214,322,3,991,55,0,1
59,2582,1293,570,1093,25,15,163,1318,10,195,123,241,205,364,1516,2795,6,17273,959,0,1
33,1883,384,251,317,7,8,52,391,11,70,44,84,81,128,467,811,6,5355,297,0,1
39,1727,386,256,301,16,9,68,402,4,59,35,69,63,104,355,621,2,1453,80,0,1
16,1214,215,129,180,6,0,29,221,8,65,43,72,73,115,415,711,4,3153,175,0,1
79,3060,1043,504,840,53,9,147,1096,9,180,112,198,189,310,1377,2344,4,11604,644,0,1
14,530,295,56,236,0,4,54,295,2,9,5,10,11,15,30,51,1,57,3,0,1
30,1241,373,158,315,8,0,51,381,5,76,44,79,81,123,486,779,2,2026,112,0,1
77,3211,1178,367,1042,6,15,115,1184,9,94,51,95,103,146,644,976,4,4439,246,0,1
91,4584,1943,715,1694,26,18,214,1969,12,185,120,237,197,357,1436,2721,7,20915,1161,0,1
14,826,442,244,305,14,16,103,456,11,68,45,75,79,120,452,756,6,4588,254,0,1
48,1744,1098,241,925,5,10,155,1103,7,46,25,49,53,74,273,423,3,1580,87,0,1
19,682,601,196,481,2,23,85,603,8,63,36,72,71,108,400,664,4,3036,168,0,1
213,4615,182,127,129,0,0,53,182,5,39,21,42,44,63,217,343,2,926,51,0,1
213,4615,1165,710,800,67,119,181,1232,18,243,153,282,261,435,2000,3492,10,36473,2026,1,1
58,1183,207,111,150,11,0,50,218,5,26,19,36,31,55,133,272,3,943,52,0,1
58,1183,410,198,237,31,55,97,441,11,63,38,72,74,110,414,683,6,4293,238,0,1
237,5397,4293,999,3693,19,54,507,4312,9,155,88,170,164,258,1156,1898,4,9368,520,0,1
237,5397,1482,859,1002,125,135,219,1607,16,219,134,251,235,385,1766,3032,9,27804,1544,1,1
285,6294,72,33,56,0,4,12,72,1,1,1,1,2,2,0,2,0,1,0,0,1
285,6294,1454,835,1044,76,110,219,1530,17,275,158,296,292,454,2297,3718,9,34017,1889,1,1
78,1580,757,253,292,73,244,162,830,13,61,38,67,74,105,409,651,7,4654,258,0,1
2,40,9,6,6,0,0,3,9,0,0,0,0,0,0,0,0,0,0,0,0,1
2,40,13,9,8,0,0,4,13,0,0,0,0,0,0,0,0,0,0,0,0,1
17,378,85,59,61,8,0,16,93,5,18,10,18,23,28,86,126,2,316,17,0,1
36,1088,182,127,129,0,0,53,182,5,39,21,42,44,63,217,343,2,926,51,0,1
125,5129,1513,682,1277,25,13,200,1538,11,199,116,219,210,335,1557,2584,6,15641,868,0,1
88,2881,773,419,590,28,0,166,801,10,204,113,217,214,330,1598,2554,5,13587,754,0,0
95,4653,1523,757,1297,19,12,193,1542,12,193,117,230,205,347,1508,2664,7,19053,1058,0,0
49,1844,1098,241,925,5,10,155,1103,7,46,25,49,53,74,273,423,3,1580,87,0,0
49,1845,1098,241,925,5,10,155,1103,7,46,25,49,53,74,273,423,3,1580,87,0,0
237,5390,4293,999,3693,19,54,507,4312,9,155,88,170,164,258,1156,1898,4,9368,520,0,0
237,5390,1482,859,1002,125,135,219,1607,16,219,134,251,235,385,1766,3032,9,27804,1544,1,0
262,6287,72,33,56,0,4,12,72,1,1,1,1,2,2,0,2,0,1,0,0,0
262,6287,1454,835,1044,76,110,219,1530,17,275,158,296,292,454,2297,3718,9,34017,1889,1,0
62,1229,1098,241,925,5,10,155,1103,7,46,25,49,53,74,273,423,3,1580,87,0,0
62,1229,282,202,222,14,2,44,296,8,42,24,43,50,67,250,378,4,1548,86,0,0
163,5014,1660,832,1314,41,38,274,1701,20,312,209,395,332,604,2671,5058,12,64042,3557,1,0
163,5014,1057,646,719,113,100,145,1170,18,215,134,248,233,382,1740,3004,10,31186,1732,1,0
237,5399,4293,999,3693,19,54,507,4312,9,155,88,170,164,258,1156,1898,4,9368,520,0,0
237,5399,1482,859,1002,125,135,219,1607,16,219,134,251,235,385,1766,3032,9,27804,1544,1,0
98,2661,1523,757,1297,19,12,193,1542,12,193,117,230,205,347,1508,2664,7,19053,1058,0,0
98,2661,701,378,504,33,58,109,734,13,110,68,126,123,194,794,1346,7,10027,557,0,0
285,6292,72,33,56,0,4,12,72,1,1,1,1,2,2,0,2,0,1,0,0,0
285,6292,1454,835,1044,76,110,219,1530,17,275,158,296,292,454,2297,3718,9,34017,1889,1,0
62,1230,1098,241,925,5,10,155,1103,7,46,25,49,53,74,273,423,3,1580,87,0,0
62,1230,282,202,222,14,2,44,296,8,42,24,43,50,67,250,378,4,1548,86,0,0
95,4654,1523,757,1297,19,12,193,1542,12,193,117,230,205,347,1508,2664,7,19053,1058,0,0
49,1839,1098,241,925,5,10,155,1103,7,46,25,49,53,74,273,423,3,1580,87,0,0
49,1838,1098,241,925,5,10,155,1103,7,46,25,49,53,74,273,423,3,1580,87,0,0
213,4615,182,127,129,0,0,53,182,5,39,21,42,44,63,217,343,2,926,51,0,0
213,4615,1165,710,800,67,119,181,1232,18,243,153,282,261,435,2000,3492,10,36473,2026,1,0
83,1808,773,419,590,28,0,166,801,10,204,113,217,214,330,1598,2554,5,13587,754,0,0
83,1808,421,273,302,44,34,57,465,17,81,59,107,98,166,583,1098,11,12329,684,0,0
26,525,2,2,2,0,0,0,2,0,0,0,0,0,0,0,0,0,0,0,0,0
26,525,99,48,90,1,3,5,100,0,0,0,0,0,0,0,0,0,0,0,0,0
26,525,8,5,5,2,0,1,10,0,0,0,0,0,0,0,0,0,0,0,0,0
26,525,1217,716,841,84,126,174,1301,14,185,118,215,199,333,1446,2542,8,20687,1149,0,0
26,525,160,89,115,0,13,31,160,7,15,11,17,22,28,78,124,3,495,27,0,0
26,525,10,10,9,9,0,0,19,0,0,0,0,0,0,0,0,0,0,0,0,0
26,525,173,84,99,8,29,36,181,5,12,7,13,17,20,54,81,2,221,12,0,0
26,525,3,1,1,3,0,0,6,0,0,0,0,0,0,0,0,0,0,0,0,0
164,5032,1660,832,1314,41,38,274,1701,20,312,209,395,332,604,2671,5058,12,64042,3557,1,0
164,5032,1057,646,719,113,100,145,1170,18,215,134,248,233,382,1740,3004,10,31186,1732,1,0
17,344,95,58,50,9,16,20,104,12,33,24,45,45,69,209,378,8,3100,172,0,0
89,1830,477,336,357,30,23,73,507,16,194,134,250,210,384,1538,2962,10,30538,1696,0,0
71,1702,996,429,845,24,10,117,1020,7,76,50,88,83,138,494,879,4,3565,198,0,0
71,1702,456,277,329,12,42,72,468,13,85,50,97,98,147,592,972,7,7212,400,0,0
58,1183,207,111,150,11,0,50,218,5,26,19,36,31,55,133,272,3,943,52,0,0
58,1183,410,198,237,31,55,97,441,11,63,38,72,74,110,414,683,6,4293,238,0,0
356,7117,1457,730,1242,11,6,188,1468,10,292,166,329,302,495,2424,4078,5,22973,1276,1,0
356,7117,74,35,59,1,0,14,75,3,14,7,14,17,21,58,85,1,128,7,0,0
356,7117,245,125,200,5,7,34,250,7,30,17,34,37,51,166,265,3,1053,58,0,0
28,809,339,213,244,17,9,65,356,10,42,26,48,52,74,259,421,5,2410,133,0,0
84,2154,1455,414,1257,16,76,112,1471,5,41,23,46,46,69,231,381,2,1069,59,0,0
84,2154,669,365,481,22,61,110,691,15,103,63,122,118,185,747,1273,8,11311,628,0,0
27,959,74,35,59,1,0,14,75,3,14,7,14,17,21,58,85,1,128,7,0,0
27,959,245,125,200,5,7,34,250,7,30,17,34,37,51,166,265,3,1053,58,0,0
86,2225,773,422,505,30,103,129,803,14,77,46,83,91,129,535,839,7,6334,351,0,0
122,2937,77,34,69,0,0,8,77,3,24,16,29,27,45,114,213,1,387,21,0,0
122,2937,712,438,573,51,9,84,763,14,102,71,128,116,199,733,1364,8,11988,666,0,0
24,605,2,2,2,0,0,0,2,0,0,0,0,0,0,0,0,0,0,0,0,0
24,605,99,48,90,1,3,5,100,0,0,0,0,0,0,0,0,0,0,0,0,0
24,605,8,5,5,2,0,1,10,0,0,0,0,0,0,0,0,0,0,0,0,0
24,605,1217,716,841,84,126,174,1301,14,185,118,215,199,333,1446,2542,8,20687,1149,0,0
24,605,160,89,115,0,13,31,160,7,15,11,17,22,28,78,124,3,495,27,0,0
24,605,10,10,9,9,0,0,19,0,0,0,0,0,0,0,0,0,0,0,0,0
24,605,173,84,99,8,29,36,181,5,12,7,13,17,20,54,81,2,221,12,0,0
24,605,3,1,1,3,0,0,6,0,0,0,0,0,0,0,0,0,0,0,0,0
30,658,125,97,103,3,0,19,128,9,25,17,27,34,44,144,223,4,1087,60,0,0
22,350,102,57,55,5,16,25,107,5,17,10,18,22,28,81,124,2,330,18,0,0
79,1721,402,202,227,24,74,80,426,12,52,33,61,64,94,339,564,7,3969,220,0,0
72,1644,53,23,39,0,0,13,53,2,8,4,8,10,12,26,39,1,39,2,0,0
72,1644,515,298,307,33,80,99,548,12,63,44,77,75,121,419,753,7,5527,307,0,0
23,381,424,94,331,4,0,89,428,1,5,5,5,6,10,11,25,0,12,0,0,0
23,381,38,23,23,6,0,8,44,3,11,7,11,14,18,42,68,1,102,5,0,0
20,511,205,80,86,16,53,53,221,7,18,10,19,25,29,94,134,3,497,27,0,0
17,519,184,100,137,2,15,30,186,6,38,20,39,44,59,214,322,3,991,55,0,0
17,519,103,65,74,8,5,16,111,7,17,9,17,24,26,89,119,3,417,23,0,0
226,5309,722,423,573,19,0,135,741,12,172,101,199,184,300,1320,2257,6,15668,870,0,0
226,5309,1508,847,911,44,250,301,1552,14,148,88,169,162,257,1120,1886,7,15077,837,0,0
78,1580,757,253,292,73,244,162,830,13,61,38,67,74,105,409,651,7,4654,258,0,0
46,955,386,256,301,16,9,68,402,4,59,35,69,63,104,355,621,2,1453,80,0,0
46,955,264,131,164,11,41,46,275,6,38,22,40,44,62,214,338,3,1068,59,0,0
30,650,215,129,180,6,0,29,221,8,65,43,72,73,115,415,711,4,3153,175,0,0
30,650,97,69,77,3,3,16,100,6,22,13,23,28,36,113,173,3,542,30,0,0
115,2577,1043,504,840,53,9,147,1096,9,180,112,198,189,310,1377,2344,4,11604,644,0,0
115,2577,383,288,292,26,6,62,409,11,65,38,67,76,105,429,656,5,3719,206,0,0
20,411,294,64,250,0,0,43,294,1,20,10,20,21,30,86,131,0,65,3,0,0
20,411,78,46,62,3,0,14,81,3,8,4,8,11,12,28,41,1,62,3,0,0
5,119,110,30,77,3,13,16,113,4,21,15,30,25,45,100,208,2,597,33,0,0
5,119,28,15,21,1,0,6,29,0,0,0,0,0,0,0,0,0,0,0,0,0
70,1380,1178,367,1042,6,15,115,1184,9,94,51,95,103,146,644,976,4,4439,246,0,0
70,1380,177,108,140,8,0,27,185,6,30,16,32,36,48,162,248,3,794,44,0,0
209,4543,1943,715,1694,26,18,214,1969,12,185,120,237,197,357,1436,2721,7,20915,1161,0,0
209,4543,1168,838,957,57,25,144,1225,19,348,224,416,367,640,3018,5452,11,61921,3440,1,0
22,460,601,196,481,2,23,85,603,8,63,36,72,71,108,400,664,4,3036,168,0,0
22,460,156,79,106,5,16,28,161,5,14,8,15,19,23,64,97,2,261,14,0,0
2,40,9,6,6,0,0,3,9,0,0,0,0,0,0,0,0,0,0,0,0,0
2,40,13,9,8,0,0,4,13,0,0,0,0,0,0,0,0,0,0,0,0,0
1,324,382,65,130,157,2,92,539,4,10,5,10,14,15,41,57,2,114,6,0,0
60,1081,282,196,195,3,0,86,285,8,130,71,141,138,212,936,1507,4,6538,363,0,0
4,77,127,75,83,2,11,30,129,4,14,7,14,18,21,61,87,2,175,9,0,0
4,77,652,304,544,16,6,88,668,6,89,51,101,95,152,591,998,3,3399,188,0,0
4,77,2,2,2,0,0,0,2,0,0,0,0,0,0,0,0,0,0,0,0,0
4,77,8,5,5,0,0,3,8,0,0,0,0,0,0,0,0,0,0,0,0,0
4,77,14,8,8,0,0,6,14,0,0,0,0,0,0,0,0,0,0,0,0,0
4,77,6,4,4,0,0,2,6,0,0,0,0,0,0,0,0,0,0,0,0,0
4,77,6,4,4,0,0,2,6,1,2,1,2,3,3,2,4,0,2,0,0,0
4,77,7,5,5,0,0,2,7,0,0,0,0,0,0,0,0,0,0,0,0,0
4,77,10,6,6,0,0,4,10,0,0,0,0,0,0,0,0,0,0,0,0,0
4,77,1,1,1,0,0,0,1,0,0,0,0,0,0,0,0,0,0,0,0,0
4,77,14,10,10,0,0,4,14,1,1,1,1,2,2,0,2,0,1,0,0,0
4,77,46,26,30,3,0,12,49,3,6,3,6,9,9,20,28,1,42,2,0,0
1,9,5,3,3,0,0,2,5,0,0,0,0,0,0,0,0,0,0,0,0,0
12,229,127,75,83,2,11,30,129,4,14,7,14,18,21,61,87,2,175,9,0,0
12,229,652,304,544,16,6,88,668,6,89,51,101,95,152,591,998,3,3399,188,0,0
12,229,2,2,2,0,0,0,2,0,0,0,0,0,0,0,0,0,0,0,0,0
12,229,8,5,5,0,0,3,8,0,0,0,0,0,0,0,0,0,0,0,0,0
12,229,14,8,8,0,0,6,14,0,0,0,0,0,0,0,0,0,0,0,0,0
12,229,6,4,4,0,0,2,6,0,0,0,0,0,0,0,0,0,0,0,0,0
12,229,6,4,4,0,0,2,6,1,2,1,2,3,3,2,4,0,2,0,0,0
12,229,7,5,5,0,0,2,7,0,0,0,0,0,0,0,0,0,0,0,0,0
12,229,10,6,6,0,0,4,10,0,0,0,0,0,0,0,0,0,0,0,0,0
12,229,1,1,1,0,0,0,1,0,0,0,0,0,0,0,0,0,0,0,0,0
12,229,14,10,10,0,0,4,14,1,1,1,1,2,2,0,2,0,1,0,0,0
12,229,46,26,30,3,0,12,49,3,6,3,6,9,9,20,28,1,42,2,0,0
17,378,85,59,61,8,0,16,93,5,18,10,18,23,28,86,126,2,316,17,0,0
15,484,42,7,35,4,0,5,46,1,2,1,2,3,3,2,4,0,2,0,0,0
15,484,11,6,10,0,0,1,11,2,4,2,4,6,6,10,15,1,15,0,0,0
92,3866,1289,550,1043,56,32,155,1345,10,167,93,185,177,278,1266,2075,5,11498,638,0,0
36,1088,182,127,129,0,0,53,182,5,39,21,42,44,63,217,343,2,926,51,0,0
147,6916,1392,870,1177,35,17,170,1427,14,494,280,531,508,811,4473,7289,7,54850,3047,2,0
13,570,139,89,101,2,0,35,141,7,54,34,62,61,96,330,569,4,2287,127,0,0
1,138,149,67,118,4,0,27,153,1,17,14,28,18,42,69,175,0,144,8,0,0
31,1983,1157,318,931,29,22,177,1186,6,104,63,125,110,188,712,1274,3,4596,255,0,0
54,3598,520,294,400,33,13,81,553,10,261,204,367,271,571,2128,4614,7,32445,1802,1,0
97,4401,1338,495,1086,10,64,173,1348,11,122,82,157,133,239,883,1686,7,11934,663,0,0
172,7590,139,89,101,2,0,35,141,7,54,34,62,61,96,330,569,4,2287,127,0,0
172,7590,7,5,5,0,0,2,7,1,2,1,2,3,3,2,4,0,2,0,0,0
33,989,465,148,393,5,8,60,470,4,31,20,31,35,51,161,261,2,523,29,0,0
33,989,16,12,9,0,0,6,16,1,2,1,2,3,3,2,4,0,2,0,0,0
139,5899,1782,648,1425,9,47,279,1791,8,171,97,189,179,286,1292,2140,4,9462,525,0,0
25,684,256,139,192,9,7,47,265,4,23,12,24,27,36,112,171,2,357,19,0,0
6,328,180,34,164,0,0,16,180,1,12,6,12,13,18,43,66,0,33,1,0,0
23,578,102,59,69,5,3,24,107,6,22,15,28,28,43,113,206,3,789,43,0,0
111,4186,1450,624,1228,12,26,181,1462,14,306,186,354,320,540,2580,4493,8,36391,2021,1,0
155,4437,1660,832,1314,41,38,274,1701,20,312,209,395,332,604,2671,5058,12,64042,3557,1,0
36,2873,996,429,845,24,10,117,1020,7,76,50,88,83,138,494,879,4,3565,198,0,0
125,5129,1513,682,1277,25,13,200,1538,11,199,116,219,210,335,1557,2584,6,15641,868,0,0
73,3803,1296,573,1062,40,33,157,1336,8,201,118,231,209,349,1561,2689,4,12365,686,0,0
84,4433,1457,730,1242,11,6,188,1468,10,292,166,329,302,495,2424,4078,5,22973,1276,1,0
39,2323,652,304,544,16,6,88,668,6,89,51,101,95,152,591,998,3,3399,188,0,0
69,3174,1455,414,1257,16,76,112,1471,5,41,23,46,46,69,231,381,2,1069,59,0,0
8,271,74,35,59,1,0,14,75,3,14,7,14,17,21,58,85,1,128,7,0,0
87,3811,1020,354,843,12,15,144,1032,8,134,77,144,142,221,970,1580,4,6792,377,0,0
1,107,53,23,39,0,0,13,53,2,8,4,8,10,12,26,39,1,39,2,0,0
21,658,424,94,331,4,0,89,428,1,5,5,5,6,10,11,25,0,12,0,0,0
38,2302,334,251,279,10,4,40,344,5,127,74,143,132,217,899,1528,2,4303,239,0,0
12,493,184,100,137,2,15,30,186,6,38,20,39,44,59,214,322,3,991,55,0,0
33,1883,384,251,317,7,8,52,391,11,70,44,84,81,128,467,811,6,5355,297,0,0
39,1727,386,256,301,16,9,68,402,4,59,35,69,63,104,355,621,2,1453,80,0,0
16,1214,215,129,180,6,0,29,221,8,65,43,72,73,115,415,711,4,3153,175,0,0
79,3060,1043,504,840,53,9,147,1096,9,180,112,198,189,310,1377,2344,4,11604,644,0,0
14,530,295,56,236,0,4,54,295,2,9,5,10,11,15,30,51,1,57,3,0,0
30,1241,373,158,315,8,0,51,381,5,76,44,79,81,123,486,779,2,2026,112,0,0
77,3211,1178,367,1042,6,15,115,1184,9,94,51,95,103,146,644,976,4,4439,246,0,0
91,4584,1943,715,1694,26,18,214,1969,12,185,120,237,197,357,1436,2721,7,20915,1161,0,0
14,826,442,244,305,14,16,103,456,11,68,45,75,79,120,452,756,6,4588,254,0,0
19,682,601,196,481,2,23,85,603,8,63,36,72,71,108,400,664,4,3036,168,0,0
163,5018,1660,832,1314,41,38,274,1701,20,312,209,395,332,604,2671,5058,12,64042,3557,1,0
163,5018,1057,646,719,113,100,145,1170,18,215,134,248,233,382,1740,3004,10,31186,1732,1,0
15,492,42,7,35,4,0,5,46,1,2,1,2,3,3,2,4,0,2,0,0,0
15,492,11,6,10,0,0,1,11,2,4,2,4,6,6,10,15,1,15,0,0,0
111,4174,1450,624,1228,12,26,181,1462,14,306,186,354,320,540,2580,4493,8,36391,2021,1,0
236,5393,4293,999,3693,19,54,507,4312,9,155,88,170,164,258,1156,1898,4,9368,520,0,0
236,5393,1482,859,1002,125,135,219,1607,16,219,134,251,235,385,1766,3032,9,27804,1544,1,0
147,6910,1392,870,1177,35,17,170,1427,14,494,280,531,508,811,4473,7289,7,54850,3047,2,0
157,4456,1660,832,1314,41,38,274,1701,20,312,209,395,332,604,2671,5058,12,64042,3557,1,1
154,4341,1660,832,1314,41,38,274,1701,20,312,209,395,332,604,2671,5058,12,64042,3557,1,1
154,4341,1660,832,1314,41,38,274,1701,20,312,209,395,332,604,2671,5058,12,64042,3557,1,0
15,495,42,7,35,4,0,5,46,1,2,1,2,3,3,2,4,0,2,0,0,0
15,495,11,6,10,0,0,1,11,2,4,2,4,6,6,10,15,1,15,0,0,0
356,7161,2,2,2,0,0,0,2,0,0,0,0,0,0,0,0,0,0,0,0,0
356,7161,99,48,90,1,3,5,100,0,0,0,0,0,0,0,0,0,0,0,0,0
356,7161,8,5,5,2,0,1,10,0,0,0,0,0,0,0,0,0,0,0,0,0
356,7161,1217,716,841,84,126,174,1301,14,185,118,215,199,333,1446,2542,8,20687,1149,0,0
356,7161,160,89,115,0,13,31,160,7,15,11,17,22,28,78,124,3,495,27,0,0
356,7161,10,10,9,9,0,0,19,0,0,0,0,0,0,0,0,0,0,0,0,0
356,7161,173,84,99,8,29,36,181,5,12,7,13,17,20,54,81,2,221,12,0,0
356,7161,3,1,1,3,0,0,6,0,0,0,0,0,0,0,0,0,0,0,0,0
262,5263,2,2,2,0,0,0,2,0,0,0,0,0,0,0,0,0,0,0,0,1
262,5263,99,48,90,1,3,5,100,0,0,0,0,0,0,0,0,0,0,0,0,1
262,5263,8,5,5,2,0,1,10,0,0,0,0,0,0,0,0,0,0,0,0,1
262,5263,1217,716,841,84,126,174,1301,14,185,118,215,199,333,1446,2542,8,20687,1149,0,1
262,5263,160,89,115,0,13,31,160,7,15,11,17,22,28,78,124,3,495,27,0,1
262,5263,10,10,9,9,0,0,19,0,0,0,0,0,0,0,0,0,0,0,0,1
262,5263,173,84,99,8,29,36,181,5,12,7,13,17,20,54,81,2,221,12,0,1
262,5263,3,1,1,3,0,0,6,0,0,0,0,0,0,0,0,0,0,0,0,1
94,1911,463,295,324,28,62,57,491,12,134,82,154,146,236,989,1696,6,11700,650,0,1
211,4544,2,2,2,0,0,0,2,0,0,0,0,0,0,0,0,0,0,0,0,1
211,4544,99,48,90,1,3,5,100,0,0,0,0,0,0,0,0,0,0,0,0,1
211,4544,8,5,5,2,0,1,10,0,0,0,0,0,0,0,0,0,0,0,0,1
211,4544,1217,716,841,84,126,174,1301,14,185,118,215,199,333,1446,2542,8,20687,1149,0,1
211,4544,160,89,115,0,13,31,160,7,15,11,17,22,28,78,124,3,495,27,0,1
211,4544,10,10,9,9,0,0,19,0,0,0,0,0,0,0,0,0,0,0,0,1
211,4544,173,84,99,8,29,36,181,5,12,7,13,17,20,54,81,2,221,12,0,1
211,4544,3,1,1,3,0,0,6,0,0,0,0,0,0,0,0,0,0,0,0,1
51,727,167,116,138,4,5,22,171,8,48,30,56,56,86,292,499,4,2330,129,0,1
125,5131,1513,682,1277,25,13,200,1538,11,199,116,219,210,335,1557,2584,6,15641,868,0,0
84,4436,1457,730,1242,11,6,188,1468,10,292,166,329,302,495,2424,4078,5,22973,1276,1,0
38,2304,334,251,279,10,4,40,344,5,127,74,143,132,217,899,1528,2,4303,239,0,0
10,379,42,7,35,4,0,5,46,1,2,1,2,3,3,2,4,0,2,0,0,0
10,379,11,6,10,0,0,1,11,2,4,2,4,6,6,10,15,1,15,0,0,0
115,2582,1043,504,840,53,9,147,1096,9,180,112,198,189,310,1377,2344,4,11604,644,0,0
115,2582,383,288,292,26,6,62,409,11,65,38,67,76,105,429,656,5,3719,206,0,0
79,3058,1043,504,840,53,9,147,1096,9,180,112,198,189,310,1377,2344,4,11604,644,0,0
209,4545,1943,715,1694,26,18,214,1969,12,185,120,237,197,357,1436,2721,7,20915,1161,0,0
209,4545,1168,838,957,57,25,144,1225,19,348,224,416,367,640,3018,5452,11,61921,3440,1,0
91,4597,1943,715,1694,26,18,214,1969,12,185,120,237,197,357,1436,2721,7,20915,1161,0,0
118,2609,1043,504,840,53,9,147,1096,9,180,112,198,189,310,1377,2344,4,11604,644,0,1
118,2609,383,288,292,26,6,62,409,11,65,38,67,76,105,429,656,5,3719,206,0,1
82,3156,1043,504,840,53,9,147,1096,9,180,112,198,189,310,1377,2344,4,11604,644,0,1
82,3156,1043,504,840,53,9,147,1096,9,180,112,198,189,310,1377,2344,4,11604,644,0,0
82,3160,1043,504,840,53,9,147,1096,9,180,112,198,189,310,1377,2344,4,11604,644,0,0
118,2609,1043,504,840,53,9,147,1096,9,180,112,198,189,310,1377,2344,4,11604,644,0,0
118,2609,383,288,292,26,6,62,409,11,65,38,67,76,105,429,656,5,3719,206,0,0
82,1757,402,202,227,24,74,80,426,12,52,33,61,64,94,339,564,7,3969,220,0,1
72,1650,53,23,39,0,0,13,53,2,8,4,8,10,12,26,39,1,39,2,0,1
72,1650,515,298,307,33,80,99,548,12,63,44,77,75,121,419,753,7,5527,307,0,1
88,3885,1020,354,843,12,15,144,1032,8,134,77,144,142,221,970,1580,4,6792,377,0,1
82,1767,402,202,227,24,74,80,426,12,52,33,61,64,94,339,564,7,3969,220,0,1
72,1646,53,23,39,0,0,13,53,2,8,4,8,10,12,26,39,1,39,2,0,1
72,1646,515,298,307,33,80,99,548,12,63,44,77,75,121,419,753,7,5527,307,0,1
33,1004,465,148,393,5,8,60,470,4,31,20,31,35,51,161,261,2,523,29,0,0
33,1004,16,12,9,0,0,6,16,1,2,1,2,3,3,2,4,0,2,0,0,0
82,1767,402,202,227,24,74,80,426,12,52,33,61,64,94,339,564,7,3969,220,0,0
72,1646,53,23,39,0,0,13,53,2,8,4,8,10,12,26,39,1,39,2,0,0
72,1646,515,298,307,33,80,99,548,12,63,44,77,75,121,419,753,7,5527,307,0,0
88,3885,1020,354,843,12,15,144,1032,8,134,77,144,142,221,970,1580,4,6792,377,0,0
73,1667,53,23,39,0,0,13,53,2,8,4,8,10,12,26,39,1,39,2,0,0
73,1667,515,298,307,33,80,99,548,12,63,44,77,75,121,419,753,7,5527,307,0,0
90,3963,1020,354,843,12,15,144,1032,8,134,77,144,142,221,970,1580,4,6792,377,0,0
73,1667,53,23,39,0,0,13,53,2,8,4,8,10,12,26,39,1,39,2,0,1
73,1667,515,298,307,33,80,99,548,12,63,44,77,75,121,419,753,7,5527,307,0,1
88,2248,773,422,505,30,103,129,803,14,77,46,83,91,129,535,839,7,6334,351,0,0
15,703,139,89,101,2,0,35,141,7,54,34,62,61,96,330,569,4,2287,127,0,0
8,183,51,25,36,0,0,15,51,3,11,6,12,14,18,42,68,1,112,6,0,1
8,263,51,25,36,0,0,15,51,3,11,6,12,14,18,42,68,1,112,6,0,0
8,265,51,25,36,0,0,15,51,3,11,6,12,14,18,42,68,1,112,6,0,0
70,3212,1455,414,1257,16,76,112,1471,5,41,23,46,46,69,231,381,2,1069,59,0,1
85,2161,1455,414,1257,16,76,112,1471,5,41,23,46,46,69,231,381,2,1069,59,0,0
85,2161,669,365,481,22,61,110,691,15,103,63,122,118,185,747,1273,8,11311,628,0,0
10,382,42,7,35,4,0,5,46,1,2,1,2,3,3,2,4,0,2,0,0,0
10,382,11,6,10,0,0,1,11,2,4,2,4,6,6,10,15,1,15,0,0,0
211,4544,2,2,2,0,0,0,2,0,0,0,0,0,0,0,0,0,0,0,0,0
211,4544,99,48,90,1,3,5,100,0,0,0,0,0,0,0,0,0,0,0,0,0
211,4544,8,5,5,2,0,1,10,0,0,0,0,0,0,0,0,0,0,0,0,0
211,4544,1217,716,841,84,126,174,1301,14,185,118,215,199,333,1446,2542,8,20687,1149,0,0
211,4544,160,89,115,0,13,31,160,7,15,11,17,22,28,78,124,3,495,27,0,0
211,4544,10,10,9,9,0,0,19,0,0,0,0,0,0,0,0,0,0,0,0,0
211,4544,173,84,99,8,29,36,181,5,12,7,13,17,20,54,81,2,221,12,0,0
211,4544,3,1,1,3,0,0,6,0,0,0,0,0,0,0,0,0,0,0,0,0
94,1911,463,295,324,28,62,57,491,12,134,82,154,146,236,989,1696,6,11700,650,0,0
51,727,167,116,138,4,5,22,171,8,48,30,56,56,86,292,499,4,2330,129,0,0
78,1581,757,253,292,73,244,162,830,13,61,38,67,74,105,409,651,7,4654,258,0,0
46,956,386,256,301,16,9,68,402,4,59,35,69,63,104,355,621,2,1453,80,0,0
46,956,264,131,164,11,41,46,275,6,38,22,40,44,62,214,338,3,1068,59,0,0
70,3212,1455,414,1257,16,76,112,1471,5,41,23,46,46,69,231,381,2,1069,59,0,0
285,6275,72,33,56,0,4,12,72,1,1,1,1,2,2,0,2,0,1,0,0,0
285,6275,1454,835,1044,76,110,219,1530,17,275,158,296,292,454,2297,3718,9,34017,1889,1,0
74,1755,996,429,845,24,10,117,1020,7,76,50,88,83,138,494,879,4,3565,198,0,1
74,1755,456,277,329,12,42,72,468,13,85,50,97,98,147,592,972,7,7212,400,0,1
74,1755,996,429,845,24,10,117,1020,7,76,50,88,83,138,494,879,4,3565,198,0,0
74,1755,456,277,329,12,42,72,468,13,85,50,97,98,147,592,972,7,7212,400,0,0
74,1762,996,429,845,24,10,117,1020,7,76,50,88,83,138,494,879,4,3565,198,0,0
74,1762,456,277,329,12,42,72,468,13,85,50,97,98,147,592,972,7,7212,400,0,0
39,2970,996,429,845,24,10,117,1020,7,76,50,88,83,138,494,879,4,3565,198,0,0
82,1769,402,202,227,24,74,80,426,12,52,33,61,64,94,339,564,7,3969,220,0,0
10,393,42,7,35,4,0,5,46,1,2,1,2,3,3,2,4,0,2,0,0,1
10,393,11,6,10,0,0,1,11,2,4,2,4,6,6,10,15,1,15,0,0,1
73,1672,996,429,845,24,10,117,1020,7,76,50,88,83,138,494,879,4,3565,198,0,1
73,1672,456,277,329,12,42,72,468,13,85,50,97,98,147,592,972,7,7212,400,0,1
58,1187,207,111,150,11,0,50,218,5,26,19,36,31,55,133,272,3,943,52,0,1
58,1187,410,198,237,31,55,97,441,11,63,38,72,74,110,414,683,6,4293,238,0,1
39,2971,996,429,845,24,10,117,1020,7,76,50,88,83,138,494,879,4,3565,198,0,1
2,71,167,116,138,4,5,22,171,8,48,30,56,56,86,292,499,4,2330,129,0,0
73,1672,996,429,845,24,10,117,1020,7,76,50,88,83,138,494,879,4,3565,198,0,0
73,1672,456,277,329,12,42,72,468,13,85,50,97,98,147,592,972,7,7212,400,0,0
58,1191,207,111,150,11,0,50,218,5,26,19,36,31,55,133,272,3,943,52,0,0
58,1191,410,198,237,31,55,97,441,11,63,38,72,74,110,414,683,6,4293,238,0,0
76,1730,996,429,845,24,10,117,1020,7,76,50,88,83,138,494,879,4,3565,198,0,0
76,1730,456,277,329,12,42,72,468,13,85,50,97,98,147,592,972,7,7212,400,0,0
58,1196,207,111,150,11,0,50,218,5,26,19,36,31,55,133,272,3,943,52,0,0
58,1196,410,198,237,31,55,97,441,11,63,38,72,74,110,414,683,6,4293,238,0,0
58,1196,207,111,150,11,0,50,218,5,26,19,36,31,55,133,272,3,943,52,0,1
58,1196,410,198,237,31,55,97,441,11,63,38,72,74,110,414,683,6,4293,238,0,1
76,1711,996,429,845,24,10,117,1020,7,76,50,88,83,138,494,879,4,3565,198,0,0
76,1711,456,277,329,12,42,72,468,13,85,50,97,98,147,592,972,7,7212,400,0,0
39,2971,996,429,845,24,10,117,1020,7,76,50,88,83,138,494,879,4,3565,198,0,0
74,1700,996,429,845,24,10,117,1020,7,76,50,88,83,138,494,879,4,3565,198,0,0
74,1700,456,277,329,12,42,72,468,13,85,50,97,98,147,592,972,7,7212,400,0,0
74,1693,996,429,845,24,10,117,1020,7,76,50,88,83,138,494,879,4,3565,198,0,0
74,1693,456,277,329,12,42,72,468,13,85,50,97,98,147,592,972,7,7212,400,0,0
164,5065,1660,832,1314,41,38,274,1701,20,312,209,395,332,604,2671,5058,12,64042,3557,1,0
164,5065,1057,646,719,113,100,145,1170,18,215,134,248,233,382,1740,3004,10,31186,1732,1,0
88,3896,1020,354,843,12,15,144,1032,8,134,77,144,142,221,970,1580,4,6792,377,0,0
78,1601,757,253,292,73,244,162,830,13,61,38,67,74,105,409,651,7,4654,258,0,0
56,3691,520,294,400,33,13,81,553,10,261,204,367,271,571,2128,4614,7,32445,1802,1,0
1,90,13,10,10,0,0,3,13,1,2,1,2,3,3,2,4,0,2,0,0,1
213,4619,182,127,129,0,0,53,182,5,39,21,42,44,63,217,343,2,926,51,0,1
213,4619,1165,710,800,67,119,181,1232,18,243,153,282,261,435,2000,3492,10,36473,2026,1,1
164,5065,1660,832,1314,41,38,274,1701,20,312,209,395,332,604,2671,5058,12,64042,3557,1,1
164,5065,1057,646,719,113,100,145,1170,18,215,134,248,233,382,1740,3004,10,31186,1732,1,1
58,1174,207,111,150,11,0,50,218,5,26,19,36,31,55,133,272,3,943,52,0,1
58,1174,410,198,237,31,55,97,441,11,63,38,72,74,110,414,683,6,4293,238,0,1
211,4551,2,2,2,0,0,0,2,0,0,0,0,0,0,0,0,0,0,0,0,1
211,4551,99,48,90,1,3,5,100,0,0,0,0,0,0,0,0,0,0,0,0,1
211,4551,8,5,5,2,0,1,10,0,0,0,0,0,0,0,0,0,0,0,0,1
211,4551,1217,716,841,84,126,174,1301,14,185,118,215,199,333,1446,2542,8,20687,1149,0,1
211,4551,160,89,115,0,13,31,160,7,15,11,17,22,28,78,124,3,495,27,0,1
211,4551,10,10,9,9,0,0,19,0,0,0,0,0,0,0,0,0,0,0,0,1
211,4551,173,84,99,8,29,36,181,5,12,7,13,17,20,54,81,2,221,12,0,1
211,4551,3,1,1,3,0,0,6,0,0,0,0,0,0,0,0,0,0,0,0,1
94,1909,463,295,324,28,62,57,491,12,134,82,154,146,236,989,1696,6,11700,650,0,1
28,810,339,213,244,17,9,65,356,10,42,26,48,52,74,259,421,5,2410,133,0,1
85,2161,1455,414,1257,16,76,112,1471,5,41,23,46,46,69,231,381,2,1069,59,0,1
85,2161,669,365,481,22,61,110,691,15,103,63,122,118,185,747,1273,8,11311,628,0,1
236,5392,4293,999,3693,19,54,507,4312,9,155,88,170,164,258,1156,1898,4,9368,520,0,1
236,5392,1482,859,1002,125,135,219,1607,16,219,134,251,235,385,1766,3032,9,27804,1544,1,1
82,1776,402,202,227,24,74,80,426,12,52,33,61,64,94,339,564,7,3969,220,0,1
226,5306,722,423,573,19,0,135,741,12,172,101,199,184,300,1320,2257,6,15668,870,0,1
226,5306,1508,847,911,44,250,301,1552,14,148,88,169,162,257,1120,1886,7,15077,837,0,1
285,6283,72,33,56,0,4,12,72,1,1,1,1,2,2,0,2,0,1,0,0,1
285,6283,1454,835,1044,76,110,219,1530,17,275,158,296,292,454,2297,3718,9,34017,1889,1,1
78,1601,757,253,292,73,244,162,830,13,61,38,67,74,105,409,651,7,4654,258,0,1
118,2612,1043,504,840,53,9,147,1096,9,180,112,198,189,310,1377,2344,4,11604,644,0,1
118,2612,383,288,292,26,6,62,409,11,65,38,67,76,105,429,656,5,3719,206,0,1
70,1382,1178,367,1042,6,15,115,1184,9,94,51,95,103,146,644,976,4,4439,246,0,1
70,1382,177,108,140,8,0,27,185,6,30,16,32,36,48,162,248,3,794,44,0,1
209,4552,1943,715,1694,26,18,214,1969,12,185,120,237,197,357,1436,2721,7,20915,1161,0,1
209,4552,1168,838,957,57,25,144,1225,19,348,224,416,367,640,3018,5452,11,61921,3440,1,1
62,1226,1098,241,925,5,10,155,1103,7,46,25,49,53,74,273,423,3,1580,87,0,1
62,1226,282,202,222,14,2,44,296,8,42,24,43,50,67,250,378,4,1548,86,0,1
22,458,601,196,481,2,23,85,603,8,63,36,72,71,108,400,664,4,3036,168,0,1
22,458,156,79,106,5,16,28,161,5,14,8,15,19,23,64,97,2,261,14,0,1
92,3868,1289,550,1043,56,32,155,1345,10,167,93,185,177,278,1266,2075,5,11498,638,0,1
147,6910,1392,870,1177,35,17,170,1427,14,494,280,531,508,811,4473,7289,7,54850,3047,2,1
15,744,75,38,59,1,3,12,76,2,4,2,4,6,6,10,15,1,15,0,0,1
1,136,149,67,118,4,0,27,153,1,17,14,28,18,42,69,175,0,144,8,0,1
31,1986,1157,318,931,29,22,177,1186,6,104,63,125,110,188,712,1274,3,4596,255,0,1
56,3685,520,294,400,33,13,81,553,10,261,204,367,271,571,2128,4614,7,32445,1802,1,1
97,4403,1338,495,1086,10,64,173,1348,11,122,82,157,133,239,883,1686,7,11934,663,0,1
172,7588,139,89,101,2,0,35,141,7,54,34,62,61,96,330,569,4,2287,127,0,1
172,7588,7,5,5,0,0,2,7,1,2,1,2,3,3,2,4,0,2,0,0,1
33,1004,465,148,393,5,8,60,470,4,31,20,31,35,51,161,261,2,523,29,0,1
33,1004,16,12,9,0,0,6,16,1,2,1,2,3,3,2,4,0,2,0,0,1
139,5895,1782,648,1425,9,47,279,1791,8,171,97,189,179,286,1292,2140,4,9462,525,0,1
111,4174,1450,624,1228,12,26,181,1462,14,306,186,354,320,540,2580,4493,8,36391,2021,1,1
154,4337,1660,832,1314,41,38,274,1701,20,312,209,395,332,604,2671,5058,12,64042,3557,1,1
36,2870,996,429,845,24,10,117,1020,7,76,50,88,83,138,494,879,4,3565,198,0,1
125,5131,1513,682,1277,25,13,200,1538,11,199,116,219,210,335,1557,2584,6,15641,868,0,1
84,4438,1457,730,1242,11,6,188,1468,10,292,166,329,302,495,2424,4078,5,22973,1276,1,1
95,4652,1523,757,1297,19,12,193,1542,12,193,117,230,205,347,1508,2664,7,19053,1058,0,1
88,3896,1020,354,843,12,15,144,1032,8,134,77,144,142,221,970,1580,4,6792,377,0,1
45,2209,722,423,573,19,0,135,741,12,172,101,199,184,300,1320,2257,6,15668,870,0,1
82,3157,1043,504,840,53,9,147,1096,9,180,112,198,189,310,1377,2344,4,11604,644,0,1
77,3213,1178,367,1042,6,15,115,1184,9,94,51,95,103,146,644,976,4,4439,246,0,1
91,4597,1943,715,1694,26,18,214,1969,12,185,120,237,197,357,1436,2721,7,20915,1161,0,1
49,1838,1098,241,925,5,10,155,1103,7,46,25,49,53,74,273,423,3,1580,87,0,1
19,680,601,196,481,2,23,85,603,8,63,36,72,71,108,400,664,4,3036,168,0,1
1,90,13,10,10,0,0,3,13,1,2,1,2,3,3,2,4,0,2,0,0,0
213,4619,182,127,129,0,0,53,182,5,39,21,42,44,63,217,343,2,926,51,0,0
213,4619,1165,710,800,67,119,181,1232,18,243,153,282,261,435,2000,3492,10,36473,2026,1,0
211,4551,2,2,2,0,0,0,2,0,0,0,0,0,0,0,0,0,0,0,0,0
211,4551,99,48,90,1,3,5,100,0,0,0,0,0,0,0,0,0,0,0,0,0
211,4551,8,5,5,2,0,1,10,0,0,0,0,0,0,0,0,0,0,0,0,0
211,4551,1217,716,841,84,126,174,1301,14,185,118,215,199,333,1446,2542,8,20687,1149,0,0
211,4551,160,89,115,0,13,31,160,7,15,11,17,22,28,78,124,3,495,27,0,0
211,4551,10,10,9,9,0,0,19,0,0,0,0,0,0,0,0,0,0,0,0,0
211,4551,173,84,99,8,29,36,181,5,12,7,13,17,20,54,81,2,221,12,0,0
211,4551,3,1,1,3,0,0,6,0,0,0,0,0,0,0,0,0,0,0,0,0
94,1909,463,295,324,28,62,57,491,12,134,82,154,146,236,989,1696,6,11700,650,0,0
28,810,339,213,244,17,9,65,356,10,42,26,48,52,74,259,421,5,2410,133,0,0
236,5392,4293,999,3693,19,54,507,4312,9,155,88,170,164,258,1156,1898,4,9368,520,0,0
236,5392,1482,859,1002,125,135,219,1607,16,219,134,251,235,385,1766,3032,9,27804,1544,1,0
82,1776,402,202,227,24,74,80,426,12,52,33,61,64,94,339,564,7,3969,220,0,0
226,5306,722,423,573,19,0,135,741,12,172,101,199,184,300,1320,2257,6,15668,870,0,0
226,5306,1508,847,911,44,250,301,1552,14,148,88,169,162,257,1120,1886,7,15077,837,0,0
285,6283,72,33,56,0,4,12,72,1,1,1,1,2,2,0,2,0,1,0,0,0
285,6283,1454,835,1044,76,110,219,1530,17,275,158,296,292,454,2297,3718,9,34017,1889,1,0
118,2612,1043,504,840,53,9,147,1096,9,180,112,198,189,310,1377,2344,4,11604,644,0,0
118,2612,383,288,292,26,6,62,409,11,65,38,67,76,105,429,656,5,3719,206,0,0
70,1382,1178,367,1042,6,15,115,1184,9,94,51,95,103,146,644,976,4,4439,246,0,0
70,1382,177,108,140,8,0,27,185,6,30,16,32,36,48,162,248,3,794,44,0,0
209,4552,1943,715,1694,26,18,214,1969,12,185,120,237,197,357,1436,2721,7,20915,1161,0,0
209,4552,1168,838,957,57,25,144,1225,19,348,224,416,367,640,3018,5452,11,61921,3440,1,0
62,1226,1098,241,925,5,10,155,1103,7,46,25,49,53,74,273,423,3,1580,87,0,0
62,1226,282,202,222,14,2,44,296,8,42,24,43,50,67,250,378,4,1548,86,0,0
22,458,601,196,481,2,23,85,603,8,63,36,72,71,108,400,664,4,3036,168,0,0
22,458,156,79,106,5,16,28,161,5,14,8,15,19,23,64,97,2,261,14,0,0
92,3868,1289,550,1043,56,32,155,1345,10,167,93,185,177,278,1266,2075,5,11498,638,0,0
15,744,75,38,59,1,3,12,76,2,4,2,4,6,6,10,15,1,15,0,0,0
1,136,149,67,118,4,0,27,153,1,17,14,28,18,42,69,175,0,144,8,0,0
31,1986,1157,318,931,29,22,177,1186,6,104,63,125,110,188,712,1274,3,4596,255,0,0
56,3685,520,294,400,33,13,81,553,10,261,204,367,271,571,2128,4614,7,32445,1802,1,0
97,4403,1338,495,1086,10,64,173,1348,11,122,82,157,133,239,883,1686,7,11934,663,0,0
172,7588,139,89,101,2,0,35,141,7,54,34,62,61,96,330,569,4,2287,127,0,0
172,7588,7,5,5,0,0,2,7,1,2,1,2,3,3,2,4,0,2,0,0,0
139,5895,1782,648,1425,9,47,279,1791,8,171,97,189,179,286,1292,2140,4,9462,525,0,0
154,4337,1660,832,1314,41,38,274,1701,20,312,209,395,332,604,2671,5058,12,64042,3557,1,0
36,2870,996,429,845,24,10,117,1020,7,76,50,88,83,138,494,879,4,3565,198,0,0
84,4438,1457,730,1242,11,6,188,1468,10,292,166,329,302,495,2424,4078,5,22973,1276,1,0
95,4652,1523,757,1297,19,12,193,1542,12,193,117,230,205,347,1508,2664,7,19053,1058,0,0
45,2209,722,423,573,19,0,135,741,12,172,101,199,184,300,1320,2257,6,15668,870,0,0
82,3157,1043,504,840,53,9,147,1096,9,180,112,198,189,310,1377,2344,4,11604,644,0,0
77,3213,1178,367,1042,6,15,115,1184,9,94,51,95,103,146,644,976,4,4439,246,0,0
19,680,601,196,481,2,23,85,603,8,63,36,72,71,108,400,664,4,3036,168,0,0
11,413,42,7,35,4,0,5,46,1,2,1,2,3,3,2,4,0,2,0,0,0
11,413,11,6,10,0,0,1,11,2,4,2,4,6,6,10,15,1,15,0,0,0
58,1192,207,111,150,11,0,50,218,5,26,19,36,31,55,133,272,3,943,52,0,0
58,1192,410,198,237,31,55,97,441,11,63,38,72,74,110,414,683,6,4293,238,0,0
39,2966,996,429,845,24,10,117,1020,7,76,50,88,83,138,494,879,4,3565,198,0,0
90,3974,1020,354,843,12,15,144,1032,8,134,77,144,142,221,970,1580,4,6792,377,0,0
89,3932,1020,354,843,12,15,144,1032,8,134,77,144,142,221,970,1580,4,6792,377,0,0
89,3941,1020,354,843,12,15,144,1032,8,134,77,144,142,221,970,1580,4,6792,377,0,1
83,1787,402,202,227,24,74,80,426,12,52,33,61,64,94,339,564,7,3969,220,0,1
83,1788,402,202,227,24,74,80,426,12,52,33,61,64,94,339,564,7,3969,220,0,0
28,699,466,257,367,18,25,50,484,7,126,86,171,133,257,898,1813,4,8612,478,0,1
28,699,507,281,342,29,59,88,536,10,53,29,57,63,86,336,514,5,2764,153,0,1
97,2135,1043,504,840,53,9,147,1096,9,180,112,198,189,310,1377,2344,4,11604,644,0,1
97,2135,383,288,292,26,6,62,409,11,65,38,67,76,105,429,656,5,3719,206,0,1
95,4640,1523,757,1297,19,12,193,1542,12,193,117,230,205,347,1508,2664,7,19053,1058,0,1
82,3159,1043,504,840,53,9,147,1096,9,180,112,198,189,310,1377,2344,4,11604,644,0,1
28,702,466,257,367,18,25,50,484,7,126,86,171,133,257,898,1813,4,8612,478,0,0
28,702,507,281,342,29,59,88,536,10,53,29,57,63,86,336,514,5,2764,153,0,0
90,1927,1043,504,840,53,9,147,1096,9,180,112,198,189,310,1377,2344,4,11604,644,0,0
90,1927,383,288,292,26,6,62,409,11,65,38,67,76,105,429,656,5,3719,206,0,0
227,5367,722,423,573,19,0,135,741,12,172,101,199,184,300,1320,2257,6,15668,870,0,1
227,5367,1508,847,911,44,250,301,1552,14,148,88,169,162,257,1120,1886,7,15077,837,0,1
229,5396,722,423,573,19,0,135,741,12,172,101,199,184,300,1320,2257,6,15668,870,0,1
229,5396,1508,847,911,44,250,301,1552,14,148,88,169,162,257,1120,1886,7,15077,837,0,1
1,15,127,75,83,2,11,30,129,4,14,7,14,18,21,61,87,2,175,9,0,1
1,15,652,304,544,16,6,88,668,6,89,51,101,95,152,591,998,3,3399,188,0,1
1,15,2,2,2,0,0,0,2,0,0,0,0,0,0,0,0,0,0,0,0,1
1,15,8,5,5,0,0,3,8,0,0,0,0,0,0,0,0,0,0,0,0,1
1,15,14,8,8,0,0,6,14,0,0,0,0,0,0,0,0,0,0,0,0,1
1,15,6,4,4,0,0,2,6,0,0,0,0,0,0,0,0,0,0,0,0,1
1,15,6,4,4,0,0,2,6,1,2,1,2,3,3,2,4,0,2,0,0,1
1,15,7,5,5,0,0,2,7,0,0,0,0,0,0,0,0,0,0,0,0,1
1,15,10,6,6,0,0,4,10,0,0,0,0,0,0,0,0,0,0,0,0,1
1,15,1,1,1,0,0,0,1,0,0,0,0,0,0,0,0,0,0,0,0,1
1,15,14,10,10,0,0,4,14,1,1,1,1,2,2,0,2,0,1,0,0,1
1,15,46,26,30,3,0,12,49,3,6,3,6,9,9,20,28,1,42,2,0,1
2,51,127,75,83,2,11,30,129,4,14,7,14,18,21,61,87,2,175,9,0,1
2,51,652,304,544,16,6,88,668,6,89,51,101,95,152,591,998,3,3399,188,0,1
2,51,2,2,2,0,0,0,2,0,0,0,0,0,0,0,0,0,0,0,0,1
2,51,8,5,5,0,0,3,8,0,0,0,0,0,0,0,0,0,0,0,0,1
2,51,14,8,8,0,0,6,14,0,0,0,0,0,0,0,0,0,0,0,0,1
2,51,6,4,4,0,0,2,6,0,0,0,0,0,0,0,0,0,0,0,0,1
2,51,6,4,4,0,0,2,6,1,2,1,2,3,3,2,4,0,2,0,0,1
2,51,7,5,5,0,0,2,7,0,0,0,0,0,0,0,0,0,0,0,0,1
2,51,10,6,6,0,0,4,10,0,0,0,0,0,0,0,0,0,0,0,0,1
2,51,1,1,1,0,0,0,1,0,0,0,0,0,0,0,0,0,0,0,0,1
2,51,14,10,10,0,0,4,14,1,1,1,1,2,2,0,2,0,1,0,0,1
2,51,46,26,30,3,0,12,49,3,6,3,6,9,9,20,28,1,42,2,0,1
1,6,2,2,2,0,0,0,2,0,0,0,0,0,0,0,0,0,0,0,0,1
1,18,3,3,3,0,0,0,3,0,0,0,0,0,0,0,0,0,0,0,0,1
285,6294,72,33,56,0,4,12,72,1,1,1,1,2,2,0,2,0,1,0,0,0
285,6294,1454,835,1044,76,110,219,1530,17,275,158,296,292,454,2297,3718,9,34017,1889,1,0
89,3941,1020,354,843,12,15,144,1032,8,134,77,144,142,221,970,1580,4,6792,377,0,0
231,5436,722,423,573,19,0,135,741,12,172,101,199,184,300,1320,2257,6,15668,870,0,1
231,5436,1508,847,911,44,250,301,1552,14,148,88,169,162,257,1120,1886,7,15077,837,0,1
231,5436,722,423,573,19,0,135,741,12,172,101,199,184,300,1320,2257,6,15668,870,0,0
231,5436,1508,847,911,44,250,301,1552,14,148,88,169,162,257,1120,1886,7,15077,837,0,0
1,15,127,75,83,2,11,30,129,4,14,7,14,18,21,61,87,2,175,9,0,0
1,15,652,304,544,16,6,88,668,6,89,51,101,95,152,591,998,3,3399,188,0,0
1,15,2,2,2,0,0,0,2,0,0,0,0,0,0,0,0,0,0,0,0,0
1,15,8,5,5,0,0,3,8,0,0,0,0,0,0,0,0,0,0,0,0,0
1,15,14,8,8,0,0,6,14,0,0,0,0,0,0,0,0,0,0,0,0,0
1,15,6,4,4,0,0,2,6,0,0,0,0,0,0,0,0,0,0,0,0,0
1,15,6,4,4,0,0,2,6,1,2,1,2,3,3,2,4,0,2,0,0,0
1,15,7,5,5,0,0,2,7,0,0,0,0,0,0,0,0,0,0,0,0,0
1,15,10,6,6,0,0,4,10,0,0,0,0,0,0,0,0,0,0,0,0,0
1,15,1,1,1,0,0,0,1,0,0,0,0,0,0,0,0,0,0,0,0,0
1,15,14,10,10,0,0,4,14,1,1,1,1,2,2,0,2,0,1,0,0,0
1,15,46,26,30,3,0,12,49,3,6,3,6,9,9,20,28,1,42,2,0,0
2,51,127,75,83,2,11,30,129,4,14,7,14,18,21,61,87,2,175,9,0,0
2,51,652,304,544,16,6,88,668,6,89,51,101,95,152,591,998,3,3399,188,0,0
2,51,2,2,2,0,0,0,2,0,0,0,0,0,0,0,0,0,0,0,0,0
2,51,8,5,5,0,0,3,8,0,0,0,0,0,0,0,0,0,0,0,0,0
2,51,14,8,8,0,0,6,14,0,0,0,0,0,0,0,0,0,0,0,0,0
2,51,6,4,4,0,0,2,6,0,0,0,0,0,0,0,0,0,0,0,0,0
2,51,6,4,4,0,0,2,6,1,2,1,2,3,3,2,4,0,2,0,0,0
2,51,7,5,5,0,0,2,7,0,0,0,0,0,0,0,0,0,0,0,0,0
2,51,10,6,6,0,0,4,10,0,0,0,0,0,0,0,0,0,0,0,0,0
2,51,1,1,1,0,0,0,1,0,0,0,0,0,0,0,0,0,0,0,0,0
2,51,14,10,10,0,0,4,14,1,1,1,1,2,2,0,2,0,1,0,0,0
2,51,46,26,30,3,0,12,49,3,6,3,6,9,9,20,28,1,42,2,0,0
1,6,2,2,2,0,0,0,2,0,0,0,0,0,0,0,0,0,0,0,0,0
1,18,3,3,3,0,0,0,3,0,0,0,0,0,0,0,0,0,0,0,0,0
95,4640,1523,757,1297,19,12,193,1542,12,193,117,230,205,347,1508,2664,7,19053,1058,0,0
82,3159,1043,504,840,53,9,147,1096,9,180,112,198,189,310,1377,2344,4,11604,644,0,0
240,5520,4293,999,3693,19,54,507,4312,9,155,88,170,164,258,1156,1898,4,9368,520,0,1
240,5520,1482,859,1002,125,135,219,1607,16,219,134,251,235,385,1766,3032,9,27804,1544,1,1
285,6299,72,33,56,0,4,12,72,1,1,1,1,2,2,0,2,0,1,0,0,1
285,6299,1454,835,1044,76,110,219,1530,17,275,158,296,292,454,2297,3718,9,34017,1889,1,1
98,4433,1338,495,1086,10,64,173,1348,11,122,82,157,133,239,883,1686,7,11934,663,0,1
240,5514,4293,999,3693,19,54,507,4312,9,155,88,170,164,258,1156,1898,4,9368,520,0,0
240,5514,1482,859,1002,125,135,219,1607,16,219,134,251,235,385,1766,3032,9,27804,1544,1,0
91,4019,1020,354,843,12,15,144,1032,8,134,77,144,142,221,970,1580,4,6792,377,0,0
285,6299,72,33,56,0,4,12,72,1,1,1,1,2,2,0,2,0,1,0,0,0
285,6299,1454,835,1044,76,110,219,1530,17,275,158,296,292,454,2297,3718,9,34017,1889,1,0
98,4433,1338,495,1086,10,64,173,1348,11,122,82,157,133,239,883,1686,7,11934,663,0,0
173,7581,139,89,101,2,0,35,141,7,54,34,62,61,96,330,569,4,2287,127,0,0
173,7581,7,5,5,0,0,2,7,1,2,1,2,3,3,2,4,0,2,0,0,0
173,7528,139,89,101,2,0,35,141,7,54,34,62,61,96,330,569,4,2287,127,0,1
173,7528,7,5,5,0,0,2,7,1,2,1,2,3,3,2,4,0,2,0,0,1
173,7537,139,89,101,2,0,35,141,7,54,34,62,61,96,330,569,4,2287,127,0,1
173,7537,7,5,5,0,0,2,7,1,2,1,2,3,3,2,4,0,2,0,0,1
173,7537,139,89,101,2,0,35,141,7,54,34,62,61,96,330,569,4,2287,127,0,0
173,7537,7,5,5,0,0,2,7,1,2,1,2,3,3,2,4,0,2,0,0,0
236,5588,722,423,573,19,0,135,741,12,172,101,199,184,300,1320,2257,6,15668,870,0,1
236,5588,1508,847,911,44,250,301,1552,14,148,88,169,162,257,1120,1886,7,15077,837,0,1
1,26,127,75,83,2,11,30,129,4,14,7,14,18,21,61,87,2,175,9,0,1
1,26,652,304,544,16,6,88,668,6,89,51,101,95,152,591,998,3,3399,188,0,1
1,26,2,2,2,0,0,0,2,0,0,0,0,0,0,0,0,0,0,0,0,1
1,26,8,5,5,0,0,3,8,0,0,0,0,0,0,0,0,0,0,0,0,1
1,26,14,8,8,0,0,6,14,0,0,0,0,0,0,0,0,0,0,0,0,1
1,26,6,4,4,0,0,2,6,0,0,0,0,0,0,0,0,0,0,0,0,1
1,26,6,4,4,0,0,2,6,1,2,1,2,3,3,2,4,0,2,0,0,1
1,26,7,5,5,0,0,2,7,0,0,0,0,0,0,0,0,0,0,0,0,1
1,26,10,6,6,0,0,4,10,0,0,0,0,0,0,0,0,0,0,0,0,1
1,26,1,1,1,0,0,0,1,0,0,0,0,0,0,0,0,0,0,0,0,1
1,26,14,10,10,0,0,4,14,1,1,1,1,2,2,0,2,0,1,0,0,1
1,26,46,26,30,3,0,12,49,3,6,3,6,9,9,20,28,1,42,2,0,1
1,7,2,2,2,0,0,0,2,0,0,0,0,0,0,0,0,0,0,0,0,1
1,20,127,75,83,2,11,30,129,4,14,7,14,18,21,61,87,2,175,9,0,1
1,20,652,304,544,16,6,88,668,6,89,51,101,95,152,591,998,3,3399,188,0,1
1,20,2,2,2,0,0,0,2,0,0,0,0,0,0,0,0,0,0,0,0,1
1,20,8,5,5,0,0,3,8,0,0,0,0,0,0,0,0,0,0,0,0,1
1,20,14,8,8,0,0,6,14,0,0,0,0,0,0,0,0,0,0,0,0,1
1,20,6,4,4,0,0,2,6,0,0,0,0,0,0,0,0,0,0,0,0,1
1,20,6,4,4,0,0,2,6,1,2,1,2,3,3,2,4,0,2,0,0,1
1,20,7,5,5,0,0,2,7,0,0,0,0,0,0,0,0,0,0,0,0,1
1,20,10,6,6,0,0,4,10,0,0,0,0,0,0,0,0,0,0,0,0,1
1,20,1,1,1,0,0,0,1,0,0,0,0,0,0,0,0,0,0,0,0,1
1,20,14,10,10,0,0,4,14,1,1,1,1,2,2,0,2,0,1,0,0,1
1,20,46,26,30,3,0,12,49,3,6,3,6,9,9,20,28,1,42,2,0,1
1,13,127,75,83,2,11,30,129,4,14,7,14,18,21,61,87,2,175,9,0,1
1,13,652,304,544,16,6,88,668,6,89,51,101,95,152,591,998,3,3399,188,0,1
1,13,2,2,2,0,0,0,2,0,0,0,0,0,0,0,0,0,0,0,0,1
1,13,8,5,5,0,0,3,8,0,0,0,0,0,0,0,0,0,0,0,0,1
1,13,14,8,8,0,0,6,14,0,0,0,0,0,0,0,0,0,0,0,0,1
1,13,6,4,4,0,0,2,6,0,0,0,0,0,0,0,0,0,0,0,0,1
1,13,6,4,4,0,0,2,6,1,2,1,2,3,3,2,4,0,2,0,0,1
1,13,7,5,5,0,0,2,7,0,0,0,0,0,0,0,0,0,0,0,0,1
1,13,10,6,6,0,0,4,10,0,0,0,0,0,0,0,0,0,0,0,0,1
1,13,1,1,1,0,0,0,1,0,0,0,0,0,0,0,0,0,0,0,0,1
1,13,14,10,10,0,0,4,14,1,1,1,1,2,2,0,2,0,1,0,0,1
1,13,46,26,30,3,0,12,49,3,6,3,6,9,9,20,28,1,42,2,0,1
1,16,127,75,83,2,11,30,129,4,14,7,14,18,21,61,87,2,175,9,0,1
1,16,652,304,544,16,6,88,668,6,89,51,101,95,152,591,998,3,3399,188,0,1
1,16,2,2,2,0,0,0,2,0,0,0,0,0,0,0,0,0,0,0,0,1
1,16,8,5,5,0,0,3,8,0,0,0,0,0,0,0,0,0,0,0,0,1
1,16,14,8,8,0,0,6,14,0,0,0,0,0,0,0,0,0,0,0,0,1
1,16,6,4,4,0,0,2,6,0,0,0,0,0,0,0,0,0,0,0,0,1
1,16,6,4,4,0,0,2,6,1,2,1,2,3,3,2,4,0,2,0,0,1
1,16,7,5,5,0,0,2,7,0,0,0,0,0,0,0,0,0,0,0,0,1
1,16,10,6,6,0,0,4,10,0,0,0,0,0,0,0,0,0,0,0,0,1
1,16,1,1,1,0,0,0,1,0,0,0,0,0,0,0,0,0,0,0,0,1
1,16,14,10,10,0,0,4,14,1,1,1,1,2,2,0,2,0,1,0,0,1
1,16,46,26,30,3,0,12,49,3,6,3,6,9,9,20,28,1,42,2,0,1
1,10,2,2,2,0,0,0,2,1,2,1,2,3,3,2,4,0,2,0,0,1
2,26,10,6,6,0,0,4,10,2,4,2,4,6,6,10,15,1,15,0,0,1
3,47,15,10,10,0,0,5,15,2,4,2,4,6,6,10,15,1,15,0,0,1
3,39,15,9,9,0,0,6,15,0,0,0,0,0,0,0,0,0,0,0,0,1
2,36,10,7,7,0,0,3,10,1,2,1,2,3,3,2,4,0,2,0,0,1
3,46,15,9,9,0,0,6,15,1,4,2,4,5,6,8,13,0,6,0,0,1
2,21,10,6,6,0,0,4,10,0,0,0,0,0,0,0,0,0,0,0,0,1
173,7444,139,89,101,2,0,35,141,7,54,34,62,61,96,330,569,4,2287,127,0,1
173,7444,7,5,5,0,0,2,7,1,2,1,2,3,3,2,4,0,2,0,0,1
84,1794,402,202,227,24,74,80,426,12,52,33,61,64,94,339,564,7,3969,220,0,0
92,3984,1020,354,843,12,15,144,1032,8,134,77,144,142,221,970,1580,4,6792,377,0,0
86,2229,773,422,505,30,103,129,803,14,77,46,83,91,129,535,839,7,6334,351,0,0
32,2074,1157,318,931,29,22,177,1186,6,104,63,125,110,188,712,1274,3,4596,255,0,0
32,2078,1157,318,931,29,22,177,1186,6,104,63,125,110,188,712,1274,3,4596,255,0,0
32,2083,1157,318,931,29,22,177,1186,6,104,63,125,110,188,712,1274,3,4596,255,0,0
32,2079,1157,318,931,29,22,177,1186,6,104,63,125,110,188,712,1274,3,4596,255,0,0
32,938,339,213,244,17,9,65,356,10,42,26,48,52,74,259,421,5,2410,133,0,1
60,2660,1293,570,1093,25,15,163,1318,10,195,123,241,205,364,1516,2795,6,17273,959,0,1
32,948,339,213,244,17,9,65,356,10,42,26,48,52,74,259,421,5,2410,133,0,0
60,2660,1293,570,1093,25,15,163,1318,10,195,123,241,205,364,1516,2795,6,17273,959,0,0
33,960,339,213,244,17,9,65,356,10,42,26,48,52,74,259,421,5,2410,133,0,0
60,2658,1293,570,1093,25,15,163,1318,10,195,123,241,205,364,1516,2795,6,17273,959,0,0
33,961,339,213,244,17,9,65,356,10,42,26,48,52,74,259,421,5,2410,133,0,0
34,983,339,213,244,17,9,65,356,10,42,26,48,52,74,259,421,5,2410,133,0,1
61,2743,1293,570,1093,25,15,163,1318,10,195,123,241,205,364,1516,2795,6,17273,959,0,1
61,2743,1293,570,1093,25,15,163,1318,10,195,123,241,205,364,1516,2795,6,17273,959,0,0
61,2731,1293,570,1093,25,15,163,1318,10,195,123,241,205,364,1516,2795,6,17273,959,0,0
34,995,339,213,244,17,9,65,356,10,42,26,48,52,74,259,421,5,2410,133,0,0
88,2252,773,422,505,30,103,129,803,14,77,46,83,91,129,535,839,7,6334,351,0,0
94,4062,1020,354,843,12,15,144,1032,8,134,77,144,142,221,970,1580,4,6792,377,0,0
11,413,42,7,35,4,0,5,46,1,2,1,2,3,3,2,4,0,2,0,0,1
11,413,11,6,10,0,0,1,11,2,4,2,4,6,6,10,15,1,15,0,0,1
74,1693,996,429,845,24,10,117,1020,7,76,50,88,83,138,494,879,4,3565,198,0,1
74,1693,456,277,329,12,42,72,468,13,85,50,97,98,147,592,972,7,7212,400,0,1
58,1192,207,111,150,11,0,50,218,5,26,19,36,31,55,133,272,3,943,52,0,1
58,1192,410,198,237,31,55,97,441,11,63,38,72,74,110,414,683,6,4293,238,0,1
247,5639,4293,999,3693,19,54,507,4312,9,155,88,170,164,258,1156,1898,4,9368,520,0,1
247,5639,1482,859,1002,125,135,219,1607,16,219,134,251,235,385,1766,3032,9,27804,1544,1,1
88,2252,773,422,505,30,103,129,803,14,77,46,83,91,129,535,839,7,6334,351,0,1
140,3246,77,34,69,0,0,8,77,3,24,16,29,27,45,114,213,1,387,21,0,1
140,3246,712,438,573,51,9,84,763,14,102,71,128,116,199,733,1364,8,11988,666,0,1
84,1794,402,202,227,24,74,80,426,12,52,33,61,64,94,339,564,7,3969,220,0,1
74,1669,53,23,39,0,0,13,53,2,8,4,8,10,12,26,39,1,39,2,0,1
74,1669,515,298,307,33,80,99,548,12,63,44,77,75,121,419,753,7,5527,307,0,1
2,71,167,116,138,4,5,22,171,8,48,30,56,56,86,292,499,4,2330,129,0,1
310,6786,72,33,56,0,4,12,72,1,1,1,1,2,2,0,2,0,1,0,0,1
310,6786,1454,835,1044,76,110,219,1530,17,275,158,296,292,454,2297,3718,9,34017,1889,1,1
28,702,466,257,367,18,25,50,484,7,126,86,171,133,257,898,1813,4,8612,478,0,1
28,702,507,281,342,29,59,88,536,10,53,29,57,63,86,336,514,5,2764,153,0,1
90,1927,1043,504,840,53,9,147,1096,9,180,112,198,189,310,1377,2344,4,11604,644,0,1
90,1927,383,288,292,26,6,62,409,11,65,38,67,76,105,429,656,5,3719,206,0,1
8,263,51,25,36,0,0,15,51,3,11,6,12,14,18,42,68,1,112,6,0,1
15,703,139,89,101,2,0,35,141,7,54,34,62,61,96,330,569,4,2287,127,0,1
32,2079,1157,318,931,29,22,177,1186,6,104,63,125,110,188,712,1274,3,4596,255,0,1
174,7788,139,89,101,2,0,35,141,7,54,34,62,61,96,330,569,4,2287,127,0,1
174,7788,7,5,5,0,0,2,7,1,2,1,2,3,3,2,4,0,2,0,0,1
39,2966,996,429,845,24,10,117,1020,7,76,50,88,83,138,494,879,4,3565,198,0,1
73,3805,1296,573,1062,40,33,157,1336,8,201,118,231,209,349,1561,2689,4,12365,686,0,1
94,4062,1020,354,843,12,15,144,1032,8,134,77,144,142,221,970,1580,4,6792,377,0,1
247,5639,4293,999,3693,19,54,507,4312,9,155,88,170,164,258,1156,1898,4,9368,520,0,0
247,5639,1482,859,1002,125,135,219,1607,16,219,134,251,235,385,1766,3032,9,27804,1544,1,0
140,3246,77,34,69,0,0,8,77,3,24,16,29,27,45,114,213,1,387,21,0,0
140,3246,712,438,573,51,9,84,763,14,102,71,128,116,199,733,1364,8,11988,666,0,0
74,1669,53,23,39,0,0,13,53,2,8,4,8,10,12,26,39,1,39,2,0,0
74,1669,515,298,307,33,80,99,548,12,63,44,77,75,121,419,753,7,5527,307,0,0
310,6786,72,33,56,0,4,12,72,1,1,1,1,2,2,0,2,0,1,0,0,0
310,6786,1454,835,1044,76,110,219,1530,17,275,158,296,292,454,2297,3718,9,34017,1889,1,0
174,7788,139,89,101,2,0,35,141,7,54,34,62,61,96,330,569,4,2287,127,0,0
174,7788,7,5,5,0,0,2,7,1,2,1,2,3,3,2,4,0,2,0,0,0
73,3805,1296,573,1062,40,33,157,1336,8,201,118,231,209,349,1561,2689,4,12365,686,0,0
226,5282,722,423,573,19,0,135,741,12,172,101,199,184,300,1320,2257,6,15668,870,0,1
226,5282,1508,847,911,44,250,301,1552,14,148,88,169,162,257,1120,1886,7,15077,837,0,1
46,2234,722,423,573,19,0,135,741,12,172,101,199,184,300,1320,2257,6,15668,870,0,1
226,5282,722,423,573,19,0,135,741,12,172,101,199,184,300,1320,2257,6,15668,870,0,0
226,5282,1508,847,911,44,250,301,1552,14,148,88,169,162,257,1120,1886,7,15077,837,0,0
46,2234,722,423,573,19,0,135,741,12,172,101,199,184,300,1320,2257,6,15668,870,0,0
84,1801,773,419,590,28,0,166,801,10,204,113,217,214,330,1598,2554,5,13587,754,0,0
84,1801,421,273,302,44,34,57,465,17,81,59,107,98,166,583,1098,11,12329,684,0,0
125,5127,1513,682,1277,25,13,200,1538,11,199,116,219,210,335,1557,2584,6,15641,868,0,0
92,2959,773,419,590,28,0,166,801,10,204,113,217,214,330,1598,2554,5,13587,754,0,0
46,2233,722,423,573,19,0,135,741,12,172,101,199,184,300,1320,2257,6,15668,870,0,0
288,6363,72,33,56,0,4,12,72,1,1,1,1,2,2,0,2,0,1,0,0,0
288,6363,1454,835,1044,76,110,219,1530,17,275,158,296,292,454,2297,3718,9,34017,1889,1,0
86,1828,402,202,227,24,74,80,426,12,52,33,61,64,94,339,564,7,3969,220,0,0
287,6329,72,33,56,0,4,12,72,1,1,1,1,2,2,0,2,0,1,0,0,0
287,6329,1454,835,1044,76,110,219,1530,17,275,158,296,292,454,2297,3718,9,34017,1889,1,0
236,5588,722,423,573,19,0,135,741,12,172,101,199,184,300,1320,2257,6,15668,870,0,0
236,5588,1508,847,911,44,250,301,1552,14,148,88,169,162,257,1120,1886,7,15077,837,0,0
1,26,127,75,83,2,11,30,129,4,14,7,14,18,21,61,87,2,175,9,0,0
1,26,652,304,544,16,6,88,668,6,89,51,101,95,152,591,998,3,3399,188,0,0
1,26,2,2,2,0,0,0,2,0,0,0,0,0,0,0,0,0,0,0,0,0
1,26,8,5,5,0,0,3,8,0,0,0,0,0,0,0,0,0,0,0,0,0
1,26,14,8,8,0,0,6,14,0,0,0,0,0,0,0,0,0,0,0,0,0
1,26,6,4,4,0,0,2,6,0,0,0,0,0,0,0,0,0,0,0,0,0
1,26,6,4,4,0,0,2,6,1,2,1,2,3,3,2,4,0,2,0,0,0
1,26,7,5,5,0,0,2,7,0,0,0,0,0,0,0,0,0,0,0,0,0
1,26,10,6,6,0,0,4,10,0,0,0,0,0,0,0,0,0,0,0,0,0
1,26,1,1,1,0,0,0,1,0,0,0,0,0,0,0,0,0,0,0,0,0
1,26,14,10,10,0,0,4,14,1,1,1,1,2,2,0,2,0,1,0,0,0
1,26,46,26,30,3,0,12,49,3,6,3,6,9,9,20,28,1,42,2,0,0
1,7,2,2,2,0,0,0,2,0,0,0,0,0,0,0,0,0,0,0,0,0
1,20,127,75,83,2,11,30,129,4,14,7,14,18,21,61,87,2,175,9,0,0
1,20,652,304,544,16,6,88,668,6,89,51,101,95,152,591,998,3,3399,188,0,0
1,20,2,2,2,0,0,0,2,0,0,0,0,0,0,0,0,0,0,0,0,0
1,20,8,5,5,0,0,3,8,0,0,0,0,0,0,0,0,0,0,0,0,0
1,20,14,8,8,0,0,6,14,0,0,0,0,0,0,0,0,0,0,0,0,0
1,20,6,4,4,0,0,2,6,0,0,0,0,0,0,0,0,0,0,0,0,0
1,20,6,4,4,0,0,2,6,1,2,1,2,3,3,2,4,0,2,0,0,0
1,20,7,5,5,0,0,2,7,0,0,0,0,0,0,0,0,0,0,0,0,0
1,20,10,6,6,0,0,4,10,0,0,0,0,0,0,0,0,0,0,0,0,0
1,20,1,1,1,0,0,0,1,0,0,0,0,0,0,0,0,0,0,0,0,0
1,20,14,10,10,0,0,4,14,1,1,1,1,2,2,0,2,0,1,0,0,0
1,20,46,26,30,3,0,12,49,3,6,3,6,9,9,20,28,1,42,2,0,0
1,13,127,75,83,2,11,30,129,4,14,7,14,18,21,61,87,2,175,9,0,0
1,13,652,304,544,16,6,88,668,6,89,51,101,95,152,591,998,3,3399,188,0,0
1,13,2,2,2,0,0,0,2,0,0,0,0,0,0,0,0,0,0,0,0,0
1,13,8,5,5,0,0,3,8,0,0,0,0,0,0,0,0,0,0,0,0,0
1,13,14,8,8,0,0,6,14,0,0,0,0,0,0,0,0,0,0,0,0,0
1,13,6,4,4,0,0,2,6,0,0,0,0,0,0,0,0,0,0,0,0,0
1,13,6,4,4,0,0,2,6,1,2,1,2,3,3,2,4,0,2,0,0,0
1,13,7,5,5,0,0,2,7,0,0,0,0,0,0,0,0,0,0,0,0,0
1,13,10,6,6,0,0,4,10,0,0,0,0,0,0,0,0,0,0,0,0,0
1,13,1,1,1,0,0,0,1,0,0,0,0,0,0,0,0,0,0,0,0,0
1,13,14,10,10,0,0,4,14,1,1,1,1,2,2,0,2,0,1,0,0,0
1,13,46,26,30,3,0,12,49,3,6,3,6,9,9,20,28,1,42,2,0,0
1,16,127,75,83,2,11,30,129,4,14,7,14,18,21,61,87,2,175,9,0,0
1,16,652,304,544,16,6,88,668,6,89,51,101,95,152,591,998,3,3399,188,0,0
1,16,2,2,2,0,0,0,2,0,0,0,0,0,0,0,0,0,0,0,0,0
1,16,8,5,5,0,0,3,8,0,0,0,0,0,0,0,0,0,0,0,0,0
1,16,14,8,8,0,0,6,14,0,0,0,0,0,0,0,0,0,0,0,0,0
1,16,6,4,4,0,0,2,6,0,0,0,0,0,0,0,0,0,0,0,0,0
1,16,6,4,4,0,0,2,6,1,2,1,2,3,3,2,4,0,2,0,0,0
1,16,7,5,5,0,0,2,7,0,0,0,0,0,0,0,0,0,0,0,0,0
1,16,10,6,6,0,0,4,10,0,0,0,0,0,0,0,0,0,0,0,0,0
1,16,1,1,1,0,0,0,1,0,0,0,0,0,0,0,0,0,0,0,0,0
1,16,14,10,10,0,0,4,14,1,1,1,1,2,2,0,2,0,1,0,0,0
1,16,46,26,30,3,0,12,49,3,6,3,6,9,9,20,28,1,42,2,0,0
1,10,2,2,2,0,0,0,2,1,2,1,2,3,3,2,4,0,2,0,0,0
2,26,10,6,6,0,0,4,10,2,4,2,4,6,6,10,15,1,15,0,0,0
3,47,15,10,10,0,0,5,15,2,4,2,4,6,6,10,15,1,15,0,0,0
3,39,15,9,9,0,0,6,15,0,0,0,0,0,0,0,0,0,0,0,0,0
2,36,10,7,7,0,0,3,10,1,2,1,2,3,3,2,4,0,2,0,0,0
3,46,15,9,9,0,0,6,15,1,4,2,4,5,6,8,13,0,6,0,0,0
2,21,10,6,6,0,0,4,10,0,0,0,0,0,0,0,0,0,0,0,0,0
175,7644,139,89,101,2,0,35,141,7,54,34,62,61,96,330,569,4,2287,127,0,0
175,7644,7,5,5,0,0,2,7,1,2,1,2,3,3,2,4,0,2,0,0,0
12,509,124,78,88,2,3,26,126,4,13,7,13,17,20,56,81,2,163,9,0,1
86,1822,402,202,227,24,74,80,426,12,52,33,61,64,94,339,564,7,3969,220,0,1
214,4654,182,127,129,0,0,53,182,5,39,21,42,44,63,217,343,2,926,51,0,1
214,4654,1165,710,800,67,119,181,1232,18,243,153,282,261,435,2000,3492,10,36473,2026,1,1
75,1692,53,23,39,0,0,13,53,2,8,4,8,10,12,26,39,1,39,2,0,1
75,1692,515,298,307,33,80,99,548,12,63,44,77,75,121,419,753,7,5527,307,0,1
149,6994,1392,870,1177,35,17,170,1427,14,494,280,531,508,811,4473,7289,7,54850,3047,2,1
12,509,124,78,88,2,3,26,126,4,13,7,13,17,20,56,81,2,163,9,0,0
86,1822,402,202,227,24,74,80,426,12,52,33,61,64,94,339,564,7,3969,220,0,0
236,5564,722,423,573,19,0,135,741,12,172,101,199,184,300,1320,2257,6,15668,870,0,0
236,5564,1508,847,911,44,250,301,1552,14,148,88,169,162,257,1120,1886,7,15077,837,0,0
312,6821,72,33,56,0,4,12,72,1,1,1,1,2,2,0,2,0,1,0,0,0
312,6821,1454,835,1044,76,110,219,1530,17,275,158,296,292,454,2297,3718,9,34017,1889,1,0
214,4654,182,127,129,0,0,53,182,5,39,21,42,44,63,217,343,2,926,51,0,0
214,4654,1165,710,800,67,119,181,1232,18,243,153,282,261,435,2000,3492,10,36473,2026,1,0
75,1692,53,23,39,0,0,13,53,2,8,4,8,10,12,26,39,1,39,2,0,0
75,1692,515,298,307,33,80,99,548,12,63,44,77,75,121,419,753,7,5527,307,0,0
149,6994,1392,870,1177,35,17,170,1427,14,494,280,531,508,811,4473,7289,7,54850,3047,2,0
78,1609,757,253,292,73,244,162,830,13,61,38,67,74,105,409,651,7,4654,258,0,0
247,5655,4293,999,3693,19,54,507,4312,9,155,88,170,164,258,1156,1898,4,9368,520,0,1
247,5655,1482,859,1002,125,135,219,1607,16,219,134,251,235,385,1766,3032,9,27804,1544,1,1
248,5674,4293,999,3693,19,54,507,4312,9,155,88,170,164,258,1156,1898,4,9368,520,0,0
248,5674,1482,859,1002,125,135,219,1607,16,219,134,251,235,385,1766,3032,9,27804,1544,1,0
245,5645,4293,999,3693,19,54,507,4312,9,155,88,170,164,258,1156,1898,4,9368,520,0,0
245,5645,1482,859,1002,125,135,219,1607,16,219,134,251,235,385,1766,3032,9,27804,1544,1,0
57,3792,520,294,400,33,13,81,553,10,261,204,367,271,571,2128,4614,7,32445,1802,1,0
78,1602,757,253,292,73,244,162,830,13,61,38,67,74,105,409,651,7,4654,258,0,0
57,3898,520,294,400,33,13,81,553,10,261,204,367,271,571,2128,4614,7,32445,1802,1,0
58,1198,207,111,150,11,0,50,218,5,26,19,36,31,55,133,272,3,943,52,0,1
58,1198,410,198,237,31,55,97,441,11,63,38,72,74,110,414,683,6,4293,238,0,1
255,5847,4293,999,3693,19,54,507,4312,9,155,88,170,164,258,1156,1898,4,9368,520,0,1
255,5847,1482,859,1002,125,135,219,1607,16,219,134,251,235,385,1766,3032,9,27804,1544,1,1
237,5596,722,423,573,19,0,135,741,12,172,101,199,184,300,1320,2257,6,15668,870,0,1
237,5596,1508,847,911,44,250,301,1552,14,148,88,169,162,257,1120,1886,7,15077,837,0,1
17,774,75,38,59,1,3,12,76,2,4,2,4,6,6,10,15,1,15,0,0,1
1,41,7,5,5,0,0,2,7,1,2,1,2,3,3,2,4,0,2,0,0,1
175,7644,139,89,101,2,0,35,141,7,54,34,62,61,96,330,569,4,2287,127,0,1
175,7644,7,5,5,0,0,2,7,1,2,1,2,3,3,2,4,0,2,0,0,1
111,4178,1450,624,1228,12,26,181,1462,14,306,186,354,320,540,2580,4493,8,36391,2021,1,1
39,2321,652,304,544,16,6,88,668,6,89,51,101,95,152,591,998,3,3399,188,0,1
14,717,442,244,305,14,16,103,456,11,68,45,75,79,120,452,756,6,4588,254,0,1
139,5919,1782,648,1425,9,47,279,1791,8,171,97,189,179,286,1292,2140,4,9462,525,0,1
14,725,442,244,305,14,16,103,456,11,68,45,75,79,120,452,756,6,4588,254,0,0
79,1591,757,253,292,73,244,162,830,13,61,38,67,74,105,409,651,7,4654,258,0,0
58,1198,207,111,150,11,0,50,218,5,26,19,36,31,55,133,272,3,943,52,0,0
58,1198,410,198,237,31,55,97,441,11,63,38,72,74,110,414,683,6,4293,238,0,0
255,5847,4293,999,3693,19,54,507,4312,9,155,88,170,164,258,1156,1898,4,9368,520,0,0
255,5847,1482,859,1002,125,135,219,1607,16,219,134,251,235,385,1766,3032,9,27804,1544,1,0
17,774,75,38,59,1,3,12,76,2,4,2,4,6,6,10,15,1,15,0,0,0
1,41,7,5,5,0,0,2,7,1,2,1,2,3,3,2,4,0,2,0,0,0
139,5919,1782,648,1425,9,47,279,1791,8,171,97,189,179,286,1292,2140,4,9462,525,0,0
111,4178,1450,624,1228,12,26,181,1462,14,306,186,354,320,540,2580,4493,8,36391,2021,1,0
39,2321,652,304,544,16,6,88,668,6,89,51,101,95,152,591,998,3,3399,188,0,0
79,1593,757,253,292,73,244,162,830,13,61,38,67,74,105,409,651,7,4654,258,0,0
51,608,647,139,84,35,284,233,682,0,0,0,0,0,0,0,0,0,0,0,0,0
60,4055,520,294,400,33,13,81,553,10,261,204,367,271,571,2128,4614,7,32445,1802,1,0
62,4177,520,294,400,33,13,81,553,10,261,204,367,271,571,2128,4614,7,32445,1802,1,0
51,608,647,139,84,35,284,233,682,0,0,0,0,0,0,0,0,0,0,0,0,1
33,1892,384,251,317,7,8,52,391,11,70,44,84,81,128,467,811,6,5355,297,0,1
51,604,647,139,84,35,284,233,682,0,0,0,0,0,0,0,0,0,0,0,0,0
33,1892,384,251,317,7,8,52,391,11,70,44,84,81,128,467,811,6,5355,297,0,0
81,1607,757,253,292,73,244,162,830,13,61,38,67,74,105,409,651,7,4654,258,0,0
63,4221,520,294,400,33,13,81,553,10,261,204,367,271,571,2128,4614,7,32445,1802,1,0
81,1608,757,253,292,73,244,162,830,13,61,38,67,74,105,409,651,7,4654,258,0,0
92,1762,757,253,292,73,244,162,830,13,61,38,67,74,105,409,651,7,4654,258,0,0
64,4282,520,294,400,33,13,81,553,10,261,204,367,271,571,2128,4614,7,32445,1802,1,0
64,4283,520,294,400,33,13,81,553,10,261,204,367,271,571,2128,4614,7,32445,1802,1,0
92,1758,757,253,292,73,244,162,830,13,61,38,67,74,105,409,651,7,4654,258,0,0
2,36,127,75,83,2,11,30,129,4,14,7,14,18,21,61,87,2,175,9,0,0
2,36,652,304,544,16,6,88,668,6,89,51,101,95,152,591,998,3,3399,188,0,0
2,36,2,2,2,0,0,0,2,0,0,0,0,0,0,0,0,0,0,0,0,0
2,36,8,5,5,0,0,3,8,0,0,0,0,0,0,0,0,0,0,0,0,0
2,36,14,8,8,0,0,6,14,0,0,0,0,0,0,0,0,0,0,0,0,0
2,36,6,4,4,0,0,2,6,0,0,0,0,0,0,0,0,0,0,0,0,0
2,36,6,4,4,0,0,2,6,1,2,1,2,3,3,2,4,0,2,0,0,0
2,36,7,5,5,0,0,2,7,0,0,0,0,0,0,0,0,0,0,0,0,0
2,36,10,6,6,0,0,4,10,0,0,0,0,0,0,0,0,0,0,0,0,0
2,36,1,1,1,0,0,0,1,0,0,0,0,0,0,0,0,0,0,0,0,0
2,36,14,10,10,0,0,4,14,1,1,1,1,2,2,0,2,0,1,0,0,0
2,36,46,26,30,3,0,12,49,3,6,3,6,9,9,20,28,1,42,2,0,0
176,7674,139,89,101,2,0,35,141,7,54,34,62,61,96,330,569,4,2287,127,0,0
176,7674,7,5,5,0,0,2,7,1,2,1,2,3,3,2,4,0,2,0,0,0
141,3259,77,34,69,0,0,8,77,3,24,16,29,27,45,114,213,1,387,21,0,1
141,3259,712,438,573,51,9,84,763,14,102,71,128,116,199,733,1364,8,11988,666,0,1
92,1761,757,253,292,73,244,162,830,13,61,38,67,74,105,409,651,7,4654,258,0,0
75,1704,996,429,845,24,10,117,1020,7,76,50,88,83,138,494,879,4,3565,198,0,0
75,1704,456,277,329,12,42,72,468,13,85,50,97,98,147,592,972,7,7212,400,0,0
40,3026,996,429,845,24,10,117,1020,7,76,50,88,83,138,494,879,4,3565,198,0,0
93,1841,757,253,292,73,244,162,830,13,61,38,67,74,105,409,651,7,4654,258,0,0
63,4272,520,294,400,33,13,81,553,10,261,204,367,271,571,2128,4614,7,32445,1802,1,0
91,1827,757,253,292,73,244,162,830,13,61,38,67,74,105,409,651,7,4654,258,0,0
63,4320,520,294,400,33,13,81,553,10,261,204,367,271,571,2128,4614,7,32445,1802,1,0
79,1593,757,253,292,73,244,162,830,13,61,38,67,74,105,409,651,7,4654,258,0,1
79,1596,757,253,292,73,244,162,830,13,61,38,67,74,105,409,651,7,4654,258,0,0
63,1255,207,111,150,11,0,50,218,5,26,19,36,31,55,133,272,3,943,52,0,1
63,1255,410,198,237,31,55,97,441,11,63,38,72,74,110,414,683,6,4293,238,0,1
254,5825,4293,999,3693,19,54,507,4312,9,155,88,170,164,258,1156,1898,4,9368,520,0,1
254,5825,1482,859,1002,125,135,219,1607,16,219,134,251,235,385,1766,3032,9,27804,1544,1,1
164,5055,1660,832,1314,41,38,274,1701,20,312,209,395,332,604,2671,5058,12,64042,3557,1,1
164,5055,1057,646,719,113,100,145,1170,18,215,134,248,233,382,1740,3004,10,31186,1732,1,1
155,4396,1660,832,1314,41,38,274,1701,20,312,209,395,332,604,2671,5058,12,64042,3557,1,1
91,1830,757,253,292,73,244,162,830,13,61,38,67,74,105,409,651,7,4654,258,0,0
63,1255,207,111,150,11,0,50,218,5,26,19,36,31,55,133,272,3,943,52,0,0
63,1255,410,198,237,31,55,97,441,11,63,38,72,74,110,414,683,6,4293,238,0,0
254,5825,4293,999,3693,19,54,507,4312,9,155,88,170,164,258,1156,1898,4,9368,520,0,0
254,5825,1482,859,1002,125,135,219,1607,16,219,134,251,235,385,1766,3032,9,27804,1544,1,0
164,5055,1660,832,1314,41,38,274,1701,20,312,209,395,332,604,2671,5058,12,64042,3557,1,0
164,5055,1057,646,719,113,100,145,1170,18,215,134,248,233,382,1740,3004,10,31186,1732,1,0
155,4396,1660,832,1314,41,38,274,1701,20,312,209,395,332,604,2671,5058,12,64042,3557,1,0
141,3259,77,34,69,0,0,8,77,3,24,16,29,27,45,114,213,1,387,21,0,0
141,3259,712,438,573,51,9,84,763,14,102,71,128,116,199,733,1364,8,11988,666,0,0
1,8,127,75,83,2,11,30,129,4,14,7,14,18,21,61,87,2,175,9,0,0
1,8,652,304,544,16,6,88,668,6,89,51,101,95,152,591,998,3,3399,188,0,0
1,8,2,2,2,0,0,0,2,0,0,0,0,0,0,0,0,0,0,0,0,0
1,8,8,5,5,0,0,3,8,0,0,0,0,0,0,0,0,0,0,0,0,0
1,8,14,8,8,0,0,6,14,0,0,0,0,0,0,0,0,0,0,0,0,0
1,8,6,4,4,0,0,2,6,0,0,0,0,0,0,0,0,0,0,0,0,0
1,8,6,4,4,0,0,2,6,1,2,1,2,3,3,2,4,0,2,0,0,0
1,8,7,5,5,0,0,2,7,0,0,0,0,0,0,0,0,0,0,0,0,0
1,8,10,6,6,0,0,4,10,0,0,0,0,0,0,0,0,0,0,0,0,0
1,8,1,1,1,0,0,0,1,0,0,0,0,0,0,0,0,0,0,0,0,0
1,8,14,10,10,0,0,4,14,1,1,1,1,2,2,0,2,0,1,0,0,0
1,8,46,26,30,3,0,12,49,3,6,3,6,9,9,20,28,1,42,2,0,0
99,4460,1338,495,1086,10,64,173,1348,11,122,82,157,133,239,883,1686,7,11934,663,0,0
314,6831,72,33,56,0,4,12,72,1,1,1,1,2,2,0,2,0,1,0,0,1
314,6831,1454,835,1044,76,110,219,1530,17,275,158,296,292,454,2297,3718,9,34017,1889,1,1
64,1275,207,111,150,11,0,50,218,5,26,19,36,31,55,133,272,3,943,52,0,1
64,1275,410,198,237,31,55,97,441,11,63,38,72,74,110,414,683,6,4293,238,0,1
254,5830,4293,999,3693,19,54,507,4312,9,155,88,170,164,258,1156,1898,4,9368,520,0,1
254,5830,1482,859,1002,125,135,219,1607,16,219,134,251,235,385,1766,3032,9,27804,1544,1,1
93,3899,1289,550,1043,56,32,155,1345,10,167,93,185,177,278,1266,2075,5,11498,638,0,1
2,56,16,12,9,0,0,6,16,1,2,1,2,3,3,2,4,0,2,0,0,1
20,439,207,111,150,11,0,50,218,5,26,19,36,31,55,133,272,3,943,52,0,1
212,4563,2,2,2,0,0,0,2,0,0,0,0,0,0,0,0,0,0,0,0,1
212,4563,99,48,90,1,3,5,100,0,0,0,0,0,0,0,0,0,0,0,0,1
212,4563,8,5,5,2,0,1,10,0,0,0,0,0,0,0,0,0,0,0,0,1
212,4563,1217,716,841,84,126,174,1301,14,185,118,215,199,333,1446,2542,8,20687,1149,0,1
212,4563,160,89,115,0,13,31,160,7,15,11,17,22,28,78,124,3,495,27,0,1
212,4563,10,10,9,9,0,0,19,0,0,0,0,0,0,0,0,0,0,0,0,1
212,4563,173,84,99,8,29,36,181,5,12,7,13,17,20,54,81,2,221,12,0,1
212,4563,3,1,1,3,0,0,6,0,0,0,0,0,0,0,0,0,0,0,0,1
86,4507,1457,730,1242,11,6,188,1468,10,292,166,329,302,495,2424,4078,5,22973,1276,1,1
212,4563,2,2,2,0,0,0,2,0,0,0,0,0,0,0,0,0,0,0,0,0
212,4563,99,48,90,1,3,5,100,0,0,0,0,0,0,0,0,0,0,0,0,0
212,4563,8,5,5,2,0,1,10,0,0,0,0,0,0,0,0,0,0,0,0,0
212,4563,1217,716,841,84,126,174,1301,14,185,118,215,199,333,1446,2542,8,20687,1149,0,0
212,4563,160,89,115,0,13,31,160,7,15,11,17,22,28,78,124,3,495,27,0,0
212,4563,10,10,9,9,0,0,19,0,0,0,0,0,0,0,0,0,0,0,0,0
212,4563,173,84,99,8,29,36,181,5,12,7,13,17,20,54,81,2,221,12,0,0
212,4563,3,1,1,3,0,0,6,0,0,0,0,0,0,0,0,0,0,0,0,0
86,4507,1457,730,1242,11,6,188,1468,10,292,166,329,302,495,2424,4078,5,22973,1276,1,0
314,6831,72,33,56,0,4,12,72,1,1,1,1,2,2,0,2,0,1,0,0,0
314,6831,1454,835,1044,76,110,219,1530,17,275,158,296,292,454,2297,3718,9,34017,1889,1,0
213,4573,2,2,2,0,0,0,2,0,0,0,0,0,0,0,0,0,0,0,0,1
213,4573,99,48,90,1,3,5,100,0,0,0,0,0,0,0,0,0,0,0,0,1
213,4573,8,5,5,2,0,1,10,0,0,0,0,0,0,0,0,0,0,0,0,1
213,4573,1217,716,841,84,126,174,1301,14,185,118,215,199,333,1446,2542,8,20687,1149,0,1
213,4573,160,89,115,0,13,31,160,7,15,11,17,22,28,78,124,3,495,27,0,1
213,4573,10,10,9,9,0,0,19,0,0,0,0,0,0,0,0,0,0,0,0,1
213,4573,173,84,99,8,29,36,181,5,12,7,13,17,20,54,81,2,221,12,0,1
213,4573,3,1,1,3,0,0,6,0,0,0,0,0,0,0,0,0,0,0,0,1
27,965,74,35,59,1,0,14,75,3,14,7,14,17,21,58,85,1,128,7,0,1
27,965,245,125,200,5,7,34,250,7,30,17,34,37,51,166,265,3,1053,58,0,1
86,4564,1457,730,1242,11,6,188,1468,10,292,166,329,302,495,2424,4078,5,22973,1276,1,1
50,1879,1098,241,925,5,10,155,1103,7,46,25,49,53,74,273,423,3,1580,87,0,0
213,4573,2,2,2,0,0,0,2,0,0,0,0,0,0,0,0,0,0,0,0,0
213,4573,99,48,90,1,3,5,100,0,0,0,0,0,0,0,0,0,0,0,0,0
213,4573,8,5,5,2,0,1,10,0,0,0,0,0,0,0,0,0,0,0,0,0
213,4573,1217,716,841,84,126,174,1301,14,185,118,215,199,333,1446,2542,8,20687,1149,0,0
213,4573,160,89,115,0,13,31,160,7,15,11,17,22,28,78,124,3,495,27,0,0
213,4573,10,10,9,9,0,0,19,0,0,0,0,0,0,0,0,0,0,0,0,0
213,4573,173,84,99,8,29,36,181,5,12,7,13,17,20,54,81,2,221,12,0,0
213,4573,3,1,1,3,0,0,6,0,0,0,0,0,0,0,0,0,0,0,0,0
27,965,74,35,59,1,0,14,75,3,14,7,14,17,21,58,85,1,128,7,0,0
27,965,245,125,200,5,7,34,250,7,30,17,34,37,51,166,265,3,1053,58,0,0
86,4564,1457,730,1242,11,6,188,1468,10,292,166,329,302,495,2424,4078,5,22973,1276,1,0
65,1299,207,111,150,11,0,50,218,5,26,19,36,31,55,133,272,3,943,52,0,0
65,1299,410,198,237,31,55,97,441,11,63,38,72,74,110,414,683,6,4293,238,0,0
254,5835,4293,999,3693,19,54,507,4312,9,155,88,170,164,258,1156,1898,4,9368,520,0,0
254,5835,1482,859,1002,125,135,219,1607,16,219,134,251,235,385,1766,3032,9,27804,1544,1,0
19,437,207,111,150,11,0,50,218,5,26,19,36,31,55,133,272,3,943,52,0,0
93,3899,1289,550,1043,56,32,155,1345,10,167,93,185,177,278,1266,2075,5,11498,638,0,0
2,56,16,12,9,0,0,6,16,1,2,1,2,3,3,2,4,0,2,0,0,0
314,6843,72,33,56,0,4,12,72,1,1,1,1,2,2,0,2,0,1,0,0,0
314,6843,1454,835,1044,76,110,219,1530,17,275,158,296,292,454,2297,3718,9,34017,1889,1,0
141,3263,77,34,69,0,0,8,77,3,24,16,29,27,45,114,213,1,387,21,0,0
141,3263,712,438,573,51,9,84,763,14,102,71,128,116,199,733,1364,8,11988,666,0,0
309,6791,72,33,56,0,4,12,72,1,1,1,1,2,2,0,2,0,1,0,0,1
309,6791,1454,835,1044,76,110,219,1530,17,275,158,296,292,454,2297,3718,9,34017,1889,1,1
73,3830,1296,573,1062,40,33,157,1336,8,201,118,231,209,349,1561,2689,4,12365,686,0,0
100,4602,1338,495,1086,10,64,173,1348,11,122,82,157,133,239,883,1686,7,11934,663,0,0
23,474,601,196,481,2,23,85,603,8,63,36,72,71,108,400,664,4,3036,168,0,1
23,474,156,79,106,5,16,28,161,5,14,8,15,19,23,64,97,2,261,14,0,1
20,707,601,196,481,2,23,85,603,8,63,36,72,71,108,400,664,4,3036,168,0,1
20,707,601,196,481,2,23,85,603,8,63,36,72,71,108,400,664,4,3036,168,0,0
23,474,601,196,481,2,23,85,603,8,63,36,72,71,108,400,664,4,3036,168,0,0
23,474,156,79,106,5,16,28,161,5,14,8,15,19,23,64,97,2,261,14,0,0
309,6791,72,33,56,0,4,12,72,1,1,1,1,2,2,0,2,0,1,0,0,0
309,6791,1454,835,1044,76,110,219,1530,17,275,158,296,292,454,2297,3718,9,34017,1889,1,0
215,4676,182,127,129,0,0,53,182,5,39,21,42,44,63,217,343,2,926,51,0,1
215,4676,1165,710,800,67,119,181,1232,18,243,153,282,261,435,2000,3492,10,36473,2026,1,1
152,7085,1392,870,1177,35,17,170,1427,14,494,280,531,508,811,4473,7289,7,54850,3047,2,1
215,4676,182,127,129,0,0,53,182,5,39,21,42,44,63,217,343,2,926,51,0,0
215,4676,1165,710,800,67,119,181,1232,18,243,153,282,261,435,2000,3492,10,36473,2026,1,0
152,7085,1392,870,1177,35,17,170,1427,14,494,280,531,508,811,4473,7289,7,54850,3047,2,0
126,5153,1513,682,1277,25,13,200,1538,11,199,116,219,210,335,1557,2584,6,15641,868,0,1
149,3076,1513,682,1277,25,13,200,1538,11,199,116,219,210,335,1557,2584,6,15641,868,0,1
149,3076,819,519,539,24,98,155,843,15,96,57,106,111,163,690,1107,8,9171,509,0,1
88,2266,773,422,505,30,103,129,803,14,77,46,83,91,129,535,839,7,6334,351,0,1
34,2119,1157,318,931,29,22,177,1186,6,104,63,125,110,188,712,1274,3,4596,255,0,0
126,5153,1513,682,1277,25,13,200,1538,11,199,116,219,210,335,1557,2584,6,15641,868,0,0
149,3116,1513,682,1277,25,13,200,1538,11,199,116,219,210,335,1557,2584,6,15641,868,0,1
149,3116,819,519,539,24,98,155,843,15,96,57,106,111,163,690,1107,8,9171,509,0,1
86,2245,773,422,505,30,103,129,803,14,77,46,83,91,129,535,839,7,6334,351,0,1
31,2079,1157,318,931,29,22,177,1186,6,104,63,125,110,188,712,1274,3,4596,255,0,1
254,5829,4293,999,3693,19,54,507,4312,9,155,88,170,164,258,1156,1898,4,9368,520,0,1
254,5829,1482,859,1002,125,135,219,1607,16,219,134,251,235,385,1766,3032,9,27804,1544,1,1
149,3083,1513,682,1277,25,13,200,1538,11,199,116,219,210,335,1557,2584,6,15641,868,0,1
149,3083,819,519,539,24,98,155,843,15,96,57,106,111,163,690,1107,8,9171,509,0,1
150,3111,1513,682,1277,25,13,200,1538,11,199,116,219,210,335,1557,2584,6,15641,868,0,1
150,3111,819,519,539,24,98,155,843,15,96,57,106,111,163,690,1107,8,9171,509,0,1
86,2238,773,422,505,30,103,129,803,14,77,46,83,91,129,535,839,7,6334,351,0,1
86,2240,773,422,505,30,103,129,803,14,77,46,83,91,129,535,839,7,6334,351,0,1
150,3126,1513,682,1277,25,13,200,1538,11,199,116,219,210,335,1557,2584,6,15641,868,0,1
150,3126,819,519,539,24,98,155,843,15,96,57,106,111,163,690,1107,8,9171,509,0,1
149,3115,1513,682,1277,25,13,200,1538,11,199,116,219,210,335,1557,2584,6,15641,868,0,1
149,3115,819,519,539,24,98,155,843,15,96,57,106,111,163,690,1107,8,9171,509,0,1
66,1312,207,111,150,11,0,50,218,5,26,19,36,31,55,133,272,3,943,52,0,1
66,1312,410,198,237,31,55,97,441,11,63,38,72,74,110,414,683,6,4293,238,0,1
85,2238,773,422,505,30,103,129,803,14,77,46,83,91,129,535,839,7,6334,351,0,1
254,5829,4293,999,3693,19,54,507,4312,9,155,88,170,164,258,1156,1898,4,9368,520,0,0
254,5829,1482,859,1002,125,135,219,1607,16,219,134,251,235,385,1766,3032,9,27804,1544,1,0
149,3116,1513,682,1277,25,13,200,1538,11,199,116,219,210,335,1557,2584,6,15641,868,0,0
149,3116,819,519,539,24,98,155,843,15,96,57,106,111,163,690,1107,8,9171,509,0,0
66,1312,207,111,150,11,0,50,218,5,26,19,36,31,55,133,272,3,943,52,0,0
66,1312,410,198,237,31,55,97,441,11,63,38,72,74,110,414,683,6,4293,238,0,0
85,2238,773,422,505,30,103,129,803,14,77,46,83,91,129,535,839,7,6334,351,0,0
31,2079,1157,318,931,29,22,177,1186,6,104,63,125,110,188,712,1274,3,4596,255,0,0
149,3110,1513,682,1277,25,13,200,1538,11,199,116,219,210,335,1557,2584,6,15641,868,0,0
149,3110,819,519,539,24,98,155,843,15,96,57,106,111,163,690,1107,8,9171,509,0,0
127,5180,1513,682,1277,25,13,200,1538,11,199,116,219,210,335,1557,2584,6,15641,868,0,0
149,3215,1513,682,1277,25,13,200,1538,11,199,116,219,210,335,1557,2584,6,15641,868,0,1
149,3215,819,519,539,24,98,155,843,15,96,57,106,111,163,690,1107,8,9171,509,0,1
127,5207,1513,682,1277,25,13,200,1538,11,199,116,219,210,335,1557,2584,6,15641,868,0,1
214,4585,2,2,2,0,0,0,2,0,0,0,0,0,0,0,0,0,0,0,0,0
214,4585,99,48,90,1,3,5,100,0,0,0,0,0,0,0,0,0,0,0,0,0
214,4585,8,5,5,2,0,1,10,0,0,0,0,0,0,0,0,0,0,0,0,0
214,4585,1217,716,841,84,126,174,1301,14,185,118,215,199,333,1446,2542,8,20687,1149,0,0
214,4585,160,89,115,0,13,31,160,7,15,11,17,22,28,78,124,3,495,27,0,0
214,4585,10,10,9,9,0,0,19,0,0,0,0,0,0,0,0,0,0,0,0,0
214,4585,173,84,99,8,29,36,181,5,12,7,13,17,20,54,81,2,221,12,0,0
214,4585,3,1,1,3,0,0,6,0,0,0,0,0,0,0,0,0,0,0,0,0
88,4633,1457,730,1242,11,6,188,1468,10,292,166,329,302,495,2424,4078,5,22973,1276,1,0
155,3182,1513,682,1277,25,13,200,1538,11,199,116,219,210,335,1557,2584,6,15641,868,0,1
155,3182,819,519,539,24,98,155,843,15,96,57,106,111,163,690,1107,8,9171,509,0,1
126,5159,1513,682,1277,25,13,200,1538,11,199,116,219,210,335,1557,2584,6,15641,868,0,0
126,5221,1513,682,1277,25,13,200,1538,11,199,116,219,210,335,1557,2584,6,15641,868,0,0
154,3165,1513,682,1277,25,13,200,1538,11,199,116,219,210,335,1557,2584,6,15641,868,0,0
154,3165,819,519,539,24,98,155,843,15,96,57,106,111,163,690,1107,8,9171,509,0,0
34,1000,339,213,244,17,9,65,356,10,42,26,48,52,74,259,421,5,2410,133,0,0
20,416,294,64,250,0,0,43,294,1,20,10,20,21,30,86,131,0,65,3,0,0
20,416,78,46,62,3,0,14,81,3,8,4,8,11,12,28,41,1,62,3,0,0
31,2071,1157,318,931,29,22,177,1186,6,104,63,125,110,188,712,1274,3,4596,255,0,0
126,5241,1513,682,1277,25,13,200,1538,11,199,116,219,210,335,1557,2584,6,15641,868,0,0
154,3163,1513,682,1277,25,13,200,1538,11,199,116,219,210,335,1557,2584,6,15641,868,0,0
154,3163,819,519,539,24,98,155,843,15,96,57,106,111,163,690,1107,8,9171,509,0,0
31,2065,1157,318,931,29,22,177,1186,6,104,63,125,110,188,712,1274,3,4596,255,0,0
236,5565,722,423,573,19,0,135,741,12,172,101,199,184,300,1320,2257,6,15668,870,0,0
236,5565,1508,847,911,44,250,301,1552,14,148,88,169,162,257,1120,1886,7,15077,837,0,0
236,5605,722,423,573,19,0,135,741,12,172,101,199,184,300,1320,2257,6,15668,870,0,1
236,5605,1508,847,911,44,250,301,1552,14,148,88,169,162,257,1120,1886,7,15077,837,0,1
49,2332,722,423,573,19,0,135,741,12,172,101,199,184,300,1320,2257,6,15668,870,0,1
127,5289,1513,682,1277,25,13,200,1538,11,199,116,219,210,335,1557,2584,6,15641,868,0,0
154,3163,1513,682,1277,25,13,200,1538,11,199,116,219,210,335,1557,2584,6,15641,868,0,1
154,3163,819,519,539,24,98,155,843,15,96,57,106,111,163,690,1107,8,9171,509,0,1
34,1000,339,213,244,17,9,65,356,10,42,26,48,52,74,259,421,5,2410,133,0,1
20,416,294,64,250,0,0,43,294,1,20,10,20,21,30,86,131,0,65,3,0,1
20,416,78,46,62,3,0,14,81,3,8,4,8,11,12,28,41,1,62,3,0,1
127,5289,1513,682,1277,25,13,200,1538,11,199,116,219,210,335,1557,2584,6,15641,868,0,1
149,3215,1513,682,1277,25,13,200,1538,11,199,116,219,210,335,1557,2584,6,15641,868,0,0
149,3215,819,519,539,24,98,155,843,15,96,57,106,111,163,690,1107,8,9171,509,0,0
127,5207,1513,682,1277,25,13,200,1538,11,199,116,219,210,335,1557,2584,6,15641,868,0,0
212,4578,1943,715,1694,26,18,214,1969,12,185,120,237,197,357,1436,2721,7,20915,1161,0,0
212,4578,1168,838,957,57,25,144,1225,19,348,224,416,367,640,3018,5452,11,61921,3440,1,0
92,4733,1943,715,1694,26,18,214,1969,12,185,120,237,197,357,1436,2721,7,20915,1161,0,0
236,5605,722,423,573,19,0,135,741,12,172,101,199,184,300,1320,2257,6,15668,870,0,0
236,5605,1508,847,911,44,250,301,1552,14,148,88,169,162,257,1120,1886,7,15077,837,0,0
49,2332,722,423,573,19,0,135,741,12,172,101,199,184,300,1320,2257,6,15668,870,0,0
154,3262,1513,682,1277,25,13,200,1538,11,199,116,219,210,335,1557,2584,6,15641,868,0,0
154,3262,819,519,539,24,98,155,843,15,96,57,106,111,163,690,1107,8,9171,509,0,0
128,5343,1513,682,1277,25,13,200,1538,11,199,116,219,210,335,1557,2584,6,15641,868,0,0
141,3269,77,34,69,0,0,8,77,3,24,16,29,27,45,114,213,1,387,21,0,0
141,3269,712,438,573,51,9,84,763,14,102,71,128,116,199,733,1364,8,11988,666,0,0
94,3940,1289,550,1043,56,32,155,1345,10,167,93,185,177,278,1266,2075,5,11498,638,0,0
235,5544,722,423,573,19,0,135,741,12,172,101,199,184,300,1320,2257,6,15668,870,0,0
235,5544,1508,847,911,44,250,301,1552,14,148,88,169,162,257,1120,1886,7,15077,837,0,0
47,2258,722,423,573,19,0,135,741,12,172,101,199,184,300,1320,2257,6,15668,870,0,1
47,2258,722,423,573,19,0,135,741,12,172,101,199,184,300,1320,2257,6,15668,870,0,0
96,1940,463,295,324,28,62,57,491,12,134,82,154,146,236,989,1696,6,11700,650,0,1
2,67,16,12,9,0,0,6,16,1,2,1,2,3,3,2,4,0,2,0,0,0
94,3942,1289,550,1043,56,32,155,1345,10,167,93,185,177,278,1266,2075,5,11498,638,0,1
152,7086,1392,870,1177,35,17,170,1427,14,494,280,531,508,811,4473,7289,7,54850,3047,2,1
23,579,102,59,69,5,3,24,107,6,22,15,28,28,43,113,206,3,789,43,0,1
155,4397,1660,832,1314,41,38,274,1701,20,312,209,395,332,604,2671,5058,12,64042,3557,1,1
61,2733,1293,570,1093,25,15,163,1318,10,195,123,241,205,364,1516,2795,6,17273,959,0,1
92,4735,1943,715,1694,26,18,214,1969,12,185,120,237,197,357,1436,2721,7,20915,1161,0,1
309,6803,72,33,56,0,4,12,72,1,1,1,1,2,2,0,2,0,1,0,0,0
309,6803,1454,835,1044,76,110,219,1530,17,275,158,296,292,454,2297,3718,9,34017,1889,1,0
312,6826,72,33,56,0,4,12,72,1,1,1,1,2,2,0,2,0,1,0,0,0
312,6826,1454,835,1044,76,110,219,1530,17,275,158,296,292,454,2297,3718,9,34017,1889,1,0
101,4715,1338,495,1086,10,64,173,1348,11,122,82,157,133,239,883,1686,7,11934,663,0,0
20,507,205,80,86,16,53,53,221,7,18,10,19,25,29,94,134,3,497,27,0,1
309,6789,72,33,56,0,4,12,72,1,1,1,1,2,2,0,2,0,1,0,0,1
309,6789,1454,835,1044,76,110,219,1530,17,275,158,296,292,454,2297,3718,9,34017,1889,1,1
36,1070,182,127,129,0,0,53,182,5,39,21,42,44,63,217,343,2,926,51,0,1
152,7069,1392,870,1177,35,17,170,1427,14,494,280,531,508,811,4473,7289,7,54850,3047,2,1
111,4132,1450,624,1228,12,26,181,1462,14,306,186,354,320,540,2580,4493,8,36391,2021,1,1
155,4385,1660,832,1314,41,38,274,1701,20,312,209,395,332,604,2671,5058,12,64042,3557,1,1
128,5327,1513,682,1277,25,13,200,1538,11,199,116,219,210,335,1557,2584,6,15641,868,0,1
95,4632,1523,757,1297,19,12,193,1542,12,193,117,230,205,347,1508,2664,7,19053,1058,0,1
60,1079,282,196,195,3,0,86,285,8,130,71,141,138,212,936,1507,4,6538,363,0,0
164,5053,1660,832,1314,41,38,274,1701,20,312,209,395,332,604,2671,5058,12,64042,3557,1,0
164,5053,1057,646,719,113,100,145,1170,18,215,134,248,233,382,1740,3004,10,31186,1732,1,0
91,1828,757,253,292,73,244,162,830,13,61,38,67,74,105,409,651,7,4654,258,0,0
46,952,386,256,301,16,9,68,402,4,59,35,69,63,104,355,621,2,1453,80,0,0
46,952,264,131,164,11,41,46,275,6,38,22,40,44,62,214,338,3,1068,59,0,0
92,2955,773,419,590,28,0,166,801,10,204,113,217,214,330,1598,2554,5,13587,754,0,0
155,4385,1660,832,1314,41,38,274,1701,20,312,209,395,332,604,2671,5058,12,64042,3557,1,0
111,4132,1450,624,1228,12,26,181,1462,14,306,186,354,320,540,2580,4493,8,36391,2021,1,0
90,1921,1043,504,840,53,9,147,1096,9,180,112,198,189,310,1377,2344,4,11604,644,0,0
90,1921,383,288,292,26,6,62,409,11,65,38,67,76,105,429,656,5,3719,206,0,0
152,7067,1392,870,1177,35,17,170,1427,14,494,280,531,508,811,4473,7289,7,54850,3047,2,0
20,507,205,80,86,16,53,53,221,7,18,10,19,25,29,94,134,3,497,27,0,0
309,6789,72,33,56,0,4,12,72,1,1,1,1,2,2,0,2,0,1,0,0,0
309,6789,1454,835,1044,76,110,219,1530,17,275,158,296,292,454,2297,3718,9,34017,1889,1,0
36,1070,182,127,129,0,0,53,182,5,39,21,42,44,63,217,343,2,926,51,0,0
139,5902,1782,648,1425,9,47,279,1791,8,171,97,189,179,286,1292,2140,4,9462,525,0,0
128,5327,1513,682,1277,25,13,200,1538,11,199,116,219,210,335,1557,2584,6,15641,868,0,0
95,4632,1523,757,1297,19,12,193,1542,12,193,117,230,205,347,1508,2664,7,19053,1058,0,0
94,3936,1289,550,1043,56,32,155,1345,10,167,93,185,177,278,1266,2075,5,11498,638,0,0
35,1052,182,127,129,0,0,53,182,5,39,21,42,44,63,217,343,2,926,51,0,0
152,7065,1392,870,1177,35,17,170,1427,14,494,280,531,508,811,4473,7289,7,54850,3047,2,0
100,4589,1338,495,1086,10,64,173,1348,11,122,82,157,133,239,883,1686,7,11934,663,0,0
176,7684,139,89,101,2,0,35,141,7,54,34,62,61,96,330,569,4,2287,127,0,0
176,7684,7,5,5,0,0,2,7,1,2,1,2,3,3,2,4,0,2,0,0,0
139,5896,1782,648,1425,9,47,279,1791,8,171,97,189,179,286,1292,2140,4,9462,525,0,0
155,4383,1660,832,1314,41,38,274,1701,20,312,209,395,332,604,2671,5058,12,64042,3557,1,0
40,3016,996,429,845,24,10,117,1020,7,76,50,88,83,138,494,879,4,3565,198,0,0
128,5326,1513,682,1277,25,13,200,1538,11,199,116,219,210,335,1557,2584,6,15641,868,0,0
73,3826,1296,573,1062,40,33,157,1336,8,201,118,231,209,349,1561,2689,4,12365,686,0,0
86,4499,1457,730,1242,11,6,188,1468,10,292,166,329,302,495,2424,4078,5,22973,1276,1,0
39,2317,652,304,544,16,6,88,668,6,89,51,101,95,152,591,998,3,3399,188,0,0
70,3204,1455,414,1257,16,76,112,1471,5,41,23,46,46,69,231,381,2,1069,59,0,0
92,4727,1943,715,1694,26,18,214,1969,12,185,120,237,197,357,1436,2721,7,20915,1161,0,0
96,1940,463,295,324,28,62,57,491,12,134,82,154,146,236,989,1696,6,11700,650,0,0
94,3938,1289,550,1043,56,32,155,1345,10,167,93,185,177,278,1266,2075,5,11498,638,0,0
152,7066,1392,870,1177,35,17,170,1427,14,494,280,531,508,811,4473,7289,7,54850,3047,2,0
23,579,102,59,69,5,3,24,107,6,22,15,28,28,43,113,206,3,789,43,0,0
155,4384,1660,832,1314,41,38,274,1701,20,312,209,395,332,604,2671,5058,12,64042,3557,1,0
61,2733,1293,570,1093,25,15,163,1318,10,195,123,241,205,364,1516,2795,6,17273,959,0,0
92,4729,1943,715,1694,26,18,214,1969,12,185,120,237,197,357,1436,2721,7,20915,1161,0,0
164,5047,1660,832,1314,41,38,274,1701,20,312,209,395,332,604,2671,5058,12,64042,3557,1,1
164,5047,1057,646,719,113,100,145,1170,18,215,134,248,233,382,1740,3004,10,31186,1732,1,1
89,1826,477,336,357,30,23,73,507,16,194,134,250,210,384,1538,2962,10,30538,1696,0,1
128,5324,1513,682,1277,25,13,200,1538,11,199,116,219,210,335,1557,2584,6,15641,868,0,1
312,6826,72,33,56,0,4,12,72,1,1,1,1,2,2,0,2,0,1,0,0,1
312,6826,1454,835,1044,76,110,219,1530,17,275,158,296,292,454,2297,3718,9,34017,1889,1,1
177,7801,139,89,101,2,0,35,141,7,54,34,62,61,96,330,569,4,2287,127,0,1
177,7801,7,5,5,0,0,2,7,1,2,1,2,3,3,2,4,0,2,0,0,1
211,4632,1943,715,1694,26,18,214,1969,12,185,120,237,197,357,1436,2721,7,20915,1161,0,1
211,4632,1168,838,957,57,25,144,1225,19,348,224,416,367,640,3018,5452,11,61921,3440,1,1
94,4715,1943,715,1694,26,18,214,1969,12,185,120,237,197,357,1436,2721,7,20915,1161,0,1
312,6828,72,33,56,0,4,12,72,1,1,1,1,2,2,0,2,0,1,0,0,1
312,6828,1454,835,1044,76,110,219,1530,17,275,158,296,292,454,2297,3718,9,34017,1889,1,1
164,5047,1660,832,1314,41,38,274,1701,20,312,209,395,332,604,2671,5058,12,64042,3557,1,0
164,5047,1057,646,719,113,100,145,1170,18,215,134,248,233,382,1740,3004,10,31186,1732,1,0
89,1826,477,336,357,30,23,73,507,16,194,134,250,210,384,1538,2962,10,30538,1696,0,0
128,5324,1513,682,1277,25,13,200,1538,11,199,116,219,210,335,1557,2584,6,15641,868,0,0
101,4702,1338,495,1086,10,64,173,1348,11,122,82,157,133,239,883,1686,7,11934,663,0,0
177,7811,139,89,101,2,0,35,141,7,54,34,62,61,96,330,569,4,2287,127,0,0
177,7811,7,5,5,0,0,2,7,1,2,1,2,3,3,2,4,0,2,0,0,0
177,7819,139,89,101,2,0,35,141,7,54,34,62,61,96,330,569,4,2287,127,0,0
177,7819,7,5,5,0,0,2,7,1,2,1,2,3,3,2,4,0,2,0,0,0
101,4691,1338,495,1086,10,64,173,1348,11,122,82,157,133,239,883,1686,7,11934,663,0,0
254,5822,4293,999,3693,19,54,507,4312,9,155,88,170,164,258,1156,1898,4,9368,520,0,0
254,5822,1482,859,1002,125,135,219,1607,16,219,134,251,235,385,1766,3032,9,27804,1544,1,0
254,5820,4293,999,3693,19,54,507,4312,9,155,88,170,164,258,1156,1898,4,9368,520,0,0
254,5820,1482,859,1002,125,135,219,1607,16,219,134,251,235,385,1766,3032,9,27804,1544,1,0
235,5549,722,423,573,19,0,135,741,12,172,101,199,184,300,1320,2257,6,15668,870,0,0
235,5549,1508,847,911,44,250,301,1552,14,148,88,169,162,257,1120,1886,7,15077,837,0,0
315,6881,72,33,56,0,4,12,72,1,1,1,1,2,2,0,2,0,1,0,0,0
315,6881,1454,835,1044,76,110,219,1530,17,275,158,296,292,454,2297,3718,9,34017,1889,1,0
1,6,99,48,90,1,3,5,100,0,0,0,0,0,0,0,0,0,0,0,0,0
1,6,8,5,5,2,0,1,10,0,0,0,0,0,0,0,0,0,0,0,0,0
1,6,1217,716,841,84,126,174,1301,14,185,118,215,199,333,1446,2542,8,20687,1149,0,0
1,6,160,89,115,0,13,31,160,7,15,11,17,22,28,78,124,3,495,27,0,0
1,6,10,10,9,9,0,0,19,0,0,0,0,0,0,0,0,0,0,0,0,0
1,6,173,84,99,8,29,36,181,5,12,7,13,17,20,54,81,2,221,12,0,0
1,6,3,1,1,3,0,0,6,0,0,0,0,0,0,0,0,0,0,0,0,0
74,3868,1296,573,1062,40,33,157,1336,8,201,118,231,209,349,1561,2689,4,12365,686,0,0
33,1885,384,251,317,7,8,52,391,11,70,44,84,81,128,467,811,6,5355,297,0,0
39,1696,447,308,343,6,5,95,453,7,96,59,111,103,170,651,1136,4,4600,255,0,0
41,2010,722,423,573,19,0,135,741,12,172,101,199,184,300,1320,2257,6,15668,870,0,0
94,4731,1943,715,1694,26,18,214,1969,12,185,120,237,197,357,1436,2721,7,20915,1161,0,1
94,4721,1943,715,1694,26,18,214,1969,12,185,120,237,197,357,1436,2721,7,20915,1161,0,0
235,5590,722,423,573,19,0,135,741,12,172,101,199,184,300,1320,2257,6,15668,870,0,0
235,5590,1508,847,911,44,250,301,1552,14,148,88,169,162,257,1120,1886,7,15077,837,0,0
88,4625,1457,730,1242,11,6,188,1468,10,292,166,329,302,495,2424,4078,5,22973,1276,1,0
44,2109,722,423,573,19,0,135,741,12,172,101,199,184,300,1320,2257,6,15668,870,0,0
213,4582,1943,715,1694,26,18,214,1969,12,185,120,237,197,357,1436,2721,7,20915,1161,0,0
213,4582,1168,838,957,57,25,144,1225,19,348,224,416,367,640,3018,5452,11,61921,3440,1,0
96,4914,1943,715,1694,26,18,214,1969,12,185,120,237,197,357,1436,2721,7,20915,1161,0,0
76,1715,996,429,845,24,10,117,1020,7,76,50,88,83,138,494,879,4,3565,198,0,0
76,1715,456,277,329,12,42,72,468,13,85,50,97,98,147,592,972,7,7212,400,0,0
43,3113,996,429,845,24,10,117,1020,7,76,50,88,83,138,494,879,4,3565,198,0,0
35,1068,182,127,129,0,0,53,182,5,39,21,42,44,63,217,343,2,926,51,0,0
91,2944,773,419,590,28,0,166,801,10,204,113,217,214,330,1598,2554,5,13587,754,0,0
213,4683,1943,715,1694,26,18,214,1969,12,185,120,237,197,357,1436,2721,7,20915,1161,0,0
213,4683,1168,838,957,57,25,144,1225,19,348,224,416,367,640,3018,5452,11,61921,3440,1,0
85,2166,1455,414,1257,16,76,112,1471,5,41,23,46,46,69,231,381,2,1069,59,0,0
85,2166,669,365,481,22,61,110,691,15,103,63,122,118,185,747,1273,8,11311,628,0,0
177,7829,139,89,101,2,0,35,141,7,54,34,62,61,96,330,569,4,2287,127,0,0
177,7829,7,5,5,0,0,2,7,1,2,1,2,3,3,2,4,0,2,0,0,0
166,5073,1660,832,1314,41,38,274,1701,20,312,209,395,332,604,2671,5058,12,64042,3557,1,0
166,5073,1057,646,719,113,100,145,1170,18,215,134,248,233,382,1740,3004,10,31186,1732,1,0
157,4508,1660,832,1314,41,38,274,1701,20,312,209,395,332,604,2671,5058,12,64042,3557,1,0
212,4659,1943,715,1694,26,18,214,1969,12,185,120,237,197,357,1436,2721,7,20915,1161,0,0
212,4659,1168,838,957,57,25,144,1225,19,348,224,416,367,640,3018,5452,11,61921,3440,1,0
215,4685,1943,715,1694,26,18,214,1969,12,185,120,237,197,357,1436,2721,7,20915,1161,0,0
215,4685,1168,838,957,57,25,144,1225,19,348,224,416,367,640,3018,5452,11,61921,3440,1,0
95,4853,1943,715,1694,26,18,214,1969,12,185,120,237,197,357,1436,2721,7,20915,1161,0,0
315,6882,72,33,56,0,4,12,72,1,1,1,1,2,2,0,2,0,1,0,0,0
315,6882,1454,835,1044,76,110,219,1530,17,275,158,296,292,454,2297,3718,9,34017,1889,1,0
75,1694,996,429,845,24,10,117,1020,7,76,50,88,83,138,494,879,4,3565,198,0,0
75,1694,456,277,329,12,42,72,468,13,85,50,97,98,147,592,972,7,7212,400,0,0
42,3095,996,429,845,24,10,117,1020,7,76,50,88,83,138,494,879,4,3565,198,0,0
76,1705,996,429,845,24,10,117,1020,7,76,50,88,83,138,494,879,4,3565,198,0,0
76,1705,456,277,329,12,42,72,468,13,85,50,97,98,147,592,972,7,7212,400,0,0
216,4689,1943,715,1694,26,18,214,1969,12,185,120,237,197,357,1436,2721,7,20915,1161,0,0
216,4689,1168,838,957,57,25,144,1225,19,348,224,416,367,640,3018,5452,11,61921,3440,1,0
45,3192,996,429,845,24,10,117,1020,7,76,50,88,83,138,494,879,4,3565,198,0,0
99,5038,1943,715,1694,26,18,214,1969,12,185,120,237,197,357,1436,2721,7,20915,1161,0,0
213,4576,1943,715,1694,26,18,214,1969,12,185,120,237,197,357,1436,2721,7,20915,1161,0,0
213,4576,1168,838,957,57,25,144,1225,19,348,224,416,367,640,3018,5452,11,61921,3440,1,0
215,4604,1943,715,1694,26,18,214,1969,12,185,120,237,197,357,1436,2721,7,20915,1161,0,0
215,4604,1168,838,957,57,25,144,1225,19,348,224,416,367,640,3018,5452,11,61921,3440,1,0
215,4602,1943,715,1694,26,18,214,1969,12,185,120,237,197,357,1436,2721,7,20915,1161,0,0
215,4602,1168,838,957,57,25,144,1225,19,348,224,416,367,640,3018,5452,11,61921,3440,1,0
43,3130,996,429,845,24,10,117,1020,7,76,50,88,83,138,494,879,4,3565,198,0,0
175,5294,1660,832,1314,41,38,274,1701,20,312,209,395,332,604,2671,5058,12,64042,3557,1,0
175,5294,1057,646,719,113,100,145,1170,18,215,134,248,233,382,1740,3004,10,31186,1732,1,0
141,3272,77,34,69,0,0,8,77,3,24,16,29,27,45,114,213,1,387,21,0,0
141,3272,712,438,573,51,9,84,763,14,102,71,128,116,199,733,1364,8,11988,666,0,0
179,5366,1660,832,1314,41,38,274,1701,20,312,209,395,332,604,2671,5058,12,64042,3557,1,0
179,5366,1057,646,719,113,100,145,1170,18,215,134,248,233,382,1740,3004,10,31186,1732,1,0
141,3279,77,34,69,0,0,8,77,3,24,16,29,27,45,114,213,1,387,21,0,0
141,3279,712,438,573,51,9,84,763,14,102,71,128,116,199,733,1364,8,11988,666,0,0
162,4813,1660,832,1314,41,38,274,1701,20,312,209,395,332,604,2671,5058,12,64042,3557,1,0
212,4569,2,2,2,0,0,0,2,0,0,0,0,0,0,0,0,0,0,0,0,0
212,4569,99,48,90,1,3,5,100,0,0,0,0,0,0,0,0,0,0,0,0,0
212,4569,8,5,5,2,0,1,10,0,0,0,0,0,0,0,0,0,0,0,0,0
212,4569,1217,716,841,84,126,174,1301,14,185,118,215,199,333,1446,2542,8,20687,1149,0,0
212,4569,160,89,115,0,13,31,160,7,15,11,17,22,28,78,124,3,495,27,0,0
212,4569,10,10,9,9,0,0,19,0,0,0,0,0,0,0,0,0,0,0,0,0
212,4569,173,84,99,8,29,36,181,5,12,7,13,17,20,54,81,2,221,12,0,0
212,4569,3,1,1,3,0,0,6,0,0,0,0,0,0,0,0,0,0,0,0,0
97,1999,463,295,324,28,62,57,491,12,134,82,154,146,236,989,1696,6,11700,650,0,0
95,3958,1289,550,1043,56,32,155,1345,10,167,93,185,177,278,1266,2075,5,11498,638,0,0
235,5582,722,423,573,19,0,135,741,12,172,101,199,184,300,1320,2257,6,15668,870,0,0
235,5582,1508,847,911,44,250,301,1552,14,148,88,169,162,257,1120,1886,7,15077,837,0,0
52,622,647,139,84,35,284,233,682,0,0,0,0,0,0,0,0,0,0,0,0,0
24,513,601,196,481,2,23,85,603,8,63,36,72,71,108,400,664,4,3036,168,0,0
24,513,156,79,106,5,16,28,161,5,14,8,15,19,23,64,97,2,261,14,0,0
22,807,601,196,481,2,23,85,603,8,63,36,72,71,108,400,664,4,3036,168,0,0
76,1707,53,23,39,0,0,13,53,2,8,4,8,10,12,26,39,1,39,2,0,0
76,1707,515,298,307,33,80,99,548,12,63,44,77,75,121,419,753,7,5527,307,0,0
216,4748,1943,715,1694,26,18,214,1969,12,185,120,237,197,357,1436,2721,7,20915,1161,0,0
216,4748,1168,838,957,57,25,144,1225,19,348,224,416,367,640,3018,5452,11,61921,3440,1,0
24,500,601,196,481,2,23,85,603,8,63,36,72,71,108,400,664,4,3036,168,0,0
24,500,156,79,106,5,16,28,161,5,14,8,15,19,23,64,97,2,261,14,0,0
314,6858,72,33,56,0,4,12,72,1,1,1,1,2,2,0,2,0,1,0,0,0
314,6858,1454,835,1044,76,110,219,1530,17,275,158,296,292,454,2297,3718,9,34017,1889,1,0
217,4757,1943,715,1694,26,18,214,1969,12,185,120,237,197,357,1436,2721,7,20915,1161,0,1
217,4757,1168,838,957,57,25,144,1225,19,348,224,416,367,640,3018,5452,11,61921,3440,1,1
26,557,601,196,481,2,23,85,603,8,63,36,72,71,108,400,664,4,3036,168,0,1
26,557,156,79,106,5,16,28,161,5,14,8,15,19,23,64,97,2,261,14,0,1
23,855,601,196,481,2,23,85,603,8,63,36,72,71,108,400,664,4,3036,168,0,1
79,1795,53,23,39,0,0,13,53,2,8,4,8,10,12,26,39,1,39,2,0,0
79,1795,515,298,307,33,80,99,548,12,63,44,77,75,121,419,753,7,5527,307,0,0
314,6864,72,33,56,0,4,12,72,1,1,1,1,2,2,0,2,0,1,0,0,0
314,6864,1454,835,1044,76,110,219,1530,17,275,158,296,292,454,2297,3718,9,34017,1889,1,0
217,4758,1943,715,1694,26,18,214,1969,12,185,120,237,197,357,1436,2721,7,20915,1161,0,0
217,4758,1168,838,957,57,25,144,1225,19,348,224,416,367,640,3018,5452,11,61921,3440,1,0
86,1832,402,202,227,24,74,80,426,12,52,33,61,64,94,339,564,7,3969,220,0,1
79,1799,53,23,39,0,0,13,53,2,8,4,8,10,12,26,39,1,39,2,0,1
79,1799,515,298,307,33,80,99,548,12,63,44,77,75,121,419,753,7,5527,307,0,1
314,6871,72,33,56,0,4,12,72,1,1,1,1,2,2,0,2,0,1,0,0,1
314,6871,1454,835,1044,76,110,219,1530,17,275,158,296,292,454,2297,3718,9,34017,1889,1,1
128,5332,1513,682,1277,25,13,200,1538,11,199,116,219,210,335,1557,2584,6,15641,868,0,1
214,4605,2,2,2,0,0,0,2,0,0,0,0,0,0,0,0,0,0,0,0,0
214,4605,99,48,90,1,3,5,100,0,0,0,0,0,0,0,0,0,0,0,0,0
214,4605,8,5,5,2,0,1,10,0,0,0,0,0,0,0,0,0,0,0,0,0
214,4605,1217,716,841,84,126,174,1301,14,185,118,215,199,333,1446,2542,8,20687,1149,0,0
214,4605,160,89,115,0,13,31,160,7,15,11,17,22,28,78,124,3,495,27,0,0
214,4605,10,10,9,9,0,0,19,0,0,0,0,0,0,0,0,0,0,0,0,0
214,4605,173,84,99,8,29,36,181,5,12,7,13,17,20,54,81,2,221,12,0,0
214,4605,3,1,1,3,0,0,6,0,0,0,0,0,0,0,0,0,0,0,0,0
87,1837,402,202,227,24,74,80,426,12,52,33,61,64,94,339,564,7,3969,220,0,0
315,6924,72,33,56,0,4,12,72,1,1,1,1,2,2,0,2,0,1,0,0,0
315,6924,1454,835,1044,76,110,219,1530,17,275,158,296,292,454,2297,3718,9,34017,1889,1,0
27,596,601,196,481,2,23,85,603,8,63,36,72,71,108,400,664,4,3036,168,0,0
27,596,156,79,106,5,16,28,161,5,14,8,15,19,23,64,97,2,261,14,0,0
20,864,75,38,59,1,3,12,76,2,4,2,4,6,6,10,15,1,15,0,0,0
136,5760,1782,648,1425,9,47,279,1791,8,171,97,189,179,286,1292,2140,4,9462,525,0,0
99,5044,1943,715,1694,26,18,214,1969,12,185,120,237,197,357,1436,2721,7,20915,1161,0,0
165,5078,1660,832,1314,41,38,274,1701,20,312,209,395,332,604,2671,5058,12,64042,3557,1,1
165,5078,1057,646,719,113,100,145,1170,18,215,134,248,233,382,1740,3004,10,31186,1732,1,1
76,1699,996,429,845,24,10,117,1020,7,76,50,88,83,138,494,879,4,3565,198,0,1
76,1699,456,277,329,12,42,72,468,13,85,50,97,98,147,592,972,7,7212,400,0,1
217,4679,2,2,2,0,0,0,2,0,0,0,0,0,0,0,0,0,0,0,0,1
217,4679,99,48,90,1,3,5,100,0,0,0,0,0,0,0,0,0,0,0,0,1
217,4679,8,5,5,2,0,1,10,0,0,0,0,0,0,0,0,0,0,0,0,1
217,4679,1217,716,841,84,126,174,1301,14,185,118,215,199,333,1446,2542,8,20687,1149,0,1
217,4679,160,89,115,0,13,31,160,7,15,11,17,22,28,78,124,3,495,27,0,1
217,4679,10,10,9,9,0,0,19,0,0,0,0,0,0,0,0,0,0,0,0,1
217,4679,173,84,99,8,29,36,181,5,12,7,13,17,20,54,81,2,221,12,0,1
217,4679,3,1,1,3,0,0,6,0,0,0,0,0,0,0,0,0,0,0,0,1
49,729,167,116,138,4,5,22,171,8,48,30,56,56,86,292,499,4,2330,129,0,1
254,5836,4293,999,3693,19,54,507,4312,9,155,88,170,164,258,1156,1898,4,9368,520,0,1
254,5836,1482,859,1002,125,135,219,1607,16,219,134,251,235,385,1766,3032,9,27804,1544,1,1
98,2668,1523,757,1297,19,12,193,1542,12,193,117,230,205,347,1508,2664,7,19053,1058,0,1
98,2668,701,378,504,33,58,109,734,13,110,68,126,123,194,794,1346,7,10027,557,0,1
80,1826,53,23,39,0,0,13,53,2,8,4,8,10,12,26,39,1,39,2,0,1
80,1826,515,298,307,33,80,99,548,12,63,44,77,75,121,419,753,7,5527,307,0,1
315,6944,72,33,56,0,4,12,72,1,1,1,1,2,2,0,2,0,1,0,0,1
315,6944,1454,835,1044,76,110,219,1530,17,275,158,296,292,454,2297,3718,9,34017,1889,1,1
30,658,215,129,180,6,0,29,221,8,65,43,72,73,115,415,711,4,3153,175,0,1
30,658,97,69,77,3,3,16,100,6,22,13,23,28,36,113,173,3,542,30,0,1
94,3940,1289,550,1043,56,32,155,1345,10,167,93,185,177,278,1266,2075,5,11498,638,0,1
20,968,75,38,59,1,3,12,76,2,4,2,4,6,6,10,15,1,15,0,0,1
101,4718,1338,495,1086,10,64,173,1348,11,122,82,157,133,239,883,1686,7,11934,663,0,1
136,5760,1782,648,1425,9,47,279,1791,8,171,97,189,179,286,1292,2140,4,9462,525,0,1
111,4139,1450,624,1228,12,26,181,1462,14,306,186,354,320,540,2580,4493,8,36391,2021,1,1
156,4476,1660,832,1314,41,38,274,1701,20,312,209,395,332,604,2671,5058,12,64042,3557,1,1
43,3139,996,429,845,24,10,117,1020,7,76,50,88,83,138,494,879,4,3565,198,0,1
90,4662,1457,730,1242,11,6,188,1468,10,292,166,329,302,495,2424,4078,5,22973,1276,1,1
95,4642,1523,757,1297,19,12,193,1542,12,193,117,230,205,347,1508,2664,7,19053,1058,0,1
16,1224,215,129,180,6,0,29,221,8,65,43,72,73,115,415,711,4,3153,175,0,1
217,4679,2,2,2,0,0,0,2,0,0,0,0,0,0,0,0,0,0,0,0,0
217,4679,99,48,90,1,3,5,100,0,0,0,0,0,0,0,0,0,0,0,0,0
217,4679,8,5,5,2,0,1,10,0,0,0,0,0,0,0,0,0,0,0,0,0
217,4679,1217,716,841,84,126,174,1301,14,185,118,215,199,333,1446,2542,8,20687,1149,0,0
217,4679,160,89,115,0,13,31,160,7,15,11,17,22,28,78,124,3,495,27,0,0
217,4679,10,10,9,9,0,0,19,0,0,0,0,0,0,0,0,0,0,0,0,0
217,4679,173,84,99,8,29,36,181,5,12,7,13,17,20,54,81,2,221,12,0,0
217,4679,3,1,1,3,0,0,6,0,0,0,0,0,0,0,0,0,0,0,0,0
315,6939,72,33,56,0,4,12,72,1,1,1,1,2,2,0,2,0,1,0,0,0
315,6939,1454,835,1044,76,110,219,1530,17,275,158,296,292,454,2297,3718,9,34017,1889,1,0
156,4472,1660,832,1314,41,38,274,1701,20,312,209,395,332,604,2671,5058,12,64042,3557,1,0
30,634,601,196,481,2,23,85,603,8,63,36,72,71,108,400,664,4,3036,168,0,0
30,634,156,79,106,5,16,28,161,5,14,8,15,19,23,64,97,2,261,14,0,0
102,4744,1338,495,1086,10,64,173,1348,11,122,82,157,133,239,883,1686,7,11934,663,0,0
29,1088,601,196,481,2,23,85,603,8,63,36,72,71,108,400,664,4,3036,168,0,0
33,1200,601,196,481,2,23,85,603,8,63,36,72,71,108,400,664,4,3036,168,0,0
217,4692,2,2,2,0,0,0,2,0,0,0,0,0,0,0,0,0,0,0,0,1
217,4692,99,48,90,1,3,5,100,0,0,0,0,0,0,0,0,0,0,0,0,1
217,4692,8,5,5,2,0,1,10,0,0,0,0,0,0,0,0,0,0,0,0,1
217,4692,1217,716,841,84,126,174,1301,14,185,118,215,199,333,1446,2542,8,20687,1149,0,1
217,4692,160,89,115,0,13,31,160,7,15,11,17,22,28,78,124,3,495,27,0,1
217,4692,10,10,9,9,0,0,19,0,0,0,0,0,0,0,0,0,0,0,0,1
217,4692,173,84,99,8,29,36,181,5,12,7,13,17,20,54,81,2,221,12,0,1
217,4692,3,1,1,3,0,0,6,0,0,0,0,0,0,0,0,0,0,0,0,1
51,767,167,116,138,4,5,22,171,8,48,30,56,56,86,292,499,4,2330,129,0,1
52,622,647,139,84,35,284,233,682,0,0,0,0,0,0,0,0,0,0,0,0,1
30,663,215,129,180,6,0,29,221,8,65,43,72,73,115,415,711,4,3153,175,0,1
30,663,97,69,77,3,3,16,100,6,22,13,23,28,36,113,173,3,542,30,0,1
31,704,601,196,481,2,23,85,603,8,63,36,72,71,108,400,664,4,3036,168,0,1
31,704,156,79,106,5,16,28,161,5,14,8,15,19,23,64,97,2,261,14,0,1
20,911,75,38,59,1,3,12,76,2,4,2,4,6,6,10,15,1,15,0,0,1
165,5086,1660,832,1314,41,38,274,1701,20,312,209,395,332,604,2671,5058,12,64042,3557,1,1
165,5086,1057,646,719,113,100,145,1170,18,215,134,248,233,382,1740,3004,10,31186,1732,1,1
98,2666,1523,757,1297,19,12,193,1542,12,193,117,230,205,347,1508,2664,7,19053,1058,0,1
98,2666,701,378,504,33,58,109,734,13,110,68,126,123,194,794,1346,7,10027,557,0,1
235,5586,722,423,573,19,0,135,741,12,172,101,199,184,300,1320,2257,6,15668,870,0,1
235,5586,1508,847,911,44,250,301,1552,14,148,88,169,162,257,1120,1886,7,15077,837,0,1
220,4815,1943,715,1694,26,18,214,1969,12,185,120,237,197,357,1436,2721,7,20915,1161,0,1
220,4815,1168,838,957,57,25,144,1225,19,348,224,416,367,640,3018,5452,11,61921,3440,1,1
156,4471,1660,832,1314,41,38,274,1701,20,312,209,395,332,604,2671,5058,12,64042,3557,1,1
95,4639,1523,757,1297,19,12,193,1542,12,193,117,230,205,347,1508,2664,7,19053,1058,0,1
33,1183,601,196,481,2,23,85,603,8,63,36,72,71,108,400,664,4,3036,168,0,1
235,5588,722,423,573,19,0,135,741,12,172,101,199,184,300,1320,2257,6,15668,870,0,0
235,5588,1508,847,911,44,250,301,1552,14,148,88,169,162,257,1120,1886,7,15077,837,0,0
1,54,37,13,25,0,6,6,37,1,2,1,2,3,3,2,4,0,2,0,0,0
1,54,133,47,40,1,43,49,134,0,0,0,0,0,0,0,0,0,0,0,0,0
31,704,601,196,481,2,23,85,603,8,63,36,72,71,108,400,664,4,3036,168,0,0
31,704,156,79,106,5,16,28,161,5,14,8,15,19,23,64,97,2,261,14,0,0
80,1826,53,23,39,0,0,13,53,2,8,4,8,10,12,26,39,1,39,2,0,0
80,1826,515,298,307,33,80,99,548,12,63,44,77,75,121,419,753,7,5527,307,0,0
165,5085,1660,832,1314,41,38,274,1701,20,312,209,395,332,604,2671,5058,12,64042,3557,1,0
165,5085,1057,646,719,113,100,145,1170,18,215,134,248,233,382,1740,3004,10,31186,1732,1,0
166,5096,1660,832,1314,41,38,274,1701,20,312,209,395,332,604,2671,5058,12,64042,3557,1,0
166,5096,1057,646,719,113,100,145,1170,18,215,134,248,233,382,1740,3004,10,31186,1732,1,0
111,4170,1450,624,1228,12,26,181,1462,14,306,186,354,320,540,2580,4493,8,36391,2021,1,0
76,1699,996,429,845,24,10,117,1020,7,76,50,88,83,138,494,879,4,3565,198,0,0
76,1699,456,277,329,12,42,72,468,13,85,50,97,98,147,592,972,7,7212,400,0,0
217,4683,2,2,2,0,0,0,2,0,0,0,0,0,0,0,0,0,0,0,0,1
217,4683,99,48,90,1,3,5,100,0,0,0,0,0,0,0,0,0,0,0,0,1
217,4683,8,5,5,2,0,1,10,0,0,0,0,0,0,0,0,0,0,0,0,1
217,4683,1217,716,841,84,126,174,1301,14,185,118,215,199,333,1446,2542,8,20687,1149,0,1
217,4683,160,89,115,0,13,31,160,7,15,11,17,22,28,78,124,3,495,27,0,1
217,4683,10,10,9,9,0,0,19,0,0,0,0,0,0,0,0,0,0,0,0,1
217,4683,173,84,99,8,29,36,181,5,12,7,13,17,20,54,81,2,221,12,0,1
217,4683,3,1,1,3,0,0,6,0,0,0,0,0,0,0,0,0,0,0,0,1
98,2660,1523,757,1297,19,12,193,1542,12,193,117,230,205,347,1508,2664,7,19053,1058,0,1
98,2660,701,378,504,33,58,109,734,13,110,68,126,123,194,794,1346,7,10027,557,0,1
87,1836,402,202,227,24,74,80,426,12,52,33,61,64,94,339,564,7,3969,220,0,1
80,1834,53,23,39,0,0,13,53,2,8,4,8,10,12,26,39,1,39,2,0,1
80,1834,515,298,307,33,80,99,548,12,63,44,77,75,121,419,753,7,5527,307,0,1
235,5585,722,423,573,19,0,135,741,12,172,101,199,184,300,1320,2257,6,15668,870,0,1
235,5585,1508,847,911,44,250,301,1552,14,148,88,169,162,257,1120,1886,7,15077,837,0,1
314,6932,72,33,56,0,4,12,72,1,1,1,1,2,2,0,2,0,1,0,0,1
314,6932,1454,835,1044,76,110,219,1530,17,275,158,296,292,454,2297,3718,9,34017,1889,1,1
1,62,37,13,25,0,6,6,37,1,2,1,2,3,3,2,4,0,2,0,0,1
1,62,133,47,40,1,43,49,134,0,0,0,0,0,0,0,0,0,0,0,0,1
31,716,601,196,481,2,23,85,603,8,63,36,72,71,108,400,664,4,3036,168,0,1
31,716,156,79,106,5,16,28,161,5,14,8,15,19,23,64,97,2,261,14,0,1
94,3938,1289,550,1043,56,32,155,1345,10,167,93,185,177,278,1266,2075,5,11498,638,0,1
20,918,75,38,59,1,3,12,76,2,4,2,4,6,6,10,15,1,15,0,0,1
136,5782,1782,648,1425,9,47,279,1791,8,171,97,189,179,286,1292,2140,4,9462,525,0,1
95,4080,1020,354,843,12,15,144,1032,8,134,77,144,142,221,970,1580,4,6792,377,0,1
2,145,53,23,39,0,0,13,53,2,8,4,8,10,12,26,39,1,39,2,0,1
31,712,601,196,481,2,23,85,603,8,63,36,72,71,108,400,664,4,3036,168,0,0
31,712,156,79,106,5,16,28,161,5,14,8,15,19,23,64,97,2,261,14,0,0
43,3157,996,429,845,24,10,117,1020,7,76,50,88,83,138,494,879,4,3565,198,0,1
43,3157,996,429,845,24,10,117,1020,7,76,50,88,83,138,494,879,4,3565,198,0,0
82,1862,53,23,39,0,0,13,53,2,8,4,8,10,12,26,39,1,39,2,0,1
82,1862,515,298,307,33,80,99,548,12,63,44,77,75,121,419,753,7,5527,307,0,1
33,814,601,196,481,2,23,85,603,8,63,36,72,71,108,400,664,4,3036,168,0,0
33,814,156,79,106,5,16,28,161,5,14,8,15,19,23,64,97,2,261,14,0,0
34,1230,601,196,481,2,23,85,603,8,63,36,72,71,108,400,664,4,3036,168,0,0
76,1714,996,429,845,24,10,117,1020,7,76,50,88,83,138,494,879,4,3565,198,0,0
76,1714,456,277,329,12,42,72,468,13,85,50,97,98,147,592,972,7,7212,400,0,0
166,5101,1660,832,1314,41,38,274,1701,20,312,209,395,332,604,2671,5058,12,64042,3557,1,1
166,5101,1057,646,719,113,100,145,1170,18,215,134,248,233,382,1740,3004,10,31186,1732,1,1
217,4685,2,2,2,0,0,0,2,0,0,0,0,0,0,0,0,0,0,0,0,1
217,4685,99,48,90,1,3,5,100,0,0,0,0,0,0,0,0,0,0,0,0,1
217,4685,8,5,5,2,0,1,10,0,0,0,0,0,0,0,0,0,0,0,0,1
217,4685,1217,716,841,84,126,174,1301,14,185,118,215,199,333,1446,2542,8,20687,1149,0,1
217,4685,160,89,115,0,13,31,160,7,15,11,17,22,28,78,124,3,495,27,0,1
217,4685,10,10,9,9,0,0,19,0,0,0,0,0,0,0,0,0,0,0,0,1
217,4685,173,84,99,8,29,36,181,5,12,7,13,17,20,54,81,2,221,12,0,1
217,4685,3,1,1,3,0,0,6,0,0,0,0,0,0,0,0,0,0,0,0,1
254,5841,4293,999,3693,19,54,507,4312,9,155,88,170,164,258,1156,1898,4,9368,520,0,1
254,5841,1482,859,1002,125,135,219,1607,16,219,134,251,235,385,1766,3032,9,27804,1544,1,1
314,6935,72,33,56,0,4,12,72,1,1,1,1,2,2,0,2,0,1,0,0,1
314,6935,1454,835,1044,76,110,219,1530,17,275,158,296,292,454,2297,3718,9,34017,1889,1,1
20,927,75,38,59,1,3,12,76,2,4,2,4,6,6,10,15,1,15,0,0,1
86,1893,53,23,39,0,0,13,53,2,8,4,8,10,12,26,39,1,39,2,0,0
86,1893,515,298,307,33,80,99,548,12,63,44,77,75,121,419,753,7,5527,307,0,0
92,4702,1457,730,1242,11,6,188,1468,10,292,166,329,302,495,2424,4078,5,22973,1276,1,0
313,6932,72,33,56,0,4,12,72,1,1,1,1,2,2,0,2,0,1,0,0,0
313,6932,1454,835,1044,76,110,219,1530,17,275,158,296,292,454,2297,3718,9,34017,1889,1,0
313,6930,72,33,56,0,4,12,72,1,1,1,1,2,2,0,2,0,1,0,0,0
313,6930,1454,835,1044,76,110,219,1530,17,275,158,296,292,454,2297,3718,9,34017,1889,1,0
136,5790,1782,648,1425,9,47,279,1791,8,171,97,189,179,286,1292,2140,4,9462,525,0,0
31,726,601,196,481,2,23,85,603,8,63,36,72,71,108,400,664,4,3036,168,0,0
31,726,156,79,106,5,16,28,161,5,14,8,15,19,23,64,97,2,261,14,0,0
39,1718,386,256,301,16,9,68,402,4,59,35,69,63,104,355,621,2,1453,80,0,0
136,5794,1782,648,1425,9,47,279,1791,8,171,97,189,179,286,1292,2140,4,9462,525,0,0
95,4101,1020,354,843,12,15,144,1032,8,134,77,144,142,221,970,1580,4,6792,377,0,0
35,1271,601,196,481,2,23,85,603,8,63,36,72,71,108,400,664,4,3036,168,0,0
166,5101,1660,832,1314,41,38,274,1701,20,312,209,395,332,604,2671,5058,12,64042,3557,1,0
166,5101,1057,646,719,113,100,145,1170,18,215,134,248,233,382,1740,3004,10,31186,1732,1,0
217,4685,2,2,2,0,0,0,2,0,0,0,0,0,0,0,0,0,0,0,0,0
217,4685,99,48,90,1,3,5,100,0,0,0,0,0,0,0,0,0,0,0,0,0
217,4685,8,5,5,2,0,1,10,0,0,0,0,0,0,0,0,0,0,0,0,0
217,4685,1217,716,841,84,126,174,1301,14,185,118,215,199,333,1446,2542,8,20687,1149,0,0
217,4685,160,89,115,0,13,31,160,7,15,11,17,22,28,78,124,3,495,27,0,0
217,4685,10,10,9,9,0,0,19,0,0,0,0,0,0,0,0,0,0,0,0,0
217,4685,173,84,99,8,29,36,181,5,12,7,13,17,20,54,81,2,221,12,0,0
217,4685,3,1,1,3,0,0,6,0,0,0,0,0,0,0,0,0,0,0,0,0
51,767,167,116,138,4,5,22,171,8,48,30,56,56,86,292,499,4,2330,129,0,0
254,5841,4293,999,3693,19,54,507,4312,9,155,88,170,164,258,1156,1898,4,9368,520,0,0
254,5841,1482,859,1002,125,135,219,1607,16,219,134,251,235,385,1766,3032,9,27804,1544,1,0
98,2660,1523,757,1297,19,12,193,1542,12,193,117,230,205,347,1508,2664,7,19053,1058,0,0
98,2660,701,378,504,33,58,109,734,13,110,68,126,123,194,794,1346,7,10027,557,0,0
87,1836,402,202,227,24,74,80,426,12,52,33,61,64,94,339,564,7,3969,220,0,0
235,5585,722,423,573,19,0,135,741,12,172,101,199,184,300,1320,2257,6,15668,870,0,0
235,5585,1508,847,911,44,250,301,1552,14,148,88,169,162,257,1120,1886,7,15077,837,0,0
30,663,215,129,180,6,0,29,221,8,65,43,72,73,115,415,711,4,3153,175,0,0
30,663,97,69,77,3,3,16,100,6,22,13,23,28,36,113,173,3,542,30,0,0
220,4815,1943,715,1694,26,18,214,1969,12,185,120,237,197,357,1436,2721,7,20915,1161,0,0
220,4815,1168,838,957,57,25,144,1225,19,348,224,416,367,640,3018,5452,11,61921,3440,1,0
1,62,37,13,25,0,6,6,37,1,2,1,2,3,3,2,4,0,2,0,0,0
1,62,133,47,40,1,43,49,134,0,0,0,0,0,0,0,0,0,0,0,0,0
20,927,75,38,59,1,3,12,76,2,4,2,4,6,6,10,15,1,15,0,0,0
156,4471,1660,832,1314,41,38,274,1701,20,312,209,395,332,604,2671,5058,12,64042,3557,1,0
128,5332,1513,682,1277,25,13,200,1538,11,199,116,219,210,335,1557,2584,6,15641,868,0,0
95,4639,1523,757,1297,19,12,193,1542,12,193,117,230,205,347,1508,2664,7,19053,1058,0,0
2,145,53,23,39,0,0,13,53,2,8,4,8,10,12,26,39,1,39,2,0,0
16,1224,215,129,180,6,0,29,221,8,65,43,72,73,115,415,711,4,3153,175,0,0
179,5394,1660,832,1314,41,38,274,1701,20,312,209,395,332,604,2671,5058,12,64042,3557,1,0
179,5394,1057,646,719,113,100,145,1170,18,215,134,248,233,382,1740,3004,10,31186,1732,1,0
217,4691,2,2,2,0,0,0,2,0,0,0,0,0,0,0,0,0,0,0,0,0
217,4691,99,48,90,1,3,5,100,0,0,0,0,0,0,0,0,0,0,0,0,0
217,4691,8,5,5,2,0,1,10,0,0,0,0,0,0,0,0,0,0,0,0,0
217,4691,1217,716,841,84,126,174,1301,14,185,118,215,199,333,1446,2542,8,20687,1149,0,0
217,4691,160,89,115,0,13,31,160,7,15,11,17,22,28,78,124,3,495,27,0,0
217,4691,10,10,9,9,0,0,19,0,0,0,0,0,0,0,0,0,0,0,0,0
217,4691,173,84,99,8,29,36,181,5,12,7,13,17,20,54,81,2,221,12,0,0
217,4691,3,1,1,3,0,0,6,0,0,0,0,0,0,0,0,0,0,0,0,0
222,4835,1943,715,1694,26,18,214,1969,12,185,120,237,197,357,1436,2721,7,20915,1161,0,0
222,4835,1168,838,957,57,25,144,1225,19,348,224,416,367,640,3018,5452,11,61921,3440,1,0
161,4776,1660,832,1314,41,38,274,1701,20,312,209,395,332,604,2671,5058,12,64042,3557,1,0
139,5872,1782,648,1425,9,47,279,1791,8,171,97,189,179,286,1292,2140,4,9462,525,0,0
136,5770,1782,648,1425,9,47,279,1791,8,171,97,189,179,286,1292,2140,4,9462,525,0,0
31,729,601,196,481,2,23,85,603,8,63,36,72,71,108,400,664,4,3036,168,0,0
31,729,156,79,106,5,16,28,161,5,14,8,15,19,23,64,97,2,261,14,0,0
39,1392,601,196,481,2,23,85,603,8,63,36,72,71,108,400,664,4,3036,168,0,0
35,1079,182,127,129,0,0,53,182,5,39,21,42,44,63,217,343,2,926,51,0,1
35,1079,182,127,129,0,0,53,182,5,39,21,42,44,63,217,343,2,926,51,0,0
313,6898,72,33,56,0,4,12,72,1,1,1,1,2,2,0,2,0,1,0,0,1
313,6898,1454,835,1044,76,110,219,1530,17,275,158,296,292,454,2297,3718,9,34017,1889,1,1
62,1231,1098,241,925,5,10,155,1103,7,46,25,49,53,74,273,423,3,1580,87,0,1
62,1231,282,202,222,14,2,44,296,8,42,24,43,50,67,250,378,4,1548,86,0,1
136,5770,1782,648,1425,9,47,279,1791,8,171,97,189,179,286,1292,2140,4,9462,525,0,1
86,1927,53,23,39,0,0,13,53,2,8,4,8,10,12,26,39,1,39,2,0,0
86,1927,515,298,307,33,80,99,548,12,63,44,77,75,121,419,753,7,5527,307,0,0
313,6928,72,33,56,0,4,12,72,1,1,1,1,2,2,0,2,0,1,0,0,0
313,6928,1454,835,1044,76,110,219,1530,17,275,158,296,292,454,2297,3718,9,34017,1889,1,0
21,960,75,38,59,1,3,12,76,2,4,2,4,6,6,10,15,1,15,0,0,0
254,5860,4293,999,3693,19,54,507,4312,9,155,88,170,164,258,1156,1898,4,9368,520,0,0
254,5860,1482,859,1002,125,135,219,1607,16,219,134,251,235,385,1766,3032,9,27804,1544,1,0
22,992,75,38,59,1,3,12,76,2,4,2,4,6,6,10,15,1,15,0,0,0
177,7847,139,89,101,2,0,35,141,7,54,34,62,61,96,330,569,4,2287,127,0,0
177,7847,7,5,5,0,0,2,7,1,2,1,2,3,3,2,4,0,2,0,0,0
86,1955,53,23,39,0,0,13,53,2,8,4,8,10,12,26,39,1,39,2,0,0
86,1955,515,298,307,33,80,99,548,12,63,44,77,75,121,419,753,7,5527,307,0,0
23,1030,75,38,59,1,3,12,76,2,4,2,4,6,6,10,15,1,15,0,0,0
313,6940,72,33,56,0,4,12,72,1,1,1,1,2,2,0,2,0,1,0,0,1
313,6940,1454,835,1044,76,110,219,1530,17,275,158,296,292,454,2297,3718,9,34017,1889,1,1
102,4762,1338,495,1086,10,64,173,1348,11,122,82,157,133,239,883,1686,7,11934,663,0,1
313,6898,72,33,56,0,4,12,72,1,1,1,1,2,2,0,2,0,1,0,0,0
313,6898,1454,835,1044,76,110,219,1530,17,275,158,296,292,454,2297,3718,9,34017,1889,1,0
62,1231,1098,241,925,5,10,155,1103,7,46,25,49,53,74,273,423,3,1580,87,0,0
62,1231,282,202,222,14,2,44,296,8,42,24,43,50,67,250,378,4,1548,86,0,0
254,5857,4293,999,3693,19,54,507,4312,9,155,88,170,164,258,1156,1898,4,9368,520,0,0
254,5857,1482,859,1002,125,135,219,1607,16,219,134,251,235,385,1766,3032,9,27804,1544,1,0
86,1965,53,23,39,0,0,13,53,2,8,4,8,10,12,26,39,1,39,2,0,0
86,1965,515,298,307,33,80,99,548,12,63,44,77,75,121,419,753,7,5527,307,0,0
51,757,167,116,138,4,5,22,171,8,48,30,56,56,86,292,499,4,2330,129,0,1
1,210,42,7,23,2,8,9,44,0,0,0,0,0,0,0,0,0,0,0,0,1
254,5844,4293,999,3693,19,54,507,4312,9,155,88,170,164,258,1156,1898,4,9368,520,0,1
254,5844,1482,859,1002,125,135,219,1607,16,219,134,251,235,385,1766,3032,9,27804,1544,1,1
86,1952,53,23,39,0,0,13,53,2,8,4,8,10,12,26,39,1,39,2,0,1
86,1952,515,298,307,33,80,99,548,12,63,44,77,75,121,419,753,7,5527,307,0,1
30,654,215,129,180,6,0,29,221,8,65,43,72,73,115,415,711,4,3153,175,0,1
30,654,97,69,77,3,3,16,100,6,22,13,23,28,36,113,173,3,542,30,0,1
76,1736,996,429,845,24,10,117,1020,7,76,50,88,83,138,494,879,4,3565,198,0,0
76,1736,456,277,329,12,42,72,468,13,85,50,97,98,147,592,972,7,7212,400,0,0
44,3214,996,429,845,24,10,117,1020,7,76,50,88,83,138,494,879,4,3565,198,0,0
177,7850,139,89,101,2,0,35,141,7,54,34,62,61,96,330,569,4,2287,127,0,1
177,7850,7,5,5,0,0,2,7,1,2,1,2,3,3,2,4,0,2,0,0,1
2,114,37,13,25,0,6,6,37,1,2,1,2,3,3,2,4,0,2,0,0,1
2,114,133,47,40,1,43,49,134,0,0,0,0,0,0,0,0,0,0,0,0,1
313,6905,72,33,56,0,4,12,72,1,1,1,1,2,2,0,2,0,1,0,0,0
313,6905,1454,835,1044,76,110,219,1530,17,275,158,296,292,454,2297,3718,9,34017,1889,1,0
139,6150,1782,648,1425,9,47,279,1791,8,171,97,189,179,286,1292,2140,4,9462,525,0,0
51,757,167,116,138,4,5,22,171,8,48,30,56,56,86,292,499,4,2330,129,0,0
254,5844,4293,999,3693,19,54,507,4312,9,155,88,170,164,258,1156,1898,4,9368,520,0,0
254,5844,1482,859,1002,125,135,219,1607,16,219,134,251,235,385,1766,3032,9,27804,1544,1,0
86,1952,53,23,39,0,0,13,53,2,8,4,8,10,12,26,39,1,39,2,0,0
86,1952,515,298,307,33,80,99,548,12,63,44,77,75,121,419,753,7,5527,307,0,0
313,6940,72,33,56,0,4,12,72,1,1,1,1,2,2,0,2,0,1,0,0,0
313,6940,1454,835,1044,76,110,219,1530,17,275,158,296,292,454,2297,3718,9,34017,1889,1,0
30,654,215,129,180,6,0,29,221,8,65,43,72,73,115,415,711,4,3153,175,0,0
30,654,97,69,77,3,3,16,100,6,22,13,23,28,36,113,173,3,542,30,0,0
2,114,37,13,25,0,6,6,37,1,2,1,2,3,3,2,4,0,2,0,0,0
2,114,133,47,40,1,43,49,134,0,0,0,0,0,0,0,0,0,0,0,0,0
102,4762,1338,495,1086,10,64,173,1348,11,122,82,157,133,239,883,1686,7,11934,663,0,0
177,7850,139,89,101,2,0,35,141,7,54,34,62,61,96,330,569,4,2287,127,0,0
177,7850,7,5,5,0,0,2,7,1,2,1,2,3,3,2,4,0,2,0,0,0
24,607,2,2,2,0,0,0,2,0,0,0,0,0,0,0,0,0,0,0,0,0
24,607,99,48,90,1,3,5,100,0,0,0,0,0,0,0,0,0,0,0,0,0
24,607,8,5,5,2,0,1,10,0,0,0,0,0,0,0,0,0,0,0,0,0
24,607,1217,716,841,84,126,174,1301,14,185,118,215,199,333,1446,2542,8,20687,1149,0,0
24,607,160,89,115,0,13,31,160,7,15,11,17,22,28,78,124,3,495,27,0,0
24,607,10,10,9,9,0,0,19,0,0,0,0,0,0,0,0,0,0,0,0,0
24,607,173,84,99,8,29,36,181,5,12,7,13,17,20,54,81,2,221,12,0,0
24,607,3,1,1,3,0,0,6,0,0,0,0,0,0,0,0,0,0,0,0,0
88,1873,402,202,227,24,74,80,426,12,52,33,61,64,94,339,564,7,3969,220,0,0
96,4196,1020,354,843,12,15,144,1032,8,134,77,144,142,221,970,1580,4,6792,377,0,0
180,5401,1660,832,1314,41,38,274,1701,20,312,209,395,332,604,2671,5058,12,64042,3557,1,0
180,5401,1057,646,719,113,100,145,1170,18,215,134,248,233,382,1740,3004,10,31186,1732,1,0
162,4835,1660,832,1314,41,38,274,1701,20,312,209,395,332,604,2671,5058,12,64042,3557,1,0
178,5362,1660,832,1314,41,38,274,1701,20,312,209,395,332,604,2671,5058,12,64042,3557,1,0
178,5362,1057,646,719,113,100,145,1170,18,215,134,248,233,382,1740,3004,10,31186,1732,1,0
67,1349,207,111,150,11,0,50,218,5,26,19,36,31,55,133,272,3,943,52,0,0
67,1349,410,198,237,31,55,97,441,11,63,38,72,74,110,414,683,6,4293,238,0,0
7,164,167,116,138,4,5,22,171,8,48,30,56,56,86,292,499,4,2330,129,0,0
88,2299,773,422,505,30,103,129,803,14,77,46,83,91,129,535,839,7,6334,351,0,0
32,2102,1157,318,931,29,22,177,1186,6,104,63,125,110,188,712,1274,3,4596,255,0,0
33,2202,1157,318,931,29,22,177,1186,6,104,63,125,110,188,712,1274,3,4596,255,0,0
62,2790,1293,570,1093,25,15,163,1318,10,195,123,241,205,364,1516,2795,6,17273,959,0,0
180,5384,1660,832,1314,41,38,274,1701,20,312,209,395,332,604,2671,5058,12,64042,3557,1,1
180,5384,1057,646,719,113,100,145,1170,18,215,134,248,233,382,1740,3004,10,31186,1732,1,1
165,4899,1660,832,1314,41,38,274,1701,20,312,209,395,332,604,2671,5058,12,64042,3557,1,1
180,5384,1660,832,1314,41,38,274,1701,20,312,209,395,332,604,2671,5058,12,64042,3557,1,0
180,5384,1057,646,719,113,100,145,1170,18,215,134,248,233,382,1740,3004,10,31186,1732,1,0
165,4899,1660,832,1314,41,38,274,1701,20,312,209,395,332,604,2671,5058,12,64042,3557,1,0
141,3284,77,34,69,0,0,8,77,3,24,16,29,27,45,114,213,1,387,21,0,0
141,3284,712,438,573,51,9,84,763,14,102,71,128,116,199,733,1364,8,11988,666,0,0
103,4779,1338,495,1086,10,64,173,1348,11,122,82,157,133,239,883,1686,7,11934,663,0,0
29,716,601,196,481,2,23,85,603,8,63,36,72,71,108,400,664,4,3036,168,0,0
29,716,156,79,106,5,16,28,161,5,14,8,15,19,23,64,97,2,261,14,0,0
40,1425,601,196,481,2,23,85,603,8,63,36,72,71,108,400,664,4,3036,168,0,0
313,6915,72,33,56,0,4,12,72,1,1,1,1,2,2,0,2,0,1,0,0,0
313,6915,1454,835,1044,76,110,219,1530,17,275,158,296,292,454,2297,3718,9,34017,1889,1,0
103,4797,1338,495,1086,10,64,173,1348,11,122,82,157,133,239,883,1686,7,11934,663,0,0
177,7868,139,89,101,2,0,35,141,7,54,34,62,61,96,330,569,4,2287,127,0,0
177,7868,7,5,5,0,0,2,7,1,2,1,2,3,3,2,4,0,2,0,0,0
180,5387,1660,832,1314,41,38,274,1701,20,312,209,395,332,604,2671,5058,12,64042,3557,1,0
180,5387,1057,646,719,113,100,145,1170,18,215,134,248,233,382,1740,3004,10,31186,1732,1,0
166,4970,1660,832,1314,41,38,274,1701,20,312,209,395,332,604,2671,5058,12,64042,3557,1,0
31,946,339,213,244,17,9,65,356,10,42,26,48,52,74,259,421,5,2410,133,0,1
62,2798,1293,570,1093,25,15,163,1318,10,195,123,241,205,364,1516,2795,6,17273,959,0,1
223,4840,1943,715,1694,26,18,214,1969,12,185,120,237,197,357,1436,2721,7,20915,1161,0,0
223,4840,1168,838,957,57,25,144,1225,19,348,224,416,367,640,3018,5452,11,61921,3440,1,0
28,725,466,257,367,18,25,50,484,7,126,86,171,133,257,898,1813,4,8612,478,0,0
28,725,507,281,342,29,59,88,536,10,53,29,57,63,86,336,514,5,2764,153,0,0
28,707,466,257,367,18,25,50,484,7,126,86,171,133,257,898,1813,4,8612,478,0,0
28,707,507,281,342,29,59,88,536,10,53,29,57,63,86,336,514,5,2764,153,0,0
99,5070,1943,715,1694,26,18,214,1969,12,185,120,237,197,357,1436,2721,7,20915,1161,0,0
20,893,75,38,59,1,3,12,76,2,4,2,4,6,6,10,15,1,15,0,0,0
218,4705,2,2,2,0,0,0,2,0,0,0,0,0,0,0,0,0,0,0,0,0
218,4705,99,48,90,1,3,5,100,0,0,0,0,0,0,0,0,0,0,0,0,0
218,4705,8,5,5,2,0,1,10,0,0,0,0,0,0,0,0,0,0,0,0,0
218,4705,1217,716,841,84,126,174,1301,14,185,118,215,199,333,1446,2542,8,20687,1149,0,0
218,4705,160,89,115,0,13,31,160,7,15,11,17,22,28,78,124,3,495,27,0,0
218,4705,10,10,9,9,0,0,19,0,0,0,0,0,0,0,0,0,0,0,0,0
218,4705,173,84,99,8,29,36,181,5,12,7,13,17,20,54,81,2,221,12,0,0
218,4705,3,1,1,3,0,0,6,0,0,0,0,0,0,0,0,0,0,0,0,0
21,1042,75,38,59,1,3,12,76,2,4,2,4,6,6,10,15,1,15,0,0,0
39,2322,652,304,544,16,6,88,668,6,89,51,101,95,152,591,998,3,3399,188,0,0
23,367,102,57,55,5,16,25,107,5,17,10,18,22,28,81,124,2,330,18,0,0
92,4051,1020,354,843,12,15,144,1032,8,134,77,144,142,221,970,1580,4,6792,377,0,0
96,4133,1020,354,843,12,15,144,1032,8,134,77,144,142,221,970,1580,4,6792,377,0,0
51,1046,447,308,343,6,5,95,453,7,96,59,111,103,170,651,1136,4,4600,255,0,0
51,1046,322,174,179,16,74,51,338,10,41,26,46,51,72,252,408,5,2291,127,0,0
41,1806,447,308,343,6,5,95,453,7,96,59,111,103,170,651,1136,4,4600,255,0,0
91,2946,773,419,590,28,0,166,801,10,204,113,217,214,330,1598,2554,5,13587,754,0,0
52,1071,447,308,343,6,5,95,453,7,96,59,111,103,170,651,1136,4,4600,255,0,1
52,1071,322,174,179,16,74,51,338,10,41,26,46,51,72,252,408,5,2291,127,0,1
95,3964,1289,550,1043,56,32,155,1345,10,167,93,185,177,278,1266,2075,5,11498,638,0,1
44,3226,996,429,845,24,10,117,1020,7,76,50,88,83,138,494,879,4,3565,198,0,1
42,1899,447,308,343,6,5,95,453,7,96,59,111,103,170,651,1136,4,4600,255,0,1
52,1071,447,308,343,6,5,95,453,7,96,59,111,103,170,651,1136,4,4600,255,0,0
52,1071,322,174,179,16,74,51,338,10,41,26,46,51,72,252,408,5,2291,127,0,0
95,3964,1289,550,1043,56,32,155,1345,10,167,93,185,177,278,1266,2075,5,11498,638,0,0
44,3226,996,429,845,24,10,117,1020,7,76,50,88,83,138,494,879,4,3565,198,0,0
95,4642,1523,757,1297,19,12,193,1542,12,193,117,230,205,347,1508,2664,7,19053,1058,0,0
42,1899,447,308,343,6,5,95,453,7,96,59,111,103,170,651,1136,4,4600,255,0,0
24,1145,75,38,59,1,3,12,76,2,4,2,4,6,6,10,15,1,15,0,0,0
97,4228,1020,354,843,12,15,144,1032,8,134,77,144,142,221,970,1580,4,6792,377,0,0
68,1571,773,419,590,28,0,166,801,10,204,113,217,214,330,1598,2554,5,13587,754,0,0
68,1571,421,273,302,44,34,57,465,17,81,59,107,98,166,583,1098,11,12329,684,0,0
91,2922,773,419,590,28,0,166,801,10,204,113,217,214,330,1598,2554,5,13587,754,0,0
90,2885,773,419,590,28,0,166,801,10,204,113,217,214,330,1598,2554,5,13587,754,0,0
68,1561,773,419,590,28,0,166,801,10,204,113,217,214,330,1598,2554,5,13587,754,0,0
68,1561,421,273,302,44,34,57,465,17,81,59,107,98,166,583,1098,11,12329,684,0,0
254,5861,4293,999,3693,19,54,507,4312,9,155,88,170,164,258,1156,1898,4,9368,520,0,0
254,5861,1482,859,1002,125,135,219,1607,16,219,134,251,235,385,1766,3032,9,27804,1544,1,0
4,61,20,12,12,0,0,8,20,1,2,1,2,3,3,2,4,0,2,0,0,0
178,7880,139,89,101,2,0,35,141,7,54,34,62,61,96,330,569,4,2287,127,0,0
178,7880,7,5,5,0,0,2,7,1,2,1,2,3,3,2,4,0,2,0,0,0
256,5900,4293,999,3693,19,54,507,4312,9,155,88,170,164,258,1156,1898,4,9368,520,0,0
256,5900,1482,859,1002,125,135,219,1607,16,219,134,251,235,385,1766,3032,9,27804,1544,1,0
2,51,14,9,9,0,0,5,14,0,0,0,0,0,0,0,0,0,0,0,0,0
51,1913,1098,241,925,5,10,155,1103,7,46,25,49,53,74,273,423,3,1580,87,0,0
11,415,42,7,35,4,0,5,46,1,2,1,2,3,3,2,4,0,2,0,0,1
11,415,11,6,10,0,0,1,11,2,4,2,4,6,6,10,15,1,15,0,0,1
242,5716,722,423,573,19,0,135,741,12,172,101,199,184,300,1320,2257,6,15668,870,0,1
242,5716,1508,847,911,44,250,301,1552,14,148,88,169,162,257,1120,1886,7,15077,837,0,1
46,2172,722,423,573,19,0,135,741,12,172,101,199,184,300,1320,2257,6,15668,870,0,1
242,5718,722,423,573,19,0,135,741,12,172,101,199,184,300,1320,2257,6,15668,870,0,0
242,5718,1508,847,911,44,250,301,1552,14,148,88,169,162,257,1120,1886,7,15077,837,0,0
46,2170,722,423,573,19,0,135,741,12,172,101,199,184,300,1320,2257,6,15668,870,0,0
242,5716,722,423,573,19,0,135,741,12,172,101,199,184,300,1320,2257,6,15668,870,0,0
242,5716,1508,847,911,44,250,301,1552,14,148,88,169,162,257,1120,1886,7,15077,837,0,0
242,5735,722,423,573,19,0,135,741,12,172,101,199,184,300,1320,2257,6,15668,870,0,0
242,5735,1508,847,911,44,250,301,1552,14,148,88,169,162,257,1120,1886,7,15077,837,0,0
243,5749,722,423,573,19,0,135,741,12,172,101,199,184,300,1320,2257,6,15668,870,0,0
243,5749,1508,847,911,44,250,301,1552,14,148,88,169,162,257,1120,1886,7,15077,837,0,0
243,5757,722,423,573,19,0,135,741,12,172,101,199,184,300,1320,2257,6,15668,870,0,1
243,5757,1508,847,911,44,250,301,1552,14,148,88,169,162,257,1120,1886,7,15077,837,0,1
47,2227,722,423,573,19,0,135,741,12,172,101,199,184,300,1320,2257,6,15668,870,0,1
47,2225,722,423,573,19,0,135,741,12,172,101,199,184,300,1320,2257,6,15668,870,0,0
242,5792,722,423,573,19,0,135,741,12,172,101,199,184,300,1320,2257,6,15668,870,0,0
242,5792,1508,847,911,44,250,301,1552,14,148,88,169,162,257,1120,1886,7,15077,837,0,0
241,5777,722,423,573,19,0,135,741,12,172,101,199,184,300,1320,2257,6,15668,870,0,0
241,5777,1508,847,911,44,250,301,1552,14,148,88,169,162,257,1120,1886,7,15077,837,0,0
243,5819,722,423,573,19,0,135,741,12,172,101,199,184,300,1320,2257,6,15668,870,0,1
243,5819,1508,847,911,44,250,301,1552,14,148,88,169,162,257,1120,1886,7,15077,837,0,1
243,5819,722,423,573,19,0,135,741,12,172,101,199,184,300,1320,2257,6,15668,870,0,0
243,5819,1508,847,911,44,250,301,1552,14,148,88,169,162,257,1120,1886,7,15077,837,0,0
244,5784,722,423,573,19,0,135,741,12,172,101,199,184,300,1320,2257,6,15668,870,0,0
244,5784,1508,847,911,44,250,301,1552,14,148,88,169,162,257,1120,1886,7,15077,837,0,0
244,5775,722,423,573,19,0,135,741,12,172,101,199,184,300,1320,2257,6,15668,870,0,1
244,5775,1508,847,911,44,250,301,1552,14,148,88,169,162,257,1120,1886,7,15077,837,0,1
244,5775,722,423,573,19,0,135,741,12,172,101,199,184,300,1320,2257,6,15668,870,0,0
244,5775,1508,847,911,44,250,301,1552,14,148,88,169,162,257,1120,1886,7,15077,837,0,0
244,5770,722,423,573,19,0,135,741,12,172,101,199,184,300,1320,2257,6,15668,870,0,0
244,5770,1508,847,911,44,250,301,1552,14,148,88,169,162,257,1120,1886,7,15077,837,0,0
256,5920,4293,999,3693,19,54,507,4312,9,155,88,170,164,258,1156,1898,4,9368,520,0,0
256,5920,1482,859,1002,125,135,219,1607,16,219,134,251,235,385,1766,3032,9,27804,1544,1,0
244,5779,722,423,573,19,0,135,741,12,172,101,199,184,300,1320,2257,6,15668,870,0,0
244,5779,1508,847,911,44,250,301,1552,14,148,88,169,162,257,1120,1886,7,15077,837,0,0
92,1945,1043,504,840,53,9,147,1096,9,180,112,198,189,310,1377,2344,4,11604,644,0,0
92,1945,383,288,292,26,6,62,409,11,65,38,67,76,105,429,656,5,3719,206,0,0
101,4044,1289,550,1043,56,32,155,1345,10,167,93,185,177,278,1266,2075,5,11498,638,0,0
60,1079,282,196,195,3,0,86,285,8,130,71,141,138,212,936,1507,4,6538,363,0,1
218,4706,2,2,2,0,0,0,2,0,0,0,0,0,0,0,0,0,0,0,0,1
218,4706,99,48,90,1,3,5,100,0,0,0,0,0,0,0,0,0,0,0,0,1
218,4706,8,5,5,2,0,1,10,0,0,0,0,0,0,0,0,0,0,0,0,1
218,4706,1217,716,841,84,126,174,1301,14,185,118,215,199,333,1446,2542,8,20687,1149,0,1
218,4706,160,89,115,0,13,31,160,7,15,11,17,22,28,78,124,3,495,27,0,1
218,4706,10,10,9,9,0,0,19,0,0,0,0,0,0,0,0,0,0,0,0,1
218,4706,173,84,99,8,29,36,181,5,12,7,13,17,20,54,81,2,221,12,0,1
218,4706,3,1,1,3,0,0,6,0,0,0,0,0,0,0,0,0,0,0,0,1
85,2240,773,422,505,30,103,129,803,14,77,46,83,91,129,535,839,7,6334,351,0,1
30,660,125,97,103,3,0,19,128,9,25,17,27,34,44,144,223,4,1087,60,0,1
63,4331,520,294,400,33,13,81,553,10,261,204,367,271,571,2128,4614,7,32445,1802,1,1
44,2109,722,423,573,19,0,135,741,12,172,101,199,184,300,1320,2257,6,15668,870,0,1
151,7095,1392,870,1177,35,17,170,1427,14,494,280,531,508,811,4473,7289,7,54850,3047,2,1
151,7095,1392,870,1177,35,17,170,1427,14,494,280,531,508,811,4473,7289,7,54850,3047,2,0
47,2228,722,423,573,19,0,135,741,12,172,101,199,184,300,1320,2257,6,15668,870,0,0
218,4706,2,2,2,0,0,0,2,0,0,0,0,0,0,0,0,0,0,0,0,0
218,4706,99,48,90,1,3,5,100,0,0,0,0,0,0,0,0,0,0,0,0,0
218,4706,8,5,5,2,0,1,10,0,0,0,0,0,0,0,0,0,0,0,0,0
218,4706,1217,716,841,84,126,174,1301,14,185,118,215,199,333,1446,2542,8,20687,1149,0,0
218,4706,160,89,115,0,13,31,160,7,15,11,17,22,28,78,124,3,495,27,0,0
218,4706,10,10,9,9,0,0,19,0,0,0,0,0,0,0,0,0,0,0,0,0
218,4706,173,84,99,8,29,36,181,5,12,7,13,17,20,54,81,2,221,12,0,0
218,4706,3,1,1,3,0,0,6,0,0,0,0,0,0,0,0,0,0,0,0,0
30,660,125,97,103,3,0,19,128,9,25,17,27,34,44,144,223,4,1087,60,0,0
63,4331,520,294,400,33,13,81,553,10,261,204,367,271,571,2128,4614,7,32445,1802,1,0
256,5923,4293,999,3693,19,54,507,4312,9,155,88,170,164,258,1156,1898,4,9368,520,0,0
256,5923,1482,859,1002,125,135,219,1607,16,219,134,251,235,385,1766,3032,9,27804,1544,1,0
178,7898,139,89,101,2,0,35,141,7,54,34,62,61,96,330,569,4,2287,127,0,0
178,7898,7,5,5,0,0,2,7,1,2,1,2,3,3,2,4,0,2,0,0,0
38,779,386,256,301,16,9,68,402,4,59,35,69,63,104,355,621,2,1453,80,0,1
38,779,264,131,164,11,41,46,275,6,38,22,40,44,62,214,338,3,1068,59,0,1
40,1789,386,256,301,16,9,68,402,4,59,35,69,63,104,355,621,2,1453,80,0,1
41,830,386,256,301,16,9,68,402,4,59,35,69,63,104,355,621,2,1453,80,0,1
41,830,264,131,164,11,41,46,275,6,38,22,40,44,62,214,338,3,1068,59,0,1
42,1848,386,256,301,16,9,68,402,4,59,35,69,63,104,355,621,2,1453,80,0,1
244,5785,722,423,573,19,0,135,741,12,172,101,199,184,300,1320,2257,6,15668,870,0,0
244,5785,1508,847,911,44,250,301,1552,14,148,88,169,162,257,1120,1886,7,15077,837,0,0
60,1078,282,196,195,3,0,86,285,8,130,71,141,138,212,936,1507,4,6538,363,0,0
89,1825,477,336,357,30,23,73,507,16,194,134,250,210,384,1538,2962,10,30538,1696,0,0
76,1735,996,429,845,24,10,117,1020,7,76,50,88,83,138,494,879,4,3565,198,0,0
76,1735,456,277,329,12,42,72,468,13,85,50,97,98,147,592,972,7,7212,400,0,0
154,3261,1513,682,1277,25,13,200,1538,11,199,116,219,210,335,1557,2584,6,15641,868,0,0
154,3261,819,519,539,24,98,155,843,15,96,57,106,111,163,690,1107,8,9171,509,0,0
67,1348,207,111,150,11,0,50,218,5,26,19,36,31,55,133,272,3,943,52,0,0
67,1348,410,198,237,31,55,97,441,11,63,38,72,74,110,414,683,6,4293,238,0,0
27,964,74,35,59,1,0,14,75,3,14,7,14,17,21,58,85,1,128,7,0,0
27,964,245,125,200,5,7,34,250,7,30,17,34,37,51,166,265,3,1053,58,0,0
313,6904,72,33,56,0,4,12,72,1,1,1,1,2,2,0,2,0,1,0,0,0
313,6904,1454,835,1044,76,110,219,1530,17,275,158,296,292,454,2297,3718,9,34017,1889,1,0
223,4839,1943,715,1694,26,18,214,1969,12,185,120,237,197,357,1436,2721,7,20915,1161,0,0
223,4839,1168,838,957,57,25,144,1225,19,348,224,416,367,640,3018,5452,11,61921,3440,1,0
95,3960,1289,550,1043,56,32,155,1345,10,167,93,185,177,278,1266,2075,5,11498,638,0,0
1,134,149,67,118,4,0,27,153,1,17,14,28,18,42,69,175,0,144,8,0,0
95,4641,1523,757,1297,19,12,193,1542,12,193,117,230,205,347,1508,2664,7,19053,1058,0,0
62,2789,1293,570,1093,25,15,163,1318,10,195,123,241,205,364,1516,2795,6,17273,959,0,0
62,2808,1293,570,1093,25,15,163,1318,10,195,123,241,205,364,1516,2795,6,17273,959,0,0
218,4703,2,2,2,0,0,0,2,0,0,0,0,0,0,0,0,0,0,0,0,1
218,4703,99,48,90,1,3,5,100,0,0,0,0,0,0,0,0,0,0,0,0,1
218,4703,8,5,5,2,0,1,10,0,0,0,0,0,0,0,0,0,0,0,0,1
218,4703,1217,716,841,84,126,174,1301,14,185,118,215,199,333,1446,2542,8,20687,1149,0,1
218,4703,160,89,115,0,13,31,160,7,15,11,17,22,28,78,124,3,495,27,0,1
218,4703,10,10,9,9,0,0,19,0,0,0,0,0,0,0,0,0,0,0,0,1
218,4703,173,84,99,8,29,36,181,5,12,7,13,17,20,54,81,2,221,12,0,1
218,4703,3,1,1,3,0,0,6,0,0,0,0,0,0,0,0,0,0,0,0,1
88,1878,402,202,227,24,74,80,426,12,52,33,61,64,94,339,564,7,3969,220,0,0
256,5936,4293,999,3693,19,54,507,4312,9,155,88,170,164,258,1156,1898,4,9368,520,0,1
256,5936,1482,859,1002,125,135,219,1607,16,219,134,251,235,385,1766,3032,9,27804,1544,1,1
24,600,2,2,2,0,0,0,2,0,0,0,0,0,0,0,0,0,0,0,0,1
24,600,99,48,90,1,3,5,100,0,0,0,0,0,0,0,0,0,0,0,0,1
24,600,8,5,5,2,0,1,10,0,0,0,0,0,0,0,0,0,0,0,0,1
24,600,1217,716,841,84,126,174,1301,14,185,118,215,199,333,1446,2542,8,20687,1149,0,1
24,600,160,89,115,0,13,31,160,7,15,11,17,22,28,78,124,3,495,27,0,1
24,600,10,10,9,9,0,0,19,0,0,0,0,0,0,0,0,0,0,0,0,1
24,600,173,84,99,8,29,36,181,5,12,7,13,17,20,54,81,2,221,12,0,1
24,600,3,1,1,3,0,0,6,0,0,0,0,0,0,0,0,0,0,0,0,1
88,1887,402,202,227,24,74,80,426,12,52,33,61,64,94,339,564,7,3969,220,0,1
88,1985,53,23,39,0,0,13,53,2,8,4,8,10,12,26,39,1,39,2,0,1
88,1985,515,298,307,33,80,99,548,12,63,44,77,75,121,419,753,7,5527,307,0,1
310,6900,72,33,56,0,4,12,72,1,1,1,1,2,2,0,2,0,1,0,0,1
310,6900,1454,835,1044,76,110,219,1530,17,275,158,296,292,454,2297,3718,9,34017,1889,1,1
178,7961,139,89,101,2,0,35,141,7,54,34,62,61,96,330,569,4,2287,127,0,1
178,7961,7,5,5,0,0,2,7,1,2,1,2,3,3,2,4,0,2,0,0,1
138,6146,1782,648,1425,9,47,279,1791,8,171,97,189,179,286,1292,2140,4,9462,525,0,1
97,4228,1020,354,843,12,15,144,1032,8,134,77,144,142,221,970,1580,4,6792,377,0,1
83,3201,1043,504,840,53,9,147,1096,9,180,112,198,189,310,1377,2344,4,11604,644,0,1
141,3287,77,34,69,0,0,8,77,3,24,16,29,27,45,114,213,1,387,21,0,0
141,3287,712,438,573,51,9,84,763,14,102,71,128,116,199,733,1364,8,11988,666,0,0
26,755,442,244,305,14,16,103,456,11,68,45,75,79,120,452,756,6,4588,254,0,0
26,755,182,102,99,11,40,35,193,3,11,6,11,14,17,42,64,1,97,5,0,0
14,732,442,244,305,14,16,103,456,11,68,45,75,79,120,452,756,6,4588,254,0,0
26,761,442,244,305,14,16,103,456,11,68,45,75,79,120,452,756,6,4588,254,0,0
26,761,182,102,99,11,40,35,193,3,11,6,11,14,17,42,64,1,97,5,0,0
38,1045,442,244,305,14,16,103,456,11,68,45,75,79,120,452,756,6,4588,254,0,1
38,1045,182,102,99,11,40,35,193,3,11,6,11,14,17,42,64,1,97,5,0,1
38,1039,442,244,305,14,16,103,456,11,68,45,75,79,120,452,756,6,4588,254,0,1
38,1039,182,102,99,11,40,35,193,3,11,6,11,14,17,42,64,1,97,5,0,1
50,1304,442,244,305,14,16,103,456,11,68,45,75,79,120,452,756,6,4588,254,0,1
50,1304,182,102,99,11,40,35,193,3,11,6,11,14,17,42,64,1,97,5,0,1
19,987,442,244,305,14,16,103,456,11,68,45,75,79,120,452,756,6,4588,254,0,1
50,1308,442,244,305,14,16,103,456,11,68,45,75,79,120,452,756,6,4588,254,0,0
50,1308,182,102,99,11,40,35,193,3,11,6,11,14,17,42,64,1,97,5,0,0
56,1403,442,244,305,14,16,103,456,11,68,45,75,79,120,452,756,6,4588,254,0,1
56,1403,182,102,99,11,40,35,193,3,11,6,11,14,17,42,64,1,97,5,0,1
20,1078,442,244,305,14,16,103,456,11,68,45,75,79,120,452,756,6,4588,254,0,1
56,1416,442,244,305,14,16,103,456,11,68,45,75,79,120,452,756,6,4588,254,0,0
56,1416,182,102,99,11,40,35,193,3,11,6,11,14,17,42,64,1,97,5,0,0
20,1083,442,244,305,14,16,103,456,11,68,45,75,79,120,452,756,6,4588,254,0,0
56,1420,442,244,305,14,16,103,456,11,68,45,75,79,120,452,756,6,4588,254,0,0
56,1420,182,102,99,11,40,35,193,3,11,6,11,14,17,42,64,1,97,5,0,0
180,5391,1660,832,1314,41,38,274,1701,20,312,209,395,332,604,2671,5058,12,64042,3557,1,1
180,5391,1057,646,719,113,100,145,1170,18,215,134,248,233,382,1740,3004,10,31186,1732,1,1
76,1739,996,429,845,24,10,117,1020,7,76,50,88,83,138,494,879,4,3565,198,0,1
76,1739,456,277,329,12,42,72,468,13,85,50,97,98,147,592,972,7,7212,400,0,1
67,1325,207,111,150,11,0,50,218,5,26,19,36,31,55,133,272,3,943,52,0,1
67,1325,410,198,237,31,55,97,441,11,63,38,72,74,110,414,683,6,4293,238,0,1
37,833,91,45,69,0,3,18,91,3,9,6,10,12,16,33,57,1,95,5,0,1
37,833,367,234,237,17,34,68,384,16,55,34,61,71,95,381,584,8,5183,287,0,1
7,164,167,116,138,4,5,22,171,8,48,30,56,56,86,292,499,4,2330,129,0,1
244,5785,722,423,573,19,0,135,741,12,172,101,199,184,300,1320,2257,6,15668,870,0,1
244,5785,1508,847,911,44,250,301,1552,14,148,88,169,162,257,1120,1886,7,15077,837,0,1
19,622,442,244,305,14,16,103,456,11,68,45,75,79,120,452,756,6,4588,254,0,1
19,622,182,102,99,11,40,35,193,3,11,6,11,14,17,42,64,1,97,5,0,1
20,1083,442,244,305,14,16,103,456,11,68,45,75,79,120,452,756,6,4588,254,0,1
180,5391,1660,832,1314,41,38,274,1701,20,312,209,395,332,604,2671,5058,12,64042,3557,1,0
180,5391,1057,646,719,113,100,145,1170,18,215,134,248,233,382,1740,3004,10,31186,1732,1,0
44,988,91,45,69,0,3,18,91,3,9,6,10,12,16,33,57,1,95,5,0,0
44,988,367,234,237,17,34,68,384,16,55,34,61,71,95,381,584,8,5183,287,0,0
76,1734,996,429,845,24,10,117,1020,7,76,50,88,83,138,494,879,4,3565,198,0,1
76,1734,456,277,329,12,42,72,468,13,85,50,97,98,147,592,972,7,7212,400,0,1
49,1088,91,45,69,0,3,18,91,3,9,6,10,12,16,33,57,1,95,5,0,1
49,1088,367,234,237,17,34,68,384,16,55,34,61,71,95,381,584,8,5183,287,0,1
18,608,442,244,305,14,16,103,456,11,68,45,75,79,120,452,756,6,4588,254,0,1
18,608,182,102,99,11,40,35,193,3,11,6,11,14,17,42,64,1,97,5,0,1
21,1150,442,244,305,14,16,103,456,11,68,45,75,79,120,452,756,6,4588,254,0,1
49,1103,91,45,69,0,3,18,91,3,9,6,10,12,16,33,57,1,95,5,0,0
49,1103,367,234,237,17,34,68,384,16,55,34,61,71,95,381,584,8,5183,287,0,0
18,611,442,244,305,14,16,103,456,11,68,45,75,79,120,452,756,6,4588,254,0,0
18,611,182,102,99,11,40,35,193,3,11,6,11,14,17,42,64,1,97,5,0,0
244,5821,722,423,573,19,0,135,741,12,172,101,199,184,300,1320,2257,6,15668,870,0,1
244,5821,1508,847,911,44,250,301,1552,14,148,88,169,162,257,1120,1886,7,15077,837,0,1
19,625,442,244,305,14,16,103,456,11,68,45,75,79,120,452,756,6,4588,254,0,1
19,625,182,102,99,11,40,35,193,3,11,6,11,14,17,42,64,1,97,5,0,1
21,1128,442,244,305,14,16,103,456,11,68,45,75,79,120,452,756,6,4588,254,0,1
244,5824,722,423,573,19,0,135,741,12,172,101,199,184,300,1320,2257,6,15668,870,0,0
244,5824,1508,847,911,44,250,301,1552,14,148,88,169,162,257,1120,1886,7,15077,837,0,0
19,627,442,244,305,14,16,103,456,11,68,45,75,79,120,452,756,6,4588,254,0,0
19,627,182,102,99,11,40,35,193,3,11,6,11,14,17,42,64,1,97,5,0,0
19,628,442,244,305,14,16,103,456,11,68,45,75,79,120,452,756,6,4588,254,0,0
19,628,182,102,99,11,40,35,193,3,11,6,11,14,17,42,64,1,97,5,0,0
19,669,442,244,305,14,16,103,456,11,68,45,75,79,120,452,756,6,4588,254,0,1
19,669,182,102,99,11,40,35,193,3,11,6,11,14,17,42,64,1,97,5,0,1
218,4703,2,2,2,0,0,0,2,0,0,0,0,0,0,0,0,0,0,0,0,0
218,4703,99,48,90,1,3,5,100,0,0,0,0,0,0,0,0,0,0,0,0,0
218,4703,8,5,5,2,0,1,10,0,0,0,0,0,0,0,0,0,0,0,0,0
218,4703,1217,716,841,84,126,174,1301,14,185,118,215,199,333,1446,2542,8,20687,1149,0,0
218,4703,160,89,115,0,13,31,160,7,15,11,17,22,28,78,124,3,495,27,0,0
218,4703,10,10,9,9,0,0,19,0,0,0,0,0,0,0,0,0,0,0,0,0
218,4703,173,84,99,8,29,36,181,5,12,7,13,17,20,54,81,2,221,12,0,0
218,4703,3,1,1,3,0,0,6,0,0,0,0,0,0,0,0,0,0,0,0,0
41,830,386,256,301,16,9,68,402,4,59,35,69,63,104,355,621,2,1453,80,0,0
41,830,264,131,164,11,41,46,275,6,38,22,40,44,62,214,338,3,1068,59,0,0
42,1848,386,256,301,16,9,68,402,4,59,35,69,63,104,355,621,2,1453,80,0,0
62,2807,1293,570,1093,25,15,163,1318,10,195,123,241,205,364,1516,2795,6,17273,959,0,0
256,5936,4293,999,3693,19,54,507,4312,9,155,88,170,164,258,1156,1898,4,9368,520,0,0
256,5936,1482,859,1002,125,135,219,1607,16,219,134,251,235,385,1766,3032,9,27804,1544,1,0
88,1887,402,202,227,24,74,80,426,12,52,33,61,64,94,339,564,7,3969,220,0,0
88,1985,53,23,39,0,0,13,53,2,8,4,8,10,12,26,39,1,39,2,0,0
88,1985,515,298,307,33,80,99,548,12,63,44,77,75,121,419,753,7,5527,307,0,0
310,6900,72,33,56,0,4,12,72,1,1,1,1,2,2,0,2,0,1,0,0,0
310,6900,1454,835,1044,76,110,219,1530,17,275,158,296,292,454,2297,3718,9,34017,1889,1,0
178,7961,139,89,101,2,0,35,141,7,54,34,62,61,96,330,569,4,2287,127,0,0
178,7961,7,5,5,0,0,2,7,1,2,1,2,3,3,2,4,0,2,0,0,0
138,6146,1782,648,1425,9,47,279,1791,8,171,97,189,179,286,1292,2140,4,9462,525,0,0
83,3201,1043,504,840,53,9,147,1096,9,180,112,198,189,310,1377,2344,4,11604,644,0,0
76,1734,996,429,845,24,10,117,1020,7,76,50,88,83,138,494,879,4,3565,198,0,0
76,1734,456,277,329,12,42,72,468,13,85,50,97,98,147,592,972,7,7212,400,0,0
67,1325,207,111,150,11,0,50,218,5,26,19,36,31,55,133,272,3,943,52,0,0
67,1325,410,198,237,31,55,97,441,11,63,38,72,74,110,414,683,6,4293,238,0,0
19,669,442,244,305,14,16,103,456,11,68,45,75,79,120,452,756,6,4588,254,0,0
19,669,182,102,99,11,40,35,193,3,11,6,11,14,17,42,64,1,97,5,0,0
21,1128,442,244,305,14,16,103,456,11,68,45,75,79,120,452,756,6,4588,254,0,0
217,4704,182,127,129,0,0,53,182,5,39,21,42,44,63,217,343,2,926,51,0,1
217,4704,1165,710,800,67,119,181,1232,18,243,153,282,261,435,2000,3492,10,36473,2026,1,1
152,7140,1392,870,1177,35,17,170,1427,14,494,280,531,508,811,4473,7289,7,54850,3047,2,1
219,4763,2,2,2,0,0,0,2,0,0,0,0,0,0,0,0,0,0,0,0,0
219,4763,99,48,90,1,3,5,100,0,0,0,0,0,0,0,0,0,0,0,0,0
219,4763,8,5,5,2,0,1,10,0,0,0,0,0,0,0,0,0,0,0,0,0
219,4763,1217,716,841,84,126,174,1301,14,185,118,215,199,333,1446,2542,8,20687,1149,0,0
219,4763,160,89,115,0,13,31,160,7,15,11,17,22,28,78,124,3,495,27,0,0
219,4763,10,10,9,9,0,0,19,0,0,0,0,0,0,0,0,0,0,0,0,0
219,4763,173,84,99,8,29,36,181,5,12,7,13,17,20,54,81,2,221,12,0,0
219,4763,3,1,1,3,0,0,6,0,0,0,0,0,0,0,0,0,0,0,0,0
97,4034,1289,550,1043,56,32,155,1345,10,167,93,185,177,278,1266,2075,5,11498,638,0,0
222,4841,182,127,129,0,0,53,182,5,39,21,42,44,63,217,343,2,926,51,0,0
222,4841,1165,710,800,67,119,181,1232,18,243,153,282,261,435,2000,3492,10,36473,2026,1,0
219,4759,2,2,2,0,0,0,2,0,0,0,0,0,0,0,0,0,0,0,0,0
219,4759,99,48,90,1,3,5,100,0,0,0,0,0,0,0,0,0,0,0,0,0
219,4759,8,5,5,2,0,1,10,0,0,0,0,0,0,0,0,0,0,0,0,0
219,4759,1217,716,841,84,126,174,1301,14,185,118,215,199,333,1446,2542,8,20687,1149,0,0
219,4759,160,89,115,0,13,31,160,7,15,11,17,22,28,78,124,3,495,27,0,0
219,4759,10,10,9,9,0,0,19,0,0,0,0,0,0,0,0,0,0,0,0,0
219,4759,173,84,99,8,29,36,181,5,12,7,13,17,20,54,81,2,221,12,0,0
219,4759,3,1,1,3,0,0,6,0,0,0,0,0,0,0,0,0,0,0,0,0
305,6771,72,33,56,0,4,12,72,1,1,1,1,2,2,0,2,0,1,0,0,0
305,6771,1454,835,1044,76,110,219,1530,17,275,158,296,292,454,2297,3718,9,34017,1889,1,0
218,4716,2,2,2,0,0,0,2,0,0,0,0,0,0,0,0,0,0,0,0,0
218,4716,99,48,90,1,3,5,100,0,0,0,0,0,0,0,0,0,0,0,0,0
218,4716,8,5,5,2,0,1,10,0,0,0,0,0,0,0,0,0,0,0,0,0
218,4716,1217,716,841,84,126,174,1301,14,185,118,215,199,333,1446,2542,8,20687,1149,0,0
218,4716,160,89,115,0,13,31,160,7,15,11,17,22,28,78,124,3,495,27,0,0
218,4716,10,10,9,9,0,0,19,0,0,0,0,0,0,0,0,0,0,0,0,0
218,4716,173,84,99,8,29,36,181,5,12,7,13,17,20,54,81,2,221,12,0,0
218,4716,3,1,1,3,0,0,6,0,0,0,0,0,0,0,0,0,0,0,0,0
76,1733,996,429,845,24,10,117,1020,7,76,50,88,83,138,494,879,4,3565,198,0,0
76,1733,456,277,329,12,42,72,468,13,85,50,97,98,147,592,972,7,7212,400,0,0
67,1324,207,111,150,11,0,50,218,5,26,19,36,31,55,133,272,3,943,52,0,0
67,1324,410,198,237,31,55,97,441,11,63,38,72,74,110,414,683,6,4293,238,0,0
310,6899,72,33,56,0,4,12,72,1,1,1,1,2,2,0,2,0,1,0,0,0
310,6899,1454,835,1044,76,110,219,1530,17,275,158,296,292,454,2297,3718,9,34017,1889,1,0
41,829,386,256,301,16,9,68,402,4,59,35,69,63,104,355,621,2,1453,80,0,0
41,829,264,131,164,11,41,46,275,6,38,22,40,44,62,214,338,3,1068,59,0,0
152,7140,1392,870,1177,35,17,170,1427,14,494,280,531,508,811,4473,7289,7,54850,3047,2,0
90,3892,1289,550,1043,56,32,155,1345,10,167,93,185,177,278,1266,2075,5,11498,638,0,0
305,6770,72,33,56,0,4,12,72,1,1,1,1,2,2,0,2,0,1,0,0,0
305,6770,1454,835,1044,76,110,219,1530,17,275,158,296,292,454,2297,3718,9,34017,1889,1,0
97,4030,1289,550,1043,56,32,155,1345,10,167,93,185,177,278,1266,2075,5,11498,638,0,0
256,5918,4293,999,3693,19,54,507,4312,9,155,88,170,164,258,1156,1898,4,9368,520,0,0
256,5918,1482,859,1002,125,135,219,1607,16,219,134,251,235,385,1766,3032,9,27804,1544,1,0
141,3282,77,34,69,0,0,8,77,3,24,16,29,27,45,114,213,1,387,21,0,0
141,3282,712,438,573,51,9,84,763,14,102,71,128,116,199,733,1364,8,11988,666,0,0
235,5587,722,423,573,19,0,135,741,12,172,101,199,184,300,1320,2257,6,15668,870,0,1
235,5587,1508,847,911,44,250,301,1552,14,148,88,169,162,257,1120,1886,7,15077,837,0,1
235,5587,722,423,573,19,0,135,741,12,172,101,199,184,300,1320,2257,6,15668,870,0,0
235,5587,1508,847,911,44,250,301,1552,14,148,88,169,162,257,1120,1886,7,15077,837,0,0
92,1951,1043,504,840,53,9,147,1096,9,180,112,198,189,310,1377,2344,4,11604,644,0,0
92,1951,383,288,292,26,6,62,409,11,65,38,67,76,105,429,656,5,3719,206,0,0
92,1957,1043,504,840,53,9,147,1096,9,180,112,198,189,310,1377,2344,4,11604,644,0,1
92,1957,383,288,292,26,6,62,409,11,65,38,67,76,105,429,656,5,3719,206,0,1
101,4065,1289,550,1043,56,32,155,1345,10,167,93,185,177,278,1266,2075,5,11498,638,0,1
33,970,339,213,244,17,9,65,356,10,42,26,48,52,74,259,421,5,2410,133,0,0
64,2837,1293,570,1093,25,15,163,1318,10,195,123,241,205,364,1516,2795,6,17273,959,0,0
256,5940,4293,999,3693,19,54,507,4312,9,155,88,170,164,258,1156,1898,4,9368,520,0,1
256,5940,1482,859,1002,125,135,219,1607,16,219,134,251,235,385,1766,3032,9,27804,1544,1,1
141,3291,77,34,69,0,0,8,77,3,24,16,29,27,45,114,213,1,387,21,0,1
141,3291,712,438,573,51,9,84,763,14,102,71,128,116,199,733,1364,8,11988,666,0,1
98,4059,1289,550,1043,56,32,155,1345,10,167,93,185,177,278,1266,2075,5,11498,638,0,1
40,2477,652,304,544,16,6,88,668,6,89,51,101,95,152,591,998,3,3399,188,0,1
35,1016,339,213,244,17,9,65,356,10,42,26,48,52,74,259,421,5,2410,133,0,1
62,2819,1293,570,1093,25,15,163,1318,10,195,123,241,205,364,1516,2795,6,17273,959,0,1
64,2839,1293,570,1093,25,15,163,1318,10,195,123,241,205,364,1516,2795,6,17273,959,0,0
92,1957,1043,504,840,53,9,147,1096,9,180,112,198,189,310,1377,2344,4,11604,644,0,0
92,1957,383,288,292,26,6,62,409,11,65,38,67,76,105,429,656,5,3719,206,0,0
96,3993,1289,550,1043,56,32,155,1345,10,167,93,185,177,278,1266,2075,5,11498,638,0,0
34,986,339,213,244,17,9,65,356,10,42,26,48,52,74,259,421,5,2410,133,0,0
64,2851,1293,570,1093,25,15,163,1318,10,195,123,241,205,364,1516,2795,6,17273,959,0,0
256,5940,4293,999,3693,19,54,507,4312,9,155,88,170,164,258,1156,1898,4,9368,520,0,0
256,5940,1482,859,1002,125,135,219,1607,16,219,134,251,235,385,1766,3032,9,27804,1544,1,0
141,3291,77,34,69,0,0,8,77,3,24,16,29,27,45,114,213,1,387,21,0,0
141,3291,712,438,573,51,9,84,763,14,102,71,128,116,199,733,1364,8,11988,666,0,0
98,4059,1289,550,1043,56,32,155,1345,10,167,93,185,177,278,1266,2075,5,11498,638,0,0
40,2477,652,304,544,16,6,88,668,6,89,51,101,95,152,591,998,3,3399,188,0,0
96,3982,1289,550,1043,56,32,155,1345,10,167,93,185,177,278,1266,2075,5,11498,638,0,0
21,521,205,80,86,16,53,53,221,7,18,10,19,25,29,94,134,3,497,27,0,0
85,3247,1043,504,840,53,9,147,1096,9,180,112,198,189,310,1377,2344,4,11604,644,0,0
179,7896,139,89,101,2,0,35,141,7,54,34,62,61,96,330,569,4,2287,127,0,0
179,7896,7,5,5,0,0,2,7,1,2,1,2,3,3,2,4,0,2,0,0,0
50,1112,91,45,69,0,3,18,91,3,9,6,10,12,16,33,57,1,95,5,0,1
50,1112,367,234,237,17,34,68,384,16,55,34,61,71,95,381,584,8,5183,287,0,1
23,1181,442,244,305,14,16,103,456,11,68,45,75,79,120,452,756,6,4588,254,0,1
20,522,205,80,86,16,53,53,221,7,18,10,19,25,29,94,134,3,497,27,0,0
141,3301,77,34,69,0,0,8,77,3,24,16,29,27,45,114,213,1,387,21,0,1
141,3301,712,438,573,51,9,84,763,14,102,71,128,116,199,733,1364,8,11988,666,0,1
84,3226,1043,504,840,53,9,147,1096,9,180,112,198,189,310,1377,2344,4,11604,644,0,1
2,173,42,7,35,4,0,5,46,1,2,1,2,3,3,2,4,0,2,0,0,1
2,173,11,6,10,0,0,1,11,2,4,2,4,6,6,10,15,1,15,0,0,1
27,1218,442,244,305,14,16,103,456,11,68,45,75,79,120,452,756,6,4588,254,0,0
142,3311,77,34,69,0,0,8,77,3,24,16,29,27,45,114,213,1,387,21,0,0
142,3311,712,438,573,51,9,84,763,14,102,71,128,116,199,733,1364,8,11988,666,0,0
180,5393,1660,832,1314,41,38,274,1701,20,312,209,395,332,604,2671,5058,12,64042,3557,1,0
180,5393,1057,646,719,113,100,145,1170,18,215,134,248,233,382,1740,3004,10,31186,1732,1,0
50,1112,91,45,69,0,3,18,91,3,9,6,10,12,16,33,57,1,95,5,0,0
50,1112,367,234,237,17,34,68,384,16,55,34,61,71,95,381,584,8,5183,287,0,0
1,86,42,7,35,4,0,5,46,1,2,1,2,3,3,2,4,0,2,0,0,1
1,86,11,6,10,0,0,1,11,2,4,2,4,6,6,10,15,1,15,0,0,1
84,3226,1043,504,840,53,9,147,1096,9,180,112,198,189,310,1377,2344,4,11604,644,0,0
1,86,42,7,35,4,0,5,46,1,2,1,2,3,3,2,4,0,2,0,0,0
1,86,11,6,10,0,0,1,11,2,4,2,4,6,6,10,15,1,15,0,0,0
180,5397,1660,832,1314,41,38,274,1701,20,312,209,395,332,604,2671,5058,12,64042,3557,1,0
180,5397,1057,646,719,113,100,145,1170,18,215,134,248,233,382,1740,3004,10,31186,1732,1,0
256,5938,4293,999,3693,19,54,507,4312,9,155,88,170,164,258,1156,1898,4,9368,520,0,0
256,5938,1482,859,1002,125,135,219,1607,16,219,134,251,235,385,1766,3032,9,27804,1544,1,0
142,3309,77,34,69,0,0,8,77,3,24,16,29,27,45,114,213,1,387,21,0,0
142,3309,712,438,573,51,9,84,763,14,102,71,128,116,199,733,1364,8,11988,666,0,0
244,5826,722,423,573,19,0,135,741,12,172,101,199,184,300,1320,2257,6,15668,870,0,0
244,5826,1508,847,911,44,250,301,1552,14,148,88,169,162,257,1120,1886,7,15077,837,0,0
99,4081,1289,550,1043,56,32,155,1345,10,167,93,185,177,278,1266,2075,5,11498,638,0,0
179,7977,139,89,101,2,0,35,141,7,54,34,62,61,96,330,569,4,2287,127,0,0
179,7977,7,5,5,0,0,2,7,1,2,1,2,3,3,2,4,0,2,0,0,0
224,4845,1943,715,1694,26,18,214,1969,12,185,120,237,197,357,1436,2721,7,20915,1161,0,0
224,4845,1168,838,957,57,25,144,1225,19,348,224,416,367,640,3018,5452,11,61921,3440,1,0
218,4718,2,2,2,0,0,0,2,0,0,0,0,0,0,0,0,0,0,0,0,0
218,4718,99,48,90,1,3,5,100,0,0,0,0,0,0,0,0,0,0,0,0,0
218,4718,8,5,5,2,0,1,10,0,0,0,0,0,0,0,0,0,0,0,0,0
218,4718,1217,716,841,84,126,174,1301,14,185,118,215,199,333,1446,2542,8,20687,1149,0,0
218,4718,160,89,115,0,13,31,160,7,15,11,17,22,28,78,124,3,495,27,0,0
218,4718,10,10,9,9,0,0,19,0,0,0,0,0,0,0,0,0,0,0,0,0
218,4718,173,84,99,8,29,36,181,5,12,7,13,17,20,54,81,2,221,12,0,0
218,4718,3,1,1,3,0,0,6,0,0,0,0,0,0,0,0,0,0,0,0,0
25,412,219,78,157,11,5,46,230,3,24,20,34,27,54,114,256,2,545,30,0,0
25,412,108,64,79,9,0,20,117,5,15,11,19,20,30,70,129,3,410,22,0,0
10,454,219,78,157,11,5,46,230,3,24,20,34,27,54,114,256,2,545,30,0,0
25,418,219,78,157,11,5,46,230,3,24,20,34,27,54,114,256,2,545,30,0,0
25,418,108,64,79,9,0,20,117,5,15,11,19,20,30,70,129,3,410,22,0,0
9,441,219,78,157,11,5,46,230,3,24,20,34,27,54,114,256,2,545,30,0,0
98,2666,1523,757,1297,19,12,193,1542,12,193,117,230,205,347,1508,2664,7,19053,1058,0,0
98,2666,701,378,504,33,58,109,734,13,110,68,126,123,194,794,1346,7,10027,557,0,0
96,4691,1523,757,1297,19,12,193,1542,12,193,117,230,205,347,1508,2664,7,19053,1058,0,0
53,1164,91,45,69,0,3,18,91,3,9,6,10,12,16,33,57,1,95,5,0,1
53,1164,367,234,237,17,34,68,384,16,55,34,61,71,95,381,584,8,5183,287,0,1
27,1248,442,244,305,14,16,103,456,11,68,45,75,79,120,452,756,6,4588,254,0,1
29,1261,442,244,305,14,16,103,456,11,68,45,75,79,120,452,756,6,4588,254,0,0
30,1268,442,244,305,14,16,103,456,11,68,45,75,79,120,452,756,6,4588,254,0,0
25,397,219,78,157,11,5,46,230,3,24,20,34,27,54,114,256,2,545,30,0,0
25,397,108,64,79,9,0,20,117,5,15,11,19,20,30,70,129,3,410,22,0,0
53,1164,91,45,69,0,3,18,91,3,9,6,10,12,16,33,57,1,95,5,0,0
53,1164,367,234,237,17,34,68,384,16,55,34,61,71,95,381,584,8,5183,287,0,0
224,4857,1943,715,1694,26,18,214,1969,12,185,120,237,197,357,1436,2721,7,20915,1161,0,0
224,4857,1168,838,957,57,25,144,1225,19,348,224,416,367,640,3018,5452,11,61921,3440,1,0
41,843,386,256,301,16,9,68,402,4,59,35,69,63,104,355,621,2,1453,80,0,1
41,843,264,131,164,11,41,46,275,6,38,22,40,44,62,214,338,3,1068,59,0,1
43,1873,386,256,301,16,9,68,402,4,59,35,69,63,104,355,621,2,1453,80,0,1
43,898,386,256,301,16,9,68,402,4,59,35,69,63,104,355,621,2,1453,80,0,1
43,898,264,131,164,11,41,46,275,6,38,22,40,44,62,214,338,3,1068,59,0,1
68,1356,207,111,150,11,0,50,218,5,26,19,36,31,55,133,272,3,943,52,0,0
68,1356,410,198,237,31,55,97,441,11,63,38,72,74,110,414,683,6,4293,238,0,0
75,3898,1296,573,1062,40,33,157,1336,8,201,118,231,209,349,1561,2689,4,12365,686,0,0
43,898,386,256,301,16,9,68,402,4,59,35,69,63,104,355,621,2,1453,80,0,0
43,898,264,131,164,11,41,46,275,6,38,22,40,44,62,214,338,3,1068,59,0,0
43,1873,386,256,301,16,9,68,402,4,59,35,69,63,104,355,621,2,1453,80,0,0
29,724,601,196,481,2,23,85,603,8,63,36,72,71,108,400,664,4,3036,168,0,0
29,724,156,79,106,5,16,28,161,5,14,8,15,19,23,64,97,2,261,14,0,0
41,1472,601,196,481,2,23,85,603,8,63,36,72,71,108,400,664,4,3036,168,0,0
94,2434,773,422,505,30,103,129,803,14,77,46,83,91,129,535,839,7,6334,351,0,0
34,2285,1157,318,931,29,22,177,1186,6,104,63,125,110,188,712,1274,3,4596,255,0,0
256,5953,4293,999,3693,19,54,507,4312,9,155,88,170,164,258,1156,1898,4,9368,520,0,0
256,5953,1482,859,1002,125,135,219,1607,16,219,134,251,235,385,1766,3032,9,27804,1544,1,0
3,33,15,9,9,0,0,6,15,0,0,0,0,0,0,0,0,0,0,0,0,0
180,8007,139,89,101,2,0,35,141,7,54,34,62,61,96,330,569,4,2287,127,0,0
180,8007,7,5,5,0,0,2,7,1,2,1,2,3,3,2,4,0,2,0,0,0
258,5960,4293,999,3693,19,54,507,4312,9,155,88,170,164,258,1156,1898,4,9368,520,0,1
258,5960,1482,859,1002,125,135,219,1607,16,219,134,251,235,385,1766,3032,9,27804,1544,1,1
25,1183,75,38,59,1,3,12,76,2,4,2,4,6,6,10,15,1,15,0,0,1
2,18,10,6,6,0,0,4,10,0,0,0,0,0,0,0,0,0,0,0,0,1
258,5960,4293,999,3693,19,54,507,4312,9,155,88,170,164,258,1156,1898,4,9368,520,0,0
258,5960,1482,859,1002,125,135,219,1607,16,219,134,251,235,385,1766,3032,9,27804,1544,1,0
25,1183,75,38,59,1,3,12,76,2,4,2,4,6,6,10,15,1,15,0,0,0
2,18,10,6,6,0,0,4,10,0,0,0,0,0,0,0,0,0,0,0,0,0
53,1166,91,45,69,0,3,18,91,3,9,6,10,12,16,33,57,1,95,5,0,0
53,1166,367,234,237,17,34,68,384,16,55,34,61,71,95,381,584,8,5183,287,0,0
218,4720,2,2,2,0,0,0,2,0,0,0,0,0,0,0,0,0,0,0,0,0
218,4720,99,48,90,1,3,5,100,0,0,0,0,0,0,0,0,0,0,0,0,0
218,4720,8,5,5,2,0,1,10,0,0,0,0,0,0,0,0,0,0,0,0,0
218,4720,1217,716,841,84,126,174,1301,14,185,118,215,199,333,1446,2542,8,20687,1149,0,0
218,4720,160,89,115,0,13,31,160,7,15,11,17,22,28,78,124,3,495,27,0,0
218,4720,10,10,9,9,0,0,19,0,0,0,0,0,0,0,0,0,0,0,0,0
218,4720,173,84,99,8,29,36,181,5,12,7,13,17,20,54,81,2,221,12,0,0
218,4720,3,1,1,3,0,0,6,0,0,0,0,0,0,0,0,0,0,0,0,0
40,2509,652,304,544,16,6,88,668,6,89,51,101,95,152,591,998,3,3399,188,0,0
52,1137,91,45,69,0,3,18,91,3,9,6,10,12,16,33,57,1,95,5,0,0
52,1137,367,234,237,17,34,68,384,16,55,34,61,71,95,381,584,8,5183,287,0,0
227,4920,1943,715,1694,26,18,214,1969,12,185,120,237,197,357,1436,2721,7,20915,1161,0,1
227,4920,1168,838,957,57,25,144,1225,19,348,224,416,367,640,3018,5452,11,61921,3440,1,1
218,4727,2,2,2,0,0,0,2,0,0,0,0,0,0,0,0,0,0,0,0,0
218,4727,99,48,90,1,3,5,100,0,0,0,0,0,0,0,0,0,0,0,0,0
218,4727,8,5,5,2,0,1,10,0,0,0,0,0,0,0,0,0,0,0,0,0
218,4727,1217,716,841,84,126,174,1301,14,185,118,215,199,333,1446,2542,8,20687,1149,0,0
218,4727,160,89,115,0,13,31,160,7,15,11,17,22,28,78,124,3,495,27,0,0
218,4727,10,10,9,9,0,0,19,0,0,0,0,0,0,0,0,0,0,0,0,0
218,4727,173,84,99,8,29,36,181,5,12,7,13,17,20,54,81,2,221,12,0,0
218,4727,3,1,1,3,0,0,6,0,0,0,0,0,0,0,0,0,0,0,0,0
227,4920,1943,715,1694,26,18,214,1969,12,185,120,237,197,357,1436,2721,7,20915,1161,0,0
227,4920,1168,838,957,57,25,144,1225,19,348,224,416,367,640,3018,5452,11,61921,3440,1,0
258,5975,4293,999,3693,19,54,507,4312,9,155,88,170,164,258,1156,1898,4,9368,520,0,0
258,5975,1482,859,1002,125,135,219,1607,16,219,134,251,235,385,1766,3032,9,27804,1544,1,0
52,1139,91,45,69,0,3,18,91,3,9,6,10,12,16,33,57,1,95,5,0,0
52,1139,367,234,237,17,34,68,384,16,55,34,61,71,95,381,584,8,5183,287,0,0
31,934,339,213,244,17,9,65,356,10,42,26,48,52,74,259,421,5,2410,133,0,0
64,2859,1293,570,1093,25,15,163,1318,10,195,123,241,205,364,1516,2795,6,17273,959,0,0
31,932,339,213,244,17,9,65,356,10,42,26,48,52,74,259,421,5,2410,133,0,0
223,4835,1943,715,1694,26,18,214,1969,12,185,120,237,197,357,1436,2721,7,20915,1161,0,0
223,4835,1168,838,957,57,25,144,1225,19,348,224,416,367,640,3018,5452,11,61921,3440,1,0
41,1474,601,196,481,2,23,85,603,8,63,36,72,71,108,400,664,4,3036,168,0,0
218,4736,2,2,2,0,0,0,2,0,0,0,0,0,0,0,0,0,0,0,0,0
218,4736,99,48,90,1,3,5,100,0,0,0,0,0,0,0,0,0,0,0,0,0
218,4736,8,5,5,2,0,1,10,0,0,0,0,0,0,0,0,0,0,0,0,0
218,4736,1217,716,841,84,126,174,1301,14,185,118,215,199,333,1446,2542,8,20687,1149,0,0
218,4736,160,89,115,0,13,31,160,7,15,11,17,22,28,78,124,3,495,27,0,0
218,4736,10,10,9,9,0,0,19,0,0,0,0,0,0,0,0,0,0,0,0,0
218,4736,173,84,99,8,29,36,181,5,12,7,13,17,20,54,81,2,221,12,0,0
218,4736,3,1,1,3,0,0,6,0,0,0,0,0,0,0,0,0,0,0,0,0
218,4740,2,2,2,0,0,0,2,0,0,0,0,0,0,0,0,0,0,0,0,0
218,4740,99,48,90,1,3,5,100,0,0,0,0,0,0,0,0,0,0,0,0,0
218,4740,8,5,5,2,0,1,10,0,0,0,0,0,0,0,0,0,0,0,0,0
218,4740,1217,716,841,84,126,174,1301,14,185,118,215,199,333,1446,2542,8,20687,1149,0,0
218,4740,160,89,115,0,13,31,160,7,15,11,17,22,28,78,124,3,495,27,0,0
218,4740,10,10,9,9,0,0,19,0,0,0,0,0,0,0,0,0,0,0,0,0
218,4740,173,84,99,8,29,36,181,5,12,7,13,17,20,54,81,2,221,12,0,0
218,4740,3,1,1,3,0,0,6,0,0,0,0,0,0,0,0,0,0,0,0,0
1,319,382,65,130,157,2,92,539,4,10,5,10,14,15,41,57,2,114,6,0,1
60,1078,282,196,195,3,0,86,285,8,130,71,141,138,212,936,1507,4,6538,363,0,1
12,515,124,78,88,2,3,26,126,4,13,7,13,17,20,56,81,2,163,9,0,1
11,242,19,8,11,5,0,4,24,2,5,3,6,7,9,13,25,1,30,1,0,1
11,242,102,59,69,5,3,24,107,6,22,15,28,28,43,113,206,3,789,43,0,1
11,242,106,40,36,3,49,17,109,8,17,13,23,25,36,93,167,5,904,50,0,1
222,4859,182,127,129,0,0,53,182,5,39,21,42,44,63,217,343,2,926,51,0,1
222,4859,1165,710,800,67,119,181,1232,18,243,153,282,261,435,2000,3492,10,36473,2026,1,1
68,1565,773,419,590,28,0,166,801,10,204,113,217,214,330,1598,2554,5,13587,754,0,1
68,1565,421,273,302,44,34,57,465,17,81,59,107,98,166,583,1098,11,12329,684,0,1
26,529,2,2,2,0,0,0,2,0,0,0,0,0,0,0,0,0,0,0,0,1
26,529,99,48,90,1,3,5,100,0,0,0,0,0,0,0,0,0,0,0,0,1
26,529,8,5,5,2,0,1,10,0,0,0,0,0,0,0,0,0,0,0,0,1
26,529,1217,716,841,84,126,174,1301,14,185,118,215,199,333,1446,2542,8,20687,1149,0,1
26,529,160,89,115,0,13,31,160,7,15,11,17,22,28,78,124,3,495,27,0,1
26,529,10,10,9,9,0,0,19,0,0,0,0,0,0,0,0,0,0,0,0,1
26,529,173,84,99,8,29,36,181,5,12,7,13,17,20,54,81,2,221,12,0,1
26,529,3,1,1,3,0,0,6,0,0,0,0,0,0,0,0,0,0,0,0,1
180,5401,1660,832,1314,41,38,274,1701,20,312,209,395,332,604,2671,5058,12,64042,3557,1,1
180,5401,1057,646,719,113,100,145,1170,18,215,134,248,233,382,1740,3004,10,31186,1732,1,1
17,348,95,58,50,9,16,20,104,12,33,24,45,45,69,209,378,8,3100,172,0,1
89,1829,477,336,357,30,23,73,507,16,194,134,250,210,384,1538,2962,10,30538,1696,0,1
76,1743,996,429,845,24,10,117,1020,7,76,50,88,83,138,494,879,4,3565,198,0,1
76,1743,456,277,329,12,42,72,468,13,85,50,97,98,147,592,972,7,7212,400,0,1
154,3265,1513,682,1277,25,13,200,1538,11,199,116,219,210,335,1557,2584,6,15641,868,0,1
154,3265,819,519,539,24,98,155,843,15,96,57,106,111,163,690,1107,8,9171,509,0,1
68,1364,207,111,150,11,0,50,218,5,26,19,36,31,55,133,272,3,943,52,0,1
68,1364,410,198,237,31,55,97,441,11,63,38,72,74,110,414,683,6,4293,238,0,1
218,4738,2,2,2,0,0,0,2,0,0,0,0,0,0,0,0,0,0,0,0,1
218,4738,99,48,90,1,3,5,100,0,0,0,0,0,0,0,0,0,0,0,0,1
218,4738,8,5,5,2,0,1,10,0,0,0,0,0,0,0,0,0,0,0,0,1
218,4738,1217,716,841,84,126,174,1301,14,185,118,215,199,333,1446,2542,8,20687,1149,0,1
218,4738,160,89,115,0,13,31,160,7,15,11,17,22,28,78,124,3,495,27,0,1
218,4738,10,10,9,9,0,0,19,0,0,0,0,0,0,0,0,0,0,0,0,1
218,4738,173,84,99,8,29,36,181,5,12,7,13,17,20,54,81,2,221,12,0,1
218,4738,3,1,1,3,0,0,6,0,0,0,0,0,0,0,0,0,0,0,0,1
97,1999,463,295,324,28,62,57,491,12,134,82,154,146,236,989,1696,6,11700,650,0,1
31,936,339,213,244,17,9,65,356,10,42,26,48,52,74,259,421,5,2410,133,0,1
85,2182,1455,414,1257,16,76,112,1471,5,41,23,46,46,69,231,381,2,1069,59,0,1
85,2182,669,365,481,22,61,110,691,15,103,63,122,118,185,747,1273,8,11311,628,0,1
256,6014,4293,999,3693,19,54,507,4312,9,155,88,170,164,258,1156,1898,4,9368,520,0,1
256,6014,1482,859,1002,125,135,219,1607,16,219,134,251,235,385,1766,3032,9,27804,1544,1,1
6,140,44,22,19,0,19,6,44,2,10,6,12,12,18,35,64,1,77,4,0,1
27,968,74,35,59,1,0,14,75,3,14,7,14,17,21,58,85,1,128,7,0,1
27,968,245,125,200,5,7,34,250,7,30,17,34,37,51,166,265,3,1053,58,0,1
98,2670,1523,757,1297,19,12,193,1542,12,193,117,230,205,347,1508,2664,7,19053,1058,0,1
98,2670,701,378,504,33,58,109,734,13,110,68,126,123,194,794,1346,7,10027,557,0,1
94,2438,773,422,505,30,103,129,803,14,77,46,83,91,129,535,839,7,6334,351,0,1
142,3319,77,34,69,0,0,8,77,3,24,16,29,27,45,114,213,1,387,21,0,1
142,3319,712,438,573,51,9,84,763,14,102,71,128,116,199,733,1364,8,11988,666,0,1
24,628,2,2,2,0,0,0,2,0,0,0,0,0,0,0,0,0,0,0,0,1
24,628,99,48,90,1,3,5,100,0,0,0,0,0,0,0,0,0,0,0,0,1
24,628,8,5,5,2,0,1,10,0,0,0,0,0,0,0,0,0,0,0,0,1
24,628,1217,716,841,84,126,174,1301,14,185,118,215,199,333,1446,2542,8,20687,1149,0,1
24,628,160,89,115,0,13,31,160,7,15,11,17,22,28,78,124,3,495,27,0,1
24,628,10,10,9,9,0,0,19,0,0,0,0,0,0,0,0,0,0,0,0,1
24,628,173,84,99,8,29,36,181,5,12,7,13,17,20,54,81,2,221,12,0,1
24,628,3,1,1,3,0,0,6,0,0,0,0,0,0,0,0,0,0,0,0,1
30,664,125,97,103,3,0,19,128,9,25,17,27,34,44,144,223,4,1087,60,0,1
23,367,102,57,55,5,16,25,107,5,17,10,18,22,28,81,124,2,330,18,0,1
88,1899,402,202,227,24,74,80,426,12,52,33,61,64,94,339,564,7,3969,220,0,1
52,1075,447,308,343,6,5,95,453,7,96,59,111,103,170,651,1136,4,4600,255,0,1
52,1075,322,174,179,16,74,51,338,10,41,26,46,51,72,252,408,5,2291,127,0,1
88,1993,53,23,39,0,0,13,53,2,8,4,8,10,12,26,39,1,39,2,0,1
88,1993,515,298,307,33,80,99,548,12,63,44,77,75,121,419,753,7,5527,307,0,1
23,389,424,94,331,4,0,89,428,1,5,5,5,6,10,11,25,0,12,0,0,1
23,389,38,23,23,6,0,8,44,3,11,7,11,14,18,42,68,1,102,5,0,1
20,526,205,80,86,16,53,53,221,7,18,10,19,25,29,94,134,3,497,27,0,1
17,523,184,100,137,2,15,30,186,6,38,20,39,44,59,214,322,3,991,55,0,1
17,523,103,65,74,8,5,16,111,7,17,9,17,24,26,89,119,3,417,23,0,1
53,1178,91,45,69,0,3,18,91,3,9,6,10,12,16,33,57,1,95,5,0,1
53,1178,367,234,237,17,34,68,384,16,55,34,61,71,95,381,584,8,5183,287,0,1
244,5842,722,423,573,19,0,135,741,12,172,101,199,184,300,1320,2257,6,15668,870,0,1
244,5842,1508,847,911,44,250,301,1552,14,148,88,169,162,257,1120,1886,7,15077,837,0,1
305,6844,72,33,56,0,4,12,72,1,1,1,1,2,2,0,2,0,1,0,0,1
305,6844,1454,835,1044,76,110,219,1530,17,275,158,296,292,454,2297,3718,9,34017,1889,1,1
91,1836,757,253,292,73,244,162,830,13,61,38,67,74,105,409,651,7,4654,258,0,1
43,902,386,256,301,16,9,68,402,4,59,35,69,63,104,355,621,2,1453,80,0,1
43,902,264,131,164,11,41,46,275,6,38,22,40,44,62,214,338,3,1068,59,0,1
28,707,466,257,367,18,25,50,484,7,126,86,171,133,257,898,1813,4,8612,478,0,1
28,707,507,281,342,29,59,88,536,10,53,29,57,63,86,336,514,5,2764,153,0,1
92,1975,1043,504,840,53,9,147,1096,9,180,112,198,189,310,1377,2344,4,11604,644,0,1
92,1975,383,288,292,26,6,62,409,11,65,38,67,76,105,429,656,5,3719,206,0,1
20,420,294,64,250,0,0,43,294,1,20,10,20,21,30,86,131,0,65,3,0,1
20,420,78,46,62,3,0,14,81,3,8,4,8,11,12,28,41,1,62,3,0,1
5,123,110,30,77,3,13,16,113,4,21,15,30,25,45,100,208,2,597,33,0,1
5,123,28,15,21,1,0,6,29,0,0,0,0,0,0,0,0,0,0,0,0,1
70,1394,1178,367,1042,6,15,115,1184,9,94,51,95,103,146,644,976,4,4439,246,0,1
70,1394,177,108,140,8,0,27,185,6,30,16,32,36,48,162,248,3,794,44,0,1
223,4852,1943,715,1694,26,18,214,1969,12,185,120,237,197,357,1436,2721,7,20915,1161,0,1
223,4852,1168,838,957,57,25,144,1225,19,348,224,416,367,640,3018,5452,11,61921,3440,1,1
19,682,442,244,305,14,16,103,456,11,68,45,75,79,120,452,756,6,4588,254,0,1
19,682,182,102,99,11,40,35,193,3,11,6,11,14,17,42,64,1,97,5,0,1
62,1255,1098,241,925,5,10,155,1103,7,46,25,49,53,74,273,423,3,1580,87,0,1
62,1255,282,202,222,14,2,44,296,8,42,24,43,50,67,250,378,4,1548,86,0,1
29,728,601,196,481,2,23,85,603,8,63,36,72,71,108,400,664,4,3036,168,0,1
29,728,156,79,106,5,16,28,161,5,14,8,15,19,23,64,97,2,261,14,0,1
99,4089,1289,550,1043,56,32,155,1345,10,167,93,185,177,278,1266,2075,5,11498,638,0,1
35,1083,182,127,129,0,0,53,182,5,39,21,42,44,63,217,343,2,926,51,0,1
152,7159,1392,870,1177,35,17,170,1427,14,494,280,531,508,811,4473,7289,7,54850,3047,2,1
90,2889,773,419,590,28,0,166,801,10,204,113,217,214,330,1598,2554,5,13587,754,0,1
24,1149,75,38,59,1,3,12,76,2,4,2,4,6,6,10,15,1,15,0,0,1
2,51,14,9,9,0,0,5,14,0,0,0,0,0,0,0,0,0,0,0,0,1
1,134,149,67,118,4,0,27,153,1,17,14,28,18,42,69,175,0,144,8,0,1
34,2285,1157,318,931,29,22,177,1186,6,104,63,125,110,188,712,1274,3,4596,255,0,1
63,4333,520,294,400,33,13,81,553,10,261,204,367,271,571,2128,4614,7,32445,1802,1,1
180,8011,139,89,101,2,0,35,141,7,54,34,62,61,96,330,569,4,2287,127,0,1
180,8011,7,5,5,0,0,2,7,1,2,1,2,3,3,2,4,0,2,0,0,1
138,6148,1782,648,1425,9,47,279,1791,8,171,97,189,179,286,1292,2140,4,9462,525,0,1
23,583,102,59,69,5,3,24,107,6,22,15,28,28,43,113,206,3,789,43,0,1
166,4983,1660,832,1314,41,38,274,1701,20,312,209,395,332,604,2671,5058,12,64042,3557,1,1
44,3230,996,429,845,24,10,117,1020,7,76,50,88,83,138,494,879,4,3565,198,0,1
128,5336,1513,682,1277,25,13,200,1538,11,199,116,219,210,335,1557,2584,6,15641,868,0,1
75,3910,1296,573,1062,40,33,157,1336,8,201,118,231,209,349,1561,2689,4,12365,686,0,1
19,453,207,111,150,11,0,50,218,5,26,19,36,31,55,133,272,3,943,52,0,1
92,4718,1457,730,1242,11,6,188,1468,10,292,166,329,302,495,2424,4078,5,22973,1276,1,1
40,2521,652,304,544,16,6,88,668,6,89,51,101,95,152,591,998,3,3399,188,0,1
70,3216,1455,414,1257,16,76,112,1471,5,41,23,46,46,69,231,381,2,1069,59,0,1
2,79,7,6,5,0,0,2,7,1,1,1,2,2,3,0,3,1,3,0,0,1
8,275,74,35,59,1,0,14,75,3,14,7,14,17,21,58,85,1,128,7,0,1
96,4695,1523,757,1297,19,12,193,1542,12,193,117,230,205,347,1508,2664,7,19053,1058,0,1
97,4232,1020,354,843,12,15,144,1032,8,134,77,144,142,221,970,1580,4,6792,377,0,1
42,1903,447,308,343,6,5,95,453,7,96,59,111,103,170,651,1136,4,4600,255,0,1
21,662,424,94,331,4,0,89,428,1,5,5,5,6,10,11,25,0,12,0,0,1
38,2306,334,251,279,10,4,40,344,5,127,74,143,132,217,899,1528,2,4303,239,0,1
12,497,184,100,137,2,15,30,186,6,38,20,39,44,59,214,322,3,991,55,0,1
64,2863,1293,570,1093,25,15,163,1318,10,195,123,241,205,364,1516,2795,6,17273,959,0,1
33,1897,384,251,317,7,8,52,391,11,70,44,84,81,128,467,811,6,5355,297,0,1
47,2248,722,423,573,19,0,135,741,12,172,101,199,184,300,1320,2257,6,15668,870,0,1
43,1877,386,256,301,16,9,68,402,4,59,35,69,63,104,355,621,2,1453,80,0,1
16,1245,215,129,180,6,0,29,221,8,65,43,72,73,115,415,711,4,3153,175,0,1
84,3236,1043,504,840,53,9,147,1096,9,180,112,198,189,310,1377,2344,4,11604,644,0,1
14,534,295,56,236,0,4,54,295,2,9,5,10,11,15,30,51,1,57,3,0,1
30,1245,373,158,315,8,0,51,381,5,76,44,79,81,123,486,779,2,2026,112,0,1
77,3225,1178,367,1042,6,15,115,1184,9,94,51,95,103,146,644,976,4,4439,246,0,1
99,5086,1943,715,1694,26,18,214,1969,12,185,120,237,197,357,1436,2721,7,20915,1161,0,1
30,1272,442,244,305,14,16,103,456,11,68,45,75,79,120,452,756,6,4588,254,0,1
51,1917,1098,241,925,5,10,155,1103,7,46,25,49,53,74,273,423,3,1580,87,0,1
40,1147,339,213,244,17,9,65,356,10,42,26,48,52,74,259,421,5,2410,133,0,1
53,629,647,139,84,35,284,233,682,0,0,0,0,0,0,0,0,0,0,0,0,1
64,2924,1293,570,1093,25,15,163,1318,10,195,123,241,205,364,1516,2795,6,17273,959,0,1
40,1155,339,213,244,17,9,65,356,10,42,26,48,52,74,259,421,5,2410,133,0,0
53,633,647,139,84,35,284,233,682,0,0,0,0,0,0,0,0,0,0,0,0,0
64,2924,1293,570,1093,25,15,163,1318,10,195,123,241,205,364,1516,2795,6,17273,959,0,0
12,515,124,78,88,2,3,26,126,4,13,7,13,17,20,56,81,2,163,9,0,0
11,242,19,8,11,5,0,4,24,2,5,3,6,7,9,13,25,1,30,1,0,0
11,242,102,59,69,5,3,24,107,6,22,15,28,28,43,113,206,3,789,43,0,0
11,242,106,40,36,3,49,17,109,8,17,13,23,25,36,93,167,5,904,50,0,0
222,4859,182,127,129,0,0,53,182,5,39,21,42,44,63,217,343,2,926,51,0,0
222,4859,1165,710,800,67,119,181,1232,18,243,153,282,261,435,2000,3492,10,36473,2026,1,0
68,1565,773,419,590,28,0,166,801,10,204,113,217,214,330,1598,2554,5,13587,754,0,0
68,1565,421,273,302,44,34,57,465,17,81,59,107,98,166,583,1098,11,12329,684,0,0
26,529,2,2,2,0,0,0,2,0,0,0,0,0,0,0,0,0,0,0,0,0
26,529,99,48,90,1,3,5,100,0,0,0,0,0,0,0,0,0,0,0,0,0
26,529,8,5,5,2,0,1,10,0,0,0,0,0,0,0,0,0,0,0,0,0
26,529,1217,716,841,84,126,174,1301,14,185,118,215,199,333,1446,2542,8,20687,1149,0,0
26,529,160,89,115,0,13,31,160,7,15,11,17,22,28,78,124,3,495,27,0,0
26,529,10,10,9,9,0,0,19,0,0,0,0,0,0,0,0,0,0,0,0,0
26,529,173,84,99,8,29,36,181,5,12,7,13,17,20,54,81,2,221,12,0,0
26,529,3,1,1,3,0,0,6,0,0,0,0,0,0,0,0,0,0,0,0,0
17,348,95,58,50,9,16,20,104,12,33,24,45,45,69,209,378,8,3100,172,0,0
89,1829,477,336,357,30,23,73,507,16,194,134,250,210,384,1538,2962,10,30538,1696,0,0
76,1743,996,429,845,24,10,117,1020,7,76,50,88,83,138,494,879,4,3565,198,0,0
76,1743,456,277,329,12,42,72,468,13,85,50,97,98,147,592,972,7,7212,400,0,0
154,3265,1513,682,1277,25,13,200,1538,11,199,116,219,210,335,1557,2584,6,15641,868,0,0
154,3265,819,519,539,24,98,155,843,15,96,57,106,111,163,690,1107,8,9171,509,0,0
68,1364,207,111,150,11,0,50,218,5,26,19,36,31,55,133,272,3,943,52,0,0
68,1364,410,198,237,31,55,97,441,11,63,38,72,74,110,414,683,6,4293,238,0,0
218,4738,2,2,2,0,0,0,2,0,0,0,0,0,0,0,0,0,0,0,0,0
218,4738,99,48,90,1,3,5,100,0,0,0,0,0,0,0,0,0,0,0,0,0
218,4738,8,5,5,2,0,1,10,0,0,0,0,0,0,0,0,0,0,0,0,0
218,4738,1217,716,841,84,126,174,1301,14,185,118,215,199,333,1446,2542,8,20687,1149,0,0
218,4738,160,89,115,0,13,31,160,7,15,11,17,22,28,78,124,3,495,27,0,0
218,4738,10,10,9,9,0,0,19,0,0,0,0,0,0,0,0,0,0,0,0,0
218,4738,173,84,99,8,29,36,181,5,12,7,13,17,20,54,81,2,221,12,0,0
218,4738,3,1,1,3,0,0,6,0,0,0,0,0,0,0,0,0,0,0,0,0
31,936,339,213,244,17,9,65,356,10,42,26,48,52,74,259,421,5,2410,133,0,0
85,2182,1455,414,1257,16,76,112,1471,5,41,23,46,46,69,231,381,2,1069,59,0,0
85,2182,669,365,481,22,61,110,691,15,103,63,122,118,185,747,1273,8,11311,628,0,0
256,6014,4293,999,3693,19,54,507,4312,9,155,88,170,164,258,1156,1898,4,9368,520,0,0
256,6014,1482,859,1002,125,135,219,1607,16,219,134,251,235,385,1766,3032,9,27804,1544,1,0
6,140,44,22,19,0,19,6,44,2,10,6,12,12,18,35,64,1,77,4,0,0
27,968,74,35,59,1,0,14,75,3,14,7,14,17,21,58,85,1,128,7,0,0
27,968,245,125,200,5,7,34,250,7,30,17,34,37,51,166,265,3,1053,58,0,0
94,2438,773,422,505,30,103,129,803,14,77,46,83,91,129,535,839,7,6334,351,0,0
142,3319,77,34,69,0,0,8,77,3,24,16,29,27,45,114,213,1,387,21,0,0
142,3319,712,438,573,51,9,84,763,14,102,71,128,116,199,733,1364,8,11988,666,0,0
24,628,2,2,2,0,0,0,2,0,0,0,0,0,0,0,0,0,0,0,0,0
24,628,99,48,90,1,3,5,100,0,0,0,0,0,0,0,0,0,0,0,0,0
24,628,8,5,5,2,0,1,10,0,0,0,0,0,0,0,0,0,0,0,0,0
24,628,1217,716,841,84,126,174,1301,14,185,118,215,199,333,1446,2542,8,20687,1149,0,0
24,628,160,89,115,0,13,31,160,7,15,11,17,22,28,78,124,3,495,27,0,0
24,628,10,10,9,9,0,0,19,0,0,0,0,0,0,0,0,0,0,0,0,0
24,628,173,84,99,8,29,36,181,5,12,7,13,17,20,54,81,2,221,12,0,0
24,628,3,1,1,3,0,0,6,0,0,0,0,0,0,0,0,0,0,0,0,0
30,664,125,97,103,3,0,19,128,9,25,17,27,34,44,144,223,4,1087,60,0,0
88,1899,402,202,227,24,74,80,426,12,52,33,61,64,94,339,564,7,3969,220,0,0
52,1075,447,308,343,6,5,95,453,7,96,59,111,103,170,651,1136,4,4600,255,0,0
52,1075,322,174,179,16,74,51,338,10,41,26,46,51,72,252,408,5,2291,127,0,0
88,1993,53,23,39,0,0,13,53,2,8,4,8,10,12,26,39,1,39,2,0,0
88,1993,515,298,307,33,80,99,548,12,63,44,77,75,121,419,753,7,5527,307,0,0
23,389,424,94,331,4,0,89,428,1,5,5,5,6,10,11,25,0,12,0,0,0
23,389,38,23,23,6,0,8,44,3,11,7,11,14,18,42,68,1,102,5,0,0
20,526,205,80,86,16,53,53,221,7,18,10,19,25,29,94,134,3,497,27,0,0
17,523,184,100,137,2,15,30,186,6,38,20,39,44,59,214,322,3,991,55,0,0
17,523,103,65,74,8,5,16,111,7,17,9,17,24,26,89,119,3,417,23,0,0
53,1178,91,45,69,0,3,18,91,3,9,6,10,12,16,33,57,1,95,5,0,0
53,1178,367,234,237,17,34,68,384,16,55,34,61,71,95,381,584,8,5183,287,0,0
244,5842,722,423,573,19,0,135,741,12,172,101,199,184,300,1320,2257,6,15668,870,0,0
244,5842,1508,847,911,44,250,301,1552,14,148,88,169,162,257,1120,1886,7,15077,837,0,0
305,6844,72,33,56,0,4,12,72,1,1,1,1,2,2,0,2,0,1,0,0,0
305,6844,1454,835,1044,76,110,219,1530,17,275,158,296,292,454,2297,3718,9,34017,1889,1,0
91,1836,757,253,292,73,244,162,830,13,61,38,67,74,105,409,651,7,4654,258,0,0
43,902,386,256,301,16,9,68,402,4,59,35,69,63,104,355,621,2,1453,80,0,0
43,902,264,131,164,11,41,46,275,6,38,22,40,44,62,214,338,3,1068,59,0,0
30,658,215,129,180,6,0,29,221,8,65,43,72,73,115,415,711,4,3153,175,0,0
30,658,97,69,77,3,3,16,100,6,22,13,23,28,36,113,173,3,542,30,0,0
92,1975,1043,504,840,53,9,147,1096,9,180,112,198,189,310,1377,2344,4,11604,644,0,0
92,1975,383,288,292,26,6,62,409,11,65,38,67,76,105,429,656,5,3719,206,0,0
20,420,294,64,250,0,0,43,294,1,20,10,20,21,30,86,131,0,65,3,0,0
20,420,78,46,62,3,0,14,81,3,8,4,8,11,12,28,41,1,62,3,0,0
5,123,110,30,77,3,13,16,113,4,21,15,30,25,45,100,208,2,597,33,0,0
5,123,28,15,21,1,0,6,29,0,0,0,0,0,0,0,0,0,0,0,0,0
70,1394,1178,367,1042,6,15,115,1184,9,94,51,95,103,146,644,976,4,4439,246,0,0
70,1394,177,108,140,8,0,27,185,6,30,16,32,36,48,162,248,3,794,44,0,0
223,4852,1943,715,1694,26,18,214,1969,12,185,120,237,197,357,1436,2721,7,20915,1161,0,0
223,4852,1168,838,957,57,25,144,1225,19,348,224,416,367,640,3018,5452,11,61921,3440,1,0
19,682,442,244,305,14,16,103,456,11,68,45,75,79,120,452,756,6,4588,254,0,0
19,682,182,102,99,11,40,35,193,3,11,6,11,14,17,42,64,1,97,5,0,0
62,1255,1098,241,925,5,10,155,1103,7,46,25,49,53,74,273,423,3,1580,87,0,0
62,1255,282,202,222,14,2,44,296,8,42,24,43,50,67,250,378,4,1548,86,0,0
29,728,601,196,481,2,23,85,603,8,63,36,72,71,108,400,664,4,3036,168,0,0
29,728,156,79,106,5,16,28,161,5,14,8,15,19,23,64,97,2,261,14,0,0
99,4089,1289,550,1043,56,32,155,1345,10,167,93,185,177,278,1266,2075,5,11498,638,0,0
35,1083,182,127,129,0,0,53,182,5,39,21,42,44,63,217,343,2,926,51,0,0
152,7159,1392,870,1177,35,17,170,1427,14,494,280,531,508,811,4473,7289,7,54850,3047,2,0
90,2889,773,419,590,28,0,166,801,10,204,113,217,214,330,1598,2554,5,13587,754,0,0
24,1149,75,38,59,1,3,12,76,2,4,2,4,6,6,10,15,1,15,0,0,0
63,4333,520,294,400,33,13,81,553,10,261,204,367,271,571,2128,4614,7,32445,1802,1,0
180,8011,139,89,101,2,0,35,141,7,54,34,62,61,96,330,569,4,2287,127,0,0
180,8011,7,5,5,0,0,2,7,1,2,1,2,3,3,2,4,0,2,0,0,0
138,6148,1782,648,1425,9,47,279,1791,8,171,97,189,179,286,1292,2140,4,9462,525,0,0
23,583,102,59,69,5,3,24,107,6,22,15,28,28,43,113,206,3,789,43,0,0
166,4983,1660,832,1314,41,38,274,1701,20,312,209,395,332,604,2671,5058,12,64042,3557,1,0
44,3230,996,429,845,24,10,117,1020,7,76,50,88,83,138,494,879,4,3565,198,0,0
128,5336,1513,682,1277,25,13,200,1538,11,199,116,219,210,335,1557,2584,6,15641,868,0,0
75,3910,1296,573,1062,40,33,157,1336,8,201,118,231,209,349,1561,2689,4,12365,686,0,0
19,453,207,111,150,11,0,50,218,5,26,19,36,31,55,133,272,3,943,52,0,0
92,4718,1457,730,1242,11,6,188,1468,10,292,166,329,302,495,2424,4078,5,22973,1276,1,0
40,2521,652,304,544,16,6,88,668,6,89,51,101,95,152,591,998,3,3399,188,0,0
70,3216,1455,414,1257,16,76,112,1471,5,41,23,46,46,69,231,381,2,1069,59,0,0
2,79,7,6,5,0,0,2,7,1,1,1,2,2,3,0,3,1,3,0,0,0
8,275,74,35,59,1,0,14,75,3,14,7,14,17,21,58,85,1,128,7,0,0
96,4695,1523,757,1297,19,12,193,1542,12,193,117,230,205,347,1508,2664,7,19053,1058,0,0
97,4232,1020,354,843,12,15,144,1032,8,134,77,144,142,221,970,1580,4,6792,377,0,0
42,1903,447,308,343,6,5,95,453,7,96,59,111,103,170,651,1136,4,4600,255,0,0
21,662,424,94,331,4,0,89,428,1,5,5,5,6,10,11,25,0,12,0,0,0
38,2306,334,251,279,10,4,40,344,5,127,74,143,132,217,899,1528,2,4303,239,0,0
12,497,184,100,137,2,15,30,186,6,38,20,39,44,59,214,322,3,991,55,0,0
64,2863,1293,570,1093,25,15,163,1318,10,195,123,241,205,364,1516,2795,6,17273,959,0,0
33,1897,384,251,317,7,8,52,391,11,70,44,84,81,128,467,811,6,5355,297,0,0
47,2248,722,423,573,19,0,135,741,12,172,101,199,184,300,1320,2257,6,15668,870,0,0
43,1877,386,256,301,16,9,68,402,4,59,35,69,63,104,355,621,2,1453,80,0,0
16,1245,215,129,180,6,0,29,221,8,65,43,72,73,115,415,711,4,3153,175,0,0
84,3236,1043,504,840,53,9,147,1096,9,180,112,198,189,310,1377,2344,4,11604,644,0,0
14,534,295,56,236,0,4,54,295,2,9,5,10,11,15,30,51,1,57,3,0,0
30,1245,373,158,315,8,0,51,381,5,76,44,79,81,123,486,779,2,2026,112,0,0
77,3225,1178,367,1042,6,15,115,1184,9,94,51,95,103,146,644,976,4,4439,246,0,0
99,5086,1943,715,1694,26,18,214,1969,12,185,120,237,197,357,1436,2721,7,20915,1161,0,0
30,1272,442,244,305,14,16,103,456,11,68,45,75,79,120,452,756,6,4588,254,0,0
51,1917,1098,241,925,5,10,155,1103,7,46,25,49,53,74,273,423,3,1580,87,0,0
70,1387,207,111,150,11,0,50,218,5,26,19,36,31,55,133,272,3,943,52,0,0
70,1387,410,198,237,31,55,97,441,11,63,38,72,74,110,414,683,6,4293,238,0,0
218,4733,2,2,2,0,0,0,2,0,0,0,0,0,0,0,0,0,0,0,0,0
218,4733,99,48,90,1,3,5,100,0,0,0,0,0,0,0,0,0,0,0,0,0
218,4733,8,5,5,2,0,1,10,0,0,0,0,0,0,0,0,0,0,0,0,0
218,4733,1217,716,841,84,126,174,1301,14,185,118,215,199,333,1446,2542,8,20687,1149,0,0
218,4733,160,89,115,0,13,31,160,7,15,11,17,22,28,78,124,3,495,27,0,0
218,4733,10,10,9,9,0,0,19,0,0,0,0,0,0,0,0,0,0,0,0,0
218,4733,173,84,99,8,29,36,181,5,12,7,13,17,20,54,81,2,221,12,0,0
218,4733,3,1,1,3,0,0,6,0,0,0,0,0,0,0,0,0,0,0,0,0
142,3314,77,34,69,0,0,8,77,3,24,16,29,27,45,114,213,1,387,21,0,0
142,3314,712,438,573,51,9,84,763,14,102,71,128,116,199,733,1364,8,11988,666,0,0
303,6728,72,33,56,0,4,12,72,1,1,1,1,2,2,0,2,0,1,0,0,0
303,6728,1454,835,1044,76,110,219,1530,17,275,158,296,292,454,2297,3718,9,34017,1889,1,0
4,163,27,21,21,0,0,6,27,3,6,3,6,9,9,20,28,1,42,2,0,0
70,1395,207,111,150,11,0,50,218,5,26,19,36,31,55,133,272,3,943,52,0,1
70,1395,410,198,237,31,55,97,441,11,63,38,72,74,110,414,683,6,4293,238,0,1
218,4751,2,2,2,0,0,0,2,0,0,0,0,0,0,0,0,0,0,0,0,1
218,4751,99,48,90,1,3,5,100,0,0,0,0,0,0,0,0,0,0,0,0,1
218,4751,8,5,5,2,0,1,10,0,0,0,0,0,0,0,0,0,0,0,0,1
218,4751,1217,716,841,84,126,174,1301,14,185,118,215,199,333,1446,2542,8,20687,1149,0,1
218,4751,160,89,115,0,13,31,160,7,15,11,17,22,28,78,124,3,495,27,0,1
218,4751,10,10,9,9,0,0,19,0,0,0,0,0,0,0,0,0,0,0,0,1
218,4751,173,84,99,8,29,36,181,5,12,7,13,17,20,54,81,2,221,12,0,1
218,4751,3,1,1,3,0,0,6,0,0,0,0,0,0,0,0,0,0,0,0,1
37,1105,339,213,244,17,9,65,356,10,42,26,48,52,74,259,421,5,2410,133,0,1
258,6040,4293,999,3693,19,54,507,4312,9,155,88,170,164,258,1156,1898,4,9368,520,0,1
258,6040,1482,859,1002,125,135,219,1607,16,219,134,251,235,385,1766,3032,9,27804,1544,1,1
53,633,647,139,84,35,284,233,682,0,0,0,0,0,0,0,0,0,0,0,0,1
52,1151,91,45,69,0,3,18,91,3,9,6,10,12,16,33,57,1,95,5,0,1
52,1151,367,234,237,17,34,68,384,16,55,34,61,71,95,381,584,8,5183,287,0,1
226,4927,1943,715,1694,26,18,214,1969,12,185,120,237,197,357,1436,2721,7,20915,1161,0,1
226,4927,1168,838,957,57,25,144,1225,19,348,224,416,367,640,3018,5452,11,61921,3440,1,1
25,1187,75,38,59,1,3,12,76,2,4,2,4,6,6,10,15,1,15,0,0,1
64,2936,1293,570,1093,25,15,163,1318,10,195,123,241,205,364,1516,2795,6,17273,959,0,1
41,1474,601,196,481,2,23,85,603,8,63,36,72,71,108,400,664,4,3036,168,0,1
70,1395,207,111,150,11,0,50,218,5,26,19,36,31,55,133,272,3,943,52,0,0
70,1395,410,198,237,31,55,97,441,11,63,38,72,74,110,414,683,6,4293,238,0,0
218,4751,2,2,2,0,0,0,2,0,0,0,0,0,0,0,0,0,0,0,0,0
218,4751,99,48,90,1,3,5,100,0,0,0,0,0,0,0,0,0,0,0,0,0
218,4751,8,5,5,2,0,1,10,0,0,0,0,0,0,0,0,0,0,0,0,0
218,4751,1217,716,841,84,126,174,1301,14,185,118,215,199,333,1446,2542,8,20687,1149,0,0
218,4751,160,89,115,0,13,31,160,7,15,11,17,22,28,78,124,3,495,27,0,0
218,4751,10,10,9,9,0,0,19,0,0,0,0,0,0,0,0,0,0,0,0,0
218,4751,173,84,99,8,29,36,181,5,12,7,13,17,20,54,81,2,221,12,0,0
218,4751,3,1,1,3,0,0,6,0,0,0,0,0,0,0,0,0,0,0,0,0
37,1105,339,213,244,17,9,65,356,10,42,26,48,52,74,259,421,5,2410,133,0,0
258,6040,4293,999,3693,19,54,507,4312,9,155,88,170,164,258,1156,1898,4,9368,520,0,0
258,6040,1482,859,1002,125,135,219,1607,16,219,134,251,235,385,1766,3032,9,27804,1544,1,0
52,1151,91,45,69,0,3,18,91,3,9,6,10,12,16,33,57,1,95,5,0,0
52,1151,367,234,237,17,34,68,384,16,55,34,61,71,95,381,584,8,5183,287,0,0
226,4927,1943,715,1694,26,18,214,1969,12,185,120,237,197,357,1436,2721,7,20915,1161,0,0
226,4927,1168,838,957,57,25,144,1225,19,348,224,416,367,640,3018,5452,11,61921,3440,1,0
25,1187,75,38,59,1,3,12,76,2,4,2,4,6,6,10,15,1,15,0,0,0
64,2936,1293,570,1093,25,15,163,1318,10,195,123,241,205,364,1516,2795,6,17273,959,0,0
45,919,386,256,301,16,9,68,402,4,59,35,69,63,104,355,621,2,1453,80,0,1
45,919,264,131,164,11,41,46,275,6,38,22,40,44,62,214,338,3,1068,59,0,1
44,1910,386,256,301,16,9,68,402,4,59,35,69,63,104,355,621,2,1453,80,0,1
142,3324,77,34,69,0,0,8,77,3,24,16,29,27,45,114,213,1,387,21,0,0
142,3324,712,438,573,51,9,84,763,14,102,71,128,116,199,733,1364,8,11988,666,0,0
303,6802,72,33,56,0,4,12,72,1,1,1,1,2,2,0,2,0,1,0,0,0
303,6802,1454,835,1044,76,110,219,1530,17,275,158,296,292,454,2297,3718,9,34017,1889,1,0
45,919,386,256,301,16,9,68,402,4,59,35,69,63,104,355,621,2,1453,80,0,0
45,919,264,131,164,11,41,46,275,6,38,22,40,44,62,214,338,3,1068,59,0,0
44,1910,386,256,301,16,9,68,402,4,59,35,69,63,104,355,621,2,1453,80,0,0
54,1174,91,45,69,0,3,18,91,3,9,6,10,12,16,33,57,1,95,5,0,0
54,1174,367,234,237,17,34,68,384,16,55,34,61,71,95,381,584,8,5183,287,0,0
31,1314,442,244,305,14,16,103,456,11,68,45,75,79,120,452,756,6,4588,254,0,0
53,1176,91,45,69,0,3,18,91,3,9,6,10,12,16,33,57,1,95,5,0,1
53,1176,367,234,237,17,34,68,384,16,55,34,61,71,95,381,584,8,5183,287,0,1
303,6803,72,33,56,0,4,12,72,1,1,1,1,2,2,0,2,0,1,0,0,1
303,6803,1454,835,1044,76,110,219,1530,17,275,158,296,292,454,2297,3718,9,34017,1889,1,1
54,1188,91,45,69,0,3,18,91,3,9,6,10,12,16,33,57,1,95,5,0,0
54,1188,367,234,237,17,34,68,384,16,55,34,61,71,95,381,584,8,5183,287,0,0
31,1318,442,244,305,14,16,103,456,11,68,45,75,79,120,452,756,6,4588,254,0,0
54,1186,91,45,69,0,3,18,91,3,9,6,10,12,16,33,57,1,95,5,0,0
54,1186,367,234,237,17,34,68,384,16,55,34,61,71,95,381,584,8,5183,287,0,0
303,6803,72,33,56,0,4,12,72,1,1,1,1,2,2,0,2,0,1,0,0,0
303,6803,1454,835,1044,76,110,219,1530,17,275,158,296,292,454,2297,3718,9,34017,1889,1,0
218,4753,2,2,2,0,0,0,2,0,0,0,0,0,0,0,0,0,0,0,0,0
218,4753,99,48,90,1,3,5,100,0,0,0,0,0,0,0,0,0,0,0,0,0
218,4753,8,5,5,2,0,1,10,0,0,0,0,0,0,0,0,0,0,0,0,0
218,4753,1217,716,841,84,126,174,1301,14,185,118,215,199,333,1446,2542,8,20687,1149,0,0
218,4753,160,89,115,0,13,31,160,7,15,11,17,22,28,78,124,3,495,27,0,0
218,4753,10,10,9,9,0,0,19,0,0,0,0,0,0,0,0,0,0,0,0,0
218,4753,173,84,99,8,29,36,181,5,12,7,13,17,20,54,81,2,221,12,0,0
218,4753,3,1,1,3,0,0,6,0,0,0,0,0,0,0,0,0,0,0,0,0
53,1159,91,45,69,0,3,18,91,3,9,6,10,12,16,33,57,1,95,5,0,0
53,1159,367,234,237,17,34,68,384,16,55,34,61,71,95,381,584,8,5183,287,0,0
68,1562,773,419,590,28,0,166,801,10,204,113,217,214,330,1598,2554,5,13587,754,0,1
68,1562,421,273,302,44,34,57,465,17,81,59,107,98,166,583,1098,11,12329,684,0,1
68,1577,773,419,590,28,0,166,801,10,204,113,217,214,330,1598,2554,5,13587,754,0,1
68,1577,421,273,302,44,34,57,465,17,81,59,107,98,166,583,1098,11,12329,684,0,1
68,1577,773,419,590,28,0,166,801,10,204,113,217,214,330,1598,2554,5,13587,754,0,0
68,1577,421,273,302,44,34,57,465,17,81,59,107,98,166,583,1098,11,12329,684,0,0
147,3371,77,34,69,0,0,8,77,3,24,16,29,27,45,114,213,1,387,21,0,0
147,3371,712,438,573,51,9,84,763,14,102,71,128,116,199,733,1364,8,11988,666,0,0
304,6811,72,33,56,0,4,12,72,1,1,1,1,2,2,0,2,0,1,0,0,0
304,6811,1454,835,1044,76,110,219,1530,17,275,158,296,292,454,2297,3718,9,34017,1889,1,0
57,1214,91,45,69,0,3,18,91,3,9,6,10,12,16,33,57,1,95,5,0,0
57,1214,367,234,237,17,34,68,384,16,55,34,61,71,95,381,584,8,5183,287,0,0
8,377,91,45,69,0,3,18,91,3,9,6,10,12,16,33,57,1,95,5,0,0
77,1753,996,429,845,24,10,117,1020,7,76,50,88,83,138,494,879,4,3565,198,0,1
77,1753,456,277,329,12,42,72,468,13,85,50,97,98,147,592,972,7,7212,400,0,1
257,6042,4293,999,3693,19,54,507,4312,9,155,88,170,164,258,1156,1898,4,9368,520,0,0
257,6042,1482,859,1002,125,135,219,1607,16,219,134,251,235,385,1766,3032,9,27804,1544,1,0
155,3277,1513,682,1277,25,13,200,1538,11,199,116,219,210,335,1557,2584,6,15641,868,0,1
155,3277,819,519,539,24,98,155,843,15,96,57,106,111,163,690,1107,8,9171,509,0,1
40,1143,339,213,244,17,9,65,356,10,42,26,48,52,74,259,421,5,2410,133,0,1
65,3000,1293,570,1093,25,15,163,1318,10,195,123,241,205,364,1516,2795,6,17273,959,0,1
52,1096,447,308,343,6,5,95,453,7,96,59,111,103,170,651,1136,4,4600,255,0,1
52,1096,322,174,179,16,74,51,338,10,41,26,46,51,72,252,408,5,2291,127,0,1
42,1907,447,308,343,6,5,95,453,7,96,59,111,103,170,651,1136,4,4600,255,0,1
219,4759,2,2,2,0,0,0,2,0,0,0,0,0,0,0,0,0,0,0,0,1
219,4759,99,48,90,1,3,5,100,0,0,0,0,0,0,0,0,0,0,0,0,1
219,4759,8,5,5,2,0,1,10,0,0,0,0,0,0,0,0,0,0,0,0,1
219,4759,1217,716,841,84,126,174,1301,14,185,118,215,199,333,1446,2542,8,20687,1149,0,1
219,4759,160,89,115,0,13,31,160,7,15,11,17,22,28,78,124,3,495,27,0,1
219,4759,10,10,9,9,0,0,19,0,0,0,0,0,0,0,0,0,0,0,0,1
219,4759,173,84,99,8,29,36,181,5,12,7,13,17,20,54,81,2,221,12,0,1
219,4759,3,1,1,3,0,0,6,0,0,0,0,0,0,0,0,0,0,0,0,1
155,3277,1513,682,1277,25,13,200,1538,11,199,116,219,210,335,1557,2584,6,15641,868,0,0
155,3277,819,519,539,24,98,155,843,15,96,57,106,111,163,690,1107,8,9171,509,0,0
40,1143,339,213,244,17,9,65,356,10,42,26,48,52,74,259,421,5,2410,133,0,0
65,3000,1293,570,1093,25,15,163,1318,10,195,123,241,205,364,1516,2795,6,17273,959,0,0
77,1753,996,429,845,24,10,117,1020,7,76,50,88,83,138,494,879,4,3565,198,0,0
77,1753,456,277,329,12,42,72,468,13,85,50,97,98,147,592,972,7,7212,400,0,0
42,1906,447,308,343,6,5,95,453,7,96,59,111,103,170,651,1136,4,4600,255,0,0
75,3937,1296,573,1062,40,33,157,1336,8,201,118,231,209,349,1561,2689,4,12365,686,0,0
75,4003,1296,573,1062,40,33,157,1336,8,201,118,231,209,349,1561,2689,4,12365,686,0,0
143,3347,77,34,69,0,0,8,77,3,24,16,29,27,45,114,213,1,387,21,0,1
143,3347,712,438,573,51,9,84,763,14,102,71,128,116,199,733,1364,8,11988,666,0,1
70,1383,207,111,150,11,0,50,218,5,26,19,36,31,55,133,272,3,943,52,0,1
70,1383,410,198,237,31,55,97,441,11,63,38,72,74,110,414,683,6,4293,238,0,1
305,6850,72,33,56,0,4,12,72,1,1,1,1,2,2,0,2,0,1,0,0,1
305,6850,1454,835,1044,76,110,219,1530,17,275,158,296,292,454,2297,3718,9,34017,1889,1,1
28,800,256,139,192,9,7,47,265,4,23,12,24,27,36,112,171,2,357,19,0,1
76,3946,1296,573,1062,40,33,157,1336,8,201,118,231,209,349,1561,2689,4,12365,686,0,1
21,498,207,111,150,11,0,50,218,5,26,19,36,31,55,133,272,3,943,52,0,1
70,1383,207,111,150,11,0,50,218,5,26,19,36,31,55,133,272,3,943,52,0,0
70,1383,410,198,237,31,55,97,441,11,63,38,72,74,110,414,683,6,4293,238,0,0
305,6850,72,33,56,0,4,12,72,1,1,1,1,2,2,0,2,0,1,0,0,0
305,6850,1454,835,1044,76,110,219,1530,17,275,158,296,292,454,2297,3718,9,34017,1889,1,0
28,800,256,139,192,9,7,47,265,4,23,12,24,27,36,112,171,2,357,19,0,0
76,3946,1296,573,1062,40,33,157,1336,8,201,118,231,209,349,1561,2689,4,12365,686,0,0
21,498,207,111,150,11,0,50,218,5,26,19,36,31,55,133,272,3,943,52,0,0
52,1096,447,308,343,6,5,95,453,7,96,59,111,103,170,651,1136,4,4600,255,0,0
52,1096,322,174,179,16,74,51,338,10,41,26,46,51,72,252,408,5,2291,127,0,0
143,3347,77,34,69,0,0,8,77,3,24,16,29,27,45,114,213,1,387,21,0,0
143,3347,712,438,573,51,9,84,763,14,102,71,128,116,199,733,1364,8,11988,666,0,0
303,6808,72,33,56,0,4,12,72,1,1,1,1,2,2,0,2,0,1,0,0,0
303,6808,1454,835,1044,76,110,219,1530,17,275,158,296,292,454,2297,3718,9,34017,1889,1,0
76,4039,1296,573,1062,40,33,157,1336,8,201,118,231,209,349,1561,2689,4,12365,686,0,0
147,3379,77,34,69,0,0,8,77,3,24,16,29,27,45,114,213,1,387,21,0,0
147,3379,712,438,573,51,9,84,763,14,102,71,128,116,199,733,1364,8,11988,666,0,0
56,1200,91,45,69,0,3,18,91,3,9,6,10,12,16,33,57,1,95,5,0,0
56,1200,367,234,237,17,34,68,384,16,55,34,61,71,95,381,584,8,5183,287,0,0
301,6795,72,33,56,0,4,12,72,1,1,1,1,2,2,0,2,0,1,0,0,0
301,6795,1454,835,1044,76,110,219,1530,17,275,158,296,292,454,2297,3718,9,34017,1889,1,0
147,3364,77,34,69,0,0,8,77,3,24,16,29,27,45,114,213,1,387,21,0,1
147,3364,712,438,573,51,9,84,763,14,102,71,128,116,199,733,1364,8,11988,666,0,1
304,6818,72,33,56,0,4,12,72,1,1,1,1,2,2,0,2,0,1,0,0,1
304,6818,1454,835,1044,76,110,219,1530,17,275,158,296,292,454,2297,3718,9,34017,1889,1,1
148,3384,77,34,69,0,0,8,77,3,24,16,29,27,45,114,213,1,387,21,0,0
148,3384,712,438,573,51,9,84,763,14,102,71,128,116,199,733,1364,8,11988,666,0,0
146,3375,77,34,69,0,0,8,77,3,24,16,29,27,45,114,213,1,387,21,0,0
146,3375,712,438,573,51,9,84,763,14,102,71,128,116,199,733,1364,8,11988,666,0,0
31,958,339,213,244,17,9,65,356,10,42,26,48,52,74,259,421,5,2410,133,0,1
65,2927,1293,570,1093,25,15,163,1318,10,195,123,241,205,364,1516,2795,6,17273,959,0,1
304,6818,72,33,56,0,4,12,72,1,1,1,1,2,2,0,2,0,1,0,0,0
304,6818,1454,835,1044,76,110,219,1530,17,275,158,296,292,454,2297,3718,9,34017,1889,1,0
72,1414,207,111,150,11,0,50,218,5,26,19,36,31,55,133,272,3,943,52,0,0
72,1414,410,198,237,31,55,97,441,11,63,38,72,74,110,414,683,6,4293,238,0,0
259,6068,4293,999,3693,19,54,507,4312,9,155,88,170,164,258,1156,1898,4,9368,520,0,0
259,6068,1482,859,1002,125,135,219,1607,16,219,134,251,235,385,1766,3032,9,27804,1544,1,0
147,3398,77,34,69,0,0,8,77,3,24,16,29,27,45,114,213,1,387,21,0,0
147,3398,712,438,573,51,9,84,763,14,102,71,128,116,199,733,1364,8,11988,666,0,0
59,1228,91,45,69,0,3,18,91,3,9,6,10,12,16,33,57,1,95,5,0,0
59,1228,367,234,237,17,34,68,384,16,55,34,61,71,95,381,584,8,5183,287,0,0
304,6824,72,33,56,0,4,12,72,1,1,1,1,2,2,0,2,0,1,0,0,0
304,6824,1454,835,1044,76,110,219,1530,17,275,158,296,292,454,2297,3718,9,34017,1889,1,0
31,958,339,213,244,17,9,65,356,10,42,26,48,52,74,259,421,5,2410,133,0,0
65,2927,1293,570,1093,25,15,163,1318,10,195,123,241,205,364,1516,2795,6,17273,959,0,0
40,1165,339,213,244,17,9,65,356,10,42,26,48,52,74,259,421,5,2410,133,0,0
66,3064,1293,570,1093,25,15,163,1318,10,195,123,241,205,364,1516,2795,6,17273,959,0,0
220,4770,2,2,2,0,0,0,2,0,0,0,0,0,0,0,0,0,0,0,0,0
220,4770,99,48,90,1,3,5,100,0,0,0,0,0,0,0,0,0,0,0,0,0
220,4770,8,5,5,2,0,1,10,0,0,0,0,0,0,0,0,0,0,0,0,0
220,4770,1217,716,841,84,126,174,1301,14,185,118,215,199,333,1446,2542,8,20687,1149,0,0
220,4770,160,89,115,0,13,31,160,7,15,11,17,22,28,78,124,3,495,27,0,0
220,4770,10,10,9,9,0,0,19,0,0,0,0,0,0,0,0,0,0,0,0,0
220,4770,173,84,99,8,29,36,181,5,12,7,13,17,20,54,81,2,221,12,0,0
220,4770,3,1,1,3,0,0,6,0,0,0,0,0,0,0,0,0,0,0,0,0
123,5254,1513,682,1277,25,13,200,1538,11,199,116,219,210,335,1557,2584,6,15641,868,0,0
34,1970,384,251,317,7,8,52,391,11,70,44,84,81,128,467,811,6,5355,297,0,0
123,5258,1513,682,1277,25,13,200,1538,11,199,116,219,210,335,1557,2584,6,15641,868,0,0
219,4755,2,2,2,0,0,0,2,0,0,0,0,0,0,0,0,0,0,0,0,0
219,4755,99,48,90,1,3,5,100,0,0,0,0,0,0,0,0,0,0,0,0,0
219,4755,8,5,5,2,0,1,10,0,0,0,0,0,0,0,0,0,0,0,0,0
219,4755,1217,716,841,84,126,174,1301,14,185,118,215,199,333,1446,2542,8,20687,1149,0,0
219,4755,160,89,115,0,13,31,160,7,15,11,17,22,28,78,124,3,495,27,0,0
219,4755,10,10,9,9,0,0,19,0,0,0,0,0,0,0,0,0,0,0,0,0
219,4755,173,84,99,8,29,36,181,5,12,7,13,17,20,54,81,2,221,12,0,0
219,4755,3,1,1,3,0,0,6,0,0,0,0,0,0,0,0,0,0,0,0,0
89,1778,477,336,357,30,23,73,507,16,194,134,250,210,384,1538,2962,10,30538,1696,0,1
155,3275,1513,682,1277,25,13,200,1538,11,199,116,219,210,335,1557,2584,6,15641,868,0,1
155,3275,819,519,539,24,98,155,843,15,96,57,106,111,163,690,1107,8,9171,509,0,1
110,4151,1450,624,1228,12,26,181,1462,14,306,186,354,320,540,2580,4493,8,36391,2021,1,1
89,1778,477,336,357,30,23,73,507,16,194,134,250,210,384,1538,2962,10,30538,1696,0,0
155,3275,1513,682,1277,25,13,200,1538,11,199,116,219,210,335,1557,2584,6,15641,868,0,0
155,3275,819,519,539,24,98,155,843,15,96,57,106,111,163,690,1107,8,9171,509,0,0
110,4151,1450,624,1228,12,26,181,1462,14,306,186,354,320,540,2580,4493,8,36391,2021,1,0
220,4776,2,2,2,0,0,0,2,0,0,0,0,0,0,0,0,0,0,0,0,0
220,4776,99,48,90,1,3,5,100,0,0,0,0,0,0,0,0,0,0,0,0,0
220,4776,8,5,5,2,0,1,10,0,0,0,0,0,0,0,0,0,0,0,0,0
220,4776,1217,716,841,84,126,174,1301,14,185,118,215,199,333,1446,2542,8,20687,1149,0,0
220,4776,160,89,115,0,13,31,160,7,15,11,17,22,28,78,124,3,495,27,0,0
220,4776,10,10,9,9,0,0,19,0,0,0,0,0,0,0,0,0,0,0,0,0
220,4776,173,84,99,8,29,36,181,5,12,7,13,17,20,54,81,2,221,12,0,0
220,4776,3,1,1,3,0,0,6,0,0,0,0,0,0,0,0,0,0,0,0,0
149,3468,77,34,69,0,0,8,77,3,24,16,29,27,45,114,213,1,387,21,0,1
149,3468,712,438,573,51,9,84,763,14,102,71,128,116,199,733,1364,8,11988,666,0,1
87,1953,53,23,39,0,0,13,53,2,8,4,8,10,12,26,39,1,39,2,0,1
87,1953,515,298,307,33,80,99,548,12,63,44,77,75,121,419,753,7,5527,307,0,1
149,3468,77,34,69,0,0,8,77,3,24,16,29,27,45,114,213,1,387,21,0,0
149,3468,712,438,573,51,9,84,763,14,102,71,128,116,199,733,1364,8,11988,666,0,0
87,1953,53,23,39,0,0,13,53,2,8,4,8,10,12,26,39,1,39,2,0,0
87,1953,515,298,307,33,80,99,548,12,63,44,77,75,121,419,753,7,5527,307,0,0
219,4765,2,2,2,0,0,0,2,0,0,0,0,0,0,0,0,0,0,0,0,0
219,4765,99,48,90,1,3,5,100,0,0,0,0,0,0,0,0,0,0,0,0,0
219,4765,8,5,5,2,0,1,10,0,0,0,0,0,0,0,0,0,0,0,0,0
219,4765,1217,716,841,84,126,174,1301,14,185,118,215,199,333,1446,2542,8,20687,1149,0,0
219,4765,160,89,115,0,13,31,160,7,15,11,17,22,28,78,124,3,495,27,0,0
219,4765,10,10,9,9,0,0,19,0,0,0,0,0,0,0,0,0,0,0,0,0
219,4765,173,84,99,8,29,36,181,5,12,7,13,17,20,54,81,2,221,12,0,0
219,4765,3,1,1,3,0,0,6,0,0,0,0,0,0,0,0,0,0,0,0,0
77,4118,1296,573,1062,40,33,157,1336,8,201,118,231,209,349,1561,2689,4,12365,686,0,0
148,3423,77,34,69,0,0,8,77,3,24,16,29,27,45,114,213,1,387,21,0,0
148,3423,712,438,573,51,9,84,763,14,102,71,128,116,199,733,1364,8,11988,666,0,0
308,6881,72,33,56,0,4,12,72,1,1,1,1,2,2,0,2,0,1,0,0,0
308,6881,1454,835,1044,76,110,219,1530,17,275,158,296,292,454,2297,3718,9,34017,1889,1,0
76,4080,1296,573,1062,40,33,157,1336,8,201,118,231,209,349,1561,2689,4,12365,686,0,0
148,3409,77,34,69,0,0,8,77,3,24,16,29,27,45,114,213,1,387,21,0,0
148,3409,712,438,573,51,9,84,763,14,102,71,128,116,199,733,1364,8,11988,666,0,0
76,4115,1296,573,1062,40,33,157,1336,8,201,118,231,209,349,1561,2689,4,12365,686,0,0
76,4117,1296,573,1062,40,33,157,1336,8,201,118,231,209,349,1561,2689,4,12365,686,0,0
150,3460,77,34,69,0,0,8,77,3,24,16,29,27,45,114,213,1,387,21,0,0
150,3460,712,438,573,51,9,84,763,14,102,71,128,116,199,733,1364,8,11988,666,0,0
147,3410,77,34,69,0,0,8,77,3,24,16,29,27,45,114,213,1,387,21,0,0
147,3410,712,438,573,51,9,84,763,14,102,71,128,116,199,733,1364,8,11988,666,0,0
150,3446,77,34,69,0,0,8,77,3,24,16,29,27,45,114,213,1,387,21,0,0
150,3446,712,438,573,51,9,84,763,14,102,71,128,116,199,733,1364,8,11988,666,0,0
148,3413,77,34,69,0,0,8,77,3,24,16,29,27,45,114,213,1,387,21,0,0
148,3413,712,438,573,51,9,84,763,14,102,71,128,116,199,733,1364,8,11988,666,0,0
227,4936,1943,715,1694,26,18,214,1969,12,185,120,237,197,357,1436,2721,7,20915,1161,0,0
227,4936,1168,838,957,57,25,144,1225,19,348,224,416,367,640,3018,5452,11,61921,3440,1,0
219,4761,2,2,2,0,0,0,2,0,0,0,0,0,0,0,0,0,0,0,0,0
219,4761,99,48,90,1,3,5,100,0,0,0,0,0,0,0,0,0,0,0,0,0
219,4761,8,5,5,2,0,1,10,0,0,0,0,0,0,0,0,0,0,0,0,0
219,4761,1217,716,841,84,126,174,1301,14,185,118,215,199,333,1446,2542,8,20687,1149,0,0
219,4761,160,89,115,0,13,31,160,7,15,11,17,22,28,78,124,3,495,27,0,0
219,4761,10,10,9,9,0,0,19,0,0,0,0,0,0,0,0,0,0,0,0,0
219,4761,173,84,99,8,29,36,181,5,12,7,13,17,20,54,81,2,221,12,0,0
219,4761,3,1,1,3,0,0,6,0,0,0,0,0,0,0,0,0,0,0,0,0
150,3483,77,34,69,0,0,8,77,3,24,16,29,27,45,114,213,1,387,21,0,0
150,3483,712,438,573,51,9,84,763,14,102,71,128,116,199,733,1364,8,11988,666,0,0
77,4196,1296,573,1062,40,33,157,1336,8,201,118,231,209,349,1561,2689,4,12365,686,0,0
220,4775,2,2,2,0,0,0,2,0,0,0,0,0,0,0,0,0,0,0,0,1
220,4775,99,48,90,1,3,5,100,0,0,0,0,0,0,0,0,0,0,0,0,1
220,4775,8,5,5,2,0,1,10,0,0,0,0,0,0,0,0,0,0,0,0,1
220,4775,1217,716,841,84,126,174,1301,14,185,118,215,199,333,1446,2542,8,20687,1149,0,1
220,4775,160,89,115,0,13,31,160,7,15,11,17,22,28,78,124,3,495,27,0,1
220,4775,10,10,9,9,0,0,19,0,0,0,0,0,0,0,0,0,0,0,0,1
220,4775,173,84,99,8,29,36,181,5,12,7,13,17,20,54,81,2,221,12,0,1
220,4775,3,1,1,3,0,0,6,0,0,0,0,0,0,0,0,0,0,0,0,1
77,4244,1296,573,1062,40,33,157,1336,8,201,118,231,209,349,1561,2689,4,12365,686,0,1
220,4772,2,2,2,0,0,0,2,0,0,0,0,0,0,0,0,0,0,0,0,0
220,4772,99,48,90,1,3,5,100,0,0,0,0,0,0,0,0,0,0,0,0,0
220,4772,8,5,5,2,0,1,10,0,0,0,0,0,0,0,0,0,0,0,0,0
220,4772,1217,716,841,84,126,174,1301,14,185,118,215,199,333,1446,2542,8,20687,1149,0,0
220,4772,160,89,115,0,13,31,160,7,15,11,17,22,28,78,124,3,495,27,0,0
220,4772,10,10,9,9,0,0,19,0,0,0,0,0,0,0,0,0,0,0,0,0
220,4772,173,84,99,8,29,36,181,5,12,7,13,17,20,54,81,2,221,12,0,0
220,4772,3,1,1,3,0,0,6,0,0,0,0,0,0,0,0,0,0,0,0,0
220,4775,2,2,2,0,0,0,2,0,0,0,0,0,0,0,0,0,0,0,0,0
220,4775,99,48,90,1,3,5,100,0,0,0,0,0,0,0,0,0,0,0,0,0
220,4775,8,5,5,2,0,1,10,0,0,0,0,0,0,0,0,0,0,0,0,0
220,4775,1217,716,841,84,126,174,1301,14,185,118,215,199,333,1446,2542,8,20687,1149,0,0
220,4775,160,89,115,0,13,31,160,7,15,11,17,22,28,78,124,3,495,27,0,0
220,4775,10,10,9,9,0,0,19,0,0,0,0,0,0,0,0,0,0,0,0,0
220,4775,173,84,99,8,29,36,181,5,12,7,13,17,20,54,81,2,221,12,0,0
220,4775,3,1,1,3,0,0,6,0,0,0,0,0,0,0,0,0,0,0,0,0
77,4244,1296,573,1062,40,33,157,1336,8,201,118,231,209,349,1561,2689,4,12365,686,0,0
99,4099,1289,550,1043,56,32,155,1345,10,167,93,185,177,278,1266,2075,5,11498,638,0,0
2,25,127,75,83,2,11,30,129,4,14,7,14,18,21,61,87,2,175,9,0,0
2,25,652,304,544,16,6,88,668,6,89,51,101,95,152,591,998,3,3399,188,0,0
2,25,2,2,2,0,0,0,2,0,0,0,0,0,0,0,0,0,0,0,0,0
2,25,8,5,5,0,0,3,8,0,0,0,0,0,0,0,0,0,0,0,0,0
2,25,14,8,8,0,0,6,14,0,0,0,0,0,0,0,0,0,0,0,0,0
2,25,6,4,4,0,0,2,6,0,0,0,0,0,0,0,0,0,0,0,0,0
2,25,6,4,4,0,0,2,6,1,2,1,2,3,3,2,4,0,2,0,0,0
2,25,7,5,5,0,0,2,7,0,0,0,0,0,0,0,0,0,0,0,0,0
2,25,10,6,6,0,0,4,10,0,0,0,0,0,0,0,0,0,0,0,0,0
2,25,1,1,1,0,0,0,1,0,0,0,0,0,0,0,0,0,0,0,0,0
2,25,14,10,10,0,0,4,14,1,1,1,1,2,2,0,2,0,1,0,0,0
2,25,46,26,30,3,0,12,49,3,6,3,6,9,9,20,28,1,42,2,0,0
148,3416,77,34,69,0,0,8,77,3,24,16,29,27,45,114,213,1,387,21,0,0
148,3416,712,438,573,51,9,84,763,14,102,71,128,116,199,733,1364,8,11988,666,0,0
78,1782,996,429,845,24,10,117,1020,7,76,50,88,83,138,494,879,4,3565,198,0,0
78,1782,456,277,329,12,42,72,468,13,85,50,97,98,147,592,972,7,7212,400,0,0
47,3342,996,429,845,24,10,117,1020,7,76,50,88,83,138,494,879,4,3565,198,0,0
221,4792,2,2,2,0,0,0,2,0,0,0,0,0,0,0,0,0,0,0,0,0
221,4792,99,48,90,1,3,5,100,0,0,0,0,0,0,0,0,0,0,0,0,0
221,4792,8,5,5,2,0,1,10,0,0,0,0,0,0,0,0,0,0,0,0,0
221,4792,1217,716,841,84,126,174,1301,14,185,118,215,199,333,1446,2542,8,20687,1149,0,0
221,4792,160,89,115,0,13,31,160,7,15,11,17,22,28,78,124,3,495,27,0,0
221,4792,10,10,9,9,0,0,19,0,0,0,0,0,0,0,0,0,0,0,0,0
221,4792,173,84,99,8,29,36,181,5,12,7,13,17,20,54,81,2,221,12,0,0
221,4792,3,1,1,3,0,0,6,0,0,0,0,0,0,0,0,0,0,0,0,0
150,3486,77,34,69,0,0,8,77,3,24,16,29,27,45,114,213,1,387,21,0,0
150,3486,712,438,573,51,9,84,763,14,102,71,128,116,199,733,1364,8,11988,666,0,0
88,1991,53,23,39,0,0,13,53,2,8,4,8,10,12,26,39,1,39,2,0,0
88,1991,515,298,307,33,80,99,548,12,63,44,77,75,121,419,753,7,5527,307,0,0
3,229,53,23,39,0,0,13,53,2,8,4,8,10,12,26,39,1,39,2,0,0
30,1248,373,158,315,8,0,51,381,5,76,44,79,81,123,486,779,2,2026,112,0,0
23,613,102,59,69,5,3,24,107,6,22,15,28,28,43,113,206,3,789,43,0,0
87,1963,53,23,39,0,0,13,53,2,8,4,8,10,12,26,39,1,39,2,0,0
87,1963,515,298,307,33,80,99,548,12,63,44,77,75,121,419,753,7,5527,307,0,0
92,1965,1043,504,840,53,9,147,1096,9,180,112,198,189,310,1377,2344,4,11604,644,0,0
92,1965,383,288,292,26,6,62,409,11,65,38,67,76,105,429,656,5,3719,206,0,0
227,4916,1943,715,1694,26,18,214,1969,12,185,120,237,197,357,1436,2721,7,20915,1161,0,0
227,4916,1168,838,957,57,25,144,1225,19,348,224,416,367,640,3018,5452,11,61921,3440,1,0
77,4237,1296,573,1062,40,33,157,1336,8,201,118,231,209,349,1561,2689,4,12365,686,0,0
228,4924,1943,715,1694,26,18,214,1969,12,185,120,237,197,357,1436,2721,7,20915,1161,0,0
228,4924,1168,838,957,57,25,144,1225,19,348,224,416,367,640,3018,5452,11,61921,3440,1,0
103,4795,1338,495,1086,10,64,173,1348,11,122,82,157,133,239,883,1686,7,11934,663,0,0
78,4335,1296,573,1062,40,33,157,1336,8,201,118,231,209,349,1561,2689,4,12365,686,0,0
148,3404,77,34,69,0,0,8,77,3,24,16,29,27,45,114,213,1,387,21,0,0
148,3404,712,438,573,51,9,84,763,14,102,71,128,116,199,733,1364,8,11988,666,0,0
109,2070,477,336,357,30,23,73,507,16,194,134,250,210,384,1538,2962,10,30538,1696,0,1
111,2091,477,336,357,30,23,73,507,16,194,134,250,210,384,1538,2962,10,30538,1696,0,1
122,4845,1450,624,1228,12,26,181,1462,14,306,186,354,320,540,2580,4493,8,36391,2021,1,1
122,4887,1450,624,1228,12,26,181,1462,14,306,186,354,320,540,2580,4493,8,36391,2021,1,0
62,1174,282,196,195,3,0,86,285,8,130,71,141,138,212,936,1507,4,6538,363,0,0
111,2091,477,336,357,30,23,73,507,16,194,134,250,210,384,1538,2962,10,30538,1696,0,0
111,2094,477,336,357,30,23,73,507,16,194,134,250,210,384,1538,2962,10,30538,1696,0,0
122,4939,1450,624,1228,12,26,181,1462,14,306,186,354,320,540,2580,4493,8,36391,2021,1,0
111,2104,477,336,357,30,23,73,507,16,194,134,250,210,384,1538,2962,10,30538,1696,0,0
108,2074,477,336,357,30,23,73,507,16,194,134,250,210,384,1538,2962,10,30538,1696,0,0
108,2070,477,336,357,30,23,73,507,16,194,134,250,210,384,1538,2962,10,30538,1696,0,0
122,4959,1450,624,1228,12,26,181,1462,14,306,186,354,320,540,2580,4493,8,36391,2021,1,0
58,1067,282,196,195,3,0,86,285,8,130,71,141,138,212,936,1507,4,6538,363,0,1
29,743,601,196,481,2,23,85,603,8,63,36,72,71,108,400,664,4,3036,168,0,1
29,743,156,79,106,5,16,28,161,5,14,8,15,19,23,64,97,2,261,14,0,1
99,4109,1289,550,1043,56,32,155,1345,10,167,93,185,177,278,1266,2075,5,11498,638,0,1
25,1181,75,38,59,1,3,12,76,2,4,2,4,6,6,10,15,1,15,0,0,1
103,4810,1338,495,1086,10,64,173,1348,11,122,82,157,133,239,883,1686,7,11934,663,0,1
180,8032,139,89,101,2,0,35,141,7,54,34,62,61,96,330,569,4,2287,127,0,1
180,8032,7,5,5,0,0,2,7,1,2,1,2,3,3,2,4,0,2,0,0,1
138,6179,1782,648,1425,9,47,279,1791,8,171,97,189,179,286,1292,2140,4,9462,525,0,1
92,4728,1457,730,1242,11,6,188,1468,10,292,166,329,302,495,2424,4078,5,22973,1276,1,1
97,4242,1020,354,843,12,15,144,1032,8,134,77,144,142,221,970,1580,4,6792,377,0,1
21,670,424,94,331,4,0,89,428,1,5,5,5,6,10,11,25,0,12,0,0,1
66,3075,1293,570,1093,25,15,163,1318,10,195,123,241,205,364,1516,2795,6,17273,959,0,1
14,546,295,56,236,0,4,54,295,2,9,5,10,11,15,30,51,1,57,3,0,1
99,5096,1943,715,1694,26,18,214,1969,12,185,120,237,197,357,1436,2721,7,20915,1161,0,1
31,1326,442,244,305,14,16,103,456,11,68,45,75,79,120,452,756,6,4588,254,0,1
45,1575,601,196,481,2,23,85,603,8,63,36,72,71,108,400,664,4,3036,168,0,1
9,447,219,78,157,11,5,46,230,3,24,20,34,27,54,114,256,2,545,30,0,0
1,55,14,12,10,0,0,4,14,1,2,1,2,3,3,2,4,0,2,0,0,0
1,58,14,12,10,0,0,4,14,1,2,1,2,3,3,2,4,0,2,0,0,0
1,77,19,18,14,0,0,5,19,1,2,1,2,3,3,2,4,0,2,0,0,0
120,4779,1450,624,1228,12,26,181,1462,14,306,186,354,320,540,2580,4493,8,36391,2021,1,0
92,1983,1043,504,840,53,9,147,1096,9,180,112,198,189,310,1377,2344,4,11604,644,0,0
92,1983,383,288,292,26,6,62,409,11,65,38,67,76,105,429,656,5,3719,206,0,0
86,3304,1043,504,840,53,9,147,1096,9,180,112,198,189,310,1377,2344,4,11604,644,0,0
244,5852,722,423,573,19,0,135,741,12,172,101,199,184,300,1320,2257,6,15668,870,0,0
244,5852,1508,847,911,44,250,301,1552,14,148,88,169,162,257,1120,1886,7,15077,837,0,0
45,3296,996,429,845,24,10,117,1020,7,76,50,88,83,138,494,879,4,3565,198,0,0
58,1067,282,196,195,3,0,86,285,8,130,71,141,138,212,936,1507,4,6538,363,0,0
29,743,601,196,481,2,23,85,603,8,63,36,72,71,108,400,664,4,3036,168,0,0
29,743,156,79,106,5,16,28,161,5,14,8,15,19,23,64,97,2,261,14,0,0
99,4109,1289,550,1043,56,32,155,1345,10,167,93,185,177,278,1266,2075,5,11498,638,0,0
25,1181,75,38,59,1,3,12,76,2,4,2,4,6,6,10,15,1,15,0,0,0
103,4810,1338,495,1086,10,64,173,1348,11,122,82,157,133,239,883,1686,7,11934,663,0,0
180,8032,139,89,101,2,0,35,141,7,54,34,62,61,96,330,569,4,2287,127,0,0
180,8032,7,5,5,0,0,2,7,1,2,1,2,3,3,2,4,0,2,0,0,0
138,6179,1782,648,1425,9,47,279,1791,8,171,97,189,179,286,1292,2140,4,9462,525,0,0
92,4728,1457,730,1242,11,6,188,1468,10,292,166,329,302,495,2424,4078,5,22973,1276,1,0
97,4242,1020,354,843,12,15,144,1032,8,134,77,144,142,221,970,1580,4,6792,377,0,0
21,670,424,94,331,4,0,89,428,1,5,5,5,6,10,11,25,0,12,0,0,0
66,3075,1293,570,1093,25,15,163,1318,10,195,123,241,205,364,1516,2795,6,17273,959,0,0
14,546,295,56,236,0,4,54,295,2,9,5,10,11,15,30,51,1,57,3,0,0
99,5096,1943,715,1694,26,18,214,1969,12,185,120,237,197,357,1436,2721,7,20915,1161,0,0
31,1326,442,244,305,14,16,103,456,11,68,45,75,79,120,452,756,6,4588,254,0,0
45,1575,601,196,481,2,23,85,603,8,63,36,72,71,108,400,664,4,3036,168,0,0
150,3474,77,34,69,0,0,8,77,3,24,16,29,27,45,114,213,1,387,21,0,0
150,3474,712,438,573,51,9,84,763,14,102,71,128,116,199,733,1364,8,11988,666,0,0
87,1961,53,23,39,0,0,13,53,2,8,4,8,10,12,26,39,1,39,2,0,0
87,1961,515,298,307,33,80,99,548,12,63,44,77,75,121,419,753,7,5527,307,0,0
79,4449,1296,573,1062,40,33,157,1336,8,201,118,231,209,349,1561,2689,4,12365,686,0,0
30,1251,373,158,315,8,0,51,381,5,76,44,79,81,123,486,779,2,2026,112,0,0
108,2057,477,336,357,30,23,73,507,16,194,134,250,210,384,1538,2962,10,30538,1696,0,0
55,783,167,116,138,4,5,22,171,8,48,30,56,56,86,292,499,4,2330,129,0,0
92,1973,1043,504,840,53,9,147,1096,9,180,112,198,189,310,1377,2344,4,11604,644,0,0
92,1973,383,288,292,26,6,62,409,11,65,38,67,76,105,429,656,5,3719,206,0,0
81,1820,996,429,845,24,10,117,1020,7,76,50,88,83,138,494,879,4,3565,198,0,0
81,1820,456,277,329,12,42,72,468,13,85,50,97,98,147,592,972,7,7212,400,0,0
46,3385,996,429,845,24,10,117,1020,7,76,50,88,83,138,494,879,4,3565,198,0,0
308,6877,72,33,56,0,4,12,72,1,1,1,1,2,2,0,2,0,1,0,0,0
308,6877,1454,835,1044,76,110,219,1530,17,275,158,296,292,454,2297,3718,9,34017,1889,1,0
30,1260,373,158,315,8,0,51,381,5,76,44,79,81,123,486,779,2,2026,112,0,0
245,5865,722,423,573,19,0,135,741,12,172,101,199,184,300,1320,2257,6,15668,870,0,0
245,5865,1508,847,911,44,250,301,1552,14,148,88,169,162,257,1120,1886,7,15077,837,0,0
80,4548,1296,573,1062,40,33,157,1336,8,201,118,231,209,349,1561,2689,4,12365,686,0,0
180,5413,1660,832,1314,41,38,274,1701,20,312,209,395,332,604,2671,5058,12,64042,3557,1,0
180,5413,1057,646,719,113,100,145,1170,18,215,134,248,233,382,1740,3004,10,31186,1732,1,0
167,5019,1660,832,1314,41,38,274,1701,20,312,209,395,332,604,2671,5058,12,64042,3557,1,0
1,104,42,7,35,4,0,5,46,1,2,1,2,3,3,2,4,0,2,0,0,0
1,104,11,6,10,0,0,1,11,2,4,2,4,6,6,10,15,1,15,0,0,0
72,1422,207,111,150,11,0,50,218,5,26,19,36,31,55,133,272,3,943,52,0,0
72,1422,410,198,237,31,55,97,441,11,63,38,72,74,110,414,683,6,4293,238,0,0
92,1851,757,253,292,73,244,162,830,13,61,38,67,74,105,409,651,7,4654,258,0,0
66,4389,520,294,400,33,13,81,553,10,261,204,367,271,571,2128,4614,7,32445,1802,1,0
66,4392,520,294,400,33,13,81,553,10,261,204,367,271,571,2128,4614,7,32445,1802,1,0
41,1220,339,213,244,17,9,65,356,10,42,26,48,52,74,259,421,5,2410,133,0,1
67,3166,1293,570,1093,25,15,163,1318,10,195,123,241,205,364,1516,2795,6,17273,959,0,1
220,4765,2,2,2,0,0,0,2,0,0,0,0,0,0,0,0,0,0,0,0,0
220,4765,99,48,90,1,3,5,100,0,0,0,0,0,0,0,0,0,0,0,0,0
220,4765,8,5,5,2,0,1,10,0,0,0,0,0,0,0,0,0,0,0,0,0
220,4765,1217,716,841,84,126,174,1301,14,185,118,215,199,333,1446,2542,8,20687,1149,0,0
220,4765,160,89,115,0,13,31,160,7,15,11,17,22,28,78,124,3,495,27,0,0
220,4765,10,10,9,9,0,0,19,0,0,0,0,0,0,0,0,0,0,0,0,0
220,4765,173,84,99,8,29,36,181,5,12,7,13,17,20,54,81,2,221,12,0,0
220,4765,3,1,1,3,0,0,6,0,0,0,0,0,0,0,0,0,0,0,0,0
52,611,647,139,84,35,284,233,682,0,0,0,0,0,0,0,0,0,0,0,0,0
31,1865,384,251,317,7,8,52,391,11,70,44,84,81,128,467,811,6,5355,297,0,0
219,4745,2,2,2,0,0,0,2,0,0,0,0,0,0,0,0,0,0,0,0,0
219,4745,99,48,90,1,3,5,100,0,0,0,0,0,0,0,0,0,0,0,0,0
219,4745,8,5,5,2,0,1,10,0,0,0,0,0,0,0,0,0,0,0,0,0
219,4745,1217,716,841,84,126,174,1301,14,185,118,215,199,333,1446,2542,8,20687,1149,0,0
219,4745,160,89,115,0,13,31,160,7,15,11,17,22,28,78,124,3,495,27,0,0
219,4745,10,10,9,9,0,0,19,0,0,0,0,0,0,0,0,0,0,0,0,0
219,4745,173,84,99,8,29,36,181,5,12,7,13,17,20,54,81,2,221,12,0,0
219,4745,3,1,1,3,0,0,6,0,0,0,0,0,0,0,0,0,0,0,0,0
73,1482,207,111,150,11,0,50,218,5,26,19,36,31,55,133,272,3,943,52,0,0
73,1482,410,198,237,31,55,97,441,11,63,38,72,74,110,414,683,6,4293,238,0,0
138,6248,1782,648,1425,9,47,279,1791,8,171,97,189,179,286,1292,2140,4,9462,525,0,0
89,1926,402,202,227,24,74,80,426,12,52,33,61,64,94,339,564,7,3969,220,0,0
100,4333,1020,354,843,12,15,144,1032,8,134,77,144,142,221,970,1580,4,6792,377,0,0
89,1938,402,202,227,24,74,80,426,12,52,33,61,64,94,339,564,7,3969,220,0,0
139,6303,1782,648,1425,9,47,279,1791,8,171,97,189,179,286,1292,2140,4,9462,525,0,0
73,1512,207,111,150,11,0,50,218,5,26,19,36,31,55,133,272,3,943,52,0,0
73,1512,410,198,237,31,55,97,441,11,63,38,72,74,110,414,683,6,4293,238,0,0
139,6326,1782,648,1425,9,47,279,1791,8,171,97,189,179,286,1292,2140,4,9462,525,0,0
53,1120,447,308,343,6,5,95,453,7,96,59,111,103,170,651,1136,4,4600,255,0,1
53,1120,322,174,179,16,74,51,338,10,41,26,46,51,72,252,408,5,2291,127,0,1
19,699,442,244,305,14,16,103,456,11,68,45,75,79,120,452,756,6,4588,254,0,1
19,699,182,102,99,11,40,35,193,3,11,6,11,14,17,42,64,1,97,5,0,1
35,1433,442,244,305,14,16,103,456,11,68,45,75,79,120,452,756,6,4588,254,0,1
155,3263,1513,682,1277,25,13,200,1538,11,199,116,219,210,335,1557,2584,6,15641,868,0,0
155,3263,819,519,539,24,98,155,843,15,96,57,106,111,163,690,1107,8,9171,509,0,0
19,702,442,244,305,14,16,103,456,11,68,45,75,79,120,452,756,6,4588,254,0,0
19,702,182,102,99,11,40,35,193,3,11,6,11,14,17,42,64,1,97,5,0,0
19,709,442,244,305,14,16,103,456,11,68,45,75,79,120,452,756,6,4588,254,0,0
19,709,182,102,99,11,40,35,193,3,11,6,11,14,17,42,64,1,97,5,0,0
228,4926,1943,715,1694,26,18,214,1969,12,185,120,237,197,357,1436,2721,7,20915,1161,0,0
228,4926,1168,838,957,57,25,144,1225,19,348,224,416,367,640,3018,5452,11,61921,3440,1,0
35,1441,442,244,305,14,16,103,456,11,68,45,75,79,120,452,756,6,4588,254,0,0
180,5417,1660,832,1314,41,38,274,1701,20,312,209,395,332,604,2671,5058,12,64042,3557,1,0
180,5417,1057,646,719,113,100,145,1170,18,215,134,248,233,382,1740,3004,10,31186,1732,1,0
78,1787,996,429,845,24,10,117,1020,7,76,50,88,83,138,494,879,4,3565,198,0,0
78,1787,456,277,329,12,42,72,468,13,85,50,97,98,147,592,972,7,7212,400,0,0
220,4774,2,2,2,0,0,0,2,0,0,0,0,0,0,0,0,0,0,0,0,0
220,4774,99,48,90,1,3,5,100,0,0,0,0,0,0,0,0,0,0,0,0,0
220,4774,8,5,5,2,0,1,10,0,0,0,0,0,0,0,0,0,0,0,0,0
220,4774,1217,716,841,84,126,174,1301,14,185,118,215,199,333,1446,2542,8,20687,1149,0,0
220,4774,160,89,115,0,13,31,160,7,15,11,17,22,28,78,124,3,495,27,0,0
220,4774,10,10,9,9,0,0,19,0,0,0,0,0,0,0,0,0,0,0,0,0
220,4774,173,84,99,8,29,36,181,5,12,7,13,17,20,54,81,2,221,12,0,0
220,4774,3,1,1,3,0,0,6,0,0,0,0,0,0,0,0,0,0,0,0,0
51,766,167,116,138,4,5,22,171,8,48,30,56,56,86,292,499,4,2330,129,0,0
30,662,215,129,180,6,0,29,221,8,65,43,72,73,115,415,711,4,3153,175,0,0
30,662,97,69,77,3,3,16,100,6,22,13,23,28,36,113,173,3,542,30,0,0
29,745,601,196,481,2,23,85,603,8,63,36,72,71,108,400,664,4,3036,168,0,0
29,745,156,79,106,5,16,28,161,5,14,8,15,19,23,64,97,2,261,14,0,0
53,1120,447,308,343,6,5,95,453,7,96,59,111,103,170,651,1136,4,4600,255,0,0
53,1120,322,174,179,16,74,51,338,10,41,26,46,51,72,252,408,5,2291,127,0,0
224,4878,182,127,129,0,0,53,182,5,39,21,42,44,63,217,343,2,926,51,0,0
224,4878,1165,710,800,67,119,181,1232,18,243,153,282,261,435,2000,3492,10,36473,2026,1,0
29,843,256,139,192,9,7,47,265,4,23,12,24,27,36,112,171,2,357,19,0,0
231,4983,182,127,129,0,0,53,182,5,39,21,42,44,63,217,343,2,926,51,0,1
231,4983,1165,710,800,67,119,181,1232,18,243,153,282,261,435,2000,3492,10,36473,2026,1,1
89,1780,477,336,357,30,23,73,507,16,194,134,250,210,384,1538,2962,10,30538,1696,0,1
150,3478,77,34,69,0,0,8,77,3,24,16,29,27,45,114,213,1,387,21,0,1
150,3478,712,438,573,51,9,84,763,14,102,71,128,116,199,733,1364,8,11988,666,0,1
308,6881,72,33,56,0,4,12,72,1,1,1,1,2,2,0,2,0,1,0,0,1
308,6881,1454,835,1044,76,110,219,1530,17,275,158,296,292,454,2297,3718,9,34017,1889,1,1
91,1839,757,253,292,73,244,162,830,13,61,38,67,74,105,409,651,7,4654,258,0,1
92,1977,1043,504,840,53,9,147,1096,9,180,112,198,189,310,1377,2344,4,11604,644,0,1
92,1977,383,288,292,26,6,62,409,11,65,38,67,76,105,429,656,5,3719,206,0,1
62,1263,1098,241,925,5,10,155,1103,7,46,25,49,53,74,273,423,3,1580,87,0,1
62,1263,282,202,222,14,2,44,296,8,42,24,43,50,67,250,378,4,1548,86,0,1
35,1087,182,127,129,0,0,53,182,5,39,21,42,44,63,217,343,2,926,51,0,1
153,7207,1392,870,1177,35,17,170,1427,14,494,280,531,508,811,4473,7289,7,54850,3047,2,1
16,1247,215,129,180,6,0,29,221,8,65,43,72,73,115,415,711,4,3153,175,0,1
84,3302,1043,504,840,53,9,147,1096,9,180,112,198,189,310,1377,2344,4,11604,644,0,1
231,4983,182,127,129,0,0,53,182,5,39,21,42,44,63,217,343,2,926,51,0,0
231,4983,1165,710,800,67,119,181,1232,18,243,153,282,261,435,2000,3492,10,36473,2026,1,0
29,850,256,139,192,9,7,47,265,4,23,12,24,27,36,112,171,2,357,19,0,0
60,1163,282,196,195,3,0,86,285,8,130,71,141,138,212,936,1507,4,6538,363,0,0
46,3395,996,429,845,24,10,117,1020,7,76,50,88,83,138,494,879,4,3565,198,0,0
81,1825,996,429,845,24,10,117,1020,7,76,50,88,83,138,494,879,4,3565,198,0,0
81,1825,456,277,329,12,42,72,468,13,85,50,97,98,147,592,972,7,7212,400,0,0
108,2059,477,336,357,30,23,73,507,16,194,134,250,210,384,1538,2962,10,30538,1696,0,0
150,3478,77,34,69,0,0,8,77,3,24,16,29,27,45,114,213,1,387,21,0,0
150,3478,712,438,573,51,9,84,763,14,102,71,128,116,199,733,1364,8,11988,666,0,0
91,1839,757,253,292,73,244,162,830,13,61,38,67,74,105,409,651,7,4654,258,0,0
92,1977,1043,504,840,53,9,147,1096,9,180,112,198,189,310,1377,2344,4,11604,644,0,0
92,1977,383,288,292,26,6,62,409,11,65,38,67,76,105,429,656,5,3719,206,0,0
62,1263,1098,241,925,5,10,155,1103,7,46,25,49,53,74,273,423,3,1580,87,0,0
62,1263,282,202,222,14,2,44,296,8,42,24,43,50,67,250,378,4,1548,86,0,0
35,1087,182,127,129,0,0,53,182,5,39,21,42,44,63,217,343,2,926,51,0,0
153,7207,1392,870,1177,35,17,170,1427,14,494,280,531,508,811,4473,7289,7,54850,3047,2,0
16,1247,215,129,180,6,0,29,221,8,65,43,72,73,115,415,711,4,3153,175,0,0
84,3302,1043,504,840,53,9,147,1096,9,180,112,198,189,310,1377,2344,4,11604,644,0,0
230,4971,1943,715,1694,26,18,214,1969,12,185,120,237,197,357,1436,2721,7,20915,1161,0,0
230,4971,1168,838,957,57,25,144,1225,19,348,224,416,367,640,3018,5452,11,61921,3440,1,0
99,5127,1943,715,1694,26,18,214,1969,12,185,120,237,197,357,1436,2721,7,20915,1161,0,0
231,4976,1943,715,1694,26,18,214,1969,12,185,120,237,197,357,1436,2721,7,20915,1161,0,0
231,4976,1168,838,957,57,25,144,1225,19,348,224,416,367,640,3018,5452,11,61921,3440,1,0
100,5223,1943,715,1694,26,18,214,1969,12,185,120,237,197,357,1436,2721,7,20915,1161,0,0
30,878,256,139,192,9,7,47,265,4,23,12,24,27,36,112,171,2,357,19,0,0
219,4747,2,2,2,0,0,0,2,0,0,0,0,0,0,0,0,0,0,0,0,0
219,4747,99,48,90,1,3,5,100,0,0,0,0,0,0,0,0,0,0,0,0,0
219,4747,8,5,5,2,0,1,10,0,0,0,0,0,0,0,0,0,0,0,0,0
219,4747,1217,716,841,84,126,174,1301,14,185,118,215,199,333,1446,2542,8,20687,1149,0,0
219,4747,160,89,115,0,13,31,160,7,15,11,17,22,28,78,124,3,495,27,0,0
219,4747,10,10,9,9,0,0,19,0,0,0,0,0,0,0,0,0,0,0,0,0
219,4747,173,84,99,8,29,36,181,5,12,7,13,17,20,54,81,2,221,12,0,0
219,4747,3,1,1,3,0,0,6,0,0,0,0,0,0,0,0,0,0,0,0,0
55,792,167,116,138,4,5,22,171,8,48,30,56,56,86,292,499,4,2330,129,0,0
1,321,382,65,130,157,2,92,539,4,10,5,10,14,15,41,57,2,114,6,0,0
91,1842,757,253,292,73,244,162,830,13,61,38,67,74,105,409,651,7,4654,258,0,0
87,1961,53,23,39,0,0,13,53,2,8,4,8,10,12,26,39,1,39,2,0,1
87,1961,515,298,307,33,80,99,548,12,63,44,77,75,121,419,753,7,5527,307,0,1
105,4860,1338,495,1086,10,64,173,1348,11,122,82,157,133,239,883,1686,7,11934,663,0,1
139,6326,1782,648,1425,9,47,279,1791,8,171,97,189,179,286,1292,2140,4,9462,525,0,1
80,4548,1296,573,1062,40,33,157,1336,8,201,118,231,209,349,1561,2689,4,12365,686,0,1
100,5223,1943,715,1694,26,18,214,1969,12,185,120,237,197,357,1436,2721,7,20915,1161,0,1
105,4860,1338,495,1086,10,64,173,1348,11,122,82,157,133,239,883,1686,7,11934,663,0,0
60,1167,282,196,195,3,0,86,285,8,130,71,141,138,212,936,1507,4,6538,363,0,1
91,1864,757,253,292,73,244,162,830,13,61,38,67,74,105,409,651,7,4654,258,0,1
45,935,386,256,301,16,9,68,402,4,59,35,69,63,104,355,621,2,1453,80,0,1
45,935,264,131,164,11,41,46,275,6,38,22,40,44,62,214,338,3,1068,59,0,1
35,1093,182,127,129,0,0,53,182,5,39,21,42,44,63,217,343,2,926,51,0,1
153,7221,1392,870,1177,35,17,170,1427,14,494,280,531,508,811,4473,7289,7,54850,3047,2,1
92,2899,773,419,590,28,0,166,801,10,204,113,217,214,330,1598,2554,5,13587,754,0,1
1,24,127,75,83,2,11,30,129,4,14,7,14,18,21,61,87,2,175,9,0,1
1,24,652,304,544,16,6,88,668,6,89,51,101,95,152,591,998,3,3399,188,0,1
1,24,2,2,2,0,0,0,2,0,0,0,0,0,0,0,0,0,0,0,0,1
1,24,8,5,5,0,0,3,8,0,0,0,0,0,0,0,0,0,0,0,0,1
1,24,14,8,8,0,0,6,14,0,0,0,0,0,0,0,0,0,0,0,0,1
1,24,6,4,4,0,0,2,6,0,0,0,0,0,0,0,0,0,0,0,0,1
1,24,6,4,4,0,0,2,6,1,2,1,2,3,3,2,4,0,2,0,0,1
1,24,7,5,5,0,0,2,7,0,0,0,0,0,0,0,0,0,0,0,0,1
1,24,10,6,6,0,0,4,10,0,0,0,0,0,0,0,0,0,0,0,0,1
1,24,1,1,1,0,0,0,1,0,0,0,0,0,0,0,0,0,0,0,0,1
1,24,14,10,10,0,0,4,14,1,1,1,1,2,2,0,2,0,1,0,0,1
1,24,46,26,30,3,0,12,49,3,6,3,6,9,9,20,28,1,42,2,0,1
105,4868,1338,495,1086,10,64,173,1348,11,122,82,157,133,239,883,1686,7,11934,663,0,1
180,8038,139,89,101,2,0,35,141,7,54,34,62,61,96,330,569,4,2287,127,0,1
180,8038,7,5,5,0,0,2,7,1,2,1,2,3,3,2,4,0,2,0,0,1
139,6352,1782,648,1425,9,47,279,1791,8,171,97,189,179,286,1292,2140,4,9462,525,0,1
30,938,256,139,192,9,7,47,265,4,23,12,24,27,36,112,171,2,357,19,0,1
123,5266,1513,682,1277,25,13,200,1538,11,199,116,219,210,335,1557,2584,6,15641,868,0,1
92,4741,1457,730,1242,11,6,188,1468,10,292,166,329,302,495,2424,4078,5,22973,1276,1,1
42,1932,447,308,343,6,5,95,453,7,96,59,111,103,170,651,1136,4,4600,255,0,1
38,2315,334,251,279,10,4,40,344,5,127,74,143,132,217,899,1528,2,4303,239,0,1
31,1885,384,251,317,7,8,52,391,11,70,44,84,81,128,467,811,6,5355,297,0,1
47,2254,722,423,573,19,0,135,741,12,172,101,199,184,300,1320,2257,6,15668,870,0,1
45,1961,386,256,301,16,9,68,402,4,59,35,69,63,104,355,621,2,1453,80,0,1
84,3328,1043,504,840,53,9,147,1096,9,180,112,198,189,310,1377,2344,4,11604,644,0,1
30,1267,373,158,315,8,0,51,381,5,76,44,79,81,123,486,779,2,2026,112,0,1
100,5228,1943,715,1694,26,18,214,1969,12,185,120,237,197,357,1436,2721,7,20915,1161,0,1
60,1167,282,196,195,3,0,86,285,8,130,71,141,138,212,936,1507,4,6538,363,0,0
91,1864,757,253,292,73,244,162,830,13,61,38,67,74,105,409,651,7,4654,258,0,0
45,935,386,256,301,16,9,68,402,4,59,35,69,63,104,355,621,2,1453,80,0,0
45,935,264,131,164,11,41,46,275,6,38,22,40,44,62,214,338,3,1068,59,0,0
35,1093,182,127,129,0,0,53,182,5,39,21,42,44,63,217,343,2,926,51,0,0
153,7221,1392,870,1177,35,17,170,1427,14,494,280,531,508,811,4473,7289,7,54850,3047,2,0
92,2899,773,419,590,28,0,166,801,10,204,113,217,214,330,1598,2554,5,13587,754,0,0
1,24,127,75,83,2,11,30,129,4,14,7,14,18,21,61,87,2,175,9,0,0
1,24,652,304,544,16,6,88,668,6,89,51,101,95,152,591,998,3,3399,188,0,0
1,24,2,2,2,0,0,0,2,0,0,0,0,0,0,0,0,0,0,0,0,0
1,24,8,5,5,0,0,3,8,0,0,0,0,0,0,0,0,0,0,0,0,0
1,24,14,8,8,0,0,6,14,0,0,0,0,0,0,0,0,0,0,0,0,0
1,24,6,4,4,0,0,2,6,0,0,0,0,0,0,0,0,0,0,0,0,0
1,24,6,4,4,0,0,2,6,1,2,1,2,3,3,2,4,0,2,0,0,0
1,24,7,5,5,0,0,2,7,0,0,0,0,0,0,0,0,0,0,0,0,0
1,24,10,6,6,0,0,4,10,0,0,0,0,0,0,0,0,0,0,0,0,0
1,24,1,1,1,0,0,0,1,0,0,0,0,0,0,0,0,0,0,0,0,0
1,24,14,10,10,0,0,4,14,1,1,1,1,2,2,0,2,0,1,0,0,0
1,24,46,26,30,3,0,12,49,3,6,3,6,9,9,20,28,1,42,2,0,0
105,4868,1338,495,1086,10,64,173,1348,11,122,82,157,133,239,883,1686,7,11934,663,0,0
180,8038,139,89,101,2,0,35,141,7,54,34,62,61,96,330,569,4,2287,127,0,0
180,8038,7,5,5,0,0,2,7,1,2,1,2,3,3,2,4,0,2,0,0,0
139,6352,1782,648,1425,9,47,279,1791,8,171,97,189,179,286,1292,2140,4,9462,525,0,0
30,938,256,139,192,9,7,47,265,4,23,12,24,27,36,112,171,2,357,19,0,0
123,5266,1513,682,1277,25,13,200,1538,11,199,116,219,210,335,1557,2584,6,15641,868,0,0
92,4741,1457,730,1242,11,6,188,1468,10,292,166,329,302,495,2424,4078,5,22973,1276,1,0
42,1932,447,308,343,6,5,95,453,7,96,59,111,103,170,651,1136,4,4600,255,0,0
38,2315,334,251,279,10,4,40,344,5,127,74,143,132,217,899,1528,2,4303,239,0,0
31,1885,384,251,317,7,8,52,391,11,70,44,84,81,128,467,811,6,5355,297,0,0
47,2254,722,423,573,19,0,135,741,12,172,101,199,184,300,1320,2257,6,15668,870,0,0
45,1961,386,256,301,16,9,68,402,4,59,35,69,63,104,355,621,2,1453,80,0,0
84,3328,1043,504,840,53,9,147,1096,9,180,112,198,189,310,1377,2344,4,11604,644,0,0
30,1267,373,158,315,8,0,51,381,5,76,44,79,81,123,486,779,2,2026,112,0,0
100,5228,1943,715,1694,26,18,214,1969,12,185,120,237,197,357,1436,2721,7,20915,1161,0,0
73,1510,207,111,150,11,0,50,218,5,26,19,36,31,55,133,272,3,943,52,0,1
73,1510,410,198,237,31,55,97,441,11,63,38,72,74,110,414,683,6,4293,238,0,1
83,1769,53,23,39,0,0,13,53,2,8,4,8,10,12,26,39,1,39,2,0,1
83,1769,515,298,307,33,80,99,548,12,63,44,77,75,121,419,753,7,5527,307,0,1
18,304,424,94,331,4,0,89,428,1,5,5,5,6,10,11,25,0,12,0,0,1
18,304,38,23,23,6,0,8,44,3,11,7,11,14,18,42,68,1,102,5,0,1
300,6660,72,33,56,0,4,12,72,1,1,1,1,2,2,0,2,0,1,0,0,1
300,6660,1454,835,1044,76,110,219,1530,17,275,158,296,292,454,2297,3718,9,34017,1889,1,1
22,1058,75,38,59,1,3,12,76,2,4,2,4,6,6,10,15,1,15,0,0,1
91,4033,1338,495,1086,10,64,173,1348,11,122,82,157,133,239,883,1686,7,11934,663,0,1
179,8008,139,89,101,2,0,35,141,7,54,34,62,61,96,330,569,4,2287,127,0,1
179,8008,7,5,5,0,0,2,7,1,2,1,2,3,3,2,4,0,2,0,0,1
79,4485,1296,573,1062,40,33,157,1336,8,201,118,231,209,349,1561,2689,4,12365,686,0,1
20,626,424,94,331,4,0,89,428,1,5,5,5,6,10,11,25,0,12,0,0,1
65,2991,1293,570,1093,25,15,163,1318,10,195,123,241,205,364,1516,2795,6,17273,959,0,1
12,478,295,56,236,0,4,54,295,2,9,5,10,11,15,30,51,1,57,3,0,1
29,1210,373,158,315,8,0,51,381,5,76,44,79,81,123,486,779,2,2026,112,0,1
102,5247,1943,715,1694,26,18,214,1969,12,185,120,237,197,357,1436,2721,7,20915,1161,0,1
73,1510,207,111,150,11,0,50,218,5,26,19,36,31,55,133,272,3,943,52,0,0
73,1510,410,198,237,31,55,97,441,11,63,38,72,74,110,414,683,6,4293,238,0,0
83,1769,53,23,39,0,0,13,53,2,8,4,8,10,12,26,39,1,39,2,0,0
83,1769,515,298,307,33,80,99,548,12,63,44,77,75,121,419,753,7,5527,307,0,0
18,304,424,94,331,4,0,89,428,1,5,5,5,6,10,11,25,0,12,0,0,0
18,304,38,23,23,6,0,8,44,3,11,7,11,14,18,42,68,1,102,5,0,0
300,6660,72,33,56,0,4,12,72,1,1,1,1,2,2,0,2,0,1,0,0,0
300,6660,1454,835,1044,76,110,219,1530,17,275,158,296,292,454,2297,3718,9,34017,1889,1,0
22,1058,75,38,59,1,3,12,76,2,4,2,4,6,6,10,15,1,15,0,0,0
91,4033,1338,495,1086,10,64,173,1348,11,122,82,157,133,239,883,1686,7,11934,663,0,0
179,8008,139,89,101,2,0,35,141,7,54,34,62,61,96,330,569,4,2287,127,0,0
179,8008,7,5,5,0,0,2,7,1,2,1,2,3,3,2,4,0,2,0,0,0
79,4485,1296,573,1062,40,33,157,1336,8,201,118,231,209,349,1561,2689,4,12365,686,0,0
20,626,424,94,331,4,0,89,428,1,5,5,5,6,10,11,25,0,12,0,0,0
65,2991,1293,570,1093,25,15,163,1318,10,195,123,241,205,364,1516,2795,6,17273,959,0,0
12,478,295,56,236,0,4,54,295,2,9,5,10,11,15,30,51,1,57,3,0,0
29,1210,373,158,315,8,0,51,381,5,76,44,79,81,123,486,779,2,2026,112,0,0
102,5247,1943,715,1694,26,18,214,1969,12,185,120,237,197,357,1436,2721,7,20915,1161,0,0
18,306,424,94,331,4,0,89,428,1,5,5,5,6,10,11,25,0,12,0,0,0
18,306,38,23,23,6,0,8,44,3,11,7,11,14,18,42,68,1,102,5,0,0
95,2070,1043,504,840,53,9,147,1096,9,180,112,198,189,310,1377,2344,4,11604,644,0,0
95,2070,383,288,292,26,6,62,409,11,65,38,67,76,105,429,656,5,3719,206,0,0
82,3278,1043,504,840,53,9,147,1096,9,180,112,198,189,310,1377,2344,4,11604,644,0,0
253,5893,4293,999,3693,19,54,507,4312,9,155,88,170,164,258,1156,1898,4,9368,520,0,0
253,5893,1482,859,1002,125,135,219,1607,16,219,134,251,235,385,1766,3032,9,27804,1544,1,0
21,1025,75,38,59,1,3,12,76,2,4,2,4,6,6,10,15,1,15,0,0,0
168,7511,139,89,101,2,0,35,141,7,54,34,62,61,96,330,569,4,2287,127,0,0
168,7511,7,5,5,0,0,2,7,1,2,1,2,3,3,2,4,0,2,0,0,0
253,5889,4293,999,3693,19,54,507,4312,9,155,88,170,164,258,1156,1898,4,9368,520,0,0
253,5889,1482,859,1002,125,135,219,1607,16,219,134,251,235,385,1766,3032,9,27804,1544,1,0
292,6512,72,33,56,0,4,12,72,1,1,1,1,2,2,0,2,0,1,0,0,0
292,6512,1454,835,1044,76,110,219,1530,17,275,158,296,292,454,2297,3718,9,34017,1889,1,0
20,985,75,38,59,1,3,12,76,2,4,2,4,6,6,10,15,1,15,0,0,0
125,5615,1782,648,1425,9,47,279,1791,8,171,97,189,179,286,1292,2140,4,9462,525,0,0
156,3283,1513,682,1277,25,13,200,1538,11,199,116,219,210,335,1557,2584,6,15641,868,0,0
156,3283,819,519,539,24,98,155,843,15,96,57,106,111,163,690,1107,8,9171,509,0,0
124,5321,1513,682,1277,25,13,200,1538,11,199,116,219,210,335,1557,2584,6,15641,868,0,0
124,5323,1513,682,1277,25,13,200,1538,11,199,116,219,210,335,1557,2584,6,15641,868,0,0
154,3591,77,34,69,0,0,8,77,3,24,16,29,27,45,114,213,1,387,21,0,0
154,3591,712,438,573,51,9,84,763,14,102,71,128,116,199,733,1364,8,11988,666,0,0
102,5249,1943,715,1694,26,18,214,1969,12,185,120,237,197,357,1436,2721,7,20915,1161,0,0
82,1853,996,429,845,24,10,117,1020,7,76,50,88,83,138,494,879,4,3565,198,0,0
82,1853,456,277,329,12,42,72,468,13,85,50,97,98,147,592,972,7,7212,400,0,0
47,3455,996,429,845,24,10,117,1020,7,76,50,88,83,138,494,879,4,3565,198,0,0
49,1683,601,196,481,2,23,85,603,8,63,36,72,71,108,400,664,4,3036,168,0,0
51,1739,601,196,481,2,23,85,603,8,63,36,72,71,108,400,664,4,3036,168,0,0
183,5668,1660,832,1314,41,38,274,1701,20,312,209,395,332,604,2671,5058,12,64042,3557,1,0
183,5668,1057,646,719,113,100,145,1170,18,215,134,248,233,382,1740,3004,10,31186,1732,1,0
51,1754,601,196,481,2,23,85,603,8,63,36,72,71,108,400,664,4,3036,168,0,1
183,5584,1660,832,1314,41,38,274,1701,20,312,209,395,332,604,2671,5058,12,64042,3557,1,1
183,5584,1057,646,719,113,100,145,1170,18,215,134,248,233,382,1740,3004,10,31186,1732,1,1
183,5584,1660,832,1314,41,38,274,1701,20,312,209,395,332,604,2671,5058,12,64042,3557,1,0
183,5584,1057,646,719,113,100,145,1170,18,215,134,248,233,382,1740,3004,10,31186,1732,1,0
51,1740,601,196,481,2,23,85,603,8,63,36,72,71,108,400,664,4,3036,168,0,0
183,5583,1660,832,1314,41,38,274,1701,20,312,209,395,332,604,2671,5058,12,64042,3557,1,0
183,5583,1057,646,719,113,100,145,1170,18,215,134,248,233,382,1740,3004,10,31186,1732,1,0
183,5583,1660,832,1314,41,38,274,1701,20,312,209,395,332,604,2671,5058,12,64042,3557,1,1
183,5583,1057,646,719,113,100,145,1170,18,215,134,248,233,382,1740,3004,10,31186,1732,1,1
184,5591,1660,832,1314,41,38,274,1701,20,312,209,395,332,604,2671,5058,12,64042,3557,1,0
184,5591,1057,646,719,113,100,145,1170,18,215,134,248,233,382,1740,3004,10,31186,1732,1,0
51,1747,601,196,481,2,23,85,603,8,63,36,72,71,108,400,664,4,3036,168,0,0
110,4163,1450,624,1228,12,26,181,1462,14,306,186,354,320,540,2580,4493,8,36391,2021,1,0
92,4758,1457,730,1242,11,6,188,1468,10,292,166,329,302,495,2424,4078,5,22973,1276,1,0
96,4707,1523,757,1297,19,12,193,1542,12,193,117,230,205,347,1508,2664,7,19053,1058,0,0
100,5271,1943,715,1694,26,18,214,1969,12,185,120,237,197,357,1436,2721,7,20915,1161,0,0
222,4823,2,2,2,0,0,0,2,0,0,0,0,0,0,0,0,0,0,0,0,0
222,4823,99,48,90,1,3,5,100,0,0,0,0,0,0,0,0,0,0,0,0,0
222,4823,8,5,5,2,0,1,10,0,0,0,0,0,0,0,0,0,0,0,0,0
222,4823,1217,716,841,84,126,174,1301,14,185,118,215,199,333,1446,2542,8,20687,1149,0,0
222,4823,160,89,115,0,13,31,160,7,15,11,17,22,28,78,124,3,495,27,0,0
222,4823,10,10,9,9,0,0,19,0,0,0,0,0,0,0,0,0,0,0,0,0
222,4823,173,84,99,8,29,36,181,5,12,7,13,17,20,54,81,2,221,12,0,0
222,4823,3,1,1,3,0,0,6,0,0,0,0,0,0,0,0,0,0,0,0,0
94,4851,1457,730,1242,11,6,188,1468,10,292,166,329,302,495,2424,4078,5,22973,1276,1,0
156,3271,1513,682,1277,25,13,200,1538,11,199,116,219,210,335,1557,2584,6,15641,868,0,0
156,3271,819,519,539,24,98,155,843,15,96,57,106,111,163,690,1107,8,9171,509,0,0
221,4796,2,2,2,0,0,0,2,0,0,0,0,0,0,0,0,0,0,0,0,0
221,4796,99,48,90,1,3,5,100,0,0,0,0,0,0,0,0,0,0,0,0,0
221,4796,8,5,5,2,0,1,10,0,0,0,0,0,0,0,0,0,0,0,0,0
221,4796,1217,716,841,84,126,174,1301,14,185,118,215,199,333,1446,2542,8,20687,1149,0,0
221,4796,160,89,115,0,13,31,160,7,15,11,17,22,28,78,124,3,495,27,0,0
221,4796,10,10,9,9,0,0,19,0,0,0,0,0,0,0,0,0,0,0,0,0
221,4796,173,84,99,8,29,36,181,5,12,7,13,17,20,54,81,2,221,12,0,0
221,4796,3,1,1,3,0,0,6,0,0,0,0,0,0,0,0,0,0,0,0,0
124,5331,1513,682,1277,25,13,200,1538,11,199,116,219,210,335,1557,2584,6,15641,868,0,0
94,4864,1457,730,1242,11,6,188,1468,10,292,166,329,302,495,2424,4078,5,22973,1276,1,0
30,880,256,139,192,9,7,47,265,4,23,12,24,27,36,112,171,2,357,19,0,0
30,940,256,139,192,9,7,47,265,4,23,12,24,27,36,112,171,2,357,19,0,0
154,3597,77,34,69,0,0,8,77,3,24,16,29,27,45,114,213,1,387,21,0,1
154,3597,712,438,573,51,9,84,763,14,102,71,128,116,199,733,1364,8,11988,666,0,1
95,2085,1043,504,840,53,9,147,1096,9,180,112,198,189,310,1377,2344,4,11604,644,0,1
95,2085,383,288,292,26,6,62,409,11,65,38,67,76,105,429,656,5,3719,206,0,1
82,3282,1043,504,840,53,9,147,1096,9,180,112,198,189,310,1377,2344,4,11604,644,0,1
223,4836,2,2,2,0,0,0,2,0,0,0,0,0,0,0,0,0,0,0,0,1
223,4836,99,48,90,1,3,5,100,0,0,0,0,0,0,0,0,0,0,0,0,1
223,4836,8,5,5,2,0,1,10,0,0,0,0,0,0,0,0,0,0,0,0,1
223,4836,1217,716,841,84,126,174,1301,14,185,118,215,199,333,1446,2542,8,20687,1149,0,1
223,4836,160,89,115,0,13,31,160,7,15,11,17,22,28,78,124,3,495,27,0,1
223,4836,10,10,9,9,0,0,19,0,0,0,0,0,0,0,0,0,0,0,0,1
223,4836,173,84,99,8,29,36,181,5,12,7,13,17,20,54,81,2,221,12,0,1
223,4836,3,1,1,3,0,0,6,0,0,0,0,0,0,0,0,0,0,0,0,1
31,1922,384,251,317,7,8,52,391,11,70,44,84,81,128,467,811,6,5355,297,0,1
41,1220,339,213,244,17,9,65,356,10,42,26,48,52,74,259,421,5,2410,133,0,0
66,3082,1293,570,1093,25,15,163,1318,10,195,123,241,205,364,1516,2795,6,17273,959,0,0
97,2016,463,295,324,28,62,57,491,12,134,82,154,146,236,989,1696,6,11700,650,0,0
39,2361,334,251,279,10,4,40,344,5,127,74,143,132,217,899,1528,2,4303,239,0,0
223,4836,2,2,2,0,0,0,2,0,0,0,0,0,0,0,0,0,0,0,0,0
223,4836,99,48,90,1,3,5,100,0,0,0,0,0,0,0,0,0,0,0,0,0
223,4836,8,5,5,2,0,1,10,0,0,0,0,0,0,0,0,0,0,0,0,0
223,4836,1217,716,841,84,126,174,1301,14,185,118,215,199,333,1446,2542,8,20687,1149,0,0
223,4836,160,89,115,0,13,31,160,7,15,11,17,22,28,78,124,3,495,27,0,0
223,4836,10,10,9,9,0,0,19,0,0,0,0,0,0,0,0,0,0,0,0,0
223,4836,173,84,99,8,29,36,181,5,12,7,13,17,20,54,81,2,221,12,0,0
223,4836,3,1,1,3,0,0,6,0,0,0,0,0,0,0,0,0,0,0,0,0
31,1922,384,251,317,7,8,52,391,11,70,44,84,81,128,467,811,6,5355,297,0,0
101,2731,1523,757,1297,19,12,193,1542,12,193,117,230,205,347,1508,2664,7,19053,1058,0,0
101,2731,701,378,504,33,58,109,734,13,110,68,126,123,194,794,1346,7,10027,557,0,0
97,4762,1523,757,1297,19,12,193,1542,12,193,117,230,205,347,1508,2664,7,19053,1058,0,0
101,2732,1523,757,1297,19,12,193,1542,12,193,117,230,205,347,1508,2664,7,19053,1058,0,0
101,2732,701,378,504,33,58,109,734,13,110,68,126,123,194,794,1346,7,10027,557,0,0
77,3228,1178,367,1042,6,15,115,1184,9,94,51,95,103,146,644,976,4,4439,246,0,0
100,2714,1523,757,1297,19,12,193,1542,12,193,117,230,205,347,1508,2664,7,19053,1058,0,0
100,2714,701,378,504,33,58,109,734,13,110,68,126,123,194,794,1346,7,10027,557,0,0
97,4761,1523,757,1297,19,12,193,1542,12,193,117,230,205,347,1508,2664,7,19053,1058,0,0
291,6482,72,33,56,0,4,12,72,1,1,1,1,2,2,0,2,0,1,0,0,0
291,6482,1454,835,1044,76,110,219,1530,17,275,158,296,292,454,2297,3718,9,34017,1889,1,0
17,910,75,38,59,1,3,12,76,2,4,2,4,6,6,10,15,1,15,0,0,0
94,4881,1457,730,1242,11,6,188,1468,10,292,166,329,302,495,2424,4078,5,22973,1276,1,0
54,1145,447,308,343,6,5,95,453,7,96,59,111,103,170,651,1136,4,4600,255,0,0
54,1145,322,174,179,16,74,51,338,10,41,26,46,51,72,252,408,5,2291,127,0,0
45,2011,447,308,343,6,5,95,453,7,96,59,111,103,170,651,1136,4,4600,255,0,0
31,911,256,139,192,9,7,47,265,4,23,12,24,27,36,112,171,2,357,19,0,0
91,1876,757,253,292,73,244,162,830,13,61,38,67,74,105,409,651,7,4654,258,0,0
18,939,75,38,59,1,3,12,76,2,4,2,4,6,6,10,15,1,15,0,0,0
30,948,256,139,192,9,7,47,265,4,23,12,24,27,36,112,171,2,357,19,0,0
154,3597,77,34,69,0,0,8,77,3,24,16,29,27,45,114,213,1,387,21,0,0
154,3597,712,438,573,51,9,84,763,14,102,71,128,116,199,733,1364,8,11988,666,0,0
95,2085,1043,504,840,53,9,147,1096,9,180,112,198,189,310,1377,2344,4,11604,644,0,0
95,2085,383,288,292,26,6,62,409,11,65,38,67,76,105,429,656,5,3719,206,0,0
82,3282,1043,504,840,53,9,147,1096,9,180,112,198,189,310,1377,2344,4,11604,644,0,0
222,4829,2,2,2,0,0,0,2,0,0,0,0,0,0,0,0,0,0,0,0,0
222,4829,99,48,90,1,3,5,100,0,0,0,0,0,0,0,0,0,0,0,0,0
222,4829,8,5,5,2,0,1,10,0,0,0,0,0,0,0,0,0,0,0,0,0
222,4829,1217,716,841,84,126,174,1301,14,185,118,215,199,333,1446,2542,8,20687,1149,0,0
222,4829,160,89,115,0,13,31,160,7,15,11,17,22,28,78,124,3,495,27,0,0
222,4829,10,10,9,9,0,0,19,0,0,0,0,0,0,0,0,0,0,0,0,0
222,4829,173,84,99,8,29,36,181,5,12,7,13,17,20,54,81,2,221,12,0,0
222,4829,3,1,1,3,0,0,6,0,0,0,0,0,0,0,0,0,0,0,0,0
250,5779,4293,999,3693,19,54,507,4312,9,155,88,170,164,258,1156,1898,4,9368,520,0,0
250,5779,1482,859,1002,125,135,219,1607,16,219,134,251,235,385,1766,3032,9,27804,1544,1,0
17,901,75,38,59,1,3,12,76,2,4,2,4,6,6,10,15,1,15,0,0,0
167,7471,139,89,101,2,0,35,141,7,54,34,62,61,96,330,569,4,2287,127,0,0
167,7471,7,5,5,0,0,2,7,1,2,1,2,3,3,2,4,0,2,0,0,0
184,5593,1660,832,1314,41,38,274,1701,20,312,209,395,332,604,2671,5058,12,64042,3557,1,1
184,5593,1057,646,719,113,100,145,1170,18,215,134,248,233,382,1740,3004,10,31186,1732,1,1
82,1855,996,429,845,24,10,117,1020,7,76,50,88,83,138,494,879,4,3565,198,0,1
82,1855,456,277,329,12,42,72,468,13,85,50,97,98,147,592,972,7,7212,400,0,1
217,4669,2,2,2,0,0,0,2,0,0,0,0,0,0,0,0,0,0,0,0,1
217,4669,99,48,90,1,3,5,100,0,0,0,0,0,0,0,0,0,0,0,0,1
217,4669,8,5,5,2,0,1,10,0,0,0,0,0,0,0,0,0,0,0,0,1
217,4669,1217,716,841,84,126,174,1301,14,185,118,215,199,333,1446,2542,8,20687,1149,0,1
217,4669,160,89,115,0,13,31,160,7,15,11,17,22,28,78,124,3,495,27,0,1
217,4669,10,10,9,9,0,0,19,0,0,0,0,0,0,0,0,0,0,0,0,1
217,4669,173,84,99,8,29,36,181,5,12,7,13,17,20,54,81,2,221,12,0,1
217,4669,3,1,1,3,0,0,6,0,0,0,0,0,0,0,0,0,0,0,0,1
55,796,167,116,138,4,5,22,171,8,48,30,56,56,86,292,499,4,2330,129,0,1
52,621,647,139,84,35,284,233,682,0,0,0,0,0,0,0,0,0,0,0,0,1
76,1637,53,23,39,0,0,13,53,2,8,4,8,10,12,26,39,1,39,2,0,1
76,1637,515,298,307,33,80,99,548,12,63,44,77,75,121,419,753,7,5527,307,0,1
30,664,215,129,180,6,0,29,221,8,65,43,72,73,115,415,711,4,3153,175,0,1
30,664,97,69,77,3,3,16,100,6,22,13,23,28,36,113,173,3,542,30,0,1
230,4915,1943,715,1694,26,18,214,1969,12,185,120,237,197,357,1436,2721,7,20915,1161,0,1
230,4915,1168,838,957,57,25,144,1225,19,348,224,416,367,640,3018,5452,11,61921,3440,1,1
99,4118,1289,550,1043,56,32,155,1345,10,167,93,185,177,278,1266,2075,5,11498,638,0,1
18,948,75,38,59,1,3,12,76,2,4,2,4,6,6,10,15,1,15,0,0,1
167,5017,1660,832,1314,41,38,274,1701,20,312,209,395,332,604,2671,5058,12,64042,3557,1,1
90,4699,1457,730,1242,11,6,188,1468,10,292,166,329,302,495,2424,4078,5,22973,1276,1,1
28,1839,384,251,317,7,8,52,391,11,70,44,84,81,128,467,811,6,5355,297,0,1
51,1747,601,196,481,2,23,85,603,8,63,36,72,71,108,400,664,4,3036,168,0,1
100,2715,1523,757,1297,19,12,193,1542,12,193,117,230,205,347,1508,2664,7,19053,1058,0,0
100,2715,701,378,504,33,58,109,734,13,110,68,126,123,194,794,1346,7,10027,557,0,0
91,1879,757,253,292,73,244,162,830,13,61,38,67,74,105,409,651,7,4654,258,0,0
31,979,256,139,192,9,7,47,265,4,23,12,24,27,36,112,171,2,357,19,0,0
120,4791,1450,624,1228,12,26,181,1462,14,306,186,354,320,540,2580,4493,8,36391,2021,1,0
94,4894,1457,730,1242,11,6,188,1468,10,292,166,329,302,495,2424,4078,5,22973,1276,1,0
97,4773,1523,757,1297,19,12,193,1542,12,193,117,230,205,347,1508,2664,7,19053,1058,0,0
102,5297,1943,715,1694,26,18,214,1969,12,185,120,237,197,357,1436,2721,7,20915,1161,0,0
99,2685,1523,757,1297,19,12,193,1542,12,193,117,230,205,347,1508,2664,7,19053,1058,0,0
99,2685,701,378,504,33,58,109,734,13,110,68,126,123,194,794,1346,7,10027,557,0,0
221,4803,2,2,2,0,0,0,2,0,0,0,0,0,0,0,0,0,0,0,0,1
221,4803,99,48,90,1,3,5,100,0,0,0,0,0,0,0,0,0,0,0,0,1
221,4803,8,5,5,2,0,1,10,0,0,0,0,0,0,0,0,0,0,0,0,1
221,4803,1217,716,841,84,126,174,1301,14,185,118,215,199,333,1446,2542,8,20687,1149,0,1
221,4803,160,89,115,0,13,31,160,7,15,11,17,22,28,78,124,3,495,27,0,1
221,4803,10,10,9,9,0,0,19,0,0,0,0,0,0,0,0,0,0,0,0,1
221,4803,173,84,99,8,29,36,181,5,12,7,13,17,20,54,81,2,221,12,0,1
221,4803,3,1,1,3,0,0,6,0,0,0,0,0,0,0,0,0,0,0,0,1
99,4088,1289,550,1043,56,32,155,1345,10,167,93,185,177,278,1266,2075,5,11498,638,0,1
15,827,75,38,59,1,3,12,76,2,4,2,4,6,6,10,15,1,15,0,0,1
291,6479,72,33,56,0,4,12,72,1,1,1,1,2,2,0,2,0,1,0,0,0
291,6479,1454,835,1044,76,110,219,1530,17,275,158,296,292,454,2297,3718,9,34017,1889,1,0
125,5597,1782,648,1425,9,47,279,1791,8,171,97,189,179,286,1292,2140,4,9462,525,0,0
221,4803,2,2,2,0,0,0,2,0,0,0,0,0,0,0,0,0,0,0,0,0
221,4803,99,48,90,1,3,5,100,0,0,0,0,0,0,0,0,0,0,0,0,0
221,4803,8,5,5,2,0,1,10,0,0,0,0,0,0,0,0,0,0,0,0,0
221,4803,1217,716,841,84,126,174,1301,14,185,118,215,199,333,1446,2542,8,20687,1149,0,0
221,4803,160,89,115,0,13,31,160,7,15,11,17,22,28,78,124,3,495,27,0,0
221,4803,10,10,9,9,0,0,19,0,0,0,0,0,0,0,0,0,0,0,0,0
221,4803,173,84,99,8,29,36,181,5,12,7,13,17,20,54,81,2,221,12,0,0
221,4803,3,1,1,3,0,0,6,0,0,0,0,0,0,0,0,0,0,0,0,0
99,2686,1523,757,1297,19,12,193,1542,12,193,117,230,205,347,1508,2664,7,19053,1058,0,0
99,2686,701,378,504,33,58,109,734,13,110,68,126,123,194,794,1346,7,10027,557,0,0
99,4088,1289,550,1043,56,32,155,1345,10,167,93,185,177,278,1266,2075,5,11498,638,0,0
15,827,75,38,59,1,3,12,76,2,4,2,4,6,6,10,15,1,15,0,0,0
215,4636,2,2,2,0,0,0,2,0,0,0,0,0,0,0,0,0,0,0,0,0
215,4636,99,48,90,1,3,5,100,0,0,0,0,0,0,0,0,0,0,0,0,0
215,4636,8,5,5,2,0,1,10,0,0,0,0,0,0,0,0,0,0,0,0,0
215,4636,1217,716,841,84,126,174,1301,14,185,118,215,199,333,1446,2542,8,20687,1149,0,0
215,4636,160,89,115,0,13,31,160,7,15,11,17,22,28,78,124,3,495,27,0,0
215,4636,10,10,9,9,0,0,19,0,0,0,0,0,0,0,0,0,0,0,0,0
215,4636,173,84,99,8,29,36,181,5,12,7,13,17,20,54,81,2,221,12,0,0
215,4636,3,1,1,3,0,0,6,0,0,0,0,0,0,0,0,0,0,0,0,0
99,4097,1289,550,1043,56,32,155,1345,10,167,93,185,177,278,1266,2075,5,11498,638,0,0
15,836,75,38,59,1,3,12,76,2,4,2,4,6,6,10,15,1,15,0,0,0
90,4729,1457,730,1242,11,6,188,1468,10,292,166,329,302,495,2424,4078,5,22973,1276,1,0
73,1518,207,111,150,11,0,50,218,5,26,19,36,31,55,133,272,3,943,52,0,0
73,1518,410,198,237,31,55,97,441,11,63,38,72,74,110,414,683,6,4293,238,0,0
92,1894,757,253,292,73,244,162,830,13,61,38,67,74,105,409,651,7,4654,258,0,0
184,5593,1660,832,1314,41,38,274,1701,20,312,209,395,332,604,2671,5058,12,64042,3557,1,0
184,5593,1057,646,719,113,100,145,1170,18,215,134,248,233,382,1740,3004,10,31186,1732,1,0
82,1855,996,429,845,24,10,117,1020,7,76,50,88,83,138,494,879,4,3565,198,0,0
82,1855,456,277,329,12,42,72,468,13,85,50,97,98,147,592,972,7,7212,400,0,0
55,796,167,116,138,4,5,22,171,8,48,30,56,56,86,292,499,4,2330,129,0,0
52,621,647,139,84,35,284,233,682,0,0,0,0,0,0,0,0,0,0,0,0,0
76,1637,53,23,39,0,0,13,53,2,8,4,8,10,12,26,39,1,39,2,0,0
76,1637,515,298,307,33,80,99,548,12,63,44,77,75,121,419,753,7,5527,307,0,0
30,664,215,129,180,6,0,29,221,8,65,43,72,73,115,415,711,4,3153,175,0,0
30,664,97,69,77,3,3,16,100,6,22,13,23,28,36,113,173,3,542,30,0,0
230,4915,1943,715,1694,26,18,214,1969,12,185,120,237,197,357,1436,2721,7,20915,1161,0,0
230,4915,1168,838,957,57,25,144,1225,19,348,224,416,367,640,3018,5452,11,61921,3440,1,0
167,5017,1660,832,1314,41,38,274,1701,20,312,209,395,332,604,2671,5058,12,64042,3557,1,0
28,1839,384,251,317,7,8,52,391,11,70,44,84,81,128,467,811,6,5355,297,0,0
246,5700,4293,999,3693,19,54,507,4312,9,155,88,170,164,258,1156,1898,4,9368,520,0,1
246,5700,1482,859,1002,125,135,219,1607,16,219,134,251,235,385,1766,3032,9,27804,1544,1,1
13,806,75,38,59,1,3,12,76,2,4,2,4,6,6,10,15,1,15,0,0,1
169,7506,139,89,101,2,0,35,141,7,54,34,62,61,96,330,569,4,2287,127,0,1
169,7506,7,5,5,0,0,2,7,1,2,1,2,3,3,2,4,0,2,0,0,1
246,5700,4293,999,3693,19,54,507,4312,9,155,88,170,164,258,1156,1898,4,9368,520,0,0
246,5700,1482,859,1002,125,135,219,1607,16,219,134,251,235,385,1766,3032,9,27804,1544,1,0
13,806,75,38,59,1,3,12,76,2,4,2,4,6,6,10,15,1,15,0,0,0
169,7506,139,89,101,2,0,35,141,7,54,34,62,61,96,330,569,4,2287,127,0,0
169,7506,7,5,5,0,0,2,7,1,2,1,2,3,3,2,4,0,2,0,0,0
99,4845,1523,757,1297,19,12,193,1542,12,193,117,230,205,347,1508,2664,7,19053,1058,0,0
55,770,167,116,138,4,5,22,171,8,48,30,56,56,86,292,499,4,2330,129,0,0
13,788,75,38,59,1,3,12,76,2,4,2,4,6,6,10,15,1,15,0,0,0
215,4638,2,2,2,0,0,0,2,0,0,0,0,0,0,0,0,0,0,0,0,0
215,4638,99,48,90,1,3,5,100,0,0,0,0,0,0,0,0,0,0,0,0,0
215,4638,8,5,5,2,0,1,10,0,0,0,0,0,0,0,0,0,0,0,0,0
215,4638,1217,716,841,84,126,174,1301,14,185,118,215,199,333,1446,2542,8,20687,1149,0,0
215,4638,160,89,115,0,13,31,160,7,15,11,17,22,28,78,124,3,495,27,0,0
215,4638,10,10,9,9,0,0,19,0,0,0,0,0,0,0,0,0,0,0,0,0
215,4638,173,84,99,8,29,36,181,5,12,7,13,17,20,54,81,2,221,12,0,0
215,4638,3,1,1,3,0,0,6,0,0,0,0,0,0,0,0,0,0,0,0,0
13,808,75,38,59,1,3,12,76,2,4,2,4,6,6,10,15,1,15,0,0,0
84,1876,402,202,227,24,74,80,426,12,52,33,61,64,94,339,564,7,3969,220,0,0
90,3983,1338,495,1086,10,64,173,1348,11,122,82,157,133,239,883,1686,7,11934,663,0,0
125,5588,1782,648,1425,9,47,279,1791,8,171,97,189,179,286,1292,2140,4,9462,525,0,0
98,4153,1020,354,843,12,15,144,1032,8,134,77,144,142,221,970,1580,4,6792,377,0,0
217,4661,2,2,2,0,0,0,2,0,0,0,0,0,0,0,0,0,0,0,0,0
217,4661,99,48,90,1,3,5,100,0,0,0,0,0,0,0,0,0,0,0,0,0
217,4661,8,5,5,2,0,1,10,0,0,0,0,0,0,0,0,0,0,0,0,0
217,4661,1217,716,841,84,126,174,1301,14,185,118,215,199,333,1446,2542,8,20687,1149,0,0
217,4661,160,89,115,0,13,31,160,7,15,11,17,22,28,78,124,3,495,27,0,0
217,4661,10,10,9,9,0,0,19,0,0,0,0,0,0,0,0,0,0,0,0,0
217,4661,173,84,99,8,29,36,181,5,12,7,13,17,20,54,81,2,221,12,0,0
217,4661,3,1,1,3,0,0,6,0,0,0,0,0,0,0,0,0,0,0,0,0
245,5671,4293,999,3693,19,54,507,4312,9,155,88,170,164,258,1156,1898,4,9368,520,0,0
245,5671,1482,859,1002,125,135,219,1607,16,219,134,251,235,385,1766,3032,9,27804,1544,1,0
24,613,2,2,2,0,0,0,2,0,0,0,0,0,0,0,0,0,0,0,0,0
24,613,99,48,90,1,3,5,100,0,0,0,0,0,0,0,0,0,0,0,0,0
24,613,8,5,5,2,0,1,10,0,0,0,0,0,0,0,0,0,0,0,0,0
24,613,1217,716,841,84,126,174,1301,14,185,118,215,199,333,1446,2542,8,20687,1149,0,0
24,613,160,89,115,0,13,31,160,7,15,11,17,22,28,78,124,3,495,27,0,0
24,613,10,10,9,9,0,0,19,0,0,0,0,0,0,0,0,0,0,0,0,0
24,613,173,84,99,8,29,36,181,5,12,7,13,17,20,54,81,2,221,12,0,0
24,613,3,1,1,3,0,0,6,0,0,0,0,0,0,0,0,0,0,0,0,0
69,1497,402,202,227,24,74,80,426,12,52,33,61,64,94,339,564,7,3969,220,0,0
74,1599,53,23,39,0,0,13,53,2,8,4,8,10,12,26,39,1,39,2,0,0
74,1599,515,298,307,33,80,99,548,12,63,44,77,75,121,419,753,7,5527,307,0,0
291,6500,72,33,56,0,4,12,72,1,1,1,1,2,2,0,2,0,1,0,0,0
291,6500,1454,835,1044,76,110,219,1530,17,275,158,296,292,454,2297,3718,9,34017,1889,1,0
62,1233,1098,241,925,5,10,155,1103,7,46,25,49,53,74,273,423,3,1580,87,0,0
62,1233,282,202,222,14,2,44,296,8,42,24,43,50,67,250,378,4,1548,86,0,0
68,3066,1020,354,843,12,15,144,1032,8,134,77,144,142,221,970,1580,4,6792,377,0,0
220,4688,2,2,2,0,0,0,2,0,0,0,0,0,0,0,0,0,0,0,0,0
220,4688,99,48,90,1,3,5,100,0,0,0,0,0,0,0,0,0,0,0,0,0
220,4688,8,5,5,2,0,1,10,0,0,0,0,0,0,0,0,0,0,0,0,0
220,4688,1217,716,841,84,126,174,1301,14,185,118,215,199,333,1446,2542,8,20687,1149,0,0
220,4688,160,89,115,0,13,31,160,7,15,11,17,22,28,78,124,3,495,27,0,0
220,4688,10,10,9,9,0,0,19,0,0,0,0,0,0,0,0,0,0,0,0,0
220,4688,173,84,99,8,29,36,181,5,12,7,13,17,20,54,81,2,221,12,0,0
220,4688,3,1,1,3,0,0,6,0,0,0,0,0,0,0,0,0,0,0,0,0
234,4977,1943,715,1694,26,18,214,1969,12,185,120,237,197,357,1436,2721,7,20915,1161,0,0
234,4977,1168,838,957,57,25,144,1225,19,348,224,416,367,640,3018,5452,11,61921,3440,1,0
103,5339,1943,715,1694,26,18,214,1969,12,185,120,237,197,357,1436,2721,7,20915,1161,0,0
1,323,382,65,130,157,2,92,539,4,10,5,10,14,15,41,57,2,114,6,0,0
21,538,205,80,86,16,53,53,221,7,18,10,19,25,29,94,134,3,497,27,0,0
83,3323,1043,504,840,53,9,147,1096,9,180,112,198,189,310,1377,2344,4,11604,644,0,1
83,3323,1043,504,840,53,9,147,1096,9,180,112,198,189,310,1377,2344,4,11604,644,0,0
112,2133,477,336,357,30,23,73,507,16,194,134,250,210,384,1538,2962,10,30538,1696,0,1
123,4932,1450,624,1228,12,26,181,1462,14,306,186,354,320,540,2580,4493,8,36391,2021,1,1
52,1777,601,196,481,2,23,85,603,8,63,36,72,71,108,400,664,4,3036,168,0,0
45,940,386,256,301,16,9,68,402,4,59,35,69,63,104,355,621,2,1453,80,0,0
45,940,264,131,164,11,41,46,275,6,38,22,40,44,62,214,338,3,1068,59,0,0
52,1785,601,196,481,2,23,85,603,8,63,36,72,71,108,400,664,4,3036,168,0,0
94,2363,1455,414,1257,16,76,112,1471,5,41,23,46,46,69,231,381,2,1069,59,0,0
94,2363,669,365,481,22,61,110,691,15,103,63,122,118,185,747,1273,8,11311,628,0,0
71,3276,1455,414,1257,16,76,112,1471,5,41,23,46,46,69,231,381,2,1069,59,0,0
314,6855,72,33,56,0,4,12,72,1,1,1,1,2,2,0,2,0,1,0,0,1
314,6855,1454,835,1044,76,110,219,1530,17,275,158,296,292,454,2297,3718,9,34017,1889,1,1
68,1302,1098,241,925,5,10,155,1103,7,46,25,49,53,74,273,423,3,1580,87,0,1
68,1302,282,202,222,14,2,44,296,8,42,24,43,50,67,250,378,4,1548,86,0,1
90,3974,1338,495,1086,10,64,173,1348,11,122,82,157,133,239,883,1686,7,11934,663,0,1
170,7538,139,89,101,2,0,35,141,7,54,34,62,61,96,330,569,4,2287,127,0,1
170,7538,7,5,5,0,0,2,7,1,2,1,2,3,3,2,4,0,2,0,0,1
112,2133,477,336,357,30,23,73,507,16,194,134,250,210,384,1538,2962,10,30538,1696,0,0
123,4932,1450,624,1228,12,26,181,1462,14,306,186,354,320,540,2580,4493,8,36391,2021,1,0
172,5098,1660,832,1314,41,38,274,1701,20,312,209,395,332,604,2671,5058,12,64042,3557,1,0
185,5602,1660,832,1314,41,38,274,1701,20,312,209,395,332,604,2671,5058,12,64042,3557,1,0
185,5602,1057,646,719,113,100,145,1170,18,215,134,248,233,382,1740,3004,10,31186,1732,1,0
231,4977,182,127,129,0,0,53,182,5,39,21,42,44,63,217,343,2,926,51,0,1
231,4977,1165,710,800,67,119,181,1232,18,243,153,282,261,435,2000,3492,10,36473,2026,1,1
182,5535,1660,832,1314,41,38,274,1701,20,312,209,395,332,604,2671,5058,12,64042,3557,1,1
182,5535,1057,646,719,113,100,145,1170,18,215,134,248,233,382,1740,3004,10,31186,1732,1,1
245,5664,4293,999,3693,19,54,507,4312,9,155,88,170,164,258,1156,1898,4,9368,520,0,1
245,5664,1482,859,1002,125,135,219,1607,16,219,134,251,235,385,1766,3032,9,27804,1544,1,1
99,2671,1523,757,1297,19,12,193,1542,12,193,117,230,205,347,1508,2664,7,19053,1058,0,1
99,2671,701,378,504,33,58,109,734,13,110,68,126,123,194,794,1346,7,10027,557,0,1
290,6477,72,33,56,0,4,12,72,1,1,1,1,2,2,0,2,0,1,0,0,1
290,6477,1454,835,1044,76,110,219,1530,17,275,158,296,292,454,2297,3718,9,34017,1889,1,1
27,665,466,257,367,18,25,50,484,7,126,86,171,133,257,898,1813,4,8612,478,0,1
27,665,507,281,342,29,59,88,536,10,53,29,57,63,86,336,514,5,2764,153,0,1
25,546,215,129,180,6,0,29,221,8,65,43,72,73,115,415,711,4,3153,175,0,1
25,546,97,69,77,3,3,16,100,6,22,13,23,28,36,113,173,3,542,30,0,1
231,4941,1943,715,1694,26,18,214,1969,12,185,120,237,197,357,1436,2721,7,20915,1161,0,1
231,4941,1168,838,957,57,25,144,1225,19,348,224,416,367,640,3018,5452,11,61921,3440,1,1
125,5588,1782,648,1425,9,47,279,1791,8,171,97,189,179,286,1292,2140,4,9462,525,0,1
15,1066,215,129,180,6,0,29,221,8,65,43,72,73,115,415,711,4,3153,175,0,1
83,3318,1043,504,840,53,9,147,1096,9,180,112,198,189,310,1377,2344,4,11604,644,0,1
101,5272,1943,715,1694,26,18,214,1969,12,185,120,237,197,357,1436,2721,7,20915,1161,0,1
92,1891,757,253,292,73,244,162,830,13,61,38,67,74,105,409,651,7,4654,258,0,0
231,4977,182,127,129,0,0,53,182,5,39,21,42,44,63,217,343,2,926,51,0,0
231,4977,1165,710,800,67,119,181,1232,18,243,153,282,261,435,2000,3492,10,36473,2026,1,0
182,5535,1660,832,1314,41,38,274,1701,20,312,209,395,332,604,2671,5058,12,64042,3557,1,0
182,5535,1057,646,719,113,100,145,1170,18,215,134,248,233,382,1740,3004,10,31186,1732,1,0
245,5664,4293,999,3693,19,54,507,4312,9,155,88,170,164,258,1156,1898,4,9368,520,0,0
245,5664,1482,859,1002,125,135,219,1607,16,219,134,251,235,385,1766,3032,9,27804,1544,1,0
99,2671,1523,757,1297,19,12,193,1542,12,193,117,230,205,347,1508,2664,7,19053,1058,0,0
99,2671,701,378,504,33,58,109,734,13,110,68,126,123,194,794,1346,7,10027,557,0,0
290,6477,72,33,56,0,4,12,72,1,1,1,1,2,2,0,2,0,1,0,0,0
290,6477,1454,835,1044,76,110,219,1530,17,275,158,296,292,454,2297,3718,9,34017,1889,1,0
27,665,466,257,367,18,25,50,484,7,126,86,171,133,257,898,1813,4,8612,478,0,0
27,665,507,281,342,29,59,88,536,10,53,29,57,63,86,336,514,5,2764,153,0,0
25,546,215,129,180,6,0,29,221,8,65,43,72,73,115,415,711,4,3153,175,0,0
25,546,97,69,77,3,3,16,100,6,22,13,23,28,36,113,173,3,542,30,0,0
231,4941,1943,715,1694,26,18,214,1969,12,185,120,237,197,357,1436,2721,7,20915,1161,0,0
231,4941,1168,838,957,57,25,144,1225,19,348,224,416,367,640,3018,5452,11,61921,3440,1,0
15,1066,215,129,180,6,0,29,221,8,65,43,72,73,115,415,711,4,3153,175,0,0
83,3318,1043,504,840,53,9,147,1096,9,180,112,198,189,310,1377,2344,4,11604,644,0,0
101,5272,1943,715,1694,26,18,214,1969,12,185,120,237,197,357,1436,2721,7,20915,1161,0,0
183,5544,1660,832,1314,41,38,274,1701,20,312,209,395,332,604,2671,5058,12,64042,3557,1,0
183,5544,1057,646,719,113,100,145,1170,18,215,134,248,233,382,1740,3004,10,31186,1732,1,0
98,2641,1523,757,1297,19,12,193,1542,12,193,117,230,205,347,1508,2664,7,19053,1058,0,0
98,2641,701,378,504,33,58,109,734,13,110,68,126,123,194,794,1346,7,10027,557,0,0
99,4689,1523,757,1297,19,12,193,1542,12,193,117,230,205,347,1508,2664,7,19053,1058,0,0
106,2921,1523,757,1297,19,12,193,1542,12,193,117,230,205,347,1508,2664,7,19053,1058,0,0
106,2921,701,378,504,33,58,109,734,13,110,68,126,123,194,794,1346,7,10027,557,0,0
106,2923,1523,757,1297,19,12,193,1542,12,193,117,230,205,347,1508,2664,7,19053,1058,0,0
106,2923,701,378,504,33,58,109,734,13,110,68,126,123,194,794,1346,7,10027,557,0,0
107,2933,1523,757,1297,19,12,193,1542,12,193,117,230,205,347,1508,2664,7,19053,1058,0,0
107,2933,701,378,504,33,58,109,734,13,110,68,126,123,194,794,1346,7,10027,557,0,0
100,4747,1523,757,1297,19,12,193,1542,12,193,117,230,205,347,1508,2664,7,19053,1058,0,0
108,2938,1523,757,1297,19,12,193,1542,12,193,117,230,205,347,1508,2664,7,19053,1058,0,0
108,2938,701,378,504,33,58,109,734,13,110,68,126,123,194,794,1346,7,10027,557,0,0
45,2037,447,308,343,6,5,95,453,7,96,59,111,103,170,651,1136,4,4600,255,0,0
19,713,442,244,305,14,16,103,456,11,68,45,75,79,120,452,756,6,4588,254,0,0
19,713,182,102,99,11,40,35,193,3,11,6,11,14,17,42,64,1,97,5,0,0
36,1510,442,244,305,14,16,103,456,11,68,45,75,79,120,452,756,6,4588,254,0,0
22,373,102,57,55,5,16,25,107,5,17,10,18,22,28,81,124,2,330,18,0,0
1,14,6,4,4,0,0,2,6,0,0,0,0,0,0,0,0,0,0,0,0,0
69,3105,1020,354,843,12,15,144,1032,8,134,77,144,142,221,970,1580,4,6792,377,0,0
42,1241,339,213,244,17,9,65,356,10,42,26,48,52,74,259,421,5,2410,133,0,1
21,541,205,80,86,16,53,53,221,7,18,10,19,25,29,94,134,3,497,27,0,1
65,3082,1293,570,1093,25,15,163,1318,10,195,123,241,205,364,1516,2795,6,17273,959,0,1
67,1570,773,419,590,28,0,166,801,10,204,113,217,214,330,1598,2554,5,13587,754,0,0
67,1570,421,273,302,44,34,57,465,17,81,59,107,98,166,583,1098,11,12329,684,0,0
124,4939,1450,624,1228,12,26,181,1462,14,306,186,354,320,540,2580,4493,8,36391,2021,1,0
14,429,149,95,105,2,0,41,151,8,54,28,55,62,83,334,494,4,2013,111,0,1
14,429,82,56,54,0,13,15,82,4,13,8,16,17,24,56,98,2,241,13,0,1
16,436,149,95,105,2,0,41,151,8,54,28,55,62,83,334,494,4,2013,111,0,1
12,387,149,95,105,2,0,41,151,8,54,28,55,62,83,334,494,4,2013,111,0,1
12,387,82,56,54,0,13,15,82,4,13,8,16,17,24,56,98,2,241,13,0,1
12,318,149,95,105,2,0,41,151,8,54,28,55,62,83,334,494,4,2013,111,0,1
231,4979,182,127,129,0,0,53,182,5,39,21,42,44,63,217,343,2,926,51,0,1
231,4979,1165,710,800,67,119,181,1232,18,243,153,282,261,435,2000,3492,10,36473,2026,1,1
185,5602,1660,832,1314,41,38,274,1701,20,312,209,395,332,604,2671,5058,12,64042,3557,1,1
185,5602,1057,646,719,113,100,145,1170,18,215,134,248,233,382,1740,3004,10,31186,1732,1,1
112,2103,477,336,357,30,23,73,507,16,194,134,250,210,384,1538,2962,10,30538,1696,0,1
73,1518,207,111,150,11,0,50,218,5,26,19,36,31,55,133,272,3,943,52,0,1
73,1518,410,198,237,31,55,97,441,11,63,38,72,74,110,414,683,6,4293,238,0,1
245,5869,722,423,573,19,0,135,741,12,172,101,199,184,300,1320,2257,6,15668,870,0,1
245,5869,1508,847,911,44,250,301,1552,14,148,88,169,162,257,1120,1886,7,15077,837,0,1
231,4979,182,127,129,0,0,53,182,5,39,21,42,44,63,217,343,2,926,51,0,0
231,4979,1165,710,800,67,119,181,1232,18,243,153,282,261,435,2000,3492,10,36473,2026,1,0
12,387,149,95,105,2,0,41,151,8,54,28,55,62,83,334,494,4,2013,111,0,0
12,387,82,56,54,0,13,15,82,4,13,8,16,17,24,56,98,2,241,13,0,0
112,2103,477,336,357,30,23,73,507,16,194,134,250,210,384,1538,2962,10,30538,1696,0,0
245,5869,722,423,573,19,0,135,741,12,172,101,199,184,300,1320,2257,6,15668,870,0,0
245,5869,1508,847,911,44,250,301,1552,14,148,88,169,162,257,1120,1886,7,15077,837,0,0
12,318,149,95,105,2,0,41,151,8,54,28,55,62,83,334,494,4,2013,111,0,0
232,4964,1943,715,1694,26,18,214,1969,12,185,120,237,197,357,1436,2721,7,20915,1161,0,0
232,4964,1168,838,957,57,25,144,1225,19,348,224,416,367,640,3018,5452,11,61921,3440,1,0
245,5671,4293,999,3693,19,54,507,4312,9,155,88,170,164,258,1156,1898,4,9368,520,0,1
245,5671,1482,859,1002,125,135,219,1607,16,219,134,251,235,385,1766,3032,9,27804,1544,1,1
245,5880,722,423,573,19,0,135,741,12,172,101,199,184,300,1320,2257,6,15668,870,0,1
245,5880,1508,847,911,44,250,301,1552,14,148,88,169,162,257,1120,1886,7,15077,837,0,1
291,6502,72,33,56,0,4,12,72,1,1,1,1,2,2,0,2,0,1,0,0,1
291,6502,1454,835,1044,76,110,219,1530,17,275,158,296,292,454,2297,3718,9,34017,1889,1,1
124,5347,1513,682,1277,25,13,200,1538,11,199,116,219,210,335,1557,2584,6,15641,868,0,1
39,2363,334,251,279,10,4,40,344,5,127,74,143,132,217,899,1528,2,4303,239,0,1
245,5880,722,423,573,19,0,135,741,12,172,101,199,184,300,1320,2257,6,15668,870,0,0
245,5880,1508,847,911,44,250,301,1552,14,148,88,169,162,257,1120,1886,7,15077,837,0,0
291,6502,72,33,56,0,4,12,72,1,1,1,1,2,2,0,2,0,1,0,0,0
291,6502,1454,835,1044,76,110,219,1530,17,275,158,296,292,454,2297,3718,9,34017,1889,1,0
124,5347,1513,682,1277,25,13,200,1538,11,199,116,219,210,335,1557,2584,6,15641,868,0,0
39,2363,334,251,279,10,4,40,344,5,127,74,143,132,217,899,1528,2,4303,239,0,0
123,5301,1513,682,1277,25,13,200,1538,11,199,116,219,210,335,1557,2584,6,15641,868,0,0
235,4993,1943,715,1694,26,18,214,1969,12,185,120,237,197,357,1436,2721,7,20915,1161,0,0
235,4993,1168,838,957,57,25,144,1225,19,348,224,416,367,640,3018,5452,11,61921,3440,1,0
3,49,16,9,9,0,0,7,16,0,0,0,0,0,0,0,0,0,0,0,0,0
53,1862,601,196,481,2,23,85,603,8,63,36,72,71,108,400,664,4,3036,168,0,0
313,6832,72,33,56,0,4,12,72,1,1,1,1,2,2,0,2,0,1,0,0,0
313,6832,1454,835,1044,76,110,219,1530,17,275,158,296,292,454,2297,3718,9,34017,1889,1,0
68,1302,1098,241,925,5,10,155,1103,7,46,25,49,53,74,273,423,3,1580,87,0,0
68,1302,282,202,222,14,2,44,296,8,42,24,43,50,67,250,378,4,1548,86,0,0
90,3974,1338,495,1086,10,64,173,1348,11,122,82,157,133,239,883,1686,7,11934,663,0,0
170,7538,139,89,101,2,0,35,141,7,54,34,62,61,96,330,569,4,2287,127,0,0
170,7538,7,5,5,0,0,2,7,1,2,1,2,3,3,2,4,0,2,0,0,0
232,4966,1943,715,1694,26,18,214,1969,12,185,120,237,197,357,1436,2721,7,20915,1161,0,0
232,4966,1168,838,957,57,25,144,1225,19,348,224,416,367,640,3018,5452,11,61921,3440,1,0
99,2681,1523,757,1297,19,12,193,1542,12,193,117,230,205,347,1508,2664,7,19053,1058,0,1
99,2681,701,378,504,33,58,109,734,13,110,68,126,123,194,794,1346,7,10027,557,0,1
28,713,466,257,367,18,25,50,484,7,126,86,171,133,257,898,1813,4,8612,478,0,1
28,713,507,281,342,29,59,88,536,10,53,29,57,63,86,336,514,5,2764,153,0,1
71,1445,1178,367,1042,6,15,115,1184,9,94,51,95,103,146,644,976,4,4439,246,0,1
71,1445,177,108,140,8,0,27,185,6,30,16,32,36,48,162,248,3,794,44,0,1
237,5000,1943,715,1694,26,18,214,1969,12,185,120,237,197,357,1436,2721,7,20915,1161,0,1
237,5000,1168,838,957,57,25,144,1225,19,348,224,416,367,640,3018,5452,11,61921,3440,1,1
99,4102,1289,550,1043,56,32,155,1345,10,167,93,185,177,278,1266,2075,5,11498,638,0,1
77,3228,1178,367,1042,6,15,115,1184,9,94,51,95,103,146,644,976,4,4439,246,0,1
103,5339,1943,715,1694,26,18,214,1969,12,185,120,237,197,357,1436,2721,7,20915,1161,0,1
245,5864,722,423,573,19,0,135,741,12,172,101,199,184,300,1320,2257,6,15668,870,0,0
245,5864,1508,847,911,44,250,301,1552,14,148,88,169,162,257,1120,1886,7,15077,837,0,0
71,1439,1178,367,1042,6,15,115,1184,9,94,51,95,103,146,644,976,4,4439,246,0,0
71,1439,177,108,140,8,0,27,185,6,30,16,32,36,48,162,248,3,794,44,0,0
77,3233,1178,367,1042,6,15,115,1184,9,94,51,95,103,146,644,976,4,4439,246,0,0
99,2681,1523,757,1297,19,12,193,1542,12,193,117,230,205,347,1508,2664,7,19053,1058,0,0
99,2681,701,378,504,33,58,109,734,13,110,68,126,123,194,794,1346,7,10027,557,0,0
28,713,466,257,367,18,25,50,484,7,126,86,171,133,257,898,1813,4,8612,478,0,0
28,713,507,281,342,29,59,88,536,10,53,29,57,63,86,336,514,5,2764,153,0,0
237,5000,1943,715,1694,26,18,214,1969,12,185,120,237,197,357,1436,2721,7,20915,1161,0,0
237,5000,1168,838,957,57,25,144,1225,19,348,224,416,367,640,3018,5452,11,61921,3440,1,0
99,4102,1289,550,1043,56,32,155,1345,10,167,93,185,177,278,1266,2075,5,11498,638,0,0
238,5016,1943,715,1694,26,18,214,1969,12,185,120,237,197,357,1436,2721,7,20915,1161,0,0
238,5016,1168,838,957,57,25,144,1225,19,348,224,416,367,640,3018,5452,11,61921,3440,1,0
36,1456,442,244,305,14,16,103,456,11,68,45,75,79,120,452,756,6,4588,254,0,0
19,717,442,244,305,14,16,103,456,11,68,45,75,79,120,452,756,6,4588,254,0,0
19,717,182,102,99,11,40,35,193,3,11,6,11,14,17,42,64,1,97,5,0,0
93,1905,757,253,292,73,244,162,830,13,61,38,67,74,105,409,651,7,4654,258,0,0
33,1041,256,139,192,9,7,47,265,4,23,12,24,27,36,112,171,2,357,19,0,0
18,310,424,94,331,4,0,89,428,1,5,5,5,6,10,11,25,0,12,0,0,1
18,310,38,23,23,6,0,8,44,3,11,7,11,14,18,42,68,1,102,5,0,1
18,310,424,94,331,4,0,89,428,1,5,5,5,6,10,11,25,0,12,0,0,0
18,310,38,23,23,6,0,8,44,3,11,7,11,14,18,42,68,1,102,5,0,0
52,623,647,139,84,35,284,233,682,0,0,0,0,0,0,0,0,0,0,0,0,0
25,552,215,129,180,6,0,29,221,8,65,43,72,73,115,415,711,4,3153,175,0,0
25,552,97,69,77,3,3,16,100,6,22,13,23,28,36,113,173,3,542,30,0,0
232,4972,1943,715,1694,26,18,214,1969,12,185,120,237,197,357,1436,2721,7,20915,1161,0,0
232,4972,1168,838,957,57,25,144,1225,19,348,224,416,367,640,3018,5452,11,61921,3440,1,0
52,625,647,139,84,35,284,233,682,0,0,0,0,0,0,0,0,0,0,0,0,0
232,4978,1943,715,1694,26,18,214,1969,12,185,120,237,197,357,1436,2721,7,20915,1161,0,0
232,4978,1168,838,957,57,25,144,1225,19,348,224,416,367,640,3018,5452,11,61921,3440,1,0
19,720,442,244,305,14,16,103,456,11,68,45,75,79,120,452,756,6,4588,254,0,0
19,720,182,102,99,11,40,35,193,3,11,6,11,14,17,42,64,1,97,5,0,0
236,5073,1943,715,1694,26,18,214,1969,12,185,120,237,197,357,1436,2721,7,20915,1161,0,0
236,5073,1168,838,957,57,25,144,1225,19,348,224,416,367,640,3018,5452,11,61921,3440,1,0
100,4116,1289,550,1043,56,32,155,1345,10,167,93,185,177,278,1266,2075,5,11498,638,0,0
16,895,75,38,59,1,3,12,76,2,4,2,4,6,6,10,15,1,15,0,0,0
42,1241,339,213,244,17,9,65,356,10,42,26,48,52,74,259,421,5,2410,133,0,0
21,541,205,80,86,16,53,53,221,7,18,10,19,25,29,94,134,3,497,27,0,0
65,3082,1293,570,1093,25,15,163,1318,10,195,123,241,205,364,1516,2795,6,17273,959,0,0
231,4973,182,127,129,0,0,53,182,5,39,21,42,44,63,217,343,2,926,51,0,0
231,4973,1165,710,800,67,119,181,1232,18,243,153,282,261,435,2000,3492,10,36473,2026,1,0
108,2933,1523,757,1297,19,12,193,1542,12,193,117,230,205,347,1508,2664,7,19053,1058,0,0
108,2933,701,378,504,33,58,109,734,13,110,68,126,123,194,794,1346,7,10027,557,0,0
313,6834,72,33,56,0,4,12,72,1,1,1,1,2,2,0,2,0,1,0,0,0
313,6834,1454,835,1044,76,110,219,1530,17,275,158,296,292,454,2297,3718,9,34017,1889,1,0
27,671,466,257,367,18,25,50,484,7,126,86,171,133,257,898,1813,4,8612,478,0,0
27,671,507,281,342,29,59,88,536,10,53,29,57,63,86,336,514,5,2764,153,0,0
236,5011,1943,715,1694,26,18,214,1969,12,185,120,237,197,357,1436,2721,7,20915,1161,0,0
236,5011,1168,838,957,57,25,144,1225,19,348,224,416,367,640,3018,5452,11,61921,3440,1,0
37,1525,442,244,305,14,16,103,456,11,68,45,75,79,120,452,756,6,4588,254,0,0
220,4689,2,2,2,0,0,0,2,0,0,0,0,0,0,0,0,0,0,0,0,0
220,4689,99,48,90,1,3,5,100,0,0,0,0,0,0,0,0,0,0,0,0,0
220,4689,8,5,5,2,0,1,10,0,0,0,0,0,0,0,0,0,0,0,0,0
220,4689,1217,716,841,84,126,174,1301,14,185,118,215,199,333,1446,2542,8,20687,1149,0,0
220,4689,160,89,115,0,13,31,160,7,15,11,17,22,28,78,124,3,495,27,0,0
220,4689,10,10,9,9,0,0,19,0,0,0,0,0,0,0,0,0,0,0,0,0
220,4689,173,84,99,8,29,36,181,5,12,7,13,17,20,54,81,2,221,12,0,0
220,4689,3,1,1,3,0,0,6,0,0,0,0,0,0,0,0,0,0,0,0,0
236,5079,1943,715,1694,26,18,214,1969,12,185,120,237,197,357,1436,2721,7,20915,1161,0,0
236,5079,1168,838,957,57,25,144,1225,19,348,224,416,367,640,3018,5452,11,61921,3440,1,0
71,1445,1178,367,1042,6,15,115,1184,9,94,51,95,103,146,644,976,4,4439,246,0,0
71,1445,177,108,140,8,0,27,185,6,30,16,32,36,48,162,248,3,794,44,0,0
240,5118,1943,715,1694,26,18,214,1969,12,185,120,237,197,357,1436,2721,7,20915,1161,0,0
240,5118,1168,838,957,57,25,144,1225,19,348,224,416,367,640,3018,5452,11,61921,3440,1,0
100,4121,1289,550,1043,56,32,155,1345,10,167,93,185,177,278,1266,2075,5,11498,638,0,0
69,1323,1098,241,925,5,10,155,1103,7,46,25,49,53,74,273,423,3,1580,87,0,0
69,1323,282,202,222,14,2,44,296,8,42,24,43,50,67,250,378,4,1548,86,0,0
2,42,14,10,9,0,0,4,14,0,0,0,0,0,0,0,0,0,0,0,0,0
2,33,12,8,7,0,0,4,12,0,0,0,0,0,0,0,0,0,0,0,0,0
52,1990,1098,241,925,5,10,155,1103,7,46,25,49,53,74,273,423,3,1580,87,0,0
169,5034,1660,832,1314,41,38,274,1701,20,312,209,395,332,604,2671,5058,12,64042,3557,1,0
94,2466,773,422,505,30,103,129,803,14,77,46,83,91,129,535,839,7,6334,351,0,0
221,4701,2,2,2,0,0,0,2,0,0,0,0,0,0,0,0,0,0,0,0,0
221,4701,99,48,90,1,3,5,100,0,0,0,0,0,0,0,0,0,0,0,0,0
221,4701,8,5,5,2,0,1,10,0,0,0,0,0,0,0,0,0,0,0,0,0
221,4701,1217,716,841,84,126,174,1301,14,185,118,215,199,333,1446,2542,8,20687,1149,0,0
221,4701,160,89,115,0,13,31,160,7,15,11,17,22,28,78,124,3,495,27,0,0
221,4701,10,10,9,9,0,0,19,0,0,0,0,0,0,0,0,0,0,0,0,0
221,4701,173,84,99,8,29,36,181,5,12,7,13,17,20,54,81,2,221,12,0,0
221,4701,3,1,1,3,0,0,6,0,0,0,0,0,0,0,0,0,0,0,0,0
101,4167,1289,550,1043,56,32,155,1345,10,167,93,185,177,278,1266,2075,5,11498,638,0,0
158,3681,77,34,69,0,0,8,77,3,24,16,29,27,45,114,213,1,387,21,0,0
158,3681,712,438,573,51,9,84,763,14,102,71,128,116,199,733,1364,8,11988,666,0,0
30,1324,373,158,315,8,0,51,381,5,76,44,79,81,123,486,779,2,2026,112,0,0
241,5125,1943,715,1694,26,18,214,1969,12,185,120,237,197,357,1436,2721,7,20915,1161,0,0
241,5125,1168,838,957,57,25,144,1225,19,348,224,416,367,640,3018,5452,11,61921,3440,1,0
101,5303,1943,715,1694,26,18,214,1969,12,185,120,237,197,357,1436,2721,7,20915,1161,0,0
159,3699,77,34,69,0,0,8,77,3,24,16,29,27,45,114,213,1,387,21,0,0
159,3699,712,438,573,51,9,84,763,14,102,71,128,116,199,733,1364,8,11988,666,0,0
80,4558,1296,573,1062,40,33,157,1336,8,201,118,231,209,349,1561,2689,4,12365,686,0,0
45,955,386,256,301,16,9,68,402,4,59,35,69,63,104,355,621,2,1453,80,0,0
45,955,264,131,164,11,41,46,275,6,38,22,40,44,62,214,338,3,1068,59,0,0
17,930,75,38,59,1,3,12,76,2,4,2,4,6,6,10,15,1,15,0,0,0
221,4705,2,2,2,0,0,0,2,0,0,0,0,0,0,0,0,0,0,0,0,1
221,4705,99,48,90,1,3,5,100,0,0,0,0,0,0,0,0,0,0,0,0,1
221,4705,8,5,5,2,0,1,10,0,0,0,0,0,0,0,0,0,0,0,0,1
221,4705,1217,716,841,84,126,174,1301,14,185,118,215,199,333,1446,2542,8,20687,1149,0,1
221,4705,160,89,115,0,13,31,160,7,15,11,17,22,28,78,124,3,495,27,0,1
221,4705,10,10,9,9,0,0,19,0,0,0,0,0,0,0,0,0,0,0,0,1
221,4705,173,84,99,8,29,36,181,5,12,7,13,17,20,54,81,2,221,12,0,1
221,4705,3,1,1,3,0,0,6,0,0,0,0,0,0,0,0,0,0,0,0,1
43,2676,652,304,544,16,6,88,668,6,89,51,101,95,152,591,998,3,3399,188,0,1
221,4705,2,2,2,0,0,0,2,0,0,0,0,0,0,0,0,0,0,0,0,0
221,4705,99,48,90,1,3,5,100,0,0,0,0,0,0,0,0,0,0,0,0,0
221,4705,8,5,5,2,0,1,10,0,0,0,0,0,0,0,0,0,0,0,0,0
221,4705,1217,716,841,84,126,174,1301,14,185,118,215,199,333,1446,2542,8,20687,1149,0,0
221,4705,160,89,115,0,13,31,160,7,15,11,17,22,28,78,124,3,495,27,0,0
221,4705,10,10,9,9,0,0,19,0,0,0,0,0,0,0,0,0,0,0,0,0
221,4705,173,84,99,8,29,36,181,5,12,7,13,17,20,54,81,2,221,12,0,0
221,4705,3,1,1,3,0,0,6,0,0,0,0,0,0,0,0,0,0,0,0,0
94,2454,773,422,505,30,103,129,803,14,77,46,83,91,129,535,839,7,6334,351,0,0
126,5612,1782,648,1425,9,47,279,1791,8,171,97,189,179,286,1292,2140,4,9462,525,0,0
94,2418,773,422,505,30,103,129,803,14,77,46,83,91,129,535,839,7,6334,351,0,0
247,5178,1943,715,1694,26,18,214,1969,12,185,120,237,197,357,1436,2721,7,20915,1161,0,0
247,5178,1168,838,957,57,25,144,1225,19,348,224,416,367,640,3018,5452,11,61921,3440,1,0
154,3603,77,34,69,0,0,8,77,3,24,16,29,27,45,114,213,1,387,21,0,1
154,3603,712,438,573,51,9,84,763,14,102,71,128,116,199,733,1364,8,11988,666,0,1
313,6841,72,33,56,0,4,12,72,1,1,1,1,2,2,0,2,0,1,0,0,1
313,6841,1454,835,1044,76,110,219,1530,17,275,158,296,292,454,2297,3718,9,34017,1889,1,1
80,4551,1296,573,1062,40,33,157,1336,8,201,118,231,209,349,1561,2689,4,12365,686,0,1
153,3603,77,34,69,0,0,8,77,3,24,16,29,27,45,114,213,1,387,21,0,0
153,3603,712,438,573,51,9,84,763,14,102,71,128,116,199,733,1364,8,11988,666,0,0
154,3603,77,34,69,0,0,8,77,3,24,16,29,27,45,114,213,1,387,21,0,0
154,3603,712,438,573,51,9,84,763,14,102,71,128,116,199,733,1364,8,11988,666,0,0
313,6841,72,33,56,0,4,12,72,1,1,1,1,2,2,0,2,0,1,0,0,0
313,6841,1454,835,1044,76,110,219,1530,17,275,158,296,292,454,2297,3718,9,34017,1889,1,0
80,4551,1296,573,1062,40,33,157,1336,8,201,118,231,209,349,1561,2689,4,12365,686,0,0
153,3609,77,34,69,0,0,8,77,3,24,16,29,27,45,114,213,1,387,21,0,0
153,3609,712,438,573,51,9,84,763,14,102,71,128,116,199,733,1364,8,11988,666,0,0
43,2676,652,304,544,16,6,88,668,6,89,51,101,95,152,591,998,3,3399,188,0,0
246,5902,722,423,573,19,0,135,741,12,172,101,199,184,300,1320,2257,6,15668,870,0,0
246,5902,1508,847,911,44,250,301,1552,14,148,88,169,162,257,1120,1886,7,15077,837,0,0
48,2297,722,423,573,19,0,135,741,12,172,101,199,184,300,1320,2257,6,15668,870,0,0
159,3705,77,34,69,0,0,8,77,3,24,16,29,27,45,114,213,1,387,21,0,0
159,3705,712,438,573,51,9,84,763,14,102,71,128,116,199,733,1364,8,11988,666,0,0
81,4624,1296,573,1062,40,33,157,1336,8,201,118,231,209,349,1561,2689,4,12365,686,0,0
45,1291,339,213,244,17,9,65,356,10,42,26,48,52,74,259,421,5,2410,133,0,1
66,3225,1293,570,1093,25,15,163,1318,10,195,123,241,205,364,1516,2795,6,17273,959,0,1
153,3613,77,34,69,0,0,8,77,3,24,16,29,27,45,114,213,1,387,21,0,0
153,3613,712,438,573,51,9,84,763,14,102,71,128,116,199,733,1364,8,11988,666,0,0
81,4663,1296,573,1062,40,33,157,1336,8,201,118,231,209,349,1561,2689,4,12365,686,0,0
228,4801,2,2,2,0,0,0,2,0,0,0,0,0,0,0,0,0,0,0,0,0
228,4801,99,48,90,1,3,5,100,0,0,0,0,0,0,0,0,0,0,0,0,0
228,4801,8,5,5,2,0,1,10,0,0,0,0,0,0,0,0,0,0,0,0,0
228,4801,1217,716,841,84,126,174,1301,14,185,118,215,199,333,1446,2542,8,20687,1149,0,0
228,4801,160,89,115,0,13,31,160,7,15,11,17,22,28,78,124,3,495,27,0,0
228,4801,10,10,9,9,0,0,19,0,0,0,0,0,0,0,0,0,0,0,0,0
228,4801,173,84,99,8,29,36,181,5,12,7,13,17,20,54,81,2,221,12,0,0
228,4801,3,1,1,3,0,0,6,0,0,0,0,0,0,0,0,0,0,0,0,0
98,2019,463,295,324,28,62,57,491,12,134,82,154,146,236,989,1696,6,11700,650,0,0
28,978,74,35,59,1,0,14,75,3,14,7,14,17,21,58,85,1,128,7,0,0
28,978,245,125,200,5,7,34,250,7,30,17,34,37,51,166,265,3,1053,58,0,0
92,4896,1457,730,1242,11,6,188,1468,10,292,166,329,302,495,2424,4078,5,22973,1276,1,0
39,2350,334,251,279,10,4,40,344,5,127,74,143,132,217,899,1528,2,4303,239,0,0
1,106,42,7,35,4,0,5,46,1,2,1,2,3,3,2,4,0,2,0,0,0
1,106,11,6,10,0,0,1,11,2,4,2,4,6,6,10,15,1,15,0,0,0
237,5024,1943,715,1694,26,18,214,1969,12,185,120,237,197,357,1436,2721,7,20915,1161,0,0
237,5024,1168,838,957,57,25,144,1225,19,348,224,416,367,640,3018,5452,11,61921,3440,1,0
100,4148,1289,550,1043,56,32,155,1345,10,167,93,185,177,278,1266,2075,5,11498,638,0,0
14,843,75,38,59,1,3,12,76,2,4,2,4,6,6,10,15,1,15,0,0,0
245,5666,4293,999,3693,19,54,507,4312,9,155,88,170,164,258,1156,1898,4,9368,520,0,0
245,5666,1482,859,1002,125,135,219,1607,16,219,134,251,235,385,1766,3032,9,27804,1544,1,0
45,1291,339,213,244,17,9,65,356,10,42,26,48,52,74,259,421,5,2410,133,0,0
66,3225,1293,570,1093,25,15,163,1318,10,195,123,241,205,364,1516,2795,6,17273,959,0,0
228,4805,2,2,2,0,0,0,2,0,0,0,0,0,0,0,0,0,0,0,0,0
228,4805,99,48,90,1,3,5,100,0,0,0,0,0,0,0,0,0,0,0,0,0
228,4805,8,5,5,2,0,1,10,0,0,0,0,0,0,0,0,0,0,0,0,0
228,4805,1217,716,841,84,126,174,1301,14,185,118,215,199,333,1446,2542,8,20687,1149,0,0
228,4805,160,89,115,0,13,31,160,7,15,11,17,22,28,78,124,3,495,27,0,0
228,4805,10,10,9,9,0,0,19,0,0,0,0,0,0,0,0,0,0,0,0,0
228,4805,173,84,99,8,29,36,181,5,12,7,13,17,20,54,81,2,221,12,0,0
228,4805,3,1,1,3,0,0,6,0,0,0,0,0,0,0,0,0,0,0,0,0
158,3715,77,34,69,0,0,8,77,3,24,16,29,27,45,114,213,1,387,21,0,0
158,3715,712,438,573,51,9,84,763,14,102,71,128,116,199,733,1364,8,11988,666,0,0
246,5918,722,423,573,19,0,135,741,12,172,101,199,184,300,1320,2257,6,15668,870,0,0
246,5918,1508,847,911,44,250,301,1552,14,148,88,169,162,257,1120,1886,7,15077,837,0,0
243,5077,1943,715,1694,26,18,214,1969,12,185,120,237,197,357,1436,2721,7,20915,1161,0,0
243,5077,1168,838,957,57,25,144,1225,19,348,224,416,367,640,3018,5452,11,61921,3440,1,0
82,4736,1296,573,1062,40,33,157,1336,8,201,118,231,209,349,1561,2689,4,12365,686,0,0
153,3638,77,34,69,0,0,8,77,3,24,16,29,27,45,114,213,1,387,21,0,0
153,3638,712,438,573,51,9,84,763,14,102,71,128,116,199,733,1364,8,11988,666,0,0
314,6872,72,33,56,0,4,12,72,1,1,1,1,2,2,0,2,0,1,0,0,0
314,6872,1454,835,1044,76,110,219,1530,17,275,158,296,292,454,2297,3718,9,34017,1889,1,0
83,4788,1296,573,1062,40,33,157,1336,8,201,118,231,209,349,1561,2689,4,12365,686,0,0
99,2610,773,422,505,30,103,129,803,14,77,46,83,91,129,535,839,7,6334,351,0,0
35,2389,1157,318,931,29,22,177,1186,6,104,63,125,110,188,712,1274,3,4596,255,0,0
248,5184,1943,715,1694,26,18,214,1969,12,185,120,237,197,357,1436,2721,7,20915,1161,0,1
248,5184,1168,838,957,57,25,144,1225,19,348,224,416,367,640,3018,5452,11,61921,3440,1,1
170,5066,1660,832,1314,41,38,274,1701,20,312,209,395,332,604,2671,5058,12,64042,3557,1,1
248,5184,1943,715,1694,26,18,214,1969,12,185,120,237,197,357,1436,2721,7,20915,1161,0,0
248,5184,1168,838,957,57,25,144,1225,19,348,224,416,367,640,3018,5452,11,61921,3440,1,0
170,5066,1660,832,1314,41,38,274,1701,20,312,209,395,332,604,2671,5058,12,64042,3557,1,0
99,2574,773,422,505,30,103,129,803,14,77,46,83,91,129,535,839,7,6334,351,0,0
158,3740,77,34,69,0,0,8,77,3,24,16,29,27,45,114,213,1,387,21,0,0
158,3740,712,438,573,51,9,84,763,14,102,71,128,116,199,733,1364,8,11988,666,0,0
244,5083,1943,715,1694,26,18,214,1969,12,185,120,237,197,357,1436,2721,7,20915,1161,0,0
244,5083,1168,838,957,57,25,144,1225,19,348,224,416,367,640,3018,5452,11,61921,3440,1,0
84,4861,1296,573,1062,40,33,157,1336,8,201,118,231,209,349,1561,2689,4,12365,686,0,0
95,2929,773,419,590,28,0,166,801,10,204,113,217,214,330,1598,2554,5,13587,754,0,0
81,3273,1178,367,1042,6,15,115,1184,9,94,51,95,103,146,644,976,4,4439,246,0,0
100,2600,773,422,505,30,103,129,803,14,77,46,83,91,129,535,839,7,6334,351,0,0
36,2459,1157,318,931,29,22,177,1186,6,104,63,125,110,188,712,1274,3,4596,255,0,0
92,4912,1457,730,1242,11,6,188,1468,10,292,166,329,302,495,2424,4078,5,22973,1276,1,0
230,4829,2,2,2,0,0,0,2,0,0,0,0,0,0,0,0,0,0,0,0,0
230,4829,99,48,90,1,3,5,100,0,0,0,0,0,0,0,0,0,0,0,0,0
230,4829,8,5,5,2,0,1,10,0,0,0,0,0,0,0,0,0,0,0,0,0
230,4829,1217,716,841,84,126,174,1301,14,185,118,215,199,333,1446,2542,8,20687,1149,0,0
230,4829,160,89,115,0,13,31,160,7,15,11,17,22,28,78,124,3,495,27,0,0
230,4829,10,10,9,9,0,0,19,0,0,0,0,0,0,0,0,0,0,0,0,0
230,4829,173,84,99,8,29,36,181,5,12,7,13,17,20,54,81,2,221,12,0,0
230,4829,3,1,1,3,0,0,6,0,0,0,0,0,0,0,0,0,0,0,0,0
111,4421,1289,550,1043,56,32,155,1345,10,167,93,185,177,278,1266,2075,5,11498,638,0,0
96,4991,1457,730,1242,11,6,188,1468,10,292,166,329,302,495,2424,4078,5,22973,1276,1,0
1,108,42,7,35,4,0,5,46,1,2,1,2,3,3,2,4,0,2,0,0,0
1,108,11,6,10,0,0,1,11,2,4,2,4,6,6,10,15,1,15,0,0,0
38,2327,334,251,279,10,4,40,344,5,127,74,143,132,217,899,1528,2,4303,239,0,0
48,1340,339,213,244,17,9,65,356,10,42,26,48,52,74,259,421,5,2410,133,0,1
67,3269,1293,570,1093,25,15,163,1318,10,195,123,241,205,364,1516,2795,6,17273,959,0,1
157,3295,1513,682,1277,25,13,200,1538,11,199,116,219,210,335,1557,2584,6,15641,868,0,1
157,3295,819,519,539,24,98,155,843,15,96,57,106,111,163,690,1107,8,9171,509,0,1
125,5375,1513,682,1277,25,13,200,1538,11,199,116,219,210,335,1557,2584,6,15641,868,0,1
157,3295,1513,682,1277,25,13,200,1538,11,199,116,219,210,335,1557,2584,6,15641,868,0,0
157,3295,819,519,539,24,98,155,843,15,96,57,106,111,163,690,1107,8,9171,509,0,0
125,5375,1513,682,1277,25,13,200,1538,11,199,116,219,210,335,1557,2584,6,15641,868,0,0
183,5547,1660,832,1314,41,38,274,1701,20,312,209,395,332,604,2671,5058,12,64042,3557,1,0
183,5547,1057,646,719,113,100,145,1170,18,215,134,248,233,382,1740,3004,10,31186,1732,1,0
49,1371,339,213,244,17,9,65,356,10,42,26,48,52,74,259,421,5,2410,133,0,1
68,3294,1293,570,1093,25,15,163,1318,10,195,123,241,205,364,1516,2795,6,17273,959,0,1
49,1371,339,213,244,17,9,65,356,10,42,26,48,52,74,259,421,5,2410,133,0,0
68,3294,1293,570,1093,25,15,163,1318,10,195,123,241,205,364,1516,2795,6,17273,959,0,0
246,5928,722,423,573,19,0,135,741,12,172,101,199,184,300,1320,2257,6,15668,870,0,0
246,5928,1508,847,911,44,250,301,1552,14,148,88,169,162,257,1120,1886,7,15077,837,0,0
78,1822,996,429,845,24,10,117,1020,7,76,50,88,83,138,494,879,4,3565,198,0,0
78,1822,456,277,329,12,42,72,468,13,85,50,97,98,147,592,972,7,7212,400,0,0
248,5735,4293,999,3693,19,54,507,4312,9,155,88,170,164,258,1156,1898,4,9368,520,0,1
248,5735,1482,859,1002,125,135,219,1607,16,219,134,251,235,385,1766,3032,9,27804,1544,1,1
95,2086,1043,504,840,53,9,147,1096,9,180,112,198,189,310,1377,2344,4,11604,644,0,1
95,2086,383,288,292,26,6,62,409,11,65,38,67,76,105,429,656,5,3719,206,0,1
171,7568,4293,999,3693,19,54,507,4312,9,155,88,170,164,258,1156,1898,4,9368,520,0,0
171,7568,1482,859,1002,125,135,219,1607,16,219,134,251,235,385,1766,3032,9,27804,1544,1,0
248,5735,4293,999,3693,19,54,507,4312,9,155,88,170,164,258,1156,1898,4,9368,520,0,0
248,5735,1482,859,1002,125,135,219,1607,16,219,134,251,235,385,1766,3032,9,27804,1544,1,0
247,5132,1943,715,1694,26,18,214,1969,12,185,120,237,197,357,1436,2721,7,20915,1161,0,1
247,5132,1168,838,957,57,25,144,1225,19,348,224,416,367,640,3018,5452,11,61921,3440,1,1
102,5395,1943,715,1694,26,18,214,1969,12,185,120,237,197,357,1436,2721,7,20915,1161,0,1
247,5125,1943,715,1694,26,18,214,1969,12,185,120,237,197,357,1436,2721,7,20915,1161,0,0
247,5125,1168,838,957,57,25,144,1225,19,348,224,416,367,640,3018,5452,11,61921,3440,1,0
101,5370,1943,715,1694,26,18,214,1969,12,185,120,237,197,357,1436,2721,7,20915,1161,0,0
1,94,42,7,35,4,0,5,46,1,2,1,2,3,3,2,4,0,2,0,0,0
1,94,11,6,10,0,0,1,11,2,4,2,4,6,6,10,15,1,15,0,0,0
125,5391,1513,682,1277,25,13,200,1538,11,199,116,219,210,335,1557,2584,6,15641,868,0,0
169,5066,1660,832,1314,41,38,274,1701,20,312,209,395,332,604,2671,5058,12,64042,3557,1,1
169,5066,1660,832,1314,41,38,274,1701,20,312,209,395,332,604,2671,5058,12,64042,3557,1,0
233,5719,722,423,573,19,0,135,741,12,172,101,199,184,300,1320,2257,6,15668,870,0,0
233,5719,1508,847,911,44,250,301,1552,14,148,88,169,162,257,1120,1886,7,15077,837,0,0
313,6859,72,33,56,0,4,12,72,1,1,1,1,2,2,0,2,0,1,0,0,1
313,6859,1454,835,1044,76,110,219,1530,17,275,158,296,292,454,2297,3718,9,34017,1889,1,1
313,6859,72,33,56,0,4,12,72,1,1,1,1,2,2,0,2,0,1,0,0,0
313,6859,1454,835,1044,76,110,219,1530,17,275,158,296,292,454,2297,3718,9,34017,1889,1,0
183,5550,1660,832,1314,41,38,274,1701,20,312,209,395,332,604,2671,5058,12,64042,3557,1,0
183,5550,1057,646,719,113,100,145,1170,18,215,134,248,233,382,1740,3004,10,31186,1732,1,0
84,4869,1296,573,1062,40,33,157,1336,8,201,118,231,209,349,1561,2689,4,12365,686,0,0
48,1338,339,213,244,17,9,65,356,10,42,26,48,52,74,259,421,5,2410,133,0,1
311,6810,72,33,56,0,4,12,72,1,1,1,1,2,2,0,2,0,1,0,0,1
311,6810,1454,835,1044,76,110,219,1530,17,275,158,296,292,454,2297,3718,9,34017,1889,1,1
48,1338,339,213,244,17,9,65,356,10,42,26,48,52,74,259,421,5,2410,133,0,0
309,6777,72,33,56,0,4,12,72,1,1,1,1,2,2,0,2,0,1,0,0,0
309,6777,1454,835,1044,76,110,219,1530,17,275,158,296,292,454,2297,3718,9,34017,1889,1,0
230,4967,182,127,129,0,0,53,182,5,39,21,42,44,63,217,343,2,926,51,0,0
230,4967,1165,710,800,67,119,181,1232,18,243,153,282,261,435,2000,3492,10,36473,2026,1,0
170,5135,1660,832,1314,41,38,274,1701,20,312,209,395,332,604,2671,5058,12,64042,3557,1,0
66,3254,1293,570,1093,25,15,163,1318,10,195,123,241,205,364,1516,2795,6,17273,959,0,1
48,1341,339,213,244,17,9,65,356,10,42,26,48,52,74,259,421,5,2410,133,0,0
311,6841,72,33,56,0,4,12,72,1,1,1,1,2,2,0,2,0,1,0,0,0
311,6841,1454,835,1044,76,110,219,1530,17,275,158,296,292,454,2297,3718,9,34017,1889,1,0
112,4510,1289,550,1043,56,32,155,1345,10,167,93,185,177,278,1266,2075,5,11498,638,0,0
66,3254,1293,570,1093,25,15,163,1318,10,195,123,241,205,364,1516,2795,6,17273,959,0,0
183,5553,1660,832,1314,41,38,274,1701,20,312,209,395,332,604,2671,5058,12,64042,3557,1,0
183,5553,1057,646,719,113,100,145,1170,18,215,134,248,233,382,1740,3004,10,31186,1732,1,0
308,6764,72,33,56,0,4,12,72,1,1,1,1,2,2,0,2,0,1,0,0,0
308,6764,1454,835,1044,76,110,219,1530,17,275,158,296,292,454,2297,3718,9,34017,1889,1,0
68,3323,1293,570,1093,25,15,163,1318,10,195,123,241,205,364,1516,2795,6,17273,959,0,0
95,2385,1455,414,1257,16,76,112,1471,5,41,23,46,46,69,231,381,2,1069,59,0,0
95,2385,669,365,481,22,61,110,691,15,103,63,122,118,185,747,1273,8,11311,628,0,0
245,5668,4293,999,3693,19,54,507,4312,9,155,88,170,164,258,1156,1898,4,9368,520,0,0
245,5668,1482,859,1002,125,135,219,1607,16,219,134,251,235,385,1766,3032,9,27804,1544,1,0
72,3308,1455,414,1257,16,76,112,1471,5,41,23,46,46,69,231,381,2,1069,59,0,0
310,6828,72,33,56,0,4,12,72,1,1,1,1,2,2,0,2,0,1,0,0,0
310,6828,1454,835,1044,76,110,219,1530,17,275,158,296,292,454,2297,3718,9,34017,1889,1,0
233,5732,722,423,573,19,0,135,741,12,172,101,199,184,300,1320,2257,6,15668,870,0,1
233,5732,1508,847,911,44,250,301,1552,14,148,88,169,162,257,1120,1886,7,15077,837,0,1
49,2385,722,423,573,19,0,135,741,12,172,101,199,184,300,1320,2257,6,15668,870,0,1
233,5732,722,423,573,19,0,135,741,12,172,101,199,184,300,1320,2257,6,15668,870,0,0
233,5732,1508,847,911,44,250,301,1552,14,148,88,169,162,257,1120,1886,7,15077,837,0,0
49,2385,722,423,573,19,0,135,741,12,172,101,199,184,300,1320,2257,6,15668,870,0,0
233,4889,2,2,2,0,0,0,2,0,0,0,0,0,0,0,0,0,0,0,0,0
233,4889,99,48,90,1,3,5,100,0,0,0,0,0,0,0,0,0,0,0,0,0
233,4889,8,5,5,2,0,1,10,0,0,0,0,0,0,0,0,0,0,0,0,0
233,4889,1217,716,841,84,126,174,1301,14,185,118,215,199,333,1446,2542,8,20687,1149,0,0
233,4889,160,89,115,0,13,31,160,7,15,11,17,22,28,78,124,3,495,27,0,0
233,4889,10,10,9,9,0,0,19,0,0,0,0,0,0,0,0,0,0,0,0,0
233,4889,173,84,99,8,29,36,181,5,12,7,13,17,20,54,81,2,221,12,0,0
233,4889,3,1,1,3,0,0,6,0,0,0,0,0,0,0,0,0,0,0,0,0
29,1886,384,251,317,7,8,52,391,11,70,44,84,81,128,467,811,6,5355,297,0,0
157,3301,1513,682,1277,25,13,200,1538,11,199,116,219,210,335,1557,2584,6,15641,868,0,0
157,3301,819,519,539,24,98,155,843,15,96,57,106,111,163,690,1107,8,9171,509,0,0
24,614,2,2,2,0,0,0,2,0,0,0,0,0,0,0,0,0,0,0,0,0
24,614,99,48,90,1,3,5,100,0,0,0,0,0,0,0,0,0,0,0,0,0
24,614,8,5,5,2,0,1,10,0,0,0,0,0,0,0,0,0,0,0,0,0
24,614,1217,716,841,84,126,174,1301,14,185,118,215,199,333,1446,2542,8,20687,1149,0,0
24,614,160,89,115,0,13,31,160,7,15,11,17,22,28,78,124,3,495,27,0,0
24,614,10,10,9,9,0,0,19,0,0,0,0,0,0,0,0,0,0,0,0,0
24,614,173,84,99,8,29,36,181,5,12,7,13,17,20,54,81,2,221,12,0,0
24,614,3,1,1,3,0,0,6,0,0,0,0,0,0,0,0,0,0,0,0,0
233,5758,722,423,573,19,0,135,741,12,172,101,199,184,300,1320,2257,6,15668,870,0,0
233,5758,1508,847,911,44,250,301,1552,14,148,88,169,162,257,1120,1886,7,15077,837,0,0
100,4734,1523,757,1297,19,12,193,1542,12,193,117,230,205,347,1508,2664,7,19053,1058,0,0
68,3312,1293,570,1093,25,15,163,1318,10,195,123,241,205,364,1516,2795,6,17273,959,0,0
159,3342,1513,682,1277,25,13,200,1538,11,199,116,219,210,335,1557,2584,6,15641,868,0,0
159,3342,819,519,539,24,98,155,843,15,96,57,106,111,163,690,1107,8,9171,509,0,0
159,3338,1513,682,1277,25,13,200,1538,11,199,116,219,210,335,1557,2584,6,15641,868,0,0
159,3338,819,519,539,24,98,155,843,15,96,57,106,111,163,690,1107,8,9171,509,0,0
37,940,466,257,367,18,25,50,484,7,126,86,171,133,257,898,1813,4,8612,478,0,0
37,940,507,281,342,29,59,88,536,10,53,29,57,63,86,336,514,5,2764,153,0,0
89,1894,1043,504,840,53,9,147,1096,9,180,112,198,189,310,1377,2344,4,11604,644,0,0
89,1894,383,288,292,26,6,62,409,11,65,38,67,76,105,429,656,5,3719,206,0,0
249,5128,1943,715,1694,26,18,214,1969,12,185,120,237,197,357,1436,2721,7,20915,1161,0,0
249,5128,1168,838,957,57,25,144,1225,19,348,224,416,367,640,3018,5452,11,61921,3440,1,0
102,5449,1943,715,1694,26,18,214,1969,12,185,120,237,197,357,1436,2721,7,20915,1161,0,0
159,3344,1513,682,1277,25,13,200,1538,11,199,116,219,210,335,1557,2584,6,15641,868,0,0
159,3344,819,519,539,24,98,155,843,15,96,57,106,111,163,690,1107,8,9171,509,0,0
233,5797,722,423,573,19,0,135,741,12,172,101,199,184,300,1320,2257,6,15668,870,0,0
233,5797,1508,847,911,44,250,301,1552,14,148,88,169,162,257,1120,1886,7,15077,837,0,0
234,4906,2,2,2,0,0,0,2,0,0,0,0,0,0,0,0,0,0,0,0,0
234,4906,99,48,90,1,3,5,100,0,0,0,0,0,0,0,0,0,0,0,0,0
234,4906,8,5,5,2,0,1,10,0,0,0,0,0,0,0,0,0,0,0,0,0
234,4906,1217,716,841,84,126,174,1301,14,185,118,215,199,333,1446,2542,8,20687,1149,0,0
234,4906,160,89,115,0,13,31,160,7,15,11,17,22,28,78,124,3,495,27,0,0
234,4906,10,10,9,9,0,0,19,0,0,0,0,0,0,0,0,0,0,0,0,0
234,4906,173,84,99,8,29,36,181,5,12,7,13,17,20,54,81,2,221,12,0,0
234,4906,3,1,1,3,0,0,6,0,0,0,0,0,0,0,0,0,0,0,0,0
97,5074,1457,730,1242,11,6,188,1468,10,292,166,329,302,495,2424,4078,5,22973,1276,1,0
249,5132,1943,715,1694,26,18,214,1969,12,185,120,237,197,357,1436,2721,7,20915,1161,0,0
249,5132,1168,838,957,57,25,144,1225,19,348,224,416,367,640,3018,5452,11,61921,3440,1,0
97,5072,1457,730,1242,11,6,188,1468,10,292,166,329,302,495,2424,4078,5,22973,1276,1,0
248,5116,1943,715,1694,26,18,214,1969,12,185,120,237,197,357,1436,2721,7,20915,1161,0,0
248,5116,1168,838,957,57,25,144,1225,19,348,224,416,367,640,3018,5452,11,61921,3440,1,0
248,5119,1943,715,1694,26,18,214,1969,12,185,120,237,197,357,1436,2721,7,20915,1161,0,0
248,5119,1168,838,957,57,25,144,1225,19,348,224,416,367,640,3018,5452,11,61921,3440,1,0
103,5526,1943,715,1694,26,18,214,1969,12,185,120,237,197,357,1436,2721,7,20915,1161,0,0
234,4911,2,2,2,0,0,0,2,0,0,0,0,0,0,0,0,0,0,0,0,0
234,4911,99,48,90,1,3,5,100,0,0,0,0,0,0,0,0,0,0,0,0,0
234,4911,8,5,5,2,0,1,10,0,0,0,0,0,0,0,0,0,0,0,0,0
234,4911,1217,716,841,84,126,174,1301,14,185,118,215,199,333,1446,2542,8,20687,1149,0,0
234,4911,160,89,115,0,13,31,160,7,15,11,17,22,28,78,124,3,495,27,0,0
234,4911,10,10,9,9,0,0,19,0,0,0,0,0,0,0,0,0,0,0,0,0
234,4911,173,84,99,8,29,36,181,5,12,7,13,17,20,54,81,2,221,12,0,0
234,4911,3,1,1,3,0,0,6,0,0,0,0,0,0,0,0,0,0,0,0,0
158,3743,77,34,69,0,0,8,77,3,24,16,29,27,45,114,213,1,387,21,0,0
158,3743,712,438,573,51,9,84,763,14,102,71,128,116,199,733,1364,8,11988,666,0,0
89,1902,1043,504,840,53,9,147,1096,9,180,112,198,189,310,1377,2344,4,11604,644,0,0
89,1902,383,288,292,26,6,62,409,11,65,38,67,76,105,429,656,5,3719,206,0,0
248,5121,1943,715,1694,26,18,214,1969,12,185,120,237,197,357,1436,2721,7,20915,1161,0,0
248,5121,1168,838,957,57,25,144,1225,19,348,224,416,367,640,3018,5452,11,61921,3440,1,0
100,5227,1457,730,1242,11,6,188,1468,10,292,166,329,302,495,2424,4078,5,22973,1276,1,0
235,4912,2,2,2,0,0,0,2,0,0,0,0,0,0,0,0,0,0,0,0,0
235,4912,99,48,90,1,3,5,100,0,0,0,0,0,0,0,0,0,0,0,0,0
235,4912,8,5,5,2,0,1,10,0,0,0,0,0,0,0,0,0,0,0,0,0
235,4912,1217,716,841,84,126,174,1301,14,185,118,215,199,333,1446,2542,8,20687,1149,0,0
235,4912,160,89,115,0,13,31,160,7,15,11,17,22,28,78,124,3,495,27,0,0
235,4912,10,10,9,9,0,0,19,0,0,0,0,0,0,0,0,0,0,0,0,0
235,4912,173,84,99,8,29,36,181,5,12,7,13,17,20,54,81,2,221,12,0,0
235,4912,3,1,1,3,0,0,6,0,0,0,0,0,0,0,0,0,0,0,0,0
29,1894,384,251,317,7,8,52,391,11,70,44,84,81,128,467,811,6,5355,297,0,0
235,4917,2,2,2,0,0,0,2,0,0,0,0,0,0,0,0,0,0,0,0,0
235,4917,99,48,90,1,3,5,100,0,0,0,0,0,0,0,0,0,0,0,0,0
235,4917,8,5,5,2,0,1,10,0,0,0,0,0,0,0,0,0,0,0,0,0
235,4917,1217,716,841,84,126,174,1301,14,185,118,215,199,333,1446,2542,8,20687,1149,0,0
235,4917,160,89,115,0,13,31,160,7,15,11,17,22,28,78,124,3,495,27,0,0
235,4917,10,10,9,9,0,0,19,0,0,0,0,0,0,0,0,0,0,0,0,0
235,4917,173,84,99,8,29,36,181,5,12,7,13,17,20,54,81,2,221,12,0,0
235,4917,3,1,1,3,0,0,6,0,0,0,0,0,0,0,0,0,0,0,0,0
176,5282,1660,832,1314,41,38,274,1701,20,312,209,395,332,604,2671,5058,12,64042,3557,1,0
54,1156,447,308,343,6,5,95,453,7,96,59,111,103,170,651,1136,4,4600,255,0,1
54,1156,322,174,179,16,74,51,338,10,41,26,46,51,72,252,408,5,2291,127,0,1
47,2152,447,308,343,6,5,95,453,7,96,59,111,103,170,651,1136,4,4600,255,0,1
90,3956,1338,495,1086,10,64,173,1348,11,122,82,157,133,239,883,1686,7,11934,663,0,0
170,5125,1660,832,1314,41,38,274,1701,20,312,209,395,332,604,2671,5058,12,64042,3557,1,0
233,5808,722,423,573,19,0,135,741,12,172,101,199,184,300,1320,2257,6,15668,870,0,1
233,5808,1508,847,911,44,250,301,1552,14,148,88,169,162,257,1120,1886,7,15077,837,0,1
232,5798,722,423,573,19,0,135,741,12,172,101,199,184,300,1320,2257,6,15668,870,0,1
232,5798,1508,847,911,44,250,301,1552,14,148,88,169,162,257,1120,1886,7,15077,837,0,1
29,1879,384,251,317,7,8,52,391,11,70,44,84,81,128,467,811,6,5355,297,0,0
21,500,207,111,150,11,0,50,218,5,26,19,36,31,55,133,272,3,943,52,0,1
29,1306,373,158,315,8,0,51,381,5,76,44,79,81,123,486,779,2,2026,112,0,1
230,4977,182,127,129,0,0,53,182,5,39,21,42,44,63,217,343,2,926,51,0,0
230,4977,1165,710,800,67,119,181,1232,18,243,153,282,261,435,2000,3492,10,36473,2026,1,0
36,1120,182,127,129,0,0,53,182,5,39,21,42,44,63,217,343,2,926,51,0,0
112,4514,1289,550,1043,56,32,155,1345,10,167,93,185,177,278,1266,2075,5,11498,638,0,0
14,845,75,38,59,1,3,12,76,2,4,2,4,6,6,10,15,1,15,0,0,0
36,2461,1157,318,931,29,22,177,1186,6,104,63,125,110,188,712,1274,3,4596,255,0,0
90,3992,1338,495,1086,10,64,173,1348,11,122,82,157,133,239,883,1686,7,11934,663,0,0
171,7580,4293,999,3693,19,54,507,4312,9,155,88,170,164,258,1156,1898,4,9368,520,0,0
171,7580,1482,859,1002,125,135,219,1607,16,219,134,251,235,385,1766,3032,9,27804,1544,1,0
170,5149,1660,832,1314,41,38,274,1701,20,312,209,395,332,604,2671,5058,12,64042,3557,1,0
47,3469,996,429,845,24,10,117,1020,7,76,50,88,83,138,494,879,4,3565,198,0,0
125,5393,1513,682,1277,25,13,200,1538,11,199,116,219,210,335,1557,2584,6,15641,868,0,0
84,4877,1296,573,1062,40,33,157,1336,8,201,118,231,209,349,1561,2689,4,12365,686,0,0
100,5229,1457,730,1242,11,6,188,1468,10,292,166,329,302,495,2424,4078,5,22973,1276,1,0
72,3310,1455,414,1257,16,76,112,1471,5,41,23,46,46,69,231,381,2,1069,59,0,0
21,655,424,94,331,4,0,89,428,1,5,5,5,6,10,11,25,0,12,0,0,0
83,3328,1043,504,840,53,9,147,1096,9,180,112,198,189,310,1377,2344,4,11604,644,0,0
81,3287,1178,367,1042,6,15,115,1184,9,94,51,95,103,146,644,976,4,4439,246,0,0
37,1527,442,244,305,14,16,103,456,11,68,45,75,79,120,452,756,6,4588,254,0,0
52,1994,1098,241,925,5,10,155,1103,7,46,25,49,53,74,273,423,3,1580,87,0,0
125,5396,1513,682,1277,25,13,200,1538,11,199,116,219,210,335,1557,2584,6,15641,868,0,0
159,3781,77,34,69,0,0,8,77,3,24,16,29,27,45,114,213,1,387,21,0,0
159,3781,712,438,573,51,9,84,763,14,102,71,128,116,199,733,1364,8,11988,666,0,0
170,7547,139,89,101,2,0,35,141,7,54,34,62,61,96,330,569,4,2287,127,0,0
170,7547,7,5,5,0,0,2,7,1,2,1,2,3,3,2,4,0,2,0,0,0
30,1342,373,158,315,8,0,51,381,5,76,44,79,81,123,486,779,2,2026,112,0,0
36,2434,1157,318,931,29,22,177,1186,6,104,63,125,110,188,712,1274,3,4596,255,0,0
36,2425,1157,318,931,29,22,177,1186,6,104,63,125,110,188,712,1274,3,4596,255,0,0
75,1617,53,23,39,0,0,13,53,2,8,4,8,10,12,26,39,1,39,2,0,1
75,1617,515,298,307,33,80,99,548,12,63,44,77,75,121,419,753,7,5527,307,0,1
85,4928,1296,573,1062,40,33,157,1336,8,201,118,231,209,349,1561,2689,4,12365,686,0,1
21,500,207,111,150,11,0,50,218,5,26,19,36,31,55,133,272,3,943,52,0,0
29,1306,373,158,315,8,0,51,381,5,76,44,79,81,123,486,779,2,2026,112,0,0
54,1156,447,308,343,6,5,95,453,7,96,59,111,103,170,651,1136,4,4600,255,0,0
54,1156,322,174,179,16,74,51,338,10,41,26,46,51,72,252,408,5,2291,127,0,0
232,5798,722,423,573,19,0,135,741,12,172,101,199,184,300,1320,2257,6,15668,870,0,0
232,5798,1508,847,911,44,250,301,1552,14,148,88,169,162,257,1120,1886,7,15077,837,0,0
47,2152,447,308,343,6,5,95,453,7,96,59,111,103,170,651,1136,4,4600,255,0,0
170,5139,1660,832,1314,41,38,274,1701,20,312,209,395,332,604,2671,5058,12,64042,3557,1,0
176,5286,1660,832,1314,41,38,274,1701,20,312,209,395,332,604,2671,5058,12,64042,3557,1,0
60,1610,466,257,367,18,25,50,484,7,126,86,171,133,257,898,1813,4,8612,478,0,1
60,1610,507,281,342,29,59,88,536,10,53,29,57,63,86,336,514,5,2764,153,0,1
21,1078,466,257,367,18,25,50,484,7,126,86,171,133,257,898,1813,4,8612,478,0,1
235,4919,2,2,2,0,0,0,2,0,0,0,0,0,0,0,0,0,0,0,0,0
235,4919,99,48,90,1,3,5,100,0,0,0,0,0,0,0,0,0,0,0,0,0
235,4919,8,5,5,2,0,1,10,0,0,0,0,0,0,0,0,0,0,0,0,0
235,4919,1217,716,841,84,126,174,1301,14,185,118,215,199,333,1446,2542,8,20687,1149,0,0
235,4919,160,89,115,0,13,31,160,7,15,11,17,22,28,78,124,3,495,27,0,0
235,4919,10,10,9,9,0,0,19,0,0,0,0,0,0,0,0,0,0,0,0,0
235,4919,173,84,99,8,29,36,181,5,12,7,13,17,20,54,81,2,221,12,0,0
235,4919,3,1,1,3,0,0,6,0,0,0,0,0,0,0,0,0,0,0,0,0
54,657,647,139,84,35,284,233,682,0,0,0,0,0,0,0,0,0,0,0,0,0
66,1698,466,257,367,18,25,50,484,7,126,86,171,133,257,898,1813,4,8612,478,0,0
66,1698,507,281,342,29,59,88,536,10,53,29,57,63,86,336,514,5,2764,153,0,0
25,1292,466,257,367,18,25,50,484,7,126,86,171,133,257,898,1813,4,8612,478,0,0
66,1701,466,257,367,18,25,50,484,7,126,86,171,133,257,898,1813,4,8612,478,0,0
66,1701,507,281,342,29,59,88,536,10,53,29,57,63,86,336,514,5,2764,153,0,0
66,1702,466,257,367,18,25,50,484,7,126,86,171,133,257,898,1813,4,8612,478,0,0
66,1702,507,281,342,29,59,88,536,10,53,29,57,63,86,336,514,5,2764,153,0,0
25,1299,466,257,367,18,25,50,484,7,126,86,171,133,257,898,1813,4,8612,478,0,0
66,1712,466,257,367,18,25,50,484,7,126,86,171,133,257,898,1813,4,8612,478,0,1
66,1712,507,281,342,29,59,88,536,10,53,29,57,63,86,336,514,5,2764,153,0,1
26,1396,466,257,367,18,25,50,484,7,126,86,171,133,257,898,1813,4,8612,478,0,1
27,1494,466,257,367,18,25,50,484,7,126,86,171,133,257,898,1813,4,8612,478,0,1
36,2427,1157,318,931,29,22,177,1186,6,104,63,125,110,188,712,1274,3,4596,255,0,0
29,1324,373,158,315,8,0,51,381,5,76,44,79,81,123,486,779,2,2026,112,0,0
112,2106,477,336,357,30,23,73,507,16,194,134,250,210,384,1538,2962,10,30538,1696,0,1
78,1824,996,429,845,24,10,117,1020,7,76,50,88,83,138,494,879,4,3565,198,0,1
78,1824,456,277,329,12,42,72,468,13,85,50,97,98,147,592,972,7,7212,400,0,1
100,2601,773,422,505,30,103,129,803,14,77,46,83,91,129,535,839,7,6334,351,0,1
103,5544,1943,715,1694,26,18,214,1969,12,185,120,237,197,357,1436,2721,7,20915,1161,0,1
113,2113,477,336,357,30,23,73,507,16,194,134,250,210,384,1538,2962,10,30538,1696,0,1
126,4991,1450,624,1228,12,26,181,1462,14,306,186,354,320,540,2580,4493,8,36391,2021,1,1
248,5737,4293,999,3693,19,54,507,4312,9,155,88,170,164,258,1156,1898,4,9368,520,0,0
248,5737,1482,859,1002,125,135,219,1607,16,219,134,251,235,385,1766,3032,9,27804,1544,1,0
171,7589,4293,999,3693,19,54,507,4312,9,155,88,170,164,258,1156,1898,4,9368,520,0,0
171,7589,1482,859,1002,125,135,219,1607,16,219,134,251,235,385,1766,3032,9,27804,1544,1,0
125,5398,1513,682,1277,25,13,200,1538,11,199,116,219,210,335,1557,2584,6,15641,868,0,0
28,452,219,78,157,11,5,46,230,3,24,20,34,27,54,114,256,2,545,30,0,0
28,452,108,64,79,9,0,20,117,5,15,11,19,20,30,70,129,3,410,22,0,0
72,1466,1178,367,1042,6,15,115,1184,9,94,51,95,103,146,644,976,4,4439,246,0,0
72,1466,177,108,140,8,0,27,185,6,30,16,32,36,48,162,248,3,794,44,0,0
66,1714,466,257,367,18,25,50,484,7,126,86,171,133,257,898,1813,4,8612,478,0,0
66,1714,507,281,342,29,59,88,536,10,53,29,57,63,86,336,514,5,2764,153,0,0
28,1596,466,257,367,18,25,50,484,7,126,86,171,133,257,898,1813,4,8612,478,0,0
101,2611,773,422,505,30,103,129,803,14,77,46,83,91,129,535,839,7,6334,351,0,0
75,1617,53,23,39,0,0,13,53,2,8,4,8,10,12,26,39,1,39,2,0,0
75,1617,515,298,307,33,80,99,548,12,63,44,77,75,121,419,753,7,5527,307,0,0
85,4936,1296,573,1062,40,33,157,1336,8,201,118,231,209,349,1561,2689,4,12365,686,0,0
112,2106,477,336,357,30,23,73,507,16,194,134,250,210,384,1538,2962,10,30538,1696,0,0
78,1824,996,429,845,24,10,117,1020,7,76,50,88,83,138,494,879,4,3565,198,0,0
78,1824,456,277,329,12,42,72,468,13,85,50,97,98,147,592,972,7,7212,400,0,0
101,2612,773,422,505,30,103,129,803,14,77,46,83,91,129,535,839,7,6334,351,0,0
103,5544,1943,715,1694,26,18,214,1969,12,185,120,237,197,357,1436,2721,7,20915,1161,0,0
113,2116,477,336,357,30,23,73,507,16,194,134,250,210,384,1538,2962,10,30538,1696,0,0
126,4991,1450,624,1228,12,26,181,1462,14,306,186,354,320,540,2580,4493,8,36391,2021,1,0
313,6885,72,33,56,0,4,12,72,1,1,1,1,2,2,0,2,0,1,0,0,0
313,6885,1454,835,1044,76,110,219,1530,17,275,158,296,292,454,2297,3718,9,34017,1889,1,0
69,1499,402,202,227,24,74,80,426,12,52,33,61,64,94,339,564,7,3969,220,0,0
69,3122,1020,354,843,12,15,144,1032,8,134,77,144,142,221,970,1580,4,6792,377,0,0
247,5945,722,423,573,19,0,135,741,12,172,101,199,184,300,1320,2257,6,15668,870,0,1
247,5945,1508,847,911,44,250,301,1552,14,148,88,169,162,257,1120,1886,7,15077,837,0,1
92,4888,1457,730,1242,11,6,188,1468,10,292,166,329,302,495,2424,4078,5,22973,1276,1,1
28,1833,384,251,317,7,8,52,391,11,70,44,84,81,128,467,811,6,5355,297,0,1
247,5945,722,423,573,19,0,135,741,12,172,101,199,184,300,1320,2257,6,15668,870,0,0
247,5945,1508,847,911,44,250,301,1552,14,148,88,169,162,257,1120,1886,7,15077,837,0,0
92,4888,1457,730,1242,11,6,188,1468,10,292,166,329,302,495,2424,4078,5,22973,1276,1,0
28,1833,384,251,317,7,8,52,391,11,70,44,84,81,128,467,811,6,5355,297,0,0
164,3436,1513,682,1277,25,13,200,1538,11,199,116,219,210,335,1557,2584,6,15641,868,0,0
164,3436,819,519,539,24,98,155,843,15,96,57,106,111,163,690,1107,8,9171,509,0,0
50,1389,339,213,244,17,9,65,356,10,42,26,48,52,74,259,421,5,2410,133,0,0
69,3465,1293,570,1093,25,15,163,1318,10,195,123,241,205,364,1516,2795,6,17273,959,0,0
50,1396,339,213,244,17,9,65,356,10,42,26,48,52,74,259,421,5,2410,133,0,0
69,3468,1293,570,1093,25,15,163,1318,10,195,123,241,205,364,1516,2795,6,17273,959,0,0
73,3679,1293,570,1093,25,15,163,1318,10,195,123,241,205,364,1516,2795,6,17273,959,0,0
164,3417,1513,682,1277,25,13,200,1538,11,199,116,219,210,335,1557,2584,6,15641,868,0,0
164,3417,819,519,539,24,98,155,843,15,96,57,106,111,163,690,1107,8,9171,509,0,0
72,3663,1293,570,1093,25,15,163,1318,10,195,123,241,205,364,1516,2795,6,17273,959,0,0
50,1402,339,213,244,17,9,65,356,10,42,26,48,52,74,259,421,5,2410,133,0,0
101,5285,1457,730,1242,11,6,188,1468,10,292,166,329,302,495,2424,4078,5,22973,1276,1,0
51,1410,339,213,244,17,9,65,356,10,42,26,48,52,74,259,421,5,2410,133,0,0
72,3697,1293,570,1093,25,15,163,1318,10,195,123,241,205,364,1516,2795,6,17273,959,0,0
233,5825,722,423,573,19,0,135,741,12,172,101,199,184,300,1320,2257,6,15668,870,0,0
233,5825,1508,847,911,44,250,301,1552,14,148,88,169,162,257,1120,1886,7,15077,837,0,0
100,5205,1457,730,1242,11,6,188,1468,10,292,166,329,302,495,2424,4078,5,22973,1276,1,0
29,1873,384,251,317,7,8,52,391,11,70,44,84,81,128,467,811,6,5355,297,0,0
52,1439,339,213,244,17,9,65,356,10,42,26,48,52,74,259,421,5,2410,133,0,0
73,3713,1293,570,1093,25,15,163,1318,10,195,123,241,205,364,1516,2795,6,17273,959,0,0
101,5261,1457,730,1242,11,6,188,1468,10,292,166,329,302,495,2424,4078,5,22973,1276,1,0
233,5835,722,423,573,19,0,135,741,12,172,101,199,184,300,1320,2257,6,15668,870,0,0
233,5835,1508,847,911,44,250,301,1552,14,148,88,169,162,257,1120,1886,7,15077,837,0,0
171,7601,4293,999,3693,19,54,507,4312,9,155,88,170,164,258,1156,1898,4,9368,520,0,0
171,7601,1482,859,1002,125,135,219,1607,16,219,134,251,235,385,1766,3032,9,27804,1544,1,0
33,1007,465,148,393,5,8,60,470,4,31,20,31,35,51,161,261,2,523,29,0,0
33,1007,16,12,9,0,0,6,16,1,2,1,2,3,3,2,4,0,2,0,0,0
126,5666,1782,648,1425,9,47,279,1791,8,171,97,189,179,286,1292,2140,4,9462,525,0,0
125,5401,1513,682,1277,25,13,200,1538,11,199,116,219,210,335,1557,2584,6,15641,868,0,0
43,2679,652,304,544,16,6,88,668,6,89,51,101,95,152,591,998,3,3399,188,0,0
69,3128,1020,354,843,12,15,144,1032,8,134,77,144,142,221,970,1580,4,6792,377,0,0
23,607,2,2,2,0,0,0,2,0,0,0,0,0,0,0,0,0,0,0,0,1
23,607,99,48,90,1,3,5,100,0,0,0,0,0,0,0,0,0,0,0,0,1
23,607,8,5,5,2,0,1,10,0,0,0,0,0,0,0,0,0,0,0,0,1
23,607,1217,716,841,84,126,174,1301,14,185,118,215,199,333,1446,2542,8,20687,1149,0,1
23,607,160,89,115,0,13,31,160,7,15,11,17,22,28,78,124,3,495,27,0,1
23,607,10,10,9,9,0,0,19,0,0,0,0,0,0,0,0,0,0,0,0,1
23,607,173,84,99,8,29,36,181,5,12,7,13,17,20,54,81,2,221,12,0,1
23,607,3,1,1,3,0,0,6,0,0,0,0,0,0,0,0,0,0,0,0,1
69,1509,402,202,227,24,74,80,426,12,52,33,61,64,94,339,564,7,3969,220,0,1
69,1509,402,202,227,24,74,80,426,12,52,33,61,64,94,339,564,7,3969,220,0,0
2,121,37,13,25,0,6,6,37,1,2,1,2,3,3,2,4,0,2,0,0,0
2,121,133,47,40,1,43,49,134,0,0,0,0,0,0,0,0,0,0,0,0,0
68,1497,402,202,227,24,74,80,426,12,52,33,61,64,94,339,564,7,3969,220,0,0
23,607,2,2,2,0,0,0,2,0,0,0,0,0,0,0,0,0,0,0,0,0
23,607,99,48,90,1,3,5,100,0,0,0,0,0,0,0,0,0,0,0,0,0
23,607,8,5,5,2,0,1,10,0,0,0,0,0,0,0,0,0,0,0,0,0
23,607,1217,716,841,84,126,174,1301,14,185,118,215,199,333,1446,2542,8,20687,1149,0,0
23,607,160,89,115,0,13,31,160,7,15,11,17,22,28,78,124,3,495,27,0,0
23,607,10,10,9,9,0,0,19,0,0,0,0,0,0,0,0,0,0,0,0,0
23,607,173,84,99,8,29,36,181,5,12,7,13,17,20,54,81,2,221,12,0,0
23,607,3,1,1,3,0,0,6,0,0,0,0,0,0,0,0,0,0,0,0,0
162,3389,1513,682,1277,25,13,200,1538,11,199,116,219,210,335,1557,2584,6,15641,868,0,0
162,3389,819,519,539,24,98,155,843,15,96,57,106,111,163,690,1107,8,9171,509,0,0
236,4937,2,2,2,0,0,0,2,0,0,0,0,0,0,0,0,0,0,0,0,0
236,4937,99,48,90,1,3,5,100,0,0,0,0,0,0,0,0,0,0,0,0,0
236,4937,8,5,5,2,0,1,10,0,0,0,0,0,0,0,0,0,0,0,0,0
236,4937,1217,716,841,84,126,174,1301,14,185,118,215,199,333,1446,2542,8,20687,1149,0,0
236,4937,160,89,115,0,13,31,160,7,15,11,17,22,28,78,124,3,495,27,0,0
236,4937,10,10,9,9,0,0,19,0,0,0,0,0,0,0,0,0,0,0,0,0
236,4937,173,84,99,8,29,36,181,5,12,7,13,17,20,54,81,2,221,12,0,0
236,4937,3,1,1,3,0,0,6,0,0,0,0,0,0,0,0,0,0,0,0,0
248,5130,1943,715,1694,26,18,214,1969,12,185,120,237,197,357,1436,2721,7,20915,1161,0,0
248,5130,1168,838,957,57,25,144,1225,19,348,224,416,367,640,3018,5452,11,61921,3440,1,0
103,5260,1457,730,1242,11,6,188,1468,10,292,166,329,302,495,2424,4078,5,22973,1276,1,0
29,1903,384,251,317,7,8,52,391,11,70,44,84,81,128,467,811,6,5355,297,0,0
159,3782,77,34,69,0,0,8,77,3,24,16,29,27,45,114,213,1,387,21,0,1
159,3782,712,438,573,51,9,84,763,14,102,71,128,116,199,733,1364,8,11988,666,0,1
72,3698,1293,570,1093,25,15,163,1318,10,195,123,241,205,364,1516,2795,6,17273,959,0,1
83,3389,1043,504,840,53,9,147,1096,9,180,112,198,189,310,1377,2344,4,11604,644,0,1
18,312,424,94,331,4,0,89,428,1,5,5,5,6,10,11,25,0,12,0,0,0
18,312,38,23,23,6,0,8,44,3,11,7,11,14,18,42,68,1,102,5,0,0
233,5831,722,423,573,19,0,135,741,12,172,101,199,184,300,1320,2257,6,15668,870,0,1
233,5831,1508,847,911,44,250,301,1552,14,148,88,169,162,257,1120,1886,7,15077,837,0,1
51,2434,722,423,573,19,0,135,741,12,172,101,199,184,300,1320,2257,6,15668,870,0,1
233,5831,722,423,573,19,0,135,741,12,172,101,199,184,300,1320,2257,6,15668,870,0,0
233,5831,1508,847,911,44,250,301,1552,14,148,88,169,162,257,1120,1886,7,15077,837,0,0
51,2434,722,423,573,19,0,135,741,12,172,101,199,184,300,1320,2257,6,15668,870,0,0
77,1854,996,429,845,24,10,117,1020,7,76,50,88,83,138,494,879,4,3565,198,0,0
77,1854,456,277,329,12,42,72,468,13,85,50,97,98,147,592,972,7,7212,400,0,0
47,3494,996,429,845,24,10,117,1020,7,76,50,88,83,138,494,879,4,3565,198,0,0
233,5841,722,423,573,19,0,135,741,12,172,101,199,184,300,1320,2257,6,15668,870,0,0
233,5841,1508,847,911,44,250,301,1552,14,148,88,169,162,257,1120,1886,7,15077,837,0,0
53,1447,339,213,244,17,9,65,356,10,42,26,48,52,74,259,421,5,2410,133,0,0
73,3747,1293,570,1093,25,15,163,1318,10,195,123,241,205,364,1516,2795,6,17273,959,0,0
52,1451,339,213,244,17,9,65,356,10,42,26,48,52,74,259,421,5,2410,133,0,1
73,3779,1293,570,1093,25,15,163,1318,10,195,123,241,205,364,1516,2795,6,17273,959,0,1
52,1451,339,213,244,17,9,65,356,10,42,26,48,52,74,259,421,5,2410,133,0,0
73,3779,1293,570,1093,25,15,163,1318,10,195,123,241,205,364,1516,2795,6,17273,959,0,0
159,3782,77,34,69,0,0,8,77,3,24,16,29,27,45,114,213,1,387,21,0,0
159,3782,712,438,573,51,9,84,763,14,102,71,128,116,199,733,1364,8,11988,666,0,0
73,3748,1293,570,1093,25,15,163,1318,10,195,123,241,205,364,1516,2795,6,17273,959,0,0
83,3389,1043,504,840,53,9,147,1096,9,180,112,198,189,310,1377,2344,4,11604,644,0,0
176,5309,1660,832,1314,41,38,274,1701,20,312,209,395,332,604,2671,5058,12,64042,3557,1,0
113,2119,477,336,357,30,23,73,507,16,194,134,250,210,384,1538,2962,10,30538,1696,0,0
113,2123,477,336,357,30,23,73,507,16,194,134,250,210,384,1538,2962,10,30538,1696,0,0
117,2176,477,336,357,30,23,73,507,16,194,134,250,210,384,1538,2962,10,30538,1696,0,1
128,5170,1450,624,1228,12,26,181,1462,14,306,186,354,320,540,2580,4493,8,36391,2021,1,1
78,1883,996,429,845,24,10,117,1020,7,76,50,88,83,138,494,879,4,3565,198,0,0
78,1883,456,277,329,12,42,72,468,13,85,50,97,98,147,592,972,7,7212,400,0,0
47,3558,996,429,845,24,10,117,1020,7,76,50,88,83,138,494,879,4,3565,198,0,0
75,1547,1178,367,1042,6,15,115,1184,9,94,51,95,103,146,644,976,4,4439,246,0,0
75,1547,177,108,140,8,0,27,185,6,30,16,32,36,48,162,248,3,794,44,0,0
103,5555,1943,715,1694,26,18,214,1969,12,185,120,237,197,357,1436,2721,7,20915,1161,0,0
78,1611,1178,367,1042,6,15,115,1184,9,94,51,95,103,146,644,976,4,4439,246,0,0
78,1611,177,108,140,8,0,27,185,6,30,16,32,36,48,162,248,3,794,44,0,0
84,3507,1178,367,1042,6,15,115,1184,9,94,51,95,103,146,644,976,4,4439,246,0,0
110,2979,1523,757,1297,19,12,193,1542,12,193,117,230,205,347,1508,2664,7,19053,1058,0,0
110,2979,701,378,504,33,58,109,734,13,110,68,126,123,194,794,1346,7,10027,557,0,0
101,4811,1523,757,1297,19,12,193,1542,12,193,117,230,205,347,1508,2664,7,19053,1058,0,0
44,2727,652,304,544,16,6,88,668,6,89,51,101,95,152,591,998,3,3399,188,0,1
44,2733,652,304,544,16,6,88,668,6,89,51,101,95,152,591,998,3,3399,188,0,0
234,5861,722,423,573,19,0,135,741,12,172,101,199,184,300,1320,2257,6,15668,870,0,0
234,5861,1508,847,911,44,250,301,1552,14,148,88,169,162,257,1120,1886,7,15077,837,0,0
112,4516,1289,550,1043,56,32,155,1345,10,167,93,185,177,278,1266,2075,5,11498,638,0,0
153,7223,1392,870,1177,35,17,170,1427,14,494,280,531,508,811,4473,7289,7,54850,3047,2,0
95,2931,773,419,590,28,0,166,801,10,204,113,217,214,330,1598,2554,5,13587,754,0,0
101,5269,1457,730,1242,11,6,188,1468,10,292,166,329,302,495,2424,4078,5,22973,1276,1,0
43,2695,652,304,544,16,6,88,668,6,89,51,101,95,152,591,998,3,3399,188,0,0
116,2173,477,336,357,30,23,73,507,16,194,134,250,210,384,1538,2962,10,30538,1696,0,0
78,1607,1178,367,1042,6,15,115,1184,9,94,51,95,103,146,644,976,4,4439,246,0,0
78,1607,177,108,140,8,0,27,185,6,30,16,32,36,48,162,248,3,794,44,0,0
128,5170,1450,624,1228,12,26,181,1462,14,306,186,354,320,540,2580,4493,8,36391,2021,1,0
28,981,74,35,59,1,0,14,75,3,14,7,14,17,21,58,85,1,128,7,0,0
28,981,245,125,200,5,7,34,250,7,30,17,34,37,51,166,265,3,1053,58,0,0
84,3547,1178,367,1042,6,15,115,1184,9,94,51,95,103,146,644,976,4,4439,246,0,0
1,96,42,7,35,4,0,5,46,1,2,1,2,3,3,2,4,0,2,0,0,1
1,96,11,6,10,0,0,1,11,2,4,2,4,6,6,10,15,1,15,0,0,1
79,1627,1178,367,1042,6,15,115,1184,9,94,51,95,103,146,644,976,4,4439,246,0,1
79,1627,177,108,140,8,0,27,185,6,30,16,32,36,48,162,248,3,794,44,0,1
87,3601,1178,367,1042,6,15,115,1184,9,94,51,95,103,146,644,976,4,4439,246,0,1
54,1488,339,213,244,17,9,65,356,10,42,26,48,52,74,259,421,5,2410,133,0,0
74,3830,1293,570,1093,25,15,163,1318,10,195,123,241,205,364,1516,2795,6,17273,959,0,0
239,5959,722,423,573,19,0,135,741,12,172,101,199,184,300,1320,2257,6,15668,870,0,1
239,5959,1508,847,911,44,250,301,1552,14,148,88,169,162,257,1120,1886,7,15077,837,0,1
54,2723,722,423,573,19,0,135,741,12,172,101,199,184,300,1320,2257,6,15668,870,0,1
235,5967,722,423,573,19,0,135,741,12,172,101,199,184,300,1320,2257,6,15668,870,0,1
235,5967,1508,847,911,44,250,301,1552,14,148,88,169,162,257,1120,1886,7,15077,837,0,1
55,2800,722,423,573,19,0,135,741,12,172,101,199,184,300,1320,2257,6,15668,870,0,1
87,3622,1178,367,1042,6,15,115,1184,9,94,51,95,103,146,644,976,4,4439,246,0,0
87,3625,1178,367,1042,6,15,115,1184,9,94,51,95,103,146,644,976,4,4439,246,0,0
248,5135,1943,715,1694,26,18,214,1969,12,185,120,237,197,357,1436,2721,7,20915,1161,0,0
248,5135,1168,838,957,57,25,144,1225,19,348,224,416,367,640,3018,5452,11,61921,3440,1,0
103,5558,1943,715,1694,26,18,214,1969,12,185,120,237,197,357,1436,2721,7,20915,1161,0,0
103,5579,1943,715,1694,26,18,214,1969,12,185,120,237,197,357,1436,2721,7,20915,1161,0,0
41,821,1178,367,1042,6,15,115,1184,9,94,51,95,103,146,644,976,4,4439,246,0,0
41,821,177,108,140,8,0,27,185,6,30,16,32,36,48,162,248,3,794,44,0,0
279,5775,1943,715,1694,26,18,214,1969,12,185,120,237,197,357,1436,2721,7,20915,1161,0,0
279,5775,1168,838,957,57,25,144,1225,19,348,224,416,367,640,3018,5452,11,61921,3440,1,0
80,3144,1178,367,1042,6,15,115,1184,9,94,51,95,103,146,644,976,4,4439,246,0,0
104,5687,1943,715,1694,26,18,214,1969,12,185,120,237,197,357,1436,2721,7,20915,1161,0,0
7,107,127,75,83,2,11,30,129,4,14,7,14,18,21,61,87,2,175,9,0,1
7,107,652,304,544,16,6,88,668,6,89,51,101,95,152,591,998,3,3399,188,0,1
7,107,2,2,2,0,0,0,2,0,0,0,0,0,0,0,0,0,0,0,0,1
7,107,8,5,5,0,0,3,8,0,0,0,0,0,0,0,0,0,0,0,0,1
7,107,14,8,8,0,0,6,14,0,0,0,0,0,0,0,0,0,0,0,0,1
7,107,6,4,4,0,0,2,6,0,0,0,0,0,0,0,0,0,0,0,0,1
7,107,6,4,4,0,0,2,6,1,2,1,2,3,3,2,4,0,2,0,0,1
7,107,7,5,5,0,0,2,7,0,0,0,0,0,0,0,0,0,0,0,0,1
7,107,10,6,6,0,0,4,10,0,0,0,0,0,0,0,0,0,0,0,0,1
7,107,1,1,1,0,0,0,1,0,0,0,0,0,0,0,0,0,0,0,0,1
7,107,14,10,10,0,0,4,14,1,1,1,1,2,2,0,2,0,1,0,0,1
7,107,46,26,30,3,0,12,49,3,6,3,6,9,9,20,28,1,42,2,0,1
280,5752,1943,715,1694,26,18,214,1969,12,185,120,237,197,357,1436,2721,7,20915,1161,0,0
280,5752,1168,838,957,57,25,144,1225,19,348,224,416,367,640,3018,5452,11,61921,3440,1,0
278,5743,1943,715,1694,26,18,214,1969,12,185,120,237,197,357,1436,2721,7,20915,1161,0,0
278,5743,1168,838,957,57,25,144,1225,19,348,224,416,367,640,3018,5452,11,61921,3440,1,0
275,5744,1943,715,1694,26,18,214,1969,12,185,120,237,197,357,1436,2721,7,20915,1161,0,1
275,5744,1168,838,957,57,25,144,1225,19,348,224,416,367,640,3018,5452,11,61921,3440,1,1
54,1488,339,213,244,17,9,65,356,10,42,26,48,52,74,259,421,5,2410,133,0,1
74,3867,1293,570,1093,25,15,163,1318,10,195,123,241,205,364,1516,2795,6,17273,959,0,1
74,3867,1293,570,1093,25,15,163,1318,10,195,123,241,205,364,1516,2795,6,17273,959,0,0
235,5973,722,423,573,19,0,135,741,12,172,101,199,184,300,1320,2257,6,15668,870,0,0
235,5973,1508,847,911,44,250,301,1552,14,148,88,169,162,257,1120,1886,7,15077,837,0,0
234,5944,722,423,573,19,0,135,741,12,172,101,199,184,300,1320,2257,6,15668,870,0,0
234,5944,1508,847,911,44,250,301,1552,14,148,88,169,162,257,1120,1886,7,15077,837,0,0
55,2800,722,423,573,19,0,135,741,12,172,101,199,184,300,1320,2257,6,15668,870,0,0
7,107,127,75,83,2,11,30,129,4,14,7,14,18,21,61,87,2,175,9,0,0
7,107,652,304,544,16,6,88,668,6,89,51,101,95,152,591,998,3,3399,188,0,0
7,107,2,2,2,0,0,0,2,0,0,0,0,0,0,0,0,0,0,0,0,0
7,107,8,5,5,0,0,3,8,0,0,0,0,0,0,0,0,0,0,0,0,0
7,107,14,8,8,0,0,6,14,0,0,0,0,0,0,0,0,0,0,0,0,0
7,107,6,4,4,0,0,2,6,0,0,0,0,0,0,0,0,0,0,0,0,0
7,107,6,4,4,0,0,2,6,1,2,1,2,3,3,2,4,0,2,0,0,0
7,107,7,5,5,0,0,2,7,0,0,0,0,0,0,0,0,0,0,0,0,0
7,107,10,6,6,0,0,4,10,0,0,0,0,0,0,0,0,0,0,0,0,0
7,107,1,1,1,0,0,0,1,0,0,0,0,0,0,0,0,0,0,0,0,0
7,107,14,10,10,0,0,4,14,1,1,1,1,2,2,0,2,0,1,0,0,0
7,107,46,26,30,3,0,12,49,3,6,3,6,9,9,20,28,1,42,2,0,0
233,5970,722,423,573,19,0,135,741,12,172,101,199,184,300,1320,2257,6,15668,870,0,0
233,5970,1508,847,911,44,250,301,1552,14,148,88,169,162,257,1120,1886,7,15077,837,0,0
125,5397,1513,682,1277,25,13,200,1538,11,199,116,219,210,335,1557,2584,6,15641,868,0,0
276,5742,1943,715,1694,26,18,214,1969,12,185,120,237,197,357,1436,2721,7,20915,1161,0,0
276,5742,1168,838,957,57,25,144,1225,19,348,224,416,367,640,3018,5452,11,61921,3440,1,0
234,6000,722,423,573,19,0,135,741,12,172,101,199,184,300,1320,2257,6,15668,870,0,0
234,6000,1508,847,911,44,250,301,1552,14,148,88,169,162,257,1120,1886,7,15077,837,0,0
103,5268,1457,730,1242,11,6,188,1468,10,292,166,329,302,495,2424,4078,5,22973,1276,1,0
43,2698,652,304,544,16,6,88,668,6,89,51,101,95,152,591,998,3,3399,188,0,0
109,2961,1523,757,1297,19,12,193,1542,12,193,117,230,205,347,1508,2664,7,19053,1058,0,0
109,2961,701,378,504,33,58,109,734,13,110,68,126,123,194,794,1346,7,10027,557,0,0
101,4838,1523,757,1297,19,12,193,1542,12,193,117,230,205,347,1508,2664,7,19053,1058,0,0
81,1651,1178,367,1042,6,15,115,1184,9,94,51,95,103,146,644,976,4,4439,246,0,0
81,1651,177,108,140,8,0,27,185,6,30,16,32,36,48,162,248,3,794,44,0,0
276,5747,1943,715,1694,26,18,214,1969,12,185,120,237,197,357,1436,2721,7,20915,1161,0,0
276,5747,1168,838,957,57,25,144,1225,19,348,224,416,367,640,3018,5452,11,61921,3440,1,0
104,5722,1943,715,1694,26,18,214,1969,12,185,120,237,197,357,1436,2721,7,20915,1161,0,0
248,5739,4293,999,3693,19,54,507,4312,9,155,88,170,164,258,1156,1898,4,9368,520,0,1
248,5739,1482,859,1002,125,135,219,1607,16,219,134,251,235,385,1766,3032,9,27804,1544,1,1
234,5859,722,423,573,19,0,135,741,12,172,101,199,184,300,1320,2257,6,15668,870,0,1
234,5859,1508,847,911,44,250,301,1552,14,148,88,169,162,257,1120,1886,7,15077,837,0,1
171,7587,4293,999,3693,19,54,507,4312,9,155,88,170,164,258,1156,1898,4,9368,520,0,1
171,7587,1482,859,1002,125,135,219,1607,16,219,134,251,235,385,1766,3032,9,27804,1544,1,1
248,5739,4293,999,3693,19,54,507,4312,9,155,88,170,164,258,1156,1898,4,9368,520,0,0
248,5739,1482,859,1002,125,135,219,1607,16,219,134,251,235,385,1766,3032,9,27804,1544,1,0
234,5859,722,423,573,19,0,135,741,12,172,101,199,184,300,1320,2257,6,15668,870,0,0
234,5859,1508,847,911,44,250,301,1552,14,148,88,169,162,257,1120,1886,7,15077,837,0,0
171,7587,4293,999,3693,19,54,507,4312,9,155,88,170,164,258,1156,1898,4,9368,520,0,0
171,7587,1482,859,1002,125,135,219,1607,16,219,134,251,235,385,1766,3032,9,27804,1544,1,0
70,1528,402,202,227,24,74,80,426,12,52,33,61,64,94,339,564,7,3969,220,0,0
20,531,205,80,86,16,53,53,221,7,18,10,19,25,29,94,134,3,497,27,0,0
92,1890,757,253,292,73,244,162,830,13,61,38,67,74,105,409,651,7,4654,258,0,0
70,3188,1020,354,843,12,15,144,1032,8,134,77,144,142,221,970,1580,4,6792,377,0,0
55,1174,447,308,343,6,5,95,453,7,96,59,111,103,170,651,1136,4,4600,255,0,0
55,1174,322,174,179,16,74,51,338,10,41,26,46,51,72,252,408,5,2291,127,0,0
232,5822,722,423,573,19,0,135,741,12,172,101,199,184,300,1320,2257,6,15668,870,0,0
232,5822,1508,847,911,44,250,301,1552,14,148,88,169,162,257,1120,1886,7,15077,837,0,0
47,2189,447,308,343,6,5,95,453,7,96,59,111,103,170,651,1136,4,4600,255,0,0
276,5755,1943,715,1694,26,18,214,1969,12,185,120,237,197,357,1436,2721,7,20915,1161,0,0
276,5755,1168,838,957,57,25,144,1225,19,348,224,416,367,640,3018,5452,11,61921,3440,1,0
24,612,2,2,2,0,0,0,2,0,0,0,0,0,0,0,0,0,0,0,0,0
24,612,99,48,90,1,3,5,100,0,0,0,0,0,0,0,0,0,0,0,0,0
24,612,8,5,5,2,0,1,10,0,0,0,0,0,0,0,0,0,0,0,0,0
24,612,1217,716,841,84,126,174,1301,14,185,118,215,199,333,1446,2542,8,20687,1149,0,0
24,612,160,89,115,0,13,31,160,7,15,11,17,22,28,78,124,3,495,27,0,0
24,612,10,10,9,9,0,0,19,0,0,0,0,0,0,0,0,0,0,0,0,0
24,612,173,84,99,8,29,36,181,5,12,7,13,17,20,54,81,2,221,12,0,0
24,612,3,1,1,3,0,0,6,0,0,0,0,0,0,0,0,0,0,0,0,0
86,3411,1043,504,840,53,9,147,1096,9,180,112,198,189,310,1377,2344,4,11604,644,0,1
233,6008,722,423,573,19,0,135,741,12,172,101,199,184,300,1320,2257,6,15668,870,0,0
233,6008,1508,847,911,44,250,301,1552,14,148,88,169,162,257,1120,1886,7,15077,837,0,0
275,5744,1943,715,1694,26,18,214,1969,12,185,120,237,197,357,1436,2721,7,20915,1161,0,0
275,5744,1168,838,957,57,25,144,1225,19,348,224,416,367,640,3018,5452,11,61921,3440,1,0
274,5752,1943,715,1694,26,18,214,1969,12,185,120,237,197,357,1436,2721,7,20915,1161,0,1
274,5752,1168,838,957,57,25,144,1225,19,348,224,416,367,640,3018,5452,11,61921,3440,1,1
69,1526,402,202,227,24,74,80,426,12,52,33,61,64,94,339,564,7,3969,220,0,0
232,5961,722,423,573,19,0,135,741,12,172,101,199,184,300,1320,2257,6,15668,870,0,0
232,5961,1508,847,911,44,250,301,1552,14,148,88,169,162,257,1120,1886,7,15077,837,0,0
171,7599,4293,999,3693,19,54,507,4312,9,155,88,170,164,258,1156,1898,4,9368,520,0,0
171,7599,1482,859,1002,125,135,219,1607,16,219,134,251,235,385,1766,3032,9,27804,1544,1,0
70,3194,1020,354,843,12,15,144,1032,8,134,77,144,142,221,970,1580,4,6792,377,0,0
86,3411,1043,504,840,53,9,147,1096,9,180,112,198,189,310,1377,2344,4,11604,644,0,0
66,1720,466,257,367,18,25,50,484,7,126,86,171,133,257,898,1813,4,8612,478,0,0
66,1720,507,281,342,29,59,88,536,10,53,29,57,63,86,336,514,5,2764,153,0,0
277,5779,1943,715,1694,26,18,214,1969,12,185,120,237,197,357,1436,2721,7,20915,1161,0,0
277,5779,1168,838,957,57,25,144,1225,19,348,224,416,367,640,3018,5452,11,61921,3440,1,0
104,5724,1943,715,1694,26,18,214,1969,12,185,120,237,197,357,1436,2721,7,20915,1161,0,0
276,5746,1943,715,1694,26,18,214,1969,12,185,120,237,197,357,1436,2721,7,20915,1161,0,0
276,5746,1168,838,957,57,25,144,1225,19,348,224,416,367,640,3018,5452,11,61921,3440,1,0
67,1744,466,257,367,18,25,50,484,7,126,86,171,133,257,898,1813,4,8612,478,0,0
67,1744,507,281,342,29,59,88,536,10,53,29,57,63,86,336,514,5,2764,153,0,0
275,5715,1943,715,1694,26,18,214,1969,12,185,120,237,197,357,1436,2721,7,20915,1161,0,0
275,5715,1168,838,957,57,25,144,1225,19,348,224,416,367,640,3018,5452,11,61921,3440,1,0
277,5778,1943,715,1694,26,18,214,1969,12,185,120,237,197,357,1436,2721,7,20915,1161,0,0
277,5778,1168,838,957,57,25,144,1225,19,348,224,416,367,640,3018,5452,11,61921,3440,1,0
231,5969,722,423,573,19,0,135,741,12,172,101,199,184,300,1320,2257,6,15668,870,0,0
231,5969,1508,847,911,44,250,301,1552,14,148,88,169,162,257,1120,1886,7,15077,837,0,0
273,5733,1943,715,1694,26,18,214,1969,12,185,120,237,197,357,1436,2721,7,20915,1161,0,0
273,5733,1168,838,957,57,25,144,1225,19,348,224,416,367,640,3018,5452,11,61921,3440,1,0
274,5764,1943,715,1694,26,18,214,1969,12,185,120,237,197,357,1436,2721,7,20915,1161,0,0
274,5764,1168,838,957,57,25,144,1225,19,348,224,416,367,640,3018,5452,11,61921,3440,1,0
183,5551,1660,832,1314,41,38,274,1701,20,312,209,395,332,604,2671,5058,12,64042,3557,1,0
183,5551,1057,646,719,113,100,145,1170,18,215,134,248,233,382,1740,3004,10,31186,1732,1,0
67,1750,466,257,367,18,25,50,484,7,126,86,171,133,257,898,1813,4,8612,478,0,0
67,1750,507,281,342,29,59,88,536,10,53,29,57,63,86,336,514,5,2764,153,0,0
273,5732,1943,715,1694,26,18,214,1969,12,185,120,237,197,357,1436,2721,7,20915,1161,0,0
273,5732,1168,838,957,57,25,144,1225,19,348,224,416,367,640,3018,5452,11,61921,3440,1,0
283,5921,1943,715,1694,26,18,214,1969,12,185,120,237,197,357,1436,2721,7,20915,1161,0,0
283,5921,1168,838,957,57,25,144,1225,19,348,224,416,367,640,3018,5452,11,61921,3440,1,0
86,3482,1178,367,1042,6,15,115,1184,9,94,51,95,103,146,644,976,4,4439,246,0,0
104,5735,1943,715,1694,26,18,214,1969,12,185,120,237,197,357,1436,2721,7,20915,1161,0,0
80,3144,1178,367,1042,6,15,115,1184,9,94,51,95,103,146,644,976,4,4439,246,0,1
110,6063,1943,715,1694,26,18,214,1969,12,185,120,237,197,357,1436,2721,7,20915,1161,0,1
235,4924,2,2,2,0,0,0,2,0,0,0,0,0,0,0,0,0,0,0,0,1
235,4924,99,48,90,1,3,5,100,0,0,0,0,0,0,0,0,0,0,0,0,1
235,4924,8,5,5,2,0,1,10,0,0,0,0,0,0,0,0,0,0,0,0,1
235,4924,1217,716,841,84,126,174,1301,14,185,118,215,199,333,1446,2542,8,20687,1149,0,1
235,4924,160,89,115,0,13,31,160,7,15,11,17,22,28,78,124,3,495,27,0,1
235,4924,10,10,9,9,0,0,19,0,0,0,0,0,0,0,0,0,0,0,0,1
235,4924,173,84,99,8,29,36,181,5,12,7,13,17,20,54,81,2,221,12,0,1
235,4924,3,1,1,3,0,0,6,0,0,0,0,0,0,0,0,0,0,0,0,1
75,1629,53,23,39,0,0,13,53,2,8,4,8,10,12,26,39,1,39,2,0,1
75,1629,515,298,307,33,80,99,548,12,63,44,77,75,121,419,753,7,5527,307,0,1
313,6894,72,33,56,0,4,12,72,1,1,1,1,2,2,0,2,0,1,0,0,1
313,6894,1454,835,1044,76,110,219,1530,17,275,158,296,292,454,2297,3718,9,34017,1889,1,1
66,1717,466,257,367,18,25,50,484,7,126,86,171,133,257,898,1813,4,8612,478,0,1
66,1717,507,281,342,29,59,88,536,10,53,29,57,63,86,336,514,5,2764,153,0,1
101,5325,1457,730,1242,11,6,188,1468,10,292,166,329,302,495,2424,4078,5,22973,1276,1,1
235,4924,2,2,2,0,0,0,2,0,0,0,0,0,0,0,0,0,0,0,0,0
235,4924,99,48,90,1,3,5,100,0,0,0,0,0,0,0,0,0,0,0,0,0
235,4924,8,5,5,2,0,1,10,0,0,0,0,0,0,0,0,0,0,0,0,0
235,4924,1217,716,841,84,126,174,1301,14,185,118,215,199,333,1446,2542,8,20687,1149,0,0
235,4924,160,89,115,0,13,31,160,7,15,11,17,22,28,78,124,3,495,27,0,0
235,4924,10,10,9,9,0,0,19,0,0,0,0,0,0,0,0,0,0,0,0,0
235,4924,173,84,99,8,29,36,181,5,12,7,13,17,20,54,81,2,221,12,0,0
235,4924,3,1,1,3,0,0,6,0,0,0,0,0,0,0,0,0,0,0,0,0
75,1629,53,23,39,0,0,13,53,2,8,4,8,10,12,26,39,1,39,2,0,0
75,1629,515,298,307,33,80,99,548,12,63,44,77,75,121,419,753,7,5527,307,0,0
313,6894,72,33,56,0,4,12,72,1,1,1,1,2,2,0,2,0,1,0,0,0
313,6894,1454,835,1044,76,110,219,1530,17,275,158,296,292,454,2297,3718,9,34017,1889,1,0
66,1717,466,257,367,18,25,50,484,7,126,86,171,133,257,898,1813,4,8612,478,0,0
66,1717,507,281,342,29,59,88,536,10,53,29,57,63,86,336,514,5,2764,153,0,0
101,5325,1457,730,1242,11,6,188,1468,10,292,166,329,302,495,2424,4078,5,22973,1276,1,0
159,3787,77,34,69,0,0,8,77,3,24,16,29,27,45,114,213,1,387,21,0,0
159,3787,712,438,573,51,9,84,763,14,102,71,128,116,199,733,1364,8,11988,666,0,0
112,4538,1289,550,1043,56,32,155,1345,10,167,93,185,177,278,1266,2075,5,11498,638,0,0
163,3497,1513,682,1277,25,13,200,1538,11,199,116,219,210,335,1557,2584,6,15641,868,0,0
163,3497,819,519,539,24,98,155,843,15,96,57,106,111,163,690,1107,8,9171,509,0,0
7,123,127,75,83,2,11,30,129,4,14,7,14,18,21,61,87,2,175,9,0,0
7,123,652,304,544,16,6,88,668,6,89,51,101,95,152,591,998,3,3399,188,0,0
7,123,2,2,2,0,0,0,2,0,0,0,0,0,0,0,0,0,0,0,0,0
7,123,8,5,5,0,0,3,8,0,0,0,0,0,0,0,0,0,0,0,0,0
7,123,14,8,8,0,0,6,14,0,0,0,0,0,0,0,0,0,0,0,0,0
7,123,6,4,4,0,0,2,6,0,0,0,0,0,0,0,0,0,0,0,0,0
7,123,6,4,4,0,0,2,6,1,2,1,2,3,3,2,4,0,2,0,0,0
7,123,7,5,5,0,0,2,7,0,0,0,0,0,0,0,0,0,0,0,0,0
7,123,10,6,6,0,0,4,10,0,0,0,0,0,0,0,0,0,0,0,0,0
7,123,1,1,1,0,0,0,1,0,0,0,0,0,0,0,0,0,0,0,0,0
7,123,14,10,10,0,0,4,14,1,1,1,1,2,2,0,2,0,1,0,0,0
7,123,46,26,30,3,0,12,49,3,6,3,6,9,9,20,28,1,42,2,0,0
229,4964,182,127,129,0,0,53,182,5,39,21,42,44,63,217,343,2,926,51,0,1
229,4964,1165,710,800,67,119,181,1232,18,243,153,282,261,435,2000,3492,10,36473,2026,1,1
14,411,149,95,105,2,0,41,151,8,54,28,55,62,83,334,494,4,2013,111,0,1
14,411,82,56,54,0,13,15,82,4,13,8,16,17,24,56,98,2,241,13,0,1
158,7390,1392,870,1177,35,17,170,1427,14,494,280,531,508,811,4473,7289,7,54850,3047,2,1
30,1440,373,158,315,8,0,51,381,5,76,44,79,81,123,486,779,2,2026,112,0,1
229,4964,182,127,129,0,0,53,182,5,39,21,42,44,63,217,343,2,926,51,0,0
229,4964,1165,710,800,67,119,181,1232,18,243,153,282,261,435,2000,3492,10,36473,2026,1,0
14,411,149,95,105,2,0,41,151,8,54,28,55,62,83,334,494,4,2013,111,0,0
14,411,82,56,54,0,13,15,82,4,13,8,16,17,24,56,98,2,241,13,0,0
158,7390,1392,870,1177,35,17,170,1427,14,494,280,531,508,811,4473,7289,7,54850,3047,2,0
30,1440,373,158,315,8,0,51,381,5,76,44,79,81,123,486,779,2,2026,112,0,0
159,3778,77,34,69,0,0,8,77,3,24,16,29,27,45,114,213,1,387,21,0,0
159,3778,712,438,573,51,9,84,763,14,102,71,128,116,199,733,1364,8,11988,666,0,0
273,5728,1943,715,1694,26,18,214,1969,12,185,120,237,197,357,1436,2721,7,20915,1161,0,0
273,5728,1168,838,957,57,25,144,1225,19,348,224,416,367,640,3018,5452,11,61921,3440,1,0
236,4942,2,2,2,0,0,0,2,0,0,0,0,0,0,0,0,0,0,0,0,0
236,4942,99,48,90,1,3,5,100,0,0,0,0,0,0,0,0,0,0,0,0,0
236,4942,8,5,5,2,0,1,10,0,0,0,0,0,0,0,0,0,0,0,0,0
236,4942,1217,716,841,84,126,174,1301,14,185,118,215,199,333,1446,2542,8,20687,1149,0,0
236,4942,160,89,115,0,13,31,160,7,15,11,17,22,28,78,124,3,495,27,0,0
236,4942,10,10,9,9,0,0,19,0,0,0,0,0,0,0,0,0,0,0,0,0
236,4942,173,84,99,8,29,36,181,5,12,7,13,17,20,54,81,2,221,12,0,0
236,4942,3,1,1,3,0,0,6,0,0,0,0,0,0,0,0,0,0,0,0,0
67,1753,466,257,367,18,25,50,484,7,126,86,171,133,257,898,1813,4,8612,478,0,0
67,1753,507,281,342,29,59,88,536,10,53,29,57,63,86,336,514,5,2764,153,0,0
103,5324,1457,730,1242,11,6,188,1468,10,292,166,329,302,495,2424,4078,5,22973,1276,1,0
73,3817,1293,570,1093,25,15,163,1318,10,195,123,241,205,364,1516,2795,6,17273,959,0,0
103,5336,1457,730,1242,11,6,188,1468,10,292,166,329,302,495,2424,4078,5,22973,1276,1,0
109,2963,1523,757,1297,19,12,193,1542,12,193,117,230,205,347,1508,2664,7,19053,1058,0,0
109,2963,701,378,504,33,58,109,734,13,110,68,126,123,194,794,1346,7,10027,557,0,0
313,6900,72,33,56,0,4,12,72,1,1,1,1,2,2,0,2,0,1,0,0,0
313,6900,1454,835,1044,76,110,219,1530,17,275,158,296,292,454,2297,3718,9,34017,1889,1,0
2,156,37,13,25,0,6,6,37,1,2,1,2,3,3,2,4,0,2,0,0,0
2,156,133,47,40,1,43,49,134,0,0,0,0,0,0,0,0,0,0,0,0,0
89,2050,996,429,845,24,10,117,1020,7,76,50,88,83,138,494,879,4,3565,198,0,1
89,2050,456,277,329,12,42,72,468,13,85,50,97,98,147,592,972,7,7212,400,0,1
48,3659,996,429,845,24,10,117,1020,7,76,50,88,83,138,494,879,4,3565,198,0,1
89,2050,996,429,845,24,10,117,1020,7,76,50,88,83,138,494,879,4,3565,198,0,0
89,2050,456,277,329,12,42,72,468,13,85,50,97,98,147,592,972,7,7212,400,0,0
48,3659,996,429,845,24,10,117,1020,7,76,50,88,83,138,494,879,4,3565,198,0,0
275,5732,1943,715,1694,26,18,214,1969,12,185,120,237,197,357,1436,2721,7,20915,1161,0,0
275,5732,1168,838,957,57,25,144,1225,19,348,224,416,367,640,3018,5452,11,61921,3440,1,0
105,5773,1943,715,1694,26,18,214,1969,12,185,120,237,197,357,1436,2721,7,20915,1161,0,0
272,5717,1943,715,1694,26,18,214,1969,12,185,120,237,197,357,1436,2721,7,20915,1161,0,0
272,5717,1168,838,957,57,25,144,1225,19,348,224,416,367,640,3018,5452,11,61921,3440,1,0
105,5775,1943,715,1694,26,18,214,1969,12,185,120,237,197,357,1436,2721,7,20915,1161,0,0
159,3783,77,34,69,0,0,8,77,3,24,16,29,27,45,114,213,1,387,21,0,0
159,3783,712,438,573,51,9,84,763,14,102,71,128,116,199,733,1364,8,11988,666,0,0
272,5713,1943,715,1694,26,18,214,1969,12,185,120,237,197,357,1436,2721,7,20915,1161,0,0
272,5713,1168,838,957,57,25,144,1225,19,348,224,416,367,640,3018,5452,11,61921,3440,1,0
272,5721,1943,715,1694,26,18,214,1969,12,185,120,237,197,357,1436,2721,7,20915,1161,0,0
272,5721,1168,838,957,57,25,144,1225,19,348,224,416,367,640,3018,5452,11,61921,3440,1,0
110,3013,1523,757,1297,19,12,193,1542,12,193,117,230,205,347,1508,2664,7,19053,1058,0,0
110,3013,701,378,504,33,58,109,734,13,110,68,126,123,194,794,1346,7,10027,557,0,0
103,4933,1523,757,1297,19,12,193,1542,12,193,117,230,205,347,1508,2664,7,19053,1058,0,0
110,6063,1943,715,1694,26,18,214,1969,12,185,120,237,197,357,1436,2721,7,20915,1161,0,0
110,6071,1943,715,1694,26,18,214,1969,12,185,120,237,197,357,1436,2721,7,20915,1161,0,0
229,4960,182,127,129,0,0,53,182,5,39,21,42,44,63,217,343,2,926,51,0,0
229,4960,1165,710,800,67,119,181,1232,18,243,153,282,261,435,2000,3492,10,36473,2026,1,0
92,1886,757,253,292,73,244,162,830,13,61,38,67,74,105,409,651,7,4654,258,0,0
45,953,386,256,301,16,9,68,402,4,59,35,69,63,104,355,621,2,1453,80,0,0
45,953,264,131,164,11,41,46,275,6,38,22,40,44,62,214,338,3,1068,59,0,0
95,2927,773,419,590,28,0,166,801,10,204,113,217,214,330,1598,2554,5,13587,754,0,0
176,5284,1660,832,1314,41,38,274,1701,20,312,209,395,332,604,2671,5058,12,64042,3557,1,0
176,5307,1660,832,1314,41,38,274,1701,20,312,209,395,332,604,2671,5058,12,64042,3557,1,0
314,6930,72,33,56,0,4,12,72,1,1,1,1,2,2,0,2,0,1,0,0,0
314,6930,1454,835,1044,76,110,219,1530,17,275,158,296,292,454,2297,3718,9,34017,1889,1,0
171,7609,4293,999,3693,19,54,507,4312,9,155,88,170,164,258,1156,1898,4,9368,520,0,0
171,7609,1482,859,1002,125,135,219,1607,16,219,134,251,235,385,1766,3032,9,27804,1544,1,0
282,5913,1943,715,1694,26,18,214,1969,12,185,120,237,197,357,1436,2721,7,20915,1161,0,0
282,5913,1168,838,957,57,25,144,1225,19,348,224,416,367,640,3018,5452,11,61921,3440,1,0
1,96,42,7,35,4,0,5,46,1,2,1,2,3,3,2,4,0,2,0,0,0
1,96,11,6,10,0,0,1,11,2,4,2,4,6,6,10,15,1,15,0,0,0
281,5902,1943,715,1694,26,18,214,1969,12,185,120,237,197,357,1436,2721,7,20915,1161,0,0
281,5902,1168,838,957,57,25,144,1225,19,348,224,416,367,640,3018,5452,11,61921,3440,1,0
111,6122,1943,715,1694,26,18,214,1969,12,185,120,237,197,357,1436,2721,7,20915,1161,0,0
52,1464,339,213,244,17,9,65,356,10,42,26,48,52,74,259,421,5,2410,133,0,0
75,3895,1293,570,1093,25,15,163,1318,10,195,123,241,205,364,1516,2795,6,17273,959,0,0
183,5549,1660,832,1314,41,38,274,1701,20,312,209,395,332,604,2671,5058,12,64042,3557,1,0
183,5549,1057,646,719,113,100,145,1170,18,215,134,248,233,382,1740,3004,10,31186,1732,1,0
159,3785,77,34,69,0,0,8,77,3,24,16,29,27,45,114,213,1,387,21,0,0
159,3785,712,438,573,51,9,84,763,14,102,71,128,116,199,733,1364,8,11988,666,0,0
69,1527,402,202,227,24,74,80,426,12,52,33,61,64,94,339,564,7,3969,220,0,0
70,3211,1020,354,843,12,15,144,1032,8,134,77,144,142,221,970,1580,4,6792,377,0,0
9,449,219,78,157,11,5,46,230,3,24,20,34,27,54,114,256,2,545,30,0,0
171,7566,4293,999,3693,19,54,507,4312,9,155,88,170,164,258,1156,1898,4,9368,520,0,0
171,7566,1482,859,1002,125,135,219,1607,16,219,134,251,235,385,1766,3032,9,27804,1544,1,0
33,999,465,148,393,5,8,60,470,4,31,20,31,35,51,161,261,2,523,29,0,0
33,999,16,12,9,0,0,6,16,1,2,1,2,3,3,2,4,0,2,0,0,0
126,5520,1782,648,1425,9,47,279,1791,8,171,97,189,179,286,1292,2140,4,9462,525,0,0
125,5389,1513,682,1277,25,13,200,1538,11,199,116,219,210,335,1557,2584,6,15641,868,0,0
43,2690,652,304,544,16,6,88,668,6,89,51,101,95,152,591,998,3,3399,188,0,0
70,3187,1020,354,843,12,15,144,1032,8,134,77,144,142,221,970,1580,4,6792,377,0,0
45,1953,386,256,301,16,9,68,402,4,59,35,69,63,104,355,621,2,1453,80,0,0
37,1519,442,244,305,14,16,103,456,11,68,45,75,79,120,452,756,6,4588,254,0,0
52,1986,1098,241,925,5,10,155,1103,7,46,25,49,53,74,273,423,3,1580,87,0,0
158,7384,1392,870,1177,35,17,170,1427,14,494,280,531,508,811,4473,7289,7,54850,3047,2,0
95,2916,773,419,590,28,0,166,801,10,204,113,217,214,330,1598,2554,5,13587,754,0,0
115,3128,1523,757,1297,19,12,193,1542,12,193,117,230,205,347,1508,2664,7,19053,1058,0,0
115,3128,701,378,504,33,58,109,734,13,110,68,126,123,194,794,1346,7,10027,557,0,0
107,5109,1523,757,1297,19,12,193,1542,12,193,117,230,205,347,1508,2664,7,19053,1058,0,0
95,2912,773,419,590,28,0,166,801,10,204,113,217,214,330,1598,2554,5,13587,754,0,0
76,3910,1293,570,1093,25,15,163,1318,10,195,123,241,205,364,1516,2795,6,17273,959,0,0
164,3518,1513,682,1277,25,13,200,1538,11,199,116,219,210,335,1557,2584,6,15641,868,0,0
164,3518,819,519,539,24,98,155,843,15,96,57,106,111,163,690,1107,8,9171,509,0,0
126,5406,1513,682,1277,25,13,200,1538,11,199,116,219,210,335,1557,2584,6,15641,868,0,0
282,5915,1943,715,1694,26,18,214,1969,12,185,120,237,197,357,1436,2721,7,20915,1161,0,0
282,5915,1168,838,957,57,25,144,1225,19,348,224,416,367,640,3018,5452,11,61921,3440,1,0
129,5191,1450,624,1228,12,26,181,1462,14,306,186,354,320,540,2580,4493,8,36391,2021,1,0
184,5563,1660,832,1314,41,38,274,1701,20,312,209,395,332,604,2671,5058,12,64042,3557,1,0
184,5563,1057,646,719,113,100,145,1170,18,215,134,248,233,382,1740,3004,10,31186,1732,1,0
249,5765,4293,999,3693,19,54,507,4312,9,155,88,170,164,258,1156,1898,4,9368,520,0,0
249,5765,1482,859,1002,125,135,219,1607,16,219,134,251,235,385,1766,3032,9,27804,1544,1,0
314,6910,72,33,56,0,4,12,72,1,1,1,1,2,2,0,2,0,1,0,0,0
314,6910,1454,835,1044,76,110,219,1530,17,275,158,296,292,454,2297,3718,9,34017,1889,1,0
104,5361,1457,730,1242,11,6,188,1468,10,292,166,329,302,495,2424,4078,5,22973,1276,1,0
20,534,205,80,86,16,53,53,221,7,18,10,19,25,29,94,134,3,497,27,0,0
81,3172,1178,367,1042,6,15,115,1184,9,94,51,95,103,146,644,976,4,4439,246,0,0
314,6932,72,33,56,0,4,12,72,1,1,1,1,2,2,0,2,0,1,0,0,0
314,6932,1454,835,1044,76,110,219,1530,17,275,158,296,292,454,2297,3718,9,34017,1889,1,0
144,5944,1782,648,1425,9,47,279,1791,8,171,97,189,179,286,1292,2140,4,9462,525,0,0
51,1442,339,213,244,17,9,65,356,10,42,26,48,52,74,259,421,5,2410,133,0,0
77,3944,1293,570,1093,25,15,163,1318,10,195,123,241,205,364,1516,2795,6,17273,959,0,0
166,3529,1513,682,1277,25,13,200,1538,11,199,116,219,210,335,1557,2584,6,15641,868,0,0
166,3529,819,519,539,24,98,155,843,15,96,57,106,111,163,690,1107,8,9171,509,0,0
31,1087,74,35,59,1,0,14,75,3,14,7,14,17,21,58,85,1,128,7,0,0
31,1087,245,125,200,5,7,34,250,7,30,17,34,37,51,166,265,3,1053,58,0,0
314,6912,72,33,56,0,4,12,72,1,1,1,1,2,2,0,2,0,1,0,0,0
314,6912,1454,835,1044,76,110,219,1530,17,275,158,296,292,454,2297,3718,9,34017,1889,1,0
104,2698,773,422,505,30,103,129,803,14,77,46,83,91,129,535,839,7,6334,351,0,0
179,5318,1660,832,1314,41,38,274,1701,20,312,209,395,332,604,2671,5058,12,64042,3557,1,0
186,5684,1660,832,1314,41,38,274,1701,20,312,209,395,332,604,2671,5058,12,64042,3557,1,0
186,5684,1057,646,719,113,100,145,1170,18,215,134,248,233,382,1740,3004,10,31186,1732,1,0
186,5709,1660,832,1314,41,38,274,1701,20,312,209,395,332,604,2671,5058,12,64042,3557,1,0
186,5709,1057,646,719,113,100,145,1170,18,215,134,248,233,382,1740,3004,10,31186,1732,1,0
182,5417,1660,832,1314,41,38,274,1701,20,312,209,395,332,604,2671,5058,12,64042,3557,1,0
277,5793,1943,715,1694,26,18,214,1969,12,185,120,237,197,357,1436,2721,7,20915,1161,0,0
277,5793,1168,838,957,57,25,144,1225,19,348,224,416,367,640,3018,5452,11,61921,3440,1,0
105,5755,1943,715,1694,26,18,214,1969,12,185,120,237,197,357,1436,2721,7,20915,1161,0,0
105,5753,1943,715,1694,26,18,214,1969,12,185,120,237,197,357,1436,2721,7,20915,1161,0,0
187,5720,1660,832,1314,41,38,274,1701,20,312,209,395,332,604,2671,5058,12,64042,3557,1,0
187,5720,1057,646,719,113,100,145,1170,18,215,134,248,233,382,1740,3004,10,31186,1732,1,0
187,5730,1660,832,1314,41,38,274,1701,20,312,209,395,332,604,2671,5058,12,64042,3557,1,0
187,5730,1057,646,719,113,100,145,1170,18,215,134,248,233,382,1740,3004,10,31186,1732,1,0
189,5757,1660,832,1314,41,38,274,1701,20,312,209,395,332,604,2671,5058,12,64042,3557,1,0
189,5757,1057,646,719,113,100,145,1170,18,215,134,248,233,382,1740,3004,10,31186,1732,1,0
52,1442,339,213,244,17,9,65,356,10,42,26,48,52,74,259,421,5,2410,133,0,0
77,3947,1293,570,1093,25,15,163,1318,10,195,123,241,205,364,1516,2795,6,17273,959,0,0
1,98,42,7,35,4,0,5,46,1,2,1,2,3,3,2,4,0,2,0,0,1
1,98,11,6,10,0,0,1,11,2,4,2,4,6,6,10,15,1,15,0,0,1
181,5514,1660,832,1314,41,38,274,1701,20,312,209,395,332,604,2671,5058,12,64042,3557,1,1
181,5514,1057,646,719,113,100,145,1170,18,215,134,248,233,382,1740,3004,10,31186,1732,1,1
237,4939,2,2,2,0,0,0,2,0,0,0,0,0,0,0,0,0,0,0,0,1
237,4939,99,48,90,1,3,5,100,0,0,0,0,0,0,0,0,0,0,0,0,1
237,4939,8,5,5,2,0,1,10,0,0,0,0,0,0,0,0,0,0,0,0,1
237,4939,1217,716,841,84,126,174,1301,14,185,118,215,199,333,1446,2542,8,20687,1149,0,1
237,4939,160,89,115,0,13,31,160,7,15,11,17,22,28,78,124,3,495,27,0,1
237,4939,10,10,9,9,0,0,19,0,0,0,0,0,0,0,0,0,0,0,0,1
237,4939,173,84,99,8,29,36,181,5,12,7,13,17,20,54,81,2,221,12,0,1
237,4939,3,1,1,3,0,0,6,0,0,0,0,0,0,0,0,0,0,0,0,1
19,513,205,80,86,16,53,53,221,7,18,10,19,25,29,94,134,3,497,27,0,1
106,4498,1289,550,1043,56,32,155,1345,10,167,93,185,177,278,1266,2075,5,11498,638,0,1
129,5167,1450,624,1228,12,26,181,1462,14,306,186,354,320,540,2580,4493,8,36391,2021,1,1
97,5225,1457,730,1242,11,6,188,1468,10,292,166,329,302,495,2424,4078,5,22973,1276,1,1
2,56,7,6,5,0,0,2,7,1,1,1,2,2,3,0,3,1,3,0,0,1
1,98,42,7,35,4,0,5,46,1,2,1,2,3,3,2,4,0,2,0,0,0
1,98,11,6,10,0,0,1,11,2,4,2,4,6,6,10,15,1,15,0,0,0
181,5514,1660,832,1314,41,38,274,1701,20,312,209,395,332,604,2671,5058,12,64042,3557,1,0
181,5514,1057,646,719,113,100,145,1170,18,215,134,248,233,382,1740,3004,10,31186,1732,1,0
237,4939,2,2,2,0,0,0,2,0,0,0,0,0,0,0,0,0,0,0,0,0
237,4939,99,48,90,1,3,5,100,0,0,0,0,0,0,0,0,0,0,0,0,0
237,4939,8,5,5,2,0,1,10,0,0,0,0,0,0,0,0,0,0,0,0,0
237,4939,1217,716,841,84,126,174,1301,14,185,118,215,199,333,1446,2542,8,20687,1149,0,0
237,4939,160,89,115,0,13,31,160,7,15,11,17,22,28,78,124,3,495,27,0,0
237,4939,10,10,9,9,0,0,19,0,0,0,0,0,0,0,0,0,0,0,0,0
237,4939,173,84,99,8,29,36,181,5,12,7,13,17,20,54,81,2,221,12,0,0
237,4939,3,1,1,3,0,0,6,0,0,0,0,0,0,0,0,0,0,0,0,0
19,513,205,80,86,16,53,53,221,7,18,10,19,25,29,94,134,3,497,27,0,0
106,4498,1289,550,1043,56,32,155,1345,10,167,93,185,177,278,1266,2075,5,11498,638,0,0
129,5167,1450,624,1228,12,26,181,1462,14,306,186,354,320,540,2580,4493,8,36391,2021,1,0
97,5225,1457,730,1242,11,6,188,1468,10,292,166,329,302,495,2424,4078,5,22973,1276,1,0
2,56,7,6,5,0,0,2,7,1,1,1,2,2,3,0,3,1,3,0,0,0
187,5718,1660,832,1314,41,38,274,1701,20,312,209,395,332,604,2671,5058,12,64042,3557,1,0
187,5718,1057,646,719,113,100,145,1170,18,215,134,248,233,382,1740,3004,10,31186,1732,1,0
182,5438,1660,832,1314,41,38,274,1701,20,312,209,395,332,604,2671,5058,12,64042,3557,1,0
188,5732,1660,832,1314,41,38,274,1701,20,312,209,395,332,604,2671,5058,12,64042,3557,1,0
188,5732,1057,646,719,113,100,145,1170,18,215,134,248,233,382,1740,3004,10,31186,1732,1,0
249,5763,4293,999,3693,19,54,507,4312,9,155,88,170,164,258,1156,1898,4,9368,520,0,0
249,5763,1482,859,1002,125,135,219,1607,16,219,134,251,235,385,1766,3032,9,27804,1544,1,0
98,5250,1457,730,1242,11,6,188,1468,10,292,166,329,302,495,2424,4078,5,22973,1276,1,0
78,3962,1293,570,1093,25,15,163,1318,10,195,123,241,205,364,1516,2795,6,17273,959,0,0
315,6908,72,33,56,0,4,12,72,1,1,1,1,2,2,0,2,0,1,0,0,0
315,6908,1454,835,1044,76,110,219,1530,17,275,158,296,292,454,2297,3718,9,34017,1889,1,0
19,721,442,244,305,14,16,103,456,11,68,45,75,79,120,452,756,6,4588,254,0,0
19,721,182,102,99,11,40,35,193,3,11,6,11,14,17,42,64,1,97,5,0,0
6,151,127,75,83,2,11,30,129,4,14,7,14,18,21,61,87,2,175,9,0,1
6,151,652,304,544,16,6,88,668,6,89,51,101,95,152,591,998,3,3399,188,0,1
6,151,2,2,2,0,0,0,2,0,0,0,0,0,0,0,0,0,0,0,0,1
6,151,8,5,5,0,0,3,8,0,0,0,0,0,0,0,0,0,0,0,0,1
6,151,14,8,8,0,0,6,14,0,0,0,0,0,0,0,0,0,0,0,0,1
6,151,6,4,4,0,0,2,6,0,0,0,0,0,0,0,0,0,0,0,0,1
6,151,6,4,4,0,0,2,6,1,2,1,2,3,3,2,4,0,2,0,0,1
6,151,7,5,5,0,0,2,7,0,0,0,0,0,0,0,0,0,0,0,0,1
6,151,10,6,6,0,0,4,10,0,0,0,0,0,0,0,0,0,0,0,0,1
6,151,1,1,1,0,0,0,1,0,0,0,0,0,0,0,0,0,0,0,0,1
6,151,14,10,10,0,0,4,14,1,1,1,1,2,2,0,2,0,1,0,0,1
6,151,46,26,30,3,0,12,49,3,6,3,6,9,9,20,28,1,42,2,0,1
103,2661,773,422,505,30,103,129,803,14,77,46,83,91,129,535,839,7,6334,351,0,0
38,2498,1157,318,931,29,22,177,1186,6,104,63,125,110,188,712,1274,3,4596,255,0,0
6,151,127,75,83,2,11,30,129,4,14,7,14,18,21,61,87,2,175,9,0,0
6,151,652,304,544,16,6,88,668,6,89,51,101,95,152,591,998,3,3399,188,0,0
6,151,2,2,2,0,0,0,2,0,0,0,0,0,0,0,0,0,0,0,0,0
6,151,8,5,5,0,0,3,8,0,0,0,0,0,0,0,0,0,0,0,0,0
6,151,14,8,8,0,0,6,14,0,0,0,0,0,0,0,0,0,0,0,0,0
6,151,6,4,4,0,0,2,6,0,0,0,0,0,0,0,0,0,0,0,0,0
6,151,6,4,4,0,0,2,6,1,2,1,2,3,3,2,4,0,2,0,0,0
6,151,7,5,5,0,0,2,7,0,0,0,0,0,0,0,0,0,0,0,0,0
6,151,10,6,6,0,0,4,10,0,0,0,0,0,0,0,0,0,0,0,0,0
6,151,1,1,1,0,0,0,1,0,0,0,0,0,0,0,0,0,0,0,0,0
6,151,14,10,10,0,0,4,14,1,1,1,1,2,2,0,2,0,1,0,0,0
6,151,46,26,30,3,0,12,49,3,6,3,6,9,9,20,28,1,42,2,0,0
6,153,127,75,83,2,11,30,129,4,14,7,14,18,21,61,87,2,175,9,0,0
6,153,652,304,544,16,6,88,668,6,89,51,101,95,152,591,998,3,3399,188,0,0
6,153,2,2,2,0,0,0,2,0,0,0,0,0,0,0,0,0,0,0,0,0
6,153,8,5,5,0,0,3,8,0,0,0,0,0,0,0,0,0,0,0,0,0
6,153,14,8,8,0,0,6,14,0,0,0,0,0,0,0,0,0,0,0,0,0
6,153,6,4,4,0,0,2,6,0,0,0,0,0,0,0,0,0,0,0,0,0
6,153,6,4,4,0,0,2,6,1,2,1,2,3,3,2,4,0,2,0,0,0
6,153,7,5,5,0,0,2,7,0,0,0,0,0,0,0,0,0,0,0,0,0
6,153,10,6,6,0,0,4,10,0,0,0,0,0,0,0,0,0,0,0,0,0
6,153,1,1,1,0,0,0,1,0,0,0,0,0,0,0,0,0,0,0,0,0
6,153,14,10,10,0,0,4,14,1,1,1,1,2,2,0,2,0,1,0,0,0
6,153,46,26,30,3,0,12,49,3,6,3,6,9,9,20,28,1,42,2,0,0
90,2054,996,429,845,24,10,117,1020,7,76,50,88,83,138,494,879,4,3565,198,0,1
90,2054,456,277,329,12,42,72,468,13,85,50,97,98,147,592,972,7,7212,400,0,1
49,3737,996,429,845,24,10,117,1020,7,76,50,88,83,138,494,879,4,3565,198,0,1
107,2805,773,422,505,30,103,129,803,14,77,46,83,91,129,535,839,7,6334,351,0,0
2,235,149,67,118,4,0,27,153,1,17,14,28,18,42,69,175,0,144,8,0,0
91,2069,996,429,845,24,10,117,1020,7,76,50,88,83,138,494,879,4,3565,198,0,0
91,2069,456,277,329,12,42,72,468,13,85,50,97,98,147,592,972,7,7212,400,0,0
49,3805,996,429,845,24,10,117,1020,7,76,50,88,83,138,494,879,4,3565,198,0,0
91,2063,996,429,845,24,10,117,1020,7,76,50,88,83,138,494,879,4,3565,198,0,0
91,2063,456,277,329,12,42,72,468,13,85,50,97,98,147,592,972,7,7212,400,0,0
91,2055,996,429,845,24,10,117,1020,7,76,50,88,83,138,494,879,4,3565,198,0,0
91,2055,456,277,329,12,42,72,468,13,85,50,97,98,147,592,972,7,7212,400,0,0
117,3174,1523,757,1297,19,12,193,1542,12,193,117,230,205,347,1508,2664,7,19053,1058,0,0
117,3174,701,378,504,33,58,109,734,13,110,68,126,123,194,794,1346,7,10027,557,0,0
108,5173,1523,757,1297,19,12,193,1542,12,193,117,230,205,347,1508,2664,7,19053,1058,0,0
57,1522,339,213,244,17,9,65,356,10,42,26,48,52,74,259,421,5,2410,133,0,0
79,4018,1293,570,1093,25,15,163,1318,10,195,123,241,205,364,1516,2795,6,17273,959,0,0
76,3947,1293,570,1093,25,15,163,1318,10,195,123,241,205,364,1516,2795,6,17273,959,0,0
76,3942,1293,570,1093,25,15,163,1318,10,195,123,241,205,364,1516,2795,6,17273,959,0,0
77,3957,1293,570,1093,25,15,163,1318,10,195,123,241,205,364,1516,2795,6,17273,959,0,0
6,163,127,75,83,2,11,30,129,4,14,7,14,18,21,61,87,2,175,9,0,0
6,163,652,304,544,16,6,88,668,6,89,51,101,95,152,591,998,3,3399,188,0,0
6,163,2,2,2,0,0,0,2,0,0,0,0,0,0,0,0,0,0,0,0,0
6,163,8,5,5,0,0,3,8,0,0,0,0,0,0,0,0,0,0,0,0,0
6,163,14,8,8,0,0,6,14,0,0,0,0,0,0,0,0,0,0,0,0,0
6,163,6,4,4,0,0,2,6,0,0,0,0,0,0,0,0,0,0,0,0,0
6,163,6,4,4,0,0,2,6,1,2,1,2,3,3,2,4,0,2,0,0,0
6,163,7,5,5,0,0,2,7,0,0,0,0,0,0,0,0,0,0,0,0,0
6,163,10,6,6,0,0,4,10,0,0,0,0,0,0,0,0,0,0,0,0,0
6,163,1,1,1,0,0,0,1,0,0,0,0,0,0,0,0,0,0,0,0,0
6,163,14,10,10,0,0,4,14,1,1,1,1,2,2,0,2,0,1,0,0,0
6,163,46,26,30,3,0,12,49,3,6,3,6,9,9,20,28,1,42,2,0,0
231,5945,722,423,573,19,0,135,741,12,172,101,199,184,300,1320,2257,6,15668,870,0,0
231,5945,1508,847,911,44,250,301,1552,14,148,88,169,162,257,1120,1886,7,15077,837,0,0
314,6928,72,33,56,0,4,12,72,1,1,1,1,2,2,0,2,0,1,0,0,0
314,6928,1454,835,1044,76,110,219,1530,17,275,158,296,292,454,2297,3718,9,34017,1889,1,0
91,4008,1338,495,1086,10,64,173,1348,11,122,82,157,133,239,883,1686,7,11934,663,0,0
78,4013,1293,570,1093,25,15,163,1318,10,195,123,241,205,364,1516,2795,6,17273,959,0,0
231,5978,722,423,573,19,0,135,741,12,172,101,199,184,300,1320,2257,6,15668,870,0,1
231,5978,1508,847,911,44,250,301,1552,14,148,88,169,162,257,1120,1886,7,15077,837,0,1
56,2875,722,423,573,19,0,135,741,12,172,101,199,184,300,1320,2257,6,15668,870,0,1
232,5970,722,423,573,19,0,135,741,12,172,101,199,184,300,1320,2257,6,15668,870,0,0
232,5970,1508,847,911,44,250,301,1552,14,148,88,169,162,257,1120,1886,7,15077,837,0,0
56,2883,722,423,573,19,0,135,741,12,172,101,199,184,300,1320,2257,6,15668,870,0,0
253,5855,4293,999,3693,19,54,507,4312,9,155,88,170,164,258,1156,1898,4,9368,520,0,1
253,5855,1482,859,1002,125,135,219,1607,16,219,134,251,235,385,1766,3032,9,27804,1544,1,1
70,1557,402,202,227,24,74,80,426,12,52,33,61,64,94,339,564,7,3969,220,0,1
172,7635,4293,999,3693,19,54,507,4312,9,155,88,170,164,258,1156,1898,4,9368,520,0,1
172,7635,1482,859,1002,125,135,219,1607,16,219,134,251,235,385,1766,3032,9,27804,1544,1,1
253,5855,4293,999,3693,19,54,507,4312,9,155,88,170,164,258,1156,1898,4,9368,520,0,0
253,5855,1482,859,1002,125,135,219,1607,16,219,134,251,235,385,1766,3032,9,27804,1544,1,0
70,1557,402,202,227,24,74,80,426,12,52,33,61,64,94,339,564,7,3969,220,0,0
172,7635,4293,999,3693,19,54,507,4312,9,155,88,170,164,258,1156,1898,4,9368,520,0,0
172,7635,1482,859,1002,125,135,219,1607,16,219,134,251,235,385,1766,3032,9,27804,1544,1,0
253,5853,4293,999,3693,19,54,507,4312,9,155,88,170,164,258,1156,1898,4,9368,520,0,0
253,5853,1482,859,1002,125,135,219,1607,16,219,134,251,235,385,1766,3032,9,27804,1544,1,0
71,1576,402,202,227,24,74,80,426,12,52,33,61,64,94,339,564,7,3969,220,0,0
71,3226,1020,354,843,12,15,144,1032,8,134,77,144,142,221,970,1580,4,6792,377,0,0
189,5744,1660,832,1314,41,38,274,1701,20,312,209,395,332,604,2671,5058,12,64042,3557,1,0
189,5744,1057,646,719,113,100,145,1170,18,215,134,248,233,382,1740,3004,10,31186,1732,1,0
184,5506,1660,832,1314,41,38,274,1701,20,312,209,395,332,604,2671,5058,12,64042,3557,1,0
1,94,42,7,35,4,0,5,46,1,2,1,2,3,3,2,4,0,2,0,0,1
1,94,11,6,10,0,0,1,11,2,4,2,4,6,6,10,15,1,15,0,0,1
221,4758,182,127,129,0,0,53,182,5,39,21,42,44,63,217,343,2,926,51,0,1
221,4758,1165,710,800,67,119,181,1232,18,243,153,282,261,435,2000,3492,10,36473,2026,1,1
25,514,2,2,2,0,0,0,2,0,0,0,0,0,0,0,0,0,0,0,0,1
25,514,99,48,90,1,3,5,100,0,0,0,0,0,0,0,0,0,0,0,0,1
25,514,8,5,5,2,0,1,10,0,0,0,0,0,0,0,0,0,0,0,0,1
25,514,1217,716,841,84,126,174,1301,14,185,118,215,199,333,1446,2542,8,20687,1149,0,1
25,514,160,89,115,0,13,31,160,7,15,11,17,22,28,78,124,3,495,27,0,1
25,514,10,10,9,9,0,0,19,0,0,0,0,0,0,0,0,0,0,0,0,1
25,514,173,84,99,8,29,36,181,5,12,7,13,17,20,54,81,2,221,12,0,1
25,514,3,1,1,3,0,0,6,0,0,0,0,0,0,0,0,0,0,0,0,1
174,5298,1660,832,1314,41,38,274,1701,20,312,209,395,332,604,2671,5058,12,64042,3557,1,1
174,5298,1057,646,719,113,100,145,1170,18,215,134,248,233,382,1740,3004,10,31186,1732,1,1
116,2173,477,336,357,30,23,73,507,16,194,134,250,210,384,1538,2962,10,30538,1696,0,1
90,2044,996,429,845,24,10,117,1020,7,76,50,88,83,138,494,879,4,3565,198,0,1
90,2044,456,277,329,12,42,72,468,13,85,50,97,98,147,592,972,7,7212,400,0,1
160,3459,1513,682,1277,25,13,200,1538,11,199,116,219,210,335,1557,2584,6,15641,868,0,1
160,3459,819,519,539,24,98,155,843,15,96,57,106,111,163,690,1107,8,9171,509,0,1
59,1120,207,111,150,11,0,50,218,5,26,19,36,31,55,133,272,3,943,52,0,1
59,1120,410,198,237,31,55,97,441,11,63,38,72,74,110,414,683,6,4293,238,0,1
235,4913,2,2,2,0,0,0,2,0,0,0,0,0,0,0,0,0,0,0,0,1
235,4913,99,48,90,1,3,5,100,0,0,0,0,0,0,0,0,0,0,0,0,1
235,4913,8,5,5,2,0,1,10,0,0,0,0,0,0,0,0,0,0,0,0,1
235,4913,1217,716,841,84,126,174,1301,14,185,118,215,199,333,1446,2542,8,20687,1149,0,1
235,4913,160,89,115,0,13,31,160,7,15,11,17,22,28,78,124,3,495,27,0,1
235,4913,10,10,9,9,0,0,19,0,0,0,0,0,0,0,0,0,0,0,0,1
235,4913,173,84,99,8,29,36,181,5,12,7,13,17,20,54,81,2,221,12,0,1
235,4913,3,1,1,3,0,0,6,0,0,0,0,0,0,0,0,0,0,0,0,1
90,2308,1455,414,1257,16,76,112,1471,5,41,23,46,46,69,231,381,2,1069,59,0,1
90,2308,669,365,481,22,61,110,691,15,103,63,122,118,185,747,1273,8,11311,628,0,1
251,5838,4293,999,3693,19,54,507,4312,9,155,88,170,164,258,1156,1898,4,9368,520,0,1
251,5838,1482,859,1002,125,135,219,1607,16,219,134,251,235,385,1766,3032,9,27804,1544,1,1
117,3160,1523,757,1297,19,12,193,1542,12,193,117,230,205,347,1508,2664,7,19053,1058,0,1
117,3160,701,378,504,33,58,109,734,13,110,68,126,123,194,794,1346,7,10027,557,0,1
105,2779,773,422,505,30,103,129,803,14,77,46,83,91,129,535,839,7,6334,351,0,1
149,3603,77,34,69,0,0,8,77,3,24,16,29,27,45,114,213,1,387,21,0,1
149,3603,712,438,573,51,9,84,763,14,102,71,128,116,199,733,1364,8,11988,666,0,1
71,1576,402,202,227,24,74,80,426,12,52,33,61,64,94,339,564,7,3969,220,0,1
51,1113,447,308,343,6,5,95,453,7,96,59,111,103,170,651,1136,4,4600,255,0,1
51,1113,322,174,179,16,74,51,338,10,41,26,46,51,72,252,408,5,2291,127,0,1
15,490,184,100,137,2,15,30,186,6,38,20,39,44,59,214,322,3,991,55,0,1
15,490,103,65,74,8,5,16,111,7,17,9,17,24,26,89,119,3,417,23,0,1
58,1203,91,45,69,0,3,18,91,3,9,6,10,12,16,33,57,1,95,5,0,1
58,1203,367,234,237,17,34,68,384,16,55,34,61,71,95,381,584,8,5183,287,0,1
228,5903,722,423,573,19,0,135,741,12,172,101,199,184,300,1320,2257,6,15668,870,0,1
228,5903,1508,847,911,44,250,301,1552,14,148,88,169,162,257,1120,1886,7,15077,837,0,1
315,6914,72,33,56,0,4,12,72,1,1,1,1,2,2,0,2,0,1,0,0,1
315,6914,1454,835,1044,76,110,219,1530,17,275,158,296,292,454,2297,3718,9,34017,1889,1,1
89,1819,757,253,292,73,244,162,830,13,61,38,67,74,105,409,651,7,4654,258,0,1
38,814,386,256,301,16,9,68,402,4,59,35,69,63,104,355,621,2,1453,80,0,1
38,814,264,131,164,11,41,46,275,6,38,22,40,44,62,214,338,3,1068,59,0,1
40,796,1178,367,1042,6,15,115,1184,9,94,51,95,103,146,644,976,4,4439,246,0,1
40,796,177,108,140,8,0,27,185,6,30,16,32,36,48,162,248,3,794,44,0,1
280,5888,1943,715,1694,26,18,214,1969,12,185,120,237,197,357,1436,2721,7,20915,1161,0,1
280,5888,1168,838,957,57,25,144,1225,19,348,224,416,367,640,3018,5452,11,61921,3440,1,1
19,717,442,244,305,14,16,103,456,11,68,45,75,79,120,452,756,6,4588,254,0,1
19,717,182,102,99,11,40,35,193,3,11,6,11,14,17,42,64,1,97,5,0,1
65,1263,1098,241,925,5,10,155,1103,7,46,25,49,53,74,273,423,3,1580,87,0,1
65,1263,282,202,222,14,2,44,296,8,42,24,43,50,67,250,378,4,1548,86,0,1
23,642,601,196,481,2,23,85,603,8,63,36,72,71,108,400,664,4,3036,168,0,1
23,642,156,79,106,5,16,28,161,5,14,8,15,19,23,64,97,2,261,14,0,1
104,4436,1289,550,1043,56,32,155,1345,10,167,93,185,177,278,1266,2075,5,11498,638,0,1
31,994,182,127,129,0,0,53,182,5,39,21,42,44,63,217,343,2,926,51,0,1
151,7251,1392,870,1177,35,17,170,1427,14,494,280,531,508,811,4473,7289,7,54850,3047,2,1
95,2896,773,419,590,28,0,166,801,10,204,113,217,214,330,1598,2554,5,13587,754,0,1
2,58,16,12,9,0,0,6,16,1,2,1,2,3,3,2,4,0,2,0,0,1
65,4378,520,294,400,33,13,81,553,10,261,204,367,271,571,2128,4614,7,32445,1802,1,1
90,3988,1338,495,1086,10,64,173,1348,11,122,82,157,133,239,883,1686,7,11934,663,0,1
144,5933,1782,648,1425,9,47,279,1791,8,171,97,189,179,286,1292,2140,4,9462,525,0,1
32,982,256,139,192,9,7,47,265,4,23,12,24,27,36,112,171,2,357,19,0,1
19,517,102,59,69,5,3,24,107,6,22,15,28,28,43,113,206,3,789,43,0,1
119,4920,1450,624,1228,12,26,181,1462,14,306,186,354,320,540,2580,4493,8,36391,2021,1,1
176,5162,1660,832,1314,41,38,274,1701,20,312,209,395,332,604,2671,5058,12,64042,3557,1,1
120,5123,1513,682,1277,25,13,200,1538,11,199,116,219,210,335,1557,2584,6,15641,868,0,1
84,4916,1296,573,1062,40,33,157,1336,8,201,118,231,209,349,1561,2689,4,12365,686,0,1
20,467,207,111,150,11,0,50,218,5,26,19,36,31,55,133,272,3,943,52,0,1
98,5241,1457,730,1242,11,6,188,1468,10,292,166,329,302,495,2424,4078,5,22973,1276,1,1
72,3266,1455,414,1257,16,76,112,1471,5,41,23,46,46,69,231,381,2,1069,59,0,1
107,5160,1523,757,1297,19,12,193,1542,12,193,117,230,205,347,1508,2664,7,19053,1058,0,1
70,3204,1020,354,843,12,15,144,1032,8,134,77,144,142,221,970,1580,4,6792,377,0,1
44,2058,447,308,343,6,5,95,453,7,96,59,111,103,170,651,1136,4,4600,255,0,1
9,444,184,100,137,2,15,30,186,6,38,20,39,44,59,214,322,3,991,55,0,1
75,3960,1293,570,1093,25,15,163,1318,10,195,123,241,205,364,1516,2795,6,17273,959,0,1
85,3387,1043,504,840,53,9,147,1096,9,180,112,198,189,310,1377,2344,4,11604,644,0,1
79,3101,1178,367,1042,6,15,115,1184,9,94,51,95,103,146,644,976,4,4439,246,0,1
35,1497,442,244,305,14,16,103,456,11,68,45,75,79,120,452,756,6,4588,254,0,1
48,1943,1098,241,925,5,10,155,1103,7,46,25,49,53,74,273,423,3,1580,87,0,1
48,1649,601,196,481,2,23,85,603,8,63,36,72,71,108,400,664,4,3036,168,0,1
221,4758,182,127,129,0,0,53,182,5,39,21,42,44,63,217,343,2,926,51,0,0
221,4758,1165,710,800,67,119,181,1232,18,243,153,282,261,435,2000,3492,10,36473,2026,1,0
25,514,2,2,2,0,0,0,2,0,0,0,0,0,0,0,0,0,0,0,0,0
25,514,99,48,90,1,3,5,100,0,0,0,0,0,0,0,0,0,0,0,0,0
25,514,8,5,5,2,0,1,10,0,0,0,0,0,0,0,0,0,0,0,0,0
25,514,1217,716,841,84,126,174,1301,14,185,118,215,199,333,1446,2542,8,20687,1149,0,0
25,514,160,89,115,0,13,31,160,7,15,11,17,22,28,78,124,3,495,27,0,0
25,514,10,10,9,9,0,0,19,0,0,0,0,0,0,0,0,0,0,0,0,0
25,514,173,84,99,8,29,36,181,5,12,7,13,17,20,54,81,2,221,12,0,0
25,514,3,1,1,3,0,0,6,0,0,0,0,0,0,0,0,0,0,0,0,0
174,5298,1660,832,1314,41,38,274,1701,20,312,209,395,332,604,2671,5058,12,64042,3557,1,0
174,5298,1057,646,719,113,100,145,1170,18,215,134,248,233,382,1740,3004,10,31186,1732,1,0
90,2044,996,429,845,24,10,117,1020,7,76,50,88,83,138,494,879,4,3565,198,0,0
90,2044,456,277,329,12,42,72,468,13,85,50,97,98,147,592,972,7,7212,400,0,0
160,3459,1513,682,1277,25,13,200,1538,11,199,116,219,210,335,1557,2584,6,15641,868,0,0
160,3459,819,519,539,24,98,155,843,15,96,57,106,111,163,690,1107,8,9171,509,0,0
59,1120,207,111,150,11,0,50,218,5,26,19,36,31,55,133,272,3,943,52,0,0
59,1120,410,198,237,31,55,97,441,11,63,38,72,74,110,414,683,6,4293,238,0,0
235,4913,2,2,2,0,0,0,2,0,0,0,0,0,0,0,0,0,0,0,0,0
235,4913,99,48,90,1,3,5,100,0,0,0,0,0,0,0,0,0,0,0,0,0
235,4913,8,5,5,2,0,1,10,0,0,0,0,0,0,0,0,0,0,0,0,0
235,4913,1217,716,841,84,126,174,1301,14,185,118,215,199,333,1446,2542,8,20687,1149,0,0
235,4913,160,89,115,0,13,31,160,7,15,11,17,22,28,78,124,3,495,27,0,0
235,4913,10,10,9,9,0,0,19,0,0,0,0,0,0,0,0,0,0,0,0,0
235,4913,173,84,99,8,29,36,181,5,12,7,13,17,20,54,81,2,221,12,0,0
235,4913,3,1,1,3,0,0,6,0,0,0,0,0,0,0,0,0,0,0,0,0
90,2308,1455,414,1257,16,76,112,1471,5,41,23,46,46,69,231,381,2,1069,59,0,0
90,2308,669,365,481,22,61,110,691,15,103,63,122,118,185,747,1273,8,11311,628,0,0
251,5838,4293,999,3693,19,54,507,4312,9,155,88,170,164,258,1156,1898,4,9368,520,0,0
251,5838,1482,859,1002,125,135,219,1607,16,219,134,251,235,385,1766,3032,9,27804,1544,1,0
117,3160,1523,757,1297,19,12,193,1542,12,193,117,230,205,347,1508,2664,7,19053,1058,0,0
117,3160,701,378,504,33,58,109,734,13,110,68,126,123,194,794,1346,7,10027,557,0,0
105,2779,773,422,505,30,103,129,803,14,77,46,83,91,129,535,839,7,6334,351,0,0
149,3603,77,34,69,0,0,8,77,3,24,16,29,27,45,114,213,1,387,21,0,0
149,3603,712,438,573,51,9,84,763,14,102,71,128,116,199,733,1364,8,11988,666,0,0
51,1113,447,308,343,6,5,95,453,7,96,59,111,103,170,651,1136,4,4600,255,0,0
51,1113,322,174,179,16,74,51,338,10,41,26,46,51,72,252,408,5,2291,127,0,0
15,490,184,100,137,2,15,30,186,6,38,20,39,44,59,214,322,3,991,55,0,0
15,490,103,65,74,8,5,16,111,7,17,9,17,24,26,89,119,3,417,23,0,0
58,1203,91,45,69,0,3,18,91,3,9,6,10,12,16,33,57,1,95,5,0,0
58,1203,367,234,237,17,34,68,384,16,55,34,61,71,95,381,584,8,5183,287,0,0
228,5903,722,423,573,19,0,135,741,12,172,101,199,184,300,1320,2257,6,15668,870,0,0
228,5903,1508,847,911,44,250,301,1552,14,148,88,169,162,257,1120,1886,7,15077,837,0,0
315,6914,72,33,56,0,4,12,72,1,1,1,1,2,2,0,2,0,1,0,0,0
315,6914,1454,835,1044,76,110,219,1530,17,275,158,296,292,454,2297,3718,9,34017,1889,1,0
89,1819,757,253,292,73,244,162,830,13,61,38,67,74,105,409,651,7,4654,258,0,0
38,814,386,256,301,16,9,68,402,4,59,35,69,63,104,355,621,2,1453,80,0,0
38,814,264,131,164,11,41,46,275,6,38,22,40,44,62,214,338,3,1068,59,0,0
40,796,1178,367,1042,6,15,115,1184,9,94,51,95,103,146,644,976,4,4439,246,0,0
40,796,177,108,140,8,0,27,185,6,30,16,32,36,48,162,248,3,794,44,0,0
280,5888,1943,715,1694,26,18,214,1969,12,185,120,237,197,357,1436,2721,7,20915,1161,0,0
280,5888,1168,838,957,57,25,144,1225,19,348,224,416,367,640,3018,5452,11,61921,3440,1,0
65,1263,1098,241,925,5,10,155,1103,7,46,25,49,53,74,273,423,3,1580,87,0,0
65,1263,282,202,222,14,2,44,296,8,42,24,43,50,67,250,378,4,1548,86,0,0
23,642,601,196,481,2,23,85,603,8,63,36,72,71,108,400,664,4,3036,168,0,0
23,642,156,79,106,5,16,28,161,5,14,8,15,19,23,64,97,2,261,14,0,0
104,4436,1289,550,1043,56,32,155,1345,10,167,93,185,177,278,1266,2075,5,11498,638,0,0
31,994,182,127,129,0,0,53,182,5,39,21,42,44,63,217,343,2,926,51,0,0
151,7251,1392,870,1177,35,17,170,1427,14,494,280,531,508,811,4473,7289,7,54850,3047,2,0
95,2896,773,419,590,28,0,166,801,10,204,113,217,214,330,1598,2554,5,13587,754,0,0
2,58,16,12,9,0,0,6,16,1,2,1,2,3,3,2,4,0,2,0,0,0
65,4378,520,294,400,33,13,81,553,10,261,204,367,271,571,2128,4614,7,32445,1802,1,0
90,3988,1338,495,1086,10,64,173,1348,11,122,82,157,133,239,883,1686,7,11934,663,0,0
144,5933,1782,648,1425,9,47,279,1791,8,171,97,189,179,286,1292,2140,4,9462,525,0,0
32,982,256,139,192,9,7,47,265,4,23,12,24,27,36,112,171,2,357,19,0,0
19,517,102,59,69,5,3,24,107,6,22,15,28,28,43,113,206,3,789,43,0,0
119,4920,1450,624,1228,12,26,181,1462,14,306,186,354,320,540,2580,4493,8,36391,2021,1,0
176,5162,1660,832,1314,41,38,274,1701,20,312,209,395,332,604,2671,5058,12,64042,3557,1,0
120,5123,1513,682,1277,25,13,200,1538,11,199,116,219,210,335,1557,2584,6,15641,868,0,0
84,4916,1296,573,1062,40,33,157,1336,8,201,118,231,209,349,1561,2689,4,12365,686,0,0
20,467,207,111,150,11,0,50,218,5,26,19,36,31,55,133,272,3,943,52,0,0
98,5241,1457,730,1242,11,6,188,1468,10,292,166,329,302,495,2424,4078,5,22973,1276,1,0
72,3266,1455,414,1257,16,76,112,1471,5,41,23,46,46,69,231,381,2,1069,59,0,0
107,5160,1523,757,1297,19,12,193,1542,12,193,117,230,205,347,1508,2664,7,19053,1058,0,0
70,3204,1020,354,843,12,15,144,1032,8,134,77,144,142,221,970,1580,4,6792,377,0,0
44,2058,447,308,343,6,5,95,453,7,96,59,111,103,170,651,1136,4,4600,255,0,0
9,444,184,100,137,2,15,30,186,6,38,20,39,44,59,214,322,3,991,55,0,0
75,3960,1293,570,1093,25,15,163,1318,10,195,123,241,205,364,1516,2795,6,17273,959,0,0
85,3387,1043,504,840,53,9,147,1096,9,180,112,198,189,310,1377,2344,4,11604,644,0,0
79,3101,1178,367,1042,6,15,115,1184,9,94,51,95,103,146,644,976,4,4439,246,0,0
35,1497,442,244,305,14,16,103,456,11,68,45,75,79,120,452,756,6,4588,254,0,0
48,1943,1098,241,925,5,10,155,1103,7,46,25,49,53,74,273,423,3,1580,87,0,0
48,1649,601,196,481,2,23,85,603,8,63,36,72,71,108,400,664,4,3036,168,0,0
3,330,149,67,118,4,0,27,153,1,17,14,28,18,42,69,175,0,144,8,0,0
11,230,19,8,11,5,0,4,24,2,5,3,6,7,9,13,25,1,30,1,0,0
11,230,102,59,69,5,3,24,107,6,22,15,28,28,43,113,206,3,789,43,0,0
11,230,106,40,36,3,49,17,109,8,17,13,23,25,36,93,167,5,904,50,0,0
221,4746,182,127,129,0,0,53,182,5,39,21,42,44,63,217,343,2,926,51,0,0
221,4746,1165,710,800,67,119,181,1232,18,243,153,282,261,435,2000,3492,10,36473,2026,1,0
67,1558,773,419,590,28,0,166,801,10,204,113,217,214,330,1598,2554,5,13587,754,0,0
67,1558,421,273,302,44,34,57,465,17,81,59,107,98,166,583,1098,11,12329,684,0,0
14,407,149,95,105,2,0,41,151,8,54,28,55,62,83,334,494,4,2013,111,0,0
14,407,82,56,54,0,13,15,82,4,13,8,16,17,24,56,98,2,241,13,0,0
25,502,2,2,2,0,0,0,2,0,0,0,0,0,0,0,0,0,0,0,0,0
25,502,99,48,90,1,3,5,100,0,0,0,0,0,0,0,0,0,0,0,0,0
25,502,8,5,5,2,0,1,10,0,0,0,0,0,0,0,0,0,0,0,0,0
25,502,1217,716,841,84,126,174,1301,14,185,118,215,199,333,1446,2542,8,20687,1149,0,0
25,502,160,89,115,0,13,31,160,7,15,11,17,22,28,78,124,3,495,27,0,0
25,502,10,10,9,9,0,0,19,0,0,0,0,0,0,0,0,0,0,0,0,0
25,502,173,84,99,8,29,36,181,5,12,7,13,17,20,54,81,2,221,12,0,0
25,502,3,1,1,3,0,0,6,0,0,0,0,0,0,0,0,0,0,0,0,0
174,5286,1660,832,1314,41,38,274,1701,20,312,209,395,332,604,2671,5058,12,64042,3557,1,0
174,5286,1057,646,719,113,100,145,1170,18,215,134,248,233,382,1740,3004,10,31186,1732,1,0
17,336,95,58,50,9,16,20,104,12,33,24,45,45,69,209,378,8,3100,172,0,0
116,2161,477,336,357,30,23,73,507,16,194,134,250,210,384,1538,2962,10,30538,1696,0,0
90,2032,996,429,845,24,10,117,1020,7,76,50,88,83,138,494,879,4,3565,198,0,0
90,2032,456,277,329,12,42,72,468,13,85,50,97,98,147,592,972,7,7212,400,0,0
160,3447,1513,682,1277,25,13,200,1538,11,199,116,219,210,335,1557,2584,6,15641,868,0,0
160,3447,819,519,539,24,98,155,843,15,96,57,106,111,163,690,1107,8,9171,509,0,0
59,1108,207,111,150,11,0,50,218,5,26,19,36,31,55,133,272,3,943,52,0,0
59,1108,410,198,237,31,55,97,441,11,63,38,72,74,110,414,683,6,4293,238,0,0
235,4901,2,2,2,0,0,0,2,0,0,0,0,0,0,0,0,0,0,0,0,0
235,4901,99,48,90,1,3,5,100,0,0,0,0,0,0,0,0,0,0,0,0,0
235,4901,8,5,5,2,0,1,10,0,0,0,0,0,0,0,0,0,0,0,0,0
235,4901,1217,716,841,84,126,174,1301,14,185,118,215,199,333,1446,2542,8,20687,1149,0,0
235,4901,160,89,115,0,13,31,160,7,15,11,17,22,28,78,124,3,495,27,0,0
235,4901,10,10,9,9,0,0,19,0,0,0,0,0,0,0,0,0,0,0,0,0
235,4901,173,84,99,8,29,36,181,5,12,7,13,17,20,54,81,2,221,12,0,0
235,4901,3,1,1,3,0,0,6,0,0,0,0,0,0,0,0,0,0,0,0,0
57,1510,339,213,244,17,9,65,356,10,42,26,48,52,74,259,421,5,2410,133,0,0
90,2296,1455,414,1257,16,76,112,1471,5,41,23,46,46,69,231,381,2,1069,59,0,0
90,2296,669,365,481,22,61,110,691,15,103,63,122,118,185,747,1273,8,11311,628,0,0
251,5826,4293,999,3693,19,54,507,4312,9,155,88,170,164,258,1156,1898,4,9368,520,0,0
251,5826,1482,859,1002,125,135,219,1607,16,219,134,251,235,385,1766,3032,9,27804,1544,1,0
6,128,44,22,19,0,19,6,44,2,10,6,12,12,18,35,64,1,77,4,0,0
31,1075,74,35,59,1,0,14,75,3,14,7,14,17,21,58,85,1,128,7,0,0
31,1075,245,125,200,5,7,34,250,7,30,17,34,37,51,166,265,3,1053,58,0,0
117,3148,1523,757,1297,19,12,193,1542,12,193,117,230,205,347,1508,2664,7,19053,1058,0,0
117,3148,701,378,504,33,58,109,734,13,110,68,126,123,194,794,1346,7,10027,557,0,0
105,2767,773,422,505,30,103,129,803,14,77,46,83,91,129,535,839,7,6334,351,0,0
149,3591,77,34,69,0,0,8,77,3,24,16,29,27,45,114,213,1,387,21,0,0
149,3591,712,438,573,51,9,84,763,14,102,71,128,116,199,733,1364,8,11988,666,0,0
51,1101,447,308,343,6,5,95,453,7,96,59,111,103,170,651,1136,4,4600,255,0,0
51,1101,322,174,179,16,74,51,338,10,41,26,46,51,72,252,408,5,2291,127,0,0
18,300,424,94,331,4,0,89,428,1,5,5,5,6,10,11,25,0,12,0,0,0
18,300,38,23,23,6,0,8,44,3,11,7,11,14,18,42,68,1,102,5,0,0
19,501,205,80,86,16,53,53,221,7,18,10,19,25,29,94,134,3,497,27,0,0
15,478,184,100,137,2,15,30,186,6,38,20,39,44,59,214,322,3,991,55,0,0
15,478,103,65,74,8,5,16,111,7,17,9,17,24,26,89,119,3,417,23,0,0
58,1197,91,45,69,0,3,18,91,3,9,6,10,12,16,33,57,1,95,5,0,0
58,1197,367,234,237,17,34,68,384,16,55,34,61,71,95,381,584,8,5183,287,0,0
228,5891,722,423,573,19,0,135,741,12,172,101,199,184,300,1320,2257,6,15668,870,0,0
228,5891,1508,847,911,44,250,301,1552,14,148,88,169,162,257,1120,1886,7,15077,837,0,0
315,6902,72,33,56,0,4,12,72,1,1,1,1,2,2,0,2,0,1,0,0,0
315,6902,1454,835,1044,76,110,219,1530,17,275,158,296,292,454,2297,3718,9,34017,1889,1,0
89,1807,757,253,292,73,244,162,830,13,61,38,67,74,105,409,651,7,4654,258,0,0
38,802,386,256,301,16,9,68,402,4,59,35,69,63,104,355,621,2,1453,80,0,0
38,802,264,131,164,11,41,46,275,6,38,22,40,44,62,214,338,3,1068,59,0,0
25,540,215,129,180,6,0,29,221,8,65,43,72,73,115,415,711,4,3153,175,0,0
25,540,97,69,77,3,3,16,100,6,22,13,23,28,36,113,173,3,542,30,0,0
89,1882,1043,504,840,53,9,147,1096,9,180,112,198,189,310,1377,2344,4,11604,644,0,0
89,1882,383,288,292,26,6,62,409,11,65,38,67,76,105,429,656,5,3719,206,0,0
5,111,110,30,77,3,13,16,113,4,21,15,30,25,45,100,208,2,597,33,0,0
5,111,28,15,21,1,0,6,29,0,0,0,0,0,0,0,0,0,0,0,0,0
40,784,1178,367,1042,6,15,115,1184,9,94,51,95,103,146,644,976,4,4439,246,0,0
40,784,177,108,140,8,0,27,185,6,30,16,32,36,48,162,248,3,794,44,0,0
280,5876,1943,715,1694,26,18,214,1969,12,185,120,237,197,357,1436,2721,7,20915,1161,0,0
280,5876,1168,838,957,57,25,144,1225,19,348,224,416,367,640,3018,5452,11,61921,3440,1,0
19,705,442,244,305,14,16,103,456,11,68,45,75,79,120,452,756,6,4588,254,0,0
19,705,182,102,99,11,40,35,193,3,11,6,11,14,17,42,64,1,97,5,0,0
65,1251,1098,241,925,5,10,155,1103,7,46,25,49,53,74,273,423,3,1580,87,0,0
65,1251,282,202,222,14,2,44,296,8,42,24,43,50,67,250,378,4,1548,86,0,0
23,630,601,196,481,2,23,85,603,8,63,36,72,71,108,400,664,4,3036,168,0,0
23,630,156,79,106,5,16,28,161,5,14,8,15,19,23,64,97,2,261,14,0,0
104,4424,1289,550,1043,56,32,155,1345,10,167,93,185,177,278,1266,2075,5,11498,638,0,0
31,982,182,127,129,0,0,53,182,5,39,21,42,44,63,217,343,2,926,51,0,0
151,7235,1392,870,1177,35,17,170,1427,14,494,280,531,508,811,4473,7289,7,54850,3047,2,0
95,2884,773,419,590,28,0,166,801,10,204,113,217,214,330,1598,2554,5,13587,754,0,0
14,833,75,38,59,1,3,12,76,2,4,2,4,6,6,10,15,1,15,0,0,0
19,505,102,59,69,5,3,24,107,6,22,15,28,28,43,113,206,3,789,43,0,0
119,4908,1450,624,1228,12,26,181,1462,14,306,186,354,320,540,2580,4493,8,36391,2021,1,0
176,5150,1660,832,1314,41,38,274,1701,20,312,209,395,332,604,2671,5058,12,64042,3557,1,0
49,3793,996,429,845,24,10,117,1020,7,76,50,88,83,138,494,879,4,3565,198,0,0
120,5111,1513,682,1277,25,13,200,1538,11,199,116,219,210,335,1557,2584,6,15641,868,0,0
84,4904,1296,573,1062,40,33,157,1336,8,201,118,231,209,349,1561,2689,4,12365,686,0,0
20,455,207,111,150,11,0,50,218,5,26,19,36,31,55,133,272,3,943,52,0,0
98,5229,1457,730,1242,11,6,188,1468,10,292,166,329,302,495,2424,4078,5,22973,1276,1,0
43,2678,652,304,544,16,6,88,668,6,89,51,101,95,152,591,998,3,3399,188,0,0
72,3254,1455,414,1257,16,76,112,1471,5,41,23,46,46,69,231,381,2,1069,59,0,0
2,44,7,6,5,0,0,2,7,1,1,1,2,2,3,0,3,1,3,0,0,0
8,263,74,35,59,1,0,14,75,3,14,7,14,17,21,58,85,1,128,7,0,0
107,5148,1523,757,1297,19,12,193,1542,12,193,117,230,205,347,1508,2664,7,19053,1058,0,0
70,3192,1020,354,843,12,15,144,1032,8,134,77,144,142,221,970,1580,4,6792,377,0,0
44,2046,447,308,343,6,5,95,453,7,96,59,111,103,170,651,1136,4,4600,255,0,0
21,643,424,94,331,4,0,89,428,1,5,5,5,6,10,11,25,0,12,0,0,0
9,432,184,100,137,2,15,30,186,6,38,20,39,44,59,214,322,3,991,55,0,0
75,3948,1293,570,1093,25,15,163,1318,10,195,123,241,205,364,1516,2795,6,17273,959,0,0
29,1891,384,251,317,7,8,52,391,11,70,44,84,81,128,467,811,6,5355,297,0,0
56,2871,722,423,573,19,0,135,741,12,172,101,199,184,300,1320,2257,6,15668,870,0,0
45,1941,386,256,301,16,9,68,402,4,59,35,69,63,104,355,621,2,1453,80,0,0
15,1054,215,129,180,6,0,29,221,8,65,43,72,73,115,415,711,4,3153,175,0,0
85,3375,1043,504,840,53,9,147,1096,9,180,112,198,189,310,1377,2344,4,11604,644,0,0
12,466,295,56,236,0,4,54,295,2,9,5,10,11,15,30,51,1,57,3,0,0
30,1428,373,158,315,8,0,51,381,5,76,44,79,81,123,486,779,2,2026,112,0,0
79,3089,1178,367,1042,6,15,115,1184,9,94,51,95,103,146,644,976,4,4439,246,0,0
111,6110,1943,715,1694,26,18,214,1969,12,185,120,237,197,357,1436,2721,7,20915,1161,0,0
35,1485,442,244,305,14,16,103,456,11,68,45,75,79,120,452,756,6,4588,254,0,0
48,1931,1098,241,925,5,10,155,1103,7,46,25,49,53,74,273,423,3,1580,87,0,0
48,1645,601,196,481,2,23,85,603,8,63,36,72,71,108,400,664,4,3036,168,0,0
1,313,382,65,130,157,2,92,539,4,10,5,10,14,15,41,57,2,114,6,0,1
60,1118,282,196,195,3,0,86,285,8,130,71,141,138,212,936,1507,4,6538,363,0,1
7,293,72,33,56,0,4,12,72,1,1,1,1,2,2,0,2,0,1,0,0,1
12,226,127,75,83,2,11,30,129,4,14,7,14,18,21,61,87,2,175,9,0,1
12,226,652,304,544,16,6,88,668,6,89,51,101,95,152,591,998,3,3399,188,0,1
12,226,2,2,2,0,0,0,2,0,0,0,0,0,0,0,0,0,0,0,0,1
12,226,8,5,5,0,0,3,8,0,0,0,0,0,0,0,0,0,0,0,0,1
12,226,14,8,8,0,0,6,14,0,0,0,0,0,0,0,0,0,0,0,0,1
12,226,6,4,4,0,0,2,6,0,0,0,0,0,0,0,0,0,0,0,0,1
12,226,6,4,4,0,0,2,6,1,2,1,2,3,3,2,4,0,2,0,0,1
12,226,7,5,5,0,0,2,7,0,0,0,0,0,0,0,0,0,0,0,0,1
12,226,10,6,6,0,0,4,10,0,0,0,0,0,0,0,0,0,0,0,0,1
12,226,1,1,1,0,0,0,1,0,0,0,0,0,0,0,0,0,0,0,0,1
12,226,14,10,10,0,0,4,14,1,1,1,1,2,2,0,2,0,1,0,0,1
12,226,46,26,30,3,0,12,49,3,6,3,6,9,9,20,28,1,42,2,0,1
11,227,19,8,11,5,0,4,24,2,5,3,6,7,9,13,25,1,30,1,0,1
11,227,102,59,69,5,3,24,107,6,22,15,28,28,43,113,206,3,789,43,0,1
11,227,106,40,36,3,49,17,109,8,17,13,23,25,36,93,167,5,904,50,0,1
221,4718,182,127,129,0,0,53,182,5,39,21,42,44,63,217,343,2,926,51,0,1
221,4718,1165,710,800,67,119,181,1232,18,243,153,282,261,435,2000,3492,10,36473,2026,1,1
67,1551,773,419,590,28,0,166,801,10,204,113,217,214,330,1598,2554,5,13587,754,0,1
67,1551,421,273,302,44,34,57,465,17,81,59,107,98,166,583,1098,11,12329,684,0,1
14,404,149,95,105,2,0,41,151,8,54,28,55,62,83,334,494,4,2013,111,0,1
14,404,82,56,54,0,13,15,82,4,13,8,16,17,24,56,98,2,241,13,0,1
25,489,2,2,2,0,0,0,2,0,0,0,0,0,0,0,0,0,0,0,0,1
25,489,99,48,90,1,3,5,100,0,0,0,0,0,0,0,0,0,0,0,0,1
25,489,8,5,5,2,0,1,10,0,0,0,0,0,0,0,0,0,0,0,0,1
25,489,1217,716,841,84,126,174,1301,14,185,118,215,199,333,1446,2542,8,20687,1149,0,1
25,489,160,89,115,0,13,31,160,7,15,11,17,22,28,78,124,3,495,27,0,1
25,489,10,10,9,9,0,0,19,0,0,0,0,0,0,0,0,0,0,0,0,1
25,489,173,84,99,8,29,36,181,5,12,7,13,17,20,54,81,2,221,12,0,1
25,489,3,1,1,3,0,0,6,0,0,0,0,0,0,0,0,0,0,0,0,1
174,5271,1660,832,1314,41,38,274,1701,20,312,209,395,332,604,2671,5058,12,64042,3557,1,1
174,5271,1057,646,719,113,100,145,1170,18,215,134,248,233,382,1740,3004,10,31186,1732,1,1
17,327,95,58,50,9,16,20,104,12,33,24,45,45,69,209,378,8,3100,172,0,1
116,2120,477,336,357,30,23,73,507,16,194,134,250,210,384,1538,2962,10,30538,1696,0,1
90,2017,996,429,845,24,10,117,1020,7,76,50,88,83,138,494,879,4,3565,198,0,1
90,2017,456,277,329,12,42,72,468,13,85,50,97,98,147,592,972,7,7212,400,0,1
160,3411,1513,682,1277,25,13,200,1538,11,199,116,219,210,335,1557,2584,6,15641,868,0,1
160,3411,819,519,539,24,98,155,843,15,96,57,106,111,163,690,1107,8,9171,509,0,1
59,1095,207,111,150,11,0,50,218,5,26,19,36,31,55,133,272,3,943,52,0,1
59,1095,410,198,237,31,55,97,441,11,63,38,72,74,110,414,683,6,4293,238,0,1
235,4869,2,2,2,0,0,0,2,0,0,0,0,0,0,0,0,0,0,0,0,1
235,4869,99,48,90,1,3,5,100,0,0,0,0,0,0,0,0,0,0,0,0,1
235,4869,8,5,5,2,0,1,10,0,0,0,0,0,0,0,0,0,0,0,0,1
235,4869,1217,716,841,84,126,174,1301,14,185,118,215,199,333,1446,2542,8,20687,1149,0,1
235,4869,160,89,115,0,13,31,160,7,15,11,17,22,28,78,124,3,495,27,0,1
235,4869,10,10,9,9,0,0,19,0,0,0,0,0,0,0,0,0,0,0,0,1
235,4869,173,84,99,8,29,36,181,5,12,7,13,17,20,54,81,2,221,12,0,1
235,4869,3,1,1,3,0,0,6,0,0,0,0,0,0,0,0,0,0,0,0,1
98,2010,463,295,324,28,62,57,491,12,134,82,154,146,236,989,1696,6,11700,650,0,1
57,1484,339,213,244,17,9,65,356,10,42,26,48,52,74,259,421,5,2410,133,0,1
90,2288,1455,414,1257,16,76,112,1471,5,41,23,46,46,69,231,381,2,1069,59,0,1
90,2288,669,365,481,22,61,110,691,15,103,63,122,118,185,747,1273,8,11311,628,0,1
251,5813,4293,999,3693,19,54,507,4312,9,155,88,170,164,258,1156,1898,4,9368,520,0,1
251,5813,1482,859,1002,125,135,219,1607,16,219,134,251,235,385,1766,3032,9,27804,1544,1,1
31,1078,74,35,59,1,0,14,75,3,14,7,14,17,21,58,85,1,128,7,0,1
31,1078,245,125,200,5,7,34,250,7,30,17,34,37,51,166,265,3,1053,58,0,1
117,3127,1523,757,1297,19,12,193,1542,12,193,117,230,205,347,1508,2664,7,19053,1058,0,1
117,3127,701,378,504,33,58,109,734,13,110,68,126,123,194,794,1346,7,10027,557,0,1
105,2753,773,422,505,30,103,129,803,14,77,46,83,91,129,535,839,7,6334,351,0,1
146,3571,77,34,69,0,0,8,77,3,24,16,29,27,45,114,213,1,387,21,0,1
146,3571,712,438,573,51,9,84,763,14,102,71,128,116,199,733,1364,8,11988,666,0,1
30,657,125,97,103,3,0,19,128,9,25,17,27,34,44,144,223,4,1087,60,0,1
22,367,102,57,55,5,16,25,107,5,17,10,18,22,28,81,124,2,330,18,0,1
71,1560,402,202,227,24,74,80,426,12,52,33,61,64,94,339,564,7,3969,220,0,1
51,1090,447,308,343,6,5,95,453,7,96,59,111,103,170,651,1136,4,4600,255,0,1
51,1090,322,174,179,16,74,51,338,10,41,26,46,51,72,252,408,5,2291,127,0,1
75,1603,53,23,39,0,0,13,53,2,8,4,8,10,12,26,39,1,39,2,0,1
75,1603,515,298,307,33,80,99,548,12,63,44,77,75,121,419,753,7,5527,307,0,1
18,296,424,94,331,4,0,89,428,1,5,5,5,6,10,11,25,0,12,0,0,1
18,296,38,23,23,6,0,8,44,3,11,7,11,14,18,42,68,1,102,5,0,1
19,499,205,80,86,16,53,53,221,7,18,10,19,25,29,94,134,3,497,27,0,1
15,476,184,100,137,2,15,30,186,6,38,20,39,44,59,214,322,3,991,55,0,1
15,476,103,65,74,8,5,16,111,7,17,9,17,24,26,89,119,3,417,23,0,1
58,1189,91,45,69,0,3,18,91,3,9,6,10,12,16,33,57,1,95,5,0,1
58,1189,367,234,237,17,34,68,384,16,55,34,61,71,95,381,584,8,5183,287,0,1
228,5843,722,423,573,19,0,135,741,12,172,101,199,184,300,1320,2257,6,15668,870,0,1
228,5843,1508,847,911,44,250,301,1552,14,148,88,169,162,257,1120,1886,7,15077,837,0,1
314,6872,72,33,56,0,4,12,72,1,1,1,1,2,2,0,2,0,1,0,0,1
314,6872,1454,835,1044,76,110,219,1530,17,275,158,296,292,454,2297,3718,9,34017,1889,1,1
89,1801,757,253,292,73,244,162,830,13,61,38,67,74,105,409,651,7,4654,258,0,1
38,787,386,256,301,16,9,68,402,4,59,35,69,63,104,355,621,2,1453,80,0,1
38,787,264,131,164,11,41,46,275,6,38,22,40,44,62,214,338,3,1068,59,0,1
67,1747,466,257,367,18,25,50,484,7,126,86,171,133,257,898,1813,4,8612,478,0,1
67,1747,507,281,342,29,59,88,536,10,53,29,57,63,86,336,514,5,2764,153,0,1
25,538,215,129,180,6,0,29,221,8,65,43,72,73,115,415,711,4,3153,175,0,1
25,538,97,69,77,3,3,16,100,6,22,13,23,28,36,113,173,3,542,30,0,1
89,1877,1043,504,840,53,9,147,1096,9,180,112,198,189,310,1377,2344,4,11604,644,0,1
89,1877,383,288,292,26,6,62,409,11,65,38,67,76,105,429,656,5,3719,206,0,1
280,5869,1943,715,1694,26,18,214,1969,12,185,120,237,197,357,1436,2721,7,20915,1161,0,1
280,5869,1168,838,957,57,25,144,1225,19,348,224,416,367,640,3018,5452,11,61921,3440,1,1
2,153,37,13,25,0,6,6,37,1,2,1,2,3,3,2,4,0,2,0,0,1
2,153,133,47,40,1,43,49,134,0,0,0,0,0,0,0,0,0,0,0,0,1
23,630,601,196,481,2,23,85,603,8,63,36,72,71,108,400,664,4,3036,168,0,1
23,630,156,79,106,5,16,28,161,5,14,8,15,19,23,64,97,2,261,14,0,1
104,4398,1289,550,1043,56,32,155,1345,10,167,93,185,177,278,1266,2075,5,11498,638,0,1
31,963,182,127,129,0,0,53,182,5,39,21,42,44,63,217,343,2,926,51,0,1
151,7198,1392,870,1177,35,17,170,1427,14,494,280,531,508,811,4473,7289,7,54850,3047,2,1
95,2841,773,419,590,28,0,166,801,10,204,113,217,214,330,1598,2554,5,13587,754,0,1
1,52,14,12,10,0,0,4,14,1,2,1,2,3,3,2,4,0,2,0,0,1
1,55,14,12,10,0,0,4,14,1,2,1,2,3,3,2,4,0,2,0,0,1
1,71,19,18,14,0,0,5,19,1,2,1,2,3,3,2,4,0,2,0,0,1
3,44,15,10,10,0,0,5,15,2,4,2,4,6,6,10,15,1,15,0,0,1
2,33,10,7,7,0,0,3,10,1,2,1,2,3,3,2,4,0,2,0,0,1
3,43,15,9,9,0,0,6,15,1,4,2,4,5,6,8,13,0,6,0,0,1
12,313,149,95,105,2,0,41,151,8,54,28,55,62,83,334,494,4,2013,111,0,1
15,699,139,89,101,2,0,35,141,7,54,34,62,61,96,330,569,4,2287,127,0,1
3,324,149,67,118,4,0,27,153,1,17,14,28,18,42,69,175,0,144,8,0,1
38,2497,1157,318,931,29,22,177,1186,6,104,63,125,110,188,712,1274,3,4596,255,0,1
65,4371,520,294,400,33,13,81,553,10,261,204,367,271,571,2128,4614,7,32445,1802,1,1
90,3959,1338,495,1086,10,64,173,1348,11,122,82,157,133,239,883,1686,7,11934,663,0,1
172,7590,4293,999,3693,19,54,507,4312,9,155,88,170,164,258,1156,1898,4,9368,520,0,1
172,7590,1482,859,1002,125,135,219,1607,16,219,134,251,235,385,1766,3032,9,27804,1544,1,1
33,984,465,148,393,5,8,60,470,4,31,20,31,35,51,161,261,2,523,29,0,1
33,984,16,12,9,0,0,6,16,1,2,1,2,3,3,2,4,0,2,0,0,1
144,5870,1782,648,1425,9,47,279,1791,8,171,97,189,179,286,1292,2140,4,9462,525,0,1
32,968,256,139,192,9,7,47,265,4,23,12,24,27,36,112,171,2,357,19,0,1
19,499,102,59,69,5,3,24,107,6,22,15,28,28,43,113,206,3,789,43,0,1
119,4854,1450,624,1228,12,26,181,1462,14,306,186,354,320,540,2580,4493,8,36391,2021,1,1
176,5109,1660,832,1314,41,38,274,1701,20,312,209,395,332,604,2671,5058,12,64042,3557,1,1
49,3780,996,429,845,24,10,117,1020,7,76,50,88,83,138,494,879,4,3565,198,0,1
120,5083,1513,682,1277,25,13,200,1538,11,199,116,219,210,335,1557,2584,6,15641,868,0,1
84,4871,1296,573,1062,40,33,157,1336,8,201,118,231,209,349,1561,2689,4,12365,686,0,1
20,449,207,111,150,11,0,50,218,5,26,19,36,31,55,133,272,3,943,52,0,1
98,5169,1457,730,1242,11,6,188,1468,10,292,166,329,302,495,2424,4078,5,22973,1276,1,1
43,2669,652,304,544,16,6,88,668,6,89,51,101,95,152,591,998,3,3399,188,0,1
72,3231,1455,414,1257,16,76,112,1471,5,41,23,46,46,69,231,381,2,1069,59,0,1
107,5128,1523,757,1297,19,12,193,1542,12,193,117,230,205,347,1508,2664,7,19053,1058,0,1
70,3177,1020,354,843,12,15,144,1032,8,134,77,144,142,221,970,1580,4,6792,377,0,1
44,2024,447,308,343,6,5,95,453,7,96,59,111,103,170,651,1136,4,4600,255,0,1
21,637,424,94,331,4,0,89,428,1,5,5,5,6,10,11,25,0,12,0,0,1
38,2309,334,251,279,10,4,40,344,5,127,74,143,132,217,899,1528,2,4303,239,0,1
9,423,184,100,137,2,15,30,186,6,38,20,39,44,59,214,322,3,991,55,0,1
75,3937,1293,570,1093,25,15,163,1318,10,195,123,241,205,364,1516,2795,6,17273,959,0,1
29,1873,384,251,317,7,8,52,391,11,70,44,84,81,128,467,811,6,5355,297,0,1
56,2846,722,423,573,19,0,135,741,12,172,101,199,184,300,1320,2257,6,15668,870,0,1
45,1932,386,256,301,16,9,68,402,4,59,35,69,63,104,355,621,2,1453,80,0,1
28,1590,466,257,367,18,25,50,484,7,126,86,171,133,257,898,1813,4,8612,478,0,1
15,1051,215,129,180,6,0,29,221,8,65,43,72,73,115,415,711,4,3153,175,0,1
85,3359,1043,504,840,53,9,147,1096,9,180,112,198,189,310,1377,2344,4,11604,644,0,1
30,1422,373,158,315,8,0,51,381,5,76,44,79,81,123,486,779,2,2026,112,0,1
79,3071,1178,367,1042,6,15,115,1184,9,94,51,95,103,146,644,976,4,4439,246,0,1
111,6048,1943,715,1694,26,18,214,1969,12,185,120,237,197,357,1436,2721,7,20915,1161,0,1
35,1473,442,244,305,14,16,103,456,11,68,45,75,79,120,452,756,6,4588,254,0,1
48,1928,1098,241,925,5,10,155,1103,7,46,25,49,53,74,273,423,3,1580,87,0,1
48,1639,601,196,481,2,23,85,603,8,63,36,72,71,108,400,664,4,3036,168,0,1
228,5833,722,423,573,19,0,135,741,12,172,101,199,184,300,1320,2257,6,15668,870,0,0
228,5833,1508,847,911,44,250,301,1552,14,148,88,169,162,257,1120,1886,7,15077,837,0,0
38,2493,1157,318,931,29,22,177,1186,6,104,63,125,110,188,712,1274,3,4596,255,0,0
1,92,42,7,35,4,0,5,46,1,2,1,2,3,3,2,4,0,2,0,0,0
1,92,11,6,10,0,0,1,11,2,4,2,4,6,6,10,15,1,15,0,0,0
174,5263,1660,832,1314,41,38,274,1701,20,312,209,395,332,604,2671,5058,12,64042,3557,1,0
174,5263,1057,646,719,113,100,145,1170,18,215,134,248,233,382,1740,3004,10,31186,1732,1,0
251,5822,4293,999,3693,19,54,507,4312,9,155,88,170,164,258,1156,1898,4,9368,520,0,0
251,5822,1482,859,1002,125,135,219,1607,16,219,134,251,235,385,1766,3032,9,27804,1544,1,0
104,2739,773,422,505,30,103,129,803,14,77,46,83,91,129,535,839,7,6334,351,0,0
89,1896,1043,504,840,53,9,147,1096,9,180,112,198,189,310,1377,2344,4,11604,644,0,0
89,1896,383,288,292,26,6,62,409,11,65,38,67,76,105,429,656,5,3719,206,0,0
95,2839,773,419,590,28,0,166,801,10,204,113,217,214,330,1598,2554,5,13587,754,0,0
3,305,149,67,118,4,0,27,153,1,17,14,28,18,42,69,175,0,144,8,0,0
172,7590,4293,999,3693,19,54,507,4312,9,155,88,170,164,258,1156,1898,4,9368,520,0,0
172,7590,1482,859,1002,125,135,219,1607,16,219,134,251,235,385,1766,3032,9,27804,1544,1,0
144,5870,1782,648,1425,9,47,279,1791,8,171,97,189,179,286,1292,2140,4,9462,525,0,0
48,1928,1098,241,925,5,10,155,1103,7,46,25,49,53,74,273,423,3,1580,87,0,0
48,1639,601,196,481,2,23,85,603,8,63,36,72,71,108,400,664,4,3036,168,0,0
95,2843,773,419,590,28,0,166,801,10,204,113,217,214,330,1598,2554,5,13587,754,0,0
3,299,149,67,118,4,0,27,153,1,17,14,28,18,42,69,175,0,144,8,0,0
1,313,382,65,130,157,2,92,539,4,10,5,10,14,15,41,57,2,114,6,0,0
60,1118,282,196,195,3,0,86,285,8,130,71,141,138,212,936,1507,4,6538,363,0,0
7,111,44,19,17,0,16,11,44,3,14,7,14,17,21,58,85,1,128,7,0,0
7,293,72,33,56,0,4,12,72,1,1,1,1,2,2,0,2,0,1,0,0,0
12,226,127,75,83,2,11,30,129,4,14,7,14,18,21,61,87,2,175,9,0,0
12,226,652,304,544,16,6,88,668,6,89,51,101,95,152,591,998,3,3399,188,0,0
12,226,2,2,2,0,0,0,2,0,0,0,0,0,0,0,0,0,0,0,0,0
12,226,8,5,5,0,0,3,8,0,0,0,0,0,0,0,0,0,0,0,0,0
12,226,14,8,8,0,0,6,14,0,0,0,0,0,0,0,0,0,0,0,0,0
12,226,6,4,4,0,0,2,6,0,0,0,0,0,0,0,0,0,0,0,0,0
12,226,6,4,4,0,0,2,6,1,2,1,2,3,3,2,4,0,2,0,0,0
12,226,7,5,5,0,0,2,7,0,0,0,0,0,0,0,0,0,0,0,0,0
12,226,10,6,6,0,0,4,10,0,0,0,0,0,0,0,0,0,0,0,0,0
12,226,1,1,1,0,0,0,1,0,0,0,0,0,0,0,0,0,0,0,0,0
12,226,14,10,10,0,0,4,14,1,1,1,1,2,2,0,2,0,1,0,0,0
12,226,46,26,30,3,0,12,49,3,6,3,6,9,9,20,28,1,42,2,0,0
11,227,19,8,11,5,0,4,24,2,5,3,6,7,9,13,25,1,30,1,0,0
11,227,102,59,69,5,3,24,107,6,22,15,28,28,43,113,206,3,789,43,0,0
11,227,106,40,36,3,49,17,109,8,17,13,23,25,36,93,167,5,904,50,0,0
221,4718,182,127,129,0,0,53,182,5,39,21,42,44,63,217,343,2,926,51,0,0
221,4718,1165,710,800,67,119,181,1232,18,243,153,282,261,435,2000,3492,10,36473,2026,1,0
67,1551,773,419,590,28,0,166,801,10,204,113,217,214,330,1598,2554,5,13587,754,0,0
67,1551,421,273,302,44,34,57,465,17,81,59,107,98,166,583,1098,11,12329,684,0,0
14,404,149,95,105,2,0,41,151,8,54,28,55,62,83,334,494,4,2013,111,0,0
14,404,82,56,54,0,13,15,82,4,13,8,16,17,24,56,98,2,241,13,0,0
25,489,2,2,2,0,0,0,2,0,0,0,0,0,0,0,0,0,0,0,0,0
25,489,99,48,90,1,3,5,100,0,0,0,0,0,0,0,0,0,0,0,0,0
25,489,8,5,5,2,0,1,10,0,0,0,0,0,0,0,0,0,0,0,0,0
25,489,1217,716,841,84,126,174,1301,14,185,118,215,199,333,1446,2542,8,20687,1149,0,0
25,489,160,89,115,0,13,31,160,7,15,11,17,22,28,78,124,3,495,27,0,0
25,489,10,10,9,9,0,0,19,0,0,0,0,0,0,0,0,0,0,0,0,0
25,489,173,84,99,8,29,36,181,5,12,7,13,17,20,54,81,2,221,12,0,0
25,489,3,1,1,3,0,0,6,0,0,0,0,0,0,0,0,0,0,0,0,0
17,327,95,58,50,9,16,20,104,12,33,24,45,45,69,209,378,8,3100,172,0,0
116,2120,477,336,357,30,23,73,507,16,194,134,250,210,384,1538,2962,10,30538,1696,0,0
90,2017,996,429,845,24,10,117,1020,7,76,50,88,83,138,494,879,4,3565,198,0,0
90,2017,456,277,329,12,42,72,468,13,85,50,97,98,147,592,972,7,7212,400,0,0
160,3411,1513,682,1277,25,13,200,1538,11,199,116,219,210,335,1557,2584,6,15641,868,0,0
160,3411,819,519,539,24,98,155,843,15,96,57,106,111,163,690,1107,8,9171,509,0,0
59,1095,207,111,150,11,0,50,218,5,26,19,36,31,55,133,272,3,943,52,0,0
59,1095,410,198,237,31,55,97,441,11,63,38,72,74,110,414,683,6,4293,238,0,0
235,4869,2,2,2,0,0,0,2,0,0,0,0,0,0,0,0,0,0,0,0,0
235,4869,99,48,90,1,3,5,100,0,0,0,0,0,0,0,0,0,0,0,0,0
235,4869,8,5,5,2,0,1,10,0,0,0,0,0,0,0,0,0,0,0,0,0
235,4869,1217,716,841,84,126,174,1301,14,185,118,215,199,333,1446,2542,8,20687,1149,0,0
235,4869,160,89,115,0,13,31,160,7,15,11,17,22,28,78,124,3,495,27,0,0
235,4869,10,10,9,9,0,0,19,0,0,0,0,0,0,0,0,0,0,0,0,0
235,4869,173,84,99,8,29,36,181,5,12,7,13,17,20,54,81,2,221,12,0,0
235,4869,3,1,1,3,0,0,6,0,0,0,0,0,0,0,0,0,0,0,0,0
98,2010,463,295,324,28,62,57,491,12,134,82,154,146,236,989,1696,6,11700,650,0,0
57,1484,339,213,244,17,9,65,356,10,42,26,48,52,74,259,421,5,2410,133,0,0
90,2288,1455,414,1257,16,76,112,1471,5,41,23,46,46,69,231,381,2,1069,59,0,0
90,2288,669,365,481,22,61,110,691,15,103,63,122,118,185,747,1273,8,11311,628,0,0
31,1078,74,35,59,1,0,14,75,3,14,7,14,17,21,58,85,1,128,7,0,0
31,1078,245,125,200,5,7,34,250,7,30,17,34,37,51,166,265,3,1053,58,0,0
117,3127,1523,757,1297,19,12,193,1542,12,193,117,230,205,347,1508,2664,7,19053,1058,0,0
117,3127,701,378,504,33,58,109,734,13,110,68,126,123,194,794,1346,7,10027,557,0,0
146,3571,77,34,69,0,0,8,77,3,24,16,29,27,45,114,213,1,387,21,0,0
146,3571,712,438,573,51,9,84,763,14,102,71,128,116,199,733,1364,8,11988,666,0,0
22,367,102,57,55,5,16,25,107,5,17,10,18,22,28,81,124,2,330,18,0,0
71,1560,402,202,227,24,74,80,426,12,52,33,61,64,94,339,564,7,3969,220,0,0
51,1090,447,308,343,6,5,95,453,7,96,59,111,103,170,651,1136,4,4600,255,0,0
51,1090,322,174,179,16,74,51,338,10,41,26,46,51,72,252,408,5,2291,127,0,0
75,1603,53,23,39,0,0,13,53,2,8,4,8,10,12,26,39,1,39,2,0,0
75,1603,515,298,307,33,80,99,548,12,63,44,77,75,121,419,753,7,5527,307,0,0
18,296,424,94,331,4,0,89,428,1,5,5,5,6,10,11,25,0,12,0,0,0
18,296,38,23,23,6,0,8,44,3,11,7,11,14,18,42,68,1,102,5,0,0
19,499,205,80,86,16,53,53,221,7,18,10,19,25,29,94,134,3,497,27,0,0
15,476,184,100,137,2,15,30,186,6,38,20,39,44,59,214,322,3,991,55,0,0
15,476,103,65,74,8,5,16,111,7,17,9,17,24,26,89,119,3,417,23,0,0
58,1189,91,45,69,0,3,18,91,3,9,6,10,12,16,33,57,1,95,5,0,0
58,1189,367,234,237,17,34,68,384,16,55,34,61,71,95,381,584,8,5183,287,0,0
89,1801,757,253,292,73,244,162,830,13,61,38,67,74,105,409,651,7,4654,258,0,0
67,1747,466,257,367,18,25,50,484,7,126,86,171,133,257,898,1813,4,8612,478,0,0
67,1747,507,281,342,29,59,88,536,10,53,29,57,63,86,336,514,5,2764,153,0,0
25,538,215,129,180,6,0,29,221,8,65,43,72,73,115,415,711,4,3153,175,0,0
25,538,97,69,77,3,3,16,100,6,22,13,23,28,36,113,173,3,542,30,0,0
280,5869,1943,715,1694,26,18,214,1969,12,185,120,237,197,357,1436,2721,7,20915,1161,0,0
280,5869,1168,838,957,57,25,144,1225,19,348,224,416,367,640,3018,5452,11,61921,3440,1,0
19,699,442,244,305,14,16,103,456,11,68,45,75,79,120,452,756,6,4588,254,0,0
19,699,182,102,99,11,40,35,193,3,11,6,11,14,17,42,64,1,97,5,0,0
2,153,37,13,25,0,6,6,37,1,2,1,2,3,3,2,4,0,2,0,0,0
2,153,133,47,40,1,43,49,134,0,0,0,0,0,0,0,0,0,0,0,0,0
104,4398,1289,550,1043,56,32,155,1345,10,167,93,185,177,278,1266,2075,5,11498,638,0,0
31,963,182,127,129,0,0,53,182,5,39,21,42,44,63,217,343,2,926,51,0,0
151,7198,1392,870,1177,35,17,170,1427,14,494,280,531,508,811,4473,7289,7,54850,3047,2,0
1,52,14,12,10,0,0,4,14,1,2,1,2,3,3,2,4,0,2,0,0,0
1,71,19,18,14,0,0,5,19,1,2,1,2,3,3,2,4,0,2,0,0,0
3,44,15,10,10,0,0,5,15,2,4,2,4,6,6,10,15,1,15,0,0,0
2,33,10,7,7,0,0,3,10,1,2,1,2,3,3,2,4,0,2,0,0,0
3,43,15,9,9,0,0,6,15,1,4,2,4,5,6,8,13,0,6,0,0,0
12,313,149,95,105,2,0,41,151,8,54,28,55,62,83,334,494,4,2013,111,0,0
15,699,139,89,101,2,0,35,141,7,54,34,62,61,96,330,569,4,2287,127,0,0
65,4371,520,294,400,33,13,81,553,10,261,204,367,271,571,2128,4614,7,32445,1802,1,0
90,3959,1338,495,1086,10,64,173,1348,11,122,82,157,133,239,883,1686,7,11934,663,0,0
33,984,465,148,393,5,8,60,470,4,31,20,31,35,51,161,261,2,523,29,0,0
33,984,16,12,9,0,0,6,16,1,2,1,2,3,3,2,4,0,2,0,0,0
32,968,256,139,192,9,7,47,265,4,23,12,24,27,36,112,171,2,357,19,0,0
19,499,102,59,69,5,3,24,107,6,22,15,28,28,43,113,206,3,789,43,0,0
119,4854,1450,624,1228,12,26,181,1462,14,306,186,354,320,540,2580,4493,8,36391,2021,1,0
176,5109,1660,832,1314,41,38,274,1701,20,312,209,395,332,604,2671,5058,12,64042,3557,1,0
49,3780,996,429,845,24,10,117,1020,7,76,50,88,83,138,494,879,4,3565,198,0,0
120,5083,1513,682,1277,25,13,200,1538,11,199,116,219,210,335,1557,2584,6,15641,868,0,0
84,4871,1296,573,1062,40,33,157,1336,8,201,118,231,209,349,1561,2689,4,12365,686,0,0
20,449,207,111,150,11,0,50,218,5,26,19,36,31,55,133,272,3,943,52,0,0
98,5169,1457,730,1242,11,6,188,1468,10,292,166,329,302,495,2424,4078,5,22973,1276,1,0
43,2669,652,304,544,16,6,88,668,6,89,51,101,95,152,591,998,3,3399,188,0,0
72,3231,1455,414,1257,16,76,112,1471,5,41,23,46,46,69,231,381,2,1069,59,0,0
107,5128,1523,757,1297,19,12,193,1542,12,193,117,230,205,347,1508,2664,7,19053,1058,0,0
70,3177,1020,354,843,12,15,144,1032,8,134,77,144,142,221,970,1580,4,6792,377,0,0
44,2024,447,308,343,6,5,95,453,7,96,59,111,103,170,651,1136,4,4600,255,0,0
21,637,424,94,331,4,0,89,428,1,5,5,5,6,10,11,25,0,12,0,0,0
38,2309,334,251,279,10,4,40,344,5,127,74,143,132,217,899,1528,2,4303,239,0,0
9,423,184,100,137,2,15,30,186,6,38,20,39,44,59,214,322,3,991,55,0,0
75,3937,1293,570,1093,25,15,163,1318,10,195,123,241,205,364,1516,2795,6,17273,959,0,0
56,2846,722,423,573,19,0,135,741,12,172,101,199,184,300,1320,2257,6,15668,870,0,0
45,1932,386,256,301,16,9,68,402,4,59,35,69,63,104,355,621,2,1453,80,0,0
28,1590,466,257,367,18,25,50,484,7,126,86,171,133,257,898,1813,4,8612,478,0,0
15,1051,215,129,180,6,0,29,221,8,65,43,72,73,115,415,711,4,3153,175,0,0
85,3359,1043,504,840,53,9,147,1096,9,180,112,198,189,310,1377,2344,4,11604,644,0,0
30,1422,373,158,315,8,0,51,381,5,76,44,79,81,123,486,779,2,2026,112,0,0
79,3071,1178,367,1042,6,15,115,1184,9,94,51,95,103,146,644,976,4,4439,246,0,0
111,6048,1943,715,1694,26,18,214,1969,12,185,120,237,197,357,1436,2721,7,20915,1161,0,0
35,1473,442,244,305,14,16,103,456,11,68,45,75,79,120,452,756,6,4588,254,0,0
172,5239,1660,832,1314,41,38,274,1701,20,312,209,395,332,604,2671,5058,12,64042,3557,1,0
172,5239,1057,646,719,113,100,145,1170,18,215,134,248,233,382,1740,3004,10,31186,1732,1,0
174,5041,1660,832,1314,41,38,274,1701,20,312,209,395,332,604,2671,5058,12,64042,3557,1,0
168,5062,1660,832,1314,41,38,274,1701,20,312,209,395,332,604,2671,5058,12,64042,3557,1,0
168,5062,1057,646,719,113,100,145,1170,18,215,134,248,233,382,1740,3004,10,31186,1732,1,0
168,4910,1660,832,1314,41,38,274,1701,20,312,209,395,332,604,2671,5058,12,64042,3557,1,0
236,4872,2,2,2,0,0,0,2,0,0,0,0,0,0,0,0,0,0,0,0,0
236,4872,99,48,90,1,3,5,100,0,0,0,0,0,0,0,0,0,0,0,0,0
236,4872,8,5,5,2,0,1,10,0,0,0,0,0,0,0,0,0,0,0,0,0
236,4872,1217,716,841,84,126,174,1301,14,185,118,215,199,333,1446,2542,8,20687,1149,0,0
236,4872,160,89,115,0,13,31,160,7,15,11,17,22,28,78,124,3,495,27,0,0
236,4872,10,10,9,9,0,0,19,0,0,0,0,0,0,0,0,0,0,0,0,0
236,4872,173,84,99,8,29,36,181,5,12,7,13,17,20,54,81,2,221,12,0,0
236,4872,3,1,1,3,0,0,6,0,0,0,0,0,0,0,0,0,0,0,0,0
101,5251,1457,730,1242,11,6,188,1468,10,292,166,329,302,495,2424,4078,5,22973,1276,1,0
65,1270,1098,241,925,5,10,155,1103,7,46,25,49,53,74,273,423,3,1580,87,0,0
65,1270,282,202,222,14,2,44,296,8,42,24,43,50,67,250,378,4,1548,86,0,0
49,1964,1098,241,925,5,10,155,1103,7,46,25,49,53,74,273,423,3,1580,87,0,0
18,476,205,80,86,16,53,53,221,7,18,10,19,25,29,94,134,3,497,27,0,0
226,5756,722,423,573,19,0,135,741,12,172,101,199,184,300,1320,2257,6,15668,870,0,0
226,5756,1508,847,911,44,250,301,1552,14,148,88,169,162,257,1120,1886,7,15077,837,0,0
163,4979,1660,832,1314,41,38,274,1701,20,312,209,395,332,604,2671,5058,12,64042,3557,1,1
163,4979,1057,646,719,113,100,145,1170,18,215,134,248,233,382,1740,3004,10,31186,1732,1,1
114,2084,477,336,357,30,23,73,507,16,194,134,250,210,384,1538,2962,10,30538,1696,0,1
57,1176,91,45,69,0,3,18,91,3,9,6,10,12,16,33,57,1,95,5,0,1
57,1176,367,234,237,17,34,68,384,16,55,34,61,71,95,381,584,8,5183,287,0,1
95,2843,773,419,590,28,0,166,801,10,204,113,217,214,330,1598,2554,5,13587,754,0,1
56,2845,722,423,573,19,0,135,741,12,172,101,199,184,300,1320,2257,6,15668,870,0,1
85,3340,1043,504,840,53,9,147,1096,9,180,112,198,189,310,1377,2344,4,11604,644,0,1
163,4979,1660,832,1314,41,38,274,1701,20,312,209,395,332,604,2671,5058,12,64042,3557,1,0
163,4979,1057,646,719,113,100,145,1170,18,215,134,248,233,382,1740,3004,10,31186,1732,1,0
114,2084,477,336,357,30,23,73,507,16,194,134,250,210,384,1538,2962,10,30538,1696,0,0
57,1176,91,45,69,0,3,18,91,3,9,6,10,12,16,33,57,1,95,5,0,0
57,1176,367,234,237,17,34,68,384,16,55,34,61,71,95,381,584,8,5183,287,0,0
56,2845,722,423,573,19,0,135,741,12,172,101,199,184,300,1320,2257,6,15668,870,0,0
85,3340,1043,504,840,53,9,147,1096,9,180,112,198,189,310,1377,2344,4,11604,644,0,0
8,210,127,75,83,2,11,30,129,4,14,7,14,18,21,61,87,2,175,9,0,0
8,210,652,304,544,16,6,88,668,6,89,51,101,95,152,591,998,3,3399,188,0,0
8,210,2,2,2,0,0,0,2,0,0,0,0,0,0,0,0,0,0,0,0,0
8,210,8,5,5,0,0,3,8,0,0,0,0,0,0,0,0,0,0,0,0,0
8,210,14,8,8,0,0,6,14,0,0,0,0,0,0,0,0,0,0,0,0,0
8,210,6,4,4,0,0,2,6,0,0,0,0,0,0,0,0,0,0,0,0,0
8,210,6,4,4,0,0,2,6,1,2,1,2,3,3,2,4,0,2,0,0,0
8,210,7,5,5,0,0,2,7,0,0,0,0,0,0,0,0,0,0,0,0,0
8,210,10,6,6,0,0,4,10,0,0,0,0,0,0,0,0,0,0,0,0,0
8,210,1,1,1,0,0,0,1,0,0,0,0,0,0,0,0,0,0,0,0,0
8,210,14,10,10,0,0,4,14,1,1,1,1,2,2,0,2,0,1,0,0,0
8,210,46,26,30,3,0,12,49,3,6,3,6,9,9,20,28,1,42,2,0,0
172,7582,4293,999,3693,19,54,507,4312,9,155,88,170,164,258,1156,1898,4,9368,520,0,1
172,7582,1482,859,1002,125,135,219,1607,16,219,134,251,235,385,1766,3032,9,27804,1544,1,1
52,1740,601,196,481,2,23,85,603,8,63,36,72,71,108,400,664,4,3036,168,0,1
105,2754,773,422,505,30,103,129,803,14,77,46,83,91,129,535,839,7,6334,351,0,0
42,2613,1157,318,931,29,22,177,1186,6,104,63,125,110,188,712,1274,3,4596,255,0,0
172,7582,4293,999,3693,19,54,507,4312,9,155,88,170,164,258,1156,1898,4,9368,520,0,0
172,7582,1482,859,1002,125,135,219,1607,16,219,134,251,235,385,1766,3032,9,27804,1544,1,0
52,1740,601,196,481,2,23,85,603,8,63,36,72,71,108,400,664,4,3036,168,0,0
219,4666,182,127,129,0,0,53,182,5,39,21,42,44,63,217,343,2,926,51,0,0
219,4666,1165,710,800,67,119,181,1232,18,243,153,282,261,435,2000,3492,10,36473,2026,1,0
150,7150,1392,870,1177,35,17,170,1427,14,494,280,531,508,811,4473,7289,7,54850,3047,2,0
114,2073,477,336,357,30,23,73,507,16,194,134,250,210,384,1538,2962,10,30538,1696,0,0
18,474,205,80,86,16,53,53,221,7,18,10,19,25,29,94,134,3,497,27,0,0
12,314,149,95,105,2,0,41,151,8,54,28,55,62,83,334,494,4,2013,111,0,0
32,965,256,139,192,9,7,47,265,4,23,12,24,27,36,112,171,2,357,19,0,0
55,2831,722,423,573,19,0,135,741,12,172,101,199,184,300,1320,2257,6,15668,870,0,0
35,1463,442,244,305,14,16,103,456,11,68,45,75,79,120,452,756,6,4588,254,0,0
92,2323,1455,414,1257,16,76,112,1471,5,41,23,46,46,69,231,381,2,1069,59,0,0
92,2323,669,365,481,22,61,110,691,15,103,63,122,118,185,747,1273,8,11311,628,0,0
74,3363,1455,414,1257,16,76,112,1471,5,41,23,46,46,69,231,381,2,1069,59,0,0
29,461,219,78,157,11,5,46,230,3,24,20,34,27,54,114,256,2,545,30,0,0
29,461,108,64,79,9,0,20,117,5,15,11,19,20,30,70,129,3,410,22,0,0
11,488,219,78,157,11,5,46,230,3,24,20,34,27,54,114,256,2,545,30,0,0
26,435,219,78,157,11,5,46,230,3,24,20,34,27,54,114,256,2,545,30,0,0
26,435,108,64,79,9,0,20,117,5,15,11,19,20,30,70,129,3,410,22,0,0
10,475,219,78,157,11,5,46,230,3,24,20,34,27,54,114,256,2,545,30,0,0
235,4840,2,2,2,0,0,0,2,0,0,0,0,0,0,0,0,0,0,0,0,0
235,4840,99,48,90,1,3,5,100,0,0,0,0,0,0,0,0,0,0,0,0,0
235,4840,8,5,5,2,0,1,10,0,0,0,0,0,0,0,0,0,0,0,0,0
235,4840,1217,716,841,84,126,174,1301,14,185,118,215,199,333,1446,2542,8,20687,1149,0,0
235,4840,160,89,115,0,13,31,160,7,15,11,17,22,28,78,124,3,495,27,0,0
235,4840,10,10,9,9,0,0,19,0,0,0,0,0,0,0,0,0,0,0,0,0
235,4840,173,84,99,8,29,36,181,5,12,7,13,17,20,54,81,2,221,12,0,0
235,4840,3,1,1,3,0,0,6,0,0,0,0,0,0,0,0,0,0,0,0,0
235,4842,2,2,2,0,0,0,2,0,0,0,0,0,0,0,0,0,0,0,0,0
235,4842,99,48,90,1,3,5,100,0,0,0,0,0,0,0,0,0,0,0,0,0
235,4842,8,5,5,2,0,1,10,0,0,0,0,0,0,0,0,0,0,0,0,0
235,4842,1217,716,841,84,126,174,1301,14,185,118,215,199,333,1446,2542,8,20687,1149,0,0
235,4842,160,89,115,0,13,31,160,7,15,11,17,22,28,78,124,3,495,27,0,0
235,4842,10,10,9,9,0,0,19,0,0,0,0,0,0,0,0,0,0,0,0,0
235,4842,173,84,99,8,29,36,181,5,12,7,13,17,20,54,81,2,221,12,0,0
235,4842,3,1,1,3,0,0,6,0,0,0,0,0,0,0,0,0,0,0,0,0
146,3595,77,34,69,0,0,8,77,3,24,16,29,27,45,114,213,1,387,21,0,0
146,3595,712,438,573,51,9,84,763,14,102,71,128,116,199,733,1364,8,11988,666,0,0
280,5857,1943,715,1694,26,18,214,1969,12,185,120,237,197,357,1436,2721,7,20915,1161,0,0
280,5857,1168,838,957,57,25,144,1225,19,348,224,416,367,640,3018,5452,11,61921,3440,1,0
104,4414,1289,550,1043,56,32,155,1345,10,167,93,185,177,278,1266,2075,5,11498,638,0,0
90,3963,1338,495,1086,10,64,173,1348,11,122,82,157,133,239,883,1686,7,11934,663,0,0
168,4914,1660,832,1314,41,38,274,1701,20,312,209,395,332,604,2671,5058,12,64042,3557,1,0
49,3782,996,429,845,24,10,117,1020,7,76,50,88,83,138,494,879,4,3565,198,0,0
120,5085,1513,682,1277,25,13,200,1538,11,199,116,219,210,335,1557,2584,6,15641,868,0,0
84,4875,1296,573,1062,40,33,157,1336,8,201,118,231,209,349,1561,2689,4,12365,686,0,0
101,5249,1457,730,1242,11,6,188,1468,10,292,166,329,302,495,2424,4078,5,22973,1276,1,0
8,269,74,35,59,1,0,14,75,3,14,7,14,17,21,58,85,1,128,7,0,0
70,3179,1020,354,843,12,15,144,1032,8,134,77,144,142,221,970,1580,4,6792,377,0,0
29,1875,384,251,317,7,8,52,391,11,70,44,84,81,128,467,811,6,5355,297,0,0
55,2829,722,423,573,19,0,135,741,12,172,101,199,184,300,1320,2257,6,15668,870,0,0
85,3346,1043,504,840,53,9,147,1096,9,180,112,198,189,310,1377,2344,4,11604,644,0,0
30,1424,373,158,315,8,0,51,381,5,76,44,79,81,123,486,779,2,2026,112,0,0
111,6050,1943,715,1694,26,18,214,1969,12,185,120,237,197,357,1436,2721,7,20915,1161,0,0
49,1968,1098,241,925,5,10,155,1103,7,46,25,49,53,74,273,423,3,1580,87,0,0
58,1091,207,111,150,11,0,50,218,5,26,19,36,31,55,133,272,3,943,52,0,0
58,1091,410,198,237,31,55,97,441,11,63,38,72,74,110,414,683,6,4293,238,0,0
251,5809,4293,999,3693,19,54,507,4312,9,155,88,170,164,258,1156,1898,4,9368,520,0,0
251,5809,1482,859,1002,125,135,219,1607,16,219,134,251,235,385,1766,3032,9,27804,1544,1,0
314,6868,72,33,56,0,4,12,72,1,1,1,1,2,2,0,2,0,1,0,0,0
314,6868,1454,835,1044,76,110,219,1530,17,275,158,296,292,454,2297,3718,9,34017,1889,1,0
89,1799,757,253,292,73,244,162,830,13,61,38,67,74,105,409,651,7,4654,258,0,0
314,6853,72,33,56,0,4,12,72,1,1,1,1,2,2,0,2,0,1,0,0,0
314,6853,1454,835,1044,76,110,219,1530,17,275,158,296,292,454,2297,3718,9,34017,1889,1,0
88,1782,757,253,292,73,244,162,830,13,61,38,67,74,105,409,651,7,4654,258,0,0
111,2037,477,336,357,30,23,73,507,16,194,134,250,210,384,1538,2962,10,30538,1696,0,0
2,183,37,13,25,0,6,6,37,1,2,1,2,3,3,2,4,0,2,0,0,0
2,183,133,47,40,1,43,49,134,0,0,0,0,0,0,0,0,0,0,0,0,0
2,103,37,13,25,0,6,6,37,1,2,1,2,3,3,2,4,0,2,0,0,0
146,3596,77,34,69,0,0,8,77,3,24,16,29,27,45,114,213,1,387,21,0,0
146,3596,712,438,573,51,9,84,763,14,102,71,128,116,199,733,1364,8,11988,666,0,0
236,4874,2,2,2,0,0,0,2,0,0,0,0,0,0,0,0,0,0,0,0,1
236,4874,99,48,90,1,3,5,100,0,0,0,0,0,0,0,0,0,0,0,0,1
236,4874,8,5,5,2,0,1,10,0,0,0,0,0,0,0,0,0,0,0,0,1
236,4874,1217,716,841,84,126,174,1301,14,185,118,215,199,333,1446,2542,8,20687,1149,0,1
236,4874,160,89,115,0,13,31,160,7,15,11,17,22,28,78,124,3,495,27,0,1
236,4874,10,10,9,9,0,0,19,0,0,0,0,0,0,0,0,0,0,0,0,1
236,4874,173,84,99,8,29,36,181,5,12,7,13,17,20,54,81,2,221,12,0,1
236,4874,3,1,1,3,0,0,6,0,0,0,0,0,0,0,0,0,0,0,0,1
15,340,103,47,73,2,12,15,105,5,16,9,17,21,26,75,114,2,303,16,0,1
15,340,86,50,52,8,5,21,94,3,5,3,6,8,9,16,27,1,48,2,0,1
14,833,75,38,59,1,3,12,76,2,4,2,4,6,6,10,15,1,15,0,0,1
8,304,103,47,73,2,12,15,105,5,16,9,17,21,26,75,114,2,303,16,0,1
13,278,103,47,73,2,12,15,105,5,16,9,17,21,26,75,114,2,303,16,0,0
13,278,86,50,52,8,5,21,94,3,5,3,6,8,9,16,27,1,48,2,0,0
8,310,103,47,73,2,12,15,105,5,16,9,17,21,26,75,114,2,303,16,0,0
280,5856,1943,715,1694,26,18,214,1969,12,185,120,237,197,357,1436,2721,7,20915,1161,0,0
280,5856,1168,838,957,57,25,144,1225,19,348,224,416,367,640,3018,5452,11,61921,3440,1,0
170,5244,1660,832,1314,41,38,274,1701,20,312,209,395,332,604,2671,5058,12,64042,3557,1,1
170,5244,1057,646,719,113,100,145,1170,18,215,134,248,233,382,1740,3004,10,31186,1732,1,1
111,2040,477,336,357,30,23,73,507,16,194,134,250,210,384,1538,2962,10,30538,1696,0,1
55,670,647,139,84,35,284,233,682,0,0,0,0,0,0,0,0,0,0,0,0,1
103,4384,1289,550,1043,56,32,155,1345,10,167,93,185,177,278,1266,2075,5,11498,638,0,1
171,5019,1660,832,1314,41,38,274,1701,20,312,209,395,332,604,2671,5058,12,64042,3557,1,1
170,5218,1660,832,1314,41,38,274,1701,20,312,209,395,332,604,2671,5058,12,64042,3557,1,0
170,5218,1057,646,719,113,100,145,1170,18,215,134,248,233,382,1740,3004,10,31186,1732,1,0
148,4602,1660,832,1314,41,38,274,1701,20,312,209,395,332,604,2671,5058,12,64042,3557,1,1
148,4602,1057,646,719,113,100,145,1170,18,215,134,248,233,382,1740,3004,10,31186,1732,1,1
146,3588,77,34,69,0,0,8,77,3,24,16,29,27,45,114,213,1,387,21,0,1
146,3588,712,438,573,51,9,84,763,14,102,71,128,116,199,733,1364,8,11988,666,0,1
59,1205,91,45,69,0,3,18,91,3,9,6,10,12,16,33,57,1,95,5,0,1
59,1205,367,234,237,17,34,68,384,16,55,34,61,71,95,381,584,8,5183,287,0,1
225,5725,722,423,573,19,0,135,741,12,172,101,199,184,300,1320,2257,6,15668,870,0,1
225,5725,1508,847,911,44,250,301,1552,14,148,88,169,162,257,1120,1886,7,15077,837,0,1
105,4490,1289,550,1043,56,32,155,1345,10,167,93,185,177,278,1266,2075,5,11498,638,0,1
168,5033,1660,832,1314,41,38,274,1701,20,312,209,395,332,604,2671,5058,12,64042,3557,1,1
9,413,91,45,69,0,3,18,91,3,9,6,10,12,16,33,57,1,95,5,0,1
148,4602,1660,832,1314,41,38,274,1701,20,312,209,395,332,604,2671,5058,12,64042,3557,1,0
148,4602,1057,646,719,113,100,145,1170,18,215,134,248,233,382,1740,3004,10,31186,1732,1,0
146,3588,77,34,69,0,0,8,77,3,24,16,29,27,45,114,213,1,387,21,0,0
146,3588,712,438,573,51,9,84,763,14,102,71,128,116,199,733,1364,8,11988,666,0,0
59,1205,91,45,69,0,3,18,91,3,9,6,10,12,16,33,57,1,95,5,0,0
59,1205,367,234,237,17,34,68,384,16,55,34,61,71,95,381,584,8,5183,287,0,0
225,5725,722,423,573,19,0,135,741,12,172,101,199,184,300,1320,2257,6,15668,870,0,0
225,5725,1508,847,911,44,250,301,1552,14,148,88,169,162,257,1120,1886,7,15077,837,0,0
105,4490,1289,550,1043,56,32,155,1345,10,167,93,185,177,278,1266,2075,5,11498,638,0,0
168,5033,1660,832,1314,41,38,274,1701,20,312,209,395,332,604,2671,5058,12,64042,3557,1,0
9,413,91,45,69,0,3,18,91,3,9,6,10,12,16,33,57,1,95,5,0,0
17,467,205,80,86,16,53,53,221,7,18,10,19,25,29,94,134,3,497,27,0,0
235,4844,2,2,2,0,0,0,2,0,0,0,0,0,0,0,0,0,0,0,0,0
235,4844,99,48,90,1,3,5,100,0,0,0,0,0,0,0,0,0,0,0,0,0
235,4844,8,5,5,2,0,1,10,0,0,0,0,0,0,0,0,0,0,0,0,0
235,4844,1217,716,841,84,126,174,1301,14,185,118,215,199,333,1446,2542,8,20687,1149,0,0
235,4844,160,89,115,0,13,31,160,7,15,11,17,22,28,78,124,3,495,27,0,0
235,4844,10,10,9,9,0,0,19,0,0,0,0,0,0,0,0,0,0,0,0,0
235,4844,173,84,99,8,29,36,181,5,12,7,13,17,20,54,81,2,221,12,0,0
235,4844,3,1,1,3,0,0,6,0,0,0,0,0,0,0,0,0,0,0,0,0
148,4610,1660,832,1314,41,38,274,1701,20,312,209,395,332,604,2671,5058,12,64042,3557,1,0
148,4610,1057,646,719,113,100,145,1170,18,215,134,248,233,382,1740,3004,10,31186,1732,1,0
169,5104,1660,832,1314,41,38,274,1701,20,312,209,395,332,604,2671,5058,12,64042,3557,1,0
71,1562,402,202,227,24,74,80,426,12,52,33,61,64,94,339,564,7,3969,220,0,0
145,5899,1782,648,1425,9,47,279,1791,8,171,97,189,179,286,1292,2140,4,9462,525,0,0
17,382,85,59,61,8,0,16,93,5,18,10,18,23,28,86,126,2,316,17,0,1
12,518,124,78,88,2,3,26,126,4,13,7,13,17,20,56,81,2,163,9,0,1
113,2243,463,295,324,28,62,57,491,12,134,82,154,146,236,989,1696,6,11700,650,0,1
4,166,27,21,21,0,0,6,27,3,6,3,6,9,9,20,28,1,42,2,0,1
55,670,647,139,84,35,284,233,682,0,0,0,0,0,0,0,0,0,0,0,0,0
169,5193,1660,832,1314,41,38,274,1701,20,312,209,395,332,604,2671,5058,12,64042,3557,1,0
169,5193,1057,646,719,113,100,145,1170,18,215,134,248,233,382,1740,3004,10,31186,1732,1,0
171,5019,1660,832,1314,41,38,274,1701,20,312,209,395,332,604,2671,5058,12,64042,3557,1,0
17,382,85,59,61,8,0,16,93,5,18,10,18,23,28,86,126,2,316,17,0,0
12,518,124,78,88,2,3,26,126,4,13,7,13,17,20,56,81,2,163,9,0,0
113,2243,463,295,324,28,62,57,491,12,134,82,154,146,236,989,1696,6,11700,650,0,0
4,166,27,21,21,0,0,6,27,3,6,3,6,9,9,20,28,1,42,2,0,0
149,4616,1660,832,1314,41,38,274,1701,20,312,209,395,332,604,2671,5058,12,64042,3557,1,0
149,4616,1057,646,719,113,100,145,1170,18,215,134,248,233,382,1740,3004,10,31186,1732,1,0
27,566,2,2,2,0,0,0,2,0,0,0,0,0,0,0,0,0,0,0,0,1
27,566,99,48,90,1,3,5,100,0,0,0,0,0,0,0,0,0,0,0,0,1
27,566,8,5,5,2,0,1,10,0,0,0,0,0,0,0,0,0,0,0,0,1
27,566,1217,716,841,84,126,174,1301,14,185,118,215,199,333,1446,2542,8,20687,1149,0,1
27,566,160,89,115,0,13,31,160,7,15,11,17,22,28,78,124,3,495,27,0,1
27,566,10,10,9,9,0,0,19,0,0,0,0,0,0,0,0,0,0,0,0,1
27,566,173,84,99,8,29,36,181,5,12,7,13,17,20,54,81,2,221,12,0,1
27,566,3,1,1,3,0,0,6,0,0,0,0,0,0,0,0,0,0,0,0,1
173,5396,1660,832,1314,41,38,274,1701,20,312,209,395,332,604,2671,5058,12,64042,3557,1,1
173,5396,1057,646,719,113,100,145,1170,18,215,134,248,233,382,1740,3004,10,31186,1732,1,1
235,4848,2,2,2,0,0,0,2,0,0,0,0,0,0,0,0,0,0,0,0,1
235,4848,99,48,90,1,3,5,100,0,0,0,0,0,0,0,0,0,0,0,0,1
235,4848,8,5,5,2,0,1,10,0,0,0,0,0,0,0,0,0,0,0,0,1
235,4848,1217,716,841,84,126,174,1301,14,185,118,215,199,333,1446,2542,8,20687,1149,0,1
235,4848,160,89,115,0,13,31,160,7,15,11,17,22,28,78,124,3,495,27,0,1
235,4848,10,10,9,9,0,0,19,0,0,0,0,0,0,0,0,0,0,0,0,1
235,4848,173,84,99,8,29,36,181,5,12,7,13,17,20,54,81,2,221,12,0,1
235,4848,3,1,1,3,0,0,6,0,0,0,0,0,0,0,0,0,0,0,0,1
173,5082,1660,832,1314,41,38,274,1701,20,312,209,395,332,604,2671,5058,12,64042,3557,1,1
58,1109,207,111,150,11,0,50,218,5,26,19,36,31,55,133,272,3,943,52,0,0
58,1109,410,198,237,31,55,97,441,11,63,38,72,74,110,414,683,6,4293,238,0,0
112,2047,477,336,357,30,23,73,507,16,194,134,250,210,384,1538,2962,10,30538,1696,0,0
121,4896,1450,624,1228,12,26,181,1462,14,306,186,354,320,540,2580,4493,8,36391,2021,1,0
114,2088,477,336,357,30,23,73,507,16,194,134,250,210,384,1538,2962,10,30538,1696,0,0
121,4918,1450,624,1228,12,26,181,1462,14,306,186,354,320,540,2580,4493,8,36391,2021,1,0
149,4624,1660,832,1314,41,38,274,1701,20,312,209,395,332,604,2671,5058,12,64042,3557,1,0
149,4624,1057,646,719,113,100,145,1170,18,215,134,248,233,382,1740,3004,10,31186,1732,1,0
173,5396,1660,832,1314,41,38,274,1701,20,312,209,395,332,604,2671,5058,12,64042,3557,1,0
173,5396,1057,646,719,113,100,145,1170,18,215,134,248,233,382,1740,3004,10,31186,1732,1,0
27,562,2,2,2,0,0,0,2,0,0,0,0,0,0,0,0,0,0,0,0,0
27,562,99,48,90,1,3,5,100,0,0,0,0,0,0,0,0,0,0,0,0,0
27,562,8,5,5,2,0,1,10,0,0,0,0,0,0,0,0,0,0,0,0,0
27,562,1217,716,841,84,126,174,1301,14,185,118,215,199,333,1446,2542,8,20687,1149,0,0
27,562,160,89,115,0,13,31,160,7,15,11,17,22,28,78,124,3,495,27,0,0
27,562,10,10,9,9,0,0,19,0,0,0,0,0,0,0,0,0,0,0,0,0
27,562,173,84,99,8,29,36,181,5,12,7,13,17,20,54,81,2,221,12,0,0
27,562,3,1,1,3,0,0,6,0,0,0,0,0,0,0,0,0,0,0,0,0
174,5392,1660,832,1314,41,38,274,1701,20,312,209,395,332,604,2671,5058,12,64042,3557,1,0
174,5392,1057,646,719,113,100,145,1170,18,215,134,248,233,382,1740,3004,10,31186,1732,1,0
173,5098,1660,832,1314,41,38,274,1701,20,312,209,395,332,604,2671,5058,12,64042,3557,1,0
174,5414,1660,832,1314,41,38,274,1701,20,312,209,395,332,604,2671,5058,12,64042,3557,1,0
174,5414,1057,646,719,113,100,145,1170,18,215,134,248,233,382,1740,3004,10,31186,1732,1,0
160,5064,1660,832,1314,41,38,274,1701,20,312,209,395,332,604,2671,5058,12,64042,3557,1,0
160,5064,1057,646,719,113,100,145,1170,18,215,134,248,233,382,1740,3004,10,31186,1732,1,0
114,2091,477,336,357,30,23,73,507,16,194,134,250,210,384,1538,2962,10,30538,1696,0,0
174,5288,1660,832,1314,41,38,274,1701,20,312,209,395,332,604,2671,5058,12,64042,3557,1,0
160,5080,1660,832,1314,41,38,274,1701,20,312,209,395,332,604,2671,5058,12,64042,3557,1,0
160,5080,1057,646,719,113,100,145,1170,18,215,134,248,233,382,1740,3004,10,31186,1732,1,0
175,5312,1660,832,1314,41,38,274,1701,20,312,209,395,332,604,2671,5058,12,64042,3557,1,0
160,5086,1660,832,1314,41,38,274,1701,20,312,209,395,332,604,2671,5058,12,64042,3557,1,0
160,5086,1057,646,719,113,100,145,1170,18,215,134,248,233,382,1740,3004,10,31186,1732,1,0
160,5078,1660,832,1314,41,38,274,1701,20,312,209,395,332,604,2671,5058,12,64042,3557,1,0
160,5078,1057,646,719,113,100,145,1170,18,215,134,248,233,382,1740,3004,10,31186,1732,1,0
159,5037,1660,832,1314,41,38,274,1701,20,312,209,395,332,604,2671,5058,12,64042,3557,1,0
159,5037,1057,646,719,113,100,145,1170,18,215,134,248,233,382,1740,3004,10,31186,1732,1,0
146,3590,77,34,69,0,0,8,77,3,24,16,29,27,45,114,213,1,387,21,0,0
146,3590,712,438,573,51,9,84,763,14,102,71,128,116,199,733,1364,8,11988,666,0,0
106,4541,1289,550,1043,56,32,155,1345,10,167,93,185,177,278,1266,2075,5,11498,638,0,0
75,1605,53,23,39,0,0,13,53,2,8,4,8,10,12,26,39,1,39,2,0,0
75,1605,515,298,307,33,80,99,548,12,63,44,77,75,121,419,753,7,5527,307,0,0
102,5281,1457,730,1242,11,6,188,1468,10,292,166,329,302,495,2424,4078,5,22973,1276,1,0
91,2310,1455,414,1257,16,76,112,1471,5,41,23,46,46,69,231,381,2,1069,59,0,0
91,2310,669,365,481,22,61,110,691,15,103,63,122,118,185,747,1273,8,11311,628,0,0
1,92,42,7,35,4,0,5,46,1,2,1,2,3,3,2,4,0,2,0,0,1
1,92,11,6,10,0,0,1,11,2,4,2,4,6,6,10,15,1,15,0,0,1
180,5373,1660,832,1314,41,38,274,1701,20,312,209,395,332,604,2671,5058,12,64042,3557,1,1
180,5373,1057,646,719,113,100,145,1170,18,215,134,248,233,382,1740,3004,10,31186,1732,1,1
179,5679,1660,832,1314,41,38,274,1701,20,312,209,395,332,604,2671,5058,12,64042,3557,1,1
180,5373,1660,832,1314,41,38,274,1701,20,312,209,395,332,604,2671,5058,12,64042,3557,1,0
180,5373,1057,646,719,113,100,145,1170,18,215,134,248,233,382,1740,3004,10,31186,1732,1,0
179,5679,1660,832,1314,41,38,274,1701,20,312,209,395,332,604,2671,5058,12,64042,3557,1,0
60,1136,282,196,195,3,0,86,285,8,130,71,141,138,212,936,1507,4,6538,363,0,0
7,289,72,33,56,0,4,12,72,1,1,1,1,2,2,0,2,0,1,0,0,0
250,5777,4293,999,3693,19,54,507,4312,9,155,88,170,164,258,1156,1898,4,9368,520,0,0
250,5777,1482,859,1002,125,135,219,1607,16,219,134,251,235,385,1766,3032,9,27804,1544,1,0
13,817,75,38,59,1,3,12,76,2,4,2,4,6,6,10,15,1,15,0,0,0
170,7532,4293,999,3693,19,54,507,4312,9,155,88,170,164,258,1156,1898,4,9368,520,0,0
170,7532,1482,859,1002,125,135,219,1607,16,219,134,251,235,385,1766,3032,9,27804,1544,1,0
87,1703,757,253,292,73,244,162,830,13,61,38,67,74,105,409,651,7,4654,258,0,1
38,712,386,256,301,16,9,68,402,4,59,35,69,63,104,355,621,2,1453,80,0,1
38,712,264,131,164,11,41,46,275,6,38,22,40,44,62,214,338,3,1068,59,0,1
30,879,256,139,192,9,7,47,265,4,23,12,24,27,36,112,171,2,357,19,0,1
70,3178,1020,354,843,12,15,144,1032,8,134,77,144,142,221,970,1580,4,6792,377,0,1
45,1930,386,256,301,16,9,68,402,4,59,35,69,63,104,355,621,2,1453,80,0,1
86,1672,757,253,292,73,244,162,830,13,61,38,67,74,105,409,651,7,4654,258,0,0
12,788,75,38,59,1,3,12,76,2,4,2,4,6,6,10,15,1,15,0,0,0
28,820,256,139,192,9,7,47,265,4,23,12,24,27,36,112,171,2,357,19,0,0
70,1518,402,202,227,24,74,80,426,12,52,33,61,64,94,339,564,7,3969,220,0,0
85,1663,757,253,292,73,244,162,830,13,61,38,67,74,105,409,651,7,4654,258,0,0
38,702,386,256,301,16,9,68,402,4,59,35,69,63,104,355,621,2,1453,80,0,0
38,702,264,131,164,11,41,46,275,6,38,22,40,44,62,214,338,3,1068,59,0,0
11,753,75,38,59,1,3,12,76,2,4,2,4,6,6,10,15,1,15,0,0,0
69,3112,1020,354,843,12,15,144,1032,8,134,77,144,142,221,970,1580,4,6792,377,0,0
236,4859,2,2,2,0,0,0,2,0,0,0,0,0,0,0,0,0,0,0,0,0
236,4859,99,48,90,1,3,5,100,0,0,0,0,0,0,0,0,0,0,0,0,0
236,4859,8,5,5,2,0,1,10,0,0,0,0,0,0,0,0,0,0,0,0,0
236,4859,1217,716,841,84,126,174,1301,14,185,118,215,199,333,1446,2542,8,20687,1149,0,0
236,4859,160,89,115,0,13,31,160,7,15,11,17,22,28,78,124,3,495,27,0,0
236,4859,10,10,9,9,0,0,19,0,0,0,0,0,0,0,0,0,0,0,0,0
236,4859,173,84,99,8,29,36,181,5,12,7,13,17,20,54,81,2,221,12,0,0
236,4859,3,1,1,3,0,0,6,0,0,0,0,0,0,0,0,0,0,0,0,0
7,287,75,38,59,1,3,12,76,2,4,2,4,6,6,10,15,1,15,0,0,0
106,5687,1457,730,1242,11,6,188,1468,10,292,166,329,302,495,2424,4078,5,22973,1276,1,0
55,761,167,116,138,4,5,22,171,8,48,30,56,56,86,292,499,4,2330,129,0,0
5,216,75,38,59,1,3,12,76,2,4,2,4,6,6,10,15,1,15,0,0,0
108,5765,1457,730,1242,11,6,188,1468,10,292,166,329,302,495,2424,4078,5,22973,1276,1,0
141,3466,77,34,69,0,0,8,77,3,24,16,29,27,45,114,213,1,387,21,0,0
141,3466,712,438,573,51,9,84,763,14,102,71,128,116,199,733,1364,8,11988,666,0,0
55,2824,722,423,573,19,0,135,741,12,172,101,199,184,300,1320,2257,6,15668,870,0,0
18,638,442,244,305,14,16,103,456,11,68,45,75,79,120,452,756,6,4588,254,0,0
18,638,182,102,99,11,40,35,193,3,11,6,11,14,17,42,64,1,97,5,0,0
34,1434,442,244,305,14,16,103,456,11,68,45,75,79,120,452,756,6,4588,254,0,0
314,6847,72,33,56,0,4,12,72,1,1,1,1,2,2,0,2,0,1,0,0,0
314,6847,1454,835,1044,76,110,219,1530,17,275,158,296,292,454,2297,3718,9,34017,1889,1,0
54,640,647,139,84,35,284,233,682,0,0,0,0,0,0,0,0,0,0,0,0,0
2,173,37,13,25,0,6,6,37,1,2,1,2,3,3,2,4,0,2,0,0,0
2,173,133,47,40,1,43,49,134,0,0,0,0,0,0,0,0,0,0,0,0,0
23,615,601,196,481,2,23,85,603,8,63,36,72,71,108,400,664,4,3036,168,0,0
23,615,156,79,106,5,16,28,161,5,14,8,15,19,23,64,97,2,261,14,0,0
106,4531,1289,550,1043,56,32,155,1345,10,167,93,185,177,278,1266,2075,5,11498,638,0,0
170,7525,4293,999,3693,19,54,507,4312,9,155,88,170,164,258,1156,1898,4,9368,520,0,0
170,7525,1482,859,1002,125,135,219,1607,16,219,134,251,235,385,1766,3032,9,27804,1544,1,0
145,5874,1782,648,1425,9,47,279,1791,8,171,97,189,179,286,1292,2140,4,9462,525,0,0
69,3090,1020,354,843,12,15,144,1032,8,134,77,144,142,221,970,1580,4,6792,377,0,0
34,1424,442,244,305,14,16,103,456,11,68,45,75,79,120,452,756,6,4588,254,0,0
48,1651,601,196,481,2,23,85,603,8,63,36,72,71,108,400,664,4,3036,168,0,0
250,5776,4293,999,3693,19,54,507,4312,9,155,88,170,164,258,1156,1898,4,9368,520,0,0
250,5776,1482,859,1002,125,135,219,1607,16,219,134,251,235,385,1766,3032,9,27804,1544,1,0
59,1116,207,111,150,11,0,50,218,5,26,19,36,31,55,133,272,3,943,52,0,1
59,1116,410,198,237,31,55,97,441,11,63,38,72,74,110,414,683,6,4293,238,0,1
236,4863,2,2,2,0,0,0,2,0,0,0,0,0,0,0,0,0,0,0,0,1
236,4863,99,48,90,1,3,5,100,0,0,0,0,0,0,0,0,0,0,0,0,1
236,4863,8,5,5,2,0,1,10,0,0,0,0,0,0,0,0,0,0,0,0,1
236,4863,1217,716,841,84,126,174,1301,14,185,118,215,199,333,1446,2542,8,20687,1149,0,1
236,4863,160,89,115,0,13,31,160,7,15,11,17,22,28,78,124,3,495,27,0,1
236,4863,10,10,9,9,0,0,19,0,0,0,0,0,0,0,0,0,0,0,0,1
236,4863,173,84,99,8,29,36,181,5,12,7,13,17,20,54,81,2,221,12,0,1
236,4863,3,1,1,3,0,0,6,0,0,0,0,0,0,0,0,0,0,0,0,1
250,5782,4293,999,3693,19,54,507,4312,9,155,88,170,164,258,1156,1898,4,9368,520,0,1
250,5782,1482,859,1002,125,135,219,1607,16,219,134,251,235,385,1766,3032,9,27804,1544,1,1
4,178,75,38,59,1,3,12,76,2,4,2,4,6,6,10,15,1,15,0,0,1
170,7527,4293,999,3693,19,54,507,4312,9,155,88,170,164,258,1156,1898,4,9368,520,0,1
170,7527,1482,859,1002,125,135,219,1607,16,219,134,251,235,385,1766,3032,9,27804,1544,1,1
84,1645,757,253,292,73,244,162,830,13,61,38,67,74,105,409,651,7,4654,258,0,0
37,680,386,256,301,16,9,68,402,4,59,35,69,63,104,355,621,2,1453,80,0,0
37,680,264,131,164,11,41,46,275,6,38,22,40,44,62,214,338,3,1068,59,0,0
219,4669,182,127,129,0,0,53,182,5,39,21,42,44,63,217,343,2,926,51,0,0
219,4669,1165,710,800,67,119,181,1232,18,243,153,282,261,435,2000,3492,10,36473,2026,1,0
33,1013,256,139,192,9,7,47,265,4,23,12,24,27,36,112,171,2,357,19,0,0
58,1130,207,111,150,11,0,50,218,5,26,19,36,31,55,133,272,3,943,52,0,0
58,1130,410,198,237,31,55,97,441,11,63,38,72,74,110,414,683,6,4293,238,0,0
235,4848,2,2,2,0,0,0,2,0,0,0,0,0,0,0,0,0,0,0,0,0
235,4848,99,48,90,1,3,5,100,0,0,0,0,0,0,0,0,0,0,0,0,0
235,4848,8,5,5,2,0,1,10,0,0,0,0,0,0,0,0,0,0,0,0,0
235,4848,1217,716,841,84,126,174,1301,14,185,118,215,199,333,1446,2542,8,20687,1149,0,0
235,4848,160,89,115,0,13,31,160,7,15,11,17,22,28,78,124,3,495,27,0,0
235,4848,10,10,9,9,0,0,19,0,0,0,0,0,0,0,0,0,0,0,0,0
235,4848,173,84,99,8,29,36,181,5,12,7,13,17,20,54,81,2,221,12,0,0
235,4848,3,1,1,3,0,0,6,0,0,0,0,0,0,0,0,0,0,0,0,0
106,4545,1289,550,1043,56,32,155,1345,10,167,93,185,177,278,1266,2075,5,11498,638,0,0
102,5285,1457,730,1242,11,6,188,1468,10,292,166,329,302,495,2424,4078,5,22973,1276,1,0
2,48,7,6,5,0,0,2,7,1,1,1,2,2,3,0,3,1,3,0,0,0
25,429,219,78,157,11,5,46,230,3,24,20,34,27,54,114,256,2,545,30,0,1
25,429,108,64,79,9,0,20,117,5,15,11,19,20,30,70,129,3,410,22,0,1
11,631,219,78,157,11,5,46,230,3,24,20,34,27,54,114,256,2,545,30,0,1
25,429,219,78,157,11,5,46,230,3,24,20,34,27,54,114,256,2,545,30,0,0
25,429,108,64,79,9,0,20,117,5,15,11,19,20,30,70,129,3,410,22,0,0
11,631,219,78,157,11,5,46,230,3,24,20,34,27,54,114,256,2,545,30,0,0
117,3137,1523,757,1297,19,12,193,1542,12,193,117,230,205,347,1508,2664,7,19053,1058,0,0
117,3137,701,378,504,33,58,109,734,13,110,68,126,123,194,794,1346,7,10027,557,0,0
111,5221,1523,757,1297,19,12,193,1542,12,193,117,230,205,347,1508,2664,7,19053,1058,0,0
14,836,75,38,59,1,3,12,76,2,4,2,4,6,6,10,15,1,15,0,0,0
235,4868,2,2,2,0,0,0,2,0,0,0,0,0,0,0,0,0,0,0,0,0
235,4868,99,48,90,1,3,5,100,0,0,0,0,0,0,0,0,0,0,0,0,0
235,4868,8,5,5,2,0,1,10,0,0,0,0,0,0,0,0,0,0,0,0,0
235,4868,1217,716,841,84,126,174,1301,14,185,118,215,199,333,1446,2542,8,20687,1149,0,0
235,4868,160,89,115,0,13,31,160,7,15,11,17,22,28,78,124,3,495,27,0,0
235,4868,10,10,9,9,0,0,19,0,0,0,0,0,0,0,0,0,0,0,0,0
235,4868,173,84,99,8,29,36,181,5,12,7,13,17,20,54,81,2,221,12,0,0
235,4868,3,1,1,3,0,0,6,0,0,0,0,0,0,0,0,0,0,0,0,0
103,5394,1457,730,1242,11,6,188,1468,10,292,166,329,302,495,2424,4078,5,22973,1276,1,0
237,4975,2,2,2,0,0,0,2,0,0,0,0,0,0,0,0,0,0,0,0,0
237,4975,99,48,90,1,3,5,100,0,0,0,0,0,0,0,0,0,0,0,0,0
237,4975,8,5,5,2,0,1,10,0,0,0,0,0,0,0,0,0,0,0,0,0
237,4975,1217,716,841,84,126,174,1301,14,185,118,215,199,333,1446,2542,8,20687,1149,0,0
237,4975,160,89,115,0,13,31,160,7,15,11,17,22,28,78,124,3,495,27,0,0
237,4975,10,10,9,9,0,0,19,0,0,0,0,0,0,0,0,0,0,0,0,0
237,4975,173,84,99,8,29,36,181,5,12,7,13,17,20,54,81,2,221,12,0,0
237,4975,3,1,1,3,0,0,6,0,0,0,0,0,0,0,0,0,0,0,0,0
103,5415,1457,730,1242,11,6,188,1468,10,292,166,329,302,495,2424,4078,5,22973,1276,1,0
103,5418,1457,730,1242,11,6,188,1468,10,292,166,329,302,495,2424,4078,5,22973,1276,1,0
1,302,382,65,130,157,2,92,539,4,10,5,10,14,15,41,57,2,114,6,0,0
101,2578,1455,414,1257,16,76,112,1471,5,41,23,46,46,69,231,381,2,1069,59,0,1
101,2578,669,365,481,22,61,110,691,15,103,63,122,118,185,747,1273,8,11311,628,0,1
81,3701,1455,414,1257,16,76,112,1471,5,41,23,46,46,69,231,381,2,1069,59,0,1
11,231,19,8,11,5,0,4,24,2,5,3,6,7,9,13,25,1,30,1,0,1
11,231,102,59,69,5,3,24,107,6,22,15,28,28,43,113,206,3,789,43,0,1
11,231,106,40,36,3,49,17,109,8,17,13,23,25,36,93,167,5,904,50,0,1
219,4648,182,127,129,0,0,53,182,5,39,21,42,44,63,217,343,2,926,51,0,1
219,4648,1165,710,800,67,119,181,1232,18,243,153,282,261,435,2000,3492,10,36473,2026,1,1
160,3425,1513,682,1277,25,13,200,1538,11,199,116,219,210,335,1557,2584,6,15641,868,0,1
160,3425,819,519,539,24,98,155,843,15,96,57,106,111,163,690,1107,8,9171,509,0,1
251,5824,4293,999,3693,19,54,507,4312,9,155,88,170,164,258,1156,1898,4,9368,520,0,1
251,5824,1482,859,1002,125,135,219,1607,16,219,134,251,235,385,1766,3032,9,27804,1544,1,1
71,1566,402,202,227,24,74,80,426,12,52,33,61,64,94,339,564,7,3969,220,0,1
76,1623,53,23,39,0,0,13,53,2,8,4,8,10,12,26,39,1,39,2,0,1
76,1623,515,298,307,33,80,99,548,12,63,44,77,75,121,419,753,7,5527,307,0,1
17,467,205,80,86,16,53,53,221,7,18,10,19,25,29,94,134,3,497,27,0,1
88,1786,757,253,292,73,244,162,830,13,61,38,67,74,105,409,651,7,4654,258,0,1
67,1751,466,257,367,18,25,50,484,7,126,86,171,133,257,898,1813,4,8612,478,0,1
67,1751,507,281,342,29,59,88,536,10,53,29,57,63,86,336,514,5,2764,153,0,1
150,7150,1392,870,1177,35,17,170,1427,14,494,280,531,508,811,4473,7289,7,54850,3047,2,1
11,231,19,8,11,5,0,4,24,2,5,3,6,7,9,13,25,1,30,1,0,0
11,231,102,59,69,5,3,24,107,6,22,15,28,28,43,113,206,3,789,43,0,0
11,231,106,40,36,3,49,17,109,8,17,13,23,25,36,93,167,5,904,50,0,0
219,4651,182,127,129,0,0,53,182,5,39,21,42,44,63,217,343,2,926,51,0,0
219,4651,1165,710,800,67,119,181,1232,18,243,153,282,261,435,2000,3492,10,36473,2026,1,0
160,3425,1513,682,1277,25,13,200,1538,11,199,116,219,210,335,1557,2584,6,15641,868,0,0
160,3425,819,519,539,24,98,155,843,15,96,57,106,111,163,690,1107,8,9171,509,0,0
251,5824,4293,999,3693,19,54,507,4312,9,155,88,170,164,258,1156,1898,4,9368,520,0,0
251,5824,1482,859,1002,125,135,219,1607,16,219,134,251,235,385,1766,3032,9,27804,1544,1,0
71,1566,402,202,227,24,74,80,426,12,52,33,61,64,94,339,564,7,3969,220,0,0
76,1623,53,23,39,0,0,13,53,2,8,4,8,10,12,26,39,1,39,2,0,0
76,1623,515,298,307,33,80,99,548,12,63,44,77,75,121,419,753,7,5527,307,0,0
88,1786,757,253,292,73,244,162,830,13,61,38,67,74,105,409,651,7,4654,258,0,0
67,1751,466,257,367,18,25,50,484,7,126,86,171,133,257,898,1813,4,8612,478,0,0
67,1751,507,281,342,29,59,88,536,10,53,29,57,63,86,336,514,5,2764,153,0,0
18,486,205,80,86,16,53,53,221,7,18,10,19,25,29,94,134,3,497,27,0,1
87,3393,1043,504,840,53,9,147,1096,9,180,112,198,189,310,1377,2344,4,11604,644,0,1
59,1137,207,111,150,11,0,50,218,5,26,19,36,31,55,133,272,3,943,52,0,0
59,1137,410,198,237,31,55,97,441,11,63,38,72,74,110,414,683,6,4293,238,0,0
236,4867,2,2,2,0,0,0,2,0,0,0,0,0,0,0,0,0,0,0,0,0
236,4867,99,48,90,1,3,5,100,0,0,0,0,0,0,0,0,0,0,0,0,0
236,4867,8,5,5,2,0,1,10,0,0,0,0,0,0,0,0,0,0,0,0,0
236,4867,1217,716,841,84,126,174,1301,14,185,118,215,199,333,1446,2542,8,20687,1149,0,0
236,4867,160,89,115,0,13,31,160,7,15,11,17,22,28,78,124,3,495,27,0,0
236,4867,10,10,9,9,0,0,19,0,0,0,0,0,0,0,0,0,0,0,0,0
236,4867,173,84,99,8,29,36,181,5,12,7,13,17,20,54,81,2,221,12,0,0
236,4867,3,1,1,3,0,0,6,0,0,0,0,0,0,0,0,0,0,0,0,0
250,5797,4293,999,3693,19,54,507,4312,9,155,88,170,164,258,1156,1898,4,9368,520,0,0
250,5797,1482,859,1002,125,135,219,1607,16,219,134,251,235,385,1766,3032,9,27804,1544,1,0
70,1522,402,202,227,24,74,80,426,12,52,33,61,64,94,339,564,7,3969,220,0,0
84,1649,757,253,292,73,244,162,830,13,61,38,67,74,105,409,651,7,4654,258,0,0
106,4535,1289,550,1043,56,32,155,1345,10,167,93,185,177,278,1266,2075,5,11498,638,0,0
4,178,75,38,59,1,3,12,76,2,4,2,4,6,6,10,15,1,15,0,0,0
170,7527,4293,999,3693,19,54,507,4312,9,155,88,170,164,258,1156,1898,4,9368,520,0,0
170,7527,1482,859,1002,125,135,219,1607,16,219,134,251,235,385,1766,3032,9,27804,1544,1,0
29,865,256,139,192,9,7,47,265,4,23,12,24,27,36,112,171,2,357,19,0,0
108,5769,1457,730,1242,11,6,188,1468,10,292,166,329,302,495,2424,4078,5,22973,1276,1,0
45,1930,386,256,301,16,9,68,402,4,59,35,69,63,104,355,621,2,1453,80,0,0
18,486,205,80,86,16,53,53,221,7,18,10,19,25,29,94,134,3,497,27,0,0
87,3393,1043,504,840,53,9,147,1096,9,180,112,198,189,310,1377,2344,4,11604,644,0,0
238,4994,2,2,2,0,0,0,2,0,0,0,0,0,0,0,0,0,0,0,0,0
238,4994,99,48,90,1,3,5,100,0,0,0,0,0,0,0,0,0,0,0,0,0
238,4994,8,5,5,2,0,1,10,0,0,0,0,0,0,0,0,0,0,0,0,0
238,4994,1217,716,841,84,126,174,1301,14,185,118,215,199,333,1446,2542,8,20687,1149,0,0
238,4994,160,89,115,0,13,31,160,7,15,11,17,22,28,78,124,3,495,27,0,0
238,4994,10,10,9,9,0,0,19,0,0,0,0,0,0,0,0,0,0,0,0,0
238,4994,173,84,99,8,29,36,181,5,12,7,13,17,20,54,81,2,221,12,0,0
238,4994,3,1,1,3,0,0,6,0,0,0,0,0,0,0,0,0,0,0,0,0
109,5902,1457,730,1242,11,6,188,1468,10,292,166,329,302,495,2424,4078,5,22973,1276,1,0
84,1646,757,253,292,73,244,162,830,13,61,38,67,74,105,409,651,7,4654,258,0,0
81,3712,1455,414,1257,16,76,112,1471,5,41,23,46,46,69,231,381,2,1069,59,0,0
81,3729,1455,414,1257,16,76,112,1471,5,41,23,46,46,69,231,381,2,1069,59,0,0
101,2578,1455,414,1257,16,76,112,1471,5,41,23,46,46,69,231,381,2,1069,59,0,0
101,2578,669,365,481,22,61,110,691,15,103,63,122,118,185,747,1273,8,11311,628,0,0
90,2013,996,429,845,24,10,117,1020,7,76,50,88,83,138,494,879,4,3565,198,0,0
90,2013,456,277,329,12,42,72,468,13,85,50,97,98,147,592,972,7,7212,400,0,0
64,1298,91,45,69,0,3,18,91,3,9,6,10,12,16,33,57,1,95,5,0,0
64,1298,367,234,237,17,34,68,384,16,55,34,61,71,95,381,584,8,5183,287,0,0
38,1654,442,244,305,14,16,103,456,11,68,45,75,79,120,452,756,6,4588,254,0,0
12,177,424,94,331,4,0,89,428,1,5,5,5,6,10,11,25,0,12,0,0,0
12,177,38,23,23,6,0,8,44,3,11,7,11,14,18,42,68,1,102,5,0,0
90,1912,1043,504,840,53,9,147,1096,9,180,112,198,189,310,1377,2344,4,11604,644,0,0
90,1912,383,288,292,26,6,62,409,11,65,38,67,76,105,429,656,5,3719,206,0,0
68,1337,1098,241,925,5,10,155,1103,7,46,25,49,53,74,273,423,3,1580,87,0,0
68,1337,282,202,222,14,2,44,296,8,42,24,43,50,67,250,378,4,1548,86,0,0
49,1966,1098,241,925,5,10,155,1103,7,46,25,49,53,74,273,423,3,1580,87,0,0
313,6823,72,33,56,0,4,12,72,1,1,1,1,2,2,0,2,0,1,0,0,0
313,6823,1454,835,1044,76,110,219,1530,17,275,158,296,292,454,2297,3718,9,34017,1889,1,0
313,6817,72,33,56,0,4,12,72,1,1,1,1,2,2,0,2,0,1,0,0,0
313,6817,1454,835,1044,76,110,219,1530,17,275,158,296,292,454,2297,3718,9,34017,1889,1,0
312,6802,72,33,56,0,4,12,72,1,1,1,1,2,2,0,2,0,1,0,0,0
312,6802,1454,835,1044,76,110,219,1530,17,275,158,296,292,454,2297,3718,9,34017,1889,1,0
307,6733,72,33,56,0,4,12,72,1,1,1,1,2,2,0,2,0,1,0,0,0
307,6733,1454,835,1044,76,110,219,1530,17,275,158,296,292,454,2297,3718,9,34017,1889,1,0
307,6751,72,33,56,0,4,12,72,1,1,1,1,2,2,0,2,0,1,0,0,0
307,6751,1454,835,1044,76,110,219,1530,17,275,158,296,292,454,2297,3718,9,34017,1889,1,0
147,5933,1782,648,1425,9,47,279,1791,8,171,97,189,179,286,1292,2140,4,9462,525,0,0
305,6729,72,33,56,0,4,12,72,1,1,1,1,2,2,0,2,0,1,0,0,0
305,6729,1454,835,1044,76,110,219,1530,17,275,158,296,292,454,2297,3718,9,34017,1889,1,0
7,140,38,22,22,1,0,15,39,1,2,1,2,3,3,2,4,0,2,0,0,1
7,140,38,22,22,1,0,15,39,1,2,1,2,3,3,2,4,0,2,0,0,0
85,1664,757,253,292,73,244,162,830,13,61,38,67,74,105,409,651,7,4654,258,0,1
38,702,386,256,301,16,9,68,402,4,59,35,69,63,104,355,621,2,1453,80,0,1
38,702,264,131,164,11,41,46,275,6,38,22,40,44,62,214,338,3,1068,59,0,1
30,903,256,139,192,9,7,47,265,4,23,12,24,27,36,112,171,2,357,19,0,1
46,1968,386,256,301,16,9,68,402,4,59,35,69,63,104,355,621,2,1453,80,0,1
11,553,205,80,86,16,53,53,221,7,18,10,19,25,29,94,134,3,497,27,0,0
20,993,386,256,301,16,9,68,402,4,59,35,69,63,104,355,621,2,1453,80,0,1
20,993,264,131,164,11,41,46,275,6,38,22,40,44,62,214,338,3,1068,59,0,1
219,4842,182,127,129,0,0,53,182,5,39,21,42,44,63,217,343,2,926,51,0,1
219,4842,1165,710,800,67,119,181,1232,18,243,153,282,261,435,2000,3492,10,36473,2026,1,1
79,1897,757,253,292,73,244,162,830,13,61,38,67,74,105,409,651,7,4654,258,0,1
214,4866,182,127,129,0,0,53,182,5,39,21,42,44,63,217,343,2,926,51,0,0
214,4866,1165,710,800,67,119,181,1232,18,243,153,282,261,435,2000,3492,10,36473,2026,1,0
79,1947,757,253,292,73,244,162,830,13,61,38,67,74,105,409,651,7,4654,258,0,0
215,4899,182,127,129,0,0,53,182,5,39,21,42,44,63,217,343,2,926,51,0,0
215,4899,1165,710,800,67,119,181,1232,18,243,153,282,261,435,2000,3492,10,36473,2026,1,0
79,1959,757,253,292,73,244,162,830,13,61,38,67,74,105,409,651,7,4654,258,0,0
216,4938,182,127,129,0,0,53,182,5,39,21,42,44,63,217,343,2,926,51,0,0
216,4938,1165,710,800,67,119,181,1232,18,243,153,282,261,435,2000,3492,10,36473,2026,1,0
79,1967,757,253,292,73,244,162,830,13,61,38,67,74,105,409,651,7,4654,258,0,0
152,7195,1392,870,1177,35,17,170,1427,14,494,280,531,508,811,4473,7289,7,54850,3047,2,0
9,261,149,95,105,2,0,41,151,8,54,28,55,62,83,334,494,4,2013,111,0,0
9,261,82,56,54,0,13,15,82,4,13,8,16,17,24,56,98,2,241,13,0,0
10,274,149,95,105,2,0,41,151,8,54,28,55,62,83,334,494,4,2013,111,0,0
10,274,82,56,54,0,13,15,82,4,13,8,16,17,24,56,98,2,241,13,0,0
12,315,149,95,105,2,0,41,151,8,54,28,55,62,83,334,494,4,2013,111,0,0
10,269,149,95,105,2,0,41,151,8,54,28,55,62,83,334,494,4,2013,111,0,0
10,269,82,56,54,0,13,15,82,4,13,8,16,17,24,56,98,2,241,13,0,0
12,280,149,95,105,2,0,41,151,8,54,28,55,62,83,334,494,4,2013,111,0,0
12,280,82,56,54,0,13,15,82,4,13,8,16,17,24,56,98,2,241,13,0,0
14,343,149,95,105,2,0,41,151,8,54,28,55,62,83,334,494,4,2013,111,0,0
33,966,465,148,393,5,8,60,470,4,31,20,31,35,51,161,261,2,523,29,0,0
33,966,16,12,9,0,0,6,16,1,2,1,2,3,3,2,4,0,2,0,0,0
32,954,465,148,393,5,8,60,470,4,31,20,31,35,51,161,261,2,523,29,0,0
32,954,16,12,9,0,0,6,16,1,2,1,2,3,3,2,4,0,2,0,0,0
20,993,386,256,301,16,9,68,402,4,59,35,69,63,104,355,621,2,1453,80,0,0
20,993,264,131,164,11,41,46,275,6,38,22,40,44,62,214,338,3,1068,59,0,0
30,903,256,139,192,9,7,47,265,4,23,12,24,27,36,112,171,2,357,19,0,0
46,1968,386,256,301,16,9,68,402,4,59,35,69,63,104,355,621,2,1453,80,0,0
216,4948,182,127,129,0,0,53,182,5,39,21,42,44,63,217,343,2,926,51,0,0
216,4948,1165,710,800,67,119,181,1232,18,243,153,282,261,435,2000,3492,10,36473,2026,1,0
11,562,205,80,86,16,53,53,221,7,18,10,19,25,29,94,134,3,497,27,0,1
304,6724,72,33,56,0,4,12,72,1,1,1,1,2,2,0,2,0,1,0,0,0
304,6724,1454,835,1044,76,110,219,1530,17,275,158,296,292,454,2297,3718,9,34017,1889,1,0
87,1891,1043,504,840,53,9,147,1096,9,180,112,198,189,310,1377,2344,4,11604,644,0,0
87,1891,383,288,292,26,6,62,409,11,65,38,67,76,105,429,656,5,3719,206,0,0
10,530,205,80,86,16,53,53,221,7,18,10,19,25,29,94,134,3,497,27,0,0
102,2603,1455,414,1257,16,76,112,1471,5,41,23,46,46,69,231,381,2,1069,59,0,1
102,2603,669,365,481,22,61,110,691,15,103,63,122,118,185,747,1273,8,11311,628,0,1
76,4016,1293,570,1093,25,15,163,1318,10,195,123,241,205,364,1516,2795,6,17273,959,0,1
67,1304,1098,241,925,5,10,155,1103,7,46,25,49,53,74,273,423,3,1580,87,0,0
67,1304,282,202,222,14,2,44,296,8,42,24,43,50,67,250,378,4,1548,86,0,0
51,2027,1098,241,925,5,10,155,1103,7,46,25,49,53,74,273,423,3,1580,87,0,0
33,992,465,148,393,5,8,60,470,4,31,20,31,35,51,161,261,2,523,29,0,0
33,992,16,12,9,0,0,6,16,1,2,1,2,3,3,2,4,0,2,0,0,0
56,1107,207,111,150,11,0,50,218,5,26,19,36,31,55,133,272,3,943,52,0,0
56,1107,410,198,237,31,55,97,441,11,63,38,72,74,110,414,683,6,4293,238,0,0
238,4997,2,2,2,0,0,0,2,0,0,0,0,0,0,0,0,0,0,0,0,0
238,4997,99,48,90,1,3,5,100,0,0,0,0,0,0,0,0,0,0,0,0,0
238,4997,8,5,5,2,0,1,10,0,0,0,0,0,0,0,0,0,0,0,0,0
238,4997,1217,716,841,84,126,174,1301,14,185,118,215,199,333,1446,2542,8,20687,1149,0,0
238,4997,160,89,115,0,13,31,160,7,15,11,17,22,28,78,124,3,495,27,0,0
238,4997,10,10,9,9,0,0,19,0,0,0,0,0,0,0,0,0,0,0,0,0
238,4997,173,84,99,8,29,36,181,5,12,7,13,17,20,54,81,2,221,12,0,0
238,4997,3,1,1,3,0,0,6,0,0,0,0,0,0,0,0,0,0,0,0,0
31,1080,74,35,59,1,0,14,75,3,14,7,14,17,21,58,85,1,128,7,0,0
31,1080,245,125,200,5,7,34,250,7,30,17,34,37,51,166,265,3,1053,58,0,0
109,5904,1457,730,1242,11,6,188,1468,10,292,166,329,302,495,2424,4078,5,22973,1276,1,0
51,2030,1098,241,925,5,10,155,1103,7,46,25,49,53,74,273,423,3,1580,87,0,1
51,2030,1098,241,925,5,10,155,1103,7,46,25,49,53,74,273,423,3,1580,87,0,0
56,789,167,116,138,4,5,22,171,8,48,30,56,56,86,292,499,4,2330,129,0,0
103,5325,1457,730,1242,11,6,188,1468,10,292,166,329,302,495,2424,4078,5,22973,1276,1,0
51,2034,1098,241,925,5,10,155,1103,7,46,25,49,53,74,273,423,3,1580,87,0,0
12,645,219,78,157,11,5,46,230,3,24,20,34,27,54,114,256,2,545,30,0,1
12,645,219,78,157,11,5,46,230,3,24,20,34,27,54,114,256,2,545,30,0,0
65,1368,91,45,69,0,3,18,91,3,9,6,10,12,16,33,57,1,95,5,0,0
65,1368,367,234,237,17,34,68,384,16,55,34,61,71,95,381,584,8,5183,287,0,0
40,1809,442,244,305,14,16,103,456,11,68,45,75,79,120,452,756,6,4588,254,0,0
57,1135,207,111,150,11,0,50,218,5,26,19,36,31,55,133,272,3,943,52,0,0
57,1135,410,198,237,31,55,97,441,11,63,38,72,74,110,414,683,6,4293,238,0,0
56,780,167,116,138,4,5,22,171,8,48,30,56,56,86,292,499,4,2330,129,0,0
12,572,205,80,86,16,53,53,221,7,18,10,19,25,29,94,134,3,497,27,0,0
70,1371,1098,241,925,5,10,155,1103,7,46,25,49,53,74,273,423,3,1580,87,0,0
70,1371,282,202,222,14,2,44,296,8,42,24,43,50,67,250,378,4,1548,86,0,0
4,181,75,38,59,1,3,12,76,2,4,2,4,6,6,10,15,1,15,0,0,0
110,5948,1457,730,1242,11,6,188,1468,10,292,166,329,302,495,2424,4078,5,22973,1276,1,0
39,1770,442,244,305,14,16,103,456,11,68,45,75,79,120,452,756,6,4588,254,0,0
51,2032,1098,241,925,5,10,155,1103,7,46,25,49,53,74,273,423,3,1580,87,0,0
183,5400,1660,832,1314,41,38,274,1701,20,312,209,395,332,604,2671,5058,12,64042,3557,1,1
183,5400,1057,646,719,113,100,145,1170,18,215,134,248,233,382,1740,3004,10,31186,1732,1,1
63,1284,91,45,69,0,3,18,91,3,9,6,10,12,16,33,57,1,95,5,0,1
63,1284,367,234,237,17,34,68,384,16,55,34,61,71,95,381,584,8,5183,287,0,1
181,5925,1660,832,1314,41,38,274,1701,20,312,209,395,332,604,2671,5058,12,64042,3557,1,1
117,3166,1523,757,1297,19,12,193,1542,12,193,117,230,205,347,1508,2664,7,19053,1058,0,0
117,3166,701,378,504,33,58,109,734,13,110,68,126,123,194,794,1346,7,10027,557,0,0
113,5329,1523,757,1297,19,12,193,1542,12,193,117,230,205,347,1508,2664,7,19053,1058,0,0
183,5400,1660,832,1314,41,38,274,1701,20,312,209,395,332,604,2671,5058,12,64042,3557,1,0
183,5400,1057,646,719,113,100,145,1170,18,215,134,248,233,382,1740,3004,10,31186,1732,1,0
64,1354,91,45,69,0,3,18,91,3,9,6,10,12,16,33,57,1,95,5,0,0
64,1354,367,234,237,17,34,68,384,16,55,34,61,71,95,381,584,8,5183,287,0,0
181,5925,1660,832,1314,41,38,274,1701,20,312,209,395,332,604,2671,5058,12,64042,3557,1,0
147,3596,77,34,69,0,0,8,77,3,24,16,29,27,45,114,213,1,387,21,0,0
147,3596,712,438,573,51,9,84,763,14,102,71,128,116,199,733,1364,8,11988,666,0,0
85,4953,1296,573,1062,40,33,157,1336,8,201,118,231,209,349,1561,2689,4,12365,686,0,0
142,3472,77,34,69,0,0,8,77,3,24,16,29,27,45,114,213,1,387,21,0,0
142,3472,712,438,573,51,9,84,763,14,102,71,128,116,199,733,1364,8,11988,666,0,0
1,93,42,7,35,4,0,5,46,1,2,1,2,3,3,2,4,0,2,0,0,1
1,93,11,6,10,0,0,1,11,2,4,2,4,6,6,10,15,1,15,0,0,1
113,5706,1523,757,1297,19,12,193,1542,12,193,117,230,205,347,1508,2664,7,19053,1058,0,1
113,5691,1523,757,1297,19,12,193,1542,12,193,117,230,205,347,1508,2664,7,19053,1058,0,0
299,6647,72,33,56,0,4,12,72,1,1,1,1,2,2,0,2,0,1,0,0,0
299,6647,1454,835,1044,76,110,219,1530,17,275,158,296,292,454,2297,3718,9,34017,1889,1,0
1,93,42,7,35,4,0,5,46,1,2,1,2,3,3,2,4,0,2,0,0,0
1,93,11,6,10,0,0,1,11,2,4,2,4,6,6,10,15,1,15,0,0,0
225,5726,722,423,573,19,0,135,741,12,172,101,199,184,300,1320,2257,6,15668,870,0,1
225,5726,1508,847,911,44,250,301,1552,14,148,88,169,162,257,1120,1886,7,15077,837,0,1
225,5726,722,423,573,19,0,135,741,12,172,101,199,184,300,1320,2257,6,15668,870,0,0
225,5726,1508,847,911,44,250,301,1552,14,148,88,169,162,257,1120,1886,7,15077,837,0,0
224,5729,722,423,573,19,0,135,741,12,172,101,199,184,300,1320,2257,6,15668,870,0,1
224,5729,1508,847,911,44,250,301,1552,14,148,88,169,162,257,1120,1886,7,15077,837,0,1
282,5904,1943,715,1694,26,18,214,1969,12,185,120,237,197,357,1436,2721,7,20915,1161,0,1
282,5904,1168,838,957,57,25,144,1225,19,348,224,416,367,640,3018,5452,11,61921,3440,1,1
42,2613,1157,318,931,29,22,177,1186,6,104,63,125,110,188,712,1274,3,4596,255,0,1
55,2824,722,423,573,19,0,135,741,12,172,101,199,184,300,1320,2257,6,15668,870,0,1
112,6136,1943,715,1694,26,18,214,1969,12,185,120,237,197,357,1436,2721,7,20915,1161,0,1
224,5729,722,423,573,19,0,135,741,12,172,101,199,184,300,1320,2257,6,15668,870,0,0
224,5729,1508,847,911,44,250,301,1552,14,148,88,169,162,257,1120,1886,7,15077,837,0,0
282,5904,1943,715,1694,26,18,214,1969,12,185,120,237,197,357,1436,2721,7,20915,1161,0,0
282,5904,1168,838,957,57,25,144,1225,19,348,224,416,367,640,3018,5452,11,61921,3440,1,0
112,6136,1943,715,1694,26,18,214,1969,12,185,120,237,197,357,1436,2721,7,20915,1161,0,0
114,2087,477,336,357,30,23,73,507,16,194,134,250,210,384,1538,2962,10,30538,1696,0,0
183,5967,1660,832,1314,41,38,274,1701,20,312,209,395,332,604,2671,5058,12,64042,3557,1,0
183,5396,1660,832,1314,41,38,274,1701,20,312,209,395,332,604,2671,5058,12,64042,3557,1,1
183,5396,1057,646,719,113,100,145,1170,18,215,134,248,233,382,1740,3004,10,31186,1732,1,1
60,1139,282,196,195,3,0,86,285,8,130,71,141,138,212,936,1507,4,6538,363,0,0
7,292,72,33,56,0,4,12,72,1,1,1,1,2,2,0,2,0,1,0,0,0
183,5396,1660,832,1314,41,38,274,1701,20,312,209,395,332,604,2671,5058,12,64042,3557,1,0
183,5396,1057,646,719,113,100,145,1170,18,215,134,248,233,382,1740,3004,10,31186,1732,1,0
225,5744,722,423,573,19,0,135,741,12,172,101,199,184,300,1320,2257,6,15668,870,0,0
225,5744,1508,847,911,44,250,301,1552,14,148,88,169,162,257,1120,1886,7,15077,837,0,0
235,4857,2,2,2,0,0,0,2,0,0,0,0,0,0,0,0,0,0,0,0,0
235,4857,99,48,90,1,3,5,100,0,0,0,0,0,0,0,0,0,0,0,0,0
235,4857,8,5,5,2,0,1,10,0,0,0,0,0,0,0,0,0,0,0,0,0
235,4857,1217,716,841,84,126,174,1301,14,185,118,215,199,333,1446,2542,8,20687,1149,0,0
235,4857,160,89,115,0,13,31,160,7,15,11,17,22,28,78,124,3,495,27,0,0
235,4857,10,10,9,9,0,0,19,0,0,0,0,0,0,0,0,0,0,0,0,0
235,4857,173,84,99,8,29,36,181,5,12,7,13,17,20,54,81,2,221,12,0,0
235,4857,3,1,1,3,0,0,6,0,0,0,0,0,0,0,0,0,0,0,0,0
53,1795,601,196,481,2,23,85,603,8,63,36,72,71,108,400,664,4,3036,168,0,0
55,1098,207,111,150,11,0,50,218,5,26,19,36,31,55,133,272,3,943,52,0,0
55,1098,410,198,237,31,55,97,441,11,63,38,72,74,110,414,683,6,4293,238,0,0
315,6863,72,33,56,0,4,12,72,1,1,1,1,2,2,0,2,0,1,0,0,0
315,6863,1454,835,1044,76,110,219,1530,17,275,158,296,292,454,2297,3718,9,34017,1889,1,0
107,4626,1289,550,1043,56,32,155,1345,10,167,93,185,177,278,1266,2075,5,11498,638,0,0
21,478,207,111,150,11,0,50,218,5,26,19,36,31,55,133,272,3,943,52,0,0
57,1122,207,111,150,11,0,50,218,5,26,19,36,31,55,133,272,3,943,52,0,1
57,1122,410,198,237,31,55,97,441,11,63,38,72,74,110,414,683,6,4293,238,0,1
251,5834,4293,999,3693,19,54,507,4312,9,155,88,170,164,258,1156,1898,4,9368,520,0,1
251,5834,1482,859,1002,125,135,219,1607,16,219,134,251,235,385,1766,3032,9,27804,1544,1,1
89,3931,1338,495,1086,10,64,173,1348,11,122,82,157,133,239,883,1686,7,11934,663,0,1
178,7721,4293,999,3693,19,54,507,4312,9,155,88,170,164,258,1156,1898,4,9368,520,0,1
178,7721,1482,859,1002,125,135,219,1607,16,219,134,251,235,385,1766,3032,9,27804,1544,1,1
22,484,207,111,150,11,0,50,218,5,26,19,36,31,55,133,272,3,943,52,0,1
318,6891,72,33,56,0,4,12,72,1,1,1,1,2,2,0,2,0,1,0,0,0
318,6891,1454,835,1044,76,110,219,1530,17,275,158,296,292,454,2297,3718,9,34017,1889,1,0
107,4630,1289,550,1043,56,32,155,1345,10,167,93,185,177,278,1266,2075,5,11498,638,0,0
56,1113,207,111,150,11,0,50,218,5,26,19,36,31,55,133,272,3,943,52,0,0
56,1113,410,198,237,31,55,97,441,11,63,38,72,74,110,414,683,6,4293,238,0,0
251,5834,4293,999,3693,19,54,507,4312,9,155,88,170,164,258,1156,1898,4,9368,520,0,0
251,5834,1482,859,1002,125,135,219,1607,16,219,134,251,235,385,1766,3032,9,27804,1544,1,0
89,3931,1338,495,1086,10,64,173,1348,11,122,82,157,133,239,883,1686,7,11934,663,0,0
178,7721,4293,999,3693,19,54,507,4312,9,155,88,170,164,258,1156,1898,4,9368,520,0,0
178,7721,1482,859,1002,125,135,219,1607,16,219,134,251,235,385,1766,3032,9,27804,1544,1,0
23,513,207,111,150,11,0,50,218,5,26,19,36,31,55,133,272,3,943,52,0,0
57,1141,207,111,150,11,0,50,218,5,26,19,36,31,55,133,272,3,943,52,0,0
57,1141,410,198,237,31,55,97,441,11,63,38,72,74,110,414,683,6,4293,238,0,0
238,5010,2,2,2,0,0,0,2,0,0,0,0,0,0,0,0,0,0,0,0,0
238,5010,99,48,90,1,3,5,100,0,0,0,0,0,0,0,0,0,0,0,0,0
238,5010,8,5,5,2,0,1,10,0,0,0,0,0,0,0,0,0,0,0,0,0
238,5010,1217,716,841,84,126,174,1301,14,185,118,215,199,333,1446,2542,8,20687,1149,0,0
238,5010,160,89,115,0,13,31,160,7,15,11,17,22,28,78,124,3,495,27,0,0
238,5010,10,10,9,9,0,0,19,0,0,0,0,0,0,0,0,0,0,0,0,0
238,5010,173,84,99,8,29,36,181,5,12,7,13,17,20,54,81,2,221,12,0,0
238,5010,3,1,1,3,0,0,6,0,0,0,0,0,0,0,0,0,0,0,0,0
250,5807,4293,999,3693,19,54,507,4312,9,155,88,170,164,258,1156,1898,4,9368,520,0,0
250,5807,1482,859,1002,125,135,219,1607,16,219,134,251,235,385,1766,3032,9,27804,1544,1,0
225,5745,722,423,573,19,0,135,741,12,172,101,199,184,300,1320,2257,6,15668,870,0,0
225,5745,1508,847,911,44,250,301,1552,14,148,88,169,162,257,1120,1886,7,15077,837,0,0
303,6685,72,33,56,0,4,12,72,1,1,1,1,2,2,0,2,0,1,0,0,0
303,6685,1454,835,1044,76,110,219,1530,17,275,158,296,292,454,2297,3718,9,34017,1889,1,0
107,4624,1289,550,1043,56,32,155,1345,10,167,93,185,177,278,1266,2075,5,11498,638,0,0
176,7666,4293,999,3693,19,54,507,4312,9,155,88,170,164,258,1156,1898,4,9368,520,0,0
176,7666,1482,859,1002,125,135,219,1607,16,219,134,251,235,385,1766,3032,9,27804,1544,1,0
49,1706,601,196,481,2,23,85,603,8,63,36,72,71,108,400,664,4,3036,168,0,0
178,7750,4293,999,3693,19,54,507,4312,9,155,88,170,164,258,1156,1898,4,9368,520,0,0
178,7750,1482,859,1002,125,135,219,1607,16,219,134,251,235,385,1766,3032,9,27804,1544,1,0
176,7695,4293,999,3693,19,54,507,4312,9,155,88,170,164,258,1156,1898,4,9368,520,0,0
176,7695,1482,859,1002,125,135,219,1607,16,219,134,251,235,385,1766,3032,9,27804,1544,1,0
183,5407,1660,832,1314,41,38,274,1701,20,312,209,395,332,604,2671,5058,12,64042,3557,1,0
183,5407,1057,646,719,113,100,145,1170,18,215,134,248,233,382,1740,3004,10,31186,1732,1,0
216,4979,182,127,129,0,0,53,182,5,39,21,42,44,63,217,343,2,926,51,0,1
216,4979,1165,710,800,67,119,181,1232,18,243,153,282,261,435,2000,3492,10,36473,2026,1,1
67,1549,773,419,590,28,0,166,801,10,204,113,217,214,330,1598,2554,5,13587,754,0,1
67,1549,421,273,302,44,34,57,465,17,81,59,107,98,166,583,1098,11,12329,684,0,1
27,568,2,2,2,0,0,0,2,0,0,0,0,0,0,0,0,0,0,0,0,1
27,568,99,48,90,1,3,5,100,0,0,0,0,0,0,0,0,0,0,0,0,1
27,568,8,5,5,2,0,1,10,0,0,0,0,0,0,0,0,0,0,0,0,1
27,568,1217,716,841,84,126,174,1301,14,185,118,215,199,333,1446,2542,8,20687,1149,0,1
27,568,160,89,115,0,13,31,160,7,15,11,17,22,28,78,124,3,495,27,0,1
27,568,10,10,9,9,0,0,19,0,0,0,0,0,0,0,0,0,0,0,0,1
27,568,173,84,99,8,29,36,181,5,12,7,13,17,20,54,81,2,221,12,0,1
27,568,3,1,1,3,0,0,6,0,0,0,0,0,0,0,0,0,0,0,0,1
183,5421,1660,832,1314,41,38,274,1701,20,312,209,395,332,604,2671,5058,12,64042,3557,1,1
183,5421,1057,646,719,113,100,145,1170,18,215,134,248,233,382,1740,3004,10,31186,1732,1,1
114,2099,477,336,357,30,23,73,507,16,194,134,250,210,384,1538,2962,10,30538,1696,0,1
238,5067,2,2,2,0,0,0,2,0,0,0,0,0,0,0,0,0,0,0,0,1
238,5067,99,48,90,1,3,5,100,0,0,0,0,0,0,0,0,0,0,0,0,1
238,5067,8,5,5,2,0,1,10,0,0,0,0,0,0,0,0,0,0,0,0,1
238,5067,1217,716,841,84,126,174,1301,14,185,118,215,199,333,1446,2542,8,20687,1149,0,1
238,5067,160,89,115,0,13,31,160,7,15,11,17,22,28,78,124,3,495,27,0,1
238,5067,10,10,9,9,0,0,19,0,0,0,0,0,0,0,0,0,0,0,0,1
238,5067,173,84,99,8,29,36,181,5,12,7,13,17,20,54,81,2,221,12,0,1
238,5067,3,1,1,3,0,0,6,0,0,0,0,0,0,0,0,0,0,0,0,1
111,2283,463,295,324,28,62,57,491,12,134,82,154,146,236,989,1696,6,11700,650,0,1
37,813,167,116,138,4,5,22,171,8,48,30,56,56,86,292,499,4,2330,129,0,1
30,669,125,97,103,3,0,19,128,9,25,17,27,34,44,144,223,4,1087,60,0,1
70,1526,402,202,227,24,74,80,426,12,52,33,61,64,94,339,564,7,3969,220,0,1
73,1707,53,23,39,0,0,13,53,2,8,4,8,10,12,26,39,1,39,2,0,1
73,1707,515,298,307,33,80,99,548,12,63,44,77,75,121,419,753,7,5527,307,0,1
67,1752,466,257,367,18,25,50,484,7,126,86,171,133,257,898,1813,4,8612,478,0,1
67,1752,507,281,342,29,59,88,536,10,53,29,57,63,86,336,514,5,2764,153,0,1
87,1935,1043,504,840,53,9,147,1096,9,180,112,198,189,310,1377,2344,4,11604,644,0,1
87,1935,383,288,292,26,6,62,409,11,65,38,67,76,105,429,656,5,3719,206,0,1
216,4943,182,127,129,0,0,53,182,5,39,21,42,44,63,217,343,2,926,51,0,0
216,4943,1165,710,800,67,119,181,1232,18,243,153,282,261,435,2000,3492,10,36473,2026,1,0
80,1982,757,253,292,73,244,162,830,13,61,38,67,74,105,409,651,7,4654,258,0,0
21,1008,386,256,301,16,9,68,402,4,59,35,69,63,104,355,621,2,1453,80,0,0
21,1008,264,131,164,11,41,46,275,6,38,22,40,44,62,214,338,3,1068,59,0,0
115,2286,463,295,324,28,62,57,491,12,134,82,154,146,236,989,1696,6,11700,650,0,1
111,6022,1457,730,1242,11,6,188,1468,10,292,166,329,302,495,2424,4078,5,22973,1276,1,1
183,5390,1660,832,1314,41,38,274,1701,20,312,209,395,332,604,2671,5058,12,64042,3557,1,0
183,5390,1057,646,719,113,100,145,1170,18,215,134,248,233,382,1740,3004,10,31186,1732,1,0
122,4961,1450,624,1228,12,26,181,1462,14,306,186,354,320,540,2580,4493,8,36391,2021,1,0
122,4963,1450,624,1228,12,26,181,1462,14,306,186,354,320,540,2580,4493,8,36391,2021,1,0
115,2286,463,295,324,28,62,57,491,12,134,82,154,146,236,989,1696,6,11700,650,0,0
111,6022,1457,730,1242,11,6,188,1468,10,292,166,329,302,495,2424,4078,5,22973,1276,1,0
57,1141,207,111,150,11,0,50,218,5,26,19,36,31,55,133,272,3,943,52,0,1
57,1141,410,198,237,31,55,97,441,11,63,38,72,74,110,414,683,6,4293,238,0,1
58,1166,207,111,150,11,0,50,218,5,26,19,36,31,55,133,272,3,943,52,0,0
58,1166,410,198,237,31,55,97,441,11,63,38,72,74,110,414,683,6,4293,238,0,0
79,1961,757,253,292,73,244,162,830,13,61,38,67,74,105,409,651,7,4654,258,0,0
20,987,386,256,301,16,9,68,402,4,59,35,69,63,104,355,621,2,1453,80,0,0
20,987,264,131,164,11,41,46,275,6,38,22,40,44,62,214,338,3,1068,59,0,0
252,5831,4293,999,3693,19,54,507,4312,9,155,88,170,164,258,1156,1898,4,9368,520,0,0
252,5831,1482,859,1002,125,135,219,1607,16,219,134,251,235,385,1766,3032,9,27804,1544,1,0
177,7730,4293,999,3693,19,54,507,4312,9,155,88,170,164,258,1156,1898,4,9368,520,0,0
177,7730,1482,859,1002,125,135,219,1607,16,219,134,251,235,385,1766,3032,9,27804,1544,1,0
30,911,256,139,192,9,7,47,265,4,23,12,24,27,36,112,171,2,357,19,0,0
30,919,256,139,192,9,7,47,265,4,23,12,24,27,36,112,171,2,357,19,0,0
216,4979,182,127,129,0,0,53,182,5,39,21,42,44,63,217,343,2,926,51,0,0
216,4979,1165,710,800,67,119,181,1232,18,243,153,282,261,435,2000,3492,10,36473,2026,1,0
67,1549,773,419,590,28,0,166,801,10,204,113,217,214,330,1598,2554,5,13587,754,0,0
67,1549,421,273,302,44,34,57,465,17,81,59,107,98,166,583,1098,11,12329,684,0,0
27,568,2,2,2,0,0,0,2,0,0,0,0,0,0,0,0,0,0,0,0,0
27,568,99,48,90,1,3,5,100,0,0,0,0,0,0,0,0,0,0,0,0,0
27,568,8,5,5,2,0,1,10,0,0,0,0,0,0,0,0,0,0,0,0,0
27,568,1217,716,841,84,126,174,1301,14,185,118,215,199,333,1446,2542,8,20687,1149,0,0
27,568,160,89,115,0,13,31,160,7,15,11,17,22,28,78,124,3,495,27,0,0
27,568,10,10,9,9,0,0,19,0,0,0,0,0,0,0,0,0,0,0,0,0
27,568,173,84,99,8,29,36,181,5,12,7,13,17,20,54,81,2,221,12,0,0
27,568,3,1,1,3,0,0,6,0,0,0,0,0,0,0,0,0,0,0,0,0
183,5421,1660,832,1314,41,38,274,1701,20,312,209,395,332,604,2671,5058,12,64042,3557,1,0
183,5421,1057,646,719,113,100,145,1170,18,215,134,248,233,382,1740,3004,10,31186,1732,1,0
114,2099,477,336,357,30,23,73,507,16,194,134,250,210,384,1538,2962,10,30538,1696,0,0
238,5067,2,2,2,0,0,0,2,0,0,0,0,0,0,0,0,0,0,0,0,0
238,5067,99,48,90,1,3,5,100,0,0,0,0,0,0,0,0,0,0,0,0,0
238,5067,8,5,5,2,0,1,10,0,0,0,0,0,0,0,0,0,0,0,0,0
238,5067,1217,716,841,84,126,174,1301,14,185,118,215,199,333,1446,2542,8,20687,1149,0,0
238,5067,160,89,115,0,13,31,160,7,15,11,17,22,28,78,124,3,495,27,0,0
238,5067,10,10,9,9,0,0,19,0,0,0,0,0,0,0,0,0,0,0,0,0
238,5067,173,84,99,8,29,36,181,5,12,7,13,17,20,54,81,2,221,12,0,0
238,5067,3,1,1,3,0,0,6,0,0,0,0,0,0,0,0,0,0,0,0,0
113,2326,463,295,324,28,62,57,491,12,134,82,154,146,236,989,1696,6,11700,650,0,0
37,813,167,116,138,4,5,22,171,8,48,30,56,56,86,292,499,4,2330,129,0,0
30,669,125,97,103,3,0,19,128,9,25,17,27,34,44,144,223,4,1087,60,0,0
70,1526,402,202,227,24,74,80,426,12,52,33,61,64,94,339,564,7,3969,220,0,0
73,1707,53,23,39,0,0,13,53,2,8,4,8,10,12,26,39,1,39,2,0,0
73,1707,515,298,307,33,80,99,548,12,63,44,77,75,121,419,753,7,5527,307,0,0
67,1752,466,257,367,18,25,50,484,7,126,86,171,133,257,898,1813,4,8612,478,0,0
67,1752,507,281,342,29,59,88,536,10,53,29,57,63,86,336,514,5,2764,153,0,0
87,1935,1043,504,840,53,9,147,1096,9,180,112,198,189,310,1377,2344,4,11604,644,0,0
87,1935,383,288,292,26,6,62,409,11,65,38,67,76,105,429,656,5,3719,206,0,0
15,481,184,100,137,2,15,30,186,6,38,20,39,44,59,214,322,3,991,55,0,0
15,481,103,65,74,8,5,16,111,7,17,9,17,24,26,89,119,3,417,23,0,0
11,492,184,100,137,2,15,30,186,6,38,20,39,44,59,214,322,3,991,55,0,0
75,1811,466,257,367,18,25,50,484,7,126,86,171,133,257,898,1813,4,8612,478,0,0
75,1811,507,281,342,29,59,88,536,10,53,29,57,63,86,336,514,5,2764,153,0,0
31,956,182,127,129,0,0,53,182,5,39,21,42,44,63,217,343,2,926,51,0,0
146,7027,1392,870,1177,35,17,170,1427,14,494,280,531,508,811,4473,7289,7,54850,3047,2,0
15,359,127,75,83,2,11,30,129,4,14,7,14,18,21,61,87,2,175,9,0,0
15,359,652,304,544,16,6,88,668,6,89,51,101,95,152,591,998,3,3399,188,0,0
15,359,2,2,2,0,0,0,2,0,0,0,0,0,0,0,0,0,0,0,0,0
15,359,8,5,5,0,0,3,8,0,0,0,0,0,0,0,0,0,0,0,0,0
15,359,14,8,8,0,0,6,14,0,0,0,0,0,0,0,0,0,0,0,0,0
15,359,6,4,4,0,0,2,6,0,0,0,0,0,0,0,0,0,0,0,0,0
15,359,6,4,4,0,0,2,6,1,2,1,2,3,3,2,4,0,2,0,0,0
15,359,7,5,5,0,0,2,7,0,0,0,0,0,0,0,0,0,0,0,0,0
15,359,10,6,6,0,0,4,10,0,0,0,0,0,0,0,0,0,0,0,0,0
15,359,1,1,1,0,0,0,1,0,0,0,0,0,0,0,0,0,0,0,0,0
15,359,14,10,10,0,0,4,14,1,1,1,1,2,2,0,2,0,1,0,0,0
15,359,46,26,30,3,0,12,49,3,6,3,6,9,9,20,28,1,42,2,0,0
239,5045,2,2,2,0,0,0,2,0,0,0,0,0,0,0,0,0,0,0,0,1
239,5045,99,48,90,1,3,5,100,0,0,0,0,0,0,0,0,0,0,0,0,1
239,5045,8,5,5,2,0,1,10,0,0,0,0,0,0,0,0,0,0,0,0,1
239,5045,1217,716,841,84,126,174,1301,14,185,118,215,199,333,1446,2542,8,20687,1149,0,1
239,5045,160,89,115,0,13,31,160,7,15,11,17,22,28,78,124,3,495,27,0,1
239,5045,10,10,9,9,0,0,19,0,0,0,0,0,0,0,0,0,0,0,0,1
239,5045,173,84,99,8,29,36,181,5,12,7,13,17,20,54,81,2,221,12,0,1
239,5045,3,1,1,3,0,0,6,0,0,0,0,0,0,0,0,0,0,0,0,1
45,2802,652,304,544,16,6,88,668,6,89,51,101,95,152,591,998,3,3399,188,0,1
216,4974,182,127,129,0,0,53,182,5,39,21,42,44,63,217,343,2,926,51,0,0
216,4974,1165,710,800,67,119,181,1232,18,243,153,282,261,435,2000,3492,10,36473,2026,1,0
183,5415,1660,832,1314,41,38,274,1701,20,312,209,395,332,604,2671,5058,12,64042,3557,1,0
183,5415,1057,646,719,113,100,145,1170,18,215,134,248,233,382,1740,3004,10,31186,1732,1,0
18,697,184,100,137,2,15,30,186,6,38,20,39,44,59,214,322,3,991,55,0,0
45,2806,652,304,544,16,6,88,668,6,89,51,101,95,152,591,998,3,3399,188,0,1
238,5023,2,2,2,0,0,0,2,0,0,0,0,0,0,0,0,0,0,0,0,1
238,5023,99,48,90,1,3,5,100,0,0,0,0,0,0,0,0,0,0,0,0,1
238,5023,8,5,5,2,0,1,10,0,0,0,0,0,0,0,0,0,0,0,0,1
238,5023,1217,716,841,84,126,174,1301,14,185,118,215,199,333,1446,2542,8,20687,1149,0,1
238,5023,160,89,115,0,13,31,160,7,15,11,17,22,28,78,124,3,495,27,0,1
238,5023,10,10,9,9,0,0,19,0,0,0,0,0,0,0,0,0,0,0,0,1
238,5023,173,84,99,8,29,36,181,5,12,7,13,17,20,54,81,2,221,12,0,1
238,5023,3,1,1,3,0,0,6,0,0,0,0,0,0,0,0,0,0,0,0,1
65,1385,91,45,69,0,3,18,91,3,9,6,10,12,16,33,57,1,95,5,0,1
65,1385,367,234,237,17,34,68,384,16,55,34,61,71,95,381,584,8,5183,287,0,1
238,5023,2,2,2,0,0,0,2,0,0,0,0,0,0,0,0,0,0,0,0,0
238,5023,99,48,90,1,3,5,100,0,0,0,0,0,0,0,0,0,0,0,0,0
238,5023,8,5,5,2,0,1,10,0,0,0,0,0,0,0,0,0,0,0,0,0
238,5023,1217,716,841,84,126,174,1301,14,185,118,215,199,333,1446,2542,8,20687,1149,0,0
238,5023,160,89,115,0,13,31,160,7,15,11,17,22,28,78,124,3,495,27,0,0
238,5023,10,10,9,9,0,0,19,0,0,0,0,0,0,0,0,0,0,0,0,0
238,5023,173,84,99,8,29,36,181,5,12,7,13,17,20,54,81,2,221,12,0,0
238,5023,3,1,1,3,0,0,6,0,0,0,0,0,0,0,0,0,0,0,0,0
65,1385,91,45,69,0,3,18,91,3,9,6,10,12,16,33,57,1,95,5,0,0
65,1385,367,234,237,17,34,68,384,16,55,34,61,71,95,381,584,8,5183,287,0,0
45,2806,652,304,544,16,6,88,668,6,89,51,101,95,152,591,998,3,3399,188,0,0
252,5837,4293,999,3693,19,54,507,4312,9,155,88,170,164,258,1156,1898,4,9368,520,0,0
252,5837,1482,859,1002,125,135,219,1607,16,219,134,251,235,385,1766,3032,9,27804,1544,1,0
177,7722,4293,999,3693,19,54,507,4312,9,155,88,170,164,258,1156,1898,4,9368,520,0,0
177,7722,1482,859,1002,125,135,219,1607,16,219,134,251,235,385,1766,3032,9,27804,1544,1,0
79,1938,466,257,367,18,25,50,484,7,126,86,171,133,257,898,1813,4,8612,478,0,0
79,1938,507,281,342,29,59,88,536,10,53,29,57,63,86,336,514,5,2764,153,0,0
31,1843,466,257,367,18,25,50,484,7,126,86,171,133,257,898,1813,4,8612,478,0,0
177,7723,4293,999,3693,19,54,507,4312,9,155,88,170,164,258,1156,1898,4,9368,520,0,0
177,7723,1482,859,1002,125,135,219,1607,16,219,134,251,235,385,1766,3032,9,27804,1544,1,0
177,7731,4293,999,3693,19,54,507,4312,9,155,88,170,164,258,1156,1898,4,9368,520,0,0
177,7731,1482,859,1002,125,135,219,1607,16,219,134,251,235,385,1766,3032,9,27804,1544,1,0
178,7759,4293,999,3693,19,54,507,4312,9,155,88,170,164,258,1156,1898,4,9368,520,0,0
178,7759,1482,859,1002,125,135,219,1607,16,219,134,251,235,385,1766,3032,9,27804,1544,1,0
260,6091,4293,999,3693,19,54,507,4312,9,155,88,170,164,258,1156,1898,4,9368,520,0,1
260,6091,1482,859,1002,125,135,219,1607,16,219,134,251,235,385,1766,3032,9,27804,1544,1,1
180,7835,4293,999,3693,19,54,507,4312,9,155,88,170,164,258,1156,1898,4,9368,520,0,1
180,7835,1482,859,1002,125,135,219,1607,16,219,134,251,235,385,1766,3032,9,27804,1544,1,1
74,3931,1293,570,1093,25,15,163,1318,10,195,123,241,205,364,1516,2795,6,17273,959,0,0
161,3434,1513,682,1277,25,13,200,1538,11,199,116,219,210,335,1557,2584,6,15641,868,0,0
161,3434,819,519,539,24,98,155,843,15,96,57,106,111,163,690,1107,8,9171,509,0,0
257,6183,4293,999,3693,19,54,507,4312,9,155,88,170,164,258,1156,1898,4,9368,520,0,0
257,6183,1482,859,1002,125,135,219,1607,16,219,134,251,235,385,1766,3032,9,27804,1544,1,0
238,5019,2,2,2,0,0,0,2,0,0,0,0,0,0,0,0,0,0,0,0,0
238,5019,99,48,90,1,3,5,100,0,0,0,0,0,0,0,0,0,0,0,0,0
238,5019,8,5,5,2,0,1,10,0,0,0,0,0,0,0,0,0,0,0,0,0
238,5019,1217,716,841,84,126,174,1301,14,185,118,215,199,333,1446,2542,8,20687,1149,0,0
238,5019,160,89,115,0,13,31,160,7,15,11,17,22,28,78,124,3,495,27,0,0
238,5019,10,10,9,9,0,0,19,0,0,0,0,0,0,0,0,0,0,0,0,0
238,5019,173,84,99,8,29,36,181,5,12,7,13,17,20,54,81,2,221,12,0,0
238,5019,3,1,1,3,0,0,6,0,0,0,0,0,0,0,0,0,0,0,0,0
46,2854,652,304,544,16,6,88,668,6,89,51,101,95,152,591,998,3,3399,188,0,0
76,1631,53,23,39,0,0,13,53,2,8,4,8,10,12,26,39,1,39,2,0,0
76,1631,515,298,307,33,80,99,548,12,63,44,77,75,121,419,753,7,5527,307,0,0
146,7064,1392,870,1177,35,17,170,1427,14,494,280,531,508,811,4473,7289,7,54850,3047,2,0
238,5076,2,2,2,0,0,0,2,0,0,0,0,0,0,0,0,0,0,0,0,0
238,5076,99,48,90,1,3,5,100,0,0,0,0,0,0,0,0,0,0,0,0,0
238,5076,8,5,5,2,0,1,10,0,0,0,0,0,0,0,0,0,0,0,0,0
238,5076,1217,716,841,84,126,174,1301,14,185,118,215,199,333,1446,2542,8,20687,1149,0,0
238,5076,160,89,115,0,13,31,160,7,15,11,17,22,28,78,124,3,495,27,0,0
238,5076,10,10,9,9,0,0,19,0,0,0,0,0,0,0,0,0,0,0,0,0
238,5076,173,84,99,8,29,36,181,5,12,7,13,17,20,54,81,2,221,12,0,0
238,5076,3,1,1,3,0,0,6,0,0,0,0,0,0,0,0,0,0,0,0,0
73,1701,53,23,39,0,0,13,53,2,8,4,8,10,12,26,39,1,39,2,0,0
73,1701,515,298,307,33,80,99,548,12,63,44,77,75,121,419,753,7,5527,307,0,0
79,1942,466,257,367,18,25,50,484,7,126,86,171,133,257,898,1813,4,8612,478,0,0
79,1942,507,281,342,29,59,88,536,10,53,29,57,63,86,336,514,5,2764,153,0,0
261,6237,4293,999,3693,19,54,507,4312,9,155,88,170,164,258,1156,1898,4,9368,520,0,0
261,6237,1482,859,1002,125,135,219,1607,16,219,134,251,235,385,1766,3032,9,27804,1544,1,0
182,7900,4293,999,3693,19,54,507,4312,9,155,88,170,164,258,1156,1898,4,9368,520,0,0
182,7900,1482,859,1002,125,135,219,1607,16,219,134,251,235,385,1766,3032,9,27804,1544,1,0
184,7983,4293,999,3693,19,54,507,4312,9,155,88,170,164,258,1156,1898,4,9368,520,0,0
184,7983,1482,859,1002,125,135,219,1607,16,219,134,251,235,385,1766,3032,9,27804,1544,1,0
184,7975,4293,999,3693,19,54,507,4312,9,155,88,170,164,258,1156,1898,4,9368,520,0,0
184,7975,1482,859,1002,125,135,219,1607,16,219,134,251,235,385,1766,3032,9,27804,1544,1,0
38,2308,334,251,279,10,4,40,344,5,127,74,143,132,217,899,1528,2,4303,239,0,0
16,386,127,75,83,2,11,30,129,4,14,7,14,18,21,61,87,2,175,9,0,0
16,386,652,304,544,16,6,88,668,6,89,51,101,95,152,591,998,3,3399,188,0,0
16,386,2,2,2,0,0,0,2,0,0,0,0,0,0,0,0,0,0,0,0,0
16,386,8,5,5,0,0,3,8,0,0,0,0,0,0,0,0,0,0,0,0,0
16,386,14,8,8,0,0,6,14,0,0,0,0,0,0,0,0,0,0,0,0,0
16,386,6,4,4,0,0,2,6,0,0,0,0,0,0,0,0,0,0,0,0,0
16,386,6,4,4,0,0,2,6,1,2,1,2,3,3,2,4,0,2,0,0,0
16,386,7,5,5,0,0,2,7,0,0,0,0,0,0,0,0,0,0,0,0,0
16,386,10,6,6,0,0,4,10,0,0,0,0,0,0,0,0,0,0,0,0,0
16,386,1,1,1,0,0,0,1,0,0,0,0,0,0,0,0,0,0,0,0,0
16,386,14,10,10,0,0,4,14,1,1,1,1,2,2,0,2,0,1,0,0,0
16,386,46,26,30,3,0,12,49,3,6,3,6,9,9,20,28,1,42,2,0,0
116,2131,477,336,357,30,23,73,507,16,194,134,250,210,384,1538,2962,10,30538,1696,0,0
58,1205,207,111,150,11,0,50,218,5,26,19,36,31,55,133,272,3,943,52,0,0
58,1205,410,198,237,31,55,97,441,11,63,38,72,74,110,414,683,6,4293,238,0,0
70,1531,402,202,227,24,74,80,426,12,52,33,61,64,94,339,564,7,3969,220,0,0
122,4968,1450,624,1228,12,26,181,1462,14,306,186,354,320,540,2580,4493,8,36391,2021,1,0
114,2108,477,336,357,30,23,73,507,16,194,134,250,210,384,1538,2962,10,30538,1696,0,0
70,1535,402,202,227,24,74,80,426,12,52,33,61,64,94,339,564,7,3969,220,0,0
122,4972,1450,624,1228,12,26,181,1462,14,306,186,354,320,540,2580,4493,8,36391,2021,1,0
57,1488,339,213,244,17,9,65,356,10,42,26,48,52,74,259,421,5,2410,133,0,0
108,4697,1289,550,1043,56,32,155,1345,10,167,93,185,177,278,1266,2075,5,11498,638,0,0
232,5908,722,423,573,19,0,135,741,12,172,101,199,184,300,1320,2257,6,15668,870,0,1
232,5908,1508,847,911,44,250,301,1552,14,148,88,169,162,257,1120,1886,7,15077,837,0,1
59,2994,722,423,573,19,0,135,741,12,172,101,199,184,300,1320,2257,6,15668,870,0,1
107,4615,1289,550,1043,56,32,155,1345,10,167,93,185,177,278,1266,2075,5,11498,638,0,0
146,7058,1392,870,1177,35,17,170,1427,14,494,280,531,508,811,4473,7289,7,54850,3047,2,0
15,696,139,89,101,2,0,35,141,7,54,34,62,61,96,330,569,4,2287,127,0,0
42,2589,1157,318,931,29,22,177,1186,6,104,63,125,110,188,712,1274,3,4596,255,0,0
89,3928,1338,495,1086,10,64,173,1348,11,122,82,157,133,239,883,1686,7,11934,663,0,0
184,7966,4293,999,3693,19,54,507,4312,9,155,88,170,164,258,1156,1898,4,9368,520,0,0
184,7966,1482,859,1002,125,135,219,1607,16,219,134,251,235,385,1766,3032,9,27804,1544,1,0
6,322,180,34,164,0,0,16,180,1,12,6,12,13,18,43,66,0,33,1,0,0
122,4966,1450,624,1228,12,26,181,1462,14,306,186,354,320,540,2580,4493,8,36391,2021,1,0
183,5958,1660,832,1314,41,38,274,1701,20,312,209,395,332,604,2671,5058,12,64042,3557,1,0
49,3773,996,429,845,24,10,117,1020,7,76,50,88,83,138,494,879,4,3565,198,0,0
120,5064,1513,682,1277,25,13,200,1538,11,199,116,219,210,335,1557,2584,6,15641,868,0,0
85,4935,1296,573,1062,40,33,157,1336,8,201,118,231,209,349,1561,2689,4,12365,686,0,0
46,2848,652,304,544,16,6,88,668,6,89,51,101,95,152,591,998,3,3399,188,0,0
81,3714,1455,414,1257,16,76,112,1471,5,41,23,46,46,69,231,381,2,1069,59,0,0
113,5682,1523,757,1297,19,12,193,1542,12,193,117,230,205,347,1508,2664,7,19053,1058,0,0
87,3375,1043,504,840,53,9,147,1096,9,180,112,198,189,310,1377,2344,4,11604,644,0,0
12,463,295,56,236,0,4,54,295,2,9,5,10,11,15,30,51,1,57,3,0,0
79,3068,1178,367,1042,6,15,115,1184,9,94,51,95,103,146,644,976,4,4439,246,0,0
112,6100,1943,715,1694,26,18,214,1969,12,185,120,237,197,357,1436,2721,7,20915,1161,0,0
51,2017,1098,241,925,5,10,155,1103,7,46,25,49,53,74,273,423,3,1580,87,0,0
3,90,35,12,22,4,5,6,39,1,2,1,2,3,3,2,4,0,2,0,0,0
232,5908,722,423,573,19,0,135,741,12,172,101,199,184,300,1320,2257,6,15668,870,0,0
232,5908,1508,847,911,44,250,301,1552,14,148,88,169,162,257,1120,1886,7,15077,837,0,0
108,4688,1289,550,1043,56,32,155,1345,10,167,93,185,177,278,1266,2075,5,11498,638,0,0
59,2994,722,423,573,19,0,135,741,12,172,101,199,184,300,1320,2257,6,15668,870,0,0
87,3404,1043,504,840,53,9,147,1096,9,180,112,198,189,310,1377,2344,4,11604,644,0,0
123,2323,477,336,357,30,23,73,507,16,194,134,250,210,384,1538,2962,10,30538,1696,0,1
124,5157,1450,624,1228,12,26,181,1462,14,306,186,354,320,540,2580,4493,8,36391,2021,1,1
123,2323,477,336,357,30,23,73,507,16,194,134,250,210,384,1538,2962,10,30538,1696,0,0
124,5157,1450,624,1228,12,26,181,1462,14,306,186,354,320,540,2580,4493,8,36391,2021,1,0
87,3386,1043,504,840,53,9,147,1096,9,180,112,198,189,310,1377,2344,4,11604,644,0,0
216,4987,182,127,129,0,0,53,182,5,39,21,42,44,63,217,343,2,926,51,0,0
216,4987,1165,710,800,67,119,181,1232,18,243,153,282,261,435,2000,3492,10,36473,2026,1,0
148,7105,1392,870,1177,35,17,170,1427,14,494,280,531,508,811,4473,7289,7,54850,3047,2,0
124,5153,1450,624,1228,12,26,181,1462,14,306,186,354,320,540,2580,4493,8,36391,2021,1,0
1,95,42,7,35,4,0,5,46,1,2,1,2,3,3,2,4,0,2,0,0,0
1,95,11,6,10,0,0,1,11,2,4,2,4,6,6,10,15,1,15,0,0,0
185,8002,4293,999,3693,19,54,507,4312,9,155,88,170,164,258,1156,1898,4,9368,520,0,0
185,8002,1482,859,1002,125,135,219,1607,16,219,134,251,235,385,1766,3032,9,27804,1544,1,0
261,6225,4293,999,3693,19,54,507,4312,9,155,88,170,164,258,1156,1898,4,9368,520,0,0
261,6225,1482,859,1002,125,135,219,1607,16,219,134,251,235,385,1766,3032,9,27804,1544,1,0
113,5657,1523,757,1297,19,12,193,1542,12,193,117,230,205,347,1508,2664,7,19053,1058,0,0
185,8008,4293,999,3693,19,54,507,4312,9,155,88,170,164,258,1156,1898,4,9368,520,0,0
185,8008,1482,859,1002,125,135,219,1607,16,219,134,251,235,385,1766,3032,9,27804,1544,1,0
76,3969,1293,570,1093,25,15,163,1318,10,195,123,241,205,364,1516,2795,6,17273,959,0,0
185,7999,4293,999,3693,19,54,507,4312,9,155,88,170,164,258,1156,1898,4,9368,520,0,0
185,7999,1482,859,1002,125,135,219,1607,16,219,134,251,235,385,1766,3032,9,27804,1544,1,0
282,5905,1943,715,1694,26,18,214,1969,12,185,120,237,197,357,1436,2721,7,20915,1161,0,0
282,5905,1168,838,957,57,25,144,1225,19,348,224,416,367,640,3018,5452,11,61921,3440,1,0
237,5050,2,2,2,0,0,0,2,0,0,0,0,0,0,0,0,0,0,0,0,0
237,5050,99,48,90,1,3,5,100,0,0,0,0,0,0,0,0,0,0,0,0,0
237,5050,8,5,5,2,0,1,10,0,0,0,0,0,0,0,0,0,0,0,0,0
237,5050,1217,716,841,84,126,174,1301,14,185,118,215,199,333,1446,2542,8,20687,1149,0,0
237,5050,160,89,115,0,13,31,160,7,15,11,17,22,28,78,124,3,495,27,0,0
237,5050,10,10,9,9,0,0,19,0,0,0,0,0,0,0,0,0,0,0,0,0
237,5050,173,84,99,8,29,36,181,5,12,7,13,17,20,54,81,2,221,12,0,0
237,5050,3,1,1,3,0,0,6,0,0,0,0,0,0,0,0,0,0,0,0,0
216,4989,182,127,129,0,0,53,182,5,39,21,42,44,63,217,343,2,926,51,0,0
216,4989,1165,710,800,67,119,181,1232,18,243,153,282,261,435,2000,3492,10,36473,2026,1,0
90,2024,996,429,845,24,10,117,1020,7,76,50,88,83,138,494,879,4,3565,198,0,0
90,2024,456,277,329,12,42,72,468,13,85,50,97,98,147,592,972,7,7212,400,0,0
49,3806,996,429,845,24,10,117,1020,7,76,50,88,83,138,494,879,4,3565,198,0,0
51,2040,1098,241,925,5,10,155,1103,7,46,25,49,53,74,273,423,3,1580,87,0,0
87,1918,1043,504,840,53,9,147,1096,9,180,112,198,189,310,1377,2344,4,11604,644,0,0
87,1918,383,288,292,26,6,62,409,11,65,38,67,76,105,429,656,5,3719,206,0,0
88,3446,1043,504,840,53,9,147,1096,9,180,112,198,189,310,1377,2344,4,11604,644,0,0
20,381,294,64,250,0,0,43,294,1,20,10,20,21,30,86,131,0,65,3,0,0
20,381,78,46,62,3,0,14,81,3,8,4,8,11,12,28,41,1,62,3,0,0
239,5074,2,2,2,0,0,0,2,0,0,0,0,0,0,0,0,0,0,0,0,0
239,5074,99,48,90,1,3,5,100,0,0,0,0,0,0,0,0,0,0,0,0,0
239,5074,8,5,5,2,0,1,10,0,0,0,0,0,0,0,0,0,0,0,0,0
239,5074,1217,716,841,84,126,174,1301,14,185,118,215,199,333,1446,2542,8,20687,1149,0,0
239,5074,160,89,115,0,13,31,160,7,15,11,17,22,28,78,124,3,495,27,0,0
239,5074,10,10,9,9,0,0,19,0,0,0,0,0,0,0,0,0,0,0,0,0
239,5074,173,84,99,8,29,36,181,5,12,7,13,17,20,54,81,2,221,12,0,0
239,5074,3,1,1,3,0,0,6,0,0,0,0,0,0,0,0,0,0,0,0,0
111,6057,1457,730,1242,11,6,188,1468,10,292,166,329,302,495,2424,4078,5,22973,1276,1,0
20,405,294,64,250,0,0,43,294,1,20,10,20,21,30,86,131,0,65,3,0,0
20,405,78,46,62,3,0,14,81,3,8,4,8,11,12,28,41,1,62,3,0,0
124,2350,477,336,357,30,23,73,507,16,194,134,250,210,384,1538,2962,10,30538,1696,0,0
185,6013,1660,832,1314,41,38,274,1701,20,312,209,395,332,604,2671,5058,12,64042,3557,1,0
238,5048,2,2,2,0,0,0,2,0,0,0,0,0,0,0,0,0,0,0,0,0
238,5048,99,48,90,1,3,5,100,0,0,0,0,0,0,0,0,0,0,0,0,0
238,5048,8,5,5,2,0,1,10,0,0,0,0,0,0,0,0,0,0,0,0,0
238,5048,1217,716,841,84,126,174,1301,14,185,118,215,199,333,1446,2542,8,20687,1149,0,0
238,5048,160,89,115,0,13,31,160,7,15,11,17,22,28,78,124,3,495,27,0,0
238,5048,10,10,9,9,0,0,19,0,0,0,0,0,0,0,0,0,0,0,0,0
238,5048,173,84,99,8,29,36,181,5,12,7,13,17,20,54,81,2,221,12,0,0
238,5048,3,1,1,3,0,0,6,0,0,0,0,0,0,0,0,0,0,0,0,0
12,572,294,64,250,0,0,43,294,1,20,10,20,21,30,86,131,0,65,3,0,0
304,6701,72,33,56,0,4,12,72,1,1,1,1,2,2,0,2,0,1,0,0,1
304,6701,1454,835,1044,76,110,219,1530,17,275,158,296,292,454,2297,3718,9,34017,1889,1,1
80,3116,1178,367,1042,6,15,115,1184,9,94,51,95,103,146,644,976,4,4439,246,0,1
306,6750,72,33,56,0,4,12,72,1,1,1,1,2,2,0,2,0,1,0,0,0
306,6750,1454,835,1044,76,110,219,1530,17,275,158,296,292,454,2297,3718,9,34017,1889,1,0
306,6763,72,33,56,0,4,12,72,1,1,1,1,2,2,0,2,0,1,0,0,1
306,6763,1454,835,1044,76,110,219,1530,17,275,158,296,292,454,2297,3718,9,34017,1889,1,1
232,5898,722,423,573,19,0,135,741,12,172,101,199,184,300,1320,2257,6,15668,870,0,0
232,5898,1508,847,911,44,250,301,1552,14,148,88,169,162,257,1120,1886,7,15077,837,0,0
161,3433,1513,682,1277,25,13,200,1538,11,199,116,219,210,335,1557,2584,6,15641,868,0,0
161,3433,819,519,539,24,98,155,843,15,96,57,106,111,163,690,1107,8,9171,509,0,0
288,6093,1943,715,1694,26,18,214,1969,12,185,120,237,197,357,1436,2721,7,20915,1161,0,0
288,6093,1168,838,957,57,25,144,1225,19,348,224,416,367,640,3018,5452,11,61921,3440,1,0
112,6632,1943,715,1694,26,18,214,1969,12,185,120,237,197,357,1436,2721,7,20915,1161,0,0
3,96,35,12,22,4,5,6,39,1,2,1,2,3,3,2,4,0,2,0,0,0
77,4048,1293,570,1093,25,15,163,1318,10,195,123,241,205,364,1516,2795,6,17273,959,0,0
1,43,110,30,77,3,13,16,113,4,21,15,30,25,45,100,208,2,597,33,0,0
102,2603,1455,414,1257,16,76,112,1471,5,41,23,46,46,69,231,381,2,1069,59,0,0
102,2603,669,365,481,22,61,110,691,15,103,63,122,118,185,747,1273,8,11311,628,0,0
20,378,294,64,250,0,0,43,294,1,20,10,20,21,30,86,131,0,65,3,0,0
20,378,78,46,62,3,0,14,81,3,8,4,8,11,12,28,41,1,62,3,0,0
103,2613,1455,414,1257,16,76,112,1471,5,41,23,46,46,69,231,381,2,1069,59,0,0
103,2613,669,365,481,22,61,110,691,15,103,63,122,118,185,747,1273,8,11311,628,0,0
106,4670,1289,550,1043,56,32,155,1345,10,167,93,185,177,278,1266,2075,5,11498,638,0,0
239,5069,2,2,2,0,0,0,2,0,0,0,0,0,0,0,0,0,0,0,0,0
239,5069,99,48,90,1,3,5,100,0,0,0,0,0,0,0,0,0,0,0,0,0
239,5069,8,5,5,2,0,1,10,0,0,0,0,0,0,0,0,0,0,0,0,0
239,5069,1217,716,841,84,126,174,1301,14,185,118,215,199,333,1446,2542,8,20687,1149,0,0
239,5069,160,89,115,0,13,31,160,7,15,11,17,22,28,78,124,3,495,27,0,0
239,5069,10,10,9,9,0,0,19,0,0,0,0,0,0,0,0,0,0,0,0,0
239,5069,173,84,99,8,29,36,181,5,12,7,13,17,20,54,81,2,221,12,0,0
239,5069,3,1,1,3,0,0,6,0,0,0,0,0,0,0,0,0,0,0,0,0
232,5896,722,423,573,19,0,135,741,12,172,101,199,184,300,1320,2257,6,15668,870,0,0
232,5896,1508,847,911,44,250,301,1552,14,148,88,169,162,257,1120,1886,7,15077,837,0,0
111,6056,1457,730,1242,11,6,188,1468,10,292,166,329,302,495,2424,4078,5,22973,1276,1,0
88,3442,1043,504,840,53,9,147,1096,9,180,112,198,189,310,1377,2344,4,11604,644,0,0
20,983,386,256,301,16,9,68,402,4,59,35,69,63,104,355,621,2,1453,80,0,0
20,983,264,131,164,11,41,46,275,6,38,22,40,44,62,214,338,3,1068,59,0,0
102,2626,1455,414,1257,16,76,112,1471,5,41,23,46,46,69,231,381,2,1069,59,0,0
102,2626,669,365,481,22,61,110,691,15,103,63,122,118,185,747,1273,8,11311,628,0,0
103,2636,1455,414,1257,16,76,112,1471,5,41,23,46,46,69,231,381,2,1069,59,0,0
103,2636,669,365,481,22,61,110,691,15,103,63,122,118,185,747,1273,8,11311,628,0,0
103,2720,1455,414,1257,16,76,112,1471,5,41,23,46,46,69,231,381,2,1069,59,0,1
103,2720,669,365,481,22,61,110,691,15,103,63,122,118,185,747,1273,8,11311,628,0,1
81,3715,1455,414,1257,16,76,112,1471,5,41,23,46,46,69,231,381,2,1069,59,0,1
105,2793,773,422,505,30,103,129,803,14,77,46,83,91,129,535,839,7,6334,351,0,0
23,625,601,196,481,2,23,85,603,8,63,36,72,71,108,400,664,4,3036,168,0,0
23,625,156,79,106,5,16,28,161,5,14,8,15,19,23,64,97,2,261,14,0,0
85,2046,996,429,845,24,10,117,1020,7,76,50,88,83,138,494,879,4,3565,198,0,0
85,2046,456,277,329,12,42,72,468,13,85,50,97,98,147,592,972,7,7212,400,0,0
288,6168,1943,715,1694,26,18,214,1969,12,185,120,237,197,357,1436,2721,7,20915,1161,0,0
288,6168,1168,838,957,57,25,144,1225,19,348,224,416,367,640,3018,5452,11,61921,3440,1,0
161,3438,1513,682,1277,25,13,200,1538,11,199,116,219,210,335,1557,2584,6,15641,868,0,0
161,3438,819,519,539,24,98,155,843,15,96,57,106,111,163,690,1107,8,9171,509,0,0
120,5074,1513,682,1277,25,13,200,1538,11,199,116,219,210,335,1557,2584,6,15641,868,0,0
65,1379,91,45,69,0,3,18,91,3,9,6,10,12,16,33,57,1,95,5,0,0
65,1379,367,234,237,17,34,68,384,16,55,34,61,71,95,381,584,8,5183,287,0,0
39,1798,442,244,305,14,16,103,456,11,68,45,75,79,120,452,756,6,4588,254,0,0
184,5417,1660,832,1314,41,38,274,1701,20,312,209,395,332,604,2671,5058,12,64042,3557,1,0
184,5417,1057,646,719,113,100,145,1170,18,215,134,248,233,382,1740,3004,10,31186,1732,1,0
103,2720,1455,414,1257,16,76,112,1471,5,41,23,46,46,69,231,381,2,1069,59,0,0
103,2720,669,365,481,22,61,110,691,15,103,63,122,118,185,747,1273,8,11311,628,0,0
233,5923,722,423,573,19,0,135,741,12,172,101,199,184,300,1320,2257,6,15668,870,0,1
233,5923,1508,847,911,44,250,301,1552,14,148,88,169,162,257,1120,1886,7,15077,837,0,1
59,3032,722,423,573,19,0,135,741,12,172,101,199,184,300,1320,2257,6,15668,870,0,1
233,5913,722,423,573,19,0,135,741,12,172,101,199,184,300,1320,2257,6,15668,870,0,0
233,5913,1508,847,911,44,250,301,1552,14,148,88,169,162,257,1120,1886,7,15077,837,0,0
59,3032,722,423,573,19,0,135,741,12,172,101,199,184,300,1320,2257,6,15668,870,0,0
233,5911,722,423,573,19,0,135,741,12,172,101,199,184,300,1320,2257,6,15668,870,0,0
233,5911,1508,847,911,44,250,301,1552,14,148,88,169,162,257,1120,1886,7,15077,837,0,0
81,3715,1455,414,1257,16,76,112,1471,5,41,23,46,46,69,231,381,2,1069,59,0,0
232,5986,722,423,573,19,0,135,741,12,172,101,199,184,300,1320,2257,6,15668,870,0,1
232,5986,1508,847,911,44,250,301,1552,14,148,88,169,162,257,1120,1886,7,15077,837,0,1
60,3137,722,423,573,19,0,135,741,12,172,101,199,184,300,1320,2257,6,15668,870,0,1
233,5989,722,423,573,19,0,135,741,12,172,101,199,184,300,1320,2257,6,15668,870,0,0
233,5989,1508,847,911,44,250,301,1552,14,148,88,169,162,257,1120,1886,7,15077,837,0,0
60,3175,722,423,573,19,0,135,741,12,172,101,199,184,300,1320,2257,6,15668,870,0,0
85,2057,996,429,845,24,10,117,1020,7,76,50,88,83,138,494,879,4,3565,198,0,0
85,2057,456,277,329,12,42,72,468,13,85,50,97,98,147,592,972,7,7212,400,0,0
49,3797,996,429,845,24,10,117,1020,7,76,50,88,83,138,494,879,4,3565,198,0,0
80,1970,757,253,292,73,244,162,830,13,61,38,67,74,105,409,651,7,4654,258,0,0
66,4451,520,294,400,33,13,81,553,10,261,204,367,271,571,2128,4614,7,32445,1802,1,0
65,4328,520,294,400,33,13,81,553,10,261,204,367,271,571,2128,4614,7,32445,1802,1,0
290,6183,1943,715,1694,26,18,214,1969,12,185,120,237,197,357,1436,2721,7,20915,1161,0,0
290,6183,1168,838,957,57,25,144,1225,19,348,224,416,367,640,3018,5452,11,61921,3440,1,0
113,6684,1943,715,1694,26,18,214,1969,12,185,120,237,197,357,1436,2721,7,20915,1161,0,0
117,2936,773,422,505,30,103,129,803,14,77,46,83,91,129,535,839,7,6334,351,0,0
3,501,149,67,118,4,0,27,153,1,17,14,28,18,42,69,175,0,144,8,0,0
187,5471,1660,832,1314,41,38,274,1701,20,312,209,395,332,604,2671,5058,12,64042,3557,1,1
187,5471,1057,646,719,113,100,145,1170,18,215,134,248,233,382,1740,3004,10,31186,1732,1,1
189,6306,1660,832,1314,41,38,274,1701,20,312,209,395,332,604,2671,5058,12,64042,3557,1,1
105,2748,773,422,505,30,103,129,803,14,77,46,83,91,129,535,839,7,6334,351,0,0
15,1033,215,129,180,6,0,29,221,8,65,43,72,73,115,415,711,4,3153,175,0,0
186,5480,1660,832,1314,41,38,274,1701,20,312,209,395,332,604,2671,5058,12,64042,3557,1,0
186,5480,1057,646,719,113,100,145,1170,18,215,134,248,233,382,1740,3004,10,31186,1732,1,0
59,1223,207,111,150,11,0,50,218,5,26,19,36,31,55,133,272,3,943,52,0,0
59,1223,410,198,237,31,55,97,441,11,63,38,72,74,110,414,683,6,4293,238,0,0
189,6308,1660,832,1314,41,38,274,1701,20,312,209,395,332,604,2671,5058,12,64042,3557,1,0
60,1550,91,45,69,0,3,18,91,3,9,6,10,12,16,33,57,1,95,5,0,0
60,1550,367,234,237,17,34,68,384,16,55,34,61,71,95,381,584,8,5183,287,0,0
18,704,442,244,305,14,16,103,456,11,68,45,75,79,120,452,756,6,4588,254,0,0
18,704,182,102,99,11,40,35,193,3,11,6,11,14,17,42,64,1,97,5,0,0
232,5973,722,423,573,19,0,135,741,12,172,101,199,184,300,1320,2257,6,15668,870,0,0
232,5973,1508,847,911,44,250,301,1552,14,148,88,169,162,257,1120,1886,7,15077,837,0,0
105,2787,773,422,505,30,103,129,803,14,77,46,83,91,129,535,839,7,6334,351,0,0
120,5072,1513,682,1277,25,13,200,1538,11,199,116,219,210,335,1557,2584,6,15641,868,0,0
120,5076,1513,682,1277,25,13,200,1538,11,199,116,219,210,335,1557,2584,6,15641,868,0,0
24,608,2,2,2,0,0,0,2,0,0,0,0,0,0,0,0,0,0,0,0,0
24,608,99,48,90,1,3,5,100,0,0,0,0,0,0,0,0,0,0,0,0,0
24,608,8,5,5,2,0,1,10,0,0,0,0,0,0,0,0,0,0,0,0,0
24,608,1217,716,841,84,126,174,1301,14,185,118,215,199,333,1446,2542,8,20687,1149,0,0
24,608,160,89,115,0,13,31,160,7,15,11,17,22,28,78,124,3,495,27,0,0
24,608,10,10,9,9,0,0,19,0,0,0,0,0,0,0,0,0,0,0,0,0
24,608,173,84,99,8,29,36,181,5,12,7,13,17,20,54,81,2,221,12,0,0
24,608,3,1,1,3,0,0,6,0,0,0,0,0,0,0,0,0,0,0,0,0
235,6063,722,423,573,19,0,135,741,12,172,101,199,184,300,1320,2257,6,15668,870,0,0
235,6063,1508,847,911,44,250,301,1552,14,148,88,169,162,257,1120,1886,7,15077,837,0,0
62,3231,722,423,573,19,0,135,741,12,172,101,199,184,300,1320,2257,6,15668,870,0,0
143,3484,77,34,69,0,0,8,77,3,24,16,29,27,45,114,213,1,387,21,0,0
143,3484,712,438,573,51,9,84,763,14,102,71,128,116,199,733,1364,8,11988,666,0,0
292,6223,1943,715,1694,26,18,214,1969,12,185,120,237,197,357,1436,2721,7,20915,1161,0,0
292,6223,1168,838,957,57,25,144,1225,19,348,224,416,367,640,3018,5452,11,61921,3440,1,0
112,6661,1943,715,1694,26,18,214,1969,12,185,120,237,197,357,1436,2721,7,20915,1161,0,0
119,4999,1513,682,1277,25,13,200,1538,11,199,116,219,210,335,1557,2584,6,15641,868,0,0
234,6047,722,423,573,19,0,135,741,12,172,101,199,184,300,1320,2257,6,15668,870,0,0
234,6047,1508,847,911,44,250,301,1552,14,148,88,169,162,257,1120,1886,7,15077,837,0,0
69,4366,520,294,400,33,13,81,553,10,261,204,367,271,571,2128,4614,7,32445,1802,1,0
69,4372,520,294,400,33,13,81,553,10,261,204,367,271,571,2128,4614,7,32445,1802,1,0
17,400,127,75,83,2,11,30,129,4,14,7,14,18,21,61,87,2,175,9,0,0
17,400,652,304,544,16,6,88,668,6,89,51,101,95,152,591,998,3,3399,188,0,0
17,400,2,2,2,0,0,0,2,0,0,0,0,0,0,0,0,0,0,0,0,0
17,400,8,5,5,0,0,3,8,0,0,0,0,0,0,0,0,0,0,0,0,0
17,400,14,8,8,0,0,6,14,0,0,0,0,0,0,0,0,0,0,0,0,0
17,400,6,4,4,0,0,2,6,0,0,0,0,0,0,0,0,0,0,0,0,0
17,400,6,4,4,0,0,2,6,1,2,1,2,3,3,2,4,0,2,0,0,0
17,400,7,5,5,0,0,2,7,0,0,0,0,0,0,0,0,0,0,0,0,0
17,400,10,6,6,0,0,4,10,0,0,0,0,0,0,0,0,0,0,0,0,0
17,400,1,1,1,0,0,0,1,0,0,0,0,0,0,0,0,0,0,0,0,0
17,400,14,10,10,0,0,4,14,1,1,1,1,2,2,0,2,0,1,0,0,0
17,400,46,26,30,3,0,12,49,3,6,3,6,9,9,20,28,1,42,2,0,0
40,786,1178,367,1042,6,15,115,1184,9,94,51,95,103,146,644,976,4,4439,246,0,0
40,786,177,108,140,8,0,27,185,6,30,16,32,36,48,162,248,3,794,44,0,0
292,6221,1943,715,1694,26,18,214,1969,12,185,120,237,197,357,1436,2721,7,20915,1161,0,0
292,6221,1168,838,957,57,25,144,1225,19,348,224,416,367,640,3018,5452,11,61921,3440,1,0
120,5079,1513,682,1277,25,13,200,1538,11,199,116,219,210,335,1557,2584,6,15641,868,0,0
239,5071,2,2,2,0,0,0,2,0,0,0,0,0,0,0,0,0,0,0,0,0
239,5071,99,48,90,1,3,5,100,0,0,0,0,0,0,0,0,0,0,0,0,0
239,5071,8,5,5,2,0,1,10,0,0,0,0,0,0,0,0,0,0,0,0,0
239,5071,1217,716,841,84,126,174,1301,14,185,118,215,199,333,1446,2542,8,20687,1149,0,0
239,5071,160,89,115,0,13,31,160,7,15,11,17,22,28,78,124,3,495,27,0,0
239,5071,10,10,9,9,0,0,19,0,0,0,0,0,0,0,0,0,0,0,0,0
239,5071,173,84,99,8,29,36,181,5,12,7,13,17,20,54,81,2,221,12,0,0
239,5071,3,1,1,3,0,0,6,0,0,0,0,0,0,0,0,0,0,0,0,0
237,5056,2,2,2,0,0,0,2,0,0,0,0,0,0,0,0,0,0,0,0,0
237,5056,99,48,90,1,3,5,100,0,0,0,0,0,0,0,0,0,0,0,0,0
237,5056,8,5,5,2,0,1,10,0,0,0,0,0,0,0,0,0,0,0,0,0
237,5056,1217,716,841,84,126,174,1301,14,185,118,215,199,333,1446,2542,8,20687,1149,0,0
237,5056,160,89,115,0,13,31,160,7,15,11,17,22,28,78,124,3,495,27,0,0
237,5056,10,10,9,9,0,0,19,0,0,0,0,0,0,0,0,0,0,0,0,0
237,5056,173,84,99,8,29,36,181,5,12,7,13,17,20,54,81,2,221,12,0,0
237,5056,3,1,1,3,0,0,6,0,0,0,0,0,0,0,0,0,0,0,0,0
54,642,647,139,84,35,284,233,682,0,0,0,0,0,0,0,0,0,0,0,0,0
30,1924,384,251,317,7,8,52,391,11,70,44,84,81,128,467,811,6,5355,297,0,0
57,1473,339,213,244,17,9,65,356,10,42,26,48,52,74,259,421,5,2410,133,0,1
78,4151,1293,570,1093,25,15,163,1318,10,195,123,241,205,364,1516,2795,6,17273,959,0,1
57,1473,339,213,244,17,9,65,356,10,42,26,48,52,74,259,421,5,2410,133,0,0
78,4151,1293,570,1093,25,15,163,1318,10,195,123,241,205,364,1516,2795,6,17273,959,0,0
66,1699,53,23,39,0,0,13,53,2,8,4,8,10,12,26,39,1,39,2,0,0
66,1699,515,298,307,33,80,99,548,12,63,44,77,75,121,419,753,7,5527,307,0,0
294,6238,1943,715,1694,26,18,214,1969,12,185,120,237,197,357,1436,2721,7,20915,1161,0,0
294,6238,1168,838,957,57,25,144,1225,19,348,224,416,367,640,3018,5452,11,61921,3440,1,0
113,6713,1943,715,1694,26,18,214,1969,12,185,120,237,197,357,1436,2721,7,20915,1161,0,0
12,320,149,95,105,2,0,41,151,8,54,28,55,62,83,334,494,4,2013,111,0,0
12,320,82,56,54,0,13,15,82,4,13,8,16,17,24,56,98,2,241,13,0,0
121,2276,477,336,357,30,23,73,507,16,194,134,250,210,384,1538,2962,10,30538,1696,0,0
73,2511,477,336,357,30,23,73,507,16,194,134,250,210,384,1538,2962,10,30538,1696,0,0
49,1715,601,196,481,2,23,85,603,8,63,36,72,71,108,400,664,4,3036,168,0,0
112,6693,1943,715,1694,26,18,214,1969,12,185,120,237,197,357,1436,2721,7,20915,1161,0,0
296,6307,1943,715,1694,26,18,214,1969,12,185,120,237,197,357,1436,2721,7,20915,1161,0,0
296,6307,1168,838,957,57,25,144,1225,19,348,224,416,367,640,3018,5452,11,61921,3440,1,0
114,6826,1943,715,1694,26,18,214,1969,12,185,120,237,197,357,1436,2721,7,20915,1161,0,0
114,2105,477,336,357,30,23,73,507,16,194,134,250,210,384,1538,2962,10,30538,1696,0,0
217,5035,182,127,129,0,0,53,182,5,39,21,42,44,63,217,343,2,926,51,0,1
217,5035,1165,710,800,67,119,181,1232,18,243,153,282,261,435,2000,3492,10,36473,2026,1,1
103,2729,1455,414,1257,16,76,112,1471,5,41,23,46,46,69,231,381,2,1069,59,0,1
103,2729,669,365,481,22,61,110,691,15,103,63,122,118,185,747,1273,8,11311,628,0,1
261,6241,4293,999,3693,19,54,507,4312,9,155,88,170,164,258,1156,1898,4,9368,520,0,1
261,6241,1482,859,1002,125,135,219,1607,16,219,134,251,235,385,1766,3032,9,27804,1544,1,1
143,3505,77,34,69,0,0,8,77,3,24,16,29,27,45,114,213,1,387,21,0,1
143,3505,712,438,573,51,9,84,763,14,102,71,128,116,199,733,1364,8,11988,666,0,1
63,1828,53,23,39,0,0,13,53,2,8,4,8,10,12,26,39,1,39,2,0,1
63,1828,515,298,307,33,80,99,548,12,63,44,77,75,121,419,753,7,5527,307,0,1
303,6698,72,33,56,0,4,12,72,1,1,1,1,2,2,0,2,0,1,0,0,1
303,6698,1454,835,1044,76,110,219,1530,17,275,158,296,292,454,2297,3718,9,34017,1889,1,1
78,1979,466,257,367,18,25,50,484,7,126,86,171,133,257,898,1813,4,8612,478,0,1
78,1979,507,281,342,29,59,88,536,10,53,29,57,63,86,336,514,5,2764,153,0,1
87,1930,1043,504,840,53,9,147,1096,9,180,112,198,189,310,1377,2344,4,11604,644,0,1
87,1930,383,288,292,26,6,62,409,11,65,38,67,76,105,429,656,5,3719,206,0,1
148,7107,1392,870,1177,35,17,170,1427,14,494,280,531,508,811,4473,7289,7,54850,3047,2,1
217,5035,182,127,129,0,0,53,182,5,39,21,42,44,63,217,343,2,926,51,0,0
217,5035,1165,710,800,67,119,181,1232,18,243,153,282,261,435,2000,3492,10,36473,2026,1,0
103,2729,1455,414,1257,16,76,112,1471,5,41,23,46,46,69,231,381,2,1069,59,0,0
103,2729,669,365,481,22,61,110,691,15,103,63,122,118,185,747,1273,8,11311,628,0,0
261,6241,4293,999,3693,19,54,507,4312,9,155,88,170,164,258,1156,1898,4,9368,520,0,0
261,6241,1482,859,1002,125,135,219,1607,16,219,134,251,235,385,1766,3032,9,27804,1544,1,0
143,3505,77,34,69,0,0,8,77,3,24,16,29,27,45,114,213,1,387,21,0,0
143,3505,712,438,573,51,9,84,763,14,102,71,128,116,199,733,1364,8,11988,666,0,0
63,1828,53,23,39,0,0,13,53,2,8,4,8,10,12,26,39,1,39,2,0,0
63,1828,515,298,307,33,80,99,548,12,63,44,77,75,121,419,753,7,5527,307,0,0
303,6698,72,33,56,0,4,12,72,1,1,1,1,2,2,0,2,0,1,0,0,0
303,6698,1454,835,1044,76,110,219,1530,17,275,158,296,292,454,2297,3718,9,34017,1889,1,0
78,1979,466,257,367,18,25,50,484,7,126,86,171,133,257,898,1813,4,8612,478,0,0
78,1979,507,281,342,29,59,88,536,10,53,29,57,63,86,336,514,5,2764,153,0,0
87,1930,1043,504,840,53,9,147,1096,9,180,112,198,189,310,1377,2344,4,11604,644,0,0
87,1930,383,288,292,26,6,62,409,11,65,38,67,76,105,429,656,5,3719,206,0,0
148,7107,1392,870,1177,35,17,170,1427,14,494,280,531,508,811,4473,7289,7,54850,3047,2,0
49,3865,996,429,845,24,10,117,1020,7,76,50,88,83,138,494,879,4,3565,198,0,0
51,3873,996,429,845,24,10,117,1020,7,76,50,88,83,138,494,879,4,3565,198,0,0
51,3885,996,429,845,24,10,117,1020,7,76,50,88,83,138,494,879,4,3565,198,0,0
113,6806,1943,715,1694,26,18,214,1969,12,185,120,237,197,357,1436,2721,7,20915,1161,0,0
117,2969,773,422,505,30,103,129,803,14,77,46,83,91,129,535,839,7,6334,351,0,0
73,2511,477,336,357,30,23,73,507,16,194,134,250,210,384,1538,2962,10,30538,1696,0,1
125,5319,1450,624,1228,12,26,181,1462,14,306,186,354,320,540,2580,4493,8,36391,2021,1,1
56,1826,53,23,39,0,0,13,53,2,8,4,8,10,12,26,39,1,39,2,0,0
56,1826,515,298,307,33,80,99,548,12,63,44,77,75,121,419,753,7,5527,307,0,0
119,5003,1513,682,1277,25,13,200,1538,11,199,116,219,210,335,1557,2584,6,15641,868,0,0
296,6305,1943,715,1694,26,18,214,1969,12,185,120,237,197,357,1436,2721,7,20915,1161,0,0
296,6305,1168,838,957,57,25,144,1225,19,348,224,416,367,640,3018,5452,11,61921,3440,1,0
73,2508,477,336,357,30,23,73,507,16,194,134,250,210,384,1538,2962,10,30538,1696,0,0
57,1477,339,213,244,17,9,65,356,10,42,26,48,52,74,259,421,5,2410,133,0,0
79,4230,1293,570,1093,25,15,163,1318,10,195,123,241,205,364,1516,2795,6,17273,959,0,0
119,5010,1513,682,1277,25,13,200,1538,11,199,116,219,210,335,1557,2584,6,15641,868,0,0
239,5077,2,2,2,0,0,0,2,0,0,0,0,0,0,0,0,0,0,0,0,0
239,5077,99,48,90,1,3,5,100,0,0,0,0,0,0,0,0,0,0,0,0,0
239,5077,8,5,5,2,0,1,10,0,0,0,0,0,0,0,0,0,0,0,0,0
239,5077,1217,716,841,84,126,174,1301,14,185,118,215,199,333,1446,2542,8,20687,1149,0,0
239,5077,160,89,115,0,13,31,160,7,15,11,17,22,28,78,124,3,495,27,0,0
239,5077,10,10,9,9,0,0,19,0,0,0,0,0,0,0,0,0,0,0,0,0
239,5077,173,84,99,8,29,36,181,5,12,7,13,17,20,54,81,2,221,12,0,0
239,5077,3,1,1,3,0,0,6,0,0,0,0,0,0,0,0,0,0,0,0,0
306,6763,72,33,56,0,4,12,72,1,1,1,1,2,2,0,2,0,1,0,0,0
306,6763,1454,835,1044,76,110,219,1530,17,275,158,296,292,454,2297,3718,9,34017,1889,1,0
80,3116,1178,367,1042,6,15,115,1184,9,94,51,95,103,146,644,976,4,4439,246,0,0
13,539,124,78,88,2,3,26,126,4,13,7,13,17,20,56,81,2,163,9,0,0
125,5319,1450,624,1228,12,26,181,1462,14,306,186,354,320,540,2580,4493,8,36391,2021,1,0
18,382,149,95,105,2,0,41,151,8,54,28,55,62,83,334,494,4,2013,111,0,0
18,382,82,56,54,0,13,15,82,4,13,8,16,17,24,56,98,2,241,13,0,0
24,691,149,95,105,2,0,41,151,8,54,28,55,62,83,334,494,4,2013,111,0,0
24,694,149,95,105,2,0,41,151,8,54,28,55,62,83,334,494,4,2013,111,0,0
143,3503,77,34,69,0,0,8,77,3,24,16,29,27,45,114,213,1,387,21,0,0
143,3503,712,438,573,51,9,84,763,14,102,71,128,116,199,733,1364,8,11988,666,0,0
100,2883,773,419,590,28,0,166,801,10,204,113,217,214,330,1598,2554,5,13587,754,0,0
125,5340,1450,624,1228,12,26,181,1462,14,306,186,354,320,540,2580,4493,8,36391,2021,1,0
148,7121,1392,870,1177,35,17,170,1427,14,494,280,531,508,811,4473,7289,7,54850,3047,2,0
106,4685,1289,550,1043,56,32,155,1345,10,167,93,185,177,278,1266,2075,5,11498,638,0,0
61,1561,91,45,69,0,3,18,91,3,9,6,10,12,16,33,57,1,95,5,0,0
61,1561,367,234,237,17,34,68,384,16,55,34,61,71,95,381,584,8,5183,287,0,0
40,1853,442,244,305,14,16,103,456,11,68,45,75,79,120,452,756,6,4588,254,0,0
40,1859,442,244,305,14,16,103,456,11,68,45,75,79,120,452,756,6,4588,254,0,0
2,222,37,13,25,0,6,6,37,1,2,1,2,3,3,2,4,0,2,0,0,0
2,222,133,47,40,1,43,49,134,0,0,0,0,0,0,0,0,0,0,0,0,0
58,1732,773,419,590,28,0,166,801,10,204,113,217,214,330,1598,2554,5,13587,754,0,1
58,1732,421,273,302,44,34,57,465,17,81,59,107,98,166,583,1098,11,12329,684,0,1
227,6311,722,423,573,19,0,135,741,12,172,101,199,184,300,1320,2257,6,15668,870,0,0
227,6311,1508,847,911,44,250,301,1552,14,148,88,169,162,257,1120,1886,7,15077,837,0,0
58,1732,773,419,590,28,0,166,801,10,204,113,217,214,330,1598,2554,5,13587,754,0,0
58,1732,421,273,302,44,34,57,465,17,81,59,107,98,166,583,1098,11,12329,684,0,0
191,5617,1660,832,1314,41,38,274,1701,20,312,209,395,332,604,2671,5058,12,64042,3557,1,0
191,5617,1057,646,719,113,100,145,1170,18,215,134,248,233,382,1740,3004,10,31186,1732,1,0
191,6340,1660,832,1314,41,38,274,1701,20,312,209,395,332,604,2671,5058,12,64042,3557,1,0
28,596,2,2,2,0,0,0,2,0,0,0,0,0,0,0,0,0,0,0,0,0
28,596,99,48,90,1,3,5,100,0,0,0,0,0,0,0,0,0,0,0,0,0
28,596,8,5,5,2,0,1,10,0,0,0,0,0,0,0,0,0,0,0,0,0
28,596,1217,716,841,84,126,174,1301,14,185,118,215,199,333,1446,2542,8,20687,1149,0,0
28,596,160,89,115,0,13,31,160,7,15,11,17,22,28,78,124,3,495,27,0,0
28,596,10,10,9,9,0,0,19,0,0,0,0,0,0,0,0,0,0,0,0,0
28,596,173,84,99,8,29,36,181,5,12,7,13,17,20,54,81,2,221,12,0,0
28,596,3,1,1,3,0,0,6,0,0,0,0,0,0,0,0,0,0,0,0,0
77,2606,477,336,357,30,23,73,507,16,194,134,250,210,384,1538,2962,10,30538,1696,0,0
127,5419,1450,624,1228,12,26,181,1462,14,306,186,354,320,540,2580,4493,8,36391,2021,1,0
302,6691,72,33,56,0,4,12,72,1,1,1,1,2,2,0,2,0,1,0,0,0
302,6691,1454,835,1044,76,110,219,1530,17,275,158,296,292,454,2297,3718,9,34017,1889,1,0
70,3147,1020,354,843,12,15,144,1032,8,134,77,144,142,221,970,1580,4,6792,377,0,0
68,1510,402,202,227,24,74,80,426,12,52,33,61,64,94,339,564,7,3969,220,0,0
68,1479,402,202,227,24,74,80,426,12,52,33,61,64,94,339,564,7,3969,220,0,0
70,3140,1020,354,843,12,15,144,1032,8,134,77,144,142,221,970,1580,4,6792,377,0,0
71,3197,1020,354,843,12,15,144,1032,8,134,77,144,142,221,970,1580,4,6792,377,0,0
31,1070,74,35,59,1,0,14,75,3,14,7,14,17,21,58,85,1,128,7,0,0
31,1070,245,125,200,5,7,34,250,7,30,17,34,37,51,166,265,3,1053,58,0,0
78,1993,466,257,367,18,25,50,484,7,126,86,171,133,257,898,1813,4,8612,478,0,1
78,1993,507,281,342,29,59,88,536,10,53,29,57,63,86,336,514,5,2764,153,0,1
296,6372,1943,715,1694,26,18,214,1969,12,185,120,237,197,357,1436,2721,7,20915,1161,0,1
296,6372,1168,838,957,57,25,144,1225,19,348,224,416,367,640,3018,5452,11,61921,3440,1,1
78,1993,466,257,367,18,25,50,484,7,126,86,171,133,257,898,1813,4,8612,478,0,0
78,1993,507,281,342,29,59,88,536,10,53,29,57,63,86,336,514,5,2764,153,0,0
296,6372,1943,715,1694,26,18,214,1969,12,185,120,237,197,357,1436,2721,7,20915,1161,0,0
296,6372,1168,838,957,57,25,144,1225,19,348,224,416,367,640,3018,5452,11,61921,3440,1,0
64,1418,207,111,150,11,0,50,218,5,26,19,36,31,55,133,272,3,943,52,0,1
64,1418,410,198,237,31,55,97,441,11,63,38,72,74,110,414,683,6,4293,238,0,1
55,1815,53,23,39,0,0,13,53,2,8,4,8,10,12,26,39,1,39,2,0,1
55,1815,515,298,307,33,80,99,548,12,63,44,77,75,121,419,753,7,5527,307,0,1
25,591,207,111,150,11,0,50,218,5,26,19,36,31,55,133,272,3,943,52,0,1
56,1884,53,23,39,0,0,13,53,2,8,4,8,10,12,26,39,1,39,2,0,0
56,1884,515,298,307,33,80,99,548,12,63,44,77,75,121,419,753,7,5527,307,0,0
64,1418,207,111,150,11,0,50,218,5,26,19,36,31,55,133,272,3,943,52,0,0
64,1418,410,198,237,31,55,97,441,11,63,38,72,74,110,414,683,6,4293,238,0,0
55,1815,53,23,39,0,0,13,53,2,8,4,8,10,12,26,39,1,39,2,0,0
55,1815,515,298,307,33,80,99,548,12,63,44,77,75,121,419,753,7,5527,307,0,0
25,591,207,111,150,11,0,50,218,5,26,19,36,31,55,133,272,3,943,52,0,0
145,5858,1782,648,1425,9,47,279,1791,8,171,97,189,179,286,1292,2140,4,9462,525,0,0
55,1873,53,23,39,0,0,13,53,2,8,4,8,10,12,26,39,1,39,2,0,0
55,1873,515,298,307,33,80,99,548,12,63,44,77,75,121,419,753,7,5527,307,0,0
227,6314,722,423,573,19,0,135,741,12,172,101,199,184,300,1320,2257,6,15668,870,0,0
227,6314,1508,847,911,44,250,301,1552,14,148,88,169,162,257,1120,1886,7,15077,837,0,0
227,6345,722,423,573,19,0,135,741,12,172,101,199,184,300,1320,2257,6,15668,870,0,0
227,6345,1508,847,911,44,250,301,1552,14,148,88,169,162,257,1120,1886,7,15077,837,0,0
127,5424,1450,624,1228,12,26,181,1462,14,306,186,354,320,540,2580,4493,8,36391,2021,1,0
298,6416,1943,715,1694,26,18,214,1969,12,185,120,237,197,357,1436,2721,7,20915,1161,0,0
298,6416,1168,838,957,57,25,144,1225,19,348,224,416,367,640,3018,5452,11,61921,3440,1,0
85,4946,1296,573,1062,40,33,157,1336,8,201,118,231,209,349,1561,2689,4,12365,686,0,0
114,6852,1943,715,1694,26,18,214,1969,12,185,120,237,197,357,1436,2721,7,20915,1161,0,0
118,3197,1523,757,1297,19,12,193,1542,12,193,117,230,205,347,1508,2664,7,19053,1058,0,0
118,3197,701,378,504,33,58,109,734,13,110,68,126,123,194,794,1346,7,10027,557,0,0
7,265,75,38,59,1,3,12,76,2,4,2,4,6,6,10,15,1,15,0,0,0
307,6777,72,33,56,0,4,12,72,1,1,1,1,2,2,0,2,0,1,0,0,0
307,6777,1454,835,1044,76,110,219,1530,17,275,158,296,292,454,2297,3718,9,34017,1889,1,0
149,5988,1782,648,1425,9,47,279,1791,8,171,97,189,179,286,1292,2140,4,9462,525,0,0
239,5075,2,2,2,0,0,0,2,0,0,0,0,0,0,0,0,0,0,0,0,0
239,5075,99,48,90,1,3,5,100,0,0,0,0,0,0,0,0,0,0,0,0,0
239,5075,8,5,5,2,0,1,10,0,0,0,0,0,0,0,0,0,0,0,0,0
239,5075,1217,716,841,84,126,174,1301,14,185,118,215,199,333,1446,2542,8,20687,1149,0,0
239,5075,160,89,115,0,13,31,160,7,15,11,17,22,28,78,124,3,495,27,0,0
239,5075,10,10,9,9,0,0,19,0,0,0,0,0,0,0,0,0,0,0,0,0
239,5075,173,84,99,8,29,36,181,5,12,7,13,17,20,54,81,2,221,12,0,0
239,5075,3,1,1,3,0,0,6,0,0,0,0,0,0,0,0,0,0,0,0,0
304,6699,72,33,56,0,4,12,72,1,1,1,1,2,2,0,2,0,1,0,0,0
304,6699,1454,835,1044,76,110,219,1530,17,275,158,296,292,454,2297,3718,9,34017,1889,1,0
87,5041,1296,573,1062,40,33,157,1336,8,201,118,231,209,349,1561,2689,4,12365,686,0,0
191,5619,1660,832,1314,41,38,274,1701,20,312,209,395,332,604,2671,5058,12,64042,3557,1,0
191,5619,1057,646,719,113,100,145,1170,18,215,134,248,233,382,1740,3004,10,31186,1732,1,0
239,5079,2,2,2,0,0,0,2,0,0,0,0,0,0,0,0,0,0,0,0,0
239,5079,99,48,90,1,3,5,100,0,0,0,0,0,0,0,0,0,0,0,0,0
239,5079,8,5,5,2,0,1,10,0,0,0,0,0,0,0,0,0,0,0,0,0
239,5079,1217,716,841,84,126,174,1301,14,185,118,215,199,333,1446,2542,8,20687,1149,0,0
239,5079,160,89,115,0,13,31,160,7,15,11,17,22,28,78,124,3,495,27,0,0
239,5079,10,10,9,9,0,0,19,0,0,0,0,0,0,0,0,0,0,0,0,0
239,5079,173,84,99,8,29,36,181,5,12,7,13,17,20,54,81,2,221,12,0,0
239,5079,3,1,1,3,0,0,6,0,0,0,0,0,0,0,0,0,0,0,0,0
191,6342,1660,832,1314,41,38,274,1701,20,312,209,395,332,604,2671,5058,12,64042,3557,1,0
111,6058,1457,730,1242,11,6,188,1468,10,292,166,329,302,495,2424,4078,5,22973,1276,1,0
46,2850,652,304,544,16,6,88,668,6,89,51,101,95,152,591,998,3,3399,188,0,0
113,5659,1523,757,1297,19,12,193,1542,12,193,117,230,205,347,1508,2664,7,19053,1058,0,0
303,6705,72,33,56,0,4,12,72,1,1,1,1,2,2,0,2,0,1,0,0,0
303,6705,1454,835,1044,76,110,219,1530,17,275,158,296,292,454,2297,3718,9,34017,1889,1,0
147,5913,1782,648,1425,9,47,279,1791,8,171,97,189,179,286,1292,2140,4,9462,525,0,0
87,5034,1296,573,1062,40,33,157,1336,8,201,118,231,209,349,1561,2689,4,12365,686,0,0
304,6689,72,33,56,0,4,12,72,1,1,1,1,2,2,0,2,0,1,0,0,0
304,6689,1454,835,1044,76,110,219,1530,17,275,158,296,292,454,2297,3718,9,34017,1889,1,0
20,989,386,256,301,16,9,68,402,4,59,35,69,63,104,355,621,2,1453,80,0,0
20,989,264,131,164,11,41,46,275,6,38,22,40,44,62,214,338,3,1068,59,0,0
117,4986,1513,682,1277,25,13,200,1538,11,199,116,219,210,335,1557,2584,6,15641,868,0,0
217,5015,182,127,129,0,0,53,182,5,39,21,42,44,63,217,343,2,926,51,0,0
217,5015,1165,710,800,67,119,181,1232,18,243,153,282,261,435,2000,3492,10,36473,2026,1,0
148,7106,1392,870,1177,35,17,170,1427,14,494,280,531,508,811,4473,7289,7,54850,3047,2,0
100,2878,773,419,590,28,0,166,801,10,204,113,217,214,330,1598,2554,5,13587,754,0,0
63,1383,207,111,150,11,0,50,218,5,26,19,36,31,55,133,272,3,943,52,0,0
63,1383,410,198,237,31,55,97,441,11,63,38,72,74,110,414,683,6,4293,238,0,0
262,6261,4293,999,3693,19,54,507,4312,9,155,88,170,164,258,1156,1898,4,9368,520,0,0
262,6261,1482,859,1002,125,135,219,1607,16,219,134,251,235,385,1766,3032,9,27804,1544,1,0
304,6734,72,33,56,0,4,12,72,1,1,1,1,2,2,0,2,0,1,0,0,0
304,6734,1454,835,1044,76,110,219,1530,17,275,158,296,292,454,2297,3718,9,34017,1889,1,0
217,5010,182,127,129,0,0,53,182,5,39,21,42,44,63,217,343,2,926,51,0,0
217,5010,1165,710,800,67,119,181,1232,18,243,153,282,261,435,2000,3492,10,36473,2026,1,0
143,6926,1392,870,1177,35,17,170,1427,14,494,280,531,508,811,4473,7289,7,54850,3047,2,0
59,1754,773,419,590,28,0,166,801,10,204,113,217,214,330,1598,2554,5,13587,754,0,0
59,1754,421,273,302,44,34,57,465,17,81,59,107,98,166,583,1098,11,12329,684,0,0
53,1495,207,111,150,11,0,50,218,5,26,19,36,31,55,133,272,3,943,52,0,0
53,1495,410,198,237,31,55,97,441,11,63,38,72,74,110,414,683,6,4293,238,0,0
85,2063,996,429,845,24,10,117,1020,7,76,50,88,83,138,494,879,4,3565,198,0,0
85,2063,456,277,329,12,42,72,468,13,85,50,97,98,147,592,972,7,7212,400,0,0
113,2328,463,295,324,28,62,57,491,12,134,82,154,146,236,989,1696,6,11700,650,0,0
227,6346,722,423,573,19,0,135,741,12,172,101,199,184,300,1320,2257,6,15668,870,0,0
227,6346,1508,847,911,44,250,301,1552,14,148,88,169,162,257,1120,1886,7,15077,837,0,0
185,8005,4293,999,3693,19,54,507,4312,9,155,88,170,164,258,1156,1898,4,9368,520,0,0
185,8005,1482,859,1002,125,135,219,1607,16,219,134,251,235,385,1766,3032,9,27804,1544,1,0
30,921,256,139,192,9,7,47,265,4,23,12,24,27,36,112,171,2,357,19,0,0
85,4954,1296,573,1062,40,33,157,1336,8,201,118,231,209,349,1561,2689,4,12365,686,0,0
71,3199,1020,354,843,12,15,144,1032,8,134,77,144,142,221,970,1580,4,6792,377,0,0
79,3073,1178,367,1042,6,15,115,1184,9,94,51,95,103,146,644,976,4,4439,246,0,0
40,1861,442,244,305,14,16,103,456,11,68,45,75,79,120,452,756,6,4588,254,0,0
51,2042,1098,241,925,5,10,155,1103,7,46,25,49,53,74,273,423,3,1580,87,0,0
186,5483,182,127,129,0,0,53,182,5,39,21,42,44,63,217,343,2,926,51,0,1
186,5483,1165,710,800,67,119,181,1232,18,243,153,282,261,435,2000,3492,10,36473,2026,1,1
31,1010,182,127,129,0,0,53,182,5,39,21,42,44,63,217,343,2,926,51,0,1
143,6943,1392,870,1177,35,17,170,1427,14,494,280,531,508,811,4473,7289,7,54850,3047,2,1
100,3088,773,419,590,28,0,166,801,10,204,113,217,214,330,1598,2554,5,13587,754,0,1
51,3863,996,429,845,24,10,117,1020,7,76,50,88,83,138,494,879,4,3565,198,0,0
186,5483,182,127,129,0,0,53,182,5,39,21,42,44,63,217,343,2,926,51,0,0
186,5483,1165,710,800,67,119,181,1232,18,243,153,282,261,435,2000,3492,10,36473,2026,1,0
31,1010,182,127,129,0,0,53,182,5,39,21,42,44,63,217,343,2,926,51,0,0
143,6943,1392,870,1177,35,17,170,1427,14,494,280,531,508,811,4473,7289,7,54850,3047,2,0
100,3088,773,419,590,28,0,166,801,10,204,113,217,214,330,1598,2554,5,13587,754,0,0
305,6748,72,33,56,0,4,12,72,1,1,1,1,2,2,0,2,0,1,0,0,0
305,6748,1454,835,1044,76,110,219,1530,17,275,158,296,292,454,2297,3718,9,34017,1889,1,0
87,5042,1296,573,1062,40,33,157,1336,8,201,118,231,209,349,1561,2689,4,12365,686,0,0
305,6741,72,33,56,0,4,12,72,1,1,1,1,2,2,0,2,0,1,0,0,0
305,6741,1454,835,1044,76,110,219,1530,17,275,158,296,292,454,2297,3718,9,34017,1889,1,0
306,6756,72,33,56,0,4,12,72,1,1,1,1,2,2,0,2,0,1,0,0,0
306,6756,1454,835,1044,76,110,219,1530,17,275,158,296,292,454,2297,3718,9,34017,1889,1,0
87,5061,1296,573,1062,40,33,157,1336,8,201,118,231,209,349,1561,2689,4,12365,686,0,0
306,6749,72,33,56,0,4,12,72,1,1,1,1,2,2,0,2,0,1,0,0,0
306,6749,1454,835,1044,76,110,219,1530,17,275,158,296,292,454,2297,3718,9,34017,1889,1,0
305,6740,72,33,56,0,4,12,72,1,1,1,1,2,2,0,2,0,1,0,0,0
305,6740,1454,835,1044,76,110,219,1530,17,275,158,296,292,454,2297,3718,9,34017,1889,1,0
147,5922,1782,648,1425,9,47,279,1791,8,171,97,189,179,286,1292,2140,4,9462,525,0,0
191,5605,1660,832,1314,41,38,274,1701,20,312,209,395,332,604,2671,5058,12,64042,3557,1,0
191,5605,1057,646,719,113,100,145,1170,18,215,134,248,233,382,1740,3004,10,31186,1732,1,0
107,4605,1289,550,1043,56,32,155,1345,10,167,93,185,177,278,1266,2075,5,11498,638,0,0
304,6726,72,33,56,0,4,12,72,1,1,1,1,2,2,0,2,0,1,0,0,0
304,6726,1454,835,1044,76,110,219,1530,17,275,158,296,292,454,2297,3718,9,34017,1889,1,0
69,1500,402,202,227,24,74,80,426,12,52,33,61,64,94,339,564,7,3969,220,0,0
302,6686,72,33,56,0,4,12,72,1,1,1,1,2,2,0,2,0,1,0,0,0
302,6686,1454,835,1044,76,110,219,1530,17,275,158,296,292,454,2297,3718,9,34017,1889,1,0
147,5907,1782,648,1425,9,47,279,1791,8,171,97,189,179,286,1292,2140,4,9462,525,0,0
304,6716,72,33,56,0,4,12,72,1,1,1,1,2,2,0,2,0,1,0,0,0
304,6716,1454,835,1044,76,110,219,1530,17,275,158,296,292,454,2297,3718,9,34017,1889,1,0
106,4666,1289,550,1043,56,32,155,1345,10,167,93,185,177,278,1266,2075,5,11498,638,0,0
87,5062,1296,573,1062,40,33,157,1336,8,201,118,231,209,349,1561,2689,4,12365,686,0,0
12,190,110,30,77,3,13,16,113,4,21,15,30,25,45,100,208,2,597,33,0,0
189,5498,1660,832,1314,41,38,274,1701,20,312,209,395,332,604,2671,5058,12,64042,3557,1,0
189,5498,1057,646,719,113,100,145,1170,18,215,134,248,233,382,1740,3004,10,31186,1732,1,0
45,1597,601,196,481,2,23,85,603,8,63,36,72,71,108,400,664,4,3036,168,0,0
301,6672,72,33,56,0,4,12,72,1,1,1,1,2,2,0,2,0,1,0,0,0
301,6672,1454,835,1044,76,110,219,1530,17,275,158,296,292,454,2297,3718,9,34017,1889,1,0
301,6662,72,33,56,0,4,12,72,1,1,1,1,2,2,0,2,0,1,0,0,0
301,6662,1454,835,1044,76,110,219,1530,17,275,158,296,292,454,2297,3718,9,34017,1889,1,0
227,6367,722,423,573,19,0,135,741,12,172,101,199,184,300,1320,2257,6,15668,870,0,1
227,6367,1508,847,911,44,250,301,1552,14,148,88,169,162,257,1120,1886,7,15077,837,0,1
63,3295,722,423,573,19,0,135,741,12,172,101,199,184,300,1320,2257,6,15668,870,0,1
227,6367,722,423,573,19,0,135,741,12,172,101,199,184,300,1320,2257,6,15668,870,0,0
227,6367,1508,847,911,44,250,301,1552,14,148,88,169,162,257,1120,1886,7,15077,837,0,0
63,3295,722,423,573,19,0,135,741,12,172,101,199,184,300,1320,2257,6,15668,870,0,0
1,303,382,65,130,157,2,92,539,4,10,5,10,14,15,41,57,2,114,6,0,0
227,6370,722,423,573,19,0,135,741,12,172,101,199,184,300,1320,2257,6,15668,870,0,0
227,6370,1508,847,911,44,250,301,1552,14,148,88,169,162,257,1120,1886,7,15077,837,0,0
88,3448,1043,504,840,53,9,147,1096,9,180,112,198,189,310,1377,2344,4,11604,644,0,0
88,1929,1043,504,840,53,9,147,1096,9,180,112,198,189,310,1377,2344,4,11604,644,0,0
88,1929,383,288,292,26,6,62,409,11,65,38,67,76,105,429,656,5,3719,206,0,0
1,322,382,65,130,157,2,92,539,4,10,5,10,14,15,41,57,2,114,6,0,0
145,3551,77,34,69,0,0,8,77,3,24,16,29,27,45,114,213,1,387,21,0,0
145,3551,712,438,573,51,9,84,763,14,102,71,128,116,199,733,1364,8,11988,666,0,0
4,216,77,34,69,0,0,8,77,3,24,16,29,27,45,114,213,1,387,21,0,0
298,6420,1943,715,1694,26,18,214,1969,12,185,120,237,197,357,1436,2721,7,20915,1161,0,0
298,6420,1168,838,957,57,25,144,1225,19,348,224,416,367,640,3018,5452,11,61921,3440,1,0
105,2771,1455,414,1257,16,76,112,1471,5,41,23,46,46,69,231,381,2,1069,59,0,0
105,2771,669,365,481,22,61,110,691,15,103,63,122,118,185,747,1273,8,11311,628,0,0
83,3818,1455,414,1257,16,76,112,1471,5,41,23,46,46,69,231,381,2,1069,59,0,0
118,3203,1523,757,1297,19,12,193,1542,12,193,117,230,205,347,1508,2664,7,19053,1058,0,0
118,3203,701,378,504,33,58,109,734,13,110,68,126,123,194,794,1346,7,10027,557,0,0
114,5827,1523,757,1297,19,12,193,1542,12,193,117,230,205,347,1508,2664,7,19053,1058,0,0
119,3209,1523,757,1297,19,12,193,1542,12,193,117,230,205,347,1508,2664,7,19053,1058,0,0
119,3209,701,378,504,33,58,109,734,13,110,68,126,123,194,794,1346,7,10027,557,0,0
7,458,382,65,130,157,2,92,539,4,10,5,10,14,15,41,57,2,114,6,0,0
14,567,124,78,88,2,3,26,126,4,13,7,13,17,20,56,81,2,163,9,0,0
88,2116,996,429,845,24,10,117,1020,7,76,50,88,83,138,494,879,4,3565,198,0,0
88,2116,456,277,329,12,42,72,468,13,85,50,97,98,147,592,972,7,7212,400,0,0
51,3888,996,429,845,24,10,117,1020,7,76,50,88,83,138,494,879,4,3565,198,0,0
244,5149,2,2,2,0,0,0,2,0,0,0,0,0,0,0,0,0,0,0,0,0
244,5149,99,48,90,1,3,5,100,0,0,0,0,0,0,0,0,0,0,0,0,0
244,5149,8,5,5,2,0,1,10,0,0,0,0,0,0,0,0,0,0,0,0,0
244,5149,1217,716,841,84,126,174,1301,14,185,118,215,199,333,1446,2542,8,20687,1149,0,0
244,5149,160,89,115,0,13,31,160,7,15,11,17,22,28,78,124,3,495,27,0,0
244,5149,10,10,9,9,0,0,19,0,0,0,0,0,0,0,0,0,0,0,0,0
244,5149,173,84,99,8,29,36,181,5,12,7,13,17,20,54,81,2,221,12,0,0
244,5149,3,1,1,3,0,0,6,0,0,0,0,0,0,0,0,0,0,0,0,0
111,6090,1457,730,1242,11,6,188,1468,10,292,166,329,302,495,2424,4078,5,22973,1276,1,0
87,3421,1043,504,840,53,9,147,1096,9,180,112,198,189,310,1377,2344,4,11604,644,0,0
299,6663,72,33,56,0,4,12,72,1,1,1,1,2,2,0,2,0,1,0,0,0
299,6663,1454,835,1044,76,110,219,1530,17,275,158,296,292,454,2297,3718,9,34017,1889,1,0
227,6379,722,423,573,19,0,135,741,12,172,101,199,184,300,1320,2257,6,15668,870,0,1
227,6379,1508,847,911,44,250,301,1552,14,148,88,169,162,257,1120,1886,7,15077,837,0,1
64,3325,722,423,573,19,0,135,741,12,172,101,199,184,300,1320,2257,6,15668,870,0,1
14,367,105,62,62,2,14,27,107,4,12,8,12,16,20,51,80,2,160,8,0,0
227,6379,722,423,573,19,0,135,741,12,172,101,199,184,300,1320,2257,6,15668,870,0,0
227,6379,1508,847,911,44,250,301,1552,14,148,88,169,162,257,1120,1886,7,15077,837,0,0
64,3325,722,423,573,19,0,135,741,12,172,101,199,184,300,1320,2257,6,15668,870,0,0
228,6397,722,423,573,19,0,135,741,12,172,101,199,184,300,1320,2257,6,15668,870,0,0
228,6397,1508,847,911,44,250,301,1552,14,148,88,169,162,257,1120,1886,7,15077,837,0,0
64,3340,722,423,573,19,0,135,741,12,172,101,199,184,300,1320,2257,6,15668,870,0,0
80,2023,466,257,367,18,25,50,484,7,126,86,171,133,257,898,1813,4,8612,478,0,1
80,2023,507,281,342,29,59,88,536,10,53,29,57,63,86,336,514,5,2764,153,0,1
33,2003,466,257,367,18,25,50,484,7,126,86,171,133,257,898,1813,4,8612,478,0,1
80,2023,466,257,367,18,25,50,484,7,126,86,171,133,257,898,1813,4,8612,478,0,0
80,2023,507,281,342,29,59,88,536,10,53,29,57,63,86,336,514,5,2764,153,0,0
33,2003,466,257,367,18,25,50,484,7,126,86,171,133,257,898,1813,4,8612,478,0,0
301,6450,1943,715,1694,26,18,214,1969,12,185,120,237,197,357,1436,2721,7,20915,1161,0,0
301,6450,1168,838,957,57,25,144,1225,19,348,224,416,367,640,3018,5452,11,61921,3440,1,0
114,6860,1943,715,1694,26,18,214,1969,12,185,120,237,197,357,1436,2721,7,20915,1161,0,0
11,629,219,78,157,11,5,46,230,3,24,20,34,27,54,114,256,2,545,30,0,0
37,816,167,116,138,4,5,22,171,8,48,30,56,56,86,292,499,4,2330,129,0,0
111,6108,1457,730,1242,11,6,188,1468,10,292,166,329,302,495,2424,4078,5,22973,1276,1,0
28,598,2,2,2,0,0,0,2,0,0,0,0,0,0,0,0,0,0,0,0,1
28,598,99,48,90,1,3,5,100,0,0,0,0,0,0,0,0,0,0,0,0,1
28,598,8,5,5,2,0,1,10,0,0,0,0,0,0,0,0,0,0,0,0,1
28,598,1217,716,841,84,126,174,1301,14,185,118,215,199,333,1446,2542,8,20687,1149,0,1
28,598,160,89,115,0,13,31,160,7,15,11,17,22,28,78,124,3,495,27,0,1
28,598,10,10,9,9,0,0,19,0,0,0,0,0,0,0,0,0,0,0,0,1
28,598,173,84,99,8,29,36,181,5,12,7,13,17,20,54,81,2,221,12,0,1
28,598,3,1,1,3,0,0,6,0,0,0,0,0,0,0,0,0,0,0,0,1
189,5498,1660,832,1314,41,38,274,1701,20,312,209,395,332,604,2671,5058,12,64042,3557,1,1
189,5498,1057,646,719,113,100,145,1170,18,215,134,248,233,382,1740,3004,10,31186,1732,1,1
53,1495,207,111,150,11,0,50,218,5,26,19,36,31,55,133,272,3,943,52,0,1
53,1495,410,198,237,31,55,97,441,11,63,38,72,74,110,414,683,6,4293,238,0,1
105,2773,1455,414,1257,16,76,112,1471,5,41,23,46,46,69,231,381,2,1069,59,0,1
105,2773,669,365,481,22,61,110,691,15,103,63,122,118,185,747,1273,8,11311,628,0,1
228,6399,722,423,573,19,0,135,741,12,172,101,199,184,300,1320,2257,6,15668,870,0,1
228,6399,1508,847,911,44,250,301,1552,14,148,88,169,162,257,1120,1886,7,15077,837,0,1
80,2025,466,257,367,18,25,50,484,7,126,86,171,133,257,898,1813,4,8612,478,0,1
80,2025,507,281,342,29,59,88,536,10,53,29,57,63,86,336,514,5,2764,153,0,1
88,1931,1043,504,840,53,9,147,1096,9,180,112,198,189,310,1377,2344,4,11604,644,0,1
88,1931,383,288,292,26,6,62,409,11,65,38,67,76,105,429,656,5,3719,206,0,1
100,3089,773,419,590,28,0,166,801,10,204,113,217,214,330,1598,2554,5,13587,754,0,1
28,598,2,2,2,0,0,0,2,0,0,0,0,0,0,0,0,0,0,0,0,0
28,598,99,48,90,1,3,5,100,0,0,0,0,0,0,0,0,0,0,0,0,0
28,598,8,5,5,2,0,1,10,0,0,0,0,0,0,0,0,0,0,0,0,0
28,598,1217,716,841,84,126,174,1301,14,185,118,215,199,333,1446,2542,8,20687,1149,0,0
28,598,160,89,115,0,13,31,160,7,15,11,17,22,28,78,124,3,495,27,0,0
28,598,10,10,9,9,0,0,19,0,0,0,0,0,0,0,0,0,0,0,0,0
28,598,173,84,99,8,29,36,181,5,12,7,13,17,20,54,81,2,221,12,0,0
28,598,3,1,1,3,0,0,6,0,0,0,0,0,0,0,0,0,0,0,0,0
105,2773,1455,414,1257,16,76,112,1471,5,41,23,46,46,69,231,381,2,1069,59,0,0
105,2773,669,365,481,22,61,110,691,15,103,63,122,118,185,747,1273,8,11311,628,0,0
228,6399,722,423,573,19,0,135,741,12,172,101,199,184,300,1320,2257,6,15668,870,0,0
228,6399,1508,847,911,44,250,301,1552,14,148,88,169,162,257,1120,1886,7,15077,837,0,0
80,2025,466,257,367,18,25,50,484,7,126,86,171,133,257,898,1813,4,8612,478,0,0
80,2025,507,281,342,29,59,88,536,10,53,29,57,63,86,336,514,5,2764,153,0,0
88,1931,1043,504,840,53,9,147,1096,9,180,112,198,189,310,1377,2344,4,11604,644,0,0
88,1931,383,288,292,26,6,62,409,11,65,38,67,76,105,429,656,5,3719,206,0,0
100,3089,773,419,590,28,0,166,801,10,204,113,217,214,330,1598,2554,5,13587,754,0,0
1,101,42,7,35,4,0,5,46,1,2,1,2,3,3,2,4,0,2,0,0,0
1,101,11,6,10,0,0,1,11,2,4,2,4,6,6,10,15,1,15,0,0,0
1,92,36,13,19,2,6,9,38,1,2,1,2,3,3,2,4,0,2,0,0,0
26,621,207,111,150,11,0,50,218,5,26,19,36,31,55,133,272,3,943,52,0,0
15,385,105,62,62,2,14,27,107,4,12,8,12,16,20,51,80,2,160,8,0,0
267,6383,4293,999,3693,19,54,507,4312,9,155,88,170,164,258,1156,1898,4,9368,520,0,1
267,6383,1482,859,1002,125,135,219,1607,16,219,134,251,235,385,1766,3032,9,27804,1544,1,1
186,8051,4293,999,3693,19,54,507,4312,9,155,88,170,164,258,1156,1898,4,9368,520,0,1
186,8051,1482,859,1002,125,135,219,1607,16,219,134,251,235,385,1766,3032,9,27804,1544,1,1
267,6383,4293,999,3693,19,54,507,4312,9,155,88,170,164,258,1156,1898,4,9368,520,0,0
267,6383,1482,859,1002,125,135,219,1607,16,219,134,251,235,385,1766,3032,9,27804,1544,1,0
186,8051,4293,999,3693,19,54,507,4312,9,155,88,170,164,258,1156,1898,4,9368,520,0,0
186,8051,1482,859,1002,125,135,219,1607,16,219,134,251,235,385,1766,3032,9,27804,1544,1,0
7,464,382,65,130,157,2,92,539,4,10,5,10,14,15,41,57,2,114,6,0,0
186,5489,182,127,129,0,0,53,182,5,39,21,42,44,63,217,343,2,926,51,0,0
186,5489,1165,710,800,67,119,181,1232,18,243,153,282,261,435,2000,3492,10,36473,2026,1,0
53,1517,207,111,150,11,0,50,218,5,26,19,36,31,55,133,272,3,943,52,0,0
53,1517,410,198,237,31,55,97,441,11,63,38,72,74,110,414,683,6,4293,238,0,0
244,5155,2,2,2,0,0,0,2,0,0,0,0,0,0,0,0,0,0,0,0,0
244,5155,99,48,90,1,3,5,100,0,0,0,0,0,0,0,0,0,0,0,0,0
244,5155,8,5,5,2,0,1,10,0,0,0,0,0,0,0,0,0,0,0,0,0
244,5155,1217,716,841,84,126,174,1301,14,185,118,215,199,333,1446,2542,8,20687,1149,0,0
244,5155,160,89,115,0,13,31,160,7,15,11,17,22,28,78,124,3,495,27,0,0
244,5155,10,10,9,9,0,0,19,0,0,0,0,0,0,0,0,0,0,0,0,0
244,5155,173,84,99,8,29,36,181,5,12,7,13,17,20,54,81,2,221,12,0,0
244,5155,3,1,1,3,0,0,6,0,0,0,0,0,0,0,0,0,0,0,0,0
37,822,167,116,138,4,5,22,171,8,48,30,56,56,86,292,499,4,2330,129,0,0
105,2779,1455,414,1257,16,76,112,1471,5,41,23,46,46,69,231,381,2,1069,59,0,0
105,2779,669,365,481,22,61,110,691,15,103,63,122,118,185,747,1273,8,11311,628,0,0
267,6389,4293,999,3693,19,54,507,4312,9,155,88,170,164,258,1156,1898,4,9368,520,0,0
267,6389,1482,859,1002,125,135,219,1607,16,219,134,251,235,385,1766,3032,9,27804,1544,1,0
55,1879,53,23,39,0,0,13,53,2,8,4,8,10,12,26,39,1,39,2,0,0
55,1879,515,298,307,33,80,99,548,12,63,44,77,75,121,419,753,7,5527,307,0,0
12,575,205,80,86,16,53,53,221,7,18,10,19,25,29,94,134,3,497,27,0,0
228,6405,722,423,573,19,0,135,741,12,172,101,199,184,300,1320,2257,6,15668,870,0,0
228,6405,1508,847,911,44,250,301,1552,14,148,88,169,162,257,1120,1886,7,15077,837,0,0
80,1976,757,253,292,73,244,162,830,13,61,38,67,74,105,409,651,7,4654,258,0,0
20,995,386,256,301,16,9,68,402,4,59,35,69,63,104,355,621,2,1453,80,0,0
20,995,264,131,164,11,41,46,275,6,38,22,40,44,62,214,338,3,1068,59,0,0
88,1937,1043,504,840,53,9,147,1096,9,180,112,198,189,310,1377,2344,4,11604,644,0,0
88,1937,383,288,292,26,6,62,409,11,65,38,67,76,105,429,656,5,3719,206,0,0
2,228,37,13,25,0,6,6,37,1,2,1,2,3,3,2,4,0,2,0,0,0
2,228,133,47,40,1,43,49,134,0,0,0,0,0,0,0,0,0,0,0,0,0
111,6082,1457,730,1242,11,6,188,1468,10,292,166,329,302,495,2424,4078,5,22973,1276,1,0
35,2036,466,257,367,18,25,50,484,7,126,86,171,133,257,898,1813,4,8612,478,0,0
106,4662,1289,550,1043,56,32,155,1345,10,167,93,185,177,278,1266,2075,5,11498,638,0,0
17,398,127,75,83,2,11,30,129,4,14,7,14,18,21,61,87,2,175,9,0,0
17,398,652,304,544,16,6,88,668,6,89,51,101,95,152,591,998,3,3399,188,0,0
17,398,2,2,2,0,0,0,2,0,0,0,0,0,0,0,0,0,0,0,0,0
17,398,8,5,5,0,0,3,8,0,0,0,0,0,0,0,0,0,0,0,0,0
17,398,14,8,8,0,0,6,14,0,0,0,0,0,0,0,0,0,0,0,0,0
17,398,6,4,4,0,0,2,6,0,0,0,0,0,0,0,0,0,0,0,0,0
17,398,6,4,4,0,0,2,6,1,2,1,2,3,3,2,4,0,2,0,0,0
17,398,7,5,5,0,0,2,7,0,0,0,0,0,0,0,0,0,0,0,0,0
17,398,10,6,6,0,0,4,10,0,0,0,0,0,0,0,0,0,0,0,0,0
17,398,1,1,1,0,0,0,1,0,0,0,0,0,0,0,0,0,0,0,0,0
17,398,14,10,10,0,0,4,14,1,1,1,1,2,2,0,2,0,1,0,0,0
17,398,46,26,30,3,0,12,49,3,6,3,6,9,9,20,28,1,42,2,0,0
42,2587,1157,318,931,29,22,177,1186,6,104,63,125,110,188,712,1274,3,4596,255,0,0
89,3918,1338,495,1086,10,64,173,1348,11,122,82,157,133,239,883,1686,7,11934,663,0,0
186,8049,4293,999,3693,19,54,507,4312,9,155,88,170,164,258,1156,1898,4,9368,520,0,0
186,8049,1482,859,1002,125,135,219,1607,16,219,134,251,235,385,1766,3032,9,27804,1544,1,0
147,5899,1782,648,1425,9,47,279,1791,8,171,97,189,179,286,1292,2140,4,9462,525,0,0
127,5420,1450,624,1228,12,26,181,1462,14,306,186,354,320,540,2580,4493,8,36391,2021,1,0
117,4982,1513,682,1277,25,13,200,1538,11,199,116,219,210,335,1557,2584,6,15641,868,0,0
87,5056,1296,573,1062,40,33,157,1336,8,201,118,231,209,349,1561,2689,4,12365,686,0,0
8,308,103,47,73,2,12,15,105,5,16,9,17,21,26,75,114,2,303,16,0,0
8,267,74,35,59,1,0,14,75,3,14,7,14,17,21,58,85,1,128,7,0,0
38,2311,334,251,279,10,4,40,344,5,127,74,143,132,217,899,1528,2,4303,239,0,0
79,4224,1293,570,1093,25,15,163,1318,10,195,123,241,205,364,1516,2795,6,17273,959,0,0
30,1922,384,251,317,7,8,52,391,11,70,44,84,81,128,467,811,6,5355,297,0,0
114,6854,1943,715,1694,26,18,214,1969,12,185,120,237,197,357,1436,2721,7,20915,1161,0,0
14,566,124,78,88,2,3,26,126,4,13,7,13,17,20,56,81,2,163,9,0,0
228,6419,722,423,573,19,0,135,741,12,172,101,199,184,300,1320,2257,6,15668,870,0,0
228,6419,1508,847,911,44,250,301,1552,14,148,88,169,162,257,1120,1886,7,15077,837,0,0
267,6395,4293,999,3693,19,54,507,4312,9,155,88,170,164,258,1156,1898,4,9368,520,0,0
267,6395,1482,859,1002,125,135,219,1607,16,219,134,251,235,385,1766,3032,9,27804,1544,1,0
55,1888,53,23,39,0,0,13,53,2,8,4,8,10,12,26,39,1,39,2,0,0
55,1888,515,298,307,33,80,99,548,12,63,44,77,75,121,419,753,7,5527,307,0,0
80,2027,466,257,367,18,25,50,484,7,126,86,171,133,257,898,1813,4,8612,478,0,0
80,2027,507,281,342,29,59,88,536,10,53,29,57,63,86,336,514,5,2764,153,0,0
262,6273,4293,999,3693,19,54,507,4312,9,155,88,170,164,258,1156,1898,4,9368,520,0,0
262,6273,1482,859,1002,125,135,219,1607,16,219,134,251,235,385,1766,3032,9,27804,1544,1,0
185,8003,4293,999,3693,19,54,507,4312,9,155,88,170,164,258,1156,1898,4,9368,520,0,0
185,8003,1482,859,1002,125,135,219,1607,16,219,134,251,235,385,1766,3032,9,27804,1544,1,0
117,4992,1513,682,1277,25,13,200,1538,11,199,116,219,210,335,1557,2584,6,15641,868,0,0
115,6857,1943,715,1694,26,18,214,1969,12,185,120,237,197,357,1436,2721,7,20915,1161,0,0
118,7014,1943,715,1694,26,18,214,1969,12,185,120,237,197,357,1436,2721,7,20915,1161,0,0
143,6921,1392,870,1177,35,17,170,1427,14,494,280,531,508,811,4473,7289,7,54850,3047,2,0
145,3560,77,34,69,0,0,8,77,3,24,16,29,27,45,114,213,1,387,21,0,0
145,3560,712,438,573,51,9,84,763,14,102,71,128,116,199,733,1364,8,11988,666,0,0
55,1890,53,23,39,0,0,13,53,2,8,4,8,10,12,26,39,1,39,2,0,0
55,1890,515,298,307,33,80,99,548,12,63,44,77,75,121,419,753,7,5527,307,0,0
186,5549,182,127,129,0,0,53,182,5,39,21,42,44,63,217,343,2,926,51,0,0
186,5549,1165,710,800,67,119,181,1232,18,243,153,282,261,435,2000,3492,10,36473,2026,1,0
105,2787,1455,414,1257,16,76,112,1471,5,41,23,46,46,69,231,381,2,1069,59,0,0
105,2787,669,365,481,22,61,110,691,15,103,63,122,118,185,747,1273,8,11311,628,0,0
267,6401,4293,999,3693,19,54,507,4312,9,155,88,170,164,258,1156,1898,4,9368,520,0,0
267,6401,1482,859,1002,125,135,219,1607,16,219,134,251,235,385,1766,3032,9,27804,1544,1,0
143,6949,1392,870,1177,35,17,170,1427,14,494,280,531,508,811,4473,7289,7,54850,3047,2,0
186,5491,182,127,129,0,0,53,182,5,39,21,42,44,63,217,343,2,926,51,0,0
186,5491,1165,710,800,67,119,181,1232,18,243,153,282,261,435,2000,3492,10,36473,2026,1,0
88,1967,1043,504,840,53,9,147,1096,9,180,112,198,189,310,1377,2344,4,11604,644,0,0
88,1967,383,288,292,26,6,62,409,11,65,38,67,76,105,429,656,5,3719,206,0,0
53,1523,207,111,150,11,0,50,218,5,26,19,36,31,55,133,272,3,943,52,0,0
53,1523,410,198,237,31,55,97,441,11,63,38,72,74,110,414,683,6,4293,238,0,0
186,5551,182,127,129,0,0,53,182,5,39,21,42,44,63,217,343,2,926,51,0,0
186,5551,1165,710,800,67,119,181,1232,18,243,153,282,261,435,2000,3492,10,36473,2026,1,0
143,6927,1392,870,1177,35,17,170,1427,14,494,280,531,508,811,4473,7289,7,54850,3047,2,0
113,2328,463,295,324,28,62,57,491,12,134,82,154,146,236,989,1696,6,11700,650,0,1
37,865,167,116,138,4,5,22,171,8,48,30,56,56,86,292,499,4,2330,129,0,1
105,2791,1455,414,1257,16,76,112,1471,5,41,23,46,46,69,231,381,2,1069,59,0,1
105,2791,669,365,481,22,61,110,691,15,103,63,122,118,185,747,1273,8,11311,628,0,1
267,6409,4293,999,3693,19,54,507,4312,9,155,88,170,164,258,1156,1898,4,9368,520,0,1
267,6409,1482,859,1002,125,135,219,1607,16,219,134,251,235,385,1766,3032,9,27804,1544,1,1
145,3575,77,34,69,0,0,8,77,3,24,16,29,27,45,114,213,1,387,21,0,1
145,3575,712,438,573,51,9,84,763,14,102,71,128,116,199,733,1364,8,11988,666,0,1
55,1909,53,23,39,0,0,13,53,2,8,4,8,10,12,26,39,1,39,2,0,1
55,1909,515,298,307,33,80,99,548,12,63,44,77,75,121,419,753,7,5527,307,0,1
89,3918,1338,495,1086,10,64,173,1348,11,122,82,157,133,239,883,1686,7,11934,663,0,1
37,865,167,116,138,4,5,22,171,8,48,30,56,56,86,292,499,4,2330,129,0,0
105,2791,1455,414,1257,16,76,112,1471,5,41,23,46,46,69,231,381,2,1069,59,0,0
105,2791,669,365,481,22,61,110,691,15,103,63,122,118,185,747,1273,8,11311,628,0,0
267,6409,4293,999,3693,19,54,507,4312,9,155,88,170,164,258,1156,1898,4,9368,520,0,0
267,6409,1482,859,1002,125,135,219,1607,16,219,134,251,235,385,1766,3032,9,27804,1544,1,0
145,3575,77,34,69,0,0,8,77,3,24,16,29,27,45,114,213,1,387,21,0,0
145,3575,712,438,573,51,9,84,763,14,102,71,128,116,199,733,1364,8,11988,666,0,0
55,1909,53,23,39,0,0,13,53,2,8,4,8,10,12,26,39,1,39,2,0,0
55,1909,515,298,307,33,80,99,548,12,63,44,77,75,121,419,753,7,5527,307,0,0
59,1750,773,419,590,28,0,166,801,10,204,113,217,214,330,1598,2554,5,13587,754,0,0
59,1750,421,273,302,44,34,57,465,17,81,59,107,98,166,583,1098,11,12329,684,0,0
186,5566,182,127,129,0,0,53,182,5,39,21,42,44,63,217,343,2,926,51,0,1
186,5566,1165,710,800,67,119,181,1232,18,243,153,282,261,435,2000,3492,10,36473,2026,1,1
62,2102,773,419,590,28,0,166,801,10,204,113,217,214,330,1598,2554,5,13587,754,0,1
62,2102,421,273,302,44,34,57,465,17,81,59,107,98,166,583,1098,11,12329,684,0,1
102,3170,773,419,590,28,0,166,801,10,204,113,217,214,330,1598,2554,5,13587,754,0,1
64,3430,722,423,573,19,0,135,741,12,172,101,199,184,300,1320,2257,6,15668,870,0,1
20,1004,386,256,301,16,9,68,402,4,59,35,69,63,104,355,621,2,1453,80,0,0
20,1004,264,131,164,11,41,46,275,6,38,22,40,44,62,214,338,3,1068,59,0,0
46,1995,386,256,301,16,9,68,402,4,59,35,69,63,104,355,621,2,1453,80,0,0
81,2060,466,257,367,18,25,50,484,7,126,86,171,133,257,898,1813,4,8612,478,0,0
81,2060,507,281,342,29,59,88,536,10,53,29,57,63,86,336,514,5,2764,153,0,0
87,3572,1043,504,840,53,9,147,1096,9,180,112,198,189,310,1377,2344,4,11604,644,0,0
186,5566,182,127,129,0,0,53,182,5,39,21,42,44,63,217,343,2,926,51,0,0
186,5566,1165,710,800,67,119,181,1232,18,243,153,282,261,435,2000,3492,10,36473,2026,1,0
62,2102,773,419,590,28,0,166,801,10,204,113,217,214,330,1598,2554,5,13587,754,0,0
62,2102,421,273,302,44,34,57,465,17,81,59,107,98,166,583,1098,11,12329,684,0,0
102,3170,773,419,590,28,0,166,801,10,204,113,217,214,330,1598,2554,5,13587,754,0,0
64,3430,722,423,573,19,0,135,741,12,172,101,199,184,300,1320,2257,6,15668,870,0,0
262,6287,4293,999,3693,19,54,507,4312,9,155,88,170,164,258,1156,1898,4,9368,520,0,0
262,6287,1482,859,1002,125,135,219,1607,16,219,134,251,235,385,1766,3032,9,27804,1544,1,0
262,6279,4293,999,3693,19,54,507,4312,9,155,88,170,164,258,1156,1898,4,9368,520,0,0
262,6279,1482,859,1002,125,135,219,1607,16,219,134,251,235,385,1766,3032,9,27804,1544,1,0
22,666,424,94,331,4,0,89,428,1,5,5,5,6,10,11,25,0,12,0,0,0
62,2105,773,419,590,28,0,166,801,10,204,113,217,214,330,1598,2554,5,13587,754,0,1
62,2105,421,273,302,44,34,57,465,17,81,59,107,98,166,583,1098,11,12329,684,0,1
51,3916,996,429,845,24,10,117,1020,7,76,50,88,83,138,494,879,4,3565,198,0,0
228,6422,722,423,573,19,0,135,741,12,172,101,199,184,300,1320,2257,6,15668,870,0,0
228,6422,1508,847,911,44,250,301,1552,14,148,88,169,162,257,1120,1886,7,15077,837,0,0
64,3443,722,423,573,19,0,135,741,12,172,101,199,184,300,1320,2257,6,15668,870,0,0
87,3578,1043,504,840,53,9,147,1096,9,180,112,198,189,310,1377,2344,4,11604,644,0,0
145,3599,77,34,69,0,0,8,77,3,24,16,29,27,45,114,213,1,387,21,0,0
145,3599,712,438,573,51,9,84,763,14,102,71,128,116,199,733,1364,8,11988,666,0,0
22,703,424,94,331,4,0,89,428,1,5,5,5,6,10,11,25,0,12,0,0,0
262,6287,4293,999,3693,19,54,507,4312,9,155,88,170,164,258,1156,1898,4,9368,520,0,1
262,6287,1482,859,1002,125,135,219,1607,16,219,134,251,235,385,1766,3032,9,27804,1544,1,1
145,3614,77,34,69,0,0,8,77,3,24,16,29,27,45,114,213,1,387,21,0,1
145,3614,712,438,573,51,9,84,763,14,102,71,128,116,199,733,1364,8,11988,666,0,1
56,1916,53,23,39,0,0,13,53,2,8,4,8,10,12,26,39,1,39,2,0,0
56,1916,515,298,307,33,80,99,548,12,63,44,77,75,121,419,753,7,5527,307,0,0
22,710,424,94,331,4,0,89,428,1,5,5,5,6,10,11,25,0,12,0,0,0
53,1539,207,111,150,11,0,50,218,5,26,19,36,31,55,133,272,3,943,52,0,0
53,1539,410,198,237,31,55,97,441,11,63,38,72,74,110,414,683,6,4293,238,0,0
299,6679,72,33,56,0,4,12,72,1,1,1,1,2,2,0,2,0,1,0,0,0
299,6679,1454,835,1044,76,110,219,1530,17,275,158,296,292,454,2297,3718,9,34017,1889,1,0
114,5837,1523,757,1297,19,12,193,1542,12,193,117,230,205,347,1508,2664,7,19053,1058,0,0
89,3913,1338,495,1086,10,64,173,1348,11,122,82,157,133,239,883,1686,7,11934,663,0,0
51,3915,996,429,845,24,10,117,1020,7,76,50,88,83,138,494,879,4,3565,198,0,0
114,5832,1523,757,1297,19,12,193,1542,12,193,117,230,205,347,1508,2664,7,19053,1058,0,0
30,1920,384,251,317,7,8,52,391,11,70,44,84,81,128,467,811,6,5355,297,0,0
112,6130,1457,730,1242,11,6,188,1468,10,292,166,329,302,495,2424,4078,5,22973,1276,1,0
300,6694,72,33,56,0,4,12,72,1,1,1,1,2,2,0,2,0,1,0,0,0
300,6694,1454,835,1044,76,110,219,1530,17,275,158,296,292,454,2297,3718,9,34017,1889,1,0
62,2105,773,419,590,28,0,166,801,10,204,113,217,214,330,1598,2554,5,13587,754,0,0
62,2105,421,273,302,44,34,57,465,17,81,59,107,98,166,583,1098,11,12329,684,0,0
56,1923,53,23,39,0,0,13,53,2,8,4,8,10,12,26,39,1,39,2,0,0
56,1923,515,298,307,33,80,99,548,12,63,44,77,75,121,419,753,7,5527,307,0,0
145,3614,77,34,69,0,0,8,77,3,24,16,29,27,45,114,213,1,387,21,0,0
145,3614,712,438,573,51,9,84,763,14,102,71,128,116,199,733,1364,8,11988,666,0,0
186,5528,182,127,129,0,0,53,182,5,39,21,42,44,63,217,343,2,926,51,0,0
186,5528,1165,710,800,67,119,181,1232,18,243,153,282,261,435,2000,3492,10,36473,2026,1,0
88,2118,996,429,845,24,10,117,1020,7,76,50,88,83,138,494,879,4,3565,198,0,0
88,2118,456,277,329,12,42,72,468,13,85,50,97,98,147,592,972,7,7212,400,0,0
244,5153,2,2,2,0,0,0,2,0,0,0,0,0,0,0,0,0,0,0,0,0
244,5153,99,48,90,1,3,5,100,0,0,0,0,0,0,0,0,0,0,0,0,0
244,5153,8,5,5,2,0,1,10,0,0,0,0,0,0,0,0,0,0,0,0,0
244,5153,1217,716,841,84,126,174,1301,14,185,118,215,199,333,1446,2542,8,20687,1149,0,0
244,5153,160,89,115,0,13,31,160,7,15,11,17,22,28,78,124,3,495,27,0,0
244,5153,10,10,9,9,0,0,19,0,0,0,0,0,0,0,0,0,0,0,0,0
244,5153,173,84,99,8,29,36,181,5,12,7,13,17,20,54,81,2,221,12,0,0
244,5153,3,1,1,3,0,0,6,0,0,0,0,0,0,0,0,0,0,0,0,0
105,2795,1455,414,1257,16,76,112,1471,5,41,23,46,46,69,231,381,2,1069,59,0,0
105,2795,669,365,481,22,61,110,691,15,103,63,122,118,185,747,1273,8,11311,628,0,0
262,6289,4293,999,3693,19,54,507,4312,9,155,88,170,164,258,1156,1898,4,9368,520,0,0
262,6289,1482,859,1002,125,135,219,1607,16,219,134,251,235,385,1766,3032,9,27804,1544,1,0
81,2062,466,257,367,18,25,50,484,7,126,86,171,133,257,898,1813,4,8612,478,0,0
81,2062,507,281,342,29,59,88,536,10,53,29,57,63,86,336,514,5,2764,153,0,0
3,495,149,67,118,4,0,27,153,1,17,14,28,18,42,69,175,0,144,8,0,0
144,7018,1392,870,1177,35,17,170,1427,14,494,280,531,508,811,4473,7289,7,54850,3047,2,0
186,8037,4293,999,3693,19,54,507,4312,9,155,88,170,164,258,1156,1898,4,9368,520,0,0
186,8037,1482,859,1002,125,135,219,1607,16,219,134,251,235,385,1766,3032,9,27804,1544,1,0
161,3439,1513,682,1277,25,13,200,1538,11,199,116,219,210,335,1557,2584,6,15641,868,0,0
161,3439,819,519,539,24,98,155,843,15,96,57,106,111,163,690,1107,8,9171,509,0,0
118,5010,1513,682,1277,25,13,200,1538,11,199,116,219,210,335,1557,2584,6,15641,868,0,0
145,3612,77,34,69,0,0,8,77,3,24,16,29,27,45,114,213,1,387,21,0,0
145,3612,712,438,573,51,9,84,763,14,102,71,128,116,199,733,1364,8,11988,666,0,0
145,3620,77,34,69,0,0,8,77,3,24,16,29,27,45,114,213,1,387,21,0,0
145,3620,712,438,573,51,9,84,763,14,102,71,128,116,199,733,1364,8,11988,666,0,0
300,6703,72,33,56,0,4,12,72,1,1,1,1,2,2,0,2,0,1,0,0,0
300,6703,1454,835,1044,76,110,219,1530,17,275,158,296,292,454,2297,3718,9,34017,1889,1,0
162,3459,1513,682,1277,25,13,200,1538,11,199,116,219,210,335,1557,2584,6,15641,868,0,1
162,3459,819,519,539,24,98,155,843,15,96,57,106,111,163,690,1107,8,9171,509,0,1
119,5094,1513,682,1277,25,13,200,1538,11,199,116,219,210,335,1557,2584,6,15641,868,0,1
300,6695,72,33,56,0,4,12,72,1,1,1,1,2,2,0,2,0,1,0,0,0
300,6695,1454,835,1044,76,110,219,1530,17,275,158,296,292,454,2297,3718,9,34017,1889,1,0
137,3410,77,34,69,0,0,8,77,3,24,16,29,27,45,114,213,1,387,21,0,0
137,3410,712,438,573,51,9,84,763,14,102,71,128,116,199,733,1364,8,11988,666,0,0
65,2152,53,23,39,0,0,13,53,2,8,4,8,10,12,26,39,1,39,2,0,0
65,2152,515,298,307,33,80,99,548,12,63,44,77,75,121,419,753,7,5527,307,0,0
294,6553,72,33,56,0,4,12,72,1,1,1,1,2,2,0,2,0,1,0,0,0
294,6553,1454,835,1044,76,110,219,1530,17,275,158,296,292,454,2297,3718,9,34017,1889,1,0
162,3473,1513,682,1277,25,13,200,1538,11,199,116,219,210,335,1557,2584,6,15641,868,0,1
162,3473,819,519,539,24,98,155,843,15,96,57,106,111,163,690,1107,8,9171,509,0,1
119,5100,1513,682,1277,25,13,200,1538,11,199,116,219,210,335,1557,2584,6,15641,868,0,1
119,5113,1513,682,1277,25,13,200,1538,11,199,116,219,210,335,1557,2584,6,15641,868,0,0
119,7063,1943,715,1694,26,18,214,1969,12,185,120,237,197,357,1436,2721,7,20915,1161,0,0
162,3471,1513,682,1277,25,13,200,1538,11,199,116,219,210,335,1557,2584,6,15641,868,0,0
162,3471,819,519,539,24,98,155,843,15,96,57,106,111,163,690,1107,8,9171,509,0,0
66,3522,722,423,573,19,0,135,741,12,172,101,199,184,300,1320,2257,6,15668,870,0,0
137,3416,77,34,69,0,0,8,77,3,24,16,29,27,45,114,213,1,387,21,0,0
137,3416,712,438,573,51,9,84,763,14,102,71,128,116,199,733,1364,8,11988,666,0,0
65,2176,53,23,39,0,0,13,53,2,8,4,8,10,12,26,39,1,39,2,0,0
65,2176,515,298,307,33,80,99,548,12,63,44,77,75,121,419,753,7,5527,307,0,0
294,6559,72,33,56,0,4,12,72,1,1,1,1,2,2,0,2,0,1,0,0,0
294,6559,1454,835,1044,76,110,219,1530,17,275,158,296,292,454,2297,3718,9,34017,1889,1,0
228,6434,722,423,573,19,0,135,741,12,172,101,199,184,300,1320,2257,6,15668,870,0,0
228,6434,1508,847,911,44,250,301,1552,14,148,88,169,162,257,1120,1886,7,15077,837,0,0
225,6470,722,423,573,19,0,135,741,12,172,101,199,184,300,1320,2257,6,15668,870,0,0
225,6470,1508,847,911,44,250,301,1552,14,148,88,169,162,257,1120,1886,7,15077,837,0,0
244,5157,2,2,2,0,0,0,2,0,0,0,0,0,0,0,0,0,0,0,0,0
244,5157,99,48,90,1,3,5,100,0,0,0,0,0,0,0,0,0,0,0,0,0
244,5157,8,5,5,2,0,1,10,0,0,0,0,0,0,0,0,0,0,0,0,0
244,5157,1217,716,841,84,126,174,1301,14,185,118,215,199,333,1446,2542,8,20687,1149,0,0
244,5157,160,89,115,0,13,31,160,7,15,11,17,22,28,78,124,3,495,27,0,0
244,5157,10,10,9,9,0,0,19,0,0,0,0,0,0,0,0,0,0,0,0,0
244,5157,173,84,99,8,29,36,181,5,12,7,13,17,20,54,81,2,221,12,0,0
244,5157,3,1,1,3,0,0,6,0,0,0,0,0,0,0,0,0,0,0,0,0
225,6476,722,423,573,19,0,135,741,12,172,101,199,184,300,1320,2257,6,15668,870,0,0
225,6476,1508,847,911,44,250,301,1552,14,148,88,169,162,257,1120,1886,7,15077,837,0,0
87,5086,1296,573,1062,40,33,157,1336,8,201,118,231,209,349,1561,2689,4,12365,686,0,0
186,5527,182,127,129,0,0,53,182,5,39,21,42,44,63,217,343,2,926,51,0,0
186,5527,1165,710,800,67,119,181,1232,18,243,153,282,261,435,2000,3492,10,36473,2026,1,0
120,7094,1943,715,1694,26,18,214,1969,12,185,120,237,197,357,1436,2721,7,20915,1161,0,0
262,6283,4293,999,3693,19,54,507,4312,9,155,88,170,164,258,1156,1898,4,9368,520,0,0
262,6283,1482,859,1002,125,135,219,1607,16,219,134,251,235,385,1766,3032,9,27804,1544,1,0
186,8102,4293,999,3693,19,54,507,4312,9,155,88,170,164,258,1156,1898,4,9368,520,0,0
186,8102,1482,859,1002,125,135,219,1607,16,219,134,251,235,385,1766,3032,9,27804,1544,1,0
262,6280,4293,999,3693,19,54,507,4312,9,155,88,170,164,258,1156,1898,4,9368,520,0,0
262,6280,1482,859,1002,125,135,219,1607,16,219,134,251,235,385,1766,3032,9,27804,1544,1,0
51,1103,447,308,343,6,5,95,453,7,96,59,111,103,170,651,1136,4,4600,255,0,0
51,1103,322,174,179,16,74,51,338,10,41,26,46,51,72,252,408,5,2291,127,0,0
187,8092,4293,999,3693,19,54,507,4312,9,155,88,170,164,258,1156,1898,4,9368,520,0,0
187,8092,1482,859,1002,125,135,219,1607,16,219,134,251,235,385,1766,3032,9,27804,1544,1,0
187,8157,4293,999,3693,19,54,507,4312,9,155,88,170,164,258,1156,1898,4,9368,520,0,0
187,8157,1482,859,1002,125,135,219,1607,16,219,134,251,235,385,1766,3032,9,27804,1544,1,0
33,1148,182,127,129,0,0,53,182,5,39,21,42,44,63,217,343,2,926,51,0,0
100,3049,773,419,590,28,0,166,801,10,204,113,217,214,330,1598,2554,5,13587,754,0,0
33,1151,182,127,129,0,0,53,182,5,39,21,42,44,63,217,343,2,926,51,0,0
33,1085,182,127,129,0,0,53,182,5,39,21,42,44,63,217,343,2,926,51,0,0
15,391,105,62,62,2,14,27,107,4,12,8,12,16,20,51,80,2,160,8,0,0
31,944,182,127,129,0,0,53,182,5,39,21,42,44,63,217,343,2,926,51,0,0
102,3186,773,419,590,28,0,166,801,10,204,113,217,214,330,1598,2554,5,13587,754,0,0
28,617,2,2,2,0,0,0,2,0,0,0,0,0,0,0,0,0,0,0,0,0
28,617,99,48,90,1,3,5,100,0,0,0,0,0,0,0,0,0,0,0,0,0
28,617,8,5,5,2,0,1,10,0,0,0,0,0,0,0,0,0,0,0,0,0
28,617,1217,716,841,84,126,174,1301,14,185,118,215,199,333,1446,2542,8,20687,1149,0,0
28,617,160,89,115,0,13,31,160,7,15,11,17,22,28,78,124,3,495,27,0,0
28,617,10,10,9,9,0,0,19,0,0,0,0,0,0,0,0,0,0,0,0,0
28,617,173,84,99,8,29,36,181,5,12,7,13,17,20,54,81,2,221,12,0,0
28,617,3,1,1,3,0,0,6,0,0,0,0,0,0,0,0,0,0,0,0,0
54,672,647,139,84,35,284,233,682,0,0,0,0,0,0,0,0,0,0,0,0,0
117,2982,773,422,505,30,103,129,803,14,77,46,83,91,129,535,839,7,6334,351,0,0
137,3440,77,34,69,0,0,8,77,3,24,16,29,27,45,114,213,1,387,21,0,0
137,3440,712,438,573,51,9,84,763,14,102,71,128,116,199,733,1364,8,11988,666,0,0
301,6452,1943,715,1694,26,18,214,1969,12,185,120,237,197,357,1436,2721,7,20915,1161,0,0
301,6452,1168,838,957,57,25,144,1225,19,348,224,416,367,640,3018,5452,11,61921,3440,1,0
23,646,601,196,481,2,23,85,603,8,63,36,72,71,108,400,664,4,3036,168,0,0
23,646,156,79,106,5,16,28,161,5,14,8,15,19,23,64,97,2,261,14,0,0
294,6572,72,33,56,0,4,12,72,1,1,1,1,2,2,0,2,0,1,0,0,0
294,6572,1454,835,1044,76,110,219,1530,17,275,158,296,292,454,2297,3718,9,34017,1889,1,0
294,6565,72,33,56,0,4,12,72,1,1,1,1,2,2,0,2,0,1,0,0,0
294,6565,1454,835,1044,76,110,219,1530,17,275,158,296,292,454,2297,3718,9,34017,1889,1,0
124,3469,77,34,69,0,0,8,77,3,24,16,29,27,45,114,213,1,387,21,0,0
124,3469,712,438,573,51,9,84,763,14,102,71,128,116,199,733,1364,8,11988,666,0,0
124,3511,77,34,69,0,0,8,77,3,24,16,29,27,45,114,213,1,387,21,0,0
124,3511,712,438,573,51,9,84,763,14,102,71,128,116,199,733,1364,8,11988,666,0,0
5,319,77,34,69,0,0,8,77,3,24,16,29,27,45,114,213,1,387,21,0,0
3,97,35,12,22,4,5,6,39,1,2,1,2,3,3,2,4,0,2,0,0,0
63,2130,773,419,590,28,0,166,801,10,204,113,217,214,330,1598,2554,5,13587,754,0,1
63,2130,421,273,302,44,34,57,465,17,81,59,107,98,166,583,1098,11,12329,684,0,1
52,1508,207,111,150,11,0,50,218,5,26,19,36,31,55,133,272,3,943,52,0,1
52,1508,410,198,237,31,55,97,441,11,63,38,72,74,110,414,683,6,4293,238,0,1
262,6282,4293,999,3693,19,54,507,4312,9,155,88,170,164,258,1156,1898,4,9368,520,0,1
262,6282,1482,859,1002,125,135,219,1607,16,219,134,251,235,385,1766,3032,9,27804,1544,1,1
69,1502,402,202,227,24,74,80,426,12,52,33,61,64,94,339,564,7,3969,220,0,1
65,2178,53,23,39,0,0,13,53,2,8,4,8,10,12,26,39,1,39,2,0,1
65,2178,515,298,307,33,80,99,548,12,63,44,77,75,121,419,753,7,5527,307,0,1
294,6567,72,33,56,0,4,12,72,1,1,1,1,2,2,0,2,0,1,0,0,1
294,6567,1454,835,1044,76,110,219,1530,17,275,158,296,292,454,2297,3718,9,34017,1889,1,1
187,5537,182,127,129,0,0,53,182,5,39,21,42,44,63,217,343,2,926,51,0,0
187,5537,1165,710,800,67,119,181,1232,18,243,153,282,261,435,2000,3492,10,36473,2026,1,0
103,3235,773,419,590,28,0,166,801,10,204,113,217,214,330,1598,2554,5,13587,754,0,0
63,2124,773,419,590,28,0,166,801,10,204,113,217,214,330,1598,2554,5,13587,754,0,0
63,2124,421,273,302,44,34,57,465,17,81,59,107,98,166,583,1098,11,12329,684,0,0
52,1512,207,111,150,11,0,50,218,5,26,19,36,31,55,133,272,3,943,52,0,0
52,1512,410,198,237,31,55,97,441,11,63,38,72,74,110,414,683,6,4293,238,0,0
51,1472,207,111,150,11,0,50,218,5,26,19,36,31,55,133,272,3,943,52,0,0
51,1472,410,198,237,31,55,97,441,11,63,38,72,74,110,414,683,6,4293,238,0,0
27,637,2,2,2,0,0,0,2,0,0,0,0,0,0,0,0,0,0,0,0,0
27,637,99,48,90,1,3,5,100,0,0,0,0,0,0,0,0,0,0,0,0,0
27,637,8,5,5,2,0,1,10,0,0,0,0,0,0,0,0,0,0,0,0,0
27,637,1217,716,841,84,126,174,1301,14,185,118,215,199,333,1446,2542,8,20687,1149,0,0
27,637,160,89,115,0,13,31,160,7,15,11,17,22,28,78,124,3,495,27,0,0
27,637,10,10,9,9,0,0,19,0,0,0,0,0,0,0,0,0,0,0,0,0
27,637,173,84,99,8,29,36,181,5,12,7,13,17,20,54,81,2,221,12,0,0
27,637,3,1,1,3,0,0,6,0,0,0,0,0,0,0,0,0,0,0,0,0
244,5161,2,2,2,0,0,0,2,0,0,0,0,0,0,0,0,0,0,0,0,0
244,5161,99,48,90,1,3,5,100,0,0,0,0,0,0,0,0,0,0,0,0,0
244,5161,8,5,5,2,0,1,10,0,0,0,0,0,0,0,0,0,0,0,0,0
244,5161,1217,716,841,84,126,174,1301,14,185,118,215,199,333,1446,2542,8,20687,1149,0,0
244,5161,160,89,115,0,13,31,160,7,15,11,17,22,28,78,124,3,495,27,0,0
244,5161,10,10,9,9,0,0,19,0,0,0,0,0,0,0,0,0,0,0,0,0
244,5161,173,84,99,8,29,36,181,5,12,7,13,17,20,54,81,2,221,12,0,0
244,5161,3,1,1,3,0,0,6,0,0,0,0,0,0,0,0,0,0,0,0,0
127,5438,1450,624,1228,12,26,181,1462,14,306,186,354,320,540,2580,4493,8,36391,2021,1,0
106,4668,1289,550,1043,56,32,155,1345,10,167,93,185,177,278,1266,2075,5,11498,638,0,0
18,430,127,75,83,2,11,30,129,4,14,7,14,18,21,61,87,2,175,9,0,0
18,430,652,304,544,16,6,88,668,6,89,51,101,95,152,591,998,3,3399,188,0,0
18,430,2,2,2,0,0,0,2,0,0,0,0,0,0,0,0,0,0,0,0,0
18,430,8,5,5,0,0,3,8,0,0,0,0,0,0,0,0,0,0,0,0,0
18,430,14,8,8,0,0,6,14,0,0,0,0,0,0,0,0,0,0,0,0,0
18,430,6,4,4,0,0,2,6,0,0,0,0,0,0,0,0,0,0,0,0,0
18,430,6,4,4,0,0,2,6,1,2,1,2,3,3,2,4,0,2,0,0,0
18,430,7,5,5,0,0,2,7,0,0,0,0,0,0,0,0,0,0,0,0,0
18,430,10,6,6,0,0,4,10,0,0,0,0,0,0,0,0,0,0,0,0,0
18,430,1,1,1,0,0,0,1,0,0,0,0,0,0,0,0,0,0,0,0,0
18,430,14,10,10,0,0,4,14,1,1,1,1,2,2,0,2,0,1,0,0,0
18,430,46,26,30,3,0,12,49,3,6,3,6,9,9,20,28,1,42,2,0,0
114,5840,1523,757,1297,19,12,193,1542,12,193,117,230,205,347,1508,2664,7,19053,1058,0,0
120,7110,1943,715,1694,26,18,214,1969,12,185,120,237,197,357,1436,2721,7,20915,1161,0,0
262,6282,4293,999,3693,19,54,507,4312,9,155,88,170,164,258,1156,1898,4,9368,520,0,0
262,6282,1482,859,1002,125,135,219,1607,16,219,134,251,235,385,1766,3032,9,27804,1544,1,0
69,1502,402,202,227,24,74,80,426,12,52,33,61,64,94,339,564,7,3969,220,0,0
65,2178,53,23,39,0,0,13,53,2,8,4,8,10,12,26,39,1,39,2,0,0
65,2178,515,298,307,33,80,99,548,12,63,44,77,75,121,419,753,7,5527,307,0,0
294,6567,72,33,56,0,4,12,72,1,1,1,1,2,2,0,2,0,1,0,0,0
294,6567,1454,835,1044,76,110,219,1530,17,275,158,296,292,454,2297,3718,9,34017,1889,1,0
