,CommitID,filename,token_count,change_type,loc,lloc,sloc,comments,multi,blank,code_comment,h1,h2,N1,N2,vocabulary,length,calculated_length,volume,difficulty,effort,time,bugs,defect
0,1f639e2c22ca92f85521db7dd05f743e946ff338,/Users/sanika/Downloads/Master Thesis/repo_updated/pytest/setup.py,95.0,ModificationType.MODIFY,42,7,35,4,0,5,46,1,2,1,2,3,3,2.0,4.754887502163468,0.5,2.3774437510817346,0.1320802083934297,0.0015849625007211565,False
1,1f639e2c22ca92f85521db7dd05f743e946ff338,/Users/sanika/Downloads/Master Thesis/repo_updated/pytest/extra/setup-py.test/setup.py,95.0,ModificationType.MODIFY,11,6,10,0,0,1,11,2,4,2,4,6,6,10.0,15.509775004326935,1.0,15.509775004326935,0.861654166907052,0.005169925001442312,False
2,1f639e2c22ca92f85521db7dd05f743e946ff338,/Users/sanika/Downloads/Master Thesis/repo_updated/pytest/testing/python/fixtures.py,6237.0,ModificationType.MODIFY,4293,999,3693,19,54,507,4312,9,155,88,170,164,258,1156.3286078304875,1898.2484171914662,4.935483870967742,9368.774446138525,520.4874692299181,0.6327494723971553,False
3,1f639e2c22ca92f85521db7dd05f743e946ff338,/Users/sanika/Downloads/Master Thesis/repo_updated/pytest/src/_pytest/fixtures.py,6237.0,ModificationType.MODIFY,1482,859,1002,125,135,219,1607,16,219,134,251,235,385,1766.6783660526569,3032.459024427525,9.168949771689498,27804.46447968251,1544.692471093473,1.0108196748091751,False
4,1f639e2c22ca92f85521db7dd05f743e946ff338,/Users/sanika/Downloads/Master Thesis/repo_updated/pytest/testing/python/fixtures.py,8002.0,ModificationType.MODIFY,4293,999,3693,19,54,507,4312,9,155,88,170,164,258,1156.3286078304875,1898.2484171914662,4.935483870967742,9368.774446138525,520.4874692299181,0.6327494723971553,False
5,1f639e2c22ca92f85521db7dd05f743e946ff338,/Users/sanika/Downloads/Master Thesis/repo_updated/pytest/src/_pytest/fixtures.py,8002.0,ModificationType.MODIFY,1482,859,1002,125,135,219,1607,16,219,134,251,235,385,1766.6783660526569,3032.459024427525,9.168949771689498,27804.46447968251,1544.692471093473,1.0108196748091751,False
6,63e3d89647499b7c28bde50391fa9313edb21c5d,/Users/sanika/Downloads/Master Thesis/repo_updated/pytest/testing/python/fixtures.py,8002.0,ModificationType.MODIFY,4293,999,3693,19,54,507,4312,9,155,88,170,164,258,1156.3286078304875,1898.2484171914662,4.935483870967742,9368.774446138525,520.4874692299181,0.6327494723971553,False
7,63e3d89647499b7c28bde50391fa9313edb21c5d,/Users/sanika/Downloads/Master Thesis/repo_updated/pytest/src/_pytest/fixtures.py,8002.0,ModificationType.MODIFY,1482,859,1002,125,135,219,1607,16,219,134,251,235,385,1766.6783660526569,3032.459024427525,9.168949771689498,27804.46447968251,1544.692471093473,1.0108196748091751,False
8,122cf60b2789487efec2b725f429eaa59baf3ea2,/Users/sanika/Downloads/Master Thesis/repo_updated/pytest/testing/python/fixtures.py,6225.0,ModificationType.MODIFY,4293,999,3693,19,54,507,4312,9,155,88,170,164,258,1156.3286078304875,1898.2484171914662,4.935483870967742,9368.774446138525,520.4874692299181,0.6327494723971553,False
9,122cf60b2789487efec2b725f429eaa59baf3ea2,/Users/sanika/Downloads/Master Thesis/repo_updated/pytest/src/_pytest/fixtures.py,6225.0,ModificationType.MODIFY,1482,859,1002,125,135,219,1607,16,219,134,251,235,385,1766.6783660526569,3032.459024427525,9.168949771689498,27804.46447968251,1544.692471093473,1.0108196748091751,False
10,3322c1e03306b6db17ae7ea6991a5d6817658ae2,/Users/sanika/Downloads/Master Thesis/repo_updated/pytest/setup.py,95.0,ModificationType.MODIFY,42,7,35,4,0,5,46,1,2,1,2,3,3,2.0,4.754887502163468,0.5,2.3774437510817346,0.1320802083934297,0.0015849625007211565,False
11,3322c1e03306b6db17ae7ea6991a5d6817658ae2,/Users/sanika/Downloads/Master Thesis/repo_updated/pytest/extra/setup-py.test/setup.py,95.0,ModificationType.MODIFY,11,6,10,0,0,1,11,2,4,2,4,6,6,10.0,15.509775004326935,1.0,15.509775004326935,0.861654166907052,0.005169925001442312,False
12,3322c1e03306b6db17ae7ea6991a5d6817658ae2,/Users/sanika/Downloads/Master Thesis/repo_updated/pytest/testing/python/fixtures.py,6225.0,ModificationType.MODIFY,4293,999,3693,19,54,507,4312,9,155,88,170,164,258,1156.3286078304875,1898.2484171914662,4.935483870967742,9368.774446138525,520.4874692299181,0.6327494723971553,False
13,3322c1e03306b6db17ae7ea6991a5d6817658ae2,/Users/sanika/Downloads/Master Thesis/repo_updated/pytest/src/_pytest/fixtures.py,6225.0,ModificationType.MODIFY,1482,859,1002,125,135,219,1607,16,219,134,251,235,385,1766.6783660526569,3032.459024427525,9.168949771689498,27804.46447968251,1544.692471093473,1.0108196748091751,False
14,3322c1e03306b6db17ae7ea6991a5d6817658ae2,/Users/sanika/Downloads/Master Thesis/repo_updated/pytest/testing/python/fixtures.py,8002.0,ModificationType.MODIFY,4293,999,3693,19,54,507,4312,9,155,88,170,164,258,1156.3286078304875,1898.2484171914662,4.935483870967742,9368.774446138525,520.4874692299181,0.6327494723971553,False
15,3322c1e03306b6db17ae7ea6991a5d6817658ae2,/Users/sanika/Downloads/Master Thesis/repo_updated/pytest/src/_pytest/fixtures.py,8002.0,ModificationType.MODIFY,1482,859,1002,125,135,219,1607,16,219,134,251,235,385,1766.6783660526569,3032.459024427525,9.168949771689498,27804.46447968251,1544.692471093473,1.0108196748091751,False
16,361f0e6ba7f1949d7daefa882be4b7c975375e1c,/Users/sanika/Downloads/Master Thesis/repo_updated/pytest/testing/test_junitxml.py,5657.0,ModificationType.MODIFY,1523,757,1297,19,12,193,1542,12,193,117,230,205,347,1508.3637582013935,2664.7795945283897,7.150259067357513,19053.86445828589,1058.5480254603274,0.8882598648427965,False
17,c2ae0e0dc631cbcbc8921b79bcdc7740dad33aaf,/Users/sanika/Downloads/Master Thesis/repo_updated/pytest/testing/test_setuponly.py,,ModificationType.RENAME,294,64,250,0,0,43,294,1,20,10,20,21,30,86.43856189774725,131.7695226833628,0.5,65.8847613416814,3.660264518982301,0.04392317422778761,False
18,c2ae0e0dc631cbcbc8921b79bcdc7740dad33aaf,/Users/sanika/Downloads/Master Thesis/repo_updated/pytest/testing/test_setupplan.py,,ModificationType.RENAME,110,30,77,3,13,16,113,4,21,15,30,25,45,100.23866587835396,208.9735285398626,2.8571428571428568,597.0672243996074,33.17040135553375,0.06965784284662087,False
19,71a7fd02a574120ef9c1e9d6aeeb65d186cc756a,/Users/sanika/Downloads/Master Thesis/repo_updated/pytest/src/_pytest/logging.py,2754.0,ModificationType.MODIFY,773,422,505,30,103,129,803,14,77,46,83,91,129,535.8455325423139,839.5055085856317,7.545454545454546,6334.450655691586,351.9139253161992,0.2798351695285439,False
20,76c2a8ebbe367a8de8143aa91586d1c16e0bd482,/Users/sanika/Downloads/Master Thesis/repo_updated/pytest/src/_pytest/logging.py,2754.0,ModificationType.MODIFY,773,422,505,30,103,129,803,14,77,46,83,91,129,535.8455325423139,839.5055085856317,7.545454545454546,6334.450655691586,351.9139253161992,0.2798351695285439,False
21,0383d4364584a32899f73efd4c4e0d2a6b30a03e,/Users/sanika/Downloads/Master Thesis/repo_updated/pytest/testing/example_scripts/collect/package_infinite_recursion/__init__.pyi,5076.0,ModificationType.MODIFY,0,0,0,0,0,0,0,0,0,0,0,0,0,0.0,0.0,0.0,0.0,0.0,0.0,False
22,0383d4364584a32899f73efd4c4e0d2a6b30a03e,/Users/sanika/Downloads/Master Thesis/repo_updated/pytest/testing/example_scripts/collect/package_infinite_recursion/tests/__init__.py,5076.0,ModificationType.MODIFY,0,0,0,0,0,0,0,0,0,0,0,0,0,0.0,0.0,0.0,0.0,0.0,0.0,False
23,0383d4364584a32899f73efd4c4e0d2a6b30a03e,/Users/sanika/Downloads/Master Thesis/repo_updated/pytest/testing/example_scripts/collect/collect_init_tests/tests/__init__.py,5076.0,ModificationType.MODIFY,2,2,2,0,0,0,2,0,0,0,0,0,0,0.0,0.0,0.0,0.0,0.0,0.0,False
24,0383d4364584a32899f73efd4c4e0d2a6b30a03e,/Users/sanika/Downloads/Master Thesis/repo_updated/pytest/testing/example_scripts/collect/package_init_given_as_arg/pkg/__init__.py,5076.0,ModificationType.MODIFY,0,0,0,0,0,0,0,0,0,0,0,0,0,0.0,0.0,0.0,0.0,0.0,0.0,False
25,0383d4364584a32899f73efd4c4e0d2a6b30a03e,/Users/sanika/Downloads/Master Thesis/repo_updated/pytest/testing/example_scripts/conftest_usageerror/__init__.pyi,5076.0,ModificationType.MODIFY,0,0,0,0,0,0,0,0,0,0,0,0,0,0.0,0.0,0.0,0.0,0.0,0.0,False
26,0383d4364584a32899f73efd4c4e0d2a6b30a03e,/Users/sanika/Downloads/Master Thesis/repo_updated/pytest/testing/example_scripts/marks/marks_considered_keywords/__init__.pyi,5076.0,ModificationType.MODIFY,0,0,0,0,0,0,0,0,0,0,0,0,0,0.0,0.0,0.0,0.0,0.0,0.0,False
27,0383d4364584a32899f73efd4c4e0d2a6b30a03e,/Users/sanika/Downloads/Master Thesis/repo_updated/pytest/testing/example_scripts/config/collect_pytest_prefix/__init__.pyi,5076.0,ModificationType.MODIFY,0,0,0,0,0,0,0,0,0,0,0,0,0,0.0,0.0,0.0,0.0,0.0,0.0,False
28,0383d4364584a32899f73efd4c4e0d2a6b30a03e,/Users/sanika/Downloads/Master Thesis/repo_updated/pytest/testing/example_scripts/issue88_initial_file_multinodes/__init__.pyi,5076.0,ModificationType.MODIFY,0,0,0,0,0,0,0,0,0,0,0,0,0,0.0,0.0,0.0,0.0,0.0,0.0,False
29,0383d4364584a32899f73efd4c4e0d2a6b30a03e,/Users/sanika/Downloads/Master Thesis/repo_updated/pytest/testing/example_scripts/fixtures/fill_fixtures/test_extend_fixture_conftest_conftest/__init__.pyi,5076.0,ModificationType.MODIFY,0,0,0,0,0,0,0,0,0,0,0,0,0,0.0,0.0,0.0,0.0,0.0,0.0,False
30,0383d4364584a32899f73efd4c4e0d2a6b30a03e,/Users/sanika/Downloads/Master Thesis/repo_updated/pytest/testing/example_scripts/fixtures/fill_fixtures/test_extend_fixture_conftest_conftest/pkg/__init__.py,5076.0,ModificationType.MODIFY,0,0,0,0,0,0,0,0,0,0,0,0,0,0.0,0.0,0.0,0.0,0.0,0.0,False
31,0383d4364584a32899f73efd4c4e0d2a6b30a03e,/Users/sanika/Downloads/Master Thesis/repo_updated/pytest/testing/example_scripts/fixtures/fill_fixtures/test_extend_fixture_conftest_module/__init__.pyi,5076.0,ModificationType.MODIFY,0,0,0,0,0,0,0,0,0,0,0,0,0,0.0,0.0,0.0,0.0,0.0,0.0,False
32,0383d4364584a32899f73efd4c4e0d2a6b30a03e,/Users/sanika/Downloads/Master Thesis/repo_updated/pytest/testing/example_scripts/fixtures/fill_fixtures/test_conftest_funcargs_only_available_in_subdir/sub1/__init__.py,5076.0,ModificationType.MODIFY,0,0,0,0,0,0,0,0,0,0,0,0,0,0.0,0.0,0.0,0.0,0.0,0.0,False
33,0383d4364584a32899f73efd4c4e0d2a6b30a03e,/Users/sanika/Downloads/Master Thesis/repo_updated/pytest/testing/example_scripts/fixtures/fill_fixtures/test_conftest_funcargs_only_available_in_subdir/sub2/__init__.py,5076.0,ModificationType.MODIFY,0,0,0,0,0,0,0,0,0,0,0,0,0,0.0,0.0,0.0,0.0,0.0,0.0,False
34,0383d4364584a32899f73efd4c4e0d2a6b30a03e,/Users/sanika/Downloads/Master Thesis/repo_updated/pytest/testing/example_scripts/fixtures/custom_item/__init__.pyi,5076.0,ModificationType.MODIFY,0,0,0,0,0,0,0,0,0,0,0,0,0,0.0,0.0,0.0,0.0,0.0,0.0,False
35,0383d4364584a32899f73efd4c4e0d2a6b30a03e,/Users/sanika/Downloads/Master Thesis/repo_updated/pytest/testing/example_scripts/fixtures/custom_item/foo/__init__.py,5076.0,ModificationType.MODIFY,0,0,0,0,0,0,0,0,0,0,0,0,0,0.0,0.0,0.0,0.0,0.0,0.0,False
36,0383d4364584a32899f73efd4c4e0d2a6b30a03e,/Users/sanika/Downloads/Master Thesis/repo_updated/pytest/doc/en/example/nonpython/__init__.py,5076.0,ModificationType.MODIFY,0,0,0,0,0,0,0,0,0,0,0,0,0,0.0,0.0,0.0,0.0,0.0,0.0,False
37,0383d4364584a32899f73efd4c4e0d2a6b30a03e,/Users/sanika/Downloads/Master Thesis/repo_updated/pytest/src/pytest/__init__.py,5076.0,ModificationType.MODIFY,99,48,90,1,3,5,100,0,0,0,0,0,0,0.0,0.0,0.0,0.0,0.0,0.0,False
38,0383d4364584a32899f73efd4c4e0d2a6b30a03e,/Users/sanika/Downloads/Master Thesis/repo_updated/pytest/src/_pytest/__init__.py,5076.0,ModificationType.MODIFY,8,5,5,2,0,1,10,0,0,0,0,0,0,0.0,0.0,0.0,0.0,0.0,0.0,False
39,0383d4364584a32899f73efd4c4e0d2a6b30a03e,/Users/sanika/Downloads/Master Thesis/repo_updated/pytest/src/_pytest/config/__init__.py,5076.0,ModificationType.MODIFY,1217,716,841,84,126,174,1301,14,185,118,215,199,333,1446.608539104324,2542.995998641035,8.135135135135135,20687.616097052745,1149.3120053918194,0.847665332880345,False
40,0383d4364584a32899f73efd4c4e0d2a6b30a03e,/Users/sanika/Downloads/Master Thesis/repo_updated/pytest/src/_pytest/mark/__init__.py,5076.0,ModificationType.MODIFY,160,89,115,0,13,31,160,7,15,11,17,22,28,78.25484338853101,124.86408532184431,3.966666666666667,495.29420510998256,27.516344728332356,0.04162136177394811,False
41,0383d4364584a32899f73efd4c4e0d2a6b30a03e,/Users/sanika/Downloads/Master Thesis/repo_updated/pytest/src/_pytest/_code/__init__.py,5076.0,ModificationType.MODIFY,10,10,9,9,0,0,19,0,0,0,0,0,0,0.0,0.0,0.0,0.0,0.0,0.0,False
42,0383d4364584a32899f73efd4c4e0d2a6b30a03e,/Users/sanika/Downloads/Master Thesis/repo_updated/pytest/src/_pytest/assertion/__init__.py,5076.0,ModificationType.MODIFY,173,84,99,8,29,36,181,5,12,7,13,17,20,54.62919048309069,81.7492568250068,2.708333333333333,221.40423723439343,12.300235401910744,0.027249752275002263,False
43,0383d4364584a32899f73efd4c4e0d2a6b30a03e,/Users/sanika/Downloads/Master Thesis/repo_updated/pytest/src/_pytest/_io/__init__.py,5076.0,ModificationType.MODIFY,3,1,1,3,0,0,6,0,0,0,0,0,0,0.0,0.0,0.0,0.0,0.0,0.0,False
44,0383d4364584a32899f73efd4c4e0d2a6b30a03e,/Users/sanika/Downloads/Master Thesis/repo_updated/pytest/testing/python/fixtures.py,6225.0,ModificationType.MODIFY,4293,999,3693,19,54,507,4312,9,155,88,170,164,258,1156.3286078304875,1898.2484171914662,4.935483870967742,9368.774446138525,520.4874692299181,0.6327494723971553,False
45,0383d4364584a32899f73efd4c4e0d2a6b30a03e,/Users/sanika/Downloads/Master Thesis/repo_updated/pytest/src/_pytest/fixtures.py,6225.0,ModificationType.MODIFY,1482,859,1002,125,135,219,1607,16,219,134,251,235,385,1766.6783660526569,3032.459024427525,9.168949771689498,27804.46447968251,1544.692471093473,1.0108196748091751,False
46,0383d4364584a32899f73efd4c4e0d2a6b30a03e,/Users/sanika/Downloads/Master Thesis/repo_updated/pytest/src/_pytest/hookspec.py,640.0,ModificationType.MODIFY,647,139,84,35,284,233,682,0,0,0,0,0,0,0.0,0.0,0.0,0.0,0.0,0.0,False
47,0383d4364584a32899f73efd4c4e0d2a6b30a03e,/Users/sanika/Downloads/Master Thesis/repo_updated/pytest/testing/test_main.py,3472.0,ModificationType.MODIFY,77,34,69,0,0,8,77,3,24,16,29,27,45,114.79398751947123,213.9699375973561,1.8125,387.82051189520797,21.54558399417822,0.07132331253245204,False
48,0383d4364584a32899f73efd4c4e0d2a6b30a03e,/Users/sanika/Downloads/Master Thesis/repo_updated/pytest/src/_pytest/main.py,3472.0,ModificationType.MODIFY,712,438,573,51,9,84,763,14,102,71,128,116,199,733.8903537898989,1364.7382180303869,8.784313725490197,11988.288660345359,666.0160366858534,0.4549127393434623,False
49,f739d511b0665dbfc0e93cab8c219c9e34f146c8,/Users/sanika/Downloads/Master Thesis/repo_updated/pytest/testing/test_junitxml.py,5657.0,ModificationType.MODIFY,1523,757,1297,19,12,193,1542,12,193,117,230,205,347,1508.3637582013935,2664.7795945283897,7.150259067357513,19053.86445828589,1058.5480254603274,0.8882598648427965,False
50,914a9465aba501e776282961fb3317837772435d,/Users/sanika/Downloads/Master Thesis/repo_updated/pytest/testing/test_setuponly.py,,ModificationType.RENAME,294,64,250,0,0,43,294,1,20,10,20,21,30,86.43856189774725,131.7695226833628,0.5,65.8847613416814,3.660264518982301,0.04392317422778761,False
51,914a9465aba501e776282961fb3317837772435d,/Users/sanika/Downloads/Master Thesis/repo_updated/pytest/testing/test_setupplan.py,,ModificationType.RENAME,110,30,77,3,13,16,113,4,21,15,30,25,45,100.23866587835396,208.9735285398626,2.8571428571428568,597.0672243996074,33.17040135553375,0.06965784284662087,False
52,77a995ffada780b8136740b0ff468189b60bda7a,/Users/sanika/Downloads/Master Thesis/repo_updated/pytest/testing/example_scripts/collect/package_infinite_recursion/__init__.pyi,5076.0,ModificationType.MODIFY,0,0,0,0,0,0,0,0,0,0,0,0,0,0.0,0.0,0.0,0.0,0.0,0.0,False
53,77a995ffada780b8136740b0ff468189b60bda7a,/Users/sanika/Downloads/Master Thesis/repo_updated/pytest/testing/example_scripts/collect/package_infinite_recursion/tests/__init__.py,5076.0,ModificationType.MODIFY,0,0,0,0,0,0,0,0,0,0,0,0,0,0.0,0.0,0.0,0.0,0.0,0.0,False
54,77a995ffada780b8136740b0ff468189b60bda7a,/Users/sanika/Downloads/Master Thesis/repo_updated/pytest/testing/example_scripts/collect/collect_init_tests/tests/__init__.py,5076.0,ModificationType.MODIFY,2,2,2,0,0,0,2,0,0,0,0,0,0,0.0,0.0,0.0,0.0,0.0,0.0,False
55,77a995ffada780b8136740b0ff468189b60bda7a,/Users/sanika/Downloads/Master Thesis/repo_updated/pytest/testing/example_scripts/collect/package_init_given_as_arg/pkg/__init__.py,5076.0,ModificationType.MODIFY,0,0,0,0,0,0,0,0,0,0,0,0,0,0.0,0.0,0.0,0.0,0.0,0.0,False
56,77a995ffada780b8136740b0ff468189b60bda7a,/Users/sanika/Downloads/Master Thesis/repo_updated/pytest/testing/example_scripts/conftest_usageerror/__init__.pyi,5076.0,ModificationType.MODIFY,0,0,0,0,0,0,0,0,0,0,0,0,0,0.0,0.0,0.0,0.0,0.0,0.0,False
57,77a995ffada780b8136740b0ff468189b60bda7a,/Users/sanika/Downloads/Master Thesis/repo_updated/pytest/testing/example_scripts/marks/marks_considered_keywords/__init__.pyi,5076.0,ModificationType.MODIFY,0,0,0,0,0,0,0,0,0,0,0,0,0,0.0,0.0,0.0,0.0,0.0,0.0,False
58,77a995ffada780b8136740b0ff468189b60bda7a,/Users/sanika/Downloads/Master Thesis/repo_updated/pytest/testing/example_scripts/config/collect_pytest_prefix/__init__.pyi,5076.0,ModificationType.MODIFY,0,0,0,0,0,0,0,0,0,0,0,0,0,0.0,0.0,0.0,0.0,0.0,0.0,False
59,77a995ffada780b8136740b0ff468189b60bda7a,/Users/sanika/Downloads/Master Thesis/repo_updated/pytest/testing/example_scripts/issue88_initial_file_multinodes/__init__.pyi,5076.0,ModificationType.MODIFY,0,0,0,0,0,0,0,0,0,0,0,0,0,0.0,0.0,0.0,0.0,0.0,0.0,False
60,77a995ffada780b8136740b0ff468189b60bda7a,/Users/sanika/Downloads/Master Thesis/repo_updated/pytest/testing/example_scripts/fixtures/fill_fixtures/test_extend_fixture_conftest_conftest/__init__.pyi,5076.0,ModificationType.MODIFY,0,0,0,0,0,0,0,0,0,0,0,0,0,0.0,0.0,0.0,0.0,0.0,0.0,False
61,77a995ffada780b8136740b0ff468189b60bda7a,/Users/sanika/Downloads/Master Thesis/repo_updated/pytest/testing/example_scripts/fixtures/fill_fixtures/test_extend_fixture_conftest_conftest/pkg/__init__.py,5076.0,ModificationType.MODIFY,0,0,0,0,0,0,0,0,0,0,0,0,0,0.0,0.0,0.0,0.0,0.0,0.0,False
62,77a995ffada780b8136740b0ff468189b60bda7a,/Users/sanika/Downloads/Master Thesis/repo_updated/pytest/testing/example_scripts/fixtures/fill_fixtures/test_extend_fixture_conftest_module/__init__.pyi,5076.0,ModificationType.MODIFY,0,0,0,0,0,0,0,0,0,0,0,0,0,0.0,0.0,0.0,0.0,0.0,0.0,False
63,77a995ffada780b8136740b0ff468189b60bda7a,/Users/sanika/Downloads/Master Thesis/repo_updated/pytest/testing/example_scripts/fixtures/fill_fixtures/test_conftest_funcargs_only_available_in_subdir/sub1/__init__.py,5076.0,ModificationType.MODIFY,0,0,0,0,0,0,0,0,0,0,0,0,0,0.0,0.0,0.0,0.0,0.0,0.0,False
64,77a995ffada780b8136740b0ff468189b60bda7a,/Users/sanika/Downloads/Master Thesis/repo_updated/pytest/testing/example_scripts/fixtures/fill_fixtures/test_conftest_funcargs_only_available_in_subdir/sub2/__init__.py,5076.0,ModificationType.MODIFY,0,0,0,0,0,0,0,0,0,0,0,0,0,0.0,0.0,0.0,0.0,0.0,0.0,False
65,77a995ffada780b8136740b0ff468189b60bda7a,/Users/sanika/Downloads/Master Thesis/repo_updated/pytest/testing/example_scripts/fixtures/custom_item/__init__.pyi,5076.0,ModificationType.MODIFY,0,0,0,0,0,0,0,0,0,0,0,0,0,0.0,0.0,0.0,0.0,0.0,0.0,False
66,77a995ffada780b8136740b0ff468189b60bda7a,/Users/sanika/Downloads/Master Thesis/repo_updated/pytest/testing/example_scripts/fixtures/custom_item/foo/__init__.py,5076.0,ModificationType.MODIFY,0,0,0,0,0,0,0,0,0,0,0,0,0,0.0,0.0,0.0,0.0,0.0,0.0,False
67,77a995ffada780b8136740b0ff468189b60bda7a,/Users/sanika/Downloads/Master Thesis/repo_updated/pytest/doc/en/example/nonpython/__init__.py,5076.0,ModificationType.MODIFY,0,0,0,0,0,0,0,0,0,0,0,0,0,0.0,0.0,0.0,0.0,0.0,0.0,False
68,77a995ffada780b8136740b0ff468189b60bda7a,/Users/sanika/Downloads/Master Thesis/repo_updated/pytest/src/pytest/__init__.py,5076.0,ModificationType.MODIFY,99,48,90,1,3,5,100,0,0,0,0,0,0,0.0,0.0,0.0,0.0,0.0,0.0,False
69,77a995ffada780b8136740b0ff468189b60bda7a,/Users/sanika/Downloads/Master Thesis/repo_updated/pytest/src/_pytest/__init__.py,5076.0,ModificationType.MODIFY,8,5,5,2,0,1,10,0,0,0,0,0,0,0.0,0.0,0.0,0.0,0.0,0.0,False
70,77a995ffada780b8136740b0ff468189b60bda7a,/Users/sanika/Downloads/Master Thesis/repo_updated/pytest/src/_pytest/config/__init__.py,5076.0,ModificationType.MODIFY,1217,716,841,84,126,174,1301,14,185,118,215,199,333,1446.608539104324,2542.995998641035,8.135135135135135,20687.616097052745,1149.3120053918194,0.847665332880345,False
71,77a995ffada780b8136740b0ff468189b60bda7a,/Users/sanika/Downloads/Master Thesis/repo_updated/pytest/src/_pytest/mark/__init__.py,5076.0,ModificationType.MODIFY,160,89,115,0,13,31,160,7,15,11,17,22,28,78.25484338853101,124.86408532184431,3.966666666666667,495.29420510998256,27.516344728332356,0.04162136177394811,False
72,77a995ffada780b8136740b0ff468189b60bda7a,/Users/sanika/Downloads/Master Thesis/repo_updated/pytest/src/_pytest/_code/__init__.py,5076.0,ModificationType.MODIFY,10,10,9,9,0,0,19,0,0,0,0,0,0,0.0,0.0,0.0,0.0,0.0,0.0,False
73,77a995ffada780b8136740b0ff468189b60bda7a,/Users/sanika/Downloads/Master Thesis/repo_updated/pytest/src/_pytest/assertion/__init__.py,5076.0,ModificationType.MODIFY,173,84,99,8,29,36,181,5,12,7,13,17,20,54.62919048309069,81.7492568250068,2.708333333333333,221.40423723439343,12.300235401910744,0.027249752275002263,False
74,77a995ffada780b8136740b0ff468189b60bda7a,/Users/sanika/Downloads/Master Thesis/repo_updated/pytest/src/_pytest/_io/__init__.py,5076.0,ModificationType.MODIFY,3,1,1,3,0,0,6,0,0,0,0,0,0,0.0,0.0,0.0,0.0,0.0,0.0,False
75,77a995ffada780b8136740b0ff468189b60bda7a,/Users/sanika/Downloads/Master Thesis/repo_updated/pytest/testing/python/fixtures.py,6225.0,ModificationType.MODIFY,4293,999,3693,19,54,507,4312,9,155,88,170,164,258,1156.3286078304875,1898.2484171914662,4.935483870967742,9368.774446138525,520.4874692299181,0.6327494723971553,False
76,77a995ffada780b8136740b0ff468189b60bda7a,/Users/sanika/Downloads/Master Thesis/repo_updated/pytest/src/_pytest/fixtures.py,6225.0,ModificationType.MODIFY,1482,859,1002,125,135,219,1607,16,219,134,251,235,385,1766.6783660526569,3032.459024427525,9.168949771689498,27804.46447968251,1544.692471093473,1.0108196748091751,False
77,77a995ffada780b8136740b0ff468189b60bda7a,/Users/sanika/Downloads/Master Thesis/repo_updated/pytest/src/_pytest/hookspec.py,640.0,ModificationType.MODIFY,647,139,84,35,284,233,682,0,0,0,0,0,0,0.0,0.0,0.0,0.0,0.0,0.0,False
78,77a995ffada780b8136740b0ff468189b60bda7a,/Users/sanika/Downloads/Master Thesis/repo_updated/pytest/testing/test_main.py,3472.0,ModificationType.MODIFY,77,34,69,0,0,8,77,3,24,16,29,27,45,114.79398751947123,213.9699375973561,1.8125,387.82051189520797,21.54558399417822,0.07132331253245204,False
79,77a995ffada780b8136740b0ff468189b60bda7a,/Users/sanika/Downloads/Master Thesis/repo_updated/pytest/src/_pytest/main.py,3472.0,ModificationType.MODIFY,712,438,573,51,9,84,763,14,102,71,128,116,199,733.8903537898989,1364.7382180303869,8.784313725490197,11988.288660345359,666.0160366858534,0.4549127393434623,False
80,90dfee5da55f4b2e55a92568186dc435624d5499,/Users/sanika/Downloads/Master Thesis/repo_updated/pytest/setup.py,93.0,ModificationType.MODIFY,42,7,35,4,0,5,46,1,2,1,2,3,3,2.0,4.754887502163468,0.5,2.3774437510817346,0.1320802083934297,0.0015849625007211565,False
81,90dfee5da55f4b2e55a92568186dc435624d5499,/Users/sanika/Downloads/Master Thesis/repo_updated/pytest/extra/setup-py.test/setup.py,93.0,ModificationType.MODIFY,11,6,10,0,0,1,11,2,4,2,4,6,6,10.0,15.509775004326935,1.0,15.509775004326935,0.861654166907052,0.005169925001442312,False
82,90dfee5da55f4b2e55a92568186dc435624d5499,/Users/sanika/Downloads/Master Thesis/repo_updated/pytest/testing/python/fixtures.py,8008.0,ModificationType.MODIFY,4293,999,3693,19,54,507,4312,9,155,88,170,164,258,1156.3286078304875,1898.2484171914662,4.935483870967742,9368.774446138525,520.4874692299181,0.6327494723971553,False
83,90dfee5da55f4b2e55a92568186dc435624d5499,/Users/sanika/Downloads/Master Thesis/repo_updated/pytest/src/_pytest/fixtures.py,8008.0,ModificationType.MODIFY,1482,859,1002,125,135,219,1607,16,219,134,251,235,385,1766.6783660526569,3032.459024427525,9.168949771689498,27804.46447968251,1544.692471093473,1.0108196748091751,False
84,3cb1457e6ddbaec97bf2ca8f44209bd88ff11bb2,/Users/sanika/Downloads/Master Thesis/repo_updated/pytest/setup.py,93.0,ModificationType.MODIFY,42,7,35,4,0,5,46,1,2,1,2,3,3,2.0,4.754887502163468,0.5,2.3774437510817346,0.1320802083934297,0.0015849625007211565,False
85,3cb1457e6ddbaec97bf2ca8f44209bd88ff11bb2,/Users/sanika/Downloads/Master Thesis/repo_updated/pytest/extra/setup-py.test/setup.py,93.0,ModificationType.MODIFY,11,6,10,0,0,1,11,2,4,2,4,6,6,10.0,15.509775004326935,1.0,15.509775004326935,0.861654166907052,0.005169925001442312,False
86,3cb1457e6ddbaec97bf2ca8f44209bd88ff11bb2,/Users/sanika/Downloads/Master Thesis/repo_updated/pytest/testing/python/fixtures.py,8008.0,ModificationType.MODIFY,4293,999,3693,19,54,507,4312,9,155,88,170,164,258,1156.3286078304875,1898.2484171914662,4.935483870967742,9368.774446138525,520.4874692299181,0.6327494723971553,False
87,3cb1457e6ddbaec97bf2ca8f44209bd88ff11bb2,/Users/sanika/Downloads/Master Thesis/repo_updated/pytest/src/_pytest/fixtures.py,8008.0,ModificationType.MODIFY,1482,859,1002,125,135,219,1607,16,219,134,251,235,385,1766.6783660526569,3032.459024427525,9.168949771689498,27804.46447968251,1544.692471093473,1.0108196748091751,False
88,7ef44913a1ee5c79c966372e613ce3ea06a68090,/Users/sanika/Downloads/Master Thesis/repo_updated/pytest/testing/test_pdb.py,3969.0,ModificationType.MODIFY,1293,570,1093,25,15,163,1318,10,195,123,241,205,364,1516.6486921300477,2795.3307562199825,6.17948717948718,17273.710570487587,959.6505872493103,0.931776918739994,False
89,0783030357807ba91ad07e89b12bf8d2205ae21d,/Users/sanika/Downloads/Master Thesis/repo_updated/pytest/testing/test_pdb.py,3969.0,ModificationType.MODIFY,1293,570,1093,25,15,163,1318,10,195,123,241,205,364,1516.6486921300477,2795.3307562199825,6.17948717948718,17273.710570487587,959.6505872493103,0.931776918739994,False
90,0976e2f50de87d28ad3f7680013b40f72bc99f50,/Users/sanika/Downloads/Master Thesis/repo_updated/pytest/testing/example_scripts/collect/package_infinite_recursion/__init__.pyi,5076.0,ModificationType.MODIFY,0,0,0,0,0,0,0,0,0,0,0,0,0,0.0,0.0,0.0,0.0,0.0,0.0,False
91,0976e2f50de87d28ad3f7680013b40f72bc99f50,/Users/sanika/Downloads/Master Thesis/repo_updated/pytest/testing/example_scripts/collect/package_infinite_recursion/tests/__init__.py,5076.0,ModificationType.MODIFY,0,0,0,0,0,0,0,0,0,0,0,0,0,0.0,0.0,0.0,0.0,0.0,0.0,False
92,0976e2f50de87d28ad3f7680013b40f72bc99f50,/Users/sanika/Downloads/Master Thesis/repo_updated/pytest/testing/example_scripts/collect/collect_init_tests/tests/__init__.py,5076.0,ModificationType.MODIFY,2,2,2,0,0,0,2,0,0,0,0,0,0,0.0,0.0,0.0,0.0,0.0,0.0,False
93,0976e2f50de87d28ad3f7680013b40f72bc99f50,/Users/sanika/Downloads/Master Thesis/repo_updated/pytest/testing/example_scripts/collect/package_init_given_as_arg/pkg/__init__.py,5076.0,ModificationType.MODIFY,0,0,0,0,0,0,0,0,0,0,0,0,0,0.0,0.0,0.0,0.0,0.0,0.0,False
94,0976e2f50de87d28ad3f7680013b40f72bc99f50,/Users/sanika/Downloads/Master Thesis/repo_updated/pytest/testing/example_scripts/conftest_usageerror/__init__.pyi,5076.0,ModificationType.MODIFY,0,0,0,0,0,0,0,0,0,0,0,0,0,0.0,0.0,0.0,0.0,0.0,0.0,False
95,0976e2f50de87d28ad3f7680013b40f72bc99f50,/Users/sanika/Downloads/Master Thesis/repo_updated/pytest/testing/example_scripts/marks/marks_considered_keywords/__init__.pyi,5076.0,ModificationType.MODIFY,0,0,0,0,0,0,0,0,0,0,0,0,0,0.0,0.0,0.0,0.0,0.0,0.0,False
96,0976e2f50de87d28ad3f7680013b40f72bc99f50,/Users/sanika/Downloads/Master Thesis/repo_updated/pytest/testing/example_scripts/config/collect_pytest_prefix/__init__.pyi,5076.0,ModificationType.MODIFY,0,0,0,0,0,0,0,0,0,0,0,0,0,0.0,0.0,0.0,0.0,0.0,0.0,False
97,0976e2f50de87d28ad3f7680013b40f72bc99f50,/Users/sanika/Downloads/Master Thesis/repo_updated/pytest/testing/example_scripts/issue88_initial_file_multinodes/__init__.pyi,5076.0,ModificationType.MODIFY,0,0,0,0,0,0,0,0,0,0,0,0,0,0.0,0.0,0.0,0.0,0.0,0.0,False
98,0976e2f50de87d28ad3f7680013b40f72bc99f50,/Users/sanika/Downloads/Master Thesis/repo_updated/pytest/testing/example_scripts/fixtures/fill_fixtures/test_extend_fixture_conftest_conftest/__init__.pyi,5076.0,ModificationType.MODIFY,0,0,0,0,0,0,0,0,0,0,0,0,0,0.0,0.0,0.0,0.0,0.0,0.0,False
99,0976e2f50de87d28ad3f7680013b40f72bc99f50,/Users/sanika/Downloads/Master Thesis/repo_updated/pytest/testing/example_scripts/fixtures/fill_fixtures/test_extend_fixture_conftest_conftest/pkg/__init__.py,5076.0,ModificationType.MODIFY,0,0,0,0,0,0,0,0,0,0,0,0,0,0.0,0.0,0.0,0.0,0.0,0.0,False
100,0976e2f50de87d28ad3f7680013b40f72bc99f50,/Users/sanika/Downloads/Master Thesis/repo_updated/pytest/testing/example_scripts/fixtures/fill_fixtures/test_extend_fixture_conftest_module/__init__.pyi,5076.0,ModificationType.MODIFY,0,0,0,0,0,0,0,0,0,0,0,0,0,0.0,0.0,0.0,0.0,0.0,0.0,False
101,0976e2f50de87d28ad3f7680013b40f72bc99f50,/Users/sanika/Downloads/Master Thesis/repo_updated/pytest/testing/example_scripts/fixtures/fill_fixtures/test_conftest_funcargs_only_available_in_subdir/sub1/__init__.py,5076.0,ModificationType.MODIFY,0,0,0,0,0,0,0,0,0,0,0,0,0,0.0,0.0,0.0,0.0,0.0,0.0,False
102,0976e2f50de87d28ad3f7680013b40f72bc99f50,/Users/sanika/Downloads/Master Thesis/repo_updated/pytest/testing/example_scripts/fixtures/fill_fixtures/test_conftest_funcargs_only_available_in_subdir/sub2/__init__.py,5076.0,ModificationType.MODIFY,0,0,0,0,0,0,0,0,0,0,0,0,0,0.0,0.0,0.0,0.0,0.0,0.0,False
103,0976e2f50de87d28ad3f7680013b40f72bc99f50,/Users/sanika/Downloads/Master Thesis/repo_updated/pytest/testing/example_scripts/fixtures/custom_item/__init__.pyi,5076.0,ModificationType.MODIFY,0,0,0,0,0,0,0,0,0,0,0,0,0,0.0,0.0,0.0,0.0,0.0,0.0,False
104,0976e2f50de87d28ad3f7680013b40f72bc99f50,/Users/sanika/Downloads/Master Thesis/repo_updated/pytest/testing/example_scripts/fixtures/custom_item/foo/__init__.py,5076.0,ModificationType.MODIFY,0,0,0,0,0,0,0,0,0,0,0,0,0,0.0,0.0,0.0,0.0,0.0,0.0,False
105,0976e2f50de87d28ad3f7680013b40f72bc99f50,/Users/sanika/Downloads/Master Thesis/repo_updated/pytest/doc/en/example/nonpython/__init__.py,5076.0,ModificationType.MODIFY,0,0,0,0,0,0,0,0,0,0,0,0,0,0.0,0.0,0.0,0.0,0.0,0.0,False
106,0976e2f50de87d28ad3f7680013b40f72bc99f50,/Users/sanika/Downloads/Master Thesis/repo_updated/pytest/src/pytest/__init__.py,5076.0,ModificationType.MODIFY,99,48,90,1,3,5,100,0,0,0,0,0,0,0.0,0.0,0.0,0.0,0.0,0.0,False
107,0976e2f50de87d28ad3f7680013b40f72bc99f50,/Users/sanika/Downloads/Master Thesis/repo_updated/pytest/src/_pytest/__init__.py,5076.0,ModificationType.MODIFY,8,5,5,2,0,1,10,0,0,0,0,0,0,0.0,0.0,0.0,0.0,0.0,0.0,False
108,0976e2f50de87d28ad3f7680013b40f72bc99f50,/Users/sanika/Downloads/Master Thesis/repo_updated/pytest/src/_pytest/config/__init__.py,5076.0,ModificationType.MODIFY,1217,716,841,84,126,174,1301,14,185,118,215,199,333,1446.608539104324,2542.995998641035,8.135135135135135,20687.616097052745,1149.3120053918194,0.847665332880345,False
109,0976e2f50de87d28ad3f7680013b40f72bc99f50,/Users/sanika/Downloads/Master Thesis/repo_updated/pytest/src/_pytest/mark/__init__.py,5076.0,ModificationType.MODIFY,160,89,115,0,13,31,160,7,15,11,17,22,28,78.25484338853101,124.86408532184431,3.966666666666667,495.29420510998256,27.516344728332356,0.04162136177394811,False
110,0976e2f50de87d28ad3f7680013b40f72bc99f50,/Users/sanika/Downloads/Master Thesis/repo_updated/pytest/src/_pytest/_code/__init__.py,5076.0,ModificationType.MODIFY,10,10,9,9,0,0,19,0,0,0,0,0,0,0.0,0.0,0.0,0.0,0.0,0.0,False
111,0976e2f50de87d28ad3f7680013b40f72bc99f50,/Users/sanika/Downloads/Master Thesis/repo_updated/pytest/src/_pytest/assertion/__init__.py,5076.0,ModificationType.MODIFY,173,84,99,8,29,36,181,5,12,7,13,17,20,54.62919048309069,81.7492568250068,2.708333333333333,221.40423723439343,12.300235401910744,0.027249752275002263,False
112,0976e2f50de87d28ad3f7680013b40f72bc99f50,/Users/sanika/Downloads/Master Thesis/repo_updated/pytest/src/_pytest/_io/__init__.py,5076.0,ModificationType.MODIFY,3,1,1,3,0,0,6,0,0,0,0,0,0,0.0,0.0,0.0,0.0,0.0,0.0,False
113,0976e2f50de87d28ad3f7680013b40f72bc99f50,/Users/sanika/Downloads/Master Thesis/repo_updated/pytest/testing/python/fixtures.py,6225.0,ModificationType.MODIFY,4293,999,3693,19,54,507,4312,9,155,88,170,164,258,1156.3286078304875,1898.2484171914662,4.935483870967742,9368.774446138525,520.4874692299181,0.6327494723971553,False
114,0976e2f50de87d28ad3f7680013b40f72bc99f50,/Users/sanika/Downloads/Master Thesis/repo_updated/pytest/src/_pytest/fixtures.py,6225.0,ModificationType.MODIFY,1482,859,1002,125,135,219,1607,16,219,134,251,235,385,1766.6783660526569,3032.459024427525,9.168949771689498,27804.46447968251,1544.692471093473,1.0108196748091751,False
115,0976e2f50de87d28ad3f7680013b40f72bc99f50,/Users/sanika/Downloads/Master Thesis/repo_updated/pytest/src/_pytest/hookspec.py,640.0,ModificationType.MODIFY,647,139,84,35,284,233,682,0,0,0,0,0,0,0.0,0.0,0.0,0.0,0.0,0.0,False
116,0976e2f50de87d28ad3f7680013b40f72bc99f50,/Users/sanika/Downloads/Master Thesis/repo_updated/pytest/src/_pytest/logging.py,2754.0,ModificationType.MODIFY,773,422,505,30,103,129,803,14,77,46,83,91,129,535.8455325423139,839.5055085856317,7.545454545454546,6334.450655691586,351.9139253161992,0.2798351695285439,False
117,0976e2f50de87d28ad3f7680013b40f72bc99f50,/Users/sanika/Downloads/Master Thesis/repo_updated/pytest/testing/test_main.py,3472.0,ModificationType.MODIFY,77,34,69,0,0,8,77,3,24,16,29,27,45,114.79398751947123,213.9699375973561,1.8125,387.82051189520797,21.54558399417822,0.07132331253245204,False
118,0976e2f50de87d28ad3f7680013b40f72bc99f50,/Users/sanika/Downloads/Master Thesis/repo_updated/pytest/src/_pytest/main.py,3472.0,ModificationType.MODIFY,712,438,573,51,9,84,763,14,102,71,128,116,199,733.8903537898989,1364.7382180303869,8.784313725490197,11988.288660345359,666.0160366858534,0.4549127393434623,False
119,0976e2f50de87d28ad3f7680013b40f72bc99f50,/Users/sanika/Downloads/Master Thesis/repo_updated/pytest/testing/python/fixtures.py,7999.0,ModificationType.MODIFY,4293,999,3693,19,54,507,4312,9,155,88,170,164,258,1156.3286078304875,1898.2484171914662,4.935483870967742,9368.774446138525,520.4874692299181,0.6327494723971553,False
120,0976e2f50de87d28ad3f7680013b40f72bc99f50,/Users/sanika/Downloads/Master Thesis/repo_updated/pytest/src/_pytest/fixtures.py,7999.0,ModificationType.MODIFY,1482,859,1002,125,135,219,1607,16,219,134,251,235,385,1766.6783660526569,3032.459024427525,9.168949771689498,27804.46447968251,1544.692471093473,1.0108196748091751,False
121,0976e2f50de87d28ad3f7680013b40f72bc99f50,/Users/sanika/Downloads/Master Thesis/repo_updated/pytest/testing/test_pdb.py,3969.0,ModificationType.MODIFY,1293,570,1093,25,15,163,1318,10,195,123,241,205,364,1516.6486921300477,2795.3307562199825,6.17948717948718,17273.710570487587,959.6505872493103,0.931776918739994,False
122,c9524af5ae58bbca9d1696925b15585e07ef72ae,/Users/sanika/Downloads/Master Thesis/repo_updated/pytest/testing/example_scripts/collect/package_infinite_recursion/__init__.pyi,5076.0,ModificationType.MODIFY,0,0,0,0,0,0,0,0,0,0,0,0,0,0.0,0.0,0.0,0.0,0.0,0.0,False
123,c9524af5ae58bbca9d1696925b15585e07ef72ae,/Users/sanika/Downloads/Master Thesis/repo_updated/pytest/testing/example_scripts/collect/package_infinite_recursion/tests/__init__.py,5076.0,ModificationType.MODIFY,0,0,0,0,0,0,0,0,0,0,0,0,0,0.0,0.0,0.0,0.0,0.0,0.0,False
124,c9524af5ae58bbca9d1696925b15585e07ef72ae,/Users/sanika/Downloads/Master Thesis/repo_updated/pytest/testing/example_scripts/collect/collect_init_tests/tests/__init__.py,5076.0,ModificationType.MODIFY,2,2,2,0,0,0,2,0,0,0,0,0,0,0.0,0.0,0.0,0.0,0.0,0.0,False
125,c9524af5ae58bbca9d1696925b15585e07ef72ae,/Users/sanika/Downloads/Master Thesis/repo_updated/pytest/testing/example_scripts/collect/package_init_given_as_arg/pkg/__init__.py,5076.0,ModificationType.MODIFY,0,0,0,0,0,0,0,0,0,0,0,0,0,0.0,0.0,0.0,0.0,0.0,0.0,False
126,c9524af5ae58bbca9d1696925b15585e07ef72ae,/Users/sanika/Downloads/Master Thesis/repo_updated/pytest/testing/example_scripts/conftest_usageerror/__init__.pyi,5076.0,ModificationType.MODIFY,0,0,0,0,0,0,0,0,0,0,0,0,0,0.0,0.0,0.0,0.0,0.0,0.0,False
127,c9524af5ae58bbca9d1696925b15585e07ef72ae,/Users/sanika/Downloads/Master Thesis/repo_updated/pytest/testing/example_scripts/marks/marks_considered_keywords/__init__.pyi,5076.0,ModificationType.MODIFY,0,0,0,0,0,0,0,0,0,0,0,0,0,0.0,0.0,0.0,0.0,0.0,0.0,False
128,c9524af5ae58bbca9d1696925b15585e07ef72ae,/Users/sanika/Downloads/Master Thesis/repo_updated/pytest/testing/example_scripts/config/collect_pytest_prefix/__init__.pyi,5076.0,ModificationType.MODIFY,0,0,0,0,0,0,0,0,0,0,0,0,0,0.0,0.0,0.0,0.0,0.0,0.0,False
129,c9524af5ae58bbca9d1696925b15585e07ef72ae,/Users/sanika/Downloads/Master Thesis/repo_updated/pytest/testing/example_scripts/issue88_initial_file_multinodes/__init__.pyi,5076.0,ModificationType.MODIFY,0,0,0,0,0,0,0,0,0,0,0,0,0,0.0,0.0,0.0,0.0,0.0,0.0,False
130,c9524af5ae58bbca9d1696925b15585e07ef72ae,/Users/sanika/Downloads/Master Thesis/repo_updated/pytest/testing/example_scripts/fixtures/fill_fixtures/test_extend_fixture_conftest_conftest/__init__.pyi,5076.0,ModificationType.MODIFY,0,0,0,0,0,0,0,0,0,0,0,0,0,0.0,0.0,0.0,0.0,0.0,0.0,False
131,c9524af5ae58bbca9d1696925b15585e07ef72ae,/Users/sanika/Downloads/Master Thesis/repo_updated/pytest/testing/example_scripts/fixtures/fill_fixtures/test_extend_fixture_conftest_conftest/pkg/__init__.py,5076.0,ModificationType.MODIFY,0,0,0,0,0,0,0,0,0,0,0,0,0,0.0,0.0,0.0,0.0,0.0,0.0,False
132,c9524af5ae58bbca9d1696925b15585e07ef72ae,/Users/sanika/Downloads/Master Thesis/repo_updated/pytest/testing/example_scripts/fixtures/fill_fixtures/test_extend_fixture_conftest_module/__init__.pyi,5076.0,ModificationType.MODIFY,0,0,0,0,0,0,0,0,0,0,0,0,0,0.0,0.0,0.0,0.0,0.0,0.0,False
133,c9524af5ae58bbca9d1696925b15585e07ef72ae,/Users/sanika/Downloads/Master Thesis/repo_updated/pytest/testing/example_scripts/fixtures/fill_fixtures/test_conftest_funcargs_only_available_in_subdir/sub1/__init__.py,5076.0,ModificationType.MODIFY,0,0,0,0,0,0,0,0,0,0,0,0,0,0.0,0.0,0.0,0.0,0.0,0.0,False
134,c9524af5ae58bbca9d1696925b15585e07ef72ae,/Users/sanika/Downloads/Master Thesis/repo_updated/pytest/testing/example_scripts/fixtures/fill_fixtures/test_conftest_funcargs_only_available_in_subdir/sub2/__init__.py,5076.0,ModificationType.MODIFY,0,0,0,0,0,0,0,0,0,0,0,0,0,0.0,0.0,0.0,0.0,0.0,0.0,False
135,c9524af5ae58bbca9d1696925b15585e07ef72ae,/Users/sanika/Downloads/Master Thesis/repo_updated/pytest/testing/example_scripts/fixtures/custom_item/__init__.pyi,5076.0,ModificationType.MODIFY,0,0,0,0,0,0,0,0,0,0,0,0,0,0.0,0.0,0.0,0.0,0.0,0.0,False
136,c9524af5ae58bbca9d1696925b15585e07ef72ae,/Users/sanika/Downloads/Master Thesis/repo_updated/pytest/testing/example_scripts/fixtures/custom_item/foo/__init__.py,5076.0,ModificationType.MODIFY,0,0,0,0,0,0,0,0,0,0,0,0,0,0.0,0.0,0.0,0.0,0.0,0.0,False
137,c9524af5ae58bbca9d1696925b15585e07ef72ae,/Users/sanika/Downloads/Master Thesis/repo_updated/pytest/doc/en/example/nonpython/__init__.py,5076.0,ModificationType.MODIFY,0,0,0,0,0,0,0,0,0,0,0,0,0,0.0,0.0,0.0,0.0,0.0,0.0,False
138,c9524af5ae58bbca9d1696925b15585e07ef72ae,/Users/sanika/Downloads/Master Thesis/repo_updated/pytest/src/pytest/__init__.py,5076.0,ModificationType.MODIFY,99,48,90,1,3,5,100,0,0,0,0,0,0,0.0,0.0,0.0,0.0,0.0,0.0,False
139,c9524af5ae58bbca9d1696925b15585e07ef72ae,/Users/sanika/Downloads/Master Thesis/repo_updated/pytest/src/_pytest/__init__.py,5076.0,ModificationType.MODIFY,8,5,5,2,0,1,10,0,0,0,0,0,0,0.0,0.0,0.0,0.0,0.0,0.0,False
140,c9524af5ae58bbca9d1696925b15585e07ef72ae,/Users/sanika/Downloads/Master Thesis/repo_updated/pytest/src/_pytest/config/__init__.py,5076.0,ModificationType.MODIFY,1217,716,841,84,126,174,1301,14,185,118,215,199,333,1446.608539104324,2542.995998641035,8.135135135135135,20687.616097052745,1149.3120053918194,0.847665332880345,False
141,c9524af5ae58bbca9d1696925b15585e07ef72ae,/Users/sanika/Downloads/Master Thesis/repo_updated/pytest/src/_pytest/mark/__init__.py,5076.0,ModificationType.MODIFY,160,89,115,0,13,31,160,7,15,11,17,22,28,78.25484338853101,124.86408532184431,3.966666666666667,495.29420510998256,27.516344728332356,0.04162136177394811,False
142,c9524af5ae58bbca9d1696925b15585e07ef72ae,/Users/sanika/Downloads/Master Thesis/repo_updated/pytest/src/_pytest/_code/__init__.py,5076.0,ModificationType.MODIFY,10,10,9,9,0,0,19,0,0,0,0,0,0,0.0,0.0,0.0,0.0,0.0,0.0,False
143,c9524af5ae58bbca9d1696925b15585e07ef72ae,/Users/sanika/Downloads/Master Thesis/repo_updated/pytest/src/_pytest/assertion/__init__.py,5076.0,ModificationType.MODIFY,173,84,99,8,29,36,181,5,12,7,13,17,20,54.62919048309069,81.7492568250068,2.708333333333333,221.40423723439343,12.300235401910744,0.027249752275002263,False
144,c9524af5ae58bbca9d1696925b15585e07ef72ae,/Users/sanika/Downloads/Master Thesis/repo_updated/pytest/src/_pytest/_io/__init__.py,5076.0,ModificationType.MODIFY,3,1,1,3,0,0,6,0,0,0,0,0,0,0.0,0.0,0.0,0.0,0.0,0.0,False
145,c9524af5ae58bbca9d1696925b15585e07ef72ae,/Users/sanika/Downloads/Master Thesis/repo_updated/pytest/testing/python/fixtures.py,6225.0,ModificationType.MODIFY,4293,999,3693,19,54,507,4312,9,155,88,170,164,258,1156.3286078304875,1898.2484171914662,4.935483870967742,9368.774446138525,520.4874692299181,0.6327494723971553,False
146,c9524af5ae58bbca9d1696925b15585e07ef72ae,/Users/sanika/Downloads/Master Thesis/repo_updated/pytest/src/_pytest/fixtures.py,6225.0,ModificationType.MODIFY,1482,859,1002,125,135,219,1607,16,219,134,251,235,385,1766.6783660526569,3032.459024427525,9.168949771689498,27804.46447968251,1544.692471093473,1.0108196748091751,False
147,c9524af5ae58bbca9d1696925b15585e07ef72ae,/Users/sanika/Downloads/Master Thesis/repo_updated/pytest/src/_pytest/hookspec.py,640.0,ModificationType.MODIFY,647,139,84,35,284,233,682,0,0,0,0,0,0,0.0,0.0,0.0,0.0,0.0,0.0,False
148,c9524af5ae58bbca9d1696925b15585e07ef72ae,/Users/sanika/Downloads/Master Thesis/repo_updated/pytest/src/_pytest/logging.py,2754.0,ModificationType.MODIFY,773,422,505,30,103,129,803,14,77,46,83,91,129,535.8455325423139,839.5055085856317,7.545454545454546,6334.450655691586,351.9139253161992,0.2798351695285439,False
149,c9524af5ae58bbca9d1696925b15585e07ef72ae,/Users/sanika/Downloads/Master Thesis/repo_updated/pytest/testing/test_main.py,3472.0,ModificationType.MODIFY,77,34,69,0,0,8,77,3,24,16,29,27,45,114.79398751947123,213.9699375973561,1.8125,387.82051189520797,21.54558399417822,0.07132331253245204,False
150,c9524af5ae58bbca9d1696925b15585e07ef72ae,/Users/sanika/Downloads/Master Thesis/repo_updated/pytest/src/_pytest/main.py,3472.0,ModificationType.MODIFY,712,438,573,51,9,84,763,14,102,71,128,116,199,733.8903537898989,1364.7382180303869,8.784313725490197,11988.288660345359,666.0160366858534,0.4549127393434623,False
151,c9524af5ae58bbca9d1696925b15585e07ef72ae,/Users/sanika/Downloads/Master Thesis/repo_updated/pytest/testing/python/fixtures.py,7999.0,ModificationType.MODIFY,4293,999,3693,19,54,507,4312,9,155,88,170,164,258,1156.3286078304875,1898.2484171914662,4.935483870967742,9368.774446138525,520.4874692299181,0.6327494723971553,False
152,c9524af5ae58bbca9d1696925b15585e07ef72ae,/Users/sanika/Downloads/Master Thesis/repo_updated/pytest/src/_pytest/fixtures.py,7999.0,ModificationType.MODIFY,1482,859,1002,125,135,219,1607,16,219,134,251,235,385,1766.6783660526569,3032.459024427525,9.168949771689498,27804.46447968251,1544.692471093473,1.0108196748091751,False
153,c9524af5ae58bbca9d1696925b15585e07ef72ae,/Users/sanika/Downloads/Master Thesis/repo_updated/pytest/testing/test_pdb.py,3969.0,ModificationType.MODIFY,1293,570,1093,25,15,163,1318,10,195,123,241,205,364,1516.6486921300477,2795.3307562199825,6.17948717948718,17273.710570487587,959.6505872493103,0.931776918739994,False
154,ab245ccdc3f1d7aa99a695dd43ceb9d94ccc93bb,/Users/sanika/Downloads/Master Thesis/repo_updated/pytest/testing/test_terminal.py,5905.0,ModificationType.MODIFY,1943,715,1694,26,18,214,1969,12,185,120,237,197,357,1436.3251202041715,2721.0724995459263,7.686486486486486,20915.486996509768,1161.971499806098,0.9070241665153088,False
155,ab245ccdc3f1d7aa99a695dd43ceb9d94ccc93bb,/Users/sanika/Downloads/Master Thesis/repo_updated/pytest/src/_pytest/terminal.py,5905.0,ModificationType.MODIFY,1168,838,957,57,25,144,1225,19,348,224,416,367,640,3018.854959310786,5452.567201819657,11.35632183908046,61921.107993078396,3440.0615551710216,1.817522400606552,False
156,afac1f002109e71a0b492d5aba44c30bfdaec89d,/Users/sanika/Downloads/Master Thesis/repo_updated/pytest/testing/example_scripts/collect/package_infinite_recursion/__init__.pyi,5050.0,ModificationType.MODIFY,0,0,0,0,0,0,0,0,0,0,0,0,0,0.0,0.0,0.0,0.0,0.0,0.0,False
157,afac1f002109e71a0b492d5aba44c30bfdaec89d,/Users/sanika/Downloads/Master Thesis/repo_updated/pytest/testing/example_scripts/collect/package_infinite_recursion/tests/__init__.py,5050.0,ModificationType.MODIFY,0,0,0,0,0,0,0,0,0,0,0,0,0,0.0,0.0,0.0,0.0,0.0,0.0,False
158,afac1f002109e71a0b492d5aba44c30bfdaec89d,/Users/sanika/Downloads/Master Thesis/repo_updated/pytest/testing/example_scripts/collect/collect_init_tests/tests/__init__.py,5050.0,ModificationType.MODIFY,2,2,2,0,0,0,2,0,0,0,0,0,0,0.0,0.0,0.0,0.0,0.0,0.0,False
159,afac1f002109e71a0b492d5aba44c30bfdaec89d,/Users/sanika/Downloads/Master Thesis/repo_updated/pytest/testing/example_scripts/collect/package_init_given_as_arg/pkg/__init__.py,5050.0,ModificationType.MODIFY,0,0,0,0,0,0,0,0,0,0,0,0,0,0.0,0.0,0.0,0.0,0.0,0.0,False
160,afac1f002109e71a0b492d5aba44c30bfdaec89d,/Users/sanika/Downloads/Master Thesis/repo_updated/pytest/testing/example_scripts/conftest_usageerror/__init__.pyi,5050.0,ModificationType.MODIFY,0,0,0,0,0,0,0,0,0,0,0,0,0,0.0,0.0,0.0,0.0,0.0,0.0,False
161,afac1f002109e71a0b492d5aba44c30bfdaec89d,/Users/sanika/Downloads/Master Thesis/repo_updated/pytest/testing/example_scripts/marks/marks_considered_keywords/__init__.pyi,5050.0,ModificationType.MODIFY,0,0,0,0,0,0,0,0,0,0,0,0,0,0.0,0.0,0.0,0.0,0.0,0.0,False
162,afac1f002109e71a0b492d5aba44c30bfdaec89d,/Users/sanika/Downloads/Master Thesis/repo_updated/pytest/testing/example_scripts/config/collect_pytest_prefix/__init__.pyi,5050.0,ModificationType.MODIFY,0,0,0,0,0,0,0,0,0,0,0,0,0,0.0,0.0,0.0,0.0,0.0,0.0,False
163,afac1f002109e71a0b492d5aba44c30bfdaec89d,/Users/sanika/Downloads/Master Thesis/repo_updated/pytest/testing/example_scripts/issue88_initial_file_multinodes/__init__.pyi,5050.0,ModificationType.MODIFY,0,0,0,0,0,0,0,0,0,0,0,0,0,0.0,0.0,0.0,0.0,0.0,0.0,False
164,afac1f002109e71a0b492d5aba44c30bfdaec89d,/Users/sanika/Downloads/Master Thesis/repo_updated/pytest/testing/example_scripts/fixtures/fill_fixtures/test_extend_fixture_conftest_conftest/__init__.pyi,5050.0,ModificationType.MODIFY,0,0,0,0,0,0,0,0,0,0,0,0,0,0.0,0.0,0.0,0.0,0.0,0.0,False
165,afac1f002109e71a0b492d5aba44c30bfdaec89d,/Users/sanika/Downloads/Master Thesis/repo_updated/pytest/testing/example_scripts/fixtures/fill_fixtures/test_extend_fixture_conftest_conftest/pkg/__init__.py,5050.0,ModificationType.MODIFY,0,0,0,0,0,0,0,0,0,0,0,0,0,0.0,0.0,0.0,0.0,0.0,0.0,False
166,afac1f002109e71a0b492d5aba44c30bfdaec89d,/Users/sanika/Downloads/Master Thesis/repo_updated/pytest/testing/example_scripts/fixtures/fill_fixtures/test_extend_fixture_conftest_module/__init__.pyi,5050.0,ModificationType.MODIFY,0,0,0,0,0,0,0,0,0,0,0,0,0,0.0,0.0,0.0,0.0,0.0,0.0,False
167,afac1f002109e71a0b492d5aba44c30bfdaec89d,/Users/sanika/Downloads/Master Thesis/repo_updated/pytest/testing/example_scripts/fixtures/fill_fixtures/test_conftest_funcargs_only_available_in_subdir/sub1/__init__.py,5050.0,ModificationType.MODIFY,0,0,0,0,0,0,0,0,0,0,0,0,0,0.0,0.0,0.0,0.0,0.0,0.0,False
168,afac1f002109e71a0b492d5aba44c30bfdaec89d,/Users/sanika/Downloads/Master Thesis/repo_updated/pytest/testing/example_scripts/fixtures/fill_fixtures/test_conftest_funcargs_only_available_in_subdir/sub2/__init__.py,5050.0,ModificationType.MODIFY,0,0,0,0,0,0,0,0,0,0,0,0,0,0.0,0.0,0.0,0.0,0.0,0.0,False
169,afac1f002109e71a0b492d5aba44c30bfdaec89d,/Users/sanika/Downloads/Master Thesis/repo_updated/pytest/testing/example_scripts/fixtures/custom_item/__init__.pyi,5050.0,ModificationType.MODIFY,0,0,0,0,0,0,0,0,0,0,0,0,0,0.0,0.0,0.0,0.0,0.0,0.0,False
170,afac1f002109e71a0b492d5aba44c30bfdaec89d,/Users/sanika/Downloads/Master Thesis/repo_updated/pytest/testing/example_scripts/fixtures/custom_item/foo/__init__.py,5050.0,ModificationType.MODIFY,0,0,0,0,0,0,0,0,0,0,0,0,0,0.0,0.0,0.0,0.0,0.0,0.0,False
171,afac1f002109e71a0b492d5aba44c30bfdaec89d,/Users/sanika/Downloads/Master Thesis/repo_updated/pytest/doc/en/example/nonpython/__init__.py,5050.0,ModificationType.MODIFY,0,0,0,0,0,0,0,0,0,0,0,0,0,0.0,0.0,0.0,0.0,0.0,0.0,False
172,afac1f002109e71a0b492d5aba44c30bfdaec89d,/Users/sanika/Downloads/Master Thesis/repo_updated/pytest/src/pytest/__init__.py,5050.0,ModificationType.MODIFY,99,48,90,1,3,5,100,0,0,0,0,0,0,0.0,0.0,0.0,0.0,0.0,0.0,False
173,afac1f002109e71a0b492d5aba44c30bfdaec89d,/Users/sanika/Downloads/Master Thesis/repo_updated/pytest/src/_pytest/__init__.py,5050.0,ModificationType.MODIFY,8,5,5,2,0,1,10,0,0,0,0,0,0,0.0,0.0,0.0,0.0,0.0,0.0,False
174,afac1f002109e71a0b492d5aba44c30bfdaec89d,/Users/sanika/Downloads/Master Thesis/repo_updated/pytest/src/_pytest/config/__init__.py,5050.0,ModificationType.MODIFY,1217,716,841,84,126,174,1301,14,185,118,215,199,333,1446.608539104324,2542.995998641035,8.135135135135135,20687.616097052745,1149.3120053918194,0.847665332880345,False
175,afac1f002109e71a0b492d5aba44c30bfdaec89d,/Users/sanika/Downloads/Master Thesis/repo_updated/pytest/src/_pytest/mark/__init__.py,5050.0,ModificationType.MODIFY,160,89,115,0,13,31,160,7,15,11,17,22,28,78.25484338853101,124.86408532184431,3.966666666666667,495.29420510998256,27.516344728332356,0.04162136177394811,False
176,afac1f002109e71a0b492d5aba44c30bfdaec89d,/Users/sanika/Downloads/Master Thesis/repo_updated/pytest/src/_pytest/_code/__init__.py,5050.0,ModificationType.MODIFY,10,10,9,9,0,0,19,0,0,0,0,0,0,0.0,0.0,0.0,0.0,0.0,0.0,False
177,afac1f002109e71a0b492d5aba44c30bfdaec89d,/Users/sanika/Downloads/Master Thesis/repo_updated/pytest/src/_pytest/assertion/__init__.py,5050.0,ModificationType.MODIFY,173,84,99,8,29,36,181,5,12,7,13,17,20,54.62919048309069,81.7492568250068,2.708333333333333,221.40423723439343,12.300235401910744,0.027249752275002263,False
178,afac1f002109e71a0b492d5aba44c30bfdaec89d,/Users/sanika/Downloads/Master Thesis/repo_updated/pytest/src/_pytest/_io/__init__.py,5050.0,ModificationType.MODIFY,3,1,1,3,0,0,6,0,0,0,0,0,0,0.0,0.0,0.0,0.0,0.0,0.0,False
179,94c4dd6ad776179fd9589b4790ed36760454b0dd,/Users/sanika/Downloads/Master Thesis/repo_updated/pytest/testing/test_terminal.py,5905.0,ModificationType.MODIFY,1943,715,1694,26,18,214,1969,12,185,120,237,197,357,1436.3251202041715,2721.0724995459263,7.686486486486486,20915.486996509768,1161.971499806098,0.9070241665153088,False
180,94c4dd6ad776179fd9589b4790ed36760454b0dd,/Users/sanika/Downloads/Master Thesis/repo_updated/pytest/src/_pytest/terminal.py,5905.0,ModificationType.MODIFY,1168,838,957,57,25,144,1225,19,348,224,416,367,640,3018.854959310786,5452.567201819657,11.35632183908046,61921.107993078396,3440.0615551710216,1.817522400606552,False
181,5e7b8d813b851e2a3dc646a523bac621ce6801c3,/Users/sanika/Downloads/Master Thesis/repo_updated/pytest/testing/example_scripts/collect/package_infinite_recursion/__init__.pyi,5050.0,ModificationType.MODIFY,0,0,0,0,0,0,0,0,0,0,0,0,0,0.0,0.0,0.0,0.0,0.0,0.0,False
182,5e7b8d813b851e2a3dc646a523bac621ce6801c3,/Users/sanika/Downloads/Master Thesis/repo_updated/pytest/testing/example_scripts/collect/package_infinite_recursion/tests/__init__.py,5050.0,ModificationType.MODIFY,0,0,0,0,0,0,0,0,0,0,0,0,0,0.0,0.0,0.0,0.0,0.0,0.0,False
183,5e7b8d813b851e2a3dc646a523bac621ce6801c3,/Users/sanika/Downloads/Master Thesis/repo_updated/pytest/testing/example_scripts/collect/collect_init_tests/tests/__init__.py,5050.0,ModificationType.MODIFY,2,2,2,0,0,0,2,0,0,0,0,0,0,0.0,0.0,0.0,0.0,0.0,0.0,False
184,5e7b8d813b851e2a3dc646a523bac621ce6801c3,/Users/sanika/Downloads/Master Thesis/repo_updated/pytest/testing/example_scripts/collect/package_init_given_as_arg/pkg/__init__.py,5050.0,ModificationType.MODIFY,0,0,0,0,0,0,0,0,0,0,0,0,0,0.0,0.0,0.0,0.0,0.0,0.0,False
185,5e7b8d813b851e2a3dc646a523bac621ce6801c3,/Users/sanika/Downloads/Master Thesis/repo_updated/pytest/testing/example_scripts/conftest_usageerror/__init__.pyi,5050.0,ModificationType.MODIFY,0,0,0,0,0,0,0,0,0,0,0,0,0,0.0,0.0,0.0,0.0,0.0,0.0,False
186,5e7b8d813b851e2a3dc646a523bac621ce6801c3,/Users/sanika/Downloads/Master Thesis/repo_updated/pytest/testing/example_scripts/marks/marks_considered_keywords/__init__.pyi,5050.0,ModificationType.MODIFY,0,0,0,0,0,0,0,0,0,0,0,0,0,0.0,0.0,0.0,0.0,0.0,0.0,False
187,5e7b8d813b851e2a3dc646a523bac621ce6801c3,/Users/sanika/Downloads/Master Thesis/repo_updated/pytest/testing/example_scripts/config/collect_pytest_prefix/__init__.pyi,5050.0,ModificationType.MODIFY,0,0,0,0,0,0,0,0,0,0,0,0,0,0.0,0.0,0.0,0.0,0.0,0.0,False
188,5e7b8d813b851e2a3dc646a523bac621ce6801c3,/Users/sanika/Downloads/Master Thesis/repo_updated/pytest/testing/example_scripts/issue88_initial_file_multinodes/__init__.pyi,5050.0,ModificationType.MODIFY,0,0,0,0,0,0,0,0,0,0,0,0,0,0.0,0.0,0.0,0.0,0.0,0.0,False
189,5e7b8d813b851e2a3dc646a523bac621ce6801c3,/Users/sanika/Downloads/Master Thesis/repo_updated/pytest/testing/example_scripts/fixtures/fill_fixtures/test_extend_fixture_conftest_conftest/__init__.pyi,5050.0,ModificationType.MODIFY,0,0,0,0,0,0,0,0,0,0,0,0,0,0.0,0.0,0.0,0.0,0.0,0.0,False
190,5e7b8d813b851e2a3dc646a523bac621ce6801c3,/Users/sanika/Downloads/Master Thesis/repo_updated/pytest/testing/example_scripts/fixtures/fill_fixtures/test_extend_fixture_conftest_conftest/pkg/__init__.py,5050.0,ModificationType.MODIFY,0,0,0,0,0,0,0,0,0,0,0,0,0,0.0,0.0,0.0,0.0,0.0,0.0,False
191,5e7b8d813b851e2a3dc646a523bac621ce6801c3,/Users/sanika/Downloads/Master Thesis/repo_updated/pytest/testing/example_scripts/fixtures/fill_fixtures/test_extend_fixture_conftest_module/__init__.pyi,5050.0,ModificationType.MODIFY,0,0,0,0,0,0,0,0,0,0,0,0,0,0.0,0.0,0.0,0.0,0.0,0.0,False
192,5e7b8d813b851e2a3dc646a523bac621ce6801c3,/Users/sanika/Downloads/Master Thesis/repo_updated/pytest/testing/example_scripts/fixtures/fill_fixtures/test_conftest_funcargs_only_available_in_subdir/sub1/__init__.py,5050.0,ModificationType.MODIFY,0,0,0,0,0,0,0,0,0,0,0,0,0,0.0,0.0,0.0,0.0,0.0,0.0,False
193,5e7b8d813b851e2a3dc646a523bac621ce6801c3,/Users/sanika/Downloads/Master Thesis/repo_updated/pytest/testing/example_scripts/fixtures/fill_fixtures/test_conftest_funcargs_only_available_in_subdir/sub2/__init__.py,5050.0,ModificationType.MODIFY,0,0,0,0,0,0,0,0,0,0,0,0,0,0.0,0.0,0.0,0.0,0.0,0.0,False
194,5e7b8d813b851e2a3dc646a523bac621ce6801c3,/Users/sanika/Downloads/Master Thesis/repo_updated/pytest/testing/example_scripts/fixtures/custom_item/__init__.pyi,5050.0,ModificationType.MODIFY,0,0,0,0,0,0,0,0,0,0,0,0,0,0.0,0.0,0.0,0.0,0.0,0.0,False
195,5e7b8d813b851e2a3dc646a523bac621ce6801c3,/Users/sanika/Downloads/Master Thesis/repo_updated/pytest/testing/example_scripts/fixtures/custom_item/foo/__init__.py,5050.0,ModificationType.MODIFY,0,0,0,0,0,0,0,0,0,0,0,0,0,0.0,0.0,0.0,0.0,0.0,0.0,False
196,5e7b8d813b851e2a3dc646a523bac621ce6801c3,/Users/sanika/Downloads/Master Thesis/repo_updated/pytest/doc/en/example/nonpython/__init__.py,5050.0,ModificationType.MODIFY,0,0,0,0,0,0,0,0,0,0,0,0,0,0.0,0.0,0.0,0.0,0.0,0.0,False
197,5e7b8d813b851e2a3dc646a523bac621ce6801c3,/Users/sanika/Downloads/Master Thesis/repo_updated/pytest/src/pytest/__init__.py,5050.0,ModificationType.MODIFY,99,48,90,1,3,5,100,0,0,0,0,0,0,0.0,0.0,0.0,0.0,0.0,0.0,False
198,5e7b8d813b851e2a3dc646a523bac621ce6801c3,/Users/sanika/Downloads/Master Thesis/repo_updated/pytest/src/_pytest/__init__.py,5050.0,ModificationType.MODIFY,8,5,5,2,0,1,10,0,0,0,0,0,0,0.0,0.0,0.0,0.0,0.0,0.0,False
199,5e7b8d813b851e2a3dc646a523bac621ce6801c3,/Users/sanika/Downloads/Master Thesis/repo_updated/pytest/src/_pytest/config/__init__.py,5050.0,ModificationType.MODIFY,1217,716,841,84,126,174,1301,14,185,118,215,199,333,1446.608539104324,2542.995998641035,8.135135135135135,20687.616097052745,1149.3120053918194,0.847665332880345,False
200,5e7b8d813b851e2a3dc646a523bac621ce6801c3,/Users/sanika/Downloads/Master Thesis/repo_updated/pytest/src/_pytest/mark/__init__.py,5050.0,ModificationType.MODIFY,160,89,115,0,13,31,160,7,15,11,17,22,28,78.25484338853101,124.86408532184431,3.966666666666667,495.29420510998256,27.516344728332356,0.04162136177394811,False
201,5e7b8d813b851e2a3dc646a523bac621ce6801c3,/Users/sanika/Downloads/Master Thesis/repo_updated/pytest/src/_pytest/_code/__init__.py,5050.0,ModificationType.MODIFY,10,10,9,9,0,0,19,0,0,0,0,0,0,0.0,0.0,0.0,0.0,0.0,0.0,False
202,5e7b8d813b851e2a3dc646a523bac621ce6801c3,/Users/sanika/Downloads/Master Thesis/repo_updated/pytest/src/_pytest/assertion/__init__.py,5050.0,ModificationType.MODIFY,173,84,99,8,29,36,181,5,12,7,13,17,20,54.62919048309069,81.7492568250068,2.708333333333333,221.40423723439343,12.300235401910744,0.027249752275002263,False
203,5e7b8d813b851e2a3dc646a523bac621ce6801c3,/Users/sanika/Downloads/Master Thesis/repo_updated/pytest/src/_pytest/_io/__init__.py,5050.0,ModificationType.MODIFY,3,1,1,3,0,0,6,0,0,0,0,0,0,0.0,0.0,0.0,0.0,0.0,0.0,False
204,cd753aa4ab599d2cccbefb7c837681efae406a29,/Users/sanika/Downloads/Master Thesis/repo_updated/pytest/testing/code/test_code.py,4989.0,ModificationType.MODIFY,182,127,129,0,0,53,182,5,39,21,42,44,63,217.7403270100645,343.9441919741497,2.6923076923076925,926.003593776557,51.44464409869761,0.11464806399138325,False
205,cd753aa4ab599d2cccbefb7c837681efae406a29,/Users/sanika/Downloads/Master Thesis/repo_updated/pytest/src/_pytest/_code/code.py,4989.0,ModificationType.MODIFY,1165,710,800,67,119,181,1232,18,243,153,282,261,435,2000.7880884021665,3492.1391085079,10.444444444444443,36473.45291108252,2026.302939504584,1.1640463695026333,False
206,3173a26388b7724adeb2c5f44325bbbfbad77d10,/Users/sanika/Downloads/Master Thesis/repo_updated/pytest/testing/test_cacheprovider.py,2024.0,ModificationType.MODIFY,996,429,845,24,10,117,1020,7,76,50,88,83,138,494.49397547611574,879.7554415258757,4.052631578947368,3565.324684078549,198.07359355991935,0.2932518138419585,False
207,3173a26388b7724adeb2c5f44325bbbfbad77d10,/Users/sanika/Downloads/Master Thesis/repo_updated/pytest/src/_pytest/cacheprovider.py,2024.0,ModificationType.MODIFY,456,277,329,12,42,72,468,13,85,50,97,98,147,592.903945907539,972.3623470849358,7.417647058823531,7212.640703965319,400.7022613314065,0.3241207823616453,False
208,3173a26388b7724adeb2c5f44325bbbfbad77d10,/Users/sanika/Downloads/Master Thesis/repo_updated/pytest/testing/test_cacheprovider.py,3806.0,ModificationType.MODIFY,996,429,845,24,10,117,1020,7,76,50,88,83,138,494.49397547611574,879.7554415258757,4.052631578947368,3565.324684078549,198.07359355991935,0.2932518138419585,False
209,5b88612e5bebc3e4d067484436cfc591f41a3eac,/Users/sanika/Downloads/Master Thesis/repo_updated/pytest/testing/test_unittest.py,2040.0,ModificationType.MODIFY,1098,241,925,5,10,155,1103,7,46,25,49,53,74,273.7353344330258,423.86611363767685,3.728260869565217,1580.283445410034,87.79352474500189,0.14128870454589226,False
210,15f956869479a60b1c39f72309e9a0e7b75f1689,/Users/sanika/Downloads/Master Thesis/repo_updated/pytest/testing/test_runner.py,1918.0,ModificationType.MODIFY,1043,504,840,53,9,147,1096,9,180,112,198,189,310,1377.0628823523223,2344.2951515085324,4.95,11604.260999967237,644.6811666648464,0.7814317171695108,False
211,15f956869479a60b1c39f72309e9a0e7b75f1689,/Users/sanika/Downloads/Master Thesis/repo_updated/pytest/src/_pytest/runner.py,1918.0,ModificationType.MODIFY,383,288,292,26,6,62,409,11,65,38,67,76,105,429.5076556518598,656.0323889115765,5.6692307692307695,3719.1990048294756,206.6221669349709,0.2186774629705255,False
212,15f956869479a60b1c39f72309e9a0e7b75f1689,/Users/sanika/Downloads/Master Thesis/repo_updated/pytest/testing/test_runner.py,3446.0,ModificationType.MODIFY,1043,504,840,53,9,147,1096,9,180,112,198,189,310,1377.0628823523223,2344.2951515085324,4.95,11604.260999967237,644.6811666648464,0.7814317171695108,False
213,119bf66d7a29a11f1a8a6ba1df496f3d3c457005,/Users/sanika/Downloads/Master Thesis/repo_updated/pytest/testing/code/test_code.py,4989.0,ModificationType.MODIFY,182,127,129,0,0,53,182,5,39,21,42,44,63,217.7403270100645,343.9441919741497,2.6923076923076925,926.003593776557,51.44464409869761,0.11464806399138325,False
214,119bf66d7a29a11f1a8a6ba1df496f3d3c457005,/Users/sanika/Downloads/Master Thesis/repo_updated/pytest/src/_pytest/_code/code.py,4989.0,ModificationType.MODIFY,1165,710,800,67,119,181,1232,18,243,153,282,261,435,2000.7880884021665,3492.1391085079,10.444444444444443,36473.45291108252,2026.302939504584,1.1640463695026333,False
215,e05b33ed162fd9da8f9c44c9de035a0fa14631ec,/Users/sanika/Downloads/Master Thesis/repo_updated/pytest/testing/test_setuponly.py,381.0,ModificationType.MODIFY,294,64,250,0,0,43,294,1,20,10,20,21,30,86.43856189774725,131.7695226833628,0.5,65.8847613416814,3.660264518982301,0.04392317422778761,False
216,e05b33ed162fd9da8f9c44c9de035a0fa14631ec,/Users/sanika/Downloads/Master Thesis/repo_updated/pytest/src/_pytest/setuponly.py,381.0,ModificationType.MODIFY,78,46,62,3,0,14,81,3,8,4,8,11,12,28.754887502163466,41.51317942364757,1.5,62.269769135471364,3.4594316186372978,0.013837726474549191,False
217,d12cdd3127d5222335c699fd8e52c7ed8257b9e4,/Users/sanika/Downloads/Master Thesis/repo_updated/pytest/testing/example_scripts/collect/package_infinite_recursion/__init__.pyi,5074.0,ModificationType.MODIFY,0,0,0,0,0,0,0,0,0,0,0,0,0,0.0,0.0,0.0,0.0,0.0,0.0,False
218,d12cdd3127d5222335c699fd8e52c7ed8257b9e4,/Users/sanika/Downloads/Master Thesis/repo_updated/pytest/testing/example_scripts/collect/package_infinite_recursion/tests/__init__.py,5074.0,ModificationType.MODIFY,0,0,0,0,0,0,0,0,0,0,0,0,0,0.0,0.0,0.0,0.0,0.0,0.0,False
219,d12cdd3127d5222335c699fd8e52c7ed8257b9e4,/Users/sanika/Downloads/Master Thesis/repo_updated/pytest/testing/example_scripts/collect/collect_init_tests/tests/__init__.py,5074.0,ModificationType.MODIFY,2,2,2,0,0,0,2,0,0,0,0,0,0,0.0,0.0,0.0,0.0,0.0,0.0,False
220,d12cdd3127d5222335c699fd8e52c7ed8257b9e4,/Users/sanika/Downloads/Master Thesis/repo_updated/pytest/testing/example_scripts/collect/package_init_given_as_arg/pkg/__init__.py,5074.0,ModificationType.MODIFY,0,0,0,0,0,0,0,0,0,0,0,0,0,0.0,0.0,0.0,0.0,0.0,0.0,False
221,d12cdd3127d5222335c699fd8e52c7ed8257b9e4,/Users/sanika/Downloads/Master Thesis/repo_updated/pytest/testing/example_scripts/conftest_usageerror/__init__.pyi,5074.0,ModificationType.MODIFY,0,0,0,0,0,0,0,0,0,0,0,0,0,0.0,0.0,0.0,0.0,0.0,0.0,False
222,d12cdd3127d5222335c699fd8e52c7ed8257b9e4,/Users/sanika/Downloads/Master Thesis/repo_updated/pytest/testing/example_scripts/marks/marks_considered_keywords/__init__.pyi,5074.0,ModificationType.MODIFY,0,0,0,0,0,0,0,0,0,0,0,0,0,0.0,0.0,0.0,0.0,0.0,0.0,False
223,d12cdd3127d5222335c699fd8e52c7ed8257b9e4,/Users/sanika/Downloads/Master Thesis/repo_updated/pytest/testing/example_scripts/config/collect_pytest_prefix/__init__.pyi,5074.0,ModificationType.MODIFY,0,0,0,0,0,0,0,0,0,0,0,0,0,0.0,0.0,0.0,0.0,0.0,0.0,False
224,d12cdd3127d5222335c699fd8e52c7ed8257b9e4,/Users/sanika/Downloads/Master Thesis/repo_updated/pytest/testing/example_scripts/issue88_initial_file_multinodes/__init__.pyi,5074.0,ModificationType.MODIFY,0,0,0,0,0,0,0,0,0,0,0,0,0,0.0,0.0,0.0,0.0,0.0,0.0,False
225,d12cdd3127d5222335c699fd8e52c7ed8257b9e4,/Users/sanika/Downloads/Master Thesis/repo_updated/pytest/testing/example_scripts/fixtures/fill_fixtures/test_extend_fixture_conftest_conftest/__init__.pyi,5074.0,ModificationType.MODIFY,0,0,0,0,0,0,0,0,0,0,0,0,0,0.0,0.0,0.0,0.0,0.0,0.0,False
226,d12cdd3127d5222335c699fd8e52c7ed8257b9e4,/Users/sanika/Downloads/Master Thesis/repo_updated/pytest/testing/example_scripts/fixtures/fill_fixtures/test_extend_fixture_conftest_conftest/pkg/__init__.py,5074.0,ModificationType.MODIFY,0,0,0,0,0,0,0,0,0,0,0,0,0,0.0,0.0,0.0,0.0,0.0,0.0,False
227,d12cdd3127d5222335c699fd8e52c7ed8257b9e4,/Users/sanika/Downloads/Master Thesis/repo_updated/pytest/testing/example_scripts/fixtures/fill_fixtures/test_extend_fixture_conftest_module/__init__.pyi,5074.0,ModificationType.MODIFY,0,0,0,0,0,0,0,0,0,0,0,0,0,0.0,0.0,0.0,0.0,0.0,0.0,False
228,d12cdd3127d5222335c699fd8e52c7ed8257b9e4,/Users/sanika/Downloads/Master Thesis/repo_updated/pytest/testing/example_scripts/fixtures/fill_fixtures/test_conftest_funcargs_only_available_in_subdir/sub1/__init__.py,5074.0,ModificationType.MODIFY,0,0,0,0,0,0,0,0,0,0,0,0,0,0.0,0.0,0.0,0.0,0.0,0.0,False
229,d12cdd3127d5222335c699fd8e52c7ed8257b9e4,/Users/sanika/Downloads/Master Thesis/repo_updated/pytest/testing/example_scripts/fixtures/fill_fixtures/test_conftest_funcargs_only_available_in_subdir/sub2/__init__.py,5074.0,ModificationType.MODIFY,0,0,0,0,0,0,0,0,0,0,0,0,0,0.0,0.0,0.0,0.0,0.0,0.0,False
230,d12cdd3127d5222335c699fd8e52c7ed8257b9e4,/Users/sanika/Downloads/Master Thesis/repo_updated/pytest/testing/example_scripts/fixtures/custom_item/__init__.pyi,5074.0,ModificationType.MODIFY,0,0,0,0,0,0,0,0,0,0,0,0,0,0.0,0.0,0.0,0.0,0.0,0.0,False
231,d12cdd3127d5222335c699fd8e52c7ed8257b9e4,/Users/sanika/Downloads/Master Thesis/repo_updated/pytest/testing/example_scripts/fixtures/custom_item/foo/__init__.py,5074.0,ModificationType.MODIFY,0,0,0,0,0,0,0,0,0,0,0,0,0,0.0,0.0,0.0,0.0,0.0,0.0,False
232,d12cdd3127d5222335c699fd8e52c7ed8257b9e4,/Users/sanika/Downloads/Master Thesis/repo_updated/pytest/doc/en/example/nonpython/__init__.py,5074.0,ModificationType.MODIFY,0,0,0,0,0,0,0,0,0,0,0,0,0,0.0,0.0,0.0,0.0,0.0,0.0,False
233,d12cdd3127d5222335c699fd8e52c7ed8257b9e4,/Users/sanika/Downloads/Master Thesis/repo_updated/pytest/src/pytest/__init__.py,5074.0,ModificationType.MODIFY,99,48,90,1,3,5,100,0,0,0,0,0,0,0.0,0.0,0.0,0.0,0.0,0.0,False
234,d12cdd3127d5222335c699fd8e52c7ed8257b9e4,/Users/sanika/Downloads/Master Thesis/repo_updated/pytest/src/_pytest/__init__.py,5074.0,ModificationType.MODIFY,8,5,5,2,0,1,10,0,0,0,0,0,0,0.0,0.0,0.0,0.0,0.0,0.0,False
235,d12cdd3127d5222335c699fd8e52c7ed8257b9e4,/Users/sanika/Downloads/Master Thesis/repo_updated/pytest/src/_pytest/config/__init__.py,5074.0,ModificationType.MODIFY,1217,716,841,84,126,174,1301,14,185,118,215,199,333,1446.608539104324,2542.995998641035,8.135135135135135,20687.616097052745,1149.3120053918194,0.847665332880345,False
236,d12cdd3127d5222335c699fd8e52c7ed8257b9e4,/Users/sanika/Downloads/Master Thesis/repo_updated/pytest/src/_pytest/mark/__init__.py,5074.0,ModificationType.MODIFY,160,89,115,0,13,31,160,7,15,11,17,22,28,78.25484338853101,124.86408532184431,3.966666666666667,495.29420510998256,27.516344728332356,0.04162136177394811,False
237,d12cdd3127d5222335c699fd8e52c7ed8257b9e4,/Users/sanika/Downloads/Master Thesis/repo_updated/pytest/src/_pytest/_code/__init__.py,5074.0,ModificationType.MODIFY,10,10,9,9,0,0,19,0,0,0,0,0,0,0.0,0.0,0.0,0.0,0.0,0.0,False
238,d12cdd3127d5222335c699fd8e52c7ed8257b9e4,/Users/sanika/Downloads/Master Thesis/repo_updated/pytest/src/_pytest/assertion/__init__.py,5074.0,ModificationType.MODIFY,173,84,99,8,29,36,181,5,12,7,13,17,20,54.62919048309069,81.7492568250068,2.708333333333333,221.40423723439343,12.300235401910744,0.027249752275002263,False
239,d12cdd3127d5222335c699fd8e52c7ed8257b9e4,/Users/sanika/Downloads/Master Thesis/repo_updated/pytest/src/_pytest/_io/__init__.py,5074.0,ModificationType.MODIFY,3,1,1,3,0,0,6,0,0,0,0,0,0,0.0,0.0,0.0,0.0,0.0,0.0,False
240,d12cdd3127d5222335c699fd8e52c7ed8257b9e4,/Users/sanika/Downloads/Master Thesis/repo_updated/pytest/testing/test_config.py,6057.0,ModificationType.MODIFY,1457,730,1242,11,6,188,1468,10,292,166,329,302,495,2424.648052141839,4078.0103459659135,5.633561643835616,22973.722668198385,1276.3179260110217,1.359336781988638,False
241,9b673bcc44b8dc9d1436e3cd2403f21724324064,/Users/sanika/Downloads/Master Thesis/repo_updated/pytest/testing/test_runner.py,1918.0,ModificationType.MODIFY,1043,504,840,53,9,147,1096,9,180,112,198,189,310,1377.0628823523223,2344.2951515085324,4.95,11604.260999967237,644.6811666648464,0.7814317171695108,False
242,9b673bcc44b8dc9d1436e3cd2403f21724324064,/Users/sanika/Downloads/Master Thesis/repo_updated/pytest/src/_pytest/runner.py,1918.0,ModificationType.MODIFY,383,288,292,26,6,62,409,11,65,38,67,76,105,429.5076556518598,656.0323889115765,5.6692307692307695,3719.1990048294756,206.6221669349709,0.2186774629705255,False
243,9b673bcc44b8dc9d1436e3cd2403f21724324064,/Users/sanika/Downloads/Master Thesis/repo_updated/pytest/testing/test_runner.py,3446.0,ModificationType.MODIFY,1043,504,840,53,9,147,1096,9,180,112,198,189,310,1377.0628823523223,2344.2951515085324,4.95,11604.260999967237,644.6811666648464,0.7814317171695108,False
244,b5579d2cf21cd72469fe20c10ccee0238330c93e,/Users/sanika/Downloads/Master Thesis/repo_updated/pytest/testing/example_scripts/collect/package_infinite_recursion/__init__.pyi,5074.0,ModificationType.MODIFY,0,0,0,0,0,0,0,0,0,0,0,0,0,0.0,0.0,0.0,0.0,0.0,0.0,False
245,b5579d2cf21cd72469fe20c10ccee0238330c93e,/Users/sanika/Downloads/Master Thesis/repo_updated/pytest/testing/example_scripts/collect/package_infinite_recursion/tests/__init__.py,5074.0,ModificationType.MODIFY,0,0,0,0,0,0,0,0,0,0,0,0,0,0.0,0.0,0.0,0.0,0.0,0.0,False
246,b5579d2cf21cd72469fe20c10ccee0238330c93e,/Users/sanika/Downloads/Master Thesis/repo_updated/pytest/testing/example_scripts/collect/collect_init_tests/tests/__init__.py,5074.0,ModificationType.MODIFY,2,2,2,0,0,0,2,0,0,0,0,0,0,0.0,0.0,0.0,0.0,0.0,0.0,False
247,b5579d2cf21cd72469fe20c10ccee0238330c93e,/Users/sanika/Downloads/Master Thesis/repo_updated/pytest/testing/example_scripts/collect/package_init_given_as_arg/pkg/__init__.py,5074.0,ModificationType.MODIFY,0,0,0,0,0,0,0,0,0,0,0,0,0,0.0,0.0,0.0,0.0,0.0,0.0,False
248,b5579d2cf21cd72469fe20c10ccee0238330c93e,/Users/sanika/Downloads/Master Thesis/repo_updated/pytest/testing/example_scripts/conftest_usageerror/__init__.pyi,5074.0,ModificationType.MODIFY,0,0,0,0,0,0,0,0,0,0,0,0,0,0.0,0.0,0.0,0.0,0.0,0.0,False
249,b5579d2cf21cd72469fe20c10ccee0238330c93e,/Users/sanika/Downloads/Master Thesis/repo_updated/pytest/testing/example_scripts/marks/marks_considered_keywords/__init__.pyi,5074.0,ModificationType.MODIFY,0,0,0,0,0,0,0,0,0,0,0,0,0,0.0,0.0,0.0,0.0,0.0,0.0,False
250,b5579d2cf21cd72469fe20c10ccee0238330c93e,/Users/sanika/Downloads/Master Thesis/repo_updated/pytest/testing/example_scripts/config/collect_pytest_prefix/__init__.pyi,5074.0,ModificationType.MODIFY,0,0,0,0,0,0,0,0,0,0,0,0,0,0.0,0.0,0.0,0.0,0.0,0.0,False
251,b5579d2cf21cd72469fe20c10ccee0238330c93e,/Users/sanika/Downloads/Master Thesis/repo_updated/pytest/testing/example_scripts/issue88_initial_file_multinodes/__init__.pyi,5074.0,ModificationType.MODIFY,0,0,0,0,0,0,0,0,0,0,0,0,0,0.0,0.0,0.0,0.0,0.0,0.0,False
252,b5579d2cf21cd72469fe20c10ccee0238330c93e,/Users/sanika/Downloads/Master Thesis/repo_updated/pytest/testing/example_scripts/fixtures/fill_fixtures/test_extend_fixture_conftest_conftest/__init__.pyi,5074.0,ModificationType.MODIFY,0,0,0,0,0,0,0,0,0,0,0,0,0,0.0,0.0,0.0,0.0,0.0,0.0,False
253,b5579d2cf21cd72469fe20c10ccee0238330c93e,/Users/sanika/Downloads/Master Thesis/repo_updated/pytest/testing/example_scripts/fixtures/fill_fixtures/test_extend_fixture_conftest_conftest/pkg/__init__.py,5074.0,ModificationType.MODIFY,0,0,0,0,0,0,0,0,0,0,0,0,0,0.0,0.0,0.0,0.0,0.0,0.0,False
254,b5579d2cf21cd72469fe20c10ccee0238330c93e,/Users/sanika/Downloads/Master Thesis/repo_updated/pytest/testing/example_scripts/fixtures/fill_fixtures/test_extend_fixture_conftest_module/__init__.pyi,5074.0,ModificationType.MODIFY,0,0,0,0,0,0,0,0,0,0,0,0,0,0.0,0.0,0.0,0.0,0.0,0.0,False
255,b5579d2cf21cd72469fe20c10ccee0238330c93e,/Users/sanika/Downloads/Master Thesis/repo_updated/pytest/testing/example_scripts/fixtures/fill_fixtures/test_conftest_funcargs_only_available_in_subdir/sub1/__init__.py,5074.0,ModificationType.MODIFY,0,0,0,0,0,0,0,0,0,0,0,0,0,0.0,0.0,0.0,0.0,0.0,0.0,False
256,b5579d2cf21cd72469fe20c10ccee0238330c93e,/Users/sanika/Downloads/Master Thesis/repo_updated/pytest/testing/example_scripts/fixtures/fill_fixtures/test_conftest_funcargs_only_available_in_subdir/sub2/__init__.py,5074.0,ModificationType.MODIFY,0,0,0,0,0,0,0,0,0,0,0,0,0,0.0,0.0,0.0,0.0,0.0,0.0,False
257,b5579d2cf21cd72469fe20c10ccee0238330c93e,/Users/sanika/Downloads/Master Thesis/repo_updated/pytest/testing/example_scripts/fixtures/custom_item/__init__.pyi,5074.0,ModificationType.MODIFY,0,0,0,0,0,0,0,0,0,0,0,0,0,0.0,0.0,0.0,0.0,0.0,0.0,False
258,b5579d2cf21cd72469fe20c10ccee0238330c93e,/Users/sanika/Downloads/Master Thesis/repo_updated/pytest/testing/example_scripts/fixtures/custom_item/foo/__init__.py,5074.0,ModificationType.MODIFY,0,0,0,0,0,0,0,0,0,0,0,0,0,0.0,0.0,0.0,0.0,0.0,0.0,False
259,b5579d2cf21cd72469fe20c10ccee0238330c93e,/Users/sanika/Downloads/Master Thesis/repo_updated/pytest/doc/en/example/nonpython/__init__.py,5074.0,ModificationType.MODIFY,0,0,0,0,0,0,0,0,0,0,0,0,0,0.0,0.0,0.0,0.0,0.0,0.0,False
260,b5579d2cf21cd72469fe20c10ccee0238330c93e,/Users/sanika/Downloads/Master Thesis/repo_updated/pytest/src/pytest/__init__.py,5074.0,ModificationType.MODIFY,99,48,90,1,3,5,100,0,0,0,0,0,0,0.0,0.0,0.0,0.0,0.0,0.0,False
261,b5579d2cf21cd72469fe20c10ccee0238330c93e,/Users/sanika/Downloads/Master Thesis/repo_updated/pytest/src/_pytest/__init__.py,5074.0,ModificationType.MODIFY,8,5,5,2,0,1,10,0,0,0,0,0,0,0.0,0.0,0.0,0.0,0.0,0.0,False
262,b5579d2cf21cd72469fe20c10ccee0238330c93e,/Users/sanika/Downloads/Master Thesis/repo_updated/pytest/src/_pytest/config/__init__.py,5074.0,ModificationType.MODIFY,1217,716,841,84,126,174,1301,14,185,118,215,199,333,1446.608539104324,2542.995998641035,8.135135135135135,20687.616097052745,1149.3120053918194,0.847665332880345,False
263,b5579d2cf21cd72469fe20c10ccee0238330c93e,/Users/sanika/Downloads/Master Thesis/repo_updated/pytest/src/_pytest/mark/__init__.py,5074.0,ModificationType.MODIFY,160,89,115,0,13,31,160,7,15,11,17,22,28,78.25484338853101,124.86408532184431,3.966666666666667,495.29420510998256,27.516344728332356,0.04162136177394811,False
264,b5579d2cf21cd72469fe20c10ccee0238330c93e,/Users/sanika/Downloads/Master Thesis/repo_updated/pytest/src/_pytest/_code/__init__.py,5074.0,ModificationType.MODIFY,10,10,9,9,0,0,19,0,0,0,0,0,0,0.0,0.0,0.0,0.0,0.0,0.0,False
265,b5579d2cf21cd72469fe20c10ccee0238330c93e,/Users/sanika/Downloads/Master Thesis/repo_updated/pytest/src/_pytest/assertion/__init__.py,5074.0,ModificationType.MODIFY,173,84,99,8,29,36,181,5,12,7,13,17,20,54.62919048309069,81.7492568250068,2.708333333333333,221.40423723439343,12.300235401910744,0.027249752275002263,False
266,b5579d2cf21cd72469fe20c10ccee0238330c93e,/Users/sanika/Downloads/Master Thesis/repo_updated/pytest/src/_pytest/_io/__init__.py,5074.0,ModificationType.MODIFY,3,1,1,3,0,0,6,0,0,0,0,0,0,0.0,0.0,0.0,0.0,0.0,0.0,False
267,b5579d2cf21cd72469fe20c10ccee0238330c93e,/Users/sanika/Downloads/Master Thesis/repo_updated/pytest/testing/test_config.py,6057.0,ModificationType.MODIFY,1457,730,1242,11,6,188,1468,10,292,166,329,302,495,2424.648052141839,4078.0103459659135,5.633561643835616,22973.722668198385,1276.3179260110217,1.359336781988638,False
268,3a402811de5227dd46d3a9ab75a9e75d3ef3097e,/Users/sanika/Downloads/Master Thesis/repo_updated/pytest/testing/test_cacheprovider.py,2013.0,ModificationType.MODIFY,996,429,845,24,10,117,1020,7,76,50,88,83,138,494.49397547611574,879.7554415258757,4.052631578947368,3565.324684078549,198.07359355991935,0.2932518138419585,False
269,3a402811de5227dd46d3a9ab75a9e75d3ef3097e,/Users/sanika/Downloads/Master Thesis/repo_updated/pytest/src/_pytest/cacheprovider.py,2013.0,ModificationType.MODIFY,456,277,329,12,42,72,468,13,85,50,97,98,147,592.903945907539,972.3623470849358,7.417647058823531,7212.640703965319,400.7022613314065,0.3241207823616453,False
270,3a402811de5227dd46d3a9ab75a9e75d3ef3097e,/Users/sanika/Downloads/Master Thesis/repo_updated/pytest/testing/test_cacheprovider.py,3782.0,ModificationType.MODIFY,996,429,845,24,10,117,1020,7,76,50,88,83,138,494.49397547611574,879.7554415258757,4.052631578947368,3565.324684078549,198.07359355991935,0.2932518138419585,False
271,b88f5df4ce29e5dae05ad60c013b3a6a83535703,/Users/sanika/Downloads/Master Thesis/repo_updated/pytest/testing/test_cacheprovider.py,2013.0,ModificationType.MODIFY,996,429,845,24,10,117,1020,7,76,50,88,83,138,494.49397547611574,879.7554415258757,4.052631578947368,3565.324684078549,198.07359355991935,0.2932518138419585,False
272,b88f5df4ce29e5dae05ad60c013b3a6a83535703,/Users/sanika/Downloads/Master Thesis/repo_updated/pytest/src/_pytest/cacheprovider.py,2013.0,ModificationType.MODIFY,456,277,329,12,42,72,468,13,85,50,97,98,147,592.903945907539,972.3623470849358,7.417647058823531,7212.640703965319,400.7022613314065,0.3241207823616453,False
273,b88f5df4ce29e5dae05ad60c013b3a6a83535703,/Users/sanika/Downloads/Master Thesis/repo_updated/pytest/testing/test_cacheprovider.py,3782.0,ModificationType.MODIFY,996,429,845,24,10,117,1020,7,76,50,88,83,138,494.49397547611574,879.7554415258757,4.052631578947368,3565.324684078549,198.07359355991935,0.2932518138419585,False
274,fbb7f663be2fa88e689f2e5883ed59d01722f4be,/Users/sanika/Downloads/Master Thesis/repo_updated/pytest/testing/test_unittest.py,2040.0,ModificationType.MODIFY,1098,241,925,5,10,155,1103,7,46,25,49,53,74,273.7353344330258,423.86611363767685,3.728260869565217,1580.283445410034,87.79352474500189,0.14128870454589226,False
275,83351a33682df31fca12e6baf67370ab21af185b,/Users/sanika/Downloads/Master Thesis/repo_updated/pytest/testing/test_warnings.py,615.0,ModificationType.MODIFY,601,196,481,2,23,85,603,8,63,36,72,71,108,400.5686351804948,664.1726889065056,4.571428571428571,3036.21800642974,168.67877813498555,0.22139089630216852,False
276,83351a33682df31fca12e6baf67370ab21af185b,/Users/sanika/Downloads/Master Thesis/repo_updated/pytest/src/_pytest/warnings.py,615.0,ModificationType.MODIFY,156,79,106,5,16,28,161,5,14,8,15,19,23,64.91260938324325,97.70233280920246,2.6785714285714284,261.7026771675066,14.539037620417032,0.03256744426973415,False
277,a6152db84adfb7e9b64c16826aad73d5be91cb28,/Users/sanika/Downloads/Master Thesis/repo_updated/pytest/testing/test_setuponly.py,405.0,ModificationType.MODIFY,294,64,250,0,0,43,294,1,20,10,20,21,30,86.43856189774725,131.7695226833628,0.5,65.8847613416814,3.660264518982301,0.04392317422778761,False
278,a6152db84adfb7e9b64c16826aad73d5be91cb28,/Users/sanika/Downloads/Master Thesis/repo_updated/pytest/src/_pytest/setuponly.py,405.0,ModificationType.MODIFY,78,46,62,3,0,14,81,3,8,4,8,11,12,28.754887502163466,41.51317942364757,1.5,62.269769135471364,3.4594316186372978,0.013837726474549191,False
279,16efa1bfef19ee41f3a74f464139b4129ff804dc,/Users/sanika/Downloads/Master Thesis/repo_updated/pytest/testing/test_setuponly.py,381.0,ModificationType.MODIFY,294,64,250,0,0,43,294,1,20,10,20,21,30,86.43856189774725,131.7695226833628,0.5,65.8847613416814,3.660264518982301,0.04392317422778761,False
280,16efa1bfef19ee41f3a74f464139b4129ff804dc,/Users/sanika/Downloads/Master Thesis/repo_updated/pytest/src/_pytest/setuponly.py,381.0,ModificationType.MODIFY,78,46,62,3,0,14,81,3,8,4,8,11,12,28.754887502163466,41.51317942364757,1.5,62.269769135471364,3.4594316186372978,0.013837726474549191,False
281,d91ff0af8a1d7fde73b88017ee7fd3c8ad846f3b,/Users/sanika/Downloads/Master Thesis/repo_updated/pytest/src/_pytest/assertion/util.py,2350.0,ModificationType.MODIFY,477,336,357,30,23,73,507,16,194,134,250,210,384,1538.3830913843026,2962.2702787837907,10.309278350515463,30538.868853441152,1696.603825191175,0.9874234262612636,False
282,d91ff0af8a1d7fde73b88017ee7fd3c8ad846f3b,/Users/sanika/Downloads/Master Thesis/repo_updated/pytest/testing/test_assertrewrite.py,6013.0,ModificationType.MODIFY,1660,832,1314,41,38,274,1701,20,312,209,395,332,604,2671.484054182769,5058.523816533542,12.660256410256409,64042.208574703494,3557.900476372417,1.6861746055111808,False
283,803cc1f294782b7a7abe0c82fe100de95bb8cfb3,/Users/sanika/Downloads/Master Thesis/repo_updated/pytest/testing/test_cacheprovider.py,2013.0,ModificationType.MODIFY,996,429,845,24,10,117,1020,7,76,50,88,83,138,494.49397547611574,879.7554415258757,4.052631578947368,3565.324684078549,198.07359355991935,0.2932518138419585,False
284,803cc1f294782b7a7abe0c82fe100de95bb8cfb3,/Users/sanika/Downloads/Master Thesis/repo_updated/pytest/src/_pytest/cacheprovider.py,2013.0,ModificationType.MODIFY,456,277,329,12,42,72,468,13,85,50,97,98,147,592.903945907539,972.3623470849358,7.417647058823531,7212.640703965319,400.7022613314065,0.3241207823616453,False
285,803cc1f294782b7a7abe0c82fe100de95bb8cfb3,/Users/sanika/Downloads/Master Thesis/repo_updated/pytest/testing/example_scripts/collect/package_infinite_recursion/__init__.pyi,5048.0,ModificationType.MODIFY,0,0,0,0,0,0,0,0,0,0,0,0,0,0.0,0.0,0.0,0.0,0.0,0.0,False
286,803cc1f294782b7a7abe0c82fe100de95bb8cfb3,/Users/sanika/Downloads/Master Thesis/repo_updated/pytest/testing/example_scripts/collect/package_infinite_recursion/tests/__init__.py,5048.0,ModificationType.MODIFY,0,0,0,0,0,0,0,0,0,0,0,0,0,0.0,0.0,0.0,0.0,0.0,0.0,False
287,803cc1f294782b7a7abe0c82fe100de95bb8cfb3,/Users/sanika/Downloads/Master Thesis/repo_updated/pytest/testing/example_scripts/collect/collect_init_tests/tests/__init__.py,5048.0,ModificationType.MODIFY,2,2,2,0,0,0,2,0,0,0,0,0,0,0.0,0.0,0.0,0.0,0.0,0.0,False
288,803cc1f294782b7a7abe0c82fe100de95bb8cfb3,/Users/sanika/Downloads/Master Thesis/repo_updated/pytest/testing/example_scripts/collect/package_init_given_as_arg/pkg/__init__.py,5048.0,ModificationType.MODIFY,0,0,0,0,0,0,0,0,0,0,0,0,0,0.0,0.0,0.0,0.0,0.0,0.0,False
289,803cc1f294782b7a7abe0c82fe100de95bb8cfb3,/Users/sanika/Downloads/Master Thesis/repo_updated/pytest/testing/example_scripts/conftest_usageerror/__init__.pyi,5048.0,ModificationType.MODIFY,0,0,0,0,0,0,0,0,0,0,0,0,0,0.0,0.0,0.0,0.0,0.0,0.0,False
290,803cc1f294782b7a7abe0c82fe100de95bb8cfb3,/Users/sanika/Downloads/Master Thesis/repo_updated/pytest/testing/example_scripts/marks/marks_considered_keywords/__init__.pyi,5048.0,ModificationType.MODIFY,0,0,0,0,0,0,0,0,0,0,0,0,0,0.0,0.0,0.0,0.0,0.0,0.0,False
291,803cc1f294782b7a7abe0c82fe100de95bb8cfb3,/Users/sanika/Downloads/Master Thesis/repo_updated/pytest/testing/example_scripts/config/collect_pytest_prefix/__init__.pyi,5048.0,ModificationType.MODIFY,0,0,0,0,0,0,0,0,0,0,0,0,0,0.0,0.0,0.0,0.0,0.0,0.0,False
292,803cc1f294782b7a7abe0c82fe100de95bb8cfb3,/Users/sanika/Downloads/Master Thesis/repo_updated/pytest/testing/example_scripts/issue88_initial_file_multinodes/__init__.pyi,5048.0,ModificationType.MODIFY,0,0,0,0,0,0,0,0,0,0,0,0,0,0.0,0.0,0.0,0.0,0.0,0.0,False
293,803cc1f294782b7a7abe0c82fe100de95bb8cfb3,/Users/sanika/Downloads/Master Thesis/repo_updated/pytest/testing/example_scripts/fixtures/fill_fixtures/test_extend_fixture_conftest_conftest/__init__.pyi,5048.0,ModificationType.MODIFY,0,0,0,0,0,0,0,0,0,0,0,0,0,0.0,0.0,0.0,0.0,0.0,0.0,False
294,803cc1f294782b7a7abe0c82fe100de95bb8cfb3,/Users/sanika/Downloads/Master Thesis/repo_updated/pytest/testing/example_scripts/fixtures/fill_fixtures/test_extend_fixture_conftest_conftest/pkg/__init__.py,5048.0,ModificationType.MODIFY,0,0,0,0,0,0,0,0,0,0,0,0,0,0.0,0.0,0.0,0.0,0.0,0.0,False
295,803cc1f294782b7a7abe0c82fe100de95bb8cfb3,/Users/sanika/Downloads/Master Thesis/repo_updated/pytest/testing/example_scripts/fixtures/fill_fixtures/test_extend_fixture_conftest_module/__init__.pyi,5048.0,ModificationType.MODIFY,0,0,0,0,0,0,0,0,0,0,0,0,0,0.0,0.0,0.0,0.0,0.0,0.0,False
296,803cc1f294782b7a7abe0c82fe100de95bb8cfb3,/Users/sanika/Downloads/Master Thesis/repo_updated/pytest/testing/example_scripts/fixtures/fill_fixtures/test_conftest_funcargs_only_available_in_subdir/sub1/__init__.py,5048.0,ModificationType.MODIFY,0,0,0,0,0,0,0,0,0,0,0,0,0,0.0,0.0,0.0,0.0,0.0,0.0,False
297,803cc1f294782b7a7abe0c82fe100de95bb8cfb3,/Users/sanika/Downloads/Master Thesis/repo_updated/pytest/testing/example_scripts/fixtures/fill_fixtures/test_conftest_funcargs_only_available_in_subdir/sub2/__init__.py,5048.0,ModificationType.MODIFY,0,0,0,0,0,0,0,0,0,0,0,0,0,0.0,0.0,0.0,0.0,0.0,0.0,False
298,803cc1f294782b7a7abe0c82fe100de95bb8cfb3,/Users/sanika/Downloads/Master Thesis/repo_updated/pytest/testing/example_scripts/fixtures/custom_item/__init__.pyi,5048.0,ModificationType.MODIFY,0,0,0,0,0,0,0,0,0,0,0,0,0,0.0,0.0,0.0,0.0,0.0,0.0,False
299,803cc1f294782b7a7abe0c82fe100de95bb8cfb3,/Users/sanika/Downloads/Master Thesis/repo_updated/pytest/testing/example_scripts/fixtures/custom_item/foo/__init__.py,5048.0,ModificationType.MODIFY,0,0,0,0,0,0,0,0,0,0,0,0,0,0.0,0.0,0.0,0.0,0.0,0.0,False
300,803cc1f294782b7a7abe0c82fe100de95bb8cfb3,/Users/sanika/Downloads/Master Thesis/repo_updated/pytest/doc/en/example/nonpython/__init__.py,5048.0,ModificationType.MODIFY,0,0,0,0,0,0,0,0,0,0,0,0,0,0.0,0.0,0.0,0.0,0.0,0.0,False
301,803cc1f294782b7a7abe0c82fe100de95bb8cfb3,/Users/sanika/Downloads/Master Thesis/repo_updated/pytest/src/pytest/__init__.py,5048.0,ModificationType.MODIFY,99,48,90,1,3,5,100,0,0,0,0,0,0,0.0,0.0,0.0,0.0,0.0,0.0,False
302,803cc1f294782b7a7abe0c82fe100de95bb8cfb3,/Users/sanika/Downloads/Master Thesis/repo_updated/pytest/src/_pytest/__init__.py,5048.0,ModificationType.MODIFY,8,5,5,2,0,1,10,0,0,0,0,0,0,0.0,0.0,0.0,0.0,0.0,0.0,False
303,803cc1f294782b7a7abe0c82fe100de95bb8cfb3,/Users/sanika/Downloads/Master Thesis/repo_updated/pytest/src/_pytest/config/__init__.py,5048.0,ModificationType.MODIFY,1217,716,841,84,126,174,1301,14,185,118,215,199,333,1446.608539104324,2542.995998641035,8.135135135135135,20687.616097052745,1149.3120053918194,0.847665332880345,False
304,803cc1f294782b7a7abe0c82fe100de95bb8cfb3,/Users/sanika/Downloads/Master Thesis/repo_updated/pytest/src/_pytest/mark/__init__.py,5048.0,ModificationType.MODIFY,160,89,115,0,13,31,160,7,15,11,17,22,28,78.25484338853101,124.86408532184431,3.966666666666667,495.29420510998256,27.516344728332356,0.04162136177394811,False
305,803cc1f294782b7a7abe0c82fe100de95bb8cfb3,/Users/sanika/Downloads/Master Thesis/repo_updated/pytest/src/_pytest/_code/__init__.py,5048.0,ModificationType.MODIFY,10,10,9,9,0,0,19,0,0,0,0,0,0,0.0,0.0,0.0,0.0,0.0,0.0,False
306,803cc1f294782b7a7abe0c82fe100de95bb8cfb3,/Users/sanika/Downloads/Master Thesis/repo_updated/pytest/src/_pytest/assertion/__init__.py,5048.0,ModificationType.MODIFY,173,84,99,8,29,36,181,5,12,7,13,17,20,54.62919048309069,81.7492568250068,2.708333333333333,221.40423723439343,12.300235401910744,0.027249752275002263,False
307,803cc1f294782b7a7abe0c82fe100de95bb8cfb3,/Users/sanika/Downloads/Master Thesis/repo_updated/pytest/src/_pytest/_io/__init__.py,5048.0,ModificationType.MODIFY,3,1,1,3,0,0,6,0,0,0,0,0,0,0.0,0.0,0.0,0.0,0.0,0.0,False
308,803cc1f294782b7a7abe0c82fe100de95bb8cfb3,/Users/sanika/Downloads/Master Thesis/repo_updated/pytest/testing/test_setuponly.py,381.0,ModificationType.MODIFY,294,64,250,0,0,43,294,1,20,10,20,21,30,86.43856189774725,131.7695226833628,0.5,65.8847613416814,3.660264518982301,0.04392317422778761,False
309,803cc1f294782b7a7abe0c82fe100de95bb8cfb3,/Users/sanika/Downloads/Master Thesis/repo_updated/pytest/src/_pytest/setuponly.py,381.0,ModificationType.MODIFY,78,46,62,3,0,14,81,3,8,4,8,11,12,28.754887502163466,41.51317942364757,1.5,62.269769135471364,3.4594316186372978,0.013837726474549191,False
310,803cc1f294782b7a7abe0c82fe100de95bb8cfb3,/Users/sanika/Downloads/Master Thesis/repo_updated/pytest/testing/test_cacheprovider.py,3773.0,ModificationType.MODIFY,996,429,845,24,10,117,1020,7,76,50,88,83,138,494.49397547611574,879.7554415258757,4.052631578947368,3565.324684078549,198.07359355991935,0.2932518138419585,False
311,803cc1f294782b7a7abe0c82fe100de95bb8cfb3,/Users/sanika/Downloads/Master Thesis/repo_updated/pytest/testing/test_setuponly.py,572.0,ModificationType.MODIFY,294,64,250,0,0,43,294,1,20,10,20,21,30,86.43856189774725,131.7695226833628,0.5,65.8847613416814,3.660264518982301,0.04392317422778761,False
312,9275012ef789048998d1b87b9536bd7c2c063596,/Users/sanika/Downloads/Master Thesis/repo_updated/pytest/doc/en/example/multipython.py,6701.0,ModificationType.MODIFY,72,33,56,0,4,12,72,1,1,1,1,2,2,0.0,2.0,0.5,1.0,0.05555555555555555,0.0006666666666666666,False
313,9275012ef789048998d1b87b9536bd7c2c063596,/Users/sanika/Downloads/Master Thesis/repo_updated/pytest/src/_pytest/python.py,6701.0,ModificationType.MODIFY,1454,835,1044,76,110,219,1530,17,275,158,296,292,454,2297.8910156145625,3718.1803497315277,9.149090909090908,34017.97003608918,1889.8872242271768,1.2393934499105097,False
314,9275012ef789048998d1b87b9536bd7c2c063596,/Users/sanika/Downloads/Master Thesis/repo_updated/pytest/testing/test_skipping.py,3116.0,ModificationType.MODIFY,1178,367,1042,6,15,115,1184,9,94,51,95,103,146,644.6606770706788,976.22907696875,4.547872340425532,4439.7652170653255,246.65362317029587,0.3254096923229167,False
315,b94eb4cb7b455282144e99e9c0b21aa80596e993,/Users/sanika/Downloads/Master Thesis/repo_updated/pytest/doc/en/example/multipython.py,6750.0,ModificationType.MODIFY,72,33,56,0,4,12,72,1,1,1,1,2,2,0.0,2.0,0.5,1.0,0.05555555555555555,0.0006666666666666666,False
316,b94eb4cb7b455282144e99e9c0b21aa80596e993,/Users/sanika/Downloads/Master Thesis/repo_updated/pytest/src/_pytest/python.py,6750.0,ModificationType.MODIFY,1454,835,1044,76,110,219,1530,17,275,158,296,292,454,2297.8910156145625,3718.1803497315277,9.149090909090908,34017.97003608918,1889.8872242271768,1.2393934499105097,False
317,5cefcb20522e3d48282ba3f889162be5ef8e9040,/Users/sanika/Downloads/Master Thesis/repo_updated/pytest/doc/en/example/multipython.py,6763.0,ModificationType.MODIFY,72,33,56,0,4,12,72,1,1,1,1,2,2,0.0,2.0,0.5,1.0,0.05555555555555555,0.0006666666666666666,False
318,5cefcb20522e3d48282ba3f889162be5ef8e9040,/Users/sanika/Downloads/Master Thesis/repo_updated/pytest/src/_pytest/python.py,6763.0,ModificationType.MODIFY,1454,835,1044,76,110,219,1530,17,275,158,296,292,454,2297.8910156145625,3718.1803497315277,9.149090909090908,34017.97003608918,1889.8872242271768,1.2393934499105097,False
319,b47f57a08a9db7b3ec80b8197153a86d1eef117d,/Users/sanika/Downloads/Master Thesis/repo_updated/pytest/testing/test_pytester.py,5898.0,ModificationType.MODIFY,722,423,573,19,0,135,741,12,172,101,199,184,300,1320.3370878174146,2257.068586817104,6.941860465116278,15668.255189881524,870.4586216600846,0.7523561956057013,False
320,b47f57a08a9db7b3ec80b8197153a86d1eef117d,/Users/sanika/Downloads/Master Thesis/repo_updated/pytest/src/_pytest/pytester.py,5898.0,ModificationType.MODIFY,1508,847,911,44,250,301,1552,14,148,88,169,162,257,1120.302067021891,1886.3414507413486,7.993243243243242,15077.986055587939,837.6658919771077,0.6287804835804495,False
321,995990c61b1eaa5830d01a1a14608ec981eaf8b9,/Users/sanika/Downloads/Master Thesis/repo_updated/pytest/testing/test_capture.py,3433.0,ModificationType.MODIFY,1513,682,1277,25,13,200,1538,11,199,116,219,210,335,1557.7420472931965,2584.272248418151,6.052763819095478,15641.989563917903,868.9994202176613,0.8614240828060503,False
322,995990c61b1eaa5830d01a1a14608ec981eaf8b9,/Users/sanika/Downloads/Master Thesis/repo_updated/pytest/src/_pytest/capture.py,3433.0,ModificationType.MODIFY,819,519,539,24,98,155,843,15,96,57,106,111,163,690.7597590033588,1107.4897862150674,8.28125,9171.399792093527,509.5222106718626,0.3691632620716892,False
323,554dba391c2302c29590d7991414bfe5d01ab81e,/Users/sanika/Downloads/Master Thesis/repo_updated/pytest/testing/test_terminal.py,6093.0,ModificationType.MODIFY,1943,715,1694,26,18,214,1969,12,185,120,237,197,357,1436.3251202041715,2721.0724995459263,7.686486486486486,20915.486996509768,1161.971499806098,0.9070241665153088,False
324,554dba391c2302c29590d7991414bfe5d01ab81e,/Users/sanika/Downloads/Master Thesis/repo_updated/pytest/src/_pytest/terminal.py,6093.0,ModificationType.MODIFY,1168,838,957,57,25,144,1225,19,348,224,416,367,640,3018.854959310786,5452.567201819657,11.35632183908046,61921.107993078396,3440.0615551710216,1.817522400606552,False
325,554dba391c2302c29590d7991414bfe5d01ab81e,/Users/sanika/Downloads/Master Thesis/repo_updated/pytest/testing/test_pdb.py,3969.0,ModificationType.MODIFY,1293,570,1093,25,15,163,1318,10,195,123,241,205,364,1516.6486921300477,2795.3307562199825,6.17948717948718,17273.710570487587,959.6505872493103,0.931776918739994,False
326,554dba391c2302c29590d7991414bfe5d01ab81e,/Users/sanika/Downloads/Master Thesis/repo_updated/pytest/testing/test_terminal.py,6632.0,ModificationType.MODIFY,1943,715,1694,26,18,214,1969,12,185,120,237,197,357,1436.3251202041715,2721.0724995459263,7.686486486486486,20915.486996509768,1161.971499806098,0.9070241665153088,False
327,978c7ae1b72e410be6d2db25cee2817e91c2d4e4,/Users/sanika/Downloads/Master Thesis/repo_updated/pytest/testing/test_cacheprovider.py,2013.0,ModificationType.MODIFY,996,429,845,24,10,117,1020,7,76,50,88,83,138,494.49397547611574,879.7554415258757,4.052631578947368,3565.324684078549,198.07359355991935,0.2932518138419585,False
328,978c7ae1b72e410be6d2db25cee2817e91c2d4e4,/Users/sanika/Downloads/Master Thesis/repo_updated/pytest/src/_pytest/cacheprovider.py,2013.0,ModificationType.MODIFY,456,277,329,12,42,72,468,13,85,50,97,98,147,592.903945907539,972.3623470849358,7.417647058823531,7212.640703965319,400.7022613314065,0.3241207823616453,False
329,978c7ae1b72e410be6d2db25cee2817e91c2d4e4,/Users/sanika/Downloads/Master Thesis/repo_updated/pytest/testing/example_scripts/collect/package_infinite_recursion/__init__.pyi,5048.0,ModificationType.MODIFY,0,0,0,0,0,0,0,0,0,0,0,0,0,0.0,0.0,0.0,0.0,0.0,0.0,False
330,978c7ae1b72e410be6d2db25cee2817e91c2d4e4,/Users/sanika/Downloads/Master Thesis/repo_updated/pytest/testing/example_scripts/collect/package_infinite_recursion/tests/__init__.py,5048.0,ModificationType.MODIFY,0,0,0,0,0,0,0,0,0,0,0,0,0,0.0,0.0,0.0,0.0,0.0,0.0,False
331,978c7ae1b72e410be6d2db25cee2817e91c2d4e4,/Users/sanika/Downloads/Master Thesis/repo_updated/pytest/testing/example_scripts/collect/collect_init_tests/tests/__init__.py,5048.0,ModificationType.MODIFY,2,2,2,0,0,0,2,0,0,0,0,0,0,0.0,0.0,0.0,0.0,0.0,0.0,False
332,978c7ae1b72e410be6d2db25cee2817e91c2d4e4,/Users/sanika/Downloads/Master Thesis/repo_updated/pytest/testing/example_scripts/collect/package_init_given_as_arg/pkg/__init__.py,5048.0,ModificationType.MODIFY,0,0,0,0,0,0,0,0,0,0,0,0,0,0.0,0.0,0.0,0.0,0.0,0.0,False
333,978c7ae1b72e410be6d2db25cee2817e91c2d4e4,/Users/sanika/Downloads/Master Thesis/repo_updated/pytest/testing/example_scripts/conftest_usageerror/__init__.pyi,5048.0,ModificationType.MODIFY,0,0,0,0,0,0,0,0,0,0,0,0,0,0.0,0.0,0.0,0.0,0.0,0.0,False
334,978c7ae1b72e410be6d2db25cee2817e91c2d4e4,/Users/sanika/Downloads/Master Thesis/repo_updated/pytest/testing/example_scripts/marks/marks_considered_keywords/__init__.pyi,5048.0,ModificationType.MODIFY,0,0,0,0,0,0,0,0,0,0,0,0,0,0.0,0.0,0.0,0.0,0.0,0.0,False
335,978c7ae1b72e410be6d2db25cee2817e91c2d4e4,/Users/sanika/Downloads/Master Thesis/repo_updated/pytest/testing/example_scripts/config/collect_pytest_prefix/__init__.pyi,5048.0,ModificationType.MODIFY,0,0,0,0,0,0,0,0,0,0,0,0,0,0.0,0.0,0.0,0.0,0.0,0.0,False
336,978c7ae1b72e410be6d2db25cee2817e91c2d4e4,/Users/sanika/Downloads/Master Thesis/repo_updated/pytest/testing/example_scripts/issue88_initial_file_multinodes/__init__.pyi,5048.0,ModificationType.MODIFY,0,0,0,0,0,0,0,0,0,0,0,0,0,0.0,0.0,0.0,0.0,0.0,0.0,False
337,978c7ae1b72e410be6d2db25cee2817e91c2d4e4,/Users/sanika/Downloads/Master Thesis/repo_updated/pytest/testing/example_scripts/fixtures/fill_fixtures/test_extend_fixture_conftest_conftest/__init__.pyi,5048.0,ModificationType.MODIFY,0,0,0,0,0,0,0,0,0,0,0,0,0,0.0,0.0,0.0,0.0,0.0,0.0,False
338,978c7ae1b72e410be6d2db25cee2817e91c2d4e4,/Users/sanika/Downloads/Master Thesis/repo_updated/pytest/testing/example_scripts/fixtures/fill_fixtures/test_extend_fixture_conftest_conftest/pkg/__init__.py,5048.0,ModificationType.MODIFY,0,0,0,0,0,0,0,0,0,0,0,0,0,0.0,0.0,0.0,0.0,0.0,0.0,False
339,978c7ae1b72e410be6d2db25cee2817e91c2d4e4,/Users/sanika/Downloads/Master Thesis/repo_updated/pytest/testing/example_scripts/fixtures/fill_fixtures/test_extend_fixture_conftest_module/__init__.pyi,5048.0,ModificationType.MODIFY,0,0,0,0,0,0,0,0,0,0,0,0,0,0.0,0.0,0.0,0.0,0.0,0.0,False
340,978c7ae1b72e410be6d2db25cee2817e91c2d4e4,/Users/sanika/Downloads/Master Thesis/repo_updated/pytest/testing/example_scripts/fixtures/fill_fixtures/test_conftest_funcargs_only_available_in_subdir/sub1/__init__.py,5048.0,ModificationType.MODIFY,0,0,0,0,0,0,0,0,0,0,0,0,0,0.0,0.0,0.0,0.0,0.0,0.0,False
341,978c7ae1b72e410be6d2db25cee2817e91c2d4e4,/Users/sanika/Downloads/Master Thesis/repo_updated/pytest/testing/example_scripts/fixtures/fill_fixtures/test_conftest_funcargs_only_available_in_subdir/sub2/__init__.py,5048.0,ModificationType.MODIFY,0,0,0,0,0,0,0,0,0,0,0,0,0,0.0,0.0,0.0,0.0,0.0,0.0,False
342,978c7ae1b72e410be6d2db25cee2817e91c2d4e4,/Users/sanika/Downloads/Master Thesis/repo_updated/pytest/testing/example_scripts/fixtures/custom_item/__init__.pyi,5048.0,ModificationType.MODIFY,0,0,0,0,0,0,0,0,0,0,0,0,0,0.0,0.0,0.0,0.0,0.0,0.0,False
343,978c7ae1b72e410be6d2db25cee2817e91c2d4e4,/Users/sanika/Downloads/Master Thesis/repo_updated/pytest/testing/example_scripts/fixtures/custom_item/foo/__init__.py,5048.0,ModificationType.MODIFY,0,0,0,0,0,0,0,0,0,0,0,0,0,0.0,0.0,0.0,0.0,0.0,0.0,False
344,978c7ae1b72e410be6d2db25cee2817e91c2d4e4,/Users/sanika/Downloads/Master Thesis/repo_updated/pytest/doc/en/example/nonpython/__init__.py,5048.0,ModificationType.MODIFY,0,0,0,0,0,0,0,0,0,0,0,0,0,0.0,0.0,0.0,0.0,0.0,0.0,False
345,978c7ae1b72e410be6d2db25cee2817e91c2d4e4,/Users/sanika/Downloads/Master Thesis/repo_updated/pytest/src/pytest/__init__.py,5048.0,ModificationType.MODIFY,99,48,90,1,3,5,100,0,0,0,0,0,0,0.0,0.0,0.0,0.0,0.0,0.0,False
346,978c7ae1b72e410be6d2db25cee2817e91c2d4e4,/Users/sanika/Downloads/Master Thesis/repo_updated/pytest/src/_pytest/__init__.py,5048.0,ModificationType.MODIFY,8,5,5,2,0,1,10,0,0,0,0,0,0,0.0,0.0,0.0,0.0,0.0,0.0,False
347,978c7ae1b72e410be6d2db25cee2817e91c2d4e4,/Users/sanika/Downloads/Master Thesis/repo_updated/pytest/src/_pytest/config/__init__.py,5048.0,ModificationType.MODIFY,1217,716,841,84,126,174,1301,14,185,118,215,199,333,1446.608539104324,2542.995998641035,8.135135135135135,20687.616097052745,1149.3120053918194,0.847665332880345,False
348,978c7ae1b72e410be6d2db25cee2817e91c2d4e4,/Users/sanika/Downloads/Master Thesis/repo_updated/pytest/src/_pytest/mark/__init__.py,5048.0,ModificationType.MODIFY,160,89,115,0,13,31,160,7,15,11,17,22,28,78.25484338853101,124.86408532184431,3.966666666666667,495.29420510998256,27.516344728332356,0.04162136177394811,False
349,978c7ae1b72e410be6d2db25cee2817e91c2d4e4,/Users/sanika/Downloads/Master Thesis/repo_updated/pytest/src/_pytest/_code/__init__.py,5048.0,ModificationType.MODIFY,10,10,9,9,0,0,19,0,0,0,0,0,0,0.0,0.0,0.0,0.0,0.0,0.0,False
350,978c7ae1b72e410be6d2db25cee2817e91c2d4e4,/Users/sanika/Downloads/Master Thesis/repo_updated/pytest/src/_pytest/assertion/__init__.py,5048.0,ModificationType.MODIFY,173,84,99,8,29,36,181,5,12,7,13,17,20,54.62919048309069,81.7492568250068,2.708333333333333,221.40423723439343,12.300235401910744,0.027249752275002263,False
351,978c7ae1b72e410be6d2db25cee2817e91c2d4e4,/Users/sanika/Downloads/Master Thesis/repo_updated/pytest/src/_pytest/_io/__init__.py,5048.0,ModificationType.MODIFY,3,1,1,3,0,0,6,0,0,0,0,0,0,0.0,0.0,0.0,0.0,0.0,0.0,False
352,978c7ae1b72e410be6d2db25cee2817e91c2d4e4,/Users/sanika/Downloads/Master Thesis/repo_updated/pytest/testing/test_setuponly.py,381.0,ModificationType.MODIFY,294,64,250,0,0,43,294,1,20,10,20,21,30,86.43856189774725,131.7695226833628,0.5,65.8847613416814,3.660264518982301,0.04392317422778761,False
353,978c7ae1b72e410be6d2db25cee2817e91c2d4e4,/Users/sanika/Downloads/Master Thesis/repo_updated/pytest/src/_pytest/setuponly.py,381.0,ModificationType.MODIFY,78,46,62,3,0,14,81,3,8,4,8,11,12,28.754887502163466,41.51317942364757,1.5,62.269769135471364,3.4594316186372978,0.013837726474549191,False
354,978c7ae1b72e410be6d2db25cee2817e91c2d4e4,/Users/sanika/Downloads/Master Thesis/repo_updated/pytest/testing/test_cacheprovider.py,3773.0,ModificationType.MODIFY,996,429,845,24,10,117,1020,7,76,50,88,83,138,494.49397547611574,879.7554415258757,4.052631578947368,3565.324684078549,198.07359355991935,0.2932518138419585,False
355,978c7ae1b72e410be6d2db25cee2817e91c2d4e4,/Users/sanika/Downloads/Master Thesis/repo_updated/pytest/testing/test_setuponly.py,572.0,ModificationType.MODIFY,294,64,250,0,0,43,294,1,20,10,20,21,30,86.43856189774725,131.7695226833628,0.5,65.8847613416814,3.660264518982301,0.04392317422778761,False
356,3c14dd7f55dbc14dabdff4ecf5246ba0f4501e8f,/Users/sanika/Downloads/Master Thesis/repo_updated/pytest/testing/test_capture.py,3434.0,ModificationType.MODIFY,1513,682,1277,25,13,200,1538,11,199,116,219,210,335,1557.7420472931965,2584.272248418151,6.052763819095478,15641.989563917903,868.9994202176613,0.8614240828060503,False
357,3c14dd7f55dbc14dabdff4ecf5246ba0f4501e8f,/Users/sanika/Downloads/Master Thesis/repo_updated/pytest/src/_pytest/capture.py,3434.0,ModificationType.MODIFY,819,519,539,24,98,155,843,15,96,57,106,111,163,690.7597590033588,1107.4897862150674,8.28125,9171.399792093527,509.5222106718626,0.3691632620716892,False
358,0dd68ba0b6a923bd57a4ba50772540020b974386,/Users/sanika/Downloads/Master Thesis/repo_updated/pytest/testing/test_meta.py,96.0,ModificationType.MODIFY,35,12,22,4,5,6,39,1,2,1,2,3,3,2.0,4.754887502163468,0.5,2.3774437510817346,0.1320802083934297,0.0015849625007211565,False
359,f4734213e5871364894c79f826e268d4b294f222,/Users/sanika/Downloads/Master Thesis/repo_updated/pytest/doc/en/conf.py,300.0,ModificationType.MODIFY,382,65,130,157,2,92,539,4,10,5,10,14,15,41.21928094887362,57.11032383086405,2.0,114.22064766172814,6.345591536762672,0.019036774610288014,False
360,f4734213e5871364894c79f826e268d4b294f222,/Users/sanika/Downloads/Master Thesis/repo_updated/pytest/doc/en/example/assertion/failure_demo.py,1139.0,ModificationType.MODIFY,282,196,195,3,0,86,285,8,130,71,141,138,212,936.907815693699,1507.007184836972,4.338461538461538,6538.092709600402,363.22737275557785,0.5023357282789906,False
361,f4734213e5871364894c79f826e268d4b294f222,/Users/sanika/Downloads/Master Thesis/repo_updated/pytest/testing/conftest.py,65.0,ModificationType.MODIFY,127,75,83,2,11,30,129,4,14,7,14,18,21,61.302968908806456,87.56842503028854,2.0,175.13685006057707,9.729825003365397,0.02918947501009618,False
362,f4734213e5871364894c79f826e268d4b294f222,/Users/sanika/Downloads/Master Thesis/repo_updated/pytest/testing/test_conftest.py,65.0,ModificationType.MODIFY,652,304,544,16,6,88,668,6,89,51,101,95,152,591.8500503603364,998.618052466304,3.4044943820224716,3399.789549407755,188.87719718931967,0.3328726841554347,False
363,f4734213e5871364894c79f826e268d4b294f222,/Users/sanika/Downloads/Master Thesis/repo_updated/pytest/testing/example_scripts/collect/package_infinite_recursion/conftest.py,65.0,ModificationType.MODIFY,2,2,2,0,0,0,2,0,0,0,0,0,0,0.0,0.0,0.0,0.0,0.0,0.0,False
364,f4734213e5871364894c79f826e268d4b294f222,/Users/sanika/Downloads/Master Thesis/repo_updated/pytest/testing/example_scripts/conftest_usageerror/conftest.py,65.0,ModificationType.MODIFY,8,5,5,0,0,3,8,0,0,0,0,0,0,0.0,0.0,0.0,0.0,0.0,0.0,False
365,f4734213e5871364894c79f826e268d4b294f222,/Users/sanika/Downloads/Master Thesis/repo_updated/pytest/testing/example_scripts/marks/marks_considered_keywords/conftest.py,65.0,ModificationType.MODIFY,0,0,0,0,0,0,0,0,0,0,0,0,0,0.0,0.0,0.0,0.0,0.0,0.0,False
366,f4734213e5871364894c79f826e268d4b294f222,/Users/sanika/Downloads/Master Thesis/repo_updated/pytest/testing/example_scripts/config/collect_pytest_prefix/conftest.py,65.0,ModificationType.MODIFY,2,2,2,0,0,0,2,0,0,0,0,0,0,0.0,0.0,0.0,0.0,0.0,0.0,False
367,f4734213e5871364894c79f826e268d4b294f222,/Users/sanika/Downloads/Master Thesis/repo_updated/pytest/testing/example_scripts/issue88_initial_file_multinodes/conftest.py,65.0,ModificationType.MODIFY,14,8,8,0,0,6,14,0,0,0,0,0,0,0.0,0.0,0.0,0.0,0.0,0.0,False
368,f4734213e5871364894c79f826e268d4b294f222,/Users/sanika/Downloads/Master Thesis/repo_updated/pytest/testing/example_scripts/fixtures/fill_fixtures/test_extend_fixture_conftest_conftest/conftest.py,65.0,ModificationType.MODIFY,6,4,4,0,0,2,6,0,0,0,0,0,0,0.0,0.0,0.0,0.0,0.0,0.0,False
369,f4734213e5871364894c79f826e268d4b294f222,/Users/sanika/Downloads/Master Thesis/repo_updated/pytest/testing/example_scripts/fixtures/fill_fixtures/test_extend_fixture_conftest_conftest/pkg/conftest.py,65.0,ModificationType.MODIFY,6,4,4,0,0,2,6,1,2,1,2,3,3,2.0,4.754887502163468,0.5,2.3774437510817346,0.1320802083934297,0.0015849625007211565,False
370,f4734213e5871364894c79f826e268d4b294f222,/Users/sanika/Downloads/Master Thesis/repo_updated/pytest/testing/example_scripts/fixtures/fill_fixtures/test_extend_fixture_conftest_module/conftest.py,65.0,ModificationType.MODIFY,6,4,4,0,0,2,6,0,0,0,0,0,0,0.0,0.0,0.0,0.0,0.0,0.0,False
371,f4734213e5871364894c79f826e268d4b294f222,/Users/sanika/Downloads/Master Thesis/repo_updated/pytest/testing/example_scripts/fixtures/fill_fixtures/test_conftest_funcargs_only_available_in_subdir/sub1/conftest.py,65.0,ModificationType.MODIFY,7,5,5,0,0,2,7,0,0,0,0,0,0,0.0,0.0,0.0,0.0,0.0,0.0,False
372,f4734213e5871364894c79f826e268d4b294f222,/Users/sanika/Downloads/Master Thesis/repo_updated/pytest/testing/example_scripts/fixtures/fill_fixtures/test_conftest_funcargs_only_available_in_subdir/sub2/conftest.py,65.0,ModificationType.MODIFY,6,4,4,0,0,2,6,0,0,0,0,0,0,0.0,0.0,0.0,0.0,0.0,0.0,False
373,f4734213e5871364894c79f826e268d4b294f222,/Users/sanika/Downloads/Master Thesis/repo_updated/pytest/testing/example_scripts/fixtures/custom_item/conftest.py,65.0,ModificationType.MODIFY,10,6,6,0,0,4,10,0,0,0,0,0,0,0.0,0.0,0.0,0.0,0.0,0.0,False
374,f4734213e5871364894c79f826e268d4b294f222,/Users/sanika/Downloads/Master Thesis/repo_updated/pytest/doc/en/conftest.py,65.0,ModificationType.MODIFY,1,1,1,0,0,0,1,0,0,0,0,0,0,0.0,0.0,0.0,0.0,0.0,0.0,False
375,f4734213e5871364894c79f826e268d4b294f222,/Users/sanika/Downloads/Master Thesis/repo_updated/pytest/doc/en/example/conftest.py,65.0,ModificationType.MODIFY,1,1,1,0,0,0,1,0,0,0,0,0,0,0.0,0.0,0.0,0.0,0.0,0.0,False
376,f4734213e5871364894c79f826e268d4b294f222,/Users/sanika/Downloads/Master Thesis/repo_updated/pytest/doc/en/example/assertion/global_testmodule_config/conftest.py,65.0,ModificationType.MODIFY,14,10,10,0,0,4,14,1,1,1,1,2,2,0.0,2.0,0.5,1.0,0.05555555555555555,0.0006666666666666666,False
377,f4734213e5871364894c79f826e268d4b294f222,/Users/sanika/Downloads/Master Thesis/repo_updated/pytest/doc/en/example/nonpython/conftest.py,65.0,ModificationType.MODIFY,46,26,30,3,0,12,49,3,6,3,6,9,9,20.264662506490406,28.52932501298081,1.5,42.79398751947122,2.377443751081734,0.009509775004326938,False
378,f4734213e5871364894c79f826e268d4b294f222,/Users/sanika/Downloads/Master Thesis/repo_updated/pytest/doc/en/example/fixtures/test_fixtures_order.py,140.0,ModificationType.ADD,38,22,22,1,0,15,39,1,2,1,2,3,3,2.0,4.754887502163468,0.5,2.3774437510817346,0.1320802083934297,0.0015849625007211565,False
379,f4734213e5871364894c79f826e268d4b294f222,/Users/sanika/Downloads/Master Thesis/repo_updated/pytest/doc/en/example/multipython.py,292.0,ModificationType.MODIFY,72,33,56,0,4,12,72,1,1,1,1,2,2,0.0,2.0,0.5,1.0,0.05555555555555555,0.0006666666666666666,False
380,f4734213e5871364894c79f826e268d4b294f222,/Users/sanika/Downloads/Master Thesis/repo_updated/pytest/testing/conftest.py,228.0,ModificationType.MODIFY,127,75,83,2,11,30,129,4,14,7,14,18,21,61.302968908806456,87.56842503028854,2.0,175.13685006057707,9.729825003365397,0.02918947501009618,False
381,f4734213e5871364894c79f826e268d4b294f222,/Users/sanika/Downloads/Master Thesis/repo_updated/pytest/testing/test_conftest.py,228.0,ModificationType.MODIFY,652,304,544,16,6,88,668,6,89,51,101,95,152,591.8500503603364,998.618052466304,3.4044943820224716,3399.789549407755,188.87719718931967,0.3328726841554347,False
382,f4734213e5871364894c79f826e268d4b294f222,/Users/sanika/Downloads/Master Thesis/repo_updated/pytest/testing/example_scripts/collect/package_infinite_recursion/conftest.py,228.0,ModificationType.MODIFY,2,2,2,0,0,0,2,0,0,0,0,0,0,0.0,0.0,0.0,0.0,0.0,0.0,False
383,f4734213e5871364894c79f826e268d4b294f222,/Users/sanika/Downloads/Master Thesis/repo_updated/pytest/testing/example_scripts/conftest_usageerror/conftest.py,228.0,ModificationType.MODIFY,8,5,5,0,0,3,8,0,0,0,0,0,0,0.0,0.0,0.0,0.0,0.0,0.0,False
384,f4734213e5871364894c79f826e268d4b294f222,/Users/sanika/Downloads/Master Thesis/repo_updated/pytest/testing/example_scripts/marks/marks_considered_keywords/conftest.py,228.0,ModificationType.MODIFY,0,0,0,0,0,0,0,0,0,0,0,0,0,0.0,0.0,0.0,0.0,0.0,0.0,False
385,f4734213e5871364894c79f826e268d4b294f222,/Users/sanika/Downloads/Master Thesis/repo_updated/pytest/testing/example_scripts/config/collect_pytest_prefix/conftest.py,228.0,ModificationType.MODIFY,2,2,2,0,0,0,2,0,0,0,0,0,0,0.0,0.0,0.0,0.0,0.0,0.0,False
386,f4734213e5871364894c79f826e268d4b294f222,/Users/sanika/Downloads/Master Thesis/repo_updated/pytest/testing/example_scripts/issue88_initial_file_multinodes/conftest.py,228.0,ModificationType.MODIFY,14,8,8,0,0,6,14,0,0,0,0,0,0,0.0,0.0,0.0,0.0,0.0,0.0,False
387,f4734213e5871364894c79f826e268d4b294f222,/Users/sanika/Downloads/Master Thesis/repo_updated/pytest/testing/example_scripts/fixtures/fill_fixtures/test_extend_fixture_conftest_conftest/conftest.py,228.0,ModificationType.MODIFY,6,4,4,0,0,2,6,0,0,0,0,0,0,0.0,0.0,0.0,0.0,0.0,0.0,False
388,f4734213e5871364894c79f826e268d4b294f222,/Users/sanika/Downloads/Master Thesis/repo_updated/pytest/testing/example_scripts/fixtures/fill_fixtures/test_extend_fixture_conftest_conftest/pkg/conftest.py,228.0,ModificationType.MODIFY,6,4,4,0,0,2,6,1,2,1,2,3,3,2.0,4.754887502163468,0.5,2.3774437510817346,0.1320802083934297,0.0015849625007211565,False
389,f4734213e5871364894c79f826e268d4b294f222,/Users/sanika/Downloads/Master Thesis/repo_updated/pytest/testing/example_scripts/fixtures/fill_fixtures/test_extend_fixture_conftest_module/conftest.py,228.0,ModificationType.MODIFY,6,4,4,0,0,2,6,0,0,0,0,0,0,0.0,0.0,0.0,0.0,0.0,0.0,False
390,f4734213e5871364894c79f826e268d4b294f222,/Users/sanika/Downloads/Master Thesis/repo_updated/pytest/testing/example_scripts/fixtures/fill_fixtures/test_conftest_funcargs_only_available_in_subdir/sub1/conftest.py,228.0,ModificationType.MODIFY,7,5,5,0,0,2,7,0,0,0,0,0,0,0.0,0.0,0.0,0.0,0.0,0.0,False
391,f4734213e5871364894c79f826e268d4b294f222,/Users/sanika/Downloads/Master Thesis/repo_updated/pytest/testing/example_scripts/fixtures/fill_fixtures/test_conftest_funcargs_only_available_in_subdir/sub2/conftest.py,228.0,ModificationType.MODIFY,6,4,4,0,0,2,6,0,0,0,0,0,0,0.0,0.0,0.0,0.0,0.0,0.0,False
392,f4734213e5871364894c79f826e268d4b294f222,/Users/sanika/Downloads/Master Thesis/repo_updated/pytest/testing/example_scripts/fixtures/custom_item/conftest.py,228.0,ModificationType.MODIFY,10,6,6,0,0,4,10,0,0,0,0,0,0,0.0,0.0,0.0,0.0,0.0,0.0,False
393,f4734213e5871364894c79f826e268d4b294f222,/Users/sanika/Downloads/Master Thesis/repo_updated/pytest/doc/en/conftest.py,228.0,ModificationType.MODIFY,1,1,1,0,0,0,1,0,0,0,0,0,0,0.0,0.0,0.0,0.0,0.0,0.0,False
394,f4734213e5871364894c79f826e268d4b294f222,/Users/sanika/Downloads/Master Thesis/repo_updated/pytest/doc/en/example/conftest.py,228.0,ModificationType.MODIFY,1,1,1,0,0,0,1,0,0,0,0,0,0,0.0,0.0,0.0,0.0,0.0,0.0,False
395,f4734213e5871364894c79f826e268d4b294f222,/Users/sanika/Downloads/Master Thesis/repo_updated/pytest/doc/en/example/assertion/global_testmodule_config/conftest.py,228.0,ModificationType.MODIFY,14,10,10,0,0,4,14,1,1,1,1,2,2,0.0,2.0,0.5,1.0,0.05555555555555555,0.0006666666666666666,False
396,f4734213e5871364894c79f826e268d4b294f222,/Users/sanika/Downloads/Master Thesis/repo_updated/pytest/doc/en/example/nonpython/conftest.py,228.0,ModificationType.MODIFY,46,26,30,3,0,12,49,3,6,3,6,9,9,20.264662506490406,28.52932501298081,1.5,42.79398751947122,2.377443751081734,0.009509775004326938,False
397,f4734213e5871364894c79f826e268d4b294f222,/Users/sanika/Downloads/Master Thesis/repo_updated/pytest/setup.py,93.0,ModificationType.MODIFY,42,7,35,4,0,5,46,1,2,1,2,3,3,2.0,4.754887502163468,0.5,2.3774437510817346,0.1320802083934297,0.0015849625007211565,False
398,f4734213e5871364894c79f826e268d4b294f222,/Users/sanika/Downloads/Master Thesis/repo_updated/pytest/extra/setup-py.test/setup.py,93.0,ModificationType.MODIFY,11,6,10,0,0,1,11,2,4,2,4,6,6,10.0,15.509775004326935,1.0,15.509775004326935,0.861654166907052,0.005169925001442312,False
399,f4734213e5871364894c79f826e268d4b294f222,/Users/sanika/Downloads/Master Thesis/repo_updated/pytest/testing/code/test_code.py,4989.0,ModificationType.MODIFY,182,127,129,0,0,53,182,5,39,21,42,44,63,217.7403270100645,343.9441919741497,2.6923076923076925,926.003593776557,51.44464409869761,0.11464806399138325,False
400,f4734213e5871364894c79f826e268d4b294f222,/Users/sanika/Downloads/Master Thesis/repo_updated/pytest/src/_pytest/_code/code.py,4989.0,ModificationType.MODIFY,1165,710,800,67,119,181,1232,18,243,153,282,261,435,2000.7880884021665,3492.1391085079,10.444444444444443,36473.45291108252,2026.302939504584,1.1640463695026333,False
401,f4734213e5871364894c79f826e268d4b294f222,/Users/sanika/Downloads/Master Thesis/repo_updated/pytest/testing/code/test_source.py,1549.0,ModificationType.MODIFY,773,419,590,28,0,166,801,10,204,113,217,214,330,1598.3940507110583,2554.6841055123778,5.318627450980392,13587.413012161423,754.8562784534123,0.8515613685041261,False
402,f4734213e5871364894c79f826e268d4b294f222,/Users/sanika/Downloads/Master Thesis/repo_updated/pytest/src/_pytest/_code/source.py,1549.0,ModificationType.MODIFY,421,273,302,44,34,57,465,17,81,59,107,98,166,583.0147185349102,1098.0418341231248,11.228395061728396,12329.247507839285,684.9581948799603,0.36601394470770826,False
403,f4734213e5871364894c79f826e268d4b294f222,/Users/sanika/Downloads/Master Thesis/repo_updated/pytest/testing/example_scripts/collect/package_infinite_recursion/__init__.pyi,568.0,ModificationType.MODIFY,0,0,0,0,0,0,0,0,0,0,0,0,0,0.0,0.0,0.0,0.0,0.0,0.0,False
404,f4734213e5871364894c79f826e268d4b294f222,/Users/sanika/Downloads/Master Thesis/repo_updated/pytest/testing/example_scripts/collect/package_infinite_recursion/tests/__init__.py,568.0,ModificationType.MODIFY,0,0,0,0,0,0,0,0,0,0,0,0,0,0.0,0.0,0.0,0.0,0.0,0.0,False
405,f4734213e5871364894c79f826e268d4b294f222,/Users/sanika/Downloads/Master Thesis/repo_updated/pytest/testing/example_scripts/collect/collect_init_tests/tests/__init__.py,568.0,ModificationType.MODIFY,2,2,2,0,0,0,2,0,0,0,0,0,0,0.0,0.0,0.0,0.0,0.0,0.0,False
406,f4734213e5871364894c79f826e268d4b294f222,/Users/sanika/Downloads/Master Thesis/repo_updated/pytest/testing/example_scripts/collect/package_init_given_as_arg/pkg/__init__.py,568.0,ModificationType.MODIFY,0,0,0,0,0,0,0,0,0,0,0,0,0,0.0,0.0,0.0,0.0,0.0,0.0,False
407,f4734213e5871364894c79f826e268d4b294f222,/Users/sanika/Downloads/Master Thesis/repo_updated/pytest/testing/example_scripts/conftest_usageerror/__init__.pyi,568.0,ModificationType.MODIFY,0,0,0,0,0,0,0,0,0,0,0,0,0,0.0,0.0,0.0,0.0,0.0,0.0,False
408,f4734213e5871364894c79f826e268d4b294f222,/Users/sanika/Downloads/Master Thesis/repo_updated/pytest/testing/example_scripts/marks/marks_considered_keywords/__init__.pyi,568.0,ModificationType.MODIFY,0,0,0,0,0,0,0,0,0,0,0,0,0,0.0,0.0,0.0,0.0,0.0,0.0,False
409,f4734213e5871364894c79f826e268d4b294f222,/Users/sanika/Downloads/Master Thesis/repo_updated/pytest/testing/example_scripts/config/collect_pytest_prefix/__init__.pyi,568.0,ModificationType.MODIFY,0,0,0,0,0,0,0,0,0,0,0,0,0,0.0,0.0,0.0,0.0,0.0,0.0,False
410,f4734213e5871364894c79f826e268d4b294f222,/Users/sanika/Downloads/Master Thesis/repo_updated/pytest/testing/example_scripts/issue88_initial_file_multinodes/__init__.pyi,568.0,ModificationType.MODIFY,0,0,0,0,0,0,0,0,0,0,0,0,0,0.0,0.0,0.0,0.0,0.0,0.0,False
411,f4734213e5871364894c79f826e268d4b294f222,/Users/sanika/Downloads/Master Thesis/repo_updated/pytest/testing/example_scripts/fixtures/fill_fixtures/test_extend_fixture_conftest_conftest/__init__.pyi,568.0,ModificationType.MODIFY,0,0,0,0,0,0,0,0,0,0,0,0,0,0.0,0.0,0.0,0.0,0.0,0.0,False
412,f4734213e5871364894c79f826e268d4b294f222,/Users/sanika/Downloads/Master Thesis/repo_updated/pytest/testing/example_scripts/fixtures/fill_fixtures/test_extend_fixture_conftest_conftest/pkg/__init__.py,568.0,ModificationType.MODIFY,0,0,0,0,0,0,0,0,0,0,0,0,0,0.0,0.0,0.0,0.0,0.0,0.0,False
413,f4734213e5871364894c79f826e268d4b294f222,/Users/sanika/Downloads/Master Thesis/repo_updated/pytest/testing/example_scripts/fixtures/fill_fixtures/test_extend_fixture_conftest_module/__init__.pyi,568.0,ModificationType.MODIFY,0,0,0,0,0,0,0,0,0,0,0,0,0,0.0,0.0,0.0,0.0,0.0,0.0,False
414,f4734213e5871364894c79f826e268d4b294f222,/Users/sanika/Downloads/Master Thesis/repo_updated/pytest/testing/example_scripts/fixtures/fill_fixtures/test_conftest_funcargs_only_available_in_subdir/sub1/__init__.py,568.0,ModificationType.MODIFY,0,0,0,0,0,0,0,0,0,0,0,0,0,0.0,0.0,0.0,0.0,0.0,0.0,False
415,f4734213e5871364894c79f826e268d4b294f222,/Users/sanika/Downloads/Master Thesis/repo_updated/pytest/testing/example_scripts/fixtures/fill_fixtures/test_conftest_funcargs_only_available_in_subdir/sub2/__init__.py,568.0,ModificationType.MODIFY,0,0,0,0,0,0,0,0,0,0,0,0,0,0.0,0.0,0.0,0.0,0.0,0.0,False
416,f4734213e5871364894c79f826e268d4b294f222,/Users/sanika/Downloads/Master Thesis/repo_updated/pytest/testing/example_scripts/fixtures/custom_item/__init__.pyi,568.0,ModificationType.MODIFY,0,0,0,0,0,0,0,0,0,0,0,0,0,0.0,0.0,0.0,0.0,0.0,0.0,False
417,f4734213e5871364894c79f826e268d4b294f222,/Users/sanika/Downloads/Master Thesis/repo_updated/pytest/testing/example_scripts/fixtures/custom_item/foo/__init__.py,568.0,ModificationType.MODIFY,0,0,0,0,0,0,0,0,0,0,0,0,0,0.0,0.0,0.0,0.0,0.0,0.0,False
418,f4734213e5871364894c79f826e268d4b294f222,/Users/sanika/Downloads/Master Thesis/repo_updated/pytest/doc/en/example/nonpython/__init__.py,568.0,ModificationType.MODIFY,0,0,0,0,0,0,0,0,0,0,0,0,0,0.0,0.0,0.0,0.0,0.0,0.0,False
419,f4734213e5871364894c79f826e268d4b294f222,/Users/sanika/Downloads/Master Thesis/repo_updated/pytest/src/pytest/__init__.py,568.0,ModificationType.MODIFY,99,48,90,1,3,5,100,0,0,0,0,0,0,0.0,0.0,0.0,0.0,0.0,0.0,False
420,f4734213e5871364894c79f826e268d4b294f222,/Users/sanika/Downloads/Master Thesis/repo_updated/pytest/src/_pytest/__init__.py,568.0,ModificationType.MODIFY,8,5,5,2,0,1,10,0,0,0,0,0,0,0.0,0.0,0.0,0.0,0.0,0.0,False
421,f4734213e5871364894c79f826e268d4b294f222,/Users/sanika/Downloads/Master Thesis/repo_updated/pytest/src/_pytest/config/__init__.py,568.0,ModificationType.MODIFY,1217,716,841,84,126,174,1301,14,185,118,215,199,333,1446.608539104324,2542.995998641035,8.135135135135135,20687.616097052745,1149.3120053918194,0.847665332880345,False
422,f4734213e5871364894c79f826e268d4b294f222,/Users/sanika/Downloads/Master Thesis/repo_updated/pytest/src/_pytest/mark/__init__.py,568.0,ModificationType.MODIFY,160,89,115,0,13,31,160,7,15,11,17,22,28,78.25484338853101,124.86408532184431,3.966666666666667,495.29420510998256,27.516344728332356,0.04162136177394811,False
423,f4734213e5871364894c79f826e268d4b294f222,/Users/sanika/Downloads/Master Thesis/repo_updated/pytest/src/_pytest/_code/__init__.py,568.0,ModificationType.MODIFY,10,10,9,9,0,0,19,0,0,0,0,0,0,0.0,0.0,0.0,0.0,0.0,0.0,False
424,f4734213e5871364894c79f826e268d4b294f222,/Users/sanika/Downloads/Master Thesis/repo_updated/pytest/src/_pytest/assertion/__init__.py,568.0,ModificationType.MODIFY,173,84,99,8,29,36,181,5,12,7,13,17,20,54.62919048309069,81.7492568250068,2.708333333333333,221.40423723439343,12.300235401910744,0.027249752275002263,False
425,f4734213e5871364894c79f826e268d4b294f222,/Users/sanika/Downloads/Master Thesis/repo_updated/pytest/src/_pytest/_io/__init__.py,568.0,ModificationType.MODIFY,3,1,1,3,0,0,6,0,0,0,0,0,0,0.0,0.0,0.0,0.0,0.0,0.0,False
426,f4734213e5871364894c79f826e268d4b294f222,/Users/sanika/Downloads/Master Thesis/repo_updated/pytest/testing/test_assertrewrite.py,5415.0,ModificationType.MODIFY,1660,832,1314,41,38,274,1701,20,312,209,395,332,604,2671.484054182769,5058.523816533542,12.660256410256409,64042.208574703494,3557.900476372417,1.6861746055111808,False
427,f4734213e5871364894c79f826e268d4b294f222,/Users/sanika/Downloads/Master Thesis/repo_updated/pytest/src/_pytest/assertion/rewrite.py,5415.0,ModificationType.MODIFY,1057,646,719,113,100,145,1170,18,215,134,248,233,382,1740.9201126876956,3004.119107257935,10.381395348837211,31186.94812744052,1732.608229302251,1.001373035752645,False
428,f4734213e5871364894c79f826e268d4b294f222,/Users/sanika/Downloads/Master Thesis/repo_updated/pytest/src/_pytest/assertion/util.py,2323.0,ModificationType.MODIFY,477,336,357,30,23,73,507,16,194,134,250,210,384,1538.3830913843026,2962.2702787837907,10.309278350515463,30538.868853441152,1696.603825191175,0.9874234262612636,False
429,f4734213e5871364894c79f826e268d4b294f222,/Users/sanika/Downloads/Master Thesis/repo_updated/pytest/testing/test_cacheprovider.py,2013.0,ModificationType.MODIFY,996,429,845,24,10,117,1020,7,76,50,88,83,138,494.49397547611574,879.7554415258757,4.052631578947368,3565.324684078549,198.07359355991935,0.2932518138419585,False
430,f4734213e5871364894c79f826e268d4b294f222,/Users/sanika/Downloads/Master Thesis/repo_updated/pytest/src/_pytest/cacheprovider.py,2013.0,ModificationType.MODIFY,456,277,329,12,42,72,468,13,85,50,97,98,147,592.903945907539,972.3623470849358,7.417647058823531,7212.640703965319,400.7022613314065,0.3241207823616453,False
431,f4734213e5871364894c79f826e268d4b294f222,/Users/sanika/Downloads/Master Thesis/repo_updated/pytest/testing/test_capture.py,3434.0,ModificationType.MODIFY,1513,682,1277,25,13,200,1538,11,199,116,219,210,335,1557.7420472931965,2584.272248418151,6.052763819095478,15641.989563917903,868.9994202176613,0.8614240828060503,False
432,f4734213e5871364894c79f826e268d4b294f222,/Users/sanika/Downloads/Master Thesis/repo_updated/pytest/src/_pytest/capture.py,3434.0,ModificationType.MODIFY,819,519,539,24,98,155,843,15,96,57,106,111,163,690.7597590033588,1107.4897862150674,8.28125,9171.399792093527,509.5222106718626,0.3691632620716892,False
433,f4734213e5871364894c79f826e268d4b294f222,/Users/sanika/Downloads/Master Thesis/repo_updated/pytest/testing/test_compat.py,1191.0,ModificationType.MODIFY,207,111,150,11,0,50,218,5,26,19,36,31,55,133.82107314610522,272.4807970712782,3.4615384615384617,943.202759092886,52.400153282938106,0.09082693235709273,False
434,f4734213e5871364894c79f826e268d4b294f222,/Users/sanika/Downloads/Master Thesis/repo_updated/pytest/src/_pytest/compat.py,1191.0,ModificationType.MODIFY,410,198,237,31,55,97,441,11,63,38,72,74,110,414.62238298550506,683.0398702191846,6.2857142857142865,4293.39346994916,238.52185944162002,0.2276799567397282,False
435,f4734213e5871364894c79f826e268d4b294f222,/Users/sanika/Downloads/Master Thesis/repo_updated/pytest/testing/example_scripts/collect/package_infinite_recursion/__init__.pyi,5048.0,ModificationType.MODIFY,0,0,0,0,0,0,0,0,0,0,0,0,0,0.0,0.0,0.0,0.0,0.0,0.0,False
436,f4734213e5871364894c79f826e268d4b294f222,/Users/sanika/Downloads/Master Thesis/repo_updated/pytest/testing/example_scripts/collect/package_infinite_recursion/tests/__init__.py,5048.0,ModificationType.MODIFY,0,0,0,0,0,0,0,0,0,0,0,0,0,0.0,0.0,0.0,0.0,0.0,0.0,False
437,f4734213e5871364894c79f826e268d4b294f222,/Users/sanika/Downloads/Master Thesis/repo_updated/pytest/testing/example_scripts/collect/collect_init_tests/tests/__init__.py,5048.0,ModificationType.MODIFY,2,2,2,0,0,0,2,0,0,0,0,0,0,0.0,0.0,0.0,0.0,0.0,0.0,False
438,f4734213e5871364894c79f826e268d4b294f222,/Users/sanika/Downloads/Master Thesis/repo_updated/pytest/testing/example_scripts/collect/package_init_given_as_arg/pkg/__init__.py,5048.0,ModificationType.MODIFY,0,0,0,0,0,0,0,0,0,0,0,0,0,0.0,0.0,0.0,0.0,0.0,0.0,False
439,f4734213e5871364894c79f826e268d4b294f222,/Users/sanika/Downloads/Master Thesis/repo_updated/pytest/testing/example_scripts/conftest_usageerror/__init__.pyi,5048.0,ModificationType.MODIFY,0,0,0,0,0,0,0,0,0,0,0,0,0,0.0,0.0,0.0,0.0,0.0,0.0,False
440,f4734213e5871364894c79f826e268d4b294f222,/Users/sanika/Downloads/Master Thesis/repo_updated/pytest/testing/example_scripts/marks/marks_considered_keywords/__init__.pyi,5048.0,ModificationType.MODIFY,0,0,0,0,0,0,0,0,0,0,0,0,0,0.0,0.0,0.0,0.0,0.0,0.0,False
441,f4734213e5871364894c79f826e268d4b294f222,/Users/sanika/Downloads/Master Thesis/repo_updated/pytest/testing/example_scripts/config/collect_pytest_prefix/__init__.pyi,5048.0,ModificationType.MODIFY,0,0,0,0,0,0,0,0,0,0,0,0,0,0.0,0.0,0.0,0.0,0.0,0.0,False
442,f4734213e5871364894c79f826e268d4b294f222,/Users/sanika/Downloads/Master Thesis/repo_updated/pytest/testing/example_scripts/issue88_initial_file_multinodes/__init__.pyi,5048.0,ModificationType.MODIFY,0,0,0,0,0,0,0,0,0,0,0,0,0,0.0,0.0,0.0,0.0,0.0,0.0,False
443,f4734213e5871364894c79f826e268d4b294f222,/Users/sanika/Downloads/Master Thesis/repo_updated/pytest/testing/example_scripts/fixtures/fill_fixtures/test_extend_fixture_conftest_conftest/__init__.pyi,5048.0,ModificationType.MODIFY,0,0,0,0,0,0,0,0,0,0,0,0,0,0.0,0.0,0.0,0.0,0.0,0.0,False
444,f4734213e5871364894c79f826e268d4b294f222,/Users/sanika/Downloads/Master Thesis/repo_updated/pytest/testing/example_scripts/fixtures/fill_fixtures/test_extend_fixture_conftest_conftest/pkg/__init__.py,5048.0,ModificationType.MODIFY,0,0,0,0,0,0,0,0,0,0,0,0,0,0.0,0.0,0.0,0.0,0.0,0.0,False
445,f4734213e5871364894c79f826e268d4b294f222,/Users/sanika/Downloads/Master Thesis/repo_updated/pytest/testing/example_scripts/fixtures/fill_fixtures/test_extend_fixture_conftest_module/__init__.pyi,5048.0,ModificationType.MODIFY,0,0,0,0,0,0,0,0,0,0,0,0,0,0.0,0.0,0.0,0.0,0.0,0.0,False
446,f4734213e5871364894c79f826e268d4b294f222,/Users/sanika/Downloads/Master Thesis/repo_updated/pytest/testing/example_scripts/fixtures/fill_fixtures/test_conftest_funcargs_only_available_in_subdir/sub1/__init__.py,5048.0,ModificationType.MODIFY,0,0,0,0,0,0,0,0,0,0,0,0,0,0.0,0.0,0.0,0.0,0.0,0.0,False
447,f4734213e5871364894c79f826e268d4b294f222,/Users/sanika/Downloads/Master Thesis/repo_updated/pytest/testing/example_scripts/fixtures/fill_fixtures/test_conftest_funcargs_only_available_in_subdir/sub2/__init__.py,5048.0,ModificationType.MODIFY,0,0,0,0,0,0,0,0,0,0,0,0,0,0.0,0.0,0.0,0.0,0.0,0.0,False
448,f4734213e5871364894c79f826e268d4b294f222,/Users/sanika/Downloads/Master Thesis/repo_updated/pytest/testing/example_scripts/fixtures/custom_item/__init__.pyi,5048.0,ModificationType.MODIFY,0,0,0,0,0,0,0,0,0,0,0,0,0,0.0,0.0,0.0,0.0,0.0,0.0,False
449,f4734213e5871364894c79f826e268d4b294f222,/Users/sanika/Downloads/Master Thesis/repo_updated/pytest/testing/example_scripts/fixtures/custom_item/foo/__init__.py,5048.0,ModificationType.MODIFY,0,0,0,0,0,0,0,0,0,0,0,0,0,0.0,0.0,0.0,0.0,0.0,0.0,False
450,f4734213e5871364894c79f826e268d4b294f222,/Users/sanika/Downloads/Master Thesis/repo_updated/pytest/doc/en/example/nonpython/__init__.py,5048.0,ModificationType.MODIFY,0,0,0,0,0,0,0,0,0,0,0,0,0,0.0,0.0,0.0,0.0,0.0,0.0,False
451,f4734213e5871364894c79f826e268d4b294f222,/Users/sanika/Downloads/Master Thesis/repo_updated/pytest/src/pytest/__init__.py,5048.0,ModificationType.MODIFY,99,48,90,1,3,5,100,0,0,0,0,0,0,0.0,0.0,0.0,0.0,0.0,0.0,False
452,f4734213e5871364894c79f826e268d4b294f222,/Users/sanika/Downloads/Master Thesis/repo_updated/pytest/src/_pytest/__init__.py,5048.0,ModificationType.MODIFY,8,5,5,2,0,1,10,0,0,0,0,0,0,0.0,0.0,0.0,0.0,0.0,0.0,False
453,f4734213e5871364894c79f826e268d4b294f222,/Users/sanika/Downloads/Master Thesis/repo_updated/pytest/src/_pytest/config/__init__.py,5048.0,ModificationType.MODIFY,1217,716,841,84,126,174,1301,14,185,118,215,199,333,1446.608539104324,2542.995998641035,8.135135135135135,20687.616097052745,1149.3120053918194,0.847665332880345,False
454,f4734213e5871364894c79f826e268d4b294f222,/Users/sanika/Downloads/Master Thesis/repo_updated/pytest/src/_pytest/mark/__init__.py,5048.0,ModificationType.MODIFY,160,89,115,0,13,31,160,7,15,11,17,22,28,78.25484338853101,124.86408532184431,3.966666666666667,495.29420510998256,27.516344728332356,0.04162136177394811,False
455,f4734213e5871364894c79f826e268d4b294f222,/Users/sanika/Downloads/Master Thesis/repo_updated/pytest/src/_pytest/_code/__init__.py,5048.0,ModificationType.MODIFY,10,10,9,9,0,0,19,0,0,0,0,0,0,0.0,0.0,0.0,0.0,0.0,0.0,False
456,f4734213e5871364894c79f826e268d4b294f222,/Users/sanika/Downloads/Master Thesis/repo_updated/pytest/src/_pytest/assertion/__init__.py,5048.0,ModificationType.MODIFY,173,84,99,8,29,36,181,5,12,7,13,17,20,54.62919048309069,81.7492568250068,2.708333333333333,221.40423723439343,12.300235401910744,0.027249752275002263,False
457,f4734213e5871364894c79f826e268d4b294f222,/Users/sanika/Downloads/Master Thesis/repo_updated/pytest/src/_pytest/_io/__init__.py,5048.0,ModificationType.MODIFY,3,1,1,3,0,0,6,0,0,0,0,0,0,0.0,0.0,0.0,0.0,0.0,0.0,False
458,f4734213e5871364894c79f826e268d4b294f222,/Users/sanika/Downloads/Master Thesis/repo_updated/pytest/src/_pytest/config/argparsing.py,2326.0,ModificationType.MODIFY,463,295,324,28,62,57,491,12,134,82,154,146,236,989.8755015299953,1696.7985958956842,6.8955223880597005,11700.312706026956,650.0173725570531,0.565599531965228,False
459,f4734213e5871364894c79f826e268d4b294f222,/Users/sanika/Downloads/Master Thesis/repo_updated/pytest/src/_pytest/config/findpaths.py,813.0,ModificationType.MODIFY,167,116,138,4,5,22,171,8,48,30,56,56,86,292.0782000346155,499.43252329695395,4.666666666666667,2330.685108719119,129.48250603995106,0.16647750776565134,False
460,f4734213e5871364894c79f826e268d4b294f222,/Users/sanika/Downloads/Master Thesis/repo_updated/pytest/src/_pytest/debugging.py,1488.0,ModificationType.MODIFY,339,213,244,17,9,65,356,10,42,26,48,52,74,259.6966127055816,421.83253914244085,5.7142857142857135,2410.4716522425188,133.91509179125106,0.1406108463808136,False
461,f4734213e5871364894c79f826e268d4b294f222,/Users/sanika/Downloads/Master Thesis/repo_updated/pytest/src/_pytest/deprecated.py,38.0,ModificationType.MODIFY,42,7,23,2,8,9,44,0,0,0,0,0,0,0.0,0.0,0.0,0.0,0.0,0.0,False
462,f4734213e5871364894c79f826e268d4b294f222,/Users/sanika/Downloads/Master Thesis/repo_updated/pytest/testing/python/fixtures.py,6225.0,ModificationType.MODIFY,4293,999,3693,19,54,507,4312,9,155,88,170,164,258,1156.3286078304875,1898.2484171914662,4.935483870967742,9368.774446138525,520.4874692299181,0.6327494723971553,False
463,f4734213e5871364894c79f826e268d4b294f222,/Users/sanika/Downloads/Master Thesis/repo_updated/pytest/src/_pytest/fixtures.py,6225.0,ModificationType.MODIFY,1482,859,1002,125,135,219,1607,16,219,134,251,235,385,1766.6783660526569,3032.459024427525,9.168949771689498,27804.46447968251,1544.692471093473,1.0108196748091751,False
464,f4734213e5871364894c79f826e268d4b294f222,/Users/sanika/Downloads/Master Thesis/repo_updated/pytest/testing/test_helpconfig.py,1080.0,ModificationType.MODIFY,74,35,59,1,0,14,75,3,14,7,14,17,21,58.057856410969926,85.83671966625714,1.5,128.75507949938572,7.153059972188095,0.028612239888752382,False
465,f4734213e5871364894c79f826e268d4b294f222,/Users/sanika/Downloads/Master Thesis/repo_updated/pytest/src/_pytest/helpconfig.py,1080.0,ModificationType.MODIFY,245,125,200,5,7,34,250,7,30,17,34,37,51,166.8582023226588,265.6821216470764,3.966666666666667,1053.8724158667364,58.548467548152026,0.08856070721569215,False
466,f4734213e5871364894c79f826e268d4b294f222,/Users/sanika/Downloads/Master Thesis/repo_updated/pytest/src/_pytest/hookspec.py,640.0,ModificationType.MODIFY,647,139,84,35,284,233,682,0,0,0,0,0,0,0.0,0.0,0.0,0.0,0.0,0.0,False
467,f4734213e5871364894c79f826e268d4b294f222,/Users/sanika/Downloads/Master Thesis/repo_updated/pytest/testing/test_junitxml.py,3166.0,ModificationType.MODIFY,1523,757,1297,19,12,193,1542,12,193,117,230,205,347,1508.3637582013935,2664.7795945283897,7.150259067357513,19053.86445828589,1058.5480254603274,0.8882598648427965,False
468,f4734213e5871364894c79f826e268d4b294f222,/Users/sanika/Downloads/Master Thesis/repo_updated/pytest/src/_pytest/junitxml.py,3166.0,ModificationType.MODIFY,701,378,504,33,58,109,734,13,110,68,126,123,194,794.0552848235468,1346.8478140358125,7.445454545454545,10027.894179048459,557.1052321693588,0.4489492713452708,False
469,f4734213e5871364894c79f826e268d4b294f222,/Users/sanika/Downloads/Master Thesis/repo_updated/pytest/src/_pytest/logging.py,2754.0,ModificationType.MODIFY,773,422,505,30,103,129,803,14,77,46,83,91,129,535.8455325423139,839.5055085856317,7.545454545454546,6334.450655691586,351.9139253161992,0.2798351695285439,False
470,f4734213e5871364894c79f826e268d4b294f222,/Users/sanika/Downloads/Master Thesis/repo_updated/pytest/testing/test_main.py,3472.0,ModificationType.MODIFY,77,34,69,0,0,8,77,3,24,16,29,27,45,114.79398751947123,213.9699375973561,1.8125,387.82051189520797,21.54558399417822,0.07132331253245204,False
471,f4734213e5871364894c79f826e268d4b294f222,/Users/sanika/Downloads/Master Thesis/repo_updated/pytest/src/_pytest/main.py,3472.0,ModificationType.MODIFY,712,438,573,51,9,84,763,14,102,71,128,116,199,733.8903537898989,1364.7382180303869,8.784313725490197,11988.288660345359,666.0160366858534,0.4549127393434623,False
472,f4734213e5871364894c79f826e268d4b294f222,/Users/sanika/Downloads/Master Thesis/repo_updated/pytest/src/_pytest/mark/evaluate.py,669.0,ModificationType.MODIFY,125,97,103,3,0,19,128,9,25,17,27,34,44,144.6257297573489,223.84836501501496,4.86,1087.9030539729727,60.43905855405405,0.07461612167167166,False
473,f4734213e5871364894c79f826e268d4b294f222,/Users/sanika/Downloads/Master Thesis/repo_updated/pytest/src/_pytest/mark/structures.py,1535.0,ModificationType.MODIFY,402,202,227,24,74,80,426,12,52,33,61,64,94,339.4424153519907,564.0,7.038461538461537,3969.6923076923076,220.53846153846158,0.188,False
474,f4734213e5871364894c79f826e268d4b294f222,/Users/sanika/Downloads/Master Thesis/repo_updated/pytest/testing/test_nodes.py,1701.0,ModificationType.MODIFY,53,23,39,0,0,13,53,2,8,4,8,10,12,26.0,39.863137138648355,1.0,39.863137138648355,2.2146187299249087,0.013287712379549451,False
475,f4734213e5871364894c79f826e268d4b294f222,/Users/sanika/Downloads/Master Thesis/repo_updated/pytest/src/_pytest/nodes.py,1701.0,ModificationType.MODIFY,515,298,307,33,80,99,548,12,63,44,77,75,121,419.5881851891487,753.6870615500015,7.333333333333332,5527.038451366679,307.0576917425932,0.2512290205166672,False
476,f4734213e5871364894c79f826e268d4b294f222,/Users/sanika/Downloads/Master Thesis/repo_updated/pytest/src/_pytest/outcomes.py,572.0,ModificationType.MODIFY,205,80,86,16,53,53,221,7,18,10,19,25,29,94.71013448036484,134.671829503467,3.6944444444444446,497.5375923322531,27.64097735179184,0.044890609834489004,False
477,f4734213e5871364894c79f826e268d4b294f222,/Users/sanika/Downloads/Master Thesis/repo_updated/pytest/testing/test_pastebin.py,491.0,ModificationType.MODIFY,184,100,137,2,15,30,186,6,38,20,39,44,59,214.93102051518318,322.10646549960046,3.0789473684210527,991.7488543014017,55.09715857230009,0.10736882183320018,False
478,f4734213e5871364894c79f826e268d4b294f222,/Users/sanika/Downloads/Master Thesis/repo_updated/pytest/src/_pytest/pastebin.py,491.0,ModificationType.MODIFY,103,65,74,8,5,16,111,7,17,9,17,24,26,89.13835275565901,119.20902501875008,3.5,417.2315875656253,23.17953264253474,0.039736341672916696,False
479,f4734213e5871364894c79f826e268d4b294f222,/Users/sanika/Downloads/Master Thesis/repo_updated/pytest/testing/test_pathlib.py,1354.0,ModificationType.MODIFY,91,45,69,0,3,18,91,3,9,6,10,12,16,33.28421251514428,57.3594000115385,1.6666666666666667,95.59900001923084,5.311055556623936,0.01911980000384617,False
480,f4734213e5871364894c79f826e268d4b294f222,/Users/sanika/Downloads/Master Thesis/repo_updated/pytest/src/_pytest/pathlib.py,1354.0,ModificationType.MODIFY,367,234,237,17,34,68,384,16,55,34,61,71,95,381.9747842438563,584.2259763529447,8.872727272727273,5183.677753822492,287.98209743458284,0.19474199211764828,False
481,f4734213e5871364894c79f826e268d4b294f222,/Users/sanika/Downloads/Master Thesis/repo_updated/pytest/testing/test_pytester.py,5908.0,ModificationType.MODIFY,722,423,573,19,0,135,741,12,172,101,199,184,300,1320.3370878174146,2257.068586817104,6.941860465116278,15668.255189881524,870.4586216600846,0.7523561956057013,False
482,f4734213e5871364894c79f826e268d4b294f222,/Users/sanika/Downloads/Master Thesis/repo_updated/pytest/src/_pytest/pytester.py,5908.0,ModificationType.MODIFY,1508,847,911,44,250,301,1552,14,148,88,169,162,257,1120.302067021891,1886.3414507413486,7.993243243243242,15077.986055587939,837.6658919771077,0.6287804835804495,False
483,f4734213e5871364894c79f826e268d4b294f222,/Users/sanika/Downloads/Master Thesis/repo_updated/pytest/doc/en/example/multipython.py,6685.0,ModificationType.MODIFY,72,33,56,0,4,12,72,1,1,1,1,2,2,0.0,2.0,0.5,1.0,0.05555555555555555,0.0006666666666666666,False
484,f4734213e5871364894c79f826e268d4b294f222,/Users/sanika/Downloads/Master Thesis/repo_updated/pytest/src/_pytest/python.py,6685.0,ModificationType.MODIFY,1454,835,1044,76,110,219,1530,17,275,158,296,292,454,2297.8910156145625,3718.1803497315277,9.149090909090908,34017.97003608918,1889.8872242271768,1.2393934499105097,False
485,f4734213e5871364894c79f826e268d4b294f222,/Users/sanika/Downloads/Master Thesis/repo_updated/pytest/src/_pytest/python_api.py,1961.0,ModificationType.MODIFY,757,253,292,73,244,162,830,13,61,38,67,74,105,409.88069392717034,651.9926033910399,7.139344262295082,4654.799652078655,258.5999806710363,0.2173308677970133,False
486,f4734213e5871364894c79f826e268d4b294f222,/Users/sanika/Downloads/Master Thesis/repo_updated/pytest/testing/test_recwarn.py,987.0,ModificationType.MODIFY,386,256,301,16,9,68,402,4,59,35,69,63,104,355.07593991234864,621.6371120439914,2.3389830508474576,1453.9986688486576,80.77770382492542,0.20721237068133044,False
487,f4734213e5871364894c79f826e268d4b294f222,/Users/sanika/Downloads/Master Thesis/repo_updated/pytest/src/_pytest/recwarn.py,987.0,ModificationType.MODIFY,264,131,164,11,41,46,275,6,38,22,40,44,62,214.93102051518318,338.48476035551244,3.1578947368421053,1068.899243227934,59.38329129044078,0.11282825345183747,False
488,f4734213e5871364894c79f826e268d4b294f222,/Users/sanika/Downloads/Master Thesis/repo_updated/pytest/testing/test_reports.py,1942.0,ModificationType.MODIFY,466,257,367,18,25,50,484,7,126,86,171,133,257,898.7887548153927,1813.2075859238055,4.75,8612.736033138077,478.4853351743376,0.6044025286412685,False
489,f4734213e5871364894c79f826e268d4b294f222,/Users/sanika/Downloads/Master Thesis/repo_updated/pytest/src/_pytest/reports.py,1942.0,ModificationType.MODIFY,507,281,342,29,59,88,536,10,53,29,57,63,86,336.7990650407233,514.0460734209928,5.377358490566038,2764.2100174525085,153.56722319180602,0.17134869114033094,False
490,f4734213e5871364894c79f826e268d4b294f222,/Users/sanika/Downloads/Master Thesis/repo_updated/pytest/testing/test_runner.py,1918.0,ModificationType.MODIFY,1043,504,840,53,9,147,1096,9,180,112,198,189,310,1377.0628823523223,2344.2951515085324,4.95,11604.260999967237,644.6811666648464,0.7814317171695108,False
491,f4734213e5871364894c79f826e268d4b294f222,/Users/sanika/Downloads/Master Thesis/repo_updated/pytest/src/_pytest/runner.py,1918.0,ModificationType.MODIFY,383,288,292,26,6,62,409,11,65,38,67,76,105,429.5076556518598,656.0323889115765,5.6692307692307695,3719.1990048294756,206.6221669349709,0.2186774629705255,False
492,f4734213e5871364894c79f826e268d4b294f222,/Users/sanika/Downloads/Master Thesis/repo_updated/pytest/testing/test_setuponly.py,381.0,ModificationType.MODIFY,294,64,250,0,0,43,294,1,20,10,20,21,30,86.43856189774725,131.7695226833628,0.5,65.8847613416814,3.660264518982301,0.04392317422778761,False
493,f4734213e5871364894c79f826e268d4b294f222,/Users/sanika/Downloads/Master Thesis/repo_updated/pytest/src/_pytest/setuponly.py,381.0,ModificationType.MODIFY,78,46,62,3,0,14,81,3,8,4,8,11,12,28.754887502163466,41.51317942364757,1.5,62.269769135471364,3.4594316186372978,0.013837726474549191,False
494,f4734213e5871364894c79f826e268d4b294f222,/Users/sanika/Downloads/Master Thesis/repo_updated/pytest/testing/test_stepwise.py,429.0,ModificationType.MODIFY,219,78,157,11,5,46,230,3,24,20,34,27,54,114.79398751947123,256.7639251168273,2.125,545.6233408732581,30.31240782629212,0.08558797503894246,False
495,f4734213e5871364894c79f826e268d4b294f222,/Users/sanika/Downloads/Master Thesis/repo_updated/pytest/src/_pytest/stepwise.py,429.0,ModificationType.MODIFY,108,64,79,9,0,20,117,5,15,11,19,20,30,70.2129994085646,129.6578428466209,3.1666666666666665,410.5831690142994,22.81017605634997,0.04321928094887362,False
496,f4734213e5871364894c79f826e268d4b294f222,/Users/sanika/Downloads/Master Thesis/repo_updated/pytest/testing/test_terminal.py,5905.0,ModificationType.MODIFY,1943,715,1694,26,18,214,1969,12,185,120,237,197,357,1436.3251202041715,2721.0724995459263,7.686486486486486,20915.486996509768,1161.971499806098,0.9070241665153088,False
497,f4734213e5871364894c79f826e268d4b294f222,/Users/sanika/Downloads/Master Thesis/repo_updated/pytest/src/_pytest/terminal.py,5905.0,ModificationType.MODIFY,1168,838,957,57,25,144,1225,19,348,224,416,367,640,3018.854959310786,5452.567201819657,11.35632183908046,61921.107993078396,3440.0615551710216,1.817522400606552,False
498,f4734213e5871364894c79f826e268d4b294f222,/Users/sanika/Downloads/Master Thesis/repo_updated/pytest/testing/test_unittest.py,1371.0,ModificationType.MODIFY,1098,241,925,5,10,155,1103,7,46,25,49,53,74,273.7353344330258,423.86611363767685,3.728260869565217,1580.283445410034,87.79352474500189,0.14128870454589226,False
499,f4734213e5871364894c79f826e268d4b294f222,/Users/sanika/Downloads/Master Thesis/repo_updated/pytest/src/_pytest/unittest.py,1371.0,ModificationType.MODIFY,282,202,222,14,2,44,296,8,42,24,43,50,67,250.47733175670794,378.13836471490646,4.095238095238095,1548.5666364515216,86.03147980286232,0.1260461215716355,False
500,f4734213e5871364894c79f826e268d4b294f222,/Users/sanika/Downloads/Master Thesis/repo_updated/pytest/testing/acceptance_test.py,4688.0,ModificationType.MODIFY,1289,550,1043,56,32,155,1345,10,167,93,185,177,278,1266.2978977920407,2075.994342923073,5.538922155688622,11498.771061100857,638.8206145056031,0.6919981143076911,False
501,f4734213e5871364894c79f826e268d4b294f222,/Users/sanika/Downloads/Master Thesis/repo_updated/pytest/testing/code/test_code.py,956.0,ModificationType.MODIFY,182,127,129,0,0,53,182,5,39,21,42,44,63,217.7403270100645,343.9441919741497,2.6923076923076925,926.003593776557,51.44464409869761,0.11464806399138325,False
502,f4734213e5871364894c79f826e268d4b294f222,/Users/sanika/Downloads/Master Thesis/repo_updated/pytest/testing/code/test_excinfo.py,7105.0,ModificationType.MODIFY,1392,870,1177,35,17,170,1427,14,494,280,531,508,811,4473.796381311637,7289.823280972227,7.5242914979757085,54850.755334764704,3047.2641852647052,2.4299410936574084,False
503,f4734213e5871364894c79f826e268d4b294f222,/Users/sanika/Downloads/Master Thesis/repo_updated/pytest/testing/conftest.py,386.0,ModificationType.MODIFY,127,75,83,2,11,30,129,4,14,7,14,18,21,61.302968908806456,87.56842503028854,2.0,175.13685006057707,9.729825003365397,0.02918947501009618,False
504,f4734213e5871364894c79f826e268d4b294f222,/Users/sanika/Downloads/Master Thesis/repo_updated/pytest/testing/test_conftest.py,386.0,ModificationType.MODIFY,652,304,544,16,6,88,668,6,89,51,101,95,152,591.8500503603364,998.618052466304,3.4044943820224716,3399.789549407755,188.87719718931967,0.3328726841554347,False
505,f4734213e5871364894c79f826e268d4b294f222,/Users/sanika/Downloads/Master Thesis/repo_updated/pytest/testing/example_scripts/collect/package_infinite_recursion/conftest.py,386.0,ModificationType.MODIFY,2,2,2,0,0,0,2,0,0,0,0,0,0,0.0,0.0,0.0,0.0,0.0,0.0,False
506,f4734213e5871364894c79f826e268d4b294f222,/Users/sanika/Downloads/Master Thesis/repo_updated/pytest/testing/example_scripts/conftest_usageerror/conftest.py,386.0,ModificationType.MODIFY,8,5,5,0,0,3,8,0,0,0,0,0,0,0.0,0.0,0.0,0.0,0.0,0.0,False
507,f4734213e5871364894c79f826e268d4b294f222,/Users/sanika/Downloads/Master Thesis/repo_updated/pytest/testing/example_scripts/marks/marks_considered_keywords/conftest.py,386.0,ModificationType.MODIFY,0,0,0,0,0,0,0,0,0,0,0,0,0,0.0,0.0,0.0,0.0,0.0,0.0,False
508,f4734213e5871364894c79f826e268d4b294f222,/Users/sanika/Downloads/Master Thesis/repo_updated/pytest/testing/example_scripts/config/collect_pytest_prefix/conftest.py,386.0,ModificationType.MODIFY,2,2,2,0,0,0,2,0,0,0,0,0,0,0.0,0.0,0.0,0.0,0.0,0.0,False
509,f4734213e5871364894c79f826e268d4b294f222,/Users/sanika/Downloads/Master Thesis/repo_updated/pytest/testing/example_scripts/issue88_initial_file_multinodes/conftest.py,386.0,ModificationType.MODIFY,14,8,8,0,0,6,14,0,0,0,0,0,0,0.0,0.0,0.0,0.0,0.0,0.0,False
510,f4734213e5871364894c79f826e268d4b294f222,/Users/sanika/Downloads/Master Thesis/repo_updated/pytest/testing/example_scripts/fixtures/fill_fixtures/test_extend_fixture_conftest_conftest/conftest.py,386.0,ModificationType.MODIFY,6,4,4,0,0,2,6,0,0,0,0,0,0,0.0,0.0,0.0,0.0,0.0,0.0,False
511,f4734213e5871364894c79f826e268d4b294f222,/Users/sanika/Downloads/Master Thesis/repo_updated/pytest/testing/example_scripts/fixtures/fill_fixtures/test_extend_fixture_conftest_conftest/pkg/conftest.py,386.0,ModificationType.MODIFY,6,4,4,0,0,2,6,1,2,1,2,3,3,2.0,4.754887502163468,0.5,2.3774437510817346,0.1320802083934297,0.0015849625007211565,False
512,f4734213e5871364894c79f826e268d4b294f222,/Users/sanika/Downloads/Master Thesis/repo_updated/pytest/testing/example_scripts/fixtures/fill_fixtures/test_extend_fixture_conftest_module/conftest.py,386.0,ModificationType.MODIFY,6,4,4,0,0,2,6,0,0,0,0,0,0,0.0,0.0,0.0,0.0,0.0,0.0,False
513,f4734213e5871364894c79f826e268d4b294f222,/Users/sanika/Downloads/Master Thesis/repo_updated/pytest/testing/example_scripts/fixtures/fill_fixtures/test_conftest_funcargs_only_available_in_subdir/sub1/conftest.py,386.0,ModificationType.MODIFY,7,5,5,0,0,2,7,0,0,0,0,0,0,0.0,0.0,0.0,0.0,0.0,0.0,False
514,f4734213e5871364894c79f826e268d4b294f222,/Users/sanika/Downloads/Master Thesis/repo_updated/pytest/testing/example_scripts/fixtures/fill_fixtures/test_conftest_funcargs_only_available_in_subdir/sub2/conftest.py,386.0,ModificationType.MODIFY,6,4,4,0,0,2,6,0,0,0,0,0,0,0.0,0.0,0.0,0.0,0.0,0.0,False
515,f4734213e5871364894c79f826e268d4b294f222,/Users/sanika/Downloads/Master Thesis/repo_updated/pytest/testing/example_scripts/fixtures/custom_item/conftest.py,386.0,ModificationType.MODIFY,10,6,6,0,0,4,10,0,0,0,0,0,0,0.0,0.0,0.0,0.0,0.0,0.0,False
516,f4734213e5871364894c79f826e268d4b294f222,/Users/sanika/Downloads/Master Thesis/repo_updated/pytest/doc/en/conftest.py,386.0,ModificationType.MODIFY,1,1,1,0,0,0,1,0,0,0,0,0,0,0.0,0.0,0.0,0.0,0.0,0.0,False
517,f4734213e5871364894c79f826e268d4b294f222,/Users/sanika/Downloads/Master Thesis/repo_updated/pytest/doc/en/example/conftest.py,386.0,ModificationType.MODIFY,1,1,1,0,0,0,1,0,0,0,0,0,0,0.0,0.0,0.0,0.0,0.0,0.0,False
518,f4734213e5871364894c79f826e268d4b294f222,/Users/sanika/Downloads/Master Thesis/repo_updated/pytest/doc/en/example/assertion/global_testmodule_config/conftest.py,386.0,ModificationType.MODIFY,14,10,10,0,0,4,14,1,1,1,1,2,2,0.0,2.0,0.5,1.0,0.05555555555555555,0.0006666666666666666,False
519,f4734213e5871364894c79f826e268d4b294f222,/Users/sanika/Downloads/Master Thesis/repo_updated/pytest/doc/en/example/nonpython/conftest.py,386.0,ModificationType.MODIFY,46,26,30,3,0,12,49,3,6,3,6,9,9,20.264662506490406,28.52932501298081,1.5,42.79398751947122,2.377443751081734,0.009509775004326938,False
520,f4734213e5871364894c79f826e268d4b294f222,/Users/sanika/Downloads/Master Thesis/repo_updated/pytest/testing/deprecated_test.py,181.0,ModificationType.MODIFY,75,38,59,1,3,12,76,2,4,2,4,6,6,10.0,15.509775004326935,1.0,15.509775004326935,0.861654166907052,0.005169925001442312,False
521,f4734213e5871364894c79f826e268d4b294f222,/Users/sanika/Downloads/Master Thesis/repo_updated/pytest/testing/logging/test_fixture.py,696.0,ModificationType.MODIFY,139,89,101,2,0,35,141,7,54,34,62,61,96,330.4154095712305,569.3507844060372,4.018518518518518,2287.9466706687044,127.10814837048358,0.18978359480201235,False
522,f4734213e5871364894c79f826e268d4b294f222,/Users/sanika/Downloads/Master Thesis/repo_updated/pytest/testing/logging/test_reporting.py,2589.0,ModificationType.MODIFY,1157,318,931,29,22,177,1186,6,104,63,125,110,188,712.3555056910004,1274.895626142636,3.6057692307692313,4596.9794211873905,255.38774562152162,0.424965208714212,False
523,f4734213e5871364894c79f826e268d4b294f222,/Users/sanika/Downloads/Master Thesis/repo_updated/pytest/testing/python/collect.py,3928.0,ModificationType.MODIFY,1338,495,1086,10,64,173,1348,11,122,82,157,133,239,883.6037029876825,1686.2125020847845,7.077868852459017,11934.79094713288,663.0439415073823,0.5620708340282614,False
524,f4734213e5871364894c79f826e268d4b294f222,/Users/sanika/Downloads/Master Thesis/repo_updated/pytest/testing/python/fixtures.py,7999.0,ModificationType.MODIFY,4293,999,3693,19,54,507,4312,9,155,88,170,164,258,1156.3286078304875,1898.2484171914662,4.935483870967742,9368.774446138525,520.4874692299181,0.6327494723971553,False
525,f4734213e5871364894c79f826e268d4b294f222,/Users/sanika/Downloads/Master Thesis/repo_updated/pytest/src/_pytest/fixtures.py,7999.0,ModificationType.MODIFY,1482,859,1002,125,135,219,1607,16,219,134,251,235,385,1766.6783660526569,3032.459024427525,9.168949771689498,27804.46447968251,1544.692471093473,1.0108196748091751,False
526,f4734213e5871364894c79f826e268d4b294f222,/Users/sanika/Downloads/Master Thesis/repo_updated/pytest/testing/python/integration.py,992.0,ModificationType.MODIFY,465,148,393,5,8,60,470,4,31,20,31,35,51,161.58008562199316,261.5934338641933,2.0,523.1868677283866,29.065937096021475,0.08719781128806442,False
527,f4734213e5871364894c79f826e268d4b294f222,/Users/sanika/Downloads/Master Thesis/repo_updated/pytest/testing/example_scripts/acceptance/fixture_mock_integration.py,992.0,ModificationType.MODIFY,16,12,9,0,0,6,16,1,2,1,2,3,3,2.0,4.754887502163468,0.5,2.3774437510817346,0.1320802083934297,0.0015849625007211565,False
528,f4734213e5871364894c79f826e268d4b294f222,/Users/sanika/Downloads/Master Thesis/repo_updated/pytest/testing/python/raises.py,919.0,ModificationType.MODIFY,256,139,192,9,7,47,265,4,23,12,24,27,36,112.0419249893113,171.1759500778849,2.0869565217391304,357.2367653799337,19.846486965551872,0.057058650025961624,False
529,f4734213e5871364894c79f826e268d4b294f222,/Users/sanika/Downloads/Master Thesis/repo_updated/pytest/testing/python/show_fixtures_per_test.py,322.0,ModificationType.MODIFY,180,34,164,0,0,16,180,1,12,6,12,13,18,43.01955000865388,66.60791492653966,0.5,33.30395746326983,1.8502198590705463,0.02220263830884656,False
530,f4734213e5871364894c79f826e268d4b294f222,/Users/sanika/Downloads/Master Thesis/repo_updated/pytest/testing/test_assertion.py,5153.0,ModificationType.MODIFY,1450,624,1228,12,26,181,1462,14,306,186,354,320,540,2580.063648772758,4493.841171239174,8.098039215686274,36391.30203376038,2021.7390018755768,1.4979470570797249,False
531,f4734213e5871364894c79f826e268d4b294f222,/Users/sanika/Downloads/Master Thesis/repo_updated/pytest/testing/test_assertrewrite.py,5958.0,ModificationType.MODIFY,1660,832,1314,41,38,274,1701,20,312,209,395,332,604,2671.484054182769,5058.523816533542,12.660256410256409,64042.208574703494,3557.900476372417,1.6861746055111808,False
532,f4734213e5871364894c79f826e268d4b294f222,/Users/sanika/Downloads/Master Thesis/repo_updated/pytest/testing/test_cacheprovider.py,3773.0,ModificationType.MODIFY,996,429,845,24,10,117,1020,7,76,50,88,83,138,494.49397547611574,879.7554415258757,4.052631578947368,3565.324684078549,198.07359355991935,0.2932518138419585,False
533,f4734213e5871364894c79f826e268d4b294f222,/Users/sanika/Downloads/Master Thesis/repo_updated/pytest/testing/test_capture.py,5064.0,ModificationType.MODIFY,1513,682,1277,25,13,200,1538,11,199,116,219,210,335,1557.7420472931965,2584.272248418151,6.052763819095478,15641.989563917903,868.9994202176613,0.8614240828060503,False
534,f4734213e5871364894c79f826e268d4b294f222,/Users/sanika/Downloads/Master Thesis/repo_updated/pytest/testing/test_collection.py,4935.0,ModificationType.MODIFY,1296,573,1062,40,33,157,1336,8,201,118,231,209,349,1561.8613899269644,2689.868337096228,4.597014925373134,12365.364892919973,686.9647162733319,0.896622779032076,False
535,f4734213e5871364894c79f826e268d4b294f222,/Users/sanika/Downloads/Master Thesis/repo_updated/pytest/testing/test_compat.py,513.0,ModificationType.MODIFY,207,111,150,11,0,50,218,5,26,19,36,31,55,133.82107314610522,272.4807970712782,3.4615384615384617,943.202759092886,52.400153282938106,0.09082693235709273,False
536,f4734213e5871364894c79f826e268d4b294f222,/Users/sanika/Downloads/Master Thesis/repo_updated/pytest/testing/test_config.py,6057.0,ModificationType.MODIFY,1457,730,1242,11,6,188,1468,10,292,166,329,302,495,2424.648052141839,4078.0103459659135,5.633561643835616,22973.722668198385,1276.3179260110217,1.359336781988638,False
537,f4734213e5871364894c79f826e268d4b294f222,/Users/sanika/Downloads/Master Thesis/repo_updated/pytest/testing/test_conftest.py,2848.0,ModificationType.MODIFY,652,304,544,16,6,88,668,6,89,51,101,95,152,591.8500503603364,998.618052466304,3.4044943820224716,3399.789549407755,188.87719718931967,0.3328726841554347,False
538,f4734213e5871364894c79f826e268d4b294f222,/Users/sanika/Downloads/Master Thesis/repo_updated/pytest/testing/test_doctest.py,3714.0,ModificationType.MODIFY,1455,414,1257,16,76,112,1471,5,41,23,46,46,69,231.26927266377825,381.12577496793386,2.804878048780488,1069.0113200320095,59.3895177795561,0.1270419249893113,False
539,f4734213e5871364894c79f826e268d4b294f222,/Users/sanika/Downloads/Master Thesis/repo_updated/pytest/testing/test_junitxml.py,5657.0,ModificationType.MODIFY,1523,757,1297,19,12,193,1542,12,193,117,230,205,347,1508.3637582013935,2664.7795945283897,7.150259067357513,19053.86445828589,1058.5480254603274,0.8882598648427965,False
540,f4734213e5871364894c79f826e268d4b294f222,/Users/sanika/Downloads/Master Thesis/repo_updated/pytest/testing/test_mark.py,3090.0,ModificationType.MODIFY,1020,354,843,12,15,144,1032,8,134,77,144,142,221,970.8559515213416,1580.0941134105346,4.298507462686567,6792.0463382422995,377.3359076801278,0.5266980378035117,False
541,f4734213e5871364894c79f826e268d4b294f222,/Users/sanika/Downloads/Master Thesis/repo_updated/pytest/testing/test_meta.py,90.0,ModificationType.ADD,35,12,22,4,5,6,39,1,2,1,2,3,3,2.0,4.754887502163468,0.5,2.3774437510817346,0.1320802083934297,0.0015849625007211565,False
542,f4734213e5871364894c79f826e268d4b294f222,/Users/sanika/Downloads/Master Thesis/repo_updated/pytest/testing/test_nose.py,637.0,ModificationType.MODIFY,424,94,331,4,0,89,428,1,5,5,5,6,10,11.60964047443681,25.849625007211557,0.5,12.924812503605779,0.7180451390892101,0.00861654166907052,False
543,f4734213e5871364894c79f826e268d4b294f222,/Users/sanika/Downloads/Master Thesis/repo_updated/pytest/testing/test_parseopt.py,2315.0,ModificationType.MODIFY,334,251,279,10,4,40,344,5,127,74,143,132,217,899.1725956945018,1528.6335239007847,2.81496062992126,4303.0431873585085,239.05795485325038,0.5095445079669282,False
544,f4734213e5871364894c79f826e268d4b294f222,/Users/sanika/Downloads/Master Thesis/repo_updated/pytest/testing/test_pastebin.py,697.0,ModificationType.MODIFY,184,100,137,2,15,30,186,6,38,20,39,44,59,214.93102051518318,322.10646549960046,3.0789473684210527,991.7488543014017,55.09715857230009,0.10736882183320018,False
545,f4734213e5871364894c79f826e268d4b294f222,/Users/sanika/Downloads/Master Thesis/repo_updated/pytest/testing/test_pdb.py,4048.0,ModificationType.MODIFY,1293,570,1093,25,15,163,1318,10,195,123,241,205,364,1516.6486921300477,2795.3307562199825,6.17948717948718,17273.710570487587,959.6505872493103,0.931776918739994,False
546,f4734213e5871364894c79f826e268d4b294f222,/Users/sanika/Downloads/Master Thesis/repo_updated/pytest/testing/test_pytester.py,2994.0,ModificationType.MODIFY,722,423,573,19,0,135,741,12,172,101,199,184,300,1320.3370878174146,2257.068586817104,6.941860465116278,15668.255189881524,870.4586216600846,0.7523561956057013,False
547,f4734213e5871364894c79f826e268d4b294f222,/Users/sanika/Downloads/Master Thesis/repo_updated/pytest/testing/test_reports.py,1843.0,ModificationType.MODIFY,466,257,367,18,25,50,484,7,126,86,171,133,257,898.7887548153927,1813.2075859238055,4.75,8612.736033138077,478.4853351743376,0.6044025286412685,False
548,f4734213e5871364894c79f826e268d4b294f222,/Users/sanika/Downloads/Master Thesis/repo_updated/pytest/testing/test_runner.py,3446.0,ModificationType.MODIFY,1043,504,840,53,9,147,1096,9,180,112,198,189,310,1377.0628823523223,2344.2951515085324,4.95,11604.260999967237,644.6811666648464,0.7814317171695108,False
549,f4734213e5871364894c79f826e268d4b294f222,/Users/sanika/Downloads/Master Thesis/repo_updated/pytest/testing/test_runner_xunit.py,463.0,ModificationType.MODIFY,295,56,236,0,4,54,295,2,9,5,10,11,15,30.52932501298081,51.89147427955947,1.1111111111111112,57.657193643954976,3.203177424664165,0.01729715809318649,False
550,f4734213e5871364894c79f826e268d4b294f222,/Users/sanika/Downloads/Master Thesis/repo_updated/pytest/testing/test_setuponly.py,572.0,ModificationType.RENAME,294,64,250,0,0,43,294,1,20,10,20,21,30,86.43856189774725,131.7695226833628,0.5,65.8847613416814,3.660264518982301,0.04392317422778761,False
551,f4734213e5871364894c79f826e268d4b294f222,/Users/sanika/Downloads/Master Thesis/repo_updated/pytest/testing/test_setupplan.py,43.0,ModificationType.RENAME,110,30,77,3,13,16,113,4,21,15,30,25,45,100.23866587835396,208.9735285398626,2.8571428571428568,597.0672243996074,33.17040135553375,0.06965784284662087,False
552,f4734213e5871364894c79f826e268d4b294f222,/Users/sanika/Downloads/Master Thesis/repo_updated/pytest/testing/test_skipping.py,3068.0,ModificationType.MODIFY,1178,367,1042,6,15,115,1184,9,94,51,95,103,146,644.6606770706788,976.22907696875,4.547872340425532,4439.7652170653255,246.65362317029587,0.3254096923229167,False
553,f4734213e5871364894c79f826e268d4b294f222,/Users/sanika/Downloads/Master Thesis/repo_updated/pytest/testing/test_stepwise.py,645.0,ModificationType.MODIFY,219,78,157,11,5,46,230,3,24,20,34,27,54,114.79398751947123,256.7639251168273,2.125,545.6233408732581,30.31240782629212,0.08558797503894246,False
554,f4734213e5871364894c79f826e268d4b294f222,/Users/sanika/Downloads/Master Thesis/repo_updated/pytest/testing/test_terminal.py,6100.0,ModificationType.MODIFY,1943,715,1694,26,18,214,1969,12,185,120,237,197,357,1436.3251202041715,2721.0724995459263,7.686486486486486,20915.486996509768,1161.971499806098,0.9070241665153088,False
555,f4734213e5871364894c79f826e268d4b294f222,/Users/sanika/Downloads/Master Thesis/repo_updated/pytest/testing/test_tmpdir.py,1770.0,ModificationType.MODIFY,442,244,305,14,16,103,456,11,68,45,75,79,120,452.00122101003336,756.4536897812525,6.066176470588236,4588.781574040686,254.932309668927,0.2521512299270841,False
556,f4734213e5871364894c79f826e268d4b294f222,/Users/sanika/Downloads/Master Thesis/repo_updated/pytest/testing/test_unittest.py,2040.0,ModificationType.MODIFY,1098,241,925,5,10,155,1103,7,46,25,49,53,74,273.7353344330258,423.86611363767685,3.728260869565217,1580.283445410034,87.79352474500189,0.14128870454589226,False
557,f4734213e5871364894c79f826e268d4b294f222,/Users/sanika/Downloads/Master Thesis/repo_updated/pytest/testing/test_warnings.py,1706.0,ModificationType.MODIFY,601,196,481,2,23,85,603,8,63,36,72,71,108,400.5686351804948,664.1726889065056,4.571428571428571,3036.21800642974,168.67877813498555,0.22139089630216852,False
558,82e9013e73ca6da796ff85627875936887ba213e,/Users/sanika/Downloads/Master Thesis/repo_updated/pytest/testing/test_cacheprovider.py,2024.0,ModificationType.MODIFY,996,429,845,24,10,117,1020,7,76,50,88,83,138,494.49397547611574,879.7554415258757,4.052631578947368,3565.324684078549,198.07359355991935,0.2932518138419585,False
559,82e9013e73ca6da796ff85627875936887ba213e,/Users/sanika/Downloads/Master Thesis/repo_updated/pytest/src/_pytest/cacheprovider.py,2024.0,ModificationType.MODIFY,456,277,329,12,42,72,468,13,85,50,97,98,147,592.903945907539,972.3623470849358,7.417647058823531,7212.640703965319,400.7022613314065,0.3241207823616453,False
560,82e9013e73ca6da796ff85627875936887ba213e,/Users/sanika/Downloads/Master Thesis/repo_updated/pytest/testing/test_cacheprovider.py,3806.0,ModificationType.MODIFY,996,429,845,24,10,117,1020,7,76,50,88,83,138,494.49397547611574,879.7554415258757,4.052631578947368,3565.324684078549,198.07359355991935,0.2932518138419585,False
561,8683293031afd812f23c7bfe5e6ddcc9ef092b00,/Users/sanika/Downloads/Master Thesis/repo_updated/pytest/testing/test_capture.py,3433.0,ModificationType.MODIFY,1513,682,1277,25,13,200,1538,11,199,116,219,210,335,1557.7420472931965,2584.272248418151,6.052763819095478,15641.989563917903,868.9994202176613,0.8614240828060503,False
562,8683293031afd812f23c7bfe5e6ddcc9ef092b00,/Users/sanika/Downloads/Master Thesis/repo_updated/pytest/src/_pytest/capture.py,3433.0,ModificationType.MODIFY,819,519,539,24,98,155,843,15,96,57,106,111,163,690.7597590033588,1107.4897862150674,8.28125,9171.399792093527,509.5222106718626,0.3691632620716892,False
563,98fc9377d93771c8b877d37c812d10bd789396e0,/Users/sanika/Downloads/Master Thesis/repo_updated/pytest/testing/test_doctest.py,2603.0,ModificationType.MODIFY,1455,414,1257,16,76,112,1471,5,41,23,46,46,69,231.26927266377825,381.12577496793386,2.804878048780488,1069.0113200320095,59.3895177795561,0.1270419249893113,False
564,98fc9377d93771c8b877d37c812d10bd789396e0,/Users/sanika/Downloads/Master Thesis/repo_updated/pytest/src/_pytest/doctest.py,2603.0,ModificationType.MODIFY,669,365,481,22,61,110,691,15,103,63,122,118,185,747.3129132339992,1273.2889641319407,8.88349514563107,11311.256331851706,628.403129547317,0.4244296547106469,False
565,98fc9377d93771c8b877d37c812d10bd789396e0,/Users/sanika/Downloads/Master Thesis/repo_updated/pytest/testing/test_pdb.py,4048.0,ModificationType.MODIFY,1293,570,1093,25,15,163,1318,10,195,123,241,205,364,1516.6486921300477,2795.3307562199825,6.17948717948718,17273.710570487587,959.6505872493103,0.931776918739994,False
566,215be88fed6816db31cd57e638804c69caab423a,/Users/sanika/Downloads/Master Thesis/repo_updated/pytest/testing/test_setuponly.py,378.0,ModificationType.MODIFY,294,64,250,0,0,43,294,1,20,10,20,21,30,86.43856189774725,131.7695226833628,0.5,65.8847613416814,3.660264518982301,0.04392317422778761,False
567,215be88fed6816db31cd57e638804c69caab423a,/Users/sanika/Downloads/Master Thesis/repo_updated/pytest/src/_pytest/setuponly.py,378.0,ModificationType.MODIFY,78,46,62,3,0,14,81,3,8,4,8,11,12,28.754887502163466,41.51317942364757,1.5,62.269769135471364,3.4594316186372978,0.013837726474549191,False
568,215be88fed6816db31cd57e638804c69caab423a,/Users/sanika/Downloads/Master Thesis/repo_updated/pytest/testing/test_warnings.py,615.0,ModificationType.MODIFY,601,196,481,2,23,85,603,8,63,36,72,71,108,400.5686351804948,664.1726889065056,4.571428571428571,3036.21800642974,168.67877813498555,0.22139089630216852,False
569,215be88fed6816db31cd57e638804c69caab423a,/Users/sanika/Downloads/Master Thesis/repo_updated/pytest/src/_pytest/warnings.py,615.0,ModificationType.MODIFY,156,79,106,5,16,28,161,5,14,8,15,19,23,64.91260938324325,97.70233280920246,2.6785714285714284,261.7026771675066,14.539037620417032,0.03256744426973415,False
570,bae22e1fdd57b33d118d1912878466360477fc1b,/Users/sanika/Downloads/Master Thesis/repo_updated/pytest/testing/test_pytester.py,5898.0,ModificationType.MODIFY,722,423,573,19,0,135,741,12,172,101,199,184,300,1320.3370878174146,2257.068586817104,6.941860465116278,15668.255189881524,870.4586216600846,0.7523561956057013,False
571,bae22e1fdd57b33d118d1912878466360477fc1b,/Users/sanika/Downloads/Master Thesis/repo_updated/pytest/src/_pytest/pytester.py,5898.0,ModificationType.MODIFY,1508,847,911,44,250,301,1552,14,148,88,169,162,257,1120.302067021891,1886.3414507413486,7.993243243243242,15077.986055587939,837.6658919771077,0.6287804835804495,False
572,5e7b2ae704da84db5e9d4a786ebe1efe1997f9ff,/Users/sanika/Downloads/Master Thesis/repo_updated/pytest/testing/test_doctest.py,2613.0,ModificationType.MODIFY,1455,414,1257,16,76,112,1471,5,41,23,46,46,69,231.26927266377825,381.12577496793386,2.804878048780488,1069.0113200320095,59.3895177795561,0.1270419249893113,False
573,5e7b2ae704da84db5e9d4a786ebe1efe1997f9ff,/Users/sanika/Downloads/Master Thesis/repo_updated/pytest/src/_pytest/doctest.py,2613.0,ModificationType.MODIFY,669,365,481,22,61,110,691,15,103,63,122,118,185,747.3129132339992,1273.2889641319407,8.88349514563107,11311.256331851706,628.403129547317,0.4244296547106469,False
574,5e7b2ae704da84db5e9d4a786ebe1efe1997f9ff,/Users/sanika/Downloads/Master Thesis/repo_updated/pytest/testing/acceptance_test.py,4670.0,ModificationType.MODIFY,1289,550,1043,56,32,155,1345,10,167,93,185,177,278,1266.2978977920407,2075.994342923073,5.538922155688622,11498.771061100857,638.8206145056031,0.6919981143076911,False
575,4af89bba9d9df9f5548f5ac06fd59b40c5a8350f,/Users/sanika/Downloads/Master Thesis/repo_updated/pytest/testing/test_terminal.py,6093.0,ModificationType.MODIFY,1943,715,1694,26,18,214,1969,12,185,120,237,197,357,1436.3251202041715,2721.0724995459263,7.686486486486486,20915.486996509768,1161.971499806098,0.9070241665153088,False
576,4af89bba9d9df9f5548f5ac06fd59b40c5a8350f,/Users/sanika/Downloads/Master Thesis/repo_updated/pytest/src/_pytest/terminal.py,6093.0,ModificationType.MODIFY,1168,838,957,57,25,144,1225,19,348,224,416,367,640,3018.854959310786,5452.567201819657,11.35632183908046,61921.107993078396,3440.0615551710216,1.817522400606552,False
577,4af89bba9d9df9f5548f5ac06fd59b40c5a8350f,/Users/sanika/Downloads/Master Thesis/repo_updated/pytest/testing/test_pdb.py,4048.0,ModificationType.MODIFY,1293,570,1093,25,15,163,1318,10,195,123,241,205,364,1516.6486921300477,2795.3307562199825,6.17948717948718,17273.710570487587,959.6505872493103,0.931776918739994,False
578,4af89bba9d9df9f5548f5ac06fd59b40c5a8350f,/Users/sanika/Downloads/Master Thesis/repo_updated/pytest/testing/test_terminal.py,6632.0,ModificationType.MODIFY,1943,715,1694,26,18,214,1969,12,185,120,237,197,357,1436.3251202041715,2721.0724995459263,7.686486486486486,20915.486996509768,1161.971499806098,0.9070241665153088,False
579,b079dc2dbeb5f117de8c18e41a25cf44531f6bb2,/Users/sanika/Downloads/Master Thesis/repo_updated/pytest/testing/test_pdb.py,4048.0,ModificationType.MODIFY,1293,570,1093,25,15,163,1318,10,195,123,241,205,364,1516.6486921300477,2795.3307562199825,6.17948717948718,17273.710570487587,959.6505872493103,0.931776918739994,False
580,f0c2b070c5be690ab2285f44cae51b521cf53e52,/Users/sanika/Downloads/Master Thesis/repo_updated/pytest/testing/test_pdb.py,4048.0,ModificationType.MODIFY,1293,570,1093,25,15,163,1318,10,195,123,241,205,364,1516.6486921300477,2795.3307562199825,6.17948717948718,17273.710570487587,959.6505872493103,0.931776918739994,False
581,046aa0b6e93db59dbb67f6909415215d038fd02b,/Users/sanika/Downloads/Master Thesis/repo_updated/pytest/testing/example_scripts/collect/package_infinite_recursion/__init__.pyi,5069.0,ModificationType.MODIFY,0,0,0,0,0,0,0,0,0,0,0,0,0,0.0,0.0,0.0,0.0,0.0,0.0,False
582,046aa0b6e93db59dbb67f6909415215d038fd02b,/Users/sanika/Downloads/Master Thesis/repo_updated/pytest/testing/example_scripts/collect/package_infinite_recursion/tests/__init__.py,5069.0,ModificationType.MODIFY,0,0,0,0,0,0,0,0,0,0,0,0,0,0.0,0.0,0.0,0.0,0.0,0.0,False
583,046aa0b6e93db59dbb67f6909415215d038fd02b,/Users/sanika/Downloads/Master Thesis/repo_updated/pytest/testing/example_scripts/collect/collect_init_tests/tests/__init__.py,5069.0,ModificationType.MODIFY,2,2,2,0,0,0,2,0,0,0,0,0,0,0.0,0.0,0.0,0.0,0.0,0.0,False
584,046aa0b6e93db59dbb67f6909415215d038fd02b,/Users/sanika/Downloads/Master Thesis/repo_updated/pytest/testing/example_scripts/collect/package_init_given_as_arg/pkg/__init__.py,5069.0,ModificationType.MODIFY,0,0,0,0,0,0,0,0,0,0,0,0,0,0.0,0.0,0.0,0.0,0.0,0.0,False
585,046aa0b6e93db59dbb67f6909415215d038fd02b,/Users/sanika/Downloads/Master Thesis/repo_updated/pytest/testing/example_scripts/conftest_usageerror/__init__.pyi,5069.0,ModificationType.MODIFY,0,0,0,0,0,0,0,0,0,0,0,0,0,0.0,0.0,0.0,0.0,0.0,0.0,False
586,046aa0b6e93db59dbb67f6909415215d038fd02b,/Users/sanika/Downloads/Master Thesis/repo_updated/pytest/testing/example_scripts/marks/marks_considered_keywords/__init__.pyi,5069.0,ModificationType.MODIFY,0,0,0,0,0,0,0,0,0,0,0,0,0,0.0,0.0,0.0,0.0,0.0,0.0,False
587,046aa0b6e93db59dbb67f6909415215d038fd02b,/Users/sanika/Downloads/Master Thesis/repo_updated/pytest/testing/example_scripts/config/collect_pytest_prefix/__init__.pyi,5069.0,ModificationType.MODIFY,0,0,0,0,0,0,0,0,0,0,0,0,0,0.0,0.0,0.0,0.0,0.0,0.0,False
588,046aa0b6e93db59dbb67f6909415215d038fd02b,/Users/sanika/Downloads/Master Thesis/repo_updated/pytest/testing/example_scripts/issue88_initial_file_multinodes/__init__.pyi,5069.0,ModificationType.MODIFY,0,0,0,0,0,0,0,0,0,0,0,0,0,0.0,0.0,0.0,0.0,0.0,0.0,False
589,046aa0b6e93db59dbb67f6909415215d038fd02b,/Users/sanika/Downloads/Master Thesis/repo_updated/pytest/testing/example_scripts/fixtures/fill_fixtures/test_extend_fixture_conftest_conftest/__init__.pyi,5069.0,ModificationType.MODIFY,0,0,0,0,0,0,0,0,0,0,0,0,0,0.0,0.0,0.0,0.0,0.0,0.0,False
590,046aa0b6e93db59dbb67f6909415215d038fd02b,/Users/sanika/Downloads/Master Thesis/repo_updated/pytest/testing/example_scripts/fixtures/fill_fixtures/test_extend_fixture_conftest_conftest/pkg/__init__.py,5069.0,ModificationType.MODIFY,0,0,0,0,0,0,0,0,0,0,0,0,0,0.0,0.0,0.0,0.0,0.0,0.0,False
591,046aa0b6e93db59dbb67f6909415215d038fd02b,/Users/sanika/Downloads/Master Thesis/repo_updated/pytest/testing/example_scripts/fixtures/fill_fixtures/test_extend_fixture_conftest_module/__init__.pyi,5069.0,ModificationType.MODIFY,0,0,0,0,0,0,0,0,0,0,0,0,0,0.0,0.0,0.0,0.0,0.0,0.0,False
592,046aa0b6e93db59dbb67f6909415215d038fd02b,/Users/sanika/Downloads/Master Thesis/repo_updated/pytest/testing/example_scripts/fixtures/fill_fixtures/test_conftest_funcargs_only_available_in_subdir/sub1/__init__.py,5069.0,ModificationType.MODIFY,0,0,0,0,0,0,0,0,0,0,0,0,0,0.0,0.0,0.0,0.0,0.0,0.0,False
593,046aa0b6e93db59dbb67f6909415215d038fd02b,/Users/sanika/Downloads/Master Thesis/repo_updated/pytest/testing/example_scripts/fixtures/fill_fixtures/test_conftest_funcargs_only_available_in_subdir/sub2/__init__.py,5069.0,ModificationType.MODIFY,0,0,0,0,0,0,0,0,0,0,0,0,0,0.0,0.0,0.0,0.0,0.0,0.0,False
594,046aa0b6e93db59dbb67f6909415215d038fd02b,/Users/sanika/Downloads/Master Thesis/repo_updated/pytest/testing/example_scripts/fixtures/custom_item/__init__.pyi,5069.0,ModificationType.MODIFY,0,0,0,0,0,0,0,0,0,0,0,0,0,0.0,0.0,0.0,0.0,0.0,0.0,False
595,046aa0b6e93db59dbb67f6909415215d038fd02b,/Users/sanika/Downloads/Master Thesis/repo_updated/pytest/testing/example_scripts/fixtures/custom_item/foo/__init__.py,5069.0,ModificationType.MODIFY,0,0,0,0,0,0,0,0,0,0,0,0,0,0.0,0.0,0.0,0.0,0.0,0.0,False
596,046aa0b6e93db59dbb67f6909415215d038fd02b,/Users/sanika/Downloads/Master Thesis/repo_updated/pytest/doc/en/example/nonpython/__init__.py,5069.0,ModificationType.MODIFY,0,0,0,0,0,0,0,0,0,0,0,0,0,0.0,0.0,0.0,0.0,0.0,0.0,False
597,046aa0b6e93db59dbb67f6909415215d038fd02b,/Users/sanika/Downloads/Master Thesis/repo_updated/pytest/src/pytest/__init__.py,5069.0,ModificationType.MODIFY,99,48,90,1,3,5,100,0,0,0,0,0,0,0.0,0.0,0.0,0.0,0.0,0.0,False
598,046aa0b6e93db59dbb67f6909415215d038fd02b,/Users/sanika/Downloads/Master Thesis/repo_updated/pytest/src/_pytest/__init__.py,5069.0,ModificationType.MODIFY,8,5,5,2,0,1,10,0,0,0,0,0,0,0.0,0.0,0.0,0.0,0.0,0.0,False
599,046aa0b6e93db59dbb67f6909415215d038fd02b,/Users/sanika/Downloads/Master Thesis/repo_updated/pytest/src/_pytest/config/__init__.py,5069.0,ModificationType.MODIFY,1217,716,841,84,126,174,1301,14,185,118,215,199,333,1446.608539104324,2542.995998641035,8.135135135135135,20687.616097052745,1149.3120053918194,0.847665332880345,False
600,046aa0b6e93db59dbb67f6909415215d038fd02b,/Users/sanika/Downloads/Master Thesis/repo_updated/pytest/src/_pytest/mark/__init__.py,5069.0,ModificationType.MODIFY,160,89,115,0,13,31,160,7,15,11,17,22,28,78.25484338853101,124.86408532184431,3.966666666666667,495.29420510998256,27.516344728332356,0.04162136177394811,False
601,046aa0b6e93db59dbb67f6909415215d038fd02b,/Users/sanika/Downloads/Master Thesis/repo_updated/pytest/src/_pytest/_code/__init__.py,5069.0,ModificationType.MODIFY,10,10,9,9,0,0,19,0,0,0,0,0,0,0.0,0.0,0.0,0.0,0.0,0.0,False
602,046aa0b6e93db59dbb67f6909415215d038fd02b,/Users/sanika/Downloads/Master Thesis/repo_updated/pytest/src/_pytest/assertion/__init__.py,5069.0,ModificationType.MODIFY,173,84,99,8,29,36,181,5,12,7,13,17,20,54.62919048309069,81.7492568250068,2.708333333333333,221.40423723439343,12.300235401910744,0.027249752275002263,False
603,046aa0b6e93db59dbb67f6909415215d038fd02b,/Users/sanika/Downloads/Master Thesis/repo_updated/pytest/src/_pytest/_io/__init__.py,5069.0,ModificationType.MODIFY,3,1,1,3,0,0,6,0,0,0,0,0,0,0.0,0.0,0.0,0.0,0.0,0.0,False
604,2f589a9769e12e71253624372e7eeb7076b7549b,/Users/sanika/Downloads/Master Thesis/repo_updated/pytest/testing/test_pytester.py,5896.0,ModificationType.MODIFY,722,423,573,19,0,135,741,12,172,101,199,184,300,1320.3370878174146,2257.068586817104,6.941860465116278,15668.255189881524,870.4586216600846,0.7523561956057013,False
605,2f589a9769e12e71253624372e7eeb7076b7549b,/Users/sanika/Downloads/Master Thesis/repo_updated/pytest/src/_pytest/pytester.py,5896.0,ModificationType.MODIFY,1508,847,911,44,250,301,1552,14,148,88,169,162,257,1120.302067021891,1886.3414507413486,7.993243243243242,15077.986055587939,837.6658919771077,0.6287804835804495,False
606,2f589a9769e12e71253624372e7eeb7076b7549b,/Users/sanika/Downloads/Master Thesis/repo_updated/pytest/testing/test_config.py,6056.0,ModificationType.MODIFY,1457,730,1242,11,6,188,1468,10,292,166,329,302,495,2424.648052141839,4078.0103459659135,5.633561643835616,22973.722668198385,1276.3179260110217,1.359336781988638,False
607,2f589a9769e12e71253624372e7eeb7076b7549b,/Users/sanika/Downloads/Master Thesis/repo_updated/pytest/testing/test_runner.py,3442.0,ModificationType.MODIFY,1043,504,840,53,9,147,1096,9,180,112,198,189,310,1377.0628823523223,2344.2951515085324,4.95,11604.260999967237,644.6811666648464,0.7814317171695108,False
608,c71a2c9f80c230cd1dd4813d833db92fb88c2b60,/Users/sanika/Downloads/Master Thesis/repo_updated/pytest/testing/example_scripts/collect/package_infinite_recursion/__init__.pyi,5069.0,ModificationType.MODIFY,0,0,0,0,0,0,0,0,0,0,0,0,0,0.0,0.0,0.0,0.0,0.0,0.0,False
609,c71a2c9f80c230cd1dd4813d833db92fb88c2b60,/Users/sanika/Downloads/Master Thesis/repo_updated/pytest/testing/example_scripts/collect/package_infinite_recursion/tests/__init__.py,5069.0,ModificationType.MODIFY,0,0,0,0,0,0,0,0,0,0,0,0,0,0.0,0.0,0.0,0.0,0.0,0.0,False
610,c71a2c9f80c230cd1dd4813d833db92fb88c2b60,/Users/sanika/Downloads/Master Thesis/repo_updated/pytest/testing/example_scripts/collect/collect_init_tests/tests/__init__.py,5069.0,ModificationType.MODIFY,2,2,2,0,0,0,2,0,0,0,0,0,0,0.0,0.0,0.0,0.0,0.0,0.0,False
611,c71a2c9f80c230cd1dd4813d833db92fb88c2b60,/Users/sanika/Downloads/Master Thesis/repo_updated/pytest/testing/example_scripts/collect/package_init_given_as_arg/pkg/__init__.py,5069.0,ModificationType.MODIFY,0,0,0,0,0,0,0,0,0,0,0,0,0,0.0,0.0,0.0,0.0,0.0,0.0,False
612,c71a2c9f80c230cd1dd4813d833db92fb88c2b60,/Users/sanika/Downloads/Master Thesis/repo_updated/pytest/testing/example_scripts/conftest_usageerror/__init__.pyi,5069.0,ModificationType.MODIFY,0,0,0,0,0,0,0,0,0,0,0,0,0,0.0,0.0,0.0,0.0,0.0,0.0,False
613,c71a2c9f80c230cd1dd4813d833db92fb88c2b60,/Users/sanika/Downloads/Master Thesis/repo_updated/pytest/testing/example_scripts/marks/marks_considered_keywords/__init__.pyi,5069.0,ModificationType.MODIFY,0,0,0,0,0,0,0,0,0,0,0,0,0,0.0,0.0,0.0,0.0,0.0,0.0,False
614,c71a2c9f80c230cd1dd4813d833db92fb88c2b60,/Users/sanika/Downloads/Master Thesis/repo_updated/pytest/testing/example_scripts/config/collect_pytest_prefix/__init__.pyi,5069.0,ModificationType.MODIFY,0,0,0,0,0,0,0,0,0,0,0,0,0,0.0,0.0,0.0,0.0,0.0,0.0,False
615,c71a2c9f80c230cd1dd4813d833db92fb88c2b60,/Users/sanika/Downloads/Master Thesis/repo_updated/pytest/testing/example_scripts/issue88_initial_file_multinodes/__init__.pyi,5069.0,ModificationType.MODIFY,0,0,0,0,0,0,0,0,0,0,0,0,0,0.0,0.0,0.0,0.0,0.0,0.0,False
616,c71a2c9f80c230cd1dd4813d833db92fb88c2b60,/Users/sanika/Downloads/Master Thesis/repo_updated/pytest/testing/example_scripts/fixtures/fill_fixtures/test_extend_fixture_conftest_conftest/__init__.pyi,5069.0,ModificationType.MODIFY,0,0,0,0,0,0,0,0,0,0,0,0,0,0.0,0.0,0.0,0.0,0.0,0.0,False
617,c71a2c9f80c230cd1dd4813d833db92fb88c2b60,/Users/sanika/Downloads/Master Thesis/repo_updated/pytest/testing/example_scripts/fixtures/fill_fixtures/test_extend_fixture_conftest_conftest/pkg/__init__.py,5069.0,ModificationType.MODIFY,0,0,0,0,0,0,0,0,0,0,0,0,0,0.0,0.0,0.0,0.0,0.0,0.0,False
618,c71a2c9f80c230cd1dd4813d833db92fb88c2b60,/Users/sanika/Downloads/Master Thesis/repo_updated/pytest/testing/example_scripts/fixtures/fill_fixtures/test_extend_fixture_conftest_module/__init__.pyi,5069.0,ModificationType.MODIFY,0,0,0,0,0,0,0,0,0,0,0,0,0,0.0,0.0,0.0,0.0,0.0,0.0,False
619,c71a2c9f80c230cd1dd4813d833db92fb88c2b60,/Users/sanika/Downloads/Master Thesis/repo_updated/pytest/testing/example_scripts/fixtures/fill_fixtures/test_conftest_funcargs_only_available_in_subdir/sub1/__init__.py,5069.0,ModificationType.MODIFY,0,0,0,0,0,0,0,0,0,0,0,0,0,0.0,0.0,0.0,0.0,0.0,0.0,False
620,c71a2c9f80c230cd1dd4813d833db92fb88c2b60,/Users/sanika/Downloads/Master Thesis/repo_updated/pytest/testing/example_scripts/fixtures/fill_fixtures/test_conftest_funcargs_only_available_in_subdir/sub2/__init__.py,5069.0,ModificationType.MODIFY,0,0,0,0,0,0,0,0,0,0,0,0,0,0.0,0.0,0.0,0.0,0.0,0.0,False
621,c71a2c9f80c230cd1dd4813d833db92fb88c2b60,/Users/sanika/Downloads/Master Thesis/repo_updated/pytest/testing/example_scripts/fixtures/custom_item/__init__.pyi,5069.0,ModificationType.MODIFY,0,0,0,0,0,0,0,0,0,0,0,0,0,0.0,0.0,0.0,0.0,0.0,0.0,False
622,c71a2c9f80c230cd1dd4813d833db92fb88c2b60,/Users/sanika/Downloads/Master Thesis/repo_updated/pytest/testing/example_scripts/fixtures/custom_item/foo/__init__.py,5069.0,ModificationType.MODIFY,0,0,0,0,0,0,0,0,0,0,0,0,0,0.0,0.0,0.0,0.0,0.0,0.0,False
623,c71a2c9f80c230cd1dd4813d833db92fb88c2b60,/Users/sanika/Downloads/Master Thesis/repo_updated/pytest/doc/en/example/nonpython/__init__.py,5069.0,ModificationType.MODIFY,0,0,0,0,0,0,0,0,0,0,0,0,0,0.0,0.0,0.0,0.0,0.0,0.0,False
624,c71a2c9f80c230cd1dd4813d833db92fb88c2b60,/Users/sanika/Downloads/Master Thesis/repo_updated/pytest/src/pytest/__init__.py,5069.0,ModificationType.MODIFY,99,48,90,1,3,5,100,0,0,0,0,0,0,0.0,0.0,0.0,0.0,0.0,0.0,False
625,c71a2c9f80c230cd1dd4813d833db92fb88c2b60,/Users/sanika/Downloads/Master Thesis/repo_updated/pytest/src/_pytest/__init__.py,5069.0,ModificationType.MODIFY,8,5,5,2,0,1,10,0,0,0,0,0,0,0.0,0.0,0.0,0.0,0.0,0.0,False
626,c71a2c9f80c230cd1dd4813d833db92fb88c2b60,/Users/sanika/Downloads/Master Thesis/repo_updated/pytest/src/_pytest/config/__init__.py,5069.0,ModificationType.MODIFY,1217,716,841,84,126,174,1301,14,185,118,215,199,333,1446.608539104324,2542.995998641035,8.135135135135135,20687.616097052745,1149.3120053918194,0.847665332880345,False
627,c71a2c9f80c230cd1dd4813d833db92fb88c2b60,/Users/sanika/Downloads/Master Thesis/repo_updated/pytest/src/_pytest/mark/__init__.py,5069.0,ModificationType.MODIFY,160,89,115,0,13,31,160,7,15,11,17,22,28,78.25484338853101,124.86408532184431,3.966666666666667,495.29420510998256,27.516344728332356,0.04162136177394811,False
628,c71a2c9f80c230cd1dd4813d833db92fb88c2b60,/Users/sanika/Downloads/Master Thesis/repo_updated/pytest/src/_pytest/_code/__init__.py,5069.0,ModificationType.MODIFY,10,10,9,9,0,0,19,0,0,0,0,0,0,0.0,0.0,0.0,0.0,0.0,0.0,False
629,c71a2c9f80c230cd1dd4813d833db92fb88c2b60,/Users/sanika/Downloads/Master Thesis/repo_updated/pytest/src/_pytest/assertion/__init__.py,5069.0,ModificationType.MODIFY,173,84,99,8,29,36,181,5,12,7,13,17,20,54.62919048309069,81.7492568250068,2.708333333333333,221.40423723439343,12.300235401910744,0.027249752275002263,False
630,c71a2c9f80c230cd1dd4813d833db92fb88c2b60,/Users/sanika/Downloads/Master Thesis/repo_updated/pytest/src/_pytest/_io/__init__.py,5069.0,ModificationType.MODIFY,3,1,1,3,0,0,6,0,0,0,0,0,0,0.0,0.0,0.0,0.0,0.0,0.0,False
631,52b85f6f1ae44bb35c0292817696daf092858b98,/Users/sanika/Downloads/Master Thesis/repo_updated/pytest/testing/test_recwarn.py,983.0,ModificationType.MODIFY,386,256,301,16,9,68,402,4,59,35,69,63,104,355.07593991234864,621.6371120439914,2.3389830508474576,1453.9986688486576,80.77770382492542,0.20721237068133044,False
632,52b85f6f1ae44bb35c0292817696daf092858b98,/Users/sanika/Downloads/Master Thesis/repo_updated/pytest/src/_pytest/recwarn.py,983.0,ModificationType.MODIFY,264,131,164,11,41,46,275,6,38,22,40,44,62,214.93102051518318,338.48476035551244,3.1578947368421053,1068.899243227934,59.38329129044078,0.11282825345183747,False
633,1371b01f78afcfb836ef21a81cdb9b6516c1119e,/Users/sanika/Downloads/Master Thesis/repo_updated/pytest/testing/test_doctest.py,2626.0,ModificationType.MODIFY,1455,414,1257,16,76,112,1471,5,41,23,46,46,69,231.26927266377825,381.12577496793386,2.804878048780488,1069.0113200320095,59.3895177795561,0.1270419249893113,False
634,1371b01f78afcfb836ef21a81cdb9b6516c1119e,/Users/sanika/Downloads/Master Thesis/repo_updated/pytest/src/_pytest/doctest.py,2626.0,ModificationType.MODIFY,669,365,481,22,61,110,691,15,103,63,122,118,185,747.3129132339992,1273.2889641319407,8.88349514563107,11311.256331851706,628.403129547317,0.4244296547106469,False
635,db9e248b2edef4bb872858d267697e0e59fc13ac,/Users/sanika/Downloads/Master Thesis/repo_updated/pytest/testing/test_doctest.py,2613.0,ModificationType.MODIFY,1455,414,1257,16,76,112,1471,5,41,23,46,46,69,231.26927266377825,381.12577496793386,2.804878048780488,1069.0113200320095,59.3895177795561,0.1270419249893113,False
636,db9e248b2edef4bb872858d267697e0e59fc13ac,/Users/sanika/Downloads/Master Thesis/repo_updated/pytest/src/_pytest/doctest.py,2613.0,ModificationType.MODIFY,669,365,481,22,61,110,691,15,103,63,122,118,185,747.3129132339992,1273.2889641319407,8.88349514563107,11311.256331851706,628.403129547317,0.4244296547106469,False
637,db9e248b2edef4bb872858d267697e0e59fc13ac,/Users/sanika/Downloads/Master Thesis/repo_updated/pytest/testing/acceptance_test.py,4670.0,ModificationType.MODIFY,1289,550,1043,56,32,155,1345,10,167,93,185,177,278,1266.2978977920407,2075.994342923073,5.538922155688622,11498.771061100857,638.8206145056031,0.6919981143076911,False
638,b30e7bd1de30c561540c8de605a2a1f47e175b23,/Users/sanika/Downloads/Master Thesis/repo_updated/pytest/testing/test_doctest.py,2636.0,ModificationType.MODIFY,1455,414,1257,16,76,112,1471,5,41,23,46,46,69,231.26927266377825,381.12577496793386,2.804878048780488,1069.0113200320095,59.3895177795561,0.1270419249893113,False
639,b30e7bd1de30c561540c8de605a2a1f47e175b23,/Users/sanika/Downloads/Master Thesis/repo_updated/pytest/src/_pytest/doctest.py,2636.0,ModificationType.MODIFY,669,365,481,22,61,110,691,15,103,63,122,118,185,747.3129132339992,1273.2889641319407,8.88349514563107,11311.256331851706,628.403129547317,0.4244296547106469,False
640,3246d8a6e9c5ea398df3470401cc8b7f59b2f525,/Users/sanika/Downloads/Master Thesis/repo_updated/pytest/testing/test_recwarn.py,983.0,ModificationType.MODIFY,386,256,301,16,9,68,402,4,59,35,69,63,104,355.07593991234864,621.6371120439914,2.3389830508474576,1453.9986688486576,80.77770382492542,0.20721237068133044,False
641,3246d8a6e9c5ea398df3470401cc8b7f59b2f525,/Users/sanika/Downloads/Master Thesis/repo_updated/pytest/src/_pytest/recwarn.py,983.0,ModificationType.MODIFY,264,131,164,11,41,46,275,6,38,22,40,44,62,214.93102051518318,338.48476035551244,3.1578947368421053,1068.899243227934,59.38329129044078,0.11282825345183747,False
642,1984c10427adc264d7cdd1bedbb315792181c14b,/Users/sanika/Downloads/Master Thesis/repo_updated/pytest/testing/test_doctest.py,2720.0,ModificationType.MODIFY,1455,414,1257,16,76,112,1471,5,41,23,46,46,69,231.26927266377825,381.12577496793386,2.804878048780488,1069.0113200320095,59.3895177795561,0.1270419249893113,True
643,1984c10427adc264d7cdd1bedbb315792181c14b,/Users/sanika/Downloads/Master Thesis/repo_updated/pytest/src/_pytest/doctest.py,2720.0,ModificationType.MODIFY,669,365,481,22,61,110,691,15,103,63,122,118,185,747.3129132339992,1273.2889641319407,8.88349514563107,11311.256331851706,628.403129547317,0.4244296547106469,True
644,1984c10427adc264d7cdd1bedbb315792181c14b,/Users/sanika/Downloads/Master Thesis/repo_updated/pytest/testing/test_doctest.py,3715.0,ModificationType.MODIFY,1455,414,1257,16,76,112,1471,5,41,23,46,46,69,231.26927266377825,381.12577496793386,2.804878048780488,1069.0113200320095,59.3895177795561,0.1270419249893113,True
645,583c2a2f9babe67c8f2413b391416874efe91d36,/Users/sanika/Downloads/Master Thesis/repo_updated/pytest/src/_pytest/logging.py,2793.0,ModificationType.MODIFY,773,422,505,30,103,129,803,14,77,46,83,91,129,535.8455325423139,839.5055085856317,7.545454545454546,6334.450655691586,351.9139253161992,0.2798351695285439,False
646,93c8822f26c90e3b440021b26da62e6aa6d49158,/Users/sanika/Downloads/Master Thesis/repo_updated/pytest/testing/test_warnings.py,625.0,ModificationType.MODIFY,601,196,481,2,23,85,603,8,63,36,72,71,108,400.5686351804948,664.1726889065056,4.571428571428571,3036.21800642974,168.67877813498555,0.22139089630216852,False
647,93c8822f26c90e3b440021b26da62e6aa6d49158,/Users/sanika/Downloads/Master Thesis/repo_updated/pytest/src/_pytest/warnings.py,625.0,ModificationType.MODIFY,156,79,106,5,16,28,161,5,14,8,15,19,23,64.91260938324325,97.70233280920246,2.6785714285714284,261.7026771675066,14.539037620417032,0.03256744426973415,False
648,5dca7a2f4fa5e5c16935bc79c2f1da9d28886609,/Users/sanika/Downloads/Master Thesis/repo_updated/pytest/testing/test_cacheprovider.py,2046.0,ModificationType.MODIFY,996,429,845,24,10,117,1020,7,76,50,88,83,138,494.49397547611574,879.7554415258757,4.052631578947368,3565.324684078549,198.07359355991935,0.2932518138419585,False
649,5dca7a2f4fa5e5c16935bc79c2f1da9d28886609,/Users/sanika/Downloads/Master Thesis/repo_updated/pytest/src/_pytest/cacheprovider.py,2046.0,ModificationType.MODIFY,456,277,329,12,42,72,468,13,85,50,97,98,147,592.903945907539,972.3623470849358,7.417647058823531,7212.640703965319,400.7022613314065,0.3241207823616453,False
650,0267b25c66875617ed69132445820a6f82e6e2fa,/Users/sanika/Downloads/Master Thesis/repo_updated/pytest/testing/test_terminal.py,6168.0,ModificationType.MODIFY,1943,715,1694,26,18,214,1969,12,185,120,237,197,357,1436.3251202041715,2721.0724995459263,7.686486486486486,20915.486996509768,1161.971499806098,0.9070241665153088,False
651,0267b25c66875617ed69132445820a6f82e6e2fa,/Users/sanika/Downloads/Master Thesis/repo_updated/pytest/src/_pytest/terminal.py,6168.0,ModificationType.MODIFY,1168,838,957,57,25,144,1225,19,348,224,416,367,640,3018.854959310786,5452.567201819657,11.35632183908046,61921.107993078396,3440.0615551710216,1.817522400606552,False
652,1787bffda016f07b25c6dc7a2fb27e39ab920ec4,/Users/sanika/Downloads/Master Thesis/repo_updated/pytest/testing/test_capture.py,3438.0,ModificationType.MODIFY,1513,682,1277,25,13,200,1538,11,199,116,219,210,335,1557.7420472931965,2584.272248418151,6.052763819095478,15641.989563917903,868.9994202176613,0.8614240828060503,False
653,1787bffda016f07b25c6dc7a2fb27e39ab920ec4,/Users/sanika/Downloads/Master Thesis/repo_updated/pytest/src/_pytest/capture.py,3438.0,ModificationType.MODIFY,819,519,539,24,98,155,843,15,96,57,106,111,163,690.7597590033588,1107.4897862150674,8.28125,9171.399792093527,509.5222106718626,0.3691632620716892,False
654,1787bffda016f07b25c6dc7a2fb27e39ab920ec4,/Users/sanika/Downloads/Master Thesis/repo_updated/pytest/testing/test_capture.py,5074.0,ModificationType.MODIFY,1513,682,1277,25,13,200,1538,11,199,116,219,210,335,1557.7420472931965,2584.272248418151,6.052763819095478,15641.989563917903,868.9994202176613,0.8614240828060503,False
655,ba4b8c869c70f6c46b780a1e1478ec75da61417a,/Users/sanika/Downloads/Master Thesis/repo_updated/pytest/testing/test_pathlib.py,1379.0,ModificationType.MODIFY,91,45,69,0,3,18,91,3,9,6,10,12,16,33.28421251514428,57.3594000115385,1.6666666666666667,95.59900001923084,5.311055556623936,0.01911980000384617,False
656,ba4b8c869c70f6c46b780a1e1478ec75da61417a,/Users/sanika/Downloads/Master Thesis/repo_updated/pytest/src/_pytest/pathlib.py,1379.0,ModificationType.MODIFY,367,234,237,17,34,68,384,16,55,34,61,71,95,381.9747842438563,584.2259763529447,8.872727272727273,5183.677753822492,287.98209743458284,0.19474199211764828,False
657,ba4b8c869c70f6c46b780a1e1478ec75da61417a,/Users/sanika/Downloads/Master Thesis/repo_updated/pytest/testing/test_tmpdir.py,1798.0,ModificationType.MODIFY,442,244,305,14,16,103,456,11,68,45,75,79,120,452.00122101003336,756.4536897812525,6.066176470588236,4588.781574040686,254.932309668927,0.2521512299270841,False
658,1cc1ac51838f45d819fcdbfd71df79aa851dc677,/Users/sanika/Downloads/Master Thesis/repo_updated/pytest/testing/test_assertrewrite.py,5417.0,ModificationType.MODIFY,1660,832,1314,41,38,274,1701,20,312,209,395,332,604,2671.484054182769,5058.523816533542,12.660256410256409,64042.208574703494,3557.900476372417,1.6861746055111808,False
659,1cc1ac51838f45d819fcdbfd71df79aa851dc677,/Users/sanika/Downloads/Master Thesis/repo_updated/pytest/src/_pytest/assertion/rewrite.py,5417.0,ModificationType.MODIFY,1057,646,719,113,100,145,1170,18,215,134,248,233,382,1740.9201126876956,3004.119107257935,10.381395348837211,31186.94812744052,1732.608229302251,1.001373035752645,False
660,1cc1ac51838f45d819fcdbfd71df79aa851dc677,/Users/sanika/Downloads/Master Thesis/repo_updated/pytest/testing/test_doctest.py,2720.0,ModificationType.MODIFY,1455,414,1257,16,76,112,1471,5,41,23,46,46,69,231.26927266377825,381.12577496793386,2.804878048780488,1069.0113200320095,59.3895177795561,0.1270419249893113,False
661,1cc1ac51838f45d819fcdbfd71df79aa851dc677,/Users/sanika/Downloads/Master Thesis/repo_updated/pytest/src/_pytest/doctest.py,2720.0,ModificationType.MODIFY,669,365,481,22,61,110,691,15,103,63,122,118,185,747.3129132339992,1273.2889641319407,8.88349514563107,11311.256331851706,628.403129547317,0.4244296547106469,False
662,1cc1ac51838f45d819fcdbfd71df79aa851dc677,/Users/sanika/Downloads/Master Thesis/repo_updated/pytest/testing/test_nodes.py,1701.0,ModificationType.MODIFY,53,23,39,0,0,13,53,2,8,4,8,10,12,26.0,39.863137138648355,1.0,39.863137138648355,2.2146187299249087,0.013287712379549451,False
663,1cc1ac51838f45d819fcdbfd71df79aa851dc677,/Users/sanika/Downloads/Master Thesis/repo_updated/pytest/src/_pytest/nodes.py,1701.0,ModificationType.MODIFY,515,298,307,33,80,99,548,12,63,44,77,75,121,419.5881851891487,753.6870615500015,7.333333333333332,5527.038451366679,307.0576917425932,0.2512290205166672,False
664,7beb520555b7908c647c5cfa35bbfc3e48b28638,/Users/sanika/Downloads/Master Thesis/repo_updated/pytest/testing/test_pytester.py,5923.0,ModificationType.MODIFY,722,423,573,19,0,135,741,12,172,101,199,184,300,1320.3370878174146,2257.068586817104,6.941860465116278,15668.255189881524,870.4586216600846,0.7523561956057013,False
665,7beb520555b7908c647c5cfa35bbfc3e48b28638,/Users/sanika/Downloads/Master Thesis/repo_updated/pytest/src/_pytest/pytester.py,5923.0,ModificationType.MODIFY,1508,847,911,44,250,301,1552,14,148,88,169,162,257,1120.302067021891,1886.3414507413486,7.993243243243242,15077.986055587939,837.6658919771077,0.6287804835804495,False
666,7beb520555b7908c647c5cfa35bbfc3e48b28638,/Users/sanika/Downloads/Master Thesis/repo_updated/pytest/testing/test_pytester.py,3032.0,ModificationType.MODIFY,722,423,573,19,0,135,741,12,172,101,199,184,300,1320.3370878174146,2257.068586817104,6.941860465116278,15668.255189881524,870.4586216600846,0.7523561956057013,False
667,20ee883b5f69fa0f1ff9a28bedb3d411b085acca,/Users/sanika/Downloads/Master Thesis/repo_updated/pytest/testing/test_pytester.py,5913.0,ModificationType.MODIFY,722,423,573,19,0,135,741,12,172,101,199,184,300,1320.3370878174146,2257.068586817104,6.941860465116278,15668.255189881524,870.4586216600846,0.7523561956057013,False
668,20ee883b5f69fa0f1ff9a28bedb3d411b085acca,/Users/sanika/Downloads/Master Thesis/repo_updated/pytest/src/_pytest/pytester.py,5913.0,ModificationType.MODIFY,1508,847,911,44,250,301,1552,14,148,88,169,162,257,1120.302067021891,1886.3414507413486,7.993243243243242,15077.986055587939,837.6658919771077,0.6287804835804495,False
669,20ee883b5f69fa0f1ff9a28bedb3d411b085acca,/Users/sanika/Downloads/Master Thesis/repo_updated/pytest/testing/test_pytester.py,3032.0,ModificationType.MODIFY,722,423,573,19,0,135,741,12,172,101,199,184,300,1320.3370878174146,2257.068586817104,6.941860465116278,15668.255189881524,870.4586216600846,0.7523561956057013,False
670,62427778188a403122df36665e7a50e5ab2740fe,/Users/sanika/Downloads/Master Thesis/repo_updated/pytest/testing/test_pytester.py,5911.0,ModificationType.MODIFY,722,423,573,19,0,135,741,12,172,101,199,184,300,1320.3370878174146,2257.068586817104,6.941860465116278,15668.255189881524,870.4586216600846,0.7523561956057013,False
671,62427778188a403122df36665e7a50e5ab2740fe,/Users/sanika/Downloads/Master Thesis/repo_updated/pytest/src/_pytest/pytester.py,5911.0,ModificationType.MODIFY,1508,847,911,44,250,301,1552,14,148,88,169,162,257,1120.302067021891,1886.3414507413486,7.993243243243242,15077.986055587939,837.6658919771077,0.6287804835804495,False
672,62427778188a403122df36665e7a50e5ab2740fe,/Users/sanika/Downloads/Master Thesis/repo_updated/pytest/testing/test_config.py,6056.0,ModificationType.MODIFY,1457,730,1242,11,6,188,1468,10,292,166,329,302,495,2424.648052141839,4078.0103459659135,5.633561643835616,22973.722668198385,1276.3179260110217,1.359336781988638,False
673,62427778188a403122df36665e7a50e5ab2740fe,/Users/sanika/Downloads/Master Thesis/repo_updated/pytest/testing/test_runner.py,3442.0,ModificationType.MODIFY,1043,504,840,53,9,147,1096,9,180,112,198,189,310,1377.0628823523223,2344.2951515085324,4.95,11604.260999967237,644.6811666648464,0.7814317171695108,False
674,7a2d2d8f07d65e3d4b8360086df009777f130b5e,/Users/sanika/Downloads/Master Thesis/repo_updated/pytest/testing/test_assertrewrite.py,5417.0,ModificationType.MODIFY,1660,832,1314,41,38,274,1701,20,312,209,395,332,604,2671.484054182769,5058.523816533542,12.660256410256409,64042.208574703494,3557.900476372417,1.6861746055111808,False
675,7a2d2d8f07d65e3d4b8360086df009777f130b5e,/Users/sanika/Downloads/Master Thesis/repo_updated/pytest/src/_pytest/assertion/rewrite.py,5417.0,ModificationType.MODIFY,1057,646,719,113,100,145,1170,18,215,134,248,233,382,1740.9201126876956,3004.119107257935,10.381395348837211,31186.94812744052,1732.608229302251,1.001373035752645,False
676,7a2d2d8f07d65e3d4b8360086df009777f130b5e,/Users/sanika/Downloads/Master Thesis/repo_updated/pytest/testing/test_cacheprovider.py,2046.0,ModificationType.MODIFY,996,429,845,24,10,117,1020,7,76,50,88,83,138,494.49397547611574,879.7554415258757,4.052631578947368,3565.324684078549,198.07359355991935,0.2932518138419585,False
677,7a2d2d8f07d65e3d4b8360086df009777f130b5e,/Users/sanika/Downloads/Master Thesis/repo_updated/pytest/src/_pytest/cacheprovider.py,2046.0,ModificationType.MODIFY,456,277,329,12,42,72,468,13,85,50,97,98,147,592.903945907539,972.3623470849358,7.417647058823531,7212.640703965319,400.7022613314065,0.3241207823616453,False
678,7a2d2d8f07d65e3d4b8360086df009777f130b5e,/Users/sanika/Downloads/Master Thesis/repo_updated/pytest/testing/test_capture.py,3438.0,ModificationType.MODIFY,1513,682,1277,25,13,200,1538,11,199,116,219,210,335,1557.7420472931965,2584.272248418151,6.052763819095478,15641.989563917903,868.9994202176613,0.8614240828060503,False
679,7a2d2d8f07d65e3d4b8360086df009777f130b5e,/Users/sanika/Downloads/Master Thesis/repo_updated/pytest/src/_pytest/capture.py,3438.0,ModificationType.MODIFY,819,519,539,24,98,155,843,15,96,57,106,111,163,690.7597590033588,1107.4897862150674,8.28125,9171.399792093527,509.5222106718626,0.3691632620716892,False
680,7a2d2d8f07d65e3d4b8360086df009777f130b5e,/Users/sanika/Downloads/Master Thesis/repo_updated/pytest/testing/test_doctest.py,2720.0,ModificationType.MODIFY,1455,414,1257,16,76,112,1471,5,41,23,46,46,69,231.26927266377825,381.12577496793386,2.804878048780488,1069.0113200320095,59.3895177795561,0.1270419249893113,False
681,7a2d2d8f07d65e3d4b8360086df009777f130b5e,/Users/sanika/Downloads/Master Thesis/repo_updated/pytest/src/_pytest/doctest.py,2720.0,ModificationType.MODIFY,669,365,481,22,61,110,691,15,103,63,122,118,185,747.3129132339992,1273.2889641319407,8.88349514563107,11311.256331851706,628.403129547317,0.4244296547106469,False
682,7a2d2d8f07d65e3d4b8360086df009777f130b5e,/Users/sanika/Downloads/Master Thesis/repo_updated/pytest/src/_pytest/logging.py,2793.0,ModificationType.MODIFY,773,422,505,30,103,129,803,14,77,46,83,91,129,535.8455325423139,839.5055085856317,7.545454545454546,6334.450655691586,351.9139253161992,0.2798351695285439,False
683,7a2d2d8f07d65e3d4b8360086df009777f130b5e,/Users/sanika/Downloads/Master Thesis/repo_updated/pytest/testing/test_nodes.py,1701.0,ModificationType.MODIFY,53,23,39,0,0,13,53,2,8,4,8,10,12,26.0,39.863137138648355,1.0,39.863137138648355,2.2146187299249087,0.013287712379549451,False
684,7a2d2d8f07d65e3d4b8360086df009777f130b5e,/Users/sanika/Downloads/Master Thesis/repo_updated/pytest/src/_pytest/nodes.py,1701.0,ModificationType.MODIFY,515,298,307,33,80,99,548,12,63,44,77,75,121,419.5881851891487,753.6870615500015,7.333333333333332,5527.038451366679,307.0576917425932,0.2512290205166672,False
685,7a2d2d8f07d65e3d4b8360086df009777f130b5e,/Users/sanika/Downloads/Master Thesis/repo_updated/pytest/testing/test_terminal.py,6168.0,ModificationType.MODIFY,1943,715,1694,26,18,214,1969,12,185,120,237,197,357,1436.3251202041715,2721.0724995459263,7.686486486486486,20915.486996509768,1161.971499806098,0.9070241665153088,False
686,7a2d2d8f07d65e3d4b8360086df009777f130b5e,/Users/sanika/Downloads/Master Thesis/repo_updated/pytest/src/_pytest/terminal.py,6168.0,ModificationType.MODIFY,1168,838,957,57,25,144,1225,19,348,224,416,367,640,3018.854959310786,5452.567201819657,11.35632183908046,61921.107993078396,3440.0615551710216,1.817522400606552,False
687,7a2d2d8f07d65e3d4b8360086df009777f130b5e,/Users/sanika/Downloads/Master Thesis/repo_updated/pytest/testing/test_warnings.py,625.0,ModificationType.MODIFY,601,196,481,2,23,85,603,8,63,36,72,71,108,400.5686351804948,664.1726889065056,4.571428571428571,3036.21800642974,168.67877813498555,0.22139089630216852,False
688,7a2d2d8f07d65e3d4b8360086df009777f130b5e,/Users/sanika/Downloads/Master Thesis/repo_updated/pytest/src/_pytest/warnings.py,625.0,ModificationType.MODIFY,156,79,106,5,16,28,161,5,14,8,15,19,23,64.91260938324325,97.70233280920246,2.6785714285714284,261.7026771675066,14.539037620417032,0.03256744426973415,False
689,7a2d2d8f07d65e3d4b8360086df009777f130b5e,/Users/sanika/Downloads/Master Thesis/repo_updated/pytest/testing/test_capture.py,5074.0,ModificationType.MODIFY,1513,682,1277,25,13,200,1538,11,199,116,219,210,335,1557.7420472931965,2584.272248418151,6.052763819095478,15641.989563917903,868.9994202176613,0.8614240828060503,False
690,7a2d2d8f07d65e3d4b8360086df009777f130b5e,/Users/sanika/Downloads/Master Thesis/repo_updated/pytest/testing/test_doctest.py,3715.0,ModificationType.MODIFY,1455,414,1257,16,76,112,1471,5,41,23,46,46,69,231.26927266377825,381.12577496793386,2.804878048780488,1069.0113200320095,59.3895177795561,0.1270419249893113,False
691,8316d4392aadab5e91d508a8a130968f19a20c29,/Users/sanika/Downloads/Master Thesis/repo_updated/pytest/testing/test_capture.py,3438.0,ModificationType.MODIFY,1513,682,1277,25,13,200,1538,11,199,116,219,210,335,1557.7420472931965,2584.272248418151,6.052763819095478,15641.989563917903,868.9994202176613,0.8614240828060503,False
692,8316d4392aadab5e91d508a8a130968f19a20c29,/Users/sanika/Downloads/Master Thesis/repo_updated/pytest/src/_pytest/capture.py,3438.0,ModificationType.MODIFY,819,519,539,24,98,155,843,15,96,57,106,111,163,690.7597590033588,1107.4897862150674,8.28125,9171.399792093527,509.5222106718626,0.3691632620716892,False
693,713b9e54c31a8ec66c59ebe44c3e86a9b60fa7c7,/Users/sanika/Downloads/Master Thesis/repo_updated/pytest/testing/test_pathlib.py,1379.0,ModificationType.MODIFY,91,45,69,0,3,18,91,3,9,6,10,12,16,33.28421251514428,57.3594000115385,1.6666666666666667,95.59900001923084,5.311055556623936,0.01911980000384617,False
694,713b9e54c31a8ec66c59ebe44c3e86a9b60fa7c7,/Users/sanika/Downloads/Master Thesis/repo_updated/pytest/src/_pytest/pathlib.py,1379.0,ModificationType.MODIFY,367,234,237,17,34,68,384,16,55,34,61,71,95,381.9747842438563,584.2259763529447,8.872727272727273,5183.677753822492,287.98209743458284,0.19474199211764828,False
695,713b9e54c31a8ec66c59ebe44c3e86a9b60fa7c7,/Users/sanika/Downloads/Master Thesis/repo_updated/pytest/testing/test_tmpdir.py,1798.0,ModificationType.MODIFY,442,244,305,14,16,103,456,11,68,45,75,79,120,452.00122101003336,756.4536897812525,6.066176470588236,4588.781574040686,254.932309668927,0.2521512299270841,False
696,432e5550e5ae8843d40bffd436e6a88582ef7dc3,/Users/sanika/Downloads/Master Thesis/repo_updated/pytest/src/_pytest/assertion/util.py,2350.0,ModificationType.MODIFY,477,336,357,30,23,73,507,16,194,134,250,210,384,1538.3830913843026,2962.2702787837907,10.309278350515463,30538.868853441152,1696.603825191175,0.9874234262612636,False
697,432e5550e5ae8843d40bffd436e6a88582ef7dc3,/Users/sanika/Downloads/Master Thesis/repo_updated/pytest/testing/test_assertrewrite.py,6013.0,ModificationType.MODIFY,1660,832,1314,41,38,274,1701,20,312,209,395,332,604,2671.484054182769,5058.523816533542,12.660256410256409,64042.208574703494,3557.900476372417,1.6861746055111808,False
698,45fc0d9cd80ed37d77698f4e316103ba187f7eaf,/Users/sanika/Downloads/Master Thesis/repo_updated/pytest/testing/test_meta.py,96.0,ModificationType.MODIFY,35,12,22,4,5,6,39,1,2,1,2,3,3,2.0,4.754887502163468,0.5,2.3774437510817346,0.1320802083934297,0.0015849625007211565,False
699,8ef4287bf0b2a0a6ff7e612ed48ba3e781f570d4,/Users/sanika/Downloads/Master Thesis/repo_updated/pytest/testing/test_pytester.py,5986.0,ModificationType.MODIFY,722,423,573,19,0,135,741,12,172,101,199,184,300,1320.3370878174146,2257.068586817104,6.941860465116278,15668.255189881524,870.4586216600846,0.7523561956057013,False
700,8ef4287bf0b2a0a6ff7e612ed48ba3e781f570d4,/Users/sanika/Downloads/Master Thesis/repo_updated/pytest/src/_pytest/pytester.py,5986.0,ModificationType.MODIFY,1508,847,911,44,250,301,1552,14,148,88,169,162,257,1120.302067021891,1886.3414507413486,7.993243243243242,15077.986055587939,837.6658919771077,0.6287804835804495,False
701,8ef4287bf0b2a0a6ff7e612ed48ba3e781f570d4,/Users/sanika/Downloads/Master Thesis/repo_updated/pytest/testing/test_pytester.py,3137.0,ModificationType.MODIFY,722,423,573,19,0,135,741,12,172,101,199,184,300,1320.3370878174146,2257.068586817104,6.941860465116278,15668.255189881524,870.4586216600846,0.7523561956057013,False
702,d1bc2601e490b85763b2b711d4cd11d06e8e7be7,/Users/sanika/Downloads/Master Thesis/repo_updated/pytest/testing/test_pytester.py,5989.0,ModificationType.MODIFY,722,423,573,19,0,135,741,12,172,101,199,184,300,1320.3370878174146,2257.068586817104,6.941860465116278,15668.255189881524,870.4586216600846,0.7523561956057013,False
703,d1bc2601e490b85763b2b711d4cd11d06e8e7be7,/Users/sanika/Downloads/Master Thesis/repo_updated/pytest/src/_pytest/pytester.py,5989.0,ModificationType.MODIFY,1508,847,911,44,250,301,1552,14,148,88,169,162,257,1120.302067021891,1886.3414507413486,7.993243243243242,15077.986055587939,837.6658919771077,0.6287804835804495,False
704,d1bc2601e490b85763b2b711d4cd11d06e8e7be7,/Users/sanika/Downloads/Master Thesis/repo_updated/pytest/testing/test_pytester.py,3175.0,ModificationType.MODIFY,722,423,573,19,0,135,741,12,172,101,199,184,300,1320.3370878174146,2257.068586817104,6.941860465116278,15668.255189881524,870.4586216600846,0.7523561956057013,False
705,fb0e8b99d11e66dd5c4957b079aa4d58090b92a2,/Users/sanika/Downloads/Master Thesis/repo_updated/pytest/testing/test_cacheprovider.py,2057.0,ModificationType.MODIFY,996,429,845,24,10,117,1020,7,76,50,88,83,138,494.49397547611574,879.7554415258757,4.052631578947368,3565.324684078549,198.07359355991935,0.2932518138419585,False
706,fb0e8b99d11e66dd5c4957b079aa4d58090b92a2,/Users/sanika/Downloads/Master Thesis/repo_updated/pytest/src/_pytest/cacheprovider.py,2057.0,ModificationType.MODIFY,456,277,329,12,42,72,468,13,85,50,97,98,147,592.903945907539,972.3623470849358,7.417647058823531,7212.640703965319,400.7022613314065,0.3241207823616453,False
707,fb0e8b99d11e66dd5c4957b079aa4d58090b92a2,/Users/sanika/Downloads/Master Thesis/repo_updated/pytest/testing/test_pathlib.py,1379.0,ModificationType.MODIFY,91,45,69,0,3,18,91,3,9,6,10,12,16,33.28421251514428,57.3594000115385,1.6666666666666667,95.59900001923084,5.311055556623936,0.01911980000384617,False
708,fb0e8b99d11e66dd5c4957b079aa4d58090b92a2,/Users/sanika/Downloads/Master Thesis/repo_updated/pytest/src/_pytest/pathlib.py,1379.0,ModificationType.MODIFY,367,234,237,17,34,68,384,16,55,34,61,71,95,381.9747842438563,584.2259763529447,8.872727272727273,5183.677753822492,287.98209743458284,0.19474199211764828,False
709,fb0e8b99d11e66dd5c4957b079aa4d58090b92a2,/Users/sanika/Downloads/Master Thesis/repo_updated/pytest/testing/test_cacheprovider.py,3797.0,ModificationType.MODIFY,996,429,845,24,10,117,1020,7,76,50,88,83,138,494.49397547611574,879.7554415258757,4.052631578947368,3565.324684078549,198.07359355991935,0.2932518138419585,False
710,fb0e8b99d11e66dd5c4957b079aa4d58090b92a2,/Users/sanika/Downloads/Master Thesis/repo_updated/pytest/testing/test_tmpdir.py,1798.0,ModificationType.MODIFY,442,244,305,14,16,103,456,11,68,45,75,79,120,452.00122101003336,756.4536897812525,6.066176470588236,4588.781574040686,254.932309668927,0.2521512299270841,False
711,ed9fda84d30850f71b7d7d5c831c9ab1aaf3b2c8,/Users/sanika/Downloads/Master Thesis/repo_updated/pytest/src/_pytest/python_api.py,1970.0,ModificationType.MODIFY,757,253,292,73,244,162,830,13,61,38,67,74,105,409.88069392717034,651.9926033910399,7.139344262295082,4654.799652078655,258.5999806710363,0.2173308677970133,False
712,ed9fda84d30850f71b7d7d5c831c9ab1aaf3b2c8,/Users/sanika/Downloads/Master Thesis/repo_updated/pytest/testing/python/approx.py,4451.0,ModificationType.MODIFY,520,294,400,33,13,81,553,10,261,204,367,271,571,2128.502746053614,4614.9071026130605,7.030651340996169,32445.802809559264,1802.5446005310705,1.5383023675376872,False
713,34a02121adc2af5641b663c25804def9adb151e3,/Users/sanika/Downloads/Master Thesis/repo_updated/pytest/testing/python/approx.py,4328.0,ModificationType.MODIFY,520,294,400,33,13,81,553,10,261,204,367,271,571,2128.502746053614,4614.9071026130605,7.030651340996169,32445.802809559264,1802.5446005310705,1.5383023675376872,False
714,82753bec50fae4718fc6f38bdab3cf214f2be00f,/Users/sanika/Downloads/Master Thesis/repo_updated/pytest/testing/test_terminal.py,6183.0,ModificationType.MODIFY,1943,715,1694,26,18,214,1969,12,185,120,237,197,357,1436.3251202041715,2721.0724995459263,7.686486486486486,20915.486996509768,1161.971499806098,0.9070241665153088,False
715,82753bec50fae4718fc6f38bdab3cf214f2be00f,/Users/sanika/Downloads/Master Thesis/repo_updated/pytest/src/_pytest/terminal.py,6183.0,ModificationType.MODIFY,1168,838,957,57,25,144,1225,19,348,224,416,367,640,3018.854959310786,5452.567201819657,11.35632183908046,61921.107993078396,3440.0615551710216,1.817522400606552,False
716,82753bec50fae4718fc6f38bdab3cf214f2be00f,/Users/sanika/Downloads/Master Thesis/repo_updated/pytest/testing/test_terminal.py,6684.0,ModificationType.MODIFY,1943,715,1694,26,18,214,1969,12,185,120,237,197,357,1436.3251202041715,2721.0724995459263,7.686486486486486,20915.486996509768,1161.971499806098,0.9070241665153088,False
717,1f5b454355d27bccda2ce1b3b145cfbde020fb76,/Users/sanika/Downloads/Master Thesis/repo_updated/pytest/src/_pytest/logging.py,2936.0,ModificationType.MODIFY,773,422,505,30,103,129,803,14,77,46,83,91,129,535.8455325423139,839.5055085856317,7.545454545454546,6334.450655691586,351.9139253161992,0.2798351695285439,False
718,1f5b454355d27bccda2ce1b3b145cfbde020fb76,/Users/sanika/Downloads/Master Thesis/repo_updated/pytest/testing/logging/test_formatter.py,501.0,ModificationType.MODIFY,149,67,118,4,0,27,153,1,17,14,28,18,42,69.48686830125578,175.13685006057707,0.8235294117647058,144.23034710871056,8.01279706159503,0.058378950020192374,False
719,3c7fbe2d8b4e3a0f3d9dcd7fbdf6ac12de181ef8,/Users/sanika/Downloads/Master Thesis/repo_updated/pytest/src/_pytest/python_api.py,1970.0,ModificationType.MODIFY,757,253,292,73,244,162,830,13,61,38,67,74,105,409.88069392717034,651.9926033910399,7.139344262295082,4654.799652078655,258.5999806710363,0.2173308677970133,False
720,39066d5a4210f8c26b4336636fcab1244f1cfee3,/Users/sanika/Downloads/Master Thesis/repo_updated/pytest/testing/test_cacheprovider.py,2057.0,ModificationType.MODIFY,996,429,845,24,10,117,1020,7,76,50,88,83,138,494.49397547611574,879.7554415258757,4.052631578947368,3565.324684078549,198.07359355991935,0.2932518138419585,False
721,39066d5a4210f8c26b4336636fcab1244f1cfee3,/Users/sanika/Downloads/Master Thesis/repo_updated/pytest/src/_pytest/cacheprovider.py,2057.0,ModificationType.MODIFY,456,277,329,12,42,72,468,13,85,50,97,98,147,592.903945907539,972.3623470849358,7.417647058823531,7212.640703965319,400.7022613314065,0.3241207823616453,False
722,39066d5a4210f8c26b4336636fcab1244f1cfee3,/Users/sanika/Downloads/Master Thesis/repo_updated/pytest/testing/test_pathlib.py,1379.0,ModificationType.MODIFY,91,45,69,0,3,18,91,3,9,6,10,12,16,33.28421251514428,57.3594000115385,1.6666666666666667,95.59900001923084,5.311055556623936,0.01911980000384617,False
723,39066d5a4210f8c26b4336636fcab1244f1cfee3,/Users/sanika/Downloads/Master Thesis/repo_updated/pytest/src/_pytest/pathlib.py,1379.0,ModificationType.MODIFY,367,234,237,17,34,68,384,16,55,34,61,71,95,381.9747842438563,584.2259763529447,8.872727272727273,5183.677753822492,287.98209743458284,0.19474199211764828,False
724,39066d5a4210f8c26b4336636fcab1244f1cfee3,/Users/sanika/Downloads/Master Thesis/repo_updated/pytest/testing/test_cacheprovider.py,3797.0,ModificationType.MODIFY,996,429,845,24,10,117,1020,7,76,50,88,83,138,494.49397547611574,879.7554415258757,4.052631578947368,3565.324684078549,198.07359355991935,0.2932518138419585,False
725,39066d5a4210f8c26b4336636fcab1244f1cfee3,/Users/sanika/Downloads/Master Thesis/repo_updated/pytest/testing/test_tmpdir.py,1798.0,ModificationType.MODIFY,442,244,305,14,16,103,456,11,68,45,75,79,120,452.00122101003336,756.4536897812525,6.066176470588236,4588.781574040686,254.932309668927,0.2521512299270841,False
726,b9df9a476177cac1760a5d10cd66392368a8c00a,/Users/sanika/Downloads/Master Thesis/repo_updated/pytest/src/_pytest/python_api.py,1970.0,ModificationType.MODIFY,757,253,292,73,244,162,830,13,61,38,67,74,105,409.88069392717034,651.9926033910399,7.139344262295082,4654.799652078655,258.5999806710363,0.2173308677970133,False
727,b9df9a476177cac1760a5d10cd66392368a8c00a,/Users/sanika/Downloads/Master Thesis/repo_updated/pytest/testing/python/approx.py,4328.0,ModificationType.MODIFY,520,294,400,33,13,81,553,10,261,204,367,271,571,2128.502746053614,4614.9071026130605,7.030651340996169,32445.802809559264,1802.5446005310705,1.5383023675376872,False
728,f93f284356c73e35ef3f50076496538bbdce4b6b,/Users/sanika/Downloads/Master Thesis/repo_updated/pytest/testing/test_assertrewrite.py,5471.0,ModificationType.MODIFY,1660,832,1314,41,38,274,1701,20,312,209,395,332,604,2671.484054182769,5058.523816533542,12.660256410256409,64042.208574703494,3557.900476372417,1.6861746055111808,True
729,f93f284356c73e35ef3f50076496538bbdce4b6b,/Users/sanika/Downloads/Master Thesis/repo_updated/pytest/src/_pytest/assertion/rewrite.py,5471.0,ModificationType.MODIFY,1057,646,719,113,100,145,1170,18,215,134,248,233,382,1740.9201126876956,3004.119107257935,10.381395348837211,31186.94812744052,1732.608229302251,1.001373035752645,True
730,f93f284356c73e35ef3f50076496538bbdce4b6b,/Users/sanika/Downloads/Master Thesis/repo_updated/pytest/testing/test_assertrewrite.py,6306.0,ModificationType.MODIFY,1660,832,1314,41,38,274,1701,20,312,209,395,332,604,2671.484054182769,5058.523816533542,12.660256410256409,64042.208574703494,3557.900476372417,1.6861746055111808,True
731,96de23279165af589822f54365f31925390f434d,/Users/sanika/Downloads/Master Thesis/repo_updated/pytest/testing/freeze/runtests_script.py,20.0,ModificationType.MODIFY,10,5,4,0,4,2,10,1,2,1,2,3,3,2.0,4.754887502163468,0.5,2.3774437510817346,0.1320802083934297,0.0015849625007211565,False
732,96de23279165af589822f54365f31925390f434d,/Users/sanika/Downloads/Master Thesis/repo_updated/pytest/testing/python/collect.py,3931.0,ModificationType.MODIFY,1338,495,1086,10,64,173,1348,11,122,82,157,133,239,883.6037029876825,1686.2125020847845,7.077868852459017,11934.79094713288,663.0439415073823,0.5620708340282614,False
733,96de23279165af589822f54365f31925390f434d,/Users/sanika/Downloads/Master Thesis/repo_updated/pytest/testing/test_reports.py,1843.0,ModificationType.MODIFY,466,257,367,18,25,50,484,7,126,86,171,133,257,898.7887548153927,1813.2075859238055,4.75,8612.736033138077,478.4853351743376,0.6044025286412685,False
734,0b8c35516fc3da230e6ce177b76f8af0d5a14ed1,/Users/sanika/Downloads/Master Thesis/repo_updated/pytest/testing/code/test_code.py,4974.0,ModificationType.MODIFY,182,127,129,0,0,53,182,5,39,21,42,44,63,217.7403270100645,343.9441919741497,2.6923076923076925,926.003593776557,51.44464409869761,0.11464806399138325,False
735,0b8c35516fc3da230e6ce177b76f8af0d5a14ed1,/Users/sanika/Downloads/Master Thesis/repo_updated/pytest/src/_pytest/_code/code.py,4974.0,ModificationType.MODIFY,1165,710,800,67,119,181,1232,18,243,153,282,261,435,2000.7880884021665,3492.1391085079,10.444444444444443,36473.45291108252,2026.302939504584,1.1640463695026333,False
736,0b8c35516fc3da230e6ce177b76f8af0d5a14ed1,/Users/sanika/Downloads/Master Thesis/repo_updated/pytest/src/_pytest/logging.py,2748.0,ModificationType.MODIFY,773,422,505,30,103,129,803,14,77,46,83,91,129,535.8455325423139,839.5055085856317,7.545454545454546,6334.450655691586,351.9139253161992,0.2798351695285439,False
737,0b8c35516fc3da230e6ce177b76f8af0d5a14ed1,/Users/sanika/Downloads/Master Thesis/repo_updated/pytest/testing/test_pytester.py,5745.0,ModificationType.MODIFY,722,423,573,19,0,135,741,12,172,101,199,184,300,1320.3370878174146,2257.068586817104,6.941860465116278,15668.255189881524,870.4586216600846,0.7523561956057013,False
738,0b8c35516fc3da230e6ce177b76f8af0d5a14ed1,/Users/sanika/Downloads/Master Thesis/repo_updated/pytest/src/_pytest/pytester.py,5745.0,ModificationType.MODIFY,1508,847,911,44,250,301,1552,14,148,88,169,162,257,1120.302067021891,1886.3414507413486,7.993243243243242,15077.986055587939,837.6658919771077,0.6287804835804495,False
739,0b8c35516fc3da230e6ce177b76f8af0d5a14ed1,/Users/sanika/Downloads/Master Thesis/repo_updated/pytest/testing/test_reports.py,1942.0,ModificationType.MODIFY,466,257,367,18,25,50,484,7,126,86,171,133,257,898.7887548153927,1813.2075859238055,4.75,8612.736033138077,478.4853351743376,0.6044025286412685,False
740,0b8c35516fc3da230e6ce177b76f8af0d5a14ed1,/Users/sanika/Downloads/Master Thesis/repo_updated/pytest/src/_pytest/reports.py,1942.0,ModificationType.MODIFY,507,281,342,29,59,88,536,10,53,29,57,63,86,336.7990650407233,514.0460734209928,5.377358490566038,2764.2100174525085,153.56722319180602,0.17134869114033094,False
741,0b8c35516fc3da230e6ce177b76f8af0d5a14ed1,/Users/sanika/Downloads/Master Thesis/repo_updated/pytest/testing/test_capture.py,5083.0,ModificationType.MODIFY,1513,682,1277,25,13,200,1538,11,199,116,219,210,335,1557.7420472931965,2584.272248418151,6.052763819095478,15641.989563917903,868.9994202176613,0.8614240828060503,False
742,0b8c35516fc3da230e6ce177b76f8af0d5a14ed1,/Users/sanika/Downloads/Master Thesis/repo_updated/pytest/testing/test_resultlog.py,1033.0,ModificationType.MODIFY,215,129,180,6,0,29,221,8,65,43,72,73,115,415.4539078468495,711.8298242712019,4.430769230769231,3153.9536829247113,175.21964905137278,0.2372766080904007,False
743,0b8c35516fc3da230e6ce177b76f8af0d5a14ed1,/Users/sanika/Downloads/Master Thesis/repo_updated/pytest/testing/test_terminal.py,6136.0,ModificationType.MODIFY,1943,715,1694,26,18,214,1969,12,185,120,237,197,357,1436.3251202041715,2721.0724995459263,7.686486486486486,20915.486996509768,1161.971499806098,0.9070241665153088,False
744,6f20b4b014f5e01a64f811372625284e2e8b08fe,/Users/sanika/Downloads/Master Thesis/repo_updated/pytest/testing/test_assertrewrite.py,5480.0,ModificationType.MODIFY,1660,832,1314,41,38,274,1701,20,312,209,395,332,604,2671.484054182769,5058.523816533542,12.660256410256409,64042.208574703494,3557.900476372417,1.6861746055111808,False
745,6f20b4b014f5e01a64f811372625284e2e8b08fe,/Users/sanika/Downloads/Master Thesis/repo_updated/pytest/src/_pytest/assertion/rewrite.py,5480.0,ModificationType.MODIFY,1057,646,719,113,100,145,1170,18,215,134,248,233,382,1740.9201126876956,3004.119107257935,10.381395348837211,31186.94812744052,1732.608229302251,1.001373035752645,False
746,6f20b4b014f5e01a64f811372625284e2e8b08fe,/Users/sanika/Downloads/Master Thesis/repo_updated/pytest/testing/test_compat.py,1223.0,ModificationType.MODIFY,207,111,150,11,0,50,218,5,26,19,36,31,55,133.82107314610522,272.4807970712782,3.4615384615384617,943.202759092886,52.400153282938106,0.09082693235709273,False
747,6f20b4b014f5e01a64f811372625284e2e8b08fe,/Users/sanika/Downloads/Master Thesis/repo_updated/pytest/src/_pytest/compat.py,1223.0,ModificationType.MODIFY,410,198,237,31,55,97,441,11,63,38,72,74,110,414.62238298550506,683.0398702191846,6.2857142857142865,4293.39346994916,238.52185944162002,0.2276799567397282,False
748,6f20b4b014f5e01a64f811372625284e2e8b08fe,/Users/sanika/Downloads/Master Thesis/repo_updated/pytest/testing/test_assertrewrite.py,6308.0,ModificationType.MODIFY,1660,832,1314,41,38,274,1701,20,312,209,395,332,604,2671.484054182769,5058.523816533542,12.660256410256409,64042.208574703494,3557.900476372417,1.6861746055111808,False
749,1ad4ca6ac14ccabc2fb537bfc766251dfad22aec,/Users/sanika/Downloads/Master Thesis/repo_updated/pytest/testing/test_assertrewrite.py,5480.0,ModificationType.MODIFY,1660,832,1314,41,38,274,1701,20,312,209,395,332,604,2671.484054182769,5058.523816533542,12.660256410256409,64042.208574703494,3557.900476372417,1.6861746055111808,False
750,1ad4ca6ac14ccabc2fb537bfc766251dfad22aec,/Users/sanika/Downloads/Master Thesis/repo_updated/pytest/src/_pytest/assertion/rewrite.py,5480.0,ModificationType.MODIFY,1057,646,719,113,100,145,1170,18,215,134,248,233,382,1740.9201126876956,3004.119107257935,10.381395348837211,31186.94812744052,1732.608229302251,1.001373035752645,False
751,1ad4ca6ac14ccabc2fb537bfc766251dfad22aec,/Users/sanika/Downloads/Master Thesis/repo_updated/pytest/testing/test_compat.py,1223.0,ModificationType.MODIFY,207,111,150,11,0,50,218,5,26,19,36,31,55,133.82107314610522,272.4807970712782,3.4615384615384617,943.202759092886,52.400153282938106,0.09082693235709273,False
752,1ad4ca6ac14ccabc2fb537bfc766251dfad22aec,/Users/sanika/Downloads/Master Thesis/repo_updated/pytest/src/_pytest/compat.py,1223.0,ModificationType.MODIFY,410,198,237,31,55,97,441,11,63,38,72,74,110,414.62238298550506,683.0398702191846,6.2857142857142865,4293.39346994916,238.52185944162002,0.2276799567397282,False
753,1ad4ca6ac14ccabc2fb537bfc766251dfad22aec,/Users/sanika/Downloads/Master Thesis/repo_updated/pytest/testing/test_assertrewrite.py,6308.0,ModificationType.MODIFY,1660,832,1314,41,38,274,1701,20,312,209,395,332,604,2671.484054182769,5058.523816533542,12.660256410256409,64042.208574703494,3557.900476372417,1.6861746055111808,False
754,ac633b8969ced41c49d3cb8ce9bc4d4b20be4682,/Users/sanika/Downloads/Master Thesis/repo_updated/pytest/testing/code/test_code.py,4974.0,ModificationType.MODIFY,182,127,129,0,0,53,182,5,39,21,42,44,63,217.7403270100645,343.9441919741497,2.6923076923076925,926.003593776557,51.44464409869761,0.11464806399138325,False
755,ac633b8969ced41c49d3cb8ce9bc4d4b20be4682,/Users/sanika/Downloads/Master Thesis/repo_updated/pytest/src/_pytest/_code/code.py,4974.0,ModificationType.MODIFY,1165,710,800,67,119,181,1232,18,243,153,282,261,435,2000.7880884021665,3492.1391085079,10.444444444444443,36473.45291108252,2026.302939504584,1.1640463695026333,False
756,ac633b8969ced41c49d3cb8ce9bc4d4b20be4682,/Users/sanika/Downloads/Master Thesis/repo_updated/pytest/src/_pytest/logging.py,2748.0,ModificationType.MODIFY,773,422,505,30,103,129,803,14,77,46,83,91,129,535.8455325423139,839.5055085856317,7.545454545454546,6334.450655691586,351.9139253161992,0.2798351695285439,False
757,ac633b8969ced41c49d3cb8ce9bc4d4b20be4682,/Users/sanika/Downloads/Master Thesis/repo_updated/pytest/testing/test_pytester.py,5745.0,ModificationType.MODIFY,722,423,573,19,0,135,741,12,172,101,199,184,300,1320.3370878174146,2257.068586817104,6.941860465116278,15668.255189881524,870.4586216600846,0.7523561956057013,False
758,ac633b8969ced41c49d3cb8ce9bc4d4b20be4682,/Users/sanika/Downloads/Master Thesis/repo_updated/pytest/src/_pytest/pytester.py,5745.0,ModificationType.MODIFY,1508,847,911,44,250,301,1552,14,148,88,169,162,257,1120.302067021891,1886.3414507413486,7.993243243243242,15077.986055587939,837.6658919771077,0.6287804835804495,False
759,ac633b8969ced41c49d3cb8ce9bc4d4b20be4682,/Users/sanika/Downloads/Master Thesis/repo_updated/pytest/testing/test_reports.py,1942.0,ModificationType.MODIFY,466,257,367,18,25,50,484,7,126,86,171,133,257,898.7887548153927,1813.2075859238055,4.75,8612.736033138077,478.4853351743376,0.6044025286412685,False
760,ac633b8969ced41c49d3cb8ce9bc4d4b20be4682,/Users/sanika/Downloads/Master Thesis/repo_updated/pytest/src/_pytest/reports.py,1942.0,ModificationType.MODIFY,507,281,342,29,59,88,536,10,53,29,57,63,86,336.7990650407233,514.0460734209928,5.377358490566038,2764.2100174525085,153.56722319180602,0.17134869114033094,False
761,ac633b8969ced41c49d3cb8ce9bc4d4b20be4682,/Users/sanika/Downloads/Master Thesis/repo_updated/pytest/testing/test_capture.py,5083.0,ModificationType.MODIFY,1513,682,1277,25,13,200,1538,11,199,116,219,210,335,1557.7420472931965,2584.272248418151,6.052763819095478,15641.989563917903,868.9994202176613,0.8614240828060503,False
762,ac633b8969ced41c49d3cb8ce9bc4d4b20be4682,/Users/sanika/Downloads/Master Thesis/repo_updated/pytest/testing/test_resultlog.py,1033.0,ModificationType.MODIFY,215,129,180,6,0,29,221,8,65,43,72,73,115,415.4539078468495,711.8298242712019,4.430769230769231,3153.9536829247113,175.21964905137278,0.2372766080904007,False
763,ac633b8969ced41c49d3cb8ce9bc4d4b20be4682,/Users/sanika/Downloads/Master Thesis/repo_updated/pytest/testing/test_terminal.py,6136.0,ModificationType.MODIFY,1943,715,1694,26,18,214,1969,12,185,120,237,197,357,1436.3251202041715,2721.0724995459263,7.686486486486486,20915.486996509768,1161.971499806098,0.9070241665153088,False
764,cefe6bfec38f8f9e200b2e233a840cf1de2bf3b4,/Users/sanika/Downloads/Master Thesis/repo_updated/pytest/testing/freeze/runtests_script.py,20.0,ModificationType.MODIFY,10,5,4,0,4,2,10,1,2,1,2,3,3,2.0,4.754887502163468,0.5,2.3774437510817346,0.1320802083934297,0.0015849625007211565,False
765,cefe6bfec38f8f9e200b2e233a840cf1de2bf3b4,/Users/sanika/Downloads/Master Thesis/repo_updated/pytest/testing/python/collect.py,3931.0,ModificationType.MODIFY,1338,495,1086,10,64,173,1348,11,122,82,157,133,239,883.6037029876825,1686.2125020847845,7.077868852459017,11934.79094713288,663.0439415073823,0.5620708340282614,False
766,cefe6bfec38f8f9e200b2e233a840cf1de2bf3b4,/Users/sanika/Downloads/Master Thesis/repo_updated/pytest/testing/test_reports.py,1843.0,ModificationType.MODIFY,466,257,367,18,25,50,484,7,126,86,171,133,257,898.7887548153927,1813.2075859238055,4.75,8612.736033138077,478.4853351743376,0.6044025286412685,False
767,59a59f371b303e8825b07fdd6567609b698d0092,/Users/sanika/Downloads/Master Thesis/repo_updated/pytest/testing/test_pathlib.py,1550.0,ModificationType.MODIFY,91,45,69,0,3,18,91,3,9,6,10,12,16,33.28421251514428,57.3594000115385,1.6666666666666667,95.59900001923084,5.311055556623936,0.01911980000384617,False
768,59a59f371b303e8825b07fdd6567609b698d0092,/Users/sanika/Downloads/Master Thesis/repo_updated/pytest/src/_pytest/pathlib.py,1550.0,ModificationType.MODIFY,367,234,237,17,34,68,384,16,55,34,61,71,95,381.9747842438563,584.2259763529447,8.872727272727273,5183.677753822492,287.98209743458284,0.19474199211764828,False
769,00a278cdb4549973998b58206ca020a87c38fcee,/Users/sanika/Downloads/Master Thesis/repo_updated/pytest/testing/test_tmpdir.py,704.0,ModificationType.MODIFY,442,244,305,14,16,103,456,11,68,45,75,79,120,452.00122101003336,756.4536897812525,6.066176470588236,4588.781574040686,254.932309668927,0.2521512299270841,False
770,00a278cdb4549973998b58206ca020a87c38fcee,/Users/sanika/Downloads/Master Thesis/repo_updated/pytest/src/_pytest/tmpdir.py,704.0,ModificationType.MODIFY,182,102,99,11,40,35,193,3,11,6,11,14,17,42.808635307173745,64.72503367497926,1.5,97.08755051246887,5.393752806248272,0.021575011224993085,False
771,8e8a8fa4b9b1b88c8afc9ce92e3c2a8bc5466541,/Users/sanika/Downloads/Master Thesis/repo_updated/pytest/testing/test_pytester.py,5973.0,ModificationType.MODIFY,722,423,573,19,0,135,741,12,172,101,199,184,300,1320.3370878174146,2257.068586817104,6.941860465116278,15668.255189881524,870.4586216600846,0.7523561956057013,False
772,8e8a8fa4b9b1b88c8afc9ce92e3c2a8bc5466541,/Users/sanika/Downloads/Master Thesis/repo_updated/pytest/src/_pytest/pytester.py,5973.0,ModificationType.MODIFY,1508,847,911,44,250,301,1552,14,148,88,169,162,257,1120.302067021891,1886.3414507413486,7.993243243243242,15077.986055587939,837.6658919771077,0.6287804835804495,False
773,7f1af84f47f9237006c9678f97b8c7cc946312e5,/Users/sanika/Downloads/Master Thesis/repo_updated/pytest/testing/code/test_code.py,4989.0,ModificationType.MODIFY,182,127,129,0,0,53,182,5,39,21,42,44,63,217.7403270100645,343.9441919741497,2.6923076923076925,926.003593776557,51.44464409869761,0.11464806399138325,False
774,7f1af84f47f9237006c9678f97b8c7cc946312e5,/Users/sanika/Downloads/Master Thesis/repo_updated/pytest/src/_pytest/_code/code.py,4989.0,ModificationType.MODIFY,1165,710,800,67,119,181,1232,18,243,153,282,261,435,2000.7880884021665,3492.1391085079,10.444444444444443,36473.45291108252,2026.302939504584,1.1640463695026333,False
775,7f1af84f47f9237006c9678f97b8c7cc946312e5,/Users/sanika/Downloads/Master Thesis/repo_updated/pytest/src/_pytest/logging.py,2787.0,ModificationType.MODIFY,773,422,505,30,103,129,803,14,77,46,83,91,129,535.8455325423139,839.5055085856317,7.545454545454546,6334.450655691586,351.9139253161992,0.2798351695285439,False
776,7f1af84f47f9237006c9678f97b8c7cc946312e5,/Users/sanika/Downloads/Master Thesis/repo_updated/pytest/testing/test_pytester.py,5989.0,ModificationType.MODIFY,722,423,573,19,0,135,741,12,172,101,199,184,300,1320.3370878174146,2257.068586817104,6.941860465116278,15668.255189881524,870.4586216600846,0.7523561956057013,False
777,7f1af84f47f9237006c9678f97b8c7cc946312e5,/Users/sanika/Downloads/Master Thesis/repo_updated/pytest/src/_pytest/pytester.py,5989.0,ModificationType.MODIFY,1508,847,911,44,250,301,1552,14,148,88,169,162,257,1120.302067021891,1886.3414507413486,7.993243243243242,15077.986055587939,837.6658919771077,0.6287804835804495,False
778,7f1af84f47f9237006c9678f97b8c7cc946312e5,/Users/sanika/Downloads/Master Thesis/repo_updated/pytest/testing/test_reports.py,1942.0,ModificationType.MODIFY,466,257,367,18,25,50,484,7,126,86,171,133,257,898.7887548153927,1813.2075859238055,4.75,8612.736033138077,478.4853351743376,0.6044025286412685,False
779,7f1af84f47f9237006c9678f97b8c7cc946312e5,/Users/sanika/Downloads/Master Thesis/repo_updated/pytest/src/_pytest/reports.py,1942.0,ModificationType.MODIFY,507,281,342,29,59,88,536,10,53,29,57,63,86,336.7990650407233,514.0460734209928,5.377358490566038,2764.2100174525085,153.56722319180602,0.17134869114033094,False
780,7f1af84f47f9237006c9678f97b8c7cc946312e5,/Users/sanika/Downloads/Master Thesis/repo_updated/pytest/testing/freeze/runtests_script.py,20.0,ModificationType.MODIFY,10,5,4,0,4,2,10,1,2,1,2,3,3,2.0,4.754887502163468,0.5,2.3774437510817346,0.1320802083934297,0.0015849625007211565,False
781,7f1af84f47f9237006c9678f97b8c7cc946312e5,/Users/sanika/Downloads/Master Thesis/repo_updated/pytest/testing/python/collect.py,3928.0,ModificationType.MODIFY,1338,495,1086,10,64,173,1348,11,122,82,157,133,239,883.6037029876825,1686.2125020847845,7.077868852459017,11934.79094713288,663.0439415073823,0.5620708340282614,False
782,7f1af84f47f9237006c9678f97b8c7cc946312e5,/Users/sanika/Downloads/Master Thesis/repo_updated/pytest/testing/test_capture.py,5072.0,ModificationType.MODIFY,1513,682,1277,25,13,200,1538,11,199,116,219,210,335,1557.7420472931965,2584.272248418151,6.052763819095478,15641.989563917903,868.9994202176613,0.8614240828060503,False
783,7f1af84f47f9237006c9678f97b8c7cc946312e5,/Users/sanika/Downloads/Master Thesis/repo_updated/pytest/testing/test_reports.py,1843.0,ModificationType.MODIFY,466,257,367,18,25,50,484,7,126,86,171,133,257,898.7887548153927,1813.2075859238055,4.75,8612.736033138077,478.4853351743376,0.6044025286412685,False
784,7f1af84f47f9237006c9678f97b8c7cc946312e5,/Users/sanika/Downloads/Master Thesis/repo_updated/pytest/testing/test_resultlog.py,1033.0,ModificationType.MODIFY,215,129,180,6,0,29,221,8,65,43,72,73,115,415.4539078468495,711.8298242712019,4.430769230769231,3153.9536829247113,175.21964905137278,0.2372766080904007,False
785,7f1af84f47f9237006c9678f97b8c7cc946312e5,/Users/sanika/Downloads/Master Thesis/repo_updated/pytest/testing/test_terminal.py,6632.0,ModificationType.MODIFY,1943,715,1694,26,18,214,1969,12,185,120,237,197,357,1436.3251202041715,2721.0724995459263,7.686486486486486,20915.486996509768,1161.971499806098,0.9070241665153088,False
786,a92f49afa7d32d3c64972390a22c9ed7710fcfcb,/Users/sanika/Downloads/Master Thesis/repo_updated/pytest/testing/code/test_code.py,4989.0,ModificationType.MODIFY,182,127,129,0,0,53,182,5,39,21,42,44,63,217.7403270100645,343.9441919741497,2.6923076923076925,926.003593776557,51.44464409869761,0.11464806399138325,False
787,a92f49afa7d32d3c64972390a22c9ed7710fcfcb,/Users/sanika/Downloads/Master Thesis/repo_updated/pytest/src/_pytest/_code/code.py,4989.0,ModificationType.MODIFY,1165,710,800,67,119,181,1232,18,243,153,282,261,435,2000.7880884021665,3492.1391085079,10.444444444444443,36473.45291108252,2026.302939504584,1.1640463695026333,False
788,a92f49afa7d32d3c64972390a22c9ed7710fcfcb,/Users/sanika/Downloads/Master Thesis/repo_updated/pytest/src/_pytest/logging.py,2787.0,ModificationType.MODIFY,773,422,505,30,103,129,803,14,77,46,83,91,129,535.8455325423139,839.5055085856317,7.545454545454546,6334.450655691586,351.9139253161992,0.2798351695285439,False
789,a92f49afa7d32d3c64972390a22c9ed7710fcfcb,/Users/sanika/Downloads/Master Thesis/repo_updated/pytest/testing/test_pytester.py,5989.0,ModificationType.MODIFY,722,423,573,19,0,135,741,12,172,101,199,184,300,1320.3370878174146,2257.068586817104,6.941860465116278,15668.255189881524,870.4586216600846,0.7523561956057013,False
790,a92f49afa7d32d3c64972390a22c9ed7710fcfcb,/Users/sanika/Downloads/Master Thesis/repo_updated/pytest/src/_pytest/pytester.py,5989.0,ModificationType.MODIFY,1508,847,911,44,250,301,1552,14,148,88,169,162,257,1120.302067021891,1886.3414507413486,7.993243243243242,15077.986055587939,837.6658919771077,0.6287804835804495,False
791,a92f49afa7d32d3c64972390a22c9ed7710fcfcb,/Users/sanika/Downloads/Master Thesis/repo_updated/pytest/testing/test_reports.py,1942.0,ModificationType.MODIFY,466,257,367,18,25,50,484,7,126,86,171,133,257,898.7887548153927,1813.2075859238055,4.75,8612.736033138077,478.4853351743376,0.6044025286412685,False
792,a92f49afa7d32d3c64972390a22c9ed7710fcfcb,/Users/sanika/Downloads/Master Thesis/repo_updated/pytest/src/_pytest/reports.py,1942.0,ModificationType.MODIFY,507,281,342,29,59,88,536,10,53,29,57,63,86,336.7990650407233,514.0460734209928,5.377358490566038,2764.2100174525085,153.56722319180602,0.17134869114033094,False
793,a92f49afa7d32d3c64972390a22c9ed7710fcfcb,/Users/sanika/Downloads/Master Thesis/repo_updated/pytest/testing/freeze/runtests_script.py,20.0,ModificationType.MODIFY,10,5,4,0,4,2,10,1,2,1,2,3,3,2.0,4.754887502163468,0.5,2.3774437510817346,0.1320802083934297,0.0015849625007211565,False
794,a92f49afa7d32d3c64972390a22c9ed7710fcfcb,/Users/sanika/Downloads/Master Thesis/repo_updated/pytest/testing/python/collect.py,3928.0,ModificationType.MODIFY,1338,495,1086,10,64,173,1348,11,122,82,157,133,239,883.6037029876825,1686.2125020847845,7.077868852459017,11934.79094713288,663.0439415073823,0.5620708340282614,False
795,a92f49afa7d32d3c64972390a22c9ed7710fcfcb,/Users/sanika/Downloads/Master Thesis/repo_updated/pytest/testing/test_capture.py,5072.0,ModificationType.MODIFY,1513,682,1277,25,13,200,1538,11,199,116,219,210,335,1557.7420472931965,2584.272248418151,6.052763819095478,15641.989563917903,868.9994202176613,0.8614240828060503,False
796,a92f49afa7d32d3c64972390a22c9ed7710fcfcb,/Users/sanika/Downloads/Master Thesis/repo_updated/pytest/testing/test_reports.py,1843.0,ModificationType.MODIFY,466,257,367,18,25,50,484,7,126,86,171,133,257,898.7887548153927,1813.2075859238055,4.75,8612.736033138077,478.4853351743376,0.6044025286412685,False
797,a92f49afa7d32d3c64972390a22c9ed7710fcfcb,/Users/sanika/Downloads/Master Thesis/repo_updated/pytest/testing/test_resultlog.py,1033.0,ModificationType.MODIFY,215,129,180,6,0,29,221,8,65,43,72,73,115,415.4539078468495,711.8298242712019,4.430769230769231,3153.9536829247113,175.21964905137278,0.2372766080904007,False
798,a92f49afa7d32d3c64972390a22c9ed7710fcfcb,/Users/sanika/Downloads/Master Thesis/repo_updated/pytest/testing/test_terminal.py,6632.0,ModificationType.MODIFY,1943,715,1694,26,18,214,1969,12,185,120,237,197,357,1436.3251202041715,2721.0724995459263,7.686486486486486,20915.486996509768,1161.971499806098,0.9070241665153088,False
799,81c3bc76bcd366c61da2a63047421241e33c366b,/Users/sanika/Downloads/Master Thesis/repo_updated/pytest/testing/test_capture.py,5076.0,ModificationType.MODIFY,1513,682,1277,25,13,200,1538,11,199,116,219,210,335,1557.7420472931965,2584.272248418151,6.052763819095478,15641.989563917903,868.9994202176613,0.8614240828060503,False
800,a4faac6c942f38613bca7b88176565da173d1ab2,/Users/sanika/Downloads/Master Thesis/repo_updated/pytest/testing/example_scripts/collect/package_infinite_recursion/__init__.pyi,608.0,ModificationType.MODIFY,0,0,0,0,0,0,0,0,0,0,0,0,0,0.0,0.0,0.0,0.0,0.0,0.0,False
801,a4faac6c942f38613bca7b88176565da173d1ab2,/Users/sanika/Downloads/Master Thesis/repo_updated/pytest/testing/example_scripts/collect/package_infinite_recursion/tests/__init__.py,608.0,ModificationType.MODIFY,0,0,0,0,0,0,0,0,0,0,0,0,0,0.0,0.0,0.0,0.0,0.0,0.0,False
802,a4faac6c942f38613bca7b88176565da173d1ab2,/Users/sanika/Downloads/Master Thesis/repo_updated/pytest/testing/example_scripts/collect/collect_init_tests/tests/__init__.py,608.0,ModificationType.MODIFY,2,2,2,0,0,0,2,0,0,0,0,0,0,0.0,0.0,0.0,0.0,0.0,0.0,False
803,a4faac6c942f38613bca7b88176565da173d1ab2,/Users/sanika/Downloads/Master Thesis/repo_updated/pytest/testing/example_scripts/collect/package_init_given_as_arg/pkg/__init__.py,608.0,ModificationType.MODIFY,0,0,0,0,0,0,0,0,0,0,0,0,0,0.0,0.0,0.0,0.0,0.0,0.0,False
804,a4faac6c942f38613bca7b88176565da173d1ab2,/Users/sanika/Downloads/Master Thesis/repo_updated/pytest/testing/example_scripts/conftest_usageerror/__init__.pyi,608.0,ModificationType.MODIFY,0,0,0,0,0,0,0,0,0,0,0,0,0,0.0,0.0,0.0,0.0,0.0,0.0,False
805,a4faac6c942f38613bca7b88176565da173d1ab2,/Users/sanika/Downloads/Master Thesis/repo_updated/pytest/testing/example_scripts/marks/marks_considered_keywords/__init__.pyi,608.0,ModificationType.MODIFY,0,0,0,0,0,0,0,0,0,0,0,0,0,0.0,0.0,0.0,0.0,0.0,0.0,False
806,a4faac6c942f38613bca7b88176565da173d1ab2,/Users/sanika/Downloads/Master Thesis/repo_updated/pytest/testing/example_scripts/config/collect_pytest_prefix/__init__.pyi,608.0,ModificationType.MODIFY,0,0,0,0,0,0,0,0,0,0,0,0,0,0.0,0.0,0.0,0.0,0.0,0.0,False
807,a4faac6c942f38613bca7b88176565da173d1ab2,/Users/sanika/Downloads/Master Thesis/repo_updated/pytest/testing/example_scripts/issue88_initial_file_multinodes/__init__.pyi,608.0,ModificationType.MODIFY,0,0,0,0,0,0,0,0,0,0,0,0,0,0.0,0.0,0.0,0.0,0.0,0.0,False
808,a4faac6c942f38613bca7b88176565da173d1ab2,/Users/sanika/Downloads/Master Thesis/repo_updated/pytest/testing/example_scripts/fixtures/fill_fixtures/test_extend_fixture_conftest_conftest/__init__.pyi,608.0,ModificationType.MODIFY,0,0,0,0,0,0,0,0,0,0,0,0,0,0.0,0.0,0.0,0.0,0.0,0.0,False
809,a4faac6c942f38613bca7b88176565da173d1ab2,/Users/sanika/Downloads/Master Thesis/repo_updated/pytest/testing/example_scripts/fixtures/fill_fixtures/test_extend_fixture_conftest_conftest/pkg/__init__.py,608.0,ModificationType.MODIFY,0,0,0,0,0,0,0,0,0,0,0,0,0,0.0,0.0,0.0,0.0,0.0,0.0,False
810,a4faac6c942f38613bca7b88176565da173d1ab2,/Users/sanika/Downloads/Master Thesis/repo_updated/pytest/testing/example_scripts/fixtures/fill_fixtures/test_extend_fixture_conftest_module/__init__.pyi,608.0,ModificationType.MODIFY,0,0,0,0,0,0,0,0,0,0,0,0,0,0.0,0.0,0.0,0.0,0.0,0.0,False
811,a4faac6c942f38613bca7b88176565da173d1ab2,/Users/sanika/Downloads/Master Thesis/repo_updated/pytest/testing/example_scripts/fixtures/fill_fixtures/test_conftest_funcargs_only_available_in_subdir/sub1/__init__.py,608.0,ModificationType.MODIFY,0,0,0,0,0,0,0,0,0,0,0,0,0,0.0,0.0,0.0,0.0,0.0,0.0,False
812,a4faac6c942f38613bca7b88176565da173d1ab2,/Users/sanika/Downloads/Master Thesis/repo_updated/pytest/testing/example_scripts/fixtures/fill_fixtures/test_conftest_funcargs_only_available_in_subdir/sub2/__init__.py,608.0,ModificationType.MODIFY,0,0,0,0,0,0,0,0,0,0,0,0,0,0.0,0.0,0.0,0.0,0.0,0.0,False
813,a4faac6c942f38613bca7b88176565da173d1ab2,/Users/sanika/Downloads/Master Thesis/repo_updated/pytest/testing/example_scripts/fixtures/custom_item/__init__.pyi,608.0,ModificationType.MODIFY,0,0,0,0,0,0,0,0,0,0,0,0,0,0.0,0.0,0.0,0.0,0.0,0.0,False
814,a4faac6c942f38613bca7b88176565da173d1ab2,/Users/sanika/Downloads/Master Thesis/repo_updated/pytest/testing/example_scripts/fixtures/custom_item/foo/__init__.py,608.0,ModificationType.MODIFY,0,0,0,0,0,0,0,0,0,0,0,0,0,0.0,0.0,0.0,0.0,0.0,0.0,False
815,a4faac6c942f38613bca7b88176565da173d1ab2,/Users/sanika/Downloads/Master Thesis/repo_updated/pytest/doc/en/example/nonpython/__init__.py,608.0,ModificationType.MODIFY,0,0,0,0,0,0,0,0,0,0,0,0,0,0.0,0.0,0.0,0.0,0.0,0.0,False
816,a4faac6c942f38613bca7b88176565da173d1ab2,/Users/sanika/Downloads/Master Thesis/repo_updated/pytest/src/pytest/__init__.py,608.0,ModificationType.MODIFY,99,48,90,1,3,5,100,0,0,0,0,0,0,0.0,0.0,0.0,0.0,0.0,0.0,False
817,a4faac6c942f38613bca7b88176565da173d1ab2,/Users/sanika/Downloads/Master Thesis/repo_updated/pytest/src/_pytest/__init__.py,608.0,ModificationType.MODIFY,8,5,5,2,0,1,10,0,0,0,0,0,0,0.0,0.0,0.0,0.0,0.0,0.0,False
818,a4faac6c942f38613bca7b88176565da173d1ab2,/Users/sanika/Downloads/Master Thesis/repo_updated/pytest/src/_pytest/config/__init__.py,608.0,ModificationType.MODIFY,1217,716,841,84,126,174,1301,14,185,118,215,199,333,1446.608539104324,2542.995998641035,8.135135135135135,20687.616097052745,1149.3120053918194,0.847665332880345,False
819,a4faac6c942f38613bca7b88176565da173d1ab2,/Users/sanika/Downloads/Master Thesis/repo_updated/pytest/src/_pytest/mark/__init__.py,608.0,ModificationType.MODIFY,160,89,115,0,13,31,160,7,15,11,17,22,28,78.25484338853101,124.86408532184431,3.966666666666667,495.29420510998256,27.516344728332356,0.04162136177394811,False
820,a4faac6c942f38613bca7b88176565da173d1ab2,/Users/sanika/Downloads/Master Thesis/repo_updated/pytest/src/_pytest/_code/__init__.py,608.0,ModificationType.MODIFY,10,10,9,9,0,0,19,0,0,0,0,0,0,0.0,0.0,0.0,0.0,0.0,0.0,False
821,a4faac6c942f38613bca7b88176565da173d1ab2,/Users/sanika/Downloads/Master Thesis/repo_updated/pytest/src/_pytest/assertion/__init__.py,608.0,ModificationType.MODIFY,173,84,99,8,29,36,181,5,12,7,13,17,20,54.62919048309069,81.7492568250068,2.708333333333333,221.40423723439343,12.300235401910744,0.027249752275002263,False
822,a4faac6c942f38613bca7b88176565da173d1ab2,/Users/sanika/Downloads/Master Thesis/repo_updated/pytest/src/_pytest/_io/__init__.py,608.0,ModificationType.MODIFY,3,1,1,3,0,0,6,0,0,0,0,0,0,0.0,0.0,0.0,0.0,0.0,0.0,False
823,cbc39dd86ecfc7ebfd25756f42adf4b9ef1121fc,/Users/sanika/Downloads/Master Thesis/repo_updated/pytest/testing/example_scripts/collect/package_infinite_recursion/__init__.pyi,608.0,ModificationType.MODIFY,0,0,0,0,0,0,0,0,0,0,0,0,0,0.0,0.0,0.0,0.0,0.0,0.0,False
824,cbc39dd86ecfc7ebfd25756f42adf4b9ef1121fc,/Users/sanika/Downloads/Master Thesis/repo_updated/pytest/testing/example_scripts/collect/package_infinite_recursion/tests/__init__.py,608.0,ModificationType.MODIFY,0,0,0,0,0,0,0,0,0,0,0,0,0,0.0,0.0,0.0,0.0,0.0,0.0,False
825,cbc39dd86ecfc7ebfd25756f42adf4b9ef1121fc,/Users/sanika/Downloads/Master Thesis/repo_updated/pytest/testing/example_scripts/collect/collect_init_tests/tests/__init__.py,608.0,ModificationType.MODIFY,2,2,2,0,0,0,2,0,0,0,0,0,0,0.0,0.0,0.0,0.0,0.0,0.0,False
826,cbc39dd86ecfc7ebfd25756f42adf4b9ef1121fc,/Users/sanika/Downloads/Master Thesis/repo_updated/pytest/testing/example_scripts/collect/package_init_given_as_arg/pkg/__init__.py,608.0,ModificationType.MODIFY,0,0,0,0,0,0,0,0,0,0,0,0,0,0.0,0.0,0.0,0.0,0.0,0.0,False
827,cbc39dd86ecfc7ebfd25756f42adf4b9ef1121fc,/Users/sanika/Downloads/Master Thesis/repo_updated/pytest/testing/example_scripts/conftest_usageerror/__init__.pyi,608.0,ModificationType.MODIFY,0,0,0,0,0,0,0,0,0,0,0,0,0,0.0,0.0,0.0,0.0,0.0,0.0,False
828,cbc39dd86ecfc7ebfd25756f42adf4b9ef1121fc,/Users/sanika/Downloads/Master Thesis/repo_updated/pytest/testing/example_scripts/marks/marks_considered_keywords/__init__.pyi,608.0,ModificationType.MODIFY,0,0,0,0,0,0,0,0,0,0,0,0,0,0.0,0.0,0.0,0.0,0.0,0.0,False
829,cbc39dd86ecfc7ebfd25756f42adf4b9ef1121fc,/Users/sanika/Downloads/Master Thesis/repo_updated/pytest/testing/example_scripts/config/collect_pytest_prefix/__init__.pyi,608.0,ModificationType.MODIFY,0,0,0,0,0,0,0,0,0,0,0,0,0,0.0,0.0,0.0,0.0,0.0,0.0,False
830,cbc39dd86ecfc7ebfd25756f42adf4b9ef1121fc,/Users/sanika/Downloads/Master Thesis/repo_updated/pytest/testing/example_scripts/issue88_initial_file_multinodes/__init__.pyi,608.0,ModificationType.MODIFY,0,0,0,0,0,0,0,0,0,0,0,0,0,0.0,0.0,0.0,0.0,0.0,0.0,False
831,cbc39dd86ecfc7ebfd25756f42adf4b9ef1121fc,/Users/sanika/Downloads/Master Thesis/repo_updated/pytest/testing/example_scripts/fixtures/fill_fixtures/test_extend_fixture_conftest_conftest/__init__.pyi,608.0,ModificationType.MODIFY,0,0,0,0,0,0,0,0,0,0,0,0,0,0.0,0.0,0.0,0.0,0.0,0.0,False
832,cbc39dd86ecfc7ebfd25756f42adf4b9ef1121fc,/Users/sanika/Downloads/Master Thesis/repo_updated/pytest/testing/example_scripts/fixtures/fill_fixtures/test_extend_fixture_conftest_conftest/pkg/__init__.py,608.0,ModificationType.MODIFY,0,0,0,0,0,0,0,0,0,0,0,0,0,0.0,0.0,0.0,0.0,0.0,0.0,False
833,cbc39dd86ecfc7ebfd25756f42adf4b9ef1121fc,/Users/sanika/Downloads/Master Thesis/repo_updated/pytest/testing/example_scripts/fixtures/fill_fixtures/test_extend_fixture_conftest_module/__init__.pyi,608.0,ModificationType.MODIFY,0,0,0,0,0,0,0,0,0,0,0,0,0,0.0,0.0,0.0,0.0,0.0,0.0,False
834,cbc39dd86ecfc7ebfd25756f42adf4b9ef1121fc,/Users/sanika/Downloads/Master Thesis/repo_updated/pytest/testing/example_scripts/fixtures/fill_fixtures/test_conftest_funcargs_only_available_in_subdir/sub1/__init__.py,608.0,ModificationType.MODIFY,0,0,0,0,0,0,0,0,0,0,0,0,0,0.0,0.0,0.0,0.0,0.0,0.0,False
835,cbc39dd86ecfc7ebfd25756f42adf4b9ef1121fc,/Users/sanika/Downloads/Master Thesis/repo_updated/pytest/testing/example_scripts/fixtures/fill_fixtures/test_conftest_funcargs_only_available_in_subdir/sub2/__init__.py,608.0,ModificationType.MODIFY,0,0,0,0,0,0,0,0,0,0,0,0,0,0.0,0.0,0.0,0.0,0.0,0.0,False
836,cbc39dd86ecfc7ebfd25756f42adf4b9ef1121fc,/Users/sanika/Downloads/Master Thesis/repo_updated/pytest/testing/example_scripts/fixtures/custom_item/__init__.pyi,608.0,ModificationType.MODIFY,0,0,0,0,0,0,0,0,0,0,0,0,0,0.0,0.0,0.0,0.0,0.0,0.0,False
837,cbc39dd86ecfc7ebfd25756f42adf4b9ef1121fc,/Users/sanika/Downloads/Master Thesis/repo_updated/pytest/testing/example_scripts/fixtures/custom_item/foo/__init__.py,608.0,ModificationType.MODIFY,0,0,0,0,0,0,0,0,0,0,0,0,0,0.0,0.0,0.0,0.0,0.0,0.0,False
838,cbc39dd86ecfc7ebfd25756f42adf4b9ef1121fc,/Users/sanika/Downloads/Master Thesis/repo_updated/pytest/doc/en/example/nonpython/__init__.py,608.0,ModificationType.MODIFY,0,0,0,0,0,0,0,0,0,0,0,0,0,0.0,0.0,0.0,0.0,0.0,0.0,False
839,cbc39dd86ecfc7ebfd25756f42adf4b9ef1121fc,/Users/sanika/Downloads/Master Thesis/repo_updated/pytest/src/pytest/__init__.py,608.0,ModificationType.MODIFY,99,48,90,1,3,5,100,0,0,0,0,0,0,0.0,0.0,0.0,0.0,0.0,0.0,False
840,cbc39dd86ecfc7ebfd25756f42adf4b9ef1121fc,/Users/sanika/Downloads/Master Thesis/repo_updated/pytest/src/_pytest/__init__.py,608.0,ModificationType.MODIFY,8,5,5,2,0,1,10,0,0,0,0,0,0,0.0,0.0,0.0,0.0,0.0,0.0,False
841,cbc39dd86ecfc7ebfd25756f42adf4b9ef1121fc,/Users/sanika/Downloads/Master Thesis/repo_updated/pytest/src/_pytest/config/__init__.py,608.0,ModificationType.MODIFY,1217,716,841,84,126,174,1301,14,185,118,215,199,333,1446.608539104324,2542.995998641035,8.135135135135135,20687.616097052745,1149.3120053918194,0.847665332880345,False
842,cbc39dd86ecfc7ebfd25756f42adf4b9ef1121fc,/Users/sanika/Downloads/Master Thesis/repo_updated/pytest/src/_pytest/mark/__init__.py,608.0,ModificationType.MODIFY,160,89,115,0,13,31,160,7,15,11,17,22,28,78.25484338853101,124.86408532184431,3.966666666666667,495.29420510998256,27.516344728332356,0.04162136177394811,False
843,cbc39dd86ecfc7ebfd25756f42adf4b9ef1121fc,/Users/sanika/Downloads/Master Thesis/repo_updated/pytest/src/_pytest/_code/__init__.py,608.0,ModificationType.MODIFY,10,10,9,9,0,0,19,0,0,0,0,0,0,0.0,0.0,0.0,0.0,0.0,0.0,False
844,cbc39dd86ecfc7ebfd25756f42adf4b9ef1121fc,/Users/sanika/Downloads/Master Thesis/repo_updated/pytest/src/_pytest/assertion/__init__.py,608.0,ModificationType.MODIFY,173,84,99,8,29,36,181,5,12,7,13,17,20,54.62919048309069,81.7492568250068,2.708333333333333,221.40423723439343,12.300235401910744,0.027249752275002263,False
845,cbc39dd86ecfc7ebfd25756f42adf4b9ef1121fc,/Users/sanika/Downloads/Master Thesis/repo_updated/pytest/src/_pytest/_io/__init__.py,608.0,ModificationType.MODIFY,3,1,1,3,0,0,6,0,0,0,0,0,0,0.0,0.0,0.0,0.0,0.0,0.0,False
846,886a3ad609e16bb69a5d0b02f285e4fb076ebcc6,/Users/sanika/Downloads/Master Thesis/repo_updated/pytest/testing/test_pytester.py,6063.0,ModificationType.MODIFY,722,423,573,19,0,135,741,12,172,101,199,184,300,1320.3370878174146,2257.068586817104,6.941860465116278,15668.255189881524,870.4586216600846,0.7523561956057013,False
847,886a3ad609e16bb69a5d0b02f285e4fb076ebcc6,/Users/sanika/Downloads/Master Thesis/repo_updated/pytest/src/_pytest/pytester.py,6063.0,ModificationType.MODIFY,1508,847,911,44,250,301,1552,14,148,88,169,162,257,1120.302067021891,1886.3414507413486,7.993243243243242,15077.986055587939,837.6658919771077,0.6287804835804495,False
848,886a3ad609e16bb69a5d0b02f285e4fb076ebcc6,/Users/sanika/Downloads/Master Thesis/repo_updated/pytest/testing/test_pytester.py,3231.0,ModificationType.MODIFY,722,423,573,19,0,135,741,12,172,101,199,184,300,1320.3370878174146,2257.068586817104,6.941860465116278,15668.255189881524,870.4586216600846,0.7523561956057013,False
849,d863c30c743138ed29cdf786cb18c41c24983fe1,/Users/sanika/Downloads/Master Thesis/repo_updated/pytest/testing/test_main.py,3484.0,ModificationType.MODIFY,77,34,69,0,0,8,77,3,24,16,29,27,45,114.79398751947123,213.9699375973561,1.8125,387.82051189520797,21.54558399417822,0.07132331253245204,False
850,d863c30c743138ed29cdf786cb18c41c24983fe1,/Users/sanika/Downloads/Master Thesis/repo_updated/pytest/src/_pytest/main.py,3484.0,ModificationType.MODIFY,712,438,573,51,9,84,763,14,102,71,128,116,199,733.8903537898989,1364.7382180303869,8.784313725490197,11988.288660345359,666.0160366858534,0.4549127393434623,False
851,d863c30c743138ed29cdf786cb18c41c24983fe1,/Users/sanika/Downloads/Master Thesis/repo_updated/pytest/testing/test_terminal.py,6223.0,ModificationType.MODIFY,1943,715,1694,26,18,214,1969,12,185,120,237,197,357,1436.3251202041715,2721.0724995459263,7.686486486486486,20915.486996509768,1161.971499806098,0.9070241665153088,False
852,d863c30c743138ed29cdf786cb18c41c24983fe1,/Users/sanika/Downloads/Master Thesis/repo_updated/pytest/src/_pytest/terminal.py,6223.0,ModificationType.MODIFY,1168,838,957,57,25,144,1225,19,348,224,416,367,640,3018.854959310786,5452.567201819657,11.35632183908046,61921.107993078396,3440.0615551710216,1.817522400606552,False
853,d863c30c743138ed29cdf786cb18c41c24983fe1,/Users/sanika/Downloads/Master Thesis/repo_updated/pytest/testing/acceptance_test.py,4670.0,ModificationType.MODIFY,1289,550,1043,56,32,155,1345,10,167,93,185,177,278,1266.2978977920407,2075.994342923073,5.538922155688622,11498.771061100857,638.8206145056031,0.6919981143076911,False
854,d863c30c743138ed29cdf786cb18c41c24983fe1,/Users/sanika/Downloads/Master Thesis/repo_updated/pytest/testing/python/collect.py,3928.0,ModificationType.MODIFY,1338,495,1086,10,64,173,1348,11,122,82,157,133,239,883.6037029876825,1686.2125020847845,7.077868852459017,11934.79094713288,663.0439415073823,0.5620708340282614,False
855,d863c30c743138ed29cdf786cb18c41c24983fe1,/Users/sanika/Downloads/Master Thesis/repo_updated/pytest/testing/python/fixtures.py,7999.0,ModificationType.MODIFY,4293,999,3693,19,54,507,4312,9,155,88,170,164,258,1156.3286078304875,1898.2484171914662,4.935483870967742,9368.774446138525,520.4874692299181,0.6327494723971553,False
856,d863c30c743138ed29cdf786cb18c41c24983fe1,/Users/sanika/Downloads/Master Thesis/repo_updated/pytest/src/_pytest/fixtures.py,7999.0,ModificationType.MODIFY,1482,859,1002,125,135,219,1607,16,219,134,251,235,385,1766.6783660526569,3032.459024427525,9.168949771689498,27804.46447968251,1544.692471093473,1.0108196748091751,False
857,d863c30c743138ed29cdf786cb18c41c24983fe1,/Users/sanika/Downloads/Master Thesis/repo_updated/pytest/testing/test_assertrewrite.py,6308.0,ModificationType.MODIFY,1660,832,1314,41,38,274,1701,20,312,209,395,332,604,2671.484054182769,5058.523816533542,12.660256410256409,64042.208574703494,3557.900476372417,1.6861746055111808,False
858,d863c30c743138ed29cdf786cb18c41c24983fe1,/Users/sanika/Downloads/Master Thesis/repo_updated/pytest/testing/test_capture.py,5072.0,ModificationType.MODIFY,1513,682,1277,25,13,200,1538,11,199,116,219,210,335,1557.7420472931965,2584.272248418151,6.052763819095478,15641.989563917903,868.9994202176613,0.8614240828060503,False
859,d863c30c743138ed29cdf786cb18c41c24983fe1,/Users/sanika/Downloads/Master Thesis/repo_updated/pytest/testing/test_collection.py,4935.0,ModificationType.MODIFY,1296,573,1062,40,33,157,1336,8,201,118,231,209,349,1561.8613899269644,2689.868337096228,4.597014925373134,12365.364892919973,686.9647162733319,0.896622779032076,False
860,d863c30c743138ed29cdf786cb18c41c24983fe1,/Users/sanika/Downloads/Master Thesis/repo_updated/pytest/testing/test_doctest.py,3715.0,ModificationType.MODIFY,1455,414,1257,16,76,112,1471,5,41,23,46,46,69,231.26927266377825,381.12577496793386,2.804878048780488,1069.0113200320095,59.3895177795561,0.1270419249893113,False
861,d863c30c743138ed29cdf786cb18c41c24983fe1,/Users/sanika/Downloads/Master Thesis/repo_updated/pytest/testing/test_mark.py,3090.0,ModificationType.MODIFY,1020,354,843,12,15,144,1032,8,134,77,144,142,221,970.8559515213416,1580.0941134105346,4.298507462686567,6792.0463382422995,377.3359076801278,0.5266980378035117,False
862,d863c30c743138ed29cdf786cb18c41c24983fe1,/Users/sanika/Downloads/Master Thesis/repo_updated/pytest/testing/test_runner_xunit.py,463.0,ModificationType.MODIFY,295,56,236,0,4,54,295,2,9,5,10,11,15,30.52932501298081,51.89147427955947,1.1111111111111112,57.657193643954976,3.203177424664165,0.01729715809318649,False
863,d863c30c743138ed29cdf786cb18c41c24983fe1,/Users/sanika/Downloads/Master Thesis/repo_updated/pytest/testing/test_skipping.py,3068.0,ModificationType.MODIFY,1178,367,1042,6,15,115,1184,9,94,51,95,103,146,644.6606770706788,976.22907696875,4.547872340425532,4439.7652170653255,246.65362317029587,0.3254096923229167,False
864,d863c30c743138ed29cdf786cb18c41c24983fe1,/Users/sanika/Downloads/Master Thesis/repo_updated/pytest/testing/test_stepwise.py,645.0,ModificationType.MODIFY,219,78,157,11,5,46,230,3,24,20,34,27,54,114.79398751947123,256.7639251168273,2.125,545.6233408732581,30.31240782629212,0.08558797503894246,False
865,d863c30c743138ed29cdf786cb18c41c24983fe1,/Users/sanika/Downloads/Master Thesis/repo_updated/pytest/testing/test_terminal.py,6661.0,ModificationType.MODIFY,1943,715,1694,26,18,214,1969,12,185,120,237,197,357,1436.3251202041715,2721.0724995459263,7.686486486486486,20915.486996509768,1161.971499806098,0.9070241665153088,False
866,d863c30c743138ed29cdf786cb18c41c24983fe1,/Users/sanika/Downloads/Master Thesis/repo_updated/pytest/testing/test_warnings.py,1706.0,ModificationType.MODIFY,601,196,481,2,23,85,603,8,63,36,72,71,108,400.5686351804948,664.1726889065056,4.571428571428571,3036.21800642974,168.67877813498555,0.22139089630216852,False
867,820b747e7a14e441bb0e499eff51de65973252d0,/Users/sanika/Downloads/Master Thesis/repo_updated/pytest/testing/test_capture.py,4999.0,ModificationType.MODIFY,1513,682,1277,25,13,200,1538,11,199,116,219,210,335,1557.7420472931965,2584.272248418151,6.052763819095478,15641.989563917903,868.9994202176613,0.8614240828060503,False
868,716f532a3871ef45655c327f483f9b1897c4d73f,/Users/sanika/Downloads/Master Thesis/repo_updated/pytest/testing/test_pytester.py,5973.0,ModificationType.MODIFY,722,423,573,19,0,135,741,12,172,101,199,184,300,1320.3370878174146,2257.068586817104,6.941860465116278,15668.255189881524,870.4586216600846,0.7523561956057013,False
869,716f532a3871ef45655c327f483f9b1897c4d73f,/Users/sanika/Downloads/Master Thesis/repo_updated/pytest/src/_pytest/pytester.py,5973.0,ModificationType.MODIFY,1508,847,911,44,250,301,1552,14,148,88,169,162,257,1120.302067021891,1886.3414507413486,7.993243243243242,15077.986055587939,837.6658919771077,0.6287804835804495,False
870,ec273637481f7df64198539510b0b3e5c1e5e849,/Users/sanika/Downloads/Master Thesis/repo_updated/pytest/testing/test_pytester.py,6047.0,ModificationType.MODIFY,722,423,573,19,0,135,741,12,172,101,199,184,300,1320.3370878174146,2257.068586817104,6.941860465116278,15668.255189881524,870.4586216600846,0.7523561956057013,False
871,ec273637481f7df64198539510b0b3e5c1e5e849,/Users/sanika/Downloads/Master Thesis/repo_updated/pytest/src/_pytest/pytester.py,6047.0,ModificationType.MODIFY,1508,847,911,44,250,301,1552,14,148,88,169,162,257,1120.302067021891,1886.3414507413486,7.993243243243242,15077.986055587939,837.6658919771077,0.6287804835804495,False
872,ec273637481f7df64198539510b0b3e5c1e5e849,/Users/sanika/Downloads/Master Thesis/repo_updated/pytest/testing/test_pytester.py,3231.0,ModificationType.MODIFY,722,423,573,19,0,135,741,12,172,101,199,184,300,1320.3370878174146,2257.068586817104,6.941860465116278,15668.255189881524,870.4586216600846,0.7523561956057013,False
873,32412532ef58fbaf7a43a766e20fbf94da21feee,/Users/sanika/Downloads/Master Thesis/repo_updated/pytest/testing/python/approx.py,4366.0,ModificationType.MODIFY,520,294,400,33,13,81,553,10,261,204,367,271,571,2128.502746053614,4614.9071026130605,7.030651340996169,32445.802809559264,1802.5446005310705,1.5383023675376872,False
874,a5bd19e3b406f45ffaadf7e1d257b90f11e5931f,/Users/sanika/Downloads/Master Thesis/repo_updated/pytest/testing/python/approx.py,4372.0,ModificationType.MODIFY,520,294,400,33,13,81,553,10,261,204,367,271,571,2128.502746053614,4614.9071026130605,7.030651340996169,32445.802809559264,1802.5446005310705,1.5383023675376872,False
875,d6e324a5e640382bcfcf6b2abeb024577edc01c3,/Users/sanika/Downloads/Master Thesis/repo_updated/pytest/testing/conftest.py,400.0,ModificationType.MODIFY,127,75,83,2,11,30,129,4,14,7,14,18,21,61.302968908806456,87.56842503028854,2.0,175.13685006057707,9.729825003365397,0.02918947501009618,False
876,d6e324a5e640382bcfcf6b2abeb024577edc01c3,/Users/sanika/Downloads/Master Thesis/repo_updated/pytest/testing/test_conftest.py,400.0,ModificationType.MODIFY,652,304,544,16,6,88,668,6,89,51,101,95,152,591.8500503603364,998.618052466304,3.4044943820224716,3399.789549407755,188.87719718931967,0.3328726841554347,False
877,d6e324a5e640382bcfcf6b2abeb024577edc01c3,/Users/sanika/Downloads/Master Thesis/repo_updated/pytest/testing/example_scripts/collect/package_infinite_recursion/conftest.py,400.0,ModificationType.MODIFY,2,2,2,0,0,0,2,0,0,0,0,0,0,0.0,0.0,0.0,0.0,0.0,0.0,False
878,d6e324a5e640382bcfcf6b2abeb024577edc01c3,/Users/sanika/Downloads/Master Thesis/repo_updated/pytest/testing/example_scripts/conftest_usageerror/conftest.py,400.0,ModificationType.MODIFY,8,5,5,0,0,3,8,0,0,0,0,0,0,0.0,0.0,0.0,0.0,0.0,0.0,False
879,d6e324a5e640382bcfcf6b2abeb024577edc01c3,/Users/sanika/Downloads/Master Thesis/repo_updated/pytest/testing/example_scripts/marks/marks_considered_keywords/conftest.py,400.0,ModificationType.MODIFY,0,0,0,0,0,0,0,0,0,0,0,0,0,0.0,0.0,0.0,0.0,0.0,0.0,False
880,d6e324a5e640382bcfcf6b2abeb024577edc01c3,/Users/sanika/Downloads/Master Thesis/repo_updated/pytest/testing/example_scripts/config/collect_pytest_prefix/conftest.py,400.0,ModificationType.MODIFY,2,2,2,0,0,0,2,0,0,0,0,0,0,0.0,0.0,0.0,0.0,0.0,0.0,False
881,d6e324a5e640382bcfcf6b2abeb024577edc01c3,/Users/sanika/Downloads/Master Thesis/repo_updated/pytest/testing/example_scripts/issue88_initial_file_multinodes/conftest.py,400.0,ModificationType.MODIFY,14,8,8,0,0,6,14,0,0,0,0,0,0,0.0,0.0,0.0,0.0,0.0,0.0,False
882,d6e324a5e640382bcfcf6b2abeb024577edc01c3,/Users/sanika/Downloads/Master Thesis/repo_updated/pytest/testing/example_scripts/fixtures/fill_fixtures/test_extend_fixture_conftest_conftest/conftest.py,400.0,ModificationType.MODIFY,6,4,4,0,0,2,6,0,0,0,0,0,0,0.0,0.0,0.0,0.0,0.0,0.0,False
883,d6e324a5e640382bcfcf6b2abeb024577edc01c3,/Users/sanika/Downloads/Master Thesis/repo_updated/pytest/testing/example_scripts/fixtures/fill_fixtures/test_extend_fixture_conftest_conftest/pkg/conftest.py,400.0,ModificationType.MODIFY,6,4,4,0,0,2,6,1,2,1,2,3,3,2.0,4.754887502163468,0.5,2.3774437510817346,0.1320802083934297,0.0015849625007211565,False
884,d6e324a5e640382bcfcf6b2abeb024577edc01c3,/Users/sanika/Downloads/Master Thesis/repo_updated/pytest/testing/example_scripts/fixtures/fill_fixtures/test_extend_fixture_conftest_module/conftest.py,400.0,ModificationType.MODIFY,6,4,4,0,0,2,6,0,0,0,0,0,0,0.0,0.0,0.0,0.0,0.0,0.0,False
885,d6e324a5e640382bcfcf6b2abeb024577edc01c3,/Users/sanika/Downloads/Master Thesis/repo_updated/pytest/testing/example_scripts/fixtures/fill_fixtures/test_conftest_funcargs_only_available_in_subdir/sub1/conftest.py,400.0,ModificationType.MODIFY,7,5,5,0,0,2,7,0,0,0,0,0,0,0.0,0.0,0.0,0.0,0.0,0.0,False
886,d6e324a5e640382bcfcf6b2abeb024577edc01c3,/Users/sanika/Downloads/Master Thesis/repo_updated/pytest/testing/example_scripts/fixtures/fill_fixtures/test_conftest_funcargs_only_available_in_subdir/sub2/conftest.py,400.0,ModificationType.MODIFY,6,4,4,0,0,2,6,0,0,0,0,0,0,0.0,0.0,0.0,0.0,0.0,0.0,False
887,d6e324a5e640382bcfcf6b2abeb024577edc01c3,/Users/sanika/Downloads/Master Thesis/repo_updated/pytest/testing/example_scripts/fixtures/custom_item/conftest.py,400.0,ModificationType.MODIFY,10,6,6,0,0,4,10,0,0,0,0,0,0,0.0,0.0,0.0,0.0,0.0,0.0,False
888,d6e324a5e640382bcfcf6b2abeb024577edc01c3,/Users/sanika/Downloads/Master Thesis/repo_updated/pytest/doc/en/conftest.py,400.0,ModificationType.MODIFY,1,1,1,0,0,0,1,0,0,0,0,0,0,0.0,0.0,0.0,0.0,0.0,0.0,False
889,d6e324a5e640382bcfcf6b2abeb024577edc01c3,/Users/sanika/Downloads/Master Thesis/repo_updated/pytest/doc/en/example/conftest.py,400.0,ModificationType.MODIFY,1,1,1,0,0,0,1,0,0,0,0,0,0,0.0,0.0,0.0,0.0,0.0,0.0,False
890,d6e324a5e640382bcfcf6b2abeb024577edc01c3,/Users/sanika/Downloads/Master Thesis/repo_updated/pytest/doc/en/example/assertion/global_testmodule_config/conftest.py,400.0,ModificationType.MODIFY,14,10,10,0,0,4,14,1,1,1,1,2,2,0.0,2.0,0.5,1.0,0.05555555555555555,0.0006666666666666666,False
891,d6e324a5e640382bcfcf6b2abeb024577edc01c3,/Users/sanika/Downloads/Master Thesis/repo_updated/pytest/doc/en/example/nonpython/conftest.py,400.0,ModificationType.MODIFY,46,26,30,3,0,12,49,3,6,3,6,9,9,20.264662506490406,28.52932501298081,1.5,42.79398751947122,2.377443751081734,0.009509775004326938,False
892,a4554e666af4d62500bec2bae393fc9e67e2d4d8,/Users/sanika/Downloads/Master Thesis/repo_updated/pytest/testing/test_faulthandler.py,310.0,ModificationType.MODIFY,103,47,73,2,12,15,105,5,16,9,17,21,26,75.60964047443682,114.20025299224777,2.65625,303.3444220106581,16.85246788948101,0.03806675099741593,False
893,7f8bf4d9f6de201ace76162c62217a8f72661b40,/Users/sanika/Downloads/Master Thesis/repo_updated/pytest/testing/test_pathlib.py,1550.0,ModificationType.MODIFY,91,45,69,0,3,18,91,3,9,6,10,12,16,33.28421251514428,57.3594000115385,1.6666666666666667,95.59900001923084,5.311055556623936,0.01911980000384617,False
894,7f8bf4d9f6de201ace76162c62217a8f72661b40,/Users/sanika/Downloads/Master Thesis/repo_updated/pytest/src/_pytest/pathlib.py,1550.0,ModificationType.MODIFY,367,234,237,17,34,68,384,16,55,34,61,71,95,381.9747842438563,584.2259763529447,8.872727272727273,5183.677753822492,287.98209743458284,0.19474199211764828,False
895,7f8bf4d9f6de201ace76162c62217a8f72661b40,/Users/sanika/Downloads/Master Thesis/repo_updated/pytest/testing/test_tmpdir.py,704.0,ModificationType.MODIFY,442,244,305,14,16,103,456,11,68,45,75,79,120,452.00122101003336,756.4536897812525,6.066176470588236,4588.781574040686,254.932309668927,0.2521512299270841,False
896,7f8bf4d9f6de201ace76162c62217a8f72661b40,/Users/sanika/Downloads/Master Thesis/repo_updated/pytest/src/_pytest/tmpdir.py,704.0,ModificationType.MODIFY,182,102,99,11,40,35,193,3,11,6,11,14,17,42.808635307173745,64.72503367497926,1.5,97.08755051246887,5.393752806248272,0.021575011224993085,False
897,60ceec6eb180ba1ac76741edf82804ed9ae8baf2,/Users/sanika/Downloads/Master Thesis/repo_updated/pytest/testing/test_capture.py,5072.0,ModificationType.MODIFY,1513,682,1277,25,13,200,1538,11,199,116,219,210,335,1557.7420472931965,2584.272248418151,6.052763819095478,15641.989563917903,868.9994202176613,0.8614240828060503,False
898,6d33f4cdce6db22a00810736fb4028a6c7eab2fa,/Users/sanika/Downloads/Master Thesis/repo_updated/pytest/testing/conftest.py,400.0,ModificationType.MODIFY,127,75,83,2,11,30,129,4,14,7,14,18,21,61.302968908806456,87.56842503028854,2.0,175.13685006057707,9.729825003365397,0.02918947501009618,False
899,6d33f4cdce6db22a00810736fb4028a6c7eab2fa,/Users/sanika/Downloads/Master Thesis/repo_updated/pytest/testing/test_conftest.py,400.0,ModificationType.MODIFY,652,304,544,16,6,88,668,6,89,51,101,95,152,591.8500503603364,998.618052466304,3.4044943820224716,3399.789549407755,188.87719718931967,0.3328726841554347,False
900,6d33f4cdce6db22a00810736fb4028a6c7eab2fa,/Users/sanika/Downloads/Master Thesis/repo_updated/pytest/testing/example_scripts/collect/package_infinite_recursion/conftest.py,400.0,ModificationType.MODIFY,2,2,2,0,0,0,2,0,0,0,0,0,0,0.0,0.0,0.0,0.0,0.0,0.0,False
901,6d33f4cdce6db22a00810736fb4028a6c7eab2fa,/Users/sanika/Downloads/Master Thesis/repo_updated/pytest/testing/example_scripts/conftest_usageerror/conftest.py,400.0,ModificationType.MODIFY,8,5,5,0,0,3,8,0,0,0,0,0,0,0.0,0.0,0.0,0.0,0.0,0.0,False
902,6d33f4cdce6db22a00810736fb4028a6c7eab2fa,/Users/sanika/Downloads/Master Thesis/repo_updated/pytest/testing/example_scripts/marks/marks_considered_keywords/conftest.py,400.0,ModificationType.MODIFY,0,0,0,0,0,0,0,0,0,0,0,0,0,0.0,0.0,0.0,0.0,0.0,0.0,False
903,6d33f4cdce6db22a00810736fb4028a6c7eab2fa,/Users/sanika/Downloads/Master Thesis/repo_updated/pytest/testing/example_scripts/config/collect_pytest_prefix/conftest.py,400.0,ModificationType.MODIFY,2,2,2,0,0,0,2,0,0,0,0,0,0,0.0,0.0,0.0,0.0,0.0,0.0,False
904,6d33f4cdce6db22a00810736fb4028a6c7eab2fa,/Users/sanika/Downloads/Master Thesis/repo_updated/pytest/testing/example_scripts/issue88_initial_file_multinodes/conftest.py,400.0,ModificationType.MODIFY,14,8,8,0,0,6,14,0,0,0,0,0,0,0.0,0.0,0.0,0.0,0.0,0.0,False
905,6d33f4cdce6db22a00810736fb4028a6c7eab2fa,/Users/sanika/Downloads/Master Thesis/repo_updated/pytest/testing/example_scripts/fixtures/fill_fixtures/test_extend_fixture_conftest_conftest/conftest.py,400.0,ModificationType.MODIFY,6,4,4,0,0,2,6,0,0,0,0,0,0,0.0,0.0,0.0,0.0,0.0,0.0,False
906,6d33f4cdce6db22a00810736fb4028a6c7eab2fa,/Users/sanika/Downloads/Master Thesis/repo_updated/pytest/testing/example_scripts/fixtures/fill_fixtures/test_extend_fixture_conftest_conftest/pkg/conftest.py,400.0,ModificationType.MODIFY,6,4,4,0,0,2,6,1,2,1,2,3,3,2.0,4.754887502163468,0.5,2.3774437510817346,0.1320802083934297,0.0015849625007211565,False
907,6d33f4cdce6db22a00810736fb4028a6c7eab2fa,/Users/sanika/Downloads/Master Thesis/repo_updated/pytest/testing/example_scripts/fixtures/fill_fixtures/test_extend_fixture_conftest_module/conftest.py,400.0,ModificationType.MODIFY,6,4,4,0,0,2,6,0,0,0,0,0,0,0.0,0.0,0.0,0.0,0.0,0.0,False
908,6d33f4cdce6db22a00810736fb4028a6c7eab2fa,/Users/sanika/Downloads/Master Thesis/repo_updated/pytest/testing/example_scripts/fixtures/fill_fixtures/test_conftest_funcargs_only_available_in_subdir/sub1/conftest.py,400.0,ModificationType.MODIFY,7,5,5,0,0,2,7,0,0,0,0,0,0,0.0,0.0,0.0,0.0,0.0,0.0,False
909,6d33f4cdce6db22a00810736fb4028a6c7eab2fa,/Users/sanika/Downloads/Master Thesis/repo_updated/pytest/testing/example_scripts/fixtures/fill_fixtures/test_conftest_funcargs_only_available_in_subdir/sub2/conftest.py,400.0,ModificationType.MODIFY,6,4,4,0,0,2,6,0,0,0,0,0,0,0.0,0.0,0.0,0.0,0.0,0.0,False
910,6d33f4cdce6db22a00810736fb4028a6c7eab2fa,/Users/sanika/Downloads/Master Thesis/repo_updated/pytest/testing/example_scripts/fixtures/custom_item/conftest.py,400.0,ModificationType.MODIFY,10,6,6,0,0,4,10,0,0,0,0,0,0,0.0,0.0,0.0,0.0,0.0,0.0,False
911,6d33f4cdce6db22a00810736fb4028a6c7eab2fa,/Users/sanika/Downloads/Master Thesis/repo_updated/pytest/doc/en/conftest.py,400.0,ModificationType.MODIFY,1,1,1,0,0,0,1,0,0,0,0,0,0,0.0,0.0,0.0,0.0,0.0,0.0,False
912,6d33f4cdce6db22a00810736fb4028a6c7eab2fa,/Users/sanika/Downloads/Master Thesis/repo_updated/pytest/doc/en/example/conftest.py,400.0,ModificationType.MODIFY,1,1,1,0,0,0,1,0,0,0,0,0,0,0.0,0.0,0.0,0.0,0.0,0.0,False
913,6d33f4cdce6db22a00810736fb4028a6c7eab2fa,/Users/sanika/Downloads/Master Thesis/repo_updated/pytest/doc/en/example/assertion/global_testmodule_config/conftest.py,400.0,ModificationType.MODIFY,14,10,10,0,0,4,14,1,1,1,1,2,2,0.0,2.0,0.5,1.0,0.05555555555555555,0.0006666666666666666,False
914,6d33f4cdce6db22a00810736fb4028a6c7eab2fa,/Users/sanika/Downloads/Master Thesis/repo_updated/pytest/doc/en/example/nonpython/conftest.py,400.0,ModificationType.MODIFY,46,26,30,3,0,12,49,3,6,3,6,9,9,20.264662506490406,28.52932501298081,1.5,42.79398751947122,2.377443751081734,0.009509775004326938,False
915,e7898dedf40c294faceee25963183c61c745e976,/Users/sanika/Downloads/Master Thesis/repo_updated/pytest/testing/test_capture.py,5072.0,ModificationType.MODIFY,1513,682,1277,25,13,200,1538,11,199,116,219,210,335,1557.7420472931965,2584.272248418151,6.052763819095478,15641.989563917903,868.9994202176613,0.8614240828060503,False
916,cdc53da19c586e62fc17900c77165fcb1592257c,/Users/sanika/Downloads/Master Thesis/repo_updated/pytest/testing/test_main.py,3484.0,ModificationType.MODIFY,77,34,69,0,0,8,77,3,24,16,29,27,45,114.79398751947123,213.9699375973561,1.8125,387.82051189520797,21.54558399417822,0.07132331253245204,False
917,cdc53da19c586e62fc17900c77165fcb1592257c,/Users/sanika/Downloads/Master Thesis/repo_updated/pytest/src/_pytest/main.py,3484.0,ModificationType.MODIFY,712,438,573,51,9,84,763,14,102,71,128,116,199,733.8903537898989,1364.7382180303869,8.784313725490197,11988.288660345359,666.0160366858534,0.4549127393434623,False
918,cdc53da19c586e62fc17900c77165fcb1592257c,/Users/sanika/Downloads/Master Thesis/repo_updated/pytest/testing/test_terminal.py,6223.0,ModificationType.MODIFY,1943,715,1694,26,18,214,1969,12,185,120,237,197,357,1436.3251202041715,2721.0724995459263,7.686486486486486,20915.486996509768,1161.971499806098,0.9070241665153088,False
919,cdc53da19c586e62fc17900c77165fcb1592257c,/Users/sanika/Downloads/Master Thesis/repo_updated/pytest/src/_pytest/terminal.py,6223.0,ModificationType.MODIFY,1168,838,957,57,25,144,1225,19,348,224,416,367,640,3018.854959310786,5452.567201819657,11.35632183908046,61921.107993078396,3440.0615551710216,1.817522400606552,False
920,cdc53da19c586e62fc17900c77165fcb1592257c,/Users/sanika/Downloads/Master Thesis/repo_updated/pytest/testing/acceptance_test.py,4670.0,ModificationType.MODIFY,1289,550,1043,56,32,155,1345,10,167,93,185,177,278,1266.2978977920407,2075.994342923073,5.538922155688622,11498.771061100857,638.8206145056031,0.6919981143076911,False
921,cdc53da19c586e62fc17900c77165fcb1592257c,/Users/sanika/Downloads/Master Thesis/repo_updated/pytest/testing/python/collect.py,3928.0,ModificationType.MODIFY,1338,495,1086,10,64,173,1348,11,122,82,157,133,239,883.6037029876825,1686.2125020847845,7.077868852459017,11934.79094713288,663.0439415073823,0.5620708340282614,False
922,cdc53da19c586e62fc17900c77165fcb1592257c,/Users/sanika/Downloads/Master Thesis/repo_updated/pytest/testing/python/fixtures.py,7999.0,ModificationType.MODIFY,4293,999,3693,19,54,507,4312,9,155,88,170,164,258,1156.3286078304875,1898.2484171914662,4.935483870967742,9368.774446138525,520.4874692299181,0.6327494723971553,False
923,cdc53da19c586e62fc17900c77165fcb1592257c,/Users/sanika/Downloads/Master Thesis/repo_updated/pytest/src/_pytest/fixtures.py,7999.0,ModificationType.MODIFY,1482,859,1002,125,135,219,1607,16,219,134,251,235,385,1766.6783660526569,3032.459024427525,9.168949771689498,27804.46447968251,1544.692471093473,1.0108196748091751,False
924,cdc53da19c586e62fc17900c77165fcb1592257c,/Users/sanika/Downloads/Master Thesis/repo_updated/pytest/testing/test_assertrewrite.py,6308.0,ModificationType.MODIFY,1660,832,1314,41,38,274,1701,20,312,209,395,332,604,2671.484054182769,5058.523816533542,12.660256410256409,64042.208574703494,3557.900476372417,1.6861746055111808,False
925,cdc53da19c586e62fc17900c77165fcb1592257c,/Users/sanika/Downloads/Master Thesis/repo_updated/pytest/testing/test_capture.py,5072.0,ModificationType.MODIFY,1513,682,1277,25,13,200,1538,11,199,116,219,210,335,1557.7420472931965,2584.272248418151,6.052763819095478,15641.989563917903,868.9994202176613,0.8614240828060503,False
926,cdc53da19c586e62fc17900c77165fcb1592257c,/Users/sanika/Downloads/Master Thesis/repo_updated/pytest/testing/test_collection.py,4935.0,ModificationType.MODIFY,1296,573,1062,40,33,157,1336,8,201,118,231,209,349,1561.8613899269644,2689.868337096228,4.597014925373134,12365.364892919973,686.9647162733319,0.896622779032076,False
927,cdc53da19c586e62fc17900c77165fcb1592257c,/Users/sanika/Downloads/Master Thesis/repo_updated/pytest/testing/test_doctest.py,3715.0,ModificationType.MODIFY,1455,414,1257,16,76,112,1471,5,41,23,46,46,69,231.26927266377825,381.12577496793386,2.804878048780488,1069.0113200320095,59.3895177795561,0.1270419249893113,False
928,cdc53da19c586e62fc17900c77165fcb1592257c,/Users/sanika/Downloads/Master Thesis/repo_updated/pytest/testing/test_mark.py,3090.0,ModificationType.MODIFY,1020,354,843,12,15,144,1032,8,134,77,144,142,221,970.8559515213416,1580.0941134105346,4.298507462686567,6792.0463382422995,377.3359076801278,0.5266980378035117,False
929,cdc53da19c586e62fc17900c77165fcb1592257c,/Users/sanika/Downloads/Master Thesis/repo_updated/pytest/testing/test_runner_xunit.py,463.0,ModificationType.MODIFY,295,56,236,0,4,54,295,2,9,5,10,11,15,30.52932501298081,51.89147427955947,1.1111111111111112,57.657193643954976,3.203177424664165,0.01729715809318649,False
930,cdc53da19c586e62fc17900c77165fcb1592257c,/Users/sanika/Downloads/Master Thesis/repo_updated/pytest/testing/test_skipping.py,3068.0,ModificationType.MODIFY,1178,367,1042,6,15,115,1184,9,94,51,95,103,146,644.6606770706788,976.22907696875,4.547872340425532,4439.7652170653255,246.65362317029587,0.3254096923229167,False
931,cdc53da19c586e62fc17900c77165fcb1592257c,/Users/sanika/Downloads/Master Thesis/repo_updated/pytest/testing/test_stepwise.py,645.0,ModificationType.MODIFY,219,78,157,11,5,46,230,3,24,20,34,27,54,114.79398751947123,256.7639251168273,2.125,545.6233408732581,30.31240782629212,0.08558797503894246,False
932,cdc53da19c586e62fc17900c77165fcb1592257c,/Users/sanika/Downloads/Master Thesis/repo_updated/pytest/testing/test_terminal.py,6661.0,ModificationType.MODIFY,1943,715,1694,26,18,214,1969,12,185,120,237,197,357,1436.3251202041715,2721.0724995459263,7.686486486486486,20915.486996509768,1161.971499806098,0.9070241665153088,False
933,cdc53da19c586e62fc17900c77165fcb1592257c,/Users/sanika/Downloads/Master Thesis/repo_updated/pytest/testing/test_warnings.py,1706.0,ModificationType.MODIFY,601,196,481,2,23,85,603,8,63,36,72,71,108,400.5686351804948,664.1726889065056,4.571428571428571,3036.21800642974,168.67877813498555,0.22139089630216852,False
934,6d2cabae5752d7bf8e7f5b1b1c43ee41ec1ac067,/Users/sanika/Downloads/Master Thesis/repo_updated/pytest/testing/test_skipping.py,786.0,ModificationType.MODIFY,1178,367,1042,6,15,115,1184,9,94,51,95,103,146,644.6606770706788,976.22907696875,4.547872340425532,4439.7652170653255,246.65362317029587,0.3254096923229167,False
935,6d2cabae5752d7bf8e7f5b1b1c43ee41ec1ac067,/Users/sanika/Downloads/Master Thesis/repo_updated/pytest/src/_pytest/skipping.py,786.0,ModificationType.MODIFY,177,108,140,8,0,27,185,6,30,16,32,36,48,162.7164928725825,248.15640006923095,3.2,794.1004802215393,44.11669334564107,0.082718800023077,False
936,6d2cabae5752d7bf8e7f5b1b1c43ee41ec1ac067,/Users/sanika/Downloads/Master Thesis/repo_updated/pytest/testing/test_terminal.py,6221.0,ModificationType.MODIFY,1943,715,1694,26,18,214,1969,12,185,120,237,197,357,1436.3251202041715,2721.0724995459263,7.686486486486486,20915.486996509768,1161.971499806098,0.9070241665153088,False
937,6d2cabae5752d7bf8e7f5b1b1c43ee41ec1ac067,/Users/sanika/Downloads/Master Thesis/repo_updated/pytest/src/_pytest/terminal.py,6221.0,ModificationType.MODIFY,1168,838,957,57,25,144,1225,19,348,224,416,367,640,3018.854959310786,5452.567201819657,11.35632183908046,61921.107993078396,3440.0615551710216,1.817522400606552,False
938,6d2cabae5752d7bf8e7f5b1b1c43ee41ec1ac067,/Users/sanika/Downloads/Master Thesis/repo_updated/pytest/testing/test_skipping.py,3071.0,ModificationType.MODIFY,1178,367,1042,6,15,115,1184,9,94,51,95,103,146,644.6606770706788,976.22907696875,4.547872340425532,4439.7652170653255,246.65362317029587,0.3254096923229167,False
939,8c21416798af488da173b2b1c98b5435c0865660,/Users/sanika/Downloads/Master Thesis/repo_updated/pytest/testing/test_capture.py,5079.0,ModificationType.MODIFY,1513,682,1277,25,13,200,1538,11,199,116,219,210,335,1557.7420472931965,2584.272248418151,6.052763819095478,15641.989563917903,868.9994202176613,0.8614240828060503,False
940,b99661b9d77fbbc9ecb70d48a61a2a88eb0cd055,/Users/sanika/Downloads/Master Thesis/repo_updated/pytest/testing/example_scripts/collect/package_infinite_recursion/__init__.pyi,5071.0,ModificationType.MODIFY,0,0,0,0,0,0,0,0,0,0,0,0,0,0.0,0.0,0.0,0.0,0.0,0.0,False
941,b99661b9d77fbbc9ecb70d48a61a2a88eb0cd055,/Users/sanika/Downloads/Master Thesis/repo_updated/pytest/testing/example_scripts/collect/package_infinite_recursion/tests/__init__.py,5071.0,ModificationType.MODIFY,0,0,0,0,0,0,0,0,0,0,0,0,0,0.0,0.0,0.0,0.0,0.0,0.0,False
942,b99661b9d77fbbc9ecb70d48a61a2a88eb0cd055,/Users/sanika/Downloads/Master Thesis/repo_updated/pytest/testing/example_scripts/collect/collect_init_tests/tests/__init__.py,5071.0,ModificationType.MODIFY,2,2,2,0,0,0,2,0,0,0,0,0,0,0.0,0.0,0.0,0.0,0.0,0.0,False
943,b99661b9d77fbbc9ecb70d48a61a2a88eb0cd055,/Users/sanika/Downloads/Master Thesis/repo_updated/pytest/testing/example_scripts/collect/package_init_given_as_arg/pkg/__init__.py,5071.0,ModificationType.MODIFY,0,0,0,0,0,0,0,0,0,0,0,0,0,0.0,0.0,0.0,0.0,0.0,0.0,False
944,b99661b9d77fbbc9ecb70d48a61a2a88eb0cd055,/Users/sanika/Downloads/Master Thesis/repo_updated/pytest/testing/example_scripts/conftest_usageerror/__init__.pyi,5071.0,ModificationType.MODIFY,0,0,0,0,0,0,0,0,0,0,0,0,0,0.0,0.0,0.0,0.0,0.0,0.0,False
945,b99661b9d77fbbc9ecb70d48a61a2a88eb0cd055,/Users/sanika/Downloads/Master Thesis/repo_updated/pytest/testing/example_scripts/marks/marks_considered_keywords/__init__.pyi,5071.0,ModificationType.MODIFY,0,0,0,0,0,0,0,0,0,0,0,0,0,0.0,0.0,0.0,0.0,0.0,0.0,False
946,b99661b9d77fbbc9ecb70d48a61a2a88eb0cd055,/Users/sanika/Downloads/Master Thesis/repo_updated/pytest/testing/example_scripts/config/collect_pytest_prefix/__init__.pyi,5071.0,ModificationType.MODIFY,0,0,0,0,0,0,0,0,0,0,0,0,0,0.0,0.0,0.0,0.0,0.0,0.0,False
947,b99661b9d77fbbc9ecb70d48a61a2a88eb0cd055,/Users/sanika/Downloads/Master Thesis/repo_updated/pytest/testing/example_scripts/issue88_initial_file_multinodes/__init__.pyi,5071.0,ModificationType.MODIFY,0,0,0,0,0,0,0,0,0,0,0,0,0,0.0,0.0,0.0,0.0,0.0,0.0,False
948,b99661b9d77fbbc9ecb70d48a61a2a88eb0cd055,/Users/sanika/Downloads/Master Thesis/repo_updated/pytest/testing/example_scripts/fixtures/fill_fixtures/test_extend_fixture_conftest_conftest/__init__.pyi,5071.0,ModificationType.MODIFY,0,0,0,0,0,0,0,0,0,0,0,0,0,0.0,0.0,0.0,0.0,0.0,0.0,False
949,b99661b9d77fbbc9ecb70d48a61a2a88eb0cd055,/Users/sanika/Downloads/Master Thesis/repo_updated/pytest/testing/example_scripts/fixtures/fill_fixtures/test_extend_fixture_conftest_conftest/pkg/__init__.py,5071.0,ModificationType.MODIFY,0,0,0,0,0,0,0,0,0,0,0,0,0,0.0,0.0,0.0,0.0,0.0,0.0,False
950,b99661b9d77fbbc9ecb70d48a61a2a88eb0cd055,/Users/sanika/Downloads/Master Thesis/repo_updated/pytest/testing/example_scripts/fixtures/fill_fixtures/test_extend_fixture_conftest_module/__init__.pyi,5071.0,ModificationType.MODIFY,0,0,0,0,0,0,0,0,0,0,0,0,0,0.0,0.0,0.0,0.0,0.0,0.0,False
951,b99661b9d77fbbc9ecb70d48a61a2a88eb0cd055,/Users/sanika/Downloads/Master Thesis/repo_updated/pytest/testing/example_scripts/fixtures/fill_fixtures/test_conftest_funcargs_only_available_in_subdir/sub1/__init__.py,5071.0,ModificationType.MODIFY,0,0,0,0,0,0,0,0,0,0,0,0,0,0.0,0.0,0.0,0.0,0.0,0.0,False
952,b99661b9d77fbbc9ecb70d48a61a2a88eb0cd055,/Users/sanika/Downloads/Master Thesis/repo_updated/pytest/testing/example_scripts/fixtures/fill_fixtures/test_conftest_funcargs_only_available_in_subdir/sub2/__init__.py,5071.0,ModificationType.MODIFY,0,0,0,0,0,0,0,0,0,0,0,0,0,0.0,0.0,0.0,0.0,0.0,0.0,False
953,b99661b9d77fbbc9ecb70d48a61a2a88eb0cd055,/Users/sanika/Downloads/Master Thesis/repo_updated/pytest/testing/example_scripts/fixtures/custom_item/__init__.pyi,5071.0,ModificationType.MODIFY,0,0,0,0,0,0,0,0,0,0,0,0,0,0.0,0.0,0.0,0.0,0.0,0.0,False
954,b99661b9d77fbbc9ecb70d48a61a2a88eb0cd055,/Users/sanika/Downloads/Master Thesis/repo_updated/pytest/testing/example_scripts/fixtures/custom_item/foo/__init__.py,5071.0,ModificationType.MODIFY,0,0,0,0,0,0,0,0,0,0,0,0,0,0.0,0.0,0.0,0.0,0.0,0.0,False
955,b99661b9d77fbbc9ecb70d48a61a2a88eb0cd055,/Users/sanika/Downloads/Master Thesis/repo_updated/pytest/doc/en/example/nonpython/__init__.py,5071.0,ModificationType.MODIFY,0,0,0,0,0,0,0,0,0,0,0,0,0,0.0,0.0,0.0,0.0,0.0,0.0,False
956,b99661b9d77fbbc9ecb70d48a61a2a88eb0cd055,/Users/sanika/Downloads/Master Thesis/repo_updated/pytest/src/pytest/__init__.py,5071.0,ModificationType.MODIFY,99,48,90,1,3,5,100,0,0,0,0,0,0,0.0,0.0,0.0,0.0,0.0,0.0,False
957,b99661b9d77fbbc9ecb70d48a61a2a88eb0cd055,/Users/sanika/Downloads/Master Thesis/repo_updated/pytest/src/_pytest/__init__.py,5071.0,ModificationType.MODIFY,8,5,5,2,0,1,10,0,0,0,0,0,0,0.0,0.0,0.0,0.0,0.0,0.0,False
958,b99661b9d77fbbc9ecb70d48a61a2a88eb0cd055,/Users/sanika/Downloads/Master Thesis/repo_updated/pytest/src/_pytest/config/__init__.py,5071.0,ModificationType.MODIFY,1217,716,841,84,126,174,1301,14,185,118,215,199,333,1446.608539104324,2542.995998641035,8.135135135135135,20687.616097052745,1149.3120053918194,0.847665332880345,False
959,b99661b9d77fbbc9ecb70d48a61a2a88eb0cd055,/Users/sanika/Downloads/Master Thesis/repo_updated/pytest/src/_pytest/mark/__init__.py,5071.0,ModificationType.MODIFY,160,89,115,0,13,31,160,7,15,11,17,22,28,78.25484338853101,124.86408532184431,3.966666666666667,495.29420510998256,27.516344728332356,0.04162136177394811,False
960,b99661b9d77fbbc9ecb70d48a61a2a88eb0cd055,/Users/sanika/Downloads/Master Thesis/repo_updated/pytest/src/_pytest/_code/__init__.py,5071.0,ModificationType.MODIFY,10,10,9,9,0,0,19,0,0,0,0,0,0,0.0,0.0,0.0,0.0,0.0,0.0,False
961,b99661b9d77fbbc9ecb70d48a61a2a88eb0cd055,/Users/sanika/Downloads/Master Thesis/repo_updated/pytest/src/_pytest/assertion/__init__.py,5071.0,ModificationType.MODIFY,173,84,99,8,29,36,181,5,12,7,13,17,20,54.62919048309069,81.7492568250068,2.708333333333333,221.40423723439343,12.300235401910744,0.027249752275002263,False
962,b99661b9d77fbbc9ecb70d48a61a2a88eb0cd055,/Users/sanika/Downloads/Master Thesis/repo_updated/pytest/src/_pytest/_io/__init__.py,5071.0,ModificationType.MODIFY,3,1,1,3,0,0,6,0,0,0,0,0,0,0.0,0.0,0.0,0.0,0.0,0.0,False
963,b99661b9d77fbbc9ecb70d48a61a2a88eb0cd055,/Users/sanika/Downloads/Master Thesis/repo_updated/pytest/testing/test_reports.py,1942.0,ModificationType.MODIFY,466,257,367,18,25,50,484,7,126,86,171,133,257,898.7887548153927,1813.2075859238055,4.75,8612.736033138077,478.4853351743376,0.6044025286412685,False
964,b99661b9d77fbbc9ecb70d48a61a2a88eb0cd055,/Users/sanika/Downloads/Master Thesis/repo_updated/pytest/src/_pytest/reports.py,1942.0,ModificationType.MODIFY,507,281,342,29,59,88,536,10,53,29,57,63,86,336.7990650407233,514.0460734209928,5.377358490566038,2764.2100174525085,153.56722319180602,0.17134869114033094,False
965,b99661b9d77fbbc9ecb70d48a61a2a88eb0cd055,/Users/sanika/Downloads/Master Thesis/repo_updated/pytest/testing/test_reports.py,1843.0,ModificationType.MODIFY,466,257,367,18,25,50,484,7,126,86,171,133,257,898.7887548153927,1813.2075859238055,4.75,8612.736033138077,478.4853351743376,0.6044025286412685,False
966,09096f74368a45b0d23181f3120cfe78aef9363f,/Users/sanika/Downloads/Master Thesis/repo_updated/pytest/src/_pytest/hookspec.py,640.0,ModificationType.MODIFY,647,139,84,35,284,233,682,0,0,0,0,0,0,0.0,0.0,0.0,0.0,0.0,0.0,False
967,34068572848c166f499a1ed7671972688560c97a,/Users/sanika/Downloads/Master Thesis/repo_updated/pytest/testing/example_scripts/collect/package_infinite_recursion/__init__.pyi,5071.0,ModificationType.MODIFY,0,0,0,0,0,0,0,0,0,0,0,0,0,0.0,0.0,0.0,0.0,0.0,0.0,False
968,34068572848c166f499a1ed7671972688560c97a,/Users/sanika/Downloads/Master Thesis/repo_updated/pytest/testing/example_scripts/collect/package_infinite_recursion/tests/__init__.py,5071.0,ModificationType.MODIFY,0,0,0,0,0,0,0,0,0,0,0,0,0,0.0,0.0,0.0,0.0,0.0,0.0,False
969,34068572848c166f499a1ed7671972688560c97a,/Users/sanika/Downloads/Master Thesis/repo_updated/pytest/testing/example_scripts/collect/collect_init_tests/tests/__init__.py,5071.0,ModificationType.MODIFY,2,2,2,0,0,0,2,0,0,0,0,0,0,0.0,0.0,0.0,0.0,0.0,0.0,False
970,34068572848c166f499a1ed7671972688560c97a,/Users/sanika/Downloads/Master Thesis/repo_updated/pytest/testing/example_scripts/collect/package_init_given_as_arg/pkg/__init__.py,5071.0,ModificationType.MODIFY,0,0,0,0,0,0,0,0,0,0,0,0,0,0.0,0.0,0.0,0.0,0.0,0.0,False
971,34068572848c166f499a1ed7671972688560c97a,/Users/sanika/Downloads/Master Thesis/repo_updated/pytest/testing/example_scripts/conftest_usageerror/__init__.pyi,5071.0,ModificationType.MODIFY,0,0,0,0,0,0,0,0,0,0,0,0,0,0.0,0.0,0.0,0.0,0.0,0.0,False
972,34068572848c166f499a1ed7671972688560c97a,/Users/sanika/Downloads/Master Thesis/repo_updated/pytest/testing/example_scripts/marks/marks_considered_keywords/__init__.pyi,5071.0,ModificationType.MODIFY,0,0,0,0,0,0,0,0,0,0,0,0,0,0.0,0.0,0.0,0.0,0.0,0.0,False
973,34068572848c166f499a1ed7671972688560c97a,/Users/sanika/Downloads/Master Thesis/repo_updated/pytest/testing/example_scripts/config/collect_pytest_prefix/__init__.pyi,5071.0,ModificationType.MODIFY,0,0,0,0,0,0,0,0,0,0,0,0,0,0.0,0.0,0.0,0.0,0.0,0.0,False
974,34068572848c166f499a1ed7671972688560c97a,/Users/sanika/Downloads/Master Thesis/repo_updated/pytest/testing/example_scripts/issue88_initial_file_multinodes/__init__.pyi,5071.0,ModificationType.MODIFY,0,0,0,0,0,0,0,0,0,0,0,0,0,0.0,0.0,0.0,0.0,0.0,0.0,False
975,34068572848c166f499a1ed7671972688560c97a,/Users/sanika/Downloads/Master Thesis/repo_updated/pytest/testing/example_scripts/fixtures/fill_fixtures/test_extend_fixture_conftest_conftest/__init__.pyi,5071.0,ModificationType.MODIFY,0,0,0,0,0,0,0,0,0,0,0,0,0,0.0,0.0,0.0,0.0,0.0,0.0,False
976,34068572848c166f499a1ed7671972688560c97a,/Users/sanika/Downloads/Master Thesis/repo_updated/pytest/testing/example_scripts/fixtures/fill_fixtures/test_extend_fixture_conftest_conftest/pkg/__init__.py,5071.0,ModificationType.MODIFY,0,0,0,0,0,0,0,0,0,0,0,0,0,0.0,0.0,0.0,0.0,0.0,0.0,False
977,34068572848c166f499a1ed7671972688560c97a,/Users/sanika/Downloads/Master Thesis/repo_updated/pytest/testing/example_scripts/fixtures/fill_fixtures/test_extend_fixture_conftest_module/__init__.pyi,5071.0,ModificationType.MODIFY,0,0,0,0,0,0,0,0,0,0,0,0,0,0.0,0.0,0.0,0.0,0.0,0.0,False
978,34068572848c166f499a1ed7671972688560c97a,/Users/sanika/Downloads/Master Thesis/repo_updated/pytest/testing/example_scripts/fixtures/fill_fixtures/test_conftest_funcargs_only_available_in_subdir/sub1/__init__.py,5071.0,ModificationType.MODIFY,0,0,0,0,0,0,0,0,0,0,0,0,0,0.0,0.0,0.0,0.0,0.0,0.0,False
979,34068572848c166f499a1ed7671972688560c97a,/Users/sanika/Downloads/Master Thesis/repo_updated/pytest/testing/example_scripts/fixtures/fill_fixtures/test_conftest_funcargs_only_available_in_subdir/sub2/__init__.py,5071.0,ModificationType.MODIFY,0,0,0,0,0,0,0,0,0,0,0,0,0,0.0,0.0,0.0,0.0,0.0,0.0,False
980,34068572848c166f499a1ed7671972688560c97a,/Users/sanika/Downloads/Master Thesis/repo_updated/pytest/testing/example_scripts/fixtures/custom_item/__init__.pyi,5071.0,ModificationType.MODIFY,0,0,0,0,0,0,0,0,0,0,0,0,0,0.0,0.0,0.0,0.0,0.0,0.0,False
981,34068572848c166f499a1ed7671972688560c97a,/Users/sanika/Downloads/Master Thesis/repo_updated/pytest/testing/example_scripts/fixtures/custom_item/foo/__init__.py,5071.0,ModificationType.MODIFY,0,0,0,0,0,0,0,0,0,0,0,0,0,0.0,0.0,0.0,0.0,0.0,0.0,False
982,34068572848c166f499a1ed7671972688560c97a,/Users/sanika/Downloads/Master Thesis/repo_updated/pytest/doc/en/example/nonpython/__init__.py,5071.0,ModificationType.MODIFY,0,0,0,0,0,0,0,0,0,0,0,0,0,0.0,0.0,0.0,0.0,0.0,0.0,False
983,34068572848c166f499a1ed7671972688560c97a,/Users/sanika/Downloads/Master Thesis/repo_updated/pytest/src/pytest/__init__.py,5071.0,ModificationType.MODIFY,99,48,90,1,3,5,100,0,0,0,0,0,0,0.0,0.0,0.0,0.0,0.0,0.0,False
984,34068572848c166f499a1ed7671972688560c97a,/Users/sanika/Downloads/Master Thesis/repo_updated/pytest/src/_pytest/__init__.py,5071.0,ModificationType.MODIFY,8,5,5,2,0,1,10,0,0,0,0,0,0,0.0,0.0,0.0,0.0,0.0,0.0,False
985,34068572848c166f499a1ed7671972688560c97a,/Users/sanika/Downloads/Master Thesis/repo_updated/pytest/src/_pytest/config/__init__.py,5071.0,ModificationType.MODIFY,1217,716,841,84,126,174,1301,14,185,118,215,199,333,1446.608539104324,2542.995998641035,8.135135135135135,20687.616097052745,1149.3120053918194,0.847665332880345,False
986,34068572848c166f499a1ed7671972688560c97a,/Users/sanika/Downloads/Master Thesis/repo_updated/pytest/src/_pytest/mark/__init__.py,5071.0,ModificationType.MODIFY,160,89,115,0,13,31,160,7,15,11,17,22,28,78.25484338853101,124.86408532184431,3.966666666666667,495.29420510998256,27.516344728332356,0.04162136177394811,False
987,34068572848c166f499a1ed7671972688560c97a,/Users/sanika/Downloads/Master Thesis/repo_updated/pytest/src/_pytest/_code/__init__.py,5071.0,ModificationType.MODIFY,10,10,9,9,0,0,19,0,0,0,0,0,0,0.0,0.0,0.0,0.0,0.0,0.0,False
988,34068572848c166f499a1ed7671972688560c97a,/Users/sanika/Downloads/Master Thesis/repo_updated/pytest/src/_pytest/assertion/__init__.py,5071.0,ModificationType.MODIFY,173,84,99,8,29,36,181,5,12,7,13,17,20,54.62919048309069,81.7492568250068,2.708333333333333,221.40423723439343,12.300235401910744,0.027249752275002263,False
989,34068572848c166f499a1ed7671972688560c97a,/Users/sanika/Downloads/Master Thesis/repo_updated/pytest/src/_pytest/_io/__init__.py,5071.0,ModificationType.MODIFY,3,1,1,3,0,0,6,0,0,0,0,0,0,0.0,0.0,0.0,0.0,0.0,0.0,False
990,34068572848c166f499a1ed7671972688560c97a,/Users/sanika/Downloads/Master Thesis/repo_updated/pytest/src/_pytest/hookspec.py,640.0,ModificationType.MODIFY,647,139,84,35,284,233,682,0,0,0,0,0,0,0.0,0.0,0.0,0.0,0.0,0.0,False
991,34068572848c166f499a1ed7671972688560c97a,/Users/sanika/Downloads/Master Thesis/repo_updated/pytest/testing/test_reports.py,1942.0,ModificationType.MODIFY,466,257,367,18,25,50,484,7,126,86,171,133,257,898.7887548153927,1813.2075859238055,4.75,8612.736033138077,478.4853351743376,0.6044025286412685,False
992,34068572848c166f499a1ed7671972688560c97a,/Users/sanika/Downloads/Master Thesis/repo_updated/pytest/src/_pytest/reports.py,1942.0,ModificationType.MODIFY,507,281,342,29,59,88,536,10,53,29,57,63,86,336.7990650407233,514.0460734209928,5.377358490566038,2764.2100174525085,153.56722319180602,0.17134869114033094,False
993,34068572848c166f499a1ed7671972688560c97a,/Users/sanika/Downloads/Master Thesis/repo_updated/pytest/testing/test_reports.py,1843.0,ModificationType.MODIFY,466,257,367,18,25,50,484,7,126,86,171,133,257,898.7887548153927,1813.2075859238055,4.75,8612.736033138077,478.4853351743376,0.6044025286412685,False
994,7a96d94fd4f98f725ce04f7ac45de041b521b86d,/Users/sanika/Downloads/Master Thesis/repo_updated/pytest/testing/example_scripts/collect/package_infinite_recursion/__init__.pyi,5056.0,ModificationType.MODIFY,0,0,0,0,0,0,0,0,0,0,0,0,0,0.0,0.0,0.0,0.0,0.0,0.0,False
995,7a96d94fd4f98f725ce04f7ac45de041b521b86d,/Users/sanika/Downloads/Master Thesis/repo_updated/pytest/testing/example_scripts/collect/package_infinite_recursion/tests/__init__.py,5056.0,ModificationType.MODIFY,0,0,0,0,0,0,0,0,0,0,0,0,0,0.0,0.0,0.0,0.0,0.0,0.0,False
996,7a96d94fd4f98f725ce04f7ac45de041b521b86d,/Users/sanika/Downloads/Master Thesis/repo_updated/pytest/testing/example_scripts/collect/collect_init_tests/tests/__init__.py,5056.0,ModificationType.MODIFY,2,2,2,0,0,0,2,0,0,0,0,0,0,0.0,0.0,0.0,0.0,0.0,0.0,False
997,7a96d94fd4f98f725ce04f7ac45de041b521b86d,/Users/sanika/Downloads/Master Thesis/repo_updated/pytest/testing/example_scripts/collect/package_init_given_as_arg/pkg/__init__.py,5056.0,ModificationType.MODIFY,0,0,0,0,0,0,0,0,0,0,0,0,0,0.0,0.0,0.0,0.0,0.0,0.0,False
998,7a96d94fd4f98f725ce04f7ac45de041b521b86d,/Users/sanika/Downloads/Master Thesis/repo_updated/pytest/testing/example_scripts/conftest_usageerror/__init__.pyi,5056.0,ModificationType.MODIFY,0,0,0,0,0,0,0,0,0,0,0,0,0,0.0,0.0,0.0,0.0,0.0,0.0,False
999,7a96d94fd4f98f725ce04f7ac45de041b521b86d,/Users/sanika/Downloads/Master Thesis/repo_updated/pytest/testing/example_scripts/marks/marks_considered_keywords/__init__.pyi,5056.0,ModificationType.MODIFY,0,0,0,0,0,0,0,0,0,0,0,0,0,0.0,0.0,0.0,0.0,0.0,0.0,False
1000,7a96d94fd4f98f725ce04f7ac45de041b521b86d,/Users/sanika/Downloads/Master Thesis/repo_updated/pytest/testing/example_scripts/config/collect_pytest_prefix/__init__.pyi,5056.0,ModificationType.MODIFY,0,0,0,0,0,0,0,0,0,0,0,0,0,0.0,0.0,0.0,0.0,0.0,0.0,False
1001,7a96d94fd4f98f725ce04f7ac45de041b521b86d,/Users/sanika/Downloads/Master Thesis/repo_updated/pytest/testing/example_scripts/issue88_initial_file_multinodes/__init__.pyi,5056.0,ModificationType.MODIFY,0,0,0,0,0,0,0,0,0,0,0,0,0,0.0,0.0,0.0,0.0,0.0,0.0,False
1002,7a96d94fd4f98f725ce04f7ac45de041b521b86d,/Users/sanika/Downloads/Master Thesis/repo_updated/pytest/testing/example_scripts/fixtures/fill_fixtures/test_extend_fixture_conftest_conftest/__init__.pyi,5056.0,ModificationType.MODIFY,0,0,0,0,0,0,0,0,0,0,0,0,0,0.0,0.0,0.0,0.0,0.0,0.0,False
1003,7a96d94fd4f98f725ce04f7ac45de041b521b86d,/Users/sanika/Downloads/Master Thesis/repo_updated/pytest/testing/example_scripts/fixtures/fill_fixtures/test_extend_fixture_conftest_conftest/pkg/__init__.py,5056.0,ModificationType.MODIFY,0,0,0,0,0,0,0,0,0,0,0,0,0,0.0,0.0,0.0,0.0,0.0,0.0,False
1004,7a96d94fd4f98f725ce04f7ac45de041b521b86d,/Users/sanika/Downloads/Master Thesis/repo_updated/pytest/testing/example_scripts/fixtures/fill_fixtures/test_extend_fixture_conftest_module/__init__.pyi,5056.0,ModificationType.MODIFY,0,0,0,0,0,0,0,0,0,0,0,0,0,0.0,0.0,0.0,0.0,0.0,0.0,False
1005,7a96d94fd4f98f725ce04f7ac45de041b521b86d,/Users/sanika/Downloads/Master Thesis/repo_updated/pytest/testing/example_scripts/fixtures/fill_fixtures/test_conftest_funcargs_only_available_in_subdir/sub1/__init__.py,5056.0,ModificationType.MODIFY,0,0,0,0,0,0,0,0,0,0,0,0,0,0.0,0.0,0.0,0.0,0.0,0.0,False
1006,7a96d94fd4f98f725ce04f7ac45de041b521b86d,/Users/sanika/Downloads/Master Thesis/repo_updated/pytest/testing/example_scripts/fixtures/fill_fixtures/test_conftest_funcargs_only_available_in_subdir/sub2/__init__.py,5056.0,ModificationType.MODIFY,0,0,0,0,0,0,0,0,0,0,0,0,0,0.0,0.0,0.0,0.0,0.0,0.0,False
1007,7a96d94fd4f98f725ce04f7ac45de041b521b86d,/Users/sanika/Downloads/Master Thesis/repo_updated/pytest/testing/example_scripts/fixtures/custom_item/__init__.pyi,5056.0,ModificationType.MODIFY,0,0,0,0,0,0,0,0,0,0,0,0,0,0.0,0.0,0.0,0.0,0.0,0.0,False
1008,7a96d94fd4f98f725ce04f7ac45de041b521b86d,/Users/sanika/Downloads/Master Thesis/repo_updated/pytest/testing/example_scripts/fixtures/custom_item/foo/__init__.py,5056.0,ModificationType.MODIFY,0,0,0,0,0,0,0,0,0,0,0,0,0,0.0,0.0,0.0,0.0,0.0,0.0,False
1009,7a96d94fd4f98f725ce04f7ac45de041b521b86d,/Users/sanika/Downloads/Master Thesis/repo_updated/pytest/doc/en/example/nonpython/__init__.py,5056.0,ModificationType.MODIFY,0,0,0,0,0,0,0,0,0,0,0,0,0,0.0,0.0,0.0,0.0,0.0,0.0,False
1010,7a96d94fd4f98f725ce04f7ac45de041b521b86d,/Users/sanika/Downloads/Master Thesis/repo_updated/pytest/src/pytest/__init__.py,5056.0,ModificationType.MODIFY,99,48,90,1,3,5,100,0,0,0,0,0,0,0.0,0.0,0.0,0.0,0.0,0.0,False
1011,7a96d94fd4f98f725ce04f7ac45de041b521b86d,/Users/sanika/Downloads/Master Thesis/repo_updated/pytest/src/_pytest/__init__.py,5056.0,ModificationType.MODIFY,8,5,5,2,0,1,10,0,0,0,0,0,0,0.0,0.0,0.0,0.0,0.0,0.0,False
1012,7a96d94fd4f98f725ce04f7ac45de041b521b86d,/Users/sanika/Downloads/Master Thesis/repo_updated/pytest/src/_pytest/config/__init__.py,5056.0,ModificationType.MODIFY,1217,716,841,84,126,174,1301,14,185,118,215,199,333,1446.608539104324,2542.995998641035,8.135135135135135,20687.616097052745,1149.3120053918194,0.847665332880345,False
1013,7a96d94fd4f98f725ce04f7ac45de041b521b86d,/Users/sanika/Downloads/Master Thesis/repo_updated/pytest/src/_pytest/mark/__init__.py,5056.0,ModificationType.MODIFY,160,89,115,0,13,31,160,7,15,11,17,22,28,78.25484338853101,124.86408532184431,3.966666666666667,495.29420510998256,27.516344728332356,0.04162136177394811,False
1014,7a96d94fd4f98f725ce04f7ac45de041b521b86d,/Users/sanika/Downloads/Master Thesis/repo_updated/pytest/src/_pytest/_code/__init__.py,5056.0,ModificationType.MODIFY,10,10,9,9,0,0,19,0,0,0,0,0,0,0.0,0.0,0.0,0.0,0.0,0.0,False
1015,7a96d94fd4f98f725ce04f7ac45de041b521b86d,/Users/sanika/Downloads/Master Thesis/repo_updated/pytest/src/_pytest/assertion/__init__.py,5056.0,ModificationType.MODIFY,173,84,99,8,29,36,181,5,12,7,13,17,20,54.62919048309069,81.7492568250068,2.708333333333333,221.40423723439343,12.300235401910744,0.027249752275002263,False
1016,7a96d94fd4f98f725ce04f7ac45de041b521b86d,/Users/sanika/Downloads/Master Thesis/repo_updated/pytest/src/_pytest/_io/__init__.py,5056.0,ModificationType.MODIFY,3,1,1,3,0,0,6,0,0,0,0,0,0,0.0,0.0,0.0,0.0,0.0,0.0,False
1017,7a96d94fd4f98f725ce04f7ac45de041b521b86d,/Users/sanika/Downloads/Master Thesis/repo_updated/pytest/src/_pytest/hookspec.py,642.0,ModificationType.MODIFY,647,139,84,35,284,233,682,0,0,0,0,0,0,0.0,0.0,0.0,0.0,0.0,0.0,False
1018,7a96d94fd4f98f725ce04f7ac45de041b521b86d,/Users/sanika/Downloads/Master Thesis/repo_updated/pytest/testing/test_pluginmanager.py,1924.0,ModificationType.MODIFY,384,251,317,7,8,52,391,11,70,44,84,81,128,467.10355899115797,811.500800369232,6.6,5355.905282436931,297.5502934687184,0.270500266789744,False
1019,285524c6cdde61fde3d9b4f250b4fa9bbb46e932,/Users/sanika/Downloads/Master Thesis/repo_updated/pytest/src/_pytest/debugging.py,1473.0,ModificationType.MODIFY,339,213,244,17,9,65,356,10,42,26,48,52,74,259.6966127055816,421.83253914244085,5.7142857142857135,2410.4716522425188,133.91509179125106,0.1406108463808136,False
1020,285524c6cdde61fde3d9b4f250b4fa9bbb46e932,/Users/sanika/Downloads/Master Thesis/repo_updated/pytest/testing/test_pdb.py,4151.0,ModificationType.MODIFY,1293,570,1093,25,15,163,1318,10,195,123,241,205,364,1516.6486921300477,2795.3307562199825,6.17948717948718,17273.710570487587,959.6505872493103,0.931776918739994,False
1021,dc5a4fbe2303fb97b962095610368f73c7bc66e2,/Users/sanika/Downloads/Master Thesis/repo_updated/pytest/src/_pytest/debugging.py,1473.0,ModificationType.MODIFY,339,213,244,17,9,65,356,10,42,26,48,52,74,259.6966127055816,421.83253914244085,5.7142857142857135,2410.4716522425188,133.91509179125106,0.1406108463808136,False
1022,dc5a4fbe2303fb97b962095610368f73c7bc66e2,/Users/sanika/Downloads/Master Thesis/repo_updated/pytest/testing/test_pdb.py,4151.0,ModificationType.MODIFY,1293,570,1093,25,15,163,1318,10,195,123,241,205,364,1516.6486921300477,2795.3307562199825,6.17948717948718,17273.710570487587,959.6505872493103,0.931776918739994,False
1023,abc890079f92c116e30bf197c46c427a850ecdec,/Users/sanika/Downloads/Master Thesis/repo_updated/pytest/testing/code/test_code.py,4974.0,ModificationType.MODIFY,182,127,129,0,0,53,182,5,39,21,42,44,63,217.7403270100645,343.9441919741497,2.6923076923076925,926.003593776557,51.44464409869761,0.11464806399138325,False
1024,abc890079f92c116e30bf197c46c427a850ecdec,/Users/sanika/Downloads/Master Thesis/repo_updated/pytest/src/_pytest/_code/code.py,4974.0,ModificationType.MODIFY,1165,710,800,67,119,181,1232,18,243,153,282,261,435,2000.7880884021665,3492.1391085079,10.444444444444443,36473.45291108252,2026.302939504584,1.1640463695026333,False
1025,abc890079f92c116e30bf197c46c427a850ecdec,/Users/sanika/Downloads/Master Thesis/repo_updated/pytest/testing/test_junitxml.py,3166.0,ModificationType.MODIFY,1523,757,1297,19,12,193,1542,12,193,117,230,205,347,1508.3637582013935,2664.7795945283897,7.150259067357513,19053.86445828589,1058.5480254603274,0.8882598648427965,False
1026,abc890079f92c116e30bf197c46c427a850ecdec,/Users/sanika/Downloads/Master Thesis/repo_updated/pytest/src/_pytest/junitxml.py,3166.0,ModificationType.MODIFY,701,378,504,33,58,109,734,13,110,68,126,123,194,794.0552848235468,1346.8478140358125,7.445454545454545,10027.894179048459,557.1052321693588,0.4489492713452708,False
1027,abc890079f92c116e30bf197c46c427a850ecdec,/Users/sanika/Downloads/Master Thesis/repo_updated/pytest/testing/test_main.py,3472.0,ModificationType.MODIFY,77,34,69,0,0,8,77,3,24,16,29,27,45,114.79398751947123,213.9699375973561,1.8125,387.82051189520797,21.54558399417822,0.07132331253245204,False
1028,abc890079f92c116e30bf197c46c427a850ecdec,/Users/sanika/Downloads/Master Thesis/repo_updated/pytest/src/_pytest/main.py,3472.0,ModificationType.MODIFY,712,438,573,51,9,84,763,14,102,71,128,116,199,733.8903537898989,1364.7382180303869,8.784313725490197,11988.288660345359,666.0160366858534,0.4549127393434623,False
1029,abc890079f92c116e30bf197c46c427a850ecdec,/Users/sanika/Downloads/Master Thesis/repo_updated/pytest/src/_pytest/mark/evaluate.py,669.0,ModificationType.MODIFY,125,97,103,3,0,19,128,9,25,17,27,34,44,144.6257297573489,223.84836501501496,4.86,1087.9030539729727,60.43905855405405,0.07461612167167166,False
1030,abc890079f92c116e30bf197c46c427a850ecdec,/Users/sanika/Downloads/Master Thesis/repo_updated/pytest/src/_pytest/mark/legacy.py,367.0,ModificationType.MODIFY,102,57,55,5,16,25,107,5,17,10,18,22,28,81.0965087756926,124.86408532184431,2.647058823529412,330.5225787931173,18.36236548850652,0.04162136177394811,False
1031,abc890079f92c116e30bf197c46c427a850ecdec,/Users/sanika/Downloads/Master Thesis/repo_updated/pytest/doc/en/example/multipython.py,6685.0,ModificationType.MODIFY,72,33,56,0,4,12,72,1,1,1,1,2,2,0.0,2.0,0.5,1.0,0.05555555555555555,0.0006666666666666666,False
1032,abc890079f92c116e30bf197c46c427a850ecdec,/Users/sanika/Downloads/Master Thesis/repo_updated/pytest/src/_pytest/python.py,6685.0,ModificationType.MODIFY,1454,835,1044,76,110,219,1530,17,275,158,296,292,454,2297.8910156145625,3718.1803497315277,9.149090909090908,34017.97003608918,1889.8872242271768,1.2393934499105097,False
1033,abc890079f92c116e30bf197c46c427a850ecdec,/Users/sanika/Downloads/Master Thesis/repo_updated/pytest/testing/test_skipping.py,784.0,ModificationType.MODIFY,1178,367,1042,6,15,115,1184,9,94,51,95,103,146,644.6606770706788,976.22907696875,4.547872340425532,4439.7652170653255,246.65362317029587,0.3254096923229167,False
1034,abc890079f92c116e30bf197c46c427a850ecdec,/Users/sanika/Downloads/Master Thesis/repo_updated/pytest/src/_pytest/skipping.py,784.0,ModificationType.MODIFY,177,108,140,8,0,27,185,6,30,16,32,36,48,162.7164928725825,248.15640006923095,3.2,794.1004802215393,44.11669334564107,0.082718800023077,False
1035,abc890079f92c116e30bf197c46c427a850ecdec,/Users/sanika/Downloads/Master Thesis/repo_updated/pytest/testing/python/metafunc.py,5933.0,ModificationType.MODIFY,1782,648,1425,9,47,279,1791,8,171,97,189,179,286,1292.4527800454887,2140.3713122975773,4.421052631578949,9462.69422278929,525.705234599405,0.7134571040991925,False
1036,abc890079f92c116e30bf197c46c427a850ecdec,/Users/sanika/Downloads/Master Thesis/repo_updated/pytest/testing/test_mark.py,3090.0,ModificationType.MODIFY,1020,354,843,12,15,144,1032,8,134,77,144,142,221,970.8559515213416,1580.0941134105346,4.298507462686567,6792.0463382422995,377.3359076801278,0.5266980378035117,False
1037,abc890079f92c116e30bf197c46c427a850ecdec,/Users/sanika/Downloads/Master Thesis/repo_updated/pytest/testing/test_nose.py,637.0,ModificationType.MODIFY,424,94,331,4,0,89,428,1,5,5,5,6,10,11.60964047443681,25.849625007211557,0.5,12.924812503605779,0.7180451390892101,0.00861654166907052,False
1038,abc890079f92c116e30bf197c46c427a850ecdec,/Users/sanika/Downloads/Master Thesis/repo_updated/pytest/testing/test_parseopt.py,2315.0,ModificationType.MODIFY,334,251,279,10,4,40,344,5,127,74,143,132,217,899.1725956945018,1528.6335239007847,2.81496062992126,4303.0431873585085,239.05795485325038,0.5095445079669282,False
1039,abc890079f92c116e30bf197c46c427a850ecdec,/Users/sanika/Downloads/Master Thesis/repo_updated/pytest/testing/test_pdb.py,3969.0,ModificationType.MODIFY,1293,570,1093,25,15,163,1318,10,195,123,241,205,364,1516.6486921300477,2795.3307562199825,6.17948717948718,17273.710570487587,959.6505872493103,0.931776918739994,False
1040,abc890079f92c116e30bf197c46c427a850ecdec,/Users/sanika/Downloads/Master Thesis/repo_updated/pytest/testing/test_stepwise.py,645.0,ModificationType.MODIFY,219,78,157,11,5,46,230,3,24,20,34,27,54,114.79398751947123,256.7639251168273,2.125,545.6233408732581,30.31240782629212,0.08558797503894246,False
1041,35800a2f73c4233285a4a8f403ca94bc9c6e998e,/Users/sanika/Downloads/Master Thesis/repo_updated/pytest/testing/code/test_code.py,4974.0,ModificationType.MODIFY,182,127,129,0,0,53,182,5,39,21,42,44,63,217.7403270100645,343.9441919741497,2.6923076923076925,926.003593776557,51.44464409869761,0.11464806399138325,False
1042,35800a2f73c4233285a4a8f403ca94bc9c6e998e,/Users/sanika/Downloads/Master Thesis/repo_updated/pytest/src/_pytest/_code/code.py,4974.0,ModificationType.MODIFY,1165,710,800,67,119,181,1232,18,243,153,282,261,435,2000.7880884021665,3492.1391085079,10.444444444444443,36473.45291108252,2026.302939504584,1.1640463695026333,False
1043,35800a2f73c4233285a4a8f403ca94bc9c6e998e,/Users/sanika/Downloads/Master Thesis/repo_updated/pytest/testing/test_junitxml.py,3166.0,ModificationType.MODIFY,1523,757,1297,19,12,193,1542,12,193,117,230,205,347,1508.3637582013935,2664.7795945283897,7.150259067357513,19053.86445828589,1058.5480254603274,0.8882598648427965,False
1044,35800a2f73c4233285a4a8f403ca94bc9c6e998e,/Users/sanika/Downloads/Master Thesis/repo_updated/pytest/src/_pytest/junitxml.py,3166.0,ModificationType.MODIFY,701,378,504,33,58,109,734,13,110,68,126,123,194,794.0552848235468,1346.8478140358125,7.445454545454545,10027.894179048459,557.1052321693588,0.4489492713452708,False
1045,35800a2f73c4233285a4a8f403ca94bc9c6e998e,/Users/sanika/Downloads/Master Thesis/repo_updated/pytest/testing/test_main.py,3472.0,ModificationType.MODIFY,77,34,69,0,0,8,77,3,24,16,29,27,45,114.79398751947123,213.9699375973561,1.8125,387.82051189520797,21.54558399417822,0.07132331253245204,False
1046,35800a2f73c4233285a4a8f403ca94bc9c6e998e,/Users/sanika/Downloads/Master Thesis/repo_updated/pytest/src/_pytest/main.py,3472.0,ModificationType.MODIFY,712,438,573,51,9,84,763,14,102,71,128,116,199,733.8903537898989,1364.7382180303869,8.784313725490197,11988.288660345359,666.0160366858534,0.4549127393434623,False
1047,35800a2f73c4233285a4a8f403ca94bc9c6e998e,/Users/sanika/Downloads/Master Thesis/repo_updated/pytest/src/_pytest/mark/evaluate.py,669.0,ModificationType.MODIFY,125,97,103,3,0,19,128,9,25,17,27,34,44,144.6257297573489,223.84836501501496,4.86,1087.9030539729727,60.43905855405405,0.07461612167167166,False
1048,35800a2f73c4233285a4a8f403ca94bc9c6e998e,/Users/sanika/Downloads/Master Thesis/repo_updated/pytest/src/_pytest/mark/legacy.py,367.0,ModificationType.MODIFY,102,57,55,5,16,25,107,5,17,10,18,22,28,81.0965087756926,124.86408532184431,2.647058823529412,330.5225787931173,18.36236548850652,0.04162136177394811,False
1049,35800a2f73c4233285a4a8f403ca94bc9c6e998e,/Users/sanika/Downloads/Master Thesis/repo_updated/pytest/doc/en/example/multipython.py,6685.0,ModificationType.MODIFY,72,33,56,0,4,12,72,1,1,1,1,2,2,0.0,2.0,0.5,1.0,0.05555555555555555,0.0006666666666666666,False
1050,35800a2f73c4233285a4a8f403ca94bc9c6e998e,/Users/sanika/Downloads/Master Thesis/repo_updated/pytest/src/_pytest/python.py,6685.0,ModificationType.MODIFY,1454,835,1044,76,110,219,1530,17,275,158,296,292,454,2297.8910156145625,3718.1803497315277,9.149090909090908,34017.97003608918,1889.8872242271768,1.2393934499105097,False
1051,35800a2f73c4233285a4a8f403ca94bc9c6e998e,/Users/sanika/Downloads/Master Thesis/repo_updated/pytest/testing/test_skipping.py,784.0,ModificationType.MODIFY,1178,367,1042,6,15,115,1184,9,94,51,95,103,146,644.6606770706788,976.22907696875,4.547872340425532,4439.7652170653255,246.65362317029587,0.3254096923229167,False
1052,35800a2f73c4233285a4a8f403ca94bc9c6e998e,/Users/sanika/Downloads/Master Thesis/repo_updated/pytest/src/_pytest/skipping.py,784.0,ModificationType.MODIFY,177,108,140,8,0,27,185,6,30,16,32,36,48,162.7164928725825,248.15640006923095,3.2,794.1004802215393,44.11669334564107,0.082718800023077,False
1053,35800a2f73c4233285a4a8f403ca94bc9c6e998e,/Users/sanika/Downloads/Master Thesis/repo_updated/pytest/testing/python/metafunc.py,5933.0,ModificationType.MODIFY,1782,648,1425,9,47,279,1791,8,171,97,189,179,286,1292.4527800454887,2140.3713122975773,4.421052631578949,9462.69422278929,525.705234599405,0.7134571040991925,False
1054,35800a2f73c4233285a4a8f403ca94bc9c6e998e,/Users/sanika/Downloads/Master Thesis/repo_updated/pytest/testing/test_mark.py,3090.0,ModificationType.MODIFY,1020,354,843,12,15,144,1032,8,134,77,144,142,221,970.8559515213416,1580.0941134105346,4.298507462686567,6792.0463382422995,377.3359076801278,0.5266980378035117,False
1055,35800a2f73c4233285a4a8f403ca94bc9c6e998e,/Users/sanika/Downloads/Master Thesis/repo_updated/pytest/testing/test_nose.py,637.0,ModificationType.MODIFY,424,94,331,4,0,89,428,1,5,5,5,6,10,11.60964047443681,25.849625007211557,0.5,12.924812503605779,0.7180451390892101,0.00861654166907052,False
1056,35800a2f73c4233285a4a8f403ca94bc9c6e998e,/Users/sanika/Downloads/Master Thesis/repo_updated/pytest/testing/test_parseopt.py,2315.0,ModificationType.MODIFY,334,251,279,10,4,40,344,5,127,74,143,132,217,899.1725956945018,1528.6335239007847,2.81496062992126,4303.0431873585085,239.05795485325038,0.5095445079669282,False
1057,35800a2f73c4233285a4a8f403ca94bc9c6e998e,/Users/sanika/Downloads/Master Thesis/repo_updated/pytest/testing/test_pdb.py,4151.0,ModificationType.MODIFY,1293,570,1093,25,15,163,1318,10,195,123,241,205,364,1516.6486921300477,2795.3307562199825,6.17948717948718,17273.710570487587,959.6505872493103,0.931776918739994,False
1058,35800a2f73c4233285a4a8f403ca94bc9c6e998e,/Users/sanika/Downloads/Master Thesis/repo_updated/pytest/testing/test_stepwise.py,645.0,ModificationType.MODIFY,219,78,157,11,5,46,230,3,24,20,34,27,54,114.79398751947123,256.7639251168273,2.125,545.6233408732581,30.31240782629212,0.08558797503894246,False
1059,0c7c26fe6e7a9d53e080b3214898651042c6dbee,/Users/sanika/Downloads/Master Thesis/repo_updated/pytest/testing/test_nodes.py,1699.0,ModificationType.MODIFY,53,23,39,0,0,13,53,2,8,4,8,10,12,26.0,39.863137138648355,1.0,39.863137138648355,2.2146187299249087,0.013287712379549451,False
1060,0c7c26fe6e7a9d53e080b3214898651042c6dbee,/Users/sanika/Downloads/Master Thesis/repo_updated/pytest/src/_pytest/nodes.py,1699.0,ModificationType.MODIFY,515,298,307,33,80,99,548,12,63,44,77,75,121,419.5881851891487,753.6870615500015,7.333333333333332,5527.038451366679,307.0576917425932,0.2512290205166672,False
1061,6df4d07a57cf3dd6486e7ea23c3eeda6ace3ca89,/Users/sanika/Downloads/Master Thesis/repo_updated/pytest/testing/test_capture.py,5076.0,ModificationType.MODIFY,1513,682,1277,25,13,200,1538,11,199,116,219,210,335,1557.7420472931965,2584.272248418151,6.052763819095478,15641.989563917903,868.9994202176613,0.8614240828060503,False
1062,3fb969897a012c5acf481126e95d6d2d282108aa,/Users/sanika/Downloads/Master Thesis/repo_updated/pytest/testing/test_terminal.py,6238.0,ModificationType.MODIFY,1943,715,1694,26,18,214,1969,12,185,120,237,197,357,1436.3251202041715,2721.0724995459263,7.686486486486486,20915.486996509768,1161.971499806098,0.9070241665153088,False
1063,3fb969897a012c5acf481126e95d6d2d282108aa,/Users/sanika/Downloads/Master Thesis/repo_updated/pytest/src/_pytest/terminal.py,6238.0,ModificationType.MODIFY,1168,838,957,57,25,144,1225,19,348,224,416,367,640,3018.854959310786,5452.567201819657,11.35632183908046,61921.107993078396,3440.0615551710216,1.817522400606552,False
1064,3fb969897a012c5acf481126e95d6d2d282108aa,/Users/sanika/Downloads/Master Thesis/repo_updated/pytest/testing/test_terminal.py,6713.0,ModificationType.MODIFY,1943,715,1694,26,18,214,1969,12,185,120,237,197,357,1436.3251202041715,2721.0724995459263,7.686486486486486,20915.486996509768,1161.971499806098,0.9070241665153088,False
1065,9303de877aefc5304522b2e2522c314e0616040c,/Users/sanika/Downloads/Master Thesis/repo_updated/pytest/testing/test_terminal.py,6713.0,ModificationType.MODIFY,1943,715,1694,26,18,214,1969,12,185,120,237,197,357,1436.3251202041715,2721.0724995459263,7.686486486486486,20915.486996509768,1161.971499806098,0.9070241665153088,False
1066,dc30d78845970afd3089d4ff79b2df0eb86af156,/Users/sanika/Downloads/Master Thesis/repo_updated/pytest/testing/io/test_saferepr.py,320.0,ModificationType.MODIFY,149,95,105,2,0,41,151,8,54,28,55,62,83,334.7639251168273,494.1982937621106,4.0740740740740735,2013.4004560678586,111.8555808926588,0.1647327645873702,False
1067,dc30d78845970afd3089d4ff79b2df0eb86af156,/Users/sanika/Downloads/Master Thesis/repo_updated/pytest/src/_pytest/_io/saferepr.py,320.0,ModificationType.MODIFY,82,56,54,0,13,15,82,4,13,8,16,17,24,56.10571633583421,98.09910819000817,2.4615384615384617,241.47472785232785,13.415262658462654,0.03269970273000272,False
1068,18d181fa7776ced81249e18805c91c53c739834c,/Users/sanika/Downloads/Master Thesis/repo_updated/pytest/src/_pytest/assertion/util.py,2276.0,ModificationType.MODIFY,477,336,357,30,23,73,507,16,194,134,250,210,384,1538.3830913843026,2962.2702787837907,10.309278350515463,30538.868853441152,1696.603825191175,0.9874234262612636,False
1069,7d3ce374d28d7eadd85c59ed1e59319556e61635,/Users/sanika/Downloads/Master Thesis/repo_updated/pytest/src/_pytest/assertion/util.py,2511.0,ModificationType.MODIFY,477,336,357,30,23,73,507,16,194,134,250,210,384,1538.3830913843026,2962.2702787837907,10.309278350515463,30538.868853441152,1696.603825191175,0.9874234262612636,False
1070,68dbc24dcbb6e2bf1aa03289caff112786eb92d2,/Users/sanika/Downloads/Master Thesis/repo_updated/pytest/testing/test_warnings.py,1715.0,ModificationType.MODIFY,601,196,481,2,23,85,603,8,63,36,72,71,108,400.5686351804948,664.1726889065056,4.571428571428571,3036.21800642974,168.67877813498555,0.22139089630216852,False
1071,9f800b2a77e60637ad8ece1c62c3c4352e70d410,/Users/sanika/Downloads/Master Thesis/repo_updated/pytest/testing/test_terminal.py,6693.0,ModificationType.MODIFY,1943,715,1694,26,18,214,1969,12,185,120,237,197,357,1436.3251202041715,2721.0724995459263,7.686486486486486,20915.486996509768,1161.971499806098,0.9070241665153088,False
1072,08c25b7fe0aab6f4d12c55a21031c4c22e7a57ac,/Users/sanika/Downloads/Master Thesis/repo_updated/pytest/testing/io/test_saferepr.py,320.0,ModificationType.MODIFY,149,95,105,2,0,41,151,8,54,28,55,62,83,334.7639251168273,494.1982937621106,4.0740740740740735,2013.4004560678586,111.8555808926588,0.1647327645873702,False
1073,08c25b7fe0aab6f4d12c55a21031c4c22e7a57ac,/Users/sanika/Downloads/Master Thesis/repo_updated/pytest/src/_pytest/_io/saferepr.py,320.0,ModificationType.MODIFY,82,56,54,0,13,15,82,4,13,8,16,17,24,56.10571633583421,98.09910819000817,2.4615384615384617,241.47472785232785,13.415262658462654,0.03269970273000272,False
1074,08c25b7fe0aab6f4d12c55a21031c4c22e7a57ac,/Users/sanika/Downloads/Master Thesis/repo_updated/pytest/src/_pytest/assertion/util.py,2511.0,ModificationType.MODIFY,477,336,357,30,23,73,507,16,194,134,250,210,384,1538.3830913843026,2962.2702787837907,10.309278350515463,30538.868853441152,1696.603825191175,0.9874234262612636,False
1075,d53794f9162affedd107089f374a2262b9cd80a0,/Users/sanika/Downloads/Master Thesis/repo_updated/pytest/testing/test_terminal.py,6693.0,ModificationType.MODIFY,1943,715,1694,26,18,214,1969,12,185,120,237,197,357,1436.3251202041715,2721.0724995459263,7.686486486486486,20915.486996509768,1161.971499806098,0.9070241665153088,False
1076,0d79061432639308ecf3e3c2e838080567c84e20,/Users/sanika/Downloads/Master Thesis/repo_updated/pytest/testing/test_terminal.py,6307.0,ModificationType.MODIFY,1943,715,1694,26,18,214,1969,12,185,120,237,197,357,1436.3251202041715,2721.0724995459263,7.686486486486486,20915.486996509768,1161.971499806098,0.9070241665153088,False
1077,0d79061432639308ecf3e3c2e838080567c84e20,/Users/sanika/Downloads/Master Thesis/repo_updated/pytest/src/_pytest/terminal.py,6307.0,ModificationType.MODIFY,1168,838,957,57,25,144,1225,19,348,224,416,367,640,3018.854959310786,5452.567201819657,11.35632183908046,61921.107993078396,3440.0615551710216,1.817522400606552,False
1078,0d79061432639308ecf3e3c2e838080567c84e20,/Users/sanika/Downloads/Master Thesis/repo_updated/pytest/testing/test_terminal.py,6826.0,ModificationType.MODIFY,1943,715,1694,26,18,214,1969,12,185,120,237,197,357,1436.3251202041715,2721.0724995459263,7.686486486486486,20915.486996509768,1161.971499806098,0.9070241665153088,False
1079,f9e3a5395c9cbabcfd7d548afb7bff8f9310f229,/Users/sanika/Downloads/Master Thesis/repo_updated/pytest/src/_pytest/assertion/util.py,2105.0,ModificationType.MODIFY,477,336,357,30,23,73,507,16,194,134,250,210,384,1538.3830913843026,2962.2702787837907,10.309278350515463,30538.868853441152,1696.603825191175,0.9874234262612636,False
1080,990d75b7e6bae670a9de292b69118e0b64da6171,/Users/sanika/Downloads/Master Thesis/repo_updated/pytest/src/_pytest/assertion/util.py,2105.0,ModificationType.MODIFY,477,336,357,30,23,73,507,16,194,134,250,210,384,1538.3830913843026,2962.2702787837907,10.309278350515463,30538.868853441152,1696.603825191175,0.9874234262612636,False
1081,741f0fedd1d8661ed671fdc7a1091dd42203a56f,/Users/sanika/Downloads/Master Thesis/repo_updated/pytest/testing/code/test_code.py,5035.0,ModificationType.MODIFY,182,127,129,0,0,53,182,5,39,21,42,44,63,217.7403270100645,343.9441919741497,2.6923076923076925,926.003593776557,51.44464409869761,0.11464806399138325,False
1082,741f0fedd1d8661ed671fdc7a1091dd42203a56f,/Users/sanika/Downloads/Master Thesis/repo_updated/pytest/src/_pytest/_code/code.py,5035.0,ModificationType.MODIFY,1165,710,800,67,119,181,1232,18,243,153,282,261,435,2000.7880884021665,3492.1391085079,10.444444444444443,36473.45291108252,2026.302939504584,1.1640463695026333,False
1083,741f0fedd1d8661ed671fdc7a1091dd42203a56f,/Users/sanika/Downloads/Master Thesis/repo_updated/pytest/testing/test_doctest.py,2729.0,ModificationType.MODIFY,1455,414,1257,16,76,112,1471,5,41,23,46,46,69,231.26927266377825,381.12577496793386,2.804878048780488,1069.0113200320095,59.3895177795561,0.1270419249893113,False
1084,741f0fedd1d8661ed671fdc7a1091dd42203a56f,/Users/sanika/Downloads/Master Thesis/repo_updated/pytest/src/_pytest/doctest.py,2729.0,ModificationType.MODIFY,669,365,481,22,61,110,691,15,103,63,122,118,185,747.3129132339992,1273.2889641319407,8.88349514563107,11311.256331851706,628.403129547317,0.4244296547106469,False
1085,741f0fedd1d8661ed671fdc7a1091dd42203a56f,/Users/sanika/Downloads/Master Thesis/repo_updated/pytest/testing/python/fixtures.py,6241.0,ModificationType.MODIFY,4293,999,3693,19,54,507,4312,9,155,88,170,164,258,1156.3286078304875,1898.2484171914662,4.935483870967742,9368.774446138525,520.4874692299181,0.6327494723971553,False
1086,741f0fedd1d8661ed671fdc7a1091dd42203a56f,/Users/sanika/Downloads/Master Thesis/repo_updated/pytest/src/_pytest/fixtures.py,6241.0,ModificationType.MODIFY,1482,859,1002,125,135,219,1607,16,219,134,251,235,385,1766.6783660526569,3032.459024427525,9.168949771689498,27804.46447968251,1544.692471093473,1.0108196748091751,False
1087,741f0fedd1d8661ed671fdc7a1091dd42203a56f,/Users/sanika/Downloads/Master Thesis/repo_updated/pytest/testing/test_main.py,3505.0,ModificationType.MODIFY,77,34,69,0,0,8,77,3,24,16,29,27,45,114.79398751947123,213.9699375973561,1.8125,387.82051189520797,21.54558399417822,0.07132331253245204,False
1088,741f0fedd1d8661ed671fdc7a1091dd42203a56f,/Users/sanika/Downloads/Master Thesis/repo_updated/pytest/src/_pytest/main.py,3505.0,ModificationType.MODIFY,712,438,573,51,9,84,763,14,102,71,128,116,199,733.8903537898989,1364.7382180303869,8.784313725490197,11988.288660345359,666.0160366858534,0.4549127393434623,False
1089,741f0fedd1d8661ed671fdc7a1091dd42203a56f,/Users/sanika/Downloads/Master Thesis/repo_updated/pytest/testing/test_nodes.py,1828.0,ModificationType.MODIFY,53,23,39,0,0,13,53,2,8,4,8,10,12,26.0,39.863137138648355,1.0,39.863137138648355,2.2146187299249087,0.013287712379549451,False
1090,741f0fedd1d8661ed671fdc7a1091dd42203a56f,/Users/sanika/Downloads/Master Thesis/repo_updated/pytest/src/_pytest/nodes.py,1828.0,ModificationType.MODIFY,515,298,307,33,80,99,548,12,63,44,77,75,121,419.5881851891487,753.6870615500015,7.333333333333332,5527.038451366679,307.0576917425932,0.2512290205166672,False
1091,741f0fedd1d8661ed671fdc7a1091dd42203a56f,/Users/sanika/Downloads/Master Thesis/repo_updated/pytest/doc/en/example/multipython.py,6698.0,ModificationType.MODIFY,72,33,56,0,4,12,72,1,1,1,1,2,2,0.0,2.0,0.5,1.0,0.05555555555555555,0.0006666666666666666,False
1092,741f0fedd1d8661ed671fdc7a1091dd42203a56f,/Users/sanika/Downloads/Master Thesis/repo_updated/pytest/src/_pytest/python.py,6698.0,ModificationType.MODIFY,1454,835,1044,76,110,219,1530,17,275,158,296,292,454,2297.8910156145625,3718.1803497315277,9.149090909090908,34017.97003608918,1889.8872242271768,1.2393934499105097,False
1093,741f0fedd1d8661ed671fdc7a1091dd42203a56f,/Users/sanika/Downloads/Master Thesis/repo_updated/pytest/testing/test_reports.py,1979.0,ModificationType.MODIFY,466,257,367,18,25,50,484,7,126,86,171,133,257,898.7887548153927,1813.2075859238055,4.75,8612.736033138077,478.4853351743376,0.6044025286412685,False
1094,741f0fedd1d8661ed671fdc7a1091dd42203a56f,/Users/sanika/Downloads/Master Thesis/repo_updated/pytest/src/_pytest/reports.py,1979.0,ModificationType.MODIFY,507,281,342,29,59,88,536,10,53,29,57,63,86,336.7990650407233,514.0460734209928,5.377358490566038,2764.2100174525085,153.56722319180602,0.17134869114033094,False
1095,741f0fedd1d8661ed671fdc7a1091dd42203a56f,/Users/sanika/Downloads/Master Thesis/repo_updated/pytest/testing/test_runner.py,1930.0,ModificationType.MODIFY,1043,504,840,53,9,147,1096,9,180,112,198,189,310,1377.0628823523223,2344.2951515085324,4.95,11604.260999967237,644.6811666648464,0.7814317171695108,False
1096,741f0fedd1d8661ed671fdc7a1091dd42203a56f,/Users/sanika/Downloads/Master Thesis/repo_updated/pytest/src/_pytest/runner.py,1930.0,ModificationType.MODIFY,383,288,292,26,6,62,409,11,65,38,67,76,105,429.5076556518598,656.0323889115765,5.6692307692307695,3719.1990048294756,206.6221669349709,0.2186774629705255,False
1097,741f0fedd1d8661ed671fdc7a1091dd42203a56f,/Users/sanika/Downloads/Master Thesis/repo_updated/pytest/testing/code/test_excinfo.py,7107.0,ModificationType.MODIFY,1392,870,1177,35,17,170,1427,14,494,280,531,508,811,4473.796381311637,7289.823280972227,7.5242914979757085,54850.755334764704,3047.2641852647052,2.4299410936574084,False
1098,cab29dc861ce4d28cc3a33e70bd6cb5c5bbea801,/Users/sanika/Downloads/Master Thesis/repo_updated/pytest/testing/test_warnings.py,1715.0,ModificationType.MODIFY,601,196,481,2,23,85,603,8,63,36,72,71,108,400.5686351804948,664.1726889065056,4.571428571428571,3036.21800642974,168.67877813498555,0.22139089630216852,False
1099,0794289689a3079625d8c6fd839968075b852e13,/Users/sanika/Downloads/Master Thesis/repo_updated/pytest/testing/code/test_code.py,5035.0,ModificationType.MODIFY,182,127,129,0,0,53,182,5,39,21,42,44,63,217.7403270100645,343.9441919741497,2.6923076923076925,926.003593776557,51.44464409869761,0.11464806399138325,False
1100,0794289689a3079625d8c6fd839968075b852e13,/Users/sanika/Downloads/Master Thesis/repo_updated/pytest/src/_pytest/_code/code.py,5035.0,ModificationType.MODIFY,1165,710,800,67,119,181,1232,18,243,153,282,261,435,2000.7880884021665,3492.1391085079,10.444444444444443,36473.45291108252,2026.302939504584,1.1640463695026333,False
1101,0794289689a3079625d8c6fd839968075b852e13,/Users/sanika/Downloads/Master Thesis/repo_updated/pytest/testing/test_doctest.py,2729.0,ModificationType.MODIFY,1455,414,1257,16,76,112,1471,5,41,23,46,46,69,231.26927266377825,381.12577496793386,2.804878048780488,1069.0113200320095,59.3895177795561,0.1270419249893113,False
1102,0794289689a3079625d8c6fd839968075b852e13,/Users/sanika/Downloads/Master Thesis/repo_updated/pytest/src/_pytest/doctest.py,2729.0,ModificationType.MODIFY,669,365,481,22,61,110,691,15,103,63,122,118,185,747.3129132339992,1273.2889641319407,8.88349514563107,11311.256331851706,628.403129547317,0.4244296547106469,False
1103,0794289689a3079625d8c6fd839968075b852e13,/Users/sanika/Downloads/Master Thesis/repo_updated/pytest/testing/python/fixtures.py,6241.0,ModificationType.MODIFY,4293,999,3693,19,54,507,4312,9,155,88,170,164,258,1156.3286078304875,1898.2484171914662,4.935483870967742,9368.774446138525,520.4874692299181,0.6327494723971553,False
1104,0794289689a3079625d8c6fd839968075b852e13,/Users/sanika/Downloads/Master Thesis/repo_updated/pytest/src/_pytest/fixtures.py,6241.0,ModificationType.MODIFY,1482,859,1002,125,135,219,1607,16,219,134,251,235,385,1766.6783660526569,3032.459024427525,9.168949771689498,27804.46447968251,1544.692471093473,1.0108196748091751,False
1105,0794289689a3079625d8c6fd839968075b852e13,/Users/sanika/Downloads/Master Thesis/repo_updated/pytest/testing/test_main.py,3505.0,ModificationType.MODIFY,77,34,69,0,0,8,77,3,24,16,29,27,45,114.79398751947123,213.9699375973561,1.8125,387.82051189520797,21.54558399417822,0.07132331253245204,False
1106,0794289689a3079625d8c6fd839968075b852e13,/Users/sanika/Downloads/Master Thesis/repo_updated/pytest/src/_pytest/main.py,3505.0,ModificationType.MODIFY,712,438,573,51,9,84,763,14,102,71,128,116,199,733.8903537898989,1364.7382180303869,8.784313725490197,11988.288660345359,666.0160366858534,0.4549127393434623,False
1107,0794289689a3079625d8c6fd839968075b852e13,/Users/sanika/Downloads/Master Thesis/repo_updated/pytest/testing/test_nodes.py,1828.0,ModificationType.MODIFY,53,23,39,0,0,13,53,2,8,4,8,10,12,26.0,39.863137138648355,1.0,39.863137138648355,2.2146187299249087,0.013287712379549451,False
1108,0794289689a3079625d8c6fd839968075b852e13,/Users/sanika/Downloads/Master Thesis/repo_updated/pytest/src/_pytest/nodes.py,1828.0,ModificationType.MODIFY,515,298,307,33,80,99,548,12,63,44,77,75,121,419.5881851891487,753.6870615500015,7.333333333333332,5527.038451366679,307.0576917425932,0.2512290205166672,False
1109,0794289689a3079625d8c6fd839968075b852e13,/Users/sanika/Downloads/Master Thesis/repo_updated/pytest/doc/en/example/multipython.py,6698.0,ModificationType.MODIFY,72,33,56,0,4,12,72,1,1,1,1,2,2,0.0,2.0,0.5,1.0,0.05555555555555555,0.0006666666666666666,False
1110,0794289689a3079625d8c6fd839968075b852e13,/Users/sanika/Downloads/Master Thesis/repo_updated/pytest/src/_pytest/python.py,6698.0,ModificationType.MODIFY,1454,835,1044,76,110,219,1530,17,275,158,296,292,454,2297.8910156145625,3718.1803497315277,9.149090909090908,34017.97003608918,1889.8872242271768,1.2393934499105097,False
1111,0794289689a3079625d8c6fd839968075b852e13,/Users/sanika/Downloads/Master Thesis/repo_updated/pytest/testing/test_reports.py,1979.0,ModificationType.MODIFY,466,257,367,18,25,50,484,7,126,86,171,133,257,898.7887548153927,1813.2075859238055,4.75,8612.736033138077,478.4853351743376,0.6044025286412685,False
1112,0794289689a3079625d8c6fd839968075b852e13,/Users/sanika/Downloads/Master Thesis/repo_updated/pytest/src/_pytest/reports.py,1979.0,ModificationType.MODIFY,507,281,342,29,59,88,536,10,53,29,57,63,86,336.7990650407233,514.0460734209928,5.377358490566038,2764.2100174525085,153.56722319180602,0.17134869114033094,False
1113,0794289689a3079625d8c6fd839968075b852e13,/Users/sanika/Downloads/Master Thesis/repo_updated/pytest/testing/test_runner.py,1930.0,ModificationType.MODIFY,1043,504,840,53,9,147,1096,9,180,112,198,189,310,1377.0628823523223,2344.2951515085324,4.95,11604.260999967237,644.6811666648464,0.7814317171695108,False
1114,0794289689a3079625d8c6fd839968075b852e13,/Users/sanika/Downloads/Master Thesis/repo_updated/pytest/src/_pytest/runner.py,1930.0,ModificationType.MODIFY,383,288,292,26,6,62,409,11,65,38,67,76,105,429.5076556518598,656.0323889115765,5.6692307692307695,3719.1990048294756,206.6221669349709,0.2186774629705255,False
1115,0794289689a3079625d8c6fd839968075b852e13,/Users/sanika/Downloads/Master Thesis/repo_updated/pytest/testing/code/test_excinfo.py,7107.0,ModificationType.MODIFY,1392,870,1177,35,17,170,1427,14,494,280,531,508,811,4473.796381311637,7289.823280972227,7.5242914979757085,54850.755334764704,3047.2641852647052,2.4299410936574084,False
1116,262ed567d065cf2455f988a60def75133a711345,/Users/sanika/Downloads/Master Thesis/repo_updated/pytest/testing/test_cacheprovider.py,3865.0,ModificationType.MODIFY,996,429,845,24,10,117,1020,7,76,50,88,83,138,494.49397547611574,879.7554415258757,4.052631578947368,3565.324684078549,198.07359355991935,0.2932518138419585,False
1117,9309ae299ae94caf66187f98ad500ef6f082d762,/Users/sanika/Downloads/Master Thesis/repo_updated/pytest/testing/test_cacheprovider.py,3873.0,ModificationType.MODIFY,996,429,845,24,10,117,1020,7,76,50,88,83,138,494.49397547611574,879.7554415258757,4.052631578947368,3565.324684078549,198.07359355991935,0.2932518138419585,False
1118,d8096925fac4093deda89bc952e12e46bb9557ab,/Users/sanika/Downloads/Master Thesis/repo_updated/pytest/testing/test_cacheprovider.py,3885.0,ModificationType.MODIFY,996,429,845,24,10,117,1020,7,76,50,88,83,138,494.49397547611574,879.7554415258757,4.052631578947368,3565.324684078549,198.07359355991935,0.2932518138419585,False
1119,00f67494e5de70ffa4427bf0802a164c5790160d,/Users/sanika/Downloads/Master Thesis/repo_updated/pytest/testing/test_terminal.py,6307.0,ModificationType.MODIFY,1943,715,1694,26,18,214,1969,12,185,120,237,197,357,1436.3251202041715,2721.0724995459263,7.686486486486486,20915.486996509768,1161.971499806098,0.9070241665153088,False
1120,00f67494e5de70ffa4427bf0802a164c5790160d,/Users/sanika/Downloads/Master Thesis/repo_updated/pytest/src/_pytest/terminal.py,6307.0,ModificationType.MODIFY,1168,838,957,57,25,144,1225,19,348,224,416,367,640,3018.854959310786,5452.567201819657,11.35632183908046,61921.107993078396,3440.0615551710216,1.817522400606552,False
1121,00f67494e5de70ffa4427bf0802a164c5790160d,/Users/sanika/Downloads/Master Thesis/repo_updated/pytest/testing/test_terminal.py,6806.0,ModificationType.MODIFY,1943,715,1694,26,18,214,1969,12,185,120,237,197,357,1436.3251202041715,2721.0724995459263,7.686486486486486,20915.486996509768,1161.971499806098,0.9070241665153088,False
1122,e7320c6b547750e630ac59d8b40d48be25e779ce,/Users/sanika/Downloads/Master Thesis/repo_updated/pytest/src/_pytest/logging.py,2969.0,ModificationType.MODIFY,773,422,505,30,103,129,803,14,77,46,83,91,129,535.8455325423139,839.5055085856317,7.545454545454546,6334.450655691586,351.9139253161992,0.2798351695285439,False
1123,e7320c6b547750e630ac59d8b40d48be25e779ce,/Users/sanika/Downloads/Master Thesis/repo_updated/pytest/testing/logging/test_formatter.py,501.0,ModificationType.MODIFY,149,67,118,4,0,27,153,1,17,14,28,18,42,69.48686830125578,175.13685006057707,0.8235294117647058,144.23034710871056,8.01279706159503,0.058378950020192374,False
1124,ce3d43100267622edbfcf5786d20bdd23c8e29af,/Users/sanika/Downloads/Master Thesis/repo_updated/pytest/src/_pytest/assertion/util.py,2511.0,ModificationType.MODIFY,477,336,357,30,23,73,507,16,194,134,250,210,384,1538.3830913843026,2962.2702787837907,10.309278350515463,30538.868853441152,1696.603825191175,0.9874234262612636,False
1125,ce3d43100267622edbfcf5786d20bdd23c8e29af,/Users/sanika/Downloads/Master Thesis/repo_updated/pytest/testing/test_assertion.py,5319.0,ModificationType.MODIFY,1450,624,1228,12,26,181,1462,14,306,186,354,320,540,2580.063648772758,4493.841171239174,8.098039215686274,36391.30203376038,2021.7390018755768,1.4979470570797249,False
1126,9071a2a5e01a1f2a44af793d3466a3aa9433b8b7,/Users/sanika/Downloads/Master Thesis/repo_updated/pytest/testing/test_nodes.py,1826.0,ModificationType.MODIFY,53,23,39,0,0,13,53,2,8,4,8,10,12,26.0,39.863137138648355,1.0,39.863137138648355,2.2146187299249087,0.013287712379549451,False
1127,9071a2a5e01a1f2a44af793d3466a3aa9433b8b7,/Users/sanika/Downloads/Master Thesis/repo_updated/pytest/src/_pytest/nodes.py,1826.0,ModificationType.MODIFY,515,298,307,33,80,99,548,12,63,44,77,75,121,419.5881851891487,753.6870615500015,7.333333333333332,5527.038451366679,307.0576917425932,0.2512290205166672,False
1128,eb4b3ce1c84fe5919d38e0d58805ca417c8a499d,/Users/sanika/Downloads/Master Thesis/repo_updated/pytest/testing/test_capture.py,5003.0,ModificationType.MODIFY,1513,682,1277,25,13,200,1538,11,199,116,219,210,335,1557.7420472931965,2584.272248418151,6.052763819095478,15641.989563917903,868.9994202176613,0.8614240828060503,False
1129,0485b07ff07ad5520418142c7a85b50111403e78,/Users/sanika/Downloads/Master Thesis/repo_updated/pytest/testing/python/approx.py,4372.0,ModificationType.MODIFY,520,294,400,33,13,81,553,10,261,204,367,271,571,2128.502746053614,4614.9071026130605,7.030651340996169,32445.802809559264,1802.5446005310705,1.5383023675376872,False
1130,01769b141a842ba4e7c53d853bb0c7d14c111451,/Users/sanika/Downloads/Master Thesis/repo_updated/pytest/testing/test_skipping.py,786.0,ModificationType.MODIFY,1178,367,1042,6,15,115,1184,9,94,51,95,103,146,644.6606770706788,976.22907696875,4.547872340425532,4439.7652170653255,246.65362317029587,0.3254096923229167,False
1131,01769b141a842ba4e7c53d853bb0c7d14c111451,/Users/sanika/Downloads/Master Thesis/repo_updated/pytest/src/_pytest/skipping.py,786.0,ModificationType.MODIFY,177,108,140,8,0,27,185,6,30,16,32,36,48,162.7164928725825,248.15640006923095,3.2,794.1004802215393,44.11669334564107,0.082718800023077,False
1132,01769b141a842ba4e7c53d853bb0c7d14c111451,/Users/sanika/Downloads/Master Thesis/repo_updated/pytest/testing/test_terminal.py,6305.0,ModificationType.MODIFY,1943,715,1694,26,18,214,1969,12,185,120,237,197,357,1436.3251202041715,2721.0724995459263,7.686486486486486,20915.486996509768,1161.971499806098,0.9070241665153088,False
1133,01769b141a842ba4e7c53d853bb0c7d14c111451,/Users/sanika/Downloads/Master Thesis/repo_updated/pytest/src/_pytest/terminal.py,6305.0,ModificationType.MODIFY,1168,838,957,57,25,144,1225,19,348,224,416,367,640,3018.854959310786,5452.567201819657,11.35632183908046,61921.107993078396,3440.0615551710216,1.817522400606552,False
1134,01769b141a842ba4e7c53d853bb0c7d14c111451,/Users/sanika/Downloads/Master Thesis/repo_updated/pytest/testing/test_skipping.py,3071.0,ModificationType.MODIFY,1178,367,1042,6,15,115,1184,9,94,51,95,103,146,644.6606770706788,976.22907696875,4.547872340425532,4439.7652170653255,246.65362317029587,0.3254096923229167,False
1135,92b436c938ae08ef8b579a88d9ace8e807b5927e,/Users/sanika/Downloads/Master Thesis/repo_updated/pytest/testing/test_cacheprovider.py,3885.0,ModificationType.MODIFY,996,429,845,24,10,117,1020,7,76,50,88,83,138,494.49397547611574,879.7554415258757,4.052631578947368,3565.324684078549,198.07359355991935,0.2932518138419585,False
1136,4e454724057ceda78790caaace6810194aa22dc4,/Users/sanika/Downloads/Master Thesis/repo_updated/pytest/testing/code/test_code.py,5035.0,ModificationType.MODIFY,182,127,129,0,0,53,182,5,39,21,42,44,63,217.7403270100645,343.9441919741497,2.6923076923076925,926.003593776557,51.44464409869761,0.11464806399138325,False
1137,4e454724057ceda78790caaace6810194aa22dc4,/Users/sanika/Downloads/Master Thesis/repo_updated/pytest/src/_pytest/_code/code.py,5035.0,ModificationType.MODIFY,1165,710,800,67,119,181,1232,18,243,153,282,261,435,2000.7880884021665,3492.1391085079,10.444444444444443,36473.45291108252,2026.302939504584,1.1640463695026333,False
1138,4e454724057ceda78790caaace6810194aa22dc4,/Users/sanika/Downloads/Master Thesis/repo_updated/pytest/src/_pytest/assertion/util.py,2508.0,ModificationType.MODIFY,477,336,357,30,23,73,507,16,194,134,250,210,384,1538.3830913843026,2962.2702787837907,10.309278350515463,30538.868853441152,1696.603825191175,0.9874234262612636,False
1139,4e454724057ceda78790caaace6810194aa22dc4,/Users/sanika/Downloads/Master Thesis/repo_updated/pytest/src/_pytest/debugging.py,1477.0,ModificationType.MODIFY,339,213,244,17,9,65,356,10,42,26,48,52,74,259.6966127055816,421.83253914244085,5.7142857142857135,2410.4716522425188,133.91509179125106,0.1406108463808136,False
1140,4e454724057ceda78790caaace6810194aa22dc4,/Users/sanika/Downloads/Master Thesis/repo_updated/pytest/testing/test_junitxml.py,3166.0,ModificationType.MODIFY,1523,757,1297,19,12,193,1542,12,193,117,230,205,347,1508.3637582013935,2664.7795945283897,7.150259067357513,19053.86445828589,1058.5480254603274,0.8882598648427965,False
1141,4e454724057ceda78790caaace6810194aa22dc4,/Users/sanika/Downloads/Master Thesis/repo_updated/pytest/src/_pytest/junitxml.py,3166.0,ModificationType.MODIFY,701,378,504,33,58,109,734,13,110,68,126,123,194,794.0552848235468,1346.8478140358125,7.445454545454545,10027.894179048459,557.1052321693588,0.4489492713452708,False
1142,4e454724057ceda78790caaace6810194aa22dc4,/Users/sanika/Downloads/Master Thesis/repo_updated/pytest/testing/test_main.py,3505.0,ModificationType.MODIFY,77,34,69,0,0,8,77,3,24,16,29,27,45,114.79398751947123,213.9699375973561,1.8125,387.82051189520797,21.54558399417822,0.07132331253245204,False
1143,4e454724057ceda78790caaace6810194aa22dc4,/Users/sanika/Downloads/Master Thesis/repo_updated/pytest/src/_pytest/main.py,3505.0,ModificationType.MODIFY,712,438,573,51,9,84,763,14,102,71,128,116,199,733.8903537898989,1364.7382180303869,8.784313725490197,11988.288660345359,666.0160366858534,0.4549127393434623,False
1144,4e454724057ceda78790caaace6810194aa22dc4,/Users/sanika/Downloads/Master Thesis/repo_updated/pytest/src/_pytest/mark/evaluate.py,669.0,ModificationType.MODIFY,125,97,103,3,0,19,128,9,25,17,27,34,44,144.6257297573489,223.84836501501496,4.86,1087.9030539729727,60.43905855405405,0.07461612167167166,False
1145,4e454724057ceda78790caaace6810194aa22dc4,/Users/sanika/Downloads/Master Thesis/repo_updated/pytest/src/_pytest/mark/legacy.py,367.0,ModificationType.MODIFY,102,57,55,5,16,25,107,5,17,10,18,22,28,81.0965087756926,124.86408532184431,2.647058823529412,330.5225787931173,18.36236548850652,0.04162136177394811,False
1146,4e454724057ceda78790caaace6810194aa22dc4,/Users/sanika/Downloads/Master Thesis/repo_updated/pytest/doc/en/example/multipython.py,6698.0,ModificationType.MODIFY,72,33,56,0,4,12,72,1,1,1,1,2,2,0.0,2.0,0.5,1.0,0.05555555555555555,0.0006666666666666666,False
1147,4e454724057ceda78790caaace6810194aa22dc4,/Users/sanika/Downloads/Master Thesis/repo_updated/pytest/src/_pytest/python.py,6698.0,ModificationType.MODIFY,1454,835,1044,76,110,219,1530,17,275,158,296,292,454,2297.8910156145625,3718.1803497315277,9.149090909090908,34017.97003608918,1889.8872242271768,1.2393934499105097,False
1148,4e454724057ceda78790caaace6810194aa22dc4,/Users/sanika/Downloads/Master Thesis/repo_updated/pytest/testing/test_skipping.py,786.0,ModificationType.MODIFY,1178,367,1042,6,15,115,1184,9,94,51,95,103,146,644.6606770706788,976.22907696875,4.547872340425532,4439.7652170653255,246.65362317029587,0.3254096923229167,False
1149,4e454724057ceda78790caaace6810194aa22dc4,/Users/sanika/Downloads/Master Thesis/repo_updated/pytest/src/_pytest/skipping.py,786.0,ModificationType.MODIFY,177,108,140,8,0,27,185,6,30,16,32,36,48,162.7164928725825,248.15640006923095,3.2,794.1004802215393,44.11669334564107,0.082718800023077,False
1150,4e454724057ceda78790caaace6810194aa22dc4,/Users/sanika/Downloads/Master Thesis/repo_updated/pytest/testing/python/metafunc.py,5933.0,ModificationType.MODIFY,1782,648,1425,9,47,279,1791,8,171,97,189,179,286,1292.4527800454887,2140.3713122975773,4.421052631578949,9462.69422278929,525.705234599405,0.7134571040991925,False
1151,4e454724057ceda78790caaace6810194aa22dc4,/Users/sanika/Downloads/Master Thesis/repo_updated/pytest/testing/test_mark.py,3090.0,ModificationType.MODIFY,1020,354,843,12,15,144,1032,8,134,77,144,142,221,970.8559515213416,1580.0941134105346,4.298507462686567,6792.0463382422995,377.3359076801278,0.5266980378035117,False
1152,4e454724057ceda78790caaace6810194aa22dc4,/Users/sanika/Downloads/Master Thesis/repo_updated/pytest/testing/test_nose.py,637.0,ModificationType.MODIFY,424,94,331,4,0,89,428,1,5,5,5,6,10,11.60964047443681,25.849625007211557,0.5,12.924812503605779,0.7180451390892101,0.00861654166907052,False
1153,4e454724057ceda78790caaace6810194aa22dc4,/Users/sanika/Downloads/Master Thesis/repo_updated/pytest/testing/test_parseopt.py,2315.0,ModificationType.MODIFY,334,251,279,10,4,40,344,5,127,74,143,132,217,899.1725956945018,1528.6335239007847,2.81496062992126,4303.0431873585085,239.05795485325038,0.5095445079669282,False
1154,4e454724057ceda78790caaace6810194aa22dc4,/Users/sanika/Downloads/Master Thesis/repo_updated/pytest/testing/test_pdb.py,4230.0,ModificationType.MODIFY,1293,570,1093,25,15,163,1318,10,195,123,241,205,364,1516.6486921300477,2795.3307562199825,6.17948717948718,17273.710570487587,959.6505872493103,0.931776918739994,False
1155,4e454724057ceda78790caaace6810194aa22dc4,/Users/sanika/Downloads/Master Thesis/repo_updated/pytest/testing/test_stepwise.py,645.0,ModificationType.MODIFY,219,78,157,11,5,46,230,3,24,20,34,27,54,114.79398751947123,256.7639251168273,2.125,545.6233408732581,30.31240782629212,0.08558797503894246,False
1156,8dcee39ce93f36acd2f7daf4482546a6ac9f4041,/Users/sanika/Downloads/Master Thesis/repo_updated/pytest/testing/test_capture.py,5010.0,ModificationType.MODIFY,1513,682,1277,25,13,200,1538,11,199,116,219,210,335,1557.7420472931965,2584.272248418151,6.052763819095478,15641.989563917903,868.9994202176613,0.8614240828060503,False
1157,74f4ec59869c417b1891f7a97cd184a2093263a7,/Users/sanika/Downloads/Master Thesis/repo_updated/pytest/testing/example_scripts/collect/package_infinite_recursion/__init__.pyi,5077.0,ModificationType.MODIFY,0,0,0,0,0,0,0,0,0,0,0,0,0,0.0,0.0,0.0,0.0,0.0,0.0,False
1158,74f4ec59869c417b1891f7a97cd184a2093263a7,/Users/sanika/Downloads/Master Thesis/repo_updated/pytest/testing/example_scripts/collect/package_infinite_recursion/tests/__init__.py,5077.0,ModificationType.MODIFY,0,0,0,0,0,0,0,0,0,0,0,0,0,0.0,0.0,0.0,0.0,0.0,0.0,False
1159,74f4ec59869c417b1891f7a97cd184a2093263a7,/Users/sanika/Downloads/Master Thesis/repo_updated/pytest/testing/example_scripts/collect/collect_init_tests/tests/__init__.py,5077.0,ModificationType.MODIFY,2,2,2,0,0,0,2,0,0,0,0,0,0,0.0,0.0,0.0,0.0,0.0,0.0,False
1160,74f4ec59869c417b1891f7a97cd184a2093263a7,/Users/sanika/Downloads/Master Thesis/repo_updated/pytest/testing/example_scripts/collect/package_init_given_as_arg/pkg/__init__.py,5077.0,ModificationType.MODIFY,0,0,0,0,0,0,0,0,0,0,0,0,0,0.0,0.0,0.0,0.0,0.0,0.0,False
1161,74f4ec59869c417b1891f7a97cd184a2093263a7,/Users/sanika/Downloads/Master Thesis/repo_updated/pytest/testing/example_scripts/conftest_usageerror/__init__.pyi,5077.0,ModificationType.MODIFY,0,0,0,0,0,0,0,0,0,0,0,0,0,0.0,0.0,0.0,0.0,0.0,0.0,False
1162,74f4ec59869c417b1891f7a97cd184a2093263a7,/Users/sanika/Downloads/Master Thesis/repo_updated/pytest/testing/example_scripts/marks/marks_considered_keywords/__init__.pyi,5077.0,ModificationType.MODIFY,0,0,0,0,0,0,0,0,0,0,0,0,0,0.0,0.0,0.0,0.0,0.0,0.0,False
1163,74f4ec59869c417b1891f7a97cd184a2093263a7,/Users/sanika/Downloads/Master Thesis/repo_updated/pytest/testing/example_scripts/config/collect_pytest_prefix/__init__.pyi,5077.0,ModificationType.MODIFY,0,0,0,0,0,0,0,0,0,0,0,0,0,0.0,0.0,0.0,0.0,0.0,0.0,False
1164,74f4ec59869c417b1891f7a97cd184a2093263a7,/Users/sanika/Downloads/Master Thesis/repo_updated/pytest/testing/example_scripts/issue88_initial_file_multinodes/__init__.pyi,5077.0,ModificationType.MODIFY,0,0,0,0,0,0,0,0,0,0,0,0,0,0.0,0.0,0.0,0.0,0.0,0.0,False
1165,74f4ec59869c417b1891f7a97cd184a2093263a7,/Users/sanika/Downloads/Master Thesis/repo_updated/pytest/testing/example_scripts/fixtures/fill_fixtures/test_extend_fixture_conftest_conftest/__init__.pyi,5077.0,ModificationType.MODIFY,0,0,0,0,0,0,0,0,0,0,0,0,0,0.0,0.0,0.0,0.0,0.0,0.0,False
1166,74f4ec59869c417b1891f7a97cd184a2093263a7,/Users/sanika/Downloads/Master Thesis/repo_updated/pytest/testing/example_scripts/fixtures/fill_fixtures/test_extend_fixture_conftest_conftest/pkg/__init__.py,5077.0,ModificationType.MODIFY,0,0,0,0,0,0,0,0,0,0,0,0,0,0.0,0.0,0.0,0.0,0.0,0.0,False
1167,74f4ec59869c417b1891f7a97cd184a2093263a7,/Users/sanika/Downloads/Master Thesis/repo_updated/pytest/testing/example_scripts/fixtures/fill_fixtures/test_extend_fixture_conftest_module/__init__.pyi,5077.0,ModificationType.MODIFY,0,0,0,0,0,0,0,0,0,0,0,0,0,0.0,0.0,0.0,0.0,0.0,0.0,False
1168,74f4ec59869c417b1891f7a97cd184a2093263a7,/Users/sanika/Downloads/Master Thesis/repo_updated/pytest/testing/example_scripts/fixtures/fill_fixtures/test_conftest_funcargs_only_available_in_subdir/sub1/__init__.py,5077.0,ModificationType.MODIFY,0,0,0,0,0,0,0,0,0,0,0,0,0,0.0,0.0,0.0,0.0,0.0,0.0,False
1169,74f4ec59869c417b1891f7a97cd184a2093263a7,/Users/sanika/Downloads/Master Thesis/repo_updated/pytest/testing/example_scripts/fixtures/fill_fixtures/test_conftest_funcargs_only_available_in_subdir/sub2/__init__.py,5077.0,ModificationType.MODIFY,0,0,0,0,0,0,0,0,0,0,0,0,0,0.0,0.0,0.0,0.0,0.0,0.0,False
1170,74f4ec59869c417b1891f7a97cd184a2093263a7,/Users/sanika/Downloads/Master Thesis/repo_updated/pytest/testing/example_scripts/fixtures/custom_item/__init__.pyi,5077.0,ModificationType.MODIFY,0,0,0,0,0,0,0,0,0,0,0,0,0,0.0,0.0,0.0,0.0,0.0,0.0,False
1171,74f4ec59869c417b1891f7a97cd184a2093263a7,/Users/sanika/Downloads/Master Thesis/repo_updated/pytest/testing/example_scripts/fixtures/custom_item/foo/__init__.py,5077.0,ModificationType.MODIFY,0,0,0,0,0,0,0,0,0,0,0,0,0,0.0,0.0,0.0,0.0,0.0,0.0,False
1172,74f4ec59869c417b1891f7a97cd184a2093263a7,/Users/sanika/Downloads/Master Thesis/repo_updated/pytest/doc/en/example/nonpython/__init__.py,5077.0,ModificationType.MODIFY,0,0,0,0,0,0,0,0,0,0,0,0,0,0.0,0.0,0.0,0.0,0.0,0.0,False
1173,74f4ec59869c417b1891f7a97cd184a2093263a7,/Users/sanika/Downloads/Master Thesis/repo_updated/pytest/src/pytest/__init__.py,5077.0,ModificationType.MODIFY,99,48,90,1,3,5,100,0,0,0,0,0,0,0.0,0.0,0.0,0.0,0.0,0.0,False
1174,74f4ec59869c417b1891f7a97cd184a2093263a7,/Users/sanika/Downloads/Master Thesis/repo_updated/pytest/src/_pytest/__init__.py,5077.0,ModificationType.MODIFY,8,5,5,2,0,1,10,0,0,0,0,0,0,0.0,0.0,0.0,0.0,0.0,0.0,False
1175,74f4ec59869c417b1891f7a97cd184a2093263a7,/Users/sanika/Downloads/Master Thesis/repo_updated/pytest/src/_pytest/config/__init__.py,5077.0,ModificationType.MODIFY,1217,716,841,84,126,174,1301,14,185,118,215,199,333,1446.608539104324,2542.995998641035,8.135135135135135,20687.616097052745,1149.3120053918194,0.847665332880345,False
1176,74f4ec59869c417b1891f7a97cd184a2093263a7,/Users/sanika/Downloads/Master Thesis/repo_updated/pytest/src/_pytest/mark/__init__.py,5077.0,ModificationType.MODIFY,160,89,115,0,13,31,160,7,15,11,17,22,28,78.25484338853101,124.86408532184431,3.966666666666667,495.29420510998256,27.516344728332356,0.04162136177394811,False
1177,74f4ec59869c417b1891f7a97cd184a2093263a7,/Users/sanika/Downloads/Master Thesis/repo_updated/pytest/src/_pytest/_code/__init__.py,5077.0,ModificationType.MODIFY,10,10,9,9,0,0,19,0,0,0,0,0,0,0.0,0.0,0.0,0.0,0.0,0.0,False
1178,74f4ec59869c417b1891f7a97cd184a2093263a7,/Users/sanika/Downloads/Master Thesis/repo_updated/pytest/src/_pytest/assertion/__init__.py,5077.0,ModificationType.MODIFY,173,84,99,8,29,36,181,5,12,7,13,17,20,54.62919048309069,81.7492568250068,2.708333333333333,221.40423723439343,12.300235401910744,0.027249752275002263,False
1179,74f4ec59869c417b1891f7a97cd184a2093263a7,/Users/sanika/Downloads/Master Thesis/repo_updated/pytest/src/_pytest/_io/__init__.py,5077.0,ModificationType.MODIFY,3,1,1,3,0,0,6,0,0,0,0,0,0,0.0,0.0,0.0,0.0,0.0,0.0,False
1180,74f4ec59869c417b1891f7a97cd184a2093263a7,/Users/sanika/Downloads/Master Thesis/repo_updated/pytest/src/_pytest/hookspec.py,642.0,ModificationType.MODIFY,647,139,84,35,284,233,682,0,0,0,0,0,0,0.0,0.0,0.0,0.0,0.0,0.0,False
1181,74f4ec59869c417b1891f7a97cd184a2093263a7,/Users/sanika/Downloads/Master Thesis/repo_updated/pytest/testing/test_pluginmanager.py,1924.0,ModificationType.MODIFY,384,251,317,7,8,52,391,11,70,44,84,81,128,467.10355899115797,811.500800369232,6.6,5355.905282436931,297.5502934687184,0.270500266789744,False
1182,85288b53218d4e0037dce9c34bd37f86fa9e212d,/Users/sanika/Downloads/Master Thesis/repo_updated/pytest/doc/en/example/multipython.py,6763.0,ModificationType.MODIFY,72,33,56,0,4,12,72,1,1,1,1,2,2,0.0,2.0,0.5,1.0,0.05555555555555555,0.0006666666666666666,False
1183,85288b53218d4e0037dce9c34bd37f86fa9e212d,/Users/sanika/Downloads/Master Thesis/repo_updated/pytest/src/_pytest/python.py,6763.0,ModificationType.MODIFY,1454,835,1044,76,110,219,1530,17,275,158,296,292,454,2297.8910156145625,3718.1803497315277,9.149090909090908,34017.97003608918,1889.8872242271768,1.2393934499105097,False
1184,85288b53218d4e0037dce9c34bd37f86fa9e212d,/Users/sanika/Downloads/Master Thesis/repo_updated/pytest/testing/test_skipping.py,3116.0,ModificationType.MODIFY,1178,367,1042,6,15,115,1184,9,94,51,95,103,146,644.6606770706788,976.22907696875,4.547872340425532,4439.7652170653255,246.65362317029587,0.3254096923229167,False
1185,1cecdf66198049c7ca48356d8349e2f07732764c,/Users/sanika/Downloads/Master Thesis/repo_updated/pytest/doc/en/conf.py,319.0,ModificationType.MODIFY,382,65,130,157,2,92,539,4,10,5,10,14,15,41.21928094887362,57.11032383086405,2.0,114.22064766172814,6.345591536762672,0.019036774610288014,False
1186,1cecdf66198049c7ca48356d8349e2f07732764c,/Users/sanika/Downloads/Master Thesis/repo_updated/pytest/scripts/release.py,539.0,ModificationType.MODIFY,124,78,88,2,3,26,126,4,13,7,13,17,20,56.10571633583421,81.7492568250068,2.0,163.4985136500136,9.083250758334088,0.027249752275002263,False
1187,fe429d4ce8eaf556930f8739f08eedef209508c9,/Users/sanika/Downloads/Master Thesis/repo_updated/pytest/src/_pytest/assertion/util.py,2511.0,ModificationType.MODIFY,477,336,357,30,23,73,507,16,194,134,250,210,384,1538.3830913843026,2962.2702787837907,10.309278350515463,30538.868853441152,1696.603825191175,0.9874234262612636,False
1188,fe429d4ce8eaf556930f8739f08eedef209508c9,/Users/sanika/Downloads/Master Thesis/repo_updated/pytest/testing/test_assertion.py,5319.0,ModificationType.MODIFY,1450,624,1228,12,26,181,1462,14,306,186,354,320,540,2580.063648772758,4493.841171239174,8.098039215686274,36391.30203376038,2021.7390018755768,1.4979470570797249,False
1189,5be3a9b5cee3ef73b627049272db5bd2e34f5026,/Users/sanika/Downloads/Master Thesis/repo_updated/pytest/testing/test_faulthandler.py,310.0,ModificationType.MODIFY,103,47,73,2,12,15,105,5,16,9,17,21,26,75.60964047443682,114.20025299224777,2.65625,303.3444220106581,16.85246788948101,0.03806675099741593,False
1190,eb7a4e32ad920b4cdd9c956763535fed194ae8a7,/Users/sanika/Downloads/Master Thesis/repo_updated/pytest/testing/io/test_saferepr.py,382.0,ModificationType.MODIFY,149,95,105,2,0,41,151,8,54,28,55,62,83,334.7639251168273,494.1982937621106,4.0740740740740735,2013.4004560678586,111.8555808926588,0.1647327645873702,False
1191,eb7a4e32ad920b4cdd9c956763535fed194ae8a7,/Users/sanika/Downloads/Master Thesis/repo_updated/pytest/src/_pytest/_io/saferepr.py,382.0,ModificationType.MODIFY,82,56,54,0,13,15,82,4,13,8,16,17,24,56.10571633583421,98.09910819000817,2.4615384615384617,241.47472785232785,13.415262658462654,0.03269970273000272,False
1192,eb7a4e32ad920b4cdd9c956763535fed194ae8a7,/Users/sanika/Downloads/Master Thesis/repo_updated/pytest/testing/code/test_excinfo.py,7107.0,ModificationType.MODIFY,1392,870,1177,35,17,170,1427,14,494,280,531,508,811,4473.796381311637,7289.823280972227,7.5242914979757085,54850.755334764704,3047.2641852647052,2.4299410936574084,False
1193,eb7a4e32ad920b4cdd9c956763535fed194ae8a7,/Users/sanika/Downloads/Master Thesis/repo_updated/pytest/testing/io/test_saferepr.py,691.0,ModificationType.MODIFY,149,95,105,2,0,41,151,8,54,28,55,62,83,334.7639251168273,494.1982937621106,4.0740740740740735,2013.4004560678586,111.8555808926588,0.1647327645873702,False
1194,eb7a4e32ad920b4cdd9c956763535fed194ae8a7,/Users/sanika/Downloads/Master Thesis/repo_updated/pytest/testing/test_session.py,1422.0,ModificationType.MODIFY,373,158,315,8,0,51,381,5,76,44,79,81,123,486.4521314961493,779.8015503548088,2.598684210526316,2026.4579762509838,112.5809986806102,0.25993385011826964,False
1195,fee7c7b032b5995339375e8cfbaf8f9832aeb512,/Users/sanika/Downloads/Master Thesis/repo_updated/pytest/testing/io/test_saferepr.py,694.0,ModificationType.MODIFY,149,95,105,2,0,41,151,8,54,28,55,62,83,334.7639251168273,494.1982937621106,4.0740740740740735,2013.4004560678586,111.8555808926588,0.1647327645873702,False
1196,c4a110b20a8c26c9eec89e8f0e496633dab42c98,/Users/sanika/Downloads/Master Thesis/repo_updated/pytest/testing/test_main.py,3503.0,ModificationType.MODIFY,77,34,69,0,0,8,77,3,24,16,29,27,45,114.79398751947123,213.9699375973561,1.8125,387.82051189520797,21.54558399417822,0.07132331253245204,False
1197,c4a110b20a8c26c9eec89e8f0e496633dab42c98,/Users/sanika/Downloads/Master Thesis/repo_updated/pytest/src/_pytest/main.py,3503.0,ModificationType.MODIFY,712,438,573,51,9,84,763,14,102,71,128,116,199,733.8903537898989,1364.7382180303869,8.784313725490197,11988.288660345359,666.0160366858534,0.4549127393434623,False
1198,0c0d33f78ef626dd9aba9151f9ef13e136805f65,/Users/sanika/Downloads/Master Thesis/repo_updated/pytest/testing/test_main.py,3503.0,ModificationType.MODIFY,77,34,69,0,0,8,77,3,24,16,29,27,45,114.79398751947123,213.9699375973561,1.8125,387.82051189520797,21.54558399417822,0.07132331253245204,False
1199,0c0d33f78ef626dd9aba9151f9ef13e136805f65,/Users/sanika/Downloads/Master Thesis/repo_updated/pytest/src/_pytest/main.py,3503.0,ModificationType.MODIFY,712,438,573,51,9,84,763,14,102,71,128,116,199,733.8903537898989,1364.7382180303869,8.784313725490197,11988.288660345359,666.0160366858534,0.4549127393434623,False
1200,cb21a8db1d0dbbf1284eb0e644a8cd7b8fc837be,/Users/sanika/Downloads/Master Thesis/repo_updated/pytest/testing/code/test_source.py,2883.0,ModificationType.MODIFY,773,419,590,28,0,166,801,10,204,113,217,214,330,1598.3940507110583,2554.6841055123778,5.318627450980392,13587.413012161423,754.8562784534123,0.8515613685041261,False
1201,e8a3d1adf2c2688e01e0eaff2110df0d8fc5acd6,/Users/sanika/Downloads/Master Thesis/repo_updated/pytest/testing/test_pdb.py,4230.0,ModificationType.MODIFY,1293,570,1093,25,15,163,1318,10,195,123,241,205,364,1516.6486921300477,2795.3307562199825,6.17948717948718,17273.710570487587,959.6505872493103,0.931776918739994,False
1202,5c00226847e41f734b496e3ba7c7fb8ded0f6739,/Users/sanika/Downloads/Master Thesis/repo_updated/pytest/testing/test_assertion.py,5340.0,ModificationType.MODIFY,1450,624,1228,12,26,181,1462,14,306,186,354,320,540,2580.063648772758,4493.841171239174,8.098039215686274,36391.30203376038,2021.7390018755768,1.4979470570797249,False
1203,dd6cf7c172afbe6a67483e6a5986432f2f5f043f,/Users/sanika/Downloads/Master Thesis/repo_updated/pytest/testing/code/test_excinfo.py,7121.0,ModificationType.MODIFY,1392,870,1177,35,17,170,1427,14,494,280,531,508,811,4473.796381311637,7289.823280972227,7.5242914979757085,54850.755334764704,3047.2641852647052,2.4299410936574084,False
1204,dd852ded705e10c85452fba1458736e71dcb06e0,/Users/sanika/Downloads/Master Thesis/repo_updated/pytest/testing/test_main.py,3505.0,ModificationType.MODIFY,77,34,69,0,0,8,77,3,24,16,29,27,45,114.79398751947123,213.9699375973561,1.8125,387.82051189520797,21.54558399417822,0.07132331253245204,False
1205,dd852ded705e10c85452fba1458736e71dcb06e0,/Users/sanika/Downloads/Master Thesis/repo_updated/pytest/src/_pytest/main.py,3505.0,ModificationType.MODIFY,712,438,573,51,9,84,763,14,102,71,128,116,199,733.8903537898989,1364.7382180303869,8.784313725490197,11988.288660345359,666.0160366858534,0.4549127393434623,False
1206,dd852ded705e10c85452fba1458736e71dcb06e0,/Users/sanika/Downloads/Master Thesis/repo_updated/pytest/testing/acceptance_test.py,4685.0,ModificationType.MODIFY,1289,550,1043,56,32,155,1345,10,167,93,185,177,278,1266.2978977920407,2075.994342923073,5.538922155688622,11498.771061100857,638.8206145056031,0.6919981143076911,False
1207,b268463243a71bcc9e5018e5d3dc9f018539529a,/Users/sanika/Downloads/Master Thesis/repo_updated/pytest/testing/code/test_code.py,5035.0,ModificationType.MODIFY,182,127,129,0,0,53,182,5,39,21,42,44,63,217.7403270100645,343.9441919741497,2.6923076923076925,926.003593776557,51.44464409869761,0.11464806399138325,False
1208,b268463243a71bcc9e5018e5d3dc9f018539529a,/Users/sanika/Downloads/Master Thesis/repo_updated/pytest/src/_pytest/_code/code.py,5035.0,ModificationType.MODIFY,1165,710,800,67,119,181,1232,18,243,153,282,261,435,2000.7880884021665,3492.1391085079,10.444444444444443,36473.45291108252,2026.302939504584,1.1640463695026333,False
1209,b268463243a71bcc9e5018e5d3dc9f018539529a,/Users/sanika/Downloads/Master Thesis/repo_updated/pytest/src/_pytest/assertion/util.py,2508.0,ModificationType.MODIFY,477,336,357,30,23,73,507,16,194,134,250,210,384,1538.3830913843026,2962.2702787837907,10.309278350515463,30538.868853441152,1696.603825191175,0.9874234262612636,False
1210,b268463243a71bcc9e5018e5d3dc9f018539529a,/Users/sanika/Downloads/Master Thesis/repo_updated/pytest/src/_pytest/debugging.py,1477.0,ModificationType.MODIFY,339,213,244,17,9,65,356,10,42,26,48,52,74,259.6966127055816,421.83253914244085,5.7142857142857135,2410.4716522425188,133.91509179125106,0.1406108463808136,False
1211,b268463243a71bcc9e5018e5d3dc9f018539529a,/Users/sanika/Downloads/Master Thesis/repo_updated/pytest/testing/test_junitxml.py,3166.0,ModificationType.MODIFY,1523,757,1297,19,12,193,1542,12,193,117,230,205,347,1508.3637582013935,2664.7795945283897,7.150259067357513,19053.86445828589,1058.5480254603274,0.8882598648427965,False
1212,b268463243a71bcc9e5018e5d3dc9f018539529a,/Users/sanika/Downloads/Master Thesis/repo_updated/pytest/src/_pytest/junitxml.py,3166.0,ModificationType.MODIFY,701,378,504,33,58,109,734,13,110,68,126,123,194,794.0552848235468,1346.8478140358125,7.445454545454545,10027.894179048459,557.1052321693588,0.4489492713452708,False
1213,b268463243a71bcc9e5018e5d3dc9f018539529a,/Users/sanika/Downloads/Master Thesis/repo_updated/pytest/testing/test_main.py,3503.0,ModificationType.MODIFY,77,34,69,0,0,8,77,3,24,16,29,27,45,114.79398751947123,213.9699375973561,1.8125,387.82051189520797,21.54558399417822,0.07132331253245204,False
1214,b268463243a71bcc9e5018e5d3dc9f018539529a,/Users/sanika/Downloads/Master Thesis/repo_updated/pytest/src/_pytest/main.py,3503.0,ModificationType.MODIFY,712,438,573,51,9,84,763,14,102,71,128,116,199,733.8903537898989,1364.7382180303869,8.784313725490197,11988.288660345359,666.0160366858534,0.4549127393434623,False
1215,b268463243a71bcc9e5018e5d3dc9f018539529a,/Users/sanika/Downloads/Master Thesis/repo_updated/pytest/src/_pytest/mark/evaluate.py,669.0,ModificationType.MODIFY,125,97,103,3,0,19,128,9,25,17,27,34,44,144.6257297573489,223.84836501501496,4.86,1087.9030539729727,60.43905855405405,0.07461612167167166,False
1216,b268463243a71bcc9e5018e5d3dc9f018539529a,/Users/sanika/Downloads/Master Thesis/repo_updated/pytest/src/_pytest/mark/legacy.py,367.0,ModificationType.MODIFY,102,57,55,5,16,25,107,5,17,10,18,22,28,81.0965087756926,124.86408532184431,2.647058823529412,330.5225787931173,18.36236548850652,0.04162136177394811,False
1217,b268463243a71bcc9e5018e5d3dc9f018539529a,/Users/sanika/Downloads/Master Thesis/repo_updated/pytest/doc/en/example/multipython.py,6698.0,ModificationType.MODIFY,72,33,56,0,4,12,72,1,1,1,1,2,2,0.0,2.0,0.5,1.0,0.05555555555555555,0.0006666666666666666,False
1218,b268463243a71bcc9e5018e5d3dc9f018539529a,/Users/sanika/Downloads/Master Thesis/repo_updated/pytest/src/_pytest/python.py,6698.0,ModificationType.MODIFY,1454,835,1044,76,110,219,1530,17,275,158,296,292,454,2297.8910156145625,3718.1803497315277,9.149090909090908,34017.97003608918,1889.8872242271768,1.2393934499105097,False
1219,b268463243a71bcc9e5018e5d3dc9f018539529a,/Users/sanika/Downloads/Master Thesis/repo_updated/pytest/testing/test_skipping.py,786.0,ModificationType.MODIFY,1178,367,1042,6,15,115,1184,9,94,51,95,103,146,644.6606770706788,976.22907696875,4.547872340425532,4439.7652170653255,246.65362317029587,0.3254096923229167,False
1220,b268463243a71bcc9e5018e5d3dc9f018539529a,/Users/sanika/Downloads/Master Thesis/repo_updated/pytest/src/_pytest/skipping.py,786.0,ModificationType.MODIFY,177,108,140,8,0,27,185,6,30,16,32,36,48,162.7164928725825,248.15640006923095,3.2,794.1004802215393,44.11669334564107,0.082718800023077,False
1221,b268463243a71bcc9e5018e5d3dc9f018539529a,/Users/sanika/Downloads/Master Thesis/repo_updated/pytest/testing/python/metafunc.py,5933.0,ModificationType.MODIFY,1782,648,1425,9,47,279,1791,8,171,97,189,179,286,1292.4527800454887,2140.3713122975773,4.421052631578949,9462.69422278929,525.705234599405,0.7134571040991925,False
1222,b268463243a71bcc9e5018e5d3dc9f018539529a,/Users/sanika/Downloads/Master Thesis/repo_updated/pytest/testing/test_mark.py,3090.0,ModificationType.MODIFY,1020,354,843,12,15,144,1032,8,134,77,144,142,221,970.8559515213416,1580.0941134105346,4.298507462686567,6792.0463382422995,377.3359076801278,0.5266980378035117,False
1223,b268463243a71bcc9e5018e5d3dc9f018539529a,/Users/sanika/Downloads/Master Thesis/repo_updated/pytest/testing/test_nose.py,637.0,ModificationType.MODIFY,424,94,331,4,0,89,428,1,5,5,5,6,10,11.60964047443681,25.849625007211557,0.5,12.924812503605779,0.7180451390892101,0.00861654166907052,False
1224,b268463243a71bcc9e5018e5d3dc9f018539529a,/Users/sanika/Downloads/Master Thesis/repo_updated/pytest/testing/test_parseopt.py,2315.0,ModificationType.MODIFY,334,251,279,10,4,40,344,5,127,74,143,132,217,899.1725956945018,1528.6335239007847,2.81496062992126,4303.0431873585085,239.05795485325038,0.5095445079669282,False
1225,b268463243a71bcc9e5018e5d3dc9f018539529a,/Users/sanika/Downloads/Master Thesis/repo_updated/pytest/testing/test_pdb.py,4230.0,ModificationType.MODIFY,1293,570,1093,25,15,163,1318,10,195,123,241,205,364,1516.6486921300477,2795.3307562199825,6.17948717948718,17273.710570487587,959.6505872493103,0.931776918739994,False
1226,b268463243a71bcc9e5018e5d3dc9f018539529a,/Users/sanika/Downloads/Master Thesis/repo_updated/pytest/testing/test_stepwise.py,645.0,ModificationType.MODIFY,219,78,157,11,5,46,230,3,24,20,34,27,54,114.79398751947123,256.7639251168273,2.125,545.6233408732581,30.31240782629212,0.08558797503894246,False
1227,ab101658f03e29bf69a7252a937b706ee3f75a01,/Users/sanika/Downloads/Master Thesis/repo_updated/pytest/testing/io/test_saferepr.py,382.0,ModificationType.MODIFY,149,95,105,2,0,41,151,8,54,28,55,62,83,334.7639251168273,494.1982937621106,4.0740740740740735,2013.4004560678586,111.8555808926588,0.1647327645873702,False
1228,ab101658f03e29bf69a7252a937b706ee3f75a01,/Users/sanika/Downloads/Master Thesis/repo_updated/pytest/src/_pytest/_io/saferepr.py,382.0,ModificationType.MODIFY,82,56,54,0,13,15,82,4,13,8,16,17,24,56.10571633583421,98.09910819000817,2.4615384615384617,241.47472785232785,13.415262658462654,0.03269970273000272,False
1229,ab101658f03e29bf69a7252a937b706ee3f75a01,/Users/sanika/Downloads/Master Thesis/repo_updated/pytest/testing/code/test_excinfo.py,7107.0,ModificationType.MODIFY,1392,870,1177,35,17,170,1427,14,494,280,531,508,811,4473.796381311637,7289.823280972227,7.5242914979757085,54850.755334764704,3047.2641852647052,2.4299410936574084,False
1230,ab101658f03e29bf69a7252a937b706ee3f75a01,/Users/sanika/Downloads/Master Thesis/repo_updated/pytest/testing/io/test_saferepr.py,694.0,ModificationType.MODIFY,149,95,105,2,0,41,151,8,54,28,55,62,83,334.7639251168273,494.1982937621106,4.0740740740740735,2013.4004560678586,111.8555808926588,0.1647327645873702,False
1231,ab101658f03e29bf69a7252a937b706ee3f75a01,/Users/sanika/Downloads/Master Thesis/repo_updated/pytest/testing/test_session.py,1422.0,ModificationType.MODIFY,373,158,315,8,0,51,381,5,76,44,79,81,123,486.4521314961493,779.8015503548088,2.598684210526316,2026.4579762509838,112.5809986806102,0.25993385011826964,False
1232,8aa0809fbc9a91ec286ca02bd7f0b673e06905de,/Users/sanika/Downloads/Master Thesis/repo_updated/pytest/testing/test_pathlib.py,1561.0,ModificationType.MODIFY,91,45,69,0,3,18,91,3,9,6,10,12,16,33.28421251514428,57.3594000115385,1.6666666666666667,95.59900001923084,5.311055556623936,0.01911980000384617,False
1233,8aa0809fbc9a91ec286ca02bd7f0b673e06905de,/Users/sanika/Downloads/Master Thesis/repo_updated/pytest/src/_pytest/pathlib.py,1561.0,ModificationType.MODIFY,367,234,237,17,34,68,384,16,55,34,61,71,95,381.9747842438563,584.2259763529447,8.872727272727273,5183.677753822492,287.98209743458284,0.19474199211764828,False
1234,8aa0809fbc9a91ec286ca02bd7f0b673e06905de,/Users/sanika/Downloads/Master Thesis/repo_updated/pytest/testing/test_tmpdir.py,1853.0,ModificationType.MODIFY,442,244,305,14,16,103,456,11,68,45,75,79,120,452.00122101003336,756.4536897812525,6.066176470588236,4588.781574040686,254.932309668927,0.2521512299270841,False
1235,2e5cf1cc789908ab4856c84a99d7d1120f84e694,/Users/sanika/Downloads/Master Thesis/repo_updated/pytest/testing/test_pathlib.py,1561.0,ModificationType.MODIFY,91,45,69,0,3,18,91,3,9,6,10,12,16,33.28421251514428,57.3594000115385,1.6666666666666667,95.59900001923084,5.311055556623936,0.01911980000384617,False
1236,2e5cf1cc789908ab4856c84a99d7d1120f84e694,/Users/sanika/Downloads/Master Thesis/repo_updated/pytest/src/_pytest/pathlib.py,1561.0,ModificationType.MODIFY,367,234,237,17,34,68,384,16,55,34,61,71,95,381.9747842438563,584.2259763529447,8.872727272727273,5183.677753822492,287.98209743458284,0.19474199211764828,False
1237,2e5cf1cc789908ab4856c84a99d7d1120f84e694,/Users/sanika/Downloads/Master Thesis/repo_updated/pytest/testing/test_tmpdir.py,1859.0,ModificationType.MODIFY,442,244,305,14,16,103,456,11,68,45,75,79,120,452.00122101003336,756.4536897812525,6.066176470588236,4588.781574040686,254.932309668927,0.2521512299270841,False
1238,b2537b22d7799d02621a68c1ff4b49adc98693cf,/Users/sanika/Downloads/Master Thesis/repo_updated/pytest/testing/test_warning_types.py,222.0,ModificationType.MODIFY,37,13,25,0,6,6,37,1,2,1,2,3,3,2.0,4.754887502163468,0.5,2.3774437510817346,0.1320802083934297,0.0015849625007211565,False
1239,b2537b22d7799d02621a68c1ff4b49adc98693cf,/Users/sanika/Downloads/Master Thesis/repo_updated/pytest/src/_pytest/warning_types.py,222.0,ModificationType.MODIFY,133,47,40,1,43,49,134,0,0,0,0,0,0,0.0,0.0,0.0,0.0,0.0,0.0,False
1240,58f2849bf6c46790b2d2f9975b61cf1a9bbd9e92,/Users/sanika/Downloads/Master Thesis/repo_updated/pytest/testing/code/test_source.py,1732.0,ModificationType.MODIFY,773,419,590,28,0,166,801,10,204,113,217,214,330,1598.3940507110583,2554.6841055123778,5.318627450980392,13587.413012161423,754.8562784534123,0.8515613685041261,True
1241,58f2849bf6c46790b2d2f9975b61cf1a9bbd9e92,/Users/sanika/Downloads/Master Thesis/repo_updated/pytest/src/_pytest/_code/source.py,1732.0,ModificationType.MODIFY,421,273,302,44,34,57,465,17,81,59,107,98,166,583.0147185349102,1098.0418341231248,11.228395061728396,12329.247507839285,684.9581948799603,0.36601394470770826,True
1242,265a9eb6a2916a8224d0561c269dc52d59d2ac48,/Users/sanika/Downloads/Master Thesis/repo_updated/pytest/testing/test_pytester.py,6311.0,ModificationType.MODIFY,722,423,573,19,0,135,741,12,172,101,199,184,300,1320.3370878174146,2257.068586817104,6.941860465116278,15668.255189881524,870.4586216600846,0.7523561956057013,False
1243,265a9eb6a2916a8224d0561c269dc52d59d2ac48,/Users/sanika/Downloads/Master Thesis/repo_updated/pytest/src/_pytest/pytester.py,6311.0,ModificationType.MODIFY,1508,847,911,44,250,301,1552,14,148,88,169,162,257,1120.302067021891,1886.3414507413486,7.993243243243242,15077.986055587939,837.6658919771077,0.6287804835804495,False
1244,14eaa05b607c22fc40aeda93ded46b40b8b9ed86,/Users/sanika/Downloads/Master Thesis/repo_updated/pytest/testing/code/test_source.py,2883.0,ModificationType.MODIFY,773,419,590,28,0,166,801,10,204,113,217,214,330,1598.3940507110583,2554.6841055123778,5.318627450980392,13587.413012161423,754.8562784534123,0.8515613685041261,False
1245,f11237b0661aa53f3a5bc3c28330365a0e57012c,/Users/sanika/Downloads/Master Thesis/repo_updated/pytest/testing/test_main.py,3503.0,ModificationType.MODIFY,77,34,69,0,0,8,77,3,24,16,29,27,45,114.79398751947123,213.9699375973561,1.8125,387.82051189520797,21.54558399417822,0.07132331253245204,False
1246,f11237b0661aa53f3a5bc3c28330365a0e57012c,/Users/sanika/Downloads/Master Thesis/repo_updated/pytest/src/_pytest/main.py,3503.0,ModificationType.MODIFY,712,438,573,51,9,84,763,14,102,71,128,116,199,733.8903537898989,1364.7382180303869,8.784313725490197,11988.288660345359,666.0160366858534,0.4549127393434623,False
1247,f11237b0661aa53f3a5bc3c28330365a0e57012c,/Users/sanika/Downloads/Master Thesis/repo_updated/pytest/testing/acceptance_test.py,4685.0,ModificationType.MODIFY,1289,550,1043,56,32,155,1345,10,167,93,185,177,278,1266.2978977920407,2075.994342923073,5.538922155688622,11498.771061100857,638.8206145056031,0.6919981143076911,False
1248,19b2f4bb8ac2f981396b5ab1973cceaea3679a2f,/Users/sanika/Downloads/Master Thesis/repo_updated/pytest/testing/code/test_excinfo.py,7121.0,ModificationType.MODIFY,1392,870,1177,35,17,170,1427,14,494,280,531,508,811,4473.796381311637,7289.823280972227,7.5242914979757085,54850.755334764704,3047.2641852647052,2.4299410936574084,False
1249,19b2f4bb8ac2f981396b5ab1973cceaea3679a2f,/Users/sanika/Downloads/Master Thesis/repo_updated/pytest/testing/test_assertion.py,5340.0,ModificationType.MODIFY,1450,624,1228,12,26,181,1462,14,306,186,354,320,540,2580.063648772758,4493.841171239174,8.098039215686274,36391.30203376038,2021.7390018755768,1.4979470570797249,False
1250,e670ff76cbad80108bde9bab616b66771b8653cf,/Users/sanika/Downloads/Master Thesis/repo_updated/pytest/testing/code/test_source.py,1732.0,ModificationType.MODIFY,773,419,590,28,0,166,801,10,204,113,217,214,330,1598.3940507110583,2554.6841055123778,5.318627450980392,13587.413012161423,754.8562784534123,0.8515613685041261,False
1251,e670ff76cbad80108bde9bab616b66771b8653cf,/Users/sanika/Downloads/Master Thesis/repo_updated/pytest/src/_pytest/_code/source.py,1732.0,ModificationType.MODIFY,421,273,302,44,34,57,465,17,81,59,107,98,166,583.0147185349102,1098.0418341231248,11.228395061728396,12329.247507839285,684.9581948799603,0.36601394470770826,False
1252,e670ff76cbad80108bde9bab616b66771b8653cf,/Users/sanika/Downloads/Master Thesis/repo_updated/pytest/testing/test_pytester.py,6311.0,ModificationType.MODIFY,722,423,573,19,0,135,741,12,172,101,199,184,300,1320.3370878174146,2257.068586817104,6.941860465116278,15668.255189881524,870.4586216600846,0.7523561956057013,False
1253,e670ff76cbad80108bde9bab616b66771b8653cf,/Users/sanika/Downloads/Master Thesis/repo_updated/pytest/src/_pytest/pytester.py,6311.0,ModificationType.MODIFY,1508,847,911,44,250,301,1552,14,148,88,169,162,257,1120.302067021891,1886.3414507413486,7.993243243243242,15077.986055587939,837.6658919771077,0.6287804835804495,False
1254,e670ff76cbad80108bde9bab616b66771b8653cf,/Users/sanika/Downloads/Master Thesis/repo_updated/pytest/testing/test_warning_types.py,222.0,ModificationType.MODIFY,37,13,25,0,6,6,37,1,2,1,2,3,3,2.0,4.754887502163468,0.5,2.3774437510817346,0.1320802083934297,0.0015849625007211565,False
1255,e670ff76cbad80108bde9bab616b66771b8653cf,/Users/sanika/Downloads/Master Thesis/repo_updated/pytest/src/_pytest/warning_types.py,222.0,ModificationType.MODIFY,133,47,40,1,43,49,134,0,0,0,0,0,0,0.0,0.0,0.0,0.0,0.0,0.0,False
1256,45c4a8fb3d33698704ac17a376de36ada3cabecf,/Users/sanika/Downloads/Master Thesis/repo_updated/pytest/setup.py,93.0,ModificationType.MODIFY,42,7,35,4,0,5,46,1,2,1,2,3,3,2.0,4.754887502163468,0.5,2.3774437510817346,0.1320802083934297,0.0015849625007211565,False
1257,45c4a8fb3d33698704ac17a376de36ada3cabecf,/Users/sanika/Downloads/Master Thesis/repo_updated/pytest/extra/setup-py.test/setup.py,93.0,ModificationType.MODIFY,11,6,10,0,0,1,11,2,4,2,4,6,6,10.0,15.509775004326935,1.0,15.509775004326935,0.861654166907052,0.005169925001442312,False
1258,45c4a8fb3d33698704ac17a376de36ada3cabecf,/Users/sanika/Downloads/Master Thesis/repo_updated/pytest/testing/test_assertrewrite.py,5617.0,ModificationType.MODIFY,1660,832,1314,41,38,274,1701,20,312,209,395,332,604,2671.484054182769,5058.523816533542,12.660256410256409,64042.208574703494,3557.900476372417,1.6861746055111808,False
1259,45c4a8fb3d33698704ac17a376de36ada3cabecf,/Users/sanika/Downloads/Master Thesis/repo_updated/pytest/src/_pytest/assertion/rewrite.py,5617.0,ModificationType.MODIFY,1057,646,719,113,100,145,1170,18,215,134,248,233,382,1740.9201126876956,3004.119107257935,10.381395348837211,31186.94812744052,1732.608229302251,1.001373035752645,False
1260,45c4a8fb3d33698704ac17a376de36ada3cabecf,/Users/sanika/Downloads/Master Thesis/repo_updated/pytest/testing/test_assertrewrite.py,6340.0,ModificationType.MODIFY,1660,832,1314,41,38,274,1701,20,312,209,395,332,604,2671.484054182769,5058.523816533542,12.660256410256409,64042.208574703494,3557.900476372417,1.6861746055111808,False
1261,4946cc82825c277754979cf6ea995482e5b1e2d5,/Users/sanika/Downloads/Master Thesis/repo_updated/pytest/testing/test_main.py,3505.0,ModificationType.MODIFY,77,34,69,0,0,8,77,3,24,16,29,27,45,114.79398751947123,213.9699375973561,1.8125,387.82051189520797,21.54558399417822,0.07132331253245204,False
1262,4946cc82825c277754979cf6ea995482e5b1e2d5,/Users/sanika/Downloads/Master Thesis/repo_updated/pytest/src/_pytest/main.py,3505.0,ModificationType.MODIFY,712,438,573,51,9,84,763,14,102,71,128,116,199,733.8903537898989,1364.7382180303869,8.784313725490197,11988.288660345359,666.0160366858534,0.4549127393434623,False
1263,4946cc82825c277754979cf6ea995482e5b1e2d5,/Users/sanika/Downloads/Master Thesis/repo_updated/pytest/testing/test_collection.py,4935.0,ModificationType.MODIFY,1296,573,1062,40,33,157,1336,8,201,118,231,209,349,1561.8613899269644,2689.868337096228,4.597014925373134,12365.364892919973,686.9647162733319,0.896622779032076,False
1264,0cf2002a1fcc7eda7d8ff7ff78bb9528098bebe4,/Users/sanika/Downloads/Master Thesis/repo_updated/pytest/testing/example_scripts/collect/package_infinite_recursion/__init__.pyi,596.0,ModificationType.MODIFY,0,0,0,0,0,0,0,0,0,0,0,0,0,0.0,0.0,0.0,0.0,0.0,0.0,False
1265,0cf2002a1fcc7eda7d8ff7ff78bb9528098bebe4,/Users/sanika/Downloads/Master Thesis/repo_updated/pytest/testing/example_scripts/collect/package_infinite_recursion/tests/__init__.py,596.0,ModificationType.MODIFY,0,0,0,0,0,0,0,0,0,0,0,0,0,0.0,0.0,0.0,0.0,0.0,0.0,False
1266,0cf2002a1fcc7eda7d8ff7ff78bb9528098bebe4,/Users/sanika/Downloads/Master Thesis/repo_updated/pytest/testing/example_scripts/collect/collect_init_tests/tests/__init__.py,596.0,ModificationType.MODIFY,2,2,2,0,0,0,2,0,0,0,0,0,0,0.0,0.0,0.0,0.0,0.0,0.0,False
1267,0cf2002a1fcc7eda7d8ff7ff78bb9528098bebe4,/Users/sanika/Downloads/Master Thesis/repo_updated/pytest/testing/example_scripts/collect/package_init_given_as_arg/pkg/__init__.py,596.0,ModificationType.MODIFY,0,0,0,0,0,0,0,0,0,0,0,0,0,0.0,0.0,0.0,0.0,0.0,0.0,False
1268,0cf2002a1fcc7eda7d8ff7ff78bb9528098bebe4,/Users/sanika/Downloads/Master Thesis/repo_updated/pytest/testing/example_scripts/conftest_usageerror/__init__.pyi,596.0,ModificationType.MODIFY,0,0,0,0,0,0,0,0,0,0,0,0,0,0.0,0.0,0.0,0.0,0.0,0.0,False
1269,0cf2002a1fcc7eda7d8ff7ff78bb9528098bebe4,/Users/sanika/Downloads/Master Thesis/repo_updated/pytest/testing/example_scripts/marks/marks_considered_keywords/__init__.pyi,596.0,ModificationType.MODIFY,0,0,0,0,0,0,0,0,0,0,0,0,0,0.0,0.0,0.0,0.0,0.0,0.0,False
1270,0cf2002a1fcc7eda7d8ff7ff78bb9528098bebe4,/Users/sanika/Downloads/Master Thesis/repo_updated/pytest/testing/example_scripts/config/collect_pytest_prefix/__init__.pyi,596.0,ModificationType.MODIFY,0,0,0,0,0,0,0,0,0,0,0,0,0,0.0,0.0,0.0,0.0,0.0,0.0,False
1271,0cf2002a1fcc7eda7d8ff7ff78bb9528098bebe4,/Users/sanika/Downloads/Master Thesis/repo_updated/pytest/testing/example_scripts/issue88_initial_file_multinodes/__init__.pyi,596.0,ModificationType.MODIFY,0,0,0,0,0,0,0,0,0,0,0,0,0,0.0,0.0,0.0,0.0,0.0,0.0,False
1272,0cf2002a1fcc7eda7d8ff7ff78bb9528098bebe4,/Users/sanika/Downloads/Master Thesis/repo_updated/pytest/testing/example_scripts/fixtures/fill_fixtures/test_extend_fixture_conftest_conftest/__init__.pyi,596.0,ModificationType.MODIFY,0,0,0,0,0,0,0,0,0,0,0,0,0,0.0,0.0,0.0,0.0,0.0,0.0,False
1273,0cf2002a1fcc7eda7d8ff7ff78bb9528098bebe4,/Users/sanika/Downloads/Master Thesis/repo_updated/pytest/testing/example_scripts/fixtures/fill_fixtures/test_extend_fixture_conftest_conftest/pkg/__init__.py,596.0,ModificationType.MODIFY,0,0,0,0,0,0,0,0,0,0,0,0,0,0.0,0.0,0.0,0.0,0.0,0.0,False
1274,0cf2002a1fcc7eda7d8ff7ff78bb9528098bebe4,/Users/sanika/Downloads/Master Thesis/repo_updated/pytest/testing/example_scripts/fixtures/fill_fixtures/test_extend_fixture_conftest_module/__init__.pyi,596.0,ModificationType.MODIFY,0,0,0,0,0,0,0,0,0,0,0,0,0,0.0,0.0,0.0,0.0,0.0,0.0,False
1275,0cf2002a1fcc7eda7d8ff7ff78bb9528098bebe4,/Users/sanika/Downloads/Master Thesis/repo_updated/pytest/testing/example_scripts/fixtures/fill_fixtures/test_conftest_funcargs_only_available_in_subdir/sub1/__init__.py,596.0,ModificationType.MODIFY,0,0,0,0,0,0,0,0,0,0,0,0,0,0.0,0.0,0.0,0.0,0.0,0.0,False
1276,0cf2002a1fcc7eda7d8ff7ff78bb9528098bebe4,/Users/sanika/Downloads/Master Thesis/repo_updated/pytest/testing/example_scripts/fixtures/fill_fixtures/test_conftest_funcargs_only_available_in_subdir/sub2/__init__.py,596.0,ModificationType.MODIFY,0,0,0,0,0,0,0,0,0,0,0,0,0,0.0,0.0,0.0,0.0,0.0,0.0,False
1277,0cf2002a1fcc7eda7d8ff7ff78bb9528098bebe4,/Users/sanika/Downloads/Master Thesis/repo_updated/pytest/testing/example_scripts/fixtures/custom_item/__init__.pyi,596.0,ModificationType.MODIFY,0,0,0,0,0,0,0,0,0,0,0,0,0,0.0,0.0,0.0,0.0,0.0,0.0,False
1278,0cf2002a1fcc7eda7d8ff7ff78bb9528098bebe4,/Users/sanika/Downloads/Master Thesis/repo_updated/pytest/testing/example_scripts/fixtures/custom_item/foo/__init__.py,596.0,ModificationType.MODIFY,0,0,0,0,0,0,0,0,0,0,0,0,0,0.0,0.0,0.0,0.0,0.0,0.0,False
1279,0cf2002a1fcc7eda7d8ff7ff78bb9528098bebe4,/Users/sanika/Downloads/Master Thesis/repo_updated/pytest/doc/en/example/nonpython/__init__.py,596.0,ModificationType.MODIFY,0,0,0,0,0,0,0,0,0,0,0,0,0,0.0,0.0,0.0,0.0,0.0,0.0,False
1280,0cf2002a1fcc7eda7d8ff7ff78bb9528098bebe4,/Users/sanika/Downloads/Master Thesis/repo_updated/pytest/src/pytest/__init__.py,596.0,ModificationType.MODIFY,99,48,90,1,3,5,100,0,0,0,0,0,0,0.0,0.0,0.0,0.0,0.0,0.0,False
1281,0cf2002a1fcc7eda7d8ff7ff78bb9528098bebe4,/Users/sanika/Downloads/Master Thesis/repo_updated/pytest/src/_pytest/__init__.py,596.0,ModificationType.MODIFY,8,5,5,2,0,1,10,0,0,0,0,0,0,0.0,0.0,0.0,0.0,0.0,0.0,False
1282,0cf2002a1fcc7eda7d8ff7ff78bb9528098bebe4,/Users/sanika/Downloads/Master Thesis/repo_updated/pytest/src/_pytest/config/__init__.py,596.0,ModificationType.MODIFY,1217,716,841,84,126,174,1301,14,185,118,215,199,333,1446.608539104324,2542.995998641035,8.135135135135135,20687.616097052745,1149.3120053918194,0.847665332880345,False
1283,0cf2002a1fcc7eda7d8ff7ff78bb9528098bebe4,/Users/sanika/Downloads/Master Thesis/repo_updated/pytest/src/_pytest/mark/__init__.py,596.0,ModificationType.MODIFY,160,89,115,0,13,31,160,7,15,11,17,22,28,78.25484338853101,124.86408532184431,3.966666666666667,495.29420510998256,27.516344728332356,0.04162136177394811,False
1284,0cf2002a1fcc7eda7d8ff7ff78bb9528098bebe4,/Users/sanika/Downloads/Master Thesis/repo_updated/pytest/src/_pytest/_code/__init__.py,596.0,ModificationType.MODIFY,10,10,9,9,0,0,19,0,0,0,0,0,0,0.0,0.0,0.0,0.0,0.0,0.0,False
1285,0cf2002a1fcc7eda7d8ff7ff78bb9528098bebe4,/Users/sanika/Downloads/Master Thesis/repo_updated/pytest/src/_pytest/assertion/__init__.py,596.0,ModificationType.MODIFY,173,84,99,8,29,36,181,5,12,7,13,17,20,54.62919048309069,81.7492568250068,2.708333333333333,221.40423723439343,12.300235401910744,0.027249752275002263,False
1286,0cf2002a1fcc7eda7d8ff7ff78bb9528098bebe4,/Users/sanika/Downloads/Master Thesis/repo_updated/pytest/src/_pytest/_io/__init__.py,596.0,ModificationType.MODIFY,3,1,1,3,0,0,6,0,0,0,0,0,0,0.0,0.0,0.0,0.0,0.0,0.0,False
1287,7ed33996f15d006030d45aeda9dda962bd8da6e9,/Users/sanika/Downloads/Master Thesis/repo_updated/pytest/testing/test_pathlib.py,1561.0,ModificationType.MODIFY,91,45,69,0,3,18,91,3,9,6,10,12,16,33.28421251514428,57.3594000115385,1.6666666666666667,95.59900001923084,5.311055556623936,0.01911980000384617,False
1288,7ed33996f15d006030d45aeda9dda962bd8da6e9,/Users/sanika/Downloads/Master Thesis/repo_updated/pytest/src/_pytest/pathlib.py,1561.0,ModificationType.MODIFY,367,234,237,17,34,68,384,16,55,34,61,71,95,381.9747842438563,584.2259763529447,8.872727272727273,5183.677753822492,287.98209743458284,0.19474199211764828,False
1289,7ed33996f15d006030d45aeda9dda962bd8da6e9,/Users/sanika/Downloads/Master Thesis/repo_updated/pytest/testing/test_tmpdir.py,1859.0,ModificationType.MODIFY,442,244,305,14,16,103,456,11,68,45,75,79,120,452.00122101003336,756.4536897812525,6.066176470588236,4588.781574040686,254.932309668927,0.2521512299270841,False
1290,09709bba06c9c8564ec7b6cd0dc25bf4a450ecc0,/Users/sanika/Downloads/Master Thesis/repo_updated/pytest/setup.py,93.0,ModificationType.MODIFY,42,7,35,4,0,5,46,1,2,1,2,3,3,2.0,4.754887502163468,0.5,2.3774437510817346,0.1320802083934297,0.0015849625007211565,False
1291,09709bba06c9c8564ec7b6cd0dc25bf4a450ecc0,/Users/sanika/Downloads/Master Thesis/repo_updated/pytest/extra/setup-py.test/setup.py,93.0,ModificationType.MODIFY,11,6,10,0,0,1,11,2,4,2,4,6,6,10.0,15.509775004326935,1.0,15.509775004326935,0.861654166907052,0.005169925001442312,False
1292,09709bba06c9c8564ec7b6cd0dc25bf4a450ecc0,/Users/sanika/Downloads/Master Thesis/repo_updated/pytest/testing/test_assertrewrite.py,5617.0,ModificationType.MODIFY,1660,832,1314,41,38,274,1701,20,312,209,395,332,604,2671.484054182769,5058.523816533542,12.660256410256409,64042.208574703494,3557.900476372417,1.6861746055111808,False
1293,09709bba06c9c8564ec7b6cd0dc25bf4a450ecc0,/Users/sanika/Downloads/Master Thesis/repo_updated/pytest/src/_pytest/assertion/rewrite.py,5617.0,ModificationType.MODIFY,1057,646,719,113,100,145,1170,18,215,134,248,233,382,1740.9201126876956,3004.119107257935,10.381395348837211,31186.94812744052,1732.608229302251,1.001373035752645,False
1294,09709bba06c9c8564ec7b6cd0dc25bf4a450ecc0,/Users/sanika/Downloads/Master Thesis/repo_updated/pytest/testing/test_assertrewrite.py,6340.0,ModificationType.MODIFY,1660,832,1314,41,38,274,1701,20,312,209,395,332,604,2671.484054182769,5058.523816533542,12.660256410256409,64042.208574703494,3557.900476372417,1.6861746055111808,False
1295,3b243404e656e646f8f9f873c85c49b86e5803fb,/Users/sanika/Downloads/Master Thesis/repo_updated/pytest/testing/example_scripts/collect/package_infinite_recursion/__init__.pyi,596.0,ModificationType.MODIFY,0,0,0,0,0,0,0,0,0,0,0,0,0,0.0,0.0,0.0,0.0,0.0,0.0,False
1296,3b243404e656e646f8f9f873c85c49b86e5803fb,/Users/sanika/Downloads/Master Thesis/repo_updated/pytest/testing/example_scripts/collect/package_infinite_recursion/tests/__init__.py,596.0,ModificationType.MODIFY,0,0,0,0,0,0,0,0,0,0,0,0,0,0.0,0.0,0.0,0.0,0.0,0.0,False
1297,3b243404e656e646f8f9f873c85c49b86e5803fb,/Users/sanika/Downloads/Master Thesis/repo_updated/pytest/testing/example_scripts/collect/collect_init_tests/tests/__init__.py,596.0,ModificationType.MODIFY,2,2,2,0,0,0,2,0,0,0,0,0,0,0.0,0.0,0.0,0.0,0.0,0.0,False
1298,3b243404e656e646f8f9f873c85c49b86e5803fb,/Users/sanika/Downloads/Master Thesis/repo_updated/pytest/testing/example_scripts/collect/package_init_given_as_arg/pkg/__init__.py,596.0,ModificationType.MODIFY,0,0,0,0,0,0,0,0,0,0,0,0,0,0.0,0.0,0.0,0.0,0.0,0.0,False
1299,3b243404e656e646f8f9f873c85c49b86e5803fb,/Users/sanika/Downloads/Master Thesis/repo_updated/pytest/testing/example_scripts/conftest_usageerror/__init__.pyi,596.0,ModificationType.MODIFY,0,0,0,0,0,0,0,0,0,0,0,0,0,0.0,0.0,0.0,0.0,0.0,0.0,False
1300,3b243404e656e646f8f9f873c85c49b86e5803fb,/Users/sanika/Downloads/Master Thesis/repo_updated/pytest/testing/example_scripts/marks/marks_considered_keywords/__init__.pyi,596.0,ModificationType.MODIFY,0,0,0,0,0,0,0,0,0,0,0,0,0,0.0,0.0,0.0,0.0,0.0,0.0,False
1301,3b243404e656e646f8f9f873c85c49b86e5803fb,/Users/sanika/Downloads/Master Thesis/repo_updated/pytest/testing/example_scripts/config/collect_pytest_prefix/__init__.pyi,596.0,ModificationType.MODIFY,0,0,0,0,0,0,0,0,0,0,0,0,0,0.0,0.0,0.0,0.0,0.0,0.0,False
1302,3b243404e656e646f8f9f873c85c49b86e5803fb,/Users/sanika/Downloads/Master Thesis/repo_updated/pytest/testing/example_scripts/issue88_initial_file_multinodes/__init__.pyi,596.0,ModificationType.MODIFY,0,0,0,0,0,0,0,0,0,0,0,0,0,0.0,0.0,0.0,0.0,0.0,0.0,False
1303,3b243404e656e646f8f9f873c85c49b86e5803fb,/Users/sanika/Downloads/Master Thesis/repo_updated/pytest/testing/example_scripts/fixtures/fill_fixtures/test_extend_fixture_conftest_conftest/__init__.pyi,596.0,ModificationType.MODIFY,0,0,0,0,0,0,0,0,0,0,0,0,0,0.0,0.0,0.0,0.0,0.0,0.0,False
1304,3b243404e656e646f8f9f873c85c49b86e5803fb,/Users/sanika/Downloads/Master Thesis/repo_updated/pytest/testing/example_scripts/fixtures/fill_fixtures/test_extend_fixture_conftest_conftest/pkg/__init__.py,596.0,ModificationType.MODIFY,0,0,0,0,0,0,0,0,0,0,0,0,0,0.0,0.0,0.0,0.0,0.0,0.0,False
1305,3b243404e656e646f8f9f873c85c49b86e5803fb,/Users/sanika/Downloads/Master Thesis/repo_updated/pytest/testing/example_scripts/fixtures/fill_fixtures/test_extend_fixture_conftest_module/__init__.pyi,596.0,ModificationType.MODIFY,0,0,0,0,0,0,0,0,0,0,0,0,0,0.0,0.0,0.0,0.0,0.0,0.0,False
1306,3b243404e656e646f8f9f873c85c49b86e5803fb,/Users/sanika/Downloads/Master Thesis/repo_updated/pytest/testing/example_scripts/fixtures/fill_fixtures/test_conftest_funcargs_only_available_in_subdir/sub1/__init__.py,596.0,ModificationType.MODIFY,0,0,0,0,0,0,0,0,0,0,0,0,0,0.0,0.0,0.0,0.0,0.0,0.0,False
1307,3b243404e656e646f8f9f873c85c49b86e5803fb,/Users/sanika/Downloads/Master Thesis/repo_updated/pytest/testing/example_scripts/fixtures/fill_fixtures/test_conftest_funcargs_only_available_in_subdir/sub2/__init__.py,596.0,ModificationType.MODIFY,0,0,0,0,0,0,0,0,0,0,0,0,0,0.0,0.0,0.0,0.0,0.0,0.0,False
1308,3b243404e656e646f8f9f873c85c49b86e5803fb,/Users/sanika/Downloads/Master Thesis/repo_updated/pytest/testing/example_scripts/fixtures/custom_item/__init__.pyi,596.0,ModificationType.MODIFY,0,0,0,0,0,0,0,0,0,0,0,0,0,0.0,0.0,0.0,0.0,0.0,0.0,False
1309,3b243404e656e646f8f9f873c85c49b86e5803fb,/Users/sanika/Downloads/Master Thesis/repo_updated/pytest/testing/example_scripts/fixtures/custom_item/foo/__init__.py,596.0,ModificationType.MODIFY,0,0,0,0,0,0,0,0,0,0,0,0,0,0.0,0.0,0.0,0.0,0.0,0.0,False
1310,3b243404e656e646f8f9f873c85c49b86e5803fb,/Users/sanika/Downloads/Master Thesis/repo_updated/pytest/doc/en/example/nonpython/__init__.py,596.0,ModificationType.MODIFY,0,0,0,0,0,0,0,0,0,0,0,0,0,0.0,0.0,0.0,0.0,0.0,0.0,False
1311,3b243404e656e646f8f9f873c85c49b86e5803fb,/Users/sanika/Downloads/Master Thesis/repo_updated/pytest/src/pytest/__init__.py,596.0,ModificationType.MODIFY,99,48,90,1,3,5,100,0,0,0,0,0,0,0.0,0.0,0.0,0.0,0.0,0.0,False
1312,3b243404e656e646f8f9f873c85c49b86e5803fb,/Users/sanika/Downloads/Master Thesis/repo_updated/pytest/src/_pytest/__init__.py,596.0,ModificationType.MODIFY,8,5,5,2,0,1,10,0,0,0,0,0,0,0.0,0.0,0.0,0.0,0.0,0.0,False
1313,3b243404e656e646f8f9f873c85c49b86e5803fb,/Users/sanika/Downloads/Master Thesis/repo_updated/pytest/src/_pytest/config/__init__.py,596.0,ModificationType.MODIFY,1217,716,841,84,126,174,1301,14,185,118,215,199,333,1446.608539104324,2542.995998641035,8.135135135135135,20687.616097052745,1149.3120053918194,0.847665332880345,False
1314,3b243404e656e646f8f9f873c85c49b86e5803fb,/Users/sanika/Downloads/Master Thesis/repo_updated/pytest/src/_pytest/mark/__init__.py,596.0,ModificationType.MODIFY,160,89,115,0,13,31,160,7,15,11,17,22,28,78.25484338853101,124.86408532184431,3.966666666666667,495.29420510998256,27.516344728332356,0.04162136177394811,False
1315,3b243404e656e646f8f9f873c85c49b86e5803fb,/Users/sanika/Downloads/Master Thesis/repo_updated/pytest/src/_pytest/_code/__init__.py,596.0,ModificationType.MODIFY,10,10,9,9,0,0,19,0,0,0,0,0,0,0.0,0.0,0.0,0.0,0.0,0.0,False
1316,3b243404e656e646f8f9f873c85c49b86e5803fb,/Users/sanika/Downloads/Master Thesis/repo_updated/pytest/src/_pytest/assertion/__init__.py,596.0,ModificationType.MODIFY,173,84,99,8,29,36,181,5,12,7,13,17,20,54.62919048309069,81.7492568250068,2.708333333333333,221.40423723439343,12.300235401910744,0.027249752275002263,False
1317,3b243404e656e646f8f9f873c85c49b86e5803fb,/Users/sanika/Downloads/Master Thesis/repo_updated/pytest/src/_pytest/_io/__init__.py,596.0,ModificationType.MODIFY,3,1,1,3,0,0,6,0,0,0,0,0,0,0.0,0.0,0.0,0.0,0.0,0.0,False
1318,6ad95716dacd8448df7d4d4d3a5f759d32c17418,/Users/sanika/Downloads/Master Thesis/repo_updated/pytest/testing/test_main.py,3505.0,ModificationType.MODIFY,77,34,69,0,0,8,77,3,24,16,29,27,45,114.79398751947123,213.9699375973561,1.8125,387.82051189520797,21.54558399417822,0.07132331253245204,False
1319,6ad95716dacd8448df7d4d4d3a5f759d32c17418,/Users/sanika/Downloads/Master Thesis/repo_updated/pytest/src/_pytest/main.py,3505.0,ModificationType.MODIFY,712,438,573,51,9,84,763,14,102,71,128,116,199,733.8903537898989,1364.7382180303869,8.784313725490197,11988.288660345359,666.0160366858534,0.4549127393434623,False
1320,6ad95716dacd8448df7d4d4d3a5f759d32c17418,/Users/sanika/Downloads/Master Thesis/repo_updated/pytest/testing/test_collection.py,4935.0,ModificationType.MODIFY,1296,573,1062,40,33,157,1336,8,201,118,231,209,349,1561.8613899269644,2689.868337096228,4.597014925373134,12365.364892919973,686.9647162733319,0.896622779032076,False
1321,cc503c1821e709376d9a05ee4f6459e4e4f41a0c,/Users/sanika/Downloads/Master Thesis/repo_updated/pytest/src/_pytest/assertion/util.py,2606.0,ModificationType.MODIFY,477,336,357,30,23,73,507,16,194,134,250,210,384,1538.3830913843026,2962.2702787837907,10.309278350515463,30538.868853441152,1696.603825191175,0.9874234262612636,False
1322,cc503c1821e709376d9a05ee4f6459e4e4f41a0c,/Users/sanika/Downloads/Master Thesis/repo_updated/pytest/testing/test_assertion.py,5419.0,ModificationType.MODIFY,1450,624,1228,12,26,181,1462,14,306,186,354,320,540,2580.063648772758,4493.841171239174,8.098039215686274,36391.30203376038,2021.7390018755768,1.4979470570797249,False
1323,c22ce1a12cc1ad75d50696321a96bd2f1d9a7e86,/Users/sanika/Downloads/Master Thesis/repo_updated/pytest/doc/en/example/multipython.py,6691.0,ModificationType.MODIFY,72,33,56,0,4,12,72,1,1,1,1,2,2,0.0,2.0,0.5,1.0,0.05555555555555555,0.0006666666666666666,False
1324,c22ce1a12cc1ad75d50696321a96bd2f1d9a7e86,/Users/sanika/Downloads/Master Thesis/repo_updated/pytest/src/_pytest/python.py,6691.0,ModificationType.MODIFY,1454,835,1044,76,110,219,1530,17,275,158,296,292,454,2297.8910156145625,3718.1803497315277,9.149090909090908,34017.97003608918,1889.8872242271768,1.2393934499105097,False
1325,db82432ec850aed3ee654db131c1cd4879e0cb06,/Users/sanika/Downloads/Master Thesis/repo_updated/pytest/testing/test_mark.py,3147.0,ModificationType.MODIFY,1020,354,843,12,15,144,1032,8,134,77,144,142,221,970.8559515213416,1580.0941134105346,4.298507462686567,6792.0463382422995,377.3359076801278,0.5266980378035117,False
1326,984d90a811afc344518e64f8e8c8f300c69b8aaf,/Users/sanika/Downloads/Master Thesis/repo_updated/pytest/src/_pytest/mark/structures.py,1510.0,ModificationType.MODIFY,402,202,227,24,74,80,426,12,52,33,61,64,94,339.4424153519907,564.0,7.038461538461537,3969.6923076923076,220.53846153846158,0.188,False
1327,84b2c81db4b998e41bc0d2583e4acbc47544e103,/Users/sanika/Downloads/Master Thesis/repo_updated/pytest/src/_pytest/mark/structures.py,1479.0,ModificationType.MODIFY,402,202,227,24,74,80,426,12,52,33,61,64,94,339.4424153519907,564.0,7.038461538461537,3969.6923076923076,220.53846153846158,0.188,False
1328,84b2c81db4b998e41bc0d2583e4acbc47544e103,/Users/sanika/Downloads/Master Thesis/repo_updated/pytest/testing/test_mark.py,3140.0,ModificationType.MODIFY,1020,354,843,12,15,144,1032,8,134,77,144,142,221,970.8559515213416,1580.0941134105346,4.298507462686567,6792.0463382422995,377.3359076801278,0.5266980378035117,False
1329,04891048e18b046037627caf4b5a2665a40b5f02,/Users/sanika/Downloads/Master Thesis/repo_updated/pytest/src/_pytest/mark/structures.py,1479.0,ModificationType.MODIFY,402,202,227,24,74,80,426,12,52,33,61,64,94,339.4424153519907,564.0,7.038461538461537,3969.6923076923076,220.53846153846158,0.188,False
1330,04891048e18b046037627caf4b5a2665a40b5f02,/Users/sanika/Downloads/Master Thesis/repo_updated/pytest/testing/test_mark.py,3140.0,ModificationType.MODIFY,1020,354,843,12,15,144,1032,8,134,77,144,142,221,970.8559515213416,1580.0941134105346,4.298507462686567,6792.0463382422995,377.3359076801278,0.5266980378035117,False
1331,245e1f10e587931ce03ac414bc7230be76520f40,/Users/sanika/Downloads/Master Thesis/repo_updated/pytest/doc/en/example/multipython.py,6691.0,ModificationType.MODIFY,72,33,56,0,4,12,72,1,1,1,1,2,2,0.0,2.0,0.5,1.0,0.05555555555555555,0.0006666666666666666,False
1332,245e1f10e587931ce03ac414bc7230be76520f40,/Users/sanika/Downloads/Master Thesis/repo_updated/pytest/src/_pytest/python.py,6691.0,ModificationType.MODIFY,1454,835,1044,76,110,219,1530,17,275,158,296,292,454,2297.8910156145625,3718.1803497315277,9.149090909090908,34017.97003608918,1889.8872242271768,1.2393934499105097,False
1333,245e1f10e587931ce03ac414bc7230be76520f40,/Users/sanika/Downloads/Master Thesis/repo_updated/pytest/testing/test_mark.py,3197.0,ModificationType.MODIFY,1020,354,843,12,15,144,1032,8,134,77,144,142,221,970.8559515213416,1580.0941134105346,4.298507462686567,6792.0463382422995,377.3359076801278,0.5266980378035117,False
1334,28edbaace4b5ebad5875d65eb518c29f495212e5,/Users/sanika/Downloads/Master Thesis/repo_updated/pytest/testing/test_helpconfig.py,1070.0,ModificationType.MODIFY,74,35,59,1,0,14,75,3,14,7,14,17,21,58.057856410969926,85.83671966625714,1.5,128.75507949938572,7.153059972188095,0.028612239888752382,False
1335,28edbaace4b5ebad5875d65eb518c29f495212e5,/Users/sanika/Downloads/Master Thesis/repo_updated/pytest/src/_pytest/helpconfig.py,1070.0,ModificationType.MODIFY,245,125,200,5,7,34,250,7,30,17,34,37,51,166.8582023226588,265.6821216470764,3.966666666666667,1053.8724158667364,58.548467548152026,0.08856070721569215,False
1336,96c315e4393c67ae97911398b3f7df1b48ea02b6,/Users/sanika/Downloads/Master Thesis/repo_updated/pytest/testing/test_helpconfig.py,1070.0,ModificationType.MODIFY,74,35,59,1,0,14,75,3,14,7,14,17,21,58.057856410969926,85.83671966625714,1.5,128.75507949938572,7.153059972188095,0.028612239888752382,False
1337,96c315e4393c67ae97911398b3f7df1b48ea02b6,/Users/sanika/Downloads/Master Thesis/repo_updated/pytest/src/_pytest/helpconfig.py,1070.0,ModificationType.MODIFY,245,125,200,5,7,34,250,7,30,17,34,37,51,166.8582023226588,265.6821216470764,3.966666666666667,1053.8724158667364,58.548467548152026,0.08856070721569215,False
1338,0bbc032db0969efa42d35aa74a5a523bd977538d,/Users/sanika/Downloads/Master Thesis/repo_updated/pytest/testing/test_reports.py,1993.0,ModificationType.MODIFY,466,257,367,18,25,50,484,7,126,86,171,133,257,898.7887548153927,1813.2075859238055,4.75,8612.736033138077,478.4853351743376,0.6044025286412685,False
1339,0bbc032db0969efa42d35aa74a5a523bd977538d,/Users/sanika/Downloads/Master Thesis/repo_updated/pytest/src/_pytest/reports.py,1993.0,ModificationType.MODIFY,507,281,342,29,59,88,536,10,53,29,57,63,86,336.7990650407233,514.0460734209928,5.377358490566038,2764.2100174525085,153.56722319180602,0.17134869114033094,False
1340,0bbc032db0969efa42d35aa74a5a523bd977538d,/Users/sanika/Downloads/Master Thesis/repo_updated/pytest/testing/test_terminal.py,6372.0,ModificationType.MODIFY,1943,715,1694,26,18,214,1969,12,185,120,237,197,357,1436.3251202041715,2721.0724995459263,7.686486486486486,20915.486996509768,1161.971499806098,0.9070241665153088,False
1341,0bbc032db0969efa42d35aa74a5a523bd977538d,/Users/sanika/Downloads/Master Thesis/repo_updated/pytest/src/_pytest/terminal.py,6372.0,ModificationType.MODIFY,1168,838,957,57,25,144,1225,19,348,224,416,367,640,3018.854959310786,5452.567201819657,11.35632183908046,61921.107993078396,3440.0615551710216,1.817522400606552,False
1342,710e3c40e0e613a06eef62f58b3f7db9761ee868,/Users/sanika/Downloads/Master Thesis/repo_updated/pytest/testing/test_reports.py,1993.0,ModificationType.MODIFY,466,257,367,18,25,50,484,7,126,86,171,133,257,898.7887548153927,1813.2075859238055,4.75,8612.736033138077,478.4853351743376,0.6044025286412685,False
1343,710e3c40e0e613a06eef62f58b3f7db9761ee868,/Users/sanika/Downloads/Master Thesis/repo_updated/pytest/src/_pytest/reports.py,1993.0,ModificationType.MODIFY,507,281,342,29,59,88,536,10,53,29,57,63,86,336.7990650407233,514.0460734209928,5.377358490566038,2764.2100174525085,153.56722319180602,0.17134869114033094,False
1344,710e3c40e0e613a06eef62f58b3f7db9761ee868,/Users/sanika/Downloads/Master Thesis/repo_updated/pytest/testing/test_terminal.py,6372.0,ModificationType.MODIFY,1943,715,1694,26,18,214,1969,12,185,120,237,197,357,1436.3251202041715,2721.0724995459263,7.686486486486486,20915.486996509768,1161.971499806098,0.9070241665153088,False
1345,710e3c40e0e613a06eef62f58b3f7db9761ee868,/Users/sanika/Downloads/Master Thesis/repo_updated/pytest/src/_pytest/terminal.py,6372.0,ModificationType.MODIFY,1168,838,957,57,25,144,1225,19,348,224,416,367,640,3018.854959310786,5452.567201819657,11.35632183908046,61921.107993078396,3440.0615551710216,1.817522400606552,False
1346,42a46ea78617b8e210636bc2f9d9bf06435b60fa,/Users/sanika/Downloads/Master Thesis/repo_updated/pytest/testing/test_compat.py,1418.0,ModificationType.MODIFY,207,111,150,11,0,50,218,5,26,19,36,31,55,133.82107314610522,272.4807970712782,3.4615384615384617,943.202759092886,52.400153282938106,0.09082693235709273,True
1347,42a46ea78617b8e210636bc2f9d9bf06435b60fa,/Users/sanika/Downloads/Master Thesis/repo_updated/pytest/src/_pytest/compat.py,1418.0,ModificationType.MODIFY,410,198,237,31,55,97,441,11,63,38,72,74,110,414.62238298550506,683.0398702191846,6.2857142857142865,4293.39346994916,238.52185944162002,0.2276799567397282,True
1348,42a46ea78617b8e210636bc2f9d9bf06435b60fa,/Users/sanika/Downloads/Master Thesis/repo_updated/pytest/testing/test_nodes.py,1815.0,ModificationType.MODIFY,53,23,39,0,0,13,53,2,8,4,8,10,12,26.0,39.863137138648355,1.0,39.863137138648355,2.2146187299249087,0.013287712379549451,True
1349,42a46ea78617b8e210636bc2f9d9bf06435b60fa,/Users/sanika/Downloads/Master Thesis/repo_updated/pytest/src/_pytest/nodes.py,1815.0,ModificationType.MODIFY,515,298,307,33,80,99,548,12,63,44,77,75,121,419.5881851891487,753.6870615500015,7.333333333333332,5527.038451366679,307.0576917425932,0.2512290205166672,True
1350,42a46ea78617b8e210636bc2f9d9bf06435b60fa,/Users/sanika/Downloads/Master Thesis/repo_updated/pytest/testing/test_compat.py,591.0,ModificationType.MODIFY,207,111,150,11,0,50,218,5,26,19,36,31,55,133.82107314610522,272.4807970712782,3.4615384615384617,943.202759092886,52.400153282938106,0.09082693235709273,True
1351,abcedd6095054aa66aa4a5271959da0866c52266,/Users/sanika/Downloads/Master Thesis/repo_updated/pytest/src/_pytest/assertion/util.py,2606.0,ModificationType.MODIFY,477,336,357,30,23,73,507,16,194,134,250,210,384,1538.3830913843026,2962.2702787837907,10.309278350515463,30538.868853441152,1696.603825191175,0.9874234262612636,False
1352,abcedd6095054aa66aa4a5271959da0866c52266,/Users/sanika/Downloads/Master Thesis/repo_updated/pytest/testing/test_assertion.py,5419.0,ModificationType.MODIFY,1450,624,1228,12,26,181,1462,14,306,186,354,320,540,2580.063648772758,4493.841171239174,8.098039215686274,36391.30203376038,2021.7390018755768,1.4979470570797249,False
1353,3ef8aa8173eb10c5a57fd38b4df7d3ba959e8b5f,/Users/sanika/Downloads/Master Thesis/repo_updated/pytest/testing/test_nodes.py,1884.0,ModificationType.MODIFY,53,23,39,0,0,13,53,2,8,4,8,10,12,26.0,39.863137138648355,1.0,39.863137138648355,2.2146187299249087,0.013287712379549451,False
1354,3ef8aa8173eb10c5a57fd38b4df7d3ba959e8b5f,/Users/sanika/Downloads/Master Thesis/repo_updated/pytest/src/_pytest/nodes.py,1884.0,ModificationType.MODIFY,515,298,307,33,80,99,548,12,63,44,77,75,121,419.5881851891487,753.6870615500015,7.333333333333332,5527.038451366679,307.0576917425932,0.2512290205166672,False
1355,b352e34938726e13fd8b0e5d5912535e29e6592c,/Users/sanika/Downloads/Master Thesis/repo_updated/pytest/testing/test_compat.py,1418.0,ModificationType.MODIFY,207,111,150,11,0,50,218,5,26,19,36,31,55,133.82107314610522,272.4807970712782,3.4615384615384617,943.202759092886,52.400153282938106,0.09082693235709273,False
1356,b352e34938726e13fd8b0e5d5912535e29e6592c,/Users/sanika/Downloads/Master Thesis/repo_updated/pytest/src/_pytest/compat.py,1418.0,ModificationType.MODIFY,410,198,237,31,55,97,441,11,63,38,72,74,110,414.62238298550506,683.0398702191846,6.2857142857142865,4293.39346994916,238.52185944162002,0.2276799567397282,False
1357,b352e34938726e13fd8b0e5d5912535e29e6592c,/Users/sanika/Downloads/Master Thesis/repo_updated/pytest/testing/test_nodes.py,1815.0,ModificationType.MODIFY,53,23,39,0,0,13,53,2,8,4,8,10,12,26.0,39.863137138648355,1.0,39.863137138648355,2.2146187299249087,0.013287712379549451,False
1358,b352e34938726e13fd8b0e5d5912535e29e6592c,/Users/sanika/Downloads/Master Thesis/repo_updated/pytest/src/_pytest/nodes.py,1815.0,ModificationType.MODIFY,515,298,307,33,80,99,548,12,63,44,77,75,121,419.5881851891487,753.6870615500015,7.333333333333332,5527.038451366679,307.0576917425932,0.2512290205166672,False
1359,b352e34938726e13fd8b0e5d5912535e29e6592c,/Users/sanika/Downloads/Master Thesis/repo_updated/pytest/testing/test_compat.py,591.0,ModificationType.MODIFY,207,111,150,11,0,50,218,5,26,19,36,31,55,133.82107314610522,272.4807970712782,3.4615384615384617,943.202759092886,52.400153282938106,0.09082693235709273,False
1360,fc1c015c6b79ead0d76793cf0b7ae155b365f3a6,/Users/sanika/Downloads/Master Thesis/repo_updated/pytest/testing/python/metafunc.py,5858.0,ModificationType.MODIFY,1782,648,1425,9,47,279,1791,8,171,97,189,179,286,1292.4527800454887,2140.3713122975773,4.421052631578949,9462.69422278929,525.705234599405,0.7134571040991925,False
1361,dad4985be1fde2fc2bdc83ae65034c43f3ce42aa,/Users/sanika/Downloads/Master Thesis/repo_updated/pytest/testing/test_nodes.py,1873.0,ModificationType.MODIFY,53,23,39,0,0,13,53,2,8,4,8,10,12,26.0,39.863137138648355,1.0,39.863137138648355,2.2146187299249087,0.013287712379549451,False
1362,dad4985be1fde2fc2bdc83ae65034c43f3ce42aa,/Users/sanika/Downloads/Master Thesis/repo_updated/pytest/src/_pytest/nodes.py,1873.0,ModificationType.MODIFY,515,298,307,33,80,99,548,12,63,44,77,75,121,419.5881851891487,753.6870615500015,7.333333333333332,5527.038451366679,307.0576917425932,0.2512290205166672,False
1363,86e9ae39f0ff0f16179d3e1d25674445432cfaef,/Users/sanika/Downloads/Master Thesis/repo_updated/pytest/testing/test_pytester.py,6314.0,ModificationType.MODIFY,722,423,573,19,0,135,741,12,172,101,199,184,300,1320.3370878174146,2257.068586817104,6.941860465116278,15668.255189881524,870.4586216600846,0.7523561956057013,False
1364,86e9ae39f0ff0f16179d3e1d25674445432cfaef,/Users/sanika/Downloads/Master Thesis/repo_updated/pytest/src/_pytest/pytester.py,6314.0,ModificationType.MODIFY,1508,847,911,44,250,301,1552,14,148,88,169,162,257,1120.302067021891,1886.3414507413486,7.993243243243242,15077.986055587939,837.6658919771077,0.6287804835804495,False
1365,e2022a6d488bc809f30118a58df50525dd345c7e,/Users/sanika/Downloads/Master Thesis/repo_updated/pytest/testing/test_pytester.py,6314.0,ModificationType.MODIFY,722,423,573,19,0,135,741,12,172,101,199,184,300,1320.3370878174146,2257.068586817104,6.941860465116278,15668.255189881524,870.4586216600846,0.7523561956057013,False
1366,e2022a6d488bc809f30118a58df50525dd345c7e,/Users/sanika/Downloads/Master Thesis/repo_updated/pytest/src/_pytest/pytester.py,6314.0,ModificationType.MODIFY,1508,847,911,44,250,301,1552,14,148,88,169,162,257,1120.302067021891,1886.3414507413486,7.993243243243242,15077.986055587939,837.6658919771077,0.6287804835804495,False
1367,6ddf7c3d42efcf01c8641893e7331f9e33e6877d,/Users/sanika/Downloads/Master Thesis/repo_updated/pytest/testing/test_pytester.py,6345.0,ModificationType.MODIFY,722,423,573,19,0,135,741,12,172,101,199,184,300,1320.3370878174146,2257.068586817104,6.941860465116278,15668.255189881524,870.4586216600846,0.7523561956057013,False
1368,6ddf7c3d42efcf01c8641893e7331f9e33e6877d,/Users/sanika/Downloads/Master Thesis/repo_updated/pytest/src/_pytest/pytester.py,6345.0,ModificationType.MODIFY,1508,847,911,44,250,301,1552,14,148,88,169,162,257,1120.302067021891,1886.3414507413486,7.993243243243242,15077.986055587939,837.6658919771077,0.6287804835804495,False
1369,6ddf7c3d42efcf01c8641893e7331f9e33e6877d,/Users/sanika/Downloads/Master Thesis/repo_updated/pytest/testing/test_assertion.py,5424.0,ModificationType.MODIFY,1450,624,1228,12,26,181,1462,14,306,186,354,320,540,2580.063648772758,4493.841171239174,8.098039215686274,36391.30203376038,2021.7390018755768,1.4979470570797249,False
1370,b06f33f4748ee1bf928c01b4e12d5506a4e05870,/Users/sanika/Downloads/Master Thesis/repo_updated/pytest/testing/test_terminal.py,6416.0,ModificationType.MODIFY,1943,715,1694,26,18,214,1969,12,185,120,237,197,357,1436.3251202041715,2721.0724995459263,7.686486486486486,20915.486996509768,1161.971499806098,0.9070241665153088,False
1371,b06f33f4748ee1bf928c01b4e12d5506a4e05870,/Users/sanika/Downloads/Master Thesis/repo_updated/pytest/src/_pytest/terminal.py,6416.0,ModificationType.MODIFY,1168,838,957,57,25,144,1225,19,348,224,416,367,640,3018.854959310786,5452.567201819657,11.35632183908046,61921.107993078396,3440.0615551710216,1.817522400606552,False
1372,b06f33f4748ee1bf928c01b4e12d5506a4e05870,/Users/sanika/Downloads/Master Thesis/repo_updated/pytest/testing/test_collection.py,4946.0,ModificationType.MODIFY,1296,573,1062,40,33,157,1336,8,201,118,231,209,349,1561.8613899269644,2689.868337096228,4.597014925373134,12365.364892919973,686.9647162733319,0.896622779032076,False
1373,b06f33f4748ee1bf928c01b4e12d5506a4e05870,/Users/sanika/Downloads/Master Thesis/repo_updated/pytest/testing/test_terminal.py,6852.0,ModificationType.MODIFY,1943,715,1694,26,18,214,1969,12,185,120,237,197,357,1436.3251202041715,2721.0724995459263,7.686486486486486,20915.486996509768,1161.971499806098,0.9070241665153088,False
1374,c232366f2ff17d72b3baee53c0260da2459a9702,/Users/sanika/Downloads/Master Thesis/repo_updated/pytest/testing/python/metafunc.py,5858.0,ModificationType.MODIFY,1782,648,1425,9,47,279,1791,8,171,97,189,179,286,1292.4527800454887,2140.3713122975773,4.421052631578949,9462.69422278929,525.705234599405,0.7134571040991925,False
1375,a6e10cc2e3f3c9e400d9a03417d1186eee052730,/Users/sanika/Downloads/Master Thesis/repo_updated/pytest/testing/test_terminal.py,6416.0,ModificationType.MODIFY,1943,715,1694,26,18,214,1969,12,185,120,237,197,357,1436.3251202041715,2721.0724995459263,7.686486486486486,20915.486996509768,1161.971499806098,0.9070241665153088,False
1376,a6e10cc2e3f3c9e400d9a03417d1186eee052730,/Users/sanika/Downloads/Master Thesis/repo_updated/pytest/src/_pytest/terminal.py,6416.0,ModificationType.MODIFY,1168,838,957,57,25,144,1225,19,348,224,416,367,640,3018.854959310786,5452.567201819657,11.35632183908046,61921.107993078396,3440.0615551710216,1.817522400606552,False
1377,a6e10cc2e3f3c9e400d9a03417d1186eee052730,/Users/sanika/Downloads/Master Thesis/repo_updated/pytest/testing/test_collection.py,4946.0,ModificationType.MODIFY,1296,573,1062,40,33,157,1336,8,201,118,231,209,349,1561.8613899269644,2689.868337096228,4.597014925373134,12365.364892919973,686.9647162733319,0.896622779032076,False
1378,a6e10cc2e3f3c9e400d9a03417d1186eee052730,/Users/sanika/Downloads/Master Thesis/repo_updated/pytest/testing/test_terminal.py,6852.0,ModificationType.MODIFY,1943,715,1694,26,18,214,1969,12,185,120,237,197,357,1436.3251202041715,2721.0724995459263,7.686486486486486,20915.486996509768,1161.971499806098,0.9070241665153088,False
1379,f91bf48a40da5ee7f7c2a3c71ee56d854d35e983,/Users/sanika/Downloads/Master Thesis/repo_updated/pytest/testing/test_pytester.py,6345.0,ModificationType.MODIFY,722,423,573,19,0,135,741,12,172,101,199,184,300,1320.3370878174146,2257.068586817104,6.941860465116278,15668.255189881524,870.4586216600846,0.7523561956057013,False
1380,f91bf48a40da5ee7f7c2a3c71ee56d854d35e983,/Users/sanika/Downloads/Master Thesis/repo_updated/pytest/src/_pytest/pytester.py,6345.0,ModificationType.MODIFY,1508,847,911,44,250,301,1552,14,148,88,169,162,257,1120.302067021891,1886.3414507413486,7.993243243243242,15077.986055587939,837.6658919771077,0.6287804835804495,False
1381,f91bf48a40da5ee7f7c2a3c71ee56d854d35e983,/Users/sanika/Downloads/Master Thesis/repo_updated/pytest/testing/test_assertion.py,5424.0,ModificationType.MODIFY,1450,624,1228,12,26,181,1462,14,306,186,354,320,540,2580.063648772758,4493.841171239174,8.098039215686274,36391.30203376038,2021.7390018755768,1.4979470570797249,False
1382,b3bb60468331d49ff3eaa3241adb9fa070c90d19,/Users/sanika/Downloads/Master Thesis/repo_updated/pytest/testing/test_warnings.py,625.0,ModificationType.MODIFY,601,196,481,2,23,85,603,8,63,36,72,71,108,400.5686351804948,664.1726889065056,4.571428571428571,3036.21800642974,168.67877813498555,0.22139089630216852,False
1383,b3bb60468331d49ff3eaa3241adb9fa070c90d19,/Users/sanika/Downloads/Master Thesis/repo_updated/pytest/src/_pytest/warnings.py,625.0,ModificationType.MODIFY,156,79,106,5,16,28,161,5,14,8,15,19,23,64.91260938324325,97.70233280920246,2.6785714285714284,261.7026771675066,14.539037620417032,0.03256744426973415,False
1384,55bc084dcc783bda88a221a5437a515df3e7b2ae,/Users/sanika/Downloads/Master Thesis/repo_updated/pytest/testing/example_scripts/collect/package_infinite_recursion/__init__.pyi,5077.0,ModificationType.MODIFY,0,0,0,0,0,0,0,0,0,0,0,0,0,0.0,0.0,0.0,0.0,0.0,0.0,False
1385,55bc084dcc783bda88a221a5437a515df3e7b2ae,/Users/sanika/Downloads/Master Thesis/repo_updated/pytest/testing/example_scripts/collect/package_infinite_recursion/tests/__init__.py,5077.0,ModificationType.MODIFY,0,0,0,0,0,0,0,0,0,0,0,0,0,0.0,0.0,0.0,0.0,0.0,0.0,False
1386,55bc084dcc783bda88a221a5437a515df3e7b2ae,/Users/sanika/Downloads/Master Thesis/repo_updated/pytest/testing/example_scripts/collect/collect_init_tests/tests/__init__.py,5077.0,ModificationType.MODIFY,2,2,2,0,0,0,2,0,0,0,0,0,0,0.0,0.0,0.0,0.0,0.0,0.0,False
1387,55bc084dcc783bda88a221a5437a515df3e7b2ae,/Users/sanika/Downloads/Master Thesis/repo_updated/pytest/testing/example_scripts/collect/package_init_given_as_arg/pkg/__init__.py,5077.0,ModificationType.MODIFY,0,0,0,0,0,0,0,0,0,0,0,0,0,0.0,0.0,0.0,0.0,0.0,0.0,False
1388,55bc084dcc783bda88a221a5437a515df3e7b2ae,/Users/sanika/Downloads/Master Thesis/repo_updated/pytest/testing/example_scripts/conftest_usageerror/__init__.pyi,5077.0,ModificationType.MODIFY,0,0,0,0,0,0,0,0,0,0,0,0,0,0.0,0.0,0.0,0.0,0.0,0.0,False
1389,55bc084dcc783bda88a221a5437a515df3e7b2ae,/Users/sanika/Downloads/Master Thesis/repo_updated/pytest/testing/example_scripts/marks/marks_considered_keywords/__init__.pyi,5077.0,ModificationType.MODIFY,0,0,0,0,0,0,0,0,0,0,0,0,0,0.0,0.0,0.0,0.0,0.0,0.0,False
1390,55bc084dcc783bda88a221a5437a515df3e7b2ae,/Users/sanika/Downloads/Master Thesis/repo_updated/pytest/testing/example_scripts/config/collect_pytest_prefix/__init__.pyi,5077.0,ModificationType.MODIFY,0,0,0,0,0,0,0,0,0,0,0,0,0,0.0,0.0,0.0,0.0,0.0,0.0,False
1391,55bc084dcc783bda88a221a5437a515df3e7b2ae,/Users/sanika/Downloads/Master Thesis/repo_updated/pytest/testing/example_scripts/issue88_initial_file_multinodes/__init__.pyi,5077.0,ModificationType.MODIFY,0,0,0,0,0,0,0,0,0,0,0,0,0,0.0,0.0,0.0,0.0,0.0,0.0,False
1392,55bc084dcc783bda88a221a5437a515df3e7b2ae,/Users/sanika/Downloads/Master Thesis/repo_updated/pytest/testing/example_scripts/fixtures/fill_fixtures/test_extend_fixture_conftest_conftest/__init__.pyi,5077.0,ModificationType.MODIFY,0,0,0,0,0,0,0,0,0,0,0,0,0,0.0,0.0,0.0,0.0,0.0,0.0,False
1393,55bc084dcc783bda88a221a5437a515df3e7b2ae,/Users/sanika/Downloads/Master Thesis/repo_updated/pytest/testing/example_scripts/fixtures/fill_fixtures/test_extend_fixture_conftest_conftest/pkg/__init__.py,5077.0,ModificationType.MODIFY,0,0,0,0,0,0,0,0,0,0,0,0,0,0.0,0.0,0.0,0.0,0.0,0.0,False
1394,55bc084dcc783bda88a221a5437a515df3e7b2ae,/Users/sanika/Downloads/Master Thesis/repo_updated/pytest/testing/example_scripts/fixtures/fill_fixtures/test_extend_fixture_conftest_module/__init__.pyi,5077.0,ModificationType.MODIFY,0,0,0,0,0,0,0,0,0,0,0,0,0,0.0,0.0,0.0,0.0,0.0,0.0,False
1395,55bc084dcc783bda88a221a5437a515df3e7b2ae,/Users/sanika/Downloads/Master Thesis/repo_updated/pytest/testing/example_scripts/fixtures/fill_fixtures/test_conftest_funcargs_only_available_in_subdir/sub1/__init__.py,5077.0,ModificationType.MODIFY,0,0,0,0,0,0,0,0,0,0,0,0,0,0.0,0.0,0.0,0.0,0.0,0.0,False
1396,55bc084dcc783bda88a221a5437a515df3e7b2ae,/Users/sanika/Downloads/Master Thesis/repo_updated/pytest/testing/example_scripts/fixtures/fill_fixtures/test_conftest_funcargs_only_available_in_subdir/sub2/__init__.py,5077.0,ModificationType.MODIFY,0,0,0,0,0,0,0,0,0,0,0,0,0,0.0,0.0,0.0,0.0,0.0,0.0,False
1397,55bc084dcc783bda88a221a5437a515df3e7b2ae,/Users/sanika/Downloads/Master Thesis/repo_updated/pytest/testing/example_scripts/fixtures/custom_item/__init__.pyi,5077.0,ModificationType.MODIFY,0,0,0,0,0,0,0,0,0,0,0,0,0,0.0,0.0,0.0,0.0,0.0,0.0,False
1398,55bc084dcc783bda88a221a5437a515df3e7b2ae,/Users/sanika/Downloads/Master Thesis/repo_updated/pytest/testing/example_scripts/fixtures/custom_item/foo/__init__.py,5077.0,ModificationType.MODIFY,0,0,0,0,0,0,0,0,0,0,0,0,0,0.0,0.0,0.0,0.0,0.0,0.0,False
1399,55bc084dcc783bda88a221a5437a515df3e7b2ae,/Users/sanika/Downloads/Master Thesis/repo_updated/pytest/doc/en/example/nonpython/__init__.py,5077.0,ModificationType.MODIFY,0,0,0,0,0,0,0,0,0,0,0,0,0,0.0,0.0,0.0,0.0,0.0,0.0,False
1400,55bc084dcc783bda88a221a5437a515df3e7b2ae,/Users/sanika/Downloads/Master Thesis/repo_updated/pytest/src/pytest/__init__.py,5077.0,ModificationType.MODIFY,99,48,90,1,3,5,100,0,0,0,0,0,0,0.0,0.0,0.0,0.0,0.0,0.0,False
1401,55bc084dcc783bda88a221a5437a515df3e7b2ae,/Users/sanika/Downloads/Master Thesis/repo_updated/pytest/src/_pytest/__init__.py,5077.0,ModificationType.MODIFY,8,5,5,2,0,1,10,0,0,0,0,0,0,0.0,0.0,0.0,0.0,0.0,0.0,False
1402,55bc084dcc783bda88a221a5437a515df3e7b2ae,/Users/sanika/Downloads/Master Thesis/repo_updated/pytest/src/_pytest/config/__init__.py,5077.0,ModificationType.MODIFY,1217,716,841,84,126,174,1301,14,185,118,215,199,333,1446.608539104324,2542.995998641035,8.135135135135135,20687.616097052745,1149.3120053918194,0.847665332880345,False
1403,55bc084dcc783bda88a221a5437a515df3e7b2ae,/Users/sanika/Downloads/Master Thesis/repo_updated/pytest/src/_pytest/mark/__init__.py,5077.0,ModificationType.MODIFY,160,89,115,0,13,31,160,7,15,11,17,22,28,78.25484338853101,124.86408532184431,3.966666666666667,495.29420510998256,27.516344728332356,0.04162136177394811,False
1404,55bc084dcc783bda88a221a5437a515df3e7b2ae,/Users/sanika/Downloads/Master Thesis/repo_updated/pytest/src/_pytest/_code/__init__.py,5077.0,ModificationType.MODIFY,10,10,9,9,0,0,19,0,0,0,0,0,0,0.0,0.0,0.0,0.0,0.0,0.0,False
1405,55bc084dcc783bda88a221a5437a515df3e7b2ae,/Users/sanika/Downloads/Master Thesis/repo_updated/pytest/src/_pytest/assertion/__init__.py,5077.0,ModificationType.MODIFY,173,84,99,8,29,36,181,5,12,7,13,17,20,54.62919048309069,81.7492568250068,2.708333333333333,221.40423723439343,12.300235401910744,0.027249752275002263,False
1406,55bc084dcc783bda88a221a5437a515df3e7b2ae,/Users/sanika/Downloads/Master Thesis/repo_updated/pytest/src/_pytest/_io/__init__.py,5077.0,ModificationType.MODIFY,3,1,1,3,0,0,6,0,0,0,0,0,0,0.0,0.0,0.0,0.0,0.0,0.0,False
1407,55bc084dcc783bda88a221a5437a515df3e7b2ae,/Users/sanika/Downloads/Master Thesis/repo_updated/pytest/src/_pytest/config/argparsing.py,2326.0,ModificationType.MODIFY,463,295,324,28,62,57,491,12,134,82,154,146,236,989.8755015299953,1696.7985958956842,6.8955223880597005,11700.312706026956,650.0173725570531,0.565599531965228,False
1408,55bc084dcc783bda88a221a5437a515df3e7b2ae,/Users/sanika/Downloads/Master Thesis/repo_updated/pytest/src/_pytest/hookspec.py,642.0,ModificationType.MODIFY,647,139,84,35,284,233,682,0,0,0,0,0,0,0.0,0.0,0.0,0.0,0.0,0.0,False
1409,772dfc4f9d610ebd735be48fd1c0924384c94e04,/Users/sanika/Downloads/Master Thesis/repo_updated/pytest/testing/test_terminal.py,6372.0,ModificationType.MODIFY,1943,715,1694,26,18,214,1969,12,185,120,237,197,357,1436.3251202041715,2721.0724995459263,7.686486486486486,20915.486996509768,1161.971499806098,0.9070241665153088,False
1410,772dfc4f9d610ebd735be48fd1c0924384c94e04,/Users/sanika/Downloads/Master Thesis/repo_updated/pytest/src/_pytest/terminal.py,6372.0,ModificationType.MODIFY,1168,838,957,57,25,144,1225,19,348,224,416,367,640,3018.854959310786,5452.567201819657,11.35632183908046,61921.107993078396,3440.0615551710216,1.817522400606552,False
1411,2a67637accc9b5f25b4d3fda3b99ad37cfcab18b,/Users/sanika/Downloads/Master Thesis/repo_updated/pytest/src/_pytest/deprecated.py,45.0,ModificationType.MODIFY,42,7,23,2,8,9,44,0,0,0,0,0,0,0.0,0.0,0.0,0.0,0.0,0.0,False
1412,2a67637accc9b5f25b4d3fda3b99ad37cfcab18b,/Users/sanika/Downloads/Master Thesis/repo_updated/pytest/testing/test_junitxml.py,3197.0,ModificationType.MODIFY,1523,757,1297,19,12,193,1542,12,193,117,230,205,347,1508.3637582013935,2664.7795945283897,7.150259067357513,19053.86445828589,1058.5480254603274,0.8882598648427965,False
1413,2a67637accc9b5f25b4d3fda3b99ad37cfcab18b,/Users/sanika/Downloads/Master Thesis/repo_updated/pytest/src/_pytest/junitxml.py,3197.0,ModificationType.MODIFY,701,378,504,33,58,109,734,13,110,68,126,123,194,794.0552848235468,1346.8478140358125,7.445454545454545,10027.894179048459,557.1052321693588,0.4489492713452708,False
1414,2a67637accc9b5f25b4d3fda3b99ad37cfcab18b,/Users/sanika/Downloads/Master Thesis/repo_updated/pytest/testing/deprecated_test.py,265.0,ModificationType.MODIFY,75,38,59,1,3,12,76,2,4,2,4,6,6,10.0,15.509775004326935,1.0,15.509775004326935,0.861654166907052,0.005169925001442312,False
1415,6f2c0fd2e8e8154c8129900c9a1c650068811404,/Users/sanika/Downloads/Master Thesis/repo_updated/pytest/doc/en/example/multipython.py,6777.0,ModificationType.MODIFY,72,33,56,0,4,12,72,1,1,1,1,2,2,0.0,2.0,0.5,1.0,0.05555555555555555,0.0006666666666666666,False
1416,6f2c0fd2e8e8154c8129900c9a1c650068811404,/Users/sanika/Downloads/Master Thesis/repo_updated/pytest/src/_pytest/python.py,6777.0,ModificationType.MODIFY,1454,835,1044,76,110,219,1530,17,275,158,296,292,454,2297.8910156145625,3718.1803497315277,9.149090909090908,34017.97003608918,1889.8872242271768,1.2393934499105097,False
1417,6f2c0fd2e8e8154c8129900c9a1c650068811404,/Users/sanika/Downloads/Master Thesis/repo_updated/pytest/testing/python/metafunc.py,5988.0,ModificationType.MODIFY,1782,648,1425,9,47,279,1791,8,171,97,189,179,286,1292.4527800454887,2140.3713122975773,4.421052631578949,9462.69422278929,525.705234599405,0.7134571040991925,False
1418,92d6a0500b9f528a9adcd6bbcda46ebf9b6baf03,/Users/sanika/Downloads/Master Thesis/repo_updated/pytest/doc/en/example/multipython.py,6777.0,ModificationType.MODIFY,72,33,56,0,4,12,72,1,1,1,1,2,2,0.0,2.0,0.5,1.0,0.05555555555555555,0.0006666666666666666,False
1419,92d6a0500b9f528a9adcd6bbcda46ebf9b6baf03,/Users/sanika/Downloads/Master Thesis/repo_updated/pytest/src/_pytest/python.py,6777.0,ModificationType.MODIFY,1454,835,1044,76,110,219,1530,17,275,158,296,292,454,2297.8910156145625,3718.1803497315277,9.149090909090908,34017.97003608918,1889.8872242271768,1.2393934499105097,False
1420,92d6a0500b9f528a9adcd6bbcda46ebf9b6baf03,/Users/sanika/Downloads/Master Thesis/repo_updated/pytest/testing/python/metafunc.py,5988.0,ModificationType.MODIFY,1782,648,1425,9,47,279,1791,8,171,97,189,179,286,1292.4527800454887,2140.3713122975773,4.421052631578949,9462.69422278929,525.705234599405,0.7134571040991925,False
1421,2fc7d04fc380e0ee6f43538504ec36c896688c47,/Users/sanika/Downloads/Master Thesis/repo_updated/pytest/testing/example_scripts/collect/package_infinite_recursion/__init__.pyi,5077.0,ModificationType.MODIFY,0,0,0,0,0,0,0,0,0,0,0,0,0,0.0,0.0,0.0,0.0,0.0,0.0,False
1422,2fc7d04fc380e0ee6f43538504ec36c896688c47,/Users/sanika/Downloads/Master Thesis/repo_updated/pytest/testing/example_scripts/collect/package_infinite_recursion/tests/__init__.py,5077.0,ModificationType.MODIFY,0,0,0,0,0,0,0,0,0,0,0,0,0,0.0,0.0,0.0,0.0,0.0,0.0,False
1423,2fc7d04fc380e0ee6f43538504ec36c896688c47,/Users/sanika/Downloads/Master Thesis/repo_updated/pytest/testing/example_scripts/collect/collect_init_tests/tests/__init__.py,5077.0,ModificationType.MODIFY,2,2,2,0,0,0,2,0,0,0,0,0,0,0.0,0.0,0.0,0.0,0.0,0.0,False
1424,2fc7d04fc380e0ee6f43538504ec36c896688c47,/Users/sanika/Downloads/Master Thesis/repo_updated/pytest/testing/example_scripts/collect/package_init_given_as_arg/pkg/__init__.py,5077.0,ModificationType.MODIFY,0,0,0,0,0,0,0,0,0,0,0,0,0,0.0,0.0,0.0,0.0,0.0,0.0,False
1425,2fc7d04fc380e0ee6f43538504ec36c896688c47,/Users/sanika/Downloads/Master Thesis/repo_updated/pytest/testing/example_scripts/conftest_usageerror/__init__.pyi,5077.0,ModificationType.MODIFY,0,0,0,0,0,0,0,0,0,0,0,0,0,0.0,0.0,0.0,0.0,0.0,0.0,False
1426,2fc7d04fc380e0ee6f43538504ec36c896688c47,/Users/sanika/Downloads/Master Thesis/repo_updated/pytest/testing/example_scripts/marks/marks_considered_keywords/__init__.pyi,5077.0,ModificationType.MODIFY,0,0,0,0,0,0,0,0,0,0,0,0,0,0.0,0.0,0.0,0.0,0.0,0.0,False
1427,2fc7d04fc380e0ee6f43538504ec36c896688c47,/Users/sanika/Downloads/Master Thesis/repo_updated/pytest/testing/example_scripts/config/collect_pytest_prefix/__init__.pyi,5077.0,ModificationType.MODIFY,0,0,0,0,0,0,0,0,0,0,0,0,0,0.0,0.0,0.0,0.0,0.0,0.0,False
1428,2fc7d04fc380e0ee6f43538504ec36c896688c47,/Users/sanika/Downloads/Master Thesis/repo_updated/pytest/testing/example_scripts/issue88_initial_file_multinodes/__init__.pyi,5077.0,ModificationType.MODIFY,0,0,0,0,0,0,0,0,0,0,0,0,0,0.0,0.0,0.0,0.0,0.0,0.0,False
1429,2fc7d04fc380e0ee6f43538504ec36c896688c47,/Users/sanika/Downloads/Master Thesis/repo_updated/pytest/testing/example_scripts/fixtures/fill_fixtures/test_extend_fixture_conftest_conftest/__init__.pyi,5077.0,ModificationType.MODIFY,0,0,0,0,0,0,0,0,0,0,0,0,0,0.0,0.0,0.0,0.0,0.0,0.0,False
1430,2fc7d04fc380e0ee6f43538504ec36c896688c47,/Users/sanika/Downloads/Master Thesis/repo_updated/pytest/testing/example_scripts/fixtures/fill_fixtures/test_extend_fixture_conftest_conftest/pkg/__init__.py,5077.0,ModificationType.MODIFY,0,0,0,0,0,0,0,0,0,0,0,0,0,0.0,0.0,0.0,0.0,0.0,0.0,False
1431,2fc7d04fc380e0ee6f43538504ec36c896688c47,/Users/sanika/Downloads/Master Thesis/repo_updated/pytest/testing/example_scripts/fixtures/fill_fixtures/test_extend_fixture_conftest_module/__init__.pyi,5077.0,ModificationType.MODIFY,0,0,0,0,0,0,0,0,0,0,0,0,0,0.0,0.0,0.0,0.0,0.0,0.0,False
1432,2fc7d04fc380e0ee6f43538504ec36c896688c47,/Users/sanika/Downloads/Master Thesis/repo_updated/pytest/testing/example_scripts/fixtures/fill_fixtures/test_conftest_funcargs_only_available_in_subdir/sub1/__init__.py,5077.0,ModificationType.MODIFY,0,0,0,0,0,0,0,0,0,0,0,0,0,0.0,0.0,0.0,0.0,0.0,0.0,False
1433,2fc7d04fc380e0ee6f43538504ec36c896688c47,/Users/sanika/Downloads/Master Thesis/repo_updated/pytest/testing/example_scripts/fixtures/fill_fixtures/test_conftest_funcargs_only_available_in_subdir/sub2/__init__.py,5077.0,ModificationType.MODIFY,0,0,0,0,0,0,0,0,0,0,0,0,0,0.0,0.0,0.0,0.0,0.0,0.0,False
1434,2fc7d04fc380e0ee6f43538504ec36c896688c47,/Users/sanika/Downloads/Master Thesis/repo_updated/pytest/testing/example_scripts/fixtures/custom_item/__init__.pyi,5077.0,ModificationType.MODIFY,0,0,0,0,0,0,0,0,0,0,0,0,0,0.0,0.0,0.0,0.0,0.0,0.0,False
1435,2fc7d04fc380e0ee6f43538504ec36c896688c47,/Users/sanika/Downloads/Master Thesis/repo_updated/pytest/testing/example_scripts/fixtures/custom_item/foo/__init__.py,5077.0,ModificationType.MODIFY,0,0,0,0,0,0,0,0,0,0,0,0,0,0.0,0.0,0.0,0.0,0.0,0.0,False
1436,2fc7d04fc380e0ee6f43538504ec36c896688c47,/Users/sanika/Downloads/Master Thesis/repo_updated/pytest/doc/en/example/nonpython/__init__.py,5077.0,ModificationType.MODIFY,0,0,0,0,0,0,0,0,0,0,0,0,0,0.0,0.0,0.0,0.0,0.0,0.0,False
1437,2fc7d04fc380e0ee6f43538504ec36c896688c47,/Users/sanika/Downloads/Master Thesis/repo_updated/pytest/src/pytest/__init__.py,5077.0,ModificationType.MODIFY,99,48,90,1,3,5,100,0,0,0,0,0,0,0.0,0.0,0.0,0.0,0.0,0.0,False
1438,2fc7d04fc380e0ee6f43538504ec36c896688c47,/Users/sanika/Downloads/Master Thesis/repo_updated/pytest/src/_pytest/__init__.py,5077.0,ModificationType.MODIFY,8,5,5,2,0,1,10,0,0,0,0,0,0,0.0,0.0,0.0,0.0,0.0,0.0,False
1439,2fc7d04fc380e0ee6f43538504ec36c896688c47,/Users/sanika/Downloads/Master Thesis/repo_updated/pytest/src/_pytest/config/__init__.py,5077.0,ModificationType.MODIFY,1217,716,841,84,126,174,1301,14,185,118,215,199,333,1446.608539104324,2542.995998641035,8.135135135135135,20687.616097052745,1149.3120053918194,0.847665332880345,False
1440,2fc7d04fc380e0ee6f43538504ec36c896688c47,/Users/sanika/Downloads/Master Thesis/repo_updated/pytest/src/_pytest/mark/__init__.py,5077.0,ModificationType.MODIFY,160,89,115,0,13,31,160,7,15,11,17,22,28,78.25484338853101,124.86408532184431,3.966666666666667,495.29420510998256,27.516344728332356,0.04162136177394811,False
1441,2fc7d04fc380e0ee6f43538504ec36c896688c47,/Users/sanika/Downloads/Master Thesis/repo_updated/pytest/src/_pytest/_code/__init__.py,5077.0,ModificationType.MODIFY,10,10,9,9,0,0,19,0,0,0,0,0,0,0.0,0.0,0.0,0.0,0.0,0.0,False
1442,2fc7d04fc380e0ee6f43538504ec36c896688c47,/Users/sanika/Downloads/Master Thesis/repo_updated/pytest/src/_pytest/assertion/__init__.py,5077.0,ModificationType.MODIFY,173,84,99,8,29,36,181,5,12,7,13,17,20,54.62919048309069,81.7492568250068,2.708333333333333,221.40423723439343,12.300235401910744,0.027249752275002263,False
1443,2fc7d04fc380e0ee6f43538504ec36c896688c47,/Users/sanika/Downloads/Master Thesis/repo_updated/pytest/src/_pytest/_io/__init__.py,5077.0,ModificationType.MODIFY,3,1,1,3,0,0,6,0,0,0,0,0,0,0.0,0.0,0.0,0.0,0.0,0.0,False
1444,2fc7d04fc380e0ee6f43538504ec36c896688c47,/Users/sanika/Downloads/Master Thesis/repo_updated/pytest/src/_pytest/config/argparsing.py,2326.0,ModificationType.MODIFY,463,295,324,28,62,57,491,12,134,82,154,146,236,989.8755015299953,1696.7985958956842,6.8955223880597005,11700.312706026956,650.0173725570531,0.565599531965228,False
1445,2fc7d04fc380e0ee6f43538504ec36c896688c47,/Users/sanika/Downloads/Master Thesis/repo_updated/pytest/src/_pytest/hookspec.py,642.0,ModificationType.MODIFY,647,139,84,35,284,233,682,0,0,0,0,0,0,0.0,0.0,0.0,0.0,0.0,0.0,False
1446,2fc7d04fc380e0ee6f43538504ec36c896688c47,/Users/sanika/Downloads/Master Thesis/repo_updated/pytest/testing/test_terminal.py,6416.0,ModificationType.MODIFY,1943,715,1694,26,18,214,1969,12,185,120,237,197,357,1436.3251202041715,2721.0724995459263,7.686486486486486,20915.486996509768,1161.971499806098,0.9070241665153088,False
1447,2fc7d04fc380e0ee6f43538504ec36c896688c47,/Users/sanika/Downloads/Master Thesis/repo_updated/pytest/src/_pytest/terminal.py,6416.0,ModificationType.MODIFY,1168,838,957,57,25,144,1225,19,348,224,416,367,640,3018.854959310786,5452.567201819657,11.35632183908046,61921.107993078396,3440.0615551710216,1.817522400606552,False
1448,2fc7d04fc380e0ee6f43538504ec36c896688c47,/Users/sanika/Downloads/Master Thesis/repo_updated/pytest/testing/test_warnings.py,625.0,ModificationType.MODIFY,601,196,481,2,23,85,603,8,63,36,72,71,108,400.5686351804948,664.1726889065056,4.571428571428571,3036.21800642974,168.67877813498555,0.22139089630216852,False
1449,2fc7d04fc380e0ee6f43538504ec36c896688c47,/Users/sanika/Downloads/Master Thesis/repo_updated/pytest/src/_pytest/warnings.py,625.0,ModificationType.MODIFY,156,79,106,5,16,28,161,5,14,8,15,19,23,64.91260938324325,97.70233280920246,2.6785714285714284,261.7026771675066,14.539037620417032,0.03256744426973415,False
1450,99f487864caf2a4a1d75a3d322304e7b3b03d01b,/Users/sanika/Downloads/Master Thesis/repo_updated/pytest/src/_pytest/deprecated.py,45.0,ModificationType.MODIFY,42,7,23,2,8,9,44,0,0,0,0,0,0,0.0,0.0,0.0,0.0,0.0,0.0,False
1451,99f487864caf2a4a1d75a3d322304e7b3b03d01b,/Users/sanika/Downloads/Master Thesis/repo_updated/pytest/testing/test_junitxml.py,3197.0,ModificationType.MODIFY,1523,757,1297,19,12,193,1542,12,193,117,230,205,347,1508.3637582013935,2664.7795945283897,7.150259067357513,19053.86445828589,1058.5480254603274,0.8882598648427965,False
1452,99f487864caf2a4a1d75a3d322304e7b3b03d01b,/Users/sanika/Downloads/Master Thesis/repo_updated/pytest/src/_pytest/junitxml.py,3197.0,ModificationType.MODIFY,701,378,504,33,58,109,734,13,110,68,126,123,194,794.0552848235468,1346.8478140358125,7.445454545454545,10027.894179048459,557.1052321693588,0.4489492713452708,False
1453,99f487864caf2a4a1d75a3d322304e7b3b03d01b,/Users/sanika/Downloads/Master Thesis/repo_updated/pytest/testing/deprecated_test.py,265.0,ModificationType.MODIFY,75,38,59,1,3,12,76,2,4,2,4,6,6,10.0,15.509775004326935,1.0,15.509775004326935,0.861654166907052,0.005169925001442312,False
1454,d2ea9e2db58dfb6c5a3c2981bfd062369e51fbf3,/Users/sanika/Downloads/Master Thesis/repo_updated/pytest/testing/example_scripts/collect/package_infinite_recursion/__init__.pyi,5075.0,ModificationType.MODIFY,0,0,0,0,0,0,0,0,0,0,0,0,0,0.0,0.0,0.0,0.0,0.0,0.0,False
1455,d2ea9e2db58dfb6c5a3c2981bfd062369e51fbf3,/Users/sanika/Downloads/Master Thesis/repo_updated/pytest/testing/example_scripts/collect/package_infinite_recursion/tests/__init__.py,5075.0,ModificationType.MODIFY,0,0,0,0,0,0,0,0,0,0,0,0,0,0.0,0.0,0.0,0.0,0.0,0.0,False
1456,d2ea9e2db58dfb6c5a3c2981bfd062369e51fbf3,/Users/sanika/Downloads/Master Thesis/repo_updated/pytest/testing/example_scripts/collect/collect_init_tests/tests/__init__.py,5075.0,ModificationType.MODIFY,2,2,2,0,0,0,2,0,0,0,0,0,0,0.0,0.0,0.0,0.0,0.0,0.0,False
1457,d2ea9e2db58dfb6c5a3c2981bfd062369e51fbf3,/Users/sanika/Downloads/Master Thesis/repo_updated/pytest/testing/example_scripts/collect/package_init_given_as_arg/pkg/__init__.py,5075.0,ModificationType.MODIFY,0,0,0,0,0,0,0,0,0,0,0,0,0,0.0,0.0,0.0,0.0,0.0,0.0,False
1458,d2ea9e2db58dfb6c5a3c2981bfd062369e51fbf3,/Users/sanika/Downloads/Master Thesis/repo_updated/pytest/testing/example_scripts/conftest_usageerror/__init__.pyi,5075.0,ModificationType.MODIFY,0,0,0,0,0,0,0,0,0,0,0,0,0,0.0,0.0,0.0,0.0,0.0,0.0,False
1459,d2ea9e2db58dfb6c5a3c2981bfd062369e51fbf3,/Users/sanika/Downloads/Master Thesis/repo_updated/pytest/testing/example_scripts/marks/marks_considered_keywords/__init__.pyi,5075.0,ModificationType.MODIFY,0,0,0,0,0,0,0,0,0,0,0,0,0,0.0,0.0,0.0,0.0,0.0,0.0,False
1460,d2ea9e2db58dfb6c5a3c2981bfd062369e51fbf3,/Users/sanika/Downloads/Master Thesis/repo_updated/pytest/testing/example_scripts/config/collect_pytest_prefix/__init__.pyi,5075.0,ModificationType.MODIFY,0,0,0,0,0,0,0,0,0,0,0,0,0,0.0,0.0,0.0,0.0,0.0,0.0,False
1461,d2ea9e2db58dfb6c5a3c2981bfd062369e51fbf3,/Users/sanika/Downloads/Master Thesis/repo_updated/pytest/testing/example_scripts/issue88_initial_file_multinodes/__init__.pyi,5075.0,ModificationType.MODIFY,0,0,0,0,0,0,0,0,0,0,0,0,0,0.0,0.0,0.0,0.0,0.0,0.0,False
1462,d2ea9e2db58dfb6c5a3c2981bfd062369e51fbf3,/Users/sanika/Downloads/Master Thesis/repo_updated/pytest/testing/example_scripts/fixtures/fill_fixtures/test_extend_fixture_conftest_conftest/__init__.pyi,5075.0,ModificationType.MODIFY,0,0,0,0,0,0,0,0,0,0,0,0,0,0.0,0.0,0.0,0.0,0.0,0.0,False
1463,d2ea9e2db58dfb6c5a3c2981bfd062369e51fbf3,/Users/sanika/Downloads/Master Thesis/repo_updated/pytest/testing/example_scripts/fixtures/fill_fixtures/test_extend_fixture_conftest_conftest/pkg/__init__.py,5075.0,ModificationType.MODIFY,0,0,0,0,0,0,0,0,0,0,0,0,0,0.0,0.0,0.0,0.0,0.0,0.0,False
1464,d2ea9e2db58dfb6c5a3c2981bfd062369e51fbf3,/Users/sanika/Downloads/Master Thesis/repo_updated/pytest/testing/example_scripts/fixtures/fill_fixtures/test_extend_fixture_conftest_module/__init__.pyi,5075.0,ModificationType.MODIFY,0,0,0,0,0,0,0,0,0,0,0,0,0,0.0,0.0,0.0,0.0,0.0,0.0,False
1465,d2ea9e2db58dfb6c5a3c2981bfd062369e51fbf3,/Users/sanika/Downloads/Master Thesis/repo_updated/pytest/testing/example_scripts/fixtures/fill_fixtures/test_conftest_funcargs_only_available_in_subdir/sub1/__init__.py,5075.0,ModificationType.MODIFY,0,0,0,0,0,0,0,0,0,0,0,0,0,0.0,0.0,0.0,0.0,0.0,0.0,False
1466,d2ea9e2db58dfb6c5a3c2981bfd062369e51fbf3,/Users/sanika/Downloads/Master Thesis/repo_updated/pytest/testing/example_scripts/fixtures/fill_fixtures/test_conftest_funcargs_only_available_in_subdir/sub2/__init__.py,5075.0,ModificationType.MODIFY,0,0,0,0,0,0,0,0,0,0,0,0,0,0.0,0.0,0.0,0.0,0.0,0.0,False
1467,d2ea9e2db58dfb6c5a3c2981bfd062369e51fbf3,/Users/sanika/Downloads/Master Thesis/repo_updated/pytest/testing/example_scripts/fixtures/custom_item/__init__.pyi,5075.0,ModificationType.MODIFY,0,0,0,0,0,0,0,0,0,0,0,0,0,0.0,0.0,0.0,0.0,0.0,0.0,False
1468,d2ea9e2db58dfb6c5a3c2981bfd062369e51fbf3,/Users/sanika/Downloads/Master Thesis/repo_updated/pytest/testing/example_scripts/fixtures/custom_item/foo/__init__.py,5075.0,ModificationType.MODIFY,0,0,0,0,0,0,0,0,0,0,0,0,0,0.0,0.0,0.0,0.0,0.0,0.0,False
1469,d2ea9e2db58dfb6c5a3c2981bfd062369e51fbf3,/Users/sanika/Downloads/Master Thesis/repo_updated/pytest/doc/en/example/nonpython/__init__.py,5075.0,ModificationType.MODIFY,0,0,0,0,0,0,0,0,0,0,0,0,0,0.0,0.0,0.0,0.0,0.0,0.0,False
1470,d2ea9e2db58dfb6c5a3c2981bfd062369e51fbf3,/Users/sanika/Downloads/Master Thesis/repo_updated/pytest/src/pytest/__init__.py,5075.0,ModificationType.MODIFY,99,48,90,1,3,5,100,0,0,0,0,0,0,0.0,0.0,0.0,0.0,0.0,0.0,False
1471,d2ea9e2db58dfb6c5a3c2981bfd062369e51fbf3,/Users/sanika/Downloads/Master Thesis/repo_updated/pytest/src/_pytest/__init__.py,5075.0,ModificationType.MODIFY,8,5,5,2,0,1,10,0,0,0,0,0,0,0.0,0.0,0.0,0.0,0.0,0.0,False
1472,d2ea9e2db58dfb6c5a3c2981bfd062369e51fbf3,/Users/sanika/Downloads/Master Thesis/repo_updated/pytest/src/_pytest/config/__init__.py,5075.0,ModificationType.MODIFY,1217,716,841,84,126,174,1301,14,185,118,215,199,333,1446.608539104324,2542.995998641035,8.135135135135135,20687.616097052745,1149.3120053918194,0.847665332880345,False
1473,d2ea9e2db58dfb6c5a3c2981bfd062369e51fbf3,/Users/sanika/Downloads/Master Thesis/repo_updated/pytest/src/_pytest/mark/__init__.py,5075.0,ModificationType.MODIFY,160,89,115,0,13,31,160,7,15,11,17,22,28,78.25484338853101,124.86408532184431,3.966666666666667,495.29420510998256,27.516344728332356,0.04162136177394811,False
1474,d2ea9e2db58dfb6c5a3c2981bfd062369e51fbf3,/Users/sanika/Downloads/Master Thesis/repo_updated/pytest/src/_pytest/_code/__init__.py,5075.0,ModificationType.MODIFY,10,10,9,9,0,0,19,0,0,0,0,0,0,0.0,0.0,0.0,0.0,0.0,0.0,False
1475,d2ea9e2db58dfb6c5a3c2981bfd062369e51fbf3,/Users/sanika/Downloads/Master Thesis/repo_updated/pytest/src/_pytest/assertion/__init__.py,5075.0,ModificationType.MODIFY,173,84,99,8,29,36,181,5,12,7,13,17,20,54.62919048309069,81.7492568250068,2.708333333333333,221.40423723439343,12.300235401910744,0.027249752275002263,False
1476,d2ea9e2db58dfb6c5a3c2981bfd062369e51fbf3,/Users/sanika/Downloads/Master Thesis/repo_updated/pytest/src/_pytest/_io/__init__.py,5075.0,ModificationType.MODIFY,3,1,1,3,0,0,6,0,0,0,0,0,0,0.0,0.0,0.0,0.0,0.0,0.0,False
1477,d2ea9e2db58dfb6c5a3c2981bfd062369e51fbf3,/Users/sanika/Downloads/Master Thesis/repo_updated/pytest/src/_pytest/deprecated.py,45.0,ModificationType.MODIFY,42,7,23,2,8,9,44,0,0,0,0,0,0,0.0,0.0,0.0,0.0,0.0,0.0,False
1478,d2ea9e2db58dfb6c5a3c2981bfd062369e51fbf3,/Users/sanika/Downloads/Master Thesis/repo_updated/pytest/testing/deprecated_test.py,265.0,ModificationType.MODIFY,75,38,59,1,3,12,76,2,4,2,4,6,6,10.0,15.509775004326935,1.0,15.509775004326935,0.861654166907052,0.005169925001442312,False
1479,176c7771fb4f3bd703bb6c9650cc32e31d548a2b,/Users/sanika/Downloads/Master Thesis/repo_updated/pytest/doc/en/example/multipython.py,6699.0,ModificationType.MODIFY,72,33,56,0,4,12,72,1,1,1,1,2,2,0.0,2.0,0.5,1.0,0.05555555555555555,0.0006666666666666666,False
1480,176c7771fb4f3bd703bb6c9650cc32e31d548a2b,/Users/sanika/Downloads/Master Thesis/repo_updated/pytest/src/_pytest/python.py,6699.0,ModificationType.MODIFY,1454,835,1044,76,110,219,1530,17,275,158,296,292,454,2297.8910156145625,3718.1803497315277,9.149090909090908,34017.97003608918,1889.8872242271768,1.2393934499105097,False
1481,176c7771fb4f3bd703bb6c9650cc32e31d548a2b,/Users/sanika/Downloads/Master Thesis/repo_updated/pytest/testing/test_skipping.py,3071.0,ModificationType.MODIFY,1178,367,1042,6,15,115,1184,9,94,51,95,103,146,644.6606770706788,976.22907696875,4.547872340425532,4439.7652170653255,246.65362317029587,0.3254096923229167,False
1482,4e0f99260d438d750b55a0881110658b8bba5a4a,/Users/sanika/Downloads/Master Thesis/repo_updated/pytest/testing/test_collection.py,5041.0,ModificationType.MODIFY,1296,573,1062,40,33,157,1336,8,201,118,231,209,349,1561.8613899269644,2689.868337096228,4.597014925373134,12365.364892919973,686.9647162733319,0.896622779032076,False
1483,19a15a94eeb403631f847fab5fe5073bc56e8bcc,/Users/sanika/Downloads/Master Thesis/repo_updated/pytest/doc/en/example/multipython.py,6699.0,ModificationType.MODIFY,72,33,56,0,4,12,72,1,1,1,1,2,2,0.0,2.0,0.5,1.0,0.05555555555555555,0.0006666666666666666,False
1484,19a15a94eeb403631f847fab5fe5073bc56e8bcc,/Users/sanika/Downloads/Master Thesis/repo_updated/pytest/src/_pytest/python.py,6699.0,ModificationType.MODIFY,1454,835,1044,76,110,219,1530,17,275,158,296,292,454,2297.8910156145625,3718.1803497315277,9.149090909090908,34017.97003608918,1889.8872242271768,1.2393934499105097,False
1485,19a15a94eeb403631f847fab5fe5073bc56e8bcc,/Users/sanika/Downloads/Master Thesis/repo_updated/pytest/testing/test_collection.py,5041.0,ModificationType.MODIFY,1296,573,1062,40,33,157,1336,8,201,118,231,209,349,1561.8613899269644,2689.868337096228,4.597014925373134,12365.364892919973,686.9647162733319,0.896622779032076,False
1486,19a15a94eeb403631f847fab5fe5073bc56e8bcc,/Users/sanika/Downloads/Master Thesis/repo_updated/pytest/testing/test_skipping.py,3071.0,ModificationType.MODIFY,1178,367,1042,6,15,115,1184,9,94,51,95,103,146,644.6606770706788,976.22907696875,4.547872340425532,4439.7652170653255,246.65362317029587,0.3254096923229167,False
1487,5979837c6084e80367ce4f7e1b97aabd755221b0,/Users/sanika/Downloads/Master Thesis/repo_updated/pytest/testing/test_assertrewrite.py,5619.0,ModificationType.MODIFY,1660,832,1314,41,38,274,1701,20,312,209,395,332,604,2671.484054182769,5058.523816533542,12.660256410256409,64042.208574703494,3557.900476372417,1.6861746055111808,False
1488,5979837c6084e80367ce4f7e1b97aabd755221b0,/Users/sanika/Downloads/Master Thesis/repo_updated/pytest/src/_pytest/assertion/rewrite.py,5619.0,ModificationType.MODIFY,1057,646,719,113,100,145,1170,18,215,134,248,233,382,1740.9201126876956,3004.119107257935,10.381395348837211,31186.94812744052,1732.608229302251,1.001373035752645,False
1489,5979837c6084e80367ce4f7e1b97aabd755221b0,/Users/sanika/Downloads/Master Thesis/repo_updated/pytest/testing/example_scripts/collect/package_infinite_recursion/__init__.pyi,5079.0,ModificationType.MODIFY,0,0,0,0,0,0,0,0,0,0,0,0,0,0.0,0.0,0.0,0.0,0.0,0.0,False
1490,5979837c6084e80367ce4f7e1b97aabd755221b0,/Users/sanika/Downloads/Master Thesis/repo_updated/pytest/testing/example_scripts/collect/package_infinite_recursion/tests/__init__.py,5079.0,ModificationType.MODIFY,0,0,0,0,0,0,0,0,0,0,0,0,0,0.0,0.0,0.0,0.0,0.0,0.0,False
1491,5979837c6084e80367ce4f7e1b97aabd755221b0,/Users/sanika/Downloads/Master Thesis/repo_updated/pytest/testing/example_scripts/collect/collect_init_tests/tests/__init__.py,5079.0,ModificationType.MODIFY,2,2,2,0,0,0,2,0,0,0,0,0,0,0.0,0.0,0.0,0.0,0.0,0.0,False
1492,5979837c6084e80367ce4f7e1b97aabd755221b0,/Users/sanika/Downloads/Master Thesis/repo_updated/pytest/testing/example_scripts/collect/package_init_given_as_arg/pkg/__init__.py,5079.0,ModificationType.MODIFY,0,0,0,0,0,0,0,0,0,0,0,0,0,0.0,0.0,0.0,0.0,0.0,0.0,False
1493,5979837c6084e80367ce4f7e1b97aabd755221b0,/Users/sanika/Downloads/Master Thesis/repo_updated/pytest/testing/example_scripts/conftest_usageerror/__init__.pyi,5079.0,ModificationType.MODIFY,0,0,0,0,0,0,0,0,0,0,0,0,0,0.0,0.0,0.0,0.0,0.0,0.0,False
1494,5979837c6084e80367ce4f7e1b97aabd755221b0,/Users/sanika/Downloads/Master Thesis/repo_updated/pytest/testing/example_scripts/marks/marks_considered_keywords/__init__.pyi,5079.0,ModificationType.MODIFY,0,0,0,0,0,0,0,0,0,0,0,0,0,0.0,0.0,0.0,0.0,0.0,0.0,False
1495,5979837c6084e80367ce4f7e1b97aabd755221b0,/Users/sanika/Downloads/Master Thesis/repo_updated/pytest/testing/example_scripts/config/collect_pytest_prefix/__init__.pyi,5079.0,ModificationType.MODIFY,0,0,0,0,0,0,0,0,0,0,0,0,0,0.0,0.0,0.0,0.0,0.0,0.0,False
1496,5979837c6084e80367ce4f7e1b97aabd755221b0,/Users/sanika/Downloads/Master Thesis/repo_updated/pytest/testing/example_scripts/issue88_initial_file_multinodes/__init__.pyi,5079.0,ModificationType.MODIFY,0,0,0,0,0,0,0,0,0,0,0,0,0,0.0,0.0,0.0,0.0,0.0,0.0,False
1497,5979837c6084e80367ce4f7e1b97aabd755221b0,/Users/sanika/Downloads/Master Thesis/repo_updated/pytest/testing/example_scripts/fixtures/fill_fixtures/test_extend_fixture_conftest_conftest/__init__.pyi,5079.0,ModificationType.MODIFY,0,0,0,0,0,0,0,0,0,0,0,0,0,0.0,0.0,0.0,0.0,0.0,0.0,False
1498,5979837c6084e80367ce4f7e1b97aabd755221b0,/Users/sanika/Downloads/Master Thesis/repo_updated/pytest/testing/example_scripts/fixtures/fill_fixtures/test_extend_fixture_conftest_conftest/pkg/__init__.py,5079.0,ModificationType.MODIFY,0,0,0,0,0,0,0,0,0,0,0,0,0,0.0,0.0,0.0,0.0,0.0,0.0,False
1499,5979837c6084e80367ce4f7e1b97aabd755221b0,/Users/sanika/Downloads/Master Thesis/repo_updated/pytest/testing/example_scripts/fixtures/fill_fixtures/test_extend_fixture_conftest_module/__init__.pyi,5079.0,ModificationType.MODIFY,0,0,0,0,0,0,0,0,0,0,0,0,0,0.0,0.0,0.0,0.0,0.0,0.0,False
1500,5979837c6084e80367ce4f7e1b97aabd755221b0,/Users/sanika/Downloads/Master Thesis/repo_updated/pytest/testing/example_scripts/fixtures/fill_fixtures/test_conftest_funcargs_only_available_in_subdir/sub1/__init__.py,5079.0,ModificationType.MODIFY,0,0,0,0,0,0,0,0,0,0,0,0,0,0.0,0.0,0.0,0.0,0.0,0.0,False
1501,5979837c6084e80367ce4f7e1b97aabd755221b0,/Users/sanika/Downloads/Master Thesis/repo_updated/pytest/testing/example_scripts/fixtures/fill_fixtures/test_conftest_funcargs_only_available_in_subdir/sub2/__init__.py,5079.0,ModificationType.MODIFY,0,0,0,0,0,0,0,0,0,0,0,0,0,0.0,0.0,0.0,0.0,0.0,0.0,False
1502,5979837c6084e80367ce4f7e1b97aabd755221b0,/Users/sanika/Downloads/Master Thesis/repo_updated/pytest/testing/example_scripts/fixtures/custom_item/__init__.pyi,5079.0,ModificationType.MODIFY,0,0,0,0,0,0,0,0,0,0,0,0,0,0.0,0.0,0.0,0.0,0.0,0.0,False
1503,5979837c6084e80367ce4f7e1b97aabd755221b0,/Users/sanika/Downloads/Master Thesis/repo_updated/pytest/testing/example_scripts/fixtures/custom_item/foo/__init__.py,5079.0,ModificationType.MODIFY,0,0,0,0,0,0,0,0,0,0,0,0,0,0.0,0.0,0.0,0.0,0.0,0.0,False
1504,5979837c6084e80367ce4f7e1b97aabd755221b0,/Users/sanika/Downloads/Master Thesis/repo_updated/pytest/doc/en/example/nonpython/__init__.py,5079.0,ModificationType.MODIFY,0,0,0,0,0,0,0,0,0,0,0,0,0,0.0,0.0,0.0,0.0,0.0,0.0,False
1505,5979837c6084e80367ce4f7e1b97aabd755221b0,/Users/sanika/Downloads/Master Thesis/repo_updated/pytest/src/pytest/__init__.py,5079.0,ModificationType.MODIFY,99,48,90,1,3,5,100,0,0,0,0,0,0,0.0,0.0,0.0,0.0,0.0,0.0,False
1506,5979837c6084e80367ce4f7e1b97aabd755221b0,/Users/sanika/Downloads/Master Thesis/repo_updated/pytest/src/_pytest/__init__.py,5079.0,ModificationType.MODIFY,8,5,5,2,0,1,10,0,0,0,0,0,0,0.0,0.0,0.0,0.0,0.0,0.0,False
1507,5979837c6084e80367ce4f7e1b97aabd755221b0,/Users/sanika/Downloads/Master Thesis/repo_updated/pytest/src/_pytest/config/__init__.py,5079.0,ModificationType.MODIFY,1217,716,841,84,126,174,1301,14,185,118,215,199,333,1446.608539104324,2542.995998641035,8.135135135135135,20687.616097052745,1149.3120053918194,0.847665332880345,False
1508,5979837c6084e80367ce4f7e1b97aabd755221b0,/Users/sanika/Downloads/Master Thesis/repo_updated/pytest/src/_pytest/mark/__init__.py,5079.0,ModificationType.MODIFY,160,89,115,0,13,31,160,7,15,11,17,22,28,78.25484338853101,124.86408532184431,3.966666666666667,495.29420510998256,27.516344728332356,0.04162136177394811,False
1509,5979837c6084e80367ce4f7e1b97aabd755221b0,/Users/sanika/Downloads/Master Thesis/repo_updated/pytest/src/_pytest/_code/__init__.py,5079.0,ModificationType.MODIFY,10,10,9,9,0,0,19,0,0,0,0,0,0,0.0,0.0,0.0,0.0,0.0,0.0,False
1510,5979837c6084e80367ce4f7e1b97aabd755221b0,/Users/sanika/Downloads/Master Thesis/repo_updated/pytest/src/_pytest/assertion/__init__.py,5079.0,ModificationType.MODIFY,173,84,99,8,29,36,181,5,12,7,13,17,20,54.62919048309069,81.7492568250068,2.708333333333333,221.40423723439343,12.300235401910744,0.027249752275002263,False
1511,5979837c6084e80367ce4f7e1b97aabd755221b0,/Users/sanika/Downloads/Master Thesis/repo_updated/pytest/src/_pytest/_io/__init__.py,5079.0,ModificationType.MODIFY,3,1,1,3,0,0,6,0,0,0,0,0,0,0.0,0.0,0.0,0.0,0.0,0.0,False
1512,5979837c6084e80367ce4f7e1b97aabd755221b0,/Users/sanika/Downloads/Master Thesis/repo_updated/pytest/testing/test_assertrewrite.py,6342.0,ModificationType.MODIFY,1660,832,1314,41,38,274,1701,20,312,209,395,332,604,2671.484054182769,5058.523816533542,12.660256410256409,64042.208574703494,3557.900476372417,1.6861746055111808,False
1513,5979837c6084e80367ce4f7e1b97aabd755221b0,/Users/sanika/Downloads/Master Thesis/repo_updated/pytest/testing/test_config.py,6058.0,ModificationType.MODIFY,1457,730,1242,11,6,188,1468,10,292,166,329,302,495,2424.648052141839,4078.0103459659135,5.633561643835616,22973.722668198385,1276.3179260110217,1.359336781988638,False
1514,5979837c6084e80367ce4f7e1b97aabd755221b0,/Users/sanika/Downloads/Master Thesis/repo_updated/pytest/testing/test_conftest.py,2850.0,ModificationType.MODIFY,652,304,544,16,6,88,668,6,89,51,101,95,152,591.8500503603364,998.618052466304,3.4044943820224716,3399.789549407755,188.87719718931967,0.3328726841554347,False
1515,5979837c6084e80367ce4f7e1b97aabd755221b0,/Users/sanika/Downloads/Master Thesis/repo_updated/pytest/testing/test_junitxml.py,5659.0,ModificationType.MODIFY,1523,757,1297,19,12,193,1542,12,193,117,230,205,347,1508.3637582013935,2664.7795945283897,7.150259067357513,19053.86445828589,1058.5480254603274,0.8882598648427965,False
1516,1abb08d52f165e46bb3cc80a9ece860aa4afe5b5,/Users/sanika/Downloads/Master Thesis/repo_updated/pytest/testing/test_cacheprovider.py,3885.0,ModificationType.MODIFY,996,429,845,24,10,117,1020,7,76,50,88,83,138,494.49397547611574,879.7554415258757,4.052631578947368,3565.324684078549,198.07359355991935,0.2932518138419585,False
1517,c49c61fdafdce50ffefd3ad482e3bd6f58ef298e,/Users/sanika/Downloads/Master Thesis/repo_updated/pytest/testing/test_assertrewrite.py,5619.0,ModificationType.MODIFY,1660,832,1314,41,38,274,1701,20,312,209,395,332,604,2671.484054182769,5058.523816533542,12.660256410256409,64042.208574703494,3557.900476372417,1.6861746055111808,False
1518,c49c61fdafdce50ffefd3ad482e3bd6f58ef298e,/Users/sanika/Downloads/Master Thesis/repo_updated/pytest/src/_pytest/assertion/rewrite.py,5619.0,ModificationType.MODIFY,1057,646,719,113,100,145,1170,18,215,134,248,233,382,1740.9201126876956,3004.119107257935,10.381395348837211,31186.94812744052,1732.608229302251,1.001373035752645,False
1519,c49c61fdafdce50ffefd3ad482e3bd6f58ef298e,/Users/sanika/Downloads/Master Thesis/repo_updated/pytest/testing/example_scripts/collect/package_infinite_recursion/__init__.pyi,5079.0,ModificationType.MODIFY,0,0,0,0,0,0,0,0,0,0,0,0,0,0.0,0.0,0.0,0.0,0.0,0.0,False
1520,c49c61fdafdce50ffefd3ad482e3bd6f58ef298e,/Users/sanika/Downloads/Master Thesis/repo_updated/pytest/testing/example_scripts/collect/package_infinite_recursion/tests/__init__.py,5079.0,ModificationType.MODIFY,0,0,0,0,0,0,0,0,0,0,0,0,0,0.0,0.0,0.0,0.0,0.0,0.0,False
1521,c49c61fdafdce50ffefd3ad482e3bd6f58ef298e,/Users/sanika/Downloads/Master Thesis/repo_updated/pytest/testing/example_scripts/collect/collect_init_tests/tests/__init__.py,5079.0,ModificationType.MODIFY,2,2,2,0,0,0,2,0,0,0,0,0,0,0.0,0.0,0.0,0.0,0.0,0.0,False
1522,c49c61fdafdce50ffefd3ad482e3bd6f58ef298e,/Users/sanika/Downloads/Master Thesis/repo_updated/pytest/testing/example_scripts/collect/package_init_given_as_arg/pkg/__init__.py,5079.0,ModificationType.MODIFY,0,0,0,0,0,0,0,0,0,0,0,0,0,0.0,0.0,0.0,0.0,0.0,0.0,False
1523,c49c61fdafdce50ffefd3ad482e3bd6f58ef298e,/Users/sanika/Downloads/Master Thesis/repo_updated/pytest/testing/example_scripts/conftest_usageerror/__init__.pyi,5079.0,ModificationType.MODIFY,0,0,0,0,0,0,0,0,0,0,0,0,0,0.0,0.0,0.0,0.0,0.0,0.0,False
1524,c49c61fdafdce50ffefd3ad482e3bd6f58ef298e,/Users/sanika/Downloads/Master Thesis/repo_updated/pytest/testing/example_scripts/marks/marks_considered_keywords/__init__.pyi,5079.0,ModificationType.MODIFY,0,0,0,0,0,0,0,0,0,0,0,0,0,0.0,0.0,0.0,0.0,0.0,0.0,False
1525,c49c61fdafdce50ffefd3ad482e3bd6f58ef298e,/Users/sanika/Downloads/Master Thesis/repo_updated/pytest/testing/example_scripts/config/collect_pytest_prefix/__init__.pyi,5079.0,ModificationType.MODIFY,0,0,0,0,0,0,0,0,0,0,0,0,0,0.0,0.0,0.0,0.0,0.0,0.0,False
1526,c49c61fdafdce50ffefd3ad482e3bd6f58ef298e,/Users/sanika/Downloads/Master Thesis/repo_updated/pytest/testing/example_scripts/issue88_initial_file_multinodes/__init__.pyi,5079.0,ModificationType.MODIFY,0,0,0,0,0,0,0,0,0,0,0,0,0,0.0,0.0,0.0,0.0,0.0,0.0,False
1527,c49c61fdafdce50ffefd3ad482e3bd6f58ef298e,/Users/sanika/Downloads/Master Thesis/repo_updated/pytest/testing/example_scripts/fixtures/fill_fixtures/test_extend_fixture_conftest_conftest/__init__.pyi,5079.0,ModificationType.MODIFY,0,0,0,0,0,0,0,0,0,0,0,0,0,0.0,0.0,0.0,0.0,0.0,0.0,False
1528,c49c61fdafdce50ffefd3ad482e3bd6f58ef298e,/Users/sanika/Downloads/Master Thesis/repo_updated/pytest/testing/example_scripts/fixtures/fill_fixtures/test_extend_fixture_conftest_conftest/pkg/__init__.py,5079.0,ModificationType.MODIFY,0,0,0,0,0,0,0,0,0,0,0,0,0,0.0,0.0,0.0,0.0,0.0,0.0,False
1529,c49c61fdafdce50ffefd3ad482e3bd6f58ef298e,/Users/sanika/Downloads/Master Thesis/repo_updated/pytest/testing/example_scripts/fixtures/fill_fixtures/test_extend_fixture_conftest_module/__init__.pyi,5079.0,ModificationType.MODIFY,0,0,0,0,0,0,0,0,0,0,0,0,0,0.0,0.0,0.0,0.0,0.0,0.0,False
1530,c49c61fdafdce50ffefd3ad482e3bd6f58ef298e,/Users/sanika/Downloads/Master Thesis/repo_updated/pytest/testing/example_scripts/fixtures/fill_fixtures/test_conftest_funcargs_only_available_in_subdir/sub1/__init__.py,5079.0,ModificationType.MODIFY,0,0,0,0,0,0,0,0,0,0,0,0,0,0.0,0.0,0.0,0.0,0.0,0.0,False
1531,c49c61fdafdce50ffefd3ad482e3bd6f58ef298e,/Users/sanika/Downloads/Master Thesis/repo_updated/pytest/testing/example_scripts/fixtures/fill_fixtures/test_conftest_funcargs_only_available_in_subdir/sub2/__init__.py,5079.0,ModificationType.MODIFY,0,0,0,0,0,0,0,0,0,0,0,0,0,0.0,0.0,0.0,0.0,0.0,0.0,False
1532,c49c61fdafdce50ffefd3ad482e3bd6f58ef298e,/Users/sanika/Downloads/Master Thesis/repo_updated/pytest/testing/example_scripts/fixtures/custom_item/__init__.pyi,5079.0,ModificationType.MODIFY,0,0,0,0,0,0,0,0,0,0,0,0,0,0.0,0.0,0.0,0.0,0.0,0.0,False
1533,c49c61fdafdce50ffefd3ad482e3bd6f58ef298e,/Users/sanika/Downloads/Master Thesis/repo_updated/pytest/testing/example_scripts/fixtures/custom_item/foo/__init__.py,5079.0,ModificationType.MODIFY,0,0,0,0,0,0,0,0,0,0,0,0,0,0.0,0.0,0.0,0.0,0.0,0.0,False
1534,c49c61fdafdce50ffefd3ad482e3bd6f58ef298e,/Users/sanika/Downloads/Master Thesis/repo_updated/pytest/doc/en/example/nonpython/__init__.py,5079.0,ModificationType.MODIFY,0,0,0,0,0,0,0,0,0,0,0,0,0,0.0,0.0,0.0,0.0,0.0,0.0,False
1535,c49c61fdafdce50ffefd3ad482e3bd6f58ef298e,/Users/sanika/Downloads/Master Thesis/repo_updated/pytest/src/pytest/__init__.py,5079.0,ModificationType.MODIFY,99,48,90,1,3,5,100,0,0,0,0,0,0,0.0,0.0,0.0,0.0,0.0,0.0,False
1536,c49c61fdafdce50ffefd3ad482e3bd6f58ef298e,/Users/sanika/Downloads/Master Thesis/repo_updated/pytest/src/_pytest/__init__.py,5079.0,ModificationType.MODIFY,8,5,5,2,0,1,10,0,0,0,0,0,0,0.0,0.0,0.0,0.0,0.0,0.0,False
1537,c49c61fdafdce50ffefd3ad482e3bd6f58ef298e,/Users/sanika/Downloads/Master Thesis/repo_updated/pytest/src/_pytest/config/__init__.py,5079.0,ModificationType.MODIFY,1217,716,841,84,126,174,1301,14,185,118,215,199,333,1446.608539104324,2542.995998641035,8.135135135135135,20687.616097052745,1149.3120053918194,0.847665332880345,False
1538,c49c61fdafdce50ffefd3ad482e3bd6f58ef298e,/Users/sanika/Downloads/Master Thesis/repo_updated/pytest/src/_pytest/mark/__init__.py,5079.0,ModificationType.MODIFY,160,89,115,0,13,31,160,7,15,11,17,22,28,78.25484338853101,124.86408532184431,3.966666666666667,495.29420510998256,27.516344728332356,0.04162136177394811,False
1539,c49c61fdafdce50ffefd3ad482e3bd6f58ef298e,/Users/sanika/Downloads/Master Thesis/repo_updated/pytest/src/_pytest/_code/__init__.py,5079.0,ModificationType.MODIFY,10,10,9,9,0,0,19,0,0,0,0,0,0,0.0,0.0,0.0,0.0,0.0,0.0,False
1540,c49c61fdafdce50ffefd3ad482e3bd6f58ef298e,/Users/sanika/Downloads/Master Thesis/repo_updated/pytest/src/_pytest/assertion/__init__.py,5079.0,ModificationType.MODIFY,173,84,99,8,29,36,181,5,12,7,13,17,20,54.62919048309069,81.7492568250068,2.708333333333333,221.40423723439343,12.300235401910744,0.027249752275002263,False
1541,c49c61fdafdce50ffefd3ad482e3bd6f58ef298e,/Users/sanika/Downloads/Master Thesis/repo_updated/pytest/src/_pytest/_io/__init__.py,5079.0,ModificationType.MODIFY,3,1,1,3,0,0,6,0,0,0,0,0,0,0.0,0.0,0.0,0.0,0.0,0.0,False
1542,c49c61fdafdce50ffefd3ad482e3bd6f58ef298e,/Users/sanika/Downloads/Master Thesis/repo_updated/pytest/testing/test_assertrewrite.py,6342.0,ModificationType.MODIFY,1660,832,1314,41,38,274,1701,20,312,209,395,332,604,2671.484054182769,5058.523816533542,12.660256410256409,64042.208574703494,3557.900476372417,1.6861746055111808,False
1543,c49c61fdafdce50ffefd3ad482e3bd6f58ef298e,/Users/sanika/Downloads/Master Thesis/repo_updated/pytest/testing/test_config.py,6058.0,ModificationType.MODIFY,1457,730,1242,11,6,188,1468,10,292,166,329,302,495,2424.648052141839,4078.0103459659135,5.633561643835616,22973.722668198385,1276.3179260110217,1.359336781988638,False
1544,c49c61fdafdce50ffefd3ad482e3bd6f58ef298e,/Users/sanika/Downloads/Master Thesis/repo_updated/pytest/testing/test_conftest.py,2850.0,ModificationType.MODIFY,652,304,544,16,6,88,668,6,89,51,101,95,152,591.8500503603364,998.618052466304,3.4044943820224716,3399.789549407755,188.87719718931967,0.3328726841554347,False
1545,c49c61fdafdce50ffefd3ad482e3bd6f58ef298e,/Users/sanika/Downloads/Master Thesis/repo_updated/pytest/testing/test_junitxml.py,5659.0,ModificationType.MODIFY,1523,757,1297,19,12,193,1542,12,193,117,230,205,347,1508.3637582013935,2664.7795945283897,7.150259067357513,19053.86445828589,1058.5480254603274,0.8882598648427965,False
1546,cc78444c30ba7930358cd0bd3cfac9ba52cb579f,/Users/sanika/Downloads/Master Thesis/repo_updated/pytest/doc/en/example/multipython.py,6705.0,ModificationType.MODIFY,72,33,56,0,4,12,72,1,1,1,1,2,2,0.0,2.0,0.5,1.0,0.05555555555555555,0.0006666666666666666,False
1547,cc78444c30ba7930358cd0bd3cfac9ba52cb579f,/Users/sanika/Downloads/Master Thesis/repo_updated/pytest/src/_pytest/python.py,6705.0,ModificationType.MODIFY,1454,835,1044,76,110,219,1530,17,275,158,296,292,454,2297.8910156145625,3718.1803497315277,9.149090909090908,34017.97003608918,1889.8872242271768,1.2393934499105097,False
1548,cc78444c30ba7930358cd0bd3cfac9ba52cb579f,/Users/sanika/Downloads/Master Thesis/repo_updated/pytest/testing/python/metafunc.py,5913.0,ModificationType.MODIFY,1782,648,1425,9,47,279,1791,8,171,97,189,179,286,1292.4527800454887,2140.3713122975773,4.421052631578949,9462.69422278929,525.705234599405,0.7134571040991925,False
1549,cc78444c30ba7930358cd0bd3cfac9ba52cb579f,/Users/sanika/Downloads/Master Thesis/repo_updated/pytest/testing/test_collection.py,5034.0,ModificationType.MODIFY,1296,573,1062,40,33,157,1336,8,201,118,231,209,349,1561.8613899269644,2689.868337096228,4.597014925373134,12365.364892919973,686.9647162733319,0.896622779032076,False
1550,329f56ecec5a9fcbfa160d4b467342a7c19ef2c0,/Users/sanika/Downloads/Master Thesis/repo_updated/pytest/doc/en/example/multipython.py,6689.0,ModificationType.MODIFY,72,33,56,0,4,12,72,1,1,1,1,2,2,0.0,2.0,0.5,1.0,0.05555555555555555,0.0006666666666666666,False
1551,329f56ecec5a9fcbfa160d4b467342a7c19ef2c0,/Users/sanika/Downloads/Master Thesis/repo_updated/pytest/src/_pytest/python.py,6689.0,ModificationType.MODIFY,1454,835,1044,76,110,219,1530,17,275,158,296,292,454,2297.8910156145625,3718.1803497315277,9.149090909090908,34017.97003608918,1889.8872242271768,1.2393934499105097,False
1552,f760356578836fd888a1cd825460d8daa8808ea6,/Users/sanika/Downloads/Master Thesis/repo_updated/pytest/testing/code/test_source.py,1732.0,ModificationType.MODIFY,773,419,590,28,0,166,801,10,204,113,217,214,330,1598.3940507110583,2554.6841055123778,5.318627450980392,13587.413012161423,754.8562784534123,0.8515613685041261,False
1553,f760356578836fd888a1cd825460d8daa8808ea6,/Users/sanika/Downloads/Master Thesis/repo_updated/pytest/src/_pytest/_code/source.py,1732.0,ModificationType.MODIFY,421,273,302,44,34,57,465,17,81,59,107,98,166,583.0147185349102,1098.0418341231248,11.228395061728396,12329.247507839285,684.9581948799603,0.36601394470770826,False
1554,f760356578836fd888a1cd825460d8daa8808ea6,/Users/sanika/Downloads/Master Thesis/repo_updated/pytest/testing/test_assertrewrite.py,5619.0,ModificationType.MODIFY,1660,832,1314,41,38,274,1701,20,312,209,395,332,604,2671.484054182769,5058.523816533542,12.660256410256409,64042.208574703494,3557.900476372417,1.6861746055111808,False
1555,f760356578836fd888a1cd825460d8daa8808ea6,/Users/sanika/Downloads/Master Thesis/repo_updated/pytest/src/_pytest/assertion/rewrite.py,5619.0,ModificationType.MODIFY,1057,646,719,113,100,145,1170,18,215,134,248,233,382,1740.9201126876956,3004.119107257935,10.381395348837211,31186.94812744052,1732.608229302251,1.001373035752645,False
1556,f760356578836fd888a1cd825460d8daa8808ea6,/Users/sanika/Downloads/Master Thesis/repo_updated/pytest/testing/test_compat.py,1418.0,ModificationType.MODIFY,207,111,150,11,0,50,218,5,26,19,36,31,55,133.82107314610522,272.4807970712782,3.4615384615384617,943.202759092886,52.400153282938106,0.09082693235709273,False
1557,f760356578836fd888a1cd825460d8daa8808ea6,/Users/sanika/Downloads/Master Thesis/repo_updated/pytest/src/_pytest/compat.py,1418.0,ModificationType.MODIFY,410,198,237,31,55,97,441,11,63,38,72,74,110,414.62238298550506,683.0398702191846,6.2857142857142865,4293.39346994916,238.52185944162002,0.2276799567397282,False
1558,f760356578836fd888a1cd825460d8daa8808ea6,/Users/sanika/Downloads/Master Thesis/repo_updated/pytest/src/_pytest/python_api.py,1970.0,ModificationType.MODIFY,757,253,292,73,244,162,830,13,61,38,67,74,105,409.88069392717034,651.9926033910399,7.139344262295082,4654.799652078655,258.5999806710363,0.2173308677970133,False
1559,f760356578836fd888a1cd825460d8daa8808ea6,/Users/sanika/Downloads/Master Thesis/repo_updated/pytest/testing/test_recwarn.py,989.0,ModificationType.MODIFY,386,256,301,16,9,68,402,4,59,35,69,63,104,355.07593991234864,621.6371120439914,2.3389830508474576,1453.9986688486576,80.77770382492542,0.20721237068133044,False
1560,f760356578836fd888a1cd825460d8daa8808ea6,/Users/sanika/Downloads/Master Thesis/repo_updated/pytest/src/_pytest/recwarn.py,989.0,ModificationType.MODIFY,264,131,164,11,41,46,275,6,38,22,40,44,62,214.93102051518318,338.48476035551244,3.1578947368421053,1068.899243227934,59.38329129044078,0.11282825345183747,False
1561,c7a83a0f316c8bebd42df636b8d5cccfe948a72c,/Users/sanika/Downloads/Master Thesis/repo_updated/pytest/testing/test_capture.py,4986.0,ModificationType.MODIFY,1513,682,1277,25,13,200,1538,11,199,116,219,210,335,1557.7420472931965,2584.272248418151,6.052763819095478,15641.989563917903,868.9994202176613,0.8614240828060503,False
1562,04d68fbc9e53ff01962ed5da8686ced276425c95,/Users/sanika/Downloads/Master Thesis/repo_updated/pytest/testing/code/test_code.py,5015.0,ModificationType.MODIFY,182,127,129,0,0,53,182,5,39,21,42,44,63,217.7403270100645,343.9441919741497,2.6923076923076925,926.003593776557,51.44464409869761,0.11464806399138325,False
1563,04d68fbc9e53ff01962ed5da8686ced276425c95,/Users/sanika/Downloads/Master Thesis/repo_updated/pytest/src/_pytest/_code/code.py,5015.0,ModificationType.MODIFY,1165,710,800,67,119,181,1232,18,243,153,282,261,435,2000.7880884021665,3492.1391085079,10.444444444444443,36473.45291108252,2026.302939504584,1.1640463695026333,False
1564,5bfe793fd5455c04049c4a564d1a6dc666cc647a,/Users/sanika/Downloads/Master Thesis/repo_updated/pytest/testing/code/test_excinfo.py,7106.0,ModificationType.MODIFY,1392,870,1177,35,17,170,1427,14,494,280,531,508,811,4473.796381311637,7289.823280972227,7.5242914979757085,54850.755334764704,3047.2641852647052,2.4299410936574084,False
1565,5bfe793fd5455c04049c4a564d1a6dc666cc647a,/Users/sanika/Downloads/Master Thesis/repo_updated/pytest/testing/code/test_source.py,2878.0,ModificationType.MODIFY,773,419,590,28,0,166,801,10,204,113,217,214,330,1598.3940507110583,2554.6841055123778,5.318627450980392,13587.413012161423,754.8562784534123,0.8515613685041261,False
1566,e3ac44df360849809d8d156bd24827025238072c,/Users/sanika/Downloads/Master Thesis/repo_updated/pytest/testing/test_compat.py,1383.0,ModificationType.MODIFY,207,111,150,11,0,50,218,5,26,19,36,31,55,133.82107314610522,272.4807970712782,3.4615384615384617,943.202759092886,52.400153282938106,0.09082693235709273,False
1567,e3ac44df360849809d8d156bd24827025238072c,/Users/sanika/Downloads/Master Thesis/repo_updated/pytest/src/_pytest/compat.py,1383.0,ModificationType.MODIFY,410,198,237,31,55,97,441,11,63,38,72,74,110,414.62238298550506,683.0398702191846,6.2857142857142865,4293.39346994916,238.52185944162002,0.2276799567397282,False
1568,e3ac44df360849809d8d156bd24827025238072c,/Users/sanika/Downloads/Master Thesis/repo_updated/pytest/testing/python/fixtures.py,6261.0,ModificationType.MODIFY,4293,999,3693,19,54,507,4312,9,155,88,170,164,258,1156.3286078304875,1898.2484171914662,4.935483870967742,9368.774446138525,520.4874692299181,0.6327494723971553,False
1569,e3ac44df360849809d8d156bd24827025238072c,/Users/sanika/Downloads/Master Thesis/repo_updated/pytest/src/_pytest/fixtures.py,6261.0,ModificationType.MODIFY,1482,859,1002,125,135,219,1607,16,219,134,251,235,385,1766.6783660526569,3032.459024427525,9.168949771689498,27804.46447968251,1544.692471093473,1.0108196748091751,False
1570,e3ac44df360849809d8d156bd24827025238072c,/Users/sanika/Downloads/Master Thesis/repo_updated/pytest/doc/en/example/multipython.py,6734.0,ModificationType.MODIFY,72,33,56,0,4,12,72,1,1,1,1,2,2,0.0,2.0,0.5,1.0,0.05555555555555555,0.0006666666666666666,False
1571,e3ac44df360849809d8d156bd24827025238072c,/Users/sanika/Downloads/Master Thesis/repo_updated/pytest/src/_pytest/python.py,6734.0,ModificationType.MODIFY,1454,835,1044,76,110,219,1530,17,275,158,296,292,454,2297.8910156145625,3718.1803497315277,9.149090909090908,34017.97003608918,1889.8872242271768,1.2393934499105097,False
1572,307add025b5464e87a55b49c6e5e4ce4c6373eee,/Users/sanika/Downloads/Master Thesis/repo_updated/pytest/testing/code/test_code.py,5010.0,ModificationType.MODIFY,182,127,129,0,0,53,182,5,39,21,42,44,63,217.7403270100645,343.9441919741497,2.6923076923076925,926.003593776557,51.44464409869761,0.11464806399138325,False
1573,307add025b5464e87a55b49c6e5e4ce4c6373eee,/Users/sanika/Downloads/Master Thesis/repo_updated/pytest/src/_pytest/_code/code.py,5010.0,ModificationType.MODIFY,1165,710,800,67,119,181,1232,18,243,153,282,261,435,2000.7880884021665,3492.1391085079,10.444444444444443,36473.45291108252,2026.302939504584,1.1640463695026333,False
1574,307add025b5464e87a55b49c6e5e4ce4c6373eee,/Users/sanika/Downloads/Master Thesis/repo_updated/pytest/testing/code/test_excinfo.py,6926.0,ModificationType.MODIFY,1392,870,1177,35,17,170,1427,14,494,280,531,508,811,4473.796381311637,7289.823280972227,7.5242914979757085,54850.755334764704,3047.2641852647052,2.4299410936574084,False
1575,a649f157de8bc16fb99152b2f64e407f1e842692,/Users/sanika/Downloads/Master Thesis/repo_updated/pytest/testing/code/test_source.py,1754.0,ModificationType.MODIFY,773,419,590,28,0,166,801,10,204,113,217,214,330,1598.3940507110583,2554.6841055123778,5.318627450980392,13587.413012161423,754.8562784534123,0.8515613685041261,False
1576,a649f157de8bc16fb99152b2f64e407f1e842692,/Users/sanika/Downloads/Master Thesis/repo_updated/pytest/src/_pytest/_code/source.py,1754.0,ModificationType.MODIFY,421,273,302,44,34,57,465,17,81,59,107,98,166,583.0147185349102,1098.0418341231248,11.228395061728396,12329.247507839285,684.9581948799603,0.36601394470770826,False
1577,562d4811d59e495bdfd3123a7f725d55462769ec,/Users/sanika/Downloads/Master Thesis/repo_updated/pytest/testing/test_compat.py,1495.0,ModificationType.MODIFY,207,111,150,11,0,50,218,5,26,19,36,31,55,133.82107314610522,272.4807970712782,3.4615384615384617,943.202759092886,52.400153282938106,0.09082693235709273,False
1578,562d4811d59e495bdfd3123a7f725d55462769ec,/Users/sanika/Downloads/Master Thesis/repo_updated/pytest/src/_pytest/compat.py,1495.0,ModificationType.MODIFY,410,198,237,31,55,97,441,11,63,38,72,74,110,414.62238298550506,683.0398702191846,6.2857142857142865,4293.39346994916,238.52185944162002,0.2276799567397282,False
1579,786d839db1e584e33f2f0543b6c16cdfeefe11ee,/Users/sanika/Downloads/Master Thesis/repo_updated/pytest/testing/test_cacheprovider.py,2063.0,ModificationType.MODIFY,996,429,845,24,10,117,1020,7,76,50,88,83,138,494.49397547611574,879.7554415258757,4.052631578947368,3565.324684078549,198.07359355991935,0.2932518138419585,False
1580,786d839db1e584e33f2f0543b6c16cdfeefe11ee,/Users/sanika/Downloads/Master Thesis/repo_updated/pytest/src/_pytest/cacheprovider.py,2063.0,ModificationType.MODIFY,456,277,329,12,42,72,468,13,85,50,97,98,147,592.903945907539,972.3623470849358,7.417647058823531,7212.640703965319,400.7022613314065,0.3241207823616453,False
1581,4b7148f9a4a48a41ebc745902d486efe23663dff,/Users/sanika/Downloads/Master Thesis/repo_updated/pytest/testing/test_cacheprovider.py,2063.0,ModificationType.MODIFY,996,429,845,24,10,117,1020,7,76,50,88,83,138,494.49397547611574,879.7554415258757,4.052631578947368,3565.324684078549,198.07359355991935,0.2932518138419585,False
1582,4b7148f9a4a48a41ebc745902d486efe23663dff,/Users/sanika/Downloads/Master Thesis/repo_updated/pytest/src/_pytest/cacheprovider.py,2063.0,ModificationType.MODIFY,456,277,329,12,42,72,468,13,85,50,97,98,147,592.903945907539,972.3623470849358,7.417647058823531,7212.640703965319,400.7022613314065,0.3241207823616453,False
1583,b1a597ab0292a1360a750f7df8cd9bf498e2cd72,/Users/sanika/Downloads/Master Thesis/repo_updated/pytest/testing/example_scripts/collect/package_infinite_recursion/__init__.pyi,5079.0,ModificationType.MODIFY,0,0,0,0,0,0,0,0,0,0,0,0,0,0.0,0.0,0.0,0.0,0.0,0.0,False
1584,b1a597ab0292a1360a750f7df8cd9bf498e2cd72,/Users/sanika/Downloads/Master Thesis/repo_updated/pytest/testing/example_scripts/collect/package_infinite_recursion/tests/__init__.py,5079.0,ModificationType.MODIFY,0,0,0,0,0,0,0,0,0,0,0,0,0,0.0,0.0,0.0,0.0,0.0,0.0,False
1585,b1a597ab0292a1360a750f7df8cd9bf498e2cd72,/Users/sanika/Downloads/Master Thesis/repo_updated/pytest/testing/example_scripts/collect/collect_init_tests/tests/__init__.py,5079.0,ModificationType.MODIFY,2,2,2,0,0,0,2,0,0,0,0,0,0,0.0,0.0,0.0,0.0,0.0,0.0,False
1586,b1a597ab0292a1360a750f7df8cd9bf498e2cd72,/Users/sanika/Downloads/Master Thesis/repo_updated/pytest/testing/example_scripts/collect/package_init_given_as_arg/pkg/__init__.py,5079.0,ModificationType.MODIFY,0,0,0,0,0,0,0,0,0,0,0,0,0,0.0,0.0,0.0,0.0,0.0,0.0,False
1587,b1a597ab0292a1360a750f7df8cd9bf498e2cd72,/Users/sanika/Downloads/Master Thesis/repo_updated/pytest/testing/example_scripts/conftest_usageerror/__init__.pyi,5079.0,ModificationType.MODIFY,0,0,0,0,0,0,0,0,0,0,0,0,0,0.0,0.0,0.0,0.0,0.0,0.0,False
1588,b1a597ab0292a1360a750f7df8cd9bf498e2cd72,/Users/sanika/Downloads/Master Thesis/repo_updated/pytest/testing/example_scripts/marks/marks_considered_keywords/__init__.pyi,5079.0,ModificationType.MODIFY,0,0,0,0,0,0,0,0,0,0,0,0,0,0.0,0.0,0.0,0.0,0.0,0.0,False
1589,b1a597ab0292a1360a750f7df8cd9bf498e2cd72,/Users/sanika/Downloads/Master Thesis/repo_updated/pytest/testing/example_scripts/config/collect_pytest_prefix/__init__.pyi,5079.0,ModificationType.MODIFY,0,0,0,0,0,0,0,0,0,0,0,0,0,0.0,0.0,0.0,0.0,0.0,0.0,False
1590,b1a597ab0292a1360a750f7df8cd9bf498e2cd72,/Users/sanika/Downloads/Master Thesis/repo_updated/pytest/testing/example_scripts/issue88_initial_file_multinodes/__init__.pyi,5079.0,ModificationType.MODIFY,0,0,0,0,0,0,0,0,0,0,0,0,0,0.0,0.0,0.0,0.0,0.0,0.0,False
1591,b1a597ab0292a1360a750f7df8cd9bf498e2cd72,/Users/sanika/Downloads/Master Thesis/repo_updated/pytest/testing/example_scripts/fixtures/fill_fixtures/test_extend_fixture_conftest_conftest/__init__.pyi,5079.0,ModificationType.MODIFY,0,0,0,0,0,0,0,0,0,0,0,0,0,0.0,0.0,0.0,0.0,0.0,0.0,False
1592,b1a597ab0292a1360a750f7df8cd9bf498e2cd72,/Users/sanika/Downloads/Master Thesis/repo_updated/pytest/testing/example_scripts/fixtures/fill_fixtures/test_extend_fixture_conftest_conftest/pkg/__init__.py,5079.0,ModificationType.MODIFY,0,0,0,0,0,0,0,0,0,0,0,0,0,0.0,0.0,0.0,0.0,0.0,0.0,False
1593,b1a597ab0292a1360a750f7df8cd9bf498e2cd72,/Users/sanika/Downloads/Master Thesis/repo_updated/pytest/testing/example_scripts/fixtures/fill_fixtures/test_extend_fixture_conftest_module/__init__.pyi,5079.0,ModificationType.MODIFY,0,0,0,0,0,0,0,0,0,0,0,0,0,0.0,0.0,0.0,0.0,0.0,0.0,False
1594,b1a597ab0292a1360a750f7df8cd9bf498e2cd72,/Users/sanika/Downloads/Master Thesis/repo_updated/pytest/testing/example_scripts/fixtures/fill_fixtures/test_conftest_funcargs_only_available_in_subdir/sub1/__init__.py,5079.0,ModificationType.MODIFY,0,0,0,0,0,0,0,0,0,0,0,0,0,0.0,0.0,0.0,0.0,0.0,0.0,False
1595,b1a597ab0292a1360a750f7df8cd9bf498e2cd72,/Users/sanika/Downloads/Master Thesis/repo_updated/pytest/testing/example_scripts/fixtures/fill_fixtures/test_conftest_funcargs_only_available_in_subdir/sub2/__init__.py,5079.0,ModificationType.MODIFY,0,0,0,0,0,0,0,0,0,0,0,0,0,0.0,0.0,0.0,0.0,0.0,0.0,False
1596,b1a597ab0292a1360a750f7df8cd9bf498e2cd72,/Users/sanika/Downloads/Master Thesis/repo_updated/pytest/testing/example_scripts/fixtures/custom_item/__init__.pyi,5079.0,ModificationType.MODIFY,0,0,0,0,0,0,0,0,0,0,0,0,0,0.0,0.0,0.0,0.0,0.0,0.0,False
1597,b1a597ab0292a1360a750f7df8cd9bf498e2cd72,/Users/sanika/Downloads/Master Thesis/repo_updated/pytest/testing/example_scripts/fixtures/custom_item/foo/__init__.py,5079.0,ModificationType.MODIFY,0,0,0,0,0,0,0,0,0,0,0,0,0,0.0,0.0,0.0,0.0,0.0,0.0,False
1598,b1a597ab0292a1360a750f7df8cd9bf498e2cd72,/Users/sanika/Downloads/Master Thesis/repo_updated/pytest/doc/en/example/nonpython/__init__.py,5079.0,ModificationType.MODIFY,0,0,0,0,0,0,0,0,0,0,0,0,0,0.0,0.0,0.0,0.0,0.0,0.0,False
1599,b1a597ab0292a1360a750f7df8cd9bf498e2cd72,/Users/sanika/Downloads/Master Thesis/repo_updated/pytest/src/pytest/__init__.py,5079.0,ModificationType.MODIFY,99,48,90,1,3,5,100,0,0,0,0,0,0,0.0,0.0,0.0,0.0,0.0,0.0,False
1600,b1a597ab0292a1360a750f7df8cd9bf498e2cd72,/Users/sanika/Downloads/Master Thesis/repo_updated/pytest/src/_pytest/__init__.py,5079.0,ModificationType.MODIFY,8,5,5,2,0,1,10,0,0,0,0,0,0,0.0,0.0,0.0,0.0,0.0,0.0,False
1601,b1a597ab0292a1360a750f7df8cd9bf498e2cd72,/Users/sanika/Downloads/Master Thesis/repo_updated/pytest/src/_pytest/config/__init__.py,5079.0,ModificationType.MODIFY,1217,716,841,84,126,174,1301,14,185,118,215,199,333,1446.608539104324,2542.995998641035,8.135135135135135,20687.616097052745,1149.3120053918194,0.847665332880345,False
1602,b1a597ab0292a1360a750f7df8cd9bf498e2cd72,/Users/sanika/Downloads/Master Thesis/repo_updated/pytest/src/_pytest/mark/__init__.py,5079.0,ModificationType.MODIFY,160,89,115,0,13,31,160,7,15,11,17,22,28,78.25484338853101,124.86408532184431,3.966666666666667,495.29420510998256,27.516344728332356,0.04162136177394811,False
1603,b1a597ab0292a1360a750f7df8cd9bf498e2cd72,/Users/sanika/Downloads/Master Thesis/repo_updated/pytest/src/_pytest/_code/__init__.py,5079.0,ModificationType.MODIFY,10,10,9,9,0,0,19,0,0,0,0,0,0,0.0,0.0,0.0,0.0,0.0,0.0,False
1604,b1a597ab0292a1360a750f7df8cd9bf498e2cd72,/Users/sanika/Downloads/Master Thesis/repo_updated/pytest/src/_pytest/assertion/__init__.py,5079.0,ModificationType.MODIFY,173,84,99,8,29,36,181,5,12,7,13,17,20,54.62919048309069,81.7492568250068,2.708333333333333,221.40423723439343,12.300235401910744,0.027249752275002263,False
1605,b1a597ab0292a1360a750f7df8cd9bf498e2cd72,/Users/sanika/Downloads/Master Thesis/repo_updated/pytest/src/_pytest/_io/__init__.py,5079.0,ModificationType.MODIFY,3,1,1,3,0,0,6,0,0,0,0,0,0,0.0,0.0,0.0,0.0,0.0,0.0,False
1606,54a954514b5a02b4858707ef653a1a204cd05509,/Users/sanika/Downloads/Master Thesis/repo_updated/pytest/src/_pytest/config/argparsing.py,2328.0,ModificationType.MODIFY,463,295,324,28,62,57,491,12,134,82,154,146,236,989.8755015299953,1696.7985958956842,6.8955223880597005,11700.312706026956,650.0173725570531,0.565599531965228,False
1607,54a954514b5a02b4858707ef653a1a204cd05509,/Users/sanika/Downloads/Master Thesis/repo_updated/pytest/testing/test_pytester.py,6346.0,ModificationType.MODIFY,722,423,573,19,0,135,741,12,172,101,199,184,300,1320.3370878174146,2257.068586817104,6.941860465116278,15668.255189881524,870.4586216600846,0.7523561956057013,False
1608,54a954514b5a02b4858707ef653a1a204cd05509,/Users/sanika/Downloads/Master Thesis/repo_updated/pytest/src/_pytest/pytester.py,6346.0,ModificationType.MODIFY,1508,847,911,44,250,301,1552,14,148,88,169,162,257,1120.302067021891,1886.3414507413486,7.993243243243242,15077.986055587939,837.6658919771077,0.6287804835804495,False
1609,54a954514b5a02b4858707ef653a1a204cd05509,/Users/sanika/Downloads/Master Thesis/repo_updated/pytest/testing/python/fixtures.py,8005.0,ModificationType.MODIFY,4293,999,3693,19,54,507,4312,9,155,88,170,164,258,1156.3286078304875,1898.2484171914662,4.935483870967742,9368.774446138525,520.4874692299181,0.6327494723971553,False
1610,54a954514b5a02b4858707ef653a1a204cd05509,/Users/sanika/Downloads/Master Thesis/repo_updated/pytest/src/_pytest/fixtures.py,8005.0,ModificationType.MODIFY,1482,859,1002,125,135,219,1607,16,219,134,251,235,385,1766.6783660526569,3032.459024427525,9.168949771689498,27804.46447968251,1544.692471093473,1.0108196748091751,False
1611,54a954514b5a02b4858707ef653a1a204cd05509,/Users/sanika/Downloads/Master Thesis/repo_updated/pytest/testing/python/raises.py,921.0,ModificationType.MODIFY,256,139,192,9,7,47,265,4,23,12,24,27,36,112.0419249893113,171.1759500778849,2.0869565217391304,357.2367653799337,19.846486965551872,0.057058650025961624,False
1612,54a954514b5a02b4858707ef653a1a204cd05509,/Users/sanika/Downloads/Master Thesis/repo_updated/pytest/testing/test_collection.py,4954.0,ModificationType.MODIFY,1296,573,1062,40,33,157,1336,8,201,118,231,209,349,1561.8613899269644,2689.868337096228,4.597014925373134,12365.364892919973,686.9647162733319,0.896622779032076,False
1613,54a954514b5a02b4858707ef653a1a204cd05509,/Users/sanika/Downloads/Master Thesis/repo_updated/pytest/testing/test_mark.py,3199.0,ModificationType.MODIFY,1020,354,843,12,15,144,1032,8,134,77,144,142,221,970.8559515213416,1580.0941134105346,4.298507462686567,6792.0463382422995,377.3359076801278,0.5266980378035117,False
1614,54a954514b5a02b4858707ef653a1a204cd05509,/Users/sanika/Downloads/Master Thesis/repo_updated/pytest/testing/test_skipping.py,3073.0,ModificationType.MODIFY,1178,367,1042,6,15,115,1184,9,94,51,95,103,146,644.6606770706788,976.22907696875,4.547872340425532,4439.7652170653255,246.65362317029587,0.3254096923229167,False
1615,54a954514b5a02b4858707ef653a1a204cd05509,/Users/sanika/Downloads/Master Thesis/repo_updated/pytest/testing/test_tmpdir.py,1861.0,ModificationType.MODIFY,442,244,305,14,16,103,456,11,68,45,75,79,120,452.00122101003336,756.4536897812525,6.066176470588236,4588.781574040686,254.932309668927,0.2521512299270841,False
1616,54a954514b5a02b4858707ef653a1a204cd05509,/Users/sanika/Downloads/Master Thesis/repo_updated/pytest/testing/test_unittest.py,2042.0,ModificationType.MODIFY,1098,241,925,5,10,155,1103,7,46,25,49,53,74,273.7353344330258,423.86611363767685,3.728260869565217,1580.283445410034,87.79352474500189,0.14128870454589226,False
1617,e3796047c1b09f58d14ee60d669b1258479d3c76,/Users/sanika/Downloads/Master Thesis/repo_updated/pytest/testing/example_scripts/collect/package_infinite_recursion/__init__.pyi,5079.0,ModificationType.MODIFY,0,0,0,0,0,0,0,0,0,0,0,0,0,0.0,0.0,0.0,0.0,0.0,0.0,False
1618,e3796047c1b09f58d14ee60d669b1258479d3c76,/Users/sanika/Downloads/Master Thesis/repo_updated/pytest/testing/example_scripts/collect/package_infinite_recursion/tests/__init__.py,5079.0,ModificationType.MODIFY,0,0,0,0,0,0,0,0,0,0,0,0,0,0.0,0.0,0.0,0.0,0.0,0.0,False
1619,e3796047c1b09f58d14ee60d669b1258479d3c76,/Users/sanika/Downloads/Master Thesis/repo_updated/pytest/testing/example_scripts/collect/collect_init_tests/tests/__init__.py,5079.0,ModificationType.MODIFY,2,2,2,0,0,0,2,0,0,0,0,0,0,0.0,0.0,0.0,0.0,0.0,0.0,False
1620,e3796047c1b09f58d14ee60d669b1258479d3c76,/Users/sanika/Downloads/Master Thesis/repo_updated/pytest/testing/example_scripts/collect/package_init_given_as_arg/pkg/__init__.py,5079.0,ModificationType.MODIFY,0,0,0,0,0,0,0,0,0,0,0,0,0,0.0,0.0,0.0,0.0,0.0,0.0,False
1621,e3796047c1b09f58d14ee60d669b1258479d3c76,/Users/sanika/Downloads/Master Thesis/repo_updated/pytest/testing/example_scripts/conftest_usageerror/__init__.pyi,5079.0,ModificationType.MODIFY,0,0,0,0,0,0,0,0,0,0,0,0,0,0.0,0.0,0.0,0.0,0.0,0.0,False
1622,e3796047c1b09f58d14ee60d669b1258479d3c76,/Users/sanika/Downloads/Master Thesis/repo_updated/pytest/testing/example_scripts/marks/marks_considered_keywords/__init__.pyi,5079.0,ModificationType.MODIFY,0,0,0,0,0,0,0,0,0,0,0,0,0,0.0,0.0,0.0,0.0,0.0,0.0,False
1623,e3796047c1b09f58d14ee60d669b1258479d3c76,/Users/sanika/Downloads/Master Thesis/repo_updated/pytest/testing/example_scripts/config/collect_pytest_prefix/__init__.pyi,5079.0,ModificationType.MODIFY,0,0,0,0,0,0,0,0,0,0,0,0,0,0.0,0.0,0.0,0.0,0.0,0.0,False
1624,e3796047c1b09f58d14ee60d669b1258479d3c76,/Users/sanika/Downloads/Master Thesis/repo_updated/pytest/testing/example_scripts/issue88_initial_file_multinodes/__init__.pyi,5079.0,ModificationType.MODIFY,0,0,0,0,0,0,0,0,0,0,0,0,0,0.0,0.0,0.0,0.0,0.0,0.0,False
1625,e3796047c1b09f58d14ee60d669b1258479d3c76,/Users/sanika/Downloads/Master Thesis/repo_updated/pytest/testing/example_scripts/fixtures/fill_fixtures/test_extend_fixture_conftest_conftest/__init__.pyi,5079.0,ModificationType.MODIFY,0,0,0,0,0,0,0,0,0,0,0,0,0,0.0,0.0,0.0,0.0,0.0,0.0,False
1626,e3796047c1b09f58d14ee60d669b1258479d3c76,/Users/sanika/Downloads/Master Thesis/repo_updated/pytest/testing/example_scripts/fixtures/fill_fixtures/test_extend_fixture_conftest_conftest/pkg/__init__.py,5079.0,ModificationType.MODIFY,0,0,0,0,0,0,0,0,0,0,0,0,0,0.0,0.0,0.0,0.0,0.0,0.0,False
1627,e3796047c1b09f58d14ee60d669b1258479d3c76,/Users/sanika/Downloads/Master Thesis/repo_updated/pytest/testing/example_scripts/fixtures/fill_fixtures/test_extend_fixture_conftest_module/__init__.pyi,5079.0,ModificationType.MODIFY,0,0,0,0,0,0,0,0,0,0,0,0,0,0.0,0.0,0.0,0.0,0.0,0.0,False
1628,e3796047c1b09f58d14ee60d669b1258479d3c76,/Users/sanika/Downloads/Master Thesis/repo_updated/pytest/testing/example_scripts/fixtures/fill_fixtures/test_conftest_funcargs_only_available_in_subdir/sub1/__init__.py,5079.0,ModificationType.MODIFY,0,0,0,0,0,0,0,0,0,0,0,0,0,0.0,0.0,0.0,0.0,0.0,0.0,False
1629,e3796047c1b09f58d14ee60d669b1258479d3c76,/Users/sanika/Downloads/Master Thesis/repo_updated/pytest/testing/example_scripts/fixtures/fill_fixtures/test_conftest_funcargs_only_available_in_subdir/sub2/__init__.py,5079.0,ModificationType.MODIFY,0,0,0,0,0,0,0,0,0,0,0,0,0,0.0,0.0,0.0,0.0,0.0,0.0,False
1630,e3796047c1b09f58d14ee60d669b1258479d3c76,/Users/sanika/Downloads/Master Thesis/repo_updated/pytest/testing/example_scripts/fixtures/custom_item/__init__.pyi,5079.0,ModificationType.MODIFY,0,0,0,0,0,0,0,0,0,0,0,0,0,0.0,0.0,0.0,0.0,0.0,0.0,False
1631,e3796047c1b09f58d14ee60d669b1258479d3c76,/Users/sanika/Downloads/Master Thesis/repo_updated/pytest/testing/example_scripts/fixtures/custom_item/foo/__init__.py,5079.0,ModificationType.MODIFY,0,0,0,0,0,0,0,0,0,0,0,0,0,0.0,0.0,0.0,0.0,0.0,0.0,False
1632,e3796047c1b09f58d14ee60d669b1258479d3c76,/Users/sanika/Downloads/Master Thesis/repo_updated/pytest/doc/en/example/nonpython/__init__.py,5079.0,ModificationType.MODIFY,0,0,0,0,0,0,0,0,0,0,0,0,0,0.0,0.0,0.0,0.0,0.0,0.0,False
1633,e3796047c1b09f58d14ee60d669b1258479d3c76,/Users/sanika/Downloads/Master Thesis/repo_updated/pytest/src/pytest/__init__.py,5079.0,ModificationType.MODIFY,99,48,90,1,3,5,100,0,0,0,0,0,0,0.0,0.0,0.0,0.0,0.0,0.0,False
1634,e3796047c1b09f58d14ee60d669b1258479d3c76,/Users/sanika/Downloads/Master Thesis/repo_updated/pytest/src/_pytest/__init__.py,5079.0,ModificationType.MODIFY,8,5,5,2,0,1,10,0,0,0,0,0,0,0.0,0.0,0.0,0.0,0.0,0.0,False
1635,e3796047c1b09f58d14ee60d669b1258479d3c76,/Users/sanika/Downloads/Master Thesis/repo_updated/pytest/src/_pytest/config/__init__.py,5079.0,ModificationType.MODIFY,1217,716,841,84,126,174,1301,14,185,118,215,199,333,1446.608539104324,2542.995998641035,8.135135135135135,20687.616097052745,1149.3120053918194,0.847665332880345,False
1636,e3796047c1b09f58d14ee60d669b1258479d3c76,/Users/sanika/Downloads/Master Thesis/repo_updated/pytest/src/_pytest/mark/__init__.py,5079.0,ModificationType.MODIFY,160,89,115,0,13,31,160,7,15,11,17,22,28,78.25484338853101,124.86408532184431,3.966666666666667,495.29420510998256,27.516344728332356,0.04162136177394811,False
1637,e3796047c1b09f58d14ee60d669b1258479d3c76,/Users/sanika/Downloads/Master Thesis/repo_updated/pytest/src/_pytest/_code/__init__.py,5079.0,ModificationType.MODIFY,10,10,9,9,0,0,19,0,0,0,0,0,0,0.0,0.0,0.0,0.0,0.0,0.0,False
1638,e3796047c1b09f58d14ee60d669b1258479d3c76,/Users/sanika/Downloads/Master Thesis/repo_updated/pytest/src/_pytest/assertion/__init__.py,5079.0,ModificationType.MODIFY,173,84,99,8,29,36,181,5,12,7,13,17,20,54.62919048309069,81.7492568250068,2.708333333333333,221.40423723439343,12.300235401910744,0.027249752275002263,False
1639,e3796047c1b09f58d14ee60d669b1258479d3c76,/Users/sanika/Downloads/Master Thesis/repo_updated/pytest/src/_pytest/_io/__init__.py,5079.0,ModificationType.MODIFY,3,1,1,3,0,0,6,0,0,0,0,0,0,0.0,0.0,0.0,0.0,0.0,0.0,False
1640,e3796047c1b09f58d14ee60d669b1258479d3c76,/Users/sanika/Downloads/Master Thesis/repo_updated/pytest/src/_pytest/config/argparsing.py,2328.0,ModificationType.MODIFY,463,295,324,28,62,57,491,12,134,82,154,146,236,989.8755015299953,1696.7985958956842,6.8955223880597005,11700.312706026956,650.0173725570531,0.565599531965228,False
1641,e3796047c1b09f58d14ee60d669b1258479d3c76,/Users/sanika/Downloads/Master Thesis/repo_updated/pytest/testing/test_pytester.py,6346.0,ModificationType.MODIFY,722,423,573,19,0,135,741,12,172,101,199,184,300,1320.3370878174146,2257.068586817104,6.941860465116278,15668.255189881524,870.4586216600846,0.7523561956057013,False
1642,e3796047c1b09f58d14ee60d669b1258479d3c76,/Users/sanika/Downloads/Master Thesis/repo_updated/pytest/src/_pytest/pytester.py,6346.0,ModificationType.MODIFY,1508,847,911,44,250,301,1552,14,148,88,169,162,257,1120.302067021891,1886.3414507413486,7.993243243243242,15077.986055587939,837.6658919771077,0.6287804835804495,False
1643,e3796047c1b09f58d14ee60d669b1258479d3c76,/Users/sanika/Downloads/Master Thesis/repo_updated/pytest/testing/python/fixtures.py,8005.0,ModificationType.MODIFY,4293,999,3693,19,54,507,4312,9,155,88,170,164,258,1156.3286078304875,1898.2484171914662,4.935483870967742,9368.774446138525,520.4874692299181,0.6327494723971553,False
1644,e3796047c1b09f58d14ee60d669b1258479d3c76,/Users/sanika/Downloads/Master Thesis/repo_updated/pytest/src/_pytest/fixtures.py,8005.0,ModificationType.MODIFY,1482,859,1002,125,135,219,1607,16,219,134,251,235,385,1766.6783660526569,3032.459024427525,9.168949771689498,27804.46447968251,1544.692471093473,1.0108196748091751,False
1645,e3796047c1b09f58d14ee60d669b1258479d3c76,/Users/sanika/Downloads/Master Thesis/repo_updated/pytest/testing/python/raises.py,921.0,ModificationType.MODIFY,256,139,192,9,7,47,265,4,23,12,24,27,36,112.0419249893113,171.1759500778849,2.0869565217391304,357.2367653799337,19.846486965551872,0.057058650025961624,False
1646,e3796047c1b09f58d14ee60d669b1258479d3c76,/Users/sanika/Downloads/Master Thesis/repo_updated/pytest/testing/test_collection.py,4954.0,ModificationType.MODIFY,1296,573,1062,40,33,157,1336,8,201,118,231,209,349,1561.8613899269644,2689.868337096228,4.597014925373134,12365.364892919973,686.9647162733319,0.896622779032076,False
1647,e3796047c1b09f58d14ee60d669b1258479d3c76,/Users/sanika/Downloads/Master Thesis/repo_updated/pytest/testing/test_mark.py,3199.0,ModificationType.MODIFY,1020,354,843,12,15,144,1032,8,134,77,144,142,221,970.8559515213416,1580.0941134105346,4.298507462686567,6792.0463382422995,377.3359076801278,0.5266980378035117,False
1648,e3796047c1b09f58d14ee60d669b1258479d3c76,/Users/sanika/Downloads/Master Thesis/repo_updated/pytest/testing/test_skipping.py,3073.0,ModificationType.MODIFY,1178,367,1042,6,15,115,1184,9,94,51,95,103,146,644.6606770706788,976.22907696875,4.547872340425532,4439.7652170653255,246.65362317029587,0.3254096923229167,False
1649,e3796047c1b09f58d14ee60d669b1258479d3c76,/Users/sanika/Downloads/Master Thesis/repo_updated/pytest/testing/test_tmpdir.py,1861.0,ModificationType.MODIFY,442,244,305,14,16,103,456,11,68,45,75,79,120,452.00122101003336,756.4536897812525,6.066176470588236,4588.781574040686,254.932309668927,0.2521512299270841,False
1650,e3796047c1b09f58d14ee60d669b1258479d3c76,/Users/sanika/Downloads/Master Thesis/repo_updated/pytest/testing/test_unittest.py,2042.0,ModificationType.MODIFY,1098,241,925,5,10,155,1103,7,46,25,49,53,74,273.7353344330258,423.86611363767685,3.728260869565217,1580.283445410034,87.79352474500189,0.14128870454589226,False
1651,eaa34a9df0fa341c1b21bd3b232928812e6e8a06,/Users/sanika/Downloads/Master Thesis/repo_updated/pytest/testing/code/test_code.py,5483.0,ModificationType.MODIFY,182,127,129,0,0,53,182,5,39,21,42,44,63,217.7403270100645,343.9441919741497,2.6923076923076925,926.003593776557,51.44464409869761,0.11464806399138325,False
1652,eaa34a9df0fa341c1b21bd3b232928812e6e8a06,/Users/sanika/Downloads/Master Thesis/repo_updated/pytest/src/_pytest/_code/code.py,5483.0,ModificationType.MODIFY,1165,710,800,67,119,181,1232,18,243,153,282,261,435,2000.7880884021665,3492.1391085079,10.444444444444443,36473.45291108252,2026.302939504584,1.1640463695026333,False
1653,eaa34a9df0fa341c1b21bd3b232928812e6e8a06,/Users/sanika/Downloads/Master Thesis/repo_updated/pytest/testing/code/test_code.py,1010.0,ModificationType.MODIFY,182,127,129,0,0,53,182,5,39,21,42,44,63,217.7403270100645,343.9441919741497,2.6923076923076925,926.003593776557,51.44464409869761,0.11464806399138325,False
1654,eaa34a9df0fa341c1b21bd3b232928812e6e8a06,/Users/sanika/Downloads/Master Thesis/repo_updated/pytest/testing/code/test_excinfo.py,6943.0,ModificationType.MODIFY,1392,870,1177,35,17,170,1427,14,494,280,531,508,811,4473.796381311637,7289.823280972227,7.5242914979757085,54850.755334764704,3047.2641852647052,2.4299410936574084,False
1655,eaa34a9df0fa341c1b21bd3b232928812e6e8a06,/Users/sanika/Downloads/Master Thesis/repo_updated/pytest/testing/code/test_source.py,3088.0,ModificationType.MODIFY,773,419,590,28,0,166,801,10,204,113,217,214,330,1598.3940507110583,2554.6841055123778,5.318627450980392,13587.413012161423,754.8562784534123,0.8515613685041261,False
1656,1b4623a6d16a17d228deda23d4242d944dff2397,/Users/sanika/Downloads/Master Thesis/repo_updated/pytest/testing/test_cacheprovider.py,3863.0,ModificationType.MODIFY,996,429,845,24,10,117,1020,7,76,50,88,83,138,494.49397547611574,879.7554415258757,4.052631578947368,3565.324684078549,198.07359355991935,0.2932518138419585,False
1657,b9a3ba1fe8a02b5093ad72785ab5d908e18e228c,/Users/sanika/Downloads/Master Thesis/repo_updated/pytest/testing/test_cacheprovider.py,3873.0,ModificationType.MODIFY,996,429,845,24,10,117,1020,7,76,50,88,83,138,494.49397547611574,879.7554415258757,4.052631578947368,3565.324684078549,198.07359355991935,0.2932518138419585,False
1658,fa578d7329593ceb9405189aac1de23b6354c2dd,/Users/sanika/Downloads/Master Thesis/repo_updated/pytest/testing/code/test_code.py,5483.0,ModificationType.MODIFY,182,127,129,0,0,53,182,5,39,21,42,44,63,217.7403270100645,343.9441919741497,2.6923076923076925,926.003593776557,51.44464409869761,0.11464806399138325,False
1659,fa578d7329593ceb9405189aac1de23b6354c2dd,/Users/sanika/Downloads/Master Thesis/repo_updated/pytest/src/_pytest/_code/code.py,5483.0,ModificationType.MODIFY,1165,710,800,67,119,181,1232,18,243,153,282,261,435,2000.7880884021665,3492.1391085079,10.444444444444443,36473.45291108252,2026.302939504584,1.1640463695026333,False
1660,fa578d7329593ceb9405189aac1de23b6354c2dd,/Users/sanika/Downloads/Master Thesis/repo_updated/pytest/testing/code/test_source.py,1754.0,ModificationType.MODIFY,773,419,590,28,0,166,801,10,204,113,217,214,330,1598.3940507110583,2554.6841055123778,5.318627450980392,13587.413012161423,754.8562784534123,0.8515613685041261,False
1661,fa578d7329593ceb9405189aac1de23b6354c2dd,/Users/sanika/Downloads/Master Thesis/repo_updated/pytest/src/_pytest/_code/source.py,1754.0,ModificationType.MODIFY,421,273,302,44,34,57,465,17,81,59,107,98,166,583.0147185349102,1098.0418341231248,11.228395061728396,12329.247507839285,684.9581948799603,0.36601394470770826,False
1662,fa578d7329593ceb9405189aac1de23b6354c2dd,/Users/sanika/Downloads/Master Thesis/repo_updated/pytest/testing/test_assertrewrite.py,5619.0,ModificationType.MODIFY,1660,832,1314,41,38,274,1701,20,312,209,395,332,604,2671.484054182769,5058.523816533542,12.660256410256409,64042.208574703494,3557.900476372417,1.6861746055111808,False
1663,fa578d7329593ceb9405189aac1de23b6354c2dd,/Users/sanika/Downloads/Master Thesis/repo_updated/pytest/src/_pytest/assertion/rewrite.py,5619.0,ModificationType.MODIFY,1057,646,719,113,100,145,1170,18,215,134,248,233,382,1740.9201126876956,3004.119107257935,10.381395348837211,31186.94812744052,1732.608229302251,1.001373035752645,False
1664,fa578d7329593ceb9405189aac1de23b6354c2dd,/Users/sanika/Downloads/Master Thesis/repo_updated/pytest/testing/test_compat.py,1495.0,ModificationType.MODIFY,207,111,150,11,0,50,218,5,26,19,36,31,55,133.82107314610522,272.4807970712782,3.4615384615384617,943.202759092886,52.400153282938106,0.09082693235709273,False
1665,fa578d7329593ceb9405189aac1de23b6354c2dd,/Users/sanika/Downloads/Master Thesis/repo_updated/pytest/src/_pytest/compat.py,1495.0,ModificationType.MODIFY,410,198,237,31,55,97,441,11,63,38,72,74,110,414.62238298550506,683.0398702191846,6.2857142857142865,4293.39346994916,238.52185944162002,0.2276799567397282,False
1666,fa578d7329593ceb9405189aac1de23b6354c2dd,/Users/sanika/Downloads/Master Thesis/repo_updated/pytest/testing/python/fixtures.py,6261.0,ModificationType.MODIFY,4293,999,3693,19,54,507,4312,9,155,88,170,164,258,1156.3286078304875,1898.2484171914662,4.935483870967742,9368.774446138525,520.4874692299181,0.6327494723971553,False
1667,fa578d7329593ceb9405189aac1de23b6354c2dd,/Users/sanika/Downloads/Master Thesis/repo_updated/pytest/src/_pytest/fixtures.py,6261.0,ModificationType.MODIFY,1482,859,1002,125,135,219,1607,16,219,134,251,235,385,1766.6783660526569,3032.459024427525,9.168949771689498,27804.46447968251,1544.692471093473,1.0108196748091751,False
1668,fa578d7329593ceb9405189aac1de23b6354c2dd,/Users/sanika/Downloads/Master Thesis/repo_updated/pytest/doc/en/example/multipython.py,6734.0,ModificationType.MODIFY,72,33,56,0,4,12,72,1,1,1,1,2,2,0.0,2.0,0.5,1.0,0.05555555555555555,0.0006666666666666666,False
1669,fa578d7329593ceb9405189aac1de23b6354c2dd,/Users/sanika/Downloads/Master Thesis/repo_updated/pytest/src/_pytest/python.py,6734.0,ModificationType.MODIFY,1454,835,1044,76,110,219,1530,17,275,158,296,292,454,2297.8910156145625,3718.1803497315277,9.149090909090908,34017.97003608918,1889.8872242271768,1.2393934499105097,False
1670,fa578d7329593ceb9405189aac1de23b6354c2dd,/Users/sanika/Downloads/Master Thesis/repo_updated/pytest/src/_pytest/python_api.py,1970.0,ModificationType.MODIFY,757,253,292,73,244,162,830,13,61,38,67,74,105,409.88069392717034,651.9926033910399,7.139344262295082,4654.799652078655,258.5999806710363,0.2173308677970133,False
1671,fa578d7329593ceb9405189aac1de23b6354c2dd,/Users/sanika/Downloads/Master Thesis/repo_updated/pytest/testing/test_recwarn.py,989.0,ModificationType.MODIFY,386,256,301,16,9,68,402,4,59,35,69,63,104,355.07593991234864,621.6371120439914,2.3389830508474576,1453.9986688486576,80.77770382492542,0.20721237068133044,False
1672,fa578d7329593ceb9405189aac1de23b6354c2dd,/Users/sanika/Downloads/Master Thesis/repo_updated/pytest/src/_pytest/recwarn.py,989.0,ModificationType.MODIFY,264,131,164,11,41,46,275,6,38,22,40,44,62,214.93102051518318,338.48476035551244,3.1578947368421053,1068.899243227934,59.38329129044078,0.11282825345183747,False
1673,fa578d7329593ceb9405189aac1de23b6354c2dd,/Users/sanika/Downloads/Master Thesis/repo_updated/pytest/testing/code/test_code.py,1010.0,ModificationType.MODIFY,182,127,129,0,0,53,182,5,39,21,42,44,63,217.7403270100645,343.9441919741497,2.6923076923076925,926.003593776557,51.44464409869761,0.11464806399138325,False
1674,fa578d7329593ceb9405189aac1de23b6354c2dd,/Users/sanika/Downloads/Master Thesis/repo_updated/pytest/testing/code/test_excinfo.py,6943.0,ModificationType.MODIFY,1392,870,1177,35,17,170,1427,14,494,280,531,508,811,4473.796381311637,7289.823280972227,7.5242914979757085,54850.755334764704,3047.2641852647052,2.4299410936574084,False
1675,fa578d7329593ceb9405189aac1de23b6354c2dd,/Users/sanika/Downloads/Master Thesis/repo_updated/pytest/testing/code/test_source.py,3088.0,ModificationType.MODIFY,773,419,590,28,0,166,801,10,204,113,217,214,330,1598.3940507110583,2554.6841055123778,5.318627450980392,13587.413012161423,754.8562784534123,0.8515613685041261,False
1676,fa578d7329593ceb9405189aac1de23b6354c2dd,/Users/sanika/Downloads/Master Thesis/repo_updated/pytest/testing/test_capture.py,4986.0,ModificationType.MODIFY,1513,682,1277,25,13,200,1538,11,199,116,219,210,335,1557.7420472931965,2584.272248418151,6.052763819095478,15641.989563917903,868.9994202176613,0.8614240828060503,False
1677,bac6eebfff8f1cd21736dbf0d367bf4ca97da0d9,/Users/sanika/Downloads/Master Thesis/repo_updated/pytest/testing/test_cacheprovider.py,3873.0,ModificationType.MODIFY,996,429,845,24,10,117,1020,7,76,50,88,83,138,494.49397547611574,879.7554415258757,4.052631578947368,3565.324684078549,198.07359355991935,0.2932518138419585,False
1678,a2d48332fc767b06d024c7988a7a29d221d83ec4,/Users/sanika/Downloads/Master Thesis/repo_updated/pytest/doc/en/example/multipython.py,6748.0,ModificationType.MODIFY,72,33,56,0,4,12,72,1,1,1,1,2,2,0.0,2.0,0.5,1.0,0.05555555555555555,0.0006666666666666666,False
1679,a2d48332fc767b06d024c7988a7a29d221d83ec4,/Users/sanika/Downloads/Master Thesis/repo_updated/pytest/src/_pytest/python.py,6748.0,ModificationType.MODIFY,1454,835,1044,76,110,219,1530,17,275,158,296,292,454,2297.8910156145625,3718.1803497315277,9.149090909090908,34017.97003608918,1889.8872242271768,1.2393934499105097,False
1680,a2d48332fc767b06d024c7988a7a29d221d83ec4,/Users/sanika/Downloads/Master Thesis/repo_updated/pytest/testing/python/metafunc.py,5913.0,ModificationType.MODIFY,1782,648,1425,9,47,279,1791,8,171,97,189,179,286,1292.4527800454887,2140.3713122975773,4.421052631578949,9462.69422278929,525.705234599405,0.7134571040991925,False
1681,a2d48332fc767b06d024c7988a7a29d221d83ec4,/Users/sanika/Downloads/Master Thesis/repo_updated/pytest/testing/test_collection.py,5042.0,ModificationType.MODIFY,1296,573,1062,40,33,157,1336,8,201,118,231,209,349,1561.8613899269644,2689.868337096228,4.597014925373134,12365.364892919973,686.9647162733319,0.896622779032076,False
1682,9e759010d9e9bf6ff10766c54f37bdb6ce1266c2,/Users/sanika/Downloads/Master Thesis/repo_updated/pytest/testing/test_setupplan.py,119.0,ModificationType.MODIFY,110,30,77,3,13,16,113,4,21,15,30,25,45,100.23866587835396,208.9735285398626,2.8571428571428568,597.0672243996074,33.17040135553375,0.06965784284662087,False
1683,9e759010d9e9bf6ff10766c54f37bdb6ce1266c2,/Users/sanika/Downloads/Master Thesis/repo_updated/pytest/src/_pytest/setupplan.py,119.0,ModificationType.MODIFY,28,15,21,1,0,6,29,0,0,0,0,0,0,0.0,0.0,0.0,0.0,0.0,0.0,False
1684,f3a10245d0cfbad21c8c49d1ce7227afbcb0d716,/Users/sanika/Downloads/Master Thesis/repo_updated/pytest/doc/en/example/multipython.py,6741.0,ModificationType.MODIFY,72,33,56,0,4,12,72,1,1,1,1,2,2,0.0,2.0,0.5,1.0,0.05555555555555555,0.0006666666666666666,False
1685,f3a10245d0cfbad21c8c49d1ce7227afbcb0d716,/Users/sanika/Downloads/Master Thesis/repo_updated/pytest/src/_pytest/python.py,6741.0,ModificationType.MODIFY,1454,835,1044,76,110,219,1530,17,275,158,296,292,454,2297.8910156145625,3718.1803497315277,9.149090909090908,34017.97003608918,1889.8872242271768,1.2393934499105097,False
1686,91dec8e2bf5e4e9c43b040a8b2f286c8275f8141,/Users/sanika/Downloads/Master Thesis/repo_updated/pytest/doc/en/example/multipython.py,6756.0,ModificationType.MODIFY,72,33,56,0,4,12,72,1,1,1,1,2,2,0.0,2.0,0.5,1.0,0.05555555555555555,0.0006666666666666666,False
1687,91dec8e2bf5e4e9c43b040a8b2f286c8275f8141,/Users/sanika/Downloads/Master Thesis/repo_updated/pytest/src/_pytest/python.py,6756.0,ModificationType.MODIFY,1454,835,1044,76,110,219,1530,17,275,158,296,292,454,2297.8910156145625,3718.1803497315277,9.149090909090908,34017.97003608918,1889.8872242271768,1.2393934499105097,False
1688,5d5f48097922dae26da06a12482a7a74de7ba924,/Users/sanika/Downloads/Master Thesis/repo_updated/pytest/testing/test_collection.py,5061.0,ModificationType.MODIFY,1296,573,1062,40,33,157,1336,8,201,118,231,209,349,1561.8613899269644,2689.868337096228,4.597014925373134,12365.364892919973,686.9647162733319,0.896622779032076,False
1689,b412661de9fca2ed51d30eb29a3c0606bb10a868,/Users/sanika/Downloads/Master Thesis/repo_updated/pytest/doc/en/example/multipython.py,6756.0,ModificationType.MODIFY,72,33,56,0,4,12,72,1,1,1,1,2,2,0.0,2.0,0.5,1.0,0.05555555555555555,0.0006666666666666666,False
1690,b412661de9fca2ed51d30eb29a3c0606bb10a868,/Users/sanika/Downloads/Master Thesis/repo_updated/pytest/src/_pytest/python.py,6756.0,ModificationType.MODIFY,1454,835,1044,76,110,219,1530,17,275,158,296,292,454,2297.8910156145625,3718.1803497315277,9.149090909090908,34017.97003608918,1889.8872242271768,1.2393934499105097,False
1691,64d89105166264ad5169869bae8b945f542e7fb4,/Users/sanika/Downloads/Master Thesis/repo_updated/pytest/doc/en/example/multipython.py,6749.0,ModificationType.MODIFY,72,33,56,0,4,12,72,1,1,1,1,2,2,0.0,2.0,0.5,1.0,0.05555555555555555,0.0006666666666666666,False
1692,64d89105166264ad5169869bae8b945f542e7fb4,/Users/sanika/Downloads/Master Thesis/repo_updated/pytest/src/_pytest/python.py,6749.0,ModificationType.MODIFY,1454,835,1044,76,110,219,1530,17,275,158,296,292,454,2297.8910156145625,3718.1803497315277,9.149090909090908,34017.97003608918,1889.8872242271768,1.2393934499105097,False
1693,2ad2fbc9a222f3ab2cab5379972c40d3f5ad2db1,/Users/sanika/Downloads/Master Thesis/repo_updated/pytest/doc/en/example/multipython.py,6740.0,ModificationType.MODIFY,72,33,56,0,4,12,72,1,1,1,1,2,2,0.0,2.0,0.5,1.0,0.05555555555555555,0.0006666666666666666,False
1694,2ad2fbc9a222f3ab2cab5379972c40d3f5ad2db1,/Users/sanika/Downloads/Master Thesis/repo_updated/pytest/src/_pytest/python.py,6740.0,ModificationType.MODIFY,1454,835,1044,76,110,219,1530,17,275,158,296,292,454,2297.8910156145625,3718.1803497315277,9.149090909090908,34017.97003608918,1889.8872242271768,1.2393934499105097,False
1695,2ad2fbc9a222f3ab2cab5379972c40d3f5ad2db1,/Users/sanika/Downloads/Master Thesis/repo_updated/pytest/testing/python/metafunc.py,5922.0,ModificationType.MODIFY,1782,648,1425,9,47,279,1791,8,171,97,189,179,286,1292.4527800454887,2140.3713122975773,4.421052631578949,9462.69422278929,525.705234599405,0.7134571040991925,False
1696,b4ff6b36727cdaa64e0f6d524d290eddd0593e72,/Users/sanika/Downloads/Master Thesis/repo_updated/pytest/doc/en/example/multipython.py,6740.0,ModificationType.MODIFY,72,33,56,0,4,12,72,1,1,1,1,2,2,0.0,2.0,0.5,1.0,0.05555555555555555,0.0006666666666666666,False
1697,b4ff6b36727cdaa64e0f6d524d290eddd0593e72,/Users/sanika/Downloads/Master Thesis/repo_updated/pytest/src/_pytest/python.py,6740.0,ModificationType.MODIFY,1454,835,1044,76,110,219,1530,17,275,158,296,292,454,2297.8910156145625,3718.1803497315277,9.149090909090908,34017.97003608918,1889.8872242271768,1.2393934499105097,False
1698,b4ff6b36727cdaa64e0f6d524d290eddd0593e72,/Users/sanika/Downloads/Master Thesis/repo_updated/pytest/testing/python/metafunc.py,5922.0,ModificationType.MODIFY,1782,648,1425,9,47,279,1791,8,171,97,189,179,286,1292.4527800454887,2140.3713122975773,4.421052631578949,9462.69422278929,525.705234599405,0.7134571040991925,False
1699,89eeefbbafaccbee48d8c8501cf9b9318946f491,/Users/sanika/Downloads/Master Thesis/repo_updated/pytest/testing/example_scripts/collect/package_infinite_recursion/__init__.pyi,5077.0,ModificationType.MODIFY,0,0,0,0,0,0,0,0,0,0,0,0,0,0.0,0.0,0.0,0.0,0.0,0.0,False
1700,89eeefbbafaccbee48d8c8501cf9b9318946f491,/Users/sanika/Downloads/Master Thesis/repo_updated/pytest/testing/example_scripts/collect/package_infinite_recursion/tests/__init__.py,5077.0,ModificationType.MODIFY,0,0,0,0,0,0,0,0,0,0,0,0,0,0.0,0.0,0.0,0.0,0.0,0.0,False
1701,89eeefbbafaccbee48d8c8501cf9b9318946f491,/Users/sanika/Downloads/Master Thesis/repo_updated/pytest/testing/example_scripts/collect/collect_init_tests/tests/__init__.py,5077.0,ModificationType.MODIFY,2,2,2,0,0,0,2,0,0,0,0,0,0,0.0,0.0,0.0,0.0,0.0,0.0,False
1702,89eeefbbafaccbee48d8c8501cf9b9318946f491,/Users/sanika/Downloads/Master Thesis/repo_updated/pytest/testing/example_scripts/collect/package_init_given_as_arg/pkg/__init__.py,5077.0,ModificationType.MODIFY,0,0,0,0,0,0,0,0,0,0,0,0,0,0.0,0.0,0.0,0.0,0.0,0.0,False
1703,89eeefbbafaccbee48d8c8501cf9b9318946f491,/Users/sanika/Downloads/Master Thesis/repo_updated/pytest/testing/example_scripts/conftest_usageerror/__init__.pyi,5077.0,ModificationType.MODIFY,0,0,0,0,0,0,0,0,0,0,0,0,0,0.0,0.0,0.0,0.0,0.0,0.0,False
1704,89eeefbbafaccbee48d8c8501cf9b9318946f491,/Users/sanika/Downloads/Master Thesis/repo_updated/pytest/testing/example_scripts/marks/marks_considered_keywords/__init__.pyi,5077.0,ModificationType.MODIFY,0,0,0,0,0,0,0,0,0,0,0,0,0,0.0,0.0,0.0,0.0,0.0,0.0,False
1705,89eeefbbafaccbee48d8c8501cf9b9318946f491,/Users/sanika/Downloads/Master Thesis/repo_updated/pytest/testing/example_scripts/config/collect_pytest_prefix/__init__.pyi,5077.0,ModificationType.MODIFY,0,0,0,0,0,0,0,0,0,0,0,0,0,0.0,0.0,0.0,0.0,0.0,0.0,False
1706,89eeefbbafaccbee48d8c8501cf9b9318946f491,/Users/sanika/Downloads/Master Thesis/repo_updated/pytest/testing/example_scripts/issue88_initial_file_multinodes/__init__.pyi,5077.0,ModificationType.MODIFY,0,0,0,0,0,0,0,0,0,0,0,0,0,0.0,0.0,0.0,0.0,0.0,0.0,False
1707,89eeefbbafaccbee48d8c8501cf9b9318946f491,/Users/sanika/Downloads/Master Thesis/repo_updated/pytest/testing/example_scripts/fixtures/fill_fixtures/test_extend_fixture_conftest_conftest/__init__.pyi,5077.0,ModificationType.MODIFY,0,0,0,0,0,0,0,0,0,0,0,0,0,0.0,0.0,0.0,0.0,0.0,0.0,False
1708,89eeefbbafaccbee48d8c8501cf9b9318946f491,/Users/sanika/Downloads/Master Thesis/repo_updated/pytest/testing/example_scripts/fixtures/fill_fixtures/test_extend_fixture_conftest_conftest/pkg/__init__.py,5077.0,ModificationType.MODIFY,0,0,0,0,0,0,0,0,0,0,0,0,0,0.0,0.0,0.0,0.0,0.0,0.0,False
1709,89eeefbbafaccbee48d8c8501cf9b9318946f491,/Users/sanika/Downloads/Master Thesis/repo_updated/pytest/testing/example_scripts/fixtures/fill_fixtures/test_extend_fixture_conftest_module/__init__.pyi,5077.0,ModificationType.MODIFY,0,0,0,0,0,0,0,0,0,0,0,0,0,0.0,0.0,0.0,0.0,0.0,0.0,False
1710,89eeefbbafaccbee48d8c8501cf9b9318946f491,/Users/sanika/Downloads/Master Thesis/repo_updated/pytest/testing/example_scripts/fixtures/fill_fixtures/test_conftest_funcargs_only_available_in_subdir/sub1/__init__.py,5077.0,ModificationType.MODIFY,0,0,0,0,0,0,0,0,0,0,0,0,0,0.0,0.0,0.0,0.0,0.0,0.0,False
1711,89eeefbbafaccbee48d8c8501cf9b9318946f491,/Users/sanika/Downloads/Master Thesis/repo_updated/pytest/testing/example_scripts/fixtures/fill_fixtures/test_conftest_funcargs_only_available_in_subdir/sub2/__init__.py,5077.0,ModificationType.MODIFY,0,0,0,0,0,0,0,0,0,0,0,0,0,0.0,0.0,0.0,0.0,0.0,0.0,False
1712,89eeefbbafaccbee48d8c8501cf9b9318946f491,/Users/sanika/Downloads/Master Thesis/repo_updated/pytest/testing/example_scripts/fixtures/custom_item/__init__.pyi,5077.0,ModificationType.MODIFY,0,0,0,0,0,0,0,0,0,0,0,0,0,0.0,0.0,0.0,0.0,0.0,0.0,False
1713,89eeefbbafaccbee48d8c8501cf9b9318946f491,/Users/sanika/Downloads/Master Thesis/repo_updated/pytest/testing/example_scripts/fixtures/custom_item/foo/__init__.py,5077.0,ModificationType.MODIFY,0,0,0,0,0,0,0,0,0,0,0,0,0,0.0,0.0,0.0,0.0,0.0,0.0,False
1714,89eeefbbafaccbee48d8c8501cf9b9318946f491,/Users/sanika/Downloads/Master Thesis/repo_updated/pytest/doc/en/example/nonpython/__init__.py,5077.0,ModificationType.MODIFY,0,0,0,0,0,0,0,0,0,0,0,0,0,0.0,0.0,0.0,0.0,0.0,0.0,False
1715,89eeefbbafaccbee48d8c8501cf9b9318946f491,/Users/sanika/Downloads/Master Thesis/repo_updated/pytest/src/pytest/__init__.py,5077.0,ModificationType.MODIFY,99,48,90,1,3,5,100,0,0,0,0,0,0,0.0,0.0,0.0,0.0,0.0,0.0,False
1716,89eeefbbafaccbee48d8c8501cf9b9318946f491,/Users/sanika/Downloads/Master Thesis/repo_updated/pytest/src/_pytest/__init__.py,5077.0,ModificationType.MODIFY,8,5,5,2,0,1,10,0,0,0,0,0,0,0.0,0.0,0.0,0.0,0.0,0.0,False
1717,89eeefbbafaccbee48d8c8501cf9b9318946f491,/Users/sanika/Downloads/Master Thesis/repo_updated/pytest/src/_pytest/config/__init__.py,5077.0,ModificationType.MODIFY,1217,716,841,84,126,174,1301,14,185,118,215,199,333,1446.608539104324,2542.995998641035,8.135135135135135,20687.616097052745,1149.3120053918194,0.847665332880345,False
1718,89eeefbbafaccbee48d8c8501cf9b9318946f491,/Users/sanika/Downloads/Master Thesis/repo_updated/pytest/src/_pytest/mark/__init__.py,5077.0,ModificationType.MODIFY,160,89,115,0,13,31,160,7,15,11,17,22,28,78.25484338853101,124.86408532184431,3.966666666666667,495.29420510998256,27.516344728332356,0.04162136177394811,False
1719,89eeefbbafaccbee48d8c8501cf9b9318946f491,/Users/sanika/Downloads/Master Thesis/repo_updated/pytest/src/_pytest/_code/__init__.py,5077.0,ModificationType.MODIFY,10,10,9,9,0,0,19,0,0,0,0,0,0,0.0,0.0,0.0,0.0,0.0,0.0,False
1720,89eeefbbafaccbee48d8c8501cf9b9318946f491,/Users/sanika/Downloads/Master Thesis/repo_updated/pytest/src/_pytest/assertion/__init__.py,5077.0,ModificationType.MODIFY,173,84,99,8,29,36,181,5,12,7,13,17,20,54.62919048309069,81.7492568250068,2.708333333333333,221.40423723439343,12.300235401910744,0.027249752275002263,False
1721,89eeefbbafaccbee48d8c8501cf9b9318946f491,/Users/sanika/Downloads/Master Thesis/repo_updated/pytest/src/_pytest/_io/__init__.py,5077.0,ModificationType.MODIFY,3,1,1,3,0,0,6,0,0,0,0,0,0,0.0,0.0,0.0,0.0,0.0,0.0,False
1722,89eeefbbafaccbee48d8c8501cf9b9318946f491,/Users/sanika/Downloads/Master Thesis/repo_updated/pytest/src/_pytest/deprecated.py,45.0,ModificationType.MODIFY,42,7,23,2,8,9,44,0,0,0,0,0,0,0.0,0.0,0.0,0.0,0.0,0.0,False
1723,89eeefbbafaccbee48d8c8501cf9b9318946f491,/Users/sanika/Downloads/Master Thesis/repo_updated/pytest/testing/deprecated_test.py,265.0,ModificationType.MODIFY,75,38,59,1,3,12,76,2,4,2,4,6,6,10.0,15.509775004326935,1.0,15.509775004326935,0.861654166907052,0.005169925001442312,False
1724,f38f2d402e183130222993f501d92eefe0d398dc,/Users/sanika/Downloads/Master Thesis/repo_updated/pytest/testing/test_assertrewrite.py,5605.0,ModificationType.MODIFY,1660,832,1314,41,38,274,1701,20,312,209,395,332,604,2671.484054182769,5058.523816533542,12.660256410256409,64042.208574703494,3557.900476372417,1.6861746055111808,False
1725,f38f2d402e183130222993f501d92eefe0d398dc,/Users/sanika/Downloads/Master Thesis/repo_updated/pytest/src/_pytest/assertion/rewrite.py,5605.0,ModificationType.MODIFY,1057,646,719,113,100,145,1170,18,215,134,248,233,382,1740.9201126876956,3004.119107257935,10.381395348837211,31186.94812744052,1732.608229302251,1.001373035752645,False
1726,bebd80456b4a9865c88c5341ed21cf7ecfee9aa4,/Users/sanika/Downloads/Master Thesis/repo_updated/pytest/testing/test_setupplan.py,119.0,ModificationType.MODIFY,110,30,77,3,13,16,113,4,21,15,30,25,45,100.23866587835396,208.9735285398626,2.8571428571428568,597.0672243996074,33.17040135553375,0.06965784284662087,False
1727,bebd80456b4a9865c88c5341ed21cf7ecfee9aa4,/Users/sanika/Downloads/Master Thesis/repo_updated/pytest/src/_pytest/setupplan.py,119.0,ModificationType.MODIFY,28,15,21,1,0,6,29,0,0,0,0,0,0,0.0,0.0,0.0,0.0,0.0,0.0,False
1728,eeeb19626b26072ff49735e221dc558363716b78,/Users/sanika/Downloads/Master Thesis/repo_updated/pytest/doc/en/example/multipython.py,6689.0,ModificationType.MODIFY,72,33,56,0,4,12,72,1,1,1,1,2,2,0.0,2.0,0.5,1.0,0.05555555555555555,0.0006666666666666666,False
1729,eeeb19626b26072ff49735e221dc558363716b78,/Users/sanika/Downloads/Master Thesis/repo_updated/pytest/src/_pytest/python.py,6689.0,ModificationType.MODIFY,1454,835,1044,76,110,219,1530,17,275,158,296,292,454,2297.8910156145625,3718.1803497315277,9.149090909090908,34017.97003608918,1889.8872242271768,1.2393934499105097,False
1730,eeeb19626b26072ff49735e221dc558363716b78,/Users/sanika/Downloads/Master Thesis/repo_updated/pytest/testing/test_collection.py,5061.0,ModificationType.MODIFY,1296,573,1062,40,33,157,1336,8,201,118,231,209,349,1561.8613899269644,2689.868337096228,4.597014925373134,12365.364892919973,686.9647162733319,0.896622779032076,False
1731,63a23d876cad98d42f03cf6c6f397513e96ffcdb,/Users/sanika/Downloads/Master Thesis/repo_updated/pytest/testing/acceptance_test.py,4605.0,ModificationType.MODIFY,1289,550,1043,56,32,155,1345,10,167,93,185,177,278,1266.2978977920407,2075.994342923073,5.538922155688622,11498.771061100857,638.8206145056031,0.6919981143076911,False
1732,b820b7e384a0e86ed0954bd79b89f4ff928e2837,/Users/sanika/Downloads/Master Thesis/repo_updated/pytest/testing/test_assertrewrite.py,5605.0,ModificationType.MODIFY,1660,832,1314,41,38,274,1701,20,312,209,395,332,604,2671.484054182769,5058.523816533542,12.660256410256409,64042.208574703494,3557.900476372417,1.6861746055111808,False
1733,b820b7e384a0e86ed0954bd79b89f4ff928e2837,/Users/sanika/Downloads/Master Thesis/repo_updated/pytest/src/_pytest/assertion/rewrite.py,5605.0,ModificationType.MODIFY,1057,646,719,113,100,145,1170,18,215,134,248,233,382,1740.9201126876956,3004.119107257935,10.381395348837211,31186.94812744052,1732.608229302251,1.001373035752645,False
1734,4804d4bc9824f7a6fb0153a25e896627dec37b3b,/Users/sanika/Downloads/Master Thesis/repo_updated/pytest/doc/en/example/multipython.py,6726.0,ModificationType.MODIFY,72,33,56,0,4,12,72,1,1,1,1,2,2,0.0,2.0,0.5,1.0,0.05555555555555555,0.0006666666666666666,False
1735,4804d4bc9824f7a6fb0153a25e896627dec37b3b,/Users/sanika/Downloads/Master Thesis/repo_updated/pytest/src/_pytest/python.py,6726.0,ModificationType.MODIFY,1454,835,1044,76,110,219,1530,17,275,158,296,292,454,2297.8910156145625,3718.1803497315277,9.149090909090908,34017.97003608918,1889.8872242271768,1.2393934499105097,False
1736,f36ea240fe3579f945bf5d6cc41b5e45a572249d,/Users/sanika/Downloads/Master Thesis/repo_updated/pytest/testing/acceptance_test.py,4605.0,ModificationType.MODIFY,1289,550,1043,56,32,155,1345,10,167,93,185,177,278,1266.2978977920407,2075.994342923073,5.538922155688622,11498.771061100857,638.8206145056031,0.6919981143076911,False
1737,d1e2d12b3feae7366b57b878f88a8b772817820e,/Users/sanika/Downloads/Master Thesis/repo_updated/pytest/doc/en/example/multipython.py,6726.0,ModificationType.MODIFY,72,33,56,0,4,12,72,1,1,1,1,2,2,0.0,2.0,0.5,1.0,0.05555555555555555,0.0006666666666666666,False
1738,d1e2d12b3feae7366b57b878f88a8b772817820e,/Users/sanika/Downloads/Master Thesis/repo_updated/pytest/src/_pytest/python.py,6726.0,ModificationType.MODIFY,1454,835,1044,76,110,219,1530,17,275,158,296,292,454,2297.8910156145625,3718.1803497315277,9.149090909090908,34017.97003608918,1889.8872242271768,1.2393934499105097,False
1739,4ad61cbcf6063d5bc414a9a37a5fbb29a3083e73,/Users/sanika/Downloads/Master Thesis/repo_updated/pytest/src/_pytest/mark/structures.py,1500.0,ModificationType.MODIFY,402,202,227,24,74,80,426,12,52,33,61,64,94,339.4424153519907,564.0,7.038461538461537,3969.6923076923076,220.53846153846158,0.188,False
1740,4ad61cbcf6063d5bc414a9a37a5fbb29a3083e73,/Users/sanika/Downloads/Master Thesis/repo_updated/pytest/doc/en/example/multipython.py,6686.0,ModificationType.MODIFY,72,33,56,0,4,12,72,1,1,1,1,2,2,0.0,2.0,0.5,1.0,0.05555555555555555,0.0006666666666666666,False
1741,4ad61cbcf6063d5bc414a9a37a5fbb29a3083e73,/Users/sanika/Downloads/Master Thesis/repo_updated/pytest/src/_pytest/python.py,6686.0,ModificationType.MODIFY,1454,835,1044,76,110,219,1530,17,275,158,296,292,454,2297.8910156145625,3718.1803497315277,9.149090909090908,34017.97003608918,1889.8872242271768,1.2393934499105097,False
1742,4ad61cbcf6063d5bc414a9a37a5fbb29a3083e73,/Users/sanika/Downloads/Master Thesis/repo_updated/pytest/testing/python/metafunc.py,5907.0,ModificationType.MODIFY,1782,648,1425,9,47,279,1791,8,171,97,189,179,286,1292.4527800454887,2140.3713122975773,4.421052631578949,9462.69422278929,525.705234599405,0.7134571040991925,False
1743,21622d0df43609b84644134a4741343d147df1eb,/Users/sanika/Downloads/Master Thesis/repo_updated/pytest/doc/en/example/multipython.py,6716.0,ModificationType.MODIFY,72,33,56,0,4,12,72,1,1,1,1,2,2,0.0,2.0,0.5,1.0,0.05555555555555555,0.0006666666666666666,False
1744,21622d0df43609b84644134a4741343d147df1eb,/Users/sanika/Downloads/Master Thesis/repo_updated/pytest/src/_pytest/python.py,6716.0,ModificationType.MODIFY,1454,835,1044,76,110,219,1530,17,275,158,296,292,454,2297.8910156145625,3718.1803497315277,9.149090909090908,34017.97003608918,1889.8872242271768,1.2393934499105097,False
1745,21622d0df43609b84644134a4741343d147df1eb,/Users/sanika/Downloads/Master Thesis/repo_updated/pytest/testing/test_setupplan.py,119.0,ModificationType.MODIFY,110,30,77,3,13,16,113,4,21,15,30,25,45,100.23866587835396,208.9735285398626,2.8571428571428568,597.0672243996074,33.17040135553375,0.06965784284662087,False
1746,21622d0df43609b84644134a4741343d147df1eb,/Users/sanika/Downloads/Master Thesis/repo_updated/pytest/src/_pytest/setupplan.py,119.0,ModificationType.MODIFY,28,15,21,1,0,6,29,0,0,0,0,0,0,0.0,0.0,0.0,0.0,0.0,0.0,False
1747,21622d0df43609b84644134a4741343d147df1eb,/Users/sanika/Downloads/Master Thesis/repo_updated/pytest/testing/acceptance_test.py,4666.0,ModificationType.MODIFY,1289,550,1043,56,32,155,1345,10,167,93,185,177,278,1266.2978977920407,2075.994342923073,5.538922155688622,11498.771061100857,638.8206145056031,0.6919981143076911,False
1748,21622d0df43609b84644134a4741343d147df1eb,/Users/sanika/Downloads/Master Thesis/repo_updated/pytest/testing/test_collection.py,5062.0,ModificationType.MODIFY,1296,573,1062,40,33,157,1336,8,201,118,231,209,349,1561.8613899269644,2689.868337096228,4.597014925373134,12365.364892919973,686.9647162733319,0.896622779032076,False
1749,21622d0df43609b84644134a4741343d147df1eb,/Users/sanika/Downloads/Master Thesis/repo_updated/pytest/testing/test_setupplan.py,190.0,ModificationType.MODIFY,110,30,77,3,13,16,113,4,21,15,30,25,45,100.23866587835396,208.9735285398626,2.8571428571428568,597.0672243996074,33.17040135553375,0.06965784284662087,False
1750,faea273c930985074783703e7d37d88441acf30e,/Users/sanika/Downloads/Master Thesis/repo_updated/pytest/testing/test_assertrewrite.py,5498.0,ModificationType.MODIFY,1660,832,1314,41,38,274,1701,20,312,209,395,332,604,2671.484054182769,5058.523816533542,12.660256410256409,64042.208574703494,3557.900476372417,1.6861746055111808,False
1751,faea273c930985074783703e7d37d88441acf30e,/Users/sanika/Downloads/Master Thesis/repo_updated/pytest/src/_pytest/assertion/rewrite.py,5498.0,ModificationType.MODIFY,1057,646,719,113,100,145,1170,18,215,134,248,233,382,1740.9201126876956,3004.119107257935,10.381395348837211,31186.94812744052,1732.608229302251,1.001373035752645,False
1752,faea273c930985074783703e7d37d88441acf30e,/Users/sanika/Downloads/Master Thesis/repo_updated/pytest/testing/test_warnings.py,1597.0,ModificationType.MODIFY,601,196,481,2,23,85,603,8,63,36,72,71,108,400.5686351804948,664.1726889065056,4.571428571428571,3036.21800642974,168.67877813498555,0.22139089630216852,False
1753,1d368e0ed468ede55718b1990441725778ce6e9b,/Users/sanika/Downloads/Master Thesis/repo_updated/pytest/src/_pytest/mark/structures.py,1500.0,ModificationType.MODIFY,402,202,227,24,74,80,426,12,52,33,61,64,94,339.4424153519907,564.0,7.038461538461537,3969.6923076923076,220.53846153846158,0.188,False
1754,1d368e0ed468ede55718b1990441725778ce6e9b,/Users/sanika/Downloads/Master Thesis/repo_updated/pytest/doc/en/example/multipython.py,6672.0,ModificationType.MODIFY,72,33,56,0,4,12,72,1,1,1,1,2,2,0.0,2.0,0.5,1.0,0.05555555555555555,0.0006666666666666666,False
1755,1d368e0ed468ede55718b1990441725778ce6e9b,/Users/sanika/Downloads/Master Thesis/repo_updated/pytest/src/_pytest/python.py,6672.0,ModificationType.MODIFY,1454,835,1044,76,110,219,1530,17,275,158,296,292,454,2297.8910156145625,3718.1803497315277,9.149090909090908,34017.97003608918,1889.8872242271768,1.2393934499105097,False
1756,1d368e0ed468ede55718b1990441725778ce6e9b,/Users/sanika/Downloads/Master Thesis/repo_updated/pytest/testing/python/metafunc.py,5907.0,ModificationType.MODIFY,1782,648,1425,9,47,279,1791,8,171,97,189,179,286,1292.4527800454887,2140.3713122975773,4.421052631578949,9462.69422278929,525.705234599405,0.7134571040991925,False
1757,5b3867fd6553edcb456bd8758f6a15b16f2ec84c,/Users/sanika/Downloads/Master Thesis/repo_updated/pytest/doc/en/example/multipython.py,6662.0,ModificationType.MODIFY,72,33,56,0,4,12,72,1,1,1,1,2,2,0.0,2.0,0.5,1.0,0.05555555555555555,0.0006666666666666666,False
1758,5b3867fd6553edcb456bd8758f6a15b16f2ec84c,/Users/sanika/Downloads/Master Thesis/repo_updated/pytest/src/_pytest/python.py,6662.0,ModificationType.MODIFY,1454,835,1044,76,110,219,1530,17,275,158,296,292,454,2297.8910156145625,3718.1803497315277,9.149090909090908,34017.97003608918,1889.8872242271768,1.2393934499105097,False
1759,5b3867fd6553edcb456bd8758f6a15b16f2ec84c,/Users/sanika/Downloads/Master Thesis/repo_updated/pytest/testing/test_setupplan.py,119.0,ModificationType.MODIFY,110,30,77,3,13,16,113,4,21,15,30,25,45,100.23866587835396,208.9735285398626,2.8571428571428568,597.0672243996074,33.17040135553375,0.06965784284662087,False
1760,5b3867fd6553edcb456bd8758f6a15b16f2ec84c,/Users/sanika/Downloads/Master Thesis/repo_updated/pytest/src/_pytest/setupplan.py,119.0,ModificationType.MODIFY,28,15,21,1,0,6,29,0,0,0,0,0,0,0.0,0.0,0.0,0.0,0.0,0.0,False
1761,5b3867fd6553edcb456bd8758f6a15b16f2ec84c,/Users/sanika/Downloads/Master Thesis/repo_updated/pytest/testing/acceptance_test.py,4666.0,ModificationType.MODIFY,1289,550,1043,56,32,155,1345,10,167,93,185,177,278,1266.2978977920407,2075.994342923073,5.538922155688622,11498.771061100857,638.8206145056031,0.6919981143076911,False
1762,5b3867fd6553edcb456bd8758f6a15b16f2ec84c,/Users/sanika/Downloads/Master Thesis/repo_updated/pytest/testing/test_collection.py,5062.0,ModificationType.MODIFY,1296,573,1062,40,33,157,1336,8,201,118,231,209,349,1561.8613899269644,2689.868337096228,4.597014925373134,12365.364892919973,686.9647162733319,0.896622779032076,False
1763,5b3867fd6553edcb456bd8758f6a15b16f2ec84c,/Users/sanika/Downloads/Master Thesis/repo_updated/pytest/testing/test_setupplan.py,190.0,ModificationType.MODIFY,110,30,77,3,13,16,113,4,21,15,30,25,45,100.23866587835396,208.9735285398626,2.8571428571428568,597.0672243996074,33.17040135553375,0.06965784284662087,False
1764,7e5ad314287a5c86856efea13c04333d7baf3643,/Users/sanika/Downloads/Master Thesis/repo_updated/pytest/setup.py,93.0,ModificationType.MODIFY,42,7,35,4,0,5,46,1,2,1,2,3,3,2.0,4.754887502163468,0.5,2.3774437510817346,0.1320802083934297,0.0015849625007211565,False
1765,7e5ad314287a5c86856efea13c04333d7baf3643,/Users/sanika/Downloads/Master Thesis/repo_updated/pytest/extra/setup-py.test/setup.py,93.0,ModificationType.MODIFY,11,6,10,0,0,1,11,2,4,2,4,6,6,10.0,15.509775004326935,1.0,15.509775004326935,0.861654166907052,0.005169925001442312,False
1766,7e5ad314287a5c86856efea13c04333d7baf3643,/Users/sanika/Downloads/Master Thesis/repo_updated/pytest/testing/code/test_code.py,5483.0,ModificationType.MODIFY,182,127,129,0,0,53,182,5,39,21,42,44,63,217.7403270100645,343.9441919741497,2.6923076923076925,926.003593776557,51.44464409869761,0.11464806399138325,False
1767,7e5ad314287a5c86856efea13c04333d7baf3643,/Users/sanika/Downloads/Master Thesis/repo_updated/pytest/src/_pytest/_code/code.py,5483.0,ModificationType.MODIFY,1165,710,800,67,119,181,1232,18,243,153,282,261,435,2000.7880884021665,3492.1391085079,10.444444444444443,36473.45291108252,2026.302939504584,1.1640463695026333,False
1768,7e5ad314287a5c86856efea13c04333d7baf3643,/Users/sanika/Downloads/Master Thesis/repo_updated/pytest/testing/code/test_source.py,1754.0,ModificationType.MODIFY,773,419,590,28,0,166,801,10,204,113,217,214,330,1598.3940507110583,2554.6841055123778,5.318627450980392,13587.413012161423,754.8562784534123,0.8515613685041261,False
1769,7e5ad314287a5c86856efea13c04333d7baf3643,/Users/sanika/Downloads/Master Thesis/repo_updated/pytest/src/_pytest/_code/source.py,1754.0,ModificationType.MODIFY,421,273,302,44,34,57,465,17,81,59,107,98,166,583.0147185349102,1098.0418341231248,11.228395061728396,12329.247507839285,684.9581948799603,0.36601394470770826,False
1770,7e5ad314287a5c86856efea13c04333d7baf3643,/Users/sanika/Downloads/Master Thesis/repo_updated/pytest/testing/io/test_saferepr.py,382.0,ModificationType.MODIFY,149,95,105,2,0,41,151,8,54,28,55,62,83,334.7639251168273,494.1982937621106,4.0740740740740735,2013.4004560678586,111.8555808926588,0.1647327645873702,False
1771,7e5ad314287a5c86856efea13c04333d7baf3643,/Users/sanika/Downloads/Master Thesis/repo_updated/pytest/src/_pytest/_io/saferepr.py,382.0,ModificationType.MODIFY,82,56,54,0,13,15,82,4,13,8,16,17,24,56.10571633583421,98.09910819000817,2.4615384615384617,241.47472785232785,13.415262658462654,0.03269970273000272,False
1772,7e5ad314287a5c86856efea13c04333d7baf3643,/Users/sanika/Downloads/Master Thesis/repo_updated/pytest/testing/example_scripts/collect/package_infinite_recursion/__init__.pyi,596.0,ModificationType.MODIFY,0,0,0,0,0,0,0,0,0,0,0,0,0,0.0,0.0,0.0,0.0,0.0,0.0,False
1773,7e5ad314287a5c86856efea13c04333d7baf3643,/Users/sanika/Downloads/Master Thesis/repo_updated/pytest/testing/example_scripts/collect/package_infinite_recursion/tests/__init__.py,596.0,ModificationType.MODIFY,0,0,0,0,0,0,0,0,0,0,0,0,0,0.0,0.0,0.0,0.0,0.0,0.0,False
1774,7e5ad314287a5c86856efea13c04333d7baf3643,/Users/sanika/Downloads/Master Thesis/repo_updated/pytest/testing/example_scripts/collect/collect_init_tests/tests/__init__.py,596.0,ModificationType.MODIFY,2,2,2,0,0,0,2,0,0,0,0,0,0,0.0,0.0,0.0,0.0,0.0,0.0,False
1775,7e5ad314287a5c86856efea13c04333d7baf3643,/Users/sanika/Downloads/Master Thesis/repo_updated/pytest/testing/example_scripts/collect/package_init_given_as_arg/pkg/__init__.py,596.0,ModificationType.MODIFY,0,0,0,0,0,0,0,0,0,0,0,0,0,0.0,0.0,0.0,0.0,0.0,0.0,False
1776,7e5ad314287a5c86856efea13c04333d7baf3643,/Users/sanika/Downloads/Master Thesis/repo_updated/pytest/testing/example_scripts/conftest_usageerror/__init__.pyi,596.0,ModificationType.MODIFY,0,0,0,0,0,0,0,0,0,0,0,0,0,0.0,0.0,0.0,0.0,0.0,0.0,False
1777,7e5ad314287a5c86856efea13c04333d7baf3643,/Users/sanika/Downloads/Master Thesis/repo_updated/pytest/testing/example_scripts/marks/marks_considered_keywords/__init__.pyi,596.0,ModificationType.MODIFY,0,0,0,0,0,0,0,0,0,0,0,0,0,0.0,0.0,0.0,0.0,0.0,0.0,False
1778,7e5ad314287a5c86856efea13c04333d7baf3643,/Users/sanika/Downloads/Master Thesis/repo_updated/pytest/testing/example_scripts/config/collect_pytest_prefix/__init__.pyi,596.0,ModificationType.MODIFY,0,0,0,0,0,0,0,0,0,0,0,0,0,0.0,0.0,0.0,0.0,0.0,0.0,False
1779,7e5ad314287a5c86856efea13c04333d7baf3643,/Users/sanika/Downloads/Master Thesis/repo_updated/pytest/testing/example_scripts/issue88_initial_file_multinodes/__init__.pyi,596.0,ModificationType.MODIFY,0,0,0,0,0,0,0,0,0,0,0,0,0,0.0,0.0,0.0,0.0,0.0,0.0,False
1780,7e5ad314287a5c86856efea13c04333d7baf3643,/Users/sanika/Downloads/Master Thesis/repo_updated/pytest/testing/example_scripts/fixtures/fill_fixtures/test_extend_fixture_conftest_conftest/__init__.pyi,596.0,ModificationType.MODIFY,0,0,0,0,0,0,0,0,0,0,0,0,0,0.0,0.0,0.0,0.0,0.0,0.0,False
1781,7e5ad314287a5c86856efea13c04333d7baf3643,/Users/sanika/Downloads/Master Thesis/repo_updated/pytest/testing/example_scripts/fixtures/fill_fixtures/test_extend_fixture_conftest_conftest/pkg/__init__.py,596.0,ModificationType.MODIFY,0,0,0,0,0,0,0,0,0,0,0,0,0,0.0,0.0,0.0,0.0,0.0,0.0,False
1782,7e5ad314287a5c86856efea13c04333d7baf3643,/Users/sanika/Downloads/Master Thesis/repo_updated/pytest/testing/example_scripts/fixtures/fill_fixtures/test_extend_fixture_conftest_module/__init__.pyi,596.0,ModificationType.MODIFY,0,0,0,0,0,0,0,0,0,0,0,0,0,0.0,0.0,0.0,0.0,0.0,0.0,False
1783,7e5ad314287a5c86856efea13c04333d7baf3643,/Users/sanika/Downloads/Master Thesis/repo_updated/pytest/testing/example_scripts/fixtures/fill_fixtures/test_conftest_funcargs_only_available_in_subdir/sub1/__init__.py,596.0,ModificationType.MODIFY,0,0,0,0,0,0,0,0,0,0,0,0,0,0.0,0.0,0.0,0.0,0.0,0.0,False
1784,7e5ad314287a5c86856efea13c04333d7baf3643,/Users/sanika/Downloads/Master Thesis/repo_updated/pytest/testing/example_scripts/fixtures/fill_fixtures/test_conftest_funcargs_only_available_in_subdir/sub2/__init__.py,596.0,ModificationType.MODIFY,0,0,0,0,0,0,0,0,0,0,0,0,0,0.0,0.0,0.0,0.0,0.0,0.0,False
1785,7e5ad314287a5c86856efea13c04333d7baf3643,/Users/sanika/Downloads/Master Thesis/repo_updated/pytest/testing/example_scripts/fixtures/custom_item/__init__.pyi,596.0,ModificationType.MODIFY,0,0,0,0,0,0,0,0,0,0,0,0,0,0.0,0.0,0.0,0.0,0.0,0.0,False
1786,7e5ad314287a5c86856efea13c04333d7baf3643,/Users/sanika/Downloads/Master Thesis/repo_updated/pytest/testing/example_scripts/fixtures/custom_item/foo/__init__.py,596.0,ModificationType.MODIFY,0,0,0,0,0,0,0,0,0,0,0,0,0,0.0,0.0,0.0,0.0,0.0,0.0,False
1787,7e5ad314287a5c86856efea13c04333d7baf3643,/Users/sanika/Downloads/Master Thesis/repo_updated/pytest/doc/en/example/nonpython/__init__.py,596.0,ModificationType.MODIFY,0,0,0,0,0,0,0,0,0,0,0,0,0,0.0,0.0,0.0,0.0,0.0,0.0,False
1788,7e5ad314287a5c86856efea13c04333d7baf3643,/Users/sanika/Downloads/Master Thesis/repo_updated/pytest/src/pytest/__init__.py,596.0,ModificationType.MODIFY,99,48,90,1,3,5,100,0,0,0,0,0,0,0.0,0.0,0.0,0.0,0.0,0.0,False
1789,7e5ad314287a5c86856efea13c04333d7baf3643,/Users/sanika/Downloads/Master Thesis/repo_updated/pytest/src/_pytest/__init__.py,596.0,ModificationType.MODIFY,8,5,5,2,0,1,10,0,0,0,0,0,0,0.0,0.0,0.0,0.0,0.0,0.0,False
1790,7e5ad314287a5c86856efea13c04333d7baf3643,/Users/sanika/Downloads/Master Thesis/repo_updated/pytest/src/_pytest/config/__init__.py,596.0,ModificationType.MODIFY,1217,716,841,84,126,174,1301,14,185,118,215,199,333,1446.608539104324,2542.995998641035,8.135135135135135,20687.616097052745,1149.3120053918194,0.847665332880345,False
1791,7e5ad314287a5c86856efea13c04333d7baf3643,/Users/sanika/Downloads/Master Thesis/repo_updated/pytest/src/_pytest/mark/__init__.py,596.0,ModificationType.MODIFY,160,89,115,0,13,31,160,7,15,11,17,22,28,78.25484338853101,124.86408532184431,3.966666666666667,495.29420510998256,27.516344728332356,0.04162136177394811,False
1792,7e5ad314287a5c86856efea13c04333d7baf3643,/Users/sanika/Downloads/Master Thesis/repo_updated/pytest/src/_pytest/_code/__init__.py,596.0,ModificationType.MODIFY,10,10,9,9,0,0,19,0,0,0,0,0,0,0.0,0.0,0.0,0.0,0.0,0.0,False
1793,7e5ad314287a5c86856efea13c04333d7baf3643,/Users/sanika/Downloads/Master Thesis/repo_updated/pytest/src/_pytest/assertion/__init__.py,596.0,ModificationType.MODIFY,173,84,99,8,29,36,181,5,12,7,13,17,20,54.62919048309069,81.7492568250068,2.708333333333333,221.40423723439343,12.300235401910744,0.027249752275002263,False
1794,7e5ad314287a5c86856efea13c04333d7baf3643,/Users/sanika/Downloads/Master Thesis/repo_updated/pytest/src/_pytest/_io/__init__.py,596.0,ModificationType.MODIFY,3,1,1,3,0,0,6,0,0,0,0,0,0,0.0,0.0,0.0,0.0,0.0,0.0,False
1795,7e5ad314287a5c86856efea13c04333d7baf3643,/Users/sanika/Downloads/Master Thesis/repo_updated/pytest/testing/test_assertrewrite.py,5605.0,ModificationType.MODIFY,1660,832,1314,41,38,274,1701,20,312,209,395,332,604,2671.484054182769,5058.523816533542,12.660256410256409,64042.208574703494,3557.900476372417,1.6861746055111808,False
1796,7e5ad314287a5c86856efea13c04333d7baf3643,/Users/sanika/Downloads/Master Thesis/repo_updated/pytest/src/_pytest/assertion/rewrite.py,5605.0,ModificationType.MODIFY,1057,646,719,113,100,145,1170,18,215,134,248,233,382,1740.9201126876956,3004.119107257935,10.381395348837211,31186.94812744052,1732.608229302251,1.001373035752645,False
1797,7e5ad314287a5c86856efea13c04333d7baf3643,/Users/sanika/Downloads/Master Thesis/repo_updated/pytest/src/_pytest/assertion/util.py,2606.0,ModificationType.MODIFY,477,336,357,30,23,73,507,16,194,134,250,210,384,1538.3830913843026,2962.2702787837907,10.309278350515463,30538.868853441152,1696.603825191175,0.9874234262612636,False
1798,7e5ad314287a5c86856efea13c04333d7baf3643,/Users/sanika/Downloads/Master Thesis/repo_updated/pytest/testing/test_cacheprovider.py,2063.0,ModificationType.MODIFY,996,429,845,24,10,117,1020,7,76,50,88,83,138,494.49397547611574,879.7554415258757,4.052631578947368,3565.324684078549,198.07359355991935,0.2932518138419585,False
1799,7e5ad314287a5c86856efea13c04333d7baf3643,/Users/sanika/Downloads/Master Thesis/repo_updated/pytest/src/_pytest/cacheprovider.py,2063.0,ModificationType.MODIFY,456,277,329,12,42,72,468,13,85,50,97,98,147,592.903945907539,972.3623470849358,7.417647058823531,7212.640703965319,400.7022613314065,0.3241207823616453,False
1800,7e5ad314287a5c86856efea13c04333d7baf3643,/Users/sanika/Downloads/Master Thesis/repo_updated/pytest/testing/test_capture.py,3438.0,ModificationType.MODIFY,1513,682,1277,25,13,200,1538,11,199,116,219,210,335,1557.7420472931965,2584.272248418151,6.052763819095478,15641.989563917903,868.9994202176613,0.8614240828060503,False
1801,7e5ad314287a5c86856efea13c04333d7baf3643,/Users/sanika/Downloads/Master Thesis/repo_updated/pytest/src/_pytest/capture.py,3438.0,ModificationType.MODIFY,819,519,539,24,98,155,843,15,96,57,106,111,163,690.7597590033588,1107.4897862150674,8.28125,9171.399792093527,509.5222106718626,0.3691632620716892,False
1802,7e5ad314287a5c86856efea13c04333d7baf3643,/Users/sanika/Downloads/Master Thesis/repo_updated/pytest/testing/test_compat.py,1495.0,ModificationType.MODIFY,207,111,150,11,0,50,218,5,26,19,36,31,55,133.82107314610522,272.4807970712782,3.4615384615384617,943.202759092886,52.400153282938106,0.09082693235709273,False
1803,7e5ad314287a5c86856efea13c04333d7baf3643,/Users/sanika/Downloads/Master Thesis/repo_updated/pytest/src/_pytest/compat.py,1495.0,ModificationType.MODIFY,410,198,237,31,55,97,441,11,63,38,72,74,110,414.62238298550506,683.0398702191846,6.2857142857142865,4293.39346994916,238.52185944162002,0.2276799567397282,False
1804,7e5ad314287a5c86856efea13c04333d7baf3643,/Users/sanika/Downloads/Master Thesis/repo_updated/pytest/testing/example_scripts/collect/package_infinite_recursion/__init__.pyi,5077.0,ModificationType.MODIFY,0,0,0,0,0,0,0,0,0,0,0,0,0,0.0,0.0,0.0,0.0,0.0,0.0,False
1805,7e5ad314287a5c86856efea13c04333d7baf3643,/Users/sanika/Downloads/Master Thesis/repo_updated/pytest/testing/example_scripts/collect/package_infinite_recursion/tests/__init__.py,5077.0,ModificationType.MODIFY,0,0,0,0,0,0,0,0,0,0,0,0,0,0.0,0.0,0.0,0.0,0.0,0.0,False
1806,7e5ad314287a5c86856efea13c04333d7baf3643,/Users/sanika/Downloads/Master Thesis/repo_updated/pytest/testing/example_scripts/collect/collect_init_tests/tests/__init__.py,5077.0,ModificationType.MODIFY,2,2,2,0,0,0,2,0,0,0,0,0,0,0.0,0.0,0.0,0.0,0.0,0.0,False
1807,7e5ad314287a5c86856efea13c04333d7baf3643,/Users/sanika/Downloads/Master Thesis/repo_updated/pytest/testing/example_scripts/collect/package_init_given_as_arg/pkg/__init__.py,5077.0,ModificationType.MODIFY,0,0,0,0,0,0,0,0,0,0,0,0,0,0.0,0.0,0.0,0.0,0.0,0.0,False
1808,7e5ad314287a5c86856efea13c04333d7baf3643,/Users/sanika/Downloads/Master Thesis/repo_updated/pytest/testing/example_scripts/conftest_usageerror/__init__.pyi,5077.0,ModificationType.MODIFY,0,0,0,0,0,0,0,0,0,0,0,0,0,0.0,0.0,0.0,0.0,0.0,0.0,False
1809,7e5ad314287a5c86856efea13c04333d7baf3643,/Users/sanika/Downloads/Master Thesis/repo_updated/pytest/testing/example_scripts/marks/marks_considered_keywords/__init__.pyi,5077.0,ModificationType.MODIFY,0,0,0,0,0,0,0,0,0,0,0,0,0,0.0,0.0,0.0,0.0,0.0,0.0,False
1810,7e5ad314287a5c86856efea13c04333d7baf3643,/Users/sanika/Downloads/Master Thesis/repo_updated/pytest/testing/example_scripts/config/collect_pytest_prefix/__init__.pyi,5077.0,ModificationType.MODIFY,0,0,0,0,0,0,0,0,0,0,0,0,0,0.0,0.0,0.0,0.0,0.0,0.0,False
1811,7e5ad314287a5c86856efea13c04333d7baf3643,/Users/sanika/Downloads/Master Thesis/repo_updated/pytest/testing/example_scripts/issue88_initial_file_multinodes/__init__.pyi,5077.0,ModificationType.MODIFY,0,0,0,0,0,0,0,0,0,0,0,0,0,0.0,0.0,0.0,0.0,0.0,0.0,False
1812,7e5ad314287a5c86856efea13c04333d7baf3643,/Users/sanika/Downloads/Master Thesis/repo_updated/pytest/testing/example_scripts/fixtures/fill_fixtures/test_extend_fixture_conftest_conftest/__init__.pyi,5077.0,ModificationType.MODIFY,0,0,0,0,0,0,0,0,0,0,0,0,0,0.0,0.0,0.0,0.0,0.0,0.0,False
1813,7e5ad314287a5c86856efea13c04333d7baf3643,/Users/sanika/Downloads/Master Thesis/repo_updated/pytest/testing/example_scripts/fixtures/fill_fixtures/test_extend_fixture_conftest_conftest/pkg/__init__.py,5077.0,ModificationType.MODIFY,0,0,0,0,0,0,0,0,0,0,0,0,0,0.0,0.0,0.0,0.0,0.0,0.0,False
1814,7e5ad314287a5c86856efea13c04333d7baf3643,/Users/sanika/Downloads/Master Thesis/repo_updated/pytest/testing/example_scripts/fixtures/fill_fixtures/test_extend_fixture_conftest_module/__init__.pyi,5077.0,ModificationType.MODIFY,0,0,0,0,0,0,0,0,0,0,0,0,0,0.0,0.0,0.0,0.0,0.0,0.0,False
1815,7e5ad314287a5c86856efea13c04333d7baf3643,/Users/sanika/Downloads/Master Thesis/repo_updated/pytest/testing/example_scripts/fixtures/fill_fixtures/test_conftest_funcargs_only_available_in_subdir/sub1/__init__.py,5077.0,ModificationType.MODIFY,0,0,0,0,0,0,0,0,0,0,0,0,0,0.0,0.0,0.0,0.0,0.0,0.0,False
1816,7e5ad314287a5c86856efea13c04333d7baf3643,/Users/sanika/Downloads/Master Thesis/repo_updated/pytest/testing/example_scripts/fixtures/fill_fixtures/test_conftest_funcargs_only_available_in_subdir/sub2/__init__.py,5077.0,ModificationType.MODIFY,0,0,0,0,0,0,0,0,0,0,0,0,0,0.0,0.0,0.0,0.0,0.0,0.0,False
1817,7e5ad314287a5c86856efea13c04333d7baf3643,/Users/sanika/Downloads/Master Thesis/repo_updated/pytest/testing/example_scripts/fixtures/custom_item/__init__.pyi,5077.0,ModificationType.MODIFY,0,0,0,0,0,0,0,0,0,0,0,0,0,0.0,0.0,0.0,0.0,0.0,0.0,False
1818,7e5ad314287a5c86856efea13c04333d7baf3643,/Users/sanika/Downloads/Master Thesis/repo_updated/pytest/testing/example_scripts/fixtures/custom_item/foo/__init__.py,5077.0,ModificationType.MODIFY,0,0,0,0,0,0,0,0,0,0,0,0,0,0.0,0.0,0.0,0.0,0.0,0.0,False
1819,7e5ad314287a5c86856efea13c04333d7baf3643,/Users/sanika/Downloads/Master Thesis/repo_updated/pytest/doc/en/example/nonpython/__init__.py,5077.0,ModificationType.MODIFY,0,0,0,0,0,0,0,0,0,0,0,0,0,0.0,0.0,0.0,0.0,0.0,0.0,False
1820,7e5ad314287a5c86856efea13c04333d7baf3643,/Users/sanika/Downloads/Master Thesis/repo_updated/pytest/src/pytest/__init__.py,5077.0,ModificationType.MODIFY,99,48,90,1,3,5,100,0,0,0,0,0,0,0.0,0.0,0.0,0.0,0.0,0.0,False
1821,7e5ad314287a5c86856efea13c04333d7baf3643,/Users/sanika/Downloads/Master Thesis/repo_updated/pytest/src/_pytest/__init__.py,5077.0,ModificationType.MODIFY,8,5,5,2,0,1,10,0,0,0,0,0,0,0.0,0.0,0.0,0.0,0.0,0.0,False
1822,7e5ad314287a5c86856efea13c04333d7baf3643,/Users/sanika/Downloads/Master Thesis/repo_updated/pytest/src/_pytest/config/__init__.py,5077.0,ModificationType.MODIFY,1217,716,841,84,126,174,1301,14,185,118,215,199,333,1446.608539104324,2542.995998641035,8.135135135135135,20687.616097052745,1149.3120053918194,0.847665332880345,False
1823,7e5ad314287a5c86856efea13c04333d7baf3643,/Users/sanika/Downloads/Master Thesis/repo_updated/pytest/src/_pytest/mark/__init__.py,5077.0,ModificationType.MODIFY,160,89,115,0,13,31,160,7,15,11,17,22,28,78.25484338853101,124.86408532184431,3.966666666666667,495.29420510998256,27.516344728332356,0.04162136177394811,False
1824,7e5ad314287a5c86856efea13c04333d7baf3643,/Users/sanika/Downloads/Master Thesis/repo_updated/pytest/src/_pytest/_code/__init__.py,5077.0,ModificationType.MODIFY,10,10,9,9,0,0,19,0,0,0,0,0,0,0.0,0.0,0.0,0.0,0.0,0.0,False
1825,7e5ad314287a5c86856efea13c04333d7baf3643,/Users/sanika/Downloads/Master Thesis/repo_updated/pytest/src/_pytest/assertion/__init__.py,5077.0,ModificationType.MODIFY,173,84,99,8,29,36,181,5,12,7,13,17,20,54.62919048309069,81.7492568250068,2.708333333333333,221.40423723439343,12.300235401910744,0.027249752275002263,False
1826,7e5ad314287a5c86856efea13c04333d7baf3643,/Users/sanika/Downloads/Master Thesis/repo_updated/pytest/src/_pytest/_io/__init__.py,5077.0,ModificationType.MODIFY,3,1,1,3,0,0,6,0,0,0,0,0,0,0.0,0.0,0.0,0.0,0.0,0.0,False
1827,7e5ad314287a5c86856efea13c04333d7baf3643,/Users/sanika/Downloads/Master Thesis/repo_updated/pytest/src/_pytest/config/argparsing.py,2328.0,ModificationType.MODIFY,463,295,324,28,62,57,491,12,134,82,154,146,236,989.8755015299953,1696.7985958956842,6.8955223880597005,11700.312706026956,650.0173725570531,0.565599531965228,False
1828,7e5ad314287a5c86856efea13c04333d7baf3643,/Users/sanika/Downloads/Master Thesis/repo_updated/pytest/src/_pytest/debugging.py,1477.0,ModificationType.MODIFY,339,213,244,17,9,65,356,10,42,26,48,52,74,259.6966127055816,421.83253914244085,5.7142857142857135,2410.4716522425188,133.91509179125106,0.1406108463808136,False
1829,7e5ad314287a5c86856efea13c04333d7baf3643,/Users/sanika/Downloads/Master Thesis/repo_updated/pytest/src/_pytest/deprecated.py,45.0,ModificationType.MODIFY,42,7,23,2,8,9,44,0,0,0,0,0,0,0.0,0.0,0.0,0.0,0.0,0.0,False
1830,7e5ad314287a5c86856efea13c04333d7baf3643,/Users/sanika/Downloads/Master Thesis/repo_updated/pytest/testing/test_doctest.py,2729.0,ModificationType.MODIFY,1455,414,1257,16,76,112,1471,5,41,23,46,46,69,231.26927266377825,381.12577496793386,2.804878048780488,1069.0113200320095,59.3895177795561,0.1270419249893113,False
1831,7e5ad314287a5c86856efea13c04333d7baf3643,/Users/sanika/Downloads/Master Thesis/repo_updated/pytest/src/_pytest/doctest.py,2729.0,ModificationType.MODIFY,669,365,481,22,61,110,691,15,103,63,122,118,185,747.3129132339992,1273.2889641319407,8.88349514563107,11311.256331851706,628.403129547317,0.4244296547106469,False
1832,7e5ad314287a5c86856efea13c04333d7baf3643,/Users/sanika/Downloads/Master Thesis/repo_updated/pytest/testing/python/fixtures.py,6261.0,ModificationType.MODIFY,4293,999,3693,19,54,507,4312,9,155,88,170,164,258,1156.3286078304875,1898.2484171914662,4.935483870967742,9368.774446138525,520.4874692299181,0.6327494723971553,False
1833,7e5ad314287a5c86856efea13c04333d7baf3643,/Users/sanika/Downloads/Master Thesis/repo_updated/pytest/src/_pytest/fixtures.py,6261.0,ModificationType.MODIFY,1482,859,1002,125,135,219,1607,16,219,134,251,235,385,1766.6783660526569,3032.459024427525,9.168949771689498,27804.46447968251,1544.692471093473,1.0108196748091751,False
1834,7e5ad314287a5c86856efea13c04333d7baf3643,/Users/sanika/Downloads/Master Thesis/repo_updated/pytest/testing/test_helpconfig.py,1070.0,ModificationType.MODIFY,74,35,59,1,0,14,75,3,14,7,14,17,21,58.057856410969926,85.83671966625714,1.5,128.75507949938572,7.153059972188095,0.028612239888752382,False
1835,7e5ad314287a5c86856efea13c04333d7baf3643,/Users/sanika/Downloads/Master Thesis/repo_updated/pytest/src/_pytest/helpconfig.py,1070.0,ModificationType.MODIFY,245,125,200,5,7,34,250,7,30,17,34,37,51,166.8582023226588,265.6821216470764,3.966666666666667,1053.8724158667364,58.548467548152026,0.08856070721569215,False
1836,7e5ad314287a5c86856efea13c04333d7baf3643,/Users/sanika/Downloads/Master Thesis/repo_updated/pytest/src/_pytest/hookspec.py,642.0,ModificationType.MODIFY,647,139,84,35,284,233,682,0,0,0,0,0,0,0.0,0.0,0.0,0.0,0.0,0.0,False
1837,7e5ad314287a5c86856efea13c04333d7baf3643,/Users/sanika/Downloads/Master Thesis/repo_updated/pytest/testing/test_junitxml.py,3197.0,ModificationType.MODIFY,1523,757,1297,19,12,193,1542,12,193,117,230,205,347,1508.3637582013935,2664.7795945283897,7.150259067357513,19053.86445828589,1058.5480254603274,0.8882598648427965,False
1838,7e5ad314287a5c86856efea13c04333d7baf3643,/Users/sanika/Downloads/Master Thesis/repo_updated/pytest/src/_pytest/junitxml.py,3197.0,ModificationType.MODIFY,701,378,504,33,58,109,734,13,110,68,126,123,194,794.0552848235468,1346.8478140358125,7.445454545454545,10027.894179048459,557.1052321693588,0.4489492713452708,False
1839,7e5ad314287a5c86856efea13c04333d7baf3643,/Users/sanika/Downloads/Master Thesis/repo_updated/pytest/src/_pytest/logging.py,2969.0,ModificationType.MODIFY,773,422,505,30,103,129,803,14,77,46,83,91,129,535.8455325423139,839.5055085856317,7.545454545454546,6334.450655691586,351.9139253161992,0.2798351695285439,False
1840,7e5ad314287a5c86856efea13c04333d7baf3643,/Users/sanika/Downloads/Master Thesis/repo_updated/pytest/testing/test_main.py,3505.0,ModificationType.MODIFY,77,34,69,0,0,8,77,3,24,16,29,27,45,114.79398751947123,213.9699375973561,1.8125,387.82051189520797,21.54558399417822,0.07132331253245204,False
1841,7e5ad314287a5c86856efea13c04333d7baf3643,/Users/sanika/Downloads/Master Thesis/repo_updated/pytest/src/_pytest/main.py,3505.0,ModificationType.MODIFY,712,438,573,51,9,84,763,14,102,71,128,116,199,733.8903537898989,1364.7382180303869,8.784313725490197,11988.288660345359,666.0160366858534,0.4549127393434623,False
1842,7e5ad314287a5c86856efea13c04333d7baf3643,/Users/sanika/Downloads/Master Thesis/repo_updated/pytest/testing/example_scripts/collect/package_infinite_recursion/__init__.pyi,608.0,ModificationType.MODIFY,0,0,0,0,0,0,0,0,0,0,0,0,0,0.0,0.0,0.0,0.0,0.0,0.0,False
1843,7e5ad314287a5c86856efea13c04333d7baf3643,/Users/sanika/Downloads/Master Thesis/repo_updated/pytest/testing/example_scripts/collect/package_infinite_recursion/tests/__init__.py,608.0,ModificationType.MODIFY,0,0,0,0,0,0,0,0,0,0,0,0,0,0.0,0.0,0.0,0.0,0.0,0.0,False
1844,7e5ad314287a5c86856efea13c04333d7baf3643,/Users/sanika/Downloads/Master Thesis/repo_updated/pytest/testing/example_scripts/collect/collect_init_tests/tests/__init__.py,608.0,ModificationType.MODIFY,2,2,2,0,0,0,2,0,0,0,0,0,0,0.0,0.0,0.0,0.0,0.0,0.0,False
1845,7e5ad314287a5c86856efea13c04333d7baf3643,/Users/sanika/Downloads/Master Thesis/repo_updated/pytest/testing/example_scripts/collect/package_init_given_as_arg/pkg/__init__.py,608.0,ModificationType.MODIFY,0,0,0,0,0,0,0,0,0,0,0,0,0,0.0,0.0,0.0,0.0,0.0,0.0,False
1846,7e5ad314287a5c86856efea13c04333d7baf3643,/Users/sanika/Downloads/Master Thesis/repo_updated/pytest/testing/example_scripts/conftest_usageerror/__init__.pyi,608.0,ModificationType.MODIFY,0,0,0,0,0,0,0,0,0,0,0,0,0,0.0,0.0,0.0,0.0,0.0,0.0,False
1847,7e5ad314287a5c86856efea13c04333d7baf3643,/Users/sanika/Downloads/Master Thesis/repo_updated/pytest/testing/example_scripts/marks/marks_considered_keywords/__init__.pyi,608.0,ModificationType.MODIFY,0,0,0,0,0,0,0,0,0,0,0,0,0,0.0,0.0,0.0,0.0,0.0,0.0,False
1848,7e5ad314287a5c86856efea13c04333d7baf3643,/Users/sanika/Downloads/Master Thesis/repo_updated/pytest/testing/example_scripts/config/collect_pytest_prefix/__init__.pyi,608.0,ModificationType.MODIFY,0,0,0,0,0,0,0,0,0,0,0,0,0,0.0,0.0,0.0,0.0,0.0,0.0,False
1849,7e5ad314287a5c86856efea13c04333d7baf3643,/Users/sanika/Downloads/Master Thesis/repo_updated/pytest/testing/example_scripts/issue88_initial_file_multinodes/__init__.pyi,608.0,ModificationType.MODIFY,0,0,0,0,0,0,0,0,0,0,0,0,0,0.0,0.0,0.0,0.0,0.0,0.0,False
1850,7e5ad314287a5c86856efea13c04333d7baf3643,/Users/sanika/Downloads/Master Thesis/repo_updated/pytest/testing/example_scripts/fixtures/fill_fixtures/test_extend_fixture_conftest_conftest/__init__.pyi,608.0,ModificationType.MODIFY,0,0,0,0,0,0,0,0,0,0,0,0,0,0.0,0.0,0.0,0.0,0.0,0.0,False
1851,7e5ad314287a5c86856efea13c04333d7baf3643,/Users/sanika/Downloads/Master Thesis/repo_updated/pytest/testing/example_scripts/fixtures/fill_fixtures/test_extend_fixture_conftest_conftest/pkg/__init__.py,608.0,ModificationType.MODIFY,0,0,0,0,0,0,0,0,0,0,0,0,0,0.0,0.0,0.0,0.0,0.0,0.0,False
1852,7e5ad314287a5c86856efea13c04333d7baf3643,/Users/sanika/Downloads/Master Thesis/repo_updated/pytest/testing/example_scripts/fixtures/fill_fixtures/test_extend_fixture_conftest_module/__init__.pyi,608.0,ModificationType.MODIFY,0,0,0,0,0,0,0,0,0,0,0,0,0,0.0,0.0,0.0,0.0,0.0,0.0,False
1853,7e5ad314287a5c86856efea13c04333d7baf3643,/Users/sanika/Downloads/Master Thesis/repo_updated/pytest/testing/example_scripts/fixtures/fill_fixtures/test_conftest_funcargs_only_available_in_subdir/sub1/__init__.py,608.0,ModificationType.MODIFY,0,0,0,0,0,0,0,0,0,0,0,0,0,0.0,0.0,0.0,0.0,0.0,0.0,False
1854,7e5ad314287a5c86856efea13c04333d7baf3643,/Users/sanika/Downloads/Master Thesis/repo_updated/pytest/testing/example_scripts/fixtures/fill_fixtures/test_conftest_funcargs_only_available_in_subdir/sub2/__init__.py,608.0,ModificationType.MODIFY,0,0,0,0,0,0,0,0,0,0,0,0,0,0.0,0.0,0.0,0.0,0.0,0.0,False
1855,7e5ad314287a5c86856efea13c04333d7baf3643,/Users/sanika/Downloads/Master Thesis/repo_updated/pytest/testing/example_scripts/fixtures/custom_item/__init__.pyi,608.0,ModificationType.MODIFY,0,0,0,0,0,0,0,0,0,0,0,0,0,0.0,0.0,0.0,0.0,0.0,0.0,False
1856,7e5ad314287a5c86856efea13c04333d7baf3643,/Users/sanika/Downloads/Master Thesis/repo_updated/pytest/testing/example_scripts/fixtures/custom_item/foo/__init__.py,608.0,ModificationType.MODIFY,0,0,0,0,0,0,0,0,0,0,0,0,0,0.0,0.0,0.0,0.0,0.0,0.0,False
1857,7e5ad314287a5c86856efea13c04333d7baf3643,/Users/sanika/Downloads/Master Thesis/repo_updated/pytest/doc/en/example/nonpython/__init__.py,608.0,ModificationType.MODIFY,0,0,0,0,0,0,0,0,0,0,0,0,0,0.0,0.0,0.0,0.0,0.0,0.0,False
1858,7e5ad314287a5c86856efea13c04333d7baf3643,/Users/sanika/Downloads/Master Thesis/repo_updated/pytest/src/pytest/__init__.py,608.0,ModificationType.MODIFY,99,48,90,1,3,5,100,0,0,0,0,0,0,0.0,0.0,0.0,0.0,0.0,0.0,False
1859,7e5ad314287a5c86856efea13c04333d7baf3643,/Users/sanika/Downloads/Master Thesis/repo_updated/pytest/src/_pytest/__init__.py,608.0,ModificationType.MODIFY,8,5,5,2,0,1,10,0,0,0,0,0,0,0.0,0.0,0.0,0.0,0.0,0.0,False
1860,7e5ad314287a5c86856efea13c04333d7baf3643,/Users/sanika/Downloads/Master Thesis/repo_updated/pytest/src/_pytest/config/__init__.py,608.0,ModificationType.MODIFY,1217,716,841,84,126,174,1301,14,185,118,215,199,333,1446.608539104324,2542.995998641035,8.135135135135135,20687.616097052745,1149.3120053918194,0.847665332880345,False
1861,7e5ad314287a5c86856efea13c04333d7baf3643,/Users/sanika/Downloads/Master Thesis/repo_updated/pytest/src/_pytest/mark/__init__.py,608.0,ModificationType.MODIFY,160,89,115,0,13,31,160,7,15,11,17,22,28,78.25484338853101,124.86408532184431,3.966666666666667,495.29420510998256,27.516344728332356,0.04162136177394811,False
1862,7e5ad314287a5c86856efea13c04333d7baf3643,/Users/sanika/Downloads/Master Thesis/repo_updated/pytest/src/_pytest/_code/__init__.py,608.0,ModificationType.MODIFY,10,10,9,9,0,0,19,0,0,0,0,0,0,0.0,0.0,0.0,0.0,0.0,0.0,False
1863,7e5ad314287a5c86856efea13c04333d7baf3643,/Users/sanika/Downloads/Master Thesis/repo_updated/pytest/src/_pytest/assertion/__init__.py,608.0,ModificationType.MODIFY,173,84,99,8,29,36,181,5,12,7,13,17,20,54.62919048309069,81.7492568250068,2.708333333333333,221.40423723439343,12.300235401910744,0.027249752275002263,False
1864,7e5ad314287a5c86856efea13c04333d7baf3643,/Users/sanika/Downloads/Master Thesis/repo_updated/pytest/src/_pytest/_io/__init__.py,608.0,ModificationType.MODIFY,3,1,1,3,0,0,6,0,0,0,0,0,0,0.0,0.0,0.0,0.0,0.0,0.0,False
1865,7e5ad314287a5c86856efea13c04333d7baf3643,/Users/sanika/Downloads/Master Thesis/repo_updated/pytest/src/_pytest/mark/structures.py,1500.0,ModificationType.MODIFY,402,202,227,24,74,80,426,12,52,33,61,64,94,339.4424153519907,564.0,7.038461538461537,3969.6923076923076,220.53846153846158,0.188,False
1866,7e5ad314287a5c86856efea13c04333d7baf3643,/Users/sanika/Downloads/Master Thesis/repo_updated/pytest/testing/test_nodes.py,1873.0,ModificationType.MODIFY,53,23,39,0,0,13,53,2,8,4,8,10,12,26.0,39.863137138648355,1.0,39.863137138648355,2.2146187299249087,0.013287712379549451,False
1867,7e5ad314287a5c86856efea13c04333d7baf3643,/Users/sanika/Downloads/Master Thesis/repo_updated/pytest/src/_pytest/nodes.py,1873.0,ModificationType.MODIFY,515,298,307,33,80,99,548,12,63,44,77,75,121,419.5881851891487,753.6870615500015,7.333333333333332,5527.038451366679,307.0576917425932,0.2512290205166672,False
1868,7e5ad314287a5c86856efea13c04333d7baf3643,/Users/sanika/Downloads/Master Thesis/repo_updated/pytest/testing/test_pathlib.py,1561.0,ModificationType.MODIFY,91,45,69,0,3,18,91,3,9,6,10,12,16,33.28421251514428,57.3594000115385,1.6666666666666667,95.59900001923084,5.311055556623936,0.01911980000384617,False
1869,7e5ad314287a5c86856efea13c04333d7baf3643,/Users/sanika/Downloads/Master Thesis/repo_updated/pytest/src/_pytest/pathlib.py,1561.0,ModificationType.MODIFY,367,234,237,17,34,68,384,16,55,34,61,71,95,381.9747842438563,584.2259763529447,8.872727272727273,5183.677753822492,287.98209743458284,0.19474199211764828,False
1870,7e5ad314287a5c86856efea13c04333d7baf3643,/Users/sanika/Downloads/Master Thesis/repo_updated/pytest/testing/test_pytester.py,6346.0,ModificationType.MODIFY,722,423,573,19,0,135,741,12,172,101,199,184,300,1320.3370878174146,2257.068586817104,6.941860465116278,15668.255189881524,870.4586216600846,0.7523561956057013,False
1871,7e5ad314287a5c86856efea13c04333d7baf3643,/Users/sanika/Downloads/Master Thesis/repo_updated/pytest/src/_pytest/pytester.py,6346.0,ModificationType.MODIFY,1508,847,911,44,250,301,1552,14,148,88,169,162,257,1120.302067021891,1886.3414507413486,7.993243243243242,15077.986055587939,837.6658919771077,0.6287804835804495,False
1872,7e5ad314287a5c86856efea13c04333d7baf3643,/Users/sanika/Downloads/Master Thesis/repo_updated/pytest/doc/en/example/multipython.py,6662.0,ModificationType.MODIFY,72,33,56,0,4,12,72,1,1,1,1,2,2,0.0,2.0,0.5,1.0,0.05555555555555555,0.0006666666666666666,False
1873,7e5ad314287a5c86856efea13c04333d7baf3643,/Users/sanika/Downloads/Master Thesis/repo_updated/pytest/src/_pytest/python.py,6662.0,ModificationType.MODIFY,1454,835,1044,76,110,219,1530,17,275,158,296,292,454,2297.8910156145625,3718.1803497315277,9.149090909090908,34017.97003608918,1889.8872242271768,1.2393934499105097,False
1874,7e5ad314287a5c86856efea13c04333d7baf3643,/Users/sanika/Downloads/Master Thesis/repo_updated/pytest/src/_pytest/python_api.py,1970.0,ModificationType.MODIFY,757,253,292,73,244,162,830,13,61,38,67,74,105,409.88069392717034,651.9926033910399,7.139344262295082,4654.799652078655,258.5999806710363,0.2173308677970133,False
1875,7e5ad314287a5c86856efea13c04333d7baf3643,/Users/sanika/Downloads/Master Thesis/repo_updated/pytest/testing/test_recwarn.py,989.0,ModificationType.MODIFY,386,256,301,16,9,68,402,4,59,35,69,63,104,355.07593991234864,621.6371120439914,2.3389830508474576,1453.9986688486576,80.77770382492542,0.20721237068133044,False
1876,7e5ad314287a5c86856efea13c04333d7baf3643,/Users/sanika/Downloads/Master Thesis/repo_updated/pytest/src/_pytest/recwarn.py,989.0,ModificationType.MODIFY,264,131,164,11,41,46,275,6,38,22,40,44,62,214.93102051518318,338.48476035551244,3.1578947368421053,1068.899243227934,59.38329129044078,0.11282825345183747,False
1877,7e5ad314287a5c86856efea13c04333d7baf3643,/Users/sanika/Downloads/Master Thesis/repo_updated/pytest/testing/test_reports.py,1993.0,ModificationType.MODIFY,466,257,367,18,25,50,484,7,126,86,171,133,257,898.7887548153927,1813.2075859238055,4.75,8612.736033138077,478.4853351743376,0.6044025286412685,False
1878,7e5ad314287a5c86856efea13c04333d7baf3643,/Users/sanika/Downloads/Master Thesis/repo_updated/pytest/src/_pytest/reports.py,1993.0,ModificationType.MODIFY,507,281,342,29,59,88,536,10,53,29,57,63,86,336.7990650407233,514.0460734209928,5.377358490566038,2764.2100174525085,153.56722319180602,0.17134869114033094,False
1879,7e5ad314287a5c86856efea13c04333d7baf3643,/Users/sanika/Downloads/Master Thesis/repo_updated/pytest/testing/test_runner.py,1930.0,ModificationType.MODIFY,1043,504,840,53,9,147,1096,9,180,112,198,189,310,1377.0628823523223,2344.2951515085324,4.95,11604.260999967237,644.6811666648464,0.7814317171695108,False
1880,7e5ad314287a5c86856efea13c04333d7baf3643,/Users/sanika/Downloads/Master Thesis/repo_updated/pytest/src/_pytest/runner.py,1930.0,ModificationType.MODIFY,383,288,292,26,6,62,409,11,65,38,67,76,105,429.5076556518598,656.0323889115765,5.6692307692307695,3719.1990048294756,206.6221669349709,0.2186774629705255,False
1881,7e5ad314287a5c86856efea13c04333d7baf3643,/Users/sanika/Downloads/Master Thesis/repo_updated/pytest/testing/test_setuponly.py,378.0,ModificationType.MODIFY,294,64,250,0,0,43,294,1,20,10,20,21,30,86.43856189774725,131.7695226833628,0.5,65.8847613416814,3.660264518982301,0.04392317422778761,False
1882,7e5ad314287a5c86856efea13c04333d7baf3643,/Users/sanika/Downloads/Master Thesis/repo_updated/pytest/src/_pytest/setuponly.py,378.0,ModificationType.MODIFY,78,46,62,3,0,14,81,3,8,4,8,11,12,28.754887502163466,41.51317942364757,1.5,62.269769135471364,3.4594316186372978,0.013837726474549191,False
1883,7e5ad314287a5c86856efea13c04333d7baf3643,/Users/sanika/Downloads/Master Thesis/repo_updated/pytest/testing/test_skipping.py,786.0,ModificationType.MODIFY,1178,367,1042,6,15,115,1184,9,94,51,95,103,146,644.6606770706788,976.22907696875,4.547872340425532,4439.7652170653255,246.65362317029587,0.3254096923229167,False
1884,7e5ad314287a5c86856efea13c04333d7baf3643,/Users/sanika/Downloads/Master Thesis/repo_updated/pytest/src/_pytest/skipping.py,786.0,ModificationType.MODIFY,177,108,140,8,0,27,185,6,30,16,32,36,48,162.7164928725825,248.15640006923095,3.2,794.1004802215393,44.11669334564107,0.082718800023077,False
1885,7e5ad314287a5c86856efea13c04333d7baf3643,/Users/sanika/Downloads/Master Thesis/repo_updated/pytest/testing/test_terminal.py,6416.0,ModificationType.MODIFY,1943,715,1694,26,18,214,1969,12,185,120,237,197,357,1436.3251202041715,2721.0724995459263,7.686486486486486,20915.486996509768,1161.971499806098,0.9070241665153088,False
1886,7e5ad314287a5c86856efea13c04333d7baf3643,/Users/sanika/Downloads/Master Thesis/repo_updated/pytest/src/_pytest/terminal.py,6416.0,ModificationType.MODIFY,1168,838,957,57,25,144,1225,19,348,224,416,367,640,3018.854959310786,5452.567201819657,11.35632183908046,61921.107993078396,3440.0615551710216,1.817522400606552,False
1887,7e5ad314287a5c86856efea13c04333d7baf3643,/Users/sanika/Downloads/Master Thesis/repo_updated/pytest/testing/test_tmpdir.py,704.0,ModificationType.MODIFY,442,244,305,14,16,103,456,11,68,45,75,79,120,452.00122101003336,756.4536897812525,6.066176470588236,4588.781574040686,254.932309668927,0.2521512299270841,False
1888,7e5ad314287a5c86856efea13c04333d7baf3643,/Users/sanika/Downloads/Master Thesis/repo_updated/pytest/src/_pytest/tmpdir.py,704.0,ModificationType.MODIFY,182,102,99,11,40,35,193,3,11,6,11,14,17,42.808635307173745,64.72503367497926,1.5,97.08755051246887,5.393752806248272,0.021575011224993085,False
1889,7e5ad314287a5c86856efea13c04333d7baf3643,/Users/sanika/Downloads/Master Thesis/repo_updated/pytest/testing/test_warning_types.py,222.0,ModificationType.MODIFY,37,13,25,0,6,6,37,1,2,1,2,3,3,2.0,4.754887502163468,0.5,2.3774437510817346,0.1320802083934297,0.0015849625007211565,False
1890,7e5ad314287a5c86856efea13c04333d7baf3643,/Users/sanika/Downloads/Master Thesis/repo_updated/pytest/src/_pytest/warning_types.py,222.0,ModificationType.MODIFY,133,47,40,1,43,49,134,0,0,0,0,0,0,0.0,0.0,0.0,0.0,0.0,0.0,False
1891,7e5ad314287a5c86856efea13c04333d7baf3643,/Users/sanika/Downloads/Master Thesis/repo_updated/pytest/testing/test_warnings.py,625.0,ModificationType.MODIFY,601,196,481,2,23,85,603,8,63,36,72,71,108,400.5686351804948,664.1726889065056,4.571428571428571,3036.21800642974,168.67877813498555,0.22139089630216852,False
1892,7e5ad314287a5c86856efea13c04333d7baf3643,/Users/sanika/Downloads/Master Thesis/repo_updated/pytest/src/_pytest/warnings.py,625.0,ModificationType.MODIFY,156,79,106,5,16,28,161,5,14,8,15,19,23,64.91260938324325,97.70233280920246,2.6785714285714284,261.7026771675066,14.539037620417032,0.03256744426973415,False
1893,7e5ad314287a5c86856efea13c04333d7baf3643,/Users/sanika/Downloads/Master Thesis/repo_updated/pytest/testing/acceptance_test.py,4666.0,ModificationType.MODIFY,1289,550,1043,56,32,155,1345,10,167,93,185,177,278,1266.2978977920407,2075.994342923073,5.538922155688622,11498.771061100857,638.8206145056031,0.6919981143076911,False
1894,7e5ad314287a5c86856efea13c04333d7baf3643,/Users/sanika/Downloads/Master Thesis/repo_updated/pytest/testing/code/test_code.py,1010.0,ModificationType.MODIFY,182,127,129,0,0,53,182,5,39,21,42,44,63,217.7403270100645,343.9441919741497,2.6923076923076925,926.003593776557,51.44464409869761,0.11464806399138325,False
1895,7e5ad314287a5c86856efea13c04333d7baf3643,/Users/sanika/Downloads/Master Thesis/repo_updated/pytest/testing/code/test_excinfo.py,6943.0,ModificationType.MODIFY,1392,870,1177,35,17,170,1427,14,494,280,531,508,811,4473.796381311637,7289.823280972227,7.5242914979757085,54850.755334764704,3047.2641852647052,2.4299410936574084,False
1896,7e5ad314287a5c86856efea13c04333d7baf3643,/Users/sanika/Downloads/Master Thesis/repo_updated/pytest/testing/code/test_source.py,3088.0,ModificationType.MODIFY,773,419,590,28,0,166,801,10,204,113,217,214,330,1598.3940507110583,2554.6841055123778,5.318627450980392,13587.413012161423,754.8562784534123,0.8515613685041261,False
1897,7e5ad314287a5c86856efea13c04333d7baf3643,/Users/sanika/Downloads/Master Thesis/repo_updated/pytest/testing/conftest.py,400.0,ModificationType.MODIFY,127,75,83,2,11,30,129,4,14,7,14,18,21,61.302968908806456,87.56842503028854,2.0,175.13685006057707,9.729825003365397,0.02918947501009618,False
1898,7e5ad314287a5c86856efea13c04333d7baf3643,/Users/sanika/Downloads/Master Thesis/repo_updated/pytest/testing/test_conftest.py,400.0,ModificationType.MODIFY,652,304,544,16,6,88,668,6,89,51,101,95,152,591.8500503603364,998.618052466304,3.4044943820224716,3399.789549407755,188.87719718931967,0.3328726841554347,False
1899,7e5ad314287a5c86856efea13c04333d7baf3643,/Users/sanika/Downloads/Master Thesis/repo_updated/pytest/testing/example_scripts/collect/package_infinite_recursion/conftest.py,400.0,ModificationType.MODIFY,2,2,2,0,0,0,2,0,0,0,0,0,0,0.0,0.0,0.0,0.0,0.0,0.0,False
1900,7e5ad314287a5c86856efea13c04333d7baf3643,/Users/sanika/Downloads/Master Thesis/repo_updated/pytest/testing/example_scripts/conftest_usageerror/conftest.py,400.0,ModificationType.MODIFY,8,5,5,0,0,3,8,0,0,0,0,0,0,0.0,0.0,0.0,0.0,0.0,0.0,False
1901,7e5ad314287a5c86856efea13c04333d7baf3643,/Users/sanika/Downloads/Master Thesis/repo_updated/pytest/testing/example_scripts/marks/marks_considered_keywords/conftest.py,400.0,ModificationType.MODIFY,0,0,0,0,0,0,0,0,0,0,0,0,0,0.0,0.0,0.0,0.0,0.0,0.0,False
1902,7e5ad314287a5c86856efea13c04333d7baf3643,/Users/sanika/Downloads/Master Thesis/repo_updated/pytest/testing/example_scripts/config/collect_pytest_prefix/conftest.py,400.0,ModificationType.MODIFY,2,2,2,0,0,0,2,0,0,0,0,0,0,0.0,0.0,0.0,0.0,0.0,0.0,False
1903,7e5ad314287a5c86856efea13c04333d7baf3643,/Users/sanika/Downloads/Master Thesis/repo_updated/pytest/testing/example_scripts/issue88_initial_file_multinodes/conftest.py,400.0,ModificationType.MODIFY,14,8,8,0,0,6,14,0,0,0,0,0,0,0.0,0.0,0.0,0.0,0.0,0.0,False
1904,7e5ad314287a5c86856efea13c04333d7baf3643,/Users/sanika/Downloads/Master Thesis/repo_updated/pytest/testing/example_scripts/fixtures/fill_fixtures/test_extend_fixture_conftest_conftest/conftest.py,400.0,ModificationType.MODIFY,6,4,4,0,0,2,6,0,0,0,0,0,0,0.0,0.0,0.0,0.0,0.0,0.0,False
1905,7e5ad314287a5c86856efea13c04333d7baf3643,/Users/sanika/Downloads/Master Thesis/repo_updated/pytest/testing/example_scripts/fixtures/fill_fixtures/test_extend_fixture_conftest_conftest/pkg/conftest.py,400.0,ModificationType.MODIFY,6,4,4,0,0,2,6,1,2,1,2,3,3,2.0,4.754887502163468,0.5,2.3774437510817346,0.1320802083934297,0.0015849625007211565,False
1906,7e5ad314287a5c86856efea13c04333d7baf3643,/Users/sanika/Downloads/Master Thesis/repo_updated/pytest/testing/example_scripts/fixtures/fill_fixtures/test_extend_fixture_conftest_module/conftest.py,400.0,ModificationType.MODIFY,6,4,4,0,0,2,6,0,0,0,0,0,0,0.0,0.0,0.0,0.0,0.0,0.0,False
1907,7e5ad314287a5c86856efea13c04333d7baf3643,/Users/sanika/Downloads/Master Thesis/repo_updated/pytest/testing/example_scripts/fixtures/fill_fixtures/test_conftest_funcargs_only_available_in_subdir/sub1/conftest.py,400.0,ModificationType.MODIFY,7,5,5,0,0,2,7,0,0,0,0,0,0,0.0,0.0,0.0,0.0,0.0,0.0,False
1908,7e5ad314287a5c86856efea13c04333d7baf3643,/Users/sanika/Downloads/Master Thesis/repo_updated/pytest/testing/example_scripts/fixtures/fill_fixtures/test_conftest_funcargs_only_available_in_subdir/sub2/conftest.py,400.0,ModificationType.MODIFY,6,4,4,0,0,2,6,0,0,0,0,0,0,0.0,0.0,0.0,0.0,0.0,0.0,False
1909,7e5ad314287a5c86856efea13c04333d7baf3643,/Users/sanika/Downloads/Master Thesis/repo_updated/pytest/testing/example_scripts/fixtures/custom_item/conftest.py,400.0,ModificationType.MODIFY,10,6,6,0,0,4,10,0,0,0,0,0,0,0.0,0.0,0.0,0.0,0.0,0.0,False
1910,7e5ad314287a5c86856efea13c04333d7baf3643,/Users/sanika/Downloads/Master Thesis/repo_updated/pytest/doc/en/conftest.py,400.0,ModificationType.MODIFY,1,1,1,0,0,0,1,0,0,0,0,0,0,0.0,0.0,0.0,0.0,0.0,0.0,False
1911,7e5ad314287a5c86856efea13c04333d7baf3643,/Users/sanika/Downloads/Master Thesis/repo_updated/pytest/doc/en/example/conftest.py,400.0,ModificationType.MODIFY,1,1,1,0,0,0,1,0,0,0,0,0,0,0.0,0.0,0.0,0.0,0.0,0.0,False
1912,7e5ad314287a5c86856efea13c04333d7baf3643,/Users/sanika/Downloads/Master Thesis/repo_updated/pytest/doc/en/example/assertion/global_testmodule_config/conftest.py,400.0,ModificationType.MODIFY,14,10,10,0,0,4,14,1,1,1,1,2,2,0.0,2.0,0.5,1.0,0.05555555555555555,0.0006666666666666666,False
1913,7e5ad314287a5c86856efea13c04333d7baf3643,/Users/sanika/Downloads/Master Thesis/repo_updated/pytest/doc/en/example/nonpython/conftest.py,400.0,ModificationType.MODIFY,46,26,30,3,0,12,49,3,6,3,6,9,9,20.264662506490406,28.52932501298081,1.5,42.79398751947122,2.377443751081734,0.009509775004326938,False
1914,7e5ad314287a5c86856efea13c04333d7baf3643,/Users/sanika/Downloads/Master Thesis/repo_updated/pytest/testing/deprecated_test.py,265.0,ModificationType.MODIFY,75,38,59,1,3,12,76,2,4,2,4,6,6,10.0,15.509775004326935,1.0,15.509775004326935,0.861654166907052,0.005169925001442312,False
1915,7e5ad314287a5c86856efea13c04333d7baf3643,/Users/sanika/Downloads/Master Thesis/repo_updated/pytest/testing/io/test_saferepr.py,694.0,ModificationType.MODIFY,149,95,105,2,0,41,151,8,54,28,55,62,83,334.7639251168273,494.1982937621106,4.0740740740740735,2013.4004560678586,111.8555808926588,0.1647327645873702,False
1916,7e5ad314287a5c86856efea13c04333d7baf3643,/Users/sanika/Downloads/Master Thesis/repo_updated/pytest/testing/logging/test_fixture.py,696.0,ModificationType.MODIFY,139,89,101,2,0,35,141,7,54,34,62,61,96,330.4154095712305,569.3507844060372,4.018518518518518,2287.9466706687044,127.10814837048358,0.18978359480201235,False
1917,7e5ad314287a5c86856efea13c04333d7baf3643,/Users/sanika/Downloads/Master Thesis/repo_updated/pytest/testing/logging/test_formatter.py,501.0,ModificationType.MODIFY,149,67,118,4,0,27,153,1,17,14,28,18,42,69.48686830125578,175.13685006057707,0.8235294117647058,144.23034710871056,8.01279706159503,0.058378950020192374,False
1918,7e5ad314287a5c86856efea13c04333d7baf3643,/Users/sanika/Downloads/Master Thesis/repo_updated/pytest/testing/logging/test_reporting.py,2589.0,ModificationType.MODIFY,1157,318,931,29,22,177,1186,6,104,63,125,110,188,712.3555056910004,1274.895626142636,3.6057692307692313,4596.9794211873905,255.38774562152162,0.424965208714212,False
1919,7e5ad314287a5c86856efea13c04333d7baf3643,/Users/sanika/Downloads/Master Thesis/repo_updated/pytest/testing/python/approx.py,4372.0,ModificationType.MODIFY,520,294,400,33,13,81,553,10,261,204,367,271,571,2128.502746053614,4614.9071026130605,7.030651340996169,32445.802809559264,1802.5446005310705,1.5383023675376872,False
1920,7e5ad314287a5c86856efea13c04333d7baf3643,/Users/sanika/Downloads/Master Thesis/repo_updated/pytest/testing/python/collect.py,3928.0,ModificationType.MODIFY,1338,495,1086,10,64,173,1348,11,122,82,157,133,239,883.6037029876825,1686.2125020847845,7.077868852459017,11934.79094713288,663.0439415073823,0.5620708340282614,False
1921,7e5ad314287a5c86856efea13c04333d7baf3643,/Users/sanika/Downloads/Master Thesis/repo_updated/pytest/testing/python/fixtures.py,8005.0,ModificationType.MODIFY,4293,999,3693,19,54,507,4312,9,155,88,170,164,258,1156.3286078304875,1898.2484171914662,4.935483870967742,9368.774446138525,520.4874692299181,0.6327494723971553,False
1922,7e5ad314287a5c86856efea13c04333d7baf3643,/Users/sanika/Downloads/Master Thesis/repo_updated/pytest/src/_pytest/fixtures.py,8005.0,ModificationType.MODIFY,1482,859,1002,125,135,219,1607,16,219,134,251,235,385,1766.6783660526569,3032.459024427525,9.168949771689498,27804.46447968251,1544.692471093473,1.0108196748091751,False
1923,7e5ad314287a5c86856efea13c04333d7baf3643,/Users/sanika/Downloads/Master Thesis/repo_updated/pytest/testing/python/metafunc.py,5907.0,ModificationType.MODIFY,1782,648,1425,9,47,279,1791,8,171,97,189,179,286,1292.4527800454887,2140.3713122975773,4.421052631578949,9462.69422278929,525.705234599405,0.7134571040991925,False
1924,7e5ad314287a5c86856efea13c04333d7baf3643,/Users/sanika/Downloads/Master Thesis/repo_updated/pytest/testing/python/raises.py,921.0,ModificationType.MODIFY,256,139,192,9,7,47,265,4,23,12,24,27,36,112.0419249893113,171.1759500778849,2.0869565217391304,357.2367653799337,19.846486965551872,0.057058650025961624,False
1925,7e5ad314287a5c86856efea13c04333d7baf3643,/Users/sanika/Downloads/Master Thesis/repo_updated/pytest/testing/python/show_fixtures_per_test.py,322.0,ModificationType.MODIFY,180,34,164,0,0,16,180,1,12,6,12,13,18,43.01955000865388,66.60791492653966,0.5,33.30395746326983,1.8502198590705463,0.02220263830884656,False
1926,7e5ad314287a5c86856efea13c04333d7baf3643,/Users/sanika/Downloads/Master Thesis/repo_updated/pytest/testing/test_assertion.py,5424.0,ModificationType.MODIFY,1450,624,1228,12,26,181,1462,14,306,186,354,320,540,2580.063648772758,4493.841171239174,8.098039215686274,36391.30203376038,2021.7390018755768,1.4979470570797249,False
1927,7e5ad314287a5c86856efea13c04333d7baf3643,/Users/sanika/Downloads/Master Thesis/repo_updated/pytest/testing/test_assertrewrite.py,6342.0,ModificationType.MODIFY,1660,832,1314,41,38,274,1701,20,312,209,395,332,604,2671.484054182769,5058.523816533542,12.660256410256409,64042.208574703494,3557.900476372417,1.6861746055111808,False
1928,7e5ad314287a5c86856efea13c04333d7baf3643,/Users/sanika/Downloads/Master Thesis/repo_updated/pytest/testing/test_cacheprovider.py,3873.0,ModificationType.MODIFY,996,429,845,24,10,117,1020,7,76,50,88,83,138,494.49397547611574,879.7554415258757,4.052631578947368,3565.324684078549,198.07359355991935,0.2932518138419585,False
1929,7e5ad314287a5c86856efea13c04333d7baf3643,/Users/sanika/Downloads/Master Thesis/repo_updated/pytest/testing/test_capture.py,4986.0,ModificationType.MODIFY,1513,682,1277,25,13,200,1538,11,199,116,219,210,335,1557.7420472931965,2584.272248418151,6.052763819095478,15641.989563917903,868.9994202176613,0.8614240828060503,False
1930,7e5ad314287a5c86856efea13c04333d7baf3643,/Users/sanika/Downloads/Master Thesis/repo_updated/pytest/testing/test_collection.py,5062.0,ModificationType.MODIFY,1296,573,1062,40,33,157,1336,8,201,118,231,209,349,1561.8613899269644,2689.868337096228,4.597014925373134,12365.364892919973,686.9647162733319,0.896622779032076,False
1931,7e5ad314287a5c86856efea13c04333d7baf3643,/Users/sanika/Downloads/Master Thesis/repo_updated/pytest/testing/test_compat.py,591.0,ModificationType.MODIFY,207,111,150,11,0,50,218,5,26,19,36,31,55,133.82107314610522,272.4807970712782,3.4615384615384617,943.202759092886,52.400153282938106,0.09082693235709273,False
1932,7e5ad314287a5c86856efea13c04333d7baf3643,/Users/sanika/Downloads/Master Thesis/repo_updated/pytest/testing/test_config.py,6058.0,ModificationType.MODIFY,1457,730,1242,11,6,188,1468,10,292,166,329,302,495,2424.648052141839,4078.0103459659135,5.633561643835616,22973.722668198385,1276.3179260110217,1.359336781988638,False
1933,7e5ad314287a5c86856efea13c04333d7baf3643,/Users/sanika/Downloads/Master Thesis/repo_updated/pytest/testing/test_conftest.py,2850.0,ModificationType.MODIFY,652,304,544,16,6,88,668,6,89,51,101,95,152,591.8500503603364,998.618052466304,3.4044943820224716,3399.789549407755,188.87719718931967,0.3328726841554347,False
1934,7e5ad314287a5c86856efea13c04333d7baf3643,/Users/sanika/Downloads/Master Thesis/repo_updated/pytest/testing/test_doctest.py,3715.0,ModificationType.MODIFY,1455,414,1257,16,76,112,1471,5,41,23,46,46,69,231.26927266377825,381.12577496793386,2.804878048780488,1069.0113200320095,59.3895177795561,0.1270419249893113,False
1935,7e5ad314287a5c86856efea13c04333d7baf3643,/Users/sanika/Downloads/Master Thesis/repo_updated/pytest/testing/test_faulthandler.py,310.0,ModificationType.MODIFY,103,47,73,2,12,15,105,5,16,9,17,21,26,75.60964047443682,114.20025299224777,2.65625,303.3444220106581,16.85246788948101,0.03806675099741593,False
1936,7e5ad314287a5c86856efea13c04333d7baf3643,/Users/sanika/Downloads/Master Thesis/repo_updated/pytest/testing/test_junitxml.py,5659.0,ModificationType.MODIFY,1523,757,1297,19,12,193,1542,12,193,117,230,205,347,1508.3637582013935,2664.7795945283897,7.150259067357513,19053.86445828589,1058.5480254603274,0.8882598648427965,False
1937,7e5ad314287a5c86856efea13c04333d7baf3643,/Users/sanika/Downloads/Master Thesis/repo_updated/pytest/testing/test_mark.py,3199.0,ModificationType.MODIFY,1020,354,843,12,15,144,1032,8,134,77,144,142,221,970.8559515213416,1580.0941134105346,4.298507462686567,6792.0463382422995,377.3359076801278,0.5266980378035117,False
1938,7e5ad314287a5c86856efea13c04333d7baf3643,/Users/sanika/Downloads/Master Thesis/repo_updated/pytest/testing/test_meta.py,96.0,ModificationType.MODIFY,35,12,22,4,5,6,39,1,2,1,2,3,3,2.0,4.754887502163468,0.5,2.3774437510817346,0.1320802083934297,0.0015849625007211565,False
1939,7e5ad314287a5c86856efea13c04333d7baf3643,/Users/sanika/Downloads/Master Thesis/repo_updated/pytest/testing/test_pdb.py,4230.0,ModificationType.MODIFY,1293,570,1093,25,15,163,1318,10,195,123,241,205,364,1516.6486921300477,2795.3307562199825,6.17948717948718,17273.710570487587,959.6505872493103,0.931776918739994,False
1940,7e5ad314287a5c86856efea13c04333d7baf3643,/Users/sanika/Downloads/Master Thesis/repo_updated/pytest/testing/test_pluginmanager.py,1924.0,ModificationType.MODIFY,384,251,317,7,8,52,391,11,70,44,84,81,128,467.10355899115797,811.500800369232,6.6,5355.905282436931,297.5502934687184,0.270500266789744,False
1941,7e5ad314287a5c86856efea13c04333d7baf3643,/Users/sanika/Downloads/Master Thesis/repo_updated/pytest/testing/test_pytester.py,3231.0,ModificationType.MODIFY,722,423,573,19,0,135,741,12,172,101,199,184,300,1320.3370878174146,2257.068586817104,6.941860465116278,15668.255189881524,870.4586216600846,0.7523561956057013,False
1942,7e5ad314287a5c86856efea13c04333d7baf3643,/Users/sanika/Downloads/Master Thesis/repo_updated/pytest/testing/test_reports.py,1843.0,ModificationType.MODIFY,466,257,367,18,25,50,484,7,126,86,171,133,257,898.7887548153927,1813.2075859238055,4.75,8612.736033138077,478.4853351743376,0.6044025286412685,False
1943,7e5ad314287a5c86856efea13c04333d7baf3643,/Users/sanika/Downloads/Master Thesis/repo_updated/pytest/testing/test_runner.py,3442.0,ModificationType.MODIFY,1043,504,840,53,9,147,1096,9,180,112,198,189,310,1377.0628823523223,2344.2951515085324,4.95,11604.260999967237,644.6811666648464,0.7814317171695108,False
1944,7e5ad314287a5c86856efea13c04333d7baf3643,/Users/sanika/Downloads/Master Thesis/repo_updated/pytest/testing/test_runner_xunit.py,463.0,ModificationType.MODIFY,295,56,236,0,4,54,295,2,9,5,10,11,15,30.52932501298081,51.89147427955947,1.1111111111111112,57.657193643954976,3.203177424664165,0.01729715809318649,False
1945,7e5ad314287a5c86856efea13c04333d7baf3643,/Users/sanika/Downloads/Master Thesis/repo_updated/pytest/testing/test_session.py,1422.0,ModificationType.MODIFY,373,158,315,8,0,51,381,5,76,44,79,81,123,486.4521314961493,779.8015503548088,2.598684210526316,2026.4579762509838,112.5809986806102,0.25993385011826964,False
1946,7e5ad314287a5c86856efea13c04333d7baf3643,/Users/sanika/Downloads/Master Thesis/repo_updated/pytest/testing/test_setuponly.py,572.0,ModificationType.RENAME,294,64,250,0,0,43,294,1,20,10,20,21,30,86.43856189774725,131.7695226833628,0.5,65.8847613416814,3.660264518982301,0.04392317422778761,False
1947,7e5ad314287a5c86856efea13c04333d7baf3643,/Users/sanika/Downloads/Master Thesis/repo_updated/pytest/testing/test_setupplan.py,,ModificationType.RENAME,110,30,77,3,13,16,113,4,21,15,30,25,45,100.23866587835396,208.9735285398626,2.8571428571428568,597.0672243996074,33.17040135553375,0.06965784284662087,False
1948,7e5ad314287a5c86856efea13c04333d7baf3643,/Users/sanika/Downloads/Master Thesis/repo_updated/pytest/testing/test_skipping.py,3073.0,ModificationType.MODIFY,1178,367,1042,6,15,115,1184,9,94,51,95,103,146,644.6606770706788,976.22907696875,4.547872340425532,4439.7652170653255,246.65362317029587,0.3254096923229167,False
1949,7e5ad314287a5c86856efea13c04333d7baf3643,/Users/sanika/Downloads/Master Thesis/repo_updated/pytest/testing/test_stepwise.py,645.0,ModificationType.MODIFY,219,78,157,11,5,46,230,3,24,20,34,27,54,114.79398751947123,256.7639251168273,2.125,545.6233408732581,30.31240782629212,0.08558797503894246,False
1950,7e5ad314287a5c86856efea13c04333d7baf3643,/Users/sanika/Downloads/Master Thesis/repo_updated/pytest/testing/test_terminal.py,6852.0,ModificationType.MODIFY,1943,715,1694,26,18,214,1969,12,185,120,237,197,357,1436.3251202041715,2721.0724995459263,7.686486486486486,20915.486996509768,1161.971499806098,0.9070241665153088,False
1951,7e5ad314287a5c86856efea13c04333d7baf3643,/Users/sanika/Downloads/Master Thesis/repo_updated/pytest/testing/test_tmpdir.py,1861.0,ModificationType.MODIFY,442,244,305,14,16,103,456,11,68,45,75,79,120,452.00122101003336,756.4536897812525,6.066176470588236,4588.781574040686,254.932309668927,0.2521512299270841,False
1952,7e5ad314287a5c86856efea13c04333d7baf3643,/Users/sanika/Downloads/Master Thesis/repo_updated/pytest/testing/test_unittest.py,2042.0,ModificationType.MODIFY,1098,241,925,5,10,155,1103,7,46,25,49,53,74,273.7353344330258,423.86611363767685,3.728260869565217,1580.283445410034,87.79352474500189,0.14128870454589226,False
1953,7e5ad314287a5c86856efea13c04333d7baf3643,/Users/sanika/Downloads/Master Thesis/repo_updated/pytest/testing/test_warnings.py,1715.0,ModificationType.MODIFY,601,196,481,2,23,85,603,8,63,36,72,71,108,400.5686351804948,664.1726889065056,4.571428571428571,3036.21800642974,168.67877813498555,0.22139089630216852,False
1954,2228ccbfb412e58138e88101876187008bb22346,/Users/sanika/Downloads/Master Thesis/repo_updated/pytest/testing/test_pytester.py,6367.0,ModificationType.MODIFY,722,423,573,19,0,135,741,12,172,101,199,184,300,1320.3370878174146,2257.068586817104,6.941860465116278,15668.255189881524,870.4586216600846,0.7523561956057013,False
1955,2228ccbfb412e58138e88101876187008bb22346,/Users/sanika/Downloads/Master Thesis/repo_updated/pytest/src/_pytest/pytester.py,6367.0,ModificationType.MODIFY,1508,847,911,44,250,301,1552,14,148,88,169,162,257,1120.302067021891,1886.3414507413486,7.993243243243242,15077.986055587939,837.6658919771077,0.6287804835804495,False
1956,2228ccbfb412e58138e88101876187008bb22346,/Users/sanika/Downloads/Master Thesis/repo_updated/pytest/testing/test_pytester.py,3295.0,ModificationType.MODIFY,722,423,573,19,0,135,741,12,172,101,199,184,300,1320.3370878174146,2257.068586817104,6.941860465116278,15668.255189881524,870.4586216600846,0.7523561956057013,False
1957,58ec5bea353ba7141781b683d811824fd7b9a31b,/Users/sanika/Downloads/Master Thesis/repo_updated/pytest/testing/test_pytester.py,6367.0,ModificationType.MODIFY,722,423,573,19,0,135,741,12,172,101,199,184,300,1320.3370878174146,2257.068586817104,6.941860465116278,15668.255189881524,870.4586216600846,0.7523561956057013,False
1958,58ec5bea353ba7141781b683d811824fd7b9a31b,/Users/sanika/Downloads/Master Thesis/repo_updated/pytest/src/_pytest/pytester.py,6367.0,ModificationType.MODIFY,1508,847,911,44,250,301,1552,14,148,88,169,162,257,1120.302067021891,1886.3414507413486,7.993243243243242,15077.986055587939,837.6658919771077,0.6287804835804495,False
1959,58ec5bea353ba7141781b683d811824fd7b9a31b,/Users/sanika/Downloads/Master Thesis/repo_updated/pytest/testing/test_pytester.py,3295.0,ModificationType.MODIFY,722,423,573,19,0,135,741,12,172,101,199,184,300,1320.3370878174146,2257.068586817104,6.941860465116278,15668.255189881524,870.4586216600846,0.7523561956057013,False
1960,be722652f0b63411a6c9e9e5a193cac129404d24,/Users/sanika/Downloads/Master Thesis/repo_updated/pytest/doc/en/conf.py,303.0,ModificationType.MODIFY,382,65,130,157,2,92,539,4,10,5,10,14,15,41.21928094887362,57.11032383086405,2.0,114.22064766172814,6.345591536762672,0.019036774610288014,False
1961,b96e0a71a6ce4130b480b6c601befadbeec5dfe5,/Users/sanika/Downloads/Master Thesis/repo_updated/pytest/testing/test_pytester.py,6370.0,ModificationType.MODIFY,722,423,573,19,0,135,741,12,172,101,199,184,300,1320.3370878174146,2257.068586817104,6.941860465116278,15668.255189881524,870.4586216600846,0.7523561956057013,False
1962,b96e0a71a6ce4130b480b6c601befadbeec5dfe5,/Users/sanika/Downloads/Master Thesis/repo_updated/pytest/src/_pytest/pytester.py,6370.0,ModificationType.MODIFY,1508,847,911,44,250,301,1552,14,148,88,169,162,257,1120.302067021891,1886.3414507413486,7.993243243243242,15077.986055587939,837.6658919771077,0.6287804835804495,False
1963,4ee984ff0ab9bbf46ff07dc5691fdb48bf70e5e1,/Users/sanika/Downloads/Master Thesis/repo_updated/pytest/testing/test_pytester.py,6370.0,ModificationType.MODIFY,722,423,573,19,0,135,741,12,172,101,199,184,300,1320.3370878174146,2257.068586817104,6.941860465116278,15668.255189881524,870.4586216600846,0.7523561956057013,False
1964,4ee984ff0ab9bbf46ff07dc5691fdb48bf70e5e1,/Users/sanika/Downloads/Master Thesis/repo_updated/pytest/src/_pytest/pytester.py,6370.0,ModificationType.MODIFY,1508,847,911,44,250,301,1552,14,148,88,169,162,257,1120.302067021891,1886.3414507413486,7.993243243243242,15077.986055587939,837.6658919771077,0.6287804835804495,False
1965,7e10c8191d0a6b8e2a0047947ededc232d02cd06,/Users/sanika/Downloads/Master Thesis/repo_updated/pytest/doc/en/conf.py,319.0,ModificationType.MODIFY,382,65,130,157,2,92,539,4,10,5,10,14,15,41.21928094887362,57.11032383086405,2.0,114.22064766172814,6.345591536762672,0.019036774610288014,False
1966,7e10c8191d0a6b8e2a0047947ededc232d02cd06,/Users/sanika/Downloads/Master Thesis/repo_updated/pytest/scripts/release.py,539.0,ModificationType.MODIFY,124,78,88,2,3,26,126,4,13,7,13,17,20,56.10571633583421,81.7492568250068,2.0,163.4985136500136,9.083250758334088,0.027249752275002263,False
1967,64eb9ea670fd4d31e46e41ee397933fcad05886d,/Users/sanika/Downloads/Master Thesis/repo_updated/pytest/testing/test_runner.py,3448.0,ModificationType.MODIFY,1043,504,840,53,9,147,1096,9,180,112,198,189,310,1377.0628823523223,2344.2951515085324,4.95,11604.260999967237,644.6811666648464,0.7814317171695108,False
1968,2ffbe41ae526b5367fca798e405fceab9bc57228,/Users/sanika/Downloads/Master Thesis/repo_updated/pytest/testing/test_runner.py,1929.0,ModificationType.MODIFY,1043,504,840,53,9,147,1096,9,180,112,198,189,310,1377.0628823523223,2344.2951515085324,4.95,11604.260999967237,644.6811666648464,0.7814317171695108,False
1969,2ffbe41ae526b5367fca798e405fceab9bc57228,/Users/sanika/Downloads/Master Thesis/repo_updated/pytest/src/_pytest/runner.py,1929.0,ModificationType.MODIFY,383,288,292,26,6,62,409,11,65,38,67,76,105,429.5076556518598,656.0323889115765,5.6692307692307695,3719.1990048294756,206.6221669349709,0.2186774629705255,False
1970,f1ac0eeef0c7fd504dc7a87c72a35730857363fc,/Users/sanika/Downloads/Master Thesis/repo_updated/pytest/testing/test_runner.py,1929.0,ModificationType.MODIFY,1043,504,840,53,9,147,1096,9,180,112,198,189,310,1377.0628823523223,2344.2951515085324,4.95,11604.260999967237,644.6811666648464,0.7814317171695108,False
1971,f1ac0eeef0c7fd504dc7a87c72a35730857363fc,/Users/sanika/Downloads/Master Thesis/repo_updated/pytest/src/_pytest/runner.py,1929.0,ModificationType.MODIFY,383,288,292,26,6,62,409,11,65,38,67,76,105,429.5076556518598,656.0323889115765,5.6692307692307695,3719.1990048294756,206.6221669349709,0.2186774629705255,False
1972,f1ac0eeef0c7fd504dc7a87c72a35730857363fc,/Users/sanika/Downloads/Master Thesis/repo_updated/pytest/testing/test_runner.py,3448.0,ModificationType.MODIFY,1043,504,840,53,9,147,1096,9,180,112,198,189,310,1377.0628823523223,2344.2951515085324,4.95,11604.260999967237,644.6811666648464,0.7814317171695108,False
1973,8b7aeefd7d57a5885017450b09e2b12203d6aede,/Users/sanika/Downloads/Master Thesis/repo_updated/pytest/doc/en/conf.py,322.0,ModificationType.MODIFY,382,65,130,157,2,92,539,4,10,5,10,14,15,41.21928094887362,57.11032383086405,2.0,114.22064766172814,6.345591536762672,0.019036774610288014,False
1974,2344982d7fec6c37727288621d3d3dbf7291f53b,/Users/sanika/Downloads/Master Thesis/repo_updated/pytest/testing/test_main.py,3551.0,ModificationType.MODIFY,77,34,69,0,0,8,77,3,24,16,29,27,45,114.79398751947123,213.9699375973561,1.8125,387.82051189520797,21.54558399417822,0.07132331253245204,False
1975,2344982d7fec6c37727288621d3d3dbf7291f53b,/Users/sanika/Downloads/Master Thesis/repo_updated/pytest/src/_pytest/main.py,3551.0,ModificationType.MODIFY,712,438,573,51,9,84,763,14,102,71,128,116,199,733.8903537898989,1364.7382180303869,8.784313725490197,11988.288660345359,666.0160366858534,0.4549127393434623,False
1976,2344982d7fec6c37727288621d3d3dbf7291f53b,/Users/sanika/Downloads/Master Thesis/repo_updated/pytest/testing/test_main.py,216.0,ModificationType.ADD,77,34,69,0,0,8,77,3,24,16,29,27,45,114.79398751947123,213.9699375973561,1.8125,387.82051189520797,21.54558399417822,0.07132331253245204,False
1977,1f736a663d6bd9c7a1a99dc970d70367863810a8,/Users/sanika/Downloads/Master Thesis/repo_updated/pytest/testing/test_terminal.py,6420.0,ModificationType.MODIFY,1943,715,1694,26,18,214,1969,12,185,120,237,197,357,1436.3251202041715,2721.0724995459263,7.686486486486486,20915.486996509768,1161.971499806098,0.9070241665153088,False
1978,1f736a663d6bd9c7a1a99dc970d70367863810a8,/Users/sanika/Downloads/Master Thesis/repo_updated/pytest/src/_pytest/terminal.py,6420.0,ModificationType.MODIFY,1168,838,957,57,25,144,1225,19,348,224,416,367,640,3018.854959310786,5452.567201819657,11.35632183908046,61921.107993078396,3440.0615551710216,1.817522400606552,False
1979,a7268aaa5df737bbea8afd81470d2f750c9abc2e,/Users/sanika/Downloads/Master Thesis/repo_updated/pytest/testing/test_main.py,3551.0,ModificationType.MODIFY,77,34,69,0,0,8,77,3,24,16,29,27,45,114.79398751947123,213.9699375973561,1.8125,387.82051189520797,21.54558399417822,0.07132331253245204,False
1980,a7268aaa5df737bbea8afd81470d2f750c9abc2e,/Users/sanika/Downloads/Master Thesis/repo_updated/pytest/src/_pytest/main.py,3551.0,ModificationType.MODIFY,712,438,573,51,9,84,763,14,102,71,128,116,199,733.8903537898989,1364.7382180303869,8.784313725490197,11988.288660345359,666.0160366858534,0.4549127393434623,False
1981,a7268aaa5df737bbea8afd81470d2f750c9abc2e,/Users/sanika/Downloads/Master Thesis/repo_updated/pytest/testing/test_main.py,216.0,ModificationType.ADD,77,34,69,0,0,8,77,3,24,16,29,27,45,114.79398751947123,213.9699375973561,1.8125,387.82051189520797,21.54558399417822,0.07132331253245204,False
1982,0601f5cdad56a3e64cf15618ee2856a49aab58cd,/Users/sanika/Downloads/Master Thesis/repo_updated/pytest/testing/test_terminal.py,6420.0,ModificationType.MODIFY,1943,715,1694,26,18,214,1969,12,185,120,237,197,357,1436.3251202041715,2721.0724995459263,7.686486486486486,20915.486996509768,1161.971499806098,0.9070241665153088,False
1983,0601f5cdad56a3e64cf15618ee2856a49aab58cd,/Users/sanika/Downloads/Master Thesis/repo_updated/pytest/src/_pytest/terminal.py,6420.0,ModificationType.MODIFY,1168,838,957,57,25,144,1225,19,348,224,416,367,640,3018.854959310786,5452.567201819657,11.35632183908046,61921.107993078396,3440.0615551710216,1.817522400606552,False
1984,5e097970df24a47a5944f29a6dca1eb1219b5b8e,/Users/sanika/Downloads/Master Thesis/repo_updated/pytest/testing/test_doctest.py,2771.0,ModificationType.MODIFY,1455,414,1257,16,76,112,1471,5,41,23,46,46,69,231.26927266377825,381.12577496793386,2.804878048780488,1069.0113200320095,59.3895177795561,0.1270419249893113,False
1985,5e097970df24a47a5944f29a6dca1eb1219b5b8e,/Users/sanika/Downloads/Master Thesis/repo_updated/pytest/src/_pytest/doctest.py,2771.0,ModificationType.MODIFY,669,365,481,22,61,110,691,15,103,63,122,118,185,747.3129132339992,1273.2889641319407,8.88349514563107,11311.256331851706,628.403129547317,0.4244296547106469,False
1986,5e097970df24a47a5944f29a6dca1eb1219b5b8e,/Users/sanika/Downloads/Master Thesis/repo_updated/pytest/testing/test_doctest.py,3818.0,ModificationType.MODIFY,1455,414,1257,16,76,112,1471,5,41,23,46,46,69,231.26927266377825,381.12577496793386,2.804878048780488,1069.0113200320095,59.3895177795561,0.1270419249893113,False
1987,d1eb89d6940d3081876f663622017d8952e77a80,/Users/sanika/Downloads/Master Thesis/repo_updated/pytest/testing/test_doctest.py,2771.0,ModificationType.MODIFY,1455,414,1257,16,76,112,1471,5,41,23,46,46,69,231.26927266377825,381.12577496793386,2.804878048780488,1069.0113200320095,59.3895177795561,0.1270419249893113,False
1988,d1eb89d6940d3081876f663622017d8952e77a80,/Users/sanika/Downloads/Master Thesis/repo_updated/pytest/src/_pytest/doctest.py,2771.0,ModificationType.MODIFY,669,365,481,22,61,110,691,15,103,63,122,118,185,747.3129132339992,1273.2889641319407,8.88349514563107,11311.256331851706,628.403129547317,0.4244296547106469,False
1989,d1eb89d6940d3081876f663622017d8952e77a80,/Users/sanika/Downloads/Master Thesis/repo_updated/pytest/testing/test_doctest.py,3818.0,ModificationType.MODIFY,1455,414,1257,16,76,112,1471,5,41,23,46,46,69,231.26927266377825,381.12577496793386,2.804878048780488,1069.0113200320095,59.3895177795561,0.1270419249893113,False
1990,b7bc52f770dd3352cfaf54ed5ec82df382013e2d,/Users/sanika/Downloads/Master Thesis/repo_updated/pytest/testing/example_scripts/collect/package_infinite_recursion/__init__.pyi,5077.0,ModificationType.MODIFY,0,0,0,0,0,0,0,0,0,0,0,0,0,0.0,0.0,0.0,0.0,0.0,0.0,False
1991,b7bc52f770dd3352cfaf54ed5ec82df382013e2d,/Users/sanika/Downloads/Master Thesis/repo_updated/pytest/testing/example_scripts/collect/package_infinite_recursion/tests/__init__.py,5077.0,ModificationType.MODIFY,0,0,0,0,0,0,0,0,0,0,0,0,0,0.0,0.0,0.0,0.0,0.0,0.0,False
1992,b7bc52f770dd3352cfaf54ed5ec82df382013e2d,/Users/sanika/Downloads/Master Thesis/repo_updated/pytest/testing/example_scripts/collect/collect_init_tests/tests/__init__.py,5077.0,ModificationType.MODIFY,2,2,2,0,0,0,2,0,0,0,0,0,0,0.0,0.0,0.0,0.0,0.0,0.0,False
1993,b7bc52f770dd3352cfaf54ed5ec82df382013e2d,/Users/sanika/Downloads/Master Thesis/repo_updated/pytest/testing/example_scripts/collect/package_init_given_as_arg/pkg/__init__.py,5077.0,ModificationType.MODIFY,0,0,0,0,0,0,0,0,0,0,0,0,0,0.0,0.0,0.0,0.0,0.0,0.0,False
1994,b7bc52f770dd3352cfaf54ed5ec82df382013e2d,/Users/sanika/Downloads/Master Thesis/repo_updated/pytest/testing/example_scripts/conftest_usageerror/__init__.pyi,5077.0,ModificationType.MODIFY,0,0,0,0,0,0,0,0,0,0,0,0,0,0.0,0.0,0.0,0.0,0.0,0.0,False
1995,b7bc52f770dd3352cfaf54ed5ec82df382013e2d,/Users/sanika/Downloads/Master Thesis/repo_updated/pytest/testing/example_scripts/marks/marks_considered_keywords/__init__.pyi,5077.0,ModificationType.MODIFY,0,0,0,0,0,0,0,0,0,0,0,0,0,0.0,0.0,0.0,0.0,0.0,0.0,False
1996,b7bc52f770dd3352cfaf54ed5ec82df382013e2d,/Users/sanika/Downloads/Master Thesis/repo_updated/pytest/testing/example_scripts/config/collect_pytest_prefix/__init__.pyi,5077.0,ModificationType.MODIFY,0,0,0,0,0,0,0,0,0,0,0,0,0,0.0,0.0,0.0,0.0,0.0,0.0,False
1997,b7bc52f770dd3352cfaf54ed5ec82df382013e2d,/Users/sanika/Downloads/Master Thesis/repo_updated/pytest/testing/example_scripts/issue88_initial_file_multinodes/__init__.pyi,5077.0,ModificationType.MODIFY,0,0,0,0,0,0,0,0,0,0,0,0,0,0.0,0.0,0.0,0.0,0.0,0.0,False
1998,b7bc52f770dd3352cfaf54ed5ec82df382013e2d,/Users/sanika/Downloads/Master Thesis/repo_updated/pytest/testing/example_scripts/fixtures/fill_fixtures/test_extend_fixture_conftest_conftest/__init__.pyi,5077.0,ModificationType.MODIFY,0,0,0,0,0,0,0,0,0,0,0,0,0,0.0,0.0,0.0,0.0,0.0,0.0,False
1999,b7bc52f770dd3352cfaf54ed5ec82df382013e2d,/Users/sanika/Downloads/Master Thesis/repo_updated/pytest/testing/example_scripts/fixtures/fill_fixtures/test_extend_fixture_conftest_conftest/pkg/__init__.py,5077.0,ModificationType.MODIFY,0,0,0,0,0,0,0,0,0,0,0,0,0,0.0,0.0,0.0,0.0,0.0,0.0,False
2000,b7bc52f770dd3352cfaf54ed5ec82df382013e2d,/Users/sanika/Downloads/Master Thesis/repo_updated/pytest/testing/example_scripts/fixtures/fill_fixtures/test_extend_fixture_conftest_module/__init__.pyi,5077.0,ModificationType.MODIFY,0,0,0,0,0,0,0,0,0,0,0,0,0,0.0,0.0,0.0,0.0,0.0,0.0,False
2001,b7bc52f770dd3352cfaf54ed5ec82df382013e2d,/Users/sanika/Downloads/Master Thesis/repo_updated/pytest/testing/example_scripts/fixtures/fill_fixtures/test_conftest_funcargs_only_available_in_subdir/sub1/__init__.py,5077.0,ModificationType.MODIFY,0,0,0,0,0,0,0,0,0,0,0,0,0,0.0,0.0,0.0,0.0,0.0,0.0,False
2002,b7bc52f770dd3352cfaf54ed5ec82df382013e2d,/Users/sanika/Downloads/Master Thesis/repo_updated/pytest/testing/example_scripts/fixtures/fill_fixtures/test_conftest_funcargs_only_available_in_subdir/sub2/__init__.py,5077.0,ModificationType.MODIFY,0,0,0,0,0,0,0,0,0,0,0,0,0,0.0,0.0,0.0,0.0,0.0,0.0,False
2003,b7bc52f770dd3352cfaf54ed5ec82df382013e2d,/Users/sanika/Downloads/Master Thesis/repo_updated/pytest/testing/example_scripts/fixtures/custom_item/__init__.pyi,5077.0,ModificationType.MODIFY,0,0,0,0,0,0,0,0,0,0,0,0,0,0.0,0.0,0.0,0.0,0.0,0.0,False
2004,b7bc52f770dd3352cfaf54ed5ec82df382013e2d,/Users/sanika/Downloads/Master Thesis/repo_updated/pytest/testing/example_scripts/fixtures/custom_item/foo/__init__.py,5077.0,ModificationType.MODIFY,0,0,0,0,0,0,0,0,0,0,0,0,0,0.0,0.0,0.0,0.0,0.0,0.0,False
2005,b7bc52f770dd3352cfaf54ed5ec82df382013e2d,/Users/sanika/Downloads/Master Thesis/repo_updated/pytest/doc/en/example/nonpython/__init__.py,5077.0,ModificationType.MODIFY,0,0,0,0,0,0,0,0,0,0,0,0,0,0.0,0.0,0.0,0.0,0.0,0.0,False
2006,b7bc52f770dd3352cfaf54ed5ec82df382013e2d,/Users/sanika/Downloads/Master Thesis/repo_updated/pytest/src/pytest/__init__.py,5077.0,ModificationType.MODIFY,99,48,90,1,3,5,100,0,0,0,0,0,0,0.0,0.0,0.0,0.0,0.0,0.0,False
2007,b7bc52f770dd3352cfaf54ed5ec82df382013e2d,/Users/sanika/Downloads/Master Thesis/repo_updated/pytest/src/_pytest/__init__.py,5077.0,ModificationType.MODIFY,8,5,5,2,0,1,10,0,0,0,0,0,0,0.0,0.0,0.0,0.0,0.0,0.0,False
2008,b7bc52f770dd3352cfaf54ed5ec82df382013e2d,/Users/sanika/Downloads/Master Thesis/repo_updated/pytest/src/_pytest/config/__init__.py,5077.0,ModificationType.MODIFY,1217,716,841,84,126,174,1301,14,185,118,215,199,333,1446.608539104324,2542.995998641035,8.135135135135135,20687.616097052745,1149.3120053918194,0.847665332880345,False
2009,b7bc52f770dd3352cfaf54ed5ec82df382013e2d,/Users/sanika/Downloads/Master Thesis/repo_updated/pytest/src/_pytest/mark/__init__.py,5077.0,ModificationType.MODIFY,160,89,115,0,13,31,160,7,15,11,17,22,28,78.25484338853101,124.86408532184431,3.966666666666667,495.29420510998256,27.516344728332356,0.04162136177394811,False
2010,b7bc52f770dd3352cfaf54ed5ec82df382013e2d,/Users/sanika/Downloads/Master Thesis/repo_updated/pytest/src/_pytest/_code/__init__.py,5077.0,ModificationType.MODIFY,10,10,9,9,0,0,19,0,0,0,0,0,0,0.0,0.0,0.0,0.0,0.0,0.0,False
2011,b7bc52f770dd3352cfaf54ed5ec82df382013e2d,/Users/sanika/Downloads/Master Thesis/repo_updated/pytest/src/_pytest/assertion/__init__.py,5077.0,ModificationType.MODIFY,173,84,99,8,29,36,181,5,12,7,13,17,20,54.62919048309069,81.7492568250068,2.708333333333333,221.40423723439343,12.300235401910744,0.027249752275002263,False
2012,b7bc52f770dd3352cfaf54ed5ec82df382013e2d,/Users/sanika/Downloads/Master Thesis/repo_updated/pytest/src/_pytest/_io/__init__.py,5077.0,ModificationType.MODIFY,3,1,1,3,0,0,6,0,0,0,0,0,0,0.0,0.0,0.0,0.0,0.0,0.0,False
2013,f9f092a5e6dc27d28b220fde75b348f086ef85c0,/Users/sanika/Downloads/Master Thesis/repo_updated/pytest/testing/test_junitxml.py,3203.0,ModificationType.MODIFY,1523,757,1297,19,12,193,1542,12,193,117,230,205,347,1508.3637582013935,2664.7795945283897,7.150259067357513,19053.86445828589,1058.5480254603274,0.8882598648427965,False
2014,f9f092a5e6dc27d28b220fde75b348f086ef85c0,/Users/sanika/Downloads/Master Thesis/repo_updated/pytest/src/_pytest/junitxml.py,3203.0,ModificationType.MODIFY,701,378,504,33,58,109,734,13,110,68,126,123,194,794.0552848235468,1346.8478140358125,7.445454545454545,10027.894179048459,557.1052321693588,0.4489492713452708,False
2015,f9f092a5e6dc27d28b220fde75b348f086ef85c0,/Users/sanika/Downloads/Master Thesis/repo_updated/pytest/testing/test_junitxml.py,5827.0,ModificationType.MODIFY,1523,757,1297,19,12,193,1542,12,193,117,230,205,347,1508.3637582013935,2664.7795945283897,7.150259067357513,19053.86445828589,1058.5480254603274,0.8882598648427965,False
2016,2d24c062b6c1beb914399174c1fd9190f6093371,/Users/sanika/Downloads/Master Thesis/repo_updated/pytest/testing/test_junitxml.py,3209.0,ModificationType.MODIFY,1523,757,1297,19,12,193,1542,12,193,117,230,205,347,1508.3637582013935,2664.7795945283897,7.150259067357513,19053.86445828589,1058.5480254603274,0.8882598648427965,False
2017,2d24c062b6c1beb914399174c1fd9190f6093371,/Users/sanika/Downloads/Master Thesis/repo_updated/pytest/src/_pytest/junitxml.py,3209.0,ModificationType.MODIFY,701,378,504,33,58,109,734,13,110,68,126,123,194,794.0552848235468,1346.8478140358125,7.445454545454545,10027.894179048459,557.1052321693588,0.4489492713452708,False
2018,ed67312bca2b8b51c6b309df1201be0f89bbb6ae,/Users/sanika/Downloads/Master Thesis/repo_updated/pytest/testing/example_scripts/collect/package_infinite_recursion/__init__.pyi,5077.0,ModificationType.MODIFY,0,0,0,0,0,0,0,0,0,0,0,0,0,0.0,0.0,0.0,0.0,0.0,0.0,False
2019,ed67312bca2b8b51c6b309df1201be0f89bbb6ae,/Users/sanika/Downloads/Master Thesis/repo_updated/pytest/testing/example_scripts/collect/package_infinite_recursion/tests/__init__.py,5077.0,ModificationType.MODIFY,0,0,0,0,0,0,0,0,0,0,0,0,0,0.0,0.0,0.0,0.0,0.0,0.0,False
2020,ed67312bca2b8b51c6b309df1201be0f89bbb6ae,/Users/sanika/Downloads/Master Thesis/repo_updated/pytest/testing/example_scripts/collect/collect_init_tests/tests/__init__.py,5077.0,ModificationType.MODIFY,2,2,2,0,0,0,2,0,0,0,0,0,0,0.0,0.0,0.0,0.0,0.0,0.0,False
2021,ed67312bca2b8b51c6b309df1201be0f89bbb6ae,/Users/sanika/Downloads/Master Thesis/repo_updated/pytest/testing/example_scripts/collect/package_init_given_as_arg/pkg/__init__.py,5077.0,ModificationType.MODIFY,0,0,0,0,0,0,0,0,0,0,0,0,0,0.0,0.0,0.0,0.0,0.0,0.0,False
2022,ed67312bca2b8b51c6b309df1201be0f89bbb6ae,/Users/sanika/Downloads/Master Thesis/repo_updated/pytest/testing/example_scripts/conftest_usageerror/__init__.pyi,5077.0,ModificationType.MODIFY,0,0,0,0,0,0,0,0,0,0,0,0,0,0.0,0.0,0.0,0.0,0.0,0.0,False
2023,ed67312bca2b8b51c6b309df1201be0f89bbb6ae,/Users/sanika/Downloads/Master Thesis/repo_updated/pytest/testing/example_scripts/marks/marks_considered_keywords/__init__.pyi,5077.0,ModificationType.MODIFY,0,0,0,0,0,0,0,0,0,0,0,0,0,0.0,0.0,0.0,0.0,0.0,0.0,False
2024,ed67312bca2b8b51c6b309df1201be0f89bbb6ae,/Users/sanika/Downloads/Master Thesis/repo_updated/pytest/testing/example_scripts/config/collect_pytest_prefix/__init__.pyi,5077.0,ModificationType.MODIFY,0,0,0,0,0,0,0,0,0,0,0,0,0,0.0,0.0,0.0,0.0,0.0,0.0,False
2025,ed67312bca2b8b51c6b309df1201be0f89bbb6ae,/Users/sanika/Downloads/Master Thesis/repo_updated/pytest/testing/example_scripts/issue88_initial_file_multinodes/__init__.pyi,5077.0,ModificationType.MODIFY,0,0,0,0,0,0,0,0,0,0,0,0,0,0.0,0.0,0.0,0.0,0.0,0.0,False
2026,ed67312bca2b8b51c6b309df1201be0f89bbb6ae,/Users/sanika/Downloads/Master Thesis/repo_updated/pytest/testing/example_scripts/fixtures/fill_fixtures/test_extend_fixture_conftest_conftest/__init__.pyi,5077.0,ModificationType.MODIFY,0,0,0,0,0,0,0,0,0,0,0,0,0,0.0,0.0,0.0,0.0,0.0,0.0,False
2027,ed67312bca2b8b51c6b309df1201be0f89bbb6ae,/Users/sanika/Downloads/Master Thesis/repo_updated/pytest/testing/example_scripts/fixtures/fill_fixtures/test_extend_fixture_conftest_conftest/pkg/__init__.py,5077.0,ModificationType.MODIFY,0,0,0,0,0,0,0,0,0,0,0,0,0,0.0,0.0,0.0,0.0,0.0,0.0,False
2028,ed67312bca2b8b51c6b309df1201be0f89bbb6ae,/Users/sanika/Downloads/Master Thesis/repo_updated/pytest/testing/example_scripts/fixtures/fill_fixtures/test_extend_fixture_conftest_module/__init__.pyi,5077.0,ModificationType.MODIFY,0,0,0,0,0,0,0,0,0,0,0,0,0,0.0,0.0,0.0,0.0,0.0,0.0,False
2029,ed67312bca2b8b51c6b309df1201be0f89bbb6ae,/Users/sanika/Downloads/Master Thesis/repo_updated/pytest/testing/example_scripts/fixtures/fill_fixtures/test_conftest_funcargs_only_available_in_subdir/sub1/__init__.py,5077.0,ModificationType.MODIFY,0,0,0,0,0,0,0,0,0,0,0,0,0,0.0,0.0,0.0,0.0,0.0,0.0,False
2030,ed67312bca2b8b51c6b309df1201be0f89bbb6ae,/Users/sanika/Downloads/Master Thesis/repo_updated/pytest/testing/example_scripts/fixtures/fill_fixtures/test_conftest_funcargs_only_available_in_subdir/sub2/__init__.py,5077.0,ModificationType.MODIFY,0,0,0,0,0,0,0,0,0,0,0,0,0,0.0,0.0,0.0,0.0,0.0,0.0,False
2031,ed67312bca2b8b51c6b309df1201be0f89bbb6ae,/Users/sanika/Downloads/Master Thesis/repo_updated/pytest/testing/example_scripts/fixtures/custom_item/__init__.pyi,5077.0,ModificationType.MODIFY,0,0,0,0,0,0,0,0,0,0,0,0,0,0.0,0.0,0.0,0.0,0.0,0.0,False
2032,ed67312bca2b8b51c6b309df1201be0f89bbb6ae,/Users/sanika/Downloads/Master Thesis/repo_updated/pytest/testing/example_scripts/fixtures/custom_item/foo/__init__.py,5077.0,ModificationType.MODIFY,0,0,0,0,0,0,0,0,0,0,0,0,0,0.0,0.0,0.0,0.0,0.0,0.0,False
2033,ed67312bca2b8b51c6b309df1201be0f89bbb6ae,/Users/sanika/Downloads/Master Thesis/repo_updated/pytest/doc/en/example/nonpython/__init__.py,5077.0,ModificationType.MODIFY,0,0,0,0,0,0,0,0,0,0,0,0,0,0.0,0.0,0.0,0.0,0.0,0.0,False
2034,ed67312bca2b8b51c6b309df1201be0f89bbb6ae,/Users/sanika/Downloads/Master Thesis/repo_updated/pytest/src/pytest/__init__.py,5077.0,ModificationType.MODIFY,99,48,90,1,3,5,100,0,0,0,0,0,0,0.0,0.0,0.0,0.0,0.0,0.0,False
2035,ed67312bca2b8b51c6b309df1201be0f89bbb6ae,/Users/sanika/Downloads/Master Thesis/repo_updated/pytest/src/_pytest/__init__.py,5077.0,ModificationType.MODIFY,8,5,5,2,0,1,10,0,0,0,0,0,0,0.0,0.0,0.0,0.0,0.0,0.0,False
2036,ed67312bca2b8b51c6b309df1201be0f89bbb6ae,/Users/sanika/Downloads/Master Thesis/repo_updated/pytest/src/_pytest/config/__init__.py,5077.0,ModificationType.MODIFY,1217,716,841,84,126,174,1301,14,185,118,215,199,333,1446.608539104324,2542.995998641035,8.135135135135135,20687.616097052745,1149.3120053918194,0.847665332880345,False
2037,ed67312bca2b8b51c6b309df1201be0f89bbb6ae,/Users/sanika/Downloads/Master Thesis/repo_updated/pytest/src/_pytest/mark/__init__.py,5077.0,ModificationType.MODIFY,160,89,115,0,13,31,160,7,15,11,17,22,28,78.25484338853101,124.86408532184431,3.966666666666667,495.29420510998256,27.516344728332356,0.04162136177394811,False
2038,ed67312bca2b8b51c6b309df1201be0f89bbb6ae,/Users/sanika/Downloads/Master Thesis/repo_updated/pytest/src/_pytest/_code/__init__.py,5077.0,ModificationType.MODIFY,10,10,9,9,0,0,19,0,0,0,0,0,0,0.0,0.0,0.0,0.0,0.0,0.0,False
2039,ed67312bca2b8b51c6b309df1201be0f89bbb6ae,/Users/sanika/Downloads/Master Thesis/repo_updated/pytest/src/_pytest/assertion/__init__.py,5077.0,ModificationType.MODIFY,173,84,99,8,29,36,181,5,12,7,13,17,20,54.62919048309069,81.7492568250068,2.708333333333333,221.40423723439343,12.300235401910744,0.027249752275002263,False
2040,ed67312bca2b8b51c6b309df1201be0f89bbb6ae,/Users/sanika/Downloads/Master Thesis/repo_updated/pytest/src/_pytest/_io/__init__.py,5077.0,ModificationType.MODIFY,3,1,1,3,0,0,6,0,0,0,0,0,0,0.0,0.0,0.0,0.0,0.0,0.0,False
2041,69ad2026f606b2b9d6ea018aa37b10a8c7bf379c,/Users/sanika/Downloads/Master Thesis/repo_updated/pytest/testing/example_scripts/collect/package_infinite_recursion/__init__.pyi,5077.0,ModificationType.MODIFY,0,0,0,0,0,0,0,0,0,0,0,0,0,0.0,0.0,0.0,0.0,0.0,0.0,False
2042,69ad2026f606b2b9d6ea018aa37b10a8c7bf379c,/Users/sanika/Downloads/Master Thesis/repo_updated/pytest/testing/example_scripts/collect/package_infinite_recursion/tests/__init__.py,5077.0,ModificationType.MODIFY,0,0,0,0,0,0,0,0,0,0,0,0,0,0.0,0.0,0.0,0.0,0.0,0.0,False
2043,69ad2026f606b2b9d6ea018aa37b10a8c7bf379c,/Users/sanika/Downloads/Master Thesis/repo_updated/pytest/testing/example_scripts/collect/collect_init_tests/tests/__init__.py,5077.0,ModificationType.MODIFY,2,2,2,0,0,0,2,0,0,0,0,0,0,0.0,0.0,0.0,0.0,0.0,0.0,False
2044,69ad2026f606b2b9d6ea018aa37b10a8c7bf379c,/Users/sanika/Downloads/Master Thesis/repo_updated/pytest/testing/example_scripts/collect/package_init_given_as_arg/pkg/__init__.py,5077.0,ModificationType.MODIFY,0,0,0,0,0,0,0,0,0,0,0,0,0,0.0,0.0,0.0,0.0,0.0,0.0,False
2045,69ad2026f606b2b9d6ea018aa37b10a8c7bf379c,/Users/sanika/Downloads/Master Thesis/repo_updated/pytest/testing/example_scripts/conftest_usageerror/__init__.pyi,5077.0,ModificationType.MODIFY,0,0,0,0,0,0,0,0,0,0,0,0,0,0.0,0.0,0.0,0.0,0.0,0.0,False
2046,69ad2026f606b2b9d6ea018aa37b10a8c7bf379c,/Users/sanika/Downloads/Master Thesis/repo_updated/pytest/testing/example_scripts/marks/marks_considered_keywords/__init__.pyi,5077.0,ModificationType.MODIFY,0,0,0,0,0,0,0,0,0,0,0,0,0,0.0,0.0,0.0,0.0,0.0,0.0,False
2047,69ad2026f606b2b9d6ea018aa37b10a8c7bf379c,/Users/sanika/Downloads/Master Thesis/repo_updated/pytest/testing/example_scripts/config/collect_pytest_prefix/__init__.pyi,5077.0,ModificationType.MODIFY,0,0,0,0,0,0,0,0,0,0,0,0,0,0.0,0.0,0.0,0.0,0.0,0.0,False
2048,69ad2026f606b2b9d6ea018aa37b10a8c7bf379c,/Users/sanika/Downloads/Master Thesis/repo_updated/pytest/testing/example_scripts/issue88_initial_file_multinodes/__init__.pyi,5077.0,ModificationType.MODIFY,0,0,0,0,0,0,0,0,0,0,0,0,0,0.0,0.0,0.0,0.0,0.0,0.0,False
2049,69ad2026f606b2b9d6ea018aa37b10a8c7bf379c,/Users/sanika/Downloads/Master Thesis/repo_updated/pytest/testing/example_scripts/fixtures/fill_fixtures/test_extend_fixture_conftest_conftest/__init__.pyi,5077.0,ModificationType.MODIFY,0,0,0,0,0,0,0,0,0,0,0,0,0,0.0,0.0,0.0,0.0,0.0,0.0,False
2050,69ad2026f606b2b9d6ea018aa37b10a8c7bf379c,/Users/sanika/Downloads/Master Thesis/repo_updated/pytest/testing/example_scripts/fixtures/fill_fixtures/test_extend_fixture_conftest_conftest/pkg/__init__.py,5077.0,ModificationType.MODIFY,0,0,0,0,0,0,0,0,0,0,0,0,0,0.0,0.0,0.0,0.0,0.0,0.0,False
2051,69ad2026f606b2b9d6ea018aa37b10a8c7bf379c,/Users/sanika/Downloads/Master Thesis/repo_updated/pytest/testing/example_scripts/fixtures/fill_fixtures/test_extend_fixture_conftest_module/__init__.pyi,5077.0,ModificationType.MODIFY,0,0,0,0,0,0,0,0,0,0,0,0,0,0.0,0.0,0.0,0.0,0.0,0.0,False
2052,69ad2026f606b2b9d6ea018aa37b10a8c7bf379c,/Users/sanika/Downloads/Master Thesis/repo_updated/pytest/testing/example_scripts/fixtures/fill_fixtures/test_conftest_funcargs_only_available_in_subdir/sub1/__init__.py,5077.0,ModificationType.MODIFY,0,0,0,0,0,0,0,0,0,0,0,0,0,0.0,0.0,0.0,0.0,0.0,0.0,False
2053,69ad2026f606b2b9d6ea018aa37b10a8c7bf379c,/Users/sanika/Downloads/Master Thesis/repo_updated/pytest/testing/example_scripts/fixtures/fill_fixtures/test_conftest_funcargs_only_available_in_subdir/sub2/__init__.py,5077.0,ModificationType.MODIFY,0,0,0,0,0,0,0,0,0,0,0,0,0,0.0,0.0,0.0,0.0,0.0,0.0,False
2054,69ad2026f606b2b9d6ea018aa37b10a8c7bf379c,/Users/sanika/Downloads/Master Thesis/repo_updated/pytest/testing/example_scripts/fixtures/custom_item/__init__.pyi,5077.0,ModificationType.MODIFY,0,0,0,0,0,0,0,0,0,0,0,0,0,0.0,0.0,0.0,0.0,0.0,0.0,False
2055,69ad2026f606b2b9d6ea018aa37b10a8c7bf379c,/Users/sanika/Downloads/Master Thesis/repo_updated/pytest/testing/example_scripts/fixtures/custom_item/foo/__init__.py,5077.0,ModificationType.MODIFY,0,0,0,0,0,0,0,0,0,0,0,0,0,0.0,0.0,0.0,0.0,0.0,0.0,False
2056,69ad2026f606b2b9d6ea018aa37b10a8c7bf379c,/Users/sanika/Downloads/Master Thesis/repo_updated/pytest/doc/en/example/nonpython/__init__.py,5077.0,ModificationType.MODIFY,0,0,0,0,0,0,0,0,0,0,0,0,0,0.0,0.0,0.0,0.0,0.0,0.0,False
2057,69ad2026f606b2b9d6ea018aa37b10a8c7bf379c,/Users/sanika/Downloads/Master Thesis/repo_updated/pytest/src/pytest/__init__.py,5077.0,ModificationType.MODIFY,99,48,90,1,3,5,100,0,0,0,0,0,0,0.0,0.0,0.0,0.0,0.0,0.0,False
2058,69ad2026f606b2b9d6ea018aa37b10a8c7bf379c,/Users/sanika/Downloads/Master Thesis/repo_updated/pytest/src/_pytest/__init__.py,5077.0,ModificationType.MODIFY,8,5,5,2,0,1,10,0,0,0,0,0,0,0.0,0.0,0.0,0.0,0.0,0.0,False
2059,69ad2026f606b2b9d6ea018aa37b10a8c7bf379c,/Users/sanika/Downloads/Master Thesis/repo_updated/pytest/src/_pytest/config/__init__.py,5077.0,ModificationType.MODIFY,1217,716,841,84,126,174,1301,14,185,118,215,199,333,1446.608539104324,2542.995998641035,8.135135135135135,20687.616097052745,1149.3120053918194,0.847665332880345,False
2060,69ad2026f606b2b9d6ea018aa37b10a8c7bf379c,/Users/sanika/Downloads/Master Thesis/repo_updated/pytest/src/_pytest/mark/__init__.py,5077.0,ModificationType.MODIFY,160,89,115,0,13,31,160,7,15,11,17,22,28,78.25484338853101,124.86408532184431,3.966666666666667,495.29420510998256,27.516344728332356,0.04162136177394811,False
2061,69ad2026f606b2b9d6ea018aa37b10a8c7bf379c,/Users/sanika/Downloads/Master Thesis/repo_updated/pytest/src/_pytest/_code/__init__.py,5077.0,ModificationType.MODIFY,10,10,9,9,0,0,19,0,0,0,0,0,0,0.0,0.0,0.0,0.0,0.0,0.0,False
2062,69ad2026f606b2b9d6ea018aa37b10a8c7bf379c,/Users/sanika/Downloads/Master Thesis/repo_updated/pytest/src/_pytest/assertion/__init__.py,5077.0,ModificationType.MODIFY,173,84,99,8,29,36,181,5,12,7,13,17,20,54.62919048309069,81.7492568250068,2.708333333333333,221.40423723439343,12.300235401910744,0.027249752275002263,False
2063,69ad2026f606b2b9d6ea018aa37b10a8c7bf379c,/Users/sanika/Downloads/Master Thesis/repo_updated/pytest/src/_pytest/_io/__init__.py,5077.0,ModificationType.MODIFY,3,1,1,3,0,0,6,0,0,0,0,0,0,0.0,0.0,0.0,0.0,0.0,0.0,False
2064,69ad2026f606b2b9d6ea018aa37b10a8c7bf379c,/Users/sanika/Downloads/Master Thesis/repo_updated/pytest/testing/test_doctest.py,2771.0,ModificationType.MODIFY,1455,414,1257,16,76,112,1471,5,41,23,46,46,69,231.26927266377825,381.12577496793386,2.804878048780488,1069.0113200320095,59.3895177795561,0.1270419249893113,False
2065,69ad2026f606b2b9d6ea018aa37b10a8c7bf379c,/Users/sanika/Downloads/Master Thesis/repo_updated/pytest/src/_pytest/doctest.py,2771.0,ModificationType.MODIFY,669,365,481,22,61,110,691,15,103,63,122,118,185,747.3129132339992,1273.2889641319407,8.88349514563107,11311.256331851706,628.403129547317,0.4244296547106469,False
2066,69ad2026f606b2b9d6ea018aa37b10a8c7bf379c,/Users/sanika/Downloads/Master Thesis/repo_updated/pytest/testing/test_terminal.py,6420.0,ModificationType.MODIFY,1943,715,1694,26,18,214,1969,12,185,120,237,197,357,1436.3251202041715,2721.0724995459263,7.686486486486486,20915.486996509768,1161.971499806098,0.9070241665153088,False
2067,69ad2026f606b2b9d6ea018aa37b10a8c7bf379c,/Users/sanika/Downloads/Master Thesis/repo_updated/pytest/src/_pytest/terminal.py,6420.0,ModificationType.MODIFY,1168,838,957,57,25,144,1225,19,348,224,416,367,640,3018.854959310786,5452.567201819657,11.35632183908046,61921.107993078396,3440.0615551710216,1.817522400606552,False
2068,69ad2026f606b2b9d6ea018aa37b10a8c7bf379c,/Users/sanika/Downloads/Master Thesis/repo_updated/pytest/testing/test_doctest.py,3818.0,ModificationType.MODIFY,1455,414,1257,16,76,112,1471,5,41,23,46,46,69,231.26927266377825,381.12577496793386,2.804878048780488,1069.0113200320095,59.3895177795561,0.1270419249893113,False
2069,b66dc800081bff90b82b6e3649da5838c7531089,/Users/sanika/Downloads/Master Thesis/repo_updated/pytest/testing/test_junitxml.py,3203.0,ModificationType.MODIFY,1523,757,1297,19,12,193,1542,12,193,117,230,205,347,1508.3637582013935,2664.7795945283897,7.150259067357513,19053.86445828589,1058.5480254603274,0.8882598648427965,False
2070,b66dc800081bff90b82b6e3649da5838c7531089,/Users/sanika/Downloads/Master Thesis/repo_updated/pytest/src/_pytest/junitxml.py,3203.0,ModificationType.MODIFY,701,378,504,33,58,109,734,13,110,68,126,123,194,794.0552848235468,1346.8478140358125,7.445454545454545,10027.894179048459,557.1052321693588,0.4489492713452708,False
2071,b66dc800081bff90b82b6e3649da5838c7531089,/Users/sanika/Downloads/Master Thesis/repo_updated/pytest/testing/test_junitxml.py,5827.0,ModificationType.MODIFY,1523,757,1297,19,12,193,1542,12,193,117,230,205,347,1508.3637582013935,2664.7795945283897,7.150259067357513,19053.86445828589,1058.5480254603274,0.8882598648427965,False
2072,31d5cedc6d087d7f5932e8f53e968c15d72fa463,/Users/sanika/Downloads/Master Thesis/repo_updated/pytest/testing/test_junitxml.py,3209.0,ModificationType.MODIFY,1523,757,1297,19,12,193,1542,12,193,117,230,205,347,1508.3637582013935,2664.7795945283897,7.150259067357513,19053.86445828589,1058.5480254603274,0.8882598648427965,False
2073,31d5cedc6d087d7f5932e8f53e968c15d72fa463,/Users/sanika/Downloads/Master Thesis/repo_updated/pytest/src/_pytest/junitxml.py,3209.0,ModificationType.MODIFY,701,378,504,33,58,109,734,13,110,68,126,123,194,794.0552848235468,1346.8478140358125,7.445454545454545,10027.894179048459,557.1052321693588,0.4489492713452708,False
2074,209d99102da374bc2b445d08fba4c893d47a7a2a,/Users/sanika/Downloads/Master Thesis/repo_updated/pytest/testing/test_assertrewrite.py,5498.0,ModificationType.MODIFY,1660,832,1314,41,38,274,1701,20,312,209,395,332,604,2671.484054182769,5058.523816533542,12.660256410256409,64042.208574703494,3557.900476372417,1.6861746055111808,False
2075,209d99102da374bc2b445d08fba4c893d47a7a2a,/Users/sanika/Downloads/Master Thesis/repo_updated/pytest/src/_pytest/assertion/rewrite.py,5498.0,ModificationType.MODIFY,1057,646,719,113,100,145,1170,18,215,134,248,233,382,1740.9201126876956,3004.119107257935,10.381395348837211,31186.94812744052,1732.608229302251,1.001373035752645,False
2076,209d99102da374bc2b445d08fba4c893d47a7a2a,/Users/sanika/Downloads/Master Thesis/repo_updated/pytest/testing/test_warnings.py,1597.0,ModificationType.MODIFY,601,196,481,2,23,85,603,8,63,36,72,71,108,400.5686351804948,664.1726889065056,4.571428571428571,3036.21800642974,168.67877813498555,0.22139089630216852,False
2077,d3ab56f531f7419fb1bfe037244a96fa3ddf765c,/Users/sanika/Downloads/Master Thesis/repo_updated/pytest/doc/en/conf.py,458.0,ModificationType.MODIFY,382,65,130,157,2,92,539,4,10,5,10,14,15,41.21928094887362,57.11032383086405,2.0,114.22064766172814,6.345591536762672,0.019036774610288014,False
2078,d3ab56f531f7419fb1bfe037244a96fa3ddf765c,/Users/sanika/Downloads/Master Thesis/repo_updated/pytest/scripts/release.py,567.0,ModificationType.MODIFY,124,78,88,2,3,26,126,4,13,7,13,17,20,56.10571633583421,81.7492568250068,2.0,163.4985136500136,9.083250758334088,0.027249752275002263,False
2079,277857b026fbc4a5150b0e75b14660a2768e6d74,/Users/sanika/Downloads/Master Thesis/repo_updated/pytest/doc/en/conf.py,458.0,ModificationType.MODIFY,382,65,130,157,2,92,539,4,10,5,10,14,15,41.21928094887362,57.11032383086405,2.0,114.22064766172814,6.345591536762672,0.019036774610288014,False
2080,277857b026fbc4a5150b0e75b14660a2768e6d74,/Users/sanika/Downloads/Master Thesis/repo_updated/pytest/scripts/release.py,567.0,ModificationType.MODIFY,124,78,88,2,3,26,126,4,13,7,13,17,20,56.10571633583421,81.7492568250068,2.0,163.4985136500136,9.083250758334088,0.027249752275002263,False
2081,172b82875a2c3c1052938a300bc97d8cfb9688ab,/Users/sanika/Downloads/Master Thesis/repo_updated/pytest/testing/test_cacheprovider.py,2116.0,ModificationType.MODIFY,996,429,845,24,10,117,1020,7,76,50,88,83,138,494.49397547611574,879.7554415258757,4.052631578947368,3565.324684078549,198.07359355991935,0.2932518138419585,False
2082,172b82875a2c3c1052938a300bc97d8cfb9688ab,/Users/sanika/Downloads/Master Thesis/repo_updated/pytest/src/_pytest/cacheprovider.py,2116.0,ModificationType.MODIFY,456,277,329,12,42,72,468,13,85,50,97,98,147,592.903945907539,972.3623470849358,7.417647058823531,7212.640703965319,400.7022613314065,0.3241207823616453,False
2083,172b82875a2c3c1052938a300bc97d8cfb9688ab,/Users/sanika/Downloads/Master Thesis/repo_updated/pytest/testing/test_cacheprovider.py,3888.0,ModificationType.MODIFY,996,429,845,24,10,117,1020,7,76,50,88,83,138,494.49397547611574,879.7554415258757,4.052631578947368,3565.324684078549,198.07359355991935,0.2932518138419585,False
2084,23f6adc760cbeb78b71e2c82cf106f48535efa82,/Users/sanika/Downloads/Master Thesis/repo_updated/pytest/testing/test_cacheprovider.py,2116.0,ModificationType.MODIFY,996,429,845,24,10,117,1020,7,76,50,88,83,138,494.49397547611574,879.7554415258757,4.052631578947368,3565.324684078549,198.07359355991935,0.2932518138419585,False
2085,23f6adc760cbeb78b71e2c82cf106f48535efa82,/Users/sanika/Downloads/Master Thesis/repo_updated/pytest/src/_pytest/cacheprovider.py,2116.0,ModificationType.MODIFY,456,277,329,12,42,72,468,13,85,50,97,98,147,592.903945907539,972.3623470849358,7.417647058823531,7212.640703965319,400.7022613314065,0.3241207823616453,False
2086,23f6adc760cbeb78b71e2c82cf106f48535efa82,/Users/sanika/Downloads/Master Thesis/repo_updated/pytest/testing/test_cacheprovider.py,3888.0,ModificationType.MODIFY,996,429,845,24,10,117,1020,7,76,50,88,83,138,494.49397547611574,879.7554415258757,4.052631578947368,3565.324684078549,198.07359355991935,0.2932518138419585,False
2087,d2d7b97a70c1e9dce9e2018c885a4e4203fadf64,/Users/sanika/Downloads/Master Thesis/repo_updated/pytest/testing/conftest.py,,ModificationType.DELETE,127,75,83,2,11,30,129,4,14,7,14,18,21,61.302968908806456,87.56842503028854,2.0,175.13685006057707,9.729825003365397,0.02918947501009618,False
2088,d2d7b97a70c1e9dce9e2018c885a4e4203fadf64,/Users/sanika/Downloads/Master Thesis/repo_updated/pytest/testing/test_conftest.py,,ModificationType.DELETE,652,304,544,16,6,88,668,6,89,51,101,95,152,591.8500503603364,998.618052466304,3.4044943820224716,3399.789549407755,188.87719718931967,0.3328726841554347,False
2089,d2d7b97a70c1e9dce9e2018c885a4e4203fadf64,/Users/sanika/Downloads/Master Thesis/repo_updated/pytest/testing/example_scripts/collect/package_infinite_recursion/conftest.py,,ModificationType.DELETE,2,2,2,0,0,0,2,0,0,0,0,0,0,0.0,0.0,0.0,0.0,0.0,0.0,False
2090,d2d7b97a70c1e9dce9e2018c885a4e4203fadf64,/Users/sanika/Downloads/Master Thesis/repo_updated/pytest/testing/example_scripts/conftest_usageerror/conftest.py,,ModificationType.DELETE,8,5,5,0,0,3,8,0,0,0,0,0,0,0.0,0.0,0.0,0.0,0.0,0.0,False
2091,d2d7b97a70c1e9dce9e2018c885a4e4203fadf64,/Users/sanika/Downloads/Master Thesis/repo_updated/pytest/testing/example_scripts/marks/marks_considered_keywords/conftest.py,,ModificationType.DELETE,0,0,0,0,0,0,0,0,0,0,0,0,0,0.0,0.0,0.0,0.0,0.0,0.0,False
2092,d2d7b97a70c1e9dce9e2018c885a4e4203fadf64,/Users/sanika/Downloads/Master Thesis/repo_updated/pytest/testing/example_scripts/config/collect_pytest_prefix/conftest.py,,ModificationType.DELETE,2,2,2,0,0,0,2,0,0,0,0,0,0,0.0,0.0,0.0,0.0,0.0,0.0,False
2093,d2d7b97a70c1e9dce9e2018c885a4e4203fadf64,/Users/sanika/Downloads/Master Thesis/repo_updated/pytest/testing/example_scripts/issue88_initial_file_multinodes/conftest.py,,ModificationType.DELETE,14,8,8,0,0,6,14,0,0,0,0,0,0,0.0,0.0,0.0,0.0,0.0,0.0,False
2094,d2d7b97a70c1e9dce9e2018c885a4e4203fadf64,/Users/sanika/Downloads/Master Thesis/repo_updated/pytest/testing/example_scripts/fixtures/fill_fixtures/test_extend_fixture_conftest_conftest/conftest.py,,ModificationType.DELETE,6,4,4,0,0,2,6,0,0,0,0,0,0,0.0,0.0,0.0,0.0,0.0,0.0,False
2095,d2d7b97a70c1e9dce9e2018c885a4e4203fadf64,/Users/sanika/Downloads/Master Thesis/repo_updated/pytest/testing/example_scripts/fixtures/fill_fixtures/test_extend_fixture_conftest_conftest/pkg/conftest.py,,ModificationType.DELETE,6,4,4,0,0,2,6,1,2,1,2,3,3,2.0,4.754887502163468,0.5,2.3774437510817346,0.1320802083934297,0.0015849625007211565,False
2096,d2d7b97a70c1e9dce9e2018c885a4e4203fadf64,/Users/sanika/Downloads/Master Thesis/repo_updated/pytest/testing/example_scripts/fixtures/fill_fixtures/test_extend_fixture_conftest_module/conftest.py,,ModificationType.DELETE,6,4,4,0,0,2,6,0,0,0,0,0,0,0.0,0.0,0.0,0.0,0.0,0.0,False
2097,d2d7b97a70c1e9dce9e2018c885a4e4203fadf64,/Users/sanika/Downloads/Master Thesis/repo_updated/pytest/testing/example_scripts/fixtures/fill_fixtures/test_conftest_funcargs_only_available_in_subdir/sub1/conftest.py,,ModificationType.DELETE,7,5,5,0,0,2,7,0,0,0,0,0,0,0.0,0.0,0.0,0.0,0.0,0.0,False
2098,d2d7b97a70c1e9dce9e2018c885a4e4203fadf64,/Users/sanika/Downloads/Master Thesis/repo_updated/pytest/testing/example_scripts/fixtures/fill_fixtures/test_conftest_funcargs_only_available_in_subdir/sub2/conftest.py,,ModificationType.DELETE,6,4,4,0,0,2,6,0,0,0,0,0,0,0.0,0.0,0.0,0.0,0.0,0.0,False
2099,d2d7b97a70c1e9dce9e2018c885a4e4203fadf64,/Users/sanika/Downloads/Master Thesis/repo_updated/pytest/testing/example_scripts/fixtures/custom_item/conftest.py,,ModificationType.DELETE,10,6,6,0,0,4,10,0,0,0,0,0,0,0.0,0.0,0.0,0.0,0.0,0.0,False
2100,d2d7b97a70c1e9dce9e2018c885a4e4203fadf64,/Users/sanika/Downloads/Master Thesis/repo_updated/pytest/doc/en/conftest.py,,ModificationType.DELETE,1,1,1,0,0,0,1,0,0,0,0,0,0,0.0,0.0,0.0,0.0,0.0,0.0,False
2101,d2d7b97a70c1e9dce9e2018c885a4e4203fadf64,/Users/sanika/Downloads/Master Thesis/repo_updated/pytest/doc/en/example/conftest.py,,ModificationType.DELETE,1,1,1,0,0,0,1,0,0,0,0,0,0,0.0,0.0,0.0,0.0,0.0,0.0,False
2102,d2d7b97a70c1e9dce9e2018c885a4e4203fadf64,/Users/sanika/Downloads/Master Thesis/repo_updated/pytest/doc/en/example/assertion/global_testmodule_config/conftest.py,,ModificationType.DELETE,14,10,10,0,0,4,14,1,1,1,1,2,2,0.0,2.0,0.5,1.0,0.05555555555555555,0.0006666666666666666,False
2103,d2d7b97a70c1e9dce9e2018c885a4e4203fadf64,/Users/sanika/Downloads/Master Thesis/repo_updated/pytest/doc/en/example/nonpython/conftest.py,,ModificationType.DELETE,46,26,30,3,0,12,49,3,6,3,6,9,9,20.264662506490406,28.52932501298081,1.5,42.79398751947122,2.377443751081734,0.009509775004326938,False
2104,256a9e0027f8479d3e9951ffd00e41df00e603d7,/Users/sanika/Downloads/Master Thesis/repo_updated/pytest/testing/conftest.py,,ModificationType.DELETE,127,75,83,2,11,30,129,4,14,7,14,18,21,61.302968908806456,87.56842503028854,2.0,175.13685006057707,9.729825003365397,0.02918947501009618,False
2105,256a9e0027f8479d3e9951ffd00e41df00e603d7,/Users/sanika/Downloads/Master Thesis/repo_updated/pytest/testing/test_conftest.py,,ModificationType.DELETE,652,304,544,16,6,88,668,6,89,51,101,95,152,591.8500503603364,998.618052466304,3.4044943820224716,3399.789549407755,188.87719718931967,0.3328726841554347,False
2106,256a9e0027f8479d3e9951ffd00e41df00e603d7,/Users/sanika/Downloads/Master Thesis/repo_updated/pytest/testing/example_scripts/collect/package_infinite_recursion/conftest.py,,ModificationType.DELETE,2,2,2,0,0,0,2,0,0,0,0,0,0,0.0,0.0,0.0,0.0,0.0,0.0,False
2107,256a9e0027f8479d3e9951ffd00e41df00e603d7,/Users/sanika/Downloads/Master Thesis/repo_updated/pytest/testing/example_scripts/conftest_usageerror/conftest.py,,ModificationType.DELETE,8,5,5,0,0,3,8,0,0,0,0,0,0,0.0,0.0,0.0,0.0,0.0,0.0,False
2108,256a9e0027f8479d3e9951ffd00e41df00e603d7,/Users/sanika/Downloads/Master Thesis/repo_updated/pytest/testing/example_scripts/marks/marks_considered_keywords/conftest.py,,ModificationType.DELETE,0,0,0,0,0,0,0,0,0,0,0,0,0,0.0,0.0,0.0,0.0,0.0,0.0,False
2109,256a9e0027f8479d3e9951ffd00e41df00e603d7,/Users/sanika/Downloads/Master Thesis/repo_updated/pytest/testing/example_scripts/config/collect_pytest_prefix/conftest.py,,ModificationType.DELETE,2,2,2,0,0,0,2,0,0,0,0,0,0,0.0,0.0,0.0,0.0,0.0,0.0,False
2110,256a9e0027f8479d3e9951ffd00e41df00e603d7,/Users/sanika/Downloads/Master Thesis/repo_updated/pytest/testing/example_scripts/issue88_initial_file_multinodes/conftest.py,,ModificationType.DELETE,14,8,8,0,0,6,14,0,0,0,0,0,0,0.0,0.0,0.0,0.0,0.0,0.0,False
2111,256a9e0027f8479d3e9951ffd00e41df00e603d7,/Users/sanika/Downloads/Master Thesis/repo_updated/pytest/testing/example_scripts/fixtures/fill_fixtures/test_extend_fixture_conftest_conftest/conftest.py,,ModificationType.DELETE,6,4,4,0,0,2,6,0,0,0,0,0,0,0.0,0.0,0.0,0.0,0.0,0.0,False
2112,256a9e0027f8479d3e9951ffd00e41df00e603d7,/Users/sanika/Downloads/Master Thesis/repo_updated/pytest/testing/example_scripts/fixtures/fill_fixtures/test_extend_fixture_conftest_conftest/pkg/conftest.py,,ModificationType.DELETE,6,4,4,0,0,2,6,1,2,1,2,3,3,2.0,4.754887502163468,0.5,2.3774437510817346,0.1320802083934297,0.0015849625007211565,False
2113,256a9e0027f8479d3e9951ffd00e41df00e603d7,/Users/sanika/Downloads/Master Thesis/repo_updated/pytest/testing/example_scripts/fixtures/fill_fixtures/test_extend_fixture_conftest_module/conftest.py,,ModificationType.DELETE,6,4,4,0,0,2,6,0,0,0,0,0,0,0.0,0.0,0.0,0.0,0.0,0.0,False
2114,256a9e0027f8479d3e9951ffd00e41df00e603d7,/Users/sanika/Downloads/Master Thesis/repo_updated/pytest/testing/example_scripts/fixtures/fill_fixtures/test_conftest_funcargs_only_available_in_subdir/sub1/conftest.py,,ModificationType.DELETE,7,5,5,0,0,2,7,0,0,0,0,0,0,0.0,0.0,0.0,0.0,0.0,0.0,False
2115,256a9e0027f8479d3e9951ffd00e41df00e603d7,/Users/sanika/Downloads/Master Thesis/repo_updated/pytest/testing/example_scripts/fixtures/fill_fixtures/test_conftest_funcargs_only_available_in_subdir/sub2/conftest.py,,ModificationType.DELETE,6,4,4,0,0,2,6,0,0,0,0,0,0,0.0,0.0,0.0,0.0,0.0,0.0,False
2116,256a9e0027f8479d3e9951ffd00e41df00e603d7,/Users/sanika/Downloads/Master Thesis/repo_updated/pytest/testing/example_scripts/fixtures/custom_item/conftest.py,,ModificationType.DELETE,10,6,6,0,0,4,10,0,0,0,0,0,0,0.0,0.0,0.0,0.0,0.0,0.0,False
2117,256a9e0027f8479d3e9951ffd00e41df00e603d7,/Users/sanika/Downloads/Master Thesis/repo_updated/pytest/doc/en/conftest.py,,ModificationType.DELETE,1,1,1,0,0,0,1,0,0,0,0,0,0,0.0,0.0,0.0,0.0,0.0,0.0,False
2118,256a9e0027f8479d3e9951ffd00e41df00e603d7,/Users/sanika/Downloads/Master Thesis/repo_updated/pytest/doc/en/example/conftest.py,,ModificationType.DELETE,1,1,1,0,0,0,1,0,0,0,0,0,0,0.0,0.0,0.0,0.0,0.0,0.0,False
2119,256a9e0027f8479d3e9951ffd00e41df00e603d7,/Users/sanika/Downloads/Master Thesis/repo_updated/pytest/doc/en/example/assertion/global_testmodule_config/conftest.py,,ModificationType.DELETE,14,10,10,0,0,4,14,1,1,1,1,2,2,0.0,2.0,0.5,1.0,0.05555555555555555,0.0006666666666666666,False
2120,256a9e0027f8479d3e9951ffd00e41df00e603d7,/Users/sanika/Downloads/Master Thesis/repo_updated/pytest/doc/en/example/nonpython/conftest.py,,ModificationType.DELETE,46,26,30,3,0,12,49,3,6,3,6,9,9,20.264662506490406,28.52932501298081,1.5,42.79398751947122,2.377443751081734,0.009509775004326938,False
2121,e5bd7fb0530efa49e5ca7d5fcd9fd741968226b0,/Users/sanika/Downloads/Master Thesis/repo_updated/pytest/testing/example_scripts/collect/package_infinite_recursion/__init__.pyi,361.0,ModificationType.RENAME,0,0,0,0,0,0,0,0,0,0,0,0,0,0.0,0.0,0.0,0.0,0.0,0.0,False
2122,e5bd7fb0530efa49e5ca7d5fcd9fd741968226b0,/Users/sanika/Downloads/Master Thesis/repo_updated/pytest/testing/example_scripts/collect/package_infinite_recursion/tests/__init__.py,361.0,ModificationType.RENAME,0,0,0,0,0,0,0,0,0,0,0,0,0,0.0,0.0,0.0,0.0,0.0,0.0,False
2123,e5bd7fb0530efa49e5ca7d5fcd9fd741968226b0,/Users/sanika/Downloads/Master Thesis/repo_updated/pytest/testing/example_scripts/collect/collect_init_tests/tests/__init__.py,361.0,ModificationType.RENAME,2,2,2,0,0,0,2,0,0,0,0,0,0,0.0,0.0,0.0,0.0,0.0,0.0,False
2124,e5bd7fb0530efa49e5ca7d5fcd9fd741968226b0,/Users/sanika/Downloads/Master Thesis/repo_updated/pytest/testing/example_scripts/collect/package_init_given_as_arg/pkg/__init__.py,361.0,ModificationType.RENAME,0,0,0,0,0,0,0,0,0,0,0,0,0,0.0,0.0,0.0,0.0,0.0,0.0,False
2125,e5bd7fb0530efa49e5ca7d5fcd9fd741968226b0,/Users/sanika/Downloads/Master Thesis/repo_updated/pytest/testing/example_scripts/conftest_usageerror/__init__.pyi,361.0,ModificationType.RENAME,0,0,0,0,0,0,0,0,0,0,0,0,0,0.0,0.0,0.0,0.0,0.0,0.0,False
2126,e5bd7fb0530efa49e5ca7d5fcd9fd741968226b0,/Users/sanika/Downloads/Master Thesis/repo_updated/pytest/testing/example_scripts/marks/marks_considered_keywords/__init__.pyi,361.0,ModificationType.RENAME,0,0,0,0,0,0,0,0,0,0,0,0,0,0.0,0.0,0.0,0.0,0.0,0.0,False
2127,e5bd7fb0530efa49e5ca7d5fcd9fd741968226b0,/Users/sanika/Downloads/Master Thesis/repo_updated/pytest/testing/example_scripts/config/collect_pytest_prefix/__init__.pyi,361.0,ModificationType.RENAME,0,0,0,0,0,0,0,0,0,0,0,0,0,0.0,0.0,0.0,0.0,0.0,0.0,False
2128,e5bd7fb0530efa49e5ca7d5fcd9fd741968226b0,/Users/sanika/Downloads/Master Thesis/repo_updated/pytest/testing/example_scripts/issue88_initial_file_multinodes/__init__.pyi,361.0,ModificationType.RENAME,0,0,0,0,0,0,0,0,0,0,0,0,0,0.0,0.0,0.0,0.0,0.0,0.0,False
2129,e5bd7fb0530efa49e5ca7d5fcd9fd741968226b0,/Users/sanika/Downloads/Master Thesis/repo_updated/pytest/testing/example_scripts/fixtures/fill_fixtures/test_extend_fixture_conftest_conftest/__init__.pyi,361.0,ModificationType.RENAME,0,0,0,0,0,0,0,0,0,0,0,0,0,0.0,0.0,0.0,0.0,0.0,0.0,False
2130,e5bd7fb0530efa49e5ca7d5fcd9fd741968226b0,/Users/sanika/Downloads/Master Thesis/repo_updated/pytest/testing/example_scripts/fixtures/fill_fixtures/test_extend_fixture_conftest_conftest/pkg/__init__.py,361.0,ModificationType.RENAME,0,0,0,0,0,0,0,0,0,0,0,0,0,0.0,0.0,0.0,0.0,0.0,0.0,False
2131,e5bd7fb0530efa49e5ca7d5fcd9fd741968226b0,/Users/sanika/Downloads/Master Thesis/repo_updated/pytest/testing/example_scripts/fixtures/fill_fixtures/test_extend_fixture_conftest_module/__init__.pyi,361.0,ModificationType.RENAME,0,0,0,0,0,0,0,0,0,0,0,0,0,0.0,0.0,0.0,0.0,0.0,0.0,False
2132,e5bd7fb0530efa49e5ca7d5fcd9fd741968226b0,/Users/sanika/Downloads/Master Thesis/repo_updated/pytest/testing/example_scripts/fixtures/fill_fixtures/test_conftest_funcargs_only_available_in_subdir/sub1/__init__.py,361.0,ModificationType.RENAME,0,0,0,0,0,0,0,0,0,0,0,0,0,0.0,0.0,0.0,0.0,0.0,0.0,False
2133,e5bd7fb0530efa49e5ca7d5fcd9fd741968226b0,/Users/sanika/Downloads/Master Thesis/repo_updated/pytest/testing/example_scripts/fixtures/fill_fixtures/test_conftest_funcargs_only_available_in_subdir/sub2/__init__.py,361.0,ModificationType.RENAME,0,0,0,0,0,0,0,0,0,0,0,0,0,0.0,0.0,0.0,0.0,0.0,0.0,False
2134,e5bd7fb0530efa49e5ca7d5fcd9fd741968226b0,/Users/sanika/Downloads/Master Thesis/repo_updated/pytest/testing/example_scripts/fixtures/custom_item/__init__.pyi,361.0,ModificationType.RENAME,0,0,0,0,0,0,0,0,0,0,0,0,0,0.0,0.0,0.0,0.0,0.0,0.0,False
2135,e5bd7fb0530efa49e5ca7d5fcd9fd741968226b0,/Users/sanika/Downloads/Master Thesis/repo_updated/pytest/testing/example_scripts/fixtures/custom_item/foo/__init__.py,361.0,ModificationType.RENAME,0,0,0,0,0,0,0,0,0,0,0,0,0,0.0,0.0,0.0,0.0,0.0,0.0,False
2136,e5bd7fb0530efa49e5ca7d5fcd9fd741968226b0,/Users/sanika/Downloads/Master Thesis/repo_updated/pytest/doc/en/example/nonpython/__init__.py,361.0,ModificationType.RENAME,0,0,0,0,0,0,0,0,0,0,0,0,0,0.0,0.0,0.0,0.0,0.0,0.0,False
2137,e5bd7fb0530efa49e5ca7d5fcd9fd741968226b0,/Users/sanika/Downloads/Master Thesis/repo_updated/pytest/src/pytest/__init__.py,361.0,ModificationType.RENAME,99,48,90,1,3,5,100,0,0,0,0,0,0,0.0,0.0,0.0,0.0,0.0,0.0,False
2138,e5bd7fb0530efa49e5ca7d5fcd9fd741968226b0,/Users/sanika/Downloads/Master Thesis/repo_updated/pytest/src/_pytest/__init__.py,361.0,ModificationType.RENAME,8,5,5,2,0,1,10,0,0,0,0,0,0,0.0,0.0,0.0,0.0,0.0,0.0,False
2139,e5bd7fb0530efa49e5ca7d5fcd9fd741968226b0,/Users/sanika/Downloads/Master Thesis/repo_updated/pytest/src/_pytest/config/__init__.py,361.0,ModificationType.RENAME,1217,716,841,84,126,174,1301,14,185,118,215,199,333,1446.608539104324,2542.995998641035,8.135135135135135,20687.616097052745,1149.3120053918194,0.847665332880345,False
2140,e5bd7fb0530efa49e5ca7d5fcd9fd741968226b0,/Users/sanika/Downloads/Master Thesis/repo_updated/pytest/src/_pytest/mark/__init__.py,361.0,ModificationType.RENAME,160,89,115,0,13,31,160,7,15,11,17,22,28,78.25484338853101,124.86408532184431,3.966666666666667,495.29420510998256,27.516344728332356,0.04162136177394811,False
2141,e5bd7fb0530efa49e5ca7d5fcd9fd741968226b0,/Users/sanika/Downloads/Master Thesis/repo_updated/pytest/src/_pytest/_code/__init__.py,361.0,ModificationType.RENAME,10,10,9,9,0,0,19,0,0,0,0,0,0,0.0,0.0,0.0,0.0,0.0,0.0,False
2142,e5bd7fb0530efa49e5ca7d5fcd9fd741968226b0,/Users/sanika/Downloads/Master Thesis/repo_updated/pytest/src/_pytest/assertion/__init__.py,361.0,ModificationType.RENAME,173,84,99,8,29,36,181,5,12,7,13,17,20,54.62919048309069,81.7492568250068,2.708333333333333,221.40423723439343,12.300235401910744,0.027249752275002263,False
2143,e5bd7fb0530efa49e5ca7d5fcd9fd741968226b0,/Users/sanika/Downloads/Master Thesis/repo_updated/pytest/src/_pytest/_io/__init__.py,361.0,ModificationType.RENAME,3,1,1,3,0,0,6,0,0,0,0,0,0,0.0,0.0,0.0,0.0,0.0,0.0,False
2144,e5bd7fb0530efa49e5ca7d5fcd9fd741968226b0,/Users/sanika/Downloads/Master Thesis/repo_updated/pytest/src/pytest/__main__.py,17.0,ModificationType.ADD,7,4,3,0,3,1,7,1,2,1,2,3,3,2.0,4.754887502163468,0.5,2.3774437510817346,0.1320802083934297,0.0015849625007211565,False
2145,1dc612f7d41bdbf5e40a5b539c607c62b04f2ed3,/Users/sanika/Downloads/Master Thesis/repo_updated/pytest/testing/example_scripts/collect/package_infinite_recursion/__init__.pyi,361.0,ModificationType.RENAME,0,0,0,0,0,0,0,0,0,0,0,0,0,0.0,0.0,0.0,0.0,0.0,0.0,False
2146,1dc612f7d41bdbf5e40a5b539c607c62b04f2ed3,/Users/sanika/Downloads/Master Thesis/repo_updated/pytest/testing/example_scripts/collect/package_infinite_recursion/tests/__init__.py,361.0,ModificationType.RENAME,0,0,0,0,0,0,0,0,0,0,0,0,0,0.0,0.0,0.0,0.0,0.0,0.0,False
2147,1dc612f7d41bdbf5e40a5b539c607c62b04f2ed3,/Users/sanika/Downloads/Master Thesis/repo_updated/pytest/testing/example_scripts/collect/collect_init_tests/tests/__init__.py,361.0,ModificationType.RENAME,2,2,2,0,0,0,2,0,0,0,0,0,0,0.0,0.0,0.0,0.0,0.0,0.0,False
2148,1dc612f7d41bdbf5e40a5b539c607c62b04f2ed3,/Users/sanika/Downloads/Master Thesis/repo_updated/pytest/testing/example_scripts/collect/package_init_given_as_arg/pkg/__init__.py,361.0,ModificationType.RENAME,0,0,0,0,0,0,0,0,0,0,0,0,0,0.0,0.0,0.0,0.0,0.0,0.0,False
2149,1dc612f7d41bdbf5e40a5b539c607c62b04f2ed3,/Users/sanika/Downloads/Master Thesis/repo_updated/pytest/testing/example_scripts/conftest_usageerror/__init__.pyi,361.0,ModificationType.RENAME,0,0,0,0,0,0,0,0,0,0,0,0,0,0.0,0.0,0.0,0.0,0.0,0.0,False
2150,1dc612f7d41bdbf5e40a5b539c607c62b04f2ed3,/Users/sanika/Downloads/Master Thesis/repo_updated/pytest/testing/example_scripts/marks/marks_considered_keywords/__init__.pyi,361.0,ModificationType.RENAME,0,0,0,0,0,0,0,0,0,0,0,0,0,0.0,0.0,0.0,0.0,0.0,0.0,False
2151,1dc612f7d41bdbf5e40a5b539c607c62b04f2ed3,/Users/sanika/Downloads/Master Thesis/repo_updated/pytest/testing/example_scripts/config/collect_pytest_prefix/__init__.pyi,361.0,ModificationType.RENAME,0,0,0,0,0,0,0,0,0,0,0,0,0,0.0,0.0,0.0,0.0,0.0,0.0,False
2152,1dc612f7d41bdbf5e40a5b539c607c62b04f2ed3,/Users/sanika/Downloads/Master Thesis/repo_updated/pytest/testing/example_scripts/issue88_initial_file_multinodes/__init__.pyi,361.0,ModificationType.RENAME,0,0,0,0,0,0,0,0,0,0,0,0,0,0.0,0.0,0.0,0.0,0.0,0.0,False
2153,1dc612f7d41bdbf5e40a5b539c607c62b04f2ed3,/Users/sanika/Downloads/Master Thesis/repo_updated/pytest/testing/example_scripts/fixtures/fill_fixtures/test_extend_fixture_conftest_conftest/__init__.pyi,361.0,ModificationType.RENAME,0,0,0,0,0,0,0,0,0,0,0,0,0,0.0,0.0,0.0,0.0,0.0,0.0,False
2154,1dc612f7d41bdbf5e40a5b539c607c62b04f2ed3,/Users/sanika/Downloads/Master Thesis/repo_updated/pytest/testing/example_scripts/fixtures/fill_fixtures/test_extend_fixture_conftest_conftest/pkg/__init__.py,361.0,ModificationType.RENAME,0,0,0,0,0,0,0,0,0,0,0,0,0,0.0,0.0,0.0,0.0,0.0,0.0,False
2155,1dc612f7d41bdbf5e40a5b539c607c62b04f2ed3,/Users/sanika/Downloads/Master Thesis/repo_updated/pytest/testing/example_scripts/fixtures/fill_fixtures/test_extend_fixture_conftest_module/__init__.pyi,361.0,ModificationType.RENAME,0,0,0,0,0,0,0,0,0,0,0,0,0,0.0,0.0,0.0,0.0,0.0,0.0,False
2156,1dc612f7d41bdbf5e40a5b539c607c62b04f2ed3,/Users/sanika/Downloads/Master Thesis/repo_updated/pytest/testing/example_scripts/fixtures/fill_fixtures/test_conftest_funcargs_only_available_in_subdir/sub1/__init__.py,361.0,ModificationType.RENAME,0,0,0,0,0,0,0,0,0,0,0,0,0,0.0,0.0,0.0,0.0,0.0,0.0,False
2157,1dc612f7d41bdbf5e40a5b539c607c62b04f2ed3,/Users/sanika/Downloads/Master Thesis/repo_updated/pytest/testing/example_scripts/fixtures/fill_fixtures/test_conftest_funcargs_only_available_in_subdir/sub2/__init__.py,361.0,ModificationType.RENAME,0,0,0,0,0,0,0,0,0,0,0,0,0,0.0,0.0,0.0,0.0,0.0,0.0,False
2158,1dc612f7d41bdbf5e40a5b539c607c62b04f2ed3,/Users/sanika/Downloads/Master Thesis/repo_updated/pytest/testing/example_scripts/fixtures/custom_item/__init__.pyi,361.0,ModificationType.RENAME,0,0,0,0,0,0,0,0,0,0,0,0,0,0.0,0.0,0.0,0.0,0.0,0.0,False
2159,1dc612f7d41bdbf5e40a5b539c607c62b04f2ed3,/Users/sanika/Downloads/Master Thesis/repo_updated/pytest/testing/example_scripts/fixtures/custom_item/foo/__init__.py,361.0,ModificationType.RENAME,0,0,0,0,0,0,0,0,0,0,0,0,0,0.0,0.0,0.0,0.0,0.0,0.0,False
2160,1dc612f7d41bdbf5e40a5b539c607c62b04f2ed3,/Users/sanika/Downloads/Master Thesis/repo_updated/pytest/doc/en/example/nonpython/__init__.py,361.0,ModificationType.RENAME,0,0,0,0,0,0,0,0,0,0,0,0,0,0.0,0.0,0.0,0.0,0.0,0.0,False
2161,1dc612f7d41bdbf5e40a5b539c607c62b04f2ed3,/Users/sanika/Downloads/Master Thesis/repo_updated/pytest/src/pytest/__init__.py,361.0,ModificationType.RENAME,99,48,90,1,3,5,100,0,0,0,0,0,0,0.0,0.0,0.0,0.0,0.0,0.0,False
2162,1dc612f7d41bdbf5e40a5b539c607c62b04f2ed3,/Users/sanika/Downloads/Master Thesis/repo_updated/pytest/src/_pytest/__init__.py,361.0,ModificationType.RENAME,8,5,5,2,0,1,10,0,0,0,0,0,0,0.0,0.0,0.0,0.0,0.0,0.0,False
2163,1dc612f7d41bdbf5e40a5b539c607c62b04f2ed3,/Users/sanika/Downloads/Master Thesis/repo_updated/pytest/src/_pytest/config/__init__.py,361.0,ModificationType.RENAME,1217,716,841,84,126,174,1301,14,185,118,215,199,333,1446.608539104324,2542.995998641035,8.135135135135135,20687.616097052745,1149.3120053918194,0.847665332880345,False
2164,1dc612f7d41bdbf5e40a5b539c607c62b04f2ed3,/Users/sanika/Downloads/Master Thesis/repo_updated/pytest/src/_pytest/mark/__init__.py,361.0,ModificationType.RENAME,160,89,115,0,13,31,160,7,15,11,17,22,28,78.25484338853101,124.86408532184431,3.966666666666667,495.29420510998256,27.516344728332356,0.04162136177394811,False
2165,1dc612f7d41bdbf5e40a5b539c607c62b04f2ed3,/Users/sanika/Downloads/Master Thesis/repo_updated/pytest/src/_pytest/_code/__init__.py,361.0,ModificationType.RENAME,10,10,9,9,0,0,19,0,0,0,0,0,0,0.0,0.0,0.0,0.0,0.0,0.0,False
2166,1dc612f7d41bdbf5e40a5b539c607c62b04f2ed3,/Users/sanika/Downloads/Master Thesis/repo_updated/pytest/src/_pytest/assertion/__init__.py,361.0,ModificationType.RENAME,173,84,99,8,29,36,181,5,12,7,13,17,20,54.62919048309069,81.7492568250068,2.708333333333333,221.40423723439343,12.300235401910744,0.027249752275002263,False
2167,1dc612f7d41bdbf5e40a5b539c607c62b04f2ed3,/Users/sanika/Downloads/Master Thesis/repo_updated/pytest/src/_pytest/_io/__init__.py,361.0,ModificationType.RENAME,3,1,1,3,0,0,6,0,0,0,0,0,0,0.0,0.0,0.0,0.0,0.0,0.0,False
2168,1dc612f7d41bdbf5e40a5b539c607c62b04f2ed3,/Users/sanika/Downloads/Master Thesis/repo_updated/pytest/src/pytest/__main__.py,17.0,ModificationType.ADD,7,4,3,0,3,1,7,1,2,1,2,3,3,2.0,4.754887502163468,0.5,2.3774437510817346,0.1320802083934297,0.0015849625007211565,False
2169,c7f9fda42d475a5579aa988d8b491be3de53925b,/Users/sanika/Downloads/Master Thesis/repo_updated/pytest/testing/example_scripts/collect/package_infinite_recursion/__init__.pyi,5149.0,ModificationType.MODIFY,0,0,0,0,0,0,0,0,0,0,0,0,0,0.0,0.0,0.0,0.0,0.0,0.0,False
2170,c7f9fda42d475a5579aa988d8b491be3de53925b,/Users/sanika/Downloads/Master Thesis/repo_updated/pytest/testing/example_scripts/collect/package_infinite_recursion/tests/__init__.py,5149.0,ModificationType.MODIFY,0,0,0,0,0,0,0,0,0,0,0,0,0,0.0,0.0,0.0,0.0,0.0,0.0,False
2171,c7f9fda42d475a5579aa988d8b491be3de53925b,/Users/sanika/Downloads/Master Thesis/repo_updated/pytest/testing/example_scripts/collect/collect_init_tests/tests/__init__.py,5149.0,ModificationType.MODIFY,2,2,2,0,0,0,2,0,0,0,0,0,0,0.0,0.0,0.0,0.0,0.0,0.0,False
2172,c7f9fda42d475a5579aa988d8b491be3de53925b,/Users/sanika/Downloads/Master Thesis/repo_updated/pytest/testing/example_scripts/collect/package_init_given_as_arg/pkg/__init__.py,5149.0,ModificationType.MODIFY,0,0,0,0,0,0,0,0,0,0,0,0,0,0.0,0.0,0.0,0.0,0.0,0.0,False
2173,c7f9fda42d475a5579aa988d8b491be3de53925b,/Users/sanika/Downloads/Master Thesis/repo_updated/pytest/testing/example_scripts/conftest_usageerror/__init__.pyi,5149.0,ModificationType.MODIFY,0,0,0,0,0,0,0,0,0,0,0,0,0,0.0,0.0,0.0,0.0,0.0,0.0,False
2174,c7f9fda42d475a5579aa988d8b491be3de53925b,/Users/sanika/Downloads/Master Thesis/repo_updated/pytest/testing/example_scripts/marks/marks_considered_keywords/__init__.pyi,5149.0,ModificationType.MODIFY,0,0,0,0,0,0,0,0,0,0,0,0,0,0.0,0.0,0.0,0.0,0.0,0.0,False
2175,c7f9fda42d475a5579aa988d8b491be3de53925b,/Users/sanika/Downloads/Master Thesis/repo_updated/pytest/testing/example_scripts/config/collect_pytest_prefix/__init__.pyi,5149.0,ModificationType.MODIFY,0,0,0,0,0,0,0,0,0,0,0,0,0,0.0,0.0,0.0,0.0,0.0,0.0,False
2176,c7f9fda42d475a5579aa988d8b491be3de53925b,/Users/sanika/Downloads/Master Thesis/repo_updated/pytest/testing/example_scripts/issue88_initial_file_multinodes/__init__.pyi,5149.0,ModificationType.MODIFY,0,0,0,0,0,0,0,0,0,0,0,0,0,0.0,0.0,0.0,0.0,0.0,0.0,False
2177,c7f9fda42d475a5579aa988d8b491be3de53925b,/Users/sanika/Downloads/Master Thesis/repo_updated/pytest/testing/example_scripts/fixtures/fill_fixtures/test_extend_fixture_conftest_conftest/__init__.pyi,5149.0,ModificationType.MODIFY,0,0,0,0,0,0,0,0,0,0,0,0,0,0.0,0.0,0.0,0.0,0.0,0.0,False
2178,c7f9fda42d475a5579aa988d8b491be3de53925b,/Users/sanika/Downloads/Master Thesis/repo_updated/pytest/testing/example_scripts/fixtures/fill_fixtures/test_extend_fixture_conftest_conftest/pkg/__init__.py,5149.0,ModificationType.MODIFY,0,0,0,0,0,0,0,0,0,0,0,0,0,0.0,0.0,0.0,0.0,0.0,0.0,False
2179,c7f9fda42d475a5579aa988d8b491be3de53925b,/Users/sanika/Downloads/Master Thesis/repo_updated/pytest/testing/example_scripts/fixtures/fill_fixtures/test_extend_fixture_conftest_module/__init__.pyi,5149.0,ModificationType.MODIFY,0,0,0,0,0,0,0,0,0,0,0,0,0,0.0,0.0,0.0,0.0,0.0,0.0,False
2180,c7f9fda42d475a5579aa988d8b491be3de53925b,/Users/sanika/Downloads/Master Thesis/repo_updated/pytest/testing/example_scripts/fixtures/fill_fixtures/test_conftest_funcargs_only_available_in_subdir/sub1/__init__.py,5149.0,ModificationType.MODIFY,0,0,0,0,0,0,0,0,0,0,0,0,0,0.0,0.0,0.0,0.0,0.0,0.0,False
2181,c7f9fda42d475a5579aa988d8b491be3de53925b,/Users/sanika/Downloads/Master Thesis/repo_updated/pytest/testing/example_scripts/fixtures/fill_fixtures/test_conftest_funcargs_only_available_in_subdir/sub2/__init__.py,5149.0,ModificationType.MODIFY,0,0,0,0,0,0,0,0,0,0,0,0,0,0.0,0.0,0.0,0.0,0.0,0.0,False
2182,c7f9fda42d475a5579aa988d8b491be3de53925b,/Users/sanika/Downloads/Master Thesis/repo_updated/pytest/testing/example_scripts/fixtures/custom_item/__init__.pyi,5149.0,ModificationType.MODIFY,0,0,0,0,0,0,0,0,0,0,0,0,0,0.0,0.0,0.0,0.0,0.0,0.0,False
2183,c7f9fda42d475a5579aa988d8b491be3de53925b,/Users/sanika/Downloads/Master Thesis/repo_updated/pytest/testing/example_scripts/fixtures/custom_item/foo/__init__.py,5149.0,ModificationType.MODIFY,0,0,0,0,0,0,0,0,0,0,0,0,0,0.0,0.0,0.0,0.0,0.0,0.0,False
2184,c7f9fda42d475a5579aa988d8b491be3de53925b,/Users/sanika/Downloads/Master Thesis/repo_updated/pytest/doc/en/example/nonpython/__init__.py,5149.0,ModificationType.MODIFY,0,0,0,0,0,0,0,0,0,0,0,0,0,0.0,0.0,0.0,0.0,0.0,0.0,False
2185,c7f9fda42d475a5579aa988d8b491be3de53925b,/Users/sanika/Downloads/Master Thesis/repo_updated/pytest/src/pytest/__init__.py,5149.0,ModificationType.MODIFY,99,48,90,1,3,5,100,0,0,0,0,0,0,0.0,0.0,0.0,0.0,0.0,0.0,False
2186,c7f9fda42d475a5579aa988d8b491be3de53925b,/Users/sanika/Downloads/Master Thesis/repo_updated/pytest/src/_pytest/__init__.py,5149.0,ModificationType.MODIFY,8,5,5,2,0,1,10,0,0,0,0,0,0,0.0,0.0,0.0,0.0,0.0,0.0,False
2187,c7f9fda42d475a5579aa988d8b491be3de53925b,/Users/sanika/Downloads/Master Thesis/repo_updated/pytest/src/_pytest/config/__init__.py,5149.0,ModificationType.MODIFY,1217,716,841,84,126,174,1301,14,185,118,215,199,333,1446.608539104324,2542.995998641035,8.135135135135135,20687.616097052745,1149.3120053918194,0.847665332880345,False
2188,c7f9fda42d475a5579aa988d8b491be3de53925b,/Users/sanika/Downloads/Master Thesis/repo_updated/pytest/src/_pytest/mark/__init__.py,5149.0,ModificationType.MODIFY,160,89,115,0,13,31,160,7,15,11,17,22,28,78.25484338853101,124.86408532184431,3.966666666666667,495.29420510998256,27.516344728332356,0.04162136177394811,False
2189,c7f9fda42d475a5579aa988d8b491be3de53925b,/Users/sanika/Downloads/Master Thesis/repo_updated/pytest/src/_pytest/_code/__init__.py,5149.0,ModificationType.MODIFY,10,10,9,9,0,0,19,0,0,0,0,0,0,0.0,0.0,0.0,0.0,0.0,0.0,False
2190,c7f9fda42d475a5579aa988d8b491be3de53925b,/Users/sanika/Downloads/Master Thesis/repo_updated/pytest/src/_pytest/assertion/__init__.py,5149.0,ModificationType.MODIFY,173,84,99,8,29,36,181,5,12,7,13,17,20,54.62919048309069,81.7492568250068,2.708333333333333,221.40423723439343,12.300235401910744,0.027249752275002263,False
2191,c7f9fda42d475a5579aa988d8b491be3de53925b,/Users/sanika/Downloads/Master Thesis/repo_updated/pytest/src/_pytest/_io/__init__.py,5149.0,ModificationType.MODIFY,3,1,1,3,0,0,6,0,0,0,0,0,0,0.0,0.0,0.0,0.0,0.0,0.0,False
2192,c7f9fda42d475a5579aa988d8b491be3de53925b,/Users/sanika/Downloads/Master Thesis/repo_updated/pytest/testing/test_config.py,6090.0,ModificationType.MODIFY,1457,730,1242,11,6,188,1468,10,292,166,329,302,495,2424.648052141839,4078.0103459659135,5.633561643835616,22973.722668198385,1276.3179260110217,1.359336781988638,False
