CommitID,filename,token_count,change_type,loc,lloc,sloc,comments,multi,blank,code_comment,h1,h2,N1,N2,vocabulary,length,calculated_length,volume,difficulty,effort,time,bugs
1f639e2c22ca92f85521db7dd05f743e946ff338,/Users/sanika/Downloads/Master Thesis/repo_updated/pytest/setup.py,95,ModificationType.MODIFY,42,7,35,4,0,5,46,1,2,1,2,3,3,2.0,4.754887502163469,0.5,2.3774437510817346,0.1320802083934297,0.0015849625007211565
1f639e2c22ca92f85521db7dd05f743e946ff338,/Users/sanika/Downloads/Master Thesis/repo_updated/pytest/extra/setup-py.test/setup.py,95,ModificationType.MODIFY,11,6,10,0,0,1,11,2,4,2,4,6,6,10.0,15.509775004326936,1.0,15.509775004326936,0.861654166907052,0.005169925001442312
1f639e2c22ca92f85521db7dd05f743e946ff338,/Users/sanika/Downloads/Master Thesis/repo_updated/pytest/testing/python/fixtures.py,6237,ModificationType.MODIFY,4293,999,3693,19,54,507,4312,9,155,88,170,164,258,1156.3286078304877,1898.248417191466,4.935483870967742,9368.774446138526,520.4874692299181,0.6327494723971553
1f639e2c22ca92f85521db7dd05f743e946ff338,/Users/sanika/Downloads/Master Thesis/repo_updated/pytest/src/_pytest/fixtures.py,6237,ModificationType.MODIFY,1482,859,1002,125,135,219,1607,16,219,134,251,235,385,1766.678366052657,3032.459024427525,9.168949771689498,27804.464479682512,1544.692471093473,1.0108196748091751
1f639e2c22ca92f85521db7dd05f743e946ff338,/Users/sanika/Downloads/Master Thesis/repo_updated/pytest/testing/python/fixtures.py,8002,ModificationType.MODIFY,4293,999,3693,19,54,507,4312,9,155,88,170,164,258,1156.3286078304877,1898.248417191466,4.935483870967742,9368.774446138526,520.4874692299181,0.6327494723971553
1f639e2c22ca92f85521db7dd05f743e946ff338,/Users/sanika/Downloads/Master Thesis/repo_updated/pytest/src/_pytest/fixtures.py,8002,ModificationType.MODIFY,1482,859,1002,125,135,219,1607,16,219,134,251,235,385,1766.678366052657,3032.459024427525,9.168949771689498,27804.464479682512,1544.692471093473,1.0108196748091751
63e3d89647499b7c28bde50391fa9313edb21c5d,/Users/sanika/Downloads/Master Thesis/repo_updated/pytest/testing/python/fixtures.py,8002,ModificationType.MODIFY,4293,999,3693,19,54,507,4312,9,155,88,170,164,258,1156.3286078304877,1898.248417191466,4.935483870967742,9368.774446138526,520.4874692299181,0.6327494723971553
63e3d89647499b7c28bde50391fa9313edb21c5d,/Users/sanika/Downloads/Master Thesis/repo_updated/pytest/src/_pytest/fixtures.py,8002,ModificationType.MODIFY,1482,859,1002,125,135,219,1607,16,219,134,251,235,385,1766.678366052657,3032.459024427525,9.168949771689498,27804.464479682512,1544.692471093473,1.0108196748091751
122cf60b2789487efec2b725f429eaa59baf3ea2,/Users/sanika/Downloads/Master Thesis/repo_updated/pytest/testing/python/fixtures.py,6225,ModificationType.MODIFY,4293,999,3693,19,54,507,4312,9,155,88,170,164,258,1156.3286078304877,1898.248417191466,4.935483870967742,9368.774446138526,520.4874692299181,0.6327494723971553
122cf60b2789487efec2b725f429eaa59baf3ea2,/Users/sanika/Downloads/Master Thesis/repo_updated/pytest/src/_pytest/fixtures.py,6225,ModificationType.MODIFY,1482,859,1002,125,135,219,1607,16,219,134,251,235,385,1766.678366052657,3032.459024427525,9.168949771689498,27804.464479682512,1544.692471093473,1.0108196748091751
3322c1e03306b6db17ae7ea6991a5d6817658ae2,/Users/sanika/Downloads/Master Thesis/repo_updated/pytest/setup.py,95,ModificationType.MODIFY,42,7,35,4,0,5,46,1,2,1,2,3,3,2.0,4.754887502163469,0.5,2.3774437510817346,0.1320802083934297,0.0015849625007211565
3322c1e03306b6db17ae7ea6991a5d6817658ae2,/Users/sanika/Downloads/Master Thesis/repo_updated/pytest/extra/setup-py.test/setup.py,95,ModificationType.MODIFY,11,6,10,0,0,1,11,2,4,2,4,6,6,10.0,15.509775004326936,1.0,15.509775004326936,0.861654166907052,0.005169925001442312
3322c1e03306b6db17ae7ea6991a5d6817658ae2,/Users/sanika/Downloads/Master Thesis/repo_updated/pytest/testing/python/fixtures.py,6225,ModificationType.MODIFY,4293,999,3693,19,54,507,4312,9,155,88,170,164,258,1156.3286078304877,1898.248417191466,4.935483870967742,9368.774446138526,520.4874692299181,0.6327494723971553
3322c1e03306b6db17ae7ea6991a5d6817658ae2,/Users/sanika/Downloads/Master Thesis/repo_updated/pytest/src/_pytest/fixtures.py,6225,ModificationType.MODIFY,1482,859,1002,125,135,219,1607,16,219,134,251,235,385,1766.678366052657,3032.459024427525,9.168949771689498,27804.464479682512,1544.692471093473,1.0108196748091751
3322c1e03306b6db17ae7ea6991a5d6817658ae2,/Users/sanika/Downloads/Master Thesis/repo_updated/pytest/testing/python/fixtures.py,8002,ModificationType.MODIFY,4293,999,3693,19,54,507,4312,9,155,88,170,164,258,1156.3286078304877,1898.248417191466,4.935483870967742,9368.774446138526,520.4874692299181,0.6327494723971553
3322c1e03306b6db17ae7ea6991a5d6817658ae2,/Users/sanika/Downloads/Master Thesis/repo_updated/pytest/src/_pytest/fixtures.py,8002,ModificationType.MODIFY,1482,859,1002,125,135,219,1607,16,219,134,251,235,385,1766.678366052657,3032.459024427525,9.168949771689498,27804.464479682512,1544.692471093473,1.0108196748091751
361f0e6ba7f1949d7daefa882be4b7c975375e1c,/Users/sanika/Downloads/Master Thesis/repo_updated/pytest/testing/test_junitxml.py,5657,ModificationType.MODIFY,1523,757,1297,19,12,193,1542,12,193,117,230,205,347,1508.3637582013935,2664.7795945283897,7.150259067357513,19053.864458285894,1058.5480254603274,0.8882598648427965
c2ae0e0dc631cbcbc8921b79bcdc7740dad33aaf,/Users/sanika/Downloads/Master Thesis/repo_updated/pytest/testing/test_setuponly.py,,ModificationType.RENAME,294,64,250,0,0,43,294,1,20,10,20,21,30,86.43856189774725,131.76952268336282,0.5,65.88476134168141,3.6602645189823004,0.04392317422778761
c2ae0e0dc631cbcbc8921b79bcdc7740dad33aaf,/Users/sanika/Downloads/Master Thesis/repo_updated/pytest/testing/test_setupplan.py,,ModificationType.RENAME,110,30,77,3,13,16,113,4,21,15,30,25,45,100.23866587835397,208.9735285398626,2.857142857142857,597.0672243996074,33.17040135553375,0.06965784284662087
71a7fd02a574120ef9c1e9d6aeeb65d186cc756a,/Users/sanika/Downloads/Master Thesis/repo_updated/pytest/src/_pytest/logging.py,2754,ModificationType.MODIFY,773,422,505,30,103,129,803,14,77,46,83,91,129,535.8455325423139,839.5055085856318,7.545454545454546,6334.450655691586,351.9139253161992,0.2798351695285439
76c2a8ebbe367a8de8143aa91586d1c16e0bd482,/Users/sanika/Downloads/Master Thesis/repo_updated/pytest/src/_pytest/logging.py,2754,ModificationType.MODIFY,773,422,505,30,103,129,803,14,77,46,83,91,129,535.8455325423139,839.5055085856318,7.545454545454546,6334.450655691586,351.9139253161992,0.2798351695285439
0383d4364584a32899f73efd4c4e0d2a6b30a03e,/Users/sanika/Downloads/Master Thesis/repo_updated/pytest/testing/example_scripts/collect/package_infinite_recursion/__init__.pyi,5076,ModificationType.MODIFY,0,0,0,0,0,0,0,0,0,0,0,0,0,0,0,0,0,0.0,0.0
0383d4364584a32899f73efd4c4e0d2a6b30a03e,/Users/sanika/Downloads/Master Thesis/repo_updated/pytest/testing/example_scripts/collect/package_infinite_recursion/tests/__init__.py,5076,ModificationType.MODIFY,0,0,0,0,0,0,0,0,0,0,0,0,0,0,0,0,0,0.0,0.0
0383d4364584a32899f73efd4c4e0d2a6b30a03e,/Users/sanika/Downloads/Master Thesis/repo_updated/pytest/testing/example_scripts/collect/collect_init_tests/tests/__init__.py,5076,ModificationType.MODIFY,2,2,2,0,0,0,2,0,0,0,0,0,0,0,0,0,0,0.0,0.0
0383d4364584a32899f73efd4c4e0d2a6b30a03e,/Users/sanika/Downloads/Master Thesis/repo_updated/pytest/testing/example_scripts/collect/package_init_given_as_arg/pkg/__init__.py,5076,ModificationType.MODIFY,0,0,0,0,0,0,0,0,0,0,0,0,0,0,0,0,0,0.0,0.0
0383d4364584a32899f73efd4c4e0d2a6b30a03e,/Users/sanika/Downloads/Master Thesis/repo_updated/pytest/testing/example_scripts/conftest_usageerror/__init__.pyi,5076,ModificationType.MODIFY,0,0,0,0,0,0,0,0,0,0,0,0,0,0,0,0,0,0.0,0.0
0383d4364584a32899f73efd4c4e0d2a6b30a03e,/Users/sanika/Downloads/Master Thesis/repo_updated/pytest/testing/example_scripts/marks/marks_considered_keywords/__init__.pyi,5076,ModificationType.MODIFY,0,0,0,0,0,0,0,0,0,0,0,0,0,0,0,0,0,0.0,0.0
0383d4364584a32899f73efd4c4e0d2a6b30a03e,/Users/sanika/Downloads/Master Thesis/repo_updated/pytest/testing/example_scripts/config/collect_pytest_prefix/__init__.pyi,5076,ModificationType.MODIFY,0,0,0,0,0,0,0,0,0,0,0,0,0,0,0,0,0,0.0,0.0
0383d4364584a32899f73efd4c4e0d2a6b30a03e,/Users/sanika/Downloads/Master Thesis/repo_updated/pytest/testing/example_scripts/issue88_initial_file_multinodes/__init__.pyi,5076,ModificationType.MODIFY,0,0,0,0,0,0,0,0,0,0,0,0,0,0,0,0,0,0.0,0.0
0383d4364584a32899f73efd4c4e0d2a6b30a03e,/Users/sanika/Downloads/Master Thesis/repo_updated/pytest/testing/example_scripts/fixtures/fill_fixtures/test_extend_fixture_conftest_conftest/__init__.pyi,5076,ModificationType.MODIFY,0,0,0,0,0,0,0,0,0,0,0,0,0,0,0,0,0,0.0,0.0
0383d4364584a32899f73efd4c4e0d2a6b30a03e,/Users/sanika/Downloads/Master Thesis/repo_updated/pytest/testing/example_scripts/fixtures/fill_fixtures/test_extend_fixture_conftest_conftest/pkg/__init__.py,5076,ModificationType.MODIFY,0,0,0,0,0,0,0,0,0,0,0,0,0,0,0,0,0,0.0,0.0
0383d4364584a32899f73efd4c4e0d2a6b30a03e,/Users/sanika/Downloads/Master Thesis/repo_updated/pytest/testing/example_scripts/fixtures/fill_fixtures/test_extend_fixture_conftest_module/__init__.pyi,5076,ModificationType.MODIFY,0,0,0,0,0,0,0,0,0,0,0,0,0,0,0,0,0,0.0,0.0
0383d4364584a32899f73efd4c4e0d2a6b30a03e,/Users/sanika/Downloads/Master Thesis/repo_updated/pytest/testing/example_scripts/fixtures/fill_fixtures/test_conftest_funcargs_only_available_in_subdir/sub1/__init__.py,5076,ModificationType.MODIFY,0,0,0,0,0,0,0,0,0,0,0,0,0,0,0,0,0,0.0,0.0
0383d4364584a32899f73efd4c4e0d2a6b30a03e,/Users/sanika/Downloads/Master Thesis/repo_updated/pytest/testing/example_scripts/fixtures/fill_fixtures/test_conftest_funcargs_only_available_in_subdir/sub2/__init__.py,5076,ModificationType.MODIFY,0,0,0,0,0,0,0,0,0,0,0,0,0,0,0,0,0,0.0,0.0
0383d4364584a32899f73efd4c4e0d2a6b30a03e,/Users/sanika/Downloads/Master Thesis/repo_updated/pytest/testing/example_scripts/fixtures/custom_item/__init__.pyi,5076,ModificationType.MODIFY,0,0,0,0,0,0,0,0,0,0,0,0,0,0,0,0,0,0.0,0.0
0383d4364584a32899f73efd4c4e0d2a6b30a03e,/Users/sanika/Downloads/Master Thesis/repo_updated/pytest/testing/example_scripts/fixtures/custom_item/foo/__init__.py,5076,ModificationType.MODIFY,0,0,0,0,0,0,0,0,0,0,0,0,0,0,0,0,0,0.0,0.0
0383d4364584a32899f73efd4c4e0d2a6b30a03e,/Users/sanika/Downloads/Master Thesis/repo_updated/pytest/doc/en/example/nonpython/__init__.py,5076,ModificationType.MODIFY,0,0,0,0,0,0,0,0,0,0,0,0,0,0,0,0,0,0.0,0.0
0383d4364584a32899f73efd4c4e0d2a6b30a03e,/Users/sanika/Downloads/Master Thesis/repo_updated/pytest/src/pytest/__init__.py,5076,ModificationType.MODIFY,99,48,90,1,3,5,100,0,0,0,0,0,0,0,0,0,0,0.0,0.0
0383d4364584a32899f73efd4c4e0d2a6b30a03e,/Users/sanika/Downloads/Master Thesis/repo_updated/pytest/src/_pytest/__init__.py,5076,ModificationType.MODIFY,8,5,5,2,0,1,10,0,0,0,0,0,0,0,0,0,0,0.0,0.0
0383d4364584a32899f73efd4c4e0d2a6b30a03e,/Users/sanika/Downloads/Master Thesis/repo_updated/pytest/src/_pytest/config/__init__.py,5076,ModificationType.MODIFY,1217,716,841,84,126,174,1301,14,185,118,215,199,333,1446.608539104324,2542.995998641035,8.135135135135135,20687.616097052745,1149.3120053918192,0.847665332880345
0383d4364584a32899f73efd4c4e0d2a6b30a03e,/Users/sanika/Downloads/Master Thesis/repo_updated/pytest/src/_pytest/mark/__init__.py,5076,ModificationType.MODIFY,160,89,115,0,13,31,160,7,15,11,17,22,28,78.25484338853101,124.86408532184433,3.966666666666667,495.2942051099825,27.51634472833236,0.04162136177394811
0383d4364584a32899f73efd4c4e0d2a6b30a03e,/Users/sanika/Downloads/Master Thesis/repo_updated/pytest/src/_pytest/_code/__init__.py,5076,ModificationType.MODIFY,10,10,9,9,0,0,19,0,0,0,0,0,0,0,0,0,0,0.0,0.0
0383d4364584a32899f73efd4c4e0d2a6b30a03e,/Users/sanika/Downloads/Master Thesis/repo_updated/pytest/src/_pytest/assertion/__init__.py,5076,ModificationType.MODIFY,173,84,99,8,29,36,181,5,12,7,13,17,20,54.62919048309069,81.7492568250068,2.7083333333333335,221.4042372343934,12.300235401910745,0.027249752275002266
0383d4364584a32899f73efd4c4e0d2a6b30a03e,/Users/sanika/Downloads/Master Thesis/repo_updated/pytest/src/_pytest/_io/__init__.py,5076,ModificationType.MODIFY,3,1,1,3,0,0,6,0,0,0,0,0,0,0,0,0,0,0.0,0.0
0383d4364584a32899f73efd4c4e0d2a6b30a03e,/Users/sanika/Downloads/Master Thesis/repo_updated/pytest/testing/python/fixtures.py,6225,ModificationType.MODIFY,4293,999,3693,19,54,507,4312,9,155,88,170,164,258,1156.3286078304877,1898.248417191466,4.935483870967742,9368.774446138526,520.4874692299181,0.6327494723971553
0383d4364584a32899f73efd4c4e0d2a6b30a03e,/Users/sanika/Downloads/Master Thesis/repo_updated/pytest/src/_pytest/fixtures.py,6225,ModificationType.MODIFY,1482,859,1002,125,135,219,1607,16,219,134,251,235,385,1766.678366052657,3032.459024427525,9.168949771689498,27804.464479682512,1544.692471093473,1.0108196748091751
0383d4364584a32899f73efd4c4e0d2a6b30a03e,/Users/sanika/Downloads/Master Thesis/repo_updated/pytest/src/_pytest/hookspec.py,640,ModificationType.MODIFY,647,139,84,35,284,233,682,0,0,0,0,0,0,0,0,0,0,0.0,0.0
0383d4364584a32899f73efd4c4e0d2a6b30a03e,/Users/sanika/Downloads/Master Thesis/repo_updated/pytest/testing/test_main.py,3472,ModificationType.MODIFY,77,34,69,0,0,8,77,3,24,16,29,27,45,114.79398751947123,213.9699375973561,1.8125,387.82051189520797,21.54558399417822,0.07132331253245204
0383d4364584a32899f73efd4c4e0d2a6b30a03e,/Users/sanika/Downloads/Master Thesis/repo_updated/pytest/src/_pytest/main.py,3472,ModificationType.MODIFY,712,438,573,51,9,84,763,14,102,71,128,116,199,733.8903537898989,1364.7382180303869,8.784313725490197,11988.28866034536,666.0160366858534,0.45491273934346227
f739d511b0665dbfc0e93cab8c219c9e34f146c8,/Users/sanika/Downloads/Master Thesis/repo_updated/pytest/testing/test_junitxml.py,5657,ModificationType.MODIFY,1523,757,1297,19,12,193,1542,12,193,117,230,205,347,1508.3637582013935,2664.7795945283897,7.150259067357513,19053.864458285894,1058.5480254603274,0.8882598648427965
914a9465aba501e776282961fb3317837772435d,/Users/sanika/Downloads/Master Thesis/repo_updated/pytest/testing/test_setuponly.py,,ModificationType.RENAME,294,64,250,0,0,43,294,1,20,10,20,21,30,86.43856189774725,131.76952268336282,0.5,65.88476134168141,3.6602645189823004,0.04392317422778761
914a9465aba501e776282961fb3317837772435d,/Users/sanika/Downloads/Master Thesis/repo_updated/pytest/testing/test_setupplan.py,,ModificationType.RENAME,110,30,77,3,13,16,113,4,21,15,30,25,45,100.23866587835397,208.9735285398626,2.857142857142857,597.0672243996074,33.17040135553375,0.06965784284662087
77a995ffada780b8136740b0ff468189b60bda7a,/Users/sanika/Downloads/Master Thesis/repo_updated/pytest/testing/example_scripts/collect/package_infinite_recursion/__init__.pyi,5076,ModificationType.MODIFY,0,0,0,0,0,0,0,0,0,0,0,0,0,0,0,0,0,0.0,0.0
77a995ffada780b8136740b0ff468189b60bda7a,/Users/sanika/Downloads/Master Thesis/repo_updated/pytest/testing/example_scripts/collect/package_infinite_recursion/tests/__init__.py,5076,ModificationType.MODIFY,0,0,0,0,0,0,0,0,0,0,0,0,0,0,0,0,0,0.0,0.0
77a995ffada780b8136740b0ff468189b60bda7a,/Users/sanika/Downloads/Master Thesis/repo_updated/pytest/testing/example_scripts/collect/collect_init_tests/tests/__init__.py,5076,ModificationType.MODIFY,2,2,2,0,0,0,2,0,0,0,0,0,0,0,0,0,0,0.0,0.0
77a995ffada780b8136740b0ff468189b60bda7a,/Users/sanika/Downloads/Master Thesis/repo_updated/pytest/testing/example_scripts/collect/package_init_given_as_arg/pkg/__init__.py,5076,ModificationType.MODIFY,0,0,0,0,0,0,0,0,0,0,0,0,0,0,0,0,0,0.0,0.0
77a995ffada780b8136740b0ff468189b60bda7a,/Users/sanika/Downloads/Master Thesis/repo_updated/pytest/testing/example_scripts/conftest_usageerror/__init__.pyi,5076,ModificationType.MODIFY,0,0,0,0,0,0,0,0,0,0,0,0,0,0,0,0,0,0.0,0.0
77a995ffada780b8136740b0ff468189b60bda7a,/Users/sanika/Downloads/Master Thesis/repo_updated/pytest/testing/example_scripts/marks/marks_considered_keywords/__init__.pyi,5076,ModificationType.MODIFY,0,0,0,0,0,0,0,0,0,0,0,0,0,0,0,0,0,0.0,0.0
77a995ffada780b8136740b0ff468189b60bda7a,/Users/sanika/Downloads/Master Thesis/repo_updated/pytest/testing/example_scripts/config/collect_pytest_prefix/__init__.pyi,5076,ModificationType.MODIFY,0,0,0,0,0,0,0,0,0,0,0,0,0,0,0,0,0,0.0,0.0
77a995ffada780b8136740b0ff468189b60bda7a,/Users/sanika/Downloads/Master Thesis/repo_updated/pytest/testing/example_scripts/issue88_initial_file_multinodes/__init__.pyi,5076,ModificationType.MODIFY,0,0,0,0,0,0,0,0,0,0,0,0,0,0,0,0,0,0.0,0.0
77a995ffada780b8136740b0ff468189b60bda7a,/Users/sanika/Downloads/Master Thesis/repo_updated/pytest/testing/example_scripts/fixtures/fill_fixtures/test_extend_fixture_conftest_conftest/__init__.pyi,5076,ModificationType.MODIFY,0,0,0,0,0,0,0,0,0,0,0,0,0,0,0,0,0,0.0,0.0
77a995ffada780b8136740b0ff468189b60bda7a,/Users/sanika/Downloads/Master Thesis/repo_updated/pytest/testing/example_scripts/fixtures/fill_fixtures/test_extend_fixture_conftest_conftest/pkg/__init__.py,5076,ModificationType.MODIFY,0,0,0,0,0,0,0,0,0,0,0,0,0,0,0,0,0,0.0,0.0
77a995ffada780b8136740b0ff468189b60bda7a,/Users/sanika/Downloads/Master Thesis/repo_updated/pytest/testing/example_scripts/fixtures/fill_fixtures/test_extend_fixture_conftest_module/__init__.pyi,5076,ModificationType.MODIFY,0,0,0,0,0,0,0,0,0,0,0,0,0,0,0,0,0,0.0,0.0
77a995ffada780b8136740b0ff468189b60bda7a,/Users/sanika/Downloads/Master Thesis/repo_updated/pytest/testing/example_scripts/fixtures/fill_fixtures/test_conftest_funcargs_only_available_in_subdir/sub1/__init__.py,5076,ModificationType.MODIFY,0,0,0,0,0,0,0,0,0,0,0,0,0,0,0,0,0,0.0,0.0
77a995ffada780b8136740b0ff468189b60bda7a,/Users/sanika/Downloads/Master Thesis/repo_updated/pytest/testing/example_scripts/fixtures/fill_fixtures/test_conftest_funcargs_only_available_in_subdir/sub2/__init__.py,5076,ModificationType.MODIFY,0,0,0,0,0,0,0,0,0,0,0,0,0,0,0,0,0,0.0,0.0
77a995ffada780b8136740b0ff468189b60bda7a,/Users/sanika/Downloads/Master Thesis/repo_updated/pytest/testing/example_scripts/fixtures/custom_item/__init__.pyi,5076,ModificationType.MODIFY,0,0,0,0,0,0,0,0,0,0,0,0,0,0,0,0,0,0.0,0.0
77a995ffada780b8136740b0ff468189b60bda7a,/Users/sanika/Downloads/Master Thesis/repo_updated/pytest/testing/example_scripts/fixtures/custom_item/foo/__init__.py,5076,ModificationType.MODIFY,0,0,0,0,0,0,0,0,0,0,0,0,0,0,0,0,0,0.0,0.0
77a995ffada780b8136740b0ff468189b60bda7a,/Users/sanika/Downloads/Master Thesis/repo_updated/pytest/doc/en/example/nonpython/__init__.py,5076,ModificationType.MODIFY,0,0,0,0,0,0,0,0,0,0,0,0,0,0,0,0,0,0.0,0.0
77a995ffada780b8136740b0ff468189b60bda7a,/Users/sanika/Downloads/Master Thesis/repo_updated/pytest/src/pytest/__init__.py,5076,ModificationType.MODIFY,99,48,90,1,3,5,100,0,0,0,0,0,0,0,0,0,0,0.0,0.0
77a995ffada780b8136740b0ff468189b60bda7a,/Users/sanika/Downloads/Master Thesis/repo_updated/pytest/src/_pytest/__init__.py,5076,ModificationType.MODIFY,8,5,5,2,0,1,10,0,0,0,0,0,0,0,0,0,0,0.0,0.0
77a995ffada780b8136740b0ff468189b60bda7a,/Users/sanika/Downloads/Master Thesis/repo_updated/pytest/src/_pytest/config/__init__.py,5076,ModificationType.MODIFY,1217,716,841,84,126,174,1301,14,185,118,215,199,333,1446.608539104324,2542.995998641035,8.135135135135135,20687.616097052745,1149.3120053918192,0.847665332880345
77a995ffada780b8136740b0ff468189b60bda7a,/Users/sanika/Downloads/Master Thesis/repo_updated/pytest/src/_pytest/mark/__init__.py,5076,ModificationType.MODIFY,160,89,115,0,13,31,160,7,15,11,17,22,28,78.25484338853101,124.86408532184433,3.966666666666667,495.2942051099825,27.51634472833236,0.04162136177394811
77a995ffada780b8136740b0ff468189b60bda7a,/Users/sanika/Downloads/Master Thesis/repo_updated/pytest/src/_pytest/_code/__init__.py,5076,ModificationType.MODIFY,10,10,9,9,0,0,19,0,0,0,0,0,0,0,0,0,0,0.0,0.0
77a995ffada780b8136740b0ff468189b60bda7a,/Users/sanika/Downloads/Master Thesis/repo_updated/pytest/src/_pytest/assertion/__init__.py,5076,ModificationType.MODIFY,173,84,99,8,29,36,181,5,12,7,13,17,20,54.62919048309069,81.7492568250068,2.7083333333333335,221.4042372343934,12.300235401910745,0.027249752275002266
77a995ffada780b8136740b0ff468189b60bda7a,/Users/sanika/Downloads/Master Thesis/repo_updated/pytest/src/_pytest/_io/__init__.py,5076,ModificationType.MODIFY,3,1,1,3,0,0,6,0,0,0,0,0,0,0,0,0,0,0.0,0.0
77a995ffada780b8136740b0ff468189b60bda7a,/Users/sanika/Downloads/Master Thesis/repo_updated/pytest/testing/python/fixtures.py,6225,ModificationType.MODIFY,4293,999,3693,19,54,507,4312,9,155,88,170,164,258,1156.3286078304877,1898.248417191466,4.935483870967742,9368.774446138526,520.4874692299181,0.6327494723971553
77a995ffada780b8136740b0ff468189b60bda7a,/Users/sanika/Downloads/Master Thesis/repo_updated/pytest/src/_pytest/fixtures.py,6225,ModificationType.MODIFY,1482,859,1002,125,135,219,1607,16,219,134,251,235,385,1766.678366052657,3032.459024427525,9.168949771689498,27804.464479682512,1544.692471093473,1.0108196748091751
77a995ffada780b8136740b0ff468189b60bda7a,/Users/sanika/Downloads/Master Thesis/repo_updated/pytest/src/_pytest/hookspec.py,640,ModificationType.MODIFY,647,139,84,35,284,233,682,0,0,0,0,0,0,0,0,0,0,0.0,0.0
77a995ffada780b8136740b0ff468189b60bda7a,/Users/sanika/Downloads/Master Thesis/repo_updated/pytest/testing/test_main.py,3472,ModificationType.MODIFY,77,34,69,0,0,8,77,3,24,16,29,27,45,114.79398751947123,213.9699375973561,1.8125,387.82051189520797,21.54558399417822,0.07132331253245204
77a995ffada780b8136740b0ff468189b60bda7a,/Users/sanika/Downloads/Master Thesis/repo_updated/pytest/src/_pytest/main.py,3472,ModificationType.MODIFY,712,438,573,51,9,84,763,14,102,71,128,116,199,733.8903537898989,1364.7382180303869,8.784313725490197,11988.28866034536,666.0160366858534,0.45491273934346227
90dfee5da55f4b2e55a92568186dc435624d5499,/Users/sanika/Downloads/Master Thesis/repo_updated/pytest/setup.py,93,ModificationType.MODIFY,42,7,35,4,0,5,46,1,2,1,2,3,3,2.0,4.754887502163469,0.5,2.3774437510817346,0.1320802083934297,0.0015849625007211565
90dfee5da55f4b2e55a92568186dc435624d5499,/Users/sanika/Downloads/Master Thesis/repo_updated/pytest/extra/setup-py.test/setup.py,93,ModificationType.MODIFY,11,6,10,0,0,1,11,2,4,2,4,6,6,10.0,15.509775004326936,1.0,15.509775004326936,0.861654166907052,0.005169925001442312
90dfee5da55f4b2e55a92568186dc435624d5499,/Users/sanika/Downloads/Master Thesis/repo_updated/pytest/testing/python/fixtures.py,8008,ModificationType.MODIFY,4293,999,3693,19,54,507,4312,9,155,88,170,164,258,1156.3286078304877,1898.248417191466,4.935483870967742,9368.774446138526,520.4874692299181,0.6327494723971553
90dfee5da55f4b2e55a92568186dc435624d5499,/Users/sanika/Downloads/Master Thesis/repo_updated/pytest/src/_pytest/fixtures.py,8008,ModificationType.MODIFY,1482,859,1002,125,135,219,1607,16,219,134,251,235,385,1766.678366052657,3032.459024427525,9.168949771689498,27804.464479682512,1544.692471093473,1.0108196748091751
3cb1457e6ddbaec97bf2ca8f44209bd88ff11bb2,/Users/sanika/Downloads/Master Thesis/repo_updated/pytest/setup.py,93,ModificationType.MODIFY,42,7,35,4,0,5,46,1,2,1,2,3,3,2.0,4.754887502163469,0.5,2.3774437510817346,0.1320802083934297,0.0015849625007211565
3cb1457e6ddbaec97bf2ca8f44209bd88ff11bb2,/Users/sanika/Downloads/Master Thesis/repo_updated/pytest/extra/setup-py.test/setup.py,93,ModificationType.MODIFY,11,6,10,0,0,1,11,2,4,2,4,6,6,10.0,15.509775004326936,1.0,15.509775004326936,0.861654166907052,0.005169925001442312
3cb1457e6ddbaec97bf2ca8f44209bd88ff11bb2,/Users/sanika/Downloads/Master Thesis/repo_updated/pytest/testing/python/fixtures.py,8008,ModificationType.MODIFY,4293,999,3693,19,54,507,4312,9,155,88,170,164,258,1156.3286078304877,1898.248417191466,4.935483870967742,9368.774446138526,520.4874692299181,0.6327494723971553
3cb1457e6ddbaec97bf2ca8f44209bd88ff11bb2,/Users/sanika/Downloads/Master Thesis/repo_updated/pytest/src/_pytest/fixtures.py,8008,ModificationType.MODIFY,1482,859,1002,125,135,219,1607,16,219,134,251,235,385,1766.678366052657,3032.459024427525,9.168949771689498,27804.464479682512,1544.692471093473,1.0108196748091751
7ef44913a1ee5c79c966372e613ce3ea06a68090,/Users/sanika/Downloads/Master Thesis/repo_updated/pytest/testing/test_pdb.py,3969,ModificationType.MODIFY,1293,570,1093,25,15,163,1318,10,195,123,241,205,364,1516.6486921300477,2795.3307562199825,6.17948717948718,17273.710570487587,959.6505872493103,0.9317769187399941
0783030357807ba91ad07e89b12bf8d2205ae21d,/Users/sanika/Downloads/Master Thesis/repo_updated/pytest/testing/test_pdb.py,3969,ModificationType.MODIFY,1293,570,1093,25,15,163,1318,10,195,123,241,205,364,1516.6486921300477,2795.3307562199825,6.17948717948718,17273.710570487587,959.6505872493103,0.9317769187399941
0976e2f50de87d28ad3f7680013b40f72bc99f50,/Users/sanika/Downloads/Master Thesis/repo_updated/pytest/testing/example_scripts/collect/package_infinite_recursion/__init__.pyi,5076,ModificationType.MODIFY,0,0,0,0,0,0,0,0,0,0,0,0,0,0,0,0,0,0.0,0.0
0976e2f50de87d28ad3f7680013b40f72bc99f50,/Users/sanika/Downloads/Master Thesis/repo_updated/pytest/testing/example_scripts/collect/package_infinite_recursion/tests/__init__.py,5076,ModificationType.MODIFY,0,0,0,0,0,0,0,0,0,0,0,0,0,0,0,0,0,0.0,0.0
0976e2f50de87d28ad3f7680013b40f72bc99f50,/Users/sanika/Downloads/Master Thesis/repo_updated/pytest/testing/example_scripts/collect/collect_init_tests/tests/__init__.py,5076,ModificationType.MODIFY,2,2,2,0,0,0,2,0,0,0,0,0,0,0,0,0,0,0.0,0.0
0976e2f50de87d28ad3f7680013b40f72bc99f50,/Users/sanika/Downloads/Master Thesis/repo_updated/pytest/testing/example_scripts/collect/package_init_given_as_arg/pkg/__init__.py,5076,ModificationType.MODIFY,0,0,0,0,0,0,0,0,0,0,0,0,0,0,0,0,0,0.0,0.0
0976e2f50de87d28ad3f7680013b40f72bc99f50,/Users/sanika/Downloads/Master Thesis/repo_updated/pytest/testing/example_scripts/conftest_usageerror/__init__.pyi,5076,ModificationType.MODIFY,0,0,0,0,0,0,0,0,0,0,0,0,0,0,0,0,0,0.0,0.0
0976e2f50de87d28ad3f7680013b40f72bc99f50,/Users/sanika/Downloads/Master Thesis/repo_updated/pytest/testing/example_scripts/marks/marks_considered_keywords/__init__.pyi,5076,ModificationType.MODIFY,0,0,0,0,0,0,0,0,0,0,0,0,0,0,0,0,0,0.0,0.0
0976e2f50de87d28ad3f7680013b40f72bc99f50,/Users/sanika/Downloads/Master Thesis/repo_updated/pytest/testing/example_scripts/config/collect_pytest_prefix/__init__.pyi,5076,ModificationType.MODIFY,0,0,0,0,0,0,0,0,0,0,0,0,0,0,0,0,0,0.0,0.0
0976e2f50de87d28ad3f7680013b40f72bc99f50,/Users/sanika/Downloads/Master Thesis/repo_updated/pytest/testing/example_scripts/issue88_initial_file_multinodes/__init__.pyi,5076,ModificationType.MODIFY,0,0,0,0,0,0,0,0,0,0,0,0,0,0,0,0,0,0.0,0.0
0976e2f50de87d28ad3f7680013b40f72bc99f50,/Users/sanika/Downloads/Master Thesis/repo_updated/pytest/testing/example_scripts/fixtures/fill_fixtures/test_extend_fixture_conftest_conftest/__init__.pyi,5076,ModificationType.MODIFY,0,0,0,0,0,0,0,0,0,0,0,0,0,0,0,0,0,0.0,0.0
0976e2f50de87d28ad3f7680013b40f72bc99f50,/Users/sanika/Downloads/Master Thesis/repo_updated/pytest/testing/example_scripts/fixtures/fill_fixtures/test_extend_fixture_conftest_conftest/pkg/__init__.py,5076,ModificationType.MODIFY,0,0,0,0,0,0,0,0,0,0,0,0,0,0,0,0,0,0.0,0.0
0976e2f50de87d28ad3f7680013b40f72bc99f50,/Users/sanika/Downloads/Master Thesis/repo_updated/pytest/testing/example_scripts/fixtures/fill_fixtures/test_extend_fixture_conftest_module/__init__.pyi,5076,ModificationType.MODIFY,0,0,0,0,0,0,0,0,0,0,0,0,0,0,0,0,0,0.0,0.0
0976e2f50de87d28ad3f7680013b40f72bc99f50,/Users/sanika/Downloads/Master Thesis/repo_updated/pytest/testing/example_scripts/fixtures/fill_fixtures/test_conftest_funcargs_only_available_in_subdir/sub1/__init__.py,5076,ModificationType.MODIFY,0,0,0,0,0,0,0,0,0,0,0,0,0,0,0,0,0,0.0,0.0
0976e2f50de87d28ad3f7680013b40f72bc99f50,/Users/sanika/Downloads/Master Thesis/repo_updated/pytest/testing/example_scripts/fixtures/fill_fixtures/test_conftest_funcargs_only_available_in_subdir/sub2/__init__.py,5076,ModificationType.MODIFY,0,0,0,0,0,0,0,0,0,0,0,0,0,0,0,0,0,0.0,0.0
0976e2f50de87d28ad3f7680013b40f72bc99f50,/Users/sanika/Downloads/Master Thesis/repo_updated/pytest/testing/example_scripts/fixtures/custom_item/__init__.pyi,5076,ModificationType.MODIFY,0,0,0,0,0,0,0,0,0,0,0,0,0,0,0,0,0,0.0,0.0
0976e2f50de87d28ad3f7680013b40f72bc99f50,/Users/sanika/Downloads/Master Thesis/repo_updated/pytest/testing/example_scripts/fixtures/custom_item/foo/__init__.py,5076,ModificationType.MODIFY,0,0,0,0,0,0,0,0,0,0,0,0,0,0,0,0,0,0.0,0.0
0976e2f50de87d28ad3f7680013b40f72bc99f50,/Users/sanika/Downloads/Master Thesis/repo_updated/pytest/doc/en/example/nonpython/__init__.py,5076,ModificationType.MODIFY,0,0,0,0,0,0,0,0,0,0,0,0,0,0,0,0,0,0.0,0.0
0976e2f50de87d28ad3f7680013b40f72bc99f50,/Users/sanika/Downloads/Master Thesis/repo_updated/pytest/src/pytest/__init__.py,5076,ModificationType.MODIFY,99,48,90,1,3,5,100,0,0,0,0,0,0,0,0,0,0,0.0,0.0
0976e2f50de87d28ad3f7680013b40f72bc99f50,/Users/sanika/Downloads/Master Thesis/repo_updated/pytest/src/_pytest/__init__.py,5076,ModificationType.MODIFY,8,5,5,2,0,1,10,0,0,0,0,0,0,0,0,0,0,0.0,0.0
0976e2f50de87d28ad3f7680013b40f72bc99f50,/Users/sanika/Downloads/Master Thesis/repo_updated/pytest/src/_pytest/config/__init__.py,5076,ModificationType.MODIFY,1217,716,841,84,126,174,1301,14,185,118,215,199,333,1446.608539104324,2542.995998641035,8.135135135135135,20687.616097052745,1149.3120053918192,0.847665332880345
0976e2f50de87d28ad3f7680013b40f72bc99f50,/Users/sanika/Downloads/Master Thesis/repo_updated/pytest/src/_pytest/mark/__init__.py,5076,ModificationType.MODIFY,160,89,115,0,13,31,160,7,15,11,17,22,28,78.25484338853101,124.86408532184433,3.966666666666667,495.2942051099825,27.51634472833236,0.04162136177394811
0976e2f50de87d28ad3f7680013b40f72bc99f50,/Users/sanika/Downloads/Master Thesis/repo_updated/pytest/src/_pytest/_code/__init__.py,5076,ModificationType.MODIFY,10,10,9,9,0,0,19,0,0,0,0,0,0,0,0,0,0,0.0,0.0
0976e2f50de87d28ad3f7680013b40f72bc99f50,/Users/sanika/Downloads/Master Thesis/repo_updated/pytest/src/_pytest/assertion/__init__.py,5076,ModificationType.MODIFY,173,84,99,8,29,36,181,5,12,7,13,17,20,54.62919048309069,81.7492568250068,2.7083333333333335,221.4042372343934,12.300235401910745,0.027249752275002266
0976e2f50de87d28ad3f7680013b40f72bc99f50,/Users/sanika/Downloads/Master Thesis/repo_updated/pytest/src/_pytest/_io/__init__.py,5076,ModificationType.MODIFY,3,1,1,3,0,0,6,0,0,0,0,0,0,0,0,0,0,0.0,0.0
0976e2f50de87d28ad3f7680013b40f72bc99f50,/Users/sanika/Downloads/Master Thesis/repo_updated/pytest/testing/python/fixtures.py,6225,ModificationType.MODIFY,4293,999,3693,19,54,507,4312,9,155,88,170,164,258,1156.3286078304877,1898.248417191466,4.935483870967742,9368.774446138526,520.4874692299181,0.6327494723971553
0976e2f50de87d28ad3f7680013b40f72bc99f50,/Users/sanika/Downloads/Master Thesis/repo_updated/pytest/src/_pytest/fixtures.py,6225,ModificationType.MODIFY,1482,859,1002,125,135,219,1607,16,219,134,251,235,385,1766.678366052657,3032.459024427525,9.168949771689498,27804.464479682512,1544.692471093473,1.0108196748091751
0976e2f50de87d28ad3f7680013b40f72bc99f50,/Users/sanika/Downloads/Master Thesis/repo_updated/pytest/src/_pytest/hookspec.py,640,ModificationType.MODIFY,647,139,84,35,284,233,682,0,0,0,0,0,0,0,0,0,0,0.0,0.0
0976e2f50de87d28ad3f7680013b40f72bc99f50,/Users/sanika/Downloads/Master Thesis/repo_updated/pytest/src/_pytest/logging.py,2754,ModificationType.MODIFY,773,422,505,30,103,129,803,14,77,46,83,91,129,535.8455325423139,839.5055085856318,7.545454545454546,6334.450655691586,351.9139253161992,0.2798351695285439
0976e2f50de87d28ad3f7680013b40f72bc99f50,/Users/sanika/Downloads/Master Thesis/repo_updated/pytest/testing/test_main.py,3472,ModificationType.MODIFY,77,34,69,0,0,8,77,3,24,16,29,27,45,114.79398751947123,213.9699375973561,1.8125,387.82051189520797,21.54558399417822,0.07132331253245204
0976e2f50de87d28ad3f7680013b40f72bc99f50,/Users/sanika/Downloads/Master Thesis/repo_updated/pytest/src/_pytest/main.py,3472,ModificationType.MODIFY,712,438,573,51,9,84,763,14,102,71,128,116,199,733.8903537898989,1364.7382180303869,8.784313725490197,11988.28866034536,666.0160366858534,0.45491273934346227
0976e2f50de87d28ad3f7680013b40f72bc99f50,/Users/sanika/Downloads/Master Thesis/repo_updated/pytest/testing/python/fixtures.py,7999,ModificationType.MODIFY,4293,999,3693,19,54,507,4312,9,155,88,170,164,258,1156.3286078304877,1898.248417191466,4.935483870967742,9368.774446138526,520.4874692299181,0.6327494723971553
0976e2f50de87d28ad3f7680013b40f72bc99f50,/Users/sanika/Downloads/Master Thesis/repo_updated/pytest/src/_pytest/fixtures.py,7999,ModificationType.MODIFY,1482,859,1002,125,135,219,1607,16,219,134,251,235,385,1766.678366052657,3032.459024427525,9.168949771689498,27804.464479682512,1544.692471093473,1.0108196748091751
0976e2f50de87d28ad3f7680013b40f72bc99f50,/Users/sanika/Downloads/Master Thesis/repo_updated/pytest/testing/test_pdb.py,3969,ModificationType.MODIFY,1293,570,1093,25,15,163,1318,10,195,123,241,205,364,1516.6486921300477,2795.3307562199825,6.17948717948718,17273.710570487587,959.6505872493103,0.9317769187399941
c9524af5ae58bbca9d1696925b15585e07ef72ae,/Users/sanika/Downloads/Master Thesis/repo_updated/pytest/testing/example_scripts/collect/package_infinite_recursion/__init__.pyi,5076,ModificationType.MODIFY,0,0,0,0,0,0,0,0,0,0,0,0,0,0,0,0,0,0.0,0.0
c9524af5ae58bbca9d1696925b15585e07ef72ae,/Users/sanika/Downloads/Master Thesis/repo_updated/pytest/testing/example_scripts/collect/package_infinite_recursion/tests/__init__.py,5076,ModificationType.MODIFY,0,0,0,0,0,0,0,0,0,0,0,0,0,0,0,0,0,0.0,0.0
c9524af5ae58bbca9d1696925b15585e07ef72ae,/Users/sanika/Downloads/Master Thesis/repo_updated/pytest/testing/example_scripts/collect/collect_init_tests/tests/__init__.py,5076,ModificationType.MODIFY,2,2,2,0,0,0,2,0,0,0,0,0,0,0,0,0,0,0.0,0.0
c9524af5ae58bbca9d1696925b15585e07ef72ae,/Users/sanika/Downloads/Master Thesis/repo_updated/pytest/testing/example_scripts/collect/package_init_given_as_arg/pkg/__init__.py,5076,ModificationType.MODIFY,0,0,0,0,0,0,0,0,0,0,0,0,0,0,0,0,0,0.0,0.0
c9524af5ae58bbca9d1696925b15585e07ef72ae,/Users/sanika/Downloads/Master Thesis/repo_updated/pytest/testing/example_scripts/conftest_usageerror/__init__.pyi,5076,ModificationType.MODIFY,0,0,0,0,0,0,0,0,0,0,0,0,0,0,0,0,0,0.0,0.0
c9524af5ae58bbca9d1696925b15585e07ef72ae,/Users/sanika/Downloads/Master Thesis/repo_updated/pytest/testing/example_scripts/marks/marks_considered_keywords/__init__.pyi,5076,ModificationType.MODIFY,0,0,0,0,0,0,0,0,0,0,0,0,0,0,0,0,0,0.0,0.0
c9524af5ae58bbca9d1696925b15585e07ef72ae,/Users/sanika/Downloads/Master Thesis/repo_updated/pytest/testing/example_scripts/config/collect_pytest_prefix/__init__.pyi,5076,ModificationType.MODIFY,0,0,0,0,0,0,0,0,0,0,0,0,0,0,0,0,0,0.0,0.0
c9524af5ae58bbca9d1696925b15585e07ef72ae,/Users/sanika/Downloads/Master Thesis/repo_updated/pytest/testing/example_scripts/issue88_initial_file_multinodes/__init__.pyi,5076,ModificationType.MODIFY,0,0,0,0,0,0,0,0,0,0,0,0,0,0,0,0,0,0.0,0.0
c9524af5ae58bbca9d1696925b15585e07ef72ae,/Users/sanika/Downloads/Master Thesis/repo_updated/pytest/testing/example_scripts/fixtures/fill_fixtures/test_extend_fixture_conftest_conftest/__init__.pyi,5076,ModificationType.MODIFY,0,0,0,0,0,0,0,0,0,0,0,0,0,0,0,0,0,0.0,0.0
c9524af5ae58bbca9d1696925b15585e07ef72ae,/Users/sanika/Downloads/Master Thesis/repo_updated/pytest/testing/example_scripts/fixtures/fill_fixtures/test_extend_fixture_conftest_conftest/pkg/__init__.py,5076,ModificationType.MODIFY,0,0,0,0,0,0,0,0,0,0,0,0,0,0,0,0,0,0.0,0.0
c9524af5ae58bbca9d1696925b15585e07ef72ae,/Users/sanika/Downloads/Master Thesis/repo_updated/pytest/testing/example_scripts/fixtures/fill_fixtures/test_extend_fixture_conftest_module/__init__.pyi,5076,ModificationType.MODIFY,0,0,0,0,0,0,0,0,0,0,0,0,0,0,0,0,0,0.0,0.0
c9524af5ae58bbca9d1696925b15585e07ef72ae,/Users/sanika/Downloads/Master Thesis/repo_updated/pytest/testing/example_scripts/fixtures/fill_fixtures/test_conftest_funcargs_only_available_in_subdir/sub1/__init__.py,5076,ModificationType.MODIFY,0,0,0,0,0,0,0,0,0,0,0,0,0,0,0,0,0,0.0,0.0
c9524af5ae58bbca9d1696925b15585e07ef72ae,/Users/sanika/Downloads/Master Thesis/repo_updated/pytest/testing/example_scripts/fixtures/fill_fixtures/test_conftest_funcargs_only_available_in_subdir/sub2/__init__.py,5076,ModificationType.MODIFY,0,0,0,0,0,0,0,0,0,0,0,0,0,0,0,0,0,0.0,0.0
c9524af5ae58bbca9d1696925b15585e07ef72ae,/Users/sanika/Downloads/Master Thesis/repo_updated/pytest/testing/example_scripts/fixtures/custom_item/__init__.pyi,5076,ModificationType.MODIFY,0,0,0,0,0,0,0,0,0,0,0,0,0,0,0,0,0,0.0,0.0
c9524af5ae58bbca9d1696925b15585e07ef72ae,/Users/sanika/Downloads/Master Thesis/repo_updated/pytest/testing/example_scripts/fixtures/custom_item/foo/__init__.py,5076,ModificationType.MODIFY,0,0,0,0,0,0,0,0,0,0,0,0,0,0,0,0,0,0.0,0.0
c9524af5ae58bbca9d1696925b15585e07ef72ae,/Users/sanika/Downloads/Master Thesis/repo_updated/pytest/doc/en/example/nonpython/__init__.py,5076,ModificationType.MODIFY,0,0,0,0,0,0,0,0,0,0,0,0,0,0,0,0,0,0.0,0.0
c9524af5ae58bbca9d1696925b15585e07ef72ae,/Users/sanika/Downloads/Master Thesis/repo_updated/pytest/src/pytest/__init__.py,5076,ModificationType.MODIFY,99,48,90,1,3,5,100,0,0,0,0,0,0,0,0,0,0,0.0,0.0
c9524af5ae58bbca9d1696925b15585e07ef72ae,/Users/sanika/Downloads/Master Thesis/repo_updated/pytest/src/_pytest/__init__.py,5076,ModificationType.MODIFY,8,5,5,2,0,1,10,0,0,0,0,0,0,0,0,0,0,0.0,0.0
c9524af5ae58bbca9d1696925b15585e07ef72ae,/Users/sanika/Downloads/Master Thesis/repo_updated/pytest/src/_pytest/config/__init__.py,5076,ModificationType.MODIFY,1217,716,841,84,126,174,1301,14,185,118,215,199,333,1446.608539104324,2542.995998641035,8.135135135135135,20687.616097052745,1149.3120053918192,0.847665332880345
c9524af5ae58bbca9d1696925b15585e07ef72ae,/Users/sanika/Downloads/Master Thesis/repo_updated/pytest/src/_pytest/mark/__init__.py,5076,ModificationType.MODIFY,160,89,115,0,13,31,160,7,15,11,17,22,28,78.25484338853101,124.86408532184433,3.966666666666667,495.2942051099825,27.51634472833236,0.04162136177394811
c9524af5ae58bbca9d1696925b15585e07ef72ae,/Users/sanika/Downloads/Master Thesis/repo_updated/pytest/src/_pytest/_code/__init__.py,5076,ModificationType.MODIFY,10,10,9,9,0,0,19,0,0,0,0,0,0,0,0,0,0,0.0,0.0
c9524af5ae58bbca9d1696925b15585e07ef72ae,/Users/sanika/Downloads/Master Thesis/repo_updated/pytest/src/_pytest/assertion/__init__.py,5076,ModificationType.MODIFY,173,84,99,8,29,36,181,5,12,7,13,17,20,54.62919048309069,81.7492568250068,2.7083333333333335,221.4042372343934,12.300235401910745,0.027249752275002266
c9524af5ae58bbca9d1696925b15585e07ef72ae,/Users/sanika/Downloads/Master Thesis/repo_updated/pytest/src/_pytest/_io/__init__.py,5076,ModificationType.MODIFY,3,1,1,3,0,0,6,0,0,0,0,0,0,0,0,0,0,0.0,0.0
c9524af5ae58bbca9d1696925b15585e07ef72ae,/Users/sanika/Downloads/Master Thesis/repo_updated/pytest/testing/python/fixtures.py,6225,ModificationType.MODIFY,4293,999,3693,19,54,507,4312,9,155,88,170,164,258,1156.3286078304877,1898.248417191466,4.935483870967742,9368.774446138526,520.4874692299181,0.6327494723971553
c9524af5ae58bbca9d1696925b15585e07ef72ae,/Users/sanika/Downloads/Master Thesis/repo_updated/pytest/src/_pytest/fixtures.py,6225,ModificationType.MODIFY,1482,859,1002,125,135,219,1607,16,219,134,251,235,385,1766.678366052657,3032.459024427525,9.168949771689498,27804.464479682512,1544.692471093473,1.0108196748091751
c9524af5ae58bbca9d1696925b15585e07ef72ae,/Users/sanika/Downloads/Master Thesis/repo_updated/pytest/src/_pytest/hookspec.py,640,ModificationType.MODIFY,647,139,84,35,284,233,682,0,0,0,0,0,0,0,0,0,0,0.0,0.0
c9524af5ae58bbca9d1696925b15585e07ef72ae,/Users/sanika/Downloads/Master Thesis/repo_updated/pytest/src/_pytest/logging.py,2754,ModificationType.MODIFY,773,422,505,30,103,129,803,14,77,46,83,91,129,535.8455325423139,839.5055085856318,7.545454545454546,6334.450655691586,351.9139253161992,0.2798351695285439
c9524af5ae58bbca9d1696925b15585e07ef72ae,/Users/sanika/Downloads/Master Thesis/repo_updated/pytest/testing/test_main.py,3472,ModificationType.MODIFY,77,34,69,0,0,8,77,3,24,16,29,27,45,114.79398751947123,213.9699375973561,1.8125,387.82051189520797,21.54558399417822,0.07132331253245204
c9524af5ae58bbca9d1696925b15585e07ef72ae,/Users/sanika/Downloads/Master Thesis/repo_updated/pytest/src/_pytest/main.py,3472,ModificationType.MODIFY,712,438,573,51,9,84,763,14,102,71,128,116,199,733.8903537898989,1364.7382180303869,8.784313725490197,11988.28866034536,666.0160366858534,0.45491273934346227
c9524af5ae58bbca9d1696925b15585e07ef72ae,/Users/sanika/Downloads/Master Thesis/repo_updated/pytest/testing/python/fixtures.py,7999,ModificationType.MODIFY,4293,999,3693,19,54,507,4312,9,155,88,170,164,258,1156.3286078304877,1898.248417191466,4.935483870967742,9368.774446138526,520.4874692299181,0.6327494723971553
c9524af5ae58bbca9d1696925b15585e07ef72ae,/Users/sanika/Downloads/Master Thesis/repo_updated/pytest/src/_pytest/fixtures.py,7999,ModificationType.MODIFY,1482,859,1002,125,135,219,1607,16,219,134,251,235,385,1766.678366052657,3032.459024427525,9.168949771689498,27804.464479682512,1544.692471093473,1.0108196748091751
c9524af5ae58bbca9d1696925b15585e07ef72ae,/Users/sanika/Downloads/Master Thesis/repo_updated/pytest/testing/test_pdb.py,3969,ModificationType.MODIFY,1293,570,1093,25,15,163,1318,10,195,123,241,205,364,1516.6486921300477,2795.3307562199825,6.17948717948718,17273.710570487587,959.6505872493103,0.9317769187399941
ab245ccdc3f1d7aa99a695dd43ceb9d94ccc93bb,/Users/sanika/Downloads/Master Thesis/repo_updated/pytest/testing/test_terminal.py,5905,ModificationType.MODIFY,1943,715,1694,26,18,214,1969,12,185,120,237,197,357,1436.3251202041715,2721.0724995459263,7.686486486486486,20915.486996509768,1161.971499806098,0.9070241665153088
ab245ccdc3f1d7aa99a695dd43ceb9d94ccc93bb,/Users/sanika/Downloads/Master Thesis/repo_updated/pytest/src/_pytest/terminal.py,5905,ModificationType.MODIFY,1168,838,957,57,25,144,1225,19,348,224,416,367,640,3018.854959310786,5452.5672018196565,11.35632183908046,61921.107993078396,3440.061555171022,1.8175224006065522
afac1f002109e71a0b492d5aba44c30bfdaec89d,/Users/sanika/Downloads/Master Thesis/repo_updated/pytest/testing/example_scripts/collect/package_infinite_recursion/__init__.pyi,5050,ModificationType.MODIFY,0,0,0,0,0,0,0,0,0,0,0,0,0,0,0,0,0,0.0,0.0
afac1f002109e71a0b492d5aba44c30bfdaec89d,/Users/sanika/Downloads/Master Thesis/repo_updated/pytest/testing/example_scripts/collect/package_infinite_recursion/tests/__init__.py,5050,ModificationType.MODIFY,0,0,0,0,0,0,0,0,0,0,0,0,0,0,0,0,0,0.0,0.0
afac1f002109e71a0b492d5aba44c30bfdaec89d,/Users/sanika/Downloads/Master Thesis/repo_updated/pytest/testing/example_scripts/collect/collect_init_tests/tests/__init__.py,5050,ModificationType.MODIFY,2,2,2,0,0,0,2,0,0,0,0,0,0,0,0,0,0,0.0,0.0
afac1f002109e71a0b492d5aba44c30bfdaec89d,/Users/sanika/Downloads/Master Thesis/repo_updated/pytest/testing/example_scripts/collect/package_init_given_as_arg/pkg/__init__.py,5050,ModificationType.MODIFY,0,0,0,0,0,0,0,0,0,0,0,0,0,0,0,0,0,0.0,0.0
afac1f002109e71a0b492d5aba44c30bfdaec89d,/Users/sanika/Downloads/Master Thesis/repo_updated/pytest/testing/example_scripts/conftest_usageerror/__init__.pyi,5050,ModificationType.MODIFY,0,0,0,0,0,0,0,0,0,0,0,0,0,0,0,0,0,0.0,0.0
afac1f002109e71a0b492d5aba44c30bfdaec89d,/Users/sanika/Downloads/Master Thesis/repo_updated/pytest/testing/example_scripts/marks/marks_considered_keywords/__init__.pyi,5050,ModificationType.MODIFY,0,0,0,0,0,0,0,0,0,0,0,0,0,0,0,0,0,0.0,0.0
afac1f002109e71a0b492d5aba44c30bfdaec89d,/Users/sanika/Downloads/Master Thesis/repo_updated/pytest/testing/example_scripts/config/collect_pytest_prefix/__init__.pyi,5050,ModificationType.MODIFY,0,0,0,0,0,0,0,0,0,0,0,0,0,0,0,0,0,0.0,0.0
afac1f002109e71a0b492d5aba44c30bfdaec89d,/Users/sanika/Downloads/Master Thesis/repo_updated/pytest/testing/example_scripts/issue88_initial_file_multinodes/__init__.pyi,5050,ModificationType.MODIFY,0,0,0,0,0,0,0,0,0,0,0,0,0,0,0,0,0,0.0,0.0
afac1f002109e71a0b492d5aba44c30bfdaec89d,/Users/sanika/Downloads/Master Thesis/repo_updated/pytest/testing/example_scripts/fixtures/fill_fixtures/test_extend_fixture_conftest_conftest/__init__.pyi,5050,ModificationType.MODIFY,0,0,0,0,0,0,0,0,0,0,0,0,0,0,0,0,0,0.0,0.0
afac1f002109e71a0b492d5aba44c30bfdaec89d,/Users/sanika/Downloads/Master Thesis/repo_updated/pytest/testing/example_scripts/fixtures/fill_fixtures/test_extend_fixture_conftest_conftest/pkg/__init__.py,5050,ModificationType.MODIFY,0,0,0,0,0,0,0,0,0,0,0,0,0,0,0,0,0,0.0,0.0
afac1f002109e71a0b492d5aba44c30bfdaec89d,/Users/sanika/Downloads/Master Thesis/repo_updated/pytest/testing/example_scripts/fixtures/fill_fixtures/test_extend_fixture_conftest_module/__init__.pyi,5050,ModificationType.MODIFY,0,0,0,0,0,0,0,0,0,0,0,0,0,0,0,0,0,0.0,0.0
afac1f002109e71a0b492d5aba44c30bfdaec89d,/Users/sanika/Downloads/Master Thesis/repo_updated/pytest/testing/example_scripts/fixtures/fill_fixtures/test_conftest_funcargs_only_available_in_subdir/sub1/__init__.py,5050,ModificationType.MODIFY,0,0,0,0,0,0,0,0,0,0,0,0,0,0,0,0,0,0.0,0.0
afac1f002109e71a0b492d5aba44c30bfdaec89d,/Users/sanika/Downloads/Master Thesis/repo_updated/pytest/testing/example_scripts/fixtures/fill_fixtures/test_conftest_funcargs_only_available_in_subdir/sub2/__init__.py,5050,ModificationType.MODIFY,0,0,0,0,0,0,0,0,0,0,0,0,0,0,0,0,0,0.0,0.0
afac1f002109e71a0b492d5aba44c30bfdaec89d,/Users/sanika/Downloads/Master Thesis/repo_updated/pytest/testing/example_scripts/fixtures/custom_item/__init__.pyi,5050,ModificationType.MODIFY,0,0,0,0,0,0,0,0,0,0,0,0,0,0,0,0,0,0.0,0.0
afac1f002109e71a0b492d5aba44c30bfdaec89d,/Users/sanika/Downloads/Master Thesis/repo_updated/pytest/testing/example_scripts/fixtures/custom_item/foo/__init__.py,5050,ModificationType.MODIFY,0,0,0,0,0,0,0,0,0,0,0,0,0,0,0,0,0,0.0,0.0
afac1f002109e71a0b492d5aba44c30bfdaec89d,/Users/sanika/Downloads/Master Thesis/repo_updated/pytest/doc/en/example/nonpython/__init__.py,5050,ModificationType.MODIFY,0,0,0,0,0,0,0,0,0,0,0,0,0,0,0,0,0,0.0,0.0
afac1f002109e71a0b492d5aba44c30bfdaec89d,/Users/sanika/Downloads/Master Thesis/repo_updated/pytest/src/pytest/__init__.py,5050,ModificationType.MODIFY,99,48,90,1,3,5,100,0,0,0,0,0,0,0,0,0,0,0.0,0.0
afac1f002109e71a0b492d5aba44c30bfdaec89d,/Users/sanika/Downloads/Master Thesis/repo_updated/pytest/src/_pytest/__init__.py,5050,ModificationType.MODIFY,8,5,5,2,0,1,10,0,0,0,0,0,0,0,0,0,0,0.0,0.0
afac1f002109e71a0b492d5aba44c30bfdaec89d,/Users/sanika/Downloads/Master Thesis/repo_updated/pytest/src/_pytest/config/__init__.py,5050,ModificationType.MODIFY,1217,716,841,84,126,174,1301,14,185,118,215,199,333,1446.608539104324,2542.995998641035,8.135135135135135,20687.616097052745,1149.3120053918192,0.847665332880345
afac1f002109e71a0b492d5aba44c30bfdaec89d,/Users/sanika/Downloads/Master Thesis/repo_updated/pytest/src/_pytest/mark/__init__.py,5050,ModificationType.MODIFY,160,89,115,0,13,31,160,7,15,11,17,22,28,78.25484338853101,124.86408532184433,3.966666666666667,495.2942051099825,27.51634472833236,0.04162136177394811
afac1f002109e71a0b492d5aba44c30bfdaec89d,/Users/sanika/Downloads/Master Thesis/repo_updated/pytest/src/_pytest/_code/__init__.py,5050,ModificationType.MODIFY,10,10,9,9,0,0,19,0,0,0,0,0,0,0,0,0,0,0.0,0.0
afac1f002109e71a0b492d5aba44c30bfdaec89d,/Users/sanika/Downloads/Master Thesis/repo_updated/pytest/src/_pytest/assertion/__init__.py,5050,ModificationType.MODIFY,173,84,99,8,29,36,181,5,12,7,13,17,20,54.62919048309069,81.7492568250068,2.7083333333333335,221.4042372343934,12.300235401910745,0.027249752275002266
afac1f002109e71a0b492d5aba44c30bfdaec89d,/Users/sanika/Downloads/Master Thesis/repo_updated/pytest/src/_pytest/_io/__init__.py,5050,ModificationType.MODIFY,3,1,1,3,0,0,6,0,0,0,0,0,0,0,0,0,0,0.0,0.0
94c4dd6ad776179fd9589b4790ed36760454b0dd,/Users/sanika/Downloads/Master Thesis/repo_updated/pytest/testing/test_terminal.py,5905,ModificationType.MODIFY,1943,715,1694,26,18,214,1969,12,185,120,237,197,357,1436.3251202041715,2721.0724995459263,7.686486486486486,20915.486996509768,1161.971499806098,0.9070241665153088
94c4dd6ad776179fd9589b4790ed36760454b0dd,/Users/sanika/Downloads/Master Thesis/repo_updated/pytest/src/_pytest/terminal.py,5905,ModificationType.MODIFY,1168,838,957,57,25,144,1225,19,348,224,416,367,640,3018.854959310786,5452.5672018196565,11.35632183908046,61921.107993078396,3440.061555171022,1.8175224006065522
5e7b8d813b851e2a3dc646a523bac621ce6801c3,/Users/sanika/Downloads/Master Thesis/repo_updated/pytest/testing/example_scripts/collect/package_infinite_recursion/__init__.pyi,5050,ModificationType.MODIFY,0,0,0,0,0,0,0,0,0,0,0,0,0,0,0,0,0,0.0,0.0
5e7b8d813b851e2a3dc646a523bac621ce6801c3,/Users/sanika/Downloads/Master Thesis/repo_updated/pytest/testing/example_scripts/collect/package_infinite_recursion/tests/__init__.py,5050,ModificationType.MODIFY,0,0,0,0,0,0,0,0,0,0,0,0,0,0,0,0,0,0.0,0.0
5e7b8d813b851e2a3dc646a523bac621ce6801c3,/Users/sanika/Downloads/Master Thesis/repo_updated/pytest/testing/example_scripts/collect/collect_init_tests/tests/__init__.py,5050,ModificationType.MODIFY,2,2,2,0,0,0,2,0,0,0,0,0,0,0,0,0,0,0.0,0.0
5e7b8d813b851e2a3dc646a523bac621ce6801c3,/Users/sanika/Downloads/Master Thesis/repo_updated/pytest/testing/example_scripts/collect/package_init_given_as_arg/pkg/__init__.py,5050,ModificationType.MODIFY,0,0,0,0,0,0,0,0,0,0,0,0,0,0,0,0,0,0.0,0.0
5e7b8d813b851e2a3dc646a523bac621ce6801c3,/Users/sanika/Downloads/Master Thesis/repo_updated/pytest/testing/example_scripts/conftest_usageerror/__init__.pyi,5050,ModificationType.MODIFY,0,0,0,0,0,0,0,0,0,0,0,0,0,0,0,0,0,0.0,0.0
5e7b8d813b851e2a3dc646a523bac621ce6801c3,/Users/sanika/Downloads/Master Thesis/repo_updated/pytest/testing/example_scripts/marks/marks_considered_keywords/__init__.pyi,5050,ModificationType.MODIFY,0,0,0,0,0,0,0,0,0,0,0,0,0,0,0,0,0,0.0,0.0
5e7b8d813b851e2a3dc646a523bac621ce6801c3,/Users/sanika/Downloads/Master Thesis/repo_updated/pytest/testing/example_scripts/config/collect_pytest_prefix/__init__.pyi,5050,ModificationType.MODIFY,0,0,0,0,0,0,0,0,0,0,0,0,0,0,0,0,0,0.0,0.0
5e7b8d813b851e2a3dc646a523bac621ce6801c3,/Users/sanika/Downloads/Master Thesis/repo_updated/pytest/testing/example_scripts/issue88_initial_file_multinodes/__init__.pyi,5050,ModificationType.MODIFY,0,0,0,0,0,0,0,0,0,0,0,0,0,0,0,0,0,0.0,0.0
5e7b8d813b851e2a3dc646a523bac621ce6801c3,/Users/sanika/Downloads/Master Thesis/repo_updated/pytest/testing/example_scripts/fixtures/fill_fixtures/test_extend_fixture_conftest_conftest/__init__.pyi,5050,ModificationType.MODIFY,0,0,0,0,0,0,0,0,0,0,0,0,0,0,0,0,0,0.0,0.0
5e7b8d813b851e2a3dc646a523bac621ce6801c3,/Users/sanika/Downloads/Master Thesis/repo_updated/pytest/testing/example_scripts/fixtures/fill_fixtures/test_extend_fixture_conftest_conftest/pkg/__init__.py,5050,ModificationType.MODIFY,0,0,0,0,0,0,0,0,0,0,0,0,0,0,0,0,0,0.0,0.0
5e7b8d813b851e2a3dc646a523bac621ce6801c3,/Users/sanika/Downloads/Master Thesis/repo_updated/pytest/testing/example_scripts/fixtures/fill_fixtures/test_extend_fixture_conftest_module/__init__.pyi,5050,ModificationType.MODIFY,0,0,0,0,0,0,0,0,0,0,0,0,0,0,0,0,0,0.0,0.0
5e7b8d813b851e2a3dc646a523bac621ce6801c3,/Users/sanika/Downloads/Master Thesis/repo_updated/pytest/testing/example_scripts/fixtures/fill_fixtures/test_conftest_funcargs_only_available_in_subdir/sub1/__init__.py,5050,ModificationType.MODIFY,0,0,0,0,0,0,0,0,0,0,0,0,0,0,0,0,0,0.0,0.0
5e7b8d813b851e2a3dc646a523bac621ce6801c3,/Users/sanika/Downloads/Master Thesis/repo_updated/pytest/testing/example_scripts/fixtures/fill_fixtures/test_conftest_funcargs_only_available_in_subdir/sub2/__init__.py,5050,ModificationType.MODIFY,0,0,0,0,0,0,0,0,0,0,0,0,0,0,0,0,0,0.0,0.0
5e7b8d813b851e2a3dc646a523bac621ce6801c3,/Users/sanika/Downloads/Master Thesis/repo_updated/pytest/testing/example_scripts/fixtures/custom_item/__init__.pyi,5050,ModificationType.MODIFY,0,0,0,0,0,0,0,0,0,0,0,0,0,0,0,0,0,0.0,0.0
5e7b8d813b851e2a3dc646a523bac621ce6801c3,/Users/sanika/Downloads/Master Thesis/repo_updated/pytest/testing/example_scripts/fixtures/custom_item/foo/__init__.py,5050,ModificationType.MODIFY,0,0,0,0,0,0,0,0,0,0,0,0,0,0,0,0,0,0.0,0.0
5e7b8d813b851e2a3dc646a523bac621ce6801c3,/Users/sanika/Downloads/Master Thesis/repo_updated/pytest/doc/en/example/nonpython/__init__.py,5050,ModificationType.MODIFY,0,0,0,0,0,0,0,0,0,0,0,0,0,0,0,0,0,0.0,0.0
5e7b8d813b851e2a3dc646a523bac621ce6801c3,/Users/sanika/Downloads/Master Thesis/repo_updated/pytest/src/pytest/__init__.py,5050,ModificationType.MODIFY,99,48,90,1,3,5,100,0,0,0,0,0,0,0,0,0,0,0.0,0.0
5e7b8d813b851e2a3dc646a523bac621ce6801c3,/Users/sanika/Downloads/Master Thesis/repo_updated/pytest/src/_pytest/__init__.py,5050,ModificationType.MODIFY,8,5,5,2,0,1,10,0,0,0,0,0,0,0,0,0,0,0.0,0.0
5e7b8d813b851e2a3dc646a523bac621ce6801c3,/Users/sanika/Downloads/Master Thesis/repo_updated/pytest/src/_pytest/config/__init__.py,5050,ModificationType.MODIFY,1217,716,841,84,126,174,1301,14,185,118,215,199,333,1446.608539104324,2542.995998641035,8.135135135135135,20687.616097052745,1149.3120053918192,0.847665332880345
5e7b8d813b851e2a3dc646a523bac621ce6801c3,/Users/sanika/Downloads/Master Thesis/repo_updated/pytest/src/_pytest/mark/__init__.py,5050,ModificationType.MODIFY,160,89,115,0,13,31,160,7,15,11,17,22,28,78.25484338853101,124.86408532184433,3.966666666666667,495.2942051099825,27.51634472833236,0.04162136177394811
5e7b8d813b851e2a3dc646a523bac621ce6801c3,/Users/sanika/Downloads/Master Thesis/repo_updated/pytest/src/_pytest/_code/__init__.py,5050,ModificationType.MODIFY,10,10,9,9,0,0,19,0,0,0,0,0,0,0,0,0,0,0.0,0.0
5e7b8d813b851e2a3dc646a523bac621ce6801c3,/Users/sanika/Downloads/Master Thesis/repo_updated/pytest/src/_pytest/assertion/__init__.py,5050,ModificationType.MODIFY,173,84,99,8,29,36,181,5,12,7,13,17,20,54.62919048309069,81.7492568250068,2.7083333333333335,221.4042372343934,12.300235401910745,0.027249752275002266
5e7b8d813b851e2a3dc646a523bac621ce6801c3,/Users/sanika/Downloads/Master Thesis/repo_updated/pytest/src/_pytest/_io/__init__.py,5050,ModificationType.MODIFY,3,1,1,3,0,0,6,0,0,0,0,0,0,0,0,0,0,0.0,0.0
cd753aa4ab599d2cccbefb7c837681efae406a29,/Users/sanika/Downloads/Master Thesis/repo_updated/pytest/testing/code/test_code.py,4989,ModificationType.MODIFY,182,127,129,0,0,53,182,5,39,21,42,44,63,217.7403270100645,343.9441919741497,2.6923076923076925,926.003593776557,51.44464409869761,0.11464806399138323
cd753aa4ab599d2cccbefb7c837681efae406a29,/Users/sanika/Downloads/Master Thesis/repo_updated/pytest/src/_pytest/_code/code.py,4989,ModificationType.MODIFY,1165,710,800,67,119,181,1232,18,243,153,282,261,435,2000.7880884021665,3492.1391085079,10.444444444444445,36473.45291108251,2026.302939504584,1.1640463695026333
3173a26388b7724adeb2c5f44325bbbfbad77d10,/Users/sanika/Downloads/Master Thesis/repo_updated/pytest/testing/test_cacheprovider.py,2024,ModificationType.MODIFY,996,429,845,24,10,117,1020,7,76,50,88,83,138,494.49397547611574,879.7554415258757,4.052631578947368,3565.3246840785487,198.07359355991937,0.29325181384195853
3173a26388b7724adeb2c5f44325bbbfbad77d10,/Users/sanika/Downloads/Master Thesis/repo_updated/pytest/src/_pytest/cacheprovider.py,2024,ModificationType.MODIFY,456,277,329,12,42,72,468,13,85,50,97,98,147,592.903945907539,972.3623470849358,7.41764705882353,7212.640703965318,400.70226133140653,0.32412078236164527
3173a26388b7724adeb2c5f44325bbbfbad77d10,/Users/sanika/Downloads/Master Thesis/repo_updated/pytest/testing/test_cacheprovider.py,3806,ModificationType.MODIFY,996,429,845,24,10,117,1020,7,76,50,88,83,138,494.49397547611574,879.7554415258757,4.052631578947368,3565.3246840785487,198.07359355991937,0.29325181384195853
5b88612e5bebc3e4d067484436cfc591f41a3eac,/Users/sanika/Downloads/Master Thesis/repo_updated/pytest/testing/test_unittest.py,2040,ModificationType.MODIFY,1098,241,925,5,10,155,1103,7,46,25,49,53,74,273.7353344330258,423.8661136376768,3.7282608695652173,1580.2834454100341,87.79352474500189,0.14128870454589226
15f956869479a60b1c39f72309e9a0e7b75f1689,/Users/sanika/Downloads/Master Thesis/repo_updated/pytest/testing/test_runner.py,1918,ModificationType.MODIFY,1043,504,840,53,9,147,1096,9,180,112,198,189,310,1377.0628823523223,2344.2951515085324,4.95,11604.260999967235,644.6811666648464,0.7814317171695108
15f956869479a60b1c39f72309e9a0e7b75f1689,/Users/sanika/Downloads/Master Thesis/repo_updated/pytest/src/_pytest/runner.py,1918,ModificationType.MODIFY,383,288,292,26,6,62,409,11,65,38,67,76,105,429.5076556518598,656.0323889115765,5.6692307692307695,3719.199004829476,206.6221669349709,0.2186774629705255
15f956869479a60b1c39f72309e9a0e7b75f1689,/Users/sanika/Downloads/Master Thesis/repo_updated/pytest/testing/test_runner.py,3446,ModificationType.MODIFY,1043,504,840,53,9,147,1096,9,180,112,198,189,310,1377.0628823523223,2344.2951515085324,4.95,11604.260999967235,644.6811666648464,0.7814317171695108
119bf66d7a29a11f1a8a6ba1df496f3d3c457005,/Users/sanika/Downloads/Master Thesis/repo_updated/pytest/testing/code/test_code.py,4989,ModificationType.MODIFY,182,127,129,0,0,53,182,5,39,21,42,44,63,217.7403270100645,343.9441919741497,2.6923076923076925,926.003593776557,51.44464409869761,0.11464806399138323
119bf66d7a29a11f1a8a6ba1df496f3d3c457005,/Users/sanika/Downloads/Master Thesis/repo_updated/pytest/src/_pytest/_code/code.py,4989,ModificationType.MODIFY,1165,710,800,67,119,181,1232,18,243,153,282,261,435,2000.7880884021665,3492.1391085079,10.444444444444445,36473.45291108251,2026.302939504584,1.1640463695026333
e05b33ed162fd9da8f9c44c9de035a0fa14631ec,/Users/sanika/Downloads/Master Thesis/repo_updated/pytest/testing/test_setuponly.py,381,ModificationType.MODIFY,294,64,250,0,0,43,294,1,20,10,20,21,30,86.43856189774725,131.76952268336282,0.5,65.88476134168141,3.6602645189823004,0.04392317422778761
e05b33ed162fd9da8f9c44c9de035a0fa14631ec,/Users/sanika/Downloads/Master Thesis/repo_updated/pytest/src/_pytest/setuponly.py,381,ModificationType.MODIFY,78,46,62,3,0,14,81,3,8,4,8,11,12,28.75488750216347,41.51317942364757,1.5,62.26976913547136,3.4594316186372978,0.01383772647454919
d12cdd3127d5222335c699fd8e52c7ed8257b9e4,/Users/sanika/Downloads/Master Thesis/repo_updated/pytest/testing/example_scripts/collect/package_infinite_recursion/__init__.pyi,5074,ModificationType.MODIFY,0,0,0,0,0,0,0,0,0,0,0,0,0,0,0,0,0,0.0,0.0
d12cdd3127d5222335c699fd8e52c7ed8257b9e4,/Users/sanika/Downloads/Master Thesis/repo_updated/pytest/testing/example_scripts/collect/package_infinite_recursion/tests/__init__.py,5074,ModificationType.MODIFY,0,0,0,0,0,0,0,0,0,0,0,0,0,0,0,0,0,0.0,0.0
d12cdd3127d5222335c699fd8e52c7ed8257b9e4,/Users/sanika/Downloads/Master Thesis/repo_updated/pytest/testing/example_scripts/collect/collect_init_tests/tests/__init__.py,5074,ModificationType.MODIFY,2,2,2,0,0,0,2,0,0,0,0,0,0,0,0,0,0,0.0,0.0
d12cdd3127d5222335c699fd8e52c7ed8257b9e4,/Users/sanika/Downloads/Master Thesis/repo_updated/pytest/testing/example_scripts/collect/package_init_given_as_arg/pkg/__init__.py,5074,ModificationType.MODIFY,0,0,0,0,0,0,0,0,0,0,0,0,0,0,0,0,0,0.0,0.0
d12cdd3127d5222335c699fd8e52c7ed8257b9e4,/Users/sanika/Downloads/Master Thesis/repo_updated/pytest/testing/example_scripts/conftest_usageerror/__init__.pyi,5074,ModificationType.MODIFY,0,0,0,0,0,0,0,0,0,0,0,0,0,0,0,0,0,0.0,0.0
d12cdd3127d5222335c699fd8e52c7ed8257b9e4,/Users/sanika/Downloads/Master Thesis/repo_updated/pytest/testing/example_scripts/marks/marks_considered_keywords/__init__.pyi,5074,ModificationType.MODIFY,0,0,0,0,0,0,0,0,0,0,0,0,0,0,0,0,0,0.0,0.0
d12cdd3127d5222335c699fd8e52c7ed8257b9e4,/Users/sanika/Downloads/Master Thesis/repo_updated/pytest/testing/example_scripts/config/collect_pytest_prefix/__init__.pyi,5074,ModificationType.MODIFY,0,0,0,0,0,0,0,0,0,0,0,0,0,0,0,0,0,0.0,0.0
d12cdd3127d5222335c699fd8e52c7ed8257b9e4,/Users/sanika/Downloads/Master Thesis/repo_updated/pytest/testing/example_scripts/issue88_initial_file_multinodes/__init__.pyi,5074,ModificationType.MODIFY,0,0,0,0,0,0,0,0,0,0,0,0,0,0,0,0,0,0.0,0.0
d12cdd3127d5222335c699fd8e52c7ed8257b9e4,/Users/sanika/Downloads/Master Thesis/repo_updated/pytest/testing/example_scripts/fixtures/fill_fixtures/test_extend_fixture_conftest_conftest/__init__.pyi,5074,ModificationType.MODIFY,0,0,0,0,0,0,0,0,0,0,0,0,0,0,0,0,0,0.0,0.0
d12cdd3127d5222335c699fd8e52c7ed8257b9e4,/Users/sanika/Downloads/Master Thesis/repo_updated/pytest/testing/example_scripts/fixtures/fill_fixtures/test_extend_fixture_conftest_conftest/pkg/__init__.py,5074,ModificationType.MODIFY,0,0,0,0,0,0,0,0,0,0,0,0,0,0,0,0,0,0.0,0.0
d12cdd3127d5222335c699fd8e52c7ed8257b9e4,/Users/sanika/Downloads/Master Thesis/repo_updated/pytest/testing/example_scripts/fixtures/fill_fixtures/test_extend_fixture_conftest_module/__init__.pyi,5074,ModificationType.MODIFY,0,0,0,0,0,0,0,0,0,0,0,0,0,0,0,0,0,0.0,0.0
d12cdd3127d5222335c699fd8e52c7ed8257b9e4,/Users/sanika/Downloads/Master Thesis/repo_updated/pytest/testing/example_scripts/fixtures/fill_fixtures/test_conftest_funcargs_only_available_in_subdir/sub1/__init__.py,5074,ModificationType.MODIFY,0,0,0,0,0,0,0,0,0,0,0,0,0,0,0,0,0,0.0,0.0
d12cdd3127d5222335c699fd8e52c7ed8257b9e4,/Users/sanika/Downloads/Master Thesis/repo_updated/pytest/testing/example_scripts/fixtures/fill_fixtures/test_conftest_funcargs_only_available_in_subdir/sub2/__init__.py,5074,ModificationType.MODIFY,0,0,0,0,0,0,0,0,0,0,0,0,0,0,0,0,0,0.0,0.0
d12cdd3127d5222335c699fd8e52c7ed8257b9e4,/Users/sanika/Downloads/Master Thesis/repo_updated/pytest/testing/example_scripts/fixtures/custom_item/__init__.pyi,5074,ModificationType.MODIFY,0,0,0,0,0,0,0,0,0,0,0,0,0,0,0,0,0,0.0,0.0
d12cdd3127d5222335c699fd8e52c7ed8257b9e4,/Users/sanika/Downloads/Master Thesis/repo_updated/pytest/testing/example_scripts/fixtures/custom_item/foo/__init__.py,5074,ModificationType.MODIFY,0,0,0,0,0,0,0,0,0,0,0,0,0,0,0,0,0,0.0,0.0
d12cdd3127d5222335c699fd8e52c7ed8257b9e4,/Users/sanika/Downloads/Master Thesis/repo_updated/pytest/doc/en/example/nonpython/__init__.py,5074,ModificationType.MODIFY,0,0,0,0,0,0,0,0,0,0,0,0,0,0,0,0,0,0.0,0.0
d12cdd3127d5222335c699fd8e52c7ed8257b9e4,/Users/sanika/Downloads/Master Thesis/repo_updated/pytest/src/pytest/__init__.py,5074,ModificationType.MODIFY,99,48,90,1,3,5,100,0,0,0,0,0,0,0,0,0,0,0.0,0.0
d12cdd3127d5222335c699fd8e52c7ed8257b9e4,/Users/sanika/Downloads/Master Thesis/repo_updated/pytest/src/_pytest/__init__.py,5074,ModificationType.MODIFY,8,5,5,2,0,1,10,0,0,0,0,0,0,0,0,0,0,0.0,0.0
d12cdd3127d5222335c699fd8e52c7ed8257b9e4,/Users/sanika/Downloads/Master Thesis/repo_updated/pytest/src/_pytest/config/__init__.py,5074,ModificationType.MODIFY,1217,716,841,84,126,174,1301,14,185,118,215,199,333,1446.608539104324,2542.995998641035,8.135135135135135,20687.616097052745,1149.3120053918192,0.847665332880345
d12cdd3127d5222335c699fd8e52c7ed8257b9e4,/Users/sanika/Downloads/Master Thesis/repo_updated/pytest/src/_pytest/mark/__init__.py,5074,ModificationType.MODIFY,160,89,115,0,13,31,160,7,15,11,17,22,28,78.25484338853101,124.86408532184433,3.966666666666667,495.2942051099825,27.51634472833236,0.04162136177394811
d12cdd3127d5222335c699fd8e52c7ed8257b9e4,/Users/sanika/Downloads/Master Thesis/repo_updated/pytest/src/_pytest/_code/__init__.py,5074,ModificationType.MODIFY,10,10,9,9,0,0,19,0,0,0,0,0,0,0,0,0,0,0.0,0.0
d12cdd3127d5222335c699fd8e52c7ed8257b9e4,/Users/sanika/Downloads/Master Thesis/repo_updated/pytest/src/_pytest/assertion/__init__.py,5074,ModificationType.MODIFY,173,84,99,8,29,36,181,5,12,7,13,17,20,54.62919048309069,81.7492568250068,2.7083333333333335,221.4042372343934,12.300235401910745,0.027249752275002266
d12cdd3127d5222335c699fd8e52c7ed8257b9e4,/Users/sanika/Downloads/Master Thesis/repo_updated/pytest/src/_pytest/_io/__init__.py,5074,ModificationType.MODIFY,3,1,1,3,0,0,6,0,0,0,0,0,0,0,0,0,0,0.0,0.0
d12cdd3127d5222335c699fd8e52c7ed8257b9e4,/Users/sanika/Downloads/Master Thesis/repo_updated/pytest/testing/test_config.py,6057,ModificationType.MODIFY,1457,730,1242,11,6,188,1468,10,292,166,329,302,495,2424.648052141839,4078.010345965914,5.633561643835616,22973.722668198385,1276.3179260110214,1.359336781988638
9b673bcc44b8dc9d1436e3cd2403f21724324064,/Users/sanika/Downloads/Master Thesis/repo_updated/pytest/testing/test_runner.py,1918,ModificationType.MODIFY,1043,504,840,53,9,147,1096,9,180,112,198,189,310,1377.0628823523223,2344.2951515085324,4.95,11604.260999967235,644.6811666648464,0.7814317171695108
9b673bcc44b8dc9d1436e3cd2403f21724324064,/Users/sanika/Downloads/Master Thesis/repo_updated/pytest/src/_pytest/runner.py,1918,ModificationType.MODIFY,383,288,292,26,6,62,409,11,65,38,67,76,105,429.5076556518598,656.0323889115765,5.6692307692307695,3719.199004829476,206.6221669349709,0.2186774629705255
9b673bcc44b8dc9d1436e3cd2403f21724324064,/Users/sanika/Downloads/Master Thesis/repo_updated/pytest/testing/test_runner.py,3446,ModificationType.MODIFY,1043,504,840,53,9,147,1096,9,180,112,198,189,310,1377.0628823523223,2344.2951515085324,4.95,11604.260999967235,644.6811666648464,0.7814317171695108
b5579d2cf21cd72469fe20c10ccee0238330c93e,/Users/sanika/Downloads/Master Thesis/repo_updated/pytest/testing/example_scripts/collect/package_infinite_recursion/__init__.pyi,5074,ModificationType.MODIFY,0,0,0,0,0,0,0,0,0,0,0,0,0,0,0,0,0,0.0,0.0
b5579d2cf21cd72469fe20c10ccee0238330c93e,/Users/sanika/Downloads/Master Thesis/repo_updated/pytest/testing/example_scripts/collect/package_infinite_recursion/tests/__init__.py,5074,ModificationType.MODIFY,0,0,0,0,0,0,0,0,0,0,0,0,0,0,0,0,0,0.0,0.0
b5579d2cf21cd72469fe20c10ccee0238330c93e,/Users/sanika/Downloads/Master Thesis/repo_updated/pytest/testing/example_scripts/collect/collect_init_tests/tests/__init__.py,5074,ModificationType.MODIFY,2,2,2,0,0,0,2,0,0,0,0,0,0,0,0,0,0,0.0,0.0
b5579d2cf21cd72469fe20c10ccee0238330c93e,/Users/sanika/Downloads/Master Thesis/repo_updated/pytest/testing/example_scripts/collect/package_init_given_as_arg/pkg/__init__.py,5074,ModificationType.MODIFY,0,0,0,0,0,0,0,0,0,0,0,0,0,0,0,0,0,0.0,0.0
b5579d2cf21cd72469fe20c10ccee0238330c93e,/Users/sanika/Downloads/Master Thesis/repo_updated/pytest/testing/example_scripts/conftest_usageerror/__init__.pyi,5074,ModificationType.MODIFY,0,0,0,0,0,0,0,0,0,0,0,0,0,0,0,0,0,0.0,0.0
b5579d2cf21cd72469fe20c10ccee0238330c93e,/Users/sanika/Downloads/Master Thesis/repo_updated/pytest/testing/example_scripts/marks/marks_considered_keywords/__init__.pyi,5074,ModificationType.MODIFY,0,0,0,0,0,0,0,0,0,0,0,0,0,0,0,0,0,0.0,0.0
b5579d2cf21cd72469fe20c10ccee0238330c93e,/Users/sanika/Downloads/Master Thesis/repo_updated/pytest/testing/example_scripts/config/collect_pytest_prefix/__init__.pyi,5074,ModificationType.MODIFY,0,0,0,0,0,0,0,0,0,0,0,0,0,0,0,0,0,0.0,0.0
b5579d2cf21cd72469fe20c10ccee0238330c93e,/Users/sanika/Downloads/Master Thesis/repo_updated/pytest/testing/example_scripts/issue88_initial_file_multinodes/__init__.pyi,5074,ModificationType.MODIFY,0,0,0,0,0,0,0,0,0,0,0,0,0,0,0,0,0,0.0,0.0
b5579d2cf21cd72469fe20c10ccee0238330c93e,/Users/sanika/Downloads/Master Thesis/repo_updated/pytest/testing/example_scripts/fixtures/fill_fixtures/test_extend_fixture_conftest_conftest/__init__.pyi,5074,ModificationType.MODIFY,0,0,0,0,0,0,0,0,0,0,0,0,0,0,0,0,0,0.0,0.0
b5579d2cf21cd72469fe20c10ccee0238330c93e,/Users/sanika/Downloads/Master Thesis/repo_updated/pytest/testing/example_scripts/fixtures/fill_fixtures/test_extend_fixture_conftest_conftest/pkg/__init__.py,5074,ModificationType.MODIFY,0,0,0,0,0,0,0,0,0,0,0,0,0,0,0,0,0,0.0,0.0
b5579d2cf21cd72469fe20c10ccee0238330c93e,/Users/sanika/Downloads/Master Thesis/repo_updated/pytest/testing/example_scripts/fixtures/fill_fixtures/test_extend_fixture_conftest_module/__init__.pyi,5074,ModificationType.MODIFY,0,0,0,0,0,0,0,0,0,0,0,0,0,0,0,0,0,0.0,0.0
b5579d2cf21cd72469fe20c10ccee0238330c93e,/Users/sanika/Downloads/Master Thesis/repo_updated/pytest/testing/example_scripts/fixtures/fill_fixtures/test_conftest_funcargs_only_available_in_subdir/sub1/__init__.py,5074,ModificationType.MODIFY,0,0,0,0,0,0,0,0,0,0,0,0,0,0,0,0,0,0.0,0.0
b5579d2cf21cd72469fe20c10ccee0238330c93e,/Users/sanika/Downloads/Master Thesis/repo_updated/pytest/testing/example_scripts/fixtures/fill_fixtures/test_conftest_funcargs_only_available_in_subdir/sub2/__init__.py,5074,ModificationType.MODIFY,0,0,0,0,0,0,0,0,0,0,0,0,0,0,0,0,0,0.0,0.0
b5579d2cf21cd72469fe20c10ccee0238330c93e,/Users/sanika/Downloads/Master Thesis/repo_updated/pytest/testing/example_scripts/fixtures/custom_item/__init__.pyi,5074,ModificationType.MODIFY,0,0,0,0,0,0,0,0,0,0,0,0,0,0,0,0,0,0.0,0.0
b5579d2cf21cd72469fe20c10ccee0238330c93e,/Users/sanika/Downloads/Master Thesis/repo_updated/pytest/testing/example_scripts/fixtures/custom_item/foo/__init__.py,5074,ModificationType.MODIFY,0,0,0,0,0,0,0,0,0,0,0,0,0,0,0,0,0,0.0,0.0
b5579d2cf21cd72469fe20c10ccee0238330c93e,/Users/sanika/Downloads/Master Thesis/repo_updated/pytest/doc/en/example/nonpython/__init__.py,5074,ModificationType.MODIFY,0,0,0,0,0,0,0,0,0,0,0,0,0,0,0,0,0,0.0,0.0
b5579d2cf21cd72469fe20c10ccee0238330c93e,/Users/sanika/Downloads/Master Thesis/repo_updated/pytest/src/pytest/__init__.py,5074,ModificationType.MODIFY,99,48,90,1,3,5,100,0,0,0,0,0,0,0,0,0,0,0.0,0.0
b5579d2cf21cd72469fe20c10ccee0238330c93e,/Users/sanika/Downloads/Master Thesis/repo_updated/pytest/src/_pytest/__init__.py,5074,ModificationType.MODIFY,8,5,5,2,0,1,10,0,0,0,0,0,0,0,0,0,0,0.0,0.0
b5579d2cf21cd72469fe20c10ccee0238330c93e,/Users/sanika/Downloads/Master Thesis/repo_updated/pytest/src/_pytest/config/__init__.py,5074,ModificationType.MODIFY,1217,716,841,84,126,174,1301,14,185,118,215,199,333,1446.608539104324,2542.995998641035,8.135135135135135,20687.616097052745,1149.3120053918192,0.847665332880345
b5579d2cf21cd72469fe20c10ccee0238330c93e,/Users/sanika/Downloads/Master Thesis/repo_updated/pytest/src/_pytest/mark/__init__.py,5074,ModificationType.MODIFY,160,89,115,0,13,31,160,7,15,11,17,22,28,78.25484338853101,124.86408532184433,3.966666666666667,495.2942051099825,27.51634472833236,0.04162136177394811
b5579d2cf21cd72469fe20c10ccee0238330c93e,/Users/sanika/Downloads/Master Thesis/repo_updated/pytest/src/_pytest/_code/__init__.py,5074,ModificationType.MODIFY,10,10,9,9,0,0,19,0,0,0,0,0,0,0,0,0,0,0.0,0.0
b5579d2cf21cd72469fe20c10ccee0238330c93e,/Users/sanika/Downloads/Master Thesis/repo_updated/pytest/src/_pytest/assertion/__init__.py,5074,ModificationType.MODIFY,173,84,99,8,29,36,181,5,12,7,13,17,20,54.62919048309069,81.7492568250068,2.7083333333333335,221.4042372343934,12.300235401910745,0.027249752275002266
b5579d2cf21cd72469fe20c10ccee0238330c93e,/Users/sanika/Downloads/Master Thesis/repo_updated/pytest/src/_pytest/_io/__init__.py,5074,ModificationType.MODIFY,3,1,1,3,0,0,6,0,0,0,0,0,0,0,0,0,0,0.0,0.0
b5579d2cf21cd72469fe20c10ccee0238330c93e,/Users/sanika/Downloads/Master Thesis/repo_updated/pytest/testing/test_config.py,6057,ModificationType.MODIFY,1457,730,1242,11,6,188,1468,10,292,166,329,302,495,2424.648052141839,4078.010345965914,5.633561643835616,22973.722668198385,1276.3179260110214,1.359336781988638
3a402811de5227dd46d3a9ab75a9e75d3ef3097e,/Users/sanika/Downloads/Master Thesis/repo_updated/pytest/testing/test_cacheprovider.py,2013,ModificationType.MODIFY,996,429,845,24,10,117,1020,7,76,50,88,83,138,494.49397547611574,879.7554415258757,4.052631578947368,3565.3246840785487,198.07359355991937,0.29325181384195853
3a402811de5227dd46d3a9ab75a9e75d3ef3097e,/Users/sanika/Downloads/Master Thesis/repo_updated/pytest/src/_pytest/cacheprovider.py,2013,ModificationType.MODIFY,456,277,329,12,42,72,468,13,85,50,97,98,147,592.903945907539,972.3623470849358,7.41764705882353,7212.640703965318,400.70226133140653,0.32412078236164527
3a402811de5227dd46d3a9ab75a9e75d3ef3097e,/Users/sanika/Downloads/Master Thesis/repo_updated/pytest/testing/test_cacheprovider.py,3782,ModificationType.MODIFY,996,429,845,24,10,117,1020,7,76,50,88,83,138,494.49397547611574,879.7554415258757,4.052631578947368,3565.3246840785487,198.07359355991937,0.29325181384195853
b88f5df4ce29e5dae05ad60c013b3a6a83535703,/Users/sanika/Downloads/Master Thesis/repo_updated/pytest/testing/test_cacheprovider.py,2013,ModificationType.MODIFY,996,429,845,24,10,117,1020,7,76,50,88,83,138,494.49397547611574,879.7554415258757,4.052631578947368,3565.3246840785487,198.07359355991937,0.29325181384195853
b88f5df4ce29e5dae05ad60c013b3a6a83535703,/Users/sanika/Downloads/Master Thesis/repo_updated/pytest/src/_pytest/cacheprovider.py,2013,ModificationType.MODIFY,456,277,329,12,42,72,468,13,85,50,97,98,147,592.903945907539,972.3623470849358,7.41764705882353,7212.640703965318,400.70226133140653,0.32412078236164527
b88f5df4ce29e5dae05ad60c013b3a6a83535703,/Users/sanika/Downloads/Master Thesis/repo_updated/pytest/testing/test_cacheprovider.py,3782,ModificationType.MODIFY,996,429,845,24,10,117,1020,7,76,50,88,83,138,494.49397547611574,879.7554415258757,4.052631578947368,3565.3246840785487,198.07359355991937,0.29325181384195853
fbb7f663be2fa88e689f2e5883ed59d01722f4be,/Users/sanika/Downloads/Master Thesis/repo_updated/pytest/testing/test_unittest.py,2040,ModificationType.MODIFY,1098,241,925,5,10,155,1103,7,46,25,49,53,74,273.7353344330258,423.8661136376768,3.7282608695652173,1580.2834454100341,87.79352474500189,0.14128870454589226
83351a33682df31fca12e6baf67370ab21af185b,/Users/sanika/Downloads/Master Thesis/repo_updated/pytest/testing/test_warnings.py,615,ModificationType.MODIFY,601,196,481,2,23,85,603,8,63,36,72,71,108,400.56863518049477,664.1726889065056,4.571428571428571,3036.21800642974,168.67877813498555,0.22139089630216854
83351a33682df31fca12e6baf67370ab21af185b,/Users/sanika/Downloads/Master Thesis/repo_updated/pytest/src/_pytest/warnings.py,615,ModificationType.MODIFY,156,79,106,5,16,28,161,5,14,8,15,19,23,64.91260938324326,97.70233280920246,2.6785714285714284,261.7026771675066,14.539037620417032,0.03256744426973415
a6152db84adfb7e9b64c16826aad73d5be91cb28,/Users/sanika/Downloads/Master Thesis/repo_updated/pytest/testing/test_setuponly.py,405,ModificationType.MODIFY,294,64,250,0,0,43,294,1,20,10,20,21,30,86.43856189774725,131.76952268336282,0.5,65.88476134168141,3.6602645189823004,0.04392317422778761
a6152db84adfb7e9b64c16826aad73d5be91cb28,/Users/sanika/Downloads/Master Thesis/repo_updated/pytest/src/_pytest/setuponly.py,405,ModificationType.MODIFY,78,46,62,3,0,14,81,3,8,4,8,11,12,28.75488750216347,41.51317942364757,1.5,62.26976913547136,3.4594316186372978,0.01383772647454919
16efa1bfef19ee41f3a74f464139b4129ff804dc,/Users/sanika/Downloads/Master Thesis/repo_updated/pytest/testing/test_setuponly.py,381,ModificationType.MODIFY,294,64,250,0,0,43,294,1,20,10,20,21,30,86.43856189774725,131.76952268336282,0.5,65.88476134168141,3.6602645189823004,0.04392317422778761
16efa1bfef19ee41f3a74f464139b4129ff804dc,/Users/sanika/Downloads/Master Thesis/repo_updated/pytest/src/_pytest/setuponly.py,381,ModificationType.MODIFY,78,46,62,3,0,14,81,3,8,4,8,11,12,28.75488750216347,41.51317942364757,1.5,62.26976913547136,3.4594316186372978,0.01383772647454919
d91ff0af8a1d7fde73b88017ee7fd3c8ad846f3b,/Users/sanika/Downloads/Master Thesis/repo_updated/pytest/src/_pytest/assertion/util.py,2350,ModificationType.MODIFY,477,336,357,30,23,73,507,16,194,134,250,210,384,1538.3830913843028,2962.270278783791,10.309278350515465,30538.86885344115,1696.603825191175,0.9874234262612637
d91ff0af8a1d7fde73b88017ee7fd3c8ad846f3b,/Users/sanika/Downloads/Master Thesis/repo_updated/pytest/testing/test_assertrewrite.py,6013,ModificationType.MODIFY,1660,832,1314,41,38,274,1701,20,312,209,395,332,604,2671.484054182769,5058.523816533542,12.66025641025641,64042.2085747035,3557.900476372417,1.6861746055111808
803cc1f294782b7a7abe0c82fe100de95bb8cfb3,/Users/sanika/Downloads/Master Thesis/repo_updated/pytest/testing/test_cacheprovider.py,2013,ModificationType.MODIFY,996,429,845,24,10,117,1020,7,76,50,88,83,138,494.49397547611574,879.7554415258757,4.052631578947368,3565.3246840785487,198.07359355991937,0.29325181384195853
803cc1f294782b7a7abe0c82fe100de95bb8cfb3,/Users/sanika/Downloads/Master Thesis/repo_updated/pytest/src/_pytest/cacheprovider.py,2013,ModificationType.MODIFY,456,277,329,12,42,72,468,13,85,50,97,98,147,592.903945907539,972.3623470849358,7.41764705882353,7212.640703965318,400.70226133140653,0.32412078236164527
803cc1f294782b7a7abe0c82fe100de95bb8cfb3,/Users/sanika/Downloads/Master Thesis/repo_updated/pytest/testing/example_scripts/collect/package_infinite_recursion/__init__.pyi,5048,ModificationType.MODIFY,0,0,0,0,0,0,0,0,0,0,0,0,0,0,0,0,0,0.0,0.0
803cc1f294782b7a7abe0c82fe100de95bb8cfb3,/Users/sanika/Downloads/Master Thesis/repo_updated/pytest/testing/example_scripts/collect/package_infinite_recursion/tests/__init__.py,5048,ModificationType.MODIFY,0,0,0,0,0,0,0,0,0,0,0,0,0,0,0,0,0,0.0,0.0
803cc1f294782b7a7abe0c82fe100de95bb8cfb3,/Users/sanika/Downloads/Master Thesis/repo_updated/pytest/testing/example_scripts/collect/collect_init_tests/tests/__init__.py,5048,ModificationType.MODIFY,2,2,2,0,0,0,2,0,0,0,0,0,0,0,0,0,0,0.0,0.0
803cc1f294782b7a7abe0c82fe100de95bb8cfb3,/Users/sanika/Downloads/Master Thesis/repo_updated/pytest/testing/example_scripts/collect/package_init_given_as_arg/pkg/__init__.py,5048,ModificationType.MODIFY,0,0,0,0,0,0,0,0,0,0,0,0,0,0,0,0,0,0.0,0.0
803cc1f294782b7a7abe0c82fe100de95bb8cfb3,/Users/sanika/Downloads/Master Thesis/repo_updated/pytest/testing/example_scripts/conftest_usageerror/__init__.pyi,5048,ModificationType.MODIFY,0,0,0,0,0,0,0,0,0,0,0,0,0,0,0,0,0,0.0,0.0
803cc1f294782b7a7abe0c82fe100de95bb8cfb3,/Users/sanika/Downloads/Master Thesis/repo_updated/pytest/testing/example_scripts/marks/marks_considered_keywords/__init__.pyi,5048,ModificationType.MODIFY,0,0,0,0,0,0,0,0,0,0,0,0,0,0,0,0,0,0.0,0.0
803cc1f294782b7a7abe0c82fe100de95bb8cfb3,/Users/sanika/Downloads/Master Thesis/repo_updated/pytest/testing/example_scripts/config/collect_pytest_prefix/__init__.pyi,5048,ModificationType.MODIFY,0,0,0,0,0,0,0,0,0,0,0,0,0,0,0,0,0,0.0,0.0
803cc1f294782b7a7abe0c82fe100de95bb8cfb3,/Users/sanika/Downloads/Master Thesis/repo_updated/pytest/testing/example_scripts/issue88_initial_file_multinodes/__init__.pyi,5048,ModificationType.MODIFY,0,0,0,0,0,0,0,0,0,0,0,0,0,0,0,0,0,0.0,0.0
803cc1f294782b7a7abe0c82fe100de95bb8cfb3,/Users/sanika/Downloads/Master Thesis/repo_updated/pytest/testing/example_scripts/fixtures/fill_fixtures/test_extend_fixture_conftest_conftest/__init__.pyi,5048,ModificationType.MODIFY,0,0,0,0,0,0,0,0,0,0,0,0,0,0,0,0,0,0.0,0.0
803cc1f294782b7a7abe0c82fe100de95bb8cfb3,/Users/sanika/Downloads/Master Thesis/repo_updated/pytest/testing/example_scripts/fixtures/fill_fixtures/test_extend_fixture_conftest_conftest/pkg/__init__.py,5048,ModificationType.MODIFY,0,0,0,0,0,0,0,0,0,0,0,0,0,0,0,0,0,0.0,0.0
803cc1f294782b7a7abe0c82fe100de95bb8cfb3,/Users/sanika/Downloads/Master Thesis/repo_updated/pytest/testing/example_scripts/fixtures/fill_fixtures/test_extend_fixture_conftest_module/__init__.pyi,5048,ModificationType.MODIFY,0,0,0,0,0,0,0,0,0,0,0,0,0,0,0,0,0,0.0,0.0
803cc1f294782b7a7abe0c82fe100de95bb8cfb3,/Users/sanika/Downloads/Master Thesis/repo_updated/pytest/testing/example_scripts/fixtures/fill_fixtures/test_conftest_funcargs_only_available_in_subdir/sub1/__init__.py,5048,ModificationType.MODIFY,0,0,0,0,0,0,0,0,0,0,0,0,0,0,0,0,0,0.0,0.0
803cc1f294782b7a7abe0c82fe100de95bb8cfb3,/Users/sanika/Downloads/Master Thesis/repo_updated/pytest/testing/example_scripts/fixtures/fill_fixtures/test_conftest_funcargs_only_available_in_subdir/sub2/__init__.py,5048,ModificationType.MODIFY,0,0,0,0,0,0,0,0,0,0,0,0,0,0,0,0,0,0.0,0.0
803cc1f294782b7a7abe0c82fe100de95bb8cfb3,/Users/sanika/Downloads/Master Thesis/repo_updated/pytest/testing/example_scripts/fixtures/custom_item/__init__.pyi,5048,ModificationType.MODIFY,0,0,0,0,0,0,0,0,0,0,0,0,0,0,0,0,0,0.0,0.0
803cc1f294782b7a7abe0c82fe100de95bb8cfb3,/Users/sanika/Downloads/Master Thesis/repo_updated/pytest/testing/example_scripts/fixtures/custom_item/foo/__init__.py,5048,ModificationType.MODIFY,0,0,0,0,0,0,0,0,0,0,0,0,0,0,0,0,0,0.0,0.0
803cc1f294782b7a7abe0c82fe100de95bb8cfb3,/Users/sanika/Downloads/Master Thesis/repo_updated/pytest/doc/en/example/nonpython/__init__.py,5048,ModificationType.MODIFY,0,0,0,0,0,0,0,0,0,0,0,0,0,0,0,0,0,0.0,0.0
803cc1f294782b7a7abe0c82fe100de95bb8cfb3,/Users/sanika/Downloads/Master Thesis/repo_updated/pytest/src/pytest/__init__.py,5048,ModificationType.MODIFY,99,48,90,1,3,5,100,0,0,0,0,0,0,0,0,0,0,0.0,0.0
803cc1f294782b7a7abe0c82fe100de95bb8cfb3,/Users/sanika/Downloads/Master Thesis/repo_updated/pytest/src/_pytest/__init__.py,5048,ModificationType.MODIFY,8,5,5,2,0,1,10,0,0,0,0,0,0,0,0,0,0,0.0,0.0
803cc1f294782b7a7abe0c82fe100de95bb8cfb3,/Users/sanika/Downloads/Master Thesis/repo_updated/pytest/src/_pytest/config/__init__.py,5048,ModificationType.MODIFY,1217,716,841,84,126,174,1301,14,185,118,215,199,333,1446.608539104324,2542.995998641035,8.135135135135135,20687.616097052745,1149.3120053918192,0.847665332880345
803cc1f294782b7a7abe0c82fe100de95bb8cfb3,/Users/sanika/Downloads/Master Thesis/repo_updated/pytest/src/_pytest/mark/__init__.py,5048,ModificationType.MODIFY,160,89,115,0,13,31,160,7,15,11,17,22,28,78.25484338853101,124.86408532184433,3.966666666666667,495.2942051099825,27.51634472833236,0.04162136177394811
803cc1f294782b7a7abe0c82fe100de95bb8cfb3,/Users/sanika/Downloads/Master Thesis/repo_updated/pytest/src/_pytest/_code/__init__.py,5048,ModificationType.MODIFY,10,10,9,9,0,0,19,0,0,0,0,0,0,0,0,0,0,0.0,0.0
803cc1f294782b7a7abe0c82fe100de95bb8cfb3,/Users/sanika/Downloads/Master Thesis/repo_updated/pytest/src/_pytest/assertion/__init__.py,5048,ModificationType.MODIFY,173,84,99,8,29,36,181,5,12,7,13,17,20,54.62919048309069,81.7492568250068,2.7083333333333335,221.4042372343934,12.300235401910745,0.027249752275002266
803cc1f294782b7a7abe0c82fe100de95bb8cfb3,/Users/sanika/Downloads/Master Thesis/repo_updated/pytest/src/_pytest/_io/__init__.py,5048,ModificationType.MODIFY,3,1,1,3,0,0,6,0,0,0,0,0,0,0,0,0,0,0.0,0.0
803cc1f294782b7a7abe0c82fe100de95bb8cfb3,/Users/sanika/Downloads/Master Thesis/repo_updated/pytest/testing/test_setuponly.py,381,ModificationType.MODIFY,294,64,250,0,0,43,294,1,20,10,20,21,30,86.43856189774725,131.76952268336282,0.5,65.88476134168141,3.6602645189823004,0.04392317422778761
803cc1f294782b7a7abe0c82fe100de95bb8cfb3,/Users/sanika/Downloads/Master Thesis/repo_updated/pytest/src/_pytest/setuponly.py,381,ModificationType.MODIFY,78,46,62,3,0,14,81,3,8,4,8,11,12,28.75488750216347,41.51317942364757,1.5,62.26976913547136,3.4594316186372978,0.01383772647454919
803cc1f294782b7a7abe0c82fe100de95bb8cfb3,/Users/sanika/Downloads/Master Thesis/repo_updated/pytest/testing/test_cacheprovider.py,3773,ModificationType.MODIFY,996,429,845,24,10,117,1020,7,76,50,88,83,138,494.49397547611574,879.7554415258757,4.052631578947368,3565.3246840785487,198.07359355991937,0.29325181384195853
803cc1f294782b7a7abe0c82fe100de95bb8cfb3,/Users/sanika/Downloads/Master Thesis/repo_updated/pytest/testing/test_setuponly.py,572,ModificationType.MODIFY,294,64,250,0,0,43,294,1,20,10,20,21,30,86.43856189774725,131.76952268336282,0.5,65.88476134168141,3.6602645189823004,0.04392317422778761
9275012ef789048998d1b87b9536bd7c2c063596,/Users/sanika/Downloads/Master Thesis/repo_updated/pytest/doc/en/example/multipython.py,6701,ModificationType.MODIFY,72,33,56,0,4,12,72,1,1,1,1,2,2,0.0,2.0,0.5,1.0,0.05555555555555555,0.0006666666666666666
9275012ef789048998d1b87b9536bd7c2c063596,/Users/sanika/Downloads/Master Thesis/repo_updated/pytest/src/_pytest/python.py,6701,ModificationType.MODIFY,1454,835,1044,76,110,219,1530,17,275,158,296,292,454,2297.8910156145625,3718.180349731528,9.149090909090908,34017.97003608918,1889.8872242271766,1.2393934499105095
9275012ef789048998d1b87b9536bd7c2c063596,/Users/sanika/Downloads/Master Thesis/repo_updated/pytest/testing/test_skipping.py,3116,ModificationType.MODIFY,1178,367,1042,6,15,115,1184,9,94,51,95,103,146,644.6606770706787,976.22907696875,4.547872340425532,4439.7652170653255,246.65362317029587,0.32540969232291667
b94eb4cb7b455282144e99e9c0b21aa80596e993,/Users/sanika/Downloads/Master Thesis/repo_updated/pytest/doc/en/example/multipython.py,6750,ModificationType.MODIFY,72,33,56,0,4,12,72,1,1,1,1,2,2,0.0,2.0,0.5,1.0,0.05555555555555555,0.0006666666666666666
b94eb4cb7b455282144e99e9c0b21aa80596e993,/Users/sanika/Downloads/Master Thesis/repo_updated/pytest/src/_pytest/python.py,6750,ModificationType.MODIFY,1454,835,1044,76,110,219,1530,17,275,158,296,292,454,2297.8910156145625,3718.180349731528,9.149090909090908,34017.97003608918,1889.8872242271766,1.2393934499105095
5cefcb20522e3d48282ba3f889162be5ef8e9040,/Users/sanika/Downloads/Master Thesis/repo_updated/pytest/doc/en/example/multipython.py,6763,ModificationType.MODIFY,72,33,56,0,4,12,72,1,1,1,1,2,2,0.0,2.0,0.5,1.0,0.05555555555555555,0.0006666666666666666
5cefcb20522e3d48282ba3f889162be5ef8e9040,/Users/sanika/Downloads/Master Thesis/repo_updated/pytest/src/_pytest/python.py,6763,ModificationType.MODIFY,1454,835,1044,76,110,219,1530,17,275,158,296,292,454,2297.8910156145625,3718.180349731528,9.149090909090908,34017.97003608918,1889.8872242271766,1.2393934499105095
b47f57a08a9db7b3ec80b8197153a86d1eef117d,/Users/sanika/Downloads/Master Thesis/repo_updated/pytest/testing/test_pytester.py,5898,ModificationType.MODIFY,722,423,573,19,0,135,741,12,172,101,199,184,300,1320.3370878174146,2257.068586817104,6.941860465116279,15668.255189881524,870.4586216600846,0.7523561956057013
b47f57a08a9db7b3ec80b8197153a86d1eef117d,/Users/sanika/Downloads/Master Thesis/repo_updated/pytest/src/_pytest/pytester.py,5898,ModificationType.MODIFY,1508,847,911,44,250,301,1552,14,148,88,169,162,257,1120.302067021891,1886.3414507413484,7.993243243243243,15077.986055587939,837.6658919771077,0.6287804835804495
995990c61b1eaa5830d01a1a14608ec981eaf8b9,/Users/sanika/Downloads/Master Thesis/repo_updated/pytest/testing/test_capture.py,3433,ModificationType.MODIFY,1513,682,1277,25,13,200,1538,11,199,116,219,210,335,1557.7420472931965,2584.272248418151,6.052763819095477,15641.989563917903,868.9994202176613,0.8614240828060503
995990c61b1eaa5830d01a1a14608ec981eaf8b9,/Users/sanika/Downloads/Master Thesis/repo_updated/pytest/src/_pytest/capture.py,3433,ModificationType.MODIFY,819,519,539,24,98,155,843,15,96,57,106,111,163,690.7597590033588,1107.4897862150674,8.28125,9171.399792093527,509.52221067186264,0.36916326207168915
554dba391c2302c29590d7991414bfe5d01ab81e,/Users/sanika/Downloads/Master Thesis/repo_updated/pytest/testing/test_terminal.py,6093,ModificationType.MODIFY,1943,715,1694,26,18,214,1969,12,185,120,237,197,357,1436.3251202041715,2721.0724995459263,7.686486486486486,20915.486996509768,1161.971499806098,0.9070241665153088
554dba391c2302c29590d7991414bfe5d01ab81e,/Users/sanika/Downloads/Master Thesis/repo_updated/pytest/src/_pytest/terminal.py,6093,ModificationType.MODIFY,1168,838,957,57,25,144,1225,19,348,224,416,367,640,3018.854959310786,5452.5672018196565,11.35632183908046,61921.107993078396,3440.061555171022,1.8175224006065522
554dba391c2302c29590d7991414bfe5d01ab81e,/Users/sanika/Downloads/Master Thesis/repo_updated/pytest/testing/test_pdb.py,3969,ModificationType.MODIFY,1293,570,1093,25,15,163,1318,10,195,123,241,205,364,1516.6486921300477,2795.3307562199825,6.17948717948718,17273.710570487587,959.6505872493103,0.9317769187399941
554dba391c2302c29590d7991414bfe5d01ab81e,/Users/sanika/Downloads/Master Thesis/repo_updated/pytest/testing/test_terminal.py,6632,ModificationType.MODIFY,1943,715,1694,26,18,214,1969,12,185,120,237,197,357,1436.3251202041715,2721.0724995459263,7.686486486486486,20915.486996509768,1161.971499806098,0.9070241665153088
978c7ae1b72e410be6d2db25cee2817e91c2d4e4,/Users/sanika/Downloads/Master Thesis/repo_updated/pytest/testing/test_cacheprovider.py,2013,ModificationType.MODIFY,996,429,845,24,10,117,1020,7,76,50,88,83,138,494.49397547611574,879.7554415258757,4.052631578947368,3565.3246840785487,198.07359355991937,0.29325181384195853
978c7ae1b72e410be6d2db25cee2817e91c2d4e4,/Users/sanika/Downloads/Master Thesis/repo_updated/pytest/src/_pytest/cacheprovider.py,2013,ModificationType.MODIFY,456,277,329,12,42,72,468,13,85,50,97,98,147,592.903945907539,972.3623470849358,7.41764705882353,7212.640703965318,400.70226133140653,0.32412078236164527
978c7ae1b72e410be6d2db25cee2817e91c2d4e4,/Users/sanika/Downloads/Master Thesis/repo_updated/pytest/testing/example_scripts/collect/package_infinite_recursion/__init__.pyi,5048,ModificationType.MODIFY,0,0,0,0,0,0,0,0,0,0,0,0,0,0,0,0,0,0.0,0.0
978c7ae1b72e410be6d2db25cee2817e91c2d4e4,/Users/sanika/Downloads/Master Thesis/repo_updated/pytest/testing/example_scripts/collect/package_infinite_recursion/tests/__init__.py,5048,ModificationType.MODIFY,0,0,0,0,0,0,0,0,0,0,0,0,0,0,0,0,0,0.0,0.0
978c7ae1b72e410be6d2db25cee2817e91c2d4e4,/Users/sanika/Downloads/Master Thesis/repo_updated/pytest/testing/example_scripts/collect/collect_init_tests/tests/__init__.py,5048,ModificationType.MODIFY,2,2,2,0,0,0,2,0,0,0,0,0,0,0,0,0,0,0.0,0.0
978c7ae1b72e410be6d2db25cee2817e91c2d4e4,/Users/sanika/Downloads/Master Thesis/repo_updated/pytest/testing/example_scripts/collect/package_init_given_as_arg/pkg/__init__.py,5048,ModificationType.MODIFY,0,0,0,0,0,0,0,0,0,0,0,0,0,0,0,0,0,0.0,0.0
978c7ae1b72e410be6d2db25cee2817e91c2d4e4,/Users/sanika/Downloads/Master Thesis/repo_updated/pytest/testing/example_scripts/conftest_usageerror/__init__.pyi,5048,ModificationType.MODIFY,0,0,0,0,0,0,0,0,0,0,0,0,0,0,0,0,0,0.0,0.0
978c7ae1b72e410be6d2db25cee2817e91c2d4e4,/Users/sanika/Downloads/Master Thesis/repo_updated/pytest/testing/example_scripts/marks/marks_considered_keywords/__init__.pyi,5048,ModificationType.MODIFY,0,0,0,0,0,0,0,0,0,0,0,0,0,0,0,0,0,0.0,0.0
978c7ae1b72e410be6d2db25cee2817e91c2d4e4,/Users/sanika/Downloads/Master Thesis/repo_updated/pytest/testing/example_scripts/config/collect_pytest_prefix/__init__.pyi,5048,ModificationType.MODIFY,0,0,0,0,0,0,0,0,0,0,0,0,0,0,0,0,0,0.0,0.0
978c7ae1b72e410be6d2db25cee2817e91c2d4e4,/Users/sanika/Downloads/Master Thesis/repo_updated/pytest/testing/example_scripts/issue88_initial_file_multinodes/__init__.pyi,5048,ModificationType.MODIFY,0,0,0,0,0,0,0,0,0,0,0,0,0,0,0,0,0,0.0,0.0
978c7ae1b72e410be6d2db25cee2817e91c2d4e4,/Users/sanika/Downloads/Master Thesis/repo_updated/pytest/testing/example_scripts/fixtures/fill_fixtures/test_extend_fixture_conftest_conftest/__init__.pyi,5048,ModificationType.MODIFY,0,0,0,0,0,0,0,0,0,0,0,0,0,0,0,0,0,0.0,0.0
978c7ae1b72e410be6d2db25cee2817e91c2d4e4,/Users/sanika/Downloads/Master Thesis/repo_updated/pytest/testing/example_scripts/fixtures/fill_fixtures/test_extend_fixture_conftest_conftest/pkg/__init__.py,5048,ModificationType.MODIFY,0,0,0,0,0,0,0,0,0,0,0,0,0,0,0,0,0,0.0,0.0
978c7ae1b72e410be6d2db25cee2817e91c2d4e4,/Users/sanika/Downloads/Master Thesis/repo_updated/pytest/testing/example_scripts/fixtures/fill_fixtures/test_extend_fixture_conftest_module/__init__.pyi,5048,ModificationType.MODIFY,0,0,0,0,0,0,0,0,0,0,0,0,0,0,0,0,0,0.0,0.0
978c7ae1b72e410be6d2db25cee2817e91c2d4e4,/Users/sanika/Downloads/Master Thesis/repo_updated/pytest/testing/example_scripts/fixtures/fill_fixtures/test_conftest_funcargs_only_available_in_subdir/sub1/__init__.py,5048,ModificationType.MODIFY,0,0,0,0,0,0,0,0,0,0,0,0,0,0,0,0,0,0.0,0.0
978c7ae1b72e410be6d2db25cee2817e91c2d4e4,/Users/sanika/Downloads/Master Thesis/repo_updated/pytest/testing/example_scripts/fixtures/fill_fixtures/test_conftest_funcargs_only_available_in_subdir/sub2/__init__.py,5048,ModificationType.MODIFY,0,0,0,0,0,0,0,0,0,0,0,0,0,0,0,0,0,0.0,0.0
978c7ae1b72e410be6d2db25cee2817e91c2d4e4,/Users/sanika/Downloads/Master Thesis/repo_updated/pytest/testing/example_scripts/fixtures/custom_item/__init__.pyi,5048,ModificationType.MODIFY,0,0,0,0,0,0,0,0,0,0,0,0,0,0,0,0,0,0.0,0.0
978c7ae1b72e410be6d2db25cee2817e91c2d4e4,/Users/sanika/Downloads/Master Thesis/repo_updated/pytest/testing/example_scripts/fixtures/custom_item/foo/__init__.py,5048,ModificationType.MODIFY,0,0,0,0,0,0,0,0,0,0,0,0,0,0,0,0,0,0.0,0.0
978c7ae1b72e410be6d2db25cee2817e91c2d4e4,/Users/sanika/Downloads/Master Thesis/repo_updated/pytest/doc/en/example/nonpython/__init__.py,5048,ModificationType.MODIFY,0,0,0,0,0,0,0,0,0,0,0,0,0,0,0,0,0,0.0,0.0
978c7ae1b72e410be6d2db25cee2817e91c2d4e4,/Users/sanika/Downloads/Master Thesis/repo_updated/pytest/src/pytest/__init__.py,5048,ModificationType.MODIFY,99,48,90,1,3,5,100,0,0,0,0,0,0,0,0,0,0,0.0,0.0
978c7ae1b72e410be6d2db25cee2817e91c2d4e4,/Users/sanika/Downloads/Master Thesis/repo_updated/pytest/src/_pytest/__init__.py,5048,ModificationType.MODIFY,8,5,5,2,0,1,10,0,0,0,0,0,0,0,0,0,0,0.0,0.0
978c7ae1b72e410be6d2db25cee2817e91c2d4e4,/Users/sanika/Downloads/Master Thesis/repo_updated/pytest/src/_pytest/config/__init__.py,5048,ModificationType.MODIFY,1217,716,841,84,126,174,1301,14,185,118,215,199,333,1446.608539104324,2542.995998641035,8.135135135135135,20687.616097052745,1149.3120053918192,0.847665332880345
978c7ae1b72e410be6d2db25cee2817e91c2d4e4,/Users/sanika/Downloads/Master Thesis/repo_updated/pytest/src/_pytest/mark/__init__.py,5048,ModificationType.MODIFY,160,89,115,0,13,31,160,7,15,11,17,22,28,78.25484338853101,124.86408532184433,3.966666666666667,495.2942051099825,27.51634472833236,0.04162136177394811
978c7ae1b72e410be6d2db25cee2817e91c2d4e4,/Users/sanika/Downloads/Master Thesis/repo_updated/pytest/src/_pytest/_code/__init__.py,5048,ModificationType.MODIFY,10,10,9,9,0,0,19,0,0,0,0,0,0,0,0,0,0,0.0,0.0
978c7ae1b72e410be6d2db25cee2817e91c2d4e4,/Users/sanika/Downloads/Master Thesis/repo_updated/pytest/src/_pytest/assertion/__init__.py,5048,ModificationType.MODIFY,173,84,99,8,29,36,181,5,12,7,13,17,20,54.62919048309069,81.7492568250068,2.7083333333333335,221.4042372343934,12.300235401910745,0.027249752275002266
978c7ae1b72e410be6d2db25cee2817e91c2d4e4,/Users/sanika/Downloads/Master Thesis/repo_updated/pytest/src/_pytest/_io/__init__.py,5048,ModificationType.MODIFY,3,1,1,3,0,0,6,0,0,0,0,0,0,0,0,0,0,0.0,0.0
978c7ae1b72e410be6d2db25cee2817e91c2d4e4,/Users/sanika/Downloads/Master Thesis/repo_updated/pytest/testing/test_setuponly.py,381,ModificationType.MODIFY,294,64,250,0,0,43,294,1,20,10,20,21,30,86.43856189774725,131.76952268336282,0.5,65.88476134168141,3.6602645189823004,0.04392317422778761
978c7ae1b72e410be6d2db25cee2817e91c2d4e4,/Users/sanika/Downloads/Master Thesis/repo_updated/pytest/src/_pytest/setuponly.py,381,ModificationType.MODIFY,78,46,62,3,0,14,81,3,8,4,8,11,12,28.75488750216347,41.51317942364757,1.5,62.26976913547136,3.4594316186372978,0.01383772647454919
978c7ae1b72e410be6d2db25cee2817e91c2d4e4,/Users/sanika/Downloads/Master Thesis/repo_updated/pytest/testing/test_cacheprovider.py,3773,ModificationType.MODIFY,996,429,845,24,10,117,1020,7,76,50,88,83,138,494.49397547611574,879.7554415258757,4.052631578947368,3565.3246840785487,198.07359355991937,0.29325181384195853
978c7ae1b72e410be6d2db25cee2817e91c2d4e4,/Users/sanika/Downloads/Master Thesis/repo_updated/pytest/testing/test_setuponly.py,572,ModificationType.MODIFY,294,64,250,0,0,43,294,1,20,10,20,21,30,86.43856189774725,131.76952268336282,0.5,65.88476134168141,3.6602645189823004,0.04392317422778761
3c14dd7f55dbc14dabdff4ecf5246ba0f4501e8f,/Users/sanika/Downloads/Master Thesis/repo_updated/pytest/testing/test_capture.py,3434,ModificationType.MODIFY,1513,682,1277,25,13,200,1538,11,199,116,219,210,335,1557.7420472931965,2584.272248418151,6.052763819095477,15641.989563917903,868.9994202176613,0.8614240828060503
3c14dd7f55dbc14dabdff4ecf5246ba0f4501e8f,/Users/sanika/Downloads/Master Thesis/repo_updated/pytest/src/_pytest/capture.py,3434,ModificationType.MODIFY,819,519,539,24,98,155,843,15,96,57,106,111,163,690.7597590033588,1107.4897862150674,8.28125,9171.399792093527,509.52221067186264,0.36916326207168915
0dd68ba0b6a923bd57a4ba50772540020b974386,/Users/sanika/Downloads/Master Thesis/repo_updated/pytest/testing/test_meta.py,96,ModificationType.MODIFY,35,12,22,4,5,6,39,1,2,1,2,3,3,2.0,4.754887502163469,0.5,2.3774437510817346,0.1320802083934297,0.0015849625007211565
f4734213e5871364894c79f826e268d4b294f222,/Users/sanika/Downloads/Master Thesis/repo_updated/pytest/doc/en/conf.py,300,ModificationType.MODIFY,382,65,130,157,2,92,539,4,10,5,10,14,15,41.219280948873624,57.110323830864054,2.0,114.22064766172811,6.345591536762672,0.019036774610288017
f4734213e5871364894c79f826e268d4b294f222,/Users/sanika/Downloads/Master Thesis/repo_updated/pytest/doc/en/example/assertion/failure_demo.py,1139,ModificationType.MODIFY,282,196,195,3,0,86,285,8,130,71,141,138,212,936.907815693699,1507.007184836972,4.338461538461538,6538.092709600402,363.22737275557785,0.5023357282789906
f4734213e5871364894c79f826e268d4b294f222,/Users/sanika/Downloads/Master Thesis/repo_updated/pytest/testing/conftest.py,65,ModificationType.MODIFY,127,75,83,2,11,30,129,4,14,7,14,18,21,61.30296890880645,87.56842503028855,2.0,175.1368500605771,9.729825003365395,0.029189475010096184
f4734213e5871364894c79f826e268d4b294f222,/Users/sanika/Downloads/Master Thesis/repo_updated/pytest/testing/test_conftest.py,65,ModificationType.MODIFY,652,304,544,16,6,88,668,6,89,51,101,95,152,591.8500503603364,998.6180524663041,3.404494382022472,3399.7895494077547,188.8771971893197,0.3328726841554347
f4734213e5871364894c79f826e268d4b294f222,/Users/sanika/Downloads/Master Thesis/repo_updated/pytest/testing/example_scripts/collect/package_infinite_recursion/conftest.py,65,ModificationType.MODIFY,2,2,2,0,0,0,2,0,0,0,0,0,0,0,0,0,0,0.0,0.0
f4734213e5871364894c79f826e268d4b294f222,/Users/sanika/Downloads/Master Thesis/repo_updated/pytest/testing/example_scripts/conftest_usageerror/conftest.py,65,ModificationType.MODIFY,8,5,5,0,0,3,8,0,0,0,0,0,0,0,0,0,0,0.0,0.0
f4734213e5871364894c79f826e268d4b294f222,/Users/sanika/Downloads/Master Thesis/repo_updated/pytest/testing/example_scripts/marks/marks_considered_keywords/conftest.py,65,ModificationType.MODIFY,0,0,0,0,0,0,0,0,0,0,0,0,0,0,0,0,0,0.0,0.0
f4734213e5871364894c79f826e268d4b294f222,/Users/sanika/Downloads/Master Thesis/repo_updated/pytest/testing/example_scripts/config/collect_pytest_prefix/conftest.py,65,ModificationType.MODIFY,2,2,2,0,0,0,2,0,0,0,0,0,0,0,0,0,0,0.0,0.0
f4734213e5871364894c79f826e268d4b294f222,/Users/sanika/Downloads/Master Thesis/repo_updated/pytest/testing/example_scripts/issue88_initial_file_multinodes/conftest.py,65,ModificationType.MODIFY,14,8,8,0,0,6,14,0,0,0,0,0,0,0,0,0,0,0.0,0.0
f4734213e5871364894c79f826e268d4b294f222,/Users/sanika/Downloads/Master Thesis/repo_updated/pytest/testing/example_scripts/fixtures/fill_fixtures/test_extend_fixture_conftest_conftest/conftest.py,65,ModificationType.MODIFY,6,4,4,0,0,2,6,0,0,0,0,0,0,0,0,0,0,0.0,0.0
f4734213e5871364894c79f826e268d4b294f222,/Users/sanika/Downloads/Master Thesis/repo_updated/pytest/testing/example_scripts/fixtures/fill_fixtures/test_extend_fixture_conftest_conftest/pkg/conftest.py,65,ModificationType.MODIFY,6,4,4,0,0,2,6,1,2,1,2,3,3,2.0,4.754887502163469,0.5,2.3774437510817346,0.1320802083934297,0.0015849625007211565
f4734213e5871364894c79f826e268d4b294f222,/Users/sanika/Downloads/Master Thesis/repo_updated/pytest/testing/example_scripts/fixtures/fill_fixtures/test_extend_fixture_conftest_module/conftest.py,65,ModificationType.MODIFY,6,4,4,0,0,2,6,0,0,0,0,0,0,0,0,0,0,0.0,0.0
f4734213e5871364894c79f826e268d4b294f222,/Users/sanika/Downloads/Master Thesis/repo_updated/pytest/testing/example_scripts/fixtures/fill_fixtures/test_conftest_funcargs_only_available_in_subdir/sub1/conftest.py,65,ModificationType.MODIFY,7,5,5,0,0,2,7,0,0,0,0,0,0,0,0,0,0,0.0,0.0
f4734213e5871364894c79f826e268d4b294f222,/Users/sanika/Downloads/Master Thesis/repo_updated/pytest/testing/example_scripts/fixtures/fill_fixtures/test_conftest_funcargs_only_available_in_subdir/sub2/conftest.py,65,ModificationType.MODIFY,6,4,4,0,0,2,6,0,0,0,0,0,0,0,0,0,0,0.0,0.0
f4734213e5871364894c79f826e268d4b294f222,/Users/sanika/Downloads/Master Thesis/repo_updated/pytest/testing/example_scripts/fixtures/custom_item/conftest.py,65,ModificationType.MODIFY,10,6,6,0,0,4,10,0,0,0,0,0,0,0,0,0,0,0.0,0.0
f4734213e5871364894c79f826e268d4b294f222,/Users/sanika/Downloads/Master Thesis/repo_updated/pytest/doc/en/conftest.py,65,ModificationType.MODIFY,1,1,1,0,0,0,1,0,0,0,0,0,0,0,0,0,0,0.0,0.0
f4734213e5871364894c79f826e268d4b294f222,/Users/sanika/Downloads/Master Thesis/repo_updated/pytest/doc/en/example/conftest.py,65,ModificationType.MODIFY,1,1,1,0,0,0,1,0,0,0,0,0,0,0,0,0,0,0.0,0.0
f4734213e5871364894c79f826e268d4b294f222,/Users/sanika/Downloads/Master Thesis/repo_updated/pytest/doc/en/example/assertion/global_testmodule_config/conftest.py,65,ModificationType.MODIFY,14,10,10,0,0,4,14,1,1,1,1,2,2,0.0,2.0,0.5,1.0,0.05555555555555555,0.0006666666666666666
f4734213e5871364894c79f826e268d4b294f222,/Users/sanika/Downloads/Master Thesis/repo_updated/pytest/doc/en/example/nonpython/conftest.py,65,ModificationType.MODIFY,46,26,30,3,0,12,49,3,6,3,6,9,9,20.264662506490406,28.529325012980813,1.5,42.793987519471216,2.377443751081734,0.009509775004326938
f4734213e5871364894c79f826e268d4b294f222,/Users/sanika/Downloads/Master Thesis/repo_updated/pytest/doc/en/example/fixtures/test_fixtures_order.py,140,ModificationType.ADD,38,22,22,1,0,15,39,1,2,1,2,3,3,2.0,4.754887502163469,0.5,2.3774437510817346,0.1320802083934297,0.0015849625007211565
f4734213e5871364894c79f826e268d4b294f222,/Users/sanika/Downloads/Master Thesis/repo_updated/pytest/doc/en/example/multipython.py,292,ModificationType.MODIFY,72,33,56,0,4,12,72,1,1,1,1,2,2,0.0,2.0,0.5,1.0,0.05555555555555555,0.0006666666666666666
f4734213e5871364894c79f826e268d4b294f222,/Users/sanika/Downloads/Master Thesis/repo_updated/pytest/testing/conftest.py,228,ModificationType.MODIFY,127,75,83,2,11,30,129,4,14,7,14,18,21,61.30296890880645,87.56842503028855,2.0,175.1368500605771,9.729825003365395,0.029189475010096184
f4734213e5871364894c79f826e268d4b294f222,/Users/sanika/Downloads/Master Thesis/repo_updated/pytest/testing/test_conftest.py,228,ModificationType.MODIFY,652,304,544,16,6,88,668,6,89,51,101,95,152,591.8500503603364,998.6180524663041,3.404494382022472,3399.7895494077547,188.8771971893197,0.3328726841554347
f4734213e5871364894c79f826e268d4b294f222,/Users/sanika/Downloads/Master Thesis/repo_updated/pytest/testing/example_scripts/collect/package_infinite_recursion/conftest.py,228,ModificationType.MODIFY,2,2,2,0,0,0,2,0,0,0,0,0,0,0,0,0,0,0.0,0.0
f4734213e5871364894c79f826e268d4b294f222,/Users/sanika/Downloads/Master Thesis/repo_updated/pytest/testing/example_scripts/conftest_usageerror/conftest.py,228,ModificationType.MODIFY,8,5,5,0,0,3,8,0,0,0,0,0,0,0,0,0,0,0.0,0.0
f4734213e5871364894c79f826e268d4b294f222,/Users/sanika/Downloads/Master Thesis/repo_updated/pytest/testing/example_scripts/marks/marks_considered_keywords/conftest.py,228,ModificationType.MODIFY,0,0,0,0,0,0,0,0,0,0,0,0,0,0,0,0,0,0.0,0.0
f4734213e5871364894c79f826e268d4b294f222,/Users/sanika/Downloads/Master Thesis/repo_updated/pytest/testing/example_scripts/config/collect_pytest_prefix/conftest.py,228,ModificationType.MODIFY,2,2,2,0,0,0,2,0,0,0,0,0,0,0,0,0,0,0.0,0.0
f4734213e5871364894c79f826e268d4b294f222,/Users/sanika/Downloads/Master Thesis/repo_updated/pytest/testing/example_scripts/issue88_initial_file_multinodes/conftest.py,228,ModificationType.MODIFY,14,8,8,0,0,6,14,0,0,0,0,0,0,0,0,0,0,0.0,0.0
f4734213e5871364894c79f826e268d4b294f222,/Users/sanika/Downloads/Master Thesis/repo_updated/pytest/testing/example_scripts/fixtures/fill_fixtures/test_extend_fixture_conftest_conftest/conftest.py,228,ModificationType.MODIFY,6,4,4,0,0,2,6,0,0,0,0,0,0,0,0,0,0,0.0,0.0
f4734213e5871364894c79f826e268d4b294f222,/Users/sanika/Downloads/Master Thesis/repo_updated/pytest/testing/example_scripts/fixtures/fill_fixtures/test_extend_fixture_conftest_conftest/pkg/conftest.py,228,ModificationType.MODIFY,6,4,4,0,0,2,6,1,2,1,2,3,3,2.0,4.754887502163469,0.5,2.3774437510817346,0.1320802083934297,0.0015849625007211565
f4734213e5871364894c79f826e268d4b294f222,/Users/sanika/Downloads/Master Thesis/repo_updated/pytest/testing/example_scripts/fixtures/fill_fixtures/test_extend_fixture_conftest_module/conftest.py,228,ModificationType.MODIFY,6,4,4,0,0,2,6,0,0,0,0,0,0,0,0,0,0,0.0,0.0
f4734213e5871364894c79f826e268d4b294f222,/Users/sanika/Downloads/Master Thesis/repo_updated/pytest/testing/example_scripts/fixtures/fill_fixtures/test_conftest_funcargs_only_available_in_subdir/sub1/conftest.py,228,ModificationType.MODIFY,7,5,5,0,0,2,7,0,0,0,0,0,0,0,0,0,0,0.0,0.0
f4734213e5871364894c79f826e268d4b294f222,/Users/sanika/Downloads/Master Thesis/repo_updated/pytest/testing/example_scripts/fixtures/fill_fixtures/test_conftest_funcargs_only_available_in_subdir/sub2/conftest.py,228,ModificationType.MODIFY,6,4,4,0,0,2,6,0,0,0,0,0,0,0,0,0,0,0.0,0.0
f4734213e5871364894c79f826e268d4b294f222,/Users/sanika/Downloads/Master Thesis/repo_updated/pytest/testing/example_scripts/fixtures/custom_item/conftest.py,228,ModificationType.MODIFY,10,6,6,0,0,4,10,0,0,0,0,0,0,0,0,0,0,0.0,0.0
f4734213e5871364894c79f826e268d4b294f222,/Users/sanika/Downloads/Master Thesis/repo_updated/pytest/doc/en/conftest.py,228,ModificationType.MODIFY,1,1,1,0,0,0,1,0,0,0,0,0,0,0,0,0,0,0.0,0.0
f4734213e5871364894c79f826e268d4b294f222,/Users/sanika/Downloads/Master Thesis/repo_updated/pytest/doc/en/example/conftest.py,228,ModificationType.MODIFY,1,1,1,0,0,0,1,0,0,0,0,0,0,0,0,0,0,0.0,0.0
f4734213e5871364894c79f826e268d4b294f222,/Users/sanika/Downloads/Master Thesis/repo_updated/pytest/doc/en/example/assertion/global_testmodule_config/conftest.py,228,ModificationType.MODIFY,14,10,10,0,0,4,14,1,1,1,1,2,2,0.0,2.0,0.5,1.0,0.05555555555555555,0.0006666666666666666
f4734213e5871364894c79f826e268d4b294f222,/Users/sanika/Downloads/Master Thesis/repo_updated/pytest/doc/en/example/nonpython/conftest.py,228,ModificationType.MODIFY,46,26,30,3,0,12,49,3,6,3,6,9,9,20.264662506490406,28.529325012980813,1.5,42.793987519471216,2.377443751081734,0.009509775004326938
f4734213e5871364894c79f826e268d4b294f222,/Users/sanika/Downloads/Master Thesis/repo_updated/pytest/setup.py,93,ModificationType.MODIFY,42,7,35,4,0,5,46,1,2,1,2,3,3,2.0,4.754887502163469,0.5,2.3774437510817346,0.1320802083934297,0.0015849625007211565
f4734213e5871364894c79f826e268d4b294f222,/Users/sanika/Downloads/Master Thesis/repo_updated/pytest/extra/setup-py.test/setup.py,93,ModificationType.MODIFY,11,6,10,0,0,1,11,2,4,2,4,6,6,10.0,15.509775004326936,1.0,15.509775004326936,0.861654166907052,0.005169925001442312
f4734213e5871364894c79f826e268d4b294f222,/Users/sanika/Downloads/Master Thesis/repo_updated/pytest/testing/code/test_code.py,4989,ModificationType.MODIFY,182,127,129,0,0,53,182,5,39,21,42,44,63,217.7403270100645,343.9441919741497,2.6923076923076925,926.003593776557,51.44464409869761,0.11464806399138323
f4734213e5871364894c79f826e268d4b294f222,/Users/sanika/Downloads/Master Thesis/repo_updated/pytest/src/_pytest/_code/code.py,4989,ModificationType.MODIFY,1165,710,800,67,119,181,1232,18,243,153,282,261,435,2000.7880884021665,3492.1391085079,10.444444444444445,36473.45291108251,2026.302939504584,1.1640463695026333
f4734213e5871364894c79f826e268d4b294f222,/Users/sanika/Downloads/Master Thesis/repo_updated/pytest/testing/code/test_source.py,1549,ModificationType.MODIFY,773,419,590,28,0,166,801,10,204,113,217,214,330,1598.3940507110585,2554.684105512378,5.318627450980392,13587.413012161423,754.8562784534124,0.8515613685041261
f4734213e5871364894c79f826e268d4b294f222,/Users/sanika/Downloads/Master Thesis/repo_updated/pytest/src/_pytest/_code/source.py,1549,ModificationType.MODIFY,421,273,302,44,34,57,465,17,81,59,107,98,166,583.0147185349103,1098.0418341231248,11.228395061728396,12329.247507839284,684.9581948799602,0.36601394470770826
f4734213e5871364894c79f826e268d4b294f222,/Users/sanika/Downloads/Master Thesis/repo_updated/pytest/testing/example_scripts/collect/package_infinite_recursion/__init__.pyi,568,ModificationType.MODIFY,0,0,0,0,0,0,0,0,0,0,0,0,0,0,0,0,0,0.0,0.0
f4734213e5871364894c79f826e268d4b294f222,/Users/sanika/Downloads/Master Thesis/repo_updated/pytest/testing/example_scripts/collect/package_infinite_recursion/tests/__init__.py,568,ModificationType.MODIFY,0,0,0,0,0,0,0,0,0,0,0,0,0,0,0,0,0,0.0,0.0
f4734213e5871364894c79f826e268d4b294f222,/Users/sanika/Downloads/Master Thesis/repo_updated/pytest/testing/example_scripts/collect/collect_init_tests/tests/__init__.py,568,ModificationType.MODIFY,2,2,2,0,0,0,2,0,0,0,0,0,0,0,0,0,0,0.0,0.0
f4734213e5871364894c79f826e268d4b294f222,/Users/sanika/Downloads/Master Thesis/repo_updated/pytest/testing/example_scripts/collect/package_init_given_as_arg/pkg/__init__.py,568,ModificationType.MODIFY,0,0,0,0,0,0,0,0,0,0,0,0,0,0,0,0,0,0.0,0.0
f4734213e5871364894c79f826e268d4b294f222,/Users/sanika/Downloads/Master Thesis/repo_updated/pytest/testing/example_scripts/conftest_usageerror/__init__.pyi,568,ModificationType.MODIFY,0,0,0,0,0,0,0,0,0,0,0,0,0,0,0,0,0,0.0,0.0
f4734213e5871364894c79f826e268d4b294f222,/Users/sanika/Downloads/Master Thesis/repo_updated/pytest/testing/example_scripts/marks/marks_considered_keywords/__init__.pyi,568,ModificationType.MODIFY,0,0,0,0,0,0,0,0,0,0,0,0,0,0,0,0,0,0.0,0.0
f4734213e5871364894c79f826e268d4b294f222,/Users/sanika/Downloads/Master Thesis/repo_updated/pytest/testing/example_scripts/config/collect_pytest_prefix/__init__.pyi,568,ModificationType.MODIFY,0,0,0,0,0,0,0,0,0,0,0,0,0,0,0,0,0,0.0,0.0
f4734213e5871364894c79f826e268d4b294f222,/Users/sanika/Downloads/Master Thesis/repo_updated/pytest/testing/example_scripts/issue88_initial_file_multinodes/__init__.pyi,568,ModificationType.MODIFY,0,0,0,0,0,0,0,0,0,0,0,0,0,0,0,0,0,0.0,0.0
f4734213e5871364894c79f826e268d4b294f222,/Users/sanika/Downloads/Master Thesis/repo_updated/pytest/testing/example_scripts/fixtures/fill_fixtures/test_extend_fixture_conftest_conftest/__init__.pyi,568,ModificationType.MODIFY,0,0,0,0,0,0,0,0,0,0,0,0,0,0,0,0,0,0.0,0.0
f4734213e5871364894c79f826e268d4b294f222,/Users/sanika/Downloads/Master Thesis/repo_updated/pytest/testing/example_scripts/fixtures/fill_fixtures/test_extend_fixture_conftest_conftest/pkg/__init__.py,568,ModificationType.MODIFY,0,0,0,0,0,0,0,0,0,0,0,0,0,0,0,0,0,0.0,0.0
f4734213e5871364894c79f826e268d4b294f222,/Users/sanika/Downloads/Master Thesis/repo_updated/pytest/testing/example_scripts/fixtures/fill_fixtures/test_extend_fixture_conftest_module/__init__.pyi,568,ModificationType.MODIFY,0,0,0,0,0,0,0,0,0,0,0,0,0,0,0,0,0,0.0,0.0
f4734213e5871364894c79f826e268d4b294f222,/Users/sanika/Downloads/Master Thesis/repo_updated/pytest/testing/example_scripts/fixtures/fill_fixtures/test_conftest_funcargs_only_available_in_subdir/sub1/__init__.py,568,ModificationType.MODIFY,0,0,0,0,0,0,0,0,0,0,0,0,0,0,0,0,0,0.0,0.0
f4734213e5871364894c79f826e268d4b294f222,/Users/sanika/Downloads/Master Thesis/repo_updated/pytest/testing/example_scripts/fixtures/fill_fixtures/test_conftest_funcargs_only_available_in_subdir/sub2/__init__.py,568,ModificationType.MODIFY,0,0,0,0,0,0,0,0,0,0,0,0,0,0,0,0,0,0.0,0.0
f4734213e5871364894c79f826e268d4b294f222,/Users/sanika/Downloads/Master Thesis/repo_updated/pytest/testing/example_scripts/fixtures/custom_item/__init__.pyi,568,ModificationType.MODIFY,0,0,0,0,0,0,0,0,0,0,0,0,0,0,0,0,0,0.0,0.0
f4734213e5871364894c79f826e268d4b294f222,/Users/sanika/Downloads/Master Thesis/repo_updated/pytest/testing/example_scripts/fixtures/custom_item/foo/__init__.py,568,ModificationType.MODIFY,0,0,0,0,0,0,0,0,0,0,0,0,0,0,0,0,0,0.0,0.0
f4734213e5871364894c79f826e268d4b294f222,/Users/sanika/Downloads/Master Thesis/repo_updated/pytest/doc/en/example/nonpython/__init__.py,568,ModificationType.MODIFY,0,0,0,0,0,0,0,0,0,0,0,0,0,0,0,0,0,0.0,0.0
f4734213e5871364894c79f826e268d4b294f222,/Users/sanika/Downloads/Master Thesis/repo_updated/pytest/src/pytest/__init__.py,568,ModificationType.MODIFY,99,48,90,1,3,5,100,0,0,0,0,0,0,0,0,0,0,0.0,0.0
f4734213e5871364894c79f826e268d4b294f222,/Users/sanika/Downloads/Master Thesis/repo_updated/pytest/src/_pytest/__init__.py,568,ModificationType.MODIFY,8,5,5,2,0,1,10,0,0,0,0,0,0,0,0,0,0,0.0,0.0
f4734213e5871364894c79f826e268d4b294f222,/Users/sanika/Downloads/Master Thesis/repo_updated/pytest/src/_pytest/config/__init__.py,568,ModificationType.MODIFY,1217,716,841,84,126,174,1301,14,185,118,215,199,333,1446.608539104324,2542.995998641035,8.135135135135135,20687.616097052745,1149.3120053918192,0.847665332880345
f4734213e5871364894c79f826e268d4b294f222,/Users/sanika/Downloads/Master Thesis/repo_updated/pytest/src/_pytest/mark/__init__.py,568,ModificationType.MODIFY,160,89,115,0,13,31,160,7,15,11,17,22,28,78.25484338853101,124.86408532184433,3.966666666666667,495.2942051099825,27.51634472833236,0.04162136177394811
f4734213e5871364894c79f826e268d4b294f222,/Users/sanika/Downloads/Master Thesis/repo_updated/pytest/src/_pytest/_code/__init__.py,568,ModificationType.MODIFY,10,10,9,9,0,0,19,0,0,0,0,0,0,0,0,0,0,0.0,0.0
f4734213e5871364894c79f826e268d4b294f222,/Users/sanika/Downloads/Master Thesis/repo_updated/pytest/src/_pytest/assertion/__init__.py,568,ModificationType.MODIFY,173,84,99,8,29,36,181,5,12,7,13,17,20,54.62919048309069,81.7492568250068,2.7083333333333335,221.4042372343934,12.300235401910745,0.027249752275002266
f4734213e5871364894c79f826e268d4b294f222,/Users/sanika/Downloads/Master Thesis/repo_updated/pytest/src/_pytest/_io/__init__.py,568,ModificationType.MODIFY,3,1,1,3,0,0,6,0,0,0,0,0,0,0,0,0,0,0.0,0.0
f4734213e5871364894c79f826e268d4b294f222,/Users/sanika/Downloads/Master Thesis/repo_updated/pytest/testing/test_assertrewrite.py,5415,ModificationType.MODIFY,1660,832,1314,41,38,274,1701,20,312,209,395,332,604,2671.484054182769,5058.523816533542,12.66025641025641,64042.2085747035,3557.900476372417,1.6861746055111808
f4734213e5871364894c79f826e268d4b294f222,/Users/sanika/Downloads/Master Thesis/repo_updated/pytest/src/_pytest/assertion/rewrite.py,5415,ModificationType.MODIFY,1057,646,719,113,100,145,1170,18,215,134,248,233,382,1740.9201126876956,3004.119107257935,10.38139534883721,31186.948127440515,1732.608229302251,1.001373035752645
f4734213e5871364894c79f826e268d4b294f222,/Users/sanika/Downloads/Master Thesis/repo_updated/pytest/src/_pytest/assertion/util.py,2323,ModificationType.MODIFY,477,336,357,30,23,73,507,16,194,134,250,210,384,1538.3830913843028,2962.270278783791,10.309278350515465,30538.86885344115,1696.603825191175,0.9874234262612637
f4734213e5871364894c79f826e268d4b294f222,/Users/sanika/Downloads/Master Thesis/repo_updated/pytest/testing/test_cacheprovider.py,2013,ModificationType.MODIFY,996,429,845,24,10,117,1020,7,76,50,88,83,138,494.49397547611574,879.7554415258757,4.052631578947368,3565.3246840785487,198.07359355991937,0.29325181384195853
f4734213e5871364894c79f826e268d4b294f222,/Users/sanika/Downloads/Master Thesis/repo_updated/pytest/src/_pytest/cacheprovider.py,2013,ModificationType.MODIFY,456,277,329,12,42,72,468,13,85,50,97,98,147,592.903945907539,972.3623470849358,7.41764705882353,7212.640703965318,400.70226133140653,0.32412078236164527
f4734213e5871364894c79f826e268d4b294f222,/Users/sanika/Downloads/Master Thesis/repo_updated/pytest/testing/test_capture.py,3434,ModificationType.MODIFY,1513,682,1277,25,13,200,1538,11,199,116,219,210,335,1557.7420472931965,2584.272248418151,6.052763819095477,15641.989563917903,868.9994202176613,0.8614240828060503
f4734213e5871364894c79f826e268d4b294f222,/Users/sanika/Downloads/Master Thesis/repo_updated/pytest/src/_pytest/capture.py,3434,ModificationType.MODIFY,819,519,539,24,98,155,843,15,96,57,106,111,163,690.7597590033588,1107.4897862150674,8.28125,9171.399792093527,509.52221067186264,0.36916326207168915
f4734213e5871364894c79f826e268d4b294f222,/Users/sanika/Downloads/Master Thesis/repo_updated/pytest/testing/test_compat.py,1191,ModificationType.MODIFY,207,111,150,11,0,50,218,5,26,19,36,31,55,133.82107314610522,272.4807970712782,3.4615384615384617,943.202759092886,52.40015328293811,0.09082693235709273
f4734213e5871364894c79f826e268d4b294f222,/Users/sanika/Downloads/Master Thesis/repo_updated/pytest/src/_pytest/compat.py,1191,ModificationType.MODIFY,410,198,237,31,55,97,441,11,63,38,72,74,110,414.62238298550506,683.0398702191846,6.285714285714286,4293.39346994916,238.52185944162,0.2276799567397282
f4734213e5871364894c79f826e268d4b294f222,/Users/sanika/Downloads/Master Thesis/repo_updated/pytest/testing/example_scripts/collect/package_infinite_recursion/__init__.pyi,5048,ModificationType.MODIFY,0,0,0,0,0,0,0,0,0,0,0,0,0,0,0,0,0,0.0,0.0
f4734213e5871364894c79f826e268d4b294f222,/Users/sanika/Downloads/Master Thesis/repo_updated/pytest/testing/example_scripts/collect/package_infinite_recursion/tests/__init__.py,5048,ModificationType.MODIFY,0,0,0,0,0,0,0,0,0,0,0,0,0,0,0,0,0,0.0,0.0
f4734213e5871364894c79f826e268d4b294f222,/Users/sanika/Downloads/Master Thesis/repo_updated/pytest/testing/example_scripts/collect/collect_init_tests/tests/__init__.py,5048,ModificationType.MODIFY,2,2,2,0,0,0,2,0,0,0,0,0,0,0,0,0,0,0.0,0.0
f4734213e5871364894c79f826e268d4b294f222,/Users/sanika/Downloads/Master Thesis/repo_updated/pytest/testing/example_scripts/collect/package_init_given_as_arg/pkg/__init__.py,5048,ModificationType.MODIFY,0,0,0,0,0,0,0,0,0,0,0,0,0,0,0,0,0,0.0,0.0
f4734213e5871364894c79f826e268d4b294f222,/Users/sanika/Downloads/Master Thesis/repo_updated/pytest/testing/example_scripts/conftest_usageerror/__init__.pyi,5048,ModificationType.MODIFY,0,0,0,0,0,0,0,0,0,0,0,0,0,0,0,0,0,0.0,0.0
f4734213e5871364894c79f826e268d4b294f222,/Users/sanika/Downloads/Master Thesis/repo_updated/pytest/testing/example_scripts/marks/marks_considered_keywords/__init__.pyi,5048,ModificationType.MODIFY,0,0,0,0,0,0,0,0,0,0,0,0,0,0,0,0,0,0.0,0.0
f4734213e5871364894c79f826e268d4b294f222,/Users/sanika/Downloads/Master Thesis/repo_updated/pytest/testing/example_scripts/config/collect_pytest_prefix/__init__.pyi,5048,ModificationType.MODIFY,0,0,0,0,0,0,0,0,0,0,0,0,0,0,0,0,0,0.0,0.0
f4734213e5871364894c79f826e268d4b294f222,/Users/sanika/Downloads/Master Thesis/repo_updated/pytest/testing/example_scripts/issue88_initial_file_multinodes/__init__.pyi,5048,ModificationType.MODIFY,0,0,0,0,0,0,0,0,0,0,0,0,0,0,0,0,0,0.0,0.0
f4734213e5871364894c79f826e268d4b294f222,/Users/sanika/Downloads/Master Thesis/repo_updated/pytest/testing/example_scripts/fixtures/fill_fixtures/test_extend_fixture_conftest_conftest/__init__.pyi,5048,ModificationType.MODIFY,0,0,0,0,0,0,0,0,0,0,0,0,0,0,0,0,0,0.0,0.0
f4734213e5871364894c79f826e268d4b294f222,/Users/sanika/Downloads/Master Thesis/repo_updated/pytest/testing/example_scripts/fixtures/fill_fixtures/test_extend_fixture_conftest_conftest/pkg/__init__.py,5048,ModificationType.MODIFY,0,0,0,0,0,0,0,0,0,0,0,0,0,0,0,0,0,0.0,0.0
f4734213e5871364894c79f826e268d4b294f222,/Users/sanika/Downloads/Master Thesis/repo_updated/pytest/testing/example_scripts/fixtures/fill_fixtures/test_extend_fixture_conftest_module/__init__.pyi,5048,ModificationType.MODIFY,0,0,0,0,0,0,0,0,0,0,0,0,0,0,0,0,0,0.0,0.0
f4734213e5871364894c79f826e268d4b294f222,/Users/sanika/Downloads/Master Thesis/repo_updated/pytest/testing/example_scripts/fixtures/fill_fixtures/test_conftest_funcargs_only_available_in_subdir/sub1/__init__.py,5048,ModificationType.MODIFY,0,0,0,0,0,0,0,0,0,0,0,0,0,0,0,0,0,0.0,0.0
f4734213e5871364894c79f826e268d4b294f222,/Users/sanika/Downloads/Master Thesis/repo_updated/pytest/testing/example_scripts/fixtures/fill_fixtures/test_conftest_funcargs_only_available_in_subdir/sub2/__init__.py,5048,ModificationType.MODIFY,0,0,0,0,0,0,0,0,0,0,0,0,0,0,0,0,0,0.0,0.0
f4734213e5871364894c79f826e268d4b294f222,/Users/sanika/Downloads/Master Thesis/repo_updated/pytest/testing/example_scripts/fixtures/custom_item/__init__.pyi,5048,ModificationType.MODIFY,0,0,0,0,0,0,0,0,0,0,0,0,0,0,0,0,0,0.0,0.0
f4734213e5871364894c79f826e268d4b294f222,/Users/sanika/Downloads/Master Thesis/repo_updated/pytest/testing/example_scripts/fixtures/custom_item/foo/__init__.py,5048,ModificationType.MODIFY,0,0,0,0,0,0,0,0,0,0,0,0,0,0,0,0,0,0.0,0.0
f4734213e5871364894c79f826e268d4b294f222,/Users/sanika/Downloads/Master Thesis/repo_updated/pytest/doc/en/example/nonpython/__init__.py,5048,ModificationType.MODIFY,0,0,0,0,0,0,0,0,0,0,0,0,0,0,0,0,0,0.0,0.0
f4734213e5871364894c79f826e268d4b294f222,/Users/sanika/Downloads/Master Thesis/repo_updated/pytest/src/pytest/__init__.py,5048,ModificationType.MODIFY,99,48,90,1,3,5,100,0,0,0,0,0,0,0,0,0,0,0.0,0.0
f4734213e5871364894c79f826e268d4b294f222,/Users/sanika/Downloads/Master Thesis/repo_updated/pytest/src/_pytest/__init__.py,5048,ModificationType.MODIFY,8,5,5,2,0,1,10,0,0,0,0,0,0,0,0,0,0,0.0,0.0
f4734213e5871364894c79f826e268d4b294f222,/Users/sanika/Downloads/Master Thesis/repo_updated/pytest/src/_pytest/config/__init__.py,5048,ModificationType.MODIFY,1217,716,841,84,126,174,1301,14,185,118,215,199,333,1446.608539104324,2542.995998641035,8.135135135135135,20687.616097052745,1149.3120053918192,0.847665332880345
f4734213e5871364894c79f826e268d4b294f222,/Users/sanika/Downloads/Master Thesis/repo_updated/pytest/src/_pytest/mark/__init__.py,5048,ModificationType.MODIFY,160,89,115,0,13,31,160,7,15,11,17,22,28,78.25484338853101,124.86408532184433,3.966666666666667,495.2942051099825,27.51634472833236,0.04162136177394811
f4734213e5871364894c79f826e268d4b294f222,/Users/sanika/Downloads/Master Thesis/repo_updated/pytest/src/_pytest/_code/__init__.py,5048,ModificationType.MODIFY,10,10,9,9,0,0,19,0,0,0,0,0,0,0,0,0,0,0.0,0.0
f4734213e5871364894c79f826e268d4b294f222,/Users/sanika/Downloads/Master Thesis/repo_updated/pytest/src/_pytest/assertion/__init__.py,5048,ModificationType.MODIFY,173,84,99,8,29,36,181,5,12,7,13,17,20,54.62919048309069,81.7492568250068,2.7083333333333335,221.4042372343934,12.300235401910745,0.027249752275002266
f4734213e5871364894c79f826e268d4b294f222,/Users/sanika/Downloads/Master Thesis/repo_updated/pytest/src/_pytest/_io/__init__.py,5048,ModificationType.MODIFY,3,1,1,3,0,0,6,0,0,0,0,0,0,0,0,0,0,0.0,0.0
f4734213e5871364894c79f826e268d4b294f222,/Users/sanika/Downloads/Master Thesis/repo_updated/pytest/src/_pytest/config/argparsing.py,2326,ModificationType.MODIFY,463,295,324,28,62,57,491,12,134,82,154,146,236,989.8755015299953,1696.7985958956842,6.895522388059701,11700.312706026956,650.0173725570531,0.565599531965228
f4734213e5871364894c79f826e268d4b294f222,/Users/sanika/Downloads/Master Thesis/repo_updated/pytest/src/_pytest/config/findpaths.py,813,ModificationType.MODIFY,167,116,138,4,5,22,171,8,48,30,56,56,86,292.0782000346155,499.432523296954,4.666666666666667,2330.685108719119,129.48250603995106,0.16647750776565134
f4734213e5871364894c79f826e268d4b294f222,/Users/sanika/Downloads/Master Thesis/repo_updated/pytest/src/_pytest/debugging.py,1488,ModificationType.MODIFY,339,213,244,17,9,65,356,10,42,26,48,52,74,259.6966127055816,421.83253914244085,5.714285714285714,2410.471652242519,133.91509179125106,0.14061084638081361
f4734213e5871364894c79f826e268d4b294f222,/Users/sanika/Downloads/Master Thesis/repo_updated/pytest/src/_pytest/deprecated.py,38,ModificationType.MODIFY,42,7,23,2,8,9,44,0,0,0,0,0,0,0,0,0,0,0.0,0.0
f4734213e5871364894c79f826e268d4b294f222,/Users/sanika/Downloads/Master Thesis/repo_updated/pytest/testing/python/fixtures.py,6225,ModificationType.MODIFY,4293,999,3693,19,54,507,4312,9,155,88,170,164,258,1156.3286078304877,1898.248417191466,4.935483870967742,9368.774446138526,520.4874692299181,0.6327494723971553
f4734213e5871364894c79f826e268d4b294f222,/Users/sanika/Downloads/Master Thesis/repo_updated/pytest/src/_pytest/fixtures.py,6225,ModificationType.MODIFY,1482,859,1002,125,135,219,1607,16,219,134,251,235,385,1766.678366052657,3032.459024427525,9.168949771689498,27804.464479682512,1544.692471093473,1.0108196748091751
f4734213e5871364894c79f826e268d4b294f222,/Users/sanika/Downloads/Master Thesis/repo_updated/pytest/testing/test_helpconfig.py,1080,ModificationType.MODIFY,74,35,59,1,0,14,75,3,14,7,14,17,21,58.05785641096992,85.83671966625714,1.5,128.75507949938572,7.153059972188095,0.02861223988875238
f4734213e5871364894c79f826e268d4b294f222,/Users/sanika/Downloads/Master Thesis/repo_updated/pytest/src/_pytest/helpconfig.py,1080,ModificationType.MODIFY,245,125,200,5,7,34,250,7,30,17,34,37,51,166.8582023226588,265.6821216470764,3.966666666666667,1053.8724158667364,58.548467548152026,0.08856070721569215
f4734213e5871364894c79f826e268d4b294f222,/Users/sanika/Downloads/Master Thesis/repo_updated/pytest/src/_pytest/hookspec.py,640,ModificationType.MODIFY,647,139,84,35,284,233,682,0,0,0,0,0,0,0,0,0,0,0.0,0.0
f4734213e5871364894c79f826e268d4b294f222,/Users/sanika/Downloads/Master Thesis/repo_updated/pytest/testing/test_junitxml.py,3166,ModificationType.MODIFY,1523,757,1297,19,12,193,1542,12,193,117,230,205,347,1508.3637582013935,2664.7795945283897,7.150259067357513,19053.864458285894,1058.5480254603274,0.8882598648427965
f4734213e5871364894c79f826e268d4b294f222,/Users/sanika/Downloads/Master Thesis/repo_updated/pytest/src/_pytest/junitxml.py,3166,ModificationType.MODIFY,701,378,504,33,58,109,734,13,110,68,126,123,194,794.0552848235468,1346.8478140358125,7.445454545454545,10027.894179048459,557.1052321693588,0.4489492713452708
f4734213e5871364894c79f826e268d4b294f222,/Users/sanika/Downloads/Master Thesis/repo_updated/pytest/src/_pytest/logging.py,2754,ModificationType.MODIFY,773,422,505,30,103,129,803,14,77,46,83,91,129,535.8455325423139,839.5055085856318,7.545454545454546,6334.450655691586,351.9139253161992,0.2798351695285439
f4734213e5871364894c79f826e268d4b294f222,/Users/sanika/Downloads/Master Thesis/repo_updated/pytest/testing/test_main.py,3472,ModificationType.MODIFY,77,34,69,0,0,8,77,3,24,16,29,27,45,114.79398751947123,213.9699375973561,1.8125,387.82051189520797,21.54558399417822,0.07132331253245204
f4734213e5871364894c79f826e268d4b294f222,/Users/sanika/Downloads/Master Thesis/repo_updated/pytest/src/_pytest/main.py,3472,ModificationType.MODIFY,712,438,573,51,9,84,763,14,102,71,128,116,199,733.8903537898989,1364.7382180303869,8.784313725490197,11988.28866034536,666.0160366858534,0.45491273934346227
f4734213e5871364894c79f826e268d4b294f222,/Users/sanika/Downloads/Master Thesis/repo_updated/pytest/src/_pytest/mark/evaluate.py,669,ModificationType.MODIFY,125,97,103,3,0,19,128,9,25,17,27,34,44,144.62572975734892,223.84836501501496,4.86,1087.9030539729729,60.43905855405405,0.07461612167167166
f4734213e5871364894c79f826e268d4b294f222,/Users/sanika/Downloads/Master Thesis/repo_updated/pytest/src/_pytest/mark/structures.py,1535,ModificationType.MODIFY,402,202,227,24,74,80,426,12,52,33,61,64,94,339.4424153519907,564.0,7.038461538461538,3969.6923076923076,220.53846153846155,0.188
f4734213e5871364894c79f826e268d4b294f222,/Users/sanika/Downloads/Master Thesis/repo_updated/pytest/testing/test_nodes.py,1701,ModificationType.MODIFY,53,23,39,0,0,13,53,2,8,4,8,10,12,26.0,39.863137138648355,1.0,39.863137138648355,2.2146187299249087,0.013287712379549451
f4734213e5871364894c79f826e268d4b294f222,/Users/sanika/Downloads/Master Thesis/repo_updated/pytest/src/_pytest/nodes.py,1701,ModificationType.MODIFY,515,298,307,33,80,99,548,12,63,44,77,75,121,419.58818518914865,753.6870615500015,7.333333333333333,5527.038451366678,307.0576917425932,0.2512290205166672
f4734213e5871364894c79f826e268d4b294f222,/Users/sanika/Downloads/Master Thesis/repo_updated/pytest/src/_pytest/outcomes.py,572,ModificationType.MODIFY,205,80,86,16,53,53,221,7,18,10,19,25,29,94.71013448036484,134.671829503467,3.6944444444444446,497.5375923322531,27.64097735179184,0.044890609834489
f4734213e5871364894c79f826e268d4b294f222,/Users/sanika/Downloads/Master Thesis/repo_updated/pytest/testing/test_pastebin.py,491,ModificationType.MODIFY,184,100,137,2,15,30,186,6,38,20,39,44,59,214.93102051518318,322.1064654996005,3.0789473684210527,991.7488543014016,55.09715857230009,0.10736882183320018
f4734213e5871364894c79f826e268d4b294f222,/Users/sanika/Downloads/Master Thesis/repo_updated/pytest/src/_pytest/pastebin.py,491,ModificationType.MODIFY,103,65,74,8,5,16,111,7,17,9,17,24,26,89.13835275565901,119.20902501875008,3.5,417.2315875656253,23.17953264253474,0.039736341672916696
f4734213e5871364894c79f826e268d4b294f222,/Users/sanika/Downloads/Master Thesis/repo_updated/pytest/testing/test_pathlib.py,1354,ModificationType.MODIFY,91,45,69,0,3,18,91,3,9,6,10,12,16,33.28421251514428,57.359400011538504,1.6666666666666667,95.59900001923084,5.311055556623936,0.01911980000384617
f4734213e5871364894c79f826e268d4b294f222,/Users/sanika/Downloads/Master Thesis/repo_updated/pytest/src/_pytest/pathlib.py,1354,ModificationType.MODIFY,367,234,237,17,34,68,384,16,55,34,61,71,95,381.9747842438563,584.2259763529448,8.872727272727273,5183.677753822492,287.9820974345829,0.19474199211764828
f4734213e5871364894c79f826e268d4b294f222,/Users/sanika/Downloads/Master Thesis/repo_updated/pytest/testing/test_pytester.py,5908,ModificationType.MODIFY,722,423,573,19,0,135,741,12,172,101,199,184,300,1320.3370878174146,2257.068586817104,6.941860465116279,15668.255189881524,870.4586216600846,0.7523561956057013
f4734213e5871364894c79f826e268d4b294f222,/Users/sanika/Downloads/Master Thesis/repo_updated/pytest/src/_pytest/pytester.py,5908,ModificationType.MODIFY,1508,847,911,44,250,301,1552,14,148,88,169,162,257,1120.302067021891,1886.3414507413484,7.993243243243243,15077.986055587939,837.6658919771077,0.6287804835804495
f4734213e5871364894c79f826e268d4b294f222,/Users/sanika/Downloads/Master Thesis/repo_updated/pytest/doc/en/example/multipython.py,6685,ModificationType.MODIFY,72,33,56,0,4,12,72,1,1,1,1,2,2,0.0,2.0,0.5,1.0,0.05555555555555555,0.0006666666666666666
f4734213e5871364894c79f826e268d4b294f222,/Users/sanika/Downloads/Master Thesis/repo_updated/pytest/src/_pytest/python.py,6685,ModificationType.MODIFY,1454,835,1044,76,110,219,1530,17,275,158,296,292,454,2297.8910156145625,3718.180349731528,9.149090909090908,34017.97003608918,1889.8872242271766,1.2393934499105095
f4734213e5871364894c79f826e268d4b294f222,/Users/sanika/Downloads/Master Thesis/repo_updated/pytest/src/_pytest/python_api.py,1961,ModificationType.MODIFY,757,253,292,73,244,162,830,13,61,38,67,74,105,409.8806939271703,651.9926033910399,7.139344262295082,4654.799652078654,258.5999806710363,0.2173308677970133
f4734213e5871364894c79f826e268d4b294f222,/Users/sanika/Downloads/Master Thesis/repo_updated/pytest/testing/test_recwarn.py,987,ModificationType.MODIFY,386,256,301,16,9,68,402,4,59,35,69,63,104,355.07593991234864,621.6371120439914,2.3389830508474576,1453.9986688486576,80.77770382492542,0.20721237068133044
f4734213e5871364894c79f826e268d4b294f222,/Users/sanika/Downloads/Master Thesis/repo_updated/pytest/src/_pytest/recwarn.py,987,ModificationType.MODIFY,264,131,164,11,41,46,275,6,38,22,40,44,62,214.93102051518318,338.48476035551244,3.1578947368421053,1068.899243227934,59.38329129044078,0.11282825345183747
f4734213e5871364894c79f826e268d4b294f222,/Users/sanika/Downloads/Master Thesis/repo_updated/pytest/testing/test_reports.py,1942,ModificationType.MODIFY,466,257,367,18,25,50,484,7,126,86,171,133,257,898.7887548153927,1813.2075859238057,4.75,8612.736033138077,478.4853351743376,0.6044025286412685
f4734213e5871364894c79f826e268d4b294f222,/Users/sanika/Downloads/Master Thesis/repo_updated/pytest/src/_pytest/reports.py,1942,ModificationType.MODIFY,507,281,342,29,59,88,536,10,53,29,57,63,86,336.79906504072324,514.0460734209928,5.377358490566038,2764.2100174525085,153.56722319180602,0.17134869114033094
f4734213e5871364894c79f826e268d4b294f222,/Users/sanika/Downloads/Master Thesis/repo_updated/pytest/testing/test_runner.py,1918,ModificationType.MODIFY,1043,504,840,53,9,147,1096,9,180,112,198,189,310,1377.0628823523223,2344.2951515085324,4.95,11604.260999967235,644.6811666648464,0.7814317171695108
f4734213e5871364894c79f826e268d4b294f222,/Users/sanika/Downloads/Master Thesis/repo_updated/pytest/src/_pytest/runner.py,1918,ModificationType.MODIFY,383,288,292,26,6,62,409,11,65,38,67,76,105,429.5076556518598,656.0323889115765,5.6692307692307695,3719.199004829476,206.6221669349709,0.2186774629705255
f4734213e5871364894c79f826e268d4b294f222,/Users/sanika/Downloads/Master Thesis/repo_updated/pytest/testing/test_setuponly.py,381,ModificationType.MODIFY,294,64,250,0,0,43,294,1,20,10,20,21,30,86.43856189774725,131.76952268336282,0.5,65.88476134168141,3.6602645189823004,0.04392317422778761
f4734213e5871364894c79f826e268d4b294f222,/Users/sanika/Downloads/Master Thesis/repo_updated/pytest/src/_pytest/setuponly.py,381,ModificationType.MODIFY,78,46,62,3,0,14,81,3,8,4,8,11,12,28.75488750216347,41.51317942364757,1.5,62.26976913547136,3.4594316186372978,0.01383772647454919
f4734213e5871364894c79f826e268d4b294f222,/Users/sanika/Downloads/Master Thesis/repo_updated/pytest/testing/test_stepwise.py,429,ModificationType.MODIFY,219,78,157,11,5,46,230,3,24,20,34,27,54,114.79398751947123,256.76392511682735,2.125,545.6233408732581,30.31240782629212,0.08558797503894246
f4734213e5871364894c79f826e268d4b294f222,/Users/sanika/Downloads/Master Thesis/repo_updated/pytest/src/_pytest/stepwise.py,429,ModificationType.MODIFY,108,64,79,9,0,20,117,5,15,11,19,20,30,70.2129994085646,129.65784284662087,3.1666666666666665,410.5831690142994,22.810176056349967,0.043219280948873624
f4734213e5871364894c79f826e268d4b294f222,/Users/sanika/Downloads/Master Thesis/repo_updated/pytest/testing/test_terminal.py,5905,ModificationType.MODIFY,1943,715,1694,26,18,214,1969,12,185,120,237,197,357,1436.3251202041715,2721.0724995459263,7.686486486486486,20915.486996509768,1161.971499806098,0.9070241665153088
f4734213e5871364894c79f826e268d4b294f222,/Users/sanika/Downloads/Master Thesis/repo_updated/pytest/src/_pytest/terminal.py,5905,ModificationType.MODIFY,1168,838,957,57,25,144,1225,19,348,224,416,367,640,3018.854959310786,5452.5672018196565,11.35632183908046,61921.107993078396,3440.061555171022,1.8175224006065522
f4734213e5871364894c79f826e268d4b294f222,/Users/sanika/Downloads/Master Thesis/repo_updated/pytest/testing/test_unittest.py,1371,ModificationType.MODIFY,1098,241,925,5,10,155,1103,7,46,25,49,53,74,273.7353344330258,423.8661136376768,3.7282608695652173,1580.2834454100341,87.79352474500189,0.14128870454589226
f4734213e5871364894c79f826e268d4b294f222,/Users/sanika/Downloads/Master Thesis/repo_updated/pytest/src/_pytest/unittest.py,1371,ModificationType.MODIFY,282,202,222,14,2,44,296,8,42,24,43,50,67,250.47733175670794,378.1383647149065,4.095238095238095,1548.5666364515218,86.03147980286232,0.1260461215716355
f4734213e5871364894c79f826e268d4b294f222,/Users/sanika/Downloads/Master Thesis/repo_updated/pytest/testing/acceptance_test.py,4688,ModificationType.MODIFY,1289,550,1043,56,32,155,1345,10,167,93,185,177,278,1266.2978977920404,2075.9943429230734,5.538922155688622,11498.771061100855,638.8206145056031,0.6919981143076911
f4734213e5871364894c79f826e268d4b294f222,/Users/sanika/Downloads/Master Thesis/repo_updated/pytest/testing/code/test_code.py,956,ModificationType.MODIFY,182,127,129,0,0,53,182,5,39,21,42,44,63,217.7403270100645,343.9441919741497,2.6923076923076925,926.003593776557,51.44464409869761,0.11464806399138323
f4734213e5871364894c79f826e268d4b294f222,/Users/sanika/Downloads/Master Thesis/repo_updated/pytest/testing/code/test_excinfo.py,7105,ModificationType.MODIFY,1392,870,1177,35,17,170,1427,14,494,280,531,508,811,4473.796381311637,7289.823280972226,7.5242914979757085,54850.755334764704,3047.2641852647057,2.4299410936574084
f4734213e5871364894c79f826e268d4b294f222,/Users/sanika/Downloads/Master Thesis/repo_updated/pytest/testing/conftest.py,386,ModificationType.MODIFY,127,75,83,2,11,30,129,4,14,7,14,18,21,61.30296890880645,87.56842503028855,2.0,175.1368500605771,9.729825003365395,0.029189475010096184
f4734213e5871364894c79f826e268d4b294f222,/Users/sanika/Downloads/Master Thesis/repo_updated/pytest/testing/test_conftest.py,386,ModificationType.MODIFY,652,304,544,16,6,88,668,6,89,51,101,95,152,591.8500503603364,998.6180524663041,3.404494382022472,3399.7895494077547,188.8771971893197,0.3328726841554347
f4734213e5871364894c79f826e268d4b294f222,/Users/sanika/Downloads/Master Thesis/repo_updated/pytest/testing/example_scripts/collect/package_infinite_recursion/conftest.py,386,ModificationType.MODIFY,2,2,2,0,0,0,2,0,0,0,0,0,0,0,0,0,0,0.0,0.0
f4734213e5871364894c79f826e268d4b294f222,/Users/sanika/Downloads/Master Thesis/repo_updated/pytest/testing/example_scripts/conftest_usageerror/conftest.py,386,ModificationType.MODIFY,8,5,5,0,0,3,8,0,0,0,0,0,0,0,0,0,0,0.0,0.0
f4734213e5871364894c79f826e268d4b294f222,/Users/sanika/Downloads/Master Thesis/repo_updated/pytest/testing/example_scripts/marks/marks_considered_keywords/conftest.py,386,ModificationType.MODIFY,0,0,0,0,0,0,0,0,0,0,0,0,0,0,0,0,0,0.0,0.0
f4734213e5871364894c79f826e268d4b294f222,/Users/sanika/Downloads/Master Thesis/repo_updated/pytest/testing/example_scripts/config/collect_pytest_prefix/conftest.py,386,ModificationType.MODIFY,2,2,2,0,0,0,2,0,0,0,0,0,0,0,0,0,0,0.0,0.0
f4734213e5871364894c79f826e268d4b294f222,/Users/sanika/Downloads/Master Thesis/repo_updated/pytest/testing/example_scripts/issue88_initial_file_multinodes/conftest.py,386,ModificationType.MODIFY,14,8,8,0,0,6,14,0,0,0,0,0,0,0,0,0,0,0.0,0.0
f4734213e5871364894c79f826e268d4b294f222,/Users/sanika/Downloads/Master Thesis/repo_updated/pytest/testing/example_scripts/fixtures/fill_fixtures/test_extend_fixture_conftest_conftest/conftest.py,386,ModificationType.MODIFY,6,4,4,0,0,2,6,0,0,0,0,0,0,0,0,0,0,0.0,0.0
f4734213e5871364894c79f826e268d4b294f222,/Users/sanika/Downloads/Master Thesis/repo_updated/pytest/testing/example_scripts/fixtures/fill_fixtures/test_extend_fixture_conftest_conftest/pkg/conftest.py,386,ModificationType.MODIFY,6,4,4,0,0,2,6,1,2,1,2,3,3,2.0,4.754887502163469,0.5,2.3774437510817346,0.1320802083934297,0.0015849625007211565
f4734213e5871364894c79f826e268d4b294f222,/Users/sanika/Downloads/Master Thesis/repo_updated/pytest/testing/example_scripts/fixtures/fill_fixtures/test_extend_fixture_conftest_module/conftest.py,386,ModificationType.MODIFY,6,4,4,0,0,2,6,0,0,0,0,0,0,0,0,0,0,0.0,0.0
f4734213e5871364894c79f826e268d4b294f222,/Users/sanika/Downloads/Master Thesis/repo_updated/pytest/testing/example_scripts/fixtures/fill_fixtures/test_conftest_funcargs_only_available_in_subdir/sub1/conftest.py,386,ModificationType.MODIFY,7,5,5,0,0,2,7,0,0,0,0,0,0,0,0,0,0,0.0,0.0
f4734213e5871364894c79f826e268d4b294f222,/Users/sanika/Downloads/Master Thesis/repo_updated/pytest/testing/example_scripts/fixtures/fill_fixtures/test_conftest_funcargs_only_available_in_subdir/sub2/conftest.py,386,ModificationType.MODIFY,6,4,4,0,0,2,6,0,0,0,0,0,0,0,0,0,0,0.0,0.0
f4734213e5871364894c79f826e268d4b294f222,/Users/sanika/Downloads/Master Thesis/repo_updated/pytest/testing/example_scripts/fixtures/custom_item/conftest.py,386,ModificationType.MODIFY,10,6,6,0,0,4,10,0,0,0,0,0,0,0,0,0,0,0.0,0.0
f4734213e5871364894c79f826e268d4b294f222,/Users/sanika/Downloads/Master Thesis/repo_updated/pytest/doc/en/conftest.py,386,ModificationType.MODIFY,1,1,1,0,0,0,1,0,0,0,0,0,0,0,0,0,0,0.0,0.0
f4734213e5871364894c79f826e268d4b294f222,/Users/sanika/Downloads/Master Thesis/repo_updated/pytest/doc/en/example/conftest.py,386,ModificationType.MODIFY,1,1,1,0,0,0,1,0,0,0,0,0,0,0,0,0,0,0.0,0.0
f4734213e5871364894c79f826e268d4b294f222,/Users/sanika/Downloads/Master Thesis/repo_updated/pytest/doc/en/example/assertion/global_testmodule_config/conftest.py,386,ModificationType.MODIFY,14,10,10,0,0,4,14,1,1,1,1,2,2,0.0,2.0,0.5,1.0,0.05555555555555555,0.0006666666666666666
f4734213e5871364894c79f826e268d4b294f222,/Users/sanika/Downloads/Master Thesis/repo_updated/pytest/doc/en/example/nonpython/conftest.py,386,ModificationType.MODIFY,46,26,30,3,0,12,49,3,6,3,6,9,9,20.264662506490406,28.529325012980813,1.5,42.793987519471216,2.377443751081734,0.009509775004326938
f4734213e5871364894c79f826e268d4b294f222,/Users/sanika/Downloads/Master Thesis/repo_updated/pytest/testing/deprecated_test.py,181,ModificationType.MODIFY,75,38,59,1,3,12,76,2,4,2,4,6,6,10.0,15.509775004326936,1.0,15.509775004326936,0.861654166907052,0.005169925001442312
f4734213e5871364894c79f826e268d4b294f222,/Users/sanika/Downloads/Master Thesis/repo_updated/pytest/testing/logging/test_fixture.py,696,ModificationType.MODIFY,139,89,101,2,0,35,141,7,54,34,62,61,96,330.41540957123055,569.3507844060371,4.018518518518518,2287.9466706687044,127.10814837048358,0.18978359480201235
f4734213e5871364894c79f826e268d4b294f222,/Users/sanika/Downloads/Master Thesis/repo_updated/pytest/testing/logging/test_reporting.py,2589,ModificationType.MODIFY,1157,318,931,29,22,177,1186,6,104,63,125,110,188,712.3555056910004,1274.895626142636,3.605769230769231,4596.97942118739,255.38774562152165,0.424965208714212
f4734213e5871364894c79f826e268d4b294f222,/Users/sanika/Downloads/Master Thesis/repo_updated/pytest/testing/python/collect.py,3928,ModificationType.MODIFY,1338,495,1086,10,64,173,1348,11,122,82,157,133,239,883.6037029876825,1686.2125020847843,7.077868852459017,11934.79094713288,663.0439415073822,0.5620708340282614
f4734213e5871364894c79f826e268d4b294f222,/Users/sanika/Downloads/Master Thesis/repo_updated/pytest/testing/python/fixtures.py,7999,ModificationType.MODIFY,4293,999,3693,19,54,507,4312,9,155,88,170,164,258,1156.3286078304877,1898.248417191466,4.935483870967742,9368.774446138526,520.4874692299181,0.6327494723971553
f4734213e5871364894c79f826e268d4b294f222,/Users/sanika/Downloads/Master Thesis/repo_updated/pytest/src/_pytest/fixtures.py,7999,ModificationType.MODIFY,1482,859,1002,125,135,219,1607,16,219,134,251,235,385,1766.678366052657,3032.459024427525,9.168949771689498,27804.464479682512,1544.692471093473,1.0108196748091751
f4734213e5871364894c79f826e268d4b294f222,/Users/sanika/Downloads/Master Thesis/repo_updated/pytest/testing/python/integration.py,992,ModificationType.MODIFY,465,148,393,5,8,60,470,4,31,20,31,35,51,161.58008562199316,261.5934338641933,2.0,523.1868677283866,29.065937096021475,0.08719781128806443
f4734213e5871364894c79f826e268d4b294f222,/Users/sanika/Downloads/Master Thesis/repo_updated/pytest/testing/example_scripts/acceptance/fixture_mock_integration.py,992,ModificationType.MODIFY,16,12,9,0,0,6,16,1,2,1,2,3,3,2.0,4.754887502163469,0.5,2.3774437510817346,0.1320802083934297,0.0015849625007211565
f4734213e5871364894c79f826e268d4b294f222,/Users/sanika/Downloads/Master Thesis/repo_updated/pytest/testing/python/raises.py,919,ModificationType.MODIFY,256,139,192,9,7,47,265,4,23,12,24,27,36,112.0419249893113,171.1759500778849,2.0869565217391304,357.2367653799337,19.846486965551872,0.05705865002596163
f4734213e5871364894c79f826e268d4b294f222,/Users/sanika/Downloads/Master Thesis/repo_updated/pytest/testing/python/show_fixtures_per_test.py,322,ModificationType.MODIFY,180,34,164,0,0,16,180,1,12,6,12,13,18,43.01955000865388,66.60791492653966,0.5,33.30395746326983,1.8502198590705463,0.022202638308846556
f4734213e5871364894c79f826e268d4b294f222,/Users/sanika/Downloads/Master Thesis/repo_updated/pytest/testing/test_assertion.py,5153,ModificationType.MODIFY,1450,624,1228,12,26,181,1462,14,306,186,354,320,540,2580.063648772758,4493.841171239175,8.098039215686274,36391.30203376038,2021.7390018755768,1.497947057079725
f4734213e5871364894c79f826e268d4b294f222,/Users/sanika/Downloads/Master Thesis/repo_updated/pytest/testing/test_assertrewrite.py,5958,ModificationType.MODIFY,1660,832,1314,41,38,274,1701,20,312,209,395,332,604,2671.484054182769,5058.523816533542,12.66025641025641,64042.2085747035,3557.900476372417,1.6861746055111808
f4734213e5871364894c79f826e268d4b294f222,/Users/sanika/Downloads/Master Thesis/repo_updated/pytest/testing/test_cacheprovider.py,3773,ModificationType.MODIFY,996,429,845,24,10,117,1020,7,76,50,88,83,138,494.49397547611574,879.7554415258757,4.052631578947368,3565.3246840785487,198.07359355991937,0.29325181384195853
f4734213e5871364894c79f826e268d4b294f222,/Users/sanika/Downloads/Master Thesis/repo_updated/pytest/testing/test_capture.py,5064,ModificationType.MODIFY,1513,682,1277,25,13,200,1538,11,199,116,219,210,335,1557.7420472931965,2584.272248418151,6.052763819095477,15641.989563917903,868.9994202176613,0.8614240828060503
f4734213e5871364894c79f826e268d4b294f222,/Users/sanika/Downloads/Master Thesis/repo_updated/pytest/testing/test_collection.py,4935,ModificationType.MODIFY,1296,573,1062,40,33,157,1336,8,201,118,231,209,349,1561.8613899269646,2689.868337096228,4.597014925373134,12365.364892919973,686.9647162733319,0.896622779032076
f4734213e5871364894c79f826e268d4b294f222,/Users/sanika/Downloads/Master Thesis/repo_updated/pytest/testing/test_compat.py,513,ModificationType.MODIFY,207,111,150,11,0,50,218,5,26,19,36,31,55,133.82107314610522,272.4807970712782,3.4615384615384617,943.202759092886,52.40015328293811,0.09082693235709273
f4734213e5871364894c79f826e268d4b294f222,/Users/sanika/Downloads/Master Thesis/repo_updated/pytest/testing/test_config.py,6057,ModificationType.MODIFY,1457,730,1242,11,6,188,1468,10,292,166,329,302,495,2424.648052141839,4078.010345965914,5.633561643835616,22973.722668198385,1276.3179260110214,1.359336781988638
f4734213e5871364894c79f826e268d4b294f222,/Users/sanika/Downloads/Master Thesis/repo_updated/pytest/testing/test_conftest.py,2848,ModificationType.MODIFY,652,304,544,16,6,88,668,6,89,51,101,95,152,591.8500503603364,998.6180524663041,3.404494382022472,3399.7895494077547,188.8771971893197,0.3328726841554347
f4734213e5871364894c79f826e268d4b294f222,/Users/sanika/Downloads/Master Thesis/repo_updated/pytest/testing/test_doctest.py,3714,ModificationType.MODIFY,1455,414,1257,16,76,112,1471,5,41,23,46,46,69,231.26927266377825,381.1257749679339,2.8048780487804876,1069.0113200320097,59.389517779556094,0.1270419249893113
f4734213e5871364894c79f826e268d4b294f222,/Users/sanika/Downloads/Master Thesis/repo_updated/pytest/testing/test_junitxml.py,5657,ModificationType.MODIFY,1523,757,1297,19,12,193,1542,12,193,117,230,205,347,1508.3637582013935,2664.7795945283897,7.150259067357513,19053.864458285894,1058.5480254603274,0.8882598648427965
f4734213e5871364894c79f826e268d4b294f222,/Users/sanika/Downloads/Master Thesis/repo_updated/pytest/testing/test_mark.py,3090,ModificationType.MODIFY,1020,354,843,12,15,144,1032,8,134,77,144,142,221,970.8559515213415,1580.0941134105349,4.298507462686567,6792.0463382422995,377.3359076801278,0.5266980378035117
f4734213e5871364894c79f826e268d4b294f222,/Users/sanika/Downloads/Master Thesis/repo_updated/pytest/testing/test_meta.py,90,ModificationType.ADD,35,12,22,4,5,6,39,1,2,1,2,3,3,2.0,4.754887502163469,0.5,2.3774437510817346,0.1320802083934297,0.0015849625007211565
f4734213e5871364894c79f826e268d4b294f222,/Users/sanika/Downloads/Master Thesis/repo_updated/pytest/testing/test_nose.py,637,ModificationType.MODIFY,424,94,331,4,0,89,428,1,5,5,5,6,10,11.60964047443681,25.84962500721156,0.5,12.92481250360578,0.71804513908921,0.00861654166907052
f4734213e5871364894c79f826e268d4b294f222,/Users/sanika/Downloads/Master Thesis/repo_updated/pytest/testing/test_parseopt.py,2315,ModificationType.MODIFY,334,251,279,10,4,40,344,5,127,74,143,132,217,899.1725956945019,1528.6335239007844,2.8149606299212597,4303.043187358508,239.0579548532504,0.5095445079669282
f4734213e5871364894c79f826e268d4b294f222,/Users/sanika/Downloads/Master Thesis/repo_updated/pytest/testing/test_pastebin.py,697,ModificationType.MODIFY,184,100,137,2,15,30,186,6,38,20,39,44,59,214.93102051518318,322.1064654996005,3.0789473684210527,991.7488543014016,55.09715857230009,0.10736882183320018
f4734213e5871364894c79f826e268d4b294f222,/Users/sanika/Downloads/Master Thesis/repo_updated/pytest/testing/test_pdb.py,4048,ModificationType.MODIFY,1293,570,1093,25,15,163,1318,10,195,123,241,205,364,1516.6486921300477,2795.3307562199825,6.17948717948718,17273.710570487587,959.6505872493103,0.9317769187399941
f4734213e5871364894c79f826e268d4b294f222,/Users/sanika/Downloads/Master Thesis/repo_updated/pytest/testing/test_pytester.py,2994,ModificationType.MODIFY,722,423,573,19,0,135,741,12,172,101,199,184,300,1320.3370878174146,2257.068586817104,6.941860465116279,15668.255189881524,870.4586216600846,0.7523561956057013
f4734213e5871364894c79f826e268d4b294f222,/Users/sanika/Downloads/Master Thesis/repo_updated/pytest/testing/test_reports.py,1843,ModificationType.MODIFY,466,257,367,18,25,50,484,7,126,86,171,133,257,898.7887548153927,1813.2075859238057,4.75,8612.736033138077,478.4853351743376,0.6044025286412685
f4734213e5871364894c79f826e268d4b294f222,/Users/sanika/Downloads/Master Thesis/repo_updated/pytest/testing/test_runner.py,3446,ModificationType.MODIFY,1043,504,840,53,9,147,1096,9,180,112,198,189,310,1377.0628823523223,2344.2951515085324,4.95,11604.260999967235,644.6811666648464,0.7814317171695108
f4734213e5871364894c79f826e268d4b294f222,/Users/sanika/Downloads/Master Thesis/repo_updated/pytest/testing/test_runner_xunit.py,463,ModificationType.MODIFY,295,56,236,0,4,54,295,2,9,5,10,11,15,30.529325012980813,51.89147427955947,1.1111111111111112,57.65719364395497,3.203177424664165,0.01729715809318649
f4734213e5871364894c79f826e268d4b294f222,/Users/sanika/Downloads/Master Thesis/repo_updated/pytest/testing/test_setuponly.py,572,ModificationType.RENAME,294,64,250,0,0,43,294,1,20,10,20,21,30,86.43856189774725,131.76952268336282,0.5,65.88476134168141,3.6602645189823004,0.04392317422778761
f4734213e5871364894c79f826e268d4b294f222,/Users/sanika/Downloads/Master Thesis/repo_updated/pytest/testing/test_setupplan.py,43,ModificationType.RENAME,110,30,77,3,13,16,113,4,21,15,30,25,45,100.23866587835397,208.9735285398626,2.857142857142857,597.0672243996074,33.17040135553375,0.06965784284662087
f4734213e5871364894c79f826e268d4b294f222,/Users/sanika/Downloads/Master Thesis/repo_updated/pytest/testing/test_skipping.py,3068,ModificationType.MODIFY,1178,367,1042,6,15,115,1184,9,94,51,95,103,146,644.6606770706787,976.22907696875,4.547872340425532,4439.7652170653255,246.65362317029587,0.32540969232291667
f4734213e5871364894c79f826e268d4b294f222,/Users/sanika/Downloads/Master Thesis/repo_updated/pytest/testing/test_stepwise.py,645,ModificationType.MODIFY,219,78,157,11,5,46,230,3,24,20,34,27,54,114.79398751947123,256.76392511682735,2.125,545.6233408732581,30.31240782629212,0.08558797503894246
f4734213e5871364894c79f826e268d4b294f222,/Users/sanika/Downloads/Master Thesis/repo_updated/pytest/testing/test_terminal.py,6100,ModificationType.MODIFY,1943,715,1694,26,18,214,1969,12,185,120,237,197,357,1436.3251202041715,2721.0724995459263,7.686486486486486,20915.486996509768,1161.971499806098,0.9070241665153088
f4734213e5871364894c79f826e268d4b294f222,/Users/sanika/Downloads/Master Thesis/repo_updated/pytest/testing/test_tmpdir.py,1770,ModificationType.MODIFY,442,244,305,14,16,103,456,11,68,45,75,79,120,452.0012210100334,756.4536897812524,6.0661764705882355,4588.781574040686,254.932309668927,0.2521512299270841
f4734213e5871364894c79f826e268d4b294f222,/Users/sanika/Downloads/Master Thesis/repo_updated/pytest/testing/test_unittest.py,2040,ModificationType.MODIFY,1098,241,925,5,10,155,1103,7,46,25,49,53,74,273.7353344330258,423.8661136376768,3.7282608695652173,1580.2834454100341,87.79352474500189,0.14128870454589226
f4734213e5871364894c79f826e268d4b294f222,/Users/sanika/Downloads/Master Thesis/repo_updated/pytest/testing/test_warnings.py,1706,ModificationType.MODIFY,601,196,481,2,23,85,603,8,63,36,72,71,108,400.56863518049477,664.1726889065056,4.571428571428571,3036.21800642974,168.67877813498555,0.22139089630216854
82e9013e73ca6da796ff85627875936887ba213e,/Users/sanika/Downloads/Master Thesis/repo_updated/pytest/testing/test_cacheprovider.py,2024,ModificationType.MODIFY,996,429,845,24,10,117,1020,7,76,50,88,83,138,494.49397547611574,879.7554415258757,4.052631578947368,3565.3246840785487,198.07359355991937,0.29325181384195853
82e9013e73ca6da796ff85627875936887ba213e,/Users/sanika/Downloads/Master Thesis/repo_updated/pytest/src/_pytest/cacheprovider.py,2024,ModificationType.MODIFY,456,277,329,12,42,72,468,13,85,50,97,98,147,592.903945907539,972.3623470849358,7.41764705882353,7212.640703965318,400.70226133140653,0.32412078236164527
82e9013e73ca6da796ff85627875936887ba213e,/Users/sanika/Downloads/Master Thesis/repo_updated/pytest/testing/test_cacheprovider.py,3806,ModificationType.MODIFY,996,429,845,24,10,117,1020,7,76,50,88,83,138,494.49397547611574,879.7554415258757,4.052631578947368,3565.3246840785487,198.07359355991937,0.29325181384195853
8683293031afd812f23c7bfe5e6ddcc9ef092b00,/Users/sanika/Downloads/Master Thesis/repo_updated/pytest/testing/test_capture.py,3433,ModificationType.MODIFY,1513,682,1277,25,13,200,1538,11,199,116,219,210,335,1557.7420472931965,2584.272248418151,6.052763819095477,15641.989563917903,868.9994202176613,0.8614240828060503
8683293031afd812f23c7bfe5e6ddcc9ef092b00,/Users/sanika/Downloads/Master Thesis/repo_updated/pytest/src/_pytest/capture.py,3433,ModificationType.MODIFY,819,519,539,24,98,155,843,15,96,57,106,111,163,690.7597590033588,1107.4897862150674,8.28125,9171.399792093527,509.52221067186264,0.36916326207168915
98fc9377d93771c8b877d37c812d10bd789396e0,/Users/sanika/Downloads/Master Thesis/repo_updated/pytest/testing/test_doctest.py,2603,ModificationType.MODIFY,1455,414,1257,16,76,112,1471,5,41,23,46,46,69,231.26927266377825,381.1257749679339,2.8048780487804876,1069.0113200320097,59.389517779556094,0.1270419249893113
98fc9377d93771c8b877d37c812d10bd789396e0,/Users/sanika/Downloads/Master Thesis/repo_updated/pytest/src/_pytest/doctest.py,2603,ModificationType.MODIFY,669,365,481,22,61,110,691,15,103,63,122,118,185,747.3129132339992,1273.2889641319407,8.883495145631068,11311.256331851706,628.403129547317,0.4244296547106469
98fc9377d93771c8b877d37c812d10bd789396e0,/Users/sanika/Downloads/Master Thesis/repo_updated/pytest/testing/test_pdb.py,4048,ModificationType.MODIFY,1293,570,1093,25,15,163,1318,10,195,123,241,205,364,1516.6486921300477,2795.3307562199825,6.17948717948718,17273.710570487587,959.6505872493103,0.9317769187399941
215be88fed6816db31cd57e638804c69caab423a,/Users/sanika/Downloads/Master Thesis/repo_updated/pytest/testing/test_setuponly.py,378,ModificationType.MODIFY,294,64,250,0,0,43,294,1,20,10,20,21,30,86.43856189774725,131.76952268336282,0.5,65.88476134168141,3.6602645189823004,0.04392317422778761
215be88fed6816db31cd57e638804c69caab423a,/Users/sanika/Downloads/Master Thesis/repo_updated/pytest/src/_pytest/setuponly.py,378,ModificationType.MODIFY,78,46,62,3,0,14,81,3,8,4,8,11,12,28.75488750216347,41.51317942364757,1.5,62.26976913547136,3.4594316186372978,0.01383772647454919
215be88fed6816db31cd57e638804c69caab423a,/Users/sanika/Downloads/Master Thesis/repo_updated/pytest/testing/test_warnings.py,615,ModificationType.MODIFY,601,196,481,2,23,85,603,8,63,36,72,71,108,400.56863518049477,664.1726889065056,4.571428571428571,3036.21800642974,168.67877813498555,0.22139089630216854
215be88fed6816db31cd57e638804c69caab423a,/Users/sanika/Downloads/Master Thesis/repo_updated/pytest/src/_pytest/warnings.py,615,ModificationType.MODIFY,156,79,106,5,16,28,161,5,14,8,15,19,23,64.91260938324326,97.70233280920246,2.6785714285714284,261.7026771675066,14.539037620417032,0.03256744426973415
bae22e1fdd57b33d118d1912878466360477fc1b,/Users/sanika/Downloads/Master Thesis/repo_updated/pytest/testing/test_pytester.py,5898,ModificationType.MODIFY,722,423,573,19,0,135,741,12,172,101,199,184,300,1320.3370878174146,2257.068586817104,6.941860465116279,15668.255189881524,870.4586216600846,0.7523561956057013
bae22e1fdd57b33d118d1912878466360477fc1b,/Users/sanika/Downloads/Master Thesis/repo_updated/pytest/src/_pytest/pytester.py,5898,ModificationType.MODIFY,1508,847,911,44,250,301,1552,14,148,88,169,162,257,1120.302067021891,1886.3414507413484,7.993243243243243,15077.986055587939,837.6658919771077,0.6287804835804495
5e7b2ae704da84db5e9d4a786ebe1efe1997f9ff,/Users/sanika/Downloads/Master Thesis/repo_updated/pytest/testing/test_doctest.py,2613,ModificationType.MODIFY,1455,414,1257,16,76,112,1471,5,41,23,46,46,69,231.26927266377825,381.1257749679339,2.8048780487804876,1069.0113200320097,59.389517779556094,0.1270419249893113
5e7b2ae704da84db5e9d4a786ebe1efe1997f9ff,/Users/sanika/Downloads/Master Thesis/repo_updated/pytest/src/_pytest/doctest.py,2613,ModificationType.MODIFY,669,365,481,22,61,110,691,15,103,63,122,118,185,747.3129132339992,1273.2889641319407,8.883495145631068,11311.256331851706,628.403129547317,0.4244296547106469
5e7b2ae704da84db5e9d4a786ebe1efe1997f9ff,/Users/sanika/Downloads/Master Thesis/repo_updated/pytest/testing/acceptance_test.py,4670,ModificationType.MODIFY,1289,550,1043,56,32,155,1345,10,167,93,185,177,278,1266.2978977920404,2075.9943429230734,5.538922155688622,11498.771061100855,638.8206145056031,0.6919981143076911
4af89bba9d9df9f5548f5ac06fd59b40c5a8350f,/Users/sanika/Downloads/Master Thesis/repo_updated/pytest/testing/test_terminal.py,6093,ModificationType.MODIFY,1943,715,1694,26,18,214,1969,12,185,120,237,197,357,1436.3251202041715,2721.0724995459263,7.686486486486486,20915.486996509768,1161.971499806098,0.9070241665153088
4af89bba9d9df9f5548f5ac06fd59b40c5a8350f,/Users/sanika/Downloads/Master Thesis/repo_updated/pytest/src/_pytest/terminal.py,6093,ModificationType.MODIFY,1168,838,957,57,25,144,1225,19,348,224,416,367,640,3018.854959310786,5452.5672018196565,11.35632183908046,61921.107993078396,3440.061555171022,1.8175224006065522
4af89bba9d9df9f5548f5ac06fd59b40c5a8350f,/Users/sanika/Downloads/Master Thesis/repo_updated/pytest/testing/test_pdb.py,4048,ModificationType.MODIFY,1293,570,1093,25,15,163,1318,10,195,123,241,205,364,1516.6486921300477,2795.3307562199825,6.17948717948718,17273.710570487587,959.6505872493103,0.9317769187399941
4af89bba9d9df9f5548f5ac06fd59b40c5a8350f,/Users/sanika/Downloads/Master Thesis/repo_updated/pytest/testing/test_terminal.py,6632,ModificationType.MODIFY,1943,715,1694,26,18,214,1969,12,185,120,237,197,357,1436.3251202041715,2721.0724995459263,7.686486486486486,20915.486996509768,1161.971499806098,0.9070241665153088
b079dc2dbeb5f117de8c18e41a25cf44531f6bb2,/Users/sanika/Downloads/Master Thesis/repo_updated/pytest/testing/test_pdb.py,4048,ModificationType.MODIFY,1293,570,1093,25,15,163,1318,10,195,123,241,205,364,1516.6486921300477,2795.3307562199825,6.17948717948718,17273.710570487587,959.6505872493103,0.9317769187399941
f0c2b070c5be690ab2285f44cae51b521cf53e52,/Users/sanika/Downloads/Master Thesis/repo_updated/pytest/testing/test_pdb.py,4048,ModificationType.MODIFY,1293,570,1093,25,15,163,1318,10,195,123,241,205,364,1516.6486921300477,2795.3307562199825,6.17948717948718,17273.710570487587,959.6505872493103,0.9317769187399941
046aa0b6e93db59dbb67f6909415215d038fd02b,/Users/sanika/Downloads/Master Thesis/repo_updated/pytest/testing/example_scripts/collect/package_infinite_recursion/__init__.pyi,5069,ModificationType.MODIFY,0,0,0,0,0,0,0,0,0,0,0,0,0,0,0,0,0,0.0,0.0
046aa0b6e93db59dbb67f6909415215d038fd02b,/Users/sanika/Downloads/Master Thesis/repo_updated/pytest/testing/example_scripts/collect/package_infinite_recursion/tests/__init__.py,5069,ModificationType.MODIFY,0,0,0,0,0,0,0,0,0,0,0,0,0,0,0,0,0,0.0,0.0
046aa0b6e93db59dbb67f6909415215d038fd02b,/Users/sanika/Downloads/Master Thesis/repo_updated/pytest/testing/example_scripts/collect/collect_init_tests/tests/__init__.py,5069,ModificationType.MODIFY,2,2,2,0,0,0,2,0,0,0,0,0,0,0,0,0,0,0.0,0.0
046aa0b6e93db59dbb67f6909415215d038fd02b,/Users/sanika/Downloads/Master Thesis/repo_updated/pytest/testing/example_scripts/collect/package_init_given_as_arg/pkg/__init__.py,5069,ModificationType.MODIFY,0,0,0,0,0,0,0,0,0,0,0,0,0,0,0,0,0,0.0,0.0
046aa0b6e93db59dbb67f6909415215d038fd02b,/Users/sanika/Downloads/Master Thesis/repo_updated/pytest/testing/example_scripts/conftest_usageerror/__init__.pyi,5069,ModificationType.MODIFY,0,0,0,0,0,0,0,0,0,0,0,0,0,0,0,0,0,0.0,0.0
046aa0b6e93db59dbb67f6909415215d038fd02b,/Users/sanika/Downloads/Master Thesis/repo_updated/pytest/testing/example_scripts/marks/marks_considered_keywords/__init__.pyi,5069,ModificationType.MODIFY,0,0,0,0,0,0,0,0,0,0,0,0,0,0,0,0,0,0.0,0.0
046aa0b6e93db59dbb67f6909415215d038fd02b,/Users/sanika/Downloads/Master Thesis/repo_updated/pytest/testing/example_scripts/config/collect_pytest_prefix/__init__.pyi,5069,ModificationType.MODIFY,0,0,0,0,0,0,0,0,0,0,0,0,0,0,0,0,0,0.0,0.0
046aa0b6e93db59dbb67f6909415215d038fd02b,/Users/sanika/Downloads/Master Thesis/repo_updated/pytest/testing/example_scripts/issue88_initial_file_multinodes/__init__.pyi,5069,ModificationType.MODIFY,0,0,0,0,0,0,0,0,0,0,0,0,0,0,0,0,0,0.0,0.0
046aa0b6e93db59dbb67f6909415215d038fd02b,/Users/sanika/Downloads/Master Thesis/repo_updated/pytest/testing/example_scripts/fixtures/fill_fixtures/test_extend_fixture_conftest_conftest/__init__.pyi,5069,ModificationType.MODIFY,0,0,0,0,0,0,0,0,0,0,0,0,0,0,0,0,0,0.0,0.0
046aa0b6e93db59dbb67f6909415215d038fd02b,/Users/sanika/Downloads/Master Thesis/repo_updated/pytest/testing/example_scripts/fixtures/fill_fixtures/test_extend_fixture_conftest_conftest/pkg/__init__.py,5069,ModificationType.MODIFY,0,0,0,0,0,0,0,0,0,0,0,0,0,0,0,0,0,0.0,0.0
046aa0b6e93db59dbb67f6909415215d038fd02b,/Users/sanika/Downloads/Master Thesis/repo_updated/pytest/testing/example_scripts/fixtures/fill_fixtures/test_extend_fixture_conftest_module/__init__.pyi,5069,ModificationType.MODIFY,0,0,0,0,0,0,0,0,0,0,0,0,0,0,0,0,0,0.0,0.0
046aa0b6e93db59dbb67f6909415215d038fd02b,/Users/sanika/Downloads/Master Thesis/repo_updated/pytest/testing/example_scripts/fixtures/fill_fixtures/test_conftest_funcargs_only_available_in_subdir/sub1/__init__.py,5069,ModificationType.MODIFY,0,0,0,0,0,0,0,0,0,0,0,0,0,0,0,0,0,0.0,0.0
046aa0b6e93db59dbb67f6909415215d038fd02b,/Users/sanika/Downloads/Master Thesis/repo_updated/pytest/testing/example_scripts/fixtures/fill_fixtures/test_conftest_funcargs_only_available_in_subdir/sub2/__init__.py,5069,ModificationType.MODIFY,0,0,0,0,0,0,0,0,0,0,0,0,0,0,0,0,0,0.0,0.0
046aa0b6e93db59dbb67f6909415215d038fd02b,/Users/sanika/Downloads/Master Thesis/repo_updated/pytest/testing/example_scripts/fixtures/custom_item/__init__.pyi,5069,ModificationType.MODIFY,0,0,0,0,0,0,0,0,0,0,0,0,0,0,0,0,0,0.0,0.0
046aa0b6e93db59dbb67f6909415215d038fd02b,/Users/sanika/Downloads/Master Thesis/repo_updated/pytest/testing/example_scripts/fixtures/custom_item/foo/__init__.py,5069,ModificationType.MODIFY,0,0,0,0,0,0,0,0,0,0,0,0,0,0,0,0,0,0.0,0.0
046aa0b6e93db59dbb67f6909415215d038fd02b,/Users/sanika/Downloads/Master Thesis/repo_updated/pytest/doc/en/example/nonpython/__init__.py,5069,ModificationType.MODIFY,0,0,0,0,0,0,0,0,0,0,0,0,0,0,0,0,0,0.0,0.0
046aa0b6e93db59dbb67f6909415215d038fd02b,/Users/sanika/Downloads/Master Thesis/repo_updated/pytest/src/pytest/__init__.py,5069,ModificationType.MODIFY,99,48,90,1,3,5,100,0,0,0,0,0,0,0,0,0,0,0.0,0.0
046aa0b6e93db59dbb67f6909415215d038fd02b,/Users/sanika/Downloads/Master Thesis/repo_updated/pytest/src/_pytest/__init__.py,5069,ModificationType.MODIFY,8,5,5,2,0,1,10,0,0,0,0,0,0,0,0,0,0,0.0,0.0
046aa0b6e93db59dbb67f6909415215d038fd02b,/Users/sanika/Downloads/Master Thesis/repo_updated/pytest/src/_pytest/config/__init__.py,5069,ModificationType.MODIFY,1217,716,841,84,126,174,1301,14,185,118,215,199,333,1446.608539104324,2542.995998641035,8.135135135135135,20687.616097052745,1149.3120053918192,0.847665332880345
046aa0b6e93db59dbb67f6909415215d038fd02b,/Users/sanika/Downloads/Master Thesis/repo_updated/pytest/src/_pytest/mark/__init__.py,5069,ModificationType.MODIFY,160,89,115,0,13,31,160,7,15,11,17,22,28,78.25484338853101,124.86408532184433,3.966666666666667,495.2942051099825,27.51634472833236,0.04162136177394811
046aa0b6e93db59dbb67f6909415215d038fd02b,/Users/sanika/Downloads/Master Thesis/repo_updated/pytest/src/_pytest/_code/__init__.py,5069,ModificationType.MODIFY,10,10,9,9,0,0,19,0,0,0,0,0,0,0,0,0,0,0.0,0.0
046aa0b6e93db59dbb67f6909415215d038fd02b,/Users/sanika/Downloads/Master Thesis/repo_updated/pytest/src/_pytest/assertion/__init__.py,5069,ModificationType.MODIFY,173,84,99,8,29,36,181,5,12,7,13,17,20,54.62919048309069,81.7492568250068,2.7083333333333335,221.4042372343934,12.300235401910745,0.027249752275002266
046aa0b6e93db59dbb67f6909415215d038fd02b,/Users/sanika/Downloads/Master Thesis/repo_updated/pytest/src/_pytest/_io/__init__.py,5069,ModificationType.MODIFY,3,1,1,3,0,0,6,0,0,0,0,0,0,0,0,0,0,0.0,0.0
2f589a9769e12e71253624372e7eeb7076b7549b,/Users/sanika/Downloads/Master Thesis/repo_updated/pytest/testing/test_pytester.py,5896,ModificationType.MODIFY,722,423,573,19,0,135,741,12,172,101,199,184,300,1320.3370878174146,2257.068586817104,6.941860465116279,15668.255189881524,870.4586216600846,0.7523561956057013
2f589a9769e12e71253624372e7eeb7076b7549b,/Users/sanika/Downloads/Master Thesis/repo_updated/pytest/src/_pytest/pytester.py,5896,ModificationType.MODIFY,1508,847,911,44,250,301,1552,14,148,88,169,162,257,1120.302067021891,1886.3414507413484,7.993243243243243,15077.986055587939,837.6658919771077,0.6287804835804495
2f589a9769e12e71253624372e7eeb7076b7549b,/Users/sanika/Downloads/Master Thesis/repo_updated/pytest/testing/test_config.py,6056,ModificationType.MODIFY,1457,730,1242,11,6,188,1468,10,292,166,329,302,495,2424.648052141839,4078.010345965914,5.633561643835616,22973.722668198385,1276.3179260110214,1.359336781988638
2f589a9769e12e71253624372e7eeb7076b7549b,/Users/sanika/Downloads/Master Thesis/repo_updated/pytest/testing/test_runner.py,3442,ModificationType.MODIFY,1043,504,840,53,9,147,1096,9,180,112,198,189,310,1377.0628823523223,2344.2951515085324,4.95,11604.260999967235,644.6811666648464,0.7814317171695108
c71a2c9f80c230cd1dd4813d833db92fb88c2b60,/Users/sanika/Downloads/Master Thesis/repo_updated/pytest/testing/example_scripts/collect/package_infinite_recursion/__init__.pyi,5069,ModificationType.MODIFY,0,0,0,0,0,0,0,0,0,0,0,0,0,0,0,0,0,0.0,0.0
c71a2c9f80c230cd1dd4813d833db92fb88c2b60,/Users/sanika/Downloads/Master Thesis/repo_updated/pytest/testing/example_scripts/collect/package_infinite_recursion/tests/__init__.py,5069,ModificationType.MODIFY,0,0,0,0,0,0,0,0,0,0,0,0,0,0,0,0,0,0.0,0.0
c71a2c9f80c230cd1dd4813d833db92fb88c2b60,/Users/sanika/Downloads/Master Thesis/repo_updated/pytest/testing/example_scripts/collect/collect_init_tests/tests/__init__.py,5069,ModificationType.MODIFY,2,2,2,0,0,0,2,0,0,0,0,0,0,0,0,0,0,0.0,0.0
c71a2c9f80c230cd1dd4813d833db92fb88c2b60,/Users/sanika/Downloads/Master Thesis/repo_updated/pytest/testing/example_scripts/collect/package_init_given_as_arg/pkg/__init__.py,5069,ModificationType.MODIFY,0,0,0,0,0,0,0,0,0,0,0,0,0,0,0,0,0,0.0,0.0
c71a2c9f80c230cd1dd4813d833db92fb88c2b60,/Users/sanika/Downloads/Master Thesis/repo_updated/pytest/testing/example_scripts/conftest_usageerror/__init__.pyi,5069,ModificationType.MODIFY,0,0,0,0,0,0,0,0,0,0,0,0,0,0,0,0,0,0.0,0.0
c71a2c9f80c230cd1dd4813d833db92fb88c2b60,/Users/sanika/Downloads/Master Thesis/repo_updated/pytest/testing/example_scripts/marks/marks_considered_keywords/__init__.pyi,5069,ModificationType.MODIFY,0,0,0,0,0,0,0,0,0,0,0,0,0,0,0,0,0,0.0,0.0
c71a2c9f80c230cd1dd4813d833db92fb88c2b60,/Users/sanika/Downloads/Master Thesis/repo_updated/pytest/testing/example_scripts/config/collect_pytest_prefix/__init__.pyi,5069,ModificationType.MODIFY,0,0,0,0,0,0,0,0,0,0,0,0,0,0,0,0,0,0.0,0.0
c71a2c9f80c230cd1dd4813d833db92fb88c2b60,/Users/sanika/Downloads/Master Thesis/repo_updated/pytest/testing/example_scripts/issue88_initial_file_multinodes/__init__.pyi,5069,ModificationType.MODIFY,0,0,0,0,0,0,0,0,0,0,0,0,0,0,0,0,0,0.0,0.0
c71a2c9f80c230cd1dd4813d833db92fb88c2b60,/Users/sanika/Downloads/Master Thesis/repo_updated/pytest/testing/example_scripts/fixtures/fill_fixtures/test_extend_fixture_conftest_conftest/__init__.pyi,5069,ModificationType.MODIFY,0,0,0,0,0,0,0,0,0,0,0,0,0,0,0,0,0,0.0,0.0
c71a2c9f80c230cd1dd4813d833db92fb88c2b60,/Users/sanika/Downloads/Master Thesis/repo_updated/pytest/testing/example_scripts/fixtures/fill_fixtures/test_extend_fixture_conftest_conftest/pkg/__init__.py,5069,ModificationType.MODIFY,0,0,0,0,0,0,0,0,0,0,0,0,0,0,0,0,0,0.0,0.0
c71a2c9f80c230cd1dd4813d833db92fb88c2b60,/Users/sanika/Downloads/Master Thesis/repo_updated/pytest/testing/example_scripts/fixtures/fill_fixtures/test_extend_fixture_conftest_module/__init__.pyi,5069,ModificationType.MODIFY,0,0,0,0,0,0,0,0,0,0,0,0,0,0,0,0,0,0.0,0.0
c71a2c9f80c230cd1dd4813d833db92fb88c2b60,/Users/sanika/Downloads/Master Thesis/repo_updated/pytest/testing/example_scripts/fixtures/fill_fixtures/test_conftest_funcargs_only_available_in_subdir/sub1/__init__.py,5069,ModificationType.MODIFY,0,0,0,0,0,0,0,0,0,0,0,0,0,0,0,0,0,0.0,0.0
c71a2c9f80c230cd1dd4813d833db92fb88c2b60,/Users/sanika/Downloads/Master Thesis/repo_updated/pytest/testing/example_scripts/fixtures/fill_fixtures/test_conftest_funcargs_only_available_in_subdir/sub2/__init__.py,5069,ModificationType.MODIFY,0,0,0,0,0,0,0,0,0,0,0,0,0,0,0,0,0,0.0,0.0
c71a2c9f80c230cd1dd4813d833db92fb88c2b60,/Users/sanika/Downloads/Master Thesis/repo_updated/pytest/testing/example_scripts/fixtures/custom_item/__init__.pyi,5069,ModificationType.MODIFY,0,0,0,0,0,0,0,0,0,0,0,0,0,0,0,0,0,0.0,0.0
c71a2c9f80c230cd1dd4813d833db92fb88c2b60,/Users/sanika/Downloads/Master Thesis/repo_updated/pytest/testing/example_scripts/fixtures/custom_item/foo/__init__.py,5069,ModificationType.MODIFY,0,0,0,0,0,0,0,0,0,0,0,0,0,0,0,0,0,0.0,0.0
c71a2c9f80c230cd1dd4813d833db92fb88c2b60,/Users/sanika/Downloads/Master Thesis/repo_updated/pytest/doc/en/example/nonpython/__init__.py,5069,ModificationType.MODIFY,0,0,0,0,0,0,0,0,0,0,0,0,0,0,0,0,0,0.0,0.0
c71a2c9f80c230cd1dd4813d833db92fb88c2b60,/Users/sanika/Downloads/Master Thesis/repo_updated/pytest/src/pytest/__init__.py,5069,ModificationType.MODIFY,99,48,90,1,3,5,100,0,0,0,0,0,0,0,0,0,0,0.0,0.0
c71a2c9f80c230cd1dd4813d833db92fb88c2b60,/Users/sanika/Downloads/Master Thesis/repo_updated/pytest/src/_pytest/__init__.py,5069,ModificationType.MODIFY,8,5,5,2,0,1,10,0,0,0,0,0,0,0,0,0,0,0.0,0.0
c71a2c9f80c230cd1dd4813d833db92fb88c2b60,/Users/sanika/Downloads/Master Thesis/repo_updated/pytest/src/_pytest/config/__init__.py,5069,ModificationType.MODIFY,1217,716,841,84,126,174,1301,14,185,118,215,199,333,1446.608539104324,2542.995998641035,8.135135135135135,20687.616097052745,1149.3120053918192,0.847665332880345
c71a2c9f80c230cd1dd4813d833db92fb88c2b60,/Users/sanika/Downloads/Master Thesis/repo_updated/pytest/src/_pytest/mark/__init__.py,5069,ModificationType.MODIFY,160,89,115,0,13,31,160,7,15,11,17,22,28,78.25484338853101,124.86408532184433,3.966666666666667,495.2942051099825,27.51634472833236,0.04162136177394811
c71a2c9f80c230cd1dd4813d833db92fb88c2b60,/Users/sanika/Downloads/Master Thesis/repo_updated/pytest/src/_pytest/_code/__init__.py,5069,ModificationType.MODIFY,10,10,9,9,0,0,19,0,0,0,0,0,0,0,0,0,0,0.0,0.0
c71a2c9f80c230cd1dd4813d833db92fb88c2b60,/Users/sanika/Downloads/Master Thesis/repo_updated/pytest/src/_pytest/assertion/__init__.py,5069,ModificationType.MODIFY,173,84,99,8,29,36,181,5,12,7,13,17,20,54.62919048309069,81.7492568250068,2.7083333333333335,221.4042372343934,12.300235401910745,0.027249752275002266
c71a2c9f80c230cd1dd4813d833db92fb88c2b60,/Users/sanika/Downloads/Master Thesis/repo_updated/pytest/src/_pytest/_io/__init__.py,5069,ModificationType.MODIFY,3,1,1,3,0,0,6,0,0,0,0,0,0,0,0,0,0,0.0,0.0
52b85f6f1ae44bb35c0292817696daf092858b98,/Users/sanika/Downloads/Master Thesis/repo_updated/pytest/testing/test_recwarn.py,983,ModificationType.MODIFY,386,256,301,16,9,68,402,4,59,35,69,63,104,355.07593991234864,621.6371120439914,2.3389830508474576,1453.9986688486576,80.77770382492542,0.20721237068133044
52b85f6f1ae44bb35c0292817696daf092858b98,/Users/sanika/Downloads/Master Thesis/repo_updated/pytest/src/_pytest/recwarn.py,983,ModificationType.MODIFY,264,131,164,11,41,46,275,6,38,22,40,44,62,214.93102051518318,338.48476035551244,3.1578947368421053,1068.899243227934,59.38329129044078,0.11282825345183747
1371b01f78afcfb836ef21a81cdb9b6516c1119e,/Users/sanika/Downloads/Master Thesis/repo_updated/pytest/testing/test_doctest.py,2626,ModificationType.MODIFY,1455,414,1257,16,76,112,1471,5,41,23,46,46,69,231.26927266377825,381.1257749679339,2.8048780487804876,1069.0113200320097,59.389517779556094,0.1270419249893113
1371b01f78afcfb836ef21a81cdb9b6516c1119e,/Users/sanika/Downloads/Master Thesis/repo_updated/pytest/src/_pytest/doctest.py,2626,ModificationType.MODIFY,669,365,481,22,61,110,691,15,103,63,122,118,185,747.3129132339992,1273.2889641319407,8.883495145631068,11311.256331851706,628.403129547317,0.4244296547106469
db9e248b2edef4bb872858d267697e0e59fc13ac,/Users/sanika/Downloads/Master Thesis/repo_updated/pytest/testing/test_doctest.py,2613,ModificationType.MODIFY,1455,414,1257,16,76,112,1471,5,41,23,46,46,69,231.26927266377825,381.1257749679339,2.8048780487804876,1069.0113200320097,59.389517779556094,0.1270419249893113
db9e248b2edef4bb872858d267697e0e59fc13ac,/Users/sanika/Downloads/Master Thesis/repo_updated/pytest/src/_pytest/doctest.py,2613,ModificationType.MODIFY,669,365,481,22,61,110,691,15,103,63,122,118,185,747.3129132339992,1273.2889641319407,8.883495145631068,11311.256331851706,628.403129547317,0.4244296547106469
db9e248b2edef4bb872858d267697e0e59fc13ac,/Users/sanika/Downloads/Master Thesis/repo_updated/pytest/testing/acceptance_test.py,4670,ModificationType.MODIFY,1289,550,1043,56,32,155,1345,10,167,93,185,177,278,1266.2978977920404,2075.9943429230734,5.538922155688622,11498.771061100855,638.8206145056031,0.6919981143076911
b30e7bd1de30c561540c8de605a2a1f47e175b23,/Users/sanika/Downloads/Master Thesis/repo_updated/pytest/testing/test_doctest.py,2636,ModificationType.MODIFY,1455,414,1257,16,76,112,1471,5,41,23,46,46,69,231.26927266377825,381.1257749679339,2.8048780487804876,1069.0113200320097,59.389517779556094,0.1270419249893113
b30e7bd1de30c561540c8de605a2a1f47e175b23,/Users/sanika/Downloads/Master Thesis/repo_updated/pytest/src/_pytest/doctest.py,2636,ModificationType.MODIFY,669,365,481,22,61,110,691,15,103,63,122,118,185,747.3129132339992,1273.2889641319407,8.883495145631068,11311.256331851706,628.403129547317,0.4244296547106469
3246d8a6e9c5ea398df3470401cc8b7f59b2f525,/Users/sanika/Downloads/Master Thesis/repo_updated/pytest/testing/test_recwarn.py,983,ModificationType.MODIFY,386,256,301,16,9,68,402,4,59,35,69,63,104,355.07593991234864,621.6371120439914,2.3389830508474576,1453.9986688486576,80.77770382492542,0.20721237068133044
3246d8a6e9c5ea398df3470401cc8b7f59b2f525,/Users/sanika/Downloads/Master Thesis/repo_updated/pytest/src/_pytest/recwarn.py,983,ModificationType.MODIFY,264,131,164,11,41,46,275,6,38,22,40,44,62,214.93102051518318,338.48476035551244,3.1578947368421053,1068.899243227934,59.38329129044078,0.11282825345183747
1984c10427adc264d7cdd1bedbb315792181c14b,/Users/sanika/Downloads/Master Thesis/repo_updated/pytest/testing/test_doctest.py,2720,ModificationType.MODIFY,1455,414,1257,16,76,112,1471,5,41,23,46,46,69,231.26927266377825,381.1257749679339,2.8048780487804876,1069.0113200320097,59.389517779556094,0.1270419249893113
1984c10427adc264d7cdd1bedbb315792181c14b,/Users/sanika/Downloads/Master Thesis/repo_updated/pytest/src/_pytest/doctest.py,2720,ModificationType.MODIFY,669,365,481,22,61,110,691,15,103,63,122,118,185,747.3129132339992,1273.2889641319407,8.883495145631068,11311.256331851706,628.403129547317,0.4244296547106469
1984c10427adc264d7cdd1bedbb315792181c14b,/Users/sanika/Downloads/Master Thesis/repo_updated/pytest/testing/test_doctest.py,3715,ModificationType.MODIFY,1455,414,1257,16,76,112,1471,5,41,23,46,46,69,231.26927266377825,381.1257749679339,2.8048780487804876,1069.0113200320097,59.389517779556094,0.1270419249893113
583c2a2f9babe67c8f2413b391416874efe91d36,/Users/sanika/Downloads/Master Thesis/repo_updated/pytest/src/_pytest/logging.py,2793,ModificationType.MODIFY,773,422,505,30,103,129,803,14,77,46,83,91,129,535.8455325423139,839.5055085856318,7.545454545454546,6334.450655691586,351.9139253161992,0.2798351695285439
93c8822f26c90e3b440021b26da62e6aa6d49158,/Users/sanika/Downloads/Master Thesis/repo_updated/pytest/testing/test_warnings.py,625,ModificationType.MODIFY,601,196,481,2,23,85,603,8,63,36,72,71,108,400.56863518049477,664.1726889065056,4.571428571428571,3036.21800642974,168.67877813498555,0.22139089630216854
93c8822f26c90e3b440021b26da62e6aa6d49158,/Users/sanika/Downloads/Master Thesis/repo_updated/pytest/src/_pytest/warnings.py,625,ModificationType.MODIFY,156,79,106,5,16,28,161,5,14,8,15,19,23,64.91260938324326,97.70233280920246,2.6785714285714284,261.7026771675066,14.539037620417032,0.03256744426973415
5dca7a2f4fa5e5c16935bc79c2f1da9d28886609,/Users/sanika/Downloads/Master Thesis/repo_updated/pytest/testing/test_cacheprovider.py,2046,ModificationType.MODIFY,996,429,845,24,10,117,1020,7,76,50,88,83,138,494.49397547611574,879.7554415258757,4.052631578947368,3565.3246840785487,198.07359355991937,0.29325181384195853
5dca7a2f4fa5e5c16935bc79c2f1da9d28886609,/Users/sanika/Downloads/Master Thesis/repo_updated/pytest/src/_pytest/cacheprovider.py,2046,ModificationType.MODIFY,456,277,329,12,42,72,468,13,85,50,97,98,147,592.903945907539,972.3623470849358,7.41764705882353,7212.640703965318,400.70226133140653,0.32412078236164527
0267b25c66875617ed69132445820a6f82e6e2fa,/Users/sanika/Downloads/Master Thesis/repo_updated/pytest/testing/test_terminal.py,6168,ModificationType.MODIFY,1943,715,1694,26,18,214,1969,12,185,120,237,197,357,1436.3251202041715,2721.0724995459263,7.686486486486486,20915.486996509768,1161.971499806098,0.9070241665153088
0267b25c66875617ed69132445820a6f82e6e2fa,/Users/sanika/Downloads/Master Thesis/repo_updated/pytest/src/_pytest/terminal.py,6168,ModificationType.MODIFY,1168,838,957,57,25,144,1225,19,348,224,416,367,640,3018.854959310786,5452.5672018196565,11.35632183908046,61921.107993078396,3440.061555171022,1.8175224006065522
1787bffda016f07b25c6dc7a2fb27e39ab920ec4,/Users/sanika/Downloads/Master Thesis/repo_updated/pytest/testing/test_capture.py,3438,ModificationType.MODIFY,1513,682,1277,25,13,200,1538,11,199,116,219,210,335,1557.7420472931965,2584.272248418151,6.052763819095477,15641.989563917903,868.9994202176613,0.8614240828060503
1787bffda016f07b25c6dc7a2fb27e39ab920ec4,/Users/sanika/Downloads/Master Thesis/repo_updated/pytest/src/_pytest/capture.py,3438,ModificationType.MODIFY,819,519,539,24,98,155,843,15,96,57,106,111,163,690.7597590033588,1107.4897862150674,8.28125,9171.399792093527,509.52221067186264,0.36916326207168915
1787bffda016f07b25c6dc7a2fb27e39ab920ec4,/Users/sanika/Downloads/Master Thesis/repo_updated/pytest/testing/test_capture.py,5074,ModificationType.MODIFY,1513,682,1277,25,13,200,1538,11,199,116,219,210,335,1557.7420472931965,2584.272248418151,6.052763819095477,15641.989563917903,868.9994202176613,0.8614240828060503
ba4b8c869c70f6c46b780a1e1478ec75da61417a,/Users/sanika/Downloads/Master Thesis/repo_updated/pytest/testing/test_pathlib.py,1379,ModificationType.MODIFY,91,45,69,0,3,18,91,3,9,6,10,12,16,33.28421251514428,57.359400011538504,1.6666666666666667,95.59900001923084,5.311055556623936,0.01911980000384617
ba4b8c869c70f6c46b780a1e1478ec75da61417a,/Users/sanika/Downloads/Master Thesis/repo_updated/pytest/src/_pytest/pathlib.py,1379,ModificationType.MODIFY,367,234,237,17,34,68,384,16,55,34,61,71,95,381.9747842438563,584.2259763529448,8.872727272727273,5183.677753822492,287.9820974345829,0.19474199211764828
ba4b8c869c70f6c46b780a1e1478ec75da61417a,/Users/sanika/Downloads/Master Thesis/repo_updated/pytest/testing/test_tmpdir.py,1798,ModificationType.MODIFY,442,244,305,14,16,103,456,11,68,45,75,79,120,452.0012210100334,756.4536897812524,6.0661764705882355,4588.781574040686,254.932309668927,0.2521512299270841
1cc1ac51838f45d819fcdbfd71df79aa851dc677,/Users/sanika/Downloads/Master Thesis/repo_updated/pytest/testing/test_assertrewrite.py,5417,ModificationType.MODIFY,1660,832,1314,41,38,274,1701,20,312,209,395,332,604,2671.484054182769,5058.523816533542,12.66025641025641,64042.2085747035,3557.900476372417,1.6861746055111808
1cc1ac51838f45d819fcdbfd71df79aa851dc677,/Users/sanika/Downloads/Master Thesis/repo_updated/pytest/src/_pytest/assertion/rewrite.py,5417,ModificationType.MODIFY,1057,646,719,113,100,145,1170,18,215,134,248,233,382,1740.9201126876956,3004.119107257935,10.38139534883721,31186.948127440515,1732.608229302251,1.001373035752645
1cc1ac51838f45d819fcdbfd71df79aa851dc677,/Users/sanika/Downloads/Master Thesis/repo_updated/pytest/testing/test_doctest.py,2720,ModificationType.MODIFY,1455,414,1257,16,76,112,1471,5,41,23,46,46,69,231.26927266377825,381.1257749679339,2.8048780487804876,1069.0113200320097,59.389517779556094,0.1270419249893113
1cc1ac51838f45d819fcdbfd71df79aa851dc677,/Users/sanika/Downloads/Master Thesis/repo_updated/pytest/src/_pytest/doctest.py,2720,ModificationType.MODIFY,669,365,481,22,61,110,691,15,103,63,122,118,185,747.3129132339992,1273.2889641319407,8.883495145631068,11311.256331851706,628.403129547317,0.4244296547106469
1cc1ac51838f45d819fcdbfd71df79aa851dc677,/Users/sanika/Downloads/Master Thesis/repo_updated/pytest/testing/test_nodes.py,1701,ModificationType.MODIFY,53,23,39,0,0,13,53,2,8,4,8,10,12,26.0,39.863137138648355,1.0,39.863137138648355,2.2146187299249087,0.013287712379549451
1cc1ac51838f45d819fcdbfd71df79aa851dc677,/Users/sanika/Downloads/Master Thesis/repo_updated/pytest/src/_pytest/nodes.py,1701,ModificationType.MODIFY,515,298,307,33,80,99,548,12,63,44,77,75,121,419.58818518914865,753.6870615500015,7.333333333333333,5527.038451366678,307.0576917425932,0.2512290205166672
7beb520555b7908c647c5cfa35bbfc3e48b28638,/Users/sanika/Downloads/Master Thesis/repo_updated/pytest/testing/test_pytester.py,5923,ModificationType.MODIFY,722,423,573,19,0,135,741,12,172,101,199,184,300,1320.3370878174146,2257.068586817104,6.941860465116279,15668.255189881524,870.4586216600846,0.7523561956057013
7beb520555b7908c647c5cfa35bbfc3e48b28638,/Users/sanika/Downloads/Master Thesis/repo_updated/pytest/src/_pytest/pytester.py,5923,ModificationType.MODIFY,1508,847,911,44,250,301,1552,14,148,88,169,162,257,1120.302067021891,1886.3414507413484,7.993243243243243,15077.986055587939,837.6658919771077,0.6287804835804495
7beb520555b7908c647c5cfa35bbfc3e48b28638,/Users/sanika/Downloads/Master Thesis/repo_updated/pytest/testing/test_pytester.py,3032,ModificationType.MODIFY,722,423,573,19,0,135,741,12,172,101,199,184,300,1320.3370878174146,2257.068586817104,6.941860465116279,15668.255189881524,870.4586216600846,0.7523561956057013
20ee883b5f69fa0f1ff9a28bedb3d411b085acca,/Users/sanika/Downloads/Master Thesis/repo_updated/pytest/testing/test_pytester.py,5913,ModificationType.MODIFY,722,423,573,19,0,135,741,12,172,101,199,184,300,1320.3370878174146,2257.068586817104,6.941860465116279,15668.255189881524,870.4586216600846,0.7523561956057013
20ee883b5f69fa0f1ff9a28bedb3d411b085acca,/Users/sanika/Downloads/Master Thesis/repo_updated/pytest/src/_pytest/pytester.py,5913,ModificationType.MODIFY,1508,847,911,44,250,301,1552,14,148,88,169,162,257,1120.302067021891,1886.3414507413484,7.993243243243243,15077.986055587939,837.6658919771077,0.6287804835804495
20ee883b5f69fa0f1ff9a28bedb3d411b085acca,/Users/sanika/Downloads/Master Thesis/repo_updated/pytest/testing/test_pytester.py,3032,ModificationType.MODIFY,722,423,573,19,0,135,741,12,172,101,199,184,300,1320.3370878174146,2257.068586817104,6.941860465116279,15668.255189881524,870.4586216600846,0.7523561956057013
62427778188a403122df36665e7a50e5ab2740fe,/Users/sanika/Downloads/Master Thesis/repo_updated/pytest/testing/test_pytester.py,5911,ModificationType.MODIFY,722,423,573,19,0,135,741,12,172,101,199,184,300,1320.3370878174146,2257.068586817104,6.941860465116279,15668.255189881524,870.4586216600846,0.7523561956057013
62427778188a403122df36665e7a50e5ab2740fe,/Users/sanika/Downloads/Master Thesis/repo_updated/pytest/src/_pytest/pytester.py,5911,ModificationType.MODIFY,1508,847,911,44,250,301,1552,14,148,88,169,162,257,1120.302067021891,1886.3414507413484,7.993243243243243,15077.986055587939,837.6658919771077,0.6287804835804495
62427778188a403122df36665e7a50e5ab2740fe,/Users/sanika/Downloads/Master Thesis/repo_updated/pytest/testing/test_config.py,6056,ModificationType.MODIFY,1457,730,1242,11,6,188,1468,10,292,166,329,302,495,2424.648052141839,4078.010345965914,5.633561643835616,22973.722668198385,1276.3179260110214,1.359336781988638
62427778188a403122df36665e7a50e5ab2740fe,/Users/sanika/Downloads/Master Thesis/repo_updated/pytest/testing/test_runner.py,3442,ModificationType.MODIFY,1043,504,840,53,9,147,1096,9,180,112,198,189,310,1377.0628823523223,2344.2951515085324,4.95,11604.260999967235,644.6811666648464,0.7814317171695108
7a2d2d8f07d65e3d4b8360086df009777f130b5e,/Users/sanika/Downloads/Master Thesis/repo_updated/pytest/testing/test_assertrewrite.py,5417,ModificationType.MODIFY,1660,832,1314,41,38,274,1701,20,312,209,395,332,604,2671.484054182769,5058.523816533542,12.66025641025641,64042.2085747035,3557.900476372417,1.6861746055111808
7a2d2d8f07d65e3d4b8360086df009777f130b5e,/Users/sanika/Downloads/Master Thesis/repo_updated/pytest/src/_pytest/assertion/rewrite.py,5417,ModificationType.MODIFY,1057,646,719,113,100,145,1170,18,215,134,248,233,382,1740.9201126876956,3004.119107257935,10.38139534883721,31186.948127440515,1732.608229302251,1.001373035752645
7a2d2d8f07d65e3d4b8360086df009777f130b5e,/Users/sanika/Downloads/Master Thesis/repo_updated/pytest/testing/test_cacheprovider.py,2046,ModificationType.MODIFY,996,429,845,24,10,117,1020,7,76,50,88,83,138,494.49397547611574,879.7554415258757,4.052631578947368,3565.3246840785487,198.07359355991937,0.29325181384195853
7a2d2d8f07d65e3d4b8360086df009777f130b5e,/Users/sanika/Downloads/Master Thesis/repo_updated/pytest/src/_pytest/cacheprovider.py,2046,ModificationType.MODIFY,456,277,329,12,42,72,468,13,85,50,97,98,147,592.903945907539,972.3623470849358,7.41764705882353,7212.640703965318,400.70226133140653,0.32412078236164527
7a2d2d8f07d65e3d4b8360086df009777f130b5e,/Users/sanika/Downloads/Master Thesis/repo_updated/pytest/testing/test_capture.py,3438,ModificationType.MODIFY,1513,682,1277,25,13,200,1538,11,199,116,219,210,335,1557.7420472931965,2584.272248418151,6.052763819095477,15641.989563917903,868.9994202176613,0.8614240828060503
7a2d2d8f07d65e3d4b8360086df009777f130b5e,/Users/sanika/Downloads/Master Thesis/repo_updated/pytest/src/_pytest/capture.py,3438,ModificationType.MODIFY,819,519,539,24,98,155,843,15,96,57,106,111,163,690.7597590033588,1107.4897862150674,8.28125,9171.399792093527,509.52221067186264,0.36916326207168915
7a2d2d8f07d65e3d4b8360086df009777f130b5e,/Users/sanika/Downloads/Master Thesis/repo_updated/pytest/testing/test_doctest.py,2720,ModificationType.MODIFY,1455,414,1257,16,76,112,1471,5,41,23,46,46,69,231.26927266377825,381.1257749679339,2.8048780487804876,1069.0113200320097,59.389517779556094,0.1270419249893113
7a2d2d8f07d65e3d4b8360086df009777f130b5e,/Users/sanika/Downloads/Master Thesis/repo_updated/pytest/src/_pytest/doctest.py,2720,ModificationType.MODIFY,669,365,481,22,61,110,691,15,103,63,122,118,185,747.3129132339992,1273.2889641319407,8.883495145631068,11311.256331851706,628.403129547317,0.4244296547106469
7a2d2d8f07d65e3d4b8360086df009777f130b5e,/Users/sanika/Downloads/Master Thesis/repo_updated/pytest/src/_pytest/logging.py,2793,ModificationType.MODIFY,773,422,505,30,103,129,803,14,77,46,83,91,129,535.8455325423139,839.5055085856318,7.545454545454546,6334.450655691586,351.9139253161992,0.2798351695285439
7a2d2d8f07d65e3d4b8360086df009777f130b5e,/Users/sanika/Downloads/Master Thesis/repo_updated/pytest/testing/test_nodes.py,1701,ModificationType.MODIFY,53,23,39,0,0,13,53,2,8,4,8,10,12,26.0,39.863137138648355,1.0,39.863137138648355,2.2146187299249087,0.013287712379549451
7a2d2d8f07d65e3d4b8360086df009777f130b5e,/Users/sanika/Downloads/Master Thesis/repo_updated/pytest/src/_pytest/nodes.py,1701,ModificationType.MODIFY,515,298,307,33,80,99,548,12,63,44,77,75,121,419.58818518914865,753.6870615500015,7.333333333333333,5527.038451366678,307.0576917425932,0.2512290205166672
7a2d2d8f07d65e3d4b8360086df009777f130b5e,/Users/sanika/Downloads/Master Thesis/repo_updated/pytest/testing/test_terminal.py,6168,ModificationType.MODIFY,1943,715,1694,26,18,214,1969,12,185,120,237,197,357,1436.3251202041715,2721.0724995459263,7.686486486486486,20915.486996509768,1161.971499806098,0.9070241665153088
7a2d2d8f07d65e3d4b8360086df009777f130b5e,/Users/sanika/Downloads/Master Thesis/repo_updated/pytest/src/_pytest/terminal.py,6168,ModificationType.MODIFY,1168,838,957,57,25,144,1225,19,348,224,416,367,640,3018.854959310786,5452.5672018196565,11.35632183908046,61921.107993078396,3440.061555171022,1.8175224006065522
7a2d2d8f07d65e3d4b8360086df009777f130b5e,/Users/sanika/Downloads/Master Thesis/repo_updated/pytest/testing/test_warnings.py,625,ModificationType.MODIFY,601,196,481,2,23,85,603,8,63,36,72,71,108,400.56863518049477,664.1726889065056,4.571428571428571,3036.21800642974,168.67877813498555,0.22139089630216854
7a2d2d8f07d65e3d4b8360086df009777f130b5e,/Users/sanika/Downloads/Master Thesis/repo_updated/pytest/src/_pytest/warnings.py,625,ModificationType.MODIFY,156,79,106,5,16,28,161,5,14,8,15,19,23,64.91260938324326,97.70233280920246,2.6785714285714284,261.7026771675066,14.539037620417032,0.03256744426973415
7a2d2d8f07d65e3d4b8360086df009777f130b5e,/Users/sanika/Downloads/Master Thesis/repo_updated/pytest/testing/test_capture.py,5074,ModificationType.MODIFY,1513,682,1277,25,13,200,1538,11,199,116,219,210,335,1557.7420472931965,2584.272248418151,6.052763819095477,15641.989563917903,868.9994202176613,0.8614240828060503
7a2d2d8f07d65e3d4b8360086df009777f130b5e,/Users/sanika/Downloads/Master Thesis/repo_updated/pytest/testing/test_doctest.py,3715,ModificationType.MODIFY,1455,414,1257,16,76,112,1471,5,41,23,46,46,69,231.26927266377825,381.1257749679339,2.8048780487804876,1069.0113200320097,59.389517779556094,0.1270419249893113
8316d4392aadab5e91d508a8a130968f19a20c29,/Users/sanika/Downloads/Master Thesis/repo_updated/pytest/testing/test_capture.py,3438,ModificationType.MODIFY,1513,682,1277,25,13,200,1538,11,199,116,219,210,335,1557.7420472931965,2584.272248418151,6.052763819095477,15641.989563917903,868.9994202176613,0.8614240828060503
8316d4392aadab5e91d508a8a130968f19a20c29,/Users/sanika/Downloads/Master Thesis/repo_updated/pytest/src/_pytest/capture.py,3438,ModificationType.MODIFY,819,519,539,24,98,155,843,15,96,57,106,111,163,690.7597590033588,1107.4897862150674,8.28125,9171.399792093527,509.52221067186264,0.36916326207168915
713b9e54c31a8ec66c59ebe44c3e86a9b60fa7c7,/Users/sanika/Downloads/Master Thesis/repo_updated/pytest/testing/test_pathlib.py,1379,ModificationType.MODIFY,91,45,69,0,3,18,91,3,9,6,10,12,16,33.28421251514428,57.359400011538504,1.6666666666666667,95.59900001923084,5.311055556623936,0.01911980000384617
713b9e54c31a8ec66c59ebe44c3e86a9b60fa7c7,/Users/sanika/Downloads/Master Thesis/repo_updated/pytest/src/_pytest/pathlib.py,1379,ModificationType.MODIFY,367,234,237,17,34,68,384,16,55,34,61,71,95,381.9747842438563,584.2259763529448,8.872727272727273,5183.677753822492,287.9820974345829,0.19474199211764828
713b9e54c31a8ec66c59ebe44c3e86a9b60fa7c7,/Users/sanika/Downloads/Master Thesis/repo_updated/pytest/testing/test_tmpdir.py,1798,ModificationType.MODIFY,442,244,305,14,16,103,456,11,68,45,75,79,120,452.0012210100334,756.4536897812524,6.0661764705882355,4588.781574040686,254.932309668927,0.2521512299270841
432e5550e5ae8843d40bffd436e6a88582ef7dc3,/Users/sanika/Downloads/Master Thesis/repo_updated/pytest/src/_pytest/assertion/util.py,2350,ModificationType.MODIFY,477,336,357,30,23,73,507,16,194,134,250,210,384,1538.3830913843028,2962.270278783791,10.309278350515465,30538.86885344115,1696.603825191175,0.9874234262612637
432e5550e5ae8843d40bffd436e6a88582ef7dc3,/Users/sanika/Downloads/Master Thesis/repo_updated/pytest/testing/test_assertrewrite.py,6013,ModificationType.MODIFY,1660,832,1314,41,38,274,1701,20,312,209,395,332,604,2671.484054182769,5058.523816533542,12.66025641025641,64042.2085747035,3557.900476372417,1.6861746055111808
45fc0d9cd80ed37d77698f4e316103ba187f7eaf,/Users/sanika/Downloads/Master Thesis/repo_updated/pytest/testing/test_meta.py,96,ModificationType.MODIFY,35,12,22,4,5,6,39,1,2,1,2,3,3,2.0,4.754887502163469,0.5,2.3774437510817346,0.1320802083934297,0.0015849625007211565
8ef4287bf0b2a0a6ff7e612ed48ba3e781f570d4,/Users/sanika/Downloads/Master Thesis/repo_updated/pytest/testing/test_pytester.py,5986,ModificationType.MODIFY,722,423,573,19,0,135,741,12,172,101,199,184,300,1320.3370878174146,2257.068586817104,6.941860465116279,15668.255189881524,870.4586216600846,0.7523561956057013
8ef4287bf0b2a0a6ff7e612ed48ba3e781f570d4,/Users/sanika/Downloads/Master Thesis/repo_updated/pytest/src/_pytest/pytester.py,5986,ModificationType.MODIFY,1508,847,911,44,250,301,1552,14,148,88,169,162,257,1120.302067021891,1886.3414507413484,7.993243243243243,15077.986055587939,837.6658919771077,0.6287804835804495
8ef4287bf0b2a0a6ff7e612ed48ba3e781f570d4,/Users/sanika/Downloads/Master Thesis/repo_updated/pytest/testing/test_pytester.py,3137,ModificationType.MODIFY,722,423,573,19,0,135,741,12,172,101,199,184,300,1320.3370878174146,2257.068586817104,6.941860465116279,15668.255189881524,870.4586216600846,0.7523561956057013
d1bc2601e490b85763b2b711d4cd11d06e8e7be7,/Users/sanika/Downloads/Master Thesis/repo_updated/pytest/testing/test_pytester.py,5989,ModificationType.MODIFY,722,423,573,19,0,135,741,12,172,101,199,184,300,1320.3370878174146,2257.068586817104,6.941860465116279,15668.255189881524,870.4586216600846,0.7523561956057013
d1bc2601e490b85763b2b711d4cd11d06e8e7be7,/Users/sanika/Downloads/Master Thesis/repo_updated/pytest/src/_pytest/pytester.py,5989,ModificationType.MODIFY,1508,847,911,44,250,301,1552,14,148,88,169,162,257,1120.302067021891,1886.3414507413484,7.993243243243243,15077.986055587939,837.6658919771077,0.6287804835804495
d1bc2601e490b85763b2b711d4cd11d06e8e7be7,/Users/sanika/Downloads/Master Thesis/repo_updated/pytest/testing/test_pytester.py,3175,ModificationType.MODIFY,722,423,573,19,0,135,741,12,172,101,199,184,300,1320.3370878174146,2257.068586817104,6.941860465116279,15668.255189881524,870.4586216600846,0.7523561956057013
fb0e8b99d11e66dd5c4957b079aa4d58090b92a2,/Users/sanika/Downloads/Master Thesis/repo_updated/pytest/testing/test_cacheprovider.py,2057,ModificationType.MODIFY,996,429,845,24,10,117,1020,7,76,50,88,83,138,494.49397547611574,879.7554415258757,4.052631578947368,3565.3246840785487,198.07359355991937,0.29325181384195853
fb0e8b99d11e66dd5c4957b079aa4d58090b92a2,/Users/sanika/Downloads/Master Thesis/repo_updated/pytest/src/_pytest/cacheprovider.py,2057,ModificationType.MODIFY,456,277,329,12,42,72,468,13,85,50,97,98,147,592.903945907539,972.3623470849358,7.41764705882353,7212.640703965318,400.70226133140653,0.32412078236164527
fb0e8b99d11e66dd5c4957b079aa4d58090b92a2,/Users/sanika/Downloads/Master Thesis/repo_updated/pytest/testing/test_pathlib.py,1379,ModificationType.MODIFY,91,45,69,0,3,18,91,3,9,6,10,12,16,33.28421251514428,57.359400011538504,1.6666666666666667,95.59900001923084,5.311055556623936,0.01911980000384617
fb0e8b99d11e66dd5c4957b079aa4d58090b92a2,/Users/sanika/Downloads/Master Thesis/repo_updated/pytest/src/_pytest/pathlib.py,1379,ModificationType.MODIFY,367,234,237,17,34,68,384,16,55,34,61,71,95,381.9747842438563,584.2259763529448,8.872727272727273,5183.677753822492,287.9820974345829,0.19474199211764828
fb0e8b99d11e66dd5c4957b079aa4d58090b92a2,/Users/sanika/Downloads/Master Thesis/repo_updated/pytest/testing/test_cacheprovider.py,3797,ModificationType.MODIFY,996,429,845,24,10,117,1020,7,76,50,88,83,138,494.49397547611574,879.7554415258757,4.052631578947368,3565.3246840785487,198.07359355991937,0.29325181384195853
fb0e8b99d11e66dd5c4957b079aa4d58090b92a2,/Users/sanika/Downloads/Master Thesis/repo_updated/pytest/testing/test_tmpdir.py,1798,ModificationType.MODIFY,442,244,305,14,16,103,456,11,68,45,75,79,120,452.0012210100334,756.4536897812524,6.0661764705882355,4588.781574040686,254.932309668927,0.2521512299270841
ed9fda84d30850f71b7d7d5c831c9ab1aaf3b2c8,/Users/sanika/Downloads/Master Thesis/repo_updated/pytest/src/_pytest/python_api.py,1970,ModificationType.MODIFY,757,253,292,73,244,162,830,13,61,38,67,74,105,409.8806939271703,651.9926033910399,7.139344262295082,4654.799652078654,258.5999806710363,0.2173308677970133
ed9fda84d30850f71b7d7d5c831c9ab1aaf3b2c8,/Users/sanika/Downloads/Master Thesis/repo_updated/pytest/testing/python/approx.py,4451,ModificationType.MODIFY,520,294,400,33,13,81,553,10,261,204,367,271,571,2128.502746053614,4614.907102613061,7.030651340996169,32445.802809559264,1802.5446005310703,1.5383023675376872
34a02121adc2af5641b663c25804def9adb151e3,/Users/sanika/Downloads/Master Thesis/repo_updated/pytest/testing/python/approx.py,4328,ModificationType.MODIFY,520,294,400,33,13,81,553,10,261,204,367,271,571,2128.502746053614,4614.907102613061,7.030651340996169,32445.802809559264,1802.5446005310703,1.5383023675376872
82753bec50fae4718fc6f38bdab3cf214f2be00f,/Users/sanika/Downloads/Master Thesis/repo_updated/pytest/testing/test_terminal.py,6183,ModificationType.MODIFY,1943,715,1694,26,18,214,1969,12,185,120,237,197,357,1436.3251202041715,2721.0724995459263,7.686486486486486,20915.486996509768,1161.971499806098,0.9070241665153088
82753bec50fae4718fc6f38bdab3cf214f2be00f,/Users/sanika/Downloads/Master Thesis/repo_updated/pytest/src/_pytest/terminal.py,6183,ModificationType.MODIFY,1168,838,957,57,25,144,1225,19,348,224,416,367,640,3018.854959310786,5452.5672018196565,11.35632183908046,61921.107993078396,3440.061555171022,1.8175224006065522
82753bec50fae4718fc6f38bdab3cf214f2be00f,/Users/sanika/Downloads/Master Thesis/repo_updated/pytest/testing/test_terminal.py,6684,ModificationType.MODIFY,1943,715,1694,26,18,214,1969,12,185,120,237,197,357,1436.3251202041715,2721.0724995459263,7.686486486486486,20915.486996509768,1161.971499806098,0.9070241665153088
1f5b454355d27bccda2ce1b3b145cfbde020fb76,/Users/sanika/Downloads/Master Thesis/repo_updated/pytest/src/_pytest/logging.py,2936,ModificationType.MODIFY,773,422,505,30,103,129,803,14,77,46,83,91,129,535.8455325423139,839.5055085856318,7.545454545454546,6334.450655691586,351.9139253161992,0.2798351695285439
1f5b454355d27bccda2ce1b3b145cfbde020fb76,/Users/sanika/Downloads/Master Thesis/repo_updated/pytest/testing/logging/test_formatter.py,501,ModificationType.MODIFY,149,67,118,4,0,27,153,1,17,14,28,18,42,69.48686830125578,175.1368500605771,0.8235294117647058,144.23034710871056,8.01279706159503,0.05837895002019237
3c7fbe2d8b4e3a0f3d9dcd7fbdf6ac12de181ef8,/Users/sanika/Downloads/Master Thesis/repo_updated/pytest/src/_pytest/python_api.py,1970,ModificationType.MODIFY,757,253,292,73,244,162,830,13,61,38,67,74,105,409.8806939271703,651.9926033910399,7.139344262295082,4654.799652078654,258.5999806710363,0.2173308677970133
39066d5a4210f8c26b4336636fcab1244f1cfee3,/Users/sanika/Downloads/Master Thesis/repo_updated/pytest/testing/test_cacheprovider.py,2057,ModificationType.MODIFY,996,429,845,24,10,117,1020,7,76,50,88,83,138,494.49397547611574,879.7554415258757,4.052631578947368,3565.3246840785487,198.07359355991937,0.29325181384195853
39066d5a4210f8c26b4336636fcab1244f1cfee3,/Users/sanika/Downloads/Master Thesis/repo_updated/pytest/src/_pytest/cacheprovider.py,2057,ModificationType.MODIFY,456,277,329,12,42,72,468,13,85,50,97,98,147,592.903945907539,972.3623470849358,7.41764705882353,7212.640703965318,400.70226133140653,0.32412078236164527
39066d5a4210f8c26b4336636fcab1244f1cfee3,/Users/sanika/Downloads/Master Thesis/repo_updated/pytest/testing/test_pathlib.py,1379,ModificationType.MODIFY,91,45,69,0,3,18,91,3,9,6,10,12,16,33.28421251514428,57.359400011538504,1.6666666666666667,95.59900001923084,5.311055556623936,0.01911980000384617
39066d5a4210f8c26b4336636fcab1244f1cfee3,/Users/sanika/Downloads/Master Thesis/repo_updated/pytest/src/_pytest/pathlib.py,1379,ModificationType.MODIFY,367,234,237,17,34,68,384,16,55,34,61,71,95,381.9747842438563,584.2259763529448,8.872727272727273,5183.677753822492,287.9820974345829,0.19474199211764828
39066d5a4210f8c26b4336636fcab1244f1cfee3,/Users/sanika/Downloads/Master Thesis/repo_updated/pytest/testing/test_cacheprovider.py,3797,ModificationType.MODIFY,996,429,845,24,10,117,1020,7,76,50,88,83,138,494.49397547611574,879.7554415258757,4.052631578947368,3565.3246840785487,198.07359355991937,0.29325181384195853
39066d5a4210f8c26b4336636fcab1244f1cfee3,/Users/sanika/Downloads/Master Thesis/repo_updated/pytest/testing/test_tmpdir.py,1798,ModificationType.MODIFY,442,244,305,14,16,103,456,11,68,45,75,79,120,452.0012210100334,756.4536897812524,6.0661764705882355,4588.781574040686,254.932309668927,0.2521512299270841
b9df9a476177cac1760a5d10cd66392368a8c00a,/Users/sanika/Downloads/Master Thesis/repo_updated/pytest/src/_pytest/python_api.py,1970,ModificationType.MODIFY,757,253,292,73,244,162,830,13,61,38,67,74,105,409.8806939271703,651.9926033910399,7.139344262295082,4654.799652078654,258.5999806710363,0.2173308677970133
b9df9a476177cac1760a5d10cd66392368a8c00a,/Users/sanika/Downloads/Master Thesis/repo_updated/pytest/testing/python/approx.py,4328,ModificationType.MODIFY,520,294,400,33,13,81,553,10,261,204,367,271,571,2128.502746053614,4614.907102613061,7.030651340996169,32445.802809559264,1802.5446005310703,1.5383023675376872
f93f284356c73e35ef3f50076496538bbdce4b6b,/Users/sanika/Downloads/Master Thesis/repo_updated/pytest/testing/test_assertrewrite.py,5471,ModificationType.MODIFY,1660,832,1314,41,38,274,1701,20,312,209,395,332,604,2671.484054182769,5058.523816533542,12.66025641025641,64042.2085747035,3557.900476372417,1.6861746055111808
f93f284356c73e35ef3f50076496538bbdce4b6b,/Users/sanika/Downloads/Master Thesis/repo_updated/pytest/src/_pytest/assertion/rewrite.py,5471,ModificationType.MODIFY,1057,646,719,113,100,145,1170,18,215,134,248,233,382,1740.9201126876956,3004.119107257935,10.38139534883721,31186.948127440515,1732.608229302251,1.001373035752645
f93f284356c73e35ef3f50076496538bbdce4b6b,/Users/sanika/Downloads/Master Thesis/repo_updated/pytest/testing/test_assertrewrite.py,6306,ModificationType.MODIFY,1660,832,1314,41,38,274,1701,20,312,209,395,332,604,2671.484054182769,5058.523816533542,12.66025641025641,64042.2085747035,3557.900476372417,1.6861746055111808
96de23279165af589822f54365f31925390f434d,/Users/sanika/Downloads/Master Thesis/repo_updated/pytest/testing/freeze/runtests_script.py,20,ModificationType.MODIFY,10,5,4,0,4,2,10,1,2,1,2,3,3,2.0,4.754887502163469,0.5,2.3774437510817346,0.1320802083934297,0.0015849625007211565
96de23279165af589822f54365f31925390f434d,/Users/sanika/Downloads/Master Thesis/repo_updated/pytest/testing/python/collect.py,3931,ModificationType.MODIFY,1338,495,1086,10,64,173,1348,11,122,82,157,133,239,883.6037029876825,1686.2125020847843,7.077868852459017,11934.79094713288,663.0439415073822,0.5620708340282614
96de23279165af589822f54365f31925390f434d,/Users/sanika/Downloads/Master Thesis/repo_updated/pytest/testing/test_reports.py,1843,ModificationType.MODIFY,466,257,367,18,25,50,484,7,126,86,171,133,257,898.7887548153927,1813.2075859238057,4.75,8612.736033138077,478.4853351743376,0.6044025286412685
0b8c35516fc3da230e6ce177b76f8af0d5a14ed1,/Users/sanika/Downloads/Master Thesis/repo_updated/pytest/testing/code/test_code.py,4974,ModificationType.MODIFY,182,127,129,0,0,53,182,5,39,21,42,44,63,217.7403270100645,343.9441919741497,2.6923076923076925,926.003593776557,51.44464409869761,0.11464806399138323
0b8c35516fc3da230e6ce177b76f8af0d5a14ed1,/Users/sanika/Downloads/Master Thesis/repo_updated/pytest/src/_pytest/_code/code.py,4974,ModificationType.MODIFY,1165,710,800,67,119,181,1232,18,243,153,282,261,435,2000.7880884021665,3492.1391085079,10.444444444444445,36473.45291108251,2026.302939504584,1.1640463695026333
0b8c35516fc3da230e6ce177b76f8af0d5a14ed1,/Users/sanika/Downloads/Master Thesis/repo_updated/pytest/src/_pytest/logging.py,2748,ModificationType.MODIFY,773,422,505,30,103,129,803,14,77,46,83,91,129,535.8455325423139,839.5055085856318,7.545454545454546,6334.450655691586,351.9139253161992,0.2798351695285439
0b8c35516fc3da230e6ce177b76f8af0d5a14ed1,/Users/sanika/Downloads/Master Thesis/repo_updated/pytest/testing/test_pytester.py,5745,ModificationType.MODIFY,722,423,573,19,0,135,741,12,172,101,199,184,300,1320.3370878174146,2257.068586817104,6.941860465116279,15668.255189881524,870.4586216600846,0.7523561956057013
0b8c35516fc3da230e6ce177b76f8af0d5a14ed1,/Users/sanika/Downloads/Master Thesis/repo_updated/pytest/src/_pytest/pytester.py,5745,ModificationType.MODIFY,1508,847,911,44,250,301,1552,14,148,88,169,162,257,1120.302067021891,1886.3414507413484,7.993243243243243,15077.986055587939,837.6658919771077,0.6287804835804495
0b8c35516fc3da230e6ce177b76f8af0d5a14ed1,/Users/sanika/Downloads/Master Thesis/repo_updated/pytest/testing/test_reports.py,1942,ModificationType.MODIFY,466,257,367,18,25,50,484,7,126,86,171,133,257,898.7887548153927,1813.2075859238057,4.75,8612.736033138077,478.4853351743376,0.6044025286412685
0b8c35516fc3da230e6ce177b76f8af0d5a14ed1,/Users/sanika/Downloads/Master Thesis/repo_updated/pytest/src/_pytest/reports.py,1942,ModificationType.MODIFY,507,281,342,29,59,88,536,10,53,29,57,63,86,336.79906504072324,514.0460734209928,5.377358490566038,2764.2100174525085,153.56722319180602,0.17134869114033094
0b8c35516fc3da230e6ce177b76f8af0d5a14ed1,/Users/sanika/Downloads/Master Thesis/repo_updated/pytest/testing/test_capture.py,5083,ModificationType.MODIFY,1513,682,1277,25,13,200,1538,11,199,116,219,210,335,1557.7420472931965,2584.272248418151,6.052763819095477,15641.989563917903,868.9994202176613,0.8614240828060503
0b8c35516fc3da230e6ce177b76f8af0d5a14ed1,/Users/sanika/Downloads/Master Thesis/repo_updated/pytest/testing/test_resultlog.py,1033,ModificationType.MODIFY,215,129,180,6,0,29,221,8,65,43,72,73,115,415.4539078468495,711.829824271202,4.430769230769231,3153.953682924711,175.2196490513728,0.2372766080904007
0b8c35516fc3da230e6ce177b76f8af0d5a14ed1,/Users/sanika/Downloads/Master Thesis/repo_updated/pytest/testing/test_terminal.py,6136,ModificationType.MODIFY,1943,715,1694,26,18,214,1969,12,185,120,237,197,357,1436.3251202041715,2721.0724995459263,7.686486486486486,20915.486996509768,1161.971499806098,0.9070241665153088
6f20b4b014f5e01a64f811372625284e2e8b08fe,/Users/sanika/Downloads/Master Thesis/repo_updated/pytest/testing/test_assertrewrite.py,5480,ModificationType.MODIFY,1660,832,1314,41,38,274,1701,20,312,209,395,332,604,2671.484054182769,5058.523816533542,12.66025641025641,64042.2085747035,3557.900476372417,1.6861746055111808
6f20b4b014f5e01a64f811372625284e2e8b08fe,/Users/sanika/Downloads/Master Thesis/repo_updated/pytest/src/_pytest/assertion/rewrite.py,5480,ModificationType.MODIFY,1057,646,719,113,100,145,1170,18,215,134,248,233,382,1740.9201126876956,3004.119107257935,10.38139534883721,31186.948127440515,1732.608229302251,1.001373035752645
6f20b4b014f5e01a64f811372625284e2e8b08fe,/Users/sanika/Downloads/Master Thesis/repo_updated/pytest/testing/test_compat.py,1223,ModificationType.MODIFY,207,111,150,11,0,50,218,5,26,19,36,31,55,133.82107314610522,272.4807970712782,3.4615384615384617,943.202759092886,52.40015328293811,0.09082693235709273
6f20b4b014f5e01a64f811372625284e2e8b08fe,/Users/sanika/Downloads/Master Thesis/repo_updated/pytest/src/_pytest/compat.py,1223,ModificationType.MODIFY,410,198,237,31,55,97,441,11,63,38,72,74,110,414.62238298550506,683.0398702191846,6.285714285714286,4293.39346994916,238.52185944162,0.2276799567397282
6f20b4b014f5e01a64f811372625284e2e8b08fe,/Users/sanika/Downloads/Master Thesis/repo_updated/pytest/testing/test_assertrewrite.py,6308,ModificationType.MODIFY,1660,832,1314,41,38,274,1701,20,312,209,395,332,604,2671.484054182769,5058.523816533542,12.66025641025641,64042.2085747035,3557.900476372417,1.6861746055111808
1ad4ca6ac14ccabc2fb537bfc766251dfad22aec,/Users/sanika/Downloads/Master Thesis/repo_updated/pytest/testing/test_assertrewrite.py,5480,ModificationType.MODIFY,1660,832,1314,41,38,274,1701,20,312,209,395,332,604,2671.484054182769,5058.523816533542,12.66025641025641,64042.2085747035,3557.900476372417,1.6861746055111808
1ad4ca6ac14ccabc2fb537bfc766251dfad22aec,/Users/sanika/Downloads/Master Thesis/repo_updated/pytest/src/_pytest/assertion/rewrite.py,5480,ModificationType.MODIFY,1057,646,719,113,100,145,1170,18,215,134,248,233,382,1740.9201126876956,3004.119107257935,10.38139534883721,31186.948127440515,1732.608229302251,1.001373035752645
1ad4ca6ac14ccabc2fb537bfc766251dfad22aec,/Users/sanika/Downloads/Master Thesis/repo_updated/pytest/testing/test_compat.py,1223,ModificationType.MODIFY,207,111,150,11,0,50,218,5,26,19,36,31,55,133.82107314610522,272.4807970712782,3.4615384615384617,943.202759092886,52.40015328293811,0.09082693235709273
1ad4ca6ac14ccabc2fb537bfc766251dfad22aec,/Users/sanika/Downloads/Master Thesis/repo_updated/pytest/src/_pytest/compat.py,1223,ModificationType.MODIFY,410,198,237,31,55,97,441,11,63,38,72,74,110,414.62238298550506,683.0398702191846,6.285714285714286,4293.39346994916,238.52185944162,0.2276799567397282
1ad4ca6ac14ccabc2fb537bfc766251dfad22aec,/Users/sanika/Downloads/Master Thesis/repo_updated/pytest/testing/test_assertrewrite.py,6308,ModificationType.MODIFY,1660,832,1314,41,38,274,1701,20,312,209,395,332,604,2671.484054182769,5058.523816533542,12.66025641025641,64042.2085747035,3557.900476372417,1.6861746055111808
ac633b8969ced41c49d3cb8ce9bc4d4b20be4682,/Users/sanika/Downloads/Master Thesis/repo_updated/pytest/testing/code/test_code.py,4974,ModificationType.MODIFY,182,127,129,0,0,53,182,5,39,21,42,44,63,217.7403270100645,343.9441919741497,2.6923076923076925,926.003593776557,51.44464409869761,0.11464806399138323
ac633b8969ced41c49d3cb8ce9bc4d4b20be4682,/Users/sanika/Downloads/Master Thesis/repo_updated/pytest/src/_pytest/_code/code.py,4974,ModificationType.MODIFY,1165,710,800,67,119,181,1232,18,243,153,282,261,435,2000.7880884021665,3492.1391085079,10.444444444444445,36473.45291108251,2026.302939504584,1.1640463695026333
ac633b8969ced41c49d3cb8ce9bc4d4b20be4682,/Users/sanika/Downloads/Master Thesis/repo_updated/pytest/src/_pytest/logging.py,2748,ModificationType.MODIFY,773,422,505,30,103,129,803,14,77,46,83,91,129,535.8455325423139,839.5055085856318,7.545454545454546,6334.450655691586,351.9139253161992,0.2798351695285439
ac633b8969ced41c49d3cb8ce9bc4d4b20be4682,/Users/sanika/Downloads/Master Thesis/repo_updated/pytest/testing/test_pytester.py,5745,ModificationType.MODIFY,722,423,573,19,0,135,741,12,172,101,199,184,300,1320.3370878174146,2257.068586817104,6.941860465116279,15668.255189881524,870.4586216600846,0.7523561956057013
ac633b8969ced41c49d3cb8ce9bc4d4b20be4682,/Users/sanika/Downloads/Master Thesis/repo_updated/pytest/src/_pytest/pytester.py,5745,ModificationType.MODIFY,1508,847,911,44,250,301,1552,14,148,88,169,162,257,1120.302067021891,1886.3414507413484,7.993243243243243,15077.986055587939,837.6658919771077,0.6287804835804495
ac633b8969ced41c49d3cb8ce9bc4d4b20be4682,/Users/sanika/Downloads/Master Thesis/repo_updated/pytest/testing/test_reports.py,1942,ModificationType.MODIFY,466,257,367,18,25,50,484,7,126,86,171,133,257,898.7887548153927,1813.2075859238057,4.75,8612.736033138077,478.4853351743376,0.6044025286412685
ac633b8969ced41c49d3cb8ce9bc4d4b20be4682,/Users/sanika/Downloads/Master Thesis/repo_updated/pytest/src/_pytest/reports.py,1942,ModificationType.MODIFY,507,281,342,29,59,88,536,10,53,29,57,63,86,336.79906504072324,514.0460734209928,5.377358490566038,2764.2100174525085,153.56722319180602,0.17134869114033094
ac633b8969ced41c49d3cb8ce9bc4d4b20be4682,/Users/sanika/Downloads/Master Thesis/repo_updated/pytest/testing/test_capture.py,5083,ModificationType.MODIFY,1513,682,1277,25,13,200,1538,11,199,116,219,210,335,1557.7420472931965,2584.272248418151,6.052763819095477,15641.989563917903,868.9994202176613,0.8614240828060503
ac633b8969ced41c49d3cb8ce9bc4d4b20be4682,/Users/sanika/Downloads/Master Thesis/repo_updated/pytest/testing/test_resultlog.py,1033,ModificationType.MODIFY,215,129,180,6,0,29,221,8,65,43,72,73,115,415.4539078468495,711.829824271202,4.430769230769231,3153.953682924711,175.2196490513728,0.2372766080904007
ac633b8969ced41c49d3cb8ce9bc4d4b20be4682,/Users/sanika/Downloads/Master Thesis/repo_updated/pytest/testing/test_terminal.py,6136,ModificationType.MODIFY,1943,715,1694,26,18,214,1969,12,185,120,237,197,357,1436.3251202041715,2721.0724995459263,7.686486486486486,20915.486996509768,1161.971499806098,0.9070241665153088
cefe6bfec38f8f9e200b2e233a840cf1de2bf3b4,/Users/sanika/Downloads/Master Thesis/repo_updated/pytest/testing/freeze/runtests_script.py,20,ModificationType.MODIFY,10,5,4,0,4,2,10,1,2,1,2,3,3,2.0,4.754887502163469,0.5,2.3774437510817346,0.1320802083934297,0.0015849625007211565
cefe6bfec38f8f9e200b2e233a840cf1de2bf3b4,/Users/sanika/Downloads/Master Thesis/repo_updated/pytest/testing/python/collect.py,3931,ModificationType.MODIFY,1338,495,1086,10,64,173,1348,11,122,82,157,133,239,883.6037029876825,1686.2125020847843,7.077868852459017,11934.79094713288,663.0439415073822,0.5620708340282614
cefe6bfec38f8f9e200b2e233a840cf1de2bf3b4,/Users/sanika/Downloads/Master Thesis/repo_updated/pytest/testing/test_reports.py,1843,ModificationType.MODIFY,466,257,367,18,25,50,484,7,126,86,171,133,257,898.7887548153927,1813.2075859238057,4.75,8612.736033138077,478.4853351743376,0.6044025286412685
59a59f371b303e8825b07fdd6567609b698d0092,/Users/sanika/Downloads/Master Thesis/repo_updated/pytest/testing/test_pathlib.py,1550,ModificationType.MODIFY,91,45,69,0,3,18,91,3,9,6,10,12,16,33.28421251514428,57.359400011538504,1.6666666666666667,95.59900001923084,5.311055556623936,0.01911980000384617
59a59f371b303e8825b07fdd6567609b698d0092,/Users/sanika/Downloads/Master Thesis/repo_updated/pytest/src/_pytest/pathlib.py,1550,ModificationType.MODIFY,367,234,237,17,34,68,384,16,55,34,61,71,95,381.9747842438563,584.2259763529448,8.872727272727273,5183.677753822492,287.9820974345829,0.19474199211764828
00a278cdb4549973998b58206ca020a87c38fcee,/Users/sanika/Downloads/Master Thesis/repo_updated/pytest/testing/test_tmpdir.py,704,ModificationType.MODIFY,442,244,305,14,16,103,456,11,68,45,75,79,120,452.0012210100334,756.4536897812524,6.0661764705882355,4588.781574040686,254.932309668927,0.2521512299270841
00a278cdb4549973998b58206ca020a87c38fcee,/Users/sanika/Downloads/Master Thesis/repo_updated/pytest/src/_pytest/tmpdir.py,704,ModificationType.MODIFY,182,102,99,11,40,35,193,3,11,6,11,14,17,42.808635307173745,64.72503367497926,1.5,97.08755051246888,5.393752806248271,0.021575011224993085
8e8a8fa4b9b1b88c8afc9ce92e3c2a8bc5466541,/Users/sanika/Downloads/Master Thesis/repo_updated/pytest/testing/test_pytester.py,5973,ModificationType.MODIFY,722,423,573,19,0,135,741,12,172,101,199,184,300,1320.3370878174146,2257.068586817104,6.941860465116279,15668.255189881524,870.4586216600846,0.7523561956057013
8e8a8fa4b9b1b88c8afc9ce92e3c2a8bc5466541,/Users/sanika/Downloads/Master Thesis/repo_updated/pytest/src/_pytest/pytester.py,5973,ModificationType.MODIFY,1508,847,911,44,250,301,1552,14,148,88,169,162,257,1120.302067021891,1886.3414507413484,7.993243243243243,15077.986055587939,837.6658919771077,0.6287804835804495
7f1af84f47f9237006c9678f97b8c7cc946312e5,/Users/sanika/Downloads/Master Thesis/repo_updated/pytest/testing/code/test_code.py,4989,ModificationType.MODIFY,182,127,129,0,0,53,182,5,39,21,42,44,63,217.7403270100645,343.9441919741497,2.6923076923076925,926.003593776557,51.44464409869761,0.11464806399138323
7f1af84f47f9237006c9678f97b8c7cc946312e5,/Users/sanika/Downloads/Master Thesis/repo_updated/pytest/src/_pytest/_code/code.py,4989,ModificationType.MODIFY,1165,710,800,67,119,181,1232,18,243,153,282,261,435,2000.7880884021665,3492.1391085079,10.444444444444445,36473.45291108251,2026.302939504584,1.1640463695026333
7f1af84f47f9237006c9678f97b8c7cc946312e5,/Users/sanika/Downloads/Master Thesis/repo_updated/pytest/src/_pytest/logging.py,2787,ModificationType.MODIFY,773,422,505,30,103,129,803,14,77,46,83,91,129,535.8455325423139,839.5055085856318,7.545454545454546,6334.450655691586,351.9139253161992,0.2798351695285439
7f1af84f47f9237006c9678f97b8c7cc946312e5,/Users/sanika/Downloads/Master Thesis/repo_updated/pytest/testing/test_pytester.py,5989,ModificationType.MODIFY,722,423,573,19,0,135,741,12,172,101,199,184,300,1320.3370878174146,2257.068586817104,6.941860465116279,15668.255189881524,870.4586216600846,0.7523561956057013
7f1af84f47f9237006c9678f97b8c7cc946312e5,/Users/sanika/Downloads/Master Thesis/repo_updated/pytest/src/_pytest/pytester.py,5989,ModificationType.MODIFY,1508,847,911,44,250,301,1552,14,148,88,169,162,257,1120.302067021891,1886.3414507413484,7.993243243243243,15077.986055587939,837.6658919771077,0.6287804835804495
7f1af84f47f9237006c9678f97b8c7cc946312e5,/Users/sanika/Downloads/Master Thesis/repo_updated/pytest/testing/test_reports.py,1942,ModificationType.MODIFY,466,257,367,18,25,50,484,7,126,86,171,133,257,898.7887548153927,1813.2075859238057,4.75,8612.736033138077,478.4853351743376,0.6044025286412685
7f1af84f47f9237006c9678f97b8c7cc946312e5,/Users/sanika/Downloads/Master Thesis/repo_updated/pytest/src/_pytest/reports.py,1942,ModificationType.MODIFY,507,281,342,29,59,88,536,10,53,29,57,63,86,336.79906504072324,514.0460734209928,5.377358490566038,2764.2100174525085,153.56722319180602,0.17134869114033094
7f1af84f47f9237006c9678f97b8c7cc946312e5,/Users/sanika/Downloads/Master Thesis/repo_updated/pytest/testing/freeze/runtests_script.py,20,ModificationType.MODIFY,10,5,4,0,4,2,10,1,2,1,2,3,3,2.0,4.754887502163469,0.5,2.3774437510817346,0.1320802083934297,0.0015849625007211565
7f1af84f47f9237006c9678f97b8c7cc946312e5,/Users/sanika/Downloads/Master Thesis/repo_updated/pytest/testing/python/collect.py,3928,ModificationType.MODIFY,1338,495,1086,10,64,173,1348,11,122,82,157,133,239,883.6037029876825,1686.2125020847843,7.077868852459017,11934.79094713288,663.0439415073822,0.5620708340282614
7f1af84f47f9237006c9678f97b8c7cc946312e5,/Users/sanika/Downloads/Master Thesis/repo_updated/pytest/testing/test_capture.py,5072,ModificationType.MODIFY,1513,682,1277,25,13,200,1538,11,199,116,219,210,335,1557.7420472931965,2584.272248418151,6.052763819095477,15641.989563917903,868.9994202176613,0.8614240828060503
7f1af84f47f9237006c9678f97b8c7cc946312e5,/Users/sanika/Downloads/Master Thesis/repo_updated/pytest/testing/test_reports.py,1843,ModificationType.MODIFY,466,257,367,18,25,50,484,7,126,86,171,133,257,898.7887548153927,1813.2075859238057,4.75,8612.736033138077,478.4853351743376,0.6044025286412685
7f1af84f47f9237006c9678f97b8c7cc946312e5,/Users/sanika/Downloads/Master Thesis/repo_updated/pytest/testing/test_resultlog.py,1033,ModificationType.MODIFY,215,129,180,6,0,29,221,8,65,43,72,73,115,415.4539078468495,711.829824271202,4.430769230769231,3153.953682924711,175.2196490513728,0.2372766080904007
7f1af84f47f9237006c9678f97b8c7cc946312e5,/Users/sanika/Downloads/Master Thesis/repo_updated/pytest/testing/test_terminal.py,6632,ModificationType.MODIFY,1943,715,1694,26,18,214,1969,12,185,120,237,197,357,1436.3251202041715,2721.0724995459263,7.686486486486486,20915.486996509768,1161.971499806098,0.9070241665153088
a92f49afa7d32d3c64972390a22c9ed7710fcfcb,/Users/sanika/Downloads/Master Thesis/repo_updated/pytest/testing/code/test_code.py,4989,ModificationType.MODIFY,182,127,129,0,0,53,182,5,39,21,42,44,63,217.7403270100645,343.9441919741497,2.6923076923076925,926.003593776557,51.44464409869761,0.11464806399138323
a92f49afa7d32d3c64972390a22c9ed7710fcfcb,/Users/sanika/Downloads/Master Thesis/repo_updated/pytest/src/_pytest/_code/code.py,4989,ModificationType.MODIFY,1165,710,800,67,119,181,1232,18,243,153,282,261,435,2000.7880884021665,3492.1391085079,10.444444444444445,36473.45291108251,2026.302939504584,1.1640463695026333
a92f49afa7d32d3c64972390a22c9ed7710fcfcb,/Users/sanika/Downloads/Master Thesis/repo_updated/pytest/src/_pytest/logging.py,2787,ModificationType.MODIFY,773,422,505,30,103,129,803,14,77,46,83,91,129,535.8455325423139,839.5055085856318,7.545454545454546,6334.450655691586,351.9139253161992,0.2798351695285439
a92f49afa7d32d3c64972390a22c9ed7710fcfcb,/Users/sanika/Downloads/Master Thesis/repo_updated/pytest/testing/test_pytester.py,5989,ModificationType.MODIFY,722,423,573,19,0,135,741,12,172,101,199,184,300,1320.3370878174146,2257.068586817104,6.941860465116279,15668.255189881524,870.4586216600846,0.7523561956057013
a92f49afa7d32d3c64972390a22c9ed7710fcfcb,/Users/sanika/Downloads/Master Thesis/repo_updated/pytest/src/_pytest/pytester.py,5989,ModificationType.MODIFY,1508,847,911,44,250,301,1552,14,148,88,169,162,257,1120.302067021891,1886.3414507413484,7.993243243243243,15077.986055587939,837.6658919771077,0.6287804835804495
a92f49afa7d32d3c64972390a22c9ed7710fcfcb,/Users/sanika/Downloads/Master Thesis/repo_updated/pytest/testing/test_reports.py,1942,ModificationType.MODIFY,466,257,367,18,25,50,484,7,126,86,171,133,257,898.7887548153927,1813.2075859238057,4.75,8612.736033138077,478.4853351743376,0.6044025286412685
a92f49afa7d32d3c64972390a22c9ed7710fcfcb,/Users/sanika/Downloads/Master Thesis/repo_updated/pytest/src/_pytest/reports.py,1942,ModificationType.MODIFY,507,281,342,29,59,88,536,10,53,29,57,63,86,336.79906504072324,514.0460734209928,5.377358490566038,2764.2100174525085,153.56722319180602,0.17134869114033094
a92f49afa7d32d3c64972390a22c9ed7710fcfcb,/Users/sanika/Downloads/Master Thesis/repo_updated/pytest/testing/freeze/runtests_script.py,20,ModificationType.MODIFY,10,5,4,0,4,2,10,1,2,1,2,3,3,2.0,4.754887502163469,0.5,2.3774437510817346,0.1320802083934297,0.0015849625007211565
a92f49afa7d32d3c64972390a22c9ed7710fcfcb,/Users/sanika/Downloads/Master Thesis/repo_updated/pytest/testing/python/collect.py,3928,ModificationType.MODIFY,1338,495,1086,10,64,173,1348,11,122,82,157,133,239,883.6037029876825,1686.2125020847843,7.077868852459017,11934.79094713288,663.0439415073822,0.5620708340282614
a92f49afa7d32d3c64972390a22c9ed7710fcfcb,/Users/sanika/Downloads/Master Thesis/repo_updated/pytest/testing/test_capture.py,5072,ModificationType.MODIFY,1513,682,1277,25,13,200,1538,11,199,116,219,210,335,1557.7420472931965,2584.272248418151,6.052763819095477,15641.989563917903,868.9994202176613,0.8614240828060503
a92f49afa7d32d3c64972390a22c9ed7710fcfcb,/Users/sanika/Downloads/Master Thesis/repo_updated/pytest/testing/test_reports.py,1843,ModificationType.MODIFY,466,257,367,18,25,50,484,7,126,86,171,133,257,898.7887548153927,1813.2075859238057,4.75,8612.736033138077,478.4853351743376,0.6044025286412685
a92f49afa7d32d3c64972390a22c9ed7710fcfcb,/Users/sanika/Downloads/Master Thesis/repo_updated/pytest/testing/test_resultlog.py,1033,ModificationType.MODIFY,215,129,180,6,0,29,221,8,65,43,72,73,115,415.4539078468495,711.829824271202,4.430769230769231,3153.953682924711,175.2196490513728,0.2372766080904007
a92f49afa7d32d3c64972390a22c9ed7710fcfcb,/Users/sanika/Downloads/Master Thesis/repo_updated/pytest/testing/test_terminal.py,6632,ModificationType.MODIFY,1943,715,1694,26,18,214,1969,12,185,120,237,197,357,1436.3251202041715,2721.0724995459263,7.686486486486486,20915.486996509768,1161.971499806098,0.9070241665153088
81c3bc76bcd366c61da2a63047421241e33c366b,/Users/sanika/Downloads/Master Thesis/repo_updated/pytest/testing/test_capture.py,5076,ModificationType.MODIFY,1513,682,1277,25,13,200,1538,11,199,116,219,210,335,1557.7420472931965,2584.272248418151,6.052763819095477,15641.989563917903,868.9994202176613,0.8614240828060503
a4faac6c942f38613bca7b88176565da173d1ab2,/Users/sanika/Downloads/Master Thesis/repo_updated/pytest/testing/example_scripts/collect/package_infinite_recursion/__init__.pyi,608,ModificationType.MODIFY,0,0,0,0,0,0,0,0,0,0,0,0,0,0,0,0,0,0.0,0.0
a4faac6c942f38613bca7b88176565da173d1ab2,/Users/sanika/Downloads/Master Thesis/repo_updated/pytest/testing/example_scripts/collect/package_infinite_recursion/tests/__init__.py,608,ModificationType.MODIFY,0,0,0,0,0,0,0,0,0,0,0,0,0,0,0,0,0,0.0,0.0
a4faac6c942f38613bca7b88176565da173d1ab2,/Users/sanika/Downloads/Master Thesis/repo_updated/pytest/testing/example_scripts/collect/collect_init_tests/tests/__init__.py,608,ModificationType.MODIFY,2,2,2,0,0,0,2,0,0,0,0,0,0,0,0,0,0,0.0,0.0
a4faac6c942f38613bca7b88176565da173d1ab2,/Users/sanika/Downloads/Master Thesis/repo_updated/pytest/testing/example_scripts/collect/package_init_given_as_arg/pkg/__init__.py,608,ModificationType.MODIFY,0,0,0,0,0,0,0,0,0,0,0,0,0,0,0,0,0,0.0,0.0
a4faac6c942f38613bca7b88176565da173d1ab2,/Users/sanika/Downloads/Master Thesis/repo_updated/pytest/testing/example_scripts/conftest_usageerror/__init__.pyi,608,ModificationType.MODIFY,0,0,0,0,0,0,0,0,0,0,0,0,0,0,0,0,0,0.0,0.0
a4faac6c942f38613bca7b88176565da173d1ab2,/Users/sanika/Downloads/Master Thesis/repo_updated/pytest/testing/example_scripts/marks/marks_considered_keywords/__init__.pyi,608,ModificationType.MODIFY,0,0,0,0,0,0,0,0,0,0,0,0,0,0,0,0,0,0.0,0.0
a4faac6c942f38613bca7b88176565da173d1ab2,/Users/sanika/Downloads/Master Thesis/repo_updated/pytest/testing/example_scripts/config/collect_pytest_prefix/__init__.pyi,608,ModificationType.MODIFY,0,0,0,0,0,0,0,0,0,0,0,0,0,0,0,0,0,0.0,0.0
a4faac6c942f38613bca7b88176565da173d1ab2,/Users/sanika/Downloads/Master Thesis/repo_updated/pytest/testing/example_scripts/issue88_initial_file_multinodes/__init__.pyi,608,ModificationType.MODIFY,0,0,0,0,0,0,0,0,0,0,0,0,0,0,0,0,0,0.0,0.0
a4faac6c942f38613bca7b88176565da173d1ab2,/Users/sanika/Downloads/Master Thesis/repo_updated/pytest/testing/example_scripts/fixtures/fill_fixtures/test_extend_fixture_conftest_conftest/__init__.pyi,608,ModificationType.MODIFY,0,0,0,0,0,0,0,0,0,0,0,0,0,0,0,0,0,0.0,0.0
a4faac6c942f38613bca7b88176565da173d1ab2,/Users/sanika/Downloads/Master Thesis/repo_updated/pytest/testing/example_scripts/fixtures/fill_fixtures/test_extend_fixture_conftest_conftest/pkg/__init__.py,608,ModificationType.MODIFY,0,0,0,0,0,0,0,0,0,0,0,0,0,0,0,0,0,0.0,0.0
a4faac6c942f38613bca7b88176565da173d1ab2,/Users/sanika/Downloads/Master Thesis/repo_updated/pytest/testing/example_scripts/fixtures/fill_fixtures/test_extend_fixture_conftest_module/__init__.pyi,608,ModificationType.MODIFY,0,0,0,0,0,0,0,0,0,0,0,0,0,0,0,0,0,0.0,0.0
a4faac6c942f38613bca7b88176565da173d1ab2,/Users/sanika/Downloads/Master Thesis/repo_updated/pytest/testing/example_scripts/fixtures/fill_fixtures/test_conftest_funcargs_only_available_in_subdir/sub1/__init__.py,608,ModificationType.MODIFY,0,0,0,0,0,0,0,0,0,0,0,0,0,0,0,0,0,0.0,0.0
a4faac6c942f38613bca7b88176565da173d1ab2,/Users/sanika/Downloads/Master Thesis/repo_updated/pytest/testing/example_scripts/fixtures/fill_fixtures/test_conftest_funcargs_only_available_in_subdir/sub2/__init__.py,608,ModificationType.MODIFY,0,0,0,0,0,0,0,0,0,0,0,0,0,0,0,0,0,0.0,0.0
a4faac6c942f38613bca7b88176565da173d1ab2,/Users/sanika/Downloads/Master Thesis/repo_updated/pytest/testing/example_scripts/fixtures/custom_item/__init__.pyi,608,ModificationType.MODIFY,0,0,0,0,0,0,0,0,0,0,0,0,0,0,0,0,0,0.0,0.0
a4faac6c942f38613bca7b88176565da173d1ab2,/Users/sanika/Downloads/Master Thesis/repo_updated/pytest/testing/example_scripts/fixtures/custom_item/foo/__init__.py,608,ModificationType.MODIFY,0,0,0,0,0,0,0,0,0,0,0,0,0,0,0,0,0,0.0,0.0
a4faac6c942f38613bca7b88176565da173d1ab2,/Users/sanika/Downloads/Master Thesis/repo_updated/pytest/doc/en/example/nonpython/__init__.py,608,ModificationType.MODIFY,0,0,0,0,0,0,0,0,0,0,0,0,0,0,0,0,0,0.0,0.0
a4faac6c942f38613bca7b88176565da173d1ab2,/Users/sanika/Downloads/Master Thesis/repo_updated/pytest/src/pytest/__init__.py,608,ModificationType.MODIFY,99,48,90,1,3,5,100,0,0,0,0,0,0,0,0,0,0,0.0,0.0
a4faac6c942f38613bca7b88176565da173d1ab2,/Users/sanika/Downloads/Master Thesis/repo_updated/pytest/src/_pytest/__init__.py,608,ModificationType.MODIFY,8,5,5,2,0,1,10,0,0,0,0,0,0,0,0,0,0,0.0,0.0
a4faac6c942f38613bca7b88176565da173d1ab2,/Users/sanika/Downloads/Master Thesis/repo_updated/pytest/src/_pytest/config/__init__.py,608,ModificationType.MODIFY,1217,716,841,84,126,174,1301,14,185,118,215,199,333,1446.608539104324,2542.995998641035,8.135135135135135,20687.616097052745,1149.3120053918192,0.847665332880345
a4faac6c942f38613bca7b88176565da173d1ab2,/Users/sanika/Downloads/Master Thesis/repo_updated/pytest/src/_pytest/mark/__init__.py,608,ModificationType.MODIFY,160,89,115,0,13,31,160,7,15,11,17,22,28,78.25484338853101,124.86408532184433,3.966666666666667,495.2942051099825,27.51634472833236,0.04162136177394811
a4faac6c942f38613bca7b88176565da173d1ab2,/Users/sanika/Downloads/Master Thesis/repo_updated/pytest/src/_pytest/_code/__init__.py,608,ModificationType.MODIFY,10,10,9,9,0,0,19,0,0,0,0,0,0,0,0,0,0,0.0,0.0
a4faac6c942f38613bca7b88176565da173d1ab2,/Users/sanika/Downloads/Master Thesis/repo_updated/pytest/src/_pytest/assertion/__init__.py,608,ModificationType.MODIFY,173,84,99,8,29,36,181,5,12,7,13,17,20,54.62919048309069,81.7492568250068,2.7083333333333335,221.4042372343934,12.300235401910745,0.027249752275002266
a4faac6c942f38613bca7b88176565da173d1ab2,/Users/sanika/Downloads/Master Thesis/repo_updated/pytest/src/_pytest/_io/__init__.py,608,ModificationType.MODIFY,3,1,1,3,0,0,6,0,0,0,0,0,0,0,0,0,0,0.0,0.0
cbc39dd86ecfc7ebfd25756f42adf4b9ef1121fc,/Users/sanika/Downloads/Master Thesis/repo_updated/pytest/testing/example_scripts/collect/package_infinite_recursion/__init__.pyi,608,ModificationType.MODIFY,0,0,0,0,0,0,0,0,0,0,0,0,0,0,0,0,0,0.0,0.0
cbc39dd86ecfc7ebfd25756f42adf4b9ef1121fc,/Users/sanika/Downloads/Master Thesis/repo_updated/pytest/testing/example_scripts/collect/package_infinite_recursion/tests/__init__.py,608,ModificationType.MODIFY,0,0,0,0,0,0,0,0,0,0,0,0,0,0,0,0,0,0.0,0.0
cbc39dd86ecfc7ebfd25756f42adf4b9ef1121fc,/Users/sanika/Downloads/Master Thesis/repo_updated/pytest/testing/example_scripts/collect/collect_init_tests/tests/__init__.py,608,ModificationType.MODIFY,2,2,2,0,0,0,2,0,0,0,0,0,0,0,0,0,0,0.0,0.0
cbc39dd86ecfc7ebfd25756f42adf4b9ef1121fc,/Users/sanika/Downloads/Master Thesis/repo_updated/pytest/testing/example_scripts/collect/package_init_given_as_arg/pkg/__init__.py,608,ModificationType.MODIFY,0,0,0,0,0,0,0,0,0,0,0,0,0,0,0,0,0,0.0,0.0
cbc39dd86ecfc7ebfd25756f42adf4b9ef1121fc,/Users/sanika/Downloads/Master Thesis/repo_updated/pytest/testing/example_scripts/conftest_usageerror/__init__.pyi,608,ModificationType.MODIFY,0,0,0,0,0,0,0,0,0,0,0,0,0,0,0,0,0,0.0,0.0
cbc39dd86ecfc7ebfd25756f42adf4b9ef1121fc,/Users/sanika/Downloads/Master Thesis/repo_updated/pytest/testing/example_scripts/marks/marks_considered_keywords/__init__.pyi,608,ModificationType.MODIFY,0,0,0,0,0,0,0,0,0,0,0,0,0,0,0,0,0,0.0,0.0
cbc39dd86ecfc7ebfd25756f42adf4b9ef1121fc,/Users/sanika/Downloads/Master Thesis/repo_updated/pytest/testing/example_scripts/config/collect_pytest_prefix/__init__.pyi,608,ModificationType.MODIFY,0,0,0,0,0,0,0,0,0,0,0,0,0,0,0,0,0,0.0,0.0
cbc39dd86ecfc7ebfd25756f42adf4b9ef1121fc,/Users/sanika/Downloads/Master Thesis/repo_updated/pytest/testing/example_scripts/issue88_initial_file_multinodes/__init__.pyi,608,ModificationType.MODIFY,0,0,0,0,0,0,0,0,0,0,0,0,0,0,0,0,0,0.0,0.0
cbc39dd86ecfc7ebfd25756f42adf4b9ef1121fc,/Users/sanika/Downloads/Master Thesis/repo_updated/pytest/testing/example_scripts/fixtures/fill_fixtures/test_extend_fixture_conftest_conftest/__init__.pyi,608,ModificationType.MODIFY,0,0,0,0,0,0,0,0,0,0,0,0,0,0,0,0,0,0.0,0.0
cbc39dd86ecfc7ebfd25756f42adf4b9ef1121fc,/Users/sanika/Downloads/Master Thesis/repo_updated/pytest/testing/example_scripts/fixtures/fill_fixtures/test_extend_fixture_conftest_conftest/pkg/__init__.py,608,ModificationType.MODIFY,0,0,0,0,0,0,0,0,0,0,0,0,0,0,0,0,0,0.0,0.0
cbc39dd86ecfc7ebfd25756f42adf4b9ef1121fc,/Users/sanika/Downloads/Master Thesis/repo_updated/pytest/testing/example_scripts/fixtures/fill_fixtures/test_extend_fixture_conftest_module/__init__.pyi,608,ModificationType.MODIFY,0,0,0,0,0,0,0,0,0,0,0,0,0,0,0,0,0,0.0,0.0
cbc39dd86ecfc7ebfd25756f42adf4b9ef1121fc,/Users/sanika/Downloads/Master Thesis/repo_updated/pytest/testing/example_scripts/fixtures/fill_fixtures/test_conftest_funcargs_only_available_in_subdir/sub1/__init__.py,608,ModificationType.MODIFY,0,0,0,0,0,0,0,0,0,0,0,0,0,0,0,0,0,0.0,0.0
cbc39dd86ecfc7ebfd25756f42adf4b9ef1121fc,/Users/sanika/Downloads/Master Thesis/repo_updated/pytest/testing/example_scripts/fixtures/fill_fixtures/test_conftest_funcargs_only_available_in_subdir/sub2/__init__.py,608,ModificationType.MODIFY,0,0,0,0,0,0,0,0,0,0,0,0,0,0,0,0,0,0.0,0.0
cbc39dd86ecfc7ebfd25756f42adf4b9ef1121fc,/Users/sanika/Downloads/Master Thesis/repo_updated/pytest/testing/example_scripts/fixtures/custom_item/__init__.pyi,608,ModificationType.MODIFY,0,0,0,0,0,0,0,0,0,0,0,0,0,0,0,0,0,0.0,0.0
cbc39dd86ecfc7ebfd25756f42adf4b9ef1121fc,/Users/sanika/Downloads/Master Thesis/repo_updated/pytest/testing/example_scripts/fixtures/custom_item/foo/__init__.py,608,ModificationType.MODIFY,0,0,0,0,0,0,0,0,0,0,0,0,0,0,0,0,0,0.0,0.0
cbc39dd86ecfc7ebfd25756f42adf4b9ef1121fc,/Users/sanika/Downloads/Master Thesis/repo_updated/pytest/doc/en/example/nonpython/__init__.py,608,ModificationType.MODIFY,0,0,0,0,0,0,0,0,0,0,0,0,0,0,0,0,0,0.0,0.0
cbc39dd86ecfc7ebfd25756f42adf4b9ef1121fc,/Users/sanika/Downloads/Master Thesis/repo_updated/pytest/src/pytest/__init__.py,608,ModificationType.MODIFY,99,48,90,1,3,5,100,0,0,0,0,0,0,0,0,0,0,0.0,0.0
cbc39dd86ecfc7ebfd25756f42adf4b9ef1121fc,/Users/sanika/Downloads/Master Thesis/repo_updated/pytest/src/_pytest/__init__.py,608,ModificationType.MODIFY,8,5,5,2,0,1,10,0,0,0,0,0,0,0,0,0,0,0.0,0.0
cbc39dd86ecfc7ebfd25756f42adf4b9ef1121fc,/Users/sanika/Downloads/Master Thesis/repo_updated/pytest/src/_pytest/config/__init__.py,608,ModificationType.MODIFY,1217,716,841,84,126,174,1301,14,185,118,215,199,333,1446.608539104324,2542.995998641035,8.135135135135135,20687.616097052745,1149.3120053918192,0.847665332880345
cbc39dd86ecfc7ebfd25756f42adf4b9ef1121fc,/Users/sanika/Downloads/Master Thesis/repo_updated/pytest/src/_pytest/mark/__init__.py,608,ModificationType.MODIFY,160,89,115,0,13,31,160,7,15,11,17,22,28,78.25484338853101,124.86408532184433,3.966666666666667,495.2942051099825,27.51634472833236,0.04162136177394811
cbc39dd86ecfc7ebfd25756f42adf4b9ef1121fc,/Users/sanika/Downloads/Master Thesis/repo_updated/pytest/src/_pytest/_code/__init__.py,608,ModificationType.MODIFY,10,10,9,9,0,0,19,0,0,0,0,0,0,0,0,0,0,0.0,0.0
cbc39dd86ecfc7ebfd25756f42adf4b9ef1121fc,/Users/sanika/Downloads/Master Thesis/repo_updated/pytest/src/_pytest/assertion/__init__.py,608,ModificationType.MODIFY,173,84,99,8,29,36,181,5,12,7,13,17,20,54.62919048309069,81.7492568250068,2.7083333333333335,221.4042372343934,12.300235401910745,0.027249752275002266
cbc39dd86ecfc7ebfd25756f42adf4b9ef1121fc,/Users/sanika/Downloads/Master Thesis/repo_updated/pytest/src/_pytest/_io/__init__.py,608,ModificationType.MODIFY,3,1,1,3,0,0,6,0,0,0,0,0,0,0,0,0,0,0.0,0.0
886a3ad609e16bb69a5d0b02f285e4fb076ebcc6,/Users/sanika/Downloads/Master Thesis/repo_updated/pytest/testing/test_pytester.py,6063,ModificationType.MODIFY,722,423,573,19,0,135,741,12,172,101,199,184,300,1320.3370878174146,2257.068586817104,6.941860465116279,15668.255189881524,870.4586216600846,0.7523561956057013
886a3ad609e16bb69a5d0b02f285e4fb076ebcc6,/Users/sanika/Downloads/Master Thesis/repo_updated/pytest/src/_pytest/pytester.py,6063,ModificationType.MODIFY,1508,847,911,44,250,301,1552,14,148,88,169,162,257,1120.302067021891,1886.3414507413484,7.993243243243243,15077.986055587939,837.6658919771077,0.6287804835804495
886a3ad609e16bb69a5d0b02f285e4fb076ebcc6,/Users/sanika/Downloads/Master Thesis/repo_updated/pytest/testing/test_pytester.py,3231,ModificationType.MODIFY,722,423,573,19,0,135,741,12,172,101,199,184,300,1320.3370878174146,2257.068586817104,6.941860465116279,15668.255189881524,870.4586216600846,0.7523561956057013
d863c30c743138ed29cdf786cb18c41c24983fe1,/Users/sanika/Downloads/Master Thesis/repo_updated/pytest/testing/test_main.py,3484,ModificationType.MODIFY,77,34,69,0,0,8,77,3,24,16,29,27,45,114.79398751947123,213.9699375973561,1.8125,387.82051189520797,21.54558399417822,0.07132331253245204
d863c30c743138ed29cdf786cb18c41c24983fe1,/Users/sanika/Downloads/Master Thesis/repo_updated/pytest/src/_pytest/main.py,3484,ModificationType.MODIFY,712,438,573,51,9,84,763,14,102,71,128,116,199,733.8903537898989,1364.7382180303869,8.784313725490197,11988.28866034536,666.0160366858534,0.45491273934346227
d863c30c743138ed29cdf786cb18c41c24983fe1,/Users/sanika/Downloads/Master Thesis/repo_updated/pytest/testing/test_terminal.py,6223,ModificationType.MODIFY,1943,715,1694,26,18,214,1969,12,185,120,237,197,357,1436.3251202041715,2721.0724995459263,7.686486486486486,20915.486996509768,1161.971499806098,0.9070241665153088
d863c30c743138ed29cdf786cb18c41c24983fe1,/Users/sanika/Downloads/Master Thesis/repo_updated/pytest/src/_pytest/terminal.py,6223,ModificationType.MODIFY,1168,838,957,57,25,144,1225,19,348,224,416,367,640,3018.854959310786,5452.5672018196565,11.35632183908046,61921.107993078396,3440.061555171022,1.8175224006065522
d863c30c743138ed29cdf786cb18c41c24983fe1,/Users/sanika/Downloads/Master Thesis/repo_updated/pytest/testing/acceptance_test.py,4670,ModificationType.MODIFY,1289,550,1043,56,32,155,1345,10,167,93,185,177,278,1266.2978977920404,2075.9943429230734,5.538922155688622,11498.771061100855,638.8206145056031,0.6919981143076911
d863c30c743138ed29cdf786cb18c41c24983fe1,/Users/sanika/Downloads/Master Thesis/repo_updated/pytest/testing/python/collect.py,3928,ModificationType.MODIFY,1338,495,1086,10,64,173,1348,11,122,82,157,133,239,883.6037029876825,1686.2125020847843,7.077868852459017,11934.79094713288,663.0439415073822,0.5620708340282614
d863c30c743138ed29cdf786cb18c41c24983fe1,/Users/sanika/Downloads/Master Thesis/repo_updated/pytest/testing/python/fixtures.py,7999,ModificationType.MODIFY,4293,999,3693,19,54,507,4312,9,155,88,170,164,258,1156.3286078304877,1898.248417191466,4.935483870967742,9368.774446138526,520.4874692299181,0.6327494723971553
d863c30c743138ed29cdf786cb18c41c24983fe1,/Users/sanika/Downloads/Master Thesis/repo_updated/pytest/src/_pytest/fixtures.py,7999,ModificationType.MODIFY,1482,859,1002,125,135,219,1607,16,219,134,251,235,385,1766.678366052657,3032.459024427525,9.168949771689498,27804.464479682512,1544.692471093473,1.0108196748091751
d863c30c743138ed29cdf786cb18c41c24983fe1,/Users/sanika/Downloads/Master Thesis/repo_updated/pytest/testing/test_assertrewrite.py,6308,ModificationType.MODIFY,1660,832,1314,41,38,274,1701,20,312,209,395,332,604,2671.484054182769,5058.523816533542,12.66025641025641,64042.2085747035,3557.900476372417,1.6861746055111808
d863c30c743138ed29cdf786cb18c41c24983fe1,/Users/sanika/Downloads/Master Thesis/repo_updated/pytest/testing/test_capture.py,5072,ModificationType.MODIFY,1513,682,1277,25,13,200,1538,11,199,116,219,210,335,1557.7420472931965,2584.272248418151,6.052763819095477,15641.989563917903,868.9994202176613,0.8614240828060503
d863c30c743138ed29cdf786cb18c41c24983fe1,/Users/sanika/Downloads/Master Thesis/repo_updated/pytest/testing/test_collection.py,4935,ModificationType.MODIFY,1296,573,1062,40,33,157,1336,8,201,118,231,209,349,1561.8613899269646,2689.868337096228,4.597014925373134,12365.364892919973,686.9647162733319,0.896622779032076
d863c30c743138ed29cdf786cb18c41c24983fe1,/Users/sanika/Downloads/Master Thesis/repo_updated/pytest/testing/test_doctest.py,3715,ModificationType.MODIFY,1455,414,1257,16,76,112,1471,5,41,23,46,46,69,231.26927266377825,381.1257749679339,2.8048780487804876,1069.0113200320097,59.389517779556094,0.1270419249893113
d863c30c743138ed29cdf786cb18c41c24983fe1,/Users/sanika/Downloads/Master Thesis/repo_updated/pytest/testing/test_mark.py,3090,ModificationType.MODIFY,1020,354,843,12,15,144,1032,8,134,77,144,142,221,970.8559515213415,1580.0941134105349,4.298507462686567,6792.0463382422995,377.3359076801278,0.5266980378035117
d863c30c743138ed29cdf786cb18c41c24983fe1,/Users/sanika/Downloads/Master Thesis/repo_updated/pytest/testing/test_runner_xunit.py,463,ModificationType.MODIFY,295,56,236,0,4,54,295,2,9,5,10,11,15,30.529325012980813,51.89147427955947,1.1111111111111112,57.65719364395497,3.203177424664165,0.01729715809318649
d863c30c743138ed29cdf786cb18c41c24983fe1,/Users/sanika/Downloads/Master Thesis/repo_updated/pytest/testing/test_skipping.py,3068,ModificationType.MODIFY,1178,367,1042,6,15,115,1184,9,94,51,95,103,146,644.6606770706787,976.22907696875,4.547872340425532,4439.7652170653255,246.65362317029587,0.32540969232291667
d863c30c743138ed29cdf786cb18c41c24983fe1,/Users/sanika/Downloads/Master Thesis/repo_updated/pytest/testing/test_stepwise.py,645,ModificationType.MODIFY,219,78,157,11,5,46,230,3,24,20,34,27,54,114.79398751947123,256.76392511682735,2.125,545.6233408732581,30.31240782629212,0.08558797503894246
d863c30c743138ed29cdf786cb18c41c24983fe1,/Users/sanika/Downloads/Master Thesis/repo_updated/pytest/testing/test_terminal.py,6661,ModificationType.MODIFY,1943,715,1694,26,18,214,1969,12,185,120,237,197,357,1436.3251202041715,2721.0724995459263,7.686486486486486,20915.486996509768,1161.971499806098,0.9070241665153088
d863c30c743138ed29cdf786cb18c41c24983fe1,/Users/sanika/Downloads/Master Thesis/repo_updated/pytest/testing/test_warnings.py,1706,ModificationType.MODIFY,601,196,481,2,23,85,603,8,63,36,72,71,108,400.56863518049477,664.1726889065056,4.571428571428571,3036.21800642974,168.67877813498555,0.22139089630216854
820b747e7a14e441bb0e499eff51de65973252d0,/Users/sanika/Downloads/Master Thesis/repo_updated/pytest/testing/test_capture.py,4999,ModificationType.MODIFY,1513,682,1277,25,13,200,1538,11,199,116,219,210,335,1557.7420472931965,2584.272248418151,6.052763819095477,15641.989563917903,868.9994202176613,0.8614240828060503
716f532a3871ef45655c327f483f9b1897c4d73f,/Users/sanika/Downloads/Master Thesis/repo_updated/pytest/testing/test_pytester.py,5973,ModificationType.MODIFY,722,423,573,19,0,135,741,12,172,101,199,184,300,1320.3370878174146,2257.068586817104,6.941860465116279,15668.255189881524,870.4586216600846,0.7523561956057013
716f532a3871ef45655c327f483f9b1897c4d73f,/Users/sanika/Downloads/Master Thesis/repo_updated/pytest/src/_pytest/pytester.py,5973,ModificationType.MODIFY,1508,847,911,44,250,301,1552,14,148,88,169,162,257,1120.302067021891,1886.3414507413484,7.993243243243243,15077.986055587939,837.6658919771077,0.6287804835804495
ec273637481f7df64198539510b0b3e5c1e5e849,/Users/sanika/Downloads/Master Thesis/repo_updated/pytest/testing/test_pytester.py,6047,ModificationType.MODIFY,722,423,573,19,0,135,741,12,172,101,199,184,300,1320.3370878174146,2257.068586817104,6.941860465116279,15668.255189881524,870.4586216600846,0.7523561956057013
ec273637481f7df64198539510b0b3e5c1e5e849,/Users/sanika/Downloads/Master Thesis/repo_updated/pytest/src/_pytest/pytester.py,6047,ModificationType.MODIFY,1508,847,911,44,250,301,1552,14,148,88,169,162,257,1120.302067021891,1886.3414507413484,7.993243243243243,15077.986055587939,837.6658919771077,0.6287804835804495
ec273637481f7df64198539510b0b3e5c1e5e849,/Users/sanika/Downloads/Master Thesis/repo_updated/pytest/testing/test_pytester.py,3231,ModificationType.MODIFY,722,423,573,19,0,135,741,12,172,101,199,184,300,1320.3370878174146,2257.068586817104,6.941860465116279,15668.255189881524,870.4586216600846,0.7523561956057013
32412532ef58fbaf7a43a766e20fbf94da21feee,/Users/sanika/Downloads/Master Thesis/repo_updated/pytest/testing/python/approx.py,4366,ModificationType.MODIFY,520,294,400,33,13,81,553,10,261,204,367,271,571,2128.502746053614,4614.907102613061,7.030651340996169,32445.802809559264,1802.5446005310703,1.5383023675376872
a5bd19e3b406f45ffaadf7e1d257b90f11e5931f,/Users/sanika/Downloads/Master Thesis/repo_updated/pytest/testing/python/approx.py,4372,ModificationType.MODIFY,520,294,400,33,13,81,553,10,261,204,367,271,571,2128.502746053614,4614.907102613061,7.030651340996169,32445.802809559264,1802.5446005310703,1.5383023675376872
d6e324a5e640382bcfcf6b2abeb024577edc01c3,/Users/sanika/Downloads/Master Thesis/repo_updated/pytest/testing/conftest.py,400,ModificationType.MODIFY,127,75,83,2,11,30,129,4,14,7,14,18,21,61.30296890880645,87.56842503028855,2.0,175.1368500605771,9.729825003365395,0.029189475010096184
d6e324a5e640382bcfcf6b2abeb024577edc01c3,/Users/sanika/Downloads/Master Thesis/repo_updated/pytest/testing/test_conftest.py,400,ModificationType.MODIFY,652,304,544,16,6,88,668,6,89,51,101,95,152,591.8500503603364,998.6180524663041,3.404494382022472,3399.7895494077547,188.8771971893197,0.3328726841554347
d6e324a5e640382bcfcf6b2abeb024577edc01c3,/Users/sanika/Downloads/Master Thesis/repo_updated/pytest/testing/example_scripts/collect/package_infinite_recursion/conftest.py,400,ModificationType.MODIFY,2,2,2,0,0,0,2,0,0,0,0,0,0,0,0,0,0,0.0,0.0
d6e324a5e640382bcfcf6b2abeb024577edc01c3,/Users/sanika/Downloads/Master Thesis/repo_updated/pytest/testing/example_scripts/conftest_usageerror/conftest.py,400,ModificationType.MODIFY,8,5,5,0,0,3,8,0,0,0,0,0,0,0,0,0,0,0.0,0.0
d6e324a5e640382bcfcf6b2abeb024577edc01c3,/Users/sanika/Downloads/Master Thesis/repo_updated/pytest/testing/example_scripts/marks/marks_considered_keywords/conftest.py,400,ModificationType.MODIFY,0,0,0,0,0,0,0,0,0,0,0,0,0,0,0,0,0,0.0,0.0
d6e324a5e640382bcfcf6b2abeb024577edc01c3,/Users/sanika/Downloads/Master Thesis/repo_updated/pytest/testing/example_scripts/config/collect_pytest_prefix/conftest.py,400,ModificationType.MODIFY,2,2,2,0,0,0,2,0,0,0,0,0,0,0,0,0,0,0.0,0.0
d6e324a5e640382bcfcf6b2abeb024577edc01c3,/Users/sanika/Downloads/Master Thesis/repo_updated/pytest/testing/example_scripts/issue88_initial_file_multinodes/conftest.py,400,ModificationType.MODIFY,14,8,8,0,0,6,14,0,0,0,0,0,0,0,0,0,0,0.0,0.0
d6e324a5e640382bcfcf6b2abeb024577edc01c3,/Users/sanika/Downloads/Master Thesis/repo_updated/pytest/testing/example_scripts/fixtures/fill_fixtures/test_extend_fixture_conftest_conftest/conftest.py,400,ModificationType.MODIFY,6,4,4,0,0,2,6,0,0,0,0,0,0,0,0,0,0,0.0,0.0
d6e324a5e640382bcfcf6b2abeb024577edc01c3,/Users/sanika/Downloads/Master Thesis/repo_updated/pytest/testing/example_scripts/fixtures/fill_fixtures/test_extend_fixture_conftest_conftest/pkg/conftest.py,400,ModificationType.MODIFY,6,4,4,0,0,2,6,1,2,1,2,3,3,2.0,4.754887502163469,0.5,2.3774437510817346,0.1320802083934297,0.0015849625007211565
d6e324a5e640382bcfcf6b2abeb024577edc01c3,/Users/sanika/Downloads/Master Thesis/repo_updated/pytest/testing/example_scripts/fixtures/fill_fixtures/test_extend_fixture_conftest_module/conftest.py,400,ModificationType.MODIFY,6,4,4,0,0,2,6,0,0,0,0,0,0,0,0,0,0,0.0,0.0
d6e324a5e640382bcfcf6b2abeb024577edc01c3,/Users/sanika/Downloads/Master Thesis/repo_updated/pytest/testing/example_scripts/fixtures/fill_fixtures/test_conftest_funcargs_only_available_in_subdir/sub1/conftest.py,400,ModificationType.MODIFY,7,5,5,0,0,2,7,0,0,0,0,0,0,0,0,0,0,0.0,0.0
d6e324a5e640382bcfcf6b2abeb024577edc01c3,/Users/sanika/Downloads/Master Thesis/repo_updated/pytest/testing/example_scripts/fixtures/fill_fixtures/test_conftest_funcargs_only_available_in_subdir/sub2/conftest.py,400,ModificationType.MODIFY,6,4,4,0,0,2,6,0,0,0,0,0,0,0,0,0,0,0.0,0.0
d6e324a5e640382bcfcf6b2abeb024577edc01c3,/Users/sanika/Downloads/Master Thesis/repo_updated/pytest/testing/example_scripts/fixtures/custom_item/conftest.py,400,ModificationType.MODIFY,10,6,6,0,0,4,10,0,0,0,0,0,0,0,0,0,0,0.0,0.0
d6e324a5e640382bcfcf6b2abeb024577edc01c3,/Users/sanika/Downloads/Master Thesis/repo_updated/pytest/doc/en/conftest.py,400,ModificationType.MODIFY,1,1,1,0,0,0,1,0,0,0,0,0,0,0,0,0,0,0.0,0.0
d6e324a5e640382bcfcf6b2abeb024577edc01c3,/Users/sanika/Downloads/Master Thesis/repo_updated/pytest/doc/en/example/conftest.py,400,ModificationType.MODIFY,1,1,1,0,0,0,1,0,0,0,0,0,0,0,0,0,0,0.0,0.0
d6e324a5e640382bcfcf6b2abeb024577edc01c3,/Users/sanika/Downloads/Master Thesis/repo_updated/pytest/doc/en/example/assertion/global_testmodule_config/conftest.py,400,ModificationType.MODIFY,14,10,10,0,0,4,14,1,1,1,1,2,2,0.0,2.0,0.5,1.0,0.05555555555555555,0.0006666666666666666
d6e324a5e640382bcfcf6b2abeb024577edc01c3,/Users/sanika/Downloads/Master Thesis/repo_updated/pytest/doc/en/example/nonpython/conftest.py,400,ModificationType.MODIFY,46,26,30,3,0,12,49,3,6,3,6,9,9,20.264662506490406,28.529325012980813,1.5,42.793987519471216,2.377443751081734,0.009509775004326938
a4554e666af4d62500bec2bae393fc9e67e2d4d8,/Users/sanika/Downloads/Master Thesis/repo_updated/pytest/testing/test_faulthandler.py,310,ModificationType.MODIFY,103,47,73,2,12,15,105,5,16,9,17,21,26,75.60964047443682,114.20025299224778,2.65625,303.34442201065815,16.85246788948101,0.03806675099741593
7f8bf4d9f6de201ace76162c62217a8f72661b40,/Users/sanika/Downloads/Master Thesis/repo_updated/pytest/testing/test_pathlib.py,1550,ModificationType.MODIFY,91,45,69,0,3,18,91,3,9,6,10,12,16,33.28421251514428,57.359400011538504,1.6666666666666667,95.59900001923084,5.311055556623936,0.01911980000384617
7f8bf4d9f6de201ace76162c62217a8f72661b40,/Users/sanika/Downloads/Master Thesis/repo_updated/pytest/src/_pytest/pathlib.py,1550,ModificationType.MODIFY,367,234,237,17,34,68,384,16,55,34,61,71,95,381.9747842438563,584.2259763529448,8.872727272727273,5183.677753822492,287.9820974345829,0.19474199211764828
7f8bf4d9f6de201ace76162c62217a8f72661b40,/Users/sanika/Downloads/Master Thesis/repo_updated/pytest/testing/test_tmpdir.py,704,ModificationType.MODIFY,442,244,305,14,16,103,456,11,68,45,75,79,120,452.0012210100334,756.4536897812524,6.0661764705882355,4588.781574040686,254.932309668927,0.2521512299270841
7f8bf4d9f6de201ace76162c62217a8f72661b40,/Users/sanika/Downloads/Master Thesis/repo_updated/pytest/src/_pytest/tmpdir.py,704,ModificationType.MODIFY,182,102,99,11,40,35,193,3,11,6,11,14,17,42.808635307173745,64.72503367497926,1.5,97.08755051246888,5.393752806248271,0.021575011224993085
60ceec6eb180ba1ac76741edf82804ed9ae8baf2,/Users/sanika/Downloads/Master Thesis/repo_updated/pytest/testing/test_capture.py,5072,ModificationType.MODIFY,1513,682,1277,25,13,200,1538,11,199,116,219,210,335,1557.7420472931965,2584.272248418151,6.052763819095477,15641.989563917903,868.9994202176613,0.8614240828060503
6d33f4cdce6db22a00810736fb4028a6c7eab2fa,/Users/sanika/Downloads/Master Thesis/repo_updated/pytest/testing/conftest.py,400,ModificationType.MODIFY,127,75,83,2,11,30,129,4,14,7,14,18,21,61.30296890880645,87.56842503028855,2.0,175.1368500605771,9.729825003365395,0.029189475010096184
6d33f4cdce6db22a00810736fb4028a6c7eab2fa,/Users/sanika/Downloads/Master Thesis/repo_updated/pytest/testing/test_conftest.py,400,ModificationType.MODIFY,652,304,544,16,6,88,668,6,89,51,101,95,152,591.8500503603364,998.6180524663041,3.404494382022472,3399.7895494077547,188.8771971893197,0.3328726841554347
6d33f4cdce6db22a00810736fb4028a6c7eab2fa,/Users/sanika/Downloads/Master Thesis/repo_updated/pytest/testing/example_scripts/collect/package_infinite_recursion/conftest.py,400,ModificationType.MODIFY,2,2,2,0,0,0,2,0,0,0,0,0,0,0,0,0,0,0.0,0.0
6d33f4cdce6db22a00810736fb4028a6c7eab2fa,/Users/sanika/Downloads/Master Thesis/repo_updated/pytest/testing/example_scripts/conftest_usageerror/conftest.py,400,ModificationType.MODIFY,8,5,5,0,0,3,8,0,0,0,0,0,0,0,0,0,0,0.0,0.0
6d33f4cdce6db22a00810736fb4028a6c7eab2fa,/Users/sanika/Downloads/Master Thesis/repo_updated/pytest/testing/example_scripts/marks/marks_considered_keywords/conftest.py,400,ModificationType.MODIFY,0,0,0,0,0,0,0,0,0,0,0,0,0,0,0,0,0,0.0,0.0
6d33f4cdce6db22a00810736fb4028a6c7eab2fa,/Users/sanika/Downloads/Master Thesis/repo_updated/pytest/testing/example_scripts/config/collect_pytest_prefix/conftest.py,400,ModificationType.MODIFY,2,2,2,0,0,0,2,0,0,0,0,0,0,0,0,0,0,0.0,0.0
6d33f4cdce6db22a00810736fb4028a6c7eab2fa,/Users/sanika/Downloads/Master Thesis/repo_updated/pytest/testing/example_scripts/issue88_initial_file_multinodes/conftest.py,400,ModificationType.MODIFY,14,8,8,0,0,6,14,0,0,0,0,0,0,0,0,0,0,0.0,0.0
6d33f4cdce6db22a00810736fb4028a6c7eab2fa,/Users/sanika/Downloads/Master Thesis/repo_updated/pytest/testing/example_scripts/fixtures/fill_fixtures/test_extend_fixture_conftest_conftest/conftest.py,400,ModificationType.MODIFY,6,4,4,0,0,2,6,0,0,0,0,0,0,0,0,0,0,0.0,0.0
6d33f4cdce6db22a00810736fb4028a6c7eab2fa,/Users/sanika/Downloads/Master Thesis/repo_updated/pytest/testing/example_scripts/fixtures/fill_fixtures/test_extend_fixture_conftest_conftest/pkg/conftest.py,400,ModificationType.MODIFY,6,4,4,0,0,2,6,1,2,1,2,3,3,2.0,4.754887502163469,0.5,2.3774437510817346,0.1320802083934297,0.0015849625007211565
6d33f4cdce6db22a00810736fb4028a6c7eab2fa,/Users/sanika/Downloads/Master Thesis/repo_updated/pytest/testing/example_scripts/fixtures/fill_fixtures/test_extend_fixture_conftest_module/conftest.py,400,ModificationType.MODIFY,6,4,4,0,0,2,6,0,0,0,0,0,0,0,0,0,0,0.0,0.0
6d33f4cdce6db22a00810736fb4028a6c7eab2fa,/Users/sanika/Downloads/Master Thesis/repo_updated/pytest/testing/example_scripts/fixtures/fill_fixtures/test_conftest_funcargs_only_available_in_subdir/sub1/conftest.py,400,ModificationType.MODIFY,7,5,5,0,0,2,7,0,0,0,0,0,0,0,0,0,0,0.0,0.0
6d33f4cdce6db22a00810736fb4028a6c7eab2fa,/Users/sanika/Downloads/Master Thesis/repo_updated/pytest/testing/example_scripts/fixtures/fill_fixtures/test_conftest_funcargs_only_available_in_subdir/sub2/conftest.py,400,ModificationType.MODIFY,6,4,4,0,0,2,6,0,0,0,0,0,0,0,0,0,0,0.0,0.0
6d33f4cdce6db22a00810736fb4028a6c7eab2fa,/Users/sanika/Downloads/Master Thesis/repo_updated/pytest/testing/example_scripts/fixtures/custom_item/conftest.py,400,ModificationType.MODIFY,10,6,6,0,0,4,10,0,0,0,0,0,0,0,0,0,0,0.0,0.0
6d33f4cdce6db22a00810736fb4028a6c7eab2fa,/Users/sanika/Downloads/Master Thesis/repo_updated/pytest/doc/en/conftest.py,400,ModificationType.MODIFY,1,1,1,0,0,0,1,0,0,0,0,0,0,0,0,0,0,0.0,0.0
6d33f4cdce6db22a00810736fb4028a6c7eab2fa,/Users/sanika/Downloads/Master Thesis/repo_updated/pytest/doc/en/example/conftest.py,400,ModificationType.MODIFY,1,1,1,0,0,0,1,0,0,0,0,0,0,0,0,0,0,0.0,0.0
6d33f4cdce6db22a00810736fb4028a6c7eab2fa,/Users/sanika/Downloads/Master Thesis/repo_updated/pytest/doc/en/example/assertion/global_testmodule_config/conftest.py,400,ModificationType.MODIFY,14,10,10,0,0,4,14,1,1,1,1,2,2,0.0,2.0,0.5,1.0,0.05555555555555555,0.0006666666666666666
6d33f4cdce6db22a00810736fb4028a6c7eab2fa,/Users/sanika/Downloads/Master Thesis/repo_updated/pytest/doc/en/example/nonpython/conftest.py,400,ModificationType.MODIFY,46,26,30,3,0,12,49,3,6,3,6,9,9,20.264662506490406,28.529325012980813,1.5,42.793987519471216,2.377443751081734,0.009509775004326938
e7898dedf40c294faceee25963183c61c745e976,/Users/sanika/Downloads/Master Thesis/repo_updated/pytest/testing/test_capture.py,5072,ModificationType.MODIFY,1513,682,1277,25,13,200,1538,11,199,116,219,210,335,1557.7420472931965,2584.272248418151,6.052763819095477,15641.989563917903,868.9994202176613,0.8614240828060503
cdc53da19c586e62fc17900c77165fcb1592257c,/Users/sanika/Downloads/Master Thesis/repo_updated/pytest/testing/test_main.py,3484,ModificationType.MODIFY,77,34,69,0,0,8,77,3,24,16,29,27,45,114.79398751947123,213.9699375973561,1.8125,387.82051189520797,21.54558399417822,0.07132331253245204
cdc53da19c586e62fc17900c77165fcb1592257c,/Users/sanika/Downloads/Master Thesis/repo_updated/pytest/src/_pytest/main.py,3484,ModificationType.MODIFY,712,438,573,51,9,84,763,14,102,71,128,116,199,733.8903537898989,1364.7382180303869,8.784313725490197,11988.28866034536,666.0160366858534,0.45491273934346227
cdc53da19c586e62fc17900c77165fcb1592257c,/Users/sanika/Downloads/Master Thesis/repo_updated/pytest/testing/test_terminal.py,6223,ModificationType.MODIFY,1943,715,1694,26,18,214,1969,12,185,120,237,197,357,1436.3251202041715,2721.0724995459263,7.686486486486486,20915.486996509768,1161.971499806098,0.9070241665153088
cdc53da19c586e62fc17900c77165fcb1592257c,/Users/sanika/Downloads/Master Thesis/repo_updated/pytest/src/_pytest/terminal.py,6223,ModificationType.MODIFY,1168,838,957,57,25,144,1225,19,348,224,416,367,640,3018.854959310786,5452.5672018196565,11.35632183908046,61921.107993078396,3440.061555171022,1.8175224006065522
cdc53da19c586e62fc17900c77165fcb1592257c,/Users/sanika/Downloads/Master Thesis/repo_updated/pytest/testing/acceptance_test.py,4670,ModificationType.MODIFY,1289,550,1043,56,32,155,1345,10,167,93,185,177,278,1266.2978977920404,2075.9943429230734,5.538922155688622,11498.771061100855,638.8206145056031,0.6919981143076911
cdc53da19c586e62fc17900c77165fcb1592257c,/Users/sanika/Downloads/Master Thesis/repo_updated/pytest/testing/python/collect.py,3928,ModificationType.MODIFY,1338,495,1086,10,64,173,1348,11,122,82,157,133,239,883.6037029876825,1686.2125020847843,7.077868852459017,11934.79094713288,663.0439415073822,0.5620708340282614
cdc53da19c586e62fc17900c77165fcb1592257c,/Users/sanika/Downloads/Master Thesis/repo_updated/pytest/testing/python/fixtures.py,7999,ModificationType.MODIFY,4293,999,3693,19,54,507,4312,9,155,88,170,164,258,1156.3286078304877,1898.248417191466,4.935483870967742,9368.774446138526,520.4874692299181,0.6327494723971553
cdc53da19c586e62fc17900c77165fcb1592257c,/Users/sanika/Downloads/Master Thesis/repo_updated/pytest/src/_pytest/fixtures.py,7999,ModificationType.MODIFY,1482,859,1002,125,135,219,1607,16,219,134,251,235,385,1766.678366052657,3032.459024427525,9.168949771689498,27804.464479682512,1544.692471093473,1.0108196748091751
cdc53da19c586e62fc17900c77165fcb1592257c,/Users/sanika/Downloads/Master Thesis/repo_updated/pytest/testing/test_assertrewrite.py,6308,ModificationType.MODIFY,1660,832,1314,41,38,274,1701,20,312,209,395,332,604,2671.484054182769,5058.523816533542,12.66025641025641,64042.2085747035,3557.900476372417,1.6861746055111808
cdc53da19c586e62fc17900c77165fcb1592257c,/Users/sanika/Downloads/Master Thesis/repo_updated/pytest/testing/test_capture.py,5072,ModificationType.MODIFY,1513,682,1277,25,13,200,1538,11,199,116,219,210,335,1557.7420472931965,2584.272248418151,6.052763819095477,15641.989563917903,868.9994202176613,0.8614240828060503
cdc53da19c586e62fc17900c77165fcb1592257c,/Users/sanika/Downloads/Master Thesis/repo_updated/pytest/testing/test_collection.py,4935,ModificationType.MODIFY,1296,573,1062,40,33,157,1336,8,201,118,231,209,349,1561.8613899269646,2689.868337096228,4.597014925373134,12365.364892919973,686.9647162733319,0.896622779032076
cdc53da19c586e62fc17900c77165fcb1592257c,/Users/sanika/Downloads/Master Thesis/repo_updated/pytest/testing/test_doctest.py,3715,ModificationType.MODIFY,1455,414,1257,16,76,112,1471,5,41,23,46,46,69,231.26927266377825,381.1257749679339,2.8048780487804876,1069.0113200320097,59.389517779556094,0.1270419249893113
cdc53da19c586e62fc17900c77165fcb1592257c,/Users/sanika/Downloads/Master Thesis/repo_updated/pytest/testing/test_mark.py,3090,ModificationType.MODIFY,1020,354,843,12,15,144,1032,8,134,77,144,142,221,970.8559515213415,1580.0941134105349,4.298507462686567,6792.0463382422995,377.3359076801278,0.5266980378035117
cdc53da19c586e62fc17900c77165fcb1592257c,/Users/sanika/Downloads/Master Thesis/repo_updated/pytest/testing/test_runner_xunit.py,463,ModificationType.MODIFY,295,56,236,0,4,54,295,2,9,5,10,11,15,30.529325012980813,51.89147427955947,1.1111111111111112,57.65719364395497,3.203177424664165,0.01729715809318649
cdc53da19c586e62fc17900c77165fcb1592257c,/Users/sanika/Downloads/Master Thesis/repo_updated/pytest/testing/test_skipping.py,3068,ModificationType.MODIFY,1178,367,1042,6,15,115,1184,9,94,51,95,103,146,644.6606770706787,976.22907696875,4.547872340425532,4439.7652170653255,246.65362317029587,0.32540969232291667
cdc53da19c586e62fc17900c77165fcb1592257c,/Users/sanika/Downloads/Master Thesis/repo_updated/pytest/testing/test_stepwise.py,645,ModificationType.MODIFY,219,78,157,11,5,46,230,3,24,20,34,27,54,114.79398751947123,256.76392511682735,2.125,545.6233408732581,30.31240782629212,0.08558797503894246
cdc53da19c586e62fc17900c77165fcb1592257c,/Users/sanika/Downloads/Master Thesis/repo_updated/pytest/testing/test_terminal.py,6661,ModificationType.MODIFY,1943,715,1694,26,18,214,1969,12,185,120,237,197,357,1436.3251202041715,2721.0724995459263,7.686486486486486,20915.486996509768,1161.971499806098,0.9070241665153088
cdc53da19c586e62fc17900c77165fcb1592257c,/Users/sanika/Downloads/Master Thesis/repo_updated/pytest/testing/test_warnings.py,1706,ModificationType.MODIFY,601,196,481,2,23,85,603,8,63,36,72,71,108,400.56863518049477,664.1726889065056,4.571428571428571,3036.21800642974,168.67877813498555,0.22139089630216854
6d2cabae5752d7bf8e7f5b1b1c43ee41ec1ac067,/Users/sanika/Downloads/Master Thesis/repo_updated/pytest/testing/test_skipping.py,786,ModificationType.MODIFY,1178,367,1042,6,15,115,1184,9,94,51,95,103,146,644.6606770706787,976.22907696875,4.547872340425532,4439.7652170653255,246.65362317029587,0.32540969232291667
6d2cabae5752d7bf8e7f5b1b1c43ee41ec1ac067,/Users/sanika/Downloads/Master Thesis/repo_updated/pytest/src/_pytest/skipping.py,786,ModificationType.MODIFY,177,108,140,8,0,27,185,6,30,16,32,36,48,162.7164928725825,248.15640006923098,3.2,794.1004802215392,44.11669334564107,0.082718800023077
6d2cabae5752d7bf8e7f5b1b1c43ee41ec1ac067,/Users/sanika/Downloads/Master Thesis/repo_updated/pytest/testing/test_terminal.py,6221,ModificationType.MODIFY,1943,715,1694,26,18,214,1969,12,185,120,237,197,357,1436.3251202041715,2721.0724995459263,7.686486486486486,20915.486996509768,1161.971499806098,0.9070241665153088
6d2cabae5752d7bf8e7f5b1b1c43ee41ec1ac067,/Users/sanika/Downloads/Master Thesis/repo_updated/pytest/src/_pytest/terminal.py,6221,ModificationType.MODIFY,1168,838,957,57,25,144,1225,19,348,224,416,367,640,3018.854959310786,5452.5672018196565,11.35632183908046,61921.107993078396,3440.061555171022,1.8175224006065522
6d2cabae5752d7bf8e7f5b1b1c43ee41ec1ac067,/Users/sanika/Downloads/Master Thesis/repo_updated/pytest/testing/test_skipping.py,3071,ModificationType.MODIFY,1178,367,1042,6,15,115,1184,9,94,51,95,103,146,644.6606770706787,976.22907696875,4.547872340425532,4439.7652170653255,246.65362317029587,0.32540969232291667
8c21416798af488da173b2b1c98b5435c0865660,/Users/sanika/Downloads/Master Thesis/repo_updated/pytest/testing/test_capture.py,5079,ModificationType.MODIFY,1513,682,1277,25,13,200,1538,11,199,116,219,210,335,1557.7420472931965,2584.272248418151,6.052763819095477,15641.989563917903,868.9994202176613,0.8614240828060503
b99661b9d77fbbc9ecb70d48a61a2a88eb0cd055,/Users/sanika/Downloads/Master Thesis/repo_updated/pytest/testing/example_scripts/collect/package_infinite_recursion/__init__.pyi,5071,ModificationType.MODIFY,0,0,0,0,0,0,0,0,0,0,0,0,0,0,0,0,0,0.0,0.0
b99661b9d77fbbc9ecb70d48a61a2a88eb0cd055,/Users/sanika/Downloads/Master Thesis/repo_updated/pytest/testing/example_scripts/collect/package_infinite_recursion/tests/__init__.py,5071,ModificationType.MODIFY,0,0,0,0,0,0,0,0,0,0,0,0,0,0,0,0,0,0.0,0.0
b99661b9d77fbbc9ecb70d48a61a2a88eb0cd055,/Users/sanika/Downloads/Master Thesis/repo_updated/pytest/testing/example_scripts/collect/collect_init_tests/tests/__init__.py,5071,ModificationType.MODIFY,2,2,2,0,0,0,2,0,0,0,0,0,0,0,0,0,0,0.0,0.0
b99661b9d77fbbc9ecb70d48a61a2a88eb0cd055,/Users/sanika/Downloads/Master Thesis/repo_updated/pytest/testing/example_scripts/collect/package_init_given_as_arg/pkg/__init__.py,5071,ModificationType.MODIFY,0,0,0,0,0,0,0,0,0,0,0,0,0,0,0,0,0,0.0,0.0
b99661b9d77fbbc9ecb70d48a61a2a88eb0cd055,/Users/sanika/Downloads/Master Thesis/repo_updated/pytest/testing/example_scripts/conftest_usageerror/__init__.pyi,5071,ModificationType.MODIFY,0,0,0,0,0,0,0,0,0,0,0,0,0,0,0,0,0,0.0,0.0
b99661b9d77fbbc9ecb70d48a61a2a88eb0cd055,/Users/sanika/Downloads/Master Thesis/repo_updated/pytest/testing/example_scripts/marks/marks_considered_keywords/__init__.pyi,5071,ModificationType.MODIFY,0,0,0,0,0,0,0,0,0,0,0,0,0,0,0,0,0,0.0,0.0
b99661b9d77fbbc9ecb70d48a61a2a88eb0cd055,/Users/sanika/Downloads/Master Thesis/repo_updated/pytest/testing/example_scripts/config/collect_pytest_prefix/__init__.pyi,5071,ModificationType.MODIFY,0,0,0,0,0,0,0,0,0,0,0,0,0,0,0,0,0,0.0,0.0
b99661b9d77fbbc9ecb70d48a61a2a88eb0cd055,/Users/sanika/Downloads/Master Thesis/repo_updated/pytest/testing/example_scripts/issue88_initial_file_multinodes/__init__.pyi,5071,ModificationType.MODIFY,0,0,0,0,0,0,0,0,0,0,0,0,0,0,0,0,0,0.0,0.0
b99661b9d77fbbc9ecb70d48a61a2a88eb0cd055,/Users/sanika/Downloads/Master Thesis/repo_updated/pytest/testing/example_scripts/fixtures/fill_fixtures/test_extend_fixture_conftest_conftest/__init__.pyi,5071,ModificationType.MODIFY,0,0,0,0,0,0,0,0,0,0,0,0,0,0,0,0,0,0.0,0.0
b99661b9d77fbbc9ecb70d48a61a2a88eb0cd055,/Users/sanika/Downloads/Master Thesis/repo_updated/pytest/testing/example_scripts/fixtures/fill_fixtures/test_extend_fixture_conftest_conftest/pkg/__init__.py,5071,ModificationType.MODIFY,0,0,0,0,0,0,0,0,0,0,0,0,0,0,0,0,0,0.0,0.0
b99661b9d77fbbc9ecb70d48a61a2a88eb0cd055,/Users/sanika/Downloads/Master Thesis/repo_updated/pytest/testing/example_scripts/fixtures/fill_fixtures/test_extend_fixture_conftest_module/__init__.pyi,5071,ModificationType.MODIFY,0,0,0,0,0,0,0,0,0,0,0,0,0,0,0,0,0,0.0,0.0
b99661b9d77fbbc9ecb70d48a61a2a88eb0cd055,/Users/sanika/Downloads/Master Thesis/repo_updated/pytest/testing/example_scripts/fixtures/fill_fixtures/test_conftest_funcargs_only_available_in_subdir/sub1/__init__.py,5071,ModificationType.MODIFY,0,0,0,0,0,0,0,0,0,0,0,0,0,0,0,0,0,0.0,0.0
b99661b9d77fbbc9ecb70d48a61a2a88eb0cd055,/Users/sanika/Downloads/Master Thesis/repo_updated/pytest/testing/example_scripts/fixtures/fill_fixtures/test_conftest_funcargs_only_available_in_subdir/sub2/__init__.py,5071,ModificationType.MODIFY,0,0,0,0,0,0,0,0,0,0,0,0,0,0,0,0,0,0.0,0.0
b99661b9d77fbbc9ecb70d48a61a2a88eb0cd055,/Users/sanika/Downloads/Master Thesis/repo_updated/pytest/testing/example_scripts/fixtures/custom_item/__init__.pyi,5071,ModificationType.MODIFY,0,0,0,0,0,0,0,0,0,0,0,0,0,0,0,0,0,0.0,0.0
b99661b9d77fbbc9ecb70d48a61a2a88eb0cd055,/Users/sanika/Downloads/Master Thesis/repo_updated/pytest/testing/example_scripts/fixtures/custom_item/foo/__init__.py,5071,ModificationType.MODIFY,0,0,0,0,0,0,0,0,0,0,0,0,0,0,0,0,0,0.0,0.0
b99661b9d77fbbc9ecb70d48a61a2a88eb0cd055,/Users/sanika/Downloads/Master Thesis/repo_updated/pytest/doc/en/example/nonpython/__init__.py,5071,ModificationType.MODIFY,0,0,0,0,0,0,0,0,0,0,0,0,0,0,0,0,0,0.0,0.0
b99661b9d77fbbc9ecb70d48a61a2a88eb0cd055,/Users/sanika/Downloads/Master Thesis/repo_updated/pytest/src/pytest/__init__.py,5071,ModificationType.MODIFY,99,48,90,1,3,5,100,0,0,0,0,0,0,0,0,0,0,0.0,0.0
b99661b9d77fbbc9ecb70d48a61a2a88eb0cd055,/Users/sanika/Downloads/Master Thesis/repo_updated/pytest/src/_pytest/__init__.py,5071,ModificationType.MODIFY,8,5,5,2,0,1,10,0,0,0,0,0,0,0,0,0,0,0.0,0.0
b99661b9d77fbbc9ecb70d48a61a2a88eb0cd055,/Users/sanika/Downloads/Master Thesis/repo_updated/pytest/src/_pytest/config/__init__.py,5071,ModificationType.MODIFY,1217,716,841,84,126,174,1301,14,185,118,215,199,333,1446.608539104324,2542.995998641035,8.135135135135135,20687.616097052745,1149.3120053918192,0.847665332880345
b99661b9d77fbbc9ecb70d48a61a2a88eb0cd055,/Users/sanika/Downloads/Master Thesis/repo_updated/pytest/src/_pytest/mark/__init__.py,5071,ModificationType.MODIFY,160,89,115,0,13,31,160,7,15,11,17,22,28,78.25484338853101,124.86408532184433,3.966666666666667,495.2942051099825,27.51634472833236,0.04162136177394811
b99661b9d77fbbc9ecb70d48a61a2a88eb0cd055,/Users/sanika/Downloads/Master Thesis/repo_updated/pytest/src/_pytest/_code/__init__.py,5071,ModificationType.MODIFY,10,10,9,9,0,0,19,0,0,0,0,0,0,0,0,0,0,0.0,0.0
b99661b9d77fbbc9ecb70d48a61a2a88eb0cd055,/Users/sanika/Downloads/Master Thesis/repo_updated/pytest/src/_pytest/assertion/__init__.py,5071,ModificationType.MODIFY,173,84,99,8,29,36,181,5,12,7,13,17,20,54.62919048309069,81.7492568250068,2.7083333333333335,221.4042372343934,12.300235401910745,0.027249752275002266
b99661b9d77fbbc9ecb70d48a61a2a88eb0cd055,/Users/sanika/Downloads/Master Thesis/repo_updated/pytest/src/_pytest/_io/__init__.py,5071,ModificationType.MODIFY,3,1,1,3,0,0,6,0,0,0,0,0,0,0,0,0,0,0.0,0.0
b99661b9d77fbbc9ecb70d48a61a2a88eb0cd055,/Users/sanika/Downloads/Master Thesis/repo_updated/pytest/testing/test_reports.py,1942,ModificationType.MODIFY,466,257,367,18,25,50,484,7,126,86,171,133,257,898.7887548153927,1813.2075859238057,4.75,8612.736033138077,478.4853351743376,0.6044025286412685
b99661b9d77fbbc9ecb70d48a61a2a88eb0cd055,/Users/sanika/Downloads/Master Thesis/repo_updated/pytest/src/_pytest/reports.py,1942,ModificationType.MODIFY,507,281,342,29,59,88,536,10,53,29,57,63,86,336.79906504072324,514.0460734209928,5.377358490566038,2764.2100174525085,153.56722319180602,0.17134869114033094
b99661b9d77fbbc9ecb70d48a61a2a88eb0cd055,/Users/sanika/Downloads/Master Thesis/repo_updated/pytest/testing/test_reports.py,1843,ModificationType.MODIFY,466,257,367,18,25,50,484,7,126,86,171,133,257,898.7887548153927,1813.2075859238057,4.75,8612.736033138077,478.4853351743376,0.6044025286412685
09096f74368a45b0d23181f3120cfe78aef9363f,/Users/sanika/Downloads/Master Thesis/repo_updated/pytest/src/_pytest/hookspec.py,640,ModificationType.MODIFY,647,139,84,35,284,233,682,0,0,0,0,0,0,0,0,0,0,0.0,0.0
34068572848c166f499a1ed7671972688560c97a,/Users/sanika/Downloads/Master Thesis/repo_updated/pytest/testing/example_scripts/collect/package_infinite_recursion/__init__.pyi,5071,ModificationType.MODIFY,0,0,0,0,0,0,0,0,0,0,0,0,0,0,0,0,0,0.0,0.0
34068572848c166f499a1ed7671972688560c97a,/Users/sanika/Downloads/Master Thesis/repo_updated/pytest/testing/example_scripts/collect/package_infinite_recursion/tests/__init__.py,5071,ModificationType.MODIFY,0,0,0,0,0,0,0,0,0,0,0,0,0,0,0,0,0,0.0,0.0
34068572848c166f499a1ed7671972688560c97a,/Users/sanika/Downloads/Master Thesis/repo_updated/pytest/testing/example_scripts/collect/collect_init_tests/tests/__init__.py,5071,ModificationType.MODIFY,2,2,2,0,0,0,2,0,0,0,0,0,0,0,0,0,0,0.0,0.0
34068572848c166f499a1ed7671972688560c97a,/Users/sanika/Downloads/Master Thesis/repo_updated/pytest/testing/example_scripts/collect/package_init_given_as_arg/pkg/__init__.py,5071,ModificationType.MODIFY,0,0,0,0,0,0,0,0,0,0,0,0,0,0,0,0,0,0.0,0.0
34068572848c166f499a1ed7671972688560c97a,/Users/sanika/Downloads/Master Thesis/repo_updated/pytest/testing/example_scripts/conftest_usageerror/__init__.pyi,5071,ModificationType.MODIFY,0,0,0,0,0,0,0,0,0,0,0,0,0,0,0,0,0,0.0,0.0
34068572848c166f499a1ed7671972688560c97a,/Users/sanika/Downloads/Master Thesis/repo_updated/pytest/testing/example_scripts/marks/marks_considered_keywords/__init__.pyi,5071,ModificationType.MODIFY,0,0,0,0,0,0,0,0,0,0,0,0,0,0,0,0,0,0.0,0.0
34068572848c166f499a1ed7671972688560c97a,/Users/sanika/Downloads/Master Thesis/repo_updated/pytest/testing/example_scripts/config/collect_pytest_prefix/__init__.pyi,5071,ModificationType.MODIFY,0,0,0,0,0,0,0,0,0,0,0,0,0,0,0,0,0,0.0,0.0
34068572848c166f499a1ed7671972688560c97a,/Users/sanika/Downloads/Master Thesis/repo_updated/pytest/testing/example_scripts/issue88_initial_file_multinodes/__init__.pyi,5071,ModificationType.MODIFY,0,0,0,0,0,0,0,0,0,0,0,0,0,0,0,0,0,0.0,0.0
34068572848c166f499a1ed7671972688560c97a,/Users/sanika/Downloads/Master Thesis/repo_updated/pytest/testing/example_scripts/fixtures/fill_fixtures/test_extend_fixture_conftest_conftest/__init__.pyi,5071,ModificationType.MODIFY,0,0,0,0,0,0,0,0,0,0,0,0,0,0,0,0,0,0.0,0.0
34068572848c166f499a1ed7671972688560c97a,/Users/sanika/Downloads/Master Thesis/repo_updated/pytest/testing/example_scripts/fixtures/fill_fixtures/test_extend_fixture_conftest_conftest/pkg/__init__.py,5071,ModificationType.MODIFY,0,0,0,0,0,0,0,0,0,0,0,0,0,0,0,0,0,0.0,0.0
34068572848c166f499a1ed7671972688560c97a,/Users/sanika/Downloads/Master Thesis/repo_updated/pytest/testing/example_scripts/fixtures/fill_fixtures/test_extend_fixture_conftest_module/__init__.pyi,5071,ModificationType.MODIFY,0,0,0,0,0,0,0,0,0,0,0,0,0,0,0,0,0,0.0,0.0
34068572848c166f499a1ed7671972688560c97a,/Users/sanika/Downloads/Master Thesis/repo_updated/pytest/testing/example_scripts/fixtures/fill_fixtures/test_conftest_funcargs_only_available_in_subdir/sub1/__init__.py,5071,ModificationType.MODIFY,0,0,0,0,0,0,0,0,0,0,0,0,0,0,0,0,0,0.0,0.0
34068572848c166f499a1ed7671972688560c97a,/Users/sanika/Downloads/Master Thesis/repo_updated/pytest/testing/example_scripts/fixtures/fill_fixtures/test_conftest_funcargs_only_available_in_subdir/sub2/__init__.py,5071,ModificationType.MODIFY,0,0,0,0,0,0,0,0,0,0,0,0,0,0,0,0,0,0.0,0.0
34068572848c166f499a1ed7671972688560c97a,/Users/sanika/Downloads/Master Thesis/repo_updated/pytest/testing/example_scripts/fixtures/custom_item/__init__.pyi,5071,ModificationType.MODIFY,0,0,0,0,0,0,0,0,0,0,0,0,0,0,0,0,0,0.0,0.0
34068572848c166f499a1ed7671972688560c97a,/Users/sanika/Downloads/Master Thesis/repo_updated/pytest/testing/example_scripts/fixtures/custom_item/foo/__init__.py,5071,ModificationType.MODIFY,0,0,0,0,0,0,0,0,0,0,0,0,0,0,0,0,0,0.0,0.0
34068572848c166f499a1ed7671972688560c97a,/Users/sanika/Downloads/Master Thesis/repo_updated/pytest/doc/en/example/nonpython/__init__.py,5071,ModificationType.MODIFY,0,0,0,0,0,0,0,0,0,0,0,0,0,0,0,0,0,0.0,0.0
34068572848c166f499a1ed7671972688560c97a,/Users/sanika/Downloads/Master Thesis/repo_updated/pytest/src/pytest/__init__.py,5071,ModificationType.MODIFY,99,48,90,1,3,5,100,0,0,0,0,0,0,0,0,0,0,0.0,0.0
34068572848c166f499a1ed7671972688560c97a,/Users/sanika/Downloads/Master Thesis/repo_updated/pytest/src/_pytest/__init__.py,5071,ModificationType.MODIFY,8,5,5,2,0,1,10,0,0,0,0,0,0,0,0,0,0,0.0,0.0
34068572848c166f499a1ed7671972688560c97a,/Users/sanika/Downloads/Master Thesis/repo_updated/pytest/src/_pytest/config/__init__.py,5071,ModificationType.MODIFY,1217,716,841,84,126,174,1301,14,185,118,215,199,333,1446.608539104324,2542.995998641035,8.135135135135135,20687.616097052745,1149.3120053918192,0.847665332880345
34068572848c166f499a1ed7671972688560c97a,/Users/sanika/Downloads/Master Thesis/repo_updated/pytest/src/_pytest/mark/__init__.py,5071,ModificationType.MODIFY,160,89,115,0,13,31,160,7,15,11,17,22,28,78.25484338853101,124.86408532184433,3.966666666666667,495.2942051099825,27.51634472833236,0.04162136177394811
34068572848c166f499a1ed7671972688560c97a,/Users/sanika/Downloads/Master Thesis/repo_updated/pytest/src/_pytest/_code/__init__.py,5071,ModificationType.MODIFY,10,10,9,9,0,0,19,0,0,0,0,0,0,0,0,0,0,0.0,0.0
34068572848c166f499a1ed7671972688560c97a,/Users/sanika/Downloads/Master Thesis/repo_updated/pytest/src/_pytest/assertion/__init__.py,5071,ModificationType.MODIFY,173,84,99,8,29,36,181,5,12,7,13,17,20,54.62919048309069,81.7492568250068,2.7083333333333335,221.4042372343934,12.300235401910745,0.027249752275002266
34068572848c166f499a1ed7671972688560c97a,/Users/sanika/Downloads/Master Thesis/repo_updated/pytest/src/_pytest/_io/__init__.py,5071,ModificationType.MODIFY,3,1,1,3,0,0,6,0,0,0,0,0,0,0,0,0,0,0.0,0.0
34068572848c166f499a1ed7671972688560c97a,/Users/sanika/Downloads/Master Thesis/repo_updated/pytest/src/_pytest/hookspec.py,640,ModificationType.MODIFY,647,139,84,35,284,233,682,0,0,0,0,0,0,0,0,0,0,0.0,0.0
34068572848c166f499a1ed7671972688560c97a,/Users/sanika/Downloads/Master Thesis/repo_updated/pytest/testing/test_reports.py,1942,ModificationType.MODIFY,466,257,367,18,25,50,484,7,126,86,171,133,257,898.7887548153927,1813.2075859238057,4.75,8612.736033138077,478.4853351743376,0.6044025286412685
34068572848c166f499a1ed7671972688560c97a,/Users/sanika/Downloads/Master Thesis/repo_updated/pytest/src/_pytest/reports.py,1942,ModificationType.MODIFY,507,281,342,29,59,88,536,10,53,29,57,63,86,336.79906504072324,514.0460734209928,5.377358490566038,2764.2100174525085,153.56722319180602,0.17134869114033094
34068572848c166f499a1ed7671972688560c97a,/Users/sanika/Downloads/Master Thesis/repo_updated/pytest/testing/test_reports.py,1843,ModificationType.MODIFY,466,257,367,18,25,50,484,7,126,86,171,133,257,898.7887548153927,1813.2075859238057,4.75,8612.736033138077,478.4853351743376,0.6044025286412685
7a96d94fd4f98f725ce04f7ac45de041b521b86d,/Users/sanika/Downloads/Master Thesis/repo_updated/pytest/testing/example_scripts/collect/package_infinite_recursion/__init__.pyi,5056,ModificationType.MODIFY,0,0,0,0,0,0,0,0,0,0,0,0,0,0,0,0,0,0.0,0.0
7a96d94fd4f98f725ce04f7ac45de041b521b86d,/Users/sanika/Downloads/Master Thesis/repo_updated/pytest/testing/example_scripts/collect/package_infinite_recursion/tests/__init__.py,5056,ModificationType.MODIFY,0,0,0,0,0,0,0,0,0,0,0,0,0,0,0,0,0,0.0,0.0
7a96d94fd4f98f725ce04f7ac45de041b521b86d,/Users/sanika/Downloads/Master Thesis/repo_updated/pytest/testing/example_scripts/collect/collect_init_tests/tests/__init__.py,5056,ModificationType.MODIFY,2,2,2,0,0,0,2,0,0,0,0,0,0,0,0,0,0,0.0,0.0
7a96d94fd4f98f725ce04f7ac45de041b521b86d,/Users/sanika/Downloads/Master Thesis/repo_updated/pytest/testing/example_scripts/collect/package_init_given_as_arg/pkg/__init__.py,5056,ModificationType.MODIFY,0,0,0,0,0,0,0,0,0,0,0,0,0,0,0,0,0,0.0,0.0
7a96d94fd4f98f725ce04f7ac45de041b521b86d,/Users/sanika/Downloads/Master Thesis/repo_updated/pytest/testing/example_scripts/conftest_usageerror/__init__.pyi,5056,ModificationType.MODIFY,0,0,0,0,0,0,0,0,0,0,0,0,0,0,0,0,0,0.0,0.0
7a96d94fd4f98f725ce04f7ac45de041b521b86d,/Users/sanika/Downloads/Master Thesis/repo_updated/pytest/testing/example_scripts/marks/marks_considered_keywords/__init__.pyi,5056,ModificationType.MODIFY,0,0,0,0,0,0,0,0,0,0,0,0,0,0,0,0,0,0.0,0.0
7a96d94fd4f98f725ce04f7ac45de041b521b86d,/Users/sanika/Downloads/Master Thesis/repo_updated/pytest/testing/example_scripts/config/collect_pytest_prefix/__init__.pyi,5056,ModificationType.MODIFY,0,0,0,0,0,0,0,0,0,0,0,0,0,0,0,0,0,0.0,0.0
7a96d94fd4f98f725ce04f7ac45de041b521b86d,/Users/sanika/Downloads/Master Thesis/repo_updated/pytest/testing/example_scripts/issue88_initial_file_multinodes/__init__.pyi,5056,ModificationType.MODIFY,0,0,0,0,0,0,0,0,0,0,0,0,0,0,0,0,0,0.0,0.0
7a96d94fd4f98f725ce04f7ac45de041b521b86d,/Users/sanika/Downloads/Master Thesis/repo_updated/pytest/testing/example_scripts/fixtures/fill_fixtures/test_extend_fixture_conftest_conftest/__init__.pyi,5056,ModificationType.MODIFY,0,0,0,0,0,0,0,0,0,0,0,0,0,0,0,0,0,0.0,0.0
7a96d94fd4f98f725ce04f7ac45de041b521b86d,/Users/sanika/Downloads/Master Thesis/repo_updated/pytest/testing/example_scripts/fixtures/fill_fixtures/test_extend_fixture_conftest_conftest/pkg/__init__.py,5056,ModificationType.MODIFY,0,0,0,0,0,0,0,0,0,0,0,0,0,0,0,0,0,0.0,0.0
7a96d94fd4f98f725ce04f7ac45de041b521b86d,/Users/sanika/Downloads/Master Thesis/repo_updated/pytest/testing/example_scripts/fixtures/fill_fixtures/test_extend_fixture_conftest_module/__init__.pyi,5056,ModificationType.MODIFY,0,0,0,0,0,0,0,0,0,0,0,0,0,0,0,0,0,0.0,0.0
7a96d94fd4f98f725ce04f7ac45de041b521b86d,/Users/sanika/Downloads/Master Thesis/repo_updated/pytest/testing/example_scripts/fixtures/fill_fixtures/test_conftest_funcargs_only_available_in_subdir/sub1/__init__.py,5056,ModificationType.MODIFY,0,0,0,0,0,0,0,0,0,0,0,0,0,0,0,0,0,0.0,0.0
7a96d94fd4f98f725ce04f7ac45de041b521b86d,/Users/sanika/Downloads/Master Thesis/repo_updated/pytest/testing/example_scripts/fixtures/fill_fixtures/test_conftest_funcargs_only_available_in_subdir/sub2/__init__.py,5056,ModificationType.MODIFY,0,0,0,0,0,0,0,0,0,0,0,0,0,0,0,0,0,0.0,0.0
7a96d94fd4f98f725ce04f7ac45de041b521b86d,/Users/sanika/Downloads/Master Thesis/repo_updated/pytest/testing/example_scripts/fixtures/custom_item/__init__.pyi,5056,ModificationType.MODIFY,0,0,0,0,0,0,0,0,0,0,0,0,0,0,0,0,0,0.0,0.0
7a96d94fd4f98f725ce04f7ac45de041b521b86d,/Users/sanika/Downloads/Master Thesis/repo_updated/pytest/testing/example_scripts/fixtures/custom_item/foo/__init__.py,5056,ModificationType.MODIFY,0,0,0,0,0,0,0,0,0,0,0,0,0,0,0,0,0,0.0,0.0
7a96d94fd4f98f725ce04f7ac45de041b521b86d,/Users/sanika/Downloads/Master Thesis/repo_updated/pytest/doc/en/example/nonpython/__init__.py,5056,ModificationType.MODIFY,0,0,0,0,0,0,0,0,0,0,0,0,0,0,0,0,0,0.0,0.0
7a96d94fd4f98f725ce04f7ac45de041b521b86d,/Users/sanika/Downloads/Master Thesis/repo_updated/pytest/src/pytest/__init__.py,5056,ModificationType.MODIFY,99,48,90,1,3,5,100,0,0,0,0,0,0,0,0,0,0,0.0,0.0
7a96d94fd4f98f725ce04f7ac45de041b521b86d,/Users/sanika/Downloads/Master Thesis/repo_updated/pytest/src/_pytest/__init__.py,5056,ModificationType.MODIFY,8,5,5,2,0,1,10,0,0,0,0,0,0,0,0,0,0,0.0,0.0
7a96d94fd4f98f725ce04f7ac45de041b521b86d,/Users/sanika/Downloads/Master Thesis/repo_updated/pytest/src/_pytest/config/__init__.py,5056,ModificationType.MODIFY,1217,716,841,84,126,174,1301,14,185,118,215,199,333,1446.608539104324,2542.995998641035,8.135135135135135,20687.616097052745,1149.3120053918192,0.847665332880345
7a96d94fd4f98f725ce04f7ac45de041b521b86d,/Users/sanika/Downloads/Master Thesis/repo_updated/pytest/src/_pytest/mark/__init__.py,5056,ModificationType.MODIFY,160,89,115,0,13,31,160,7,15,11,17,22,28,78.25484338853101,124.86408532184433,3.966666666666667,495.2942051099825,27.51634472833236,0.04162136177394811
7a96d94fd4f98f725ce04f7ac45de041b521b86d,/Users/sanika/Downloads/Master Thesis/repo_updated/pytest/src/_pytest/_code/__init__.py,5056,ModificationType.MODIFY,10,10,9,9,0,0,19,0,0,0,0,0,0,0,0,0,0,0.0,0.0
7a96d94fd4f98f725ce04f7ac45de041b521b86d,/Users/sanika/Downloads/Master Thesis/repo_updated/pytest/src/_pytest/assertion/__init__.py,5056,ModificationType.MODIFY,173,84,99,8,29,36,181,5,12,7,13,17,20,54.62919048309069,81.7492568250068,2.7083333333333335,221.4042372343934,12.300235401910745,0.027249752275002266
7a96d94fd4f98f725ce04f7ac45de041b521b86d,/Users/sanika/Downloads/Master Thesis/repo_updated/pytest/src/_pytest/_io/__init__.py,5056,ModificationType.MODIFY,3,1,1,3,0,0,6,0,0,0,0,0,0,0,0,0,0,0.0,0.0
7a96d94fd4f98f725ce04f7ac45de041b521b86d,/Users/sanika/Downloads/Master Thesis/repo_updated/pytest/src/_pytest/hookspec.py,642,ModificationType.MODIFY,647,139,84,35,284,233,682,0,0,0,0,0,0,0,0,0,0,0.0,0.0
7a96d94fd4f98f725ce04f7ac45de041b521b86d,/Users/sanika/Downloads/Master Thesis/repo_updated/pytest/testing/test_pluginmanager.py,1924,ModificationType.MODIFY,384,251,317,7,8,52,391,11,70,44,84,81,128,467.103558991158,811.500800369232,6.6,5355.905282436931,297.5502934687184,0.270500266789744
285524c6cdde61fde3d9b4f250b4fa9bbb46e932,/Users/sanika/Downloads/Master Thesis/repo_updated/pytest/src/_pytest/debugging.py,1473,ModificationType.MODIFY,339,213,244,17,9,65,356,10,42,26,48,52,74,259.6966127055816,421.83253914244085,5.714285714285714,2410.471652242519,133.91509179125106,0.14061084638081361
285524c6cdde61fde3d9b4f250b4fa9bbb46e932,/Users/sanika/Downloads/Master Thesis/repo_updated/pytest/testing/test_pdb.py,4151,ModificationType.MODIFY,1293,570,1093,25,15,163,1318,10,195,123,241,205,364,1516.6486921300477,2795.3307562199825,6.17948717948718,17273.710570487587,959.6505872493103,0.9317769187399941
dc5a4fbe2303fb97b962095610368f73c7bc66e2,/Users/sanika/Downloads/Master Thesis/repo_updated/pytest/src/_pytest/debugging.py,1473,ModificationType.MODIFY,339,213,244,17,9,65,356,10,42,26,48,52,74,259.6966127055816,421.83253914244085,5.714285714285714,2410.471652242519,133.91509179125106,0.14061084638081361
dc5a4fbe2303fb97b962095610368f73c7bc66e2,/Users/sanika/Downloads/Master Thesis/repo_updated/pytest/testing/test_pdb.py,4151,ModificationType.MODIFY,1293,570,1093,25,15,163,1318,10,195,123,241,205,364,1516.6486921300477,2795.3307562199825,6.17948717948718,17273.710570487587,959.6505872493103,0.9317769187399941
abc890079f92c116e30bf197c46c427a850ecdec,/Users/sanika/Downloads/Master Thesis/repo_updated/pytest/testing/code/test_code.py,4974,ModificationType.MODIFY,182,127,129,0,0,53,182,5,39,21,42,44,63,217.7403270100645,343.9441919741497,2.6923076923076925,926.003593776557,51.44464409869761,0.11464806399138323
abc890079f92c116e30bf197c46c427a850ecdec,/Users/sanika/Downloads/Master Thesis/repo_updated/pytest/src/_pytest/_code/code.py,4974,ModificationType.MODIFY,1165,710,800,67,119,181,1232,18,243,153,282,261,435,2000.7880884021665,3492.1391085079,10.444444444444445,36473.45291108251,2026.302939504584,1.1640463695026333
abc890079f92c116e30bf197c46c427a850ecdec,/Users/sanika/Downloads/Master Thesis/repo_updated/pytest/testing/test_junitxml.py,3166,ModificationType.MODIFY,1523,757,1297,19,12,193,1542,12,193,117,230,205,347,1508.3637582013935,2664.7795945283897,7.150259067357513,19053.864458285894,1058.5480254603274,0.8882598648427965
abc890079f92c116e30bf197c46c427a850ecdec,/Users/sanika/Downloads/Master Thesis/repo_updated/pytest/src/_pytest/junitxml.py,3166,ModificationType.MODIFY,701,378,504,33,58,109,734,13,110,68,126,123,194,794.0552848235468,1346.8478140358125,7.445454545454545,10027.894179048459,557.1052321693588,0.4489492713452708
abc890079f92c116e30bf197c46c427a850ecdec,/Users/sanika/Downloads/Master Thesis/repo_updated/pytest/testing/test_main.py,3472,ModificationType.MODIFY,77,34,69,0,0,8,77,3,24,16,29,27,45,114.79398751947123,213.9699375973561,1.8125,387.82051189520797,21.54558399417822,0.07132331253245204
abc890079f92c116e30bf197c46c427a850ecdec,/Users/sanika/Downloads/Master Thesis/repo_updated/pytest/src/_pytest/main.py,3472,ModificationType.MODIFY,712,438,573,51,9,84,763,14,102,71,128,116,199,733.8903537898989,1364.7382180303869,8.784313725490197,11988.28866034536,666.0160366858534,0.45491273934346227
abc890079f92c116e30bf197c46c427a850ecdec,/Users/sanika/Downloads/Master Thesis/repo_updated/pytest/src/_pytest/mark/evaluate.py,669,ModificationType.MODIFY,125,97,103,3,0,19,128,9,25,17,27,34,44,144.62572975734892,223.84836501501496,4.86,1087.9030539729729,60.43905855405405,0.07461612167167166
abc890079f92c116e30bf197c46c427a850ecdec,/Users/sanika/Downloads/Master Thesis/repo_updated/pytest/src/_pytest/mark/legacy.py,367,ModificationType.MODIFY,102,57,55,5,16,25,107,5,17,10,18,22,28,81.0965087756926,124.86408532184433,2.6470588235294117,330.5225787931173,18.362365488506516,0.04162136177394811
abc890079f92c116e30bf197c46c427a850ecdec,/Users/sanika/Downloads/Master Thesis/repo_updated/pytest/doc/en/example/multipython.py,6685,ModificationType.MODIFY,72,33,56,0,4,12,72,1,1,1,1,2,2,0.0,2.0,0.5,1.0,0.05555555555555555,0.0006666666666666666
abc890079f92c116e30bf197c46c427a850ecdec,/Users/sanika/Downloads/Master Thesis/repo_updated/pytest/src/_pytest/python.py,6685,ModificationType.MODIFY,1454,835,1044,76,110,219,1530,17,275,158,296,292,454,2297.8910156145625,3718.180349731528,9.149090909090908,34017.97003608918,1889.8872242271766,1.2393934499105095
abc890079f92c116e30bf197c46c427a850ecdec,/Users/sanika/Downloads/Master Thesis/repo_updated/pytest/testing/test_skipping.py,784,ModificationType.MODIFY,1178,367,1042,6,15,115,1184,9,94,51,95,103,146,644.6606770706787,976.22907696875,4.547872340425532,4439.7652170653255,246.65362317029587,0.32540969232291667
abc890079f92c116e30bf197c46c427a850ecdec,/Users/sanika/Downloads/Master Thesis/repo_updated/pytest/src/_pytest/skipping.py,784,ModificationType.MODIFY,177,108,140,8,0,27,185,6,30,16,32,36,48,162.7164928725825,248.15640006923098,3.2,794.1004802215392,44.11669334564107,0.082718800023077
abc890079f92c116e30bf197c46c427a850ecdec,/Users/sanika/Downloads/Master Thesis/repo_updated/pytest/testing/python/metafunc.py,5933,ModificationType.MODIFY,1782,648,1425,9,47,279,1791,8,171,97,189,179,286,1292.4527800454887,2140.3713122975773,4.421052631578948,9462.69422278929,525.705234599405,0.7134571040991925
abc890079f92c116e30bf197c46c427a850ecdec,/Users/sanika/Downloads/Master Thesis/repo_updated/pytest/testing/test_mark.py,3090,ModificationType.MODIFY,1020,354,843,12,15,144,1032,8,134,77,144,142,221,970.8559515213415,1580.0941134105349,4.298507462686567,6792.0463382422995,377.3359076801278,0.5266980378035117
abc890079f92c116e30bf197c46c427a850ecdec,/Users/sanika/Downloads/Master Thesis/repo_updated/pytest/testing/test_nose.py,637,ModificationType.MODIFY,424,94,331,4,0,89,428,1,5,5,5,6,10,11.60964047443681,25.84962500721156,0.5,12.92481250360578,0.71804513908921,0.00861654166907052
abc890079f92c116e30bf197c46c427a850ecdec,/Users/sanika/Downloads/Master Thesis/repo_updated/pytest/testing/test_parseopt.py,2315,ModificationType.MODIFY,334,251,279,10,4,40,344,5,127,74,143,132,217,899.1725956945019,1528.6335239007844,2.8149606299212597,4303.043187358508,239.0579548532504,0.5095445079669282
abc890079f92c116e30bf197c46c427a850ecdec,/Users/sanika/Downloads/Master Thesis/repo_updated/pytest/testing/test_pdb.py,3969,ModificationType.MODIFY,1293,570,1093,25,15,163,1318,10,195,123,241,205,364,1516.6486921300477,2795.3307562199825,6.17948717948718,17273.710570487587,959.6505872493103,0.9317769187399941
abc890079f92c116e30bf197c46c427a850ecdec,/Users/sanika/Downloads/Master Thesis/repo_updated/pytest/testing/test_stepwise.py,645,ModificationType.MODIFY,219,78,157,11,5,46,230,3,24,20,34,27,54,114.79398751947123,256.76392511682735,2.125,545.6233408732581,30.31240782629212,0.08558797503894246
35800a2f73c4233285a4a8f403ca94bc9c6e998e,/Users/sanika/Downloads/Master Thesis/repo_updated/pytest/testing/code/test_code.py,4974,ModificationType.MODIFY,182,127,129,0,0,53,182,5,39,21,42,44,63,217.7403270100645,343.9441919741497,2.6923076923076925,926.003593776557,51.44464409869761,0.11464806399138323
35800a2f73c4233285a4a8f403ca94bc9c6e998e,/Users/sanika/Downloads/Master Thesis/repo_updated/pytest/src/_pytest/_code/code.py,4974,ModificationType.MODIFY,1165,710,800,67,119,181,1232,18,243,153,282,261,435,2000.7880884021665,3492.1391085079,10.444444444444445,36473.45291108251,2026.302939504584,1.1640463695026333
35800a2f73c4233285a4a8f403ca94bc9c6e998e,/Users/sanika/Downloads/Master Thesis/repo_updated/pytest/testing/test_junitxml.py,3166,ModificationType.MODIFY,1523,757,1297,19,12,193,1542,12,193,117,230,205,347,1508.3637582013935,2664.7795945283897,7.150259067357513,19053.864458285894,1058.5480254603274,0.8882598648427965
35800a2f73c4233285a4a8f403ca94bc9c6e998e,/Users/sanika/Downloads/Master Thesis/repo_updated/pytest/src/_pytest/junitxml.py,3166,ModificationType.MODIFY,701,378,504,33,58,109,734,13,110,68,126,123,194,794.0552848235468,1346.8478140358125,7.445454545454545,10027.894179048459,557.1052321693588,0.4489492713452708
35800a2f73c4233285a4a8f403ca94bc9c6e998e,/Users/sanika/Downloads/Master Thesis/repo_updated/pytest/testing/test_main.py,3472,ModificationType.MODIFY,77,34,69,0,0,8,77,3,24,16,29,27,45,114.79398751947123,213.9699375973561,1.8125,387.82051189520797,21.54558399417822,0.07132331253245204
35800a2f73c4233285a4a8f403ca94bc9c6e998e,/Users/sanika/Downloads/Master Thesis/repo_updated/pytest/src/_pytest/main.py,3472,ModificationType.MODIFY,712,438,573,51,9,84,763,14,102,71,128,116,199,733.8903537898989,1364.7382180303869,8.784313725490197,11988.28866034536,666.0160366858534,0.45491273934346227
35800a2f73c4233285a4a8f403ca94bc9c6e998e,/Users/sanika/Downloads/Master Thesis/repo_updated/pytest/src/_pytest/mark/evaluate.py,669,ModificationType.MODIFY,125,97,103,3,0,19,128,9,25,17,27,34,44,144.62572975734892,223.84836501501496,4.86,1087.9030539729729,60.43905855405405,0.07461612167167166
35800a2f73c4233285a4a8f403ca94bc9c6e998e,/Users/sanika/Downloads/Master Thesis/repo_updated/pytest/src/_pytest/mark/legacy.py,367,ModificationType.MODIFY,102,57,55,5,16,25,107,5,17,10,18,22,28,81.0965087756926,124.86408532184433,2.6470588235294117,330.5225787931173,18.362365488506516,0.04162136177394811
35800a2f73c4233285a4a8f403ca94bc9c6e998e,/Users/sanika/Downloads/Master Thesis/repo_updated/pytest/doc/en/example/multipython.py,6685,ModificationType.MODIFY,72,33,56,0,4,12,72,1,1,1,1,2,2,0.0,2.0,0.5,1.0,0.05555555555555555,0.0006666666666666666
35800a2f73c4233285a4a8f403ca94bc9c6e998e,/Users/sanika/Downloads/Master Thesis/repo_updated/pytest/src/_pytest/python.py,6685,ModificationType.MODIFY,1454,835,1044,76,110,219,1530,17,275,158,296,292,454,2297.8910156145625,3718.180349731528,9.149090909090908,34017.97003608918,1889.8872242271766,1.2393934499105095
35800a2f73c4233285a4a8f403ca94bc9c6e998e,/Users/sanika/Downloads/Master Thesis/repo_updated/pytest/testing/test_skipping.py,784,ModificationType.MODIFY,1178,367,1042,6,15,115,1184,9,94,51,95,103,146,644.6606770706787,976.22907696875,4.547872340425532,4439.7652170653255,246.65362317029587,0.32540969232291667
35800a2f73c4233285a4a8f403ca94bc9c6e998e,/Users/sanika/Downloads/Master Thesis/repo_updated/pytest/src/_pytest/skipping.py,784,ModificationType.MODIFY,177,108,140,8,0,27,185,6,30,16,32,36,48,162.7164928725825,248.15640006923098,3.2,794.1004802215392,44.11669334564107,0.082718800023077
35800a2f73c4233285a4a8f403ca94bc9c6e998e,/Users/sanika/Downloads/Master Thesis/repo_updated/pytest/testing/python/metafunc.py,5933,ModificationType.MODIFY,1782,648,1425,9,47,279,1791,8,171,97,189,179,286,1292.4527800454887,2140.3713122975773,4.421052631578948,9462.69422278929,525.705234599405,0.7134571040991925
35800a2f73c4233285a4a8f403ca94bc9c6e998e,/Users/sanika/Downloads/Master Thesis/repo_updated/pytest/testing/test_mark.py,3090,ModificationType.MODIFY,1020,354,843,12,15,144,1032,8,134,77,144,142,221,970.8559515213415,1580.0941134105349,4.298507462686567,6792.0463382422995,377.3359076801278,0.5266980378035117
35800a2f73c4233285a4a8f403ca94bc9c6e998e,/Users/sanika/Downloads/Master Thesis/repo_updated/pytest/testing/test_nose.py,637,ModificationType.MODIFY,424,94,331,4,0,89,428,1,5,5,5,6,10,11.60964047443681,25.84962500721156,0.5,12.92481250360578,0.71804513908921,0.00861654166907052
35800a2f73c4233285a4a8f403ca94bc9c6e998e,/Users/sanika/Downloads/Master Thesis/repo_updated/pytest/testing/test_parseopt.py,2315,ModificationType.MODIFY,334,251,279,10,4,40,344,5,127,74,143,132,217,899.1725956945019,1528.6335239007844,2.8149606299212597,4303.043187358508,239.0579548532504,0.5095445079669282
35800a2f73c4233285a4a8f403ca94bc9c6e998e,/Users/sanika/Downloads/Master Thesis/repo_updated/pytest/testing/test_pdb.py,4151,ModificationType.MODIFY,1293,570,1093,25,15,163,1318,10,195,123,241,205,364,1516.6486921300477,2795.3307562199825,6.17948717948718,17273.710570487587,959.6505872493103,0.9317769187399941
35800a2f73c4233285a4a8f403ca94bc9c6e998e,/Users/sanika/Downloads/Master Thesis/repo_updated/pytest/testing/test_stepwise.py,645,ModificationType.MODIFY,219,78,157,11,5,46,230,3,24,20,34,27,54,114.79398751947123,256.76392511682735,2.125,545.6233408732581,30.31240782629212,0.08558797503894246
0c7c26fe6e7a9d53e080b3214898651042c6dbee,/Users/sanika/Downloads/Master Thesis/repo_updated/pytest/testing/test_nodes.py,1699,ModificationType.MODIFY,53,23,39,0,0,13,53,2,8,4,8,10,12,26.0,39.863137138648355,1.0,39.863137138648355,2.2146187299249087,0.013287712379549451
0c7c26fe6e7a9d53e080b3214898651042c6dbee,/Users/sanika/Downloads/Master Thesis/repo_updated/pytest/src/_pytest/nodes.py,1699,ModificationType.MODIFY,515,298,307,33,80,99,548,12,63,44,77,75,121,419.58818518914865,753.6870615500015,7.333333333333333,5527.038451366678,307.0576917425932,0.2512290205166672
6df4d07a57cf3dd6486e7ea23c3eeda6ace3ca89,/Users/sanika/Downloads/Master Thesis/repo_updated/pytest/testing/test_capture.py,5076,ModificationType.MODIFY,1513,682,1277,25,13,200,1538,11,199,116,219,210,335,1557.7420472931965,2584.272248418151,6.052763819095477,15641.989563917903,868.9994202176613,0.8614240828060503
3fb969897a012c5acf481126e95d6d2d282108aa,/Users/sanika/Downloads/Master Thesis/repo_updated/pytest/testing/test_terminal.py,6238,ModificationType.MODIFY,1943,715,1694,26,18,214,1969,12,185,120,237,197,357,1436.3251202041715,2721.0724995459263,7.686486486486486,20915.486996509768,1161.971499806098,0.9070241665153088
3fb969897a012c5acf481126e95d6d2d282108aa,/Users/sanika/Downloads/Master Thesis/repo_updated/pytest/src/_pytest/terminal.py,6238,ModificationType.MODIFY,1168,838,957,57,25,144,1225,19,348,224,416,367,640,3018.854959310786,5452.5672018196565,11.35632183908046,61921.107993078396,3440.061555171022,1.8175224006065522
3fb969897a012c5acf481126e95d6d2d282108aa,/Users/sanika/Downloads/Master Thesis/repo_updated/pytest/testing/test_terminal.py,6713,ModificationType.MODIFY,1943,715,1694,26,18,214,1969,12,185,120,237,197,357,1436.3251202041715,2721.0724995459263,7.686486486486486,20915.486996509768,1161.971499806098,0.9070241665153088
9303de877aefc5304522b2e2522c314e0616040c,/Users/sanika/Downloads/Master Thesis/repo_updated/pytest/testing/test_terminal.py,6713,ModificationType.MODIFY,1943,715,1694,26,18,214,1969,12,185,120,237,197,357,1436.3251202041715,2721.0724995459263,7.686486486486486,20915.486996509768,1161.971499806098,0.9070241665153088
dc30d78845970afd3089d4ff79b2df0eb86af156,/Users/sanika/Downloads/Master Thesis/repo_updated/pytest/testing/io/test_saferepr.py,320,ModificationType.MODIFY,149,95,105,2,0,41,151,8,54,28,55,62,83,334.76392511682735,494.19829376211067,4.074074074074074,2013.4004560678584,111.85558089265879,0.1647327645873702
dc30d78845970afd3089d4ff79b2df0eb86af156,/Users/sanika/Downloads/Master Thesis/repo_updated/pytest/src/_pytest/_io/saferepr.py,320,ModificationType.MODIFY,82,56,54,0,13,15,82,4,13,8,16,17,24,56.105716335834195,98.09910819000817,2.4615384615384617,241.47472785232782,13.415262658462657,0.03269970273000272
18d181fa7776ced81249e18805c91c53c739834c,/Users/sanika/Downloads/Master Thesis/repo_updated/pytest/src/_pytest/assertion/util.py,2276,ModificationType.MODIFY,477,336,357,30,23,73,507,16,194,134,250,210,384,1538.3830913843028,2962.270278783791,10.309278350515465,30538.86885344115,1696.603825191175,0.9874234262612637
7d3ce374d28d7eadd85c59ed1e59319556e61635,/Users/sanika/Downloads/Master Thesis/repo_updated/pytest/src/_pytest/assertion/util.py,2511,ModificationType.MODIFY,477,336,357,30,23,73,507,16,194,134,250,210,384,1538.3830913843028,2962.270278783791,10.309278350515465,30538.86885344115,1696.603825191175,0.9874234262612637
68dbc24dcbb6e2bf1aa03289caff112786eb92d2,/Users/sanika/Downloads/Master Thesis/repo_updated/pytest/testing/test_warnings.py,1715,ModificationType.MODIFY,601,196,481,2,23,85,603,8,63,36,72,71,108,400.56863518049477,664.1726889065056,4.571428571428571,3036.21800642974,168.67877813498555,0.22139089630216854
9f800b2a77e60637ad8ece1c62c3c4352e70d410,/Users/sanika/Downloads/Master Thesis/repo_updated/pytest/testing/test_terminal.py,6693,ModificationType.MODIFY,1943,715,1694,26,18,214,1969,12,185,120,237,197,357,1436.3251202041715,2721.0724995459263,7.686486486486486,20915.486996509768,1161.971499806098,0.9070241665153088
08c25b7fe0aab6f4d12c55a21031c4c22e7a57ac,/Users/sanika/Downloads/Master Thesis/repo_updated/pytest/testing/io/test_saferepr.py,320,ModificationType.MODIFY,149,95,105,2,0,41,151,8,54,28,55,62,83,334.76392511682735,494.19829376211067,4.074074074074074,2013.4004560678584,111.85558089265879,0.1647327645873702
08c25b7fe0aab6f4d12c55a21031c4c22e7a57ac,/Users/sanika/Downloads/Master Thesis/repo_updated/pytest/src/_pytest/_io/saferepr.py,320,ModificationType.MODIFY,82,56,54,0,13,15,82,4,13,8,16,17,24,56.105716335834195,98.09910819000817,2.4615384615384617,241.47472785232782,13.415262658462657,0.03269970273000272
08c25b7fe0aab6f4d12c55a21031c4c22e7a57ac,/Users/sanika/Downloads/Master Thesis/repo_updated/pytest/src/_pytest/assertion/util.py,2511,ModificationType.MODIFY,477,336,357,30,23,73,507,16,194,134,250,210,384,1538.3830913843028,2962.270278783791,10.309278350515465,30538.86885344115,1696.603825191175,0.9874234262612637
d53794f9162affedd107089f374a2262b9cd80a0,/Users/sanika/Downloads/Master Thesis/repo_updated/pytest/testing/test_terminal.py,6693,ModificationType.MODIFY,1943,715,1694,26,18,214,1969,12,185,120,237,197,357,1436.3251202041715,2721.0724995459263,7.686486486486486,20915.486996509768,1161.971499806098,0.9070241665153088
0d79061432639308ecf3e3c2e838080567c84e20,/Users/sanika/Downloads/Master Thesis/repo_updated/pytest/testing/test_terminal.py,6307,ModificationType.MODIFY,1943,715,1694,26,18,214,1969,12,185,120,237,197,357,1436.3251202041715,2721.0724995459263,7.686486486486486,20915.486996509768,1161.971499806098,0.9070241665153088
0d79061432639308ecf3e3c2e838080567c84e20,/Users/sanika/Downloads/Master Thesis/repo_updated/pytest/src/_pytest/terminal.py,6307,ModificationType.MODIFY,1168,838,957,57,25,144,1225,19,348,224,416,367,640,3018.854959310786,5452.5672018196565,11.35632183908046,61921.107993078396,3440.061555171022,1.8175224006065522
0d79061432639308ecf3e3c2e838080567c84e20,/Users/sanika/Downloads/Master Thesis/repo_updated/pytest/testing/test_terminal.py,6826,ModificationType.MODIFY,1943,715,1694,26,18,214,1969,12,185,120,237,197,357,1436.3251202041715,2721.0724995459263,7.686486486486486,20915.486996509768,1161.971499806098,0.9070241665153088
f9e3a5395c9cbabcfd7d548afb7bff8f9310f229,/Users/sanika/Downloads/Master Thesis/repo_updated/pytest/src/_pytest/assertion/util.py,2105,ModificationType.MODIFY,477,336,357,30,23,73,507,16,194,134,250,210,384,1538.3830913843028,2962.270278783791,10.309278350515465,30538.86885344115,1696.603825191175,0.9874234262612637
990d75b7e6bae670a9de292b69118e0b64da6171,/Users/sanika/Downloads/Master Thesis/repo_updated/pytest/src/_pytest/assertion/util.py,2105,ModificationType.MODIFY,477,336,357,30,23,73,507,16,194,134,250,210,384,1538.3830913843028,2962.270278783791,10.309278350515465,30538.86885344115,1696.603825191175,0.9874234262612637
741f0fedd1d8661ed671fdc7a1091dd42203a56f,/Users/sanika/Downloads/Master Thesis/repo_updated/pytest/testing/code/test_code.py,5035,ModificationType.MODIFY,182,127,129,0,0,53,182,5,39,21,42,44,63,217.7403270100645,343.9441919741497,2.6923076923076925,926.003593776557,51.44464409869761,0.11464806399138323
741f0fedd1d8661ed671fdc7a1091dd42203a56f,/Users/sanika/Downloads/Master Thesis/repo_updated/pytest/src/_pytest/_code/code.py,5035,ModificationType.MODIFY,1165,710,800,67,119,181,1232,18,243,153,282,261,435,2000.7880884021665,3492.1391085079,10.444444444444445,36473.45291108251,2026.302939504584,1.1640463695026333
741f0fedd1d8661ed671fdc7a1091dd42203a56f,/Users/sanika/Downloads/Master Thesis/repo_updated/pytest/testing/test_doctest.py,2729,ModificationType.MODIFY,1455,414,1257,16,76,112,1471,5,41,23,46,46,69,231.26927266377825,381.1257749679339,2.8048780487804876,1069.0113200320097,59.389517779556094,0.1270419249893113
741f0fedd1d8661ed671fdc7a1091dd42203a56f,/Users/sanika/Downloads/Master Thesis/repo_updated/pytest/src/_pytest/doctest.py,2729,ModificationType.MODIFY,669,365,481,22,61,110,691,15,103,63,122,118,185,747.3129132339992,1273.2889641319407,8.883495145631068,11311.256331851706,628.403129547317,0.4244296547106469
741f0fedd1d8661ed671fdc7a1091dd42203a56f,/Users/sanika/Downloads/Master Thesis/repo_updated/pytest/testing/python/fixtures.py,6241,ModificationType.MODIFY,4293,999,3693,19,54,507,4312,9,155,88,170,164,258,1156.3286078304877,1898.248417191466,4.935483870967742,9368.774446138526,520.4874692299181,0.6327494723971553
741f0fedd1d8661ed671fdc7a1091dd42203a56f,/Users/sanika/Downloads/Master Thesis/repo_updated/pytest/src/_pytest/fixtures.py,6241,ModificationType.MODIFY,1482,859,1002,125,135,219,1607,16,219,134,251,235,385,1766.678366052657,3032.459024427525,9.168949771689498,27804.464479682512,1544.692471093473,1.0108196748091751
741f0fedd1d8661ed671fdc7a1091dd42203a56f,/Users/sanika/Downloads/Master Thesis/repo_updated/pytest/testing/test_main.py,3505,ModificationType.MODIFY,77,34,69,0,0,8,77,3,24,16,29,27,45,114.79398751947123,213.9699375973561,1.8125,387.82051189520797,21.54558399417822,0.07132331253245204
741f0fedd1d8661ed671fdc7a1091dd42203a56f,/Users/sanika/Downloads/Master Thesis/repo_updated/pytest/src/_pytest/main.py,3505,ModificationType.MODIFY,712,438,573,51,9,84,763,14,102,71,128,116,199,733.8903537898989,1364.7382180303869,8.784313725490197,11988.28866034536,666.0160366858534,0.45491273934346227
741f0fedd1d8661ed671fdc7a1091dd42203a56f,/Users/sanika/Downloads/Master Thesis/repo_updated/pytest/testing/test_nodes.py,1828,ModificationType.MODIFY,53,23,39,0,0,13,53,2,8,4,8,10,12,26.0,39.863137138648355,1.0,39.863137138648355,2.2146187299249087,0.013287712379549451
741f0fedd1d8661ed671fdc7a1091dd42203a56f,/Users/sanika/Downloads/Master Thesis/repo_updated/pytest/src/_pytest/nodes.py,1828,ModificationType.MODIFY,515,298,307,33,80,99,548,12,63,44,77,75,121,419.58818518914865,753.6870615500015,7.333333333333333,5527.038451366678,307.0576917425932,0.2512290205166672
741f0fedd1d8661ed671fdc7a1091dd42203a56f,/Users/sanika/Downloads/Master Thesis/repo_updated/pytest/doc/en/example/multipython.py,6698,ModificationType.MODIFY,72,33,56,0,4,12,72,1,1,1,1,2,2,0.0,2.0,0.5,1.0,0.05555555555555555,0.0006666666666666666
741f0fedd1d8661ed671fdc7a1091dd42203a56f,/Users/sanika/Downloads/Master Thesis/repo_updated/pytest/src/_pytest/python.py,6698,ModificationType.MODIFY,1454,835,1044,76,110,219,1530,17,275,158,296,292,454,2297.8910156145625,3718.180349731528,9.149090909090908,34017.97003608918,1889.8872242271766,1.2393934499105095
741f0fedd1d8661ed671fdc7a1091dd42203a56f,/Users/sanika/Downloads/Master Thesis/repo_updated/pytest/testing/test_reports.py,1979,ModificationType.MODIFY,466,257,367,18,25,50,484,7,126,86,171,133,257,898.7887548153927,1813.2075859238057,4.75,8612.736033138077,478.4853351743376,0.6044025286412685
741f0fedd1d8661ed671fdc7a1091dd42203a56f,/Users/sanika/Downloads/Master Thesis/repo_updated/pytest/src/_pytest/reports.py,1979,ModificationType.MODIFY,507,281,342,29,59,88,536,10,53,29,57,63,86,336.79906504072324,514.0460734209928,5.377358490566038,2764.2100174525085,153.56722319180602,0.17134869114033094
741f0fedd1d8661ed671fdc7a1091dd42203a56f,/Users/sanika/Downloads/Master Thesis/repo_updated/pytest/testing/test_runner.py,1930,ModificationType.MODIFY,1043,504,840,53,9,147,1096,9,180,112,198,189,310,1377.0628823523223,2344.2951515085324,4.95,11604.260999967235,644.6811666648464,0.7814317171695108
741f0fedd1d8661ed671fdc7a1091dd42203a56f,/Users/sanika/Downloads/Master Thesis/repo_updated/pytest/src/_pytest/runner.py,1930,ModificationType.MODIFY,383,288,292,26,6,62,409,11,65,38,67,76,105,429.5076556518598,656.0323889115765,5.6692307692307695,3719.199004829476,206.6221669349709,0.2186774629705255
741f0fedd1d8661ed671fdc7a1091dd42203a56f,/Users/sanika/Downloads/Master Thesis/repo_updated/pytest/testing/code/test_excinfo.py,7107,ModificationType.MODIFY,1392,870,1177,35,17,170,1427,14,494,280,531,508,811,4473.796381311637,7289.823280972226,7.5242914979757085,54850.755334764704,3047.2641852647057,2.4299410936574084
cab29dc861ce4d28cc3a33e70bd6cb5c5bbea801,/Users/sanika/Downloads/Master Thesis/repo_updated/pytest/testing/test_warnings.py,1715,ModificationType.MODIFY,601,196,481,2,23,85,603,8,63,36,72,71,108,400.56863518049477,664.1726889065056,4.571428571428571,3036.21800642974,168.67877813498555,0.22139089630216854
0794289689a3079625d8c6fd839968075b852e13,/Users/sanika/Downloads/Master Thesis/repo_updated/pytest/testing/code/test_code.py,5035,ModificationType.MODIFY,182,127,129,0,0,53,182,5,39,21,42,44,63,217.7403270100645,343.9441919741497,2.6923076923076925,926.003593776557,51.44464409869761,0.11464806399138323
0794289689a3079625d8c6fd839968075b852e13,/Users/sanika/Downloads/Master Thesis/repo_updated/pytest/src/_pytest/_code/code.py,5035,ModificationType.MODIFY,1165,710,800,67,119,181,1232,18,243,153,282,261,435,2000.7880884021665,3492.1391085079,10.444444444444445,36473.45291108251,2026.302939504584,1.1640463695026333
0794289689a3079625d8c6fd839968075b852e13,/Users/sanika/Downloads/Master Thesis/repo_updated/pytest/testing/test_doctest.py,2729,ModificationType.MODIFY,1455,414,1257,16,76,112,1471,5,41,23,46,46,69,231.26927266377825,381.1257749679339,2.8048780487804876,1069.0113200320097,59.389517779556094,0.1270419249893113
0794289689a3079625d8c6fd839968075b852e13,/Users/sanika/Downloads/Master Thesis/repo_updated/pytest/src/_pytest/doctest.py,2729,ModificationType.MODIFY,669,365,481,22,61,110,691,15,103,63,122,118,185,747.3129132339992,1273.2889641319407,8.883495145631068,11311.256331851706,628.403129547317,0.4244296547106469
0794289689a3079625d8c6fd839968075b852e13,/Users/sanika/Downloads/Master Thesis/repo_updated/pytest/testing/python/fixtures.py,6241,ModificationType.MODIFY,4293,999,3693,19,54,507,4312,9,155,88,170,164,258,1156.3286078304877,1898.248417191466,4.935483870967742,9368.774446138526,520.4874692299181,0.6327494723971553
0794289689a3079625d8c6fd839968075b852e13,/Users/sanika/Downloads/Master Thesis/repo_updated/pytest/src/_pytest/fixtures.py,6241,ModificationType.MODIFY,1482,859,1002,125,135,219,1607,16,219,134,251,235,385,1766.678366052657,3032.459024427525,9.168949771689498,27804.464479682512,1544.692471093473,1.0108196748091751
0794289689a3079625d8c6fd839968075b852e13,/Users/sanika/Downloads/Master Thesis/repo_updated/pytest/testing/test_main.py,3505,ModificationType.MODIFY,77,34,69,0,0,8,77,3,24,16,29,27,45,114.79398751947123,213.9699375973561,1.8125,387.82051189520797,21.54558399417822,0.07132331253245204
0794289689a3079625d8c6fd839968075b852e13,/Users/sanika/Downloads/Master Thesis/repo_updated/pytest/src/_pytest/main.py,3505,ModificationType.MODIFY,712,438,573,51,9,84,763,14,102,71,128,116,199,733.8903537898989,1364.7382180303869,8.784313725490197,11988.28866034536,666.0160366858534,0.45491273934346227
0794289689a3079625d8c6fd839968075b852e13,/Users/sanika/Downloads/Master Thesis/repo_updated/pytest/testing/test_nodes.py,1828,ModificationType.MODIFY,53,23,39,0,0,13,53,2,8,4,8,10,12,26.0,39.863137138648355,1.0,39.863137138648355,2.2146187299249087,0.013287712379549451
0794289689a3079625d8c6fd839968075b852e13,/Users/sanika/Downloads/Master Thesis/repo_updated/pytest/src/_pytest/nodes.py,1828,ModificationType.MODIFY,515,298,307,33,80,99,548,12,63,44,77,75,121,419.58818518914865,753.6870615500015,7.333333333333333,5527.038451366678,307.0576917425932,0.2512290205166672
0794289689a3079625d8c6fd839968075b852e13,/Users/sanika/Downloads/Master Thesis/repo_updated/pytest/doc/en/example/multipython.py,6698,ModificationType.MODIFY,72,33,56,0,4,12,72,1,1,1,1,2,2,0.0,2.0,0.5,1.0,0.05555555555555555,0.0006666666666666666
0794289689a3079625d8c6fd839968075b852e13,/Users/sanika/Downloads/Master Thesis/repo_updated/pytest/src/_pytest/python.py,6698,ModificationType.MODIFY,1454,835,1044,76,110,219,1530,17,275,158,296,292,454,2297.8910156145625,3718.180349731528,9.149090909090908,34017.97003608918,1889.8872242271766,1.2393934499105095
0794289689a3079625d8c6fd839968075b852e13,/Users/sanika/Downloads/Master Thesis/repo_updated/pytest/testing/test_reports.py,1979,ModificationType.MODIFY,466,257,367,18,25,50,484,7,126,86,171,133,257,898.7887548153927,1813.2075859238057,4.75,8612.736033138077,478.4853351743376,0.6044025286412685
0794289689a3079625d8c6fd839968075b852e13,/Users/sanika/Downloads/Master Thesis/repo_updated/pytest/src/_pytest/reports.py,1979,ModificationType.MODIFY,507,281,342,29,59,88,536,10,53,29,57,63,86,336.79906504072324,514.0460734209928,5.377358490566038,2764.2100174525085,153.56722319180602,0.17134869114033094
0794289689a3079625d8c6fd839968075b852e13,/Users/sanika/Downloads/Master Thesis/repo_updated/pytest/testing/test_runner.py,1930,ModificationType.MODIFY,1043,504,840,53,9,147,1096,9,180,112,198,189,310,1377.0628823523223,2344.2951515085324,4.95,11604.260999967235,644.6811666648464,0.7814317171695108
0794289689a3079625d8c6fd839968075b852e13,/Users/sanika/Downloads/Master Thesis/repo_updated/pytest/src/_pytest/runner.py,1930,ModificationType.MODIFY,383,288,292,26,6,62,409,11,65,38,67,76,105,429.5076556518598,656.0323889115765,5.6692307692307695,3719.199004829476,206.6221669349709,0.2186774629705255
0794289689a3079625d8c6fd839968075b852e13,/Users/sanika/Downloads/Master Thesis/repo_updated/pytest/testing/code/test_excinfo.py,7107,ModificationType.MODIFY,1392,870,1177,35,17,170,1427,14,494,280,531,508,811,4473.796381311637,7289.823280972226,7.5242914979757085,54850.755334764704,3047.2641852647057,2.4299410936574084
262ed567d065cf2455f988a60def75133a711345,/Users/sanika/Downloads/Master Thesis/repo_updated/pytest/testing/test_cacheprovider.py,3865,ModificationType.MODIFY,996,429,845,24,10,117,1020,7,76,50,88,83,138,494.49397547611574,879.7554415258757,4.052631578947368,3565.3246840785487,198.07359355991937,0.29325181384195853
9309ae299ae94caf66187f98ad500ef6f082d762,/Users/sanika/Downloads/Master Thesis/repo_updated/pytest/testing/test_cacheprovider.py,3873,ModificationType.MODIFY,996,429,845,24,10,117,1020,7,76,50,88,83,138,494.49397547611574,879.7554415258757,4.052631578947368,3565.3246840785487,198.07359355991937,0.29325181384195853
d8096925fac4093deda89bc952e12e46bb9557ab,/Users/sanika/Downloads/Master Thesis/repo_updated/pytest/testing/test_cacheprovider.py,3885,ModificationType.MODIFY,996,429,845,24,10,117,1020,7,76,50,88,83,138,494.49397547611574,879.7554415258757,4.052631578947368,3565.3246840785487,198.07359355991937,0.29325181384195853
00f67494e5de70ffa4427bf0802a164c5790160d,/Users/sanika/Downloads/Master Thesis/repo_updated/pytest/testing/test_terminal.py,6307,ModificationType.MODIFY,1943,715,1694,26,18,214,1969,12,185,120,237,197,357,1436.3251202041715,2721.0724995459263,7.686486486486486,20915.486996509768,1161.971499806098,0.9070241665153088
00f67494e5de70ffa4427bf0802a164c5790160d,/Users/sanika/Downloads/Master Thesis/repo_updated/pytest/src/_pytest/terminal.py,6307,ModificationType.MODIFY,1168,838,957,57,25,144,1225,19,348,224,416,367,640,3018.854959310786,5452.5672018196565,11.35632183908046,61921.107993078396,3440.061555171022,1.8175224006065522
00f67494e5de70ffa4427bf0802a164c5790160d,/Users/sanika/Downloads/Master Thesis/repo_updated/pytest/testing/test_terminal.py,6806,ModificationType.MODIFY,1943,715,1694,26,18,214,1969,12,185,120,237,197,357,1436.3251202041715,2721.0724995459263,7.686486486486486,20915.486996509768,1161.971499806098,0.9070241665153088
e7320c6b547750e630ac59d8b40d48be25e779ce,/Users/sanika/Downloads/Master Thesis/repo_updated/pytest/src/_pytest/logging.py,2969,ModificationType.MODIFY,773,422,505,30,103,129,803,14,77,46,83,91,129,535.8455325423139,839.5055085856318,7.545454545454546,6334.450655691586,351.9139253161992,0.2798351695285439
e7320c6b547750e630ac59d8b40d48be25e779ce,/Users/sanika/Downloads/Master Thesis/repo_updated/pytest/testing/logging/test_formatter.py,501,ModificationType.MODIFY,149,67,118,4,0,27,153,1,17,14,28,18,42,69.48686830125578,175.1368500605771,0.8235294117647058,144.23034710871056,8.01279706159503,0.05837895002019237
ce3d43100267622edbfcf5786d20bdd23c8e29af,/Users/sanika/Downloads/Master Thesis/repo_updated/pytest/src/_pytest/assertion/util.py,2511,ModificationType.MODIFY,477,336,357,30,23,73,507,16,194,134,250,210,384,1538.3830913843028,2962.270278783791,10.309278350515465,30538.86885344115,1696.603825191175,0.9874234262612637
ce3d43100267622edbfcf5786d20bdd23c8e29af,/Users/sanika/Downloads/Master Thesis/repo_updated/pytest/testing/test_assertion.py,5319,ModificationType.MODIFY,1450,624,1228,12,26,181,1462,14,306,186,354,320,540,2580.063648772758,4493.841171239175,8.098039215686274,36391.30203376038,2021.7390018755768,1.497947057079725
9071a2a5e01a1f2a44af793d3466a3aa9433b8b7,/Users/sanika/Downloads/Master Thesis/repo_updated/pytest/testing/test_nodes.py,1826,ModificationType.MODIFY,53,23,39,0,0,13,53,2,8,4,8,10,12,26.0,39.863137138648355,1.0,39.863137138648355,2.2146187299249087,0.013287712379549451
9071a2a5e01a1f2a44af793d3466a3aa9433b8b7,/Users/sanika/Downloads/Master Thesis/repo_updated/pytest/src/_pytest/nodes.py,1826,ModificationType.MODIFY,515,298,307,33,80,99,548,12,63,44,77,75,121,419.58818518914865,753.6870615500015,7.333333333333333,5527.038451366678,307.0576917425932,0.2512290205166672
eb4b3ce1c84fe5919d38e0d58805ca417c8a499d,/Users/sanika/Downloads/Master Thesis/repo_updated/pytest/testing/test_capture.py,5003,ModificationType.MODIFY,1513,682,1277,25,13,200,1538,11,199,116,219,210,335,1557.7420472931965,2584.272248418151,6.052763819095477,15641.989563917903,868.9994202176613,0.8614240828060503
0485b07ff07ad5520418142c7a85b50111403e78,/Users/sanika/Downloads/Master Thesis/repo_updated/pytest/testing/python/approx.py,4372,ModificationType.MODIFY,520,294,400,33,13,81,553,10,261,204,367,271,571,2128.502746053614,4614.907102613061,7.030651340996169,32445.802809559264,1802.5446005310703,1.5383023675376872
01769b141a842ba4e7c53d853bb0c7d14c111451,/Users/sanika/Downloads/Master Thesis/repo_updated/pytest/testing/test_skipping.py,786,ModificationType.MODIFY,1178,367,1042,6,15,115,1184,9,94,51,95,103,146,644.6606770706787,976.22907696875,4.547872340425532,4439.7652170653255,246.65362317029587,0.32540969232291667
01769b141a842ba4e7c53d853bb0c7d14c111451,/Users/sanika/Downloads/Master Thesis/repo_updated/pytest/src/_pytest/skipping.py,786,ModificationType.MODIFY,177,108,140,8,0,27,185,6,30,16,32,36,48,162.7164928725825,248.15640006923098,3.2,794.1004802215392,44.11669334564107,0.082718800023077
01769b141a842ba4e7c53d853bb0c7d14c111451,/Users/sanika/Downloads/Master Thesis/repo_updated/pytest/testing/test_terminal.py,6305,ModificationType.MODIFY,1943,715,1694,26,18,214,1969,12,185,120,237,197,357,1436.3251202041715,2721.0724995459263,7.686486486486486,20915.486996509768,1161.971499806098,0.9070241665153088
01769b141a842ba4e7c53d853bb0c7d14c111451,/Users/sanika/Downloads/Master Thesis/repo_updated/pytest/src/_pytest/terminal.py,6305,ModificationType.MODIFY,1168,838,957,57,25,144,1225,19,348,224,416,367,640,3018.854959310786,5452.5672018196565,11.35632183908046,61921.107993078396,3440.061555171022,1.8175224006065522
01769b141a842ba4e7c53d853bb0c7d14c111451,/Users/sanika/Downloads/Master Thesis/repo_updated/pytest/testing/test_skipping.py,3071,ModificationType.MODIFY,1178,367,1042,6,15,115,1184,9,94,51,95,103,146,644.6606770706787,976.22907696875,4.547872340425532,4439.7652170653255,246.65362317029587,0.32540969232291667
92b436c938ae08ef8b579a88d9ace8e807b5927e,/Users/sanika/Downloads/Master Thesis/repo_updated/pytest/testing/test_cacheprovider.py,3885,ModificationType.MODIFY,996,429,845,24,10,117,1020,7,76,50,88,83,138,494.49397547611574,879.7554415258757,4.052631578947368,3565.3246840785487,198.07359355991937,0.29325181384195853
4e454724057ceda78790caaace6810194aa22dc4,/Users/sanika/Downloads/Master Thesis/repo_updated/pytest/testing/code/test_code.py,5035,ModificationType.MODIFY,182,127,129,0,0,53,182,5,39,21,42,44,63,217.7403270100645,343.9441919741497,2.6923076923076925,926.003593776557,51.44464409869761,0.11464806399138323
4e454724057ceda78790caaace6810194aa22dc4,/Users/sanika/Downloads/Master Thesis/repo_updated/pytest/src/_pytest/_code/code.py,5035,ModificationType.MODIFY,1165,710,800,67,119,181,1232,18,243,153,282,261,435,2000.7880884021665,3492.1391085079,10.444444444444445,36473.45291108251,2026.302939504584,1.1640463695026333
4e454724057ceda78790caaace6810194aa22dc4,/Users/sanika/Downloads/Master Thesis/repo_updated/pytest/src/_pytest/assertion/util.py,2508,ModificationType.MODIFY,477,336,357,30,23,73,507,16,194,134,250,210,384,1538.3830913843028,2962.270278783791,10.309278350515465,30538.86885344115,1696.603825191175,0.9874234262612637
4e454724057ceda78790caaace6810194aa22dc4,/Users/sanika/Downloads/Master Thesis/repo_updated/pytest/src/_pytest/debugging.py,1477,ModificationType.MODIFY,339,213,244,17,9,65,356,10,42,26,48,52,74,259.6966127055816,421.83253914244085,5.714285714285714,2410.471652242519,133.91509179125106,0.14061084638081361
4e454724057ceda78790caaace6810194aa22dc4,/Users/sanika/Downloads/Master Thesis/repo_updated/pytest/testing/test_junitxml.py,3166,ModificationType.MODIFY,1523,757,1297,19,12,193,1542,12,193,117,230,205,347,1508.3637582013935,2664.7795945283897,7.150259067357513,19053.864458285894,1058.5480254603274,0.8882598648427965
4e454724057ceda78790caaace6810194aa22dc4,/Users/sanika/Downloads/Master Thesis/repo_updated/pytest/src/_pytest/junitxml.py,3166,ModificationType.MODIFY,701,378,504,33,58,109,734,13,110,68,126,123,194,794.0552848235468,1346.8478140358125,7.445454545454545,10027.894179048459,557.1052321693588,0.4489492713452708
4e454724057ceda78790caaace6810194aa22dc4,/Users/sanika/Downloads/Master Thesis/repo_updated/pytest/testing/test_main.py,3505,ModificationType.MODIFY,77,34,69,0,0,8,77,3,24,16,29,27,45,114.79398751947123,213.9699375973561,1.8125,387.82051189520797,21.54558399417822,0.07132331253245204
4e454724057ceda78790caaace6810194aa22dc4,/Users/sanika/Downloads/Master Thesis/repo_updated/pytest/src/_pytest/main.py,3505,ModificationType.MODIFY,712,438,573,51,9,84,763,14,102,71,128,116,199,733.8903537898989,1364.7382180303869,8.784313725490197,11988.28866034536,666.0160366858534,0.45491273934346227
4e454724057ceda78790caaace6810194aa22dc4,/Users/sanika/Downloads/Master Thesis/repo_updated/pytest/src/_pytest/mark/evaluate.py,669,ModificationType.MODIFY,125,97,103,3,0,19,128,9,25,17,27,34,44,144.62572975734892,223.84836501501496,4.86,1087.9030539729729,60.43905855405405,0.07461612167167166
4e454724057ceda78790caaace6810194aa22dc4,/Users/sanika/Downloads/Master Thesis/repo_updated/pytest/src/_pytest/mark/legacy.py,367,ModificationType.MODIFY,102,57,55,5,16,25,107,5,17,10,18,22,28,81.0965087756926,124.86408532184433,2.6470588235294117,330.5225787931173,18.362365488506516,0.04162136177394811
4e454724057ceda78790caaace6810194aa22dc4,/Users/sanika/Downloads/Master Thesis/repo_updated/pytest/doc/en/example/multipython.py,6698,ModificationType.MODIFY,72,33,56,0,4,12,72,1,1,1,1,2,2,0.0,2.0,0.5,1.0,0.05555555555555555,0.0006666666666666666
4e454724057ceda78790caaace6810194aa22dc4,/Users/sanika/Downloads/Master Thesis/repo_updated/pytest/src/_pytest/python.py,6698,ModificationType.MODIFY,1454,835,1044,76,110,219,1530,17,275,158,296,292,454,2297.8910156145625,3718.180349731528,9.149090909090908,34017.97003608918,1889.8872242271766,1.2393934499105095
4e454724057ceda78790caaace6810194aa22dc4,/Users/sanika/Downloads/Master Thesis/repo_updated/pytest/testing/test_skipping.py,786,ModificationType.MODIFY,1178,367,1042,6,15,115,1184,9,94,51,95,103,146,644.6606770706787,976.22907696875,4.547872340425532,4439.7652170653255,246.65362317029587,0.32540969232291667
4e454724057ceda78790caaace6810194aa22dc4,/Users/sanika/Downloads/Master Thesis/repo_updated/pytest/src/_pytest/skipping.py,786,ModificationType.MODIFY,177,108,140,8,0,27,185,6,30,16,32,36,48,162.7164928725825,248.15640006923098,3.2,794.1004802215392,44.11669334564107,0.082718800023077
4e454724057ceda78790caaace6810194aa22dc4,/Users/sanika/Downloads/Master Thesis/repo_updated/pytest/testing/python/metafunc.py,5933,ModificationType.MODIFY,1782,648,1425,9,47,279,1791,8,171,97,189,179,286,1292.4527800454887,2140.3713122975773,4.421052631578948,9462.69422278929,525.705234599405,0.7134571040991925
4e454724057ceda78790caaace6810194aa22dc4,/Users/sanika/Downloads/Master Thesis/repo_updated/pytest/testing/test_mark.py,3090,ModificationType.MODIFY,1020,354,843,12,15,144,1032,8,134,77,144,142,221,970.8559515213415,1580.0941134105349,4.298507462686567,6792.0463382422995,377.3359076801278,0.5266980378035117
4e454724057ceda78790caaace6810194aa22dc4,/Users/sanika/Downloads/Master Thesis/repo_updated/pytest/testing/test_nose.py,637,ModificationType.MODIFY,424,94,331,4,0,89,428,1,5,5,5,6,10,11.60964047443681,25.84962500721156,0.5,12.92481250360578,0.71804513908921,0.00861654166907052
4e454724057ceda78790caaace6810194aa22dc4,/Users/sanika/Downloads/Master Thesis/repo_updated/pytest/testing/test_parseopt.py,2315,ModificationType.MODIFY,334,251,279,10,4,40,344,5,127,74,143,132,217,899.1725956945019,1528.6335239007844,2.8149606299212597,4303.043187358508,239.0579548532504,0.5095445079669282
4e454724057ceda78790caaace6810194aa22dc4,/Users/sanika/Downloads/Master Thesis/repo_updated/pytest/testing/test_pdb.py,4230,ModificationType.MODIFY,1293,570,1093,25,15,163,1318,10,195,123,241,205,364,1516.6486921300477,2795.3307562199825,6.17948717948718,17273.710570487587,959.6505872493103,0.9317769187399941
4e454724057ceda78790caaace6810194aa22dc4,/Users/sanika/Downloads/Master Thesis/repo_updated/pytest/testing/test_stepwise.py,645,ModificationType.MODIFY,219,78,157,11,5,46,230,3,24,20,34,27,54,114.79398751947123,256.76392511682735,2.125,545.6233408732581,30.31240782629212,0.08558797503894246
8dcee39ce93f36acd2f7daf4482546a6ac9f4041,/Users/sanika/Downloads/Master Thesis/repo_updated/pytest/testing/test_capture.py,5010,ModificationType.MODIFY,1513,682,1277,25,13,200,1538,11,199,116,219,210,335,1557.7420472931965,2584.272248418151,6.052763819095477,15641.989563917903,868.9994202176613,0.8614240828060503
74f4ec59869c417b1891f7a97cd184a2093263a7,/Users/sanika/Downloads/Master Thesis/repo_updated/pytest/testing/example_scripts/collect/package_infinite_recursion/__init__.pyi,5077,ModificationType.MODIFY,0,0,0,0,0,0,0,0,0,0,0,0,0,0,0,0,0,0.0,0.0
74f4ec59869c417b1891f7a97cd184a2093263a7,/Users/sanika/Downloads/Master Thesis/repo_updated/pytest/testing/example_scripts/collect/package_infinite_recursion/tests/__init__.py,5077,ModificationType.MODIFY,0,0,0,0,0,0,0,0,0,0,0,0,0,0,0,0,0,0.0,0.0
74f4ec59869c417b1891f7a97cd184a2093263a7,/Users/sanika/Downloads/Master Thesis/repo_updated/pytest/testing/example_scripts/collect/collect_init_tests/tests/__init__.py,5077,ModificationType.MODIFY,2,2,2,0,0,0,2,0,0,0,0,0,0,0,0,0,0,0.0,0.0
74f4ec59869c417b1891f7a97cd184a2093263a7,/Users/sanika/Downloads/Master Thesis/repo_updated/pytest/testing/example_scripts/collect/package_init_given_as_arg/pkg/__init__.py,5077,ModificationType.MODIFY,0,0,0,0,0,0,0,0,0,0,0,0,0,0,0,0,0,0.0,0.0
74f4ec59869c417b1891f7a97cd184a2093263a7,/Users/sanika/Downloads/Master Thesis/repo_updated/pytest/testing/example_scripts/conftest_usageerror/__init__.pyi,5077,ModificationType.MODIFY,0,0,0,0,0,0,0,0,0,0,0,0,0,0,0,0,0,0.0,0.0
74f4ec59869c417b1891f7a97cd184a2093263a7,/Users/sanika/Downloads/Master Thesis/repo_updated/pytest/testing/example_scripts/marks/marks_considered_keywords/__init__.pyi,5077,ModificationType.MODIFY,0,0,0,0,0,0,0,0,0,0,0,0,0,0,0,0,0,0.0,0.0
74f4ec59869c417b1891f7a97cd184a2093263a7,/Users/sanika/Downloads/Master Thesis/repo_updated/pytest/testing/example_scripts/config/collect_pytest_prefix/__init__.pyi,5077,ModificationType.MODIFY,0,0,0,0,0,0,0,0,0,0,0,0,0,0,0,0,0,0.0,0.0
74f4ec59869c417b1891f7a97cd184a2093263a7,/Users/sanika/Downloads/Master Thesis/repo_updated/pytest/testing/example_scripts/issue88_initial_file_multinodes/__init__.pyi,5077,ModificationType.MODIFY,0,0,0,0,0,0,0,0,0,0,0,0,0,0,0,0,0,0.0,0.0
74f4ec59869c417b1891f7a97cd184a2093263a7,/Users/sanika/Downloads/Master Thesis/repo_updated/pytest/testing/example_scripts/fixtures/fill_fixtures/test_extend_fixture_conftest_conftest/__init__.pyi,5077,ModificationType.MODIFY,0,0,0,0,0,0,0,0,0,0,0,0,0,0,0,0,0,0.0,0.0
74f4ec59869c417b1891f7a97cd184a2093263a7,/Users/sanika/Downloads/Master Thesis/repo_updated/pytest/testing/example_scripts/fixtures/fill_fixtures/test_extend_fixture_conftest_conftest/pkg/__init__.py,5077,ModificationType.MODIFY,0,0,0,0,0,0,0,0,0,0,0,0,0,0,0,0,0,0.0,0.0
74f4ec59869c417b1891f7a97cd184a2093263a7,/Users/sanika/Downloads/Master Thesis/repo_updated/pytest/testing/example_scripts/fixtures/fill_fixtures/test_extend_fixture_conftest_module/__init__.pyi,5077,ModificationType.MODIFY,0,0,0,0,0,0,0,0,0,0,0,0,0,0,0,0,0,0.0,0.0
74f4ec59869c417b1891f7a97cd184a2093263a7,/Users/sanika/Downloads/Master Thesis/repo_updated/pytest/testing/example_scripts/fixtures/fill_fixtures/test_conftest_funcargs_only_available_in_subdir/sub1/__init__.py,5077,ModificationType.MODIFY,0,0,0,0,0,0,0,0,0,0,0,0,0,0,0,0,0,0.0,0.0
74f4ec59869c417b1891f7a97cd184a2093263a7,/Users/sanika/Downloads/Master Thesis/repo_updated/pytest/testing/example_scripts/fixtures/fill_fixtures/test_conftest_funcargs_only_available_in_subdir/sub2/__init__.py,5077,ModificationType.MODIFY,0,0,0,0,0,0,0,0,0,0,0,0,0,0,0,0,0,0.0,0.0
74f4ec59869c417b1891f7a97cd184a2093263a7,/Users/sanika/Downloads/Master Thesis/repo_updated/pytest/testing/example_scripts/fixtures/custom_item/__init__.pyi,5077,ModificationType.MODIFY,0,0,0,0,0,0,0,0,0,0,0,0,0,0,0,0,0,0.0,0.0
74f4ec59869c417b1891f7a97cd184a2093263a7,/Users/sanika/Downloads/Master Thesis/repo_updated/pytest/testing/example_scripts/fixtures/custom_item/foo/__init__.py,5077,ModificationType.MODIFY,0,0,0,0,0,0,0,0,0,0,0,0,0,0,0,0,0,0.0,0.0
74f4ec59869c417b1891f7a97cd184a2093263a7,/Users/sanika/Downloads/Master Thesis/repo_updated/pytest/doc/en/example/nonpython/__init__.py,5077,ModificationType.MODIFY,0,0,0,0,0,0,0,0,0,0,0,0,0,0,0,0,0,0.0,0.0
74f4ec59869c417b1891f7a97cd184a2093263a7,/Users/sanika/Downloads/Master Thesis/repo_updated/pytest/src/pytest/__init__.py,5077,ModificationType.MODIFY,99,48,90,1,3,5,100,0,0,0,0,0,0,0,0,0,0,0.0,0.0
74f4ec59869c417b1891f7a97cd184a2093263a7,/Users/sanika/Downloads/Master Thesis/repo_updated/pytest/src/_pytest/__init__.py,5077,ModificationType.MODIFY,8,5,5,2,0,1,10,0,0,0,0,0,0,0,0,0,0,0.0,0.0
74f4ec59869c417b1891f7a97cd184a2093263a7,/Users/sanika/Downloads/Master Thesis/repo_updated/pytest/src/_pytest/config/__init__.py,5077,ModificationType.MODIFY,1217,716,841,84,126,174,1301,14,185,118,215,199,333,1446.608539104324,2542.995998641035,8.135135135135135,20687.616097052745,1149.3120053918192,0.847665332880345
74f4ec59869c417b1891f7a97cd184a2093263a7,/Users/sanika/Downloads/Master Thesis/repo_updated/pytest/src/_pytest/mark/__init__.py,5077,ModificationType.MODIFY,160,89,115,0,13,31,160,7,15,11,17,22,28,78.25484338853101,124.86408532184433,3.966666666666667,495.2942051099825,27.51634472833236,0.04162136177394811
74f4ec59869c417b1891f7a97cd184a2093263a7,/Users/sanika/Downloads/Master Thesis/repo_updated/pytest/src/_pytest/_code/__init__.py,5077,ModificationType.MODIFY,10,10,9,9,0,0,19,0,0,0,0,0,0,0,0,0,0,0.0,0.0
74f4ec59869c417b1891f7a97cd184a2093263a7,/Users/sanika/Downloads/Master Thesis/repo_updated/pytest/src/_pytest/assertion/__init__.py,5077,ModificationType.MODIFY,173,84,99,8,29,36,181,5,12,7,13,17,20,54.62919048309069,81.7492568250068,2.7083333333333335,221.4042372343934,12.300235401910745,0.027249752275002266
74f4ec59869c417b1891f7a97cd184a2093263a7,/Users/sanika/Downloads/Master Thesis/repo_updated/pytest/src/_pytest/_io/__init__.py,5077,ModificationType.MODIFY,3,1,1,3,0,0,6,0,0,0,0,0,0,0,0,0,0,0.0,0.0
74f4ec59869c417b1891f7a97cd184a2093263a7,/Users/sanika/Downloads/Master Thesis/repo_updated/pytest/src/_pytest/hookspec.py,642,ModificationType.MODIFY,647,139,84,35,284,233,682,0,0,0,0,0,0,0,0,0,0,0.0,0.0
74f4ec59869c417b1891f7a97cd184a2093263a7,/Users/sanika/Downloads/Master Thesis/repo_updated/pytest/testing/test_pluginmanager.py,1924,ModificationType.MODIFY,384,251,317,7,8,52,391,11,70,44,84,81,128,467.103558991158,811.500800369232,6.6,5355.905282436931,297.5502934687184,0.270500266789744
85288b53218d4e0037dce9c34bd37f86fa9e212d,/Users/sanika/Downloads/Master Thesis/repo_updated/pytest/doc/en/example/multipython.py,6763,ModificationType.MODIFY,72,33,56,0,4,12,72,1,1,1,1,2,2,0.0,2.0,0.5,1.0,0.05555555555555555,0.0006666666666666666
85288b53218d4e0037dce9c34bd37f86fa9e212d,/Users/sanika/Downloads/Master Thesis/repo_updated/pytest/src/_pytest/python.py,6763,ModificationType.MODIFY,1454,835,1044,76,110,219,1530,17,275,158,296,292,454,2297.8910156145625,3718.180349731528,9.149090909090908,34017.97003608918,1889.8872242271766,1.2393934499105095
85288b53218d4e0037dce9c34bd37f86fa9e212d,/Users/sanika/Downloads/Master Thesis/repo_updated/pytest/testing/test_skipping.py,3116,ModificationType.MODIFY,1178,367,1042,6,15,115,1184,9,94,51,95,103,146,644.6606770706787,976.22907696875,4.547872340425532,4439.7652170653255,246.65362317029587,0.32540969232291667
1cecdf66198049c7ca48356d8349e2f07732764c,/Users/sanika/Downloads/Master Thesis/repo_updated/pytest/doc/en/conf.py,319,ModificationType.MODIFY,382,65,130,157,2,92,539,4,10,5,10,14,15,41.219280948873624,57.110323830864054,2.0,114.22064766172811,6.345591536762672,0.019036774610288017
1cecdf66198049c7ca48356d8349e2f07732764c,/Users/sanika/Downloads/Master Thesis/repo_updated/pytest/scripts/release.py,539,ModificationType.MODIFY,124,78,88,2,3,26,126,4,13,7,13,17,20,56.105716335834195,81.7492568250068,2.0,163.4985136500136,9.083250758334088,0.027249752275002266
fe429d4ce8eaf556930f8739f08eedef209508c9,/Users/sanika/Downloads/Master Thesis/repo_updated/pytest/src/_pytest/assertion/util.py,2511,ModificationType.MODIFY,477,336,357,30,23,73,507,16,194,134,250,210,384,1538.3830913843028,2962.270278783791,10.309278350515465,30538.86885344115,1696.603825191175,0.9874234262612637
fe429d4ce8eaf556930f8739f08eedef209508c9,/Users/sanika/Downloads/Master Thesis/repo_updated/pytest/testing/test_assertion.py,5319,ModificationType.MODIFY,1450,624,1228,12,26,181,1462,14,306,186,354,320,540,2580.063648772758,4493.841171239175,8.098039215686274,36391.30203376038,2021.7390018755768,1.497947057079725
5be3a9b5cee3ef73b627049272db5bd2e34f5026,/Users/sanika/Downloads/Master Thesis/repo_updated/pytest/testing/test_faulthandler.py,310,ModificationType.MODIFY,103,47,73,2,12,15,105,5,16,9,17,21,26,75.60964047443682,114.20025299224778,2.65625,303.34442201065815,16.85246788948101,0.03806675099741593
eb7a4e32ad920b4cdd9c956763535fed194ae8a7,/Users/sanika/Downloads/Master Thesis/repo_updated/pytest/testing/io/test_saferepr.py,382,ModificationType.MODIFY,149,95,105,2,0,41,151,8,54,28,55,62,83,334.76392511682735,494.19829376211067,4.074074074074074,2013.4004560678584,111.85558089265879,0.1647327645873702
eb7a4e32ad920b4cdd9c956763535fed194ae8a7,/Users/sanika/Downloads/Master Thesis/repo_updated/pytest/src/_pytest/_io/saferepr.py,382,ModificationType.MODIFY,82,56,54,0,13,15,82,4,13,8,16,17,24,56.105716335834195,98.09910819000817,2.4615384615384617,241.47472785232782,13.415262658462657,0.03269970273000272
eb7a4e32ad920b4cdd9c956763535fed194ae8a7,/Users/sanika/Downloads/Master Thesis/repo_updated/pytest/testing/code/test_excinfo.py,7107,ModificationType.MODIFY,1392,870,1177,35,17,170,1427,14,494,280,531,508,811,4473.796381311637,7289.823280972226,7.5242914979757085,54850.755334764704,3047.2641852647057,2.4299410936574084
eb7a4e32ad920b4cdd9c956763535fed194ae8a7,/Users/sanika/Downloads/Master Thesis/repo_updated/pytest/testing/io/test_saferepr.py,691,ModificationType.MODIFY,149,95,105,2,0,41,151,8,54,28,55,62,83,334.76392511682735,494.19829376211067,4.074074074074074,2013.4004560678584,111.85558089265879,0.1647327645873702
eb7a4e32ad920b4cdd9c956763535fed194ae8a7,/Users/sanika/Downloads/Master Thesis/repo_updated/pytest/testing/test_session.py,1422,ModificationType.MODIFY,373,158,315,8,0,51,381,5,76,44,79,81,123,486.4521314961493,779.8015503548089,2.598684210526316,2026.4579762509838,112.58099868061021,0.25993385011826964
fee7c7b032b5995339375e8cfbaf8f9832aeb512,/Users/sanika/Downloads/Master Thesis/repo_updated/pytest/testing/io/test_saferepr.py,694,ModificationType.MODIFY,149,95,105,2,0,41,151,8,54,28,55,62,83,334.76392511682735,494.19829376211067,4.074074074074074,2013.4004560678584,111.85558089265879,0.1647327645873702
c4a110b20a8c26c9eec89e8f0e496633dab42c98,/Users/sanika/Downloads/Master Thesis/repo_updated/pytest/testing/test_main.py,3503,ModificationType.MODIFY,77,34,69,0,0,8,77,3,24,16,29,27,45,114.79398751947123,213.9699375973561,1.8125,387.82051189520797,21.54558399417822,0.07132331253245204
c4a110b20a8c26c9eec89e8f0e496633dab42c98,/Users/sanika/Downloads/Master Thesis/repo_updated/pytest/src/_pytest/main.py,3503,ModificationType.MODIFY,712,438,573,51,9,84,763,14,102,71,128,116,199,733.8903537898989,1364.7382180303869,8.784313725490197,11988.28866034536,666.0160366858534,0.45491273934346227
0c0d33f78ef626dd9aba9151f9ef13e136805f65,/Users/sanika/Downloads/Master Thesis/repo_updated/pytest/testing/test_main.py,3503,ModificationType.MODIFY,77,34,69,0,0,8,77,3,24,16,29,27,45,114.79398751947123,213.9699375973561,1.8125,387.82051189520797,21.54558399417822,0.07132331253245204
0c0d33f78ef626dd9aba9151f9ef13e136805f65,/Users/sanika/Downloads/Master Thesis/repo_updated/pytest/src/_pytest/main.py,3503,ModificationType.MODIFY,712,438,573,51,9,84,763,14,102,71,128,116,199,733.8903537898989,1364.7382180303869,8.784313725490197,11988.28866034536,666.0160366858534,0.45491273934346227
cb21a8db1d0dbbf1284eb0e644a8cd7b8fc837be,/Users/sanika/Downloads/Master Thesis/repo_updated/pytest/testing/code/test_source.py,2883,ModificationType.MODIFY,773,419,590,28,0,166,801,10,204,113,217,214,330,1598.3940507110585,2554.684105512378,5.318627450980392,13587.413012161423,754.8562784534124,0.8515613685041261
e8a3d1adf2c2688e01e0eaff2110df0d8fc5acd6,/Users/sanika/Downloads/Master Thesis/repo_updated/pytest/testing/test_pdb.py,4230,ModificationType.MODIFY,1293,570,1093,25,15,163,1318,10,195,123,241,205,364,1516.6486921300477,2795.3307562199825,6.17948717948718,17273.710570487587,959.6505872493103,0.9317769187399941
5c00226847e41f734b496e3ba7c7fb8ded0f6739,/Users/sanika/Downloads/Master Thesis/repo_updated/pytest/testing/test_assertion.py,5340,ModificationType.MODIFY,1450,624,1228,12,26,181,1462,14,306,186,354,320,540,2580.063648772758,4493.841171239175,8.098039215686274,36391.30203376038,2021.7390018755768,1.497947057079725
dd6cf7c172afbe6a67483e6a5986432f2f5f043f,/Users/sanika/Downloads/Master Thesis/repo_updated/pytest/testing/code/test_excinfo.py,7121,ModificationType.MODIFY,1392,870,1177,35,17,170,1427,14,494,280,531,508,811,4473.796381311637,7289.823280972226,7.5242914979757085,54850.755334764704,3047.2641852647057,2.4299410936574084
dd852ded705e10c85452fba1458736e71dcb06e0,/Users/sanika/Downloads/Master Thesis/repo_updated/pytest/testing/test_main.py,3505,ModificationType.MODIFY,77,34,69,0,0,8,77,3,24,16,29,27,45,114.79398751947123,213.9699375973561,1.8125,387.82051189520797,21.54558399417822,0.07132331253245204
dd852ded705e10c85452fba1458736e71dcb06e0,/Users/sanika/Downloads/Master Thesis/repo_updated/pytest/src/_pytest/main.py,3505,ModificationType.MODIFY,712,438,573,51,9,84,763,14,102,71,128,116,199,733.8903537898989,1364.7382180303869,8.784313725490197,11988.28866034536,666.0160366858534,0.45491273934346227
dd852ded705e10c85452fba1458736e71dcb06e0,/Users/sanika/Downloads/Master Thesis/repo_updated/pytest/testing/acceptance_test.py,4685,ModificationType.MODIFY,1289,550,1043,56,32,155,1345,10,167,93,185,177,278,1266.2978977920404,2075.9943429230734,5.538922155688622,11498.771061100855,638.8206145056031,0.6919981143076911
b268463243a71bcc9e5018e5d3dc9f018539529a,/Users/sanika/Downloads/Master Thesis/repo_updated/pytest/testing/code/test_code.py,5035,ModificationType.MODIFY,182,127,129,0,0,53,182,5,39,21,42,44,63,217.7403270100645,343.9441919741497,2.6923076923076925,926.003593776557,51.44464409869761,0.11464806399138323
b268463243a71bcc9e5018e5d3dc9f018539529a,/Users/sanika/Downloads/Master Thesis/repo_updated/pytest/src/_pytest/_code/code.py,5035,ModificationType.MODIFY,1165,710,800,67,119,181,1232,18,243,153,282,261,435,2000.7880884021665,3492.1391085079,10.444444444444445,36473.45291108251,2026.302939504584,1.1640463695026333
b268463243a71bcc9e5018e5d3dc9f018539529a,/Users/sanika/Downloads/Master Thesis/repo_updated/pytest/src/_pytest/assertion/util.py,2508,ModificationType.MODIFY,477,336,357,30,23,73,507,16,194,134,250,210,384,1538.3830913843028,2962.270278783791,10.309278350515465,30538.86885344115,1696.603825191175,0.9874234262612637
b268463243a71bcc9e5018e5d3dc9f018539529a,/Users/sanika/Downloads/Master Thesis/repo_updated/pytest/src/_pytest/debugging.py,1477,ModificationType.MODIFY,339,213,244,17,9,65,356,10,42,26,48,52,74,259.6966127055816,421.83253914244085,5.714285714285714,2410.471652242519,133.91509179125106,0.14061084638081361
b268463243a71bcc9e5018e5d3dc9f018539529a,/Users/sanika/Downloads/Master Thesis/repo_updated/pytest/testing/test_junitxml.py,3166,ModificationType.MODIFY,1523,757,1297,19,12,193,1542,12,193,117,230,205,347,1508.3637582013935,2664.7795945283897,7.150259067357513,19053.864458285894,1058.5480254603274,0.8882598648427965
b268463243a71bcc9e5018e5d3dc9f018539529a,/Users/sanika/Downloads/Master Thesis/repo_updated/pytest/src/_pytest/junitxml.py,3166,ModificationType.MODIFY,701,378,504,33,58,109,734,13,110,68,126,123,194,794.0552848235468,1346.8478140358125,7.445454545454545,10027.894179048459,557.1052321693588,0.4489492713452708
b268463243a71bcc9e5018e5d3dc9f018539529a,/Users/sanika/Downloads/Master Thesis/repo_updated/pytest/testing/test_main.py,3503,ModificationType.MODIFY,77,34,69,0,0,8,77,3,24,16,29,27,45,114.79398751947123,213.9699375973561,1.8125,387.82051189520797,21.54558399417822,0.07132331253245204
b268463243a71bcc9e5018e5d3dc9f018539529a,/Users/sanika/Downloads/Master Thesis/repo_updated/pytest/src/_pytest/main.py,3503,ModificationType.MODIFY,712,438,573,51,9,84,763,14,102,71,128,116,199,733.8903537898989,1364.7382180303869,8.784313725490197,11988.28866034536,666.0160366858534,0.45491273934346227
b268463243a71bcc9e5018e5d3dc9f018539529a,/Users/sanika/Downloads/Master Thesis/repo_updated/pytest/src/_pytest/mark/evaluate.py,669,ModificationType.MODIFY,125,97,103,3,0,19,128,9,25,17,27,34,44,144.62572975734892,223.84836501501496,4.86,1087.9030539729729,60.43905855405405,0.07461612167167166
b268463243a71bcc9e5018e5d3dc9f018539529a,/Users/sanika/Downloads/Master Thesis/repo_updated/pytest/src/_pytest/mark/legacy.py,367,ModificationType.MODIFY,102,57,55,5,16,25,107,5,17,10,18,22,28,81.0965087756926,124.86408532184433,2.6470588235294117,330.5225787931173,18.362365488506516,0.04162136177394811
b268463243a71bcc9e5018e5d3dc9f018539529a,/Users/sanika/Downloads/Master Thesis/repo_updated/pytest/doc/en/example/multipython.py,6698,ModificationType.MODIFY,72,33,56,0,4,12,72,1,1,1,1,2,2,0.0,2.0,0.5,1.0,0.05555555555555555,0.0006666666666666666
b268463243a71bcc9e5018e5d3dc9f018539529a,/Users/sanika/Downloads/Master Thesis/repo_updated/pytest/src/_pytest/python.py,6698,ModificationType.MODIFY,1454,835,1044,76,110,219,1530,17,275,158,296,292,454,2297.8910156145625,3718.180349731528,9.149090909090908,34017.97003608918,1889.8872242271766,1.2393934499105095
b268463243a71bcc9e5018e5d3dc9f018539529a,/Users/sanika/Downloads/Master Thesis/repo_updated/pytest/testing/test_skipping.py,786,ModificationType.MODIFY,1178,367,1042,6,15,115,1184,9,94,51,95,103,146,644.6606770706787,976.22907696875,4.547872340425532,4439.7652170653255,246.65362317029587,0.32540969232291667
b268463243a71bcc9e5018e5d3dc9f018539529a,/Users/sanika/Downloads/Master Thesis/repo_updated/pytest/src/_pytest/skipping.py,786,ModificationType.MODIFY,177,108,140,8,0,27,185,6,30,16,32,36,48,162.7164928725825,248.15640006923098,3.2,794.1004802215392,44.11669334564107,0.082718800023077
b268463243a71bcc9e5018e5d3dc9f018539529a,/Users/sanika/Downloads/Master Thesis/repo_updated/pytest/testing/python/metafunc.py,5933,ModificationType.MODIFY,1782,648,1425,9,47,279,1791,8,171,97,189,179,286,1292.4527800454887,2140.3713122975773,4.421052631578948,9462.69422278929,525.705234599405,0.7134571040991925
b268463243a71bcc9e5018e5d3dc9f018539529a,/Users/sanika/Downloads/Master Thesis/repo_updated/pytest/testing/test_mark.py,3090,ModificationType.MODIFY,1020,354,843,12,15,144,1032,8,134,77,144,142,221,970.8559515213415,1580.0941134105349,4.298507462686567,6792.0463382422995,377.3359076801278,0.5266980378035117
b268463243a71bcc9e5018e5d3dc9f018539529a,/Users/sanika/Downloads/Master Thesis/repo_updated/pytest/testing/test_nose.py,637,ModificationType.MODIFY,424,94,331,4,0,89,428,1,5,5,5,6,10,11.60964047443681,25.84962500721156,0.5,12.92481250360578,0.71804513908921,0.00861654166907052
b268463243a71bcc9e5018e5d3dc9f018539529a,/Users/sanika/Downloads/Master Thesis/repo_updated/pytest/testing/test_parseopt.py,2315,ModificationType.MODIFY,334,251,279,10,4,40,344,5,127,74,143,132,217,899.1725956945019,1528.6335239007844,2.8149606299212597,4303.043187358508,239.0579548532504,0.5095445079669282
b268463243a71bcc9e5018e5d3dc9f018539529a,/Users/sanika/Downloads/Master Thesis/repo_updated/pytest/testing/test_pdb.py,4230,ModificationType.MODIFY,1293,570,1093,25,15,163,1318,10,195,123,241,205,364,1516.6486921300477,2795.3307562199825,6.17948717948718,17273.710570487587,959.6505872493103,0.9317769187399941
b268463243a71bcc9e5018e5d3dc9f018539529a,/Users/sanika/Downloads/Master Thesis/repo_updated/pytest/testing/test_stepwise.py,645,ModificationType.MODIFY,219,78,157,11,5,46,230,3,24,20,34,27,54,114.79398751947123,256.76392511682735,2.125,545.6233408732581,30.31240782629212,0.08558797503894246
ab101658f03e29bf69a7252a937b706ee3f75a01,/Users/sanika/Downloads/Master Thesis/repo_updated/pytest/testing/io/test_saferepr.py,382,ModificationType.MODIFY,149,95,105,2,0,41,151,8,54,28,55,62,83,334.76392511682735,494.19829376211067,4.074074074074074,2013.4004560678584,111.85558089265879,0.1647327645873702
ab101658f03e29bf69a7252a937b706ee3f75a01,/Users/sanika/Downloads/Master Thesis/repo_updated/pytest/src/_pytest/_io/saferepr.py,382,ModificationType.MODIFY,82,56,54,0,13,15,82,4,13,8,16,17,24,56.105716335834195,98.09910819000817,2.4615384615384617,241.47472785232782,13.415262658462657,0.03269970273000272
ab101658f03e29bf69a7252a937b706ee3f75a01,/Users/sanika/Downloads/Master Thesis/repo_updated/pytest/testing/code/test_excinfo.py,7107,ModificationType.MODIFY,1392,870,1177,35,17,170,1427,14,494,280,531,508,811,4473.796381311637,7289.823280972226,7.5242914979757085,54850.755334764704,3047.2641852647057,2.4299410936574084
ab101658f03e29bf69a7252a937b706ee3f75a01,/Users/sanika/Downloads/Master Thesis/repo_updated/pytest/testing/io/test_saferepr.py,694,ModificationType.MODIFY,149,95,105,2,0,41,151,8,54,28,55,62,83,334.76392511682735,494.19829376211067,4.074074074074074,2013.4004560678584,111.85558089265879,0.1647327645873702
ab101658f03e29bf69a7252a937b706ee3f75a01,/Users/sanika/Downloads/Master Thesis/repo_updated/pytest/testing/test_session.py,1422,ModificationType.MODIFY,373,158,315,8,0,51,381,5,76,44,79,81,123,486.4521314961493,779.8015503548089,2.598684210526316,2026.4579762509838,112.58099868061021,0.25993385011826964
8aa0809fbc9a91ec286ca02bd7f0b673e06905de,/Users/sanika/Downloads/Master Thesis/repo_updated/pytest/testing/test_pathlib.py,1561,ModificationType.MODIFY,91,45,69,0,3,18,91,3,9,6,10,12,16,33.28421251514428,57.359400011538504,1.6666666666666667,95.59900001923084,5.311055556623936,0.01911980000384617
8aa0809fbc9a91ec286ca02bd7f0b673e06905de,/Users/sanika/Downloads/Master Thesis/repo_updated/pytest/src/_pytest/pathlib.py,1561,ModificationType.MODIFY,367,234,237,17,34,68,384,16,55,34,61,71,95,381.9747842438563,584.2259763529448,8.872727272727273,5183.677753822492,287.9820974345829,0.19474199211764828
8aa0809fbc9a91ec286ca02bd7f0b673e06905de,/Users/sanika/Downloads/Master Thesis/repo_updated/pytest/testing/test_tmpdir.py,1853,ModificationType.MODIFY,442,244,305,14,16,103,456,11,68,45,75,79,120,452.0012210100334,756.4536897812524,6.0661764705882355,4588.781574040686,254.932309668927,0.2521512299270841
2e5cf1cc789908ab4856c84a99d7d1120f84e694,/Users/sanika/Downloads/Master Thesis/repo_updated/pytest/testing/test_pathlib.py,1561,ModificationType.MODIFY,91,45,69,0,3,18,91,3,9,6,10,12,16,33.28421251514428,57.359400011538504,1.6666666666666667,95.59900001923084,5.311055556623936,0.01911980000384617
2e5cf1cc789908ab4856c84a99d7d1120f84e694,/Users/sanika/Downloads/Master Thesis/repo_updated/pytest/src/_pytest/pathlib.py,1561,ModificationType.MODIFY,367,234,237,17,34,68,384,16,55,34,61,71,95,381.9747842438563,584.2259763529448,8.872727272727273,5183.677753822492,287.9820974345829,0.19474199211764828
2e5cf1cc789908ab4856c84a99d7d1120f84e694,/Users/sanika/Downloads/Master Thesis/repo_updated/pytest/testing/test_tmpdir.py,1859,ModificationType.MODIFY,442,244,305,14,16,103,456,11,68,45,75,79,120,452.0012210100334,756.4536897812524,6.0661764705882355,4588.781574040686,254.932309668927,0.2521512299270841
b2537b22d7799d02621a68c1ff4b49adc98693cf,/Users/sanika/Downloads/Master Thesis/repo_updated/pytest/testing/test_warning_types.py,222,ModificationType.MODIFY,37,13,25,0,6,6,37,1,2,1,2,3,3,2.0,4.754887502163469,0.5,2.3774437510817346,0.1320802083934297,0.0015849625007211565
b2537b22d7799d02621a68c1ff4b49adc98693cf,/Users/sanika/Downloads/Master Thesis/repo_updated/pytest/src/_pytest/warning_types.py,222,ModificationType.MODIFY,133,47,40,1,43,49,134,0,0,0,0,0,0,0,0,0,0,0.0,0.0
58f2849bf6c46790b2d2f9975b61cf1a9bbd9e92,/Users/sanika/Downloads/Master Thesis/repo_updated/pytest/testing/code/test_source.py,1732,ModificationType.MODIFY,773,419,590,28,0,166,801,10,204,113,217,214,330,1598.3940507110585,2554.684105512378,5.318627450980392,13587.413012161423,754.8562784534124,0.8515613685041261
58f2849bf6c46790b2d2f9975b61cf1a9bbd9e92,/Users/sanika/Downloads/Master Thesis/repo_updated/pytest/src/_pytest/_code/source.py,1732,ModificationType.MODIFY,421,273,302,44,34,57,465,17,81,59,107,98,166,583.0147185349103,1098.0418341231248,11.228395061728396,12329.247507839284,684.9581948799602,0.36601394470770826
265a9eb6a2916a8224d0561c269dc52d59d2ac48,/Users/sanika/Downloads/Master Thesis/repo_updated/pytest/testing/test_pytester.py,6311,ModificationType.MODIFY,722,423,573,19,0,135,741,12,172,101,199,184,300,1320.3370878174146,2257.068586817104,6.941860465116279,15668.255189881524,870.4586216600846,0.7523561956057013
265a9eb6a2916a8224d0561c269dc52d59d2ac48,/Users/sanika/Downloads/Master Thesis/repo_updated/pytest/src/_pytest/pytester.py,6311,ModificationType.MODIFY,1508,847,911,44,250,301,1552,14,148,88,169,162,257,1120.302067021891,1886.3414507413484,7.993243243243243,15077.986055587939,837.6658919771077,0.6287804835804495
14eaa05b607c22fc40aeda93ded46b40b8b9ed86,/Users/sanika/Downloads/Master Thesis/repo_updated/pytest/testing/code/test_source.py,2883,ModificationType.MODIFY,773,419,590,28,0,166,801,10,204,113,217,214,330,1598.3940507110585,2554.684105512378,5.318627450980392,13587.413012161423,754.8562784534124,0.8515613685041261
f11237b0661aa53f3a5bc3c28330365a0e57012c,/Users/sanika/Downloads/Master Thesis/repo_updated/pytest/testing/test_main.py,3503,ModificationType.MODIFY,77,34,69,0,0,8,77,3,24,16,29,27,45,114.79398751947123,213.9699375973561,1.8125,387.82051189520797,21.54558399417822,0.07132331253245204
f11237b0661aa53f3a5bc3c28330365a0e57012c,/Users/sanika/Downloads/Master Thesis/repo_updated/pytest/src/_pytest/main.py,3503,ModificationType.MODIFY,712,438,573,51,9,84,763,14,102,71,128,116,199,733.8903537898989,1364.7382180303869,8.784313725490197,11988.28866034536,666.0160366858534,0.45491273934346227
f11237b0661aa53f3a5bc3c28330365a0e57012c,/Users/sanika/Downloads/Master Thesis/repo_updated/pytest/testing/acceptance_test.py,4685,ModificationType.MODIFY,1289,550,1043,56,32,155,1345,10,167,93,185,177,278,1266.2978977920404,2075.9943429230734,5.538922155688622,11498.771061100855,638.8206145056031,0.6919981143076911
19b2f4bb8ac2f981396b5ab1973cceaea3679a2f,/Users/sanika/Downloads/Master Thesis/repo_updated/pytest/testing/code/test_excinfo.py,7121,ModificationType.MODIFY,1392,870,1177,35,17,170,1427,14,494,280,531,508,811,4473.796381311637,7289.823280972226,7.5242914979757085,54850.755334764704,3047.2641852647057,2.4299410936574084
19b2f4bb8ac2f981396b5ab1973cceaea3679a2f,/Users/sanika/Downloads/Master Thesis/repo_updated/pytest/testing/test_assertion.py,5340,ModificationType.MODIFY,1450,624,1228,12,26,181,1462,14,306,186,354,320,540,2580.063648772758,4493.841171239175,8.098039215686274,36391.30203376038,2021.7390018755768,1.497947057079725
e670ff76cbad80108bde9bab616b66771b8653cf,/Users/sanika/Downloads/Master Thesis/repo_updated/pytest/testing/code/test_source.py,1732,ModificationType.MODIFY,773,419,590,28,0,166,801,10,204,113,217,214,330,1598.3940507110585,2554.684105512378,5.318627450980392,13587.413012161423,754.8562784534124,0.8515613685041261
e670ff76cbad80108bde9bab616b66771b8653cf,/Users/sanika/Downloads/Master Thesis/repo_updated/pytest/src/_pytest/_code/source.py,1732,ModificationType.MODIFY,421,273,302,44,34,57,465,17,81,59,107,98,166,583.0147185349103,1098.0418341231248,11.228395061728396,12329.247507839284,684.9581948799602,0.36601394470770826
e670ff76cbad80108bde9bab616b66771b8653cf,/Users/sanika/Downloads/Master Thesis/repo_updated/pytest/testing/test_pytester.py,6311,ModificationType.MODIFY,722,423,573,19,0,135,741,12,172,101,199,184,300,1320.3370878174146,2257.068586817104,6.941860465116279,15668.255189881524,870.4586216600846,0.7523561956057013
e670ff76cbad80108bde9bab616b66771b8653cf,/Users/sanika/Downloads/Master Thesis/repo_updated/pytest/src/_pytest/pytester.py,6311,ModificationType.MODIFY,1508,847,911,44,250,301,1552,14,148,88,169,162,257,1120.302067021891,1886.3414507413484,7.993243243243243,15077.986055587939,837.6658919771077,0.6287804835804495
e670ff76cbad80108bde9bab616b66771b8653cf,/Users/sanika/Downloads/Master Thesis/repo_updated/pytest/testing/test_warning_types.py,222,ModificationType.MODIFY,37,13,25,0,6,6,37,1,2,1,2,3,3,2.0,4.754887502163469,0.5,2.3774437510817346,0.1320802083934297,0.0015849625007211565
e670ff76cbad80108bde9bab616b66771b8653cf,/Users/sanika/Downloads/Master Thesis/repo_updated/pytest/src/_pytest/warning_types.py,222,ModificationType.MODIFY,133,47,40,1,43,49,134,0,0,0,0,0,0,0,0,0,0,0.0,0.0
45c4a8fb3d33698704ac17a376de36ada3cabecf,/Users/sanika/Downloads/Master Thesis/repo_updated/pytest/setup.py,93,ModificationType.MODIFY,42,7,35,4,0,5,46,1,2,1,2,3,3,2.0,4.754887502163469,0.5,2.3774437510817346,0.1320802083934297,0.0015849625007211565
45c4a8fb3d33698704ac17a376de36ada3cabecf,/Users/sanika/Downloads/Master Thesis/repo_updated/pytest/extra/setup-py.test/setup.py,93,ModificationType.MODIFY,11,6,10,0,0,1,11,2,4,2,4,6,6,10.0,15.509775004326936,1.0,15.509775004326936,0.861654166907052,0.005169925001442312
45c4a8fb3d33698704ac17a376de36ada3cabecf,/Users/sanika/Downloads/Master Thesis/repo_updated/pytest/testing/test_assertrewrite.py,5617,ModificationType.MODIFY,1660,832,1314,41,38,274,1701,20,312,209,395,332,604,2671.484054182769,5058.523816533542,12.66025641025641,64042.2085747035,3557.900476372417,1.6861746055111808
45c4a8fb3d33698704ac17a376de36ada3cabecf,/Users/sanika/Downloads/Master Thesis/repo_updated/pytest/src/_pytest/assertion/rewrite.py,5617,ModificationType.MODIFY,1057,646,719,113,100,145,1170,18,215,134,248,233,382,1740.9201126876956,3004.119107257935,10.38139534883721,31186.948127440515,1732.608229302251,1.001373035752645
45c4a8fb3d33698704ac17a376de36ada3cabecf,/Users/sanika/Downloads/Master Thesis/repo_updated/pytest/testing/test_assertrewrite.py,6340,ModificationType.MODIFY,1660,832,1314,41,38,274,1701,20,312,209,395,332,604,2671.484054182769,5058.523816533542,12.66025641025641,64042.2085747035,3557.900476372417,1.6861746055111808
4946cc82825c277754979cf6ea995482e5b1e2d5,/Users/sanika/Downloads/Master Thesis/repo_updated/pytest/testing/test_main.py,3505,ModificationType.MODIFY,77,34,69,0,0,8,77,3,24,16,29,27,45,114.79398751947123,213.9699375973561,1.8125,387.82051189520797,21.54558399417822,0.07132331253245204
4946cc82825c277754979cf6ea995482e5b1e2d5,/Users/sanika/Downloads/Master Thesis/repo_updated/pytest/src/_pytest/main.py,3505,ModificationType.MODIFY,712,438,573,51,9,84,763,14,102,71,128,116,199,733.8903537898989,1364.7382180303869,8.784313725490197,11988.28866034536,666.0160366858534,0.45491273934346227
4946cc82825c277754979cf6ea995482e5b1e2d5,/Users/sanika/Downloads/Master Thesis/repo_updated/pytest/testing/test_collection.py,4935,ModificationType.MODIFY,1296,573,1062,40,33,157,1336,8,201,118,231,209,349,1561.8613899269646,2689.868337096228,4.597014925373134,12365.364892919973,686.9647162733319,0.896622779032076
0cf2002a1fcc7eda7d8ff7ff78bb9528098bebe4,/Users/sanika/Downloads/Master Thesis/repo_updated/pytest/testing/example_scripts/collect/package_infinite_recursion/__init__.pyi,596,ModificationType.MODIFY,0,0,0,0,0,0,0,0,0,0,0,0,0,0,0,0,0,0.0,0.0
0cf2002a1fcc7eda7d8ff7ff78bb9528098bebe4,/Users/sanika/Downloads/Master Thesis/repo_updated/pytest/testing/example_scripts/collect/package_infinite_recursion/tests/__init__.py,596,ModificationType.MODIFY,0,0,0,0,0,0,0,0,0,0,0,0,0,0,0,0,0,0.0,0.0
0cf2002a1fcc7eda7d8ff7ff78bb9528098bebe4,/Users/sanika/Downloads/Master Thesis/repo_updated/pytest/testing/example_scripts/collect/collect_init_tests/tests/__init__.py,596,ModificationType.MODIFY,2,2,2,0,0,0,2,0,0,0,0,0,0,0,0,0,0,0.0,0.0
0cf2002a1fcc7eda7d8ff7ff78bb9528098bebe4,/Users/sanika/Downloads/Master Thesis/repo_updated/pytest/testing/example_scripts/collect/package_init_given_as_arg/pkg/__init__.py,596,ModificationType.MODIFY,0,0,0,0,0,0,0,0,0,0,0,0,0,0,0,0,0,0.0,0.0
0cf2002a1fcc7eda7d8ff7ff78bb9528098bebe4,/Users/sanika/Downloads/Master Thesis/repo_updated/pytest/testing/example_scripts/conftest_usageerror/__init__.pyi,596,ModificationType.MODIFY,0,0,0,0,0,0,0,0,0,0,0,0,0,0,0,0,0,0.0,0.0
0cf2002a1fcc7eda7d8ff7ff78bb9528098bebe4,/Users/sanika/Downloads/Master Thesis/repo_updated/pytest/testing/example_scripts/marks/marks_considered_keywords/__init__.pyi,596,ModificationType.MODIFY,0,0,0,0,0,0,0,0,0,0,0,0,0,0,0,0,0,0.0,0.0
0cf2002a1fcc7eda7d8ff7ff78bb9528098bebe4,/Users/sanika/Downloads/Master Thesis/repo_updated/pytest/testing/example_scripts/config/collect_pytest_prefix/__init__.pyi,596,ModificationType.MODIFY,0,0,0,0,0,0,0,0,0,0,0,0,0,0,0,0,0,0.0,0.0
0cf2002a1fcc7eda7d8ff7ff78bb9528098bebe4,/Users/sanika/Downloads/Master Thesis/repo_updated/pytest/testing/example_scripts/issue88_initial_file_multinodes/__init__.pyi,596,ModificationType.MODIFY,0,0,0,0,0,0,0,0,0,0,0,0,0,0,0,0,0,0.0,0.0
0cf2002a1fcc7eda7d8ff7ff78bb9528098bebe4,/Users/sanika/Downloads/Master Thesis/repo_updated/pytest/testing/example_scripts/fixtures/fill_fixtures/test_extend_fixture_conftest_conftest/__init__.pyi,596,ModificationType.MODIFY,0,0,0,0,0,0,0,0,0,0,0,0,0,0,0,0,0,0.0,0.0
0cf2002a1fcc7eda7d8ff7ff78bb9528098bebe4,/Users/sanika/Downloads/Master Thesis/repo_updated/pytest/testing/example_scripts/fixtures/fill_fixtures/test_extend_fixture_conftest_conftest/pkg/__init__.py,596,ModificationType.MODIFY,0,0,0,0,0,0,0,0,0,0,0,0,0,0,0,0,0,0.0,0.0
0cf2002a1fcc7eda7d8ff7ff78bb9528098bebe4,/Users/sanika/Downloads/Master Thesis/repo_updated/pytest/testing/example_scripts/fixtures/fill_fixtures/test_extend_fixture_conftest_module/__init__.pyi,596,ModificationType.MODIFY,0,0,0,0,0,0,0,0,0,0,0,0,0,0,0,0,0,0.0,0.0
0cf2002a1fcc7eda7d8ff7ff78bb9528098bebe4,/Users/sanika/Downloads/Master Thesis/repo_updated/pytest/testing/example_scripts/fixtures/fill_fixtures/test_conftest_funcargs_only_available_in_subdir/sub1/__init__.py,596,ModificationType.MODIFY,0,0,0,0,0,0,0,0,0,0,0,0,0,0,0,0,0,0.0,0.0
0cf2002a1fcc7eda7d8ff7ff78bb9528098bebe4,/Users/sanika/Downloads/Master Thesis/repo_updated/pytest/testing/example_scripts/fixtures/fill_fixtures/test_conftest_funcargs_only_available_in_subdir/sub2/__init__.py,596,ModificationType.MODIFY,0,0,0,0,0,0,0,0,0,0,0,0,0,0,0,0,0,0.0,0.0
0cf2002a1fcc7eda7d8ff7ff78bb9528098bebe4,/Users/sanika/Downloads/Master Thesis/repo_updated/pytest/testing/example_scripts/fixtures/custom_item/__init__.pyi,596,ModificationType.MODIFY,0,0,0,0,0,0,0,0,0,0,0,0,0,0,0,0,0,0.0,0.0
0cf2002a1fcc7eda7d8ff7ff78bb9528098bebe4,/Users/sanika/Downloads/Master Thesis/repo_updated/pytest/testing/example_scripts/fixtures/custom_item/foo/__init__.py,596,ModificationType.MODIFY,0,0,0,0,0,0,0,0,0,0,0,0,0,0,0,0,0,0.0,0.0
0cf2002a1fcc7eda7d8ff7ff78bb9528098bebe4,/Users/sanika/Downloads/Master Thesis/repo_updated/pytest/doc/en/example/nonpython/__init__.py,596,ModificationType.MODIFY,0,0,0,0,0,0,0,0,0,0,0,0,0,0,0,0,0,0.0,0.0
0cf2002a1fcc7eda7d8ff7ff78bb9528098bebe4,/Users/sanika/Downloads/Master Thesis/repo_updated/pytest/src/pytest/__init__.py,596,ModificationType.MODIFY,99,48,90,1,3,5,100,0,0,0,0,0,0,0,0,0,0,0.0,0.0
0cf2002a1fcc7eda7d8ff7ff78bb9528098bebe4,/Users/sanika/Downloads/Master Thesis/repo_updated/pytest/src/_pytest/__init__.py,596,ModificationType.MODIFY,8,5,5,2,0,1,10,0,0,0,0,0,0,0,0,0,0,0.0,0.0
0cf2002a1fcc7eda7d8ff7ff78bb9528098bebe4,/Users/sanika/Downloads/Master Thesis/repo_updated/pytest/src/_pytest/config/__init__.py,596,ModificationType.MODIFY,1217,716,841,84,126,174,1301,14,185,118,215,199,333,1446.608539104324,2542.995998641035,8.135135135135135,20687.616097052745,1149.3120053918192,0.847665332880345
0cf2002a1fcc7eda7d8ff7ff78bb9528098bebe4,/Users/sanika/Downloads/Master Thesis/repo_updated/pytest/src/_pytest/mark/__init__.py,596,ModificationType.MODIFY,160,89,115,0,13,31,160,7,15,11,17,22,28,78.25484338853101,124.86408532184433,3.966666666666667,495.2942051099825,27.51634472833236,0.04162136177394811
0cf2002a1fcc7eda7d8ff7ff78bb9528098bebe4,/Users/sanika/Downloads/Master Thesis/repo_updated/pytest/src/_pytest/_code/__init__.py,596,ModificationType.MODIFY,10,10,9,9,0,0,19,0,0,0,0,0,0,0,0,0,0,0.0,0.0
0cf2002a1fcc7eda7d8ff7ff78bb9528098bebe4,/Users/sanika/Downloads/Master Thesis/repo_updated/pytest/src/_pytest/assertion/__init__.py,596,ModificationType.MODIFY,173,84,99,8,29,36,181,5,12,7,13,17,20,54.62919048309069,81.7492568250068,2.7083333333333335,221.4042372343934,12.300235401910745,0.027249752275002266
0cf2002a1fcc7eda7d8ff7ff78bb9528098bebe4,/Users/sanika/Downloads/Master Thesis/repo_updated/pytest/src/_pytest/_io/__init__.py,596,ModificationType.MODIFY,3,1,1,3,0,0,6,0,0,0,0,0,0,0,0,0,0,0.0,0.0
7ed33996f15d006030d45aeda9dda962bd8da6e9,/Users/sanika/Downloads/Master Thesis/repo_updated/pytest/testing/test_pathlib.py,1561,ModificationType.MODIFY,91,45,69,0,3,18,91,3,9,6,10,12,16,33.28421251514428,57.359400011538504,1.6666666666666667,95.59900001923084,5.311055556623936,0.01911980000384617
7ed33996f15d006030d45aeda9dda962bd8da6e9,/Users/sanika/Downloads/Master Thesis/repo_updated/pytest/src/_pytest/pathlib.py,1561,ModificationType.MODIFY,367,234,237,17,34,68,384,16,55,34,61,71,95,381.9747842438563,584.2259763529448,8.872727272727273,5183.677753822492,287.9820974345829,0.19474199211764828
7ed33996f15d006030d45aeda9dda962bd8da6e9,/Users/sanika/Downloads/Master Thesis/repo_updated/pytest/testing/test_tmpdir.py,1859,ModificationType.MODIFY,442,244,305,14,16,103,456,11,68,45,75,79,120,452.0012210100334,756.4536897812524,6.0661764705882355,4588.781574040686,254.932309668927,0.2521512299270841
09709bba06c9c8564ec7b6cd0dc25bf4a450ecc0,/Users/sanika/Downloads/Master Thesis/repo_updated/pytest/setup.py,93,ModificationType.MODIFY,42,7,35,4,0,5,46,1,2,1,2,3,3,2.0,4.754887502163469,0.5,2.3774437510817346,0.1320802083934297,0.0015849625007211565
09709bba06c9c8564ec7b6cd0dc25bf4a450ecc0,/Users/sanika/Downloads/Master Thesis/repo_updated/pytest/extra/setup-py.test/setup.py,93,ModificationType.MODIFY,11,6,10,0,0,1,11,2,4,2,4,6,6,10.0,15.509775004326936,1.0,15.509775004326936,0.861654166907052,0.005169925001442312
09709bba06c9c8564ec7b6cd0dc25bf4a450ecc0,/Users/sanika/Downloads/Master Thesis/repo_updated/pytest/testing/test_assertrewrite.py,5617,ModificationType.MODIFY,1660,832,1314,41,38,274,1701,20,312,209,395,332,604,2671.484054182769,5058.523816533542,12.66025641025641,64042.2085747035,3557.900476372417,1.6861746055111808
09709bba06c9c8564ec7b6cd0dc25bf4a450ecc0,/Users/sanika/Downloads/Master Thesis/repo_updated/pytest/src/_pytest/assertion/rewrite.py,5617,ModificationType.MODIFY,1057,646,719,113,100,145,1170,18,215,134,248,233,382,1740.9201126876956,3004.119107257935,10.38139534883721,31186.948127440515,1732.608229302251,1.001373035752645
09709bba06c9c8564ec7b6cd0dc25bf4a450ecc0,/Users/sanika/Downloads/Master Thesis/repo_updated/pytest/testing/test_assertrewrite.py,6340,ModificationType.MODIFY,1660,832,1314,41,38,274,1701,20,312,209,395,332,604,2671.484054182769,5058.523816533542,12.66025641025641,64042.2085747035,3557.900476372417,1.6861746055111808
3b243404e656e646f8f9f873c85c49b86e5803fb,/Users/sanika/Downloads/Master Thesis/repo_updated/pytest/testing/example_scripts/collect/package_infinite_recursion/__init__.pyi,596,ModificationType.MODIFY,0,0,0,0,0,0,0,0,0,0,0,0,0,0,0,0,0,0.0,0.0
3b243404e656e646f8f9f873c85c49b86e5803fb,/Users/sanika/Downloads/Master Thesis/repo_updated/pytest/testing/example_scripts/collect/package_infinite_recursion/tests/__init__.py,596,ModificationType.MODIFY,0,0,0,0,0,0,0,0,0,0,0,0,0,0,0,0,0,0.0,0.0
3b243404e656e646f8f9f873c85c49b86e5803fb,/Users/sanika/Downloads/Master Thesis/repo_updated/pytest/testing/example_scripts/collect/collect_init_tests/tests/__init__.py,596,ModificationType.MODIFY,2,2,2,0,0,0,2,0,0,0,0,0,0,0,0,0,0,0.0,0.0
3b243404e656e646f8f9f873c85c49b86e5803fb,/Users/sanika/Downloads/Master Thesis/repo_updated/pytest/testing/example_scripts/collect/package_init_given_as_arg/pkg/__init__.py,596,ModificationType.MODIFY,0,0,0,0,0,0,0,0,0,0,0,0,0,0,0,0,0,0.0,0.0
3b243404e656e646f8f9f873c85c49b86e5803fb,/Users/sanika/Downloads/Master Thesis/repo_updated/pytest/testing/example_scripts/conftest_usageerror/__init__.pyi,596,ModificationType.MODIFY,0,0,0,0,0,0,0,0,0,0,0,0,0,0,0,0,0,0.0,0.0
3b243404e656e646f8f9f873c85c49b86e5803fb,/Users/sanika/Downloads/Master Thesis/repo_updated/pytest/testing/example_scripts/marks/marks_considered_keywords/__init__.pyi,596,ModificationType.MODIFY,0,0,0,0,0,0,0,0,0,0,0,0,0,0,0,0,0,0.0,0.0
3b243404e656e646f8f9f873c85c49b86e5803fb,/Users/sanika/Downloads/Master Thesis/repo_updated/pytest/testing/example_scripts/config/collect_pytest_prefix/__init__.pyi,596,ModificationType.MODIFY,0,0,0,0,0,0,0,0,0,0,0,0,0,0,0,0,0,0.0,0.0
3b243404e656e646f8f9f873c85c49b86e5803fb,/Users/sanika/Downloads/Master Thesis/repo_updated/pytest/testing/example_scripts/issue88_initial_file_multinodes/__init__.pyi,596,ModificationType.MODIFY,0,0,0,0,0,0,0,0,0,0,0,0,0,0,0,0,0,0.0,0.0
3b243404e656e646f8f9f873c85c49b86e5803fb,/Users/sanika/Downloads/Master Thesis/repo_updated/pytest/testing/example_scripts/fixtures/fill_fixtures/test_extend_fixture_conftest_conftest/__init__.pyi,596,ModificationType.MODIFY,0,0,0,0,0,0,0,0,0,0,0,0,0,0,0,0,0,0.0,0.0
3b243404e656e646f8f9f873c85c49b86e5803fb,/Users/sanika/Downloads/Master Thesis/repo_updated/pytest/testing/example_scripts/fixtures/fill_fixtures/test_extend_fixture_conftest_conftest/pkg/__init__.py,596,ModificationType.MODIFY,0,0,0,0,0,0,0,0,0,0,0,0,0,0,0,0,0,0.0,0.0
3b243404e656e646f8f9f873c85c49b86e5803fb,/Users/sanika/Downloads/Master Thesis/repo_updated/pytest/testing/example_scripts/fixtures/fill_fixtures/test_extend_fixture_conftest_module/__init__.pyi,596,ModificationType.MODIFY,0,0,0,0,0,0,0,0,0,0,0,0,0,0,0,0,0,0.0,0.0
3b243404e656e646f8f9f873c85c49b86e5803fb,/Users/sanika/Downloads/Master Thesis/repo_updated/pytest/testing/example_scripts/fixtures/fill_fixtures/test_conftest_funcargs_only_available_in_subdir/sub1/__init__.py,596,ModificationType.MODIFY,0,0,0,0,0,0,0,0,0,0,0,0,0,0,0,0,0,0.0,0.0
3b243404e656e646f8f9f873c85c49b86e5803fb,/Users/sanika/Downloads/Master Thesis/repo_updated/pytest/testing/example_scripts/fixtures/fill_fixtures/test_conftest_funcargs_only_available_in_subdir/sub2/__init__.py,596,ModificationType.MODIFY,0,0,0,0,0,0,0,0,0,0,0,0,0,0,0,0,0,0.0,0.0
3b243404e656e646f8f9f873c85c49b86e5803fb,/Users/sanika/Downloads/Master Thesis/repo_updated/pytest/testing/example_scripts/fixtures/custom_item/__init__.pyi,596,ModificationType.MODIFY,0,0,0,0,0,0,0,0,0,0,0,0,0,0,0,0,0,0.0,0.0
3b243404e656e646f8f9f873c85c49b86e5803fb,/Users/sanika/Downloads/Master Thesis/repo_updated/pytest/testing/example_scripts/fixtures/custom_item/foo/__init__.py,596,ModificationType.MODIFY,0,0,0,0,0,0,0,0,0,0,0,0,0,0,0,0,0,0.0,0.0
3b243404e656e646f8f9f873c85c49b86e5803fb,/Users/sanika/Downloads/Master Thesis/repo_updated/pytest/doc/en/example/nonpython/__init__.py,596,ModificationType.MODIFY,0,0,0,0,0,0,0,0,0,0,0,0,0,0,0,0,0,0.0,0.0
3b243404e656e646f8f9f873c85c49b86e5803fb,/Users/sanika/Downloads/Master Thesis/repo_updated/pytest/src/pytest/__init__.py,596,ModificationType.MODIFY,99,48,90,1,3,5,100,0,0,0,0,0,0,0,0,0,0,0.0,0.0
3b243404e656e646f8f9f873c85c49b86e5803fb,/Users/sanika/Downloads/Master Thesis/repo_updated/pytest/src/_pytest/__init__.py,596,ModificationType.MODIFY,8,5,5,2,0,1,10,0,0,0,0,0,0,0,0,0,0,0.0,0.0
3b243404e656e646f8f9f873c85c49b86e5803fb,/Users/sanika/Downloads/Master Thesis/repo_updated/pytest/src/_pytest/config/__init__.py,596,ModificationType.MODIFY,1217,716,841,84,126,174,1301,14,185,118,215,199,333,1446.608539104324,2542.995998641035,8.135135135135135,20687.616097052745,1149.3120053918192,0.847665332880345
3b243404e656e646f8f9f873c85c49b86e5803fb,/Users/sanika/Downloads/Master Thesis/repo_updated/pytest/src/_pytest/mark/__init__.py,596,ModificationType.MODIFY,160,89,115,0,13,31,160,7,15,11,17,22,28,78.25484338853101,124.86408532184433,3.966666666666667,495.2942051099825,27.51634472833236,0.04162136177394811
3b243404e656e646f8f9f873c85c49b86e5803fb,/Users/sanika/Downloads/Master Thesis/repo_updated/pytest/src/_pytest/_code/__init__.py,596,ModificationType.MODIFY,10,10,9,9,0,0,19,0,0,0,0,0,0,0,0,0,0,0.0,0.0
3b243404e656e646f8f9f873c85c49b86e5803fb,/Users/sanika/Downloads/Master Thesis/repo_updated/pytest/src/_pytest/assertion/__init__.py,596,ModificationType.MODIFY,173,84,99,8,29,36,181,5,12,7,13,17,20,54.62919048309069,81.7492568250068,2.7083333333333335,221.4042372343934,12.300235401910745,0.027249752275002266
3b243404e656e646f8f9f873c85c49b86e5803fb,/Users/sanika/Downloads/Master Thesis/repo_updated/pytest/src/_pytest/_io/__init__.py,596,ModificationType.MODIFY,3,1,1,3,0,0,6,0,0,0,0,0,0,0,0,0,0,0.0,0.0
6ad95716dacd8448df7d4d4d3a5f759d32c17418,/Users/sanika/Downloads/Master Thesis/repo_updated/pytest/testing/test_main.py,3505,ModificationType.MODIFY,77,34,69,0,0,8,77,3,24,16,29,27,45,114.79398751947123,213.9699375973561,1.8125,387.82051189520797,21.54558399417822,0.07132331253245204
6ad95716dacd8448df7d4d4d3a5f759d32c17418,/Users/sanika/Downloads/Master Thesis/repo_updated/pytest/src/_pytest/main.py,3505,ModificationType.MODIFY,712,438,573,51,9,84,763,14,102,71,128,116,199,733.8903537898989,1364.7382180303869,8.784313725490197,11988.28866034536,666.0160366858534,0.45491273934346227
6ad95716dacd8448df7d4d4d3a5f759d32c17418,/Users/sanika/Downloads/Master Thesis/repo_updated/pytest/testing/test_collection.py,4935,ModificationType.MODIFY,1296,573,1062,40,33,157,1336,8,201,118,231,209,349,1561.8613899269646,2689.868337096228,4.597014925373134,12365.364892919973,686.9647162733319,0.896622779032076
cc503c1821e709376d9a05ee4f6459e4e4f41a0c,/Users/sanika/Downloads/Master Thesis/repo_updated/pytest/src/_pytest/assertion/util.py,2606,ModificationType.MODIFY,477,336,357,30,23,73,507,16,194,134,250,210,384,1538.3830913843028,2962.270278783791,10.309278350515465,30538.86885344115,1696.603825191175,0.9874234262612637
cc503c1821e709376d9a05ee4f6459e4e4f41a0c,/Users/sanika/Downloads/Master Thesis/repo_updated/pytest/testing/test_assertion.py,5419,ModificationType.MODIFY,1450,624,1228,12,26,181,1462,14,306,186,354,320,540,2580.063648772758,4493.841171239175,8.098039215686274,36391.30203376038,2021.7390018755768,1.497947057079725
c22ce1a12cc1ad75d50696321a96bd2f1d9a7e86,/Users/sanika/Downloads/Master Thesis/repo_updated/pytest/doc/en/example/multipython.py,6691,ModificationType.MODIFY,72,33,56,0,4,12,72,1,1,1,1,2,2,0.0,2.0,0.5,1.0,0.05555555555555555,0.0006666666666666666
c22ce1a12cc1ad75d50696321a96bd2f1d9a7e86,/Users/sanika/Downloads/Master Thesis/repo_updated/pytest/src/_pytest/python.py,6691,ModificationType.MODIFY,1454,835,1044,76,110,219,1530,17,275,158,296,292,454,2297.8910156145625,3718.180349731528,9.149090909090908,34017.97003608918,1889.8872242271766,1.2393934499105095
db82432ec850aed3ee654db131c1cd4879e0cb06,/Users/sanika/Downloads/Master Thesis/repo_updated/pytest/testing/test_mark.py,3147,ModificationType.MODIFY,1020,354,843,12,15,144,1032,8,134,77,144,142,221,970.8559515213415,1580.0941134105349,4.298507462686567,6792.0463382422995,377.3359076801278,0.5266980378035117
984d90a811afc344518e64f8e8c8f300c69b8aaf,/Users/sanika/Downloads/Master Thesis/repo_updated/pytest/src/_pytest/mark/structures.py,1510,ModificationType.MODIFY,402,202,227,24,74,80,426,12,52,33,61,64,94,339.4424153519907,564.0,7.038461538461538,3969.6923076923076,220.53846153846155,0.188
84b2c81db4b998e41bc0d2583e4acbc47544e103,/Users/sanika/Downloads/Master Thesis/repo_updated/pytest/src/_pytest/mark/structures.py,1479,ModificationType.MODIFY,402,202,227,24,74,80,426,12,52,33,61,64,94,339.4424153519907,564.0,7.038461538461538,3969.6923076923076,220.53846153846155,0.188
84b2c81db4b998e41bc0d2583e4acbc47544e103,/Users/sanika/Downloads/Master Thesis/repo_updated/pytest/testing/test_mark.py,3140,ModificationType.MODIFY,1020,354,843,12,15,144,1032,8,134,77,144,142,221,970.8559515213415,1580.0941134105349,4.298507462686567,6792.0463382422995,377.3359076801278,0.5266980378035117
04891048e18b046037627caf4b5a2665a40b5f02,/Users/sanika/Downloads/Master Thesis/repo_updated/pytest/src/_pytest/mark/structures.py,1479,ModificationType.MODIFY,402,202,227,24,74,80,426,12,52,33,61,64,94,339.4424153519907,564.0,7.038461538461538,3969.6923076923076,220.53846153846155,0.188
04891048e18b046037627caf4b5a2665a40b5f02,/Users/sanika/Downloads/Master Thesis/repo_updated/pytest/testing/test_mark.py,3140,ModificationType.MODIFY,1020,354,843,12,15,144,1032,8,134,77,144,142,221,970.8559515213415,1580.0941134105349,4.298507462686567,6792.0463382422995,377.3359076801278,0.5266980378035117
245e1f10e587931ce03ac414bc7230be76520f40,/Users/sanika/Downloads/Master Thesis/repo_updated/pytest/doc/en/example/multipython.py,6691,ModificationType.MODIFY,72,33,56,0,4,12,72,1,1,1,1,2,2,0.0,2.0,0.5,1.0,0.05555555555555555,0.0006666666666666666
245e1f10e587931ce03ac414bc7230be76520f40,/Users/sanika/Downloads/Master Thesis/repo_updated/pytest/src/_pytest/python.py,6691,ModificationType.MODIFY,1454,835,1044,76,110,219,1530,17,275,158,296,292,454,2297.8910156145625,3718.180349731528,9.149090909090908,34017.97003608918,1889.8872242271766,1.2393934499105095
245e1f10e587931ce03ac414bc7230be76520f40,/Users/sanika/Downloads/Master Thesis/repo_updated/pytest/testing/test_mark.py,3197,ModificationType.MODIFY,1020,354,843,12,15,144,1032,8,134,77,144,142,221,970.8559515213415,1580.0941134105349,4.298507462686567,6792.0463382422995,377.3359076801278,0.5266980378035117
28edbaace4b5ebad5875d65eb518c29f495212e5,/Users/sanika/Downloads/Master Thesis/repo_updated/pytest/testing/test_helpconfig.py,1070,ModificationType.MODIFY,74,35,59,1,0,14,75,3,14,7,14,17,21,58.05785641096992,85.83671966625714,1.5,128.75507949938572,7.153059972188095,0.02861223988875238
28edbaace4b5ebad5875d65eb518c29f495212e5,/Users/sanika/Downloads/Master Thesis/repo_updated/pytest/src/_pytest/helpconfig.py,1070,ModificationType.MODIFY,245,125,200,5,7,34,250,7,30,17,34,37,51,166.8582023226588,265.6821216470764,3.966666666666667,1053.8724158667364,58.548467548152026,0.08856070721569215
96c315e4393c67ae97911398b3f7df1b48ea02b6,/Users/sanika/Downloads/Master Thesis/repo_updated/pytest/testing/test_helpconfig.py,1070,ModificationType.MODIFY,74,35,59,1,0,14,75,3,14,7,14,17,21,58.05785641096992,85.83671966625714,1.5,128.75507949938572,7.153059972188095,0.02861223988875238
96c315e4393c67ae97911398b3f7df1b48ea02b6,/Users/sanika/Downloads/Master Thesis/repo_updated/pytest/src/_pytest/helpconfig.py,1070,ModificationType.MODIFY,245,125,200,5,7,34,250,7,30,17,34,37,51,166.8582023226588,265.6821216470764,3.966666666666667,1053.8724158667364,58.548467548152026,0.08856070721569215
0bbc032db0969efa42d35aa74a5a523bd977538d,/Users/sanika/Downloads/Master Thesis/repo_updated/pytest/testing/test_reports.py,1993,ModificationType.MODIFY,466,257,367,18,25,50,484,7,126,86,171,133,257,898.7887548153927,1813.2075859238057,4.75,8612.736033138077,478.4853351743376,0.6044025286412685
0bbc032db0969efa42d35aa74a5a523bd977538d,/Users/sanika/Downloads/Master Thesis/repo_updated/pytest/src/_pytest/reports.py,1993,ModificationType.MODIFY,507,281,342,29,59,88,536,10,53,29,57,63,86,336.79906504072324,514.0460734209928,5.377358490566038,2764.2100174525085,153.56722319180602,0.17134869114033094
0bbc032db0969efa42d35aa74a5a523bd977538d,/Users/sanika/Downloads/Master Thesis/repo_updated/pytest/testing/test_terminal.py,6372,ModificationType.MODIFY,1943,715,1694,26,18,214,1969,12,185,120,237,197,357,1436.3251202041715,2721.0724995459263,7.686486486486486,20915.486996509768,1161.971499806098,0.9070241665153088
0bbc032db0969efa42d35aa74a5a523bd977538d,/Users/sanika/Downloads/Master Thesis/repo_updated/pytest/src/_pytest/terminal.py,6372,ModificationType.MODIFY,1168,838,957,57,25,144,1225,19,348,224,416,367,640,3018.854959310786,5452.5672018196565,11.35632183908046,61921.107993078396,3440.061555171022,1.8175224006065522
710e3c40e0e613a06eef62f58b3f7db9761ee868,/Users/sanika/Downloads/Master Thesis/repo_updated/pytest/testing/test_reports.py,1993,ModificationType.MODIFY,466,257,367,18,25,50,484,7,126,86,171,133,257,898.7887548153927,1813.2075859238057,4.75,8612.736033138077,478.4853351743376,0.6044025286412685
710e3c40e0e613a06eef62f58b3f7db9761ee868,/Users/sanika/Downloads/Master Thesis/repo_updated/pytest/src/_pytest/reports.py,1993,ModificationType.MODIFY,507,281,342,29,59,88,536,10,53,29,57,63,86,336.79906504072324,514.0460734209928,5.377358490566038,2764.2100174525085,153.56722319180602,0.17134869114033094
710e3c40e0e613a06eef62f58b3f7db9761ee868,/Users/sanika/Downloads/Master Thesis/repo_updated/pytest/testing/test_terminal.py,6372,ModificationType.MODIFY,1943,715,1694,26,18,214,1969,12,185,120,237,197,357,1436.3251202041715,2721.0724995459263,7.686486486486486,20915.486996509768,1161.971499806098,0.9070241665153088
710e3c40e0e613a06eef62f58b3f7db9761ee868,/Users/sanika/Downloads/Master Thesis/repo_updated/pytest/src/_pytest/terminal.py,6372,ModificationType.MODIFY,1168,838,957,57,25,144,1225,19,348,224,416,367,640,3018.854959310786,5452.5672018196565,11.35632183908046,61921.107993078396,3440.061555171022,1.8175224006065522
42a46ea78617b8e210636bc2f9d9bf06435b60fa,/Users/sanika/Downloads/Master Thesis/repo_updated/pytest/testing/test_compat.py,1418,ModificationType.MODIFY,207,111,150,11,0,50,218,5,26,19,36,31,55,133.82107314610522,272.4807970712782,3.4615384615384617,943.202759092886,52.40015328293811,0.09082693235709273
42a46ea78617b8e210636bc2f9d9bf06435b60fa,/Users/sanika/Downloads/Master Thesis/repo_updated/pytest/src/_pytest/compat.py,1418,ModificationType.MODIFY,410,198,237,31,55,97,441,11,63,38,72,74,110,414.62238298550506,683.0398702191846,6.285714285714286,4293.39346994916,238.52185944162,0.2276799567397282
42a46ea78617b8e210636bc2f9d9bf06435b60fa,/Users/sanika/Downloads/Master Thesis/repo_updated/pytest/testing/test_nodes.py,1815,ModificationType.MODIFY,53,23,39,0,0,13,53,2,8,4,8,10,12,26.0,39.863137138648355,1.0,39.863137138648355,2.2146187299249087,0.013287712379549451
42a46ea78617b8e210636bc2f9d9bf06435b60fa,/Users/sanika/Downloads/Master Thesis/repo_updated/pytest/src/_pytest/nodes.py,1815,ModificationType.MODIFY,515,298,307,33,80,99,548,12,63,44,77,75,121,419.58818518914865,753.6870615500015,7.333333333333333,5527.038451366678,307.0576917425932,0.2512290205166672
42a46ea78617b8e210636bc2f9d9bf06435b60fa,/Users/sanika/Downloads/Master Thesis/repo_updated/pytest/testing/test_compat.py,591,ModificationType.MODIFY,207,111,150,11,0,50,218,5,26,19,36,31,55,133.82107314610522,272.4807970712782,3.4615384615384617,943.202759092886,52.40015328293811,0.09082693235709273
abcedd6095054aa66aa4a5271959da0866c52266,/Users/sanika/Downloads/Master Thesis/repo_updated/pytest/src/_pytest/assertion/util.py,2606,ModificationType.MODIFY,477,336,357,30,23,73,507,16,194,134,250,210,384,1538.3830913843028,2962.270278783791,10.309278350515465,30538.86885344115,1696.603825191175,0.9874234262612637
abcedd6095054aa66aa4a5271959da0866c52266,/Users/sanika/Downloads/Master Thesis/repo_updated/pytest/testing/test_assertion.py,5419,ModificationType.MODIFY,1450,624,1228,12,26,181,1462,14,306,186,354,320,540,2580.063648772758,4493.841171239175,8.098039215686274,36391.30203376038,2021.7390018755768,1.497947057079725
3ef8aa8173eb10c5a57fd38b4df7d3ba959e8b5f,/Users/sanika/Downloads/Master Thesis/repo_updated/pytest/testing/test_nodes.py,1884,ModificationType.MODIFY,53,23,39,0,0,13,53,2,8,4,8,10,12,26.0,39.863137138648355,1.0,39.863137138648355,2.2146187299249087,0.013287712379549451
3ef8aa8173eb10c5a57fd38b4df7d3ba959e8b5f,/Users/sanika/Downloads/Master Thesis/repo_updated/pytest/src/_pytest/nodes.py,1884,ModificationType.MODIFY,515,298,307,33,80,99,548,12,63,44,77,75,121,419.58818518914865,753.6870615500015,7.333333333333333,5527.038451366678,307.0576917425932,0.2512290205166672
b352e34938726e13fd8b0e5d5912535e29e6592c,/Users/sanika/Downloads/Master Thesis/repo_updated/pytest/testing/test_compat.py,1418,ModificationType.MODIFY,207,111,150,11,0,50,218,5,26,19,36,31,55,133.82107314610522,272.4807970712782,3.4615384615384617,943.202759092886,52.40015328293811,0.09082693235709273
b352e34938726e13fd8b0e5d5912535e29e6592c,/Users/sanika/Downloads/Master Thesis/repo_updated/pytest/src/_pytest/compat.py,1418,ModificationType.MODIFY,410,198,237,31,55,97,441,11,63,38,72,74,110,414.62238298550506,683.0398702191846,6.285714285714286,4293.39346994916,238.52185944162,0.2276799567397282
b352e34938726e13fd8b0e5d5912535e29e6592c,/Users/sanika/Downloads/Master Thesis/repo_updated/pytest/testing/test_nodes.py,1815,ModificationType.MODIFY,53,23,39,0,0,13,53,2,8,4,8,10,12,26.0,39.863137138648355,1.0,39.863137138648355,2.2146187299249087,0.013287712379549451
b352e34938726e13fd8b0e5d5912535e29e6592c,/Users/sanika/Downloads/Master Thesis/repo_updated/pytest/src/_pytest/nodes.py,1815,ModificationType.MODIFY,515,298,307,33,80,99,548,12,63,44,77,75,121,419.58818518914865,753.6870615500015,7.333333333333333,5527.038451366678,307.0576917425932,0.2512290205166672
b352e34938726e13fd8b0e5d5912535e29e6592c,/Users/sanika/Downloads/Master Thesis/repo_updated/pytest/testing/test_compat.py,591,ModificationType.MODIFY,207,111,150,11,0,50,218,5,26,19,36,31,55,133.82107314610522,272.4807970712782,3.4615384615384617,943.202759092886,52.40015328293811,0.09082693235709273
fc1c015c6b79ead0d76793cf0b7ae155b365f3a6,/Users/sanika/Downloads/Master Thesis/repo_updated/pytest/testing/python/metafunc.py,5858,ModificationType.MODIFY,1782,648,1425,9,47,279,1791,8,171,97,189,179,286,1292.4527800454887,2140.3713122975773,4.421052631578948,9462.69422278929,525.705234599405,0.7134571040991925
dad4985be1fde2fc2bdc83ae65034c43f3ce42aa,/Users/sanika/Downloads/Master Thesis/repo_updated/pytest/testing/test_nodes.py,1873,ModificationType.MODIFY,53,23,39,0,0,13,53,2,8,4,8,10,12,26.0,39.863137138648355,1.0,39.863137138648355,2.2146187299249087,0.013287712379549451
dad4985be1fde2fc2bdc83ae65034c43f3ce42aa,/Users/sanika/Downloads/Master Thesis/repo_updated/pytest/src/_pytest/nodes.py,1873,ModificationType.MODIFY,515,298,307,33,80,99,548,12,63,44,77,75,121,419.58818518914865,753.6870615500015,7.333333333333333,5527.038451366678,307.0576917425932,0.2512290205166672
86e9ae39f0ff0f16179d3e1d25674445432cfaef,/Users/sanika/Downloads/Master Thesis/repo_updated/pytest/testing/test_pytester.py,6314,ModificationType.MODIFY,722,423,573,19,0,135,741,12,172,101,199,184,300,1320.3370878174146,2257.068586817104,6.941860465116279,15668.255189881524,870.4586216600846,0.7523561956057013
86e9ae39f0ff0f16179d3e1d25674445432cfaef,/Users/sanika/Downloads/Master Thesis/repo_updated/pytest/src/_pytest/pytester.py,6314,ModificationType.MODIFY,1508,847,911,44,250,301,1552,14,148,88,169,162,257,1120.302067021891,1886.3414507413484,7.993243243243243,15077.986055587939,837.6658919771077,0.6287804835804495
e2022a6d488bc809f30118a58df50525dd345c7e,/Users/sanika/Downloads/Master Thesis/repo_updated/pytest/testing/test_pytester.py,6314,ModificationType.MODIFY,722,423,573,19,0,135,741,12,172,101,199,184,300,1320.3370878174146,2257.068586817104,6.941860465116279,15668.255189881524,870.4586216600846,0.7523561956057013
e2022a6d488bc809f30118a58df50525dd345c7e,/Users/sanika/Downloads/Master Thesis/repo_updated/pytest/src/_pytest/pytester.py,6314,ModificationType.MODIFY,1508,847,911,44,250,301,1552,14,148,88,169,162,257,1120.302067021891,1886.3414507413484,7.993243243243243,15077.986055587939,837.6658919771077,0.6287804835804495
6ddf7c3d42efcf01c8641893e7331f9e33e6877d,/Users/sanika/Downloads/Master Thesis/repo_updated/pytest/testing/test_pytester.py,6345,ModificationType.MODIFY,722,423,573,19,0,135,741,12,172,101,199,184,300,1320.3370878174146,2257.068586817104,6.941860465116279,15668.255189881524,870.4586216600846,0.7523561956057013
6ddf7c3d42efcf01c8641893e7331f9e33e6877d,/Users/sanika/Downloads/Master Thesis/repo_updated/pytest/src/_pytest/pytester.py,6345,ModificationType.MODIFY,1508,847,911,44,250,301,1552,14,148,88,169,162,257,1120.302067021891,1886.3414507413484,7.993243243243243,15077.986055587939,837.6658919771077,0.6287804835804495
6ddf7c3d42efcf01c8641893e7331f9e33e6877d,/Users/sanika/Downloads/Master Thesis/repo_updated/pytest/testing/test_assertion.py,5424,ModificationType.MODIFY,1450,624,1228,12,26,181,1462,14,306,186,354,320,540,2580.063648772758,4493.841171239175,8.098039215686274,36391.30203376038,2021.7390018755768,1.497947057079725
b06f33f4748ee1bf928c01b4e12d5506a4e05870,/Users/sanika/Downloads/Master Thesis/repo_updated/pytest/testing/test_terminal.py,6416,ModificationType.MODIFY,1943,715,1694,26,18,214,1969,12,185,120,237,197,357,1436.3251202041715,2721.0724995459263,7.686486486486486,20915.486996509768,1161.971499806098,0.9070241665153088
b06f33f4748ee1bf928c01b4e12d5506a4e05870,/Users/sanika/Downloads/Master Thesis/repo_updated/pytest/src/_pytest/terminal.py,6416,ModificationType.MODIFY,1168,838,957,57,25,144,1225,19,348,224,416,367,640,3018.854959310786,5452.5672018196565,11.35632183908046,61921.107993078396,3440.061555171022,1.8175224006065522
b06f33f4748ee1bf928c01b4e12d5506a4e05870,/Users/sanika/Downloads/Master Thesis/repo_updated/pytest/testing/test_collection.py,4946,ModificationType.MODIFY,1296,573,1062,40,33,157,1336,8,201,118,231,209,349,1561.8613899269646,2689.868337096228,4.597014925373134,12365.364892919973,686.9647162733319,0.896622779032076
b06f33f4748ee1bf928c01b4e12d5506a4e05870,/Users/sanika/Downloads/Master Thesis/repo_updated/pytest/testing/test_terminal.py,6852,ModificationType.MODIFY,1943,715,1694,26,18,214,1969,12,185,120,237,197,357,1436.3251202041715,2721.0724995459263,7.686486486486486,20915.486996509768,1161.971499806098,0.9070241665153088
c232366f2ff17d72b3baee53c0260da2459a9702,/Users/sanika/Downloads/Master Thesis/repo_updated/pytest/testing/python/metafunc.py,5858,ModificationType.MODIFY,1782,648,1425,9,47,279,1791,8,171,97,189,179,286,1292.4527800454887,2140.3713122975773,4.421052631578948,9462.69422278929,525.705234599405,0.7134571040991925
a6e10cc2e3f3c9e400d9a03417d1186eee052730,/Users/sanika/Downloads/Master Thesis/repo_updated/pytest/testing/test_terminal.py,6416,ModificationType.MODIFY,1943,715,1694,26,18,214,1969,12,185,120,237,197,357,1436.3251202041715,2721.0724995459263,7.686486486486486,20915.486996509768,1161.971499806098,0.9070241665153088
a6e10cc2e3f3c9e400d9a03417d1186eee052730,/Users/sanika/Downloads/Master Thesis/repo_updated/pytest/src/_pytest/terminal.py,6416,ModificationType.MODIFY,1168,838,957,57,25,144,1225,19,348,224,416,367,640,3018.854959310786,5452.5672018196565,11.35632183908046,61921.107993078396,3440.061555171022,1.8175224006065522
a6e10cc2e3f3c9e400d9a03417d1186eee052730,/Users/sanika/Downloads/Master Thesis/repo_updated/pytest/testing/test_collection.py,4946,ModificationType.MODIFY,1296,573,1062,40,33,157,1336,8,201,118,231,209,349,1561.8613899269646,2689.868337096228,4.597014925373134,12365.364892919973,686.9647162733319,0.896622779032076
a6e10cc2e3f3c9e400d9a03417d1186eee052730,/Users/sanika/Downloads/Master Thesis/repo_updated/pytest/testing/test_terminal.py,6852,ModificationType.MODIFY,1943,715,1694,26,18,214,1969,12,185,120,237,197,357,1436.3251202041715,2721.0724995459263,7.686486486486486,20915.486996509768,1161.971499806098,0.9070241665153088
f91bf48a40da5ee7f7c2a3c71ee56d854d35e983,/Users/sanika/Downloads/Master Thesis/repo_updated/pytest/testing/test_pytester.py,6345,ModificationType.MODIFY,722,423,573,19,0,135,741,12,172,101,199,184,300,1320.3370878174146,2257.068586817104,6.941860465116279,15668.255189881524,870.4586216600846,0.7523561956057013
f91bf48a40da5ee7f7c2a3c71ee56d854d35e983,/Users/sanika/Downloads/Master Thesis/repo_updated/pytest/src/_pytest/pytester.py,6345,ModificationType.MODIFY,1508,847,911,44,250,301,1552,14,148,88,169,162,257,1120.302067021891,1886.3414507413484,7.993243243243243,15077.986055587939,837.6658919771077,0.6287804835804495
f91bf48a40da5ee7f7c2a3c71ee56d854d35e983,/Users/sanika/Downloads/Master Thesis/repo_updated/pytest/testing/test_assertion.py,5424,ModificationType.MODIFY,1450,624,1228,12,26,181,1462,14,306,186,354,320,540,2580.063648772758,4493.841171239175,8.098039215686274,36391.30203376038,2021.7390018755768,1.497947057079725
b3bb60468331d49ff3eaa3241adb9fa070c90d19,/Users/sanika/Downloads/Master Thesis/repo_updated/pytest/testing/test_warnings.py,625,ModificationType.MODIFY,601,196,481,2,23,85,603,8,63,36,72,71,108,400.56863518049477,664.1726889065056,4.571428571428571,3036.21800642974,168.67877813498555,0.22139089630216854
b3bb60468331d49ff3eaa3241adb9fa070c90d19,/Users/sanika/Downloads/Master Thesis/repo_updated/pytest/src/_pytest/warnings.py,625,ModificationType.MODIFY,156,79,106,5,16,28,161,5,14,8,15,19,23,64.91260938324326,97.70233280920246,2.6785714285714284,261.7026771675066,14.539037620417032,0.03256744426973415
55bc084dcc783bda88a221a5437a515df3e7b2ae,/Users/sanika/Downloads/Master Thesis/repo_updated/pytest/testing/example_scripts/collect/package_infinite_recursion/__init__.pyi,5077,ModificationType.MODIFY,0,0,0,0,0,0,0,0,0,0,0,0,0,0,0,0,0,0.0,0.0
55bc084dcc783bda88a221a5437a515df3e7b2ae,/Users/sanika/Downloads/Master Thesis/repo_updated/pytest/testing/example_scripts/collect/package_infinite_recursion/tests/__init__.py,5077,ModificationType.MODIFY,0,0,0,0,0,0,0,0,0,0,0,0,0,0,0,0,0,0.0,0.0
55bc084dcc783bda88a221a5437a515df3e7b2ae,/Users/sanika/Downloads/Master Thesis/repo_updated/pytest/testing/example_scripts/collect/collect_init_tests/tests/__init__.py,5077,ModificationType.MODIFY,2,2,2,0,0,0,2,0,0,0,0,0,0,0,0,0,0,0.0,0.0
55bc084dcc783bda88a221a5437a515df3e7b2ae,/Users/sanika/Downloads/Master Thesis/repo_updated/pytest/testing/example_scripts/collect/package_init_given_as_arg/pkg/__init__.py,5077,ModificationType.MODIFY,0,0,0,0,0,0,0,0,0,0,0,0,0,0,0,0,0,0.0,0.0
55bc084dcc783bda88a221a5437a515df3e7b2ae,/Users/sanika/Downloads/Master Thesis/repo_updated/pytest/testing/example_scripts/conftest_usageerror/__init__.pyi,5077,ModificationType.MODIFY,0,0,0,0,0,0,0,0,0,0,0,0,0,0,0,0,0,0.0,0.0
55bc084dcc783bda88a221a5437a515df3e7b2ae,/Users/sanika/Downloads/Master Thesis/repo_updated/pytest/testing/example_scripts/marks/marks_considered_keywords/__init__.pyi,5077,ModificationType.MODIFY,0,0,0,0,0,0,0,0,0,0,0,0,0,0,0,0,0,0.0,0.0
55bc084dcc783bda88a221a5437a515df3e7b2ae,/Users/sanika/Downloads/Master Thesis/repo_updated/pytest/testing/example_scripts/config/collect_pytest_prefix/__init__.pyi,5077,ModificationType.MODIFY,0,0,0,0,0,0,0,0,0,0,0,0,0,0,0,0,0,0.0,0.0
55bc084dcc783bda88a221a5437a515df3e7b2ae,/Users/sanika/Downloads/Master Thesis/repo_updated/pytest/testing/example_scripts/issue88_initial_file_multinodes/__init__.pyi,5077,ModificationType.MODIFY,0,0,0,0,0,0,0,0,0,0,0,0,0,0,0,0,0,0.0,0.0
55bc084dcc783bda88a221a5437a515df3e7b2ae,/Users/sanika/Downloads/Master Thesis/repo_updated/pytest/testing/example_scripts/fixtures/fill_fixtures/test_extend_fixture_conftest_conftest/__init__.pyi,5077,ModificationType.MODIFY,0,0,0,0,0,0,0,0,0,0,0,0,0,0,0,0,0,0.0,0.0
55bc084dcc783bda88a221a5437a515df3e7b2ae,/Users/sanika/Downloads/Master Thesis/repo_updated/pytest/testing/example_scripts/fixtures/fill_fixtures/test_extend_fixture_conftest_conftest/pkg/__init__.py,5077,ModificationType.MODIFY,0,0,0,0,0,0,0,0,0,0,0,0,0,0,0,0,0,0.0,0.0
55bc084dcc783bda88a221a5437a515df3e7b2ae,/Users/sanika/Downloads/Master Thesis/repo_updated/pytest/testing/example_scripts/fixtures/fill_fixtures/test_extend_fixture_conftest_module/__init__.pyi,5077,ModificationType.MODIFY,0,0,0,0,0,0,0,0,0,0,0,0,0,0,0,0,0,0.0,0.0
55bc084dcc783bda88a221a5437a515df3e7b2ae,/Users/sanika/Downloads/Master Thesis/repo_updated/pytest/testing/example_scripts/fixtures/fill_fixtures/test_conftest_funcargs_only_available_in_subdir/sub1/__init__.py,5077,ModificationType.MODIFY,0,0,0,0,0,0,0,0,0,0,0,0,0,0,0,0,0,0.0,0.0
55bc084dcc783bda88a221a5437a515df3e7b2ae,/Users/sanika/Downloads/Master Thesis/repo_updated/pytest/testing/example_scripts/fixtures/fill_fixtures/test_conftest_funcargs_only_available_in_subdir/sub2/__init__.py,5077,ModificationType.MODIFY,0,0,0,0,0,0,0,0,0,0,0,0,0,0,0,0,0,0.0,0.0
55bc084dcc783bda88a221a5437a515df3e7b2ae,/Users/sanika/Downloads/Master Thesis/repo_updated/pytest/testing/example_scripts/fixtures/custom_item/__init__.pyi,5077,ModificationType.MODIFY,0,0,0,0,0,0,0,0,0,0,0,0,0,0,0,0,0,0.0,0.0
55bc084dcc783bda88a221a5437a515df3e7b2ae,/Users/sanika/Downloads/Master Thesis/repo_updated/pytest/testing/example_scripts/fixtures/custom_item/foo/__init__.py,5077,ModificationType.MODIFY,0,0,0,0,0,0,0,0,0,0,0,0,0,0,0,0,0,0.0,0.0
55bc084dcc783bda88a221a5437a515df3e7b2ae,/Users/sanika/Downloads/Master Thesis/repo_updated/pytest/doc/en/example/nonpython/__init__.py,5077,ModificationType.MODIFY,0,0,0,0,0,0,0,0,0,0,0,0,0,0,0,0,0,0.0,0.0
55bc084dcc783bda88a221a5437a515df3e7b2ae,/Users/sanika/Downloads/Master Thesis/repo_updated/pytest/src/pytest/__init__.py,5077,ModificationType.MODIFY,99,48,90,1,3,5,100,0,0,0,0,0,0,0,0,0,0,0.0,0.0
55bc084dcc783bda88a221a5437a515df3e7b2ae,/Users/sanika/Downloads/Master Thesis/repo_updated/pytest/src/_pytest/__init__.py,5077,ModificationType.MODIFY,8,5,5,2,0,1,10,0,0,0,0,0,0,0,0,0,0,0.0,0.0
55bc084dcc783bda88a221a5437a515df3e7b2ae,/Users/sanika/Downloads/Master Thesis/repo_updated/pytest/src/_pytest/config/__init__.py,5077,ModificationType.MODIFY,1217,716,841,84,126,174,1301,14,185,118,215,199,333,1446.608539104324,2542.995998641035,8.135135135135135,20687.616097052745,1149.3120053918192,0.847665332880345
55bc084dcc783bda88a221a5437a515df3e7b2ae,/Users/sanika/Downloads/Master Thesis/repo_updated/pytest/src/_pytest/mark/__init__.py,5077,ModificationType.MODIFY,160,89,115,0,13,31,160,7,15,11,17,22,28,78.25484338853101,124.86408532184433,3.966666666666667,495.2942051099825,27.51634472833236,0.04162136177394811
55bc084dcc783bda88a221a5437a515df3e7b2ae,/Users/sanika/Downloads/Master Thesis/repo_updated/pytest/src/_pytest/_code/__init__.py,5077,ModificationType.MODIFY,10,10,9,9,0,0,19,0,0,0,0,0,0,0,0,0,0,0.0,0.0
55bc084dcc783bda88a221a5437a515df3e7b2ae,/Users/sanika/Downloads/Master Thesis/repo_updated/pytest/src/_pytest/assertion/__init__.py,5077,ModificationType.MODIFY,173,84,99,8,29,36,181,5,12,7,13,17,20,54.62919048309069,81.7492568250068,2.7083333333333335,221.4042372343934,12.300235401910745,0.027249752275002266
55bc084dcc783bda88a221a5437a515df3e7b2ae,/Users/sanika/Downloads/Master Thesis/repo_updated/pytest/src/_pytest/_io/__init__.py,5077,ModificationType.MODIFY,3,1,1,3,0,0,6,0,0,0,0,0,0,0,0,0,0,0.0,0.0
55bc084dcc783bda88a221a5437a515df3e7b2ae,/Users/sanika/Downloads/Master Thesis/repo_updated/pytest/src/_pytest/config/argparsing.py,2326,ModificationType.MODIFY,463,295,324,28,62,57,491,12,134,82,154,146,236,989.8755015299953,1696.7985958956842,6.895522388059701,11700.312706026956,650.0173725570531,0.565599531965228
55bc084dcc783bda88a221a5437a515df3e7b2ae,/Users/sanika/Downloads/Master Thesis/repo_updated/pytest/src/_pytest/hookspec.py,642,ModificationType.MODIFY,647,139,84,35,284,233,682,0,0,0,0,0,0,0,0,0,0,0.0,0.0
772dfc4f9d610ebd735be48fd1c0924384c94e04,/Users/sanika/Downloads/Master Thesis/repo_updated/pytest/testing/test_terminal.py,6372,ModificationType.MODIFY,1943,715,1694,26,18,214,1969,12,185,120,237,197,357,1436.3251202041715,2721.0724995459263,7.686486486486486,20915.486996509768,1161.971499806098,0.9070241665153088
772dfc4f9d610ebd735be48fd1c0924384c94e04,/Users/sanika/Downloads/Master Thesis/repo_updated/pytest/src/_pytest/terminal.py,6372,ModificationType.MODIFY,1168,838,957,57,25,144,1225,19,348,224,416,367,640,3018.854959310786,5452.5672018196565,11.35632183908046,61921.107993078396,3440.061555171022,1.8175224006065522
2a67637accc9b5f25b4d3fda3b99ad37cfcab18b,/Users/sanika/Downloads/Master Thesis/repo_updated/pytest/src/_pytest/deprecated.py,45,ModificationType.MODIFY,42,7,23,2,8,9,44,0,0,0,0,0,0,0,0,0,0,0.0,0.0
2a67637accc9b5f25b4d3fda3b99ad37cfcab18b,/Users/sanika/Downloads/Master Thesis/repo_updated/pytest/testing/test_junitxml.py,3197,ModificationType.MODIFY,1523,757,1297,19,12,193,1542,12,193,117,230,205,347,1508.3637582013935,2664.7795945283897,7.150259067357513,19053.864458285894,1058.5480254603274,0.8882598648427965
2a67637accc9b5f25b4d3fda3b99ad37cfcab18b,/Users/sanika/Downloads/Master Thesis/repo_updated/pytest/src/_pytest/junitxml.py,3197,ModificationType.MODIFY,701,378,504,33,58,109,734,13,110,68,126,123,194,794.0552848235468,1346.8478140358125,7.445454545454545,10027.894179048459,557.1052321693588,0.4489492713452708
2a67637accc9b5f25b4d3fda3b99ad37cfcab18b,/Users/sanika/Downloads/Master Thesis/repo_updated/pytest/testing/deprecated_test.py,265,ModificationType.MODIFY,75,38,59,1,3,12,76,2,4,2,4,6,6,10.0,15.509775004326936,1.0,15.509775004326936,0.861654166907052,0.005169925001442312
6f2c0fd2e8e8154c8129900c9a1c650068811404,/Users/sanika/Downloads/Master Thesis/repo_updated/pytest/doc/en/example/multipython.py,6777,ModificationType.MODIFY,72,33,56,0,4,12,72,1,1,1,1,2,2,0.0,2.0,0.5,1.0,0.05555555555555555,0.0006666666666666666
6f2c0fd2e8e8154c8129900c9a1c650068811404,/Users/sanika/Downloads/Master Thesis/repo_updated/pytest/src/_pytest/python.py,6777,ModificationType.MODIFY,1454,835,1044,76,110,219,1530,17,275,158,296,292,454,2297.8910156145625,3718.180349731528,9.149090909090908,34017.97003608918,1889.8872242271766,1.2393934499105095
6f2c0fd2e8e8154c8129900c9a1c650068811404,/Users/sanika/Downloads/Master Thesis/repo_updated/pytest/testing/python/metafunc.py,5988,ModificationType.MODIFY,1782,648,1425,9,47,279,1791,8,171,97,189,179,286,1292.4527800454887,2140.3713122975773,4.421052631578948,9462.69422278929,525.705234599405,0.7134571040991925
92d6a0500b9f528a9adcd6bbcda46ebf9b6baf03,/Users/sanika/Downloads/Master Thesis/repo_updated/pytest/doc/en/example/multipython.py,6777,ModificationType.MODIFY,72,33,56,0,4,12,72,1,1,1,1,2,2,0.0,2.0,0.5,1.0,0.05555555555555555,0.0006666666666666666
92d6a0500b9f528a9adcd6bbcda46ebf9b6baf03,/Users/sanika/Downloads/Master Thesis/repo_updated/pytest/src/_pytest/python.py,6777,ModificationType.MODIFY,1454,835,1044,76,110,219,1530,17,275,158,296,292,454,2297.8910156145625,3718.180349731528,9.149090909090908,34017.97003608918,1889.8872242271766,1.2393934499105095
92d6a0500b9f528a9adcd6bbcda46ebf9b6baf03,/Users/sanika/Downloads/Master Thesis/repo_updated/pytest/testing/python/metafunc.py,5988,ModificationType.MODIFY,1782,648,1425,9,47,279,1791,8,171,97,189,179,286,1292.4527800454887,2140.3713122975773,4.421052631578948,9462.69422278929,525.705234599405,0.7134571040991925
2fc7d04fc380e0ee6f43538504ec36c896688c47,/Users/sanika/Downloads/Master Thesis/repo_updated/pytest/testing/example_scripts/collect/package_infinite_recursion/__init__.pyi,5077,ModificationType.MODIFY,0,0,0,0,0,0,0,0,0,0,0,0,0,0,0,0,0,0.0,0.0
2fc7d04fc380e0ee6f43538504ec36c896688c47,/Users/sanika/Downloads/Master Thesis/repo_updated/pytest/testing/example_scripts/collect/package_infinite_recursion/tests/__init__.py,5077,ModificationType.MODIFY,0,0,0,0,0,0,0,0,0,0,0,0,0,0,0,0,0,0.0,0.0
2fc7d04fc380e0ee6f43538504ec36c896688c47,/Users/sanika/Downloads/Master Thesis/repo_updated/pytest/testing/example_scripts/collect/collect_init_tests/tests/__init__.py,5077,ModificationType.MODIFY,2,2,2,0,0,0,2,0,0,0,0,0,0,0,0,0,0,0.0,0.0
2fc7d04fc380e0ee6f43538504ec36c896688c47,/Users/sanika/Downloads/Master Thesis/repo_updated/pytest/testing/example_scripts/collect/package_init_given_as_arg/pkg/__init__.py,5077,ModificationType.MODIFY,0,0,0,0,0,0,0,0,0,0,0,0,0,0,0,0,0,0.0,0.0
2fc7d04fc380e0ee6f43538504ec36c896688c47,/Users/sanika/Downloads/Master Thesis/repo_updated/pytest/testing/example_scripts/conftest_usageerror/__init__.pyi,5077,ModificationType.MODIFY,0,0,0,0,0,0,0,0,0,0,0,0,0,0,0,0,0,0.0,0.0
2fc7d04fc380e0ee6f43538504ec36c896688c47,/Users/sanika/Downloads/Master Thesis/repo_updated/pytest/testing/example_scripts/marks/marks_considered_keywords/__init__.pyi,5077,ModificationType.MODIFY,0,0,0,0,0,0,0,0,0,0,0,0,0,0,0,0,0,0.0,0.0
2fc7d04fc380e0ee6f43538504ec36c896688c47,/Users/sanika/Downloads/Master Thesis/repo_updated/pytest/testing/example_scripts/config/collect_pytest_prefix/__init__.pyi,5077,ModificationType.MODIFY,0,0,0,0,0,0,0,0,0,0,0,0,0,0,0,0,0,0.0,0.0
2fc7d04fc380e0ee6f43538504ec36c896688c47,/Users/sanika/Downloads/Master Thesis/repo_updated/pytest/testing/example_scripts/issue88_initial_file_multinodes/__init__.pyi,5077,ModificationType.MODIFY,0,0,0,0,0,0,0,0,0,0,0,0,0,0,0,0,0,0.0,0.0
2fc7d04fc380e0ee6f43538504ec36c896688c47,/Users/sanika/Downloads/Master Thesis/repo_updated/pytest/testing/example_scripts/fixtures/fill_fixtures/test_extend_fixture_conftest_conftest/__init__.pyi,5077,ModificationType.MODIFY,0,0,0,0,0,0,0,0,0,0,0,0,0,0,0,0,0,0.0,0.0
2fc7d04fc380e0ee6f43538504ec36c896688c47,/Users/sanika/Downloads/Master Thesis/repo_updated/pytest/testing/example_scripts/fixtures/fill_fixtures/test_extend_fixture_conftest_conftest/pkg/__init__.py,5077,ModificationType.MODIFY,0,0,0,0,0,0,0,0,0,0,0,0,0,0,0,0,0,0.0,0.0
2fc7d04fc380e0ee6f43538504ec36c896688c47,/Users/sanika/Downloads/Master Thesis/repo_updated/pytest/testing/example_scripts/fixtures/fill_fixtures/test_extend_fixture_conftest_module/__init__.pyi,5077,ModificationType.MODIFY,0,0,0,0,0,0,0,0,0,0,0,0,0,0,0,0,0,0.0,0.0
2fc7d04fc380e0ee6f43538504ec36c896688c47,/Users/sanika/Downloads/Master Thesis/repo_updated/pytest/testing/example_scripts/fixtures/fill_fixtures/test_conftest_funcargs_only_available_in_subdir/sub1/__init__.py,5077,ModificationType.MODIFY,0,0,0,0,0,0,0,0,0,0,0,0,0,0,0,0,0,0.0,0.0
2fc7d04fc380e0ee6f43538504ec36c896688c47,/Users/sanika/Downloads/Master Thesis/repo_updated/pytest/testing/example_scripts/fixtures/fill_fixtures/test_conftest_funcargs_only_available_in_subdir/sub2/__init__.py,5077,ModificationType.MODIFY,0,0,0,0,0,0,0,0,0,0,0,0,0,0,0,0,0,0.0,0.0
2fc7d04fc380e0ee6f43538504ec36c896688c47,/Users/sanika/Downloads/Master Thesis/repo_updated/pytest/testing/example_scripts/fixtures/custom_item/__init__.pyi,5077,ModificationType.MODIFY,0,0,0,0,0,0,0,0,0,0,0,0,0,0,0,0,0,0.0,0.0
2fc7d04fc380e0ee6f43538504ec36c896688c47,/Users/sanika/Downloads/Master Thesis/repo_updated/pytest/testing/example_scripts/fixtures/custom_item/foo/__init__.py,5077,ModificationType.MODIFY,0,0,0,0,0,0,0,0,0,0,0,0,0,0,0,0,0,0.0,0.0
2fc7d04fc380e0ee6f43538504ec36c896688c47,/Users/sanika/Downloads/Master Thesis/repo_updated/pytest/doc/en/example/nonpython/__init__.py,5077,ModificationType.MODIFY,0,0,0,0,0,0,0,0,0,0,0,0,0,0,0,0,0,0.0,0.0
2fc7d04fc380e0ee6f43538504ec36c896688c47,/Users/sanika/Downloads/Master Thesis/repo_updated/pytest/src/pytest/__init__.py,5077,ModificationType.MODIFY,99,48,90,1,3,5,100,0,0,0,0,0,0,0,0,0,0,0.0,0.0
2fc7d04fc380e0ee6f43538504ec36c896688c47,/Users/sanika/Downloads/Master Thesis/repo_updated/pytest/src/_pytest/__init__.py,5077,ModificationType.MODIFY,8,5,5,2,0,1,10,0,0,0,0,0,0,0,0,0,0,0.0,0.0
2fc7d04fc380e0ee6f43538504ec36c896688c47,/Users/sanika/Downloads/Master Thesis/repo_updated/pytest/src/_pytest/config/__init__.py,5077,ModificationType.MODIFY,1217,716,841,84,126,174,1301,14,185,118,215,199,333,1446.608539104324,2542.995998641035,8.135135135135135,20687.616097052745,1149.3120053918192,0.847665332880345
2fc7d04fc380e0ee6f43538504ec36c896688c47,/Users/sanika/Downloads/Master Thesis/repo_updated/pytest/src/_pytest/mark/__init__.py,5077,ModificationType.MODIFY,160,89,115,0,13,31,160,7,15,11,17,22,28,78.25484338853101,124.86408532184433,3.966666666666667,495.2942051099825,27.51634472833236,0.04162136177394811
2fc7d04fc380e0ee6f43538504ec36c896688c47,/Users/sanika/Downloads/Master Thesis/repo_updated/pytest/src/_pytest/_code/__init__.py,5077,ModificationType.MODIFY,10,10,9,9,0,0,19,0,0,0,0,0,0,0,0,0,0,0.0,0.0
2fc7d04fc380e0ee6f43538504ec36c896688c47,/Users/sanika/Downloads/Master Thesis/repo_updated/pytest/src/_pytest/assertion/__init__.py,5077,ModificationType.MODIFY,173,84,99,8,29,36,181,5,12,7,13,17,20,54.62919048309069,81.7492568250068,2.7083333333333335,221.4042372343934,12.300235401910745,0.027249752275002266
2fc7d04fc380e0ee6f43538504ec36c896688c47,/Users/sanika/Downloads/Master Thesis/repo_updated/pytest/src/_pytest/_io/__init__.py,5077,ModificationType.MODIFY,3,1,1,3,0,0,6,0,0,0,0,0,0,0,0,0,0,0.0,0.0
2fc7d04fc380e0ee6f43538504ec36c896688c47,/Users/sanika/Downloads/Master Thesis/repo_updated/pytest/src/_pytest/config/argparsing.py,2326,ModificationType.MODIFY,463,295,324,28,62,57,491,12,134,82,154,146,236,989.8755015299953,1696.7985958956842,6.895522388059701,11700.312706026956,650.0173725570531,0.565599531965228
2fc7d04fc380e0ee6f43538504ec36c896688c47,/Users/sanika/Downloads/Master Thesis/repo_updated/pytest/src/_pytest/hookspec.py,642,ModificationType.MODIFY,647,139,84,35,284,233,682,0,0,0,0,0,0,0,0,0,0,0.0,0.0
2fc7d04fc380e0ee6f43538504ec36c896688c47,/Users/sanika/Downloads/Master Thesis/repo_updated/pytest/testing/test_terminal.py,6416,ModificationType.MODIFY,1943,715,1694,26,18,214,1969,12,185,120,237,197,357,1436.3251202041715,2721.0724995459263,7.686486486486486,20915.486996509768,1161.971499806098,0.9070241665153088
2fc7d04fc380e0ee6f43538504ec36c896688c47,/Users/sanika/Downloads/Master Thesis/repo_updated/pytest/src/_pytest/terminal.py,6416,ModificationType.MODIFY,1168,838,957,57,25,144,1225,19,348,224,416,367,640,3018.854959310786,5452.5672018196565,11.35632183908046,61921.107993078396,3440.061555171022,1.8175224006065522
2fc7d04fc380e0ee6f43538504ec36c896688c47,/Users/sanika/Downloads/Master Thesis/repo_updated/pytest/testing/test_warnings.py,625,ModificationType.MODIFY,601,196,481,2,23,85,603,8,63,36,72,71,108,400.56863518049477,664.1726889065056,4.571428571428571,3036.21800642974,168.67877813498555,0.22139089630216854
2fc7d04fc380e0ee6f43538504ec36c896688c47,/Users/sanika/Downloads/Master Thesis/repo_updated/pytest/src/_pytest/warnings.py,625,ModificationType.MODIFY,156,79,106,5,16,28,161,5,14,8,15,19,23,64.91260938324326,97.70233280920246,2.6785714285714284,261.7026771675066,14.539037620417032,0.03256744426973415
99f487864caf2a4a1d75a3d322304e7b3b03d01b,/Users/sanika/Downloads/Master Thesis/repo_updated/pytest/src/_pytest/deprecated.py,45,ModificationType.MODIFY,42,7,23,2,8,9,44,0,0,0,0,0,0,0,0,0,0,0.0,0.0
99f487864caf2a4a1d75a3d322304e7b3b03d01b,/Users/sanika/Downloads/Master Thesis/repo_updated/pytest/testing/test_junitxml.py,3197,ModificationType.MODIFY,1523,757,1297,19,12,193,1542,12,193,117,230,205,347,1508.3637582013935,2664.7795945283897,7.150259067357513,19053.864458285894,1058.5480254603274,0.8882598648427965
99f487864caf2a4a1d75a3d322304e7b3b03d01b,/Users/sanika/Downloads/Master Thesis/repo_updated/pytest/src/_pytest/junitxml.py,3197,ModificationType.MODIFY,701,378,504,33,58,109,734,13,110,68,126,123,194,794.0552848235468,1346.8478140358125,7.445454545454545,10027.894179048459,557.1052321693588,0.4489492713452708
99f487864caf2a4a1d75a3d322304e7b3b03d01b,/Users/sanika/Downloads/Master Thesis/repo_updated/pytest/testing/deprecated_test.py,265,ModificationType.MODIFY,75,38,59,1,3,12,76,2,4,2,4,6,6,10.0,15.509775004326936,1.0,15.509775004326936,0.861654166907052,0.005169925001442312
d2ea9e2db58dfb6c5a3c2981bfd062369e51fbf3,/Users/sanika/Downloads/Master Thesis/repo_updated/pytest/testing/example_scripts/collect/package_infinite_recursion/__init__.pyi,5075,ModificationType.MODIFY,0,0,0,0,0,0,0,0,0,0,0,0,0,0,0,0,0,0.0,0.0
d2ea9e2db58dfb6c5a3c2981bfd062369e51fbf3,/Users/sanika/Downloads/Master Thesis/repo_updated/pytest/testing/example_scripts/collect/package_infinite_recursion/tests/__init__.py,5075,ModificationType.MODIFY,0,0,0,0,0,0,0,0,0,0,0,0,0,0,0,0,0,0.0,0.0
d2ea9e2db58dfb6c5a3c2981bfd062369e51fbf3,/Users/sanika/Downloads/Master Thesis/repo_updated/pytest/testing/example_scripts/collect/collect_init_tests/tests/__init__.py,5075,ModificationType.MODIFY,2,2,2,0,0,0,2,0,0,0,0,0,0,0,0,0,0,0.0,0.0
d2ea9e2db58dfb6c5a3c2981bfd062369e51fbf3,/Users/sanika/Downloads/Master Thesis/repo_updated/pytest/testing/example_scripts/collect/package_init_given_as_arg/pkg/__init__.py,5075,ModificationType.MODIFY,0,0,0,0,0,0,0,0,0,0,0,0,0,0,0,0,0,0.0,0.0
d2ea9e2db58dfb6c5a3c2981bfd062369e51fbf3,/Users/sanika/Downloads/Master Thesis/repo_updated/pytest/testing/example_scripts/conftest_usageerror/__init__.pyi,5075,ModificationType.MODIFY,0,0,0,0,0,0,0,0,0,0,0,0,0,0,0,0,0,0.0,0.0
d2ea9e2db58dfb6c5a3c2981bfd062369e51fbf3,/Users/sanika/Downloads/Master Thesis/repo_updated/pytest/testing/example_scripts/marks/marks_considered_keywords/__init__.pyi,5075,ModificationType.MODIFY,0,0,0,0,0,0,0,0,0,0,0,0,0,0,0,0,0,0.0,0.0
d2ea9e2db58dfb6c5a3c2981bfd062369e51fbf3,/Users/sanika/Downloads/Master Thesis/repo_updated/pytest/testing/example_scripts/config/collect_pytest_prefix/__init__.pyi,5075,ModificationType.MODIFY,0,0,0,0,0,0,0,0,0,0,0,0,0,0,0,0,0,0.0,0.0
d2ea9e2db58dfb6c5a3c2981bfd062369e51fbf3,/Users/sanika/Downloads/Master Thesis/repo_updated/pytest/testing/example_scripts/issue88_initial_file_multinodes/__init__.pyi,5075,ModificationType.MODIFY,0,0,0,0,0,0,0,0,0,0,0,0,0,0,0,0,0,0.0,0.0
d2ea9e2db58dfb6c5a3c2981bfd062369e51fbf3,/Users/sanika/Downloads/Master Thesis/repo_updated/pytest/testing/example_scripts/fixtures/fill_fixtures/test_extend_fixture_conftest_conftest/__init__.pyi,5075,ModificationType.MODIFY,0,0,0,0,0,0,0,0,0,0,0,0,0,0,0,0,0,0.0,0.0
d2ea9e2db58dfb6c5a3c2981bfd062369e51fbf3,/Users/sanika/Downloads/Master Thesis/repo_updated/pytest/testing/example_scripts/fixtures/fill_fixtures/test_extend_fixture_conftest_conftest/pkg/__init__.py,5075,ModificationType.MODIFY,0,0,0,0,0,0,0,0,0,0,0,0,0,0,0,0,0,0.0,0.0
d2ea9e2db58dfb6c5a3c2981bfd062369e51fbf3,/Users/sanika/Downloads/Master Thesis/repo_updated/pytest/testing/example_scripts/fixtures/fill_fixtures/test_extend_fixture_conftest_module/__init__.pyi,5075,ModificationType.MODIFY,0,0,0,0,0,0,0,0,0,0,0,0,0,0,0,0,0,0.0,0.0
d2ea9e2db58dfb6c5a3c2981bfd062369e51fbf3,/Users/sanika/Downloads/Master Thesis/repo_updated/pytest/testing/example_scripts/fixtures/fill_fixtures/test_conftest_funcargs_only_available_in_subdir/sub1/__init__.py,5075,ModificationType.MODIFY,0,0,0,0,0,0,0,0,0,0,0,0,0,0,0,0,0,0.0,0.0
d2ea9e2db58dfb6c5a3c2981bfd062369e51fbf3,/Users/sanika/Downloads/Master Thesis/repo_updated/pytest/testing/example_scripts/fixtures/fill_fixtures/test_conftest_funcargs_only_available_in_subdir/sub2/__init__.py,5075,ModificationType.MODIFY,0,0,0,0,0,0,0,0,0,0,0,0,0,0,0,0,0,0.0,0.0
d2ea9e2db58dfb6c5a3c2981bfd062369e51fbf3,/Users/sanika/Downloads/Master Thesis/repo_updated/pytest/testing/example_scripts/fixtures/custom_item/__init__.pyi,5075,ModificationType.MODIFY,0,0,0,0,0,0,0,0,0,0,0,0,0,0,0,0,0,0.0,0.0
d2ea9e2db58dfb6c5a3c2981bfd062369e51fbf3,/Users/sanika/Downloads/Master Thesis/repo_updated/pytest/testing/example_scripts/fixtures/custom_item/foo/__init__.py,5075,ModificationType.MODIFY,0,0,0,0,0,0,0,0,0,0,0,0,0,0,0,0,0,0.0,0.0
d2ea9e2db58dfb6c5a3c2981bfd062369e51fbf3,/Users/sanika/Downloads/Master Thesis/repo_updated/pytest/doc/en/example/nonpython/__init__.py,5075,ModificationType.MODIFY,0,0,0,0,0,0,0,0,0,0,0,0,0,0,0,0,0,0.0,0.0
d2ea9e2db58dfb6c5a3c2981bfd062369e51fbf3,/Users/sanika/Downloads/Master Thesis/repo_updated/pytest/src/pytest/__init__.py,5075,ModificationType.MODIFY,99,48,90,1,3,5,100,0,0,0,0,0,0,0,0,0,0,0.0,0.0
d2ea9e2db58dfb6c5a3c2981bfd062369e51fbf3,/Users/sanika/Downloads/Master Thesis/repo_updated/pytest/src/_pytest/__init__.py,5075,ModificationType.MODIFY,8,5,5,2,0,1,10,0,0,0,0,0,0,0,0,0,0,0.0,0.0
d2ea9e2db58dfb6c5a3c2981bfd062369e51fbf3,/Users/sanika/Downloads/Master Thesis/repo_updated/pytest/src/_pytest/config/__init__.py,5075,ModificationType.MODIFY,1217,716,841,84,126,174,1301,14,185,118,215,199,333,1446.608539104324,2542.995998641035,8.135135135135135,20687.616097052745,1149.3120053918192,0.847665332880345
d2ea9e2db58dfb6c5a3c2981bfd062369e51fbf3,/Users/sanika/Downloads/Master Thesis/repo_updated/pytest/src/_pytest/mark/__init__.py,5075,ModificationType.MODIFY,160,89,115,0,13,31,160,7,15,11,17,22,28,78.25484338853101,124.86408532184433,3.966666666666667,495.2942051099825,27.51634472833236,0.04162136177394811
d2ea9e2db58dfb6c5a3c2981bfd062369e51fbf3,/Users/sanika/Downloads/Master Thesis/repo_updated/pytest/src/_pytest/_code/__init__.py,5075,ModificationType.MODIFY,10,10,9,9,0,0,19,0,0,0,0,0,0,0,0,0,0,0.0,0.0
d2ea9e2db58dfb6c5a3c2981bfd062369e51fbf3,/Users/sanika/Downloads/Master Thesis/repo_updated/pytest/src/_pytest/assertion/__init__.py,5075,ModificationType.MODIFY,173,84,99,8,29,36,181,5,12,7,13,17,20,54.62919048309069,81.7492568250068,2.7083333333333335,221.4042372343934,12.300235401910745,0.027249752275002266
d2ea9e2db58dfb6c5a3c2981bfd062369e51fbf3,/Users/sanika/Downloads/Master Thesis/repo_updated/pytest/src/_pytest/_io/__init__.py,5075,ModificationType.MODIFY,3,1,1,3,0,0,6,0,0,0,0,0,0,0,0,0,0,0.0,0.0
d2ea9e2db58dfb6c5a3c2981bfd062369e51fbf3,/Users/sanika/Downloads/Master Thesis/repo_updated/pytest/src/_pytest/deprecated.py,45,ModificationType.MODIFY,42,7,23,2,8,9,44,0,0,0,0,0,0,0,0,0,0,0.0,0.0
d2ea9e2db58dfb6c5a3c2981bfd062369e51fbf3,/Users/sanika/Downloads/Master Thesis/repo_updated/pytest/testing/deprecated_test.py,265,ModificationType.MODIFY,75,38,59,1,3,12,76,2,4,2,4,6,6,10.0,15.509775004326936,1.0,15.509775004326936,0.861654166907052,0.005169925001442312
176c7771fb4f3bd703bb6c9650cc32e31d548a2b,/Users/sanika/Downloads/Master Thesis/repo_updated/pytest/doc/en/example/multipython.py,6699,ModificationType.MODIFY,72,33,56,0,4,12,72,1,1,1,1,2,2,0.0,2.0,0.5,1.0,0.05555555555555555,0.0006666666666666666
176c7771fb4f3bd703bb6c9650cc32e31d548a2b,/Users/sanika/Downloads/Master Thesis/repo_updated/pytest/src/_pytest/python.py,6699,ModificationType.MODIFY,1454,835,1044,76,110,219,1530,17,275,158,296,292,454,2297.8910156145625,3718.180349731528,9.149090909090908,34017.97003608918,1889.8872242271766,1.2393934499105095
176c7771fb4f3bd703bb6c9650cc32e31d548a2b,/Users/sanika/Downloads/Master Thesis/repo_updated/pytest/testing/test_skipping.py,3071,ModificationType.MODIFY,1178,367,1042,6,15,115,1184,9,94,51,95,103,146,644.6606770706787,976.22907696875,4.547872340425532,4439.7652170653255,246.65362317029587,0.32540969232291667
4e0f99260d438d750b55a0881110658b8bba5a4a,/Users/sanika/Downloads/Master Thesis/repo_updated/pytest/testing/test_collection.py,5041,ModificationType.MODIFY,1296,573,1062,40,33,157,1336,8,201,118,231,209,349,1561.8613899269646,2689.868337096228,4.597014925373134,12365.364892919973,686.9647162733319,0.896622779032076
19a15a94eeb403631f847fab5fe5073bc56e8bcc,/Users/sanika/Downloads/Master Thesis/repo_updated/pytest/doc/en/example/multipython.py,6699,ModificationType.MODIFY,72,33,56,0,4,12,72,1,1,1,1,2,2,0.0,2.0,0.5,1.0,0.05555555555555555,0.0006666666666666666
19a15a94eeb403631f847fab5fe5073bc56e8bcc,/Users/sanika/Downloads/Master Thesis/repo_updated/pytest/src/_pytest/python.py,6699,ModificationType.MODIFY,1454,835,1044,76,110,219,1530,17,275,158,296,292,454,2297.8910156145625,3718.180349731528,9.149090909090908,34017.97003608918,1889.8872242271766,1.2393934499105095
19a15a94eeb403631f847fab5fe5073bc56e8bcc,/Users/sanika/Downloads/Master Thesis/repo_updated/pytest/testing/test_collection.py,5041,ModificationType.MODIFY,1296,573,1062,40,33,157,1336,8,201,118,231,209,349,1561.8613899269646,2689.868337096228,4.597014925373134,12365.364892919973,686.9647162733319,0.896622779032076
19a15a94eeb403631f847fab5fe5073bc56e8bcc,/Users/sanika/Downloads/Master Thesis/repo_updated/pytest/testing/test_skipping.py,3071,ModificationType.MODIFY,1178,367,1042,6,15,115,1184,9,94,51,95,103,146,644.6606770706787,976.22907696875,4.547872340425532,4439.7652170653255,246.65362317029587,0.32540969232291667
5979837c6084e80367ce4f7e1b97aabd755221b0,/Users/sanika/Downloads/Master Thesis/repo_updated/pytest/testing/test_assertrewrite.py,5619,ModificationType.MODIFY,1660,832,1314,41,38,274,1701,20,312,209,395,332,604,2671.484054182769,5058.523816533542,12.66025641025641,64042.2085747035,3557.900476372417,1.6861746055111808
5979837c6084e80367ce4f7e1b97aabd755221b0,/Users/sanika/Downloads/Master Thesis/repo_updated/pytest/src/_pytest/assertion/rewrite.py,5619,ModificationType.MODIFY,1057,646,719,113,100,145,1170,18,215,134,248,233,382,1740.9201126876956,3004.119107257935,10.38139534883721,31186.948127440515,1732.608229302251,1.001373035752645
5979837c6084e80367ce4f7e1b97aabd755221b0,/Users/sanika/Downloads/Master Thesis/repo_updated/pytest/testing/example_scripts/collect/package_infinite_recursion/__init__.pyi,5079,ModificationType.MODIFY,0,0,0,0,0,0,0,0,0,0,0,0,0,0,0,0,0,0.0,0.0
5979837c6084e80367ce4f7e1b97aabd755221b0,/Users/sanika/Downloads/Master Thesis/repo_updated/pytest/testing/example_scripts/collect/package_infinite_recursion/tests/__init__.py,5079,ModificationType.MODIFY,0,0,0,0,0,0,0,0,0,0,0,0,0,0,0,0,0,0.0,0.0
5979837c6084e80367ce4f7e1b97aabd755221b0,/Users/sanika/Downloads/Master Thesis/repo_updated/pytest/testing/example_scripts/collect/collect_init_tests/tests/__init__.py,5079,ModificationType.MODIFY,2,2,2,0,0,0,2,0,0,0,0,0,0,0,0,0,0,0.0,0.0
5979837c6084e80367ce4f7e1b97aabd755221b0,/Users/sanika/Downloads/Master Thesis/repo_updated/pytest/testing/example_scripts/collect/package_init_given_as_arg/pkg/__init__.py,5079,ModificationType.MODIFY,0,0,0,0,0,0,0,0,0,0,0,0,0,0,0,0,0,0.0,0.0
5979837c6084e80367ce4f7e1b97aabd755221b0,/Users/sanika/Downloads/Master Thesis/repo_updated/pytest/testing/example_scripts/conftest_usageerror/__init__.pyi,5079,ModificationType.MODIFY,0,0,0,0,0,0,0,0,0,0,0,0,0,0,0,0,0,0.0,0.0
5979837c6084e80367ce4f7e1b97aabd755221b0,/Users/sanika/Downloads/Master Thesis/repo_updated/pytest/testing/example_scripts/marks/marks_considered_keywords/__init__.pyi,5079,ModificationType.MODIFY,0,0,0,0,0,0,0,0,0,0,0,0,0,0,0,0,0,0.0,0.0
5979837c6084e80367ce4f7e1b97aabd755221b0,/Users/sanika/Downloads/Master Thesis/repo_updated/pytest/testing/example_scripts/config/collect_pytest_prefix/__init__.pyi,5079,ModificationType.MODIFY,0,0,0,0,0,0,0,0,0,0,0,0,0,0,0,0,0,0.0,0.0
5979837c6084e80367ce4f7e1b97aabd755221b0,/Users/sanika/Downloads/Master Thesis/repo_updated/pytest/testing/example_scripts/issue88_initial_file_multinodes/__init__.pyi,5079,ModificationType.MODIFY,0,0,0,0,0,0,0,0,0,0,0,0,0,0,0,0,0,0.0,0.0
5979837c6084e80367ce4f7e1b97aabd755221b0,/Users/sanika/Downloads/Master Thesis/repo_updated/pytest/testing/example_scripts/fixtures/fill_fixtures/test_extend_fixture_conftest_conftest/__init__.pyi,5079,ModificationType.MODIFY,0,0,0,0,0,0,0,0,0,0,0,0,0,0,0,0,0,0.0,0.0
5979837c6084e80367ce4f7e1b97aabd755221b0,/Users/sanika/Downloads/Master Thesis/repo_updated/pytest/testing/example_scripts/fixtures/fill_fixtures/test_extend_fixture_conftest_conftest/pkg/__init__.py,5079,ModificationType.MODIFY,0,0,0,0,0,0,0,0,0,0,0,0,0,0,0,0,0,0.0,0.0
5979837c6084e80367ce4f7e1b97aabd755221b0,/Users/sanika/Downloads/Master Thesis/repo_updated/pytest/testing/example_scripts/fixtures/fill_fixtures/test_extend_fixture_conftest_module/__init__.pyi,5079,ModificationType.MODIFY,0,0,0,0,0,0,0,0,0,0,0,0,0,0,0,0,0,0.0,0.0
5979837c6084e80367ce4f7e1b97aabd755221b0,/Users/sanika/Downloads/Master Thesis/repo_updated/pytest/testing/example_scripts/fixtures/fill_fixtures/test_conftest_funcargs_only_available_in_subdir/sub1/__init__.py,5079,ModificationType.MODIFY,0,0,0,0,0,0,0,0,0,0,0,0,0,0,0,0,0,0.0,0.0
5979837c6084e80367ce4f7e1b97aabd755221b0,/Users/sanika/Downloads/Master Thesis/repo_updated/pytest/testing/example_scripts/fixtures/fill_fixtures/test_conftest_funcargs_only_available_in_subdir/sub2/__init__.py,5079,ModificationType.MODIFY,0,0,0,0,0,0,0,0,0,0,0,0,0,0,0,0,0,0.0,0.0
5979837c6084e80367ce4f7e1b97aabd755221b0,/Users/sanika/Downloads/Master Thesis/repo_updated/pytest/testing/example_scripts/fixtures/custom_item/__init__.pyi,5079,ModificationType.MODIFY,0,0,0,0,0,0,0,0,0,0,0,0,0,0,0,0,0,0.0,0.0
5979837c6084e80367ce4f7e1b97aabd755221b0,/Users/sanika/Downloads/Master Thesis/repo_updated/pytest/testing/example_scripts/fixtures/custom_item/foo/__init__.py,5079,ModificationType.MODIFY,0,0,0,0,0,0,0,0,0,0,0,0,0,0,0,0,0,0.0,0.0
5979837c6084e80367ce4f7e1b97aabd755221b0,/Users/sanika/Downloads/Master Thesis/repo_updated/pytest/doc/en/example/nonpython/__init__.py,5079,ModificationType.MODIFY,0,0,0,0,0,0,0,0,0,0,0,0,0,0,0,0,0,0.0,0.0
5979837c6084e80367ce4f7e1b97aabd755221b0,/Users/sanika/Downloads/Master Thesis/repo_updated/pytest/src/pytest/__init__.py,5079,ModificationType.MODIFY,99,48,90,1,3,5,100,0,0,0,0,0,0,0,0,0,0,0.0,0.0
5979837c6084e80367ce4f7e1b97aabd755221b0,/Users/sanika/Downloads/Master Thesis/repo_updated/pytest/src/_pytest/__init__.py,5079,ModificationType.MODIFY,8,5,5,2,0,1,10,0,0,0,0,0,0,0,0,0,0,0.0,0.0
5979837c6084e80367ce4f7e1b97aabd755221b0,/Users/sanika/Downloads/Master Thesis/repo_updated/pytest/src/_pytest/config/__init__.py,5079,ModificationType.MODIFY,1217,716,841,84,126,174,1301,14,185,118,215,199,333,1446.608539104324,2542.995998641035,8.135135135135135,20687.616097052745,1149.3120053918192,0.847665332880345
5979837c6084e80367ce4f7e1b97aabd755221b0,/Users/sanika/Downloads/Master Thesis/repo_updated/pytest/src/_pytest/mark/__init__.py,5079,ModificationType.MODIFY,160,89,115,0,13,31,160,7,15,11,17,22,28,78.25484338853101,124.86408532184433,3.966666666666667,495.2942051099825,27.51634472833236,0.04162136177394811
5979837c6084e80367ce4f7e1b97aabd755221b0,/Users/sanika/Downloads/Master Thesis/repo_updated/pytest/src/_pytest/_code/__init__.py,5079,ModificationType.MODIFY,10,10,9,9,0,0,19,0,0,0,0,0,0,0,0,0,0,0.0,0.0
5979837c6084e80367ce4f7e1b97aabd755221b0,/Users/sanika/Downloads/Master Thesis/repo_updated/pytest/src/_pytest/assertion/__init__.py,5079,ModificationType.MODIFY,173,84,99,8,29,36,181,5,12,7,13,17,20,54.62919048309069,81.7492568250068,2.7083333333333335,221.4042372343934,12.300235401910745,0.027249752275002266
5979837c6084e80367ce4f7e1b97aabd755221b0,/Users/sanika/Downloads/Master Thesis/repo_updated/pytest/src/_pytest/_io/__init__.py,5079,ModificationType.MODIFY,3,1,1,3,0,0,6,0,0,0,0,0,0,0,0,0,0,0.0,0.0
5979837c6084e80367ce4f7e1b97aabd755221b0,/Users/sanika/Downloads/Master Thesis/repo_updated/pytest/testing/test_assertrewrite.py,6342,ModificationType.MODIFY,1660,832,1314,41,38,274,1701,20,312,209,395,332,604,2671.484054182769,5058.523816533542,12.66025641025641,64042.2085747035,3557.900476372417,1.6861746055111808
5979837c6084e80367ce4f7e1b97aabd755221b0,/Users/sanika/Downloads/Master Thesis/repo_updated/pytest/testing/test_config.py,6058,ModificationType.MODIFY,1457,730,1242,11,6,188,1468,10,292,166,329,302,495,2424.648052141839,4078.010345965914,5.633561643835616,22973.722668198385,1276.3179260110214,1.359336781988638
5979837c6084e80367ce4f7e1b97aabd755221b0,/Users/sanika/Downloads/Master Thesis/repo_updated/pytest/testing/test_conftest.py,2850,ModificationType.MODIFY,652,304,544,16,6,88,668,6,89,51,101,95,152,591.8500503603364,998.6180524663041,3.404494382022472,3399.7895494077547,188.8771971893197,0.3328726841554347
5979837c6084e80367ce4f7e1b97aabd755221b0,/Users/sanika/Downloads/Master Thesis/repo_updated/pytest/testing/test_junitxml.py,5659,ModificationType.MODIFY,1523,757,1297,19,12,193,1542,12,193,117,230,205,347,1508.3637582013935,2664.7795945283897,7.150259067357513,19053.864458285894,1058.5480254603274,0.8882598648427965
1abb08d52f165e46bb3cc80a9ece860aa4afe5b5,/Users/sanika/Downloads/Master Thesis/repo_updated/pytest/testing/test_cacheprovider.py,3885,ModificationType.MODIFY,996,429,845,24,10,117,1020,7,76,50,88,83,138,494.49397547611574,879.7554415258757,4.052631578947368,3565.3246840785487,198.07359355991937,0.29325181384195853
c49c61fdafdce50ffefd3ad482e3bd6f58ef298e,/Users/sanika/Downloads/Master Thesis/repo_updated/pytest/testing/test_assertrewrite.py,5619,ModificationType.MODIFY,1660,832,1314,41,38,274,1701,20,312,209,395,332,604,2671.484054182769,5058.523816533542,12.66025641025641,64042.2085747035,3557.900476372417,1.6861746055111808
c49c61fdafdce50ffefd3ad482e3bd6f58ef298e,/Users/sanika/Downloads/Master Thesis/repo_updated/pytest/src/_pytest/assertion/rewrite.py,5619,ModificationType.MODIFY,1057,646,719,113,100,145,1170,18,215,134,248,233,382,1740.9201126876956,3004.119107257935,10.38139534883721,31186.948127440515,1732.608229302251,1.001373035752645
c49c61fdafdce50ffefd3ad482e3bd6f58ef298e,/Users/sanika/Downloads/Master Thesis/repo_updated/pytest/testing/example_scripts/collect/package_infinite_recursion/__init__.pyi,5079,ModificationType.MODIFY,0,0,0,0,0,0,0,0,0,0,0,0,0,0,0,0,0,0.0,0.0
c49c61fdafdce50ffefd3ad482e3bd6f58ef298e,/Users/sanika/Downloads/Master Thesis/repo_updated/pytest/testing/example_scripts/collect/package_infinite_recursion/tests/__init__.py,5079,ModificationType.MODIFY,0,0,0,0,0,0,0,0,0,0,0,0,0,0,0,0,0,0.0,0.0
c49c61fdafdce50ffefd3ad482e3bd6f58ef298e,/Users/sanika/Downloads/Master Thesis/repo_updated/pytest/testing/example_scripts/collect/collect_init_tests/tests/__init__.py,5079,ModificationType.MODIFY,2,2,2,0,0,0,2,0,0,0,0,0,0,0,0,0,0,0.0,0.0
c49c61fdafdce50ffefd3ad482e3bd6f58ef298e,/Users/sanika/Downloads/Master Thesis/repo_updated/pytest/testing/example_scripts/collect/package_init_given_as_arg/pkg/__init__.py,5079,ModificationType.MODIFY,0,0,0,0,0,0,0,0,0,0,0,0,0,0,0,0,0,0.0,0.0
c49c61fdafdce50ffefd3ad482e3bd6f58ef298e,/Users/sanika/Downloads/Master Thesis/repo_updated/pytest/testing/example_scripts/conftest_usageerror/__init__.pyi,5079,ModificationType.MODIFY,0,0,0,0,0,0,0,0,0,0,0,0,0,0,0,0,0,0.0,0.0
c49c61fdafdce50ffefd3ad482e3bd6f58ef298e,/Users/sanika/Downloads/Master Thesis/repo_updated/pytest/testing/example_scripts/marks/marks_considered_keywords/__init__.pyi,5079,ModificationType.MODIFY,0,0,0,0,0,0,0,0,0,0,0,0,0,0,0,0,0,0.0,0.0
c49c61fdafdce50ffefd3ad482e3bd6f58ef298e,/Users/sanika/Downloads/Master Thesis/repo_updated/pytest/testing/example_scripts/config/collect_pytest_prefix/__init__.pyi,5079,ModificationType.MODIFY,0,0,0,0,0,0,0,0,0,0,0,0,0,0,0,0,0,0.0,0.0
c49c61fdafdce50ffefd3ad482e3bd6f58ef298e,/Users/sanika/Downloads/Master Thesis/repo_updated/pytest/testing/example_scripts/issue88_initial_file_multinodes/__init__.pyi,5079,ModificationType.MODIFY,0,0,0,0,0,0,0,0,0,0,0,0,0,0,0,0,0,0.0,0.0
c49c61fdafdce50ffefd3ad482e3bd6f58ef298e,/Users/sanika/Downloads/Master Thesis/repo_updated/pytest/testing/example_scripts/fixtures/fill_fixtures/test_extend_fixture_conftest_conftest/__init__.pyi,5079,ModificationType.MODIFY,0,0,0,0,0,0,0,0,0,0,0,0,0,0,0,0,0,0.0,0.0
c49c61fdafdce50ffefd3ad482e3bd6f58ef298e,/Users/sanika/Downloads/Master Thesis/repo_updated/pytest/testing/example_scripts/fixtures/fill_fixtures/test_extend_fixture_conftest_conftest/pkg/__init__.py,5079,ModificationType.MODIFY,0,0,0,0,0,0,0,0,0,0,0,0,0,0,0,0,0,0.0,0.0
c49c61fdafdce50ffefd3ad482e3bd6f58ef298e,/Users/sanika/Downloads/Master Thesis/repo_updated/pytest/testing/example_scripts/fixtures/fill_fixtures/test_extend_fixture_conftest_module/__init__.pyi,5079,ModificationType.MODIFY,0,0,0,0,0,0,0,0,0,0,0,0,0,0,0,0,0,0.0,0.0
c49c61fdafdce50ffefd3ad482e3bd6f58ef298e,/Users/sanika/Downloads/Master Thesis/repo_updated/pytest/testing/example_scripts/fixtures/fill_fixtures/test_conftest_funcargs_only_available_in_subdir/sub1/__init__.py,5079,ModificationType.MODIFY,0,0,0,0,0,0,0,0,0,0,0,0,0,0,0,0,0,0.0,0.0
c49c61fdafdce50ffefd3ad482e3bd6f58ef298e,/Users/sanika/Downloads/Master Thesis/repo_updated/pytest/testing/example_scripts/fixtures/fill_fixtures/test_conftest_funcargs_only_available_in_subdir/sub2/__init__.py,5079,ModificationType.MODIFY,0,0,0,0,0,0,0,0,0,0,0,0,0,0,0,0,0,0.0,0.0
c49c61fdafdce50ffefd3ad482e3bd6f58ef298e,/Users/sanika/Downloads/Master Thesis/repo_updated/pytest/testing/example_scripts/fixtures/custom_item/__init__.pyi,5079,ModificationType.MODIFY,0,0,0,0,0,0,0,0,0,0,0,0,0,0,0,0,0,0.0,0.0
c49c61fdafdce50ffefd3ad482e3bd6f58ef298e,/Users/sanika/Downloads/Master Thesis/repo_updated/pytest/testing/example_scripts/fixtures/custom_item/foo/__init__.py,5079,ModificationType.MODIFY,0,0,0,0,0,0,0,0,0,0,0,0,0,0,0,0,0,0.0,0.0
c49c61fdafdce50ffefd3ad482e3bd6f58ef298e,/Users/sanika/Downloads/Master Thesis/repo_updated/pytest/doc/en/example/nonpython/__init__.py,5079,ModificationType.MODIFY,0,0,0,0,0,0,0,0,0,0,0,0,0,0,0,0,0,0.0,0.0
c49c61fdafdce50ffefd3ad482e3bd6f58ef298e,/Users/sanika/Downloads/Master Thesis/repo_updated/pytest/src/pytest/__init__.py,5079,ModificationType.MODIFY,99,48,90,1,3,5,100,0,0,0,0,0,0,0,0,0,0,0.0,0.0
c49c61fdafdce50ffefd3ad482e3bd6f58ef298e,/Users/sanika/Downloads/Master Thesis/repo_updated/pytest/src/_pytest/__init__.py,5079,ModificationType.MODIFY,8,5,5,2,0,1,10,0,0,0,0,0,0,0,0,0,0,0.0,0.0
c49c61fdafdce50ffefd3ad482e3bd6f58ef298e,/Users/sanika/Downloads/Master Thesis/repo_updated/pytest/src/_pytest/config/__init__.py,5079,ModificationType.MODIFY,1217,716,841,84,126,174,1301,14,185,118,215,199,333,1446.608539104324,2542.995998641035,8.135135135135135,20687.616097052745,1149.3120053918192,0.847665332880345
c49c61fdafdce50ffefd3ad482e3bd6f58ef298e,/Users/sanika/Downloads/Master Thesis/repo_updated/pytest/src/_pytest/mark/__init__.py,5079,ModificationType.MODIFY,160,89,115,0,13,31,160,7,15,11,17,22,28,78.25484338853101,124.86408532184433,3.966666666666667,495.2942051099825,27.51634472833236,0.04162136177394811
c49c61fdafdce50ffefd3ad482e3bd6f58ef298e,/Users/sanika/Downloads/Master Thesis/repo_updated/pytest/src/_pytest/_code/__init__.py,5079,ModificationType.MODIFY,10,10,9,9,0,0,19,0,0,0,0,0,0,0,0,0,0,0.0,0.0
c49c61fdafdce50ffefd3ad482e3bd6f58ef298e,/Users/sanika/Downloads/Master Thesis/repo_updated/pytest/src/_pytest/assertion/__init__.py,5079,ModificationType.MODIFY,173,84,99,8,29,36,181,5,12,7,13,17,20,54.62919048309069,81.7492568250068,2.7083333333333335,221.4042372343934,12.300235401910745,0.027249752275002266
c49c61fdafdce50ffefd3ad482e3bd6f58ef298e,/Users/sanika/Downloads/Master Thesis/repo_updated/pytest/src/_pytest/_io/__init__.py,5079,ModificationType.MODIFY,3,1,1,3,0,0,6,0,0,0,0,0,0,0,0,0,0,0.0,0.0
c49c61fdafdce50ffefd3ad482e3bd6f58ef298e,/Users/sanika/Downloads/Master Thesis/repo_updated/pytest/testing/test_assertrewrite.py,6342,ModificationType.MODIFY,1660,832,1314,41,38,274,1701,20,312,209,395,332,604,2671.484054182769,5058.523816533542,12.66025641025641,64042.2085747035,3557.900476372417,1.6861746055111808
c49c61fdafdce50ffefd3ad482e3bd6f58ef298e,/Users/sanika/Downloads/Master Thesis/repo_updated/pytest/testing/test_config.py,6058,ModificationType.MODIFY,1457,730,1242,11,6,188,1468,10,292,166,329,302,495,2424.648052141839,4078.010345965914,5.633561643835616,22973.722668198385,1276.3179260110214,1.359336781988638
c49c61fdafdce50ffefd3ad482e3bd6f58ef298e,/Users/sanika/Downloads/Master Thesis/repo_updated/pytest/testing/test_conftest.py,2850,ModificationType.MODIFY,652,304,544,16,6,88,668,6,89,51,101,95,152,591.8500503603364,998.6180524663041,3.404494382022472,3399.7895494077547,188.8771971893197,0.3328726841554347
c49c61fdafdce50ffefd3ad482e3bd6f58ef298e,/Users/sanika/Downloads/Master Thesis/repo_updated/pytest/testing/test_junitxml.py,5659,ModificationType.MODIFY,1523,757,1297,19,12,193,1542,12,193,117,230,205,347,1508.3637582013935,2664.7795945283897,7.150259067357513,19053.864458285894,1058.5480254603274,0.8882598648427965
cc78444c30ba7930358cd0bd3cfac9ba52cb579f,/Users/sanika/Downloads/Master Thesis/repo_updated/pytest/doc/en/example/multipython.py,6705,ModificationType.MODIFY,72,33,56,0,4,12,72,1,1,1,1,2,2,0.0,2.0,0.5,1.0,0.05555555555555555,0.0006666666666666666
cc78444c30ba7930358cd0bd3cfac9ba52cb579f,/Users/sanika/Downloads/Master Thesis/repo_updated/pytest/src/_pytest/python.py,6705,ModificationType.MODIFY,1454,835,1044,76,110,219,1530,17,275,158,296,292,454,2297.8910156145625,3718.180349731528,9.149090909090908,34017.97003608918,1889.8872242271766,1.2393934499105095
cc78444c30ba7930358cd0bd3cfac9ba52cb579f,/Users/sanika/Downloads/Master Thesis/repo_updated/pytest/testing/python/metafunc.py,5913,ModificationType.MODIFY,1782,648,1425,9,47,279,1791,8,171,97,189,179,286,1292.4527800454887,2140.3713122975773,4.421052631578948,9462.69422278929,525.705234599405,0.7134571040991925
cc78444c30ba7930358cd0bd3cfac9ba52cb579f,/Users/sanika/Downloads/Master Thesis/repo_updated/pytest/testing/test_collection.py,5034,ModificationType.MODIFY,1296,573,1062,40,33,157,1336,8,201,118,231,209,349,1561.8613899269646,2689.868337096228,4.597014925373134,12365.364892919973,686.9647162733319,0.896622779032076
329f56ecec5a9fcbfa160d4b467342a7c19ef2c0,/Users/sanika/Downloads/Master Thesis/repo_updated/pytest/doc/en/example/multipython.py,6689,ModificationType.MODIFY,72,33,56,0,4,12,72,1,1,1,1,2,2,0.0,2.0,0.5,1.0,0.05555555555555555,0.0006666666666666666
329f56ecec5a9fcbfa160d4b467342a7c19ef2c0,/Users/sanika/Downloads/Master Thesis/repo_updated/pytest/src/_pytest/python.py,6689,ModificationType.MODIFY,1454,835,1044,76,110,219,1530,17,275,158,296,292,454,2297.8910156145625,3718.180349731528,9.149090909090908,34017.97003608918,1889.8872242271766,1.2393934499105095
f760356578836fd888a1cd825460d8daa8808ea6,/Users/sanika/Downloads/Master Thesis/repo_updated/pytest/testing/code/test_source.py,1732,ModificationType.MODIFY,773,419,590,28,0,166,801,10,204,113,217,214,330,1598.3940507110585,2554.684105512378,5.318627450980392,13587.413012161423,754.8562784534124,0.8515613685041261
f760356578836fd888a1cd825460d8daa8808ea6,/Users/sanika/Downloads/Master Thesis/repo_updated/pytest/src/_pytest/_code/source.py,1732,ModificationType.MODIFY,421,273,302,44,34,57,465,17,81,59,107,98,166,583.0147185349103,1098.0418341231248,11.228395061728396,12329.247507839284,684.9581948799602,0.36601394470770826
f760356578836fd888a1cd825460d8daa8808ea6,/Users/sanika/Downloads/Master Thesis/repo_updated/pytest/testing/test_assertrewrite.py,5619,ModificationType.MODIFY,1660,832,1314,41,38,274,1701,20,312,209,395,332,604,2671.484054182769,5058.523816533542,12.66025641025641,64042.2085747035,3557.900476372417,1.6861746055111808
f760356578836fd888a1cd825460d8daa8808ea6,/Users/sanika/Downloads/Master Thesis/repo_updated/pytest/src/_pytest/assertion/rewrite.py,5619,ModificationType.MODIFY,1057,646,719,113,100,145,1170,18,215,134,248,233,382,1740.9201126876956,3004.119107257935,10.38139534883721,31186.948127440515,1732.608229302251,1.001373035752645
f760356578836fd888a1cd825460d8daa8808ea6,/Users/sanika/Downloads/Master Thesis/repo_updated/pytest/testing/test_compat.py,1418,ModificationType.MODIFY,207,111,150,11,0,50,218,5,26,19,36,31,55,133.82107314610522,272.4807970712782,3.4615384615384617,943.202759092886,52.40015328293811,0.09082693235709273
f760356578836fd888a1cd825460d8daa8808ea6,/Users/sanika/Downloads/Master Thesis/repo_updated/pytest/src/_pytest/compat.py,1418,ModificationType.MODIFY,410,198,237,31,55,97,441,11,63,38,72,74,110,414.62238298550506,683.0398702191846,6.285714285714286,4293.39346994916,238.52185944162,0.2276799567397282
f760356578836fd888a1cd825460d8daa8808ea6,/Users/sanika/Downloads/Master Thesis/repo_updated/pytest/src/_pytest/python_api.py,1970,ModificationType.MODIFY,757,253,292,73,244,162,830,13,61,38,67,74,105,409.8806939271703,651.9926033910399,7.139344262295082,4654.799652078654,258.5999806710363,0.2173308677970133
f760356578836fd888a1cd825460d8daa8808ea6,/Users/sanika/Downloads/Master Thesis/repo_updated/pytest/testing/test_recwarn.py,989,ModificationType.MODIFY,386,256,301,16,9,68,402,4,59,35,69,63,104,355.07593991234864,621.6371120439914,2.3389830508474576,1453.9986688486576,80.77770382492542,0.20721237068133044
f760356578836fd888a1cd825460d8daa8808ea6,/Users/sanika/Downloads/Master Thesis/repo_updated/pytest/src/_pytest/recwarn.py,989,ModificationType.MODIFY,264,131,164,11,41,46,275,6,38,22,40,44,62,214.93102051518318,338.48476035551244,3.1578947368421053,1068.899243227934,59.38329129044078,0.11282825345183747
c7a83a0f316c8bebd42df636b8d5cccfe948a72c,/Users/sanika/Downloads/Master Thesis/repo_updated/pytest/testing/test_capture.py,4986,ModificationType.MODIFY,1513,682,1277,25,13,200,1538,11,199,116,219,210,335,1557.7420472931965,2584.272248418151,6.052763819095477,15641.989563917903,868.9994202176613,0.8614240828060503
04d68fbc9e53ff01962ed5da8686ced276425c95,/Users/sanika/Downloads/Master Thesis/repo_updated/pytest/testing/code/test_code.py,5015,ModificationType.MODIFY,182,127,129,0,0,53,182,5,39,21,42,44,63,217.7403270100645,343.9441919741497,2.6923076923076925,926.003593776557,51.44464409869761,0.11464806399138323
04d68fbc9e53ff01962ed5da8686ced276425c95,/Users/sanika/Downloads/Master Thesis/repo_updated/pytest/src/_pytest/_code/code.py,5015,ModificationType.MODIFY,1165,710,800,67,119,181,1232,18,243,153,282,261,435,2000.7880884021665,3492.1391085079,10.444444444444445,36473.45291108251,2026.302939504584,1.1640463695026333
5bfe793fd5455c04049c4a564d1a6dc666cc647a,/Users/sanika/Downloads/Master Thesis/repo_updated/pytest/testing/code/test_excinfo.py,7106,ModificationType.MODIFY,1392,870,1177,35,17,170,1427,14,494,280,531,508,811,4473.796381311637,7289.823280972226,7.5242914979757085,54850.755334764704,3047.2641852647057,2.4299410936574084
5bfe793fd5455c04049c4a564d1a6dc666cc647a,/Users/sanika/Downloads/Master Thesis/repo_updated/pytest/testing/code/test_source.py,2878,ModificationType.MODIFY,773,419,590,28,0,166,801,10,204,113,217,214,330,1598.3940507110585,2554.684105512378,5.318627450980392,13587.413012161423,754.8562784534124,0.8515613685041261
e3ac44df360849809d8d156bd24827025238072c,/Users/sanika/Downloads/Master Thesis/repo_updated/pytest/testing/test_compat.py,1383,ModificationType.MODIFY,207,111,150,11,0,50,218,5,26,19,36,31,55,133.82107314610522,272.4807970712782,3.4615384615384617,943.202759092886,52.40015328293811,0.09082693235709273
e3ac44df360849809d8d156bd24827025238072c,/Users/sanika/Downloads/Master Thesis/repo_updated/pytest/src/_pytest/compat.py,1383,ModificationType.MODIFY,410,198,237,31,55,97,441,11,63,38,72,74,110,414.62238298550506,683.0398702191846,6.285714285714286,4293.39346994916,238.52185944162,0.2276799567397282
e3ac44df360849809d8d156bd24827025238072c,/Users/sanika/Downloads/Master Thesis/repo_updated/pytest/testing/python/fixtures.py,6261,ModificationType.MODIFY,4293,999,3693,19,54,507,4312,9,155,88,170,164,258,1156.3286078304877,1898.248417191466,4.935483870967742,9368.774446138526,520.4874692299181,0.6327494723971553
e3ac44df360849809d8d156bd24827025238072c,/Users/sanika/Downloads/Master Thesis/repo_updated/pytest/src/_pytest/fixtures.py,6261,ModificationType.MODIFY,1482,859,1002,125,135,219,1607,16,219,134,251,235,385,1766.678366052657,3032.459024427525,9.168949771689498,27804.464479682512,1544.692471093473,1.0108196748091751
e3ac44df360849809d8d156bd24827025238072c,/Users/sanika/Downloads/Master Thesis/repo_updated/pytest/doc/en/example/multipython.py,6734,ModificationType.MODIFY,72,33,56,0,4,12,72,1,1,1,1,2,2,0.0,2.0,0.5,1.0,0.05555555555555555,0.0006666666666666666
e3ac44df360849809d8d156bd24827025238072c,/Users/sanika/Downloads/Master Thesis/repo_updated/pytest/src/_pytest/python.py,6734,ModificationType.MODIFY,1454,835,1044,76,110,219,1530,17,275,158,296,292,454,2297.8910156145625,3718.180349731528,9.149090909090908,34017.97003608918,1889.8872242271766,1.2393934499105095
307add025b5464e87a55b49c6e5e4ce4c6373eee,/Users/sanika/Downloads/Master Thesis/repo_updated/pytest/testing/code/test_code.py,5010,ModificationType.MODIFY,182,127,129,0,0,53,182,5,39,21,42,44,63,217.7403270100645,343.9441919741497,2.6923076923076925,926.003593776557,51.44464409869761,0.11464806399138323
307add025b5464e87a55b49c6e5e4ce4c6373eee,/Users/sanika/Downloads/Master Thesis/repo_updated/pytest/src/_pytest/_code/code.py,5010,ModificationType.MODIFY,1165,710,800,67,119,181,1232,18,243,153,282,261,435,2000.7880884021665,3492.1391085079,10.444444444444445,36473.45291108251,2026.302939504584,1.1640463695026333
307add025b5464e87a55b49c6e5e4ce4c6373eee,/Users/sanika/Downloads/Master Thesis/repo_updated/pytest/testing/code/test_excinfo.py,6926,ModificationType.MODIFY,1392,870,1177,35,17,170,1427,14,494,280,531,508,811,4473.796381311637,7289.823280972226,7.5242914979757085,54850.755334764704,3047.2641852647057,2.4299410936574084
a649f157de8bc16fb99152b2f64e407f1e842692,/Users/sanika/Downloads/Master Thesis/repo_updated/pytest/testing/code/test_source.py,1754,ModificationType.MODIFY,773,419,590,28,0,166,801,10,204,113,217,214,330,1598.3940507110585,2554.684105512378,5.318627450980392,13587.413012161423,754.8562784534124,0.8515613685041261
a649f157de8bc16fb99152b2f64e407f1e842692,/Users/sanika/Downloads/Master Thesis/repo_updated/pytest/src/_pytest/_code/source.py,1754,ModificationType.MODIFY,421,273,302,44,34,57,465,17,81,59,107,98,166,583.0147185349103,1098.0418341231248,11.228395061728396,12329.247507839284,684.9581948799602,0.36601394470770826
562d4811d59e495bdfd3123a7f725d55462769ec,/Users/sanika/Downloads/Master Thesis/repo_updated/pytest/testing/test_compat.py,1495,ModificationType.MODIFY,207,111,150,11,0,50,218,5,26,19,36,31,55,133.82107314610522,272.4807970712782,3.4615384615384617,943.202759092886,52.40015328293811,0.09082693235709273
562d4811d59e495bdfd3123a7f725d55462769ec,/Users/sanika/Downloads/Master Thesis/repo_updated/pytest/src/_pytest/compat.py,1495,ModificationType.MODIFY,410,198,237,31,55,97,441,11,63,38,72,74,110,414.62238298550506,683.0398702191846,6.285714285714286,4293.39346994916,238.52185944162,0.2276799567397282
786d839db1e584e33f2f0543b6c16cdfeefe11ee,/Users/sanika/Downloads/Master Thesis/repo_updated/pytest/testing/test_cacheprovider.py,2063,ModificationType.MODIFY,996,429,845,24,10,117,1020,7,76,50,88,83,138,494.49397547611574,879.7554415258757,4.052631578947368,3565.3246840785487,198.07359355991937,0.29325181384195853
786d839db1e584e33f2f0543b6c16cdfeefe11ee,/Users/sanika/Downloads/Master Thesis/repo_updated/pytest/src/_pytest/cacheprovider.py,2063,ModificationType.MODIFY,456,277,329,12,42,72,468,13,85,50,97,98,147,592.903945907539,972.3623470849358,7.41764705882353,7212.640703965318,400.70226133140653,0.32412078236164527
4b7148f9a4a48a41ebc745902d486efe23663dff,/Users/sanika/Downloads/Master Thesis/repo_updated/pytest/testing/test_cacheprovider.py,2063,ModificationType.MODIFY,996,429,845,24,10,117,1020,7,76,50,88,83,138,494.49397547611574,879.7554415258757,4.052631578947368,3565.3246840785487,198.07359355991937,0.29325181384195853
4b7148f9a4a48a41ebc745902d486efe23663dff,/Users/sanika/Downloads/Master Thesis/repo_updated/pytest/src/_pytest/cacheprovider.py,2063,ModificationType.MODIFY,456,277,329,12,42,72,468,13,85,50,97,98,147,592.903945907539,972.3623470849358,7.41764705882353,7212.640703965318,400.70226133140653,0.32412078236164527
b1a597ab0292a1360a750f7df8cd9bf498e2cd72,/Users/sanika/Downloads/Master Thesis/repo_updated/pytest/testing/example_scripts/collect/package_infinite_recursion/__init__.pyi,5079,ModificationType.MODIFY,0,0,0,0,0,0,0,0,0,0,0,0,0,0,0,0,0,0.0,0.0
b1a597ab0292a1360a750f7df8cd9bf498e2cd72,/Users/sanika/Downloads/Master Thesis/repo_updated/pytest/testing/example_scripts/collect/package_infinite_recursion/tests/__init__.py,5079,ModificationType.MODIFY,0,0,0,0,0,0,0,0,0,0,0,0,0,0,0,0,0,0.0,0.0
b1a597ab0292a1360a750f7df8cd9bf498e2cd72,/Users/sanika/Downloads/Master Thesis/repo_updated/pytest/testing/example_scripts/collect/collect_init_tests/tests/__init__.py,5079,ModificationType.MODIFY,2,2,2,0,0,0,2,0,0,0,0,0,0,0,0,0,0,0.0,0.0
b1a597ab0292a1360a750f7df8cd9bf498e2cd72,/Users/sanika/Downloads/Master Thesis/repo_updated/pytest/testing/example_scripts/collect/package_init_given_as_arg/pkg/__init__.py,5079,ModificationType.MODIFY,0,0,0,0,0,0,0,0,0,0,0,0,0,0,0,0,0,0.0,0.0
b1a597ab0292a1360a750f7df8cd9bf498e2cd72,/Users/sanika/Downloads/Master Thesis/repo_updated/pytest/testing/example_scripts/conftest_usageerror/__init__.pyi,5079,ModificationType.MODIFY,0,0,0,0,0,0,0,0,0,0,0,0,0,0,0,0,0,0.0,0.0
b1a597ab0292a1360a750f7df8cd9bf498e2cd72,/Users/sanika/Downloads/Master Thesis/repo_updated/pytest/testing/example_scripts/marks/marks_considered_keywords/__init__.pyi,5079,ModificationType.MODIFY,0,0,0,0,0,0,0,0,0,0,0,0,0,0,0,0,0,0.0,0.0
b1a597ab0292a1360a750f7df8cd9bf498e2cd72,/Users/sanika/Downloads/Master Thesis/repo_updated/pytest/testing/example_scripts/config/collect_pytest_prefix/__init__.pyi,5079,ModificationType.MODIFY,0,0,0,0,0,0,0,0,0,0,0,0,0,0,0,0,0,0.0,0.0
b1a597ab0292a1360a750f7df8cd9bf498e2cd72,/Users/sanika/Downloads/Master Thesis/repo_updated/pytest/testing/example_scripts/issue88_initial_file_multinodes/__init__.pyi,5079,ModificationType.MODIFY,0,0,0,0,0,0,0,0,0,0,0,0,0,0,0,0,0,0.0,0.0
b1a597ab0292a1360a750f7df8cd9bf498e2cd72,/Users/sanika/Downloads/Master Thesis/repo_updated/pytest/testing/example_scripts/fixtures/fill_fixtures/test_extend_fixture_conftest_conftest/__init__.pyi,5079,ModificationType.MODIFY,0,0,0,0,0,0,0,0,0,0,0,0,0,0,0,0,0,0.0,0.0
b1a597ab0292a1360a750f7df8cd9bf498e2cd72,/Users/sanika/Downloads/Master Thesis/repo_updated/pytest/testing/example_scripts/fixtures/fill_fixtures/test_extend_fixture_conftest_conftest/pkg/__init__.py,5079,ModificationType.MODIFY,0,0,0,0,0,0,0,0,0,0,0,0,0,0,0,0,0,0.0,0.0
b1a597ab0292a1360a750f7df8cd9bf498e2cd72,/Users/sanika/Downloads/Master Thesis/repo_updated/pytest/testing/example_scripts/fixtures/fill_fixtures/test_extend_fixture_conftest_module/__init__.pyi,5079,ModificationType.MODIFY,0,0,0,0,0,0,0,0,0,0,0,0,0,0,0,0,0,0.0,0.0
b1a597ab0292a1360a750f7df8cd9bf498e2cd72,/Users/sanika/Downloads/Master Thesis/repo_updated/pytest/testing/example_scripts/fixtures/fill_fixtures/test_conftest_funcargs_only_available_in_subdir/sub1/__init__.py,5079,ModificationType.MODIFY,0,0,0,0,0,0,0,0,0,0,0,0,0,0,0,0,0,0.0,0.0
b1a597ab0292a1360a750f7df8cd9bf498e2cd72,/Users/sanika/Downloads/Master Thesis/repo_updated/pytest/testing/example_scripts/fixtures/fill_fixtures/test_conftest_funcargs_only_available_in_subdir/sub2/__init__.py,5079,ModificationType.MODIFY,0,0,0,0,0,0,0,0,0,0,0,0,0,0,0,0,0,0.0,0.0
b1a597ab0292a1360a750f7df8cd9bf498e2cd72,/Users/sanika/Downloads/Master Thesis/repo_updated/pytest/testing/example_scripts/fixtures/custom_item/__init__.pyi,5079,ModificationType.MODIFY,0,0,0,0,0,0,0,0,0,0,0,0,0,0,0,0,0,0.0,0.0
b1a597ab0292a1360a750f7df8cd9bf498e2cd72,/Users/sanika/Downloads/Master Thesis/repo_updated/pytest/testing/example_scripts/fixtures/custom_item/foo/__init__.py,5079,ModificationType.MODIFY,0,0,0,0,0,0,0,0,0,0,0,0,0,0,0,0,0,0.0,0.0
b1a597ab0292a1360a750f7df8cd9bf498e2cd72,/Users/sanika/Downloads/Master Thesis/repo_updated/pytest/doc/en/example/nonpython/__init__.py,5079,ModificationType.MODIFY,0,0,0,0,0,0,0,0,0,0,0,0,0,0,0,0,0,0.0,0.0
b1a597ab0292a1360a750f7df8cd9bf498e2cd72,/Users/sanika/Downloads/Master Thesis/repo_updated/pytest/src/pytest/__init__.py,5079,ModificationType.MODIFY,99,48,90,1,3,5,100,0,0,0,0,0,0,0,0,0,0,0.0,0.0
b1a597ab0292a1360a750f7df8cd9bf498e2cd72,/Users/sanika/Downloads/Master Thesis/repo_updated/pytest/src/_pytest/__init__.py,5079,ModificationType.MODIFY,8,5,5,2,0,1,10,0,0,0,0,0,0,0,0,0,0,0.0,0.0
b1a597ab0292a1360a750f7df8cd9bf498e2cd72,/Users/sanika/Downloads/Master Thesis/repo_updated/pytest/src/_pytest/config/__init__.py,5079,ModificationType.MODIFY,1217,716,841,84,126,174,1301,14,185,118,215,199,333,1446.608539104324,2542.995998641035,8.135135135135135,20687.616097052745,1149.3120053918192,0.847665332880345
b1a597ab0292a1360a750f7df8cd9bf498e2cd72,/Users/sanika/Downloads/Master Thesis/repo_updated/pytest/src/_pytest/mark/__init__.py,5079,ModificationType.MODIFY,160,89,115,0,13,31,160,7,15,11,17,22,28,78.25484338853101,124.86408532184433,3.966666666666667,495.2942051099825,27.51634472833236,0.04162136177394811
b1a597ab0292a1360a750f7df8cd9bf498e2cd72,/Users/sanika/Downloads/Master Thesis/repo_updated/pytest/src/_pytest/_code/__init__.py,5079,ModificationType.MODIFY,10,10,9,9,0,0,19,0,0,0,0,0,0,0,0,0,0,0.0,0.0
b1a597ab0292a1360a750f7df8cd9bf498e2cd72,/Users/sanika/Downloads/Master Thesis/repo_updated/pytest/src/_pytest/assertion/__init__.py,5079,ModificationType.MODIFY,173,84,99,8,29,36,181,5,12,7,13,17,20,54.62919048309069,81.7492568250068,2.7083333333333335,221.4042372343934,12.300235401910745,0.027249752275002266
b1a597ab0292a1360a750f7df8cd9bf498e2cd72,/Users/sanika/Downloads/Master Thesis/repo_updated/pytest/src/_pytest/_io/__init__.py,5079,ModificationType.MODIFY,3,1,1,3,0,0,6,0,0,0,0,0,0,0,0,0,0,0.0,0.0
54a954514b5a02b4858707ef653a1a204cd05509,/Users/sanika/Downloads/Master Thesis/repo_updated/pytest/src/_pytest/config/argparsing.py,2328,ModificationType.MODIFY,463,295,324,28,62,57,491,12,134,82,154,146,236,989.8755015299953,1696.7985958956842,6.895522388059701,11700.312706026956,650.0173725570531,0.565599531965228
54a954514b5a02b4858707ef653a1a204cd05509,/Users/sanika/Downloads/Master Thesis/repo_updated/pytest/testing/test_pytester.py,6346,ModificationType.MODIFY,722,423,573,19,0,135,741,12,172,101,199,184,300,1320.3370878174146,2257.068586817104,6.941860465116279,15668.255189881524,870.4586216600846,0.7523561956057013
54a954514b5a02b4858707ef653a1a204cd05509,/Users/sanika/Downloads/Master Thesis/repo_updated/pytest/src/_pytest/pytester.py,6346,ModificationType.MODIFY,1508,847,911,44,250,301,1552,14,148,88,169,162,257,1120.302067021891,1886.3414507413484,7.993243243243243,15077.986055587939,837.6658919771077,0.6287804835804495
54a954514b5a02b4858707ef653a1a204cd05509,/Users/sanika/Downloads/Master Thesis/repo_updated/pytest/testing/python/fixtures.py,8005,ModificationType.MODIFY,4293,999,3693,19,54,507,4312,9,155,88,170,164,258,1156.3286078304877,1898.248417191466,4.935483870967742,9368.774446138526,520.4874692299181,0.6327494723971553
54a954514b5a02b4858707ef653a1a204cd05509,/Users/sanika/Downloads/Master Thesis/repo_updated/pytest/src/_pytest/fixtures.py,8005,ModificationType.MODIFY,1482,859,1002,125,135,219,1607,16,219,134,251,235,385,1766.678366052657,3032.459024427525,9.168949771689498,27804.464479682512,1544.692471093473,1.0108196748091751
54a954514b5a02b4858707ef653a1a204cd05509,/Users/sanika/Downloads/Master Thesis/repo_updated/pytest/testing/python/raises.py,921,ModificationType.MODIFY,256,139,192,9,7,47,265,4,23,12,24,27,36,112.0419249893113,171.1759500778849,2.0869565217391304,357.2367653799337,19.846486965551872,0.05705865002596163
54a954514b5a02b4858707ef653a1a204cd05509,/Users/sanika/Downloads/Master Thesis/repo_updated/pytest/testing/test_collection.py,4954,ModificationType.MODIFY,1296,573,1062,40,33,157,1336,8,201,118,231,209,349,1561.8613899269646,2689.868337096228,4.597014925373134,12365.364892919973,686.9647162733319,0.896622779032076
54a954514b5a02b4858707ef653a1a204cd05509,/Users/sanika/Downloads/Master Thesis/repo_updated/pytest/testing/test_mark.py,3199,ModificationType.MODIFY,1020,354,843,12,15,144,1032,8,134,77,144,142,221,970.8559515213415,1580.0941134105349,4.298507462686567,6792.0463382422995,377.3359076801278,0.5266980378035117
54a954514b5a02b4858707ef653a1a204cd05509,/Users/sanika/Downloads/Master Thesis/repo_updated/pytest/testing/test_skipping.py,3073,ModificationType.MODIFY,1178,367,1042,6,15,115,1184,9,94,51,95,103,146,644.6606770706787,976.22907696875,4.547872340425532,4439.7652170653255,246.65362317029587,0.32540969232291667
54a954514b5a02b4858707ef653a1a204cd05509,/Users/sanika/Downloads/Master Thesis/repo_updated/pytest/testing/test_tmpdir.py,1861,ModificationType.MODIFY,442,244,305,14,16,103,456,11,68,45,75,79,120,452.0012210100334,756.4536897812524,6.0661764705882355,4588.781574040686,254.932309668927,0.2521512299270841
54a954514b5a02b4858707ef653a1a204cd05509,/Users/sanika/Downloads/Master Thesis/repo_updated/pytest/testing/test_unittest.py,2042,ModificationType.MODIFY,1098,241,925,5,10,155,1103,7,46,25,49,53,74,273.7353344330258,423.8661136376768,3.7282608695652173,1580.2834454100341,87.79352474500189,0.14128870454589226
e3796047c1b09f58d14ee60d669b1258479d3c76,/Users/sanika/Downloads/Master Thesis/repo_updated/pytest/testing/example_scripts/collect/package_infinite_recursion/__init__.pyi,5079,ModificationType.MODIFY,0,0,0,0,0,0,0,0,0,0,0,0,0,0,0,0,0,0.0,0.0
e3796047c1b09f58d14ee60d669b1258479d3c76,/Users/sanika/Downloads/Master Thesis/repo_updated/pytest/testing/example_scripts/collect/package_infinite_recursion/tests/__init__.py,5079,ModificationType.MODIFY,0,0,0,0,0,0,0,0,0,0,0,0,0,0,0,0,0,0.0,0.0
e3796047c1b09f58d14ee60d669b1258479d3c76,/Users/sanika/Downloads/Master Thesis/repo_updated/pytest/testing/example_scripts/collect/collect_init_tests/tests/__init__.py,5079,ModificationType.MODIFY,2,2,2,0,0,0,2,0,0,0,0,0,0,0,0,0,0,0.0,0.0
e3796047c1b09f58d14ee60d669b1258479d3c76,/Users/sanika/Downloads/Master Thesis/repo_updated/pytest/testing/example_scripts/collect/package_init_given_as_arg/pkg/__init__.py,5079,ModificationType.MODIFY,0,0,0,0,0,0,0,0,0,0,0,0,0,0,0,0,0,0.0,0.0
e3796047c1b09f58d14ee60d669b1258479d3c76,/Users/sanika/Downloads/Master Thesis/repo_updated/pytest/testing/example_scripts/conftest_usageerror/__init__.pyi,5079,ModificationType.MODIFY,0,0,0,0,0,0,0,0,0,0,0,0,0,0,0,0,0,0.0,0.0
e3796047c1b09f58d14ee60d669b1258479d3c76,/Users/sanika/Downloads/Master Thesis/repo_updated/pytest/testing/example_scripts/marks/marks_considered_keywords/__init__.pyi,5079,ModificationType.MODIFY,0,0,0,0,0,0,0,0,0,0,0,0,0,0,0,0,0,0.0,0.0
e3796047c1b09f58d14ee60d669b1258479d3c76,/Users/sanika/Downloads/Master Thesis/repo_updated/pytest/testing/example_scripts/config/collect_pytest_prefix/__init__.pyi,5079,ModificationType.MODIFY,0,0,0,0,0,0,0,0,0,0,0,0,0,0,0,0,0,0.0,0.0
e3796047c1b09f58d14ee60d669b1258479d3c76,/Users/sanika/Downloads/Master Thesis/repo_updated/pytest/testing/example_scripts/issue88_initial_file_multinodes/__init__.pyi,5079,ModificationType.MODIFY,0,0,0,0,0,0,0,0,0,0,0,0,0,0,0,0,0,0.0,0.0
e3796047c1b09f58d14ee60d669b1258479d3c76,/Users/sanika/Downloads/Master Thesis/repo_updated/pytest/testing/example_scripts/fixtures/fill_fixtures/test_extend_fixture_conftest_conftest/__init__.pyi,5079,ModificationType.MODIFY,0,0,0,0,0,0,0,0,0,0,0,0,0,0,0,0,0,0.0,0.0
e3796047c1b09f58d14ee60d669b1258479d3c76,/Users/sanika/Downloads/Master Thesis/repo_updated/pytest/testing/example_scripts/fixtures/fill_fixtures/test_extend_fixture_conftest_conftest/pkg/__init__.py,5079,ModificationType.MODIFY,0,0,0,0,0,0,0,0,0,0,0,0,0,0,0,0,0,0.0,0.0
e3796047c1b09f58d14ee60d669b1258479d3c76,/Users/sanika/Downloads/Master Thesis/repo_updated/pytest/testing/example_scripts/fixtures/fill_fixtures/test_extend_fixture_conftest_module/__init__.pyi,5079,ModificationType.MODIFY,0,0,0,0,0,0,0,0,0,0,0,0,0,0,0,0,0,0.0,0.0
e3796047c1b09f58d14ee60d669b1258479d3c76,/Users/sanika/Downloads/Master Thesis/repo_updated/pytest/testing/example_scripts/fixtures/fill_fixtures/test_conftest_funcargs_only_available_in_subdir/sub1/__init__.py,5079,ModificationType.MODIFY,0,0,0,0,0,0,0,0,0,0,0,0,0,0,0,0,0,0.0,0.0
e3796047c1b09f58d14ee60d669b1258479d3c76,/Users/sanika/Downloads/Master Thesis/repo_updated/pytest/testing/example_scripts/fixtures/fill_fixtures/test_conftest_funcargs_only_available_in_subdir/sub2/__init__.py,5079,ModificationType.MODIFY,0,0,0,0,0,0,0,0,0,0,0,0,0,0,0,0,0,0.0,0.0
e3796047c1b09f58d14ee60d669b1258479d3c76,/Users/sanika/Downloads/Master Thesis/repo_updated/pytest/testing/example_scripts/fixtures/custom_item/__init__.pyi,5079,ModificationType.MODIFY,0,0,0,0,0,0,0,0,0,0,0,0,0,0,0,0,0,0.0,0.0
e3796047c1b09f58d14ee60d669b1258479d3c76,/Users/sanika/Downloads/Master Thesis/repo_updated/pytest/testing/example_scripts/fixtures/custom_item/foo/__init__.py,5079,ModificationType.MODIFY,0,0,0,0,0,0,0,0,0,0,0,0,0,0,0,0,0,0.0,0.0
e3796047c1b09f58d14ee60d669b1258479d3c76,/Users/sanika/Downloads/Master Thesis/repo_updated/pytest/doc/en/example/nonpython/__init__.py,5079,ModificationType.MODIFY,0,0,0,0,0,0,0,0,0,0,0,0,0,0,0,0,0,0.0,0.0
e3796047c1b09f58d14ee60d669b1258479d3c76,/Users/sanika/Downloads/Master Thesis/repo_updated/pytest/src/pytest/__init__.py,5079,ModificationType.MODIFY,99,48,90,1,3,5,100,0,0,0,0,0,0,0,0,0,0,0.0,0.0
e3796047c1b09f58d14ee60d669b1258479d3c76,/Users/sanika/Downloads/Master Thesis/repo_updated/pytest/src/_pytest/__init__.py,5079,ModificationType.MODIFY,8,5,5,2,0,1,10,0,0,0,0,0,0,0,0,0,0,0.0,0.0
e3796047c1b09f58d14ee60d669b1258479d3c76,/Users/sanika/Downloads/Master Thesis/repo_updated/pytest/src/_pytest/config/__init__.py,5079,ModificationType.MODIFY,1217,716,841,84,126,174,1301,14,185,118,215,199,333,1446.608539104324,2542.995998641035,8.135135135135135,20687.616097052745,1149.3120053918192,0.847665332880345
e3796047c1b09f58d14ee60d669b1258479d3c76,/Users/sanika/Downloads/Master Thesis/repo_updated/pytest/src/_pytest/mark/__init__.py,5079,ModificationType.MODIFY,160,89,115,0,13,31,160,7,15,11,17,22,28,78.25484338853101,124.86408532184433,3.966666666666667,495.2942051099825,27.51634472833236,0.04162136177394811
e3796047c1b09f58d14ee60d669b1258479d3c76,/Users/sanika/Downloads/Master Thesis/repo_updated/pytest/src/_pytest/_code/__init__.py,5079,ModificationType.MODIFY,10,10,9,9,0,0,19,0,0,0,0,0,0,0,0,0,0,0.0,0.0
e3796047c1b09f58d14ee60d669b1258479d3c76,/Users/sanika/Downloads/Master Thesis/repo_updated/pytest/src/_pytest/assertion/__init__.py,5079,ModificationType.MODIFY,173,84,99,8,29,36,181,5,12,7,13,17,20,54.62919048309069,81.7492568250068,2.7083333333333335,221.4042372343934,12.300235401910745,0.027249752275002266
e3796047c1b09f58d14ee60d669b1258479d3c76,/Users/sanika/Downloads/Master Thesis/repo_updated/pytest/src/_pytest/_io/__init__.py,5079,ModificationType.MODIFY,3,1,1,3,0,0,6,0,0,0,0,0,0,0,0,0,0,0.0,0.0
e3796047c1b09f58d14ee60d669b1258479d3c76,/Users/sanika/Downloads/Master Thesis/repo_updated/pytest/src/_pytest/config/argparsing.py,2328,ModificationType.MODIFY,463,295,324,28,62,57,491,12,134,82,154,146,236,989.8755015299953,1696.7985958956842,6.895522388059701,11700.312706026956,650.0173725570531,0.565599531965228
e3796047c1b09f58d14ee60d669b1258479d3c76,/Users/sanika/Downloads/Master Thesis/repo_updated/pytest/testing/test_pytester.py,6346,ModificationType.MODIFY,722,423,573,19,0,135,741,12,172,101,199,184,300,1320.3370878174146,2257.068586817104,6.941860465116279,15668.255189881524,870.4586216600846,0.7523561956057013
e3796047c1b09f58d14ee60d669b1258479d3c76,/Users/sanika/Downloads/Master Thesis/repo_updated/pytest/src/_pytest/pytester.py,6346,ModificationType.MODIFY,1508,847,911,44,250,301,1552,14,148,88,169,162,257,1120.302067021891,1886.3414507413484,7.993243243243243,15077.986055587939,837.6658919771077,0.6287804835804495
e3796047c1b09f58d14ee60d669b1258479d3c76,/Users/sanika/Downloads/Master Thesis/repo_updated/pytest/testing/python/fixtures.py,8005,ModificationType.MODIFY,4293,999,3693,19,54,507,4312,9,155,88,170,164,258,1156.3286078304877,1898.248417191466,4.935483870967742,9368.774446138526,520.4874692299181,0.6327494723971553
e3796047c1b09f58d14ee60d669b1258479d3c76,/Users/sanika/Downloads/Master Thesis/repo_updated/pytest/src/_pytest/fixtures.py,8005,ModificationType.MODIFY,1482,859,1002,125,135,219,1607,16,219,134,251,235,385,1766.678366052657,3032.459024427525,9.168949771689498,27804.464479682512,1544.692471093473,1.0108196748091751
e3796047c1b09f58d14ee60d669b1258479d3c76,/Users/sanika/Downloads/Master Thesis/repo_updated/pytest/testing/python/raises.py,921,ModificationType.MODIFY,256,139,192,9,7,47,265,4,23,12,24,27,36,112.0419249893113,171.1759500778849,2.0869565217391304,357.2367653799337,19.846486965551872,0.05705865002596163
e3796047c1b09f58d14ee60d669b1258479d3c76,/Users/sanika/Downloads/Master Thesis/repo_updated/pytest/testing/test_collection.py,4954,ModificationType.MODIFY,1296,573,1062,40,33,157,1336,8,201,118,231,209,349,1561.8613899269646,2689.868337096228,4.597014925373134,12365.364892919973,686.9647162733319,0.896622779032076
e3796047c1b09f58d14ee60d669b1258479d3c76,/Users/sanika/Downloads/Master Thesis/repo_updated/pytest/testing/test_mark.py,3199,ModificationType.MODIFY,1020,354,843,12,15,144,1032,8,134,77,144,142,221,970.8559515213415,1580.0941134105349,4.298507462686567,6792.0463382422995,377.3359076801278,0.5266980378035117
e3796047c1b09f58d14ee60d669b1258479d3c76,/Users/sanika/Downloads/Master Thesis/repo_updated/pytest/testing/test_skipping.py,3073,ModificationType.MODIFY,1178,367,1042,6,15,115,1184,9,94,51,95,103,146,644.6606770706787,976.22907696875,4.547872340425532,4439.7652170653255,246.65362317029587,0.32540969232291667
e3796047c1b09f58d14ee60d669b1258479d3c76,/Users/sanika/Downloads/Master Thesis/repo_updated/pytest/testing/test_tmpdir.py,1861,ModificationType.MODIFY,442,244,305,14,16,103,456,11,68,45,75,79,120,452.0012210100334,756.4536897812524,6.0661764705882355,4588.781574040686,254.932309668927,0.2521512299270841
e3796047c1b09f58d14ee60d669b1258479d3c76,/Users/sanika/Downloads/Master Thesis/repo_updated/pytest/testing/test_unittest.py,2042,ModificationType.MODIFY,1098,241,925,5,10,155,1103,7,46,25,49,53,74,273.7353344330258,423.8661136376768,3.7282608695652173,1580.2834454100341,87.79352474500189,0.14128870454589226
eaa34a9df0fa341c1b21bd3b232928812e6e8a06,/Users/sanika/Downloads/Master Thesis/repo_updated/pytest/testing/code/test_code.py,5483,ModificationType.MODIFY,182,127,129,0,0,53,182,5,39,21,42,44,63,217.7403270100645,343.9441919741497,2.6923076923076925,926.003593776557,51.44464409869761,0.11464806399138323
eaa34a9df0fa341c1b21bd3b232928812e6e8a06,/Users/sanika/Downloads/Master Thesis/repo_updated/pytest/src/_pytest/_code/code.py,5483,ModificationType.MODIFY,1165,710,800,67,119,181,1232,18,243,153,282,261,435,2000.7880884021665,3492.1391085079,10.444444444444445,36473.45291108251,2026.302939504584,1.1640463695026333
eaa34a9df0fa341c1b21bd3b232928812e6e8a06,/Users/sanika/Downloads/Master Thesis/repo_updated/pytest/testing/code/test_code.py,1010,ModificationType.MODIFY,182,127,129,0,0,53,182,5,39,21,42,44,63,217.7403270100645,343.9441919741497,2.6923076923076925,926.003593776557,51.44464409869761,0.11464806399138323
eaa34a9df0fa341c1b21bd3b232928812e6e8a06,/Users/sanika/Downloads/Master Thesis/repo_updated/pytest/testing/code/test_excinfo.py,6943,ModificationType.MODIFY,1392,870,1177,35,17,170,1427,14,494,280,531,508,811,4473.796381311637,7289.823280972226,7.5242914979757085,54850.755334764704,3047.2641852647057,2.4299410936574084
eaa34a9df0fa341c1b21bd3b232928812e6e8a06,/Users/sanika/Downloads/Master Thesis/repo_updated/pytest/testing/code/test_source.py,3088,ModificationType.MODIFY,773,419,590,28,0,166,801,10,204,113,217,214,330,1598.3940507110585,2554.684105512378,5.318627450980392,13587.413012161423,754.8562784534124,0.8515613685041261
1b4623a6d16a17d228deda23d4242d944dff2397,/Users/sanika/Downloads/Master Thesis/repo_updated/pytest/testing/test_cacheprovider.py,3863,ModificationType.MODIFY,996,429,845,24,10,117,1020,7,76,50,88,83,138,494.49397547611574,879.7554415258757,4.052631578947368,3565.3246840785487,198.07359355991937,0.29325181384195853
b9a3ba1fe8a02b5093ad72785ab5d908e18e228c,/Users/sanika/Downloads/Master Thesis/repo_updated/pytest/testing/test_cacheprovider.py,3873,ModificationType.MODIFY,996,429,845,24,10,117,1020,7,76,50,88,83,138,494.49397547611574,879.7554415258757,4.052631578947368,3565.3246840785487,198.07359355991937,0.29325181384195853
fa578d7329593ceb9405189aac1de23b6354c2dd,/Users/sanika/Downloads/Master Thesis/repo_updated/pytest/testing/code/test_code.py,5483,ModificationType.MODIFY,182,127,129,0,0,53,182,5,39,21,42,44,63,217.7403270100645,343.9441919741497,2.6923076923076925,926.003593776557,51.44464409869761,0.11464806399138323
fa578d7329593ceb9405189aac1de23b6354c2dd,/Users/sanika/Downloads/Master Thesis/repo_updated/pytest/src/_pytest/_code/code.py,5483,ModificationType.MODIFY,1165,710,800,67,119,181,1232,18,243,153,282,261,435,2000.7880884021665,3492.1391085079,10.444444444444445,36473.45291108251,2026.302939504584,1.1640463695026333
fa578d7329593ceb9405189aac1de23b6354c2dd,/Users/sanika/Downloads/Master Thesis/repo_updated/pytest/testing/code/test_source.py,1754,ModificationType.MODIFY,773,419,590,28,0,166,801,10,204,113,217,214,330,1598.3940507110585,2554.684105512378,5.318627450980392,13587.413012161423,754.8562784534124,0.8515613685041261
fa578d7329593ceb9405189aac1de23b6354c2dd,/Users/sanika/Downloads/Master Thesis/repo_updated/pytest/src/_pytest/_code/source.py,1754,ModificationType.MODIFY,421,273,302,44,34,57,465,17,81,59,107,98,166,583.0147185349103,1098.0418341231248,11.228395061728396,12329.247507839284,684.9581948799602,0.36601394470770826
fa578d7329593ceb9405189aac1de23b6354c2dd,/Users/sanika/Downloads/Master Thesis/repo_updated/pytest/testing/test_assertrewrite.py,5619,ModificationType.MODIFY,1660,832,1314,41,38,274,1701,20,312,209,395,332,604,2671.484054182769,5058.523816533542,12.66025641025641,64042.2085747035,3557.900476372417,1.6861746055111808
fa578d7329593ceb9405189aac1de23b6354c2dd,/Users/sanika/Downloads/Master Thesis/repo_updated/pytest/src/_pytest/assertion/rewrite.py,5619,ModificationType.MODIFY,1057,646,719,113,100,145,1170,18,215,134,248,233,382,1740.9201126876956,3004.119107257935,10.38139534883721,31186.948127440515,1732.608229302251,1.001373035752645
fa578d7329593ceb9405189aac1de23b6354c2dd,/Users/sanika/Downloads/Master Thesis/repo_updated/pytest/testing/test_compat.py,1495,ModificationType.MODIFY,207,111,150,11,0,50,218,5,26,19,36,31,55,133.82107314610522,272.4807970712782,3.4615384615384617,943.202759092886,52.40015328293811,0.09082693235709273
fa578d7329593ceb9405189aac1de23b6354c2dd,/Users/sanika/Downloads/Master Thesis/repo_updated/pytest/src/_pytest/compat.py,1495,ModificationType.MODIFY,410,198,237,31,55,97,441,11,63,38,72,74,110,414.62238298550506,683.0398702191846,6.285714285714286,4293.39346994916,238.52185944162,0.2276799567397282
fa578d7329593ceb9405189aac1de23b6354c2dd,/Users/sanika/Downloads/Master Thesis/repo_updated/pytest/testing/python/fixtures.py,6261,ModificationType.MODIFY,4293,999,3693,19,54,507,4312,9,155,88,170,164,258,1156.3286078304877,1898.248417191466,4.935483870967742,9368.774446138526,520.4874692299181,0.6327494723971553
fa578d7329593ceb9405189aac1de23b6354c2dd,/Users/sanika/Downloads/Master Thesis/repo_updated/pytest/src/_pytest/fixtures.py,6261,ModificationType.MODIFY,1482,859,1002,125,135,219,1607,16,219,134,251,235,385,1766.678366052657,3032.459024427525,9.168949771689498,27804.464479682512,1544.692471093473,1.0108196748091751
fa578d7329593ceb9405189aac1de23b6354c2dd,/Users/sanika/Downloads/Master Thesis/repo_updated/pytest/doc/en/example/multipython.py,6734,ModificationType.MODIFY,72,33,56,0,4,12,72,1,1,1,1,2,2,0.0,2.0,0.5,1.0,0.05555555555555555,0.0006666666666666666
fa578d7329593ceb9405189aac1de23b6354c2dd,/Users/sanika/Downloads/Master Thesis/repo_updated/pytest/src/_pytest/python.py,6734,ModificationType.MODIFY,1454,835,1044,76,110,219,1530,17,275,158,296,292,454,2297.8910156145625,3718.180349731528,9.149090909090908,34017.97003608918,1889.8872242271766,1.2393934499105095
fa578d7329593ceb9405189aac1de23b6354c2dd,/Users/sanika/Downloads/Master Thesis/repo_updated/pytest/src/_pytest/python_api.py,1970,ModificationType.MODIFY,757,253,292,73,244,162,830,13,61,38,67,74,105,409.8806939271703,651.9926033910399,7.139344262295082,4654.799652078654,258.5999806710363,0.2173308677970133
fa578d7329593ceb9405189aac1de23b6354c2dd,/Users/sanika/Downloads/Master Thesis/repo_updated/pytest/testing/test_recwarn.py,989,ModificationType.MODIFY,386,256,301,16,9,68,402,4,59,35,69,63,104,355.07593991234864,621.6371120439914,2.3389830508474576,1453.9986688486576,80.77770382492542,0.20721237068133044
fa578d7329593ceb9405189aac1de23b6354c2dd,/Users/sanika/Downloads/Master Thesis/repo_updated/pytest/src/_pytest/recwarn.py,989,ModificationType.MODIFY,264,131,164,11,41,46,275,6,38,22,40,44,62,214.93102051518318,338.48476035551244,3.1578947368421053,1068.899243227934,59.38329129044078,0.11282825345183747
fa578d7329593ceb9405189aac1de23b6354c2dd,/Users/sanika/Downloads/Master Thesis/repo_updated/pytest/testing/code/test_code.py,1010,ModificationType.MODIFY,182,127,129,0,0,53,182,5,39,21,42,44,63,217.7403270100645,343.9441919741497,2.6923076923076925,926.003593776557,51.44464409869761,0.11464806399138323
fa578d7329593ceb9405189aac1de23b6354c2dd,/Users/sanika/Downloads/Master Thesis/repo_updated/pytest/testing/code/test_excinfo.py,6943,ModificationType.MODIFY,1392,870,1177,35,17,170,1427,14,494,280,531,508,811,4473.796381311637,7289.823280972226,7.5242914979757085,54850.755334764704,3047.2641852647057,2.4299410936574084
fa578d7329593ceb9405189aac1de23b6354c2dd,/Users/sanika/Downloads/Master Thesis/repo_updated/pytest/testing/code/test_source.py,3088,ModificationType.MODIFY,773,419,590,28,0,166,801,10,204,113,217,214,330,1598.3940507110585,2554.684105512378,5.318627450980392,13587.413012161423,754.8562784534124,0.8515613685041261
fa578d7329593ceb9405189aac1de23b6354c2dd,/Users/sanika/Downloads/Master Thesis/repo_updated/pytest/testing/test_capture.py,4986,ModificationType.MODIFY,1513,682,1277,25,13,200,1538,11,199,116,219,210,335,1557.7420472931965,2584.272248418151,6.052763819095477,15641.989563917903,868.9994202176613,0.8614240828060503
bac6eebfff8f1cd21736dbf0d367bf4ca97da0d9,/Users/sanika/Downloads/Master Thesis/repo_updated/pytest/testing/test_cacheprovider.py,3873,ModificationType.MODIFY,996,429,845,24,10,117,1020,7,76,50,88,83,138,494.49397547611574,879.7554415258757,4.052631578947368,3565.3246840785487,198.07359355991937,0.29325181384195853
a2d48332fc767b06d024c7988a7a29d221d83ec4,/Users/sanika/Downloads/Master Thesis/repo_updated/pytest/doc/en/example/multipython.py,6748,ModificationType.MODIFY,72,33,56,0,4,12,72,1,1,1,1,2,2,0.0,2.0,0.5,1.0,0.05555555555555555,0.0006666666666666666
a2d48332fc767b06d024c7988a7a29d221d83ec4,/Users/sanika/Downloads/Master Thesis/repo_updated/pytest/src/_pytest/python.py,6748,ModificationType.MODIFY,1454,835,1044,76,110,219,1530,17,275,158,296,292,454,2297.8910156145625,3718.180349731528,9.149090909090908,34017.97003608918,1889.8872242271766,1.2393934499105095
a2d48332fc767b06d024c7988a7a29d221d83ec4,/Users/sanika/Downloads/Master Thesis/repo_updated/pytest/testing/python/metafunc.py,5913,ModificationType.MODIFY,1782,648,1425,9,47,279,1791,8,171,97,189,179,286,1292.4527800454887,2140.3713122975773,4.421052631578948,9462.69422278929,525.705234599405,0.7134571040991925
a2d48332fc767b06d024c7988a7a29d221d83ec4,/Users/sanika/Downloads/Master Thesis/repo_updated/pytest/testing/test_collection.py,5042,ModificationType.MODIFY,1296,573,1062,40,33,157,1336,8,201,118,231,209,349,1561.8613899269646,2689.868337096228,4.597014925373134,12365.364892919973,686.9647162733319,0.896622779032076
9e759010d9e9bf6ff10766c54f37bdb6ce1266c2,/Users/sanika/Downloads/Master Thesis/repo_updated/pytest/testing/test_setupplan.py,119,ModificationType.MODIFY,110,30,77,3,13,16,113,4,21,15,30,25,45,100.23866587835397,208.9735285398626,2.857142857142857,597.0672243996074,33.17040135553375,0.06965784284662087
9e759010d9e9bf6ff10766c54f37bdb6ce1266c2,/Users/sanika/Downloads/Master Thesis/repo_updated/pytest/src/_pytest/setupplan.py,119,ModificationType.MODIFY,28,15,21,1,0,6,29,0,0,0,0,0,0,0,0,0,0,0.0,0.0
f3a10245d0cfbad21c8c49d1ce7227afbcb0d716,/Users/sanika/Downloads/Master Thesis/repo_updated/pytest/doc/en/example/multipython.py,6741,ModificationType.MODIFY,72,33,56,0,4,12,72,1,1,1,1,2,2,0.0,2.0,0.5,1.0,0.05555555555555555,0.0006666666666666666
f3a10245d0cfbad21c8c49d1ce7227afbcb0d716,/Users/sanika/Downloads/Master Thesis/repo_updated/pytest/src/_pytest/python.py,6741,ModificationType.MODIFY,1454,835,1044,76,110,219,1530,17,275,158,296,292,454,2297.8910156145625,3718.180349731528,9.149090909090908,34017.97003608918,1889.8872242271766,1.2393934499105095
91dec8e2bf5e4e9c43b040a8b2f286c8275f8141,/Users/sanika/Downloads/Master Thesis/repo_updated/pytest/doc/en/example/multipython.py,6756,ModificationType.MODIFY,72,33,56,0,4,12,72,1,1,1,1,2,2,0.0,2.0,0.5,1.0,0.05555555555555555,0.0006666666666666666
91dec8e2bf5e4e9c43b040a8b2f286c8275f8141,/Users/sanika/Downloads/Master Thesis/repo_updated/pytest/src/_pytest/python.py,6756,ModificationType.MODIFY,1454,835,1044,76,110,219,1530,17,275,158,296,292,454,2297.8910156145625,3718.180349731528,9.149090909090908,34017.97003608918,1889.8872242271766,1.2393934499105095
5d5f48097922dae26da06a12482a7a74de7ba924,/Users/sanika/Downloads/Master Thesis/repo_updated/pytest/testing/test_collection.py,5061,ModificationType.MODIFY,1296,573,1062,40,33,157,1336,8,201,118,231,209,349,1561.8613899269646,2689.868337096228,4.597014925373134,12365.364892919973,686.9647162733319,0.896622779032076
b412661de9fca2ed51d30eb29a3c0606bb10a868,/Users/sanika/Downloads/Master Thesis/repo_updated/pytest/doc/en/example/multipython.py,6756,ModificationType.MODIFY,72,33,56,0,4,12,72,1,1,1,1,2,2,0.0,2.0,0.5,1.0,0.05555555555555555,0.0006666666666666666
b412661de9fca2ed51d30eb29a3c0606bb10a868,/Users/sanika/Downloads/Master Thesis/repo_updated/pytest/src/_pytest/python.py,6756,ModificationType.MODIFY,1454,835,1044,76,110,219,1530,17,275,158,296,292,454,2297.8910156145625,3718.180349731528,9.149090909090908,34017.97003608918,1889.8872242271766,1.2393934499105095
64d89105166264ad5169869bae8b945f542e7fb4,/Users/sanika/Downloads/Master Thesis/repo_updated/pytest/doc/en/example/multipython.py,6749,ModificationType.MODIFY,72,33,56,0,4,12,72,1,1,1,1,2,2,0.0,2.0,0.5,1.0,0.05555555555555555,0.0006666666666666666
64d89105166264ad5169869bae8b945f542e7fb4,/Users/sanika/Downloads/Master Thesis/repo_updated/pytest/src/_pytest/python.py,6749,ModificationType.MODIFY,1454,835,1044,76,110,219,1530,17,275,158,296,292,454,2297.8910156145625,3718.180349731528,9.149090909090908,34017.97003608918,1889.8872242271766,1.2393934499105095
2ad2fbc9a222f3ab2cab5379972c40d3f5ad2db1,/Users/sanika/Downloads/Master Thesis/repo_updated/pytest/doc/en/example/multipython.py,6740,ModificationType.MODIFY,72,33,56,0,4,12,72,1,1,1,1,2,2,0.0,2.0,0.5,1.0,0.05555555555555555,0.0006666666666666666
2ad2fbc9a222f3ab2cab5379972c40d3f5ad2db1,/Users/sanika/Downloads/Master Thesis/repo_updated/pytest/src/_pytest/python.py,6740,ModificationType.MODIFY,1454,835,1044,76,110,219,1530,17,275,158,296,292,454,2297.8910156145625,3718.180349731528,9.149090909090908,34017.97003608918,1889.8872242271766,1.2393934499105095
2ad2fbc9a222f3ab2cab5379972c40d3f5ad2db1,/Users/sanika/Downloads/Master Thesis/repo_updated/pytest/testing/python/metafunc.py,5922,ModificationType.MODIFY,1782,648,1425,9,47,279,1791,8,171,97,189,179,286,1292.4527800454887,2140.3713122975773,4.421052631578948,9462.69422278929,525.705234599405,0.7134571040991925
b4ff6b36727cdaa64e0f6d524d290eddd0593e72,/Users/sanika/Downloads/Master Thesis/repo_updated/pytest/doc/en/example/multipython.py,6740,ModificationType.MODIFY,72,33,56,0,4,12,72,1,1,1,1,2,2,0.0,2.0,0.5,1.0,0.05555555555555555,0.0006666666666666666
b4ff6b36727cdaa64e0f6d524d290eddd0593e72,/Users/sanika/Downloads/Master Thesis/repo_updated/pytest/src/_pytest/python.py,6740,ModificationType.MODIFY,1454,835,1044,76,110,219,1530,17,275,158,296,292,454,2297.8910156145625,3718.180349731528,9.149090909090908,34017.97003608918,1889.8872242271766,1.2393934499105095
b4ff6b36727cdaa64e0f6d524d290eddd0593e72,/Users/sanika/Downloads/Master Thesis/repo_updated/pytest/testing/python/metafunc.py,5922,ModificationType.MODIFY,1782,648,1425,9,47,279,1791,8,171,97,189,179,286,1292.4527800454887,2140.3713122975773,4.421052631578948,9462.69422278929,525.705234599405,0.7134571040991925
89eeefbbafaccbee48d8c8501cf9b9318946f491,/Users/sanika/Downloads/Master Thesis/repo_updated/pytest/testing/example_scripts/collect/package_infinite_recursion/__init__.pyi,5077,ModificationType.MODIFY,0,0,0,0,0,0,0,0,0,0,0,0,0,0,0,0,0,0.0,0.0
89eeefbbafaccbee48d8c8501cf9b9318946f491,/Users/sanika/Downloads/Master Thesis/repo_updated/pytest/testing/example_scripts/collect/package_infinite_recursion/tests/__init__.py,5077,ModificationType.MODIFY,0,0,0,0,0,0,0,0,0,0,0,0,0,0,0,0,0,0.0,0.0
89eeefbbafaccbee48d8c8501cf9b9318946f491,/Users/sanika/Downloads/Master Thesis/repo_updated/pytest/testing/example_scripts/collect/collect_init_tests/tests/__init__.py,5077,ModificationType.MODIFY,2,2,2,0,0,0,2,0,0,0,0,0,0,0,0,0,0,0.0,0.0
89eeefbbafaccbee48d8c8501cf9b9318946f491,/Users/sanika/Downloads/Master Thesis/repo_updated/pytest/testing/example_scripts/collect/package_init_given_as_arg/pkg/__init__.py,5077,ModificationType.MODIFY,0,0,0,0,0,0,0,0,0,0,0,0,0,0,0,0,0,0.0,0.0
89eeefbbafaccbee48d8c8501cf9b9318946f491,/Users/sanika/Downloads/Master Thesis/repo_updated/pytest/testing/example_scripts/conftest_usageerror/__init__.pyi,5077,ModificationType.MODIFY,0,0,0,0,0,0,0,0,0,0,0,0,0,0,0,0,0,0.0,0.0
89eeefbbafaccbee48d8c8501cf9b9318946f491,/Users/sanika/Downloads/Master Thesis/repo_updated/pytest/testing/example_scripts/marks/marks_considered_keywords/__init__.pyi,5077,ModificationType.MODIFY,0,0,0,0,0,0,0,0,0,0,0,0,0,0,0,0,0,0.0,0.0
89eeefbbafaccbee48d8c8501cf9b9318946f491,/Users/sanika/Downloads/Master Thesis/repo_updated/pytest/testing/example_scripts/config/collect_pytest_prefix/__init__.pyi,5077,ModificationType.MODIFY,0,0,0,0,0,0,0,0,0,0,0,0,0,0,0,0,0,0.0,0.0
89eeefbbafaccbee48d8c8501cf9b9318946f491,/Users/sanika/Downloads/Master Thesis/repo_updated/pytest/testing/example_scripts/issue88_initial_file_multinodes/__init__.pyi,5077,ModificationType.MODIFY,0,0,0,0,0,0,0,0,0,0,0,0,0,0,0,0,0,0.0,0.0
89eeefbbafaccbee48d8c8501cf9b9318946f491,/Users/sanika/Downloads/Master Thesis/repo_updated/pytest/testing/example_scripts/fixtures/fill_fixtures/test_extend_fixture_conftest_conftest/__init__.pyi,5077,ModificationType.MODIFY,0,0,0,0,0,0,0,0,0,0,0,0,0,0,0,0,0,0.0,0.0
89eeefbbafaccbee48d8c8501cf9b9318946f491,/Users/sanika/Downloads/Master Thesis/repo_updated/pytest/testing/example_scripts/fixtures/fill_fixtures/test_extend_fixture_conftest_conftest/pkg/__init__.py,5077,ModificationType.MODIFY,0,0,0,0,0,0,0,0,0,0,0,0,0,0,0,0,0,0.0,0.0
89eeefbbafaccbee48d8c8501cf9b9318946f491,/Users/sanika/Downloads/Master Thesis/repo_updated/pytest/testing/example_scripts/fixtures/fill_fixtures/test_extend_fixture_conftest_module/__init__.pyi,5077,ModificationType.MODIFY,0,0,0,0,0,0,0,0,0,0,0,0,0,0,0,0,0,0.0,0.0
89eeefbbafaccbee48d8c8501cf9b9318946f491,/Users/sanika/Downloads/Master Thesis/repo_updated/pytest/testing/example_scripts/fixtures/fill_fixtures/test_conftest_funcargs_only_available_in_subdir/sub1/__init__.py,5077,ModificationType.MODIFY,0,0,0,0,0,0,0,0,0,0,0,0,0,0,0,0,0,0.0,0.0
89eeefbbafaccbee48d8c8501cf9b9318946f491,/Users/sanika/Downloads/Master Thesis/repo_updated/pytest/testing/example_scripts/fixtures/fill_fixtures/test_conftest_funcargs_only_available_in_subdir/sub2/__init__.py,5077,ModificationType.MODIFY,0,0,0,0,0,0,0,0,0,0,0,0,0,0,0,0,0,0.0,0.0
89eeefbbafaccbee48d8c8501cf9b9318946f491,/Users/sanika/Downloads/Master Thesis/repo_updated/pytest/testing/example_scripts/fixtures/custom_item/__init__.pyi,5077,ModificationType.MODIFY,0,0,0,0,0,0,0,0,0,0,0,0,0,0,0,0,0,0.0,0.0
89eeefbbafaccbee48d8c8501cf9b9318946f491,/Users/sanika/Downloads/Master Thesis/repo_updated/pytest/testing/example_scripts/fixtures/custom_item/foo/__init__.py,5077,ModificationType.MODIFY,0,0,0,0,0,0,0,0,0,0,0,0,0,0,0,0,0,0.0,0.0
89eeefbbafaccbee48d8c8501cf9b9318946f491,/Users/sanika/Downloads/Master Thesis/repo_updated/pytest/doc/en/example/nonpython/__init__.py,5077,ModificationType.MODIFY,0,0,0,0,0,0,0,0,0,0,0,0,0,0,0,0,0,0.0,0.0
89eeefbbafaccbee48d8c8501cf9b9318946f491,/Users/sanika/Downloads/Master Thesis/repo_updated/pytest/src/pytest/__init__.py,5077,ModificationType.MODIFY,99,48,90,1,3,5,100,0,0,0,0,0,0,0,0,0,0,0.0,0.0
89eeefbbafaccbee48d8c8501cf9b9318946f491,/Users/sanika/Downloads/Master Thesis/repo_updated/pytest/src/_pytest/__init__.py,5077,ModificationType.MODIFY,8,5,5,2,0,1,10,0,0,0,0,0,0,0,0,0,0,0.0,0.0
89eeefbbafaccbee48d8c8501cf9b9318946f491,/Users/sanika/Downloads/Master Thesis/repo_updated/pytest/src/_pytest/config/__init__.py,5077,ModificationType.MODIFY,1217,716,841,84,126,174,1301,14,185,118,215,199,333,1446.608539104324,2542.995998641035,8.135135135135135,20687.616097052745,1149.3120053918192,0.847665332880345
89eeefbbafaccbee48d8c8501cf9b9318946f491,/Users/sanika/Downloads/Master Thesis/repo_updated/pytest/src/_pytest/mark/__init__.py,5077,ModificationType.MODIFY,160,89,115,0,13,31,160,7,15,11,17,22,28,78.25484338853101,124.86408532184433,3.966666666666667,495.2942051099825,27.51634472833236,0.04162136177394811
89eeefbbafaccbee48d8c8501cf9b9318946f491,/Users/sanika/Downloads/Master Thesis/repo_updated/pytest/src/_pytest/_code/__init__.py,5077,ModificationType.MODIFY,10,10,9,9,0,0,19,0,0,0,0,0,0,0,0,0,0,0.0,0.0
89eeefbbafaccbee48d8c8501cf9b9318946f491,/Users/sanika/Downloads/Master Thesis/repo_updated/pytest/src/_pytest/assertion/__init__.py,5077,ModificationType.MODIFY,173,84,99,8,29,36,181,5,12,7,13,17,20,54.62919048309069,81.7492568250068,2.7083333333333335,221.4042372343934,12.300235401910745,0.027249752275002266
89eeefbbafaccbee48d8c8501cf9b9318946f491,/Users/sanika/Downloads/Master Thesis/repo_updated/pytest/src/_pytest/_io/__init__.py,5077,ModificationType.MODIFY,3,1,1,3,0,0,6,0,0,0,0,0,0,0,0,0,0,0.0,0.0
89eeefbbafaccbee48d8c8501cf9b9318946f491,/Users/sanika/Downloads/Master Thesis/repo_updated/pytest/src/_pytest/deprecated.py,45,ModificationType.MODIFY,42,7,23,2,8,9,44,0,0,0,0,0,0,0,0,0,0,0.0,0.0
89eeefbbafaccbee48d8c8501cf9b9318946f491,/Users/sanika/Downloads/Master Thesis/repo_updated/pytest/testing/deprecated_test.py,265,ModificationType.MODIFY,75,38,59,1,3,12,76,2,4,2,4,6,6,10.0,15.509775004326936,1.0,15.509775004326936,0.861654166907052,0.005169925001442312
f38f2d402e183130222993f501d92eefe0d398dc,/Users/sanika/Downloads/Master Thesis/repo_updated/pytest/testing/test_assertrewrite.py,5605,ModificationType.MODIFY,1660,832,1314,41,38,274,1701,20,312,209,395,332,604,2671.484054182769,5058.523816533542,12.66025641025641,64042.2085747035,3557.900476372417,1.6861746055111808
f38f2d402e183130222993f501d92eefe0d398dc,/Users/sanika/Downloads/Master Thesis/repo_updated/pytest/src/_pytest/assertion/rewrite.py,5605,ModificationType.MODIFY,1057,646,719,113,100,145,1170,18,215,134,248,233,382,1740.9201126876956,3004.119107257935,10.38139534883721,31186.948127440515,1732.608229302251,1.001373035752645
bebd80456b4a9865c88c5341ed21cf7ecfee9aa4,/Users/sanika/Downloads/Master Thesis/repo_updated/pytest/testing/test_setupplan.py,119,ModificationType.MODIFY,110,30,77,3,13,16,113,4,21,15,30,25,45,100.23866587835397,208.9735285398626,2.857142857142857,597.0672243996074,33.17040135553375,0.06965784284662087
bebd80456b4a9865c88c5341ed21cf7ecfee9aa4,/Users/sanika/Downloads/Master Thesis/repo_updated/pytest/src/_pytest/setupplan.py,119,ModificationType.MODIFY,28,15,21,1,0,6,29,0,0,0,0,0,0,0,0,0,0,0.0,0.0
eeeb19626b26072ff49735e221dc558363716b78,/Users/sanika/Downloads/Master Thesis/repo_updated/pytest/doc/en/example/multipython.py,6689,ModificationType.MODIFY,72,33,56,0,4,12,72,1,1,1,1,2,2,0.0,2.0,0.5,1.0,0.05555555555555555,0.0006666666666666666
eeeb19626b26072ff49735e221dc558363716b78,/Users/sanika/Downloads/Master Thesis/repo_updated/pytest/src/_pytest/python.py,6689,ModificationType.MODIFY,1454,835,1044,76,110,219,1530,17,275,158,296,292,454,2297.8910156145625,3718.180349731528,9.149090909090908,34017.97003608918,1889.8872242271766,1.2393934499105095
eeeb19626b26072ff49735e221dc558363716b78,/Users/sanika/Downloads/Master Thesis/repo_updated/pytest/testing/test_collection.py,5061,ModificationType.MODIFY,1296,573,1062,40,33,157,1336,8,201,118,231,209,349,1561.8613899269646,2689.868337096228,4.597014925373134,12365.364892919973,686.9647162733319,0.896622779032076
63a23d876cad98d42f03cf6c6f397513e96ffcdb,/Users/sanika/Downloads/Master Thesis/repo_updated/pytest/testing/acceptance_test.py,4605,ModificationType.MODIFY,1289,550,1043,56,32,155,1345,10,167,93,185,177,278,1266.2978977920404,2075.9943429230734,5.538922155688622,11498.771061100855,638.8206145056031,0.6919981143076911
b820b7e384a0e86ed0954bd79b89f4ff928e2837,/Users/sanika/Downloads/Master Thesis/repo_updated/pytest/testing/test_assertrewrite.py,5605,ModificationType.MODIFY,1660,832,1314,41,38,274,1701,20,312,209,395,332,604,2671.484054182769,5058.523816533542,12.66025641025641,64042.2085747035,3557.900476372417,1.6861746055111808
b820b7e384a0e86ed0954bd79b89f4ff928e2837,/Users/sanika/Downloads/Master Thesis/repo_updated/pytest/src/_pytest/assertion/rewrite.py,5605,ModificationType.MODIFY,1057,646,719,113,100,145,1170,18,215,134,248,233,382,1740.9201126876956,3004.119107257935,10.38139534883721,31186.948127440515,1732.608229302251,1.001373035752645
4804d4bc9824f7a6fb0153a25e896627dec37b3b,/Users/sanika/Downloads/Master Thesis/repo_updated/pytest/doc/en/example/multipython.py,6726,ModificationType.MODIFY,72,33,56,0,4,12,72,1,1,1,1,2,2,0.0,2.0,0.5,1.0,0.05555555555555555,0.0006666666666666666
4804d4bc9824f7a6fb0153a25e896627dec37b3b,/Users/sanika/Downloads/Master Thesis/repo_updated/pytest/src/_pytest/python.py,6726,ModificationType.MODIFY,1454,835,1044,76,110,219,1530,17,275,158,296,292,454,2297.8910156145625,3718.180349731528,9.149090909090908,34017.97003608918,1889.8872242271766,1.2393934499105095
f36ea240fe3579f945bf5d6cc41b5e45a572249d,/Users/sanika/Downloads/Master Thesis/repo_updated/pytest/testing/acceptance_test.py,4605,ModificationType.MODIFY,1289,550,1043,56,32,155,1345,10,167,93,185,177,278,1266.2978977920404,2075.9943429230734,5.538922155688622,11498.771061100855,638.8206145056031,0.6919981143076911
d1e2d12b3feae7366b57b878f88a8b772817820e,/Users/sanika/Downloads/Master Thesis/repo_updated/pytest/doc/en/example/multipython.py,6726,ModificationType.MODIFY,72,33,56,0,4,12,72,1,1,1,1,2,2,0.0,2.0,0.5,1.0,0.05555555555555555,0.0006666666666666666
d1e2d12b3feae7366b57b878f88a8b772817820e,/Users/sanika/Downloads/Master Thesis/repo_updated/pytest/src/_pytest/python.py,6726,ModificationType.MODIFY,1454,835,1044,76,110,219,1530,17,275,158,296,292,454,2297.8910156145625,3718.180349731528,9.149090909090908,34017.97003608918,1889.8872242271766,1.2393934499105095
4ad61cbcf6063d5bc414a9a37a5fbb29a3083e73,/Users/sanika/Downloads/Master Thesis/repo_updated/pytest/src/_pytest/mark/structures.py,1500,ModificationType.MODIFY,402,202,227,24,74,80,426,12,52,33,61,64,94,339.4424153519907,564.0,7.038461538461538,3969.6923076923076,220.53846153846155,0.188
4ad61cbcf6063d5bc414a9a37a5fbb29a3083e73,/Users/sanika/Downloads/Master Thesis/repo_updated/pytest/doc/en/example/multipython.py,6686,ModificationType.MODIFY,72,33,56,0,4,12,72,1,1,1,1,2,2,0.0,2.0,0.5,1.0,0.05555555555555555,0.0006666666666666666
4ad61cbcf6063d5bc414a9a37a5fbb29a3083e73,/Users/sanika/Downloads/Master Thesis/repo_updated/pytest/src/_pytest/python.py,6686,ModificationType.MODIFY,1454,835,1044,76,110,219,1530,17,275,158,296,292,454,2297.8910156145625,3718.180349731528,9.149090909090908,34017.97003608918,1889.8872242271766,1.2393934499105095
4ad61cbcf6063d5bc414a9a37a5fbb29a3083e73,/Users/sanika/Downloads/Master Thesis/repo_updated/pytest/testing/python/metafunc.py,5907,ModificationType.MODIFY,1782,648,1425,9,47,279,1791,8,171,97,189,179,286,1292.4527800454887,2140.3713122975773,4.421052631578948,9462.69422278929,525.705234599405,0.7134571040991925
21622d0df43609b84644134a4741343d147df1eb,/Users/sanika/Downloads/Master Thesis/repo_updated/pytest/doc/en/example/multipython.py,6716,ModificationType.MODIFY,72,33,56,0,4,12,72,1,1,1,1,2,2,0.0,2.0,0.5,1.0,0.05555555555555555,0.0006666666666666666
21622d0df43609b84644134a4741343d147df1eb,/Users/sanika/Downloads/Master Thesis/repo_updated/pytest/src/_pytest/python.py,6716,ModificationType.MODIFY,1454,835,1044,76,110,219,1530,17,275,158,296,292,454,2297.8910156145625,3718.180349731528,9.149090909090908,34017.97003608918,1889.8872242271766,1.2393934499105095
21622d0df43609b84644134a4741343d147df1eb,/Users/sanika/Downloads/Master Thesis/repo_updated/pytest/testing/test_setupplan.py,119,ModificationType.MODIFY,110,30,77,3,13,16,113,4,21,15,30,25,45,100.23866587835397,208.9735285398626,2.857142857142857,597.0672243996074,33.17040135553375,0.06965784284662087
21622d0df43609b84644134a4741343d147df1eb,/Users/sanika/Downloads/Master Thesis/repo_updated/pytest/src/_pytest/setupplan.py,119,ModificationType.MODIFY,28,15,21,1,0,6,29,0,0,0,0,0,0,0,0,0,0,0.0,0.0
21622d0df43609b84644134a4741343d147df1eb,/Users/sanika/Downloads/Master Thesis/repo_updated/pytest/testing/acceptance_test.py,4666,ModificationType.MODIFY,1289,550,1043,56,32,155,1345,10,167,93,185,177,278,1266.2978977920404,2075.9943429230734,5.538922155688622,11498.771061100855,638.8206145056031,0.6919981143076911
21622d0df43609b84644134a4741343d147df1eb,/Users/sanika/Downloads/Master Thesis/repo_updated/pytest/testing/test_collection.py,5062,ModificationType.MODIFY,1296,573,1062,40,33,157,1336,8,201,118,231,209,349,1561.8613899269646,2689.868337096228,4.597014925373134,12365.364892919973,686.9647162733319,0.896622779032076
21622d0df43609b84644134a4741343d147df1eb,/Users/sanika/Downloads/Master Thesis/repo_updated/pytest/testing/test_setupplan.py,190,ModificationType.MODIFY,110,30,77,3,13,16,113,4,21,15,30,25,45,100.23866587835397,208.9735285398626,2.857142857142857,597.0672243996074,33.17040135553375,0.06965784284662087
faea273c930985074783703e7d37d88441acf30e,/Users/sanika/Downloads/Master Thesis/repo_updated/pytest/testing/test_assertrewrite.py,5498,ModificationType.MODIFY,1660,832,1314,41,38,274,1701,20,312,209,395,332,604,2671.484054182769,5058.523816533542,12.66025641025641,64042.2085747035,3557.900476372417,1.6861746055111808
faea273c930985074783703e7d37d88441acf30e,/Users/sanika/Downloads/Master Thesis/repo_updated/pytest/src/_pytest/assertion/rewrite.py,5498,ModificationType.MODIFY,1057,646,719,113,100,145,1170,18,215,134,248,233,382,1740.9201126876956,3004.119107257935,10.38139534883721,31186.948127440515,1732.608229302251,1.001373035752645
faea273c930985074783703e7d37d88441acf30e,/Users/sanika/Downloads/Master Thesis/repo_updated/pytest/testing/test_warnings.py,1597,ModificationType.MODIFY,601,196,481,2,23,85,603,8,63,36,72,71,108,400.56863518049477,664.1726889065056,4.571428571428571,3036.21800642974,168.67877813498555,0.22139089630216854
1d368e0ed468ede55718b1990441725778ce6e9b,/Users/sanika/Downloads/Master Thesis/repo_updated/pytest/src/_pytest/mark/structures.py,1500,ModificationType.MODIFY,402,202,227,24,74,80,426,12,52,33,61,64,94,339.4424153519907,564.0,7.038461538461538,3969.6923076923076,220.53846153846155,0.188
1d368e0ed468ede55718b1990441725778ce6e9b,/Users/sanika/Downloads/Master Thesis/repo_updated/pytest/doc/en/example/multipython.py,6672,ModificationType.MODIFY,72,33,56,0,4,12,72,1,1,1,1,2,2,0.0,2.0,0.5,1.0,0.05555555555555555,0.0006666666666666666
1d368e0ed468ede55718b1990441725778ce6e9b,/Users/sanika/Downloads/Master Thesis/repo_updated/pytest/src/_pytest/python.py,6672,ModificationType.MODIFY,1454,835,1044,76,110,219,1530,17,275,158,296,292,454,2297.8910156145625,3718.180349731528,9.149090909090908,34017.97003608918,1889.8872242271766,1.2393934499105095
1d368e0ed468ede55718b1990441725778ce6e9b,/Users/sanika/Downloads/Master Thesis/repo_updated/pytest/testing/python/metafunc.py,5907,ModificationType.MODIFY,1782,648,1425,9,47,279,1791,8,171,97,189,179,286,1292.4527800454887,2140.3713122975773,4.421052631578948,9462.69422278929,525.705234599405,0.7134571040991925
5b3867fd6553edcb456bd8758f6a15b16f2ec84c,/Users/sanika/Downloads/Master Thesis/repo_updated/pytest/doc/en/example/multipython.py,6662,ModificationType.MODIFY,72,33,56,0,4,12,72,1,1,1,1,2,2,0.0,2.0,0.5,1.0,0.05555555555555555,0.0006666666666666666
5b3867fd6553edcb456bd8758f6a15b16f2ec84c,/Users/sanika/Downloads/Master Thesis/repo_updated/pytest/src/_pytest/python.py,6662,ModificationType.MODIFY,1454,835,1044,76,110,219,1530,17,275,158,296,292,454,2297.8910156145625,3718.180349731528,9.149090909090908,34017.97003608918,1889.8872242271766,1.2393934499105095
5b3867fd6553edcb456bd8758f6a15b16f2ec84c,/Users/sanika/Downloads/Master Thesis/repo_updated/pytest/testing/test_setupplan.py,119,ModificationType.MODIFY,110,30,77,3,13,16,113,4,21,15,30,25,45,100.23866587835397,208.9735285398626,2.857142857142857,597.0672243996074,33.17040135553375,0.06965784284662087
5b3867fd6553edcb456bd8758f6a15b16f2ec84c,/Users/sanika/Downloads/Master Thesis/repo_updated/pytest/src/_pytest/setupplan.py,119,ModificationType.MODIFY,28,15,21,1,0,6,29,0,0,0,0,0,0,0,0,0,0,0.0,0.0
5b3867fd6553edcb456bd8758f6a15b16f2ec84c,/Users/sanika/Downloads/Master Thesis/repo_updated/pytest/testing/acceptance_test.py,4666,ModificationType.MODIFY,1289,550,1043,56,32,155,1345,10,167,93,185,177,278,1266.2978977920404,2075.9943429230734,5.538922155688622,11498.771061100855,638.8206145056031,0.6919981143076911
5b3867fd6553edcb456bd8758f6a15b16f2ec84c,/Users/sanika/Downloads/Master Thesis/repo_updated/pytest/testing/test_collection.py,5062,ModificationType.MODIFY,1296,573,1062,40,33,157,1336,8,201,118,231,209,349,1561.8613899269646,2689.868337096228,4.597014925373134,12365.364892919973,686.9647162733319,0.896622779032076
5b3867fd6553edcb456bd8758f6a15b16f2ec84c,/Users/sanika/Downloads/Master Thesis/repo_updated/pytest/testing/test_setupplan.py,190,ModificationType.MODIFY,110,30,77,3,13,16,113,4,21,15,30,25,45,100.23866587835397,208.9735285398626,2.857142857142857,597.0672243996074,33.17040135553375,0.06965784284662087
7e5ad314287a5c86856efea13c04333d7baf3643,/Users/sanika/Downloads/Master Thesis/repo_updated/pytest/setup.py,93,ModificationType.MODIFY,42,7,35,4,0,5,46,1,2,1,2,3,3,2.0,4.754887502163469,0.5,2.3774437510817346,0.1320802083934297,0.0015849625007211565
7e5ad314287a5c86856efea13c04333d7baf3643,/Users/sanika/Downloads/Master Thesis/repo_updated/pytest/extra/setup-py.test/setup.py,93,ModificationType.MODIFY,11,6,10,0,0,1,11,2,4,2,4,6,6,10.0,15.509775004326936,1.0,15.509775004326936,0.861654166907052,0.005169925001442312
7e5ad314287a5c86856efea13c04333d7baf3643,/Users/sanika/Downloads/Master Thesis/repo_updated/pytest/testing/code/test_code.py,5483,ModificationType.MODIFY,182,127,129,0,0,53,182,5,39,21,42,44,63,217.7403270100645,343.9441919741497,2.6923076923076925,926.003593776557,51.44464409869761,0.11464806399138323
7e5ad314287a5c86856efea13c04333d7baf3643,/Users/sanika/Downloads/Master Thesis/repo_updated/pytest/src/_pytest/_code/code.py,5483,ModificationType.MODIFY,1165,710,800,67,119,181,1232,18,243,153,282,261,435,2000.7880884021665,3492.1391085079,10.444444444444445,36473.45291108251,2026.302939504584,1.1640463695026333
7e5ad314287a5c86856efea13c04333d7baf3643,/Users/sanika/Downloads/Master Thesis/repo_updated/pytest/testing/code/test_source.py,1754,ModificationType.MODIFY,773,419,590,28,0,166,801,10,204,113,217,214,330,1598.3940507110585,2554.684105512378,5.318627450980392,13587.413012161423,754.8562784534124,0.8515613685041261
7e5ad314287a5c86856efea13c04333d7baf3643,/Users/sanika/Downloads/Master Thesis/repo_updated/pytest/src/_pytest/_code/source.py,1754,ModificationType.MODIFY,421,273,302,44,34,57,465,17,81,59,107,98,166,583.0147185349103,1098.0418341231248,11.228395061728396,12329.247507839284,684.9581948799602,0.36601394470770826
7e5ad314287a5c86856efea13c04333d7baf3643,/Users/sanika/Downloads/Master Thesis/repo_updated/pytest/testing/io/test_saferepr.py,382,ModificationType.MODIFY,149,95,105,2,0,41,151,8,54,28,55,62,83,334.76392511682735,494.19829376211067,4.074074074074074,2013.4004560678584,111.85558089265879,0.1647327645873702
7e5ad314287a5c86856efea13c04333d7baf3643,/Users/sanika/Downloads/Master Thesis/repo_updated/pytest/src/_pytest/_io/saferepr.py,382,ModificationType.MODIFY,82,56,54,0,13,15,82,4,13,8,16,17,24,56.105716335834195,98.09910819000817,2.4615384615384617,241.47472785232782,13.415262658462657,0.03269970273000272
7e5ad314287a5c86856efea13c04333d7baf3643,/Users/sanika/Downloads/Master Thesis/repo_updated/pytest/testing/example_scripts/collect/package_infinite_recursion/__init__.pyi,596,ModificationType.MODIFY,0,0,0,0,0,0,0,0,0,0,0,0,0,0,0,0,0,0.0,0.0
7e5ad314287a5c86856efea13c04333d7baf3643,/Users/sanika/Downloads/Master Thesis/repo_updated/pytest/testing/example_scripts/collect/package_infinite_recursion/tests/__init__.py,596,ModificationType.MODIFY,0,0,0,0,0,0,0,0,0,0,0,0,0,0,0,0,0,0.0,0.0
7e5ad314287a5c86856efea13c04333d7baf3643,/Users/sanika/Downloads/Master Thesis/repo_updated/pytest/testing/example_scripts/collect/collect_init_tests/tests/__init__.py,596,ModificationType.MODIFY,2,2,2,0,0,0,2,0,0,0,0,0,0,0,0,0,0,0.0,0.0
7e5ad314287a5c86856efea13c04333d7baf3643,/Users/sanika/Downloads/Master Thesis/repo_updated/pytest/testing/example_scripts/collect/package_init_given_as_arg/pkg/__init__.py,596,ModificationType.MODIFY,0,0,0,0,0,0,0,0,0,0,0,0,0,0,0,0,0,0.0,0.0
7e5ad314287a5c86856efea13c04333d7baf3643,/Users/sanika/Downloads/Master Thesis/repo_updated/pytest/testing/example_scripts/conftest_usageerror/__init__.pyi,596,ModificationType.MODIFY,0,0,0,0,0,0,0,0,0,0,0,0,0,0,0,0,0,0.0,0.0
7e5ad314287a5c86856efea13c04333d7baf3643,/Users/sanika/Downloads/Master Thesis/repo_updated/pytest/testing/example_scripts/marks/marks_considered_keywords/__init__.pyi,596,ModificationType.MODIFY,0,0,0,0,0,0,0,0,0,0,0,0,0,0,0,0,0,0.0,0.0
7e5ad314287a5c86856efea13c04333d7baf3643,/Users/sanika/Downloads/Master Thesis/repo_updated/pytest/testing/example_scripts/config/collect_pytest_prefix/__init__.pyi,596,ModificationType.MODIFY,0,0,0,0,0,0,0,0,0,0,0,0,0,0,0,0,0,0.0,0.0
7e5ad314287a5c86856efea13c04333d7baf3643,/Users/sanika/Downloads/Master Thesis/repo_updated/pytest/testing/example_scripts/issue88_initial_file_multinodes/__init__.pyi,596,ModificationType.MODIFY,0,0,0,0,0,0,0,0,0,0,0,0,0,0,0,0,0,0.0,0.0
7e5ad314287a5c86856efea13c04333d7baf3643,/Users/sanika/Downloads/Master Thesis/repo_updated/pytest/testing/example_scripts/fixtures/fill_fixtures/test_extend_fixture_conftest_conftest/__init__.pyi,596,ModificationType.MODIFY,0,0,0,0,0,0,0,0,0,0,0,0,0,0,0,0,0,0.0,0.0
7e5ad314287a5c86856efea13c04333d7baf3643,/Users/sanika/Downloads/Master Thesis/repo_updated/pytest/testing/example_scripts/fixtures/fill_fixtures/test_extend_fixture_conftest_conftest/pkg/__init__.py,596,ModificationType.MODIFY,0,0,0,0,0,0,0,0,0,0,0,0,0,0,0,0,0,0.0,0.0
7e5ad314287a5c86856efea13c04333d7baf3643,/Users/sanika/Downloads/Master Thesis/repo_updated/pytest/testing/example_scripts/fixtures/fill_fixtures/test_extend_fixture_conftest_module/__init__.pyi,596,ModificationType.MODIFY,0,0,0,0,0,0,0,0,0,0,0,0,0,0,0,0,0,0.0,0.0
7e5ad314287a5c86856efea13c04333d7baf3643,/Users/sanika/Downloads/Master Thesis/repo_updated/pytest/testing/example_scripts/fixtures/fill_fixtures/test_conftest_funcargs_only_available_in_subdir/sub1/__init__.py,596,ModificationType.MODIFY,0,0,0,0,0,0,0,0,0,0,0,0,0,0,0,0,0,0.0,0.0
7e5ad314287a5c86856efea13c04333d7baf3643,/Users/sanika/Downloads/Master Thesis/repo_updated/pytest/testing/example_scripts/fixtures/fill_fixtures/test_conftest_funcargs_only_available_in_subdir/sub2/__init__.py,596,ModificationType.MODIFY,0,0,0,0,0,0,0,0,0,0,0,0,0,0,0,0,0,0.0,0.0
7e5ad314287a5c86856efea13c04333d7baf3643,/Users/sanika/Downloads/Master Thesis/repo_updated/pytest/testing/example_scripts/fixtures/custom_item/__init__.pyi,596,ModificationType.MODIFY,0,0,0,0,0,0,0,0,0,0,0,0,0,0,0,0,0,0.0,0.0
7e5ad314287a5c86856efea13c04333d7baf3643,/Users/sanika/Downloads/Master Thesis/repo_updated/pytest/testing/example_scripts/fixtures/custom_item/foo/__init__.py,596,ModificationType.MODIFY,0,0,0,0,0,0,0,0,0,0,0,0,0,0,0,0,0,0.0,0.0
7e5ad314287a5c86856efea13c04333d7baf3643,/Users/sanika/Downloads/Master Thesis/repo_updated/pytest/doc/en/example/nonpython/__init__.py,596,ModificationType.MODIFY,0,0,0,0,0,0,0,0,0,0,0,0,0,0,0,0,0,0.0,0.0
7e5ad314287a5c86856efea13c04333d7baf3643,/Users/sanika/Downloads/Master Thesis/repo_updated/pytest/src/pytest/__init__.py,596,ModificationType.MODIFY,99,48,90,1,3,5,100,0,0,0,0,0,0,0,0,0,0,0.0,0.0
7e5ad314287a5c86856efea13c04333d7baf3643,/Users/sanika/Downloads/Master Thesis/repo_updated/pytest/src/_pytest/__init__.py,596,ModificationType.MODIFY,8,5,5,2,0,1,10,0,0,0,0,0,0,0,0,0,0,0.0,0.0
7e5ad314287a5c86856efea13c04333d7baf3643,/Users/sanika/Downloads/Master Thesis/repo_updated/pytest/src/_pytest/config/__init__.py,596,ModificationType.MODIFY,1217,716,841,84,126,174,1301,14,185,118,215,199,333,1446.608539104324,2542.995998641035,8.135135135135135,20687.616097052745,1149.3120053918192,0.847665332880345
7e5ad314287a5c86856efea13c04333d7baf3643,/Users/sanika/Downloads/Master Thesis/repo_updated/pytest/src/_pytest/mark/__init__.py,596,ModificationType.MODIFY,160,89,115,0,13,31,160,7,15,11,17,22,28,78.25484338853101,124.86408532184433,3.966666666666667,495.2942051099825,27.51634472833236,0.04162136177394811
7e5ad314287a5c86856efea13c04333d7baf3643,/Users/sanika/Downloads/Master Thesis/repo_updated/pytest/src/_pytest/_code/__init__.py,596,ModificationType.MODIFY,10,10,9,9,0,0,19,0,0,0,0,0,0,0,0,0,0,0.0,0.0
7e5ad314287a5c86856efea13c04333d7baf3643,/Users/sanika/Downloads/Master Thesis/repo_updated/pytest/src/_pytest/assertion/__init__.py,596,ModificationType.MODIFY,173,84,99,8,29,36,181,5,12,7,13,17,20,54.62919048309069,81.7492568250068,2.7083333333333335,221.4042372343934,12.300235401910745,0.027249752275002266
7e5ad314287a5c86856efea13c04333d7baf3643,/Users/sanika/Downloads/Master Thesis/repo_updated/pytest/src/_pytest/_io/__init__.py,596,ModificationType.MODIFY,3,1,1,3,0,0,6,0,0,0,0,0,0,0,0,0,0,0.0,0.0
7e5ad314287a5c86856efea13c04333d7baf3643,/Users/sanika/Downloads/Master Thesis/repo_updated/pytest/testing/test_assertrewrite.py,5605,ModificationType.MODIFY,1660,832,1314,41,38,274,1701,20,312,209,395,332,604,2671.484054182769,5058.523816533542,12.66025641025641,64042.2085747035,3557.900476372417,1.6861746055111808
7e5ad314287a5c86856efea13c04333d7baf3643,/Users/sanika/Downloads/Master Thesis/repo_updated/pytest/src/_pytest/assertion/rewrite.py,5605,ModificationType.MODIFY,1057,646,719,113,100,145,1170,18,215,134,248,233,382,1740.9201126876956,3004.119107257935,10.38139534883721,31186.948127440515,1732.608229302251,1.001373035752645
7e5ad314287a5c86856efea13c04333d7baf3643,/Users/sanika/Downloads/Master Thesis/repo_updated/pytest/src/_pytest/assertion/util.py,2606,ModificationType.MODIFY,477,336,357,30,23,73,507,16,194,134,250,210,384,1538.3830913843028,2962.270278783791,10.309278350515465,30538.86885344115,1696.603825191175,0.9874234262612637
7e5ad314287a5c86856efea13c04333d7baf3643,/Users/sanika/Downloads/Master Thesis/repo_updated/pytest/testing/test_cacheprovider.py,2063,ModificationType.MODIFY,996,429,845,24,10,117,1020,7,76,50,88,83,138,494.49397547611574,879.7554415258757,4.052631578947368,3565.3246840785487,198.07359355991937,0.29325181384195853
7e5ad314287a5c86856efea13c04333d7baf3643,/Users/sanika/Downloads/Master Thesis/repo_updated/pytest/src/_pytest/cacheprovider.py,2063,ModificationType.MODIFY,456,277,329,12,42,72,468,13,85,50,97,98,147,592.903945907539,972.3623470849358,7.41764705882353,7212.640703965318,400.70226133140653,0.32412078236164527
7e5ad314287a5c86856efea13c04333d7baf3643,/Users/sanika/Downloads/Master Thesis/repo_updated/pytest/testing/test_capture.py,3438,ModificationType.MODIFY,1513,682,1277,25,13,200,1538,11,199,116,219,210,335,1557.7420472931965,2584.272248418151,6.052763819095477,15641.989563917903,868.9994202176613,0.8614240828060503
7e5ad314287a5c86856efea13c04333d7baf3643,/Users/sanika/Downloads/Master Thesis/repo_updated/pytest/src/_pytest/capture.py,3438,ModificationType.MODIFY,819,519,539,24,98,155,843,15,96,57,106,111,163,690.7597590033588,1107.4897862150674,8.28125,9171.399792093527,509.52221067186264,0.36916326207168915
7e5ad314287a5c86856efea13c04333d7baf3643,/Users/sanika/Downloads/Master Thesis/repo_updated/pytest/testing/test_compat.py,1495,ModificationType.MODIFY,207,111,150,11,0,50,218,5,26,19,36,31,55,133.82107314610522,272.4807970712782,3.4615384615384617,943.202759092886,52.40015328293811,0.09082693235709273
7e5ad314287a5c86856efea13c04333d7baf3643,/Users/sanika/Downloads/Master Thesis/repo_updated/pytest/src/_pytest/compat.py,1495,ModificationType.MODIFY,410,198,237,31,55,97,441,11,63,38,72,74,110,414.62238298550506,683.0398702191846,6.285714285714286,4293.39346994916,238.52185944162,0.2276799567397282
7e5ad314287a5c86856efea13c04333d7baf3643,/Users/sanika/Downloads/Master Thesis/repo_updated/pytest/testing/example_scripts/collect/package_infinite_recursion/__init__.pyi,5077,ModificationType.MODIFY,0,0,0,0,0,0,0,0,0,0,0,0,0,0,0,0,0,0.0,0.0
7e5ad314287a5c86856efea13c04333d7baf3643,/Users/sanika/Downloads/Master Thesis/repo_updated/pytest/testing/example_scripts/collect/package_infinite_recursion/tests/__init__.py,5077,ModificationType.MODIFY,0,0,0,0,0,0,0,0,0,0,0,0,0,0,0,0,0,0.0,0.0
7e5ad314287a5c86856efea13c04333d7baf3643,/Users/sanika/Downloads/Master Thesis/repo_updated/pytest/testing/example_scripts/collect/collect_init_tests/tests/__init__.py,5077,ModificationType.MODIFY,2,2,2,0,0,0,2,0,0,0,0,0,0,0,0,0,0,0.0,0.0
7e5ad314287a5c86856efea13c04333d7baf3643,/Users/sanika/Downloads/Master Thesis/repo_updated/pytest/testing/example_scripts/collect/package_init_given_as_arg/pkg/__init__.py,5077,ModificationType.MODIFY,0,0,0,0,0,0,0,0,0,0,0,0,0,0,0,0,0,0.0,0.0
7e5ad314287a5c86856efea13c04333d7baf3643,/Users/sanika/Downloads/Master Thesis/repo_updated/pytest/testing/example_scripts/conftest_usageerror/__init__.pyi,5077,ModificationType.MODIFY,0,0,0,0,0,0,0,0,0,0,0,0,0,0,0,0,0,0.0,0.0
7e5ad314287a5c86856efea13c04333d7baf3643,/Users/sanika/Downloads/Master Thesis/repo_updated/pytest/testing/example_scripts/marks/marks_considered_keywords/__init__.pyi,5077,ModificationType.MODIFY,0,0,0,0,0,0,0,0,0,0,0,0,0,0,0,0,0,0.0,0.0
7e5ad314287a5c86856efea13c04333d7baf3643,/Users/sanika/Downloads/Master Thesis/repo_updated/pytest/testing/example_scripts/config/collect_pytest_prefix/__init__.pyi,5077,ModificationType.MODIFY,0,0,0,0,0,0,0,0,0,0,0,0,0,0,0,0,0,0.0,0.0
7e5ad314287a5c86856efea13c04333d7baf3643,/Users/sanika/Downloads/Master Thesis/repo_updated/pytest/testing/example_scripts/issue88_initial_file_multinodes/__init__.pyi,5077,ModificationType.MODIFY,0,0,0,0,0,0,0,0,0,0,0,0,0,0,0,0,0,0.0,0.0
7e5ad314287a5c86856efea13c04333d7baf3643,/Users/sanika/Downloads/Master Thesis/repo_updated/pytest/testing/example_scripts/fixtures/fill_fixtures/test_extend_fixture_conftest_conftest/__init__.pyi,5077,ModificationType.MODIFY,0,0,0,0,0,0,0,0,0,0,0,0,0,0,0,0,0,0.0,0.0
7e5ad314287a5c86856efea13c04333d7baf3643,/Users/sanika/Downloads/Master Thesis/repo_updated/pytest/testing/example_scripts/fixtures/fill_fixtures/test_extend_fixture_conftest_conftest/pkg/__init__.py,5077,ModificationType.MODIFY,0,0,0,0,0,0,0,0,0,0,0,0,0,0,0,0,0,0.0,0.0
7e5ad314287a5c86856efea13c04333d7baf3643,/Users/sanika/Downloads/Master Thesis/repo_updated/pytest/testing/example_scripts/fixtures/fill_fixtures/test_extend_fixture_conftest_module/__init__.pyi,5077,ModificationType.MODIFY,0,0,0,0,0,0,0,0,0,0,0,0,0,0,0,0,0,0.0,0.0
7e5ad314287a5c86856efea13c04333d7baf3643,/Users/sanika/Downloads/Master Thesis/repo_updated/pytest/testing/example_scripts/fixtures/fill_fixtures/test_conftest_funcargs_only_available_in_subdir/sub1/__init__.py,5077,ModificationType.MODIFY,0,0,0,0,0,0,0,0,0,0,0,0,0,0,0,0,0,0.0,0.0
7e5ad314287a5c86856efea13c04333d7baf3643,/Users/sanika/Downloads/Master Thesis/repo_updated/pytest/testing/example_scripts/fixtures/fill_fixtures/test_conftest_funcargs_only_available_in_subdir/sub2/__init__.py,5077,ModificationType.MODIFY,0,0,0,0,0,0,0,0,0,0,0,0,0,0,0,0,0,0.0,0.0
7e5ad314287a5c86856efea13c04333d7baf3643,/Users/sanika/Downloads/Master Thesis/repo_updated/pytest/testing/example_scripts/fixtures/custom_item/__init__.pyi,5077,ModificationType.MODIFY,0,0,0,0,0,0,0,0,0,0,0,0,0,0,0,0,0,0.0,0.0
7e5ad314287a5c86856efea13c04333d7baf3643,/Users/sanika/Downloads/Master Thesis/repo_updated/pytest/testing/example_scripts/fixtures/custom_item/foo/__init__.py,5077,ModificationType.MODIFY,0,0,0,0,0,0,0,0,0,0,0,0,0,0,0,0,0,0.0,0.0
7e5ad314287a5c86856efea13c04333d7baf3643,/Users/sanika/Downloads/Master Thesis/repo_updated/pytest/doc/en/example/nonpython/__init__.py,5077,ModificationType.MODIFY,0,0,0,0,0,0,0,0,0,0,0,0,0,0,0,0,0,0.0,0.0
7e5ad314287a5c86856efea13c04333d7baf3643,/Users/sanika/Downloads/Master Thesis/repo_updated/pytest/src/pytest/__init__.py,5077,ModificationType.MODIFY,99,48,90,1,3,5,100,0,0,0,0,0,0,0,0,0,0,0.0,0.0
7e5ad314287a5c86856efea13c04333d7baf3643,/Users/sanika/Downloads/Master Thesis/repo_updated/pytest/src/_pytest/__init__.py,5077,ModificationType.MODIFY,8,5,5,2,0,1,10,0,0,0,0,0,0,0,0,0,0,0.0,0.0
7e5ad314287a5c86856efea13c04333d7baf3643,/Users/sanika/Downloads/Master Thesis/repo_updated/pytest/src/_pytest/config/__init__.py,5077,ModificationType.MODIFY,1217,716,841,84,126,174,1301,14,185,118,215,199,333,1446.608539104324,2542.995998641035,8.135135135135135,20687.616097052745,1149.3120053918192,0.847665332880345
7e5ad314287a5c86856efea13c04333d7baf3643,/Users/sanika/Downloads/Master Thesis/repo_updated/pytest/src/_pytest/mark/__init__.py,5077,ModificationType.MODIFY,160,89,115,0,13,31,160,7,15,11,17,22,28,78.25484338853101,124.86408532184433,3.966666666666667,495.2942051099825,27.51634472833236,0.04162136177394811
7e5ad314287a5c86856efea13c04333d7baf3643,/Users/sanika/Downloads/Master Thesis/repo_updated/pytest/src/_pytest/_code/__init__.py,5077,ModificationType.MODIFY,10,10,9,9,0,0,19,0,0,0,0,0,0,0,0,0,0,0.0,0.0
7e5ad314287a5c86856efea13c04333d7baf3643,/Users/sanika/Downloads/Master Thesis/repo_updated/pytest/src/_pytest/assertion/__init__.py,5077,ModificationType.MODIFY,173,84,99,8,29,36,181,5,12,7,13,17,20,54.62919048309069,81.7492568250068,2.7083333333333335,221.4042372343934,12.300235401910745,0.027249752275002266
7e5ad314287a5c86856efea13c04333d7baf3643,/Users/sanika/Downloads/Master Thesis/repo_updated/pytest/src/_pytest/_io/__init__.py,5077,ModificationType.MODIFY,3,1,1,3,0,0,6,0,0,0,0,0,0,0,0,0,0,0.0,0.0
7e5ad314287a5c86856efea13c04333d7baf3643,/Users/sanika/Downloads/Master Thesis/repo_updated/pytest/src/_pytest/config/argparsing.py,2328,ModificationType.MODIFY,463,295,324,28,62,57,491,12,134,82,154,146,236,989.8755015299953,1696.7985958956842,6.895522388059701,11700.312706026956,650.0173725570531,0.565599531965228
7e5ad314287a5c86856efea13c04333d7baf3643,/Users/sanika/Downloads/Master Thesis/repo_updated/pytest/src/_pytest/debugging.py,1477,ModificationType.MODIFY,339,213,244,17,9,65,356,10,42,26,48,52,74,259.6966127055816,421.83253914244085,5.714285714285714,2410.471652242519,133.91509179125106,0.14061084638081361
7e5ad314287a5c86856efea13c04333d7baf3643,/Users/sanika/Downloads/Master Thesis/repo_updated/pytest/src/_pytest/deprecated.py,45,ModificationType.MODIFY,42,7,23,2,8,9,44,0,0,0,0,0,0,0,0,0,0,0.0,0.0
7e5ad314287a5c86856efea13c04333d7baf3643,/Users/sanika/Downloads/Master Thesis/repo_updated/pytest/testing/test_doctest.py,2729,ModificationType.MODIFY,1455,414,1257,16,76,112,1471,5,41,23,46,46,69,231.26927266377825,381.1257749679339,2.8048780487804876,1069.0113200320097,59.389517779556094,0.1270419249893113
7e5ad314287a5c86856efea13c04333d7baf3643,/Users/sanika/Downloads/Master Thesis/repo_updated/pytest/src/_pytest/doctest.py,2729,ModificationType.MODIFY,669,365,481,22,61,110,691,15,103,63,122,118,185,747.3129132339992,1273.2889641319407,8.883495145631068,11311.256331851706,628.403129547317,0.4244296547106469
7e5ad314287a5c86856efea13c04333d7baf3643,/Users/sanika/Downloads/Master Thesis/repo_updated/pytest/testing/python/fixtures.py,6261,ModificationType.MODIFY,4293,999,3693,19,54,507,4312,9,155,88,170,164,258,1156.3286078304877,1898.248417191466,4.935483870967742,9368.774446138526,520.4874692299181,0.6327494723971553
7e5ad314287a5c86856efea13c04333d7baf3643,/Users/sanika/Downloads/Master Thesis/repo_updated/pytest/src/_pytest/fixtures.py,6261,ModificationType.MODIFY,1482,859,1002,125,135,219,1607,16,219,134,251,235,385,1766.678366052657,3032.459024427525,9.168949771689498,27804.464479682512,1544.692471093473,1.0108196748091751
7e5ad314287a5c86856efea13c04333d7baf3643,/Users/sanika/Downloads/Master Thesis/repo_updated/pytest/testing/test_helpconfig.py,1070,ModificationType.MODIFY,74,35,59,1,0,14,75,3,14,7,14,17,21,58.05785641096992,85.83671966625714,1.5,128.75507949938572,7.153059972188095,0.02861223988875238
7e5ad314287a5c86856efea13c04333d7baf3643,/Users/sanika/Downloads/Master Thesis/repo_updated/pytest/src/_pytest/helpconfig.py,1070,ModificationType.MODIFY,245,125,200,5,7,34,250,7,30,17,34,37,51,166.8582023226588,265.6821216470764,3.966666666666667,1053.8724158667364,58.548467548152026,0.08856070721569215
7e5ad314287a5c86856efea13c04333d7baf3643,/Users/sanika/Downloads/Master Thesis/repo_updated/pytest/src/_pytest/hookspec.py,642,ModificationType.MODIFY,647,139,84,35,284,233,682,0,0,0,0,0,0,0,0,0,0,0.0,0.0
7e5ad314287a5c86856efea13c04333d7baf3643,/Users/sanika/Downloads/Master Thesis/repo_updated/pytest/testing/test_junitxml.py,3197,ModificationType.MODIFY,1523,757,1297,19,12,193,1542,12,193,117,230,205,347,1508.3637582013935,2664.7795945283897,7.150259067357513,19053.864458285894,1058.5480254603274,0.8882598648427965
7e5ad314287a5c86856efea13c04333d7baf3643,/Users/sanika/Downloads/Master Thesis/repo_updated/pytest/src/_pytest/junitxml.py,3197,ModificationType.MODIFY,701,378,504,33,58,109,734,13,110,68,126,123,194,794.0552848235468,1346.8478140358125,7.445454545454545,10027.894179048459,557.1052321693588,0.4489492713452708
7e5ad314287a5c86856efea13c04333d7baf3643,/Users/sanika/Downloads/Master Thesis/repo_updated/pytest/src/_pytest/logging.py,2969,ModificationType.MODIFY,773,422,505,30,103,129,803,14,77,46,83,91,129,535.8455325423139,839.5055085856318,7.545454545454546,6334.450655691586,351.9139253161992,0.2798351695285439
7e5ad314287a5c86856efea13c04333d7baf3643,/Users/sanika/Downloads/Master Thesis/repo_updated/pytest/testing/test_main.py,3505,ModificationType.MODIFY,77,34,69,0,0,8,77,3,24,16,29,27,45,114.79398751947123,213.9699375973561,1.8125,387.82051189520797,21.54558399417822,0.07132331253245204
7e5ad314287a5c86856efea13c04333d7baf3643,/Users/sanika/Downloads/Master Thesis/repo_updated/pytest/src/_pytest/main.py,3505,ModificationType.MODIFY,712,438,573,51,9,84,763,14,102,71,128,116,199,733.8903537898989,1364.7382180303869,8.784313725490197,11988.28866034536,666.0160366858534,0.45491273934346227
7e5ad314287a5c86856efea13c04333d7baf3643,/Users/sanika/Downloads/Master Thesis/repo_updated/pytest/testing/example_scripts/collect/package_infinite_recursion/__init__.pyi,608,ModificationType.MODIFY,0,0,0,0,0,0,0,0,0,0,0,0,0,0,0,0,0,0.0,0.0
7e5ad314287a5c86856efea13c04333d7baf3643,/Users/sanika/Downloads/Master Thesis/repo_updated/pytest/testing/example_scripts/collect/package_infinite_recursion/tests/__init__.py,608,ModificationType.MODIFY,0,0,0,0,0,0,0,0,0,0,0,0,0,0,0,0,0,0.0,0.0
7e5ad314287a5c86856efea13c04333d7baf3643,/Users/sanika/Downloads/Master Thesis/repo_updated/pytest/testing/example_scripts/collect/collect_init_tests/tests/__init__.py,608,ModificationType.MODIFY,2,2,2,0,0,0,2,0,0,0,0,0,0,0,0,0,0,0.0,0.0
7e5ad314287a5c86856efea13c04333d7baf3643,/Users/sanika/Downloads/Master Thesis/repo_updated/pytest/testing/example_scripts/collect/package_init_given_as_arg/pkg/__init__.py,608,ModificationType.MODIFY,0,0,0,0,0,0,0,0,0,0,0,0,0,0,0,0,0,0.0,0.0
7e5ad314287a5c86856efea13c04333d7baf3643,/Users/sanika/Downloads/Master Thesis/repo_updated/pytest/testing/example_scripts/conftest_usageerror/__init__.pyi,608,ModificationType.MODIFY,0,0,0,0,0,0,0,0,0,0,0,0,0,0,0,0,0,0.0,0.0
7e5ad314287a5c86856efea13c04333d7baf3643,/Users/sanika/Downloads/Master Thesis/repo_updated/pytest/testing/example_scripts/marks/marks_considered_keywords/__init__.pyi,608,ModificationType.MODIFY,0,0,0,0,0,0,0,0,0,0,0,0,0,0,0,0,0,0.0,0.0
7e5ad314287a5c86856efea13c04333d7baf3643,/Users/sanika/Downloads/Master Thesis/repo_updated/pytest/testing/example_scripts/config/collect_pytest_prefix/__init__.pyi,608,ModificationType.MODIFY,0,0,0,0,0,0,0,0,0,0,0,0,0,0,0,0,0,0.0,0.0
7e5ad314287a5c86856efea13c04333d7baf3643,/Users/sanika/Downloads/Master Thesis/repo_updated/pytest/testing/example_scripts/issue88_initial_file_multinodes/__init__.pyi,608,ModificationType.MODIFY,0,0,0,0,0,0,0,0,0,0,0,0,0,0,0,0,0,0.0,0.0
7e5ad314287a5c86856efea13c04333d7baf3643,/Users/sanika/Downloads/Master Thesis/repo_updated/pytest/testing/example_scripts/fixtures/fill_fixtures/test_extend_fixture_conftest_conftest/__init__.pyi,608,ModificationType.MODIFY,0,0,0,0,0,0,0,0,0,0,0,0,0,0,0,0,0,0.0,0.0
7e5ad314287a5c86856efea13c04333d7baf3643,/Users/sanika/Downloads/Master Thesis/repo_updated/pytest/testing/example_scripts/fixtures/fill_fixtures/test_extend_fixture_conftest_conftest/pkg/__init__.py,608,ModificationType.MODIFY,0,0,0,0,0,0,0,0,0,0,0,0,0,0,0,0,0,0.0,0.0
7e5ad314287a5c86856efea13c04333d7baf3643,/Users/sanika/Downloads/Master Thesis/repo_updated/pytest/testing/example_scripts/fixtures/fill_fixtures/test_extend_fixture_conftest_module/__init__.pyi,608,ModificationType.MODIFY,0,0,0,0,0,0,0,0,0,0,0,0,0,0,0,0,0,0.0,0.0
7e5ad314287a5c86856efea13c04333d7baf3643,/Users/sanika/Downloads/Master Thesis/repo_updated/pytest/testing/example_scripts/fixtures/fill_fixtures/test_conftest_funcargs_only_available_in_subdir/sub1/__init__.py,608,ModificationType.MODIFY,0,0,0,0,0,0,0,0,0,0,0,0,0,0,0,0,0,0.0,0.0
7e5ad314287a5c86856efea13c04333d7baf3643,/Users/sanika/Downloads/Master Thesis/repo_updated/pytest/testing/example_scripts/fixtures/fill_fixtures/test_conftest_funcargs_only_available_in_subdir/sub2/__init__.py,608,ModificationType.MODIFY,0,0,0,0,0,0,0,0,0,0,0,0,0,0,0,0,0,0.0,0.0
7e5ad314287a5c86856efea13c04333d7baf3643,/Users/sanika/Downloads/Master Thesis/repo_updated/pytest/testing/example_scripts/fixtures/custom_item/__init__.pyi,608,ModificationType.MODIFY,0,0,0,0,0,0,0,0,0,0,0,0,0,0,0,0,0,0.0,0.0
7e5ad314287a5c86856efea13c04333d7baf3643,/Users/sanika/Downloads/Master Thesis/repo_updated/pytest/testing/example_scripts/fixtures/custom_item/foo/__init__.py,608,ModificationType.MODIFY,0,0,0,0,0,0,0,0,0,0,0,0,0,0,0,0,0,0.0,0.0
7e5ad314287a5c86856efea13c04333d7baf3643,/Users/sanika/Downloads/Master Thesis/repo_updated/pytest/doc/en/example/nonpython/__init__.py,608,ModificationType.MODIFY,0,0,0,0,0,0,0,0,0,0,0,0,0,0,0,0,0,0.0,0.0
7e5ad314287a5c86856efea13c04333d7baf3643,/Users/sanika/Downloads/Master Thesis/repo_updated/pytest/src/pytest/__init__.py,608,ModificationType.MODIFY,99,48,90,1,3,5,100,0,0,0,0,0,0,0,0,0,0,0.0,0.0
7e5ad314287a5c86856efea13c04333d7baf3643,/Users/sanika/Downloads/Master Thesis/repo_updated/pytest/src/_pytest/__init__.py,608,ModificationType.MODIFY,8,5,5,2,0,1,10,0,0,0,0,0,0,0,0,0,0,0.0,0.0
7e5ad314287a5c86856efea13c04333d7baf3643,/Users/sanika/Downloads/Master Thesis/repo_updated/pytest/src/_pytest/config/__init__.py,608,ModificationType.MODIFY,1217,716,841,84,126,174,1301,14,185,118,215,199,333,1446.608539104324,2542.995998641035,8.135135135135135,20687.616097052745,1149.3120053918192,0.847665332880345
7e5ad314287a5c86856efea13c04333d7baf3643,/Users/sanika/Downloads/Master Thesis/repo_updated/pytest/src/_pytest/mark/__init__.py,608,ModificationType.MODIFY,160,89,115,0,13,31,160,7,15,11,17,22,28,78.25484338853101,124.86408532184433,3.966666666666667,495.2942051099825,27.51634472833236,0.04162136177394811
7e5ad314287a5c86856efea13c04333d7baf3643,/Users/sanika/Downloads/Master Thesis/repo_updated/pytest/src/_pytest/_code/__init__.py,608,ModificationType.MODIFY,10,10,9,9,0,0,19,0,0,0,0,0,0,0,0,0,0,0.0,0.0
7e5ad314287a5c86856efea13c04333d7baf3643,/Users/sanika/Downloads/Master Thesis/repo_updated/pytest/src/_pytest/assertion/__init__.py,608,ModificationType.MODIFY,173,84,99,8,29,36,181,5,12,7,13,17,20,54.62919048309069,81.7492568250068,2.7083333333333335,221.4042372343934,12.300235401910745,0.027249752275002266
7e5ad314287a5c86856efea13c04333d7baf3643,/Users/sanika/Downloads/Master Thesis/repo_updated/pytest/src/_pytest/_io/__init__.py,608,ModificationType.MODIFY,3,1,1,3,0,0,6,0,0,0,0,0,0,0,0,0,0,0.0,0.0
7e5ad314287a5c86856efea13c04333d7baf3643,/Users/sanika/Downloads/Master Thesis/repo_updated/pytest/src/_pytest/mark/structures.py,1500,ModificationType.MODIFY,402,202,227,24,74,80,426,12,52,33,61,64,94,339.4424153519907,564.0,7.038461538461538,3969.6923076923076,220.53846153846155,0.188
7e5ad314287a5c86856efea13c04333d7baf3643,/Users/sanika/Downloads/Master Thesis/repo_updated/pytest/testing/test_nodes.py,1873,ModificationType.MODIFY,53,23,39,0,0,13,53,2,8,4,8,10,12,26.0,39.863137138648355,1.0,39.863137138648355,2.2146187299249087,0.013287712379549451
7e5ad314287a5c86856efea13c04333d7baf3643,/Users/sanika/Downloads/Master Thesis/repo_updated/pytest/src/_pytest/nodes.py,1873,ModificationType.MODIFY,515,298,307,33,80,99,548,12,63,44,77,75,121,419.58818518914865,753.6870615500015,7.333333333333333,5527.038451366678,307.0576917425932,0.2512290205166672
7e5ad314287a5c86856efea13c04333d7baf3643,/Users/sanika/Downloads/Master Thesis/repo_updated/pytest/testing/test_pathlib.py,1561,ModificationType.MODIFY,91,45,69,0,3,18,91,3,9,6,10,12,16,33.28421251514428,57.359400011538504,1.6666666666666667,95.59900001923084,5.311055556623936,0.01911980000384617
7e5ad314287a5c86856efea13c04333d7baf3643,/Users/sanika/Downloads/Master Thesis/repo_updated/pytest/src/_pytest/pathlib.py,1561,ModificationType.MODIFY,367,234,237,17,34,68,384,16,55,34,61,71,95,381.9747842438563,584.2259763529448,8.872727272727273,5183.677753822492,287.9820974345829,0.19474199211764828
7e5ad314287a5c86856efea13c04333d7baf3643,/Users/sanika/Downloads/Master Thesis/repo_updated/pytest/testing/test_pytester.py,6346,ModificationType.MODIFY,722,423,573,19,0,135,741,12,172,101,199,184,300,1320.3370878174146,2257.068586817104,6.941860465116279,15668.255189881524,870.4586216600846,0.7523561956057013
7e5ad314287a5c86856efea13c04333d7baf3643,/Users/sanika/Downloads/Master Thesis/repo_updated/pytest/src/_pytest/pytester.py,6346,ModificationType.MODIFY,1508,847,911,44,250,301,1552,14,148,88,169,162,257,1120.302067021891,1886.3414507413484,7.993243243243243,15077.986055587939,837.6658919771077,0.6287804835804495
7e5ad314287a5c86856efea13c04333d7baf3643,/Users/sanika/Downloads/Master Thesis/repo_updated/pytest/doc/en/example/multipython.py,6662,ModificationType.MODIFY,72,33,56,0,4,12,72,1,1,1,1,2,2,0.0,2.0,0.5,1.0,0.05555555555555555,0.0006666666666666666
7e5ad314287a5c86856efea13c04333d7baf3643,/Users/sanika/Downloads/Master Thesis/repo_updated/pytest/src/_pytest/python.py,6662,ModificationType.MODIFY,1454,835,1044,76,110,219,1530,17,275,158,296,292,454,2297.8910156145625,3718.180349731528,9.149090909090908,34017.97003608918,1889.8872242271766,1.2393934499105095
7e5ad314287a5c86856efea13c04333d7baf3643,/Users/sanika/Downloads/Master Thesis/repo_updated/pytest/src/_pytest/python_api.py,1970,ModificationType.MODIFY,757,253,292,73,244,162,830,13,61,38,67,74,105,409.8806939271703,651.9926033910399,7.139344262295082,4654.799652078654,258.5999806710363,0.2173308677970133
7e5ad314287a5c86856efea13c04333d7baf3643,/Users/sanika/Downloads/Master Thesis/repo_updated/pytest/testing/test_recwarn.py,989,ModificationType.MODIFY,386,256,301,16,9,68,402,4,59,35,69,63,104,355.07593991234864,621.6371120439914,2.3389830508474576,1453.9986688486576,80.77770382492542,0.20721237068133044
7e5ad314287a5c86856efea13c04333d7baf3643,/Users/sanika/Downloads/Master Thesis/repo_updated/pytest/src/_pytest/recwarn.py,989,ModificationType.MODIFY,264,131,164,11,41,46,275,6,38,22,40,44,62,214.93102051518318,338.48476035551244,3.1578947368421053,1068.899243227934,59.38329129044078,0.11282825345183747
7e5ad314287a5c86856efea13c04333d7baf3643,/Users/sanika/Downloads/Master Thesis/repo_updated/pytest/testing/test_reports.py,1993,ModificationType.MODIFY,466,257,367,18,25,50,484,7,126,86,171,133,257,898.7887548153927,1813.2075859238057,4.75,8612.736033138077,478.4853351743376,0.6044025286412685
7e5ad314287a5c86856efea13c04333d7baf3643,/Users/sanika/Downloads/Master Thesis/repo_updated/pytest/src/_pytest/reports.py,1993,ModificationType.MODIFY,507,281,342,29,59,88,536,10,53,29,57,63,86,336.79906504072324,514.0460734209928,5.377358490566038,2764.2100174525085,153.56722319180602,0.17134869114033094
7e5ad314287a5c86856efea13c04333d7baf3643,/Users/sanika/Downloads/Master Thesis/repo_updated/pytest/testing/test_runner.py,1930,ModificationType.MODIFY,1043,504,840,53,9,147,1096,9,180,112,198,189,310,1377.0628823523223,2344.2951515085324,4.95,11604.260999967235,644.6811666648464,0.7814317171695108
7e5ad314287a5c86856efea13c04333d7baf3643,/Users/sanika/Downloads/Master Thesis/repo_updated/pytest/src/_pytest/runner.py,1930,ModificationType.MODIFY,383,288,292,26,6,62,409,11,65,38,67,76,105,429.5076556518598,656.0323889115765,5.6692307692307695,3719.199004829476,206.6221669349709,0.2186774629705255
7e5ad314287a5c86856efea13c04333d7baf3643,/Users/sanika/Downloads/Master Thesis/repo_updated/pytest/testing/test_setuponly.py,378,ModificationType.MODIFY,294,64,250,0,0,43,294,1,20,10,20,21,30,86.43856189774725,131.76952268336282,0.5,65.88476134168141,3.6602645189823004,0.04392317422778761
7e5ad314287a5c86856efea13c04333d7baf3643,/Users/sanika/Downloads/Master Thesis/repo_updated/pytest/src/_pytest/setuponly.py,378,ModificationType.MODIFY,78,46,62,3,0,14,81,3,8,4,8,11,12,28.75488750216347,41.51317942364757,1.5,62.26976913547136,3.4594316186372978,0.01383772647454919
7e5ad314287a5c86856efea13c04333d7baf3643,/Users/sanika/Downloads/Master Thesis/repo_updated/pytest/testing/test_skipping.py,786,ModificationType.MODIFY,1178,367,1042,6,15,115,1184,9,94,51,95,103,146,644.6606770706787,976.22907696875,4.547872340425532,4439.7652170653255,246.65362317029587,0.32540969232291667
7e5ad314287a5c86856efea13c04333d7baf3643,/Users/sanika/Downloads/Master Thesis/repo_updated/pytest/src/_pytest/skipping.py,786,ModificationType.MODIFY,177,108,140,8,0,27,185,6,30,16,32,36,48,162.7164928725825,248.15640006923098,3.2,794.1004802215392,44.11669334564107,0.082718800023077
7e5ad314287a5c86856efea13c04333d7baf3643,/Users/sanika/Downloads/Master Thesis/repo_updated/pytest/testing/test_terminal.py,6416,ModificationType.MODIFY,1943,715,1694,26,18,214,1969,12,185,120,237,197,357,1436.3251202041715,2721.0724995459263,7.686486486486486,20915.486996509768,1161.971499806098,0.9070241665153088
7e5ad314287a5c86856efea13c04333d7baf3643,/Users/sanika/Downloads/Master Thesis/repo_updated/pytest/src/_pytest/terminal.py,6416,ModificationType.MODIFY,1168,838,957,57,25,144,1225,19,348,224,416,367,640,3018.854959310786,5452.5672018196565,11.35632183908046,61921.107993078396,3440.061555171022,1.8175224006065522
7e5ad314287a5c86856efea13c04333d7baf3643,/Users/sanika/Downloads/Master Thesis/repo_updated/pytest/testing/test_tmpdir.py,704,ModificationType.MODIFY,442,244,305,14,16,103,456,11,68,45,75,79,120,452.0012210100334,756.4536897812524,6.0661764705882355,4588.781574040686,254.932309668927,0.2521512299270841
7e5ad314287a5c86856efea13c04333d7baf3643,/Users/sanika/Downloads/Master Thesis/repo_updated/pytest/src/_pytest/tmpdir.py,704,ModificationType.MODIFY,182,102,99,11,40,35,193,3,11,6,11,14,17,42.808635307173745,64.72503367497926,1.5,97.08755051246888,5.393752806248271,0.021575011224993085
7e5ad314287a5c86856efea13c04333d7baf3643,/Users/sanika/Downloads/Master Thesis/repo_updated/pytest/testing/test_warning_types.py,222,ModificationType.MODIFY,37,13,25,0,6,6,37,1,2,1,2,3,3,2.0,4.754887502163469,0.5,2.3774437510817346,0.1320802083934297,0.0015849625007211565
7e5ad314287a5c86856efea13c04333d7baf3643,/Users/sanika/Downloads/Master Thesis/repo_updated/pytest/src/_pytest/warning_types.py,222,ModificationType.MODIFY,133,47,40,1,43,49,134,0,0,0,0,0,0,0,0,0,0,0.0,0.0
7e5ad314287a5c86856efea13c04333d7baf3643,/Users/sanika/Downloads/Master Thesis/repo_updated/pytest/testing/test_warnings.py,625,ModificationType.MODIFY,601,196,481,2,23,85,603,8,63,36,72,71,108,400.56863518049477,664.1726889065056,4.571428571428571,3036.21800642974,168.67877813498555,0.22139089630216854
7e5ad314287a5c86856efea13c04333d7baf3643,/Users/sanika/Downloads/Master Thesis/repo_updated/pytest/src/_pytest/warnings.py,625,ModificationType.MODIFY,156,79,106,5,16,28,161,5,14,8,15,19,23,64.91260938324326,97.70233280920246,2.6785714285714284,261.7026771675066,14.539037620417032,0.03256744426973415
7e5ad314287a5c86856efea13c04333d7baf3643,/Users/sanika/Downloads/Master Thesis/repo_updated/pytest/testing/acceptance_test.py,4666,ModificationType.MODIFY,1289,550,1043,56,32,155,1345,10,167,93,185,177,278,1266.2978977920404,2075.9943429230734,5.538922155688622,11498.771061100855,638.8206145056031,0.6919981143076911
7e5ad314287a5c86856efea13c04333d7baf3643,/Users/sanika/Downloads/Master Thesis/repo_updated/pytest/testing/code/test_code.py,1010,ModificationType.MODIFY,182,127,129,0,0,53,182,5,39,21,42,44,63,217.7403270100645,343.9441919741497,2.6923076923076925,926.003593776557,51.44464409869761,0.11464806399138323
7e5ad314287a5c86856efea13c04333d7baf3643,/Users/sanika/Downloads/Master Thesis/repo_updated/pytest/testing/code/test_excinfo.py,6943,ModificationType.MODIFY,1392,870,1177,35,17,170,1427,14,494,280,531,508,811,4473.796381311637,7289.823280972226,7.5242914979757085,54850.755334764704,3047.2641852647057,2.4299410936574084
7e5ad314287a5c86856efea13c04333d7baf3643,/Users/sanika/Downloads/Master Thesis/repo_updated/pytest/testing/code/test_source.py,3088,ModificationType.MODIFY,773,419,590,28,0,166,801,10,204,113,217,214,330,1598.3940507110585,2554.684105512378,5.318627450980392,13587.413012161423,754.8562784534124,0.8515613685041261
7e5ad314287a5c86856efea13c04333d7baf3643,/Users/sanika/Downloads/Master Thesis/repo_updated/pytest/testing/conftest.py,400,ModificationType.MODIFY,127,75,83,2,11,30,129,4,14,7,14,18,21,61.30296890880645,87.56842503028855,2.0,175.1368500605771,9.729825003365395,0.029189475010096184
7e5ad314287a5c86856efea13c04333d7baf3643,/Users/sanika/Downloads/Master Thesis/repo_updated/pytest/testing/test_conftest.py,400,ModificationType.MODIFY,652,304,544,16,6,88,668,6,89,51,101,95,152,591.8500503603364,998.6180524663041,3.404494382022472,3399.7895494077547,188.8771971893197,0.3328726841554347
7e5ad314287a5c86856efea13c04333d7baf3643,/Users/sanika/Downloads/Master Thesis/repo_updated/pytest/testing/example_scripts/collect/package_infinite_recursion/conftest.py,400,ModificationType.MODIFY,2,2,2,0,0,0,2,0,0,0,0,0,0,0,0,0,0,0.0,0.0
7e5ad314287a5c86856efea13c04333d7baf3643,/Users/sanika/Downloads/Master Thesis/repo_updated/pytest/testing/example_scripts/conftest_usageerror/conftest.py,400,ModificationType.MODIFY,8,5,5,0,0,3,8,0,0,0,0,0,0,0,0,0,0,0.0,0.0
7e5ad314287a5c86856efea13c04333d7baf3643,/Users/sanika/Downloads/Master Thesis/repo_updated/pytest/testing/example_scripts/marks/marks_considered_keywords/conftest.py,400,ModificationType.MODIFY,0,0,0,0,0,0,0,0,0,0,0,0,0,0,0,0,0,0.0,0.0
7e5ad314287a5c86856efea13c04333d7baf3643,/Users/sanika/Downloads/Master Thesis/repo_updated/pytest/testing/example_scripts/config/collect_pytest_prefix/conftest.py,400,ModificationType.MODIFY,2,2,2,0,0,0,2,0,0,0,0,0,0,0,0,0,0,0.0,0.0
7e5ad314287a5c86856efea13c04333d7baf3643,/Users/sanika/Downloads/Master Thesis/repo_updated/pytest/testing/example_scripts/issue88_initial_file_multinodes/conftest.py,400,ModificationType.MODIFY,14,8,8,0,0,6,14,0,0,0,0,0,0,0,0,0,0,0.0,0.0
7e5ad314287a5c86856efea13c04333d7baf3643,/Users/sanika/Downloads/Master Thesis/repo_updated/pytest/testing/example_scripts/fixtures/fill_fixtures/test_extend_fixture_conftest_conftest/conftest.py,400,ModificationType.MODIFY,6,4,4,0,0,2,6,0,0,0,0,0,0,0,0,0,0,0.0,0.0
7e5ad314287a5c86856efea13c04333d7baf3643,/Users/sanika/Downloads/Master Thesis/repo_updated/pytest/testing/example_scripts/fixtures/fill_fixtures/test_extend_fixture_conftest_conftest/pkg/conftest.py,400,ModificationType.MODIFY,6,4,4,0,0,2,6,1,2,1,2,3,3,2.0,4.754887502163469,0.5,2.3774437510817346,0.1320802083934297,0.0015849625007211565
7e5ad314287a5c86856efea13c04333d7baf3643,/Users/sanika/Downloads/Master Thesis/repo_updated/pytest/testing/example_scripts/fixtures/fill_fixtures/test_extend_fixture_conftest_module/conftest.py,400,ModificationType.MODIFY,6,4,4,0,0,2,6,0,0,0,0,0,0,0,0,0,0,0.0,0.0
7e5ad314287a5c86856efea13c04333d7baf3643,/Users/sanika/Downloads/Master Thesis/repo_updated/pytest/testing/example_scripts/fixtures/fill_fixtures/test_conftest_funcargs_only_available_in_subdir/sub1/conftest.py,400,ModificationType.MODIFY,7,5,5,0,0,2,7,0,0,0,0,0,0,0,0,0,0,0.0,0.0
7e5ad314287a5c86856efea13c04333d7baf3643,/Users/sanika/Downloads/Master Thesis/repo_updated/pytest/testing/example_scripts/fixtures/fill_fixtures/test_conftest_funcargs_only_available_in_subdir/sub2/conftest.py,400,ModificationType.MODIFY,6,4,4,0,0,2,6,0,0,0,0,0,0,0,0,0,0,0.0,0.0
7e5ad314287a5c86856efea13c04333d7baf3643,/Users/sanika/Downloads/Master Thesis/repo_updated/pytest/testing/example_scripts/fixtures/custom_item/conftest.py,400,ModificationType.MODIFY,10,6,6,0,0,4,10,0,0,0,0,0,0,0,0,0,0,0.0,0.0
7e5ad314287a5c86856efea13c04333d7baf3643,/Users/sanika/Downloads/Master Thesis/repo_updated/pytest/doc/en/conftest.py,400,ModificationType.MODIFY,1,1,1,0,0,0,1,0,0,0,0,0,0,0,0,0,0,0.0,0.0
7e5ad314287a5c86856efea13c04333d7baf3643,/Users/sanika/Downloads/Master Thesis/repo_updated/pytest/doc/en/example/conftest.py,400,ModificationType.MODIFY,1,1,1,0,0,0,1,0,0,0,0,0,0,0,0,0,0,0.0,0.0
7e5ad314287a5c86856efea13c04333d7baf3643,/Users/sanika/Downloads/Master Thesis/repo_updated/pytest/doc/en/example/assertion/global_testmodule_config/conftest.py,400,ModificationType.MODIFY,14,10,10,0,0,4,14,1,1,1,1,2,2,0.0,2.0,0.5,1.0,0.05555555555555555,0.0006666666666666666
7e5ad314287a5c86856efea13c04333d7baf3643,/Users/sanika/Downloads/Master Thesis/repo_updated/pytest/doc/en/example/nonpython/conftest.py,400,ModificationType.MODIFY,46,26,30,3,0,12,49,3,6,3,6,9,9,20.264662506490406,28.529325012980813,1.5,42.793987519471216,2.377443751081734,0.009509775004326938
7e5ad314287a5c86856efea13c04333d7baf3643,/Users/sanika/Downloads/Master Thesis/repo_updated/pytest/testing/deprecated_test.py,265,ModificationType.MODIFY,75,38,59,1,3,12,76,2,4,2,4,6,6,10.0,15.509775004326936,1.0,15.509775004326936,0.861654166907052,0.005169925001442312
7e5ad314287a5c86856efea13c04333d7baf3643,/Users/sanika/Downloads/Master Thesis/repo_updated/pytest/testing/io/test_saferepr.py,694,ModificationType.MODIFY,149,95,105,2,0,41,151,8,54,28,55,62,83,334.76392511682735,494.19829376211067,4.074074074074074,2013.4004560678584,111.85558089265879,0.1647327645873702
7e5ad314287a5c86856efea13c04333d7baf3643,/Users/sanika/Downloads/Master Thesis/repo_updated/pytest/testing/logging/test_fixture.py,696,ModificationType.MODIFY,139,89,101,2,0,35,141,7,54,34,62,61,96,330.41540957123055,569.3507844060371,4.018518518518518,2287.9466706687044,127.10814837048358,0.18978359480201235
7e5ad314287a5c86856efea13c04333d7baf3643,/Users/sanika/Downloads/Master Thesis/repo_updated/pytest/testing/logging/test_formatter.py,501,ModificationType.MODIFY,149,67,118,4,0,27,153,1,17,14,28,18,42,69.48686830125578,175.1368500605771,0.8235294117647058,144.23034710871056,8.01279706159503,0.05837895002019237
7e5ad314287a5c86856efea13c04333d7baf3643,/Users/sanika/Downloads/Master Thesis/repo_updated/pytest/testing/logging/test_reporting.py,2589,ModificationType.MODIFY,1157,318,931,29,22,177,1186,6,104,63,125,110,188,712.3555056910004,1274.895626142636,3.605769230769231,4596.97942118739,255.38774562152165,0.424965208714212
7e5ad314287a5c86856efea13c04333d7baf3643,/Users/sanika/Downloads/Master Thesis/repo_updated/pytest/testing/python/approx.py,4372,ModificationType.MODIFY,520,294,400,33,13,81,553,10,261,204,367,271,571,2128.502746053614,4614.907102613061,7.030651340996169,32445.802809559264,1802.5446005310703,1.5383023675376872
7e5ad314287a5c86856efea13c04333d7baf3643,/Users/sanika/Downloads/Master Thesis/repo_updated/pytest/testing/python/collect.py,3928,ModificationType.MODIFY,1338,495,1086,10,64,173,1348,11,122,82,157,133,239,883.6037029876825,1686.2125020847843,7.077868852459017,11934.79094713288,663.0439415073822,0.5620708340282614
7e5ad314287a5c86856efea13c04333d7baf3643,/Users/sanika/Downloads/Master Thesis/repo_updated/pytest/testing/python/fixtures.py,8005,ModificationType.MODIFY,4293,999,3693,19,54,507,4312,9,155,88,170,164,258,1156.3286078304877,1898.248417191466,4.935483870967742,9368.774446138526,520.4874692299181,0.6327494723971553
7e5ad314287a5c86856efea13c04333d7baf3643,/Users/sanika/Downloads/Master Thesis/repo_updated/pytest/src/_pytest/fixtures.py,8005,ModificationType.MODIFY,1482,859,1002,125,135,219,1607,16,219,134,251,235,385,1766.678366052657,3032.459024427525,9.168949771689498,27804.464479682512,1544.692471093473,1.0108196748091751
7e5ad314287a5c86856efea13c04333d7baf3643,/Users/sanika/Downloads/Master Thesis/repo_updated/pytest/testing/python/metafunc.py,5907,ModificationType.MODIFY,1782,648,1425,9,47,279,1791,8,171,97,189,179,286,1292.4527800454887,2140.3713122975773,4.421052631578948,9462.69422278929,525.705234599405,0.7134571040991925
7e5ad314287a5c86856efea13c04333d7baf3643,/Users/sanika/Downloads/Master Thesis/repo_updated/pytest/testing/python/raises.py,921,ModificationType.MODIFY,256,139,192,9,7,47,265,4,23,12,24,27,36,112.0419249893113,171.1759500778849,2.0869565217391304,357.2367653799337,19.846486965551872,0.05705865002596163
7e5ad314287a5c86856efea13c04333d7baf3643,/Users/sanika/Downloads/Master Thesis/repo_updated/pytest/testing/python/show_fixtures_per_test.py,322,ModificationType.MODIFY,180,34,164,0,0,16,180,1,12,6,12,13,18,43.01955000865388,66.60791492653966,0.5,33.30395746326983,1.8502198590705463,0.022202638308846556
7e5ad314287a5c86856efea13c04333d7baf3643,/Users/sanika/Downloads/Master Thesis/repo_updated/pytest/testing/test_assertion.py,5424,ModificationType.MODIFY,1450,624,1228,12,26,181,1462,14,306,186,354,320,540,2580.063648772758,4493.841171239175,8.098039215686274,36391.30203376038,2021.7390018755768,1.497947057079725
7e5ad314287a5c86856efea13c04333d7baf3643,/Users/sanika/Downloads/Master Thesis/repo_updated/pytest/testing/test_assertrewrite.py,6342,ModificationType.MODIFY,1660,832,1314,41,38,274,1701,20,312,209,395,332,604,2671.484054182769,5058.523816533542,12.66025641025641,64042.2085747035,3557.900476372417,1.6861746055111808
7e5ad314287a5c86856efea13c04333d7baf3643,/Users/sanika/Downloads/Master Thesis/repo_updated/pytest/testing/test_cacheprovider.py,3873,ModificationType.MODIFY,996,429,845,24,10,117,1020,7,76,50,88,83,138,494.49397547611574,879.7554415258757,4.052631578947368,3565.3246840785487,198.07359355991937,0.29325181384195853
7e5ad314287a5c86856efea13c04333d7baf3643,/Users/sanika/Downloads/Master Thesis/repo_updated/pytest/testing/test_capture.py,4986,ModificationType.MODIFY,1513,682,1277,25,13,200,1538,11,199,116,219,210,335,1557.7420472931965,2584.272248418151,6.052763819095477,15641.989563917903,868.9994202176613,0.8614240828060503
7e5ad314287a5c86856efea13c04333d7baf3643,/Users/sanika/Downloads/Master Thesis/repo_updated/pytest/testing/test_collection.py,5062,ModificationType.MODIFY,1296,573,1062,40,33,157,1336,8,201,118,231,209,349,1561.8613899269646,2689.868337096228,4.597014925373134,12365.364892919973,686.9647162733319,0.896622779032076
7e5ad314287a5c86856efea13c04333d7baf3643,/Users/sanika/Downloads/Master Thesis/repo_updated/pytest/testing/test_compat.py,591,ModificationType.MODIFY,207,111,150,11,0,50,218,5,26,19,36,31,55,133.82107314610522,272.4807970712782,3.4615384615384617,943.202759092886,52.40015328293811,0.09082693235709273
7e5ad314287a5c86856efea13c04333d7baf3643,/Users/sanika/Downloads/Master Thesis/repo_updated/pytest/testing/test_config.py,6058,ModificationType.MODIFY,1457,730,1242,11,6,188,1468,10,292,166,329,302,495,2424.648052141839,4078.010345965914,5.633561643835616,22973.722668198385,1276.3179260110214,1.359336781988638
7e5ad314287a5c86856efea13c04333d7baf3643,/Users/sanika/Downloads/Master Thesis/repo_updated/pytest/testing/test_conftest.py,2850,ModificationType.MODIFY,652,304,544,16,6,88,668,6,89,51,101,95,152,591.8500503603364,998.6180524663041,3.404494382022472,3399.7895494077547,188.8771971893197,0.3328726841554347
7e5ad314287a5c86856efea13c04333d7baf3643,/Users/sanika/Downloads/Master Thesis/repo_updated/pytest/testing/test_doctest.py,3715,ModificationType.MODIFY,1455,414,1257,16,76,112,1471,5,41,23,46,46,69,231.26927266377825,381.1257749679339,2.8048780487804876,1069.0113200320097,59.389517779556094,0.1270419249893113
7e5ad314287a5c86856efea13c04333d7baf3643,/Users/sanika/Downloads/Master Thesis/repo_updated/pytest/testing/test_faulthandler.py,310,ModificationType.MODIFY,103,47,73,2,12,15,105,5,16,9,17,21,26,75.60964047443682,114.20025299224778,2.65625,303.34442201065815,16.85246788948101,0.03806675099741593
7e5ad314287a5c86856efea13c04333d7baf3643,/Users/sanika/Downloads/Master Thesis/repo_updated/pytest/testing/test_junitxml.py,5659,ModificationType.MODIFY,1523,757,1297,19,12,193,1542,12,193,117,230,205,347,1508.3637582013935,2664.7795945283897,7.150259067357513,19053.864458285894,1058.5480254603274,0.8882598648427965
7e5ad314287a5c86856efea13c04333d7baf3643,/Users/sanika/Downloads/Master Thesis/repo_updated/pytest/testing/test_mark.py,3199,ModificationType.MODIFY,1020,354,843,12,15,144,1032,8,134,77,144,142,221,970.8559515213415,1580.0941134105349,4.298507462686567,6792.0463382422995,377.3359076801278,0.5266980378035117
7e5ad314287a5c86856efea13c04333d7baf3643,/Users/sanika/Downloads/Master Thesis/repo_updated/pytest/testing/test_meta.py,96,ModificationType.MODIFY,35,12,22,4,5,6,39,1,2,1,2,3,3,2.0,4.754887502163469,0.5,2.3774437510817346,0.1320802083934297,0.0015849625007211565
7e5ad314287a5c86856efea13c04333d7baf3643,/Users/sanika/Downloads/Master Thesis/repo_updated/pytest/testing/test_pdb.py,4230,ModificationType.MODIFY,1293,570,1093,25,15,163,1318,10,195,123,241,205,364,1516.6486921300477,2795.3307562199825,6.17948717948718,17273.710570487587,959.6505872493103,0.9317769187399941
7e5ad314287a5c86856efea13c04333d7baf3643,/Users/sanika/Downloads/Master Thesis/repo_updated/pytest/testing/test_pluginmanager.py,1924,ModificationType.MODIFY,384,251,317,7,8,52,391,11,70,44,84,81,128,467.103558991158,811.500800369232,6.6,5355.905282436931,297.5502934687184,0.270500266789744
7e5ad314287a5c86856efea13c04333d7baf3643,/Users/sanika/Downloads/Master Thesis/repo_updated/pytest/testing/test_pytester.py,3231,ModificationType.MODIFY,722,423,573,19,0,135,741,12,172,101,199,184,300,1320.3370878174146,2257.068586817104,6.941860465116279,15668.255189881524,870.4586216600846,0.7523561956057013
7e5ad314287a5c86856efea13c04333d7baf3643,/Users/sanika/Downloads/Master Thesis/repo_updated/pytest/testing/test_reports.py,1843,ModificationType.MODIFY,466,257,367,18,25,50,484,7,126,86,171,133,257,898.7887548153927,1813.2075859238057,4.75,8612.736033138077,478.4853351743376,0.6044025286412685
7e5ad314287a5c86856efea13c04333d7baf3643,/Users/sanika/Downloads/Master Thesis/repo_updated/pytest/testing/test_runner.py,3442,ModificationType.MODIFY,1043,504,840,53,9,147,1096,9,180,112,198,189,310,1377.0628823523223,2344.2951515085324,4.95,11604.260999967235,644.6811666648464,0.7814317171695108
7e5ad314287a5c86856efea13c04333d7baf3643,/Users/sanika/Downloads/Master Thesis/repo_updated/pytest/testing/test_runner_xunit.py,463,ModificationType.MODIFY,295,56,236,0,4,54,295,2,9,5,10,11,15,30.529325012980813,51.89147427955947,1.1111111111111112,57.65719364395497,3.203177424664165,0.01729715809318649
7e5ad314287a5c86856efea13c04333d7baf3643,/Users/sanika/Downloads/Master Thesis/repo_updated/pytest/testing/test_session.py,1422,ModificationType.MODIFY,373,158,315,8,0,51,381,5,76,44,79,81,123,486.4521314961493,779.8015503548089,2.598684210526316,2026.4579762509838,112.58099868061021,0.25993385011826964
7e5ad314287a5c86856efea13c04333d7baf3643,/Users/sanika/Downloads/Master Thesis/repo_updated/pytest/testing/test_setuponly.py,572,ModificationType.RENAME,294,64,250,0,0,43,294,1,20,10,20,21,30,86.43856189774725,131.76952268336282,0.5,65.88476134168141,3.6602645189823004,0.04392317422778761
7e5ad314287a5c86856efea13c04333d7baf3643,/Users/sanika/Downloads/Master Thesis/repo_updated/pytest/testing/test_setupplan.py,,ModificationType.RENAME,110,30,77,3,13,16,113,4,21,15,30,25,45,100.23866587835397,208.9735285398626,2.857142857142857,597.0672243996074,33.17040135553375,0.06965784284662087
7e5ad314287a5c86856efea13c04333d7baf3643,/Users/sanika/Downloads/Master Thesis/repo_updated/pytest/testing/test_skipping.py,3073,ModificationType.MODIFY,1178,367,1042,6,15,115,1184,9,94,51,95,103,146,644.6606770706787,976.22907696875,4.547872340425532,4439.7652170653255,246.65362317029587,0.32540969232291667
7e5ad314287a5c86856efea13c04333d7baf3643,/Users/sanika/Downloads/Master Thesis/repo_updated/pytest/testing/test_stepwise.py,645,ModificationType.MODIFY,219,78,157,11,5,46,230,3,24,20,34,27,54,114.79398751947123,256.76392511682735,2.125,545.6233408732581,30.31240782629212,0.08558797503894246
7e5ad314287a5c86856efea13c04333d7baf3643,/Users/sanika/Downloads/Master Thesis/repo_updated/pytest/testing/test_terminal.py,6852,ModificationType.MODIFY,1943,715,1694,26,18,214,1969,12,185,120,237,197,357,1436.3251202041715,2721.0724995459263,7.686486486486486,20915.486996509768,1161.971499806098,0.9070241665153088
7e5ad314287a5c86856efea13c04333d7baf3643,/Users/sanika/Downloads/Master Thesis/repo_updated/pytest/testing/test_tmpdir.py,1861,ModificationType.MODIFY,442,244,305,14,16,103,456,11,68,45,75,79,120,452.0012210100334,756.4536897812524,6.0661764705882355,4588.781574040686,254.932309668927,0.2521512299270841
7e5ad314287a5c86856efea13c04333d7baf3643,/Users/sanika/Downloads/Master Thesis/repo_updated/pytest/testing/test_unittest.py,2042,ModificationType.MODIFY,1098,241,925,5,10,155,1103,7,46,25,49,53,74,273.7353344330258,423.8661136376768,3.7282608695652173,1580.2834454100341,87.79352474500189,0.14128870454589226
7e5ad314287a5c86856efea13c04333d7baf3643,/Users/sanika/Downloads/Master Thesis/repo_updated/pytest/testing/test_warnings.py,1715,ModificationType.MODIFY,601,196,481,2,23,85,603,8,63,36,72,71,108,400.56863518049477,664.1726889065056,4.571428571428571,3036.21800642974,168.67877813498555,0.22139089630216854
2228ccbfb412e58138e88101876187008bb22346,/Users/sanika/Downloads/Master Thesis/repo_updated/pytest/testing/test_pytester.py,6367,ModificationType.MODIFY,722,423,573,19,0,135,741,12,172,101,199,184,300,1320.3370878174146,2257.068586817104,6.941860465116279,15668.255189881524,870.4586216600846,0.7523561956057013
2228ccbfb412e58138e88101876187008bb22346,/Users/sanika/Downloads/Master Thesis/repo_updated/pytest/src/_pytest/pytester.py,6367,ModificationType.MODIFY,1508,847,911,44,250,301,1552,14,148,88,169,162,257,1120.302067021891,1886.3414507413484,7.993243243243243,15077.986055587939,837.6658919771077,0.6287804835804495
2228ccbfb412e58138e88101876187008bb22346,/Users/sanika/Downloads/Master Thesis/repo_updated/pytest/testing/test_pytester.py,3295,ModificationType.MODIFY,722,423,573,19,0,135,741,12,172,101,199,184,300,1320.3370878174146,2257.068586817104,6.941860465116279,15668.255189881524,870.4586216600846,0.7523561956057013
58ec5bea353ba7141781b683d811824fd7b9a31b,/Users/sanika/Downloads/Master Thesis/repo_updated/pytest/testing/test_pytester.py,6367,ModificationType.MODIFY,722,423,573,19,0,135,741,12,172,101,199,184,300,1320.3370878174146,2257.068586817104,6.941860465116279,15668.255189881524,870.4586216600846,0.7523561956057013
58ec5bea353ba7141781b683d811824fd7b9a31b,/Users/sanika/Downloads/Master Thesis/repo_updated/pytest/src/_pytest/pytester.py,6367,ModificationType.MODIFY,1508,847,911,44,250,301,1552,14,148,88,169,162,257,1120.302067021891,1886.3414507413484,7.993243243243243,15077.986055587939,837.6658919771077,0.6287804835804495
58ec5bea353ba7141781b683d811824fd7b9a31b,/Users/sanika/Downloads/Master Thesis/repo_updated/pytest/testing/test_pytester.py,3295,ModificationType.MODIFY,722,423,573,19,0,135,741,12,172,101,199,184,300,1320.3370878174146,2257.068586817104,6.941860465116279,15668.255189881524,870.4586216600846,0.7523561956057013
be722652f0b63411a6c9e9e5a193cac129404d24,/Users/sanika/Downloads/Master Thesis/repo_updated/pytest/doc/en/conf.py,303,ModificationType.MODIFY,382,65,130,157,2,92,539,4,10,5,10,14,15,41.219280948873624,57.110323830864054,2.0,114.22064766172811,6.345591536762672,0.019036774610288017
b96e0a71a6ce4130b480b6c601befadbeec5dfe5,/Users/sanika/Downloads/Master Thesis/repo_updated/pytest/testing/test_pytester.py,6370,ModificationType.MODIFY,722,423,573,19,0,135,741,12,172,101,199,184,300,1320.3370878174146,2257.068586817104,6.941860465116279,15668.255189881524,870.4586216600846,0.7523561956057013
b96e0a71a6ce4130b480b6c601befadbeec5dfe5,/Users/sanika/Downloads/Master Thesis/repo_updated/pytest/src/_pytest/pytester.py,6370,ModificationType.MODIFY,1508,847,911,44,250,301,1552,14,148,88,169,162,257,1120.302067021891,1886.3414507413484,7.993243243243243,15077.986055587939,837.6658919771077,0.6287804835804495
4ee984ff0ab9bbf46ff07dc5691fdb48bf70e5e1,/Users/sanika/Downloads/Master Thesis/repo_updated/pytest/testing/test_pytester.py,6370,ModificationType.MODIFY,722,423,573,19,0,135,741,12,172,101,199,184,300,1320.3370878174146,2257.068586817104,6.941860465116279,15668.255189881524,870.4586216600846,0.7523561956057013
4ee984ff0ab9bbf46ff07dc5691fdb48bf70e5e1,/Users/sanika/Downloads/Master Thesis/repo_updated/pytest/src/_pytest/pytester.py,6370,ModificationType.MODIFY,1508,847,911,44,250,301,1552,14,148,88,169,162,257,1120.302067021891,1886.3414507413484,7.993243243243243,15077.986055587939,837.6658919771077,0.6287804835804495
7e10c8191d0a6b8e2a0047947ededc232d02cd06,/Users/sanika/Downloads/Master Thesis/repo_updated/pytest/doc/en/conf.py,319,ModificationType.MODIFY,382,65,130,157,2,92,539,4,10,5,10,14,15,41.219280948873624,57.110323830864054,2.0,114.22064766172811,6.345591536762672,0.019036774610288017
7e10c8191d0a6b8e2a0047947ededc232d02cd06,/Users/sanika/Downloads/Master Thesis/repo_updated/pytest/scripts/release.py,539,ModificationType.MODIFY,124,78,88,2,3,26,126,4,13,7,13,17,20,56.105716335834195,81.7492568250068,2.0,163.4985136500136,9.083250758334088,0.027249752275002266
64eb9ea670fd4d31e46e41ee397933fcad05886d,/Users/sanika/Downloads/Master Thesis/repo_updated/pytest/testing/test_runner.py,3448,ModificationType.MODIFY,1043,504,840,53,9,147,1096,9,180,112,198,189,310,1377.0628823523223,2344.2951515085324,4.95,11604.260999967235,644.6811666648464,0.7814317171695108
2ffbe41ae526b5367fca798e405fceab9bc57228,/Users/sanika/Downloads/Master Thesis/repo_updated/pytest/testing/test_runner.py,1929,ModificationType.MODIFY,1043,504,840,53,9,147,1096,9,180,112,198,189,310,1377.0628823523223,2344.2951515085324,4.95,11604.260999967235,644.6811666648464,0.7814317171695108
2ffbe41ae526b5367fca798e405fceab9bc57228,/Users/sanika/Downloads/Master Thesis/repo_updated/pytest/src/_pytest/runner.py,1929,ModificationType.MODIFY,383,288,292,26,6,62,409,11,65,38,67,76,105,429.5076556518598,656.0323889115765,5.6692307692307695,3719.199004829476,206.6221669349709,0.2186774629705255
f1ac0eeef0c7fd504dc7a87c72a35730857363fc,/Users/sanika/Downloads/Master Thesis/repo_updated/pytest/testing/test_runner.py,1929,ModificationType.MODIFY,1043,504,840,53,9,147,1096,9,180,112,198,189,310,1377.0628823523223,2344.2951515085324,4.95,11604.260999967235,644.6811666648464,0.7814317171695108
f1ac0eeef0c7fd504dc7a87c72a35730857363fc,/Users/sanika/Downloads/Master Thesis/repo_updated/pytest/src/_pytest/runner.py,1929,ModificationType.MODIFY,383,288,292,26,6,62,409,11,65,38,67,76,105,429.5076556518598,656.0323889115765,5.6692307692307695,3719.199004829476,206.6221669349709,0.2186774629705255
f1ac0eeef0c7fd504dc7a87c72a35730857363fc,/Users/sanika/Downloads/Master Thesis/repo_updated/pytest/testing/test_runner.py,3448,ModificationType.MODIFY,1043,504,840,53,9,147,1096,9,180,112,198,189,310,1377.0628823523223,2344.2951515085324,4.95,11604.260999967235,644.6811666648464,0.7814317171695108
8b7aeefd7d57a5885017450b09e2b12203d6aede,/Users/sanika/Downloads/Master Thesis/repo_updated/pytest/doc/en/conf.py,322,ModificationType.MODIFY,382,65,130,157,2,92,539,4,10,5,10,14,15,41.219280948873624,57.110323830864054,2.0,114.22064766172811,6.345591536762672,0.019036774610288017
2344982d7fec6c37727288621d3d3dbf7291f53b,/Users/sanika/Downloads/Master Thesis/repo_updated/pytest/testing/test_main.py,3551,ModificationType.MODIFY,77,34,69,0,0,8,77,3,24,16,29,27,45,114.79398751947123,213.9699375973561,1.8125,387.82051189520797,21.54558399417822,0.07132331253245204
2344982d7fec6c37727288621d3d3dbf7291f53b,/Users/sanika/Downloads/Master Thesis/repo_updated/pytest/src/_pytest/main.py,3551,ModificationType.MODIFY,712,438,573,51,9,84,763,14,102,71,128,116,199,733.8903537898989,1364.7382180303869,8.784313725490197,11988.28866034536,666.0160366858534,0.45491273934346227
2344982d7fec6c37727288621d3d3dbf7291f53b,/Users/sanika/Downloads/Master Thesis/repo_updated/pytest/testing/test_main.py,216,ModificationType.ADD,77,34,69,0,0,8,77,3,24,16,29,27,45,114.79398751947123,213.9699375973561,1.8125,387.82051189520797,21.54558399417822,0.07132331253245204
1f736a663d6bd9c7a1a99dc970d70367863810a8,/Users/sanika/Downloads/Master Thesis/repo_updated/pytest/testing/test_terminal.py,6420,ModificationType.MODIFY,1943,715,1694,26,18,214,1969,12,185,120,237,197,357,1436.3251202041715,2721.0724995459263,7.686486486486486,20915.486996509768,1161.971499806098,0.9070241665153088
1f736a663d6bd9c7a1a99dc970d70367863810a8,/Users/sanika/Downloads/Master Thesis/repo_updated/pytest/src/_pytest/terminal.py,6420,ModificationType.MODIFY,1168,838,957,57,25,144,1225,19,348,224,416,367,640,3018.854959310786,5452.5672018196565,11.35632183908046,61921.107993078396,3440.061555171022,1.8175224006065522
a7268aaa5df737bbea8afd81470d2f750c9abc2e,/Users/sanika/Downloads/Master Thesis/repo_updated/pytest/testing/test_main.py,3551,ModificationType.MODIFY,77,34,69,0,0,8,77,3,24,16,29,27,45,114.79398751947123,213.9699375973561,1.8125,387.82051189520797,21.54558399417822,0.07132331253245204
a7268aaa5df737bbea8afd81470d2f750c9abc2e,/Users/sanika/Downloads/Master Thesis/repo_updated/pytest/src/_pytest/main.py,3551,ModificationType.MODIFY,712,438,573,51,9,84,763,14,102,71,128,116,199,733.8903537898989,1364.7382180303869,8.784313725490197,11988.28866034536,666.0160366858534,0.45491273934346227
a7268aaa5df737bbea8afd81470d2f750c9abc2e,/Users/sanika/Downloads/Master Thesis/repo_updated/pytest/testing/test_main.py,216,ModificationType.ADD,77,34,69,0,0,8,77,3,24,16,29,27,45,114.79398751947123,213.9699375973561,1.8125,387.82051189520797,21.54558399417822,0.07132331253245204
0601f5cdad56a3e64cf15618ee2856a49aab58cd,/Users/sanika/Downloads/Master Thesis/repo_updated/pytest/testing/test_terminal.py,6420,ModificationType.MODIFY,1943,715,1694,26,18,214,1969,12,185,120,237,197,357,1436.3251202041715,2721.0724995459263,7.686486486486486,20915.486996509768,1161.971499806098,0.9070241665153088
0601f5cdad56a3e64cf15618ee2856a49aab58cd,/Users/sanika/Downloads/Master Thesis/repo_updated/pytest/src/_pytest/terminal.py,6420,ModificationType.MODIFY,1168,838,957,57,25,144,1225,19,348,224,416,367,640,3018.854959310786,5452.5672018196565,11.35632183908046,61921.107993078396,3440.061555171022,1.8175224006065522
5e097970df24a47a5944f29a6dca1eb1219b5b8e,/Users/sanika/Downloads/Master Thesis/repo_updated/pytest/testing/test_doctest.py,2771,ModificationType.MODIFY,1455,414,1257,16,76,112,1471,5,41,23,46,46,69,231.26927266377825,381.1257749679339,2.8048780487804876,1069.0113200320097,59.389517779556094,0.1270419249893113
5e097970df24a47a5944f29a6dca1eb1219b5b8e,/Users/sanika/Downloads/Master Thesis/repo_updated/pytest/src/_pytest/doctest.py,2771,ModificationType.MODIFY,669,365,481,22,61,110,691,15,103,63,122,118,185,747.3129132339992,1273.2889641319407,8.883495145631068,11311.256331851706,628.403129547317,0.4244296547106469
5e097970df24a47a5944f29a6dca1eb1219b5b8e,/Users/sanika/Downloads/Master Thesis/repo_updated/pytest/testing/test_doctest.py,3818,ModificationType.MODIFY,1455,414,1257,16,76,112,1471,5,41,23,46,46,69,231.26927266377825,381.1257749679339,2.8048780487804876,1069.0113200320097,59.389517779556094,0.1270419249893113
d1eb89d6940d3081876f663622017d8952e77a80,/Users/sanika/Downloads/Master Thesis/repo_updated/pytest/testing/test_doctest.py,2771,ModificationType.MODIFY,1455,414,1257,16,76,112,1471,5,41,23,46,46,69,231.26927266377825,381.1257749679339,2.8048780487804876,1069.0113200320097,59.389517779556094,0.1270419249893113
d1eb89d6940d3081876f663622017d8952e77a80,/Users/sanika/Downloads/Master Thesis/repo_updated/pytest/src/_pytest/doctest.py,2771,ModificationType.MODIFY,669,365,481,22,61,110,691,15,103,63,122,118,185,747.3129132339992,1273.2889641319407,8.883495145631068,11311.256331851706,628.403129547317,0.4244296547106469
d1eb89d6940d3081876f663622017d8952e77a80,/Users/sanika/Downloads/Master Thesis/repo_updated/pytest/testing/test_doctest.py,3818,ModificationType.MODIFY,1455,414,1257,16,76,112,1471,5,41,23,46,46,69,231.26927266377825,381.1257749679339,2.8048780487804876,1069.0113200320097,59.389517779556094,0.1270419249893113
b7bc52f770dd3352cfaf54ed5ec82df382013e2d,/Users/sanika/Downloads/Master Thesis/repo_updated/pytest/testing/example_scripts/collect/package_infinite_recursion/__init__.pyi,5077,ModificationType.MODIFY,0,0,0,0,0,0,0,0,0,0,0,0,0,0,0,0,0,0.0,0.0
b7bc52f770dd3352cfaf54ed5ec82df382013e2d,/Users/sanika/Downloads/Master Thesis/repo_updated/pytest/testing/example_scripts/collect/package_infinite_recursion/tests/__init__.py,5077,ModificationType.MODIFY,0,0,0,0,0,0,0,0,0,0,0,0,0,0,0,0,0,0.0,0.0
b7bc52f770dd3352cfaf54ed5ec82df382013e2d,/Users/sanika/Downloads/Master Thesis/repo_updated/pytest/testing/example_scripts/collect/collect_init_tests/tests/__init__.py,5077,ModificationType.MODIFY,2,2,2,0,0,0,2,0,0,0,0,0,0,0,0,0,0,0.0,0.0
b7bc52f770dd3352cfaf54ed5ec82df382013e2d,/Users/sanika/Downloads/Master Thesis/repo_updated/pytest/testing/example_scripts/collect/package_init_given_as_arg/pkg/__init__.py,5077,ModificationType.MODIFY,0,0,0,0,0,0,0,0,0,0,0,0,0,0,0,0,0,0.0,0.0
b7bc52f770dd3352cfaf54ed5ec82df382013e2d,/Users/sanika/Downloads/Master Thesis/repo_updated/pytest/testing/example_scripts/conftest_usageerror/__init__.pyi,5077,ModificationType.MODIFY,0,0,0,0,0,0,0,0,0,0,0,0,0,0,0,0,0,0.0,0.0
b7bc52f770dd3352cfaf54ed5ec82df382013e2d,/Users/sanika/Downloads/Master Thesis/repo_updated/pytest/testing/example_scripts/marks/marks_considered_keywords/__init__.pyi,5077,ModificationType.MODIFY,0,0,0,0,0,0,0,0,0,0,0,0,0,0,0,0,0,0.0,0.0
b7bc52f770dd3352cfaf54ed5ec82df382013e2d,/Users/sanika/Downloads/Master Thesis/repo_updated/pytest/testing/example_scripts/config/collect_pytest_prefix/__init__.pyi,5077,ModificationType.MODIFY,0,0,0,0,0,0,0,0,0,0,0,0,0,0,0,0,0,0.0,0.0
b7bc52f770dd3352cfaf54ed5ec82df382013e2d,/Users/sanika/Downloads/Master Thesis/repo_updated/pytest/testing/example_scripts/issue88_initial_file_multinodes/__init__.pyi,5077,ModificationType.MODIFY,0,0,0,0,0,0,0,0,0,0,0,0,0,0,0,0,0,0.0,0.0
b7bc52f770dd3352cfaf54ed5ec82df382013e2d,/Users/sanika/Downloads/Master Thesis/repo_updated/pytest/testing/example_scripts/fixtures/fill_fixtures/test_extend_fixture_conftest_conftest/__init__.pyi,5077,ModificationType.MODIFY,0,0,0,0,0,0,0,0,0,0,0,0,0,0,0,0,0,0.0,0.0
b7bc52f770dd3352cfaf54ed5ec82df382013e2d,/Users/sanika/Downloads/Master Thesis/repo_updated/pytest/testing/example_scripts/fixtures/fill_fixtures/test_extend_fixture_conftest_conftest/pkg/__init__.py,5077,ModificationType.MODIFY,0,0,0,0,0,0,0,0,0,0,0,0,0,0,0,0,0,0.0,0.0
b7bc52f770dd3352cfaf54ed5ec82df382013e2d,/Users/sanika/Downloads/Master Thesis/repo_updated/pytest/testing/example_scripts/fixtures/fill_fixtures/test_extend_fixture_conftest_module/__init__.pyi,5077,ModificationType.MODIFY,0,0,0,0,0,0,0,0,0,0,0,0,0,0,0,0,0,0.0,0.0
b7bc52f770dd3352cfaf54ed5ec82df382013e2d,/Users/sanika/Downloads/Master Thesis/repo_updated/pytest/testing/example_scripts/fixtures/fill_fixtures/test_conftest_funcargs_only_available_in_subdir/sub1/__init__.py,5077,ModificationType.MODIFY,0,0,0,0,0,0,0,0,0,0,0,0,0,0,0,0,0,0.0,0.0
b7bc52f770dd3352cfaf54ed5ec82df382013e2d,/Users/sanika/Downloads/Master Thesis/repo_updated/pytest/testing/example_scripts/fixtures/fill_fixtures/test_conftest_funcargs_only_available_in_subdir/sub2/__init__.py,5077,ModificationType.MODIFY,0,0,0,0,0,0,0,0,0,0,0,0,0,0,0,0,0,0.0,0.0
b7bc52f770dd3352cfaf54ed5ec82df382013e2d,/Users/sanika/Downloads/Master Thesis/repo_updated/pytest/testing/example_scripts/fixtures/custom_item/__init__.pyi,5077,ModificationType.MODIFY,0,0,0,0,0,0,0,0,0,0,0,0,0,0,0,0,0,0.0,0.0
b7bc52f770dd3352cfaf54ed5ec82df382013e2d,/Users/sanika/Downloads/Master Thesis/repo_updated/pytest/testing/example_scripts/fixtures/custom_item/foo/__init__.py,5077,ModificationType.MODIFY,0,0,0,0,0,0,0,0,0,0,0,0,0,0,0,0,0,0.0,0.0
b7bc52f770dd3352cfaf54ed5ec82df382013e2d,/Users/sanika/Downloads/Master Thesis/repo_updated/pytest/doc/en/example/nonpython/__init__.py,5077,ModificationType.MODIFY,0,0,0,0,0,0,0,0,0,0,0,0,0,0,0,0,0,0.0,0.0
b7bc52f770dd3352cfaf54ed5ec82df382013e2d,/Users/sanika/Downloads/Master Thesis/repo_updated/pytest/src/pytest/__init__.py,5077,ModificationType.MODIFY,99,48,90,1,3,5,100,0,0,0,0,0,0,0,0,0,0,0.0,0.0
b7bc52f770dd3352cfaf54ed5ec82df382013e2d,/Users/sanika/Downloads/Master Thesis/repo_updated/pytest/src/_pytest/__init__.py,5077,ModificationType.MODIFY,8,5,5,2,0,1,10,0,0,0,0,0,0,0,0,0,0,0.0,0.0
b7bc52f770dd3352cfaf54ed5ec82df382013e2d,/Users/sanika/Downloads/Master Thesis/repo_updated/pytest/src/_pytest/config/__init__.py,5077,ModificationType.MODIFY,1217,716,841,84,126,174,1301,14,185,118,215,199,333,1446.608539104324,2542.995998641035,8.135135135135135,20687.616097052745,1149.3120053918192,0.847665332880345
b7bc52f770dd3352cfaf54ed5ec82df382013e2d,/Users/sanika/Downloads/Master Thesis/repo_updated/pytest/src/_pytest/mark/__init__.py,5077,ModificationType.MODIFY,160,89,115,0,13,31,160,7,15,11,17,22,28,78.25484338853101,124.86408532184433,3.966666666666667,495.2942051099825,27.51634472833236,0.04162136177394811
b7bc52f770dd3352cfaf54ed5ec82df382013e2d,/Users/sanika/Downloads/Master Thesis/repo_updated/pytest/src/_pytest/_code/__init__.py,5077,ModificationType.MODIFY,10,10,9,9,0,0,19,0,0,0,0,0,0,0,0,0,0,0.0,0.0
b7bc52f770dd3352cfaf54ed5ec82df382013e2d,/Users/sanika/Downloads/Master Thesis/repo_updated/pytest/src/_pytest/assertion/__init__.py,5077,ModificationType.MODIFY,173,84,99,8,29,36,181,5,12,7,13,17,20,54.62919048309069,81.7492568250068,2.7083333333333335,221.4042372343934,12.300235401910745,0.027249752275002266
b7bc52f770dd3352cfaf54ed5ec82df382013e2d,/Users/sanika/Downloads/Master Thesis/repo_updated/pytest/src/_pytest/_io/__init__.py,5077,ModificationType.MODIFY,3,1,1,3,0,0,6,0,0,0,0,0,0,0,0,0,0,0.0,0.0
f9f092a5e6dc27d28b220fde75b348f086ef85c0,/Users/sanika/Downloads/Master Thesis/repo_updated/pytest/testing/test_junitxml.py,3203,ModificationType.MODIFY,1523,757,1297,19,12,193,1542,12,193,117,230,205,347,1508.3637582013935,2664.7795945283897,7.150259067357513,19053.864458285894,1058.5480254603274,0.8882598648427965
f9f092a5e6dc27d28b220fde75b348f086ef85c0,/Users/sanika/Downloads/Master Thesis/repo_updated/pytest/src/_pytest/junitxml.py,3203,ModificationType.MODIFY,701,378,504,33,58,109,734,13,110,68,126,123,194,794.0552848235468,1346.8478140358125,7.445454545454545,10027.894179048459,557.1052321693588,0.4489492713452708
f9f092a5e6dc27d28b220fde75b348f086ef85c0,/Users/sanika/Downloads/Master Thesis/repo_updated/pytest/testing/test_junitxml.py,5827,ModificationType.MODIFY,1523,757,1297,19,12,193,1542,12,193,117,230,205,347,1508.3637582013935,2664.7795945283897,7.150259067357513,19053.864458285894,1058.5480254603274,0.8882598648427965
2d24c062b6c1beb914399174c1fd9190f6093371,/Users/sanika/Downloads/Master Thesis/repo_updated/pytest/testing/test_junitxml.py,3209,ModificationType.MODIFY,1523,757,1297,19,12,193,1542,12,193,117,230,205,347,1508.3637582013935,2664.7795945283897,7.150259067357513,19053.864458285894,1058.5480254603274,0.8882598648427965
2d24c062b6c1beb914399174c1fd9190f6093371,/Users/sanika/Downloads/Master Thesis/repo_updated/pytest/src/_pytest/junitxml.py,3209,ModificationType.MODIFY,701,378,504,33,58,109,734,13,110,68,126,123,194,794.0552848235468,1346.8478140358125,7.445454545454545,10027.894179048459,557.1052321693588,0.4489492713452708
ed67312bca2b8b51c6b309df1201be0f89bbb6ae,/Users/sanika/Downloads/Master Thesis/repo_updated/pytest/testing/example_scripts/collect/package_infinite_recursion/__init__.pyi,5077,ModificationType.MODIFY,0,0,0,0,0,0,0,0,0,0,0,0,0,0,0,0,0,0.0,0.0
ed67312bca2b8b51c6b309df1201be0f89bbb6ae,/Users/sanika/Downloads/Master Thesis/repo_updated/pytest/testing/example_scripts/collect/package_infinite_recursion/tests/__init__.py,5077,ModificationType.MODIFY,0,0,0,0,0,0,0,0,0,0,0,0,0,0,0,0,0,0.0,0.0
ed67312bca2b8b51c6b309df1201be0f89bbb6ae,/Users/sanika/Downloads/Master Thesis/repo_updated/pytest/testing/example_scripts/collect/collect_init_tests/tests/__init__.py,5077,ModificationType.MODIFY,2,2,2,0,0,0,2,0,0,0,0,0,0,0,0,0,0,0.0,0.0
ed67312bca2b8b51c6b309df1201be0f89bbb6ae,/Users/sanika/Downloads/Master Thesis/repo_updated/pytest/testing/example_scripts/collect/package_init_given_as_arg/pkg/__init__.py,5077,ModificationType.MODIFY,0,0,0,0,0,0,0,0,0,0,0,0,0,0,0,0,0,0.0,0.0
ed67312bca2b8b51c6b309df1201be0f89bbb6ae,/Users/sanika/Downloads/Master Thesis/repo_updated/pytest/testing/example_scripts/conftest_usageerror/__init__.pyi,5077,ModificationType.MODIFY,0,0,0,0,0,0,0,0,0,0,0,0,0,0,0,0,0,0.0,0.0
ed67312bca2b8b51c6b309df1201be0f89bbb6ae,/Users/sanika/Downloads/Master Thesis/repo_updated/pytest/testing/example_scripts/marks/marks_considered_keywords/__init__.pyi,5077,ModificationType.MODIFY,0,0,0,0,0,0,0,0,0,0,0,0,0,0,0,0,0,0.0,0.0
ed67312bca2b8b51c6b309df1201be0f89bbb6ae,/Users/sanika/Downloads/Master Thesis/repo_updated/pytest/testing/example_scripts/config/collect_pytest_prefix/__init__.pyi,5077,ModificationType.MODIFY,0,0,0,0,0,0,0,0,0,0,0,0,0,0,0,0,0,0.0,0.0
ed67312bca2b8b51c6b309df1201be0f89bbb6ae,/Users/sanika/Downloads/Master Thesis/repo_updated/pytest/testing/example_scripts/issue88_initial_file_multinodes/__init__.pyi,5077,ModificationType.MODIFY,0,0,0,0,0,0,0,0,0,0,0,0,0,0,0,0,0,0.0,0.0
ed67312bca2b8b51c6b309df1201be0f89bbb6ae,/Users/sanika/Downloads/Master Thesis/repo_updated/pytest/testing/example_scripts/fixtures/fill_fixtures/test_extend_fixture_conftest_conftest/__init__.pyi,5077,ModificationType.MODIFY,0,0,0,0,0,0,0,0,0,0,0,0,0,0,0,0,0,0.0,0.0
ed67312bca2b8b51c6b309df1201be0f89bbb6ae,/Users/sanika/Downloads/Master Thesis/repo_updated/pytest/testing/example_scripts/fixtures/fill_fixtures/test_extend_fixture_conftest_conftest/pkg/__init__.py,5077,ModificationType.MODIFY,0,0,0,0,0,0,0,0,0,0,0,0,0,0,0,0,0,0.0,0.0
ed67312bca2b8b51c6b309df1201be0f89bbb6ae,/Users/sanika/Downloads/Master Thesis/repo_updated/pytest/testing/example_scripts/fixtures/fill_fixtures/test_extend_fixture_conftest_module/__init__.pyi,5077,ModificationType.MODIFY,0,0,0,0,0,0,0,0,0,0,0,0,0,0,0,0,0,0.0,0.0
ed67312bca2b8b51c6b309df1201be0f89bbb6ae,/Users/sanika/Downloads/Master Thesis/repo_updated/pytest/testing/example_scripts/fixtures/fill_fixtures/test_conftest_funcargs_only_available_in_subdir/sub1/__init__.py,5077,ModificationType.MODIFY,0,0,0,0,0,0,0,0,0,0,0,0,0,0,0,0,0,0.0,0.0
ed67312bca2b8b51c6b309df1201be0f89bbb6ae,/Users/sanika/Downloads/Master Thesis/repo_updated/pytest/testing/example_scripts/fixtures/fill_fixtures/test_conftest_funcargs_only_available_in_subdir/sub2/__init__.py,5077,ModificationType.MODIFY,0,0,0,0,0,0,0,0,0,0,0,0,0,0,0,0,0,0.0,0.0
ed67312bca2b8b51c6b309df1201be0f89bbb6ae,/Users/sanika/Downloads/Master Thesis/repo_updated/pytest/testing/example_scripts/fixtures/custom_item/__init__.pyi,5077,ModificationType.MODIFY,0,0,0,0,0,0,0,0,0,0,0,0,0,0,0,0,0,0.0,0.0
ed67312bca2b8b51c6b309df1201be0f89bbb6ae,/Users/sanika/Downloads/Master Thesis/repo_updated/pytest/testing/example_scripts/fixtures/custom_item/foo/__init__.py,5077,ModificationType.MODIFY,0,0,0,0,0,0,0,0,0,0,0,0,0,0,0,0,0,0.0,0.0
ed67312bca2b8b51c6b309df1201be0f89bbb6ae,/Users/sanika/Downloads/Master Thesis/repo_updated/pytest/doc/en/example/nonpython/__init__.py,5077,ModificationType.MODIFY,0,0,0,0,0,0,0,0,0,0,0,0,0,0,0,0,0,0.0,0.0
ed67312bca2b8b51c6b309df1201be0f89bbb6ae,/Users/sanika/Downloads/Master Thesis/repo_updated/pytest/src/pytest/__init__.py,5077,ModificationType.MODIFY,99,48,90,1,3,5,100,0,0,0,0,0,0,0,0,0,0,0.0,0.0
ed67312bca2b8b51c6b309df1201be0f89bbb6ae,/Users/sanika/Downloads/Master Thesis/repo_updated/pytest/src/_pytest/__init__.py,5077,ModificationType.MODIFY,8,5,5,2,0,1,10,0,0,0,0,0,0,0,0,0,0,0.0,0.0
ed67312bca2b8b51c6b309df1201be0f89bbb6ae,/Users/sanika/Downloads/Master Thesis/repo_updated/pytest/src/_pytest/config/__init__.py,5077,ModificationType.MODIFY,1217,716,841,84,126,174,1301,14,185,118,215,199,333,1446.608539104324,2542.995998641035,8.135135135135135,20687.616097052745,1149.3120053918192,0.847665332880345
ed67312bca2b8b51c6b309df1201be0f89bbb6ae,/Users/sanika/Downloads/Master Thesis/repo_updated/pytest/src/_pytest/mark/__init__.py,5077,ModificationType.MODIFY,160,89,115,0,13,31,160,7,15,11,17,22,28,78.25484338853101,124.86408532184433,3.966666666666667,495.2942051099825,27.51634472833236,0.04162136177394811
ed67312bca2b8b51c6b309df1201be0f89bbb6ae,/Users/sanika/Downloads/Master Thesis/repo_updated/pytest/src/_pytest/_code/__init__.py,5077,ModificationType.MODIFY,10,10,9,9,0,0,19,0,0,0,0,0,0,0,0,0,0,0.0,0.0
ed67312bca2b8b51c6b309df1201be0f89bbb6ae,/Users/sanika/Downloads/Master Thesis/repo_updated/pytest/src/_pytest/assertion/__init__.py,5077,ModificationType.MODIFY,173,84,99,8,29,36,181,5,12,7,13,17,20,54.62919048309069,81.7492568250068,2.7083333333333335,221.4042372343934,12.300235401910745,0.027249752275002266
ed67312bca2b8b51c6b309df1201be0f89bbb6ae,/Users/sanika/Downloads/Master Thesis/repo_updated/pytest/src/_pytest/_io/__init__.py,5077,ModificationType.MODIFY,3,1,1,3,0,0,6,0,0,0,0,0,0,0,0,0,0,0.0,0.0
69ad2026f606b2b9d6ea018aa37b10a8c7bf379c,/Users/sanika/Downloads/Master Thesis/repo_updated/pytest/testing/example_scripts/collect/package_infinite_recursion/__init__.pyi,5077,ModificationType.MODIFY,0,0,0,0,0,0,0,0,0,0,0,0,0,0,0,0,0,0.0,0.0
69ad2026f606b2b9d6ea018aa37b10a8c7bf379c,/Users/sanika/Downloads/Master Thesis/repo_updated/pytest/testing/example_scripts/collect/package_infinite_recursion/tests/__init__.py,5077,ModificationType.MODIFY,0,0,0,0,0,0,0,0,0,0,0,0,0,0,0,0,0,0.0,0.0
69ad2026f606b2b9d6ea018aa37b10a8c7bf379c,/Users/sanika/Downloads/Master Thesis/repo_updated/pytest/testing/example_scripts/collect/collect_init_tests/tests/__init__.py,5077,ModificationType.MODIFY,2,2,2,0,0,0,2,0,0,0,0,0,0,0,0,0,0,0.0,0.0
69ad2026f606b2b9d6ea018aa37b10a8c7bf379c,/Users/sanika/Downloads/Master Thesis/repo_updated/pytest/testing/example_scripts/collect/package_init_given_as_arg/pkg/__init__.py,5077,ModificationType.MODIFY,0,0,0,0,0,0,0,0,0,0,0,0,0,0,0,0,0,0.0,0.0
69ad2026f606b2b9d6ea018aa37b10a8c7bf379c,/Users/sanika/Downloads/Master Thesis/repo_updated/pytest/testing/example_scripts/conftest_usageerror/__init__.pyi,5077,ModificationType.MODIFY,0,0,0,0,0,0,0,0,0,0,0,0,0,0,0,0,0,0.0,0.0
69ad2026f606b2b9d6ea018aa37b10a8c7bf379c,/Users/sanika/Downloads/Master Thesis/repo_updated/pytest/testing/example_scripts/marks/marks_considered_keywords/__init__.pyi,5077,ModificationType.MODIFY,0,0,0,0,0,0,0,0,0,0,0,0,0,0,0,0,0,0.0,0.0
69ad2026f606b2b9d6ea018aa37b10a8c7bf379c,/Users/sanika/Downloads/Master Thesis/repo_updated/pytest/testing/example_scripts/config/collect_pytest_prefix/__init__.pyi,5077,ModificationType.MODIFY,0,0,0,0,0,0,0,0,0,0,0,0,0,0,0,0,0,0.0,0.0
69ad2026f606b2b9d6ea018aa37b10a8c7bf379c,/Users/sanika/Downloads/Master Thesis/repo_updated/pytest/testing/example_scripts/issue88_initial_file_multinodes/__init__.pyi,5077,ModificationType.MODIFY,0,0,0,0,0,0,0,0,0,0,0,0,0,0,0,0,0,0.0,0.0
69ad2026f606b2b9d6ea018aa37b10a8c7bf379c,/Users/sanika/Downloads/Master Thesis/repo_updated/pytest/testing/example_scripts/fixtures/fill_fixtures/test_extend_fixture_conftest_conftest/__init__.pyi,5077,ModificationType.MODIFY,0,0,0,0,0,0,0,0,0,0,0,0,0,0,0,0,0,0.0,0.0
69ad2026f606b2b9d6ea018aa37b10a8c7bf379c,/Users/sanika/Downloads/Master Thesis/repo_updated/pytest/testing/example_scripts/fixtures/fill_fixtures/test_extend_fixture_conftest_conftest/pkg/__init__.py,5077,ModificationType.MODIFY,0,0,0,0,0,0,0,0,0,0,0,0,0,0,0,0,0,0.0,0.0
69ad2026f606b2b9d6ea018aa37b10a8c7bf379c,/Users/sanika/Downloads/Master Thesis/repo_updated/pytest/testing/example_scripts/fixtures/fill_fixtures/test_extend_fixture_conftest_module/__init__.pyi,5077,ModificationType.MODIFY,0,0,0,0,0,0,0,0,0,0,0,0,0,0,0,0,0,0.0,0.0
69ad2026f606b2b9d6ea018aa37b10a8c7bf379c,/Users/sanika/Downloads/Master Thesis/repo_updated/pytest/testing/example_scripts/fixtures/fill_fixtures/test_conftest_funcargs_only_available_in_subdir/sub1/__init__.py,5077,ModificationType.MODIFY,0,0,0,0,0,0,0,0,0,0,0,0,0,0,0,0,0,0.0,0.0
69ad2026f606b2b9d6ea018aa37b10a8c7bf379c,/Users/sanika/Downloads/Master Thesis/repo_updated/pytest/testing/example_scripts/fixtures/fill_fixtures/test_conftest_funcargs_only_available_in_subdir/sub2/__init__.py,5077,ModificationType.MODIFY,0,0,0,0,0,0,0,0,0,0,0,0,0,0,0,0,0,0.0,0.0
69ad2026f606b2b9d6ea018aa37b10a8c7bf379c,/Users/sanika/Downloads/Master Thesis/repo_updated/pytest/testing/example_scripts/fixtures/custom_item/__init__.pyi,5077,ModificationType.MODIFY,0,0,0,0,0,0,0,0,0,0,0,0,0,0,0,0,0,0.0,0.0
69ad2026f606b2b9d6ea018aa37b10a8c7bf379c,/Users/sanika/Downloads/Master Thesis/repo_updated/pytest/testing/example_scripts/fixtures/custom_item/foo/__init__.py,5077,ModificationType.MODIFY,0,0,0,0,0,0,0,0,0,0,0,0,0,0,0,0,0,0.0,0.0
69ad2026f606b2b9d6ea018aa37b10a8c7bf379c,/Users/sanika/Downloads/Master Thesis/repo_updated/pytest/doc/en/example/nonpython/__init__.py,5077,ModificationType.MODIFY,0,0,0,0,0,0,0,0,0,0,0,0,0,0,0,0,0,0.0,0.0
69ad2026f606b2b9d6ea018aa37b10a8c7bf379c,/Users/sanika/Downloads/Master Thesis/repo_updated/pytest/src/pytest/__init__.py,5077,ModificationType.MODIFY,99,48,90,1,3,5,100,0,0,0,0,0,0,0,0,0,0,0.0,0.0
69ad2026f606b2b9d6ea018aa37b10a8c7bf379c,/Users/sanika/Downloads/Master Thesis/repo_updated/pytest/src/_pytest/__init__.py,5077,ModificationType.MODIFY,8,5,5,2,0,1,10,0,0,0,0,0,0,0,0,0,0,0.0,0.0
69ad2026f606b2b9d6ea018aa37b10a8c7bf379c,/Users/sanika/Downloads/Master Thesis/repo_updated/pytest/src/_pytest/config/__init__.py,5077,ModificationType.MODIFY,1217,716,841,84,126,174,1301,14,185,118,215,199,333,1446.608539104324,2542.995998641035,8.135135135135135,20687.616097052745,1149.3120053918192,0.847665332880345
69ad2026f606b2b9d6ea018aa37b10a8c7bf379c,/Users/sanika/Downloads/Master Thesis/repo_updated/pytest/src/_pytest/mark/__init__.py,5077,ModificationType.MODIFY,160,89,115,0,13,31,160,7,15,11,17,22,28,78.25484338853101,124.86408532184433,3.966666666666667,495.2942051099825,27.51634472833236,0.04162136177394811
69ad2026f606b2b9d6ea018aa37b10a8c7bf379c,/Users/sanika/Downloads/Master Thesis/repo_updated/pytest/src/_pytest/_code/__init__.py,5077,ModificationType.MODIFY,10,10,9,9,0,0,19,0,0,0,0,0,0,0,0,0,0,0.0,0.0
69ad2026f606b2b9d6ea018aa37b10a8c7bf379c,/Users/sanika/Downloads/Master Thesis/repo_updated/pytest/src/_pytest/assertion/__init__.py,5077,ModificationType.MODIFY,173,84,99,8,29,36,181,5,12,7,13,17,20,54.62919048309069,81.7492568250068,2.7083333333333335,221.4042372343934,12.300235401910745,0.027249752275002266
69ad2026f606b2b9d6ea018aa37b10a8c7bf379c,/Users/sanika/Downloads/Master Thesis/repo_updated/pytest/src/_pytest/_io/__init__.py,5077,ModificationType.MODIFY,3,1,1,3,0,0,6,0,0,0,0,0,0,0,0,0,0,0.0,0.0
69ad2026f606b2b9d6ea018aa37b10a8c7bf379c,/Users/sanika/Downloads/Master Thesis/repo_updated/pytest/testing/test_doctest.py,2771,ModificationType.MODIFY,1455,414,1257,16,76,112,1471,5,41,23,46,46,69,231.26927266377825,381.1257749679339,2.8048780487804876,1069.0113200320097,59.389517779556094,0.1270419249893113
69ad2026f606b2b9d6ea018aa37b10a8c7bf379c,/Users/sanika/Downloads/Master Thesis/repo_updated/pytest/src/_pytest/doctest.py,2771,ModificationType.MODIFY,669,365,481,22,61,110,691,15,103,63,122,118,185,747.3129132339992,1273.2889641319407,8.883495145631068,11311.256331851706,628.403129547317,0.4244296547106469
69ad2026f606b2b9d6ea018aa37b10a8c7bf379c,/Users/sanika/Downloads/Master Thesis/repo_updated/pytest/testing/test_terminal.py,6420,ModificationType.MODIFY,1943,715,1694,26,18,214,1969,12,185,120,237,197,357,1436.3251202041715,2721.0724995459263,7.686486486486486,20915.486996509768,1161.971499806098,0.9070241665153088
69ad2026f606b2b9d6ea018aa37b10a8c7bf379c,/Users/sanika/Downloads/Master Thesis/repo_updated/pytest/src/_pytest/terminal.py,6420,ModificationType.MODIFY,1168,838,957,57,25,144,1225,19,348,224,416,367,640,3018.854959310786,5452.5672018196565,11.35632183908046,61921.107993078396,3440.061555171022,1.8175224006065522
69ad2026f606b2b9d6ea018aa37b10a8c7bf379c,/Users/sanika/Downloads/Master Thesis/repo_updated/pytest/testing/test_doctest.py,3818,ModificationType.MODIFY,1455,414,1257,16,76,112,1471,5,41,23,46,46,69,231.26927266377825,381.1257749679339,2.8048780487804876,1069.0113200320097,59.389517779556094,0.1270419249893113
b66dc800081bff90b82b6e3649da5838c7531089,/Users/sanika/Downloads/Master Thesis/repo_updated/pytest/testing/test_junitxml.py,3203,ModificationType.MODIFY,1523,757,1297,19,12,193,1542,12,193,117,230,205,347,1508.3637582013935,2664.7795945283897,7.150259067357513,19053.864458285894,1058.5480254603274,0.8882598648427965
b66dc800081bff90b82b6e3649da5838c7531089,/Users/sanika/Downloads/Master Thesis/repo_updated/pytest/src/_pytest/junitxml.py,3203,ModificationType.MODIFY,701,378,504,33,58,109,734,13,110,68,126,123,194,794.0552848235468,1346.8478140358125,7.445454545454545,10027.894179048459,557.1052321693588,0.4489492713452708
b66dc800081bff90b82b6e3649da5838c7531089,/Users/sanika/Downloads/Master Thesis/repo_updated/pytest/testing/test_junitxml.py,5827,ModificationType.MODIFY,1523,757,1297,19,12,193,1542,12,193,117,230,205,347,1508.3637582013935,2664.7795945283897,7.150259067357513,19053.864458285894,1058.5480254603274,0.8882598648427965
31d5cedc6d087d7f5932e8f53e968c15d72fa463,/Users/sanika/Downloads/Master Thesis/repo_updated/pytest/testing/test_junitxml.py,3209,ModificationType.MODIFY,1523,757,1297,19,12,193,1542,12,193,117,230,205,347,1508.3637582013935,2664.7795945283897,7.150259067357513,19053.864458285894,1058.5480254603274,0.8882598648427965
31d5cedc6d087d7f5932e8f53e968c15d72fa463,/Users/sanika/Downloads/Master Thesis/repo_updated/pytest/src/_pytest/junitxml.py,3209,ModificationType.MODIFY,701,378,504,33,58,109,734,13,110,68,126,123,194,794.0552848235468,1346.8478140358125,7.445454545454545,10027.894179048459,557.1052321693588,0.4489492713452708
209d99102da374bc2b445d08fba4c893d47a7a2a,/Users/sanika/Downloads/Master Thesis/repo_updated/pytest/testing/test_assertrewrite.py,5498,ModificationType.MODIFY,1660,832,1314,41,38,274,1701,20,312,209,395,332,604,2671.484054182769,5058.523816533542,12.66025641025641,64042.2085747035,3557.900476372417,1.6861746055111808
209d99102da374bc2b445d08fba4c893d47a7a2a,/Users/sanika/Downloads/Master Thesis/repo_updated/pytest/src/_pytest/assertion/rewrite.py,5498,ModificationType.MODIFY,1057,646,719,113,100,145,1170,18,215,134,248,233,382,1740.9201126876956,3004.119107257935,10.38139534883721,31186.948127440515,1732.608229302251,1.001373035752645
209d99102da374bc2b445d08fba4c893d47a7a2a,/Users/sanika/Downloads/Master Thesis/repo_updated/pytest/testing/test_warnings.py,1597,ModificationType.MODIFY,601,196,481,2,23,85,603,8,63,36,72,71,108,400.56863518049477,664.1726889065056,4.571428571428571,3036.21800642974,168.67877813498555,0.22139089630216854
d3ab56f531f7419fb1bfe037244a96fa3ddf765c,/Users/sanika/Downloads/Master Thesis/repo_updated/pytest/doc/en/conf.py,458,ModificationType.MODIFY,382,65,130,157,2,92,539,4,10,5,10,14,15,41.219280948873624,57.110323830864054,2.0,114.22064766172811,6.345591536762672,0.019036774610288017
d3ab56f531f7419fb1bfe037244a96fa3ddf765c,/Users/sanika/Downloads/Master Thesis/repo_updated/pytest/scripts/release.py,567,ModificationType.MODIFY,124,78,88,2,3,26,126,4,13,7,13,17,20,56.105716335834195,81.7492568250068,2.0,163.4985136500136,9.083250758334088,0.027249752275002266
277857b026fbc4a5150b0e75b14660a2768e6d74,/Users/sanika/Downloads/Master Thesis/repo_updated/pytest/doc/en/conf.py,458,ModificationType.MODIFY,382,65,130,157,2,92,539,4,10,5,10,14,15,41.219280948873624,57.110323830864054,2.0,114.22064766172811,6.345591536762672,0.019036774610288017
277857b026fbc4a5150b0e75b14660a2768e6d74,/Users/sanika/Downloads/Master Thesis/repo_updated/pytest/scripts/release.py,567,ModificationType.MODIFY,124,78,88,2,3,26,126,4,13,7,13,17,20,56.105716335834195,81.7492568250068,2.0,163.4985136500136,9.083250758334088,0.027249752275002266
172b82875a2c3c1052938a300bc97d8cfb9688ab,/Users/sanika/Downloads/Master Thesis/repo_updated/pytest/testing/test_cacheprovider.py,2116,ModificationType.MODIFY,996,429,845,24,10,117,1020,7,76,50,88,83,138,494.49397547611574,879.7554415258757,4.052631578947368,3565.3246840785487,198.07359355991937,0.29325181384195853
172b82875a2c3c1052938a300bc97d8cfb9688ab,/Users/sanika/Downloads/Master Thesis/repo_updated/pytest/src/_pytest/cacheprovider.py,2116,ModificationType.MODIFY,456,277,329,12,42,72,468,13,85,50,97,98,147,592.903945907539,972.3623470849358,7.41764705882353,7212.640703965318,400.70226133140653,0.32412078236164527
172b82875a2c3c1052938a300bc97d8cfb9688ab,/Users/sanika/Downloads/Master Thesis/repo_updated/pytest/testing/test_cacheprovider.py,3888,ModificationType.MODIFY,996,429,845,24,10,117,1020,7,76,50,88,83,138,494.49397547611574,879.7554415258757,4.052631578947368,3565.3246840785487,198.07359355991937,0.29325181384195853
23f6adc760cbeb78b71e2c82cf106f48535efa82,/Users/sanika/Downloads/Master Thesis/repo_updated/pytest/testing/test_cacheprovider.py,2116,ModificationType.MODIFY,996,429,845,24,10,117,1020,7,76,50,88,83,138,494.49397547611574,879.7554415258757,4.052631578947368,3565.3246840785487,198.07359355991937,0.29325181384195853
23f6adc760cbeb78b71e2c82cf106f48535efa82,/Users/sanika/Downloads/Master Thesis/repo_updated/pytest/src/_pytest/cacheprovider.py,2116,ModificationType.MODIFY,456,277,329,12,42,72,468,13,85,50,97,98,147,592.903945907539,972.3623470849358,7.41764705882353,7212.640703965318,400.70226133140653,0.32412078236164527
23f6adc760cbeb78b71e2c82cf106f48535efa82,/Users/sanika/Downloads/Master Thesis/repo_updated/pytest/testing/test_cacheprovider.py,3888,ModificationType.MODIFY,996,429,845,24,10,117,1020,7,76,50,88,83,138,494.49397547611574,879.7554415258757,4.052631578947368,3565.3246840785487,198.07359355991937,0.29325181384195853
d2d7b97a70c1e9dce9e2018c885a4e4203fadf64,/Users/sanika/Downloads/Master Thesis/repo_updated/pytest/testing/conftest.py,,ModificationType.DELETE,127,75,83,2,11,30,129,4,14,7,14,18,21,61.30296890880645,87.56842503028855,2.0,175.1368500605771,9.729825003365395,0.029189475010096184
d2d7b97a70c1e9dce9e2018c885a4e4203fadf64,/Users/sanika/Downloads/Master Thesis/repo_updated/pytest/testing/test_conftest.py,,ModificationType.DELETE,652,304,544,16,6,88,668,6,89,51,101,95,152,591.8500503603364,998.6180524663041,3.404494382022472,3399.7895494077547,188.8771971893197,0.3328726841554347
d2d7b97a70c1e9dce9e2018c885a4e4203fadf64,/Users/sanika/Downloads/Master Thesis/repo_updated/pytest/testing/example_scripts/collect/package_infinite_recursion/conftest.py,,ModificationType.DELETE,2,2,2,0,0,0,2,0,0,0,0,0,0,0,0,0,0,0.0,0.0
d2d7b97a70c1e9dce9e2018c885a4e4203fadf64,/Users/sanika/Downloads/Master Thesis/repo_updated/pytest/testing/example_scripts/conftest_usageerror/conftest.py,,ModificationType.DELETE,8,5,5,0,0,3,8,0,0,0,0,0,0,0,0,0,0,0.0,0.0
d2d7b97a70c1e9dce9e2018c885a4e4203fadf64,/Users/sanika/Downloads/Master Thesis/repo_updated/pytest/testing/example_scripts/marks/marks_considered_keywords/conftest.py,,ModificationType.DELETE,0,0,0,0,0,0,0,0,0,0,0,0,0,0,0,0,0,0.0,0.0
d2d7b97a70c1e9dce9e2018c885a4e4203fadf64,/Users/sanika/Downloads/Master Thesis/repo_updated/pytest/testing/example_scripts/config/collect_pytest_prefix/conftest.py,,ModificationType.DELETE,2,2,2,0,0,0,2,0,0,0,0,0,0,0,0,0,0,0.0,0.0
d2d7b97a70c1e9dce9e2018c885a4e4203fadf64,/Users/sanika/Downloads/Master Thesis/repo_updated/pytest/testing/example_scripts/issue88_initial_file_multinodes/conftest.py,,ModificationType.DELETE,14,8,8,0,0,6,14,0,0,0,0,0,0,0,0,0,0,0.0,0.0
d2d7b97a70c1e9dce9e2018c885a4e4203fadf64,/Users/sanika/Downloads/Master Thesis/repo_updated/pytest/testing/example_scripts/fixtures/fill_fixtures/test_extend_fixture_conftest_conftest/conftest.py,,ModificationType.DELETE,6,4,4,0,0,2,6,0,0,0,0,0,0,0,0,0,0,0.0,0.0
d2d7b97a70c1e9dce9e2018c885a4e4203fadf64,/Users/sanika/Downloads/Master Thesis/repo_updated/pytest/testing/example_scripts/fixtures/fill_fixtures/test_extend_fixture_conftest_conftest/pkg/conftest.py,,ModificationType.DELETE,6,4,4,0,0,2,6,1,2,1,2,3,3,2.0,4.754887502163469,0.5,2.3774437510817346,0.1320802083934297,0.0015849625007211565
d2d7b97a70c1e9dce9e2018c885a4e4203fadf64,/Users/sanika/Downloads/Master Thesis/repo_updated/pytest/testing/example_scripts/fixtures/fill_fixtures/test_extend_fixture_conftest_module/conftest.py,,ModificationType.DELETE,6,4,4,0,0,2,6,0,0,0,0,0,0,0,0,0,0,0.0,0.0
d2d7b97a70c1e9dce9e2018c885a4e4203fadf64,/Users/sanika/Downloads/Master Thesis/repo_updated/pytest/testing/example_scripts/fixtures/fill_fixtures/test_conftest_funcargs_only_available_in_subdir/sub1/conftest.py,,ModificationType.DELETE,7,5,5,0,0,2,7,0,0,0,0,0,0,0,0,0,0,0.0,0.0
d2d7b97a70c1e9dce9e2018c885a4e4203fadf64,/Users/sanika/Downloads/Master Thesis/repo_updated/pytest/testing/example_scripts/fixtures/fill_fixtures/test_conftest_funcargs_only_available_in_subdir/sub2/conftest.py,,ModificationType.DELETE,6,4,4,0,0,2,6,0,0,0,0,0,0,0,0,0,0,0.0,0.0
d2d7b97a70c1e9dce9e2018c885a4e4203fadf64,/Users/sanika/Downloads/Master Thesis/repo_updated/pytest/testing/example_scripts/fixtures/custom_item/conftest.py,,ModificationType.DELETE,10,6,6,0,0,4,10,0,0,0,0,0,0,0,0,0,0,0.0,0.0
d2d7b97a70c1e9dce9e2018c885a4e4203fadf64,/Users/sanika/Downloads/Master Thesis/repo_updated/pytest/doc/en/conftest.py,,ModificationType.DELETE,1,1,1,0,0,0,1,0,0,0,0,0,0,0,0,0,0,0.0,0.0
d2d7b97a70c1e9dce9e2018c885a4e4203fadf64,/Users/sanika/Downloads/Master Thesis/repo_updated/pytest/doc/en/example/conftest.py,,ModificationType.DELETE,1,1,1,0,0,0,1,0,0,0,0,0,0,0,0,0,0,0.0,0.0
d2d7b97a70c1e9dce9e2018c885a4e4203fadf64,/Users/sanika/Downloads/Master Thesis/repo_updated/pytest/doc/en/example/assertion/global_testmodule_config/conftest.py,,ModificationType.DELETE,14,10,10,0,0,4,14,1,1,1,1,2,2,0.0,2.0,0.5,1.0,0.05555555555555555,0.0006666666666666666
d2d7b97a70c1e9dce9e2018c885a4e4203fadf64,/Users/sanika/Downloads/Master Thesis/repo_updated/pytest/doc/en/example/nonpython/conftest.py,,ModificationType.DELETE,46,26,30,3,0,12,49,3,6,3,6,9,9,20.264662506490406,28.529325012980813,1.5,42.793987519471216,2.377443751081734,0.009509775004326938
256a9e0027f8479d3e9951ffd00e41df00e603d7,/Users/sanika/Downloads/Master Thesis/repo_updated/pytest/testing/conftest.py,,ModificationType.DELETE,127,75,83,2,11,30,129,4,14,7,14,18,21,61.30296890880645,87.56842503028855,2.0,175.1368500605771,9.729825003365395,0.029189475010096184
256a9e0027f8479d3e9951ffd00e41df00e603d7,/Users/sanika/Downloads/Master Thesis/repo_updated/pytest/testing/test_conftest.py,,ModificationType.DELETE,652,304,544,16,6,88,668,6,89,51,101,95,152,591.8500503603364,998.6180524663041,3.404494382022472,3399.7895494077547,188.8771971893197,0.3328726841554347
256a9e0027f8479d3e9951ffd00e41df00e603d7,/Users/sanika/Downloads/Master Thesis/repo_updated/pytest/testing/example_scripts/collect/package_infinite_recursion/conftest.py,,ModificationType.DELETE,2,2,2,0,0,0,2,0,0,0,0,0,0,0,0,0,0,0.0,0.0
256a9e0027f8479d3e9951ffd00e41df00e603d7,/Users/sanika/Downloads/Master Thesis/repo_updated/pytest/testing/example_scripts/conftest_usageerror/conftest.py,,ModificationType.DELETE,8,5,5,0,0,3,8,0,0,0,0,0,0,0,0,0,0,0.0,0.0
256a9e0027f8479d3e9951ffd00e41df00e603d7,/Users/sanika/Downloads/Master Thesis/repo_updated/pytest/testing/example_scripts/marks/marks_considered_keywords/conftest.py,,ModificationType.DELETE,0,0,0,0,0,0,0,0,0,0,0,0,0,0,0,0,0,0.0,0.0
256a9e0027f8479d3e9951ffd00e41df00e603d7,/Users/sanika/Downloads/Master Thesis/repo_updated/pytest/testing/example_scripts/config/collect_pytest_prefix/conftest.py,,ModificationType.DELETE,2,2,2,0,0,0,2,0,0,0,0,0,0,0,0,0,0,0.0,0.0
256a9e0027f8479d3e9951ffd00e41df00e603d7,/Users/sanika/Downloads/Master Thesis/repo_updated/pytest/testing/example_scripts/issue88_initial_file_multinodes/conftest.py,,ModificationType.DELETE,14,8,8,0,0,6,14,0,0,0,0,0,0,0,0,0,0,0.0,0.0
256a9e0027f8479d3e9951ffd00e41df00e603d7,/Users/sanika/Downloads/Master Thesis/repo_updated/pytest/testing/example_scripts/fixtures/fill_fixtures/test_extend_fixture_conftest_conftest/conftest.py,,ModificationType.DELETE,6,4,4,0,0,2,6,0,0,0,0,0,0,0,0,0,0,0.0,0.0
256a9e0027f8479d3e9951ffd00e41df00e603d7,/Users/sanika/Downloads/Master Thesis/repo_updated/pytest/testing/example_scripts/fixtures/fill_fixtures/test_extend_fixture_conftest_conftest/pkg/conftest.py,,ModificationType.DELETE,6,4,4,0,0,2,6,1,2,1,2,3,3,2.0,4.754887502163469,0.5,2.3774437510817346,0.1320802083934297,0.0015849625007211565
256a9e0027f8479d3e9951ffd00e41df00e603d7,/Users/sanika/Downloads/Master Thesis/repo_updated/pytest/testing/example_scripts/fixtures/fill_fixtures/test_extend_fixture_conftest_module/conftest.py,,ModificationType.DELETE,6,4,4,0,0,2,6,0,0,0,0,0,0,0,0,0,0,0.0,0.0
256a9e0027f8479d3e9951ffd00e41df00e603d7,/Users/sanika/Downloads/Master Thesis/repo_updated/pytest/testing/example_scripts/fixtures/fill_fixtures/test_conftest_funcargs_only_available_in_subdir/sub1/conftest.py,,ModificationType.DELETE,7,5,5,0,0,2,7,0,0,0,0,0,0,0,0,0,0,0.0,0.0
256a9e0027f8479d3e9951ffd00e41df00e603d7,/Users/sanika/Downloads/Master Thesis/repo_updated/pytest/testing/example_scripts/fixtures/fill_fixtures/test_conftest_funcargs_only_available_in_subdir/sub2/conftest.py,,ModificationType.DELETE,6,4,4,0,0,2,6,0,0,0,0,0,0,0,0,0,0,0.0,0.0
256a9e0027f8479d3e9951ffd00e41df00e603d7,/Users/sanika/Downloads/Master Thesis/repo_updated/pytest/testing/example_scripts/fixtures/custom_item/conftest.py,,ModificationType.DELETE,10,6,6,0,0,4,10,0,0,0,0,0,0,0,0,0,0,0.0,0.0
256a9e0027f8479d3e9951ffd00e41df00e603d7,/Users/sanika/Downloads/Master Thesis/repo_updated/pytest/doc/en/conftest.py,,ModificationType.DELETE,1,1,1,0,0,0,1,0,0,0,0,0,0,0,0,0,0,0.0,0.0
256a9e0027f8479d3e9951ffd00e41df00e603d7,/Users/sanika/Downloads/Master Thesis/repo_updated/pytest/doc/en/example/conftest.py,,ModificationType.DELETE,1,1,1,0,0,0,1,0,0,0,0,0,0,0,0,0,0,0.0,0.0
256a9e0027f8479d3e9951ffd00e41df00e603d7,/Users/sanika/Downloads/Master Thesis/repo_updated/pytest/doc/en/example/assertion/global_testmodule_config/conftest.py,,ModificationType.DELETE,14,10,10,0,0,4,14,1,1,1,1,2,2,0.0,2.0,0.5,1.0,0.05555555555555555,0.0006666666666666666
256a9e0027f8479d3e9951ffd00e41df00e603d7,/Users/sanika/Downloads/Master Thesis/repo_updated/pytest/doc/en/example/nonpython/conftest.py,,ModificationType.DELETE,46,26,30,3,0,12,49,3,6,3,6,9,9,20.264662506490406,28.529325012980813,1.5,42.793987519471216,2.377443751081734,0.009509775004326938
e5bd7fb0530efa49e5ca7d5fcd9fd741968226b0,/Users/sanika/Downloads/Master Thesis/repo_updated/pytest/testing/example_scripts/collect/package_infinite_recursion/__init__.pyi,361,ModificationType.RENAME,0,0,0,0,0,0,0,0,0,0,0,0,0,0,0,0,0,0.0,0.0
e5bd7fb0530efa49e5ca7d5fcd9fd741968226b0,/Users/sanika/Downloads/Master Thesis/repo_updated/pytest/testing/example_scripts/collect/package_infinite_recursion/tests/__init__.py,361,ModificationType.RENAME,0,0,0,0,0,0,0,0,0,0,0,0,0,0,0,0,0,0.0,0.0
e5bd7fb0530efa49e5ca7d5fcd9fd741968226b0,/Users/sanika/Downloads/Master Thesis/repo_updated/pytest/testing/example_scripts/collect/collect_init_tests/tests/__init__.py,361,ModificationType.RENAME,2,2,2,0,0,0,2,0,0,0,0,0,0,0,0,0,0,0.0,0.0
e5bd7fb0530efa49e5ca7d5fcd9fd741968226b0,/Users/sanika/Downloads/Master Thesis/repo_updated/pytest/testing/example_scripts/collect/package_init_given_as_arg/pkg/__init__.py,361,ModificationType.RENAME,0,0,0,0,0,0,0,0,0,0,0,0,0,0,0,0,0,0.0,0.0
e5bd7fb0530efa49e5ca7d5fcd9fd741968226b0,/Users/sanika/Downloads/Master Thesis/repo_updated/pytest/testing/example_scripts/conftest_usageerror/__init__.pyi,361,ModificationType.RENAME,0,0,0,0,0,0,0,0,0,0,0,0,0,0,0,0,0,0.0,0.0
e5bd7fb0530efa49e5ca7d5fcd9fd741968226b0,/Users/sanika/Downloads/Master Thesis/repo_updated/pytest/testing/example_scripts/marks/marks_considered_keywords/__init__.pyi,361,ModificationType.RENAME,0,0,0,0,0,0,0,0,0,0,0,0,0,0,0,0,0,0.0,0.0
e5bd7fb0530efa49e5ca7d5fcd9fd741968226b0,/Users/sanika/Downloads/Master Thesis/repo_updated/pytest/testing/example_scripts/config/collect_pytest_prefix/__init__.pyi,361,ModificationType.RENAME,0,0,0,0,0,0,0,0,0,0,0,0,0,0,0,0,0,0.0,0.0
e5bd7fb0530efa49e5ca7d5fcd9fd741968226b0,/Users/sanika/Downloads/Master Thesis/repo_updated/pytest/testing/example_scripts/issue88_initial_file_multinodes/__init__.pyi,361,ModificationType.RENAME,0,0,0,0,0,0,0,0,0,0,0,0,0,0,0,0,0,0.0,0.0
e5bd7fb0530efa49e5ca7d5fcd9fd741968226b0,/Users/sanika/Downloads/Master Thesis/repo_updated/pytest/testing/example_scripts/fixtures/fill_fixtures/test_extend_fixture_conftest_conftest/__init__.pyi,361,ModificationType.RENAME,0,0,0,0,0,0,0,0,0,0,0,0,0,0,0,0,0,0.0,0.0
e5bd7fb0530efa49e5ca7d5fcd9fd741968226b0,/Users/sanika/Downloads/Master Thesis/repo_updated/pytest/testing/example_scripts/fixtures/fill_fixtures/test_extend_fixture_conftest_conftest/pkg/__init__.py,361,ModificationType.RENAME,0,0,0,0,0,0,0,0,0,0,0,0,0,0,0,0,0,0.0,0.0
e5bd7fb0530efa49e5ca7d5fcd9fd741968226b0,/Users/sanika/Downloads/Master Thesis/repo_updated/pytest/testing/example_scripts/fixtures/fill_fixtures/test_extend_fixture_conftest_module/__init__.pyi,361,ModificationType.RENAME,0,0,0,0,0,0,0,0,0,0,0,0,0,0,0,0,0,0.0,0.0
e5bd7fb0530efa49e5ca7d5fcd9fd741968226b0,/Users/sanika/Downloads/Master Thesis/repo_updated/pytest/testing/example_scripts/fixtures/fill_fixtures/test_conftest_funcargs_only_available_in_subdir/sub1/__init__.py,361,ModificationType.RENAME,0,0,0,0,0,0,0,0,0,0,0,0,0,0,0,0,0,0.0,0.0
e5bd7fb0530efa49e5ca7d5fcd9fd741968226b0,/Users/sanika/Downloads/Master Thesis/repo_updated/pytest/testing/example_scripts/fixtures/fill_fixtures/test_conftest_funcargs_only_available_in_subdir/sub2/__init__.py,361,ModificationType.RENAME,0,0,0,0,0,0,0,0,0,0,0,0,0,0,0,0,0,0.0,0.0
e5bd7fb0530efa49e5ca7d5fcd9fd741968226b0,/Users/sanika/Downloads/Master Thesis/repo_updated/pytest/testing/example_scripts/fixtures/custom_item/__init__.pyi,361,ModificationType.RENAME,0,0,0,0,0,0,0,0,0,0,0,0,0,0,0,0,0,0.0,0.0
e5bd7fb0530efa49e5ca7d5fcd9fd741968226b0,/Users/sanika/Downloads/Master Thesis/repo_updated/pytest/testing/example_scripts/fixtures/custom_item/foo/__init__.py,361,ModificationType.RENAME,0,0,0,0,0,0,0,0,0,0,0,0,0,0,0,0,0,0.0,0.0
e5bd7fb0530efa49e5ca7d5fcd9fd741968226b0,/Users/sanika/Downloads/Master Thesis/repo_updated/pytest/doc/en/example/nonpython/__init__.py,361,ModificationType.RENAME,0,0,0,0,0,0,0,0,0,0,0,0,0,0,0,0,0,0.0,0.0
e5bd7fb0530efa49e5ca7d5fcd9fd741968226b0,/Users/sanika/Downloads/Master Thesis/repo_updated/pytest/src/pytest/__init__.py,361,ModificationType.RENAME,99,48,90,1,3,5,100,0,0,0,0,0,0,0,0,0,0,0.0,0.0
e5bd7fb0530efa49e5ca7d5fcd9fd741968226b0,/Users/sanika/Downloads/Master Thesis/repo_updated/pytest/src/_pytest/__init__.py,361,ModificationType.RENAME,8,5,5,2,0,1,10,0,0,0,0,0,0,0,0,0,0,0.0,0.0
e5bd7fb0530efa49e5ca7d5fcd9fd741968226b0,/Users/sanika/Downloads/Master Thesis/repo_updated/pytest/src/_pytest/config/__init__.py,361,ModificationType.RENAME,1217,716,841,84,126,174,1301,14,185,118,215,199,333,1446.608539104324,2542.995998641035,8.135135135135135,20687.616097052745,1149.3120053918192,0.847665332880345
e5bd7fb0530efa49e5ca7d5fcd9fd741968226b0,/Users/sanika/Downloads/Master Thesis/repo_updated/pytest/src/_pytest/mark/__init__.py,361,ModificationType.RENAME,160,89,115,0,13,31,160,7,15,11,17,22,28,78.25484338853101,124.86408532184433,3.966666666666667,495.2942051099825,27.51634472833236,0.04162136177394811
e5bd7fb0530efa49e5ca7d5fcd9fd741968226b0,/Users/sanika/Downloads/Master Thesis/repo_updated/pytest/src/_pytest/_code/__init__.py,361,ModificationType.RENAME,10,10,9,9,0,0,19,0,0,0,0,0,0,0,0,0,0,0.0,0.0
e5bd7fb0530efa49e5ca7d5fcd9fd741968226b0,/Users/sanika/Downloads/Master Thesis/repo_updated/pytest/src/_pytest/assertion/__init__.py,361,ModificationType.RENAME,173,84,99,8,29,36,181,5,12,7,13,17,20,54.62919048309069,81.7492568250068,2.7083333333333335,221.4042372343934,12.300235401910745,0.027249752275002266
e5bd7fb0530efa49e5ca7d5fcd9fd741968226b0,/Users/sanika/Downloads/Master Thesis/repo_updated/pytest/src/_pytest/_io/__init__.py,361,ModificationType.RENAME,3,1,1,3,0,0,6,0,0,0,0,0,0,0,0,0,0,0.0,0.0
e5bd7fb0530efa49e5ca7d5fcd9fd741968226b0,/Users/sanika/Downloads/Master Thesis/repo_updated/pytest/src/pytest/__main__.py,17,ModificationType.ADD,7,4,3,0,3,1,7,1,2,1,2,3,3,2.0,4.754887502163469,0.5,2.3774437510817346,0.1320802083934297,0.0015849625007211565
1dc612f7d41bdbf5e40a5b539c607c62b04f2ed3,/Users/sanika/Downloads/Master Thesis/repo_updated/pytest/testing/example_scripts/collect/package_infinite_recursion/__init__.pyi,361,ModificationType.RENAME,0,0,0,0,0,0,0,0,0,0,0,0,0,0,0,0,0,0.0,0.0
1dc612f7d41bdbf5e40a5b539c607c62b04f2ed3,/Users/sanika/Downloads/Master Thesis/repo_updated/pytest/testing/example_scripts/collect/package_infinite_recursion/tests/__init__.py,361,ModificationType.RENAME,0,0,0,0,0,0,0,0,0,0,0,0,0,0,0,0,0,0.0,0.0
1dc612f7d41bdbf5e40a5b539c607c62b04f2ed3,/Users/sanika/Downloads/Master Thesis/repo_updated/pytest/testing/example_scripts/collect/collect_init_tests/tests/__init__.py,361,ModificationType.RENAME,2,2,2,0,0,0,2,0,0,0,0,0,0,0,0,0,0,0.0,0.0
1dc612f7d41bdbf5e40a5b539c607c62b04f2ed3,/Users/sanika/Downloads/Master Thesis/repo_updated/pytest/testing/example_scripts/collect/package_init_given_as_arg/pkg/__init__.py,361,ModificationType.RENAME,0,0,0,0,0,0,0,0,0,0,0,0,0,0,0,0,0,0.0,0.0
1dc612f7d41bdbf5e40a5b539c607c62b04f2ed3,/Users/sanika/Downloads/Master Thesis/repo_updated/pytest/testing/example_scripts/conftest_usageerror/__init__.pyi,361,ModificationType.RENAME,0,0,0,0,0,0,0,0,0,0,0,0,0,0,0,0,0,0.0,0.0
1dc612f7d41bdbf5e40a5b539c607c62b04f2ed3,/Users/sanika/Downloads/Master Thesis/repo_updated/pytest/testing/example_scripts/marks/marks_considered_keywords/__init__.pyi,361,ModificationType.RENAME,0,0,0,0,0,0,0,0,0,0,0,0,0,0,0,0,0,0.0,0.0
1dc612f7d41bdbf5e40a5b539c607c62b04f2ed3,/Users/sanika/Downloads/Master Thesis/repo_updated/pytest/testing/example_scripts/config/collect_pytest_prefix/__init__.pyi,361,ModificationType.RENAME,0,0,0,0,0,0,0,0,0,0,0,0,0,0,0,0,0,0.0,0.0
1dc612f7d41bdbf5e40a5b539c607c62b04f2ed3,/Users/sanika/Downloads/Master Thesis/repo_updated/pytest/testing/example_scripts/issue88_initial_file_multinodes/__init__.pyi,361,ModificationType.RENAME,0,0,0,0,0,0,0,0,0,0,0,0,0,0,0,0,0,0.0,0.0
1dc612f7d41bdbf5e40a5b539c607c62b04f2ed3,/Users/sanika/Downloads/Master Thesis/repo_updated/pytest/testing/example_scripts/fixtures/fill_fixtures/test_extend_fixture_conftest_conftest/__init__.pyi,361,ModificationType.RENAME,0,0,0,0,0,0,0,0,0,0,0,0,0,0,0,0,0,0.0,0.0
1dc612f7d41bdbf5e40a5b539c607c62b04f2ed3,/Users/sanika/Downloads/Master Thesis/repo_updated/pytest/testing/example_scripts/fixtures/fill_fixtures/test_extend_fixture_conftest_conftest/pkg/__init__.py,361,ModificationType.RENAME,0,0,0,0,0,0,0,0,0,0,0,0,0,0,0,0,0,0.0,0.0
1dc612f7d41bdbf5e40a5b539c607c62b04f2ed3,/Users/sanika/Downloads/Master Thesis/repo_updated/pytest/testing/example_scripts/fixtures/fill_fixtures/test_extend_fixture_conftest_module/__init__.pyi,361,ModificationType.RENAME,0,0,0,0,0,0,0,0,0,0,0,0,0,0,0,0,0,0.0,0.0
1dc612f7d41bdbf5e40a5b539c607c62b04f2ed3,/Users/sanika/Downloads/Master Thesis/repo_updated/pytest/testing/example_scripts/fixtures/fill_fixtures/test_conftest_funcargs_only_available_in_subdir/sub1/__init__.py,361,ModificationType.RENAME,0,0,0,0,0,0,0,0,0,0,0,0,0,0,0,0,0,0.0,0.0
1dc612f7d41bdbf5e40a5b539c607c62b04f2ed3,/Users/sanika/Downloads/Master Thesis/repo_updated/pytest/testing/example_scripts/fixtures/fill_fixtures/test_conftest_funcargs_only_available_in_subdir/sub2/__init__.py,361,ModificationType.RENAME,0,0,0,0,0,0,0,0,0,0,0,0,0,0,0,0,0,0.0,0.0
1dc612f7d41bdbf5e40a5b539c607c62b04f2ed3,/Users/sanika/Downloads/Master Thesis/repo_updated/pytest/testing/example_scripts/fixtures/custom_item/__init__.pyi,361,ModificationType.RENAME,0,0,0,0,0,0,0,0,0,0,0,0,0,0,0,0,0,0.0,0.0
1dc612f7d41bdbf5e40a5b539c607c62b04f2ed3,/Users/sanika/Downloads/Master Thesis/repo_updated/pytest/testing/example_scripts/fixtures/custom_item/foo/__init__.py,361,ModificationType.RENAME,0,0,0,0,0,0,0,0,0,0,0,0,0,0,0,0,0,0.0,0.0
1dc612f7d41bdbf5e40a5b539c607c62b04f2ed3,/Users/sanika/Downloads/Master Thesis/repo_updated/pytest/doc/en/example/nonpython/__init__.py,361,ModificationType.RENAME,0,0,0,0,0,0,0,0,0,0,0,0,0,0,0,0,0,0.0,0.0
1dc612f7d41bdbf5e40a5b539c607c62b04f2ed3,/Users/sanika/Downloads/Master Thesis/repo_updated/pytest/src/pytest/__init__.py,361,ModificationType.RENAME,99,48,90,1,3,5,100,0,0,0,0,0,0,0,0,0,0,0.0,0.0
1dc612f7d41bdbf5e40a5b539c607c62b04f2ed3,/Users/sanika/Downloads/Master Thesis/repo_updated/pytest/src/_pytest/__init__.py,361,ModificationType.RENAME,8,5,5,2,0,1,10,0,0,0,0,0,0,0,0,0,0,0.0,0.0
1dc612f7d41bdbf5e40a5b539c607c62b04f2ed3,/Users/sanika/Downloads/Master Thesis/repo_updated/pytest/src/_pytest/config/__init__.py,361,ModificationType.RENAME,1217,716,841,84,126,174,1301,14,185,118,215,199,333,1446.608539104324,2542.995998641035,8.135135135135135,20687.616097052745,1149.3120053918192,0.847665332880345
1dc612f7d41bdbf5e40a5b539c607c62b04f2ed3,/Users/sanika/Downloads/Master Thesis/repo_updated/pytest/src/_pytest/mark/__init__.py,361,ModificationType.RENAME,160,89,115,0,13,31,160,7,15,11,17,22,28,78.25484338853101,124.86408532184433,3.966666666666667,495.2942051099825,27.51634472833236,0.04162136177394811
1dc612f7d41bdbf5e40a5b539c607c62b04f2ed3,/Users/sanika/Downloads/Master Thesis/repo_updated/pytest/src/_pytest/_code/__init__.py,361,ModificationType.RENAME,10,10,9,9,0,0,19,0,0,0,0,0,0,0,0,0,0,0.0,0.0
1dc612f7d41bdbf5e40a5b539c607c62b04f2ed3,/Users/sanika/Downloads/Master Thesis/repo_updated/pytest/src/_pytest/assertion/__init__.py,361,ModificationType.RENAME,173,84,99,8,29,36,181,5,12,7,13,17,20,54.62919048309069,81.7492568250068,2.7083333333333335,221.4042372343934,12.300235401910745,0.027249752275002266
1dc612f7d41bdbf5e40a5b539c607c62b04f2ed3,/Users/sanika/Downloads/Master Thesis/repo_updated/pytest/src/_pytest/_io/__init__.py,361,ModificationType.RENAME,3,1,1,3,0,0,6,0,0,0,0,0,0,0,0,0,0,0.0,0.0
1dc612f7d41bdbf5e40a5b539c607c62b04f2ed3,/Users/sanika/Downloads/Master Thesis/repo_updated/pytest/src/pytest/__main__.py,17,ModificationType.ADD,7,4,3,0,3,1,7,1,2,1,2,3,3,2.0,4.754887502163469,0.5,2.3774437510817346,0.1320802083934297,0.0015849625007211565
c7f9fda42d475a5579aa988d8b491be3de53925b,/Users/sanika/Downloads/Master Thesis/repo_updated/pytest/testing/example_scripts/collect/package_infinite_recursion/__init__.pyi,5149,ModificationType.MODIFY,0,0,0,0,0,0,0,0,0,0,0,0,0,0,0,0,0,0.0,0.0
c7f9fda42d475a5579aa988d8b491be3de53925b,/Users/sanika/Downloads/Master Thesis/repo_updated/pytest/testing/example_scripts/collect/package_infinite_recursion/tests/__init__.py,5149,ModificationType.MODIFY,0,0,0,0,0,0,0,0,0,0,0,0,0,0,0,0,0,0.0,0.0
c7f9fda42d475a5579aa988d8b491be3de53925b,/Users/sanika/Downloads/Master Thesis/repo_updated/pytest/testing/example_scripts/collect/collect_init_tests/tests/__init__.py,5149,ModificationType.MODIFY,2,2,2,0,0,0,2,0,0,0,0,0,0,0,0,0,0,0.0,0.0
c7f9fda42d475a5579aa988d8b491be3de53925b,/Users/sanika/Downloads/Master Thesis/repo_updated/pytest/testing/example_scripts/collect/package_init_given_as_arg/pkg/__init__.py,5149,ModificationType.MODIFY,0,0,0,0,0,0,0,0,0,0,0,0,0,0,0,0,0,0.0,0.0
c7f9fda42d475a5579aa988d8b491be3de53925b,/Users/sanika/Downloads/Master Thesis/repo_updated/pytest/testing/example_scripts/conftest_usageerror/__init__.pyi,5149,ModificationType.MODIFY,0,0,0,0,0,0,0,0,0,0,0,0,0,0,0,0,0,0.0,0.0
c7f9fda42d475a5579aa988d8b491be3de53925b,/Users/sanika/Downloads/Master Thesis/repo_updated/pytest/testing/example_scripts/marks/marks_considered_keywords/__init__.pyi,5149,ModificationType.MODIFY,0,0,0,0,0,0,0,0,0,0,0,0,0,0,0,0,0,0.0,0.0
c7f9fda42d475a5579aa988d8b491be3de53925b,/Users/sanika/Downloads/Master Thesis/repo_updated/pytest/testing/example_scripts/config/collect_pytest_prefix/__init__.pyi,5149,ModificationType.MODIFY,0,0,0,0,0,0,0,0,0,0,0,0,0,0,0,0,0,0.0,0.0
c7f9fda42d475a5579aa988d8b491be3de53925b,/Users/sanika/Downloads/Master Thesis/repo_updated/pytest/testing/example_scripts/issue88_initial_file_multinodes/__init__.pyi,5149,ModificationType.MODIFY,0,0,0,0,0,0,0,0,0,0,0,0,0,0,0,0,0,0.0,0.0
c7f9fda42d475a5579aa988d8b491be3de53925b,/Users/sanika/Downloads/Master Thesis/repo_updated/pytest/testing/example_scripts/fixtures/fill_fixtures/test_extend_fixture_conftest_conftest/__init__.pyi,5149,ModificationType.MODIFY,0,0,0,0,0,0,0,0,0,0,0,0,0,0,0,0,0,0.0,0.0
c7f9fda42d475a5579aa988d8b491be3de53925b,/Users/sanika/Downloads/Master Thesis/repo_updated/pytest/testing/example_scripts/fixtures/fill_fixtures/test_extend_fixture_conftest_conftest/pkg/__init__.py,5149,ModificationType.MODIFY,0,0,0,0,0,0,0,0,0,0,0,0,0,0,0,0,0,0.0,0.0
c7f9fda42d475a5579aa988d8b491be3de53925b,/Users/sanika/Downloads/Master Thesis/repo_updated/pytest/testing/example_scripts/fixtures/fill_fixtures/test_extend_fixture_conftest_module/__init__.pyi,5149,ModificationType.MODIFY,0,0,0,0,0,0,0,0,0,0,0,0,0,0,0,0,0,0.0,0.0
c7f9fda42d475a5579aa988d8b491be3de53925b,/Users/sanika/Downloads/Master Thesis/repo_updated/pytest/testing/example_scripts/fixtures/fill_fixtures/test_conftest_funcargs_only_available_in_subdir/sub1/__init__.py,5149,ModificationType.MODIFY,0,0,0,0,0,0,0,0,0,0,0,0,0,0,0,0,0,0.0,0.0
c7f9fda42d475a5579aa988d8b491be3de53925b,/Users/sanika/Downloads/Master Thesis/repo_updated/pytest/testing/example_scripts/fixtures/fill_fixtures/test_conftest_funcargs_only_available_in_subdir/sub2/__init__.py,5149,ModificationType.MODIFY,0,0,0,0,0,0,0,0,0,0,0,0,0,0,0,0,0,0.0,0.0
c7f9fda42d475a5579aa988d8b491be3de53925b,/Users/sanika/Downloads/Master Thesis/repo_updated/pytest/testing/example_scripts/fixtures/custom_item/__init__.pyi,5149,ModificationType.MODIFY,0,0,0,0,0,0,0,0,0,0,0,0,0,0,0,0,0,0.0,0.0
c7f9fda42d475a5579aa988d8b491be3de53925b,/Users/sanika/Downloads/Master Thesis/repo_updated/pytest/testing/example_scripts/fixtures/custom_item/foo/__init__.py,5149,ModificationType.MODIFY,0,0,0,0,0,0,0,0,0,0,0,0,0,0,0,0,0,0.0,0.0
c7f9fda42d475a5579aa988d8b491be3de53925b,/Users/sanika/Downloads/Master Thesis/repo_updated/pytest/doc/en/example/nonpython/__init__.py,5149,ModificationType.MODIFY,0,0,0,0,0,0,0,0,0,0,0,0,0,0,0,0,0,0.0,0.0
c7f9fda42d475a5579aa988d8b491be3de53925b,/Users/sanika/Downloads/Master Thesis/repo_updated/pytest/src/pytest/__init__.py,5149,ModificationType.MODIFY,99,48,90,1,3,5,100,0,0,0,0,0,0,0,0,0,0,0.0,0.0
c7f9fda42d475a5579aa988d8b491be3de53925b,/Users/sanika/Downloads/Master Thesis/repo_updated/pytest/src/_pytest/__init__.py,5149,ModificationType.MODIFY,8,5,5,2,0,1,10,0,0,0,0,0,0,0,0,0,0,0.0,0.0
c7f9fda42d475a5579aa988d8b491be3de53925b,/Users/sanika/Downloads/Master Thesis/repo_updated/pytest/src/_pytest/config/__init__.py,5149,ModificationType.MODIFY,1217,716,841,84,126,174,1301,14,185,118,215,199,333,1446.608539104324,2542.995998641035,8.135135135135135,20687.616097052745,1149.3120053918192,0.847665332880345
c7f9fda42d475a5579aa988d8b491be3de53925b,/Users/sanika/Downloads/Master Thesis/repo_updated/pytest/src/_pytest/mark/__init__.py,5149,ModificationType.MODIFY,160,89,115,0,13,31,160,7,15,11,17,22,28,78.25484338853101,124.86408532184433,3.966666666666667,495.2942051099825,27.51634472833236,0.04162136177394811
c7f9fda42d475a5579aa988d8b491be3de53925b,/Users/sanika/Downloads/Master Thesis/repo_updated/pytest/src/_pytest/_code/__init__.py,5149,ModificationType.MODIFY,10,10,9,9,0,0,19,0,0,0,0,0,0,0,0,0,0,0.0,0.0
c7f9fda42d475a5579aa988d8b491be3de53925b,/Users/sanika/Downloads/Master Thesis/repo_updated/pytest/src/_pytest/assertion/__init__.py,5149,ModificationType.MODIFY,173,84,99,8,29,36,181,5,12,7,13,17,20,54.62919048309069,81.7492568250068,2.7083333333333335,221.4042372343934,12.300235401910745,0.027249752275002266
c7f9fda42d475a5579aa988d8b491be3de53925b,/Users/sanika/Downloads/Master Thesis/repo_updated/pytest/src/_pytest/_io/__init__.py,5149,ModificationType.MODIFY,3,1,1,3,0,0,6,0,0,0,0,0,0,0,0,0,0,0.0,0.0
c7f9fda42d475a5579aa988d8b491be3de53925b,/Users/sanika/Downloads/Master Thesis/repo_updated/pytest/testing/test_config.py,6090,ModificationType.MODIFY,1457,730,1242,11,6,188,1468,10,292,166,329,302,495,2424.648052141839,4078.010345965914,5.633561643835616,22973.722668198385,1276.3179260110214,1.359336781988638
