,complexity,token_count,loc,lloc,sloc,comments,multi,blank,code_comment,h1,h2,N1,N2,vocabulary,length,calculated_length,volume,difficulty,effort,time,bugs,change_type,added,removed,defect
381,19,473,182,127,129,0,0,53,182,5,39,21,42,44,63,217,343,2,926,51,0,0,80,0,1
382,19,473,1165,710,800,67,119,181,1232,18,243,153,282,261,435,2000,3492,10,36473,2026,1,0,80,0,1
383,12,234,1392,870,1177,35,17,170,1427,14,494,280,531,508,811,4473,7289,7,54850,3047,2,0,40,0,1
384,62,1372,773,419,590,28,0,166,801,10,204,113,217,214,330,1598,2554,5,13587,754,0,0,282,0,1
385,62,1372,421,273,302,44,34,57,465,17,81,59,107,98,166,583,1098,11,12329,684,0,0,282,0,1
409,9,297,182,127,129,0,0,53,182,5,39,21,42,44,63,217,343,2,926,51,0,0,51,0,1
410,43,971,1392,870,1177,35,17,170,1427,14,494,280,531,508,811,4473,7289,7,54850,3047,2,0,208,0,1
411,40,1319,773,419,590,28,0,166,801,10,204,113,217,214,330,1598,2554,5,13587,754,0,0,283,0,1
435,1,28,127,75,83,2,11,30,129,4,14,7,14,18,21,61,87,2,175,9,0,0,5,0,1
436,1,28,652,304,544,16,6,88,668,6,89,51,101,95,152,591,998,3,3399,188,0,0,5,0,1
437,1,28,2,2,2,0,0,0,2,0,0,0,0,0,0,0,0,0,0,0,0,0,5,0,1
438,1,28,8,5,5,0,0,3,8,0,0,0,0,0,0,0,0,0,0,0,0,0,5,0,1
441,1,28,14,8,8,0,0,6,14,0,0,0,0,0,0,0,0,0,0,0,0,0,5,0,1
442,1,28,6,4,4,0,0,2,6,0,0,0,0,0,0,0,0,0,0,0,0,0,5,0,1
443,1,28,6,4,4,0,0,2,6,1,2,1,2,3,3,2,4,0,2,0,0,0,5,0,1
445,1,28,7,5,5,0,0,2,7,0,0,0,0,0,0,0,0,0,0,0,0,0,5,0,1
447,1,28,10,6,6,0,0,4,10,0,0,0,0,0,0,0,0,0,0,0,0,0,5,0,1
448,1,28,1,1,1,0,0,0,1,0,0,0,0,0,0,0,0,0,0,0,0,0,5,0,1
450,1,28,14,10,10,0,0,4,14,1,1,1,1,2,2,0,2,0,1,0,0,0,5,0,1
451,1,28,46,26,30,3,0,12,49,3,6,3,6,9,9,20,28,1,42,2,0,0,5,0,1
452,307,7640,1455,414,1257,16,76,112,1471,5,41,23,46,46,69,231,381,2,1069,59,0,0,2672,0,1
453,307,7640,669,365,481,22,61,110,691,15,103,63,122,118,185,747,1273,8,11311,628,0,0,2672,0,1
477,25,593,1455,414,1257,16,76,112,1471,5,41,23,46,46,69,231,381,2,1069,59,0,0,2394,0,1
518,71,1529,127,75,83,2,11,30,129,4,14,7,14,18,21,61,87,2,175,9,0,0,240,0,1
519,71,1529,652,304,544,16,6,88,668,6,89,51,101,95,152,591,998,3,3399,188,0,0,240,0,1
520,71,1529,2,2,2,0,0,0,2,0,0,0,0,0,0,0,0,0,0,0,0,0,240,0,1
521,71,1529,8,5,5,0,0,3,8,0,0,0,0,0,0,0,0,0,0,0,0,0,240,0,1
524,71,1529,14,8,8,0,0,6,14,0,0,0,0,0,0,0,0,0,0,0,0,0,240,0,1
525,71,1529,6,4,4,0,0,2,6,0,0,0,0,0,0,0,0,0,0,0,0,0,240,0,1
526,71,1529,6,4,4,0,0,2,6,1,2,1,2,3,3,2,4,0,2,0,0,0,240,0,1
528,71,1529,7,5,5,0,0,2,7,0,0,0,0,0,0,0,0,0,0,0,0,0,240,0,1
530,71,1529,10,6,6,0,0,4,10,0,0,0,0,0,0,0,0,0,0,0,0,0,240,0,1
531,71,1529,1,1,1,0,0,0,1,0,0,0,0,0,0,0,0,0,0,0,0,0,240,0,1
533,71,1529,14,10,10,0,0,4,14,1,1,1,1,2,2,0,2,0,1,0,0,0,240,0,1
534,71,1529,46,26,30,3,0,12,49,3,6,3,6,9,9,20,28,1,42,2,0,0,240,0,1
535,35,478,282,196,195,3,0,86,285,8,130,71,141,138,212,936,1507,4,6538,363,0,0,120,0,1
536,1,96,13,10,10,0,0,3,13,1,2,1,2,3,3,2,4,0,2,0,0,0,12,0,1
537,7,111,44,19,17,0,16,11,44,3,14,7,14,17,21,58,85,1,128,7,0,0,42,0,1
538,4,431,652,304,544,16,6,88,668,6,89,51,101,95,152,591,998,3,3399,188,0,0,74,0,1
562,19,557,14,9,9,0,0,5,14,0,0,0,0,0,0,0,0,0,0,0,0,0,102,0,1
563,19,557,16,9,9,0,0,7,16,0,0,0,0,0,0,0,0,0,0,0,0,0,102,0,1
610,17,403,1513,682,1277,25,13,200,1538,11,199,116,219,210,335,1557,2584,6,15641,868,0,0,74,0,1
611,17,403,819,519,539,24,98,155,843,15,96,57,106,111,163,690,1107,8,9171,509,0,0,74,0,1
635,14,747,1513,682,1277,25,13,200,1538,11,199,116,219,210,335,1557,2584,6,15641,868,0,0,129,0,1
705,7,179,1450,624,1228,12,26,181,1462,14,306,186,354,320,540,2580,4493,8,36391,2021,1,0,31,0,1
706,4,116,447,308,343,6,5,95,453,7,96,59,111,103,170,651,1136,4,4600,255,0,0,26,0,1
707,4,116,322,174,179,16,74,51,338,10,41,26,46,51,72,252,408,5,2291,127,0,0,26,0,1
731,23,383,1450,624,1228,12,26,181,1462,14,306,186,354,320,540,2580,4493,8,36391,2021,1,0,98,0,1
755,7,305,1513,682,1277,25,13,200,1538,11,199,116,219,210,335,1557,2584,6,15641,868,0,0,49,0,1
756,7,305,819,519,539,24,98,155,843,15,96,57,106,111,163,690,1107,8,9171,509,0,0,49,0,1
780,9,378,15,9,9,0,0,6,15,0,0,0,0,0,0,0,0,0,0,0,0,0,79,0,1
1103,158,2888,1338,495,1086,10,64,173,1348,11,122,82,157,133,239,883,1686,7,11934,663,0,0,526,0,1
1104,6,264,207,111,150,11,0,50,218,5,26,19,36,31,55,133,272,3,943,52,0,0,58,0,1
1105,6,264,410,198,237,31,55,97,441,11,63,38,72,74,110,414,683,6,4293,238,0,0,58,0,1
1106,30,664,1457,730,1242,11,6,188,1468,10,292,166,329,302,495,2424,4078,5,22973,1276,1,0,148,0,1
1107,30,664,74,35,59,1,0,14,75,3,14,7,14,17,21,58,85,1,128,7,0,0,148,0,1
1108,30,664,245,125,200,5,7,34,250,7,30,17,34,37,51,166,265,3,1053,58,0,0,148,0,1
1109,4,109,1455,414,1257,16,76,112,1471,5,41,23,46,46,69,231,381,2,1069,59,0,0,33,0,1
1110,4,109,669,365,481,22,61,110,691,15,103,63,122,118,185,747,1273,8,11311,628,0,0,33,0,1
1111,6,202,256,139,192,9,7,47,265,4,23,12,24,27,36,112,171,2,357,19,0,0,39,0,1
1175,1,129,1457,730,1242,11,6,188,1468,10,292,166,329,302,495,2424,4078,5,22973,1276,1,0,24,0,1
1199,53,870,373,158,315,8,0,51,381,5,76,44,79,81,123,486,779,2,2026,112,0,0,154,0,1
1223,126,3063,1943,715,1694,26,18,214,1969,12,185,120,237,197,357,1436,2721,7,20915,1161,0,0,479,0,1
1224,126,3063,1168,838,957,57,25,144,1225,19,348,224,416,367,640,3018,5452,11,61921,3440,1,0,479,0,1
1271,4,217,207,111,150,11,0,50,218,5,26,19,36,31,55,133,272,3,943,52,0,0,51,0,1
1272,7,467,1457,730,1242,11,6,188,1468,10,292,166,329,302,495,2424,4078,5,22973,1276,1,0,74,0,1
1273,4,184,1455,414,1257,16,76,112,1471,5,41,23,46,46,69,231,381,2,1069,59,0,0,43,0,1
1274,35,2376,373,158,315,8,0,51,381,5,76,44,79,81,123,486,779,2,2026,112,0,0,389,0,1
1344,67,1751,477,336,357,30,23,73,507,16,194,134,250,210,384,1538,2962,10,30538,1696,0,0,291,0,1
1506,12,285,1523,757,1297,19,12,193,1542,12,193,117,230,205,347,1508,2664,7,19053,1058,0,0,58,0,1
1507,12,285,701,378,504,33,58,109,734,13,110,68,126,123,194,794,1346,7,10027,557,0,0,58,0,1
1533,1,85,13,10,10,0,0,3,13,1,2,1,2,3,3,2,4,0,2,0,0,2,1,1,1
1534,4,403,652,304,544,16,6,88,668,6,89,51,101,95,152,591,998,3,3399,188,0,2,2,3,1
1535,4,89,1943,715,1694,26,18,214,1969,12,185,120,237,197,357,1436,2721,7,20915,1161,0,0,21,0,1
1536,153,2747,1338,495,1086,10,64,173,1348,11,122,82,157,133,239,883,1686,7,11934,663,0,2,16,35,1
1537,69,1398,1457,730,1242,11,6,188,1468,10,292,166,329,302,495,2424,4078,5,22973,1276,1,2,201,61,1
1538,69,1398,74,35,59,1,0,14,75,3,14,7,14,17,21,58,85,1,128,7,0,2,201,61,1
1539,69,1398,245,125,200,5,7,34,250,7,30,17,34,37,51,166,265,3,1053,58,0,2,201,61,1
1558,40,618,373,158,315,8,0,51,381,5,76,44,79,81,123,486,779,2,2026,112,0,2,2,39,1
1559,74,1856,1943,715,1694,26,18,214,1969,12,185,120,237,197,357,1436,2721,7,20915,1161,0,2,9,197,1
1560,74,1856,1168,838,957,57,25,144,1225,19,348,224,416,367,640,3018,5452,11,61921,3440,1,2,9,197,1
1561,42,2602,1457,730,1242,11,6,188,1468,10,292,166,329,302,495,2424,4078,5,22973,1276,1,2,265,0,1
1562,4,190,1455,414,1257,16,76,112,1471,5,41,23,46,46,69,231,381,2,1069,59,0,2,2,2,1
1563,34,2129,373,158,315,8,0,51,381,5,76,44,79,81,123,486,779,2,2026,112,0,2,21,48,1
1564,40,612,373,158,315,8,0,51,381,5,76,44,79,81,123,486,779,2,2026,112,0,2,6,7,0
1565,73,1454,1457,730,1242,11,6,188,1468,10,292,166,329,302,495,2424,4078,5,22973,1276,1,2,12,1,0
1566,73,1454,74,35,59,1,0,14,75,3,14,7,14,17,21,58,85,1,128,7,0,2,12,1,0
1567,73,1454,245,125,200,5,7,34,250,7,30,17,34,37,51,166,265,3,1053,58,0,2,12,1,0
1568,44,2661,1457,730,1242,11,6,188,1468,10,292,166,329,302,495,2424,4078,5,22973,1276,1,2,23,5,0
1569,74,1467,1457,730,1242,11,6,188,1468,10,292,166,329,302,495,2424,4078,5,22973,1276,1,2,3,1,1
1570,74,1467,74,35,59,1,0,14,75,3,14,7,14,17,21,58,85,1,128,7,0,2,3,1,1
1571,74,1467,245,125,200,5,7,34,250,7,30,17,34,37,51,166,265,3,1053,58,0,2,3,1,1
1572,153,2741,1338,495,1086,10,64,173,1348,11,122,82,157,133,239,883,1686,7,11934,663,0,2,3,3,0
1573,17,403,1513,682,1277,25,13,200,1538,11,199,116,219,210,335,1557,2584,6,15641,868,0,2,1,0,0
1574,17,403,819,519,539,24,98,155,843,15,96,57,106,111,163,690,1107,8,9171,509,0,2,1,0,0
1575,5,104,1943,715,1694,26,18,214,1969,12,185,120,237,197,357,1436,2721,7,20915,1161,0,2,8,4,0
1576,44,2697,1457,730,1242,11,6,188,1468,10,292,166,329,302,495,2424,4078,5,22973,1276,1,2,4,2,0
1577,74,1599,127,75,83,2,11,30,129,4,14,7,14,18,21,61,87,2,175,9,0,2,23,7,0
1578,74,1599,652,304,544,16,6,88,668,6,89,51,101,95,152,591,998,3,3399,188,0,2,23,7,0
1579,74,1599,2,2,2,0,0,0,2,0,0,0,0,0,0,0,0,0,0,0,0,2,23,7,0
1580,74,1599,8,5,5,0,0,3,8,0,0,0,0,0,0,0,0,0,0,0,0,2,23,7,0
1583,74,1599,14,8,8,0,0,6,14,0,0,0,0,0,0,0,0,0,0,0,0,2,23,7,0
1584,74,1599,6,4,4,0,0,2,6,0,0,0,0,0,0,0,0,0,0,0,0,2,23,7,0
1585,74,1599,6,4,4,0,0,2,6,1,2,1,2,3,3,2,4,0,2,0,0,2,23,7,0
1587,74,1599,7,5,5,0,0,2,7,0,0,0,0,0,0,0,0,0,0,0,0,2,23,7,0
1589,74,1599,10,6,6,0,0,4,10,0,0,0,0,0,0,0,0,0,0,0,0,2,23,7,0
1590,74,1599,1,1,1,0,0,0,1,0,0,0,0,0,0,0,0,0,0,0,0,2,23,7,0
1592,74,1599,14,10,10,0,0,4,14,1,1,1,1,2,2,0,2,0,1,0,0,2,23,7,0
1593,74,1599,46,26,30,3,0,12,49,3,6,3,6,9,9,20,28,1,42,2,0,2,23,7,0
1594,5,535,652,304,544,16,6,88,668,6,89,51,101,95,152,591,998,3,3399,188,0,2,15,0,0
1595,74,1848,1943,715,1694,26,18,214,1969,12,185,120,237,197,357,1436,2721,7,20915,1161,0,2,0,1,0
1596,74,1848,1168,838,957,57,25,144,1225,19,348,224,416,367,640,3018,5452,11,61921,3440,1,2,0,1,0
1597,20,484,182,127,129,0,0,53,182,5,39,21,42,44,63,217,343,2,926,51,0,2,4,1,0
1598,20,484,1165,710,800,67,119,181,1232,18,243,153,282,261,435,2000,3492,10,36473,2026,1,2,4,1,0
1599,154,2757,1338,495,1086,10,64,173,1348,11,122,82,157,133,239,883,1686,7,11934,663,0,2,6,1,0
1600,20,486,182,127,129,0,0,53,182,5,39,21,42,44,63,217,343,2,926,51,0,2,1,1,0
1601,20,486,1165,710,800,67,119,181,1232,18,243,153,282,261,435,2000,3492,10,36473,2026,1,2,1,1,0
1602,10,344,182,127,129,0,0,53,182,5,39,21,42,44,63,217,343,2,926,51,0,2,6,0,0
1603,75,1511,1457,730,1242,11,6,188,1468,10,292,166,329,302,495,2424,4078,5,22973,1276,1,2,8,1,0
1604,75,1511,74,35,59,1,0,14,75,3,14,7,14,17,21,58,85,1,128,7,0,2,8,1,0
1605,75,1511,245,125,200,5,7,34,250,7,30,17,34,37,51,166,265,3,1053,58,0,2,8,1,0
1606,75,1611,127,75,83,2,11,30,129,4,14,7,14,18,21,61,87,2,175,9,0,2,7,3,1
1607,75,1611,652,304,544,16,6,88,668,6,89,51,101,95,152,591,998,3,3399,188,0,2,7,3,1
1608,75,1611,2,2,2,0,0,0,2,0,0,0,0,0,0,0,0,0,0,0,0,2,7,3,1
1609,75,1611,8,5,5,0,0,3,8,0,0,0,0,0,0,0,0,0,0,0,0,2,7,3,1
1612,75,1611,14,8,8,0,0,6,14,0,0,0,0,0,0,0,0,0,0,0,0,2,7,3,1
1613,75,1611,6,4,4,0,0,2,6,0,0,0,0,0,0,0,0,0,0,0,0,2,7,3,1
1614,75,1611,6,4,4,0,0,2,6,1,2,1,2,3,3,2,4,0,2,0,0,2,7,3,1
1616,75,1611,7,5,5,0,0,2,7,0,0,0,0,0,0,0,0,0,0,0,0,2,7,3,1
1618,75,1611,10,6,6,0,0,4,10,0,0,0,0,0,0,0,0,0,0,0,0,2,7,3,1
1619,75,1611,1,1,1,0,0,0,1,0,0,0,0,0,0,0,0,0,0,0,0,2,7,3,1
1621,75,1611,14,10,10,0,0,4,14,1,1,1,1,2,2,0,2,0,1,0,0,2,7,3,1
1622,75,1611,46,26,30,3,0,12,49,3,6,3,6,9,9,20,28,1,42,2,0,2,7,3,1
1623,75,1516,1457,730,1242,11,6,188,1468,10,292,166,329,302,495,2424,4078,5,22973,1276,1,2,1,0,0
1624,75,1516,74,35,59,1,0,14,75,3,14,7,14,17,21,58,85,1,128,7,0,2,1,0,0
1625,75,1516,245,125,200,5,7,34,250,7,30,17,34,37,51,166,265,3,1053,58,0,2,1,0,0
1626,63,1425,1457,730,1242,11,6,188,1468,10,292,166,329,302,495,2424,4078,5,22973,1276,1,2,1,26,1
1627,63,1425,74,35,59,1,0,14,75,3,14,7,14,17,21,58,85,1,128,7,0,2,1,26,1
1628,63,1425,245,125,200,5,7,34,250,7,30,17,34,37,51,166,265,3,1053,58,0,2,1,26,1
1629,49,681,373,158,315,8,0,51,381,5,76,44,79,81,123,486,779,2,2026,112,0,2,15,0,1
1630,44,2697,1457,730,1242,11,6,188,1468,10,292,166,329,302,495,2424,4078,5,22973,1276,1,2,3,1,1
1631,28,1795,373,158,315,8,0,51,381,5,76,44,79,81,123,486,779,2,2026,112,0,2,33,81,1
1632,63,1425,1457,730,1242,11,6,188,1468,10,292,166,329,302,495,2424,4078,5,22973,1276,1,2,1,1,0
1633,63,1425,74,35,59,1,0,14,75,3,14,7,14,17,21,58,85,1,128,7,0,2,1,1,0
1634,63,1425,245,125,200,5,7,34,250,7,30,17,34,37,51,166,265,3,1053,58,0,2,1,1,0
1635,62,1381,1457,730,1242,11,6,188,1468,10,292,166,329,302,495,2424,4078,5,22973,1276,1,2,0,7,0
1636,62,1381,74,35,59,1,0,14,75,3,14,7,14,17,21,58,85,1,128,7,0,2,0,7,0
1637,62,1381,245,125,200,5,7,34,250,7,30,17,34,37,51,166,265,3,1053,58,0,2,0,7,0
1638,64,1421,1457,730,1242,11,6,188,1468,10,292,166,329,302,495,2424,4078,5,22973,1276,1,2,8,0,0
1639,64,1421,74,35,59,1,0,14,75,3,14,7,14,17,21,58,85,1,128,7,0,2,8,0,0
1640,64,1421,245,125,200,5,7,34,250,7,30,17,34,37,51,166,265,3,1053,58,0,2,8,0,0
1641,63,1405,1457,730,1242,11,6,188,1468,10,292,166,329,302,495,2424,4078,5,22973,1276,1,2,0,4,0
1642,63,1405,74,35,59,1,0,14,75,3,14,7,14,17,21,58,85,1,128,7,0,2,0,4,0
1643,63,1405,245,125,200,5,7,34,250,7,30,17,34,37,51,166,265,3,1053,58,0,2,0,4,0
1644,43,2647,1457,730,1242,11,6,188,1468,10,292,166,329,302,495,2424,4078,5,22973,1276,1,2,0,5,0
1715,307,7644,1455,414,1257,16,76,112,1471,5,41,23,46,46,69,231,381,2,1069,59,0,2,1,1,0
1716,307,7644,669,365,481,22,61,110,691,15,103,63,122,118,185,747,1273,8,11311,628,0,2,1,1,0
1717,75,1589,127,75,83,2,11,30,129,4,14,7,14,18,21,61,87,2,175,9,0,2,0,3,0
1718,75,1589,652,304,544,16,6,88,668,6,89,51,101,95,152,591,998,3,3399,188,0,2,0,3,0
1719,75,1589,2,2,2,0,0,0,2,0,0,0,0,0,0,0,0,0,0,0,0,2,0,3,0
1720,75,1589,8,5,5,0,0,3,8,0,0,0,0,0,0,0,0,0,0,0,0,2,0,3,0
1723,75,1589,14,8,8,0,0,6,14,0,0,0,0,0,0,0,0,0,0,0,0,2,0,3,0
1724,75,1589,6,4,4,0,0,2,6,0,0,0,0,0,0,0,0,0,0,0,0,2,0,3,0
1725,75,1589,6,4,4,0,0,2,6,1,2,1,2,3,3,2,4,0,2,0,0,2,0,3,0
1727,75,1589,7,5,5,0,0,2,7,0,0,0,0,0,0,0,0,0,0,0,0,2,0,3,0
1729,75,1589,10,6,6,0,0,4,10,0,0,0,0,0,0,0,0,0,0,0,0,2,0,3,0
1730,75,1589,1,1,1,0,0,0,1,0,0,0,0,0,0,0,0,0,0,0,0,2,0,3,0
1732,75,1589,14,10,10,0,0,4,14,1,1,1,1,2,2,0,2,0,1,0,0,2,0,3,0
1733,75,1589,46,26,30,3,0,12,49,3,6,3,6,9,9,20,28,1,42,2,0,2,0,3,0
1803,20,491,182,127,129,0,0,53,182,5,39,21,42,44,63,217,343,2,926,51,0,2,9,0,0
1804,20,491,1165,710,800,67,119,181,1232,18,243,153,282,261,435,2000,3492,10,36473,2026,1,2,9,0,0
1805,12,236,1392,870,1177,35,17,170,1427,14,494,280,531,508,811,4473,7289,7,54850,3047,2,2,8,0,0
1880,23,517,1513,682,1277,25,13,200,1538,11,199,116,219,210,335,1557,2584,6,15641,868,0,2,41,1,0
1881,23,517,819,519,539,24,98,155,843,15,96,57,106,111,163,690,1107,8,9171,509,0,2,41,1,0
1882,18,917,1513,682,1277,25,13,200,1538,11,199,116,219,210,335,1557,2584,6,15641,868,0,2,27,0,0
1883,19,455,1513,682,1277,25,13,200,1538,11,199,116,219,210,335,1557,2584,6,15641,868,0,2,0,14,0
1884,19,455,819,519,539,24,98,155,843,15,96,57,106,111,163,690,1107,8,9171,509,0,2,0,14,0
1908,18,919,1513,682,1277,25,13,200,1538,11,199,116,219,210,335,1557,2584,6,15641,868,0,2,5,5,1
1911,154,2757,1338,495,1086,10,64,173,1348,11,122,82,157,133,239,883,1686,7,11934,663,0,2,1,5,1
1912,28,1795,373,158,315,8,0,51,381,5,76,44,79,81,123,486,779,2,2026,112,0,2,1,1,1
1913,22,1090,1513,682,1277,25,13,200,1538,11,199,116,219,210,335,1557,2584,6,15641,868,0,2,54,32,1
1914,23,1138,1513,682,1277,25,13,200,1538,11,199,116,219,210,335,1557,2584,6,15641,868,0,2,9,1,0
1915,78,1665,127,75,83,2,11,30,129,4,14,7,14,18,21,61,87,2,175,9,0,2,35,25,1
1916,78,1665,652,304,544,16,6,88,668,6,89,51,101,95,152,591,998,3,3399,188,0,2,35,25,1
1917,78,1665,2,2,2,0,0,0,2,0,0,0,0,0,0,0,0,0,0,0,0,2,35,25,1
1918,78,1665,8,5,5,0,0,3,8,0,0,0,0,0,0,0,0,0,0,0,0,2,35,25,1
1921,78,1665,14,8,8,0,0,6,14,0,0,0,0,0,0,0,0,0,0,0,0,2,35,25,1
1922,78,1665,6,4,4,0,0,2,6,0,0,0,0,0,0,0,0,0,0,0,0,2,35,25,1
1923,78,1665,6,4,4,0,0,2,6,1,2,1,2,3,3,2,4,0,2,0,0,2,35,25,1
1925,78,1665,7,5,5,0,0,2,7,0,0,0,0,0,0,0,0,0,0,0,0,2,35,25,1
1927,78,1665,10,6,6,0,0,4,10,0,0,0,0,0,0,0,0,0,0,0,0,2,35,25,1
1928,78,1665,1,1,1,0,0,0,1,0,0,0,0,0,0,0,0,0,0,0,0,2,35,25,1
1930,78,1665,14,10,10,0,0,4,14,1,1,1,1,2,2,0,2,0,1,0,0,2,35,25,1
1931,78,1665,46,26,30,3,0,12,49,3,6,3,6,9,9,20,28,1,42,2,0,2,35,25,1
1932,6,609,652,304,544,16,6,88,668,6,89,51,101,95,152,591,998,3,3399,188,0,2,13,1,1
1933,78,1680,127,75,83,2,11,30,129,4,14,7,14,18,21,61,87,2,175,9,0,2,13,10,0
1934,78,1680,652,304,544,16,6,88,668,6,89,51,101,95,152,591,998,3,3399,188,0,2,13,10,0
1935,78,1680,2,2,2,0,0,0,2,0,0,0,0,0,0,0,0,0,0,0,0,2,13,10,0
1936,78,1680,8,5,5,0,0,3,8,0,0,0,0,0,0,0,0,0,0,0,0,2,13,10,0
1939,78,1680,14,8,8,0,0,6,14,0,0,0,0,0,0,0,0,0,0,0,0,2,13,10,0
1940,78,1680,6,4,4,0,0,2,6,0,0,0,0,0,0,0,0,0,0,0,0,2,13,10,0
1941,78,1680,6,4,4,0,0,2,6,1,2,1,2,3,3,2,4,0,2,0,0,2,13,10,0
1943,78,1680,7,5,5,0,0,2,7,0,0,0,0,0,0,0,0,0,0,0,0,2,13,10,0
1945,78,1680,10,6,6,0,0,4,10,0,0,0,0,0,0,0,0,0,0,0,0,2,13,10,0
1946,78,1680,1,1,1,0,0,0,1,0,0,0,0,0,0,0,0,0,0,0,0,2,13,10,0
1948,78,1680,14,10,10,0,0,4,14,1,1,1,1,2,2,0,2,0,1,0,0,2,13,10,0
1949,78,1680,46,26,30,3,0,12,49,3,6,3,6,9,9,20,28,1,42,2,0,2,13,10,0
1950,79,1683,127,75,83,2,11,30,129,4,14,7,14,18,21,61,87,2,175,9,0,2,45,40,0
1951,79,1683,652,304,544,16,6,88,668,6,89,51,101,95,152,591,998,3,3399,188,0,2,45,40,0
1952,79,1683,2,2,2,0,0,0,2,0,0,0,0,0,0,0,0,0,0,0,0,2,45,40,0
1953,79,1683,8,5,5,0,0,3,8,0,0,0,0,0,0,0,0,0,0,0,0,2,45,40,0
1956,79,1683,14,8,8,0,0,6,14,0,0,0,0,0,0,0,0,0,0,0,0,2,45,40,0
1957,79,1683,6,4,4,0,0,2,6,0,0,0,0,0,0,0,0,0,0,0,0,2,45,40,0
1958,79,1683,6,4,4,0,0,2,6,1,2,1,2,3,3,2,4,0,2,0,0,2,45,40,0
1960,79,1683,7,5,5,0,0,2,7,0,0,0,0,0,0,0,0,0,0,0,0,2,45,40,0
1962,79,1683,10,6,6,0,0,4,10,0,0,0,0,0,0,0,0,0,0,0,0,2,45,40,0
1963,79,1683,1,1,1,0,0,0,1,0,0,0,0,0,0,0,0,0,0,0,0,2,45,40,0
1965,79,1683,14,10,10,0,0,4,14,1,1,1,1,2,2,0,2,0,1,0,0,2,45,40,0
1966,79,1683,46,26,30,3,0,12,49,3,6,3,6,9,9,20,28,1,42,2,0,2,45,40,0
1967,7,611,652,304,544,16,6,88,668,6,89,51,101,95,152,591,998,3,3399,188,0,2,16,17,0
1968,19,557,14,9,9,0,0,5,14,0,0,0,0,0,0,0,0,0,0,0,0,2,8,8,1
1969,19,557,16,9,9,0,0,7,16,0,0,0,0,0,0,0,0,0,0,0,0,2,8,8,1
1993,1,85,13,10,10,0,0,3,13,1,2,1,2,3,3,2,4,0,2,0,0,2,3,2,0
1994,7,571,652,304,544,16,6,88,668,6,89,51,101,95,152,591,998,3,3399,188,0,2,10,9,0
1995,150,2630,1338,495,1086,10,64,173,1348,11,122,82,157,133,239,883,1686,7,11934,663,0,2,0,21,0
1996,6,203,256,139,192,9,7,47,265,4,23,12,24,27,36,112,171,2,357,19,0,2,1,1,0
1997,49,683,373,158,315,8,0,51,381,5,76,44,79,81,123,486,779,2,2026,112,0,2,6,5,0
1998,74,1822,1943,715,1694,26,18,214,1969,12,185,120,237,197,357,1436,2721,7,20915,1161,0,2,13,12,0
1999,74,1822,1168,838,957,57,25,144,1225,19,348,224,416,367,640,3018,5452,11,61921,3440,1,2,13,12,0
2000,4,200,1455,414,1257,16,76,112,1471,5,41,23,46,46,69,231,381,2,1069,59,0,2,2,1,0
2001,28,1715,373,158,315,8,0,51,381,5,76,44,79,81,123,486,779,2,2026,112,0,2,17,16,0
2025,150,2630,1338,495,1086,10,64,173,1348,11,122,82,157,133,239,883,1686,7,11934,663,0,2,1,1,0
2026,152,2651,1338,495,1086,10,64,173,1348,11,122,82,157,133,239,883,1686,7,11934,663,0,2,29,24,0
2027,63,1405,1457,730,1242,11,6,188,1468,10,292,166,329,302,495,2424,4078,5,22973,1276,1,2,2,2,0
2028,63,1405,74,35,59,1,0,14,75,3,14,7,14,17,21,58,85,1,128,7,0,2,2,2,0
2029,63,1405,245,125,200,5,7,34,250,7,30,17,34,37,51,166,265,3,1053,58,0,2,2,2,0
2030,49,683,373,158,315,8,0,51,381,5,76,44,79,81,123,486,779,2,2026,112,0,2,1,1,0
2031,74,1822,1943,715,1694,26,18,214,1969,12,185,120,237,197,357,1436,2721,7,20915,1161,0,2,4,4,0
2032,74,1822,1168,838,957,57,25,144,1225,19,348,224,416,367,640,3018,5452,11,61921,3440,1,2,4,4,0
2033,43,2647,1457,730,1242,11,6,188,1468,10,292,166,329,302,495,2424,4078,5,22973,1276,1,2,5,5,0
2034,28,1715,373,158,315,8,0,51,381,5,76,44,79,81,123,486,779,2,2026,112,0,2,3,3,0
2035,152,2651,1338,495,1086,10,64,173,1348,11,122,82,157,133,239,883,1686,7,11934,663,0,2,6,6,1
2036,74,1822,1943,715,1694,26,18,214,1969,12,185,120,237,197,357,1436,2721,7,20915,1161,0,2,2,2,1
2037,74,1822,1168,838,957,57,25,144,1225,19,348,224,416,367,640,3018,5452,11,61921,3440,1,2,2,2,1
2038,4,200,1455,414,1257,16,76,112,1471,5,41,23,46,46,69,231,381,2,1069,59,0,2,1,1,1
2039,61,1365,1457,730,1242,11,6,188,1468,10,292,166,329,302,495,2424,4078,5,22973,1276,1,2,0,8,0
2040,61,1365,74,35,59,1,0,14,75,3,14,7,14,17,21,58,85,1,128,7,0,2,0,8,0
2041,61,1365,245,125,200,5,7,34,250,7,30,17,34,37,51,166,265,3,1053,58,0,2,0,8,0
2042,152,2651,1338,495,1086,10,64,173,1348,11,122,82,157,133,239,883,1686,7,11934,663,0,2,1,1,1
2043,49,683,373,158,315,8,0,51,381,5,76,44,79,81,123,486,779,2,2026,112,0,2,1,1,1
2044,74,1813,1943,715,1694,26,18,214,1969,12,185,120,237,197,357,1436,2721,7,20915,1161,0,2,1,2,1
2045,74,1813,1168,838,957,57,25,144,1225,19,348,224,416,367,640,3018,5452,11,61921,3440,1,2,1,2,1
2046,152,2659,1338,495,1086,10,64,173,1348,11,122,82,157,133,239,883,1686,7,11934,663,0,2,2,1,0
2047,152,2655,1338,495,1086,10,64,173,1348,11,122,82,157,133,239,883,1686,7,11934,663,0,2,1,1,0
2048,64,1432,1457,730,1242,11,6,188,1468,10,292,166,329,302,495,2424,4078,5,22973,1276,1,2,14,0,1
2049,64,1432,74,35,59,1,0,14,75,3,14,7,14,17,21,58,85,1,128,7,0,2,14,0,1
2050,64,1432,245,125,200,5,7,34,250,7,30,17,34,37,51,166,265,3,1053,58,0,2,14,0,1
2051,44,2743,1457,730,1242,11,6,188,1468,10,292,166,329,302,495,2424,4078,5,22973,1276,1,2,13,1,1
2345,62,1413,1457,730,1242,11,6,188,1468,10,292,166,329,302,495,2424,4078,5,22973,1276,1,2,2,6,0
2346,62,1413,74,35,59,1,0,14,75,3,14,7,14,17,21,58,85,1,128,7,0,2,2,6,0
2347,62,1413,245,125,200,5,7,34,250,7,30,17,34,37,51,166,265,3,1053,58,0,2,2,6,0
2348,44,2833,1457,730,1242,11,6,188,1468,10,292,166,329,302,495,2424,4078,5,22973,1276,1,2,23,15,0
2349,29,1741,373,158,315,8,0,51,381,5,76,44,79,81,123,486,779,2,2026,112,0,2,4,0,0
2350,44,2848,1457,730,1242,11,6,188,1468,10,292,166,329,302,495,2424,4078,5,22973,1276,1,2,4,2,0
2351,44,2906,1457,730,1242,11,6,188,1468,10,292,166,329,302,495,2424,4078,5,22973,1276,1,2,8,3,0
2352,79,1690,127,75,83,2,11,30,129,4,14,7,14,18,21,61,87,2,175,9,0,2,1,0,0
2353,79,1690,652,304,544,16,6,88,668,6,89,51,101,95,152,591,998,3,3399,188,0,2,1,0,0
2354,79,1690,2,2,2,0,0,0,2,0,0,0,0,0,0,0,0,0,0,0,0,2,1,0,0
2355,79,1690,8,5,5,0,0,3,8,0,0,0,0,0,0,0,0,0,0,0,0,2,1,0,0
2358,79,1690,14,8,8,0,0,6,14,0,0,0,0,0,0,0,0,0,0,0,0,2,1,0,0
2359,79,1690,6,4,4,0,0,2,6,0,0,0,0,0,0,0,0,0,0,0,0,2,1,0,0
2360,79,1690,6,4,4,0,0,2,6,1,2,1,2,3,3,2,4,0,2,0,0,2,1,0,0
2362,79,1690,7,5,5,0,0,2,7,0,0,0,0,0,0,0,0,0,0,0,0,2,1,0,0
2364,79,1690,10,6,6,0,0,4,10,0,0,0,0,0,0,0,0,0,0,0,0,2,1,0,0
2365,79,1690,1,1,1,0,0,0,1,0,0,0,0,0,0,0,0,0,0,0,0,2,1,0,0
2367,79,1690,14,10,10,0,0,4,14,1,1,1,1,2,2,0,2,0,1,0,0,2,1,0,0
2368,79,1690,46,26,30,3,0,12,49,3,6,3,6,9,9,20,28,1,42,2,0,2,1,0,0
2369,8,660,652,304,544,16,6,88,668,6,89,51,101,95,152,591,998,3,3399,188,0,2,15,0,0
2370,79,1690,127,75,83,2,11,30,129,4,14,7,14,18,21,61,87,2,175,9,0,2,2,2,0
2371,79,1690,652,304,544,16,6,88,668,6,89,51,101,95,152,591,998,3,3399,188,0,2,2,2,0
2372,79,1690,2,2,2,0,0,0,2,0,0,0,0,0,0,0,0,0,0,0,0,2,2,2,0
2373,79,1690,8,5,5,0,0,3,8,0,0,0,0,0,0,0,0,0,0,0,0,2,2,2,0
2376,79,1690,14,8,8,0,0,6,14,0,0,0,0,0,0,0,0,0,0,0,0,2,2,2,0
2377,79,1690,6,4,4,0,0,2,6,0,0,0,0,0,0,0,0,0,0,0,0,2,2,2,0
2378,79,1690,6,4,4,0,0,2,6,1,2,1,2,3,3,2,4,0,2,0,0,2,2,2,0
2380,79,1690,7,5,5,0,0,2,7,0,0,0,0,0,0,0,0,0,0,0,0,2,2,2,0
2382,79,1690,10,6,6,0,0,4,10,0,0,0,0,0,0,0,0,0,0,0,0,2,2,2,0
2383,79,1690,1,1,1,0,0,0,1,0,0,0,0,0,0,0,0,0,0,0,0,2,2,2,0
2385,79,1690,14,10,10,0,0,4,14,1,1,1,1,2,2,0,2,0,1,0,0,2,2,2,0
2386,79,1690,46,26,30,3,0,12,49,3,6,3,6,9,9,20,28,1,42,2,0,2,2,2,0
2387,47,2925,1457,730,1242,11,6,188,1468,10,292,166,329,302,495,2424,4078,5,22973,1276,1,2,11,7,0
2388,87,1812,127,75,83,2,11,30,129,4,14,7,14,18,21,61,87,2,175,9,0,2,22,4,0
2389,87,1812,652,304,544,16,6,88,668,6,89,51,101,95,152,591,998,3,3399,188,0,2,22,4,0
2390,87,1812,2,2,2,0,0,0,2,0,0,0,0,0,0,0,0,0,0,0,0,2,22,4,0
2391,87,1812,8,5,5,0,0,3,8,0,0,0,0,0,0,0,0,0,0,0,0,2,22,4,0
2394,87,1812,14,8,8,0,0,6,14,0,0,0,0,0,0,0,0,0,0,0,0,2,22,4,0
2395,87,1812,6,4,4,0,0,2,6,0,0,0,0,0,0,0,0,0,0,0,0,2,22,4,0
2396,87,1812,6,4,4,0,0,2,6,1,2,1,2,3,3,2,4,0,2,0,0,2,22,4,0
2398,87,1812,7,5,5,0,0,2,7,0,0,0,0,0,0,0,0,0,0,0,0,2,22,4,0
2400,87,1812,10,6,6,0,0,4,10,0,0,0,0,0,0,0,0,0,0,0,0,2,22,4,0
2401,87,1812,1,1,1,0,0,0,1,0,0,0,0,0,0,0,0,0,0,0,0,2,22,4,0
2403,87,1812,14,10,10,0,0,4,14,1,1,1,1,2,2,0,2,0,1,0,0,2,22,4,0
2404,87,1812,46,26,30,3,0,12,49,3,6,3,6,9,9,20,28,1,42,2,0,2,22,4,0
2405,10,824,652,304,544,16,6,88,668,6,89,51,101,95,152,591,998,3,3399,188,0,2,24,0,0
2406,63,1436,1457,730,1242,11,6,188,1468,10,292,166,329,302,495,2424,4078,5,22973,1276,1,2,5,2,0
2407,63,1436,74,35,59,1,0,14,75,3,14,7,14,17,21,58,85,1,128,7,0,2,5,2,0
2408,63,1436,245,125,200,5,7,34,250,7,30,17,34,37,51,166,265,3,1053,58,0,2,5,2,0
2409,50,2993,1457,730,1242,11,6,188,1468,10,292,166,329,302,495,2424,4078,5,22973,1276,1,2,15,0,0
2410,62,1440,1457,730,1242,11,6,188,1468,10,292,166,329,302,495,2424,4078,5,22973,1276,1,2,7,8,0
2411,62,1440,74,35,59,1,0,14,75,3,14,7,14,17,21,58,85,1,128,7,0,2,7,8,0
2412,62,1440,245,125,200,5,7,34,250,7,30,17,34,37,51,166,265,3,1053,58,0,2,7,8,0
2413,62,1413,1457,730,1242,11,6,188,1468,10,292,166,329,302,495,2424,4078,5,22973,1276,1,2,4,6,0
2414,62,1413,74,35,59,1,0,14,75,3,14,7,14,17,21,58,85,1,128,7,0,2,4,6,0
2415,62,1413,245,125,200,5,7,34,250,7,30,17,34,37,51,166,265,3,1053,58,0,2,4,6,0
2416,47,2925,1457,730,1242,11,6,188,1468,10,292,166,329,302,495,2424,4078,5,22973,1276,1,2,0,15,0
2485,63,1428,1457,730,1242,11,6,188,1468,10,292,166,329,302,495,2424,4078,5,22973,1276,1,2,4,0,0
2486,63,1428,74,35,59,1,0,14,75,3,14,7,14,17,21,58,85,1,128,7,0,2,4,0,0
2487,63,1428,245,125,200,5,7,34,250,7,30,17,34,37,51,166,265,3,1053,58,0,2,4,0,0
2511,150,2618,1338,495,1086,10,64,173,1348,11,122,82,157,133,239,883,1686,7,11934,663,0,2,2,7,0
2512,69,1548,1457,730,1242,11,6,188,1468,10,292,166,329,302,495,2424,4078,5,22973,1276,1,2,18,0,0
2513,69,1548,74,35,59,1,0,14,75,3,14,7,14,17,21,58,85,1,128,7,0,2,18,0,0
2514,69,1548,245,125,200,5,7,34,250,7,30,17,34,37,51,166,265,3,1053,58,0,2,18,0,0
2515,48,3110,1457,730,1242,11,6,188,1468,10,292,166,329,302,495,2424,4078,5,22973,1276,1,2,24,0,0
2516,29,1712,373,158,315,8,0,51,381,5,76,44,79,81,123,486,779,2,2026,112,0,2,2,5,0
2517,68,1525,1457,730,1242,11,6,188,1468,10,292,166,329,302,495,2424,4078,5,22973,1276,1,2,2,8,0
2518,68,1525,74,35,59,1,0,14,75,3,14,7,14,17,21,58,85,1,128,7,0,2,2,8,0
2519,68,1525,245,125,200,5,7,34,250,7,30,17,34,37,51,166,265,3,1053,58,0,2,2,8,0
2520,48,3109,1457,730,1242,11,6,188,1468,10,292,166,329,302,495,2424,4078,5,22973,1276,1,2,1,1,0
2521,74,1795,1943,715,1694,26,18,214,1969,12,185,120,237,197,357,1436,2721,7,20915,1161,0,2,2,2,0
2522,74,1795,1168,838,957,57,25,144,1225,19,348,224,416,367,640,3018,5452,11,61921,3440,1,2,2,2,0
2523,68,1525,1457,730,1242,11,6,188,1468,10,292,166,329,302,495,2424,4078,5,22973,1276,1,2,3,2,0
2524,68,1525,74,35,59,1,0,14,75,3,14,7,14,17,21,58,85,1,128,7,0,2,3,2,0
2525,68,1525,245,125,200,5,7,34,250,7,30,17,34,37,51,166,265,3,1053,58,0,2,3,2,0
2526,69,1539,1457,730,1242,11,6,188,1468,10,292,166,329,302,495,2424,4078,5,22973,1276,1,2,8,5,0
2527,69,1539,74,35,59,1,0,14,75,3,14,7,14,17,21,58,85,1,128,7,0,2,8,5,0
2528,69,1539,245,125,200,5,7,34,250,7,30,17,34,37,51,166,265,3,1053,58,0,2,8,5,0
2529,48,3144,1457,730,1242,11,6,188,1468,10,292,166,329,302,495,2424,4078,5,22973,1276,1,2,4,0,0
2530,88,1867,127,75,83,2,11,30,129,4,14,7,14,18,21,61,87,2,175,9,0,2,12,3,1
2531,88,1867,652,304,544,16,6,88,668,6,89,51,101,95,152,591,998,3,3399,188,0,2,12,3,1
2532,88,1867,2,2,2,0,0,0,2,0,0,0,0,0,0,0,0,0,0,0,0,2,12,3,1
2533,88,1867,8,5,5,0,0,3,8,0,0,0,0,0,0,0,0,0,0,0,0,2,12,3,1
2536,88,1867,14,8,8,0,0,6,14,0,0,0,0,0,0,0,0,0,0,0,0,2,12,3,1
2537,88,1867,6,4,4,0,0,2,6,0,0,0,0,0,0,0,0,0,0,0,0,2,12,3,1
2538,88,1867,6,4,4,0,0,2,6,1,2,1,2,3,3,2,4,0,2,0,0,2,12,3,1
2540,88,1867,7,5,5,0,0,2,7,0,0,0,0,0,0,0,0,0,0,0,0,2,12,3,1
2542,88,1867,10,6,6,0,0,4,10,0,0,0,0,0,0,0,0,0,0,0,0,2,12,3,1
2543,88,1867,1,1,1,0,0,0,1,0,0,0,0,0,0,0,0,0,0,0,0,2,12,3,1
2545,88,1867,14,10,10,0,0,4,14,1,1,1,1,2,2,0,2,0,1,0,0,2,12,3,1
2546,88,1867,46,26,30,3,0,12,49,3,6,3,6,9,9,20,28,1,42,2,0,2,12,3,1
2547,10,851,652,304,544,16,6,88,668,6,89,51,101,95,152,591,998,3,3399,188,0,2,8,6,1
2548,88,1870,127,75,83,2,11,30,129,4,14,7,14,18,21,61,87,2,175,9,0,2,2,1,1
2549,88,1870,652,304,544,16,6,88,668,6,89,51,101,95,152,591,998,3,3399,188,0,2,2,1,1
2550,88,1870,2,2,2,0,0,0,2,0,0,0,0,0,0,0,0,0,0,0,0,2,2,1,1
2551,88,1870,8,5,5,0,0,3,8,0,0,0,0,0,0,0,0,0,0,0,0,2,2,1,1
2554,88,1870,14,8,8,0,0,6,14,0,0,0,0,0,0,0,0,0,0,0,0,2,2,1,1
2555,88,1870,6,4,4,0,0,2,6,0,0,0,0,0,0,0,0,0,0,0,0,2,2,1,1
2556,88,1870,6,4,4,0,0,2,6,1,2,1,2,3,3,2,4,0,2,0,0,2,2,1,1
2558,88,1870,7,5,5,0,0,2,7,0,0,0,0,0,0,0,0,0,0,0,0,2,2,1,1
2560,88,1870,10,6,6,0,0,4,10,0,0,0,0,0,0,0,0,0,0,0,0,2,2,1,1
2561,88,1870,1,1,1,0,0,0,1,0,0,0,0,0,0,0,0,0,0,0,0,2,2,1,1
2563,88,1870,14,10,10,0,0,4,14,1,1,1,1,2,2,0,2,0,1,0,0,2,2,1,1
2564,88,1870,46,26,30,3,0,12,49,3,6,3,6,9,9,20,28,1,42,2,0,2,2,1,1
2565,69,1539,1457,730,1242,11,6,188,1468,10,292,166,329,302,495,2424,4078,5,22973,1276,1,2,4,4,0
2566,69,1539,74,35,59,1,0,14,75,3,14,7,14,17,21,58,85,1,128,7,0,2,4,4,0
2567,69,1539,245,125,200,5,7,34,250,7,30,17,34,37,51,166,265,3,1053,58,0,2,4,4,0
2568,48,3144,1457,730,1242,11,6,188,1468,10,292,166,329,302,495,2424,4078,5,22973,1276,1,2,11,11,0
2569,69,1539,1457,730,1242,11,6,188,1468,10,292,166,329,302,495,2424,4078,5,22973,1276,1,2,1,1,0
2570,69,1539,74,35,59,1,0,14,75,3,14,7,14,17,21,58,85,1,128,7,0,2,1,1,0
2571,69,1539,245,125,200,5,7,34,250,7,30,17,34,37,51,166,265,3,1053,58,0,2,1,1,0
2572,48,3144,1457,730,1242,11,6,188,1468,10,292,166,329,302,495,2424,4078,5,22973,1276,1,2,4,4,0
2573,148,2598,1338,495,1086,10,64,173,1348,11,122,82,157,133,239,883,1686,7,11934,663,0,2,10,9,0
2574,50,3161,1457,730,1242,11,6,188,1468,10,292,166,329,302,495,2424,4078,5,22973,1276,1,2,2,1,0
2575,148,2599,1338,495,1086,10,64,173,1348,11,122,82,157,133,239,883,1686,7,11934,663,0,2,3,5,0
2576,48,3144,1457,730,1242,11,6,188,1468,10,292,166,329,302,495,2424,4078,5,22973,1276,1,2,1,2,0
2623,88,1875,127,75,83,2,11,30,129,4,14,7,14,18,21,61,87,2,175,9,0,2,1,1,1
2624,88,1875,652,304,544,16,6,88,668,6,89,51,101,95,152,591,998,3,3399,188,0,2,1,1,1
2625,88,1875,2,2,2,0,0,0,2,0,0,0,0,0,0,0,0,0,0,0,0,2,1,1,1
2626,88,1875,8,5,5,0,0,3,8,0,0,0,0,0,0,0,0,0,0,0,0,2,1,1,1
2629,88,1875,14,8,8,0,0,6,14,0,0,0,0,0,0,0,0,0,0,0,0,2,1,1,1
2630,88,1875,6,4,4,0,0,2,6,0,0,0,0,0,0,0,0,0,0,0,0,2,1,1,1
2631,88,1875,6,4,4,0,0,2,6,1,2,1,2,3,3,2,4,0,2,0,0,2,1,1,1
2633,88,1875,7,5,5,0,0,2,7,0,0,0,0,0,0,0,0,0,0,0,0,2,1,1,1
2635,88,1875,10,6,6,0,0,4,10,0,0,0,0,0,0,0,0,0,0,0,0,2,1,1,1
2636,88,1875,1,1,1,0,0,0,1,0,0,0,0,0,0,0,0,0,0,0,0,2,1,1,1
2638,88,1875,14,10,10,0,0,4,14,1,1,1,1,2,2,0,2,0,1,0,0,2,1,1,1
2639,88,1875,46,26,30,3,0,12,49,3,6,3,6,9,9,20,28,1,42,2,0,2,1,1,1
2640,69,1539,1457,730,1242,11,6,188,1468,10,292,166,329,302,495,2424,4078,5,22973,1276,1,2,9,9,0
2641,69,1539,74,35,59,1,0,14,75,3,14,7,14,17,21,58,85,1,128,7,0,2,9,9,0
2642,69,1539,245,125,200,5,7,34,250,7,30,17,34,37,51,166,265,3,1053,58,0,2,9,9,0
2643,74,1795,1943,715,1694,26,18,214,1969,12,185,120,237,197,357,1436,2721,7,20915,1161,0,2,1,1,0
2644,74,1795,1168,838,957,57,25,144,1225,19,348,224,416,367,640,3018,5452,11,61921,3440,1,2,1,1,0
2668,88,1881,127,75,83,2,11,30,129,4,14,7,14,18,21,61,87,2,175,9,0,2,3,3,1
2669,88,1881,652,304,544,16,6,88,668,6,89,51,101,95,152,591,998,3,3399,188,0,2,3,3,1
2670,88,1881,2,2,2,0,0,0,2,0,0,0,0,0,0,0,0,0,0,0,0,2,3,3,1
2671,88,1881,8,5,5,0,0,3,8,0,0,0,0,0,0,0,0,0,0,0,0,2,3,3,1
2674,88,1881,14,8,8,0,0,6,14,0,0,0,0,0,0,0,0,0,0,0,0,2,3,3,1
2675,88,1881,6,4,4,0,0,2,6,0,0,0,0,0,0,0,0,0,0,0,0,2,3,3,1
2676,88,1881,6,4,4,0,0,2,6,1,2,1,2,3,3,2,4,0,2,0,0,2,3,3,1
2678,88,1881,7,5,5,0,0,2,7,0,0,0,0,0,0,0,0,0,0,0,0,2,3,3,1
2680,88,1881,10,6,6,0,0,4,10,0,0,0,0,0,0,0,0,0,0,0,0,2,3,3,1
2681,88,1881,1,1,1,0,0,0,1,0,0,0,0,0,0,0,0,0,0,0,0,2,3,3,1
2683,88,1881,14,10,10,0,0,4,14,1,1,1,1,2,2,0,2,0,1,0,0,2,3,3,1
2684,88,1881,46,26,30,3,0,12,49,3,6,3,6,9,9,20,28,1,42,2,0,2,3,3,1
2685,148,2605,1338,495,1086,10,64,173,1348,11,122,82,157,133,239,883,1686,7,11934,663,0,2,3,3,1
2686,4,111,1455,414,1257,16,76,112,1471,5,41,23,46,46,69,231,381,2,1069,59,0,2,1,1,1
2687,4,111,669,365,481,22,61,110,691,15,103,63,122,118,185,747,1273,8,11311,628,0,2,1,1,1
2688,49,689,373,158,315,8,0,51,381,5,76,44,79,81,123,486,779,2,2026,112,0,2,3,3,1
2689,74,1799,1943,715,1694,26,18,214,1969,12,185,120,237,197,357,1436,2721,7,20915,1161,0,2,2,2,1
2690,74,1799,1168,838,957,57,25,144,1225,19,348,224,416,367,640,3018,5452,11,61921,3440,1,2,2,2,1
2691,4,202,1455,414,1257,16,76,112,1471,5,41,23,46,46,69,231,381,2,1069,59,0,2,1,1,1
2692,29,1712,373,158,315,8,0,51,381,5,76,44,79,81,123,486,779,2,2026,112,0,2,1,1,1
2710,92,1971,127,75,83,2,11,30,129,4,14,7,14,18,21,61,87,2,175,9,0,2,20,8,0
2711,92,1971,652,304,544,16,6,88,668,6,89,51,101,95,152,591,998,3,3399,188,0,2,20,8,0
2712,92,1971,2,2,2,0,0,0,2,0,0,0,0,0,0,0,0,0,0,0,0,2,20,8,0
2713,92,1971,8,5,5,0,0,3,8,0,0,0,0,0,0,0,0,0,0,0,0,2,20,8,0
2716,92,1971,14,8,8,0,0,6,14,0,0,0,0,0,0,0,0,0,0,0,0,2,20,8,0
2717,92,1971,6,4,4,0,0,2,6,0,0,0,0,0,0,0,0,0,0,0,0,2,20,8,0
2718,92,1971,6,4,4,0,0,2,6,1,2,1,2,3,3,2,4,0,2,0,0,2,20,8,0
2720,92,1971,7,5,5,0,0,2,7,0,0,0,0,0,0,0,0,0,0,0,0,2,20,8,0
2722,92,1971,10,6,6,0,0,4,10,0,0,0,0,0,0,0,0,0,0,0,0,2,20,8,0
2723,92,1971,1,1,1,0,0,0,1,0,0,0,0,0,0,0,0,0,0,0,0,2,20,8,0
2725,92,1971,14,10,10,0,0,4,14,1,1,1,1,2,2,0,2,0,1,0,0,2,20,8,0
2726,92,1971,46,26,30,3,0,12,49,3,6,3,6,9,9,20,28,1,42,2,0,2,20,8,0
2744,92,1991,127,75,83,2,11,30,129,4,14,7,14,18,21,61,87,2,175,9,0,2,4,2,0
2745,92,1991,652,304,544,16,6,88,668,6,89,51,101,95,152,591,998,3,3399,188,0,2,4,2,0
2746,92,1991,2,2,2,0,0,0,2,0,0,0,0,0,0,0,0,0,0,0,0,2,4,2,0
2747,92,1991,8,5,5,0,0,3,8,0,0,0,0,0,0,0,0,0,0,0,0,2,4,2,0
2750,92,1991,14,8,8,0,0,6,14,0,0,0,0,0,0,0,0,0,0,0,0,2,4,2,0
2751,92,1991,6,4,4,0,0,2,6,0,0,0,0,0,0,0,0,0,0,0,0,2,4,2,0
2752,92,1991,6,4,4,0,0,2,6,1,2,1,2,3,3,2,4,0,2,0,0,2,4,2,0
2754,92,1991,7,5,5,0,0,2,7,0,0,0,0,0,0,0,0,0,0,0,0,2,4,2,0
2756,92,1991,10,6,6,0,0,4,10,0,0,0,0,0,0,0,0,0,0,0,0,2,4,2,0
2757,92,1991,1,1,1,0,0,0,1,0,0,0,0,0,0,0,0,0,0,0,0,2,4,2,0
2759,92,1991,14,10,10,0,0,4,14,1,1,1,1,2,2,0,2,0,1,0,0,2,4,2,0
2760,92,1991,46,26,30,3,0,12,49,3,6,3,6,9,9,20,28,1,42,2,0,2,4,2,0
2761,92,1995,127,75,83,2,11,30,129,4,14,7,14,18,21,61,87,2,175,9,0,2,2,1,0
2762,92,1995,652,304,544,16,6,88,668,6,89,51,101,95,152,591,998,3,3399,188,0,2,2,1,0
2763,92,1995,2,2,2,0,0,0,2,0,0,0,0,0,0,0,0,0,0,0,0,2,2,1,0
2764,92,1995,8,5,5,0,0,3,8,0,0,0,0,0,0,0,0,0,0,0,0,2,2,1,0
2767,92,1995,14,8,8,0,0,6,14,0,0,0,0,0,0,0,0,0,0,0,0,2,2,1,0
2768,92,1995,6,4,4,0,0,2,6,0,0,0,0,0,0,0,0,0,0,0,0,2,2,1,0
2769,92,1995,6,4,4,0,0,2,6,1,2,1,2,3,3,2,4,0,2,0,0,2,2,1,0
2771,92,1995,7,5,5,0,0,2,7,0,0,0,0,0,0,0,0,0,0,0,0,2,2,1,0
2773,92,1995,10,6,6,0,0,4,10,0,0,0,0,0,0,0,0,0,0,0,0,2,2,1,0
2774,92,1995,1,1,1,0,0,0,1,0,0,0,0,0,0,0,0,0,0,0,0,2,2,1,0
2776,92,1995,14,10,10,0,0,4,14,1,1,1,1,2,2,0,2,0,1,0,0,2,2,1,0
2777,92,1995,46,26,30,3,0,12,49,3,6,3,6,9,9,20,28,1,42,2,0,2,2,1,0
2801,93,1999,127,75,83,2,11,30,129,4,14,7,14,18,21,61,87,2,175,9,0,2,7,6,0
2802,93,1999,652,304,544,16,6,88,668,6,89,51,101,95,152,591,998,3,3399,188,0,2,7,6,0
2803,93,1999,2,2,2,0,0,0,2,0,0,0,0,0,0,0,0,0,0,0,0,2,7,6,0
2804,93,1999,8,5,5,0,0,3,8,0,0,0,0,0,0,0,0,0,0,0,0,2,7,6,0
2807,93,1999,14,8,8,0,0,6,14,0,0,0,0,0,0,0,0,0,0,0,0,2,7,6,0
2808,93,1999,6,4,4,0,0,2,6,0,0,0,0,0,0,0,0,0,0,0,0,2,7,6,0
2809,93,1999,6,4,4,0,0,2,6,1,2,1,2,3,3,2,4,0,2,0,0,2,7,6,0
2811,93,1999,7,5,5,0,0,2,7,0,0,0,0,0,0,0,0,0,0,0,0,2,7,6,0
2813,93,1999,10,6,6,0,0,4,10,0,0,0,0,0,0,0,0,0,0,0,0,2,7,6,0
2814,93,1999,1,1,1,0,0,0,1,0,0,0,0,0,0,0,0,0,0,0,0,2,7,6,0
2816,93,1999,14,10,10,0,0,4,14,1,1,1,1,2,2,0,2,0,1,0,0,2,7,6,0
2817,93,1999,46,26,30,3,0,12,49,3,6,3,6,9,9,20,28,1,42,2,0,2,7,6,0
2818,94,2025,127,75,83,2,11,30,129,4,14,7,14,18,21,61,87,2,175,9,0,2,3,0,0
2819,94,2025,652,304,544,16,6,88,668,6,89,51,101,95,152,591,998,3,3399,188,0,2,3,0,0
2820,94,2025,2,2,2,0,0,0,2,0,0,0,0,0,0,0,0,0,0,0,0,2,3,0,0
2821,94,2025,8,5,5,0,0,3,8,0,0,0,0,0,0,0,0,0,0,0,0,2,3,0,0
2824,94,2025,14,8,8,0,0,6,14,0,0,0,0,0,0,0,0,0,0,0,0,2,3,0,0
2825,94,2025,6,4,4,0,0,2,6,0,0,0,0,0,0,0,0,0,0,0,0,2,3,0,0
2826,94,2025,6,4,4,0,0,2,6,1,2,1,2,3,3,2,4,0,2,0,0,2,3,0,0
2828,94,2025,7,5,5,0,0,2,7,0,0,0,0,0,0,0,0,0,0,0,0,2,3,0,0
2830,94,2025,10,6,6,0,0,4,10,0,0,0,0,0,0,0,0,0,0,0,0,2,3,0,0
2831,94,2025,1,1,1,0,0,0,1,0,0,0,0,0,0,0,0,0,0,0,0,2,3,0,0
2833,94,2025,14,10,10,0,0,4,14,1,1,1,1,2,2,0,2,0,1,0,0,2,3,0,0
2834,94,2025,46,26,30,3,0,12,49,3,6,3,6,9,9,20,28,1,42,2,0,2,3,0,0
2927,74,1803,1943,715,1694,26,18,214,1969,12,185,120,237,197,357,1436,2721,7,20915,1161,0,2,9,5,0
2928,74,1803,1168,838,957,57,25,144,1225,19,348,224,416,367,640,3018,5452,11,61921,3440,1,2,9,5,0
2952,146,2579,1338,495,1086,10,64,173,1348,11,122,82,157,133,239,883,1686,7,11934,663,0,2,3,8,0
3114,41,1388,773,419,590,28,0,166,801,10,204,113,217,214,330,1598,2554,5,13587,754,0,2,12,0,0
3115,154,2728,1338,495,1086,10,64,173,1348,11,122,82,157,133,239,883,1686,7,11934,663,0,2,32,1,0
3116,54,751,373,158,315,8,0,51,381,5,76,44,79,81,123,486,779,2,2026,112,0,2,16,5,0
3117,30,1793,373,158,315,8,0,51,381,5,76,44,79,81,123,486,779,2,2026,112,0,2,14,2,0
3118,52,722,373,158,315,8,0,51,381,5,76,44,79,81,123,486,779,2,2026,112,0,2,6,11,0
3119,30,1793,373,158,315,8,0,51,381,5,76,44,79,81,123,486,779,2,2026,112,0,2,1,2,0
3120,6,265,207,111,150,11,0,50,218,5,26,19,36,31,55,133,272,3,943,52,0,0,59,0,0
3121,6,265,410,198,237,31,55,97,441,11,63,38,72,74,110,414,683,6,4293,238,0,0,59,0,0
3122,4,225,207,111,150,11,0,50,218,5,26,19,36,31,55,133,272,3,943,52,0,0,53,0,0
3146,154,2728,1338,495,1086,10,64,173,1348,11,122,82,157,133,239,883,1686,7,11934,663,0,2,1,1,0
3147,154,2732,1338,495,1086,10,64,173,1348,11,122,82,157,133,239,883,1686,7,11934,663,0,2,1,1,0
3148,13,259,1392,870,1177,35,17,170,1427,14,494,280,531,508,811,4473,7289,7,54850,3047,2,2,3,0,0
3149,12,243,1392,870,1177,35,17,170,1427,14,494,280,531,508,811,4473,7289,7,54850,3047,2,2,1,4,0
3190,31,1899,373,158,315,8,0,51,381,5,76,44,79,81,123,486,779,2,2026,112,0,2,21,0,1
3214,152,2711,1338,495,1086,10,64,173,1348,11,122,82,157,133,239,883,1686,7,11934,663,0,2,1,4,0
3215,148,2629,1338,495,1086,10,64,173,1348,11,122,82,157,133,239,883,1686,7,11934,663,0,2,5,16,0
3216,59,833,373,158,315,8,0,51,381,5,76,44,79,81,123,486,779,2,2026,112,0,2,37,19,0
3217,48,3132,1457,730,1242,11,6,188,1468,10,292,166,329,302,495,2424,4078,5,22973,1276,1,2,0,1,0
3264,74,1813,1943,715,1694,26,18,214,1969,12,185,120,237,197,357,1436,2721,7,20915,1161,0,2,2,2,0
3265,74,1813,1168,838,957,57,25,144,1225,19,348,224,416,367,640,3018,5452,11,61921,3440,1,2,2,2,0
3266,74,1815,1943,715,1694,26,18,214,1969,12,185,120,237,197,357,1436,2721,7,20915,1161,0,2,1,1,0
3267,74,1815,1168,838,957,57,25,144,1225,19,348,224,416,367,640,3018,5452,11,61921,3440,1,2,1,1,0
3268,157,2724,1338,495,1086,10,64,173,1348,11,122,82,157,133,239,883,1686,7,11934,663,0,2,23,8,0
3269,59,833,373,158,315,8,0,51,381,5,76,44,79,81,123,486,779,2,2026,112,0,2,1,1,0
3270,32,1923,373,158,315,8,0,51,381,5,76,44,79,81,123,486,779,2,2026,112,0,2,13,10,0
3271,59,840,373,158,315,8,0,51,381,5,76,44,79,81,123,486,779,2,2026,112,0,2,1,0,0
3272,95,2040,127,75,83,2,11,30,129,4,14,7,14,18,21,61,87,2,175,9,0,2,3,2,0
3273,95,2040,652,304,544,16,6,88,668,6,89,51,101,95,152,591,998,3,3399,188,0,2,3,2,0
3274,95,2040,2,2,2,0,0,0,2,0,0,0,0,0,0,0,0,0,0,0,0,2,3,2,0
3275,95,2040,8,5,5,0,0,3,8,0,0,0,0,0,0,0,0,0,0,0,0,2,3,2,0
3278,95,2040,14,8,8,0,0,6,14,0,0,0,0,0,0,0,0,0,0,0,0,2,3,2,0
3279,95,2040,6,4,4,0,0,2,6,0,0,0,0,0,0,0,0,0,0,0,0,2,3,2,0
3280,95,2040,6,4,4,0,0,2,6,1,2,1,2,3,3,2,4,0,2,0,0,2,3,2,0
3282,95,2040,7,5,5,0,0,2,7,0,0,0,0,0,0,0,0,0,0,0,0,2,3,2,0
3284,95,2040,10,6,6,0,0,4,10,0,0,0,0,0,0,0,0,0,0,0,0,2,3,2,0
3285,95,2040,1,1,1,0,0,0,1,0,0,0,0,0,0,0,0,0,0,0,0,2,3,2,0
3287,95,2040,14,10,10,0,0,4,14,1,1,1,1,2,2,0,2,0,1,0,0,2,3,2,0
3288,95,2040,46,26,30,3,0,12,49,3,6,3,6,9,9,20,28,1,42,2,0,2,3,2,0
3289,62,1372,773,419,590,28,0,166,801,10,204,113,217,214,330,1598,2554,5,13587,754,0,2,1,1,0
3290,62,1372,421,273,302,44,34,57,465,17,81,59,107,98,166,583,1098,11,12329,684,0,2,1,1,0
3314,1,70,13,10,10,0,0,3,13,1,2,1,2,3,3,2,4,0,2,0,0,2,4,6,1
3315,16,823,652,304,544,16,6,88,668,6,89,51,101,95,152,591,998,3,3399,188,0,2,32,28,1
3316,157,2724,1338,495,1086,10,64,173,1348,11,122,82,157,133,239,883,1686,7,11934,663,0,2,1,1,1
3317,67,1507,1457,730,1242,11,6,188,1468,10,292,166,329,302,495,2424,4078,5,22973,1276,1,2,7,14,1
3318,67,1507,74,35,59,1,0,14,75,3,14,7,14,17,21,58,85,1,128,7,0,2,7,14,1
3319,67,1507,245,125,200,5,7,34,250,7,30,17,34,37,51,166,265,3,1053,58,0,2,7,14,1
3320,47,906,373,158,315,8,0,51,381,5,76,44,79,81,123,486,779,2,2026,112,0,2,94,86,1
3323,47,3118,1457,730,1242,11,6,188,1468,10,292,166,329,302,495,2424,4078,5,22973,1276,1,2,9,7,1
3324,48,1730,373,158,315,8,0,51,381,5,76,44,79,81,123,486,779,2,2026,112,0,2,94,146,1
3325,2,50,127,75,83,2,11,30,129,4,14,7,14,18,21,61,87,2,175,9,0,2,6,2,1
3326,2,50,652,304,544,16,6,88,668,6,89,51,101,95,152,591,998,3,3399,188,0,2,6,2,1
3327,2,50,2,2,2,0,0,0,2,0,0,0,0,0,0,0,0,0,0,0,0,2,6,2,1
3328,2,50,8,5,5,0,0,3,8,0,0,0,0,0,0,0,0,0,0,0,0,2,6,2,1
3331,2,50,14,8,8,0,0,6,14,0,0,0,0,0,0,0,0,0,0,0,0,2,6,2,1
3332,2,50,6,4,4,0,0,2,6,0,0,0,0,0,0,0,0,0,0,0,0,2,6,2,1
3333,2,50,6,4,4,0,0,2,6,1,2,1,2,3,3,2,4,0,2,0,0,2,6,2,1
3335,2,50,7,5,5,0,0,2,7,0,0,0,0,0,0,0,0,0,0,0,0,2,6,2,1
3337,2,50,10,6,6,0,0,4,10,0,0,0,0,0,0,0,0,0,0,0,0,2,6,2,1
3338,2,50,1,1,1,0,0,0,1,0,0,0,0,0,0,0,0,0,0,0,0,2,6,2,1
3340,2,50,14,10,10,0,0,4,14,1,1,1,1,2,2,0,2,0,1,0,0,2,6,2,1
3341,2,50,46,26,30,3,0,12,49,3,6,3,6,9,9,20,28,1,42,2,0,2,6,2,1
3365,95,2040,127,75,83,2,11,30,129,4,14,7,14,18,21,61,87,2,175,9,0,2,1,1,0
3366,95,2040,652,304,544,16,6,88,668,6,89,51,101,95,152,591,998,3,3399,188,0,2,1,1,0
3367,95,2040,2,2,2,0,0,0,2,0,0,0,0,0,0,0,0,0,0,0,0,2,1,1,0
3368,95,2040,8,5,5,0,0,3,8,0,0,0,0,0,0,0,0,0,0,0,0,2,1,1,0
3371,95,2040,14,8,8,0,0,6,14,0,0,0,0,0,0,0,0,0,0,0,0,2,1,1,0
3372,95,2040,6,4,4,0,0,2,6,0,0,0,0,0,0,0,0,0,0,0,0,2,1,1,0
3373,95,2040,6,4,4,0,0,2,6,1,2,1,2,3,3,2,4,0,2,0,0,2,1,1,0
3375,95,2040,7,5,5,0,0,2,7,0,0,0,0,0,0,0,0,0,0,0,0,2,1,1,0
3377,95,2040,10,6,6,0,0,4,10,0,0,0,0,0,0,0,0,0,0,0,0,2,1,1,0
3378,95,2040,1,1,1,0,0,0,1,0,0,0,0,0,0,0,0,0,0,0,0,2,1,1,0
3380,95,2040,14,10,10,0,0,4,14,1,1,1,1,2,2,0,2,0,1,0,0,2,1,1,0
3381,95,2040,46,26,30,3,0,12,49,3,6,3,6,9,9,20,28,1,42,2,0,2,1,1,0
3422,47,906,373,158,315,8,0,51,381,5,76,44,79,81,123,486,779,2,2026,112,0,2,2,2,0
3423,48,908,373,158,315,8,0,51,381,5,76,44,79,81,123,486,779,2,2026,112,0,2,1,1,0
3424,48,1730,373,158,315,8,0,51,381,5,76,44,79,81,123,486,779,2,2026,112,0,2,3,3,0
3425,49,934,373,158,315,8,0,51,381,5,76,44,79,81,123,486,779,2,2026,112,0,2,2,0,0
3449,48,1742,373,158,315,8,0,51,381,5,76,44,79,81,123,486,779,2,2026,112,0,2,4,4,1
3450,157,2702,1338,495,1086,10,64,173,1348,11,122,82,157,133,239,883,1686,7,11934,663,0,2,10,6,0
3451,3,79,1455,414,1257,16,76,112,1471,5,41,23,46,46,69,231,381,2,1069,59,0,2,6,15,0
3452,3,79,669,365,481,22,61,110,691,15,103,63,122,118,185,747,1273,8,11311,628,0,2,6,15,0
3453,5,262,1455,414,1257,16,76,112,1471,5,41,23,46,46,69,231,381,2,1069,59,0,2,19,14,0
3454,41,1405,773,419,590,28,0,166,801,10,204,113,217,214,330,1598,2554,5,13587,754,0,2,10,7,0
3455,41,1405,773,419,590,28,0,166,801,10,204,113,217,214,330,1598,2554,5,13587,754,0,2,1,1,0
3938,22,535,182,127,129,0,0,53,182,5,39,21,42,44,63,217,343,2,926,51,0,0,102,0,1
3939,22,535,1165,710,800,67,119,181,1232,18,243,153,282,261,435,2000,3492,10,36473,2026,1,0,102,0,1
3940,84,1873,1392,870,1177,35,17,170,1427,14,494,280,531,508,811,4473,7289,7,54850,3047,2,0,325,0,1
3941,62,1415,773,419,590,28,0,166,801,10,204,113,217,214,330,1598,2554,5,13587,754,0,0,287,0,1
3942,62,1415,421,273,302,44,34,57,465,17,81,59,107,98,166,583,1098,11,12329,684,0,0,287,0,1
3966,13,518,182,127,129,0,0,53,182,5,39,21,42,44,63,217,343,2,926,51,0,0,85,0,1
3967,88,3213,1392,870,1177,35,17,170,1427,14,494,280,531,508,811,4473,7289,7,54850,3047,2,0,584,0,1
3968,46,1526,773,419,590,28,0,166,801,10,204,113,217,214,330,1598,2554,5,13587,754,0,0,316,0,1
3969,1,28,127,75,83,2,11,30,129,4,14,7,14,18,21,61,87,2,175,9,0,2,1,1,1
3970,1,28,652,304,544,16,6,88,668,6,89,51,101,95,152,591,998,3,3399,188,0,2,1,1,1
3971,1,28,2,2,2,0,0,0,2,0,0,0,0,0,0,0,0,0,0,0,0,2,1,1,1
3972,1,28,8,5,5,0,0,3,8,0,0,0,0,0,0,0,0,0,0,0,0,2,1,1,1
3975,1,28,14,8,8,0,0,6,14,0,0,0,0,0,0,0,0,0,0,0,0,2,1,1,1
3976,1,28,6,4,4,0,0,2,6,0,0,0,0,0,0,0,0,0,0,0,0,2,1,1,1
3977,1,28,6,4,4,0,0,2,6,1,2,1,2,3,3,2,4,0,2,0,0,2,1,1,1
3979,1,28,7,5,5,0,0,2,7,0,0,0,0,0,0,0,0,0,0,0,0,2,1,1,1
3981,1,28,10,6,6,0,0,4,10,0,0,0,0,0,0,0,0,0,0,0,0,2,1,1,1
3982,1,28,1,1,1,0,0,0,1,0,0,0,0,0,0,0,0,0,0,0,0,2,1,1,1
3984,1,28,14,10,10,0,0,4,14,1,1,1,1,2,2,0,2,0,1,0,0,2,1,1,1
3985,1,28,46,26,30,3,0,12,49,3,6,3,6,9,9,20,28,1,42,2,0,2,1,1,1
4009,102,2207,127,75,83,2,11,30,129,4,14,7,14,18,21,61,87,2,175,9,0,0,344,0,1
4010,102,2207,652,304,544,16,6,88,668,6,89,51,101,95,152,591,998,3,3399,188,0,0,344,0,1
4011,102,2207,2,2,2,0,0,0,2,0,0,0,0,0,0,0,0,0,0,0,0,0,344,0,1
4012,102,2207,8,5,5,0,0,3,8,0,0,0,0,0,0,0,0,0,0,0,0,0,344,0,1
4015,102,2207,14,8,8,0,0,6,14,0,0,0,0,0,0,0,0,0,0,0,0,0,344,0,1
4016,102,2207,6,4,4,0,0,2,6,0,0,0,0,0,0,0,0,0,0,0,0,0,344,0,1
4017,102,2207,6,4,4,0,0,2,6,1,2,1,2,3,3,2,4,0,2,0,0,0,344,0,1
4019,102,2207,7,5,5,0,0,2,7,0,0,0,0,0,0,0,0,0,0,0,0,0,344,0,1
4021,102,2207,10,6,6,0,0,4,10,0,0,0,0,0,0,0,0,0,0,0,0,0,344,0,1
4022,102,2207,1,1,1,0,0,0,1,0,0,0,0,0,0,0,0,0,0,0,0,0,344,0,1
4024,102,2207,14,10,10,0,0,4,14,1,1,1,1,2,2,0,2,0,1,0,0,0,344,0,1
4025,102,2207,46,26,30,3,0,12,49,3,6,3,6,9,9,20,28,1,42,2,0,0,344,0,1
4027,1,70,13,10,10,0,0,3,13,1,2,1,2,3,3,2,4,0,2,0,0,0,11,0,1
4029,17,841,652,304,544,16,6,88,668,6,89,51,101,95,152,591,998,3,3399,188,0,0,148,0,1
4030,2,50,127,75,83,2,11,30,129,4,14,7,14,18,21,61,87,2,175,9,0,2,2,2,1
4031,2,50,652,304,544,16,6,88,668,6,89,51,101,95,152,591,998,3,3399,188,0,2,2,2,1
4032,2,50,2,2,2,0,0,0,2,0,0,0,0,0,0,0,0,0,0,0,0,2,2,2,1
4033,2,50,8,5,5,0,0,3,8,0,0,0,0,0,0,0,0,0,0,0,0,2,2,2,1
4036,2,50,14,8,8,0,0,6,14,0,0,0,0,0,0,0,0,0,0,0,0,2,2,2,1
4037,2,50,6,4,4,0,0,2,6,0,0,0,0,0,0,0,0,0,0,0,0,2,2,2,1
4038,2,50,6,4,4,0,0,2,6,1,2,1,2,3,3,2,4,0,2,0,0,2,2,2,1
4040,2,50,7,5,5,0,0,2,7,0,0,0,0,0,0,0,0,0,0,0,0,2,2,2,1
4042,2,50,10,6,6,0,0,4,10,0,0,0,0,0,0,0,0,0,0,0,0,2,2,2,1
4043,2,50,1,1,1,0,0,0,1,0,0,0,0,0,0,0,0,0,0,0,0,2,2,2,1
4045,2,50,14,10,10,0,0,4,14,1,1,1,1,2,2,0,2,0,1,0,0,2,2,2,1
4046,2,50,46,26,30,3,0,12,49,3,6,3,6,9,9,20,28,1,42,2,0,2,2,2,1
4163,5,104,1943,715,1694,26,18,214,1969,12,185,120,237,197,357,1436,2721,7,20915,1161,0,0,25,0,1
4187,114,2015,1338,495,1086,10,64,173,1348,11,122,82,157,133,239,883,1686,7,11934,663,0,0,413,0,1
4188,6,254,207,111,150,11,0,50,218,5,26,19,36,31,55,133,272,3,943,52,0,0,58,0,1
4189,6,254,410,198,237,31,55,97,441,11,63,38,72,74,110,414,683,6,4293,238,0,0,58,0,1
4190,58,1278,1457,730,1242,11,6,188,1468,10,292,166,329,302,495,2424,4078,5,22973,1276,1,0,256,0,1
4191,58,1278,74,35,59,1,0,14,75,3,14,7,14,17,21,58,85,1,128,7,0,0,256,0,1
4192,58,1278,245,125,200,5,7,34,250,7,30,17,34,37,51,166,265,3,1053,58,0,0,256,0,1
4285,26,384,477,336,357,30,23,73,507,16,194,134,250,210,384,1538,2962,10,30538,1696,0,0,70,0,1
4309,61,1388,1943,715,1694,26,18,214,1969,12,185,120,237,197,357,1436,2721,7,20915,1161,0,0,199,0,1
4310,61,1388,1168,838,957,57,25,144,1225,19,348,224,416,367,640,3018,5452,11,61921,3440,1,0,199,0,1
4334,13,1034,1943,715,1694,26,18,214,1969,12,185,120,237,197,357,1436,2721,7,20915,1161,0,0,164,0,1
4358,33,845,1043,504,840,53,9,147,1096,9,180,112,198,189,310,1377,2344,4,11604,644,0,0,146,0,1
4359,33,845,383,288,292,26,6,62,409,11,65,38,67,76,105,429,656,5,3719,206,0,0,146,0,1
4360,48,883,373,158,315,8,0,51,381,5,76,44,79,81,123,486,779,2,2026,112,0,0,151,0,1
4384,32,1506,1289,550,1043,56,32,155,1345,10,167,93,185,177,278,1266,2075,5,11498,638,0,0,425,0,1
4408,4,225,207,111,150,11,0,50,218,5,26,19,36,31,55,133,272,3,943,52,0,0,53,0,1
4409,58,3609,1457,730,1242,11,6,188,1468,10,292,166,329,302,495,2424,4078,5,22973,1276,1,0,493,0,1
4410,3,185,1455,414,1257,16,76,112,1471,5,41,23,46,46,69,231,381,2,1069,59,0,0,34,0,1
4411,31,1367,373,158,315,8,0,51,381,5,76,44,79,81,123,486,779,2,2026,112,0,0,274,0,1
4521,1,76,42,7,35,4,0,5,46,1,2,1,2,3,3,2,4,0,2,0,0,0,10,0,1
4522,1,76,11,6,10,0,0,1,11,2,4,2,4,6,6,10,15,1,15,0,0,0,10,0,1
4523,6,596,42,7,35,4,0,5,46,1,2,1,2,3,3,2,4,0,2,0,0,2,207,3,1
4524,6,596,11,6,10,0,0,1,11,2,4,2,4,6,6,10,15,1,15,0,0,2,207,3,1
4525,32,1379,373,158,315,8,0,51,381,5,76,44,79,81,123,486,779,2,2026,112,0,2,2,1,1
4526,32,1517,1289,550,1043,56,32,155,1345,10,167,93,185,177,278,1266,2075,5,11498,638,0,2,2,1,0
4527,21,1028,42,7,35,4,0,5,46,1,2,1,2,3,3,2,4,0,2,0,0,2,106,13,1
4528,21,1028,11,6,10,0,0,1,11,2,4,2,4,6,6,10,15,1,15,0,0,2,106,13,1
4552,84,1873,1392,870,1177,35,17,170,1427,14,494,280,531,508,811,4473,7289,7,54850,3047,2,2,1,1,0
4622,1,485,42,7,35,4,0,5,46,1,2,1,2,3,3,2,4,0,2,0,0,2,45,111,1
4623,1,485,11,6,10,0,0,1,11,2,4,2,4,6,6,10,15,1,15,0,0,2,45,111,1
4647,33,845,1043,504,840,53,9,147,1096,9,180,112,198,189,310,1377,2344,4,11604,644,0,2,1,1,1
4648,33,845,383,288,292,26,6,62,409,11,65,38,67,76,105,429,656,5,3719,206,0,2,1,1,1
4672,1,487,42,7,35,4,0,5,46,1,2,1,2,3,3,2,4,0,2,0,0,2,2,1,0
4673,1,487,11,6,10,0,0,1,11,2,4,2,4,6,6,10,15,1,15,0,0,2,2,1,0
4674,9,213,1450,624,1228,12,26,181,1462,14,306,186,354,320,540,2580,4493,8,36391,2021,1,2,8,1,0
4675,25,429,1450,624,1228,12,26,181,1462,14,306,186,354,320,540,2580,4493,8,36391,2021,1,2,8,0,0
4676,35,1582,1289,550,1043,56,32,155,1345,10,167,93,185,177,278,1266,2075,5,11498,638,0,2,15,5,0
4677,60,1308,1457,730,1242,11,6,188,1468,10,292,166,329,302,495,2424,4078,5,22973,1276,1,2,6,0,0
4678,60,1308,74,35,59,1,0,14,75,3,14,7,14,17,21,58,85,1,128,7,0,2,6,0,0
4679,60,1308,245,125,200,5,7,34,250,7,30,17,34,37,51,166,265,3,1053,58,0,2,6,0,0
4680,59,3677,1457,730,1242,11,6,188,1468,10,292,166,329,302,495,2424,4078,5,22973,1276,1,2,8,0,0
4681,68,1461,1457,730,1242,11,6,188,1468,10,292,166,329,302,495,2424,4078,5,22973,1276,1,2,27,0,0
4682,68,1461,74,35,59,1,0,14,75,3,14,7,14,17,21,58,85,1,128,7,0,2,27,0,0
4683,68,1461,245,125,200,5,7,34,250,7,30,17,34,37,51,166,265,3,1053,58,0,2,27,0,0
4684,60,3777,1457,730,1242,11,6,188,1468,10,292,166,329,302,495,2424,4078,5,22973,1276,1,2,16,1,0
4685,1,487,42,7,35,4,0,5,46,1,2,1,2,3,3,2,4,0,2,0,0,2,1,1,1
4686,1,487,11,6,10,0,0,1,11,2,4,2,4,6,6,10,15,1,15,0,0,2,1,1,1
4687,68,1469,1457,730,1242,11,6,188,1468,10,292,166,329,302,495,2424,4078,5,22973,1276,1,2,3,2,0
4688,68,1469,74,35,59,1,0,14,75,3,14,7,14,17,21,58,85,1,128,7,0,2,3,2,0
4689,68,1469,245,125,200,5,7,34,250,7,30,17,34,37,51,166,265,3,1053,58,0,2,3,2,0
4690,60,3773,1457,730,1242,11,6,188,1468,10,292,166,329,302,495,2424,4078,5,22973,1276,1,2,2,2,0
4691,116,2055,1338,495,1086,10,64,173,1348,11,122,82,157,133,239,883,1686,7,11934,663,0,2,8,2,1
4692,68,1487,1457,730,1242,11,6,188,1468,10,292,166,329,302,495,2424,4078,5,22973,1276,1,2,2,1,1
4693,68,1487,74,35,59,1,0,14,75,3,14,7,14,17,21,58,85,1,128,7,0,2,2,1,1
4694,68,1487,245,125,200,5,7,34,250,7,30,17,34,37,51,166,265,3,1053,58,0,2,2,1,1
4695,60,3776,1457,730,1242,11,6,188,1468,10,292,166,329,302,495,2424,4078,5,22973,1276,1,2,1,1,0
4696,142,2436,1338,495,1086,10,64,173,1348,11,122,82,157,133,239,883,1686,7,11934,663,0,2,136,58,1
4697,6,254,207,111,150,11,0,50,218,5,26,19,36,31,55,133,272,3,943,52,0,2,1,1,1
4698,6,254,410,198,237,31,55,97,441,11,63,38,72,74,110,414,683,6,4293,238,0,2,1,1,1
4699,12,1018,1943,715,1694,26,18,214,1969,12,185,120,237,197,357,1436,2721,7,20915,1161,0,2,2,3,1
4700,32,832,1043,504,840,53,9,147,1096,9,180,112,198,189,310,1377,2344,4,11604,644,0,2,2,2,1
4701,32,832,383,288,292,26,6,62,409,11,65,38,67,76,105,429,656,5,3719,206,0,2,2,2,1
4702,35,1582,1289,550,1043,56,32,155,1345,10,167,93,185,177,278,1266,2075,5,11498,638,0,2,2,2,1
4703,58,3584,1457,730,1242,11,6,188,1468,10,292,166,329,302,495,2424,4078,5,22973,1276,1,2,4,30,1
4704,3,185,1455,414,1257,16,76,112,1471,5,41,23,46,46,69,231,381,2,1069,59,0,2,2,2,1
4705,33,1436,373,158,315,8,0,51,381,5,76,44,79,81,123,486,779,2,2026,112,0,2,16,1,1
4729,1,28,127,75,83,2,11,30,129,4,14,7,14,18,21,61,87,2,175,9,0,2,2,2,1
4730,1,28,652,304,544,16,6,88,668,6,89,51,101,95,152,591,998,3,3399,188,0,2,2,2,1
4731,1,28,2,2,2,0,0,0,2,0,0,0,0,0,0,0,0,0,0,0,0,2,2,2,1
4732,1,28,8,5,5,0,0,3,8,0,0,0,0,0,0,0,0,0,0,0,0,2,2,2,1
4735,1,28,14,8,8,0,0,6,14,0,0,0,0,0,0,0,0,0,0,0,0,2,2,2,1
4736,1,28,6,4,4,0,0,2,6,0,0,0,0,0,0,0,0,0,0,0,0,2,2,2,1
4737,1,28,6,4,4,0,0,2,6,1,2,1,2,3,3,2,4,0,2,0,0,2,2,2,1
4739,1,28,7,5,5,0,0,2,7,0,0,0,0,0,0,0,0,0,0,0,0,2,2,2,1
4741,1,28,10,6,6,0,0,4,10,0,0,0,0,0,0,0,0,0,0,0,0,2,2,2,1
4742,1,28,1,1,1,0,0,0,1,0,0,0,0,0,0,0,0,0,0,0,0,2,2,2,1
4744,1,28,14,10,10,0,0,4,14,1,1,1,1,2,2,0,2,0,1,0,0,2,2,2,1
4745,1,28,46,26,30,3,0,12,49,3,6,3,6,9,9,20,28,1,42,2,0,2,2,2,1
4746,88,2029,127,75,83,2,11,30,129,4,14,7,14,18,21,61,87,2,175,9,0,2,20,41,1
4747,88,2029,652,304,544,16,6,88,668,6,89,51,101,95,152,591,998,3,3399,188,0,2,20,41,1
4748,88,2029,2,2,2,0,0,0,2,0,0,0,0,0,0,0,0,0,0,0,0,2,20,41,1
4749,88,2029,8,5,5,0,0,3,8,0,0,0,0,0,0,0,0,0,0,0,0,2,20,41,1
4752,88,2029,14,8,8,0,0,6,14,0,0,0,0,0,0,0,0,0,0,0,0,2,20,41,1
4753,88,2029,6,4,4,0,0,2,6,0,0,0,0,0,0,0,0,0,0,0,0,2,20,41,1
4754,88,2029,6,4,4,0,0,2,6,1,2,1,2,3,3,2,4,0,2,0,0,2,20,41,1
4756,88,2029,7,5,5,0,0,2,7,0,0,0,0,0,0,0,0,0,0,0,0,2,20,41,1
4758,88,2029,10,6,6,0,0,4,10,0,0,0,0,0,0,0,0,0,0,0,0,2,20,41,1
4759,88,2029,1,1,1,0,0,0,1,0,0,0,0,0,0,0,0,0,0,0,0,2,20,41,1
4761,88,2029,14,10,10,0,0,4,14,1,1,1,1,2,2,0,2,0,1,0,0,2,20,41,1
4762,88,2029,46,26,30,3,0,12,49,3,6,3,6,9,9,20,28,1,42,2,0,2,20,41,1
4763,2,98,13,10,10,0,0,3,13,1,2,1,2,3,3,2,4,0,2,0,0,2,9,5,1
4764,11,596,652,304,544,16,6,88,668,6,89,51,101,95,152,591,998,3,3399,188,0,2,71,104,1
4782,144,2476,1338,495,1086,10,64,173,1348,11,122,82,157,133,239,883,1686,7,11934,663,0,2,18,14,1
4783,1,477,42,7,35,4,0,5,46,1,2,1,2,3,3,2,4,0,2,0,0,2,1,6,0
4784,1,477,11,6,10,0,0,1,11,2,4,2,4,6,6,10,15,1,15,0,0,2,1,6,0
4808,2,50,127,75,83,2,11,30,129,4,14,7,14,18,21,61,87,2,175,9,0,3,1,1,0
4809,2,50,652,304,544,16,6,88,668,6,89,51,101,95,152,591,998,3,3399,188,0,3,1,1,0
4810,2,50,2,2,2,0,0,0,2,0,0,0,0,0,0,0,0,0,0,0,0,3,1,1,0
4811,2,50,8,5,5,0,0,3,8,0,0,0,0,0,0,0,0,0,0,0,0,3,1,1,0
4814,2,50,14,8,8,0,0,6,14,0,0,0,0,0,0,0,0,0,0,0,0,3,1,1,0
4815,2,50,6,4,4,0,0,2,6,0,0,0,0,0,0,0,0,0,0,0,0,3,1,1,0
4816,2,50,6,4,4,0,0,2,6,1,2,1,2,3,3,2,4,0,2,0,0,3,1,1,0
4818,2,50,7,5,5,0,0,2,7,0,0,0,0,0,0,0,0,0,0,0,0,3,1,1,0
4820,2,50,10,6,6,0,0,4,10,0,0,0,0,0,0,0,0,0,0,0,0,3,1,1,0
4821,2,50,1,1,1,0,0,0,1,0,0,0,0,0,0,0,0,0,0,0,0,3,1,1,0
4823,2,50,14,10,10,0,0,4,14,1,1,1,1,2,2,0,2,0,1,0,0,3,1,1,0
4824,2,50,46,26,30,3,0,12,49,3,6,3,6,9,9,20,28,1,42,2,0,3,1,1,0
4894,88,3213,1392,870,1177,35,17,170,1427,14,494,280,531,508,811,4473,7289,7,54850,3047,2,2,1,1,0
4895,61,1386,1943,715,1694,26,18,214,1969,12,185,120,237,197,357,1436,2721,7,20915,1161,0,2,1,1,1
4896,61,1386,1168,838,957,57,25,144,1225,19,348,224,416,367,640,3018,5452,11,61921,3440,1,2,1,1,1
4897,57,3573,1457,730,1242,11,6,188,1468,10,292,166,329,302,495,2424,4078,5,22973,1276,1,2,17,11,1
4898,33,1460,373,158,315,8,0,51,381,5,76,44,79,81,123,486,779,2,2026,112,0,2,16,7,1
4899,19,444,127,75,83,2,11,30,129,4,14,7,14,18,21,61,87,2,175,9,0,0,71,0,1
4900,19,444,652,304,544,16,6,88,668,6,89,51,101,95,152,591,998,3,3399,188,0,0,71,0,1
4901,19,444,2,2,2,0,0,0,2,0,0,0,0,0,0,0,0,0,0,0,0,0,71,0,1
4902,19,444,8,5,5,0,0,3,8,0,0,0,0,0,0,0,0,0,0,0,0,0,71,0,1
4905,19,444,14,8,8,0,0,6,14,0,0,0,0,0,0,0,0,0,0,0,0,0,71,0,1
4906,19,444,6,4,4,0,0,2,6,0,0,0,0,0,0,0,0,0,0,0,0,0,71,0,1
4907,19,444,6,4,4,0,0,2,6,1,2,1,2,3,3,2,4,0,2,0,0,0,71,0,1
4909,19,444,7,5,5,0,0,2,7,0,0,0,0,0,0,0,0,0,0,0,0,0,71,0,1
4911,19,444,10,6,6,0,0,4,10,0,0,0,0,0,0,0,0,0,0,0,0,0,71,0,1
4912,19,444,1,1,1,0,0,0,1,0,0,0,0,0,0,0,0,0,0,0,0,0,71,0,1
4914,19,444,14,10,10,0,0,4,14,1,1,1,1,2,2,0,2,0,1,0,0,0,71,0,1
4915,19,444,46,26,30,3,0,12,49,3,6,3,6,9,9,20,28,1,42,2,0,0,71,0,1
4916,5,247,652,304,544,16,6,88,668,6,89,51,101,95,152,591,998,3,3399,188,0,0,64,0,1
4917,84,1874,1392,870,1177,35,17,170,1427,14,494,280,531,508,811,4473,7289,7,54850,3047,2,2,4,3,1
4918,144,2486,1338,495,1086,10,64,173,1348,11,122,82,157,133,239,883,1686,7,11934,663,0,2,2,1,1
4919,62,1396,1943,715,1694,26,18,214,1969,12,185,120,237,197,357,1436,2721,7,20915,1161,0,2,1,1,1
4920,62,1396,1168,838,957,57,25,144,1225,19,348,224,416,367,640,3018,5452,11,61921,3440,1,2,1,1,1
4921,17,1181,1943,715,1694,26,18,214,1969,12,185,120,237,197,357,1436,2721,7,20915,1161,0,2,31,0,1
4922,144,2489,1338,495,1086,10,64,173,1348,11,122,82,157,133,239,883,1686,7,11934,663,0,2,1,1,0
4923,85,1888,1392,870,1177,35,17,170,1427,14,494,280,531,508,811,4473,7289,7,54850,3047,2,2,9,5,1
4924,95,3486,1392,870,1177,35,17,170,1427,14,494,280,531,508,811,4473,7289,7,54850,3047,2,2,59,1,1
4925,95,3490,1392,870,1177,35,17,170,1427,14,494,280,531,508,811,4473,7289,7,54850,3047,2,2,1,1,0
4949,88,2032,127,75,83,2,11,30,129,4,14,7,14,18,21,61,87,2,175,9,0,2,2,0,0
4950,88,2032,652,304,544,16,6,88,668,6,89,51,101,95,152,591,998,3,3399,188,0,2,2,0,0
4951,88,2032,2,2,2,0,0,0,2,0,0,0,0,0,0,0,0,0,0,0,0,2,2,0,0
4952,88,2032,8,5,5,0,0,3,8,0,0,0,0,0,0,0,0,0,0,0,0,2,2,0,0
4955,88,2032,14,8,8,0,0,6,14,0,0,0,0,0,0,0,0,0,0,0,0,2,2,0,0
4956,88,2032,6,4,4,0,0,2,6,0,0,0,0,0,0,0,0,0,0,0,0,2,2,0,0
4957,88,2032,6,4,4,0,0,2,6,1,2,1,2,3,3,2,4,0,2,0,0,2,2,0,0
4959,88,2032,7,5,5,0,0,2,7,0,0,0,0,0,0,0,0,0,0,0,0,2,2,0,0
4961,88,2032,10,6,6,0,0,4,10,0,0,0,0,0,0,0,0,0,0,0,0,2,2,0,0
4962,88,2032,1,1,1,0,0,0,1,0,0,0,0,0,0,0,0,0,0,0,0,2,2,0,0
4964,88,2032,14,10,10,0,0,4,14,1,1,1,1,2,2,0,2,0,1,0,0,2,2,0,0
4965,88,2032,46,26,30,3,0,12,49,3,6,3,6,9,9,20,28,1,42,2,0,2,2,0,0
4966,35,1582,1289,550,1043,56,32,155,1345,10,167,93,185,177,278,1266,2075,5,11498,638,0,2,2,2,0
4967,36,1582,1289,550,1043,56,32,155,1345,10,167,93,185,177,278,1266,2075,5,11498,638,0,2,6,5,0
4968,1,467,42,7,35,4,0,5,46,1,2,1,2,3,3,2,4,0,2,0,0,2,0,5,0
4969,1,467,11,6,10,0,0,1,11,2,4,2,4,6,6,10,15,1,15,0,0,2,0,5,0
4970,37,1615,1289,550,1043,56,32,155,1345,10,167,93,185,177,278,1266,2075,5,11498,638,0,2,6,2,0
4971,38,1647,1289,550,1043,56,32,155,1345,10,167,93,185,177,278,1266,2075,5,11498,638,0,2,9,6,1
4995,96,3511,1392,870,1177,35,17,170,1427,14,494,280,531,508,811,4473,7289,7,54850,3047,2,2,5,2,0
4996,18,419,386,256,301,16,9,68,402,4,59,35,69,63,104,355,621,2,1453,80,0,0,74,0,0
4997,18,419,264,131,164,11,41,46,275,6,38,22,40,44,62,214,338,3,1068,59,0,0,74,0,0
4998,144,2509,1338,495,1086,10,64,173,1348,11,122,82,157,133,239,883,1686,7,11934,663,0,2,10,3,0
4999,145,2522,1338,495,1086,10,64,173,1348,11,122,82,157,133,239,883,1686,7,11934,663,0,2,8,1,0
5000,64,1428,1943,715,1694,26,18,214,1969,12,185,120,237,197,357,1436,2721,7,20915,1161,0,2,12,6,0
5001,64,1428,1168,838,957,57,25,144,1225,19,348,224,416,367,640,3018,5452,11,61921,3440,1,2,12,6,0
5002,64,1445,1943,715,1694,26,18,214,1969,12,185,120,237,197,357,1436,2721,7,20915,1161,0,2,5,0,0
5003,64,1445,1168,838,957,57,25,144,1225,19,348,224,416,367,640,3018,5452,11,61921,3440,1,2,5,0,0
5004,18,1284,1943,715,1694,26,18,214,1969,12,185,120,237,197,357,1436,2721,7,20915,1161,0,2,14,0,0
5005,62,1432,1943,715,1694,26,18,214,1969,12,185,120,237,197,357,1436,2721,7,20915,1161,0,2,3,4,0
5006,62,1432,1168,838,957,57,25,144,1225,19,348,224,416,367,640,3018,5452,11,61921,3440,1,2,3,4,0
5007,20,1426,1943,715,1694,26,18,214,1969,12,185,120,237,197,357,1436,2721,7,20915,1161,0,2,23,0,0
5008,63,1445,1943,715,1694,26,18,214,1969,12,185,120,237,197,357,1436,2721,7,20915,1161,0,2,3,2,0
5009,63,1445,1168,838,957,57,25,144,1225,19,348,224,416,367,640,3018,5452,11,61921,3440,1,2,3,2,0
5010,66,1504,1943,715,1694,26,18,214,1969,12,185,120,237,197,357,1436,2721,7,20915,1161,0,2,9,0,0
5011,66,1504,1168,838,957,57,25,144,1225,19,348,224,416,367,640,3018,5452,11,61921,3440,1,2,9,0,0
5012,23,1499,1943,715,1694,26,18,214,1969,12,185,120,237,197,357,1436,2721,7,20915,1161,0,2,24,8,0
5013,48,907,373,158,315,8,0,51,381,5,76,44,79,81,123,486,779,2,2026,112,0,2,6,3,0
5037,15,361,373,158,315,8,0,51,381,5,76,44,79,81,123,486,779,2,2026,112,0,0,58,0,0
5061,16,406,373,158,315,8,0,51,381,5,76,44,79,81,123,486,779,2,2026,112,0,2,8,0,0
5085,62,1415,773,419,590,28,0,166,801,10,204,113,217,214,330,1598,2554,5,13587,754,0,2,0,2,0
5086,62,1415,421,273,302,44,34,57,465,17,81,59,107,98,166,583,1098,11,12329,684,0,2,0,2,0
5087,19,432,127,75,83,2,11,30,129,4,14,7,14,18,21,61,87,2,175,9,0,2,1,2,0
5088,19,432,652,304,544,16,6,88,668,6,89,51,101,95,152,591,998,3,3399,188,0,2,1,2,0
5089,19,432,2,2,2,0,0,0,2,0,0,0,0,0,0,0,0,0,0,0,0,2,1,2,0
5090,19,432,8,5,5,0,0,3,8,0,0,0,0,0,0,0,0,0,0,0,0,2,1,2,0
5093,19,432,14,8,8,0,0,6,14,0,0,0,0,0,0,0,0,0,0,0,0,2,1,2,0
5094,19,432,6,4,4,0,0,2,6,0,0,0,0,0,0,0,0,0,0,0,0,2,1,2,0
5095,19,432,6,4,4,0,0,2,6,1,2,1,2,3,3,2,4,0,2,0,0,2,1,2,0
5097,19,432,7,5,5,0,0,2,7,0,0,0,0,0,0,0,0,0,0,0,0,2,1,2,0
5099,19,432,10,6,6,0,0,4,10,0,0,0,0,0,0,0,0,0,0,0,0,2,1,2,0
5100,19,432,1,1,1,0,0,0,1,0,0,0,0,0,0,0,0,0,0,0,0,2,1,2,0
5102,19,432,14,10,10,0,0,4,14,1,1,1,1,2,2,0,2,0,1,0,0,2,1,2,0
5103,19,432,46,26,30,3,0,12,49,3,6,3,6,9,9,20,28,1,42,2,0,2,1,2,0
5104,5,247,652,304,544,16,6,88,668,6,89,51,101,95,152,591,998,3,3399,188,0,2,2,2,0
5105,19,438,127,75,83,2,11,30,129,4,14,7,14,18,21,61,87,2,175,9,0,2,17,1,0
5106,19,438,652,304,544,16,6,88,668,6,89,51,101,95,152,591,998,3,3399,188,0,2,17,1,0
5107,19,438,2,2,2,0,0,0,2,0,0,0,0,0,0,0,0,0,0,0,0,2,17,1,0
5108,19,438,8,5,5,0,0,3,8,0,0,0,0,0,0,0,0,0,0,0,0,2,17,1,0
5111,19,438,14,8,8,0,0,6,14,0,0,0,0,0,0,0,0,0,0,0,0,2,17,1,0
5112,19,438,6,4,4,0,0,2,6,0,0,0,0,0,0,0,0,0,0,0,0,2,17,1,0
5113,19,438,6,4,4,0,0,2,6,1,2,1,2,3,3,2,4,0,2,0,0,2,17,1,0
5115,19,438,7,5,5,0,0,2,7,0,0,0,0,0,0,0,0,0,0,0,0,2,17,1,0
5117,19,438,10,6,6,0,0,4,10,0,0,0,0,0,0,0,0,0,0,0,0,2,17,1,0
5118,19,438,1,1,1,0,0,0,1,0,0,0,0,0,0,0,0,0,0,0,0,2,17,1,0
5120,19,438,14,10,10,0,0,4,14,1,1,1,1,2,2,0,2,0,1,0,0,2,17,1,0
5121,19,438,46,26,30,3,0,12,49,3,6,3,6,9,9,20,28,1,42,2,0,2,17,1,0
5122,19,438,127,75,83,2,11,30,129,4,14,7,14,18,21,61,87,2,175,9,0,2,10,10,0
5123,19,438,652,304,544,16,6,88,668,6,89,51,101,95,152,591,998,3,3399,188,0,2,10,10,0
5124,19,438,2,2,2,0,0,0,2,0,0,0,0,0,0,0,0,0,0,0,0,2,10,10,0
5125,19,438,8,5,5,0,0,3,8,0,0,0,0,0,0,0,0,0,0,0,0,2,10,10,0
5128,19,438,14,8,8,0,0,6,14,0,0,0,0,0,0,0,0,0,0,0,0,2,10,10,0
5129,19,438,6,4,4,0,0,2,6,0,0,0,0,0,0,0,0,0,0,0,0,2,10,10,0
5130,19,438,6,4,4,0,0,2,6,1,2,1,2,3,3,2,4,0,2,0,0,2,10,10,0
5132,19,438,7,5,5,0,0,2,7,0,0,0,0,0,0,0,0,0,0,0,0,2,10,10,0
5134,19,438,10,6,6,0,0,4,10,0,0,0,0,0,0,0,0,0,0,0,0,2,10,10,0
5135,19,438,1,1,1,0,0,0,1,0,0,0,0,0,0,0,0,0,0,0,0,2,10,10,0
5137,19,438,14,10,10,0,0,4,14,1,1,1,1,2,2,0,2,0,1,0,0,2,10,10,0
5138,19,438,46,26,30,3,0,12,49,3,6,3,6,9,9,20,28,1,42,2,0,2,10,10,0
5139,6,266,652,304,544,16,6,88,668,6,89,51,101,95,152,591,998,3,3399,188,0,2,4,0,0
5140,19,438,127,75,83,2,11,30,129,4,14,7,14,18,21,61,87,2,175,9,0,2,3,3,0
5141,19,438,652,304,544,16,6,88,668,6,89,51,101,95,152,591,998,3,3399,188,0,2,3,3,0
5142,19,438,2,2,2,0,0,0,2,0,0,0,0,0,0,0,0,0,0,0,0,2,3,3,0
5143,19,438,8,5,5,0,0,3,8,0,0,0,0,0,0,0,0,0,0,0,0,2,3,3,0
5146,19,438,14,8,8,0,0,6,14,0,0,0,0,0,0,0,0,0,0,0,0,2,3,3,0
5147,19,438,6,4,4,0,0,2,6,0,0,0,0,0,0,0,0,0,0,0,0,2,3,3,0
5148,19,438,6,4,4,0,0,2,6,1,2,1,2,3,3,2,4,0,2,0,0,2,3,3,0
5150,19,438,7,5,5,0,0,2,7,0,0,0,0,0,0,0,0,0,0,0,0,2,3,3,0
5152,19,438,10,6,6,0,0,4,10,0,0,0,0,0,0,0,0,0,0,0,0,2,3,3,0
5153,19,438,1,1,1,0,0,0,1,0,0,0,0,0,0,0,0,0,0,0,0,2,3,3,0
5155,19,438,14,10,10,0,0,4,14,1,1,1,1,2,2,0,2,0,1,0,0,2,3,3,0
5156,19,438,46,26,30,3,0,12,49,3,6,3,6,9,9,20,28,1,42,2,0,2,3,3,0
5157,37,1648,1289,550,1043,56,32,155,1345,10,167,93,185,177,278,1266,2075,5,11498,638,0,2,1,4,0
5181,87,2025,127,75,83,2,11,30,129,4,14,7,14,18,21,61,87,2,175,9,0,2,1,4,1
5182,87,2025,652,304,544,16,6,88,668,6,89,51,101,95,152,591,998,3,3399,188,0,2,1,4,1
5183,87,2025,2,2,2,0,0,0,2,0,0,0,0,0,0,0,0,0,0,0,0,2,1,4,1
5184,87,2025,8,5,5,0,0,3,8,0,0,0,0,0,0,0,0,0,0,0,0,2,1,4,1
5187,87,2025,14,8,8,0,0,6,14,0,0,0,0,0,0,0,0,0,0,0,0,2,1,4,1
5188,87,2025,6,4,4,0,0,2,6,0,0,0,0,0,0,0,0,0,0,0,0,2,1,4,1
5189,87,2025,6,4,4,0,0,2,6,1,2,1,2,3,3,2,4,0,2,0,0,2,1,4,1
5191,87,2025,7,5,5,0,0,2,7,0,0,0,0,0,0,0,0,0,0,0,0,2,1,4,1
5193,87,2025,10,6,6,0,0,4,10,0,0,0,0,0,0,0,0,0,0,0,0,2,1,4,1
5194,87,2025,1,1,1,0,0,0,1,0,0,0,0,0,0,0,0,0,0,0,0,2,1,4,1
5196,87,2025,14,10,10,0,0,4,14,1,1,1,1,2,2,0,2,0,1,0,0,2,1,4,1
5197,87,2025,46,26,30,3,0,12,49,3,6,3,6,9,9,20,28,1,42,2,0,2,1,4,1
5198,1,76,42,7,35,4,0,5,46,1,2,1,2,3,3,2,4,0,2,0,0,2,1,0,1
5199,1,76,11,6,10,0,0,1,11,2,4,2,4,6,6,10,15,1,15,0,0,2,1,0,1
5200,37,1642,1289,550,1043,56,32,155,1345,10,167,93,185,177,278,1266,2075,5,11498,638,0,2,1,1,1
5201,144,2506,1338,495,1086,10,64,173,1348,11,122,82,157,133,239,883,1686,7,11934,663,0,2,0,3,0
5202,14,320,215,129,180,6,0,29,221,8,65,43,72,73,115,415,711,4,3153,175,0,0,54,0,0
5203,14,320,97,69,77,3,3,16,100,6,22,13,23,28,36,113,173,3,542,30,0,0,54,0,0
5204,49,956,373,158,315,8,0,51,381,5,76,44,79,81,123,486,779,2,2026,112,0,2,5,0,0
5205,58,3702,1457,730,1242,11,6,188,1468,10,292,166,329,302,495,2424,4078,5,22973,1276,1,2,21,0,0
5206,15,1127,215,129,180,6,0,29,221,8,65,43,72,73,115,415,711,4,3153,175,0,0,184,0,0
5277,1,473,42,7,35,4,0,5,46,1,2,1,2,3,3,2,4,0,2,0,0,2,5,2,0
5278,1,473,11,6,10,0,0,1,11,2,4,2,4,6,6,10,15,1,15,0,0,2,5,2,0
5279,32,845,1043,504,840,53,9,147,1096,9,180,112,198,189,310,1377,2344,4,11604,644,0,2,6,3,0
5280,32,845,383,288,292,26,6,62,409,11,65,38,67,76,105,429,656,5,3719,206,0,2,6,3,0
5281,37,1642,1289,550,1043,56,32,155,1345,10,167,93,185,177,278,1266,2075,5,11498,638,0,2,3,2,0
5282,86,1899,1392,870,1177,35,17,170,1427,14,494,280,531,508,811,4473,7289,7,54850,3047,2,2,3,1,0
5283,97,3521,1392,870,1177,35,17,170,1427,14,494,280,531,508,811,4473,7289,7,54850,3047,2,2,2,0,0
5284,14,320,215,129,180,6,0,29,221,8,65,43,72,73,115,415,711,4,3153,175,0,2,1,1,0
5285,14,320,97,69,77,3,3,16,100,6,22,13,23,28,36,113,173,3,542,30,0,2,1,1,0
5286,49,951,373,158,315,8,0,51,381,5,76,44,79,81,123,486,779,2,2026,112,0,2,1,1,0
5287,58,3693,1457,730,1242,11,6,188,1468,10,292,166,329,302,495,2424,4078,5,22973,1276,1,2,0,2,0
5288,87,1905,1392,870,1177,35,17,170,1427,14,494,280,531,508,811,4473,7289,7,54850,3047,2,2,4,1,0
5289,16,586,182,127,129,0,0,53,182,5,39,21,42,44,63,217,343,2,926,51,0,2,16,0,0
5290,22,528,182,127,129,0,0,53,182,5,39,21,42,44,63,217,343,2,926,51,0,2,1,2,0
5291,22,528,1165,710,800,67,119,181,1232,18,243,153,282,261,435,2000,3492,10,36473,2026,1,2,1,2,0
5292,20,496,182,127,129,0,0,53,182,5,39,21,42,44,63,217,343,2,926,51,0,2,3,8,1
5293,20,496,1165,710,800,67,119,181,1232,18,243,153,282,261,435,2000,3492,10,36473,2026,1,2,3,8,1
5294,68,1530,773,419,590,28,0,166,801,10,204,113,217,214,330,1598,2554,5,13587,754,0,2,23,1,1
5295,68,1530,421,273,302,44,34,57,465,17,81,59,107,98,166,583,1098,11,12329,684,0,2,23,1,1
5296,97,3521,1392,870,1177,35,17,170,1427,14,494,280,531,508,811,4473,7289,7,54850,3047,2,2,1,1,1
5297,51,1685,773,419,590,28,0,166,801,10,204,113,217,214,330,1598,2554,5,13587,754,0,2,40,0,1
5298,36,1557,373,158,315,8,0,51,381,5,76,44,79,81,123,486,779,2,2026,112,0,2,14,0,1
5357,1,35,127,75,83,2,11,30,129,4,14,7,14,18,21,61,87,2,175,9,0,2,4,6,1
5358,1,35,652,304,544,16,6,88,668,6,89,51,101,95,152,591,998,3,3399,188,0,2,4,6,1
5359,1,35,2,2,2,0,0,0,2,0,0,0,0,0,0,0,0,0,0,0,0,2,4,6,1
5360,1,35,8,5,5,0,0,3,8,0,0,0,0,0,0,0,0,0,0,0,0,2,4,6,1
5363,1,35,14,8,8,0,0,6,14,0,0,0,0,0,0,0,0,0,0,0,0,2,4,6,1
5364,1,35,6,4,4,0,0,2,6,0,0,0,0,0,0,0,0,0,0,0,0,2,4,6,1
5365,1,35,6,4,4,0,0,2,6,1,2,1,2,3,3,2,4,0,2,0,0,2,4,6,1
5367,1,35,7,5,5,0,0,2,7,0,0,0,0,0,0,0,0,0,0,0,0,2,4,6,1
5369,1,35,10,6,6,0,0,4,10,0,0,0,0,0,0,0,0,0,0,0,0,2,4,6,1
5370,1,35,1,1,1,0,0,0,1,0,0,0,0,0,0,0,0,0,0,0,0,2,4,6,1
5372,1,35,14,10,10,0,0,4,14,1,1,1,1,2,2,0,2,0,1,0,0,2,4,6,1
5373,1,35,46,26,30,3,0,12,49,3,6,3,6,9,9,20,28,1,42,2,0,2,4,6,1
5374,1,85,127,75,83,2,11,30,129,4,14,7,14,18,21,61,87,2,175,9,0,2,12,35,1
5375,1,85,652,304,544,16,6,88,668,6,89,51,101,95,152,591,998,3,3399,188,0,2,12,35,1
5376,1,85,2,2,2,0,0,0,2,0,0,0,0,0,0,0,0,0,0,0,0,2,12,35,1
5377,1,85,8,5,5,0,0,3,8,0,0,0,0,0,0,0,0,0,0,0,0,2,12,35,1
5380,1,85,14,8,8,0,0,6,14,0,0,0,0,0,0,0,0,0,0,0,0,2,12,35,1
5381,1,85,6,4,4,0,0,2,6,0,0,0,0,0,0,0,0,0,0,0,0,2,12,35,1
5382,1,85,6,4,4,0,0,2,6,1,2,1,2,3,3,2,4,0,2,0,0,2,12,35,1
5384,1,85,7,5,5,0,0,2,7,0,0,0,0,0,0,0,0,0,0,0,0,2,12,35,1
5386,1,85,10,6,6,0,0,4,10,0,0,0,0,0,0,0,0,0,0,0,0,2,12,35,1
5387,1,85,1,1,1,0,0,0,1,0,0,0,0,0,0,0,0,0,0,0,0,2,12,35,1
5389,1,85,14,10,10,0,0,4,14,1,1,1,1,2,2,0,2,0,1,0,0,2,12,35,1
5390,1,85,46,26,30,3,0,12,49,3,6,3,6,9,9,20,28,1,42,2,0,2,12,35,1
5408,2,80,13,10,10,0,0,3,13,1,2,1,2,3,3,2,4,0,2,0,0,2,4,5,1
5410,15,369,386,256,301,16,9,68,402,4,59,35,69,63,104,355,621,2,1453,80,0,2,11,16,1
5411,15,369,264,131,164,11,41,46,275,6,38,22,40,44,62,214,338,3,1068,59,0,2,11,16,1
5481,151,2585,1338,495,1086,10,64,173,1348,11,122,82,157,133,239,883,1686,7,11934,663,0,2,88,57,1
5482,57,1285,1457,730,1242,11,6,188,1468,10,292,166,329,302,495,2424,4078,5,22973,1276,1,2,46,80,1
5483,57,1285,74,35,59,1,0,14,75,3,14,7,14,17,21,58,85,1,128,7,0,2,46,80,1
5484,57,1285,245,125,200,5,7,34,250,7,30,17,34,37,51,166,265,3,1053,58,0,2,46,80,1
5485,19,284,477,336,357,30,23,73,507,16,194,134,250,210,384,1538,2962,10,30538,1696,0,2,0,16,1
5486,26,496,334,251,279,10,4,40,344,5,127,74,143,132,217,899,1528,2,4303,239,0,0,92,0,1
5510,3,50,127,75,83,2,11,30,129,4,14,7,14,18,21,61,87,2,175,9,0,0,10,0,1
5511,3,50,652,304,544,16,6,88,668,6,89,51,101,95,152,591,998,3,3399,188,0,0,10,0,1
5512,3,50,2,2,2,0,0,0,2,0,0,0,0,0,0,0,0,0,0,0,0,0,10,0,1
5513,3,50,8,5,5,0,0,3,8,0,0,0,0,0,0,0,0,0,0,0,0,0,10,0,1
5516,3,50,14,8,8,0,0,6,14,0,0,0,0,0,0,0,0,0,0,0,0,0,10,0,1
5517,3,50,6,4,4,0,0,2,6,0,0,0,0,0,0,0,0,0,0,0,0,0,10,0,1
5518,3,50,6,4,4,0,0,2,6,1,2,1,2,3,3,2,4,0,2,0,0,0,10,0,1
5520,3,50,7,5,5,0,0,2,7,0,0,0,0,0,0,0,0,0,0,0,0,0,10,0,1
5522,3,50,10,6,6,0,0,4,10,0,0,0,0,0,0,0,0,0,0,0,0,0,10,0,1
5523,3,50,1,1,1,0,0,0,1,0,0,0,0,0,0,0,0,0,0,0,0,0,10,0,1
5525,3,50,14,10,10,0,0,4,14,1,1,1,1,2,2,0,2,0,1,0,0,0,10,0,1
5526,3,50,46,26,30,3,0,12,49,3,6,3,6,9,9,20,28,1,42,2,0,0,10,0,1
5532,25,611,1043,504,840,53,9,147,1096,9,180,112,198,189,310,1377,2344,4,11604,644,0,2,13,42,1
5533,25,611,383,288,292,26,6,62,409,11,65,38,67,76,105,429,656,5,3719,206,0,2,13,42,1
5534,46,833,373,158,315,8,0,51,381,5,76,44,79,81,123,486,779,2,2026,112,0,2,33,44,1
5535,25,1269,1289,550,1043,56,32,155,1345,10,167,93,185,177,278,1266,2075,5,11498,638,0,2,121,181,1
5553,48,3264,1457,730,1242,11,6,188,1468,10,292,166,329,302,495,2424,4078,5,22973,1276,1,2,339,396,1
5555,13,660,334,251,279,10,4,40,344,5,127,74,143,132,217,899,1528,2,4303,239,0,0,90,0,1
5557,23,1008,373,158,315,8,0,51,381,5,76,44,79,81,123,486,779,2,2026,112,0,2,44,128,1
5558,48,3264,1457,730,1242,11,6,188,1468,10,292,166,329,302,495,2424,4078,5,22973,1276,1,2,9,9,0
5559,57,1281,1457,730,1242,11,6,188,1468,10,292,166,329,302,495,2424,4078,5,22973,1276,1,2,4,6,0
5560,57,1281,74,35,59,1,0,14,75,3,14,7,14,17,21,58,85,1,128,7,0,2,4,6,0
5561,57,1281,245,125,200,5,7,34,250,7,30,17,34,37,51,166,265,3,1053,58,0,2,4,6,0
5585,48,3264,1457,730,1242,11,6,188,1468,10,292,166,329,302,495,2424,4078,5,22973,1276,1,2,3,3,0
5586,51,1168,1457,730,1242,11,6,188,1468,10,292,166,329,302,495,2424,4078,5,22973,1276,1,2,12,39,1
5587,51,1168,74,35,59,1,0,14,75,3,14,7,14,17,21,58,85,1,128,7,0,2,12,39,1
5588,51,1168,245,125,200,5,7,34,250,7,30,17,34,37,51,166,265,3,1053,58,0,2,12,39,1
5589,44,2896,1457,730,1242,11,6,188,1468,10,292,166,329,302,495,2424,4078,5,22973,1276,1,2,30,73,1
5590,24,1043,373,158,315,8,0,51,381,5,76,44,79,81,123,486,779,2,2026,112,0,2,5,0,1
5591,98,3601,1392,870,1177,35,17,170,1427,14,494,280,531,508,811,4473,7289,7,54850,3047,2,2,9,0,1
5592,52,1181,1457,730,1242,11,6,188,1468,10,292,166,329,302,495,2424,4078,5,22973,1276,1,2,12,8,1
5593,52,1181,74,35,59,1,0,14,75,3,14,7,14,17,21,58,85,1,128,7,0,2,12,8,1
5594,52,1181,245,125,200,5,7,34,250,7,30,17,34,37,51,166,265,3,1053,58,0,2,12,8,1
5595,44,2900,1457,730,1242,11,6,188,1468,10,292,166,329,302,495,2424,4078,5,22973,1276,1,2,21,9,1
5596,61,1328,1457,730,1242,11,6,188,1468,10,292,166,329,302,495,2424,4078,5,22973,1276,1,2,22,1,0
5597,61,1328,74,35,59,1,0,14,75,3,14,7,14,17,21,58,85,1,128,7,0,2,22,1,0
5598,61,1328,245,125,200,5,7,34,250,7,30,17,34,37,51,166,265,3,1053,58,0,2,22,1,0
5599,46,3133,1457,730,1242,11,6,188,1468,10,292,166,329,302,495,2424,4078,5,22973,1276,1,2,29,0,0
5600,150,2573,1338,495,1086,10,64,173,1348,11,122,82,157,133,239,883,1686,7,11934,663,0,2,0,3,1
5601,58,1297,1457,730,1242,11,6,188,1468,10,292,166,329,302,495,2424,4078,5,22973,1276,1,2,17,28,1
5602,58,1297,74,35,59,1,0,14,75,3,14,7,14,17,21,58,85,1,128,7,0,2,17,28,1
5603,58,1297,245,125,200,5,7,34,250,7,30,17,34,37,51,166,265,3,1053,58,0,2,17,28,1
5604,46,833,373,158,315,8,0,51,381,5,76,44,79,81,123,486,779,2,2026,112,0,2,1,1,1
5605,38,2138,1457,730,1242,11,6,188,1468,10,292,166,329,302,495,2424,4078,5,22973,1276,1,2,0,144,1
5876,140,2408,1338,495,1086,10,64,173,1348,11,122,82,157,133,239,883,1686,7,11934,663,0,2,0,33,1
5877,68,1464,1457,730,1242,11,6,188,1468,10,292,166,329,302,495,2424,4078,5,22973,1276,1,2,36,5,1
5878,68,1464,74,35,59,1,0,14,75,3,14,7,14,17,21,58,85,1,128,7,0,2,36,5,1
5879,68,1464,245,125,200,5,7,34,250,7,30,17,34,37,51,166,265,3,1053,58,0,2,36,5,1
5880,25,615,1043,504,840,53,9,147,1096,9,180,112,198,189,310,1377,2344,4,11604,644,0,2,2,2,1
5881,25,615,383,288,292,26,6,62,409,11,65,38,67,76,105,429,656,5,3719,206,0,2,2,2,1
5882,46,829,373,158,315,8,0,51,381,5,76,44,79,81,123,486,779,2,2026,112,0,2,1,1,1
5952,137,2384,1338,495,1086,10,64,173,1348,11,122,82,157,133,239,883,1686,7,11934,663,0,2,13,21,0
5953,139,2411,1338,495,1086,10,64,173,1348,11,122,82,157,133,239,883,1686,7,11934,663,0,2,5,2,0
5954,25,631,1043,504,840,53,9,147,1096,9,180,112,198,189,310,1377,2344,4,11604,644,0,2,3,1,1
5955,25,631,383,288,292,26,6,62,409,11,65,38,67,76,105,429,656,5,3719,206,0,2,3,1,1
5956,1,445,42,7,35,4,0,5,46,1,2,1,2,3,3,2,4,0,2,0,0,2,1,15,0
5957,1,445,11,6,10,0,0,1,11,2,4,2,4,6,6,10,15,1,15,0,0,2,1,15,0
5958,139,2416,1338,495,1086,10,64,173,1348,11,122,82,157,133,239,883,1686,7,11934,663,0,2,2,0,0
5959,87,1898,1392,870,1177,35,17,170,1427,14,494,280,531,508,811,4473,7289,7,54850,3047,2,2,1,1,1
5960,98,3604,1392,870,1177,35,17,170,1427,14,494,280,531,508,811,4473,7289,7,54850,3047,2,2,1,1,0
5961,1,87,127,75,83,2,11,30,129,4,14,7,14,18,21,61,87,2,175,9,0,2,1,1,1
5962,1,87,652,304,544,16,6,88,668,6,89,51,101,95,152,591,998,3,3399,188,0,2,1,1,1
5963,1,87,2,2,2,0,0,0,2,0,0,0,0,0,0,0,0,0,0,0,0,2,1,1,1
5964,1,87,8,5,5,0,0,3,8,0,0,0,0,0,0,0,0,0,0,0,0,2,1,1,1
5967,1,87,14,8,8,0,0,6,14,0,0,0,0,0,0,0,0,0,0,0,0,2,1,1,1
5968,1,87,6,4,4,0,0,2,6,0,0,0,0,0,0,0,0,0,0,0,0,2,1,1,1
5969,1,87,6,4,4,0,0,2,6,1,2,1,2,3,3,2,4,0,2,0,0,2,1,1,1
5971,1,87,7,5,5,0,0,2,7,0,0,0,0,0,0,0,0,0,0,0,0,2,1,1,1
5973,1,87,10,6,6,0,0,4,10,0,0,0,0,0,0,0,0,0,0,0,0,2,1,1,1
5974,1,87,1,1,1,0,0,0,1,0,0,0,0,0,0,0,0,0,0,0,0,2,1,1,1
5976,1,87,14,10,10,0,0,4,14,1,1,1,1,2,2,0,2,0,1,0,0,2,1,1,1
5977,1,87,46,26,30,3,0,12,49,3,6,3,6,9,9,20,28,1,42,2,0,2,1,1,1
5978,1,85,127,75,83,2,11,30,129,4,14,7,14,18,21,61,87,2,175,9,0,2,1,1,0
5979,1,85,652,304,544,16,6,88,668,6,89,51,101,95,152,591,998,3,3399,188,0,2,1,1,0
5980,1,85,2,2,2,0,0,0,2,0,0,0,0,0,0,0,0,0,0,0,0,2,1,1,0
5981,1,85,8,5,5,0,0,3,8,0,0,0,0,0,0,0,0,0,0,0,0,2,1,1,0
5984,1,85,14,8,8,0,0,6,14,0,0,0,0,0,0,0,0,0,0,0,0,2,1,1,0
5985,1,85,6,4,4,0,0,2,6,0,0,0,0,0,0,0,0,0,0,0,0,2,1,1,0
5986,1,85,6,4,4,0,0,2,6,1,2,1,2,3,3,2,4,0,2,0,0,2,1,1,0
5988,1,85,7,5,5,0,0,2,7,0,0,0,0,0,0,0,0,0,0,0,0,2,1,1,0
5990,1,85,10,6,6,0,0,4,10,0,0,0,0,0,0,0,0,0,0,0,0,2,1,1,0
5991,1,85,1,1,1,0,0,0,1,0,0,0,0,0,0,0,0,0,0,0,0,2,1,1,0
5993,1,85,14,10,10,0,0,4,14,1,1,1,1,2,2,0,2,0,1,0,0,2,1,1,0
5994,1,85,46,26,30,3,0,12,49,3,6,3,6,9,9,20,28,1,42,2,0,2,1,1,0
5995,27,503,334,251,279,10,4,40,344,5,127,74,143,132,217,899,1528,2,4303,239,0,2,2,1,0
5996,70,1507,1457,730,1242,11,6,188,1468,10,292,166,329,302,495,2424,4078,5,22973,1276,1,2,15,10,1
5997,70,1507,74,35,59,1,0,14,75,3,14,7,14,17,21,58,85,1,128,7,0,2,15,10,1
5998,70,1507,245,125,200,5,7,34,250,7,30,17,34,37,51,166,265,3,1053,58,0,2,15,10,1
5999,44,814,373,158,315,8,0,51,381,5,76,44,79,81,123,486,779,2,2026,112,0,2,3,3,1
6000,25,1266,1289,550,1043,56,32,155,1345,10,167,93,185,177,278,1266,2075,5,11498,638,0,2,8,13,1
6001,38,2103,1457,730,1242,11,6,188,1468,10,292,166,329,302,495,2424,4078,5,22973,1276,1,2,4,7,1
6002,71,1538,1457,730,1242,11,6,188,1468,10,292,166,329,302,495,2424,4078,5,22973,1276,1,2,6,0,1
6003,71,1538,74,35,59,1,0,14,75,3,14,7,14,17,21,58,85,1,128,7,0,2,6,0,1
6004,71,1538,245,125,200,5,7,34,250,7,30,17,34,37,51,166,265,3,1053,58,0,2,6,0,1
6005,26,1318,1289,550,1043,56,32,155,1345,10,167,93,185,177,278,1266,2075,5,11498,638,0,2,25,0,1
6006,39,2134,1457,730,1242,11,6,188,1468,10,292,166,329,302,495,2424,4078,5,22973,1276,1,2,6,0,1
6007,72,1555,1457,730,1242,11,6,188,1468,10,292,166,329,302,495,2424,4078,5,22973,1276,1,2,6,1,1
6008,72,1555,74,35,59,1,0,14,75,3,14,7,14,17,21,58,85,1,128,7,0,2,6,1,1
6009,72,1555,245,125,200,5,7,34,250,7,30,17,34,37,51,166,265,3,1053,58,0,2,6,1,1
6010,27,1359,1289,550,1043,56,32,155,1345,10,167,93,185,177,278,1266,2075,5,11498,638,0,2,13,1,1
6011,45,820,373,158,315,8,0,51,381,5,76,44,79,81,123,486,779,2,2026,112,0,2,2,0,1
6012,24,1006,373,158,315,8,0,51,381,5,76,44,79,81,123,486,779,2,2026,112,0,2,4,11,1
6013,45,825,373,158,315,8,0,51,381,5,76,44,79,81,123,486,779,2,2026,112,0,2,1,0,1
6014,75,1627,1457,730,1242,11,6,188,1468,10,292,166,329,302,495,2424,4078,5,22973,1276,1,2,14,6,1
6015,75,1627,74,35,59,1,0,14,75,3,14,7,14,17,21,58,85,1,128,7,0,2,14,6,1
6016,75,1627,245,125,200,5,7,34,250,7,30,17,34,37,51,166,265,3,1053,58,0,2,14,6,1
6017,28,1417,1289,550,1043,56,32,155,1345,10,167,93,185,177,278,1266,2075,5,11498,638,0,2,11,0,1
6018,39,2134,1457,730,1242,11,6,188,1468,10,292,166,329,302,495,2424,4078,5,22973,1276,1,2,2,1,1
6019,24,1014,373,158,315,8,0,51,381,5,76,44,79,81,123,486,779,2,2026,112,0,2,1,0,1
6020,78,1708,1457,730,1242,11,6,188,1468,10,292,166,329,302,495,2424,4078,5,22973,1276,1,2,15,3,1
6021,78,1708,74,35,59,1,0,14,75,3,14,7,14,17,21,58,85,1,128,7,0,2,15,3,1
6022,78,1708,245,125,200,5,7,34,250,7,30,17,34,37,51,166,265,3,1053,58,0,2,15,3,1
6023,42,2340,1457,730,1242,11,6,188,1468,10,292,166,329,302,495,2424,4078,5,22973,1276,1,2,33,7,1
6024,28,1435,1289,550,1043,56,32,155,1345,10,167,93,185,177,278,1266,2075,5,11498,638,0,2,2,1,1
6025,78,1712,1457,730,1242,11,6,188,1468,10,292,166,329,302,495,2424,4078,5,22973,1276,1,2,1,1,0
6026,78,1712,74,35,59,1,0,14,75,3,14,7,14,17,21,58,85,1,128,7,0,2,1,1,0
6027,78,1712,245,125,200,5,7,34,250,7,30,17,34,37,51,166,265,3,1053,58,0,2,1,1,0
6028,31,1528,1289,550,1043,56,32,155,1345,10,167,93,185,177,278,1266,2075,5,11498,638,0,2,21,3,1
6029,139,2413,1338,495,1086,10,64,173,1348,11,122,82,157,133,239,883,1686,7,11934,663,0,2,13,13,1
6030,25,631,1043,504,840,53,9,147,1096,9,180,112,198,189,310,1377,2344,4,11604,644,0,2,5,5,1
6031,25,631,383,288,292,26,6,62,409,11,65,38,67,76,105,429,656,5,3719,206,0,2,5,5,1
6032,45,825,373,158,315,8,0,51,381,5,76,44,79,81,123,486,779,2,2026,112,0,2,1,1,1
6033,42,2340,1457,730,1242,11,6,188,1468,10,292,166,329,302,495,2424,4078,5,22973,1276,1,2,5,5,1
6034,31,1528,1289,550,1043,56,32,155,1345,10,167,93,185,177,278,1266,2075,5,11498,638,0,2,3,3,1
6058,31,1536,1289,550,1043,56,32,155,1345,10,167,93,185,177,278,1266,2075,5,11498,638,0,2,2,2,1
6059,51,1713,773,419,590,28,0,166,801,10,204,113,217,214,330,1598,2554,5,13587,754,0,2,13,12,0
6061,140,2422,1338,495,1086,10,64,173,1348,11,122,82,157,133,239,883,1686,7,11934,663,0,2,19,10,1
6062,140,2417,1338,495,1086,10,64,173,1348,11,122,82,157,133,239,883,1686,7,11934,663,0,2,1,1,1
6063,1,90,127,75,83,2,11,30,129,4,14,7,14,18,21,61,87,2,175,9,0,2,2,0,1
6064,1,90,652,304,544,16,6,88,668,6,89,51,101,95,152,591,998,3,3399,188,0,2,2,0,1
6065,1,90,2,2,2,0,0,0,2,0,0,0,0,0,0,0,0,0,0,0,0,2,2,0,1
6066,1,90,8,5,5,0,0,3,8,0,0,0,0,0,0,0,0,0,0,0,0,2,2,0,1
6069,1,90,14,8,8,0,0,6,14,0,0,0,0,0,0,0,0,0,0,0,0,2,2,0,1
6070,1,90,6,4,4,0,0,2,6,0,0,0,0,0,0,0,0,0,0,0,0,2,2,0,1
6071,1,90,6,4,4,0,0,2,6,1,2,1,2,3,3,2,4,0,2,0,0,2,2,0,1
6073,1,90,7,5,5,0,0,2,7,0,0,0,0,0,0,0,0,0,0,0,0,2,2,0,1
6075,1,90,10,6,6,0,0,4,10,0,0,0,0,0,0,0,0,0,0,0,0,2,2,0,1
6076,1,90,1,1,1,0,0,0,1,0,0,0,0,0,0,0,0,0,0,0,0,2,2,0,1
6078,1,90,14,10,10,0,0,4,14,1,1,1,1,2,2,0,2,0,1,0,0,2,2,0,1
6079,1,90,46,26,30,3,0,12,49,3,6,3,6,9,9,20,28,1,42,2,0,2,2,0,1
6080,78,1737,1457,730,1242,11,6,188,1468,10,292,166,329,302,495,2424,4078,5,22973,1276,1,2,5,1,1
6081,78,1737,74,35,59,1,0,14,75,3,14,7,14,17,21,58,85,1,128,7,0,2,5,1,1
6082,78,1737,245,125,200,5,7,34,250,7,30,17,34,37,51,166,265,3,1053,58,0,2,5,1,1
6106,45,825,373,158,315,8,0,51,381,5,76,44,79,81,123,486,779,2,2026,112,0,2,2,2,0
6130,13,255,127,75,83,2,11,30,129,4,14,7,14,18,21,61,87,2,175,9,0,2,31,6,1
6131,13,255,652,304,544,16,6,88,668,6,89,51,101,95,152,591,998,3,3399,188,0,2,31,6,1
6132,13,255,2,2,2,0,0,0,2,0,0,0,0,0,0,0,0,0,0,0,0,2,31,6,1
6133,13,255,8,5,5,0,0,3,8,0,0,0,0,0,0,0,0,0,0,0,0,2,31,6,1
6136,13,255,14,8,8,0,0,6,14,0,0,0,0,0,0,0,0,0,0,0,0,2,31,6,1
6137,13,255,6,4,4,0,0,2,6,0,0,0,0,0,0,0,0,0,0,0,0,2,31,6,1
6138,13,255,6,4,4,0,0,2,6,1,2,1,2,3,3,2,4,0,2,0,0,2,31,6,1
6140,13,255,7,5,5,0,0,2,7,0,0,0,0,0,0,0,0,0,0,0,0,2,31,6,1
6142,13,255,10,6,6,0,0,4,10,0,0,0,0,0,0,0,0,0,0,0,0,2,31,6,1
6143,13,255,1,1,1,0,0,0,1,0,0,0,0,0,0,0,0,0,0,0,0,2,31,6,1
6145,13,255,14,10,10,0,0,4,14,1,1,1,1,2,2,0,2,0,1,0,0,2,31,6,1
6146,13,255,46,26,30,3,0,12,49,3,6,3,6,9,9,20,28,1,42,2,0,2,31,6,1
6170,13,271,127,75,83,2,11,30,129,4,14,7,14,18,21,61,87,2,175,9,0,2,2,0,1
6171,13,271,652,304,544,16,6,88,668,6,89,51,101,95,152,591,998,3,3399,188,0,2,2,0,1
6172,13,271,2,2,2,0,0,0,2,0,0,0,0,0,0,0,0,0,0,0,0,2,2,0,1
6173,13,271,8,5,5,0,0,3,8,0,0,0,0,0,0,0,0,0,0,0,0,2,2,0,1
6176,13,271,14,8,8,0,0,6,14,0,0,0,0,0,0,0,0,0,0,0,0,2,2,0,1
6177,13,271,6,4,4,0,0,2,6,0,0,0,0,0,0,0,0,0,0,0,0,2,2,0,1
6178,13,271,6,4,4,0,0,2,6,1,2,1,2,3,3,2,4,0,2,0,0,2,2,0,1
6180,13,271,7,5,5,0,0,2,7,0,0,0,0,0,0,0,0,0,0,0,0,2,2,0,1
6182,13,271,10,6,6,0,0,4,10,0,0,0,0,0,0,0,0,0,0,0,0,2,2,0,1
6183,13,271,1,1,1,0,0,0,1,0,0,0,0,0,0,0,0,0,0,0,0,2,2,0,1
6185,13,271,14,10,10,0,0,4,14,1,1,1,1,2,2,0,2,0,1,0,0,2,2,0,1
6186,13,271,46,26,30,3,0,12,49,3,6,3,6,9,9,20,28,1,42,2,0,2,2,0,1
6187,31,1539,1289,550,1043,56,32,155,1345,10,167,93,185,177,278,1266,2075,5,11498,638,0,2,7,4,0
6188,45,801,373,158,315,8,0,51,381,5,76,44,79,81,123,486,779,2,2026,112,0,2,1,2,1
6189,42,2324,1457,730,1242,11,6,188,1468,10,292,166,329,302,495,2424,4078,5,22973,1276,1,2,0,3,0
6207,94,1980,1457,730,1242,11,6,188,1468,10,292,166,329,302,495,2424,4078,5,22973,1276,1,2,39,0,1
6208,94,1980,74,35,59,1,0,14,75,3,14,7,14,17,21,58,85,1,128,7,0,2,39,0,1
6209,94,1980,245,125,200,5,7,34,250,7,30,17,34,37,51,166,265,3,1053,58,0,2,39,0,1
6210,31,1539,1289,550,1043,56,32,155,1345,10,167,93,185,177,278,1266,2075,5,11498,638,0,2,10,11,1
6211,42,2324,1457,730,1242,11,6,188,1468,10,292,166,329,302,495,2424,4078,5,22973,1276,1,2,0,2,1
6212,45,796,373,158,315,8,0,51,381,5,76,44,79,81,123,486,779,2,2026,112,0,2,1,1,1
6213,31,1539,1289,550,1043,56,32,155,1345,10,167,93,185,177,278,1266,2075,5,11498,638,0,2,4,4,1
6237,1,449,42,7,35,4,0,5,46,1,2,1,2,3,3,2,4,0,2,0,0,2,20,17,1
6238,1,449,11,6,10,0,0,1,11,2,4,2,4,6,6,10,15,1,15,0,0,2,20,17,1
6262,93,1970,1457,730,1242,11,6,188,1468,10,292,166,329,302,495,2424,4078,5,22973,1276,1,2,4,6,1
6263,93,1970,74,35,59,1,0,14,75,3,14,7,14,17,21,58,85,1,128,7,0,2,4,6,1
6264,93,1970,245,125,200,5,7,34,250,7,30,17,34,37,51,166,265,3,1053,58,0,2,4,6,1
6265,40,756,373,158,315,8,0,51,381,5,76,44,79,81,123,486,779,2,2026,112,0,2,0,12,1
6266,31,1539,1289,550,1043,56,32,155,1345,10,167,93,185,177,278,1266,2075,5,11498,638,0,2,1,1,1
6267,37,2114,1457,730,1242,11,6,188,1468,10,292,166,329,302,495,2424,4078,5,22973,1276,1,2,0,32,1
6314,25,631,1043,504,840,53,9,147,1096,9,180,112,198,189,310,1377,2344,4,11604,644,0,2,1,1,1
6315,25,631,383,288,292,26,6,62,409,11,65,38,67,76,105,429,656,5,3719,206,0,2,1,1,1
6316,93,1972,1457,730,1242,11,6,188,1468,10,292,166,329,302,495,2424,4078,5,22973,1276,1,2,2,2,1
6317,93,1972,74,35,59,1,0,14,75,3,14,7,14,17,21,58,85,1,128,7,0,2,2,2,1
6318,93,1972,245,125,200,5,7,34,250,7,30,17,34,37,51,166,265,3,1053,58,0,2,2,2,1
6319,37,2114,1457,730,1242,11,6,188,1468,10,292,166,329,302,495,2424,4078,5,22973,1276,1,2,4,4,1
6320,92,1962,1457,730,1242,11,6,188,1468,10,292,166,329,302,495,2424,4078,5,22973,1276,1,2,4,7,0
6321,92,1962,74,35,59,1,0,14,75,3,14,7,14,17,21,58,85,1,128,7,0,2,4,7,0
6322,92,1962,245,125,200,5,7,34,250,7,30,17,34,37,51,166,265,3,1053,58,0,2,4,7,0
6323,31,1539,1289,550,1043,56,32,155,1345,10,167,93,185,177,278,1266,2075,5,11498,638,0,2,4,4,0
6324,93,2003,1457,730,1242,11,6,188,1468,10,292,166,329,302,495,2424,4078,5,22973,1276,1,2,12,7,0
6325,93,2003,74,35,59,1,0,14,75,3,14,7,14,17,21,58,85,1,128,7,0,2,12,7,0
6326,93,2003,245,125,200,5,7,34,250,7,30,17,34,37,51,166,265,3,1053,58,0,2,12,7,0
6327,31,1539,1289,550,1043,56,32,155,1345,10,167,93,185,177,278,1266,2075,5,11498,638,0,2,2,2,0
6328,43,2395,1457,730,1242,11,6,188,1468,10,292,166,329,302,495,2424,4078,5,22973,1276,1,2,42,0,0
6332,92,1980,1457,730,1242,11,6,188,1468,10,292,166,329,302,495,2424,4078,5,22973,1276,1,2,10,14,1
6333,92,1980,74,35,59,1,0,14,75,3,14,7,14,17,21,58,85,1,128,7,0,2,10,14,1
6334,92,1980,245,125,200,5,7,34,250,7,30,17,34,37,51,166,265,3,1053,58,0,2,10,14,1
6335,33,1753,1289,550,1043,56,32,155,1345,10,167,93,185,177,278,1266,2075,5,11498,638,0,2,88,39,1
6336,37,2114,1457,730,1242,11,6,188,1468,10,292,166,329,302,495,2424,4078,5,22973,1276,1,2,1,45,1
6337,13,269,127,75,83,2,11,30,129,4,14,7,14,18,21,61,87,2,175,9,0,2,2,3,0
6338,13,269,652,304,544,16,6,88,668,6,89,51,101,95,152,591,998,3,3399,188,0,2,2,3,0
6339,13,269,2,2,2,0,0,0,2,0,0,0,0,0,0,0,0,0,0,0,0,2,2,3,0
6340,13,269,8,5,5,0,0,3,8,0,0,0,0,0,0,0,0,0,0,0,0,2,2,3,0
6343,13,269,14,8,8,0,0,6,14,0,0,0,0,0,0,0,0,0,0,0,0,2,2,3,0
6344,13,269,6,4,4,0,0,2,6,0,0,0,0,0,0,0,0,0,0,0,0,2,2,3,0
6345,13,269,6,4,4,0,0,2,6,1,2,1,2,3,3,2,4,0,2,0,0,2,2,3,0
6347,13,269,7,5,5,0,0,2,7,0,0,0,0,0,0,0,0,0,0,0,0,2,2,3,0
6349,13,269,10,6,6,0,0,4,10,0,0,0,0,0,0,0,0,0,0,0,0,2,2,3,0
6350,13,269,1,1,1,0,0,0,1,0,0,0,0,0,0,0,0,0,0,0,0,2,2,3,0
6352,13,269,14,10,10,0,0,4,14,1,1,1,1,2,2,0,2,0,1,0,0,2,2,3,0
6353,13,269,46,26,30,3,0,12,49,3,6,3,6,9,9,20,28,1,42,2,0,2,2,3,0
6354,33,1781,1289,550,1043,56,32,155,1345,10,167,93,185,177,278,1266,2075,5,11498,638,0,2,21,22,0
6355,1,461,42,7,35,4,0,5,46,1,2,1,2,3,3,2,4,0,2,0,0,2,18,12,1
6356,1,461,11,6,10,0,0,1,11,2,4,2,4,6,6,10,15,1,15,0,0,2,18,12,1
6357,1,459,42,7,35,4,0,5,46,1,2,1,2,3,3,2,4,0,2,0,0,2,1,2,0
6358,1,459,11,6,10,0,0,1,11,2,4,2,4,6,6,10,15,1,15,0,0,2,1,2,0
6359,1,459,42,7,35,4,0,5,46,1,2,1,2,3,3,2,4,0,2,0,0,2,1,1,1
6360,1,459,11,6,10,0,0,1,11,2,4,2,4,6,6,10,15,1,15,0,0,2,1,1,1
6361,1,449,42,7,35,4,0,5,46,1,2,1,2,3,3,2,4,0,2,0,0,2,2,7,1
6362,1,449,11,6,10,0,0,1,11,2,4,2,4,6,6,10,15,1,15,0,0,2,2,7,1
6386,1,445,42,7,35,4,0,5,46,1,2,1,2,3,3,2,4,0,2,0,0,2,3,5,0
6387,1,445,11,6,10,0,0,1,11,2,4,2,4,6,6,10,15,1,15,0,0,2,3,5,0
6411,1,445,42,7,35,4,0,5,46,1,2,1,2,3,3,2,4,0,2,0,0,2,4,4,1
6412,1,445,11,6,10,0,0,1,11,2,4,2,4,6,6,10,15,1,15,0,0,2,4,4,1
6436,1,433,42,7,35,4,0,5,46,1,2,1,2,3,3,2,4,0,2,0,0,2,6,12,1
6437,1,433,11,6,10,0,0,1,11,2,4,2,4,6,6,10,15,1,15,0,0,2,6,12,1
6438,96,2109,1457,730,1242,11,6,188,1468,10,292,166,329,302,495,2424,4078,5,22973,1276,1,2,18,1,0
6439,96,2109,74,35,59,1,0,14,75,3,14,7,14,17,21,58,85,1,128,7,0,2,18,1,0
6440,96,2109,245,125,200,5,7,34,250,7,30,17,34,37,51,166,265,3,1053,58,0,2,18,1,0
6441,43,2292,1457,730,1242,11,6,188,1468,10,292,166,329,302,495,2424,4078,5,22973,1276,1,2,28,0,0
6465,33,1810,1289,550,1043,56,32,155,1345,10,167,93,185,177,278,1266,2075,5,11498,638,0,2,8,3,1
6466,3,441,42,7,35,4,0,5,46,1,2,1,2,3,3,2,4,0,2,0,0,2,8,5,1
6467,3,441,11,6,10,0,0,1,11,2,4,2,4,6,6,10,15,1,15,0,0,2,8,5,1
6468,13,269,127,75,83,2,11,30,129,4,14,7,14,18,21,61,87,2,175,9,0,2,2,2,1
6469,13,269,652,304,544,16,6,88,668,6,89,51,101,95,152,591,998,3,3399,188,0,2,2,2,1
6470,13,269,2,2,2,0,0,0,2,0,0,0,0,0,0,0,0,0,0,0,0,2,2,2,1
6471,13,269,8,5,5,0,0,3,8,0,0,0,0,0,0,0,0,0,0,0,0,2,2,2,1
6474,13,269,14,8,8,0,0,6,14,0,0,0,0,0,0,0,0,0,0,0,0,2,2,2,1
6475,13,269,6,4,4,0,0,2,6,0,0,0,0,0,0,0,0,0,0,0,0,2,2,2,1
6476,13,269,6,4,4,0,0,2,6,1,2,1,2,3,3,2,4,0,2,0,0,2,2,2,1
6478,13,269,7,5,5,0,0,2,7,0,0,0,0,0,0,0,0,0,0,0,0,2,2,2,1
6480,13,269,10,6,6,0,0,4,10,0,0,0,0,0,0,0,0,0,0,0,0,2,2,2,1
6481,13,269,1,1,1,0,0,0,1,0,0,0,0,0,0,0,0,0,0,0,0,2,2,2,1
6483,13,269,14,10,10,0,0,4,14,1,1,1,1,2,2,0,2,0,1,0,0,2,2,2,1
6484,13,269,46,26,30,3,0,12,49,3,6,3,6,9,9,20,28,1,42,2,0,2,2,2,1
6485,92,1980,1457,730,1242,11,6,188,1468,10,292,166,329,302,495,2424,4078,5,22973,1276,1,2,1,18,0
6486,92,1980,74,35,59,1,0,14,75,3,14,7,14,17,21,58,85,1,128,7,0,2,1,18,0
6487,92,1980,245,125,200,5,7,34,250,7,30,17,34,37,51,166,265,3,1053,58,0,2,1,18,0
6488,37,2114,1457,730,1242,11,6,188,1468,10,292,166,329,302,495,2424,4078,5,22973,1276,1,2,0,28,0
6537,3,399,42,7,35,4,0,5,46,1,2,1,2,3,3,2,4,0,2,0,0,2,2,25,0
6538,3,399,11,6,10,0,0,1,11,2,4,2,4,6,6,10,15,1,15,0,0,2,2,25,0
6539,3,399,42,7,35,4,0,5,46,1,2,1,2,3,3,2,4,0,2,0,0,2,1,1,0
6540,3,399,11,6,10,0,0,1,11,2,4,2,4,6,6,10,15,1,15,0,0,2,1,1,0
6541,27,519,334,251,279,10,4,40,344,5,127,74,143,132,217,899,1528,2,4303,239,0,2,4,2,0
6542,13,660,334,251,279,10,4,40,344,5,127,74,143,132,217,899,1528,2,4303,239,0,2,1,1,0
6566,3,399,42,7,35,4,0,5,46,1,2,1,2,3,3,2,4,0,2,0,0,2,2,2,0
6567,3,399,11,6,10,0,0,1,11,2,4,2,4,6,6,10,15,1,15,0,0,2,2,2,0
6608,3,399,42,7,35,4,0,5,46,1,2,1,2,3,3,2,4,0,2,0,0,2,3,3,0
6609,3,399,11,6,10,0,0,1,11,2,4,2,4,6,6,10,15,1,15,0,0,2,3,3,0
6639,1,383,42,7,35,4,0,5,46,1,2,1,2,3,3,2,4,0,2,0,0,2,7,9,0
6640,1,383,11,6,10,0,0,1,11,2,4,2,4,6,6,10,15,1,15,0,0,2,7,9,0
6641,36,2098,1457,730,1242,11,6,188,1468,10,292,166,329,302,495,2424,4078,5,22973,1276,1,2,3,7,0
6751,13,267,127,75,83,2,11,30,129,4,14,7,14,18,21,61,87,2,175,9,0,2,1,1,1
6752,13,267,652,304,544,16,6,88,668,6,89,51,101,95,152,591,998,3,3399,188,0,2,1,1,1
6753,13,267,2,2,2,0,0,0,2,0,0,0,0,0,0,0,0,0,0,0,0,2,1,1,1
6754,13,267,8,5,5,0,0,3,8,0,0,0,0,0,0,0,0,0,0,0,0,2,1,1,1
6757,13,267,14,8,8,0,0,6,14,0,0,0,0,0,0,0,0,0,0,0,0,2,1,1,1
6758,13,267,6,4,4,0,0,2,6,0,0,0,0,0,0,0,0,0,0,0,0,2,1,1,1
6759,13,267,6,4,4,0,0,2,6,1,2,1,2,3,3,2,4,0,2,0,0,2,1,1,1
6761,13,267,7,5,5,0,0,2,7,0,0,0,0,0,0,0,0,0,0,0,0,2,1,1,1
6763,13,267,10,6,6,0,0,4,10,0,0,0,0,0,0,0,0,0,0,0,0,2,1,1,1
6764,13,267,1,1,1,0,0,0,1,0,0,0,0,0,0,0,0,0,0,0,0,2,1,1,1
6766,13,267,14,10,10,0,0,4,14,1,1,1,1,2,2,0,2,0,1,0,0,2,1,1,1
6767,13,267,46,26,30,3,0,12,49,3,6,3,6,9,9,20,28,1,42,2,0,2,1,1,1
6768,1,319,42,7,35,4,0,5,46,1,2,1,2,3,3,2,4,0,2,0,0,2,2,34,0
6769,1,319,11,6,10,0,0,1,11,2,4,2,4,6,6,10,15,1,15,0,0,2,2,34,0
6770,15,369,386,256,301,16,9,68,402,4,59,35,69,63,104,355,621,2,1453,80,0,2,1,1,1
6771,15,369,264,131,164,11,41,46,275,6,38,22,40,44,62,214,338,3,1068,59,0,2,1,1,1
6772,40,756,373,158,315,8,0,51,381,5,76,44,79,81,123,486,779,2,2026,112,0,2,2,2,1
6774,31,322,757,253,292,73,244,162,830,13,61,38,67,74,105,409,651,7,4654,258,0,0,120,0,0
6809,13,272,127,75,83,2,11,30,129,4,14,7,14,18,21,61,87,2,175,9,0,2,1,0,1
6810,13,272,652,304,544,16,6,88,668,6,89,51,101,95,152,591,998,3,3399,188,0,2,1,0,1
6811,13,272,2,2,2,0,0,0,2,0,0,0,0,0,0,0,0,0,0,0,0,2,1,0,1
6812,13,272,8,5,5,0,0,3,8,0,0,0,0,0,0,0,0,0,0,0,0,2,1,0,1
6815,13,272,14,8,8,0,0,6,14,0,0,0,0,0,0,0,0,0,0,0,0,2,1,0,1
6816,13,272,6,4,4,0,0,2,6,0,0,0,0,0,0,0,0,0,0,0,0,2,1,0,1
6817,13,272,6,4,4,0,0,2,6,1,2,1,2,3,3,2,4,0,2,0,0,2,1,0,1
6819,13,272,7,5,5,0,0,2,7,0,0,0,0,0,0,0,0,0,0,0,0,2,1,0,1
6821,13,272,10,6,6,0,0,4,10,0,0,0,0,0,0,0,0,0,0,0,0,2,1,0,1
6822,13,272,1,1,1,0,0,0,1,0,0,0,0,0,0,0,0,0,0,0,0,2,1,0,1
6824,13,272,14,10,10,0,0,4,14,1,1,1,1,2,2,0,2,0,1,0,0,2,1,0,1
6825,13,272,46,26,30,3,0,12,49,3,6,3,6,9,9,20,28,1,42,2,0,2,1,0,1
6826,31,320,757,253,292,73,244,162,830,13,61,38,67,74,105,409,651,7,4654,258,0,2,3,3,1
6827,40,750,373,158,315,8,0,51,381,5,76,44,79,81,123,486,779,2,2026,112,0,2,1,1,1
6828,24,1016,373,158,315,8,0,51,381,5,76,44,79,81,123,486,779,2,2026,112,0,2,3,3,1
6829,31,324,757,253,292,73,244,162,830,13,61,38,67,74,105,409,651,7,4654,258,0,2,1,1,1
6830,42,753,373,158,315,8,0,51,381,5,76,44,79,81,123,486,779,2,2026,112,0,2,2,1,1
6832,42,748,373,158,315,8,0,51,381,5,76,44,79,81,123,486,779,2,2026,112,0,2,1,1,1
6833,31,324,757,253,292,73,244,162,830,13,61,38,67,74,105,409,651,7,4654,258,0,2,3,3,1
6834,42,737,373,158,315,8,0,51,381,5,76,44,79,81,123,486,779,2,2026,112,0,2,2,2,1
6835,24,1014,373,158,315,8,0,51,381,5,76,44,79,81,123,486,779,2,2026,112,0,2,2,2,1
6836,31,326,757,253,292,73,244,162,830,13,61,38,67,74,105,409,651,7,4654,258,0,2,2,2,1
6837,23,632,1043,504,840,53,9,147,1096,9,180,112,198,189,310,1377,2344,4,11604,644,0,2,24,23,0
6838,23,632,383,288,292,26,6,62,409,11,65,38,67,76,105,429,656,5,3719,206,0,2,24,23,0
6862,23,1002,373,158,315,8,0,51,381,5,76,44,79,81,123,486,779,2,2026,112,0,2,4,6,0
6863,19,509,1043,504,840,53,9,147,1096,9,180,112,198,189,310,1377,2344,4,11604,644,0,2,39,60,1
6864,19,509,383,288,292,26,6,62,409,11,65,38,67,76,105,429,656,5,3719,206,0,2,39,60,1
6865,138,2386,1338,495,1086,10,64,173,1348,11,122,82,157,133,239,883,1686,7,11934,663,0,2,0,6,0
6866,32,339,757,253,292,73,244,162,830,13,61,38,67,74,105,409,651,7,4654,258,0,2,3,0,0
6867,42,736,373,158,315,8,0,51,381,5,76,44,79,81,123,486,779,2,2026,112,0,2,2,3,0
6868,42,724,373,158,315,8,0,51,381,5,76,44,79,81,123,486,779,2,2026,112,0,2,1,3,0
6869,17,451,1043,504,840,53,9,147,1096,9,180,112,198,189,310,1377,2344,4,11604,644,0,2,0,13,0
6870,17,451,383,288,292,26,6,62,409,11,65,38,67,76,105,429,656,5,3719,206,0,2,0,13,0
6871,19,276,477,336,357,30,23,73,507,16,194,134,250,210,384,1538,2962,10,30538,1696,0,2,0,1,0
6872,42,722,373,158,315,8,0,51,381,5,76,44,79,81,123,486,779,2,2026,112,0,2,1,1,0
6873,33,872,1043,504,840,53,9,147,1096,9,180,112,198,189,310,1377,2344,4,11604,644,0,2,83,6,1
6874,33,872,383,288,292,26,6,62,409,11,65,38,67,76,105,429,656,5,3719,206,0,2,83,6,1
6875,82,1830,1457,730,1242,11,6,188,1468,10,292,166,329,302,495,2424,4078,5,22973,1276,1,2,1,28,1
6876,82,1830,74,35,59,1,0,14,75,3,14,7,14,17,21,58,85,1,128,7,0,2,1,28,1
6877,82,1830,245,125,200,5,7,34,250,7,30,17,34,37,51,166,265,3,1053,58,0,2,1,28,1
6878,33,348,757,253,292,73,244,162,830,13,61,38,67,74,105,409,651,7,4654,258,0,2,3,0,1
6879,53,1236,1043,504,840,53,9,147,1096,9,180,112,198,189,310,1377,2344,4,11604,644,0,2,69,3,1
6880,53,1236,383,288,292,26,6,62,409,11,65,38,67,76,105,429,656,5,3719,206,0,2,69,3,1
6881,34,361,757,253,292,73,244,162,830,13,61,38,67,74,105,409,651,7,4654,258,0,2,4,1,1
6882,55,1341,1043,504,840,53,9,147,1096,9,180,112,198,189,310,1377,2344,4,11604,644,0,2,36,21,1
6883,55,1341,383,288,292,26,6,62,409,11,65,38,67,76,105,429,656,5,3719,206,0,2,36,21,1
6884,6,416,1043,504,840,53,9,147,1096,9,180,112,198,189,310,1377,2344,4,11604,644,0,0,91,0,1
6885,34,361,757,253,292,73,244,162,830,13,61,38,67,74,105,409,651,7,4654,258,0,2,2,2,1
6886,42,722,373,158,315,8,0,51,381,5,76,44,79,81,123,486,779,2,2026,112,0,2,4,4,1
6887,6,416,1043,504,840,53,9,147,1096,9,180,112,198,189,310,1377,2344,4,11604,644,0,2,1,1,1
6888,138,2386,1338,495,1086,10,64,173,1348,11,122,82,157,133,239,883,1686,7,11934,663,0,2,3,18,0
6889,53,1303,1043,504,840,53,9,147,1096,9,180,112,198,189,310,1377,2344,4,11604,644,0,2,0,7,0
6890,53,1303,383,288,292,26,6,62,409,11,65,38,67,76,105,429,656,5,3719,206,0,2,0,7,0
6891,6,416,1043,504,840,53,9,147,1096,9,180,112,198,189,310,1377,2344,4,11604,644,0,2,6,6,0
6892,23,1002,373,158,315,8,0,51,381,5,76,44,79,81,123,486,779,2,2026,112,0,2,3,3,0
6893,35,374,757,253,292,73,244,162,830,13,61,38,67,74,105,409,651,7,4654,258,0,2,3,0,1
6894,53,1303,1043,504,840,53,9,147,1096,9,180,112,198,189,310,1377,2344,4,11604,644,0,2,3,0,1
6895,53,1303,383,288,292,26,6,62,409,11,65,38,67,76,105,429,656,5,3719,206,0,2,3,0,1
6896,23,1002,373,158,315,8,0,51,381,5,76,44,79,81,123,486,779,2,2026,112,0,2,8,8,1
6897,35,374,757,253,292,73,244,162,830,13,61,38,67,74,105,409,651,7,4654,258,0,2,1,1,0
6898,53,1300,1043,504,840,53,9,147,1096,9,180,112,198,189,310,1377,2344,4,11604,644,0,2,2,7,0
6899,53,1300,383,288,292,26,6,62,409,11,65,38,67,76,105,429,656,5,3719,206,0,2,2,7,0
6900,42,722,373,158,315,8,0,51,381,5,76,44,79,81,123,486,779,2,2026,112,0,2,2,2,0
6904,45,1284,2,2,2,0,0,0,2,0,0,0,0,0,0,0,0,0,0,0,0,0,346,0,0
6918,45,1284,99,48,90,1,3,5,100,0,0,0,0,0,0,0,0,0,0,0,0,0,346,0,0
6919,45,1284,8,5,5,2,0,1,10,0,0,0,0,0,0,0,0,0,0,0,0,0,346,0,0
6920,45,1284,1217,716,841,84,126,174,1301,14,185,118,215,199,333,1446,2542,8,20687,1149,0,0,346,0,0
6921,45,1284,160,89,115,0,13,31,160,7,15,11,17,22,28,78,124,3,495,27,0,0,346,0,0
6922,45,1284,10,10,9,9,0,0,19,0,0,0,0,0,0,0,0,0,0,0,0,0,346,0,0
6923,45,1284,173,84,99,8,29,36,181,5,12,7,13,17,20,54,81,2,221,12,0,0,346,0,0
6924,45,1284,3,1,1,3,0,0,6,0,0,0,0,0,0,0,0,0,0,0,0,0,346,0,0
6927,16,393,2,2,2,0,0,0,2,0,0,0,0,0,0,0,0,0,0,0,0,0,114,0,0
6941,16,393,99,48,90,1,3,5,100,0,0,0,0,0,0,0,0,0,0,0,0,0,114,0,0
6942,16,393,8,5,5,2,0,1,10,0,0,0,0,0,0,0,0,0,0,0,0,0,114,0,0
6943,16,393,1217,716,841,84,126,174,1301,14,185,118,215,199,333,1446,2542,8,20687,1149,0,0,114,0,0
6944,16,393,160,89,115,0,13,31,160,7,15,11,17,22,28,78,124,3,495,27,0,0,114,0,0
6945,16,393,10,10,9,9,0,0,19,0,0,0,0,0,0,0,0,0,0,0,0,0,114,0,0
6946,16,393,173,84,99,8,29,36,181,5,12,7,13,17,20,54,81,2,221,12,0,0,114,0,0
6947,16,393,3,1,1,3,0,0,6,0,0,0,0,0,0,0,0,0,0,0,0,0,114,0,0
6948,88,1951,1457,730,1242,11,6,188,1468,10,292,166,329,302,495,2424,4078,5,22973,1276,1,2,22,0,1
6949,88,1951,74,35,59,1,0,14,75,3,14,7,14,17,21,58,85,1,128,7,0,2,22,0,1
6950,88,1951,245,125,200,5,7,34,250,7,30,17,34,37,51,166,265,3,1053,58,0,2,22,0,1
6951,49,1248,1043,504,840,53,9,147,1096,9,180,112,198,189,310,1377,2344,4,11604,644,0,2,8,27,1
6952,49,1248,383,288,292,26,6,62,409,11,65,38,67,76,105,429,656,5,3719,206,0,2,8,27,1
6953,42,2284,1457,730,1242,11,6,188,1468,10,292,166,329,302,495,2424,4078,5,22973,1276,1,2,32,3,1
6954,44,1071,1043,504,840,53,9,147,1096,9,180,112,198,189,310,1377,2344,4,11604,644,0,2,0,21,0
6955,44,1071,383,288,292,26,6,62,409,11,65,38,67,76,105,429,656,5,3719,206,0,2,0,21,0
6956,6,419,1043,504,840,53,9,147,1096,9,180,112,198,189,310,1377,2344,4,11604,644,0,2,1,0,0
7003,88,1960,1457,730,1242,11,6,188,1468,10,292,166,329,302,495,2424,4078,5,22973,1276,1,2,1,0,1
7004,88,1960,74,35,59,1,0,14,75,3,14,7,14,17,21,58,85,1,128,7,0,2,1,0,1
7005,88,1960,245,125,200,5,7,34,250,7,30,17,34,37,51,166,265,3,1053,58,0,2,1,0,1
7006,36,387,757,253,292,73,244,162,830,13,61,38,67,74,105,409,651,7,4654,258,0,2,4,0,1
7009,16,393,2,2,2,0,0,0,2,0,0,0,0,0,0,0,0,0,0,0,0,2,1,0,0
7023,16,393,99,48,90,1,3,5,100,0,0,0,0,0,0,0,0,0,0,0,0,2,1,0,0
7024,16,393,8,5,5,2,0,1,10,0,0,0,0,0,0,0,0,0,0,0,0,2,1,0,0
7025,16,393,1217,716,841,84,126,174,1301,14,185,118,215,199,333,1446,2542,8,20687,1149,0,2,1,0,0
7026,16,393,160,89,115,0,13,31,160,7,15,11,17,22,28,78,124,3,495,27,0,2,1,0,0
7027,16,393,10,10,9,9,0,0,19,0,0,0,0,0,0,0,0,0,0,0,0,2,1,0,0
7028,16,393,173,84,99,8,29,36,181,5,12,7,13,17,20,54,81,2,221,12,0,2,1,0,0
7029,16,393,3,1,1,3,0,0,6,0,0,0,0,0,0,0,0,0,0,0,0,2,1,0,0
7030,138,2382,1338,495,1086,10,64,173,1348,11,122,82,157,133,239,883,1686,7,11934,663,0,2,3,4,0
7031,37,416,757,253,292,73,244,162,830,13,61,38,67,74,105,409,651,7,4654,258,0,2,10,1,0
7032,44,1069,1043,504,840,53,9,147,1096,9,180,112,198,189,310,1377,2344,4,11604,644,0,2,2,3,0
7033,44,1069,383,288,292,26,6,62,409,11,65,38,67,76,105,429,656,5,3719,206,0,2,2,3,0
7034,13,274,127,75,83,2,11,30,129,4,14,7,14,18,21,61,87,2,175,9,0,2,2,1,1
7035,13,274,652,304,544,16,6,88,668,6,89,51,101,95,152,591,998,3,3399,188,0,2,2,1,1
7036,13,274,2,2,2,0,0,0,2,0,0,0,0,0,0,0,0,0,0,0,0,2,2,1,1
7037,13,274,8,5,5,0,0,3,8,0,0,0,0,0,0,0,0,0,0,0,0,2,2,1,1
7040,13,274,14,8,8,0,0,6,14,0,0,0,0,0,0,0,0,0,0,0,0,2,2,1,1
7041,13,274,6,4,4,0,0,2,6,0,0,0,0,0,0,0,0,0,0,0,0,2,2,1,1
7042,13,274,6,4,4,0,0,2,6,1,2,1,2,3,3,2,4,0,2,0,0,2,2,1,1
7044,13,274,7,5,5,0,0,2,7,0,0,0,0,0,0,0,0,0,0,0,0,2,2,1,1
7046,13,274,10,6,6,0,0,4,10,0,0,0,0,0,0,0,0,0,0,0,0,2,2,1,1
7047,13,274,1,1,1,0,0,0,1,0,0,0,0,0,0,0,0,0,0,0,0,2,2,1,1
7049,13,274,14,10,10,0,0,4,14,1,1,1,1,2,2,0,2,0,1,0,0,2,2,1,1
7050,13,274,46,26,30,3,0,12,49,3,6,3,6,9,9,20,28,1,42,2,0,2,2,1,1
7051,37,418,757,253,292,73,244,162,830,13,61,38,67,74,105,409,651,7,4654,258,0,2,1,1,1
7052,37,416,757,253,292,73,244,162,830,13,61,38,67,74,105,409,651,7,4654,258,0,2,1,1,0
7076,33,376,757,253,292,73,244,162,830,13,61,38,67,74,105,409,651,7,4654,258,0,2,0,12,1
7077,34,385,757,253,292,73,244,162,830,13,61,38,67,74,105,409,651,7,4654,258,0,2,31,26,1
7078,44,1069,1043,504,840,53,9,147,1096,9,180,112,198,189,310,1377,2344,4,11604,644,0,2,1,0,1
7079,44,1069,383,288,292,26,6,62,409,11,65,38,67,76,105,429,656,5,3719,206,0,2,1,0,1
7080,42,733,373,158,315,8,0,51,381,5,76,44,79,81,123,486,779,2,2026,112,0,2,5,6,1
7081,6,419,1043,504,840,53,9,147,1096,9,180,112,198,189,310,1377,2344,4,11604,644,0,2,6,6,1
7082,23,1002,373,158,315,8,0,51,381,5,76,44,79,81,123,486,779,2,2026,112,0,2,3,3,1
7083,33,376,757,253,292,73,244,162,830,13,61,38,67,74,105,409,651,7,4654,258,0,2,7,13,0
7084,42,734,373,158,315,8,0,51,381,5,76,44,79,81,123,486,779,2,2026,112,0,2,5,4,0
7085,33,376,757,253,292,73,244,162,830,13,61,38,67,74,105,409,651,7,4654,258,0,2,8,9,1
7086,42,736,373,158,315,8,0,51,381,5,76,44,79,81,123,486,779,2,2026,112,0,2,1,1,1
7087,88,1958,1457,730,1242,11,6,188,1468,10,292,166,329,302,495,2424,4078,5,22973,1276,1,2,1,1,1
7088,88,1958,74,35,59,1,0,14,75,3,14,7,14,17,21,58,85,1,128,7,0,2,1,1,1
7089,88,1958,245,125,200,5,7,34,250,7,30,17,34,37,51,166,265,3,1053,58,0,2,1,1,1
7090,31,347,757,253,292,73,244,162,830,13,61,38,67,74,105,409,651,7,4654,258,0,2,3,13,1
7091,15,369,386,256,301,16,9,68,402,4,59,35,69,63,104,355,621,2,1453,80,0,2,1,1,0
7092,15,369,264,131,164,11,41,46,275,6,38,22,40,44,62,214,338,3,1068,59,0,2,1,1,0
7093,88,1960,1457,730,1242,11,6,188,1468,10,292,166,329,302,495,2424,4078,5,22973,1276,1,2,1,1,0
7094,88,1960,74,35,59,1,0,14,75,3,14,7,14,17,21,58,85,1,128,7,0,2,1,1,0
7095,88,1960,245,125,200,5,7,34,250,7,30,17,34,37,51,166,265,3,1053,58,0,2,1,1,0
7096,31,347,757,253,292,73,244,162,830,13,61,38,67,74,105,409,651,7,4654,258,0,2,2,1,0
7097,31,347,757,253,292,73,244,162,830,13,61,38,67,74,105,409,651,7,4654,258,0,2,32,25,0
7121,15,369,386,256,301,16,9,68,402,4,59,35,69,63,104,355,621,2,1453,80,0,2,4,4,1
7122,15,369,264,131,164,11,41,46,275,6,38,22,40,44,62,214,338,3,1068,59,0,2,4,4,1
7123,138,2382,1338,495,1086,10,64,173,1348,11,122,82,157,133,239,883,1686,7,11934,663,0,2,1,1,1
7124,88,1953,1457,730,1242,11,6,188,1468,10,292,166,329,302,495,2424,4078,5,22973,1276,1,2,11,12,1
7125,88,1953,74,35,59,1,0,14,75,3,14,7,14,17,21,58,85,1,128,7,0,2,11,12,1
7126,88,1953,245,125,200,5,7,34,250,7,30,17,34,37,51,166,265,3,1053,58,0,2,11,12,1
7127,42,736,373,158,315,8,0,51,381,5,76,44,79,81,123,486,779,2,2026,112,0,2,5,5,1
7128,42,2286,1457,730,1242,11,6,188,1468,10,292,166,329,302,495,2424,4078,5,22973,1276,1,2,1,1,1
7152,42,905,384,251,317,7,8,52,391,11,70,44,84,81,128,467,811,6,5355,297,0,3,8,2,0
7153,33,1623,384,251,317,7,8,52,391,11,70,44,84,81,128,467,811,6,5355,297,0,3,3,3,0
7154,42,906,384,251,317,7,8,52,391,11,70,44,84,81,128,467,811,6,5355,297,0,2,9,9,1
7155,31,347,757,253,292,73,244,162,830,13,61,38,67,74,105,409,651,7,4654,258,0,2,27,15,1
7156,42,924,384,251,317,7,8,52,391,11,70,44,84,81,128,467,811,6,5355,297,0,2,5,1,1
7157,33,1629,384,251,317,7,8,52,391,11,70,44,84,81,128,467,811,6,5355,297,0,2,49,49,1
7158,88,1953,1457,730,1242,11,6,188,1468,10,292,166,329,302,495,2424,4078,5,22973,1276,1,2,3,1,1
7159,88,1953,74,35,59,1,0,14,75,3,14,7,14,17,21,58,85,1,128,7,0,2,3,1,1
7160,88,1953,245,125,200,5,7,34,250,7,30,17,34,37,51,166,265,3,1053,58,0,2,3,1,1
7162,138,2380,1338,495,1086,10,64,173,1348,11,122,82,157,133,239,883,1686,7,11934,663,0,2,1,2,1
7163,31,352,757,253,292,73,244,162,830,13,61,38,67,74,105,409,651,7,4654,258,0,2,1,0,1
7164,42,944,384,251,317,7,8,52,391,11,70,44,84,81,128,467,811,6,5355,297,0,2,8,8,1
7165,30,1516,384,251,317,7,8,52,391,11,70,44,84,81,128,467,811,6,5355,297,0,2,1,18,1
7190,88,1947,1457,730,1242,11,6,188,1468,10,292,166,329,302,495,2424,4078,5,22973,1276,1,2,1,2,0
7191,88,1947,74,35,59,1,0,14,75,3,14,7,14,17,21,58,85,1,128,7,0,2,1,2,0
7192,88,1947,245,125,200,5,7,34,250,7,30,17,34,37,51,166,265,3,1053,58,0,2,1,2,0
7216,138,2382,1338,495,1086,10,64,173,1348,11,122,82,157,133,239,883,1686,7,11934,663,0,2,3,3,0
7217,88,1947,1457,730,1242,11,6,188,1468,10,292,166,329,302,495,2424,4078,5,22973,1276,1,2,1,1,0
7218,88,1947,74,35,59,1,0,14,75,3,14,7,14,17,21,58,85,1,128,7,0,2,1,1,0
7219,88,1947,245,125,200,5,7,34,250,7,30,17,34,37,51,166,265,3,1053,58,0,2,1,1,0
7222,20,481,2,2,2,0,0,0,2,0,0,0,0,0,0,0,0,0,0,0,0,2,131,40,1
7236,20,481,99,48,90,1,3,5,100,0,0,0,0,0,0,0,0,0,0,0,0,2,131,40,1
7237,20,481,8,5,5,2,0,1,10,0,0,0,0,0,0,0,0,0,0,0,0,2,131,40,1
7238,20,481,1217,716,841,84,126,174,1301,14,185,118,215,199,333,1446,2542,8,20687,1149,0,2,131,40,1
7239,20,481,160,89,115,0,13,31,160,7,15,11,17,22,28,78,124,3,495,27,0,2,131,40,1
7240,20,481,10,10,9,9,0,0,19,0,0,0,0,0,0,0,0,0,0,0,0,2,131,40,1
7241,20,481,173,84,99,8,29,36,181,5,12,7,13,17,20,54,81,2,221,12,0,2,131,40,1
7242,20,481,3,1,1,3,0,0,6,0,0,0,0,0,0,0,0,0,0,0,0,2,131,40,1
7245,45,1292,2,2,2,0,0,0,2,0,0,0,0,0,0,0,0,0,0,0,0,2,4,2,0
7259,45,1292,99,48,90,1,3,5,100,0,0,0,0,0,0,0,0,0,0,0,0,2,4,2,0
7260,45,1292,8,5,5,2,0,1,10,0,0,0,0,0,0,0,0,0,0,0,0,2,4,2,0
7261,45,1292,1217,716,841,84,126,174,1301,14,185,118,215,199,333,1446,2542,8,20687,1149,0,2,4,2,0
7262,45,1292,160,89,115,0,13,31,160,7,15,11,17,22,28,78,124,3,495,27,0,2,4,2,0
7263,45,1292,10,10,9,9,0,0,19,0,0,0,0,0,0,0,0,0,0,0,0,2,4,2,0
7264,45,1292,173,84,99,8,29,36,181,5,12,7,13,17,20,54,81,2,221,12,0,2,4,2,0
7265,45,1292,3,1,1,3,0,0,6,0,0,0,0,0,0,0,0,0,0,0,0,2,4,2,0
7289,1,312,42,7,35,4,0,5,46,1,2,1,2,3,3,2,4,0,2,0,0,2,12,14,1
7290,1,312,11,6,10,0,0,1,11,2,4,2,4,6,6,10,15,1,15,0,0,2,12,14,1
7291,27,522,334,251,279,10,4,40,344,5,127,74,143,132,217,899,1528,2,4303,239,0,2,2,2,0
7292,14,695,334,251,279,10,4,40,344,5,127,74,143,132,217,899,1528,2,4303,239,0,2,9,1,0
7334,2,32,127,75,83,2,11,30,129,4,14,7,14,18,21,61,87,2,175,9,0,0,10,0,1
7335,2,32,652,304,544,16,6,88,668,6,89,51,101,95,152,591,998,3,3399,188,0,0,10,0,1
7336,2,32,2,2,2,0,0,0,2,0,0,0,0,0,0,0,0,0,0,0,0,0,10,0,1
7337,2,32,8,5,5,0,0,3,8,0,0,0,0,0,0,0,0,0,0,0,0,0,10,0,1
7340,2,32,14,8,8,0,0,6,14,0,0,0,0,0,0,0,0,0,0,0,0,0,10,0,1
7341,2,32,6,4,4,0,0,2,6,0,0,0,0,0,0,0,0,0,0,0,0,0,10,0,1
7342,2,32,6,4,4,0,0,2,6,1,2,1,2,3,3,2,4,0,2,0,0,0,10,0,1
7344,2,32,7,5,5,0,0,2,7,0,0,0,0,0,0,0,0,0,0,0,0,0,10,0,1
7346,2,32,10,6,6,0,0,4,10,0,0,0,0,0,0,0,0,0,0,0,0,0,10,0,1
7347,2,32,1,1,1,0,0,0,1,0,0,0,0,0,0,0,0,0,0,0,0,0,10,0,1
7349,2,32,14,10,10,0,0,4,14,1,1,1,1,2,2,0,2,0,1,0,0,0,10,0,1
7350,2,32,46,26,30,3,0,12,49,3,6,3,6,9,9,20,28,1,42,2,0,0,10,0,1
7351,42,953,384,251,317,7,8,52,391,11,70,44,84,81,128,467,811,6,5355,297,0,2,2,2,1
7352,13,274,127,75,83,2,11,30,129,4,14,7,14,18,21,61,87,2,175,9,0,2,4,4,1
7353,13,274,652,304,544,16,6,88,668,6,89,51,101,95,152,591,998,3,3399,188,0,2,4,4,1
7354,13,274,2,2,2,0,0,0,2,0,0,0,0,0,0,0,0,0,0,0,0,2,4,4,1
7355,13,274,8,5,5,0,0,3,8,0,0,0,0,0,0,0,0,0,0,0,0,2,4,4,1
7358,13,274,14,8,8,0,0,6,14,0,0,0,0,0,0,0,0,0,0,0,0,2,4,4,1
7359,13,274,6,4,4,0,0,2,6,0,0,0,0,0,0,0,0,0,0,0,0,2,4,4,1
7360,13,274,6,4,4,0,0,2,6,1,2,1,2,3,3,2,4,0,2,0,0,2,4,4,1
7362,13,274,7,5,5,0,0,2,7,0,0,0,0,0,0,0,0,0,0,0,0,2,4,4,1
7364,13,274,10,6,6,0,0,4,10,0,0,0,0,0,0,0,0,0,0,0,0,2,4,4,1
7365,13,274,1,1,1,0,0,0,1,0,0,0,0,0,0,0,0,0,0,0,0,2,4,4,1
7367,13,274,14,10,10,0,0,4,14,1,1,1,1,2,2,0,2,0,1,0,0,2,4,4,1
7368,13,274,46,26,30,3,0,12,49,3,6,3,6,9,9,20,28,1,42,2,0,2,4,4,1
7369,42,955,384,251,317,7,8,52,391,11,70,44,84,81,128,467,811,6,5355,297,0,2,1,0,1
7387,2,32,127,75,83,2,11,30,129,4,14,7,14,18,21,61,87,2,175,9,0,0,10,0,0
7388,2,32,652,304,544,16,6,88,668,6,89,51,101,95,152,591,998,3,3399,188,0,0,10,0,0
7389,2,32,2,2,2,0,0,0,2,0,0,0,0,0,0,0,0,0,0,0,0,0,10,0,0
7390,2,32,8,5,5,0,0,3,8,0,0,0,0,0,0,0,0,0,0,0,0,0,10,0,0
7393,2,32,14,8,8,0,0,6,14,0,0,0,0,0,0,0,0,0,0,0,0,0,10,0,0
7394,2,32,6,4,4,0,0,2,6,0,0,0,0,0,0,0,0,0,0,0,0,0,10,0,0
7395,2,32,6,4,4,0,0,2,6,1,2,1,2,3,3,2,4,0,2,0,0,0,10,0,0
7397,2,32,7,5,5,0,0,2,7,0,0,0,0,0,0,0,0,0,0,0,0,0,10,0,0
7399,2,32,10,6,6,0,0,4,10,0,0,0,0,0,0,0,0,0,0,0,0,0,10,0,0
7400,2,32,1,1,1,0,0,0,1,0,0,0,0,0,0,0,0,0,0,0,0,0,10,0,0
7402,2,32,14,10,10,0,0,4,14,1,1,1,1,2,2,0,2,0,1,0,0,0,10,0,0
7403,2,32,46,26,30,3,0,12,49,3,6,3,6,9,9,20,28,1,42,2,0,0,10,0,0
7404,13,274,127,75,83,2,11,30,129,4,14,7,14,18,21,61,87,2,175,9,0,2,4,4,0
7405,13,274,652,304,544,16,6,88,668,6,89,51,101,95,152,591,998,3,3399,188,0,2,4,4,0
7406,13,274,2,2,2,0,0,0,2,0,0,0,0,0,0,0,0,0,0,0,0,2,4,4,0
7407,13,274,8,5,5,0,0,3,8,0,0,0,0,0,0,0,0,0,0,0,0,2,4,4,0
7410,13,274,14,8,8,0,0,6,14,0,0,0,0,0,0,0,0,0,0,0,0,2,4,4,0
7411,13,274,6,4,4,0,0,2,6,0,0,0,0,0,0,0,0,0,0,0,0,2,4,4,0
7412,13,274,6,4,4,0,0,2,6,1,2,1,2,3,3,2,4,0,2,0,0,2,4,4,0
7414,13,274,7,5,5,0,0,2,7,0,0,0,0,0,0,0,0,0,0,0,0,2,4,4,0
7416,13,274,10,6,6,0,0,4,10,0,0,0,0,0,0,0,0,0,0,0,0,2,4,4,0
7417,13,274,1,1,1,0,0,0,1,0,0,0,0,0,0,0,0,0,0,0,0,2,4,4,0
7419,13,274,14,10,10,0,0,4,14,1,1,1,1,2,2,0,2,0,1,0,0,2,4,4,0
7420,13,274,46,26,30,3,0,12,49,3,6,3,6,9,9,20,28,1,42,2,0,2,4,4,0
7421,42,955,384,251,317,7,8,52,391,11,70,44,84,81,128,467,811,6,5355,297,0,2,3,2,0
7439,1,312,42,7,35,4,0,5,46,1,2,1,2,3,3,2,4,0,2,0,0,2,1,1,0
7440,1,312,11,6,10,0,0,1,11,2,4,2,4,6,6,10,15,1,15,0,0,2,1,1,0
7441,1,312,42,7,35,4,0,5,46,1,2,1,2,3,3,2,4,0,2,0,0,2,1,1,1
7442,1,312,11,6,10,0,0,1,11,2,4,2,4,6,6,10,15,1,15,0,0,2,1,1,1
7443,30,339,757,253,292,73,244,162,830,13,61,38,67,74,105,409,651,7,4654,258,0,2,0,3,0
7445,44,1063,1043,504,840,53,9,147,1096,9,180,112,198,189,310,1377,2344,4,11604,644,0,2,0,2,0
7446,44,1063,383,288,292,26,6,62,409,11,65,38,67,76,105,429,656,5,3719,206,0,2,0,2,0
7447,30,344,757,253,292,73,244,162,830,13,61,38,67,74,105,409,651,7,4654,258,0,2,1,0,0
7450,18,462,2,2,2,0,0,0,2,0,0,0,0,0,0,0,0,0,0,0,0,2,7,12,0
7464,18,462,99,48,90,1,3,5,100,0,0,0,0,0,0,0,0,0,0,0,0,2,7,12,0
7465,18,462,8,5,5,2,0,1,10,0,0,0,0,0,0,0,0,0,0,0,0,2,7,12,0
7466,18,462,1217,716,841,84,126,174,1301,14,185,118,215,199,333,1446,2542,8,20687,1149,0,2,7,12,0
7467,18,462,160,89,115,0,13,31,160,7,15,11,17,22,28,78,124,3,495,27,0,2,7,12,0
7468,18,462,10,10,9,9,0,0,19,0,0,0,0,0,0,0,0,0,0,0,0,2,7,12,0
7469,18,462,173,84,99,8,29,36,181,5,12,7,13,17,20,54,81,2,221,12,0,2,7,12,0
7470,18,462,3,1,1,3,0,0,6,0,0,0,0,0,0,0,0,0,0,0,0,2,7,12,0
7471,88,1955,1457,730,1242,11,6,188,1468,10,292,166,329,302,495,2424,4078,5,22973,1276,1,2,1,0,1
7472,88,1955,74,35,59,1,0,14,75,3,14,7,14,17,21,58,85,1,128,7,0,2,1,0,1
7473,88,1955,245,125,200,5,7,34,250,7,30,17,34,37,51,166,265,3,1053,58,0,2,1,0,1
7474,45,990,384,251,317,7,8,52,391,11,70,44,84,81,128,467,811,6,5355,297,0,2,5,0,1
7475,34,1864,1289,550,1043,56,32,155,1345,10,167,93,185,177,278,1266,2075,5,11498,638,0,2,17,0,1
7476,31,1539,384,251,317,7,8,52,391,11,70,44,84,81,128,467,811,6,5355,297,0,2,6,0,1
7477,7,97,127,75,83,2,11,30,129,4,14,7,14,18,21,61,87,2,175,9,0,0,22,0,1
7478,7,97,652,304,544,16,6,88,668,6,89,51,101,95,152,591,998,3,3399,188,0,0,22,0,1
7479,7,97,2,2,2,0,0,0,2,0,0,0,0,0,0,0,0,0,0,0,0,0,22,0,1
7480,7,97,8,5,5,0,0,3,8,0,0,0,0,0,0,0,0,0,0,0,0,0,22,0,1
7483,7,97,14,8,8,0,0,6,14,0,0,0,0,0,0,0,0,0,0,0,0,0,22,0,1
7484,7,97,6,4,4,0,0,2,6,0,0,0,0,0,0,0,0,0,0,0,0,0,22,0,1
7485,7,97,6,4,4,0,0,2,6,1,2,1,2,3,3,2,4,0,2,0,0,0,22,0,1
7487,7,97,7,5,5,0,0,2,7,0,0,0,0,0,0,0,0,0,0,0,0,0,22,0,1
7489,7,97,10,6,6,0,0,4,10,0,0,0,0,0,0,0,0,0,0,0,0,0,22,0,1
7490,7,97,1,1,1,0,0,0,1,0,0,0,0,0,0,0,0,0,0,0,0,0,22,0,1
7492,7,97,14,10,10,0,0,4,14,1,1,1,1,2,2,0,2,0,1,0,0,0,22,0,1
7493,7,97,46,26,30,3,0,12,49,3,6,3,6,9,9,20,28,1,42,2,0,0,22,0,1
7511,138,2407,1338,495,1086,10,64,173,1348,11,122,82,157,133,239,883,1686,7,11934,663,0,2,10,11,1
7512,123,2176,1338,495,1086,10,64,173,1348,11,122,82,157,133,239,883,1686,7,11934,663,0,2,6,42,1
7513,45,1069,1043,504,840,53,9,147,1096,9,180,112,198,189,310,1377,2344,4,11604,644,0,2,2,1,0
7514,45,1069,383,288,292,26,6,62,409,11,65,38,67,76,105,429,656,5,3719,206,0,2,2,1,0
7515,13,269,127,75,83,2,11,30,129,4,14,7,14,18,21,61,87,2,175,9,0,2,0,1,0
7516,13,269,652,304,544,16,6,88,668,6,89,51,101,95,152,591,998,3,3399,188,0,2,0,1,0
7517,13,269,2,2,2,0,0,0,2,0,0,0,0,0,0,0,0,0,0,0,0,2,0,1,0
7518,13,269,8,5,5,0,0,3,8,0,0,0,0,0,0,0,0,0,0,0,0,2,0,1,0
7521,13,269,14,8,8,0,0,6,14,0,0,0,0,0,0,0,0,0,0,0,0,2,0,1,0
7522,13,269,6,4,4,0,0,2,6,0,0,0,0,0,0,0,0,0,0,0,0,2,0,1,0
7523,13,269,6,4,4,0,0,2,6,1,2,1,2,3,3,2,4,0,2,0,0,2,0,1,0
7525,13,269,7,5,5,0,0,2,7,0,0,0,0,0,0,0,0,0,0,0,0,2,0,1,0
7527,13,269,10,6,6,0,0,4,10,0,0,0,0,0,0,0,0,0,0,0,0,2,0,1,0
7528,13,269,1,1,1,0,0,0,1,0,0,0,0,0,0,0,0,0,0,0,0,2,0,1,0
7530,13,269,14,10,10,0,0,4,14,1,1,1,1,2,2,0,2,0,1,0,0,2,0,1,0
7531,13,269,46,26,30,3,0,12,49,3,6,3,6,9,9,20,28,1,42,2,0,2,0,1,0
7532,30,1650,1289,550,1043,56,32,155,1345,10,167,93,185,177,278,1266,2075,5,11498,638,0,2,2,23,1
7533,124,2190,1338,495,1086,10,64,173,1348,11,122,82,157,133,239,883,1686,7,11934,663,0,2,2,0,1
7557,124,2190,1338,495,1086,10,64,173,1348,11,122,82,157,133,239,883,1686,7,11934,663,0,2,3,3,1
7558,88,1955,1457,730,1242,11,6,188,1468,10,292,166,329,302,495,2424,4078,5,22973,1276,1,2,2,2,1
7559,88,1955,74,35,59,1,0,14,75,3,14,7,14,17,21,58,85,1,128,7,0,2,2,2,1
7560,88,1955,245,125,200,5,7,34,250,7,30,17,34,37,51,166,265,3,1053,58,0,2,2,2,1
7561,45,990,384,251,317,7,8,52,391,11,70,44,84,81,128,467,811,6,5355,297,0,2,7,7,1
7562,45,1069,1043,504,840,53,9,147,1096,9,180,112,198,189,310,1377,2344,4,11604,644,0,2,1,1,1
7563,45,1069,383,288,292,26,6,62,409,11,65,38,67,76,105,429,656,5,3719,206,0,2,1,1,1
7564,42,736,373,158,315,8,0,51,381,5,76,44,79,81,123,486,779,2,2026,112,0,2,6,6,1
7565,31,1539,384,251,317,7,8,52,391,11,70,44,84,81,128,467,811,6,5355,297,0,2,1,1,1
7589,31,1517,384,251,317,7,8,52,391,11,70,44,84,81,128,467,811,6,5355,297,0,2,0,2,1
7590,30,344,757,253,292,73,244,162,830,13,61,38,67,74,105,409,651,7,4654,258,0,2,2,2,0
7591,31,353,757,253,292,73,244,162,830,13,61,38,67,74,105,409,651,7,4654,258,0,2,3,1,1
7592,31,353,757,253,292,73,244,162,830,13,61,38,67,74,105,409,651,7,4654,258,0,2,1,1,1
7593,75,1630,773,419,590,28,0,166,801,10,204,113,217,214,330,1598,2554,5,13587,754,0,2,20,0,1
7594,75,1630,421,273,302,44,34,57,465,17,81,59,107,98,166,583,1098,11,12329,684,0,2,20,0,1
7595,53,1808,773,419,590,28,0,166,801,10,204,113,217,214,330,1598,2554,5,13587,754,0,2,20,0,1
7596,54,1831,773,419,590,28,0,166,801,10,204,113,217,214,330,1598,2554,5,13587,754,0,2,6,2,1
7620,45,1069,1043,504,840,53,9,147,1096,9,180,112,198,189,310,1377,2344,4,11604,644,0,2,1,1,0
7621,45,1069,383,288,292,26,6,62,409,11,65,38,67,76,105,429,656,5,3719,206,0,2,1,1,0
7622,32,362,757,253,292,73,244,162,830,13,61,38,67,74,105,409,651,7,4654,258,0,2,5,0,0
7623,54,1827,773,419,590,28,0,166,801,10,204,113,217,214,330,1598,2554,5,13587,754,0,2,1,1,0
7624,124,2190,1338,495,1086,10,64,173,1348,11,122,82,157,133,239,883,1686,7,11934,663,0,2,1,1,1
7625,32,367,757,253,292,73,244,162,830,13,61,38,67,74,105,409,651,7,4654,258,0,2,6,5,1
7649,75,1630,773,419,590,28,0,166,801,10,204,113,217,214,330,1598,2554,5,13587,754,0,2,20,0,0
7650,75,1630,421,273,302,44,34,57,465,17,81,59,107,98,166,583,1098,11,12329,684,0,2,20,0,0
7651,54,1827,773,419,590,28,0,166,801,10,204,113,217,214,330,1598,2554,5,13587,754,0,2,24,0,0
7652,124,2190,1338,495,1086,10,64,173,1348,11,122,82,157,133,239,883,1686,7,11934,663,0,2,1,1,0
7653,32,367,757,253,292,73,244,162,830,13,61,38,67,74,105,409,651,7,4654,258,0,2,6,0,0
7656,32,367,757,253,292,73,244,162,830,13,61,38,67,74,105,409,651,7,4654,258,0,2,1,1,1
7657,7,97,127,75,83,2,11,30,129,4,14,7,14,18,21,61,87,2,175,9,0,3,2,2,1
7658,7,97,652,304,544,16,6,88,668,6,89,51,101,95,152,591,998,3,3399,188,0,3,2,2,1
7659,7,97,2,2,2,0,0,0,2,0,0,0,0,0,0,0,0,0,0,0,0,3,2,2,1
7660,7,97,8,5,5,0,0,3,8,0,0,0,0,0,0,0,0,0,0,0,0,3,2,2,1
7663,7,97,14,8,8,0,0,6,14,0,0,0,0,0,0,0,0,0,0,0,0,3,2,2,1
7664,7,97,6,4,4,0,0,2,6,0,0,0,0,0,0,0,0,0,0,0,0,3,2,2,1
7665,7,97,6,4,4,0,0,2,6,1,2,1,2,3,3,2,4,0,2,0,0,3,2,2,1
7667,7,97,7,5,5,0,0,2,7,0,0,0,0,0,0,0,0,0,0,0,0,3,2,2,1
7669,7,97,10,6,6,0,0,4,10,0,0,0,0,0,0,0,0,0,0,0,0,3,2,2,1
7670,7,97,1,1,1,0,0,0,1,0,0,0,0,0,0,0,0,0,0,0,0,3,2,2,1
7672,7,97,14,10,10,0,0,4,14,1,1,1,1,2,2,0,2,0,1,0,0,3,2,2,1
7673,7,97,46,26,30,3,0,12,49,3,6,3,6,9,9,20,28,1,42,2,0,3,2,2,1
7697,3,48,127,75,83,2,11,30,129,4,14,7,14,18,21,61,87,2,175,9,0,2,3,1,1
7698,3,48,652,304,544,16,6,88,668,6,89,51,101,95,152,591,998,3,3399,188,0,2,3,1,1
7699,3,48,2,2,2,0,0,0,2,0,0,0,0,0,0,0,0,0,0,0,0,2,3,1,1
7700,3,48,8,5,5,0,0,3,8,0,0,0,0,0,0,0,0,0,0,0,0,2,3,1,1
7703,3,48,14,8,8,0,0,6,14,0,0,0,0,0,0,0,0,0,0,0,0,2,3,1,1
7704,3,48,6,4,4,0,0,2,6,0,0,0,0,0,0,0,0,0,0,0,0,2,3,1,1
7705,3,48,6,4,4,0,0,2,6,1,2,1,2,3,3,2,4,0,2,0,0,2,3,1,1
7707,3,48,7,5,5,0,0,2,7,0,0,0,0,0,0,0,0,0,0,0,0,2,3,1,1
7709,3,48,10,6,6,0,0,4,10,0,0,0,0,0,0,0,0,0,0,0,0,2,3,1,1
7710,3,48,1,1,1,0,0,0,1,0,0,0,0,0,0,0,0,0,0,0,0,2,3,1,1
7712,3,48,14,10,10,0,0,4,14,1,1,1,1,2,2,0,2,0,1,0,0,2,3,1,1
7713,3,48,46,26,30,3,0,12,49,3,6,3,6,9,9,20,28,1,42,2,0,2,3,1,1
7737,6,113,127,75,83,2,11,30,129,4,14,7,14,18,21,61,87,2,175,9,0,0,25,0,1
7738,6,113,652,304,544,16,6,88,668,6,89,51,101,95,152,591,998,3,3399,188,0,0,25,0,1
7739,6,113,2,2,2,0,0,0,2,0,0,0,0,0,0,0,0,0,0,0,0,0,25,0,1
7740,6,113,8,5,5,0,0,3,8,0,0,0,0,0,0,0,0,0,0,0,0,0,25,0,1
7743,6,113,14,8,8,0,0,6,14,0,0,0,0,0,0,0,0,0,0,0,0,0,25,0,1
7744,6,113,6,4,4,0,0,2,6,0,0,0,0,0,0,0,0,0,0,0,0,0,25,0,1
7745,6,113,6,4,4,0,0,2,6,1,2,1,2,3,3,2,4,0,2,0,0,0,25,0,1
7747,6,113,7,5,5,0,0,2,7,0,0,0,0,0,0,0,0,0,0,0,0,0,25,0,1
7749,6,113,10,6,6,0,0,4,10,0,0,0,0,0,0,0,0,0,0,0,0,0,25,0,1
7750,6,113,1,1,1,0,0,0,1,0,0,0,0,0,0,0,0,0,0,0,0,0,25,0,1
7752,6,113,14,10,10,0,0,4,14,1,1,1,1,2,2,0,2,0,1,0,0,0,25,0,1
7753,6,113,46,26,30,3,0,12,49,3,6,3,6,9,9,20,28,1,42,2,0,0,25,0,1
7754,2,32,127,75,83,2,11,30,129,4,14,7,14,18,21,61,87,2,175,9,0,2,1,3,1
7755,2,32,652,304,544,16,6,88,668,6,89,51,101,95,152,591,998,3,3399,188,0,2,1,3,1
7756,2,32,2,2,2,0,0,0,2,0,0,0,0,0,0,0,0,0,0,0,0,2,1,3,1
7757,2,32,8,5,5,0,0,3,8,0,0,0,0,0,0,0,0,0,0,0,0,2,1,3,1
7760,2,32,14,8,8,0,0,6,14,0,0,0,0,0,0,0,0,0,0,0,0,2,1,3,1
7761,2,32,6,4,4,0,0,2,6,0,0,0,0,0,0,0,0,0,0,0,0,2,1,3,1
7762,2,32,6,4,4,0,0,2,6,1,2,1,2,3,3,2,4,0,2,0,0,2,1,3,1
7764,2,32,7,5,5,0,0,2,7,0,0,0,0,0,0,0,0,0,0,0,0,2,1,3,1
7766,2,32,10,6,6,0,0,4,10,0,0,0,0,0,0,0,0,0,0,0,0,2,1,3,1
7767,2,32,1,1,1,0,0,0,1,0,0,0,0,0,0,0,0,0,0,0,0,2,1,3,1
7769,2,32,14,10,10,0,0,4,14,1,1,1,1,2,2,0,2,0,1,0,0,2,1,3,1
7770,2,32,46,26,30,3,0,12,49,3,6,3,6,9,9,20,28,1,42,2,0,2,1,3,1
7771,49,1165,1043,504,840,53,9,147,1096,9,180,112,198,189,310,1377,2344,4,11604,644,0,2,19,3,1
7772,49,1165,383,288,292,26,6,62,409,11,65,38,67,76,105,429,656,5,3719,206,0,2,19,3,1
7773,7,469,1043,504,840,53,9,147,1096,9,180,112,198,189,310,1377,2344,4,11604,644,0,2,10,0,1
7774,13,257,127,75,83,2,11,30,129,4,14,7,14,18,21,61,87,2,175,9,0,2,15,17,1
7775,13,257,652,304,544,16,6,88,668,6,89,51,101,95,152,591,998,3,3399,188,0,2,15,17,1
7776,13,257,2,2,2,0,0,0,2,0,0,0,0,0,0,0,0,0,0,0,0,2,15,17,1
7777,13,257,8,5,5,0,0,3,8,0,0,0,0,0,0,0,0,0,0,0,0,2,15,17,1
7780,13,257,14,8,8,0,0,6,14,0,0,0,0,0,0,0,0,0,0,0,0,2,15,17,1
7781,13,257,6,4,4,0,0,2,6,0,0,0,0,0,0,0,0,0,0,0,0,2,15,17,1
7782,13,257,6,4,4,0,0,2,6,1,2,1,2,3,3,2,4,0,2,0,0,2,15,17,1
7784,13,257,7,5,5,0,0,2,7,0,0,0,0,0,0,0,0,0,0,0,0,2,15,17,1
7786,13,257,10,6,6,0,0,4,10,0,0,0,0,0,0,0,0,0,0,0,0,2,15,17,1
7787,13,257,1,1,1,0,0,0,1,0,0,0,0,0,0,0,0,0,0,0,0,2,15,17,1
7789,13,257,14,10,10,0,0,4,14,1,1,1,1,2,2,0,2,0,1,0,0,2,15,17,1
7790,13,257,46,26,30,3,0,12,49,3,6,3,6,9,9,20,28,1,42,2,0,2,15,17,1
7791,5,100,127,75,83,2,11,30,129,4,14,7,14,18,21,61,87,2,175,9,0,2,19,5,1
7792,5,100,652,304,544,16,6,88,668,6,89,51,101,95,152,591,998,3,3399,188,0,2,19,5,1
7793,5,100,2,2,2,0,0,0,2,0,0,0,0,0,0,0,0,0,0,0,0,2,19,5,1
7794,5,100,8,5,5,0,0,3,8,0,0,0,0,0,0,0,0,0,0,0,0,2,19,5,1
7797,5,100,14,8,8,0,0,6,14,0,0,0,0,0,0,0,0,0,0,0,0,2,19,5,1
7798,5,100,6,4,4,0,0,2,6,0,0,0,0,0,0,0,0,0,0,0,0,2,19,5,1
7799,5,100,6,4,4,0,0,2,6,1,2,1,2,3,3,2,4,0,2,0,0,2,19,5,1
7801,5,100,7,5,5,0,0,2,7,0,0,0,0,0,0,0,0,0,0,0,0,2,19,5,1
7803,5,100,10,6,6,0,0,4,10,0,0,0,0,0,0,0,0,0,0,0,0,2,19,5,1
7804,5,100,1,1,1,0,0,0,1,0,0,0,0,0,0,0,0,0,0,0,0,2,19,5,1
7806,5,100,14,10,10,0,0,4,14,1,1,1,1,2,2,0,2,0,1,0,0,2,19,5,1
7807,5,100,46,26,30,3,0,12,49,3,6,3,6,9,9,20,28,1,42,2,0,2,19,5,1
7808,49,1034,384,251,317,7,8,52,391,11,70,44,84,81,128,467,811,6,5355,297,0,2,29,24,1
7809,30,1650,1289,550,1043,56,32,155,1345,10,167,93,185,177,278,1266,2075,5,11498,638,0,2,4,6,1
7810,25,1340,384,251,317,7,8,52,391,11,70,44,84,81,128,467,811,6,5355,297,0,2,21,50,1
7811,127,2219,1338,495,1086,10,64,173,1348,11,122,82,157,133,239,883,1686,7,11934,663,0,2,6,0,0
7812,124,2168,1338,495,1086,10,64,173,1348,11,122,82,157,133,239,883,1686,7,11934,663,0,2,0,10,1
7813,124,2168,1338,495,1086,10,64,173,1348,11,122,82,157,133,239,883,1686,7,11934,663,0,2,6,10,0
7814,50,1088,384,251,317,7,8,52,391,11,70,44,84,81,128,467,811,6,5355,297,0,2,18,10,1
7815,26,1428,384,251,317,7,8,52,391,11,70,44,84,81,128,467,811,6,5355,297,0,2,15,2,1
7816,7,469,1043,504,840,53,9,147,1096,9,180,112,198,189,310,1377,2344,4,11604,644,0,2,12,12,1
7817,23,1002,373,158,315,8,0,51,381,5,76,44,79,81,123,486,779,2,2026,112,0,2,6,6,1
7818,32,372,757,253,292,73,244,162,830,13,61,38,67,74,105,409,651,7,4654,258,0,2,1,0,0
7819,49,1061,384,251,317,7,8,52,391,11,70,44,84,81,128,467,811,6,5355,297,0,2,1,4,0
7820,22,1316,384,251,317,7,8,52,391,11,70,44,84,81,128,467,811,6,5355,297,0,2,0,20,0
7821,5,108,127,75,83,2,11,30,129,4,14,7,14,18,21,61,87,2,175,9,0,2,1,0,1
7822,5,108,652,304,544,16,6,88,668,6,89,51,101,95,152,591,998,3,3399,188,0,2,1,0,1
7823,5,108,2,2,2,0,0,0,2,0,0,0,0,0,0,0,0,0,0,0,0,2,1,0,1
7824,5,108,8,5,5,0,0,3,8,0,0,0,0,0,0,0,0,0,0,0,0,2,1,0,1
7827,5,108,14,8,8,0,0,6,14,0,0,0,0,0,0,0,0,0,0,0,0,2,1,0,1
7828,5,108,6,4,4,0,0,2,6,0,0,0,0,0,0,0,0,0,0,0,0,2,1,0,1
7829,5,108,6,4,4,0,0,2,6,1,2,1,2,3,3,2,4,0,2,0,0,2,1,0,1
7831,5,108,7,5,5,0,0,2,7,0,0,0,0,0,0,0,0,0,0,0,0,2,1,0,1
7833,5,108,10,6,6,0,0,4,10,0,0,0,0,0,0,0,0,0,0,0,0,2,1,0,1
7834,5,108,1,1,1,0,0,0,1,0,0,0,0,0,0,0,0,0,0,0,0,2,1,0,1
7836,5,108,14,10,10,0,0,4,14,1,1,1,1,2,2,0,2,0,1,0,0,2,1,0,1
7837,5,108,46,26,30,3,0,12,49,3,6,3,6,9,9,20,28,1,42,2,0,2,1,0,1
7838,14,695,334,251,279,10,4,40,344,5,127,74,143,132,217,899,1528,2,4303,239,0,2,2,2,1
7839,42,2286,1457,730,1242,11,6,188,1468,10,292,166,329,302,495,2424,4078,5,22973,1276,1,2,2,2,1
7840,22,1316,384,251,317,7,8,52,391,11,70,44,84,81,128,467,811,6,5355,297,0,2,3,3,1
7841,23,1002,373,158,315,8,0,51,381,5,76,44,79,81,123,486,779,2,2026,112,0,2,29,29,1
7842,3,67,127,75,83,2,11,30,129,4,14,7,14,18,21,61,87,2,175,9,0,2,6,12,1
7843,3,67,652,304,544,16,6,88,668,6,89,51,101,95,152,591,998,3,3399,188,0,2,6,12,1
7844,3,67,2,2,2,0,0,0,2,0,0,0,0,0,0,0,0,0,0,0,0,2,6,12,1
7845,3,67,8,5,5,0,0,3,8,0,0,0,0,0,0,0,0,0,0,0,0,2,6,12,1
7848,3,67,14,8,8,0,0,6,14,0,0,0,0,0,0,0,0,0,0,0,0,2,6,12,1
7849,3,67,6,4,4,0,0,2,6,0,0,0,0,0,0,0,0,0,0,0,0,2,6,12,1
7850,3,67,6,4,4,0,0,2,6,1,2,1,2,3,3,2,4,0,2,0,0,2,6,12,1
7852,3,67,7,5,5,0,0,2,7,0,0,0,0,0,0,0,0,0,0,0,0,2,6,12,1
7854,3,67,10,6,6,0,0,4,10,0,0,0,0,0,0,0,0,0,0,0,0,2,6,12,1
7855,3,67,1,1,1,0,0,0,1,0,0,0,0,0,0,0,0,0,0,0,0,2,6,12,1
7857,3,67,14,10,10,0,0,4,14,1,1,1,1,2,2,0,2,0,1,0,0,2,6,12,1
7858,3,67,46,26,30,3,0,12,49,3,6,3,6,9,9,20,28,1,42,2,0,2,6,12,1
7859,2,27,127,75,83,2,11,30,129,4,14,7,14,18,21,61,87,2,175,9,0,2,2,3,1
7860,2,27,652,304,544,16,6,88,668,6,89,51,101,95,152,591,998,3,3399,188,0,2,2,3,1
7861,2,27,2,2,2,0,0,0,2,0,0,0,0,0,0,0,0,0,0,0,0,2,2,3,1
7862,2,27,8,5,5,0,0,3,8,0,0,0,0,0,0,0,0,0,0,0,0,2,2,3,1
7865,2,27,14,8,8,0,0,6,14,0,0,0,0,0,0,0,0,0,0,0,0,2,2,3,1
7866,2,27,6,4,4,0,0,2,6,0,0,0,0,0,0,0,0,0,0,0,0,2,2,3,1
7867,2,27,6,4,4,0,0,2,6,1,2,1,2,3,3,2,4,0,2,0,0,2,2,3,1
7869,2,27,7,5,5,0,0,2,7,0,0,0,0,0,0,0,0,0,0,0,0,2,2,3,1
7871,2,27,10,6,6,0,0,4,10,0,0,0,0,0,0,0,0,0,0,0,0,2,2,3,1
7872,2,27,1,1,1,0,0,0,1,0,0,0,0,0,0,0,0,0,0,0,0,2,2,3,1
7874,2,27,14,10,10,0,0,4,14,1,1,1,1,2,2,0,2,0,1,0,0,2,2,3,1
7875,2,27,46,26,30,3,0,12,49,3,6,3,6,9,9,20,28,1,42,2,0,2,2,3,1
7876,6,106,127,75,83,2,11,30,129,4,14,7,14,18,21,61,87,2,175,9,0,2,5,6,1
7877,6,106,652,304,544,16,6,88,668,6,89,51,101,95,152,591,998,3,3399,188,0,2,5,6,1
7878,6,106,2,2,2,0,0,0,2,0,0,0,0,0,0,0,0,0,0,0,0,2,5,6,1
7879,6,106,8,5,5,0,0,3,8,0,0,0,0,0,0,0,0,0,0,0,0,2,5,6,1
7882,6,106,14,8,8,0,0,6,14,0,0,0,0,0,0,0,0,0,0,0,0,2,5,6,1
7883,6,106,6,4,4,0,0,2,6,0,0,0,0,0,0,0,0,0,0,0,0,2,5,6,1
7884,6,106,6,4,4,0,0,2,6,1,2,1,2,3,3,2,4,0,2,0,0,2,5,6,1
7886,6,106,7,5,5,0,0,2,7,0,0,0,0,0,0,0,0,0,0,0,0,2,5,6,1
7888,6,106,10,6,6,0,0,4,10,0,0,0,0,0,0,0,0,0,0,0,0,2,5,6,1
7889,6,106,1,1,1,0,0,0,1,0,0,0,0,0,0,0,0,0,0,0,0,2,5,6,1
7891,6,106,14,10,10,0,0,4,14,1,1,1,1,2,2,0,2,0,1,0,0,2,5,6,1
7892,6,106,46,26,30,3,0,12,49,3,6,3,6,9,9,20,28,1,42,2,0,2,5,6,1
7893,2,80,13,10,10,0,0,3,13,1,2,1,2,3,3,2,4,0,2,0,0,2,3,3,1
7894,51,1169,1043,504,840,53,9,147,1096,9,180,112,198,189,310,1377,2344,4,11604,644,0,2,17,10,1
7895,51,1169,383,288,292,26,6,62,409,11,65,38,67,76,105,429,656,5,3719,206,0,2,17,10,1
7896,8,544,1043,504,840,53,9,147,1096,9,180,112,198,189,310,1377,2344,4,11604,644,0,2,17,1,1
7920,1,306,42,7,35,4,0,5,46,1,2,1,2,3,3,2,4,0,2,0,0,2,3,4,0
7921,1,306,11,6,10,0,0,1,11,2,4,2,4,6,6,10,15,1,15,0,0,2,3,4,0
7991,51,1158,1043,504,840,53,9,147,1096,9,180,112,198,189,310,1377,2344,4,11604,644,0,2,5,5,0
7992,51,1158,383,288,292,26,6,62,409,11,65,38,67,76,105,429,656,5,3719,206,0,2,5,5,0
7993,32,372,757,253,292,73,244,162,830,13,61,38,67,74,105,409,651,7,4654,258,0,2,2,1,1
7994,48,1080,1043,504,840,53,9,147,1096,9,180,112,198,189,310,1377,2344,4,11604,644,0,2,26,42,1
7995,48,1080,383,288,292,26,6,62,409,11,65,38,67,76,105,429,656,5,3719,206,0,2,26,42,1
7996,26,913,1043,504,840,53,9,147,1096,9,180,112,198,189,310,1377,2344,4,11604,644,0,2,244,73,1
7998,51,1155,1043,504,840,53,9,147,1096,9,180,112,198,189,310,1377,2344,4,11604,644,0,2,27,21,1
7999,51,1155,383,288,292,26,6,62,409,11,65,38,67,76,105,429,656,5,3719,206,0,2,27,21,1
8000,30,350,757,253,292,73,244,162,830,13,61,38,67,74,105,409,651,7,4654,258,0,2,7,13,1
8001,49,1053,384,251,317,7,8,52,391,11,70,44,84,81,128,467,811,6,5355,297,0,2,2,2,1
8002,49,1106,1043,504,840,53,9,147,1096,9,180,112,198,189,310,1377,2344,4,11604,644,0,2,5,10,1
8003,49,1106,383,288,292,26,6,62,409,11,65,38,67,76,105,429,656,5,3719,206,0,2,5,10,1
8004,38,676,373,158,315,8,0,51,381,5,76,44,79,81,123,486,779,2,2026,112,0,2,1,10,1
8005,28,1589,1289,550,1043,56,32,155,1345,10,167,93,185,177,278,1266,2075,5,11498,638,0,2,0,15,1
8006,24,833,1043,504,840,53,9,147,1096,9,180,112,198,189,310,1377,2344,4,11604,644,0,2,0,20,1
8007,21,888,373,158,315,8,0,51,381,5,76,44,79,81,123,486,779,2,2026,112,0,2,0,16,1
8008,30,354,757,253,292,73,244,162,830,13,61,38,67,74,105,409,651,7,4654,258,0,2,3,5,1
8009,38,683,373,158,315,8,0,51,381,5,76,44,79,81,123,486,779,2,2026,112,0,2,3,2,1
8012,45,1291,2,2,2,0,0,0,2,0,0,0,0,0,0,0,0,0,0,0,0,2,0,19,1
8026,45,1291,99,48,90,1,3,5,100,0,0,0,0,0,0,0,0,0,0,0,0,2,0,19,1
8027,45,1291,8,5,5,2,0,1,10,0,0,0,0,0,0,0,0,0,0,0,0,2,0,19,1
8028,45,1291,1217,716,841,84,126,174,1301,14,185,118,215,199,333,1446,2542,8,20687,1149,0,2,0,19,1
8029,45,1291,160,89,115,0,13,31,160,7,15,11,17,22,28,78,124,3,495,27,0,2,0,19,1
8030,45,1291,10,10,9,9,0,0,19,0,0,0,0,0,0,0,0,0,0,0,0,2,0,19,1
8031,45,1291,173,84,99,8,29,36,181,5,12,7,13,17,20,54,81,2,221,12,0,2,0,19,1
8032,45,1291,3,1,1,3,0,0,6,0,0,0,0,0,0,0,0,0,0,0,0,2,0,19,1
8035,18,449,2,2,2,0,0,0,2,0,0,0,0,0,0,0,0,0,0,0,0,2,1,4,1
8049,18,449,99,48,90,1,3,5,100,0,0,0,0,0,0,0,0,0,0,0,0,2,1,4,1
8050,18,449,8,5,5,2,0,1,10,0,0,0,0,0,0,0,0,0,0,0,0,2,1,4,1
8051,18,449,1217,716,841,84,126,174,1301,14,185,118,215,199,333,1446,2542,8,20687,1149,0,2,1,4,1
8052,18,449,160,89,115,0,13,31,160,7,15,11,17,22,28,78,124,3,495,27,0,2,1,4,1
8053,18,449,10,10,9,9,0,0,19,0,0,0,0,0,0,0,0,0,0,0,0,2,1,4,1
8054,18,449,173,84,99,8,29,36,181,5,12,7,13,17,20,54,81,2,221,12,0,2,1,4,1
8055,18,449,3,1,1,3,0,0,6,0,0,0,0,0,0,0,0,0,0,0,0,2,1,4,1
8056,5,106,127,75,83,2,11,30,129,4,14,7,14,18,21,61,87,2,175,9,0,2,1,1,1
8057,5,106,652,304,544,16,6,88,668,6,89,51,101,95,152,591,998,3,3399,188,0,2,1,1,1
8058,5,106,2,2,2,0,0,0,2,0,0,0,0,0,0,0,0,0,0,0,0,2,1,1,1
8059,5,106,8,5,5,0,0,3,8,0,0,0,0,0,0,0,0,0,0,0,0,2,1,1,1
8062,5,106,14,8,8,0,0,6,14,0,0,0,0,0,0,0,0,0,0,0,0,2,1,1,1
8063,5,106,6,4,4,0,0,2,6,0,0,0,0,0,0,0,0,0,0,0,0,2,1,1,1
8064,5,106,6,4,4,0,0,2,6,1,2,1,2,3,3,2,4,0,2,0,0,2,1,1,1
8066,5,106,7,5,5,0,0,2,7,0,0,0,0,0,0,0,0,0,0,0,0,2,1,1,1
8068,5,106,10,6,6,0,0,4,10,0,0,0,0,0,0,0,0,0,0,0,0,2,1,1,1
8069,5,106,1,1,1,0,0,0,1,0,0,0,0,0,0,0,0,0,0,0,0,2,1,1,1
8071,5,106,14,10,10,0,0,4,14,1,1,1,1,2,2,0,2,0,1,0,0,2,1,1,1
8072,5,106,46,26,30,3,0,12,49,3,6,3,6,9,9,20,28,1,42,2,0,2,1,1,1
8073,70,1433,384,251,317,7,8,52,391,11,70,44,84,81,128,467,811,6,5355,297,0,2,70,0,1
8074,29,1470,384,251,317,7,8,52,391,11,70,44,84,81,128,467,811,6,5355,297,0,2,28,2,1
8077,18,449,2,2,2,0,0,0,2,0,0,0,0,0,0,0,0,0,0,0,0,2,3,3,0
8091,18,449,99,48,90,1,3,5,100,0,0,0,0,0,0,0,0,0,0,0,0,2,3,3,0
8092,18,449,8,5,5,2,0,1,10,0,0,0,0,0,0,0,0,0,0,0,0,2,3,3,0
8093,18,449,1217,716,841,84,126,174,1301,14,185,118,215,199,333,1446,2542,8,20687,1149,0,2,3,3,0
8094,18,449,160,89,115,0,13,31,160,7,15,11,17,22,28,78,124,3,495,27,0,2,3,3,0
8095,18,449,10,10,9,9,0,0,19,0,0,0,0,0,0,0,0,0,0,0,0,2,3,3,0
8096,18,449,173,84,99,8,29,36,181,5,12,7,13,17,20,54,81,2,221,12,0,2,3,3,0
8097,18,449,3,1,1,3,0,0,6,0,0,0,0,0,0,0,0,0,0,0,0,2,3,3,0
8100,19,456,2,2,2,0,0,0,2,0,0,0,0,0,0,0,0,0,0,0,0,2,1,0,0
8114,19,456,99,48,90,1,3,5,100,0,0,0,0,0,0,0,0,0,0,0,0,2,1,0,0
8115,19,456,8,5,5,2,0,1,10,0,0,0,0,0,0,0,0,0,0,0,0,2,1,0,0
8116,19,456,1217,716,841,84,126,174,1301,14,185,118,215,199,333,1446,2542,8,20687,1149,0,2,1,0,0
8117,19,456,160,89,115,0,13,31,160,7,15,11,17,22,28,78,124,3,495,27,0,2,1,0,0
8118,19,456,10,10,9,9,0,0,19,0,0,0,0,0,0,0,0,0,0,0,0,2,1,0,0
8119,19,456,173,84,99,8,29,36,181,5,12,7,13,17,20,54,81,2,221,12,0,2,1,0,0
8120,19,456,3,1,1,3,0,0,6,0,0,0,0,0,0,0,0,0,0,0,0,2,1,0,0
8123,16,369,2,2,2,0,0,0,2,0,0,0,0,0,0,0,0,0,0,0,0,2,29,48,0
8137,16,369,99,48,90,1,3,5,100,0,0,0,0,0,0,0,0,0,0,0,0,2,29,48,0
8138,16,369,8,5,5,2,0,1,10,0,0,0,0,0,0,0,0,0,0,0,0,2,29,48,0
8139,16,369,1217,716,841,84,126,174,1301,14,185,118,215,199,333,1446,2542,8,20687,1149,0,2,29,48,0
8140,16,369,160,89,115,0,13,31,160,7,15,11,17,22,28,78,124,3,495,27,0,2,29,48,0
8141,16,369,10,10,9,9,0,0,19,0,0,0,0,0,0,0,0,0,0,0,0,2,29,48,0
8142,16,369,173,84,99,8,29,36,181,5,12,7,13,17,20,54,81,2,221,12,0,2,29,48,0
8143,16,369,3,1,1,3,0,0,6,0,0,0,0,0,0,0,0,0,0,0,0,2,29,48,0
8146,19,404,2,2,2,0,0,0,2,0,0,0,0,0,0,0,0,0,0,0,0,2,12,1,0
8160,19,404,99,48,90,1,3,5,100,0,0,0,0,0,0,0,0,0,0,0,0,2,12,1,0
8161,19,404,8,5,5,2,0,1,10,0,0,0,0,0,0,0,0,0,0,0,0,2,12,1,0
8162,19,404,1217,716,841,84,126,174,1301,14,185,118,215,199,333,1446,2542,8,20687,1149,0,2,12,1,0
8163,19,404,160,89,115,0,13,31,160,7,15,11,17,22,28,78,124,3,495,27,0,2,12,1,0
8164,19,404,10,10,9,9,0,0,19,0,0,0,0,0,0,0,0,0,0,0,0,2,12,1,0
8165,19,404,173,84,99,8,29,36,181,5,12,7,13,17,20,54,81,2,221,12,0,2,12,1,0
8166,19,404,3,1,1,3,0,0,6,0,0,0,0,0,0,0,0,0,0,0,0,2,12,1,0
8167,88,1938,1457,730,1242,11,6,188,1468,10,292,166,329,302,495,2424,4078,5,22973,1276,1,2,0,2,1
8168,88,1938,74,35,59,1,0,14,75,3,14,7,14,17,21,58,85,1,128,7,0,2,0,2,1
8169,88,1938,245,125,200,5,7,34,250,7,30,17,34,37,51,166,265,3,1053,58,0,2,0,2,1
8170,34,391,757,253,292,73,244,162,830,13,61,38,67,74,105,409,651,7,4654,258,0,2,19,6,1
8171,68,1398,384,251,317,7,8,52,391,11,70,44,84,81,128,467,811,6,5355,297,0,2,0,5,1
8172,38,680,373,158,315,8,0,51,381,5,76,44,79,81,123,486,779,2,2026,112,0,2,4,6,1
8173,21,888,373,158,315,8,0,51,381,5,76,44,79,81,123,486,779,2,2026,112,0,2,1,1,1
8174,34,387,757,253,292,73,244,162,830,13,61,38,67,74,105,409,651,7,4654,258,0,2,8,9,1
8176,34,316,647,139,84,35,284,233,682,0,0,0,0,0,0,0,0,0,0,0,0,0,153,0,1
8177,68,1394,384,251,317,7,8,52,391,11,70,44,84,81,128,467,811,6,5355,297,0,2,3,3,1
8178,66,1372,384,251,317,7,8,52,391,11,70,44,84,81,128,467,811,6,5355,297,0,2,2,6,0
8179,28,1427,384,251,317,7,8,52,391,11,70,44,84,81,128,467,811,6,5355,297,0,2,0,9,0
8180,123,2153,1338,495,1086,10,64,173,1348,11,122,82,157,133,239,883,1686,7,11934,663,0,2,4,8,1
8181,88,1939,1457,730,1242,11,6,188,1468,10,292,166,329,302,495,2424,4078,5,22973,1276,1,2,2,1,1
8182,88,1939,74,35,59,1,0,14,75,3,14,7,14,17,21,58,85,1,128,7,0,2,2,1,1
8183,88,1939,245,125,200,5,7,34,250,7,30,17,34,37,51,166,265,3,1053,58,0,2,2,1,1
8184,5,107,127,75,83,2,11,30,129,4,14,7,14,18,21,61,87,2,175,9,0,2,1,1,1
8185,5,107,652,304,544,16,6,88,668,6,89,51,101,95,152,591,998,3,3399,188,0,2,1,1,1
8186,5,107,2,2,2,0,0,0,2,0,0,0,0,0,0,0,0,0,0,0,0,2,1,1,1
8187,5,107,8,5,5,0,0,3,8,0,0,0,0,0,0,0,0,0,0,0,0,2,1,1,1
8190,5,107,14,8,8,0,0,6,14,0,0,0,0,0,0,0,0,0,0,0,0,2,1,1,1
8191,5,107,6,4,4,0,0,2,6,0,0,0,0,0,0,0,0,0,0,0,0,2,1,1,1
8192,5,107,6,4,4,0,0,2,6,1,2,1,2,3,3,2,4,0,2,0,0,2,1,1,1
8194,5,107,7,5,5,0,0,2,7,0,0,0,0,0,0,0,0,0,0,0,0,2,1,1,1
8196,5,107,10,6,6,0,0,4,10,0,0,0,0,0,0,0,0,0,0,0,0,2,1,1,1
8197,5,107,1,1,1,0,0,0,1,0,0,0,0,0,0,0,0,0,0,0,0,2,1,1,1
8199,5,107,14,10,10,0,0,4,14,1,1,1,1,2,2,0,2,0,1,0,0,2,1,1,1
8200,5,107,46,26,30,3,0,12,49,3,6,3,6,9,9,20,28,1,42,2,0,2,1,1,1
8203,18,389,2,2,2,0,0,0,2,0,0,0,0,0,0,0,0,0,0,0,0,2,2,3,1
8217,18,389,99,48,90,1,3,5,100,0,0,0,0,0,0,0,0,0,0,0,0,2,2,3,1
8218,18,389,8,5,5,2,0,1,10,0,0,0,0,0,0,0,0,0,0,0,0,2,2,3,1
8219,18,389,1217,716,841,84,126,174,1301,14,185,118,215,199,333,1446,2542,8,20687,1149,0,2,2,3,1
8220,18,389,160,89,115,0,13,31,160,7,15,11,17,22,28,78,124,3,495,27,0,2,2,3,1
8221,18,389,10,10,9,9,0,0,19,0,0,0,0,0,0,0,0,0,0,0,0,2,2,3,1
8222,18,389,173,84,99,8,29,36,181,5,12,7,13,17,20,54,81,2,221,12,0,2,2,3,1
8223,18,389,3,1,1,3,0,0,6,0,0,0,0,0,0,0,0,0,0,0,0,2,2,3,1
8224,123,2143,1338,495,1086,10,64,173,1348,11,122,82,157,133,239,883,1686,7,11934,663,0,2,3,3,1
8225,34,312,647,139,84,35,284,233,682,0,0,0,0,0,0,0,0,0,0,0,0,2,23,18,1
8226,124,2163,1338,495,1086,10,64,173,1348,11,122,82,157,133,239,883,1686,7,11934,663,0,2,10,5,1
8227,33,298,647,139,84,35,284,233,682,0,0,0,0,0,0,0,0,0,0,0,0,2,6,14,1
8228,1,319,42,7,35,4,0,5,46,1,2,1,2,3,3,2,4,0,2,0,0,2,18,16,1
8229,1,319,11,6,10,0,0,1,11,2,4,2,4,6,6,10,15,1,15,0,0,2,18,16,1
8253,34,305,647,139,84,35,284,233,682,0,0,0,0,0,0,0,0,0,0,0,0,2,4,0,1
8254,71,1431,384,251,317,7,8,52,391,11,70,44,84,81,128,467,811,6,5355,297,0,2,12,0,1
8255,42,2275,1457,730,1242,11,6,188,1468,10,292,166,329,302,495,2424,4078,5,22973,1276,1,2,2,1,1
8256,29,1463,384,251,317,7,8,52,391,11,70,44,84,81,128,467,811,6,5355,297,0,2,17,1,1
8303,72,1433,384,251,317,7,8,52,391,11,70,44,84,81,128,467,811,6,5355,297,0,2,2,1,0
8304,1,319,42,7,35,4,0,5,46,1,2,1,2,3,3,2,4,0,2,0,0,2,1,1,0
8305,1,319,11,6,10,0,0,1,11,2,4,2,4,6,6,10,15,1,15,0,0,2,1,1,0
8306,1,319,42,7,35,4,0,5,46,1,2,1,2,3,3,2,4,0,2,0,0,2,11,5,1
8307,1,319,11,6,10,0,0,1,11,2,4,2,4,6,6,10,15,1,15,0,0,2,11,5,1
8331,1,136,42,7,35,4,0,5,46,1,2,1,2,3,3,2,4,0,2,0,0,2,7,97,0
8332,1,136,11,6,10,0,0,1,11,2,4,2,4,6,6,10,15,1,15,0,0,2,7,97,0
8333,124,2163,1338,495,1086,10,64,173,1348,11,122,82,157,133,239,883,1686,7,11934,663,0,2,1,1,0
8357,1,220,42,7,35,4,0,5,46,1,2,1,2,3,3,2,4,0,2,0,0,2,51,9,1
8358,1,220,11,6,10,0,0,1,11,2,4,2,4,6,6,10,15,1,15,0,0,2,51,9,1
8359,1,311,42,7,35,4,0,5,46,1,2,1,2,3,3,2,4,0,2,0,0,2,49,8,1
8360,1,311,11,6,10,0,0,1,11,2,4,2,4,6,6,10,15,1,15,0,0,2,49,8,1
8384,1,311,42,7,35,4,0,5,46,1,2,1,2,3,3,2,4,0,2,0,0,2,3,4,0
8385,1,311,11,6,10,0,0,1,11,2,4,2,4,6,6,10,15,1,15,0,0,2,3,4,0
8386,1,311,42,7,35,4,0,5,46,1,2,1,2,3,3,2,4,0,2,0,0,2,1,1,0
8387,1,311,11,6,10,0,0,1,11,2,4,2,4,6,6,10,15,1,15,0,0,2,1,1,0
8411,124,2163,1338,495,1086,10,64,173,1348,11,122,82,157,133,239,883,1686,7,11934,663,0,2,1,1,1
8412,1,311,42,7,35,4,0,5,46,1,2,1,2,3,3,2,4,0,2,0,0,2,6,14,1
8413,1,311,11,6,10,0,0,1,11,2,4,2,4,6,6,10,15,1,15,0,0,2,6,14,1
8437,1,313,42,7,35,4,0,5,46,1,2,1,2,3,3,2,4,0,2,0,0,2,4,4,1
8438,1,313,11,6,10,0,0,1,11,2,4,2,4,6,6,10,15,1,15,0,0,2,4,4,1
8487,1,313,42,7,35,4,0,5,46,1,2,1,2,3,3,2,4,0,2,0,0,2,2,5,1
8488,1,313,11,6,10,0,0,1,11,2,4,2,4,6,6,10,15,1,15,0,0,2,2,5,1
8489,29,1465,384,251,317,7,8,52,391,11,70,44,84,81,128,467,811,6,5355,297,0,2,1,1,1
8490,34,305,647,139,84,35,284,233,682,0,0,0,0,0,0,0,0,0,0,0,0,2,1,1,0
8492,29,1465,384,251,317,7,8,52,391,11,70,44,84,81,128,467,811,6,5355,297,0,2,1,1,0
8516,1,306,42,7,35,4,0,5,46,1,2,1,2,3,3,2,4,0,2,0,0,2,1,3,1
8517,1,306,11,6,10,0,0,1,11,2,4,2,4,6,6,10,15,1,15,0,0,2,1,3,1
8518,1,306,42,7,35,4,0,5,46,1,2,1,2,3,3,2,4,0,2,0,0,2,2,6,0
8519,1,306,11,6,10,0,0,1,11,2,4,2,4,6,6,10,15,1,15,0,0,2,2,6,0
8543,28,1379,384,251,317,7,8,52,391,11,70,44,84,81,128,467,811,6,5355,297,0,2,0,24,1
8544,1,306,42,7,35,4,0,5,46,1,2,1,2,3,3,2,4,0,2,0,0,2,4,4,1
8545,1,306,11,6,10,0,0,1,11,2,4,2,4,6,6,10,15,1,15,0,0,2,4,4,1
8547,2,80,13,10,10,0,0,3,13,1,2,1,2,3,3,2,4,0,2,0,0,3,1,1,1
8566,75,1676,384,251,317,7,8,52,391,11,70,44,84,81,128,467,811,6,5355,297,0,2,48,4,1
8567,29,1440,384,251,317,7,8,52,391,11,70,44,84,81,128,467,811,6,5355,297,0,2,16,1,1
8569,2,80,13,10,10,0,0,3,13,1,2,1,2,3,3,2,4,0,2,0,0,3,1,1,0
8588,75,1676,384,251,317,7,8,52,391,11,70,44,84,81,128,467,811,6,5355,297,0,2,48,4,0
8589,29,1440,384,251,317,7,8,52,391,11,70,44,84,81,128,467,811,6,5355,297,0,2,16,25,0
8590,1,306,42,7,35,4,0,5,46,1,2,1,2,3,3,2,4,0,2,0,0,2,2,3,0
8591,1,306,11,6,10,0,0,1,11,2,4,2,4,6,6,10,15,1,15,0,0,2,2,3,0
8592,34,305,647,139,84,35,284,233,682,0,0,0,0,0,0,0,0,0,0,0,0,2,55,53,1
8616,2,311,42,7,35,4,0,5,46,1,2,1,2,3,3,2,4,0,2,0,0,2,2,1,0
8617,2,311,11,6,10,0,0,1,11,2,4,2,4,6,6,10,15,1,15,0,0,2,2,1,0
8641,34,305,647,139,84,35,284,233,682,0,0,0,0,0,0,0,0,0,0,0,0,2,55,53,0
8644,34,304,647,139,84,35,284,233,682,0,0,0,0,0,0,0,0,0,0,0,0,2,3,3,1
8645,75,1673,384,251,317,7,8,52,391,11,70,44,84,81,128,467,811,6,5355,297,0,2,2,2,1
8646,29,1440,384,251,317,7,8,52,391,11,70,44,84,81,128,467,811,6,5355,297,0,2,1,1,1
8647,35,307,647,139,84,35,284,233,682,0,0,0,0,0,0,0,0,0,0,0,0,2,6,3,1
8648,36,671,373,158,315,8,0,51,381,5,76,44,79,81,123,486,779,2,2026,112,0,2,5,5,1
8649,35,307,647,139,84,35,284,233,682,0,0,0,0,0,0,0,0,0,0,0,0,2,1,2,1
8650,35,307,647,139,84,35,284,233,682,0,0,0,0,0,0,0,0,0,0,0,0,2,10,8,0
8651,75,1673,384,251,317,7,8,52,391,11,70,44,84,81,128,467,811,6,5355,297,0,2,2,2,0
8652,36,671,373,158,315,8,0,51,381,5,76,44,79,81,123,486,779,2,2026,112,0,2,5,5,0
8653,29,1440,384,251,317,7,8,52,391,11,70,44,84,81,128,467,811,6,5355,297,0,2,1,1,0
8654,36,671,373,158,315,8,0,51,381,5,76,44,79,81,123,486,779,2,2026,112,0,2,1,1,1
8655,36,671,373,158,315,8,0,51,381,5,76,44,79,81,123,486,779,2,2026,112,0,2,1,1,0
8679,2,311,42,7,35,4,0,5,46,1,2,1,2,3,3,2,4,0,2,0,0,2,1,1,0
8680,2,311,11,6,10,0,0,1,11,2,4,2,4,6,6,10,15,1,15,0,0,2,1,1,0
8681,122,2141,1338,495,1086,10,64,173,1348,11,122,82,157,133,239,883,1686,7,11934,663,0,2,6,8,1
8682,77,1723,1457,730,1242,11,6,188,1468,10,292,166,329,302,495,2424,4078,5,22973,1276,1,2,0,37,1
8683,77,1723,74,35,59,1,0,14,75,3,14,7,14,17,21,58,85,1,128,7,0,2,0,37,1
8684,77,1723,245,125,200,5,7,34,250,7,30,17,34,37,51,166,265,3,1053,58,0,2,0,37,1
8685,27,1540,1289,550,1043,56,32,155,1345,10,167,93,185,177,278,1266,2075,5,11498,638,0,2,0,22,1
8686,34,1908,1457,730,1242,11,6,188,1468,10,292,166,329,302,495,2424,4078,5,22973,1276,1,2,0,55,1
8687,124,2153,1338,495,1086,10,64,173,1348,11,122,82,157,133,239,883,1686,7,11934,663,0,2,5,1,0
8688,17,320,127,75,83,2,11,30,129,4,14,7,14,18,21,61,87,2,175,9,0,2,10,0,1
8689,17,320,652,304,544,16,6,88,668,6,89,51,101,95,152,591,998,3,3399,188,0,2,10,0,1
8690,17,320,2,2,2,0,0,0,2,0,0,0,0,0,0,0,0,0,0,0,0,2,10,0,1
8691,17,320,8,5,5,0,0,3,8,0,0,0,0,0,0,0,0,0,0,0,0,2,10,0,1
8694,17,320,14,8,8,0,0,6,14,0,0,0,0,0,0,0,0,0,0,0,0,2,10,0,1
8695,17,320,6,4,4,0,0,2,6,0,0,0,0,0,0,0,0,0,0,0,0,2,10,0,1
8696,17,320,6,4,4,0,0,2,6,1,2,1,2,3,3,2,4,0,2,0,0,2,10,0,1
8698,17,320,7,5,5,0,0,2,7,0,0,0,0,0,0,0,0,0,0,0,0,2,10,0,1
8700,17,320,10,6,6,0,0,4,10,0,0,0,0,0,0,0,0,0,0,0,0,2,10,0,1
8701,17,320,1,1,1,0,0,0,1,0,0,0,0,0,0,0,0,0,0,0,0,2,10,0,1
8703,17,320,14,10,10,0,0,4,14,1,1,1,1,2,2,0,2,0,1,0,0,2,10,0,1
8704,17,320,46,26,30,3,0,12,49,3,6,3,6,9,9,20,28,1,42,2,0,2,10,0,1
8705,14,692,334,251,279,10,4,40,344,5,127,74,143,132,217,899,1528,2,4303,239,0,2,1,3,1
8706,37,326,647,139,84,35,284,233,682,0,0,0,0,0,0,0,0,0,0,0,0,2,8,0,1
8730,17,320,127,75,83,2,11,30,129,4,14,7,14,18,21,61,87,2,175,9,0,2,10,0,0
8731,17,320,652,304,544,16,6,88,668,6,89,51,101,95,152,591,998,3,3399,188,0,2,10,0,0
8732,17,320,2,2,2,0,0,0,2,0,0,0,0,0,0,0,0,0,0,0,0,2,10,0,0
8733,17,320,8,5,5,0,0,3,8,0,0,0,0,0,0,0,0,0,0,0,0,2,10,0,0
8736,17,320,14,8,8,0,0,6,14,0,0,0,0,0,0,0,0,0,0,0,0,2,10,0,0
8737,17,320,6,4,4,0,0,2,6,0,0,0,0,0,0,0,0,0,0,0,0,2,10,0,0
8738,17,320,6,4,4,0,0,2,6,1,2,1,2,3,3,2,4,0,2,0,0,2,10,0,0
8740,17,320,7,5,5,0,0,2,7,0,0,0,0,0,0,0,0,0,0,0,0,2,10,0,0
8742,17,320,10,6,6,0,0,4,10,0,0,0,0,0,0,0,0,0,0,0,0,2,10,0,0
8743,17,320,1,1,1,0,0,0,1,0,0,0,0,0,0,0,0,0,0,0,0,2,10,0,0
8745,17,320,14,10,10,0,0,4,14,1,1,1,1,2,2,0,2,0,1,0,0,2,10,0,0
8746,17,320,46,26,30,3,0,12,49,3,6,3,6,9,9,20,28,1,42,2,0,2,10,0,0
8747,124,2153,1338,495,1086,10,64,173,1348,11,122,82,157,133,239,883,1686,7,11934,663,0,2,11,9,0
8748,77,1723,1457,730,1242,11,6,188,1468,10,292,166,329,302,495,2424,4078,5,22973,1276,1,2,0,37,0
8749,77,1723,74,35,59,1,0,14,75,3,14,7,14,17,21,58,85,1,128,7,0,2,0,37,0
8750,77,1723,245,125,200,5,7,34,250,7,30,17,34,37,51,166,265,3,1053,58,0,2,0,37,0
8751,37,326,647,139,84,35,284,233,682,0,0,0,0,0,0,0,0,0,0,0,0,2,8,0,0
8752,27,1540,1289,550,1043,56,32,155,1345,10,167,93,185,177,278,1266,2075,5,11498,638,0,2,0,22,0
8753,34,1908,1457,730,1242,11,6,188,1468,10,292,166,329,302,495,2424,4078,5,22973,1276,1,2,0,55,0
8754,14,692,334,251,279,10,4,40,344,5,127,74,143,132,217,899,1528,2,4303,239,0,2,1,3,0
8757,25,1394,1289,550,1043,56,32,155,1345,10,167,93,185,177,278,1266,2075,5,11498,638,0,0,422,0,1
8758,16,927,1289,550,1043,56,32,155,1345,10,167,93,185,177,278,1266,2075,5,11498,638,0,2,0,203,1
8782,90,1970,1392,870,1177,35,17,170,1427,14,494,280,531,508,811,4473,7289,7,54850,3047,2,2,17,6,1
8783,100,3732,1392,870,1177,35,17,170,1427,14,494,280,531,508,811,4473,7289,7,54850,3047,2,2,21,0,1
8784,2,311,42,7,35,4,0,5,46,1,2,1,2,3,3,2,4,0,2,0,0,2,1,1,1
8785,2,311,11,6,10,0,0,1,11,2,4,2,4,6,6,10,15,1,15,0,0,2,1,1,1
8786,101,3760,1392,870,1177,35,17,170,1427,14,494,280,531,508,811,4473,7289,7,54850,3047,2,2,3,1,0
8856,9,518,1289,550,1043,56,32,155,1345,10,167,93,185,177,278,1266,2075,5,11498,638,0,2,0,274,1
8857,37,326,647,139,84,35,284,233,682,0,0,0,0,0,0,0,0,0,0,0,0,2,2,2,1
8858,36,671,373,158,315,8,0,51,381,5,76,44,79,81,123,486,779,2,2026,112,0,2,3,3,1
8859,5,261,1289,550,1043,56,32,155,1345,10,167,93,185,177,278,1266,2075,5,11498,638,0,2,0,184,1
8956,90,1970,1392,870,1177,35,17,170,1427,14,494,280,531,508,811,4473,7289,7,54850,3047,2,2,17,6,0
8957,101,3760,1392,870,1177,35,17,170,1427,14,494,280,531,508,811,4473,7289,7,54850,3047,2,2,23,0,0
8958,9,518,1289,550,1043,56,32,155,1345,10,167,93,185,177,278,1266,2075,5,11498,638,0,0,148,0,0
8959,37,326,647,139,84,35,284,233,682,0,0,0,0,0,0,0,0,0,0,0,0,2,2,2,0
8960,36,671,373,158,315,8,0,51,381,5,76,44,79,81,123,486,779,2,2026,112,0,2,3,3,0
8961,5,261,1289,550,1043,56,32,155,1345,10,167,93,185,177,278,1266,2075,5,11498,638,0,2,0,387,0
8962,2,311,42,7,35,4,0,5,46,1,2,1,2,3,3,2,4,0,2,0,0,2,2,2,0
8963,2,311,11,6,10,0,0,1,11,2,4,2,4,6,6,10,15,1,15,0,0,2,2,2,0
8987,127,2226,1338,495,1086,10,64,173,1348,11,122,82,157,133,239,883,1686,7,11934,663,0,2,10,0,1
8990,37,326,647,139,84,35,284,233,682,0,0,0,0,0,0,0,0,0,0,0,0,2,3,3,1
8991,127,2230,1338,495,1086,10,64,173,1348,11,122,82,157,133,239,883,1686,7,11934,663,0,2,2,5,1
8992,6,319,1289,550,1043,56,32,155,1345,10,167,93,185,177,278,1266,2075,5,11498,638,0,2,9,0,1
9016,127,2230,1338,495,1086,10,64,173,1348,11,122,82,157,133,239,883,1686,7,11934,663,0,2,12,5,0
9017,37,326,647,139,84,35,284,233,682,0,0,0,0,0,0,0,0,0,0,0,0,2,3,3,0
9018,6,319,1289,550,1043,56,32,155,1345,10,167,93,185,177,278,1266,2075,5,11498,638,0,2,9,0,0
9021,89,1961,1392,870,1177,35,17,170,1427,14,494,280,531,508,811,4473,7289,7,54850,3047,2,2,1,2,1
9022,101,3788,1392,870,1177,35,17,170,1427,14,494,280,531,508,811,4473,7289,7,54850,3047,2,2,5,1,1
9023,54,1827,773,419,590,28,0,166,801,10,204,113,217,214,330,1598,2554,5,13587,754,0,2,2,2,1
9024,75,1669,384,251,317,7,8,52,391,11,70,44,84,81,128,467,811,6,5355,297,0,2,0,3,1
9025,30,1475,384,251,317,7,8,52,391,11,70,44,84,81,128,467,811,6,5355,297,0,2,10,1,1
9049,75,1674,384,251,317,7,8,52,391,11,70,44,84,81,128,467,811,6,5355,297,0,2,12,9,1
9050,29,1457,384,251,317,7,8,52,391,11,70,44,84,81,128,467,811,6,5355,297,0,2,0,4,1
9051,131,2252,1338,495,1086,10,64,173,1348,11,122,82,157,133,239,883,1686,7,11934,663,0,2,6,1,1
9052,5,107,127,75,83,2,11,30,129,4,14,7,14,18,21,61,87,2,175,9,0,2,8,3,1
9053,5,107,652,304,544,16,6,88,668,6,89,51,101,95,152,591,998,3,3399,188,0,2,8,3,1
9054,5,107,2,2,2,0,0,0,2,0,0,0,0,0,0,0,0,0,0,0,0,2,8,3,1
9055,5,107,8,5,5,0,0,3,8,0,0,0,0,0,0,0,0,0,0,0,0,2,8,3,1
9058,5,107,14,8,8,0,0,6,14,0,0,0,0,0,0,0,0,0,0,0,0,2,8,3,1
9059,5,107,6,4,4,0,0,2,6,0,0,0,0,0,0,0,0,0,0,0,0,2,8,3,1
9060,5,107,6,4,4,0,0,2,6,1,2,1,2,3,3,2,4,0,2,0,0,2,8,3,1
9062,5,107,7,5,5,0,0,2,7,0,0,0,0,0,0,0,0,0,0,0,0,2,8,3,1
9064,5,107,10,6,6,0,0,4,10,0,0,0,0,0,0,0,0,0,0,0,0,2,8,3,1
9065,5,107,1,1,1,0,0,0,1,0,0,0,0,0,0,0,0,0,0,0,0,2,8,3,1
9067,5,107,14,10,10,0,0,4,14,1,1,1,1,2,2,0,2,0,1,0,0,2,8,3,1
9068,5,107,46,26,30,3,0,12,49,3,6,3,6,9,9,20,28,1,42,2,0,2,8,3,1
9069,75,1669,384,251,317,7,8,52,391,11,70,44,84,81,128,467,811,6,5355,297,0,2,8,7,1
9070,29,1457,384,251,317,7,8,52,391,11,70,44,84,81,128,467,811,6,5355,297,0,2,2,2,1
9071,7,384,1289,550,1043,56,32,155,1345,10,167,93,185,177,278,1266,2075,5,11498,638,0,2,8,0,1
9095,89,1961,1392,870,1177,35,17,170,1427,14,494,280,531,508,811,4473,7289,7,54850,3047,2,2,1,2,0
9096,101,3788,1392,870,1177,35,17,170,1427,14,494,280,531,508,811,4473,7289,7,54850,3047,2,2,5,1,0
9097,54,1827,773,419,590,28,0,166,801,10,204,113,217,214,330,1598,2554,5,13587,754,0,2,2,2,0
9098,131,2252,1338,495,1086,10,64,173,1348,11,122,82,157,133,239,883,1686,7,11934,663,0,2,6,1,0
9099,5,107,127,75,83,2,11,30,129,4,14,7,14,18,21,61,87,2,175,9,0,2,8,3,0
9100,5,107,652,304,544,16,6,88,668,6,89,51,101,95,152,591,998,3,3399,188,0,2,8,3,0
9101,5,107,2,2,2,0,0,0,2,0,0,0,0,0,0,0,0,0,0,0,0,2,8,3,0
9102,5,107,8,5,5,0,0,3,8,0,0,0,0,0,0,0,0,0,0,0,0,2,8,3,0
9105,5,107,14,8,8,0,0,6,14,0,0,0,0,0,0,0,0,0,0,0,0,2,8,3,0
9106,5,107,6,4,4,0,0,2,6,0,0,0,0,0,0,0,0,0,0,0,0,2,8,3,0
9107,5,107,6,4,4,0,0,2,6,1,2,1,2,3,3,2,4,0,2,0,0,2,8,3,0
9109,5,107,7,5,5,0,0,2,7,0,0,0,0,0,0,0,0,0,0,0,0,2,8,3,0
9111,5,107,10,6,6,0,0,4,10,0,0,0,0,0,0,0,0,0,0,0,0,2,8,3,0
9112,5,107,1,1,1,0,0,0,1,0,0,0,0,0,0,0,0,0,0,0,0,2,8,3,0
9114,5,107,14,10,10,0,0,4,14,1,1,1,1,2,2,0,2,0,1,0,0,2,8,3,0
9115,5,107,46,26,30,3,0,12,49,3,6,3,6,9,9,20,28,1,42,2,0,2,8,3,0
9116,75,1669,384,251,317,7,8,52,391,11,70,44,84,81,128,467,811,6,5355,297,0,2,20,19,0
9117,7,384,1289,550,1043,56,32,155,1345,10,167,93,185,177,278,1266,2075,5,11498,638,0,2,8,0,0
9118,29,1457,384,251,317,7,8,52,391,11,70,44,84,81,128,467,811,6,5355,297,0,2,12,7,0
9142,7,379,1289,550,1043,56,32,155,1345,10,167,93,185,177,278,1266,2075,5,11498,638,0,2,1,3,0
9162,36,504,282,196,195,3,0,86,285,8,130,71,141,138,212,936,1507,4,6538,363,0,2,7,5,1
9188,2,80,13,10,10,0,0,3,13,1,2,1,2,3,3,2,4,0,2,0,0,2,1,1,1
9189,77,1723,1457,730,1242,11,6,188,1468,10,292,166,329,302,495,2424,4078,5,22973,1276,1,2,1,1,1
9190,77,1723,74,35,59,1,0,14,75,3,14,7,14,17,21,58,85,1,128,7,0,2,1,1,1
9191,77,1723,245,125,200,5,7,34,250,7,30,17,34,37,51,166,265,3,1053,58,0,2,1,1,1
9192,9,518,1289,550,1043,56,32,155,1345,10,167,93,185,177,278,1266,2075,5,11498,638,0,2,1,1,1
9193,74,1661,384,251,317,7,8,52,391,11,70,44,84,81,128,467,811,6,5355,297,0,2,1,2,1
9194,6,314,1289,550,1043,56,32,155,1345,10,167,93,185,177,278,1266,2075,5,11498,638,0,2,0,8,1
9195,34,1908,1457,730,1242,11,6,188,1468,10,292,166,329,302,495,2424,4078,5,22973,1276,1,2,1,1,1
9196,2,307,42,7,35,4,0,5,46,1,2,1,2,3,3,2,4,0,2,0,0,2,0,2,1
9197,2,307,11,6,10,0,0,1,11,2,4,2,4,6,6,10,15,1,15,0,0,2,0,2,1
9215,36,504,282,196,195,3,0,86,285,8,130,71,141,138,212,936,1507,4,6538,363,0,2,7,5,0
9216,2,80,13,10,10,0,0,3,13,1,2,1,2,3,3,2,4,0,2,0,0,2,1,1,0
9217,77,1723,1457,730,1242,11,6,188,1468,10,292,166,329,302,495,2424,4078,5,22973,1276,1,2,1,1,0
9218,77,1723,74,35,59,1,0,14,75,3,14,7,14,17,21,58,85,1,128,7,0,2,1,1,0
9219,77,1723,245,125,200,5,7,34,250,7,30,17,34,37,51,166,265,3,1053,58,0,2,1,1,0
9220,9,518,1289,550,1043,56,32,155,1345,10,167,93,185,177,278,1266,2075,5,11498,638,0,2,1,1,0
9221,74,1661,384,251,317,7,8,52,391,11,70,44,84,81,128,467,811,6,5355,297,0,2,1,2,0
9222,6,314,1289,550,1043,56,32,155,1345,10,167,93,185,177,278,1266,2075,5,11498,638,0,2,0,10,0
9223,34,1908,1457,730,1242,11,6,188,1468,10,292,166,329,302,495,2424,4078,5,22973,1276,1,2,1,1,0
9224,2,307,42,7,35,4,0,5,46,1,2,1,2,3,3,2,4,0,2,0,0,2,0,2,0
9225,2,307,11,6,10,0,0,1,11,2,4,2,4,6,6,10,15,1,15,0,0,2,0,2,0
9249,17,322,127,75,83,2,11,30,129,4,14,7,14,18,21,61,87,2,175,9,0,2,1,1,1
9250,17,322,652,304,544,16,6,88,668,6,89,51,101,95,152,591,998,3,3399,188,0,2,1,1,1
9251,17,322,2,2,2,0,0,0,2,0,0,0,0,0,0,0,0,0,0,0,0,2,1,1,1
9252,17,322,8,5,5,0,0,3,8,0,0,0,0,0,0,0,0,0,0,0,0,2,1,1,1
9255,17,322,14,8,8,0,0,6,14,0,0,0,0,0,0,0,0,0,0,0,0,2,1,1,1
9256,17,322,6,4,4,0,0,2,6,0,0,0,0,0,0,0,0,0,0,0,0,2,1,1,1
9257,17,322,6,4,4,0,0,2,6,1,2,1,2,3,3,2,4,0,2,0,0,2,1,1,1
9259,17,322,7,5,5,0,0,2,7,0,0,0,0,0,0,0,0,0,0,0,0,2,1,1,1
9261,17,322,10,6,6,0,0,4,10,0,0,0,0,0,0,0,0,0,0,0,0,2,1,1,1
9262,17,322,1,1,1,0,0,0,1,0,0,0,0,0,0,0,0,0,0,0,0,2,1,1,1
9264,17,322,14,10,10,0,0,4,14,1,1,1,1,2,2,0,2,0,1,0,0,2,1,1,1
9265,17,322,46,26,30,3,0,12,49,3,6,3,6,9,9,20,28,1,42,2,0,2,1,1,1
9266,2,307,42,7,35,4,0,5,46,1,2,1,2,3,3,2,4,0,2,0,0,2,2,2,1
9267,2,307,11,6,10,0,0,1,11,2,4,2,4,6,6,10,15,1,15,0,0,2,2,2,1
9360,2,307,42,7,35,4,0,5,46,1,2,1,2,3,3,2,4,0,2,0,0,2,1,2,1
9361,2,307,11,6,10,0,0,1,11,2,4,2,4,6,6,10,15,1,15,0,0,2,1,2,1
9454,57,1511,1513,682,1277,25,13,200,1538,11,199,116,219,210,335,1557,2584,6,15641,868,0,3,96,4,1
9455,57,1511,819,519,539,24,98,155,843,15,96,57,106,111,163,690,1107,8,9171,509,0,3,96,4,1
9456,38,1736,1513,682,1277,25,13,200,1538,11,199,116,219,210,335,1557,2584,6,15641,868,0,3,101,3,1
9457,74,1659,384,251,317,7,8,52,391,11,70,44,84,81,128,467,811,6,5355,297,0,2,1,1,1
9550,43,844,215,129,180,6,0,29,221,8,65,43,72,73,115,415,711,4,3153,175,0,0,183,0,1
9551,43,844,97,69,77,3,3,16,100,6,22,13,23,28,36,113,173,3,542,30,0,0,183,0,1
9575,12,379,15,9,9,0,0,6,15,0,0,0,0,0,0,0,0,0,0,0,0,0,80,0,1
9623,12,380,15,9,9,0,0,6,15,0,0,0,0,0,0,0,0,0,0,0,0,2,3,0,1
9625,2,299,42,7,35,4,0,5,46,1,2,1,2,3,3,2,4,0,2,0,0,2,7,10,1
9626,2,299,11,6,10,0,0,1,11,2,4,2,4,6,6,10,15,1,15,0,0,2,7,10,1
9696,176,3856,182,127,129,0,0,53,182,5,39,21,42,44,63,217,343,2,926,51,0,2,634,1,1
9697,176,3856,1165,710,800,67,119,181,1232,18,243,153,282,261,435,2000,3492,10,36473,2026,1,2,634,1,1
9699,75,1638,773,419,590,28,0,166,801,10,204,113,217,214,330,1598,2554,5,13587,754,0,2,2,1,1
9700,75,1638,421,273,302,44,34,57,465,17,81,59,107,98,166,583,1098,11,12329,684,0,2,2,1,1
9701,31,977,182,127,129,0,0,53,182,5,39,21,42,44,63,217,343,2,926,51,0,2,68,1,1
9702,101,3788,1392,870,1177,35,17,170,1427,14,494,280,531,508,811,4473,7289,7,54850,3047,2,2,1,1,1
9726,2,307,42,7,35,4,0,5,46,1,2,1,2,3,3,2,4,0,2,0,0,2,1,1,1
9727,2,307,11,6,10,0,0,1,11,2,4,2,4,6,6,10,15,1,15,0,0,2,1,1,1
9776,2,297,42,7,35,4,0,5,46,1,2,1,2,3,3,2,4,0,2,0,0,2,3,4,0
9777,2,297,11,6,10,0,0,1,11,2,4,2,4,6,6,10,15,1,15,0,0,2,3,4,0
9801,2,307,42,7,35,4,0,5,46,1,2,1,2,3,3,2,4,0,2,0,0,2,1,1,0
9802,2,307,11,6,10,0,0,1,11,2,4,2,4,6,6,10,15,1,15,0,0,2,1,1,0
9849,125,3182,1450,624,1228,12,26,181,1462,14,306,186,354,320,540,2580,4493,8,36391,2021,1,3,127,13,1
9850,182,3987,182,127,129,0,0,53,182,5,39,21,42,44,63,217,343,2,926,51,0,2,28,5,1
9851,182,3987,1165,710,800,67,119,181,1232,18,243,153,282,261,435,2000,3492,10,36473,2026,1,2,28,5,1
9852,37,828,1450,624,1228,12,26,181,1462,14,306,186,354,320,540,2580,4493,8,36391,2021,1,0,173,0,1
9853,33,1067,182,127,129,0,0,53,182,5,39,21,42,44,63,217,343,2,926,51,0,2,15,2,1
9854,101,3788,1392,870,1177,35,17,170,1427,14,494,280,531,508,811,4473,7289,7,54850,3047,2,2,2,2,1
9882,36,799,1450,624,1228,12,26,181,1462,14,306,186,354,320,540,2580,4493,8,36391,2021,1,2,0,10,1
9929,1,73,42,7,35,4,0,5,46,1,2,1,2,3,3,2,4,0,2,0,0,2,1,1,1
9930,1,73,11,6,10,0,0,1,11,2,4,2,4,6,6,10,15,1,15,0,0,2,1,1,1
9977,27,510,334,251,279,10,4,40,344,5,127,74,143,132,217,899,1528,2,4303,239,0,2,3,3,1
9978,14,690,334,251,279,10,4,40,344,5,127,74,143,132,217,899,1528,2,4303,239,0,2,2,2,1
9979,20,854,373,158,315,8,0,51,381,5,76,44,79,81,123,486,779,2,2026,112,0,2,1,11,0
10003,182,3979,182,127,129,0,0,53,182,5,39,21,42,44,63,217,343,2,926,51,0,2,2,2,1
10004,182,3979,1165,710,800,67,119,181,1232,18,243,153,282,261,435,2000,3492,10,36473,2026,1,2,2,2,1
10029,185,4091,182,127,129,0,0,53,182,5,39,21,42,44,63,217,343,2,926,51,0,2,34,21,1
10030,185,4091,1165,710,800,67,119,181,1232,18,243,153,282,261,435,2000,3492,10,36473,2026,1,2,34,21,1
10031,73,1622,773,419,590,28,0,166,801,10,204,113,217,214,330,1598,2554,5,13587,754,0,2,12,13,1
10032,73,1622,421,273,302,44,34,57,465,17,81,59,107,98,166,583,1098,11,12329,684,0,2,12,13,1
10033,37,841,1450,624,1228,12,26,181,1462,14,306,186,354,320,540,2580,4493,8,36391,2021,1,2,19,9,1
10034,34,1106,182,127,129,0,0,53,182,5,39,21,42,44,63,217,343,2,926,51,0,2,15,8,1
10035,101,3798,1392,870,1177,35,17,170,1427,14,494,280,531,508,811,4473,7289,7,54850,3047,2,2,10,16,1
10036,54,1866,773,419,590,28,0,166,801,10,204,113,217,214,330,1598,2554,5,13587,754,0,2,15,13,1
10037,57,1522,1513,682,1277,25,13,200,1538,11,199,116,219,210,335,1557,2584,6,15641,868,0,2,5,4,1
10038,57,1522,819,519,539,24,98,155,843,15,96,57,106,111,163,690,1107,8,9171,509,0,2,5,4,1
10039,131,2259,1338,495,1086,10,64,173,1348,11,122,82,157,133,239,883,1686,7,11934,663,0,2,3,2,1
10040,80,1742,1457,730,1242,11,6,188,1468,10,292,166,329,302,495,2424,4078,5,22973,1276,1,2,4,2,1
10041,80,1742,74,35,59,1,0,14,75,3,14,7,14,17,21,58,85,1,128,7,0,2,4,2,1
10042,80,1742,245,125,200,5,7,34,250,7,30,17,34,37,51,166,265,3,1053,58,0,2,4,2,1
10043,74,1711,384,251,317,7,8,52,391,11,70,44,84,81,128,467,811,6,5355,297,0,2,12,9,1
10067,185,4091,182,127,129,0,0,53,182,5,39,21,42,44,63,217,343,2,926,51,0,2,2,2,0
10068,185,4091,1165,710,800,67,119,181,1232,18,243,153,282,261,435,2000,3492,10,36473,2026,1,2,2,2,0
10069,73,1676,773,419,590,28,0,166,801,10,204,113,217,214,330,1598,2554,5,13587,754,0,2,13,0,0
10070,73,1676,421,273,302,44,34,57,465,17,81,59,107,98,166,583,1098,11,12329,684,0,2,13,0,0
10071,56,1928,773,419,590,28,0,166,801,10,204,113,217,214,330,1598,2554,5,13587,754,0,2,9,0,0
10072,127,3221,1450,624,1228,12,26,181,1462,14,306,186,354,320,540,2580,4493,8,36391,2021,1,2,45,33,1
10073,2,293,42,7,35,4,0,5,46,1,2,1,2,3,3,2,4,0,2,0,0,2,1,3,0
10074,2,293,11,6,10,0,0,1,11,2,4,2,4,6,6,10,15,1,15,0,0,2,1,3,0
10098,15,423,1450,624,1228,12,26,181,1462,14,306,186,354,320,540,2580,4493,8,36391,2021,1,0,76,0,1
10099,185,4091,182,127,129,0,0,53,182,5,39,21,42,44,63,217,343,2,926,51,0,2,4,4,1
10100,185,4091,1165,710,800,67,119,181,1232,18,243,153,282,261,435,2000,3492,10,36473,2026,1,2,4,4,1
10101,37,841,1450,624,1228,12,26,181,1462,14,306,186,354,320,540,2580,4493,8,36391,2021,1,2,1,1,1
10102,39,869,1450,624,1228,12,26,181,1462,14,306,186,354,320,540,2580,4493,8,36391,2021,1,2,11,3,1
10103,43,937,1450,624,1228,12,26,181,1462,14,306,186,354,320,540,2580,4493,8,36391,2021,1,2,16,0,0
10128,58,1569,1513,682,1277,25,13,200,1538,11,199,116,219,210,335,1557,2584,6,15641,868,0,2,21,15,1
10129,58,1569,819,519,539,24,98,155,843,15,96,57,106,111,163,690,1107,8,9171,509,0,2,21,15,1
10130,47,1955,1513,682,1277,25,13,200,1538,11,199,116,219,210,335,1557,2584,6,15641,868,0,2,122,93,1
10131,101,3809,1392,870,1177,35,17,170,1427,14,494,280,531,508,811,4473,7289,7,54850,3047,2,2,10,7,1
10132,15,439,1450,624,1228,12,26,181,1462,14,306,186,354,320,540,2580,4493,8,36391,2021,1,2,3,0,0
10133,102,3827,1392,870,1177,35,17,170,1427,14,494,280,531,508,811,4473,7289,7,54850,3047,2,2,9,5,0
10157,73,1676,773,419,590,28,0,166,801,10,204,113,217,214,330,1598,2554,5,13587,754,0,2,1,1,1
10158,73,1676,421,273,302,44,34,57,465,17,81,59,107,98,166,583,1098,11,12329,684,0,2,1,1,1
10159,6,256,207,111,150,11,0,50,218,5,26,19,36,31,55,133,272,3,943,52,0,2,1,1,1
10160,6,256,410,198,237,31,55,97,441,11,63,38,72,74,110,414,683,6,4293,238,0,2,1,1,1
10161,19,282,477,336,357,30,23,73,507,16,194,134,250,210,384,1538,2962,10,30538,1696,0,2,1,1,1
10162,4,227,207,111,150,11,0,50,218,5,26,19,36,31,55,133,272,3,943,52,0,2,1,1,1
10163,34,1912,1457,730,1242,11,6,188,1468,10,292,166,329,302,495,2424,4078,5,22973,1276,1,2,2,2,1
10164,29,1459,384,251,317,7,8,52,391,11,70,44,84,81,128,467,811,6,5355,297,0,2,1,1,1
10165,20,856,373,158,315,8,0,51,381,5,76,44,79,81,123,486,779,2,2026,112,0,2,1,1,1
10166,12,284,1523,757,1297,19,12,193,1542,12,193,117,230,205,347,1508,2664,7,19053,1058,0,2,1,1,1
10167,12,284,701,378,504,33,58,109,734,13,110,68,126,123,194,794,1346,7,10027,557,0,2,1,1,1
10168,9,518,1289,550,1043,56,32,155,1345,10,167,93,185,177,278,1266,2075,5,11498,638,0,2,9,9,1
10169,29,1459,384,251,317,7,8,52,391,11,70,44,84,81,128,467,811,6,5355,297,0,2,4,4,1
10170,15,432,1450,624,1228,12,26,181,1462,14,306,186,354,320,540,2580,4493,8,36391,2021,1,2,1,5,0
10217,6,282,207,111,150,11,0,50,218,5,26,19,36,31,55,133,272,3,943,52,0,2,6,1,1
10218,6,282,410,198,237,31,55,97,441,11,63,38,72,74,110,414,683,6,4293,238,0,2,6,1,1
10242,11,497,127,75,83,2,11,30,129,4,14,7,14,18,21,61,87,2,175,9,0,0,71,0,1
10243,11,497,652,304,544,16,6,88,668,6,89,51,101,95,152,591,998,3,3399,188,0,0,71,0,1
10244,11,497,2,2,2,0,0,0,2,0,0,0,0,0,0,0,0,0,0,0,0,0,71,0,1
10245,11,497,8,5,5,0,0,3,8,0,0,0,0,0,0,0,0,0,0,0,0,0,71,0,1
10248,11,497,14,8,8,0,0,6,14,0,0,0,0,0,0,0,0,0,0,0,0,0,71,0,1
10249,11,497,6,4,4,0,0,2,6,0,0,0,0,0,0,0,0,0,0,0,0,0,71,0,1
10250,11,497,6,4,4,0,0,2,6,1,2,1,2,3,3,2,4,0,2,0,0,0,71,0,1
10252,11,497,7,5,5,0,0,2,7,0,0,0,0,0,0,0,0,0,0,0,0,0,71,0,1
10254,11,497,10,6,6,0,0,4,10,0,0,0,0,0,0,0,0,0,0,0,0,0,71,0,1
10255,11,497,1,1,1,0,0,0,1,0,0,0,0,0,0,0,0,0,0,0,0,0,71,0,1
10257,11,497,14,10,10,0,0,4,14,1,1,1,1,2,2,0,2,0,1,0,0,0,71,0,1
10258,11,497,46,26,30,3,0,12,49,3,6,3,6,9,9,20,28,1,42,2,0,0,71,0,1
10259,36,512,282,196,195,3,0,86,285,8,130,71,141,138,212,936,1507,4,6538,363,0,2,2,2,0
10325,65,1702,1513,682,1277,25,13,200,1538,11,199,116,219,210,335,1557,2584,6,15641,868,0,2,28,4,1
10326,65,1702,819,519,539,24,98,155,843,15,96,57,106,111,163,690,1107,8,9171,509,0,2,28,4,1
10327,43,852,215,129,180,6,0,29,221,8,65,43,72,73,115,415,711,4,3153,175,0,2,18,17,1
10328,43,852,97,69,77,3,3,16,100,6,22,13,23,28,36,113,173,3,542,30,0,2,18,17,1
10329,133,2262,1338,495,1086,10,64,173,1348,11,122,82,157,133,239,883,1686,7,11934,663,0,2,1,1,1
10330,6,261,207,111,150,11,0,50,218,5,26,19,36,31,55,133,272,3,943,52,0,2,1,6,1
10331,6,261,410,198,237,31,55,97,441,11,63,38,72,74,110,414,683,6,4293,238,0,2,1,6,1
10378,73,1676,773,419,590,28,0,166,801,10,204,113,217,214,330,1598,2554,5,13587,754,0,2,1,1,0
10379,73,1676,421,273,302,44,34,57,465,17,81,59,107,98,166,583,1098,11,12329,684,0,2,1,1,0
10566,185,4092,182,127,129,0,0,53,182,5,39,21,42,44,63,217,343,2,926,51,0,2,1,4,1
10567,185,4092,1165,710,800,67,119,181,1232,18,243,153,282,261,435,2000,3492,10,36473,2026,1,2,1,4,1
10568,102,3828,1392,870,1177,35,17,170,1427,14,494,280,531,508,811,4473,7289,7,54850,3047,2,2,1,4,1
10569,9,526,1289,550,1043,56,32,155,1345,10,167,93,185,177,278,1266,2075,5,11498,638,0,2,15,11,1
10616,73,1670,773,419,590,28,0,166,801,10,204,113,217,214,330,1598,2554,5,13587,754,0,2,2,3,1
10617,73,1670,421,273,302,44,34,57,465,17,81,59,107,98,166,583,1098,11,12329,684,0,2,2,3,1
10618,11,515,127,75,83,2,11,30,129,4,14,7,14,18,21,61,87,2,175,9,0,2,7,5,1
10619,11,515,652,304,544,16,6,88,668,6,89,51,101,95,152,591,998,3,3399,188,0,2,7,5,1
10620,11,515,2,2,2,0,0,0,2,0,0,0,0,0,0,0,0,0,0,0,0,2,7,5,1
10621,11,515,8,5,5,0,0,3,8,0,0,0,0,0,0,0,0,0,0,0,0,2,7,5,1
10624,11,515,14,8,8,0,0,6,14,0,0,0,0,0,0,0,0,0,0,0,0,2,7,5,1
10625,11,515,6,4,4,0,0,2,6,0,0,0,0,0,0,0,0,0,0,0,0,2,7,5,1
10626,11,515,6,4,4,0,0,2,6,1,2,1,2,3,3,2,4,0,2,0,0,2,7,5,1
10628,11,515,7,5,5,0,0,2,7,0,0,0,0,0,0,0,0,0,0,0,0,2,7,5,1
10630,11,515,10,6,6,0,0,4,10,0,0,0,0,0,0,0,0,0,0,0,0,2,7,5,1
10631,11,515,1,1,1,0,0,0,1,0,0,0,0,0,0,0,0,0,0,0,0,2,7,5,1
10633,11,515,14,10,10,0,0,4,14,1,1,1,1,2,2,0,2,0,1,0,0,2,7,5,1
10634,11,515,46,26,30,3,0,12,49,3,6,3,6,9,9,20,28,1,42,2,0,2,7,5,1
10635,74,1693,773,419,590,28,0,166,801,10,204,113,217,214,330,1598,2554,5,13587,754,0,2,9,1,0
10636,74,1693,421,273,302,44,34,57,465,17,81,59,107,98,166,583,1098,11,12329,684,0,2,9,1,0
10660,17,326,127,75,83,2,11,30,129,4,14,7,14,18,21,61,87,2,175,9,0,3,1,1,1
10661,17,326,652,304,544,16,6,88,668,6,89,51,101,95,152,591,998,3,3399,188,0,3,1,1,1
10662,17,326,2,2,2,0,0,0,2,0,0,0,0,0,0,0,0,0,0,0,0,3,1,1,1
10663,17,326,8,5,5,0,0,3,8,0,0,0,0,0,0,0,0,0,0,0,0,3,1,1,1
10666,17,326,14,8,8,0,0,6,14,0,0,0,0,0,0,0,0,0,0,0,0,3,1,1,1
10667,17,326,6,4,4,0,0,2,6,0,0,0,0,0,0,0,0,0,0,0,0,3,1,1,1
10668,17,326,6,4,4,0,0,2,6,1,2,1,2,3,3,2,4,0,2,0,0,3,1,1,1
10670,17,326,7,5,5,0,0,2,7,0,0,0,0,0,0,0,0,0,0,0,0,3,1,1,1
10672,17,326,10,6,6,0,0,4,10,0,0,0,0,0,0,0,0,0,0,0,0,3,1,1,1
10673,17,326,1,1,1,0,0,0,1,0,0,0,0,0,0,0,0,0,0,0,0,3,1,1,1
10675,17,326,14,10,10,0,0,4,14,1,1,1,1,2,2,0,2,0,1,0,0,3,1,1,1
10676,17,326,46,26,30,3,0,12,49,3,6,3,6,9,9,20,28,1,42,2,0,3,1,1,1
10677,7,111,44,19,17,0,16,11,44,3,14,7,14,17,21,58,85,1,128,7,0,2,1,1,1
10678,2,29,127,75,83,2,11,30,129,4,14,7,14,18,21,61,87,2,175,9,0,2,1,1,1
10679,2,29,652,304,544,16,6,88,668,6,89,51,101,95,152,591,998,3,3399,188,0,2,1,1,1
10680,2,29,2,2,2,0,0,0,2,0,0,0,0,0,0,0,0,0,0,0,0,2,1,1,1
10681,2,29,8,5,5,0,0,3,8,0,0,0,0,0,0,0,0,0,0,0,0,2,1,1,1
10684,2,29,14,8,8,0,0,6,14,0,0,0,0,0,0,0,0,0,0,0,0,2,1,1,1
10685,2,29,6,4,4,0,0,2,6,0,0,0,0,0,0,0,0,0,0,0,0,2,1,1,1
10686,2,29,6,4,4,0,0,2,6,1,2,1,2,3,3,2,4,0,2,0,0,2,1,1,1
10688,2,29,7,5,5,0,0,2,7,0,0,0,0,0,0,0,0,0,0,0,0,2,1,1,1
10690,2,29,10,6,6,0,0,4,10,0,0,0,0,0,0,0,0,0,0,0,0,2,1,1,1
10691,2,29,1,1,1,0,0,0,1,0,0,0,0,0,0,0,0,0,0,0,0,2,1,1,1
10693,2,29,14,10,10,0,0,4,14,1,1,1,1,2,2,0,2,0,1,0,0,2,1,1,1
10694,2,29,46,26,30,3,0,12,49,3,6,3,6,9,9,20,28,1,42,2,0,2,1,1,1
10695,6,108,127,75,83,2,11,30,129,4,14,7,14,18,21,61,87,2,175,9,0,2,1,1,1
10696,6,108,652,304,544,16,6,88,668,6,89,51,101,95,152,591,998,3,3399,188,0,2,1,1,1
10697,6,108,2,2,2,0,0,0,2,0,0,0,0,0,0,0,0,0,0,0,0,2,1,1,1
10698,6,108,8,5,5,0,0,3,8,0,0,0,0,0,0,0,0,0,0,0,0,2,1,1,1
10701,6,108,14,8,8,0,0,6,14,0,0,0,0,0,0,0,0,0,0,0,0,2,1,1,1
10702,6,108,6,4,4,0,0,2,6,0,0,0,0,0,0,0,0,0,0,0,0,2,1,1,1
10703,6,108,6,4,4,0,0,2,6,1,2,1,2,3,3,2,4,0,2,0,0,2,1,1,1
10705,6,108,7,5,5,0,0,2,7,0,0,0,0,0,0,0,0,0,0,0,0,2,1,1,1
10707,6,108,10,6,6,0,0,4,10,0,0,0,0,0,0,0,0,0,0,0,0,2,1,1,1
10708,6,108,1,1,1,0,0,0,1,0,0,0,0,0,0,0,0,0,0,0,0,2,1,1,1
10710,6,108,14,10,10,0,0,4,14,1,1,1,1,2,2,0,2,0,1,0,0,2,1,1,1
10711,6,108,46,26,30,3,0,12,49,3,6,3,6,9,9,20,28,1,42,2,0,2,1,1,1
11054,7,169,127,75,83,2,11,30,129,4,14,7,14,18,21,61,87,2,175,9,0,3,10,4,1
11055,7,169,652,304,544,16,6,88,668,6,89,51,101,95,152,591,998,3,3399,188,0,3,10,4,1
11056,7,169,2,2,2,0,0,0,2,0,0,0,0,0,0,0,0,0,0,0,0,3,10,4,1
11057,7,169,8,5,5,0,0,3,8,0,0,0,0,0,0,0,0,0,0,0,0,3,10,4,1
11060,7,169,14,8,8,0,0,6,14,0,0,0,0,0,0,0,0,0,0,0,0,3,10,4,1
11061,7,169,6,4,4,0,0,2,6,0,0,0,0,0,0,0,0,0,0,0,0,3,10,4,1
11062,7,169,6,4,4,0,0,2,6,1,2,1,2,3,3,2,4,0,2,0,0,3,10,4,1
11064,7,169,7,5,5,0,0,2,7,0,0,0,0,0,0,0,0,0,0,0,0,3,10,4,1
11066,7,169,10,6,6,0,0,4,10,0,0,0,0,0,0,0,0,0,0,0,0,3,10,4,1
11067,7,169,1,1,1,0,0,0,1,0,0,0,0,0,0,0,0,0,0,0,0,3,10,4,1
11069,7,169,14,10,10,0,0,4,14,1,1,1,1,2,2,0,2,0,1,0,0,3,10,4,1
11070,7,169,46,26,30,3,0,12,49,3,6,3,6,9,9,20,28,1,42,2,0,3,10,4,1
11099,1,71,42,7,35,4,0,5,46,1,2,1,2,3,3,2,4,0,2,0,0,0,11,0,1
11100,1,71,11,6,10,0,0,1,11,2,4,2,4,6,6,10,15,1,15,0,0,0,11,0,1
11147,2,223,42,7,35,4,0,5,46,1,2,1,2,3,3,2,4,0,2,0,0,2,5,39,1
11148,2,223,11,6,10,0,0,1,11,2,4,2,4,6,6,10,15,1,15,0,0,2,5,39,1
11149,186,4149,182,127,129,0,0,53,182,5,39,21,42,44,63,217,343,2,926,51,0,2,12,10,0
11150,186,4149,1165,710,800,67,119,181,1232,18,243,153,282,261,435,2000,3492,10,36473,2026,1,2,12,10,0
11151,34,1110,182,127,129,0,0,53,182,5,39,21,42,44,63,217,343,2,926,51,0,2,1,1,0
11152,11,269,127,75,83,2,11,30,129,4,14,7,14,18,21,61,87,2,175,9,0,0,46,0,0
11153,11,269,652,304,544,16,6,88,668,6,89,51,101,95,152,591,998,3,3399,188,0,0,46,0,0
11154,11,269,2,2,2,0,0,0,2,0,0,0,0,0,0,0,0,0,0,0,0,0,46,0,0
11155,11,269,8,5,5,0,0,3,8,0,0,0,0,0,0,0,0,0,0,0,0,0,46,0,0
11158,11,269,14,8,8,0,0,6,14,0,0,0,0,0,0,0,0,0,0,0,0,0,46,0,0
11159,11,269,6,4,4,0,0,2,6,0,0,0,0,0,0,0,0,0,0,0,0,0,46,0,0
11160,11,269,6,4,4,0,0,2,6,1,2,1,2,3,3,2,4,0,2,0,0,0,46,0,0
11162,11,269,7,5,5,0,0,2,7,0,0,0,0,0,0,0,0,0,0,0,0,0,46,0,0
11164,11,269,10,6,6,0,0,4,10,0,0,0,0,0,0,0,0,0,0,0,0,0,46,0,0
11165,11,269,1,1,1,0,0,0,1,0,0,0,0,0,0,0,0,0,0,0,0,0,46,0,0
11167,11,269,14,10,10,0,0,4,14,1,1,1,1,2,2,0,2,0,1,0,0,0,46,0,0
11168,11,269,46,26,30,3,0,12,49,3,6,3,6,9,9,20,28,1,42,2,0,0,46,0,0
11169,40,353,647,139,84,35,284,233,682,0,0,0,0,0,0,0,0,0,0,0,0,2,9,0,0
11170,11,269,127,75,83,2,11,30,129,4,14,7,14,18,21,61,87,2,175,9,0,2,1,1,1
11171,11,269,652,304,544,16,6,88,668,6,89,51,101,95,152,591,998,3,3399,188,0,2,1,1,1
11172,11,269,2,2,2,0,0,0,2,0,0,0,0,0,0,0,0,0,0,0,0,2,1,1,1
11173,11,269,8,5,5,0,0,3,8,0,0,0,0,0,0,0,0,0,0,0,0,2,1,1,1
11176,11,269,14,8,8,0,0,6,14,0,0,0,0,0,0,0,0,0,0,0,0,2,1,1,1
11177,11,269,6,4,4,0,0,2,6,0,0,0,0,0,0,0,0,0,0,0,0,2,1,1,1
11178,11,269,6,4,4,0,0,2,6,1,2,1,2,3,3,2,4,0,2,0,0,2,1,1,1
11180,11,269,7,5,5,0,0,2,7,0,0,0,0,0,0,0,0,0,0,0,0,2,1,1,1
11182,11,269,10,6,6,0,0,4,10,0,0,0,0,0,0,0,0,0,0,0,0,2,1,1,1
11183,11,269,1,1,1,0,0,0,1,0,0,0,0,0,0,0,0,0,0,0,0,2,1,1,1
11185,11,269,14,10,10,0,0,4,14,1,1,1,1,2,2,0,2,0,1,0,0,2,1,1,1
11186,11,269,46,26,30,3,0,12,49,3,6,3,6,9,9,20,28,1,42,2,0,2,1,1,1
11204,3,58,127,75,83,2,11,30,129,4,14,7,14,18,21,61,87,2,175,9,0,0,7,0,1
11205,3,58,652,304,544,16,6,88,668,6,89,51,101,95,152,591,998,3,3399,188,0,0,7,0,1
11206,3,58,2,2,2,0,0,0,2,0,0,0,0,0,0,0,0,0,0,0,0,0,7,0,1
11207,3,58,8,5,5,0,0,3,8,0,0,0,0,0,0,0,0,0,0,0,0,0,7,0,1
11210,3,58,14,8,8,0,0,6,14,0,0,0,0,0,0,0,0,0,0,0,0,0,7,0,1
11211,3,58,6,4,4,0,0,2,6,0,0,0,0,0,0,0,0,0,0,0,0,0,7,0,1
11212,3,58,6,4,4,0,0,2,6,1,2,1,2,3,3,2,4,0,2,0,0,0,7,0,1
11214,3,58,7,5,5,0,0,2,7,0,0,0,0,0,0,0,0,0,0,0,0,0,7,0,1
11216,3,58,10,6,6,0,0,4,10,0,0,0,0,0,0,0,0,0,0,0,0,0,7,0,1
11217,3,58,1,1,1,0,0,0,1,0,0,0,0,0,0,0,0,0,0,0,0,0,7,0,1
11219,3,58,14,10,10,0,0,4,14,1,1,1,1,2,2,0,2,0,1,0,0,0,7,0,1
11220,3,58,46,26,30,3,0,12,49,3,6,3,6,9,9,20,28,1,42,2,0,0,7,0,1
11221,1,9,2,2,2,0,0,0,2,0,0,0,0,0,0,0,0,0,0,0,0,0,5,0,1
11222,3,65,127,75,83,2,11,30,129,4,14,7,14,18,21,61,87,2,175,9,0,0,15,0,1
11223,3,65,652,304,544,16,6,88,668,6,89,51,101,95,152,591,998,3,3399,188,0,0,15,0,1
11224,3,65,2,2,2,0,0,0,2,0,0,0,0,0,0,0,0,0,0,0,0,0,15,0,1
11225,3,65,8,5,5,0,0,3,8,0,0,0,0,0,0,0,0,0,0,0,0,0,15,0,1
11228,3,65,14,8,8,0,0,6,14,0,0,0,0,0,0,0,0,0,0,0,0,0,15,0,1
11229,3,65,6,4,4,0,0,2,6,0,0,0,0,0,0,0,0,0,0,0,0,0,15,0,1
11230,3,65,6,4,4,0,0,2,6,1,2,1,2,3,3,2,4,0,2,0,0,0,15,0,1
11232,3,65,7,5,5,0,0,2,7,0,0,0,0,0,0,0,0,0,0,0,0,0,15,0,1
11234,3,65,10,6,6,0,0,4,10,0,0,0,0,0,0,0,0,0,0,0,0,0,15,0,1
11235,3,65,1,1,1,0,0,0,1,0,0,0,0,0,0,0,0,0,0,0,0,0,15,0,1
11237,3,65,14,10,10,0,0,4,14,1,1,1,1,2,2,0,2,0,1,0,0,0,15,0,1
11238,3,65,46,26,30,3,0,12,49,3,6,3,6,9,9,20,28,1,42,2,0,0,15,0,1
11239,56,1928,773,419,590,28,0,166,801,10,204,113,217,214,330,1598,2554,5,13587,754,0,2,5,5,1
11240,12,380,15,9,9,0,0,6,15,0,0,0,0,0,0,0,0,0,0,0,0,2,1,1,0
11242,19,349,127,75,83,2,11,30,129,4,14,7,14,18,21,61,87,2,175,9,0,2,6,3,1
11243,19,349,652,304,544,16,6,88,668,6,89,51,101,95,152,591,998,3,3399,188,0,2,6,3,1
11244,19,349,2,2,2,0,0,0,2,0,0,0,0,0,0,0,0,0,0,0,0,2,6,3,1
11245,19,349,8,5,5,0,0,3,8,0,0,0,0,0,0,0,0,0,0,0,0,2,6,3,1
11248,19,349,14,8,8,0,0,6,14,0,0,0,0,0,0,0,0,0,0,0,0,2,6,3,1
11249,19,349,6,4,4,0,0,2,6,0,0,0,0,0,0,0,0,0,0,0,0,2,6,3,1
11250,19,349,6,4,4,0,0,2,6,1,2,1,2,3,3,2,4,0,2,0,0,2,6,3,1
11252,19,349,7,5,5,0,0,2,7,0,0,0,0,0,0,0,0,0,0,0,0,2,6,3,1
11254,19,349,10,6,6,0,0,4,10,0,0,0,0,0,0,0,0,0,0,0,0,2,6,3,1
11255,19,349,1,1,1,0,0,0,1,0,0,0,0,0,0,0,0,0,0,0,0,2,6,3,1
11257,19,349,14,10,10,0,0,4,14,1,1,1,1,2,2,0,2,0,1,0,0,2,6,3,1
11258,19,349,46,26,30,3,0,12,49,3,6,3,6,9,9,20,28,1,42,2,0,2,6,3,1
11259,6,106,127,75,83,2,11,30,129,4,14,7,14,18,21,61,87,2,175,9,0,2,1,1,1
11260,6,106,652,304,544,16,6,88,668,6,89,51,101,95,152,591,998,3,3399,188,0,2,1,1,1
11261,6,106,2,2,2,0,0,0,2,0,0,0,0,0,0,0,0,0,0,0,0,2,1,1,1
11262,6,106,8,5,5,0,0,3,8,0,0,0,0,0,0,0,0,0,0,0,0,2,1,1,1
11265,6,106,14,8,8,0,0,6,14,0,0,0,0,0,0,0,0,0,0,0,0,2,1,1,1
11266,6,106,6,4,4,0,0,2,6,0,0,0,0,0,0,0,0,0,0,0,0,2,1,1,1
11267,6,106,6,4,4,0,0,2,6,1,2,1,2,3,3,2,4,0,2,0,0,2,1,1,1
11269,6,106,7,5,5,0,0,2,7,0,0,0,0,0,0,0,0,0,0,0,0,2,1,1,1
11271,6,106,10,6,6,0,0,4,10,0,0,0,0,0,0,0,0,0,0,0,0,2,1,1,1
11272,6,106,1,1,1,0,0,0,1,0,0,0,0,0,0,0,0,0,0,0,0,2,1,1,1
11274,6,106,14,10,10,0,0,4,14,1,1,1,1,2,2,0,2,0,1,0,0,2,1,1,1
11275,6,106,46,26,30,3,0,12,49,3,6,3,6,9,9,20,28,1,42,2,0,2,1,1,1
11345,80,1742,1457,730,1242,11,6,188,1468,10,292,166,329,302,495,2424,4078,5,22973,1276,1,2,2,1,1
11346,80,1742,74,35,59,1,0,14,75,3,14,7,14,17,21,58,85,1,128,7,0,2,2,1,1
11347,80,1742,245,125,200,5,7,34,250,7,30,17,34,37,51,166,265,3,1053,58,0,2,2,1,1
11348,2,219,42,7,35,4,0,5,46,1,2,1,2,3,3,2,4,0,2,0,0,2,4,8,1
11349,2,219,11,6,10,0,0,1,11,2,4,2,4,6,6,10,15,1,15,0,0,2,4,8,1
11390,28,538,334,251,279,10,4,40,344,5,127,74,143,132,217,899,1528,2,4303,239,0,2,5,0,1
11408,34,1920,1457,730,1242,11,6,188,1468,10,292,166,329,302,495,2424,4078,5,22973,1276,1,2,1,0,1
11409,16,752,334,251,279,10,4,40,344,5,127,74,143,132,217,899,1528,2,4303,239,0,2,15,0,1
11433,2,219,42,7,35,4,0,5,46,1,2,1,2,3,3,2,4,0,2,0,0,2,4,4,1
11434,2,219,11,6,10,0,0,1,11,2,4,2,4,6,6,10,15,1,15,0,0,2,4,4,1
11527,15,428,1450,624,1228,12,26,181,1462,14,306,186,354,320,540,2580,4493,8,36391,2021,1,3,2,2,1
11528,186,4143,182,127,129,0,0,53,182,5,39,21,42,44,63,217,343,2,926,51,0,3,3,3,1
11529,186,4143,1165,710,800,67,119,181,1232,18,243,153,282,261,435,2000,3492,10,36473,2026,1,3,3,3,1
11721,133,2264,1338,495,1086,10,64,173,1348,11,122,82,157,133,239,883,1686,7,11934,663,0,3,1,1,1
11724,79,1733,1457,730,1242,11,6,188,1468,10,292,166,329,302,495,2424,4078,5,22973,1276,1,3,11,13,1
11725,79,1733,74,35,59,1,0,14,75,3,14,7,14,17,21,58,85,1,128,7,0,3,11,13,1
11726,79,1733,245,125,200,5,7,34,250,7,30,17,34,37,51,166,265,3,1053,58,0,3,11,13,1
11799,74,1701,384,251,317,7,8,52,391,11,70,44,84,81,128,467,811,6,5355,297,0,3,6,6,1
11800,36,669,373,158,315,8,0,51,381,5,76,44,79,81,123,486,779,2,2026,112,0,3,1,1,1
11870,2,221,42,7,35,4,0,5,46,1,2,1,2,3,3,2,4,0,2,0,0,2,27,32,1
11871,2,221,11,6,10,0,0,1,11,2,4,2,4,6,6,10,15,1,15,0,0,2,27,32,1
11872,43,935,1450,624,1228,12,26,181,1462,14,306,186,354,320,540,2580,4493,8,36391,2021,1,2,1,1,1
11873,34,1106,182,127,129,0,0,53,182,5,39,21,42,44,63,217,343,2,926,51,0,2,2,2,1
11874,102,3828,1392,870,1177,35,17,170,1427,14,494,280,531,508,811,4473,7289,7,54850,3047,2,2,3,3,1
11875,56,1918,773,419,590,28,0,166,801,10,204,113,217,214,330,1598,2554,5,13587,754,0,2,5,5,1
11876,47,1953,1513,682,1277,25,13,200,1538,11,199,116,219,210,335,1557,2584,6,15641,868,0,2,1,1,1
11877,11,513,127,75,83,2,11,30,129,4,14,7,14,18,21,61,87,2,175,9,0,2,1,1,1
11878,11,513,652,304,544,16,6,88,668,6,89,51,101,95,152,591,998,3,3399,188,0,2,1,1,1
11879,11,513,2,2,2,0,0,0,2,0,0,0,0,0,0,0,0,0,0,0,0,2,1,1,1
11880,11,513,8,5,5,0,0,3,8,0,0,0,0,0,0,0,0,0,0,0,0,2,1,1,1
11883,11,513,14,8,8,0,0,6,14,0,0,0,0,0,0,0,0,0,0,0,0,2,1,1,1
11884,11,513,6,4,4,0,0,2,6,0,0,0,0,0,0,0,0,0,0,0,0,2,1,1,1
11885,11,513,6,4,4,0,0,2,6,1,2,1,2,3,3,2,4,0,2,0,0,2,1,1,1
11887,11,513,7,5,5,0,0,2,7,0,0,0,0,0,0,0,0,0,0,0,0,2,1,1,1
11889,11,513,10,6,6,0,0,4,10,0,0,0,0,0,0,0,0,0,0,0,0,2,1,1,1
11890,11,513,1,1,1,0,0,0,1,0,0,0,0,0,0,0,0,0,0,0,0,2,1,1,1
11892,11,513,14,10,10,0,0,4,14,1,1,1,1,2,2,0,2,0,1,0,0,2,1,1,1
11893,11,513,46,26,30,3,0,12,49,3,6,3,6,9,9,20,28,1,42,2,0,2,1,1,1
11894,7,169,127,75,83,2,11,30,129,4,14,7,14,18,21,61,87,2,175,9,0,2,2,2,1
11895,7,169,652,304,544,16,6,88,668,6,89,51,101,95,152,591,998,3,3399,188,0,2,2,2,1
11896,7,169,2,2,2,0,0,0,2,0,0,0,0,0,0,0,0,0,0,0,0,2,2,2,1
11897,7,169,8,5,5,0,0,3,8,0,0,0,0,0,0,0,0,0,0,0,0,2,2,2,1
11900,7,169,14,8,8,0,0,6,14,0,0,0,0,0,0,0,0,0,0,0,0,2,2,2,1
11901,7,169,6,4,4,0,0,2,6,0,0,0,0,0,0,0,0,0,0,0,0,2,2,2,1
11902,7,169,6,4,4,0,0,2,6,1,2,1,2,3,3,2,4,0,2,0,0,2,2,2,1
11904,7,169,7,5,5,0,0,2,7,0,0,0,0,0,0,0,0,0,0,0,0,2,2,2,1
11906,7,169,10,6,6,0,0,4,10,0,0,0,0,0,0,0,0,0,0,0,0,2,2,2,1
11907,7,169,1,1,1,0,0,0,1,0,0,0,0,0,0,0,0,0,0,0,0,2,2,2,1
11909,7,169,14,10,10,0,0,4,14,1,1,1,1,2,2,0,2,0,1,0,0,2,2,2,1
11910,7,169,46,26,30,3,0,12,49,3,6,3,6,9,9,20,28,1,42,2,0,2,2,2,1
11911,4,223,207,111,150,11,0,50,218,5,26,19,36,31,55,133,272,3,943,52,0,2,2,2,1
11912,34,1914,1457,730,1242,11,6,188,1468,10,292,166,329,302,495,2424,4078,5,22973,1276,1,2,3,3,1
11913,16,750,334,251,279,10,4,40,344,5,127,74,143,132,217,899,1528,2,4303,239,0,2,1,1,1
11914,29,1453,384,251,317,7,8,52,391,11,70,44,84,81,128,467,811,6,5355,297,0,2,3,3,1
11961,2,223,42,7,35,4,0,5,46,1,2,1,2,3,3,2,4,0,2,0,0,2,3,5,1
11962,2,223,11,6,10,0,0,1,11,2,4,2,4,6,6,10,15,1,15,0,0,2,3,5,1
12026,16,759,334,251,279,10,4,40,344,5,127,74,143,132,217,899,1528,2,4303,239,0,2,12,10,1
12050,42,923,1450,624,1228,12,26,181,1462,14,306,186,354,320,540,2580,4493,8,36391,2021,1,2,1,5,1
12051,55,1910,773,419,590,28,0,166,801,10,204,113,217,214,330,1598,2554,5,13587,754,0,2,1,3,1
12052,78,1734,384,251,317,7,8,52,391,11,70,44,84,81,128,467,811,6,5355,297,0,2,17,10,1
12053,30,1536,384,251,317,7,8,52,391,11,70,44,84,81,128,467,811,6,5355,297,0,2,11,1,1
12054,28,548,334,251,279,10,4,40,344,5,127,74,143,132,217,899,1528,2,4303,239,0,2,12,10,1
12055,19,349,127,75,83,2,11,30,129,4,14,7,14,18,21,61,87,2,175,9,0,2,1,1,1
12056,19,349,652,304,544,16,6,88,668,6,89,51,101,95,152,591,998,3,3399,188,0,2,1,1,1
12057,19,349,2,2,2,0,0,0,2,0,0,0,0,0,0,0,0,0,0,0,0,2,1,1,1
12058,19,349,8,5,5,0,0,3,8,0,0,0,0,0,0,0,0,0,0,0,0,2,1,1,1
12061,19,349,14,8,8,0,0,6,14,0,0,0,0,0,0,0,0,0,0,0,0,2,1,1,1
12062,19,349,6,4,4,0,0,2,6,0,0,0,0,0,0,0,0,0,0,0,0,2,1,1,1
12063,19,349,6,4,4,0,0,2,6,1,2,1,2,3,3,2,4,0,2,0,0,2,1,1,1
12065,19,349,7,5,5,0,0,2,7,0,0,0,0,0,0,0,0,0,0,0,0,2,1,1,1
12067,19,349,10,6,6,0,0,4,10,0,0,0,0,0,0,0,0,0,0,0,0,2,1,1,1
12068,19,349,1,1,1,0,0,0,1,0,0,0,0,0,0,0,0,0,0,0,0,2,1,1,1
12070,19,349,14,10,10,0,0,4,14,1,1,1,1,2,2,0,2,0,1,0,0,2,1,1,1
12071,19,349,46,26,30,3,0,12,49,3,6,3,6,9,9,20,28,1,42,2,0,2,1,1,1
12072,19,842,334,251,279,10,4,40,344,5,127,74,143,132,217,899,1528,2,4303,239,0,2,15,3,1
12073,19,349,127,75,83,2,11,30,129,4,14,7,14,18,21,61,87,2,175,9,0,2,2,2,1
12074,19,349,652,304,544,16,6,88,668,6,89,51,101,95,152,591,998,3,3399,188,0,2,2,2,1
12075,19,349,2,2,2,0,0,0,2,0,0,0,0,0,0,0,0,0,0,0,0,2,2,2,1
12076,19,349,8,5,5,0,0,3,8,0,0,0,0,0,0,0,0,0,0,0,0,2,2,2,1
12079,19,349,14,8,8,0,0,6,14,0,0,0,0,0,0,0,0,0,0,0,0,2,2,2,1
12080,19,349,6,4,4,0,0,2,6,0,0,0,0,0,0,0,0,0,0,0,0,2,2,2,1
12081,19,349,6,4,4,0,0,2,6,1,2,1,2,3,3,2,4,0,2,0,0,2,2,2,1
12083,19,349,7,5,5,0,0,2,7,0,0,0,0,0,0,0,0,0,0,0,0,2,2,2,1
12085,19,349,10,6,6,0,0,4,10,0,0,0,0,0,0,0,0,0,0,0,0,2,2,2,1
12086,19,349,1,1,1,0,0,0,1,0,0,0,0,0,0,0,0,0,0,0,0,2,2,2,1
12088,19,349,14,10,10,0,0,4,14,1,1,1,1,2,2,0,2,0,1,0,0,2,2,2,1
12089,19,349,46,26,30,3,0,12,49,3,6,3,6,9,9,20,28,1,42,2,0,2,2,2,1
12107,3,65,127,75,83,2,11,30,129,4,14,7,14,18,21,61,87,2,175,9,0,2,1,1,0
12108,3,65,652,304,544,16,6,88,668,6,89,51,101,95,152,591,998,3,3399,188,0,2,1,1,0
12109,3,65,2,2,2,0,0,0,2,0,0,0,0,0,0,0,0,0,0,0,0,2,1,1,0
12110,3,65,8,5,5,0,0,3,8,0,0,0,0,0,0,0,0,0,0,0,0,2,1,1,0
12113,3,65,14,8,8,0,0,6,14,0,0,0,0,0,0,0,0,0,0,0,0,2,1,1,0
12114,3,65,6,4,4,0,0,2,6,0,0,0,0,0,0,0,0,0,0,0,0,2,1,1,0
12115,3,65,6,4,4,0,0,2,6,1,2,1,2,3,3,2,4,0,2,0,0,2,1,1,0
12117,3,65,7,5,5,0,0,2,7,0,0,0,0,0,0,0,0,0,0,0,0,2,1,1,0
12119,3,65,10,6,6,0,0,4,10,0,0,0,0,0,0,0,0,0,0,0,0,2,1,1,0
12120,3,65,1,1,1,0,0,0,1,0,0,0,0,0,0,0,0,0,0,0,0,2,1,1,0
12122,3,65,14,10,10,0,0,4,14,1,1,1,1,2,2,0,2,0,1,0,0,2,1,1,0
12123,3,65,46,26,30,3,0,12,49,3,6,3,6,9,9,20,28,1,42,2,0,2,1,1,0
12124,34,1914,1457,730,1242,11,6,188,1468,10,292,166,329,302,495,2424,4078,5,22973,1276,1,2,1,1,0
12125,133,2248,1338,495,1086,10,64,173,1348,11,122,82,157,133,239,883,1686,7,11934,663,0,2,1,2,1
12126,78,1725,1457,730,1242,11,6,188,1468,10,292,166,329,302,495,2424,4078,5,22973,1276,1,2,2,2,1
12127,78,1725,74,35,59,1,0,14,75,3,14,7,14,17,21,58,85,1,128,7,0,2,2,2,1
12128,78,1725,245,125,200,5,7,34,250,7,30,17,34,37,51,166,265,3,1053,58,0,2,2,2,1
12152,102,3815,1392,870,1177,35,17,170,1427,14,494,280,531,508,811,4473,7289,7,54850,3047,2,2,1,1,1
12153,7,160,127,75,83,2,11,30,129,4,14,7,14,18,21,61,87,2,175,9,0,2,1,1,1
12154,7,160,652,304,544,16,6,88,668,6,89,51,101,95,152,591,998,3,3399,188,0,2,1,1,1
12155,7,160,2,2,2,0,0,0,2,0,0,0,0,0,0,0,0,0,0,0,0,2,1,1,1
12156,7,160,8,5,5,0,0,3,8,0,0,0,0,0,0,0,0,0,0,0,0,2,1,1,1
12159,7,160,14,8,8,0,0,6,14,0,0,0,0,0,0,0,0,0,0,0,0,2,1,1,1
12160,7,160,6,4,4,0,0,2,6,0,0,0,0,0,0,0,0,0,0,0,0,2,1,1,1
12161,7,160,6,4,4,0,0,2,6,1,2,1,2,3,3,2,4,0,2,0,0,2,1,1,1
12163,7,160,7,5,5,0,0,2,7,0,0,0,0,0,0,0,0,0,0,0,0,2,1,1,1
12165,7,160,10,6,6,0,0,4,10,0,0,0,0,0,0,0,0,0,0,0,0,2,1,1,1
12166,7,160,1,1,1,0,0,0,1,0,0,0,0,0,0,0,0,0,0,0,0,2,1,1,1
12168,7,160,14,10,10,0,0,4,14,1,1,1,1,2,2,0,2,0,1,0,0,2,1,1,1
12169,7,160,46,26,30,3,0,12,49,3,6,3,6,9,9,20,28,1,42,2,0,2,1,1,1
12170,15,439,1450,624,1228,12,26,181,1462,14,306,186,354,320,540,2580,4493,8,36391,2021,1,2,1,1,1
12171,187,4157,182,127,129,0,0,53,182,5,39,21,42,44,63,217,343,2,926,51,0,2,3,0,1
12172,187,4157,1165,710,800,67,119,181,1232,18,243,153,282,261,435,2000,3492,10,36473,2026,1,2,3,0,1
12173,42,935,1450,624,1228,12,26,181,1462,14,306,186,354,320,540,2580,4493,8,36391,2021,1,2,2,0,1
12174,34,1126,182,127,129,0,0,53,182,5,39,21,42,44,63,217,343,2,926,51,0,2,6,0,1
12175,102,3816,1392,870,1177,35,17,170,1427,14,494,280,531,508,811,4473,7289,7,54850,3047,2,2,1,1,1
12176,42,923,1450,624,1228,12,26,181,1462,14,306,186,354,320,540,2580,4493,8,36391,2021,1,2,1,1,0
12270,2,206,42,7,35,4,0,5,46,1,2,1,2,3,3,2,4,0,2,0,0,2,8,13,1
12271,2,206,11,6,10,0,0,1,11,2,4,2,4,6,6,10,15,1,15,0,0,2,8,13,1
12297,2,180,42,7,35,4,0,5,46,1,2,1,2,3,3,2,4,0,2,0,0,2,7,22,1
12298,2,180,11,6,10,0,0,1,11,2,4,2,4,6,6,10,15,1,15,0,0,2,7,22,1
12497,19,385,127,75,83,2,11,30,129,4,14,7,14,18,21,61,87,2,175,9,0,2,10,1,0
12498,19,385,652,304,544,16,6,88,668,6,89,51,101,95,152,591,998,3,3399,188,0,2,10,1,0
12499,19,385,2,2,2,0,0,0,2,0,0,0,0,0,0,0,0,0,0,0,0,2,10,1,0
12500,19,385,8,5,5,0,0,3,8,0,0,0,0,0,0,0,0,0,0,0,0,2,10,1,0
12503,19,385,14,8,8,0,0,6,14,0,0,0,0,0,0,0,0,0,0,0,0,2,10,1,0
12504,19,385,6,4,4,0,0,2,6,0,0,0,0,0,0,0,0,0,0,0,0,2,10,1,0
12505,19,385,6,4,4,0,0,2,6,1,2,1,2,3,3,2,4,0,2,0,0,2,10,1,0
12507,19,385,7,5,5,0,0,2,7,0,0,0,0,0,0,0,0,0,0,0,0,2,10,1,0
12509,19,385,10,6,6,0,0,4,10,0,0,0,0,0,0,0,0,0,0,0,0,2,10,1,0
12510,19,385,1,1,1,0,0,0,1,0,0,0,0,0,0,0,0,0,0,0,0,2,10,1,0
12512,19,385,14,10,10,0,0,4,14,1,1,1,1,2,2,0,2,0,1,0,0,2,10,1,0
12513,19,385,46,26,30,3,0,12,49,3,6,3,6,9,9,20,28,1,42,2,0,2,10,1,0
12514,79,1735,1457,730,1242,11,6,188,1468,10,292,166,329,302,495,2424,4078,5,22973,1276,1,2,2,2,1
12515,79,1735,74,35,59,1,0,14,75,3,14,7,14,17,21,58,85,1,128,7,0,2,2,2,1
12516,79,1735,245,125,200,5,7,34,250,7,30,17,34,37,51,166,265,3,1053,58,0,2,2,2,1
12609,15,443,1450,624,1228,12,26,181,1462,14,306,186,354,320,540,2580,4493,8,36391,2021,1,3,2,2,1
12610,187,4163,182,127,129,0,0,53,182,5,39,21,42,44,63,217,343,2,926,51,0,3,3,3,1
12611,187,4163,1165,710,800,67,119,181,1232,18,243,153,282,261,435,2000,3492,10,36473,2026,1,3,3,3,1
12780,133,2248,1338,495,1086,10,64,173,1348,11,122,82,157,133,239,883,1686,7,11934,663,0,3,1,1,1
12783,79,1724,1457,730,1242,11,6,188,1468,10,292,166,329,302,495,2424,4078,5,22973,1276,1,3,4,5,1
12784,79,1724,74,35,59,1,0,14,75,3,14,7,14,17,21,58,85,1,128,7,0,3,4,5,1
12785,79,1724,245,125,200,5,7,34,250,7,30,17,34,37,51,166,265,3,1053,58,0,3,4,5,1
12834,78,1724,384,251,317,7,8,52,391,11,70,44,84,81,128,467,811,6,5355,297,0,3,7,6,1
12835,36,671,373,158,315,8,0,51,381,5,76,44,79,81,123,486,779,2,2026,112,0,3,1,1,1
12860,2,180,42,7,35,4,0,5,46,1,2,1,2,3,3,2,4,0,2,0,0,2,13,12,1
12861,2,180,11,6,10,0,0,1,11,2,4,2,4,6,6,10,15,1,15,0,0,2,13,12,1
12862,42,923,1450,624,1228,12,26,181,1462,14,306,186,354,320,540,2580,4493,8,36391,2021,1,2,1,1,1
12863,34,1130,182,127,129,0,0,53,182,5,39,21,42,44,63,217,343,2,926,51,0,2,2,2,1
12864,102,3818,1392,870,1177,35,17,170,1427,14,494,280,531,508,811,4473,7289,7,54850,3047,2,2,1,1,1
12865,55,1920,773,419,590,28,0,166,801,10,204,113,217,214,330,1598,2554,5,13587,754,0,2,5,5,1
12866,47,1955,1513,682,1277,25,13,200,1538,11,199,116,219,210,335,1557,2584,6,15641,868,0,2,1,1,1
12867,11,515,127,75,83,2,11,30,129,4,14,7,14,18,21,61,87,2,175,9,0,2,1,1,1
12868,11,515,652,304,544,16,6,88,668,6,89,51,101,95,152,591,998,3,3399,188,0,2,1,1,1
12869,11,515,2,2,2,0,0,0,2,0,0,0,0,0,0,0,0,0,0,0,0,2,1,1,1
12870,11,515,8,5,5,0,0,3,8,0,0,0,0,0,0,0,0,0,0,0,0,2,1,1,1
12873,11,515,14,8,8,0,0,6,14,0,0,0,0,0,0,0,0,0,0,0,0,2,1,1,1
12874,11,515,6,4,4,0,0,2,6,0,0,0,0,0,0,0,0,0,0,0,0,2,1,1,1
12875,11,515,6,4,4,0,0,2,6,1,2,1,2,3,3,2,4,0,2,0,0,2,1,1,1
12877,11,515,7,5,5,0,0,2,7,0,0,0,0,0,0,0,0,0,0,0,0,2,1,1,1
12879,11,515,10,6,6,0,0,4,10,0,0,0,0,0,0,0,0,0,0,0,0,2,1,1,1
12880,11,515,1,1,1,0,0,0,1,0,0,0,0,0,0,0,0,0,0,0,0,2,1,1,1
12882,11,515,14,10,10,0,0,4,14,1,1,1,1,2,2,0,2,0,1,0,0,2,1,1,1
12883,11,515,46,26,30,3,0,12,49,3,6,3,6,9,9,20,28,1,42,2,0,2,1,1,1
12907,7,172,127,75,83,2,11,30,129,4,14,7,14,18,21,61,87,2,175,9,0,3,3,2,1
12908,7,172,652,304,544,16,6,88,668,6,89,51,101,95,152,591,998,3,3399,188,0,3,3,2,1
12909,7,172,2,2,2,0,0,0,2,0,0,0,0,0,0,0,0,0,0,0,0,3,3,2,1
12910,7,172,8,5,5,0,0,3,8,0,0,0,0,0,0,0,0,0,0,0,0,3,3,2,1
12913,7,172,14,8,8,0,0,6,14,0,0,0,0,0,0,0,0,0,0,0,0,3,3,2,1
12914,7,172,6,4,4,0,0,2,6,0,0,0,0,0,0,0,0,0,0,0,0,3,3,2,1
12915,7,172,6,4,4,0,0,2,6,1,2,1,2,3,3,2,4,0,2,0,0,3,3,2,1
12917,7,172,7,5,5,0,0,2,7,0,0,0,0,0,0,0,0,0,0,0,0,3,3,2,1
12919,7,172,10,6,6,0,0,4,10,0,0,0,0,0,0,0,0,0,0,0,0,3,3,2,1
12920,7,172,1,1,1,0,0,0,1,0,0,0,0,0,0,0,0,0,0,0,0,3,3,2,1
12922,7,172,14,10,10,0,0,4,14,1,1,1,1,2,2,0,2,0,1,0,0,3,3,2,1
12923,7,172,46,26,30,3,0,12,49,3,6,3,6,9,9,20,28,1,42,2,0,3,3,2,1
12924,4,227,207,111,150,11,0,50,218,5,26,19,36,31,55,133,272,3,943,52,0,2,2,2,1
12925,34,1920,1457,730,1242,11,6,188,1468,10,292,166,329,302,495,2424,4078,5,22973,1276,1,2,3,3,1
12926,19,844,334,251,279,10,4,40,344,5,127,74,143,132,217,899,1528,2,4303,239,0,2,1,1,1
12927,30,1542,384,251,317,7,8,52,391,11,70,44,84,81,128,467,811,6,5355,297,0,2,3,3,1
12974,28,551,334,251,279,10,4,40,344,5,127,74,143,132,217,899,1528,2,4303,239,0,2,1,0,1
12975,2,178,42,7,35,4,0,5,46,1,2,1,2,3,3,2,4,0,2,0,0,2,2,3,1
12976,2,178,11,6,10,0,0,1,11,2,4,2,4,6,6,10,15,1,15,0,0,2,2,3,1
13000,2,178,42,7,35,4,0,5,46,1,2,1,2,3,3,2,4,0,2,0,0,2,1,1,0
13001,2,178,11,6,10,0,0,1,11,2,4,2,4,6,6,10,15,1,15,0,0,2,1,1,0
13002,9,523,1289,550,1043,56,32,155,1345,10,167,93,185,177,278,1266,2075,5,11498,638,0,2,3,3,0
13026,79,1731,1457,730,1242,11,6,188,1468,10,292,166,329,302,495,2424,4078,5,22973,1276,1,2,1,0,1
13027,79,1731,74,35,59,1,0,14,75,3,14,7,14,17,21,58,85,1,128,7,0,2,1,0,1
13028,79,1731,245,125,200,5,7,34,250,7,30,17,34,37,51,166,265,3,1053,58,0,2,1,0,1
13029,81,1771,384,251,317,7,8,52,391,11,70,44,84,81,128,467,811,6,5355,297,0,2,8,0,1
13030,33,1635,384,251,317,7,8,52,391,11,70,44,84,81,128,467,811,6,5355,297,0,2,18,0,1
13031,82,1777,384,251,317,7,8,52,391,11,70,44,84,81,128,467,811,6,5355,297,0,2,4,1,0
13032,34,1678,384,251,317,7,8,52,391,11,70,44,84,81,128,467,811,6,5355,297,0,2,7,0,0
13033,44,869,215,129,180,6,0,29,221,8,65,43,72,73,115,415,711,4,3153,175,0,2,2,0,0
13034,44,869,97,69,77,3,3,16,100,6,22,13,23,28,36,113,173,3,542,30,0,2,2,0,0
13035,4,84,127,75,83,2,11,30,129,4,14,7,14,18,21,61,87,2,175,9,0,2,3,0,1
13036,4,84,652,304,544,16,6,88,668,6,89,51,101,95,152,591,998,3,3399,188,0,2,3,0,1
13037,4,84,2,2,2,0,0,0,2,0,0,0,0,0,0,0,0,0,0,0,0,2,3,0,1
13038,4,84,8,5,5,0,0,3,8,0,0,0,0,0,0,0,0,0,0,0,0,2,3,0,1
13041,4,84,14,8,8,0,0,6,14,0,0,0,0,0,0,0,0,0,0,0,0,2,3,0,1
13042,4,84,6,4,4,0,0,2,6,0,0,0,0,0,0,0,0,0,0,0,0,2,3,0,1
13043,4,84,6,4,4,0,0,2,6,1,2,1,2,3,3,2,4,0,2,0,0,2,3,0,1
13045,4,84,7,5,5,0,0,2,7,0,0,0,0,0,0,0,0,0,0,0,0,2,3,0,1
13047,4,84,10,6,6,0,0,4,10,0,0,0,0,0,0,0,0,0,0,0,0,2,3,0,1
13048,4,84,1,1,1,0,0,0,1,0,0,0,0,0,0,0,0,0,0,0,0,2,3,0,1
13050,4,84,14,10,10,0,0,4,14,1,1,1,1,2,2,0,2,0,1,0,0,2,3,0,1
13051,4,84,46,26,30,3,0,12,49,3,6,3,6,9,9,20,28,1,42,2,0,2,3,0,1
13052,45,961,1450,624,1228,12,26,181,1462,14,306,186,354,320,540,2580,4493,8,36391,2021,1,2,8,0,0
13053,19,392,127,75,83,2,11,30,129,4,14,7,14,18,21,61,87,2,175,9,0,2,2,0,0
13054,19,392,652,304,544,16,6,88,668,6,89,51,101,95,152,591,998,3,3399,188,0,2,2,0,0
13055,19,392,2,2,2,0,0,0,2,0,0,0,0,0,0,0,0,0,0,0,0,2,2,0,0
13056,19,392,8,5,5,0,0,3,8,0,0,0,0,0,0,0,0,0,0,0,0,2,2,0,0
13059,19,392,14,8,8,0,0,6,14,0,0,0,0,0,0,0,0,0,0,0,0,2,2,0,0
13060,19,392,6,4,4,0,0,2,6,0,0,0,0,0,0,0,0,0,0,0,0,2,2,0,0
13061,19,392,6,4,4,0,0,2,6,1,2,1,2,3,3,2,4,0,2,0,0,2,2,0,0
13063,19,392,7,5,5,0,0,2,7,0,0,0,0,0,0,0,0,0,0,0,0,2,2,0,0
13065,19,392,10,6,6,0,0,4,10,0,0,0,0,0,0,0,0,0,0,0,0,2,2,0,0
13066,19,392,1,1,1,0,0,0,1,0,0,0,0,0,0,0,0,0,0,0,0,2,2,0,0
13068,19,392,14,10,10,0,0,4,14,1,1,1,1,2,2,0,2,0,1,0,0,2,2,0,0
13069,19,392,46,26,30,3,0,12,49,3,6,3,6,9,9,20,28,1,42,2,0,2,2,0,0
13070,40,353,647,139,84,35,284,233,682,0,0,0,0,0,0,0,0,0,0,0,0,2,3,3,0
13094,8,346,42,7,35,4,0,5,46,1,2,1,2,3,3,2,4,0,2,0,0,2,27,9,1
13095,8,346,11,6,10,0,0,1,11,2,4,2,4,6,6,10,15,1,15,0,0,2,27,9,1
13119,8,346,42,7,35,4,0,5,46,1,2,1,2,3,3,2,4,0,2,0,0,2,1,1,0
13120,8,346,11,6,10,0,0,1,11,2,4,2,4,6,6,10,15,1,15,0,0,2,1,1,0
13122,135,2281,1338,495,1086,10,64,173,1348,11,122,82,157,133,239,883,1686,7,11934,663,0,2,6,2,0
13140,11,531,127,75,83,2,11,30,129,4,14,7,14,18,21,61,87,2,175,9,0,2,10,7,0
13141,11,531,652,304,544,16,6,88,668,6,89,51,101,95,152,591,998,3,3399,188,0,2,10,7,0
13142,11,531,2,2,2,0,0,0,2,0,0,0,0,0,0,0,0,0,0,0,0,2,10,7,0
13143,11,531,8,5,5,0,0,3,8,0,0,0,0,0,0,0,0,0,0,0,0,2,10,7,0
13146,11,531,14,8,8,0,0,6,14,0,0,0,0,0,0,0,0,0,0,0,0,2,10,7,0
13147,11,531,6,4,4,0,0,2,6,0,0,0,0,0,0,0,0,0,0,0,0,2,10,7,0
13148,11,531,6,4,4,0,0,2,6,1,2,1,2,3,3,2,4,0,2,0,0,2,10,7,0
13150,11,531,7,5,5,0,0,2,7,0,0,0,0,0,0,0,0,0,0,0,0,2,10,7,0
13152,11,531,10,6,6,0,0,4,10,0,0,0,0,0,0,0,0,0,0,0,0,2,10,7,0
13153,11,531,1,1,1,0,0,0,1,0,0,0,0,0,0,0,0,0,0,0,0,2,10,7,0
13155,11,531,14,10,10,0,0,4,14,1,1,1,1,2,2,0,2,0,1,0,0,2,10,7,0
13156,11,531,46,26,30,3,0,12,49,3,6,3,6,9,9,20,28,1,42,2,0,2,10,7,0
13157,135,2281,1338,495,1086,10,64,173,1348,11,122,82,157,133,239,883,1686,7,11934,663,0,2,1,1,0
13158,81,1777,1457,730,1242,11,6,188,1468,10,292,166,329,302,495,2424,4078,5,22973,1276,1,2,8,1,0
13159,81,1777,74,35,59,1,0,14,75,3,14,7,14,17,21,58,85,1,128,7,0,2,8,1,0
13160,81,1777,245,125,200,5,7,34,250,7,30,17,34,37,51,166,265,3,1053,58,0,2,8,1,0
13161,80,1795,384,251,317,7,8,52,391,11,70,44,84,81,128,467,811,6,5355,297,0,2,12,11,0
13162,7,170,127,75,83,2,11,30,129,4,14,7,14,18,21,61,87,2,175,9,0,2,1,1,0
13163,7,170,652,304,544,16,6,88,668,6,89,51,101,95,152,591,998,3,3399,188,0,2,1,1,0
13164,7,170,2,2,2,0,0,0,2,0,0,0,0,0,0,0,0,0,0,0,0,2,1,1,0
13165,7,170,8,5,5,0,0,3,8,0,0,0,0,0,0,0,0,0,0,0,0,2,1,1,0
13168,7,170,14,8,8,0,0,6,14,0,0,0,0,0,0,0,0,0,0,0,0,2,1,1,0
13169,7,170,6,4,4,0,0,2,6,0,0,0,0,0,0,0,0,0,0,0,0,2,1,1,0
13170,7,170,6,4,4,0,0,2,6,1,2,1,2,3,3,2,4,0,2,0,0,2,1,1,0
13172,7,170,7,5,5,0,0,2,7,0,0,0,0,0,0,0,0,0,0,0,0,2,1,1,0
13174,7,170,10,6,6,0,0,4,10,0,0,0,0,0,0,0,0,0,0,0,0,2,1,1,0
13175,7,170,1,1,1,0,0,0,1,0,0,0,0,0,0,0,0,0,0,0,0,2,1,1,0
13177,7,170,14,10,10,0,0,4,14,1,1,1,1,2,2,0,2,0,1,0,0,2,1,1,0
13178,7,170,46,26,30,3,0,12,49,3,6,3,6,9,9,20,28,1,42,2,0,2,1,1,0
13179,34,1680,384,251,317,7,8,52,391,11,70,44,84,81,128,467,811,6,5355,297,0,2,6,3,0
13180,60,1259,384,251,317,7,8,52,391,11,70,44,84,81,128,467,811,6,5355,297,0,2,1,101,1
13181,40,355,647,139,84,35,284,233,682,0,0,0,0,0,0,0,0,0,0,0,0,2,1,1,1
13182,31,1596,384,251,317,7,8,52,391,11,70,44,84,81,128,467,811,6,5355,297,0,2,3,15,1
13206,81,1754,1457,730,1242,11,6,188,1468,10,292,166,329,302,495,2424,4078,5,22973,1276,1,2,2,3,1
13207,81,1754,74,35,59,1,0,14,75,3,14,7,14,17,21,58,85,1,128,7,0,2,2,3,1
13208,81,1754,245,125,200,5,7,34,250,7,30,17,34,37,51,166,265,3,1053,58,0,2,2,3,1
13209,93,1908,384,251,317,7,8,52,391,11,70,44,84,81,128,467,811,6,5355,297,0,2,127,16,1
13210,33,1899,1457,730,1242,11,6,188,1468,10,292,166,329,302,495,2424,4078,5,22973,1276,1,2,0,3,1
13211,61,2672,384,251,317,7,8,52,391,11,70,44,84,81,128,467,811,6,5355,297,0,2,183,0,1
13212,80,1713,1457,730,1242,11,6,188,1468,10,292,166,329,302,495,2424,4078,5,22973,1276,1,2,11,24,1
13213,80,1713,74,35,59,1,0,14,75,3,14,7,14,17,21,58,85,1,128,7,0,2,11,24,1
13214,80,1713,245,125,200,5,7,34,250,7,30,17,34,37,51,166,265,3,1053,58,0,2,11,24,1
13261,81,1725,1457,730,1242,11,6,188,1468,10,292,166,329,302,495,2424,4078,5,22973,1276,1,2,14,6,1
13262,81,1725,74,35,59,1,0,14,75,3,14,7,14,17,21,58,85,1,128,7,0,2,14,6,1
13263,81,1725,245,125,200,5,7,34,250,7,30,17,34,37,51,166,265,3,1053,58,0,2,14,6,1
13264,93,1911,384,251,317,7,8,52,391,11,70,44,84,81,128,467,811,6,5355,297,0,2,1,2,1
13265,8,391,1289,550,1043,56,32,155,1345,10,167,93,185,177,278,1266,2075,5,11498,638,0,2,16,1,1
13266,61,2672,384,251,317,7,8,52,391,11,70,44,84,81,128,467,811,6,5355,297,0,2,1,0,1
13267,17,360,127,75,83,2,11,30,129,4,14,7,14,18,21,61,87,2,175,9,0,2,4,8,1
13268,17,360,652,304,544,16,6,88,668,6,89,51,101,95,152,591,998,3,3399,188,0,2,4,8,1
13269,17,360,2,2,2,0,0,0,2,0,0,0,0,0,0,0,0,0,0,0,0,2,4,8,1
13270,17,360,8,5,5,0,0,3,8,0,0,0,0,0,0,0,0,0,0,0,0,2,4,8,1
13273,17,360,14,8,8,0,0,6,14,0,0,0,0,0,0,0,0,0,0,0,0,2,4,8,1
13274,17,360,6,4,4,0,0,2,6,0,0,0,0,0,0,0,0,0,0,0,0,2,4,8,1
13275,17,360,6,4,4,0,0,2,6,1,2,1,2,3,3,2,4,0,2,0,0,2,4,8,1
13277,17,360,7,5,5,0,0,2,7,0,0,0,0,0,0,0,0,0,0,0,0,2,4,8,1
13279,17,360,10,6,6,0,0,4,10,0,0,0,0,0,0,0,0,0,0,0,0,2,4,8,1
13280,17,360,1,1,1,0,0,0,1,0,0,0,0,0,0,0,0,0,0,0,0,2,4,8,1
13282,17,360,14,10,10,0,0,4,14,1,1,1,1,2,2,0,2,0,1,0,0,2,4,8,1
13283,17,360,46,26,30,3,0,12,49,3,6,3,6,9,9,20,28,1,42,2,0,2,4,8,1
13284,79,1661,1457,730,1242,11,6,188,1468,10,292,166,329,302,495,2424,4078,5,22973,1276,1,2,0,13,1
13285,79,1661,74,35,59,1,0,14,75,3,14,7,14,17,21,58,85,1,128,7,0,2,0,13,1
13286,79,1661,245,125,200,5,7,34,250,7,30,17,34,37,51,166,265,3,1053,58,0,2,0,13,1
13287,33,1845,1457,730,1242,11,6,188,1468,10,292,166,329,302,495,2424,4078,5,22973,1276,1,2,29,31,1
13288,61,2664,384,251,317,7,8,52,391,11,70,44,84,81,128,467,811,6,5355,297,0,2,0,1,1
13289,20,851,373,158,315,8,0,51,381,5,76,44,79,81,123,486,779,2,2026,112,0,2,2,2,1
13290,32,1814,1457,730,1242,11,6,188,1468,10,292,166,329,302,495,2424,4078,5,22973,1276,1,2,0,14,0
13291,11,552,127,75,83,2,11,30,129,4,14,7,14,18,21,61,87,2,175,9,0,2,4,2,1
13292,11,552,652,304,544,16,6,88,668,6,89,51,101,95,152,591,998,3,3399,188,0,2,4,2,1
13293,11,552,2,2,2,0,0,0,2,0,0,0,0,0,0,0,0,0,0,0,0,2,4,2,1
13294,11,552,8,5,5,0,0,3,8,0,0,0,0,0,0,0,0,0,0,0,0,2,4,2,1
13297,11,552,14,8,8,0,0,6,14,0,0,0,0,0,0,0,0,0,0,0,0,2,4,2,1
13298,11,552,6,4,4,0,0,2,6,0,0,0,0,0,0,0,0,0,0,0,0,2,4,2,1
13299,11,552,6,4,4,0,0,2,6,1,2,1,2,3,3,2,4,0,2,0,0,2,4,2,1
13301,11,552,7,5,5,0,0,2,7,0,0,0,0,0,0,0,0,0,0,0,0,2,4,2,1
13303,11,552,10,6,6,0,0,4,10,0,0,0,0,0,0,0,0,0,0,0,0,2,4,2,1
13304,11,552,1,1,1,0,0,0,1,0,0,0,0,0,0,0,0,0,0,0,0,2,4,2,1
13306,11,552,14,10,10,0,0,4,14,1,1,1,1,2,2,0,2,0,1,0,0,2,4,2,1
13307,11,552,46,26,30,3,0,12,49,3,6,3,6,9,9,20,28,1,42,2,0,2,4,2,1
13308,79,1661,1457,730,1242,11,6,188,1468,10,292,166,329,302,495,2424,4078,5,22973,1276,1,2,1,0,1
13309,79,1661,74,35,59,1,0,14,75,3,14,7,14,17,21,58,85,1,128,7,0,2,1,0,1
13310,79,1661,245,125,200,5,7,34,250,7,30,17,34,37,51,166,265,3,1053,58,0,2,1,0,1
13311,95,3781,1392,870,1177,35,17,170,1427,14,494,280,531,508,811,4473,7289,7,54850,3047,2,2,48,58,1
13312,55,1911,773,419,590,28,0,166,801,10,204,113,217,214,330,1598,2554,5,13587,754,0,2,1,2,1
13313,8,388,1289,550,1043,56,32,155,1345,10,167,93,185,177,278,1266,2075,5,11498,638,0,2,3,3,1
13314,32,1815,1457,730,1242,11,6,188,1468,10,292,166,329,302,495,2424,4078,5,22973,1276,1,2,2,2,1
13315,139,2371,1338,495,1086,10,64,173,1348,11,122,82,157,133,239,883,1686,7,11934,663,0,2,15,3,1
13316,82,1712,1457,730,1242,11,6,188,1468,10,292,166,329,302,495,2424,4078,5,22973,1276,1,2,7,0,1
13317,82,1712,74,35,59,1,0,14,75,3,14,7,14,17,21,58,85,1,128,7,0,2,7,0,1
13318,82,1712,245,125,200,5,7,34,250,7,30,17,34,37,51,166,265,3,1053,58,0,2,7,0,1
13319,90,1868,384,251,317,7,8,52,391,11,70,44,84,81,128,467,811,6,5355,297,0,2,14,18,1
13320,57,2496,384,251,317,7,8,52,391,11,70,44,84,81,128,467,811,6,5355,297,0,2,0,26,1
13321,140,2381,1338,495,1086,10,64,173,1348,11,122,82,157,133,239,883,1686,7,11934,663,0,2,4,1,1
13322,82,1712,1457,730,1242,11,6,188,1468,10,292,166,329,302,495,2424,4078,5,22973,1276,1,2,1,1,1
13323,82,1712,74,35,59,1,0,14,75,3,14,7,14,17,21,58,85,1,128,7,0,2,1,1,1
13324,82,1712,245,125,200,5,7,34,250,7,30,17,34,37,51,166,265,3,1053,58,0,2,1,1,1
13325,11,574,127,75,83,2,11,30,129,4,14,7,14,18,21,61,87,2,175,9,0,2,2,0,0
13326,11,574,652,304,544,16,6,88,668,6,89,51,101,95,152,591,998,3,3399,188,0,2,2,0,0
13327,11,574,2,2,2,0,0,0,2,0,0,0,0,0,0,0,0,0,0,0,0,2,2,0,0
13328,11,574,8,5,5,0,0,3,8,0,0,0,0,0,0,0,0,0,0,0,0,2,2,0,0
13331,11,574,14,8,8,0,0,6,14,0,0,0,0,0,0,0,0,0,0,0,0,2,2,0,0
13332,11,574,6,4,4,0,0,2,6,0,0,0,0,0,0,0,0,0,0,0,0,2,2,0,0
13333,11,574,6,4,4,0,0,2,6,1,2,1,2,3,3,2,4,0,2,0,0,2,2,0,0
13335,11,574,7,5,5,0,0,2,7,0,0,0,0,0,0,0,0,0,0,0,0,2,2,0,0
13337,11,574,10,6,6,0,0,4,10,0,0,0,0,0,0,0,0,0,0,0,0,2,2,0,0
13338,11,574,1,1,1,0,0,0,1,0,0,0,0,0,0,0,0,0,0,0,0,2,2,0,0
13340,11,574,14,10,10,0,0,4,14,1,1,1,1,2,2,0,2,0,1,0,0,2,2,0,0
13341,11,574,46,26,30,3,0,12,49,3,6,3,6,9,9,20,28,1,42,2,0,2,2,0,0
13342,139,2371,1338,495,1086,10,64,173,1348,11,122,82,157,133,239,883,1686,7,11934,663,0,2,1,4,1
13343,82,1712,1457,730,1242,11,6,188,1468,10,292,166,329,302,495,2424,4078,5,22973,1276,1,2,1,1,0
13344,82,1712,74,35,59,1,0,14,75,3,14,7,14,17,21,58,85,1,128,7,0,2,1,1,0
13345,82,1712,245,125,200,5,7,34,250,7,30,17,34,37,51,166,265,3,1053,58,0,2,1,1,0
13346,8,420,1289,550,1043,56,32,155,1345,10,167,93,185,177,278,1266,2075,5,11498,638,0,2,0,33,0
13347,31,1779,1457,730,1242,11,6,188,1468,10,292,166,329,302,495,2424,4078,5,22973,1276,1,2,0,17,0
13348,140,2380,1338,495,1086,10,64,173,1348,11,122,82,157,133,239,883,1686,7,11934,663,0,2,4,4,1
13349,82,1749,1457,730,1242,11,6,188,1468,10,292,166,329,302,495,2424,4078,5,22973,1276,1,2,8,4,1
13350,82,1749,74,35,59,1,0,14,75,3,14,7,14,17,21,58,85,1,128,7,0,2,8,4,1
13351,82,1749,245,125,200,5,7,34,250,7,30,17,34,37,51,166,265,3,1053,58,0,2,8,4,1
13352,40,360,647,139,84,35,284,233,682,0,0,0,0,0,0,0,0,0,0,0,0,2,1,0,1
13353,31,606,127,75,83,2,11,30,129,4,14,7,14,18,21,61,87,2,175,9,0,2,44,0,1
13354,31,606,652,304,544,16,6,88,668,6,89,51,101,95,152,591,998,3,3399,188,0,2,44,0,1
13355,31,606,2,2,2,0,0,0,2,0,0,0,0,0,0,0,0,0,0,0,0,2,44,0,1
13356,31,606,8,5,5,0,0,3,8,0,0,0,0,0,0,0,0,0,0,0,0,2,44,0,1
13359,31,606,14,8,8,0,0,6,14,0,0,0,0,0,0,0,0,0,0,0,0,2,44,0,1
13360,31,606,6,4,4,0,0,2,6,0,0,0,0,0,0,0,0,0,0,0,0,2,44,0,1
13361,31,606,6,4,4,0,0,2,6,1,2,1,2,3,3,2,4,0,2,0,0,2,44,0,1
13363,31,606,7,5,5,0,0,2,7,0,0,0,0,0,0,0,0,0,0,0,0,2,44,0,1
13365,31,606,10,6,6,0,0,4,10,0,0,0,0,0,0,0,0,0,0,0,0,2,44,0,1
13366,31,606,1,1,1,0,0,0,1,0,0,0,0,0,0,0,0,0,0,0,0,2,44,0,1
13368,31,606,14,10,10,0,0,4,14,1,1,1,1,2,2,0,2,0,1,0,0,2,44,0,1
13369,31,606,46,26,30,3,0,12,49,3,6,3,6,9,9,20,28,1,42,2,0,2,44,0,1
13370,30,602,127,75,83,2,11,30,129,4,14,7,14,18,21,61,87,2,175,9,0,2,10,12,0
13371,30,602,652,304,544,16,6,88,668,6,89,51,101,95,152,591,998,3,3399,188,0,2,10,12,0
13372,30,602,2,2,2,0,0,0,2,0,0,0,0,0,0,0,0,0,0,0,0,2,10,12,0
13373,30,602,8,5,5,0,0,3,8,0,0,0,0,0,0,0,0,0,0,0,0,2,10,12,0
13376,30,602,14,8,8,0,0,6,14,0,0,0,0,0,0,0,0,0,0,0,0,2,10,12,0
13377,30,602,6,4,4,0,0,2,6,0,0,0,0,0,0,0,0,0,0,0,0,2,10,12,0
13378,30,602,6,4,4,0,0,2,6,1,2,1,2,3,3,2,4,0,2,0,0,2,10,12,0
13380,30,602,7,5,5,0,0,2,7,0,0,0,0,0,0,0,0,0,0,0,0,2,10,12,0
13382,30,602,10,6,6,0,0,4,10,0,0,0,0,0,0,0,0,0,0,0,0,2,10,12,0
13383,30,602,1,1,1,0,0,0,1,0,0,0,0,0,0,0,0,0,0,0,0,2,10,12,0
13385,30,602,14,10,10,0,0,4,14,1,1,1,1,2,2,0,2,0,1,0,0,2,10,12,0
13386,30,602,46,26,30,3,0,12,49,3,6,3,6,9,9,20,28,1,42,2,0,2,10,12,0
13387,83,1755,1457,730,1242,11,6,188,1468,10,292,166,329,302,495,2424,4078,5,22973,1276,1,2,4,1,1
13388,83,1755,74,35,59,1,0,14,75,3,14,7,14,17,21,58,85,1,128,7,0,2,4,1,1
13389,83,1755,245,125,200,5,7,34,250,7,30,17,34,37,51,166,265,3,1053,58,0,2,4,1,1
13390,187,4173,182,127,129,0,0,53,182,5,39,21,42,44,63,217,343,2,926,51,0,2,2,1,1
13391,187,4173,1165,710,800,67,119,181,1232,18,243,153,282,261,435,2000,3492,10,36473,2026,1,2,2,1,1
13392,90,1868,384,251,317,7,8,52,391,11,70,44,84,81,128,467,811,6,5355,297,0,2,1,1,1
13393,90,1869,384,251,317,7,8,52,391,11,70,44,84,81,128,467,811,6,5355,297,0,2,2,1,1
13394,140,2370,1338,495,1086,10,64,173,1348,11,122,82,157,133,239,883,1686,7,11934,663,0,2,6,18,0
13395,83,1755,1457,730,1242,11,6,188,1468,10,292,166,329,302,495,2424,4078,5,22973,1276,1,2,2,2,1
13396,83,1755,74,35,59,1,0,14,75,3,14,7,14,17,21,58,85,1,128,7,0,2,2,2,1
13397,83,1755,245,125,200,5,7,34,250,7,30,17,34,37,51,166,265,3,1053,58,0,2,2,2,1
13398,90,1873,384,251,317,7,8,52,391,11,70,44,84,81,128,467,811,6,5355,297,0,2,3,2,1
13399,34,1885,1457,730,1242,11,6,188,1468,10,292,166,329,302,495,2424,4078,5,22973,1276,1,2,21,0,1
13400,57,2508,384,251,317,7,8,52,391,11,70,44,84,81,128,467,811,6,5355,297,0,2,2,0,1
13401,83,1769,1457,730,1242,11,6,188,1468,10,292,166,329,302,495,2424,4078,5,22973,1276,1,2,1,0,0
13402,83,1769,74,35,59,1,0,14,75,3,14,7,14,17,21,58,85,1,128,7,0,2,1,0,0
13403,83,1769,245,125,200,5,7,34,250,7,30,17,34,37,51,166,265,3,1053,58,0,2,1,0,0
13404,32,621,334,251,279,10,4,40,344,5,127,74,143,132,217,899,1528,2,4303,239,0,2,14,5,0
13405,92,1901,384,251,317,7,8,52,391,11,70,44,84,81,128,467,811,6,5355,297,0,2,11,10,0
13406,18,815,334,251,279,10,4,40,344,5,127,74,143,132,217,899,1528,2,4303,239,0,2,2,8,0
13407,57,2515,384,251,317,7,8,52,391,11,70,44,84,81,128,467,811,6,5355,297,0,2,7,8,0
13408,92,1901,384,251,317,7,8,52,391,11,70,44,84,81,128,467,811,6,5355,297,0,2,1,1,1
13409,139,2342,1338,495,1086,10,64,173,1348,11,122,82,157,133,239,883,1686,7,11934,663,0,2,72,101,1
13410,79,1704,1457,730,1242,11,6,188,1468,10,292,166,329,302,495,2424,4078,5,22973,1276,1,2,4,11,1
13411,79,1704,74,35,59,1,0,14,75,3,14,7,14,17,21,58,85,1,128,7,0,2,4,11,1
13412,79,1704,245,125,200,5,7,34,250,7,30,17,34,37,51,166,265,3,1053,58,0,2,4,11,1
13413,34,1906,1457,730,1242,11,6,188,1468,10,292,166,329,302,495,2424,4078,5,22973,1276,1,2,4,3,1
13414,92,1901,384,251,317,7,8,52,391,11,70,44,84,81,128,467,811,6,5355,297,0,2,1,1,0
13438,8,346,42,7,35,4,0,5,46,1,2,1,2,3,3,2,4,0,2,0,0,2,2,2,0
13439,8,346,11,6,10,0,0,1,11,2,4,2,4,6,6,10,15,1,15,0,0,2,2,2,0
13463,11,544,127,75,83,2,11,30,129,4,14,7,14,18,21,61,87,2,175,9,0,2,2,2,1
13464,11,544,652,304,544,16,6,88,668,6,89,51,101,95,152,591,998,3,3399,188,0,2,2,2,1
13465,11,544,2,2,2,0,0,0,2,0,0,0,0,0,0,0,0,0,0,0,0,2,2,2,1
13466,11,544,8,5,5,0,0,3,8,0,0,0,0,0,0,0,0,0,0,0,0,2,2,2,1
13469,11,544,14,8,8,0,0,6,14,0,0,0,0,0,0,0,0,0,0,0,0,2,2,2,1
13470,11,544,6,4,4,0,0,2,6,0,0,0,0,0,0,0,0,0,0,0,0,2,2,2,1
13471,11,544,6,4,4,0,0,2,6,1,2,1,2,3,3,2,4,0,2,0,0,2,2,2,1
13473,11,544,7,5,5,0,0,2,7,0,0,0,0,0,0,0,0,0,0,0,0,2,2,2,1
13475,11,544,10,6,6,0,0,4,10,0,0,0,0,0,0,0,0,0,0,0,0,2,2,2,1
13476,11,544,1,1,1,0,0,0,1,0,0,0,0,0,0,0,0,0,0,0,0,2,2,2,1
13478,11,544,14,10,10,0,0,4,14,1,1,1,1,2,2,0,2,0,1,0,0,2,2,2,1
13479,11,544,46,26,30,3,0,12,49,3,6,3,6,9,9,20,28,1,42,2,0,2,2,2,1
13480,8,348,42,7,35,4,0,5,46,1,2,1,2,3,3,2,4,0,2,0,0,2,13,12,1
13481,8,348,11,6,10,0,0,1,11,2,4,2,4,6,6,10,15,1,15,0,0,2,13,12,1
13482,8,386,1289,550,1043,56,32,155,1345,10,167,93,185,177,278,1266,2075,5,11498,638,0,2,1,1,1
13483,8,376,1289,550,1043,56,32,155,1345,10,167,93,185,177,278,1266,2075,5,11498,638,0,2,2,2,1
13484,135,2241,1338,495,1086,10,64,173,1348,11,122,82,157,133,239,883,1686,7,11934,663,0,2,7,17,1
13485,85,1902,1457,730,1242,11,6,188,1468,10,292,166,329,302,495,2424,4078,5,22973,1276,1,2,34,11,1
13486,85,1902,74,35,59,1,0,14,75,3,14,7,14,17,21,58,85,1,128,7,0,2,34,11,1
13487,85,1902,245,125,200,5,7,34,250,7,30,17,34,37,51,166,265,3,1053,58,0,2,34,11,1
13488,33,626,373,158,315,8,0,51,381,5,76,44,79,81,123,486,779,2,2026,112,0,2,1,8,1
13489,34,1943,1457,730,1242,11,6,188,1468,10,292,166,329,302,495,2424,4078,5,22973,1276,1,2,16,14,1
13490,8,347,42,7,35,4,0,5,46,1,2,1,2,3,3,2,4,0,2,0,0,2,1,2,1
13491,8,347,11,6,10,0,0,1,11,2,4,2,4,6,6,10,15,1,15,0,0,2,1,2,1
13492,85,1902,1457,730,1242,11,6,188,1468,10,292,166,329,302,495,2424,4078,5,22973,1276,1,2,2,2,1
13493,85,1902,74,35,59,1,0,14,75,3,14,7,14,17,21,58,85,1,128,7,0,2,2,2,1
13494,85,1902,245,125,200,5,7,34,250,7,30,17,34,37,51,166,265,3,1053,58,0,2,2,2,1
13518,135,2241,1338,495,1086,10,64,173,1348,11,122,82,157,133,239,883,1686,7,11934,663,0,2,1,1,1
13519,81,1873,1457,730,1242,11,6,188,1468,10,292,166,329,302,495,2424,4078,5,22973,1276,1,2,7,11,1
13520,81,1873,74,35,59,1,0,14,75,3,14,7,14,17,21,58,85,1,128,7,0,2,7,11,1
13521,81,1873,245,125,200,5,7,34,250,7,30,17,34,37,51,166,265,3,1053,58,0,2,7,11,1
13522,95,3781,1392,870,1177,35,17,170,1427,14,494,280,531,508,811,4473,7289,7,54850,3047,2,2,1,1,1
13523,33,628,373,158,315,8,0,51,381,5,76,44,79,81,123,486,779,2,2026,112,0,2,1,4,1
13524,81,1888,1457,730,1242,11,6,188,1468,10,292,166,329,302,495,2424,4078,5,22973,1276,1,2,3,2,0
13525,81,1888,74,35,59,1,0,14,75,3,14,7,14,17,21,58,85,1,128,7,0,2,3,2,0
13526,81,1888,245,125,200,5,7,34,250,7,30,17,34,37,51,166,265,3,1053,58,0,2,3,2,0
13527,41,367,647,139,84,35,284,233,682,0,0,0,0,0,0,0,0,0,0,0,0,2,3,0,1
13528,20,429,127,75,83,2,11,30,129,4,14,7,14,18,21,61,87,2,175,9,0,2,5,38,1
13529,20,429,652,304,544,16,6,88,668,6,89,51,101,95,152,591,998,3,3399,188,0,2,5,38,1
13530,20,429,2,2,2,0,0,0,2,0,0,0,0,0,0,0,0,0,0,0,0,2,5,38,1
13531,20,429,8,5,5,0,0,3,8,0,0,0,0,0,0,0,0,0,0,0,0,2,5,38,1
13534,20,429,14,8,8,0,0,6,14,0,0,0,0,0,0,0,0,0,0,0,0,2,5,38,1
13535,20,429,6,4,4,0,0,2,6,0,0,0,0,0,0,0,0,0,0,0,0,2,5,38,1
13536,20,429,6,4,4,0,0,2,6,1,2,1,2,3,3,2,4,0,2,0,0,2,5,38,1
13538,20,429,7,5,5,0,0,2,7,0,0,0,0,0,0,0,0,0,0,0,0,2,5,38,1
13540,20,429,10,6,6,0,0,4,10,0,0,0,0,0,0,0,0,0,0,0,0,2,5,38,1
13541,20,429,1,1,1,0,0,0,1,0,0,0,0,0,0,0,0,0,0,0,0,2,5,38,1
13543,20,429,14,10,10,0,0,4,14,1,1,1,1,2,2,0,2,0,1,0,0,2,5,38,1
13544,20,429,46,26,30,3,0,12,49,3,6,3,6,9,9,20,28,1,42,2,0,2,5,38,1
13545,70,1681,1457,730,1242,11,6,188,1468,10,292,166,329,302,495,2424,4078,5,22973,1276,1,2,4,38,1
13546,70,1681,74,35,59,1,0,14,75,3,14,7,14,17,21,58,85,1,128,7,0,2,4,38,1
13547,70,1681,245,125,200,5,7,34,250,7,30,17,34,37,51,166,265,3,1053,58,0,2,4,38,1
13595,96,1953,384,251,317,7,8,52,391,11,70,44,84,81,128,467,811,6,5355,297,0,2,12,0,1
13596,8,343,42,7,35,4,0,5,46,1,2,1,2,3,3,2,4,0,2,0,0,2,0,2,1
13597,8,343,11,6,10,0,0,1,11,2,4,2,4,6,6,10,15,1,15,0,0,2,0,2,1
13662,32,1840,1457,730,1242,11,6,188,1468,10,292,166,329,302,495,2424,4078,5,22973,1276,1,2,0,15,1
13778,15,439,1450,624,1228,12,26,181,1462,14,306,186,354,320,540,2580,4493,8,36391,2021,1,3,2,2,1
13779,187,4167,182,127,129,0,0,53,182,5,39,21,42,44,63,217,343,2,926,51,0,3,3,3,1
13780,187,4167,1165,710,800,67,119,181,1232,18,243,153,282,261,435,2000,3492,10,36473,2026,1,3,3,3,1
13976,70,1671,1457,730,1242,11,6,188,1468,10,292,166,329,302,495,2424,4078,5,22973,1276,1,3,5,5,1
13977,70,1671,74,35,59,1,0,14,75,3,14,7,14,17,21,58,85,1,128,7,0,3,5,5,1
13978,70,1671,245,125,200,5,7,34,250,7,30,17,34,37,51,166,265,3,1053,58,0,3,5,5,1
13980,96,1951,384,251,317,7,8,52,391,11,70,44,84,81,128,467,811,6,5355,297,0,3,3,3,1
13981,33,626,373,158,315,8,0,51,381,5,76,44,79,81,123,486,779,2,2026,112,0,3,1,1,1
14005,8,341,42,7,35,4,0,5,46,1,2,1,2,3,3,2,4,0,2,0,0,2,9,10,1
14006,8,341,11,6,10,0,0,1,11,2,4,2,4,6,6,10,15,1,15,0,0,2,9,10,1
14007,45,961,1450,624,1228,12,26,181,1462,14,306,186,354,320,540,2580,4493,8,36391,2021,1,2,1,1,1
14008,34,1126,182,127,129,0,0,53,182,5,39,21,42,44,63,217,343,2,926,51,0,2,2,2,1
14009,95,3779,1392,870,1177,35,17,170,1427,14,494,280,531,508,811,4473,7289,7,54850,3047,2,2,1,1,1
14010,55,1901,773,419,590,28,0,166,801,10,204,113,217,214,330,1598,2554,5,13587,754,0,2,5,5,1
14012,11,542,127,75,83,2,11,30,129,4,14,7,14,18,21,61,87,2,175,9,0,2,1,1,1
14013,11,542,652,304,544,16,6,88,668,6,89,51,101,95,152,591,998,3,3399,188,0,2,1,1,1
14014,11,542,2,2,2,0,0,0,2,0,0,0,0,0,0,0,0,0,0,0,0,2,1,1,1
14015,11,542,8,5,5,0,0,3,8,0,0,0,0,0,0,0,0,0,0,0,0,2,1,1,1
14018,11,542,14,8,8,0,0,6,14,0,0,0,0,0,0,0,0,0,0,0,0,2,1,1,1
14019,11,542,6,4,4,0,0,2,6,0,0,0,0,0,0,0,0,0,0,0,0,2,1,1,1
14020,11,542,6,4,4,0,0,2,6,1,2,1,2,3,3,2,4,0,2,0,0,2,1,1,1
14022,11,542,7,5,5,0,0,2,7,0,0,0,0,0,0,0,0,0,0,0,0,2,1,1,1
14024,11,542,10,6,6,0,0,4,10,0,0,0,0,0,0,0,0,0,0,0,0,2,1,1,1
14025,11,542,1,1,1,0,0,0,1,0,0,0,0,0,0,0,0,0,0,0,0,2,1,1,1
14027,11,542,14,10,10,0,0,4,14,1,1,1,1,2,2,0,2,0,1,0,0,2,1,1,1
14028,11,542,46,26,30,3,0,12,49,3,6,3,6,9,9,20,28,1,42,2,0,2,1,1,1
14029,7,168,127,75,83,2,11,30,129,4,14,7,14,18,21,61,87,2,175,9,0,2,3,3,1
14030,7,168,652,304,544,16,6,88,668,6,89,51,101,95,152,591,998,3,3399,188,0,2,3,3,1
14031,7,168,2,2,2,0,0,0,2,0,0,0,0,0,0,0,0,0,0,0,0,2,3,3,1
14032,7,168,8,5,5,0,0,3,8,0,0,0,0,0,0,0,0,0,0,0,0,2,3,3,1
14035,7,168,14,8,8,0,0,6,14,0,0,0,0,0,0,0,0,0,0,0,0,2,3,3,1
14036,7,168,6,4,4,0,0,2,6,0,0,0,0,0,0,0,0,0,0,0,0,2,3,3,1
14037,7,168,6,4,4,0,0,2,6,1,2,1,2,3,3,2,4,0,2,0,0,2,3,3,1
14039,7,168,7,5,5,0,0,2,7,0,0,0,0,0,0,0,0,0,0,0,0,2,3,3,1
14041,7,168,10,6,6,0,0,4,10,0,0,0,0,0,0,0,0,0,0,0,0,2,3,3,1
14042,7,168,1,1,1,0,0,0,1,0,0,0,0,0,0,0,0,0,0,0,0,2,3,3,1
14044,7,168,14,10,10,0,0,4,14,1,1,1,1,2,2,0,2,0,1,0,0,2,3,3,1
14045,7,168,46,26,30,3,0,12,49,3,6,3,6,9,9,20,28,1,42,2,0,2,3,3,1
14047,32,1832,1457,730,1242,11,6,188,1468,10,292,166,329,302,495,2424,4078,5,22973,1276,1,2,4,4,1
14048,18,813,334,251,279,10,4,40,344,5,127,74,143,132,217,899,1528,2,4303,239,0,2,1,1,1
14049,57,2507,384,251,317,7,8,52,391,11,70,44,84,81,128,467,811,6,5355,297,0,2,4,4,1
14051,57,2507,384,251,317,7,8,52,391,11,70,44,84,81,128,467,811,6,5355,297,0,2,2,2,1
14056,96,1951,384,251,317,7,8,52,391,11,70,44,84,81,128,467,811,6,5355,297,0,2,1,1,1
14057,2,81,13,10,10,0,0,3,13,1,2,1,2,3,3,2,4,0,2,0,0,2,1,1,0
14058,136,2272,1338,495,1086,10,64,173,1348,11,122,82,157,133,239,883,1686,7,11934,663,0,2,26,25,1
14059,72,1693,1457,730,1242,11,6,188,1468,10,292,166,329,302,495,2424,4078,5,22973,1276,1,2,14,14,1
14060,72,1693,74,35,59,1,0,14,75,3,14,7,14,17,21,58,85,1,128,7,0,2,14,14,1
14061,72,1693,245,125,200,5,7,34,250,7,30,17,34,37,51,166,265,3,1053,58,0,2,14,14,1
14062,34,635,373,158,315,8,0,51,381,5,76,44,79,81,123,486,779,2,2026,112,0,2,2,0,1
14063,44,2711,1457,730,1242,11,6,188,1468,10,292,166,329,302,495,2424,4078,5,22973,1276,1,2,129,0,1
14064,19,818,373,158,315,8,0,51,381,5,76,44,79,81,123,486,779,2,2026,112,0,2,0,5,1
14065,187,4166,182,127,129,0,0,53,182,5,39,21,42,44,63,217,343,2,926,51,0,2,2,2,0
14066,187,4166,1165,710,800,67,119,181,1232,18,243,153,282,261,435,2000,3492,10,36473,2026,1,2,2,2,0
14067,97,3803,1392,870,1177,35,17,170,1427,14,494,280,531,508,811,4473,7289,7,54850,3047,2,2,4,2,0
14091,8,341,42,7,35,4,0,5,46,1,2,1,2,3,3,2,4,0,2,0,0,2,1,1,1
14092,8,341,11,6,10,0,0,1,11,2,4,2,4,6,6,10,15,1,15,0,0,2,1,1,1
14093,187,4169,182,127,129,0,0,53,182,5,39,21,42,44,63,217,343,2,926,51,0,2,5,5,0
14094,187,4169,1165,710,800,67,119,181,1232,18,243,153,282,261,435,2000,3492,10,36473,2026,1,2,5,5,0
14095,98,3979,1392,870,1177,35,17,170,1427,14,494,280,531,508,811,4473,7289,7,54850,3047,2,2,26,0,0
14096,1,83,13,10,10,0,0,3,13,1,2,1,2,3,3,2,4,0,2,0,0,2,8,7,0
14122,2,29,127,75,83,2,11,30,129,4,14,7,14,18,21,61,87,2,175,9,0,2,4,0,0
14123,2,29,652,304,544,16,6,88,668,6,89,51,101,95,152,591,998,3,3399,188,0,2,4,0,0
14124,2,29,2,2,2,0,0,0,2,0,0,0,0,0,0,0,0,0,0,0,0,2,4,0,0
14125,2,29,8,5,5,0,0,3,8,0,0,0,0,0,0,0,0,0,0,0,0,2,4,0,0
14128,2,29,14,8,8,0,0,6,14,0,0,0,0,0,0,0,0,0,0,0,0,2,4,0,0
14129,2,29,6,4,4,0,0,2,6,0,0,0,0,0,0,0,0,0,0,0,0,2,4,0,0
14130,2,29,6,4,4,0,0,2,6,1,2,1,2,3,3,2,4,0,2,0,0,2,4,0,0
14132,2,29,7,5,5,0,0,2,7,0,0,0,0,0,0,0,0,0,0,0,0,2,4,0,0
14134,2,29,10,6,6,0,0,4,10,0,0,0,0,0,0,0,0,0,0,0,0,2,4,0,0
14135,2,29,1,1,1,0,0,0,1,0,0,0,0,0,0,0,0,0,0,0,0,2,4,0,0
14137,2,29,14,10,10,0,0,4,14,1,1,1,1,2,2,0,2,0,1,0,0,2,4,0,0
14138,2,29,46,26,30,3,0,12,49,3,6,3,6,9,9,20,28,1,42,2,0,2,4,0,0
14162,8,341,42,7,35,4,0,5,46,1,2,1,2,3,3,2,4,0,2,0,0,2,1,1,0
14163,8,341,11,6,10,0,0,1,11,2,4,2,4,6,6,10,15,1,15,0,0,2,1,1,0
14164,2,35,127,75,83,2,11,30,129,4,14,7,14,18,21,61,87,2,175,9,0,2,1,2,0
14165,2,35,652,304,544,16,6,88,668,6,89,51,101,95,152,591,998,3,3399,188,0,2,1,2,0
14166,2,35,2,2,2,0,0,0,2,0,0,0,0,0,0,0,0,0,0,0,0,2,1,2,0
14167,2,35,8,5,5,0,0,3,8,0,0,0,0,0,0,0,0,0,0,0,0,2,1,2,0
14170,2,35,14,8,8,0,0,6,14,0,0,0,0,0,0,0,0,0,0,0,0,2,1,2,0
14171,2,35,6,4,4,0,0,2,6,0,0,0,0,0,0,0,0,0,0,0,0,2,1,2,0
14172,2,35,6,4,4,0,0,2,6,1,2,1,2,3,3,2,4,0,2,0,0,2,1,2,0
14174,2,35,7,5,5,0,0,2,7,0,0,0,0,0,0,0,0,0,0,0,0,2,1,2,0
14176,2,35,10,6,6,0,0,4,10,0,0,0,0,0,0,0,0,0,0,0,0,2,1,2,0
14177,2,35,1,1,1,0,0,0,1,0,0,0,0,0,0,0,0,0,0,0,0,2,1,2,0
14179,2,35,14,10,10,0,0,4,14,1,1,1,1,2,2,0,2,0,1,0,0,2,1,2,0
14180,2,35,46,26,30,3,0,12,49,3,6,3,6,9,9,20,28,1,42,2,0,2,1,2,0
14181,8,376,1289,550,1043,56,32,155,1345,10,167,93,185,177,278,1266,2075,5,11498,638,0,2,1,1,1
14182,8,376,1289,550,1043,56,32,155,1345,10,167,93,185,177,278,1266,2075,5,11498,638,0,2,1,1,0
14206,35,315,647,139,84,35,284,233,682,0,0,0,0,0,0,0,0,0,0,0,0,2,3,25,1
14207,100,2023,384,251,317,7,8,52,391,11,70,44,84,81,128,467,811,6,5355,297,0,2,16,3,1
14233,7,336,42,7,35,4,0,5,46,1,2,1,2,3,3,2,4,0,2,0,0,2,1,2,0
14234,7,336,11,6,10,0,0,1,11,2,4,2,4,6,6,10,15,1,15,0,0,2,1,2,0
14235,47,1977,1513,682,1277,25,13,200,1538,11,199,116,219,210,335,1557,2584,6,15641,868,0,2,9,0,0
14236,98,3995,1392,870,1177,35,17,170,1427,14,494,280,531,508,811,4473,7289,7,54850,3047,2,2,5,1,0
14237,55,1929,773,419,590,28,0,166,801,10,204,113,217,214,330,1598,2554,5,13587,754,0,2,10,0,0
14238,187,4174,182,127,129,0,0,53,182,5,39,21,42,44,63,217,343,2,926,51,0,2,2,1,0
14239,187,4174,1165,710,800,67,119,181,1232,18,243,153,282,261,435,2000,3492,10,36473,2026,1,2,2,1,0
14240,47,1957,1513,682,1277,25,13,200,1538,11,199,116,219,210,335,1557,2584,6,15641,868,0,2,1,1,1
14245,47,1981,1513,682,1277,25,13,200,1538,11,199,116,219,210,335,1557,2584,6,15641,868,0,2,9,0,0
14269,35,663,373,158,315,8,0,51,381,5,76,44,79,81,123,486,779,2,2026,112,0,2,14,10,1
14270,188,4195,182,127,129,0,0,53,182,5,39,21,42,44,63,217,343,2,926,51,0,2,4,1,1
14271,188,4195,1165,710,800,67,119,181,1232,18,243,153,282,261,435,2000,3492,10,36473,2026,1,2,4,1,1
14272,36,1177,182,127,129,0,0,53,182,5,39,21,42,44,63,217,343,2,926,51,0,2,7,0,1
14273,190,4250,182,127,129,0,0,53,182,5,39,21,42,44,63,217,343,2,926,51,0,2,12,2,1
14274,190,4250,1165,710,800,67,119,181,1232,18,243,153,282,261,435,2000,3492,10,36473,2026,1,2,12,2,1
14275,37,1193,182,127,129,0,0,53,182,5,39,21,42,44,63,217,343,2,926,51,0,2,2,0,1
14276,44,2719,1457,730,1242,11,6,188,1468,10,292,166,329,302,495,2424,4078,5,22973,1276,1,2,1,0,1
14277,72,1691,1457,730,1242,11,6,188,1468,10,292,166,329,302,495,2424,4078,5,22973,1276,1,2,1,1,1
14278,72,1691,74,35,59,1,0,14,75,3,14,7,14,17,21,58,85,1,128,7,0,2,1,1,1
14279,72,1691,245,125,200,5,7,34,250,7,30,17,34,37,51,166,265,3,1053,58,0,2,1,1,1
14280,135,2260,1338,495,1086,10,64,173,1348,11,122,82,157,133,239,883,1686,7,11934,663,0,2,4,6,0
14304,100,2021,384,251,317,7,8,52,391,11,70,44,84,81,128,467,811,6,5355,297,0,2,1,2,1
14305,35,660,373,158,315,8,0,51,381,5,76,44,79,81,123,486,779,2,2026,112,0,2,12,6,1
14306,44,2723,1457,730,1242,11,6,188,1468,10,292,166,329,302,495,2424,4078,5,22973,1276,1,2,4,3,1
14307,100,2021,384,251,317,7,8,52,391,11,70,44,84,81,128,467,811,6,5355,297,0,2,1,1,1
14308,44,2723,1457,730,1242,11,6,188,1468,10,292,166,329,302,495,2424,4078,5,22973,1276,1,2,2,2,1
14309,65,1718,1513,682,1277,25,13,200,1538,11,199,116,219,210,335,1557,2584,6,15641,868,0,2,2,0,1
14310,65,1718,819,519,539,24,98,155,843,15,96,57,106,111,163,690,1107,8,9171,509,0,2,2,0,1
14311,193,4289,182,127,129,0,0,53,182,5,39,21,42,44,63,217,343,2,926,51,0,2,17,8,1
14312,193,4289,1165,710,800,67,119,181,1232,18,243,153,282,261,435,2000,3492,10,36473,2026,1,2,17,8,1
14313,40,1273,182,127,129,0,0,53,182,5,39,21,42,44,63,217,343,2,926,51,0,2,17,1,1
14314,8,369,1289,550,1043,56,32,155,1345,10,167,93,185,177,278,1266,2075,5,11498,638,0,2,5,5,1
14315,18,812,334,251,279,10,4,40,344,5,127,74,143,132,217,899,1528,2,4303,239,0,2,1,1,1
14316,57,2505,384,251,317,7,8,52,391,11,70,44,84,81,128,467,811,6,5355,297,0,2,1,1,1
14340,15,451,1450,624,1228,12,26,181,1462,14,306,186,354,320,540,2580,4493,8,36391,2021,1,2,9,7,0
14341,193,4285,182,127,129,0,0,53,182,5,39,21,42,44,63,217,343,2,926,51,0,2,1,2,0
14342,193,4285,1165,710,800,67,119,181,1232,18,243,153,282,261,435,2000,3492,10,36473,2026,1,2,1,2,0
14343,46,981,1450,624,1228,12,26,181,1462,14,306,186,354,320,540,2580,4493,8,36391,2021,1,2,4,2,0
14367,47,1972,1513,682,1277,25,13,200,1538,11,199,116,219,210,335,1557,2584,6,15641,868,0,2,1,2,0
14391,184,4050,182,127,129,0,0,53,182,5,39,21,42,44,63,217,343,2,926,51,0,2,3,45,1
14392,184,4050,1165,710,800,67,119,181,1232,18,243,153,282,261,435,2000,3492,10,36473,2026,1,2,3,45,1
14393,9,265,149,95,105,2,0,41,151,8,54,28,55,62,83,334,494,4,2013,111,0,0,55,0,1
14394,9,265,82,56,54,0,13,15,82,4,13,8,16,17,24,56,98,2,241,13,0,0,55,0,1
14395,31,1044,182,127,129,0,0,53,182,5,39,21,42,44,63,217,343,2,926,51,0,2,0,38,1
14396,21,588,149,95,105,2,0,41,151,8,54,28,55,62,83,334,494,4,2013,111,0,0,99,0,1
14397,9,270,149,95,105,2,0,41,151,8,54,28,55,62,83,334,494,4,2013,111,0,2,1,0,0
14398,9,270,82,56,54,0,13,15,82,4,13,8,16,17,24,56,98,2,241,13,0,2,1,0,0
14399,36,329,647,139,84,35,284,233,682,0,0,0,0,0,0,0,0,0,0,0,0,2,7,0,0
14400,127,2187,1338,495,1086,10,64,173,1348,11,122,82,157,133,239,883,1686,7,11934,663,0,2,3,16,0
14401,37,343,647,139,84,35,284,233,682,0,0,0,0,0,0,0,0,0,0,0,0,2,8,0,0
14402,66,1725,1513,682,1277,25,13,200,1538,11,199,116,219,210,335,1557,2584,6,15641,868,0,2,2,0,0
14403,66,1725,819,519,539,24,98,155,843,15,96,57,106,111,163,690,1107,8,9171,509,0,2,2,0,0
14404,47,1977,1513,682,1277,25,13,200,1538,11,199,116,219,210,335,1557,2584,6,15641,868,0,2,1,0,0
14428,7,336,42,7,35,4,0,5,46,1,2,1,2,3,3,2,4,0,2,0,0,2,1,1,1
14429,7,336,11,6,10,0,0,1,11,2,4,2,4,6,6,10,15,1,15,0,0,2,1,1,1
14430,37,343,647,139,84,35,284,233,682,0,0,0,0,0,0,0,0,0,0,0,0,2,2,2,0
14431,127,2187,1338,495,1086,10,64,173,1348,11,122,82,157,133,239,883,1686,7,11934,663,0,2,1,1,0
14432,37,343,647,139,84,35,284,233,682,0,0,0,0,0,0,0,0,0,0,0,0,2,6,6,1
14433,102,2071,384,251,317,7,8,52,391,11,70,44,84,81,128,467,811,6,5355,297,0,2,16,8,1
14434,61,2680,384,251,317,7,8,52,391,11,70,44,84,81,128,467,811,6,5355,297,0,2,59,6,1
14435,7,338,42,7,35,4,0,5,46,1,2,1,2,3,3,2,4,0,2,0,0,2,2,1,1
14436,7,338,11,6,10,0,0,1,11,2,4,2,4,6,6,10,15,1,15,0,0,2,2,1,1
14437,7,338,42,7,35,4,0,5,46,1,2,1,2,3,3,2,4,0,2,0,0,2,1,1,1
14438,7,338,11,6,10,0,0,1,11,2,4,2,4,6,6,10,15,1,15,0,0,2,1,1,1
14462,9,414,1289,550,1043,56,32,155,1345,10,167,93,185,177,278,1266,2075,5,11498,638,0,2,16,0,1
14463,170,3700,182,127,129,0,0,53,182,5,39,21,42,44,63,217,343,2,926,51,0,2,6,56,1
14464,170,3700,1165,710,800,67,119,181,1232,18,243,153,282,261,435,2000,3492,10,36473,2026,1,2,6,56,1
14465,72,1616,773,419,590,28,0,166,801,10,204,113,217,214,330,1598,2554,5,13587,754,0,2,20,40,1
14466,72,1616,421,273,302,44,34,57,465,17,81,59,107,98,166,583,1098,11,12329,684,0,2,20,40,1
14467,20,590,182,127,129,0,0,53,182,5,39,21,42,44,63,217,343,2,926,51,0,2,0,75,1
14468,98,3993,1392,870,1177,35,17,170,1427,14,494,280,531,508,811,4473,7289,7,54850,3047,2,2,0,1,1
14469,55,1917,773,419,590,28,0,166,801,10,204,113,217,214,330,1598,2554,5,13587,754,0,2,3,11,1
14493,7,338,42,7,35,4,0,5,46,1,2,1,2,3,3,2,4,0,2,0,0,2,1,1,0
14494,7,338,11,6,10,0,0,1,11,2,4,2,4,6,6,10,15,1,15,0,0,2,1,1,0
14518,170,3700,182,127,129,0,0,53,182,5,39,21,42,44,63,217,343,2,926,51,0,2,6,56,0
14519,170,3700,1165,710,800,67,119,181,1232,18,243,153,282,261,435,2000,3492,10,36473,2026,1,2,6,56,0
14520,72,1616,773,419,590,28,0,166,801,10,204,113,217,214,330,1598,2554,5,13587,754,0,2,20,40,0
14521,72,1616,421,273,302,44,34,57,465,17,81,59,107,98,166,583,1098,11,12329,684,0,2,20,40,0
14524,9,414,1289,550,1043,56,32,155,1345,10,167,93,185,177,278,1266,2075,5,11498,638,0,2,16,0,0
14525,20,590,182,127,129,0,0,53,182,5,39,21,42,44,63,217,343,2,926,51,0,2,0,75,0
14526,98,3993,1392,870,1177,35,17,170,1427,14,494,280,531,508,811,4473,7289,7,54850,3047,2,2,0,1,0
14527,55,1917,773,419,590,28,0,166,801,10,204,113,217,214,330,1598,2554,5,13587,754,0,2,3,11,0
14528,54,1911,773,419,590,28,0,166,801,10,204,113,217,214,330,1598,2554,5,13587,754,0,2,1,2,1
14529,12,564,1289,550,1043,56,32,155,1345,10,167,93,185,177,278,1266,2075,5,11498,638,0,2,42,0,1
14530,54,1884,773,419,590,28,0,166,801,10,204,113,217,214,330,1598,2554,5,13587,754,0,2,2,5,0
14531,72,1661,773,419,590,28,0,166,801,10,204,113,217,214,330,1598,2554,5,13587,754,0,2,9,1,0
14532,72,1661,421,273,302,44,34,57,465,17,81,59,107,98,166,583,1098,11,12329,684,0,2,9,1,0
14533,87,1695,1513,682,1277,25,13,200,1538,11,199,116,219,210,335,1557,2584,6,15641,868,0,2,103,103,1
14534,87,1695,819,519,539,24,98,155,843,15,96,57,106,111,163,690,1107,8,9171,509,0,2,103,103,1
14535,51,2204,1513,682,1277,25,13,200,1538,11,199,116,219,210,335,1557,2584,6,15641,868,0,2,43,3,1
14536,89,1783,1513,682,1277,25,13,200,1538,11,199,116,219,210,335,1557,2584,6,15641,868,0,2,29,25,0
14537,89,1783,819,519,539,24,98,155,843,15,96,57,106,111,163,690,1107,8,9171,509,0,2,29,25,0
14538,66,2628,1513,682,1277,25,13,200,1538,11,199,116,219,210,335,1557,2584,6,15641,868,0,2,81,8,0
14539,92,1793,1513,682,1277,25,13,200,1538,11,199,116,219,210,335,1557,2584,6,15641,868,0,2,16,6,0
14540,92,1793,819,519,539,24,98,155,843,15,96,57,106,111,163,690,1107,8,9171,509,0,2,16,6,0
14541,67,2673,1513,682,1277,25,13,200,1538,11,199,116,219,210,335,1557,2584,6,15641,868,0,2,22,0,0
14542,91,1781,1513,682,1277,25,13,200,1538,11,199,116,219,210,335,1557,2584,6,15641,868,0,2,26,35,0
14543,91,1781,819,519,539,24,98,155,843,15,96,57,106,111,163,690,1107,8,9171,509,0,2,26,35,0
14544,67,2671,1513,682,1277,25,13,200,1538,11,199,116,219,210,335,1557,2584,6,15641,868,0,2,1,2,0
14545,68,2725,1513,682,1277,25,13,200,1538,11,199,116,219,210,335,1557,2584,6,15641,868,0,2,11,1,0
14546,95,1800,1513,682,1277,25,13,200,1538,11,199,116,219,210,335,1557,2584,6,15641,868,0,2,18,20,0
14547,95,1800,819,519,539,24,98,155,843,15,96,57,106,111,163,690,1107,8,9171,509,0,2,18,20,0
14548,67,2671,1513,682,1277,25,13,200,1538,11,199,116,219,210,335,1557,2584,6,15641,868,0,2,1,11,0
14549,95,1806,1513,682,1277,25,13,200,1538,11,199,116,219,210,335,1557,2584,6,15641,868,0,2,1,0,0
14550,95,1806,819,519,539,24,98,155,843,15,96,57,106,111,163,690,1107,8,9171,509,0,2,1,0,0
14551,105,2122,384,251,317,7,8,52,391,11,70,44,84,81,128,467,811,6,5355,297,0,2,7,0,1
14552,62,2713,384,251,317,7,8,52,391,11,70,44,84,81,128,467,811,6,5355,297,0,2,26,0,1
14553,102,2071,384,251,317,7,8,52,391,11,70,44,84,81,128,467,811,6,5355,297,0,2,0,7,1
14554,61,2680,384,251,317,7,8,52,391,11,70,44,84,81,128,467,811,6,5355,297,0,2,0,26,1
14555,75,1691,773,419,590,28,0,166,801,10,204,113,217,214,330,1598,2554,5,13587,754,0,2,5,1,1
14556,75,1691,421,273,302,44,34,57,465,17,81,59,107,98,166,583,1098,11,12329,684,0,2,5,1,1
14557,57,1972,773,419,590,28,0,166,801,10,204,113,217,214,330,1598,2554,5,13587,754,0,2,14,0,1
14558,175,3745,182,127,129,0,0,53,182,5,39,21,42,44,63,217,343,2,926,51,0,2,30,18,1
14559,175,3745,1165,710,800,67,119,181,1232,18,243,153,282,261,435,2000,3492,10,36473,2026,1,2,30,18,1
14560,128,2196,1338,495,1086,10,64,173,1348,11,122,82,157,133,239,883,1686,7,11934,663,0,2,6,5,1
14561,98,3995,1392,870,1177,35,17,170,1427,14,494,280,531,508,811,4473,7289,7,54850,3047,2,2,10,10,1
14587,4,68,38,23,23,0,0,15,38,0,0,0,0,0,0,0,0,0,0,0,0,0,16,0,0
14588,29,591,127,75,83,2,11,30,129,4,14,7,14,18,21,61,87,2,175,9,0,2,22,1,0
14589,29,591,652,304,544,16,6,88,668,6,89,51,101,95,152,591,998,3,3399,188,0,2,22,1,0
14590,29,591,2,2,2,0,0,0,2,0,0,0,0,0,0,0,0,0,0,0,0,2,22,1,0
14591,29,591,8,5,5,0,0,3,8,0,0,0,0,0,0,0,0,0,0,0,0,2,22,1,0
14594,29,591,14,8,8,0,0,6,14,0,0,0,0,0,0,0,0,0,0,0,0,2,22,1,0
14595,29,591,6,4,4,0,0,2,6,0,0,0,0,0,0,0,0,0,0,0,0,2,22,1,0
14596,29,591,6,4,4,0,0,2,6,1,2,1,2,3,3,2,4,0,2,0,0,2,22,1,0
14598,29,591,7,5,5,0,0,2,7,0,0,0,0,0,0,0,0,0,0,0,0,2,22,1,0
14600,29,591,10,6,6,0,0,4,10,0,0,0,0,0,0,0,0,0,0,0,0,2,22,1,0
14601,29,591,1,1,1,0,0,0,1,0,0,0,0,0,0,0,0,0,0,0,0,2,22,1,0
14603,29,591,14,10,10,0,0,4,14,1,1,1,1,2,2,0,2,0,1,0,0,2,22,1,0
14604,29,591,46,26,30,3,0,12,49,3,6,3,6,9,9,20,28,1,42,2,0,2,22,1,0
14622,36,699,373,158,315,8,0,51,381,5,76,44,79,81,123,486,779,2,2026,112,0,2,13,7,1
14623,20,857,373,158,315,8,0,51,381,5,76,44,79,81,123,486,779,2,2026,112,0,2,10,0,1
14624,36,702,373,158,315,8,0,51,381,5,76,44,79,81,123,486,779,2,2026,112,0,2,1,0,1
14650,12,386,15,9,9,0,0,6,15,0,0,0,0,0,0,0,0,0,0,0,0,2,2,2,0
14697,75,1712,773,419,590,28,0,166,801,10,204,113,217,214,330,1598,2554,5,13587,754,0,2,5,2,0
14698,75,1712,421,273,302,44,34,57,465,17,81,59,107,98,166,583,1098,11,12329,684,0,2,5,2,0
14699,59,2040,773,419,590,28,0,166,801,10,204,113,217,214,330,1598,2554,5,13587,754,0,2,19,3,0
14723,128,2201,1338,495,1086,10,64,173,1348,11,122,82,157,133,239,883,1686,7,11934,663,0,2,2,1,1
14747,48,1010,1450,624,1228,12,26,181,1462,14,306,186,354,320,540,2580,4493,8,36391,2021,1,2,7,0,1
14748,50,1037,1450,624,1228,12,26,181,1462,14,306,186,354,320,540,2580,4493,8,36391,2021,1,2,7,0,1
14749,102,2071,384,251,317,7,8,52,391,11,70,44,84,81,128,467,811,6,5355,297,0,2,2,2,1
14750,50,1037,1450,624,1228,12,26,181,1462,14,306,186,354,320,540,2580,4493,8,36391,2021,1,2,1,1,0
14751,7,338,42,7,35,4,0,5,46,1,2,1,2,3,3,2,4,0,2,0,0,2,3,3,0
14752,7,338,11,6,10,0,0,1,11,2,4,2,4,6,6,10,15,1,15,0,0,2,3,3,0
14753,130,2241,1338,495,1086,10,64,173,1348,11,122,82,157,133,239,883,1686,7,11934,663,0,2,11,4,1
14755,59,2043,773,419,590,28,0,166,801,10,204,113,217,214,330,1598,2554,5,13587,754,0,2,1,1,1
14806,29,591,127,75,83,2,11,30,129,4,14,7,14,18,21,61,87,2,175,9,0,2,5,5,1
14807,29,591,652,304,544,16,6,88,668,6,89,51,101,95,152,591,998,3,3399,188,0,2,5,5,1
14808,29,591,2,2,2,0,0,0,2,0,0,0,0,0,0,0,0,0,0,0,0,2,5,5,1
14809,29,591,8,5,5,0,0,3,8,0,0,0,0,0,0,0,0,0,0,0,0,2,5,5,1
14812,29,591,14,8,8,0,0,6,14,0,0,0,0,0,0,0,0,0,0,0,0,2,5,5,1
14813,29,591,6,4,4,0,0,2,6,0,0,0,0,0,0,0,0,0,0,0,0,2,5,5,1
14814,29,591,6,4,4,0,0,2,6,1,2,1,2,3,3,2,4,0,2,0,0,2,5,5,1
14816,29,591,7,5,5,0,0,2,7,0,0,0,0,0,0,0,0,0,0,0,0,2,5,5,1
14818,29,591,10,6,6,0,0,4,10,0,0,0,0,0,0,0,0,0,0,0,0,2,5,5,1
14819,29,591,1,1,1,0,0,0,1,0,0,0,0,0,0,0,0,0,0,0,0,2,5,5,1
14821,29,591,14,10,10,0,0,4,14,1,1,1,1,2,2,0,2,0,1,0,0,2,5,5,1
14822,29,591,46,26,30,3,0,12,49,3,6,3,6,9,9,20,28,1,42,2,0,2,5,5,1
14825,18,389,2,2,2,0,0,0,2,0,0,0,0,0,0,0,0,0,0,0,0,2,12,12,1
14839,18,389,99,48,90,1,3,5,100,0,0,0,0,0,0,0,0,0,0,0,0,2,12,12,1
14840,18,389,8,5,5,2,0,1,10,0,0,0,0,0,0,0,0,0,0,0,0,2,12,12,1
14841,18,389,1217,716,841,84,126,174,1301,14,185,118,215,199,333,1446,2542,8,20687,1149,0,2,12,12,1
14842,18,389,160,89,115,0,13,31,160,7,15,11,17,22,28,78,124,3,495,27,0,2,12,12,1
14843,18,389,10,10,9,9,0,0,19,0,0,0,0,0,0,0,0,0,0,0,0,2,12,12,1
14844,18,389,173,84,99,8,29,36,181,5,12,7,13,17,20,54,81,2,221,12,0,2,12,12,1
14845,18,389,3,1,1,3,0,0,6,0,0,0,0,0,0,0,0,0,0,0,0,2,12,12,1
14846,36,512,282,196,195,3,0,86,285,8,130,71,141,138,212,936,1507,4,6538,363,0,2,3,3,1
14847,1,9,2,2,2,0,0,0,2,0,0,0,0,0,0,0,0,0,0,0,0,2,1,1,1
14848,1,83,13,10,10,0,0,3,13,1,2,1,2,3,3,2,4,0,2,0,0,2,1,1,1
14849,3,67,127,75,83,2,11,30,129,4,14,7,14,18,21,61,87,2,175,9,0,2,2,2,1
14850,3,67,652,304,544,16,6,88,668,6,89,51,101,95,152,591,998,3,3399,188,0,2,2,2,1
14851,3,67,2,2,2,0,0,0,2,0,0,0,0,0,0,0,0,0,0,0,0,2,2,2,1
14852,3,67,8,5,5,0,0,3,8,0,0,0,0,0,0,0,0,0,0,0,0,2,2,2,1
14855,3,67,14,8,8,0,0,6,14,0,0,0,0,0,0,0,0,0,0,0,0,2,2,2,1
14856,3,67,6,4,4,0,0,2,6,0,0,0,0,0,0,0,0,0,0,0,0,2,2,2,1
14857,3,67,6,4,4,0,0,2,6,1,2,1,2,3,3,2,4,0,2,0,0,2,2,2,1
14859,3,67,7,5,5,0,0,2,7,0,0,0,0,0,0,0,0,0,0,0,0,2,2,2,1
14861,3,67,10,6,6,0,0,4,10,0,0,0,0,0,0,0,0,0,0,0,0,2,2,2,1
14862,3,67,1,1,1,0,0,0,1,0,0,0,0,0,0,0,0,0,0,0,0,2,2,2,1
14864,3,67,14,10,10,0,0,4,14,1,1,1,1,2,2,0,2,0,1,0,0,2,2,2,1
14865,3,67,46,26,30,3,0,12,49,3,6,3,6,9,9,20,28,1,42,2,0,2,2,2,1
14912,6,106,127,75,83,2,11,30,129,4,14,7,14,18,21,61,87,2,175,9,0,2,3,3,1
14913,6,106,652,304,544,16,6,88,668,6,89,51,101,95,152,591,998,3,3399,188,0,2,3,3,1
14914,6,106,2,2,2,0,0,0,2,0,0,0,0,0,0,0,0,0,0,0,0,2,3,3,1
14915,6,106,8,5,5,0,0,3,8,0,0,0,0,0,0,0,0,0,0,0,0,2,3,3,1
14918,6,106,14,8,8,0,0,6,14,0,0,0,0,0,0,0,0,0,0,0,0,2,3,3,1
14919,6,106,6,4,4,0,0,2,6,0,0,0,0,0,0,0,0,0,0,0,0,2,3,3,1
14920,6,106,6,4,4,0,0,2,6,1,2,1,2,3,3,2,4,0,2,0,0,2,3,3,1
14922,6,106,7,5,5,0,0,2,7,0,0,0,0,0,0,0,0,0,0,0,0,2,3,3,1
14924,6,106,10,6,6,0,0,4,10,0,0,0,0,0,0,0,0,0,0,0,0,2,3,3,1
14925,6,106,1,1,1,0,0,0,1,0,0,0,0,0,0,0,0,0,0,0,0,2,3,3,1
14927,6,106,14,10,10,0,0,4,14,1,1,1,1,2,2,0,2,0,1,0,0,2,3,3,1
14928,6,106,46,26,30,3,0,12,49,3,6,3,6,9,9,20,28,1,42,2,0,2,3,3,1
14929,3,65,127,75,83,2,11,30,129,4,14,7,14,18,21,61,87,2,175,9,0,2,8,8,1
14930,3,65,652,304,544,16,6,88,668,6,89,51,101,95,152,591,998,3,3399,188,0,2,8,8,1
14931,3,65,2,2,2,0,0,0,2,0,0,0,0,0,0,0,0,0,0,0,0,2,8,8,1
14932,3,65,8,5,5,0,0,3,8,0,0,0,0,0,0,0,0,0,0,0,0,2,8,8,1
14935,3,65,14,8,8,0,0,6,14,0,0,0,0,0,0,0,0,0,0,0,0,2,8,8,1
14936,3,65,6,4,4,0,0,2,6,0,0,0,0,0,0,0,0,0,0,0,0,2,8,8,1
14937,3,65,6,4,4,0,0,2,6,1,2,1,2,3,3,2,4,0,2,0,0,2,8,8,1
14939,3,65,7,5,5,0,0,2,7,0,0,0,0,0,0,0,0,0,0,0,0,2,8,8,1
14941,3,65,10,6,6,0,0,4,10,0,0,0,0,0,0,0,0,0,0,0,0,2,8,8,1
14942,3,65,1,1,1,0,0,0,1,0,0,0,0,0,0,0,0,0,0,0,0,2,8,8,1
14944,3,65,14,10,10,0,0,4,14,1,1,1,1,2,2,0,2,0,1,0,0,2,8,8,1
14945,3,65,46,26,30,3,0,12,49,3,6,3,6,9,9,20,28,1,42,2,0,2,8,8,1
14969,15,451,1450,624,1228,12,26,181,1462,14,306,186,354,320,540,2580,4493,8,36391,2021,1,2,1,1,1
14970,175,3745,182,127,129,0,0,53,182,5,39,21,42,44,63,217,343,2,926,51,0,2,100,100,1
14971,175,3745,1165,710,800,67,119,181,1232,18,243,153,282,261,435,2000,3492,10,36473,2026,1,2,100,100,1
14972,75,1712,773,419,590,28,0,166,801,10,204,113,217,214,330,1598,2554,5,13587,754,0,2,31,31,1
14973,75,1712,421,273,302,44,34,57,465,17,81,59,107,98,166,583,1098,11,12329,684,0,2,31,31,1
14974,12,386,15,9,9,0,0,6,15,0,0,0,0,0,0,0,0,0,0,0,0,2,14,14,1
14975,95,1806,1513,682,1277,25,13,200,1538,11,199,116,219,210,335,1557,2584,6,15641,868,0,2,61,61,1
14976,95,1806,819,519,539,24,98,155,843,15,96,57,106,111,163,690,1107,8,9171,509,0,2,61,61,1
14977,9,270,149,95,105,2,0,41,151,8,54,28,55,62,83,334,494,4,2013,111,0,2,6,6,1
14978,9,270,82,56,54,0,13,15,82,4,13,8,16,17,24,56,98,2,241,13,0,2,6,6,1
14979,44,869,215,129,180,6,0,29,221,8,65,43,72,73,115,415,711,4,3153,175,0,2,47,47,1
14980,44,869,97,69,77,3,3,16,100,6,22,13,23,28,36,113,173,3,542,30,0,2,47,47,1
14981,37,343,647,139,84,35,284,233,682,0,0,0,0,0,0,0,0,0,0,0,0,2,21,21,1
14982,130,2241,1338,495,1086,10,64,173,1348,11,122,82,157,133,239,883,1686,7,11934,663,0,2,68,68,1
14983,72,1691,1457,730,1242,11,6,188,1468,10,292,166,329,302,495,2424,4078,5,22973,1276,1,2,48,48,1
14984,72,1691,74,35,59,1,0,14,75,3,14,7,14,17,21,58,85,1,128,7,0,2,48,48,1
14985,72,1691,245,125,200,5,7,34,250,7,30,17,34,37,51,166,265,3,1053,58,0,2,48,48,1
14986,32,621,334,251,279,10,4,40,344,5,127,74,143,132,217,899,1528,2,4303,239,0,2,13,13,1
14987,102,2071,384,251,317,7,8,52,391,11,70,44,84,81,128,467,811,6,5355,297,0,2,37,37,1
14988,36,702,373,158,315,8,0,51,381,5,76,44,79,81,123,486,779,2,2026,112,0,2,23,23,1
14989,7,338,42,7,35,4,0,5,46,1,2,1,2,3,3,2,4,0,2,0,0,2,3,3,1
14990,7,338,11,6,10,0,0,1,11,2,4,2,4,6,6,10,15,1,15,0,0,2,3,3,1
14991,12,564,1289,550,1043,56,32,155,1345,10,167,93,185,177,278,1266,2075,5,11498,638,0,2,5,5,1
15015,50,1037,1450,624,1228,12,26,181,1462,14,306,186,354,320,540,2580,4493,8,36391,2021,1,2,10,10,1
15016,20,590,182,127,129,0,0,53,182,5,39,21,42,44,63,217,343,2,926,51,0,2,8,8,1
15017,98,3995,1392,870,1177,35,17,170,1427,14,494,280,531,508,811,4473,7289,7,54850,3047,2,2,64,64,1
15018,59,2043,773,419,590,28,0,166,801,10,204,113,217,214,330,1598,2554,5,13587,754,0,2,30,30,1
15019,67,2671,1513,682,1277,25,13,200,1538,11,199,116,219,210,335,1557,2584,6,15641,868,0,2,63,63,1
15020,21,588,149,95,105,2,0,41,151,8,54,28,55,62,83,334,494,4,2013,111,0,2,7,7,1
15021,11,542,127,75,83,2,11,30,129,4,14,7,14,18,21,61,87,2,175,9,0,2,6,6,1
15022,11,542,652,304,544,16,6,88,668,6,89,51,101,95,152,591,998,3,3399,188,0,2,6,6,1
15023,11,542,2,2,2,0,0,0,2,0,0,0,0,0,0,0,0,0,0,0,0,2,6,6,1
15024,11,542,8,5,5,0,0,3,8,0,0,0,0,0,0,0,0,0,0,0,0,2,6,6,1
15027,11,542,14,8,8,0,0,6,14,0,0,0,0,0,0,0,0,0,0,0,0,2,6,6,1
15028,11,542,6,4,4,0,0,2,6,0,0,0,0,0,0,0,0,0,0,0,0,2,6,6,1
15029,11,542,6,4,4,0,0,2,6,1,2,1,2,3,3,2,4,0,2,0,0,2,6,6,1
15031,11,542,7,5,5,0,0,2,7,0,0,0,0,0,0,0,0,0,0,0,0,2,6,6,1
15033,11,542,10,6,6,0,0,4,10,0,0,0,0,0,0,0,0,0,0,0,0,2,6,6,1
15034,11,542,1,1,1,0,0,0,1,0,0,0,0,0,0,0,0,0,0,0,0,2,6,6,1
15036,11,542,14,10,10,0,0,4,14,1,1,1,1,2,2,0,2,0,1,0,0,2,6,6,1
15037,11,542,46,26,30,3,0,12,49,3,6,3,6,9,9,20,28,1,42,2,0,2,6,6,1
15038,7,168,127,75,83,2,11,30,129,4,14,7,14,18,21,61,87,2,175,9,0,2,5,5,1
15039,7,168,652,304,544,16,6,88,668,6,89,51,101,95,152,591,998,3,3399,188,0,2,5,5,1
15040,7,168,2,2,2,0,0,0,2,0,0,0,0,0,0,0,0,0,0,0,0,2,5,5,1
15041,7,168,8,5,5,0,0,3,8,0,0,0,0,0,0,0,0,0,0,0,0,2,5,5,1
15044,7,168,14,8,8,0,0,6,14,0,0,0,0,0,0,0,0,0,0,0,0,2,5,5,1
15045,7,168,6,4,4,0,0,2,6,0,0,0,0,0,0,0,0,0,0,0,0,2,5,5,1
15046,7,168,6,4,4,0,0,2,6,1,2,1,2,3,3,2,4,0,2,0,0,2,5,5,1
15048,7,168,7,5,5,0,0,2,7,0,0,0,0,0,0,0,0,0,0,0,0,2,5,5,1
15050,7,168,10,6,6,0,0,4,10,0,0,0,0,0,0,0,0,0,0,0,0,2,5,5,1
15051,7,168,1,1,1,0,0,0,1,0,0,0,0,0,0,0,0,0,0,0,0,2,5,5,1
15053,7,168,14,10,10,0,0,4,14,1,1,1,1,2,2,0,2,0,1,0,0,2,5,5,1
15054,7,168,46,26,30,3,0,12,49,3,6,3,6,9,9,20,28,1,42,2,0,2,5,5,1
15055,44,2723,1457,730,1242,11,6,188,1468,10,292,166,329,302,495,2424,4078,5,22973,1276,1,2,40,40,1
15056,61,2680,384,251,317,7,8,52,391,11,70,44,84,81,128,467,811,6,5355,297,0,2,32,32,1
15057,20,856,373,158,315,8,0,51,381,5,76,44,79,81,123,486,779,2,2026,112,0,2,29,29,1
15058,75,1712,773,419,590,28,0,166,801,10,204,113,217,214,330,1598,2554,5,13587,754,0,2,6,9,0
15059,75,1712,421,273,302,44,34,57,465,17,81,59,107,98,166,583,1098,11,12329,684,0,2,6,9,0
15060,60,2071,773,419,590,28,0,166,801,10,204,113,217,214,330,1598,2554,5,13587,754,0,2,7,0,0
15086,13,638,1289,550,1043,56,32,155,1345,10,167,93,185,177,278,1266,2075,5,11498,638,0,2,16,0,1
15112,17,491,1450,624,1228,12,26,181,1462,14,306,186,354,320,540,2580,4493,8,36391,2021,1,2,15,4,0
15113,38,354,647,139,84,35,284,233,682,0,0,0,0,0,0,0,0,0,0,0,0,2,13,0,0
15114,104,2098,384,251,317,7,8,52,391,11,70,44,84,81,128,467,811,6,5355,297,0,2,2,0,0
15115,62,2707,384,251,317,7,8,52,391,11,70,44,84,81,128,467,811,6,5355,297,0,2,4,0,0
15118,175,3780,182,127,129,0,0,53,182,5,39,21,42,44,63,217,343,2,926,51,0,2,9,1,1
15119,175,3780,1165,710,800,67,119,181,1232,18,243,153,282,261,435,2000,3492,10,36473,2026,1,2,9,1,1
15120,99,4033,1392,870,1177,35,17,170,1427,14,494,280,531,508,811,4473,7289,7,54850,3047,2,2,9,0,1
15121,100,4061,1392,870,1177,35,17,170,1427,14,494,280,531,508,811,4473,7289,7,54850,3047,2,2,5,1,0
15145,7,338,42,7,35,4,0,5,46,1,2,1,2,3,3,2,4,0,2,0,0,2,2,2,1
15146,7,338,11,6,10,0,0,1,11,2,4,2,4,6,6,10,15,1,15,0,0,2,2,2,1
15171,175,3780,182,127,129,0,0,53,182,5,39,21,42,44,63,217,343,2,926,51,0,2,1,1,1
15172,175,3780,1165,710,800,67,119,181,1232,18,243,153,282,261,435,2000,3492,10,36473,2026,1,2,1,1,1
15173,75,1712,773,419,590,28,0,166,801,10,204,113,217,214,330,1598,2554,5,13587,754,0,2,1,1,1
15174,75,1712,421,273,302,44,34,57,465,17,81,59,107,98,166,583,1098,11,12329,684,0,2,1,1,1
15175,9,265,149,95,105,2,0,41,151,8,54,28,55,62,83,334,494,4,2013,111,0,2,1,3,1
15176,9,265,82,56,54,0,13,15,82,4,13,8,16,17,24,56,98,2,241,13,0,2,1,3,1
15177,130,2241,1338,495,1086,10,64,173,1348,11,122,82,157,133,239,883,1686,7,11934,663,0,2,1,1,1
15178,7,338,42,7,35,4,0,5,46,1,2,1,2,3,3,2,4,0,2,0,0,2,5,1,1
15179,7,338,11,6,10,0,0,1,11,2,4,2,4,6,6,10,15,1,15,0,0,2,5,1,1
15203,42,383,647,139,84,35,284,233,682,0,0,0,0,0,0,0,0,0,0,0,0,2,20,4,1
15204,86,1559,1338,495,1086,10,64,173,1348,11,122,82,157,133,239,883,1686,7,11934,663,0,2,8,135,1
15205,46,1093,1457,730,1242,11,6,188,1468,10,292,166,329,302,495,2424,4078,5,22973,1276,1,2,3,96,1
15206,46,1093,74,35,59,1,0,14,75,3,14,7,14,17,21,58,85,1,128,7,0,2,3,96,1
15207,46,1093,245,125,200,5,7,34,250,7,30,17,34,37,51,166,265,3,1053,58,0,2,3,96,1
15208,104,2098,384,251,317,7,8,52,391,11,70,44,84,81,128,467,811,6,5355,297,0,2,1,1,1
15209,75,1481,373,158,315,8,0,51,381,5,76,44,79,81,123,486,779,2,2026,112,0,2,187,60,1
15212,16,756,1289,550,1043,56,32,155,1345,10,167,93,185,177,278,1266,2075,5,11498,638,0,2,30,2,1
15213,28,2004,1296,573,1062,40,33,157,1336,8,201,118,231,209,349,1561,2689,4,12365,686,0,0,314,0,1
15214,17,1070,1457,730,1242,11,6,188,1468,10,292,166,329,302,495,2424,4078,5,22973,1276,1,2,0,230,1
15215,19,830,373,158,315,8,0,51,381,5,76,44,79,81,123,486,779,2,2026,112,0,2,5,10,1
15216,42,626,282,196,195,3,0,86,285,8,130,71,141,138,212,936,1507,4,6538,363,0,2,20,0,0
15217,38,354,647,139,84,35,284,233,682,0,0,0,0,0,0,0,0,0,0,0,0,2,6,5,0
15241,17,491,1450,624,1228,12,26,181,1462,14,306,186,354,320,540,2580,4493,8,36391,2021,1,2,1,1,0
15242,175,3780,182,127,129,0,0,53,182,5,39,21,42,44,63,217,343,2,926,51,0,2,10,2,0
15243,175,3780,1165,710,800,67,119,181,1232,18,243,153,282,261,435,2000,3492,10,36473,2026,1,2,10,2,0
15244,75,1712,773,419,590,28,0,166,801,10,204,113,217,214,330,1598,2554,5,13587,754,0,2,1,1,0
15245,75,1712,421,273,302,44,34,57,465,17,81,59,107,98,166,583,1098,11,12329,684,0,2,1,1,0
15246,9,265,149,95,105,2,0,41,151,8,54,28,55,62,83,334,494,4,2013,111,0,2,1,3,0
15247,9,265,82,56,54,0,13,15,82,4,13,8,16,17,24,56,98,2,241,13,0,2,1,3,0
15248,130,2241,1338,495,1086,10,64,173,1348,11,122,82,157,133,239,883,1686,7,11934,663,0,2,1,1,0
15249,7,338,42,7,35,4,0,5,46,1,2,1,2,3,3,2,4,0,2,0,0,2,7,3,0
15250,7,338,11,6,10,0,0,1,11,2,4,2,4,6,6,10,15,1,15,0,0,2,7,3,0
15251,100,4061,1392,870,1177,35,17,170,1427,14,494,280,531,508,811,4473,7289,7,54850,3047,2,2,13,0,0
15276,43,402,647,139,84,35,284,233,682,0,0,0,0,0,0,0,0,0,0,0,0,2,9,3,1
15277,105,2126,384,251,317,7,8,52,391,11,70,44,84,81,128,467,811,6,5355,297,0,2,7,4,1
15278,68,1433,373,158,315,8,0,51,381,5,76,44,79,81,123,486,779,2,2026,112,0,2,65,86,1
15279,28,2004,1296,573,1062,40,33,157,1336,8,201,118,231,209,349,1561,2689,4,12365,686,0,2,1,1,1
15280,63,2799,384,251,317,7,8,52,391,11,70,44,84,81,128,467,811,6,5355,297,0,2,13,0,1
15281,43,402,647,139,84,35,284,233,682,0,0,0,0,0,0,0,0,0,0,0,0,2,4,2,1
15282,86,1556,1338,495,1086,10,64,173,1348,11,122,82,157,133,239,883,1686,7,11934,663,0,2,0,1,1
15283,105,2126,384,251,317,7,8,52,391,11,70,44,84,81,128,467,811,6,5355,297,0,2,3,3,1
15284,69,1442,373,158,315,8,0,51,381,5,76,44,79,81,123,486,779,2,2026,112,0,2,3,0,1
15285,28,2012,1296,573,1062,40,33,157,1336,8,201,118,231,209,349,1561,2689,4,12365,686,0,2,8,8,1
15286,19,836,373,158,315,8,0,51,381,5,76,44,79,81,123,486,779,2,2026,112,0,2,3,3,1
15287,44,411,647,139,84,35,284,233,682,0,0,0,0,0,0,0,0,0,0,0,0,2,5,3,1
15288,44,415,647,139,84,35,284,233,682,0,0,0,0,0,0,0,0,0,0,0,0,2,2,2,1
15289,68,1426,373,158,315,8,0,51,381,5,76,44,79,81,123,486,779,2,2026,112,0,2,12,18,1
15290,69,1471,373,158,315,8,0,51,381,5,76,44,79,81,123,486,779,2,2026,112,0,2,37,28,1
15291,17,803,1289,550,1043,56,32,155,1345,10,167,93,185,177,278,1266,2075,5,11498,638,0,2,20,0,1
15292,71,1474,373,158,315,8,0,51,381,5,76,44,79,81,123,486,779,2,2026,112,0,2,1,1,0
15293,60,2071,773,419,590,28,0,166,801,10,204,113,217,214,330,1598,2554,5,13587,754,0,2,1,1,1
15294,46,754,282,196,195,3,0,86,285,8,130,71,141,138,212,936,1507,4,6538,363,0,2,18,0,0
15295,46,754,282,196,195,3,0,86,285,8,130,71,141,138,212,936,1507,4,6538,363,0,2,38,0,0
15297,45,426,647,139,84,35,284,233,682,0,0,0,0,0,0,0,0,0,0,0,0,2,14,0,0
15321,17,494,1450,624,1228,12,26,181,1462,14,306,186,354,320,540,2580,4493,8,36391,2021,1,2,1,1,1
15322,45,428,647,139,84,35,284,233,682,0,0,0,0,0,0,0,0,0,0,0,0,2,1,1,1
15323,52,1094,1450,624,1228,12,26,181,1462,14,306,186,354,320,540,2580,4493,8,36391,2021,1,2,10,0,1
15348,45,428,647,139,84,35,284,233,682,0,0,0,0,0,0,0,0,0,0,0,0,2,7,8,1
15349,52,1094,1450,624,1228,12,26,181,1462,14,306,186,354,320,540,2580,4493,8,36391,2021,1,2,2,2,1
15374,17,494,1450,624,1228,12,26,181,1462,14,306,186,354,320,540,2580,4493,8,36391,2021,1,2,17,6,0
15381,45,428,647,139,84,35,284,233,682,0,0,0,0,0,0,0,0,0,0,0,0,2,46,7,0
15382,86,1556,1338,495,1086,10,64,173,1348,11,122,82,157,133,239,883,1686,7,11934,663,0,2,9,137,0
15383,46,1093,1457,730,1242,11,6,188,1468,10,292,166,329,302,495,2424,4078,5,22973,1276,1,2,3,96,0
15384,46,1093,74,35,59,1,0,14,75,3,14,7,14,17,21,58,85,1,128,7,0,2,3,96,0
15385,46,1093,245,125,200,5,7,34,250,7,30,17,34,37,51,166,265,3,1053,58,0,2,3,96,0
15386,105,2126,384,251,317,7,8,52,391,11,70,44,84,81,128,467,811,6,5355,297,0,2,12,7,0
15387,71,1474,373,158,315,8,0,51,381,5,76,44,79,81,123,486,779,2,2026,112,0,2,201,89,0
15390,17,803,1289,550,1043,56,32,155,1345,10,167,93,185,177,278,1266,2075,5,11498,638,0,2,50,2,0
15391,52,1094,1450,624,1228,12,26,181,1462,14,306,186,354,320,540,2580,4493,8,36391,2021,1,2,10,0,0
15393,60,2071,773,419,590,28,0,166,801,10,204,113,217,214,330,1598,2554,5,13587,754,0,2,1,1,0
15394,28,2012,1296,573,1062,40,33,157,1336,8,201,118,231,209,349,1561,2689,4,12365,686,0,0,314,0,0
15395,17,1070,1457,730,1242,11,6,188,1468,10,292,166,329,302,495,2424,4078,5,22973,1276,1,2,0,230,0
15396,63,2799,384,251,317,7,8,52,391,11,70,44,84,81,128,467,811,6,5355,297,0,2,17,0,0
15397,19,836,373,158,315,8,0,51,381,5,76,44,79,81,123,486,779,2,2026,112,0,2,8,13,0
15398,16,817,1289,550,1043,56,32,155,1345,10,167,93,185,177,278,1266,2075,5,11498,638,0,2,25,28,1
15399,68,1428,373,158,315,8,0,51,381,5,76,44,79,81,123,486,779,2,2026,112,0,2,0,7,1
15400,28,1989,1296,573,1062,40,33,157,1336,8,201,118,231,209,349,1561,2689,4,12365,686,0,2,15,18,1
15401,47,774,282,196,195,3,0,86,285,8,130,71,141,138,212,936,1507,4,6538,363,0,2,3,0,1
15426,107,2170,384,251,317,7,8,52,391,11,70,44,84,81,128,467,811,6,5355,297,0,2,6,1,0
15427,65,2882,384,251,317,7,8,52,391,11,70,44,84,81,128,467,811,6,5355,297,0,2,15,0,0
15453,17,899,1289,550,1043,56,32,155,1345,10,167,93,185,177,278,1266,2075,5,11498,638,0,2,8,0,1
15454,18,929,1289,550,1043,56,32,155,1345,10,167,93,185,177,278,1266,2075,5,11498,638,0,2,7,3,0
15455,52,895,282,196,195,3,0,86,285,8,130,71,141,138,212,936,1507,4,6538,363,0,2,30,0,0
15456,1,83,13,10,10,0,0,3,13,1,2,1,2,3,3,2,4,0,2,0,0,2,1,1,0
15457,56,1187,1450,624,1228,12,26,181,1462,14,306,186,354,320,540,2580,4493,8,36391,2021,1,2,21,0,0
15458,56,1209,1450,624,1228,12,26,181,1462,14,306,186,354,320,540,2580,4493,8,36391,2021,1,2,3,0,0
15459,175,3785,182,127,129,0,0,53,182,5,39,21,42,44,63,217,343,2,926,51,0,2,2,1,0
15460,175,3785,1165,710,800,67,119,181,1232,18,243,153,282,261,435,2000,3492,10,36473,2026,1,2,2,1,0
15461,83,1749,1457,730,1242,11,6,188,1468,10,292,166,329,302,495,2424,4078,5,22973,1276,1,2,121,1,0
15462,83,1749,74,35,59,1,0,14,75,3,14,7,14,17,21,58,85,1,128,7,0,2,121,1,0
15463,83,1749,245,125,200,5,7,34,250,7,30,17,34,37,51,166,265,3,1053,58,0,2,121,1,0
15464,24,1258,652,304,544,16,6,88,668,6,89,51,101,95,152,591,998,3,3399,188,0,3,1,1,0
15465,115,2359,1457,730,1242,11,6,188,1468,10,292,166,329,302,495,2424,4078,5,22973,1276,1,2,96,2,0
15466,115,2359,74,35,59,1,0,14,75,3,14,7,14,17,21,58,85,1,128,7,0,2,96,2,0
15467,115,2359,245,125,200,5,7,34,250,7,30,17,34,37,51,166,265,3,1053,58,0,2,96,2,0
15469,18,814,334,251,279,10,4,40,344,5,127,74,143,132,217,899,1528,2,4303,239,0,2,1,1,0
15756,1,34,2,2,2,0,0,0,2,0,0,0,0,0,0,0,0,0,0,0,0,0,15,0,1
15770,1,34,99,48,90,1,3,5,100,0,0,0,0,0,0,0,0,0,0,0,0,0,15,0,1
15771,1,34,8,5,5,2,0,1,10,0,0,0,0,0,0,0,0,0,0,0,0,0,15,0,1
15772,1,34,1217,716,841,84,126,174,1301,14,185,118,215,199,333,1446,2542,8,20687,1149,0,0,15,0,1
15773,1,34,160,89,115,0,13,31,160,7,15,11,17,22,28,78,124,3,495,27,0,0,15,0,1
15774,1,34,10,10,9,9,0,0,19,0,0,0,0,0,0,0,0,0,0,0,0,0,15,0,1
15775,1,34,173,84,99,8,29,36,181,5,12,7,13,17,20,54,81,2,221,12,0,0,15,0,1
15776,1,34,3,1,1,3,0,0,6,0,0,0,0,0,0,0,0,0,0,0,0,0,15,0,1
15778,115,2357,1457,730,1242,11,6,188,1468,10,292,166,329,302,495,2424,4078,5,22973,1276,1,3,1,1,1
15779,115,2357,74,35,59,1,0,14,75,3,14,7,14,17,21,58,85,1,128,7,0,3,1,1,1
15780,115,2357,245,125,200,5,7,34,250,7,30,17,34,37,51,166,265,3,1053,58,0,3,1,1,1
15805,110,2181,384,251,317,7,8,52,391,11,70,44,84,81,128,467,811,6,5355,297,0,3,19,8,1
15806,68,1413,373,158,315,8,0,51,381,5,76,44,79,81,123,486,779,2,2026,112,0,3,5,5,1
15807,6,277,42,7,35,4,0,5,46,1,2,1,2,3,3,2,4,0,2,0,0,2,9,29,1
15808,6,277,11,6,10,0,0,1,11,2,4,2,4,6,6,10,15,1,15,0,0,2,9,29,1
15859,17,333,127,75,83,2,11,30,129,4,14,7,14,18,21,61,87,2,175,9,0,2,57,1,1
15860,17,333,652,304,544,16,6,88,668,6,89,51,101,95,152,591,998,3,3399,188,0,2,57,1,1
15861,17,333,2,2,2,0,0,0,2,0,0,0,0,0,0,0,0,0,0,0,0,2,57,1,1
15862,17,333,8,5,5,0,0,3,8,0,0,0,0,0,0,0,0,0,0,0,0,2,57,1,1
15865,17,333,14,8,8,0,0,6,14,0,0,0,0,0,0,0,0,0,0,0,0,2,57,1,1
15866,17,333,6,4,4,0,0,2,6,0,0,0,0,0,0,0,0,0,0,0,0,2,57,1,1
15867,17,333,6,4,4,0,0,2,6,1,2,1,2,3,3,2,4,0,2,0,0,2,57,1,1
15869,17,333,7,5,5,0,0,2,7,0,0,0,0,0,0,0,0,0,0,0,0,2,57,1,1
15871,17,333,10,6,6,0,0,4,10,0,0,0,0,0,0,0,0,0,0,0,0,2,57,1,1
15872,17,333,1,1,1,0,0,0,1,0,0,0,0,0,0,0,0,0,0,0,0,2,57,1,1
15874,17,333,14,10,10,0,0,4,14,1,1,1,1,2,2,0,2,0,1,0,0,2,57,1,1
15875,17,333,46,26,30,3,0,12,49,3,6,3,6,9,9,20,28,1,42,2,0,2,57,1,1
15941,7,166,127,75,83,2,11,30,129,4,14,7,14,18,21,61,87,2,175,9,0,2,3,3,1
15942,7,166,652,304,544,16,6,88,668,6,89,51,101,95,152,591,998,3,3399,188,0,2,3,3,1
15943,7,166,2,2,2,0,0,0,2,0,0,0,0,0,0,0,0,0,0,0,0,2,3,3,1
15944,7,166,8,5,5,0,0,3,8,0,0,0,0,0,0,0,0,0,0,0,0,2,3,3,1
15947,7,166,14,8,8,0,0,6,14,0,0,0,0,0,0,0,0,0,0,0,0,2,3,3,1
15948,7,166,6,4,4,0,0,2,6,0,0,0,0,0,0,0,0,0,0,0,0,2,3,3,1
15949,7,166,6,4,4,0,0,2,6,1,2,1,2,3,3,2,4,0,2,0,0,2,3,3,1
15951,7,166,7,5,5,0,0,2,7,0,0,0,0,0,0,0,0,0,0,0,0,2,3,3,1
15953,7,166,10,6,6,0,0,4,10,0,0,0,0,0,0,0,0,0,0,0,0,2,3,3,1
15954,7,166,1,1,1,0,0,0,1,0,0,0,0,0,0,0,0,0,0,0,0,2,3,3,1
15956,7,166,14,10,10,0,0,4,14,1,1,1,1,2,2,0,2,0,1,0,0,2,3,3,1
15957,7,166,46,26,30,3,0,12,49,3,6,3,6,9,9,20,28,1,42,2,0,2,3,3,1
16004,28,1987,1296,573,1062,40,33,157,1336,8,201,118,231,209,349,1561,2689,4,12365,686,0,2,1,1,1
16005,24,1256,652,304,544,16,6,88,668,6,89,51,101,95,152,591,998,3,3399,188,0,2,1,1,1
16007,65,2872,384,251,317,7,8,52,391,11,70,44,84,81,128,467,811,6,5355,297,0,2,5,5,1
16010,4,122,2,2,2,0,0,0,2,0,0,0,0,0,0,0,0,0,0,0,0,2,18,7,1
16024,4,122,99,48,90,1,3,5,100,0,0,0,0,0,0,0,0,0,0,0,0,2,18,7,1
16025,4,122,8,5,5,2,0,1,10,0,0,0,0,0,0,0,0,0,0,0,0,2,18,7,1
16026,4,122,1217,716,841,84,126,174,1301,14,185,118,215,199,333,1446,2542,8,20687,1149,0,2,18,7,1
16027,4,122,160,89,115,0,13,31,160,7,15,11,17,22,28,78,124,3,495,27,0,2,18,7,1
16028,4,122,10,10,9,9,0,0,19,0,0,0,0,0,0,0,0,0,0,0,0,2,18,7,1
16029,4,122,173,84,99,8,29,36,181,5,12,7,13,17,20,54,81,2,221,12,0,2,18,7,1
16030,4,122,3,1,1,3,0,0,6,0,0,0,0,0,0,0,0,0,0,0,0,2,18,7,1
16031,3,108,77,34,69,0,0,8,77,3,24,16,29,27,45,114,213,1,387,21,0,0,18,0,1
16032,3,108,712,438,573,51,9,84,763,14,102,71,128,116,199,733,1364,8,11988,666,0,0,18,0,1
16033,110,2181,384,251,317,7,8,52,391,11,70,44,84,81,128,467,811,6,5355,297,0,2,3,3,1
16034,6,277,42,7,35,4,0,5,46,1,2,1,2,3,3,2,4,0,2,0,0,2,1,1,1
16035,6,277,11,6,10,0,0,1,11,2,4,2,4,6,6,10,15,1,15,0,0,2,1,1,1
16036,28,1989,1296,573,1062,40,33,157,1336,8,201,118,231,209,349,1561,2689,4,12365,686,0,2,1,1,1
16037,25,1318,652,304,544,16,6,88,668,6,89,51,101,95,152,591,998,3,3399,188,0,2,10,0,1
16040,4,135,2,2,2,0,0,0,2,0,0,0,0,0,0,0,0,0,0,0,0,2,4,2,1
16054,4,135,99,48,90,1,3,5,100,0,0,0,0,0,0,0,0,0,0,0,0,2,4,2,1
16055,4,135,8,5,5,2,0,1,10,0,0,0,0,0,0,0,0,0,0,0,0,2,4,2,1
16056,4,135,1217,716,841,84,126,174,1301,14,185,118,215,199,333,1446,2542,8,20687,1149,0,2,4,2,1
16057,4,135,160,89,115,0,13,31,160,7,15,11,17,22,28,78,124,3,495,27,0,2,4,2,1
16058,4,135,10,10,9,9,0,0,19,0,0,0,0,0,0,0,0,0,0,0,0,2,4,2,1
16059,4,135,173,84,99,8,29,36,181,5,12,7,13,17,20,54,81,2,221,12,0,2,4,2,1
16060,4,135,3,1,1,3,0,0,6,0,0,0,0,0,0,0,0,0,0,0,0,2,4,2,1
16061,114,2331,1457,730,1242,11,6,188,1468,10,292,166,329,302,495,2424,4078,5,22973,1276,1,3,0,10,1
16062,111,2222,384,251,317,7,8,52,391,11,70,44,84,81,128,467,811,6,5355,297,0,2,3,3,1
16063,16,1031,1457,730,1242,11,6,188,1468,10,292,166,329,302,495,2424,4078,5,22973,1276,1,2,0,7,1
16064,25,1318,652,304,544,16,6,88,668,6,89,51,101,95,152,591,998,3,3399,188,0,2,1,1,1
16066,65,2872,384,251,317,7,8,52,391,11,70,44,84,81,128,467,811,6,5355,297,0,2,3,3,1
16069,1,50,2,2,2,0,0,0,2,0,0,0,0,0,0,0,0,0,0,0,0,2,6,19,1
16083,1,50,99,48,90,1,3,5,100,0,0,0,0,0,0,0,0,0,0,0,0,2,6,19,1
16084,1,50,8,5,5,2,0,1,10,0,0,0,0,0,0,0,0,0,0,0,0,2,6,19,1
16085,1,50,1217,716,841,84,126,174,1301,14,185,118,215,199,333,1446,2542,8,20687,1149,0,2,6,19,1
16086,1,50,160,89,115,0,13,31,160,7,15,11,17,22,28,78,124,3,495,27,0,2,6,19,1
16087,1,50,10,10,9,9,0,0,19,0,0,0,0,0,0,0,0,0,0,0,0,2,6,19,1
16088,1,50,173,84,99,8,29,36,181,5,12,7,13,17,20,54,81,2,221,12,0,2,6,19,1
16089,1,50,3,1,1,3,0,0,6,0,0,0,0,0,0,0,0,0,0,0,0,2,6,19,1
16090,114,2326,1457,730,1242,11,6,188,1468,10,292,166,329,302,495,2424,4078,5,22973,1276,1,2,0,2,1
16091,86,1567,1338,495,1086,10,64,173,1348,11,122,82,157,133,239,883,1686,7,11934,663,0,2,2,0,1
16092,110,2212,384,251,317,7,8,52,391,11,70,44,84,81,128,467,811,6,5355,297,0,2,3,5,1
16093,6,283,42,7,35,4,0,5,46,1,2,1,2,3,3,2,4,0,2,0,0,2,1,0,1
16094,6,283,11,6,10,0,0,1,11,2,4,2,4,6,6,10,15,1,15,0,0,2,1,0,1
16095,6,283,42,7,35,4,0,5,46,1,2,1,2,3,3,2,4,0,2,0,0,2,1,1,0
16096,6,283,11,6,10,0,0,1,11,2,4,2,4,6,6,10,15,1,15,0,0,2,1,1,0
16314,45,428,647,139,84,35,284,233,682,0,0,0,0,0,0,0,0,0,0,0,0,3,17,10,1
16315,110,2210,384,251,317,7,8,52,391,11,70,44,84,81,128,467,811,6,5355,297,0,2,1,1,1
16319,17,570,1455,414,1257,16,76,112,1471,5,41,23,46,46,69,231,381,2,1069,59,0,3,2,23,0
16320,17,570,669,365,481,22,61,110,691,15,103,63,122,118,185,747,1273,8,11311,628,0,3,2,23,0
16333,137,3233,722,423,573,19,0,135,741,12,172,101,199,184,300,1320,2257,6,15668,870,0,3,1,1,0
16334,137,3233,1508,847,911,44,250,301,1552,14,148,88,169,162,257,1120,1886,7,15077,837,0,3,1,1,0
16335,194,4278,72,33,56,0,4,12,72,1,1,1,1,2,2,0,2,0,1,0,0,3,1,1,0
16336,194,4278,1454,835,1044,76,110,219,1530,17,275,158,296,292,454,2297,3718,9,34017,1889,1,3,1,1,0
16352,111,2230,384,251,317,7,8,52,391,11,70,44,84,81,128,467,811,6,5355,297,0,2,6,4,0
16353,26,920,1450,624,1228,12,26,181,1462,14,306,186,354,320,540,2580,4493,8,36391,2021,1,3,1,1,0
16354,34,1380,1513,682,1277,25,13,200,1538,11,199,116,219,210,335,1557,2584,6,15641,868,0,3,1,1,0
16355,10,403,1455,414,1257,16,76,112,1471,5,41,23,46,46,69,231,381,2,1069,59,0,3,1,1,0
16356,7,226,74,35,59,1,0,14,75,3,14,7,14,17,21,58,85,1,128,7,0,3,1,1,0
16358,15,734,1020,354,843,12,15,144,1032,8,134,77,144,142,221,970,1580,4,6792,377,0,3,1,1,0
16359,12,820,447,308,343,6,5,95,453,7,96,59,111,103,170,651,1136,4,4600,255,0,3,1,1,0
16363,5,333,722,423,573,19,0,135,741,12,172,101,199,184,300,1320,2257,6,15668,870,0,3,1,1,0
16364,12,418,386,256,301,16,9,68,402,4,59,35,69,63,104,355,621,2,1453,80,0,3,1,1,0
16365,13,1146,215,129,180,6,0,29,221,8,65,43,72,73,115,415,711,4,3153,175,0,3,2,2,0
16366,44,1644,1043,504,840,53,9,147,1096,9,180,112,198,189,310,1377,2344,4,11604,644,0,3,1,1,0
16367,24,1010,373,158,315,8,0,51,381,5,76,44,79,81,123,486,779,2,2026,112,0,3,1,1,0
16368,28,1387,1178,367,1042,6,15,115,1184,9,94,51,95,103,146,644,976,4,4439,246,0,3,3,4,0
16369,50,2500,1943,715,1694,26,18,214,1969,12,185,120,237,197,357,1436,2721,7,20915,1161,0,3,2,2,0
16370,2,103,442,244,305,14,16,103,456,11,68,45,75,79,120,452,756,6,4588,254,0,3,2,2,0
16372,28,1989,1296,573,1062,40,33,157,1336,8,201,118,231,209,349,1561,2689,4,12365,686,0,2,1,1,0
16374,86,1567,1338,495,1086,10,64,173,1348,11,122,82,157,133,239,883,1686,7,11934,663,0,2,24,19,1
16375,45,428,647,139,84,35,284,233,682,0,0,0,0,0,0,0,0,0,0,0,0,2,19,10,1
16376,100,2397,1043,504,840,53,9,147,1096,9,180,112,198,189,310,1377,2344,4,11604,644,0,2,24,0,1
16377,100,2397,383,288,292,26,6,62,409,11,65,38,67,76,105,429,656,5,3719,206,0,2,24,0,1
16378,114,2321,1457,730,1242,11,6,188,1468,10,292,166,329,302,495,2424,4078,5,22973,1276,1,2,10,10,1
16380,18,379,1098,241,925,5,10,155,1103,7,46,25,49,53,74,273,423,3,1580,87,0,2,0,11,1
16381,18,379,282,202,222,14,2,44,296,8,42,24,43,50,67,250,378,4,1548,86,0,2,0,11,1
16382,17,587,1455,414,1257,16,76,112,1471,5,41,23,46,46,69,231,381,2,1069,59,0,2,6,7,1
16383,17,587,669,365,481,22,61,110,691,15,103,63,122,118,185,747,1273,8,11311,628,0,2,6,7,1
16386,1,46,2,2,2,0,0,0,2,0,0,0,0,0,0,0,0,0,0,0,0,2,0,1,1
16400,1,46,99,48,90,1,3,5,100,0,0,0,0,0,0,0,0,0,0,0,0,2,0,1,1
16401,1,46,8,5,5,2,0,1,10,0,0,0,0,0,0,0,0,0,0,0,0,2,0,1,1
16402,1,46,1217,716,841,84,126,174,1301,14,185,118,215,199,333,1446,2542,8,20687,1149,0,2,0,1,1
16403,1,46,160,89,115,0,13,31,160,7,15,11,17,22,28,78,124,3,495,27,0,2,0,1,1
16404,1,46,10,10,9,9,0,0,19,0,0,0,0,0,0,0,0,0,0,0,0,2,0,1,1
16405,1,46,173,84,99,8,29,36,181,5,12,7,13,17,20,54,81,2,221,12,0,2,0,1,1
16406,1,46,3,1,1,3,0,0,6,0,0,0,0,0,0,0,0,0,0,0,0,2,0,1,1
16408,194,4280,72,33,56,0,4,12,72,1,1,1,1,2,2,0,2,0,1,0,0,2,1,1,1
16409,194,4280,1454,835,1044,76,110,219,1530,17,275,158,296,292,454,2297,3718,9,34017,1889,1,2,1,1,1
16410,171,3359,373,158,315,8,0,51,381,5,76,44,79,81,123,486,779,2,2026,112,0,2,303,2,1
16411,112,2286,384,251,317,7,8,52,391,11,70,44,84,81,128,467,811,6,5355,297,0,2,8,1,1
16412,66,2902,384,251,317,7,8,52,391,11,70,44,84,81,128,467,811,6,5355,297,0,2,9,0,1
16415,1,42,2,2,2,0,0,0,2,0,0,0,0,0,0,0,0,0,0,0,0,2,7,4,1
16429,1,42,99,48,90,1,3,5,100,0,0,0,0,0,0,0,0,0,0,0,0,2,7,4,1
16430,1,42,8,5,5,2,0,1,10,0,0,0,0,0,0,0,0,0,0,0,0,2,7,4,1
16431,1,42,1217,716,841,84,126,174,1301,14,185,118,215,199,333,1446,2542,8,20687,1149,0,2,7,4,1
16432,1,42,160,89,115,0,13,31,160,7,15,11,17,22,28,78,124,3,495,27,0,2,7,4,1
16433,1,42,10,10,9,9,0,0,19,0,0,0,0,0,0,0,0,0,0,0,0,2,7,4,1
16434,1,42,173,84,99,8,29,36,181,5,12,7,13,17,20,54,81,2,221,12,0,2,7,4,1
16435,1,42,3,1,1,3,0,0,6,0,0,0,0,0,0,0,0,0,0,0,0,2,7,4,1
16436,45,428,647,139,84,35,284,233,682,0,0,0,0,0,0,0,0,0,0,0,0,2,1,3,1
16439,137,3229,722,423,573,19,0,135,741,12,172,101,199,184,300,1320,2257,6,15668,870,0,2,1,2,1
16440,137,3229,1508,847,911,44,250,301,1552,14,148,88,169,162,257,1120,1886,7,15077,837,0,2,1,2,1
16442,7,166,127,75,83,2,11,30,129,4,14,7,14,18,21,61,87,2,175,9,0,2,1,1,1
16443,7,166,652,304,544,16,6,88,668,6,89,51,101,95,152,591,998,3,3399,188,0,2,1,1,1
16444,7,166,2,2,2,0,0,0,2,0,0,0,0,0,0,0,0,0,0,0,0,2,1,1,1
16445,7,166,8,5,5,0,0,3,8,0,0,0,0,0,0,0,0,0,0,0,0,2,1,1,1
16448,7,166,14,8,8,0,0,6,14,0,0,0,0,0,0,0,0,0,0,0,0,2,1,1,1
16449,7,166,6,4,4,0,0,2,6,0,0,0,0,0,0,0,0,0,0,0,0,2,1,1,1
16450,7,166,6,4,4,0,0,2,6,1,2,1,2,3,3,2,4,0,2,0,0,2,1,1,1
16452,7,166,7,5,5,0,0,2,7,0,0,0,0,0,0,0,0,0,0,0,0,2,1,1,1
16454,7,166,10,6,6,0,0,4,10,0,0,0,0,0,0,0,0,0,0,0,0,2,1,1,1
16455,7,166,1,1,1,0,0,0,1,0,0,0,0,0,0,0,0,0,0,0,0,2,1,1,1
16457,7,166,14,10,10,0,0,4,14,1,1,1,1,2,2,0,2,0,1,0,0,2,1,1,1
16458,7,166,46,26,30,3,0,12,49,3,6,3,6,9,9,20,28,1,42,2,0,2,1,1,1
16459,13,1148,215,129,180,6,0,29,221,8,65,43,72,73,115,415,711,4,3153,175,0,2,1,1,1
16461,18,814,334,251,279,10,4,40,344,5,127,74,143,132,217,899,1528,2,4303,239,0,2,2,2,1
16462,66,2890,384,251,317,7,8,52,391,11,70,44,84,81,128,467,811,6,5355,297,0,2,5,8,1
16463,54,886,1020,354,843,12,15,144,1032,8,134,77,144,142,221,970,1580,4,6792,377,0,2,65,0,1
16464,28,1384,1020,354,843,12,15,144,1032,8,134,77,144,142,221,970,1580,4,6792,377,0,2,127,0,1
16465,169,3958,722,423,573,19,0,135,741,12,172,101,199,184,300,1320,2257,6,15668,870,0,2,120,1,1
16466,169,3958,1508,847,911,44,250,301,1552,14,148,88,169,162,257,1120,1886,7,15077,837,0,2,120,1,1
16467,10,500,722,423,573,19,0,135,741,12,172,101,199,184,300,1320,2257,6,15668,870,0,2,44,1,1
16470,1,31,2,2,2,0,0,0,2,0,0,0,0,0,0,0,0,0,0,0,0,2,0,2,1
16484,1,31,99,48,90,1,3,5,100,0,0,0,0,0,0,0,0,0,0,0,0,2,0,2,1
16485,1,31,8,5,5,2,0,1,10,0,0,0,0,0,0,0,0,0,0,0,0,2,0,2,1
16486,1,31,1217,716,841,84,126,174,1301,14,185,118,215,199,333,1446,2542,8,20687,1149,0,2,0,2,1
16487,1,31,160,89,115,0,13,31,160,7,15,11,17,22,28,78,124,3,495,27,0,2,0,2,1
16488,1,31,10,10,9,9,0,0,19,0,0,0,0,0,0,0,0,0,0,0,0,2,0,2,1
16489,1,31,173,84,99,8,29,36,181,5,12,7,13,17,20,54,81,2,221,12,0,2,0,2,1
16490,1,31,3,1,1,3,0,0,6,0,0,0,0,0,0,0,0,0,0,0,0,2,0,2,1
16491,46,442,647,139,84,35,284,233,682,0,0,0,0,0,0,0,0,0,0,0,0,2,8,3,1
16492,115,2361,1457,730,1242,11,6,188,1468,10,292,166,329,302,495,2424,4078,5,22973,1276,1,0,395,0,1
16493,115,2361,74,35,59,1,0,14,75,3,14,7,14,17,21,58,85,1,128,7,0,0,395,0,1
16494,115,2361,245,125,200,5,7,34,250,7,30,17,34,37,51,166,265,3,1053,58,0,0,395,0,1
16495,168,3956,722,423,573,19,0,135,741,12,172,101,199,184,300,1320,2257,6,15668,870,0,2,4,7,1
16496,168,3956,1508,847,911,44,250,301,1552,14,148,88,169,162,257,1120,1886,7,15077,837,0,2,4,7,1
16497,171,3366,373,158,315,8,0,51,381,5,76,44,79,81,123,486,779,2,2026,112,0,2,1,1,1
16498,25,1320,652,304,544,16,6,88,668,6,89,51,101,95,152,591,998,3,3399,188,0,2,1,1,1
16499,18,816,334,251,279,10,4,40,344,5,127,74,143,132,217,899,1528,2,4303,239,0,2,1,1,1
16500,115,2364,1457,730,1242,11,6,188,1468,10,292,166,329,302,495,2424,4078,5,22973,1276,1,2,1,1,1
16501,115,2364,74,35,59,1,0,14,75,3,14,7,14,17,21,58,85,1,128,7,0,2,1,1,1
16502,115,2364,245,125,200,5,7,34,250,7,30,17,34,37,51,166,265,3,1053,58,0,2,1,1,1
16503,168,3956,722,423,573,19,0,135,741,12,172,101,199,184,300,1320,2257,6,15668,870,0,2,9,9,1
16504,168,3956,1508,847,911,44,250,301,1552,14,148,88,169,162,257,1120,1886,7,15077,837,0,2,9,9,1
16505,10,500,722,423,573,19,0,135,741,12,172,101,199,184,300,1320,2257,6,15668,870,0,2,6,6,1
16506,68,2956,384,251,317,7,8,52,391,11,70,44,84,81,128,467,811,6,5355,297,0,2,53,50,1
16507,54,886,1020,354,843,12,15,144,1032,8,134,77,144,142,221,970,1580,4,6792,377,0,2,1,83,1
16508,194,4305,72,33,56,0,4,12,72,1,1,1,1,2,2,0,2,0,1,0,0,2,4,3,1
16509,194,4305,1454,835,1044,76,110,219,1530,17,275,158,296,292,454,2297,3718,9,34017,1889,1,2,4,3,1
16510,19,975,1289,550,1043,56,32,155,1345,10,167,93,185,177,278,1266,2075,5,11498,638,0,2,16,0,1
16511,109,2197,1457,730,1242,11,6,188,1468,10,292,166,329,302,495,2424,4078,5,22973,1276,1,2,0,28,1
16512,109,2197,74,35,59,1,0,14,75,3,14,7,14,17,21,58,85,1,128,7,0,2,0,28,1
16513,109,2197,245,125,200,5,7,34,250,7,30,17,34,37,51,166,265,3,1053,58,0,2,0,28,1
16514,16,579,1455,414,1257,16,76,112,1471,5,41,23,46,46,69,231,381,2,1069,59,0,2,3,4,1
16515,16,579,669,365,481,22,61,110,691,15,103,63,122,118,185,747,1273,8,11311,628,0,2,3,4,1
16516,51,842,1020,354,843,12,15,144,1032,8,134,77,144,142,221,970,1580,4,6792,377,0,2,0,6,1
16517,186,4076,72,33,56,0,4,12,72,1,1,1,1,2,2,0,2,0,1,0,0,2,7,38,1
16518,186,4076,1454,835,1044,76,110,219,1530,17,275,158,296,292,454,2297,3718,9,34017,1889,1,2,7,38,1
16519,99,2389,1043,504,840,53,9,147,1096,9,180,112,198,189,310,1377,2344,4,11604,644,0,2,1,2,1
16520,99,2389,383,288,292,26,6,62,409,11,65,38,67,76,105,429,656,5,3719,206,0,2,1,2,1
16521,150,3028,373,158,315,8,0,51,381,5,76,44,79,81,123,486,779,2,2026,112,0,2,2,77,1
16522,27,1358,1020,354,843,12,15,144,1032,8,134,77,144,142,221,970,1580,4,6792,377,0,2,11,16,1
16523,25,1029,373,158,315,8,0,51,381,5,76,44,79,81,123,486,779,2,2026,112,0,2,7,5,1
16524,50,2502,1943,715,1694,26,18,214,1969,12,185,120,237,197,357,1436,2721,7,20915,1161,0,2,1,1,1
16525,17,771,334,251,279,10,4,40,344,5,127,74,143,132,217,899,1528,2,4303,239,0,2,2,9,1
16526,111,2192,1457,730,1242,11,6,188,1468,10,292,166,329,302,495,2424,4078,5,22973,1276,1,2,10,9,1
16527,111,2192,74,35,59,1,0,14,75,3,14,7,14,17,21,58,85,1,128,7,0,2,10,9,1
16528,111,2192,245,125,200,5,7,34,250,7,30,17,34,37,51,166,265,3,1053,58,0,2,10,9,1
16529,26,1354,652,304,544,16,6,88,668,6,89,51,101,95,152,591,998,3,3399,188,0,2,21,0,1
16531,51,843,1020,354,843,12,15,144,1032,8,134,77,144,142,221,970,1580,4,6792,377,0,2,30,5,1
16532,186,4076,72,33,56,0,4,12,72,1,1,1,1,2,2,0,2,0,1,0,0,2,5,7,1
16533,186,4076,1454,835,1044,76,110,219,1530,17,275,158,296,292,454,2297,3718,9,34017,1889,1,2,5,7,1
16534,6,283,42,7,35,4,0,5,46,1,2,1,2,3,3,2,4,0,2,0,0,2,5,9,1
16535,6,283,11,6,10,0,0,1,11,2,4,2,4,6,6,10,15,1,15,0,0,2,5,9,1
16538,186,4083,72,33,56,0,4,12,72,1,1,1,1,2,2,0,2,0,1,0,0,2,1,0,0
16539,186,4083,1454,835,1044,76,110,219,1530,17,275,158,296,292,454,2297,3718,9,34017,1889,1,2,1,0,0
16540,192,4137,72,33,56,0,4,12,72,1,1,1,1,2,2,0,2,0,1,0,0,2,41,9,0
16541,192,4137,1454,835,1044,76,110,219,1530,17,275,158,296,292,454,2297,3718,9,34017,1889,1,2,41,9,0
16542,3,70,442,244,305,14,16,103,456,11,68,45,75,79,120,452,756,6,4588,254,0,2,1,1,1
16543,3,70,182,102,99,11,40,35,193,3,11,6,11,14,17,42,64,1,97,5,0,2,1,1,1
16544,2,105,442,244,305,14,16,103,456,11,68,45,75,79,120,452,756,6,4588,254,0,2,7,2,1
16545,168,3913,722,423,573,19,0,135,741,12,172,101,199,184,300,1320,2257,6,15668,870,0,2,1,6,1
16546,168,3913,1508,847,911,44,250,301,1552,14,148,88,169,162,257,1120,1886,7,15077,837,0,2,1,6,1
16549,1,31,2,2,2,0,0,0,2,0,0,0,0,0,0,0,0,0,0,0,0,2,1,1,0
16563,1,31,99,48,90,1,3,5,100,0,0,0,0,0,0,0,0,0,0,0,0,2,1,1,0
16564,1,31,8,5,5,2,0,1,10,0,0,0,0,0,0,0,0,0,0,0,0,2,1,1,0
16565,1,31,1217,716,841,84,126,174,1301,14,185,118,215,199,333,1446,2542,8,20687,1149,0,2,1,1,0
16566,1,31,160,89,115,0,13,31,160,7,15,11,17,22,28,78,124,3,495,27,0,2,1,1,0
16567,1,31,10,10,9,9,0,0,19,0,0,0,0,0,0,0,0,0,0,0,0,2,1,1,0
16568,1,31,173,84,99,8,29,36,181,5,12,7,13,17,20,54,81,2,221,12,0,2,1,1,0
16569,1,31,3,1,1,3,0,0,6,0,0,0,0,0,0,0,0,0,0,0,0,2,1,1,0
16572,3,88,442,244,305,14,16,103,456,11,68,45,75,79,120,452,756,6,4588,254,0,2,2,1,1
16573,3,88,182,102,99,11,40,35,193,3,11,6,11,14,17,42,64,1,97,5,0,2,2,1,1
16574,2,139,442,244,305,14,16,103,456,11,68,45,75,79,120,452,756,6,4588,254,0,2,6,1,1
16578,1,31,2,2,2,0,0,0,2,0,0,0,0,0,0,0,0,0,0,0,0,2,1,1,1
16592,1,31,99,48,90,1,3,5,100,0,0,0,0,0,0,0,0,0,0,0,0,2,1,1,1
16593,1,31,8,5,5,2,0,1,10,0,0,0,0,0,0,0,0,0,0,0,0,2,1,1,1
16594,1,31,1217,716,841,84,126,174,1301,14,185,118,215,199,333,1446,2542,8,20687,1149,0,2,1,1,1
16595,1,31,160,89,115,0,13,31,160,7,15,11,17,22,28,78,124,3,495,27,0,2,1,1,1
16596,1,31,10,10,9,9,0,0,19,0,0,0,0,0,0,0,0,0,0,0,0,2,1,1,1
16597,1,31,173,84,99,8,29,36,181,5,12,7,13,17,20,54,81,2,221,12,0,2,1,1,1
16598,1,31,3,1,1,3,0,0,6,0,0,0,0,0,0,0,0,0,0,0,0,2,1,1,1
16599,151,3035,373,158,315,8,0,51,381,5,76,44,79,81,123,486,779,2,2026,112,0,2,1,1,1
16600,6,283,42,7,35,4,0,5,46,1,2,1,2,3,3,2,4,0,2,0,0,2,1,1,1
16601,6,283,11,6,10,0,0,1,11,2,4,2,4,6,6,10,15,1,15,0,0,2,1,1,1
16602,28,1387,1178,367,1042,6,15,115,1184,9,94,51,95,103,146,644,976,4,4439,246,0,2,1,1,1
16603,151,3041,373,158,315,8,0,51,381,5,76,44,79,81,123,486,779,2,2026,112,0,2,1,1,1
16606,1,31,2,2,2,0,0,0,2,0,0,0,0,0,0,0,0,0,0,0,0,2,2,2,1
16620,1,31,99,48,90,1,3,5,100,0,0,0,0,0,0,0,0,0,0,0,0,2,2,2,1
16621,1,31,8,5,5,2,0,1,10,0,0,0,0,0,0,0,0,0,0,0,0,2,2,2,1
16622,1,31,1217,716,841,84,126,174,1301,14,185,118,215,199,333,1446,2542,8,20687,1149,0,2,2,2,1
16623,1,31,160,89,115,0,13,31,160,7,15,11,17,22,28,78,124,3,495,27,0,2,2,2,1
16624,1,31,10,10,9,9,0,0,19,0,0,0,0,0,0,0,0,0,0,0,0,2,2,2,1
16625,1,31,173,84,99,8,29,36,181,5,12,7,13,17,20,54,81,2,221,12,0,2,2,2,1
16626,1,31,3,1,1,3,0,0,6,0,0,0,0,0,0,0,0,0,0,0,0,2,2,2,1
16627,6,283,42,7,35,4,0,5,46,1,2,1,2,3,3,2,4,0,2,0,0,2,2,3,1
16628,6,283,11,6,10,0,0,1,11,2,4,2,4,6,6,10,15,1,15,0,0,2,2,3,1
16652,116,2264,1457,730,1242,11,6,188,1468,10,292,166,329,302,495,2424,4078,5,22973,1276,1,2,16,1,1
16653,116,2264,74,35,59,1,0,14,75,3,14,7,14,17,21,58,85,1,128,7,0,2,16,1,1
16654,116,2264,245,125,200,5,7,34,250,7,30,17,34,37,51,166,265,3,1053,58,0,2,16,1,1
16657,20,1004,1289,550,1043,56,32,155,1345,10,167,93,185,177,278,1266,2075,5,11498,638,0,2,10,2,1
16683,20,1015,1289,550,1043,56,32,155,1345,10,167,93,185,177,278,1266,2075,5,11498,638,0,2,3,0,0
16684,169,3918,722,423,573,19,0,135,741,12,172,101,199,184,300,1320,2257,6,15668,870,0,2,2,1,1
16685,169,3918,1508,847,911,44,250,301,1552,14,148,88,169,162,257,1120,1886,7,15077,837,0,2,2,1,1
16686,156,3046,373,158,315,8,0,51,381,5,76,44,79,81,123,486,779,2,2026,112,0,2,39,39,1
16687,18,346,127,75,83,2,11,30,129,4,14,7,14,18,21,61,87,2,175,9,0,2,3,0,1
16688,18,346,652,304,544,16,6,88,668,6,89,51,101,95,152,591,998,3,3399,188,0,2,3,0,1
16689,18,346,2,2,2,0,0,0,2,0,0,0,0,0,0,0,0,0,0,0,0,2,3,0,1
16690,18,346,8,5,5,0,0,3,8,0,0,0,0,0,0,0,0,0,0,0,0,2,3,0,1
16693,18,346,14,8,8,0,0,6,14,0,0,0,0,0,0,0,0,0,0,0,0,2,3,0,1
16694,18,346,6,4,4,0,0,2,6,0,0,0,0,0,0,0,0,0,0,0,0,2,3,0,1
16695,18,346,6,4,4,0,0,2,6,1,2,1,2,3,3,2,4,0,2,0,0,2,3,0,1
16697,18,346,7,5,5,0,0,2,7,0,0,0,0,0,0,0,0,0,0,0,0,2,3,0,1
16699,18,346,10,6,6,0,0,4,10,0,0,0,0,0,0,0,0,0,0,0,0,2,3,0,1
16700,18,346,1,1,1,0,0,0,1,0,0,0,0,0,0,0,0,0,0,0,0,2,3,0,1
16702,18,346,14,10,10,0,0,4,14,1,1,1,1,2,2,0,2,0,1,0,0,2,3,0,1
16703,18,346,46,26,30,3,0,12,49,3,6,3,6,9,9,20,28,1,42,2,0,2,3,0,1
16727,44,777,1020,354,843,12,15,144,1032,8,134,77,144,142,221,970,1580,4,6792,377,0,2,41,40,1
16728,169,3902,722,423,573,19,0,135,741,12,172,101,199,184,300,1320,2257,6,15668,870,0,2,2,5,1
16729,169,3902,1508,847,911,44,250,301,1552,14,148,88,169,162,257,1120,1886,7,15077,837,0,2,2,5,1
16730,191,4128,72,33,56,0,4,12,72,1,1,1,1,2,2,0,2,0,1,0,0,2,2,3,1
16731,191,4128,1454,835,1044,76,110,219,1530,17,275,158,296,292,454,2297,3718,9,34017,1889,1,2,2,3,1
16732,100,2392,1043,504,840,53,9,147,1096,9,180,112,198,189,310,1377,2344,4,11604,644,0,2,1,1,1
16733,100,2392,383,288,292,26,6,62,409,11,65,38,67,76,105,429,656,5,3719,206,0,2,1,1,1
16734,152,3008,373,158,315,8,0,51,381,5,76,44,79,81,123,486,779,2,2026,112,0,2,3,9,1
16737,31,1247,1020,354,843,12,15,144,1032,8,134,77,144,142,221,970,1580,4,6792,377,0,2,23,25,1
16738,6,219,1098,241,925,5,10,155,1103,7,46,25,49,53,74,273,423,3,1580,87,0,2,11,0,1
16762,154,3077,373,158,315,8,0,51,381,5,76,44,79,81,123,486,779,2,2026,112,0,2,14,0,1
16765,64,1168,1513,682,1277,25,13,200,1538,11,199,116,219,210,335,1557,2584,6,15641,868,0,2,9,0,1
16766,64,1168,819,519,539,24,98,155,843,15,96,57,106,111,163,690,1107,8,9171,509,0,2,9,0,1
16767,169,3919,722,423,573,19,0,135,741,12,172,101,199,184,300,1320,2257,6,15668,870,0,2,2,0,1
16768,169,3919,1508,847,911,44,250,301,1552,14,148,88,169,162,257,1120,1886,7,15077,837,0,2,2,0,1
16769,133,2578,1943,715,1694,26,18,214,1969,12,185,120,237,197,357,1436,2721,7,20915,1161,0,2,18,10,1
16770,133,2578,1168,838,957,57,25,144,1225,19,348,224,416,367,640,3018,5452,11,61921,3440,1,2,18,10,1
16796,30,524,127,75,83,2,11,30,129,4,14,7,14,18,21,61,87,2,175,9,0,2,32,2,1
16797,30,524,652,304,544,16,6,88,668,6,89,51,101,95,152,591,998,3,3399,188,0,2,32,2,1
16798,30,524,2,2,2,0,0,0,2,0,0,0,0,0,0,0,0,0,0,0,0,2,32,2,1
16799,30,524,8,5,5,0,0,3,8,0,0,0,0,0,0,0,0,0,0,0,0,2,32,2,1
16802,30,524,14,8,8,0,0,6,14,0,0,0,0,0,0,0,0,0,0,0,0,2,32,2,1
16803,30,524,6,4,4,0,0,2,6,0,0,0,0,0,0,0,0,0,0,0,0,2,32,2,1
16804,30,524,6,4,4,0,0,2,6,1,2,1,2,3,3,2,4,0,2,0,0,2,32,2,1
16806,30,524,7,5,5,0,0,2,7,0,0,0,0,0,0,0,0,0,0,0,0,2,32,2,1
16808,30,524,10,6,6,0,0,4,10,0,0,0,0,0,0,0,0,0,0,0,0,2,32,2,1
16809,30,524,1,1,1,0,0,0,1,0,0,0,0,0,0,0,0,0,0,0,0,2,32,2,1
16811,30,524,14,10,10,0,0,4,14,1,1,1,1,2,2,0,2,0,1,0,0,2,32,2,1
16812,30,524,46,26,30,3,0,12,49,3,6,3,6,9,9,20,28,1,42,2,0,2,32,2,1
16813,12,228,127,75,83,2,11,30,129,4,14,7,14,18,21,61,87,2,175,9,0,0,40,0,1
16814,12,228,652,304,544,16,6,88,668,6,89,51,101,95,152,591,998,3,3399,188,0,0,40,0,1
16815,12,228,2,2,2,0,0,0,2,0,0,0,0,0,0,0,0,0,0,0,0,0,40,0,1
16816,12,228,8,5,5,0,0,3,8,0,0,0,0,0,0,0,0,0,0,0,0,0,40,0,1
16819,12,228,14,8,8,0,0,6,14,0,0,0,0,0,0,0,0,0,0,0,0,0,40,0,1
16820,12,228,6,4,4,0,0,2,6,0,0,0,0,0,0,0,0,0,0,0,0,0,40,0,1
16821,12,228,6,4,4,0,0,2,6,1,2,1,2,3,3,2,4,0,2,0,0,0,40,0,1
16823,12,228,7,5,5,0,0,2,7,0,0,0,0,0,0,0,0,0,0,0,0,0,40,0,1
16825,12,228,10,6,6,0,0,4,10,0,0,0,0,0,0,0,0,0,0,0,0,0,40,0,1
16826,12,228,1,1,1,0,0,0,1,0,0,0,0,0,0,0,0,0,0,0,0,0,40,0,1
16828,12,228,14,10,10,0,0,4,14,1,1,1,1,2,2,0,2,0,1,0,0,0,40,0,1
16829,12,228,46,26,30,3,0,12,49,3,6,3,6,9,9,20,28,1,42,2,0,0,40,0,1
16830,1,149,382,65,130,157,2,92,539,4,10,5,10,14,15,41,57,2,114,6,0,2,6,0,1
16833,1,36,2,2,2,0,0,0,2,0,0,0,0,0,0,0,0,0,0,0,0,2,2,1,1
16847,1,36,99,48,90,1,3,5,100,0,0,0,0,0,0,0,0,0,0,0,0,2,2,1,1
16848,1,36,8,5,5,2,0,1,10,0,0,0,0,0,0,0,0,0,0,0,0,2,2,1,1
16849,1,36,1217,716,841,84,126,174,1301,14,185,118,215,199,333,1446,2542,8,20687,1149,0,2,2,1,1
16850,1,36,160,89,115,0,13,31,160,7,15,11,17,22,28,78,124,3,495,27,0,2,2,1,1
16851,1,36,10,10,9,9,0,0,19,0,0,0,0,0,0,0,0,0,0,0,0,2,2,1,1
16852,1,36,173,84,99,8,29,36,181,5,12,7,13,17,20,54,81,2,221,12,0,2,2,1,1
16853,1,36,3,1,1,3,0,0,6,0,0,0,0,0,0,0,0,0,0,0,0,2,2,1,1
16854,132,2527,1457,730,1242,11,6,188,1468,10,292,166,329,302,495,2424,4078,5,22973,1276,1,2,45,5,1
16855,132,2527,74,35,59,1,0,14,75,3,14,7,14,17,21,58,85,1,128,7,0,2,45,5,1
16856,132,2527,245,125,200,5,7,34,250,7,30,17,34,37,51,166,265,3,1053,58,0,2,45,5,1
16857,154,3069,373,158,315,8,0,51,381,5,76,44,79,81,123,486,779,2,2026,112,0,2,4,4,1
16858,20,1015,1289,550,1043,56,32,155,1345,10,167,93,185,177,278,1266,2075,5,11498,638,0,2,2,1,1
16859,32,554,127,75,83,2,11,30,129,4,14,7,14,18,21,61,87,2,175,9,0,2,6,0,1
16860,32,554,652,304,544,16,6,88,668,6,89,51,101,95,152,591,998,3,3399,188,0,2,6,0,1
16861,32,554,2,2,2,0,0,0,2,0,0,0,0,0,0,0,0,0,0,0,0,2,6,0,1
16862,32,554,8,5,5,0,0,3,8,0,0,0,0,0,0,0,0,0,0,0,0,2,6,0,1
16865,32,554,14,8,8,0,0,6,14,0,0,0,0,0,0,0,0,0,0,0,0,2,6,0,1
16866,32,554,6,4,4,0,0,2,6,0,0,0,0,0,0,0,0,0,0,0,0,2,6,0,1
16867,32,554,6,4,4,0,0,2,6,1,2,1,2,3,3,2,4,0,2,0,0,2,6,0,1
16869,32,554,7,5,5,0,0,2,7,0,0,0,0,0,0,0,0,0,0,0,0,2,6,0,1
16871,32,554,10,6,6,0,0,4,10,0,0,0,0,0,0,0,0,0,0,0,0,2,6,0,1
16872,32,554,1,1,1,0,0,0,1,0,0,0,0,0,0,0,0,0,0,0,0,2,6,0,1
16874,32,554,14,10,10,0,0,4,14,1,1,1,1,2,2,0,2,0,1,0,0,2,6,0,1
16875,32,554,46,26,30,3,0,12,49,3,6,3,6,9,9,20,28,1,42,2,0,2,6,0,1
16876,20,1267,1457,730,1242,11,6,188,1468,10,292,166,329,302,495,2424,4078,5,22973,1276,1,2,46,0,1
16877,124,2402,1457,730,1242,11,6,188,1468,10,292,166,329,302,495,2424,4078,5,22973,1276,1,2,14,32,1
16878,124,2402,74,35,59,1,0,14,75,3,14,7,14,17,21,58,85,1,128,7,0,2,14,32,1
16879,124,2402,245,125,200,5,7,34,250,7,30,17,34,37,51,166,265,3,1053,58,0,2,14,32,1
16880,33,864,74,35,59,1,0,14,75,3,14,7,14,17,21,58,85,1,128,7,0,2,36,41,1
16881,33,864,245,125,200,5,7,34,250,7,30,17,34,37,51,166,265,3,1053,58,0,2,36,41,1
16882,170,3938,722,423,573,19,0,135,741,12,172,101,199,184,300,1320,2257,6,15668,870,0,2,3,0,1
16883,170,3938,1508,847,911,44,250,301,1552,14,148,88,169,162,257,1120,1886,7,15077,837,0,2,3,0,1
16884,7,230,74,35,59,1,0,14,75,3,14,7,14,17,21,58,85,1,128,7,0,2,5,3,1
16885,50,2502,1943,715,1694,26,18,214,1969,12,185,120,237,197,357,1436,2721,7,20915,1161,0,2,2,2,1
16886,17,1016,1457,730,1242,11,6,188,1468,10,292,166,329,302,495,2424,4078,5,22973,1276,1,2,1,36,1
16887,17,771,334,251,279,10,4,40,344,5,127,74,143,132,217,899,1528,2,4303,239,0,2,2,2,1
16888,128,2500,1457,730,1242,11,6,188,1468,10,292,166,329,302,495,2424,4078,5,22973,1276,1,2,21,2,1
16889,128,2500,74,35,59,1,0,14,75,3,14,7,14,17,21,58,85,1,128,7,0,2,21,2,1
16890,128,2500,245,125,200,5,7,34,250,7,30,17,34,37,51,166,265,3,1053,58,0,2,21,2,1
16891,33,859,74,35,59,1,0,14,75,3,14,7,14,17,21,58,85,1,128,7,0,2,3,7,1
16892,33,859,245,125,200,5,7,34,250,7,30,17,34,37,51,166,265,3,1053,58,0,2,3,7,1
16893,7,230,74,35,59,1,0,14,75,3,14,7,14,17,21,58,85,1,128,7,0,2,1,1,1
16894,18,834,334,251,279,10,4,40,344,5,127,74,143,132,217,899,1528,2,4303,239,0,2,13,0,1
16895,1,80,13,10,10,0,0,3,13,1,2,1,2,3,3,2,4,0,2,0,0,2,0,2,1
16896,133,2609,1457,730,1242,11,6,188,1468,10,292,166,329,302,495,2424,4078,5,22973,1276,1,2,38,26,1
16897,133,2609,74,35,59,1,0,14,75,3,14,7,14,17,21,58,85,1,128,7,0,2,38,26,1
16898,133,2609,245,125,200,5,7,34,250,7,30,17,34,37,51,166,265,3,1053,58,0,2,38,26,1
16899,33,844,74,35,59,1,0,14,75,3,14,7,14,17,21,58,85,1,128,7,0,2,11,12,1
16900,33,844,245,125,200,5,7,34,250,7,30,17,34,37,51,166,265,3,1053,58,0,2,11,12,1
16901,172,3985,722,423,573,19,0,135,741,12,172,101,199,184,300,1320,2257,6,15668,870,0,2,7,0,1
16902,172,3985,1508,847,911,44,250,301,1552,14,148,88,169,162,257,1120,1886,7,15077,837,0,2,7,0,1
16903,154,3068,373,158,315,8,0,51,381,5,76,44,79,81,123,486,779,2,2026,112,0,2,3,2,1
16904,32,536,127,75,83,2,11,30,129,4,14,7,14,18,21,61,87,2,175,9,0,2,0,3,1
16905,32,536,652,304,544,16,6,88,668,6,89,51,101,95,152,591,998,3,3399,188,0,2,0,3,1
16906,32,536,2,2,2,0,0,0,2,0,0,0,0,0,0,0,0,0,0,0,0,2,0,3,1
16907,32,536,8,5,5,0,0,3,8,0,0,0,0,0,0,0,0,0,0,0,0,2,0,3,1
16910,32,536,14,8,8,0,0,6,14,0,0,0,0,0,0,0,0,0,0,0,0,2,0,3,1
16911,32,536,6,4,4,0,0,2,6,0,0,0,0,0,0,0,0,0,0,0,0,2,0,3,1
16912,32,536,6,4,4,0,0,2,6,1,2,1,2,3,3,2,4,0,2,0,0,2,0,3,1
16914,32,536,7,5,5,0,0,2,7,0,0,0,0,0,0,0,0,0,0,0,0,2,0,3,1
16916,32,536,10,6,6,0,0,4,10,0,0,0,0,0,0,0,0,0,0,0,0,2,0,3,1
16917,32,536,1,1,1,0,0,0,1,0,0,0,0,0,0,0,0,0,0,0,0,2,0,3,1
16919,32,536,14,10,10,0,0,4,14,1,1,1,1,2,2,0,2,0,1,0,0,2,0,3,1
16920,32,536,46,26,30,3,0,12,49,3,6,3,6,9,9,20,28,1,42,2,0,2,0,3,1
16921,7,163,127,75,83,2,11,30,129,4,14,7,14,18,21,61,87,2,175,9,0,2,0,1,1
16922,7,163,652,304,544,16,6,88,668,6,89,51,101,95,152,591,998,3,3399,188,0,2,0,1,1
16923,7,163,2,2,2,0,0,0,2,0,0,0,0,0,0,0,0,0,0,0,0,2,0,1,1
16924,7,163,8,5,5,0,0,3,8,0,0,0,0,0,0,0,0,0,0,0,0,2,0,1,1
16927,7,163,14,8,8,0,0,6,14,0,0,0,0,0,0,0,0,0,0,0,0,2,0,1,1
16928,7,163,6,4,4,0,0,2,6,0,0,0,0,0,0,0,0,0,0,0,0,2,0,1,1
16929,7,163,6,4,4,0,0,2,6,1,2,1,2,3,3,2,4,0,2,0,0,2,0,1,1
16931,7,163,7,5,5,0,0,2,7,0,0,0,0,0,0,0,0,0,0,0,0,2,0,1,1
16933,7,163,10,6,6,0,0,4,10,0,0,0,0,0,0,0,0,0,0,0,0,2,0,1,1
16934,7,163,1,1,1,0,0,0,1,0,0,0,0,0,0,0,0,0,0,0,0,2,0,1,1
16936,7,163,14,10,10,0,0,4,14,1,1,1,1,2,2,0,2,0,1,0,0,2,0,1,1
16937,7,163,46,26,30,3,0,12,49,3,6,3,6,9,9,20,28,1,42,2,0,2,0,1,1
16938,7,230,74,35,59,1,0,14,75,3,14,7,14,17,21,58,85,1,128,7,0,2,2,2,1
16939,19,1151,1457,730,1242,11,6,188,1468,10,292,166,329,302,495,2424,4078,5,22973,1276,1,2,33,3,1
16940,17,775,334,251,279,10,4,40,344,5,127,74,143,132,217,899,1528,2,4303,239,0,2,0,11,1
16941,133,2600,1457,730,1242,11,6,188,1468,10,292,166,329,302,495,2424,4078,5,22973,1276,1,2,7,5,1
16942,133,2600,74,35,59,1,0,14,75,3,14,7,14,17,21,58,85,1,128,7,0,2,7,5,1
16943,133,2600,245,125,200,5,7,34,250,7,30,17,34,37,51,166,265,3,1053,58,0,2,7,5,1
16944,175,4013,722,423,573,19,0,135,741,12,172,101,199,184,300,1320,2257,6,15668,870,0,2,5,0,1
16945,175,4013,1508,847,911,44,250,301,1552,14,148,88,169,162,257,1120,1886,7,15077,837,0,2,5,0,1
16946,151,3042,373,158,315,8,0,51,381,5,76,44,79,81,123,486,779,2,2026,112,0,2,2,8,1
16949,1,36,2,2,2,0,0,0,2,0,0,0,0,0,0,0,0,0,0,0,0,2,2,2,0
16963,1,36,99,48,90,1,3,5,100,0,0,0,0,0,0,0,0,0,0,0,0,2,2,2,0
16964,1,36,8,5,5,2,0,1,10,0,0,0,0,0,0,0,0,0,0,0,0,2,2,2,0
16965,1,36,1217,716,841,84,126,174,1301,14,185,118,215,199,333,1446,2542,8,20687,1149,0,2,2,2,0
16966,1,36,160,89,115,0,13,31,160,7,15,11,17,22,28,78,124,3,495,27,0,2,2,2,0
16967,1,36,10,10,9,9,0,0,19,0,0,0,0,0,0,0,0,0,0,0,0,2,2,2,0
16968,1,36,173,84,99,8,29,36,181,5,12,7,13,17,20,54,81,2,221,12,0,2,2,2,0
16969,1,36,3,1,1,3,0,0,6,0,0,0,0,0,0,0,0,0,0,0,0,2,2,2,0
16972,1,149,382,65,130,157,2,92,539,4,10,5,10,14,15,41,57,2,114,6,0,2,6,0,0
16973,12,228,127,75,83,2,11,30,129,4,14,7,14,18,21,61,87,2,175,9,0,0,40,0,0
16974,12,228,652,304,544,16,6,88,668,6,89,51,101,95,152,591,998,3,3399,188,0,0,40,0,0
16975,12,228,2,2,2,0,0,0,2,0,0,0,0,0,0,0,0,0,0,0,0,0,40,0,0
16976,12,228,8,5,5,0,0,3,8,0,0,0,0,0,0,0,0,0,0,0,0,0,40,0,0
16979,12,228,14,8,8,0,0,6,14,0,0,0,0,0,0,0,0,0,0,0,0,0,40,0,0
16980,12,228,6,4,4,0,0,2,6,0,0,0,0,0,0,0,0,0,0,0,0,0,40,0,0
16981,12,228,6,4,4,0,0,2,6,1,2,1,2,3,3,2,4,0,2,0,0,0,40,0,0
16983,12,228,7,5,5,0,0,2,7,0,0,0,0,0,0,0,0,0,0,0,0,0,40,0,0
16985,12,228,10,6,6,0,0,4,10,0,0,0,0,0,0,0,0,0,0,0,0,0,40,0,0
16986,12,228,1,1,1,0,0,0,1,0,0,0,0,0,0,0,0,0,0,0,0,0,40,0,0
16988,12,228,14,10,10,0,0,4,14,1,1,1,1,2,2,0,2,0,1,0,0,0,40,0,0
16989,12,228,46,26,30,3,0,12,49,3,6,3,6,9,9,20,28,1,42,2,0,0,40,0,0
16990,1,80,13,10,10,0,0,3,13,1,2,1,2,3,3,2,4,0,2,0,0,2,0,2,0
16993,1,36,2,2,2,0,0,0,2,0,0,0,0,0,0,0,0,0,0,0,0,2,2,1,0
17007,1,36,99,48,90,1,3,5,100,0,0,0,0,0,0,0,0,0,0,0,0,2,2,1,0
17008,1,36,8,5,5,2,0,1,10,0,0,0,0,0,0,0,0,0,0,0,0,2,2,1,0
17009,1,36,1217,716,841,84,126,174,1301,14,185,118,215,199,333,1446,2542,8,20687,1149,0,2,2,1,0
17010,1,36,160,89,115,0,13,31,160,7,15,11,17,22,28,78,124,3,495,27,0,2,2,1,0
17011,1,36,10,10,9,9,0,0,19,0,0,0,0,0,0,0,0,0,0,0,0,2,2,1,0
17012,1,36,173,84,99,8,29,36,181,5,12,7,13,17,20,54,81,2,221,12,0,2,2,1,0
17013,1,36,3,1,1,3,0,0,6,0,0,0,0,0,0,0,0,0,0,0,0,2,2,1,0
17014,133,2600,1457,730,1242,11,6,188,1468,10,292,166,329,302,495,2424,4078,5,22973,1276,1,2,103,48,0
17015,133,2600,74,35,59,1,0,14,75,3,14,7,14,17,21,58,85,1,128,7,0,2,103,48,0
17016,133,2600,245,125,200,5,7,34,250,7,30,17,34,37,51,166,265,3,1053,58,0,2,103,48,0
17017,33,844,74,35,59,1,0,14,75,3,14,7,14,17,21,58,85,1,128,7,0,2,37,47,0
17018,33,844,245,125,200,5,7,34,250,7,30,17,34,37,51,166,265,3,1053,58,0,2,37,47,0
17019,175,4013,722,423,573,19,0,135,741,12,172,101,199,184,300,1320,2257,6,15668,870,0,2,15,0,0
17020,175,4013,1508,847,911,44,250,301,1552,14,148,88,169,162,257,1120,1886,7,15077,837,0,2,15,0,0
17021,151,3042,373,158,315,8,0,51,381,5,76,44,79,81,123,486,779,2,2026,112,0,2,9,14,0
17024,20,1015,1289,550,1043,56,32,155,1345,10,167,93,185,177,278,1266,2075,5,11498,638,0,2,2,1,0
17025,32,536,127,75,83,2,11,30,129,4,14,7,14,18,21,61,87,2,175,9,0,2,6,3,0
17026,32,536,652,304,544,16,6,88,668,6,89,51,101,95,152,591,998,3,3399,188,0,2,6,3,0
17027,32,536,2,2,2,0,0,0,2,0,0,0,0,0,0,0,0,0,0,0,0,2,6,3,0
17028,32,536,8,5,5,0,0,3,8,0,0,0,0,0,0,0,0,0,0,0,0,2,6,3,0
17031,32,536,14,8,8,0,0,6,14,0,0,0,0,0,0,0,0,0,0,0,0,2,6,3,0
17032,32,536,6,4,4,0,0,2,6,0,0,0,0,0,0,0,0,0,0,0,0,2,6,3,0
17033,32,536,6,4,4,0,0,2,6,1,2,1,2,3,3,2,4,0,2,0,0,2,6,3,0
17035,32,536,7,5,5,0,0,2,7,0,0,0,0,0,0,0,0,0,0,0,0,2,6,3,0
17037,32,536,10,6,6,0,0,4,10,0,0,0,0,0,0,0,0,0,0,0,0,2,6,3,0
17038,32,536,1,1,1,0,0,0,1,0,0,0,0,0,0,0,0,0,0,0,0,2,6,3,0
17040,32,536,14,10,10,0,0,4,14,1,1,1,1,2,2,0,2,0,1,0,0,2,6,3,0
17041,32,536,46,26,30,3,0,12,49,3,6,3,6,9,9,20,28,1,42,2,0,2,6,3,0
17042,7,163,127,75,83,2,11,30,129,4,14,7,14,18,21,61,87,2,175,9,0,2,0,1,0
17043,7,163,652,304,544,16,6,88,668,6,89,51,101,95,152,591,998,3,3399,188,0,2,0,1,0
17044,7,163,2,2,2,0,0,0,2,0,0,0,0,0,0,0,0,0,0,0,0,2,0,1,0
17045,7,163,8,5,5,0,0,3,8,0,0,0,0,0,0,0,0,0,0,0,0,2,0,1,0
17048,7,163,14,8,8,0,0,6,14,0,0,0,0,0,0,0,0,0,0,0,0,2,0,1,0
17049,7,163,6,4,4,0,0,2,6,0,0,0,0,0,0,0,0,0,0,0,0,2,0,1,0
17050,7,163,6,4,4,0,0,2,6,1,2,1,2,3,3,2,4,0,2,0,0,2,0,1,0
17052,7,163,7,5,5,0,0,2,7,0,0,0,0,0,0,0,0,0,0,0,0,2,0,1,0
17054,7,163,10,6,6,0,0,4,10,0,0,0,0,0,0,0,0,0,0,0,0,2,0,1,0
17055,7,163,1,1,1,0,0,0,1,0,0,0,0,0,0,0,0,0,0,0,0,2,0,1,0
17057,7,163,14,10,10,0,0,4,14,1,1,1,1,2,2,0,2,0,1,0,0,2,0,1,0
17058,7,163,46,26,30,3,0,12,49,3,6,3,6,9,9,20,28,1,42,2,0,2,0,1,0
17059,7,230,74,35,59,1,0,14,75,3,14,7,14,17,21,58,85,1,128,7,0,2,5,3,0
17060,50,2502,1943,715,1694,26,18,214,1969,12,185,120,237,197,357,1436,2721,7,20915,1161,0,2,2,2,0
17061,19,1151,1457,730,1242,11,6,188,1468,10,292,166,329,302,495,2424,4078,5,22973,1276,1,2,68,27,0
17062,17,775,334,251,279,10,4,40,344,5,127,74,143,132,217,899,1528,2,4303,239,0,2,4,2,0
17063,6,283,42,7,35,4,0,5,46,1,2,1,2,3,3,2,4,0,2,0,0,2,2,2,1
17064,6,283,11,6,10,0,0,1,11,2,4,2,4,6,6,10,15,1,15,0,0,2,2,2,1
17065,67,2915,384,251,317,7,8,52,391,11,70,44,84,81,128,467,811,6,5355,297,0,2,0,5,0
17066,33,844,74,35,59,1,0,14,75,3,14,7,14,17,21,58,85,1,128,7,0,2,1,1,1
17067,33,844,245,125,200,5,7,34,250,7,30,17,34,37,51,166,265,3,1053,58,0,2,1,1,1
17068,7,224,74,35,59,1,0,14,75,3,14,7,14,17,21,58,85,1,128,7,0,2,2,3,1
17069,68,2994,384,251,317,7,8,52,391,11,70,44,84,81,128,467,811,6,5355,297,0,2,12,0,1
17070,33,848,74,35,59,1,0,14,75,3,14,7,14,17,21,58,85,1,128,7,0,2,1,1,0
17071,33,848,245,125,200,5,7,34,250,7,30,17,34,37,51,166,265,3,1053,58,0,2,1,1,0
17073,138,2686,1943,715,1694,26,18,214,1969,12,185,120,237,197,357,1436,2721,7,20915,1161,0,2,23,7,1
17074,138,2686,1168,838,957,57,25,144,1225,19,348,224,416,367,640,3018,5452,11,61921,3440,1,2,23,7,1
17075,51,2576,1943,715,1694,26,18,214,1969,12,185,120,237,197,357,1436,2721,7,20915,1161,0,2,10,0,1
17078,1,36,2,2,2,0,0,0,2,0,0,0,0,0,0,0,0,0,0,0,0,2,1,1,0
17092,1,36,99,48,90,1,3,5,100,0,0,0,0,0,0,0,0,0,0,0,0,2,1,1,0
17093,1,36,8,5,5,2,0,1,10,0,0,0,0,0,0,0,0,0,0,0,0,2,1,1,0
17094,1,36,1217,716,841,84,126,174,1301,14,185,118,215,199,333,1446,2542,8,20687,1149,0,2,1,1,0
17095,1,36,160,89,115,0,13,31,160,7,15,11,17,22,28,78,124,3,495,27,0,2,1,1,0
17096,1,36,10,10,9,9,0,0,19,0,0,0,0,0,0,0,0,0,0,0,0,2,1,1,0
17097,1,36,173,84,99,8,29,36,181,5,12,7,13,17,20,54,81,2,221,12,0,2,1,1,0
17098,1,36,3,1,1,3,0,0,6,0,0,0,0,0,0,0,0,0,0,0,0,2,1,1,0
17099,6,283,42,7,35,4,0,5,46,1,2,1,2,3,3,2,4,0,2,0,0,2,2,2,0
17100,6,283,11,6,10,0,0,1,11,2,4,2,4,6,6,10,15,1,15,0,0,2,2,2,0
17118,46,442,647,139,84,35,284,233,682,0,0,0,0,0,0,0,0,0,0,0,0,2,17,16,1
17119,44,777,1020,354,843,12,15,144,1032,8,134,77,144,142,221,970,1580,4,6792,377,0,2,1,1,1
17120,191,4124,72,33,56,0,4,12,72,1,1,1,1,2,2,0,2,0,1,0,0,2,1,3,1
17121,191,4124,1454,835,1044,76,110,219,1530,17,275,158,296,292,454,2297,3718,9,34017,1889,1,2,1,3,1
17122,151,3042,373,158,315,8,0,51,381,5,76,44,79,81,123,486,779,2,2026,112,0,2,4,4,1
17123,69,1131,1178,367,1042,6,15,115,1184,9,94,51,95,103,146,644,976,4,4439,246,0,2,1,1,1
17124,69,1131,177,108,140,8,0,27,185,6,30,16,32,36,48,162,248,3,794,44,0,2,1,1,1
17125,138,2682,1943,715,1694,26,18,214,1969,12,185,120,237,197,357,1436,2721,7,20915,1161,0,2,7,7,1
17126,138,2682,1168,838,957,57,25,144,1225,19,348,224,416,367,640,3018,5452,11,61921,3440,1,2,7,7,1
17127,25,1029,373,158,315,8,0,51,381,5,76,44,79,81,123,486,779,2,2026,112,0,2,2,2,1
17128,50,2539,1943,715,1694,26,18,214,1969,12,185,120,237,197,357,1436,2721,7,20915,1161,0,2,10,11,1
17129,46,442,647,139,84,35,284,233,682,0,0,0,0,0,0,0,0,0,0,0,0,2,4,4,1
17130,150,3013,373,158,315,8,0,51,381,5,76,44,79,81,123,486,779,2,2026,112,0,2,37,44,1
17131,149,3000,373,158,315,8,0,51,381,5,76,44,79,81,123,486,779,2,2026,112,0,2,0,2,0
17132,68,2994,384,251,317,7,8,52,391,11,70,44,84,81,128,467,811,6,5355,297,0,2,4,4,0
17135,1,36,2,2,2,0,0,0,2,0,0,0,0,0,0,0,0,0,0,0,0,2,1,1,1
17149,1,36,99,48,90,1,3,5,100,0,0,0,0,0,0,0,0,0,0,0,0,2,1,1,1
17150,1,36,8,5,5,2,0,1,10,0,0,0,0,0,0,0,0,0,0,0,0,2,1,1,1
17151,1,36,1217,716,841,84,126,174,1301,14,185,118,215,199,333,1446,2542,8,20687,1149,0,2,1,1,1
17152,1,36,160,89,115,0,13,31,160,7,15,11,17,22,28,78,124,3,495,27,0,2,1,1,1
17153,1,36,10,10,9,9,0,0,19,0,0,0,0,0,0,0,0,0,0,0,0,2,1,1,1
17154,1,36,173,84,99,8,29,36,181,5,12,7,13,17,20,54,81,2,221,12,0,2,1,1,1
17155,1,36,3,1,1,3,0,0,6,0,0,0,0,0,0,0,0,0,0,0,0,2,1,1,1
17156,175,4016,722,423,573,19,0,135,741,12,172,101,199,184,300,1320,2257,6,15668,870,0,2,1,0,1
17157,175,4016,1508,847,911,44,250,301,1552,14,148,88,169,162,257,1120,1886,7,15077,837,0,2,1,0,1
17158,149,2995,373,158,315,8,0,51,381,5,76,44,79,81,123,486,779,2,2026,112,0,2,1,1,1
17184,135,2619,1457,730,1242,11,6,188,1468,10,292,166,329,302,495,2424,4078,5,22973,1276,1,2,2,1,0
17185,135,2619,74,35,59,1,0,14,75,3,14,7,14,17,21,58,85,1,128,7,0,2,2,1,0
17186,135,2619,245,125,200,5,7,34,250,7,30,17,34,37,51,166,265,3,1053,58,0,2,2,1,0
17189,21,1047,1289,550,1043,56,32,155,1345,10,167,93,185,177,278,1266,2075,5,11498,638,0,2,5,0,0
17190,20,1175,1457,730,1242,11,6,188,1468,10,292,166,329,302,495,2424,4078,5,22973,1276,1,2,3,0,0
17214,136,2631,1457,730,1242,11,6,188,1468,10,292,166,329,302,495,2424,4078,5,22973,1276,1,2,5,4,1
17215,136,2631,74,35,59,1,0,14,75,3,14,7,14,17,21,58,85,1,128,7,0,2,5,4,1
17216,136,2631,245,125,200,5,7,34,250,7,30,17,34,37,51,166,265,3,1053,58,0,2,5,4,1
17219,50,2539,1943,715,1694,26,18,214,1969,12,185,120,237,197,357,1436,2721,7,20915,1161,0,2,2,2,1
17220,20,1203,1457,730,1242,11,6,188,1468,10,292,166,329,302,495,2424,4078,5,22973,1276,1,2,5,1,1
17246,68,2996,384,251,317,7,8,52,391,11,70,44,84,81,128,467,811,6,5355,297,0,2,1,1,0
17270,191,4126,72,33,56,0,4,12,72,1,1,1,1,2,2,0,2,0,1,0,0,2,2,1,1
17271,191,4126,1454,835,1044,76,110,219,1530,17,275,158,296,292,454,2297,3718,9,34017,1889,1,2,2,1,1
17272,17,267,1098,241,925,5,10,155,1103,7,46,25,49,53,74,273,423,3,1580,87,0,2,22,42,1
17273,17,267,282,202,222,14,2,44,296,8,42,24,43,50,67,250,378,4,1548,86,0,2,22,42,1
17276,7,249,1098,241,925,5,10,155,1103,7,46,25,49,53,74,273,423,3,1580,87,0,2,22,0,1
17277,1,151,382,65,130,157,2,92,539,4,10,5,10,14,15,41,57,2,114,6,0,2,2,1,1
17278,136,2631,1457,730,1242,11,6,188,1468,10,292,166,329,302,495,2424,4078,5,22973,1276,1,2,3,2,1
17279,136,2631,74,35,59,1,0,14,75,3,14,7,14,17,21,58,85,1,128,7,0,2,3,2,1
17280,136,2631,245,125,200,5,7,34,250,7,30,17,34,37,51,166,265,3,1053,58,0,2,3,2,1
17281,50,2531,1943,715,1694,26,18,214,1969,12,185,120,237,197,357,1436,2721,7,20915,1161,0,2,0,1,0
17282,45,430,647,139,84,35,284,233,682,0,0,0,0,0,0,0,0,0,0,0,0,2,1,9,1
17283,17,295,424,94,331,4,0,89,428,1,5,5,5,6,10,11,25,0,12,0,0,2,0,13,1
17284,17,295,38,23,23,6,0,8,44,3,11,7,11,14,18,42,68,1,102,5,0,2,0,13,1
17285,193,4179,72,33,56,0,4,12,72,1,1,1,1,2,2,0,2,0,1,0,0,2,18,7,1
17286,193,4179,1454,835,1044,76,110,219,1530,17,275,158,296,292,454,2297,3718,9,34017,1889,1,2,18,7,1
17287,100,2387,1043,504,840,53,9,147,1096,9,180,112,198,189,310,1377,2344,4,11604,644,0,2,1,1,1
17288,100,2387,383,288,292,26,6,62,409,11,65,38,67,76,105,429,656,5,3719,206,0,2,1,1,1
17289,148,2983,373,158,315,8,0,51,381,5,76,44,79,81,123,486,779,2,2026,112,0,2,0,3,1
17290,23,990,373,158,315,8,0,51,381,5,76,44,79,81,123,486,779,2,2026,112,0,2,0,10,1
17291,50,2526,1943,715,1694,26,18,214,1969,12,185,120,237,197,357,1436,2721,7,20915,1161,0,2,1,1,1
17292,136,2682,1457,730,1242,11,6,188,1468,10,292,166,329,302,495,2424,4078,5,22973,1276,1,2,18,14,1
17293,136,2682,74,35,59,1,0,14,75,3,14,7,14,17,21,58,85,1,128,7,0,2,18,14,1
17294,136,2682,245,125,200,5,7,34,250,7,30,17,34,37,51,166,265,3,1053,58,0,2,18,14,1
17295,34,867,74,35,59,1,0,14,75,3,14,7,14,17,21,58,85,1,128,7,0,2,6,3,1
17296,34,867,245,125,200,5,7,34,250,7,30,17,34,37,51,166,265,3,1053,58,0,2,6,3,1
17297,148,2991,373,158,315,8,0,51,381,5,76,44,79,81,123,486,779,2,2026,112,0,2,11,12,1
17298,21,1272,1457,730,1242,11,6,188,1468,10,292,166,329,302,495,2424,4078,5,22973,1276,1,2,17,0,1
17299,1,148,382,65,130,157,2,92,539,4,10,5,10,14,15,41,57,2,114,6,0,2,1,1,1
17300,12,230,127,75,83,2,11,30,129,4,14,7,14,18,21,61,87,2,175,9,0,2,6,6,1
17301,12,230,652,304,544,16,6,88,668,6,89,51,101,95,152,591,998,3,3399,188,0,2,6,6,1
17302,12,230,2,2,2,0,0,0,2,0,0,0,0,0,0,0,0,0,0,0,0,2,6,6,1
17303,12,230,8,5,5,0,0,3,8,0,0,0,0,0,0,0,0,0,0,0,0,2,6,6,1
17306,12,230,14,8,8,0,0,6,14,0,0,0,0,0,0,0,0,0,0,0,0,2,6,6,1
17307,12,230,6,4,4,0,0,2,6,0,0,0,0,0,0,0,0,0,0,0,0,2,6,6,1
17308,12,230,6,4,4,0,0,2,6,1,2,1,2,3,3,2,4,0,2,0,0,2,6,6,1
17310,12,230,7,5,5,0,0,2,7,0,0,0,0,0,0,0,0,0,0,0,0,2,6,6,1
17312,12,230,10,6,6,0,0,4,10,0,0,0,0,0,0,0,0,0,0,0,0,2,6,6,1
17313,12,230,1,1,1,0,0,0,1,0,0,0,0,0,0,0,0,0,0,0,0,2,6,6,1
17315,12,230,14,10,10,0,0,4,14,1,1,1,1,2,2,0,2,0,1,0,0,2,6,6,1
17316,12,230,46,26,30,3,0,12,49,3,6,3,6,9,9,20,28,1,42,2,0,2,6,6,1
17319,1,36,2,2,2,0,0,0,2,0,0,0,0,0,0,0,0,0,0,0,0,2,2,2,1
17333,1,36,99,48,90,1,3,5,100,0,0,0,0,0,0,0,0,0,0,0,0,2,2,2,1
17334,1,36,8,5,5,2,0,1,10,0,0,0,0,0,0,0,0,0,0,0,0,2,2,2,1
17335,1,36,1217,716,841,84,126,174,1301,14,185,118,215,199,333,1446,2542,8,20687,1149,0,2,2,2,1
17336,1,36,160,89,115,0,13,31,160,7,15,11,17,22,28,78,124,3,495,27,0,2,2,2,1
17337,1,36,10,10,9,9,0,0,19,0,0,0,0,0,0,0,0,0,0,0,0,2,2,2,1
17338,1,36,173,84,99,8,29,36,181,5,12,7,13,17,20,54,81,2,221,12,0,2,2,2,1
17339,1,36,3,1,1,3,0,0,6,0,0,0,0,0,0,0,0,0,0,0,0,2,2,2,1
17340,204,4492,72,33,56,0,4,12,72,1,1,1,1,2,2,0,2,0,1,0,0,2,79,7,1
17341,204,4492,1454,835,1044,76,110,219,1530,17,275,158,296,292,454,2297,3718,9,34017,1889,1,2,79,7,1
17342,87,1972,1043,504,840,53,9,147,1096,9,180,112,198,189,310,1377,2344,4,11604,644,0,2,5,104,1
17343,87,1972,383,288,292,26,6,62,409,11,65,38,67,76,105,429,656,5,3719,206,0,2,5,104,1
17344,148,3003,373,158,315,8,0,51,381,5,76,44,79,81,123,486,779,2,2026,112,0,2,8,7,1
17345,71,1178,1178,367,1042,6,15,115,1184,9,94,51,95,103,146,644,976,4,4439,246,0,2,14,142,1
17346,71,1178,177,108,140,8,0,27,185,6,30,16,32,36,48,162,248,3,794,44,0,2,14,142,1
17348,36,1462,1043,504,840,53,9,147,1096,9,180,112,198,189,310,1377,2344,4,11604,644,0,2,0,55,1
17351,138,2702,1457,730,1242,11,6,188,1468,10,292,166,329,302,495,2424,4078,5,22973,1276,1,2,6,2,1
17352,138,2702,74,35,59,1,0,14,75,3,14,7,14,17,21,58,85,1,128,7,0,2,6,2,1
17353,138,2702,245,125,200,5,7,34,250,7,30,17,34,37,51,166,265,3,1053,58,0,2,6,2,1
17354,22,1337,1457,730,1242,11,6,188,1468,10,292,166,329,302,495,2424,4078,5,22973,1276,1,2,18,0,1
17355,138,2713,1457,730,1242,11,6,188,1468,10,292,166,329,302,495,2424,4078,5,22973,1276,1,2,3,3,0
17356,138,2713,74,35,59,1,0,14,75,3,14,7,14,17,21,58,85,1,128,7,0,2,3,3,0
17357,138,2713,245,125,200,5,7,34,250,7,30,17,34,37,51,166,265,3,1053,58,0,2,3,3,0
17358,137,2714,1457,730,1242,11,6,188,1468,10,292,166,329,302,495,2424,4078,5,22973,1276,1,2,3,4,1
17359,137,2714,74,35,59,1,0,14,75,3,14,7,14,17,21,58,85,1,128,7,0,2,3,4,1
17360,137,2714,245,125,200,5,7,34,250,7,30,17,34,37,51,166,265,3,1053,58,0,2,3,4,1
17361,137,2686,1943,715,1694,26,18,214,1969,12,185,120,237,197,357,1436,2721,7,20915,1161,0,2,6,6,1
17362,137,2686,1168,838,957,57,25,144,1225,19,348,224,416,367,640,3018,5452,11,61921,3440,1,2,6,6,1
17363,51,2570,1943,715,1694,26,18,214,1969,12,185,120,237,197,357,1436,2721,7,20915,1161,0,2,13,5,1
17364,23,1388,1457,730,1242,11,6,188,1468,10,292,166,329,302,495,2424,4078,5,22973,1276,1,2,8,0,1
17365,72,3397,384,251,317,7,8,52,391,11,70,44,84,81,128,467,811,6,5355,297,0,2,66,1,1
17390,45,430,647,139,84,35,284,233,682,0,0,0,0,0,0,0,0,0,0,0,0,2,1,1,1
17391,125,2558,77,34,69,0,0,8,77,3,24,16,29,27,45,114,213,1,387,21,0,3,22,7,1
17392,125,2558,712,438,573,51,9,84,763,14,102,71,128,116,199,733,1364,8,11988,666,0,3,22,7,1
17393,137,2714,1457,730,1242,11,6,188,1468,10,292,166,329,302,495,2424,4078,5,22973,1276,1,2,1,1,1
17394,137,2714,74,35,59,1,0,14,75,3,14,7,14,17,21,58,85,1,128,7,0,2,1,1,1
17395,137,2714,245,125,200,5,7,34,250,7,30,17,34,37,51,166,265,3,1053,58,0,2,1,1,1
17396,177,4051,722,423,573,19,0,135,741,12,172,101,199,184,300,1320,2257,6,15668,870,0,2,6,2,1
17397,177,4051,1508,847,911,44,250,301,1552,14,148,88,169,162,257,1120,1886,7,15077,837,0,2,6,2,1
17398,204,4492,72,33,56,0,4,12,72,1,1,1,1,2,2,0,2,0,1,0,0,2,1,1,1
17399,204,4492,1454,835,1044,76,110,219,1530,17,275,158,296,292,454,2297,3718,9,34017,1889,1,2,1,1,1
17402,28,1309,1289,550,1043,56,32,155,1345,10,167,93,185,177,278,1266,2075,5,11498,638,0,2,81,44,1
17403,7,163,127,75,83,2,11,30,129,4,14,7,14,18,21,61,87,2,175,9,0,2,1,1,1
17404,7,163,652,304,544,16,6,88,668,6,89,51,101,95,152,591,998,3,3399,188,0,2,1,1,1
17405,7,163,2,2,2,0,0,0,2,0,0,0,0,0,0,0,0,0,0,0,0,2,1,1,1
17406,7,163,8,5,5,0,0,3,8,0,0,0,0,0,0,0,0,0,0,0,0,2,1,1,1
17409,7,163,14,8,8,0,0,6,14,0,0,0,0,0,0,0,0,0,0,0,0,2,1,1,1
17410,7,163,6,4,4,0,0,2,6,0,0,0,0,0,0,0,0,0,0,0,0,2,1,1,1
17411,7,163,6,4,4,0,0,2,6,1,2,1,2,3,3,2,4,0,2,0,0,2,1,1,1
17413,7,163,7,5,5,0,0,2,7,0,0,0,0,0,0,0,0,0,0,0,0,2,1,1,1
17415,7,163,10,6,6,0,0,4,10,0,0,0,0,0,0,0,0,0,0,0,0,2,1,1,1
17416,7,163,1,1,1,0,0,0,1,0,0,0,0,0,0,0,0,0,0,0,0,2,1,1,1
17418,7,163,14,10,10,0,0,4,14,1,1,1,1,2,2,0,2,0,1,0,0,2,1,1,1
17419,7,163,46,26,30,3,0,12,49,3,6,3,6,9,9,20,28,1,42,2,0,2,1,1,1
17420,10,500,722,423,573,19,0,135,741,12,172,101,199,184,300,1320,2257,6,15668,870,0,2,2,2,1
17421,72,3397,77,34,69,0,0,8,77,3,24,16,29,27,45,114,213,1,387,21,0,3,5,5,1
17422,126,2604,77,34,69,0,0,8,77,3,24,16,29,27,45,114,213,1,387,21,0,2,10,5,1
17423,126,2604,712,438,573,51,9,84,763,14,102,71,128,116,199,733,1364,8,11988,666,0,2,10,5,1
17424,74,3546,77,34,69,0,0,8,77,3,24,16,29,27,45,114,213,1,387,21,0,2,25,3,1
17449,128,2662,77,34,69,0,0,8,77,3,24,16,29,27,45,114,213,1,387,21,0,2,12,3,1
17450,128,2662,712,438,573,51,9,84,763,14,102,71,128,116,199,733,1364,8,11988,666,0,2,12,3,1
17451,65,1174,1513,682,1277,25,13,200,1538,11,199,116,219,210,335,1557,2584,6,15641,868,0,2,5,1,1
17452,65,1174,819,519,539,24,98,155,843,15,96,57,106,111,163,690,1107,8,9171,509,0,2,5,1,1
17453,137,2716,1457,730,1242,11,6,188,1468,10,292,166,329,302,495,2424,4078,5,22973,1276,1,2,1,1,1
17454,137,2716,74,35,59,1,0,14,75,3,14,7,14,17,21,58,85,1,128,7,0,2,1,1,1
17455,137,2716,245,125,200,5,7,34,250,7,30,17,34,37,51,166,265,3,1053,58,0,2,1,1,1
17456,16,578,1455,414,1257,16,76,112,1471,5,41,23,46,46,69,231,381,2,1069,59,0,2,1,1,1
17457,16,578,669,365,481,22,61,110,691,15,103,63,122,118,185,747,1273,8,11311,628,0,2,1,1,1
17458,37,1041,1523,757,1297,19,12,193,1542,12,193,117,230,205,347,1508,2664,7,19053,1058,0,2,4,1,1
17459,37,1041,701,378,504,33,58,109,734,13,110,68,126,123,194,794,1346,7,10027,557,0,2,4,1,1
17460,177,4149,722,423,573,19,0,135,741,12,172,101,199,184,300,1320,2257,6,15668,870,0,2,30,17,1
17461,177,4149,1508,847,911,44,250,301,1552,14,148,88,169,162,257,1120,1886,7,15077,837,0,2,30,17,1
17462,205,4488,72,33,56,0,4,12,72,1,1,1,1,2,2,0,2,0,1,0,0,2,9,8,1
17463,205,4488,1454,835,1044,76,110,219,1530,17,275,158,296,292,454,2297,3718,9,34017,1889,1,2,9,8,1
17464,84,1800,1043,504,840,53,9,147,1096,9,180,112,198,189,310,1377,2344,4,11604,644,0,2,19,53,1
17465,84,1800,383,288,292,26,6,62,409,11,65,38,67,76,105,429,656,5,3719,206,0,2,19,53,1
17466,125,2880,373,158,315,8,0,51,381,5,76,44,79,81,123,486,779,2,2026,112,0,2,191,214,1
17467,137,2668,1943,715,1694,26,18,214,1969,12,185,120,237,197,357,1436,2721,7,20915,1161,0,2,6,5,1
17468,137,2668,1168,838,957,57,25,144,1225,19,348,224,416,367,640,3018,5452,11,61921,3440,1,2,6,5,1
17471,30,1389,1289,550,1043,56,32,155,1345,10,167,93,185,177,278,1266,2075,5,11498,638,0,2,24,5,1
17472,19,1390,1523,757,1297,19,12,193,1542,12,193,117,230,205,347,1508,2664,7,19053,1058,0,2,24,10,1
17473,36,1466,1043,504,840,53,9,147,1096,9,180,112,198,189,310,1377,2344,4,11604,644,0,2,2,2,1
17474,23,996,373,158,315,8,0,51,381,5,76,44,79,81,123,486,779,2,2026,112,0,2,6,5,1
17475,51,2570,1943,715,1694,26,18,214,1969,12,185,120,237,197,357,1436,2721,7,20915,1161,0,2,3,8,1
17476,40,2822,1296,573,1062,40,33,157,1336,8,201,118,231,209,349,1561,2689,4,12365,686,0,2,345,114,1
17477,23,1388,1457,730,1242,11,6,188,1468,10,292,166,329,302,495,2424,4078,5,22973,1276,1,2,1,1,1
17478,1,149,382,65,130,157,2,92,539,4,10,5,10,14,15,41,57,2,114,6,0,2,2,2,1
17479,44,888,1450,624,1228,12,26,181,1462,14,306,186,354,320,540,2580,4493,8,36391,2021,1,2,3,0,1
17480,65,1174,1513,682,1277,25,13,200,1538,11,199,116,219,210,335,1557,2584,6,15641,868,0,2,1,3,1
17481,65,1174,819,519,539,24,98,155,843,15,96,57,106,111,163,690,1107,8,9171,509,0,2,1,3,1
17482,137,2717,1457,730,1242,11,6,188,1468,10,292,166,329,302,495,2424,4078,5,22973,1276,1,2,1,1,1
17483,137,2717,74,35,59,1,0,14,75,3,14,7,14,17,21,58,85,1,128,7,0,2,1,1,1
17484,137,2717,245,125,200,5,7,34,250,7,30,17,34,37,51,166,265,3,1053,58,0,2,1,1,1
17487,34,867,74,35,59,1,0,14,75,3,14,7,14,17,21,58,85,1,128,7,0,2,1,2,1
17488,34,867,245,125,200,5,7,34,250,7,30,17,34,37,51,166,265,3,1053,58,0,2,1,2,1
17489,37,1041,1523,757,1297,19,12,193,1542,12,193,117,230,205,347,1508,2664,7,19053,1058,0,2,3,2,1
17490,37,1041,701,378,504,33,58,109,734,13,110,68,126,123,194,794,1346,7,10027,557,0,2,3,2,1
17491,44,777,1020,354,843,12,15,144,1032,8,134,77,144,142,221,970,1580,4,6792,377,0,2,3,3,1
17492,24,514,447,308,343,6,5,95,453,7,96,59,111,103,170,651,1136,4,4600,255,0,2,1,1,1
17493,24,514,322,174,179,16,74,51,338,10,41,26,46,51,72,252,408,5,2291,127,0,2,1,1,1
17494,17,295,424,94,331,4,0,89,428,1,5,5,5,6,10,11,25,0,12,0,0,2,1,35,1
17495,17,295,38,23,23,6,0,8,44,3,11,7,11,14,18,42,68,1,102,5,0,2,1,35,1
17496,20,483,1293,570,1093,25,15,163,1318,10,195,123,241,205,364,1516,2795,6,17273,959,0,2,2,3,1
17497,177,4149,722,423,573,19,0,135,741,12,172,101,199,184,300,1320,2257,6,15668,870,0,2,1,3,1
17498,177,4149,1508,847,911,44,250,301,1552,14,148,88,169,162,257,1120,1886,7,15077,837,0,2,1,3,1
17499,205,4488,72,33,56,0,4,12,72,1,1,1,1,2,2,0,2,0,1,0,0,2,1,3,1
17500,205,4488,1454,835,1044,76,110,219,1530,17,275,158,296,292,454,2297,3718,9,34017,1889,1,2,1,3,1
17501,18,462,386,256,301,16,9,68,402,4,59,35,69,63,104,355,621,2,1453,80,0,2,1,1,1
17502,18,462,264,131,164,11,41,46,275,6,38,22,40,44,62,214,338,3,1068,59,0,2,1,1,1
17503,26,554,215,129,180,6,0,29,221,8,65,43,72,73,115,415,711,4,3153,175,0,2,1,1,1
17504,26,554,97,69,77,3,3,16,100,6,22,13,23,28,36,113,173,3,542,30,0,2,1,1,1
17505,84,1800,1043,504,840,53,9,147,1096,9,180,112,198,189,310,1377,2344,4,11604,644,0,2,4,5,1
17506,84,1800,383,288,292,26,6,62,409,11,65,38,67,76,105,429,656,5,3719,206,0,2,4,5,1
17507,125,2880,373,158,315,8,0,51,381,5,76,44,79,81,123,486,779,2,2026,112,0,2,3,7,1
17508,71,1178,1178,367,1042,6,15,115,1184,9,94,51,95,103,146,644,976,4,4439,246,0,2,1,3,1
17509,71,1178,177,108,140,8,0,27,185,6,30,16,32,36,48,162,248,3,794,44,0,2,1,3,1
17510,137,2668,1943,715,1694,26,18,214,1969,12,185,120,237,197,357,1436,2721,7,20915,1161,0,2,1,2,1
17511,137,2668,1168,838,957,57,25,144,1225,19,348,224,416,367,640,3018,5452,11,61921,3440,1,2,1,2,1
17512,3,88,442,244,305,14,16,103,456,11,68,45,75,79,120,452,756,6,4588,254,0,2,1,10,1
17513,3,88,182,102,99,11,40,35,193,3,11,6,11,14,17,42,64,1,97,5,0,2,1,10,1
17514,17,267,1098,241,925,5,10,155,1103,7,46,25,49,53,74,273,423,3,1580,87,0,2,1,3,1
17515,17,267,282,202,222,14,2,44,296,8,42,24,43,50,67,250,378,4,1548,86,0,2,1,3,1
17516,129,2662,77,34,69,0,0,8,77,3,24,16,29,27,45,114,213,1,387,21,0,2,5,4,0
17517,129,2662,712,438,573,51,9,84,763,14,102,71,128,116,199,733,1364,8,11988,666,0,2,5,4,0
17518,130,2666,77,34,69,0,0,8,77,3,24,16,29,27,45,114,213,1,387,21,0,2,6,4,0
17519,130,2666,712,438,573,51,9,84,763,14,102,71,128,116,199,733,1364,8,11988,666,0,2,6,4,0
17520,75,3605,77,34,69,0,0,8,77,3,24,16,29,27,45,114,213,1,387,21,0,2,13,5,0
17521,130,2674,77,34,69,0,0,8,77,3,24,16,29,27,45,114,213,1,387,21,0,2,1,1,0
17522,130,2674,712,438,573,51,9,84,763,14,102,71,128,116,199,733,1364,8,11988,666,0,2,1,1,0
17546,205,4488,72,33,56,0,4,12,72,1,1,1,1,2,2,0,2,0,1,0,0,2,2,2,1
17547,205,4488,1454,835,1044,76,110,219,1530,17,275,158,296,292,454,2297,3718,9,34017,1889,1,2,2,2,1
17548,130,2988,373,158,315,8,0,51,381,5,76,44,79,81,123,486,779,2,2026,112,0,2,20,1,1
17551,32,1512,1289,550,1043,56,32,155,1345,10,167,93,185,177,278,1266,2075,5,11498,638,0,2,21,0,1
17552,132,2708,77,34,69,0,0,8,77,3,24,16,29,27,45,114,213,1,387,21,0,2,5,1,1
17553,132,2708,712,438,573,51,9,84,763,14,102,71,128,116,199,733,1364,8,11988,666,0,2,5,1,1
17554,43,866,1450,624,1228,12,26,181,1462,14,306,186,354,320,540,2580,4493,8,36391,2021,1,2,6,9,1
17555,206,4499,72,33,56,0,4,12,72,1,1,1,1,2,2,0,2,0,1,0,0,2,3,0,1
17556,206,4499,1454,835,1044,76,110,219,1530,17,275,158,296,292,454,2297,3718,9,34017,1889,1,2,3,0,1
17557,17,270,1098,241,925,5,10,155,1103,7,46,25,49,53,74,273,423,3,1580,87,0,2,5,4,1
17558,17,270,282,202,222,14,2,44,296,8,42,24,43,50,67,250,378,4,1548,86,0,2,5,4,1
17559,33,1559,1289,550,1043,56,32,155,1345,10,167,93,185,177,278,1266,2075,5,11498,638,0,2,16,0,1
17560,27,949,1450,624,1228,12,26,181,1462,14,306,186,354,320,540,2580,4493,8,36391,2021,1,2,9,0,1
17561,131,3030,373,158,315,8,0,51,381,5,76,44,79,81,123,486,779,2,2026,112,0,2,11,6,1
17562,33,1567,1289,550,1043,56,32,155,1345,10,167,93,185,177,278,1266,2075,5,11498,638,0,2,2,1,1
17563,26,920,1450,624,1228,12,26,181,1462,14,306,186,354,320,540,2580,4493,8,36391,2021,1,2,0,9,1
17564,41,2892,1296,573,1062,40,33,157,1336,8,201,118,231,209,349,1561,2689,4,12365,686,0,2,13,0,1
17565,139,2720,1457,730,1242,11,6,188,1468,10,292,166,329,302,495,2424,4078,5,22973,1276,1,2,1,1,0
17566,139,2720,74,35,59,1,0,14,75,3,14,7,14,17,21,58,85,1,128,7,0,2,1,1,0
17567,139,2720,245,125,200,5,7,34,250,7,30,17,34,37,51,166,265,3,1053,58,0,2,1,1,0
17568,33,1569,1289,550,1043,56,32,155,1345,10,167,93,185,177,278,1266,2075,5,11498,638,0,2,1,1,0
17569,132,2720,77,34,69,0,0,8,77,3,24,16,29,27,45,114,213,1,387,21,0,2,5,2,0
17570,132,2720,712,438,573,51,9,84,763,14,102,71,128,116,199,733,1364,8,11988,666,0,2,5,2,0
17571,131,3034,373,158,315,8,0,51,381,5,76,44,79,81,123,486,779,2,2026,112,0,2,1,1,0
17572,19,284,1098,241,925,5,10,155,1103,7,46,25,49,53,74,273,423,3,1580,87,0,2,4,0,0
17573,19,284,282,202,222,14,2,44,296,8,42,24,43,50,67,250,378,4,1548,86,0,2,4,0,0
17574,33,1595,1289,550,1043,56,32,155,1345,10,167,93,185,177,278,1266,2075,5,11498,638,0,2,6,1,0
17575,41,2882,1296,573,1062,40,33,157,1336,8,201,118,231,209,349,1561,2689,4,12365,686,0,2,0,2,0
17576,24,1442,1457,730,1242,11,6,188,1468,10,292,166,329,302,495,2424,4078,5,22973,1276,1,2,11,0,0
17577,131,3031,373,158,315,8,0,51,381,5,76,44,79,81,123,486,779,2,2026,112,0,2,1,1,1
17603,33,1606,1289,550,1043,56,32,155,1345,10,167,93,185,177,278,1266,2075,5,11498,638,0,2,1,0,0
17652,45,430,647,139,84,35,284,233,682,0,0,0,0,0,0,0,0,0,0,0,0,2,5,5,1
17653,177,4149,722,423,573,19,0,135,741,12,172,101,199,184,300,1320,2257,6,15668,870,0,2,13,13,1
17654,177,4149,1508,847,911,44,250,301,1552,14,148,88,169,162,257,1120,1886,7,15077,837,0,2,13,13,1
17655,206,4499,72,33,56,0,4,12,72,1,1,1,1,2,2,0,2,0,1,0,0,2,9,9,1
17656,206,4499,1454,835,1044,76,110,219,1530,17,275,158,296,292,454,2297,3718,9,34017,1889,1,2,9,9,1
17657,138,3144,373,158,315,8,0,51,381,5,76,44,79,81,123,486,779,2,2026,112,0,2,40,22,1
17658,138,2675,1943,715,1694,26,18,214,1969,12,185,120,237,197,357,1436,2721,7,20915,1161,0,2,3,2,1
17659,138,2675,1168,838,957,57,25,144,1225,19,348,224,416,367,640,3018,5452,11,61921,3440,1,2,3,2,1
17662,13,1148,215,129,180,6,0,29,221,8,65,43,72,73,115,415,711,4,3153,175,0,2,4,4,1
17663,36,1466,1043,504,840,53,9,147,1096,9,180,112,198,189,310,1377,2344,4,11604,644,0,2,1,1,1
17664,51,2570,1943,715,1694,26,18,214,1969,12,185,120,237,197,357,1436,2721,7,20915,1161,0,2,1,1,1
17665,41,2894,1296,573,1062,40,33,157,1336,8,201,118,231,209,349,1561,2689,4,12365,686,0,2,14,13,1
17666,37,1039,1523,757,1297,19,12,193,1542,12,193,117,230,205,347,1508,2664,7,19053,1058,0,2,1,1,1
17667,37,1039,701,378,504,33,58,109,734,13,110,68,126,123,194,794,1346,7,10027,557,0,2,1,1,1
17668,206,4499,72,33,56,0,4,12,72,1,1,1,1,2,2,0,2,0,1,0,0,2,1,0,1
17669,206,4499,1454,835,1044,76,110,219,1530,17,275,158,296,292,454,2297,3718,9,34017,1889,1,2,1,0,1
17670,130,3030,373,158,315,8,0,51,381,5,76,44,79,81,123,486,779,2,2026,112,0,2,11,30,1
17671,133,2756,77,34,69,0,0,8,77,3,24,16,29,27,45,114,213,1,387,21,0,2,5,0,1
17672,133,2756,712,438,573,51,9,84,763,14,102,71,128,116,199,733,1364,8,11988,666,0,2,5,0,1
17673,141,2754,1457,730,1242,11,6,188,1468,10,292,166,329,302,495,2424,4078,5,22973,1276,1,2,16,11,1
17674,141,2754,74,35,59,1,0,14,75,3,14,7,14,17,21,58,85,1,128,7,0,2,16,11,1
17675,141,2754,245,125,200,5,7,34,250,7,30,17,34,37,51,166,265,3,1053,58,0,2,16,11,1
17676,34,866,74,35,59,1,0,14,75,3,14,7,14,17,21,58,85,1,128,7,0,2,2,1,1
17677,34,866,245,125,200,5,7,34,250,7,30,17,34,37,51,166,265,3,1053,58,0,2,2,1,1
17678,51,2564,1943,715,1694,26,18,214,1969,12,185,120,237,197,357,1436,2721,7,20915,1161,0,2,0,1,1
17679,26,1597,1457,730,1242,11,6,188,1468,10,292,166,329,302,495,2424,4078,5,22973,1276,1,2,24,0,1
17705,133,2758,77,34,69,0,0,8,77,3,24,16,29,27,45,114,213,1,387,21,0,2,2,2,0
17706,133,2758,712,438,573,51,9,84,763,14,102,71,128,116,199,733,1364,8,11988,666,0,2,2,2,0
17707,19,1390,1523,757,1297,19,12,193,1542,12,193,117,230,205,347,1508,2664,7,19053,1058,0,2,1,0,0
17708,177,4157,722,423,573,19,0,135,741,12,172,101,199,184,300,1320,2257,6,15668,870,0,2,1,1,0
17709,177,4157,1508,847,911,44,250,301,1552,14,148,88,169,162,257,1120,1886,7,15077,837,0,2,1,1,0
17710,12,222,127,75,83,2,11,30,129,4,14,7,14,18,21,61,87,2,175,9,0,2,2,2,1
17711,12,222,652,304,544,16,6,88,668,6,89,51,101,95,152,591,998,3,3399,188,0,2,2,2,1
17712,12,222,2,2,2,0,0,0,2,0,0,0,0,0,0,0,0,0,0,0,0,2,2,2,1
17713,12,222,8,5,5,0,0,3,8,0,0,0,0,0,0,0,0,0,0,0,0,2,2,2,1
17716,12,222,14,8,8,0,0,6,14,0,0,0,0,0,0,0,0,0,0,0,0,2,2,2,1
17717,12,222,6,4,4,0,0,2,6,0,0,0,0,0,0,0,0,0,0,0,0,2,2,2,1
17718,12,222,6,4,4,0,0,2,6,1,2,1,2,3,3,2,4,0,2,0,0,2,2,2,1
17720,12,222,7,5,5,0,0,2,7,0,0,0,0,0,0,0,0,0,0,0,0,2,2,2,1
17722,12,222,10,6,6,0,0,4,10,0,0,0,0,0,0,0,0,0,0,0,0,2,2,2,1
17723,12,222,1,1,1,0,0,0,1,0,0,0,0,0,0,0,0,0,0,0,0,2,2,2,1
17725,12,222,14,10,10,0,0,4,14,1,1,1,1,2,2,0,2,0,1,0,0,2,2,2,1
17726,12,222,46,26,30,3,0,12,49,3,6,3,6,9,9,20,28,1,42,2,0,2,2,2,1
17727,4,76,127,75,83,2,11,30,129,4,14,7,14,18,21,61,87,2,175,9,0,2,2,2,1
17728,4,76,652,304,544,16,6,88,668,6,89,51,101,95,152,591,998,3,3399,188,0,2,2,2,1
17729,4,76,2,2,2,0,0,0,2,0,0,0,0,0,0,0,0,0,0,0,0,2,2,2,1
17730,4,76,8,5,5,0,0,3,8,0,0,0,0,0,0,0,0,0,0,0,0,2,2,2,1
17733,4,76,14,8,8,0,0,6,14,0,0,0,0,0,0,0,0,0,0,0,0,2,2,2,1
17734,4,76,6,4,4,0,0,2,6,0,0,0,0,0,0,0,0,0,0,0,0,2,2,2,1
17735,4,76,6,4,4,0,0,2,6,1,2,1,2,3,3,2,4,0,2,0,0,2,2,2,1
17737,4,76,7,5,5,0,0,2,7,0,0,0,0,0,0,0,0,0,0,0,0,2,2,2,1
17739,4,76,10,6,6,0,0,4,10,0,0,0,0,0,0,0,0,0,0,0,0,2,2,2,1
17740,4,76,1,1,1,0,0,0,1,0,0,0,0,0,0,0,0,0,0,0,0,2,2,2,1
17742,4,76,14,10,10,0,0,4,14,1,1,1,1,2,2,0,2,0,1,0,0,2,2,2,1
17743,4,76,46,26,30,3,0,12,49,3,6,3,6,9,9,20,28,1,42,2,0,2,2,2,1
17768,133,2760,77,34,69,0,0,8,77,3,24,16,29,27,45,114,213,1,387,21,0,2,13,4,1
17769,133,2760,712,438,573,51,9,84,763,14,102,71,128,116,199,733,1364,8,11988,666,0,2,13,4,1
17770,16,576,1455,414,1257,16,76,112,1471,5,41,23,46,46,69,231,381,2,1069,59,0,2,2,2,1
17771,16,576,669,365,481,22,61,110,691,15,103,63,122,118,185,747,1273,8,11311,628,0,2,2,2,1
17772,44,767,1020,354,843,12,15,144,1032,8,134,77,144,142,221,970,1580,4,6792,377,0,2,3,3,1
17773,17,277,424,94,331,4,0,89,428,1,5,5,5,6,10,11,25,0,12,0,0,2,6,6,1
17774,17,277,38,23,23,6,0,8,44,3,11,7,11,14,18,42,68,1,102,5,0,2,6,6,1
17775,206,4475,72,33,56,0,4,12,72,1,1,1,1,2,2,0,2,0,1,0,0,2,11,11,1
17776,206,4475,1454,835,1044,76,110,219,1530,17,275,158,296,292,454,2297,3718,9,34017,1889,1,2,11,11,1
17777,130,3020,373,158,315,8,0,51,381,5,76,44,79,81,123,486,779,2,2026,112,0,2,7,7,1
17778,71,1170,1178,367,1042,6,15,115,1184,9,94,51,95,103,146,644,976,4,4439,246,0,2,2,2,1
17779,71,1170,177,108,140,8,0,27,185,6,30,16,32,36,48,162,248,3,794,44,0,2,2,2,1
17780,19,278,1098,241,925,5,10,155,1103,7,46,25,49,53,74,273,423,3,1580,87,0,2,3,3,1
17781,19,278,282,202,222,14,2,44,296,8,42,24,43,50,67,250,378,4,1548,86,0,2,3,3,1
17784,35,1670,1289,550,1043,56,32,155,1345,10,167,93,185,177,278,1266,2075,5,11498,638,0,2,33,22,1
17785,19,1390,1523,757,1297,19,12,193,1542,12,193,117,230,205,347,1508,2664,7,19053,1058,0,2,2,2,1
17786,36,1466,1043,504,840,53,9,147,1096,9,180,112,198,189,310,1377,2344,4,11604,644,0,2,8,9,1
17787,23,994,373,158,315,8,0,51,381,5,76,44,79,81,123,486,779,2,2026,112,0,2,4,4,1
17788,41,2834,1296,573,1062,40,33,157,1336,8,201,118,231,209,349,1561,2689,4,12365,686,0,2,32,32,1
17789,26,1354,652,304,544,16,6,88,668,6,89,51,101,95,152,591,998,3,3399,188,0,2,1,1,1
17790,75,3605,77,34,69,0,0,8,77,3,24,16,29,27,45,114,213,1,387,21,0,2,2,2,1
17814,43,864,1450,624,1228,12,26,181,1462,14,306,186,354,320,540,2580,4493,8,36391,2021,1,3,1,1,1
17817,141,2754,1457,730,1242,11,6,188,1468,10,292,166,329,302,495,2424,4078,5,22973,1276,1,3,1,1,1
17818,141,2754,74,35,59,1,0,14,75,3,14,7,14,17,21,58,85,1,128,7,0,3,1,1,1
17819,141,2754,245,125,200,5,7,34,250,7,30,17,34,37,51,166,265,3,1053,58,0,3,1,1,1
17822,34,862,74,35,59,1,0,14,75,3,14,7,14,17,21,58,85,1,128,7,0,3,1,1,1
17823,34,862,245,125,200,5,7,34,250,7,30,17,34,37,51,166,265,3,1053,58,0,3,1,1,1
17824,45,430,647,139,84,35,284,233,682,0,0,0,0,0,0,0,0,0,0,0,0,3,3,3,1
17835,177,4162,722,423,573,19,0,135,741,12,172,101,199,184,300,1320,2257,6,15668,870,0,3,3,3,1
17836,177,4162,1508,847,911,44,250,301,1552,14,148,88,169,162,257,1120,1886,7,15077,837,0,3,3,3,1
17837,206,4475,72,33,56,0,4,12,72,1,1,1,1,2,2,0,2,0,1,0,0,3,4,4,1
17838,206,4475,1454,835,1044,76,110,219,1530,17,275,158,296,292,454,2297,3718,9,34017,1889,1,3,4,4,1
17845,130,3034,373,158,315,8,0,51,381,5,76,44,79,81,123,486,779,2,2026,112,0,3,4,3,1
17854,12,222,127,75,83,2,11,30,129,4,14,7,14,18,21,61,87,2,175,9,0,2,1,1,1
17855,12,222,652,304,544,16,6,88,668,6,89,51,101,95,152,591,998,3,3399,188,0,2,1,1,1
17856,12,222,2,2,2,0,0,0,2,0,0,0,0,0,0,0,0,0,0,0,0,2,1,1,1
17857,12,222,8,5,5,0,0,3,8,0,0,0,0,0,0,0,0,0,0,0,0,2,1,1,1
17860,12,222,14,8,8,0,0,6,14,0,0,0,0,0,0,0,0,0,0,0,0,2,1,1,1
17861,12,222,6,4,4,0,0,2,6,0,0,0,0,0,0,0,0,0,0,0,0,2,1,1,1
17862,12,222,6,4,4,0,0,2,6,1,2,1,2,3,3,2,4,0,2,0,0,2,1,1,1
17864,12,222,7,5,5,0,0,2,7,0,0,0,0,0,0,0,0,0,0,0,0,2,1,1,1
17866,12,222,10,6,6,0,0,4,10,0,0,0,0,0,0,0,0,0,0,0,0,2,1,1,1
17867,12,222,1,1,1,0,0,0,1,0,0,0,0,0,0,0,0,0,0,0,0,2,1,1,1
17869,12,222,14,10,10,0,0,4,14,1,1,1,1,2,2,0,2,0,1,0,0,2,1,1,1
17870,12,222,46,26,30,3,0,12,49,3,6,3,6,9,9,20,28,1,42,2,0,2,1,1,1
17895,6,287,42,7,35,4,0,5,46,1,2,1,2,3,3,2,4,0,2,0,0,2,3,2,1
17896,6,287,11,6,10,0,0,1,11,2,4,2,4,6,6,10,15,1,15,0,0,2,3,2,1
17897,35,1615,1289,550,1043,56,32,155,1345,10,167,93,185,177,278,1266,2075,5,11498,638,0,2,20,13,1
17898,7,159,127,75,83,2,11,30,129,4,14,7,14,18,21,61,87,2,175,9,0,2,3,3,1
17899,7,159,652,304,544,16,6,88,668,6,89,51,101,95,152,591,998,3,3399,188,0,2,3,3,1
17900,7,159,2,2,2,0,0,0,2,0,0,0,0,0,0,0,0,0,0,0,0,2,3,3,1
17901,7,159,8,5,5,0,0,3,8,0,0,0,0,0,0,0,0,0,0,0,0,2,3,3,1
17904,7,159,14,8,8,0,0,6,14,0,0,0,0,0,0,0,0,0,0,0,0,2,3,3,1
17905,7,159,6,4,4,0,0,2,6,0,0,0,0,0,0,0,0,0,0,0,0,2,3,3,1
17906,7,159,6,4,4,0,0,2,6,1,2,1,2,3,3,2,4,0,2,0,0,2,3,3,1
17908,7,159,7,5,5,0,0,2,7,0,0,0,0,0,0,0,0,0,0,0,0,2,3,3,1
17910,7,159,10,6,6,0,0,4,10,0,0,0,0,0,0,0,0,0,0,0,0,2,3,3,1
17911,7,159,1,1,1,0,0,0,1,0,0,0,0,0,0,0,0,0,0,0,0,2,3,3,1
17913,7,159,14,10,10,0,0,4,14,1,1,1,1,2,2,0,2,0,1,0,0,2,3,3,1
17914,7,159,46,26,30,3,0,12,49,3,6,3,6,9,9,20,28,1,42,2,0,2,3,3,1
17915,26,918,1450,624,1228,12,26,181,1462,14,306,186,354,320,540,2580,4493,8,36391,2021,1,2,1,1,1
17916,34,1378,1513,682,1277,25,13,200,1538,11,199,116,219,210,335,1557,2584,6,15641,868,0,2,1,1,1
17917,10,401,1455,414,1257,16,76,112,1471,5,41,23,46,46,69,231,381,2,1069,59,0,2,1,1,1
17918,7,222,74,35,59,1,0,14,75,3,14,7,14,17,21,58,85,1,128,7,0,2,1,1,1
17919,31,1245,1020,354,843,12,15,144,1032,8,134,77,144,142,221,970,1580,4,6792,377,0,2,1,1,1
17920,12,818,447,308,343,6,5,95,453,7,96,59,111,103,170,651,1136,4,4600,255,0,2,1,1,1
17921,10,498,722,423,573,19,0,135,741,12,172,101,199,184,300,1320,2257,6,15668,870,0,2,3,3,1
17922,12,416,386,256,301,16,9,68,402,4,59,35,69,63,104,355,621,2,1453,80,0,2,1,1,1
17923,13,1142,215,129,180,6,0,29,221,8,65,43,72,73,115,415,711,4,3153,175,0,2,3,3,1
17924,36,1464,1043,504,840,53,9,147,1096,9,180,112,198,189,310,1377,2344,4,11604,644,0,2,1,1,1
17925,28,1381,1178,367,1042,6,15,115,1184,9,94,51,95,103,146,644,976,4,4439,246,0,2,3,3,1
17926,51,2560,1943,715,1694,26,18,214,1969,12,185,120,237,197,357,1436,2721,7,20915,1161,0,2,2,2,1
17927,2,135,442,244,305,14,16,103,456,11,68,45,75,79,120,452,756,6,4588,254,0,2,2,2,1
17928,41,2832,1296,573,1062,40,33,157,1336,8,201,118,231,209,349,1561,2689,4,12365,686,0,2,1,1,1
17929,26,1595,1457,730,1242,11,6,188,1468,10,292,166,329,302,495,2424,4078,5,22973,1276,1,2,1,1,1
17930,26,1352,652,304,544,16,6,88,668,6,89,51,101,95,152,591,998,3,3399,188,0,2,2,2,1
17931,17,773,334,251,279,10,4,40,344,5,127,74,143,132,217,899,1528,2,4303,239,0,2,1,1,1
17992,177,4154,722,423,573,19,0,135,741,12,172,101,199,184,300,1320,2257,6,15668,870,0,2,4,1,1
17993,177,4154,1508,847,911,44,250,301,1552,14,148,88,169,162,257,1120,1886,7,15077,837,0,2,4,1,1
17994,176,4145,722,423,573,19,0,135,741,12,172,101,199,184,300,1320,2257,6,15668,870,0,2,4,5,1
17995,176,4145,1508,847,911,44,250,301,1552,14,148,88,169,162,257,1120,1886,7,15077,837,0,2,4,5,1
17996,6,287,42,7,35,4,0,5,46,1,2,1,2,3,3,2,4,0,2,0,0,2,1,1,1
17997,6,287,11,6,10,0,0,1,11,2,4,2,4,6,6,10,15,1,15,0,0,2,1,1,1
17998,26,560,215,129,180,6,0,29,221,8,65,43,72,73,115,415,711,4,3153,175,0,2,3,2,1
17999,26,560,97,69,77,3,3,16,100,6,22,13,23,28,36,113,173,3,542,30,0,2,3,2,1
18000,87,1903,1043,504,840,53,9,147,1096,9,180,112,198,189,310,1377,2344,4,11604,644,0,2,20,7,1
18001,87,1903,383,288,292,26,6,62,409,11,65,38,67,76,105,429,656,5,3719,206,0,2,20,7,1
18002,71,1168,1178,367,1042,6,15,115,1184,9,94,51,95,103,146,644,976,4,4439,246,0,2,2,2,1
18003,71,1168,177,108,140,8,0,27,185,6,30,16,32,36,48,162,248,3,794,44,0,2,2,2,1
18004,138,2676,1943,715,1694,26,18,214,1969,12,185,120,237,197,357,1436,2721,7,20915,1161,0,2,1,1,1
18005,138,2676,1168,838,957,57,25,144,1225,19,348,224,416,367,640,3018,5452,11,61921,3440,1,2,1,1,1
18008,37,1499,1043,504,840,53,9,147,1096,9,180,112,198,189,310,1377,2344,4,11604,644,0,2,7,2,1
18009,28,1372,1178,367,1042,6,15,115,1184,9,94,51,95,103,146,644,976,4,4439,246,0,2,7,8,1
18010,130,3043,373,158,315,8,0,51,381,5,76,44,79,81,123,486,779,2,2026,112,0,2,2,1,1
18011,137,2628,1943,715,1694,26,18,214,1969,12,185,120,237,197,357,1436,2721,7,20915,1161,0,2,1,5,1
18012,137,2628,1168,838,957,57,25,144,1225,19,348,224,416,367,640,3018,5452,11,61921,3440,1,2,1,5,1
18013,34,862,74,35,59,1,0,14,75,3,14,7,14,17,21,58,85,1,128,7,0,2,2,2,0
18014,34,862,245,125,200,5,7,34,250,7,30,17,34,37,51,166,265,3,1053,58,0,2,2,2,0
18015,4,78,127,75,83,2,11,30,129,4,14,7,14,18,21,61,87,2,175,9,0,2,1,1,0
18016,4,78,652,304,544,16,6,88,668,6,89,51,101,95,152,591,998,3,3399,188,0,2,1,1,0
18017,4,78,2,2,2,0,0,0,2,0,0,0,0,0,0,0,0,0,0,0,0,2,1,1,0
18018,4,78,8,5,5,0,0,3,8,0,0,0,0,0,0,0,0,0,0,0,0,2,1,1,0
18021,4,78,14,8,8,0,0,6,14,0,0,0,0,0,0,0,0,0,0,0,0,2,1,1,0
18022,4,78,6,4,4,0,0,2,6,0,0,0,0,0,0,0,0,0,0,0,0,2,1,1,0
18023,4,78,6,4,4,0,0,2,6,1,2,1,2,3,3,2,4,0,2,0,0,2,1,1,0
18025,4,78,7,5,5,0,0,2,7,0,0,0,0,0,0,0,0,0,0,0,0,2,1,1,0
18027,4,78,10,6,6,0,0,4,10,0,0,0,0,0,0,0,0,0,0,0,0,2,1,1,0
18028,4,78,1,1,1,0,0,0,1,0,0,0,0,0,0,0,0,0,0,0,0,2,1,1,0
18030,4,78,14,10,10,0,0,4,14,1,1,1,1,2,2,0,2,0,1,0,0,2,1,1,0
18031,4,78,46,26,30,3,0,12,49,3,6,3,6,9,9,20,28,1,42,2,0,2,1,1,0
18032,205,4464,72,33,56,0,4,12,72,1,1,1,1,2,2,0,2,0,1,0,0,2,2,2,0
18033,205,4464,1454,835,1044,76,110,219,1530,17,275,158,296,292,454,2297,3718,9,34017,1889,1,2,2,2,0
18034,6,287,42,7,35,4,0,5,46,1,2,1,2,3,3,2,4,0,2,0,0,2,1,1,0
18035,6,287,11,6,10,0,0,1,11,2,4,2,4,6,6,10,15,1,15,0,0,2,1,1,0
18036,35,1628,1289,550,1043,56,32,155,1345,10,167,93,185,177,278,1266,2075,5,11498,638,0,2,1,0,0
18037,18,598,1455,414,1257,16,76,112,1471,5,41,23,46,46,69,231,381,2,1069,59,0,2,2,1,1
18038,18,598,669,365,481,22,61,110,691,15,103,63,122,118,185,747,1273,8,11311,628,0,2,2,1,1
18039,10,415,1455,414,1257,16,76,112,1471,5,41,23,46,46,69,231,381,2,1069,59,0,2,3,3,1
18040,17,561,1455,414,1257,16,76,112,1471,5,41,23,46,46,69,231,381,2,1069,59,0,2,2,7,1
18041,17,561,669,365,481,22,61,110,691,15,103,63,122,118,185,747,1273,8,11311,628,0,2,2,7,1
18042,131,3044,373,158,315,8,0,51,381,5,76,44,79,81,123,486,779,2,2026,112,0,2,2,3,1
18043,38,1713,1289,550,1043,56,32,155,1345,10,167,93,185,177,278,1266,2075,5,11498,638,0,2,19,0,1
18044,41,2867,1296,573,1062,40,33,157,1336,8,201,118,231,209,349,1561,2689,4,12365,686,0,2,40,4,1
18047,38,1703,1289,550,1043,56,32,155,1345,10,167,93,185,177,278,1266,2075,5,11498,638,0,2,6,6,1
18048,32,534,127,75,83,2,11,30,129,4,14,7,14,18,21,61,87,2,175,9,0,2,2,2,1
18049,32,534,652,304,544,16,6,88,668,6,89,51,101,95,152,591,998,3,3399,188,0,2,2,2,1
18050,32,534,2,2,2,0,0,0,2,0,0,0,0,0,0,0,0,0,0,0,0,2,2,2,1
18051,32,534,8,5,5,0,0,3,8,0,0,0,0,0,0,0,0,0,0,0,0,2,2,2,1
18054,32,534,14,8,8,0,0,6,14,0,0,0,0,0,0,0,0,0,0,0,0,2,2,2,1
18055,32,534,6,4,4,0,0,2,6,0,0,0,0,0,0,0,0,0,0,0,0,2,2,2,1
18056,32,534,6,4,4,0,0,2,6,1,2,1,2,3,3,2,4,0,2,0,0,2,2,2,1
18058,32,534,7,5,5,0,0,2,7,0,0,0,0,0,0,0,0,0,0,0,0,2,2,2,1
18060,32,534,10,6,6,0,0,4,10,0,0,0,0,0,0,0,0,0,0,0,0,2,2,2,1
18061,32,534,1,1,1,0,0,0,1,0,0,0,0,0,0,0,0,0,0,0,0,2,2,2,1
18063,32,534,14,10,10,0,0,4,14,1,1,1,1,2,2,0,2,0,1,0,0,2,2,2,1
18064,32,534,46,26,30,3,0,12,49,3,6,3,6,9,9,20,28,1,42,2,0,2,2,2,1
18065,26,918,1450,624,1228,12,26,181,1462,14,306,186,354,320,540,2580,4493,8,36391,2021,1,2,2,2,1
18066,34,1366,1513,682,1277,25,13,200,1538,11,199,116,219,210,335,1557,2584,6,15641,868,0,2,9,9,1
18067,41,2863,1296,573,1062,40,33,157,1336,8,201,118,231,209,349,1561,2689,4,12365,686,0,2,2,2,1
18068,26,1575,1457,730,1242,11,6,188,1468,10,292,166,329,302,495,2424,4078,5,22973,1276,1,2,10,10,1
18069,26,1350,652,304,544,16,6,88,668,6,89,51,101,95,152,591,998,3,3399,188,0,2,6,6,1
18070,10,417,1455,414,1257,16,76,112,1471,5,41,23,46,46,69,231,381,2,1069,59,0,2,2,2,1
18071,7,222,74,35,59,1,0,14,75,3,14,7,14,17,21,58,85,1,128,7,0,2,2,2,1
18072,19,1390,1523,757,1297,19,12,193,1542,12,193,117,230,205,347,1508,2664,7,19053,1058,0,2,9,9,1
18073,31,1237,1020,354,843,12,15,144,1032,8,134,77,144,142,221,970,1580,4,6792,377,0,2,26,27,1
18074,12,810,447,308,343,6,5,95,453,7,96,59,111,103,170,651,1136,4,4600,255,0,2,5,5,1
18075,9,312,424,94,331,4,0,89,428,1,5,5,5,6,10,11,25,0,12,0,0,2,1,1,1
18076,17,769,334,251,279,10,4,40,344,5,127,74,143,132,217,899,1528,2,4303,239,0,2,4,4,1
18077,5,238,184,100,137,2,15,30,186,6,38,20,39,44,59,214,322,3,991,55,0,2,4,4,1
18078,15,596,1293,570,1093,25,15,163,1318,10,195,123,241,205,364,1516,2795,6,17273,959,0,2,16,16,1
18079,10,494,722,423,573,19,0,135,741,12,172,101,199,184,300,1320,2257,6,15668,870,0,2,6,5,1
18080,12,412,386,256,301,16,9,68,402,4,59,35,69,63,104,355,621,2,1453,80,0,2,4,4,1
18081,13,1144,215,129,180,6,0,29,221,8,65,43,72,73,115,415,711,4,3153,175,0,2,11,10,1
18082,37,1475,1043,504,840,53,9,147,1096,9,180,112,198,189,310,1377,2344,4,11604,644,0,2,19,19,1
18083,10,333,295,56,236,0,4,54,295,2,9,5,10,11,15,30,51,1,57,3,0,2,4,4,1
18084,23,990,373,158,315,8,0,51,381,5,76,44,79,81,123,486,779,2,2026,112,0,2,9,9,1
18085,28,1368,1178,367,1042,6,15,115,1184,9,94,51,95,103,146,644,976,4,4439,246,0,2,60,60,1
18086,51,2556,1943,715,1694,26,18,214,1969,12,185,120,237,197,357,1436,2721,7,20915,1161,0,2,13,13,1
18087,2,137,442,244,305,14,16,103,456,11,68,45,75,79,120,452,756,6,4588,254,0,2,1,1,1
18088,7,249,1098,241,925,5,10,155,1103,7,46,25,49,53,74,273,423,3,1580,87,0,2,4,4,1
18089,17,579,1455,414,1257,16,76,112,1471,5,41,23,46,46,69,231,381,2,1069,59,0,2,7,3,1
18090,17,579,669,365,481,22,61,110,691,15,103,63,122,118,185,747,1273,8,11311,628,0,2,7,3,1
18091,17,277,424,94,331,4,0,89,428,1,5,5,5,6,10,11,25,0,12,0,0,2,1,1,1
18092,17,277,38,23,23,6,0,8,44,3,11,7,11,14,18,42,68,1,102,5,0,2,1,1,1
18093,205,4464,72,33,56,0,4,12,72,1,1,1,1,2,2,0,2,0,1,0,0,2,22,13,1
18094,205,4464,1454,835,1044,76,110,219,1530,17,275,158,296,292,454,2297,3718,9,34017,1889,1,2,22,13,1
18095,18,462,386,256,301,16,9,68,402,4,59,35,69,63,104,355,621,2,1453,80,0,2,2,2,1
18096,18,462,264,131,164,11,41,46,275,6,38,22,40,44,62,214,338,3,1068,59,0,2,2,2,1
18097,131,3070,373,158,315,8,0,51,381,5,76,44,79,81,123,486,779,2,2026,112,0,2,4,2,1
18121,38,1703,1289,550,1043,56,32,155,1345,10,167,93,185,177,278,1266,2075,5,11498,638,0,2,3,4,1
18122,41,2878,1296,573,1062,40,33,157,1336,8,201,118,231,209,349,1561,2689,4,12365,686,0,2,4,4,1
18123,32,1257,1020,354,843,12,15,144,1032,8,134,77,144,142,221,970,1580,4,6792,377,0,2,4,0,1
18125,18,604,1455,414,1257,16,76,112,1471,5,41,23,46,46,69,231,381,2,1069,59,0,2,4,1,0
18126,18,604,669,365,481,22,61,110,691,15,103,63,122,118,185,747,1273,8,11311,628,0,2,4,1,0
18127,1,185,382,65,130,157,2,92,539,4,10,5,10,14,15,41,57,2,114,6,0,2,3,1,0
18128,207,4492,72,33,56,0,4,12,72,1,1,1,1,2,2,0,2,0,1,0,0,2,9,4,1
18129,207,4492,1454,835,1044,76,110,219,1530,17,275,158,296,292,454,2297,3718,9,34017,1889,1,2,9,4,1
18132,46,795,1020,354,843,12,15,144,1032,8,134,77,144,142,221,970,1580,4,6792,377,0,2,8,8,1
18133,35,1360,1020,354,843,12,15,144,1032,8,134,77,144,142,221,970,1580,4,6792,377,0,2,16,1,1
18153,1,84,13,10,10,0,0,3,13,1,2,1,2,3,3,2,4,0,2,0,0,3,1,0,1
18155,3,71,127,75,83,2,11,30,129,4,14,7,14,18,21,61,87,2,175,9,0,3,1,0,1
18156,3,71,652,304,544,16,6,88,668,6,89,51,101,95,152,591,998,3,3399,188,0,3,1,0,1
18157,3,71,2,2,2,0,0,0,2,0,0,0,0,0,0,0,0,0,0,0,0,3,1,0,1
18158,3,71,8,5,5,0,0,3,8,0,0,0,0,0,0,0,0,0,0,0,0,3,1,0,1
18161,3,71,14,8,8,0,0,6,14,0,0,0,0,0,0,0,0,0,0,0,0,3,1,0,1
18162,3,71,6,4,4,0,0,2,6,0,0,0,0,0,0,0,0,0,0,0,0,3,1,0,1
18163,3,71,6,4,4,0,0,2,6,1,2,1,2,3,3,2,4,0,2,0,0,3,1,0,1
18165,3,71,7,5,5,0,0,2,7,0,0,0,0,0,0,0,0,0,0,0,0,3,1,0,1
18167,3,71,10,6,6,0,0,4,10,0,0,0,0,0,0,0,0,0,0,0,0,3,1,0,1
18168,3,71,1,1,1,0,0,0,1,0,0,0,0,0,0,0,0,0,0,0,0,3,1,0,1
18170,3,71,14,10,10,0,0,4,14,1,1,1,1,2,2,0,2,0,1,0,0,3,1,0,1
18171,3,71,46,26,30,3,0,12,49,3,6,3,6,9,9,20,28,1,42,2,0,3,1,0,1
18218,13,380,72,33,56,0,4,12,72,1,1,1,1,2,2,0,2,0,1,0,0,3,1,3,1
18220,5,69,38,23,23,0,0,15,38,0,0,0,0,0,0,0,0,0,0,0,0,0,21,0,1
18336,134,2593,1457,730,1242,11,6,188,1468,10,292,166,329,302,495,2424,4078,5,22973,1276,1,2,1,26,1
18337,134,2593,74,35,59,1,0,14,75,3,14,7,14,17,21,58,85,1,128,7,0,2,1,26,1
18338,134,2593,245,125,200,5,7,34,250,7,30,17,34,37,51,166,265,3,1053,58,0,2,1,26,1
18339,178,4184,722,423,573,19,0,135,741,12,172,101,199,184,300,1320,2257,6,15668,870,0,2,9,3,1
18340,178,4184,1508,847,911,44,250,301,1552,14,148,88,169,162,257,1120,1886,7,15077,837,0,2,9,3,1
18341,12,359,442,244,305,14,16,103,456,11,68,45,75,79,120,452,756,6,4588,254,0,2,53,8,1
18342,12,359,182,102,99,11,40,35,193,3,11,6,11,14,17,42,64,1,97,5,0,2,53,8,1
18343,37,1648,1289,550,1043,56,32,155,1345,10,167,93,185,177,278,1266,2075,5,11498,638,0,2,0,10,1
18344,22,1351,1457,730,1242,11,6,188,1468,10,292,166,329,302,495,2424,4078,5,22973,1276,1,2,0,27,1
18345,7,476,442,244,305,14,16,103,456,11,68,45,75,79,120,452,756,6,4588,254,0,2,49,1,1
18346,65,1200,1513,682,1277,25,13,200,1538,11,199,116,219,210,335,1557,2584,6,15641,868,0,2,5,1,1
18347,65,1200,819,519,539,24,98,155,843,15,96,57,106,111,163,690,1107,8,9171,509,0,2,5,1,1
18348,20,489,1293,570,1093,25,15,163,1318,10,195,123,241,205,364,1516,2795,6,17273,959,0,2,4,2,1
18349,207,4492,72,33,56,0,4,12,72,1,1,1,1,2,2,0,2,0,1,0,0,2,2,2,1
18350,207,4492,1454,835,1044,76,110,219,1530,17,275,158,296,292,454,2297,3718,9,34017,1889,1,2,2,2,1
18353,35,1408,1513,682,1277,25,13,200,1538,11,199,116,219,210,335,1557,2584,6,15641,868,0,2,10,0,1
18354,133,2586,1457,730,1242,11,6,188,1468,10,292,166,329,302,495,2424,4078,5,22973,1276,1,2,7,8,1
18355,133,2586,74,35,59,1,0,14,75,3,14,7,14,17,21,58,85,1,128,7,0,2,7,8,1
18356,133,2586,245,125,200,5,7,34,250,7,30,17,34,37,51,166,265,3,1053,58,0,2,7,8,1
18357,44,421,647,139,84,35,284,233,682,0,0,0,0,0,0,0,0,0,0,0,0,2,0,3,1
18358,148,2800,1943,715,1694,26,18,214,1969,12,185,120,237,197,357,1436,2721,7,20915,1161,0,2,44,10,1
18359,148,2800,1168,838,957,57,25,144,1225,19,348,224,416,367,640,3018,5452,11,61921,3440,1,2,44,10,1
18360,4,77,127,75,83,2,11,30,129,4,14,7,14,18,21,61,87,2,175,9,0,2,1,1,1
18361,4,77,652,304,544,16,6,88,668,6,89,51,101,95,152,591,998,3,3399,188,0,2,1,1,1
18362,4,77,2,2,2,0,0,0,2,0,0,0,0,0,0,0,0,0,0,0,0,2,1,1,1
18363,4,77,8,5,5,0,0,3,8,0,0,0,0,0,0,0,0,0,0,0,0,2,1,1,1
18366,4,77,14,8,8,0,0,6,14,0,0,0,0,0,0,0,0,0,0,0,0,2,1,1,1
18367,4,77,6,4,4,0,0,2,6,0,0,0,0,0,0,0,0,0,0,0,0,2,1,1,1
18368,4,77,6,4,4,0,0,2,6,1,2,1,2,3,3,2,4,0,2,0,0,2,1,1,1
18370,4,77,7,5,5,0,0,2,7,0,0,0,0,0,0,0,0,0,0,0,0,2,1,1,1
18372,4,77,10,6,6,0,0,4,10,0,0,0,0,0,0,0,0,0,0,0,0,2,1,1,1
18373,4,77,1,1,1,0,0,0,1,0,0,0,0,0,0,0,0,0,0,0,0,2,1,1,1
18375,4,77,14,10,10,0,0,4,14,1,1,1,1,2,2,0,2,0,1,0,0,2,1,1,1
18376,4,77,46,26,30,3,0,12,49,3,6,3,6,9,9,20,28,1,42,2,0,2,1,1,1
18377,28,1364,1178,367,1042,6,15,115,1184,9,94,51,95,103,146,644,976,4,4439,246,0,2,0,2,1
18378,51,2554,1943,715,1694,26,18,214,1969,12,185,120,237,197,357,1436,2721,7,20915,1161,0,2,0,1,1
18379,178,4184,722,423,573,19,0,135,741,12,172,101,199,184,300,1320,2257,6,15668,870,0,2,1,1,0
18380,178,4184,1508,847,911,44,250,301,1552,14,148,88,169,162,257,1120,1886,7,15077,837,0,2,1,1,0
18381,179,4219,722,423,573,19,0,135,741,12,172,101,199,184,300,1320,2257,6,15668,870,0,2,4,1,1
18382,179,4219,1508,847,911,44,250,301,1552,14,148,88,169,162,257,1120,1886,7,15077,837,0,2,4,1,1
18383,10,498,722,423,573,19,0,135,741,12,172,101,199,184,300,1320,2257,6,15668,870,0,2,1,1,1
18384,209,4519,72,33,56,0,4,12,72,1,1,1,1,2,2,0,2,0,1,0,0,2,3,0,1
18385,209,4519,1454,835,1044,76,110,219,1530,17,275,158,296,292,454,2297,3718,9,34017,1889,1,2,3,0,1
18386,87,1925,1043,504,840,53,9,147,1096,9,180,112,198,189,310,1377,2344,4,11604,644,0,2,5,3,1
18387,87,1925,383,288,292,26,6,62,409,11,65,38,67,76,105,429,656,5,3719,206,0,2,5,3,1
18388,28,438,1098,241,925,5,10,155,1103,7,46,25,49,53,74,273,423,3,1580,87,0,2,34,2,1
18389,28,438,282,202,222,14,2,44,296,8,42,24,43,50,67,250,378,4,1548,86,0,2,34,2,1
18390,38,1504,1043,504,840,53,9,147,1096,9,180,112,198,189,310,1377,2344,4,11604,644,0,2,11,0,1
18391,10,396,1098,241,925,5,10,155,1103,7,46,25,49,53,74,273,423,3,1580,87,0,2,62,0,1
18392,19,477,1293,570,1093,25,15,163,1318,10,195,123,241,205,364,1516,2795,6,17273,959,0,2,1,4,1
18393,87,1925,1043,504,840,53,9,147,1096,9,180,112,198,189,310,1377,2344,4,11604,644,0,2,3,1,1
18394,87,1925,383,288,292,26,6,62,409,11,65,38,67,76,105,429,656,5,3719,206,0,2,3,1,1
18395,151,2856,1943,715,1694,26,18,214,1969,12,185,120,237,197,357,1436,2721,7,20915,1161,0,2,16,5,1
18396,151,2856,1168,838,957,57,25,144,1225,19,348,224,416,367,640,3018,5452,11,61921,3440,1,2,16,5,1
18399,16,635,1293,570,1093,25,15,163,1318,10,195,123,241,205,364,1516,2795,6,17273,959,0,2,8,0,1
18400,6,287,42,7,35,4,0,5,46,1,2,1,2,3,3,2,4,0,2,0,0,2,3,3,1
18401,6,287,11,6,10,0,0,1,11,2,4,2,4,6,6,10,15,1,15,0,0,2,3,3,1
18402,6,287,42,7,35,4,0,5,46,1,2,1,2,3,3,2,4,0,2,0,0,2,2,2,1
18403,6,287,11,6,10,0,0,1,11,2,4,2,4,6,6,10,15,1,15,0,0,2,2,2,1
18404,1,192,382,65,130,157,2,92,539,4,10,5,10,14,15,41,57,2,114,6,0,2,1,0,1
18405,28,458,1098,241,925,5,10,155,1103,7,46,25,49,53,74,273,423,3,1580,87,0,2,2,0,1
18406,28,458,282,202,222,14,2,44,296,8,42,24,43,50,67,250,378,4,1548,86,0,2,2,0,1
18409,11,426,1098,241,925,5,10,155,1103,7,46,25,49,53,74,273,423,3,1580,87,0,2,21,1,1
18410,37,1034,1523,757,1297,19,12,193,1542,12,193,117,230,205,347,1508,2664,7,19053,1058,0,2,1,2,1
18411,37,1034,701,378,504,33,58,109,734,13,110,68,126,123,194,794,1346,7,10027,557,0,2,1,2,1
18412,181,4234,722,423,573,19,0,135,741,12,172,101,199,184,300,1320,2257,6,15668,870,0,2,10,4,1
18413,181,4234,1508,847,911,44,250,301,1552,14,148,88,169,162,257,1120,1886,7,15077,837,0,2,10,4,1
18416,19,478,1293,570,1093,25,15,163,1318,10,195,123,241,205,364,1516,2795,6,17273,959,0,2,2,2,1
18417,36,627,1098,241,925,5,10,155,1103,7,46,25,49,53,74,273,423,3,1580,87,0,2,31,4,1
18418,36,627,282,202,222,14,2,44,296,8,42,24,43,50,67,250,378,4,1548,86,0,2,31,4,1
18421,15,570,1098,241,925,5,10,155,1103,7,46,25,49,53,74,273,423,3,1580,87,0,2,104,0,1
18422,37,640,1098,241,925,5,10,155,1103,7,46,25,49,53,74,273,423,3,1580,87,0,2,4,2,1
18423,37,640,282,202,222,14,2,44,296,8,42,24,43,50,67,250,378,4,1548,86,0,2,4,2,1
18424,16,591,1098,241,925,5,10,155,1103,7,46,25,49,53,74,273,423,3,1580,87,0,2,32,0,1
18425,16,591,1098,241,925,5,10,155,1103,7,46,25,49,53,74,273,423,3,1580,87,0,2,11,5,0
18426,38,659,1098,241,925,5,10,155,1103,7,46,25,49,53,74,273,423,3,1580,87,0,2,5,5,1
18427,38,659,282,202,222,14,2,44,296,8,42,24,43,50,67,250,378,4,1548,86,0,2,5,5,1
18428,18,710,1098,241,925,5,10,155,1103,7,46,25,49,53,74,273,423,3,1580,87,0,2,43,3,1
18429,183,4253,722,423,573,19,0,135,741,12,172,101,199,184,300,1320,2257,6,15668,870,0,2,3,1,1
18430,183,4253,1508,847,911,44,250,301,1552,14,148,88,169,162,257,1120,1886,7,15077,837,0,2,3,1,1
18431,39,708,1098,241,925,5,10,155,1103,7,46,25,49,53,74,273,423,3,1580,87,0,2,11,5,1
18432,39,708,282,202,222,14,2,44,296,8,42,24,43,50,67,250,378,4,1548,86,0,2,11,5,1
18435,19,732,1098,241,925,5,10,155,1103,7,46,25,49,53,74,273,423,3,1580,87,0,2,60,54,1
18436,209,4519,72,33,56,0,4,12,72,1,1,1,1,2,2,0,2,0,1,0,0,2,3,3,1
18437,209,4519,1454,835,1044,76,110,219,1530,17,275,158,296,292,454,2297,3718,9,34017,1889,1,2,3,3,1
18438,38,1518,1043,504,840,53,9,147,1096,9,180,112,198,189,310,1377,2344,4,11604,644,0,2,5,1,1
18439,135,2629,1457,730,1242,11,6,188,1468,10,292,166,329,302,495,2424,4078,5,22973,1276,1,2,8,0,1
18440,135,2629,74,35,59,1,0,14,75,3,14,7,14,17,21,58,85,1,128,7,0,2,8,0,1
18441,135,2629,245,125,200,5,7,34,250,7,30,17,34,37,51,166,265,3,1053,58,0,2,8,0,1
18442,213,4623,72,33,56,0,4,12,72,1,1,1,1,2,2,0,2,0,1,0,0,2,21,4,1
18443,213,4623,1454,835,1044,76,110,219,1530,17,275,158,296,292,454,2297,3718,9,34017,1889,1,2,21,4,1
18444,210,4583,72,33,56,0,4,12,72,1,1,1,1,2,2,0,2,0,1,0,0,2,8,15,1
18445,210,4583,1454,835,1044,76,110,219,1530,17,275,158,296,292,454,2297,3718,9,34017,1889,1,2,8,15,1
18446,132,3087,373,158,315,8,0,51,381,5,76,44,79,81,123,486,779,2,2026,112,0,2,3,0,1
18447,212,4586,72,33,56,0,4,12,72,1,1,1,1,2,2,0,2,0,1,0,0,2,1,1,0
18448,212,4586,1454,835,1044,76,110,219,1530,17,275,158,296,292,454,2297,3718,9,34017,1889,1,2,1,1,0
18466,34,863,74,35,59,1,0,14,75,3,14,7,14,17,21,58,85,1,128,7,0,2,2,1,1
18467,34,863,245,125,200,5,7,34,250,7,30,17,34,37,51,166,265,3,1053,58,0,2,2,1,1
18468,212,4586,72,33,56,0,4,12,72,1,1,1,1,2,2,0,2,0,1,0,0,2,22,21,1
18469,212,4586,1454,835,1044,76,110,219,1530,17,275,158,296,292,454,2297,3718,9,34017,1889,1,2,22,21,1
18470,1,192,382,65,130,157,2,92,539,4,10,5,10,14,15,41,57,2,114,6,0,2,2,0,1
18471,52,901,282,196,195,3,0,86,285,8,130,71,141,138,212,936,1507,4,6538,363,0,2,85,81,1
18474,46,860,1098,241,925,5,10,155,1103,7,46,25,49,53,74,273,423,3,1580,87,0,2,18,0,1
18475,46,860,282,202,222,14,2,44,296,8,42,24,43,50,67,250,378,4,1548,86,0,2,18,0,1
18476,19,752,1098,241,925,5,10,155,1103,7,46,25,49,53,74,273,423,3,1580,87,0,2,26,3,1
18479,152,2888,1943,715,1694,26,18,214,1969,12,185,120,237,197,357,1436,2721,7,20915,1161,0,2,3,0,1
18480,152,2888,1168,838,957,57,25,144,1225,19,348,224,416,367,640,3018,5452,11,61921,3440,1,2,3,0,1
18483,35,1417,1513,682,1277,25,13,200,1538,11,199,116,219,210,335,1557,2584,6,15641,868,0,2,1,0,1
18484,6,287,42,7,35,4,0,5,46,1,2,1,2,3,3,2,4,0,2,0,0,2,2,2,0
18485,6,287,11,6,10,0,0,1,11,2,4,2,4,6,6,10,15,1,15,0,0,2,2,2,0
18486,153,2910,1943,715,1694,26,18,214,1969,12,185,120,237,197,357,1436,2721,7,20915,1161,0,2,4,1,1
18487,153,2910,1168,838,957,57,25,144,1225,19,348,224,416,367,640,3018,5452,11,61921,3440,1,2,4,1,1
18488,1,192,382,65,130,157,2,92,539,4,10,5,10,14,15,41,57,2,114,6,0,2,1,1,1
18491,185,4279,722,423,573,19,0,135,741,12,172,101,199,184,300,1320,2257,6,15668,870,0,2,2,0,0
18492,185,4279,1508,847,911,44,250,301,1552,14,148,88,169,162,257,1120,1886,7,15077,837,0,2,2,0,0
18493,135,2629,1457,730,1242,11,6,188,1468,10,292,166,329,302,495,2424,4078,5,22973,1276,1,2,1,1,1
18494,135,2629,74,35,59,1,0,14,75,3,14,7,14,17,21,58,85,1,128,7,0,2,1,1,1
18495,135,2629,245,125,200,5,7,34,250,7,30,17,34,37,51,166,265,3,1053,58,0,2,1,1,1
18496,35,881,74,35,59,1,0,14,75,3,14,7,14,17,21,58,85,1,128,7,0,2,5,1,1
18497,35,881,245,125,200,5,7,34,250,7,30,17,34,37,51,166,265,3,1053,58,0,2,5,1,1
18498,132,3088,77,34,69,0,0,8,77,3,24,16,29,27,45,114,213,1,387,21,0,3,2,2,1
18499,132,3088,712,438,573,51,9,84,763,14,102,71,128,116,199,733,1364,8,11988,666,0,3,2,2,1
18500,185,4279,722,423,573,19,0,135,741,12,172,101,199,184,300,1320,2257,6,15668,870,0,2,1,1,1
18501,185,4279,1508,847,911,44,250,301,1552,14,148,88,169,162,257,1120,1886,7,15077,837,0,2,1,1,1
18502,212,4586,72,33,56,0,4,12,72,1,1,1,1,2,2,0,2,0,1,0,0,2,1,1,1
18503,212,4586,1454,835,1044,76,110,219,1530,17,275,158,296,292,454,2297,3718,9,34017,1889,1,2,1,1,1
18504,26,562,215,129,180,6,0,29,221,8,65,43,72,73,115,415,711,4,3153,175,0,2,6,6,1
18505,26,562,97,69,77,3,3,16,100,6,22,13,23,28,36,113,173,3,542,30,0,2,6,6,1
18506,37,1648,1289,550,1043,56,32,155,1345,10,167,93,185,177,278,1266,2075,5,11498,638,0,2,1,1,1
18507,41,2878,1296,573,1062,40,33,157,1336,8,201,118,231,209,349,1561,2689,4,12365,686,0,2,1,1,1
18508,25,1439,1457,730,1242,11,6,188,1468,10,292,166,329,302,495,2424,4078,5,22973,1276,1,2,14,1,1
18509,13,1144,215,129,180,6,0,29,221,8,65,43,72,73,115,415,711,4,3153,175,0,2,2,2,1
18510,23,990,373,158,315,8,0,51,381,5,76,44,79,81,123,486,779,2,2026,112,0,2,2,2,1
18511,65,1200,1513,682,1277,25,13,200,1538,11,199,116,219,210,335,1557,2584,6,15641,868,0,2,3,1,1
18512,65,1200,819,519,539,24,98,155,843,15,96,57,106,111,163,690,1107,8,9171,509,0,2,3,1,1
18513,36,1475,1513,682,1277,25,13,200,1538,11,199,116,219,210,335,1557,2584,6,15641,868,0,2,20,0,1
18514,71,1174,1178,367,1042,6,15,115,1184,9,94,51,95,103,146,644,976,4,4439,246,0,2,12,12,1
18515,71,1174,177,108,140,8,0,27,185,6,30,16,32,36,48,162,248,3,794,44,0,2,12,12,1
18516,30,1431,1178,367,1042,6,15,115,1184,9,94,51,95,103,146,644,976,4,4439,246,0,2,31,0,1
18517,18,611,1455,414,1257,16,76,112,1471,5,41,23,46,46,69,231,381,2,1069,59,0,2,11,6,1
18518,18,611,669,365,481,22,61,110,691,15,103,63,122,118,185,747,1273,8,11311,628,0,2,11,6,1
18519,10,414,1455,414,1257,16,76,112,1471,5,41,23,46,46,69,231,381,2,1069,59,0,2,8,11,1
18522,136,2646,1457,730,1242,11,6,188,1468,10,292,166,329,302,495,2424,4078,5,22973,1276,1,2,2,0,1
18523,136,2646,74,35,59,1,0,14,75,3,14,7,14,17,21,58,85,1,128,7,0,2,2,0,1
18524,136,2646,245,125,200,5,7,34,250,7,30,17,34,37,51,166,265,3,1053,58,0,2,2,0,1
18525,45,430,647,139,84,35,284,233,682,0,0,0,0,0,0,0,0,0,0,0,0,2,3,1,1
18526,26,1471,1457,730,1242,11,6,188,1468,10,292,166,329,302,495,2424,4078,5,22973,1276,1,2,11,1,1
18527,136,2649,1457,730,1242,11,6,188,1468,10,292,166,329,302,495,2424,4078,5,22973,1276,1,2,3,1,0
18528,136,2649,74,35,59,1,0,14,75,3,14,7,14,17,21,58,85,1,128,7,0,2,3,1,0
18529,136,2649,245,125,200,5,7,34,250,7,30,17,34,37,51,166,265,3,1053,58,0,2,3,1,0
18532,28,1508,1457,730,1242,11,6,188,1468,10,292,166,329,302,495,2424,4078,5,22973,1276,1,2,9,2,0
18533,136,2649,1457,730,1242,11,6,188,1468,10,292,166,329,302,495,2424,4078,5,22973,1276,1,2,1,1,1
18534,136,2649,74,35,59,1,0,14,75,3,14,7,14,17,21,58,85,1,128,7,0,2,1,1,1
18535,136,2649,245,125,200,5,7,34,250,7,30,17,34,37,51,166,265,3,1053,58,0,2,1,1,1
18539,28,1508,1457,730,1242,11,6,188,1468,10,292,166,329,302,495,2424,4078,5,22973,1276,1,2,1,1,1
18540,43,862,1450,624,1228,12,26,181,1462,14,306,186,354,320,540,2580,4493,8,36391,2021,1,2,3,4,1
18541,40,1688,1289,550,1043,56,32,155,1345,10,167,93,185,177,278,1266,2075,5,11498,638,0,2,6,0,1
18542,27,999,1450,624,1228,12,26,181,1462,14,306,186,354,320,540,2580,4493,8,36391,2021,1,2,11,0,1
18543,47,952,1450,624,1228,12,26,181,1462,14,306,186,354,320,540,2580,4493,8,36391,2021,1,2,14,2,1
18544,56,977,282,196,195,3,0,86,285,8,130,71,141,138,212,936,1507,4,6538,363,0,2,16,0,1
18545,28,1028,1450,624,1228,12,26,181,1462,14,306,186,354,320,540,2580,4493,8,36391,2021,1,2,5,0,1
18546,1,84,13,10,10,0,0,3,13,1,2,1,2,3,3,2,4,0,2,0,0,2,1,1,1
18547,135,2612,1457,730,1242,11,6,188,1468,10,292,166,329,302,495,2424,4078,5,22973,1276,1,2,1,9,1
18548,135,2612,74,35,59,1,0,14,75,3,14,7,14,17,21,58,85,1,128,7,0,2,1,9,1
18549,135,2612,245,125,200,5,7,34,250,7,30,17,34,37,51,166,265,3,1053,58,0,2,1,9,1
18550,25,1227,652,304,544,16,6,88,668,6,89,51,101,95,152,591,998,3,3399,188,0,2,0,15,1
18553,9,312,424,94,331,4,0,89,428,1,5,5,5,6,10,11,25,0,12,0,0,2,21,18,1
18556,28,1028,1450,624,1228,12,26,181,1462,14,306,186,354,320,540,2580,4493,8,36391,2021,1,2,1,1,0
18557,41,991,74,35,59,1,0,14,75,3,14,7,14,17,21,58,85,1,128,7,0,2,19,0,1
18558,41,991,245,125,200,5,7,34,250,7,30,17,34,37,51,166,265,3,1053,58,0,2,19,0,1
18561,28,1512,1457,730,1242,11,6,188,1468,10,292,166,329,302,495,2424,4078,5,22973,1276,1,2,2,0,1
18562,9,271,74,35,59,1,0,14,75,3,14,7,14,17,21,58,85,1,128,7,0,2,12,1,1
18563,213,4608,72,33,56,0,4,12,72,1,1,1,1,2,2,0,2,0,1,0,0,2,5,2,1
18564,213,4608,1454,835,1044,76,110,219,1530,17,275,158,296,292,454,2297,3718,9,34017,1889,1,2,5,2,1
18565,132,3094,77,34,69,0,0,8,77,3,24,16,29,27,45,114,213,1,387,21,0,2,1,0,1
18566,132,3094,712,438,573,51,9,84,763,14,102,71,128,116,199,733,1364,8,11988,666,0,2,1,0,1
18567,213,4618,72,33,56,0,4,12,72,1,1,1,1,2,2,0,2,0,1,0,0,2,14,13,1
18568,213,4618,1454,835,1044,76,110,219,1530,17,275,158,296,292,454,2297,3718,9,34017,1889,1,2,14,13,1
18569,69,1220,1513,682,1277,25,13,200,1538,11,199,116,219,210,335,1557,2584,6,15641,868,0,2,9,3,1
18570,69,1220,819,519,539,24,98,155,843,15,96,57,106,111,163,690,1107,8,9171,509,0,2,9,3,1
18571,133,2620,1457,730,1242,11,6,188,1468,10,292,166,329,302,495,2424,4078,5,22973,1276,1,2,8,5,1
18572,133,2620,74,35,59,1,0,14,75,3,14,7,14,17,21,58,85,1,128,7,0,2,8,5,1
18573,133,2620,245,125,200,5,7,34,250,7,30,17,34,37,51,166,265,3,1053,58,0,2,8,5,1
18576,38,1602,1513,682,1277,25,13,200,1538,11,199,116,219,210,335,1557,2584,6,15641,868,0,2,34,0,1
18577,51,1024,1450,624,1228,12,26,181,1462,14,306,186,354,320,540,2580,4493,8,36391,2021,1,2,12,1,0
18578,28,1030,1450,624,1228,12,26,181,1462,14,306,186,354,320,540,2580,4493,8,36391,2021,1,2,1,2,0
18579,132,3097,77,34,69,0,0,8,77,3,24,16,29,27,45,114,213,1,387,21,0,2,1,1,1
18580,132,3097,712,438,573,51,9,84,763,14,102,71,128,116,199,733,1364,8,11988,666,0,2,1,1,1
18583,40,1725,1289,550,1043,56,32,155,1345,10,167,93,185,177,278,1266,2075,5,11498,638,0,2,6,0,1
18586,40,1725,1289,550,1043,56,32,155,1345,10,167,93,185,177,278,1266,2075,5,11498,638,0,2,1,1,1
18587,40,1725,1289,550,1043,56,32,155,1345,10,167,93,185,177,278,1266,2075,5,11498,638,0,2,1,1,0
18588,135,3145,77,34,69,0,0,8,77,3,24,16,29,27,45,114,213,1,387,21,0,2,6,0,1
18589,135,3145,712,438,573,51,9,84,763,14,102,71,128,116,199,733,1364,8,11988,666,0,2,6,0,1
18590,42,2947,1296,573,1062,40,33,157,1336,8,201,118,231,209,349,1561,2689,4,12365,686,0,2,15,0,1
18593,46,795,1020,354,843,12,15,144,1032,8,134,77,144,142,221,970,1580,4,6792,377,0,2,2,2,1
18594,213,4618,72,33,56,0,4,12,72,1,1,1,1,2,2,0,2,0,1,0,0,2,11,7,1
18595,213,4618,1454,835,1044,76,110,219,1530,17,275,158,296,292,454,2297,3718,9,34017,1889,1,2,11,7,1
18596,1,192,382,65,130,157,2,92,539,4,10,5,10,14,15,41,57,2,114,6,0,2,6,6,1
18597,51,1027,1450,624,1228,12,26,181,1462,14,306,186,354,320,540,2580,4493,8,36391,2021,1,2,2,2,1
18598,29,1054,1450,624,1228,12,26,181,1462,14,306,186,354,320,540,2580,4493,8,36391,2021,1,2,4,0,1
18599,153,2910,1943,715,1694,26,18,214,1969,12,185,120,237,197,357,1436,2721,7,20915,1161,0,2,1,1,0
18600,153,2910,1168,838,957,57,25,144,1225,19,348,224,416,367,640,3018,5452,11,61921,3440,1,2,1,1,0
18601,213,4618,72,33,56,0,4,12,72,1,1,1,1,2,2,0,2,0,1,0,0,2,4,5,1
18602,213,4618,1454,835,1044,76,110,219,1530,17,275,158,296,292,454,2297,3718,9,34017,1889,1,2,4,5,1
18605,77,1330,1178,367,1042,6,15,115,1184,9,94,51,95,103,146,644,976,4,4439,246,0,2,35,11,1
18606,77,1330,177,108,140,8,0,27,185,6,30,16,32,36,48,162,248,3,794,44,0,2,35,11,1
18609,31,1477,1178,367,1042,6,15,115,1184,9,94,51,95,103,146,644,976,4,4439,246,0,2,28,0,1
18610,79,1379,1178,367,1042,6,15,115,1184,9,94,51,95,103,146,644,976,4,4439,246,0,2,12,3,1
18611,79,1379,177,108,140,8,0,27,185,6,30,16,32,36,48,162,248,3,794,44,0,2,12,3,1
18612,6,81,38,23,23,0,0,15,38,0,0,0,0,0,0,0,0,0,0,0,0,2,4,0,1
18615,33,1542,1178,367,1042,6,15,115,1184,9,94,51,95,103,146,644,976,4,4439,246,0,2,30,0,1
18616,69,1220,1513,682,1277,25,13,200,1538,11,199,116,219,210,335,1557,2584,6,15641,868,0,2,6,8,1
18617,69,1220,819,519,539,24,98,155,843,15,96,57,106,111,163,690,1107,8,9171,509,0,2,6,8,1
18618,24,514,447,308,343,6,5,95,453,7,96,59,111,103,170,651,1136,4,4600,255,0,2,2,2,1
18619,24,514,322,174,179,16,74,51,338,10,41,26,46,51,72,252,408,5,2291,127,0,2,2,2,1
18620,18,462,386,256,301,16,9,68,402,4,59,35,69,63,104,355,621,2,1453,80,0,2,3,0,1
18621,18,462,264,131,164,11,41,46,275,6,38,22,40,44,62,214,338,3,1068,59,0,2,3,0,1
18622,12,359,442,244,305,14,16,103,456,11,68,45,75,79,120,452,756,6,4588,254,0,2,1,1,1
18623,12,359,182,102,99,11,40,35,193,3,11,6,11,14,17,42,64,1,97,5,0,2,1,1,1
18624,217,4664,72,33,56,0,4,12,72,1,1,1,1,2,2,0,2,0,1,0,0,2,15,6,1
18625,217,4664,1454,835,1044,76,110,219,1530,17,275,158,296,292,454,2297,3718,9,34017,1889,1,2,15,6,1
18628,137,3174,77,34,69,0,0,8,77,3,24,16,29,27,45,114,213,1,387,21,0,2,8,3,1
18629,137,3174,712,438,573,51,9,84,763,14,102,71,128,116,199,733,1364,8,11988,666,0,2,8,3,1
18630,217,4677,72,33,56,0,4,12,72,1,1,1,1,2,2,0,2,0,1,0,0,2,7,4,1
18631,217,4677,1454,835,1044,76,110,219,1530,17,275,158,296,292,454,2297,3718,9,34017,1889,1,2,7,4,1
18632,42,2917,1296,573,1062,40,33,157,1336,8,201,118,231,209,349,1561,2689,4,12365,686,0,2,0,5,1
18633,217,4674,72,33,56,0,4,12,72,1,1,1,1,2,2,0,2,0,1,0,0,2,1,1,0
18634,217,4674,1454,835,1044,76,110,219,1530,17,275,158,296,292,454,2297,3718,9,34017,1889,1,2,1,1,0
18635,33,1551,1178,367,1042,6,15,115,1184,9,94,51,95,103,146,644,976,4,4439,246,0,2,1,0,1
18636,47,903,1098,241,925,5,10,155,1103,7,46,25,49,53,74,273,423,3,1580,87,0,2,4,0,1
18637,47,903,282,202,222,14,2,44,296,8,42,24,43,50,67,250,378,4,1548,86,0,2,4,0,1
18638,20,782,1098,241,925,5,10,155,1103,7,46,25,49,53,74,273,423,3,1580,87,0,2,12,0,1
18641,217,4677,72,33,56,0,4,12,72,1,1,1,1,2,2,0,2,0,1,0,0,2,1,1,1
18642,217,4677,1454,835,1044,76,110,219,1530,17,275,158,296,292,454,2297,3718,9,34017,1889,1,2,1,1,1
18643,146,2815,1943,715,1694,26,18,214,1969,12,185,120,237,197,357,1436,2721,7,20915,1161,0,2,47,63,1
18644,146,2815,1168,838,957,57,25,144,1225,19,348,224,416,367,640,3018,5452,11,61921,3440,1,2,47,63,1
18647,40,1725,1289,550,1043,56,32,155,1345,10,167,93,185,177,278,1266,2075,5,11498,638,0,2,3,1,1
18648,43,2933,1296,573,1062,40,33,157,1336,8,201,118,231,209,349,1561,2689,4,12365,686,0,2,2,0,1
18649,51,2363,1943,715,1694,26,18,214,1969,12,185,120,237,197,357,1436,2721,7,20915,1161,0,2,28,47,1
18650,19,483,1293,570,1093,25,15,163,1318,10,195,123,241,205,364,1516,2795,6,17273,959,0,2,4,1,0
18653,38,958,74,35,59,1,0,14,75,3,14,7,14,17,21,58,85,1,128,7,0,2,3,8,1
18654,38,958,245,125,200,5,7,34,250,7,30,17,34,37,51,166,265,3,1053,58,0,2,3,8,1
18655,138,3212,77,34,69,0,0,8,77,3,24,16,29,27,45,114,213,1,387,21,0,2,7,1,1
18656,138,3212,712,438,573,51,9,84,763,14,102,71,128,116,199,733,1364,8,11988,666,0,2,7,1,1
18659,146,2822,1943,715,1694,26,18,214,1969,12,185,120,237,197,357,1436,2721,7,20915,1161,0,2,2,2,1
18660,146,2822,1168,838,957,57,25,144,1225,19,348,224,416,367,640,3018,5452,11,61921,3440,1,2,2,2,1
18661,52,2433,1943,715,1694,26,18,214,1969,12,185,120,237,197,357,1436,2721,7,20915,1161,0,2,16,1,1
18662,141,2820,1943,715,1694,26,18,214,1969,12,185,120,237,197,357,1436,2721,7,20915,1161,0,2,10,10,1
18663,141,2820,1168,838,957,57,25,144,1225,19,348,224,416,367,640,3018,5452,11,61921,3440,1,2,10,10,1
18666,87,1920,1043,504,840,53,9,147,1096,9,180,112,198,189,310,1377,2344,4,11604,644,0,2,1,1,0
18667,87,1920,383,288,292,26,6,62,409,11,65,38,67,76,105,429,656,5,3719,206,0,2,1,1,0
18672,215,4654,72,33,56,0,4,12,72,1,1,1,1,2,2,0,2,0,1,0,0,2,5,11,1
18673,215,4654,1454,835,1044,76,110,219,1530,17,275,158,296,292,454,2297,3718,9,34017,1889,1,2,5,11,1
18676,135,2677,1457,730,1242,11,6,188,1468,10,292,166,329,302,495,2424,4078,5,22973,1276,1,2,10,0,1
18677,135,2677,74,35,59,1,0,14,75,3,14,7,14,17,21,58,85,1,128,7,0,2,10,0,1
18678,135,2677,245,125,200,5,7,34,250,7,30,17,34,37,51,166,265,3,1053,58,0,2,10,0,1
18679,38,1068,1523,757,1297,19,12,193,1542,12,193,117,230,205,347,1508,2664,7,19053,1058,0,2,7,1,1
18680,38,1068,701,378,504,33,58,109,734,13,110,68,126,123,194,794,1346,7,10027,557,0,2,7,1,1
18683,20,1484,1523,757,1297,19,12,193,1542,12,193,117,230,205,347,1508,2664,7,19053,1058,0,2,20,0,1
18707,185,4301,722,423,573,19,0,135,741,12,172,101,199,184,300,1320,2257,6,15668,870,0,2,3,2,1
18708,185,4301,1508,847,911,44,250,301,1552,14,148,88,169,162,257,1120,1886,7,15077,837,0,2,3,2,1
18709,12,529,722,423,573,19,0,135,741,12,172,101,199,184,300,1320,2257,6,15668,870,0,2,10,0,1
18710,40,1244,1523,757,1297,19,12,193,1542,12,193,117,230,205,347,1508,2664,7,19053,1058,0,2,43,1,1
18711,40,1244,701,378,504,33,58,109,734,13,110,68,126,123,194,794,1346,7,10027,557,0,2,43,1,1
18712,28,1749,1523,757,1297,19,12,193,1542,12,193,117,230,205,347,1508,2664,7,19053,1058,0,2,68,0,1
18713,138,3216,77,34,69,0,0,8,77,3,24,16,29,27,45,114,213,1,387,21,0,2,1,1,1
18714,138,3216,712,438,573,51,9,84,763,14,102,71,128,116,199,733,1364,8,11988,666,0,2,1,1,1
18715,41,1799,1289,550,1043,56,32,155,1345,10,167,93,185,177,278,1266,2075,5,11498,638,0,2,20,0,1
18739,50,1020,1450,624,1228,12,26,181,1462,14,306,186,354,320,540,2580,4493,8,36391,2021,1,2,2,4,1
18740,137,2699,1457,730,1242,11,6,188,1468,10,292,166,329,302,495,2424,4078,5,22973,1276,1,2,6,1,1
18741,137,2699,74,35,59,1,0,14,75,3,14,7,14,17,21,58,85,1,128,7,0,2,6,1,1
18742,137,2699,245,125,200,5,7,34,250,7,30,17,34,37,51,166,265,3,1053,58,0,2,6,1,1
18743,11,351,442,244,305,14,16,103,456,11,68,45,75,79,120,452,756,6,4588,254,0,2,2,5,1
18744,11,351,182,102,99,11,40,35,193,3,11,6,11,14,17,42,64,1,97,5,0,2,2,5,1
18747,42,1842,1289,550,1043,56,32,155,1345,10,167,93,185,177,278,1266,2075,5,11498,638,0,2,13,0,1
18748,29,1058,1450,624,1228,12,26,181,1462,14,306,186,354,320,540,2580,4493,8,36391,2021,1,2,2,1,1
18797,1,162,382,65,130,157,2,92,539,4,10,5,10,14,15,41,57,2,114,6,0,2,1,1,0
18823,1,179,382,65,130,157,2,92,539,4,10,5,10,14,15,41,57,2,114,6,0,2,2,1,0
18826,46,437,647,139,84,35,284,233,682,0,0,0,0,0,0,0,0,0,0,0,0,2,3,0,0
18827,216,4677,72,33,56,0,4,12,72,1,1,1,1,2,2,0,2,0,1,0,0,2,13,8,0
18828,216,4677,1454,835,1044,76,110,219,1530,17,275,158,296,292,454,2297,3718,9,34017,1889,1,2,13,8,0
18854,57,2323,1660,832,1314,41,38,274,1701,20,312,209,395,332,604,2671,5058,12,64042,3557,1,0,295,0,1
18855,57,999,1660,832,1314,41,38,274,1701,20,312,209,395,332,604,2671,5058,12,64042,3557,1,0,195,0,1
18856,63,2372,1660,832,1314,41,38,274,1701,20,312,209,395,332,604,2671,5058,12,64042,3557,1,2,11,3,1
18857,62,1194,1660,832,1314,41,38,274,1701,20,312,209,395,332,604,2671,5058,12,64042,3557,1,2,26,2,1
18858,64,2382,1660,832,1314,41,38,274,1701,20,312,209,395,332,604,2671,5058,12,64042,3557,1,2,8,4,0
18859,63,2389,1660,832,1314,41,38,274,1701,20,312,209,395,332,604,2671,5058,12,64042,3557,1,2,8,5,0
18860,63,1225,1660,832,1314,41,38,274,1701,20,312,209,395,332,604,2671,5058,12,64042,3557,1,2,5,0,0
18861,63,2373,1660,832,1314,41,38,274,1701,20,312,209,395,332,604,2671,5058,12,64042,3557,1,2,0,2,0
18862,48,451,647,139,84,35,284,233,682,0,0,0,0,0,0,0,0,0,0,0,0,2,6,0,0
18863,217,4699,72,33,56,0,4,12,72,1,1,1,1,2,2,0,2,0,1,0,0,2,3,0,0
18864,217,4699,1454,835,1044,76,110,219,1530,17,275,158,296,292,454,2297,3718,9,34017,1889,1,2,3,0,0
18865,68,2438,1660,832,1314,41,38,274,1701,20,312,209,395,332,604,2671,5058,12,64042,3557,1,2,14,3,0
18866,60,1255,1450,624,1228,12,26,181,1462,14,306,186,354,320,540,2580,4493,8,36391,2021,1,2,56,0,0
18867,68,2414,1660,832,1314,41,38,274,1701,20,312,209,395,332,604,2671,5058,12,64042,3557,1,2,1,2,0
18868,69,2432,1660,832,1314,41,38,274,1701,20,312,209,395,332,604,2671,5058,12,64042,3557,1,2,4,1,0
18869,63,1270,1660,832,1314,41,38,274,1701,20,312,209,395,332,604,2671,5058,12,64042,3557,1,2,9,6,0
18870,69,2456,1660,832,1314,41,38,274,1701,20,312,209,395,332,604,2671,5058,12,64042,3557,1,2,5,2,1
18871,63,1306,1660,832,1314,41,38,274,1701,20,312,209,395,332,604,2671,5058,12,64042,3557,1,2,6,0,1
18872,69,2456,1660,832,1314,41,38,274,1701,20,312,209,395,332,604,2671,5058,12,64042,3557,1,2,2,2,0
18873,70,2461,1660,832,1314,41,38,274,1701,20,312,209,395,332,604,2671,5058,12,64042,3557,1,2,5,1,1
18874,64,1371,1660,832,1314,41,38,274,1701,20,312,209,395,332,604,2671,5058,12,64042,3557,1,2,8,0,1
18875,61,1266,1450,624,1228,12,26,181,1462,14,306,186,354,320,540,2580,4493,8,36391,2021,1,2,18,15,1
18876,30,1106,1450,624,1228,12,26,181,1462,14,306,186,354,320,540,2580,4493,8,36391,2021,1,2,7,0,0
18877,71,2472,1660,832,1314,41,38,274,1701,20,312,209,395,332,604,2671,5058,12,64042,3557,1,2,5,1,0
18878,70,1443,1660,832,1314,41,38,274,1701,20,312,209,395,332,604,2671,5058,12,64042,3557,1,2,14,0,0
18879,70,1449,1660,832,1314,41,38,274,1701,20,312,209,395,332,604,2671,5058,12,64042,3557,1,2,1,1,1
18880,71,2475,1660,832,1314,41,38,274,1701,20,312,209,395,332,604,2671,5058,12,64042,3557,1,2,1,1,0
18881,70,1452,1660,832,1314,41,38,274,1701,20,312,209,395,332,604,2671,5058,12,64042,3557,1,2,1,1,1
18882,217,4701,72,33,56,0,4,12,72,1,1,1,1,2,2,0,2,0,1,0,0,2,4,3,0
18883,217,4701,1454,835,1044,76,110,219,1530,17,275,158,296,292,454,2297,3718,9,34017,1889,1,2,4,3,0
18886,61,1268,2,2,2,0,0,0,2,0,0,0,0,0,0,0,0,0,0,0,0,3,1,1,0
18900,61,1268,99,48,90,1,3,5,100,0,0,0,0,0,0,0,0,0,0,0,0,3,1,1,0
18901,61,1268,8,5,5,2,0,1,10,0,0,0,0,0,0,0,0,0,0,0,0,3,1,1,0
18902,61,1268,1217,716,841,84,126,174,1301,14,185,118,215,199,333,1446,2542,8,20687,1149,0,3,1,1,0
18903,61,1268,160,89,115,0,13,31,160,7,15,11,17,22,28,78,124,3,495,27,0,3,1,1,0
18904,61,1268,10,10,9,9,0,0,19,0,0,0,0,0,0,0,0,0,0,0,0,3,1,1,0
18905,61,1268,173,84,99,8,29,36,181,5,12,7,13,17,20,54,81,2,221,12,0,3,1,1,0
18906,61,1268,3,1,1,3,0,0,6,0,0,0,0,0,0,0,0,0,0,0,0,3,1,1,0
18907,71,2475,1660,832,1314,41,38,274,1701,20,312,209,395,332,604,2671,5058,12,64042,3557,1,3,1,1,0
18908,71,2475,1057,646,719,113,100,145,1170,18,215,134,248,233,382,1740,3004,10,31186,1732,1,3,1,1,0
18909,70,1454,1660,832,1314,41,38,274,1701,20,312,209,395,332,604,2671,5058,12,64042,3557,1,2,1,1,0
18912,71,1528,2,2,2,0,0,0,2,0,0,0,0,0,0,0,0,0,0,0,0,2,51,3,1
18926,71,1528,99,48,90,1,3,5,100,0,0,0,0,0,0,0,0,0,0,0,0,2,51,3,1
18927,71,1528,8,5,5,2,0,1,10,0,0,0,0,0,0,0,0,0,0,0,0,2,51,3,1
18928,71,1528,1217,716,841,84,126,174,1301,14,185,118,215,199,333,1446,2542,8,20687,1149,0,2,51,3,1
18929,71,1528,160,89,115,0,13,31,160,7,15,11,17,22,28,78,124,3,495,27,0,2,51,3,1
18930,71,1528,10,10,9,9,0,0,19,0,0,0,0,0,0,0,0,0,0,0,0,2,51,3,1
18931,71,1528,173,84,99,8,29,36,181,5,12,7,13,17,20,54,81,2,221,12,0,2,51,3,1
18932,71,1528,3,1,1,3,0,0,6,0,0,0,0,0,0,0,0,0,0,0,0,2,51,3,1
18933,71,2478,1660,832,1314,41,38,274,1701,20,312,209,395,332,604,2671,5058,12,64042,3557,1,2,11,10,1
18934,71,2478,1057,646,719,113,100,145,1170,18,215,134,248,233,382,1740,3004,10,31186,1732,1,2,11,10,1
18935,30,1102,1450,624,1228,12,26,181,1462,14,306,186,354,320,540,2580,4493,8,36391,2021,1,2,6,5,1
18936,70,1450,1660,832,1314,41,38,274,1701,20,312,209,395,332,604,2671,5058,12,64042,3557,1,2,5,4,1
18939,20,449,2,2,2,0,0,0,2,0,0,0,0,0,0,0,0,0,0,0,0,2,3,185,1
18953,20,449,99,48,90,1,3,5,100,0,0,0,0,0,0,0,0,0,0,0,0,2,3,185,1
18954,20,449,8,5,5,2,0,1,10,0,0,0,0,0,0,0,0,0,0,0,0,2,3,185,1
18955,20,449,1217,716,841,84,126,174,1301,14,185,118,215,199,333,1446,2542,8,20687,1149,0,2,3,185,1
18956,20,449,160,89,115,0,13,31,160,7,15,11,17,22,28,78,124,3,495,27,0,2,3,185,1
18957,20,449,10,10,9,9,0,0,19,0,0,0,0,0,0,0,0,0,0,0,0,2,3,185,1
18958,20,449,173,84,99,8,29,36,181,5,12,7,13,17,20,54,81,2,221,12,0,2,3,185,1
18959,20,449,3,1,1,3,0,0,6,0,0,0,0,0,0,0,0,0,0,0,0,2,3,185,1
18960,71,2471,1660,832,1314,41,38,274,1701,20,312,209,395,332,604,2671,5058,12,64042,3557,1,2,10,10,1
18961,71,2471,1057,646,719,113,100,145,1170,18,215,134,248,233,382,1740,3004,10,31186,1732,1,2,10,10,1
18962,30,1104,1450,624,1228,12,26,181,1462,14,306,186,354,320,540,2580,4493,8,36391,2021,1,2,5,5,1
18963,70,1452,1660,832,1314,41,38,274,1701,20,312,209,395,332,604,2671,5058,12,64042,3557,1,2,11,11,1
18966,20,449,2,2,2,0,0,0,2,0,0,0,0,0,0,0,0,0,0,0,0,2,1,1,0
18980,20,449,99,48,90,1,3,5,100,0,0,0,0,0,0,0,0,0,0,0,0,2,1,1,0
18981,20,449,8,5,5,2,0,1,10,0,0,0,0,0,0,0,0,0,0,0,0,2,1,1,0
18982,20,449,1217,716,841,84,126,174,1301,14,185,118,215,199,333,1446,2542,8,20687,1149,0,2,1,1,0
18983,20,449,160,89,115,0,13,31,160,7,15,11,17,22,28,78,124,3,495,27,0,2,1,1,0
18984,20,449,10,10,9,9,0,0,19,0,0,0,0,0,0,0,0,0,0,0,0,2,1,1,0
18985,20,449,173,84,99,8,29,36,181,5,12,7,13,17,20,54,81,2,221,12,0,2,1,1,0
18986,20,449,3,1,1,3,0,0,6,0,0,0,0,0,0,0,0,0,0,0,0,2,1,1,0
19010,51,1084,477,336,357,30,23,73,507,16,194,134,250,210,384,1538,2962,10,30538,1696,0,0,191,0,1
19013,20,449,2,2,2,0,0,0,2,0,0,0,0,0,0,0,0,0,0,0,0,2,0,4,0
19027,20,449,99,48,90,1,3,5,100,0,0,0,0,0,0,0,0,0,0,0,0,2,0,4,0
19028,20,449,8,5,5,2,0,1,10,0,0,0,0,0,0,0,0,0,0,0,0,2,0,4,0
19029,20,449,1217,716,841,84,126,174,1301,14,185,118,215,199,333,1446,2542,8,20687,1149,0,2,0,4,0
19030,20,449,160,89,115,0,13,31,160,7,15,11,17,22,28,78,124,3,495,27,0,2,0,4,0
19031,20,449,10,10,9,9,0,0,19,0,0,0,0,0,0,0,0,0,0,0,0,2,0,4,0
19032,20,449,173,84,99,8,29,36,181,5,12,7,13,17,20,54,81,2,221,12,0,2,0,4,0
19033,20,449,3,1,1,3,0,0,6,0,0,0,0,0,0,0,0,0,0,0,0,2,0,4,0
19036,24,552,2,2,2,0,0,0,2,0,0,0,0,0,0,0,0,0,0,0,0,2,21,6,1
19050,24,552,99,48,90,1,3,5,100,0,0,0,0,0,0,0,0,0,0,0,0,2,21,6,1
19051,24,552,8,5,5,2,0,1,10,0,0,0,0,0,0,0,0,0,0,0,0,2,21,6,1
19052,24,552,1217,716,841,84,126,174,1301,14,185,118,215,199,333,1446,2542,8,20687,1149,0,2,21,6,1
19053,24,552,160,89,115,0,13,31,160,7,15,11,17,22,28,78,124,3,495,27,0,2,21,6,1
19054,24,552,10,10,9,9,0,0,19,0,0,0,0,0,0,0,0,0,0,0,0,2,21,6,1
19055,24,552,173,84,99,8,29,36,181,5,12,7,13,17,20,54,81,2,221,12,0,2,21,6,1
19056,24,552,3,1,1,3,0,0,6,0,0,0,0,0,0,0,0,0,0,0,0,2,21,6,1
19057,38,936,74,35,59,1,0,14,75,3,14,7,14,17,21,58,85,1,128,7,0,2,0,3,1
19058,38,936,245,125,200,5,7,34,250,7,30,17,34,37,51,166,265,3,1053,58,0,2,0,3,1
19059,34,1230,1450,624,1228,12,26,181,1462,14,306,186,354,320,540,2580,4493,8,36391,2021,1,2,25,3,1
19062,25,694,2,2,2,0,0,0,2,0,0,0,0,0,0,0,0,0,0,0,0,2,14,1,0
19076,25,694,99,48,90,1,3,5,100,0,0,0,0,0,0,0,0,0,0,0,0,2,14,1,0
19077,25,694,8,5,5,2,0,1,10,0,0,0,0,0,0,0,0,0,0,0,0,2,14,1,0
19078,25,694,1217,716,841,84,126,174,1301,14,185,118,215,199,333,1446,2542,8,20687,1149,0,2,14,1,0
19079,25,694,160,89,115,0,13,31,160,7,15,11,17,22,28,78,124,3,495,27,0,2,14,1,0
19080,25,694,10,10,9,9,0,0,19,0,0,0,0,0,0,0,0,0,0,0,0,2,14,1,0
19081,25,694,173,84,99,8,29,36,181,5,12,7,13,17,20,54,81,2,221,12,0,2,14,1,0
19082,25,694,3,1,1,3,0,0,6,0,0,0,0,0,0,0,0,0,0,0,0,2,14,1,0
19085,25,694,2,2,2,0,0,0,2,0,0,0,0,0,0,0,0,0,0,0,0,2,2,2,0
19099,25,694,99,48,90,1,3,5,100,0,0,0,0,0,0,0,0,0,0,0,0,2,2,2,0
19100,25,694,8,5,5,2,0,1,10,0,0,0,0,0,0,0,0,0,0,0,0,2,2,2,0
19101,25,694,1217,716,841,84,126,174,1301,14,185,118,215,199,333,1446,2542,8,20687,1149,0,2,2,2,0
19102,25,694,160,89,115,0,13,31,160,7,15,11,17,22,28,78,124,3,495,27,0,2,2,2,0
19103,25,694,10,10,9,9,0,0,19,0,0,0,0,0,0,0,0,0,0,0,0,2,2,2,0
19104,25,694,173,84,99,8,29,36,181,5,12,7,13,17,20,54,81,2,221,12,0,2,2,2,0
19105,25,694,3,1,1,3,0,0,6,0,0,0,0,0,0,0,0,0,0,0,0,2,2,2,0
19106,43,2933,1296,573,1062,40,33,157,1336,8,201,118,231,209,349,1561,2689,4,12365,686,0,2,7,7,0
19107,185,4381,722,423,573,19,0,135,741,12,172,101,199,184,300,1320,2257,6,15668,870,0,2,11,3,1
19108,185,4381,1508,847,911,44,250,301,1552,14,148,88,169,162,257,1120,1886,7,15077,837,0,2,11,3,1
19109,217,4703,72,33,56,0,4,12,72,1,1,1,1,2,2,0,2,0,1,0,0,2,2,2,1
19110,217,4703,1454,835,1044,76,110,219,1530,17,275,158,296,292,454,2297,3718,9,34017,1889,1,2,2,2,1
19111,86,1908,1043,504,840,53,9,147,1096,9,180,112,198,189,310,1377,2344,4,11604,644,0,2,10,12,1
19112,86,1908,383,288,292,26,6,62,409,11,65,38,67,76,105,429,656,5,3719,206,0,2,10,12,1
19115,26,708,2,2,2,0,0,0,2,0,0,0,0,0,0,0,0,0,0,0,0,2,4,5,0
19129,26,708,99,48,90,1,3,5,100,0,0,0,0,0,0,0,0,0,0,0,0,2,4,5,0
19130,26,708,8,5,5,2,0,1,10,0,0,0,0,0,0,0,0,0,0,0,0,2,4,5,0
19131,26,708,1217,716,841,84,126,174,1301,14,185,118,215,199,333,1446,2542,8,20687,1149,0,2,4,5,0
19132,26,708,160,89,115,0,13,31,160,7,15,11,17,22,28,78,124,3,495,27,0,2,4,5,0
19133,26,708,10,10,9,9,0,0,19,0,0,0,0,0,0,0,0,0,0,0,0,2,4,5,0
19134,26,708,173,84,99,8,29,36,181,5,12,7,13,17,20,54,81,2,221,12,0,2,4,5,0
19135,26,708,3,1,1,3,0,0,6,0,0,0,0,0,0,0,0,0,0,0,0,2,4,5,0
19136,43,2933,1296,573,1062,40,33,157,1336,8,201,118,231,209,349,1561,2689,4,12365,686,0,2,1,1,0
19137,185,4406,722,423,573,19,0,135,741,12,172,101,199,184,300,1320,2257,6,15668,870,0,2,2,0,0
19138,185,4406,1508,847,911,44,250,301,1552,14,148,88,169,162,257,1120,1886,7,15077,837,0,2,2,0,0
19139,185,4406,722,423,573,19,0,135,741,12,172,101,199,184,300,1320,2257,6,15668,870,0,2,1,1,0
19140,185,4406,1508,847,911,44,250,301,1552,14,148,88,169,162,257,1120,1886,7,15077,837,0,2,1,1,0
19141,49,458,647,139,84,35,284,233,682,0,0,0,0,0,0,0,0,0,0,0,0,2,3,0,0
19142,218,4722,72,33,56,0,4,12,72,1,1,1,1,2,2,0,2,0,1,0,0,2,4,1,0
19143,218,4722,1454,835,1044,76,110,219,1530,17,275,158,296,292,454,2297,3718,9,34017,1889,1,2,4,1,0
19144,50,465,647,139,84,35,284,233,682,0,0,0,0,0,0,0,0,0,0,0,0,2,3,0,0
19145,139,3230,77,34,69,0,0,8,77,3,24,16,29,27,45,114,213,1,387,21,0,2,4,1,0
19146,139,3230,712,438,573,51,9,84,763,14,102,71,128,116,199,733,1364,8,11988,666,0,2,4,1,0
19147,139,3237,77,34,69,0,0,8,77,3,24,16,29,27,45,114,213,1,387,21,0,2,2,1,1
19148,139,3237,712,438,573,51,9,84,763,14,102,71,128,116,199,733,1364,8,11988,666,0,2,2,1,1
19149,141,3267,77,34,69,0,0,8,77,3,24,16,29,27,45,114,213,1,387,21,0,2,12,5,1
19150,141,3267,712,438,573,51,9,84,763,14,102,71,128,116,199,733,1364,8,11988,666,0,2,12,5,1
19151,219,4731,72,33,56,0,4,12,72,1,1,1,1,2,2,0,2,0,1,0,0,2,4,2,1
19152,219,4731,1454,835,1044,76,110,219,1530,17,275,158,296,292,454,2297,3718,9,34017,1889,1,2,4,2,1
19153,49,458,647,139,84,35,284,233,682,0,0,0,0,0,0,0,0,0,0,0,0,2,0,3,1
19154,140,3253,77,34,69,0,0,8,77,3,24,16,29,27,45,114,213,1,387,21,0,2,1,4,1
19155,140,3253,712,438,573,51,9,84,763,14,102,71,128,116,199,733,1364,8,11988,666,0,2,1,4,1
19156,142,3276,77,34,69,0,0,8,77,3,24,16,29,27,45,114,213,1,387,21,0,2,11,6,1
19157,142,3276,712,438,573,51,9,84,763,14,102,71,128,116,199,733,1364,8,11988,666,0,2,11,6,1
19160,29,742,2,2,2,0,0,0,2,0,0,0,0,0,0,0,0,0,0,0,0,2,25,16,0
19174,29,742,99,48,90,1,3,5,100,0,0,0,0,0,0,0,0,0,0,0,0,2,25,16,0
19175,29,742,8,5,5,2,0,1,10,0,0,0,0,0,0,0,0,0,0,0,0,2,25,16,0
19176,29,742,1217,716,841,84,126,174,1301,14,185,118,215,199,333,1446,2542,8,20687,1149,0,2,25,16,0
19177,29,742,160,89,115,0,13,31,160,7,15,11,17,22,28,78,124,3,495,27,0,2,25,16,0
19178,29,742,10,10,9,9,0,0,19,0,0,0,0,0,0,0,0,0,0,0,0,2,25,16,0
19179,29,742,173,84,99,8,29,36,181,5,12,7,13,17,20,54,81,2,221,12,0,2,25,16,0
19180,29,742,3,1,1,3,0,0,6,0,0,0,0,0,0,0,0,0,0,0,0,2,25,16,0
19181,47,444,647,139,84,35,284,233,682,0,0,0,0,0,0,0,0,0,0,0,0,2,0,6,0
19182,218,4707,72,33,56,0,4,12,72,1,1,1,1,2,2,0,2,0,1,0,0,2,1,5,0
19183,218,4707,1454,835,1044,76,110,219,1530,17,275,158,296,292,454,2297,3718,9,34017,1889,1,2,1,5,0
19184,35,1250,1450,624,1228,12,26,181,1462,14,306,186,354,320,540,2580,4493,8,36391,2021,1,2,4,0,0
19187,29,742,2,2,2,0,0,0,2,0,0,0,0,0,0,0,0,0,0,0,0,2,5,1,1
19201,29,742,99,48,90,1,3,5,100,0,0,0,0,0,0,0,0,0,0,0,0,2,5,1,1
19202,29,742,8,5,5,2,0,1,10,0,0,0,0,0,0,0,0,0,0,0,0,2,5,1,1
19203,29,742,1217,716,841,84,126,174,1301,14,185,118,215,199,333,1446,2542,8,20687,1149,0,2,5,1,1
19204,29,742,160,89,115,0,13,31,160,7,15,11,17,22,28,78,124,3,495,27,0,2,5,1,1
19205,29,742,10,10,9,9,0,0,19,0,0,0,0,0,0,0,0,0,0,0,0,2,5,1,1
19206,29,742,173,84,99,8,29,36,181,5,12,7,13,17,20,54,81,2,221,12,0,2,5,1,1
19207,29,742,3,1,1,3,0,0,6,0,0,0,0,0,0,0,0,0,0,0,0,2,5,1,1
19210,29,742,2,2,2,0,0,0,2,0,0,0,0,0,0,0,0,0,0,0,0,2,2,2,0
19224,29,742,99,48,90,1,3,5,100,0,0,0,0,0,0,0,0,0,0,0,0,2,2,2,0
19225,29,742,8,5,5,2,0,1,10,0,0,0,0,0,0,0,0,0,0,0,0,2,2,2,0
19226,29,742,1217,716,841,84,126,174,1301,14,185,118,215,199,333,1446,2542,8,20687,1149,0,2,2,2,0
19227,29,742,160,89,115,0,13,31,160,7,15,11,17,22,28,78,124,3,495,27,0,2,2,2,0
19228,29,742,10,10,9,9,0,0,19,0,0,0,0,0,0,0,0,0,0,0,0,2,2,2,0
19229,29,742,173,84,99,8,29,36,181,5,12,7,13,17,20,54,81,2,221,12,0,2,2,2,0
19230,29,742,3,1,1,3,0,0,6,0,0,0,0,0,0,0,0,0,0,0,0,2,2,2,0
19231,72,2533,1660,832,1314,41,38,274,1701,20,312,209,395,332,604,2671,5058,12,64042,3557,1,2,8,1,1
19232,72,2533,1057,646,719,113,100,145,1170,18,215,134,248,233,382,1740,3004,10,31186,1732,1,2,8,1,1
19235,29,742,2,2,2,0,0,0,2,0,0,0,0,0,0,0,0,0,0,0,0,2,7,8,1
19249,29,742,99,48,90,1,3,5,100,0,0,0,0,0,0,0,0,0,0,0,0,2,7,8,1
19250,29,742,8,5,5,2,0,1,10,0,0,0,0,0,0,0,0,0,0,0,0,2,7,8,1
19251,29,742,1217,716,841,84,126,174,1301,14,185,118,215,199,333,1446,2542,8,20687,1149,0,2,7,8,1
19252,29,742,160,89,115,0,13,31,160,7,15,11,17,22,28,78,124,3,495,27,0,2,7,8,1
19253,29,742,10,10,9,9,0,0,19,0,0,0,0,0,0,0,0,0,0,0,0,2,7,8,1
19254,29,742,173,84,99,8,29,36,181,5,12,7,13,17,20,54,81,2,221,12,0,2,7,8,1
19255,29,742,3,1,1,3,0,0,6,0,0,0,0,0,0,0,0,0,0,0,0,2,7,8,1
19256,40,1258,1523,757,1297,19,12,193,1542,12,193,117,230,205,347,1508,2664,7,19053,1058,0,2,1,1,1
19257,40,1258,701,378,504,33,58,109,734,13,110,68,126,123,194,794,1346,7,10027,557,0,2,1,1,1
19258,29,1824,1523,757,1297,19,12,193,1542,12,193,117,230,205,347,1508,2664,7,19053,1058,0,2,14,1,1
19282,40,1252,1523,757,1297,19,12,193,1542,12,193,117,230,205,347,1508,2664,7,19053,1058,0,2,2,3,1
19283,40,1252,701,378,504,33,58,109,734,13,110,68,126,123,194,794,1346,7,10027,557,0,2,2,3,1
19286,30,1887,1523,757,1297,19,12,193,1542,12,193,117,230,205,347,1508,2664,7,19053,1058,0,2,12,0,1
19287,18,628,1455,414,1257,16,76,112,1471,5,41,23,46,46,69,231,381,2,1069,59,0,2,1,1,1
19288,18,628,669,365,481,22,61,110,691,15,103,63,122,118,185,747,1273,8,11311,628,0,2,1,1,1
19289,11,473,1455,414,1257,16,76,112,1471,5,41,23,46,46,69,231,381,2,1069,59,0,2,15,0,1
19290,40,1262,1523,757,1297,19,12,193,1542,12,193,117,230,205,347,1508,2664,7,19053,1058,0,2,2,1,1
19291,40,1262,701,378,504,33,58,109,734,13,110,68,126,123,194,794,1346,7,10027,557,0,2,2,1,1
19292,30,1873,1523,757,1297,19,12,193,1542,12,193,117,230,205,347,1508,2664,7,19053,1058,0,2,2,2,1
19295,30,1880,1523,757,1297,19,12,193,1542,12,193,117,230,205,347,1508,2664,7,19053,1058,0,2,1,1,0
19296,30,1887,1523,757,1297,19,12,193,1542,12,193,117,230,205,347,1508,2664,7,19053,1058,0,2,1,1,0
19300,25,697,2,2,2,0,0,0,2,0,0,0,0,0,0,0,0,0,0,0,0,2,16,25,1
19314,25,697,99,48,90,1,3,5,100,0,0,0,0,0,0,0,0,0,0,0,0,2,16,25,1
19315,25,697,8,5,5,2,0,1,10,0,0,0,0,0,0,0,0,0,0,0,0,2,16,25,1
19316,25,697,1217,716,841,84,126,174,1301,14,185,118,215,199,333,1446,2542,8,20687,1149,0,2,16,25,1
19317,25,697,160,89,115,0,13,31,160,7,15,11,17,22,28,78,124,3,495,27,0,2,16,25,1
19318,25,697,10,10,9,9,0,0,19,0,0,0,0,0,0,0,0,0,0,0,0,2,16,25,1
19319,25,697,173,84,99,8,29,36,181,5,12,7,13,17,20,54,81,2,221,12,0,2,16,25,1
19320,25,697,3,1,1,3,0,0,6,0,0,0,0,0,0,0,0,0,0,0,0,2,16,25,1
19321,46,437,647,139,84,35,284,233,682,0,0,0,0,0,0,0,0,0,0,0,0,2,0,3,1
19322,218,4708,72,33,56,0,4,12,72,1,1,1,1,2,2,0,2,0,1,0,0,2,7,5,1
19323,218,4708,1454,835,1044,76,110,219,1530,17,275,158,296,292,454,2297,3718,9,34017,1889,1,2,7,5,1
19324,11,475,1455,414,1257,16,76,112,1471,5,41,23,46,46,69,231,381,2,1069,59,0,2,1,1,0
19350,25,697,2,2,2,0,0,0,2,0,0,0,0,0,0,0,0,0,0,0,0,0,128,0,1
19364,25,697,99,48,90,1,3,5,100,0,0,0,0,0,0,0,0,0,0,0,0,0,128,0,1
19365,25,697,8,5,5,2,0,1,10,0,0,0,0,0,0,0,0,0,0,0,0,0,128,0,1
19366,25,697,1217,716,841,84,126,174,1301,14,185,118,215,199,333,1446,2542,8,20687,1149,0,0,128,0,1
19367,25,697,160,89,115,0,13,31,160,7,15,11,17,22,28,78,124,3,495,27,0,0,128,0,1
19368,25,697,10,10,9,9,0,0,19,0,0,0,0,0,0,0,0,0,0,0,0,0,128,0,1
19369,25,697,173,84,99,8,29,36,181,5,12,7,13,17,20,54,81,2,221,12,0,0,128,0,1
19370,25,697,3,1,1,3,0,0,6,0,0,0,0,0,0,0,0,0,0,0,0,0,128,0,1
19371,72,2533,1660,832,1314,41,38,274,1701,20,312,209,395,332,604,2671,5058,12,64042,3557,1,0,340,0,1
19372,72,2533,1057,646,719,113,100,145,1170,18,215,134,248,233,382,1740,3004,10,31186,1732,1,0,340,0,1
19373,51,1084,477,336,357,30,23,73,507,16,194,134,250,210,384,1538,2962,10,30538,1696,0,3,54,40,1
19376,142,3276,77,34,69,0,0,8,77,3,24,16,29,27,45,114,213,1,387,21,0,2,25,12,1
19377,142,3276,712,438,573,51,9,84,763,14,102,71,128,116,199,733,1364,8,11988,666,0,2,25,12,1
19378,185,4406,722,423,573,19,0,135,741,12,172,101,199,184,300,1320,2257,6,15668,870,0,2,14,4,1
19379,185,4406,1508,847,911,44,250,301,1552,14,148,88,169,162,257,1120,1886,7,15077,837,0,2,14,4,1
19380,218,4708,72,33,56,0,4,12,72,1,1,1,1,2,2,0,2,0,1,0,0,2,12,5,1
19381,218,4708,1454,835,1044,76,110,219,1530,17,275,158,296,292,454,2297,3718,9,34017,1889,1,2,12,5,1
19386,35,1250,1450,624,1228,12,26,181,1462,14,306,186,354,320,540,2580,4493,8,36391,2021,1,2,42,8,1
19387,70,1452,1660,832,1314,41,38,274,1701,20,312,209,395,332,604,2671,5058,12,64042,3557,1,0,256,0,1
19388,43,2933,1296,573,1062,40,33,157,1336,8,201,118,231,209,349,1561,2689,4,12365,686,0,2,8,8,1
19412,218,4708,72,33,56,0,4,12,72,1,1,1,1,2,2,0,2,0,1,0,0,2,1,1,0
19413,218,4708,1454,835,1044,76,110,219,1530,17,275,158,296,292,454,2297,3718,9,34017,1889,1,2,1,1,0
19414,6,288,42,7,35,4,0,5,46,1,2,1,2,3,3,2,4,0,2,0,0,2,2,2,0
19415,6,288,11,6,10,0,0,1,11,2,4,2,4,6,6,10,15,1,15,0,0,2,2,2,0
19416,6,288,42,7,35,4,0,5,46,1,2,1,2,3,3,2,4,0,2,0,0,2,4,4,1
19417,6,288,11,6,10,0,0,1,11,2,4,2,4,6,6,10,15,1,15,0,0,2,4,4,1
19418,46,795,1020,354,843,12,15,144,1032,8,134,77,144,142,221,970,1580,4,6792,377,0,2,1,1,1
19419,36,1391,1020,354,843,12,15,144,1032,8,134,77,144,142,221,970,1580,4,6792,377,0,2,5,0,1
19420,144,3295,77,34,69,0,0,8,77,3,24,16,29,27,45,114,213,1,387,21,0,2,8,3,1
19421,144,3295,712,438,573,51,9,84,763,14,102,71,128,116,199,733,1364,8,11988,666,0,2,8,3,1
19422,43,1893,1289,550,1043,56,32,155,1345,10,167,93,185,177,278,1266,2075,5,11498,638,0,2,13,0,1
19446,45,430,647,139,84,35,284,233,682,0,0,0,0,0,0,0,0,0,0,0,0,2,0,3,1
19447,217,4685,72,33,56,0,4,12,72,1,1,1,1,2,2,0,2,0,1,0,0,2,8,13,1
19448,217,4685,1454,835,1044,76,110,219,1530,17,275,158,296,292,454,2297,3718,9,34017,1889,1,2,8,13,1
19449,6,288,42,7,35,4,0,5,46,1,2,1,2,3,3,2,4,0,2,0,0,2,2,2,1
19450,6,288,11,6,10,0,0,1,11,2,4,2,4,6,6,10,15,1,15,0,0,2,2,2,1
19453,25,697,2,2,2,0,0,0,2,0,0,0,0,0,0,0,0,0,0,0,0,2,2,2,0
19467,25,697,99,48,90,1,3,5,100,0,0,0,0,0,0,0,0,0,0,0,0,2,2,2,0
19468,25,697,8,5,5,2,0,1,10,0,0,0,0,0,0,0,0,0,0,0,0,2,2,2,0
19469,25,697,1217,716,841,84,126,174,1301,14,185,118,215,199,333,1446,2542,8,20687,1149,0,2,2,2,0
19470,25,697,160,89,115,0,13,31,160,7,15,11,17,22,28,78,124,3,495,27,0,2,2,2,0
19471,25,697,10,10,9,9,0,0,19,0,0,0,0,0,0,0,0,0,0,0,0,2,2,2,0
19472,25,697,173,84,99,8,29,36,181,5,12,7,13,17,20,54,81,2,221,12,0,2,2,2,0
19473,25,697,3,1,1,3,0,0,6,0,0,0,0,0,0,0,0,0,0,0,0,2,2,2,0
19474,43,1893,1289,550,1043,56,32,155,1345,10,167,93,185,177,278,1266,2075,5,11498,638,0,2,1,1,1
19475,52,2433,1943,715,1694,26,18,214,1969,12,185,120,237,197,357,1436,2721,7,20915,1161,0,2,1,1,1
19476,58,1208,477,336,357,30,23,73,507,16,194,134,250,210,384,1538,2962,10,30538,1696,0,2,22,0,1
19477,70,1452,1660,832,1314,41,38,274,1701,20,312,209,395,332,604,2671,5058,12,64042,3557,1,2,6,12,1
19478,72,2533,1660,832,1314,41,38,274,1701,20,312,209,395,332,604,2671,5058,12,64042,3557,1,2,2,2,1
19479,72,2533,1057,646,719,113,100,145,1170,18,215,134,248,233,382,1740,3004,10,31186,1732,1,2,2,2,1
19480,71,1508,1660,832,1314,41,38,274,1701,20,312,209,395,332,604,2671,5058,12,64042,3557,1,2,7,0,1
19481,75,2768,1660,832,1314,41,38,274,1701,20,312,209,395,332,604,2671,5058,12,64042,3557,1,2,52,27,1
19482,75,2768,1057,646,719,113,100,145,1170,18,215,134,248,233,382,1740,3004,10,31186,1732,1,2,52,27,1
19483,75,1550,1660,832,1314,41,38,274,1701,20,312,209,395,332,604,2671,5058,12,64042,3557,1,2,8,1,1
19484,75,2763,1660,832,1314,41,38,274,1701,20,312,209,395,332,604,2671,5058,12,64042,3557,1,2,2,2,0
19485,75,2763,1057,646,719,113,100,145,1170,18,215,134,248,233,382,1740,3004,10,31186,1732,1,2,2,2,0
19488,27,581,2,2,2,0,0,0,2,0,0,0,0,0,0,0,0,0,0,0,0,2,45,64,1
19502,27,581,99,48,90,1,3,5,100,0,0,0,0,0,0,0,0,0,0,0,0,2,45,64,1
19503,27,581,8,5,5,2,0,1,10,0,0,0,0,0,0,0,0,0,0,0,0,2,45,64,1
19504,27,581,1217,716,841,84,126,174,1301,14,185,118,215,199,333,1446,2542,8,20687,1149,0,2,45,64,1
19505,27,581,160,89,115,0,13,31,160,7,15,11,17,22,28,78,124,3,495,27,0,2,45,64,1
19506,27,581,10,10,9,9,0,0,19,0,0,0,0,0,0,0,0,0,0,0,0,2,45,64,1
19507,27,581,173,84,99,8,29,36,181,5,12,7,13,17,20,54,81,2,221,12,0,2,45,64,1
19508,27,581,3,1,1,3,0,0,6,0,0,0,0,0,0,0,0,0,0,0,0,2,45,64,1
19509,111,3586,1660,832,1314,41,38,274,1701,20,312,209,395,332,604,2671,5058,12,64042,3557,1,2,161,0,1
19510,111,3586,1057,646,719,113,100,145,1170,18,215,134,248,233,382,1740,3004,10,31186,1732,1,2,161,0,1
19511,216,4665,72,33,56,0,4,12,72,1,1,1,1,2,2,0,2,0,1,0,0,2,1,6,1
19512,216,4665,1454,835,1044,76,110,219,1530,17,275,158,296,292,454,2297,3718,9,34017,1889,1,2,1,6,1
19513,35,1267,1450,624,1228,12,26,181,1462,14,306,186,354,320,540,2580,4493,8,36391,2021,1,2,3,2,1
19516,27,581,2,2,2,0,0,0,2,0,0,0,0,0,0,0,0,0,0,0,0,2,12,12,1
19530,27,581,99,48,90,1,3,5,100,0,0,0,0,0,0,0,0,0,0,0,0,2,12,12,1
19531,27,581,8,5,5,2,0,1,10,0,0,0,0,0,0,0,0,0,0,0,0,2,12,12,1
19532,27,581,1217,716,841,84,126,174,1301,14,185,118,215,199,333,1446,2542,8,20687,1149,0,2,12,12,1
19533,27,581,160,89,115,0,13,31,160,7,15,11,17,22,28,78,124,3,495,27,0,2,12,12,1
19534,27,581,10,10,9,9,0,0,19,0,0,0,0,0,0,0,0,0,0,0,0,2,12,12,1
19535,27,581,173,84,99,8,29,36,181,5,12,7,13,17,20,54,81,2,221,12,0,2,12,12,1
19536,27,581,3,1,1,3,0,0,6,0,0,0,0,0,0,0,0,0,0,0,0,2,12,12,1
19537,35,1267,1450,624,1228,12,26,181,1462,14,306,186,354,320,540,2580,4493,8,36391,2021,1,2,2,2,1
19538,111,3593,1660,832,1314,41,38,274,1701,20,312,209,395,332,604,2671,5058,12,64042,3557,1,2,1,0,0
19539,111,3593,1057,646,719,113,100,145,1170,18,215,134,248,233,382,1740,3004,10,31186,1732,1,2,1,0,0
19540,35,1267,1450,624,1228,12,26,181,1462,14,306,186,354,320,540,2580,4493,8,36391,2021,1,2,1,1,0
19541,111,3596,1660,832,1314,41,38,274,1701,20,312,209,395,332,604,2671,5058,12,64042,3557,1,2,1,1,0
19542,111,3596,1057,646,719,113,100,145,1170,18,215,134,248,233,382,1740,3004,10,31186,1732,1,2,1,1,0
19543,110,3591,1660,832,1314,41,38,274,1701,20,312,209,395,332,604,2671,5058,12,64042,3557,1,2,4,7,0
19544,110,3591,1057,646,719,113,100,145,1170,18,215,134,248,233,382,1740,3004,10,31186,1732,1,2,4,7,0
19545,35,1269,1450,624,1228,12,26,181,1462,14,306,186,354,320,540,2580,4493,8,36391,2021,1,2,6,3,0
19571,27,578,2,2,2,0,0,0,2,0,0,0,0,0,0,0,0,0,0,0,0,2,5,4,1
19585,27,578,99,48,90,1,3,5,100,0,0,0,0,0,0,0,0,0,0,0,0,2,5,4,1
19586,27,578,8,5,5,2,0,1,10,0,0,0,0,0,0,0,0,0,0,0,0,2,5,4,1
19587,27,578,1217,716,841,84,126,174,1301,14,185,118,215,199,333,1446,2542,8,20687,1149,0,2,5,4,1
19588,27,578,160,89,115,0,13,31,160,7,15,11,17,22,28,78,124,3,495,27,0,2,5,4,1
19589,27,578,10,10,9,9,0,0,19,0,0,0,0,0,0,0,0,0,0,0,0,2,5,4,1
19590,27,578,173,84,99,8,29,36,181,5,12,7,13,17,20,54,81,2,221,12,0,2,5,4,1
19591,27,578,3,1,1,3,0,0,6,0,0,0,0,0,0,0,0,0,0,0,0,2,5,4,1
19592,6,288,42,7,35,4,0,5,46,1,2,1,2,3,3,2,4,0,2,0,0,2,1,1,1
19593,6,288,11,6,10,0,0,1,11,2,4,2,4,6,6,10,15,1,15,0,0,2,1,1,1
19594,35,1271,1450,624,1228,12,26,181,1462,14,306,186,354,320,540,2580,4493,8,36391,2021,1,2,1,0,1
19620,25,553,2,2,2,0,0,0,2,0,0,0,0,0,0,0,0,0,0,0,0,2,13,16,1
19634,25,553,99,48,90,1,3,5,100,0,0,0,0,0,0,0,0,0,0,0,0,2,13,16,1
19635,25,553,8,5,5,2,0,1,10,0,0,0,0,0,0,0,0,0,0,0,0,2,13,16,1
19636,25,553,1217,716,841,84,126,174,1301,14,185,118,215,199,333,1446,2542,8,20687,1149,0,2,13,16,1
19637,25,553,160,89,115,0,13,31,160,7,15,11,17,22,28,78,124,3,495,27,0,2,13,16,1
19638,25,553,10,10,9,9,0,0,19,0,0,0,0,0,0,0,0,0,0,0,0,2,13,16,1
19639,25,553,173,84,99,8,29,36,181,5,12,7,13,17,20,54,81,2,221,12,0,2,13,16,1
19640,25,553,3,1,1,3,0,0,6,0,0,0,0,0,0,0,0,0,0,0,0,2,13,16,1
19643,33,1221,1450,624,1228,12,26,181,1462,14,306,186,354,320,540,2580,4493,8,36391,2021,1,2,7,13,1
19669,25,553,2,2,2,0,0,0,2,0,0,0,0,0,0,0,0,0,0,0,0,2,4,1,0
19683,25,553,99,48,90,1,3,5,100,0,0,0,0,0,0,0,0,0,0,0,0,2,4,1,0
19684,25,553,8,5,5,2,0,1,10,0,0,0,0,0,0,0,0,0,0,0,0,2,4,1,0
19685,25,553,1217,716,841,84,126,174,1301,14,185,118,215,199,333,1446,2542,8,20687,1149,0,2,4,1,0
19686,25,553,160,89,115,0,13,31,160,7,15,11,17,22,28,78,124,3,495,27,0,2,4,1,0
19687,25,553,10,10,9,9,0,0,19,0,0,0,0,0,0,0,0,0,0,0,0,2,4,1,0
19688,25,553,173,84,99,8,29,36,181,5,12,7,13,17,20,54,81,2,221,12,0,2,4,1,0
19689,25,553,3,1,1,3,0,0,6,0,0,0,0,0,0,0,0,0,0,0,0,2,4,1,0
19690,6,288,42,7,35,4,0,5,46,1,2,1,2,3,3,2,4,0,2,0,0,2,1,1,0
19691,6,288,11,6,10,0,0,1,11,2,4,2,4,6,6,10,15,1,15,0,0,2,1,1,0
19692,111,3633,1660,832,1314,41,38,274,1701,20,312,209,395,332,604,2671,5058,12,64042,3557,1,2,8,2,0
19693,111,3633,1057,646,719,113,100,145,1170,18,215,134,248,233,382,1740,3004,10,31186,1732,1,2,8,2,0
19742,17,283,424,94,331,4,0,89,428,1,5,5,5,6,10,11,25,0,12,0,0,2,1,0,1
19743,17,283,38,23,23,6,0,8,44,3,11,7,11,14,18,42,68,1,102,5,0,2,1,0,1
19746,10,342,424,94,331,4,0,89,428,1,5,5,5,6,10,11,25,0,12,0,0,2,16,0,1
19770,141,2829,1943,715,1694,26,18,214,1969,12,185,120,237,197,357,1436,2721,7,20915,1161,0,2,1,1,0
19771,141,2829,1168,838,957,57,25,144,1225,19,348,224,416,367,640,3018,5452,11,61921,3440,1,2,1,1,0
19774,1,189,382,65,130,157,2,92,539,4,10,5,10,14,15,41,57,2,114,6,0,2,6,6,0
19775,1,187,382,65,130,157,2,92,539,4,10,5,10,14,15,41,57,2,114,6,0,2,1,2,0
19776,6,288,42,7,35,4,0,5,46,1,2,1,2,3,3,2,4,0,2,0,0,2,4,2,0
19777,6,288,11,6,10,0,0,1,11,2,4,2,4,6,6,10,15,1,15,0,0,2,4,2,0
19778,1,187,382,65,130,157,2,92,539,4,10,5,10,14,15,41,57,2,114,6,0,2,2,2,1
19781,23,509,2,2,2,0,0,0,2,0,0,0,0,0,0,0,0,0,0,0,0,2,0,5,1
19795,23,509,99,48,90,1,3,5,100,0,0,0,0,0,0,0,0,0,0,0,0,2,0,5,1
19796,23,509,8,5,5,2,0,1,10,0,0,0,0,0,0,0,0,0,0,0,0,2,0,5,1
19797,23,509,1217,716,841,84,126,174,1301,14,185,118,215,199,333,1446,2542,8,20687,1149,0,2,0,5,1
19798,23,509,160,89,115,0,13,31,160,7,15,11,17,22,28,78,124,3,495,27,0,2,0,5,1
19799,23,509,10,10,9,9,0,0,19,0,0,0,0,0,0,0,0,0,0,0,0,2,0,5,1
19800,23,509,173,84,99,8,29,36,181,5,12,7,13,17,20,54,81,2,221,12,0,2,0,5,1
19801,23,509,3,1,1,3,0,0,6,0,0,0,0,0,0,0,0,0,0,0,0,2,0,5,1
19802,109,3599,1660,832,1314,41,38,274,1701,20,312,209,395,332,604,2671,5058,12,64042,3557,1,2,81,66,1
19803,109,3599,1057,646,719,113,100,145,1170,18,215,134,248,233,382,1740,3004,10,31186,1732,1,2,81,66,1
19804,32,1156,1450,624,1228,12,26,181,1462,14,306,186,354,320,540,2580,4493,8,36391,2021,1,2,0,8,1
19805,1,187,382,65,130,157,2,92,539,4,10,5,10,14,15,41,57,2,114,6,0,2,2,2,0
19808,109,3605,1660,832,1314,41,38,274,1701,20,312,209,395,332,604,2671,5058,12,64042,3557,1,2,1,1,1
19809,109,3605,1057,646,719,113,100,145,1170,18,215,134,248,233,382,1740,3004,10,31186,1732,1,2,1,1,1
19810,10,333,295,56,236,0,4,54,295,2,9,5,10,11,15,30,51,1,57,3,0,2,1,1,0
19811,143,2852,1943,715,1694,26,18,214,1969,12,185,120,237,197,357,1436,2721,7,20915,1161,0,2,5,0,1
19812,143,2852,1168,838,957,57,25,144,1225,19,348,224,416,367,640,3018,5452,11,61921,3440,1,2,5,0,1
19813,53,2478,1943,715,1694,26,18,214,1969,12,185,120,237,197,357,1436,2721,7,20915,1161,0,2,13,0,1
19862,1,184,382,65,130,157,2,92,539,4,10,5,10,14,15,41,57,2,114,6,0,2,3,4,0
19888,6,288,42,7,35,4,0,5,46,1,2,1,2,3,3,2,4,0,2,0,0,2,2,3,1
19889,6,288,11,6,10,0,0,1,11,2,4,2,4,6,6,10,15,1,15,0,0,2,2,3,1
19890,110,3625,1660,832,1314,41,38,274,1701,20,312,209,395,332,604,2671,5058,12,64042,3557,1,2,10,5,1
19891,110,3625,1057,646,719,113,100,145,1170,18,215,134,248,233,382,1740,3004,10,31186,1732,1,2,10,5,1
19892,110,3649,1660,832,1314,41,38,274,1701,20,312,209,395,332,604,2671,5058,12,64042,3557,1,2,8,2,0
19893,110,3649,1057,646,719,113,100,145,1170,18,215,134,248,233,382,1740,3004,10,31186,1732,1,2,8,2,0
19894,6,298,42,7,35,4,0,5,46,1,2,1,2,3,3,2,4,0,2,0,0,2,7,3,1
19895,6,298,11,6,10,0,0,1,11,2,4,2,4,6,6,10,15,1,15,0,0,2,7,3,1
19896,6,286,42,7,35,4,0,5,46,1,2,1,2,3,3,2,4,0,2,0,0,2,0,2,0
19897,6,286,11,6,10,0,0,1,11,2,4,2,4,6,6,10,15,1,15,0,0,2,0,2,0
19898,110,3652,1660,832,1314,41,38,274,1701,20,312,209,395,332,604,2671,5058,12,64042,3557,1,2,1,1,0
19899,110,3652,1057,646,719,113,100,145,1170,18,215,134,248,233,382,1740,3004,10,31186,1732,1,2,1,1,0
19900,79,1590,1660,832,1314,41,38,274,1701,20,312,209,395,332,604,2671,5058,12,64042,3557,1,2,6,0,0
19901,78,1584,1660,832,1314,41,38,274,1701,20,312,209,395,332,604,2671,5058,12,64042,3557,1,2,0,2,0
19925,6,286,42,7,35,4,0,5,46,1,2,1,2,3,3,2,4,0,2,0,0,2,2,2,1
19926,6,286,11,6,10,0,0,1,11,2,4,2,4,6,6,10,15,1,15,0,0,2,2,2,1
19952,6,286,42,7,35,4,0,5,46,1,2,1,2,3,3,2,4,0,2,0,0,2,2,2,0
19953,6,286,11,6,10,0,0,1,11,2,4,2,4,6,6,10,15,1,15,0,0,2,2,2,0
19954,78,1584,1660,832,1314,41,38,274,1701,20,312,209,395,332,604,2671,5058,12,64042,3557,1,2,4,0,0
19978,68,1200,1513,682,1277,25,13,200,1538,11,199,116,219,210,335,1557,2584,6,15641,868,0,2,1,4,1
19979,68,1200,819,519,539,24,98,155,843,15,96,57,106,111,163,690,1107,8,9171,509,0,2,1,4,1
19980,42,1319,1523,757,1297,19,12,193,1542,12,193,117,230,205,347,1508,2664,7,19053,1058,0,2,10,2,1
19981,42,1319,701,378,504,33,58,109,734,13,110,68,126,123,194,794,1346,7,10027,557,0,2,10,2,1
19982,86,1940,1043,504,840,53,9,147,1096,9,180,112,198,189,310,1377,2344,4,11604,644,0,2,8,2,1
19983,86,1940,383,288,292,26,6,62,409,11,65,38,67,76,105,429,656,5,3719,206,0,2,8,2,1
19984,146,2909,1943,715,1694,26,18,214,1969,12,185,120,237,197,357,1436,2721,7,20915,1161,0,2,10,2,1
19985,146,2909,1168,838,957,57,25,144,1225,19,348,224,416,367,640,3018,5452,11,61921,3440,1,2,10,2,1
19988,30,1925,1523,757,1297,19,12,193,1542,12,193,117,230,205,347,1508,2664,7,19053,1058,0,2,12,1,1
19989,54,2487,1943,715,1694,26,18,214,1969,12,185,120,237,197,357,1436,2721,7,20915,1161,0,2,7,4,1
19990,113,3706,1660,832,1314,41,38,274,1701,20,312,209,395,332,604,2671,5058,12,64042,3557,1,2,19,9,1
19991,113,3706,1057,646,719,113,100,145,1170,18,215,134,248,233,382,1740,3004,10,31186,1732,1,2,19,9,1
19992,79,1630,1660,832,1314,41,38,274,1701,20,312,209,395,332,604,2671,5058,12,64042,3557,1,2,11,0,1
20016,42,1306,1523,757,1297,19,12,193,1542,12,193,117,230,205,347,1508,2664,7,19053,1058,0,2,4,6,1
20017,42,1306,701,378,504,33,58,109,734,13,110,68,126,123,194,794,1346,7,10027,557,0,2,4,6,1
20018,6,286,42,7,35,4,0,5,46,1,2,1,2,3,3,2,4,0,2,0,0,2,1,1,1
20019,6,286,11,6,10,0,0,1,11,2,4,2,4,6,6,10,15,1,15,0,0,2,1,1,1
20020,30,1925,1523,757,1297,19,12,193,1542,12,193,117,230,205,347,1508,2664,7,19053,1058,0,2,4,2,1
20021,114,3710,1660,832,1314,41,38,274,1701,20,312,209,395,332,604,2671,5058,12,64042,3557,1,2,7,7,1
20022,114,3710,1057,646,719,113,100,145,1170,18,215,134,248,233,382,1740,3004,10,31186,1732,1,2,7,7,1
20023,80,1664,1660,832,1314,41,38,274,1701,20,312,209,395,332,604,2671,5058,12,64042,3557,1,2,10,0,1
20047,42,1306,1523,757,1297,19,12,193,1542,12,193,117,230,205,347,1508,2664,7,19053,1058,0,2,4,6,0
20048,42,1306,701,378,504,33,58,109,734,13,110,68,126,123,194,794,1346,7,10027,557,0,2,4,6,0
20049,6,286,42,7,35,4,0,5,46,1,2,1,2,3,3,2,4,0,2,0,0,2,1,1,0
20050,6,286,11,6,10,0,0,1,11,2,4,2,4,6,6,10,15,1,15,0,0,2,1,1,0
20051,30,1925,1523,757,1297,19,12,193,1542,12,193,117,230,205,347,1508,2664,7,19053,1058,0,2,4,2,0
20052,114,3710,1660,832,1314,41,38,274,1701,20,312,209,395,332,604,2671,5058,12,64042,3557,1,2,1,1,1
20053,114,3710,1057,646,719,113,100,145,1170,18,215,134,248,233,382,1740,3004,10,31186,1732,1,2,1,1,1
20054,81,1691,1660,832,1314,41,38,274,1701,20,312,209,395,332,604,2671,5058,12,64042,3557,1,2,4,0,1
20055,82,1720,1660,832,1314,41,38,274,1701,20,312,209,395,332,604,2671,5058,12,64042,3557,1,2,4,0,0
20056,136,2683,1457,730,1242,11,6,188,1468,10,292,166,329,302,495,2424,4078,5,22973,1276,1,2,1,2,1
20057,136,2683,74,35,59,1,0,14,75,3,14,7,14,17,21,58,85,1,128,7,0,2,1,2,1
20058,136,2683,245,125,200,5,7,34,250,7,30,17,34,37,51,166,265,3,1053,58,0,2,1,2,1
20059,42,1096,74,35,59,1,0,14,75,3,14,7,14,17,21,58,85,1,128,7,0,2,24,2,1
20060,42,1096,245,125,200,5,7,34,250,7,30,17,34,37,51,166,265,3,1053,58,0,2,24,2,1
20061,28,1512,1457,730,1242,11,6,188,1468,10,292,166,329,302,495,2424,4078,5,22973,1276,1,2,1,1,1
20062,11,350,74,35,59,1,0,14,75,3,14,7,14,17,21,58,85,1,128,7,0,2,14,0,1
20063,52,2415,1943,715,1694,26,18,214,1969,12,185,120,237,197,357,1436,2721,7,20915,1161,0,2,0,15,1
20087,115,3763,1660,832,1314,41,38,274,1701,20,312,209,395,332,604,2671,5058,12,64042,3557,1,2,9,0,1
20088,115,3763,1057,646,719,113,100,145,1170,18,215,134,248,233,382,1740,3004,10,31186,1732,1,2,9,0,1
20091,1,191,382,65,130,157,2,92,539,4,10,5,10,14,15,41,57,2,114,6,0,2,9,7,0
20094,24,527,2,2,2,0,0,0,2,0,0,0,0,0,0,0,0,0,0,0,0,2,7,1,1
20108,24,527,99,48,90,1,3,5,100,0,0,0,0,0,0,0,0,0,0,0,0,2,7,1,1
20109,24,527,8,5,5,2,0,1,10,0,0,0,0,0,0,0,0,0,0,0,0,2,7,1,1
20110,24,527,1217,716,841,84,126,174,1301,14,185,118,215,199,333,1446,2542,8,20687,1149,0,2,7,1,1
20111,24,527,160,89,115,0,13,31,160,7,15,11,17,22,28,78,124,3,495,27,0,2,7,1,1
20112,24,527,10,10,9,9,0,0,19,0,0,0,0,0,0,0,0,0,0,0,0,2,7,1,1
20113,24,527,173,84,99,8,29,36,181,5,12,7,13,17,20,54,81,2,221,12,0,2,7,1,1
20114,24,527,3,1,1,3,0,0,6,0,0,0,0,0,0,0,0,0,0,0,0,2,7,1,1
20115,84,1745,1660,832,1314,41,38,274,1701,20,312,209,395,332,604,2671,5058,12,64042,3557,1,2,5,0,1
20116,84,1745,1660,832,1314,41,38,274,1701,20,312,209,395,332,604,2671,5058,12,64042,3557,1,2,2,1,0
20117,84,1747,1660,832,1314,41,38,274,1701,20,312,209,395,332,604,2671,5058,12,64042,3557,1,2,1,1,0
20118,84,1759,1660,832,1314,41,38,274,1701,20,312,209,395,332,604,2671,5058,12,64042,3557,1,2,3,2,1
20119,120,3799,1660,832,1314,41,38,274,1701,20,312,209,395,332,604,2671,5058,12,64042,3557,1,2,29,12,1
20120,120,3799,1057,646,719,113,100,145,1170,18,215,134,248,233,382,1740,3004,10,31186,1732,1,2,29,12,1
20121,87,1884,1660,832,1314,41,38,274,1701,20,312,209,395,332,604,2671,5058,12,64042,3557,1,2,24,0,1
20122,120,3797,1660,832,1314,41,38,274,1701,20,312,209,395,332,604,2671,5058,12,64042,3557,1,2,0,1,0
20123,120,3797,1057,646,719,113,100,145,1170,18,215,134,248,233,382,1740,3004,10,31186,1732,1,2,0,1,0
20124,22,519,1293,570,1093,25,15,163,1318,10,195,123,241,205,364,1516,2795,6,17273,959,0,2,11,1,0
20125,17,678,1293,570,1093,25,15,163,1318,10,195,123,241,205,364,1516,2795,6,17273,959,0,2,13,0,0
20126,122,3814,1660,832,1314,41,38,274,1701,20,312,209,395,332,604,2671,5058,12,64042,3557,1,2,3,1,1
20127,122,3814,1057,646,719,113,100,145,1170,18,215,134,248,233,382,1740,3004,10,31186,1732,1,2,3,1,1
20128,124,3828,1660,832,1314,41,38,274,1701,20,312,209,395,332,604,2671,5058,12,64042,3557,1,2,2,1,0
20129,124,3828,1057,646,719,113,100,145,1170,18,215,134,248,233,382,1740,3004,10,31186,1732,1,2,2,1,0
20130,43,1893,1289,550,1043,56,32,155,1345,10,167,93,185,177,278,1266,2075,5,11498,638,0,2,1,1,0
20131,120,3818,1660,832,1314,41,38,274,1701,20,312,209,395,332,604,2671,5058,12,64042,3557,1,2,8,4,1
20132,120,3818,1057,646,719,113,100,145,1170,18,215,134,248,233,382,1740,3004,10,31186,1732,1,2,8,4,1
20158,120,3818,1660,832,1314,41,38,274,1701,20,312,209,395,332,604,2671,5058,12,64042,3557,1,2,8,4,0
20159,120,3818,1057,646,719,113,100,145,1170,18,215,134,248,233,382,1740,3004,10,31186,1732,1,2,8,4,0
20160,33,542,127,75,83,2,11,30,129,4,14,7,14,18,21,61,87,2,175,9,0,2,4,2,1
20161,33,542,652,304,544,16,6,88,668,6,89,51,101,95,152,591,998,3,3399,188,0,2,4,2,1
20162,33,542,2,2,2,0,0,0,2,0,0,0,0,0,0,0,0,0,0,0,0,2,4,2,1
20163,33,542,8,5,5,0,0,3,8,0,0,0,0,0,0,0,0,0,0,0,0,2,4,2,1
20166,33,542,14,8,8,0,0,6,14,0,0,0,0,0,0,0,0,0,0,0,0,2,4,2,1
20167,33,542,6,4,4,0,0,2,6,0,0,0,0,0,0,0,0,0,0,0,0,2,4,2,1
20168,33,542,6,4,4,0,0,2,6,1,2,1,2,3,3,2,4,0,2,0,0,2,4,2,1
20170,33,542,7,5,5,0,0,2,7,0,0,0,0,0,0,0,0,0,0,0,0,2,4,2,1
20172,33,542,10,6,6,0,0,4,10,0,0,0,0,0,0,0,0,0,0,0,0,2,4,2,1
20173,33,542,1,1,1,0,0,0,1,0,0,0,0,0,0,0,0,0,0,0,0,2,4,2,1
20175,33,542,14,10,10,0,0,4,14,1,1,1,1,2,2,0,2,0,1,0,0,2,4,2,1
20176,33,542,46,26,30,3,0,12,49,3,6,3,6,9,9,20,28,1,42,2,0,2,4,2,1
20200,6,286,42,7,35,4,0,5,46,1,2,1,2,3,3,2,4,0,2,0,0,2,3,3,1
20201,6,286,11,6,10,0,0,1,11,2,4,2,4,6,6,10,15,1,15,0,0,2,3,3,1
20202,120,3830,1660,832,1314,41,38,274,1701,20,312,209,395,332,604,2671,5058,12,64042,3557,1,2,4,1,1
20203,120,3830,1057,646,719,113,100,145,1170,18,215,134,248,233,382,1740,3004,10,31186,1732,1,2,4,1,1
20204,88,1968,1660,832,1314,41,38,274,1701,20,312,209,395,332,604,2671,5058,12,64042,3557,1,2,14,0,1
20205,120,3838,1660,832,1314,41,38,274,1701,20,312,209,395,332,604,2671,5058,12,64042,3557,1,2,1,1,0
20206,120,3838,1057,646,719,113,100,145,1170,18,215,134,248,233,382,1740,3004,10,31186,1732,1,2,1,1,0
20207,89,2022,1660,832,1314,41,38,274,1701,20,312,209,395,332,604,2671,5058,12,64042,3557,1,2,9,0,0
20208,118,3763,1660,832,1314,41,38,274,1701,20,312,209,395,332,604,2671,5058,12,64042,3557,1,2,7,18,1
20209,118,3763,1057,646,719,113,100,145,1170,18,215,134,248,233,382,1740,3004,10,31186,1732,1,2,7,18,1
20210,117,3766,1660,832,1314,41,38,274,1701,20,312,209,395,332,604,2671,5058,12,64042,3557,1,2,12,13,1
20211,117,3766,1057,646,719,113,100,145,1170,18,215,134,248,233,382,1740,3004,10,31186,1732,1,2,12,13,1
20212,94,2079,1660,832,1314,41,38,274,1701,20,312,209,395,332,604,2671,5058,12,64042,3557,1,2,8,0,1
20213,146,3319,77,34,69,0,0,8,77,3,24,16,29,27,45,114,213,1,387,21,0,2,17,11,1
20214,146,3319,712,438,573,51,9,84,763,14,102,71,128,116,199,733,1364,8,11988,666,0,2,17,11,1
20215,44,1956,1289,550,1043,56,32,155,1345,10,167,93,185,177,278,1266,2075,5,11498,638,0,2,11,0,1
20216,44,1956,1289,550,1043,56,32,155,1345,10,167,93,185,177,278,1266,2075,5,11498,638,0,2,2,0,0
20240,146,3319,77,34,69,0,0,8,77,3,24,16,29,27,45,114,213,1,387,21,0,2,17,11,0
20241,146,3319,712,438,573,51,9,84,763,14,102,71,128,116,199,733,1364,8,11988,666,0,2,17,11,0
20244,44,1956,1289,550,1043,56,32,155,1345,10,167,93,185,177,278,1266,2075,5,11498,638,0,2,15,2,0
20245,118,3822,1660,832,1314,41,38,274,1701,20,312,209,395,332,604,2671,5058,12,64042,3557,1,2,9,0,1
20246,118,3822,1057,646,719,113,100,145,1170,18,215,134,248,233,382,1740,3004,10,31186,1732,1,2,9,0,1
20247,95,2123,1660,832,1314,41,38,274,1701,20,312,209,395,332,604,2671,5058,12,64042,3557,1,2,6,0,1
20248,44,1956,1289,550,1043,56,32,155,1345,10,167,93,185,177,278,1266,2075,5,11498,638,0,2,1,1,1
20274,25,542,2,2,2,0,0,0,2,0,0,0,0,0,0,0,0,0,0,0,0,2,3,0,1
20288,25,542,99,48,90,1,3,5,100,0,0,0,0,0,0,0,0,0,0,0,0,2,3,0,1
20289,25,542,8,5,5,2,0,1,10,0,0,0,0,0,0,0,0,0,0,0,0,2,3,0,1
20290,25,542,1217,716,841,84,126,174,1301,14,185,118,215,199,333,1446,2542,8,20687,1149,0,2,3,0,1
20291,25,542,160,89,115,0,13,31,160,7,15,11,17,22,28,78,124,3,495,27,0,2,3,0,1
20292,25,542,10,10,9,9,0,0,19,0,0,0,0,0,0,0,0,0,0,0,0,2,3,0,1
20293,25,542,173,84,99,8,29,36,181,5,12,7,13,17,20,54,81,2,221,12,0,2,3,0,1
20294,25,542,3,1,1,3,0,0,6,0,0,0,0,0,0,0,0,0,0,0,0,2,3,0,1
20297,44,1965,1289,550,1043,56,32,155,1345,10,167,93,185,177,278,1266,2075,5,11498,638,0,2,1,0,1
20298,32,1156,1450,624,1228,12,26,181,1462,14,306,186,354,320,540,2580,4493,8,36391,2021,1,2,1,1,1
20299,95,2139,1660,832,1314,41,38,274,1701,20,312,209,395,332,604,2671,5058,12,64042,3557,1,2,3,0,1
20300,25,1230,652,304,544,16,6,88,668,6,89,51,101,95,152,591,998,3,3399,188,0,2,1,1,1
20326,40,1253,1523,757,1297,19,12,193,1542,12,193,117,230,205,347,1508,2664,7,19053,1058,0,2,1,9,1
20327,40,1253,701,378,504,33,58,109,734,13,110,68,126,123,194,794,1346,7,10027,557,0,2,1,9,1
20328,87,1986,1043,504,840,53,9,147,1096,9,180,112,198,189,310,1377,2344,4,11604,644,0,2,17,8,1
20329,87,1986,383,288,292,26,6,62,409,11,65,38,67,76,105,429,656,5,3719,206,0,2,17,8,1
20355,40,1253,1523,757,1297,19,12,193,1542,12,193,117,230,205,347,1508,2664,7,19053,1058,0,2,1,9,0
20356,40,1253,701,378,504,33,58,109,734,13,110,68,126,123,194,794,1346,7,10027,557,0,2,1,9,0
20357,87,1986,1043,504,840,53,9,147,1096,9,180,112,198,189,310,1377,2344,4,11604,644,0,2,17,8,0
20358,87,1986,383,288,292,26,6,62,409,11,65,38,67,76,105,429,656,5,3719,206,0,2,17,8,0
20359,185,4416,722,423,573,19,0,135,741,12,172,101,199,184,300,1320,2257,6,15668,870,0,2,1,0,0
20360,185,4416,1508,847,911,44,250,301,1552,14,148,88,169,162,257,1120,1886,7,15077,837,0,2,1,0,0
20361,34,1575,1178,367,1042,6,15,115,1184,9,94,51,95,103,146,644,976,4,4439,246,0,2,6,1,0
20362,136,2684,1457,730,1242,11,6,188,1468,10,292,166,329,302,495,2424,4078,5,22973,1276,1,2,1,1,1
20363,136,2684,74,35,59,1,0,14,75,3,14,7,14,17,21,58,85,1,128,7,0,2,1,1,1
20364,136,2684,245,125,200,5,7,34,250,7,30,17,34,37,51,166,265,3,1053,58,0,2,1,1,1
20365,29,1532,1457,730,1242,11,6,188,1468,10,292,166,329,302,495,2424,4078,5,22973,1276,1,2,3,0,1
20366,80,1402,1178,367,1042,6,15,115,1184,9,94,51,95,103,146,644,976,4,4439,246,0,2,6,4,1
20367,80,1402,177,108,140,8,0,27,185,6,30,16,32,36,48,162,248,3,794,44,0,2,6,4,1
20368,146,2909,1943,715,1694,26,18,214,1969,12,185,120,237,197,357,1436,2721,7,20915,1161,0,2,1,1,1
20369,146,2909,1168,838,957,57,25,144,1225,19,348,224,416,367,640,3018,5452,11,61921,3440,1,2,1,1,1
20370,35,1612,1178,367,1042,6,15,115,1184,9,94,51,95,103,146,644,976,4,4439,246,0,2,15,0,1
20371,118,3822,1660,832,1314,41,38,274,1701,20,312,209,395,332,604,2671,5058,12,64042,3557,1,2,3,3,1
20372,118,3822,1057,646,719,113,100,145,1170,18,215,134,248,233,382,1740,3004,10,31186,1732,1,2,3,3,1
20373,99,2192,1660,832,1314,41,38,274,1701,20,312,209,395,332,604,2671,5058,12,64042,3557,1,2,8,0,1
20374,118,3825,1660,832,1314,41,38,274,1701,20,312,209,395,332,604,2671,5058,12,64042,3557,1,2,1,1,0
20375,118,3825,1057,646,719,113,100,145,1170,18,215,134,248,233,382,1740,3004,10,31186,1732,1,2,1,1,0
20378,27,563,2,2,2,0,0,0,2,0,0,0,0,0,0,0,0,0,0,0,0,2,18,13,1
20392,27,563,99,48,90,1,3,5,100,0,0,0,0,0,0,0,0,0,0,0,0,2,18,13,1
20393,27,563,8,5,5,2,0,1,10,0,0,0,0,0,0,0,0,0,0,0,0,2,18,13,1
20394,27,563,1217,716,841,84,126,174,1301,14,185,118,215,199,333,1446,2542,8,20687,1149,0,2,18,13,1
20395,27,563,160,89,115,0,13,31,160,7,15,11,17,22,28,78,124,3,495,27,0,2,18,13,1
20396,27,563,10,10,9,9,0,0,19,0,0,0,0,0,0,0,0,0,0,0,0,2,18,13,1
20397,27,563,173,84,99,8,29,36,181,5,12,7,13,17,20,54,81,2,221,12,0,2,18,13,1
20398,27,563,3,1,1,3,0,0,6,0,0,0,0,0,0,0,0,0,0,0,0,2,18,13,1
20399,32,1222,1450,624,1228,12,26,181,1462,14,306,186,354,320,540,2580,4493,8,36391,2021,1,2,22,9,1
20425,147,3343,77,34,69,0,0,8,77,3,24,16,29,27,45,114,213,1,387,21,0,2,9,0,1
20426,147,3343,712,438,573,51,9,84,763,14,102,71,128,116,199,733,1364,8,11988,666,0,2,9,0,1
20427,44,1999,1289,550,1043,56,32,155,1345,10,167,93,185,177,278,1266,2075,5,11498,638,0,2,8,0,1
20428,44,1989,1289,550,1043,56,32,155,1345,10,167,93,185,177,278,1266,2075,5,11498,638,0,2,2,5,0
20429,147,3343,77,34,69,0,0,8,77,3,24,16,29,27,45,114,213,1,387,21,0,2,3,3,0
20430,147,3343,712,438,573,51,9,84,763,14,102,71,128,116,199,733,1364,8,11988,666,0,2,3,3,0
20454,187,4460,722,423,573,19,0,135,741,12,172,101,199,184,300,1320,2257,6,15668,870,0,2,9,0,0
20455,187,4460,1508,847,911,44,250,301,1552,14,148,88,169,162,257,1120,1886,7,15077,837,0,2,9,0,0
20458,33,542,127,75,83,2,11,30,129,4,14,7,14,18,21,61,87,2,175,9,0,2,1,1,0
20459,33,542,652,304,544,16,6,88,668,6,89,51,101,95,152,591,998,3,3399,188,0,2,1,1,0
20460,33,542,2,2,2,0,0,0,2,0,0,0,0,0,0,0,0,0,0,0,0,2,1,1,0
20461,33,542,8,5,5,0,0,3,8,0,0,0,0,0,0,0,0,0,0,0,0,2,1,1,0
20464,33,542,14,8,8,0,0,6,14,0,0,0,0,0,0,0,0,0,0,0,0,2,1,1,0
20465,33,542,6,4,4,0,0,2,6,0,0,0,0,0,0,0,0,0,0,0,0,2,1,1,0
20466,33,542,6,4,4,0,0,2,6,1,2,1,2,3,3,2,4,0,2,0,0,2,1,1,0
20468,33,542,7,5,5,0,0,2,7,0,0,0,0,0,0,0,0,0,0,0,0,2,1,1,0
20470,33,542,10,6,6,0,0,4,10,0,0,0,0,0,0,0,0,0,0,0,0,2,1,1,0
20471,33,542,1,1,1,0,0,0,1,0,0,0,0,0,0,0,0,0,0,0,0,2,1,1,0
20473,33,542,14,10,10,0,0,4,14,1,1,1,1,2,2,0,2,0,1,0,0,2,1,1,0
20474,33,542,46,26,30,3,0,12,49,3,6,3,6,9,9,20,28,1,42,2,0,2,1,1,0
20498,11,347,442,244,305,14,16,103,456,11,68,45,75,79,120,452,756,6,4588,254,0,2,2,2,1
20499,11,347,182,102,99,11,40,35,193,3,11,6,11,14,17,42,64,1,97,5,0,2,2,2,1
20502,8,544,442,244,305,14,16,103,456,11,68,45,75,79,120,452,756,6,4588,254,0,2,13,0,1
20526,69,1231,1513,682,1277,25,13,200,1538,11,199,116,219,210,335,1557,2584,6,15641,868,0,2,21,19,1
20527,69,1231,819,519,539,24,98,155,843,15,96,57,106,111,163,690,1107,8,9171,509,0,2,21,19,1
20528,137,2694,1457,730,1242,11,6,188,1468,10,292,166,329,302,495,2424,4078,5,22973,1276,1,2,14,8,1
20529,137,2694,74,35,59,1,0,14,75,3,14,7,14,17,21,58,85,1,128,7,0,2,14,8,1
20530,137,2694,245,125,200,5,7,34,250,7,30,17,34,37,51,166,265,3,1053,58,0,2,14,8,1
20531,42,1104,74,35,59,1,0,14,75,3,14,7,14,17,21,58,85,1,128,7,0,2,2,1,1
20532,42,1104,245,125,200,5,7,34,250,7,30,17,34,37,51,166,265,3,1053,58,0,2,2,1,1
20533,147,3343,77,34,69,0,0,8,77,3,24,16,29,27,45,114,213,1,387,21,0,2,6,6,1
20534,147,3343,712,438,573,51,9,84,763,14,102,71,128,116,199,733,1364,8,11988,666,0,2,6,6,1
20535,179,4314,722,423,573,19,0,135,741,12,172,101,199,184,300,1320,2257,6,15668,870,0,2,42,68,1
20536,179,4314,1508,847,911,44,250,301,1552,14,148,88,169,162,257,1120,1886,7,15077,837,0,2,42,68,1
20537,144,2897,1943,715,1694,26,18,214,1969,12,185,120,237,197,357,1436,2721,7,20915,1161,0,2,2,6,1
20538,144,2897,1168,838,957,57,25,144,1225,19,348,224,416,367,640,3018,5452,11,61921,3440,1,2,2,6,1
20541,45,2034,1289,550,1043,56,32,155,1345,10,167,93,185,177,278,1266,2075,5,11498,638,0,2,11,5,1
20542,35,613,127,75,83,2,11,30,129,4,14,7,14,18,21,61,87,2,175,9,0,2,19,11,1
20543,35,613,652,304,544,16,6,88,668,6,89,51,101,95,152,591,998,3,3399,188,0,2,19,11,1
20544,35,613,2,2,2,0,0,0,2,0,0,0,0,0,0,0,0,0,0,0,0,2,19,11,1
20545,35,613,8,5,5,0,0,3,8,0,0,0,0,0,0,0,0,0,0,0,0,2,19,11,1
20548,35,613,14,8,8,0,0,6,14,0,0,0,0,0,0,0,0,0,0,0,0,2,19,11,1
20549,35,613,6,4,4,0,0,2,6,0,0,0,0,0,0,0,0,0,0,0,0,2,19,11,1
20550,35,613,6,4,4,0,0,2,6,1,2,1,2,3,3,2,4,0,2,0,0,2,19,11,1
20552,35,613,7,5,5,0,0,2,7,0,0,0,0,0,0,0,0,0,0,0,0,2,19,11,1
20554,35,613,10,6,6,0,0,4,10,0,0,0,0,0,0,0,0,0,0,0,0,2,19,11,1
20555,35,613,1,1,1,0,0,0,1,0,0,0,0,0,0,0,0,0,0,0,0,2,19,11,1
20557,35,613,14,10,10,0,0,4,14,1,1,1,1,2,2,0,2,0,1,0,0,2,19,11,1
20558,35,613,46,26,30,3,0,12,49,3,6,3,6,9,9,20,28,1,42,2,0,2,19,11,1
20559,39,1597,1513,682,1277,25,13,200,1538,11,199,116,219,210,335,1557,2584,6,15641,868,0,2,17,14,1
20560,42,2708,1296,573,1062,40,33,157,1336,8,201,118,231,209,349,1561,2689,4,12365,686,0,2,17,50,1
20561,29,1472,1457,730,1242,11,6,188,1468,10,292,166,329,302,495,2424,4078,5,22973,1276,1,2,17,21,1
20562,30,1144,1020,354,843,12,15,144,1032,8,134,77,144,142,221,970,1580,4,6792,377,0,2,0,52,1
20563,6,462,442,244,305,14,16,103,456,11,68,45,75,79,120,452,756,6,4588,254,0,2,0,11,1
20564,180,4318,722,423,573,19,0,135,741,12,172,101,199,184,300,1320,2257,6,15668,870,0,2,1,1,0
20565,180,4318,1508,847,911,44,250,301,1552,14,148,88,169,162,257,1120,1886,7,15077,837,0,2,1,1,0
20566,6,472,442,244,305,14,16,103,456,11,68,45,75,79,120,452,756,6,4588,254,0,2,2,1,1
20567,6,464,442,244,305,14,16,103,456,11,68,45,75,79,120,452,756,6,4588,254,0,2,2,2,1
20591,184,4339,722,423,573,19,0,135,741,12,172,101,199,184,300,1320,2257,6,15668,870,0,2,8,1,1
20592,184,4339,1508,847,911,44,250,301,1552,14,148,88,169,162,257,1120,1886,7,15077,837,0,2,8,1,1
20593,96,2185,1043,504,840,53,9,147,1096,9,180,112,198,189,310,1377,2344,4,11604,644,0,2,34,2,1
20594,96,2185,383,288,292,26,6,62,409,11,65,38,67,76,105,429,656,5,3719,206,0,2,34,2,1
20597,51,2211,1289,550,1043,56,32,155,1345,10,167,93,185,177,278,1266,2075,5,11498,638,0,2,45,0,1
20621,45,430,647,139,84,35,284,233,682,0,0,0,0,0,0,0,0,0,0,0,0,2,2,1,1
20622,41,1260,1523,757,1297,19,12,193,1542,12,193,117,230,205,347,1508,2664,7,19053,1058,0,2,2,1,1
20623,41,1260,701,378,504,33,58,109,734,13,110,68,126,123,194,794,1346,7,10027,557,0,2,2,1,1
20624,184,4339,722,423,573,19,0,135,741,12,172,101,199,184,300,1320,2257,6,15668,870,0,2,2,2,1
20625,184,4339,1508,847,911,44,250,301,1552,14,148,88,169,162,257,1120,1886,7,15077,837,0,2,2,2,1
20626,28,574,215,129,180,6,0,29,221,8,65,43,72,73,115,415,711,4,3153,175,0,2,2,0,1
20627,28,574,97,69,77,3,3,16,100,6,22,13,23,28,36,113,173,3,542,30,0,2,2,0,1
20628,95,2257,1043,504,840,53,9,147,1096,9,180,112,198,189,310,1377,2344,4,11604,644,0,2,14,3,1
20629,95,2257,383,288,292,26,6,62,409,11,65,38,67,76,105,429,656,5,3719,206,0,2,14,3,1
20630,145,2900,1943,715,1694,26,18,214,1969,12,185,120,237,197,357,1436,2721,7,20915,1161,0,2,4,3,1
20631,145,2900,1168,838,957,57,25,144,1225,19,348,224,416,367,640,3018,5452,11,61921,3440,1,2,4,3,1
20634,52,2269,1289,550,1043,56,32,155,1345,10,167,93,185,177,278,1266,2075,5,11498,638,0,2,25,0,1
20635,30,1144,1020,354,843,12,15,144,1032,8,134,77,144,142,221,970,1580,4,6792,377,0,2,1,1,1
20636,55,2337,1289,550,1043,56,32,155,1345,10,167,93,185,177,278,1266,2075,5,11498,638,0,2,66,52,1
20660,95,2262,1043,504,840,53,9,147,1096,9,180,112,198,189,310,1377,2344,4,11604,644,0,2,2,1,1
20661,95,2262,383,288,292,26,6,62,409,11,65,38,67,76,105,429,656,5,3719,206,0,2,2,1,1
20687,95,2264,1043,504,840,53,9,147,1096,9,180,112,198,189,310,1377,2344,4,11604,644,0,2,3,4,1
20688,95,2264,383,288,292,26,6,62,409,11,65,38,67,76,105,429,656,5,3719,206,0,2,3,4,1
20691,56,2390,1289,550,1043,56,32,155,1345,10,167,93,185,177,278,1266,2075,5,11498,638,0,2,10,0,1
20715,94,2179,1043,504,840,53,9,147,1096,9,180,112,198,189,310,1377,2344,4,11604,644,0,2,8,12,1
20716,94,2179,383,288,292,26,6,62,409,11,65,38,67,76,105,429,656,5,3719,206,0,2,8,12,1
20719,56,2377,1289,550,1043,56,32,155,1345,10,167,93,185,177,278,1266,2075,5,11498,638,0,2,0,2,1
20720,56,2375,1289,550,1043,56,32,155,1345,10,167,93,185,177,278,1266,2075,5,11498,638,0,2,0,2,0
20721,56,2373,1289,550,1043,56,32,155,1345,10,167,93,185,177,278,1266,2075,5,11498,638,0,2,3,4,1
20722,94,2175,1043,504,840,53,9,147,1096,9,180,112,198,189,310,1377,2344,4,11604,644,0,2,1,8,0
20723,94,2175,383,288,292,26,6,62,409,11,65,38,67,76,105,429,656,5,3719,206,0,2,1,8,0
20724,185,4352,722,423,573,19,0,135,741,12,172,101,199,184,300,1320,2257,6,15668,870,0,2,2,0,0
20725,185,4352,1508,847,911,44,250,301,1552,14,148,88,169,162,257,1120,1886,7,15077,837,0,2,2,0,0
20726,138,2726,1457,730,1242,11,6,188,1468,10,292,166,329,302,495,2424,4078,5,22973,1276,1,2,9,0,1
20727,138,2726,74,35,59,1,0,14,75,3,14,7,14,17,21,58,85,1,128,7,0,2,9,0,1
20728,138,2726,245,125,200,5,7,34,250,7,30,17,34,37,51,166,265,3,1053,58,0,2,9,0,1
20729,31,1642,1457,730,1242,11,6,188,1468,10,292,166,329,302,495,2424,4078,5,22973,1276,1,2,34,0,1
20753,147,3357,77,34,69,0,0,8,77,3,24,16,29,27,45,114,213,1,387,21,0,2,3,0,1
20754,147,3357,712,438,573,51,9,84,763,14,102,71,128,116,199,733,1364,8,11988,666,0,2,3,0,1
20755,57,1036,1020,354,843,12,15,144,1032,8,134,77,144,142,221,970,1580,4,6792,377,0,2,40,2,1
20756,81,1431,1178,367,1042,6,15,115,1184,9,94,51,95,103,146,644,976,4,4439,246,0,2,15,0,1
20757,81,1431,177,108,140,8,0,27,185,6,30,16,32,36,48,162,248,3,794,44,0,2,15,0,1
20760,35,622,127,75,83,2,11,30,129,4,14,7,14,18,21,61,87,2,175,9,0,2,4,0,1
20761,35,622,652,304,544,16,6,88,668,6,89,51,101,95,152,591,998,3,3399,188,0,2,4,0,1
20762,35,622,2,2,2,0,0,0,2,0,0,0,0,0,0,0,0,0,0,0,0,2,4,0,1
20763,35,622,8,5,5,0,0,3,8,0,0,0,0,0,0,0,0,0,0,0,0,2,4,0,1
20766,35,622,14,8,8,0,0,6,14,0,0,0,0,0,0,0,0,0,0,0,0,2,4,0,1
20767,35,622,6,4,4,0,0,2,6,0,0,0,0,0,0,0,0,0,0,0,0,2,4,0,1
20768,35,622,6,4,4,0,0,2,6,1,2,1,2,3,3,2,4,0,2,0,0,2,4,0,1
20770,35,622,7,5,5,0,0,2,7,0,0,0,0,0,0,0,0,0,0,0,0,2,4,0,1
20772,35,622,10,6,6,0,0,4,10,0,0,0,0,0,0,0,0,0,0,0,0,2,4,0,1
20773,35,622,1,1,1,0,0,0,1,0,0,0,0,0,0,0,0,0,0,0,0,2,4,0,1
20775,35,622,14,10,10,0,0,4,14,1,1,1,1,2,2,0,2,0,1,0,0,2,4,0,1
20776,35,622,46,26,30,3,0,12,49,3,6,3,6,9,9,20,28,1,42,2,0,2,4,0,1
20777,33,1248,1020,354,843,12,15,144,1032,8,134,77,144,142,221,970,1580,4,6792,377,0,2,47,0,1
20778,36,1639,1178,367,1042,6,15,115,1184,9,94,51,95,103,146,644,976,4,4439,246,0,2,7,0,1
20802,63,1149,1020,354,843,12,15,144,1032,8,134,77,144,142,221,970,1580,4,6792,377,0,2,23,3,1
20803,147,2943,1943,715,1694,26,18,214,1969,12,185,120,237,197,357,1436,2721,7,20915,1161,0,2,8,1,1
20804,147,2943,1168,838,957,57,25,144,1225,19,348,224,416,367,640,3018,5452,11,61921,3440,1,2,8,1,1
20807,35,1375,1020,354,843,12,15,144,1032,8,134,77,144,142,221,970,1580,4,6792,377,0,2,24,0,1
20808,52,2415,1943,715,1694,26,18,214,1969,12,185,120,237,197,357,1436,2721,7,20915,1161,0,2,1,1,1
20809,14,457,184,100,137,2,15,30,186,6,38,20,39,44,59,214,322,3,991,55,0,2,5,1,1
20810,14,457,103,65,74,8,5,16,111,7,17,9,17,24,26,89,119,3,417,23,0,2,5,1,1
20811,7,293,184,100,137,2,15,30,186,6,38,20,39,44,59,214,322,3,991,55,0,2,12,0,1
20812,23,554,1293,570,1093,25,15,163,1318,10,195,123,241,205,364,1516,2795,6,17273,959,0,2,7,1,1
20813,19,756,1293,570,1093,25,15,163,1318,10,195,123,241,205,364,1516,2795,6,17273,959,0,2,20,0,1
20814,14,457,184,100,137,2,15,30,186,6,38,20,39,44,59,214,322,3,991,55,0,2,5,1,0
20815,14,457,103,65,74,8,5,16,111,7,17,9,17,24,26,89,119,3,417,23,0,2,5,1,0
20816,7,293,184,100,137,2,15,30,186,6,38,20,39,44,59,214,322,3,991,55,0,2,12,0,0
20840,247,5301,72,33,56,0,4,12,72,1,1,1,1,2,2,0,2,0,1,0,0,2,146,23,1
20841,247,5301,1454,835,1044,76,110,219,1530,17,275,158,296,292,454,2297,3718,9,34017,1889,1,2,146,23,1
20842,11,347,72,33,56,0,4,12,72,1,1,1,1,2,2,0,2,0,1,0,0,2,7,12,1
20845,94,2175,1043,504,840,53,9,147,1096,9,180,112,198,189,310,1377,2344,4,11604,644,0,2,1,1,0
20846,94,2175,383,288,292,26,6,62,409,11,65,38,67,76,105,429,656,5,3719,206,0,2,1,1,0
20870,66,1174,1513,682,1277,25,13,200,1538,11,199,116,219,210,335,1557,2584,6,15641,868,0,2,0,11,1
20871,66,1174,819,519,539,24,98,155,843,15,96,57,106,111,163,690,1107,8,9171,509,0,2,0,11,1
20872,149,3363,77,34,69,0,0,8,77,3,24,16,29,27,45,114,213,1,387,21,0,2,4,4,1
20873,149,3363,712,438,573,51,9,84,763,14,102,71,128,116,199,733,1364,8,11988,666,0,2,4,4,1
20874,185,4362,722,423,573,19,0,135,741,12,172,101,199,184,300,1320,2257,6,15668,870,0,2,4,2,1
20875,185,4362,1508,847,911,44,250,301,1552,14,148,88,169,162,257,1120,1886,7,15077,837,0,2,4,2,1
20876,247,5301,72,33,56,0,4,12,72,1,1,1,1,2,2,0,2,0,1,0,0,2,1,0,1
20877,247,5301,1454,835,1044,76,110,219,1530,17,275,158,296,292,454,2297,3718,9,34017,1889,1,2,1,0,1
20878,98,2209,1043,504,840,53,9,147,1096,9,180,112,198,189,310,1377,2344,4,11604,644,0,2,40,16,1
20879,98,2209,383,288,292,26,6,62,409,11,65,38,67,76,105,429,656,5,3719,206,0,2,40,16,1
20882,42,1675,1043,504,840,53,9,147,1096,9,180,112,198,189,310,1377,2344,4,11604,644,0,2,39,0,1
20883,48,926,1098,241,925,5,10,155,1103,7,46,25,49,53,74,273,423,3,1580,87,0,2,7,2,0
20884,48,926,282,202,222,14,2,44,296,8,42,24,43,50,67,250,378,4,1548,86,0,2,7,2,0
20908,149,3366,77,34,69,0,0,8,77,3,24,16,29,27,45,114,213,1,387,21,0,2,2,0,1
20909,149,3366,712,438,573,51,9,84,763,14,102,71,128,116,199,733,1364,8,11988,666,0,2,2,0,1
20910,97,2199,1043,504,840,53,9,147,1096,9,180,112,198,189,310,1377,2344,4,11604,644,0,2,1,7,1
20911,97,2199,383,288,292,26,6,62,409,11,65,38,67,76,105,429,656,5,3719,206,0,2,1,7,1
20937,97,2191,1043,504,840,53,9,147,1096,9,180,112,198,189,310,1377,2344,4,11604,644,0,2,8,9,1
20938,97,2191,383,288,292,26,6,62,409,11,65,38,67,76,105,429,656,5,3719,206,0,2,8,9,1
20941,97,2193,1043,504,840,53,9,147,1096,9,180,112,198,189,310,1377,2344,4,11604,644,0,2,4,4,1
20942,97,2193,383,288,292,26,6,62,409,11,65,38,67,76,105,429,656,5,3719,206,0,2,4,4,1
20966,63,1148,1020,354,843,12,15,144,1032,8,134,77,144,142,221,970,1580,4,6792,377,0,2,3,3,1
20967,247,5301,72,33,56,0,4,12,72,1,1,1,1,2,2,0,2,0,1,0,0,2,1,1,1
20968,247,5301,1454,835,1044,76,110,219,1530,17,275,158,296,292,454,2297,3718,9,34017,1889,1,2,1,1,1
20969,10,326,72,33,56,0,4,12,72,1,1,1,1,2,2,0,2,0,1,0,0,2,7,5,1
20972,247,5301,72,33,56,0,4,12,72,1,1,1,1,2,2,0,2,0,1,0,0,2,10,9,1
20973,247,5301,1454,835,1044,76,110,219,1530,17,275,158,296,292,454,2297,3718,9,34017,1889,1,2,10,9,1
20976,148,3361,77,34,69,0,0,8,77,3,24,16,29,27,45,114,213,1,387,21,0,2,7,7,1
20977,148,3361,712,438,573,51,9,84,763,14,102,71,128,116,199,733,1364,8,11988,666,0,2,7,7,1
20978,39,1240,1523,757,1297,19,12,193,1542,12,193,117,230,205,347,1508,2664,7,19053,1058,0,2,60,66,1
20979,39,1240,701,378,504,33,58,109,734,13,110,68,126,123,194,794,1346,7,10027,557,0,2,60,66,1
20980,50,966,1098,241,925,5,10,155,1103,7,46,25,49,53,74,273,423,3,1580,87,0,2,4,0,1
20981,50,966,282,202,222,14,2,44,296,8,42,24,43,50,67,250,378,4,1548,86,0,2,4,0,1
20982,22,846,1098,241,925,5,10,155,1103,7,46,25,49,53,74,273,423,3,1580,87,0,2,23,0,1
21006,45,434,647,139,84,35,284,233,682,0,0,0,0,0,0,0,0,0,0,0,0,2,19,6,1
21007,149,3388,77,34,69,0,0,8,77,3,24,16,29,27,45,114,213,1,387,21,0,2,6,2,1
21008,149,3388,712,438,573,51,9,84,763,14,102,71,128,116,199,733,1364,8,11988,666,0,2,6,2,1
21009,93,2136,1043,504,840,53,9,147,1096,9,180,112,198,189,310,1377,2344,4,11604,644,0,2,13,36,1
21010,93,2136,383,288,292,26,6,62,409,11,65,38,67,76,105,429,656,5,3719,206,0,2,13,36,1
21013,42,1681,1043,504,840,53,9,147,1096,9,180,112,198,189,310,1377,2344,4,11604,644,0,2,3,3,1
21037,43,413,647,139,84,35,284,233,682,0,0,0,0,0,0,0,0,0,0,0,0,2,0,8,1
21038,91,2091,1043,504,840,53,9,147,1096,9,180,112,198,189,310,1377,2344,4,11604,644,0,2,0,7,1
21039,91,2091,383,288,292,26,6,62,409,11,65,38,67,76,105,429,656,5,3719,206,0,2,0,7,1
21040,146,2919,1943,715,1694,26,18,214,1969,12,185,120,237,197,357,1436,2721,7,20915,1161,0,2,0,3,1
21041,146,2919,1168,838,957,57,25,144,1225,19,348,224,416,367,640,3018,5452,11,61921,3440,1,2,0,3,1
21044,39,1597,1513,682,1277,25,13,200,1538,11,199,116,219,210,335,1557,2584,6,15641,868,0,2,1,1,1
21045,247,5301,72,33,56,0,4,12,72,1,1,1,1,2,2,0,2,0,1,0,0,2,16,18,1
21046,247,5301,1454,835,1044,76,110,219,1530,17,275,158,296,292,454,2297,3718,9,34017,1889,1,2,16,18,1
21070,29,603,215,129,180,6,0,29,221,8,65,43,72,73,115,415,711,4,3153,175,0,2,4,1,1
21071,29,603,97,69,77,3,3,16,100,6,22,13,23,28,36,113,173,3,542,30,0,2,4,1,1
21074,14,1171,215,129,180,6,0,29,221,8,65,43,72,73,115,415,711,4,3153,175,0,2,7,4,1
21123,247,5322,72,33,56,0,4,12,72,1,1,1,1,2,2,0,2,0,1,0,0,2,2,0,1
21124,247,5322,1454,835,1044,76,110,219,1530,17,275,158,296,292,454,2297,3718,9,34017,1889,1,2,2,0,1
21127,23,882,1098,241,925,5,10,155,1103,7,46,25,49,53,74,273,423,3,1580,87,0,2,18,1,1
21176,24,517,447,308,343,6,5,95,453,7,96,59,111,103,170,651,1136,4,4600,255,0,2,1,1,1
21177,24,517,322,174,179,16,74,51,338,10,41,26,46,51,72,252,408,5,2291,127,0,2,1,1,1
21180,14,877,447,308,343,6,5,95,453,7,96,59,111,103,170,651,1136,4,4600,255,0,2,14,0,1
21181,14,884,447,308,343,6,5,95,453,7,96,59,111,103,170,651,1136,4,4600,255,0,2,1,0,0
21205,51,972,1098,241,925,5,10,155,1103,7,46,25,49,53,74,273,423,3,1580,87,0,2,4,1,1
21206,51,972,282,202,222,14,2,44,296,8,42,24,43,50,67,250,378,4,1548,86,0,2,4,1,1
21209,24,917,1098,241,925,5,10,155,1103,7,46,25,49,53,74,273,423,3,1580,87,0,2,11,0,1
21210,58,2413,1289,550,1043,56,32,155,1345,10,167,93,185,177,278,1266,2075,5,11498,638,0,2,7,2,1
21234,247,5323,72,33,56,0,4,12,72,1,1,1,1,2,2,0,2,0,1,0,0,2,2,1,0
21235,247,5323,1454,835,1044,76,110,219,1530,17,275,158,296,292,454,2297,3718,9,34017,1889,1,2,2,1,0
21236,6,286,42,7,35,4,0,5,46,1,2,1,2,3,3,2,4,0,2,0,0,2,3,3,0
21237,6,286,11,6,10,0,0,1,11,2,4,2,4,6,6,10,15,1,15,0,0,2,3,3,0
21238,42,1673,1043,504,840,53,9,147,1096,9,180,112,198,189,310,1377,2344,4,11604,644,0,2,4,6,1
21239,66,1221,1020,354,843,12,15,144,1032,8,134,77,144,142,221,970,1580,4,6792,377,0,2,13,2,1
21240,36,1508,1020,354,843,12,15,144,1032,8,134,77,144,142,221,970,1580,4,6792,377,0,2,25,0,1
21241,58,1088,1020,354,843,12,15,144,1032,8,134,77,144,142,221,970,1580,4,6792,377,0,2,0,19,1
21242,253,5394,72,33,56,0,4,12,72,1,1,1,1,2,2,0,2,0,1,0,0,2,18,2,1
21243,253,5394,1454,835,1044,76,110,219,1530,17,275,158,296,292,454,2297,3718,9,34017,1889,1,2,18,2,1
21244,36,1526,1020,354,843,12,15,144,1032,8,134,77,144,142,221,970,1580,4,6792,377,0,2,7,7,1
21245,25,520,447,308,343,6,5,95,453,7,96,59,111,103,170,651,1136,4,4600,255,0,2,4,1,1
21246,25,520,322,174,179,16,74,51,338,10,41,26,46,51,72,252,408,5,2291,127,0,2,4,1,1
21247,16,935,447,308,343,6,5,95,453,7,96,59,111,103,170,651,1136,4,4600,255,0,2,12,4,1
21248,42,1668,1043,504,840,53,9,147,1096,9,180,112,198,189,310,1377,2344,4,11604,644,0,2,1,2,1
21297,253,5394,72,33,56,0,4,12,72,1,1,1,1,2,2,0,2,0,1,0,0,2,5,6,1
21298,253,5394,1454,835,1044,76,110,219,1530,17,275,158,296,292,454,2297,3718,9,34017,1889,1,2,5,6,1
21299,51,1023,1098,241,925,5,10,155,1103,7,46,25,49,53,74,273,423,3,1580,87,0,2,8,0,1
21300,51,1023,282,202,222,14,2,44,296,8,42,24,43,50,67,250,378,4,1548,86,0,2,8,0,1
21303,50,983,1098,241,925,5,10,155,1103,7,46,25,49,53,74,273,423,3,1580,87,0,2,2,6,1
21304,50,983,282,202,222,14,2,44,296,8,42,24,43,50,67,250,378,4,1548,86,0,2,2,6,1
21305,18,1009,447,308,343,6,5,95,453,7,96,59,111,103,170,651,1136,4,4600,255,0,2,27,15,1
21306,25,524,447,308,343,6,5,95,453,7,96,59,111,103,170,651,1136,4,4600,255,0,2,1,0,0
21307,25,524,322,174,179,16,74,51,338,10,41,26,46,51,72,252,408,5,2291,127,0,2,1,0,0
21308,29,595,447,308,343,6,5,95,453,7,96,59,111,103,170,651,1136,4,4600,255,0,2,13,0,0
21309,29,595,322,174,179,16,74,51,338,10,41,26,46,51,72,252,408,5,2291,127,0,2,13,0,0
21310,22,1134,447,308,343,6,5,95,453,7,96,59,111,103,170,651,1136,4,4600,255,0,2,21,0,0
21311,29,596,447,308,343,6,5,95,453,7,96,59,111,103,170,651,1136,4,4600,255,0,2,4,0,0
21312,29,596,322,174,179,16,74,51,338,10,41,26,46,51,72,252,408,5,2291,127,0,2,4,0,0
21338,92,2141,1043,504,840,53,9,147,1096,9,180,112,198,189,310,1377,2344,4,11604,644,0,2,11,3,1
21339,92,2141,383,288,292,26,6,62,409,11,65,38,67,76,105,429,656,5,3719,206,0,2,11,3,1
21340,43,1766,1043,504,840,53,9,147,1096,9,180,112,198,189,310,1377,2344,4,11604,644,0,2,15,0,1
21364,93,2154,1043,504,840,53,9,147,1096,9,180,112,198,189,310,1377,2344,4,11604,644,0,2,2,0,1
21365,93,2154,383,288,292,26,6,62,409,11,65,38,67,76,105,429,656,5,3719,206,0,2,2,0,1
21368,149,3388,77,34,69,0,0,8,77,3,24,16,29,27,45,114,213,1,387,21,0,2,1,1,1
21369,149,3388,712,438,573,51,9,84,763,14,102,71,128,116,199,733,1364,8,11988,666,0,2,1,1,1
21370,53,2451,1943,715,1694,26,18,214,1969,12,185,120,237,197,357,1436,2721,7,20915,1161,0,2,11,0,1
21371,149,3000,1943,715,1694,26,18,214,1969,12,185,120,237,197,357,1436,2721,7,20915,1161,0,2,12,4,1
21372,149,3000,1168,838,957,57,25,144,1225,19,348,224,416,367,640,3018,5452,11,61921,3440,1,2,12,4,1
21373,55,2523,1943,715,1694,26,18,214,1969,12,185,120,237,197,357,1436,2721,7,20915,1161,0,2,14,0,1
21374,254,5398,72,33,56,0,4,12,72,1,1,1,1,2,2,0,2,0,1,0,0,2,5,3,1
21375,254,5398,1454,835,1044,76,110,219,1530,17,275,158,296,292,454,2297,3718,9,34017,1889,1,2,5,3,1
21426,39,1254,1523,757,1297,19,12,193,1542,12,193,117,230,205,347,1508,2664,7,19053,1058,0,2,14,8,1
21427,39,1254,701,378,504,33,58,109,734,13,110,68,126,123,194,794,1346,7,10027,557,0,2,14,8,1
21428,29,1871,1523,757,1297,19,12,193,1542,12,193,117,230,205,347,1508,2664,7,19053,1058,0,2,13,17,1
21454,118,3823,1660,832,1314,41,38,274,1701,20,312,209,395,332,604,2671,5058,12,64042,3557,1,2,0,1,0
21455,118,3823,1057,646,719,113,100,145,1170,18,215,134,248,233,382,1740,3004,10,31186,1732,1,2,0,1,0
21479,83,1472,1178,367,1042,6,15,115,1184,9,94,51,95,103,146,644,976,4,4439,246,0,2,8,0,1
21480,83,1472,177,108,140,8,0,27,185,6,30,16,32,36,48,162,248,3,794,44,0,2,8,0,1
21481,50,991,1098,241,925,5,10,155,1103,7,46,25,49,53,74,273,423,3,1580,87,0,2,9,3,1
21482,50,991,282,202,222,14,2,44,296,8,42,24,43,50,67,250,378,4,1548,86,0,2,9,3,1
21485,25,961,1098,241,925,5,10,155,1103,7,46,25,49,53,74,273,423,3,1580,87,0,2,21,0,1
21488,58,1217,477,336,357,30,23,73,507,16,194,134,250,210,384,1538,2962,10,30538,1696,0,2,1,0,1
21489,29,1871,1523,757,1297,19,12,193,1542,12,193,117,230,205,347,1508,2664,7,19053,1058,0,2,1,1,1
21490,93,2152,1043,504,840,53,9,147,1096,9,180,112,198,189,310,1377,2344,4,11604,644,0,2,2,1,1
21491,93,2152,383,288,292,26,6,62,409,11,65,38,67,76,105,429,656,5,3719,206,0,2,2,1,1
21492,118,3823,1660,832,1314,41,38,274,1701,20,312,209,395,332,604,2671,5058,12,64042,3557,1,2,1,1,1
21493,118,3823,1057,646,719,113,100,145,1170,18,215,134,248,233,382,1740,3004,10,31186,1732,1,2,1,1,1
21494,100,2215,1660,832,1314,41,38,274,1701,20,312,209,395,332,604,2671,5058,12,64042,3557,1,2,4,0,1
21497,27,565,2,2,2,0,0,0,2,0,0,0,0,0,0,0,0,0,0,0,0,2,1,1,1
21511,27,565,99,48,90,1,3,5,100,0,0,0,0,0,0,0,0,0,0,0,0,2,1,1,1
21512,27,565,8,5,5,2,0,1,10,0,0,0,0,0,0,0,0,0,0,0,0,2,1,1,1
21513,27,565,1217,716,841,84,126,174,1301,14,185,118,215,199,333,1446,2542,8,20687,1149,0,2,1,1,1
21514,27,565,160,89,115,0,13,31,160,7,15,11,17,22,28,78,124,3,495,27,0,2,1,1,1
21515,27,565,10,10,9,9,0,0,19,0,0,0,0,0,0,0,0,0,0,0,0,2,1,1,1
21516,27,565,173,84,99,8,29,36,181,5,12,7,13,17,20,54,81,2,221,12,0,2,1,1,1
21517,27,565,3,1,1,3,0,0,6,0,0,0,0,0,0,0,0,0,0,0,0,2,1,1,1
21518,254,5418,72,33,56,0,4,12,72,1,1,1,1,2,2,0,2,0,1,0,0,2,2,0,1
21519,254,5418,1454,835,1044,76,110,219,1530,17,275,158,296,292,454,2297,3718,9,34017,1889,1,2,2,0,1
21520,14,457,184,100,137,2,15,30,186,6,38,20,39,44,59,214,322,3,991,55,0,2,1,1,1
21521,14,457,103,65,74,8,5,16,111,7,17,9,17,24,26,89,119,3,417,23,0,2,1,1,1
21547,83,1475,1178,367,1042,6,15,115,1184,9,94,51,95,103,146,644,976,4,4439,246,0,2,1,1,1
21548,83,1475,177,108,140,8,0,27,185,6,30,16,32,36,48,162,248,3,794,44,0,2,1,1,1
21601,150,3427,77,34,69,0,0,8,77,3,24,16,29,27,45,114,213,1,387,21,0,2,29,24,1
21602,150,3427,712,438,573,51,9,84,763,14,102,71,128,116,199,733,1364,8,11988,666,0,2,29,24,1
21603,59,2468,1289,550,1043,56,32,155,1345,10,167,93,185,177,278,1266,2075,5,11498,638,0,2,16,0,1
21604,55,2523,1943,715,1694,26,18,214,1969,12,185,120,237,197,357,1436,2721,7,20915,1161,0,2,1,1,1
21605,59,2468,1289,550,1043,56,32,155,1345,10,167,93,185,177,278,1266,2075,5,11498,638,0,2,2,2,0
21608,100,2224,1660,832,1314,41,38,274,1701,20,312,209,395,332,604,2671,5058,12,64042,3557,1,2,1,0,0
21609,40,1265,1523,757,1297,19,12,193,1542,12,193,117,230,205,347,1508,2664,7,19053,1058,0,2,6,3,1
21610,40,1265,701,378,504,33,58,109,734,13,110,68,126,123,194,794,1346,7,10027,557,0,2,6,3,1
21611,30,1909,1523,757,1297,19,12,193,1542,12,193,117,230,205,347,1508,2664,7,19053,1058,0,2,7,0,1
21612,6,71,127,75,83,2,11,30,129,4,14,7,14,18,21,61,87,2,175,9,0,0,16,0,1
21613,6,71,652,304,544,16,6,88,668,6,89,51,101,95,152,591,998,3,3399,188,0,0,16,0,1
21614,6,71,2,2,2,0,0,0,2,0,0,0,0,0,0,0,0,0,0,0,0,0,16,0,1
21615,6,71,8,5,5,0,0,3,8,0,0,0,0,0,0,0,0,0,0,0,0,0,16,0,1
21618,6,71,14,8,8,0,0,6,14,0,0,0,0,0,0,0,0,0,0,0,0,0,16,0,1
21619,6,71,6,4,4,0,0,2,6,0,0,0,0,0,0,0,0,0,0,0,0,0,16,0,1
21620,6,71,6,4,4,0,0,2,6,1,2,1,2,3,3,2,4,0,2,0,0,0,16,0,1
21622,6,71,7,5,5,0,0,2,7,0,0,0,0,0,0,0,0,0,0,0,0,0,16,0,1
21624,6,71,10,6,6,0,0,4,10,0,0,0,0,0,0,0,0,0,0,0,0,0,16,0,1
21625,6,71,1,1,1,0,0,0,1,0,0,0,0,0,0,0,0,0,0,0,0,0,16,0,1
21627,6,71,14,10,10,0,0,4,14,1,1,1,1,2,2,0,2,0,1,0,0,0,16,0,1
21628,6,71,46,26,30,3,0,12,49,3,6,3,6,9,9,20,28,1,42,2,0,0,16,0,1
21652,69,1238,1513,682,1277,25,13,200,1538,11,199,116,219,210,335,1557,2584,6,15641,868,0,2,24,13,1
21653,69,1238,819,519,539,24,98,155,843,15,96,57,106,111,163,690,1107,8,9171,509,0,2,24,13,1
21656,41,1693,1513,682,1277,25,13,200,1538,11,199,116,219,210,335,1557,2584,6,15641,868,0,2,27,0,1
21657,68,1218,1513,682,1277,25,13,200,1538,11,199,116,219,210,335,1557,2584,6,15641,868,0,2,6,10,0
21658,68,1218,819,519,539,24,98,155,843,15,96,57,106,111,163,690,1107,8,9171,509,0,2,6,10,0
21838,1,194,382,65,130,157,2,92,539,4,10,5,10,14,15,41,57,2,114,6,0,0,273,0,1
21856,56,977,282,196,195,3,0,86,285,8,130,71,141,138,212,936,1507,4,6538,363,0,0,213,0,1
21857,4,77,127,75,83,2,11,30,129,4,14,7,14,18,21,61,87,2,175,9,0,0,10,0,1
21858,4,77,652,304,544,16,6,88,668,6,89,51,101,95,152,591,998,3,3399,188,0,0,10,0,1
21859,4,77,2,2,2,0,0,0,2,0,0,0,0,0,0,0,0,0,0,0,0,0,10,0,1
21860,4,77,8,5,5,0,0,3,8,0,0,0,0,0,0,0,0,0,0,0,0,0,10,0,1
21863,4,77,14,8,8,0,0,6,14,0,0,0,0,0,0,0,0,0,0,0,0,0,10,0,1
21864,4,77,6,4,4,0,0,2,6,0,0,0,0,0,0,0,0,0,0,0,0,0,10,0,1
21865,4,77,6,4,4,0,0,2,6,1,2,1,2,3,3,2,4,0,2,0,0,0,10,0,1
21867,4,77,7,5,5,0,0,2,7,0,0,0,0,0,0,0,0,0,0,0,0,0,10,0,1
21869,4,77,10,6,6,0,0,4,10,0,0,0,0,0,0,0,0,0,0,0,0,0,10,0,1
21870,4,77,1,1,1,0,0,0,1,0,0,0,0,0,0,0,0,0,0,0,0,0,10,0,1
21872,4,77,14,10,10,0,0,4,14,1,1,1,1,2,2,0,2,0,1,0,0,0,10,0,1
21873,4,77,46,26,30,3,0,12,49,3,6,3,6,9,9,20,28,1,42,2,0,0,10,0,1
21875,1,84,13,10,10,0,0,3,13,1,2,1,2,3,3,2,4,0,2,0,0,0,14,0,1
21894,3,71,127,75,83,2,11,30,129,4,14,7,14,18,21,61,87,2,175,9,0,0,17,0,1
21895,3,71,652,304,544,16,6,88,668,6,89,51,101,95,152,591,998,3,3399,188,0,0,17,0,1
21896,3,71,2,2,2,0,0,0,2,0,0,0,0,0,0,0,0,0,0,0,0,0,17,0,1
21897,3,71,8,5,5,0,0,3,8,0,0,0,0,0,0,0,0,0,0,0,0,0,17,0,1
21900,3,71,14,8,8,0,0,6,14,0,0,0,0,0,0,0,0,0,0,0,0,0,17,0,1
21901,3,71,6,4,4,0,0,2,6,0,0,0,0,0,0,0,0,0,0,0,0,0,17,0,1
21902,3,71,6,4,4,0,0,2,6,1,2,1,2,3,3,2,4,0,2,0,0,0,17,0,1
21904,3,71,7,5,5,0,0,2,7,0,0,0,0,0,0,0,0,0,0,0,0,0,17,0,1
21906,3,71,10,6,6,0,0,4,10,0,0,0,0,0,0,0,0,0,0,0,0,0,17,0,1
21907,3,71,1,1,1,0,0,0,1,0,0,0,0,0,0,0,0,0,0,0,0,0,17,0,1
21909,3,71,14,10,10,0,0,4,14,1,1,1,1,2,2,0,2,0,1,0,0,0,17,0,1
21910,3,71,46,26,30,3,0,12,49,3,6,3,6,9,9,20,28,1,42,2,0,0,17,0,1
21957,10,326,72,33,56,0,4,12,72,1,1,1,1,2,2,0,2,0,1,0,0,0,60,0,1
21981,12,222,127,75,83,2,11,30,129,4,14,7,14,18,21,61,87,2,175,9,0,0,40,0,1
21982,12,222,652,304,544,16,6,88,668,6,89,51,101,95,152,591,998,3,3399,188,0,0,40,0,1
21983,12,222,2,2,2,0,0,0,2,0,0,0,0,0,0,0,0,0,0,0,0,0,40,0,1
21984,12,222,8,5,5,0,0,3,8,0,0,0,0,0,0,0,0,0,0,0,0,0,40,0,1
21987,12,222,14,8,8,0,0,6,14,0,0,0,0,0,0,0,0,0,0,0,0,0,40,0,1
21988,12,222,6,4,4,0,0,2,6,0,0,0,0,0,0,0,0,0,0,0,0,0,40,0,1
21989,12,222,6,4,4,0,0,2,6,1,2,1,2,3,3,2,4,0,2,0,0,0,40,0,1
21991,12,222,7,5,5,0,0,2,7,0,0,0,0,0,0,0,0,0,0,0,0,0,40,0,1
21993,12,222,10,6,6,0,0,4,10,0,0,0,0,0,0,0,0,0,0,0,0,0,40,0,1
21994,12,222,1,1,1,0,0,0,1,0,0,0,0,0,0,0,0,0,0,0,0,0,40,0,1
21996,12,222,14,10,10,0,0,4,14,1,1,1,1,2,2,0,2,0,1,0,0,0,40,0,1
21997,12,222,46,26,30,3,0,12,49,3,6,3,6,9,9,20,28,1,42,2,0,0,40,0,1
22015,3,23,14,7,7,2,0,5,16,0,0,0,0,0,0,0,0,0,0,0,0,0,11,0,1
22016,6,81,38,23,23,0,0,15,38,0,0,0,0,0,0,0,0,0,0,0,0,0,25,0,1
22017,1,170,382,65,130,157,2,92,539,4,10,5,10,14,15,41,57,2,114,6,0,2,1,3,0
22018,1,173,382,65,130,157,2,92,539,4,10,5,10,14,15,41,57,2,114,6,0,2,1,3,0
22019,1,172,382,65,130,157,2,92,539,4,10,5,10,14,15,41,57,2,114,6,0,2,1,1,1
22020,1,175,382,65,130,157,2,92,539,4,10,5,10,14,15,41,57,2,114,6,0,2,1,1,1
22021,1,172,382,65,130,157,2,92,539,4,10,5,10,14,15,41,57,2,114,6,0,2,8,7,1
22022,118,3823,1660,832,1314,41,38,274,1701,20,312,209,395,332,604,2671,5058,12,64042,3557,1,2,1,1,0
22023,118,3823,1057,646,719,113,100,145,1170,18,215,134,248,233,382,1740,3004,10,31186,1732,1,2,1,1,0
22050,83,1481,1178,367,1042,6,15,115,1184,9,94,51,95,103,146,644,976,4,4439,246,0,2,1,0,1
22051,83,1481,177,108,140,8,0,27,185,6,30,16,32,36,48,162,248,3,794,44,0,2,1,0,1
22052,37,1694,1178,367,1042,6,15,115,1184,9,94,51,95,103,146,644,976,4,4439,246,0,2,16,0,1
22053,153,3064,1943,715,1694,26,18,214,1969,12,185,120,237,197,357,1436,2721,7,20915,1161,0,2,11,0,1
22054,153,3064,1168,838,957,57,25,144,1225,19,348,224,416,367,640,3018,5452,11,61921,3440,1,2,11,0,1
22055,56,2543,1943,715,1694,26,18,214,1969,12,185,120,237,197,357,1436,2721,7,20915,1161,0,2,4,0,1
22079,43,415,647,139,84,35,284,233,682,0,0,0,0,0,0,0,0,0,0,0,0,2,1,1,1
22080,150,3427,77,34,69,0,0,8,77,3,24,16,29,27,45,114,213,1,387,21,0,2,0,1,1
22081,150,3427,712,438,573,51,9,84,763,14,102,71,128,116,199,733,1364,8,11988,666,0,2,0,1,1
22082,154,3083,1943,715,1694,26,18,214,1969,12,185,120,237,197,357,1436,2721,7,20915,1161,0,2,11,7,1
22083,154,3083,1168,838,957,57,25,144,1225,19,348,224,416,367,640,3018,5452,11,61921,3440,1,2,11,7,1
22086,56,2548,1943,715,1694,26,18,214,1969,12,185,120,237,197,357,1436,2721,7,20915,1161,0,2,8,5,1
22087,118,3820,1660,832,1314,41,38,274,1701,20,312,209,395,332,604,2671,5058,12,64042,3557,1,2,43,40,1
22088,118,3820,1057,646,719,113,100,145,1170,18,215,134,248,233,382,1740,3004,10,31186,1732,1,2,43,40,1
22089,58,1217,477,336,357,30,23,73,507,16,194,134,250,210,384,1538,2962,10,30538,1696,0,2,1,3,1
22090,150,3428,77,34,69,0,0,8,77,3,24,16,29,27,45,114,213,1,387,21,0,2,13,8,1
22091,150,3428,712,438,573,51,9,84,763,14,102,71,128,116,199,733,1364,8,11988,666,0,2,13,8,1
22092,35,628,127,75,83,2,11,30,129,4,14,7,14,18,21,61,87,2,175,9,0,2,1,0,0
22093,35,628,652,304,544,16,6,88,668,6,89,51,101,95,152,591,998,3,3399,188,0,2,1,0,0
22094,35,628,2,2,2,0,0,0,2,0,0,0,0,0,0,0,0,0,0,0,0,2,1,0,0
22095,35,628,8,5,5,0,0,3,8,0,0,0,0,0,0,0,0,0,0,0,0,2,1,0,0
22098,35,628,14,8,8,0,0,6,14,0,0,0,0,0,0,0,0,0,0,0,0,2,1,0,0
22099,35,628,6,4,4,0,0,2,6,0,0,0,0,0,0,0,0,0,0,0,0,2,1,0,0
22100,35,628,6,4,4,0,0,2,6,1,2,1,2,3,3,2,4,0,2,0,0,2,1,0,0
22102,35,628,7,5,5,0,0,2,7,0,0,0,0,0,0,0,0,0,0,0,0,2,1,0,0
22104,35,628,10,6,6,0,0,4,10,0,0,0,0,0,0,0,0,0,0,0,0,2,1,0,0
22105,35,628,1,1,1,0,0,0,1,0,0,0,0,0,0,0,0,0,0,0,0,2,1,0,0
22107,35,628,14,10,10,0,0,4,14,1,1,1,1,2,2,0,2,0,1,0,0,2,1,0,0
22108,35,628,46,26,30,3,0,12,49,3,6,3,6,9,9,20,28,1,42,2,0,2,1,0,0
22132,40,1264,1523,757,1297,19,12,193,1542,12,193,117,230,205,347,1508,2664,7,19053,1058,0,2,3,3,1
22133,40,1264,701,378,504,33,58,109,734,13,110,68,126,123,194,794,1346,7,10027,557,0,2,3,3,1
22134,150,3423,77,34,69,0,0,8,77,3,24,16,29,27,45,114,213,1,387,21,0,2,1,1,1
22135,150,3423,712,438,573,51,9,84,763,14,102,71,128,116,199,733,1364,8,11988,666,0,2,1,1,1
22136,23,555,1293,570,1093,25,15,163,1318,10,195,123,241,205,364,1516,2795,6,17273,959,0,2,2,2,1
22137,83,1451,1178,367,1042,6,15,115,1184,9,94,51,95,103,146,644,976,4,4439,246,0,2,16,16,1
22138,83,1451,177,108,140,8,0,27,185,6,30,16,32,36,48,162,248,3,794,44,0,2,16,16,1
22141,30,1909,1523,757,1297,19,12,193,1542,12,193,117,230,205,347,1508,2664,7,19053,1058,0,2,2,2,1
22142,38,1723,1178,367,1042,6,15,115,1184,9,94,51,95,103,146,644,976,4,4439,246,0,2,29,5,1
22143,94,2157,1043,504,840,53,9,147,1096,9,180,112,198,189,310,1377,2344,4,11604,644,0,2,5,2,1
22144,94,2157,383,288,292,26,6,62,409,11,65,38,67,76,105,429,656,5,3719,206,0,2,5,2,1
22145,154,3088,1943,715,1694,26,18,214,1969,12,185,120,237,197,357,1436,2721,7,20915,1161,0,2,5,4,1
22146,154,3088,1168,838,957,57,25,144,1225,19,348,224,416,367,640,3018,5452,11,61921,3440,1,2,5,4,1
22147,44,1808,1043,504,840,53,9,147,1096,9,180,112,198,189,310,1377,2344,4,11604,644,0,2,18,0,1
22171,68,1215,1513,682,1277,25,13,200,1538,11,199,116,219,210,335,1557,2584,6,15641,868,0,2,3,3,1
22172,68,1215,819,519,539,24,98,155,843,15,96,57,106,111,163,690,1107,8,9171,509,0,2,3,3,1
22173,181,4153,77,34,69,0,0,8,77,3,24,16,29,27,45,114,213,1,387,21,0,2,168,9,1
22174,181,4153,712,438,573,51,9,84,763,14,102,71,128,116,199,733,1364,8,11988,666,0,2,168,9,1
22175,185,4355,722,423,573,19,0,135,741,12,172,101,199,184,300,1320,2257,6,15668,870,0,2,1,1,1
22176,185,4355,1508,847,911,44,250,301,1552,14,148,88,169,162,257,1120,1886,7,15077,837,0,2,1,1,1
22177,233,4981,72,33,56,0,4,12,72,1,1,1,1,2,2,0,2,0,1,0,0,2,178,271,1
22178,233,4981,1454,835,1044,76,110,219,1530,17,275,158,296,292,454,2297,3718,9,34017,1889,1,2,178,271,1
22179,29,603,215,129,180,6,0,29,221,8,65,43,72,73,115,415,711,4,3153,175,0,2,3,1,1
22180,29,603,97,69,77,3,3,16,100,6,22,13,23,28,36,113,173,3,542,30,0,2,3,1,1
22181,11,345,442,244,305,14,16,103,456,11,68,45,75,79,120,452,756,6,4588,254,0,2,3,3,1
22182,11,345,182,102,99,11,40,35,193,3,11,6,11,14,17,42,64,1,97,5,0,2,3,3,1
22183,1,178,382,65,130,157,2,92,539,4,10,5,10,14,15,41,57,2,114,6,0,2,7,2,1
22186,28,1113,1450,624,1228,12,26,181,1462,14,306,186,354,320,540,2580,4493,8,36391,2021,1,2,19,27,1
22187,6,452,442,244,305,14,16,103,456,11,68,45,75,79,120,452,756,6,4588,254,0,2,2,3,1
22188,233,4981,72,33,56,0,4,12,72,1,1,1,1,2,2,0,2,0,1,0,0,2,3,3,0
22189,233,4981,1454,835,1044,76,110,219,1530,17,275,158,296,292,454,2297,3718,9,34017,1889,1,2,3,3,0
22190,137,2710,1457,730,1242,11,6,188,1468,10,292,166,329,302,495,2424,4078,5,22973,1276,1,2,0,3,0
22191,137,2710,74,35,59,1,0,14,75,3,14,7,14,17,21,58,85,1,128,7,0,2,0,3,0
22192,137,2710,245,125,200,5,7,34,250,7,30,17,34,37,51,166,265,3,1053,58,0,2,0,3,0
22216,139,2729,1457,730,1242,11,6,188,1468,10,292,166,329,302,495,2424,4078,5,22973,1276,1,2,14,10,1
22217,139,2729,74,35,59,1,0,14,75,3,14,7,14,17,21,58,85,1,128,7,0,2,14,10,1
22218,139,2729,245,125,200,5,7,34,250,7,30,17,34,37,51,166,265,3,1053,58,0,2,14,10,1
22221,27,1295,652,304,544,16,6,88,668,6,89,51,101,95,152,591,998,3,3399,188,0,2,13,1,1
22224,29,603,2,2,2,0,0,0,2,0,0,0,0,0,0,0,0,0,0,0,0,2,4,0,1
22238,29,603,99,48,90,1,3,5,100,0,0,0,0,0,0,0,0,0,0,0,0,2,4,0,1
22239,29,603,8,5,5,2,0,1,10,0,0,0,0,0,0,0,0,0,0,0,0,2,4,0,1
22240,29,603,1217,716,841,84,126,174,1301,14,185,118,215,199,333,1446,2542,8,20687,1149,0,2,4,0,1
22241,29,603,160,89,115,0,13,31,160,7,15,11,17,22,28,78,124,3,495,27,0,2,4,0,1
22242,29,603,10,10,9,9,0,0,19,0,0,0,0,0,0,0,0,0,0,0,0,2,4,0,1
22243,29,603,173,84,99,8,29,36,181,5,12,7,13,17,20,54,81,2,221,12,0,2,4,0,1
22244,29,603,3,1,1,3,0,0,6,0,0,0,0,0,0,0,0,0,0,0,0,2,4,0,1
22245,57,1197,477,336,357,30,23,73,507,16,194,134,250,210,384,1538,2962,10,30538,1696,0,2,0,3,1
22246,29,1163,1450,624,1228,12,26,181,1462,14,306,186,354,320,540,2580,4493,8,36391,2021,1,2,23,0,1
22247,118,3822,1660,832,1314,41,38,274,1701,20,312,209,395,332,604,2671,5058,12,64042,3557,1,2,1,1,0
22248,118,3822,1057,646,719,113,100,145,1170,18,215,134,248,233,382,1740,3004,10,31186,1732,1,2,1,1,0
22249,100,2272,1660,832,1314,41,38,274,1701,20,312,209,395,332,604,2671,5058,12,64042,3557,1,2,6,0,0
22250,100,2255,1660,832,1314,41,38,274,1701,20,312,209,395,332,604,2671,5058,12,64042,3557,1,2,4,6,1
22251,154,3088,1943,715,1694,26,18,214,1969,12,185,120,237,197,357,1436,2721,7,20915,1161,0,2,1,1,1
22252,154,3088,1168,838,957,57,25,144,1225,19,348,224,416,367,640,3018,5452,11,61921,3440,1,2,1,1,1
22253,68,1224,1513,682,1277,25,13,200,1538,11,199,116,219,210,335,1557,2584,6,15641,868,0,2,3,2,1
22254,68,1224,819,519,539,24,98,155,843,15,96,57,106,111,163,690,1107,8,9171,509,0,2,3,2,1
22255,153,3459,77,34,69,0,0,8,77,3,24,16,29,27,45,114,213,1,387,21,0,2,10,143,1
22256,153,3459,712,438,573,51,9,84,763,14,102,71,128,116,199,733,1364,8,11988,666,0,2,10,143,1
22257,261,5627,72,33,56,0,4,12,72,1,1,1,1,2,2,0,2,0,1,0,0,2,144,12,1
22258,261,5627,1454,835,1044,76,110,219,1530,17,275,158,296,292,454,2297,3718,9,34017,1889,1,2,144,12,1
22259,154,3478,77,34,69,0,0,8,77,3,24,16,29,27,45,114,213,1,387,21,0,2,26,0,0
22260,154,3478,712,438,573,51,9,84,763,14,102,71,128,116,199,733,1364,8,11988,666,0,2,26,0,0
22261,1,178,382,65,130,157,2,92,539,4,10,5,10,14,15,41,57,2,114,6,0,2,1,1,1
22262,154,3478,77,34,69,0,0,8,77,3,24,16,29,27,45,114,213,1,387,21,0,2,1,1,1
22263,154,3478,712,438,573,51,9,84,763,14,102,71,128,116,199,733,1364,8,11988,666,0,2,1,1,1
22264,1,181,382,65,130,157,2,92,539,4,10,5,10,14,15,41,57,2,114,6,0,2,1,0,1
22265,68,1224,1513,682,1277,25,13,200,1538,11,199,116,219,210,335,1557,2584,6,15641,868,0,2,2,2,1
22266,68,1224,819,519,539,24,98,155,843,15,96,57,106,111,163,690,1107,8,9171,509,0,2,2,2,1
22267,153,3466,77,34,69,0,0,8,77,3,24,16,29,27,45,114,213,1,387,21,0,2,4,4,1
22268,153,3466,712,438,573,51,9,84,763,14,102,71,128,116,199,733,1364,8,11988,666,0,2,4,4,1
22269,277,5802,72,33,56,0,4,12,72,1,1,1,1,2,2,0,2,0,1,0,0,2,221,172,1
22270,277,5802,1454,835,1044,76,110,219,1530,17,275,158,296,292,454,2297,3718,9,34017,1889,1,2,221,172,1
22271,11,347,442,244,305,14,16,103,456,11,68,45,75,79,120,452,756,6,4588,254,0,2,3,3,1
22272,11,347,182,102,99,11,40,35,193,3,11,6,11,14,17,42,64,1,97,5,0,2,3,3,1
22273,68,1223,1513,682,1277,25,13,200,1538,11,199,116,219,210,335,1557,2584,6,15641,868,0,2,2,2,1
22274,68,1223,819,519,539,24,98,155,843,15,96,57,106,111,163,690,1107,8,9171,509,0,2,2,2,1
22275,175,4097,77,34,69,0,0,8,77,3,24,16,29,27,45,114,213,1,387,21,0,2,97,0,1
22276,175,4097,712,438,573,51,9,84,763,14,102,71,128,116,199,733,1364,8,11988,666,0,2,97,0,1
22277,258,5343,72,33,56,0,4,12,72,1,1,1,1,2,2,0,2,0,1,0,0,2,26,91,1
22278,258,5343,1454,835,1044,76,110,219,1530,17,275,158,296,292,454,2297,3718,9,34017,1889,1,2,26,91,1
22279,36,1526,1020,354,843,12,15,144,1032,8,134,77,144,142,221,970,1580,4,6792,377,0,2,1,1,1
22280,23,970,373,158,315,8,0,51,381,5,76,44,79,81,123,486,779,2,2026,112,0,2,9,9,1
22281,182,4179,77,34,69,0,0,8,77,3,24,16,29,27,45,114,213,1,387,21,0,2,72,55,1
22282,182,4179,712,438,573,51,9,84,763,14,102,71,128,116,199,733,1364,8,11988,666,0,2,72,55,1
22283,185,4360,722,423,573,19,0,135,741,12,172,101,199,184,300,1320,2257,6,15668,870,0,2,4,2,1
22284,185,4360,1508,847,911,44,250,301,1552,14,148,88,169,162,257,1120,1886,7,15077,837,0,2,4,2,1
22285,260,5490,72,33,56,0,4,12,72,1,1,1,1,2,2,0,2,0,1,0,0,2,47,27,1
22286,260,5490,1454,835,1044,76,110,219,1530,17,275,158,296,292,454,2297,3718,9,34017,1889,1,2,47,27,1
22287,23,946,373,158,315,8,0,51,381,5,76,44,79,81,123,486,779,2,2026,112,0,2,6,5,1
22288,6,484,442,244,305,14,16,103,456,11,68,45,75,79,120,452,756,6,4588,254,0,2,8,2,1
22289,189,4278,77,34,69,0,0,8,77,3,24,16,29,27,45,114,213,1,387,21,0,2,18,3,1
22290,189,4278,712,438,573,51,9,84,763,14,102,71,128,116,199,733,1364,8,11988,666,0,2,18,3,1
22291,257,5478,72,33,56,0,4,12,72,1,1,1,1,2,2,0,2,0,1,0,0,2,4,7,1
22292,257,5478,1454,835,1044,76,110,219,1530,17,275,158,296,292,454,2297,3718,9,34017,1889,1,2,4,7,1
22293,260,5629,72,33,56,0,4,12,72,1,1,1,1,2,2,0,2,0,1,0,0,2,35,7,1
22294,260,5629,1454,835,1044,76,110,219,1530,17,275,158,296,292,454,2297,3718,9,34017,1889,1,2,35,7,1
22295,191,4316,77,34,69,0,0,8,77,3,24,16,29,27,45,114,213,1,387,21,0,2,14,5,0
22296,191,4316,712,438,573,51,9,84,763,14,102,71,128,116,199,733,1364,8,11988,666,0,2,14,5,0
22320,261,5650,72,33,56,0,4,12,72,1,1,1,1,2,2,0,2,0,1,0,0,2,4,1,1
22321,261,5650,1454,835,1044,76,110,219,1530,17,275,158,296,292,454,2297,3718,9,34017,1889,1,2,4,1,1
22322,1,181,382,65,130,157,2,92,539,4,10,5,10,14,15,41,57,2,114,6,0,2,1,1,1
22325,198,4459,77,34,69,0,0,8,77,3,24,16,29,27,45,114,213,1,387,21,0,2,23,2,1
22326,198,4459,712,438,573,51,9,84,763,14,102,71,128,116,199,733,1364,8,11988,666,0,2,23,2,1
22327,263,5769,72,33,56,0,4,12,72,1,1,1,1,2,2,0,2,0,1,0,0,2,50,24,1
22328,263,5769,1454,835,1044,76,110,219,1530,17,275,158,296,292,454,2297,3718,9,34017,1889,1,2,50,24,1
22352,203,4578,77,34,69,0,0,8,77,3,24,16,29,27,45,114,213,1,387,21,0,2,28,4,1
22353,203,4578,712,438,573,51,9,84,763,14,102,71,128,116,199,733,1364,8,11988,666,0,2,28,4,1
22354,270,5894,72,33,56,0,4,12,72,1,1,1,1,2,2,0,2,0,1,0,0,2,24,4,1
22355,270,5894,1454,835,1044,76,110,219,1530,17,275,158,296,292,454,2297,3718,9,34017,1889,1,2,24,4,1
22381,215,4791,77,34,69,0,0,8,77,3,24,16,29,27,45,114,213,1,387,21,0,2,37,2,1
22382,215,4791,712,438,573,51,9,84,763,14,102,71,128,116,199,733,1364,8,11988,666,0,2,37,2,1
22383,273,5991,72,33,56,0,4,12,72,1,1,1,1,2,2,0,2,0,1,0,0,2,27,9,1
22384,273,5991,1454,835,1044,76,110,219,1530,17,275,158,296,292,454,2297,3718,9,34017,1889,1,2,27,9,1
22385,96,2180,1043,504,840,53,9,147,1096,9,180,112,198,189,310,1377,2344,4,11604,644,0,2,7,3,1
22386,96,2180,383,288,292,26,6,62,409,11,65,38,67,76,105,429,656,5,3719,206,0,2,7,3,1
22389,220,4925,77,34,69,0,0,8,77,3,24,16,29,27,45,114,213,1,387,21,0,2,40,8,1
22390,220,4925,712,438,573,51,9,84,763,14,102,71,128,116,199,733,1364,8,11988,666,0,2,40,8,1
22391,271,5960,72,33,56,0,4,12,72,1,1,1,1,2,2,0,2,0,1,0,0,2,8,12,1
22392,271,5960,1454,835,1044,76,110,219,1530,17,275,158,296,292,454,2297,3718,9,34017,1889,1,2,8,12,1
22393,223,5008,77,34,69,0,0,8,77,3,24,16,29,27,45,114,213,1,387,21,0,2,34,20,1
22394,223,5008,712,438,573,51,9,84,763,14,102,71,128,116,199,733,1364,8,11988,666,0,2,34,20,1
22395,272,5978,72,33,56,0,4,12,72,1,1,1,1,2,2,0,2,0,1,0,0,2,20,18,1
22396,272,5978,1454,835,1044,76,110,219,1530,17,275,158,296,292,454,2297,3718,9,34017,1889,1,2,20,18,1
22420,259,5695,77,34,69,0,0,8,77,3,24,16,29,27,45,114,213,1,387,21,0,2,154,39,1
22421,259,5695,712,438,573,51,9,84,763,14,102,71,128,116,199,733,1364,8,11988,666,0,2,154,39,1
22422,267,5870,72,33,56,0,4,12,72,1,1,1,1,2,2,0,2,0,1,0,0,2,1,20,1
22423,267,5870,1454,835,1044,76,110,219,1530,17,275,158,296,292,454,2297,3718,9,34017,1889,1,2,1,20,1
22426,29,1172,1450,624,1228,12,26,181,1462,14,306,186,354,320,540,2580,4493,8,36391,2021,1,2,1,0,0
22427,158,3594,77,34,69,0,0,8,77,3,24,16,29,27,45,114,213,1,387,21,0,2,3,385,1
22428,158,3594,712,438,573,51,9,84,763,14,102,71,128,116,199,733,1364,8,11988,666,0,2,3,385,1
22429,366,7926,72,33,56,0,4,12,72,1,1,1,1,2,2,0,2,0,1,0,0,2,357,1,1
22430,366,7926,1454,835,1044,76,110,219,1530,17,275,158,296,292,454,2297,3718,9,34017,1889,1,2,357,1,1
22431,379,8210,72,33,56,0,4,12,72,1,1,1,1,2,2,0,2,0,1,0,0,2,77,23,1
22432,379,8210,1454,835,1044,76,110,219,1530,17,275,158,296,292,454,2297,3718,9,34017,1889,1,2,77,23,1
22456,379,8214,72,33,56,0,4,12,72,1,1,1,1,2,2,0,2,0,1,0,0,2,5,2,1
22457,379,8214,1454,835,1044,76,110,219,1530,17,275,158,296,292,454,2297,3718,9,34017,1889,1,2,5,2,1
22484,383,8290,72,33,56,0,4,12,72,1,1,1,1,2,2,0,2,0,1,0,0,2,44,8,1
22485,383,8290,1454,835,1044,76,110,219,1530,17,275,158,296,292,454,2297,3718,9,34017,1889,1,2,44,8,1
22489,383,8290,72,33,56,0,4,12,72,1,1,1,1,2,2,0,2,0,1,0,0,2,5,2,1
22490,383,8290,1454,835,1044,76,110,219,1530,17,275,158,296,292,454,2297,3718,9,34017,1889,1,2,5,2,1
22515,40,1271,1523,757,1297,19,12,193,1542,12,193,117,230,205,347,1508,2664,7,19053,1058,0,2,1,1,1
22516,40,1271,701,378,504,33,58,109,734,13,110,68,126,123,194,794,1346,7,10027,557,0,2,1,1,1
22519,31,1956,1523,757,1297,19,12,193,1542,12,193,117,230,205,347,1508,2664,7,19053,1058,0,2,12,0,1
22543,158,3603,77,34,69,0,0,8,77,3,24,16,29,27,45,114,213,1,387,21,0,2,2,1,1
22544,158,3603,712,438,573,51,9,84,763,14,102,71,128,116,199,733,1364,8,11988,666,0,2,2,1,1
22545,388,8375,72,33,56,0,4,12,72,1,1,1,1,2,2,0,2,0,1,0,0,2,34,18,1
22546,388,8375,1454,835,1044,76,110,219,1530,17,275,158,296,292,454,2297,3718,9,34017,1889,1,2,34,18,1
22549,390,8417,72,33,56,0,4,12,72,1,1,1,1,2,2,0,2,0,1,0,0,2,23,19,1
22550,390,8417,1454,835,1044,76,110,219,1530,17,275,158,296,292,454,2297,3718,9,34017,1889,1,2,23,19,1
22551,3,66,127,75,83,2,11,30,129,4,14,7,14,18,21,61,87,2,175,9,0,2,7,6,1
22552,3,66,652,304,544,16,6,88,668,6,89,51,101,95,152,591,998,3,3399,188,0,2,7,6,1
22553,3,66,2,2,2,0,0,0,2,0,0,0,0,0,0,0,0,0,0,0,0,2,7,6,1
22554,3,66,8,5,5,0,0,3,8,0,0,0,0,0,0,0,0,0,0,0,0,2,7,6,1
22557,3,66,14,8,8,0,0,6,14,0,0,0,0,0,0,0,0,0,0,0,0,2,7,6,1
22558,3,66,6,4,4,0,0,2,6,0,0,0,0,0,0,0,0,0,0,0,0,2,7,6,1
22559,3,66,6,4,4,0,0,2,6,1,2,1,2,3,3,2,4,0,2,0,0,2,7,6,1
22561,3,66,7,5,5,0,0,2,7,0,0,0,0,0,0,0,0,0,0,0,0,2,7,6,1
22563,3,66,10,6,6,0,0,4,10,0,0,0,0,0,0,0,0,0,0,0,0,2,7,6,1
22564,3,66,1,1,1,0,0,0,1,0,0,0,0,0,0,0,0,0,0,0,0,2,7,6,1
22566,3,66,14,10,10,0,0,4,14,1,1,1,1,2,2,0,2,0,1,0,0,2,7,6,1
22567,3,66,46,26,30,3,0,12,49,3,6,3,6,9,9,20,28,1,42,2,0,2,7,6,1
22568,7,298,72,33,56,0,4,12,72,1,1,1,1,2,2,0,2,0,1,0,0,2,11,21,1
22569,393,8455,72,33,56,0,4,12,72,1,1,1,1,2,2,0,2,0,1,0,0,2,22,12,1
22570,393,8455,1454,835,1044,76,110,219,1530,17,275,158,296,292,454,2297,3718,9,34017,1889,1,2,22,12,1
22571,40,1278,1523,757,1297,19,12,193,1542,12,193,117,230,205,347,1508,2664,7,19053,1058,0,2,1,1,1
22572,40,1278,701,378,504,33,58,109,734,13,110,68,126,123,194,794,1346,7,10027,557,0,2,1,1,1
22573,32,1972,1523,757,1297,19,12,193,1542,12,193,117,230,205,347,1508,2664,7,19053,1058,0,2,15,12,1
22574,393,8467,72,33,56,0,4,12,72,1,1,1,1,2,2,0,2,0,1,0,0,2,6,2,1
22575,393,8467,1454,835,1044,76,110,219,1530,17,275,158,296,292,454,2297,3718,9,34017,1889,1,2,6,2,1
22576,394,8478,72,33,56,0,4,12,72,1,1,1,1,2,2,0,2,0,1,0,0,2,5,0,1
22577,394,8478,1454,835,1044,76,110,219,1530,17,275,158,296,292,454,2297,3718,9,34017,1889,1,2,5,0,1
22578,394,8468,72,33,56,0,4,12,72,1,1,1,1,2,2,0,2,0,1,0,0,2,4,6,1
22579,394,8468,1454,835,1044,76,110,219,1530,17,275,158,296,292,454,2297,3718,9,34017,1889,1,2,4,6,1
22580,394,8492,72,33,56,0,4,12,72,1,1,1,1,2,2,0,2,0,1,0,0,2,8,2,1
22581,394,8492,1454,835,1044,76,110,219,1530,17,275,158,296,292,454,2297,3718,9,34017,1889,1,2,8,2,1
22582,394,8496,72,33,56,0,4,12,72,1,1,1,1,2,2,0,2,0,1,0,0,2,1,1,1
22583,394,8496,1454,835,1044,76,110,219,1530,17,275,158,296,292,454,2297,3718,9,34017,1889,1,2,1,1,1
22584,32,1972,1523,757,1297,19,12,193,1542,12,193,117,230,205,347,1508,2664,7,19053,1058,0,2,1,1,0
22585,394,8496,72,33,56,0,4,12,72,1,1,1,1,2,2,0,2,0,1,0,0,2,13,9,0
22586,394,8496,1454,835,1044,76,110,219,1530,17,275,158,296,292,454,2297,3718,9,34017,1889,1,2,13,9,0
22611,96,2178,1043,504,840,53,9,147,1096,9,180,112,198,189,310,1377,2344,4,11604,644,0,2,4,3,1
22612,96,2178,383,288,292,26,6,62,409,11,65,38,67,76,105,429,656,5,3719,206,0,2,4,3,1
22615,23,1161,447,308,343,6,5,95,453,7,96,59,111,103,170,651,1136,4,4600,255,0,2,13,0,1
22616,32,1976,1523,757,1297,19,12,193,1542,12,193,117,230,205,347,1508,2664,7,19053,1058,0,2,2,2,0
22617,185,4356,722,423,573,19,0,135,741,12,172,101,199,184,300,1320,2257,6,15668,870,0,2,1,1,0
22618,185,4356,1508,847,911,44,250,301,1552,14,148,88,169,162,257,1120,1886,7,15077,837,0,2,1,1,0
22619,14,577,722,423,573,19,0,135,741,12,172,101,199,184,300,1320,2257,6,15668,870,0,2,10,0,0
22620,395,8517,72,33,56,0,4,12,72,1,1,1,1,2,2,0,2,0,1,0,0,2,8,4,1
22621,395,8517,1454,835,1044,76,110,219,1530,17,275,158,296,292,454,2297,3718,9,34017,1889,1,2,8,4,1
22622,159,3613,77,34,69,0,0,8,77,3,24,16,29,27,45,114,213,1,387,21,0,2,10,3,0
22623,159,3613,712,438,573,51,9,84,763,14,102,71,128,116,199,733,1364,8,11988,666,0,2,10,3,0
22624,44,1808,1043,504,840,53,9,147,1096,9,180,112,198,189,310,1377,2344,4,11604,644,0,2,6,1,0
22628,384,8296,72,33,56,0,4,12,72,1,1,1,1,2,2,0,2,0,1,0,0,2,108,146,1
22629,384,8296,1454,835,1044,76,110,219,1530,17,275,158,296,292,454,2297,3718,9,34017,1889,1,2,108,146,1
22630,3,66,127,75,83,2,11,30,129,4,14,7,14,18,21,61,87,2,175,9,0,2,2,2,1
22631,3,66,652,304,544,16,6,88,668,6,89,51,101,95,152,591,998,3,3399,188,0,2,2,2,1
22632,3,66,2,2,2,0,0,0,2,0,0,0,0,0,0,0,0,0,0,0,0,2,2,2,1
22633,3,66,8,5,5,0,0,3,8,0,0,0,0,0,0,0,0,0,0,0,0,2,2,2,1
22636,3,66,14,8,8,0,0,6,14,0,0,0,0,0,0,0,0,0,0,0,0,2,2,2,1
22637,3,66,6,4,4,0,0,2,6,0,0,0,0,0,0,0,0,0,0,0,0,2,2,2,1
22638,3,66,6,4,4,0,0,2,6,1,2,1,2,3,3,2,4,0,2,0,0,2,2,2,1
22640,3,66,7,5,5,0,0,2,7,0,0,0,0,0,0,0,0,0,0,0,0,2,2,2,1
22642,3,66,10,6,6,0,0,4,10,0,0,0,0,0,0,0,0,0,0,0,0,2,2,2,1
22643,3,66,1,1,1,0,0,0,1,0,0,0,0,0,0,0,0,0,0,0,0,2,2,2,1
22645,3,66,14,10,10,0,0,4,14,1,1,1,1,2,2,0,2,0,1,0,0,2,2,2,1
22646,3,66,46,26,30,3,0,12,49,3,6,3,6,9,9,20,28,1,42,2,0,2,2,2,1
22647,7,298,72,33,56,0,4,12,72,1,1,1,1,2,2,0,2,0,1,0,0,2,4,4,1
22671,162,3649,77,34,69,0,0,8,77,3,24,16,29,27,45,114,213,1,387,21,0,2,10,3,1
22672,162,3649,712,438,573,51,9,84,763,14,102,71,128,116,199,733,1364,8,11988,666,0,2,10,3,1
22673,385,8343,72,33,56,0,4,12,72,1,1,1,1,2,2,0,2,0,1,0,0,2,11,6,1
22674,385,8343,1454,835,1044,76,110,219,1530,17,275,158,296,292,454,2297,3718,9,34017,1889,1,2,11,6,1
22678,385,8344,72,33,56,0,4,12,72,1,1,1,1,2,2,0,2,0,1,0,0,2,5,5,1
22679,385,8344,1454,835,1044,76,110,219,1530,17,275,158,296,292,454,2297,3718,9,34017,1889,1,2,5,5,1
22680,385,8329,72,33,56,0,4,12,72,1,1,1,1,2,2,0,2,0,1,0,0,2,2,7,1
22681,385,8329,1454,835,1044,76,110,219,1530,17,275,158,296,292,454,2297,3718,9,34017,1889,1,2,2,7,1
22705,387,8382,72,33,56,0,4,12,72,1,1,1,1,2,2,0,2,0,1,0,0,2,19,10,1
22706,387,8382,1454,835,1044,76,110,219,1530,17,275,158,296,292,454,2297,3718,9,34017,1889,1,2,19,10,1
22707,51,1026,1098,241,925,5,10,155,1103,7,46,25,49,53,74,273,423,3,1580,87,0,2,4,0,1
22708,51,1026,282,202,222,14,2,44,296,8,42,24,43,50,67,250,378,4,1548,86,0,2,4,0,1
22711,26,988,1098,241,925,5,10,155,1103,7,46,25,49,53,74,273,423,3,1580,87,0,2,25,0,1
22712,389,8386,72,33,56,0,4,12,72,1,1,1,1,2,2,0,2,0,1,0,0,2,2,1,1
22713,389,8386,1454,835,1044,76,110,219,1530,17,275,158,296,292,454,2297,3718,9,34017,1889,1,2,2,1,1
22714,390,8394,72,33,56,0,4,12,72,1,1,1,1,2,2,0,2,0,1,0,0,2,6,3,1
22715,390,8394,1454,835,1044,76,110,219,1530,17,275,158,296,292,454,2297,3718,9,34017,1889,1,2,6,3,1
22739,187,4423,722,423,573,19,0,135,741,12,172,101,199,184,300,1320,2257,6,15668,870,0,2,32,22,1
22740,187,4423,1508,847,911,44,250,301,1552,14,148,88,169,162,257,1120,1886,7,15077,837,0,2,32,22,1
22766,391,8407,72,33,56,0,4,12,72,1,1,1,1,2,2,0,2,0,1,0,0,2,4,0,1
22767,391,8407,1454,835,1044,76,110,219,1530,17,275,158,296,292,454,2297,3718,9,34017,1889,1,2,4,0,1
22793,18,294,424,94,331,4,0,89,428,1,5,5,5,6,10,11,25,0,12,0,0,2,1,1,1
22794,18,294,38,23,23,6,0,8,44,3,11,7,11,14,18,42,68,1,102,5,0,2,1,1,1
22797,12,389,424,94,331,4,0,89,428,1,5,5,5,6,10,11,25,0,12,0,0,2,11,0,1
22798,42,1116,74,35,59,1,0,14,75,3,14,7,14,17,21,58,85,1,128,7,0,2,2,0,1
22799,42,1116,245,125,200,5,7,34,250,7,30,17,34,37,51,166,265,3,1053,58,0,2,2,0,1
22800,11,343,74,35,59,1,0,14,75,3,14,7,14,17,21,58,85,1,128,7,0,2,7,5,1
22801,52,1050,1098,241,925,5,10,155,1103,7,46,25,49,53,74,273,423,3,1580,87,0,2,3,0,1
22802,52,1050,282,202,222,14,2,44,296,8,42,24,43,50,67,250,378,4,1548,86,0,2,3,0,1
22803,27,1019,1098,241,925,5,10,155,1103,7,46,25,49,53,74,273,423,3,1580,87,0,2,11,0,1
22804,52,1050,1098,241,925,5,10,155,1103,7,46,25,49,53,74,273,423,3,1580,87,0,2,3,0,0
22805,52,1050,282,202,222,14,2,44,296,8,42,24,43,50,67,250,378,4,1548,86,0,2,3,0,0
22806,27,1019,1098,241,925,5,10,155,1103,7,46,25,49,53,74,273,423,3,1580,87,0,2,11,0,0
22807,391,8407,72,33,56,0,4,12,72,1,1,1,1,2,2,0,2,0,1,0,0,2,1,1,1
22808,391,8407,1454,835,1044,76,110,219,1530,17,275,158,296,292,454,2297,3718,9,34017,1889,1,2,1,1,1
22809,156,3510,77,34,69,0,0,8,77,3,24,16,29,27,45,114,213,1,387,21,0,2,0,22,0
22810,156,3510,712,438,573,51,9,84,763,14,102,71,128,116,199,733,1364,8,11988,666,0,2,0,22,0
22811,392,8417,72,33,56,0,4,12,72,1,1,1,1,2,2,0,2,0,1,0,0,2,5,1,0
22812,392,8417,1454,835,1044,76,110,219,1530,17,275,158,296,292,454,2297,3718,9,34017,1889,1,2,5,1,0
22813,96,2185,1043,504,840,53,9,147,1096,9,180,112,198,189,310,1377,2344,4,11604,644,0,2,1,1,0
22814,96,2185,383,288,292,26,6,62,409,11,65,38,67,76,105,429,656,5,3719,206,0,2,1,1,0
22815,162,3649,77,34,69,0,0,8,77,3,24,16,29,27,45,114,213,1,387,21,0,2,22,0,1
22816,162,3649,712,438,573,51,9,84,763,14,102,71,128,116,199,733,1364,8,11988,666,0,2,22,0,1
22817,391,8407,72,33,56,0,4,12,72,1,1,1,1,2,2,0,2,0,1,0,0,2,1,5,1
22818,391,8407,1454,835,1044,76,110,219,1530,17,275,158,296,292,454,2297,3718,9,34017,1889,1,2,1,5,1
22819,96,2178,1043,504,840,53,9,147,1096,9,180,112,198,189,310,1377,2344,4,11604,644,0,2,1,1,1
22820,96,2178,383,288,292,26,6,62,409,11,65,38,67,76,105,429,656,5,3719,206,0,2,1,1,1
22821,398,8516,72,33,56,0,4,12,72,1,1,1,1,2,2,0,2,0,1,0,0,2,68,38,1
22822,398,8516,1454,835,1044,76,110,219,1530,17,275,158,296,292,454,2297,3718,9,34017,1889,1,2,68,38,1
22823,398,8529,72,33,56,0,4,12,72,1,1,1,1,2,2,0,2,0,1,0,0,2,8,3,1
22824,398,8529,1454,835,1044,76,110,219,1530,17,275,158,296,292,454,2297,3718,9,34017,1889,1,2,8,3,1
22825,398,8516,72,33,56,0,4,12,72,1,1,1,1,2,2,0,2,0,1,0,0,2,3,8,1
22826,398,8516,1454,835,1044,76,110,219,1530,17,275,158,296,292,454,2297,3718,9,34017,1889,1,2,3,8,1
22827,30,618,447,308,343,6,5,95,453,7,96,59,111,103,170,651,1136,4,4600,255,0,2,5,1,1
22828,30,618,322,174,179,16,74,51,338,10,41,26,46,51,72,252,408,5,2291,127,0,2,5,1,1
22829,26,1272,447,308,343,6,5,95,453,7,96,59,111,103,170,651,1136,4,4600,255,0,2,35,0,1
22853,399,8544,72,33,56,0,4,12,72,1,1,1,1,2,2,0,2,0,1,0,0,2,3,0,1
22854,399,8544,1454,835,1044,76,110,219,1530,17,275,158,296,292,454,2297,3718,9,34017,1889,1,2,3,0,1
22857,162,3651,77,34,69,0,0,8,77,3,24,16,29,27,45,114,213,1,387,21,0,2,12,13,0
22858,162,3651,712,438,573,51,9,84,763,14,102,71,128,116,199,733,1364,8,11988,666,0,2,12,13,0
22859,398,8516,72,33,56,0,4,12,72,1,1,1,1,2,2,0,2,0,1,0,0,2,1,3,0
22860,398,8516,1454,835,1044,76,110,219,1530,17,275,158,296,292,454,2297,3718,9,34017,1889,1,2,1,3,0
22861,397,8484,72,33,56,0,4,12,72,1,1,1,1,2,2,0,2,0,1,0,0,2,12,23,1
22862,397,8484,1454,835,1044,76,110,219,1530,17,275,158,296,292,454,2297,3718,9,34017,1889,1,2,12,23,1
22863,399,8494,72,33,56,0,4,12,72,1,1,1,1,2,2,0,2,0,1,0,0,2,5,4,1
22864,399,8494,1454,835,1044,76,110,219,1530,17,275,158,296,292,454,2297,3718,9,34017,1889,1,2,5,4,1
22867,59,2468,1289,550,1043,56,32,155,1345,10,167,93,185,177,278,1266,2075,5,11498,638,0,2,3,3,1
22870,40,1699,1513,682,1277,25,13,200,1538,11,199,116,219,210,335,1557,2584,6,15641,868,0,2,8,8,0
22871,1,197,382,65,130,157,2,92,539,4,10,5,10,14,15,41,57,2,114,6,0,2,5,1,1
22872,399,8494,72,33,56,0,4,12,72,1,1,1,1,2,2,0,2,0,1,0,0,2,25,11,1
22873,399,8494,1454,835,1044,76,110,219,1530,17,275,158,296,292,454,2297,3718,9,34017,1889,1,2,25,11,1
22874,3,66,127,75,83,2,11,30,129,4,14,7,14,18,21,61,87,2,175,9,0,2,1,1,1
22875,3,66,652,304,544,16,6,88,668,6,89,51,101,95,152,591,998,3,3399,188,0,2,1,1,1
22876,3,66,2,2,2,0,0,0,2,0,0,0,0,0,0,0,0,0,0,0,0,2,1,1,1
22877,3,66,8,5,5,0,0,3,8,0,0,0,0,0,0,0,0,0,0,0,0,2,1,1,1
22880,3,66,14,8,8,0,0,6,14,0,0,0,0,0,0,0,0,0,0,0,0,2,1,1,1
22881,3,66,6,4,4,0,0,2,6,0,0,0,0,0,0,0,0,0,0,0,0,2,1,1,1
22882,3,66,6,4,4,0,0,2,6,1,2,1,2,3,3,2,4,0,2,0,0,2,1,1,1
22884,3,66,7,5,5,0,0,2,7,0,0,0,0,0,0,0,0,0,0,0,0,2,1,1,1
22886,3,66,10,6,6,0,0,4,10,0,0,0,0,0,0,0,0,0,0,0,0,2,1,1,1
22887,3,66,1,1,1,0,0,0,1,0,0,0,0,0,0,0,0,0,0,0,0,2,1,1,1
22889,3,66,14,10,10,0,0,4,14,1,1,1,1,2,2,0,2,0,1,0,0,2,1,1,1
22890,3,66,46,26,30,3,0,12,49,3,6,3,6,9,9,20,28,1,42,2,0,2,1,1,1
22891,7,298,72,33,56,0,4,12,72,1,1,1,1,2,2,0,2,0,1,0,0,2,2,2,1
22894,386,8241,72,33,56,0,4,12,72,1,1,1,1,2,2,0,2,0,1,0,0,2,103,146,1
22895,386,8241,1454,835,1044,76,110,219,1530,17,275,158,296,292,454,2297,3718,9,34017,1889,1,2,103,146,1
22896,53,1067,1098,241,925,5,10,155,1103,7,46,25,49,53,74,273,423,3,1580,87,0,2,4,1,1
22897,53,1067,282,202,222,14,2,44,296,8,42,24,43,50,67,250,378,4,1548,86,0,2,4,1,1
22898,68,1223,1513,682,1277,25,13,200,1538,11,199,116,219,210,335,1557,2584,6,15641,868,0,2,3,3,1
22899,68,1223,819,519,539,24,98,155,843,15,96,57,106,111,163,690,1107,8,9171,509,0,2,3,3,1
22900,42,1116,74,35,59,1,0,14,75,3,14,7,14,17,21,58,85,1,128,7,0,2,1,1,1
22901,42,1116,245,125,200,5,7,34,250,7,30,17,34,37,51,166,265,3,1053,58,0,2,1,1,1
22902,162,3651,77,34,69,0,0,8,77,3,24,16,29,27,45,114,213,1,387,21,0,2,3,3,1
22903,162,3651,712,438,573,51,9,84,763,14,102,71,128,116,199,733,1364,8,11988,666,0,2,3,3,1
22904,387,8271,72,33,56,0,4,12,72,1,1,1,1,2,2,0,2,0,1,0,0,2,162,159,1
22905,387,8271,1454,835,1044,76,110,219,1530,17,275,158,296,292,454,2297,3718,9,34017,1889,1,2,162,159,1
22906,53,1067,1098,241,925,5,10,155,1103,7,46,25,49,53,74,273,423,3,1580,87,0,2,4,4,1
22907,53,1067,282,202,222,14,2,44,296,8,42,24,43,50,67,250,378,4,1548,86,0,2,4,4,1
22908,56,977,282,196,195,3,0,86,285,8,130,71,141,138,212,936,1507,4,6538,363,0,2,1,1,1
22910,10,326,72,33,56,0,4,12,72,1,1,1,1,2,2,0,2,0,1,0,0,2,1,1,1
22911,35,628,127,75,83,2,11,30,129,4,14,7,14,18,21,61,87,2,175,9,0,2,1,1,1
22912,35,628,652,304,544,16,6,88,668,6,89,51,101,95,152,591,998,3,3399,188,0,2,1,1,1
22913,35,628,2,2,2,0,0,0,2,0,0,0,0,0,0,0,0,0,0,0,0,2,1,1,1
22914,35,628,8,5,5,0,0,3,8,0,0,0,0,0,0,0,0,0,0,0,0,2,1,1,1
22917,35,628,14,8,8,0,0,6,14,0,0,0,0,0,0,0,0,0,0,0,0,2,1,1,1
22918,35,628,6,4,4,0,0,2,6,0,0,0,0,0,0,0,0,0,0,0,0,2,1,1,1
22919,35,628,6,4,4,0,0,2,6,1,2,1,2,3,3,2,4,0,2,0,0,2,1,1,1
22921,35,628,7,5,5,0,0,2,7,0,0,0,0,0,0,0,0,0,0,0,0,2,1,1,1
22923,35,628,10,6,6,0,0,4,10,0,0,0,0,0,0,0,0,0,0,0,0,2,1,1,1
22924,35,628,1,1,1,0,0,0,1,0,0,0,0,0,0,0,0,0,0,0,0,2,1,1,1
22926,35,628,14,10,10,0,0,4,14,1,1,1,1,2,2,0,2,0,1,0,0,2,1,1,1
22927,35,628,46,26,30,3,0,12,49,3,6,3,6,9,9,20,28,1,42,2,0,2,1,1,1
22928,40,1699,1513,682,1277,25,13,200,1538,11,199,116,219,210,335,1557,2584,6,15641,868,0,2,1,1,1
22929,27,1295,652,304,544,16,6,88,668,6,89,51,101,95,152,591,998,3,3399,188,0,2,1,1,1
22930,11,343,74,35,59,1,0,14,75,3,14,7,14,17,21,58,85,1,128,7,0,2,1,1,1
22931,56,2548,1943,715,1694,26,18,214,1969,12,185,120,237,197,357,1436,2721,7,20915,1161,0,2,1,1,1
22932,159,3571,77,34,69,0,0,8,77,3,24,16,29,27,45,114,213,1,387,21,0,2,1,10,1
22933,159,3571,712,438,573,51,9,84,763,14,102,71,128,116,199,733,1364,8,11988,666,0,2,1,10,1
22934,387,8323,72,33,56,0,4,12,72,1,1,1,1,2,2,0,2,0,1,0,0,2,46,41,1
22935,387,8323,1454,835,1044,76,110,219,1530,17,275,158,296,292,454,2297,3718,9,34017,1889,1,2,46,41,1
22961,390,8430,72,33,56,0,4,12,72,1,1,1,1,2,2,0,2,0,1,0,0,2,30,9,1
22962,390,8430,1454,835,1044,76,110,219,1530,17,275,158,296,292,454,2297,3718,9,34017,1889,1,2,30,9,1
22963,53,1059,1098,241,925,5,10,155,1103,7,46,25,49,53,74,273,423,3,1580,87,0,2,1,1,1
22964,53,1059,282,202,222,14,2,44,296,8,42,24,43,50,67,250,378,4,1548,86,0,2,1,1,1
22965,1,197,382,65,130,157,2,92,539,4,10,5,10,14,15,41,57,2,114,6,0,2,1,1,1
22966,393,8487,72,33,56,0,4,12,72,1,1,1,1,2,2,0,2,0,1,0,0,2,28,14,1
22967,393,8487,1454,835,1044,76,110,219,1530,17,275,158,296,292,454,2297,3718,9,34017,1889,1,2,28,14,1
22968,395,8521,72,33,56,0,4,12,72,1,1,1,1,2,2,0,2,0,1,0,0,2,25,12,1
22969,395,8521,1454,835,1044,76,110,219,1530,17,275,158,296,292,454,2297,3718,9,34017,1889,1,2,25,12,1
22993,398,8551,72,33,56,0,4,12,72,1,1,1,1,2,2,0,2,0,1,0,0,2,14,6,1
22994,398,8551,1454,835,1044,76,110,219,1530,17,275,158,296,292,454,2297,3718,9,34017,1889,1,2,14,6,1
22997,398,8551,72,33,56,0,4,12,72,1,1,1,1,2,2,0,2,0,1,0,0,2,16,14,1
22998,398,8551,1454,835,1044,76,110,219,1530,17,275,158,296,292,454,2297,3718,9,34017,1889,1,2,16,14,1
22999,156,3098,1943,715,1694,26,18,214,1969,12,185,120,237,197,357,1436,2721,7,20915,1161,0,2,6,3,1
23000,156,3098,1168,838,957,57,25,144,1225,19,348,224,416,367,640,3018,5452,11,61921,3440,1,2,6,3,1
23001,1,191,382,65,130,157,2,92,539,4,10,5,10,14,15,41,57,2,114,6,0,2,3,2,1
23025,397,8525,72,33,56,0,4,12,72,1,1,1,1,2,2,0,2,0,1,0,0,2,3,9,1
23026,397,8525,1454,835,1044,76,110,219,1530,17,275,158,296,292,454,2297,3718,9,34017,1889,1,2,3,9,1
23029,12,392,424,94,331,4,0,89,428,1,5,5,5,6,10,11,25,0,12,0,0,2,1,1,1
23030,27,1019,1098,241,925,5,10,155,1103,7,46,25,49,53,74,273,423,3,1580,87,0,2,2,2,1
23031,397,8524,72,33,56,0,4,12,72,1,1,1,1,2,2,0,2,0,1,0,0,2,5,5,1
23032,397,8524,1454,835,1044,76,110,219,1530,17,275,158,296,292,454,2297,3718,9,34017,1889,1,2,5,5,1
23033,32,1987,1523,757,1297,19,12,193,1542,12,193,117,230,205,347,1508,2664,7,19053,1058,0,2,5,3,0
23034,397,8526,72,33,56,0,4,12,72,1,1,1,1,2,2,0,2,0,1,0,0,2,28,33,1
23035,397,8526,1454,835,1044,76,110,219,1530,17,275,158,296,292,454,2297,3718,9,34017,1889,1,2,28,33,1
23036,96,2178,1043,504,840,53,9,147,1096,9,180,112,198,189,310,1377,2344,4,11604,644,0,2,3,1,1
23037,96,2178,383,288,292,26,6,62,409,11,65,38,67,76,105,429,656,5,3719,206,0,2,3,1,1
23038,1,199,382,65,130,157,2,92,539,4,10,5,10,14,15,41,57,2,114,6,0,2,6,2,1
23062,394,8574,72,33,56,0,4,12,72,1,1,1,1,2,2,0,2,0,1,0,0,2,35,27,1
23063,394,8574,1454,835,1044,76,110,219,1530,17,275,158,296,292,454,2297,3718,9,34017,1889,1,2,35,27,1
23089,11,351,442,244,305,14,16,103,456,11,68,45,75,79,120,452,756,6,4588,254,0,2,1,1,1
23090,11,351,182,102,99,11,40,35,193,3,11,6,11,14,17,42,64,1,97,5,0,2,1,1,1
23093,6,484,442,244,305,14,16,103,456,11,68,45,75,79,120,452,756,6,4588,254,0,2,9,2,1
23094,19,299,424,94,331,4,0,89,428,1,5,5,5,6,10,11,25,0,12,0,0,2,1,1,1
23095,19,299,38,23,23,6,0,8,44,3,11,7,11,14,18,42,68,1,102,5,0,2,1,1,1
23119,394,8574,72,33,56,0,4,12,72,1,1,1,1,2,2,0,2,0,1,0,0,2,8,8,1
23120,394,8574,1454,835,1044,76,110,219,1530,17,275,158,296,292,454,2297,3718,9,34017,1889,1,2,8,8,1
23121,1,199,382,65,130,157,2,92,539,4,10,5,10,14,15,41,57,2,114,6,0,2,1,1,1
23126,395,8545,72,33,56,0,4,12,72,1,1,1,1,2,2,0,2,0,1,0,0,2,7,10,1
23127,395,8545,1454,835,1044,76,110,219,1530,17,275,158,296,292,454,2297,3718,9,34017,1889,1,2,7,10,1
23128,400,8685,72,33,56,0,4,12,72,1,1,1,1,2,2,0,2,0,1,0,0,2,43,20,1
23129,400,8685,1454,835,1044,76,110,219,1530,17,275,158,296,292,454,2297,3718,9,34017,1889,1,2,43,20,1
23132,404,8730,72,33,56,0,4,12,72,1,1,1,1,2,2,0,2,0,1,0,0,2,22,14,1
23133,404,8730,1454,835,1044,76,110,219,1530,17,275,158,296,292,454,2297,3718,9,34017,1889,1,2,22,14,1
23134,52,1050,1098,241,925,5,10,155,1103,7,46,25,49,53,74,273,423,3,1580,87,0,2,1,3,1
23135,52,1050,282,202,222,14,2,44,296,8,42,24,43,50,67,250,378,4,1548,86,0,2,1,3,1
23136,407,8793,72,33,56,0,4,12,72,1,1,1,1,2,2,0,2,0,1,0,0,2,28,17,1
23137,407,8793,1454,835,1044,76,110,219,1530,17,275,158,296,292,454,2297,3718,9,34017,1889,1,2,28,17,1
23138,405,8783,72,33,56,0,4,12,72,1,1,1,1,2,2,0,2,0,1,0,0,2,43,48,1
23139,405,8783,1454,835,1044,76,110,219,1530,17,275,158,296,292,454,2297,3718,9,34017,1889,1,2,43,48,1
23140,400,8717,72,33,56,0,4,12,72,1,1,1,1,2,2,0,2,0,1,0,0,2,12,25,1
23141,400,8717,1454,835,1044,76,110,219,1530,17,275,158,296,292,454,2297,3718,9,34017,1889,1,2,12,25,1
23165,405,8765,72,33,56,0,4,12,72,1,1,1,1,2,2,0,2,0,1,0,0,2,36,30,1
23166,405,8765,1454,835,1044,76,110,219,1530,17,275,158,296,292,454,2297,3718,9,34017,1889,1,2,36,30,1
23167,52,1044,1098,241,925,5,10,155,1103,7,46,25,49,53,74,273,423,3,1580,87,0,2,1,2,1
23168,52,1044,282,202,222,14,2,44,296,8,42,24,43,50,67,250,378,4,1548,86,0,2,1,2,1
23171,405,8766,72,33,56,0,4,12,72,1,1,1,1,2,2,0,2,0,1,0,0,2,32,0,1
23172,405,8766,1454,835,1044,76,110,219,1530,17,275,158,296,292,454,2297,3718,9,34017,1889,1,2,32,0,1
23173,405,8764,72,33,56,0,4,12,72,1,1,1,1,2,2,0,2,0,1,0,0,2,3,3,1
23174,405,8764,1454,835,1044,76,110,219,1530,17,275,158,296,292,454,2297,3718,9,34017,1889,1,2,3,3,1
23199,401,8727,72,33,56,0,4,12,72,1,1,1,1,2,2,0,2,0,1,0,0,2,78,78,1
23200,401,8727,1454,835,1044,76,110,219,1530,17,275,158,296,292,454,2297,3718,9,34017,1889,1,2,78,78,1
23201,52,1047,1098,241,925,5,10,155,1103,7,46,25,49,53,74,273,423,3,1580,87,0,2,2,0,1
23202,52,1047,282,202,222,14,2,44,296,8,42,24,43,50,67,250,378,4,1548,86,0,2,2,0,1
23205,397,8658,72,33,56,0,4,12,72,1,1,1,1,2,2,0,2,0,1,0,0,2,0,15,0
23206,397,8658,1454,835,1044,76,110,219,1530,17,275,158,296,292,454,2297,3718,9,34017,1889,1,2,0,15,0
23230,401,8717,72,33,56,0,4,12,72,1,1,1,1,2,2,0,2,0,1,0,0,2,13,4,1
23231,401,8717,1454,835,1044,76,110,219,1530,17,275,158,296,292,454,2297,3718,9,34017,1889,1,2,13,4,1
23234,401,8717,72,33,56,0,4,12,72,1,1,1,1,2,2,0,2,0,1,0,0,2,1,1,1
23235,401,8717,1454,835,1044,76,110,219,1530,17,275,158,296,292,454,2297,3718,9,34017,1889,1,2,1,1,1
23259,402,8746,72,33,56,0,4,12,72,1,1,1,1,2,2,0,2,0,1,0,0,2,3,0,1
23260,402,8746,1454,835,1044,76,110,219,1530,17,275,158,296,292,454,2297,3718,9,34017,1889,1,2,3,0,1
23263,402,8748,72,33,56,0,4,12,72,1,1,1,1,2,2,0,2,0,1,0,0,2,1,1,1
23264,402,8748,1454,835,1044,76,110,219,1530,17,275,158,296,292,454,2297,3718,9,34017,1889,1,2,1,1,1
23289,164,3666,77,34,69,0,0,8,77,3,24,16,29,27,45,114,213,1,387,21,0,2,32,21,1
23290,164,3666,712,438,573,51,9,84,763,14,102,71,128,116,199,733,1364,8,11988,666,0,2,32,21,1
23291,56,1056,1020,354,843,12,15,144,1032,8,134,77,144,142,221,970,1580,4,6792,377,0,2,1,9,1
23292,403,8758,72,33,56,0,4,12,72,1,1,1,1,2,2,0,2,0,1,0,0,2,7,4,1
23293,403,8758,1454,835,1044,76,110,219,1530,17,275,158,296,292,454,2297,3718,9,34017,1889,1,2,7,4,1
23297,35,1533,1020,354,843,12,15,144,1032,8,134,77,144,142,221,970,1580,4,6792,377,0,2,13,12,1
23321,403,8760,72,33,56,0,4,12,72,1,1,1,1,2,2,0,2,0,1,0,0,2,2,2,1
23322,403,8760,1454,835,1044,76,110,219,1530,17,275,158,296,292,454,2297,3718,9,34017,1889,1,2,2,2,1
23325,36,1564,1020,354,843,12,15,144,1032,8,134,77,144,142,221,970,1580,4,6792,377,0,2,19,0,1
23349,403,8762,72,33,56,0,4,12,72,1,1,1,1,2,2,0,2,0,1,0,0,2,1,1,1
23350,403,8762,1454,835,1044,76,110,219,1530,17,275,158,296,292,454,2297,3718,9,34017,1889,1,2,1,1,1
23353,27,1019,1098,241,925,5,10,155,1103,7,46,25,49,53,74,273,423,3,1580,87,0,2,1,1,1
23377,403,8761,72,33,56,0,4,12,72,1,1,1,1,2,2,0,2,0,1,0,0,2,4,2,1
23378,403,8761,1454,835,1044,76,110,219,1530,17,275,158,296,292,454,2297,3718,9,34017,1889,1,2,4,2,1
23405,403,8767,72,33,56,0,4,12,72,1,1,1,1,2,2,0,2,0,1,0,0,2,12,14,1
23406,403,8767,1454,835,1044,76,110,219,1530,17,275,158,296,292,454,2297,3718,9,34017,1889,1,2,12,14,1
23432,403,8776,72,33,56,0,4,12,72,1,1,1,1,2,2,0,2,0,1,0,0,2,4,0,1
23433,403,8776,1454,835,1044,76,110,219,1530,17,275,158,296,292,454,2297,3718,9,34017,1889,1,2,4,0,1
23461,32,1987,1523,757,1297,19,12,193,1542,12,193,117,230,205,347,1508,2664,7,19053,1058,0,2,2,2,1
23486,188,4439,722,423,573,19,0,135,741,12,172,101,199,184,300,1320,2257,6,15668,870,0,2,2,0,0
23487,188,4439,1508,847,911,44,250,301,1552,14,148,88,169,162,257,1120,1886,7,15077,837,0,2,2,0,0
23539,409,8844,72,33,56,0,4,12,72,1,1,1,1,2,2,0,2,0,1,0,0,2,23,1,1
23540,409,8844,1454,835,1044,76,110,219,1530,17,275,158,296,292,454,2297,3718,9,34017,1889,1,2,23,1,1
23543,409,8846,72,33,56,0,4,12,72,1,1,1,1,2,2,0,2,0,1,0,0,2,3,1,1
23544,409,8846,1454,835,1044,76,110,219,1530,17,275,158,296,292,454,2297,3718,9,34017,1889,1,2,3,1,1
23545,83,1453,1178,367,1042,6,15,115,1184,9,94,51,95,103,146,644,976,4,4439,246,0,2,3,1,1
23546,83,1453,177,108,140,8,0,27,185,6,30,16,32,36,48,162,248,3,794,44,0,2,3,1,1
23570,83,1452,1178,367,1042,6,15,115,1184,9,94,51,95,103,146,644,976,4,4439,246,0,2,7,8,1
23571,83,1452,177,108,140,8,0,27,185,6,30,16,32,36,48,162,248,3,794,44,0,2,7,8,1
23575,38,1723,1178,367,1042,6,15,115,1184,9,94,51,95,103,146,644,976,4,4439,246,0,2,2,2,1
23624,9,372,42,7,35,4,0,5,46,1,2,1,2,3,3,2,4,0,2,0,0,2,17,3,1
23625,9,372,11,6,10,0,0,1,11,2,4,2,4,6,6,10,15,1,15,0,0,2,17,3,1
23649,11,401,42,7,35,4,0,5,46,1,2,1,2,3,3,2,4,0,2,0,0,2,4,2,1
23650,11,401,11,6,10,0,0,1,11,2,4,2,4,6,6,10,15,1,15,0,0,2,4,2,1
23674,409,8854,72,33,56,0,4,12,72,1,1,1,1,2,2,0,2,0,1,0,0,2,2,2,1
23675,409,8854,1454,835,1044,76,110,219,1530,17,275,158,296,292,454,2297,3718,9,34017,1889,1,2,2,2,1
23676,11,401,42,7,35,4,0,5,46,1,2,1,2,3,3,2,4,0,2,0,0,2,1,1,1
23677,11,401,11,6,10,0,0,1,11,2,4,2,4,6,6,10,15,1,15,0,0,2,1,1,1
23704,100,2275,1660,832,1314,41,38,274,1701,20,312,209,395,332,604,2671,5058,12,64042,3557,1,2,7,4,1
23728,409,8857,72,33,56,0,4,12,72,1,1,1,1,2,2,0,2,0,1,0,0,2,1,1,1
23729,409,8857,1454,835,1044,76,110,219,1530,17,275,158,296,292,454,2297,3718,9,34017,1889,1,2,1,1,1
23755,165,3672,77,34,69,0,0,8,77,3,24,16,29,27,45,114,213,1,387,21,0,2,5,3,1
23756,165,3672,712,438,573,51,9,84,763,14,102,71,128,116,199,733,1364,8,11988,666,0,2,5,3,1
23757,409,8857,72,33,56,0,4,12,72,1,1,1,1,2,2,0,2,0,1,0,0,2,1,0,1
23758,409,8857,1454,835,1044,76,110,219,1530,17,275,158,296,292,454,2297,3718,9,34017,1889,1,2,1,0,1
23784,53,1057,1098,241,925,5,10,155,1103,7,46,25,49,53,74,273,423,3,1580,87,0,2,5,2,1
23785,53,1057,282,202,222,14,2,44,296,8,42,24,43,50,67,250,378,4,1548,86,0,2,5,2,1
23788,27,1018,1098,241,925,5,10,155,1103,7,46,25,49,53,74,273,423,3,1580,87,0,2,12,3,1
23812,55,1085,1098,241,925,5,10,155,1103,7,46,25,49,53,74,273,423,3,1580,87,0,2,5,2,1
23813,55,1085,282,202,222,14,2,44,296,8,42,24,43,50,67,250,378,4,1548,86,0,2,5,2,1
23816,28,1072,1098,241,925,5,10,155,1103,7,46,25,49,53,74,273,423,3,1580,87,0,2,22,2,1
23817,139,2729,1457,730,1242,11,6,188,1468,10,292,166,329,302,495,2424,4078,5,22973,1276,1,2,32,6,1
23818,139,2729,74,35,59,1,0,14,75,3,14,7,14,17,21,58,85,1,128,7,0,2,32,6,1
23819,139,2729,245,125,200,5,7,34,250,7,30,17,34,37,51,166,265,3,1053,58,0,2,32,6,1
23820,43,415,647,139,84,35,284,233,682,0,0,0,0,0,0,0,0,0,0,0,0,2,4,2,1
23847,1,199,382,65,130,157,2,92,539,4,10,5,10,14,15,41,57,2,114,6,0,2,4,4,1
23848,11,401,42,7,35,4,0,5,46,1,2,1,2,3,3,2,4,0,2,0,0,2,2,2,1
23849,11,401,11,6,10,0,0,1,11,2,4,2,4,6,6,10,15,1,15,0,0,2,2,2,1
23850,135,2675,1457,730,1242,11,6,188,1468,10,292,166,329,302,495,2424,4078,5,22973,1276,1,2,0,11,0
23851,135,2675,74,35,59,1,0,14,75,3,14,7,14,17,21,58,85,1,128,7,0,2,0,11,0
23852,135,2675,245,125,200,5,7,34,250,7,30,17,34,37,51,166,265,3,1053,58,0,2,0,11,0
23853,1,199,382,65,130,157,2,92,539,4,10,5,10,14,15,41,57,2,114,6,0,2,1,1,0
23856,410,8865,72,33,56,0,4,12,72,1,1,1,1,2,2,0,2,0,1,0,0,2,9,1,1
23857,410,8865,1454,835,1044,76,110,219,1530,17,275,158,296,292,454,2297,3718,9,34017,1889,1,2,9,1,1
23858,410,8865,72,33,56,0,4,12,72,1,1,1,1,2,2,0,2,0,1,0,0,2,9,1,0
23859,410,8865,1454,835,1044,76,110,219,1530,17,275,158,296,292,454,2297,3718,9,34017,1889,1,2,9,1,0
23883,411,8864,72,33,56,0,4,12,72,1,1,1,1,2,2,0,2,0,1,0,0,2,6,6,1
23884,411,8864,1454,835,1044,76,110,219,1530,17,275,158,296,292,454,2297,3718,9,34017,1889,1,2,6,6,1
23885,12,222,127,75,83,2,11,30,129,4,14,7,14,18,21,61,87,2,175,9,0,2,3,3,1
23886,12,222,652,304,544,16,6,88,668,6,89,51,101,95,152,591,998,3,3399,188,0,2,3,3,1
23887,12,222,2,2,2,0,0,0,2,0,0,0,0,0,0,0,0,0,0,0,0,2,3,3,1
23888,12,222,8,5,5,0,0,3,8,0,0,0,0,0,0,0,0,0,0,0,0,2,3,3,1
23891,12,222,14,8,8,0,0,6,14,0,0,0,0,0,0,0,0,0,0,0,0,2,3,3,1
23892,12,222,6,4,4,0,0,2,6,0,0,0,0,0,0,0,0,0,0,0,0,2,3,3,1
23893,12,222,6,4,4,0,0,2,6,1,2,1,2,3,3,2,4,0,2,0,0,2,3,3,1
23895,12,222,7,5,5,0,0,2,7,0,0,0,0,0,0,0,0,0,0,0,0,2,3,3,1
23897,12,222,10,6,6,0,0,4,10,0,0,0,0,0,0,0,0,0,0,0,0,2,3,3,1
23898,12,222,1,1,1,0,0,0,1,0,0,0,0,0,0,0,0,0,0,0,0,2,3,3,1
23900,12,222,14,10,10,0,0,4,14,1,1,1,1,2,2,0,2,0,1,0,0,2,3,3,1
23901,12,222,46,26,30,3,0,12,49,3,6,3,6,9,9,20,28,1,42,2,0,2,3,3,1
23904,409,8836,72,33,56,0,4,12,72,1,1,1,1,2,2,0,2,0,1,0,0,2,0,6,0
23905,409,8836,1454,835,1044,76,110,219,1530,17,275,158,296,292,454,2297,3718,9,34017,1889,1,2,0,6,0
23906,51,2762,1338,495,1086,10,64,173,1348,11,122,82,157,133,239,883,1686,7,11934,663,0,0,721,0,1
23907,97,4106,139,89,101,2,0,35,141,7,54,34,62,61,96,330,569,4,2287,127,0,3,248,1616,1
23908,97,4106,7,5,5,0,0,2,7,1,2,1,2,3,3,2,4,0,2,0,0,3,248,1616,1
23909,39,2430,1782,648,1425,9,47,279,1791,8,171,97,189,179,286,1292,2140,4,9462,525,0,0,575,0,1
23910,9,192,256,139,192,9,7,47,265,4,23,12,24,27,36,112,171,2,357,19,0,0,64,0,1
23911,57,1111,1098,241,925,5,10,155,1103,7,46,25,49,53,74,273,423,3,1580,87,0,2,4,0,1
23912,57,1111,282,202,222,14,2,44,296,8,42,24,43,50,67,250,378,4,1548,86,0,2,4,0,1
23913,29,1111,1098,241,925,5,10,155,1103,7,46,25,49,53,74,273,423,3,1580,87,0,2,19,0,1
23914,11,401,42,7,35,4,0,5,46,1,2,1,2,3,3,2,4,0,2,0,0,2,1,1,0
23915,11,401,11,6,10,0,0,1,11,2,4,2,4,6,6,10,15,1,15,0,0,2,1,1,0
23916,13,417,424,94,331,4,0,89,428,1,5,5,5,6,10,11,25,0,12,0,0,2,6,0,1
23917,19,299,424,94,331,4,0,89,428,1,5,5,5,6,10,11,25,0,12,0,0,2,1,1,0
23918,19,299,38,23,23,6,0,8,44,3,11,7,11,14,18,42,68,1,102,5,0,2,1,1,0
23919,13,417,424,94,331,4,0,89,428,1,5,5,5,6,10,11,25,0,12,0,0,2,6,0,0
23920,38,1618,1020,354,843,12,15,144,1032,8,134,77,144,142,221,970,1580,4,6792,377,0,2,19,0,1
23948,12,417,42,7,35,4,0,5,46,1,2,1,2,3,3,2,4,0,2,0,0,2,4,2,0
23949,12,417,11,6,10,0,0,1,11,2,4,2,4,6,6,10,15,1,15,0,0,2,4,2,0
23973,12,417,42,7,35,4,0,5,46,1,2,1,2,3,3,2,4,0,2,0,0,2,2,2,1
23974,12,417,11,6,10,0,0,1,11,2,4,2,4,6,6,10,15,1,15,0,0,2,2,2,1
23998,411,8874,72,33,56,0,4,12,72,1,1,1,1,2,2,0,2,0,1,0,0,2,6,0,1
23999,411,8874,1454,835,1044,76,110,219,1530,17,275,158,296,292,454,2297,3718,9,34017,1889,1,2,6,0,1
24000,12,417,42,7,35,4,0,5,46,1,2,1,2,3,3,2,4,0,2,0,0,2,1,1,1
24001,12,417,11,6,10,0,0,1,11,2,4,2,4,6,6,10,15,1,15,0,0,2,1,1,1
24002,95,3966,139,89,101,2,0,35,141,7,54,34,62,61,96,330,569,4,2287,127,0,2,0,53,1
24003,95,3966,7,5,5,0,0,2,7,1,2,1,2,3,3,2,4,0,2,0,0,2,0,53,1
24004,12,339,465,148,393,5,8,60,470,4,31,20,31,35,51,161,261,2,523,29,0,0,119,0,1
24005,12,339,16,12,9,0,0,6,16,1,2,1,2,3,3,2,4,0,2,0,0,0,119,0,1
24006,38,1620,1020,354,843,12,15,144,1032,8,134,77,144,142,221,970,1580,4,6792,377,0,2,1,1,1
24007,13,410,424,94,331,4,0,89,428,1,5,5,5,6,10,11,25,0,12,0,0,2,3,11,1
24031,138,2747,1457,730,1242,11,6,188,1468,10,292,166,329,302,495,2424,4078,5,22973,1276,1,2,24,6,1
24032,138,2747,74,35,59,1,0,14,75,3,14,7,14,17,21,58,85,1,128,7,0,2,24,6,1
24033,138,2747,245,125,200,5,7,34,250,7,30,17,34,37,51,166,265,3,1053,58,0,2,24,6,1
24034,43,415,647,139,84,35,284,233,682,0,0,0,0,0,0,0,0,0,0,0,0,2,23,5,1
24037,33,1692,1457,730,1242,11,6,188,1468,10,292,166,329,302,495,2424,4078,5,22973,1276,1,2,11,0,1
24064,19,303,424,94,331,4,0,89,428,1,5,5,5,6,10,11,25,0,12,0,0,2,1,1,1
24065,19,303,38,23,23,6,0,8,44,3,11,7,11,14,18,42,68,1,102,5,0,2,1,1,1
24066,12,417,42,7,35,4,0,5,46,1,2,1,2,3,3,2,4,0,2,0,0,2,29,5,1
24067,12,417,11,6,10,0,0,1,11,2,4,2,4,6,6,10,15,1,15,0,0,2,29,5,1
24068,12,417,42,7,35,4,0,5,46,1,2,1,2,3,3,2,4,0,2,0,0,2,1,1,0
24069,12,417,11,6,10,0,0,1,11,2,4,2,4,6,6,10,15,1,15,0,0,2,1,1,0
24121,56,1054,1020,354,843,12,15,144,1032,8,134,77,144,142,221,970,1580,4,6792,377,0,2,1,1,1
24124,40,1736,1020,354,843,12,15,144,1032,8,134,77,144,142,221,970,1580,4,6792,377,0,2,24,1,1
24148,52,1026,1020,354,843,12,15,144,1032,8,134,77,144,142,221,970,1580,4,6792,377,0,2,14,25,1
24151,42,1846,1020,354,843,12,15,144,1032,8,134,77,144,142,221,970,1580,4,6792,377,0,2,21,3,1
24175,140,2768,1457,730,1242,11,6,188,1468,10,292,166,329,302,495,2424,4078,5,22973,1276,1,2,7,2,1
24176,140,2768,74,35,59,1,0,14,75,3,14,7,14,17,21,58,85,1,128,7,0,2,7,2,1
24177,140,2768,245,125,200,5,7,34,250,7,30,17,34,37,51,166,265,3,1053,58,0,2,7,2,1
24180,34,1716,1457,730,1242,11,6,188,1468,10,292,166,329,302,495,2424,4078,5,22973,1276,1,2,4,0,1
24181,411,8874,72,33,56,0,4,12,72,1,1,1,1,2,2,0,2,0,1,0,0,2,2,2,1
24182,411,8874,1454,835,1044,76,110,219,1530,17,275,158,296,292,454,2297,3718,9,34017,1889,1,2,2,2,1
24206,411,8876,72,33,56,0,4,12,72,1,1,1,1,2,2,0,2,0,1,0,0,2,10,4,1
24207,411,8876,1454,835,1044,76,110,219,1530,17,275,158,296,292,454,2297,3718,9,34017,1889,1,2,10,4,1
24210,96,4040,139,89,101,2,0,35,141,7,54,34,62,61,96,330,569,4,2287,127,0,2,25,1,1
24211,96,4040,7,5,5,0,0,2,7,1,2,1,2,3,3,2,4,0,2,0,0,2,25,1,1
24212,412,8880,72,33,56,0,4,12,72,1,1,1,1,2,2,0,2,0,1,0,0,2,9,6,1
24213,412,8880,1454,835,1044,76,110,219,1530,17,275,158,296,292,454,2297,3718,9,34017,1889,1,2,9,6,1
24214,11,355,442,244,305,14,16,103,456,11,68,45,75,79,120,452,756,6,4588,254,0,2,3,3,1
24215,11,355,182,102,99,11,40,35,193,3,11,6,11,14,17,42,64,1,97,5,0,2,3,3,1
24216,6,488,442,244,305,14,16,103,456,11,68,45,75,79,120,452,756,6,4588,254,0,2,3,3,1
24240,412,8878,72,33,56,0,4,12,72,1,1,1,1,2,2,0,2,0,1,0,0,2,1,1,1
24241,412,8878,1454,835,1044,76,110,219,1530,17,275,158,296,292,454,2297,3718,9,34017,1889,1,2,1,1,1
24244,97,4113,139,89,101,2,0,35,141,7,54,34,62,61,96,330,569,4,2287,127,0,2,19,0,1
24245,97,4113,7,5,5,0,0,2,7,1,2,1,2,3,3,2,4,0,2,0,0,2,19,0,1
24246,414,8900,72,33,56,0,4,12,72,1,1,1,1,2,2,0,2,0,1,0,0,2,10,8,1
24247,414,8900,1454,835,1044,76,110,219,1530,17,275,158,296,292,454,2297,3718,9,34017,1889,1,2,10,8,1
24248,98,4142,139,89,101,2,0,35,141,7,54,34,62,61,96,330,569,4,2287,127,0,2,18,0,1
24249,98,4142,7,5,5,0,0,2,7,1,2,1,2,3,3,2,4,0,2,0,0,2,18,0,1
24250,34,1725,1457,730,1242,11,6,188,1468,10,292,166,329,302,495,2424,4078,5,22973,1276,1,2,1,0,0
24325,52,1027,1020,354,843,12,15,144,1032,8,134,77,144,142,221,970,1580,4,6792,377,0,2,6,5,1
24328,12,424,42,7,35,4,0,5,46,1,2,1,2,3,3,2,4,0,2,0,0,2,1,37,0
24329,12,424,11,6,10,0,0,1,11,2,4,2,4,6,6,10,15,1,15,0,0,2,1,37,0
24330,12,424,42,7,35,4,0,5,46,1,2,1,2,3,3,2,4,0,2,0,0,2,1,1,1
24331,12,424,11,6,10,0,0,1,11,2,4,2,4,6,6,10,15,1,15,0,0,2,1,1,1
24332,414,8900,72,33,56,0,4,12,72,1,1,1,1,2,2,0,2,0,1,0,0,2,5,2,1
24333,414,8900,1454,835,1044,76,110,219,1530,17,275,158,296,292,454,2297,3718,9,34017,1889,1,2,5,2,1
24357,69,1236,1513,682,1277,25,13,200,1538,11,199,116,219,210,335,1557,2584,6,15641,868,0,2,5,2,1
24358,69,1236,819,519,539,24,98,155,843,15,96,57,106,111,163,690,1107,8,9171,509,0,2,5,2,1
24361,21,825,1293,570,1093,25,15,163,1318,10,195,123,241,205,364,1516,2795,6,17273,959,0,2,16,0,1
24362,413,8892,72,33,56,0,4,12,72,1,1,1,1,2,2,0,2,0,1,0,0,2,6,7,1
24363,413,8892,1454,835,1044,76,110,219,1530,17,275,158,296,292,454,2297,3718,9,34017,1889,1,2,6,7,1
24364,52,2827,1338,495,1086,10,64,173,1348,11,122,82,157,133,239,883,1686,7,11934,663,0,2,22,0,1
24392,29,603,2,2,2,0,0,0,2,0,0,0,0,0,0,0,0,0,0,0,0,2,1,1,1
24406,29,603,99,48,90,1,3,5,100,0,0,0,0,0,0,0,0,0,0,0,0,2,1,1,1
24407,29,603,8,5,5,2,0,1,10,0,0,0,0,0,0,0,0,0,0,0,0,2,1,1,1
24408,29,603,1217,716,841,84,126,174,1301,14,185,118,215,199,333,1446,2542,8,20687,1149,0,2,1,1,1
24409,29,603,160,89,115,0,13,31,160,7,15,11,17,22,28,78,124,3,495,27,0,2,1,1,1
24410,29,603,10,10,9,9,0,0,19,0,0,0,0,0,0,0,0,0,0,0,0,2,1,1,1
24411,29,603,173,84,99,8,29,36,181,5,12,7,13,17,20,54,81,2,221,12,0,2,1,1,1
24412,29,603,3,1,1,3,0,0,6,0,0,0,0,0,0,0,0,0,0,0,0,2,1,1,1
24413,29,1172,1450,624,1228,12,26,181,1462,14,306,186,354,320,540,2580,4493,8,36391,2021,1,2,1,1,1
24414,11,345,74,35,59,1,0,14,75,3,14,7,14,17,21,58,85,1,128,7,0,2,2,1,0
24440,120,3840,1660,832,1314,41,38,274,1701,20,312,209,395,332,604,2671,5058,12,64042,3557,1,2,8,4,1
24441,120,3840,1057,646,719,113,100,145,1170,18,215,134,248,233,382,1740,3004,10,31186,1732,1,2,8,4,1
24442,102,2320,1660,832,1314,41,38,274,1701,20,312,209,395,332,604,2671,5058,12,64042,3557,1,2,10,2,1
24444,96,2189,1043,504,840,53,9,147,1096,9,180,112,198,189,310,1377,2344,4,11604,644,0,2,1,0,1
24445,96,2189,383,288,292,26,6,62,409,11,65,38,67,76,105,429,656,5,3719,206,0,2,1,0,1
24446,45,1829,1043,504,840,53,9,147,1096,9,180,112,198,189,310,1377,2344,4,11604,644,0,2,4,0,1
24448,18,678,1455,414,1257,16,76,112,1471,5,41,23,46,46,69,231,381,2,1069,59,0,2,7,0,1
24449,18,678,669,365,481,22,61,110,691,15,103,63,122,118,185,747,1273,8,11311,628,0,2,7,0,1
24450,188,4434,722,423,573,19,0,135,741,12,172,101,199,184,300,1320,2257,6,15668,870,0,2,3,5,1
24451,188,4434,1508,847,911,44,250,301,1552,14,148,88,169,162,257,1120,1886,7,15077,837,0,2,3,5,1
24452,45,1832,1043,504,840,53,9,147,1096,9,180,112,198,189,310,1377,2344,4,11604,644,0,2,1,1,1
24453,98,4158,139,89,101,2,0,35,141,7,54,34,62,61,96,330,569,4,2287,127,0,2,2,2,1
24454,98,4158,7,5,5,0,0,2,7,1,2,1,2,3,3,2,4,0,2,0,0,2,2,2,1
24455,19,306,424,94,331,4,0,89,428,1,5,5,5,6,10,11,25,0,12,0,0,2,2,1,1
24456,19,306,38,23,23,6,0,8,44,3,11,7,11,14,18,42,68,1,102,5,0,2,2,1,1
24457,21,326,424,94,331,4,0,89,428,1,5,5,5,6,10,11,25,0,12,0,0,2,12,2,1
24458,21,326,38,23,23,6,0,8,44,3,11,7,11,14,18,42,68,1,102,5,0,2,12,2,1
24459,14,437,424,94,331,4,0,89,428,1,5,5,5,6,10,11,25,0,12,0,0,2,25,0,1
24460,21,326,424,94,331,4,0,89,428,1,5,5,5,6,10,11,25,0,12,0,0,2,14,3,0
24461,21,326,38,23,23,6,0,8,44,3,11,7,11,14,18,42,68,1,102,5,0,2,14,3,0
24462,14,437,424,94,331,4,0,89,428,1,5,5,5,6,10,11,25,0,12,0,0,2,25,0,0
24486,12,424,42,7,35,4,0,5,46,1,2,1,2,3,3,2,4,0,2,0,0,2,2,2,1
24487,12,424,11,6,10,0,0,1,11,2,4,2,4,6,6,10,15,1,15,0,0,2,2,2,1
24488,30,1205,1450,624,1228,12,26,181,1462,14,306,186,354,320,540,2580,4493,8,36391,2021,1,2,13,0,1
24489,35,630,127,75,83,2,11,30,129,4,14,7,14,18,21,61,87,2,175,9,0,2,2,1,0
24490,35,630,652,304,544,16,6,88,668,6,89,51,101,95,152,591,998,3,3399,188,0,2,2,1,0
24491,35,630,2,2,2,0,0,0,2,0,0,0,0,0,0,0,0,0,0,0,0,2,2,1,0
24492,35,630,8,5,5,0,0,3,8,0,0,0,0,0,0,0,0,0,0,0,0,2,2,1,0
24495,35,630,14,8,8,0,0,6,14,0,0,0,0,0,0,0,0,0,0,0,0,2,2,1,0
24496,35,630,6,4,4,0,0,2,6,0,0,0,0,0,0,0,0,0,0,0,0,2,2,1,0
24497,35,630,6,4,4,0,0,2,6,1,2,1,2,3,3,2,4,0,2,0,0,2,2,1,0
24499,35,630,7,5,5,0,0,2,7,0,0,0,0,0,0,0,0,0,0,0,0,2,2,1,0
24501,35,630,10,6,6,0,0,4,10,0,0,0,0,0,0,0,0,0,0,0,0,2,2,1,0
24502,35,630,1,1,1,0,0,0,1,0,0,0,0,0,0,0,0,0,0,0,0,2,2,1,0
24504,35,630,14,10,10,0,0,4,14,1,1,1,1,2,2,0,2,0,1,0,0,2,2,1,0
24505,35,630,46,26,30,3,0,12,49,3,6,3,6,9,9,20,28,1,42,2,0,2,2,1,0
24506,413,8895,72,33,56,0,4,12,72,1,1,1,1,2,2,0,2,0,1,0,0,2,1,1,1
24507,413,8895,1454,835,1044,76,110,219,1530,17,275,158,296,292,454,2297,3718,9,34017,1889,1,2,1,1,1
24508,39,2462,1782,648,1425,9,47,279,1791,8,171,97,189,179,286,1292,2140,4,9462,525,0,2,5,0,1
24509,12,424,42,7,35,4,0,5,46,1,2,1,2,3,3,2,4,0,2,0,0,2,1,1,0
24510,12,424,11,6,10,0,0,1,11,2,4,2,4,6,6,10,15,1,15,0,0,2,1,1,0
24511,39,2468,1782,648,1425,9,47,279,1791,8,171,97,189,179,286,1292,2140,4,9462,525,0,2,1,1,0
24512,162,3661,77,34,69,0,0,8,77,3,24,16,29,27,45,114,213,1,387,21,0,2,6,4,0
24513,162,3661,712,438,573,51,9,84,763,14,102,71,128,116,199,733,1364,8,11988,666,0,2,6,4,0
24514,156,3100,1943,715,1694,26,18,214,1969,12,185,120,237,197,357,1436,2721,7,20915,1161,0,2,1,1,1
24515,156,3100,1168,838,957,57,25,144,1225,19,348,224,416,367,640,3018,5452,11,61921,3440,1,2,1,1,1
24516,61,2541,1289,550,1043,56,32,155,1345,10,167,93,185,177,278,1266,2075,5,11498,638,0,2,15,0,1
24517,413,8917,72,33,56,0,4,12,72,1,1,1,1,2,2,0,2,0,1,0,0,2,7,3,0
24518,413,8917,1454,835,1044,76,110,219,1530,17,275,158,296,292,454,2297,3718,9,34017,1889,1,2,7,3,0
24519,53,2846,1338,495,1086,10,64,173,1348,11,122,82,157,133,239,883,1686,7,11934,663,0,2,5,2,0
24520,83,1463,1178,367,1042,6,15,115,1184,9,94,51,95,103,146,644,976,4,4439,246,0,2,7,1,0
24521,83,1463,177,108,140,8,0,27,185,6,30,16,32,36,48,162,248,3,794,44,0,2,7,1,0
24522,39,1775,1178,367,1042,6,15,115,1184,9,94,51,95,103,146,644,976,4,4439,246,0,2,14,0,0
24523,83,1456,1178,367,1042,6,15,115,1184,9,94,51,95,103,146,644,976,4,4439,246,0,2,1,7,0
24524,83,1456,177,108,140,8,0,27,185,6,30,16,32,36,48,162,248,3,794,44,0,2,1,7,0
24525,125,3938,1660,832,1314,41,38,274,1701,20,312,209,395,332,604,2671,5058,12,64042,3557,1,2,27,0,1
24526,125,3938,1057,646,719,113,100,145,1170,18,215,134,248,233,382,1740,3004,10,31186,1732,1,2,27,0,1
24527,103,2378,1660,832,1314,41,38,274,1701,20,312,209,395,332,604,2671,5058,12,64042,3557,1,2,8,0,1
24528,1,224,382,65,130,157,2,92,539,4,10,5,10,14,15,41,57,2,114,6,0,2,13,0,1
24529,1,200,382,65,130,157,2,92,539,4,10,5,10,14,15,41,57,2,114,6,0,2,13,0,1
24530,165,3711,77,34,69,0,0,8,77,3,24,16,29,27,45,114,213,1,387,21,0,2,12,0,0
24531,165,3711,712,438,573,51,9,84,763,14,102,71,128,116,199,733,1364,8,11988,666,0,2,12,0,0
24532,21,343,424,94,331,4,0,89,428,1,5,5,5,6,10,11,25,0,12,0,0,2,2,0,0
24533,21,343,38,23,23,6,0,8,44,3,11,7,11,14,18,42,68,1,102,5,0,2,2,0,0
24536,15,464,424,94,331,4,0,89,428,1,5,5,5,6,10,11,25,0,12,0,0,2,9,0,0
24537,162,3675,77,34,69,0,0,8,77,3,24,16,29,27,45,114,213,1,387,21,0,2,4,10,1
24538,162,3675,712,438,573,51,9,84,763,14,102,71,128,116,199,733,1364,8,11988,666,0,2,4,10,1
24539,96,2186,1043,504,840,53,9,147,1096,9,180,112,198,189,310,1377,2344,4,11604,644,0,2,1,1,1
24540,96,2186,383,288,292,26,6,62,409,11,65,38,67,76,105,429,656,5,3719,206,0,2,1,1,1
24541,18,674,1455,414,1257,16,76,112,1471,5,41,23,46,46,69,231,381,2,1069,59,0,2,1,2,1
24542,18,674,669,365,481,22,61,110,691,15,103,63,122,118,185,747,1273,8,11311,628,0,2,1,2,1
24543,12,510,1455,414,1257,16,76,112,1471,5,41,23,46,46,69,231,381,2,1069,59,0,2,9,0,1
24544,18,712,1455,414,1257,16,76,112,1471,5,41,23,46,46,69,231,381,2,1069,59,0,2,5,0,1
24545,18,712,669,365,481,22,61,110,691,15,103,63,122,118,185,747,1273,8,11311,628,0,2,5,0,1
24546,13,546,1455,414,1257,16,76,112,1471,5,41,23,46,46,69,231,381,2,1069,59,0,2,11,0,1
24547,13,542,1455,414,1257,16,76,112,1471,5,41,23,46,46,69,231,381,2,1069,59,0,2,2,2,0
24548,18,712,1455,414,1257,16,76,112,1471,5,41,23,46,46,69,231,381,2,1069,59,0,2,2,2,1
24549,18,712,669,365,481,22,61,110,691,15,103,63,122,118,185,747,1273,8,11311,628,0,2,2,2,1
24550,13,542,1455,414,1257,16,76,112,1471,5,41,23,46,46,69,231,381,2,1069,59,0,2,2,2,1
24551,18,712,1455,414,1257,16,76,112,1471,5,41,23,46,46,69,231,381,2,1069,59,0,2,11,0,0
24552,18,712,669,365,481,22,61,110,691,15,103,63,122,118,185,747,1273,8,11311,628,0,2,11,0,0
24553,13,542,1455,414,1257,16,76,112,1471,5,41,23,46,46,69,231,381,2,1069,59,0,2,20,0,0
24556,30,621,2,2,2,0,0,0,2,0,0,0,0,0,0,0,0,0,0,0,0,2,4,1,1
24570,30,621,99,48,90,1,3,5,100,0,0,0,0,0,0,0,0,0,0,0,0,2,4,1,1
24571,30,621,8,5,5,2,0,1,10,0,0,0,0,0,0,0,0,0,0,0,0,2,4,1,1
24572,30,621,1217,716,841,84,126,174,1301,14,185,118,215,199,333,1446,2542,8,20687,1149,0,2,4,1,1
24573,30,621,160,89,115,0,13,31,160,7,15,11,17,22,28,78,124,3,495,27,0,2,4,1,1
24574,30,621,10,10,9,9,0,0,19,0,0,0,0,0,0,0,0,0,0,0,0,2,4,1,1
24575,30,621,173,84,99,8,29,36,181,5,12,7,13,17,20,54,81,2,221,12,0,2,4,1,1
24576,30,621,3,1,1,3,0,0,6,0,0,0,0,0,0,0,0,0,0,0,0,2,4,1,1
24577,21,767,1455,414,1257,16,76,112,1471,5,41,23,46,46,69,231,381,2,1069,59,0,2,15,5,1
24578,21,767,669,365,481,22,61,110,691,15,103,63,122,118,185,747,1273,8,11311,628,0,2,15,5,1
24579,14,597,1455,414,1257,16,76,112,1471,5,41,23,46,46,69,231,381,2,1069,59,0,2,20,0,1
24580,41,1286,1523,757,1297,19,12,193,1542,12,193,117,230,205,347,1508,2664,7,19053,1058,0,2,2,1,1
24581,41,1286,701,378,504,33,58,109,734,13,110,68,126,123,194,794,1346,7,10027,557,0,2,2,1,1
24582,34,2075,1523,757,1297,19,12,193,1542,12,193,117,230,205,347,1508,2664,7,19053,1058,0,2,19,0,1
24583,41,1749,1513,682,1277,25,13,200,1538,11,199,116,219,210,335,1557,2584,6,15641,868,0,2,12,0,1
24584,21,345,424,94,331,4,0,89,428,1,5,5,5,6,10,11,25,0,12,0,0,2,3,1,1
24585,21,345,38,23,23,6,0,8,44,3,11,7,11,14,18,42,68,1,102,5,0,2,3,1,1
24586,15,464,424,94,331,4,0,89,428,1,5,5,5,6,10,11,25,0,12,0,0,2,23,0,1
24587,72,1496,477,336,357,30,23,73,507,16,194,134,250,210,384,1538,2962,10,30538,1696,0,2,63,34,1
24588,56,985,282,196,195,3,0,86,285,8,130,71,141,138,212,936,1507,4,6538,363,0,2,1,1,1
24589,36,1357,1450,624,1228,12,26,181,1462,14,306,186,354,320,540,2580,4493,8,36391,2021,1,2,31,4,1
24615,61,2541,1289,550,1043,56,32,155,1345,10,167,93,185,177,278,1266,2075,5,11498,638,0,2,2,0,1
24616,68,1230,1513,682,1277,25,13,200,1538,11,199,116,219,210,335,1557,2584,6,15641,868,0,2,1,2,1
24617,68,1230,819,519,539,24,98,155,843,15,96,57,106,111,163,690,1107,8,9171,509,0,2,1,2,1
24618,42,1312,1523,757,1297,19,12,193,1542,12,193,117,230,205,347,1508,2664,7,19053,1058,0,2,11,6,1
24619,42,1312,701,378,504,33,58,109,734,13,110,68,126,123,194,794,1346,7,10027,557,0,2,11,6,1
24620,36,2201,1523,757,1297,19,12,193,1542,12,193,117,230,205,347,1508,2664,7,19053,1058,0,2,23,1,1
24621,24,565,1293,570,1093,25,15,163,1318,10,195,123,241,205,364,1516,2795,6,17273,959,0,2,11,6,0
24622,68,1230,1513,682,1277,25,13,200,1538,11,199,116,219,210,335,1557,2584,6,15641,868,0,2,1,2,0
24623,68,1230,819,519,539,24,98,155,843,15,96,57,106,111,163,690,1107,8,9171,509,0,2,1,2,0
24624,42,1312,1523,757,1297,19,12,193,1542,12,193,117,230,205,347,1508,2664,7,19053,1058,0,2,11,6,0
24625,42,1312,701,378,504,33,58,109,734,13,110,68,126,123,194,794,1346,7,10027,557,0,2,11,6,0
24626,36,2201,1523,757,1297,19,12,193,1542,12,193,117,230,205,347,1508,2664,7,19053,1058,0,2,23,1,0
24627,52,1027,1020,354,843,12,15,144,1032,8,134,77,144,142,221,970,1580,4,6792,377,0,2,2,2,1
24628,15,473,424,94,331,4,0,89,428,1,5,5,5,6,10,11,25,0,12,0,0,2,4,2,1
24635,24,561,1293,570,1093,25,15,163,1318,10,195,123,241,205,364,1516,2795,6,17273,959,0,2,10,9,0
24636,25,575,1293,570,1093,25,15,163,1318,10,195,123,241,205,364,1516,2795,6,17273,959,0,2,8,3,0
24637,26,594,1293,570,1093,25,15,163,1318,10,195,123,241,205,364,1516,2795,6,17273,959,0,2,20,14,1
24638,139,2741,1457,730,1242,11,6,188,1468,10,292,166,329,302,495,2424,4078,5,22973,1276,1,2,8,15,1
24639,139,2741,74,35,59,1,0,14,75,3,14,7,14,17,21,58,85,1,128,7,0,2,8,15,1
24640,139,2741,245,125,200,5,7,34,250,7,30,17,34,37,51,166,265,3,1053,58,0,2,8,15,1
24641,101,4362,139,89,101,2,0,35,141,7,54,34,62,61,96,330,569,4,2287,127,0,2,71,0,1
24642,101,4362,7,5,5,0,0,2,7,1,2,1,2,3,3,2,4,0,2,0,0,2,71,0,1
24643,29,1371,652,304,544,16,6,88,668,6,89,51,101,95,152,591,998,3,3399,188,0,2,12,0,1
24668,417,8949,72,33,56,0,4,12,72,1,1,1,1,2,2,0,2,0,1,0,0,2,11,6,1
24669,417,8949,1454,835,1044,76,110,219,1530,17,275,158,296,292,454,2297,3718,9,34017,1889,1,2,11,6,1
24670,99,2220,1043,504,840,53,9,147,1096,9,180,112,198,189,310,1377,2344,4,11604,644,0,2,8,0,1
24671,99,2220,383,288,292,26,6,62,409,11,65,38,67,76,105,429,656,5,3719,206,0,2,8,0,1
24674,13,386,465,148,393,5,8,60,470,4,31,20,31,35,51,161,261,2,523,29,0,2,32,0,1
24675,13,386,16,12,9,0,0,6,16,1,2,1,2,3,3,2,4,0,2,0,0,2,32,0,1
24676,6,493,442,244,305,14,16,103,456,11,68,45,75,79,120,452,756,6,4588,254,0,2,1,0,1
24677,72,1494,477,336,357,30,23,73,507,16,194,134,250,210,384,1538,2962,10,30538,1696,0,2,16,13,1
24678,72,1498,477,336,357,30,23,73,507,16,194,134,250,210,384,1538,2962,10,30538,1696,0,2,1,1,1
24679,37,1394,1450,624,1228,12,26,181,1462,14,306,186,354,320,540,2580,4493,8,36391,2021,1,2,5,0,1
24680,418,8966,72,33,56,0,4,12,72,1,1,1,1,2,2,0,2,0,1,0,0,2,18,13,1
24681,418,8966,1454,835,1044,76,110,219,1530,17,275,158,296,292,454,2297,3718,9,34017,1889,1,2,18,13,1
24682,99,4187,139,89,101,2,0,35,141,7,54,34,62,61,96,330,569,4,2287,127,0,2,14,0,1
24683,99,4187,7,5,5,0,0,2,7,1,2,1,2,3,3,2,4,0,2,0,0,2,14,0,1
24684,37,1396,1450,624,1228,12,26,181,1462,14,306,186,354,320,540,2580,4493,8,36391,2021,1,2,1,1,1
24685,127,3961,1660,832,1314,41,38,274,1701,20,312,209,395,332,604,2671,5058,12,64042,3557,1,2,10,4,0
24686,127,3961,1057,646,719,113,100,145,1170,18,215,134,248,233,382,1740,3004,10,31186,1732,1,2,10,4,0
24687,38,1430,1450,624,1228,12,26,181,1462,14,306,186,354,320,540,2580,4493,8,36391,2021,1,2,14,0,0
24713,1,224,382,65,130,157,2,92,539,4,10,5,10,14,15,41,57,2,114,6,0,2,1,1,0
24762,423,9090,72,33,56,0,4,12,72,1,1,1,1,2,2,0,2,0,1,0,0,2,24,1,1
24763,423,9090,1454,835,1044,76,110,219,1530,17,275,158,296,292,454,2297,3718,9,34017,1889,1,2,24,1,1
24766,104,4340,139,89,101,2,0,35,141,7,54,34,62,61,96,330,569,4,2287,127,0,2,98,0,1
24767,104,4340,7,5,5,0,0,2,7,1,2,1,2,3,3,2,4,0,2,0,0,2,98,0,1
24768,99,2230,1043,504,840,53,9,147,1096,9,180,112,198,189,310,1377,2344,4,11604,644,0,2,1,1,0
24769,99,2230,383,288,292,26,6,62,409,11,65,38,67,76,105,429,656,5,3719,206,0,2,1,1,0
24820,84,1473,1178,367,1042,6,15,115,1184,9,94,51,95,103,146,644,976,4,4439,246,0,2,5,1,1
24821,84,1473,177,108,140,8,0,27,185,6,30,16,32,36,48,162,248,3,794,44,0,2,5,1,1
24824,42,1867,1178,367,1042,6,15,115,1184,9,94,51,95,103,146,644,976,4,4439,246,0,2,41,1,1
24850,42,1321,1523,757,1297,19,12,193,1542,12,193,117,230,205,347,1508,2664,7,19053,1058,0,2,3,2,1
24851,42,1321,701,378,504,33,58,109,734,13,110,68,126,123,194,794,1346,7,10027,557,0,2,3,2,1
24852,99,2230,1043,504,840,53,9,147,1096,9,180,112,198,189,310,1377,2344,4,11604,644,0,2,2,1,1
24853,99,2230,383,288,292,26,6,62,409,11,65,38,67,76,105,429,656,5,3719,206,0,2,2,1,1
24854,57,2580,1943,715,1694,26,18,214,1969,12,185,120,237,197,357,1436,2721,7,20915,1161,0,2,16,0,1
24855,99,2230,1043,504,840,53,9,147,1096,9,180,112,198,189,310,1377,2344,4,11604,644,0,2,2,1,0
24856,99,2230,383,288,292,26,6,62,409,11,65,38,67,76,105,429,656,5,3719,206,0,2,2,1,0
24857,57,2580,1943,715,1694,26,18,214,1969,12,185,120,237,197,357,1436,2721,7,20915,1161,0,2,16,0,0
24858,37,2246,1523,757,1297,19,12,193,1542,12,193,117,230,205,347,1508,2664,7,19053,1058,0,2,13,0,1
24859,42,1321,1523,757,1297,19,12,193,1542,12,193,117,230,205,347,1508,2664,7,19053,1058,0,2,3,2,0
24860,42,1321,701,378,504,33,58,109,734,13,110,68,126,123,194,794,1346,7,10027,557,0,2,3,2,0
24861,37,2246,1523,757,1297,19,12,193,1542,12,193,117,230,205,347,1508,2664,7,19053,1058,0,2,13,0,0
24865,12,222,127,75,83,2,11,30,129,4,14,7,14,18,21,61,87,2,175,9,0,2,1,1,0
24866,12,222,652,304,544,16,6,88,668,6,89,51,101,95,152,591,998,3,3399,188,0,2,1,1,0
24867,12,222,2,2,2,0,0,0,2,0,0,0,0,0,0,0,0,0,0,0,0,2,1,1,0
24868,12,222,8,5,5,0,0,3,8,0,0,0,0,0,0,0,0,0,0,0,0,2,1,1,0
24871,12,222,14,8,8,0,0,6,14,0,0,0,0,0,0,0,0,0,0,0,0,2,1,1,0
24872,12,222,6,4,4,0,0,2,6,0,0,0,0,0,0,0,0,0,0,0,0,2,1,1,0
24873,12,222,6,4,4,0,0,2,6,1,2,1,2,3,3,2,4,0,2,0,0,2,1,1,0
24875,12,222,7,5,5,0,0,2,7,0,0,0,0,0,0,0,0,0,0,0,0,2,1,1,0
24877,12,222,10,6,6,0,0,4,10,0,0,0,0,0,0,0,0,0,0,0,0,2,1,1,0
24878,12,222,1,1,1,0,0,0,1,0,0,0,0,0,0,0,0,0,0,0,0,2,1,1,0
24880,12,222,14,10,10,0,0,4,14,1,1,1,1,2,2,0,2,0,1,0,0,2,1,1,0
24881,12,222,46,26,30,3,0,12,49,3,6,3,6,9,9,20,28,1,42,2,0,2,1,1,0
24882,427,9239,72,33,56,0,4,12,72,1,1,1,1,2,2,0,2,0,1,0,0,2,21,2,1
24883,427,9239,1454,835,1044,76,110,219,1530,17,275,158,296,292,454,2297,3718,9,34017,1889,1,2,21,2,1
24884,51,2975,1782,648,1425,9,47,279,1791,8,171,97,189,179,286,1292,2140,4,9462,525,0,2,171,0,1
24902,25,860,1455,414,1257,16,76,112,1471,5,41,23,46,46,69,231,381,2,1069,59,0,2,19,7,1
24903,25,860,669,365,481,22,61,110,691,15,103,63,122,118,185,747,1273,8,11311,628,0,2,19,7,1
24904,22,919,1455,414,1257,16,76,112,1471,5,41,23,46,46,69,231,381,2,1069,59,0,2,95,3,1
24905,425,9242,72,33,56,0,4,12,72,1,1,1,1,2,2,0,2,0,1,0,0,2,13,10,1
24906,425,9242,1454,835,1044,76,110,219,1530,17,275,158,296,292,454,2297,3718,9,34017,1889,1,2,13,10,1
24907,51,2929,1782,648,1425,9,47,279,1791,8,171,97,189,179,286,1292,2140,4,9462,525,0,2,72,60,1
24925,164,3702,77,34,69,0,0,8,77,3,24,16,29,27,45,114,213,1,387,21,0,2,12,0,1
24926,164,3702,712,438,573,51,9,84,763,14,102,71,128,116,199,733,1364,8,11988,666,0,2,12,0,1
24927,60,1138,1020,354,843,12,15,144,1032,8,134,77,144,142,221,970,1580,4,6792,377,0,2,92,32,1
24928,42,1846,1020,354,843,12,15,144,1032,8,134,77,144,142,221,970,1580,4,6792,377,0,2,1,2,1
24929,25,860,1455,414,1257,16,76,112,1471,5,41,23,46,46,69,231,381,2,1069,59,0,2,19,7,0
24930,25,860,669,365,481,22,61,110,691,15,103,63,122,118,185,747,1273,8,11311,628,0,2,19,7,0
24931,22,919,1455,414,1257,16,76,112,1471,5,41,23,46,46,69,231,381,2,1069,59,0,2,95,3,0
24932,60,1138,1020,354,843,12,15,144,1032,8,134,77,144,142,221,970,1580,4,6792,377,0,2,1,1,1
24933,425,9242,72,33,56,0,4,12,72,1,1,1,1,2,2,0,2,0,1,0,0,2,24,2,0
24934,425,9242,1454,835,1044,76,110,219,1530,17,275,158,296,292,454,2297,3718,9,34017,1889,1,2,24,2,0
24935,51,2929,1782,648,1425,9,47,279,1791,8,171,97,189,179,286,1292,2140,4,9462,525,0,2,183,0,0
24936,425,9235,72,33,56,0,4,12,72,1,1,1,1,2,2,0,2,0,1,0,0,2,17,16,1
24937,425,9235,1454,835,1044,76,110,219,1530,17,275,158,296,292,454,2297,3718,9,34017,1889,1,2,17,16,1
24938,51,2930,1782,648,1425,9,47,279,1791,8,171,97,189,179,286,1292,2140,4,9462,525,0,2,3,3,1
24939,44,1923,1020,354,843,12,15,144,1032,8,134,77,144,142,221,970,1580,4,6792,377,0,2,18,0,0
24940,45,2010,1020,354,843,12,15,144,1032,8,134,77,144,142,221,970,1580,4,6792,377,0,2,20,1,0
24941,59,1130,1020,354,843,12,15,144,1032,8,134,77,144,142,221,970,1580,4,6792,377,0,2,1,1,1
24942,164,3702,77,34,69,0,0,8,77,3,24,16,29,27,45,114,213,1,387,21,0,2,5,6,1
24943,164,3702,712,438,573,51,9,84,763,14,102,71,128,116,199,733,1364,8,11988,666,0,2,5,6,1
24944,59,1132,1020,354,843,12,15,144,1032,8,134,77,144,142,221,970,1580,4,6792,377,0,2,8,8,1
24945,45,2010,1020,354,843,12,15,144,1032,8,134,77,144,142,221,970,1580,4,6792,377,0,2,1,1,1
24946,164,3702,77,34,69,0,0,8,77,3,24,16,29,27,45,114,213,1,387,21,0,2,11,0,0
24947,164,3702,712,438,573,51,9,84,763,14,102,71,128,116,199,733,1364,8,11988,666,0,2,11,0,0
24948,59,1132,1020,354,843,12,15,144,1032,8,134,77,144,142,221,970,1580,4,6792,377,0,2,91,31,0
24949,45,2010,1020,354,843,12,15,144,1032,8,134,77,144,142,221,970,1580,4,6792,377,0,2,38,2,0
24950,59,1132,1020,354,843,12,15,144,1032,8,134,77,144,142,221,970,1580,4,6792,377,0,2,1,1,0
24974,428,9261,72,33,56,0,4,12,72,1,1,1,1,2,2,0,2,0,1,0,0,2,4,2,1
24975,428,9261,1454,835,1044,76,110,219,1530,17,275,158,296,292,454,2297,3718,9,34017,1889,1,2,4,2,1
24978,52,2959,1782,648,1425,9,47,279,1791,8,171,97,189,179,286,1292,2140,4,9462,525,0,2,10,0,1
24979,128,3970,1660,832,1314,41,38,274,1701,20,312,209,395,332,604,2671,5058,12,64042,3557,1,2,4,0,1
24980,128,3970,1057,646,719,113,100,145,1170,18,215,134,248,233,382,1740,3004,10,31186,1732,1,2,4,0,1
24981,106,2462,1660,832,1314,41,38,274,1701,20,312,209,395,332,604,2671,5058,12,64042,3557,1,2,18,1,1
24982,430,9299,72,33,56,0,4,12,72,1,1,1,1,2,2,0,2,0,1,0,0,2,5,1,1
24983,430,9299,1454,835,1044,76,110,219,1530,17,275,158,296,292,454,2297,3718,9,34017,1889,1,2,5,1,1
24984,55,3168,1782,648,1425,9,47,279,1791,8,171,97,189,179,286,1292,2140,4,9462,525,0,2,30,2,1
24985,106,2462,1660,832,1314,41,38,274,1701,20,312,209,395,332,604,2671,5058,12,64042,3557,1,2,13,13,0
24986,128,3970,1660,832,1314,41,38,274,1701,20,312,209,395,332,604,2671,5058,12,64042,3557,1,2,4,0,0
24987,128,3970,1057,646,719,113,100,145,1170,18,215,134,248,233,382,1740,3004,10,31186,1732,1,2,4,0,0
24988,106,2462,1660,832,1314,41,38,274,1701,20,312,209,395,332,604,2671,5058,12,64042,3557,1,2,29,12,0
24989,164,3720,77,34,69,0,0,8,77,3,24,16,29,27,45,114,213,1,387,21,0,2,2,0,1
24990,164,3720,712,438,573,51,9,84,763,14,102,71,128,116,199,733,1364,8,11988,666,0,2,2,0,1
24991,24,972,373,158,315,8,0,51,381,5,76,44,79,81,123,486,779,2,2026,112,0,2,14,0,1
24992,430,9291,72,33,56,0,4,12,72,1,1,1,1,2,2,0,2,0,1,0,0,2,6,2,1
24993,430,9291,1454,835,1044,76,110,219,1530,17,275,158,296,292,454,2297,3718,9,34017,1889,1,2,6,2,1
24994,30,1144,1098,241,925,5,10,155,1103,7,46,25,49,53,74,273,423,3,1580,87,0,2,22,0,1
24995,30,1144,1098,241,925,5,10,155,1103,7,46,25,49,53,74,273,423,3,1580,87,0,2,2,2,0
25021,430,9291,72,33,56,0,4,12,72,1,1,1,1,2,2,0,2,0,1,0,0,2,15,13,1
25022,430,9291,1454,835,1044,76,110,219,1530,17,275,158,296,292,454,2297,3718,9,34017,1889,1,2,15,13,1
25046,430,9303,72,33,56,0,4,12,72,1,1,1,1,2,2,0,2,0,1,0,0,2,9,1,1
25047,430,9303,1454,835,1044,76,110,219,1530,17,275,158,296,292,454,2297,3718,9,34017,1889,1,2,9,1,1
25050,53,2989,1782,648,1425,9,47,279,1791,8,171,97,189,179,286,1292,2140,4,9462,525,0,2,14,0,1
25051,157,3128,1943,715,1694,26,18,214,1969,12,185,120,237,197,357,1436,2721,7,20915,1161,0,2,6,2,0
25052,157,3128,1168,838,957,57,25,144,1225,19,348,224,416,367,640,3018,5452,11,61921,3440,1,2,6,2,0
25076,128,3970,1660,832,1314,41,38,274,1701,20,312,209,395,332,604,2671,5058,12,64042,3557,1,2,14,4,0
25077,128,3970,1057,646,719,113,100,145,1170,18,215,134,248,233,382,1740,3004,10,31186,1732,1,2,14,4,0
25078,72,1498,477,336,357,30,23,73,507,16,194,134,250,210,384,1538,2962,10,30538,1696,0,2,17,14,0
25083,164,3720,77,34,69,0,0,8,77,3,24,16,29,27,45,114,213,1,387,21,0,2,13,0,0
25084,164,3720,712,438,573,51,9,84,763,14,102,71,128,116,199,733,1364,8,11988,666,0,2,13,0,0
25086,430,9303,72,33,56,0,4,12,72,1,1,1,1,2,2,0,2,0,1,0,0,2,116,44,0
25087,430,9303,1454,835,1044,76,110,219,1530,17,275,158,296,292,454,2297,3718,9,34017,1889,1,2,116,44,0
25088,99,2230,1043,504,840,53,9,147,1096,9,180,112,198,189,310,1377,2344,4,11604,644,0,2,10,1,0
25089,99,2230,383,288,292,26,6,62,409,11,65,38,67,76,105,429,656,5,3719,206,0,2,10,1,0
25090,84,1473,1178,367,1042,6,15,115,1184,9,94,51,95,103,146,644,976,4,4439,246,0,2,5,1,0
25091,84,1473,177,108,140,8,0,27,185,6,30,16,32,36,48,162,248,3,794,44,0,2,5,1,0
25112,12,424,42,7,35,4,0,5,46,1,2,1,2,3,3,2,4,0,2,0,0,2,2,2,0
25113,12,424,11,6,10,0,0,1,11,2,4,2,4,6,6,10,15,1,15,0,0,2,2,2,0
25114,107,4544,139,89,101,2,0,35,141,7,54,34,62,61,96,330,569,4,2287,127,0,2,112,0,0
25115,107,4544,7,5,5,0,0,2,7,1,2,1,2,3,3,2,4,0,2,0,0,2,112,0,0
25116,13,386,465,148,393,5,8,60,470,4,31,20,31,35,51,161,261,2,523,29,0,2,32,0,0
25117,13,386,16,12,9,0,0,6,16,1,2,1,2,3,3,2,4,0,2,0,0,2,32,0,0
25118,53,2989,1782,648,1425,9,47,279,1791,8,171,97,189,179,286,1292,2140,4,9462,525,0,2,207,0,0
25119,38,1430,1450,624,1228,12,26,181,1462,14,306,186,354,320,540,2580,4493,8,36391,2021,1,2,19,0,0
25124,24,972,373,158,315,8,0,51,381,5,76,44,79,81,123,486,779,2,2026,112,0,2,14,0,0
25125,42,1867,1178,367,1042,6,15,115,1184,9,94,51,95,103,146,644,976,4,4439,246,0,2,41,1,0
25127,6,493,442,244,305,14,16,103,456,11,68,45,75,79,120,452,756,6,4588,254,0,2,1,0,0
25128,30,1144,1098,241,925,5,10,155,1103,7,46,25,49,53,74,273,423,3,1580,87,0,2,22,0,0
25129,29,1369,652,304,544,16,6,88,668,6,89,51,101,95,152,591,998,3,3399,188,0,2,0,1,0
25131,159,3155,1943,715,1694,26,18,214,1969,12,185,120,237,197,357,1436,2721,7,20915,1161,0,2,13,9,1
25132,159,3155,1168,838,957,57,25,144,1225,19,348,224,416,367,640,3018,5452,11,61921,3440,1,2,13,9,1
25133,58,2641,1943,715,1694,26,18,214,1969,12,185,120,237,197,357,1436,2721,7,20915,1161,0,2,16,5,1
25134,139,2741,1457,730,1242,11,6,188,1468,10,292,166,329,302,495,2424,4078,5,22973,1276,1,2,8,15,0
25135,139,2741,74,35,59,1,0,14,75,3,14,7,14,17,21,58,85,1,128,7,0,2,8,15,0
25136,139,2741,245,125,200,5,7,34,250,7,30,17,34,37,51,166,265,3,1053,58,0,2,8,15,0
25137,107,4544,139,89,101,2,0,35,141,7,54,34,62,61,96,330,569,4,2287,127,0,2,71,0,0
25138,107,4544,7,5,5,0,0,2,7,1,2,1,2,3,3,2,4,0,2,0,0,2,71,0,0
25139,29,1369,652,304,544,16,6,88,668,6,89,51,101,95,152,591,998,3,3399,188,0,2,11,0,0
25140,58,2641,1943,715,1694,26,18,214,1969,12,185,120,237,197,357,1436,2721,7,20915,1161,0,2,1,1,0
25141,159,3155,1943,715,1694,26,18,214,1969,12,185,120,237,197,357,1436,2721,7,20915,1161,0,2,13,9,0
25142,159,3155,1168,838,957,57,25,144,1225,19,348,224,416,367,640,3018,5452,11,61921,3440,1,2,13,9,0
25143,58,2641,1943,715,1694,26,18,214,1969,12,185,120,237,197,357,1436,2721,7,20915,1161,0,2,16,5,0
25147,432,9349,72,33,56,0,4,12,72,1,1,1,1,2,2,0,2,0,1,0,0,2,16,7,1
25148,432,9349,1454,835,1044,76,110,219,1530,17,275,158,296,292,454,2297,3718,9,34017,1889,1,2,16,7,1
25149,108,4591,139,89,101,2,0,35,141,7,54,34,62,61,96,330,569,4,2287,127,0,2,25,0,1
25150,108,4591,7,5,5,0,0,2,7,1,2,1,2,3,3,2,4,0,2,0,0,2,25,0,1
25151,128,3964,1660,832,1314,41,38,274,1701,20,312,209,395,332,604,2671,5058,12,64042,3557,1,2,2,8,1
25152,128,3964,1057,646,719,113,100,145,1170,18,215,134,248,233,382,1740,3004,10,31186,1732,1,2,2,8,1
25153,43,1919,1178,367,1042,6,15,115,1184,9,94,51,95,103,146,644,976,4,4439,246,0,2,12,0,1
25154,43,1919,1178,367,1042,6,15,115,1184,9,94,51,95,103,146,644,976,4,4439,246,0,2,12,0,0
25155,432,9350,72,33,56,0,4,12,72,1,1,1,1,2,2,0,2,0,1,0,0,2,2,1,1
25156,432,9350,1454,835,1044,76,110,219,1530,17,275,158,296,292,454,2297,3718,9,34017,1889,1,2,2,1,1
25157,108,4591,139,89,101,2,0,35,141,7,54,34,62,61,96,330,569,4,2287,127,0,2,3,3,1
25158,108,4591,7,5,5,0,0,2,7,1,2,1,2,3,3,2,4,0,2,0,0,2,3,3,1
25159,432,9350,72,33,56,0,4,12,72,1,1,1,1,2,2,0,2,0,1,0,0,2,2,1,0
25160,432,9350,1454,835,1044,76,110,219,1530,17,275,158,296,292,454,2297,3718,9,34017,1889,1,2,2,1,0
25161,108,4591,139,89,101,2,0,35,141,7,54,34,62,61,96,330,569,4,2287,127,0,2,3,3,0
25162,108,4591,7,5,5,0,0,2,7,1,2,1,2,3,3,2,4,0,2,0,0,2,3,3,0
25163,43,1913,1178,367,1042,6,15,115,1184,9,94,51,95,103,146,644,976,4,4439,246,0,2,1,2,1
25164,43,1913,1178,367,1042,6,15,115,1184,9,94,51,95,103,146,644,976,4,4439,246,0,2,1,2,0
25165,434,9388,72,33,56,0,4,12,72,1,1,1,1,2,2,0,2,0,1,0,0,2,5,1,0
25166,434,9388,1454,835,1044,76,110,219,1530,17,275,158,296,292,454,2297,3718,9,34017,1889,1,2,5,1,0
25167,56,3198,1782,648,1425,9,47,279,1791,8,171,97,189,179,286,1292,2140,4,9462,525,0,2,30,2,0
25194,434,9390,72,33,56,0,4,12,72,1,1,1,1,2,2,0,2,0,1,0,0,2,2,1,1
25195,434,9390,1454,835,1044,76,110,219,1530,17,275,158,296,292,454,2297,3718,9,34017,1889,1,2,2,1,1
25198,56,3203,1782,648,1425,9,47,279,1791,8,171,97,189,179,286,1292,2140,4,9462,525,0,2,5,5,1
25199,160,3161,1943,715,1694,26,18,214,1969,12,185,120,237,197,357,1436,2721,7,20915,1161,0,2,1,1,0
25200,160,3161,1168,838,957,57,25,144,1225,19,348,224,416,367,640,3018,5452,11,61921,3440,1,2,1,1,0
25224,435,9394,72,33,56,0,4,12,72,1,1,1,1,2,2,0,2,0,1,0,0,2,15,9,1
25225,435,9394,1454,835,1044,76,110,219,1530,17,275,158,296,292,454,2297,3718,9,34017,1889,1,2,15,9,1
25228,110,4667,139,89,101,2,0,35,141,7,54,34,62,61,96,330,569,4,2287,127,0,2,33,0,1
25229,110,4667,7,5,5,0,0,2,7,1,2,1,2,3,3,2,4,0,2,0,0,2,33,0,1
25255,68,1226,1513,682,1277,25,13,200,1538,11,199,116,219,210,335,1557,2584,6,15641,868,0,2,1,1,1
25256,68,1226,819,519,539,24,98,155,843,15,96,57,106,111,163,690,1107,8,9171,509,0,2,1,1,1
25257,172,3366,1457,730,1242,11,6,188,1468,10,292,166,329,302,495,2424,4078,5,22973,1276,1,2,144,11,1
25258,172,3366,74,35,59,1,0,14,75,3,14,7,14,17,21,58,85,1,128,7,0,2,144,11,1
25259,172,3366,245,125,200,5,7,34,250,7,30,17,34,37,51,166,265,3,1053,58,0,2,144,11,1
25260,42,1131,74,35,59,1,0,14,75,3,14,7,14,17,21,58,85,1,128,7,0,2,1,0,1
25261,42,1131,245,125,200,5,7,34,250,7,30,17,34,37,51,166,265,3,1053,58,0,2,1,0,1
25263,164,3720,77,34,69,0,0,8,77,3,24,16,29,27,45,114,213,1,387,21,0,2,1,1,1
25264,164,3720,712,438,573,51,9,84,763,14,102,71,128,116,199,733,1364,8,11988,666,0,2,1,1,1
25265,14,453,184,100,137,2,15,30,186,6,38,20,39,44,59,214,322,3,991,55,0,2,1,1,1
25266,14,453,103,65,74,8,5,16,111,7,17,9,17,24,26,89,119,3,417,23,0,2,1,1,1
25267,99,2230,1043,504,840,53,9,147,1096,9,180,112,198,189,310,1377,2344,4,11604,644,0,2,1,1,1
25268,99,2230,383,288,292,26,6,62,409,11,65,38,67,76,105,429,656,5,3719,206,0,2,1,1,1
25269,160,3157,1943,715,1694,26,18,214,1969,12,185,120,237,197,357,1436,2721,7,20915,1161,0,2,1,1,1
25270,160,3157,1168,838,957,57,25,144,1225,19,348,224,416,367,640,3018,5452,11,61921,3440,1,2,1,1,1
25271,46,2032,1020,354,843,12,15,144,1032,8,134,77,144,142,221,970,1580,4,6792,377,0,2,13,3,1
25272,22,1115,334,251,279,10,4,40,344,5,127,74,143,132,217,899,1528,2,4303,239,0,2,59,14,1
25273,178,3490,1457,730,1242,11,6,188,1468,10,292,166,329,302,495,2424,4078,5,22973,1276,1,2,38,1,1
25274,178,3490,74,35,59,1,0,14,75,3,14,7,14,17,21,58,85,1,128,7,0,2,38,1,1
25275,178,3490,245,125,200,5,7,34,250,7,30,17,34,37,51,166,265,3,1053,58,0,2,38,1,1
25276,68,1226,1513,682,1277,25,13,200,1538,11,199,116,219,210,335,1557,2584,6,15641,868,0,2,1,1,0
25277,68,1226,819,519,539,24,98,155,843,15,96,57,106,111,163,690,1107,8,9171,509,0,2,1,1,0
25278,178,3490,1457,730,1242,11,6,188,1468,10,292,166,329,302,495,2424,4078,5,22973,1276,1,2,181,11,0
25279,178,3490,74,35,59,1,0,14,75,3,14,7,14,17,21,58,85,1,128,7,0,2,181,11,0
25280,178,3490,245,125,200,5,7,34,250,7,30,17,34,37,51,166,265,3,1053,58,0,2,181,11,0
25281,42,1131,74,35,59,1,0,14,75,3,14,7,14,17,21,58,85,1,128,7,0,2,1,0,0
25282,42,1131,245,125,200,5,7,34,250,7,30,17,34,37,51,166,265,3,1053,58,0,2,1,0,0
25283,43,415,647,139,84,35,284,233,682,0,0,0,0,0,0,0,0,0,0,0,0,2,1,1,0
25284,164,3720,77,34,69,0,0,8,77,3,24,16,29,27,45,114,213,1,387,21,0,2,1,1,0
25285,164,3720,712,438,573,51,9,84,763,14,102,71,128,116,199,733,1364,8,11988,666,0,2,1,1,0
25286,14,453,184,100,137,2,15,30,186,6,38,20,39,44,59,214,322,3,991,55,0,2,1,1,0
25287,14,453,103,65,74,8,5,16,111,7,17,9,17,24,26,89,119,3,417,23,0,2,1,1,0
25290,160,3157,1943,715,1694,26,18,214,1969,12,185,120,237,197,357,1436,2721,7,20915,1161,0,2,1,1,0
25291,160,3157,1168,838,957,57,25,144,1225,19,348,224,416,367,640,3018,5452,11,61921,3440,1,2,1,1,0
25292,46,2032,1020,354,843,12,15,144,1032,8,134,77,144,142,221,970,1580,4,6792,377,0,2,13,3,0
25293,22,1115,334,251,279,10,4,40,344,5,127,74,143,132,217,899,1528,2,4303,239,0,2,59,14,0
25294,13,444,42,7,35,4,0,5,46,1,2,1,2,3,3,2,4,0,2,0,0,2,5,1,1
25295,13,444,11,6,10,0,0,1,11,2,4,2,4,6,6,10,15,1,15,0,0,2,5,1,1
25296,35,645,127,75,83,2,11,30,129,4,14,7,14,18,21,61,87,2,175,9,0,2,3,0,1
25297,35,645,652,304,544,16,6,88,668,6,89,51,101,95,152,591,998,3,3399,188,0,2,3,0,1
25298,35,645,2,2,2,0,0,0,2,0,0,0,0,0,0,0,0,0,0,0,0,2,3,0,1
25299,35,645,8,5,5,0,0,3,8,0,0,0,0,0,0,0,0,0,0,0,0,2,3,0,1
25302,35,645,14,8,8,0,0,6,14,0,0,0,0,0,0,0,0,0,0,0,0,2,3,0,1
25303,35,645,6,4,4,0,0,2,6,0,0,0,0,0,0,0,0,0,0,0,0,2,3,0,1
25304,35,645,6,4,4,0,0,2,6,1,2,1,2,3,3,2,4,0,2,0,0,2,3,0,1
25306,35,645,7,5,5,0,0,2,7,0,0,0,0,0,0,0,0,0,0,0,0,2,3,0,1
25308,35,645,10,6,6,0,0,4,10,0,0,0,0,0,0,0,0,0,0,0,0,2,3,0,1
25309,35,645,1,1,1,0,0,0,1,0,0,0,0,0,0,0,0,0,0,0,0,2,3,0,1
25311,35,645,14,10,10,0,0,4,14,1,1,1,1,2,2,0,2,0,1,0,0,2,3,0,1
25312,35,645,46,26,30,3,0,12,49,3,6,3,6,9,9,20,28,1,42,2,0,2,3,0,1
25313,22,1119,334,251,279,10,4,40,344,5,127,74,143,132,217,899,1528,2,4303,239,0,2,3,2,1
25314,35,645,127,75,83,2,11,30,129,4,14,7,14,18,21,61,87,2,175,9,0,2,1,1,0
25315,35,645,652,304,544,16,6,88,668,6,89,51,101,95,152,591,998,3,3399,188,0,2,1,1,0
25316,35,645,2,2,2,0,0,0,2,0,0,0,0,0,0,0,0,0,0,0,0,2,1,1,0
25317,35,645,8,5,5,0,0,3,8,0,0,0,0,0,0,0,0,0,0,0,0,2,1,1,0
25320,35,645,14,8,8,0,0,6,14,0,0,0,0,0,0,0,0,0,0,0,0,2,1,1,0
25321,35,645,6,4,4,0,0,2,6,0,0,0,0,0,0,0,0,0,0,0,0,2,1,1,0
25322,35,645,6,4,4,0,0,2,6,1,2,1,2,3,3,2,4,0,2,0,0,2,1,1,0
25324,35,645,7,5,5,0,0,2,7,0,0,0,0,0,0,0,0,0,0,0,0,2,1,1,0
25326,35,645,10,6,6,0,0,4,10,0,0,0,0,0,0,0,0,0,0,0,0,2,1,1,0
25327,35,645,1,1,1,0,0,0,1,0,0,0,0,0,0,0,0,0,0,0,0,2,1,1,0
25329,35,645,14,10,10,0,0,4,14,1,1,1,1,2,2,0,2,0,1,0,0,2,1,1,0
25330,35,645,46,26,30,3,0,12,49,3,6,3,6,9,9,20,28,1,42,2,0,2,1,1,0
25331,1,87,19,8,11,5,0,4,24,2,5,3,6,7,9,13,25,1,30,1,0,0,68,0,1
25332,1,87,102,59,69,5,3,24,107,6,22,15,28,28,43,113,206,3,789,43,0,0,68,0,1
25333,1,87,106,40,36,3,49,17,109,8,17,13,23,25,36,93,167,5,904,50,0,0,68,0,1
25334,181,3563,1457,730,1242,11,6,188,1468,10,292,166,329,302,495,2424,4078,5,22973,1276,1,2,17,8,1
25335,181,3563,74,35,59,1,0,14,75,3,14,7,14,17,21,58,85,1,128,7,0,2,17,8,1
25336,181,3563,245,125,200,5,7,34,250,7,30,17,34,37,51,166,265,3,1053,58,0,2,17,8,1
25337,25,1433,334,251,279,10,4,40,344,5,127,74,143,132,217,899,1528,2,4303,239,0,2,40,0,1
25338,1,85,19,8,11,5,0,4,24,2,5,3,6,7,9,13,25,1,30,1,0,2,0,1,1
25339,1,85,102,59,69,5,3,24,107,6,22,15,28,28,43,113,206,3,789,43,0,2,0,1,1
25340,1,85,106,40,36,3,49,17,109,8,17,13,23,25,36,93,167,5,904,50,0,2,0,1,1
25341,26,1521,334,251,279,10,4,40,344,5,127,74,143,132,217,899,1528,2,4303,239,0,2,15,7,1
25342,1,85,19,8,11,5,0,4,24,2,5,3,6,7,9,13,25,1,30,1,0,0,67,0,0
25343,1,85,102,59,69,5,3,24,107,6,22,15,28,28,43,113,206,3,789,43,0,0,67,0,0
25344,1,85,106,40,36,3,49,17,109,8,17,13,23,25,36,93,167,5,904,50,0,0,67,0,0
25345,181,3563,1457,730,1242,11,6,188,1468,10,292,166,329,302,495,2424,4078,5,22973,1276,1,2,17,8,0
25346,181,3563,74,35,59,1,0,14,75,3,14,7,14,17,21,58,85,1,128,7,0,2,17,8,0
25347,181,3563,245,125,200,5,7,34,250,7,30,17,34,37,51,166,265,3,1053,58,0,2,17,8,0
25348,26,1521,334,251,279,10,4,40,344,5,127,74,143,132,217,899,1528,2,4303,239,0,2,48,0,0
25349,26,1539,334,251,279,10,4,40,344,5,127,74,143,132,217,899,1528,2,4303,239,0,2,7,1,0
25350,26,1517,334,251,279,10,4,40,344,5,127,74,143,132,217,899,1528,2,4303,239,0,2,8,10,1
25351,13,426,42,7,35,4,0,5,46,1,2,1,2,3,3,2,4,0,2,0,0,2,1,6,0
25352,13,426,11,6,10,0,0,1,11,2,4,2,4,6,6,10,15,1,15,0,0,2,1,6,0
25353,26,1517,334,251,279,10,4,40,344,5,127,74,143,132,217,899,1528,2,4303,239,0,2,13,9,0
25355,435,9394,72,33,56,0,4,12,72,1,1,1,1,2,2,0,2,0,1,0,0,2,2,0,0
25356,435,9394,1454,835,1044,76,110,219,1530,17,275,158,296,292,454,2297,3718,9,34017,1889,1,2,2,0,0
25358,181,3565,1457,730,1242,11,6,188,1468,10,292,166,329,302,495,2424,4078,5,22973,1276,1,2,8,8,0
25359,181,3565,74,35,59,1,0,14,75,3,14,7,14,17,21,58,85,1,128,7,0,2,8,8,0
25360,181,3565,245,125,200,5,7,34,250,7,30,17,34,37,51,166,265,3,1053,58,0,2,8,8,0
25361,26,1508,334,251,279,10,4,40,344,5,127,74,143,132,217,899,1528,2,4303,239,0,2,1,1,0
25366,73,1525,477,336,357,30,23,73,507,16,194,134,250,210,384,1538,2962,10,30538,1696,0,2,7,2,1
25367,48,1675,1450,624,1228,12,26,181,1462,14,306,186,354,320,540,2580,4493,8,36391,2021,1,2,41,1,1
25368,73,1533,477,336,357,30,23,73,507,16,194,134,250,210,384,1538,2962,10,30538,1696,0,2,5,1,1
25369,35,643,127,75,83,2,11,30,129,4,14,7,14,18,21,61,87,2,175,9,0,2,1,1,1
25370,35,643,652,304,544,16,6,88,668,6,89,51,101,95,152,591,998,3,3399,188,0,2,1,1,1
25371,35,643,2,2,2,0,0,0,2,0,0,0,0,0,0,0,0,0,0,0,0,2,1,1,1
25372,35,643,8,5,5,0,0,3,8,0,0,0,0,0,0,0,0,0,0,0,0,2,1,1,1
25375,35,643,14,8,8,0,0,6,14,0,0,0,0,0,0,0,0,0,0,0,0,2,1,1,1
25376,35,643,6,4,4,0,0,2,6,0,0,0,0,0,0,0,0,0,0,0,0,2,1,1,1
25377,35,643,6,4,4,0,0,2,6,1,2,1,2,3,3,2,4,0,2,0,0,2,1,1,1
25379,35,643,7,5,5,0,0,2,7,0,0,0,0,0,0,0,0,0,0,0,0,2,1,1,1
25381,35,643,10,6,6,0,0,4,10,0,0,0,0,0,0,0,0,0,0,0,0,2,1,1,1
25382,35,643,1,1,1,0,0,0,1,0,0,0,0,0,0,0,0,0,0,0,0,2,1,1,1
25384,35,643,14,10,10,0,0,4,14,1,1,1,1,2,2,0,2,0,1,0,0,2,1,1,1
25385,35,643,46,26,30,3,0,12,49,3,6,3,6,9,9,20,28,1,42,2,0,2,1,1,1
25386,49,1694,1450,624,1228,12,26,181,1462,14,306,186,354,320,540,2580,4493,8,36391,2021,1,2,8,6,1
25387,126,3959,1660,832,1314,41,38,274,1701,20,312,209,395,332,604,2671,5058,12,64042,3557,1,2,8,12,1
25388,126,3959,1057,646,719,113,100,145,1170,18,215,134,248,233,382,1740,3004,10,31186,1732,1,2,8,12,1
25389,109,2592,1660,832,1314,41,38,274,1701,20,312,209,395,332,604,2671,5058,12,64042,3557,1,2,20,0,1
25390,200,3870,1457,730,1242,11,6,188,1468,10,292,166,329,302,495,2424,4078,5,22973,1276,1,2,69,2,1
25391,200,3870,74,35,59,1,0,14,75,3,14,7,14,17,21,58,85,1,128,7,0,2,69,2,1
25392,200,3870,245,125,200,5,7,34,250,7,30,17,34,37,51,166,265,3,1053,58,0,2,69,2,1
25393,35,2151,334,251,279,10,4,40,344,5,127,74,143,132,217,899,1528,2,4303,239,0,2,101,29,1
25394,35,2147,334,251,279,10,4,40,344,5,127,74,143,132,217,899,1528,2,4303,239,0,2,2,2,0
25395,200,3870,1457,730,1242,11,6,188,1468,10,292,166,329,302,495,2424,4078,5,22973,1276,1,2,69,2,0
25396,200,3870,74,35,59,1,0,14,75,3,14,7,14,17,21,58,85,1,128,7,0,2,69,2,0
25397,200,3870,245,125,200,5,7,34,250,7,30,17,34,37,51,166,265,3,1053,58,0,2,69,2,0
25398,35,2147,334,251,279,10,4,40,344,5,127,74,143,132,217,899,1528,2,4303,239,0,2,99,27,0
25401,30,619,2,2,2,0,0,0,2,0,0,0,0,0,0,0,0,0,0,0,0,2,2,2,1
25415,30,619,99,48,90,1,3,5,100,0,0,0,0,0,0,0,0,0,0,0,0,2,2,2,1
25416,30,619,8,5,5,2,0,1,10,0,0,0,0,0,0,0,0,0,0,0,0,2,2,2,1
25417,30,619,1217,716,841,84,126,174,1301,14,185,118,215,199,333,1446,2542,8,20687,1149,0,2,2,2,1
25418,30,619,160,89,115,0,13,31,160,7,15,11,17,22,28,78,124,3,495,27,0,2,2,2,1
25419,30,619,10,10,9,9,0,0,19,0,0,0,0,0,0,0,0,0,0,0,0,2,2,2,1
25420,30,619,173,84,99,8,29,36,181,5,12,7,13,17,20,54,81,2,221,12,0,2,2,2,1
25421,30,619,3,1,1,3,0,0,6,0,0,0,0,0,0,0,0,0,0,0,0,2,2,2,1
25422,42,1129,74,35,59,1,0,14,75,3,14,7,14,17,21,58,85,1,128,7,0,2,2,2,1
25423,42,1129,245,125,200,5,7,34,250,7,30,17,34,37,51,166,265,3,1053,58,0,2,2,2,1
25424,42,1321,1523,757,1297,19,12,193,1542,12,193,117,230,205,347,1508,2664,7,19053,1058,0,2,3,3,1
25425,42,1321,701,378,504,33,58,109,734,13,110,68,126,123,194,794,1346,7,10027,557,0,2,3,3,1
25426,164,3718,77,34,69,0,0,8,77,3,24,16,29,27,45,114,213,1,387,21,0,2,3,2,1
25427,164,3718,712,438,573,51,9,84,763,14,102,71,128,116,199,733,1364,8,11988,666,0,2,3,2,1
25428,29,601,215,129,180,6,0,29,221,8,65,43,72,73,115,415,711,4,3153,175,0,2,1,1,1
25429,29,601,97,69,77,3,3,16,100,6,22,13,23,28,36,113,173,3,542,30,0,2,1,1,1
25430,160,3155,1943,715,1694,26,18,214,1969,12,185,120,237,197,357,1436,2721,7,20915,1161,0,2,2,2,1
25431,160,3155,1168,838,957,57,25,144,1225,19,348,224,416,367,640,3018,5452,11,61921,3440,1,2,2,2,1
25432,35,2147,334,251,279,10,4,40,344,5,127,74,143,132,217,899,1528,2,4303,239,0,2,0,1,1
25435,30,619,2,2,2,0,0,0,2,0,0,0,0,0,0,0,0,0,0,0,0,2,2,2,0
25449,30,619,99,48,90,1,3,5,100,0,0,0,0,0,0,0,0,0,0,0,0,2,2,2,0
25450,30,619,8,5,5,2,0,1,10,0,0,0,0,0,0,0,0,0,0,0,0,2,2,2,0
25451,30,619,1217,716,841,84,126,174,1301,14,185,118,215,199,333,1446,2542,8,20687,1149,0,2,2,2,0
25452,30,619,160,89,115,0,13,31,160,7,15,11,17,22,28,78,124,3,495,27,0,2,2,2,0
25453,30,619,10,10,9,9,0,0,19,0,0,0,0,0,0,0,0,0,0,0,0,2,2,2,0
25454,30,619,173,84,99,8,29,36,181,5,12,7,13,17,20,54,81,2,221,12,0,2,2,2,0
25455,30,619,3,1,1,3,0,0,6,0,0,0,0,0,0,0,0,0,0,0,0,2,2,2,0
25456,42,1129,74,35,59,1,0,14,75,3,14,7,14,17,21,58,85,1,128,7,0,2,2,2,0
25457,42,1129,245,125,200,5,7,34,250,7,30,17,34,37,51,166,265,3,1053,58,0,2,2,2,0
25458,42,1321,1523,757,1297,19,12,193,1542,12,193,117,230,205,347,1508,2664,7,19053,1058,0,2,3,3,0
25459,42,1321,701,378,504,33,58,109,734,13,110,68,126,123,194,794,1346,7,10027,557,0,2,3,3,0
25460,164,3718,77,34,69,0,0,8,77,3,24,16,29,27,45,114,213,1,387,21,0,2,3,2,0
25461,164,3718,712,438,573,51,9,84,763,14,102,71,128,116,199,733,1364,8,11988,666,0,2,3,2,0
25462,29,601,215,129,180,6,0,29,221,8,65,43,72,73,115,415,711,4,3153,175,0,2,1,1,0
25463,29,601,97,69,77,3,3,16,100,6,22,13,23,28,36,113,173,3,542,30,0,2,1,1,0
25464,160,3155,1943,715,1694,26,18,214,1969,12,185,120,237,197,357,1436,2721,7,20915,1161,0,2,2,2,0
25465,160,3155,1168,838,957,57,25,144,1225,19,348,224,416,367,640,3018,5452,11,61921,3440,1,2,2,2,0
25466,35,2147,334,251,279,10,4,40,344,5,127,74,143,132,217,899,1528,2,4303,239,0,2,0,1,0
25467,3,23,14,7,7,2,0,5,16,0,0,0,0,0,0,0,0,0,0,0,0,2,1,1,1
25469,61,2541,1289,550,1043,56,32,155,1345,10,167,93,185,177,278,1266,2075,5,11498,638,0,2,1,1,1
25470,53,2846,1338,495,1086,10,64,173,1348,11,122,82,157,133,239,883,1686,7,11934,663,0,2,5,5,1
25471,110,4667,139,89,101,2,0,35,141,7,54,34,62,61,96,330,569,4,2287,127,0,2,1,1,1
25472,110,4667,7,5,5,0,0,2,7,1,2,1,2,3,3,2,4,0,2,0,0,2,1,1,1
25473,56,3203,1782,648,1425,9,47,279,1791,8,171,97,189,179,286,1292,2140,4,9462,525,0,2,1,1,1
25474,49,1694,1450,624,1228,12,26,181,1462,14,306,186,354,320,540,2580,4493,8,36391,2021,1,2,1,1,1
25475,42,2708,1296,573,1062,40,33,157,1336,8,201,118,231,209,349,1561,2689,4,12365,686,0,2,3,3,1
25476,24,972,373,158,315,8,0,51,381,5,76,44,79,81,123,486,779,2,2026,112,0,2,2,2,1
25477,58,2641,1943,715,1694,26,18,214,1969,12,185,120,237,197,357,1436,2721,7,20915,1161,0,2,9,9,1
25478,438,9405,72,33,56,0,4,12,72,1,1,1,1,2,2,0,2,0,1,0,0,2,6,6,1
25479,438,9405,1454,835,1044,76,110,219,1530,17,275,158,296,292,454,2297,3718,9,34017,1889,1,2,6,6,1
25480,112,4755,139,89,101,2,0,35,141,7,54,34,62,61,96,330,569,4,2287,127,0,2,47,1,1
25481,112,4755,7,5,5,0,0,2,7,1,2,1,2,3,3,2,4,0,2,0,0,2,47,1,1
25482,129,4014,1660,832,1314,41,38,274,1701,20,312,209,395,332,604,2671,5058,12,64042,3557,1,2,13,0,1
25483,129,4014,1057,646,719,113,100,145,1170,18,215,134,248,233,382,1740,3004,10,31186,1732,1,2,13,0,1
25484,111,2674,1660,832,1314,41,38,274,1701,20,312,209,395,332,604,2671,5058,12,64042,3557,1,2,30,0,1
25485,438,9405,72,33,56,0,4,12,72,1,1,1,1,2,2,0,2,0,1,0,0,2,6,6,0
25486,438,9405,1454,835,1044,76,110,219,1530,17,275,158,296,292,454,2297,3718,9,34017,1889,1,2,6,6,0
25487,112,4755,139,89,101,2,0,35,141,7,54,34,62,61,96,330,569,4,2287,127,0,2,47,1,0
25488,112,4755,7,5,5,0,0,2,7,1,2,1,2,3,3,2,4,0,2,0,0,2,47,1,0
25489,191,4456,722,423,573,19,0,135,741,12,172,101,199,184,300,1320,2257,6,15668,870,0,2,6,0,1
25490,191,4456,1508,847,911,44,250,301,1552,14,148,88,169,162,257,1120,1886,7,15077,837,0,2,6,0,1
25491,56,1100,1098,241,925,5,10,155,1103,7,46,25,49,53,74,273,423,3,1580,87,0,2,27,22,1
25492,56,1100,282,202,222,14,2,44,296,8,42,24,43,50,67,250,378,4,1548,86,0,2,27,22,1
25493,112,4779,139,89,101,2,0,35,141,7,54,34,62,61,96,330,569,4,2287,127,0,2,10,4,1
25494,112,4779,7,5,5,0,0,2,7,1,2,1,2,3,3,2,4,0,2,0,0,2,10,4,1
25495,32,1208,1098,241,925,5,10,155,1103,7,46,25,49,53,74,273,423,3,1580,87,0,2,51,1,1
25496,57,1106,1098,241,925,5,10,155,1103,7,46,25,49,53,74,273,423,3,1580,87,0,2,2,1,1
25497,57,1106,282,202,222,14,2,44,296,8,42,24,43,50,67,250,378,4,1548,86,0,2,2,1,1
25521,165,3739,77,34,69,0,0,8,77,3,24,16,29,27,45,114,213,1,387,21,0,2,9,1,1
25522,165,3739,712,438,573,51,9,84,763,14,102,71,128,116,199,733,1364,8,11988,666,0,2,9,1,1
25523,434,9399,72,33,56,0,4,12,72,1,1,1,1,2,2,0,2,0,1,0,0,2,22,29,1
25524,434,9399,1454,835,1044,76,110,219,1530,17,275,158,296,292,454,2297,3718,9,34017,1889,1,2,22,29,1
25525,56,1091,1098,241,925,5,10,155,1103,7,46,25,49,53,74,273,423,3,1580,87,0,2,12,15,1
25526,56,1091,282,202,222,14,2,44,296,8,42,24,43,50,67,250,378,4,1548,86,0,2,12,15,1
25527,13,426,42,7,35,4,0,5,46,1,2,1,2,3,3,2,4,0,2,0,0,2,1,1,1
25528,13,426,11,6,10,0,0,1,11,2,4,2,4,6,6,10,15,1,15,0,0,2,1,1,1
25529,112,4767,139,89,101,2,0,35,141,7,54,34,62,61,96,330,569,4,2287,127,0,2,0,2,1
25530,112,4767,7,5,5,0,0,2,7,1,2,1,2,3,3,2,4,0,2,0,0,2,0,2,1
25531,13,413,295,56,236,0,4,54,295,2,9,5,10,11,15,30,51,1,57,3,0,2,74,34,1
25532,33,1262,1098,241,925,5,10,155,1103,7,46,25,49,53,74,273,423,3,1580,87,0,2,19,1,1
25533,159,3154,1943,715,1694,26,18,214,1969,12,185,120,237,197,357,1436,2721,7,20915,1161,0,2,8,10,0
25534,159,3154,1168,838,957,57,25,144,1225,19,348,224,416,367,640,3018,5452,11,61921,3440,1,2,8,10,0
25535,8,207,19,8,11,5,0,4,24,2,5,3,6,7,9,13,25,1,30,1,0,2,36,2,1
25536,8,207,102,59,69,5,3,24,107,6,22,15,28,28,43,113,206,3,789,43,0,2,36,2,1
25537,8,207,106,40,36,3,49,17,109,8,17,13,23,25,36,93,167,5,904,50,0,2,36,2,1
25539,23,594,102,59,69,5,3,24,107,6,22,15,28,28,43,113,206,3,789,43,0,0,92,0,1
25542,8,207,19,8,11,5,0,4,24,2,5,3,6,7,9,13,25,1,30,1,0,2,36,2,0
25543,8,207,102,59,69,5,3,24,107,6,22,15,28,28,43,113,206,3,789,43,0,2,36,2,0
25544,8,207,106,40,36,3,49,17,109,8,17,13,23,25,36,93,167,5,904,50,0,2,36,2,0
25546,23,594,102,59,69,5,3,24,107,6,22,15,28,28,43,113,206,3,789,43,0,0,92,0,0
25547,43,912,447,308,343,6,5,95,453,7,96,59,111,103,170,651,1136,4,4600,255,0,2,61,1,0
25548,43,912,322,174,179,16,74,51,338,10,41,26,46,51,72,252,408,5,2291,127,0,2,61,1,0
25549,33,1460,447,308,343,6,5,95,453,7,96,59,111,103,170,651,1136,4,4600,255,0,2,32,0,0
25550,38,787,447,308,343,6,5,95,453,7,96,59,111,103,170,651,1136,4,4600,255,0,2,39,56,1
25551,38,787,322,174,179,16,74,51,338,10,41,26,46,51,72,252,408,5,2291,127,0,2,39,56,1
25552,31,1414,447,308,343,6,5,95,453,7,96,59,111,103,170,651,1136,4,4600,255,0,2,12,23,1
25578,165,3753,77,34,69,0,0,8,77,3,24,16,29,27,45,114,213,1,387,21,0,2,6,0,1
25579,165,3753,712,438,573,51,9,84,763,14,102,71,128,116,199,733,1364,8,11988,666,0,2,6,0,1
25580,22,372,424,94,331,4,0,89,428,1,5,5,5,6,10,11,25,0,12,0,0,2,3,0,1
25581,22,372,38,23,23,6,0,8,44,3,11,7,11,14,18,42,68,1,102,5,0,2,3,0,1
25582,191,4461,722,423,573,19,0,135,741,12,172,101,199,184,300,1320,2257,6,15668,870,0,2,3,2,1
25583,191,4461,1508,847,911,44,250,301,1552,14,148,88,169,162,257,1120,1886,7,15077,837,0,2,3,2,1
25584,99,2226,1043,504,840,53,9,147,1096,9,180,112,198,189,310,1377,2344,4,11604,644,0,2,1,1,1
25585,99,2226,383,288,292,26,6,62,409,11,65,38,67,76,105,429,656,5,3719,206,0,2,1,1,1
25586,16,504,424,94,331,4,0,89,428,1,5,5,5,6,10,11,25,0,12,0,0,2,11,2,1
25587,57,3243,1782,648,1425,9,47,279,1791,8,171,97,189,179,286,1292,2140,4,9462,525,0,2,17,0,1
25588,46,1863,1043,504,840,53,9,147,1096,9,180,112,198,189,310,1377,2344,4,11604,644,0,2,11,0,1
25589,46,1863,1043,504,840,53,9,147,1096,9,180,112,198,189,310,1377,2344,4,11604,644,0,2,4,1,0
25590,36,2163,334,251,279,10,4,40,344,5,127,74,143,132,217,899,1528,2,4303,239,0,2,2,0,1
25591,165,3753,77,34,69,0,0,8,77,3,24,16,29,27,45,114,213,1,387,21,0,2,1,1,1
25592,165,3753,712,438,573,51,9,84,763,14,102,71,128,116,199,733,1364,8,11988,666,0,2,1,1,1
25593,22,950,1455,414,1257,16,76,112,1471,5,41,23,46,46,69,231,381,2,1069,59,0,2,11,0,1
25617,44,428,647,139,84,35,284,233,682,0,0,0,0,0,0,0,0,0,0,0,0,2,11,1,1
25618,165,3705,77,34,69,0,0,8,77,3,24,16,29,27,45,114,213,1,387,21,0,2,5,8,1
25619,165,3705,712,438,573,51,9,84,763,14,102,71,128,116,199,733,1364,8,11988,666,0,2,5,8,1
25620,24,583,1293,570,1093,25,15,163,1318,10,195,123,241,205,364,1516,2795,6,17273,959,0,2,10,15,1
25621,107,2375,1043,504,840,53,9,147,1096,9,180,112,198,189,310,1377,2344,4,11604,644,0,2,22,1,1
25622,107,2375,383,288,292,26,6,62,409,11,65,38,67,76,105,429,656,5,3719,206,0,2,22,1,1
25625,13,384,465,148,393,5,8,60,470,4,31,20,31,35,51,161,261,2,523,29,0,2,3,2,1
25626,13,384,16,12,9,0,0,6,16,1,2,1,2,3,3,2,4,0,2,0,0,2,3,2,1
25627,25,941,1293,570,1093,25,15,163,1318,10,195,123,241,205,364,1516,2795,6,17273,959,0,2,29,0,1
25628,46,1865,1043,504,840,53,9,147,1096,9,180,112,198,189,310,1377,2344,4,11604,644,0,2,3,3,1
25629,23,383,424,94,331,4,0,89,428,1,5,5,5,6,10,11,25,0,12,0,0,2,3,2,0
25630,23,383,38,23,23,6,0,8,44,3,11,7,11,14,18,42,68,1,102,5,0,2,3,2,0
25631,23,409,424,94,331,4,0,89,428,1,5,5,5,6,10,11,25,0,12,0,0,2,8,6,0
25632,23,409,38,23,23,6,0,8,44,3,11,7,11,14,18,42,68,1,102,5,0,2,8,6,0
25633,25,625,1293,570,1093,25,15,163,1318,10,195,123,241,205,364,1516,2795,6,17273,959,0,2,6,0,1
25634,27,1013,1293,570,1093,25,15,163,1318,10,195,123,241,205,364,1516,2795,6,17273,959,0,2,16,0,1
25635,54,2876,1338,495,1086,10,64,173,1348,11,122,82,157,133,239,883,1686,7,11934,663,0,2,18,0,0
25637,166,3708,77,34,69,0,0,8,77,3,24,16,29,27,45,114,213,1,387,21,0,2,8,5,1
25638,166,3708,712,438,573,51,9,84,763,14,102,71,128,116,199,733,1364,8,11988,666,0,2,8,5,1
25639,62,2584,1289,550,1043,56,32,155,1345,10,167,93,185,177,278,1266,2075,5,11498,638,0,2,8,0,1
25640,57,1097,1098,241,925,5,10,155,1103,7,46,25,49,53,74,273,423,3,1580,87,0,2,4,1,1
25641,57,1097,282,202,222,14,2,44,296,8,42,24,43,50,67,250,378,4,1548,86,0,2,4,1,1
25642,34,1295,1098,241,925,5,10,155,1103,7,46,25,49,53,74,273,423,3,1580,87,0,2,18,0,1
25643,23,612,102,59,69,5,3,24,107,6,22,15,28,28,43,113,206,3,789,43,0,2,2,0,0
25646,37,2250,1523,757,1297,19,12,193,1542,12,193,117,230,205,347,1508,2664,7,19053,1058,0,2,1,1,1
25647,436,9474,72,33,56,0,4,12,72,1,1,1,1,2,2,0,2,0,1,0,0,2,31,14,1
25648,436,9474,1454,835,1044,76,110,219,1530,17,275,158,296,292,454,2297,3718,9,34017,1889,1,2,31,14,1
25649,113,4797,139,89,101,2,0,35,141,7,54,34,62,61,96,330,569,4,2287,127,0,2,22,6,1
25650,113,4797,7,5,5,0,0,2,7,1,2,1,2,3,3,2,4,0,2,0,0,2,22,6,1
25651,160,3165,1943,715,1694,26,18,214,1969,12,185,120,237,197,357,1436,2721,7,20915,1161,0,2,3,2,1
25652,160,3165,1168,838,957,57,25,144,1225,19,348,224,416,367,640,3018,5452,11,61921,3440,1,2,3,2,1
25653,59,2688,1943,715,1694,26,18,214,1969,12,185,120,237,197,357,1436,2721,7,20915,1161,0,2,8,1,1
25654,436,9476,72,33,56,0,4,12,72,1,1,1,1,2,2,0,2,0,1,0,0,2,1,1,1
25655,436,9476,1454,835,1044,76,110,219,1530,17,275,158,296,292,454,2297,3718,9,34017,1889,1,2,1,1,1
25656,113,4797,139,89,101,2,0,35,141,7,54,34,62,61,96,330,569,4,2287,127,0,2,10,10,1
25657,113,4797,7,5,5,0,0,2,7,1,2,1,2,3,3,2,4,0,2,0,0,2,10,10,1
25658,59,2687,1943,715,1694,26,18,214,1969,12,185,120,237,197,357,1436,2721,7,20915,1161,0,2,1,1,1
25659,42,846,447,308,343,6,5,95,453,7,96,59,111,103,170,651,1136,4,4600,255,0,2,85,56,1
25660,42,846,322,174,179,16,74,51,338,10,41,26,46,51,72,252,408,5,2291,127,0,2,85,56,1
25661,32,1449,447,308,343,6,5,95,453,7,96,59,111,103,170,651,1136,4,4600,255,0,2,14,6,1
25687,44,428,647,139,84,35,284,233,682,0,0,0,0,0,0,0,0,0,0,0,0,2,1,1,1
25688,162,3224,1943,715,1694,26,18,214,1969,12,185,120,237,197,357,1436,2721,7,20915,1161,0,2,8,1,1
25689,162,3224,1168,838,957,57,25,144,1225,19,348,224,416,367,640,3018,5452,11,61921,3440,1,2,8,1,1
25690,46,2032,1020,354,843,12,15,144,1032,8,134,77,144,142,221,970,1580,4,6792,377,0,2,1,1,1
25691,60,2714,1943,715,1694,26,18,214,1969,12,185,120,237,197,357,1436,2721,7,20915,1161,0,2,13,0,1
25692,200,3862,1457,730,1242,11,6,188,1468,10,292,166,329,302,495,2424,4078,5,22973,1276,1,2,5,18,1
25693,200,3862,74,35,59,1,0,14,75,3,14,7,14,17,21,58,85,1,128,7,0,2,5,18,1
25694,200,3862,245,125,200,5,7,34,250,7,30,17,34,37,51,166,265,3,1053,58,0,2,5,18,1
25695,36,2153,334,251,279,10,4,40,344,5,127,74,143,132,217,899,1528,2,4303,239,0,2,5,5,1
25696,199,3859,1457,730,1242,11,6,188,1468,10,292,166,329,302,495,2424,4078,5,22973,1276,1,2,3,3,1
25697,199,3859,74,35,59,1,0,14,75,3,14,7,14,17,21,58,85,1,128,7,0,2,3,3,1
25698,199,3859,245,125,200,5,7,34,250,7,30,17,34,37,51,166,265,3,1053,58,0,2,3,3,1
25699,34,1725,1457,730,1242,11,6,188,1468,10,292,166,329,302,495,2424,4078,5,22973,1276,1,2,1,1,1
25700,6,493,442,244,305,14,16,103,456,11,68,45,75,79,120,452,756,6,4588,254,0,2,1,1,1
25701,199,3865,1457,730,1242,11,6,188,1468,10,292,166,329,302,495,2424,4078,5,22973,1276,1,2,3,1,0
25702,199,3865,74,35,59,1,0,14,75,3,14,7,14,17,21,58,85,1,128,7,0,2,3,1,0
25703,199,3865,245,125,200,5,7,34,250,7,30,17,34,37,51,166,265,3,1053,58,0,2,3,1,0
25704,43,421,647,139,84,35,284,233,682,0,0,0,0,0,0,0,0,0,0,0,0,2,1,4,0
25705,70,1248,1513,682,1277,25,13,200,1538,11,199,116,219,210,335,1557,2584,6,15641,868,0,2,8,0,1
25706,70,1248,819,519,539,24,98,155,843,15,96,57,106,111,163,690,1107,8,9171,509,0,2,8,0,1
25707,165,3712,77,34,69,0,0,8,77,3,24,16,29,27,45,114,213,1,387,21,0,2,1,0,1
25708,165,3712,712,438,573,51,9,84,763,14,102,71,128,116,199,733,1364,8,11988,666,0,2,1,0,1
25709,192,4394,722,423,573,19,0,135,741,12,172,101,199,184,300,1320,2257,6,15668,870,0,2,12,21,1
25710,192,4394,1508,847,911,44,250,301,1552,14,148,88,169,162,257,1120,1886,7,15077,837,0,2,12,21,1
25711,61,2537,1289,550,1043,56,32,155,1345,10,167,93,185,177,278,1266,2075,5,11498,638,0,2,5,5,1
25712,42,2708,1296,573,1062,40,33,157,1336,8,201,118,231,209,349,1561,2689,4,12365,686,0,2,2,2,1
25713,22,954,1455,414,1257,16,76,112,1471,5,41,23,46,46,69,231,381,2,1069,59,0,2,1,1,1
25714,36,2150,334,251,279,10,4,40,344,5,127,74,143,132,217,899,1528,2,4303,239,0,2,1,1,0
25715,199,3872,1457,730,1242,11,6,188,1468,10,292,166,329,302,495,2424,4078,5,22973,1276,1,2,9,14,1
25716,199,3872,74,35,59,1,0,14,75,3,14,7,14,17,21,58,85,1,128,7,0,2,9,14,1
25717,199,3872,245,125,200,5,7,34,250,7,30,17,34,37,51,166,265,3,1053,58,0,2,9,14,1
25718,208,4134,1457,730,1242,11,6,188,1468,10,292,166,329,302,495,2424,4078,5,22973,1276,1,2,55,16,1
25719,208,4134,74,35,59,1,0,14,75,3,14,7,14,17,21,58,85,1,128,7,0,2,55,16,1
25720,208,4134,245,125,200,5,7,34,250,7,30,17,34,37,51,166,265,3,1053,58,0,2,55,16,1
25721,42,1123,74,35,59,1,0,14,75,3,14,7,14,17,21,58,85,1,128,7,0,2,2,2,1
25722,42,1123,245,125,200,5,7,34,250,7,30,17,34,37,51,166,265,3,1053,58,0,2,2,2,1
25723,165,3706,77,34,69,0,0,8,77,3,24,16,29,27,45,114,213,1,387,21,0,2,2,2,1
25724,165,3706,712,438,573,51,9,84,763,14,102,71,128,116,199,733,1364,8,11988,666,0,2,2,2,1
25725,59,1128,1020,354,843,12,15,144,1032,8,134,77,144,142,221,970,1580,4,6792,377,0,2,5,3,1
25726,192,4388,722,423,573,19,0,135,741,12,172,101,199,184,300,1320,2257,6,15668,870,0,2,2,2,1
25727,192,4388,1508,847,911,44,250,301,1552,14,148,88,169,162,257,1120,1886,7,15077,837,0,2,2,2,1
25728,24,974,373,158,315,8,0,51,381,5,76,44,79,81,123,486,779,2,2026,112,0,2,3,2,1
25729,229,4659,1457,730,1242,11,6,188,1468,10,292,166,329,302,495,2424,4078,5,22973,1276,1,2,104,2,1
25730,229,4659,74,35,59,1,0,14,75,3,14,7,14,17,21,58,85,1,128,7,0,2,104,2,1
25731,229,4659,245,125,200,5,7,34,250,7,30,17,34,37,51,166,265,3,1053,58,0,2,104,2,1
25732,165,3704,77,34,69,0,0,8,77,3,24,16,29,27,45,114,213,1,387,21,0,2,1,1,1
25733,165,3704,712,438,573,51,9,84,763,14,102,71,128,116,199,733,1364,8,11988,666,0,2,1,1,1
25736,165,3265,1943,715,1694,26,18,214,1969,12,185,120,237,197,357,1436,2721,7,20915,1161,0,2,6,0,1
25737,165,3265,1168,838,957,57,25,144,1225,19,348,224,416,367,640,3018,5452,11,61921,3440,1,2,6,0,1
25738,36,1810,1457,730,1242,11,6,188,1468,10,292,166,329,302,495,2424,4078,5,22973,1276,1,2,15,0,1
25739,14,577,722,423,573,19,0,135,741,12,172,101,199,184,300,1320,2257,6,15668,870,0,2,1,1,1
25740,71,1306,1513,682,1277,25,13,200,1538,11,199,116,219,210,335,1557,2584,6,15641,868,0,2,20,9,1
25741,71,1306,819,519,539,24,98,155,843,15,96,57,106,111,163,690,1107,8,9171,509,0,2,20,9,1
25742,229,4666,1457,730,1242,11,6,188,1468,10,292,166,329,302,495,2424,4078,5,22973,1276,1,2,21,25,1
25743,229,4666,74,35,59,1,0,14,75,3,14,7,14,17,21,58,85,1,128,7,0,2,21,25,1
25744,229,4666,245,125,200,5,7,34,250,7,30,17,34,37,51,166,265,3,1053,58,0,2,21,25,1
25745,44,432,647,139,84,35,284,233,682,0,0,0,0,0,0,0,0,0,0,0,0,2,5,1,1
25746,42,1791,1513,682,1277,25,13,200,1538,11,199,116,219,210,335,1557,2584,6,15641,868,0,2,10,0,1
25747,38,1886,1457,730,1242,11,6,188,1468,10,292,166,329,302,495,2424,4078,5,22973,1276,1,2,15,0,1
25748,37,2204,334,251,279,10,4,40,344,5,127,74,143,132,217,899,1528,2,4303,239,0,2,6,0,1
25749,440,9534,72,33,56,0,4,12,72,1,1,1,1,2,2,0,2,0,1,0,0,2,22,8,1
25750,440,9534,1454,835,1044,76,110,219,1530,17,275,158,296,292,454,2297,3718,9,34017,1889,1,2,22,8,1
25751,113,4797,139,89,101,2,0,35,141,7,54,34,62,61,96,330,569,4,2287,127,0,2,8,9,1
25752,113,4797,7,5,5,0,0,2,7,1,2,1,2,3,3,2,4,0,2,0,0,2,8,9,1
25753,441,9550,72,33,56,0,4,12,72,1,1,1,1,2,2,0,2,0,1,0,0,2,5,0,1
25754,441,9550,1454,835,1044,76,110,219,1530,17,275,158,296,292,454,2297,3718,9,34017,1889,1,2,5,0,1
25755,114,4827,139,89,101,2,0,35,141,7,54,34,62,61,96,330,569,4,2287,127,0,2,15,0,1
25756,114,4827,7,5,5,0,0,2,7,1,2,1,2,3,3,2,4,0,2,0,0,2,15,0,1
25780,73,1336,1513,682,1277,25,13,200,1538,11,199,116,219,210,335,1557,2584,6,15641,868,0,2,5,0,1
25781,73,1336,819,519,539,24,98,155,843,15,96,57,106,111,163,690,1107,8,9171,509,0,2,5,0,1
25784,61,2530,1289,550,1043,56,32,155,1345,10,167,93,185,177,278,1266,2075,5,11498,638,0,2,5,5,1
25785,42,1782,1513,682,1277,25,13,200,1538,11,199,116,219,210,335,1557,2584,6,15641,868,0,2,0,1,1
25809,13,426,42,7,35,4,0,5,46,1,2,1,2,3,3,2,4,0,2,0,0,2,2,2,1
25810,13,426,11,6,10,0,0,1,11,2,4,2,4,6,6,10,15,1,15,0,0,2,2,2,1
25811,196,4437,722,423,573,19,0,135,741,12,172,101,199,184,300,1320,2257,6,15668,870,0,2,6,0,1
25812,196,4437,1508,847,911,44,250,301,1552,14,148,88,169,162,257,1120,1886,7,15077,837,0,2,6,0,1
25813,1,224,382,65,130,157,2,92,539,4,10,5,10,14,15,41,57,2,114,6,0,2,1,1,1
25814,61,2521,1289,550,1043,56,32,155,1345,10,167,93,185,177,278,1266,2075,5,11498,638,0,2,5,9,1
25815,37,2265,1523,757,1297,19,12,193,1542,12,193,117,230,205,347,1508,2664,7,19053,1058,0,2,4,4,1
25839,13,426,42,7,35,4,0,5,46,1,2,1,2,3,3,2,4,0,2,0,0,2,1,1,0
25840,13,426,11,6,10,0,0,1,11,2,4,2,4,6,6,10,15,1,15,0,0,2,1,1,0
25841,229,4670,1457,730,1242,11,6,188,1468,10,292,166,329,302,495,2424,4078,5,22973,1276,1,2,1,1,1
25842,229,4670,74,35,59,1,0,14,75,3,14,7,14,17,21,58,85,1,128,7,0,2,1,1,1
25843,229,4670,245,125,200,5,7,34,250,7,30,17,34,37,51,166,265,3,1053,58,0,2,1,1,1
25844,39,1926,1457,730,1242,11,6,188,1468,10,292,166,329,302,495,2424,4078,5,22973,1276,1,2,11,0,1
25845,9,241,19,8,11,5,0,4,24,2,5,3,6,7,9,13,25,1,30,1,0,2,5,1,1
25846,9,241,102,59,69,5,3,24,107,6,22,15,28,28,43,113,206,3,789,43,0,2,5,1,1
25847,9,241,106,40,36,3,49,17,109,8,17,13,23,25,36,93,167,5,904,50,0,2,5,1,1
25848,9,241,19,8,11,5,0,4,24,2,5,3,6,7,9,13,25,1,30,1,0,2,5,1,0
25849,9,241,102,59,69,5,3,24,107,6,22,15,28,28,43,113,206,3,789,43,0,2,5,1,0
25850,9,241,106,40,36,3,49,17,109,8,17,13,23,25,36,93,167,5,904,50,0,2,5,1,0
25851,441,9550,72,33,56,0,4,12,72,1,1,1,1,2,2,0,2,0,1,0,0,2,2,2,1
25852,441,9550,1454,835,1044,76,110,219,1530,17,275,158,296,292,454,2297,3718,9,34017,1889,1,2,2,2,1
25853,55,2905,1338,495,1086,10,64,173,1348,11,122,82,157,133,239,883,1686,7,11934,663,0,2,10,0,1
25877,1,225,382,65,130,157,2,92,539,4,10,5,10,14,15,41,57,2,114,6,0,2,2,1,1
25903,73,1336,1513,682,1277,25,13,200,1538,11,199,116,219,210,335,1557,2584,6,15641,868,0,2,1,1,1
25904,73,1336,819,519,539,24,98,155,843,15,96,57,106,111,163,690,1107,8,9171,509,0,2,1,1,1
25905,164,3237,1943,715,1694,26,18,214,1969,12,185,120,237,197,357,1436,2721,7,20915,1161,0,2,8,5,1
25906,164,3237,1168,838,957,57,25,144,1225,19,348,224,416,367,640,3018,5452,11,61921,3440,1,2,8,5,1
25911,30,617,2,2,2,0,0,0,2,0,0,0,0,0,0,0,0,0,0,0,0,2,1,2,1
25925,30,617,99,48,90,1,3,5,100,0,0,0,0,0,0,0,0,0,0,0,0,2,1,2,1
25926,30,617,8,5,5,2,0,1,10,0,0,0,0,0,0,0,0,0,0,0,0,2,1,2,1
25927,30,617,1217,716,841,84,126,174,1301,14,185,118,215,199,333,1446,2542,8,20687,1149,0,2,1,2,1
25928,30,617,160,89,115,0,13,31,160,7,15,11,17,22,28,78,124,3,495,27,0,2,1,2,1
25929,30,617,10,10,9,9,0,0,19,0,0,0,0,0,0,0,0,0,0,0,0,2,1,2,1
25930,30,617,173,84,99,8,29,36,181,5,12,7,13,17,20,54,81,2,221,12,0,2,1,2,1
25931,30,617,3,1,1,3,0,0,6,0,0,0,0,0,0,0,0,0,0,0,0,2,1,2,1
25932,165,3696,77,34,69,0,0,8,77,3,24,16,29,27,45,114,213,1,387,21,0,2,0,2,1
25933,165,3696,712,438,573,51,9,84,763,14,102,71,128,116,199,733,1364,8,11988,666,0,2,0,2,1
25934,23,407,424,94,331,4,0,89,428,1,5,5,5,6,10,11,25,0,12,0,0,2,0,1,1
25935,23,407,38,23,23,6,0,8,44,3,11,7,11,14,18,42,68,1,102,5,0,2,0,1,1
25936,196,4435,722,423,573,19,0,135,741,12,172,101,199,184,300,1320,2257,6,15668,870,0,2,0,1,1
25937,196,4435,1508,847,911,44,250,301,1552,14,148,88,169,162,257,1120,1886,7,15077,837,0,2,0,1,1
25938,18,460,386,256,301,16,9,68,402,4,59,35,69,63,104,355,621,2,1453,80,0,2,2,2,1
25939,18,460,264,131,164,11,41,46,275,6,38,22,40,44,62,214,338,3,1068,59,0,2,2,2,1
25940,57,1095,1098,241,925,5,10,155,1103,7,46,25,49,53,74,273,423,3,1580,87,0,2,1,1,1
25941,57,1095,282,202,222,14,2,44,296,8,42,24,43,50,67,250,378,4,1548,86,0,2,1,1,1
25942,60,1136,1020,354,843,12,15,144,1032,8,134,77,144,142,221,970,1580,4,6792,377,0,2,3,2,1
25943,166,3721,77,34,69,0,0,8,77,3,24,16,29,27,45,114,213,1,387,21,0,2,20,11,1
25944,166,3721,712,438,573,51,9,84,763,14,102,71,128,116,199,733,1364,8,11988,666,0,2,20,11,1
25946,45,2799,1296,573,1062,40,33,157,1336,8,201,118,231,209,349,1561,2689,4,12365,686,0,2,22,1,1
25947,12,373,442,244,305,14,16,103,456,11,68,45,75,79,120,452,756,6,4588,254,0,2,3,0,0
25948,12,373,182,102,99,11,40,35,193,3,11,6,11,14,17,42,64,1,97,5,0,2,3,0,0
25949,7,520,442,244,305,14,16,103,456,11,68,45,75,79,120,452,756,6,4588,254,0,2,9,0,0
25950,172,3827,77,34,69,0,0,8,77,3,24,16,29,27,45,114,213,1,387,21,0,2,21,0,1
25951,172,3827,712,438,573,51,9,84,763,14,102,71,128,116,199,733,1364,8,11988,666,0,2,21,0,1
25952,61,1148,1020,354,843,12,15,144,1032,8,134,77,144,142,221,970,1580,4,6792,377,0,2,14,13,1
25953,47,2070,1020,354,843,12,15,144,1032,8,134,77,144,142,221,970,1580,4,6792,377,0,2,25,1,1
25954,163,3229,1943,715,1694,26,18,214,1969,12,185,120,237,197,357,1436,2721,7,20915,1161,0,2,1,1,1
25955,163,3229,1168,838,957,57,25,144,1225,19,348,224,416,367,640,3018,5452,11,61921,3440,1,2,1,1,1
25956,60,2704,1943,715,1694,26,18,214,1969,12,185,120,237,197,357,1436,2721,7,20915,1161,0,2,11,8,1
25980,14,439,42,7,35,4,0,5,46,1,2,1,2,3,3,2,4,0,2,0,0,2,4,2,0
25981,14,439,11,6,10,0,0,1,11,2,4,2,4,6,6,10,15,1,15,0,0,2,4,2,0
25982,38,2239,334,251,279,10,4,40,344,5,127,74,143,132,217,899,1528,2,4303,239,0,2,7,3,1
25983,42,846,447,308,343,6,5,95,453,7,96,59,111,103,170,651,1136,4,4600,255,0,2,3,2,1
25984,42,846,322,174,179,16,74,51,338,10,41,26,46,51,72,252,408,5,2291,127,0,2,3,2,1
25985,164,3240,1943,715,1694,26,18,214,1969,12,185,120,237,197,357,1436,2721,7,20915,1161,0,2,2,2,1
25986,164,3240,1168,838,957,57,25,144,1225,19,348,224,416,367,640,3018,5452,11,61921,3440,1,2,2,2,1
25987,161,3179,1943,715,1694,26,18,214,1969,12,185,120,237,197,357,1436,2721,7,20915,1161,0,2,1,19,0
25988,161,3179,1168,838,957,57,25,144,1225,19,348,224,416,367,640,3018,5452,11,61921,3440,1,2,1,19,0
25989,59,2667,1943,715,1694,26,18,214,1969,12,185,120,237,197,357,1436,2721,7,20915,1161,0,2,0,11,0
25990,14,439,42,7,35,4,0,5,46,1,2,1,2,3,3,2,4,0,2,0,0,2,1,1,1
25991,14,439,11,6,10,0,0,1,11,2,4,2,4,6,6,10,15,1,15,0,0,2,1,1,1
25992,1,225,382,65,130,157,2,92,539,4,10,5,10,14,15,41,57,2,114,6,0,2,2,2,1
25993,129,4015,1660,832,1314,41,38,274,1701,20,312,209,395,332,604,2671,5058,12,64042,3557,1,2,3,3,1
25994,129,4015,1057,646,719,113,100,145,1170,18,215,134,248,233,382,1740,3004,10,31186,1732,1,2,3,3,1
25995,112,2716,1660,832,1314,41,38,274,1701,20,312,209,395,332,604,2671,5058,12,64042,3557,1,2,7,1,1
25996,129,4017,1660,832,1314,41,38,274,1701,20,312,209,395,332,604,2671,5058,12,64042,3557,1,2,1,1,1
25997,129,4017,1057,646,719,113,100,145,1170,18,215,134,248,233,382,1740,3004,10,31186,1732,1,2,1,1,1
25998,113,2758,1660,832,1314,41,38,274,1701,20,312,209,395,332,604,2671,5058,12,64042,3557,1,2,10,1,1
25999,114,2807,1660,832,1314,41,38,274,1701,20,312,209,395,332,604,2671,5058,12,64042,3557,1,2,9,0,0
26025,86,1526,1178,367,1042,6,15,115,1184,9,94,51,95,103,146,644,976,4,4439,246,0,2,8,0,1
26026,86,1526,177,108,140,8,0,27,185,6,30,16,32,36,48,162,248,3,794,44,0,2,8,0,1
26027,13,442,42,7,35,4,0,5,46,1,2,1,2,3,3,2,4,0,2,0,0,2,15,13,1
26028,13,442,11,6,10,0,0,1,11,2,4,2,4,6,6,10,15,1,15,0,0,2,15,13,1
26029,43,1897,1178,367,1042,6,15,115,1184,9,94,51,95,103,146,644,976,4,4439,246,0,2,8,10,1
26030,115,2872,1660,832,1314,41,38,274,1701,20,312,209,395,332,604,2671,5058,12,64042,3557,1,2,31,0,0
26031,131,4056,1660,832,1314,41,38,274,1701,20,312,209,395,332,604,2671,5058,12,64042,3557,1,2,18,0,0
26032,131,4056,1057,646,719,113,100,145,1170,18,215,134,248,233,382,1740,3004,10,31186,1732,1,2,18,0,0
26033,131,4052,1660,832,1314,41,38,274,1701,20,312,209,395,332,604,2671,5058,12,64042,3557,1,2,3,2,0
26034,131,4052,1057,646,719,113,100,145,1170,18,215,134,248,233,382,1740,3004,10,31186,1732,1,2,3,2,0
26035,115,2872,1660,832,1314,41,38,274,1701,20,312,209,395,332,604,2671,5058,12,64042,3557,1,2,1,0,0
26036,131,4052,1660,832,1314,41,38,274,1701,20,312,209,395,332,604,2671,5058,12,64042,3557,1,2,19,0,0
26037,131,4052,1057,646,719,113,100,145,1170,18,215,134,248,233,382,1740,3004,10,31186,1732,1,2,19,0,0
26038,115,2872,1660,832,1314,41,38,274,1701,20,312,209,395,332,604,2671,5058,12,64042,3557,1,2,32,0,0
26039,63,1172,1020,354,843,12,15,144,1032,8,134,77,144,142,221,970,1580,4,6792,377,0,2,5,2,1
26040,48,2097,1020,354,843,12,15,144,1032,8,134,77,144,142,221,970,1580,4,6792,377,0,2,11,0,1
26043,30,617,2,2,2,0,0,0,2,0,0,0,0,0,0,0,0,0,0,0,0,2,5,5,1
26057,30,617,99,48,90,1,3,5,100,0,0,0,0,0,0,0,0,0,0,0,0,2,5,5,1
26058,30,617,8,5,5,2,0,1,10,0,0,0,0,0,0,0,0,0,0,0,0,2,5,5,1
26059,30,617,1217,716,841,84,126,174,1301,14,185,118,215,199,333,1446,2542,8,20687,1149,0,2,5,5,1
26060,30,617,160,89,115,0,13,31,160,7,15,11,17,22,28,78,124,3,495,27,0,2,5,5,1
26061,30,617,10,10,9,9,0,0,19,0,0,0,0,0,0,0,0,0,0,0,0,2,5,5,1
26062,30,617,173,84,99,8,29,36,181,5,12,7,13,17,20,54,81,2,221,12,0,2,5,5,1
26063,30,617,3,1,1,3,0,0,6,0,0,0,0,0,0,0,0,0,0,0,0,2,5,5,1
26064,131,4052,1660,832,1314,41,38,274,1701,20,312,209,395,332,604,2671,5058,12,64042,3557,1,2,3,2,1
26065,131,4052,1057,646,719,113,100,145,1170,18,215,134,248,233,382,1740,3004,10,31186,1732,1,2,3,2,1
26066,229,4668,1457,730,1242,11,6,188,1468,10,292,166,329,302,495,2424,4078,5,22973,1276,1,2,1,1,1
26067,229,4668,74,35,59,1,0,14,75,3,14,7,14,17,21,58,85,1,128,7,0,2,1,1,1
26068,229,4668,245,125,200,5,7,34,250,7,30,17,34,37,51,166,265,3,1053,58,0,2,1,1,1
26069,42,1119,74,35,59,1,0,14,75,3,14,7,14,17,21,58,85,1,128,7,0,2,0,1,1
26070,42,1119,245,125,200,5,7,34,250,7,30,17,34,37,51,166,265,3,1053,58,0,2,0,1,1
26071,172,3822,77,34,69,0,0,8,77,3,24,16,29,27,45,114,213,1,387,21,0,2,0,1,1
26072,172,3822,712,438,573,51,9,84,763,14,102,71,128,116,199,733,1364,8,11988,666,0,2,0,1,1
26073,195,4408,722,423,573,19,0,135,741,12,172,101,199,184,300,1320,2257,6,15668,870,0,2,1,6,1
26074,195,4408,1508,847,911,44,250,301,1552,14,148,88,169,162,257,1120,1886,7,15077,837,0,2,1,6,1
26075,439,9488,72,33,56,0,4,12,72,1,1,1,1,2,2,0,2,0,1,0,0,2,4,9,1
26076,439,9488,1454,835,1044,76,110,219,1530,17,275,158,296,292,454,2297,3718,9,34017,1889,1,2,4,9,1
26077,86,1521,1178,367,1042,6,15,115,1184,9,94,51,95,103,146,644,976,4,4439,246,0,2,0,1,1
26078,86,1521,177,108,140,8,0,27,185,6,30,16,32,36,48,162,248,3,794,44,0,2,0,1,1
26079,161,3177,1943,715,1694,26,18,214,1969,12,185,120,237,197,357,1436,2721,7,20915,1161,0,2,0,1,1
26080,161,3177,1168,838,957,57,25,144,1225,19,348,224,416,367,640,3018,5452,11,61921,3440,1,2,0,1,1
26081,61,2511,1289,550,1043,56,32,155,1345,10,167,93,185,177,278,1266,2075,5,11498,638,0,2,3,4,1
26082,55,2891,1338,495,1086,10,64,173,1348,11,122,82,157,133,239,883,1686,7,11934,663,0,2,4,6,1
26083,114,4817,139,89,101,2,0,35,141,7,54,34,62,61,96,330,569,4,2287,127,0,2,6,6,1
26084,114,4817,7,5,5,0,0,2,7,1,2,1,2,3,3,2,4,0,2,0,0,2,6,6,1
26085,13,380,465,148,393,5,8,60,470,4,31,20,31,35,51,161,261,2,523,29,0,2,1,1,1
26086,13,380,16,12,9,0,0,6,16,1,2,1,2,3,3,2,4,0,2,0,0,2,1,1,1
26087,57,3235,1782,648,1425,9,47,279,1791,8,171,97,189,179,286,1292,2140,4,9462,525,0,2,1,2,1
26088,9,192,256,139,192,9,7,47,265,4,23,12,24,27,36,112,171,2,357,19,0,2,1,1,1
26089,49,1690,1450,624,1228,12,26,181,1462,14,306,186,354,320,540,2580,4493,8,36391,2021,1,2,2,2,1
26090,115,2864,1660,832,1314,41,38,274,1701,20,312,209,395,332,604,2671,5058,12,64042,3557,1,2,7,8,1
26091,45,2786,1296,573,1062,40,33,157,1336,8,201,118,231,209,349,1561,2689,4,12365,686,0,2,6,6,1
26092,39,1924,1457,730,1242,11,6,188,1468,10,292,166,329,302,495,2424,4078,5,22973,1276,1,2,6,6,1
26093,29,1370,652,304,544,16,6,88,668,6,89,51,101,95,152,591,998,3,3399,188,0,2,4,4,1
26094,22,950,1455,414,1257,16,76,112,1471,5,41,23,46,46,69,231,381,2,1069,59,0,2,2,2,1
26096,37,2252,1523,757,1297,19,12,193,1542,12,193,117,230,205,347,1508,2664,7,19053,1058,0,2,2,4,1
26097,48,2093,1020,354,843,12,15,144,1032,8,134,77,144,142,221,970,1580,4,6792,377,0,2,3,3,1
26098,16,502,424,94,331,4,0,89,428,1,5,5,5,6,10,11,25,0,12,0,0,2,1,1,1
26099,38,2232,334,251,279,10,4,40,344,5,127,74,143,132,217,899,1528,2,4303,239,0,2,7,8,1
26100,7,291,184,100,137,2,15,30,186,6,38,20,39,44,59,214,322,3,991,55,0,2,1,2,1
26101,27,1009,1293,570,1093,25,15,163,1318,10,195,123,241,205,364,1516,2795,6,17273,959,0,2,2,2,1
26102,14,569,722,423,573,19,0,135,741,12,172,101,199,184,300,1320,2257,6,15668,870,0,2,2,3,1
26103,46,1867,1043,504,840,53,9,147,1096,9,180,112,198,189,310,1377,2344,4,11604,644,0,2,6,6,1
26104,24,972,373,158,315,8,0,51,381,5,76,44,79,81,123,486,779,2,2026,112,0,2,1,1,1
26105,43,1898,1178,367,1042,6,15,115,1184,9,94,51,95,103,146,644,976,4,4439,246,0,2,6,6,1
26106,59,2593,1943,715,1694,26,18,214,1969,12,185,120,237,197,357,1436,2721,7,20915,1161,0,2,20,23,1
26107,7,518,442,244,305,14,16,103,456,11,68,45,75,79,120,452,756,6,4588,254,0,2,0,1,1
26108,34,1293,1098,241,925,5,10,155,1103,7,46,25,49,53,74,273,423,3,1580,87,0,2,1,1,1
26109,439,9491,72,33,56,0,4,12,72,1,1,1,1,2,2,0,2,0,1,0,0,2,3,3,1
26110,439,9491,1454,835,1044,76,110,219,1530,17,275,158,296,292,454,2297,3718,9,34017,1889,1,2,3,3,1
26111,14,399,465,148,393,5,8,60,470,4,31,20,31,35,51,161,261,2,523,29,0,2,4,0,1
26112,14,399,16,12,9,0,0,6,16,1,2,1,2,3,3,2,4,0,2,0,0,2,4,0,1
26113,42,852,447,308,343,6,5,95,453,7,96,59,111,103,170,651,1136,4,4600,255,0,2,4,3,1
26114,42,852,322,174,179,16,74,51,338,10,41,26,46,51,72,252,408,5,2291,127,0,2,4,3,1
26115,33,1483,447,308,343,6,5,95,453,7,96,59,111,103,170,651,1136,4,4600,255,0,2,6,0,1
26139,42,1313,1523,757,1297,19,12,193,1542,12,193,117,230,205,347,1508,2664,7,19053,1058,0,2,7,8,1
26140,42,1313,701,378,504,33,58,109,734,13,110,68,126,123,194,794,1346,7,10027,557,0,2,7,8,1
26141,13,442,42,7,35,4,0,5,46,1,2,1,2,3,3,2,4,0,2,0,0,2,1,1,1
26142,13,442,11,6,10,0,0,1,11,2,4,2,4,6,6,10,15,1,15,0,0,2,1,1,1
26143,38,2361,1523,757,1297,19,12,193,1542,12,193,117,230,205,347,1508,2664,7,19053,1058,0,2,25,2,1
26144,42,852,447,308,343,6,5,95,453,7,96,59,111,103,170,651,1136,4,4600,255,0,2,2,2,1
26145,42,852,322,174,179,16,74,51,338,10,41,26,46,51,72,252,408,5,2291,127,0,2,2,2,1
26146,38,2370,1523,757,1297,19,12,193,1542,12,193,117,230,205,347,1508,2664,7,19053,1058,0,2,4,3,1
26147,13,442,42,7,35,4,0,5,46,1,2,1,2,3,3,2,4,0,2,0,0,2,1,1,0
26148,13,442,11,6,10,0,0,1,11,2,4,2,4,6,6,10,15,1,15,0,0,2,1,1,0
26149,439,9498,72,33,56,0,4,12,72,1,1,1,1,2,2,0,2,0,1,0,0,2,5,4,1
26150,439,9498,1454,835,1044,76,110,219,1530,17,275,158,296,292,454,2297,3718,9,34017,1889,1,2,5,4,1
26151,61,2962,1338,495,1086,10,64,173,1348,11,122,82,157,133,239,883,1686,7,11934,663,0,2,15,0,1
26152,439,9498,72,33,56,0,4,12,72,1,1,1,1,2,2,0,2,0,1,0,0,2,5,4,0
26153,439,9498,1454,835,1044,76,110,219,1530,17,275,158,296,292,454,2297,3718,9,34017,1889,1,2,5,4,0
26154,61,2962,1338,495,1086,10,64,173,1348,11,122,82,157,133,239,883,1686,7,11934,663,0,2,15,0,0
26158,132,4066,1660,832,1314,41,38,274,1701,20,312,209,395,332,604,2671,5058,12,64042,3557,1,2,6,1,1
26159,132,4066,1057,646,719,113,100,145,1170,18,215,134,248,233,382,1740,3004,10,31186,1732,1,2,6,1,1
26160,438,9497,72,33,56,0,4,12,72,1,1,1,1,2,2,0,2,0,1,0,0,2,1,2,1
26161,438,9497,1454,835,1044,76,110,219,1530,17,275,158,296,292,454,2297,3718,9,34017,1889,1,2,1,2,1
26162,30,1496,652,304,544,16,6,88,668,6,89,51,101,95,152,591,998,3,3399,188,0,2,37,0,1
26163,33,1481,447,308,343,6,5,95,453,7,96,59,111,103,170,651,1136,4,4600,255,0,2,2,2,0
26164,23,612,102,59,69,5,3,24,107,6,22,15,28,28,43,113,206,3,789,43,0,2,2,2,0
26166,438,9497,72,33,56,0,4,12,72,1,1,1,1,2,2,0,2,0,1,0,0,2,1,2,0
26167,438,9497,1454,835,1044,76,110,219,1530,17,275,158,296,292,454,2297,3718,9,34017,1889,1,2,1,2,0
26168,30,1496,652,304,544,16,6,88,668,6,89,51,101,95,152,591,998,3,3399,188,0,2,37,0,0
26170,438,9494,72,33,56,0,4,12,72,1,1,1,1,2,2,0,2,0,1,0,0,2,1,1,1
26171,438,9494,1454,835,1044,76,110,219,1530,17,275,158,296,292,454,2297,3718,9,34017,1889,1,2,1,1,1
26172,438,9494,72,33,56,0,4,12,72,1,1,1,1,2,2,0,2,0,1,0,0,2,1,1,0
26173,438,9494,1454,835,1044,76,110,219,1530,17,275,158,296,292,454,2297,3718,9,34017,1889,1,2,1,1,0
26174,131,4059,1660,832,1314,41,38,274,1701,20,312,209,395,332,604,2671,5058,12,64042,3557,1,2,5,6,0
26175,131,4059,1057,646,719,113,100,145,1170,18,215,134,248,233,382,1740,3004,10,31186,1732,1,2,5,6,0
26176,62,2549,1289,550,1043,56,32,155,1345,10,167,93,185,177,278,1266,2075,5,11498,638,0,2,18,0,0
26177,131,4059,1660,832,1314,41,38,274,1701,20,312,209,395,332,604,2671,5058,12,64042,3557,1,2,6,2,0
26178,131,4059,1057,646,719,113,100,145,1170,18,215,134,248,233,382,1740,3004,10,31186,1732,1,2,6,2,0
26180,11,366,85,59,61,8,0,16,93,5,18,10,18,23,28,86,126,2,316,17,0,0,73,0,1
26181,11,366,85,59,61,8,0,16,93,5,18,10,18,23,28,86,126,2,316,17,0,2,1,1,0
26182,195,4418,722,423,573,19,0,135,741,12,172,101,199,184,300,1320,2257,6,15668,870,0,2,4,3,0
26183,195,4418,1508,847,911,44,250,301,1552,14,148,88,169,162,257,1120,1886,7,15077,837,0,2,4,3,0
26184,27,1034,1293,570,1093,25,15,163,1318,10,195,123,241,205,364,1516,2795,6,17273,959,0,2,7,5,0
26185,54,1029,1098,241,925,5,10,155,1103,7,46,25,49,53,74,273,423,3,1580,87,0,2,0,6,1
26186,54,1029,282,202,222,14,2,44,296,8,42,24,43,50,67,250,378,4,1548,86,0,2,0,6,1
26187,36,1369,1098,241,925,5,10,155,1103,7,46,25,49,53,74,273,423,3,1580,87,0,2,33,4,1
26188,115,2873,1660,832,1314,41,38,274,1701,20,312,209,395,332,604,2671,5058,12,64042,3557,1,2,2,1,0
26189,36,1381,1098,241,925,5,10,155,1103,7,46,25,49,53,74,273,423,3,1580,87,0,2,2,2,1
26190,29,599,215,129,180,6,0,29,221,8,65,43,72,73,115,415,711,4,3153,175,0,2,2,2,0
26191,29,599,97,69,77,3,3,16,100,6,22,13,23,28,36,113,173,3,542,30,0,2,2,2,0
26192,15,1203,215,129,180,6,0,29,221,8,65,43,72,73,115,415,711,4,3153,175,0,2,20,0,0
26193,110,2409,1043,504,840,53,9,147,1096,9,180,112,198,189,310,1377,2344,4,11604,644,0,2,9,1,1
26194,110,2409,383,288,292,26,6,62,409,11,65,38,67,76,105,429,656,5,3719,206,0,2,9,1,1
26195,48,1985,1043,504,840,53,9,147,1096,9,180,112,198,189,310,1377,2344,4,11604,644,0,2,15,0,1
26196,170,3779,77,34,69,0,0,8,77,3,24,16,29,27,45,114,213,1,387,21,0,2,0,7,1
26197,170,3779,712,438,573,51,9,84,763,14,102,71,128,116,199,733,1364,8,11988,666,0,2,0,7,1
26198,441,9544,72,33,56,0,4,12,72,1,1,1,1,2,2,0,2,0,1,0,0,2,10,1,1
26199,441,9544,1454,835,1044,76,110,219,1530,17,275,158,296,292,454,2297,3718,9,34017,1889,1,2,10,1,1
26200,22,555,465,148,393,5,8,60,470,4,31,20,31,35,51,161,261,2,523,29,0,2,37,0,1
26201,22,555,16,12,9,0,0,6,16,1,2,1,2,3,3,2,4,0,2,0,0,2,37,0,1
26202,11,370,85,59,61,8,0,16,93,5,18,10,18,23,28,86,126,2,316,17,0,2,2,1,0
26203,110,2406,1043,504,840,53,9,147,1096,9,180,112,198,189,310,1377,2344,4,11604,644,0,2,5,4,1
26204,110,2406,383,288,292,26,6,62,409,11,65,38,67,76,105,429,656,5,3719,206,0,2,5,4,1
26205,50,2071,1043,504,840,53,9,147,1096,9,180,112,198,189,310,1377,2344,4,11604,644,0,2,13,0,1
26206,170,3779,77,34,69,0,0,8,77,3,24,16,29,27,45,114,213,1,387,21,0,2,0,7,0
26207,170,3779,712,438,573,51,9,84,763,14,102,71,128,116,199,733,1364,8,11988,666,0,2,0,7,0
26208,441,9544,72,33,56,0,4,12,72,1,1,1,1,2,2,0,2,0,1,0,0,2,10,1,0
26209,441,9544,1454,835,1044,76,110,219,1530,17,275,158,296,292,454,2297,3718,9,34017,1889,1,2,10,1,0
26211,22,555,465,148,393,5,8,60,470,4,31,20,31,35,51,161,261,2,523,29,0,2,37,0,0
26212,22,555,16,12,9,0,0,6,16,1,2,1,2,3,3,2,4,0,2,0,0,2,37,0,0
26213,118,4924,139,89,101,2,0,35,141,7,54,34,62,61,96,330,569,4,2287,127,0,2,55,1,1
26214,118,4924,7,5,5,0,0,2,7,1,2,1,2,3,3,2,4,0,2,0,0,2,55,1,1
26215,119,5017,139,89,101,2,0,35,141,7,54,34,62,61,96,330,569,4,2287,127,0,2,33,1,1
26216,119,5017,7,5,5,0,0,2,7,1,2,1,2,3,3,2,4,0,2,0,0,2,33,1,1
26217,444,9618,72,33,56,0,4,12,72,1,1,1,1,2,2,0,2,0,1,0,0,2,44,36,1
26218,444,9618,1454,835,1044,76,110,219,1530,17,275,158,296,292,454,2297,3718,9,34017,1889,1,2,44,36,1
26219,120,5065,139,89,101,2,0,35,141,7,54,34,62,61,96,330,569,4,2287,127,0,2,15,1,1
26220,120,5065,7,5,5,0,0,2,7,1,2,1,2,3,3,2,4,0,2,0,0,2,15,1,1
26221,50,2075,1043,504,840,53,9,147,1096,9,180,112,198,189,310,1377,2344,4,11604,644,0,2,2,0,1
26222,444,9616,72,33,56,0,4,12,72,1,1,1,1,2,2,0,2,0,1,0,0,2,4,5,1
26223,444,9616,1454,835,1044,76,110,219,1530,17,275,158,296,292,454,2297,3718,9,34017,1889,1,2,4,5,1
26224,446,9627,72,33,56,0,4,12,72,1,1,1,1,2,2,0,2,0,1,0,0,2,31,24,1
26225,446,9627,1454,835,1044,76,110,219,1530,17,275,158,296,292,454,2297,3718,9,34017,1889,1,2,31,24,1
26226,111,2398,1043,504,840,53,9,147,1096,9,180,112,198,189,310,1377,2344,4,11604,644,0,2,12,12,1
26227,111,2398,383,288,292,26,6,62,409,11,65,38,67,76,105,429,656,5,3719,206,0,2,12,12,1
26228,50,2070,1043,504,840,53,9,147,1096,9,180,112,198,189,310,1377,2344,4,11604,644,0,2,2,2,1
26229,446,9641,72,33,56,0,4,12,72,1,1,1,1,2,2,0,2,0,1,0,0,2,4,0,1
26230,446,9641,1454,835,1044,76,110,219,1530,17,275,158,296,292,454,2297,3718,9,34017,1889,1,2,4,0,1
26231,120,5027,139,89,101,2,0,35,141,7,54,34,62,61,96,330,569,4,2287,127,0,2,8,11,1
26232,120,5027,7,5,5,0,0,2,7,1,2,1,2,3,3,2,4,0,2,0,0,2,8,11,1
26233,29,556,127,75,83,2,11,30,129,4,14,7,14,18,21,61,87,2,175,9,0,2,4,18,0
26234,29,556,652,304,544,16,6,88,668,6,89,51,101,95,152,591,998,3,3399,188,0,2,4,18,0
26235,29,556,2,2,2,0,0,0,2,0,0,0,0,0,0,0,0,0,0,0,0,2,4,18,0
26236,29,556,8,5,5,0,0,3,8,0,0,0,0,0,0,0,0,0,0,0,0,2,4,18,0
26239,29,556,14,8,8,0,0,6,14,0,0,0,0,0,0,0,0,0,0,0,0,2,4,18,0
26240,29,556,6,4,4,0,0,2,6,0,0,0,0,0,0,0,0,0,0,0,0,2,4,18,0
26241,29,556,6,4,4,0,0,2,6,1,2,1,2,3,3,2,4,0,2,0,0,2,4,18,0
26243,29,556,7,5,5,0,0,2,7,0,0,0,0,0,0,0,0,0,0,0,0,2,4,18,0
26245,29,556,10,6,6,0,0,4,10,0,0,0,0,0,0,0,0,0,0,0,0,2,4,18,0
26246,29,556,1,1,1,0,0,0,1,0,0,0,0,0,0,0,0,0,0,0,0,2,4,18,0
26248,29,556,14,10,10,0,0,4,14,1,1,1,1,2,2,0,2,0,1,0,0,2,4,18,0
26249,29,556,46,26,30,3,0,12,49,3,6,3,6,9,9,20,28,1,42,2,0,2,4,18,0
26250,42,1782,1513,682,1277,25,13,200,1538,11,199,116,219,210,335,1557,2584,6,15641,868,0,2,3,3,0
26251,39,1924,1457,730,1242,11,6,188,1468,10,292,166,329,302,495,2424,4078,5,22973,1276,1,2,1,1,0
26252,30,1496,652,304,544,16,6,88,668,6,89,51,101,95,152,591,998,3,3399,188,0,2,1,1,0
26253,48,2093,1020,354,843,12,15,144,1032,8,134,77,144,142,221,970,1580,4,6792,377,0,2,3,3,0
26254,36,1381,1098,241,925,5,10,155,1103,7,46,25,49,53,74,273,423,3,1580,87,0,2,2,2,0
26255,28,546,127,75,83,2,11,30,129,4,14,7,14,18,21,61,87,2,175,9,0,2,2,5,0
26256,28,546,652,304,544,16,6,88,668,6,89,51,101,95,152,591,998,3,3399,188,0,2,2,5,0
26257,28,546,2,2,2,0,0,0,2,0,0,0,0,0,0,0,0,0,0,0,0,2,2,5,0
26258,28,546,8,5,5,0,0,3,8,0,0,0,0,0,0,0,0,0,0,0,0,2,2,5,0
26261,28,546,14,8,8,0,0,6,14,0,0,0,0,0,0,0,0,0,0,0,0,2,2,5,0
26262,28,546,6,4,4,0,0,2,6,0,0,0,0,0,0,0,0,0,0,0,0,2,2,5,0
26263,28,546,6,4,4,0,0,2,6,1,2,1,2,3,3,2,4,0,2,0,0,2,2,5,0
26265,28,546,7,5,5,0,0,2,7,0,0,0,0,0,0,0,0,0,0,0,0,2,2,5,0
26267,28,546,10,6,6,0,0,4,10,0,0,0,0,0,0,0,0,0,0,0,0,2,2,5,0
26268,28,546,1,1,1,0,0,0,1,0,0,0,0,0,0,0,0,0,0,0,0,2,2,5,0
26270,28,546,14,10,10,0,0,4,14,1,1,1,1,2,2,0,2,0,1,0,0,2,2,5,0
26271,28,546,46,26,30,3,0,12,49,3,6,3,6,9,9,20,28,1,42,2,0,2,2,5,0
26272,66,1213,1020,354,843,12,15,144,1032,8,134,77,144,142,221,970,1580,4,6792,377,0,2,7,1,1
26273,50,2222,1020,354,843,12,15,144,1032,8,134,77,144,142,221,970,1580,4,6792,377,0,2,23,1,1
26274,131,4059,1660,832,1314,41,38,274,1701,20,312,209,395,332,604,2671,5058,12,64042,3557,1,2,1,1,0
26275,131,4059,1057,646,719,113,100,145,1170,18,215,134,248,233,382,1740,3004,10,31186,1732,1,2,1,1,0
26278,30,640,2,2,2,0,0,0,2,0,0,0,0,0,0,0,0,0,0,0,0,2,7,4,1
26292,30,640,99,48,90,1,3,5,100,0,0,0,0,0,0,0,0,0,0,0,0,2,7,4,1
26293,30,640,8,5,5,2,0,1,10,0,0,0,0,0,0,0,0,0,0,0,0,2,7,4,1
26294,30,640,1217,716,841,84,126,174,1301,14,185,118,215,199,333,1446,2542,8,20687,1149,0,2,7,4,1
26295,30,640,160,89,115,0,13,31,160,7,15,11,17,22,28,78,124,3,495,27,0,2,7,4,1
26296,30,640,10,10,9,9,0,0,19,0,0,0,0,0,0,0,0,0,0,0,0,2,7,4,1
26297,30,640,173,84,99,8,29,36,181,5,12,7,13,17,20,54,81,2,221,12,0,2,7,4,1
26298,30,640,3,1,1,3,0,0,6,0,0,0,0,0,0,0,0,0,0,0,0,2,7,4,1
26299,75,1656,477,336,357,30,23,73,507,16,194,134,250,210,384,1538,2962,10,30538,1696,0,2,67,37,1
26302,30,619,2,2,2,0,0,0,2,0,0,0,0,0,0,0,0,0,0,0,0,2,4,2,0
26316,30,619,99,48,90,1,3,5,100,0,0,0,0,0,0,0,0,0,0,0,0,2,4,2,0
26317,30,619,8,5,5,2,0,1,10,0,0,0,0,0,0,0,0,0,0,0,0,2,4,2,0
26318,30,619,1217,716,841,84,126,174,1301,14,185,118,215,199,333,1446,2542,8,20687,1149,0,2,4,2,0
26319,30,619,160,89,115,0,13,31,160,7,15,11,17,22,28,78,124,3,495,27,0,2,4,2,0
26320,30,619,10,10,9,9,0,0,19,0,0,0,0,0,0,0,0,0,0,0,0,2,4,2,0
26321,30,619,173,84,99,8,29,36,181,5,12,7,13,17,20,54,81,2,221,12,0,2,4,2,0
26322,30,619,3,1,1,3,0,0,6,0,0,0,0,0,0,0,0,0,0,0,0,2,4,2,0
26323,74,1566,477,336,357,30,23,73,507,16,194,134,250,210,384,1538,2962,10,30538,1696,0,2,10,7,0
26326,30,617,2,2,2,0,0,0,2,0,0,0,0,0,0,0,0,0,0,0,0,2,2,4,1
26340,30,617,99,48,90,1,3,5,100,0,0,0,0,0,0,0,0,0,0,0,0,2,2,4,1
26341,30,617,8,5,5,2,0,1,10,0,0,0,0,0,0,0,0,0,0,0,0,2,2,4,1
26342,30,617,1217,716,841,84,126,174,1301,14,185,118,215,199,333,1446,2542,8,20687,1149,0,2,2,4,1
26343,30,617,160,89,115,0,13,31,160,7,15,11,17,22,28,78,124,3,495,27,0,2,2,4,1
26344,30,617,10,10,9,9,0,0,19,0,0,0,0,0,0,0,0,0,0,0,0,2,2,4,1
26345,30,617,173,84,99,8,29,36,181,5,12,7,13,17,20,54,81,2,221,12,0,2,2,4,1
26346,30,617,3,1,1,3,0,0,6,0,0,0,0,0,0,0,0,0,0,0,0,2,2,4,1
26347,73,1533,477,336,357,30,23,73,507,16,194,134,250,210,384,1538,2962,10,30538,1696,0,2,7,10,1
26348,26,887,1455,414,1257,16,76,112,1471,5,41,23,46,46,69,231,381,2,1069,59,0,2,6,1,1
26349,26,887,669,365,481,22,61,110,691,15,103,63,122,118,185,747,1273,8,11311,628,0,2,6,1,1
26350,23,997,1455,414,1257,16,76,112,1471,5,41,23,46,46,69,231,381,2,1069,59,0,2,20,0,1
26351,75,1656,477,336,357,30,23,73,507,16,194,134,250,210,384,1538,2962,10,30538,1696,0,2,1,1,1
26352,50,1776,1450,624,1228,12,26,181,1462,14,306,186,354,320,540,2580,4493,8,36391,2021,1,2,10,0,1
26353,50,2082,1043,504,840,53,9,147,1096,9,180,112,198,189,310,1377,2344,4,11604,644,0,2,3,1,1
26354,446,9636,72,33,56,0,4,12,72,1,1,1,1,2,2,0,2,0,1,0,0,2,1,2,1
26355,446,9636,1454,835,1044,76,110,219,1530,17,275,158,296,292,454,2297,3718,9,34017,1889,1,2,1,2,1
26356,24,595,465,148,393,5,8,60,470,4,31,20,31,35,51,161,261,2,523,29,0,2,4,0,1
26357,24,595,16,12,9,0,0,6,16,1,2,1,2,3,3,2,4,0,2,0,0,2,4,0,1
26358,443,9662,72,33,56,0,4,12,72,1,1,1,1,2,2,0,2,0,1,0,0,2,15,10,1
26359,443,9662,1454,835,1044,76,110,219,1530,17,275,158,296,292,454,2297,3718,9,34017,1889,1,2,15,10,1
26360,62,2992,1338,495,1086,10,64,173,1348,11,122,82,157,133,239,883,1686,7,11934,663,0,2,29,0,1
26361,443,9662,72,33,56,0,4,12,72,1,1,1,1,2,2,0,2,0,1,0,0,2,15,10,0
26362,443,9662,1454,835,1044,76,110,219,1530,17,275,158,296,292,454,2297,3718,9,34017,1889,1,2,15,10,0
26363,62,2992,1338,495,1086,10,64,173,1348,11,122,82,157,133,239,883,1686,7,11934,663,0,2,29,0,0
26364,444,9672,72,33,56,0,4,12,72,1,1,1,1,2,2,0,2,0,1,0,0,2,3,2,1
26365,444,9672,1454,835,1044,76,110,219,1530,17,275,158,296,292,454,2297,3718,9,34017,1889,1,2,3,2,1
26366,25,622,465,148,393,5,8,60,470,4,31,20,31,35,51,161,261,2,523,29,0,2,13,0,1
26367,25,622,16,12,9,0,0,6,16,1,2,1,2,3,3,2,4,0,2,0,0,2,13,0,1
26368,120,5034,139,89,101,2,0,35,141,7,54,34,62,61,96,330,569,4,2287,127,0,2,6,2,1
26369,120,5034,7,5,5,0,0,2,7,1,2,1,2,3,3,2,4,0,2,0,0,2,6,2,1
26370,440,9611,72,33,56,0,4,12,72,1,1,1,1,2,2,0,2,0,1,0,0,2,67,75,1
26371,440,9611,1454,835,1044,76,110,219,1530,17,275,158,296,292,454,2297,3718,9,34017,1889,1,2,67,75,1
26372,439,9596,72,33,56,0,4,12,72,1,1,1,1,2,2,0,2,0,1,0,0,2,0,2,0
26373,439,9596,1454,835,1044,76,110,219,1530,17,275,158,296,292,454,2297,3718,9,34017,1889,1,2,0,2,0
26374,163,3249,1943,715,1694,26,18,214,1969,12,185,120,237,197,357,1436,2721,7,20915,1161,0,2,8,0,1
26375,163,3249,1168,838,957,57,25,144,1225,19,348,224,416,367,640,3018,5452,11,61921,3440,1,2,8,0,1
26376,61,2682,1943,715,1694,26,18,214,1969,12,185,120,237,197,357,1436,2721,7,20915,1161,0,2,13,0,1
26377,61,2680,1943,715,1694,26,18,214,1969,12,185,120,237,197,357,1436,2721,7,20915,1161,0,2,2,2,0
26378,170,3786,77,34,69,0,0,8,77,3,24,16,29,27,45,114,213,1,387,21,0,2,4,0,1
26379,170,3786,712,438,573,51,9,84,763,14,102,71,128,116,199,733,1364,8,11988,666,0,2,4,0,1
26380,439,9723,72,33,56,0,4,12,72,1,1,1,1,2,2,0,2,0,1,0,0,2,180,149,1
26381,439,9723,1454,835,1044,76,110,219,1530,17,275,158,296,292,454,2297,3718,9,34017,1889,1,2,180,149,1
26382,62,2993,1338,495,1086,10,64,173,1348,11,122,82,157,133,239,883,1686,7,11934,663,0,2,1,1,1
26383,120,5138,139,89,101,2,0,35,141,7,54,34,62,61,96,330,569,4,2287,127,0,2,15,16,1
26384,120,5138,7,5,5,0,0,2,7,1,2,1,2,3,3,2,4,0,2,0,0,2,15,16,1
26385,57,3235,1782,648,1425,9,47,279,1791,8,171,97,189,179,286,1292,2140,4,9462,525,0,2,2,2,1
26386,165,3722,77,34,69,0,0,8,77,3,24,16,29,27,45,114,213,1,387,21,0,2,1,11,1
26387,165,3722,712,438,573,51,9,84,763,14,102,71,128,116,199,733,1364,8,11988,666,0,2,1,11,1
26388,431,9623,72,33,56,0,4,12,72,1,1,1,1,2,2,0,2,0,1,0,0,2,0,18,1
26389,431,9623,1454,835,1044,76,110,219,1530,17,275,158,296,292,454,2297,3718,9,34017,1889,1,2,0,18,1
26390,62,2899,1338,495,1086,10,64,173,1348,11,122,82,157,133,239,883,1686,7,11934,663,0,2,2,14,1
26391,111,2393,1043,504,840,53,9,147,1096,9,180,112,198,189,310,1377,2344,4,11604,644,0,2,0,1,0
26392,111,2393,383,288,292,26,6,62,409,11,65,38,67,76,105,429,656,5,3719,206,0,2,0,1,0
26394,2,34,9,6,6,0,0,3,9,0,0,0,0,0,0,0,0,0,0,0,0,0,10,0,0
26395,2,34,13,9,8,0,0,4,13,0,0,0,0,0,0,0,0,0,0,0,0,0,10,0,0
26396,57,3230,1782,648,1425,9,47,279,1791,8,171,97,189,179,286,1292,2140,4,9462,525,0,2,1,1,0
26397,433,9667,72,33,56,0,4,12,72,1,1,1,1,2,2,0,2,0,1,0,0,2,29,24,1
26398,433,9667,1454,835,1044,76,110,219,1530,17,275,158,296,292,454,2297,3718,9,34017,1889,1,2,29,24,1
26399,121,5214,139,89,101,2,0,35,141,7,54,34,62,61,96,330,569,4,2287,127,0,2,28,0,1
26400,121,5214,7,5,5,0,0,2,7,1,2,1,2,3,3,2,4,0,2,0,0,2,28,0,1
26401,57,3230,1782,648,1425,9,47,279,1791,8,171,97,189,179,286,1292,2140,4,9462,525,0,2,2,0,1
26402,432,9610,72,33,56,0,4,12,72,1,1,1,1,2,2,0,2,0,1,0,0,2,7,14,0
26403,432,9610,1454,835,1044,76,110,219,1530,17,275,158,296,292,454,2297,3718,9,34017,1889,1,2,7,14,0
26404,61,2678,1943,715,1694,26,18,214,1969,12,185,120,237,197,357,1436,2721,7,20915,1161,0,2,1,1,0
26405,163,3249,1943,715,1694,26,18,214,1969,12,185,120,237,197,357,1436,2721,7,20915,1161,0,2,8,0,0
26406,163,3249,1168,838,957,57,25,144,1225,19,348,224,416,367,640,3018,5452,11,61921,3440,1,2,8,0,0
26407,61,2678,1943,715,1694,26,18,214,1969,12,185,120,237,197,357,1436,2721,7,20915,1161,0,2,13,0,0
26408,163,3249,1943,715,1694,26,18,214,1969,12,185,120,237,197,357,1436,2721,7,20915,1161,0,2,1,1,1
26409,163,3249,1168,838,957,57,25,144,1225,19,348,224,416,367,640,3018,5452,11,61921,3440,1,2,1,1,1
26410,61,2676,1943,715,1694,26,18,214,1969,12,185,120,237,197,357,1436,2721,7,20915,1161,0,2,2,2,0
26412,431,9600,72,33,56,0,4,12,72,1,1,1,1,2,2,0,2,0,1,0,0,2,2,3,1
26413,431,9600,1454,835,1044,76,110,219,1530,17,275,158,296,292,454,2297,3718,9,34017,1889,1,2,2,3,1
26414,24,595,465,148,393,5,8,60,470,4,31,20,31,35,51,161,261,2,523,29,0,2,0,13,1
26415,24,595,16,12,9,0,0,6,16,1,2,1,2,3,3,2,4,0,2,0,0,2,0,13,1
26417,3,42,14,8,8,0,0,6,14,0,0,0,0,0,0,0,0,0,0,0,0,0,12,0,0
26418,437,9678,72,33,56,0,4,12,72,1,1,1,1,2,2,0,2,0,1,0,0,2,61,46,1
26419,437,9678,1454,835,1044,76,110,219,1530,17,275,158,296,292,454,2297,3718,9,34017,1889,1,2,61,46,1
26420,229,4665,1457,730,1242,11,6,188,1468,10,292,166,329,302,495,2424,4078,5,22973,1276,1,2,1,2,1
26421,229,4665,74,35,59,1,0,14,75,3,14,7,14,17,21,58,85,1,128,7,0,2,1,2,1
26422,229,4665,245,125,200,5,7,34,250,7,30,17,34,37,51,166,265,3,1053,58,0,2,1,2,1
26423,437,9677,72,33,56,0,4,12,72,1,1,1,1,2,2,0,2,0,1,0,0,2,5,5,1
26424,437,9677,1454,835,1044,76,110,219,1530,17,275,158,296,292,454,2297,3718,9,34017,1889,1,2,5,5,1
26425,439,9699,72,33,56,0,4,12,72,1,1,1,1,2,2,0,2,0,1,0,0,2,3,2,1
26426,439,9699,1454,835,1044,76,110,219,1530,17,275,158,296,292,454,2297,3718,9,34017,1889,1,2,3,2,1
26427,122,5273,139,89,101,2,0,35,141,7,54,34,62,61,96,330,569,4,2287,127,0,2,28,0,1
26428,122,5273,7,5,5,0,0,2,7,1,2,1,2,3,3,2,4,0,2,0,0,2,28,0,1
26429,439,9701,72,33,56,0,4,12,72,1,1,1,1,2,2,0,2,0,1,0,0,2,6,4,1
26430,439,9701,1454,835,1044,76,110,219,1530,17,275,158,296,292,454,2297,3718,9,34017,1889,1,2,6,4,1
26431,439,9685,72,33,56,0,4,12,72,1,1,1,1,2,2,0,2,0,1,0,0,2,0,2,1
26432,439,9685,1454,835,1044,76,110,219,1530,17,275,158,296,292,454,2297,3718,9,34017,1889,1,2,0,2,1
26433,63,2929,1338,495,1086,10,64,173,1348,11,122,82,157,133,239,883,1686,7,11934,663,0,2,18,0,1
26434,439,9685,72,33,56,0,4,12,72,1,1,1,1,2,2,0,2,0,1,0,0,2,0,2,0
26435,439,9685,1454,835,1044,76,110,219,1530,17,275,158,296,292,454,2297,3718,9,34017,1889,1,2,0,2,0
26436,63,2929,1338,495,1086,10,64,173,1348,11,122,82,157,133,239,883,1686,7,11934,663,0,2,18,0,0
26483,131,4059,1660,832,1314,41,38,274,1701,20,312,209,395,332,604,2671,5058,12,64042,3557,1,2,1,1,1
26484,131,4059,1057,646,719,113,100,145,1170,18,215,134,248,233,382,1740,3004,10,31186,1732,1,2,1,1,1
26485,75,1656,477,336,357,30,23,73,507,16,194,134,250,210,384,1538,2962,10,30538,1696,0,2,66,36,1
26486,13,442,42,7,35,4,0,5,46,1,2,1,2,3,3,2,4,0,2,0,0,2,2,2,1
26487,13,442,11,6,10,0,0,1,11,2,4,2,4,6,6,10,15,1,15,0,0,2,2,2,1
26514,51,1803,1450,624,1228,12,26,181,1462,14,306,186,354,320,540,2580,4493,8,36391,2021,1,2,13,0,1
26515,61,2674,1943,715,1694,26,18,214,1969,12,185,120,237,197,357,1436,2721,7,20915,1161,0,2,0,1,0
26518,1,225,382,65,130,157,2,92,539,4,10,5,10,14,15,41,57,2,114,6,0,2,2,2,0
26520,1,245,382,65,130,157,2,92,539,4,10,5,10,14,15,41,57,2,114,6,0,2,4,1,0
26521,1,270,382,65,130,157,2,92,539,4,10,5,10,14,15,41,57,2,114,6,0,2,14,0,0
26522,1,272,382,65,130,157,2,92,539,4,10,5,10,14,15,41,57,2,114,6,0,2,1,0,0
26523,1,274,382,65,130,157,2,92,539,4,10,5,10,14,15,41,57,2,114,6,0,2,1,0,0
26524,1,276,382,65,130,157,2,92,539,4,10,5,10,14,15,41,57,2,114,6,0,2,2,1,1
26525,1,279,382,65,130,157,2,92,539,4,10,5,10,14,15,41,57,2,114,6,0,2,3,1,0
26526,42,1312,1523,757,1297,19,12,193,1542,12,193,117,230,205,347,1508,2664,7,19053,1058,0,2,7,7,1
26527,42,1312,701,378,504,33,58,109,734,13,110,68,126,123,194,794,1346,7,10027,557,0,2,7,7,1
26528,39,2399,1523,757,1297,19,12,193,1542,12,193,117,230,205,347,1508,2664,7,19053,1058,0,2,13,1,1
26529,439,9687,72,33,56,0,4,12,72,1,1,1,1,2,2,0,2,0,1,0,0,2,1,0,1
26530,439,9687,1454,835,1044,76,110,219,1530,17,275,158,296,292,454,2297,3718,9,34017,1889,1,2,1,0,1
26531,39,2393,1523,757,1297,19,12,193,1542,12,193,117,230,205,347,1508,2664,7,19053,1058,0,2,1,1,0
26532,435,9731,72,33,56,0,4,12,72,1,1,1,1,2,2,0,2,0,1,0,0,2,17,8,1
26533,435,9731,1454,835,1044,76,110,219,1530,17,275,158,296,292,454,2297,3718,9,34017,1889,1,2,17,8,1
26534,124,5341,139,89,101,2,0,35,141,7,54,34,62,61,96,330,569,4,2287,127,0,2,34,0,1
26535,124,5341,7,5,5,0,0,2,7,1,2,1,2,3,3,2,4,0,2,0,0,2,34,0,1
26536,42,1312,1523,757,1297,19,12,193,1542,12,193,117,230,205,347,1508,2664,7,19053,1058,0,2,7,7,0
26537,42,1312,701,378,504,33,58,109,734,13,110,68,126,123,194,794,1346,7,10027,557,0,2,7,7,0
26538,435,9733,72,33,56,0,4,12,72,1,1,1,1,2,2,0,2,0,1,0,0,2,17,8,0
26539,435,9733,1454,835,1044,76,110,219,1530,17,275,158,296,292,454,2297,3718,9,34017,1889,1,2,17,8,0
26540,124,5341,139,89,101,2,0,35,141,7,54,34,62,61,96,330,569,4,2287,127,0,2,34,0,0
26541,124,5341,7,5,5,0,0,2,7,1,2,1,2,3,3,2,4,0,2,0,0,2,34,0,0
26542,39,2393,1523,757,1297,19,12,193,1542,12,193,117,230,205,347,1508,2664,7,19053,1058,0,2,13,1,0
26543,435,9731,72,33,56,0,4,12,72,1,1,1,1,2,2,0,2,0,1,0,0,2,0,1,0
26544,435,9731,1454,835,1044,76,110,219,1530,17,275,158,296,292,454,2297,3718,9,34017,1889,1,2,0,1,0
26545,435,9729,72,33,56,0,4,12,72,1,1,1,1,2,2,0,2,0,1,0,0,2,2,1,1
26546,435,9729,1454,835,1044,76,110,219,1530,17,275,158,296,292,454,2297,3718,9,34017,1889,1,2,2,1,1
26547,58,3261,1782,648,1425,9,47,279,1791,8,171,97,189,179,286,1292,2140,4,9462,525,0,2,16,0,1
26548,39,2401,1523,757,1297,19,12,193,1542,12,193,117,230,205,347,1508,2664,7,19053,1058,0,2,1,1,0
26549,435,9729,72,33,56,0,4,12,72,1,1,1,1,2,2,0,2,0,1,0,0,2,2,2,1
26550,435,9729,1454,835,1044,76,110,219,1530,17,275,158,296,292,454,2297,3718,9,34017,1889,1,2,2,2,1
26551,58,3259,1782,648,1425,9,47,279,1791,8,171,97,189,179,286,1292,2140,4,9462,525,0,2,1,1,0
26575,229,4665,1457,730,1242,11,6,188,1468,10,292,166,329,302,495,2424,4078,5,22973,1276,1,2,2,2,1
26576,229,4665,74,35,59,1,0,14,75,3,14,7,14,17,21,58,85,1,128,7,0,2,2,2,1
26577,229,4665,245,125,200,5,7,34,250,7,30,17,34,37,51,166,265,3,1053,58,0,2,2,2,1
26581,1,279,382,65,130,157,2,92,539,4,10,5,10,14,15,41,57,2,114,6,0,2,24,2,0
26582,1,279,382,65,130,157,2,92,539,4,10,5,10,14,15,41,57,2,114,6,0,2,2,2,0
26583,1,279,382,65,130,157,2,92,539,4,10,5,10,14,15,41,57,2,114,6,0,2,3,3,0
26607,75,1645,477,336,357,30,23,73,507,16,194,134,250,210,384,1538,2962,10,30538,1696,0,2,2,6,1
26610,66,1213,1020,354,843,12,15,144,1032,8,134,77,144,142,221,970,1580,4,6792,377,0,2,1,1,1
26611,51,2245,1020,354,843,12,15,144,1032,8,134,77,144,142,221,970,1580,4,6792,377,0,2,4,0,1
26612,66,1213,1020,354,843,12,15,144,1032,8,134,77,144,142,221,970,1580,4,6792,377,0,2,1,1,0
26613,51,2245,1020,354,843,12,15,144,1032,8,134,77,144,142,221,970,1580,4,6792,377,0,2,4,0,0
26614,62,2549,1289,550,1043,56,32,155,1345,10,167,93,185,177,278,1266,2075,5,11498,638,0,2,2,2,0
26615,131,4059,1660,832,1314,41,38,274,1701,20,312,209,395,332,604,2671,5058,12,64042,3557,1,2,3,3,1
26616,131,4059,1057,646,719,113,100,145,1170,18,215,134,248,233,382,1740,3004,10,31186,1732,1,2,3,3,1
26617,229,4665,1457,730,1242,11,6,188,1468,10,292,166,329,302,495,2424,4078,5,22973,1276,1,2,6,5,1
26618,229,4665,74,35,59,1,0,14,75,3,14,7,14,17,21,58,85,1,128,7,0,2,6,5,1
26619,229,4665,245,125,200,5,7,34,250,7,30,17,34,37,51,166,265,3,1053,58,0,2,6,5,1
26620,42,1119,74,35,59,1,0,14,75,3,14,7,14,17,21,58,85,1,128,7,0,2,1,1,1
26621,42,1119,245,125,200,5,7,34,250,7,30,17,34,37,51,166,265,3,1053,58,0,2,1,1,1
26622,44,432,647,139,84,35,284,233,682,0,0,0,0,0,0,0,0,0,0,0,0,2,2,2,1
26623,165,3720,77,34,69,0,0,8,77,3,24,16,29,27,45,114,213,1,387,21,0,2,1,1,1
26624,165,3720,712,438,573,51,9,84,763,14,102,71,128,116,199,733,1364,8,11988,666,0,2,1,1,1
26625,66,1213,1020,354,843,12,15,144,1032,8,134,77,144,142,221,970,1580,4,6792,377,0,2,4,4,1
26626,23,407,424,94,331,4,0,89,428,1,5,5,5,6,10,11,25,0,12,0,0,2,1,1,1
26627,23,407,38,23,23,6,0,8,44,3,11,7,11,14,18,42,68,1,102,5,0,2,1,1,1
26628,195,4406,722,423,573,19,0,135,741,12,172,101,199,184,300,1320,2257,6,15668,870,0,2,7,7,1
26629,195,4406,1508,847,911,44,250,301,1552,14,148,88,169,162,257,1120,1886,7,15077,837,0,2,7,7,1
26630,435,9729,72,33,56,0,4,12,72,1,1,1,1,2,2,0,2,0,1,0,0,2,3,3,1
26631,435,9729,1454,835,1044,76,110,219,1530,17,275,158,296,292,454,2297,3718,9,34017,1889,1,2,3,3,1
26632,111,2393,1043,504,840,53,9,147,1096,9,180,112,198,189,310,1377,2344,4,11604,644,0,2,6,4,1
26633,111,2393,383,288,292,26,6,62,409,11,65,38,67,76,105,429,656,5,3719,206,0,2,6,4,1
26634,86,1513,1178,367,1042,6,15,115,1184,9,94,51,95,103,146,644,976,4,4439,246,0,2,6,6,1
26635,86,1513,177,108,140,8,0,27,185,6,30,16,32,36,48,162,248,3,794,44,0,2,6,6,1
26636,163,3247,1943,715,1694,26,18,214,1969,12,185,120,237,197,357,1436,2721,7,20915,1161,0,2,1,1,1
26637,163,3247,1168,838,957,57,25,144,1225,19,348,224,416,367,640,3018,5452,11,61921,3440,1,2,1,1,1
26639,56,983,282,196,195,3,0,86,285,8,130,71,141,138,212,936,1507,4,6538,363,0,2,1,1,1
26640,7,296,72,33,56,0,4,12,72,1,1,1,1,2,2,0,2,0,1,0,0,2,3,2,1
26643,39,1920,1457,730,1242,11,6,188,1468,10,292,166,329,302,495,2424,4078,5,22973,1276,1,2,2,2,1
26645,16,498,424,94,331,4,0,89,428,1,5,5,5,6,10,11,25,0,12,0,0,2,2,2,1
26646,14,567,722,423,573,19,0,135,741,12,172,101,199,184,300,1320,2257,6,15668,870,0,2,1,1,1
26647,12,404,386,256,301,16,9,68,402,4,59,35,69,63,104,355,621,2,1453,80,0,2,7,7,1
26648,50,2058,1043,504,840,53,9,147,1096,9,180,112,198,189,310,1377,2344,4,11604,644,0,2,18,18,1
26649,24,968,373,158,315,8,0,51,381,5,76,44,79,81,123,486,779,2,2026,112,0,2,2,2,1
26650,7,514,442,244,305,14,16,103,456,11,68,45,75,79,120,452,756,6,4588,254,0,2,3,3,1
26651,195,4406,722,423,573,19,0,135,741,12,172,101,199,184,300,1320,2257,6,15668,870,0,2,2,2,0
26652,195,4406,1508,847,911,44,250,301,1552,14,148,88,169,162,257,1120,1886,7,15077,837,0,2,2,2,0
26653,435,9729,72,33,56,0,4,12,72,1,1,1,1,2,2,0,2,0,1,0,0,2,1,1,0
26654,435,9729,1454,835,1044,76,110,219,1530,17,275,158,296,292,454,2297,3718,9,34017,1889,1,2,1,1,0
26655,39,1920,1457,730,1242,11,6,188,1468,10,292,166,329,302,495,2424,4078,5,22973,1276,1,2,1,1,0
26656,42,1121,74,35,59,1,0,14,75,3,14,7,14,17,21,58,85,1,128,7,0,2,3,1,1
26657,42,1121,245,125,200,5,7,34,250,7,30,17,34,37,51,166,265,3,1053,58,0,2,3,1,1
26658,67,1216,1020,354,843,12,15,144,1032,8,134,77,144,142,221,970,1580,4,6792,377,0,2,19,1,0
26659,54,2310,1020,354,843,12,15,144,1032,8,134,77,144,142,221,970,1580,4,6792,377,0,2,11,0,0
26660,42,1121,74,35,59,1,0,14,75,3,14,7,14,17,21,58,85,1,128,7,0,2,3,1,0
26661,42,1121,245,125,200,5,7,34,250,7,30,17,34,37,51,166,265,3,1053,58,0,2,3,1,0
26662,42,1128,74,35,59,1,0,14,75,3,14,7,14,17,21,58,85,1,128,7,0,2,2,0,1
26663,42,1128,245,125,200,5,7,34,250,7,30,17,34,37,51,166,265,3,1053,58,0,2,2,0,1
26664,229,4667,1457,730,1242,11,6,188,1468,10,292,166,329,302,495,2424,4078,5,22973,1276,1,2,3,2,0
26665,229,4667,74,35,59,1,0,14,75,3,14,7,14,17,21,58,85,1,128,7,0,2,3,2,0
26666,229,4667,245,125,200,5,7,34,250,7,30,17,34,37,51,166,265,3,1053,58,0,2,3,2,0
26667,163,3251,1943,715,1694,26,18,214,1969,12,185,120,237,197,357,1436,2721,7,20915,1161,0,2,1,1,1
26668,163,3251,1168,838,957,57,25,144,1225,19,348,224,416,367,640,3018,5452,11,61921,3440,1,2,1,1,1
26669,61,2682,1943,715,1694,26,18,214,1969,12,185,120,237,197,357,1436,2721,7,20915,1161,0,2,3,2,1
26670,229,4665,1457,730,1242,11,6,188,1468,10,292,166,329,302,495,2424,4078,5,22973,1276,1,2,0,1,0
26671,229,4665,74,35,59,1,0,14,75,3,14,7,14,17,21,58,85,1,128,7,0,2,0,1,0
26672,229,4665,245,125,200,5,7,34,250,7,30,17,34,37,51,166,265,3,1053,58,0,2,0,1,0
26673,55,2354,1020,354,843,12,15,144,1032,8,134,77,144,142,221,970,1580,4,6792,377,0,2,22,0,0
26674,116,2937,1660,832,1314,41,38,274,1701,20,312,209,395,332,604,2671,5058,12,64042,3557,1,2,7,0,1
26675,116,2937,1660,832,1314,41,38,274,1701,20,312,209,395,332,604,2671,5058,12,64042,3557,1,2,7,0,0
26678,43,1834,1513,682,1277,25,13,200,1538,11,199,116,219,210,335,1557,2584,6,15641,868,0,2,23,0,0
26679,171,3239,1513,682,1277,25,13,200,1538,11,199,116,219,210,335,1557,2584,6,15641,868,0,2,383,5,0
26680,171,3239,819,519,539,24,98,155,843,15,96,57,106,111,163,690,1107,8,9171,509,0,2,383,5,0
26681,118,4709,1513,682,1277,25,13,200,1538,11,199,116,219,210,335,1557,2584,6,15641,868,0,2,507,2,0
26682,118,4607,1513,682,1277,25,13,200,1538,11,199,116,219,210,335,1557,2584,6,15641,868,0,2,100,68,0
26683,170,3212,1513,682,1277,25,13,200,1538,11,199,116,219,210,335,1557,2584,6,15641,868,0,2,59,30,0
26684,170,3212,819,519,539,24,98,155,843,15,96,57,106,111,163,690,1107,8,9171,509,0,2,59,30,0
26685,169,3198,1513,682,1277,25,13,200,1538,11,199,116,219,210,335,1557,2584,6,15641,868,0,2,8,9,0
26686,169,3198,819,519,539,24,98,155,843,15,96,57,106,111,163,690,1107,8,9171,509,0,2,8,9,0
26687,169,3198,1513,682,1277,25,13,200,1538,11,199,116,219,210,335,1557,2584,6,15641,868,0,2,29,29,0
26688,169,3198,819,519,539,24,98,155,843,15,96,57,106,111,163,690,1107,8,9171,509,0,2,29,29,0
26689,168,3181,1513,682,1277,25,13,200,1538,11,199,116,219,210,335,1557,2584,6,15641,868,0,2,0,4,0
26690,168,3181,819,519,539,24,98,155,843,15,96,57,106,111,163,690,1107,8,9171,509,0,2,0,4,0
26691,168,3179,1513,682,1277,25,13,200,1538,11,199,116,219,210,335,1557,2584,6,15641,868,0,2,1,1,0
26692,168,3179,819,519,539,24,98,155,843,15,96,57,106,111,163,690,1107,8,9171,509,0,2,1,1,0
26693,168,3156,1513,682,1277,25,13,200,1538,11,199,116,219,210,335,1557,2584,6,15641,868,0,2,1,10,0
26694,168,3156,819,519,539,24,98,155,843,15,96,57,106,111,163,690,1107,8,9171,509,0,2,1,10,0
26695,118,4597,1513,682,1277,25,13,200,1538,11,199,116,219,210,335,1557,2584,6,15641,868,0,2,40,44,0
26696,168,3156,1513,682,1277,25,13,200,1538,11,199,116,219,210,335,1557,2584,6,15641,868,0,2,2,0,0
26697,168,3156,819,519,539,24,98,155,843,15,96,57,106,111,163,690,1107,8,9171,509,0,2,2,0,0
26698,118,4597,1513,682,1277,25,13,200,1538,11,199,116,219,210,335,1557,2584,6,15641,868,0,2,2,0,0
26699,168,3156,1513,682,1277,25,13,200,1538,11,199,116,219,210,335,1557,2584,6,15641,868,0,2,5,5,0
26700,168,3156,819,519,539,24,98,155,843,15,96,57,106,111,163,690,1107,8,9171,509,0,2,5,5,0
26701,73,1336,1513,682,1277,25,13,200,1538,11,199,116,219,210,335,1557,2584,6,15641,868,0,2,24,419,0
26702,73,1336,819,519,539,24,98,155,843,15,96,57,106,111,163,690,1107,8,9171,509,0,2,24,419,0
26703,43,1834,1513,682,1277,25,13,200,1538,11,199,116,219,210,335,1557,2584,6,15641,868,0,2,10,545,0
26704,43,1824,1513,682,1277,25,13,200,1538,11,199,116,219,210,335,1557,2584,6,15641,868,0,2,2,2,0
26705,435,9729,72,33,56,0,4,12,72,1,1,1,1,2,2,0,2,0,1,0,0,2,6,0,0
26706,435,9729,1454,835,1044,76,110,219,1530,17,275,158,296,292,454,2297,3718,9,34017,1889,1,2,6,0,0
26707,435,9729,72,33,56,0,4,12,72,1,1,1,1,2,2,0,2,0,1,0,0,2,16,6,0
26708,435,9729,1454,835,1044,76,110,219,1530,17,275,158,296,292,454,2297,3718,9,34017,1889,1,2,16,6,0
26709,435,9729,72,33,56,0,4,12,72,1,1,1,1,2,2,0,2,0,1,0,0,2,16,0,0
26710,435,9729,1454,835,1044,76,110,219,1530,17,275,158,296,292,454,2297,3718,9,34017,1889,1,2,16,0,0
26711,435,9729,72,33,56,0,4,12,72,1,1,1,1,2,2,0,2,0,1,0,0,2,16,0,1
26712,435,9729,1454,835,1044,76,110,219,1530,17,275,158,296,292,454,2297,3718,9,34017,1889,1,2,16,0,1
26713,168,3156,1513,682,1277,25,13,200,1538,11,199,116,219,210,335,1557,2584,6,15641,868,0,2,420,25,1
26714,168,3156,819,519,539,24,98,155,843,15,96,57,106,111,163,690,1107,8,9171,509,0,2,420,25,1
26715,121,4624,1513,682,1277,25,13,200,1538,11,199,116,219,210,335,1557,2584,6,15641,868,0,2,554,10,1
26744,30,640,2,2,2,0,0,0,2,0,0,0,0,0,0,0,0,0,0,0,0,2,13,11,0
26758,30,640,99,48,90,1,3,5,100,0,0,0,0,0,0,0,0,0,0,0,0,2,13,11,0
26759,30,640,8,5,5,2,0,1,10,0,0,0,0,0,0,0,0,0,0,0,0,2,13,11,0
26760,30,640,1217,716,841,84,126,174,1301,14,185,118,215,199,333,1446,2542,8,20687,1149,0,2,13,11,0
26761,30,640,160,89,115,0,13,31,160,7,15,11,17,22,28,78,124,3,495,27,0,2,13,11,0
26762,30,640,10,10,9,9,0,0,19,0,0,0,0,0,0,0,0,0,0,0,0,2,13,11,0
26763,30,640,173,84,99,8,29,36,181,5,12,7,13,17,20,54,81,2,221,12,0,2,13,11,0
26764,30,640,3,1,1,3,0,0,6,0,0,0,0,0,0,0,0,0,0,0,0,2,13,11,0
26765,131,4059,1660,832,1314,41,38,274,1701,20,312,209,395,332,604,2671,5058,12,64042,3557,1,2,35,11,0
26766,131,4059,1057,646,719,113,100,145,1170,18,215,134,248,233,382,1740,3004,10,31186,1732,1,2,35,11,0
26767,75,1645,477,336,357,30,23,73,507,16,194,134,250,210,384,1538,2962,10,30538,1696,0,2,68,42,0
26768,168,3156,1513,682,1277,25,13,200,1538,11,199,116,219,210,335,1557,2584,6,15641,868,0,2,451,32,0
26769,168,3156,819,519,539,24,98,155,843,15,96,57,106,111,163,690,1107,8,9171,509,0,2,451,32,0
26770,229,4665,1457,730,1242,11,6,188,1468,10,292,166,329,302,495,2424,4078,5,22973,1276,1,2,196,75,0
26771,229,4665,74,35,59,1,0,14,75,3,14,7,14,17,21,58,85,1,128,7,0,2,196,75,0
26772,229,4665,245,125,200,5,7,34,250,7,30,17,34,37,51,166,265,3,1053,58,0,2,196,75,0
26773,26,887,1455,414,1257,16,76,112,1471,5,41,23,46,46,69,231,381,2,1069,59,0,2,6,1,0
26774,26,887,669,365,481,22,61,110,691,15,103,63,122,118,185,747,1273,8,11311,628,0,2,6,1,0
26775,42,1128,74,35,59,1,0,14,75,3,14,7,14,17,21,58,85,1,128,7,0,2,8,5,0
26776,42,1128,245,125,200,5,7,34,250,7,30,17,34,37,51,166,265,3,1053,58,0,2,8,5,0
26777,44,432,647,139,84,35,284,233,682,0,0,0,0,0,0,0,0,0,0,0,0,2,9,8,0
26778,42,1312,1523,757,1297,19,12,193,1542,12,193,117,230,205,347,1508,2664,7,19053,1058,0,2,12,13,0
26779,42,1312,701,378,504,33,58,109,734,13,110,68,126,123,194,794,1346,7,10027,557,0,2,12,13,0
26780,166,3723,77,34,69,0,0,8,77,3,24,16,29,27,45,114,213,1,387,21,0,2,51,36,0
26781,166,3723,712,438,573,51,9,84,763,14,102,71,128,116,199,733,1364,8,11988,666,0,2,51,36,0
26782,67,1216,1020,354,843,12,15,144,1032,8,134,77,144,142,221,970,1580,4,6792,377,0,2,58,27,0
26783,42,852,447,308,343,6,5,95,453,7,96,59,111,103,170,651,1136,4,4600,255,0,2,89,58,0
26784,42,852,322,174,179,16,74,51,338,10,41,26,46,51,72,252,408,5,2291,127,0,2,89,58,0
26785,23,407,424,94,331,4,0,89,428,1,5,5,5,6,10,11,25,0,12,0,0,2,1,2,0
26786,23,407,38,23,23,6,0,8,44,3,11,7,11,14,18,42,68,1,102,5,0,2,1,2,0
26787,195,4406,722,423,573,19,0,135,741,12,172,101,199,184,300,1320,2257,6,15668,870,0,2,34,42,0
26788,195,4406,1508,847,911,44,250,301,1552,14,148,88,169,162,257,1120,1886,7,15077,837,0,2,34,42,0
26789,435,9729,72,33,56,0,4,12,72,1,1,1,1,2,2,0,2,0,1,0,0,2,441,336,0
26790,435,9729,1454,835,1044,76,110,219,1530,17,275,158,296,292,454,2297,3718,9,34017,1889,1,2,441,336,0
26791,18,460,386,256,301,16,9,68,402,4,59,35,69,63,104,355,621,2,1453,80,0,2,2,2,0
26792,18,460,264,131,164,11,41,46,275,6,38,22,40,44,62,214,338,3,1068,59,0,2,2,2,0
26795,111,2393,1043,504,840,53,9,147,1096,9,180,112,198,189,310,1377,2344,4,11604,644,0,2,27,17,0
26796,111,2393,383,288,292,26,6,62,409,11,65,38,67,76,105,429,656,5,3719,206,0,2,27,17,0
26797,86,1513,1178,367,1042,6,15,115,1184,9,94,51,95,103,146,644,976,4,4439,246,0,2,14,7,0
26798,86,1513,177,108,140,8,0,27,185,6,30,16,32,36,48,162,248,3,794,44,0,2,14,7,0
26799,163,3251,1943,715,1694,26,18,214,1969,12,185,120,237,197,357,1436,2721,7,20915,1161,0,2,24,18,0
26800,163,3251,1168,838,957,57,25,144,1225,19,348,224,416,367,640,3018,5452,11,61921,3440,1,2,24,18,0
26803,54,1029,1098,241,925,5,10,155,1103,7,46,25,49,53,74,273,423,3,1580,87,0,2,5,8,0
26804,54,1029,282,202,222,14,2,44,296,8,42,24,43,50,67,250,378,4,1548,86,0,2,5,8,0
26810,1,279,382,65,130,157,2,92,539,4,10,5,10,14,15,41,57,2,114,6,0,2,29,6,0
26811,56,983,282,196,195,3,0,86,285,8,130,71,141,138,212,936,1507,4,6538,363,0,2,1,1,0
26812,7,296,72,33,56,0,4,12,72,1,1,1,1,2,2,0,2,0,1,0,0,2,3,2,0
26813,11,370,85,59,61,8,0,16,93,5,18,10,18,23,28,86,126,2,316,17,0,0,74,0,0
26814,13,442,42,7,35,4,0,5,46,1,2,1,2,3,3,2,4,0,2,0,0,2,20,16,0
26815,13,442,11,6,10,0,0,1,11,2,4,2,4,6,6,10,15,1,15,0,0,2,20,16,0
26816,63,2592,1289,550,1043,56,32,155,1345,10,167,93,185,177,278,1266,2075,5,11498,638,0,2,36,23,0
26817,28,546,127,75,83,2,11,30,129,4,14,7,14,18,21,61,87,2,175,9,0,2,6,23,0
26818,28,546,652,304,544,16,6,88,668,6,89,51,101,95,152,591,998,3,3399,188,0,2,6,23,0
26819,28,546,2,2,2,0,0,0,2,0,0,0,0,0,0,0,0,0,0,0,0,2,6,23,0
26820,28,546,8,5,5,0,0,3,8,0,0,0,0,0,0,0,0,0,0,0,0,2,6,23,0
26823,28,546,14,8,8,0,0,6,14,0,0,0,0,0,0,0,0,0,0,0,0,2,6,23,0
26824,28,546,6,4,4,0,0,2,6,0,0,0,0,0,0,0,0,0,0,0,0,2,6,23,0
26825,28,546,6,4,4,0,0,2,6,1,2,1,2,3,3,2,4,0,2,0,0,2,6,23,0
26827,28,546,7,5,5,0,0,2,7,0,0,0,0,0,0,0,0,0,0,0,0,2,6,23,0
26829,28,546,10,6,6,0,0,4,10,0,0,0,0,0,0,0,0,0,0,0,0,2,6,23,0
26830,28,546,1,1,1,0,0,0,1,0,0,0,0,0,0,0,0,0,0,0,0,2,6,23,0
26832,28,546,14,10,10,0,0,4,14,1,1,1,1,2,2,0,2,0,1,0,0,2,6,23,0
26833,28,546,46,26,30,3,0,12,49,3,6,3,6,9,9,20,28,1,42,2,0,2,6,23,0
26834,63,2929,1338,495,1086,10,64,173,1348,11,122,82,157,133,239,883,1686,7,11934,663,0,2,79,21,0
26835,124,5341,139,89,101,2,0,35,141,7,54,34,62,61,96,330,569,4,2287,127,0,2,266,46,0
26836,124,5341,7,5,5,0,0,2,7,1,2,1,2,3,3,2,4,0,2,0,0,2,266,46,0
26837,24,595,465,148,393,5,8,60,470,4,31,20,31,35,51,161,261,2,523,29,0,2,46,1,0
26838,24,595,16,12,9,0,0,6,16,1,2,1,2,3,3,2,4,0,2,0,0,2,46,1,0
26839,58,3259,1782,648,1425,9,47,279,1791,8,171,97,189,179,286,1292,2140,4,9462,525,0,2,22,5,0
26840,9,192,256,139,192,9,7,47,265,4,23,12,24,27,36,112,171,2,357,19,0,2,1,1,0
26842,51,1803,1450,624,1228,12,26,181,1462,14,306,186,354,320,540,2580,4493,8,36391,2021,1,2,25,2,0
26843,116,2937,1660,832,1314,41,38,274,1701,20,312,209,395,332,604,2671,5058,12,64042,3557,1,2,73,10,0
26844,121,4624,1513,682,1277,25,13,200,1538,11,199,116,219,210,335,1557,2584,6,15641,868,0,2,588,12,0
26845,45,2786,1296,573,1062,40,33,157,1336,8,201,118,231,209,349,1561,2689,4,12365,686,0,2,30,9,0
26846,39,1920,1457,730,1242,11,6,188,1468,10,292,166,329,302,495,2424,4078,5,22973,1276,1,2,51,10,0
26847,30,1496,652,304,544,16,6,88,668,6,89,51,101,95,152,591,998,3,3399,188,0,2,42,5,0
26848,23,997,1455,414,1257,16,76,112,1471,5,41,23,46,46,69,231,381,2,1069,59,0,2,23,3,0
26849,11,343,74,35,59,1,0,14,75,3,14,7,14,17,21,58,85,1,128,7,0,2,2,2,0
26850,39,2401,1523,757,1297,19,12,193,1542,12,193,117,230,205,347,1508,2664,7,19053,1058,0,2,44,10,0
26851,55,2354,1020,354,843,12,15,144,1032,8,134,77,144,142,221,970,1580,4,6792,377,0,2,103,9,0
26852,33,1481,447,308,343,6,5,95,453,7,96,59,111,103,170,651,1136,4,4600,255,0,2,20,6,0
26853,16,498,424,94,331,4,0,89,428,1,5,5,5,6,10,11,25,0,12,0,0,2,3,3,0
26854,38,2232,334,251,279,10,4,40,344,5,127,74,143,132,217,899,1528,2,4303,239,0,2,25,16,0
26855,7,291,184,100,137,2,15,30,186,6,38,20,39,44,59,214,322,3,991,55,0,2,1,2,0
26856,27,1034,1293,570,1093,25,15,163,1318,10,195,123,241,205,364,1516,2795,6,17273,959,0,2,9,7,0
26857,14,567,722,423,573,19,0,135,741,12,172,101,199,184,300,1320,2257,6,15668,870,0,2,4,5,0
26858,12,404,386,256,301,16,9,68,402,4,59,35,69,63,104,355,621,2,1453,80,0,2,7,7,0
26860,50,2058,1043,504,840,53,9,147,1096,9,180,112,198,189,310,1377,2344,4,11604,644,0,2,57,25,0
26861,24,968,373,158,315,8,0,51,381,5,76,44,79,81,123,486,779,2,2026,112,0,2,6,5,0
26862,43,1898,1178,367,1042,6,15,115,1184,9,94,51,95,103,146,644,976,4,4439,246,0,2,14,16,0
26863,61,2682,1943,715,1694,26,18,214,1969,12,185,120,237,197,357,1436,2721,7,20915,1161,0,2,50,28,0
26864,7,514,442,244,305,14,16,103,456,11,68,45,75,79,120,452,756,6,4588,254,0,2,13,5,0
26865,36,1381,1098,241,925,5,10,155,1103,7,46,25,49,53,74,273,423,3,1580,87,0,2,54,7,0
26866,166,3723,77,34,69,0,0,8,77,3,24,16,29,27,45,114,213,1,387,21,0,2,8,5,0
26867,166,3723,712,438,573,51,9,84,763,14,102,71,128,116,199,733,1364,8,11988,666,0,2,8,5,0
26868,63,2592,1289,550,1043,56,32,155,1345,10,167,93,185,177,278,1266,2075,5,11498,638,0,2,8,0,0
26869,166,3098,1513,682,1277,25,13,200,1538,11,199,116,219,210,335,1557,2584,6,15641,868,0,2,8,16,1
26870,166,3098,819,519,539,24,98,155,843,15,96,57,106,111,163,690,1107,8,9171,509,0,2,8,16,1
26871,118,4513,1513,682,1277,25,13,200,1538,11,199,116,219,210,335,1557,2584,6,15641,868,0,2,17,34,1
26872,164,3038,1513,682,1277,25,13,200,1538,11,199,116,219,210,335,1557,2584,6,15641,868,0,2,0,16,0
26873,164,3038,819,519,539,24,98,155,843,15,96,57,106,111,163,690,1107,8,9171,509,0,2,0,16,0
26874,113,4338,1513,682,1277,25,13,200,1538,11,199,116,219,210,335,1557,2584,6,15641,868,0,2,0,31,0
26875,161,3000,1513,682,1277,25,13,200,1538,11,199,116,219,210,335,1557,2584,6,15641,868,0,2,4,11,0
26876,161,3000,819,519,539,24,98,155,843,15,96,57,106,111,163,690,1107,8,9171,509,0,2,4,11,0
26877,112,4278,1513,682,1277,25,13,200,1538,11,199,116,219,210,335,1557,2584,6,15641,868,0,2,0,9,0
26878,161,3000,1513,682,1277,25,13,200,1538,11,199,116,219,210,335,1557,2584,6,15641,868,0,2,9,40,0
26879,161,3000,819,519,539,24,98,155,843,15,96,57,106,111,163,690,1107,8,9171,509,0,2,9,40,0
26880,112,4278,1513,682,1277,25,13,200,1538,11,199,116,219,210,335,1557,2584,6,15641,868,0,2,16,73,0
26881,112,2401,1043,504,840,53,9,147,1096,9,180,112,198,189,310,1377,2344,4,11604,644,0,2,3,4,1
26882,112,2401,383,288,292,26,6,62,409,11,65,38,67,76,105,429,656,5,3719,206,0,2,3,4,1
26883,49,1988,1043,504,840,53,9,147,1096,9,180,112,198,189,310,1377,2344,4,11604,644,0,2,0,14,1
26884,434,9721,72,33,56,0,4,12,72,1,1,1,1,2,2,0,2,0,1,0,0,2,9,9,1
26885,434,9721,1454,835,1044,76,110,219,1530,17,275,158,296,292,454,2297,3718,9,34017,1889,1,2,9,9,1
26886,124,5341,139,89,101,2,0,35,141,7,54,34,62,61,96,330,569,4,2287,127,0,2,1,0,1
26887,124,5341,7,5,5,0,0,2,7,1,2,1,2,3,3,2,4,0,2,0,0,2,1,0,1
26890,31,635,2,2,2,0,0,0,2,0,0,0,0,0,0,0,0,0,0,0,0,2,2,2,1
26904,31,635,99,48,90,1,3,5,100,0,0,0,0,0,0,0,0,0,0,0,0,2,2,2,1
26905,31,635,8,5,5,2,0,1,10,0,0,0,0,0,0,0,0,0,0,0,0,2,2,2,1
26906,31,635,1217,716,841,84,126,174,1301,14,185,118,215,199,333,1446,2542,8,20687,1149,0,2,2,2,1
26907,31,635,160,89,115,0,13,31,160,7,15,11,17,22,28,78,124,3,495,27,0,2,2,2,1
26908,31,635,10,10,9,9,0,0,19,0,0,0,0,0,0,0,0,0,0,0,0,2,2,2,1
26909,31,635,173,84,99,8,29,36,181,5,12,7,13,17,20,54,81,2,221,12,0,2,2,2,1
26910,31,635,3,1,1,3,0,0,6,0,0,0,0,0,0,0,0,0,0,0,0,2,2,2,1
26911,77,1715,477,336,357,30,23,73,507,16,194,134,250,210,384,1538,2962,10,30538,1696,0,2,7,1,1
26912,54,1893,1450,624,1228,12,26,181,1462,14,306,186,354,320,540,2580,4493,8,36391,2021,1,2,13,0,1
26913,116,2935,1660,832,1314,41,38,274,1701,20,312,209,395,332,604,2671,5058,12,64042,3557,1,2,1,1,0
26914,16,496,424,94,331,4,0,89,428,1,5,5,5,6,10,11,25,0,12,0,0,2,1,1,0
26915,14,565,722,423,573,19,0,135,741,12,172,101,199,184,300,1320,2257,6,15668,870,0,2,0,1,0
26916,24,966,373,158,315,8,0,51,381,5,76,44,79,81,123,486,779,2,2026,112,0,2,1,1,0
26917,7,512,442,244,305,14,16,103,456,11,68,45,75,79,120,452,756,6,4588,254,0,2,1,1,0
26918,114,4316,1513,682,1277,25,13,200,1538,11,199,116,219,210,335,1557,2584,6,15641,868,0,2,18,13,1
26919,63,2606,1289,550,1043,56,32,155,1345,10,167,93,185,177,278,1266,2075,5,11498,638,0,2,2,1,1
26920,7,528,442,244,305,14,16,103,456,11,68,45,75,79,120,452,756,6,4588,254,0,2,3,1,1
26923,116,2936,1660,832,1314,41,38,274,1701,20,312,209,395,332,604,2671,5058,12,64042,3557,1,2,2,2,1
26947,1,279,382,65,130,157,2,92,539,4,10,5,10,14,15,41,57,2,114,6,0,2,2,2,1
26950,114,4337,1513,682,1277,25,13,200,1538,11,199,116,219,210,335,1557,2584,6,15641,868,0,2,1,0,1
26951,114,4342,1513,682,1277,25,13,200,1538,11,199,116,219,210,335,1557,2584,6,15641,868,0,2,1,1,0
26952,438,9758,72,33,56,0,4,12,72,1,1,1,1,2,2,0,2,0,1,0,0,2,7,1,1
26953,438,9758,1454,835,1044,76,110,219,1530,17,275,158,296,292,454,2297,3718,9,34017,1889,1,2,7,1,1
26954,24,595,465,148,393,5,8,60,470,4,31,20,31,35,51,161,261,2,523,29,0,2,3,0,1
26955,24,595,16,12,9,0,0,6,16,1,2,1,2,3,3,2,4,0,2,0,0,2,3,0,1
26956,230,4698,1457,730,1242,11,6,188,1468,10,292,166,329,302,495,2424,4078,5,22973,1276,1,2,5,0,1
26957,230,4698,74,35,59,1,0,14,75,3,14,7,14,17,21,58,85,1,128,7,0,2,5,0,1
26958,230,4698,245,125,200,5,7,34,250,7,30,17,34,37,51,166,265,3,1053,58,0,2,5,0,1
26959,45,445,647,139,84,35,284,233,682,0,0,0,0,0,0,0,0,0,0,0,0,2,5,0,1
26960,168,3801,77,34,69,0,0,8,77,3,24,16,29,27,45,114,213,1,387,21,0,2,14,0,1
26961,168,3801,712,438,573,51,9,84,763,14,102,71,128,116,199,733,1364,8,11988,666,0,2,14,0,1
26962,169,3417,1943,715,1694,26,18,214,1969,12,185,120,237,197,357,1436,2721,7,20915,1161,0,2,27,1,1
26963,169,3417,1168,838,957,57,25,144,1225,19,348,224,416,367,640,3018,5452,11,61921,3440,1,2,27,1,1
26964,41,2014,1457,730,1242,11,6,188,1468,10,292,166,329,302,495,2424,4078,5,22973,1276,1,2,39,0,1
26965,435,9747,72,33,56,0,4,12,72,1,1,1,1,2,2,0,2,0,1,0,0,2,13,8,1
26966,435,9747,1454,835,1044,76,110,219,1530,17,275,158,296,292,454,2297,3718,9,34017,1889,1,2,13,8,1
26967,169,3417,1943,715,1694,26,18,214,1969,12,185,120,237,197,357,1436,2721,7,20915,1161,0,2,1,1,1
26968,169,3417,1168,838,957,57,25,144,1225,19,348,224,416,367,640,3018,5452,11,61921,3440,1,2,1,1,1
26969,63,2938,1338,495,1086,10,64,173,1348,11,122,82,157,133,239,883,1686,7,11934,663,0,2,18,7,1
26970,228,4658,1457,730,1242,11,6,188,1468,10,292,166,329,302,495,2424,4078,5,22973,1276,1,2,3,10,1
26971,228,4658,74,35,59,1,0,14,75,3,14,7,14,17,21,58,85,1,128,7,0,2,3,10,1
26972,228,4658,245,125,200,5,7,34,250,7,30,17,34,37,51,166,265,3,1053,58,0,2,3,10,1
26973,43,1133,74,35,59,1,0,14,75,3,14,7,14,17,21,58,85,1,128,7,0,2,2,1,1
26974,43,1133,245,125,200,5,7,34,250,7,30,17,34,37,51,166,265,3,1053,58,0,2,2,1,1
26975,166,3376,1943,715,1694,26,18,214,1969,12,185,120,237,197,357,1436,2721,7,20915,1161,0,2,0,6,1
26976,166,3376,1168,838,957,57,25,144,1225,19,348,224,416,367,640,3018,5452,11,61921,3440,1,2,0,6,1
26977,37,2191,334,251,279,10,4,40,344,5,127,74,143,132,217,899,1528,2,4303,239,0,2,0,10,1
27003,160,2985,1513,682,1277,25,13,200,1538,11,199,116,219,210,335,1557,2584,6,15641,868,0,2,1,7,0
27004,160,2985,819,519,539,24,98,155,843,15,96,57,106,111,163,690,1107,8,9171,509,0,2,1,7,0
27005,155,2896,1513,682,1277,25,13,200,1538,11,199,116,219,210,335,1557,2584,6,15641,868,0,2,8,20,1
27006,155,2896,819,519,539,24,98,155,843,15,96,57,106,111,163,690,1107,8,9171,509,0,2,8,20,1
27007,43,1314,1523,757,1297,19,12,193,1542,12,193,117,230,205,347,1508,2664,7,19053,1058,0,2,8,6,1
27008,43,1314,701,378,504,33,58,109,734,13,110,68,126,123,194,794,1346,7,10027,557,0,2,8,6,1
27009,171,3873,77,34,69,0,0,8,77,3,24,16,29,27,45,114,213,1,387,21,0,2,9,0,1
27010,171,3873,712,438,573,51,9,84,763,14,102,71,128,116,199,733,1364,8,11988,666,0,2,9,0,1
27011,24,594,1293,570,1093,25,15,163,1318,10,195,123,241,205,364,1516,2795,6,17273,959,0,2,2,2,1
27012,116,2461,1043,504,840,53,9,147,1096,9,180,112,198,189,310,1377,2344,4,11604,644,0,2,11,3,1
27013,116,2461,383,288,292,26,6,62,409,11,65,38,67,76,105,429,656,5,3719,206,0,2,11,3,1
27014,114,4342,1513,682,1277,25,13,200,1538,11,199,116,219,210,335,1557,2584,6,15641,868,0,2,2,2,1
27015,39,2415,1523,757,1297,19,12,193,1542,12,193,117,230,205,347,1508,2664,7,19053,1058,0,2,3,1,1
27016,161,3047,1513,682,1277,25,13,200,1538,11,199,116,219,210,335,1557,2584,6,15641,868,0,2,105,68,1
27017,161,3047,819,519,539,24,98,155,843,15,96,57,106,111,163,690,1107,8,9171,509,0,2,105,68,1
27018,230,4686,1457,730,1242,11,6,188,1468,10,292,166,329,302,495,2424,4078,5,22973,1276,1,2,12,5,1
27019,230,4686,74,35,59,1,0,14,75,3,14,7,14,17,21,58,85,1,128,7,0,2,12,5,1
27020,230,4686,245,125,200,5,7,34,250,7,30,17,34,37,51,166,265,3,1053,58,0,2,12,5,1
27021,43,1146,74,35,59,1,0,14,75,3,14,7,14,17,21,58,85,1,128,7,0,2,3,1,1
27022,43,1146,245,125,200,5,7,34,250,7,30,17,34,37,51,166,265,3,1053,58,0,2,3,1,1
27023,67,1214,1020,354,843,12,15,144,1032,8,134,77,144,142,221,970,1580,4,6792,377,0,2,1,1,1
27024,25,602,1293,570,1093,25,15,163,1318,10,195,123,241,205,364,1516,2795,6,17273,959,0,2,11,11,1
27025,435,9745,72,33,56,0,4,12,72,1,1,1,1,2,2,0,2,0,1,0,0,2,1,1,1
27026,435,9745,1454,835,1044,76,110,219,1530,17,275,158,296,292,454,2297,3718,9,34017,1889,1,2,1,1,1
27027,114,2464,1043,504,840,53,9,147,1096,9,180,112,198,189,310,1377,2344,4,11604,644,0,2,8,8,1
27028,114,2464,383,288,292,26,6,62,409,11,65,38,67,76,105,429,656,5,3719,206,0,2,8,8,1
27029,167,3404,1943,715,1694,26,18,214,1969,12,185,120,237,197,357,1436,2721,7,20915,1161,0,2,9,1,1
27030,167,3404,1168,838,957,57,25,144,1225,19,348,224,416,367,640,3018,5452,11,61921,3440,1,2,9,1,1
27032,114,4350,1513,682,1277,25,13,200,1538,11,199,116,219,210,335,1557,2584,6,15641,868,0,2,27,23,1
27033,21,559,1293,570,1093,25,15,163,1318,10,195,123,241,205,364,1516,2795,6,17273,959,0,2,8,21,1
27034,168,3795,77,34,69,0,0,8,77,3,24,16,29,27,45,114,213,1,387,21,0,2,0,4,1
27035,168,3795,712,438,573,51,9,84,763,14,102,71,128,116,199,733,1364,8,11988,666,0,2,0,4,1
27036,24,382,424,94,331,4,0,89,428,1,5,5,5,6,10,11,25,0,12,0,0,2,20,10,1
27037,24,382,38,23,23,6,0,8,44,3,11,7,11,14,18,42,68,1,102,5,0,2,20,10,1
27038,112,2415,1043,504,840,53,9,147,1096,9,180,112,198,189,310,1377,2344,4,11604,644,0,2,3,1,1
27039,112,2415,383,288,292,26,6,62,409,11,65,38,67,76,105,429,656,5,3719,206,0,2,3,1,1
27040,17,540,424,94,331,4,0,89,428,1,5,5,5,6,10,11,25,0,12,0,0,2,15,1,1
27041,168,3793,77,34,69,0,0,8,77,3,24,16,29,27,45,114,213,1,387,21,0,2,1,1,1
27042,168,3793,712,438,573,51,9,84,763,14,102,71,128,116,199,733,1364,8,11988,666,0,2,1,1,1
27043,63,2936,1338,495,1086,10,64,173,1348,11,122,82,157,133,239,883,1686,7,11934,663,0,2,1,1,1
27044,23,373,424,94,331,4,0,89,428,1,5,5,5,6,10,11,25,0,12,0,0,2,5,10,1
27045,23,373,38,23,23,6,0,8,44,3,11,7,11,14,18,42,68,1,102,5,0,2,5,10,1
27046,168,3793,77,34,69,0,0,8,77,3,24,16,29,27,45,114,213,1,387,21,0,2,1,5,0
27047,168,3793,712,438,573,51,9,84,763,14,102,71,128,116,199,733,1364,8,11988,666,0,2,1,5,0
27048,23,373,424,94,331,4,0,89,428,1,5,5,5,6,10,11,25,0,12,0,0,2,19,14,0
27049,23,373,38,23,23,6,0,8,44,3,11,7,11,14,18,42,68,1,102,5,0,2,19,14,0
27050,112,2415,1043,504,840,53,9,147,1096,9,180,112,198,189,310,1377,2344,4,11604,644,0,2,3,1,0
27051,112,2415,383,288,292,26,6,62,409,11,65,38,67,76,105,429,656,5,3719,206,0,2,3,1,0
27052,63,2936,1338,495,1086,10,64,173,1348,11,122,82,157,133,239,883,1686,7,11934,663,0,2,1,1,0
27053,17,540,424,94,331,4,0,89,428,1,5,5,5,6,10,11,25,0,12,0,0,2,15,1,0
27054,161,3043,1513,682,1277,25,13,200,1538,11,199,116,219,210,335,1557,2584,6,15641,868,0,2,5,6,1
27055,161,3043,819,519,539,24,98,155,843,15,96,57,106,111,163,690,1107,8,9171,509,0,2,5,6,1
27056,45,445,647,139,84,35,284,233,682,0,0,0,0,0,0,0,0,0,0,0,0,2,2,2,1
27057,438,9764,72,33,56,0,4,12,72,1,1,1,1,2,2,0,2,0,1,0,0,2,3,3,1
27058,438,9764,1454,835,1044,76,110,219,1530,17,275,158,296,292,454,2297,3718,9,34017,1889,1,2,3,3,1
27059,438,9769,72,33,56,0,4,12,72,1,1,1,1,2,2,0,2,0,1,0,0,2,3,3,1
27060,438,9769,1454,835,1044,76,110,219,1530,17,275,158,296,292,454,2297,3718,9,34017,1889,1,2,3,3,1
27061,228,4665,1457,730,1242,11,6,188,1468,10,292,166,329,302,495,2424,4078,5,22973,1276,1,2,1,1,1
27062,228,4665,74,35,59,1,0,14,75,3,14,7,14,17,21,58,85,1,128,7,0,2,1,1,1
27063,228,4665,245,125,200,5,7,34,250,7,30,17,34,37,51,166,265,3,1053,58,0,2,1,1,1
27064,228,4665,1457,730,1242,11,6,188,1468,10,292,166,329,302,495,2424,4078,5,22973,1276,1,2,1,1,0
27065,228,4665,74,35,59,1,0,14,75,3,14,7,14,17,21,58,85,1,128,7,0,2,1,1,0
27066,228,4665,245,125,200,5,7,34,250,7,30,17,34,37,51,166,265,3,1053,58,0,2,1,1,0
27067,439,9795,72,33,56,0,4,12,72,1,1,1,1,2,2,0,2,0,1,0,0,2,7,1,0
27068,439,9795,1454,835,1044,76,110,219,1530,17,275,158,296,292,454,2297,3718,9,34017,1889,1,2,7,1,0
27069,24,595,465,148,393,5,8,60,470,4,31,20,31,35,51,161,261,2,523,29,0,2,3,0,0
27070,24,595,16,12,9,0,0,6,16,1,2,1,2,3,3,2,4,0,2,0,0,2,3,0,0
27071,24,595,465,148,393,5,8,60,470,4,31,20,31,35,51,161,261,2,523,29,0,2,2,1,0
27072,24,595,16,12,9,0,0,6,16,1,2,1,2,3,3,2,4,0,2,0,0,2,2,1,0
27073,115,4390,1513,682,1277,25,13,200,1538,11,199,116,219,210,335,1557,2584,6,15641,868,0,2,18,0,0
27074,230,4693,1457,730,1242,11,6,188,1468,10,292,166,329,302,495,2424,4078,5,22973,1276,1,2,1,1,0
27075,230,4693,74,35,59,1,0,14,75,3,14,7,14,17,21,58,85,1,128,7,0,2,1,1,0
27076,230,4693,245,125,200,5,7,34,250,7,30,17,34,37,51,166,265,3,1053,58,0,2,1,1,0
27077,45,445,647,139,84,35,284,233,682,0,0,0,0,0,0,0,0,0,0,0,0,2,2,2,0
27078,171,3865,77,34,69,0,0,8,77,3,24,16,29,27,45,114,213,1,387,21,0,2,1,5,0
27079,171,3865,712,438,573,51,9,84,763,14,102,71,128,116,199,733,1364,8,11988,666,0,2,1,5,0
27082,439,9793,72,33,56,0,4,12,72,1,1,1,1,2,2,0,2,0,1,0,0,2,7,1,0
27083,439,9793,1454,835,1044,76,110,219,1530,17,275,158,296,292,454,2297,3718,9,34017,1889,1,2,7,1,0
27084,114,2478,1043,504,840,53,9,147,1096,9,180,112,198,189,310,1377,2344,4,11604,644,0,2,3,1,0
27085,114,2478,383,288,292,26,6,62,409,11,65,38,67,76,105,429,656,5,3719,206,0,2,3,1,0
27087,24,595,465,148,393,5,8,60,470,4,31,20,31,35,51,161,261,2,523,29,0,2,4,0,0
27088,24,595,16,12,9,0,0,6,16,1,2,1,2,3,3,2,4,0,2,0,0,2,4,0,0
27089,115,4398,1513,682,1277,25,13,200,1538,11,199,116,219,210,335,1557,2584,6,15641,868,0,2,18,0,0
27091,115,4399,1513,682,1277,25,13,200,1538,11,199,116,219,210,335,1557,2584,6,15641,868,0,2,1,1,0
27092,54,1027,1098,241,925,5,10,155,1103,7,46,25,49,53,74,273,423,3,1580,87,0,2,1,1,0
27093,54,1027,282,202,222,14,2,44,296,8,42,24,43,50,67,250,378,4,1548,86,0,2,1,1,0
27094,159,2935,1513,682,1277,25,13,200,1538,11,199,116,219,210,335,1557,2584,6,15641,868,0,2,6,29,1
27095,159,2935,819,519,539,24,98,155,843,15,96,57,106,111,163,690,1107,8,9171,509,0,2,6,29,1
27096,112,4283,1513,682,1277,25,13,200,1538,11,199,116,219,210,335,1557,2584,6,15641,868,0,2,3,25,1
27097,133,2539,1513,682,1277,25,13,200,1538,11,199,116,219,210,335,1557,2584,6,15641,868,0,2,105,195,1
27098,133,2539,819,519,539,24,98,155,843,15,96,57,106,111,163,690,1107,8,9171,509,0,2,105,195,1
27099,111,4191,1513,682,1277,25,13,200,1538,11,199,116,219,210,335,1557,2584,6,15641,868,0,2,24,35,1
27100,127,2479,1513,682,1277,25,13,200,1538,11,199,116,219,210,335,1557,2584,6,15641,868,0,2,49,59,1
27101,127,2479,819,519,539,24,98,155,843,15,96,57,106,111,163,690,1107,8,9171,509,0,2,49,59,1
27102,112,4213,1513,682,1277,25,13,200,1538,11,199,116,219,210,335,1557,2584,6,15641,868,0,2,54,39,1
27103,122,2423,1513,682,1277,25,13,200,1538,11,199,116,219,210,335,1557,2584,6,15641,868,0,2,23,39,1
27104,122,2423,819,519,539,24,98,155,843,15,96,57,106,111,163,690,1107,8,9171,509,0,2,23,39,1
27105,110,4169,1513,682,1277,25,13,200,1538,11,199,116,219,210,335,1557,2584,6,15641,868,0,2,62,79,1
27108,32,641,2,2,2,0,0,0,2,0,0,0,0,0,0,0,0,0,0,0,0,2,1,1,0
27122,32,641,99,48,90,1,3,5,100,0,0,0,0,0,0,0,0,0,0,0,0,2,1,1,0
27123,32,641,8,5,5,2,0,1,10,0,0,0,0,0,0,0,0,0,0,0,0,2,1,1,0
27124,32,641,1217,716,841,84,126,174,1301,14,185,118,215,199,333,1446,2542,8,20687,1149,0,2,1,1,0
27125,32,641,160,89,115,0,13,31,160,7,15,11,17,22,28,78,124,3,495,27,0,2,1,1,0
27126,32,641,10,10,9,9,0,0,19,0,0,0,0,0,0,0,0,0,0,0,0,2,1,1,0
27127,32,641,173,84,99,8,29,36,181,5,12,7,13,17,20,54,81,2,221,12,0,2,1,1,0
27128,32,641,3,1,1,3,0,0,6,0,0,0,0,0,0,0,0,0,0,0,0,2,1,1,0
27129,117,2976,1660,832,1314,41,38,274,1701,20,312,209,395,332,604,2671,5058,12,64042,3557,1,2,16,0,0
27130,117,2960,1660,832,1314,41,38,274,1701,20,312,209,395,332,604,2671,5058,12,64042,3557,1,2,3,13,0
27154,117,2960,1660,832,1314,41,38,274,1701,20,312,209,395,332,604,2671,5058,12,64042,3557,1,2,6,0,0
27155,122,2423,1513,682,1277,25,13,200,1538,11,199,116,219,210,335,1557,2584,6,15641,868,0,2,209,330,0
27156,122,2423,819,519,539,24,98,155,843,15,96,57,106,111,163,690,1107,8,9171,509,0,2,209,330,0
27157,230,4693,1457,730,1242,11,6,188,1468,10,292,166,329,302,495,2424,4078,5,22973,1276,1,2,12,5,0
27158,230,4693,74,35,59,1,0,14,75,3,14,7,14,17,21,58,85,1,128,7,0,2,12,5,0
27159,230,4693,245,125,200,5,7,34,250,7,30,17,34,37,51,166,265,3,1053,58,0,2,12,5,0
27160,43,1146,74,35,59,1,0,14,75,3,14,7,14,17,21,58,85,1,128,7,0,2,3,1,0
27161,43,1146,245,125,200,5,7,34,250,7,30,17,34,37,51,166,265,3,1053,58,0,2,3,1,0
27162,43,1314,1523,757,1297,19,12,193,1542,12,193,117,230,205,347,1508,2664,7,19053,1058,0,2,8,6,0
27163,43,1314,701,378,504,33,58,109,734,13,110,68,126,123,194,794,1346,7,10027,557,0,2,8,6,0
27164,171,3865,77,34,69,0,0,8,77,3,24,16,29,27,45,114,213,1,387,21,0,2,9,0,0
27165,171,3865,712,438,573,51,9,84,763,14,102,71,128,116,199,733,1364,8,11988,666,0,2,9,0,0
27166,67,1214,1020,354,843,12,15,144,1032,8,134,77,144,142,221,970,1580,4,6792,377,0,2,1,1,0
27167,21,559,1293,570,1093,25,15,163,1318,10,195,123,241,205,364,1516,2795,6,17273,959,0,2,12,25,0
27168,439,9793,72,33,56,0,4,12,72,1,1,1,1,2,2,0,2,0,1,0,0,2,1,1,0
27169,439,9793,1454,835,1044,76,110,219,1530,17,275,158,296,292,454,2297,3718,9,34017,1889,1,2,1,1,0
27170,114,2478,1043,504,840,53,9,147,1096,9,180,112,198,189,310,1377,2344,4,11604,644,0,2,19,11,0
27171,114,2478,383,288,292,26,6,62,409,11,65,38,67,76,105,429,656,5,3719,206,0,2,19,11,0
27172,167,3404,1943,715,1694,26,18,214,1969,12,185,120,237,197,357,1436,2721,7,20915,1161,0,2,9,1,0
27173,167,3404,1168,838,957,57,25,144,1225,19,348,224,416,367,640,3018,5452,11,61921,3440,1,2,9,1,0
27175,110,4178,1513,682,1277,25,13,200,1538,11,199,116,219,210,335,1557,2584,6,15641,868,0,2,134,165,0
27176,39,2415,1523,757,1297,19,12,193,1542,12,193,117,230,205,347,1508,2664,7,19053,1058,0,2,3,1,0
27177,118,2308,1513,682,1277,25,13,200,1538,11,199,116,219,210,335,1557,2584,6,15641,868,0,2,5,26,1
27178,118,2308,819,519,539,24,98,155,843,15,96,57,106,111,163,690,1107,8,9171,509,0,2,5,26,1
27179,110,4160,1513,682,1277,25,13,200,1538,11,199,116,219,210,335,1557,2584,6,15641,868,0,2,9,8,1
27180,116,2252,1513,682,1277,25,13,200,1538,11,199,116,219,210,335,1557,2584,6,15641,868,0,2,23,42,1
27181,116,2252,819,519,539,24,98,155,843,15,96,57,106,111,163,690,1107,8,9171,509,0,2,23,42,1
27182,168,3427,1943,715,1694,26,18,214,1969,12,185,120,237,197,357,1436,2721,7,20915,1161,0,2,4,2,1
27183,168,3427,1168,838,957,57,25,144,1225,19,348,224,416,367,640,3018,5452,11,61921,3440,1,2,4,2,1
27184,110,4131,1513,682,1277,25,13,200,1538,11,199,116,219,210,335,1557,2584,6,15641,868,0,2,12,17,1
27187,198,4464,722,423,573,19,0,135,741,12,172,101,199,184,300,1320,2257,6,15668,870,0,2,8,2,1
27188,198,4464,1508,847,911,44,250,301,1552,14,148,88,169,162,257,1120,1886,7,15077,837,0,2,8,2,1
27189,117,2950,1660,832,1314,41,38,274,1701,20,312,209,395,332,604,2671,5058,12,64042,3557,1,2,15,14,1
27190,117,2932,1660,832,1314,41,38,274,1701,20,312,209,395,332,604,2671,5058,12,64042,3557,1,2,6,6,0
27191,115,4404,1513,682,1277,25,13,200,1538,11,199,116,219,210,335,1557,2584,6,15641,868,0,2,3,2,0
27192,116,2252,1513,682,1277,25,13,200,1538,11,199,116,219,210,335,1557,2584,6,15641,868,0,2,5,5,0
27193,116,2252,819,519,539,24,98,155,843,15,96,57,106,111,163,690,1107,8,9171,509,0,2,5,5,0
27194,111,4160,1513,682,1277,25,13,200,1538,11,199,116,219,210,335,1557,2584,6,15641,868,0,2,23,4,0
27195,118,2356,1513,682,1277,25,13,200,1538,11,199,116,219,210,335,1557,2584,6,15641,868,0,2,46,25,1
27196,118,2356,819,519,539,24,98,155,843,15,96,57,106,111,163,690,1107,8,9171,509,0,2,46,25,1
27197,114,4320,1513,682,1277,25,13,200,1538,11,199,116,219,210,335,1557,2584,6,15641,868,0,2,32,6,1
27198,122,2415,1513,682,1277,25,13,200,1538,11,199,116,219,210,335,1557,2584,6,15641,868,0,2,19,11,0
27199,122,2415,819,519,539,24,98,155,843,15,96,57,106,111,163,690,1107,8,9171,509,0,2,19,11,0
27200,64,2630,1289,550,1043,56,32,155,1345,10,167,93,185,177,278,1266,2075,5,11498,638,0,2,6,0,0
27201,114,2276,1513,682,1277,25,13,200,1538,11,199,116,219,210,335,1557,2584,6,15641,868,0,2,49,79,1
27202,114,2276,819,519,539,24,98,155,843,15,96,57,106,111,163,690,1107,8,9171,509,0,2,49,79,1
27203,21,564,1293,570,1093,25,15,163,1318,10,195,123,241,205,364,1516,2795,6,17273,959,0,2,3,3,1
27204,109,4150,1513,682,1277,25,13,200,1538,11,199,116,219,210,335,1557,2584,6,15641,868,0,2,26,51,1
27205,29,1113,1293,570,1093,25,15,163,1318,10,195,123,241,205,364,1516,2795,6,17273,959,0,2,20,0,1
27206,114,2255,1513,682,1277,25,13,200,1538,11,199,116,219,210,335,1557,2584,6,15641,868,0,2,15,20,1
27207,114,2255,819,519,539,24,98,155,843,15,96,57,106,111,163,690,1107,8,9171,509,0,2,15,20,1
27208,43,1133,74,35,59,1,0,14,75,3,14,7,14,17,21,58,85,1,128,7,0,2,1,3,1
27209,43,1133,245,125,200,5,7,34,250,7,30,17,34,37,51,166,265,3,1053,58,0,2,1,3,1
27210,67,1216,1020,354,843,12,15,144,1032,8,134,77,144,142,221,970,1580,4,6792,377,0,2,1,1,1
27211,439,9795,72,33,56,0,4,12,72,1,1,1,1,2,2,0,2,0,1,0,0,2,1,1,1
27212,439,9795,1454,835,1044,76,110,219,1530,17,275,158,296,292,454,2297,3718,9,34017,1889,1,2,1,1,1
27213,167,3399,1943,715,1694,26,18,214,1969,12,185,120,237,197,357,1436,2721,7,20915,1161,0,2,1,10,1
27214,167,3399,1168,838,957,57,25,144,1225,19,348,224,416,367,640,3018,5452,11,61921,3440,1,2,1,10,1
27217,38,647,127,75,83,2,11,30,129,4,14,7,14,18,21,61,87,2,175,9,0,2,21,5,0
27218,38,647,652,304,544,16,6,88,668,6,89,51,101,95,152,591,998,3,3399,188,0,2,21,5,0
27219,38,647,2,2,2,0,0,0,2,0,0,0,0,0,0,0,0,0,0,0,0,2,21,5,0
27220,38,647,8,5,5,0,0,3,8,0,0,0,0,0,0,0,0,0,0,0,0,2,21,5,0
27223,38,647,14,8,8,0,0,6,14,0,0,0,0,0,0,0,0,0,0,0,0,2,21,5,0
27224,38,647,6,4,4,0,0,2,6,0,0,0,0,0,0,0,0,0,0,0,0,2,21,5,0
27225,38,647,6,4,4,0,0,2,6,1,2,1,2,3,3,2,4,0,2,0,0,2,21,5,0
27227,38,647,7,5,5,0,0,2,7,0,0,0,0,0,0,0,0,0,0,0,0,2,21,5,0
27229,38,647,10,6,6,0,0,4,10,0,0,0,0,0,0,0,0,0,0,0,0,2,21,5,0
27230,38,647,1,1,1,0,0,0,1,0,0,0,0,0,0,0,0,0,0,0,0,2,21,5,0
27232,38,647,14,10,10,0,0,4,14,1,1,1,1,2,2,0,2,0,1,0,0,2,21,5,0
27233,38,647,46,26,30,3,0,12,49,3,6,3,6,9,9,20,28,1,42,2,0,2,21,5,0
27234,46,790,127,75,83,2,11,30,129,4,14,7,14,18,21,61,87,2,175,9,0,2,24,8,0
27235,46,790,652,304,544,16,6,88,668,6,89,51,101,95,152,591,998,3,3399,188,0,2,24,8,0
27236,46,790,2,2,2,0,0,0,2,0,0,0,0,0,0,0,0,0,0,0,0,2,24,8,0
27237,46,790,8,5,5,0,0,3,8,0,0,0,0,0,0,0,0,0,0,0,0,2,24,8,0
27240,46,790,14,8,8,0,0,6,14,0,0,0,0,0,0,0,0,0,0,0,0,2,24,8,0
27241,46,790,6,4,4,0,0,2,6,0,0,0,0,0,0,0,0,0,0,0,0,2,24,8,0
27242,46,790,6,4,4,0,0,2,6,1,2,1,2,3,3,2,4,0,2,0,0,2,24,8,0
27244,46,790,7,5,5,0,0,2,7,0,0,0,0,0,0,0,0,0,0,0,0,2,24,8,0
27246,46,790,10,6,6,0,0,4,10,0,0,0,0,0,0,0,0,0,0,0,0,2,24,8,0
27247,46,790,1,1,1,0,0,0,1,0,0,0,0,0,0,0,0,0,0,0,0,2,24,8,0
27249,46,790,14,10,10,0,0,4,14,1,1,1,1,2,2,0,2,0,1,0,0,2,24,8,0
27250,46,790,46,26,30,3,0,12,49,3,6,3,6,9,9,20,28,1,42,2,0,2,24,8,0
27251,38,718,127,75,83,2,11,30,129,4,14,7,14,18,21,61,87,2,175,9,0,2,3,12,0
27252,38,718,652,304,544,16,6,88,668,6,89,51,101,95,152,591,998,3,3399,188,0,2,3,12,0
27253,38,718,2,2,2,0,0,0,2,0,0,0,0,0,0,0,0,0,0,0,0,2,3,12,0
27254,38,718,8,5,5,0,0,3,8,0,0,0,0,0,0,0,0,0,0,0,0,2,3,12,0
27257,38,718,14,8,8,0,0,6,14,0,0,0,0,0,0,0,0,0,0,0,0,2,3,12,0
27258,38,718,6,4,4,0,0,2,6,0,0,0,0,0,0,0,0,0,0,0,0,2,3,12,0
27259,38,718,6,4,4,0,0,2,6,1,2,1,2,3,3,2,4,0,2,0,0,2,3,12,0
27261,38,718,7,5,5,0,0,2,7,0,0,0,0,0,0,0,0,0,0,0,0,2,3,12,0
27263,38,718,10,6,6,0,0,4,10,0,0,0,0,0,0,0,0,0,0,0,0,2,3,12,0
27264,38,718,1,1,1,0,0,0,1,0,0,0,0,0,0,0,0,0,0,0,0,2,3,12,0
27266,38,718,14,10,10,0,0,4,14,1,1,1,1,2,2,0,2,0,1,0,0,2,3,12,0
27267,38,718,46,26,30,3,0,12,49,3,6,3,6,9,9,20,28,1,42,2,0,2,3,12,0
27268,38,712,127,75,83,2,11,30,129,4,14,7,14,18,21,61,87,2,175,9,0,2,2,2,0
27269,38,712,652,304,544,16,6,88,668,6,89,51,101,95,152,591,998,3,3399,188,0,2,2,2,0
27270,38,712,2,2,2,0,0,0,2,0,0,0,0,0,0,0,0,0,0,0,0,2,2,2,0
27271,38,712,8,5,5,0,0,3,8,0,0,0,0,0,0,0,0,0,0,0,0,2,2,2,0
27274,38,712,14,8,8,0,0,6,14,0,0,0,0,0,0,0,0,0,0,0,0,2,2,2,0
27275,38,712,6,4,4,0,0,2,6,0,0,0,0,0,0,0,0,0,0,0,0,2,2,2,0
27276,38,712,6,4,4,0,0,2,6,1,2,1,2,3,3,2,4,0,2,0,0,2,2,2,0
27278,38,712,7,5,5,0,0,2,7,0,0,0,0,0,0,0,0,0,0,0,0,2,2,2,0
27280,38,712,10,6,6,0,0,4,10,0,0,0,0,0,0,0,0,0,0,0,0,2,2,2,0
27281,38,712,1,1,1,0,0,0,1,0,0,0,0,0,0,0,0,0,0,0,0,2,2,2,0
27283,38,712,14,10,10,0,0,4,14,1,1,1,1,2,2,0,2,0,1,0,0,2,2,2,0
27284,38,712,46,26,30,3,0,12,49,3,6,3,6,9,9,20,28,1,42,2,0,2,2,2,0
27285,38,712,127,75,83,2,11,30,129,4,14,7,14,18,21,61,87,2,175,9,0,2,43,20,0
27286,38,712,652,304,544,16,6,88,668,6,89,51,101,95,152,591,998,3,3399,188,0,2,43,20,0
27287,38,712,2,2,2,0,0,0,2,0,0,0,0,0,0,0,0,0,0,0,0,2,43,20,0
27288,38,712,8,5,5,0,0,3,8,0,0,0,0,0,0,0,0,0,0,0,0,2,43,20,0
27291,38,712,14,8,8,0,0,6,14,0,0,0,0,0,0,0,0,0,0,0,0,2,43,20,0
27292,38,712,6,4,4,0,0,2,6,0,0,0,0,0,0,0,0,0,0,0,0,2,43,20,0
27293,38,712,6,4,4,0,0,2,6,1,2,1,2,3,3,2,4,0,2,0,0,2,43,20,0
27295,38,712,7,5,5,0,0,2,7,0,0,0,0,0,0,0,0,0,0,0,0,2,43,20,0
27297,38,712,10,6,6,0,0,4,10,0,0,0,0,0,0,0,0,0,0,0,0,2,43,20,0
27298,38,712,1,1,1,0,0,0,1,0,0,0,0,0,0,0,0,0,0,0,0,2,43,20,0
27300,38,712,14,10,10,0,0,4,14,1,1,1,1,2,2,0,2,0,1,0,0,2,43,20,0
27301,38,712,46,26,30,3,0,12,49,3,6,3,6,9,9,20,28,1,42,2,0,2,43,20,0
27302,109,4155,1513,682,1277,25,13,200,1538,11,199,116,219,210,335,1557,2584,6,15641,868,0,2,3,2,0
27303,38,712,127,75,83,2,11,30,129,4,14,7,14,18,21,61,87,2,175,9,0,2,1,1,0
27304,38,712,652,304,544,16,6,88,668,6,89,51,101,95,152,591,998,3,3399,188,0,2,1,1,0
27305,38,712,2,2,2,0,0,0,2,0,0,0,0,0,0,0,0,0,0,0,0,2,1,1,0
27306,38,712,8,5,5,0,0,3,8,0,0,0,0,0,0,0,0,0,0,0,0,2,1,1,0
27309,38,712,14,8,8,0,0,6,14,0,0,0,0,0,0,0,0,0,0,0,0,2,1,1,0
27310,38,712,6,4,4,0,0,2,6,0,0,0,0,0,0,0,0,0,0,0,0,2,1,1,0
27311,38,712,6,4,4,0,0,2,6,1,2,1,2,3,3,2,4,0,2,0,0,2,1,1,0
27313,38,712,7,5,5,0,0,2,7,0,0,0,0,0,0,0,0,0,0,0,0,2,1,1,0
27315,38,712,10,6,6,0,0,4,10,0,0,0,0,0,0,0,0,0,0,0,0,2,1,1,0
27316,38,712,1,1,1,0,0,0,1,0,0,0,0,0,0,0,0,0,0,0,0,2,1,1,0
27318,38,712,14,10,10,0,0,4,14,1,1,1,1,2,2,0,2,0,1,0,0,2,1,1,0
27319,38,712,46,26,30,3,0,12,49,3,6,3,6,9,9,20,28,1,42,2,0,2,1,1,0
27320,114,2252,1513,682,1277,25,13,200,1538,11,199,116,219,210,335,1557,2584,6,15641,868,0,2,1,1,1
27321,114,2252,819,519,539,24,98,155,843,15,96,57,106,111,163,690,1107,8,9171,509,0,2,1,1,1
27322,224,4615,1457,730,1242,11,6,188,1468,10,292,166,329,302,495,2424,4078,5,22973,1276,1,2,18,29,1
27323,224,4615,74,35,59,1,0,14,75,3,14,7,14,17,21,58,85,1,128,7,0,2,18,29,1
27324,224,4615,245,125,200,5,7,34,250,7,30,17,34,37,51,166,265,3,1053,58,0,2,18,29,1
27325,41,2012,1457,730,1242,11,6,188,1468,10,292,166,329,302,495,2424,4078,5,22973,1276,1,2,1,1,1
27326,32,1557,652,304,544,16,6,88,668,6,89,51,101,95,152,591,998,3,3399,188,0,2,39,28,1
27327,108,4151,1513,682,1277,25,13,200,1538,11,199,116,219,210,335,1557,2584,6,15641,868,0,2,5,7,0
27328,13,444,42,7,35,4,0,5,46,1,2,1,2,3,3,2,4,0,2,0,0,2,1,1,0
27329,13,444,11,6,10,0,0,1,11,2,4,2,4,6,6,10,15,1,15,0,0,2,1,1,0
27330,77,1712,477,336,357,30,23,73,507,16,194,134,250,210,384,1538,2962,10,30538,1696,0,2,1,2,0
27331,171,3868,77,34,69,0,0,8,77,3,24,16,29,27,45,114,213,1,387,21,0,2,1,0,0
27332,171,3868,712,438,573,51,9,84,763,14,102,71,128,116,199,733,1364,8,11988,666,0,2,1,0,0
27333,439,9792,72,33,56,0,4,12,72,1,1,1,1,2,2,0,2,0,1,0,0,2,2,2,0
27334,439,9792,1454,835,1044,76,110,219,1530,17,275,158,296,292,454,2297,3718,9,34017,1889,1,2,2,2,0
27335,108,4149,1513,682,1277,25,13,200,1538,11,199,116,219,210,335,1557,2584,6,15641,868,0,2,0,1,0
27338,32,641,2,2,2,0,0,0,2,0,0,0,0,0,0,0,0,0,0,0,0,2,37,17,1
27352,32,641,99,48,90,1,3,5,100,0,0,0,0,0,0,0,0,0,0,0,0,2,37,17,1
27353,32,641,8,5,5,2,0,1,10,0,0,0,0,0,0,0,0,0,0,0,0,2,37,17,1
27354,32,641,1217,716,841,84,126,174,1301,14,185,118,215,199,333,1446,2542,8,20687,1149,0,2,37,17,1
27355,32,641,160,89,115,0,13,31,160,7,15,11,17,22,28,78,124,3,495,27,0,2,37,17,1
27356,32,641,10,10,9,9,0,0,19,0,0,0,0,0,0,0,0,0,0,0,0,2,37,17,1
27357,32,641,173,84,99,8,29,36,181,5,12,7,13,17,20,54,81,2,221,12,0,2,37,17,1
27358,32,641,3,1,1,3,0,0,6,0,0,0,0,0,0,0,0,0,0,0,0,2,37,17,1
27361,33,659,2,2,2,0,0,0,2,0,0,0,0,0,0,0,0,0,0,0,0,2,22,5,1
27375,33,659,99,48,90,1,3,5,100,0,0,0,0,0,0,0,0,0,0,0,0,2,22,5,1
27376,33,659,8,5,5,2,0,1,10,0,0,0,0,0,0,0,0,0,0,0,0,2,22,5,1
27377,33,659,1217,716,841,84,126,174,1301,14,185,118,215,199,333,1446,2542,8,20687,1149,0,2,22,5,1
27378,33,659,160,89,115,0,13,31,160,7,15,11,17,22,28,78,124,3,495,27,0,2,22,5,1
27379,33,659,10,10,9,9,0,0,19,0,0,0,0,0,0,0,0,0,0,0,0,2,22,5,1
27380,33,659,173,84,99,8,29,36,181,5,12,7,13,17,20,54,81,2,221,12,0,2,22,5,1
27381,33,659,3,1,1,3,0,0,6,0,0,0,0,0,0,0,0,0,0,0,0,2,22,5,1
27382,55,1940,1450,624,1228,12,26,181,1462,14,306,186,354,320,540,2580,4493,8,36391,2021,1,2,16,0,1
27383,108,4145,1513,682,1277,25,13,200,1538,11,199,116,219,210,335,1557,2584,6,15641,868,0,2,2,2,0
27384,108,4145,1513,682,1277,25,13,200,1538,11,199,116,219,210,335,1557,2584,6,15641,868,0,2,2,3,0
27385,109,4172,1513,682,1277,25,13,200,1538,11,199,116,219,210,335,1557,2584,6,15641,868,0,2,18,0,1
27386,231,4784,1457,730,1242,11,6,188,1468,10,292,166,329,302,495,2424,4078,5,22973,1276,1,2,39,9,1
27387,231,4784,74,35,59,1,0,14,75,3,14,7,14,17,21,58,85,1,128,7,0,2,39,9,1
27388,231,4784,245,125,200,5,7,34,250,7,30,17,34,37,51,166,265,3,1053,58,0,2,39,9,1
27389,42,1077,74,35,59,1,0,14,75,3,14,7,14,17,21,58,85,1,128,7,0,2,1,9,1
27390,42,1077,245,125,200,5,7,34,250,7,30,17,34,37,51,166,265,3,1053,58,0,2,1,9,1
27391,65,2681,1289,550,1043,56,32,155,1345,10,167,93,185,177,278,1266,2075,5,11498,638,0,2,12,0,1
27392,109,4172,1513,682,1277,25,13,200,1538,11,199,116,219,210,335,1557,2584,6,15641,868,0,2,1,1,1
27393,218,4490,1457,730,1242,11,6,188,1468,10,292,166,329,302,495,2424,4078,5,22973,1276,1,2,20,46,1
27394,218,4490,74,35,59,1,0,14,75,3,14,7,14,17,21,58,85,1,128,7,0,2,20,46,1
27395,218,4490,245,125,200,5,7,34,250,7,30,17,34,37,51,166,265,3,1053,58,0,2,20,46,1
27396,171,3865,77,34,69,0,0,8,77,3,24,16,29,27,45,114,213,1,387,21,0,2,1,1,1
27397,171,3865,712,438,573,51,9,84,763,14,102,71,128,116,199,733,1364,8,11988,666,0,2,1,1,1
27398,38,1794,1457,730,1242,11,6,188,1468,10,292,166,329,302,495,2424,4078,5,22973,1276,1,2,8,36,1
27399,26,1455,652,304,544,16,6,88,668,6,89,51,101,95,152,591,998,3,3399,188,0,2,22,48,1
27400,231,4784,1457,730,1242,11,6,188,1468,10,292,166,329,302,495,2424,4078,5,22973,1276,1,2,39,9,0
27401,231,4784,74,35,59,1,0,14,75,3,14,7,14,17,21,58,85,1,128,7,0,2,39,9,0
27402,231,4784,245,125,200,5,7,34,250,7,30,17,34,37,51,166,265,3,1053,58,0,2,39,9,0
27403,42,1077,74,35,59,1,0,14,75,3,14,7,14,17,21,58,85,1,128,7,0,2,1,9,0
27404,42,1077,245,125,200,5,7,34,250,7,30,17,34,37,51,166,265,3,1053,58,0,2,1,9,0
27405,65,2681,1289,550,1043,56,32,155,1345,10,167,93,185,177,278,1266,2075,5,11498,638,0,2,12,0,0
27406,225,4659,1457,730,1242,11,6,188,1468,10,292,166,329,302,495,2424,4078,5,22973,1276,1,2,20,46,0
27407,225,4659,74,35,59,1,0,14,75,3,14,7,14,17,21,58,85,1,128,7,0,2,20,46,0
27408,225,4659,245,125,200,5,7,34,250,7,30,17,34,37,51,166,265,3,1053,58,0,2,20,46,0
27409,171,3865,77,34,69,0,0,8,77,3,24,16,29,27,45,114,213,1,387,21,0,2,1,1,0
27410,171,3865,712,438,573,51,9,84,763,14,102,71,128,116,199,733,1364,8,11988,666,0,2,1,1,0
27411,38,1794,1457,730,1242,11,6,188,1468,10,292,166,329,302,495,2424,4078,5,22973,1276,1,2,8,36,0
27412,26,1455,652,304,544,16,6,88,668,6,89,51,101,95,152,591,998,3,3399,188,0,2,22,48,0
27420,198,4464,722,423,573,19,0,135,741,12,172,101,199,184,300,1320,2257,6,15668,870,0,2,8,2,0
27421,198,4464,1508,847,911,44,250,301,1552,14,148,88,169,162,257,1120,1886,7,15077,837,0,2,8,2,0
27422,117,2932,1660,832,1314,41,38,274,1701,20,312,209,395,332,604,2671,5058,12,64042,3557,1,2,15,14,0
27423,114,2252,1513,682,1277,25,13,200,1538,11,199,116,219,210,335,1557,2584,6,15641,868,0,2,1,1,0
27424,114,2252,819,519,539,24,98,155,843,15,96,57,106,111,163,690,1107,8,9171,509,0,2,1,1,0
27448,13,444,42,7,35,4,0,5,46,1,2,1,2,3,3,2,4,0,2,0,0,2,1,1,1
27449,13,444,11,6,10,0,0,1,11,2,4,2,4,6,6,10,15,1,15,0,0,2,1,1,1
27450,440,9798,72,33,56,0,4,12,72,1,1,1,1,2,2,0,2,0,1,0,0,2,8,6,1
27451,440,9798,1454,835,1044,76,110,219,1530,17,275,158,296,292,454,2297,3718,9,34017,1889,1,2,8,6,1
27452,125,5370,139,89,101,2,0,35,141,7,54,34,62,61,96,330,569,4,2287,127,0,2,29,0,1
27453,125,5370,7,5,5,0,0,2,7,1,2,1,2,3,3,2,4,0,2,0,0,2,29,0,1
27454,440,9798,72,33,56,0,4,12,72,1,1,1,1,2,2,0,2,0,1,0,0,2,8,6,0
27455,440,9798,1454,835,1044,76,110,219,1530,17,275,158,296,292,454,2297,3718,9,34017,1889,1,2,8,6,0
27456,125,5370,139,89,101,2,0,35,141,7,54,34,62,61,96,330,569,4,2287,127,0,2,29,0,0
27457,125,5370,7,5,5,0,0,2,7,1,2,1,2,3,3,2,4,0,2,0,0,2,29,0,0
27458,440,9808,72,33,56,0,4,12,72,1,1,1,1,2,2,0,2,0,1,0,0,2,2,0,1
27459,440,9808,1454,835,1044,76,110,219,1530,17,275,158,296,292,454,2297,3718,9,34017,1889,1,2,2,0,1
27460,25,624,465,148,393,5,8,60,470,4,31,20,31,35,51,161,261,2,523,29,0,2,15,0,1
27461,25,624,16,12,9,0,0,6,16,1,2,1,2,3,3,2,4,0,2,0,0,2,15,0,1
27462,440,9808,72,33,56,0,4,12,72,1,1,1,1,2,2,0,2,0,1,0,0,2,2,0,0
27463,440,9808,1454,835,1044,76,110,219,1530,17,275,158,296,292,454,2297,3718,9,34017,1889,1,2,2,0,0
27464,25,624,465,148,393,5,8,60,470,4,31,20,31,35,51,161,261,2,523,29,0,2,15,0,0
27465,25,624,16,12,9,0,0,6,16,1,2,1,2,3,3,2,4,0,2,0,0,2,15,0,0
27466,441,9824,72,33,56,0,4,12,72,1,1,1,1,2,2,0,2,0,1,0,0,2,3,0,1
27467,441,9824,1454,835,1044,76,110,219,1530,17,275,158,296,292,454,2297,3718,9,34017,1889,1,2,3,0,1
27468,55,1039,1098,241,925,5,10,155,1103,7,46,25,49,53,74,273,423,3,1580,87,0,2,3,1,1
27469,55,1039,282,202,222,14,2,44,296,8,42,24,43,50,67,250,378,4,1548,86,0,2,3,1,1
27470,28,753,465,148,393,5,8,60,470,4,31,20,31,35,51,161,261,2,523,29,0,2,51,4,1
27471,28,753,16,12,9,0,0,6,16,1,2,1,2,3,3,2,4,0,2,0,0,2,51,4,1
27472,28,753,465,148,393,5,8,60,470,4,31,20,31,35,51,161,261,2,523,29,0,2,2,2,0
27473,28,753,16,12,9,0,0,6,16,1,2,1,2,3,3,2,4,0,2,0,0,2,2,2,0
27474,442,9834,72,33,56,0,4,12,72,1,1,1,1,2,2,0,2,0,1,0,0,2,5,4,1
27475,442,9834,1454,835,1044,76,110,219,1530,17,275,158,296,292,454,2297,3718,9,34017,1889,1,2,5,4,1
27476,28,774,465,148,393,5,8,60,470,4,31,20,31,35,51,161,261,2,523,29,0,2,4,1,1
27477,28,774,16,12,9,0,0,6,16,1,2,1,2,3,3,2,4,0,2,0,0,2,4,1,1
27478,442,9834,72,33,56,0,4,12,72,1,1,1,1,2,2,0,2,0,1,0,0,2,8,4,0
27479,442,9834,1454,835,1044,76,110,219,1530,17,275,158,296,292,454,2297,3718,9,34017,1889,1,2,8,4,0
27480,55,1039,1098,241,925,5,10,155,1103,7,46,25,49,53,74,273,423,3,1580,87,0,2,3,1,0
27481,55,1039,282,202,222,14,2,44,296,8,42,24,43,50,67,250,378,4,1548,86,0,2,3,1,0
27482,28,774,465,148,393,5,8,60,470,4,31,20,31,35,51,161,261,2,523,29,0,2,52,2,0
27483,28,774,16,12,9,0,0,6,16,1,2,1,2,3,3,2,4,0,2,0,0,2,52,2,0
27484,86,1521,1178,367,1042,6,15,115,1184,9,94,51,95,103,146,644,976,4,4439,246,0,2,1,1,0
27485,86,1521,177,108,140,8,0,27,185,6,30,16,32,36,48,162,248,3,794,44,0,2,1,1,0
27486,226,4706,1457,730,1242,11,6,188,1468,10,292,166,329,302,495,2424,4078,5,22973,1276,1,2,9,2,1
27487,226,4706,74,35,59,1,0,14,75,3,14,7,14,17,21,58,85,1,128,7,0,2,9,2,1
27488,226,4706,245,125,200,5,7,34,250,7,30,17,34,37,51,166,265,3,1053,58,0,2,9,2,1
27489,167,3428,1943,715,1694,26,18,214,1969,12,185,120,237,197,357,1436,2721,7,20915,1161,0,2,4,2,1
27490,167,3428,1168,838,957,57,25,144,1225,19,348,224,416,367,640,3018,5452,11,61921,3440,1,2,4,2,1
27491,125,5370,139,89,101,2,0,35,141,7,54,34,62,61,96,330,569,4,2287,127,0,2,30,30,1
27492,125,5370,7,5,5,0,0,2,7,1,2,1,2,3,3,2,4,0,2,0,0,2,30,30,1
27493,38,2226,334,251,279,10,4,40,344,5,127,74,143,132,217,899,1528,2,4303,239,0,2,4,0,1
27494,61,2682,1943,715,1694,26,18,214,1969,12,185,120,237,197,357,1436,2721,7,20915,1161,0,2,9,9,1
27496,446,9892,72,33,56,0,4,12,72,1,1,1,1,2,2,0,2,0,1,0,0,2,20,10,1
27497,446,9892,1454,835,1044,76,110,219,1530,17,275,158,296,292,454,2297,3718,9,34017,1889,1,2,20,10,1
27498,11,239,256,139,192,9,7,47,265,4,23,12,24,27,36,112,171,2,357,19,0,2,7,0,1
27499,226,4706,1457,730,1242,11,6,188,1468,10,292,166,329,302,495,2424,4078,5,22973,1276,1,2,9,2,0
27500,226,4706,74,35,59,1,0,14,75,3,14,7,14,17,21,58,85,1,128,7,0,2,9,2,0
27501,226,4706,245,125,200,5,7,34,250,7,30,17,34,37,51,166,265,3,1053,58,0,2,9,2,0
27502,167,3428,1943,715,1694,26,18,214,1969,12,185,120,237,197,357,1436,2721,7,20915,1161,0,2,4,2,0
27503,167,3428,1168,838,957,57,25,144,1225,19,348,224,416,367,640,3018,5452,11,61921,3440,1,2,4,2,0
27504,125,5370,139,89,101,2,0,35,141,7,54,34,62,61,96,330,569,4,2287,127,0,2,30,30,0
27505,125,5370,7,5,5,0,0,2,7,1,2,1,2,3,3,2,4,0,2,0,0,2,30,30,0
27506,38,2226,334,251,279,10,4,40,344,5,127,74,143,132,217,899,1528,2,4303,239,0,2,4,0,0
27507,61,2682,1943,715,1694,26,18,214,1969,12,185,120,237,197,357,1436,2721,7,20915,1161,0,2,9,9,0
27509,448,9938,72,33,56,0,4,12,72,1,1,1,1,2,2,0,2,0,1,0,0,2,14,11,1
27510,448,9938,1454,835,1044,76,110,219,1530,17,275,158,296,292,454,2297,3718,9,34017,1889,1,2,14,11,1
27511,126,5403,139,89,101,2,0,35,141,7,54,34,62,61,96,330,569,4,2287,127,0,2,19,0,1
27512,126,5403,7,5,5,0,0,2,7,1,2,1,2,3,3,2,4,0,2,0,0,2,19,0,1
27513,454,9994,72,33,56,0,4,12,72,1,1,1,1,2,2,0,2,0,1,0,0,2,38,15,1
27514,454,9994,1454,835,1044,76,110,219,1530,17,275,158,296,292,454,2297,3718,9,34017,1889,1,2,38,15,1
27515,65,3525,1782,648,1425,9,47,279,1791,8,171,97,189,179,286,1292,2140,4,9462,525,0,2,46,0,1
27516,43,1323,1523,757,1297,19,12,193,1542,12,193,117,230,205,347,1508,2664,7,19053,1058,0,2,1,0,0
27517,43,1323,701,378,504,33,58,109,734,13,110,68,126,123,194,794,1346,7,10027,557,0,2,1,0,0
27518,43,1318,1523,757,1297,19,12,193,1542,12,193,117,230,205,347,1508,2664,7,19053,1058,0,2,1,2,0
27519,43,1318,701,378,504,33,58,109,734,13,110,68,126,123,194,794,1346,7,10027,557,0,2,1,2,0
27520,39,2430,1523,757,1297,19,12,193,1542,12,193,117,230,205,347,1508,2664,7,19053,1058,0,2,2,0,1
27521,15,465,42,7,35,4,0,5,46,1,2,1,2,3,3,2,4,0,2,0,0,2,2,1,0
27522,15,465,11,6,10,0,0,1,11,2,4,2,4,6,6,10,15,1,15,0,0,2,2,1,0
27523,43,863,447,308,343,6,5,95,453,7,96,59,111,103,170,651,1136,4,4600,255,0,2,5,1,1
27524,43,863,322,174,179,16,74,51,338,10,41,26,46,51,72,252,408,5,2291,127,0,2,5,1,1
27527,14,452,42,7,35,4,0,5,46,1,2,1,2,3,3,2,4,0,2,0,0,2,31,29,1
27528,14,452,11,6,10,0,0,1,11,2,4,2,4,6,6,10,15,1,15,0,0,2,31,29,1
27529,14,452,42,7,35,4,0,5,46,1,2,1,2,3,3,2,4,0,2,0,0,2,1,1,0
27530,14,452,11,6,10,0,0,1,11,2,4,2,4,6,6,10,15,1,15,0,0,2,1,1,0
27531,114,2482,1043,504,840,53,9,147,1096,9,180,112,198,189,310,1377,2344,4,11604,644,0,2,1,1,1
27532,114,2482,383,288,292,26,6,62,409,11,65,38,67,76,105,429,656,5,3719,206,0,2,1,1,1
27533,114,2482,1043,504,840,53,9,147,1096,9,180,112,198,189,310,1377,2344,4,11604,644,0,2,1,1,0
27534,114,2482,383,288,292,26,6,62,409,11,65,38,67,76,105,429,656,5,3719,206,0,2,1,1,0
27535,229,4732,1457,730,1242,11,6,188,1468,10,292,166,329,302,495,2424,4078,5,22973,1276,1,2,11,3,1
27536,229,4732,74,35,59,1,0,14,75,3,14,7,14,17,21,58,85,1,128,7,0,2,11,3,1
27537,229,4732,245,125,200,5,7,34,250,7,30,17,34,37,51,166,265,3,1053,58,0,2,11,3,1
27538,39,1827,1457,730,1242,11,6,188,1468,10,292,166,329,302,495,2424,4078,5,22973,1276,1,2,9,0,1
27539,14,452,42,7,35,4,0,5,46,1,2,1,2,3,3,2,4,0,2,0,0,2,31,29,0
27540,14,452,11,6,10,0,0,1,11,2,4,2,4,6,6,10,15,1,15,0,0,2,31,29,0
27541,55,1940,1450,624,1228,12,26,181,1462,14,306,186,354,320,540,2580,4493,8,36391,2021,1,2,1,1,0
27542,1,282,382,65,130,157,2,92,539,4,10,5,10,14,15,41,57,2,114,6,0,2,1,1,0
27543,1,285,382,65,130,157,2,92,539,4,10,5,10,14,15,41,57,2,114,6,0,2,1,1,0
27544,45,445,647,139,84,35,284,233,682,0,0,0,0,0,0,0,0,0,0,0,0,2,1,1,0
27545,45,445,647,139,84,35,284,233,682,0,0,0,0,0,0,0,0,0,0,0,0,2,6,6,0
27547,127,5436,139,89,101,2,0,35,141,7,54,34,62,61,96,330,569,4,2287,127,0,2,24,0,1
27548,127,5436,7,5,5,0,0,2,7,1,2,1,2,3,3,2,4,0,2,0,0,2,24,0,1
27549,55,1934,1450,624,1228,12,26,181,1462,14,306,186,354,320,540,2580,4493,8,36391,2021,1,2,0,1,0
27550,108,4145,1513,682,1277,25,13,200,1538,11,199,116,219,210,335,1557,2584,6,15641,868,0,2,2,19,0
27551,39,1833,1457,730,1242,11,6,188,1468,10,292,166,329,302,495,2424,4078,5,22973,1276,1,2,2,2,0
27552,234,4805,1457,730,1242,11,6,188,1468,10,292,166,329,302,495,2424,4078,5,22973,1276,1,2,8,0,1
27553,234,4805,74,35,59,1,0,14,75,3,14,7,14,17,21,58,85,1,128,7,0,2,8,0,1
27554,234,4805,245,125,200,5,7,34,250,7,30,17,34,37,51,166,265,3,1053,58,0,2,8,0,1
27555,171,3890,77,34,69,0,0,8,77,3,24,16,29,27,45,114,213,1,387,21,0,2,3,0,1
27556,171,3890,712,438,573,51,9,84,763,14,102,71,128,116,199,733,1364,8,11988,666,0,2,3,0,1
27557,40,1882,1457,730,1242,11,6,188,1468,10,292,166,329,302,495,2424,4078,5,22973,1276,1,2,15,0,1
27558,231,4784,1457,730,1242,11,6,188,1468,10,292,166,329,302,495,2424,4078,5,22973,1276,1,2,9,9,1
27559,231,4784,74,35,59,1,0,14,75,3,14,7,14,17,21,58,85,1,128,7,0,2,9,9,1
27560,231,4784,245,125,200,5,7,34,250,7,30,17,34,37,51,166,265,3,1053,58,0,2,9,9,1
27561,171,3890,77,34,69,0,0,8,77,3,24,16,29,27,45,114,213,1,387,21,0,2,1,2,1
27562,171,3890,712,438,573,51,9,84,763,14,102,71,128,116,199,733,1364,8,11988,666,0,2,1,2,1
27563,231,4784,1457,730,1242,11,6,188,1468,10,292,166,329,302,495,2424,4078,5,22973,1276,1,2,9,1,0
27564,231,4784,74,35,59,1,0,14,75,3,14,7,14,17,21,58,85,1,128,7,0,2,9,1,0
27565,231,4784,245,125,200,5,7,34,250,7,30,17,34,37,51,166,265,3,1053,58,0,2,9,1,0
27566,171,3890,77,34,69,0,0,8,77,3,24,16,29,27,45,114,213,1,387,21,0,2,2,0,0
27567,171,3890,712,438,573,51,9,84,763,14,102,71,128,116,199,733,1364,8,11988,666,0,2,2,0,0
27568,40,1882,1457,730,1242,11,6,188,1468,10,292,166,329,302,495,2424,4078,5,22973,1276,1,2,15,0,0
27592,172,3908,77,34,69,0,0,8,77,3,24,16,29,27,45,114,213,1,387,21,0,2,7,3,1
27593,172,3908,712,438,573,51,9,84,763,14,102,71,128,116,199,733,1364,8,11988,666,0,2,7,3,1
27594,450,9943,72,33,56,0,4,12,72,1,1,1,1,2,2,0,2,0,1,0,0,2,10,2,1
27595,450,9943,1454,835,1044,76,110,219,1530,17,275,158,296,292,454,2297,3718,9,34017,1889,1,2,10,2,1
27596,167,3430,1943,715,1694,26,18,214,1969,12,185,120,237,197,357,1436,2721,7,20915,1161,0,2,2,2,1
27597,167,3430,1168,838,957,57,25,144,1225,19,348,224,416,367,640,3018,5452,11,61921,3440,1,2,2,2,1
27598,14,452,42,7,35,4,0,5,46,1,2,1,2,3,3,2,4,0,2,0,0,2,2,2,1
27599,14,452,11,6,10,0,0,1,11,2,4,2,4,6,6,10,15,1,15,0,0,2,2,2,1
27601,55,1982,1450,624,1228,12,26,181,1462,14,306,186,354,320,540,2580,4493,8,36391,2021,1,2,20,1,1
27602,61,2682,1943,715,1694,26,18,214,1969,12,185,120,237,197,357,1436,2721,7,20915,1161,0,2,3,3,1
27603,231,4784,1457,730,1242,11,6,188,1468,10,292,166,329,302,495,2424,4078,5,22973,1276,1,2,2,1,1
27604,231,4784,74,35,59,1,0,14,75,3,14,7,14,17,21,58,85,1,128,7,0,2,2,1,1
27605,231,4784,245,125,200,5,7,34,250,7,30,17,34,37,51,166,265,3,1053,58,0,2,2,1,1
27606,171,3870,77,34,69,0,0,8,77,3,24,16,29,27,45,114,213,1,387,21,0,2,1,1,1
27607,171,3870,712,438,573,51,9,84,763,14,102,71,128,116,199,733,1364,8,11988,666,0,2,1,1,1
27608,172,3910,77,34,69,0,0,8,77,3,24,16,29,27,45,114,213,1,387,21,0,2,1,1,0
27609,172,3910,712,438,573,51,9,84,763,14,102,71,128,116,199,733,1364,8,11988,666,0,2,1,1,0
27610,23,1010,1455,414,1257,16,76,112,1471,5,41,23,46,46,69,231,381,2,1069,59,0,2,2,0,0
27611,43,1318,1523,757,1297,19,12,193,1542,12,193,117,230,205,347,1508,2664,7,19053,1058,0,2,1,1,0
27612,43,1318,701,378,504,33,58,109,734,13,110,68,126,123,194,794,1346,7,10027,557,0,2,1,1,0
27613,39,2430,1523,757,1297,19,12,193,1542,12,193,117,230,205,347,1508,2664,7,19053,1058,0,2,2,0,0
27664,1,285,382,65,130,157,2,92,539,4,10,5,10,14,15,41,57,2,114,6,0,2,1,1,1
27665,1,285,382,65,130,157,2,92,539,4,10,5,10,14,15,41,57,2,114,6,0,2,2,2,1
27666,128,5483,139,89,101,2,0,35,141,7,54,34,62,61,96,330,569,4,2287,127,0,2,29,0,0
27667,128,5483,7,5,5,0,0,2,7,1,2,1,2,3,3,2,4,0,2,0,0,2,29,0,0
27691,231,4784,1457,730,1242,11,6,188,1468,10,292,166,329,302,495,2424,4078,5,22973,1276,1,2,11,2,0
27692,231,4784,74,35,59,1,0,14,75,3,14,7,14,17,21,58,85,1,128,7,0,2,11,2,0
27693,231,4784,245,125,200,5,7,34,250,7,30,17,34,37,51,166,265,3,1053,58,0,2,11,2,0
27696,172,3910,77,34,69,0,0,8,77,3,24,16,29,27,45,114,213,1,387,21,0,2,10,4,0
27697,172,3910,712,438,573,51,9,84,763,14,102,71,128,116,199,733,1364,8,11988,666,0,2,10,4,0
27698,452,9989,72,33,56,0,4,12,72,1,1,1,1,2,2,0,2,0,1,0,0,2,10,2,0
27699,452,9989,1454,835,1044,76,110,219,1530,17,275,158,296,292,454,2297,3718,9,34017,1889,1,2,10,2,0
27700,167,3430,1943,715,1694,26,18,214,1969,12,185,120,237,197,357,1436,2721,7,20915,1161,0,2,2,2,0
27701,167,3430,1168,838,957,57,25,144,1225,19,348,224,416,367,640,3018,5452,11,61921,3440,1,2,2,2,0
27703,14,452,42,7,35,4,0,5,46,1,2,1,2,3,3,2,4,0,2,0,0,2,2,2,0
27704,14,452,11,6,10,0,0,1,11,2,4,2,4,6,6,10,15,1,15,0,0,2,2,2,0
27706,55,1982,1450,624,1228,12,26,181,1462,14,306,186,354,320,540,2580,4493,8,36391,2021,1,2,20,2,0
27708,40,1882,1457,730,1242,11,6,188,1468,10,292,166,329,302,495,2424,4078,5,22973,1276,1,2,17,2,0
27711,61,2682,1943,715,1694,26,18,214,1969,12,185,120,237,197,357,1436,2721,7,20915,1161,0,2,3,3,0
27712,1,285,382,65,130,157,2,92,539,4,10,5,10,14,15,41,57,2,114,6,0,2,2,2,0
27713,90,1584,1178,367,1042,6,15,115,1184,9,94,51,95,103,146,644,976,4,4439,246,0,2,19,4,1
27714,90,1584,177,108,140,8,0,27,185,6,30,16,32,36,48,162,248,3,794,44,0,2,19,4,1
27715,47,2038,1178,367,1042,6,15,115,1184,9,94,51,95,103,146,644,976,4,4439,246,0,2,48,2,1
27716,29,809,465,148,393,5,8,60,470,4,31,20,31,35,51,161,261,2,523,29,0,2,20,0,0
27717,29,809,16,12,9,0,0,6,16,1,2,1,2,3,3,2,4,0,2,0,0,2,20,0,0
27718,89,1573,1178,367,1042,6,15,115,1184,9,94,51,95,103,146,644,976,4,4439,246,0,2,3,6,1
27719,89,1573,177,108,140,8,0,27,185,6,30,16,32,36,48,162,248,3,794,44,0,2,3,6,1
27720,44,1992,1178,367,1042,6,15,115,1184,9,94,51,95,103,146,644,976,4,4439,246,0,2,13,38,1
27721,7,103,38,23,23,0,0,15,38,0,0,0,0,0,0,0,0,0,0,0,0,2,5,0,0
27722,44,1989,1178,367,1042,6,15,115,1184,9,94,51,95,103,146,644,976,4,4439,246,0,2,7,9,0
27723,7,102,38,23,23,0,0,15,38,0,0,0,0,0,0,0,0,0,0,0,0,2,1,1,0
27724,454,10020,72,33,56,0,4,12,72,1,1,1,1,2,2,0,2,0,1,0,0,2,22,7,1
27725,454,10020,1454,835,1044,76,110,219,1530,17,275,158,296,292,454,2297,3718,9,34017,1889,1,2,22,7,1
27726,454,10020,72,33,56,0,4,12,72,1,1,1,1,2,2,0,2,0,1,0,0,2,4,2,1
27727,454,10020,1454,835,1044,76,110,219,1530,17,275,158,296,292,454,2297,3718,9,34017,1889,1,2,4,2,1
27728,89,1573,1178,367,1042,6,15,115,1184,9,94,51,95,103,146,644,976,4,4439,246,0,2,16,4,0
27729,89,1573,177,108,140,8,0,27,185,6,30,16,32,36,48,162,248,3,794,44,0,2,16,4,0
27730,7,102,38,23,23,0,0,15,38,0,0,0,0,0,0,0,0,0,0,0,0,2,5,0,0
27731,44,1989,1178,367,1042,6,15,115,1184,9,94,51,95,103,146,644,976,4,4439,246,0,2,21,2,0
27757,454,10020,72,33,56,0,4,12,72,1,1,1,1,2,2,0,2,0,1,0,0,2,24,7,0
27758,454,10020,1454,835,1044,76,110,219,1530,17,275,158,296,292,454,2297,3718,9,34017,1889,1,2,24,7,0
27761,454,10012,72,33,56,0,4,12,72,1,1,1,1,2,2,0,2,0,1,0,0,2,12,23,1
27762,454,10012,1454,835,1044,76,110,219,1530,17,275,158,296,292,454,2297,3718,9,34017,1889,1,2,12,23,1
27763,232,4811,1457,730,1242,11,6,188,1468,10,292,166,329,302,495,2424,4078,5,22973,1276,1,2,5,0,1
27764,232,4811,74,35,59,1,0,14,75,3,14,7,14,17,21,58,85,1,128,7,0,2,5,0,1
27765,232,4811,245,125,200,5,7,34,250,7,30,17,34,37,51,166,265,3,1053,58,0,2,5,0,1
27766,27,1535,652,304,544,16,6,88,668,6,89,51,101,95,152,591,998,3,3399,188,0,2,18,0,1
27767,234,4833,1457,730,1242,11,6,188,1468,10,292,166,329,302,495,2424,4078,5,22973,1276,1,2,7,3,1
27768,234,4833,74,35,59,1,0,14,75,3,14,7,14,17,21,58,85,1,128,7,0,2,7,3,1
27769,234,4833,245,125,200,5,7,34,250,7,30,17,34,37,51,166,265,3,1053,58,0,2,7,3,1
27770,38,2236,334,251,279,10,4,40,344,5,127,74,143,132,217,899,1528,2,4303,239,0,2,11,2,1
27771,113,2244,1513,682,1277,25,13,200,1538,11,199,116,219,210,335,1557,2584,6,15641,868,0,2,1,3,0
27772,113,2244,819,519,539,24,98,155,843,15,96,57,106,111,163,690,1107,8,9171,509,0,2,1,3,0
27773,108,4168,1513,682,1277,25,13,200,1538,11,199,116,219,210,335,1557,2584,6,15641,868,0,2,3,2,0
27774,233,4817,1457,730,1242,11,6,188,1468,10,292,166,329,302,495,2424,4078,5,22973,1276,1,2,4,7,0
27775,233,4817,74,35,59,1,0,14,75,3,14,7,14,17,21,58,85,1,128,7,0,2,4,7,0
27776,233,4817,245,125,200,5,7,34,250,7,30,17,34,37,51,166,265,3,1053,58,0,2,4,7,0
27777,38,2236,334,251,279,10,4,40,344,5,127,74,143,132,217,899,1528,2,4303,239,0,2,6,4,0
27778,233,4817,1457,730,1242,11,6,188,1468,10,292,166,329,302,495,2424,4078,5,22973,1276,1,2,9,3,0
27779,233,4817,74,35,59,1,0,14,75,3,14,7,14,17,21,58,85,1,128,7,0,2,9,3,0
27780,233,4817,245,125,200,5,7,34,250,7,30,17,34,37,51,166,265,3,1053,58,0,2,9,3,0
27781,27,1535,652,304,544,16,6,88,668,6,89,51,101,95,152,591,998,3,3399,188,0,2,18,0,0
27782,38,2236,334,251,279,10,4,40,344,5,127,74,143,132,217,899,1528,2,4303,239,0,2,13,2,0
27785,2,26,6,4,4,0,0,2,6,1,4,2,4,5,6,8,13,0,6,0,0,0,6,0,1
27790,77,1700,477,336,357,30,23,73,507,16,194,134,250,210,384,1538,2962,10,30538,1696,0,2,9,7,1
27791,233,4771,1457,730,1242,11,6,188,1468,10,292,166,329,302,495,2424,4078,5,22973,1276,1,2,20,15,1
27792,233,4771,74,35,59,1,0,14,75,3,14,7,14,17,21,58,85,1,128,7,0,2,20,15,1
27793,233,4771,245,125,200,5,7,34,250,7,30,17,34,37,51,166,265,3,1053,58,0,2,20,15,1
27794,26,866,1455,414,1257,16,76,112,1471,5,41,23,46,46,69,231,381,2,1069,59,0,2,8,7,1
27795,26,866,669,365,481,22,61,110,691,15,103,63,122,118,185,747,1273,8,11311,628,0,2,8,7,1
27796,43,1312,1523,757,1297,19,12,193,1542,12,193,117,230,205,347,1508,2664,7,19053,1058,0,2,3,2,1
27797,43,1312,701,378,504,33,58,109,734,13,110,68,126,123,194,794,1346,7,10027,557,0,2,3,2,1
27798,172,3904,77,34,69,0,0,8,77,3,24,16,29,27,45,114,213,1,387,21,0,2,3,2,1
27799,172,3904,712,438,573,51,9,84,763,14,102,71,128,116,199,733,1364,8,11988,666,0,2,3,2,1
27800,21,545,1293,570,1093,25,15,163,1318,10,195,123,241,205,364,1516,2795,6,17273,959,0,2,12,8,1
27801,198,4430,722,423,573,19,0,135,741,12,172,101,199,184,300,1320,2257,6,15668,870,0,2,22,17,1
27802,198,4430,1508,847,911,44,250,301,1552,14,148,88,169,162,257,1120,1886,7,15077,837,0,2,22,17,1
27803,18,440,386,256,301,16,9,68,402,4,59,35,69,63,104,355,621,2,1453,80,0,2,11,15,1
27804,18,440,264,131,164,11,41,46,275,6,38,22,40,44,62,214,338,3,1068,59,0,2,11,15,1
27805,114,2480,1043,504,840,53,9,147,1096,9,180,112,198,189,310,1377,2344,4,11604,644,0,2,4,3,1
27806,114,2480,383,288,292,26,6,62,409,11,65,38,67,76,105,429,656,5,3719,206,0,2,4,3,1
27807,89,1565,1178,367,1042,6,15,115,1184,9,94,51,95,103,146,644,976,4,4439,246,0,2,7,4,1
27808,89,1565,177,108,140,8,0,27,185,6,30,16,32,36,48,162,248,3,794,44,0,2,7,4,1
27809,167,3416,1943,715,1694,26,18,214,1969,12,185,120,237,197,357,1436,2721,7,20915,1161,0,2,6,4,1
27810,167,3416,1168,838,957,57,25,144,1225,19,348,224,416,367,640,3018,5452,11,61921,3440,1,2,6,4,1
27811,12,371,442,244,305,14,16,103,456,11,68,45,75,79,120,452,756,6,4588,254,0,2,6,2,1
27812,12,371,182,102,99,11,40,35,193,3,11,6,11,14,17,42,64,1,97,5,0,2,6,2,1
27813,55,1039,1098,241,925,5,10,155,1103,7,46,25,49,53,74,273,423,3,1580,87,0,2,9,3,1
27814,55,1039,282,202,222,14,2,44,296,8,42,24,43,50,67,250,378,4,1548,86,0,2,9,3,1
27815,108,4168,1513,682,1277,25,13,200,1538,11,199,116,219,210,335,1557,2584,6,15641,868,0,2,0,2,0
27816,231,4764,1457,730,1242,11,6,188,1468,10,292,166,329,302,495,2424,4078,5,22973,1276,1,2,1,10,1
27817,231,4764,74,35,59,1,0,14,75,3,14,7,14,17,21,58,85,1,128,7,0,2,1,10,1
27818,231,4764,245,125,200,5,7,34,250,7,30,17,34,37,51,166,265,3,1053,58,0,2,1,10,1
27819,166,3413,1943,715,1694,26,18,214,1969,12,185,120,237,197,357,1436,2721,7,20915,1161,0,2,0,3,1
27820,166,3413,1168,838,957,57,25,144,1225,19,348,224,416,367,640,3018,5452,11,61921,3440,1,2,0,3,1
27821,128,5483,139,89,101,2,0,35,141,7,54,34,62,61,96,330,569,4,2287,127,0,2,28,28,1
27822,128,5483,7,5,5,0,0,2,7,1,2,1,2,3,3,2,4,0,2,0,0,2,28,28,1
27823,27,1535,652,304,544,16,6,88,668,6,89,51,101,95,152,591,998,3,3399,188,0,2,1,1,1
27824,37,2191,334,251,279,10,4,40,344,5,127,74,143,132,217,899,1528,2,4303,239,0,2,0,15,1
27826,108,4168,1513,682,1277,25,13,200,1538,11,199,116,219,210,335,1557,2584,6,15641,868,0,2,2,0,0
27850,42,1271,1523,757,1297,19,12,193,1542,12,193,117,230,205,347,1508,2664,7,19053,1058,0,2,4,17,1
27851,42,1271,701,378,504,33,58,109,734,13,110,68,126,123,194,794,1346,7,10027,557,0,2,4,17,1
27852,52,1014,1098,241,925,5,10,155,1103,7,46,25,49,53,74,273,423,3,1580,87,0,2,10,17,1
27853,52,1014,282,202,222,14,2,44,296,8,42,24,43,50,67,250,378,4,1548,86,0,2,10,17,1
27854,14,452,42,7,35,4,0,5,46,1,2,1,2,3,3,2,4,0,2,0,0,2,1,1,1
27855,14,452,11,6,10,0,0,1,11,2,4,2,4,6,6,10,15,1,15,0,0,2,1,1,1
27879,77,1700,477,336,357,30,23,73,507,16,194,134,250,210,384,1538,2962,10,30538,1696,0,2,9,7,0
27880,231,4718,1457,730,1242,11,6,188,1468,10,292,166,329,302,495,2424,4078,5,22973,1276,1,2,20,15,0
27881,231,4718,74,35,59,1,0,14,75,3,14,7,14,17,21,58,85,1,128,7,0,2,20,15,0
27882,231,4718,245,125,200,5,7,34,250,7,30,17,34,37,51,166,265,3,1053,58,0,2,20,15,0
27883,26,866,1455,414,1257,16,76,112,1471,5,41,23,46,46,69,231,381,2,1069,59,0,2,8,7,0
27884,26,866,669,365,481,22,61,110,691,15,103,63,122,118,185,747,1273,8,11311,628,0,2,8,7,0
27885,42,1271,1523,757,1297,19,12,193,1542,12,193,117,230,205,347,1508,2664,7,19053,1058,0,2,4,16,0
27886,42,1271,701,378,504,33,58,109,734,13,110,68,126,123,194,794,1346,7,10027,557,0,2,4,16,0
27887,172,3904,77,34,69,0,0,8,77,3,24,16,29,27,45,114,213,1,387,21,0,2,3,2,0
27888,172,3904,712,438,573,51,9,84,763,14,102,71,128,116,199,733,1364,8,11988,666,0,2,3,2,0
27889,21,545,1293,570,1093,25,15,163,1318,10,195,123,241,205,364,1516,2795,6,17273,959,0,2,12,8,0
27890,198,4430,722,423,573,19,0,135,741,12,172,101,199,184,300,1320,2257,6,15668,870,0,2,22,17,0
27891,198,4430,1508,847,911,44,250,301,1552,14,148,88,169,162,257,1120,1886,7,15077,837,0,2,22,17,0
27892,18,440,386,256,301,16,9,68,402,4,59,35,69,63,104,355,621,2,1453,80,0,2,11,15,0
27893,18,440,264,131,164,11,41,46,275,6,38,22,40,44,62,214,338,3,1068,59,0,2,11,15,0
27894,114,2480,1043,504,840,53,9,147,1096,9,180,112,198,189,310,1377,2344,4,11604,644,0,2,4,3,0
27895,114,2480,383,288,292,26,6,62,409,11,65,38,67,76,105,429,656,5,3719,206,0,2,4,3,0
27896,89,1565,1178,367,1042,6,15,115,1184,9,94,51,95,103,146,644,976,4,4439,246,0,2,7,4,0
27897,89,1565,177,108,140,8,0,27,185,6,30,16,32,36,48,162,248,3,794,44,0,2,7,4,0
27898,166,3399,1943,715,1694,26,18,214,1969,12,185,120,237,197,357,1436,2721,7,20915,1161,0,2,6,4,0
27899,166,3399,1168,838,957,57,25,144,1225,19,348,224,416,367,640,3018,5452,11,61921,3440,1,2,6,4,0
27900,12,371,442,244,305,14,16,103,456,11,68,45,75,79,120,452,756,6,4588,254,0,2,6,2,0
27901,12,371,182,102,99,11,40,35,193,3,11,6,11,14,17,42,64,1,97,5,0,2,6,2,0
27902,52,1014,1098,241,925,5,10,155,1103,7,46,25,49,53,74,273,423,3,1580,87,0,2,17,18,0
27903,52,1014,282,202,222,14,2,44,296,8,42,24,43,50,67,250,378,4,1548,86,0,2,17,18,0
27906,132,4072,1660,832,1314,41,38,274,1701,20,312,209,395,332,604,2671,5058,12,64042,3557,1,2,4,1,1
27907,132,4072,1057,646,719,113,100,145,1170,18,215,134,248,233,382,1740,3004,10,31186,1732,1,2,4,1,1
27908,118,3030,1660,832,1314,41,38,274,1701,20,312,209,395,332,604,2671,5058,12,64042,3557,1,2,22,0,1
27909,133,4121,1660,832,1314,41,38,274,1701,20,312,209,395,332,604,2671,5058,12,64042,3557,1,2,10,5,0
27910,133,4121,1057,646,719,113,100,145,1170,18,215,134,248,233,382,1740,3004,10,31186,1732,1,2,10,5,0
27911,131,4107,1660,832,1314,41,38,274,1701,20,312,209,395,332,604,2671,5058,12,64042,3557,1,2,12,8,0
27912,131,4107,1057,646,719,113,100,145,1170,18,215,134,248,233,382,1740,3004,10,31186,1732,1,2,12,8,0
27913,118,3030,1660,832,1314,41,38,274,1701,20,312,209,395,332,604,2671,5058,12,64042,3557,1,2,22,0,0
27937,113,2247,1513,682,1277,25,13,200,1538,11,199,116,219,210,335,1557,2584,6,15641,868,0,2,1,0,0
27938,113,2247,819,519,539,24,98,155,843,15,96,57,106,111,163,690,1107,8,9171,509,0,2,1,0,0
27941,109,4195,1513,682,1277,25,13,200,1538,11,199,116,219,210,335,1557,2584,6,15641,868,0,2,10,0,0
27942,114,2252,1513,682,1277,25,13,200,1538,11,199,116,219,210,335,1557,2584,6,15641,868,0,2,2,1,1
27943,114,2252,819,519,539,24,98,155,843,15,96,57,106,111,163,690,1107,8,9171,509,0,2,2,1,1
27944,114,2261,1513,682,1277,25,13,200,1538,11,199,116,219,210,335,1557,2584,6,15641,868,0,2,6,2,1
27945,114,2261,819,519,539,24,98,155,843,15,96,57,106,111,163,690,1107,8,9171,509,0,2,6,2,1
27946,114,2261,1513,682,1277,25,13,200,1538,11,199,116,219,210,335,1557,2584,6,15641,868,0,2,3,3,1
27947,114,2261,819,519,539,24,98,155,843,15,96,57,106,111,163,690,1107,8,9171,509,0,2,3,3,1
27971,7,103,38,23,23,0,0,15,38,0,0,0,0,0,0,0,0,0,0,0,0,2,1,1,1
27974,1,288,382,65,130,157,2,92,539,4,10,5,10,14,15,41,57,2,114,6,0,2,2,2,0
28000,114,2255,1513,682,1277,25,13,200,1538,11,199,116,219,210,335,1557,2584,6,15641,868,0,2,2,6,0
28001,114,2255,819,519,539,24,98,155,843,15,96,57,106,111,163,690,1107,8,9171,509,0,2,2,6,0
28002,114,2264,1513,682,1277,25,13,200,1538,11,199,116,219,210,335,1557,2584,6,15641,868,0,2,2,0,0
28003,114,2264,819,519,539,24,98,155,843,15,96,57,106,111,163,690,1107,8,9171,509,0,2,2,0,0
28004,173,3920,77,34,69,0,0,8,77,3,24,16,29,27,45,114,213,1,387,21,0,2,2,0,0
28005,173,3920,712,438,573,51,9,84,763,14,102,71,128,116,199,733,1364,8,11988,666,0,2,2,0,0
28034,231,4718,1457,730,1242,11,6,188,1468,10,292,166,329,302,495,2424,4078,5,22973,1276,1,2,21,25,0
28035,231,4718,74,35,59,1,0,14,75,3,14,7,14,17,21,58,85,1,128,7,0,2,21,25,0
28036,231,4718,245,125,200,5,7,34,250,7,30,17,34,37,51,166,265,3,1053,58,0,2,21,25,0
28052,166,3399,1943,715,1694,26,18,214,1969,12,185,120,237,197,357,1436,2721,7,20915,1161,0,2,6,7,0
28053,166,3399,1168,838,957,57,25,144,1225,19,348,224,416,367,640,3018,5452,11,61921,3440,1,2,6,7,0
28059,7,103,38,23,23,0,0,15,38,0,0,0,0,0,0,0,0,0,0,0,0,2,1,1,0
28062,128,5483,139,89,101,2,0,35,141,7,54,34,62,61,96,330,569,4,2287,127,0,2,28,28,0
28063,128,5483,7,5,5,0,0,2,7,1,2,1,2,3,3,2,4,0,2,0,0,2,28,28,0
28066,27,1535,652,304,544,16,6,88,668,6,89,51,101,95,152,591,998,3,3399,188,0,2,1,1,0
28067,37,2191,334,251,279,10,4,40,344,5,127,74,143,132,217,899,1528,2,4303,239,0,2,0,15,0
28071,50,2018,1043,504,840,53,9,147,1096,9,180,112,198,189,310,1377,2344,4,11604,644,0,2,10,1,1
28072,133,4157,1660,832,1314,41,38,274,1701,20,312,209,395,332,604,2671,5058,12,64042,3557,1,2,9,1,1
28073,133,4157,1057,646,719,113,100,145,1170,18,215,134,248,233,382,1740,3004,10,31186,1732,1,2,9,1,1
28074,121,3087,1660,832,1314,41,38,274,1701,20,312,209,395,332,604,2671,5058,12,64042,3557,1,2,11,0,1
28075,110,4226,1513,682,1277,25,13,200,1538,11,199,116,219,210,335,1557,2584,6,15641,868,0,2,10,0,1
28076,133,4158,1660,832,1314,41,38,274,1701,20,312,209,395,332,604,2671,5058,12,64042,3557,1,2,7,0,0
28077,133,4158,1057,646,719,113,100,145,1170,18,215,134,248,233,382,1740,3004,10,31186,1732,1,2,7,0,0
28078,133,4158,1660,832,1314,41,38,274,1701,20,312,209,395,332,604,2671,5058,12,64042,3557,1,2,6,3,0
28079,133,4158,1057,646,719,113,100,145,1170,18,215,134,248,233,382,1740,3004,10,31186,1732,1,2,6,3,0
28080,136,4252,1660,832,1314,41,38,274,1701,20,312,209,395,332,604,2671,5058,12,64042,3557,1,2,118,6,1
28081,136,4252,1057,646,719,113,100,145,1170,18,215,134,248,233,382,1740,3004,10,31186,1732,1,2,118,6,1
28082,77,1717,477,336,357,30,23,73,507,16,194,134,250,210,384,1538,2962,10,30538,1696,0,2,5,4,1
28083,60,1070,282,196,195,3,0,86,285,8,130,71,141,138,212,936,1507,4,6538,363,0,2,24,0,1
28084,63,2320,1450,624,1228,12,26,181,1462,14,306,186,354,320,540,2580,4493,8,36391,2021,1,2,79,1,1
28085,122,3201,1660,832,1314,41,38,274,1701,20,312,209,395,332,604,2671,5058,12,64042,3557,1,2,50,1,1
28086,1,84,13,10,10,0,0,3,13,1,2,1,2,3,3,2,4,0,2,0,0,2,1,1,0
28087,133,4158,1660,832,1314,41,38,274,1701,20,312,209,395,332,604,2671,5058,12,64042,3557,1,2,19,1,0
28088,133,4158,1057,646,719,113,100,145,1170,18,215,134,248,233,382,1740,3004,10,31186,1732,1,2,19,1,0
28089,121,3087,1660,832,1314,41,38,274,1701,20,312,209,395,332,604,2671,5058,12,64042,3557,1,2,11,0,0
28090,50,2028,1043,504,840,53,9,147,1096,9,180,112,198,189,310,1377,2344,4,11604,644,0,2,1,0,0
28091,133,4206,1660,832,1314,41,38,274,1701,20,312,209,395,332,604,2671,5058,12,64042,3557,1,2,22,17,1
28092,133,4206,1057,646,719,113,100,145,1170,18,215,134,248,233,382,1740,3004,10,31186,1732,1,2,22,17,1
28093,121,3095,1660,832,1314,41,38,274,1701,20,312,209,395,332,604,2671,5058,12,64042,3557,1,2,2,2,1
28094,133,4194,1660,832,1314,41,38,274,1701,20,312,209,395,332,604,2671,5058,12,64042,3557,1,2,0,1,0
28095,133,4194,1057,646,719,113,100,145,1170,18,215,134,248,233,382,1740,3004,10,31186,1732,1,2,0,1,0
28098,50,2028,1043,504,840,53,9,147,1096,9,180,112,198,189,310,1377,2344,4,11604,644,0,2,11,1,0
28100,2,26,6,4,4,0,0,2,6,1,4,2,4,5,6,8,13,0,6,0,0,0,6,0,0
28102,7,292,72,33,56,0,4,12,72,1,1,1,1,2,2,0,2,0,1,0,0,2,1,1,1
28103,38,707,127,75,83,2,11,30,129,4,14,7,14,18,21,61,87,2,175,9,0,2,3,5,1
28104,38,707,652,304,544,16,6,88,668,6,89,51,101,95,152,591,998,3,3399,188,0,2,3,5,1
28105,38,707,2,2,2,0,0,0,2,0,0,0,0,0,0,0,0,0,0,0,0,2,3,5,1
28106,38,707,8,5,5,0,0,3,8,0,0,0,0,0,0,0,0,0,0,0,0,2,3,5,1
28109,38,707,14,8,8,0,0,6,14,0,0,0,0,0,0,0,0,0,0,0,0,2,3,5,1
28110,38,707,6,4,4,0,0,2,6,0,0,0,0,0,0,0,0,0,0,0,0,2,3,5,1
28111,38,707,6,4,4,0,0,2,6,1,2,1,2,3,3,2,4,0,2,0,0,2,3,5,1
28113,38,707,7,5,5,0,0,2,7,0,0,0,0,0,0,0,0,0,0,0,0,2,3,5,1
28115,38,707,10,6,6,0,0,4,10,0,0,0,0,0,0,0,0,0,0,0,0,2,3,5,1
28116,38,707,1,1,1,0,0,0,1,0,0,0,0,0,0,0,0,0,0,0,0,2,3,5,1
28118,38,707,14,10,10,0,0,4,14,1,1,1,1,2,2,0,2,0,1,0,0,2,3,5,1
28119,38,707,46,26,30,3,0,12,49,3,6,3,6,9,9,20,28,1,42,2,0,2,3,5,1
28143,1,288,382,65,130,157,2,92,539,4,10,5,10,14,15,41,57,2,114,6,0,2,1,1,1
28171,113,2252,1513,682,1277,25,13,200,1538,11,199,116,219,210,335,1557,2584,6,15641,868,0,2,1,4,0
28172,113,2252,819,519,539,24,98,155,843,15,96,57,106,111,163,690,1107,8,9171,509,0,2,1,4,0
28173,172,3915,77,34,69,0,0,8,77,3,24,16,29,27,45,114,213,1,387,21,0,2,3,4,0
28174,172,3915,712,438,573,51,9,84,763,14,102,71,128,116,199,733,1364,8,11988,666,0,2,3,4,0
28175,110,4226,1513,682,1277,25,13,200,1538,11,199,116,219,210,335,1557,2584,6,15641,868,0,2,6,6,0
28176,113,2252,1513,682,1277,25,13,200,1538,11,199,116,219,210,335,1557,2584,6,15641,868,0,2,1,1,0
28177,113,2252,819,519,539,24,98,155,843,15,96,57,106,111,163,690,1107,8,9171,509,0,2,1,1,0
28178,172,3915,77,34,69,0,0,8,77,3,24,16,29,27,45,114,213,1,387,21,0,2,3,2,0
28179,172,3915,712,438,573,51,9,84,763,14,102,71,128,116,199,733,1364,8,11988,666,0,2,3,2,0
28180,110,4226,1513,682,1277,25,13,200,1538,11,199,116,219,210,335,1557,2584,6,15641,868,0,2,10,0,0
28181,38,705,127,75,83,2,11,30,129,4,14,7,14,18,21,61,87,2,175,9,0,2,1,1,0
28182,38,705,652,304,544,16,6,88,668,6,89,51,101,95,152,591,998,3,3399,188,0,2,1,1,0
28183,38,705,2,2,2,0,0,0,2,0,0,0,0,0,0,0,0,0,0,0,0,2,1,1,0
28184,38,705,8,5,5,0,0,3,8,0,0,0,0,0,0,0,0,0,0,0,0,2,1,1,0
28187,38,705,14,8,8,0,0,6,14,0,0,0,0,0,0,0,0,0,0,0,0,2,1,1,0
28188,38,705,6,4,4,0,0,2,6,0,0,0,0,0,0,0,0,0,0,0,0,2,1,1,0
28189,38,705,6,4,4,0,0,2,6,1,2,1,2,3,3,2,4,0,2,0,0,2,1,1,0
28191,38,705,7,5,5,0,0,2,7,0,0,0,0,0,0,0,0,0,0,0,0,2,1,1,0
28193,38,705,10,6,6,0,0,4,10,0,0,0,0,0,0,0,0,0,0,0,0,2,1,1,0
28194,38,705,1,1,1,0,0,0,1,0,0,0,0,0,0,0,0,0,0,0,0,2,1,1,0
28196,38,705,14,10,10,0,0,4,14,1,1,1,1,2,2,0,2,0,1,0,0,2,1,1,0
28197,38,705,46,26,30,3,0,12,49,3,6,3,6,9,9,20,28,1,42,2,0,2,1,1,0
28223,455,10020,72,33,56,0,4,12,72,1,1,1,1,2,2,0,2,0,1,0,0,2,6,1,1
28224,455,10020,1454,835,1044,76,110,219,1530,17,275,158,296,292,454,2297,3718,9,34017,1889,1,2,6,1,1
28227,129,5619,139,89,101,2,0,35,141,7,54,34,62,61,96,330,569,4,2287,127,0,2,34,0,1
28228,129,5619,7,5,5,0,0,2,7,1,2,1,2,3,3,2,4,0,2,0,0,2,34,0,1
28252,455,10020,72,33,56,0,4,12,72,1,1,1,1,2,2,0,2,0,1,0,0,2,6,1,0
28253,455,10020,1454,835,1044,76,110,219,1530,17,275,158,296,292,454,2297,3718,9,34017,1889,1,2,6,1,0
28256,129,5619,139,89,101,2,0,35,141,7,54,34,62,61,96,330,569,4,2287,127,0,2,34,0,0
28257,129,5619,7,5,5,0,0,2,7,1,2,1,2,3,3,2,4,0,2,0,0,2,34,0,0
28258,42,1271,1523,757,1297,19,12,193,1542,12,193,117,230,205,347,1508,2664,7,19053,1058,0,2,4,4,1
28259,42,1271,701,378,504,33,58,109,734,13,110,68,126,123,194,794,1346,7,10027,557,0,2,4,4,1
28260,39,2430,1523,757,1297,19,12,193,1542,12,193,117,230,205,347,1508,2664,7,19053,1058,0,2,2,2,1
28261,46,451,647,139,84,35,284,233,682,0,0,0,0,0,0,0,0,0,0,0,0,2,2,0,1
28262,21,554,1293,570,1093,25,15,163,1318,10,195,123,241,205,364,1516,2795,6,17273,959,0,2,1,0,1
28263,31,1175,1293,570,1093,25,15,163,1318,10,195,123,241,205,364,1516,2795,6,17273,959,0,2,18,0,1
28264,113,2255,1513,682,1277,25,13,200,1538,11,199,116,219,210,335,1557,2584,6,15641,868,0,2,3,0,0
28265,113,2255,819,519,539,24,98,155,843,15,96,57,106,111,163,690,1107,8,9171,509,0,2,3,0,0
28266,111,4253,1513,682,1277,25,13,200,1538,11,199,116,219,210,335,1557,2584,6,15641,868,0,2,12,0,0
28270,111,4259,1513,682,1277,25,13,200,1538,11,199,116,219,210,335,1557,2584,6,15641,868,0,2,2,0,0
28272,138,4339,1660,832,1314,41,38,274,1701,20,312,209,395,332,604,2671,5058,12,64042,3557,1,2,118,6,0
28273,138,4339,1057,646,719,113,100,145,1170,18,215,134,248,233,382,1740,3004,10,31186,1732,1,2,118,6,0
28274,77,1717,477,336,357,30,23,73,507,16,194,134,250,210,384,1538,2962,10,30538,1696,0,2,5,4,0
28275,60,1070,282,196,195,3,0,86,285,8,130,71,141,138,212,936,1507,4,6538,363,0,2,24,0,0
28277,63,2320,1450,624,1228,12,26,181,1462,14,306,186,354,320,540,2580,4493,8,36391,2021,1,2,79,1,0
28278,125,3266,1660,832,1314,41,38,274,1701,20,312,209,395,332,604,2671,5058,12,64042,3557,1,2,50,1,0
28279,42,1271,1523,757,1297,19,12,193,1542,12,193,117,230,205,347,1508,2664,7,19053,1058,0,2,4,4,0
28280,42,1271,701,378,504,33,58,109,734,13,110,68,126,123,194,794,1346,7,10027,557,0,2,4,4,0
28281,39,2430,1523,757,1297,19,12,193,1542,12,193,117,230,205,347,1508,2664,7,19053,1058,0,2,2,2,0
28282,46,451,647,139,84,35,284,233,682,0,0,0,0,0,0,0,0,0,0,0,0,2,2,0,0
28283,21,554,1293,570,1093,25,15,163,1318,10,195,123,241,205,364,1516,2795,6,17273,959,0,2,1,0,0
28284,31,1175,1293,570,1093,25,15,163,1318,10,195,123,241,205,364,1516,2795,6,17273,959,0,2,18,0,0
28285,87,1541,1178,367,1042,6,15,115,1184,9,94,51,95,103,146,644,976,4,4439,246,0,2,1,4,0
28286,87,1541,177,108,140,8,0,27,185,6,30,16,32,36,48,162,248,3,794,44,0,2,1,4,0
28287,47,2040,1178,367,1042,6,15,115,1184,9,94,51,95,103,146,644,976,4,4439,246,0,2,20,0,0
28313,1,288,382,65,130,157,2,92,539,4,10,5,10,14,15,41,57,2,114,6,0,2,1,1,0
28339,85,1860,477,336,357,30,23,73,507,16,194,134,250,210,384,1538,2962,10,30538,1696,0,2,33,6,0
28340,64,2475,1450,624,1228,12,26,181,1462,14,306,186,354,320,540,2580,4493,8,36391,2021,1,2,45,0,0
28341,85,1860,477,336,357,30,23,73,507,16,194,134,250,210,384,1538,2962,10,30538,1696,0,2,33,6,1
28342,64,2475,1450,624,1228,12,26,181,1462,14,306,186,354,320,540,2580,4493,8,36391,2021,1,2,45,0,1
28705,229,4691,1457,730,1242,11,6,188,1468,10,292,166,329,302,495,2424,4078,5,22973,1276,1,2,2,5,0
28706,229,4691,74,35,59,1,0,14,75,3,14,7,14,17,21,58,85,1,128,7,0,2,2,5,0
28707,229,4691,245,125,200,5,7,34,250,7,30,17,34,37,51,166,265,3,1053,58,0,2,2,5,0
28708,176,4053,77,34,69,0,0,8,77,3,24,16,29,27,45,114,213,1,387,21,0,2,34,9,0
28709,176,4053,712,438,573,51,9,84,763,14,102,71,128,116,199,733,1364,8,11988,666,0,2,34,9,0
28710,456,10021,72,33,56,0,4,12,72,1,1,1,1,2,2,0,2,0,1,0,0,2,8,6,0
28711,456,10021,1454,835,1044,76,110,219,1530,17,275,158,296,292,454,2297,3718,9,34017,1889,1,2,8,6,0
28712,229,4691,1457,730,1242,11,6,188,1468,10,292,166,329,302,495,2424,4078,5,22973,1276,1,2,2,5,1
28713,229,4691,74,35,59,1,0,14,75,3,14,7,14,17,21,58,85,1,128,7,0,2,2,5,1
28714,229,4691,245,125,200,5,7,34,250,7,30,17,34,37,51,166,265,3,1053,58,0,2,2,5,1
28715,176,4053,77,34,69,0,0,8,77,3,24,16,29,27,45,114,213,1,387,21,0,2,34,9,1
28716,176,4053,712,438,573,51,9,84,763,14,102,71,128,116,199,733,1364,8,11988,666,0,2,34,9,1
28717,456,10021,72,33,56,0,4,12,72,1,1,1,1,2,2,0,2,0,1,0,0,2,8,6,1
28718,456,10021,1454,835,1044,76,110,219,1530,17,275,158,296,292,454,2297,3718,9,34017,1889,1,2,8,6,1
28719,24,753,74,35,59,1,0,14,75,3,14,7,14,17,21,58,85,1,128,7,0,2,0,67,0
28720,24,753,245,125,200,5,7,34,250,7,30,17,34,37,51,166,265,3,1053,58,0,2,0,67,0
28721,172,3928,77,34,69,0,0,8,77,3,24,16,29,27,45,114,213,1,387,21,0,2,0,22,0
28722,172,3928,712,438,573,51,9,84,763,14,102,71,128,116,199,733,1364,8,11988,666,0,2,0,22,0
28723,196,4405,722,423,573,19,0,135,741,12,172,101,199,184,300,1320,2257,6,15668,870,0,2,1,4,0
28724,196,4405,1508,847,911,44,250,301,1552,14,148,88,169,162,257,1120,1886,7,15077,837,0,2,1,4,0
28725,11,343,74,35,59,1,0,14,75,3,14,7,14,17,21,58,85,1,128,7,0,2,1,1,0
28726,16,595,722,423,573,19,0,135,741,12,172,101,199,184,300,1320,2257,6,15668,870,0,2,27,16,0
28727,24,753,74,35,59,1,0,14,75,3,14,7,14,17,21,58,85,1,128,7,0,2,0,67,1
28728,24,753,245,125,200,5,7,34,250,7,30,17,34,37,51,166,265,3,1053,58,0,2,0,67,1
28729,172,3928,77,34,69,0,0,8,77,3,24,16,29,27,45,114,213,1,387,21,0,2,0,22,1
28730,172,3928,712,438,573,51,9,84,763,14,102,71,128,116,199,733,1364,8,11988,666,0,2,0,22,1
28731,196,4405,722,423,573,19,0,135,741,12,172,101,199,184,300,1320,2257,6,15668,870,0,2,1,4,1
28732,196,4405,1508,847,911,44,250,301,1552,14,148,88,169,162,257,1120,1886,7,15077,837,0,2,1,4,1
28734,16,595,722,423,573,19,0,135,741,12,172,101,199,184,300,1320,2257,6,15668,870,0,2,27,16,1
28735,46,449,647,139,84,35,284,233,682,0,0,0,0,0,0,0,0,0,0,0,0,2,1,1,0
28737,229,4687,1457,730,1242,11,6,188,1468,10,292,166,329,302,495,2424,4078,5,22973,1276,1,2,1,1,0
28738,229,4687,74,35,59,1,0,14,75,3,14,7,14,17,21,58,85,1,128,7,0,2,1,1,0
28739,229,4687,245,125,200,5,7,34,250,7,30,17,34,37,51,166,265,3,1053,58,0,2,1,1,0
28740,24,743,74,35,59,1,0,14,75,3,14,7,14,17,21,58,85,1,128,7,0,2,2,3,0
28741,24,743,245,125,200,5,7,34,250,7,30,17,34,37,51,166,265,3,1053,58,0,2,2,3,0
28742,8,257,74,35,59,1,0,14,75,3,14,7,14,17,21,58,85,1,128,7,0,2,1,14,0
28743,229,4687,1457,730,1242,11,6,188,1468,10,292,166,329,302,495,2424,4078,5,22973,1276,1,2,1,1,1
28744,229,4687,74,35,59,1,0,14,75,3,14,7,14,17,21,58,85,1,128,7,0,2,1,1,1
28745,229,4687,245,125,200,5,7,34,250,7,30,17,34,37,51,166,265,3,1053,58,0,2,1,1,1
28746,24,743,74,35,59,1,0,14,75,3,14,7,14,17,21,58,85,1,128,7,0,2,2,3,1
28747,24,743,245,125,200,5,7,34,250,7,30,17,34,37,51,166,265,3,1053,58,0,2,2,3,1
28748,8,257,74,35,59,1,0,14,75,3,14,7,14,17,21,58,85,1,128,7,0,2,1,14,1
28749,172,3915,77,34,69,0,0,8,77,3,24,16,29,27,45,114,213,1,387,21,0,2,1,1,0
28750,172,3915,712,438,573,51,9,84,763,14,102,71,128,116,199,733,1364,8,11988,666,0,2,1,1,0
28753,455,10020,72,33,56,0,4,12,72,1,1,1,1,2,2,0,2,0,1,0,0,2,3,3,0
28754,455,10020,1454,835,1044,76,110,219,1530,17,275,158,296,292,454,2297,3718,9,34017,1889,1,2,3,3,0
28755,455,10020,72,33,56,0,4,12,72,1,1,1,1,2,2,0,2,0,1,0,0,2,3,3,1
28756,455,10020,1454,835,1044,76,110,219,1530,17,275,158,296,292,454,2297,3718,9,34017,1889,1,2,3,3,1
28765,186,4159,722,423,573,19,0,135,741,12,172,101,199,184,300,1320,2257,6,15668,870,0,2,12,55,0
28766,186,4159,1508,847,911,44,250,301,1552,14,148,88,169,162,257,1120,1886,7,15077,837,0,2,12,55,0
28767,16,595,722,423,573,19,0,135,741,12,172,101,199,184,300,1320,2257,6,15668,870,0,2,3,3,0
28771,68,1223,1020,354,843,12,15,144,1032,8,134,77,144,142,221,970,1580,4,6792,377,0,2,5,1,0
28772,55,2363,1020,354,843,12,15,144,1032,8,134,77,144,142,221,970,1580,4,6792,377,0,2,4,3,0
28773,68,1223,1020,354,843,12,15,144,1032,8,134,77,144,142,221,970,1580,4,6792,377,0,2,5,1,1
28774,55,2363,1020,354,843,12,15,144,1032,8,134,77,144,142,221,970,1580,4,6792,377,0,2,4,3,1
28775,173,3969,722,423,573,19,0,135,741,12,172,101,199,184,300,1320,2257,6,15668,870,0,2,82,118,1
28776,173,3969,1508,847,911,44,250,301,1552,14,148,88,169,162,257,1120,1886,7,15077,837,0,2,82,118,1
28778,45,2770,1296,573,1062,40,33,157,1336,8,201,118,231,209,349,1561,2689,4,12365,686,0,2,8,8,1
28779,15,573,722,423,573,19,0,135,741,12,172,101,199,184,300,1320,2257,6,15668,870,0,2,2,23,1
28789,455,9950,72,33,56,0,4,12,72,1,1,1,1,2,2,0,2,0,1,0,0,2,16,26,0
28790,455,9950,1454,835,1044,76,110,219,1530,17,275,158,296,292,454,2297,3718,9,34017,1889,1,2,16,26,0
28791,455,9950,72,33,56,0,4,12,72,1,1,1,1,2,2,0,2,0,1,0,0,2,16,26,1
28792,455,9950,1454,835,1044,76,110,219,1530,17,275,158,296,292,454,2297,3718,9,34017,1889,1,2,16,26,1
28793,172,3928,77,34,69,0,0,8,77,3,24,16,29,27,45,114,213,1,387,21,0,2,1,1,0
28794,172,3928,712,438,573,51,9,84,763,14,102,71,128,116,199,733,1364,8,11988,666,0,2,1,1,0
28796,455,9950,72,33,56,0,4,12,72,1,1,1,1,2,2,0,2,0,1,0,0,2,3,3,0
28797,455,9950,1454,835,1044,76,110,219,1530,17,275,158,296,292,454,2297,3718,9,34017,1889,1,2,3,3,0
28805,138,4352,1660,832,1314,41,38,274,1701,20,312,209,395,332,604,2671,5058,12,64042,3557,1,2,1,1,1
28806,138,4352,1057,646,719,113,100,145,1170,18,215,134,248,233,382,1740,3004,10,31186,1732,1,2,1,1,1
28807,126,3306,1660,832,1314,41,38,274,1701,20,312,209,395,332,604,2671,5058,12,64042,3557,1,2,12,0,1
28808,138,4352,1660,832,1314,41,38,274,1701,20,312,209,395,332,604,2671,5058,12,64042,3557,1,2,1,1,0
28809,138,4352,1057,646,719,113,100,145,1170,18,215,134,248,233,382,1740,3004,10,31186,1732,1,2,1,1,0
28810,126,3306,1660,832,1314,41,38,274,1701,20,312,209,395,332,604,2671,5058,12,64042,3557,1,2,12,0,0
28854,229,4687,1457,730,1242,11,6,188,1468,10,292,166,329,302,495,2424,4078,5,22973,1276,1,2,3,6,0
28855,229,4687,74,35,59,1,0,14,75,3,14,7,14,17,21,58,85,1,128,7,0,2,3,6,0
28856,229,4687,245,125,200,5,7,34,250,7,30,17,34,37,51,166,265,3,1053,58,0,2,3,6,0
28857,24,743,74,35,59,1,0,14,75,3,14,7,14,17,21,58,85,1,128,7,0,2,2,70,0
28858,24,743,245,125,200,5,7,34,250,7,30,17,34,37,51,166,265,3,1053,58,0,2,2,70,0
28860,172,3928,77,34,69,0,0,8,77,3,24,16,29,27,45,114,213,1,387,21,0,2,11,8,0
28861,172,3928,712,438,573,51,9,84,763,14,102,71,128,116,199,733,1364,8,11988,666,0,2,11,8,0
28862,173,3969,722,423,573,19,0,135,741,12,172,101,199,184,300,1320,2257,6,15668,870,0,2,89,171,0
28863,173,3969,1508,847,911,44,250,301,1552,14,148,88,169,162,257,1120,1886,7,15077,837,0,2,89,171,0
28864,455,9950,72,33,56,0,4,12,72,1,1,1,1,2,2,0,2,0,1,0,0,2,24,32,0
28865,455,9950,1454,835,1044,76,110,219,1530,17,275,158,296,292,454,2297,3718,9,34017,1889,1,2,24,32,0
28867,45,2770,1296,573,1062,40,33,157,1336,8,201,118,231,209,349,1561,2689,4,12365,686,0,2,8,8,0
28869,15,573,722,423,573,19,0,135,741,12,172,101,199,184,300,1320,2257,6,15668,870,0,2,25,35,0
28886,30,853,465,148,393,5,8,60,470,4,31,20,31,35,51,161,261,2,523,29,0,2,54,1,1
28887,30,853,16,12,9,0,0,6,16,1,2,1,2,3,3,2,4,0,2,0,0,2,54,1,1
28888,173,3969,722,423,573,19,0,135,741,12,172,101,199,184,300,1320,2257,6,15668,870,0,2,2,2,0
28889,173,3969,1508,847,911,44,250,301,1552,14,148,88,169,162,257,1120,1886,7,15077,837,0,2,2,2,0
28890,173,3969,722,423,573,19,0,135,741,12,172,101,199,184,300,1320,2257,6,15668,870,0,2,2,2,1
28891,173,3969,1508,847,911,44,250,301,1552,14,148,88,169,162,257,1120,1886,7,15077,837,0,2,2,2,1
28892,30,982,1455,414,1257,16,76,112,1471,5,41,23,46,46,69,231,381,2,1069,59,0,2,26,2,0
28893,30,982,669,365,481,22,61,110,691,15,103,63,122,118,185,747,1273,8,11311,628,0,2,26,2,0
28894,25,1094,1455,414,1257,16,76,112,1471,5,41,23,46,46,69,231,381,2,1069,59,0,2,34,0,0
28895,30,982,1455,414,1257,16,76,112,1471,5,41,23,46,46,69,231,381,2,1069,59,0,2,26,2,1
28896,30,982,669,365,481,22,61,110,691,15,103,63,122,118,185,747,1273,8,11311,628,0,2,26,2,1
28897,25,1094,1455,414,1257,16,76,112,1471,5,41,23,46,46,69,231,381,2,1069,59,0,2,34,0,1
28898,29,974,1455,414,1257,16,76,112,1471,5,41,23,46,46,69,231,381,2,1069,59,0,2,0,3,0
28899,29,974,669,365,481,22,61,110,691,15,103,63,122,118,185,747,1273,8,11311,628,0,2,0,3,0
28900,29,974,1455,414,1257,16,76,112,1471,5,41,23,46,46,69,231,381,2,1069,59,0,2,0,3,1
28901,29,974,669,365,481,22,61,110,691,15,103,63,122,118,185,747,1273,8,11311,628,0,2,0,3,1
28902,27,1182,1455,414,1257,16,76,112,1471,5,41,23,46,46,69,231,381,2,1069,59,0,2,26,0,0
28904,111,2245,1513,682,1277,25,13,200,1538,11,199,116,219,210,335,1557,2584,6,15641,868,0,2,17,22,0
28905,111,2245,819,519,539,24,98,155,843,15,96,57,106,111,163,690,1107,8,9171,509,0,2,17,22,0
28906,24,750,74,35,59,1,0,14,75,3,14,7,14,17,21,58,85,1,128,7,0,2,8,5,0
28907,24,750,245,125,200,5,7,34,250,7,30,17,34,37,51,166,265,3,1053,58,0,2,8,5,0
28908,23,371,424,94,331,4,0,89,428,1,5,5,5,6,10,11,25,0,12,0,0,2,1,1,0
28909,23,371,38,23,23,6,0,8,44,3,11,7,11,14,18,42,68,1,102,5,0,2,1,1,0
28910,14,454,184,100,137,2,15,30,186,6,38,20,39,44,59,214,322,3,991,55,0,2,4,3,0
28911,14,454,103,65,74,8,5,16,111,7,17,9,17,24,26,89,119,3,417,23,0,2,4,3,0
28912,454,9966,72,33,56,0,4,12,72,1,1,1,1,2,2,0,2,0,1,0,0,2,24,22,0
28913,454,9966,1454,835,1044,76,110,219,1530,17,275,158,296,292,454,2297,3718,9,34017,1889,1,2,24,22,0
28914,83,1483,1178,367,1042,6,15,115,1184,9,94,51,95,103,146,644,976,4,4439,246,0,2,26,40,0
28915,83,1483,177,108,140,8,0,27,185,6,30,16,32,36,48,162,248,3,794,44,0,2,26,40,0
28916,166,3406,1943,715,1694,26,18,214,1969,12,185,120,237,197,357,1436,2721,7,20915,1161,0,2,4,2,0
28917,166,3406,1168,838,957,57,25,144,1225,19,348,224,416,367,640,3018,5452,11,61921,3440,1,2,4,2,0
28918,51,1012,1098,241,925,5,10,155,1103,7,46,25,49,53,74,273,423,3,1580,87,0,2,26,23,0
28919,51,1012,282,202,222,14,2,44,296,8,42,24,43,50,67,250,378,4,1548,86,0,2,26,23,0
28920,63,2936,1338,495,1086,10,64,173,1348,11,122,82,157,133,239,883,1686,7,11934,663,0,2,9,6,0
28921,55,2363,1020,354,843,12,15,144,1032,8,134,77,144,142,221,970,1580,4,6792,377,0,2,5,3,0
28922,111,2245,1513,682,1277,25,13,200,1538,11,199,116,219,210,335,1557,2584,6,15641,868,0,2,17,22,1
28923,111,2245,819,519,539,24,98,155,843,15,96,57,106,111,163,690,1107,8,9171,509,0,2,17,22,1
28924,24,750,74,35,59,1,0,14,75,3,14,7,14,17,21,58,85,1,128,7,0,2,8,5,1
28925,24,750,245,125,200,5,7,34,250,7,30,17,34,37,51,166,265,3,1053,58,0,2,8,5,1
28926,23,371,424,94,331,4,0,89,428,1,5,5,5,6,10,11,25,0,12,0,0,2,1,1,1
28927,23,371,38,23,23,6,0,8,44,3,11,7,11,14,18,42,68,1,102,5,0,2,1,1,1
28928,14,454,184,100,137,2,15,30,186,6,38,20,39,44,59,214,322,3,991,55,0,2,4,3,1
28929,14,454,103,65,74,8,5,16,111,7,17,9,17,24,26,89,119,3,417,23,0,2,4,3,1
28930,454,9966,72,33,56,0,4,12,72,1,1,1,1,2,2,0,2,0,1,0,0,2,24,22,1
28931,454,9966,1454,835,1044,76,110,219,1530,17,275,158,296,292,454,2297,3718,9,34017,1889,1,2,24,22,1
28932,83,1483,1178,367,1042,6,15,115,1184,9,94,51,95,103,146,644,976,4,4439,246,0,2,26,40,1
28933,83,1483,177,108,140,8,0,27,185,6,30,16,32,36,48,162,248,3,794,44,0,2,26,40,1
28934,166,3406,1943,715,1694,26,18,214,1969,12,185,120,237,197,357,1436,2721,7,20915,1161,0,2,4,2,1
28935,166,3406,1168,838,957,57,25,144,1225,19,348,224,416,367,640,3018,5452,11,61921,3440,1,2,4,2,1
28936,51,1012,1098,241,925,5,10,155,1103,7,46,25,49,53,74,273,423,3,1580,87,0,2,26,23,1
28937,51,1012,282,202,222,14,2,44,296,8,42,24,43,50,67,250,378,4,1548,86,0,2,26,23,1
28938,63,2936,1338,495,1086,10,64,173,1348,11,122,82,157,133,239,883,1686,7,11934,663,0,2,9,6,1
28939,55,2363,1020,354,843,12,15,144,1032,8,134,77,144,142,221,970,1580,4,6792,377,0,2,5,3,1
28940,29,974,1455,414,1257,16,76,112,1471,5,41,23,46,46,69,231,381,2,1069,59,0,2,23,2,0
28941,29,974,669,365,481,22,61,110,691,15,103,63,122,118,185,747,1273,8,11311,628,0,2,23,2,0
28942,27,1182,1455,414,1257,16,76,112,1471,5,41,23,46,46,69,231,381,2,1069,59,0,2,60,0,0
28946,29,972,1455,414,1257,16,76,112,1471,5,41,23,46,46,69,231,381,2,1069,59,0,2,0,1,0
28947,29,972,669,365,481,22,61,110,691,15,103,63,122,118,185,747,1273,8,11311,628,0,2,0,1,0
28950,166,3406,1943,715,1694,26,18,214,1969,12,185,120,237,197,357,1436,2721,7,20915,1161,0,2,1,1,0
28951,166,3406,1168,838,957,57,25,144,1225,19,348,224,416,367,640,3018,5452,11,61921,3440,1,2,1,1,0
28952,166,3406,1943,715,1694,26,18,214,1969,12,185,120,237,197,357,1436,2721,7,20915,1161,0,2,1,1,1
28953,166,3406,1168,838,957,57,25,144,1225,19,348,224,416,367,640,3018,5452,11,61921,3440,1,2,1,1,1
28954,131,3359,1660,832,1314,41,38,274,1701,20,312,209,395,332,604,2671,5058,12,64042,3557,1,2,10,0,1
28959,131,3359,1660,832,1314,41,38,274,1701,20,312,209,395,332,604,2671,5058,12,64042,3557,1,2,10,0,0
28960,454,9990,72,33,56,0,4,12,72,1,1,1,1,2,2,0,2,0,1,0,0,2,17,7,1
28961,454,9990,1454,835,1044,76,110,219,1530,17,275,158,296,292,454,2297,3718,9,34017,1889,1,2,17,7,1
28962,47,2824,1296,573,1062,40,33,157,1336,8,201,118,231,209,349,1561,2689,4,12365,686,0,2,24,0,1
28963,138,4358,1660,832,1314,41,38,274,1701,20,312,209,395,332,604,2671,5058,12,64042,3557,1,2,1,1,0
28964,138,4358,1057,646,719,113,100,145,1170,18,215,134,248,233,382,1740,3004,10,31186,1732,1,2,1,1,0
28965,457,10005,72,33,56,0,4,12,72,1,1,1,1,2,2,0,2,0,1,0,0,2,5,1,0
28966,457,10005,1454,835,1044,76,110,219,1530,17,275,158,296,292,454,2297,3718,9,34017,1889,1,2,5,1,0
28967,457,10005,72,33,56,0,4,12,72,1,1,1,1,2,2,0,2,0,1,0,0,2,21,7,0
28968,457,10005,1454,835,1044,76,110,219,1530,17,275,158,296,292,454,2297,3718,9,34017,1889,1,2,21,7,0
28969,47,2824,1296,573,1062,40,33,157,1336,8,201,118,231,209,349,1561,2689,4,12365,686,0,2,24,0,0
28970,465,10107,72,33,56,0,4,12,72,1,1,1,1,2,2,0,2,0,1,0,0,2,38,15,0
28971,465,10107,1454,835,1044,76,110,219,1530,17,275,158,296,292,454,2297,3718,9,34017,1889,1,2,38,15,0
28972,31,888,465,148,393,5,8,60,470,4,31,20,31,35,51,161,261,2,523,29,0,2,54,1,0
28973,31,888,16,12,9,0,0,6,16,1,2,1,2,3,3,2,4,0,2,0,0,2,54,1,0
28974,65,3525,1782,648,1425,9,47,279,1791,8,171,97,189,179,286,1292,2140,4,9462,525,0,2,46,0,0
28975,15,468,184,100,137,2,15,30,186,6,38,20,39,44,59,214,322,3,991,55,0,2,31,16,1
28976,15,468,103,65,74,8,5,16,111,7,17,9,17,24,26,89,119,3,417,23,0,2,31,16,1
28977,11,374,184,100,137,2,15,30,186,6,38,20,39,44,59,214,322,3,991,55,0,2,48,19,1
28978,15,468,184,100,137,2,15,30,186,6,38,20,39,44,59,214,322,3,991,55,0,2,31,16,0
28979,15,468,103,65,74,8,5,16,111,7,17,9,17,24,26,89,119,3,417,23,0,2,31,16,0
28980,11,374,184,100,137,2,15,30,186,6,38,20,39,44,59,214,322,3,991,55,0,2,48,19,0
29007,15,467,184,100,137,2,15,30,186,6,38,20,39,44,59,214,322,3,991,55,0,2,31,16,0
29008,15,467,103,65,74,8,5,16,111,7,17,9,17,24,26,89,119,3,417,23,0,2,31,16,0
29035,139,4400,1660,832,1314,41,38,274,1701,20,312,209,395,332,604,2671,5058,12,64042,3557,1,2,6,1,1
29036,139,4400,1057,646,719,113,100,145,1170,18,215,134,248,233,382,1740,3004,10,31186,1732,1,2,6,1,1
29037,131,3348,1660,832,1314,41,38,274,1701,20,312,209,395,332,604,2671,5058,12,64042,3557,1,2,5,7,1
29038,465,10105,72,33,56,0,4,12,72,1,1,1,1,2,2,0,2,0,1,0,0,2,2,2,0
29039,465,10105,1454,835,1044,76,110,219,1530,17,275,158,296,292,454,2297,3718,9,34017,1889,1,2,2,2,0
29040,139,4400,1660,832,1314,41,38,274,1701,20,312,209,395,332,604,2671,5058,12,64042,3557,1,2,6,1,0
29041,139,4400,1057,646,719,113,100,145,1170,18,215,134,248,233,382,1740,3004,10,31186,1732,1,2,6,1,0
29042,131,3348,1660,832,1314,41,38,274,1701,20,312,209,395,332,604,2671,5058,12,64042,3557,1,2,5,7,0
29045,43,863,447,308,343,6,5,95,453,7,96,59,111,103,170,651,1136,4,4600,255,0,2,23,14,1
29046,43,863,322,174,179,16,74,51,338,10,41,26,46,51,72,252,408,5,2291,127,0,2,23,14,1
29047,465,10120,72,33,56,0,4,12,72,1,1,1,1,2,2,0,2,0,1,0,0,2,11,4,1
29048,465,10120,1454,835,1044,76,110,219,1530,17,275,158,296,292,454,2297,3718,9,34017,1889,1,2,11,4,1
29049,130,5646,139,89,101,2,0,35,141,7,54,34,62,61,96,330,569,4,2287,127,0,2,23,0,1
29050,130,5646,7,5,5,0,0,2,7,1,2,1,2,3,3,2,4,0,2,0,0,2,23,0,1
29051,16,474,184,100,137,2,15,30,186,6,38,20,39,44,59,214,322,3,991,55,0,2,10,6,1
29052,16,474,103,65,74,8,5,16,111,7,17,9,17,24,26,89,119,3,417,23,0,2,10,6,1
29053,16,474,184,100,137,2,15,30,186,6,38,20,39,44,59,214,322,3,991,55,0,2,10,6,0
29054,16,474,103,65,74,8,5,16,111,7,17,9,17,24,26,89,119,3,417,23,0,2,10,6,0
29055,43,1307,1523,757,1297,19,12,193,1542,12,193,117,230,205,347,1508,2664,7,19053,1058,0,2,6,1,1
29056,43,1307,701,378,504,33,58,109,734,13,110,68,126,123,194,794,1346,7,10027,557,0,2,6,1,1
29057,40,2493,1523,757,1297,19,12,193,1542,12,193,117,230,205,347,1508,2664,7,19053,1058,0,2,15,2,1
29058,229,4718,1457,730,1242,11,6,188,1468,10,292,166,329,302,495,2424,4078,5,22973,1276,1,2,2,0,0
29059,229,4718,74,35,59,1,0,14,75,3,14,7,14,17,21,58,85,1,128,7,0,2,2,0,0
29060,229,4718,245,125,200,5,7,34,250,7,30,17,34,37,51,166,265,3,1053,58,0,2,2,0,0
29061,40,1923,1457,730,1242,11,6,188,1468,10,292,166,329,302,495,2424,4078,5,22973,1276,1,2,7,0,0
29062,229,4709,1457,730,1242,11,6,188,1468,10,292,166,329,302,495,2424,4078,5,22973,1276,1,2,1,2,0
29063,229,4709,74,35,59,1,0,14,75,3,14,7,14,17,21,58,85,1,128,7,0,2,1,2,0
29064,229,4709,245,125,200,5,7,34,250,7,30,17,34,37,51,166,265,3,1053,58,0,2,1,2,0
29065,40,1916,1457,730,1242,11,6,188,1468,10,292,166,329,302,495,2424,4078,5,22973,1276,1,2,2,5,0
29066,31,1022,1455,414,1257,16,76,112,1471,5,41,23,46,46,69,231,381,2,1069,59,0,2,13,3,1
29067,31,1022,669,365,481,22,61,110,691,15,103,63,122,118,185,747,1273,8,11311,628,0,2,13,3,1
29068,229,4709,1457,730,1242,11,6,188,1468,10,292,166,329,302,495,2424,4078,5,22973,1276,1,2,1,0,0
29069,229,4709,74,35,59,1,0,14,75,3,14,7,14,17,21,58,85,1,128,7,0,2,1,0,0
29070,229,4709,245,125,200,5,7,34,250,7,30,17,34,37,51,166,265,3,1053,58,0,2,1,0,0
29071,40,1916,1457,730,1242,11,6,188,1468,10,292,166,329,302,495,2424,4078,5,22973,1276,1,2,5,1,0
29072,27,1147,1455,414,1257,16,76,112,1471,5,41,23,46,46,69,231,381,2,1069,59,0,2,0,8,0
29073,31,1169,1293,570,1093,25,15,163,1318,10,195,123,241,205,364,1516,2795,6,17273,959,0,2,0,2,0
29079,43,1307,1523,757,1297,19,12,193,1542,12,193,117,230,205,347,1508,2664,7,19053,1058,0,2,6,1,0
29080,43,1307,701,378,504,33,58,109,734,13,110,68,126,123,194,794,1346,7,10027,557,0,2,6,1,0
29081,40,2493,1523,757,1297,19,12,193,1542,12,193,117,230,205,347,1508,2664,7,19053,1058,0,2,15,2,0
29082,28,1226,1455,414,1257,16,76,112,1471,5,41,23,46,46,69,231,381,2,1069,59,0,2,16,0,0
29083,247,4978,1457,730,1242,11,6,188,1468,10,292,166,329,302,495,2424,4078,5,22973,1276,1,2,61,10,1
29084,247,4978,74,35,59,1,0,14,75,3,14,7,14,17,21,58,85,1,128,7,0,2,61,10,1
29085,247,4978,245,125,200,5,7,34,250,7,30,17,34,37,51,166,265,3,1053,58,0,2,61,10,1
29086,172,3925,77,34,69,0,0,8,77,3,24,16,29,27,45,114,213,1,387,21,0,2,6,5,1
29087,172,3925,712,438,573,51,9,84,763,14,102,71,128,116,199,733,1364,8,11988,666,0,2,6,5,1
29088,173,3958,722,423,573,19,0,135,741,12,172,101,199,184,300,1320,2257,6,15668,870,0,2,2,4,1
29089,173,3958,1508,847,911,44,250,301,1552,14,148,88,169,162,257,1120,1886,7,15077,837,0,2,2,4,1
29090,464,10112,72,33,56,0,4,12,72,1,1,1,1,2,2,0,2,0,1,0,0,2,1,3,1
29091,464,10112,1454,835,1044,76,110,219,1530,17,275,158,296,292,454,2297,3718,9,34017,1889,1,2,1,3,1
29092,83,1504,1178,367,1042,6,15,115,1184,9,94,51,95,103,146,644,976,4,4439,246,0,2,4,4,1
29093,83,1504,177,108,140,8,0,27,185,6,30,16,32,36,48,162,248,3,794,44,0,2,4,4,1
29094,168,3515,1943,715,1694,26,18,214,1969,12,185,120,237,197,357,1436,2721,7,20915,1161,0,2,31,21,1
29095,168,3515,1168,838,957,57,25,144,1225,19,348,224,416,367,640,3018,5452,11,61921,3440,1,2,31,21,1
29096,47,2824,1296,573,1062,40,33,157,1336,8,201,118,231,209,349,1561,2689,4,12365,686,0,2,2,2,1
29097,47,2300,1457,730,1242,11,6,188,1468,10,292,166,329,302,495,2424,4078,5,22973,1276,1,2,54,2,1
29098,30,1941,652,304,544,16,6,88,668,6,89,51,101,95,152,591,998,3,3399,188,0,2,89,0,1
29099,27,1145,1455,414,1257,16,76,112,1471,5,41,23,46,46,69,231,381,2,1069,59,0,2,0,3,1
29100,61,2681,1943,715,1694,26,18,214,1969,12,185,120,237,197,357,1436,2721,7,20915,1161,0,2,3,3,1
29101,31,1022,1455,414,1257,16,76,112,1471,5,41,23,46,46,69,231,381,2,1069,59,0,2,13,3,0
29102,31,1022,669,365,481,22,61,110,691,15,103,63,122,118,185,747,1273,8,11311,628,0,2,13,3,0
29103,28,1191,1455,414,1257,16,76,112,1471,5,41,23,46,46,69,231,381,2,1069,59,0,2,16,0,0
29104,30,1950,652,304,544,16,6,88,668,6,89,51,101,95,152,591,998,3,3399,188,0,2,84,85,1
29105,465,10120,72,33,56,0,4,12,72,1,1,1,1,2,2,0,2,0,1,0,0,2,1,1,1
29106,465,10120,1454,835,1044,76,110,219,1530,17,275,158,296,292,454,2297,3718,9,34017,1889,1,2,1,1,1
29107,11,370,85,59,61,8,0,16,93,5,18,10,18,23,28,86,126,2,316,17,0,2,2,2,1
29108,111,4259,1513,682,1277,25,13,200,1538,11,199,116,219,210,335,1557,2584,6,15641,868,0,2,1,1,1
29109,465,10120,72,33,56,0,4,12,72,1,1,1,1,2,2,0,2,0,1,0,0,2,1,1,0
29110,465,10120,1454,835,1044,76,110,219,1530,17,275,158,296,292,454,2297,3718,9,34017,1889,1,2,1,1,0
29111,11,370,85,59,61,8,0,16,93,5,18,10,18,23,28,86,126,2,316,17,0,2,2,2,0
29112,111,4259,1513,682,1277,25,13,200,1538,11,199,116,219,210,335,1557,2584,6,15641,868,0,2,1,1,0
29113,11,370,85,59,61,8,0,16,93,5,18,10,18,23,28,86,126,2,316,17,0,2,1,1,0
29115,247,4978,1457,730,1242,11,6,188,1468,10,292,166,329,302,495,2424,4078,5,22973,1276,1,2,61,10,0
29116,247,4978,74,35,59,1,0,14,75,3,14,7,14,17,21,58,85,1,128,7,0,2,61,10,0
29117,247,4978,245,125,200,5,7,34,250,7,30,17,34,37,51,166,265,3,1053,58,0,2,61,10,0
29118,172,3925,77,34,69,0,0,8,77,3,24,16,29,27,45,114,213,1,387,21,0,2,6,5,0
29119,172,3925,712,438,573,51,9,84,763,14,102,71,128,116,199,733,1364,8,11988,666,0,2,6,5,0
29120,173,3958,722,423,573,19,0,135,741,12,172,101,199,184,300,1320,2257,6,15668,870,0,2,2,4,0
29121,173,3958,1508,847,911,44,250,301,1552,14,148,88,169,162,257,1120,1886,7,15077,837,0,2,2,4,0
29122,464,10112,72,33,56,0,4,12,72,1,1,1,1,2,2,0,2,0,1,0,0,2,1,3,0
29123,464,10112,1454,835,1044,76,110,219,1530,17,275,158,296,292,454,2297,3718,9,34017,1889,1,2,1,3,0
29124,83,1504,1178,367,1042,6,15,115,1184,9,94,51,95,103,146,644,976,4,4439,246,0,2,4,4,0
29125,83,1504,177,108,140,8,0,27,185,6,30,16,32,36,48,162,248,3,794,44,0,2,4,4,0
29126,168,3515,1943,715,1694,26,18,214,1969,12,185,120,237,197,357,1436,2721,7,20915,1161,0,2,31,21,0
29127,168,3515,1168,838,957,57,25,144,1225,19,348,224,416,367,640,3018,5452,11,61921,3440,1,2,31,21,0
29128,47,2824,1296,573,1062,40,33,157,1336,8,201,118,231,209,349,1561,2689,4,12365,686,0,2,2,2,0
29129,47,2300,1457,730,1242,11,6,188,1468,10,292,166,329,302,495,2424,4078,5,22973,1276,1,2,54,2,0
29130,30,1950,652,304,544,16,6,88,668,6,89,51,101,95,152,591,998,3,3399,188,0,2,88,0,0
29131,28,1189,1455,414,1257,16,76,112,1471,5,41,23,46,46,69,231,381,2,1069,59,0,2,0,3,0
29132,61,2681,1943,715,1694,26,18,214,1969,12,185,120,237,197,357,1436,2721,7,20915,1161,0,2,3,3,0
29133,464,10117,72,33,56,0,4,12,72,1,1,1,1,2,2,0,2,0,1,0,0,2,1,1,1
29134,464,10117,1454,835,1044,76,110,219,1530,17,275,158,296,292,454,2297,3718,9,34017,1889,1,2,1,1,1
29135,14,457,42,7,35,4,0,5,46,1,2,1,2,3,3,2,4,0,2,0,0,2,2,1,1
29136,14,457,11,6,10,0,0,1,11,2,4,2,4,6,6,10,15,1,15,0,0,2,2,1,1
29137,134,5956,139,89,101,2,0,35,141,7,54,34,62,61,96,330,569,4,2287,127,0,2,108,0,1
29138,134,5956,7,5,5,0,0,2,7,1,2,1,2,3,3,2,4,0,2,0,0,2,108,0,1
29139,466,10154,72,33,56,0,4,12,72,1,1,1,1,2,2,0,2,0,1,0,0,2,6,3,1
29140,466,10154,1454,835,1044,76,110,219,1530,17,275,158,296,292,454,2297,3718,9,34017,1889,1,2,6,3,1
29141,64,2966,1338,495,1086,10,64,173,1348,11,122,82,157,133,239,883,1686,7,11934,663,0,2,17,0,1
29142,30,1950,652,304,544,16,6,88,668,6,89,51,101,95,152,591,998,3,3399,188,0,2,4,0,0
29143,465,10151,72,33,56,0,4,12,72,1,1,1,1,2,2,0,2,0,1,0,0,2,4,3,1
29144,465,10151,1454,835,1044,76,110,219,1530,17,275,158,296,292,454,2297,3718,9,34017,1889,1,2,4,3,1
29146,64,2966,1338,495,1086,10,64,173,1348,11,122,82,157,133,239,883,1686,7,11934,663,0,2,6,6,0
29147,465,10151,72,33,56,0,4,12,72,1,1,1,1,2,2,0,2,0,1,0,0,2,4,3,0
29148,465,10151,1454,835,1044,76,110,219,1530,17,275,158,296,292,454,2297,3718,9,34017,1889,1,2,4,3,0
29149,140,4414,1660,832,1314,41,38,274,1701,20,312,209,395,332,604,2671,5058,12,64042,3557,1,2,6,0,1
29150,140,4414,1057,646,719,113,100,145,1170,18,215,134,248,233,382,1740,3004,10,31186,1732,1,2,6,0,1
29151,132,3417,1660,832,1314,41,38,274,1701,20,312,209,395,332,604,2671,5058,12,64042,3557,1,2,24,0,1
29152,464,10116,72,33,56,0,4,12,72,1,1,1,1,2,2,0,2,0,1,0,0,2,1,1,1
29153,464,10116,1454,835,1044,76,110,219,1530,17,275,158,296,292,454,2297,3718,9,34017,1889,1,2,1,1,1
29154,131,5688,139,89,101,2,0,35,141,7,54,34,62,61,96,330,569,4,2287,127,0,2,31,1,1
29155,131,5688,7,5,5,0,0,2,7,1,2,1,2,3,3,2,4,0,2,0,0,2,31,1,1
29156,464,10116,72,33,56,0,4,12,72,1,1,1,1,2,2,0,2,0,1,0,0,2,1,1,0
29157,464,10116,1454,835,1044,76,110,219,1530,17,275,158,296,292,454,2297,3718,9,34017,1889,1,2,1,1,0
29158,131,5688,139,89,101,2,0,35,141,7,54,34,62,61,96,330,569,4,2287,127,0,2,31,1,0
29159,131,5688,7,5,5,0,0,2,7,1,2,1,2,3,3,2,4,0,2,0,0,2,31,1,0
29160,465,10155,72,33,56,0,4,12,72,1,1,1,1,2,2,0,2,0,1,0,0,2,10,6,0
29161,465,10155,1454,835,1044,76,110,219,1530,17,275,158,296,292,454,2297,3718,9,34017,1889,1,2,10,6,0
29162,14,457,42,7,35,4,0,5,46,1,2,1,2,3,3,2,4,0,2,0,0,2,2,1,0
29163,14,457,11,6,10,0,0,1,11,2,4,2,4,6,6,10,15,1,15,0,0,2,2,1,0
29164,64,2966,1338,495,1086,10,64,173,1348,11,122,82,157,133,239,883,1686,7,11934,663,0,2,20,3,0
29165,135,5998,139,89,101,2,0,35,141,7,54,34,62,61,96,330,569,4,2287,127,0,2,108,0,0
29166,135,5998,7,5,5,0,0,2,7,1,2,1,2,3,3,2,4,0,2,0,0,2,108,0,0
29167,115,2519,1043,504,840,53,9,147,1096,9,180,112,198,189,310,1377,2344,4,11604,644,0,2,11,1,0
29168,115,2519,383,288,292,26,6,62,409,11,65,38,67,76,105,429,656,5,3719,206,0,2,11,1,0
29169,53,2083,1043,504,840,53,9,147,1096,9,180,112,198,189,310,1377,2344,4,11604,644,0,2,15,0,1
29170,53,2083,1043,504,840,53,9,147,1096,9,180,112,198,189,310,1377,2344,4,11604,644,0,2,4,1,1
29171,466,10185,72,33,56,0,4,12,72,1,1,1,1,2,2,0,2,0,1,0,0,2,7,0,0
29172,466,10185,1454,835,1044,76,110,219,1530,17,275,158,296,292,454,2297,3718,9,34017,1889,1,2,7,0,0
29173,66,3583,1782,648,1425,9,47,279,1791,8,171,97,189,179,286,1292,2140,4,9462,525,0,2,15,0,0
29174,466,10182,72,33,56,0,4,12,72,1,1,1,1,2,2,0,2,0,1,0,0,2,2,5,0
29175,466,10182,1454,835,1044,76,110,219,1530,17,275,158,296,292,454,2297,3718,9,34017,1889,1,2,2,5,0
29176,466,10182,72,33,56,0,4,12,72,1,1,1,1,2,2,0,2,0,1,0,0,2,1,1,0
29177,466,10182,1454,835,1044,76,110,219,1530,17,275,158,296,292,454,2297,3718,9,34017,1889,1,2,1,1,0
29178,140,4414,1660,832,1314,41,38,274,1701,20,312,209,395,332,604,2671,5058,12,64042,3557,1,2,6,0,0
29179,140,4414,1057,646,719,113,100,145,1170,18,215,134,248,233,382,1740,3004,10,31186,1732,1,2,6,0,0
29180,132,3417,1660,832,1314,41,38,274,1701,20,312,209,395,332,604,2671,5058,12,64042,3557,1,2,24,0,0
29181,465,10150,72,33,56,0,4,12,72,1,1,1,1,2,2,0,2,0,1,0,0,2,0,1,0
29182,465,10150,1454,835,1044,76,110,219,1530,17,275,158,296,292,454,2297,3718,9,34017,1889,1,2,0,1,0
29183,68,1230,1020,354,843,12,15,144,1032,8,134,77,144,142,221,970,1580,4,6792,377,0,2,3,0,1
29184,466,10184,72,33,56,0,4,12,72,1,1,1,1,2,2,0,2,0,1,0,0,2,3,3,1
29185,466,10184,1454,835,1044,76,110,219,1530,17,275,158,296,292,454,2297,3718,9,34017,1889,1,2,3,3,1
29186,66,3583,1782,648,1425,9,47,279,1791,8,171,97,189,179,286,1292,2140,4,9462,525,0,2,1,1,1
29187,68,1230,1020,354,843,12,15,144,1032,8,134,77,144,142,221,970,1580,4,6792,377,0,2,3,1,1
29190,466,10179,72,33,56,0,4,12,72,1,1,1,1,2,2,0,2,0,1,0,0,2,0,1,0
29191,466,10179,1454,835,1044,76,110,219,1530,17,275,158,296,292,454,2297,3718,9,34017,1889,1,2,0,1,0
29193,68,1230,1020,354,843,12,15,144,1032,8,134,77,144,142,221,970,1580,4,6792,377,0,2,5,0,0
29194,466,10179,72,33,56,0,4,12,72,1,1,1,1,2,2,0,2,0,1,0,0,2,5,1,0
29195,466,10179,1454,835,1044,76,110,219,1530,17,275,158,296,292,454,2297,3718,9,34017,1889,1,2,5,1,0
29199,53,2083,1043,504,840,53,9,147,1096,9,180,112,198,189,310,1377,2344,4,11604,644,0,2,18,0,0
29200,68,1230,1020,354,843,12,15,144,1032,8,134,77,144,142,221,970,1580,4,6792,377,0,2,3,3,0
29224,1,288,382,65,130,157,2,92,539,4,10,5,10,14,15,41,57,2,114,6,0,2,2,2,1
29225,7,292,72,33,56,0,4,12,72,1,1,1,1,2,2,0,2,0,1,0,0,2,2,2,1
29226,14,457,42,7,35,4,0,5,46,1,2,1,2,3,3,2,4,0,2,0,0,2,1,1,1
29227,14,457,11,6,10,0,0,1,11,2,4,2,4,6,6,10,15,1,15,0,0,2,1,1,1
29228,135,5990,139,89,101,2,0,35,141,7,54,34,62,61,96,330,569,4,2287,127,0,2,3,4,1
29229,135,5990,7,5,5,0,0,2,7,1,2,1,2,3,3,2,4,0,2,0,0,2,3,4,1
29254,14,457,42,7,35,4,0,5,46,1,2,1,2,3,3,2,4,0,2,0,0,2,1,1,0
29255,14,457,11,6,10,0,0,1,11,2,4,2,4,6,6,10,15,1,15,0,0,2,1,1,0
29256,466,10197,72,33,56,0,4,12,72,1,1,1,1,2,2,0,2,0,1,0,0,2,17,16,1
29257,466,10197,1454,835,1044,76,110,219,1530,17,275,158,296,292,454,2297,3718,9,34017,1889,1,2,17,16,1
29258,136,6025,139,89,101,2,0,35,141,7,54,34,62,61,96,330,569,4,2287,127,0,2,21,0,1
29259,136,6025,7,5,5,0,0,2,7,1,2,1,2,3,3,2,4,0,2,0,0,2,21,0,1
29283,1,315,382,65,130,157,2,92,539,4,10,5,10,14,15,41,57,2,114,6,0,2,7,4,1
29284,17,539,42,7,35,4,0,5,46,1,2,1,2,3,3,2,4,0,2,0,0,2,10,1,1
29285,17,539,11,6,10,0,0,1,11,2,4,2,4,6,6,10,15,1,15,0,0,2,10,1,1
29309,1,315,382,65,130,157,2,92,539,4,10,5,10,14,15,41,57,2,114,6,0,2,7,4,0
29310,17,539,42,7,35,4,0,5,46,1,2,1,2,3,3,2,4,0,2,0,0,2,10,1,0
29311,17,539,11,6,10,0,0,1,11,2,4,2,4,6,6,10,15,1,15,0,0,2,10,1,0
29361,21,612,42,7,35,4,0,5,46,1,2,1,2,3,3,2,4,0,2,0,0,2,18,4,1
29362,21,612,11,6,10,0,0,1,11,2,4,2,4,6,6,10,15,1,15,0,0,2,18,4,1
29363,20,614,42,7,35,4,0,5,46,1,2,1,2,3,3,2,4,0,2,0,0,2,4,2,0
29364,20,614,11,6,10,0,0,1,11,2,4,2,4,6,6,10,15,1,15,0,0,2,4,2,0
29365,20,614,42,7,35,4,0,5,46,1,2,1,2,3,3,2,4,0,2,0,0,2,1,1,1
29366,20,614,11,6,10,0,0,1,11,2,4,2,4,6,6,10,15,1,15,0,0,2,1,1,1
29367,20,614,42,7,35,4,0,5,46,1,2,1,2,3,3,2,4,0,2,0,0,2,1,1,0
29368,20,614,11,6,10,0,0,1,11,2,4,2,4,6,6,10,15,1,15,0,0,2,1,1,0
29369,20,615,42,7,35,4,0,5,46,1,2,1,2,3,3,2,4,0,2,0,0,2,13,2,1
29370,20,615,11,6,10,0,0,1,11,2,4,2,4,6,6,10,15,1,15,0,0,2,13,2,1
29371,173,4001,722,423,573,19,0,135,741,12,172,101,199,184,300,1320,2257,6,15668,870,0,2,322,1,1
29372,173,4001,1508,847,911,44,250,301,1552,14,148,88,169,162,257,1120,1886,7,15077,837,0,2,322,1,1
29373,20,615,42,7,35,4,0,5,46,1,2,1,2,3,3,2,4,0,2,0,0,2,2,2,0
29374,20,615,11,6,10,0,0,1,11,2,4,2,4,6,6,10,15,1,15,0,0,2,2,2,0
29375,20,615,42,7,35,4,0,5,46,1,2,1,2,3,3,2,4,0,2,0,0,2,31,4,0
29376,20,615,11,6,10,0,0,1,11,2,4,2,4,6,6,10,15,1,15,0,0,2,31,4,0
29377,466,10197,72,33,56,0,4,12,72,1,1,1,1,2,2,0,2,0,1,0,0,2,17,16,0
29378,466,10197,1454,835,1044,76,110,219,1530,17,275,158,296,292,454,2297,3718,9,34017,1889,1,2,17,16,0
29379,136,6025,139,89,101,2,0,35,141,7,54,34,62,61,96,330,569,4,2287,127,0,2,21,0,0
29380,136,6025,7,5,5,0,0,2,7,1,2,1,2,3,3,2,4,0,2,0,0,2,21,0,0
29385,466,10197,72,33,56,0,4,12,72,1,1,1,1,2,2,0,2,0,1,0,0,2,1,1,0
29386,466,10197,1454,835,1044,76,110,219,1530,17,275,158,296,292,454,2297,3718,9,34017,1889,1,2,1,1,0
29387,467,10219,72,33,56,0,4,12,72,1,1,1,1,2,2,0,2,0,1,0,0,2,12,7,1
29388,467,10219,1454,835,1044,76,110,219,1530,17,275,158,296,292,454,2297,3718,9,34017,1889,1,2,12,7,1
29389,66,2718,1289,550,1043,56,32,155,1345,10,167,93,185,177,278,1266,2075,5,11498,638,0,2,17,0,1
29390,466,10197,72,33,56,0,4,12,72,1,1,1,1,2,2,0,2,0,1,0,0,2,1,1,1
29391,466,10197,1454,835,1044,76,110,219,1530,17,275,158,296,292,454,2297,3718,9,34017,1889,1,2,1,1,1
29415,172,3989,722,423,573,19,0,135,741,12,172,101,199,184,300,1320,2257,6,15668,870,0,2,2,4,1
29416,172,3989,1508,847,911,44,250,301,1552,14,148,88,169,162,257,1120,1886,7,15077,837,0,2,2,4,1
29417,466,10197,72,33,56,0,4,12,72,1,1,1,1,2,2,0,2,0,1,0,0,2,2,1,1
29418,466,10197,1454,835,1044,76,110,219,1530,17,275,158,296,292,454,2297,3718,9,34017,1889,1,2,2,1,1
29419,20,615,42,7,35,4,0,5,46,1,2,1,2,3,3,2,4,0,2,0,0,2,5,5,1
29420,20,615,11,6,10,0,0,1,11,2,4,2,4,6,6,10,15,1,15,0,0,2,5,5,1
29421,65,3083,1338,495,1086,10,64,173,1348,11,122,82,157,133,239,883,1686,7,11934,663,0,2,20,0,1
29422,31,888,465,148,393,5,8,60,470,4,31,20,31,35,51,161,261,2,523,29,0,2,2,2,1
29423,31,888,16,12,9,0,0,6,16,1,2,1,2,3,3,2,4,0,2,0,0,2,2,2,1
29424,467,10219,72,33,56,0,4,12,72,1,1,1,1,2,2,0,2,0,1,0,0,2,12,7,0
29425,467,10219,1454,835,1044,76,110,219,1530,17,275,158,296,292,454,2297,3718,9,34017,1889,1,2,12,7,0
29426,66,2718,1289,550,1043,56,32,155,1345,10,167,93,185,177,278,1266,2075,5,11498,638,0,2,17,0,0
29430,174,4018,722,423,573,19,0,135,741,12,172,101,199,184,300,1320,2257,6,15668,870,0,2,11,2,1
29431,174,4018,1508,847,911,44,250,301,1552,14,148,88,169,162,257,1120,1886,7,15077,837,0,2,11,2,1
29432,16,635,722,423,573,19,0,135,741,12,172,101,199,184,300,1320,2257,6,15668,870,0,2,11,0,1
29456,172,3989,722,423,573,19,0,135,741,12,172,101,199,184,300,1320,2257,6,15668,870,0,2,2,4,0
29457,172,3989,1508,847,911,44,250,301,1552,14,148,88,169,162,257,1120,1886,7,15077,837,0,2,2,4,0
29458,467,10219,72,33,56,0,4,12,72,1,1,1,1,2,2,0,2,0,1,0,0,2,2,1,0
29459,467,10219,1454,835,1044,76,110,219,1530,17,275,158,296,292,454,2297,3718,9,34017,1889,1,2,2,1,0
29460,20,615,42,7,35,4,0,5,46,1,2,1,2,3,3,2,4,0,2,0,0,2,5,5,0
29461,20,615,11,6,10,0,0,1,11,2,4,2,4,6,6,10,15,1,15,0,0,2,5,5,0
29462,65,3083,1338,495,1086,10,64,173,1348,11,122,82,157,133,239,883,1686,7,11934,663,0,2,20,0,0
29463,31,888,465,148,393,5,8,60,470,4,31,20,31,35,51,161,261,2,523,29,0,2,2,2,0
29464,31,888,16,12,9,0,0,6,16,1,2,1,2,3,3,2,4,0,2,0,0,2,2,2,0
29465,173,4006,722,423,573,19,0,135,741,12,172,101,199,184,300,1320,2257,6,15668,870,0,2,11,2,0
29466,173,4006,1508,847,911,44,250,301,1552,14,148,88,169,162,257,1120,1886,7,15077,837,0,2,11,2,0
29467,16,635,722,423,573,19,0,135,741,12,172,101,199,184,300,1320,2257,6,15668,870,0,2,11,0,0
29468,287,5589,1457,730,1242,11,6,188,1468,10,292,166,329,302,495,2424,4078,5,22973,1276,1,2,113,2,1
29469,287,5589,74,35,59,1,0,14,75,3,14,7,14,17,21,58,85,1,128,7,0,2,113,2,1
29470,287,5589,245,125,200,5,7,34,250,7,30,17,34,37,51,166,265,3,1053,58,0,2,113,2,1
29471,46,449,647,139,84,35,284,233,682,0,0,0,0,0,0,0,0,0,0,0,0,2,1,1,1
29472,172,3925,77,34,69,0,0,8,77,3,24,16,29,27,45,114,213,1,387,21,0,2,1,1,1
29473,172,3925,712,438,573,51,9,84,763,14,102,71,128,116,199,733,1364,8,11988,666,0,2,1,1,1
29474,16,631,722,423,573,19,0,135,741,12,172,101,199,184,300,1320,2257,6,15668,870,0,2,3,3,1
29475,62,2690,1943,715,1694,26,18,214,1969,12,185,120,237,197,357,1436,2721,7,20915,1161,0,2,3,1,1
29476,172,3933,77,34,69,0,0,8,77,3,24,16,29,27,45,114,213,1,387,21,0,2,3,1,0
29477,172,3933,712,438,573,51,9,84,763,14,102,71,128,116,199,733,1364,8,11988,666,0,2,3,1,0
29478,292,5675,1457,730,1242,11,6,188,1468,10,292,166,329,302,495,2424,4078,5,22973,1276,1,2,15,1,1
29479,292,5675,74,35,59,1,0,14,75,3,14,7,14,17,21,58,85,1,128,7,0,2,15,1,1
29480,292,5675,245,125,200,5,7,34,250,7,30,17,34,37,51,166,265,3,1053,58,0,2,15,1,1
29481,291,5664,1457,730,1242,11,6,188,1468,10,292,166,329,302,495,2424,4078,5,22973,1276,1,2,1,4,1
29482,291,5664,74,35,59,1,0,14,75,3,14,7,14,17,21,58,85,1,128,7,0,2,1,4,1
29483,291,5664,245,125,200,5,7,34,250,7,30,17,34,37,51,166,265,3,1053,58,0,2,1,4,1
29484,290,5645,1457,730,1242,11,6,188,1468,10,292,166,329,302,495,2424,4078,5,22973,1276,1,2,0,2,0
29485,290,5645,74,35,59,1,0,14,75,3,14,7,14,17,21,58,85,1,128,7,0,2,0,2,0
29486,290,5645,245,125,200,5,7,34,250,7,30,17,34,37,51,166,265,3,1053,58,0,2,0,2,0
29487,16,631,722,423,573,19,0,135,741,12,172,101,199,184,300,1320,2257,6,15668,870,0,2,1,1,0
29488,12,404,386,256,301,16,9,68,402,4,59,35,69,63,104,355,621,2,1453,80,0,2,0,1,0
29489,36,1381,1098,241,925,5,10,155,1103,7,46,25,49,53,74,273,423,3,1580,87,0,2,0,2,0
29490,287,5589,1457,730,1242,11,6,188,1468,10,292,166,329,302,495,2424,4078,5,22973,1276,1,2,92,98,1
29491,287,5589,74,35,59,1,0,14,75,3,14,7,14,17,21,58,85,1,128,7,0,2,92,98,1
29492,287,5589,245,125,200,5,7,34,250,7,30,17,34,37,51,166,265,3,1053,58,0,2,92,98,1
29493,31,1022,1455,414,1257,16,76,112,1471,5,41,23,46,46,69,231,381,2,1069,59,0,2,1,1,1
29494,31,1022,669,365,481,22,61,110,691,15,103,63,122,118,185,747,1273,8,11311,628,0,2,1,1,1
29495,136,6025,139,89,101,2,0,35,141,7,54,34,62,61,96,330,569,4,2287,127,0,2,1,1,1
29496,136,6025,7,5,5,0,0,2,7,1,2,1,2,3,3,2,4,0,2,0,0,2,1,1,1
29497,29,1861,652,304,544,16,6,88,668,6,89,51,101,95,152,591,998,3,3399,188,0,2,32,43,1
29498,289,5621,1457,730,1242,11,6,188,1468,10,292,166,329,302,495,2424,4078,5,22973,1276,1,2,6,1,0
29499,289,5621,74,35,59,1,0,14,75,3,14,7,14,17,21,58,85,1,128,7,0,2,6,1,0
29500,289,5621,245,125,200,5,7,34,250,7,30,17,34,37,51,166,265,3,1053,58,0,2,6,1,0
29503,33,664,2,2,2,0,0,0,2,0,0,0,0,0,0,0,0,0,0,0,0,2,5,6,1
29517,33,664,99,48,90,1,3,5,100,0,0,0,0,0,0,0,0,0,0,0,0,2,5,6,1
29518,33,664,8,5,5,2,0,1,10,0,0,0,0,0,0,0,0,0,0,0,0,2,5,6,1
29519,33,664,1217,716,841,84,126,174,1301,14,185,118,215,199,333,1446,2542,8,20687,1149,0,2,5,6,1
29520,33,664,160,89,115,0,13,31,160,7,15,11,17,22,28,78,124,3,495,27,0,2,5,6,1
29521,33,664,10,10,9,9,0,0,19,0,0,0,0,0,0,0,0,0,0,0,0,2,5,6,1
29522,33,664,173,84,99,8,29,36,181,5,12,7,13,17,20,54,81,2,221,12,0,2,5,6,1
29523,33,664,3,1,1,3,0,0,6,0,0,0,0,0,0,0,0,0,0,0,0,2,5,6,1
29524,111,2245,1513,682,1277,25,13,200,1538,11,199,116,219,210,335,1557,2584,6,15641,868,0,2,2,2,1
29525,111,2245,819,519,539,24,98,155,843,15,96,57,106,111,163,690,1107,8,9171,509,0,2,2,2,1
29526,289,5615,1457,730,1242,11,6,188,1468,10,292,166,329,302,495,2424,4078,5,22973,1276,1,2,19,20,1
29527,289,5615,74,35,59,1,0,14,75,3,14,7,14,17,21,58,85,1,128,7,0,2,19,20,1
29528,289,5615,245,125,200,5,7,34,250,7,30,17,34,37,51,166,265,3,1053,58,0,2,19,20,1
29529,23,732,74,35,59,1,0,14,75,3,14,7,14,17,21,58,85,1,128,7,0,2,11,15,1
29530,23,732,245,125,200,5,7,34,250,7,30,17,34,37,51,166,265,3,1053,58,0,2,11,15,1
29531,171,3921,77,34,69,0,0,8,77,3,24,16,29,27,45,114,213,1,387,21,0,2,2,4,1
29532,171,3921,712,438,573,51,9,84,763,14,102,71,128,116,199,733,1364,8,11988,666,0,2,2,4,1
29533,68,1230,1020,354,843,12,15,144,1032,8,134,77,144,142,221,970,1580,4,6792,377,0,2,2,2,1
29534,171,3970,722,423,573,19,0,135,741,12,172,101,199,184,300,1320,2257,6,15668,870,0,2,5,9,1
29535,171,3970,1508,847,911,44,250,301,1552,14,148,88,169,162,257,1120,1886,7,15077,837,0,2,5,9,1
29536,38,711,127,75,83,2,11,30,129,4,14,7,14,18,21,61,87,2,175,9,0,2,1,0,1
29537,38,711,652,304,544,16,6,88,668,6,89,51,101,95,152,591,998,3,3399,188,0,2,1,0,1
29538,38,711,2,2,2,0,0,0,2,0,0,0,0,0,0,0,0,0,0,0,0,2,1,0,1
29539,38,711,8,5,5,0,0,3,8,0,0,0,0,0,0,0,0,0,0,0,0,2,1,0,1
29542,38,711,14,8,8,0,0,6,14,0,0,0,0,0,0,0,0,0,0,0,0,2,1,0,1
29543,38,711,6,4,4,0,0,2,6,0,0,0,0,0,0,0,0,0,0,0,0,2,1,0,1
29544,38,711,6,4,4,0,0,2,6,1,2,1,2,3,3,2,4,0,2,0,0,2,1,0,1
29546,38,711,7,5,5,0,0,2,7,0,0,0,0,0,0,0,0,0,0,0,0,2,1,0,1
29548,38,711,10,6,6,0,0,4,10,0,0,0,0,0,0,0,0,0,0,0,0,2,1,0,1
29549,38,711,1,1,1,0,0,0,1,0,0,0,0,0,0,0,0,0,0,0,0,2,1,0,1
29551,38,711,14,10,10,0,0,4,14,1,1,1,1,2,2,0,2,0,1,0,0,2,1,0,1
29552,38,711,46,26,30,3,0,12,49,3,6,3,6,9,9,20,28,1,42,2,0,2,1,0,1
29553,24,966,373,158,315,8,0,51,381,5,76,44,79,81,123,486,779,2,2026,112,0,2,2,2,1
29554,176,4013,722,423,573,19,0,135,741,12,172,101,199,184,300,1320,2257,6,15668,870,0,2,13,0,1
29555,176,4013,1508,847,911,44,250,301,1552,14,148,88,169,162,257,1120,1886,7,15077,837,0,2,13,0,1
29556,176,4018,722,423,573,19,0,135,741,12,172,101,199,184,300,1320,2257,6,15668,870,0,2,6,1,1
29557,176,4018,1508,847,911,44,250,301,1552,14,148,88,169,162,257,1120,1886,7,15077,837,0,2,6,1,1
29558,176,4018,722,423,573,19,0,135,741,12,172,101,199,184,300,1320,2257,6,15668,870,0,2,18,0,0
29559,176,4018,1508,847,911,44,250,301,1552,14,148,88,169,162,257,1120,1886,7,15077,837,0,2,18,0,0
29560,176,4066,722,423,573,19,0,135,741,12,172,101,199,184,300,1320,2257,6,15668,870,0,2,18,0,0
29561,176,4066,1508,847,911,44,250,301,1552,14,148,88,169,162,257,1120,1886,7,15077,837,0,2,18,0,0
29562,174,4030,722,423,573,19,0,135,741,12,172,101,199,184,300,1320,2257,6,15668,870,0,2,18,0,0
29563,174,4030,1508,847,911,44,250,301,1552,14,148,88,169,162,257,1120,1886,7,15077,837,0,2,18,0,0
29564,285,5557,1457,730,1242,11,6,188,1468,10,292,166,329,302,495,2424,4078,5,22973,1276,1,2,14,20,0
29565,285,5557,74,35,59,1,0,14,75,3,14,7,14,17,21,58,85,1,128,7,0,2,14,20,0
29566,285,5557,245,125,200,5,7,34,250,7,30,17,34,37,51,166,265,3,1053,58,0,2,14,20,0
29567,283,5525,1457,730,1242,11,6,188,1468,10,292,166,329,302,495,2424,4078,5,22973,1276,1,2,11,15,1
29568,283,5525,74,35,59,1,0,14,75,3,14,7,14,17,21,58,85,1,128,7,0,2,11,15,1
29569,283,5525,245,125,200,5,7,34,250,7,30,17,34,37,51,166,265,3,1053,58,0,2,11,15,1
29572,33,664,2,2,2,0,0,0,2,0,0,0,0,0,0,0,0,0,0,0,0,2,5,6,0
29586,33,664,99,48,90,1,3,5,100,0,0,0,0,0,0,0,0,0,0,0,0,2,5,6,0
29587,33,664,8,5,5,2,0,1,10,0,0,0,0,0,0,0,0,0,0,0,0,2,5,6,0
29588,33,664,1217,716,841,84,126,174,1301,14,185,118,215,199,333,1446,2542,8,20687,1149,0,2,5,6,0
29589,33,664,160,89,115,0,13,31,160,7,15,11,17,22,28,78,124,3,495,27,0,2,5,6,0
29590,33,664,10,10,9,9,0,0,19,0,0,0,0,0,0,0,0,0,0,0,0,2,5,6,0
29591,33,664,173,84,99,8,29,36,181,5,12,7,13,17,20,54,81,2,221,12,0,2,5,6,0
29592,33,664,3,1,1,3,0,0,6,0,0,0,0,0,0,0,0,0,0,0,0,2,5,6,0
29593,111,2245,1513,682,1277,25,13,200,1538,11,199,116,219,210,335,1557,2584,6,15641,868,0,2,2,2,0
29594,111,2245,819,519,539,24,98,155,843,15,96,57,106,111,163,690,1107,8,9171,509,0,2,2,2,0
29595,283,5525,1457,730,1242,11,6,188,1468,10,292,166,329,302,495,2424,4078,5,22973,1276,1,2,230,122,0
29596,283,5525,74,35,59,1,0,14,75,3,14,7,14,17,21,58,85,1,128,7,0,2,230,122,0
29597,283,5525,245,125,200,5,7,34,250,7,30,17,34,37,51,166,265,3,1053,58,0,2,230,122,0
29598,31,1022,1455,414,1257,16,76,112,1471,5,41,23,46,46,69,231,381,2,1069,59,0,2,1,1,0
29599,31,1022,669,365,481,22,61,110,691,15,103,63,122,118,185,747,1273,8,11311,628,0,2,1,1,0
29600,23,732,74,35,59,1,0,14,75,3,14,7,14,17,21,58,85,1,128,7,0,2,11,15,0
29601,23,732,245,125,200,5,7,34,250,7,30,17,34,37,51,166,265,3,1053,58,0,2,11,15,0
29603,171,3921,77,34,69,0,0,8,77,3,24,16,29,27,45,114,213,1,387,21,0,2,6,6,0
29604,171,3921,712,438,573,51,9,84,763,14,102,71,128,116,199,733,1364,8,11988,666,0,2,6,6,0
29605,68,1230,1020,354,843,12,15,144,1032,8,134,77,144,142,221,970,1580,4,6792,377,0,2,2,2,0
29606,174,4030,722,423,573,19,0,135,741,12,172,101,199,184,300,1320,2257,6,15668,870,0,2,5,9,0
29607,174,4030,1508,847,911,44,250,301,1552,14,148,88,169,162,257,1120,1886,7,15077,837,0,2,5,9,0
29608,38,711,127,75,83,2,11,30,129,4,14,7,14,18,21,61,87,2,175,9,0,2,1,0,0
29609,38,711,652,304,544,16,6,88,668,6,89,51,101,95,152,591,998,3,3399,188,0,2,1,0,0
29610,38,711,2,2,2,0,0,0,2,0,0,0,0,0,0,0,0,0,0,0,0,2,1,0,0
29611,38,711,8,5,5,0,0,3,8,0,0,0,0,0,0,0,0,0,0,0,0,2,1,0,0
29614,38,711,14,8,8,0,0,6,14,0,0,0,0,0,0,0,0,0,0,0,0,2,1,0,0
29615,38,711,6,4,4,0,0,2,6,0,0,0,0,0,0,0,0,0,0,0,0,2,1,0,0
29616,38,711,6,4,4,0,0,2,6,1,2,1,2,3,3,2,4,0,2,0,0,2,1,0,0
29618,38,711,7,5,5,0,0,2,7,0,0,0,0,0,0,0,0,0,0,0,0,2,1,0,0
29620,38,711,10,6,6,0,0,4,10,0,0,0,0,0,0,0,0,0,0,0,0,2,1,0,0
29621,38,711,1,1,1,0,0,0,1,0,0,0,0,0,0,0,0,0,0,0,0,2,1,0,0
29623,38,711,14,10,10,0,0,4,14,1,1,1,1,2,2,0,2,0,1,0,0,2,1,0,0
29624,38,711,46,26,30,3,0,12,49,3,6,3,6,9,9,20,28,1,42,2,0,2,1,0,0
29625,136,6025,139,89,101,2,0,35,141,7,54,34,62,61,96,330,569,4,2287,127,0,2,1,1,0
29626,136,6025,7,5,5,0,0,2,7,1,2,1,2,3,3,2,4,0,2,0,0,2,1,1,0
29627,29,1861,652,304,544,16,6,88,668,6,89,51,101,95,152,591,998,3,3399,188,0,2,32,43,0
29628,16,631,722,423,573,19,0,135,741,12,172,101,199,184,300,1320,2257,6,15668,870,0,2,4,4,0
29630,24,966,373,158,315,8,0,51,381,5,76,44,79,81,123,486,779,2,2026,112,0,2,2,2,0
29631,62,2690,1943,715,1694,26,18,214,1969,12,185,120,237,197,357,1436,2721,7,20915,1161,0,2,3,1,0
29633,283,5532,1457,730,1242,11,6,188,1468,10,292,166,329,302,495,2424,4078,5,22973,1276,1,2,1,0,1
29634,283,5532,74,35,59,1,0,14,75,3,14,7,14,17,21,58,85,1,128,7,0,2,1,0,1
29635,283,5532,245,125,200,5,7,34,250,7,30,17,34,37,51,166,265,3,1053,58,0,2,1,0,1
29636,47,2308,1457,730,1242,11,6,188,1468,10,292,166,329,302,495,2424,4078,5,22973,1276,1,2,2,1,0
29637,282,5509,1457,730,1242,11,6,188,1468,10,292,166,329,302,495,2424,4078,5,22973,1276,1,2,6,10,0
29638,282,5509,74,35,59,1,0,14,75,3,14,7,14,17,21,58,85,1,128,7,0,2,6,10,0
29639,282,5509,245,125,200,5,7,34,250,7,30,17,34,37,51,166,265,3,1053,58,0,2,6,10,0
29640,111,2266,1513,682,1277,25,13,200,1538,11,199,116,219,210,335,1557,2584,6,15641,868,0,2,7,7,0
29641,111,2266,819,519,539,24,98,155,843,15,96,57,106,111,163,690,1107,8,9171,509,0,2,7,7,0
29642,23,735,74,35,59,1,0,14,75,3,14,7,14,17,21,58,85,1,128,7,0,2,1,1,0
29643,23,735,245,125,200,5,7,34,250,7,30,17,34,37,51,166,265,3,1053,58,0,2,1,1,0
29644,46,483,647,139,84,35,284,233,682,0,0,0,0,0,0,0,0,0,0,0,0,2,16,14,0
29645,171,3927,77,34,69,0,0,8,77,3,24,16,29,27,45,114,213,1,387,21,0,2,2,2,0
29646,171,3927,712,438,573,51,9,84,763,14,102,71,128,116,199,733,1364,8,11988,666,0,2,2,2,0
29647,23,374,424,94,331,4,0,89,428,1,5,5,5,6,10,11,25,0,12,0,0,2,1,1,0
29648,23,374,38,23,23,6,0,8,44,3,11,7,11,14,18,42,68,1,102,5,0,2,1,1,0
29649,16,477,184,100,137,2,15,30,186,6,38,20,39,44,59,214,322,3,991,55,0,2,1,1,0
29650,16,477,103,65,74,8,5,16,111,7,17,9,17,24,26,89,119,3,417,23,0,2,1,1,0
29651,467,10231,72,33,56,0,4,12,72,1,1,1,1,2,2,0,2,0,1,0,0,2,4,4,0
29652,467,10231,1454,835,1044,76,110,219,1530,17,275,158,296,292,454,2297,3718,9,34017,1889,1,2,4,4,0
29653,83,1510,1178,367,1042,6,15,115,1184,9,94,51,95,103,146,644,976,4,4439,246,0,2,2,2,0
29654,83,1510,177,108,140,8,0,27,185,6,30,16,32,36,48,162,248,3,794,44,0,2,2,2,0
29655,168,3521,1943,715,1694,26,18,214,1969,12,185,120,237,197,357,1436,2721,7,20915,1161,0,2,2,2,0
29656,168,3521,1168,838,957,57,25,144,1225,19,348,224,416,367,640,3018,5452,11,61921,3440,1,2,2,2,0
29657,51,1018,1098,241,925,5,10,155,1103,7,46,25,49,53,74,273,423,3,1580,87,0,2,2,2,0
29658,51,1018,282,202,222,14,2,44,296,8,42,24,43,50,67,250,378,4,1548,86,0,2,2,2,0
29659,38,714,127,75,83,2,11,30,129,4,14,7,14,18,21,61,87,2,175,9,0,2,1,1,0
29660,38,714,652,304,544,16,6,88,668,6,89,51,101,95,152,591,998,3,3399,188,0,2,1,1,0
29661,38,714,2,2,2,0,0,0,2,0,0,0,0,0,0,0,0,0,0,0,0,2,1,1,0
29662,38,714,8,5,5,0,0,3,8,0,0,0,0,0,0,0,0,0,0,0,0,2,1,1,0
29665,38,714,14,8,8,0,0,6,14,0,0,0,0,0,0,0,0,0,0,0,0,2,1,1,0
29666,38,714,6,4,4,0,0,2,6,0,0,0,0,0,0,0,0,0,0,0,0,2,1,1,0
29667,38,714,6,4,4,0,0,2,6,1,2,1,2,3,3,2,4,0,2,0,0,2,1,1,0
29669,38,714,7,5,5,0,0,2,7,0,0,0,0,0,0,0,0,0,0,0,0,2,1,1,0
29671,38,714,10,6,6,0,0,4,10,0,0,0,0,0,0,0,0,0,0,0,0,2,1,1,0
29672,38,714,1,1,1,0,0,0,1,0,0,0,0,0,0,0,0,0,0,0,0,2,1,1,0
29674,38,714,14,10,10,0,0,4,14,1,1,1,1,2,2,0,2,0,1,0,0,2,1,1,0
29675,38,714,46,26,30,3,0,12,49,3,6,3,6,9,9,20,28,1,42,2,0,2,1,1,0
29676,65,3083,1338,495,1086,10,64,173,1348,11,122,82,157,133,239,883,1686,7,11934,663,0,2,1,1,0
29677,8,257,74,35,59,1,0,14,75,3,14,7,14,17,21,58,85,1,128,7,0,2,1,1,0
29678,55,2363,1020,354,843,12,15,144,1032,8,134,77,144,142,221,970,1580,4,6792,377,0,2,1,1,0
29679,278,5480,1457,730,1242,11,6,188,1468,10,292,166,329,302,495,2424,4078,5,22973,1276,1,2,8,14,1
29680,278,5480,74,35,59,1,0,14,75,3,14,7,14,17,21,58,85,1,128,7,0,2,8,14,1
29681,278,5480,245,125,200,5,7,34,250,7,30,17,34,37,51,166,265,3,1053,58,0,2,8,14,1
29682,46,511,647,139,84,35,284,233,682,0,0,0,0,0,0,0,0,0,0,0,0,2,36,23,1
29683,468,10250,72,33,56,0,4,12,72,1,1,1,1,2,2,0,2,0,1,0,0,2,7,5,1
29684,468,10250,1454,835,1044,76,110,219,1530,17,275,158,296,292,454,2297,3718,9,34017,1889,1,2,7,5,1
29685,47,2308,1457,730,1242,11,6,188,1468,10,292,166,329,302,495,2424,4078,5,22973,1276,1,2,1,1,1
29686,278,5491,1457,730,1242,11,6,188,1468,10,292,166,329,302,495,2424,4078,5,22973,1276,1,2,7,6,1
29687,278,5491,74,35,59,1,0,14,75,3,14,7,14,17,21,58,85,1,128,7,0,2,7,6,1
29688,278,5491,245,125,200,5,7,34,250,7,30,17,34,37,51,166,265,3,1053,58,0,2,7,6,1
29689,46,518,647,139,84,35,284,233,682,0,0,0,0,0,0,0,0,0,0,0,0,2,5,3,1
29690,465,10193,72,33,56,0,4,12,72,1,1,1,1,2,2,0,2,0,1,0,0,2,2,13,1
29691,465,10193,1454,835,1044,76,110,219,1530,17,275,158,296,292,454,2297,3718,9,34017,1889,1,2,2,13,1
29692,278,5472,1457,730,1242,11,6,188,1468,10,292,166,329,302,495,2424,4078,5,22973,1276,1,2,7,8,1
29693,278,5472,74,35,59,1,0,14,75,3,14,7,14,17,21,58,85,1,128,7,0,2,7,8,1
29694,278,5472,245,125,200,5,7,34,250,7,30,17,34,37,51,166,265,3,1053,58,0,2,7,8,1
29695,47,2310,1457,730,1242,11,6,188,1468,10,292,166,329,302,495,2424,4078,5,22973,1276,1,2,2,2,1
29696,278,5481,1457,730,1242,11,6,188,1468,10,292,166,329,302,495,2424,4078,5,22973,1276,1,2,2,1,0
29697,278,5481,74,35,59,1,0,14,75,3,14,7,14,17,21,58,85,1,128,7,0,2,2,1,0
29698,278,5481,245,125,200,5,7,34,250,7,30,17,34,37,51,166,265,3,1053,58,0,2,2,1,0
29699,23,749,74,35,59,1,0,14,75,3,14,7,14,17,21,58,85,1,128,7,0,2,3,1,0
29700,23,749,245,125,200,5,7,34,250,7,30,17,34,37,51,166,265,3,1053,58,0,2,3,1,0
29701,175,4049,722,423,573,19,0,135,741,12,172,101,199,184,300,1320,2257,6,15668,870,0,2,7,7,0
29702,175,4049,1508,847,911,44,250,301,1552,14,148,88,169,162,257,1120,1886,7,15077,837,0,2,7,7,0
29703,276,5455,1457,730,1242,11,6,188,1468,10,292,166,329,302,495,2424,4078,5,22973,1276,1,2,12,16,1
29704,276,5455,74,35,59,1,0,14,75,3,14,7,14,17,21,58,85,1,128,7,0,2,12,16,1
29705,276,5455,245,125,200,5,7,34,250,7,30,17,34,37,51,166,265,3,1053,58,0,2,12,16,1
29706,175,4047,722,423,573,19,0,135,741,12,172,101,199,184,300,1320,2257,6,15668,870,0,2,1,1,1
29707,175,4047,1508,847,911,44,250,301,1552,14,148,88,169,162,257,1120,1886,7,15077,837,0,2,1,1,1
29708,47,2309,1457,730,1242,11,6,188,1468,10,292,166,329,302,495,2424,4078,5,22973,1276,1,2,1,1,1
29709,62,2690,1943,715,1694,26,18,214,1969,12,185,120,237,197,357,1436,2721,7,20915,1161,0,2,1,1,1
29710,276,5455,1457,730,1242,11,6,188,1468,10,292,166,329,302,495,2424,4078,5,22973,1276,1,2,2,0,0
29711,276,5455,74,35,59,1,0,14,75,3,14,7,14,17,21,58,85,1,128,7,0,2,2,0,0
29712,276,5455,245,125,200,5,7,34,250,7,30,17,34,37,51,166,265,3,1053,58,0,2,2,0,0
29713,170,3910,77,34,69,0,0,8,77,3,24,16,29,27,45,114,213,1,387,21,0,2,0,3,0
29714,170,3910,712,438,573,51,9,84,763,14,102,71,128,116,199,733,1364,8,11988,666,0,2,0,3,0
29715,273,5403,1457,730,1242,11,6,188,1468,10,292,166,329,302,495,2424,4078,5,22973,1276,1,2,17,23,1
29716,273,5403,74,35,59,1,0,14,75,3,14,7,14,17,21,58,85,1,128,7,0,2,17,23,1
29717,273,5403,245,125,200,5,7,34,250,7,30,17,34,37,51,166,265,3,1053,58,0,2,17,23,1
29718,171,3942,77,34,69,0,0,8,77,3,24,16,29,27,45,114,213,1,387,21,0,2,19,8,1
29719,171,3942,712,438,573,51,9,84,763,14,102,71,128,116,199,733,1364,8,11988,666,0,2,19,8,1
29720,273,5395,1457,730,1242,11,6,188,1468,10,292,166,329,302,495,2424,4078,5,22973,1276,1,2,2,3,1
29721,273,5395,74,35,59,1,0,14,75,3,14,7,14,17,21,58,85,1,128,7,0,2,2,3,1
29722,273,5395,245,125,200,5,7,34,250,7,30,17,34,37,51,166,265,3,1053,58,0,2,2,3,1
29723,267,5292,1457,730,1242,11,6,188,1468,10,292,166,329,302,495,2424,4078,5,22973,1276,1,2,5,26,0
29724,267,5292,74,35,59,1,0,14,75,3,14,7,14,17,21,58,85,1,128,7,0,2,5,26,0
29725,267,5292,245,125,200,5,7,34,250,7,30,17,34,37,51,166,265,3,1053,58,0,2,5,26,0
29726,267,5310,1457,730,1242,11,6,188,1468,10,292,166,329,302,495,2424,4078,5,22973,1276,1,2,8,0,1
29727,267,5310,74,35,59,1,0,14,75,3,14,7,14,17,21,58,85,1,128,7,0,2,8,0,1
29728,267,5310,245,125,200,5,7,34,250,7,30,17,34,37,51,166,265,3,1053,58,0,2,8,0,1
29729,270,5415,1457,730,1242,11,6,188,1468,10,292,166,329,302,495,2424,4078,5,22973,1276,1,2,19,4,1
29730,270,5415,74,35,59,1,0,14,75,3,14,7,14,17,21,58,85,1,128,7,0,2,19,4,1
29731,270,5415,245,125,200,5,7,34,250,7,30,17,34,37,51,166,265,3,1053,58,0,2,19,4,1
29732,169,3534,1943,715,1694,26,18,214,1969,12,185,120,237,197,357,1436,2721,7,20915,1161,0,2,2,0,1
29733,169,3534,1168,838,957,57,25,144,1225,19,348,224,416,367,640,3018,5452,11,61921,3440,1,2,2,0,1
29734,38,708,127,75,83,2,11,30,129,4,14,7,14,18,21,61,87,2,175,9,0,2,3,4,1
29735,38,708,652,304,544,16,6,88,668,6,89,51,101,95,152,591,998,3,3399,188,0,2,3,4,1
29736,38,708,2,2,2,0,0,0,2,0,0,0,0,0,0,0,0,0,0,0,0,2,3,4,1
29737,38,708,8,5,5,0,0,3,8,0,0,0,0,0,0,0,0,0,0,0,0,2,3,4,1
29740,38,708,14,8,8,0,0,6,14,0,0,0,0,0,0,0,0,0,0,0,0,2,3,4,1
29741,38,708,6,4,4,0,0,2,6,0,0,0,0,0,0,0,0,0,0,0,0,2,3,4,1
29742,38,708,6,4,4,0,0,2,6,1,2,1,2,3,3,2,4,0,2,0,0,2,3,4,1
29744,38,708,7,5,5,0,0,2,7,0,0,0,0,0,0,0,0,0,0,0,0,2,3,4,1
29746,38,708,10,6,6,0,0,4,10,0,0,0,0,0,0,0,0,0,0,0,0,2,3,4,1
29747,38,708,1,1,1,0,0,0,1,0,0,0,0,0,0,0,0,0,0,0,0,2,3,4,1
29749,38,708,14,10,10,0,0,4,14,1,1,1,1,2,2,0,2,0,1,0,0,2,3,4,1
29750,38,708,46,26,30,3,0,12,49,3,6,3,6,9,9,20,28,1,42,2,0,2,3,4,1
29751,271,5435,1457,730,1242,11,6,188,1468,10,292,166,329,302,495,2424,4078,5,22973,1276,1,2,4,1,0
29752,271,5435,74,35,59,1,0,14,75,3,14,7,14,17,21,58,85,1,128,7,0,2,4,1,0
29753,271,5435,245,125,200,5,7,34,250,7,30,17,34,37,51,166,265,3,1053,58,0,2,4,1,0
29756,271,5435,1457,730,1242,11,6,188,1468,10,292,166,329,302,495,2424,4078,5,22973,1276,1,2,75,87,0
29757,271,5435,74,35,59,1,0,14,75,3,14,7,14,17,21,58,85,1,128,7,0,2,75,87,0
29758,271,5435,245,125,200,5,7,34,250,7,30,17,34,37,51,166,265,3,1053,58,0,2,75,87,0
29759,23,749,74,35,59,1,0,14,75,3,14,7,14,17,21,58,85,1,128,7,0,2,4,2,0
29760,23,749,245,125,200,5,7,34,250,7,30,17,34,37,51,166,265,3,1053,58,0,2,4,2,0
29761,46,518,647,139,84,35,284,233,682,0,0,0,0,0,0,0,0,0,0,0,0,2,53,36,0
29762,171,3942,77,34,69,0,0,8,77,3,24,16,29,27,45,114,213,1,387,21,0,2,21,13,0
29763,171,3942,712,438,573,51,9,84,763,14,102,71,128,116,199,733,1364,8,11988,666,0,2,21,13,0
29768,175,4047,722,423,573,19,0,135,741,12,172,101,199,184,300,1320,2257,6,15668,870,0,2,7,7,0
29769,175,4047,1508,847,911,44,250,301,1552,14,148,88,169,162,257,1120,1886,7,15077,837,0,2,7,7,0
29770,465,10193,72,33,56,0,4,12,72,1,1,1,1,2,2,0,2,0,1,0,0,2,11,20,0
29771,465,10193,1454,835,1044,76,110,219,1530,17,275,158,296,292,454,2297,3718,9,34017,1889,1,2,11,20,0
29774,169,3534,1943,715,1694,26,18,214,1969,12,185,120,237,197,357,1436,2721,7,20915,1161,0,2,4,2,0
29775,169,3534,1168,838,957,57,25,144,1225,19,348,224,416,367,640,3018,5452,11,61921,3440,1,2,4,2,0
29778,38,708,127,75,83,2,11,30,129,4,14,7,14,18,21,61,87,2,175,9,0,2,3,4,0
29779,38,708,652,304,544,16,6,88,668,6,89,51,101,95,152,591,998,3,3399,188,0,2,3,4,0
29780,38,708,2,2,2,0,0,0,2,0,0,0,0,0,0,0,0,0,0,0,0,2,3,4,0
29781,38,708,8,5,5,0,0,3,8,0,0,0,0,0,0,0,0,0,0,0,0,2,3,4,0
29784,38,708,14,8,8,0,0,6,14,0,0,0,0,0,0,0,0,0,0,0,0,2,3,4,0
29785,38,708,6,4,4,0,0,2,6,0,0,0,0,0,0,0,0,0,0,0,0,2,3,4,0
29786,38,708,6,4,4,0,0,2,6,1,2,1,2,3,3,2,4,0,2,0,0,2,3,4,0
29788,38,708,7,5,5,0,0,2,7,0,0,0,0,0,0,0,0,0,0,0,0,2,3,4,0
29790,38,708,10,6,6,0,0,4,10,0,0,0,0,0,0,0,0,0,0,0,0,2,3,4,0
29791,38,708,1,1,1,0,0,0,1,0,0,0,0,0,0,0,0,0,0,0,0,2,3,4,0
29793,38,708,14,10,10,0,0,4,14,1,1,1,1,2,2,0,2,0,1,0,0,2,3,4,0
29794,38,708,46,26,30,3,0,12,49,3,6,3,6,9,9,20,28,1,42,2,0,2,3,4,0
29796,47,2309,1457,730,1242,11,6,188,1468,10,292,166,329,302,495,2424,4078,5,22973,1276,1,2,5,4,0
29799,62,2690,1943,715,1694,26,18,214,1969,12,185,120,237,197,357,1436,2721,7,20915,1161,0,2,1,1,0
29800,176,4105,722,423,573,19,0,135,741,12,172,101,199,184,300,1320,2257,6,15668,870,0,2,8,0,1
29801,176,4105,1508,847,911,44,250,301,1552,14,148,88,169,162,257,1120,1886,7,15077,837,0,2,8,0,1
29802,65,3083,1338,495,1086,10,64,173,1348,11,122,82,157,133,239,883,1686,7,11934,663,0,2,1,5,1
29803,66,3580,1782,648,1425,9,47,279,1791,8,171,97,189,179,286,1292,2140,4,9462,525,0,2,1,3,1
29804,47,2312,1457,730,1242,11,6,188,1468,10,292,166,329,302,495,2424,4078,5,22973,1276,1,2,4,7,1
29805,17,526,424,94,331,4,0,89,428,1,5,5,5,6,10,11,25,0,12,0,0,2,1,3,1
29807,176,4105,722,423,573,19,0,135,741,12,172,101,199,184,300,1320,2257,6,15668,870,0,2,8,0,0
29808,176,4105,1508,847,911,44,250,301,1552,14,148,88,169,162,257,1120,1886,7,15077,837,0,2,8,0,0
29809,65,3083,1338,495,1086,10,64,173,1348,11,122,82,157,133,239,883,1686,7,11934,663,0,2,1,5,0
29810,66,3580,1782,648,1425,9,47,279,1791,8,171,97,189,179,286,1292,2140,4,9462,525,0,2,1,3,0
29811,47,2312,1457,730,1242,11,6,188,1468,10,292,166,329,302,495,2424,4078,5,22973,1276,1,2,4,7,0
29812,17,526,424,94,331,4,0,89,428,1,5,5,5,6,10,11,25,0,12,0,0,2,1,3,0
29814,273,5456,1457,730,1242,11,6,188,1468,10,292,166,329,302,495,2424,4078,5,22973,1276,1,2,14,10,1
29815,273,5456,74,35,59,1,0,14,75,3,14,7,14,17,21,58,85,1,128,7,0,2,14,10,1
29816,273,5456,245,125,200,5,7,34,250,7,30,17,34,37,51,166,265,3,1053,58,0,2,14,10,1
29817,170,3908,77,34,69,0,0,8,77,3,24,16,29,27,45,114,213,1,387,21,0,2,1,4,1
29818,170,3908,712,438,573,51,9,84,763,14,102,71,128,116,199,733,1364,8,11988,666,0,2,1,4,1
29819,180,4204,722,423,573,19,0,135,741,12,172,101,199,184,300,1320,2257,6,15668,870,0,2,31,4,1
29820,180,4204,1508,847,911,44,250,301,1552,14,148,88,169,162,257,1120,1886,7,15077,837,0,2,31,4,1
29821,65,3083,1338,495,1086,10,64,173,1348,11,122,82,157,133,239,883,1686,7,11934,663,0,2,18,18,1
29822,136,6025,139,89,101,2,0,35,141,7,54,34,62,61,96,330,569,4,2287,127,0,2,57,57,1
29823,136,6025,7,5,5,0,0,2,7,1,2,1,2,3,3,2,4,0,2,0,0,2,57,57,1
29824,66,3569,1782,648,1425,9,47,279,1791,8,171,97,189,179,286,1292,2140,4,9462,525,0,2,26,34,1
29825,64,2475,1450,624,1228,12,26,181,1462,14,306,186,354,320,540,2580,4493,8,36391,2021,1,2,1,1,1
29826,47,2312,1457,730,1242,11,6,188,1468,10,292,166,329,302,495,2424,4078,5,22973,1276,1,2,5,5,1
29827,17,522,424,94,331,4,0,89,428,1,5,5,5,6,10,11,25,0,12,0,0,2,16,20,1
29828,276,5499,1457,730,1242,11,6,188,1468,10,292,166,329,302,495,2424,4078,5,22973,1276,1,2,21,9,1
29829,276,5499,74,35,59,1,0,14,75,3,14,7,14,17,21,58,85,1,128,7,0,2,21,9,1
29830,276,5499,245,125,200,5,7,34,250,7,30,17,34,37,51,166,265,3,1053,58,0,2,21,9,1
29831,181,4293,722,423,573,19,0,135,741,12,172,101,199,184,300,1320,2257,6,15668,870,0,2,29,13,1
29832,181,4293,1508,847,911,44,250,301,1552,14,148,88,169,162,257,1120,1886,7,15077,837,0,2,29,13,1
29833,1,88,13,10,10,0,0,3,13,1,2,1,2,3,3,2,4,0,2,0,0,2,1,1,1
29834,66,2732,1289,550,1043,56,32,155,1345,10,167,93,185,177,278,1266,2075,5,11498,638,0,2,3,2,1
29835,39,715,127,75,83,2,11,30,129,4,14,7,14,18,21,61,87,2,175,9,0,2,39,35,1
29836,39,715,652,304,544,16,6,88,668,6,89,51,101,95,152,591,998,3,3399,188,0,2,39,35,1
29837,39,715,2,2,2,0,0,0,2,0,0,0,0,0,0,0,0,0,0,0,0,2,39,35,1
29838,39,715,8,5,5,0,0,3,8,0,0,0,0,0,0,0,0,0,0,0,0,2,39,35,1
29841,39,715,14,8,8,0,0,6,14,0,0,0,0,0,0,0,0,0,0,0,0,2,39,35,1
29842,39,715,6,4,4,0,0,2,6,0,0,0,0,0,0,0,0,0,0,0,0,2,39,35,1
29843,39,715,6,4,4,0,0,2,6,1,2,1,2,3,3,2,4,0,2,0,0,2,39,35,1
29845,39,715,7,5,5,0,0,2,7,0,0,0,0,0,0,0,0,0,0,0,0,2,39,35,1
29847,39,715,10,6,6,0,0,4,10,0,0,0,0,0,0,0,0,0,0,0,0,2,39,35,1
29848,39,715,1,1,1,0,0,0,1,0,0,0,0,0,0,0,0,0,0,0,0,2,39,35,1
29850,39,715,14,10,10,0,0,4,14,1,1,1,1,2,2,0,2,0,1,0,0,2,39,35,1
29851,39,715,46,26,30,3,0,12,49,3,6,3,6,9,9,20,28,1,42,2,0,2,39,35,1
29852,65,3081,1338,495,1086,10,64,173,1348,11,122,82,157,133,239,883,1686,7,11934,663,0,2,2,4,1
29853,136,6023,139,89,101,2,0,35,141,7,54,34,62,61,96,330,569,4,2287,127,0,2,2,4,1
29854,136,6023,7,5,5,0,0,2,7,1,2,1,2,3,3,2,4,0,2,0,0,2,2,4,1
29855,66,3569,1782,648,1425,9,47,279,1791,8,171,97,189,179,286,1292,2140,4,9462,525,0,2,1,1,1
29856,64,2475,1450,624,1228,12,26,181,1462,14,306,186,354,320,540,2580,4493,8,36391,2021,1,2,3,3,1
29857,132,3414,1660,832,1314,41,38,274,1701,20,312,209,395,332,604,2671,5058,12,64042,3557,1,2,3,5,1
29858,111,4259,1513,682,1277,25,13,200,1538,11,199,116,219,210,335,1557,2584,6,15641,868,0,2,29,29,1
29859,47,2814,1296,573,1062,40,33,157,1336,8,201,118,231,209,349,1561,2689,4,12365,686,0,2,0,2,1
29860,28,1176,1455,414,1257,16,76,112,1471,5,41,23,46,46,69,231,381,2,1069,59,0,2,0,2,1
29861,8,257,74,35,59,1,0,14,75,3,14,7,14,17,21,58,85,1,128,7,0,2,2,2,1
29862,31,1169,1293,570,1093,25,15,163,1318,10,195,123,241,205,364,1516,2795,6,17273,959,0,2,1,1,1
29863,24,961,373,158,315,8,0,51,381,5,76,44,79,81,123,486,779,2,2026,112,0,2,0,1,1
29864,211,4765,722,423,573,19,0,135,741,12,172,101,199,184,300,1320,2257,6,15668,870,0,2,158,96,1
29865,211,4765,1508,847,911,44,250,301,1552,14,148,88,169,162,257,1120,1886,7,15077,837,0,2,158,96,1
29866,66,2728,1289,550,1043,56,32,155,1345,10,167,93,185,177,278,1266,2075,5,11498,638,0,2,1,1,1
29884,65,3081,1338,495,1086,10,64,173,1348,11,122,82,157,133,239,883,1686,7,11934,663,0,2,17,17,1
29885,136,6023,139,89,101,2,0,35,141,7,54,34,62,61,96,330,569,4,2287,127,0,2,56,56,1
29886,136,6023,7,5,5,0,0,2,7,1,2,1,2,3,3,2,4,0,2,0,0,2,56,56,1
29887,66,3569,1782,648,1425,9,47,279,1791,8,171,97,189,179,286,1292,2140,4,9462,525,0,2,18,18,1
29888,132,3410,1660,832,1314,41,38,274,1701,20,312,209,395,332,604,2671,5058,12,64042,3557,1,2,2,2,1
29889,111,4256,1513,682,1277,25,13,200,1538,11,199,116,219,210,335,1557,2584,6,15641,868,0,2,18,20,1
29890,47,2814,1296,573,1062,40,33,157,1336,8,201,118,231,209,349,1561,2689,4,12365,686,0,2,1,1,1
29891,47,2312,1457,730,1242,11,6,188,1468,10,292,166,329,302,495,2424,4078,5,22973,1276,1,2,4,4,1
29892,28,1174,1455,414,1257,16,76,112,1471,5,41,23,46,46,69,231,381,2,1069,59,0,2,1,1,1
29893,17,522,424,94,331,4,0,89,428,1,5,5,5,6,10,11,25,0,12,0,0,2,11,11,1
29894,32,1211,1293,570,1093,25,15,163,1318,10,195,123,241,205,364,1516,2795,6,17273,959,0,2,11,4,1
29895,14,581,722,423,573,19,0,135,741,12,172,101,199,184,300,1320,2257,6,15668,870,0,2,1,13,1
29902,276,5499,1457,730,1242,11,6,188,1468,10,292,166,329,302,495,2424,4078,5,22973,1276,1,2,33,17,0
29903,276,5499,74,35,59,1,0,14,75,3,14,7,14,17,21,58,85,1,128,7,0,2,33,17,0
29904,276,5499,245,125,200,5,7,34,250,7,30,17,34,37,51,166,265,3,1053,58,0,2,33,17,0
29905,170,3908,77,34,69,0,0,8,77,3,24,16,29,27,45,114,213,1,387,21,0,2,1,4,0
29906,170,3908,712,438,573,51,9,84,763,14,102,71,128,116,199,733,1364,8,11988,666,0,2,1,4,0
29907,211,4765,722,423,573,19,0,135,741,12,172,101,199,184,300,1320,2257,6,15668,870,0,2,211,106,0
29908,211,4765,1508,847,911,44,250,301,1552,14,148,88,169,162,257,1120,1886,7,15077,837,0,2,211,106,0
29909,1,88,13,10,10,0,0,3,13,1,2,1,2,3,3,2,4,0,2,0,0,2,1,1,0
29910,66,2728,1289,550,1043,56,32,155,1345,10,167,93,185,177,278,1266,2075,5,11498,638,0,2,4,3,0
29928,65,3081,1338,495,1086,10,64,173,1348,11,122,82,157,133,239,883,1686,7,11934,663,0,2,1,3,0
29929,136,6023,139,89,101,2,0,35,141,7,54,34,62,61,96,330,569,4,2287,127,0,2,1,3,0
29930,136,6023,7,5,5,0,0,2,7,1,2,1,2,3,3,2,4,0,2,0,0,2,1,3,0
29931,66,3569,1782,648,1425,9,47,279,1791,8,171,97,189,179,286,1292,2140,4,9462,525,0,2,9,17,0
29932,64,2475,1450,624,1228,12,26,181,1462,14,306,186,354,320,540,2580,4493,8,36391,2021,1,2,2,2,0
29933,132,3410,1660,832,1314,41,38,274,1701,20,312,209,395,332,604,2671,5058,12,64042,3557,1,2,5,7,0
29934,111,4256,1513,682,1277,25,13,200,1538,11,199,116,219,210,335,1557,2584,6,15641,868,0,2,13,15,0
29935,47,2814,1296,573,1062,40,33,157,1336,8,201,118,231,209,349,1561,2689,4,12365,686,0,2,1,3,0
29936,47,2312,1457,730,1242,11,6,188,1468,10,292,166,329,302,495,2424,4078,5,22973,1276,1,2,1,1,0
29937,28,1174,1455,414,1257,16,76,112,1471,5,41,23,46,46,69,231,381,2,1069,59,0,2,1,3,0
29938,8,257,74,35,59,1,0,14,75,3,14,7,14,17,21,58,85,1,128,7,0,2,2,2,0
29939,17,522,424,94,331,4,0,89,428,1,5,5,5,6,10,11,25,0,12,0,0,2,6,10,0
29940,32,1211,1293,570,1093,25,15,163,1318,10,195,123,241,205,364,1516,2795,6,17273,959,0,2,12,5,0
29941,14,581,722,423,573,19,0,135,741,12,172,101,199,184,300,1320,2257,6,15668,870,0,2,1,13,0
29942,24,961,373,158,315,8,0,51,381,5,76,44,79,81,123,486,779,2,2026,112,0,2,0,1,0
29943,276,5497,1457,730,1242,11,6,188,1468,10,292,166,329,302,495,2424,4078,5,22973,1276,1,2,1,1,1
29944,276,5497,74,35,59,1,0,14,75,3,14,7,14,17,21,58,85,1,128,7,0,2,1,1,1
29945,276,5497,245,125,200,5,7,34,250,7,30,17,34,37,51,166,265,3,1053,58,0,2,1,1,1
29946,46,516,647,139,84,35,284,233,682,0,0,0,0,0,0,0,0,0,0,0,0,2,1,1,1
29947,211,4763,722,423,573,19,0,135,741,12,172,101,199,184,300,1320,2257,6,15668,870,0,2,2,2,1
29948,211,4763,1508,847,911,44,250,301,1552,14,148,88,169,162,257,1120,1886,7,15077,837,0,2,2,2,1
29949,468,10239,72,33,56,0,4,12,72,1,1,1,1,2,2,0,2,0,1,0,0,2,15,2,1
29950,468,10239,1454,835,1044,76,110,219,1530,17,275,158,296,292,454,2297,3718,9,34017,1889,1,2,15,2,1
29951,20,617,42,7,35,4,0,5,46,1,2,1,2,3,3,2,4,0,2,0,0,2,1,1,1
29952,20,617,11,6,10,0,0,1,11,2,4,2,4,6,6,10,15,1,15,0,0,2,1,1,1
29953,31,1709,384,251,317,7,8,52,391,11,70,44,84,81,128,467,811,6,5355,297,0,0,311,0,1
29954,283,5665,1457,730,1242,11,6,188,1468,10,292,166,329,302,495,2424,4078,5,22973,1276,1,2,31,9,1
29955,283,5665,74,35,59,1,0,14,75,3,14,7,14,17,21,58,85,1,128,7,0,2,31,9,1
29956,283,5665,245,125,200,5,7,34,250,7,30,17,34,37,51,166,265,3,1053,58,0,2,31,9,1
29957,46,522,647,139,84,35,284,233,682,0,0,0,0,0,0,0,0,0,0,0,0,2,3,1,1
29958,170,3908,77,34,69,0,0,8,77,3,24,16,29,27,45,114,213,1,387,21,0,2,2,2,1
29959,170,3908,712,438,573,51,9,84,763,14,102,71,128,116,199,733,1364,8,11988,666,0,2,2,2,1
29960,47,2318,1457,730,1242,11,6,188,1468,10,292,166,329,302,495,2424,4078,5,22973,1276,1,2,3,3,1
29961,85,1873,477,336,357,30,23,73,507,16,194,134,250,210,384,1538,2962,10,30538,1696,0,2,4,2,0
29962,134,3458,1660,832,1314,41,38,274,1701,20,312,209,395,332,604,2671,5058,12,64042,3557,1,2,21,0,0
29964,134,3451,1660,832,1314,41,38,274,1701,20,312,209,395,332,604,2671,5058,12,64042,3557,1,2,21,0,0
29965,43,863,447,308,343,6,5,95,453,7,96,59,111,103,170,651,1136,4,4600,255,0,2,2,2,0
29966,43,863,322,174,179,16,74,51,338,10,41,26,46,51,72,252,408,5,2291,127,0,2,2,2,0
29967,44,1315,1523,757,1297,19,12,193,1542,12,193,117,230,205,347,1508,2664,7,19053,1058,0,2,4,4,0
29968,44,1315,701,378,504,33,58,109,734,13,110,68,126,123,194,794,1346,7,10027,557,0,2,4,4,0
29969,40,2493,1523,757,1297,19,12,193,1542,12,193,117,230,205,347,1508,2664,7,19053,1058,0,2,5,1,0
29972,284,5669,1457,730,1242,11,6,188,1468,10,292,166,329,302,495,2424,4078,5,22973,1276,1,2,12,11,0
29973,284,5669,74,35,59,1,0,14,75,3,14,7,14,17,21,58,85,1,128,7,0,2,12,11,0
29974,284,5669,245,125,200,5,7,34,250,7,30,17,34,37,51,166,265,3,1053,58,0,2,12,11,0
29979,284,5694,1457,730,1242,11,6,188,1468,10,292,166,329,302,495,2424,4078,5,22973,1276,1,2,27,20,1
29980,284,5694,74,35,59,1,0,14,75,3,14,7,14,17,21,58,85,1,128,7,0,2,27,20,1
29981,284,5694,245,125,200,5,7,34,250,7,30,17,34,37,51,166,265,3,1053,58,0,2,27,20,1
29982,23,749,74,35,59,1,0,14,75,3,14,7,14,17,21,58,85,1,128,7,0,2,3,3,1
29983,23,749,245,125,200,5,7,34,250,7,30,17,34,37,51,166,265,3,1053,58,0,2,3,3,1
29984,46,522,647,139,84,35,284,233,682,0,0,0,0,0,0,0,0,0,0,0,0,2,2,2,1
29985,169,3542,1943,715,1694,26,18,214,1969,12,185,120,237,197,357,1436,2721,7,20915,1161,0,2,6,3,1
29986,169,3542,1168,838,957,57,25,144,1225,19,348,224,416,367,640,3018,5452,11,61921,3440,1,2,6,3,1
29989,8,259,74,35,59,1,0,14,75,3,14,7,14,17,21,58,85,1,128,7,0,2,1,1,1
29990,62,2698,1943,715,1694,26,18,214,1969,12,185,120,237,197,357,1436,2721,7,20915,1161,0,2,6,4,1
29991,111,2266,1513,682,1277,25,13,200,1538,11,199,116,219,210,335,1557,2584,6,15641,868,0,2,7,7,1
29992,111,2266,819,519,539,24,98,155,843,15,96,57,106,111,163,690,1107,8,9171,509,0,2,7,7,1
29993,284,5696,1457,730,1242,11,6,188,1468,10,292,166,329,302,495,2424,4078,5,22973,1276,1,2,7,7,1
29994,284,5696,74,35,59,1,0,14,75,3,14,7,14,17,21,58,85,1,128,7,0,2,7,7,1
29995,284,5696,245,125,200,5,7,34,250,7,30,17,34,37,51,166,265,3,1053,58,0,2,7,7,1
29996,23,749,74,35,59,1,0,14,75,3,14,7,14,17,21,58,85,1,128,7,0,2,1,1,1
29997,23,749,245,125,200,5,7,34,250,7,30,17,34,37,51,166,265,3,1053,58,0,2,1,1,1
29998,46,522,647,139,84,35,284,233,682,0,0,0,0,0,0,0,0,0,0,0,0,2,22,22,1
30001,23,374,424,94,331,4,0,89,428,1,5,5,5,6,10,11,25,0,12,0,0,2,1,1,1
30002,23,374,38,23,23,6,0,8,44,3,11,7,11,14,18,42,68,1,102,5,0,2,1,1,1
30003,16,477,184,100,137,2,15,30,186,6,38,20,39,44,59,214,322,3,991,55,0,2,1,1,1
30004,16,477,103,65,74,8,5,16,111,7,17,9,17,24,26,89,119,3,417,23,0,2,1,1,1
30005,211,4763,722,423,573,19,0,135,741,12,172,101,199,184,300,1320,2257,6,15668,870,0,2,1,1,1
30006,211,4763,1508,847,911,44,250,301,1552,14,148,88,169,162,257,1120,1886,7,15077,837,0,2,1,1,1
30007,468,10239,72,33,56,0,4,12,72,1,1,1,1,2,2,0,2,0,1,0,0,2,3,3,1
30008,468,10239,1454,835,1044,76,110,219,1530,17,275,158,296,292,454,2297,3718,9,34017,1889,1,2,3,3,1
30009,83,1510,1178,367,1042,6,15,115,1184,9,94,51,95,103,146,644,976,4,4439,246,0,2,2,2,1
30010,83,1510,177,108,140,8,0,27,185,6,30,16,32,36,48,162,248,3,794,44,0,2,2,2,1
30011,169,3542,1943,715,1694,26,18,214,1969,12,185,120,237,197,357,1436,2721,7,20915,1161,0,2,2,2,1
30012,169,3542,1168,838,957,57,25,144,1225,19,348,224,416,367,640,3018,5452,11,61921,3440,1,2,2,2,1
30013,51,1018,1098,241,925,5,10,155,1103,7,46,25,49,53,74,273,423,3,1580,87,0,2,2,2,1
30014,51,1018,282,202,222,14,2,44,296,8,42,24,43,50,67,250,378,4,1548,86,0,2,2,2,1
30015,65,3081,1338,495,1086,10,64,173,1348,11,122,82,157,133,239,883,1686,7,11934,663,0,2,1,1,1
30017,55,2363,1020,354,843,12,15,144,1032,8,134,77,144,142,221,970,1580,4,6792,377,0,2,1,1,1
30041,212,4789,722,423,573,19,0,135,741,12,172,101,199,184,300,1320,2257,6,15668,870,0,2,14,6,1
30042,212,4789,1508,847,911,44,250,301,1552,14,148,88,169,162,257,1120,1886,7,15077,837,0,2,14,6,1
30070,284,5696,1457,730,1242,11,6,188,1468,10,292,166,329,302,495,2424,4078,5,22973,1276,1,2,42,12,0
30071,284,5696,74,35,59,1,0,14,75,3,14,7,14,17,21,58,85,1,128,7,0,2,42,12,0
30072,284,5696,245,125,200,5,7,34,250,7,30,17,34,37,51,166,265,3,1053,58,0,2,42,12,0
30073,23,749,74,35,59,1,0,14,75,3,14,7,14,17,21,58,85,1,128,7,0,2,4,4,0
30074,23,749,245,125,200,5,7,34,250,7,30,17,34,37,51,166,265,3,1053,58,0,2,4,4,0
30075,46,522,647,139,84,35,284,233,682,0,0,0,0,0,0,0,0,0,0,0,0,2,23,21,0
30076,170,3908,77,34,69,0,0,8,77,3,24,16,29,27,45,114,213,1,387,21,0,2,4,4,0
30077,170,3908,712,438,573,51,9,84,763,14,102,71,128,116,199,733,1364,8,11988,666,0,2,4,4,0
30082,212,4789,722,423,573,19,0,135,741,12,172,101,199,184,300,1320,2257,6,15668,870,0,2,17,9,0
30083,212,4789,1508,847,911,44,250,301,1552,14,148,88,169,162,257,1120,1886,7,15077,837,0,2,17,9,0
30084,468,10239,72,33,56,0,4,12,72,1,1,1,1,2,2,0,2,0,1,0,0,2,18,5,0
30085,468,10239,1454,835,1044,76,110,219,1530,17,275,158,296,292,454,2297,3718,9,34017,1889,1,2,18,5,0
30088,169,3542,1943,715,1694,26,18,214,1969,12,185,120,237,197,357,1436,2721,7,20915,1161,0,2,8,5,0
30089,169,3542,1168,838,957,57,25,144,1225,19,348,224,416,367,640,3018,5452,11,61921,3440,1,2,8,5,0
30092,20,617,42,7,35,4,0,5,46,1,2,1,2,3,3,2,4,0,2,0,0,2,1,1,0
30093,20,617,11,6,10,0,0,1,11,2,4,2,4,6,6,10,15,1,15,0,0,2,1,1,0
30094,65,3081,1338,495,1086,10,64,173,1348,11,122,82,157,133,239,883,1686,7,11934,663,0,2,1,1,0
30095,47,2318,1457,730,1242,11,6,188,1468,10,292,166,329,302,495,2424,4078,5,22973,1276,1,2,3,3,0
30096,8,259,74,35,59,1,0,14,75,3,14,7,14,17,21,58,85,1,128,7,0,2,2,2,0
30098,31,1709,384,251,317,7,8,52,391,11,70,44,84,81,128,467,811,6,5355,297,0,0,311,0,0
30099,62,2698,1943,715,1694,26,18,214,1969,12,185,120,237,197,357,1436,2721,7,20915,1161,0,2,6,4,0
30123,216,4821,722,423,573,19,0,135,741,12,172,101,199,184,300,1320,2257,6,15668,870,0,2,15,7,1
30124,216,4821,1508,847,911,44,250,301,1552,14,148,88,169,162,257,1120,1886,7,15077,837,0,2,15,7,1
30127,62,2705,1943,715,1694,26,18,214,1969,12,185,120,237,197,357,1436,2721,7,20915,1161,0,2,5,5,1
30151,216,4821,722,423,573,19,0,135,741,12,172,101,199,184,300,1320,2257,6,15668,870,0,2,15,7,0
30152,216,4821,1508,847,911,44,250,301,1552,14,148,88,169,162,257,1120,1886,7,15077,837,0,2,15,7,0
30155,62,2705,1943,715,1694,26,18,214,1969,12,185,120,237,197,357,1436,2721,7,20915,1161,0,2,5,5,0
30158,216,4831,722,423,573,19,0,135,741,12,172,101,199,184,300,1320,2257,6,15668,870,0,2,2,1,1
30159,216,4831,1508,847,911,44,250,301,1552,14,148,88,169,162,257,1120,1886,7,15077,837,0,2,2,1,1
30183,44,872,447,308,343,6,5,95,453,7,96,59,111,103,170,651,1136,4,4600,255,0,2,5,4,1
30184,44,872,322,174,179,16,74,51,338,10,41,26,46,51,72,252,408,5,2291,127,0,2,5,4,1
30185,34,1509,447,308,343,6,5,95,453,7,96,59,111,103,170,651,1136,4,4600,255,0,2,5,0,1
30186,169,3532,1943,715,1694,26,18,214,1969,12,185,120,237,197,357,1436,2721,7,20915,1161,0,2,2,1,1
30187,169,3532,1168,838,957,57,25,144,1225,19,348,224,416,367,640,3018,5452,11,61921,3440,1,2,2,1,1
30188,44,872,447,308,343,6,5,95,453,7,96,59,111,103,170,651,1136,4,4600,255,0,2,5,4,0
30189,44,872,322,174,179,16,74,51,338,10,41,26,46,51,72,252,408,5,2291,127,0,2,5,4,0
30190,34,1509,447,308,343,6,5,95,453,7,96,59,111,103,170,651,1136,4,4600,255,0,2,5,0,0
30191,216,4831,722,423,573,19,0,135,741,12,172,101,199,184,300,1320,2257,6,15668,870,0,2,2,1,0
30192,216,4831,1508,847,911,44,250,301,1552,14,148,88,169,162,257,1120,1886,7,15077,837,0,2,2,1,0
30193,141,4443,1660,832,1314,41,38,274,1701,20,312,209,395,332,604,2671,5058,12,64042,3557,1,2,8,1,0
30194,141,4443,1057,646,719,113,100,145,1170,18,215,134,248,233,382,1740,3004,10,31186,1732,1,2,8,1,0
30202,468,10239,72,33,56,0,4,12,72,1,1,1,1,2,2,0,2,0,1,0,0,2,1,1,1
30203,468,10239,1454,835,1044,76,110,219,1530,17,275,158,296,292,454,2297,3718,9,34017,1889,1,2,1,1,1
30204,34,1509,447,308,343,6,5,95,453,7,96,59,111,103,170,651,1136,4,4600,255,0,2,1,1,1
30205,45,1333,1523,757,1297,19,12,193,1542,12,193,117,230,205,347,1508,2664,7,19053,1058,0,2,4,2,0
30206,45,1333,701,378,504,33,58,109,734,13,110,68,126,123,194,794,1346,7,10027,557,0,2,4,2,0
30207,29,1210,1455,414,1257,16,76,112,1471,5,41,23,46,46,69,231,381,2,1069,59,0,2,13,0,0
30208,29,1211,1455,414,1257,16,76,112,1471,5,41,23,46,46,69,231,381,2,1069,59,0,2,3,0,0
30209,44,1325,1523,757,1297,19,12,193,1542,12,193,117,230,205,347,1508,2664,7,19053,1058,0,2,4,2,0
30210,44,1325,701,378,504,33,58,109,734,13,110,68,126,123,194,794,1346,7,10027,557,0,2,4,2,0
30211,29,1226,1455,414,1257,16,76,112,1471,5,41,23,46,46,69,231,381,2,1069,59,0,2,16,0,0
30212,44,1343,1523,757,1297,19,12,193,1542,12,193,117,230,205,347,1508,2664,7,19053,1058,0,2,3,0,0
30213,44,1343,701,378,504,33,58,109,734,13,110,68,126,123,194,794,1346,7,10027,557,0,2,3,0,0
30214,30,635,215,129,180,6,0,29,221,8,65,43,72,73,115,415,711,4,3153,175,0,2,4,0,0
30215,30,635,97,69,77,3,3,16,100,6,22,13,23,28,36,113,173,3,542,30,0,2,4,0,0
30216,41,2532,1523,757,1297,19,12,193,1542,12,193,117,230,205,347,1508,2664,7,19053,1058,0,2,9,0,0
30217,16,1260,215,129,180,6,0,29,221,8,65,43,72,73,115,415,711,4,3153,175,0,2,14,0,0
30218,45,1361,1523,757,1297,19,12,193,1542,12,193,117,230,205,347,1508,2664,7,19053,1058,0,2,3,0,0
30219,45,1361,701,378,504,33,58,109,734,13,110,68,126,123,194,794,1346,7,10027,557,0,2,3,0,0
30224,41,2533,1523,757,1297,19,12,193,1542,12,193,117,230,205,347,1508,2664,7,19053,1058,0,2,1,0,0
30225,16,1261,215,129,180,6,0,29,221,8,65,43,72,73,115,415,711,4,3153,175,0,2,1,0,0
30226,45,1361,1523,757,1297,19,12,193,1542,12,193,117,230,205,347,1508,2664,7,19053,1058,0,2,1,1,0
30227,45,1361,701,378,504,33,58,109,734,13,110,68,126,123,194,794,1346,7,10027,557,0,2,1,1,0
30228,30,635,215,129,180,6,0,29,221,8,65,43,72,73,115,415,711,4,3153,175,0,2,1,1,0
30229,30,635,97,69,77,3,3,16,100,6,22,13,23,28,36,113,173,3,542,30,0,2,1,1,0
30234,41,2533,1523,757,1297,19,12,193,1542,12,193,117,230,205,347,1508,2664,7,19053,1058,0,2,10,0,0
30235,16,1261,215,129,180,6,0,29,221,8,65,43,72,73,115,415,711,4,3153,175,0,2,15,0,0
30236,46,1369,1523,757,1297,19,12,193,1542,12,193,117,230,205,347,1508,2664,7,19053,1058,0,2,3,0,0
30237,46,1369,701,378,504,33,58,109,734,13,110,68,126,123,194,794,1346,7,10027,557,0,2,3,0,0
30242,86,1567,1178,367,1042,6,15,115,1184,9,94,51,95,103,146,644,976,4,4439,246,0,2,9,0,1
30243,86,1567,177,108,140,8,0,27,185,6,30,16,32,36,48,162,248,3,794,44,0,2,9,0,1
30244,47,2042,1178,367,1042,6,15,115,1184,9,94,51,95,103,146,644,976,4,4439,246,0,2,2,2,1
30245,51,1035,1098,241,925,5,10,155,1103,7,46,25,49,53,74,273,423,3,1580,87,0,2,3,0,1
30246,51,1035,282,202,222,14,2,44,296,8,42,24,43,50,67,250,378,4,1548,86,0,2,3,0,1
30247,37,1422,1098,241,925,5,10,155,1103,7,46,25,49,53,74,273,423,3,1580,87,0,2,13,0,1
30248,86,1567,1178,367,1042,6,15,115,1184,9,94,51,95,103,146,644,976,4,4439,246,0,2,9,0,0
30249,86,1567,177,108,140,8,0,27,185,6,30,16,32,36,48,162,248,3,794,44,0,2,9,0,0
30250,51,1035,1098,241,925,5,10,155,1103,7,46,25,49,53,74,273,423,3,1580,87,0,2,3,0,0
30251,51,1035,282,202,222,14,2,44,296,8,42,24,43,50,67,250,378,4,1548,86,0,2,3,0,0
30252,47,2042,1178,367,1042,6,15,115,1184,9,94,51,95,103,146,644,976,4,4439,246,0,2,2,2,0
30253,37,1422,1098,241,925,5,10,155,1103,7,46,25,49,53,74,273,423,3,1580,87,0,2,13,0,0
30254,86,1573,1178,367,1042,6,15,115,1184,9,94,51,95,103,146,644,976,4,4439,246,0,2,9,0,0
30255,86,1573,177,108,140,8,0,27,185,6,30,16,32,36,48,162,248,3,794,44,0,2,9,0,0
30256,51,1041,1098,241,925,5,10,155,1103,7,46,25,49,53,74,273,423,3,1580,87,0,2,3,0,0
30257,51,1041,282,202,222,14,2,44,296,8,42,24,43,50,67,250,378,4,1548,86,0,2,3,0,0
30260,469,10259,72,33,56,0,4,12,72,1,1,1,1,2,2,0,2,0,1,0,0,2,7,0,1
30261,469,10259,1454,835,1044,76,110,219,1530,17,275,158,296,292,454,2297,3718,9,34017,1889,1,2,7,0,1
30262,11,239,256,139,192,9,7,47,265,4,23,12,24,27,36,112,171,2,357,19,0,2,1,0,1
30263,88,1912,477,336,357,30,23,73,507,16,194,134,250,210,384,1538,2962,10,30538,1696,0,2,12,4,1
30264,72,2650,1450,624,1228,12,26,181,1462,14,306,186,354,320,540,2580,4493,8,36391,2021,1,2,36,0,1
30265,88,1912,477,336,357,30,23,73,507,16,194,134,250,210,384,1538,2962,10,30538,1696,0,2,12,4,0
30266,72,2650,1450,624,1228,12,26,181,1462,14,306,186,354,320,540,2580,4493,8,36391,2021,1,2,36,0,0
30267,469,10259,72,33,56,0,4,12,72,1,1,1,1,2,2,0,2,0,1,0,0,2,7,0,0
30268,469,10259,1454,835,1044,76,110,219,1530,17,275,158,296,292,454,2297,3718,9,34017,1889,1,2,7,0,0
30269,11,239,256,139,192,9,7,47,265,4,23,12,24,27,36,112,171,2,357,19,0,2,1,0,0
30295,285,5722,1457,730,1242,11,6,188,1468,10,292,166,329,302,495,2424,4078,5,22973,1276,1,2,4,0,1
30296,285,5722,74,35,59,1,0,14,75,3,14,7,14,17,21,58,85,1,128,7,0,2,4,0,1
30297,285,5722,245,125,200,5,7,34,250,7,30,17,34,37,51,166,265,3,1053,58,0,2,4,0,1
30298,170,3930,77,34,69,0,0,8,77,3,24,16,29,27,45,114,213,1,387,21,0,2,3,0,1
30299,170,3930,712,438,573,51,9,84,763,14,102,71,128,116,199,733,1364,8,11988,666,0,2,3,0,1
30300,30,1892,652,304,544,16,6,88,668,6,89,51,101,95,152,591,998,3,3399,188,0,2,6,0,1
30301,30,1961,652,304,544,16,6,88,668,6,89,51,101,95,152,591,998,3,3399,188,0,2,1,0,0
30303,285,5716,1457,730,1242,11,6,188,1468,10,292,166,329,302,495,2424,4078,5,22973,1276,1,2,1,1,0
30304,285,5716,74,35,59,1,0,14,75,3,14,7,14,17,21,58,85,1,128,7,0,2,1,1,0
30305,285,5716,245,125,200,5,7,34,250,7,30,17,34,37,51,166,265,3,1053,58,0,2,1,1,0
30306,38,712,127,75,83,2,11,30,129,4,14,7,14,18,21,61,87,2,175,9,0,2,4,2,1
30307,38,712,652,304,544,16,6,88,668,6,89,51,101,95,152,591,998,3,3399,188,0,2,4,2,1
30308,38,712,2,2,2,0,0,0,2,0,0,0,0,0,0,0,0,0,0,0,0,2,4,2,1
30309,38,712,8,5,5,0,0,3,8,0,0,0,0,0,0,0,0,0,0,0,0,2,4,2,1
30312,38,712,14,8,8,0,0,6,14,0,0,0,0,0,0,0,0,0,0,0,0,2,4,2,1
30313,38,712,6,4,4,0,0,2,6,0,0,0,0,0,0,0,0,0,0,0,0,2,4,2,1
30314,38,712,6,4,4,0,0,2,6,1,2,1,2,3,3,2,4,0,2,0,0,2,4,2,1
30316,38,712,7,5,5,0,0,2,7,0,0,0,0,0,0,0,0,0,0,0,0,2,4,2,1
30318,38,712,10,6,6,0,0,4,10,0,0,0,0,0,0,0,0,0,0,0,0,2,4,2,1
30319,38,712,1,1,1,0,0,0,1,0,0,0,0,0,0,0,0,0,0,0,0,2,4,2,1
30321,38,712,14,10,10,0,0,4,14,1,1,1,1,2,2,0,2,0,1,0,0,2,4,2,1
30322,38,712,46,26,30,3,0,12,49,3,6,3,6,9,9,20,28,1,42,2,0,2,4,2,1
30324,470,10279,72,33,56,0,4,12,72,1,1,1,1,2,2,0,2,0,1,0,0,2,7,0,0
30325,470,10279,1454,835,1044,76,110,219,1530,17,275,158,296,292,454,2297,3718,9,34017,1889,1,2,7,0,0
30330,29,1872,652,304,544,16,6,88,668,6,89,51,101,95,152,591,998,3,3399,188,0,2,1,0,0
30331,285,5716,1457,730,1242,11,6,188,1468,10,292,166,329,302,495,2424,4078,5,22973,1276,1,2,4,0,0
30332,285,5716,74,35,59,1,0,14,75,3,14,7,14,17,21,58,85,1,128,7,0,2,4,0,0
30333,285,5716,245,125,200,5,7,34,250,7,30,17,34,37,51,166,265,3,1053,58,0,2,4,0,0
30334,170,3930,77,34,69,0,0,8,77,3,24,16,29,27,45,114,213,1,387,21,0,2,3,0,0
30335,170,3930,712,438,573,51,9,84,763,14,102,71,128,116,199,733,1364,8,11988,666,0,2,3,0,0
30336,30,1903,652,304,544,16,6,88,668,6,89,51,101,95,152,591,998,3,3399,188,0,2,6,0,0
30337,286,5730,1457,730,1242,11,6,188,1468,10,292,166,329,302,495,2424,4078,5,22973,1276,1,2,24,0,1
30338,286,5730,74,35,59,1,0,14,75,3,14,7,14,17,21,58,85,1,128,7,0,2,24,0,1
30339,286,5730,245,125,200,5,7,34,250,7,30,17,34,37,51,166,265,3,1053,58,0,2,24,0,1
30340,67,2756,1289,550,1043,56,32,155,1345,10,167,93,185,177,278,1266,2075,5,11498,638,0,2,6,0,1
30341,18,440,386,256,301,16,9,68,402,4,59,35,69,63,104,355,621,2,1453,80,0,2,2,2,0
30342,18,440,264,131,164,11,41,46,275,6,38,22,40,44,62,214,338,3,1068,59,0,2,2,2,0
30343,12,397,386,256,301,16,9,68,402,4,59,35,69,63,104,355,621,2,1453,80,0,2,4,4,0
30344,12,442,386,256,301,16,9,68,402,4,59,35,69,63,104,355,621,2,1453,80,0,2,6,2,0
30345,170,3536,1943,715,1694,26,18,214,1969,12,185,120,237,197,357,1436,2721,7,20915,1161,0,2,22,19,1
30346,170,3536,1168,838,957,57,25,144,1225,19,348,224,416,367,640,3018,5452,11,61921,3440,1,2,22,19,1
30347,63,3152,1943,715,1694,26,18,214,1969,12,185,120,237,197,357,1436,2721,7,20915,1161,0,2,53,0,1
30348,63,3178,1943,715,1694,26,18,214,1969,12,185,120,237,197,357,1436,2721,7,20915,1161,0,2,3,0,0
30349,63,3215,1943,715,1694,26,18,214,1969,12,185,120,237,197,357,1436,2721,7,20915,1161,0,2,4,0,0
30350,170,3536,1943,715,1694,26,18,214,1969,12,185,120,237,197,357,1436,2721,7,20915,1161,0,2,5,5,1
30351,170,3536,1168,838,957,57,25,144,1225,19,348,224,416,367,640,3018,5452,11,61921,3440,1,2,5,5,1
30352,170,3536,1943,715,1694,26,18,214,1969,12,185,120,237,197,357,1436,2721,7,20915,1161,0,2,1,1,1
30353,170,3536,1168,838,957,57,25,144,1225,19,348,224,416,367,640,3018,5452,11,61921,3440,1,2,1,1,1
30354,172,3552,1943,715,1694,26,18,214,1969,12,185,120,237,197,357,1436,2721,7,20915,1161,0,2,4,0,0
30355,172,3552,1168,838,957,57,25,144,1225,19,348,224,416,367,640,3018,5452,11,61921,3440,1,2,4,0,0
30356,63,3215,1943,715,1694,26,18,214,1969,12,185,120,237,197,357,1436,2721,7,20915,1161,0,2,4,4,0
30357,173,3560,1943,715,1694,26,18,214,1969,12,185,120,237,197,357,1436,2721,7,20915,1161,0,2,3,1,0
30358,173,3560,1168,838,957,57,25,144,1225,19,348,224,416,367,640,3018,5452,11,61921,3440,1,2,3,1,0
30359,63,3215,1943,715,1694,26,18,214,1969,12,185,120,237,197,357,1436,2721,7,20915,1161,0,2,13,7,0
30360,63,3215,1943,715,1694,26,18,214,1969,12,185,120,237,197,357,1436,2721,7,20915,1161,0,2,25,25,1
30361,47,1407,1523,757,1297,19,12,193,1542,12,193,117,230,205,347,1508,2664,7,19053,1058,0,2,11,5,1
30362,47,1407,701,378,504,33,58,109,734,13,110,68,126,123,194,794,1346,7,10027,557,0,2,11,5,1
30363,41,2655,1523,757,1297,19,12,193,1542,12,193,117,230,205,347,1508,2664,7,19053,1058,0,2,25,0,1
30364,47,1407,1523,757,1297,19,12,193,1542,12,193,117,230,205,347,1508,2664,7,19053,1058,0,2,11,5,0
30365,47,1407,701,378,504,33,58,109,734,13,110,68,126,123,194,794,1346,7,10027,557,0,2,11,5,0
30366,41,2655,1523,757,1297,19,12,193,1542,12,193,117,230,205,347,1508,2664,7,19053,1058,0,2,25,0,0
30367,173,3560,1943,715,1694,26,18,214,1969,12,185,120,237,197,357,1436,2721,7,20915,1161,0,2,28,19,0
30368,173,3560,1168,838,957,57,25,144,1225,19,348,224,416,367,640,3018,5452,11,61921,3440,1,2,28,19,0
30369,63,3215,1943,715,1694,26,18,214,1969,12,185,120,237,197,357,1436,2721,7,20915,1161,0,2,66,0,0
30370,41,2660,1523,757,1297,19,12,193,1542,12,193,117,230,205,347,1508,2664,7,19053,1058,0,2,1,1,0
30371,286,5730,1457,730,1242,11,6,188,1468,10,292,166,329,302,495,2424,4078,5,22973,1276,1,2,24,0,0
30372,286,5730,74,35,59,1,0,14,75,3,14,7,14,17,21,58,85,1,128,7,0,2,24,0,0
30373,286,5730,245,125,200,5,7,34,250,7,30,17,34,37,51,166,265,3,1053,58,0,2,24,0,0
30374,67,2756,1289,550,1043,56,32,155,1345,10,167,93,185,177,278,1266,2075,5,11498,638,0,2,6,0,0
30375,470,10280,72,33,56,0,4,12,72,1,1,1,1,2,2,0,2,0,1,0,0,2,21,0,1
30376,470,10280,1454,835,1044,76,110,219,1530,17,275,158,296,292,454,2297,3718,9,34017,1889,1,2,21,0,1
30377,470,10280,72,33,56,0,4,12,72,1,1,1,1,2,2,0,2,0,1,0,0,2,21,0,0
30378,470,10280,1454,835,1044,76,110,219,1530,17,275,158,296,292,454,2297,3718,9,34017,1889,1,2,21,0,0
30379,288,5751,1457,730,1242,11,6,188,1468,10,292,166,329,302,495,2424,4078,5,22973,1276,1,2,5,1,1
30380,288,5751,74,35,59,1,0,14,75,3,14,7,14,17,21,58,85,1,128,7,0,2,5,1,1
30381,288,5751,245,125,200,5,7,34,250,7,30,17,34,37,51,166,265,3,1053,58,0,2,5,1,1
30382,170,3947,77,34,69,0,0,8,77,3,24,16,29,27,45,114,213,1,387,21,0,2,2,0,1
30383,170,3947,712,438,573,51,9,84,763,14,102,71,128,116,199,733,1364,8,11988,666,0,2,2,0,1
30384,53,2991,1296,573,1062,40,33,157,1336,8,201,118,231,209,349,1561,2689,4,12365,686,0,2,29,0,1
30385,288,5813,1457,730,1242,11,6,188,1468,10,292,166,329,302,495,2424,4078,5,22973,1276,1,2,19,5,0
30386,288,5813,74,35,59,1,0,14,75,3,14,7,14,17,21,58,85,1,128,7,0,2,19,5,0
30387,288,5813,245,125,200,5,7,34,250,7,30,17,34,37,51,166,265,3,1053,58,0,2,19,5,0
30388,48,2366,1457,730,1242,11,6,188,1468,10,292,166,329,302,495,2424,4078,5,22973,1276,1,2,13,0,0
30389,288,5751,1457,730,1242,11,6,188,1468,10,292,166,329,302,495,2424,4078,5,22973,1276,1,2,5,1,0
30390,288,5751,74,35,59,1,0,14,75,3,14,7,14,17,21,58,85,1,128,7,0,2,5,1,0
30391,288,5751,245,125,200,5,7,34,250,7,30,17,34,37,51,166,265,3,1053,58,0,2,5,1,0
30392,170,3947,77,34,69,0,0,8,77,3,24,16,29,27,45,114,213,1,387,21,0,2,2,0,0
30393,170,3947,712,438,573,51,9,84,763,14,102,71,128,116,199,733,1364,8,11988,666,0,2,2,0,0
30394,53,2991,1296,573,1062,40,33,157,1336,8,201,118,231,209,349,1561,2689,4,12365,686,0,2,29,0,0
30395,290,5834,1457,730,1242,11,6,188,1468,10,292,166,329,302,495,2424,4078,5,22973,1276,1,2,19,5,0
30396,290,5834,74,35,59,1,0,14,75,3,14,7,14,17,21,58,85,1,128,7,0,2,19,5,0
30397,290,5834,245,125,200,5,7,34,250,7,30,17,34,37,51,166,265,3,1053,58,0,2,19,5,0
30399,142,4468,1660,832,1314,41,38,274,1701,20,312,209,395,332,604,2671,5058,12,64042,3557,1,2,6,0,1
30400,142,4468,1057,646,719,113,100,145,1170,18,215,134,248,233,382,1740,3004,10,31186,1732,1,2,6,0,1
30401,135,3512,1660,832,1314,41,38,274,1701,20,312,209,395,332,604,2671,5058,12,64042,3557,1,2,15,0,1
30402,468,10189,72,33,56,0,4,12,72,1,1,1,1,2,2,0,2,0,1,0,0,2,1,9,0
30403,468,10189,1454,835,1044,76,110,219,1530,17,275,158,296,292,454,2297,3718,9,34017,1889,1,2,1,9,0
30404,137,6066,139,89,101,2,0,35,141,7,54,34,62,61,96,330,569,4,2287,127,0,2,38,0,0
30405,137,6066,7,5,5,0,0,2,7,1,2,1,2,3,3,2,4,0,2,0,0,2,38,0,0
30406,142,4468,1660,832,1314,41,38,274,1701,20,312,209,395,332,604,2671,5058,12,64042,3557,1,2,6,0,0
30407,142,4468,1057,646,719,113,100,145,1170,18,215,134,248,233,382,1740,3004,10,31186,1732,1,2,6,0,0
30408,135,3512,1660,832,1314,41,38,274,1701,20,312,209,395,332,604,2671,5058,12,64042,3557,1,2,15,0,0
30409,32,1014,1455,414,1257,16,76,112,1471,5,41,23,46,46,69,231,381,2,1069,59,0,2,20,14,1
30410,32,1014,669,365,481,22,61,110,691,15,103,63,122,118,185,747,1273,8,11311,628,0,2,20,14,1
30411,30,1250,1455,414,1257,16,76,112,1471,5,41,23,46,46,69,231,381,2,1069,59,0,2,33,0,1
30416,32,1014,1455,414,1257,16,76,112,1471,5,41,23,46,46,69,231,381,2,1069,59,0,2,20,14,0
30417,32,1014,669,365,481,22,61,110,691,15,103,63,122,118,185,747,1273,8,11311,628,0,2,20,14,0
30418,30,1250,1455,414,1257,16,76,112,1471,5,41,23,46,46,69,231,381,2,1069,59,0,2,33,0,0
30419,147,4753,1660,832,1314,41,38,274,1701,20,312,209,395,332,604,2671,5058,12,64042,3557,1,2,57,5,1
30420,147,4753,1057,646,719,113,100,145,1170,18,215,134,248,233,382,1740,3004,10,31186,1732,1,2,57,5,1
30421,147,4710,1660,832,1314,41,38,274,1701,20,312,209,395,332,604,2671,5058,12,64042,3557,1,2,4,8,0
30422,147,4710,1057,646,719,113,100,145,1170,18,215,134,248,233,382,1740,3004,10,31186,1732,1,2,4,8,0
30423,170,3950,77,34,69,0,0,8,77,3,24,16,29,27,45,114,213,1,387,21,0,2,5,3,1
30424,170,3950,712,438,573,51,9,84,763,14,102,71,128,116,199,733,1364,8,11988,666,0,2,5,3,1
30425,147,4716,1660,832,1314,41,38,274,1701,20,312,209,395,332,604,2671,5058,12,64042,3557,1,2,6,4,0
30426,147,4716,1057,646,719,113,100,145,1170,18,215,134,248,233,382,1740,3004,10,31186,1732,1,2,6,4,0
30427,216,4838,722,423,573,19,0,135,741,12,172,101,199,184,300,1320,2257,6,15668,870,0,2,8,6,1
30428,216,4838,1508,847,911,44,250,301,1552,14,148,88,169,162,257,1120,1886,7,15077,837,0,2,8,6,1
30429,13,397,442,244,305,14,16,103,456,11,68,45,75,79,120,452,756,6,4588,254,0,2,31,4,1
30430,13,397,182,102,99,11,40,35,193,3,11,6,11,14,17,42,64,1,97,5,0,2,31,4,1
30431,136,6023,139,89,101,2,0,35,141,7,54,34,62,61,96,330,569,4,2287,127,0,2,2,1,1
30432,136,6023,7,5,5,0,0,2,7,1,2,1,2,3,3,2,4,0,2,0,0,2,2,1,1
30433,30,1907,652,304,544,16,6,88,668,6,89,51,101,95,152,591,998,3,3399,188,0,2,2,2,1
30434,7,514,442,244,305,14,16,103,456,11,68,45,75,79,120,452,756,6,4588,254,0,2,18,17,1
30435,7,524,442,244,305,14,16,103,456,11,68,45,75,79,120,452,756,6,4588,254,0,2,3,1,1
30436,147,4716,1660,832,1314,41,38,274,1701,20,312,209,395,332,604,2671,5058,12,64042,3557,1,2,2,2,1
30437,147,4716,1057,646,719,113,100,145,1170,18,215,134,248,233,382,1740,3004,10,31186,1732,1,2,2,2,1
30438,68,1230,1020,354,843,12,15,144,1032,8,134,77,144,142,221,970,1580,4,6792,377,0,2,11,8,1
30439,62,2551,1020,354,843,12,15,144,1032,8,134,77,144,142,221,970,1580,4,6792,377,0,2,55,0,1
30440,12,410,442,244,305,14,16,103,456,11,68,45,75,79,120,452,756,6,4588,254,0,2,8,1,0
30441,12,410,182,102,99,11,40,35,193,3,11,6,11,14,17,42,64,1,97,5,0,2,8,1,0
30442,216,4838,722,423,573,19,0,135,741,12,172,101,199,184,300,1320,2257,6,15668,870,0,2,8,6,0
30443,216,4838,1508,847,911,44,250,301,1552,14,148,88,169,162,257,1120,1886,7,15077,837,0,2,8,6,0
30444,13,397,442,244,305,14,16,103,456,11,68,45,75,79,120,452,756,6,4588,254,0,2,31,4,0
30445,13,397,182,102,99,11,40,35,193,3,11,6,11,14,17,42,64,1,97,5,0,2,31,4,0
30446,136,6023,139,89,101,2,0,35,141,7,54,34,62,61,96,330,569,4,2287,127,0,2,2,1,0
30447,136,6023,7,5,5,0,0,2,7,1,2,1,2,3,3,2,4,0,2,0,0,2,2,1,0
30448,30,1907,652,304,544,16,6,88,668,6,89,51,101,95,152,591,998,3,3399,188,0,2,2,2,0
30449,7,524,442,244,305,14,16,103,456,11,68,45,75,79,120,452,756,6,4588,254,0,2,20,17,0
30450,474,10327,72,33,56,0,4,12,72,1,1,1,1,2,2,0,2,0,1,0,0,2,25,5,1
30451,474,10327,1454,835,1044,76,110,219,1530,17,275,158,296,292,454,2297,3718,9,34017,1889,1,2,25,5,1
30452,65,2998,1338,495,1086,10,64,173,1348,11,122,82,157,133,239,883,1686,7,11934,663,0,2,44,0,1
30453,473,10292,72,33,56,0,4,12,72,1,1,1,1,2,2,0,2,0,1,0,0,2,4,6,1
30454,473,10292,1454,835,1044,76,110,219,1530,17,275,158,296,292,454,2297,3718,9,34017,1889,1,2,4,6,1
30455,147,4716,1660,832,1314,41,38,274,1701,20,312,209,395,332,604,2671,5058,12,64042,3557,1,2,55,5,0
30456,147,4716,1057,646,719,113,100,145,1170,18,215,134,248,233,382,1740,3004,10,31186,1732,1,2,55,5,0
30457,170,3950,77,34,69,0,0,8,77,3,24,16,29,27,45,114,213,1,387,21,0,2,5,3,0
30458,170,3950,712,438,573,51,9,84,763,14,102,71,128,116,199,733,1364,8,11988,666,0,2,5,3,0
30459,146,4728,1660,832,1314,41,38,274,1701,20,312,209,395,332,604,2671,5058,12,64042,3557,1,2,57,5,1
30460,146,4728,1057,646,719,113,100,145,1170,18,215,134,248,233,382,1740,3004,10,31186,1732,1,2,57,5,1
30461,146,4685,1660,832,1314,41,38,274,1701,20,312,209,395,332,604,2671,5058,12,64042,3557,1,2,4,8,0
30462,146,4685,1057,646,719,113,100,145,1170,18,215,134,248,233,382,1740,3004,10,31186,1732,1,2,4,8,0
30463,172,3928,77,34,69,0,0,8,77,3,24,16,29,27,45,114,213,1,387,21,0,2,5,3,0
30464,172,3928,712,438,573,51,9,84,763,14,102,71,128,116,199,733,1364,8,11988,666,0,2,5,3,0
30465,146,4691,1660,832,1314,41,38,274,1701,20,312,209,395,332,604,2671,5058,12,64042,3557,1,2,6,4,0
30466,146,4691,1057,646,719,113,100,145,1170,18,215,134,248,233,382,1740,3004,10,31186,1732,1,2,6,4,0
30467,146,4691,1660,832,1314,41,38,274,1701,20,312,209,395,332,604,2671,5058,12,64042,3557,1,2,2,2,0
30468,146,4691,1057,646,719,113,100,145,1170,18,215,134,248,233,382,1740,3004,10,31186,1732,1,2,2,2,0
30469,146,4691,1660,832,1314,41,38,274,1701,20,312,209,395,332,604,2671,5058,12,64042,3557,1,2,55,5,0
30470,146,4691,1057,646,719,113,100,145,1170,18,215,134,248,233,382,1740,3004,10,31186,1732,1,2,55,5,0
30473,250,5035,1457,730,1242,11,6,188,1468,10,292,166,329,302,495,2424,4078,5,22973,1276,1,2,13,0,1
30474,250,5035,74,35,59,1,0,14,75,3,14,7,14,17,21,58,85,1,128,7,0,2,13,0,1
30475,250,5035,245,125,200,5,7,34,250,7,30,17,34,37,51,166,265,3,1053,58,0,2,13,0,1
30476,24,755,74,35,59,1,0,14,75,3,14,7,14,17,21,58,85,1,128,7,0,2,2,1,1
30477,24,755,245,125,200,5,7,34,250,7,30,17,34,37,51,166,265,3,1053,58,0,2,2,1,1
30478,68,1235,1020,354,843,12,15,144,1032,8,134,77,144,142,221,970,1580,4,6792,377,0,2,2,1,1
30479,21,574,1293,570,1093,25,15,163,1318,10,195,123,241,205,364,1516,2795,6,17273,959,0,2,5,1,1
30480,473,10297,72,33,56,0,4,12,72,1,1,1,1,2,2,0,2,0,1,0,0,2,2,1,1
30481,473,10297,1454,835,1044,76,110,219,1530,17,275,158,296,292,454,2297,3718,9,34017,1889,1,2,2,1,1
30482,166,3485,1943,715,1694,26,18,214,1969,12,185,120,237,197,357,1436,2721,7,20915,1161,0,2,3,5,1
30483,166,3485,1168,838,957,57,25,144,1225,19,348,224,416,367,640,3018,5452,11,61921,3440,1,2,3,5,1
30484,138,6100,139,89,101,2,0,35,141,7,54,34,62,61,96,330,569,4,2287,127,0,2,5,0,1
30485,138,6100,7,5,5,0,0,2,7,1,2,1,2,3,3,2,4,0,2,0,0,2,5,0,1
30486,90,1642,1178,367,1042,6,15,115,1184,9,94,51,95,103,146,644,976,4,4439,246,0,2,26,14,1
30487,90,1642,177,108,140,8,0,27,185,6,30,16,32,36,48,162,248,3,794,44,0,2,26,14,1
30488,48,2142,1178,367,1042,6,15,115,1184,9,94,51,95,103,146,644,976,4,4439,246,0,2,20,0,1
30489,68,1233,1020,354,843,12,15,144,1032,8,134,77,144,142,221,970,1580,4,6792,377,0,2,0,1,0
30490,21,572,1293,570,1093,25,15,163,1318,10,195,123,241,205,364,1516,2795,6,17273,959,0,2,0,1,0
30491,90,1642,1178,367,1042,6,15,115,1184,9,94,51,95,103,146,644,976,4,4439,246,0,2,26,14,0
30492,90,1642,177,108,140,8,0,27,185,6,30,16,32,36,48,162,248,3,794,44,0,2,26,14,0
30493,48,2142,1178,367,1042,6,15,115,1184,9,94,51,95,103,146,644,976,4,4439,246,0,2,20,0,0
30495,474,10313,72,33,56,0,4,12,72,1,1,1,1,2,2,0,2,0,1,0,0,2,24,15,1
30496,474,10313,1454,835,1044,76,110,219,1530,17,275,158,296,292,454,2297,3718,9,34017,1889,1,2,24,15,1
30497,18,440,386,256,301,16,9,68,402,4,59,35,69,63,104,355,621,2,1453,80,0,2,2,2,1
30498,18,440,264,131,164,11,41,46,275,6,38,22,40,44,62,214,338,3,1068,59,0,2,2,2,1
30499,90,1648,1178,367,1042,6,15,115,1184,9,94,51,95,103,146,644,976,4,4439,246,0,2,26,14,1
30500,90,1648,177,108,140,8,0,27,185,6,30,16,32,36,48,162,248,3,794,44,0,2,26,14,1
30501,13,436,442,244,305,14,16,103,456,11,68,45,75,79,120,452,756,6,4588,254,0,2,8,1,1
30502,13,436,182,102,99,11,40,35,193,3,11,6,11,14,17,42,64,1,97,5,0,2,8,1,1
30503,66,3113,1338,495,1086,10,64,173,1348,11,122,82,157,133,239,883,1686,7,11934,663,0,2,44,0,1
30504,137,6064,139,89,101,2,0,35,141,7,54,34,62,61,96,330,569,4,2287,127,0,2,38,0,1
30505,137,6064,7,5,5,0,0,2,7,1,2,1,2,3,3,2,4,0,2,0,0,2,38,0,1
30507,12,442,386,256,301,16,9,68,402,4,59,35,69,63,104,355,621,2,1453,80,0,2,8,4,1
30509,474,10299,72,33,56,0,4,12,72,1,1,1,1,2,2,0,2,0,1,0,0,2,12,8,1
30510,474,10299,1454,835,1044,76,110,219,1530,17,275,158,296,292,454,2297,3718,9,34017,1889,1,2,12,8,1
30511,37,1461,1098,241,925,5,10,155,1103,7,46,25,49,53,74,273,423,3,1580,87,0,2,10,5,1
30512,16,482,184,100,137,2,15,30,186,6,38,20,39,44,59,214,322,3,991,55,0,2,2,1,0
30513,16,482,103,65,74,8,5,16,111,7,17,9,17,24,26,89,119,3,417,23,0,2,2,1,0
30514,16,480,184,100,137,2,15,30,186,6,38,20,39,44,59,214,322,3,991,55,0,2,1,1,0
30515,16,480,103,65,74,8,5,16,111,7,17,9,17,24,26,89,119,3,417,23,0,2,1,1,0
30516,474,10299,72,33,56,0,4,12,72,1,1,1,1,2,2,0,2,0,1,0,0,2,12,8,0
30517,474,10299,1454,835,1044,76,110,219,1530,17,275,158,296,292,454,2297,3718,9,34017,1889,1,2,12,8,0
30518,37,1461,1098,241,925,5,10,155,1103,7,46,25,49,53,74,273,423,3,1580,87,0,2,10,5,0
30519,250,5035,1457,730,1242,11,6,188,1468,10,292,166,329,302,495,2424,4078,5,22973,1276,1,2,13,0,0
30520,250,5035,74,35,59,1,0,14,75,3,14,7,14,17,21,58,85,1,128,7,0,2,13,0,0
30521,250,5035,245,125,200,5,7,34,250,7,30,17,34,37,51,166,265,3,1053,58,0,2,13,0,0
30522,24,755,74,35,59,1,0,14,75,3,14,7,14,17,21,58,85,1,128,7,0,2,2,1,0
30523,24,755,245,125,200,5,7,34,250,7,30,17,34,37,51,166,265,3,1053,58,0,2,2,1,0
30524,68,1233,1020,354,843,12,15,144,1032,8,134,77,144,142,221,970,1580,4,6792,377,0,2,2,2,0
30525,16,480,184,100,137,2,15,30,186,6,38,20,39,44,59,214,322,3,991,55,0,2,3,2,0
30526,16,480,103,65,74,8,5,16,111,7,17,9,17,24,26,89,119,3,417,23,0,2,3,2,0
30527,21,572,1293,570,1093,25,15,163,1318,10,195,123,241,205,364,1516,2795,6,17273,959,0,2,5,2,0
30528,474,10304,72,33,56,0,4,12,72,1,1,1,1,2,2,0,2,0,1,0,0,2,2,1,0
30529,474,10304,1454,835,1044,76,110,219,1530,17,275,158,296,292,454,2297,3718,9,34017,1889,1,2,2,1,0
30530,166,3485,1943,715,1694,26,18,214,1969,12,185,120,237,197,357,1436,2721,7,20915,1161,0,2,3,5,0
30531,166,3485,1168,838,957,57,25,144,1225,19,348,224,416,367,640,3018,5452,11,61921,3440,1,2,3,5,0
30532,138,6100,139,89,101,2,0,35,141,7,54,34,62,61,96,330,569,4,2287,127,0,2,5,0,0
30533,138,6100,7,5,5,0,0,2,7,1,2,1,2,3,3,2,4,0,2,0,0,2,5,0,0
30534,293,5891,1457,730,1242,11,6,188,1468,10,292,166,329,302,495,2424,4078,5,22973,1276,1,2,12,0,0
30535,293,5891,74,35,59,1,0,14,75,3,14,7,14,17,21,58,85,1,128,7,0,2,12,0,0
30536,293,5891,245,125,200,5,7,34,250,7,30,17,34,37,51,166,265,3,1053,58,0,2,12,0,0
30537,23,754,74,35,59,1,0,14,75,3,14,7,14,17,21,58,85,1,128,7,0,2,2,1,0
30538,23,754,245,125,200,5,7,34,250,7,30,17,34,37,51,166,265,3,1053,58,0,2,2,1,0
30540,16,483,184,100,137,2,15,30,186,6,38,20,39,44,59,214,322,3,991,55,0,2,3,2,0
30541,16,483,103,65,74,8,5,16,111,7,17,9,17,24,26,89,119,3,417,23,0,2,3,2,0
30543,475,10325,72,33,56,0,4,12,72,1,1,1,1,2,2,0,2,0,1,0,0,2,14,9,0
30544,475,10325,1454,835,1044,76,110,219,1530,17,275,158,296,292,454,2297,3718,9,34017,1889,1,2,14,9,0
30545,171,3530,1943,715,1694,26,18,214,1969,12,185,120,237,197,357,1436,2721,7,20915,1161,0,2,3,5,0
30546,171,3530,1168,838,957,57,25,144,1225,19,348,224,416,367,640,3018,5452,11,61921,3440,1,2,3,5,0
30547,138,6098,139,89,101,2,0,35,141,7,54,34,62,61,96,330,569,4,2287,127,0,2,5,0,0
30548,138,6098,7,5,5,0,0,2,7,1,2,1,2,3,3,2,4,0,2,0,0,2,5,0,0
30550,295,5925,1457,730,1242,11,6,188,1468,10,292,166,329,302,495,2424,4078,5,22973,1276,1,2,3,0,1
30551,295,5925,74,35,59,1,0,14,75,3,14,7,14,17,21,58,85,1,128,7,0,2,3,0,1
30552,295,5925,245,125,200,5,7,34,250,7,30,17,34,37,51,166,265,3,1053,58,0,2,3,0,1
30553,34,2100,652,304,544,16,6,88,668,6,89,51,101,95,152,591,998,3,3399,188,0,2,41,0,1
30554,251,5055,1457,730,1242,11,6,188,1468,10,292,166,329,302,495,2424,4078,5,22973,1276,1,2,4,1,1
30555,251,5055,74,35,59,1,0,14,75,3,14,7,14,17,21,58,85,1,128,7,0,2,4,1,1
30556,251,5055,245,125,200,5,7,34,250,7,30,17,34,37,51,166,265,3,1053,58,0,2,4,1,1
30557,67,2827,1289,550,1043,56,32,155,1345,10,167,93,185,177,278,1266,2075,5,11498,638,0,2,16,0,1
30558,113,2501,1043,504,840,53,9,147,1096,9,180,112,198,189,310,1377,2344,4,11604,644,0,2,3,5,1
30559,113,2501,383,288,292,26,6,62,409,11,65,38,67,76,105,429,656,5,3719,206,0,2,3,5,1
30560,55,2166,1043,504,840,53,9,147,1096,9,180,112,198,189,310,1377,2344,4,11604,644,0,2,13,0,1
30561,55,2176,1043,504,840,53,9,147,1096,9,180,112,198,189,310,1377,2344,4,11604,644,0,2,4,4,1
30562,113,2501,1043,504,840,53,9,147,1096,9,180,112,198,189,310,1377,2344,4,11604,644,0,2,3,5,0
30563,113,2501,383,288,292,26,6,62,409,11,65,38,67,76,105,429,656,5,3719,206,0,2,3,5,0
30564,55,2176,1043,504,840,53,9,147,1096,9,180,112,198,189,310,1377,2344,4,11604,644,0,2,15,2,0
30565,39,719,127,75,83,2,11,30,129,4,14,7,14,18,21,61,87,2,175,9,0,2,7,1,0
30566,39,719,652,304,544,16,6,88,668,6,89,51,101,95,152,591,998,3,3399,188,0,2,7,1,0
30567,39,719,2,2,2,0,0,0,2,0,0,0,0,0,0,0,0,0,0,0,0,2,7,1,0
30568,39,719,8,5,5,0,0,3,8,0,0,0,0,0,0,0,0,0,0,0,0,2,7,1,0
30571,39,719,14,8,8,0,0,6,14,0,0,0,0,0,0,0,0,0,0,0,0,2,7,1,0
30572,39,719,6,4,4,0,0,2,6,0,0,0,0,0,0,0,0,0,0,0,0,2,7,1,0
30573,39,719,6,4,4,0,0,2,6,1,2,1,2,3,3,2,4,0,2,0,0,2,7,1,0
30575,39,719,7,5,5,0,0,2,7,0,0,0,0,0,0,0,0,0,0,0,0,2,7,1,0
30577,39,719,10,6,6,0,0,4,10,0,0,0,0,0,0,0,0,0,0,0,0,2,7,1,0
30578,39,719,1,1,1,0,0,0,1,0,0,0,0,0,0,0,0,0,0,0,0,2,7,1,0
30580,39,719,14,10,10,0,0,4,14,1,1,1,1,2,2,0,2,0,1,0,0,2,7,1,0
30581,39,719,46,26,30,3,0,12,49,3,6,3,6,9,9,20,28,1,42,2,0,2,7,1,0
30582,111,4263,1513,682,1277,25,13,200,1538,11,199,116,219,210,335,1557,2584,6,15641,868,0,2,2,1,0
30583,251,5055,1457,730,1242,11,6,188,1468,10,292,166,329,302,495,2424,4078,5,22973,1276,1,2,4,1,0
30584,251,5055,74,35,59,1,0,14,75,3,14,7,14,17,21,58,85,1,128,7,0,2,4,1,0
30585,251,5055,245,125,200,5,7,34,250,7,30,17,34,37,51,166,265,3,1053,58,0,2,4,1,0
30586,67,2827,1289,550,1043,56,32,155,1345,10,167,93,185,177,278,1266,2075,5,11498,638,0,2,16,0,0
30587,294,5911,1457,730,1242,11,6,188,1468,10,292,166,329,302,495,2424,4078,5,22973,1276,1,2,4,1,0
30588,294,5911,74,35,59,1,0,14,75,3,14,7,14,17,21,58,85,1,128,7,0,2,4,1,0
30589,294,5911,245,125,200,5,7,34,250,7,30,17,34,37,51,166,265,3,1053,58,0,2,4,1,0
30592,68,2865,1289,550,1043,56,32,155,1345,10,167,93,185,177,278,1266,2075,5,11498,638,0,2,16,0,0
30593,111,4260,1513,682,1277,25,13,200,1538,11,199,116,219,210,335,1557,2584,6,15641,868,0,2,2,1,0
30595,216,4842,722,423,573,19,0,135,741,12,172,101,199,184,300,1320,2257,6,15668,870,0,2,4,1,0
30596,216,4842,1508,847,911,44,250,301,1552,14,148,88,169,162,257,1120,1886,7,15077,837,0,2,4,1,0
30597,111,4260,1513,682,1277,25,13,200,1538,11,199,116,219,210,335,1557,2584,6,15641,868,0,2,1,1,0
30621,20,625,42,7,35,4,0,5,46,1,2,1,2,3,3,2,4,0,2,0,0,2,2,1,0
30622,20,625,11,6,10,0,0,1,11,2,4,2,4,6,6,10,15,1,15,0,0,2,2,1,0
30623,296,5945,1457,730,1242,11,6,188,1468,10,292,166,329,302,495,2424,4078,5,22973,1276,1,2,3,0,0
30624,296,5945,74,35,59,1,0,14,75,3,14,7,14,17,21,58,85,1,128,7,0,2,3,0,0
30625,296,5945,245,125,200,5,7,34,250,7,30,17,34,37,51,166,265,3,1053,58,0,2,3,0,0
30626,34,2100,652,304,544,16,6,88,668,6,89,51,101,95,152,591,998,3,3399,188,0,2,41,0,0
30627,67,3186,1338,495,1086,10,64,173,1348,11,122,82,157,133,239,883,1686,7,11934,663,0,2,18,0,0
30628,68,1237,1020,354,843,12,15,144,1032,8,134,77,144,142,221,970,1580,4,6792,377,0,2,1,1,1
30629,68,1237,1020,354,843,12,15,144,1032,8,134,77,144,142,221,970,1580,4,6792,377,0,2,1,1,0
30633,112,2270,1513,682,1277,25,13,200,1538,11,199,116,219,210,335,1557,2584,6,15641,868,0,2,4,2,1
30634,112,2270,819,519,539,24,98,155,843,15,96,57,106,111,163,690,1107,8,9171,509,0,2,4,2,1
30635,112,4302,1513,682,1277,25,13,200,1538,11,199,116,219,210,335,1557,2584,6,15641,868,0,2,18,0,1
30636,112,4302,1513,682,1277,25,13,200,1538,11,199,116,219,210,335,1557,2584,6,15641,868,0,2,1,0,0
30637,112,2270,1513,682,1277,25,13,200,1538,11,199,116,219,210,335,1557,2584,6,15641,868,0,2,4,2,0
30638,112,2270,819,519,539,24,98,155,843,15,96,57,106,111,163,690,1107,8,9171,509,0,2,4,2,0
30639,112,4306,1513,682,1277,25,13,200,1538,11,199,116,219,210,335,1557,2584,6,15641,868,0,2,19,0,0
30643,480,10385,72,33,56,0,4,12,72,1,1,1,1,2,2,0,2,0,1,0,0,2,17,2,1
30644,480,10385,1454,835,1044,76,110,219,1530,17,275,158,296,292,454,2297,3718,9,34017,1889,1,2,17,2,1
30645,63,2600,1020,354,843,12,15,144,1032,8,134,77,144,142,221,970,1580,4,6792,377,0,2,18,0,1
30646,68,3245,1338,495,1086,10,64,173,1348,11,122,82,157,133,239,883,1686,7,11934,663,0,2,14,0,1
30647,68,3245,1338,495,1086,10,64,173,1348,11,122,82,157,133,239,883,1686,7,11934,663,0,2,14,0,0
30648,13,436,442,244,305,14,16,103,456,11,68,45,75,79,120,452,756,6,4588,254,0,2,1,1,1
30649,13,436,182,102,99,11,40,35,193,3,11,6,11,14,17,42,64,1,97,5,0,2,1,1,1
30650,8,551,442,244,305,14,16,103,456,11,68,45,75,79,120,452,756,6,4588,254,0,2,14,0,1
30651,13,436,442,244,305,14,16,103,456,11,68,45,75,79,120,452,756,6,4588,254,0,2,1,1,0
30652,13,436,182,102,99,11,40,35,193,3,11,6,11,14,17,42,64,1,97,5,0,2,1,1,0
30653,8,551,442,244,305,14,16,103,456,11,68,45,75,79,120,452,756,6,4588,254,0,2,14,0,0
30654,480,10385,72,33,56,0,4,12,72,1,1,1,1,2,2,0,2,0,1,0,0,2,14,15,1
30655,480,10385,1454,835,1044,76,110,219,1530,17,275,158,296,292,454,2297,3718,9,34017,1889,1,2,14,15,1
30656,36,810,386,256,301,16,9,68,402,4,59,35,69,63,104,355,621,2,1453,80,0,2,147,57,1
30657,36,810,264,131,164,11,41,46,275,6,38,22,40,44,62,214,338,3,1068,59,0,2,147,57,1
30658,11,230,256,139,192,9,7,47,265,4,23,12,24,27,36,112,171,2,357,19,0,2,0,1,1
30659,20,938,386,256,301,16,9,68,402,4,59,35,69,63,104,355,621,2,1453,80,0,2,136,52,1
30660,478,10389,72,33,56,0,4,12,72,1,1,1,1,2,2,0,2,0,1,0,0,2,17,5,1
30661,478,10389,1454,835,1044,76,110,219,1530,17,275,158,296,292,454,2297,3718,9,34017,1889,1,2,17,5,1
30662,70,3830,1782,648,1425,9,47,279,1791,8,171,97,189,179,286,1292,2140,4,9462,525,0,2,40,0,1
30663,476,10387,72,33,56,0,4,12,72,1,1,1,1,2,2,0,2,0,1,0,0,2,2,2,0
30664,476,10387,1454,835,1044,76,110,219,1530,17,275,158,296,292,454,2297,3718,9,34017,1889,1,2,2,2,0
30665,70,3830,1782,648,1425,9,47,279,1791,8,171,97,189,179,286,1292,2140,4,9462,525,0,2,6,5,0
30666,71,3863,1782,648,1425,9,47,279,1791,8,171,97,189,179,286,1292,2140,4,9462,525,0,2,19,0,0
30667,72,3886,1782,648,1425,9,47,279,1791,8,171,97,189,179,286,1292,2140,4,9462,525,0,2,5,18,1
30668,477,10406,72,33,56,0,4,12,72,1,1,1,1,2,2,0,2,0,1,0,0,2,12,11,0
30669,477,10406,1454,835,1044,76,110,219,1530,17,275,158,296,292,454,2297,3718,9,34017,1889,1,2,12,11,0
30670,72,3922,1782,648,1425,9,47,279,1791,8,171,97,189,179,286,1292,2140,4,9462,525,0,2,15,2,0
30671,477,10406,72,33,56,0,4,12,72,1,1,1,1,2,2,0,2,0,1,0,0,2,1,1,1
30672,477,10406,1454,835,1044,76,110,219,1530,17,275,158,296,292,454,2297,3718,9,34017,1889,1,2,1,1,1
30673,480,10385,72,33,56,0,4,12,72,1,1,1,1,2,2,0,2,0,1,0,0,2,14,15,0
30674,480,10385,1454,835,1044,76,110,219,1530,17,275,158,296,292,454,2297,3718,9,34017,1889,1,2,14,15,0
30675,36,810,386,256,301,16,9,68,402,4,59,35,69,63,104,355,621,2,1453,80,0,2,147,57,0
30676,36,810,264,131,164,11,41,46,275,6,38,22,40,44,62,214,338,3,1068,59,0,2,147,57,0
30677,11,230,256,139,192,9,7,47,265,4,23,12,24,27,36,112,171,2,357,19,0,2,0,1,0
30678,20,938,386,256,301,16,9,68,402,4,59,35,69,63,104,355,621,2,1453,80,0,2,136,52,0
30679,1,315,382,65,130,157,2,92,539,4,10,5,10,14,15,41,57,2,114,6,0,2,5,5,0
30680,20,942,386,256,301,16,9,68,402,4,59,35,69,63,104,355,621,2,1453,80,0,2,2,1,0
30682,36,822,386,256,301,16,9,68,402,4,59,35,69,63,104,355,621,2,1453,80,0,2,6,2,1
30683,36,822,264,131,164,11,41,46,275,6,38,22,40,44,62,214,338,3,1068,59,0,2,6,2,1
30684,21,982,386,256,301,16,9,68,402,4,59,35,69,63,104,355,621,2,1453,80,0,2,6,0,1
30685,21,974,386,256,301,16,9,68,402,4,59,35,69,63,104,355,621,2,1453,80,0,2,13,4,1
30687,486,10456,72,33,56,0,4,12,72,1,1,1,1,2,2,0,2,0,1,0,0,2,15,0,1
30688,486,10456,1454,835,1044,76,110,219,1530,17,275,158,296,292,454,2297,3718,9,34017,1889,1,2,15,0,1
30689,67,3655,1782,648,1425,9,47,279,1791,8,171,97,189,179,286,1292,2140,4,9462,525,0,2,15,3,1
30690,481,10401,72,33,56,0,4,12,72,1,1,1,1,2,2,0,2,0,1,0,0,2,7,4,1
30691,481,10401,1454,835,1044,76,110,219,1530,17,275,158,296,292,454,2297,3718,9,34017,1889,1,2,7,4,1
30692,66,3598,1782,648,1425,9,47,279,1791,8,171,97,189,179,286,1292,2140,4,9462,525,0,2,6,4,1
30693,481,10401,72,33,56,0,4,12,72,1,1,1,1,2,2,0,2,0,1,0,0,2,7,4,0
30694,481,10401,1454,835,1044,76,110,219,1530,17,275,158,296,292,454,2297,3718,9,34017,1889,1,2,7,4,0
30695,66,3598,1782,648,1425,9,47,279,1791,8,171,97,189,179,286,1292,2140,4,9462,525,0,2,6,4,0
30696,486,10459,72,33,56,0,4,12,72,1,1,1,1,2,2,0,2,0,1,0,0,2,4,3,0
30697,486,10459,1454,835,1044,76,110,219,1530,17,275,158,296,292,454,2297,3718,9,34017,1889,1,2,4,3,0
30698,486,10457,72,33,56,0,4,12,72,1,1,1,1,2,2,0,2,0,1,0,0,2,4,4,1
30699,486,10457,1454,835,1044,76,110,219,1530,17,275,158,296,292,454,2297,3718,9,34017,1889,1,2,4,4,1
30700,485,10457,72,33,56,0,4,12,72,1,1,1,1,2,2,0,2,0,1,0,0,2,6,6,1
30701,485,10457,1454,835,1044,76,110,219,1530,17,275,158,296,292,454,2297,3718,9,34017,1889,1,2,6,6,1
30702,483,10482,72,33,56,0,4,12,72,1,1,1,1,2,2,0,2,0,1,0,0,2,20,7,0
30703,483,10482,1454,835,1044,76,110,219,1530,17,275,158,296,292,454,2297,3718,9,34017,1889,1,2,20,7,0
30704,72,3951,1782,648,1425,9,47,279,1791,8,171,97,189,179,286,1292,2140,4,9462,525,0,2,60,0,0
30705,75,4081,1782,648,1425,9,47,279,1791,8,171,97,189,179,286,1292,2140,4,9462,525,0,2,61,1,0
30706,486,10473,72,33,56,0,4,12,72,1,1,1,1,2,2,0,2,0,1,0,0,2,16,0,0
30707,486,10473,1454,835,1044,76,110,219,1530,17,275,158,296,292,454,2297,3718,9,34017,1889,1,2,16,0,0
30708,67,3684,1782,648,1425,9,47,279,1791,8,171,97,189,179,286,1292,2140,4,9462,525,0,2,15,3,0
30709,21,656,424,94,331,4,0,89,428,1,5,5,5,6,10,11,25,0,12,0,0,2,46,0,1
30710,493,10575,72,33,56,0,4,12,72,1,1,1,1,2,2,0,2,0,1,0,0,2,31,6,1
30711,493,10575,1454,835,1044,76,110,219,1530,17,275,158,296,292,454,2297,3718,9,34017,1889,1,2,31,6,1
30712,493,10571,72,33,56,0,4,12,72,1,1,1,1,2,2,0,2,0,1,0,0,2,2,2,1
30713,493,10571,1454,835,1044,76,110,219,1530,17,275,158,296,292,454,2297,3718,9,34017,1889,1,2,2,2,1
30714,493,10571,72,33,56,0,4,12,72,1,1,1,1,2,2,0,2,0,1,0,0,2,33,8,0
30715,493,10571,1454,835,1044,76,110,219,1530,17,275,158,296,292,454,2297,3718,9,34017,1889,1,2,33,8,0
30716,21,656,424,94,331,4,0,89,428,1,5,5,5,6,10,11,25,0,12,0,0,2,46,0,0
30717,297,5964,1457,730,1242,11,6,188,1468,10,292,166,329,302,495,2424,4078,5,22973,1276,1,2,4,0,0
30718,297,5964,74,35,59,1,0,14,75,3,14,7,14,17,21,58,85,1,128,7,0,2,4,0,0
30719,297,5964,245,125,200,5,7,34,250,7,30,17,34,37,51,166,265,3,1053,58,0,2,4,0,0
30720,69,2885,1289,550,1043,56,32,155,1345,10,167,93,185,177,278,1266,2075,5,11498,638,0,2,5,0,0
30725,492,10563,72,33,56,0,4,12,72,1,1,1,1,2,2,0,2,0,1,0,0,2,1,1,1
30726,492,10563,1454,835,1044,76,110,219,1530,17,275,158,296,292,454,2297,3718,9,34017,1889,1,2,1,1,1
30727,68,3245,1338,495,1086,10,64,173,1348,11,122,82,157,133,239,883,1686,7,11934,663,0,2,11,1,1
30728,139,6127,139,89,101,2,0,35,141,7,54,34,62,61,96,330,569,4,2287,127,0,2,16,0,1
30729,139,6127,7,5,5,0,0,2,7,1,2,1,2,3,3,2,4,0,2,0,0,2,16,0,1
30730,492,10563,72,33,56,0,4,12,72,1,1,1,1,2,2,0,2,0,1,0,0,2,1,1,0
30731,492,10563,1454,835,1044,76,110,219,1530,17,275,158,296,292,454,2297,3718,9,34017,1889,1,2,1,1,0
30732,68,3245,1338,495,1086,10,64,173,1348,11,122,82,157,133,239,883,1686,7,11934,663,0,2,11,1,0
30733,139,6127,139,89,101,2,0,35,141,7,54,34,62,61,96,330,569,4,2287,127,0,2,16,0,0
30734,139,6127,7,5,5,0,0,2,7,1,2,1,2,3,3,2,4,0,2,0,0,2,16,0,0
30735,40,1253,1455,414,1257,16,76,112,1471,5,41,23,46,46,69,231,381,2,1069,59,0,2,76,8,1
30736,40,1253,669,365,481,22,61,110,691,15,103,63,122,118,185,747,1273,8,11311,628,0,2,76,8,1
30737,33,1397,1455,414,1257,16,76,112,1471,5,41,23,46,46,69,231,381,2,1069,59,0,2,44,0,1
30738,40,1249,1455,414,1257,16,76,112,1471,5,41,23,46,46,69,231,381,2,1069,59,0,2,13,8,0
30739,40,1249,669,365,481,22,61,110,691,15,103,63,122,118,185,747,1273,8,11311,628,0,2,13,8,0
30740,33,1398,1455,414,1257,16,76,112,1471,5,41,23,46,46,69,231,381,2,1069,59,0,2,6,5,0
30766,40,1249,1455,414,1257,16,76,112,1471,5,41,23,46,46,69,231,381,2,1069,59,0,2,81,8,0
30767,40,1249,669,365,481,22,61,110,691,15,103,63,122,118,185,747,1273,8,11311,628,0,2,81,8,0
30768,33,1398,1455,414,1257,16,76,112,1471,5,41,23,46,46,69,231,381,2,1069,59,0,2,45,0,0
30769,172,3537,1943,715,1694,26,18,214,1969,12,185,120,237,197,357,1436,2721,7,20915,1161,0,2,7,2,0
30770,172,3537,1168,838,957,57,25,144,1225,19,348,224,416,367,640,3018,5452,11,61921,3440,1,2,7,2,0
30771,172,3541,1943,715,1694,26,18,214,1969,12,185,120,237,197,357,1436,2721,7,20915,1161,0,2,1,1,0
30772,172,3541,1168,838,957,57,25,144,1225,19,348,224,416,367,640,3018,5452,11,61921,3440,1,2,1,1,0
30773,173,3552,1943,715,1694,26,18,214,1969,12,185,120,237,197,357,1436,2721,7,20915,1161,0,2,18,12,1
30774,173,3552,1168,838,957,57,25,144,1225,19,348,224,416,367,640,3018,5452,11,61921,3440,1,2,18,12,1
30775,65,3354,1943,715,1694,26,18,214,1969,12,185,120,237,197,357,1436,2721,7,20915,1161,0,2,20,2,1
30776,171,3978,77,34,69,0,0,8,77,3,24,16,29,27,45,114,213,1,387,21,0,2,5,0,1
30777,171,3978,712,438,573,51,9,84,763,14,102,71,128,116,199,733,1364,8,11988,666,0,2,5,0,1
30778,171,3550,1943,715,1694,26,18,214,1969,12,185,120,237,197,357,1436,2721,7,20915,1161,0,2,7,2,1
30779,171,3550,1168,838,957,57,25,144,1225,19,348,224,416,367,640,3018,5452,11,61921,3440,1,2,7,2,1
30780,69,2894,1289,550,1043,56,32,155,1345,10,167,93,185,177,278,1266,2075,5,11498,638,0,2,9,7,1
30781,68,3251,1338,495,1086,10,64,173,1348,11,122,82,157,133,239,883,1686,7,11934,663,0,2,3,1,1
30782,135,3518,1660,832,1314,41,38,274,1701,20,312,209,395,332,604,2671,5058,12,64042,3557,1,2,3,2,1
30783,112,4312,1513,682,1277,25,13,200,1538,11,199,116,219,210,335,1557,2584,6,15641,868,0,2,2,1,1
30784,53,2988,1296,573,1062,40,33,157,1336,8,201,118,231,209,349,1561,2689,4,12365,686,0,2,5,5,1
30785,48,2372,1457,730,1242,11,6,188,1468,10,292,166,329,302,495,2424,4078,5,22973,1276,1,2,2,1,1
30786,34,2121,652,304,544,16,6,88,668,6,89,51,101,95,152,591,998,3,3399,188,0,2,5,1,1
30787,8,265,74,35,59,1,0,14,75,3,14,7,14,17,21,58,85,1,128,7,0,2,4,3,1
30788,41,2667,1523,757,1297,19,12,193,1542,12,193,117,230,205,347,1508,2664,7,19053,1058,0,2,2,1,1
30789,31,1715,384,251,317,7,8,52,391,11,70,44,84,81,128,467,811,6,5355,297,0,2,2,1,1
30790,56,2276,1043,504,840,53,9,147,1096,9,180,112,198,189,310,1377,2344,4,11604,644,0,2,21,0,1
30791,24,967,373,158,315,8,0,51,381,5,76,44,79,81,123,486,779,2,2026,112,0,2,3,1,1
30792,63,3221,1943,715,1694,26,18,214,1969,12,185,120,237,197,357,1436,2721,7,20915,1161,0,2,2,1,1
30793,37,1467,1098,241,925,5,10,155,1103,7,46,25,49,53,74,273,423,3,1580,87,0,2,3,2,1
30794,171,3978,77,34,69,0,0,8,77,3,24,16,29,27,45,114,213,1,387,21,0,2,8,8,0
30795,171,3978,712,438,573,51,9,84,763,14,102,71,128,116,199,733,1364,8,11988,666,0,2,8,8,0
30796,53,1539,1523,757,1297,19,12,193,1542,12,193,117,230,205,347,1508,2664,7,19053,1058,0,2,21,0,1
30797,53,1539,701,378,504,33,58,109,734,13,110,68,126,123,194,794,1346,7,10027,557,0,2,21,0,1
30798,42,2710,1523,757,1297,19,12,193,1542,12,193,117,230,205,347,1508,2664,7,19053,1058,0,2,10,1,1
30799,56,2276,1043,504,840,53,9,147,1096,9,180,112,198,189,310,1377,2344,4,11604,644,0,2,2,2,0
30800,173,3552,1943,715,1694,26,18,214,1969,12,185,120,237,197,357,1436,2721,7,20915,1161,0,2,18,7,0
30801,173,3552,1168,838,957,57,25,144,1225,19,348,224,416,367,640,3018,5452,11,61921,3440,1,2,18,7,0
30802,65,3354,1943,715,1694,26,18,214,1969,12,185,120,237,197,357,1436,2721,7,20915,1161,0,2,20,2,0
30803,171,3978,77,34,69,0,0,8,77,3,24,16,29,27,45,114,213,1,387,21,0,2,10,5,0
30804,171,3978,712,438,573,51,9,84,763,14,102,71,128,116,199,733,1364,8,11988,666,0,2,10,5,0
30805,173,3572,1943,715,1694,26,18,214,1969,12,185,120,237,197,357,1436,2721,7,20915,1161,0,2,7,2,0
30806,173,3572,1168,838,957,57,25,144,1225,19,348,224,416,367,640,3018,5452,11,61921,3440,1,2,7,2,0
30807,69,2894,1289,550,1043,56,32,155,1345,10,167,93,185,177,278,1266,2075,5,11498,638,0,2,9,7,0
30808,68,3251,1338,495,1086,10,64,173,1348,11,122,82,157,133,239,883,1686,7,11934,663,0,2,3,1,0
30809,135,3518,1660,832,1314,41,38,274,1701,20,312,209,395,332,604,2671,5058,12,64042,3557,1,2,3,2,0
30810,112,4312,1513,682,1277,25,13,200,1538,11,199,116,219,210,335,1557,2584,6,15641,868,0,2,2,1,0
30811,53,2988,1296,573,1062,40,33,157,1336,8,201,118,231,209,349,1561,2689,4,12365,686,0,2,5,5,0
30812,48,2372,1457,730,1242,11,6,188,1468,10,292,166,329,302,495,2424,4078,5,22973,1276,1,2,2,1,0
30813,34,2121,652,304,544,16,6,88,668,6,89,51,101,95,152,591,998,3,3399,188,0,2,5,1,0
30814,8,265,74,35,59,1,0,14,75,3,14,7,14,17,21,58,85,1,128,7,0,2,4,3,0
30815,41,2667,1523,757,1297,19,12,193,1542,12,193,117,230,205,347,1508,2664,7,19053,1058,0,2,2,1,0
30816,31,1715,384,251,317,7,8,52,391,11,70,44,84,81,128,467,811,6,5355,297,0,2,2,1,0
30817,56,2276,1043,504,840,53,9,147,1096,9,180,112,198,189,310,1377,2344,4,11604,644,0,2,23,2,0
30818,24,967,373,158,315,8,0,51,381,5,76,44,79,81,123,486,779,2,2026,112,0,2,3,1,0
30819,65,3360,1943,715,1694,26,18,214,1969,12,185,120,237,197,357,1436,2721,7,20915,1161,0,2,2,1,0
30820,37,1467,1098,241,925,5,10,155,1103,7,46,25,49,53,74,273,423,3,1580,87,0,2,3,2,0
30821,52,1519,1523,757,1297,19,12,193,1542,12,193,117,230,205,347,1508,2664,7,19053,1058,0,2,8,12,1
30822,52,1519,701,378,504,33,58,109,734,13,110,68,126,123,194,794,1346,7,10027,557,0,2,8,12,1
30823,42,2710,1523,757,1297,19,12,193,1542,12,193,117,230,205,347,1508,2664,7,19053,1058,0,2,2,3,1
30824,477,10406,72,33,56,0,4,12,72,1,1,1,1,2,2,0,2,0,1,0,0,2,4,5,1
30825,477,10406,1454,835,1044,76,110,219,1530,17,275,158,296,292,454,2297,3718,9,34017,1889,1,2,4,5,1
30826,72,3900,1782,648,1425,9,47,279,1791,8,171,97,189,179,286,1292,2140,4,9462,525,0,2,2,3,1
30827,52,1550,1523,757,1297,19,12,193,1542,12,193,117,230,205,347,1508,2664,7,19053,1058,0,2,12,6,1
30828,52,1550,701,378,504,33,58,109,734,13,110,68,126,123,194,794,1346,7,10027,557,0,2,12,6,1
30829,42,2720,1523,757,1297,19,12,193,1542,12,193,117,230,205,347,1508,2664,7,19053,1058,0,2,2,1,1
30830,52,1550,1523,757,1297,19,12,193,1542,12,193,117,230,205,347,1508,2664,7,19053,1058,0,2,24,1,0
30831,52,1550,701,378,504,33,58,109,734,13,110,68,126,123,194,794,1346,7,10027,557,0,2,24,1,0
30832,42,2727,1523,757,1297,19,12,193,1542,12,193,117,230,205,347,1508,2664,7,19053,1058,0,2,10,1,0
30858,297,5964,1457,730,1242,11,6,188,1468,10,292,166,329,302,495,2424,4078,5,22973,1276,1,2,7,0,0
30859,297,5964,74,35,59,1,0,14,75,3,14,7,14,17,21,58,85,1,128,7,0,2,7,0,0
30860,297,5964,245,125,200,5,7,34,250,7,30,17,34,37,51,166,265,3,1053,58,0,2,7,0,0
30868,494,10644,72,33,56,0,4,12,72,1,1,1,1,2,2,0,2,0,1,0,0,2,86,28,0
30869,494,10644,1454,835,1044,76,110,219,1530,17,275,158,296,292,454,2297,3718,9,34017,1889,1,2,86,28,0
30870,36,822,386,256,301,16,9,68,402,4,59,35,69,63,104,355,621,2,1453,80,0,2,151,57,0
30871,36,822,264,131,164,11,41,46,275,6,38,22,40,44,62,214,338,3,1068,59,0,2,151,57,0
30872,173,3572,1943,715,1694,26,18,214,1969,12,185,120,237,197,357,1436,2721,7,20915,1161,0,2,25,9,0
30873,173,3572,1168,838,957,57,25,144,1225,19,348,224,416,367,640,3018,5452,11,61921,3440,1,2,25,9,0
30879,69,2894,1289,550,1043,56,32,155,1345,10,167,93,185,177,278,1266,2075,5,11498,638,0,2,14,7,0
30880,68,3251,1338,495,1086,10,64,173,1348,11,122,82,157,133,239,883,1686,7,11934,663,0,2,46,2,0
30883,73,4015,1782,648,1425,9,47,279,1791,8,171,97,189,179,286,1292,2140,4,9462,525,0,2,21,7,0
30886,112,4312,1513,682,1277,25,13,200,1538,11,199,116,219,210,335,1557,2584,6,15641,868,0,2,21,1,0
30889,34,2121,652,304,544,16,6,88,668,6,89,51,101,95,152,591,998,3,3399,188,0,2,46,1,0
30892,42,2727,1523,757,1297,19,12,193,1542,12,193,117,230,205,347,1508,2664,7,19053,1058,0,2,12,2,0
30893,63,2600,1020,354,843,12,15,144,1032,8,134,77,144,142,221,970,1580,4,6792,377,0,2,18,0,0
30896,21,974,386,256,301,16,9,68,402,4,59,35,69,63,104,355,621,2,1453,80,0,2,150,50,0
30899,65,3360,1943,715,1694,26,18,214,1969,12,185,120,237,197,357,1436,2721,7,20915,1161,0,2,22,3,0
30902,297,5968,1457,730,1242,11,6,188,1468,10,292,166,329,302,495,2424,4078,5,22973,1276,1,2,6,4,1
30903,297,5968,74,35,59,1,0,14,75,3,14,7,14,17,21,58,85,1,128,7,0,2,6,4,1
30904,297,5968,245,125,200,5,7,34,250,7,30,17,34,37,51,166,265,3,1053,58,0,2,6,4,1
30905,52,2502,1457,730,1242,11,6,188,1468,10,292,166,329,302,495,2424,4078,5,22973,1276,1,2,25,0,1
30906,37,2209,334,251,279,10,4,40,344,5,127,74,143,132,217,899,1528,2,4303,239,0,2,3,1,1
30907,297,5968,1457,730,1242,11,6,188,1468,10,292,166,329,302,495,2424,4078,5,22973,1276,1,2,6,4,0
30908,297,5968,74,35,59,1,0,14,75,3,14,7,14,17,21,58,85,1,128,7,0,2,6,4,0
30909,297,5968,245,125,200,5,7,34,250,7,30,17,34,37,51,166,265,3,1053,58,0,2,6,4,0
30910,52,2502,1457,730,1242,11,6,188,1468,10,292,166,329,302,495,2424,4078,5,22973,1276,1,2,25,0,0
30911,37,2209,334,251,279,10,4,40,344,5,127,74,143,132,217,899,1528,2,4303,239,0,2,3,1,0
30912,46,522,647,139,84,35,284,233,682,0,0,0,0,0,0,0,0,0,0,0,0,2,9,2,1
30913,298,5985,1457,730,1242,11,6,188,1468,10,292,166,329,302,495,2424,4078,5,22973,1276,1,2,12,5,1
30914,298,5985,74,35,59,1,0,14,75,3,14,7,14,17,21,58,85,1,128,7,0,2,12,5,1
30915,298,5985,245,125,200,5,7,34,250,7,30,17,34,37,51,166,265,3,1053,58,0,2,12,5,1
30916,38,2255,334,251,279,10,4,40,344,5,127,74,143,132,217,899,1528,2,4303,239,0,2,9,2,1
30917,216,4842,722,423,573,19,0,135,741,12,172,101,199,184,300,1320,2257,6,15668,870,0,2,1,1,1
30918,216,4842,1508,847,911,44,250,301,1552,14,148,88,169,162,257,1120,1886,7,15077,837,0,2,1,1,1
30919,173,3589,1943,715,1694,26,18,214,1969,12,185,120,237,197,357,1436,2721,7,20915,1161,0,2,4,2,1
30920,173,3589,1168,838,957,57,25,144,1225,19,348,224,416,367,640,3018,5452,11,61921,3440,1,2,4,2,1
30921,52,2502,1457,730,1242,11,6,188,1468,10,292,166,329,302,495,2424,4078,5,22973,1276,1,2,2,2,1
30922,65,3360,1943,715,1694,26,18,214,1969,12,185,120,237,197,357,1436,2721,7,20915,1161,0,2,3,2,1
30955,494,10644,72,33,56,0,4,12,72,1,1,1,1,2,2,0,2,0,1,0,0,2,54,14,0
30956,494,10644,1454,835,1044,76,110,219,1530,17,275,158,296,292,454,2297,3718,9,34017,1889,1,2,54,14,0
30962,68,3251,1338,495,1086,10,64,173,1348,11,122,82,157,133,239,883,1686,7,11934,663,0,2,14,2,0
30965,76,4145,1782,648,1425,9,47,279,1791,8,171,97,189,179,286,1292,2140,4,9462,525,0,2,17,6,0
30982,33,678,2,2,2,0,0,0,2,0,0,0,0,0,0,0,0,0,0,0,0,2,5,2,1
30996,33,678,99,48,90,1,3,5,100,0,0,0,0,0,0,0,0,0,0,0,0,2,5,2,1
30997,33,678,8,5,5,2,0,1,10,0,0,0,0,0,0,0,0,0,0,0,0,2,5,2,1
30998,33,678,1217,716,841,84,126,174,1301,14,185,118,215,199,333,1446,2542,8,20687,1149,0,2,5,2,1
30999,33,678,160,89,115,0,13,31,160,7,15,11,17,22,28,78,124,3,495,27,0,2,5,2,1
31000,33,678,10,10,9,9,0,0,19,0,0,0,0,0,0,0,0,0,0,0,0,2,5,2,1
31001,33,678,173,84,99,8,29,36,181,5,12,7,13,17,20,54,81,2,221,12,0,2,5,2,1
31002,33,678,3,1,1,3,0,0,6,0,0,0,0,0,0,0,0,0,0,0,0,2,5,2,1
31003,72,2658,1450,624,1228,12,26,181,1462,14,306,186,354,320,540,2580,4493,8,36391,2021,1,2,6,1,1
31006,33,678,2,2,2,0,0,0,2,0,0,0,0,0,0,0,0,0,0,0,0,2,5,2,0
31020,33,678,99,48,90,1,3,5,100,0,0,0,0,0,0,0,0,0,0,0,0,2,5,2,0
31021,33,678,8,5,5,2,0,1,10,0,0,0,0,0,0,0,0,0,0,0,0,2,5,2,0
31022,33,678,1217,716,841,84,126,174,1301,14,185,118,215,199,333,1446,2542,8,20687,1149,0,2,5,2,0
31023,33,678,160,89,115,0,13,31,160,7,15,11,17,22,28,78,124,3,495,27,0,2,5,2,0
31024,33,678,10,10,9,9,0,0,19,0,0,0,0,0,0,0,0,0,0,0,0,2,5,2,0
31025,33,678,173,84,99,8,29,36,181,5,12,7,13,17,20,54,81,2,221,12,0,2,5,2,0
31026,33,678,3,1,1,3,0,0,6,0,0,0,0,0,0,0,0,0,0,0,0,2,5,2,0
31027,72,2658,1450,624,1228,12,26,181,1462,14,306,186,354,320,540,2580,4493,8,36391,2021,1,2,6,1,0
31028,494,10644,72,33,56,0,4,12,72,1,1,1,1,2,2,0,2,0,1,0,0,2,23,11,0
31029,494,10644,1454,835,1044,76,110,219,1530,17,275,158,296,292,454,2297,3718,9,34017,1889,1,2,23,11,0
31030,76,4145,1782,648,1425,9,47,279,1791,8,171,97,189,179,286,1292,2140,4,9462,525,0,2,122,3,0
31031,298,5985,1457,730,1242,11,6,188,1468,10,292,166,329,302,495,2424,4078,5,22973,1276,1,2,12,5,0
31032,298,5985,74,35,59,1,0,14,75,3,14,7,14,17,21,58,85,1,128,7,0,2,12,5,0
31033,298,5985,245,125,200,5,7,34,250,7,30,17,34,37,51,166,265,3,1053,58,0,2,12,5,0
31034,38,2255,334,251,279,10,4,40,344,5,127,74,143,132,217,899,1528,2,4303,239,0,2,9,2,0
31035,44,872,447,308,343,6,5,95,453,7,96,59,111,103,170,651,1136,4,4600,255,0,2,11,1,1
31036,44,872,322,174,179,16,74,51,338,10,41,26,46,51,72,252,408,5,2291,127,0,2,11,1,1
31037,44,872,447,308,343,6,5,95,453,7,96,59,111,103,170,651,1136,4,4600,255,0,2,1,1,0
31038,44,872,322,174,179,16,74,51,338,10,41,26,46,51,72,252,408,5,2291,127,0,2,1,1,0
31039,498,10692,72,33,56,0,4,12,72,1,1,1,1,2,2,0,2,0,1,0,0,2,4,1,1
31040,498,10692,1454,835,1044,76,110,219,1530,17,275,158,296,292,454,2297,3718,9,34017,1889,1,2,4,1,1
31041,140,6179,139,89,101,2,0,35,141,7,54,34,62,61,96,330,569,4,2287,127,0,2,16,0,1
31042,140,6179,7,5,5,0,0,2,7,1,2,1,2,3,3,2,4,0,2,0,0,2,16,0,1
31043,140,6180,139,89,101,2,0,35,141,7,54,34,62,61,96,330,569,4,2287,127,0,2,4,0,0
31044,140,6180,7,5,5,0,0,2,7,1,2,1,2,3,3,2,4,0,2,0,0,2,4,0,0
31045,498,10692,72,33,56,0,4,12,72,1,1,1,1,2,2,0,2,0,1,0,0,2,4,1,0
31046,498,10692,1454,835,1044,76,110,219,1530,17,275,158,296,292,454,2297,3718,9,34017,1889,1,2,4,1,0
31047,140,6180,139,89,101,2,0,35,141,7,54,34,62,61,96,330,569,4,2287,127,0,2,20,0,0
31048,140,6180,7,5,5,0,0,2,7,1,2,1,2,3,3,2,4,0,2,0,0,2,20,0,0
31049,301,6070,1457,730,1242,11,6,188,1468,10,292,166,329,302,495,2424,4078,5,22973,1276,1,2,32,10,1
31050,301,6070,74,35,59,1,0,14,75,3,14,7,14,17,21,58,85,1,128,7,0,2,32,10,1
31051,301,6070,245,125,200,5,7,34,250,7,30,17,34,37,51,166,265,3,1053,58,0,2,32,10,1
31052,23,771,74,35,59,1,0,14,75,3,14,7,14,17,21,58,85,1,128,7,0,2,5,6,1
31053,23,771,245,125,200,5,7,34,250,7,30,17,34,37,51,166,265,3,1053,58,0,2,5,6,1
31054,44,872,447,308,343,6,5,95,453,7,96,59,111,103,170,651,1136,4,4600,255,0,2,11,1,0
31055,44,872,322,174,179,16,74,51,338,10,41,26,46,51,72,252,408,5,2291,127,0,2,11,1,0
31056,43,1300,1455,414,1257,16,76,112,1471,5,41,23,46,46,69,231,381,2,1069,59,0,2,12,0,1
31057,43,1300,669,365,481,22,61,110,691,15,103,63,122,118,185,747,1273,8,11311,628,0,2,12,0,1
31058,39,1553,1455,414,1257,16,76,112,1471,5,41,23,46,46,69,231,381,2,1069,59,0,2,47,0,1
31059,216,4842,722,423,573,19,0,135,741,12,172,101,199,184,300,1320,2257,6,15668,870,0,2,1,1,0
31060,216,4842,1508,847,911,44,250,301,1552,14,148,88,169,162,257,1120,1886,7,15077,837,0,2,1,1,0
31061,173,3589,1943,715,1694,26,18,214,1969,12,185,120,237,197,357,1436,2721,7,20915,1161,0,2,4,2,0
31062,173,3589,1168,838,957,57,25,144,1225,19,348,224,416,367,640,3018,5452,11,61921,3440,1,2,4,2,0
31063,52,2502,1457,730,1242,11,6,188,1468,10,292,166,329,302,495,2424,4078,5,22973,1276,1,2,2,2,0
31064,65,3360,1943,715,1694,26,18,214,1969,12,185,120,237,197,357,1436,2721,7,20915,1161,0,2,3,2,0
31065,43,1300,1455,414,1257,16,76,112,1471,5,41,23,46,46,69,231,381,2,1069,59,0,2,12,0,0
31066,43,1300,669,365,481,22,61,110,691,15,103,63,122,118,185,747,1273,8,11311,628,0,2,12,0,0
31067,39,1553,1455,414,1257,16,76,112,1471,5,41,23,46,46,69,231,381,2,1069,59,0,2,47,0,0
31068,297,5985,1457,730,1242,11,6,188,1468,10,292,166,329,302,495,2424,4078,5,22973,1276,1,2,13,27,1
31069,297,5985,74,35,59,1,0,14,75,3,14,7,14,17,21,58,85,1,128,7,0,2,13,27,1
31070,297,5985,245,125,200,5,7,34,250,7,30,17,34,37,51,166,265,3,1053,58,0,2,13,27,1
31071,46,529,647,139,84,35,284,233,682,0,0,0,0,0,0,0,0,0,0,0,0,2,2,0,1
31072,171,3985,77,34,69,0,0,8,77,3,24,16,29,27,45,114,213,1,387,21,0,2,3,5,1
31073,171,3985,712,438,573,51,9,84,763,14,102,71,128,116,199,733,1364,8,11988,666,0,2,3,5,1
31074,32,1735,384,251,317,7,8,52,391,11,70,44,84,81,128,467,811,6,5355,297,0,2,10,3,1
31075,298,6002,1457,730,1242,11,6,188,1468,10,292,166,329,302,495,2424,4078,5,22973,1276,1,2,21,13,0
31076,298,6002,74,35,59,1,0,14,75,3,14,7,14,17,21,58,85,1,128,7,0,2,21,13,0
31077,298,6002,245,125,200,5,7,34,250,7,30,17,34,37,51,166,265,3,1053,58,0,2,21,13,0
31078,23,771,74,35,59,1,0,14,75,3,14,7,14,17,21,58,85,1,128,7,0,2,5,6,0
31079,23,771,245,125,200,5,7,34,250,7,30,17,34,37,51,166,265,3,1053,58,0,2,5,6,0
31080,46,529,647,139,84,35,284,233,682,0,0,0,0,0,0,0,0,0,0,0,0,2,2,0,0
31081,171,3985,77,34,69,0,0,8,77,3,24,16,29,27,45,114,213,1,387,21,0,2,3,5,0
31082,171,3985,712,438,573,51,9,84,763,14,102,71,128,116,199,733,1364,8,11988,666,0,2,3,5,0
31083,32,1735,384,251,317,7,8,52,391,11,70,44,84,81,128,467,811,6,5355,297,0,2,10,3,0
31084,298,6004,1457,730,1242,11,6,188,1468,10,292,166,329,302,495,2424,4078,5,22973,1276,1,2,1,1,1
31085,298,6004,74,35,59,1,0,14,75,3,14,7,14,17,21,58,85,1,128,7,0,2,1,1,1
31086,298,6004,245,125,200,5,7,34,250,7,30,17,34,37,51,166,265,3,1053,58,0,2,1,1,1
31087,46,531,647,139,84,35,284,233,682,0,0,0,0,0,0,0,0,0,0,0,0,2,1,1,1
31088,498,10696,72,33,56,0,4,12,72,1,1,1,1,2,2,0,2,0,1,0,0,2,1,1,1
31089,498,10696,1454,835,1044,76,110,219,1530,17,275,158,296,292,454,2297,3718,9,34017,1889,1,2,1,1,1
31090,173,3593,1943,715,1694,26,18,214,1969,12,185,120,237,197,357,1436,2721,7,20915,1161,0,2,2,1,1
31091,173,3593,1168,838,957,57,25,144,1225,19,348,224,416,367,640,3018,5452,11,61921,3440,1,2,2,1,1
31115,20,625,42,7,35,4,0,5,46,1,2,1,2,3,3,2,4,0,2,0,0,2,2,2,1
31116,20,625,11,6,10,0,0,1,11,2,4,2,4,6,6,10,15,1,15,0,0,2,2,2,1
31117,65,3364,1943,715,1694,26,18,214,1969,12,185,120,237,197,357,1436,2721,7,20915,1161,0,2,1,1,1
31118,173,3542,1943,715,1694,26,18,214,1969,12,185,120,237,197,357,1436,2721,7,20915,1161,0,2,3,1,0
31119,173,3542,1168,838,957,57,25,144,1225,19,348,224,416,367,640,3018,5452,11,61921,3440,1,2,3,1,0
31120,173,3542,1943,715,1694,26,18,214,1969,12,185,120,237,197,357,1436,2721,7,20915,1161,0,2,1,1,1
31121,173,3542,1168,838,957,57,25,144,1225,19,348,224,416,367,640,3018,5452,11,61921,3440,1,2,1,1,1
31122,50,2216,1178,367,1042,6,15,115,1184,9,94,51,95,103,146,644,976,4,4439,246,0,2,37,0,1
31123,175,3601,1943,715,1694,26,18,214,1969,12,185,120,237,197,357,1436,2721,7,20915,1161,0,2,4,2,0
31124,175,3601,1168,838,957,57,25,144,1225,19,348,224,416,367,640,3018,5452,11,61921,3440,1,2,4,2,0
31125,50,2216,1178,367,1042,6,15,115,1184,9,94,51,95,103,146,644,976,4,4439,246,0,2,37,0,0
31126,54,1131,996,429,845,24,10,117,1020,7,76,50,88,83,138,494,879,4,3565,198,0,0,214,0,1
31127,54,1131,456,277,329,12,42,72,468,13,85,50,97,98,147,592,972,7,7212,400,0,0,214,0,1
31128,298,6002,1457,730,1242,11,6,188,1468,10,292,166,329,302,495,2424,4078,5,22973,1276,1,2,1,1,1
31129,298,6002,74,35,59,1,0,14,75,3,14,7,14,17,21,58,85,1,128,7,0,2,1,1,1
31130,298,6002,245,125,200,5,7,34,250,7,30,17,34,37,51,166,265,3,1053,58,0,2,1,1,1
31131,54,1134,996,429,845,24,10,117,1020,7,76,50,88,83,138,494,879,4,3565,198,0,2,2,2,0
31132,54,1134,456,277,329,12,42,72,468,13,85,50,97,98,147,592,972,7,7212,400,0,2,2,2,0
31133,55,1150,996,429,845,24,10,117,1020,7,76,50,88,83,138,494,879,4,3565,198,0,2,4,0,1
31134,55,1150,456,277,329,12,42,72,468,13,85,50,97,98,147,592,972,7,7212,400,0,2,4,0,1
31135,55,1150,996,429,845,24,10,117,1020,7,76,50,88,83,138,494,879,4,3565,198,0,2,1,0,1
31136,55,1150,456,277,329,12,42,72,468,13,85,50,97,98,147,592,972,7,7212,400,0,2,1,0,1
31137,172,3983,77,34,69,0,0,8,77,3,24,16,29,27,45,114,213,1,387,21,0,2,7,6,1
31138,172,3983,712,438,573,51,9,84,763,14,102,71,128,116,199,733,1364,8,11988,666,0,2,7,6,1
31139,68,3251,1338,495,1086,10,64,173,1348,11,122,82,157,133,239,883,1686,7,11934,663,0,2,1,1,0
31140,65,3360,1943,715,1694,26,18,214,1969,12,185,120,237,197,357,1436,2721,7,20915,1161,0,2,0,1,0
31141,44,872,447,308,343,6,5,95,453,7,96,59,111,103,170,651,1136,4,4600,255,0,2,2,2,0
31142,44,872,322,174,179,16,74,51,338,10,41,26,46,51,72,252,408,5,2291,127,0,2,2,2,0
31143,44,876,447,308,343,6,5,95,453,7,96,59,111,103,170,651,1136,4,4600,255,0,2,4,3,0
31144,44,876,322,174,179,16,74,51,338,10,41,26,46,51,72,252,408,5,2291,127,0,2,4,3,0
31149,175,3605,1943,715,1694,26,18,214,1969,12,185,120,237,197,357,1436,2721,7,20915,1161,0,2,4,2,0
31150,175,3605,1168,838,957,57,25,144,1225,19,348,224,416,367,640,3018,5452,11,61921,3440,1,2,4,2,0
31152,172,3983,77,34,69,0,0,8,77,3,24,16,29,27,45,114,213,1,387,21,0,2,7,6,0
31153,172,3983,712,438,573,51,9,84,763,14,102,71,128,116,199,733,1364,8,11988,666,0,2,7,6,0
31154,298,6004,1457,730,1242,11,6,188,1468,10,292,166,329,302,495,2424,4078,5,22973,1276,1,2,1,1,0
31155,298,6004,74,35,59,1,0,14,75,3,14,7,14,17,21,58,85,1,128,7,0,2,1,1,0
31156,298,6004,245,125,200,5,7,34,250,7,30,17,34,37,51,166,265,3,1053,58,0,2,1,1,0
31157,46,531,647,139,84,35,284,233,682,0,0,0,0,0,0,0,0,0,0,0,0,2,1,1,0
31158,498,10696,72,33,56,0,4,12,72,1,1,1,1,2,2,0,2,0,1,0,0,2,1,1,0
31159,498,10696,1454,835,1044,76,110,219,1530,17,275,158,296,292,454,2297,3718,9,34017,1889,1,2,1,1,0
31160,175,3605,1943,715,1694,26,18,214,1969,12,185,120,237,197,357,1436,2721,7,20915,1161,0,2,2,1,0
31161,175,3605,1168,838,957,57,25,144,1225,19,348,224,416,367,640,3018,5452,11,61921,3440,1,2,2,1,0
31185,20,625,42,7,35,4,0,5,46,1,2,1,2,3,3,2,4,0,2,0,0,2,2,2,0
31186,20,625,11,6,10,0,0,1,11,2,4,2,4,6,6,10,15,1,15,0,0,2,2,2,0
31187,65,3364,1943,715,1694,26,18,214,1969,12,185,120,237,197,357,1436,2721,7,20915,1161,0,2,1,1,0
31213,115,2526,1043,504,840,53,9,147,1096,9,180,112,198,189,310,1377,2344,4,11604,644,0,2,11,5,1
31214,115,2526,383,288,292,26,6,62,409,11,65,38,67,76,105,429,656,5,3719,206,0,2,11,5,1
31215,55,2176,1043,504,840,53,9,147,1096,9,180,112,198,189,310,1377,2344,4,11604,644,0,2,1,1,1
31216,115,2524,1043,504,840,53,9,147,1096,9,180,112,198,189,310,1377,2344,4,11604,644,0,2,0,1,0
31217,115,2524,383,288,292,26,6,62,409,11,65,38,67,76,105,429,656,5,3719,206,0,2,0,1,0
31241,115,2524,1043,504,840,53,9,147,1096,9,180,112,198,189,310,1377,2344,4,11604,644,0,2,10,5,0
31242,115,2524,383,288,292,26,6,62,409,11,65,38,67,76,105,429,656,5,3719,206,0,2,10,5,0
31243,55,2176,1043,504,840,53,9,147,1096,9,180,112,198,189,310,1377,2344,4,11604,644,0,2,1,1,0
31269,503,10795,72,33,56,0,4,12,72,1,1,1,1,2,2,0,2,0,1,0,0,2,23,3,1
31270,503,10795,1454,835,1044,76,110,219,1530,17,275,158,296,292,454,2297,3718,9,34017,1889,1,2,23,3,1
31271,57,2317,1043,504,840,53,9,147,1096,9,180,112,198,189,310,1377,2344,4,11604,644,0,2,4,1,1
31272,503,10792,72,33,56,0,4,12,72,1,1,1,1,2,2,0,2,0,1,0,0,2,1,1,0
31273,503,10792,1454,835,1044,76,110,219,1530,17,275,158,296,292,454,2297,3718,9,34017,1889,1,2,1,1,0
31274,503,10791,72,33,56,0,4,12,72,1,1,1,1,2,2,0,2,0,1,0,0,2,1,1,0
31275,503,10791,1454,835,1044,76,110,219,1530,17,275,158,296,292,454,2297,3718,9,34017,1889,1,2,1,1,0
31301,503,10797,72,33,56,0,4,12,72,1,1,1,1,2,2,0,2,0,1,0,0,2,2,1,0
31302,503,10797,1454,835,1044,76,110,219,1530,17,275,158,296,292,454,2297,3718,9,34017,1889,1,2,2,1,0
31303,76,4181,1782,648,1425,9,47,279,1791,8,171,97,189,179,286,1292,2140,4,9462,525,0,2,4,0,0
31304,501,10735,72,33,56,0,4,12,72,1,1,1,1,2,2,0,2,0,1,0,0,2,4,12,1
31305,501,10735,1454,835,1044,76,110,219,1530,17,275,158,296,292,454,2297,3718,9,34017,1889,1,2,4,12,1
31306,14,449,442,244,305,14,16,103,456,11,68,45,75,79,120,452,756,6,4588,254,0,2,5,1,0
31307,14,449,182,102,99,11,40,35,193,3,11,6,11,14,17,42,64,1,97,5,0,2,5,1,0
31308,9,601,442,244,305,14,16,103,456,11,68,45,75,79,120,452,756,6,4588,254,0,2,16,1,0
31309,15,453,442,244,305,14,16,103,456,11,68,45,75,79,120,452,756,6,4588,254,0,2,13,6,1
31310,15,453,182,102,99,11,40,35,193,3,11,6,11,14,17,42,64,1,97,5,0,2,13,6,1
31311,10,640,442,244,305,14,16,103,456,11,68,45,75,79,120,452,756,6,4588,254,0,2,10,0,1
31312,10,663,442,244,305,14,16,103,456,11,68,45,75,79,120,452,756,6,4588,254,0,2,4,1,0
31313,55,1150,996,429,845,24,10,117,1020,7,76,50,88,83,138,494,879,4,3565,198,0,2,7,7,1
31314,55,1150,456,277,329,12,42,72,468,13,85,50,97,98,147,592,972,7,7212,400,0,2,7,7,1
31315,16,464,442,244,305,14,16,103,456,11,68,45,75,79,120,452,756,6,4588,254,0,2,10,7,0
31316,16,464,182,102,99,11,40,35,193,3,11,6,11,14,17,42,64,1,97,5,0,2,10,7,0
31317,10,663,442,244,305,14,16,103,456,11,68,45,75,79,120,452,756,6,4588,254,0,2,1,1,0
31318,55,1150,996,429,845,24,10,117,1020,7,76,50,88,83,138,494,879,4,3565,198,0,0,219,0,0
31319,55,1150,456,277,329,12,42,72,468,13,85,50,97,98,147,592,972,7,7212,400,0,0,219,0,0
31323,44,876,447,308,343,6,5,95,453,7,96,59,111,103,170,651,1136,4,4600,255,0,2,2,2,0
31324,44,876,322,174,179,16,74,51,338,10,41,26,46,51,72,252,408,5,2291,127,0,2,2,2,0
31326,65,3364,1943,715,1694,26,18,214,1969,12,185,120,237,197,357,1436,2721,7,20915,1161,0,2,0,1,0
31327,16,464,442,244,305,14,16,103,456,11,68,45,75,79,120,452,756,6,4588,254,0,2,18,4,0
31328,16,464,182,102,99,11,40,35,193,3,11,6,11,14,17,42,64,1,97,5,0,2,18,4,0
31329,10,663,442,244,305,14,16,103,456,11,68,45,75,79,120,452,756,6,4588,254,0,2,29,1,0
31353,498,10733,72,33,56,0,4,12,72,1,1,1,1,2,2,0,2,0,1,0,0,2,8,1,1
31354,498,10733,1454,835,1044,76,110,219,1530,17,275,158,296,292,454,2297,3718,9,34017,1889,1,2,8,1,1
31355,68,3269,1338,495,1086,10,64,173,1348,11,122,82,157,133,239,883,1686,7,11934,663,0,2,6,4,1
31356,77,4224,1782,648,1425,9,47,279,1791,8,171,97,189,179,286,1292,2140,4,9462,525,0,2,14,4,1
31403,498,10733,72,33,56,0,4,12,72,1,1,1,1,2,2,0,2,0,1,0,0,2,8,1,0
31404,498,10733,1454,835,1044,76,110,219,1530,17,275,158,296,292,454,2297,3718,9,34017,1889,1,2,8,1,0
31405,68,3269,1338,495,1086,10,64,173,1348,11,122,82,157,133,239,883,1686,7,11934,663,0,2,6,4,0
31429,20,617,42,7,35,4,0,5,46,1,2,1,2,3,3,2,4,0,2,0,0,2,1,2,1
31430,20,617,11,6,10,0,0,1,11,2,4,2,4,6,6,10,15,1,15,0,0,2,1,2,1
31454,20,617,42,7,35,4,0,5,46,1,2,1,2,3,3,2,4,0,2,0,0,2,1,2,0
31455,20,617,11,6,10,0,0,1,11,2,4,2,4,6,6,10,15,1,15,0,0,2,1,2,0
31458,501,10772,72,33,56,0,4,12,72,1,1,1,1,2,2,0,2,0,1,0,0,2,16,3,0
31459,501,10772,1454,835,1044,76,110,219,1530,17,275,158,296,292,454,2297,3718,9,34017,1889,1,2,16,3,0
31460,77,4224,1782,648,1425,9,47,279,1791,8,171,97,189,179,286,1292,2140,4,9462,525,0,2,14,0,0
31461,57,2317,1043,504,840,53,9,147,1096,9,180,112,198,189,310,1377,2344,4,11604,644,0,2,4,1,0
31489,54,1579,1523,757,1297,19,12,193,1542,12,193,117,230,205,347,1508,2664,7,19053,1058,0,2,9,1,1
31490,54,1579,701,378,504,33,58,109,734,13,110,68,126,123,194,794,1346,7,10027,557,0,2,9,1,1
31491,42,2753,1523,757,1297,19,12,193,1542,12,193,117,230,205,347,1508,2664,7,19053,1058,0,2,3,1,1
31492,54,1579,1523,757,1297,19,12,193,1542,12,193,117,230,205,347,1508,2664,7,19053,1058,0,2,9,1,0
31493,54,1579,701,378,504,33,58,109,734,13,110,68,126,123,194,794,1346,7,10027,557,0,2,9,1,0
31494,42,2753,1523,757,1297,19,12,193,1542,12,193,117,230,205,347,1508,2664,7,19053,1058,0,2,3,1,0
31518,88,1927,477,336,357,30,23,73,507,16,194,134,250,210,384,1538,2962,10,30538,1696,0,2,8,1,0
31519,74,2691,1450,624,1228,12,26,181,1462,14,306,186,354,320,540,2580,4493,8,36391,2021,1,2,11,0,0
31520,90,1940,477,336,357,30,23,73,507,16,194,134,250,210,384,1538,2962,10,30538,1696,0,2,9,7,1
31521,16,468,442,244,305,14,16,103,456,11,68,45,75,79,120,452,756,6,4588,254,0,2,1,1,1
31522,16,468,182,102,99,11,40,35,193,3,11,6,11,14,17,42,64,1,97,5,0,2,1,1,1
31523,12,822,442,244,305,14,16,103,456,11,68,45,75,79,120,452,756,6,4588,254,0,2,34,0,1
31524,16,468,442,244,305,14,16,103,456,11,68,45,75,79,120,452,756,6,4588,254,0,2,1,1,0
31525,16,468,182,102,99,11,40,35,193,3,11,6,11,14,17,42,64,1,97,5,0,2,1,1,0
31526,12,822,442,244,305,14,16,103,456,11,68,45,75,79,120,452,756,6,4588,254,0,2,34,0,0
31527,46,531,647,139,84,35,284,233,682,0,0,0,0,0,0,0,0,0,0,0,0,2,9,2,0
31528,37,841,386,256,301,16,9,68,402,4,59,35,69,63,104,355,621,2,1453,80,0,2,10,1,1
31529,37,841,264,131,164,11,41,46,275,6,38,22,40,44,62,214,338,3,1068,59,0,2,10,1,1
31530,23,1031,386,256,301,16,9,68,402,4,59,35,69,63,104,355,621,2,1453,80,0,2,11,0,1
31531,37,831,386,256,301,16,9,68,402,4,59,35,69,63,104,355,621,2,1453,80,0,2,1,2,1
31532,37,831,264,131,164,11,41,46,275,6,38,22,40,44,62,214,338,3,1068,59,0,2,1,2,1
31579,90,1940,477,336,357,30,23,73,507,16,194,134,250,210,384,1538,2962,10,30538,1696,0,2,10,1,0
31583,37,831,386,256,301,16,9,68,402,4,59,35,69,63,104,355,621,2,1453,80,0,2,10,2,0
31584,37,831,264,131,164,11,41,46,275,6,38,22,40,44,62,214,338,3,1068,59,0,2,10,2,0
31585,23,1031,386,256,301,16,9,68,402,4,59,35,69,63,104,355,621,2,1453,80,0,2,11,0,0
31586,57,1218,996,429,845,24,10,117,1020,7,76,50,88,83,138,494,879,4,3565,198,0,2,16,4,1
31587,57,1218,456,277,329,12,42,72,468,13,85,50,97,98,147,592,972,7,7212,400,0,2,16,4,1
31588,480,10385,72,33,56,0,4,12,72,1,1,1,1,2,2,0,2,0,1,0,0,2,1,1,0
31589,480,10385,1454,835,1044,76,110,219,1530,17,275,158,296,292,454,2297,3718,9,34017,1889,1,2,1,1,0
31590,501,10772,72,33,56,0,4,12,72,1,1,1,1,2,2,0,2,0,1,0,0,2,1,1,0
31591,501,10772,1454,835,1044,76,110,219,1530,17,275,158,296,292,454,2297,3718,9,34017,1889,1,2,1,1,0
31592,57,1218,996,429,845,24,10,117,1020,7,76,50,88,83,138,494,879,4,3565,198,0,2,1,1,1
31593,57,1218,456,277,329,12,42,72,468,13,85,50,97,98,147,592,972,7,7212,400,0,2,1,1,1
31594,112,2270,1513,682,1277,25,13,200,1538,11,199,116,219,210,335,1557,2584,6,15641,868,0,2,2,2,1
31595,112,2270,819,519,539,24,98,155,843,15,96,57,106,111,163,690,1107,8,9171,509,0,2,2,2,1
31596,115,2524,1043,504,840,53,9,147,1096,9,180,112,198,189,310,1377,2344,4,11604,644,0,2,1,1,1
31597,115,2524,383,288,292,26,6,62,409,11,65,38,67,76,105,429,656,5,3719,206,0,2,1,1,1
31598,57,1218,996,429,845,24,10,117,1020,7,76,50,88,83,138,494,879,4,3565,198,0,2,16,4,0
31599,57,1218,456,277,329,12,42,72,468,13,85,50,97,98,147,592,972,7,7212,400,0,2,16,4,0
31600,508,10878,72,33,56,0,4,12,72,1,1,1,1,2,2,0,2,0,1,0,0,2,43,1,1
31601,508,10878,1454,835,1044,76,110,219,1530,17,275,158,296,292,454,2297,3718,9,34017,1889,1,2,43,1,1
31602,77,4244,1782,648,1425,9,47,279,1791,8,171,97,189,179,286,1292,2140,4,9462,525,0,2,10,6,1
31603,57,1219,996,429,845,24,10,117,1020,7,76,50,88,83,138,494,879,4,3565,198,0,2,12,0,1
31604,57,1219,456,277,329,12,42,72,468,13,85,50,97,98,147,592,972,7,7212,400,0,2,12,0,1
31605,175,3605,1943,715,1694,26,18,214,1969,12,185,120,237,197,357,1436,2721,7,20915,1161,0,2,1,1,0
31606,175,3605,1168,838,957,57,25,144,1225,19,348,224,416,367,640,3018,5452,11,61921,3440,1,2,1,1,0
31609,57,1219,996,429,845,24,10,117,1020,7,76,50,88,83,138,494,879,4,3565,198,0,2,12,0,0
31610,57,1219,456,277,329,12,42,72,468,13,85,50,97,98,147,592,972,7,7212,400,0,2,12,0,0
31611,508,10878,72,33,56,0,4,12,72,1,1,1,1,2,2,0,2,0,1,0,0,2,43,1,0
31612,508,10878,1454,835,1044,76,110,219,1530,17,275,158,296,292,454,2297,3718,9,34017,1889,1,2,43,1,0
31613,77,4244,1782,648,1425,9,47,279,1791,8,171,97,189,179,286,1292,2140,4,9462,525,0,2,10,6,0
31614,57,1219,996,429,845,24,10,117,1020,7,76,50,88,83,138,494,879,4,3565,198,0,2,28,4,0
31615,57,1219,456,277,329,12,42,72,468,13,85,50,97,98,147,592,972,7,7212,400,0,2,28,4,0
31616,508,10878,72,33,56,0,4,12,72,1,1,1,1,2,2,0,2,0,1,0,0,2,44,2,0
31617,508,10878,1454,835,1044,76,110,219,1530,17,275,158,296,292,454,2297,3718,9,34017,1889,1,2,44,2,0
31621,56,1686,1523,757,1297,19,12,193,1542,12,193,117,230,205,347,1508,2664,7,19053,1058,0,2,60,16,1
31622,56,1686,701,378,504,33,58,109,734,13,110,68,126,123,194,794,1346,7,10027,557,0,2,60,16,1
31623,45,2836,1523,757,1297,19,12,193,1542,12,193,117,230,205,347,1508,2664,7,19053,1058,0,2,25,0,1
31624,56,1686,1523,757,1297,19,12,193,1542,12,193,117,230,205,347,1508,2664,7,19053,1058,0,2,60,16,0
31625,56,1686,701,378,504,33,58,109,734,13,110,68,126,123,194,794,1346,7,10027,557,0,2,60,16,0
31626,45,2836,1523,757,1297,19,12,193,1542,12,193,117,230,205,347,1508,2664,7,19053,1058,0,2,25,0,0
31630,299,6014,1457,730,1242,11,6,188,1468,10,292,166,329,302,495,2424,4078,5,22973,1276,1,2,6,0,1
31631,299,6014,74,35,59,1,0,14,75,3,14,7,14,17,21,58,85,1,128,7,0,2,6,0,1
31632,299,6014,245,125,200,5,7,34,250,7,30,17,34,37,51,166,265,3,1053,58,0,2,6,0,1
31633,35,2152,652,304,544,16,6,88,668,6,89,51,101,95,152,591,998,3,3399,188,0,2,16,0,1
31634,508,10878,72,33,56,0,4,12,72,1,1,1,1,2,2,0,2,0,1,0,0,2,2,2,1
31635,508,10878,1454,835,1044,76,110,219,1530,17,275,158,296,292,454,2297,3718,9,34017,1889,1,2,2,2,1
31636,297,5993,1457,730,1242,11,6,188,1468,10,292,166,329,302,495,2424,4078,5,22973,1276,1,2,3,9,1
31637,297,5993,74,35,59,1,0,14,75,3,14,7,14,17,21,58,85,1,128,7,0,2,3,9,1
31638,297,5993,245,125,200,5,7,34,250,7,30,17,34,37,51,166,265,3,1053,58,0,2,3,9,1
31639,297,5993,1457,730,1242,11,6,188,1468,10,292,166,329,302,495,2424,4078,5,22973,1276,1,2,8,8,0
31640,297,5993,74,35,59,1,0,14,75,3,14,7,14,17,21,58,85,1,128,7,0,2,8,8,0
31641,297,5993,245,125,200,5,7,34,250,7,30,17,34,37,51,166,265,3,1053,58,0,2,8,8,0
31642,508,10878,72,33,56,0,4,12,72,1,1,1,1,2,2,0,2,0,1,0,0,2,2,2,0
31643,508,10878,1454,835,1044,76,110,219,1530,17,275,158,296,292,454,2297,3718,9,34017,1889,1,2,2,2,0
31644,35,2152,652,304,544,16,6,88,668,6,89,51,101,95,152,591,998,3,3399,188,0,2,16,0,0
31645,36,829,386,256,301,16,9,68,402,4,59,35,69,63,104,355,621,2,1453,80,0,2,2,1,1
31646,36,829,264,131,164,11,41,46,275,6,38,22,40,44,62,214,338,3,1068,59,0,2,2,1,1
31647,22,1003,386,256,301,16,9,68,402,4,59,35,69,63,104,355,621,2,1453,80,0,2,6,3,1
31648,24,1062,386,256,301,16,9,68,402,4,59,35,69,63,104,355,621,2,1453,80,0,2,8,0,1
31649,36,829,386,256,301,16,9,68,402,4,59,35,69,63,104,355,621,2,1453,80,0,2,2,1,0
31650,36,829,264,131,164,11,41,46,275,6,38,22,40,44,62,214,338,3,1068,59,0,2,2,1,0
31651,24,1062,386,256,301,16,9,68,402,4,59,35,69,63,104,355,621,2,1453,80,0,2,14,3,0
31652,23,760,74,35,59,1,0,14,75,3,14,7,14,17,21,58,85,1,128,7,0,2,1,1,0
31653,23,760,245,125,200,5,7,34,250,7,30,17,34,37,51,166,265,3,1053,58,0,2,1,1,0
31654,24,810,74,35,59,1,0,14,75,3,14,7,14,17,21,58,85,1,128,7,0,2,12,2,0
31655,24,810,245,125,200,5,7,34,250,7,30,17,34,37,51,166,265,3,1053,58,0,2,12,2,0
31656,297,5997,1457,730,1242,11,6,188,1468,10,292,166,329,302,495,2424,4078,5,22973,1276,1,2,1,0,1
31657,297,5997,74,35,59,1,0,14,75,3,14,7,14,17,21,58,85,1,128,7,0,2,1,0,1
31658,297,5997,245,125,200,5,7,34,250,7,30,17,34,37,51,166,265,3,1053,58,0,2,1,0,1
31659,35,1821,384,251,317,7,8,52,391,11,70,44,84,81,128,467,811,6,5355,297,0,2,17,0,1
31660,297,5997,1457,730,1242,11,6,188,1468,10,292,166,329,302,495,2424,4078,5,22973,1276,1,2,1,0,0
31661,297,5997,74,35,59,1,0,14,75,3,14,7,14,17,21,58,85,1,128,7,0,2,1,0,0
31662,297,5997,245,125,200,5,7,34,250,7,30,17,34,37,51,166,265,3,1053,58,0,2,1,0,0
31663,35,1821,384,251,317,7,8,52,391,11,70,44,84,81,128,467,811,6,5355,297,0,2,17,0,0
31664,112,2270,1513,682,1277,25,13,200,1538,11,199,116,219,210,335,1557,2584,6,15641,868,0,2,2,2,0
31665,112,2270,819,519,539,24,98,155,843,15,96,57,106,111,163,690,1107,8,9171,509,0,2,2,2,0
31666,115,2524,1043,504,840,53,9,147,1096,9,180,112,198,189,310,1377,2344,4,11604,644,0,2,1,1,0
31667,115,2524,383,288,292,26,6,62,409,11,65,38,67,76,105,429,656,5,3719,206,0,2,1,1,0
31691,219,4876,722,423,573,19,0,135,741,12,172,101,199,184,300,1320,2257,6,15668,870,0,2,14,0,1
31692,219,4876,1508,847,911,44,250,301,1552,14,148,88,169,162,257,1120,1886,7,15077,837,0,2,14,0,1
31716,219,4876,722,423,573,19,0,135,741,12,172,101,199,184,300,1320,2257,6,15668,870,0,2,14,0,0
31717,219,4876,1508,847,911,44,250,301,1552,14,148,88,169,162,257,1120,1886,7,15077,837,0,2,14,0,0
31743,297,5997,1457,730,1242,11,6,188,1468,10,292,166,329,302,495,2424,4078,5,22973,1276,1,2,9,8,0
31744,297,5997,74,35,59,1,0,14,75,3,14,7,14,17,21,58,85,1,128,7,0,2,9,8,0
31745,297,5997,245,125,200,5,7,34,250,7,30,17,34,37,51,166,265,3,1053,58,0,2,9,8,0
31750,37,838,386,256,301,16,9,68,402,4,59,35,69,63,104,355,621,2,1453,80,0,2,2,1,0
31751,37,838,264,131,164,11,41,46,275,6,38,22,40,44,62,214,338,3,1068,59,0,2,2,1,0
31756,26,1119,386,256,301,16,9,68,402,4,59,35,69,63,104,355,621,2,1453,80,0,2,14,3,0
31757,14,811,442,244,305,14,16,103,456,11,68,45,75,79,120,452,756,6,4588,254,0,2,12,11,0
31759,508,10878,72,33,56,0,4,12,72,1,1,1,1,2,2,0,2,0,1,0,0,2,1,1,1
31760,508,10878,1454,835,1044,76,110,219,1530,17,275,158,296,292,454,2297,3718,9,34017,1889,1,2,1,1,1
31761,79,4325,1782,648,1425,9,47,279,1791,8,171,97,189,179,286,1292,2140,4,9462,525,0,2,19,0,1
31762,509,10885,72,33,56,0,4,12,72,1,1,1,1,2,2,0,2,0,1,0,0,2,9,5,1
31763,509,10885,1454,835,1044,76,110,219,1530,17,275,158,296,292,454,2297,3718,9,34017,1889,1,2,9,5,1
31764,81,4395,1782,648,1425,9,47,279,1791,8,171,97,189,179,286,1292,2140,4,9462,525,0,2,17,0,1
31765,508,10886,72,33,56,0,4,12,72,1,1,1,1,2,2,0,2,0,1,0,0,2,4,1,0
31766,508,10886,1454,835,1044,76,110,219,1530,17,275,158,296,292,454,2297,3718,9,34017,1889,1,2,4,1,0
31767,71,3403,1338,495,1086,10,64,173,1348,11,122,82,157,133,239,883,1686,7,11934,663,0,2,48,0,0
31768,57,1219,996,429,845,24,10,117,1020,7,76,50,88,83,138,494,879,4,3565,198,0,2,2,2,0
31769,57,1219,456,277,329,12,42,72,468,13,85,50,97,98,147,592,972,7,7212,400,0,2,2,2,0
31772,509,10885,72,33,56,0,4,12,72,1,1,1,1,2,2,0,2,0,1,0,0,2,3,2,1
31773,509,10885,1454,835,1044,76,110,219,1530,17,275,158,296,292,454,2297,3718,9,34017,1889,1,2,3,2,1
31774,510,10903,72,33,56,0,4,12,72,1,1,1,1,2,2,0,2,0,1,0,0,2,7,3,0
31775,510,10903,1454,835,1044,76,110,219,1530,17,275,158,296,292,454,2297,3718,9,34017,1889,1,2,7,3,0
31776,71,3404,1338,495,1086,10,64,173,1348,11,122,82,157,133,239,883,1686,7,11934,663,0,2,1,1,0
31777,510,10903,72,33,56,0,4,12,72,1,1,1,1,2,2,0,2,0,1,0,0,2,7,0,0
31778,510,10903,1454,835,1044,76,110,219,1530,17,275,158,296,292,454,2297,3718,9,34017,1889,1,2,7,0,0
31779,71,3404,1338,495,1086,10,64,173,1348,11,122,82,157,133,239,883,1686,7,11934,663,0,2,48,0,0
31782,511,10910,72,33,56,0,4,12,72,1,1,1,1,2,2,0,2,0,1,0,0,2,7,0,0
31783,511,10910,1454,835,1044,76,110,219,1530,17,275,158,296,292,454,2297,3718,9,34017,1889,1,2,7,0,0
31785,24,810,74,35,59,1,0,14,75,3,14,7,14,17,21,58,85,1,128,7,0,2,13,3,0
31786,24,810,245,125,200,5,7,34,250,7,30,17,34,37,51,166,265,3,1053,58,0,2,13,3,0
31787,511,10910,72,33,56,0,4,12,72,1,1,1,1,2,2,0,2,0,1,0,0,2,12,7,0
31788,511,10910,1454,835,1044,76,110,219,1530,17,275,158,296,292,454,2297,3718,9,34017,1889,1,2,12,7,0
31789,81,4395,1782,648,1425,9,47,279,1791,8,171,97,189,179,286,1292,2140,4,9462,525,0,2,36,0,0
31790,511,10910,72,33,56,0,4,12,72,1,1,1,1,2,2,0,2,0,1,0,0,2,22,0,1
31791,511,10910,1454,835,1044,76,110,219,1530,17,275,158,296,292,454,2297,3718,9,34017,1889,1,2,22,0,1
31792,511,10910,72,33,56,0,4,12,72,1,1,1,1,2,2,0,2,0,1,0,0,2,1,1,1
31793,511,10910,1454,835,1044,76,110,219,1530,17,275,158,296,292,454,2297,3718,9,34017,1889,1,2,1,1,1
31794,511,10910,72,33,56,0,4,12,72,1,1,1,1,2,2,0,2,0,1,0,0,2,19,19,1
31795,511,10910,1454,835,1044,76,110,219,1530,17,275,158,296,292,454,2297,3718,9,34017,1889,1,2,19,19,1
31796,91,1678,1178,367,1042,6,15,115,1184,9,94,51,95,103,146,644,976,4,4439,246,0,2,10,4,0
31797,91,1678,177,108,140,8,0,27,185,6,30,16,32,36,48,162,248,3,794,44,0,2,10,4,0
31798,112,4312,1513,682,1277,25,13,200,1538,11,199,116,219,210,335,1557,2584,6,15641,868,0,2,0,1,0
31799,53,2322,1178,367,1042,6,15,115,1184,9,94,51,95,103,146,644,976,4,4439,246,0,2,42,1,0
31800,92,1699,1178,367,1042,6,15,115,1184,9,94,51,95,103,146,644,976,4,4439,246,0,2,6,4,0
31801,92,1699,177,108,140,8,0,27,185,6,30,16,32,36,48,162,248,3,794,44,0,2,6,4,0
31802,54,2355,1178,367,1042,6,15,115,1184,9,94,51,95,103,146,644,976,4,4439,246,0,2,16,0,0
31803,55,2386,1178,367,1042,6,15,115,1184,9,94,51,95,103,146,644,976,4,4439,246,0,2,19,4,0
31804,92,1702,1178,367,1042,6,15,115,1184,9,94,51,95,103,146,644,976,4,4439,246,0,2,1,1,0
31805,92,1702,177,108,140,8,0,27,185,6,30,16,32,36,48,162,248,3,794,44,0,2,1,1,0
31806,55,2395,1178,367,1042,6,15,115,1184,9,94,51,95,103,146,644,976,4,4439,246,0,2,3,3,0
31807,91,1695,1178,367,1042,6,15,115,1184,9,94,51,95,103,146,644,976,4,4439,246,0,2,2,3,0
31808,91,1695,177,108,140,8,0,27,185,6,30,16,32,36,48,162,248,3,794,44,0,2,2,3,0
31809,55,2401,1178,367,1042,6,15,115,1184,9,94,51,95,103,146,644,976,4,4439,246,0,2,5,2,0
31810,94,1739,1178,367,1042,6,15,115,1184,9,94,51,95,103,146,644,976,4,4439,246,0,2,18,9,1
31811,94,1739,177,108,140,8,0,27,185,6,30,16,32,36,48,162,248,3,794,44,0,2,18,9,1
31812,56,2436,1178,367,1042,6,15,115,1184,9,94,51,95,103,146,644,976,4,4439,246,0,2,13,0,1
31813,94,1739,1178,367,1042,6,15,115,1184,9,94,51,95,103,146,644,976,4,4439,246,0,2,6,0,0
31814,94,1739,177,108,140,8,0,27,185,6,30,16,32,36,48,162,248,3,794,44,0,2,6,0,0
31815,56,2436,1178,367,1042,6,15,115,1184,9,94,51,95,103,146,644,976,4,4439,246,0,2,1,0,0
31816,94,1736,1178,367,1042,6,15,115,1184,9,94,51,95,103,146,644,976,4,4439,246,0,2,1,1,1
31817,94,1736,177,108,140,8,0,27,185,6,30,16,32,36,48,162,248,3,794,44,0,2,1,1,1
31818,56,2424,1178,367,1042,6,15,115,1184,9,94,51,95,103,146,644,976,4,4439,246,0,2,4,4,1
31819,56,2424,1178,367,1042,6,15,115,1184,9,94,51,95,103,146,644,976,4,4439,246,0,2,0,4,0
31820,56,2424,1178,367,1042,6,15,115,1184,9,94,51,95,103,146,644,976,4,4439,246,0,2,1,1,0
31821,56,2424,1178,367,1042,6,15,115,1184,9,94,51,95,103,146,644,976,4,4439,246,0,2,2,2,0
31822,94,1737,1178,367,1042,6,15,115,1184,9,94,51,95,103,146,644,976,4,4439,246,0,2,1,1,1
31823,94,1737,177,108,140,8,0,27,185,6,30,16,32,36,48,162,248,3,794,44,0,2,1,1,1
31824,56,2421,1178,367,1042,6,15,115,1184,9,94,51,95,103,146,644,976,4,4439,246,0,2,1,1,1
31825,45,1334,1455,414,1257,16,76,112,1471,5,41,23,46,46,69,231,381,2,1069,59,0,2,21,8,1
31826,45,1334,669,365,481,22,61,110,691,15,103,63,122,118,185,747,1273,8,11311,628,0,2,21,8,1
31827,44,1867,1455,414,1257,16,76,112,1471,5,41,23,46,46,69,231,381,2,1069,59,0,2,120,33,1
31828,511,10910,72,33,56,0,4,12,72,1,1,1,1,2,2,0,2,0,1,0,0,2,21,21,1
31829,511,10910,1454,835,1044,76,110,219,1530,17,275,158,296,292,454,2297,3718,9,34017,1889,1,2,21,21,1
31830,511,10910,72,33,56,0,4,12,72,1,1,1,1,2,2,0,2,0,1,0,0,2,21,21,0
31831,511,10910,1454,835,1044,76,110,219,1530,17,275,158,296,292,454,2297,3718,9,34017,1889,1,2,21,21,0
31901,72,3434,1338,495,1086,10,64,173,1348,11,122,82,157,133,239,883,1686,7,11934,663,0,2,10,0,0
31902,55,2732,1457,730,1242,11,6,188,1468,10,292,166,329,302,495,2424,4078,5,22973,1276,1,2,45,0,1
31903,297,6005,1457,730,1242,11,6,188,1468,10,292,166,329,302,495,2424,4078,5,22973,1276,1,2,3,3,0
31904,297,6005,74,35,59,1,0,14,75,3,14,7,14,17,21,58,85,1,128,7,0,2,3,3,0
31905,297,6005,245,125,200,5,7,34,250,7,30,17,34,37,51,166,265,3,1053,58,0,2,3,3,0
31906,55,2710,1457,730,1242,11,6,188,1468,10,292,166,329,302,495,2424,4078,5,22973,1276,1,2,0,2,0
31907,298,6078,1457,730,1242,11,6,188,1468,10,292,166,329,302,495,2424,4078,5,22973,1276,1,2,16,14,1
31908,298,6078,74,35,59,1,0,14,75,3,14,7,14,17,21,58,85,1,128,7,0,2,16,14,1
31909,298,6078,245,125,200,5,7,34,250,7,30,17,34,37,51,166,265,3,1053,58,0,2,16,14,1
31910,55,2794,1457,730,1242,11,6,188,1468,10,292,166,329,302,495,2424,4078,5,22973,1276,1,2,23,9,1
31911,55,2827,1457,730,1242,11,6,188,1468,10,292,166,329,302,495,2424,4078,5,22973,1276,1,2,6,0,1
31912,298,6078,1457,730,1242,11,6,188,1468,10,292,166,329,302,495,2424,4078,5,22973,1276,1,2,18,16,0
31913,298,6078,74,35,59,1,0,14,75,3,14,7,14,17,21,58,85,1,128,7,0,2,18,16,0
31914,298,6078,245,125,200,5,7,34,250,7,30,17,34,37,51,166,265,3,1053,58,0,2,18,16,0
31915,55,2827,1457,730,1242,11,6,188,1468,10,292,166,329,302,495,2424,4078,5,22973,1276,1,2,63,0,0
31916,512,10947,72,33,56,0,4,12,72,1,1,1,1,2,2,0,2,0,1,0,0,2,10,1,1
31917,512,10947,1454,835,1044,76,110,219,1530,17,275,158,296,292,454,2297,3718,9,34017,1889,1,2,10,1,1
31918,512,10947,72,33,56,0,4,12,72,1,1,1,1,2,2,0,2,0,1,0,0,2,10,1,0
31919,512,10947,1454,835,1044,76,110,219,1530,17,275,158,296,292,454,2297,3718,9,34017,1889,1,2,10,1,0
31921,45,1334,1455,414,1257,16,76,112,1471,5,41,23,46,46,69,231,381,2,1069,59,0,2,21,8,0
31922,45,1334,669,365,481,22,61,110,691,15,103,63,122,118,185,747,1273,8,11311,628,0,2,21,8,0
31923,44,1867,1455,414,1257,16,76,112,1471,5,41,23,46,46,69,231,381,2,1069,59,0,2,120,33,0
31924,513,10957,72,33,56,0,4,12,72,1,1,1,1,2,2,0,2,0,1,0,0,2,5,2,1
31925,513,10957,1454,835,1044,76,110,219,1530,17,275,158,296,292,454,2297,3718,9,34017,1889,1,2,5,2,1
31926,73,3470,1338,495,1086,10,64,173,1348,11,122,82,157,133,239,883,1686,7,11934,663,0,2,24,0,1
31927,513,10957,72,33,56,0,4,12,72,1,1,1,1,2,2,0,2,0,1,0,0,2,5,2,0
31928,513,10957,1454,835,1044,76,110,219,1530,17,275,158,296,292,454,2297,3718,9,34017,1889,1,2,5,2,0
31929,73,3470,1338,495,1086,10,64,173,1348,11,122,82,157,133,239,883,1686,7,11934,663,0,2,24,0,0
31930,513,10965,72,33,56,0,4,12,72,1,1,1,1,2,2,0,2,0,1,0,0,2,5,2,1
31931,513,10965,1454,835,1044,76,110,219,1530,17,275,158,296,292,454,2297,3718,9,34017,1889,1,2,5,2,1
31932,75,3563,1338,495,1086,10,64,173,1348,11,122,82,157,133,239,883,1686,7,11934,663,0,2,30,6,1
31933,513,10965,72,33,56,0,4,12,72,1,1,1,1,2,2,0,2,0,1,0,0,2,5,2,0
31934,513,10965,1454,835,1044,76,110,219,1530,17,275,158,296,292,454,2297,3718,9,34017,1889,1,2,5,2,0
31935,75,3563,1338,495,1086,10,64,173,1348,11,122,82,157,133,239,883,1686,7,11934,663,0,2,30,6,0
31936,147,4720,1660,832,1314,41,38,274,1701,20,312,209,395,332,604,2671,5058,12,64042,3557,1,2,1,1,0
31937,147,4720,1057,646,719,113,100,145,1170,18,215,134,248,233,382,1740,3004,10,31186,1732,1,2,1,1,0
31938,172,3983,77,34,69,0,0,8,77,3,24,16,29,27,45,114,213,1,387,21,0,2,0,6,0
31939,172,3983,712,438,573,51,9,84,763,14,102,71,128,116,199,733,1364,8,11988,666,0,2,0,6,0
31942,175,3619,1943,715,1694,26,18,214,1969,12,185,120,237,197,357,1436,2721,7,20915,1161,0,2,2,1,0
31943,175,3619,1168,838,957,57,25,144,1225,19,348,224,416,367,640,3018,5452,11,61921,3440,1,2,2,1,0
31948,51,1053,1098,241,925,5,10,155,1103,7,46,25,49,53,74,273,423,3,1580,87,0,2,1,0,1
31949,51,1053,282,202,222,14,2,44,296,8,42,24,43,50,67,250,378,4,1548,86,0,2,1,0,1
31950,38,1499,1098,241,925,5,10,155,1103,7,46,25,49,53,74,273,423,3,1580,87,0,2,13,0,1
31951,51,1053,1098,241,925,5,10,155,1103,7,46,25,49,53,74,273,423,3,1580,87,0,2,10,1,1
31952,51,1053,282,202,222,14,2,44,296,8,42,24,43,50,67,250,378,4,1548,86,0,2,10,1,1
31953,38,1508,1098,241,925,5,10,155,1103,7,46,25,49,53,74,273,423,3,1580,87,0,2,1,0,1
31954,53,1075,1098,241,925,5,10,155,1103,7,46,25,49,53,74,273,423,3,1580,87,0,2,14,10,0
31955,53,1075,282,202,222,14,2,44,296,8,42,24,43,50,67,250,378,4,1548,86,0,2,14,10,0
31956,38,1508,1098,241,925,5,10,155,1103,7,46,25,49,53,74,273,423,3,1580,87,0,2,7,5,0
31957,53,1075,1098,241,925,5,10,155,1103,7,46,25,49,53,74,273,423,3,1580,87,0,2,14,0,0
31958,53,1075,282,202,222,14,2,44,296,8,42,24,43,50,67,250,378,4,1548,86,0,2,14,0,0
31959,38,1508,1098,241,925,5,10,155,1103,7,46,25,49,53,74,273,423,3,1580,87,0,2,16,0,0
32006,46,531,647,139,84,35,284,233,682,0,0,0,0,0,0,0,0,0,0,0,0,2,3,1,0
32007,46,532,647,139,84,35,284,233,682,0,0,0,0,0,0,0,0,0,0,0,0,2,4,1,1
32008,21,574,1293,570,1093,25,15,163,1318,10,195,123,241,205,364,1516,2795,6,17273,959,0,2,1,2,1
32009,32,1211,1293,570,1093,25,15,163,1318,10,195,123,241,205,364,1516,2795,6,17273,959,0,2,5,1,1
32010,46,532,647,139,84,35,284,233,682,0,0,0,0,0,0,0,0,0,0,0,0,2,7,2,0
32011,21,574,1293,570,1093,25,15,163,1318,10,195,123,241,205,364,1516,2795,6,17273,959,0,2,1,2,0
32012,32,1211,1293,570,1093,25,15,163,1318,10,195,123,241,205,364,1516,2795,6,17273,959,0,2,5,1,0
32013,46,531,647,139,84,35,284,233,682,0,0,0,0,0,0,0,0,0,0,0,0,2,3,1,1
32014,38,889,386,256,301,16,9,68,402,4,59,35,69,63,104,355,621,2,1453,80,0,2,20,9,1
32015,38,889,264,131,164,11,41,46,275,6,38,22,40,44,62,214,338,3,1068,59,0,2,20,9,1
32016,40,935,386,256,301,16,9,68,402,4,59,35,69,63,104,355,621,2,1453,80,0,2,25,15,1
32017,40,935,264,131,164,11,41,46,275,6,38,22,40,44,62,214,338,3,1068,59,0,2,25,15,1
32018,27,1123,386,256,301,16,9,68,402,4,59,35,69,63,104,355,621,2,1453,80,0,2,44,23,1
32019,40,935,386,256,301,16,9,68,402,4,59,35,69,63,104,355,621,2,1453,80,0,2,29,8,0
32020,40,935,264,131,164,11,41,46,275,6,38,22,40,44,62,214,338,3,1068,59,0,2,29,8,0
32021,27,1123,386,256,301,16,9,68,402,4,59,35,69,63,104,355,621,2,1453,80,0,2,44,23,0
32022,16,491,184,100,137,2,15,30,186,6,38,20,39,44,59,214,322,3,991,55,0,2,1,1,1
32023,16,491,103,65,74,8,5,16,111,7,17,9,17,24,26,89,119,3,417,23,0,2,1,1,1
32024,16,487,184,100,137,2,15,30,186,6,38,20,39,44,59,214,322,3,991,55,0,2,1,1,0
32025,16,487,103,65,74,8,5,16,111,7,17,9,17,24,26,89,119,3,417,23,0,2,1,1,0
32026,11,386,184,100,137,2,15,30,186,6,38,20,39,44,59,214,322,3,991,55,0,2,3,3,0
32027,513,10973,72,33,56,0,4,12,72,1,1,1,1,2,2,0,2,0,1,0,0,2,3,2,1
32028,513,10973,1454,835,1044,76,110,219,1530,17,275,158,296,292,454,2297,3718,9,34017,1889,1,2,3,2,1
32029,76,3610,1338,495,1086,10,64,173,1348,11,122,82,157,133,239,883,1686,7,11934,663,0,2,15,0,1
32030,513,10967,72,33,56,0,4,12,72,1,1,1,1,2,2,0,2,0,1,0,0,2,4,1,0
32031,513,10967,1454,835,1044,76,110,219,1530,17,275,158,296,292,454,2297,3718,9,34017,1889,1,2,4,1,0
32032,32,933,465,148,393,5,8,60,470,4,31,20,31,35,51,161,261,2,523,29,0,2,29,0,0
32033,32,933,16,12,9,0,0,6,16,1,2,1,2,3,3,2,4,0,2,0,0,2,29,0,0
32034,513,10973,72,33,56,0,4,12,72,1,1,1,1,2,2,0,2,0,1,0,0,2,3,2,0
32035,513,10973,1454,835,1044,76,110,219,1530,17,275,158,296,292,454,2297,3718,9,34017,1889,1,2,3,2,0
32036,76,3610,1338,495,1086,10,64,173,1348,11,122,82,157,133,239,883,1686,7,11934,663,0,2,15,0,0
32037,513,10975,72,33,56,0,4,12,72,1,1,1,1,2,2,0,2,0,1,0,0,2,4,1,0
32038,513,10975,1454,835,1044,76,110,219,1530,17,275,158,296,292,454,2297,3718,9,34017,1889,1,2,4,1,0
32041,176,3627,1943,715,1694,26,18,214,1969,12,185,120,237,197,357,1436,2721,7,20915,1161,0,2,5,1,0
32042,176,3627,1168,838,957,57,25,144,1225,19,348,224,416,367,640,3018,5452,11,61921,3440,1,2,5,1,0
32043,65,3364,1943,715,1694,26,18,214,1969,12,185,120,237,197,357,1436,2721,7,20915,1161,0,2,2,2,0
32047,176,3627,1943,715,1694,26,18,214,1969,12,185,120,237,197,357,1436,2721,7,20915,1161,0,2,1,1,0
32048,176,3627,1168,838,957,57,25,144,1225,19,348,224,416,367,640,3018,5452,11,61921,3440,1,2,1,1,0
32059,11,394,184,100,137,2,15,30,186,6,38,20,39,44,59,214,322,3,991,55,0,2,3,2,1
32060,513,10975,72,33,56,0,4,12,72,1,1,1,1,2,2,0,2,0,1,0,0,2,7,3,0
32061,513,10975,1454,835,1044,76,110,219,1530,17,275,158,296,292,454,2297,3718,9,34017,1889,1,2,7,3,0
32070,16,491,184,100,137,2,15,30,186,6,38,20,39,44,59,214,322,3,991,55,0,2,2,2,0
32071,16,491,103,65,74,8,5,16,111,7,17,9,17,24,26,89,119,3,417,23,0,2,2,2,0
32072,11,394,184,100,137,2,15,30,186,6,38,20,39,44,59,214,322,3,991,55,0,2,6,5,0
32073,17,510,184,100,137,2,15,30,186,6,38,20,39,44,59,214,322,3,991,55,0,2,9,5,1
32074,17,510,103,65,74,8,5,16,111,7,17,9,17,24,26,89,119,3,417,23,0,2,9,5,1
32075,12,475,184,100,137,2,15,30,186,6,38,20,39,44,59,214,322,3,991,55,0,2,31,4,1
32076,17,510,184,100,137,2,15,30,186,6,38,20,39,44,59,214,322,3,991,55,0,2,9,5,0
32077,17,510,103,65,74,8,5,16,111,7,17,9,17,24,26,89,119,3,417,23,0,2,9,5,0
32078,12,475,184,100,137,2,15,30,186,6,38,20,39,44,59,214,322,3,991,55,0,2,31,4,0
32148,56,1686,1523,757,1297,19,12,193,1542,12,193,117,230,205,347,1508,2664,7,19053,1058,0,2,54,35,0
32149,56,1686,701,378,504,33,58,109,734,13,110,68,126,123,194,794,1346,7,10027,557,0,2,54,35,0
32150,56,1686,1523,757,1297,19,12,193,1542,12,193,117,230,205,347,1508,2664,7,19053,1058,0,2,3,3,0
32151,56,1686,701,378,504,33,58,109,734,13,110,68,126,123,194,794,1346,7,10027,557,0,2,3,3,0
32152,45,2836,1523,757,1297,19,12,193,1542,12,193,117,230,205,347,1508,2664,7,19053,1058,0,2,87,71,0
32153,58,2876,1523,757,1297,19,12,193,1542,12,193,117,230,205,347,1508,2664,7,19053,1058,0,2,204,166,1
32154,58,2876,1523,757,1297,19,12,193,1542,12,193,117,230,205,347,1508,2664,7,19053,1058,0,2,6,1,1
32155,61,1745,1523,757,1297,19,12,193,1542,12,193,117,230,205,347,1508,2664,7,19053,1058,0,2,42,32,0
32156,61,1745,701,378,504,33,58,109,734,13,110,68,126,123,194,794,1346,7,10027,557,0,2,42,32,0
32157,60,2900,1523,757,1297,19,12,193,1542,12,193,117,230,205,347,1508,2664,7,19053,1058,0,2,6,1,0
32158,61,1734,1523,757,1297,19,12,193,1542,12,193,117,230,205,347,1508,2664,7,19053,1058,0,2,0,1,0
32159,61,1734,701,378,504,33,58,109,734,13,110,68,126,123,194,794,1346,7,10027,557,0,2,0,1,0
32160,64,1801,1523,757,1297,19,12,193,1542,12,193,117,230,205,347,1508,2664,7,19053,1058,0,2,52,34,1
32161,64,1801,701,378,504,33,58,109,734,13,110,68,126,123,194,794,1346,7,10027,557,0,2,52,34,1
32162,64,1790,1523,757,1297,19,12,193,1542,12,193,117,230,205,347,1508,2664,7,19053,1058,0,2,2,2,0
32163,64,1790,701,378,504,33,58,109,734,13,110,68,126,123,194,794,1346,7,10027,557,0,2,2,2,0
32164,65,1814,1523,757,1297,19,12,193,1542,12,193,117,230,205,347,1508,2664,7,19053,1058,0,2,7,3,0
32165,65,1814,701,378,504,33,58,109,734,13,110,68,126,123,194,794,1346,7,10027,557,0,2,7,3,0
32166,61,2932,1523,757,1297,19,12,193,1542,12,193,117,230,205,347,1508,2664,7,19053,1058,0,2,6,2,0
32167,65,1825,1523,757,1297,19,12,193,1542,12,193,117,230,205,347,1508,2664,7,19053,1058,0,2,120,118,1
32168,65,1825,701,378,504,33,58,109,734,13,110,68,126,123,194,794,1346,7,10027,557,0,2,120,118,1
32169,61,2942,1523,757,1297,19,12,193,1542,12,193,117,230,205,347,1508,2664,7,19053,1058,0,2,13,12,1
32170,65,1835,1523,757,1297,19,12,193,1542,12,193,117,230,205,347,1508,2664,7,19053,1058,0,2,3,3,0
32171,65,1835,701,378,504,33,58,109,734,13,110,68,126,123,194,794,1346,7,10027,557,0,2,3,3,0
32172,61,2937,1523,757,1297,19,12,193,1542,12,193,117,230,205,347,1508,2664,7,19053,1058,0,2,1,1,0
32173,67,1895,1523,757,1297,19,12,193,1542,12,193,117,230,205,347,1508,2664,7,19053,1058,0,2,8,0,0
32174,67,1895,701,378,504,33,58,109,734,13,110,68,126,123,194,794,1346,7,10027,557,0,2,8,0,0
32175,62,2941,1523,757,1297,19,12,193,1542,12,193,117,230,205,347,1508,2664,7,19053,1058,0,2,1,1,0
32176,67,1895,1523,757,1297,19,12,193,1542,12,193,117,230,205,347,1508,2664,7,19053,1058,0,2,14,14,1
32177,67,1895,701,378,504,33,58,109,734,13,110,68,126,123,194,794,1346,7,10027,557,0,2,14,14,1
32178,67,1895,1523,757,1297,19,12,193,1542,12,193,117,230,205,347,1508,2664,7,19053,1058,0,2,1,2,0
32179,67,1895,701,378,504,33,58,109,734,13,110,68,126,123,194,794,1346,7,10027,557,0,2,1,2,0
32180,67,1895,1523,757,1297,19,12,193,1542,12,193,117,230,205,347,1508,2664,7,19053,1058,0,2,7,7,0
32181,67,1895,701,378,504,33,58,109,734,13,110,68,126,123,194,794,1346,7,10027,557,0,2,7,7,0
32182,63,2994,1523,757,1297,19,12,193,1542,12,193,117,230,205,347,1508,2664,7,19053,1058,0,2,11,0,1
32183,67,1914,1523,757,1297,19,12,193,1542,12,193,117,230,205,347,1508,2664,7,19053,1058,0,2,13,7,1
32184,67,1914,701,378,504,33,58,109,734,13,110,68,126,123,194,794,1346,7,10027,557,0,2,13,7,1
32185,64,3043,1523,757,1297,19,12,193,1542,12,193,117,230,205,347,1508,2664,7,19053,1058,0,2,14,2,1
32186,67,1914,1523,757,1297,19,12,193,1542,12,193,117,230,205,347,1508,2664,7,19053,1058,0,2,213,148,0
32187,67,1914,701,378,504,33,58,109,734,13,110,68,126,123,194,794,1346,7,10027,557,0,2,213,148,0
32188,64,3043,1523,757,1297,19,12,193,1542,12,193,117,230,205,347,1508,2664,7,19053,1058,0,2,239,147,0
32189,116,2530,1043,504,840,53,9,147,1096,9,180,112,198,189,310,1377,2344,4,11604,644,0,2,5,1,1
32190,116,2530,383,288,292,26,6,62,409,11,65,38,67,76,105,429,656,5,3719,206,0,2,5,1,1
32191,95,1752,1178,367,1042,6,15,115,1184,9,94,51,95,103,146,644,976,4,4439,246,0,2,3,0,1
32192,95,1752,177,108,140,8,0,27,185,6,30,16,32,36,48,162,248,3,794,44,0,2,3,0,1
32193,180,3684,1943,715,1694,26,18,214,1969,12,185,120,237,197,357,1436,2721,7,20915,1161,0,2,16,1,1
32194,180,3684,1168,838,957,57,25,144,1225,19,348,224,416,367,640,3018,5452,11,61921,3440,1,2,16,1,1
32209,513,10975,72,33,56,0,4,12,72,1,1,1,1,2,2,0,2,0,1,0,0,2,67,14,0
32210,513,10975,1454,835,1044,76,110,219,1530,17,275,158,296,292,454,2297,3718,9,34017,1889,1,2,67,14,0
32211,41,944,386,256,301,16,9,68,402,4,59,35,69,63,104,355,621,2,1453,80,0,2,29,8,0
32212,41,944,264,131,164,11,41,46,275,6,38,22,40,44,62,214,338,3,1068,59,0,2,29,8,0
32215,176,3627,1943,715,1694,26,18,214,1969,12,185,120,237,197,357,1436,2721,7,20915,1161,0,2,7,2,0
32216,176,3627,1168,838,957,57,25,144,1225,19,348,224,416,367,640,3018,5452,11,61921,3440,1,2,7,2,0
32219,76,3610,1338,495,1086,10,64,173,1348,11,122,82,157,133,239,883,1686,7,11934,663,0,2,121,0,0
32225,12,475,184,100,137,2,15,30,186,6,38,20,39,44,59,214,322,3,991,55,0,2,37,9,0
32226,29,1180,386,256,301,16,9,68,402,4,59,35,69,63,104,355,621,2,1453,80,0,2,43,23,0
32230,29,1184,386,256,301,16,9,68,402,4,59,35,69,63,104,355,621,2,1453,80,0,2,2,2,1
32231,40,938,386,256,301,16,9,68,402,4,59,35,69,63,104,355,621,2,1453,80,0,2,1,1,1
32232,40,938,264,131,164,11,41,46,275,6,38,22,40,44,62,214,338,3,1068,59,0,2,1,1,1
32233,27,1135,386,256,301,16,9,68,402,4,59,35,69,63,104,355,621,2,1453,80,0,2,5,4,1
32234,68,3477,1943,715,1694,26,18,214,1969,12,185,120,237,197,357,1436,2721,7,20915,1161,0,2,25,0,0
32235,68,3495,1943,715,1694,26,18,214,1969,12,185,120,237,197,357,1436,2721,7,20915,1161,0,2,2,0,0
32236,40,938,386,256,301,16,9,68,402,4,59,35,69,63,104,355,621,2,1453,80,0,2,1,1,0
32237,40,938,264,131,164,11,41,46,275,6,38,22,40,44,62,214,338,3,1068,59,0,2,1,1,0
32238,27,1135,386,256,301,16,9,68,402,4,59,35,69,63,104,355,621,2,1453,80,0,2,5,4,0
32239,116,2530,1043,504,840,53,9,147,1096,9,180,112,198,189,310,1377,2344,4,11604,644,0,2,5,1,0
32240,116,2530,383,288,292,26,6,62,409,11,65,38,67,76,105,429,656,5,3719,206,0,2,5,1,0
32241,95,1752,1178,367,1042,6,15,115,1184,9,94,51,95,103,146,644,976,4,4439,246,0,2,3,0,0
32242,95,1752,177,108,140,8,0,27,185,6,30,16,32,36,48,162,248,3,794,44,0,2,3,0,0
32243,180,3684,1943,715,1694,26,18,214,1969,12,185,120,237,197,357,1436,2721,7,20915,1161,0,2,16,1,0
32244,180,3684,1168,838,957,57,25,144,1225,19,348,224,416,367,640,3018,5452,11,61921,3440,1,2,16,1,0
32245,68,3495,1943,715,1694,26,18,214,1969,12,185,120,237,197,357,1436,2721,7,20915,1161,0,2,27,0,0
32246,513,10978,72,33,56,0,4,12,72,1,1,1,1,2,2,0,2,0,1,0,0,2,1,1,0
32247,513,10978,1454,835,1044,76,110,219,1530,17,275,158,296,292,454,2297,3718,9,34017,1889,1,2,1,1,0
32266,116,2530,1043,504,840,53,9,147,1096,9,180,112,198,189,310,1377,2344,4,11604,644,0,2,1,1,0
32267,116,2530,383,288,292,26,6,62,409,11,65,38,67,76,105,429,656,5,3719,206,0,2,1,1,0
32268,181,3706,1943,715,1694,26,18,214,1969,12,185,120,237,197,357,1436,2721,7,20915,1161,0,2,7,2,0
32269,181,3706,1168,838,957,57,25,144,1225,19,348,224,416,367,640,3018,5452,11,61921,3440,1,2,7,2,0
32279,29,1184,386,256,301,16,9,68,402,4,59,35,69,63,104,355,621,2,1453,80,0,2,45,25,0
32280,68,3495,1943,715,1694,26,18,214,1969,12,185,120,237,197,357,1436,2721,7,20915,1161,0,2,2,2,0
32283,41,947,386,256,301,16,9,68,402,4,59,35,69,63,104,355,621,2,1453,80,0,2,1,1,0
32284,41,947,264,131,164,11,41,46,275,6,38,22,40,44,62,214,338,3,1068,59,0,2,1,1,0
32285,29,1196,386,256,301,16,9,68,402,4,59,35,69,63,104,355,621,2,1453,80,0,2,5,4,0
32286,77,3648,1338,495,1086,10,64,173,1348,11,122,82,157,133,239,883,1686,7,11934,663,0,2,16,0,1
32287,77,3648,1338,495,1086,10,64,173,1348,11,122,82,157,133,239,883,1686,7,11934,663,0,2,1,1,0
32304,41,947,386,256,301,16,9,68,402,4,59,35,69,63,104,355,621,2,1453,80,0,2,29,8,0
32305,41,947,264,131,164,11,41,46,275,6,38,22,40,44,62,214,338,3,1068,59,0,2,29,8,0
32319,29,1196,386,256,301,16,9,68,402,4,59,35,69,63,104,355,621,2,1453,80,0,2,46,25,0
32323,77,3658,1338,495,1086,10,64,173,1348,11,122,82,157,133,239,883,1686,7,11934,663,0,2,1,0,0
32324,77,3658,1338,495,1086,10,64,173,1348,11,122,82,157,133,239,883,1686,7,11934,663,0,2,1,1,0
32325,77,3659,1338,495,1086,10,64,173,1348,11,122,82,157,133,239,883,1686,7,11934,663,0,2,6,0,0
32328,77,3659,1338,495,1086,10,64,173,1348,11,122,82,157,133,239,883,1686,7,11934,663,0,2,23,0,0
32381,46,531,647,139,84,35,284,233,682,0,0,0,0,0,0,0,0,0,0,0,0,2,2,3,0
32383,69,1963,1523,757,1297,19,12,193,1542,12,193,117,230,205,347,1508,2664,7,19053,1058,0,2,10,6,0
32384,69,1963,701,378,504,33,58,109,734,13,110,68,126,123,194,794,1346,7,10027,557,0,2,10,6,0
32385,65,3107,1523,757,1297,19,12,193,1542,12,193,117,230,205,347,1508,2664,7,19053,1058,0,2,41,4,0
32386,9,220,19,8,11,5,0,4,24,2,5,3,6,7,9,13,25,1,30,1,0,2,0,3,1
32387,9,220,102,59,69,5,3,24,107,6,22,15,28,28,43,113,206,3,789,43,0,2,0,3,1
32388,9,220,106,40,36,3,49,17,109,8,17,13,23,25,36,93,167,5,904,50,0,2,0,3,1
32389,69,2867,1289,550,1043,56,32,155,1345,10,167,93,185,177,278,1266,2075,5,11498,638,0,2,0,3,1
32390,23,594,102,59,69,5,3,24,107,6,22,15,28,28,43,113,206,3,789,43,0,2,0,4,1
32391,74,2661,1450,624,1228,12,26,181,1462,14,306,186,354,320,540,2580,4493,8,36391,2021,1,2,1,8,1
32392,63,2582,1020,354,843,12,15,144,1032,8,134,77,144,142,221,970,1580,4,6792,377,0,2,0,2,1
32393,21,647,424,94,331,4,0,89,428,1,5,5,5,6,10,11,25,0,12,0,0,2,0,1,1
32394,38,2201,334,251,279,10,4,40,344,5,127,74,143,132,217,899,1528,2,4303,239,0,2,0,6,1
32395,9,220,19,8,11,5,0,4,24,2,5,3,6,7,9,13,25,1,30,1,0,2,0,3,0
32396,9,220,102,59,69,5,3,24,107,6,22,15,28,28,43,113,206,3,789,43,0,2,0,3,0
32397,9,220,106,40,36,3,49,17,109,8,17,13,23,25,36,93,167,5,904,50,0,2,0,3,0
32398,69,2867,1289,550,1043,56,32,155,1345,10,167,93,185,177,278,1266,2075,5,11498,638,0,2,0,3,0
32399,23,594,102,59,69,5,3,24,107,6,22,15,28,28,43,113,206,3,789,43,0,2,0,4,0
32400,74,2661,1450,624,1228,12,26,181,1462,14,306,186,354,320,540,2580,4493,8,36391,2021,1,2,1,8,0
32401,63,2582,1020,354,843,12,15,144,1032,8,134,77,144,142,221,970,1580,4,6792,377,0,2,0,2,0
32402,21,647,424,94,331,4,0,89,428,1,5,5,5,6,10,11,25,0,12,0,0,2,0,1,0
32403,38,2201,334,251,279,10,4,40,344,5,127,74,143,132,217,899,1528,2,4303,239,0,2,0,6,0
32404,68,3173,1523,757,1297,19,12,193,1542,12,193,117,230,205,347,1508,2664,7,19053,1058,0,2,27,10,0
32405,68,3179,1523,757,1297,19,12,193,1542,12,193,117,230,205,347,1508,2664,7,19053,1058,0,2,3,0,0
32406,114,2289,1513,682,1277,25,13,200,1538,11,199,116,219,210,335,1557,2584,6,15641,868,0,2,8,0,0
32407,114,2289,819,519,539,24,98,155,843,15,96,57,106,111,163,690,1107,8,9171,509,0,2,8,0,0
32408,114,2287,1513,682,1277,25,13,200,1538,11,199,116,219,210,335,1557,2584,6,15641,868,0,2,26,8,1
32409,114,2287,819,519,539,24,98,155,843,15,96,57,106,111,163,690,1107,8,9171,509,0,2,26,8,1
32410,115,2299,1513,682,1277,25,13,200,1538,11,199,116,219,210,335,1557,2584,6,15641,868,0,2,5,3,1
32411,115,2299,819,519,539,24,98,155,843,15,96,57,106,111,163,690,1107,8,9171,509,0,2,5,3,1
32412,115,2299,1513,682,1277,25,13,200,1538,11,199,116,219,210,335,1557,2584,6,15641,868,0,2,1,1,0
32413,115,2299,819,519,539,24,98,155,843,15,96,57,106,111,163,690,1107,8,9171,509,0,2,1,1,0
32414,115,2299,1513,682,1277,25,13,200,1538,11,199,116,219,210,335,1557,2584,6,15641,868,0,2,28,0,0
32415,115,2299,819,519,539,24,98,155,843,15,96,57,106,111,163,690,1107,8,9171,509,0,2,28,0,0
32416,48,975,447,308,343,6,5,95,453,7,96,59,111,103,170,651,1136,4,4600,255,0,2,21,1,1
32417,48,975,322,174,179,16,74,51,338,10,41,26,46,51,72,252,408,5,2291,127,0,2,21,1,1
32418,36,1591,447,308,343,6,5,95,453,7,96,59,111,103,170,651,1136,4,4600,255,0,2,17,0,1
32419,48,975,447,308,343,6,5,95,453,7,96,59,111,103,170,651,1136,4,4600,255,0,2,21,1,0
32420,48,975,322,174,179,16,74,51,338,10,41,26,46,51,72,252,408,5,2291,127,0,2,21,1,0
32421,36,1591,447,308,343,6,5,95,453,7,96,59,111,103,170,651,1136,4,4600,255,0,2,17,0,0
32422,49,1414,1455,414,1257,16,76,112,1471,5,41,23,46,46,69,231,381,2,1069,59,0,2,39,21,1
32423,49,1414,669,365,481,22,61,110,691,15,103,63,122,118,185,747,1273,8,11311,628,0,2,39,21,1
32424,47,2014,1455,414,1257,16,76,112,1471,5,41,23,46,46,69,231,381,2,1069,59,0,2,46,1,1
32425,48,973,447,308,343,6,5,95,453,7,96,59,111,103,170,651,1136,4,4600,255,0,2,6,7,1
32426,48,973,322,174,179,16,74,51,338,10,41,26,46,51,72,252,408,5,2291,127,0,2,6,7,1
32427,48,1368,1455,414,1257,16,76,112,1471,5,41,23,46,46,69,231,381,2,1069,59,0,2,12,3,0
32428,48,1368,669,365,481,22,61,110,691,15,103,63,122,118,185,747,1273,8,11311,628,0,2,12,3,0
32429,49,1371,1455,414,1257,16,76,112,1471,5,41,23,46,46,69,231,381,2,1069,59,0,2,2,2,1
32430,49,1371,669,365,481,22,61,110,691,15,103,63,122,118,185,747,1273,8,11311,628,0,2,2,2,1
32431,46,1984,1455,414,1257,16,76,112,1471,5,41,23,46,46,69,231,381,2,1069,59,0,2,32,2,1
32432,49,1371,1455,414,1257,16,76,112,1471,5,41,23,46,46,69,231,381,2,1069,59,0,2,12,3,0
32433,49,1371,669,365,481,22,61,110,691,15,103,63,122,118,185,747,1273,8,11311,628,0,2,12,3,0
32434,46,1984,1455,414,1257,16,76,112,1471,5,41,23,46,46,69,231,381,2,1069,59,0,2,32,2,0
32435,48,973,447,308,343,6,5,95,453,7,96,59,111,103,170,651,1136,4,4600,255,0,2,6,7,0
32436,48,973,322,174,179,16,74,51,338,10,41,26,46,51,72,252,408,5,2291,127,0,2,6,7,0
32437,53,1451,1455,414,1257,16,76,112,1471,5,41,23,46,46,69,231,381,2,1069,59,0,2,39,21,0
32438,53,1451,669,365,481,22,61,110,691,15,103,63,122,118,185,747,1273,8,11311,628,0,2,39,21,0
32439,49,2131,1455,414,1257,16,76,112,1471,5,41,23,46,46,69,231,381,2,1069,59,0,2,45,0,0
32442,46,532,647,139,84,35,284,233,682,0,0,0,0,0,0,0,0,0,0,0,0,2,2,3,0
32445,48,973,447,308,343,6,5,95,453,7,96,59,111,103,170,651,1136,4,4600,255,0,2,27,8,0
32446,48,973,322,174,179,16,74,51,338,10,41,26,46,51,72,252,408,5,2291,127,0,2,27,8,0
32447,68,3179,1523,757,1297,19,12,193,1542,12,193,117,230,205,347,1508,2664,7,19053,1058,0,2,63,6,0
32449,176,3627,1943,715,1694,26,18,214,1969,12,185,120,237,197,357,1436,2721,7,20915,1161,0,2,1,1,1
32450,176,3627,1168,838,957,57,25,144,1225,19,348,224,416,367,640,3018,5452,11,61921,3440,1,2,1,1,1
32451,66,3398,1943,715,1694,26,18,214,1969,12,185,120,237,197,357,1436,2721,7,20915,1161,0,2,17,0,1
32454,66,3398,1943,715,1694,26,18,214,1969,12,185,120,237,197,357,1436,2721,7,20915,1161,0,2,17,0,0
32455,181,3706,1943,715,1694,26,18,214,1969,12,185,120,237,197,357,1436,2721,7,20915,1161,0,2,1,2,0
32456,181,3706,1168,838,957,57,25,144,1225,19,348,224,416,367,640,3018,5452,11,61921,3440,1,2,1,2,0
32457,69,3529,1943,715,1694,26,18,214,1969,12,185,120,237,197,357,1436,2721,7,20915,1161,0,2,17,0,0
32458,45,1324,1455,414,1257,16,76,112,1471,5,41,23,46,46,69,231,381,2,1069,59,0,2,7,7,1
32459,45,1324,669,365,481,22,61,110,691,15,103,63,122,118,185,747,1273,8,11311,628,0,2,7,7,1
32460,46,1976,1455,414,1257,16,76,112,1471,5,41,23,46,46,69,231,381,2,1069,59,0,2,59,1,1
32461,21,592,1293,570,1093,25,15,163,1318,10,195,123,241,205,364,1516,2795,6,17273,959,0,2,3,1,1
32462,34,1287,1293,570,1093,25,15,163,1318,10,195,123,241,205,364,1516,2795,6,17273,959,0,2,16,0,1
32463,21,592,1293,570,1093,25,15,163,1318,10,195,123,241,205,364,1516,2795,6,17273,959,0,2,3,1,0
32464,34,1287,1293,570,1093,25,15,163,1318,10,195,123,241,205,364,1516,2795,6,17273,959,0,2,16,0,0
32465,45,1324,1455,414,1257,16,76,112,1471,5,41,23,46,46,69,231,381,2,1069,59,0,2,7,7,0
32466,45,1324,669,365,481,22,61,110,691,15,103,63,122,118,185,747,1273,8,11311,628,0,2,7,7,0
32467,46,1976,1455,414,1257,16,76,112,1471,5,41,23,46,46,69,231,381,2,1069,59,0,2,59,1,0
32470,36,711,2,2,2,0,0,0,2,0,0,0,0,0,0,0,0,0,0,0,0,2,11,2,1
32484,36,711,99,48,90,1,3,5,100,0,0,0,0,0,0,0,0,0,0,0,0,2,11,2,1
32485,36,711,8,5,5,2,0,1,10,0,0,0,0,0,0,0,0,0,0,0,0,2,11,2,1
32486,36,711,1217,716,841,84,126,174,1301,14,185,118,215,199,333,1446,2542,8,20687,1149,0,2,11,2,1
32487,36,711,160,89,115,0,13,31,160,7,15,11,17,22,28,78,124,3,495,27,0,2,11,2,1
32488,36,711,10,10,9,9,0,0,19,0,0,0,0,0,0,0,0,0,0,0,0,2,11,2,1
32489,36,711,173,84,99,8,29,36,181,5,12,7,13,17,20,54,81,2,221,12,0,2,11,2,1
32490,36,711,3,1,1,3,0,0,6,0,0,0,0,0,0,0,0,0,0,0,0,2,11,2,1
32491,74,2699,1450,624,1228,12,26,181,1462,14,306,186,354,320,540,2580,4493,8,36391,2021,1,2,8,1,1
32494,36,711,2,2,2,0,0,0,2,0,0,0,0,0,0,0,0,0,0,0,0,2,11,2,0
32508,36,711,99,48,90,1,3,5,100,0,0,0,0,0,0,0,0,0,0,0,0,2,11,2,0
32509,36,711,8,5,5,2,0,1,10,0,0,0,0,0,0,0,0,0,0,0,0,2,11,2,0
32510,36,711,1217,716,841,84,126,174,1301,14,185,118,215,199,333,1446,2542,8,20687,1149,0,2,11,2,0
32511,36,711,160,89,115,0,13,31,160,7,15,11,17,22,28,78,124,3,495,27,0,2,11,2,0
32512,36,711,10,10,9,9,0,0,19,0,0,0,0,0,0,0,0,0,0,0,0,2,11,2,0
32513,36,711,173,84,99,8,29,36,181,5,12,7,13,17,20,54,81,2,221,12,0,2,11,2,0
32514,36,711,3,1,1,3,0,0,6,0,0,0,0,0,0,0,0,0,0,0,0,2,11,2,0
32515,74,2699,1450,624,1228,12,26,181,1462,14,306,186,354,320,540,2580,4493,8,36391,2021,1,2,8,1,0
32518,33,678,2,2,2,0,0,0,2,0,0,0,0,0,0,0,0,0,0,0,0,2,2,2,1
32532,33,678,99,48,90,1,3,5,100,0,0,0,0,0,0,0,0,0,0,0,0,2,2,2,1
32533,33,678,8,5,5,2,0,1,10,0,0,0,0,0,0,0,0,0,0,0,0,2,2,2,1
32534,33,678,1217,716,841,84,126,174,1301,14,185,118,215,199,333,1446,2542,8,20687,1149,0,2,2,2,1
32535,33,678,160,89,115,0,13,31,160,7,15,11,17,22,28,78,124,3,495,27,0,2,2,2,1
32536,33,678,10,10,9,9,0,0,19,0,0,0,0,0,0,0,0,0,0,0,0,2,2,2,1
32537,33,678,173,84,99,8,29,36,181,5,12,7,13,17,20,54,81,2,221,12,0,2,2,2,1
32538,33,678,3,1,1,3,0,0,6,0,0,0,0,0,0,0,0,0,0,0,0,2,2,2,1
32539,90,1940,477,336,357,30,23,73,507,16,194,134,250,210,384,1538,2962,10,30538,1696,0,2,3,4,1
32540,513,10978,72,33,56,0,4,12,72,1,1,1,1,2,2,0,2,0,1,0,0,2,6,4,1
32541,513,10978,1454,835,1044,76,110,219,1530,17,275,158,296,292,454,2297,3718,9,34017,1889,1,2,6,4,1
32542,53,1075,1098,241,925,5,10,155,1103,7,46,25,49,53,74,273,423,3,1580,87,0,2,4,3,1
32543,53,1075,282,202,222,14,2,44,296,8,42,24,43,50,67,250,378,4,1548,86,0,2,4,3,1
32546,33,678,2,2,2,0,0,0,2,0,0,0,0,0,0,0,0,0,0,0,0,2,2,2,0
32560,33,678,99,48,90,1,3,5,100,0,0,0,0,0,0,0,0,0,0,0,0,2,2,2,0
32561,33,678,8,5,5,2,0,1,10,0,0,0,0,0,0,0,0,0,0,0,0,2,2,2,0
32562,33,678,1217,716,841,84,126,174,1301,14,185,118,215,199,333,1446,2542,8,20687,1149,0,2,2,2,0
32563,33,678,160,89,115,0,13,31,160,7,15,11,17,22,28,78,124,3,495,27,0,2,2,2,0
32564,33,678,10,10,9,9,0,0,19,0,0,0,0,0,0,0,0,0,0,0,0,2,2,2,0
32565,33,678,173,84,99,8,29,36,181,5,12,7,13,17,20,54,81,2,221,12,0,2,2,2,0
32566,33,678,3,1,1,3,0,0,6,0,0,0,0,0,0,0,0,0,0,0,0,2,2,2,0
32567,90,1940,477,336,357,30,23,73,507,16,194,134,250,210,384,1538,2962,10,30538,1696,0,2,3,4,0
32568,513,10978,72,33,56,0,4,12,72,1,1,1,1,2,2,0,2,0,1,0,0,2,6,4,0
32569,513,10978,1454,835,1044,76,110,219,1530,17,275,158,296,292,454,2297,3718,9,34017,1889,1,2,6,4,0
32570,53,1075,1098,241,925,5,10,155,1103,7,46,25,49,53,74,273,423,3,1580,87,0,2,4,3,0
32571,53,1075,282,202,222,14,2,44,296,8,42,24,43,50,67,250,378,4,1548,86,0,2,4,3,0
32572,69,1969,1523,757,1297,19,12,193,1542,12,193,117,230,205,347,1508,2664,7,19053,1058,0,2,1,0,1
32573,69,1969,701,378,504,33,58,109,734,13,110,68,126,123,194,794,1346,7,10027,557,0,2,1,0,1
32574,70,3287,1523,757,1297,19,12,193,1542,12,193,117,230,205,347,1508,2664,7,19053,1058,0,2,29,0,1
32575,69,1969,1523,757,1297,19,12,193,1542,12,193,117,230,205,347,1508,2664,7,19053,1058,0,2,1,0,0
32576,69,1969,701,378,504,33,58,109,734,13,110,68,126,123,194,794,1346,7,10027,557,0,2,1,0,0
32577,70,3287,1523,757,1297,19,12,193,1542,12,193,117,230,205,347,1508,2664,7,19053,1058,0,2,29,0,0
32649,36,711,2,2,2,0,0,0,2,0,0,0,0,0,0,0,0,0,0,0,0,2,3,3,1
32663,36,711,99,48,90,1,3,5,100,0,0,0,0,0,0,0,0,0,0,0,0,2,3,3,1
32664,36,711,8,5,5,2,0,1,10,0,0,0,0,0,0,0,0,0,0,0,0,2,3,3,1
32665,36,711,1217,716,841,84,126,174,1301,14,185,118,215,199,333,1446,2542,8,20687,1149,0,2,3,3,1
32666,36,711,160,89,115,0,13,31,160,7,15,11,17,22,28,78,124,3,495,27,0,2,3,3,1
32667,36,711,10,10,9,9,0,0,19,0,0,0,0,0,0,0,0,0,0,0,0,2,3,3,1
32668,36,711,173,84,99,8,29,36,181,5,12,7,13,17,20,54,81,2,221,12,0,2,3,3,1
32669,36,711,3,1,1,3,0,0,6,0,0,0,0,0,0,0,0,0,0,0,0,2,3,3,1
32671,53,1441,1455,414,1257,16,76,112,1471,5,41,23,46,46,69,231,381,2,1069,59,0,2,7,7,1
32672,53,1441,669,365,481,22,61,110,691,15,103,63,122,118,185,747,1273,8,11311,628,0,2,7,7,1
32675,21,594,1293,570,1093,25,15,163,1318,10,195,123,241,205,364,1516,2795,6,17273,959,0,2,3,1,1
32680,51,2240,1455,414,1257,16,76,112,1471,5,41,23,46,46,69,231,381,2,1069,59,0,2,58,0,1
32685,36,711,2,2,2,0,0,0,2,0,0,0,0,0,0,0,0,0,0,0,0,2,3,3,0
32699,36,711,99,48,90,1,3,5,100,0,0,0,0,0,0,0,0,0,0,0,0,2,3,3,0
32700,36,711,8,5,5,2,0,1,10,0,0,0,0,0,0,0,0,0,0,0,0,2,3,3,0
32701,36,711,1217,716,841,84,126,174,1301,14,185,118,215,199,333,1446,2542,8,20687,1149,0,2,3,3,0
32702,36,711,160,89,115,0,13,31,160,7,15,11,17,22,28,78,124,3,495,27,0,2,3,3,0
32703,36,711,10,10,9,9,0,0,19,0,0,0,0,0,0,0,0,0,0,0,0,2,3,3,0
32704,36,711,173,84,99,8,29,36,181,5,12,7,13,17,20,54,81,2,221,12,0,2,3,3,0
32705,36,711,3,1,1,3,0,0,6,0,0,0,0,0,0,0,0,0,0,0,0,2,3,3,0
32707,53,1441,1455,414,1257,16,76,112,1471,5,41,23,46,46,69,231,381,2,1069,59,0,2,7,7,0
32708,53,1441,669,365,481,22,61,110,691,15,103,63,122,118,185,747,1273,8,11311,628,0,2,7,7,0
32711,21,594,1293,570,1093,25,15,163,1318,10,195,123,241,205,364,1516,2795,6,17273,959,0,2,3,1,0
32716,51,2240,1455,414,1257,16,76,112,1471,5,41,23,46,46,69,231,381,2,1069,59,0,2,58,0,0
32719,48,973,447,308,343,6,5,95,453,7,96,59,111,103,170,651,1136,4,4600,255,0,2,7,7,0
32720,48,973,322,174,179,16,74,51,338,10,41,26,46,51,72,252,408,5,2291,127,0,2,7,7,0
32721,36,1591,447,308,343,6,5,95,453,7,96,59,111,103,170,651,1136,4,4600,255,0,2,27,5,0
32722,45,912,447,308,343,6,5,95,453,7,96,59,111,103,170,651,1136,4,4600,255,0,2,37,40,1
32723,45,912,322,174,179,16,74,51,338,10,41,26,46,51,72,252,408,5,2291,127,0,2,37,40,1
32724,38,1622,447,308,343,6,5,95,453,7,96,59,111,103,170,651,1136,4,4600,255,0,2,8,0,1
32725,46,940,447,308,343,6,5,95,453,7,96,59,111,103,170,651,1136,4,4600,255,0,2,15,9,1
32726,46,940,322,174,179,16,74,51,338,10,41,26,46,51,72,252,408,5,2291,127,0,2,15,9,1
32727,38,1614,447,308,343,6,5,95,453,7,96,59,111,103,170,651,1136,4,4600,255,0,2,3,3,1
32728,46,938,447,308,343,6,5,95,453,7,96,59,111,103,170,651,1136,4,4600,255,0,2,0,1,0
32729,46,938,322,174,179,16,74,51,338,10,41,26,46,51,72,252,408,5,2291,127,0,2,0,1,0
32730,46,939,447,308,343,6,5,95,453,7,96,59,111,103,170,651,1136,4,4600,255,0,2,2,1,0
32731,46,939,322,174,179,16,74,51,338,10,41,26,46,51,72,252,408,5,2291,127,0,2,2,1,0
32732,46,943,447,308,343,6,5,95,453,7,96,59,111,103,170,651,1136,4,4600,255,0,2,17,12,0
32733,46,943,322,174,179,16,74,51,338,10,41,26,46,51,72,252,408,5,2291,127,0,2,17,12,0
32734,46,943,447,308,343,6,5,95,453,7,96,59,111,103,170,651,1136,4,4600,255,0,2,54,46,0
32735,46,943,322,174,179,16,74,51,338,10,41,26,46,51,72,252,408,5,2291,127,0,2,54,46,0
32736,38,1614,447,308,343,6,5,95,453,7,96,59,111,103,170,651,1136,4,4600,255,0,2,37,7,0
32829,19,527,1450,624,1228,12,26,181,1462,14,306,186,354,320,540,2580,4493,8,36391,2021,1,0,96,0,1
32830,199,4191,182,127,129,0,0,53,182,5,39,21,42,44,63,217,343,2,926,51,0,0,795,0,1
32831,199,4191,1165,710,800,67,119,181,1232,18,243,153,282,261,435,2000,3492,10,36473,2026,1,0,795,0,1
32832,100,2140,773,419,590,28,0,166,801,10,204,113,217,214,330,1598,2554,5,13587,754,0,0,421,0,1
32833,100,2140,421,273,302,44,34,57,465,17,81,59,107,98,166,583,1098,11,12329,684,0,0,421,0,1
32834,90,1944,477,336,357,30,23,73,507,16,194,134,250,210,384,1538,2962,10,30538,1696,0,2,2,1,1
32835,298,6082,1457,730,1242,11,6,188,1468,10,292,166,329,302,495,2424,4078,5,22973,1276,1,2,3,2,1
32836,298,6082,74,35,59,1,0,14,75,3,14,7,14,17,21,58,85,1,128,7,0,2,3,2,1
32837,298,6082,245,125,200,5,7,34,250,7,30,17,34,37,51,166,265,3,1053,58,0,2,3,2,1
32838,53,1439,1455,414,1257,16,76,112,1471,5,41,23,46,46,69,231,381,2,1069,59,0,2,7,3,1
32839,53,1439,669,365,481,22,61,110,691,15,103,63,122,118,185,747,1273,8,11311,628,0,2,7,3,1
32840,172,3987,77,34,69,0,0,8,77,3,24,16,29,27,45,114,213,1,387,21,0,2,8,4,1
32841,172,3987,712,438,573,51,9,84,763,14,102,71,128,116,199,733,1364,8,11988,666,0,2,8,4,1
32842,219,4866,722,423,573,19,0,135,741,12,172,101,199,184,300,1320,2257,6,15668,870,0,2,12,11,1
32843,219,4866,1508,847,911,44,250,301,1552,14,148,88,169,162,257,1120,1886,7,15077,837,0,2,12,11,1
32844,513,10978,72,33,56,0,4,12,72,1,1,1,1,2,2,0,2,0,1,0,0,2,36,34,1
32845,513,10978,1454,835,1044,76,110,219,1530,17,275,158,296,292,454,2297,3718,9,34017,1889,1,2,36,34,1
32846,41,951,386,256,301,16,9,68,402,4,59,35,69,63,104,355,621,2,1453,80,0,2,3,1,1
32847,41,951,264,131,164,11,41,46,275,6,38,22,40,44,62,214,338,3,1068,59,0,2,3,1,1
32848,116,2524,1043,504,840,53,9,147,1096,9,180,112,198,189,310,1377,2344,4,11604,644,0,2,4,3,1
32849,116,2524,383,288,292,26,6,62,409,11,65,38,67,76,105,429,656,5,3719,206,0,2,4,3,1
32850,95,1756,1178,367,1042,6,15,115,1184,9,94,51,95,103,146,644,976,4,4439,246,0,2,2,3,1
32851,95,1756,177,108,140,8,0,27,185,6,30,16,32,36,48,162,248,3,794,44,0,2,2,3,1
32852,53,1077,1098,241,925,5,10,155,1103,7,46,25,49,53,74,273,423,3,1580,87,0,2,5,6,1
32853,53,1077,282,202,222,14,2,44,296,8,42,24,43,50,67,250,378,4,1548,86,0,2,5,6,1
32854,60,1074,282,196,195,3,0,86,285,8,130,71,141,138,212,936,1507,4,6538,363,0,2,2,1,1
32856,20,619,42,7,35,4,0,5,46,1,2,1,2,3,3,2,4,0,2,0,0,2,1,1,1
32857,20,619,11,6,10,0,0,1,11,2,4,2,4,6,6,10,15,1,15,0,0,2,1,1,1
32858,69,2871,1289,550,1043,56,32,155,1345,10,167,93,185,177,278,1266,2075,5,11498,638,0,2,5,2,1
32859,33,992,182,127,129,0,0,53,182,5,39,21,42,44,63,217,343,2,926,51,0,0,163,0,1
32860,118,5254,1392,870,1177,35,17,170,1427,14,494,280,531,508,811,4473,7289,7,54850,3047,2,0,911,0,1
32861,92,2943,773,419,590,28,0,166,801,10,204,113,217,214,330,1598,2554,5,13587,754,0,0,657,0,1
32862,77,3663,1338,495,1086,10,64,173,1348,11,122,82,157,133,239,883,1686,7,11934,663,0,2,12,9,1
32863,140,6182,139,89,101,2,0,35,141,7,54,34,62,61,96,330,569,4,2287,127,0,2,18,14,1
32864,140,6182,7,5,5,0,0,2,7,1,2,1,2,3,3,2,4,0,2,0,0,2,18,14,1
32865,32,933,465,148,393,5,8,60,470,4,31,20,31,35,51,161,261,2,523,29,0,2,2,1,1
32866,32,933,16,12,9,0,0,6,16,1,2,1,2,3,3,2,4,0,2,0,0,2,2,1,1
32867,81,4399,1782,648,1425,9,47,279,1791,8,171,97,189,179,286,1292,2140,4,9462,525,0,2,5,3,1
32868,11,230,256,139,192,9,7,47,265,4,23,12,24,27,36,112,171,2,357,19,0,2,2,1,1
32869,74,2703,1450,624,1228,12,26,181,1462,14,306,186,354,320,540,2580,4493,8,36391,2021,1,2,4,2,1
32870,135,3522,1660,832,1314,41,38,274,1701,20,312,209,395,332,604,2671,5058,12,64042,3557,1,2,4,3,1
32871,112,4316,1513,682,1277,25,13,200,1538,11,199,116,219,210,335,1557,2584,6,15641,868,0,2,3,1,1
32872,55,2831,1457,730,1242,11,6,188,1468,10,292,166,329,302,495,2424,4078,5,22973,1276,1,2,5,4,1
32873,35,2156,652,304,544,16,6,88,668,6,89,51,101,95,152,591,998,3,3399,188,0,2,10,7,1
32874,51,2242,1455,414,1257,16,76,112,1471,5,41,23,46,46,69,231,381,2,1069,59,0,2,4,4,1
32875,34,1289,1293,570,1093,25,15,163,1318,10,195,123,241,205,364,1516,2795,6,17273,959,0,2,4,3,1
32876,16,1265,215,129,180,6,0,29,221,8,65,43,72,73,115,415,711,4,3153,175,0,2,7,3,1
32877,57,2321,1043,504,840,53,9,147,1096,9,180,112,198,189,310,1377,2344,4,11604,644,0,2,10,6,1
32878,69,3533,1943,715,1694,26,18,214,1969,12,185,120,237,197,357,1436,2721,7,20915,1161,0,2,8,6,1
32879,38,1508,1098,241,925,5,10,155,1103,7,46,25,49,53,74,273,423,3,1580,87,0,2,2,1,1
32904,199,4197,182,127,129,0,0,53,182,5,39,21,42,44,63,217,343,2,926,51,0,2,6,6,1
32905,199,4197,1165,710,800,67,119,181,1232,18,243,153,282,261,435,2000,3492,10,36473,2026,1,2,6,6,1
32906,92,2961,773,419,590,28,0,166,801,10,204,113,217,214,330,1598,2554,5,13587,754,0,2,2,0,0
32907,53,1437,1455,414,1257,16,76,112,1471,5,41,23,46,46,69,231,381,2,1069,59,0,2,0,1,0
32908,53,1437,669,365,481,22,61,110,691,15,103,63,122,118,185,747,1273,8,11311,628,0,2,0,1,0
32932,199,4197,182,127,129,0,0,53,182,5,39,21,42,44,63,217,343,2,926,51,0,0,795,0,0
32933,199,4197,1165,710,800,67,119,181,1232,18,243,153,282,261,435,2000,3492,10,36473,2026,1,0,795,0,0
32934,100,2140,773,419,590,28,0,166,801,10,204,113,217,214,330,1598,2554,5,13587,754,0,0,421,0,0
32935,100,2140,421,273,302,44,34,57,465,17,81,59,107,98,166,583,1098,11,12329,684,0,0,421,0,0
32936,90,1944,477,336,357,30,23,73,507,16,194,134,250,210,384,1538,2962,10,30538,1696,0,2,2,1,0
32937,298,6082,1457,730,1242,11,6,188,1468,10,292,166,329,302,495,2424,4078,5,22973,1276,1,2,3,2,0
32938,298,6082,74,35,59,1,0,14,75,3,14,7,14,17,21,58,85,1,128,7,0,2,3,2,0
32939,298,6082,245,125,200,5,7,34,250,7,30,17,34,37,51,166,265,3,1053,58,0,2,3,2,0
32940,53,1437,1455,414,1257,16,76,112,1471,5,41,23,46,46,69,231,381,2,1069,59,0,2,6,3,0
32941,53,1437,669,365,481,22,61,110,691,15,103,63,122,118,185,747,1273,8,11311,628,0,2,6,3,0
32942,172,3987,77,34,69,0,0,8,77,3,24,16,29,27,45,114,213,1,387,21,0,2,8,4,0
32943,172,3987,712,438,573,51,9,84,763,14,102,71,128,116,199,733,1364,8,11988,666,0,2,8,4,0
32944,219,4866,722,423,573,19,0,135,741,12,172,101,199,184,300,1320,2257,6,15668,870,0,2,12,11,0
32945,219,4866,1508,847,911,44,250,301,1552,14,148,88,169,162,257,1120,1886,7,15077,837,0,2,12,11,0
32946,513,10978,72,33,56,0,4,12,72,1,1,1,1,2,2,0,2,0,1,0,0,2,36,34,0
32947,513,10978,1454,835,1044,76,110,219,1530,17,275,158,296,292,454,2297,3718,9,34017,1889,1,2,36,34,0
32948,41,951,386,256,301,16,9,68,402,4,59,35,69,63,104,355,621,2,1453,80,0,2,3,1,0
32949,41,951,264,131,164,11,41,46,275,6,38,22,40,44,62,214,338,3,1068,59,0,2,3,1,0
32950,116,2524,1043,504,840,53,9,147,1096,9,180,112,198,189,310,1377,2344,4,11604,644,0,2,4,3,0
32951,116,2524,383,288,292,26,6,62,409,11,65,38,67,76,105,429,656,5,3719,206,0,2,4,3,0
32952,95,1756,1178,367,1042,6,15,115,1184,9,94,51,95,103,146,644,976,4,4439,246,0,2,2,3,0
32953,95,1756,177,108,140,8,0,27,185,6,30,16,32,36,48,162,248,3,794,44,0,2,2,3,0
32954,53,1077,1098,241,925,5,10,155,1103,7,46,25,49,53,74,273,423,3,1580,87,0,2,5,6,0
32955,53,1077,282,202,222,14,2,44,296,8,42,24,43,50,67,250,378,4,1548,86,0,2,5,6,0
32956,60,1074,282,196,195,3,0,86,285,8,130,71,141,138,212,936,1507,4,6538,363,0,2,2,1,0
32958,20,619,42,7,35,4,0,5,46,1,2,1,2,3,3,2,4,0,2,0,0,2,1,1,0
32959,20,619,11,6,10,0,0,1,11,2,4,2,4,6,6,10,15,1,15,0,0,2,1,1,0
32960,69,2871,1289,550,1043,56,32,155,1345,10,167,93,185,177,278,1266,2075,5,11498,638,0,2,5,2,0
32961,33,992,182,127,129,0,0,53,182,5,39,21,42,44,63,217,343,2,926,51,0,0,163,0,0
32962,118,5254,1392,870,1177,35,17,170,1427,14,494,280,531,508,811,4473,7289,7,54850,3047,2,0,911,0,0
32963,92,2961,773,419,590,28,0,166,801,10,204,113,217,214,330,1598,2554,5,13587,754,0,0,659,0,0
32964,77,3663,1338,495,1086,10,64,173,1348,11,122,82,157,133,239,883,1686,7,11934,663,0,2,12,9,0
32965,140,6182,139,89,101,2,0,35,141,7,54,34,62,61,96,330,569,4,2287,127,0,2,18,14,0
32966,140,6182,7,5,5,0,0,2,7,1,2,1,2,3,3,2,4,0,2,0,0,2,18,14,0
32967,32,933,465,148,393,5,8,60,470,4,31,20,31,35,51,161,261,2,523,29,0,2,2,1,0
32968,32,933,16,12,9,0,0,6,16,1,2,1,2,3,3,2,4,0,2,0,0,2,2,1,0
32969,81,4399,1782,648,1425,9,47,279,1791,8,171,97,189,179,286,1292,2140,4,9462,525,0,2,5,3,0
32970,11,230,256,139,192,9,7,47,265,4,23,12,24,27,36,112,171,2,357,19,0,2,2,1,0
32971,74,2703,1450,624,1228,12,26,181,1462,14,306,186,354,320,540,2580,4493,8,36391,2021,1,2,4,2,0
32972,135,3522,1660,832,1314,41,38,274,1701,20,312,209,395,332,604,2671,5058,12,64042,3557,1,2,4,3,0
32973,112,4316,1513,682,1277,25,13,200,1538,11,199,116,219,210,335,1557,2584,6,15641,868,0,2,3,1,0
32974,55,2831,1457,730,1242,11,6,188,1468,10,292,166,329,302,495,2424,4078,5,22973,1276,1,2,5,4,0
32975,35,2156,652,304,544,16,6,88,668,6,89,51,101,95,152,591,998,3,3399,188,0,2,10,7,0
32976,51,2242,1455,414,1257,16,76,112,1471,5,41,23,46,46,69,231,381,2,1069,59,0,2,4,4,0
32977,34,1289,1293,570,1093,25,15,163,1318,10,195,123,241,205,364,1516,2795,6,17273,959,0,2,4,3,0
32978,16,1265,215,129,180,6,0,29,221,8,65,43,72,73,115,415,711,4,3153,175,0,2,7,3,0
32979,57,2321,1043,504,840,53,9,147,1096,9,180,112,198,189,310,1377,2344,4,11604,644,0,2,10,6,0
32980,69,3533,1943,715,1694,26,18,214,1969,12,185,120,237,197,357,1436,2721,7,20915,1161,0,2,8,6,0
32981,38,1508,1098,241,925,5,10,155,1103,7,46,25,49,53,74,273,423,3,1580,87,0,2,2,1,0
32982,57,1223,996,429,845,24,10,117,1020,7,76,50,88,83,138,494,879,4,3565,198,0,2,2,2,0
32983,57,1223,456,277,329,12,42,72,468,13,85,50,97,98,147,592,972,7,7212,400,0,2,2,2,0
32986,513,10983,72,33,56,0,4,12,72,1,1,1,1,2,2,0,2,0,1,0,0,2,1,2,0
32987,513,10983,1454,835,1044,76,110,219,1530,17,275,158,296,292,454,2297,3718,9,34017,1889,1,2,1,2,0
32988,13,271,256,139,192,9,7,47,265,4,23,12,24,27,36,112,171,2,357,19,0,2,6,0,0
32995,147,4734,1660,832,1314,41,38,274,1701,20,312,209,395,332,604,2671,5058,12,64042,3557,1,2,5,0,1
32996,147,4734,1057,646,719,113,100,145,1170,18,215,134,248,233,382,1740,3004,10,31186,1732,1,2,5,0,1
32997,136,3553,1660,832,1314,41,38,274,1701,20,312,209,395,332,604,2671,5058,12,64042,3557,1,2,13,0,1
33077,298,6082,1457,730,1242,11,6,188,1468,10,292,166,329,302,495,2424,4078,5,22973,1276,1,2,21,18,0
33078,298,6082,74,35,59,1,0,14,75,3,14,7,14,17,21,58,85,1,128,7,0,2,21,18,0
33079,298,6082,245,125,200,5,7,34,250,7,30,17,34,37,51,166,265,3,1053,58,0,2,21,18,0
33080,53,1437,1455,414,1257,16,76,112,1471,5,41,23,46,46,69,231,381,2,1069,59,0,2,57,27,0
33081,53,1437,669,365,481,22,61,110,691,15,103,63,122,118,185,747,1273,8,11311,628,0,2,57,27,0
33082,46,532,647,139,84,35,284,233,682,0,0,0,0,0,0,0,0,0,0,0,0,2,4,1,0
33085,21,594,1293,570,1093,25,15,163,1318,10,195,123,241,205,364,1516,2795,6,17273,959,0,2,1,2,0
33088,513,10983,72,33,56,0,4,12,72,1,1,1,1,2,2,0,2,0,1,0,0,2,37,36,0
33089,513,10983,1454,835,1044,76,110,219,1530,17,275,158,296,292,454,2297,3718,9,34017,1889,1,2,37,36,0
33090,41,951,386,256,301,16,9,68,402,4,59,35,69,63,104,355,621,2,1453,80,0,2,13,3,0
33091,41,951,264,131,164,11,41,46,275,6,38,22,40,44,62,214,338,3,1068,59,0,2,13,3,0
33092,116,2524,1043,504,840,53,9,147,1096,9,180,112,198,189,310,1377,2344,4,11604,644,0,2,9,4,0
33093,116,2524,383,288,292,26,6,62,409,11,65,38,67,76,105,429,656,5,3719,206,0,2,9,4,0
33094,95,1756,1178,367,1042,6,15,115,1184,9,94,51,95,103,146,644,976,4,4439,246,0,2,31,7,0
33095,95,1756,177,108,140,8,0,27,185,6,30,16,32,36,48,162,248,3,794,44,0,2,31,7,0
33096,181,3706,1943,715,1694,26,18,214,1969,12,185,120,237,197,357,1436,2721,7,20915,1161,0,2,15,1,0
33097,181,3706,1168,838,957,57,25,144,1225,19,348,224,416,367,640,3018,5452,11,61921,3440,1,2,15,1,0
33104,69,2871,1289,550,1043,56,32,155,1345,10,167,93,185,177,278,1266,2075,5,11498,638,0,2,5,5,0
33114,13,271,256,139,192,9,7,47,265,4,23,12,24,27,36,112,171,2,357,19,0,2,8,1,0
33116,74,2703,1450,624,1228,12,26,181,1462,14,306,186,354,320,540,2580,4493,8,36391,2021,1,2,13,11,0
33118,112,4316,1513,682,1277,25,13,200,1538,11,199,116,219,210,335,1557,2584,6,15641,868,0,2,3,2,0
33119,55,2831,1457,730,1242,11,6,188,1468,10,292,166,329,302,495,2424,4078,5,22973,1276,1,2,66,2,0
33121,51,2242,1455,414,1257,16,76,112,1471,5,41,23,46,46,69,231,381,2,1069,59,0,2,80,5,0
33125,34,1289,1293,570,1093,25,15,163,1318,10,195,123,241,205,364,1516,2795,6,17273,959,0,2,9,4,0
33126,29,1196,386,256,301,16,9,68,402,4,59,35,69,63,104,355,621,2,1453,80,0,2,10,0,0
33129,56,2421,1178,367,1042,6,15,115,1184,9,94,51,95,103,146,644,976,4,4439,246,0,2,85,0,0
33130,69,3533,1943,715,1694,26,18,214,1969,12,185,120,237,197,357,1436,2721,7,20915,1161,0,2,35,6,0
33251,136,3557,1660,832,1314,41,38,274,1701,20,312,209,395,332,604,2671,5058,12,64042,3557,1,2,4,3,0
33266,147,4734,1660,832,1314,41,38,274,1701,20,312,209,395,332,604,2671,5058,12,64042,3557,1,2,5,0,0
33267,147,4734,1057,646,719,113,100,145,1170,18,215,134,248,233,382,1740,3004,10,31186,1732,1,2,5,0,0
33268,136,3557,1660,832,1314,41,38,274,1701,20,312,209,395,332,604,2671,5058,12,64042,3557,1,2,13,0,0
33269,181,3718,1943,715,1694,26,18,214,1969,12,185,120,237,197,357,1436,2721,7,20915,1161,0,2,1,0,1
33270,181,3718,1168,838,957,57,25,144,1225,19,348,224,416,367,640,3018,5452,11,61921,3440,1,2,1,0,1
33271,69,3545,1943,715,1694,26,18,214,1969,12,185,120,237,197,357,1436,2721,7,20915,1161,0,2,4,0,1
33272,181,3718,1943,715,1694,26,18,214,1969,12,185,120,237,197,357,1436,2721,7,20915,1161,0,2,1,0,0
33273,181,3718,1168,838,957,57,25,144,1225,19,348,224,416,367,640,3018,5452,11,61921,3440,1,2,1,0,0
33274,69,3545,1943,715,1694,26,18,214,1969,12,185,120,237,197,357,1436,2721,7,20915,1161,0,2,4,0,0
33275,90,1950,477,336,357,30,23,73,507,16,194,134,250,210,384,1538,2962,10,30538,1696,0,2,10,8,1
33276,75,2716,1450,624,1228,12,26,181,1462,14,306,186,354,320,540,2580,4493,8,36391,2021,1,2,3,0,1
33277,90,1950,477,336,357,30,23,73,507,16,194,134,250,210,384,1538,2962,10,30538,1696,0,2,10,8,0
33278,75,2716,1450,624,1228,12,26,181,1462,14,306,186,354,320,540,2580,4493,8,36391,2021,1,2,3,0,0
33357,90,1950,477,336,357,30,23,73,507,16,194,134,250,210,384,1538,2962,10,30538,1696,0,2,12,9,0
33379,181,3718,1943,715,1694,26,18,214,1969,12,185,120,237,197,357,1436,2721,7,20915,1161,0,2,16,1,0
33380,181,3718,1168,838,957,57,25,144,1225,19,348,224,416,367,640,3018,5452,11,61921,3440,1,2,16,1,0
33399,75,2716,1450,624,1228,12,26,181,1462,14,306,186,354,320,540,2580,4493,8,36391,2021,1,2,16,11,0
33400,136,3557,1660,832,1314,41,38,274,1701,20,312,209,395,332,604,2671,5058,12,64042,3557,1,2,17,3,0
33413,69,3545,1943,715,1694,26,18,214,1969,12,185,120,237,197,357,1436,2721,7,20915,1161,0,2,39,6,0
33415,302,6165,1457,730,1242,11,6,188,1468,10,292,166,329,302,495,2424,4078,5,22973,1276,1,2,23,2,0
33416,302,6165,74,35,59,1,0,14,75,3,14,7,14,17,21,58,85,1,128,7,0,2,23,2,0
33417,302,6165,245,125,200,5,7,34,250,7,30,17,34,37,51,166,265,3,1053,58,0,2,23,2,0
33418,57,2907,1457,730,1242,11,6,188,1468,10,292,166,329,302,495,2424,4078,5,22973,1276,1,2,15,0,0
33419,98,1843,1178,367,1042,6,15,115,1184,9,94,51,95,103,146,644,976,4,4439,246,0,2,18,0,1
33420,98,1843,177,108,140,8,0,27,185,6,30,16,32,36,48,162,248,3,794,44,0,2,18,0,1
33421,63,2648,1178,367,1042,6,15,115,1184,9,94,51,95,103,146,644,976,4,4439,246,0,2,52,0,1
33425,98,1843,1178,367,1042,6,15,115,1184,9,94,51,95,103,146,644,976,4,4439,246,0,2,18,0,0
33426,98,1843,177,108,140,8,0,27,185,6,30,16,32,36,48,162,248,3,794,44,0,2,18,0,0
33428,63,2648,1178,367,1042,6,15,115,1184,9,94,51,95,103,146,644,976,4,4439,246,0,2,52,0,0
33429,98,1850,1178,367,1042,6,15,115,1184,9,94,51,95,103,146,644,976,4,4439,246,0,2,3,0,1
33430,98,1850,177,108,140,8,0,27,185,6,30,16,32,36,48,162,248,3,794,44,0,2,3,0,1
33431,77,3673,1338,495,1086,10,64,173,1348,11,122,82,157,133,239,883,1686,7,11934,663,0,2,1,0,1
33432,63,2661,1178,367,1042,6,15,115,1184,9,94,51,95,103,146,644,976,4,4439,246,0,2,2,1,1
33433,99,1863,1178,367,1042,6,15,115,1184,9,94,51,95,103,146,644,976,4,4439,246,0,2,18,12,1
33434,99,1863,177,108,140,8,0,27,185,6,30,16,32,36,48,162,248,3,794,44,0,2,18,12,1
33435,64,2726,1178,367,1042,6,15,115,1184,9,94,51,95,103,146,644,976,4,4439,246,0,2,22,3,1
33436,60,1251,996,429,845,24,10,117,1020,7,76,50,88,83,138,494,879,4,3565,198,0,2,3,1,1
33437,60,1251,456,277,329,12,42,72,468,13,85,50,97,98,147,592,972,7,7212,400,0,2,3,1,1
33438,99,1863,1178,367,1042,6,15,115,1184,9,94,51,95,103,146,644,976,4,4439,246,0,2,20,11,0
33439,99,1863,177,108,140,8,0,27,185,6,30,16,32,36,48,162,248,3,794,44,0,2,20,11,0
33440,77,3673,1338,495,1086,10,64,173,1348,11,122,82,157,133,239,883,1686,7,11934,663,0,2,1,0,0
33441,64,2726,1178,367,1042,6,15,115,1184,9,94,51,95,103,146,644,976,4,4439,246,0,2,24,4,0
33442,181,3727,1943,715,1694,26,18,214,1969,12,185,120,237,197,357,1436,2721,7,20915,1161,0,2,4,3,0
33443,181,3727,1168,838,957,57,25,144,1225,19,348,224,416,367,640,3018,5452,11,61921,3440,1,2,4,3,0
33444,72,3652,1943,715,1694,26,18,214,1969,12,185,120,237,197,357,1436,2721,7,20915,1161,0,2,25,0,0
33448,99,1873,1178,367,1042,6,15,115,1184,9,94,51,95,103,146,644,976,4,4439,246,0,2,3,3,1
33449,99,1873,177,108,140,8,0,27,185,6,30,16,32,36,48,162,248,3,794,44,0,2,3,3,1
33450,83,3847,1338,495,1086,10,64,173,1348,11,122,82,157,133,239,883,1686,7,11934,663,0,2,78,0,1
33451,64,2751,1178,367,1042,6,15,115,1184,9,94,51,95,103,146,644,976,4,4439,246,0,2,7,4,0
33452,513,10987,72,33,56,0,4,12,72,1,1,1,1,2,2,0,2,0,1,0,0,2,1,1,1
33453,513,10987,1454,835,1044,76,110,219,1530,17,275,158,296,292,454,2297,3718,9,34017,1889,1,2,1,1,1
33454,58,2427,1043,504,840,53,9,147,1096,9,180,112,198,189,310,1377,2344,4,11604,644,0,2,43,0,1
33455,60,2418,1043,504,840,53,9,147,1096,9,180,112,198,189,310,1377,2344,4,11604,644,0,2,20,37,1
33456,99,1873,1178,367,1042,6,15,115,1184,9,94,51,95,103,146,644,976,4,4439,246,0,2,3,3,0
33457,99,1873,177,108,140,8,0,27,185,6,30,16,32,36,48,162,248,3,794,44,0,2,3,3,0
33458,83,3847,1338,495,1086,10,64,173,1348,11,122,82,157,133,239,883,1686,7,11934,663,0,2,78,0,0
33460,513,10987,72,33,56,0,4,12,72,1,1,1,1,2,2,0,2,0,1,0,0,2,1,1,0
33461,513,10987,1454,835,1044,76,110,219,1530,17,275,158,296,292,454,2297,3718,9,34017,1889,1,2,1,1,0
33462,60,2418,1043,504,840,53,9,147,1096,9,180,112,198,189,310,1377,2344,4,11604,644,0,2,26,0,0
33465,68,1945,1523,757,1297,19,12,193,1542,12,193,117,230,205,347,1508,2664,7,19053,1058,0,2,4,8,1
33466,68,1945,701,378,504,33,58,109,734,13,110,68,126,123,194,794,1346,7,10027,557,0,2,4,8,1
33467,71,3371,1523,757,1297,19,12,193,1542,12,193,117,230,205,347,1508,2664,7,19053,1058,0,2,15,0,1
33468,68,1945,1523,757,1297,19,12,193,1542,12,193,117,230,205,347,1508,2664,7,19053,1058,0,2,4,8,0
33469,68,1945,701,378,504,33,58,109,734,13,110,68,126,123,194,794,1346,7,10027,557,0,2,4,8,0
33470,71,3371,1523,757,1297,19,12,193,1542,12,193,117,230,205,347,1508,2664,7,19053,1058,0,2,15,0,0
33563,56,1502,1455,414,1257,16,76,112,1471,5,41,23,46,46,69,231,381,2,1069,59,0,2,13,0,1
33564,56,1502,669,365,481,22,61,110,691,15,103,63,122,118,185,747,1273,8,11311,628,0,2,13,0,1
33565,53,2376,1455,414,1257,16,76,112,1471,5,41,23,46,46,69,231,381,2,1069,59,0,2,50,0,1
33566,67,1986,1523,757,1297,19,12,193,1542,12,193,117,230,205,347,1508,2664,7,19053,1058,0,2,14,3,0
33567,67,1986,701,378,504,33,58,109,734,13,110,68,126,123,194,794,1346,7,10027,557,0,2,14,3,0
33568,72,3430,1523,757,1297,19,12,193,1542,12,193,117,230,205,347,1508,2664,7,19053,1058,0,2,20,5,0
33569,56,1502,1455,414,1257,16,76,112,1471,5,41,23,46,46,69,231,381,2,1069,59,0,2,13,0,0
33570,56,1502,669,365,481,22,61,110,691,15,103,63,122,118,185,747,1273,8,11311,628,0,2,13,0,0
33571,53,2376,1455,414,1257,16,76,112,1471,5,41,23,46,46,69,231,381,2,1069,59,0,2,50,0,0
33575,73,3480,1523,757,1297,19,12,193,1542,12,193,117,230,205,347,1508,2664,7,19053,1058,0,2,18,2,1
33576,73,3480,1523,757,1297,19,12,193,1542,12,193,117,230,205,347,1508,2664,7,19053,1058,0,2,18,2,0
33577,46,532,647,139,84,35,284,233,682,0,0,0,0,0,0,0,0,0,0,0,0,2,6,9,0
33579,513,10991,72,33,56,0,4,12,72,1,1,1,1,2,2,0,2,0,1,0,0,2,1,1,1
33580,513,10991,1454,835,1044,76,110,219,1530,17,275,158,296,292,454,2297,3718,9,34017,1889,1,2,1,1,1
33581,116,2528,1043,504,840,53,9,147,1096,9,180,112,198,189,310,1377,2344,4,11604,644,0,2,1,1,1
33582,116,2528,383,288,292,26,6,62,409,11,65,38,67,76,105,429,656,5,3719,206,0,2,1,1,1
33583,62,2486,1043,504,840,53,9,147,1096,9,180,112,198,189,310,1377,2344,4,11604,644,0,2,19,0,1
33584,36,1082,182,127,129,0,0,53,182,5,39,21,42,44,63,217,343,2,926,51,0,2,11,0,0
33585,84,3883,1338,495,1086,10,64,173,1348,11,122,82,157,133,239,883,1686,7,11934,663,0,2,17,0,0
33588,117,2546,1043,504,840,53,9,147,1096,9,180,112,198,189,310,1377,2344,4,11604,644,0,2,4,1,1
33589,117,2546,383,288,292,26,6,62,409,11,65,38,67,76,105,429,656,5,3719,206,0,2,4,1,1
33590,62,2505,1043,504,840,53,9,147,1096,9,180,112,198,189,310,1377,2344,4,11604,644,0,2,6,3,1
33591,514,11003,72,33,56,0,4,12,72,1,1,1,1,2,2,0,2,0,1,0,0,2,1,1,1
33592,514,11003,1454,835,1044,76,110,219,1530,17,275,158,296,292,454,2297,3718,9,34017,1889,1,2,1,1,1
33593,70,2905,1289,550,1043,56,32,155,1345,10,167,93,185,177,278,1266,2075,5,11498,638,0,2,14,0,1
33594,82,4441,1782,648,1425,9,47,279,1791,8,171,97,189,179,286,1292,2140,4,9462,525,0,2,5,0,1
33595,513,10991,72,33,56,0,4,12,72,1,1,1,1,2,2,0,2,0,1,0,0,2,1,1,0
33596,513,10991,1454,835,1044,76,110,219,1530,17,275,158,296,292,454,2297,3718,9,34017,1889,1,2,1,1,0
33597,117,2546,1043,504,840,53,9,147,1096,9,180,112,198,189,310,1377,2344,4,11604,644,0,2,4,1,0
33598,117,2546,383,288,292,26,6,62,409,11,65,38,67,76,105,429,656,5,3719,206,0,2,4,1,0
33599,62,2505,1043,504,840,53,9,147,1096,9,180,112,198,189,310,1377,2344,4,11604,644,0,2,22,0,0
33600,514,11007,72,33,56,0,4,12,72,1,1,1,1,2,2,0,2,0,1,0,0,2,1,1,0
33601,514,11007,1454,835,1044,76,110,219,1530,17,275,158,296,292,454,2297,3718,9,34017,1889,1,2,1,1,0
33602,70,2905,1289,550,1043,56,32,155,1345,10,167,93,185,177,278,1266,2075,5,11498,638,0,2,14,0,0
33603,82,4441,1782,648,1425,9,47,279,1791,8,171,97,189,179,286,1292,2140,4,9462,525,0,2,5,0,0
33604,526,11221,72,33,56,0,4,12,72,1,1,1,1,2,2,0,2,0,1,0,0,2,101,1,1
33605,526,11221,1454,835,1044,76,110,219,1530,17,275,158,296,292,454,2297,3718,9,34017,1889,1,2,101,1,1
33606,3,128,520,294,400,33,13,81,553,10,261,204,367,271,571,2128,4614,7,32445,1802,1,0,27,0,1
33607,526,11222,72,33,56,0,4,12,72,1,1,1,1,2,2,0,2,0,1,0,0,2,8,7,1
33608,526,11222,1454,835,1044,76,110,219,1530,17,275,158,296,292,454,2297,3718,9,34017,1889,1,2,8,7,1
33609,4,159,520,294,400,33,13,81,553,10,261,204,367,271,571,2128,4614,7,32445,1802,1,2,6,1,1
33610,527,11252,72,33,56,0,4,12,72,1,1,1,1,2,2,0,2,0,1,0,0,2,4,3,1
33611,527,11252,1454,835,1044,76,110,219,1530,17,275,158,296,292,454,2297,3718,9,34017,1889,1,2,4,3,1
33612,4,166,520,294,400,33,13,81,553,10,261,204,367,271,571,2128,4614,7,32445,1802,1,2,2,1,1
33613,527,11252,72,33,56,0,4,12,72,1,1,1,1,2,2,0,2,0,1,0,0,2,8,5,1
33614,527,11252,1454,835,1044,76,110,219,1530,17,275,158,296,292,454,2297,3718,9,34017,1889,1,2,8,5,1
33615,527,11252,72,33,56,0,4,12,72,1,1,1,1,2,2,0,2,0,1,0,0,2,12,8,1
33616,527,11252,1454,835,1044,76,110,219,1530,17,275,158,296,292,454,2297,3718,9,34017,1889,1,2,12,8,1
33617,527,11252,72,33,56,0,4,12,72,1,1,1,1,2,2,0,2,0,1,0,0,2,1,1,0
33618,527,11252,1454,835,1044,76,110,219,1530,17,275,158,296,292,454,2297,3718,9,34017,1889,1,2,1,1,0
33619,527,11252,72,33,56,0,4,12,72,1,1,1,1,2,2,0,2,0,1,0,0,2,2,2,0
33620,527,11252,1454,835,1044,76,110,219,1530,17,275,158,296,292,454,2297,3718,9,34017,1889,1,2,2,2,0
33621,527,11253,72,33,56,0,4,12,72,1,1,1,1,2,2,0,2,0,1,0,0,2,1,1,0
33622,527,11253,1454,835,1044,76,110,219,1530,17,275,158,296,292,454,2297,3718,9,34017,1889,1,2,1,1,0
33623,302,6177,1457,730,1242,11,6,188,1468,10,292,166,329,302,495,2424,4078,5,22973,1276,1,2,2,2,1
33624,302,6177,74,35,59,1,0,14,75,3,14,7,14,17,21,58,85,1,128,7,0,2,2,2,1
33625,302,6177,245,125,200,5,7,34,250,7,30,17,34,37,51,166,265,3,1053,58,0,2,2,2,1
33626,35,1824,384,251,317,7,8,52,391,11,70,44,84,81,128,467,811,6,5355,297,0,2,6,2,1
33627,514,11018,72,33,56,0,4,12,72,1,1,1,1,2,2,0,2,0,1,0,0,2,14,4,1
33628,514,11018,1454,835,1044,76,110,219,1530,17,275,158,296,292,454,2297,3718,9,34017,1889,1,2,14,4,1
33629,141,6212,139,89,101,2,0,35,141,7,54,34,62,61,96,330,569,4,2287,127,0,2,11,0,1
33630,141,6212,7,5,5,0,0,2,7,1,2,1,2,3,3,2,4,0,2,0,0,2,11,0,1
33631,304,6210,1457,730,1242,11,6,188,1468,10,292,166,329,302,495,2424,4078,5,22973,1276,1,2,6,1,1
33632,304,6210,74,35,59,1,0,14,75,3,14,7,14,17,21,58,85,1,128,7,0,2,6,1,1
33633,304,6210,245,125,200,5,7,34,250,7,30,17,34,37,51,166,265,3,1053,58,0,2,6,1,1
33634,304,6210,1457,730,1242,11,6,188,1468,10,292,166,329,302,495,2424,4078,5,22973,1276,1,2,7,2,0
33635,304,6210,74,35,59,1,0,14,75,3,14,7,14,17,21,58,85,1,128,7,0,2,7,2,0
33636,304,6210,245,125,200,5,7,34,250,7,30,17,34,37,51,166,265,3,1053,58,0,2,7,2,0
33637,35,1824,384,251,317,7,8,52,391,11,70,44,84,81,128,467,811,6,5355,297,0,2,6,2,0
33638,60,1251,996,429,845,24,10,117,1020,7,76,50,88,83,138,494,879,4,3565,198,0,2,1,1,1
33639,60,1251,456,277,329,12,42,72,468,13,85,50,97,98,147,592,972,7,7212,400,0,2,1,1,1
33640,60,1251,996,429,845,24,10,117,1020,7,76,50,88,83,138,494,879,4,3565,198,0,2,3,1,0
33641,60,1251,456,277,329,12,42,72,468,13,85,50,97,98,147,592,972,7,7212,400,0,2,3,1,0
33642,540,11486,72,33,56,0,4,12,72,1,1,1,1,2,2,0,2,0,1,0,0,2,104,20,1
33643,540,11486,1454,835,1044,76,110,219,1530,17,275,158,296,292,454,2297,3718,9,34017,1889,1,2,104,20,1
33644,43,2254,520,294,400,33,13,81,553,10,261,204,367,271,571,2128,4614,7,32445,1802,1,2,259,9,1
33645,540,11486,72,33,56,0,4,12,72,1,1,1,1,2,2,0,2,0,1,0,0,2,102,50,1
33646,540,11486,1454,835,1044,76,110,219,1530,17,275,158,296,292,454,2297,3718,9,34017,1889,1,2,102,50,1
33647,542,11516,72,33,56,0,4,12,72,1,1,1,1,2,2,0,2,0,1,0,0,2,6,0,1
33648,542,11516,1454,835,1044,76,110,219,1530,17,275,158,296,292,454,2297,3718,9,34017,1889,1,2,6,0,1
33649,43,2308,520,294,400,33,13,81,553,10,261,204,367,271,571,2128,4614,7,32445,1802,1,2,6,3,1
33650,46,532,647,139,84,35,284,233,682,0,0,0,0,0,0,0,0,0,0,0,0,2,1,1,0
33651,173,4001,77,34,69,0,0,8,77,3,24,16,29,27,45,114,213,1,387,21,0,2,1,1,0
33652,173,4001,712,438,573,51,9,84,763,14,102,71,128,116,199,733,1364,8,11988,666,0,2,1,1,0
33653,64,2629,1020,354,843,12,15,144,1032,8,134,77,144,142,221,970,1580,4,6792,377,0,2,16,0,0
33654,514,11018,72,33,56,0,4,12,72,1,1,1,1,2,2,0,2,0,1,0,0,2,14,4,0
33655,514,11018,1454,835,1044,76,110,219,1530,17,275,158,296,292,454,2297,3718,9,34017,1889,1,2,14,4,0
33656,141,6212,139,89,101,2,0,35,141,7,54,34,62,61,96,330,569,4,2287,127,0,2,11,0,0
33657,141,6212,7,5,5,0,0,2,7,1,2,1,2,3,3,2,4,0,2,0,0,2,11,0,0
33659,542,11516,72,33,56,0,4,12,72,1,1,1,1,2,2,0,2,0,1,0,0,2,9,7,1
33660,542,11516,1454,835,1044,76,110,219,1530,17,275,158,296,292,454,2297,3718,9,34017,1889,1,2,9,7,1
33661,542,11516,72,33,56,0,4,12,72,1,1,1,1,2,2,0,2,0,1,0,0,2,3,3,1
33662,542,11516,1454,835,1044,76,110,219,1530,17,275,158,296,292,454,2297,3718,9,34017,1889,1,2,3,3,1
33663,543,11547,72,33,56,0,4,12,72,1,1,1,1,2,2,0,2,0,1,0,0,2,14,4,0
33664,543,11547,1454,835,1044,76,110,219,1530,17,275,158,296,292,454,2297,3718,9,34017,1889,1,2,14,4,0
33667,543,11547,72,33,56,0,4,12,72,1,1,1,1,2,2,0,2,0,1,0,0,2,255,2,0
33668,543,11547,1454,835,1044,76,110,219,1530,17,275,158,296,292,454,2297,3718,9,34017,1889,1,2,255,2,0
33669,43,2308,520,294,400,33,13,81,553,10,261,204,367,271,571,2128,4614,7,32445,1802,1,0,286,0,0
33670,173,4001,77,34,69,0,0,8,77,3,24,16,29,27,45,114,213,1,387,21,0,2,1,0,0
33671,173,4001,712,438,573,51,9,84,763,14,102,71,128,116,199,733,1364,8,11988,666,0,2,1,0,0
33672,173,4001,77,34,69,0,0,8,77,3,24,16,29,27,45,114,213,1,387,21,0,2,2,1,0
33673,173,4001,712,438,573,51,9,84,763,14,102,71,128,116,199,733,1364,8,11988,666,0,2,2,1,0
33675,72,2027,1523,757,1297,19,12,193,1542,12,193,117,230,205,347,1508,2664,7,19053,1058,0,2,21,0,1
33676,72,2027,701,378,504,33,58,109,734,13,110,68,126,123,194,794,1346,7,10027,557,0,2,21,0,1
33677,73,3542,1523,757,1297,19,12,193,1542,12,193,117,230,205,347,1508,2664,7,19053,1058,0,2,35,0,1
33678,72,2027,1523,757,1297,19,12,193,1542,12,193,117,230,205,347,1508,2664,7,19053,1058,0,2,21,0,0
33679,72,2027,701,378,504,33,58,109,734,13,110,68,126,123,194,794,1346,7,10027,557,0,2,21,0,0
33680,73,3542,1523,757,1297,19,12,193,1542,12,193,117,230,205,347,1508,2664,7,19053,1058,0,2,35,0,0
33778,46,532,647,139,84,35,284,233,682,0,0,0,0,0,0,0,0,0,0,0,0,2,7,10,0
33779,71,2068,1523,757,1297,19,12,193,1542,12,193,117,230,205,347,1508,2664,7,19053,1058,0,2,14,3,0
33780,71,2068,701,378,504,33,58,109,734,13,110,68,126,123,194,794,1346,7,10027,557,0,2,14,3,0
33783,544,11567,72,33,56,0,4,12,72,1,1,1,1,2,2,0,2,0,1,0,0,2,2,2,0
33784,544,11567,1454,835,1044,76,110,219,1530,17,275,158,296,292,454,2297,3718,9,34017,1889,1,2,2,2,0
33791,75,3651,1523,757,1297,19,12,193,1542,12,193,117,230,205,347,1508,2664,7,19053,1058,0,2,36,5,0
33840,515,11032,72,33,56,0,4,12,72,1,1,1,1,2,2,0,2,0,1,0,0,2,10,8,1
33841,515,11032,1454,835,1044,76,110,219,1530,17,275,158,296,292,454,2297,3718,9,34017,1889,1,2,10,8,1
33842,83,4493,1782,648,1425,9,47,279,1791,8,171,97,189,179,286,1292,2140,4,9462,525,0,2,7,0,1
33843,84,4536,1782,648,1425,9,47,279,1791,8,171,97,189,179,286,1292,2140,4,9462,525,0,2,18,0,1
33844,86,4628,1782,648,1425,9,47,279,1791,8,171,97,189,179,286,1292,2140,4,9462,525,0,2,25,1,0
33845,209,4494,182,127,129,0,0,53,182,5,39,21,42,44,63,217,343,2,926,51,0,2,59,9,1
33846,209,4494,1165,710,800,67,119,181,1232,18,243,153,282,261,435,2000,3492,10,36473,2026,1,2,59,9,1
33847,117,2533,1043,504,840,53,9,147,1096,9,180,112,198,189,310,1377,2344,4,11604,644,0,2,3,0,1
33848,117,2533,383,288,292,26,6,62,409,11,65,38,67,76,105,429,656,5,3719,206,0,2,3,0,1
33849,128,5981,1392,870,1177,35,17,170,1427,14,494,280,531,508,811,4473,7289,7,54850,3047,2,2,88,2,1
33881,514,11007,72,33,56,0,4,12,72,1,1,1,1,2,2,0,2,0,1,0,0,2,2,2,0
33882,514,11007,1454,835,1044,76,110,219,1530,17,275,158,296,292,454,2297,3718,9,34017,1889,1,2,2,2,0
33883,118,2555,1043,504,840,53,9,147,1096,9,180,112,198,189,310,1377,2344,4,11604,644,0,2,4,1,0
33884,118,2555,383,288,292,26,6,62,409,11,65,38,67,76,105,429,656,5,3719,206,0,2,4,1,0
33892,515,11032,72,33,56,0,4,12,72,1,1,1,1,2,2,0,2,0,1,0,0,2,2,1,0
33893,515,11032,1454,835,1044,76,110,219,1530,17,275,158,296,292,454,2297,3718,9,34017,1889,1,2,2,1,0
33919,71,2068,1523,757,1297,19,12,193,1542,12,193,117,230,205,347,1508,2664,7,19053,1058,0,2,21,0,0
33920,71,2068,701,378,504,33,58,109,734,13,110,68,126,123,194,794,1346,7,10027,557,0,2,21,0,0
33921,545,11592,72,33,56,0,4,12,72,1,1,1,1,2,2,0,2,0,1,0,0,2,269,6,0
33922,545,11592,1454,835,1044,76,110,219,1530,17,275,158,296,292,454,2297,3718,9,34017,1889,1,2,269,6,0
33927,75,3651,1523,757,1297,19,12,193,1542,12,193,117,230,205,347,1508,2664,7,19053,1058,0,2,35,0,0
33928,545,11592,72,33,56,0,4,12,72,1,1,1,1,2,2,0,2,0,1,0,0,2,12,9,0
33929,545,11592,1454,835,1044,76,110,219,1530,17,275,158,296,292,454,2297,3718,9,34017,1889,1,2,12,9,0
33930,86,4628,1782,648,1425,9,47,279,1791,8,171,97,189,179,286,1292,2140,4,9462,525,0,2,49,0,0
33931,545,11597,72,33,56,0,4,12,72,1,1,1,1,2,2,0,2,0,1,0,0,2,46,34,1
33932,545,11597,1454,835,1044,76,110,219,1530,17,275,158,296,292,454,2297,3718,9,34017,1889,1,2,46,34,1
33933,99,1883,1178,367,1042,6,15,115,1184,9,94,51,95,103,146,644,976,4,4439,246,0,2,5,0,1
33934,99,1883,177,108,140,8,0,27,185,6,30,16,32,36,48,162,248,3,794,44,0,2,5,0,1
33935,65,2786,1178,367,1042,6,15,115,1184,9,94,51,95,103,146,644,976,4,4439,246,0,2,13,0,1
33936,99,1883,1178,367,1042,6,15,115,1184,9,94,51,95,103,146,644,976,4,4439,246,0,2,7,7,1
33937,99,1883,177,108,140,8,0,27,185,6,30,16,32,36,48,162,248,3,794,44,0,2,7,7,1
33938,65,2786,1178,367,1042,6,15,115,1184,9,94,51,95,103,146,644,976,4,4439,246,0,2,1,1,1
33939,99,1883,1178,367,1042,6,15,115,1184,9,94,51,95,103,146,644,976,4,4439,246,0,2,12,7,0
33940,99,1883,177,108,140,8,0,27,185,6,30,16,32,36,48,162,248,3,794,44,0,2,12,7,0
33941,65,2786,1178,367,1042,6,15,115,1184,9,94,51,95,103,146,644,976,4,4439,246,0,2,14,1,0
33967,304,6210,1457,730,1242,11,6,188,1468,10,292,166,329,302,495,2424,4078,5,22973,1276,1,2,7,2,1
33968,304,6210,74,35,59,1,0,14,75,3,14,7,14,17,21,58,85,1,128,7,0,2,7,2,1
33969,304,6210,245,125,200,5,7,34,250,7,30,17,34,37,51,166,265,3,1053,58,0,2,7,2,1
33970,46,532,647,139,84,35,284,233,682,0,0,0,0,0,0,0,0,0,0,0,0,2,7,10,1
33971,71,2068,1523,757,1297,19,12,193,1542,12,193,117,230,205,347,1508,2664,7,19053,1058,0,2,14,3,1
33972,71,2068,701,378,504,33,58,109,734,13,110,68,126,123,194,794,1346,7,10027,557,0,2,14,3,1
33973,173,4001,77,34,69,0,0,8,77,3,24,16,29,27,45,114,213,1,387,21,0,2,2,1,1
33974,173,4001,712,438,573,51,9,84,763,14,102,71,128,116,199,733,1364,8,11988,666,0,2,2,1,1
33975,545,11614,72,33,56,0,4,12,72,1,1,1,1,2,2,0,2,0,1,0,0,2,16,16,1
33976,545,11614,1454,835,1044,76,110,219,1530,17,275,158,296,292,454,2297,3718,9,34017,1889,1,2,16,16,1
33980,36,1082,182,127,129,0,0,53,182,5,39,21,42,44,63,217,343,2,926,51,0,2,11,0,1
33981,84,3883,1338,495,1086,10,64,173,1348,11,122,82,157,133,239,883,1686,7,11934,663,0,2,17,0,1
33982,86,4628,1782,648,1425,9,47,279,1791,8,171,97,189,179,286,1292,2140,4,9462,525,0,2,54,0,1
33983,75,3651,1523,757,1297,19,12,193,1542,12,193,117,230,205,347,1508,2664,7,19053,1058,0,2,36,5,1
33984,64,2629,1020,354,843,12,15,144,1032,8,134,77,144,142,221,970,1580,4,6792,377,0,2,16,0,1
33986,62,2505,1043,504,840,53,9,147,1096,9,180,112,198,189,310,1377,2344,4,11604,644,0,2,22,0,1
33987,548,11627,72,33,56,0,4,12,72,1,1,1,1,2,2,0,2,0,1,0,0,2,9,3,1
33988,548,11627,1454,835,1044,76,110,219,1530,17,275,158,296,292,454,2297,3718,9,34017,1889,1,2,9,3,1
33989,86,4636,1782,648,1425,9,47,279,1791,8,171,97,189,179,286,1292,2140,4,9462,525,0,2,8,9,1
33990,548,11638,72,33,56,0,4,12,72,1,1,1,1,2,2,0,2,0,1,0,0,2,2,2,0
33991,548,11638,1454,835,1044,76,110,219,1530,17,275,158,296,292,454,2297,3718,9,34017,1889,1,2,2,2,0
33992,548,11638,72,33,56,0,4,12,72,1,1,1,1,2,2,0,2,0,1,0,0,2,9,3,0
33993,548,11638,1454,835,1044,76,110,219,1530,17,275,158,296,292,454,2297,3718,9,34017,1889,1,2,9,3,0
33994,86,4636,1782,648,1425,9,47,279,1791,8,171,97,189,179,286,1292,2140,4,9462,525,0,2,8,9,0
33995,118,2555,1043,504,840,53,9,147,1096,9,180,112,198,189,310,1377,2344,4,11604,644,0,2,1,0,0
33996,118,2555,383,288,292,26,6,62,409,11,65,38,67,76,105,429,656,5,3719,206,0,2,1,0,0
33997,17,386,85,59,61,8,0,16,93,5,18,10,18,23,28,86,126,2,316,17,0,2,40,30,0
33999,545,11616,72,33,56,0,4,12,72,1,1,1,1,2,2,0,2,0,1,0,0,2,2,2,1
34000,545,11616,1454,835,1044,76,110,219,1530,17,275,158,296,292,454,2297,3718,9,34017,1889,1,2,2,2,1
34001,86,4619,1782,648,1425,9,47,279,1791,8,171,97,189,179,286,1292,2140,4,9462,525,0,2,8,9,1
34002,68,1241,1020,354,843,12,15,144,1032,8,134,77,144,142,221,970,1580,4,6792,377,0,2,1,1,1
34003,71,2935,1289,550,1043,56,32,155,1345,10,167,93,185,177,278,1266,2075,5,11498,638,0,2,5,0,1
34004,68,1241,1020,354,843,12,15,144,1032,8,134,77,144,142,221,970,1580,4,6792,377,0,2,1,1,0
34005,71,2935,1289,550,1043,56,32,155,1345,10,167,93,185,177,278,1266,2075,5,11498,638,0,2,5,0,0
34006,75,3651,1523,757,1297,19,12,193,1542,12,193,117,230,205,347,1508,2664,7,19053,1058,0,2,1,1,0
34007,545,11616,72,33,56,0,4,12,72,1,1,1,1,2,2,0,2,0,1,0,0,2,1,1,1
34008,545,11616,1454,835,1044,76,110,219,1530,17,275,158,296,292,454,2297,3718,9,34017,1889,1,2,1,1,1
34009,88,4705,1782,648,1425,9,47,279,1791,8,171,97,189,179,286,1292,2140,4,9462,525,0,2,17,0,1
34010,75,3651,1523,757,1297,19,12,193,1542,12,193,117,230,205,347,1508,2664,7,19053,1058,0,2,1,1,1
34011,548,11662,72,33,56,0,4,12,72,1,1,1,1,2,2,0,2,0,1,0,0,2,9,3,1
34012,548,11662,1454,835,1044,76,110,219,1530,17,275,158,296,292,454,2297,3718,9,34017,1889,1,2,9,3,1
34013,88,4713,1782,648,1425,9,47,279,1791,8,171,97,189,179,286,1292,2140,4,9462,525,0,2,8,9,1
34014,201,4242,182,127,129,0,0,53,182,5,39,21,42,44,63,217,343,2,926,51,0,2,14,0,1
34015,201,4242,1165,710,800,67,119,181,1232,18,243,153,282,261,435,2000,3492,10,36473,2026,1,2,14,0,1
34016,120,5315,1392,870,1177,35,17,170,1427,14,494,280,531,508,811,4473,7289,7,54850,3047,2,2,19,0,1
34017,201,4242,182,127,129,0,0,53,182,5,39,21,42,44,63,217,343,2,926,51,0,2,14,0,0
34018,201,4242,1165,710,800,67,119,181,1232,18,243,153,282,261,435,2000,3492,10,36473,2026,1,2,14,0,0
34019,120,5315,1392,870,1177,35,17,170,1427,14,494,280,531,508,811,4473,7289,7,54850,3047,2,2,19,0,0
34020,548,11662,72,33,56,0,4,12,72,1,1,1,1,2,2,0,2,0,1,0,0,2,42,33,0
34021,548,11662,1454,835,1044,76,110,219,1530,17,275,158,296,292,454,2297,3718,9,34017,1889,1,2,42,33,0
34022,88,4713,1782,648,1425,9,47,279,1791,8,171,97,189,179,286,1292,2140,4,9462,525,0,2,25,9,0
34023,75,3651,1523,757,1297,19,12,193,1542,12,193,117,230,205,347,1508,2664,7,19053,1058,0,2,2,2,0
34024,211,4539,182,127,129,0,0,53,182,5,39,21,42,44,63,217,343,2,926,51,0,2,59,9,0
34025,211,4539,1165,710,800,67,119,181,1232,18,243,153,282,261,435,2000,3492,10,36473,2026,1,2,59,9,0
34026,118,2555,1043,504,840,53,9,147,1096,9,180,112,198,189,310,1377,2344,4,11604,644,0,2,4,0,0
34027,118,2555,383,288,292,26,6,62,409,11,65,38,67,76,105,429,656,5,3719,206,0,2,4,0,0
34028,130,6042,1392,870,1177,35,17,170,1427,14,494,280,531,508,811,4473,7289,7,54850,3047,2,2,88,2,0
34029,202,4248,182,127,129,0,0,53,182,5,39,21,42,44,63,217,343,2,926,51,0,2,13,3,1
34030,202,4248,1165,710,800,67,119,181,1232,18,243,153,282,261,435,2000,3492,10,36473,2026,1,2,13,3,1
34031,121,5350,1392,870,1177,35,17,170,1427,14,494,280,531,508,811,4473,7289,7,54850,3047,2,2,17,1,1
34032,202,4248,182,127,129,0,0,53,182,5,39,21,42,44,63,217,343,2,926,51,0,2,13,3,0
34033,202,4248,1165,710,800,67,119,181,1232,18,243,153,282,261,435,2000,3492,10,36473,2026,1,2,13,3,0
34034,121,5350,1392,870,1177,35,17,170,1427,14,494,280,531,508,811,4473,7289,7,54850,3047,2,2,17,1,0
34035,305,6231,1457,730,1242,11,6,188,1468,10,292,166,329,302,495,2424,4078,5,22973,1276,1,2,4,1,0
34036,305,6231,74,35,59,1,0,14,75,3,14,7,14,17,21,58,85,1,128,7,0,2,4,1,0
34037,305,6231,245,125,200,5,7,34,250,7,30,17,34,37,51,166,265,3,1053,58,0,2,4,1,0
34038,101,1905,1178,367,1042,6,15,115,1184,9,94,51,95,103,146,644,976,4,4439,246,0,2,3,1,1
34039,101,1905,177,108,140,8,0,27,185,6,30,16,32,36,48,162,248,3,794,44,0,2,3,1,1
34040,66,2845,1178,367,1042,6,15,115,1184,9,94,51,95,103,146,644,976,4,4439,246,0,2,13,0,1
34041,304,6218,1457,730,1242,11,6,188,1468,10,292,166,329,302,495,2424,4078,5,22973,1276,1,2,1,4,1
34042,304,6218,74,35,59,1,0,14,75,3,14,7,14,17,21,58,85,1,128,7,0,2,1,4,1
34043,304,6218,245,125,200,5,7,34,250,7,30,17,34,37,51,166,265,3,1053,58,0,2,1,4,1
34044,58,2960,1457,730,1242,11,6,188,1468,10,292,166,329,302,495,2424,4078,5,22973,1276,1,2,11,1,1
34045,202,4248,182,127,129,0,0,53,182,5,39,21,42,44,63,217,343,2,926,51,0,2,3,3,0
34046,202,4248,1165,710,800,67,119,181,1232,18,243,153,282,261,435,2000,3492,10,36473,2026,1,2,3,3,0
34049,217,4674,182,127,129,0,0,53,182,5,39,21,42,44,63,217,343,2,926,51,0,2,28,9,0
34050,217,4674,1165,710,800,67,119,181,1232,18,243,153,282,261,435,2000,3492,10,36473,2026,1,2,28,9,0
34051,135,6195,1392,870,1177,35,17,170,1427,14,494,280,531,508,811,4473,7289,7,54850,3047,2,2,34,1,0
34052,135,6195,1392,870,1177,35,17,170,1427,14,494,280,531,508,811,4473,7289,7,54850,3047,2,2,2,2,0
34053,212,4592,182,127,129,0,0,53,182,5,39,21,42,44,63,217,343,2,926,51,0,2,13,22,1
34054,212,4592,1165,710,800,67,119,181,1232,18,243,153,282,261,435,2000,3492,10,36473,2026,1,2,13,22,1
34055,135,6209,1392,870,1177,35,17,170,1427,14,494,280,531,508,811,4473,7289,7,54850,3047,2,2,6,5,1
34056,212,4596,182,127,129,0,0,53,182,5,39,21,42,44,63,217,343,2,926,51,0,2,1,1,1
34057,212,4596,1165,710,800,67,119,181,1232,18,243,153,282,261,435,2000,3492,10,36473,2026,1,2,1,1,1
34058,212,4596,182,127,129,0,0,53,182,5,39,21,42,44,63,217,343,2,926,51,0,2,19,9,0
34059,212,4596,1165,710,800,67,119,181,1232,18,243,153,282,261,435,2000,3492,10,36473,2026,1,2,19,9,0
34060,135,6209,1392,870,1177,35,17,170,1427,14,494,280,531,508,811,4473,7289,7,54850,3047,2,2,35,1,0
34061,304,6218,1457,730,1242,11,6,188,1468,10,292,166,329,302,495,2424,4078,5,22973,1276,1,2,1,1,0
34062,304,6218,74,35,59,1,0,14,75,3,14,7,14,17,21,58,85,1,128,7,0,2,1,1,0
34063,304,6218,245,125,200,5,7,34,250,7,30,17,34,37,51,166,265,3,1053,58,0,2,1,1,0
34064,58,2960,1457,730,1242,11,6,188,1468,10,292,166,329,302,495,2424,4078,5,22973,1276,1,2,11,1,0
34065,550,11695,72,33,56,0,4,12,72,1,1,1,1,2,2,0,2,0,1,0,0,2,8,0,1
34066,550,11695,1454,835,1044,76,110,219,1530,17,275,158,296,292,454,2297,3718,9,34017,1889,1,2,8,0,1
34067,70,2907,1289,550,1043,56,32,155,1345,10,167,93,185,177,278,1266,2075,5,11498,638,0,2,2,1,1
34068,85,3922,1338,495,1086,10,64,173,1348,11,122,82,157,133,239,883,1686,7,11934,663,0,2,15,3,1
34069,53,2991,1296,573,1062,40,33,157,1336,8,201,118,231,209,349,1561,2689,4,12365,686,0,2,2,1,1
34070,24,966,373,158,315,8,0,51,381,5,76,44,79,81,123,486,779,2,2026,112,0,2,1,1,1
34071,72,3652,1943,715,1694,26,18,214,1969,12,185,120,237,197,357,1436,2721,7,20915,1161,0,2,3,3,1
34072,47,546,647,139,84,35,284,233,682,0,0,0,0,0,0,0,0,0,0,0,0,2,6,0,1
34073,551,11706,72,33,56,0,4,12,72,1,1,1,1,2,2,0,2,0,1,0,0,2,14,6,1
34074,551,11706,1454,835,1044,76,110,219,1530,17,275,158,296,292,454,2297,3718,9,34017,1889,1,2,14,6,1
34075,551,11710,72,33,56,0,4,12,72,1,1,1,1,2,2,0,2,0,1,0,0,2,2,2,1
34076,551,11710,1454,835,1044,76,110,219,1530,17,275,158,296,292,454,2297,3718,9,34017,1889,1,2,2,2,1
34077,89,4754,1782,648,1425,9,47,279,1791,8,171,97,189,179,286,1292,2140,4,9462,525,0,2,18,0,1
34078,47,546,647,139,84,35,284,233,682,0,0,0,0,0,0,0,0,0,0,0,0,2,6,6,1
34079,550,11695,72,33,56,0,4,12,72,1,1,1,1,2,2,0,2,0,1,0,0,2,8,0,0
34080,550,11695,1454,835,1044,76,110,219,1530,17,275,158,296,292,454,2297,3718,9,34017,1889,1,2,8,0,0
34081,70,2907,1289,550,1043,56,32,155,1345,10,167,93,185,177,278,1266,2075,5,11498,638,0,2,2,1,0
34082,85,3922,1338,495,1086,10,64,173,1348,11,122,82,157,133,239,883,1686,7,11934,663,0,2,15,3,0
34083,53,2991,1296,573,1062,40,33,157,1336,8,201,118,231,209,349,1561,2689,4,12365,686,0,2,2,1,0
34085,72,3652,1943,715,1694,26,18,214,1969,12,185,120,237,197,357,1436,2721,7,20915,1161,0,2,3,3,0
34086,47,548,647,139,84,35,284,233,682,0,0,0,0,0,0,0,0,0,0,0,0,2,1,1,1
34087,551,11716,72,33,56,0,4,12,72,1,1,1,1,2,2,0,2,0,1,0,0,2,2,2,1
34088,551,11716,1454,835,1044,76,110,219,1530,17,275,158,296,292,454,2297,3718,9,34017,1889,1,2,2,2,1
34089,89,4754,1782,648,1425,9,47,279,1791,8,171,97,189,179,286,1292,2140,4,9462,525,0,2,1,1,1
34090,47,548,647,139,84,35,284,233,682,0,0,0,0,0,0,0,0,0,0,0,0,2,6,0,0
34091,553,11749,72,33,56,0,4,12,72,1,1,1,1,2,2,0,2,0,1,0,0,2,14,6,0
34092,553,11749,1454,835,1044,76,110,219,1530,17,275,158,296,292,454,2297,3718,9,34017,1889,1,2,14,6,0
34093,89,4754,1782,648,1425,9,47,279,1791,8,171,97,189,179,286,1292,2140,4,9462,525,0,2,18,0,0
34098,65,2670,1020,354,843,12,15,144,1032,8,134,77,144,142,221,970,1580,4,6792,377,0,2,23,1,0
34099,65,2675,1020,354,843,12,15,144,1032,8,134,77,144,142,221,970,1580,4,6792,377,0,2,1,1,1
34100,67,1993,1523,757,1297,19,12,193,1542,12,193,117,230,205,347,1508,2664,7,19053,1058,0,2,1,1,1
34101,67,1993,701,378,504,33,58,109,734,13,110,68,126,123,194,794,1346,7,10027,557,0,2,1,1,1
34102,73,3480,1523,757,1297,19,12,193,1542,12,193,117,230,205,347,1508,2664,7,19053,1058,0,2,4,4,1
34103,67,1993,1523,757,1297,19,12,193,1542,12,193,117,230,205,347,1508,2664,7,19053,1058,0,2,1,1,0
34104,67,1993,701,378,504,33,58,109,734,13,110,68,126,123,194,794,1346,7,10027,557,0,2,1,1,0
34105,73,3480,1523,757,1297,19,12,193,1542,12,193,117,230,205,347,1508,2664,7,19053,1058,0,2,4,4,0
34110,215,4647,182,127,129,0,0,53,182,5,39,21,42,44,63,217,343,2,926,51,0,2,13,3,0
34111,215,4647,1165,710,800,67,119,181,1232,18,243,153,282,261,435,2000,3492,10,36473,2026,1,2,13,3,0
34113,71,2937,1289,550,1043,56,32,155,1345,10,167,93,185,177,278,1266,2075,5,11498,638,0,2,5,0,0
34114,138,6305,1392,870,1177,35,17,170,1427,14,494,280,531,508,811,4473,7289,7,54850,3047,2,2,20,2,0
34115,215,4647,182,127,129,0,0,53,182,5,39,21,42,44,63,217,343,2,926,51,0,2,3,3,0
34116,215,4647,1165,710,800,67,119,181,1232,18,243,153,282,261,435,2000,3492,10,36473,2026,1,2,3,3,0
34120,71,2075,1523,757,1297,19,12,193,1542,12,193,117,230,205,347,1508,2664,7,19053,1058,0,2,1,1,0
34121,71,2075,701,378,504,33,58,109,734,13,110,68,126,123,194,794,1346,7,10027,557,0,2,1,1,0
34122,553,11749,72,33,56,0,4,12,72,1,1,1,1,2,2,0,2,0,1,0,0,2,1,1,0
34123,553,11749,1454,835,1044,76,110,219,1530,17,275,158,296,292,454,2297,3718,9,34017,1889,1,2,1,1,0
34125,75,3651,1523,757,1297,19,12,193,1542,12,193,117,230,205,347,1508,2664,7,19053,1058,0,2,4,4,0
34131,54,1089,1098,241,925,5,10,155,1103,7,46,25,49,53,74,273,423,3,1580,87,0,2,2,0,1
34132,54,1089,282,202,222,14,2,44,296,8,42,24,43,50,67,250,378,4,1548,86,0,2,2,0,1
34133,39,1537,1098,241,925,5,10,155,1103,7,46,25,49,53,74,273,423,3,1580,87,0,2,14,0,1
34134,65,2675,1020,354,843,12,15,144,1032,8,134,77,144,142,221,970,1580,4,6792,377,0,2,23,1,0
34135,54,1089,1098,241,925,5,10,155,1103,7,46,25,49,53,74,273,423,3,1580,87,0,2,2,0,0
34136,54,1089,282,202,222,14,2,44,296,8,42,24,43,50,67,250,378,4,1548,86,0,2,2,0,0
34137,39,1537,1098,241,925,5,10,155,1103,7,46,25,49,53,74,273,423,3,1580,87,0,2,14,0,0
34138,173,4005,77,34,69,0,0,8,77,3,24,16,29,27,45,114,213,1,387,21,0,2,1,1,1
34139,173,4005,712,438,573,51,9,84,763,14,102,71,128,116,199,733,1364,8,11988,666,0,2,1,1,1
34140,53,3004,1296,573,1062,40,33,157,1336,8,201,118,231,209,349,1561,2689,4,12365,686,0,2,2,0,1
34143,173,4005,77,34,69,0,0,8,77,3,24,16,29,27,45,114,213,1,387,21,0,2,1,1,0
34144,173,4005,712,438,573,51,9,84,763,14,102,71,128,116,199,733,1364,8,11988,666,0,2,1,1,0
34145,53,3007,1296,573,1062,40,33,157,1336,8,201,118,231,209,349,1561,2689,4,12365,686,0,2,2,0,0
34155,215,4647,182,127,129,0,0,53,182,5,39,21,42,44,63,217,343,2,926,51,0,2,16,6,0
34156,215,4647,1165,710,800,67,119,181,1232,18,243,153,282,261,435,2000,3492,10,36473,2026,1,2,16,6,0
34175,514,11040,72,33,56,0,4,12,72,1,1,1,1,2,2,0,2,0,1,0,0,2,7,0,1
34176,514,11040,1454,835,1044,76,110,219,1530,17,275,158,296,292,454,2297,3718,9,34017,1889,1,2,7,0,1
34177,83,4488,1782,648,1425,9,47,279,1791,8,171,97,189,179,286,1292,2140,4,9462,525,0,2,7,0,1
34178,513,11010,72,33,56,0,4,12,72,1,1,1,1,2,2,0,2,0,1,0,0,2,3,12,1
34179,513,11010,1454,835,1044,76,110,219,1530,17,275,158,296,292,454,2297,3718,9,34017,1889,1,2,3,12,1
34180,513,11012,72,33,56,0,4,12,72,1,1,1,1,2,2,0,2,0,1,0,0,2,2,2,1
34181,513,11012,1454,835,1044,76,110,219,1530,17,275,158,296,292,454,2297,3718,9,34017,1889,1,2,2,2,1
34182,513,11012,72,33,56,0,4,12,72,1,1,1,1,2,2,0,2,0,1,0,0,2,9,11,0
34183,513,11012,1454,835,1044,76,110,219,1530,17,275,158,296,292,454,2297,3718,9,34017,1889,1,2,9,11,0
34184,83,4488,1782,648,1425,9,47,279,1791,8,171,97,189,179,286,1292,2140,4,9462,525,0,2,7,0,0
34185,101,1905,1178,367,1042,6,15,115,1184,9,94,51,95,103,146,644,976,4,4439,246,0,2,3,1,0
34186,101,1905,177,108,140,8,0,27,185,6,30,16,32,36,48,162,248,3,794,44,0,2,3,1,0
34187,66,2845,1178,367,1042,6,15,115,1184,9,94,51,95,103,146,644,976,4,4439,246,0,2,13,0,0
34191,514,11010,72,33,56,0,4,12,72,1,1,1,1,2,2,0,2,0,1,0,0,2,6,6,1
34192,514,11010,1454,835,1044,76,110,219,1530,17,275,158,296,292,454,2297,3718,9,34017,1889,1,2,6,6,1
34193,141,6224,139,89,101,2,0,35,141,7,54,34,62,61,96,330,569,4,2287,127,0,2,32,0,0
34194,141,6224,7,5,5,0,0,2,7,1,2,1,2,3,3,2,4,0,2,0,0,2,32,0,0
34195,514,11010,72,33,56,0,4,12,72,1,1,1,1,2,2,0,2,0,1,0,0,2,6,6,0
34196,514,11010,1454,835,1044,76,110,219,1530,17,275,158,296,292,454,2297,3718,9,34017,1889,1,2,6,6,0
34222,553,11752,72,33,56,0,4,12,72,1,1,1,1,2,2,0,2,0,1,0,0,2,15,17,0
34223,553,11752,1454,835,1044,76,110,219,1530,17,275,158,296,292,454,2297,3718,9,34017,1889,1,2,15,17,0
34226,142,6254,139,89,101,2,0,35,141,7,54,34,62,61,96,330,569,4,2287,127,0,2,32,0,0
34227,142,6254,7,5,5,0,0,2,7,1,2,1,2,3,3,2,4,0,2,0,0,2,32,0,0
34228,90,4801,1782,648,1425,9,47,279,1791,8,171,97,189,179,286,1292,2140,4,9462,525,0,2,7,0,0
34253,53,1425,1455,414,1257,16,76,112,1471,5,41,23,46,46,69,231,381,2,1069,59,0,2,6,8,0
34254,53,1425,669,365,481,22,61,110,691,15,103,63,122,118,185,747,1273,8,11311,628,0,2,6,8,0
34255,52,2288,1455,414,1257,16,76,112,1471,5,41,23,46,46,69,231,381,2,1069,59,0,2,10,2,0
34259,203,4258,182,127,129,0,0,53,182,5,39,21,42,44,63,217,343,2,926,51,0,2,7,4,1
34260,203,4258,1165,710,800,67,119,181,1232,18,243,153,282,261,435,2000,3492,10,36473,2026,1,2,7,4,1
34261,174,4021,77,34,69,0,0,8,77,3,24,16,29,27,45,114,213,1,387,21,0,2,7,1,1
34262,174,4021,712,438,573,51,9,84,763,14,102,71,128,116,199,733,1364,8,11988,666,0,2,7,1,1
34263,122,5398,1392,870,1177,35,17,170,1427,14,494,280,531,508,811,4473,7289,7,54850,3047,2,2,11,0,1
34264,553,11758,72,33,56,0,4,12,72,1,1,1,1,2,2,0,2,0,1,0,0,2,1,0,1
34265,553,11758,1454,835,1044,76,110,219,1530,17,275,158,296,292,454,2297,3718,9,34017,1889,1,2,1,0,1
34266,140,6252,139,89,101,2,0,35,141,7,54,34,62,61,96,330,569,4,2287,127,0,2,29,58,1
34267,140,6252,7,5,5,0,0,2,7,1,2,1,2,3,3,2,4,0,2,0,0,2,29,58,1
34268,553,11773,72,33,56,0,4,12,72,1,1,1,1,2,2,0,2,0,1,0,0,2,4,4,1
34269,553,11773,1454,835,1044,76,110,219,1530,17,275,158,296,292,454,2297,3718,9,34017,1889,1,2,4,4,1
34270,140,6263,139,89,101,2,0,35,141,7,54,34,62,61,96,330,569,4,2287,127,0,2,11,12,1
34271,140,6263,7,5,5,0,0,2,7,1,2,1,2,3,3,2,4,0,2,0,0,2,11,12,1
34272,553,11737,72,33,56,0,4,12,72,1,1,1,1,2,2,0,2,0,1,0,0,2,14,18,1
34273,553,11737,1454,835,1044,76,110,219,1530,17,275,158,296,292,454,2297,3718,9,34017,1889,1,2,14,18,1
34274,3,63,127,75,83,2,11,30,129,4,14,7,14,18,21,61,87,2,175,9,0,2,2,2,1
34275,3,63,652,304,544,16,6,88,668,6,89,51,101,95,152,591,998,3,3399,188,0,2,2,2,1
34276,3,63,2,2,2,0,0,0,2,0,0,0,0,0,0,0,0,0,0,0,0,2,2,2,1
34277,3,63,8,5,5,0,0,3,8,0,0,0,0,0,0,0,0,0,0,0,0,2,2,2,1
34280,3,63,14,8,8,0,0,6,14,0,0,0,0,0,0,0,0,0,0,0,0,2,2,2,1
34281,3,63,6,4,4,0,0,2,6,0,0,0,0,0,0,0,0,0,0,0,0,2,2,2,1
34282,3,63,6,4,4,0,0,2,6,1,2,1,2,3,3,2,4,0,2,0,0,2,2,2,1
34284,3,63,7,5,5,0,0,2,7,0,0,0,0,0,0,0,0,0,0,0,0,2,2,2,1
34286,3,63,10,6,6,0,0,4,10,0,0,0,0,0,0,0,0,0,0,0,0,2,2,2,1
34287,3,63,1,1,1,0,0,0,1,0,0,0,0,0,0,0,0,0,0,0,0,2,2,2,1
34289,3,63,14,10,10,0,0,4,14,1,1,1,1,2,2,0,2,0,1,0,0,2,2,2,1
34290,3,63,46,26,30,3,0,12,49,3,6,3,6,9,9,20,28,1,42,2,0,2,2,2,1
34291,550,11685,72,33,56,0,4,12,72,1,1,1,1,2,2,0,2,0,1,0,0,2,5,14,1
34292,550,11685,1454,835,1044,76,110,219,1530,17,275,158,296,292,454,2297,3718,9,34017,1889,1,2,5,14,1
34293,203,4258,182,127,129,0,0,53,182,5,39,21,42,44,63,217,343,2,926,51,0,2,7,4,0
34294,203,4258,1165,710,800,67,119,181,1232,18,243,153,282,261,435,2000,3492,10,36473,2026,1,2,7,4,0
34295,174,4021,77,34,69,0,0,8,77,3,24,16,29,27,45,114,213,1,387,21,0,2,7,1,0
34296,174,4021,712,438,573,51,9,84,763,14,102,71,128,116,199,733,1364,8,11988,666,0,2,7,1,0
34297,122,5398,1392,870,1177,35,17,170,1427,14,494,280,531,508,811,4473,7289,7,54850,3047,2,2,11,0,0
34298,5,280,180,34,164,0,0,16,180,1,12,6,12,13,18,43,66,0,33,1,0,0,137,0,0
34299,568,12095,72,33,56,0,4,12,72,1,1,1,1,2,2,0,2,0,1,0,0,2,71,0,1
34300,568,12095,1454,835,1044,76,110,219,1530,17,275,158,296,292,454,2297,3718,9,34017,1889,1,2,71,0,1
34301,568,12095,72,33,56,0,4,12,72,1,1,1,1,2,2,0,2,0,1,0,0,2,4,4,1
34302,568,12095,1454,835,1044,76,110,219,1530,17,275,158,296,292,454,2297,3718,9,34017,1889,1,2,4,4,1
34303,175,4054,77,34,69,0,0,8,77,3,24,16,29,27,45,114,213,1,387,21,0,2,3,0,1
34304,175,4054,712,438,573,51,9,84,763,14,102,71,128,116,199,733,1364,8,11988,666,0,2,3,0,1
34305,63,2641,1043,504,840,53,9,147,1096,9,180,112,198,189,310,1377,2344,4,11604,644,0,2,33,0,1
34306,175,4054,77,34,69,0,0,8,77,3,24,16,29,27,45,114,213,1,387,21,0,2,3,0,0
34307,175,4054,712,438,573,51,9,84,763,14,102,71,128,116,199,733,1364,8,11988,666,0,2,3,0,0
34308,63,2641,1043,504,840,53,9,147,1096,9,180,112,198,189,310,1377,2344,4,11604,644,0,2,33,0,0
34309,568,12095,72,33,56,0,4,12,72,1,1,1,1,2,2,0,2,0,1,0,0,2,1,1,1
34310,568,12095,1454,835,1044,76,110,219,1530,17,275,158,296,292,454,2297,3718,9,34017,1889,1,2,1,1,1
34311,5,280,180,34,164,0,0,16,180,1,12,6,12,13,18,43,66,0,33,1,0,2,5,5,1
34312,174,4005,77,34,69,0,0,8,77,3,24,16,29,27,45,114,213,1,387,21,0,2,18,29,1
34313,174,4005,712,438,573,51,9,84,763,14,102,71,128,116,199,733,1364,8,11988,666,0,2,18,29,1
34314,78,3195,1289,550,1043,56,32,155,1345,10,167,93,185,177,278,1266,2075,5,11498,638,0,2,77,6,1
34315,174,4006,77,34,69,0,0,8,77,3,24,16,29,27,45,114,213,1,387,21,0,2,4,1,1
34316,174,4006,712,438,573,51,9,84,763,14,102,71,128,116,199,733,1364,8,11988,666,0,2,4,1,1
34317,77,3168,1289,550,1043,56,32,155,1345,10,167,93,185,177,278,1266,2075,5,11498,638,0,2,9,19,1
34318,550,11685,72,33,56,0,4,12,72,1,1,1,1,2,2,0,2,0,1,0,0,2,22,34,0
34319,550,11685,1454,835,1044,76,110,219,1530,17,275,158,296,292,454,2297,3718,9,34017,1889,1,2,22,34,0
34320,3,63,127,75,83,2,11,30,129,4,14,7,14,18,21,61,87,2,175,9,0,2,2,2,0
34321,3,63,652,304,544,16,6,88,668,6,89,51,101,95,152,591,998,3,3399,188,0,2,2,2,0
34322,3,63,2,2,2,0,0,0,2,0,0,0,0,0,0,0,0,0,0,0,0,2,2,2,0
34323,3,63,8,5,5,0,0,3,8,0,0,0,0,0,0,0,0,0,0,0,0,2,2,2,0
34326,3,63,14,8,8,0,0,6,14,0,0,0,0,0,0,0,0,0,0,0,0,2,2,2,0
34327,3,63,6,4,4,0,0,2,6,0,0,0,0,0,0,0,0,0,0,0,0,2,2,2,0
34328,3,63,6,4,4,0,0,2,6,1,2,1,2,3,3,2,4,0,2,0,0,2,2,2,0
34330,3,63,7,5,5,0,0,2,7,0,0,0,0,0,0,0,0,0,0,0,0,2,2,2,0
34332,3,63,10,6,6,0,0,4,10,0,0,0,0,0,0,0,0,0,0,0,0,2,2,2,0
34333,3,63,1,1,1,0,0,0,1,0,0,0,0,0,0,0,0,0,0,0,0,2,2,2,0
34335,3,63,14,10,10,0,0,4,14,1,1,1,1,2,2,0,2,0,1,0,0,2,2,2,0
34336,3,63,46,26,30,3,0,12,49,3,6,3,6,9,9,20,28,1,42,2,0,2,2,2,0
34337,140,6263,139,89,101,2,0,35,141,7,54,34,62,61,96,330,569,4,2287,127,0,2,20,50,0
34338,140,6263,7,5,5,0,0,2,7,1,2,1,2,3,3,2,4,0,2,0,0,2,20,50,0
34339,565,12028,72,33,56,0,4,12,72,1,1,1,1,2,2,0,2,0,1,0,0,2,71,0,0
34340,565,12028,1454,835,1044,76,110,219,1530,17,275,158,296,292,454,2297,3718,9,34017,1889,1,2,71,0,0
34342,71,3617,1943,715,1694,26,18,214,1969,12,185,120,237,197,357,1436,2721,7,20915,1161,0,2,0,5,0
34343,174,4049,77,34,69,0,0,8,77,3,24,16,29,27,45,114,213,1,387,21,0,2,1,10,1
34344,174,4049,712,438,573,51,9,84,763,14,102,71,128,116,199,733,1364,8,11988,666,0,2,1,10,1
34345,174,4049,77,34,69,0,0,8,77,3,24,16,29,27,45,114,213,1,387,21,0,2,1,10,0
34346,174,4049,712,438,573,51,9,84,763,14,102,71,128,116,199,733,1364,8,11988,666,0,2,1,10,0
34348,566,12057,72,33,56,0,4,12,72,1,1,1,1,2,2,0,2,0,1,0,0,2,10,4,1
34349,566,12057,1454,835,1044,76,110,219,1530,17,275,158,296,292,454,2297,3718,9,34017,1889,1,2,10,4,1
34350,17,373,256,139,192,9,7,47,265,4,23,12,24,27,36,112,171,2,357,19,0,2,17,0,1
34351,17,375,256,139,192,9,7,47,265,4,23,12,24,27,36,112,171,2,357,19,0,2,2,2,0
34352,117,2369,1513,682,1277,25,13,200,1538,11,199,116,219,210,335,1557,2584,6,15641,868,0,2,17,6,1
34353,117,2369,819,519,539,24,98,155,843,15,96,57,106,111,163,690,1107,8,9171,509,0,2,17,6,1
34354,113,4391,1513,682,1277,25,13,200,1538,11,199,116,219,210,335,1557,2584,6,15641,868,0,2,16,0,1
34355,173,4001,77,34,69,0,0,8,77,3,24,16,29,27,45,114,213,1,387,21,0,2,21,29,0
34356,173,4001,712,438,573,51,9,84,763,14,102,71,128,116,199,733,1364,8,11988,666,0,2,21,29,0
34357,77,3168,1289,550,1043,56,32,155,1345,10,167,93,185,177,278,1266,2075,5,11498,638,0,2,70,9,0
34358,566,12055,72,33,56,0,4,12,72,1,1,1,1,2,2,0,2,0,1,0,0,2,3,4,1
34359,566,12055,1454,835,1044,76,110,219,1530,17,275,158,296,292,454,2297,3718,9,34017,1889,1,2,3,4,1
34360,16,362,256,139,192,9,7,47,265,4,23,12,24,27,36,112,171,2,357,19,0,2,7,4,1
34361,566,12055,72,33,56,0,4,12,72,1,1,1,1,2,2,0,2,0,1,0,0,2,8,0,1
34362,566,12055,1454,835,1044,76,110,219,1530,17,275,158,296,292,454,2297,3718,9,34017,1889,1,2,8,0,1
34363,566,12055,72,33,56,0,4,12,72,1,1,1,1,2,2,0,2,0,1,0,0,2,2,0,1
34364,566,12055,1454,835,1044,76,110,219,1530,17,275,158,296,292,454,2297,3718,9,34017,1889,1,2,2,0,1
34365,117,2369,1513,682,1277,25,13,200,1538,11,199,116,219,210,335,1557,2584,6,15641,868,0,2,17,6,0
34366,117,2369,819,519,539,24,98,155,843,15,96,57,106,111,163,690,1107,8,9171,509,0,2,17,6,0
34367,113,4391,1513,682,1277,25,13,200,1538,11,199,116,219,210,335,1557,2584,6,15641,868,0,2,16,0,0
34368,566,12055,72,33,56,0,4,12,72,1,1,1,1,2,2,0,2,0,1,0,0,2,19,4,0
34369,566,12055,1454,835,1044,76,110,219,1530,17,275,158,296,292,454,2297,3718,9,34017,1889,1,2,19,4,0
34370,16,362,256,139,192,9,7,47,265,4,23,12,24,27,36,112,171,2,357,19,0,2,20,0,0
34371,16,362,256,139,192,9,7,47,265,4,23,12,24,27,36,112,171,2,357,19,0,2,1,1,0
34372,54,2999,1296,573,1062,40,33,157,1336,8,201,118,231,209,349,1561,2689,4,12365,686,0,2,3,1,0
34375,37,793,2,2,2,0,0,0,2,0,0,0,0,0,0,0,0,0,0,0,0,2,35,15,1
34389,37,793,99,48,90,1,3,5,100,0,0,0,0,0,0,0,0,0,0,0,0,2,35,15,1
34390,37,793,8,5,5,2,0,1,10,0,0,0,0,0,0,0,0,0,0,0,0,2,35,15,1
34391,37,793,1217,716,841,84,126,174,1301,14,185,118,215,199,333,1446,2542,8,20687,1149,0,2,35,15,1
34392,37,793,160,89,115,0,13,31,160,7,15,11,17,22,28,78,124,3,495,27,0,2,35,15,1
34393,37,793,10,10,9,9,0,0,19,0,0,0,0,0,0,0,0,0,0,0,0,2,35,15,1
34394,37,793,173,84,99,8,29,36,181,5,12,7,13,17,20,54,81,2,221,12,0,2,35,15,1
34395,37,793,3,1,1,3,0,0,6,0,0,0,0,0,0,0,0,0,0,0,0,2,35,15,1
34396,151,4796,1660,832,1314,41,38,274,1701,20,312,209,395,332,604,2671,5058,12,64042,3557,1,2,35,22,1
34397,151,4796,1057,646,719,113,100,145,1170,18,215,134,248,233,382,1740,3004,10,31186,1732,1,2,35,22,1
34398,141,3690,1660,832,1314,41,38,274,1701,20,312,209,395,332,604,2671,5058,12,64042,3557,1,2,34,0,1
34399,59,2950,1457,730,1242,11,6,188,1468,10,292,166,329,302,495,2424,4078,5,22973,1276,1,2,8,3,1
34400,220,4876,722,423,573,19,0,135,741,12,172,101,199,184,300,1320,2257,6,15668,870,0,2,7,4,1
34401,220,4876,1508,847,911,44,250,301,1552,14,148,88,169,162,257,1120,1886,7,15077,837,0,2,7,4,1
34404,37,788,2,2,2,0,0,0,2,0,0,0,0,0,0,0,0,0,0,0,0,2,1,2,1
34418,37,788,99,48,90,1,3,5,100,0,0,0,0,0,0,0,0,0,0,0,0,2,1,2,1
34419,37,788,8,5,5,2,0,1,10,0,0,0,0,0,0,0,0,0,0,0,0,2,1,2,1
34420,37,788,1217,716,841,84,126,174,1301,14,185,118,215,199,333,1446,2542,8,20687,1149,0,2,1,2,1
34421,37,788,160,89,115,0,13,31,160,7,15,11,17,22,28,78,124,3,495,27,0,2,1,2,1
34422,37,788,10,10,9,9,0,0,19,0,0,0,0,0,0,0,0,0,0,0,0,2,1,2,1
34423,37,788,173,84,99,8,29,36,181,5,12,7,13,17,20,54,81,2,221,12,0,2,1,2,1
34424,37,788,3,1,1,3,0,0,6,0,0,0,0,0,0,0,0,0,0,0,0,2,1,2,1
34425,150,4790,1660,832,1314,41,38,274,1701,20,312,209,395,332,604,2671,5058,12,64042,3557,1,2,3,5,1
34426,150,4790,1057,646,719,113,100,145,1170,18,215,134,248,233,382,1740,3004,10,31186,1732,1,2,3,5,1
34427,516,11121,72,33,56,0,4,12,72,1,1,1,1,2,2,0,2,0,1,0,0,2,19,0,1
34428,516,11121,1454,835,1044,76,110,219,1530,17,275,158,296,292,454,2297,3718,9,34017,1889,1,2,19,0,1
34429,145,6464,139,89,101,2,0,35,141,7,54,34,62,61,96,330,569,4,2287,127,0,2,105,0,1
34430,145,6464,7,5,5,0,0,2,7,1,2,1,2,3,3,2,4,0,2,0,0,2,105,0,1
34433,37,784,2,2,2,0,0,0,2,0,0,0,0,0,0,0,0,0,0,0,0,2,0,1,0
34447,37,784,99,48,90,1,3,5,100,0,0,0,0,0,0,0,0,0,0,0,0,2,0,1,0
34448,37,784,8,5,5,2,0,1,10,0,0,0,0,0,0,0,0,0,0,0,0,2,0,1,0
34449,37,784,1217,716,841,84,126,174,1301,14,185,118,215,199,333,1446,2542,8,20687,1149,0,2,0,1,0
34450,37,784,160,89,115,0,13,31,160,7,15,11,17,22,28,78,124,3,495,27,0,2,0,1,0
34451,37,784,10,10,9,9,0,0,19,0,0,0,0,0,0,0,0,0,0,0,0,2,0,1,0
34452,37,784,173,84,99,8,29,36,181,5,12,7,13,17,20,54,81,2,221,12,0,2,0,1,0
34453,37,784,3,1,1,3,0,0,6,0,0,0,0,0,0,0,0,0,0,0,0,2,0,1,0
34454,150,4791,1660,832,1314,41,38,274,1701,20,312,209,395,332,604,2671,5058,12,64042,3557,1,2,1,1,0
34455,150,4791,1057,646,719,113,100,145,1170,18,215,134,248,233,382,1740,3004,10,31186,1732,1,2,1,1,0
34456,175,4054,77,34,69,0,0,8,77,3,24,16,29,27,45,114,213,1,387,21,0,2,8,0,1
34457,175,4054,712,438,573,51,9,84,763,14,102,71,128,116,199,733,1364,8,11988,666,0,2,8,0,1
34458,71,2946,1289,550,1043,56,32,155,1345,10,167,93,185,177,278,1266,2075,5,11498,638,0,2,6,4,1
34459,58,3261,1296,573,1062,40,33,157,1336,8,201,118,231,209,349,1561,2689,4,12365,686,0,2,111,0,1
34460,54,2412,1455,414,1257,16,76,112,1471,5,41,23,46,46,69,231,381,2,1069,59,0,2,17,4,1
34461,16,1265,215,129,180,6,0,29,221,8,65,43,72,73,115,415,711,4,3153,175,0,2,1,1,1
34462,72,3652,1943,715,1694,26,18,214,1969,12,185,120,237,197,357,1436,2721,7,20915,1161,0,2,1,1,1
34463,514,11012,72,33,56,0,4,12,72,1,1,1,1,2,2,0,2,0,1,0,0,2,1,1,1
34464,514,11012,1454,835,1044,76,110,219,1530,17,275,158,296,292,454,2297,3718,9,34017,1889,1,2,1,1,1
34465,117,2369,1513,682,1277,25,13,200,1538,11,199,116,219,210,335,1557,2584,6,15641,868,0,2,1,1,1
34466,117,2369,819,519,539,24,98,155,843,15,96,57,106,111,163,690,1107,8,9171,509,0,2,1,1,1
34467,24,810,74,35,59,1,0,14,75,3,14,7,14,17,21,58,85,1,128,7,0,2,2,2,1
34468,24,810,245,125,200,5,7,34,250,7,30,17,34,37,51,166,265,3,1053,58,0,2,2,2,1
34470,219,4866,722,423,573,19,0,135,741,12,172,101,199,184,300,1320,2257,6,15668,870,0,2,15,15,1
34471,219,4866,1508,847,911,44,250,301,1552,14,148,88,169,162,257,1120,1886,7,15077,837,0,2,15,15,1
34472,566,12055,72,33,56,0,4,12,72,1,1,1,1,2,2,0,2,0,1,0,0,2,1,1,1
34473,566,12055,1454,835,1044,76,110,219,1530,17,275,158,296,292,454,2297,3718,9,34017,1889,1,2,1,1,1
34475,20,625,42,7,35,4,0,5,46,1,2,1,2,3,3,2,4,0,2,0,0,2,1,0,1
34476,20,625,11,6,10,0,0,1,11,2,4,2,4,6,6,10,15,1,15,0,0,2,1,0,1
34478,58,2960,1457,730,1242,11,6,188,1468,10,292,166,329,302,495,2424,4078,5,22973,1276,1,2,1,1,1
34479,8,265,74,35,59,1,0,14,75,3,14,7,14,17,21,58,85,1,128,7,0,2,2,2,1
34481,38,2201,334,251,279,10,4,40,344,5,127,74,143,132,217,899,1528,2,4303,239,0,2,6,7,1
34482,220,4876,722,423,573,19,0,135,741,12,172,101,199,184,300,1320,2257,6,15668,870,0,2,7,4,0
34483,220,4876,1508,847,911,44,250,301,1552,14,148,88,169,162,257,1120,1886,7,15077,837,0,2,7,4,0
34484,175,4054,77,34,69,0,0,8,77,3,24,16,29,27,45,114,213,1,387,21,0,2,8,0,0
34485,175,4054,712,438,573,51,9,84,763,14,102,71,128,116,199,733,1364,8,11988,666,0,2,8,0,0
34486,71,2946,1289,550,1043,56,32,155,1345,10,167,93,185,177,278,1266,2075,5,11498,638,0,2,6,4,0
34487,58,3261,1296,573,1062,40,33,157,1336,8,201,118,231,209,349,1561,2689,4,12365,686,0,2,111,0,0
34488,54,2412,1455,414,1257,16,76,112,1471,5,41,23,46,46,69,231,381,2,1069,59,0,2,17,4,0
34489,16,1265,215,129,180,6,0,29,221,8,65,43,72,73,115,415,711,4,3153,175,0,2,1,1,0
34490,72,3652,1943,715,1694,26,18,214,1969,12,185,120,237,197,357,1436,2721,7,20915,1161,0,2,1,1,0
34500,37,784,2,2,2,0,0,0,2,0,0,0,0,0,0,0,0,0,0,0,0,2,34,16,0
34514,37,784,99,48,90,1,3,5,100,0,0,0,0,0,0,0,0,0,0,0,0,2,34,16,0
34515,37,784,8,5,5,2,0,1,10,0,0,0,0,0,0,0,0,0,0,0,0,2,34,16,0
34516,37,784,1217,716,841,84,126,174,1301,14,185,118,215,199,333,1446,2542,8,20687,1149,0,2,34,16,0
34517,37,784,160,89,115,0,13,31,160,7,15,11,17,22,28,78,124,3,495,27,0,2,34,16,0
34518,37,784,10,10,9,9,0,0,19,0,0,0,0,0,0,0,0,0,0,0,0,2,34,16,0
34519,37,784,173,84,99,8,29,36,181,5,12,7,13,17,20,54,81,2,221,12,0,2,34,16,0
34520,37,784,3,1,1,3,0,0,6,0,0,0,0,0,0,0,0,0,0,0,0,2,34,16,0
34521,150,4791,1660,832,1314,41,38,274,1701,20,312,209,395,332,604,2671,5058,12,64042,3557,1,2,34,23,0
34522,150,4791,1057,646,719,113,100,145,1170,18,215,134,248,233,382,1740,3004,10,31186,1732,1,2,34,23,0
34523,141,3690,1660,832,1314,41,38,274,1701,20,312,209,395,332,604,2671,5058,12,64042,3557,1,2,34,0,0
34524,59,2950,1457,730,1242,11,6,188,1468,10,292,166,329,302,495,2424,4078,5,22973,1276,1,2,8,3,0
34526,514,11012,72,33,56,0,4,12,72,1,1,1,1,2,2,0,2,0,1,0,0,2,1,1,0
34527,514,11012,1454,835,1044,76,110,219,1530,17,275,158,296,292,454,2297,3718,9,34017,1889,1,2,1,1,0
34528,117,2369,1513,682,1277,25,13,200,1538,11,199,116,219,210,335,1557,2584,6,15641,868,0,2,1,1,0
34529,117,2369,819,519,539,24,98,155,843,15,96,57,106,111,163,690,1107,8,9171,509,0,2,1,1,0
34530,24,810,74,35,59,1,0,14,75,3,14,7,14,17,21,58,85,1,128,7,0,2,2,2,0
34531,24,810,245,125,200,5,7,34,250,7,30,17,34,37,51,166,265,3,1053,58,0,2,2,2,0
34532,47,548,647,139,84,35,284,233,682,0,0,0,0,0,0,0,0,0,0,0,0,2,1,1,0
34533,219,4866,722,423,573,19,0,135,741,12,172,101,199,184,300,1320,2257,6,15668,870,0,2,15,15,0
34534,219,4866,1508,847,911,44,250,301,1552,14,148,88,169,162,257,1120,1886,7,15077,837,0,2,15,15,0
34535,566,12055,72,33,56,0,4,12,72,1,1,1,1,2,2,0,2,0,1,0,0,2,1,1,0
34536,566,12055,1454,835,1044,76,110,219,1530,17,275,158,296,292,454,2297,3718,9,34017,1889,1,2,1,1,0
34537,3,23,14,7,7,2,0,5,16,0,0,0,0,0,0,0,0,0,0,0,0,2,1,1,0
34538,20,625,42,7,35,4,0,5,46,1,2,1,2,3,3,2,4,0,2,0,0,2,1,0,0
34539,20,625,11,6,10,0,0,1,11,2,4,2,4,6,6,10,15,1,15,0,0,2,1,0,0
34541,59,2950,1457,730,1242,11,6,188,1468,10,292,166,329,302,495,2424,4078,5,22973,1276,1,2,1,1,0
34542,8,265,74,35,59,1,0,14,75,3,14,7,14,17,21,58,85,1,128,7,0,2,2,2,0
34544,38,2201,334,251,279,10,4,40,344,5,127,74,143,132,217,899,1528,2,4303,239,0,2,6,7,0
34545,516,11123,72,33,56,0,4,12,72,1,1,1,1,2,2,0,2,0,1,0,0,2,19,0,0
34546,516,11123,1454,835,1044,76,110,219,1530,17,275,158,296,292,454,2297,3718,9,34017,1889,1,2,19,0,0
34547,145,6464,139,89,101,2,0,35,141,7,54,34,62,61,96,330,569,4,2287,127,0,2,105,0,0
34548,145,6464,7,5,5,0,0,2,7,1,2,1,2,3,3,2,4,0,2,0,0,2,105,0,0
34549,173,4021,77,34,69,0,0,8,77,3,24,16,29,27,45,114,213,1,387,21,0,2,2,0,1
34550,173,4021,712,438,573,51,9,84,763,14,102,71,128,116,199,733,1364,8,11988,666,0,2,2,0,1
34551,569,12221,72,33,56,0,4,12,72,1,1,1,1,2,2,0,2,0,1,0,0,2,15,0,1
34552,569,12221,1454,835,1044,76,110,219,1530,17,275,158,296,292,454,2297,3718,9,34017,1889,1,2,15,0,1
34553,120,2635,1043,504,840,53,9,147,1096,9,180,112,198,189,310,1377,2344,4,11604,644,0,2,11,1,1
34554,120,2635,383,288,292,26,6,62,409,11,65,38,67,76,105,429,656,5,3719,206,0,2,11,1,1
34555,90,1955,477,336,357,30,23,73,507,16,194,134,250,210,384,1538,2962,10,30538,1696,0,2,3,2,1
34556,76,2747,1450,624,1228,12,26,181,1462,14,306,186,354,320,540,2580,4493,8,36391,2021,1,2,15,1,1
34557,121,2646,1043,504,840,53,9,147,1096,9,180,112,198,189,310,1377,2344,4,11604,644,0,2,12,8,1
34558,121,2646,383,288,292,26,6,62,409,11,65,38,67,76,105,429,656,5,3719,206,0,2,12,8,1
34559,146,6501,139,89,101,2,0,35,141,7,54,34,62,61,96,330,569,4,2287,127,0,2,14,0,1
34560,146,6501,7,5,5,0,0,2,7,1,2,1,2,3,3,2,4,0,2,0,0,2,14,0,1
34561,573,12239,72,33,56,0,4,12,72,1,1,1,1,2,2,0,2,0,1,0,0,2,22,12,1
34562,573,12239,1454,835,1044,76,110,219,1530,17,275,158,296,292,454,2297,3718,9,34017,1889,1,2,22,12,1
34563,121,2646,1043,504,840,53,9,147,1096,9,180,112,198,189,310,1377,2344,4,11604,644,0,2,12,8,0
34564,121,2646,383,288,292,26,6,62,409,11,65,38,67,76,105,429,656,5,3719,206,0,2,12,8,0
34565,575,12268,72,33,56,0,4,12,72,1,1,1,1,2,2,0,2,0,1,0,0,2,9,1,0
34566,575,12268,1454,835,1044,76,110,219,1530,17,275,158,296,292,454,2297,3718,9,34017,1889,1,2,9,1,0
34569,3,147,601,196,481,2,23,85,603,8,63,36,72,71,108,400,664,4,3036,168,0,0,27,0,1
34570,579,12308,72,33,56,0,4,12,72,1,1,1,1,2,2,0,2,0,1,0,0,2,6,0,0
34571,579,12308,1454,835,1044,76,110,219,1530,17,275,158,296,292,454,2297,3718,9,34017,1889,1,2,6,0,0
34572,121,2645,1043,504,840,53,9,147,1096,9,180,112,198,189,310,1377,2344,4,11604,644,0,2,2,3,0
34573,121,2645,383,288,292,26,6,62,409,11,65,38,67,76,105,429,656,5,3719,206,0,2,2,3,0
34578,90,1955,477,336,357,30,23,73,507,16,194,134,250,210,384,1538,2962,10,30538,1696,0,2,3,2,0
34579,76,2747,1450,624,1228,12,26,181,1462,14,306,186,354,320,540,2580,4493,8,36391,2021,1,2,15,1,0
34580,2,67,7,6,5,0,0,2,7,1,1,1,2,2,3,0,3,1,3,0,0,0,13,0,0
34604,216,4657,182,127,129,0,0,53,182,5,39,21,42,44,63,217,343,2,926,51,0,2,7,4,1
34605,216,4657,1165,710,800,67,119,181,1232,18,243,153,282,261,435,2000,3492,10,36473,2026,1,2,7,4,1
34606,55,1468,1455,414,1257,16,76,112,1471,5,41,23,46,46,69,231,381,2,1069,59,0,2,6,10,1
34607,55,1468,669,365,481,22,61,110,691,15,103,63,122,118,185,747,1273,8,11311,628,0,2,6,10,1
34608,175,4054,77,34,69,0,0,8,77,3,24,16,29,27,45,114,213,1,387,21,0,2,32,40,1
34609,175,4054,712,438,573,51,9,84,763,14,102,71,128,116,199,733,1364,8,11988,666,0,2,32,40,1
34612,568,12168,72,33,56,0,4,12,72,1,1,1,1,2,2,0,2,0,1,0,0,2,20,1,1
34613,568,12168,1454,835,1044,76,110,219,1530,17,275,158,296,292,454,2297,3718,9,34017,1889,1,2,20,1,1
34614,77,3179,1289,550,1043,56,32,155,1345,10,167,93,185,177,278,1266,2075,5,11498,638,0,2,70,9,1
34615,139,6353,1392,870,1177,35,17,170,1427,14,494,280,531,508,811,4473,7289,7,54850,3047,2,2,12,0,1
34616,144,6503,139,89,101,2,0,35,141,7,54,34,62,61,96,330,569,4,2287,127,0,2,105,0,1
34617,144,6503,7,5,5,0,0,2,7,1,2,1,2,3,3,2,4,0,2,0,0,2,105,0,1
34618,59,3272,1296,573,1062,40,33,157,1336,8,201,118,231,209,349,1561,2689,4,12365,686,0,2,3,1,1
34619,55,2458,1455,414,1257,16,76,112,1471,5,41,23,46,46,69,231,381,2,1069,59,0,2,10,2,1
34621,71,3617,1943,715,1694,26,18,214,1969,12,185,120,237,197,357,1436,2721,7,20915,1161,0,2,0,5,1
34622,579,12308,72,33,56,0,4,12,72,1,1,1,1,2,2,0,2,0,1,0,0,2,2,2,0
34623,579,12308,1454,835,1044,76,110,219,1530,17,275,158,296,292,454,2297,3718,9,34017,1889,1,2,2,2,0
34624,121,2645,1043,504,840,53,9,147,1096,9,180,112,198,189,310,1377,2344,4,11604,644,0,2,2,2,0
34625,121,2645,383,288,292,26,6,62,409,11,65,38,67,76,105,429,656,5,3719,206,0,2,2,2,0
34627,146,6501,139,89,101,2,0,35,141,7,54,34,62,61,96,330,569,4,2287,127,0,2,14,0,0
34628,146,6501,7,5,5,0,0,2,7,1,2,1,2,3,3,2,4,0,2,0,0,2,14,0,0
34631,145,6540,139,89,101,2,0,35,141,7,54,34,62,61,96,330,569,4,2287,127,0,2,14,0,0
34632,145,6540,7,5,5,0,0,2,7,1,2,1,2,3,3,2,4,0,2,0,0,2,14,0,0
34638,173,4038,77,34,69,0,0,8,77,3,24,16,29,27,45,114,213,1,387,21,0,2,3,0,1
34639,173,4038,712,438,573,51,9,84,763,14,102,71,128,116,199,733,1364,8,11988,666,0,2,3,0,1
34640,582,12336,72,33,56,0,4,12,72,1,1,1,1,2,2,0,2,0,1,0,0,2,10,5,1
34641,582,12336,1454,835,1044,76,110,219,1530,17,275,158,296,292,454,2297,3718,9,34017,1889,1,2,10,5,1
34642,122,2653,1043,504,840,53,9,147,1096,9,180,112,198,189,310,1377,2344,4,11604,644,0,2,1,1,1
34643,122,2653,383,288,292,26,6,62,409,11,65,38,67,76,105,429,656,5,3719,206,0,2,1,1,1
34667,216,4657,182,127,129,0,0,53,182,5,39,21,42,44,63,217,343,2,926,51,0,2,7,4,0
34668,216,4657,1165,710,800,67,119,181,1232,18,243,153,282,261,435,2000,3492,10,36473,2026,1,2,7,4,0
34670,55,1468,1455,414,1257,16,76,112,1471,5,41,23,46,46,69,231,381,2,1069,59,0,2,6,10,0
34671,55,1468,669,365,481,22,61,110,691,15,103,63,122,118,185,747,1273,8,11311,628,0,2,6,10,0
34672,175,4054,77,34,69,0,0,8,77,3,24,16,29,27,45,114,213,1,387,21,0,2,32,40,0
34673,175,4054,712,438,573,51,9,84,763,14,102,71,128,116,199,733,1364,8,11988,666,0,2,32,40,0
34676,568,12168,72,33,56,0,4,12,72,1,1,1,1,2,2,0,2,0,1,0,0,2,20,1,0
34677,568,12168,1454,835,1044,76,110,219,1530,17,275,158,296,292,454,2297,3718,9,34017,1889,1,2,20,1,0
34678,77,3179,1289,550,1043,56,32,155,1345,10,167,93,185,177,278,1266,2075,5,11498,638,0,2,70,9,0
34679,139,6353,1392,870,1177,35,17,170,1427,14,494,280,531,508,811,4473,7289,7,54850,3047,2,2,12,0,0
34680,145,6540,139,89,101,2,0,35,141,7,54,34,62,61,96,330,569,4,2287,127,0,2,119,0,0
34681,145,6540,7,5,5,0,0,2,7,1,2,1,2,3,3,2,4,0,2,0,0,2,119,0,0
34683,59,3272,1296,573,1062,40,33,157,1336,8,201,118,231,209,349,1561,2689,4,12365,686,0,2,3,1,0
34684,55,2458,1455,414,1257,16,76,112,1471,5,41,23,46,46,69,231,381,2,1069,59,0,2,10,2,0
34745,175,4087,77,34,69,0,0,8,77,3,24,16,29,27,45,114,213,1,387,21,0,2,40,40,0
34746,175,4087,712,438,573,51,9,84,763,14,102,71,128,116,199,733,1364,8,11988,666,0,2,40,40,0
34747,220,4876,722,423,573,19,0,135,741,12,172,101,199,184,300,1320,2257,6,15668,870,0,2,22,19,0
34748,220,4876,1508,847,911,44,250,301,1552,14,148,88,169,162,257,1120,1886,7,15077,837,0,2,22,19,0
34749,584,12449,72,33,56,0,4,12,72,1,1,1,1,2,2,0,2,0,1,0,0,2,21,2,0
34750,584,12449,1454,835,1044,76,110,219,1530,17,275,158,296,292,454,2297,3718,9,34017,1889,1,2,21,2,0
34754,77,3179,1289,550,1043,56,32,155,1345,10,167,93,185,177,278,1266,2075,5,11498,638,0,2,76,13,0
34761,59,3272,1296,573,1062,40,33,157,1336,8,201,118,231,209,349,1561,2689,4,12365,686,0,2,114,1,0
34762,59,2950,1457,730,1242,11,6,188,1468,10,292,166,329,302,495,2424,4078,5,22973,1276,1,2,9,4,0
34763,55,2458,1455,414,1257,16,76,112,1471,5,41,23,46,46,69,231,381,2,1069,59,0,2,27,6,0
34770,71,3617,1943,715,1694,26,18,214,1969,12,185,120,237,197,357,1436,2721,7,20915,1161,0,2,1,6,0
34771,307,6253,1457,730,1242,11,6,188,1468,10,292,166,329,302,495,2424,4078,5,22973,1276,1,2,4,0,0
34772,307,6253,74,35,59,1,0,14,75,3,14,7,14,17,21,58,85,1,128,7,0,2,4,0,0
34773,307,6253,245,125,200,5,7,34,250,7,30,17,34,37,51,166,265,3,1053,58,0,2,4,0,0
34774,39,2266,334,251,279,10,4,40,344,5,127,74,143,132,217,899,1528,2,4303,239,0,2,7,0,0
34779,584,12469,72,33,56,0,4,12,72,1,1,1,1,2,2,0,2,0,1,0,0,2,3,1,0
34780,584,12469,1454,835,1044,76,110,219,1530,17,275,158,296,292,454,2297,3718,9,34017,1889,1,2,3,1,0
34781,122,2648,1043,504,840,53,9,147,1096,9,180,112,198,189,310,1377,2344,4,11604,644,0,2,1,1,0
34782,122,2648,383,288,292,26,6,62,409,11,65,38,67,76,105,429,656,5,3719,206,0,2,1,1,0
34783,585,12481,72,33,56,0,4,12,72,1,1,1,1,2,2,0,2,0,1,0,0,2,9,7,0
34784,585,12481,1454,835,1044,76,110,219,1530,17,275,158,296,292,454,2297,3718,9,34017,1889,1,2,9,7,0
34785,53,1425,1455,414,1257,16,76,112,1471,5,41,23,46,46,69,231,381,2,1069,59,0,2,1,1,1
34786,53,1425,669,365,481,22,61,110,691,15,103,63,122,118,185,747,1273,8,11311,628,0,2,1,1,1
34787,517,11149,72,33,56,0,4,12,72,1,1,1,1,2,2,0,2,0,1,0,0,2,17,10,1
34788,517,11149,1454,835,1044,76,110,219,1530,17,275,158,296,292,454,2297,3718,9,34017,1889,1,2,17,10,1
34789,122,5398,1392,870,1177,35,17,170,1427,14,494,280,531,508,811,4473,7289,7,54850,3047,2,2,1,1,1
34790,147,6532,139,89,101,2,0,35,141,7,54,34,62,61,96,330,569,4,2287,127,0,2,27,19,1
34791,147,6532,7,5,5,0,0,2,7,1,2,1,2,3,3,2,4,0,2,0,0,2,27,19,1
34792,83,4488,1782,648,1425,9,47,279,1791,8,171,97,189,179,286,1292,2140,4,9462,525,0,2,2,2,1
34793,34,1289,1293,570,1093,25,15,163,1318,10,195,123,241,205,364,1516,2795,6,17273,959,0,2,1,1,1
34794,53,1425,1455,414,1257,16,76,112,1471,5,41,23,46,46,69,231,381,2,1069,59,0,2,1,1,0
34795,53,1425,669,365,481,22,61,110,691,15,103,63,122,118,185,747,1273,8,11311,628,0,2,1,1,0
34796,517,11149,72,33,56,0,4,12,72,1,1,1,1,2,2,0,2,0,1,0,0,2,17,10,0
34797,517,11149,1454,835,1044,76,110,219,1530,17,275,158,296,292,454,2297,3718,9,34017,1889,1,2,17,10,0
34798,122,5398,1392,870,1177,35,17,170,1427,14,494,280,531,508,811,4473,7289,7,54850,3047,2,2,1,1,0
34799,147,6532,139,89,101,2,0,35,141,7,54,34,62,61,96,330,569,4,2287,127,0,2,27,19,0
34800,147,6532,7,5,5,0,0,2,7,1,2,1,2,3,3,2,4,0,2,0,0,2,27,19,0
34801,83,4488,1782,648,1425,9,47,279,1791,8,171,97,189,179,286,1292,2140,4,9462,525,0,2,2,2,0
34802,34,1289,1293,570,1093,25,15,163,1318,10,195,123,241,205,364,1516,2795,6,17273,959,0,2,1,1,0
34803,82,1803,477,336,357,30,23,73,507,16,194,134,250,210,384,1538,2962,10,30538,1696,0,2,0,33,1
34804,135,3546,1660,832,1314,41,38,274,1701,20,312,209,395,332,604,2671,5058,12,64042,3557,1,2,20,14,1
34805,82,1803,477,336,357,30,23,73,507,16,194,134,250,210,384,1538,2962,10,30538,1696,0,2,0,33,0
34806,135,3546,1660,832,1314,41,38,274,1701,20,312,209,395,332,604,2671,5058,12,64042,3557,1,2,20,14,0
34807,569,12184,72,33,56,0,4,12,72,1,1,1,1,2,2,0,2,0,1,0,0,2,6,0,1
34808,569,12184,1454,835,1044,76,110,219,1530,17,275,158,296,292,454,2297,3718,9,34017,1889,1,2,6,0,1
34809,76,3740,1523,757,1297,19,12,193,1542,12,193,117,230,205,347,1508,2664,7,19053,1058,0,2,41,18,1
34810,16,1198,215,129,180,6,0,29,221,8,65,43,72,73,115,415,711,4,3153,175,0,2,0,9,1
34811,62,2603,1043,504,840,53,9,147,1096,9,180,112,198,189,310,1377,2344,4,11604,644,0,2,0,12,1
34812,22,942,373,158,315,8,0,51,381,5,76,44,79,81,123,486,779,2,2026,112,0,2,1,7,1
34813,67,2869,1178,367,1042,6,15,115,1184,9,94,51,95,103,146,644,976,4,4439,246,0,2,17,5,1
34814,71,3615,1943,715,1694,26,18,214,1969,12,185,120,237,197,357,1436,2721,7,20915,1161,0,2,1,2,1
34815,303,6208,1457,730,1242,11,6,188,1468,10,292,166,329,302,495,2424,4078,5,22973,1276,1,2,7,10,0
34816,303,6208,74,35,59,1,0,14,75,3,14,7,14,17,21,58,85,1,128,7,0,2,7,10,0
34817,303,6208,245,125,200,5,7,34,250,7,30,17,34,37,51,166,265,3,1053,58,0,2,7,10,0
34818,38,2210,334,251,279,10,4,40,344,5,127,74,143,132,217,899,1528,2,4303,239,0,2,3,0,0
34819,303,6198,1457,730,1242,11,6,188,1468,10,292,166,329,302,495,2424,4078,5,22973,1276,1,2,1,4,1
34820,303,6198,74,35,59,1,0,14,75,3,14,7,14,17,21,58,85,1,128,7,0,2,1,4,1
34821,303,6198,245,125,200,5,7,34,250,7,30,17,34,37,51,166,265,3,1053,58,0,2,1,4,1
34822,61,3038,1457,730,1242,11,6,188,1468,10,292,166,329,302,495,2424,4078,5,22973,1276,1,2,17,0,1
34824,304,6218,1457,730,1242,11,6,188,1468,10,292,166,329,302,495,2424,4078,5,22973,1276,1,2,1,1,1
34825,304,6218,74,35,59,1,0,14,75,3,14,7,14,17,21,58,85,1,128,7,0,2,1,1,1
34826,304,6218,245,125,200,5,7,34,250,7,30,17,34,37,51,166,265,3,1053,58,0,2,1,1,1
34827,49,571,647,139,84,35,284,233,682,0,0,0,0,0,0,0,0,0,0,0,0,2,13,0,1
34828,570,12235,72,33,56,0,4,12,72,1,1,1,1,2,2,0,2,0,1,0,0,2,35,74,1
34829,570,12235,1454,835,1044,76,110,219,1530,17,275,158,296,292,454,2297,3718,9,34017,1889,1,2,35,74,1
34830,17,325,294,64,250,0,0,43,294,1,20,10,20,21,30,86,131,0,65,3,0,0,54,0,1
34831,17,325,78,46,62,3,0,14,81,3,8,4,8,11,12,28,41,1,62,3,0,0,54,0,1
34832,4,72,110,30,77,3,13,16,113,4,21,15,30,25,45,100,208,2,597,33,0,0,14,0,1
34833,4,72,28,15,21,1,0,6,29,0,0,0,0,0,0,0,0,0,0,0,0,0,14,0,1
34834,175,4054,77,34,69,0,0,8,77,3,24,16,29,27,45,114,213,1,387,21,0,2,0,5,0
34835,175,4054,712,438,573,51,9,84,763,14,102,71,128,116,199,733,1364,8,11988,666,0,2,0,5,0
34836,18,355,294,64,250,0,0,43,294,1,20,10,20,21,30,86,131,0,65,3,0,2,5,0,0
34837,18,355,78,46,62,3,0,14,81,3,8,4,8,11,12,28,41,1,62,3,0,2,5,0,0
34838,5,103,110,30,77,3,13,16,113,4,21,15,30,25,45,100,208,2,597,33,0,2,5,0,0
34839,5,103,28,15,21,1,0,6,29,0,0,0,0,0,0,0,0,0,0,0,0,2,5,0,0
34840,15,485,42,7,35,4,0,5,46,1,2,1,2,3,3,2,4,0,2,0,0,2,2,24,1
34841,15,485,11,6,10,0,0,1,11,2,4,2,4,6,6,10,15,1,15,0,0,2,2,24,1
34846,303,6198,1457,730,1242,11,6,188,1468,10,292,166,329,302,495,2424,4078,5,22973,1276,1,2,1,4,0
34847,303,6198,74,35,59,1,0,14,75,3,14,7,14,17,21,58,85,1,128,7,0,2,1,4,0
34848,303,6198,245,125,200,5,7,34,250,7,30,17,34,37,51,166,265,3,1053,58,0,2,1,4,0
34849,61,3038,1457,730,1242,11,6,188,1468,10,292,166,329,302,495,2424,4078,5,22973,1276,1,2,17,0,0
34850,302,6188,1457,730,1242,11,6,188,1468,10,292,166,329,302,495,2424,4078,5,22973,1276,1,2,7,10,0
34851,302,6188,74,35,59,1,0,14,75,3,14,7,14,17,21,58,85,1,128,7,0,2,7,10,0
34852,302,6188,245,125,200,5,7,34,250,7,30,17,34,37,51,166,265,3,1053,58,0,2,7,10,0
34854,302,6188,1457,730,1242,11,6,188,1468,10,292,166,329,302,495,2424,4078,5,22973,1276,1,2,1,1,0
34855,302,6188,74,35,59,1,0,14,75,3,14,7,14,17,21,58,85,1,128,7,0,2,1,1,0
34856,302,6188,245,125,200,5,7,34,250,7,30,17,34,37,51,166,265,3,1053,58,0,2,1,1,0
34859,569,12184,72,33,56,0,4,12,72,1,1,1,1,2,2,0,2,0,1,0,0,2,6,0,0
34860,569,12184,1454,835,1044,76,110,219,1530,17,275,158,296,292,454,2297,3718,9,34017,1889,1,2,6,0,0
34861,76,3740,1523,757,1297,19,12,193,1542,12,193,117,230,205,347,1508,2664,7,19053,1058,0,2,41,18,0
34862,16,1198,215,129,180,6,0,29,221,8,65,43,72,73,115,415,711,4,3153,175,0,2,0,9,0
34863,62,2603,1043,504,840,53,9,147,1096,9,180,112,198,189,310,1377,2344,4,11604,644,0,2,0,12,0
34864,22,942,373,158,315,8,0,51,381,5,76,44,79,81,123,486,779,2,2026,112,0,2,1,7,0
34865,67,2869,1178,367,1042,6,15,115,1184,9,94,51,95,103,146,644,976,4,4439,246,0,2,17,5,0
34866,71,3615,1943,715,1694,26,18,214,1969,12,185,120,237,197,357,1436,2721,7,20915,1161,0,2,1,2,0
34867,66,2745,1020,354,843,12,15,144,1032,8,134,77,144,142,221,970,1580,4,6792,377,0,2,26,0,1
34868,307,6253,1457,730,1242,11,6,188,1468,10,292,166,329,302,495,2424,4078,5,22973,1276,1,2,1,1,0
34869,307,6253,74,35,59,1,0,14,75,3,14,7,14,17,21,58,85,1,128,7,0,2,1,1,0
34870,307,6253,245,125,200,5,7,34,250,7,30,17,34,37,51,166,265,3,1053,58,0,2,1,1,0
34871,49,571,647,139,84,35,284,233,682,0,0,0,0,0,0,0,0,0,0,0,0,2,13,0,0
34872,571,12251,72,33,56,0,4,12,72,1,1,1,1,2,2,0,2,0,1,0,0,2,35,26,0
34873,571,12251,1454,835,1044,76,110,219,1530,17,275,158,296,292,454,2297,3718,9,34017,1889,1,2,35,26,0
34874,122,2648,1043,504,840,53,9,147,1096,9,180,112,198,189,310,1377,2344,4,11604,644,0,2,14,1,0
34875,122,2648,383,288,292,26,6,62,409,11,65,38,67,76,105,429,656,5,3719,206,0,2,14,1,0
34876,18,355,294,64,250,0,0,43,294,1,20,10,20,21,30,86,131,0,65,3,0,0,59,0,0
34877,18,355,78,46,62,3,0,14,81,3,8,4,8,11,12,28,41,1,62,3,0,0,59,0,0
34878,5,103,110,30,77,3,13,16,113,4,21,15,30,25,45,100,208,2,597,33,0,0,19,0,0
34879,5,103,28,15,21,1,0,6,29,0,0,0,0,0,0,0,0,0,0,0,0,0,19,0,0
34880,313,6325,1457,730,1242,11,6,188,1468,10,292,166,329,302,495,2424,4078,5,22973,1276,1,2,24,8,1
34881,313,6325,74,35,59,1,0,14,75,3,14,7,14,17,21,58,85,1,128,7,0,2,24,8,1
34882,313,6325,245,125,200,5,7,34,250,7,30,17,34,37,51,166,265,3,1053,58,0,2,24,8,1
34883,24,834,74,35,59,1,0,14,75,3,14,7,14,17,21,58,85,1,128,7,0,2,4,0,1
34884,24,834,245,125,200,5,7,34,250,7,30,17,34,37,51,166,265,3,1053,58,0,2,4,0,1
34885,62,3185,1457,730,1242,11,6,188,1468,10,292,166,329,302,495,2424,4078,5,22973,1276,1,2,89,0,1
34886,313,6325,1457,730,1242,11,6,188,1468,10,292,166,329,302,495,2424,4078,5,22973,1276,1,2,24,8,0
34887,313,6325,74,35,59,1,0,14,75,3,14,7,14,17,21,58,85,1,128,7,0,2,24,8,0
34888,313,6325,245,125,200,5,7,34,250,7,30,17,34,37,51,166,265,3,1053,58,0,2,24,8,0
34889,24,834,74,35,59,1,0,14,75,3,14,7,14,17,21,58,85,1,128,7,0,2,4,0,0
34890,24,834,245,125,200,5,7,34,250,7,30,17,34,37,51,166,265,3,1053,58,0,2,4,0,0
34891,62,3185,1457,730,1242,11,6,188,1468,10,292,166,329,302,495,2424,4078,5,22973,1276,1,2,89,0,0
34892,149,4786,1660,832,1314,41,38,274,1701,20,312,209,395,332,604,2671,5058,12,64042,3557,1,2,7,0,1
34893,149,4786,1057,646,719,113,100,145,1170,18,215,134,248,233,382,1740,3004,10,31186,1732,1,2,7,0,1
34894,138,3638,1660,832,1314,41,38,274,1701,20,312,209,395,332,604,2671,5058,12,64042,3557,1,2,27,0,1
34895,185,3788,1943,715,1694,26,18,214,1969,12,185,120,237,197,357,1436,2721,7,20915,1161,0,2,11,2,1
34896,185,3788,1168,838,957,57,25,144,1225,19,348,224,416,367,640,3018,5452,11,61921,3440,1,2,11,2,1
34897,58,2959,1457,730,1242,11,6,188,1468,10,292,166,329,302,495,2424,4078,5,22973,1276,1,2,1,1,1
34898,71,3662,1943,715,1694,26,18,214,1969,12,185,120,237,197,357,1436,2721,7,20915,1161,0,2,12,2,1
34899,153,4888,1660,832,1314,41,38,274,1701,20,312,209,395,332,604,2671,5058,12,64042,3557,1,2,15,5,1
34900,153,4888,1057,646,719,113,100,145,1170,18,215,134,248,233,382,1740,3004,10,31186,1732,1,2,15,5,1
34901,77,2775,1450,624,1228,12,26,181,1462,14,306,186,354,320,540,2580,4493,8,36391,2021,1,2,8,0,1
34902,78,2812,1450,624,1228,12,26,181,1462,14,306,186,354,320,540,2580,4493,8,36391,2021,1,2,10,0,0
34903,185,3788,1943,715,1694,26,18,214,1969,12,185,120,237,197,357,1436,2721,7,20915,1161,0,2,1,1,1
34904,185,3788,1168,838,957,57,25,144,1225,19,348,224,416,367,640,3018,5452,11,61921,3440,1,2,1,1,1
34905,71,3662,1943,715,1694,26,18,214,1969,12,185,120,237,197,357,1436,2721,7,20915,1161,0,2,1,1,1
34908,35,724,2,2,2,0,0,0,2,0,0,0,0,0,0,0,0,0,0,0,0,2,0,13,1
34922,35,724,99,48,90,1,3,5,100,0,0,0,0,0,0,0,0,0,0,0,0,2,0,13,1
34923,35,724,8,5,5,2,0,1,10,0,0,0,0,0,0,0,0,0,0,0,0,2,0,13,1
34924,35,724,1217,716,841,84,126,174,1301,14,185,118,215,199,333,1446,2542,8,20687,1149,0,2,0,13,1
34925,35,724,160,89,115,0,13,31,160,7,15,11,17,22,28,78,124,3,495,27,0,2,0,13,1
34926,35,724,10,10,9,9,0,0,19,0,0,0,0,0,0,0,0,0,0,0,0,2,0,13,1
34927,35,724,173,84,99,8,29,36,181,5,12,7,13,17,20,54,81,2,221,12,0,2,0,13,1
34928,35,724,3,1,1,3,0,0,6,0,0,0,0,0,0,0,0,0,0,0,0,2,0,13,1
34929,313,6325,1457,730,1242,11,6,188,1468,10,292,166,329,302,495,2424,4078,5,22973,1276,1,2,1,1,1
34930,313,6325,74,35,59,1,0,14,75,3,14,7,14,17,21,58,85,1,128,7,0,2,1,1,1
34931,313,6325,245,125,200,5,7,34,250,7,30,17,34,37,51,166,265,3,1053,58,0,2,1,1,1
34932,176,3641,1943,715,1694,26,18,214,1969,12,185,120,237,197,357,1436,2721,7,20915,1161,0,2,0,14,1
34933,176,3641,1168,838,957,57,25,144,1225,19,348,224,416,367,640,3018,5452,11,61921,3440,1,2,0,14,1
34934,75,2695,1450,624,1228,12,26,181,1462,14,306,186,354,320,540,2580,4493,8,36391,2021,1,2,3,11,1
34935,62,3181,1457,730,1242,11,6,188,1468,10,292,166,329,302,495,2424,4078,5,22973,1276,1,2,1,1,1
34936,67,2869,1178,367,1042,6,15,115,1184,9,94,51,95,103,146,644,976,4,4439,246,0,2,3,3,1
34937,71,3566,1943,715,1694,26,18,214,1969,12,185,120,237,197,357,1436,2721,7,20915,1161,0,2,0,9,1
34938,313,6326,1457,730,1242,11,6,188,1468,10,292,166,329,302,495,2424,4078,5,22973,1276,1,2,2,1,1
34939,313,6326,74,35,59,1,0,14,75,3,14,7,14,17,21,58,85,1,128,7,0,2,2,1,1
34940,313,6326,245,125,200,5,7,34,250,7,30,17,34,37,51,166,265,3,1053,58,0,2,2,1,1
34941,7,139,44,22,19,0,19,6,44,2,10,6,12,12,18,35,64,1,77,4,0,0,45,0,1
34942,15,485,42,7,35,4,0,5,46,1,2,1,2,3,3,2,4,0,2,0,0,2,2,24,0
34943,15,485,11,6,10,0,0,1,11,2,4,2,4,6,6,10,15,1,15,0,0,2,2,24,0
34946,35,724,2,2,2,0,0,0,2,0,0,0,0,0,0,0,0,0,0,0,0,2,0,13,0
34960,35,724,99,48,90,1,3,5,100,0,0,0,0,0,0,0,0,0,0,0,0,2,0,13,0
34961,35,724,8,5,5,2,0,1,10,0,0,0,0,0,0,0,0,0,0,0,0,2,0,13,0
34962,35,724,1217,716,841,84,126,174,1301,14,185,118,215,199,333,1446,2542,8,20687,1149,0,2,0,13,0
34963,35,724,160,89,115,0,13,31,160,7,15,11,17,22,28,78,124,3,495,27,0,2,0,13,0
34964,35,724,10,10,9,9,0,0,19,0,0,0,0,0,0,0,0,0,0,0,0,2,0,13,0
34965,35,724,173,84,99,8,29,36,181,5,12,7,13,17,20,54,81,2,221,12,0,2,0,13,0
34966,35,724,3,1,1,3,0,0,6,0,0,0,0,0,0,0,0,0,0,0,0,2,0,13,0
34967,313,6326,1457,730,1242,11,6,188,1468,10,292,166,329,302,495,2424,4078,5,22973,1276,1,2,3,2,0
34968,313,6326,74,35,59,1,0,14,75,3,14,7,14,17,21,58,85,1,128,7,0,2,3,2,0
34969,313,6326,245,125,200,5,7,34,250,7,30,17,34,37,51,166,265,3,1053,58,0,2,3,2,0
34970,7,139,44,22,19,0,19,6,44,2,10,6,12,12,18,35,64,1,77,4,0,0,45,0,0
34971,176,3641,1943,715,1694,26,18,214,1969,12,185,120,237,197,357,1436,2721,7,20915,1161,0,2,0,14,0
34972,176,3641,1168,838,957,57,25,144,1225,19,348,224,416,367,640,3018,5452,11,61921,3440,1,2,0,14,0
34973,75,2695,1450,624,1228,12,26,181,1462,14,306,186,354,320,540,2580,4493,8,36391,2021,1,2,3,11,0
34974,62,3181,1457,730,1242,11,6,188,1468,10,292,166,329,302,495,2424,4078,5,22973,1276,1,2,1,1,0
34975,67,2869,1178,367,1042,6,15,115,1184,9,94,51,95,103,146,644,976,4,4439,246,0,2,3,3,0
34976,71,3566,1943,715,1694,26,18,214,1969,12,185,120,237,197,357,1436,2721,7,20915,1161,0,2,0,9,0
34979,153,4888,1660,832,1314,41,38,274,1701,20,312,209,395,332,604,2671,5058,12,64042,3557,1,2,15,5,0
34980,153,4888,1057,646,719,113,100,145,1170,18,215,134,248,233,382,1740,3004,10,31186,1732,1,2,15,5,0
34981,77,2760,1450,624,1228,12,26,181,1462,14,306,186,354,320,540,2580,4493,8,36391,2021,1,2,18,0,0
34982,149,4786,1660,832,1314,41,38,274,1701,20,312,209,395,332,604,2671,5058,12,64042,3557,1,2,0,2,0
34983,149,4786,1057,646,719,113,100,145,1170,18,215,134,248,233,382,1740,3004,10,31186,1732,1,2,0,2,0
34984,149,4786,1660,832,1314,41,38,274,1701,20,312,209,395,332,604,2671,5058,12,64042,3557,1,2,5,0,0
34985,149,4786,1057,646,719,113,100,145,1170,18,215,134,248,233,382,1740,3004,10,31186,1732,1,2,5,0,0
34986,138,3638,1660,832,1314,41,38,274,1701,20,312,209,395,332,604,2671,5058,12,64042,3557,1,2,27,0,0
34987,66,2745,1020,354,843,12,15,144,1032,8,134,77,144,142,221,970,1580,4,6792,377,0,2,2,2,0
34988,66,2745,1020,354,843,12,15,144,1032,8,134,77,144,142,221,970,1580,4,6792,377,0,2,26,0,0
34989,14,470,42,7,35,4,0,5,46,1,2,1,2,3,3,2,4,0,2,0,0,2,3,3,1
34990,14,470,11,6,10,0,0,1,11,2,4,2,4,6,6,10,15,1,15,0,0,2,3,3,1
34991,92,2960,773,419,590,28,0,166,801,10,204,113,217,214,330,1598,2554,5,13587,754,0,2,1,3,1
34992,14,470,42,7,35,4,0,5,46,1,2,1,2,3,3,2,4,0,2,0,0,2,3,3,0
34993,14,470,11,6,10,0,0,1,11,2,4,2,4,6,6,10,15,1,15,0,0,2,3,3,0
34994,92,2960,773,419,590,28,0,166,801,10,204,113,217,214,330,1598,2554,5,13587,754,0,2,1,3,0
35020,313,6326,1457,730,1242,11,6,188,1468,10,292,166,329,302,495,2424,4078,5,22973,1276,1,2,31,10,0
35021,313,6326,74,35,59,1,0,14,75,3,14,7,14,17,21,58,85,1,128,7,0,2,31,10,0
35022,313,6326,245,125,200,5,7,34,250,7,30,17,34,37,51,166,265,3,1053,58,0,2,31,10,0
35026,571,12251,72,33,56,0,4,12,72,1,1,1,1,2,2,0,2,0,1,0,0,2,6,0,0
35027,571,12251,1454,835,1044,76,110,219,1530,17,275,158,296,292,454,2297,3718,9,34017,1889,1,2,6,0,0
35030,14,470,42,7,35,4,0,5,46,1,2,1,2,3,3,2,4,0,2,0,0,2,5,27,0
35031,14,470,11,6,10,0,0,1,11,2,4,2,4,6,6,10,15,1,15,0,0,2,5,27,0
35033,77,2760,1450,624,1228,12,26,181,1462,14,306,186,354,320,540,2580,4493,8,36391,2021,1,2,21,11,0
35034,62,3181,1457,730,1242,11,6,188,1468,10,292,166,329,302,495,2424,4078,5,22973,1276,1,2,90,1,0
35041,67,2869,1178,367,1042,6,15,115,1184,9,94,51,95,103,146,644,976,4,4439,246,0,2,20,8,0
35042,71,3566,1943,715,1694,26,18,214,1969,12,185,120,237,197,357,1436,2721,7,20915,1161,0,2,1,11,0
35043,122,2648,1043,504,840,53,9,147,1096,9,180,112,198,189,310,1377,2344,4,11604,644,0,2,2,2,1
35044,122,2648,383,288,292,26,6,62,409,11,65,38,67,76,105,429,656,5,3719,206,0,2,2,2,1
35045,20,400,294,64,250,0,0,43,294,1,20,10,20,21,30,86,131,0,65,3,0,2,9,2,1
35046,20,400,78,46,62,3,0,14,81,3,8,4,8,11,12,28,41,1,62,3,0,2,9,2,1
35047,5,110,110,30,77,3,13,16,113,4,21,15,30,25,45,100,208,2,597,33,0,2,1,0,1
35048,5,110,28,15,21,1,0,6,29,0,0,0,0,0,0,0,0,0,0,0,0,2,1,0,1
35049,20,400,294,64,250,0,0,43,294,1,20,10,20,21,30,86,131,0,65,3,0,2,9,3,1
35050,20,400,78,46,62,3,0,14,81,3,8,4,8,11,12,28,41,1,62,3,0,2,9,3,1
35051,5,110,110,30,77,3,13,16,113,4,21,15,30,25,45,100,208,2,597,33,0,2,5,2,1
35052,5,110,28,15,21,1,0,6,29,0,0,0,0,0,0,0,0,0,0,0,0,2,5,2,1
35053,314,6367,1457,730,1242,11,6,188,1468,10,292,166,329,302,495,2424,4078,5,22973,1276,1,2,6,0,0
35054,314,6367,74,35,59,1,0,14,75,3,14,7,14,17,21,58,85,1,128,7,0,2,6,0,0
35055,314,6367,245,125,200,5,7,34,250,7,30,17,34,37,51,166,265,3,1053,58,0,2,6,0,0
35056,37,2203,652,304,544,16,6,88,668,6,89,51,101,95,152,591,998,3,3399,188,0,2,13,0,0
35059,58,2960,1457,730,1242,11,6,188,1468,10,292,166,329,302,495,2424,4078,5,22973,1276,1,2,3,3,1
35060,122,2648,1043,504,840,53,9,147,1096,9,180,112,198,189,310,1377,2344,4,11604,644,0,2,2,2,0
35061,122,2648,383,288,292,26,6,62,409,11,65,38,67,76,105,429,656,5,3719,206,0,2,2,2,0
35062,20,400,294,64,250,0,0,43,294,1,20,10,20,21,30,86,131,0,65,3,0,2,17,4,0
35063,20,400,78,46,62,3,0,14,81,3,8,4,8,11,12,28,41,1,62,3,0,2,17,4,0
35064,5,110,110,30,77,3,13,16,113,4,21,15,30,25,45,100,208,2,597,33,0,2,6,2,0
35065,5,110,28,15,21,1,0,6,29,0,0,0,0,0,0,0,0,0,0,0,0,2,6,2,0
35066,155,4940,1660,832,1314,41,38,274,1701,20,312,209,395,332,604,2671,5058,12,64042,3557,1,2,5,0,1
35067,155,4940,1057,646,719,113,100,145,1170,18,215,134,248,233,382,1740,3004,10,31186,1732,1,2,5,0,1
35069,311,6296,1457,730,1242,11,6,188,1468,10,292,166,329,302,495,2424,4078,5,22973,1276,1,2,9,15,1
35070,311,6296,74,35,59,1,0,14,75,3,14,7,14,17,21,58,85,1,128,7,0,2,9,15,1
35071,311,6296,245,125,200,5,7,34,250,7,30,17,34,37,51,166,265,3,1053,58,0,2,9,15,1
35073,55,1468,1455,414,1257,16,76,112,1471,5,41,23,46,46,69,231,381,2,1069,59,0,2,1,1,1
35074,55,1468,669,365,481,22,61,110,691,15,103,63,122,118,185,747,1273,8,11311,628,0,2,1,1,1
35075,572,12277,72,33,56,0,4,12,72,1,1,1,1,2,2,0,2,0,1,0,0,2,18,11,1
35076,572,12277,1454,835,1044,76,110,219,1530,17,275,158,296,292,454,2297,3718,9,34017,1889,1,2,18,11,1
35077,139,6353,1392,870,1177,35,17,170,1427,14,494,280,531,508,811,4473,7289,7,54850,3047,2,2,1,1,1
35078,146,6571,139,89,101,2,0,35,141,7,54,34,62,61,96,330,569,4,2287,127,0,2,27,19,1
35079,146,6571,7,5,5,0,0,2,7,1,2,1,2,3,3,2,4,0,2,0,0,2,27,19,1
35080,90,4801,1782,648,1425,9,47,279,1791,8,171,97,189,179,286,1292,2140,4,9462,525,0,2,2,2,1
35081,143,3771,1660,832,1314,41,38,274,1701,20,312,209,395,332,604,2671,5058,12,64042,3557,1,2,45,12,1
35082,65,3259,1457,730,1242,11,6,188,1468,10,292,166,329,302,495,2424,4078,5,22973,1276,1,2,17,0,1
35083,39,2275,334,251,279,10,4,40,344,5,127,74,143,132,217,899,1528,2,4303,239,0,2,3,0,1
35084,34,1289,1293,570,1093,25,15,163,1318,10,195,123,241,205,364,1516,2795,6,17273,959,0,2,2,2,1
35085,155,4940,1660,832,1314,41,38,274,1701,20,312,209,395,332,604,2671,5058,12,64042,3557,1,2,5,0,0
35086,155,4940,1057,646,719,113,100,145,1170,18,215,134,248,233,382,1740,3004,10,31186,1732,1,2,5,0,0
35088,311,6296,1457,730,1242,11,6,188,1468,10,292,166,329,302,495,2424,4078,5,22973,1276,1,2,9,15,0
35089,311,6296,74,35,59,1,0,14,75,3,14,7,14,17,21,58,85,1,128,7,0,2,9,15,0
35090,311,6296,245,125,200,5,7,34,250,7,30,17,34,37,51,166,265,3,1053,58,0,2,9,15,0
35092,55,1468,1455,414,1257,16,76,112,1471,5,41,23,46,46,69,231,381,2,1069,59,0,2,1,1,0
35093,55,1468,669,365,481,22,61,110,691,15,103,63,122,118,185,747,1273,8,11311,628,0,2,1,1,0
35094,572,12277,72,33,56,0,4,12,72,1,1,1,1,2,2,0,2,0,1,0,0,2,18,11,0
35095,572,12277,1454,835,1044,76,110,219,1530,17,275,158,296,292,454,2297,3718,9,34017,1889,1,2,18,11,0
35096,139,6353,1392,870,1177,35,17,170,1427,14,494,280,531,508,811,4473,7289,7,54850,3047,2,2,1,1,0
35097,146,6571,139,89,101,2,0,35,141,7,54,34,62,61,96,330,569,4,2287,127,0,2,27,19,0
35098,146,6571,7,5,5,0,0,2,7,1,2,1,2,3,3,2,4,0,2,0,0,2,27,19,0
35099,90,4801,1782,648,1425,9,47,279,1791,8,171,97,189,179,286,1292,2140,4,9462,525,0,2,2,2,0
35100,143,3771,1660,832,1314,41,38,274,1701,20,312,209,395,332,604,2671,5058,12,64042,3557,1,2,45,12,0
35101,65,3259,1457,730,1242,11,6,188,1468,10,292,166,329,302,495,2424,4078,5,22973,1276,1,2,17,0,0
35102,39,2275,334,251,279,10,4,40,344,5,127,74,143,132,217,899,1528,2,4303,239,0,2,3,0,0
35103,34,1289,1293,570,1093,25,15,163,1318,10,195,123,241,205,364,1516,2795,6,17273,959,0,2,2,2,0
35104,40,775,207,111,150,11,0,50,218,5,26,19,36,31,55,133,272,3,943,52,0,0,203,0,1
35105,40,775,410,198,237,31,55,97,441,11,63,38,72,74,110,414,683,6,4293,238,0,0,203,0,1
35106,311,6296,1457,730,1242,11,6,188,1468,10,292,166,329,302,495,2424,4078,5,22973,1276,1,2,1,1,1
35107,311,6296,74,35,59,1,0,14,75,3,14,7,14,17,21,58,85,1,128,7,0,2,1,1,1
35108,311,6296,245,125,200,5,7,34,250,7,30,17,34,37,51,166,265,3,1053,58,0,2,1,1,1
35111,222,4933,4293,999,3693,19,54,507,4312,9,155,88,170,164,258,1156,1898,4,9368,520,0,0,1083,0,1
35112,222,4933,1482,859,1002,125,135,219,1607,16,219,134,251,235,385,1766,3032,9,27804,1544,1,0,1083,0,1
35113,309,6680,72,33,56,0,4,12,72,1,1,1,1,2,2,0,2,0,1,0,0,2,33,1241,1
35114,309,6680,1454,835,1044,76,110,219,1530,17,275,158,296,292,454,2297,3718,9,34017,1889,1,2,33,1241,1
35115,85,3922,1338,495,1086,10,64,173,1348,11,122,82,157,133,239,883,1686,7,11934,663,0,2,1,1,1
35116,146,6569,139,89,101,2,0,35,141,7,54,34,62,61,96,330,569,4,2287,127,0,2,16,17,1
35117,146,6569,7,5,5,0,0,2,7,1,2,1,2,3,3,2,4,0,2,0,0,2,16,17,1
35118,32,933,465,148,393,5,8,60,470,4,31,20,31,35,51,161,261,2,523,29,0,2,3,3,1
35119,32,933,16,12,9,0,0,6,16,1,2,1,2,3,3,2,4,0,2,0,0,2,3,3,1
35120,90,4801,1782,648,1425,9,47,279,1791,8,171,97,189,179,286,1292,2140,4,9462,525,0,2,7,7,1
35121,117,2369,1513,682,1277,25,13,200,1538,11,199,116,219,210,335,1557,2584,6,15641,868,0,2,2,2,1
35122,117,2369,819,519,539,24,98,155,843,15,96,57,106,111,163,690,1107,8,9171,509,0,2,2,2,1
35123,587,12550,72,33,56,0,4,12,72,1,1,1,1,2,2,0,2,0,1,0,0,2,80,37,1
35124,587,12550,1454,835,1044,76,110,219,1530,17,275,158,296,292,454,2297,3718,9,34017,1889,1,2,80,37,1
35125,23,679,339,213,244,17,9,65,356,10,42,26,48,52,74,259,421,5,2410,133,0,2,18,6,1
35126,40,775,207,111,150,11,0,50,218,5,26,19,36,31,55,133,272,3,943,52,0,0,203,0,0
35127,40,775,410,198,237,31,55,97,441,11,63,38,72,74,110,414,683,6,4293,238,0,0,203,0,0
35128,311,6296,1457,730,1242,11,6,188,1468,10,292,166,329,302,495,2424,4078,5,22973,1276,1,2,1,1,0
35129,311,6296,74,35,59,1,0,14,75,3,14,7,14,17,21,58,85,1,128,7,0,2,1,1,0
35130,311,6296,245,125,200,5,7,34,250,7,30,17,34,37,51,166,265,3,1053,58,0,2,1,1,0
35133,222,4933,4293,999,3693,19,54,507,4312,9,155,88,170,164,258,1156,1898,4,9368,520,0,0,1083,0,0
35134,222,4933,1482,859,1002,125,135,219,1607,16,219,134,251,235,385,1766,3032,9,27804,1544,1,0,1083,0,0
35135,309,6680,72,33,56,0,4,12,72,1,1,1,1,2,2,0,2,0,1,0,0,2,33,1241,0
35136,309,6680,1454,835,1044,76,110,219,1530,17,275,158,296,292,454,2297,3718,9,34017,1889,1,2,33,1241,0
35137,85,3922,1338,495,1086,10,64,173,1348,11,122,82,157,133,239,883,1686,7,11934,663,0,2,1,1,0
35138,146,6569,139,89,101,2,0,35,141,7,54,34,62,61,96,330,569,4,2287,127,0,2,16,17,0
35139,146,6569,7,5,5,0,0,2,7,1,2,1,2,3,3,2,4,0,2,0,0,2,16,17,0
35140,32,933,465,148,393,5,8,60,470,4,31,20,31,35,51,161,261,2,523,29,0,2,3,3,0
35141,32,933,16,12,9,0,0,6,16,1,2,1,2,3,3,2,4,0,2,0,0,2,3,3,0
35142,90,4801,1782,648,1425,9,47,279,1791,8,171,97,189,179,286,1292,2140,4,9462,525,0,2,7,7,0
35150,237,5206,4293,999,3693,19,54,507,4312,9,155,88,170,164,258,1156,1898,4,9368,520,0,0,1126,0,1
35151,237,5206,1482,859,1002,125,135,219,1607,16,219,134,251,235,385,1766,3032,9,27804,1544,1,0,1126,0,1
35152,309,6680,72,33,56,0,4,12,72,1,1,1,1,2,2,0,2,0,1,0,0,2,33,1288,1
35153,309,6680,1454,835,1044,76,110,219,1530,17,275,158,296,292,454,2297,3718,9,34017,1889,1,2,33,1288,1
35160,237,5209,4293,999,3693,19,54,507,4312,9,155,88,170,164,258,1156,1898,4,9368,520,0,2,19,0,1
35161,237,5209,1482,859,1002,125,135,219,1607,16,219,134,251,235,385,1766,3032,9,27804,1544,1,2,19,0,1
35162,114,4432,1513,682,1277,25,13,200,1538,11,199,116,219,210,335,1557,2584,6,15641,868,0,2,19,0,1
35163,309,6699,72,33,56,0,4,12,72,1,1,1,1,2,2,0,2,0,1,0,0,2,2,2,1
35164,309,6699,1454,835,1044,76,110,219,1530,17,275,158,296,292,454,2297,3718,9,34017,1889,1,2,2,2,1
35165,78,3212,1289,550,1043,56,32,155,1345,10,167,93,185,177,278,1266,2075,5,11498,638,0,2,15,0,1
35166,91,2970,773,419,590,28,0,166,801,10,204,113,217,214,330,1598,2554,5,13587,754,0,2,5,5,1
35167,222,4950,4293,999,3693,19,54,507,4312,9,155,88,170,164,258,1156,1898,4,9368,520,0,2,5,0,1
35168,222,4950,1482,859,1002,125,135,219,1607,16,219,134,251,235,385,1766,3032,9,27804,1544,1,2,5,0,1
35169,79,3247,1289,550,1043,56,32,155,1345,10,167,93,185,177,278,1266,2075,5,11498,638,0,2,16,0,1
35172,35,724,2,2,2,0,0,0,2,0,0,0,0,0,0,0,0,0,0,0,0,2,2,2,1
35186,35,724,99,48,90,1,3,5,100,0,0,0,0,0,0,0,0,0,0,0,0,2,2,2,1
35187,35,724,8,5,5,2,0,1,10,0,0,0,0,0,0,0,0,0,0,0,0,2,2,2,1
35188,35,724,1217,716,841,84,126,174,1301,14,185,118,215,199,333,1446,2542,8,20687,1149,0,2,2,2,1
35189,35,724,160,89,115,0,13,31,160,7,15,11,17,22,28,78,124,3,495,27,0,2,2,2,1
35190,35,724,10,10,9,9,0,0,19,0,0,0,0,0,0,0,0,0,0,0,0,2,2,2,1
35191,35,724,173,84,99,8,29,36,181,5,12,7,13,17,20,54,81,2,221,12,0,2,2,2,1
35192,35,724,3,1,1,3,0,0,6,0,0,0,0,0,0,0,0,0,0,0,0,2,2,2,1
35193,222,4964,4293,999,3693,19,54,507,4312,9,155,88,170,164,258,1156,1898,4,9368,520,0,2,5,3,1
35194,222,4964,1482,859,1002,125,135,219,1607,16,219,134,251,235,385,1766,3032,9,27804,1544,1,2,5,3,1
35195,46,949,447,308,343,6,5,95,453,7,96,59,111,103,170,651,1136,4,4600,255,0,2,7,4,1
35196,46,949,322,174,179,16,74,51,338,10,41,26,46,51,72,252,408,5,2291,127,0,2,7,4,1
35197,220,4885,722,423,573,19,0,135,741,12,172,101,199,184,300,1320,2257,6,15668,870,0,2,2,1,1
35198,220,4885,1508,847,911,44,250,301,1552,14,148,88,169,162,257,1120,1886,7,15077,837,0,2,2,1,1
35199,16,468,442,244,305,14,16,103,456,11,68,45,75,79,120,452,756,6,4588,254,0,2,2,2,1
35200,16,468,182,102,99,11,40,35,193,3,11,6,11,14,17,42,64,1,97,5,0,2,2,2,1
35201,139,6357,1392,870,1177,35,17,170,1427,14,494,280,531,508,811,4473,7289,7,54850,3047,2,2,3,1,1
35202,85,3904,1338,495,1086,10,64,173,1348,11,122,82,157,133,239,883,1686,7,11934,663,0,2,7,4,1
35203,146,6582,139,89,101,2,0,35,141,7,54,34,62,61,96,330,569,4,2287,127,0,2,128,48,1
35204,146,6582,7,5,5,0,0,2,7,1,2,1,2,3,3,2,4,0,2,0,0,2,128,48,1
35205,32,933,465,148,393,5,8,60,470,4,31,20,31,35,51,161,261,2,523,29,0,2,5,2,1
35206,32,933,16,12,9,0,0,6,16,1,2,1,2,3,3,2,4,0,2,0,0,2,5,2,1
35207,90,4801,1782,648,1425,9,47,279,1791,8,171,97,189,179,286,1292,2140,4,9462,525,0,2,25,12,1
35208,77,2760,1450,624,1228,12,26,181,1462,14,306,186,354,320,540,2580,4493,8,36391,2021,1,2,6,3,1
35209,76,3740,1523,757,1297,19,12,193,1542,12,193,117,230,205,347,1508,2664,7,19053,1058,0,2,13,4,1
35210,66,2745,1020,354,843,12,15,144,1032,8,134,77,144,142,221,970,1580,4,6792,377,0,2,2,1,1
35211,38,1616,447,308,343,6,5,95,453,7,96,59,111,103,170,651,1136,4,4600,255,0,2,4,3,1
35212,34,1295,1293,570,1093,25,15,163,1318,10,195,123,241,205,364,1516,2795,6,17273,959,0,2,4,1,1
35213,62,2603,1043,504,840,53,9,147,1096,9,180,112,198,189,310,1377,2344,4,11604,644,0,2,3,1,1
35214,13,413,295,56,236,0,4,54,295,2,9,5,10,11,15,30,51,1,57,3,0,2,2,1,1
35215,67,2869,1178,367,1042,6,15,115,1184,9,94,51,95,103,146,644,976,4,4439,246,0,2,4,2,1
35216,71,3566,1943,715,1694,26,18,214,1969,12,185,120,237,197,357,1436,2721,7,20915,1161,0,2,9,3,1
35217,39,1537,1098,241,925,5,10,155,1103,7,46,25,49,53,74,273,423,3,1580,87,0,2,2,2,1
35218,23,680,339,213,244,17,9,65,356,10,42,26,48,52,74,259,421,5,2410,133,0,2,2,1,1
35219,38,1395,1293,570,1093,25,15,163,1318,10,195,123,241,205,364,1516,2795,6,17273,959,0,2,25,0,1
35222,35,724,2,2,2,0,0,0,2,0,0,0,0,0,0,0,0,0,0,0,0,2,2,2,0
35236,35,724,99,48,90,1,3,5,100,0,0,0,0,0,0,0,0,0,0,0,0,2,2,2,0
35237,35,724,8,5,5,2,0,1,10,0,0,0,0,0,0,0,0,0,0,0,0,2,2,2,0
35238,35,724,1217,716,841,84,126,174,1301,14,185,118,215,199,333,1446,2542,8,20687,1149,0,2,2,2,0
35239,35,724,160,89,115,0,13,31,160,7,15,11,17,22,28,78,124,3,495,27,0,2,2,2,0
35240,35,724,10,10,9,9,0,0,19,0,0,0,0,0,0,0,0,0,0,0,0,2,2,2,0
35241,35,724,173,84,99,8,29,36,181,5,12,7,13,17,20,54,81,2,221,12,0,2,2,2,0
35242,35,724,3,1,1,3,0,0,6,0,0,0,0,0,0,0,0,0,0,0,0,2,2,2,0
35243,222,4964,4293,999,3693,19,54,507,4312,9,155,88,170,164,258,1156,1898,4,9368,520,0,2,8,1,0
35244,222,4964,1482,859,1002,125,135,219,1607,16,219,134,251,235,385,1766,3032,9,27804,1544,1,2,8,1,0
35245,46,949,447,308,343,6,5,95,453,7,96,59,111,103,170,651,1136,4,4600,255,0,2,7,4,0
35246,46,949,322,174,179,16,74,51,338,10,41,26,46,51,72,252,408,5,2291,127,0,2,7,4,0
35247,220,4885,722,423,573,19,0,135,741,12,172,101,199,184,300,1320,2257,6,15668,870,0,2,2,1,0
35248,220,4885,1508,847,911,44,250,301,1552,14,148,88,169,162,257,1120,1886,7,15077,837,0,2,2,1,0
35249,309,6699,72,33,56,0,4,12,72,1,1,1,1,2,2,0,2,0,1,0,0,2,2,2,0
35250,309,6699,1454,835,1044,76,110,219,1530,17,275,158,296,292,454,2297,3718,9,34017,1889,1,2,2,2,0
35251,16,468,442,244,305,14,16,103,456,11,68,45,75,79,120,452,756,6,4588,254,0,2,2,2,0
35252,16,468,182,102,99,11,40,35,193,3,11,6,11,14,17,42,64,1,97,5,0,2,2,2,0
35253,79,3247,1289,550,1043,56,32,155,1345,10,167,93,185,177,278,1266,2075,5,11498,638,0,2,31,0,0
35254,139,6357,1392,870,1177,35,17,170,1427,14,494,280,531,508,811,4473,7289,7,54850,3047,2,2,3,1,0
35255,91,2970,773,419,590,28,0,166,801,10,204,113,217,214,330,1598,2554,5,13587,754,0,2,5,5,0
35256,85,3904,1338,495,1086,10,64,173,1348,11,122,82,157,133,239,883,1686,7,11934,663,0,2,7,4,0
35257,146,6582,139,89,101,2,0,35,141,7,54,34,62,61,96,330,569,4,2287,127,0,2,128,48,0
35258,146,6582,7,5,5,0,0,2,7,1,2,1,2,3,3,2,4,0,2,0,0,2,128,48,0
35259,32,933,465,148,393,5,8,60,470,4,31,20,31,35,51,161,261,2,523,29,0,2,5,2,0
35260,32,933,16,12,9,0,0,6,16,1,2,1,2,3,3,2,4,0,2,0,0,2,5,2,0
35261,90,4801,1782,648,1425,9,47,279,1791,8,171,97,189,179,286,1292,2140,4,9462,525,0,2,25,12,0
35262,77,2760,1450,624,1228,12,26,181,1462,14,306,186,354,320,540,2580,4493,8,36391,2021,1,2,6,3,0
35263,76,3740,1523,757,1297,19,12,193,1542,12,193,117,230,205,347,1508,2664,7,19053,1058,0,2,13,4,0
35264,66,2745,1020,354,843,12,15,144,1032,8,134,77,144,142,221,970,1580,4,6792,377,0,2,2,1,0
35265,38,1616,447,308,343,6,5,95,453,7,96,59,111,103,170,651,1136,4,4600,255,0,2,4,3,0
35266,34,1295,1293,570,1093,25,15,163,1318,10,195,123,241,205,364,1516,2795,6,17273,959,0,2,4,1,0
35267,62,2603,1043,504,840,53,9,147,1096,9,180,112,198,189,310,1377,2344,4,11604,644,0,2,3,1,0
35268,13,413,295,56,236,0,4,54,295,2,9,5,10,11,15,30,51,1,57,3,0,2,2,1,0
35269,67,2869,1178,367,1042,6,15,115,1184,9,94,51,95,103,146,644,976,4,4439,246,0,2,4,2,0
35270,71,3566,1943,715,1694,26,18,214,1969,12,185,120,237,197,357,1436,2721,7,20915,1161,0,2,9,3,0
35271,39,1537,1098,241,925,5,10,155,1103,7,46,25,49,53,74,273,423,3,1580,87,0,2,2,2,0
35272,23,680,339,213,244,17,9,65,356,10,42,26,48,52,74,259,421,5,2410,133,0,2,19,6,0
35273,38,1401,1293,570,1093,25,15,163,1318,10,195,123,241,205,364,1516,2795,6,17273,959,0,2,25,0,0
35274,222,4964,4293,999,3693,19,54,507,4312,9,155,88,170,164,258,1156,1898,4,9368,520,0,2,5,6,1
35275,222,4964,1482,859,1002,125,135,219,1607,16,219,134,251,235,385,1766,3032,9,27804,1544,1,2,5,6,1
35276,222,4964,4293,999,3693,19,54,507,4312,9,155,88,170,164,258,1156,1898,4,9368,520,0,2,5,6,0
35277,222,4964,1482,859,1002,125,135,219,1607,16,219,134,251,235,385,1766,3032,9,27804,1544,1,2,5,6,0
35280,32,614,2,2,2,0,0,0,2,0,0,0,0,0,0,0,0,0,0,0,0,2,22,51,1
35294,32,614,99,48,90,1,3,5,100,0,0,0,0,0,0,0,0,0,0,0,0,2,22,51,1
35295,32,614,8,5,5,2,0,1,10,0,0,0,0,0,0,0,0,0,0,0,0,2,22,51,1
35296,32,614,1217,716,841,84,126,174,1301,14,185,118,215,199,333,1446,2542,8,20687,1149,0,2,22,51,1
35297,32,614,160,89,115,0,13,31,160,7,15,11,17,22,28,78,124,3,495,27,0,2,22,51,1
35298,32,614,10,10,9,9,0,0,19,0,0,0,0,0,0,0,0,0,0,0,0,2,22,51,1
35299,32,614,173,84,99,8,29,36,181,5,12,7,13,17,20,54,81,2,221,12,0,2,22,51,1
35300,32,614,3,1,1,3,0,0,6,0,0,0,0,0,0,0,0,0,0,0,0,2,22,51,1
35301,160,5038,1660,832,1314,41,38,274,1701,20,312,209,395,332,604,2671,5058,12,64042,3557,1,2,24,2,1
35302,160,5038,1057,646,719,113,100,145,1170,18,215,134,248,233,382,1740,3004,10,31186,1732,1,2,24,2,1
35303,326,6554,1457,730,1242,11,6,188,1468,10,292,166,329,302,495,2424,4078,5,22973,1276,1,2,51,1,1
35304,326,6554,74,35,59,1,0,14,75,3,14,7,14,17,21,58,85,1,128,7,0,2,51,1,1
35305,326,6554,245,125,200,5,7,34,250,7,30,17,34,37,51,166,265,3,1053,58,0,2,51,1,1
35306,86,3024,1450,624,1228,12,26,181,1462,14,306,186,354,320,540,2580,4493,8,36391,2021,1,2,110,0,1
35307,140,3706,1660,832,1314,41,38,274,1701,20,312,209,395,332,604,2671,5058,12,64042,3557,1,2,11,35,1
35308,67,3305,1457,730,1242,11,6,188,1468,10,292,166,329,302,495,2424,4078,5,22973,1276,1,2,12,3,1
35309,159,5043,1660,832,1314,41,38,274,1701,20,312,209,395,332,604,2671,5058,12,64042,3557,1,2,3,3,1
35310,159,5043,1057,646,719,113,100,145,1170,18,215,134,248,233,382,1740,3004,10,31186,1732,1,2,3,3,1
35311,221,4925,722,423,573,19,0,135,741,12,172,101,199,184,300,1320,2257,6,15668,870,0,2,11,1,1
35312,221,4925,1508,847,911,44,250,301,1552,14,148,88,169,162,257,1120,1886,7,15077,837,0,2,11,1,1
35315,37,691,2,2,2,0,0,0,2,0,0,0,0,0,0,0,0,0,0,0,0,2,29,0,1
35329,37,691,99,48,90,1,3,5,100,0,0,0,0,0,0,0,0,0,0,0,0,2,29,0,1
35330,37,691,8,5,5,2,0,1,10,0,0,0,0,0,0,0,0,0,0,0,0,2,29,0,1
35331,37,691,1217,716,841,84,126,174,1301,14,185,118,215,199,333,1446,2542,8,20687,1149,0,2,29,0,1
35332,37,691,160,89,115,0,13,31,160,7,15,11,17,22,28,78,124,3,495,27,0,2,29,0,1
35333,37,691,10,10,9,9,0,0,19,0,0,0,0,0,0,0,0,0,0,0,0,2,29,0,1
35334,37,691,173,84,99,8,29,36,181,5,12,7,13,17,20,54,81,2,221,12,0,2,29,0,1
35335,37,691,3,1,1,3,0,0,6,0,0,0,0,0,0,0,0,0,0,0,0,2,29,0,1
35336,160,5038,1660,832,1314,41,38,274,1701,20,312,209,395,332,604,2671,5058,12,64042,3557,1,2,3,3,1
35337,160,5038,1057,646,719,113,100,145,1170,18,215,134,248,233,382,1740,3004,10,31186,1732,1,2,3,3,1
35338,324,6573,1457,730,1242,11,6,188,1468,10,292,166,329,302,495,2424,4078,5,22973,1276,1,2,8,4,1
35339,324,6573,74,35,59,1,0,14,75,3,14,7,14,17,21,58,85,1,128,7,0,2,8,4,1
35340,324,6573,245,125,200,5,7,34,250,7,30,17,34,37,51,166,265,3,1053,58,0,2,8,4,1
35341,91,3201,1450,624,1228,12,26,181,1462,14,306,186,354,320,540,2580,4493,8,36391,2021,1,2,87,14,1
35342,222,4964,4293,999,3693,19,54,507,4312,9,155,88,170,164,258,1156,1898,4,9368,520,0,2,1,1,0
35343,222,4964,1482,859,1002,125,135,219,1607,16,219,134,251,235,385,1766,3032,9,27804,1544,1,2,1,1,0
35344,79,3250,1289,550,1043,56,32,155,1345,10,167,93,185,177,278,1266,2075,5,11498,638,0,2,4,2,0
35371,216,4657,182,127,129,0,0,53,182,5,39,21,42,44,63,217,343,2,926,51,0,2,92,18,0
35372,216,4657,1165,710,800,67,119,181,1232,18,243,153,282,261,435,2000,3492,10,36473,2026,1,2,92,18,0
35375,35,724,2,2,2,0,0,0,2,0,0,0,0,0,0,0,0,0,0,0,0,2,33,28,0
35389,35,724,99,48,90,1,3,5,100,0,0,0,0,0,0,0,0,0,0,0,0,2,33,28,0
35390,35,724,8,5,5,2,0,1,10,0,0,0,0,0,0,0,0,0,0,0,0,2,33,28,0
35391,35,724,1217,716,841,84,126,174,1301,14,185,118,215,199,333,1446,2542,8,20687,1149,0,2,33,28,0
35392,35,724,160,89,115,0,13,31,160,7,15,11,17,22,28,78,124,3,495,27,0,2,33,28,0
35393,35,724,10,10,9,9,0,0,19,0,0,0,0,0,0,0,0,0,0,0,0,2,33,28,0
35394,35,724,173,84,99,8,29,36,181,5,12,7,13,17,20,54,81,2,221,12,0,2,33,28,0
35395,35,724,3,1,1,3,0,0,6,0,0,0,0,0,0,0,0,0,0,0,0,2,33,28,0
35396,155,4940,1660,832,1314,41,38,274,1701,20,312,209,395,332,604,2671,5058,12,64042,3557,1,2,54,28,0
35397,155,4940,1057,646,719,113,100,145,1170,18,215,134,248,233,382,1740,3004,10,31186,1732,1,2,54,28,0
35398,117,2369,1513,682,1277,25,13,200,1538,11,199,116,219,210,335,1557,2584,6,15641,868,0,2,18,7,0
35399,117,2369,819,519,539,24,98,155,843,15,96,57,106,111,163,690,1107,8,9171,509,0,2,18,7,0
35402,311,6296,1457,730,1242,11,6,188,1468,10,292,166,329,302,495,2424,4078,5,22973,1276,1,2,40,25,0
35403,311,6296,74,35,59,1,0,14,75,3,14,7,14,17,21,58,85,1,128,7,0,2,40,25,0
35404,311,6296,245,125,200,5,7,34,250,7,30,17,34,37,51,166,265,3,1053,58,0,2,40,25,0
35406,55,1468,1455,414,1257,16,76,112,1471,5,41,23,46,46,69,231,381,2,1069,59,0,2,12,1,0
35407,55,1468,669,365,481,22,61,110,691,15,103,63,122,118,185,747,1273,8,11311,628,0,2,12,1,0
35408,222,4964,4293,999,3693,19,54,507,4312,9,155,88,170,164,258,1156,1898,4,9368,520,0,0,1089,0,0
35409,222,4964,1482,859,1002,125,135,219,1607,16,219,134,251,235,385,1766,3032,9,27804,1544,1,0,1089,0,0
35411,24,834,74,35,59,1,0,14,75,3,14,7,14,17,21,58,85,1,128,7,0,2,6,2,0
35412,24,834,245,125,200,5,7,34,250,7,30,17,34,37,51,166,265,3,1053,58,0,2,6,2,0
35413,49,571,647,139,84,35,284,233,682,0,0,0,0,0,0,0,0,0,0,0,0,2,20,1,0
35414,71,2075,1523,757,1297,19,12,193,1542,12,193,117,230,205,347,1508,2664,7,19053,1058,0,2,21,0,0
35415,71,2075,701,378,504,33,58,109,734,13,110,68,126,123,194,794,1346,7,10027,557,0,2,21,0,0
35416,175,4054,77,34,69,0,0,8,77,3,24,16,29,27,45,114,213,1,387,21,0,2,9,1,0
35417,175,4054,712,438,573,51,9,84,763,14,102,71,128,116,199,733,1364,8,11988,666,0,2,9,1,0
35420,220,4885,722,423,573,19,0,135,741,12,172,101,199,184,300,1320,2257,6,15668,870,0,2,17,16,0
35421,220,4885,1508,847,911,44,250,301,1552,14,148,88,169,162,257,1120,1886,7,15077,837,0,2,17,16,0
35422,309,6699,72,33,56,0,4,12,72,1,1,1,1,2,2,0,2,0,1,0,0,2,428,1250,0
35423,309,6699,1454,835,1044,76,110,219,1530,17,275,158,296,292,454,2297,3718,9,34017,1889,1,2,428,1250,0
35424,122,2648,1043,504,840,53,9,147,1096,9,180,112,198,189,310,1377,2344,4,11604,644,0,2,18,1,0
35425,122,2648,383,288,292,26,6,62,409,11,65,38,67,76,105,429,656,5,3719,206,0,2,18,1,0
35426,20,400,294,64,250,0,0,43,294,1,20,10,20,21,30,86,131,0,65,3,0,0,72,0,0
35427,20,400,78,46,62,3,0,14,81,3,8,4,8,11,12,28,41,1,62,3,0,0,72,0,0
35428,5,110,110,30,77,3,13,16,113,4,21,15,30,25,45,100,208,2,597,33,0,0,23,0,0
35429,5,110,28,15,21,1,0,6,29,0,0,0,0,0,0,0,0,0,0,0,0,0,23,0,0
35430,180,3702,1943,715,1694,26,18,214,1969,12,185,120,237,197,357,1436,2721,7,20915,1161,0,2,0,14,0
35431,180,3702,1168,838,957,57,25,144,1225,19,348,224,416,367,640,3018,5452,11,61921,3440,1,2,0,14,0
35454,14,470,42,7,35,4,0,5,46,1,2,1,2,3,3,2,4,0,2,0,0,2,5,26,0
35455,14,470,11,6,10,0,0,1,11,2,4,2,4,6,6,10,15,1,15,0,0,2,5,26,0
35456,79,3250,1289,550,1043,56,32,155,1345,10,167,93,185,177,278,1266,2075,5,11498,638,0,2,41,5,0
35457,139,6357,1392,870,1177,35,17,170,1427,14,494,280,531,508,811,4473,7289,7,54850,3047,2,2,149,5,0
35458,91,2970,773,419,590,28,0,166,801,10,204,113,217,214,330,1598,2554,5,13587,754,0,2,6,8,0
35461,85,3904,1338,495,1086,10,64,173,1348,11,122,82,157,133,239,883,1686,7,11934,663,0,2,23,8,0
35462,146,6582,139,89,101,2,0,35,141,7,54,34,62,61,96,330,569,4,2287,127,0,2,168,108,0
35463,146,6582,7,5,5,0,0,2,7,1,2,1,2,3,3,2,4,0,2,0,0,2,168,108,0
35464,32,933,465,148,393,5,8,60,470,4,31,20,31,35,51,161,261,2,523,29,0,2,8,5,0
35465,32,933,16,12,9,0,0,6,16,1,2,1,2,3,3,2,4,0,2,0,0,2,8,5,0
35466,90,4801,1782,648,1425,9,47,279,1791,8,171,97,189,179,286,1292,2140,4,9462,525,0,2,126,31,0
35469,77,2760,1450,624,1228,12,26,181,1462,14,306,186,354,320,540,2580,4493,8,36391,2021,1,2,27,14,0
35470,143,3771,1660,832,1314,41,38,274,1701,20,312,209,395,332,604,2671,5058,12,64042,3557,1,2,61,0,0
35472,59,3272,1296,573,1062,40,33,157,1336,8,201,118,231,209,349,1561,2689,4,12365,686,0,2,115,1,0
35473,65,3259,1457,730,1242,11,6,188,1468,10,292,166,329,302,495,2424,4078,5,22973,1276,1,2,116,5,0
35474,55,2458,1455,414,1257,16,76,112,1471,5,41,23,46,46,69,231,381,2,1069,59,0,2,67,4,0
35477,76,3740,1523,757,1297,19,12,193,1542,12,193,117,230,205,347,1508,2664,7,19053,1058,0,2,91,24,0
35478,66,2745,1020,354,843,12,15,144,1032,8,134,77,144,142,221,970,1580,4,6792,377,0,2,51,2,0
35480,39,2275,334,251,279,10,4,40,344,5,127,74,143,132,217,899,1528,2,4303,239,0,2,16,7,0
35481,38,1401,1293,570,1093,25,15,163,1318,10,195,123,241,205,364,1516,2795,6,17273,959,0,2,29,1,0
35482,16,1198,215,129,180,6,0,29,221,8,65,43,72,73,115,415,711,4,3153,175,0,2,1,10,0
35483,62,2603,1043,504,840,53,9,147,1096,9,180,112,198,189,310,1377,2344,4,11604,644,0,2,3,13,0
35485,22,942,373,158,315,8,0,51,381,5,76,44,79,81,123,486,779,2,2026,112,0,2,2,8,0
35486,67,2869,1178,367,1042,6,15,115,1184,9,94,51,95,103,146,644,976,4,4439,246,0,2,24,10,0
35487,71,3611,1943,715,1694,26,18,214,1969,12,185,120,237,197,357,1436,2721,7,20915,1161,0,2,15,19,0
35488,39,1537,1098,241,925,5,10,155,1103,7,46,25,49,53,74,273,423,3,1580,87,0,2,16,2,0
35489,180,3702,1943,715,1694,26,18,214,1969,12,185,120,237,197,357,1436,2721,7,20915,1161,0,2,12,3,0
35490,180,3702,1168,838,957,57,25,144,1225,19,348,224,416,367,640,3018,5452,11,61921,3440,1,2,12,3,0
35491,65,3259,1457,730,1242,11,6,188,1468,10,292,166,329,302,495,2424,4078,5,22973,1276,1,2,2,2,0
35492,71,3611,1943,715,1694,26,18,214,1969,12,185,120,237,197,357,1436,2721,7,20915,1161,0,2,11,1,0
35493,312,6316,1457,730,1242,11,6,188,1468,10,292,166,329,302,495,2424,4078,5,22973,1276,1,2,7,0,1
35494,312,6316,74,35,59,1,0,14,75,3,14,7,14,17,21,58,85,1,128,7,0,2,7,0,1
35495,312,6316,245,125,200,5,7,34,250,7,30,17,34,37,51,166,265,3,1053,58,0,2,7,0,1
35496,81,3313,1289,550,1043,56,32,155,1345,10,167,93,185,177,278,1266,2075,5,11498,638,0,2,14,0,1
35499,37,691,2,2,2,0,0,0,2,0,0,0,0,0,0,0,0,0,0,0,0,2,2,2,1
35513,37,691,99,48,90,1,3,5,100,0,0,0,0,0,0,0,0,0,0,0,0,2,2,2,1
35514,37,691,8,5,5,2,0,1,10,0,0,0,0,0,0,0,0,0,0,0,0,2,2,2,1
35515,37,691,1217,716,841,84,126,174,1301,14,185,118,215,199,333,1446,2542,8,20687,1149,0,2,2,2,1
35516,37,691,160,89,115,0,13,31,160,7,15,11,17,22,28,78,124,3,495,27,0,2,2,2,1
35517,37,691,10,10,9,9,0,0,19,0,0,0,0,0,0,0,0,0,0,0,0,2,2,2,1
35518,37,691,173,84,99,8,29,36,181,5,12,7,13,17,20,54,81,2,221,12,0,2,2,2,1
35519,37,691,3,1,1,3,0,0,6,0,0,0,0,0,0,0,0,0,0,0,0,2,2,2,1
35520,323,6553,1457,730,1242,11,6,188,1468,10,292,166,329,302,495,2424,4078,5,22973,1276,1,2,1,4,1
35521,323,6553,74,35,59,1,0,14,75,3,14,7,14,17,21,58,85,1,128,7,0,2,1,4,1
35522,323,6553,245,125,200,5,7,34,250,7,30,17,34,37,51,166,265,3,1053,58,0,2,1,4,1
35523,68,3328,1457,730,1242,11,6,188,1468,10,292,166,329,302,495,2424,4078,5,22973,1276,1,2,7,2,1
35524,312,6316,1457,730,1242,11,6,188,1468,10,292,166,329,302,495,2424,4078,5,22973,1276,1,2,7,0,0
35525,312,6316,74,35,59,1,0,14,75,3,14,7,14,17,21,58,85,1,128,7,0,2,7,0,0
35526,312,6316,245,125,200,5,7,34,250,7,30,17,34,37,51,166,265,3,1053,58,0,2,7,0,0
35527,81,3313,1289,550,1043,56,32,155,1345,10,167,93,185,177,278,1266,2075,5,11498,638,0,2,14,0,0
35528,146,6594,139,89,101,2,0,35,141,7,54,34,62,61,96,330,569,4,2287,127,0,2,2,1,1
35529,146,6594,7,5,5,0,0,2,7,1,2,1,2,3,3,2,4,0,2,0,0,2,2,1,1
35530,35,2163,652,304,544,16,6,88,668,6,89,51,101,95,152,591,998,3,3399,188,0,2,1,0,1
35533,37,691,2,2,2,0,0,0,2,0,0,0,0,0,0,0,0,0,0,0,0,2,51,51,0
35547,37,691,99,48,90,1,3,5,100,0,0,0,0,0,0,0,0,0,0,0,0,2,51,51,0
35548,37,691,8,5,5,2,0,1,10,0,0,0,0,0,0,0,0,0,0,0,0,2,51,51,0
35549,37,691,1217,716,841,84,126,174,1301,14,185,118,215,199,333,1446,2542,8,20687,1149,0,2,51,51,0
35550,37,691,160,89,115,0,13,31,160,7,15,11,17,22,28,78,124,3,495,27,0,2,51,51,0
35551,37,691,10,10,9,9,0,0,19,0,0,0,0,0,0,0,0,0,0,0,0,2,51,51,0
35552,37,691,173,84,99,8,29,36,181,5,12,7,13,17,20,54,81,2,221,12,0,2,51,51,0
35553,37,691,3,1,1,3,0,0,6,0,0,0,0,0,0,0,0,0,0,0,0,2,51,51,0
35554,160,5038,1660,832,1314,41,38,274,1701,20,312,209,395,332,604,2671,5058,12,64042,3557,1,2,24,2,0
35555,160,5038,1057,646,719,113,100,145,1170,18,215,134,248,233,382,1740,3004,10,31186,1732,1,2,24,2,0
35556,324,6573,1457,730,1242,11,6,188,1468,10,292,166,329,302,495,2424,4078,5,22973,1276,1,2,53,2,0
35557,324,6573,74,35,59,1,0,14,75,3,14,7,14,17,21,58,85,1,128,7,0,2,53,2,0
35558,324,6573,245,125,200,5,7,34,250,7,30,17,34,37,51,166,265,3,1053,58,0,2,53,2,0
35559,221,4925,722,423,573,19,0,135,741,12,172,101,199,184,300,1320,2257,6,15668,870,0,2,11,1,0
35560,221,4925,1508,847,911,44,250,301,1552,14,148,88,169,162,257,1120,1886,7,15077,837,0,2,11,1,0
35561,91,3201,1450,624,1228,12,26,181,1462,14,306,186,354,320,540,2580,4493,8,36391,2021,1,2,183,0,0
35562,140,3706,1660,832,1314,41,38,274,1701,20,312,209,395,332,604,2671,5058,12,64042,3557,1,2,11,35,0
35563,68,3328,1457,730,1242,11,6,188,1468,10,292,166,329,302,495,2424,4078,5,22973,1276,1,2,19,5,0
35564,146,6594,139,89,101,2,0,35,141,7,54,34,62,61,96,330,569,4,2287,127,0,2,2,1,0
35565,146,6594,7,5,5,0,0,2,7,1,2,1,2,3,3,2,4,0,2,0,0,2,2,1,0
35566,35,2163,652,304,544,16,6,88,668,6,89,51,101,95,152,591,998,3,3399,188,0,2,1,0,0
35567,81,3317,1289,550,1043,56,32,155,1345,10,167,93,185,177,278,1266,2075,5,11498,638,0,2,3,1,0
35592,207,4421,182,127,129,0,0,53,182,5,39,21,42,44,63,217,343,2,926,51,0,2,0,35,1
35593,207,4421,1165,710,800,67,119,181,1232,18,243,153,282,261,435,2000,3492,10,36473,2026,1,2,0,35,1
35596,32,595,2,2,2,0,0,0,2,0,0,0,0,0,0,0,0,0,0,0,0,2,19,45,1
35610,32,595,99,48,90,1,3,5,100,0,0,0,0,0,0,0,0,0,0,0,0,2,19,45,1
35611,32,595,8,5,5,2,0,1,10,0,0,0,0,0,0,0,0,0,0,0,0,2,19,45,1
35612,32,595,1217,716,841,84,126,174,1301,14,185,118,215,199,333,1446,2542,8,20687,1149,0,2,19,45,1
35613,32,595,160,89,115,0,13,31,160,7,15,11,17,22,28,78,124,3,495,27,0,2,19,45,1
35614,32,595,10,10,9,9,0,0,19,0,0,0,0,0,0,0,0,0,0,0,0,2,19,45,1
35615,32,595,173,84,99,8,29,36,181,5,12,7,13,17,20,54,81,2,221,12,0,2,19,45,1
35616,32,595,3,1,1,3,0,0,6,0,0,0,0,0,0,0,0,0,0,0,0,2,19,45,1
35617,324,6577,1457,730,1242,11,6,188,1468,10,292,166,329,302,495,2424,4078,5,22973,1276,1,2,16,12,1
35618,324,6577,74,35,59,1,0,14,75,3,14,7,14,17,21,58,85,1,128,7,0,2,16,12,1
35619,324,6577,245,125,200,5,7,34,250,7,30,17,34,37,51,166,265,3,1053,58,0,2,16,12,1
35620,34,980,182,127,129,0,0,53,182,5,39,21,42,44,63,217,343,2,926,51,0,2,0,18,1
35621,133,6161,1392,870,1177,35,17,170,1427,14,494,280,531,508,811,4473,7289,7,54850,3047,2,2,2,46,1
35622,86,3108,1450,624,1228,12,26,181,1462,14,306,186,354,320,540,2580,4493,8,36391,2021,1,2,4,24,1
35623,311,6718,72,33,56,0,4,12,72,1,1,1,1,2,2,0,2,0,1,0,0,2,45,40,1
35624,311,6718,1454,835,1044,76,110,219,1530,17,275,158,296,292,454,2297,3718,9,34017,1889,1,2,45,40,1
35625,62,2604,1043,504,840,53,9,147,1096,9,180,112,198,189,310,1377,2344,4,11604,644,0,2,4,3,1
35626,14,520,295,56,236,0,4,54,295,2,9,5,10,11,15,30,51,1,57,3,0,2,52,0,1
35650,207,4421,182,127,129,0,0,53,182,5,39,21,42,44,63,217,343,2,926,51,0,2,0,35,0
35651,207,4421,1165,710,800,67,119,181,1232,18,243,153,282,261,435,2000,3492,10,36473,2026,1,2,0,35,0
35654,32,595,2,2,2,0,0,0,2,0,0,0,0,0,0,0,0,0,0,0,0,2,19,45,0
35668,32,595,99,48,90,1,3,5,100,0,0,0,0,0,0,0,0,0,0,0,0,2,19,45,0
35669,32,595,8,5,5,2,0,1,10,0,0,0,0,0,0,0,0,0,0,0,0,2,19,45,0
35670,32,595,1217,716,841,84,126,174,1301,14,185,118,215,199,333,1446,2542,8,20687,1149,0,2,19,45,0
35671,32,595,160,89,115,0,13,31,160,7,15,11,17,22,28,78,124,3,495,27,0,2,19,45,0
35672,32,595,10,10,9,9,0,0,19,0,0,0,0,0,0,0,0,0,0,0,0,2,19,45,0
35673,32,595,173,84,99,8,29,36,181,5,12,7,13,17,20,54,81,2,221,12,0,2,19,45,0
35674,32,595,3,1,1,3,0,0,6,0,0,0,0,0,0,0,0,0,0,0,0,2,19,45,0
35675,324,6577,1457,730,1242,11,6,188,1468,10,292,166,329,302,495,2424,4078,5,22973,1276,1,2,16,12,0
35676,324,6577,74,35,59,1,0,14,75,3,14,7,14,17,21,58,85,1,128,7,0,2,16,12,0
35677,324,6577,245,125,200,5,7,34,250,7,30,17,34,37,51,166,265,3,1053,58,0,2,16,12,0
35678,34,980,182,127,129,0,0,53,182,5,39,21,42,44,63,217,343,2,926,51,0,2,0,18,0
35679,133,6161,1392,870,1177,35,17,170,1427,14,494,280,531,508,811,4473,7289,7,54850,3047,2,2,2,46,0
35680,86,3108,1450,624,1228,12,26,181,1462,14,306,186,354,320,540,2580,4493,8,36391,2021,1,2,4,24,0
35681,311,6718,72,33,56,0,4,12,72,1,1,1,1,2,2,0,2,0,1,0,0,2,45,40,0
35682,311,6718,1454,835,1044,76,110,219,1530,17,275,158,296,292,454,2297,3718,9,34017,1889,1,2,45,40,0
35683,62,2604,1043,504,840,53,9,147,1096,9,180,112,198,189,310,1377,2344,4,11604,644,0,2,4,3,0
35684,14,520,295,56,236,0,4,54,295,2,9,5,10,11,15,30,51,1,57,3,0,2,52,0,0
35685,324,6585,1457,730,1242,11,6,188,1468,10,292,166,329,302,495,2424,4078,5,22973,1276,1,2,9,2,0
35686,324,6585,74,35,59,1,0,14,75,3,14,7,14,17,21,58,85,1,128,7,0,2,9,2,0
35687,324,6585,245,125,200,5,7,34,250,7,30,17,34,37,51,166,265,3,1053,58,0,2,9,2,0
35688,321,6564,1457,730,1242,11,6,188,1468,10,292,166,329,302,495,2424,4078,5,22973,1276,1,2,19,28,1
35689,321,6564,74,35,59,1,0,14,75,3,14,7,14,17,21,58,85,1,128,7,0,2,19,28,1
35690,321,6564,245,125,200,5,7,34,250,7,30,17,34,37,51,166,265,3,1053,58,0,2,19,28,1
35691,321,6564,1457,730,1242,11,6,188,1468,10,292,166,329,302,495,2424,4078,5,22973,1276,1,2,28,30,0
35692,321,6564,74,35,59,1,0,14,75,3,14,7,14,17,21,58,85,1,128,7,0,2,28,30,0
35693,321,6564,245,125,200,5,7,34,250,7,30,17,34,37,51,166,265,3,1053,58,0,2,28,30,0
35694,174,4040,77,34,69,0,0,8,77,3,24,16,29,27,45,114,213,1,387,21,0,2,4,4,1
35695,174,4040,712,438,573,51,9,84,763,14,102,71,128,116,199,733,1364,8,11988,666,0,2,4,4,1
35696,25,1016,373,158,315,8,0,51,381,5,76,44,79,81,123,486,779,2,2026,112,0,2,8,0,1
35697,100,1889,1178,367,1042,6,15,115,1184,9,94,51,95,103,146,644,976,4,4439,246,0,2,1,5,1
35698,100,1889,177,108,140,8,0,27,185,6,30,16,32,36,48,162,248,3,794,44,0,2,1,5,1
35699,100,1889,1178,367,1042,6,15,115,1184,9,94,51,95,103,146,644,976,4,4439,246,0,2,1,5,0
35700,100,1889,177,108,140,8,0,27,185,6,30,16,32,36,48,162,248,3,794,44,0,2,1,5,0
35701,174,4040,77,34,69,0,0,8,77,3,24,16,29,27,45,114,213,1,387,21,0,2,4,4,0
35702,174,4040,712,438,573,51,9,84,763,14,102,71,128,116,199,733,1364,8,11988,666,0,2,4,4,0
35703,25,1016,373,158,315,8,0,51,381,5,76,44,79,81,123,486,779,2,2026,112,0,2,8,0,0
35731,32,595,2,2,2,0,0,0,2,0,0,0,0,0,0,0,0,0,0,0,0,2,59,85,0
35745,32,595,99,48,90,1,3,5,100,0,0,0,0,0,0,0,0,0,0,0,0,2,59,85,0
35746,32,595,8,5,5,2,0,1,10,0,0,0,0,0,0,0,0,0,0,0,0,2,59,85,0
35747,32,595,1217,716,841,84,126,174,1301,14,185,118,215,199,333,1446,2542,8,20687,1149,0,2,59,85,0
35748,32,595,160,89,115,0,13,31,160,7,15,11,17,22,28,78,124,3,495,27,0,2,59,85,0
35749,32,595,10,10,9,9,0,0,19,0,0,0,0,0,0,0,0,0,0,0,0,2,59,85,0
35750,32,595,173,84,99,8,29,36,181,5,12,7,13,17,20,54,81,2,221,12,0,2,59,85,0
35751,32,595,3,1,1,3,0,0,6,0,0,0,0,0,0,0,0,0,0,0,0,2,59,85,0
35752,160,5038,1660,832,1314,41,38,274,1701,20,312,209,395,332,604,2671,5058,12,64042,3557,1,2,29,2,0
35753,160,5038,1057,646,719,113,100,145,1170,18,215,134,248,233,382,1740,3004,10,31186,1732,1,2,29,2,0
35757,322,6605,1457,730,1242,11,6,188,1468,10,292,166,329,302,495,2424,4078,5,22973,1276,1,2,100,46,0
35758,322,6605,74,35,59,1,0,14,75,3,14,7,14,17,21,58,85,1,128,7,0,2,100,46,0
35759,322,6605,245,125,200,5,7,34,250,7,30,17,34,37,51,166,265,3,1053,58,0,2,100,46,0
35760,23,680,339,213,244,17,9,65,356,10,42,26,48,52,74,259,421,5,2410,133,0,3,19,6,0
35761,55,1468,1455,414,1257,16,76,112,1471,5,41,23,46,46,69,231,381,2,1069,59,0,2,2,2,0
35762,55,1468,669,365,481,22,61,110,691,15,103,63,122,118,185,747,1273,8,11311,628,0,2,2,2,0
35769,221,4925,722,423,573,19,0,135,741,12,172,101,199,184,300,1320,2257,6,15668,870,0,2,13,2,0
35770,221,4925,1508,847,911,44,250,301,1552,14,148,88,169,162,257,1120,1886,7,15077,837,0,2,13,2,0
35771,311,6718,72,33,56,0,4,12,72,1,1,1,1,2,2,0,2,0,1,0,0,2,80,1276,0
35772,311,6718,1454,835,1044,76,110,219,1530,17,275,158,296,292,454,2297,3718,9,34017,1889,1,2,80,1276,0
35785,81,3317,1289,550,1043,56,32,155,1345,10,167,93,185,177,278,1266,2075,5,11498,638,0,2,49,0,0
35787,133,6161,1392,870,1177,35,17,170,1427,14,494,280,531,508,811,4473,7289,7,54850,3047,2,2,6,48,0
35789,85,3904,1338,495,1086,10,64,173,1348,11,122,82,157,133,239,883,1686,7,11934,663,0,2,8,5,0
35790,146,6594,139,89,101,2,0,35,141,7,54,34,62,61,96,330,569,4,2287,127,0,2,173,85,0
35791,146,6594,7,5,5,0,0,2,7,1,2,1,2,3,3,2,4,0,2,0,0,2,173,85,0
35794,90,4801,1782,648,1425,9,47,279,1791,8,171,97,189,179,286,1292,2140,4,9462,525,0,2,34,21,0
35795,86,3108,1450,624,1228,12,26,181,1462,14,306,186,354,320,540,2580,4493,8,36391,2021,1,2,181,15,0
35796,140,3706,1660,832,1314,41,38,274,1701,20,312,209,395,332,604,2671,5058,12,64042,3557,1,2,56,47,0
35797,68,3328,1457,730,1242,11,6,188,1468,10,292,166,329,302,495,2424,4078,5,22973,1276,1,2,37,6,0
35798,37,2210,652,304,544,16,6,88,668,6,89,51,101,95,152,591,998,3,3399,188,0,2,1,0,0
35803,38,1401,1293,570,1093,25,15,163,1318,10,195,123,241,205,364,1516,2795,6,17273,959,0,2,31,3,0
35804,62,2604,1043,504,840,53,9,147,1096,9,180,112,198,189,310,1377,2344,4,11604,644,0,2,7,4,0
35805,14,520,295,56,236,0,4,54,295,2,9,5,10,11,15,30,51,1,57,3,0,2,54,1,0
35808,71,3611,1943,715,1694,26,18,214,1969,12,185,120,237,197,357,1436,2721,7,20915,1161,0,2,20,4,0
35810,237,5209,4293,999,3693,19,54,507,4312,9,155,88,170,164,258,1156,1898,4,9368,520,0,2,2,4,1
35811,237,5209,1482,859,1002,125,135,219,1607,16,219,134,251,235,385,1766,3032,9,27804,1544,1,2,2,4,1
35812,322,6605,1457,730,1242,11,6,188,1468,10,292,166,329,302,495,2424,4078,5,22973,1276,1,2,6,0,0
35813,322,6605,74,35,59,1,0,14,75,3,14,7,14,17,21,58,85,1,128,7,0,2,6,0,0
35814,322,6605,245,125,200,5,7,34,250,7,30,17,34,37,51,166,265,3,1053,58,0,2,6,0,0
35815,37,2210,652,304,544,16,6,88,668,6,89,51,101,95,152,591,998,3,3399,188,0,2,13,0,0
35866,322,6605,1457,730,1242,11,6,188,1468,10,292,166,329,302,495,2424,4078,5,22973,1276,1,2,98,32,0
35867,322,6605,74,35,59,1,0,14,75,3,14,7,14,17,21,58,85,1,128,7,0,2,98,32,0
35868,322,6605,245,125,200,5,7,34,250,7,30,17,34,37,51,166,265,3,1053,58,0,2,98,32,0
35870,237,5240,4293,999,3693,19,54,507,4312,9,155,88,170,164,258,1156,1898,4,9368,520,0,2,9,3,0
35871,237,5240,1482,859,1002,125,135,219,1607,16,219,134,251,235,385,1766,3032,9,27804,1544,1,2,9,3,0
35878,311,6718,72,33,56,0,4,12,72,1,1,1,1,2,2,0,2,0,1,0,0,2,47,39,0
35879,311,6718,1454,835,1044,76,110,219,1530,17,275,158,296,292,454,2297,3718,9,34017,1889,1,2,47,39,0
35888,133,6161,1392,870,1177,35,17,170,1427,14,494,280,531,508,811,4473,7289,7,54850,3047,2,2,5,47,0
35891,146,6594,139,89,101,2,0,35,141,7,54,34,62,61,96,330,569,4,2287,127,0,2,130,49,0
35892,146,6594,7,5,5,0,0,2,7,1,2,1,2,3,3,2,4,0,2,0,0,2,130,49,0
35898,68,3328,1457,730,1242,11,6,188,1468,10,292,166,329,302,495,2424,4078,5,22973,1276,1,2,21,7,0
35899,37,2210,652,304,544,16,6,88,668,6,89,51,101,95,152,591,998,3,3399,188,0,2,14,0,0
35910,46,954,447,308,343,6,5,95,453,7,96,59,111,103,170,651,1136,4,4600,255,0,2,6,3,1
35911,46,954,322,174,179,16,74,51,338,10,41,26,46,51,72,252,408,5,2291,127,0,2,6,3,1
35912,39,1661,447,308,343,6,5,95,453,7,96,59,111,103,170,651,1136,4,4600,255,0,2,33,1,1
35913,223,4983,722,423,573,19,0,135,741,12,172,101,199,184,300,1320,2257,6,15668,870,0,2,18,10,1
35914,223,4983,1508,847,911,44,250,301,1552,14,148,88,169,162,257,1120,1886,7,15077,837,0,2,18,10,1
35915,223,4983,722,423,573,19,0,135,741,12,172,101,199,184,300,1320,2257,6,15668,870,0,2,18,10,0
35916,223,4983,1508,847,911,44,250,301,1552,14,148,88,169,162,257,1120,1886,7,15077,837,0,2,18,10,0
35917,117,2369,1513,682,1277,25,13,200,1538,11,199,116,219,210,335,1557,2584,6,15641,868,0,2,2,2,0
35918,117,2369,819,519,539,24,98,155,843,15,96,57,106,111,163,690,1107,8,9171,509,0,2,2,2,0
35919,237,5240,4293,999,3693,19,54,507,4312,9,155,88,170,164,258,1156,1898,4,9368,520,0,2,99,39,0
35920,237,5240,1482,859,1002,125,135,219,1607,16,219,134,251,235,385,1766,3032,9,27804,1544,1,2,99,39,0
35921,46,954,447,308,343,6,5,95,453,7,96,59,111,103,170,651,1136,4,4600,255,0,2,6,3,0
35922,46,954,322,174,179,16,74,51,338,10,41,26,46,51,72,252,408,5,2291,127,0,2,6,3,0
35923,311,6718,72,33,56,0,4,12,72,1,1,1,1,2,2,0,2,0,1,0,0,2,0,1,0
35924,311,6718,1454,835,1044,76,110,219,1530,17,275,158,296,292,454,2297,3718,9,34017,1889,1,2,0,1,0
35925,114,4432,1513,682,1277,25,13,200,1538,11,199,116,219,210,335,1557,2584,6,15641,868,0,2,19,0,0
35926,39,1661,447,308,343,6,5,95,453,7,96,59,111,103,170,651,1136,4,4600,255,0,2,33,1,0
35927,115,2299,1513,682,1277,25,13,200,1538,11,199,116,219,210,335,1557,2584,6,15641,868,0,2,2,2,1
35928,115,2299,819,519,539,24,98,155,843,15,96,57,106,111,163,690,1107,8,9171,509,0,2,2,2,1
35929,67,1993,1523,757,1297,19,12,193,1542,12,193,117,230,205,347,1508,2664,7,19053,1058,0,2,2,2,1
35930,67,1993,701,378,504,33,58,109,734,13,110,68,126,123,194,794,1346,7,10027,557,0,2,2,2,1
35931,46,943,447,308,343,6,5,95,453,7,96,59,111,103,170,651,1136,4,4600,255,0,2,3,3,1
35932,46,943,322,174,179,16,74,51,338,10,41,26,46,51,72,252,408,5,2291,127,0,2,3,3,1
35933,517,11149,72,33,56,0,4,12,72,1,1,1,1,2,2,0,2,0,1,0,0,2,1,1,1
35934,517,11149,1454,835,1044,76,110,219,1530,17,275,158,296,292,454,2297,3718,9,34017,1889,1,2,1,1,1
35937,115,2299,1513,682,1277,25,13,200,1538,11,199,116,219,210,335,1557,2584,6,15641,868,0,2,2,2,0
35938,115,2299,819,519,539,24,98,155,843,15,96,57,106,111,163,690,1107,8,9171,509,0,2,2,2,0
35939,67,1993,1523,757,1297,19,12,193,1542,12,193,117,230,205,347,1508,2664,7,19053,1058,0,2,2,2,0
35940,67,1993,701,378,504,33,58,109,734,13,110,68,126,123,194,794,1346,7,10027,557,0,2,2,2,0
35941,46,943,447,308,343,6,5,95,453,7,96,59,111,103,170,651,1136,4,4600,255,0,2,3,3,0
35942,46,943,322,174,179,16,74,51,338,10,41,26,46,51,72,252,408,5,2291,127,0,2,3,3,0
35943,517,11149,72,33,56,0,4,12,72,1,1,1,1,2,2,0,2,0,1,0,0,2,1,1,0
35944,517,11149,1454,835,1044,76,110,219,1530,17,275,158,296,292,454,2297,3718,9,34017,1889,1,2,1,1,0
35947,56,1547,1455,414,1257,16,76,112,1471,5,41,23,46,46,69,231,381,2,1069,59,0,2,15,1,1
35948,56,1547,669,365,481,22,61,110,691,15,103,63,122,118,185,747,1273,8,11311,628,0,2,15,1,1
35949,56,1556,1455,414,1257,16,76,112,1471,5,41,23,46,46,69,231,381,2,1069,59,0,2,8,7,1
35950,56,1556,669,365,481,22,61,110,691,15,103,63,122,118,185,747,1273,8,11311,628,0,2,8,7,1
35951,64,2717,1455,414,1257,16,76,112,1471,5,41,23,46,46,69,231,381,2,1069,59,0,2,79,0,1
35952,57,1569,1455,414,1257,16,76,112,1471,5,41,23,46,46,69,231,381,2,1069,59,0,2,8,7,0
35953,57,1569,669,365,481,22,61,110,691,15,103,63,122,118,185,747,1273,8,11311,628,0,2,8,7,0
35954,64,2720,1455,414,1257,16,76,112,1471,5,41,23,46,46,69,231,381,2,1069,59,0,2,81,79,1
35955,57,1571,1455,414,1257,16,76,112,1471,5,41,23,46,46,69,231,381,2,1069,59,0,2,11,3,0
35956,57,1571,669,365,481,22,61,110,691,15,103,63,122,118,185,747,1273,8,11311,628,0,2,11,3,0
35957,62,2710,1455,414,1257,16,76,112,1471,5,41,23,46,46,69,231,381,2,1069,59,0,2,2,5,0
35958,61,2720,1455,414,1257,16,76,112,1471,5,41,23,46,46,69,231,381,2,1069,59,0,2,15,15,0
35959,56,1576,1455,414,1257,16,76,112,1471,5,41,23,46,46,69,231,381,2,1069,59,0,2,26,18,1
35960,56,1576,669,365,481,22,61,110,691,15,103,63,122,118,185,747,1273,8,11311,628,0,2,26,18,1
35961,56,1576,1455,414,1257,16,76,112,1471,5,41,23,46,46,69,231,381,2,1069,59,0,2,2,2,1
35962,56,1576,669,365,481,22,61,110,691,15,103,63,122,118,185,747,1273,8,11311,628,0,2,2,2,1
35963,314,6752,72,33,56,0,4,12,72,1,1,1,1,2,2,0,2,0,1,0,0,2,8,2,1
35964,314,6752,1454,835,1044,76,110,219,1530,17,275,158,296,292,454,2297,3718,9,34017,1889,1,2,8,2,1
35965,91,4840,1782,648,1425,9,47,279,1791,8,171,97,189,179,286,1292,2140,4,9462,525,0,2,19,2,1
35966,148,6629,139,89,101,2,0,35,141,7,54,34,62,61,96,330,569,4,2287,127,0,2,32,0,1
35967,148,6629,7,5,5,0,0,2,7,1,2,1,2,3,3,2,4,0,2,0,0,2,32,0,1
35968,56,1576,1455,414,1257,16,76,112,1471,5,41,23,46,46,69,231,381,2,1069,59,0,2,36,4,0
35969,56,1576,669,365,481,22,61,110,691,15,103,63,122,118,185,747,1273,8,11311,628,0,2,36,4,0
35970,61,2720,1455,414,1257,16,76,112,1471,5,41,23,46,46,69,231,381,2,1069,59,0,2,78,0,0
35971,148,6629,139,89,101,2,0,35,141,7,54,34,62,61,96,330,569,4,2287,127,0,2,32,0,0
35972,148,6629,7,5,5,0,0,2,7,1,2,1,2,3,3,2,4,0,2,0,0,2,32,0,0
35973,518,11168,72,33,56,0,4,12,72,1,1,1,1,2,2,0,2,0,1,0,0,2,7,2,1
35974,518,11168,1454,835,1044,76,110,219,1530,17,275,158,296,292,454,2297,3718,9,34017,1889,1,2,7,2,1
35975,77,3168,1289,550,1043,56,32,155,1345,10,167,93,185,177,278,1266,2075,5,11498,638,0,2,1,1,1
35976,112,4316,1513,682,1277,25,13,200,1538,11,199,116,219,210,335,1557,2584,6,15641,868,0,2,2,2,1
35977,24,834,74,35,59,1,0,14,75,3,14,7,14,17,21,58,85,1,128,7,0,2,4,4,1
35978,24,834,245,125,200,5,7,34,250,7,30,17,34,37,51,166,265,3,1053,58,0,2,4,4,1
35979,146,6594,139,89,101,2,0,35,141,7,54,34,62,61,96,330,569,4,2287,127,0,2,1,1,1
35980,146,6594,7,5,5,0,0,2,7,1,2,1,2,3,3,2,4,0,2,0,0,2,1,1,1
35981,68,3327,1457,730,1242,11,6,188,1468,10,292,166,329,302,495,2424,4078,5,22973,1276,1,2,42,60,1
35982,314,6750,72,33,56,0,4,12,72,1,1,1,1,2,2,0,2,0,1,0,0,2,1,1,0
35983,314,6750,1454,835,1044,76,110,219,1530,17,275,158,296,292,454,2297,3718,9,34017,1889,1,2,1,1,0
35984,92,4879,1782,648,1425,9,47,279,1791,8,171,97,189,179,286,1292,2140,4,9462,525,0,2,17,0,0
35988,175,4054,77,34,69,0,0,8,77,3,24,16,29,27,45,114,213,1,387,21,0,2,5,0,1
35989,175,4054,712,438,573,51,9,84,763,14,102,71,128,116,199,733,1364,8,11988,666,0,2,5,0,1
35990,64,2671,1043,504,840,53,9,147,1096,9,180,112,198,189,310,1377,2344,4,11604,644,0,2,12,0,1
35991,24,834,74,35,59,1,0,14,75,3,14,7,14,17,21,58,85,1,128,7,0,2,4,4,0
35992,24,834,245,125,200,5,7,34,250,7,30,17,34,37,51,166,265,3,1053,58,0,2,4,4,0
35993,146,6594,139,89,101,2,0,35,141,7,54,34,62,61,96,330,569,4,2287,127,0,2,1,1,0
35994,146,6594,7,5,5,0,0,2,7,1,2,1,2,3,3,2,4,0,2,0,0,2,1,1,0
35995,68,3327,1457,730,1242,11,6,188,1468,10,292,166,329,302,495,2424,4078,5,22973,1276,1,2,42,60,0
35996,314,6750,72,33,56,0,4,12,72,1,1,1,1,2,2,0,2,0,1,0,0,2,8,2,0
35997,314,6750,1454,835,1044,76,110,219,1530,17,275,158,296,292,454,2297,3718,9,34017,1889,1,2,8,2,0
35998,92,4879,1782,648,1425,9,47,279,1791,8,171,97,189,179,286,1292,2140,4,9462,525,0,2,36,2,0
35999,175,4054,77,34,69,0,0,8,77,3,24,16,29,27,45,114,213,1,387,21,0,2,5,0,0
36000,175,4054,712,438,573,51,9,84,763,14,102,71,128,116,199,733,1364,8,11988,666,0,2,5,0,0
36001,64,2671,1043,504,840,53,9,147,1096,9,180,112,198,189,310,1377,2344,4,11604,644,0,2,12,0,0
36002,175,4040,77,34,69,0,0,8,77,3,24,16,29,27,45,114,213,1,387,21,0,2,1,2,0
36003,175,4040,712,438,573,51,9,84,763,14,102,71,128,116,199,733,1364,8,11988,666,0,2,1,2,0
36006,519,11194,72,33,56,0,4,12,72,1,1,1,1,2,2,0,2,0,1,0,0,2,11,4,0
36007,519,11194,1454,835,1044,76,110,219,1530,17,275,158,296,292,454,2297,3718,9,34017,1889,1,2,11,4,0
36008,85,3914,1338,495,1086,10,64,173,1348,11,122,82,157,133,239,883,1686,7,11934,663,0,2,12,0,0
36012,322,6612,1457,730,1242,11,6,188,1468,10,292,166,329,302,495,2424,4078,5,22973,1276,1,2,1,0,1
36013,322,6612,74,35,59,1,0,14,75,3,14,7,14,17,21,58,85,1,128,7,0,2,1,0,1
36014,322,6612,245,125,200,5,7,34,250,7,30,17,34,37,51,166,265,3,1053,58,0,2,1,0,1
36015,177,4103,77,34,69,0,0,8,77,3,24,16,29,27,45,114,213,1,387,21,0,2,22,1,1
36016,177,4103,712,438,573,51,9,84,763,14,102,71,128,116,199,733,1364,8,11988,666,0,2,22,1,1
36017,87,4028,1338,495,1086,10,64,173,1348,11,122,82,157,133,239,883,1686,7,11934,663,0,2,37,0,1
36018,92,4881,1782,648,1425,9,47,279,1791,8,171,97,189,179,286,1292,2140,4,9462,525,0,2,1,1,1
36019,523,11235,72,33,56,0,4,12,72,1,1,1,1,2,2,0,2,0,1,0,0,2,8,2,0
36020,523,11235,1454,835,1044,76,110,219,1530,17,275,158,296,292,454,2297,3718,9,34017,1889,1,2,8,2,0
36021,84,4537,1782,648,1425,9,47,279,1791,8,171,97,189,179,286,1292,2140,4,9462,525,0,2,37,0,0
36022,322,6608,1457,730,1242,11,6,188,1468,10,292,166,329,302,495,2424,4078,5,22973,1276,1,2,2,4,1
36023,322,6608,74,35,59,1,0,14,75,3,14,7,14,17,21,58,85,1,128,7,0,2,2,4,1
36024,322,6608,245,125,200,5,7,34,250,7,30,17,34,37,51,166,265,3,1053,58,0,2,2,4,1
36026,237,5245,4293,999,3693,19,54,507,4312,9,155,88,170,164,258,1156,1898,4,9368,520,0,2,4,6,1
36027,237,5245,1482,859,1002,125,135,219,1607,16,219,134,251,235,385,1766,3032,9,27804,1544,1,2,4,6,1
36028,311,6721,72,33,56,0,4,12,72,1,1,1,1,2,2,0,2,0,1,0,0,2,2,2,1
36029,311,6721,1454,835,1044,76,110,219,1530,17,275,158,296,292,454,2297,3718,9,34017,1889,1,2,2,2,1
36030,77,3179,1289,550,1043,56,32,155,1345,10,167,93,185,177,278,1266,2075,5,11498,638,0,2,0,48,1
36031,5,162,75,38,59,1,3,12,76,2,4,2,4,6,6,10,15,1,15,0,0,0,55,0,1
36032,145,6578,139,89,101,2,0,35,141,7,54,34,62,61,96,330,569,4,2287,127,0,2,1,2,1
36033,145,6578,7,5,5,0,0,2,7,1,2,1,2,3,3,2,4,0,2,0,0,2,1,2,1
36034,14,811,442,244,305,14,16,103,456,11,68,45,75,79,120,452,756,6,4588,254,0,2,0,1,1
36035,520,11213,72,33,56,0,4,12,72,1,1,1,1,2,2,0,2,0,1,0,0,2,7,2,0
36036,520,11213,1454,835,1044,76,110,219,1530,17,275,158,296,292,454,2297,3718,9,34017,1889,1,2,7,2,0
36037,77,3168,1289,550,1043,56,32,155,1345,10,167,93,185,177,278,1266,2075,5,11498,638,0,2,1,1,0
36038,112,4316,1513,682,1277,25,13,200,1538,11,199,116,219,210,335,1557,2584,6,15641,868,0,2,2,2,0
36039,524,11254,72,33,56,0,4,12,72,1,1,1,1,2,2,0,2,0,1,0,0,2,8,2,0
36040,524,11254,1454,835,1044,76,110,219,1530,17,275,158,296,292,454,2297,3718,9,34017,1889,1,2,8,2,0
36042,322,6612,1457,730,1242,11,6,188,1468,10,292,166,329,302,495,2424,4078,5,22973,1276,1,2,1,0,0
36043,322,6612,74,35,59,1,0,14,75,3,14,7,14,17,21,58,85,1,128,7,0,2,1,0,0
36044,322,6612,245,125,200,5,7,34,250,7,30,17,34,37,51,166,265,3,1053,58,0,2,1,0,0
36045,177,4103,77,34,69,0,0,8,77,3,24,16,29,27,45,114,213,1,387,21,0,2,22,1,0
36046,177,4103,712,438,573,51,9,84,763,14,102,71,128,116,199,733,1364,8,11988,666,0,2,22,1,0
36047,87,4028,1338,495,1086,10,64,173,1348,11,122,82,157,133,239,883,1686,7,11934,663,0,2,37,0,0
36048,92,4881,1782,648,1425,9,47,279,1791,8,171,97,189,179,286,1292,2140,4,9462,525,0,2,1,1,0
36049,177,4103,77,34,69,0,0,8,77,3,24,16,29,27,45,114,213,1,387,21,0,2,0,4,0
36050,177,4103,712,438,573,51,9,84,763,14,102,71,128,116,199,733,1364,8,11988,666,0,2,0,4,0
36053,238,5259,4293,999,3693,19,54,507,4312,9,155,88,170,164,258,1156,1898,4,9368,520,0,2,7,2,0
36054,238,5259,1482,859,1002,125,135,219,1607,16,219,134,251,235,385,1766,3032,9,27804,1544,1,2,7,2,0
36055,71,2075,1523,757,1297,19,12,193,1542,12,193,117,230,205,347,1508,2664,7,19053,1058,0,2,2,2,0
36056,71,2075,701,378,504,33,58,109,734,13,110,68,126,123,194,794,1346,7,10027,557,0,2,2,2,0
36057,179,4142,77,34,69,0,0,8,77,3,24,16,29,27,45,114,213,1,387,21,0,2,4,0,0
36058,179,4142,712,438,573,51,9,84,763,14,102,71,128,116,199,733,1364,8,11988,666,0,2,4,0,0
36059,46,954,447,308,343,6,5,95,453,7,96,59,111,103,170,651,1136,4,4600,255,0,2,2,2,0
36060,46,954,322,174,179,16,74,51,338,10,41,26,46,51,72,252,408,5,2291,127,0,2,2,2,0
36061,320,6840,72,33,56,0,4,12,72,1,1,1,1,2,2,0,2,0,1,0,0,2,22,8,0
36062,320,6840,1454,835,1044,76,110,219,1530,17,275,158,296,292,454,2297,3718,9,34017,1889,1,2,22,8,0
36065,81,3317,1289,550,1043,56,32,155,1345,10,167,93,185,177,278,1266,2075,5,11498,638,0,2,1,1,0
36066,88,4059,1338,495,1086,10,64,173,1348,11,122,82,157,133,239,883,1686,7,11934,663,0,2,12,0,0
36067,147,6691,139,89,101,2,0,35,141,7,54,34,62,61,96,330,569,4,2287,127,0,2,32,0,0
36068,147,6691,7,5,5,0,0,2,7,1,2,1,2,3,3,2,4,0,2,0,0,2,32,0,0
36069,93,4930,1782,648,1425,9,47,279,1791,8,171,97,189,179,286,1292,2140,4,9462,525,0,2,37,0,0
36070,114,4432,1513,682,1277,25,13,200,1538,11,199,116,219,210,335,1557,2584,6,15641,868,0,2,2,2,0
36071,63,2634,1043,504,840,53,9,147,1096,9,180,112,198,189,310,1377,2344,4,11604,644,0,2,12,0,0
36093,179,4142,77,34,69,0,0,8,77,3,24,16,29,27,45,114,213,1,387,21,0,2,1,1,1
36094,179,4142,712,438,573,51,9,84,763,14,102,71,128,116,199,733,1364,8,11988,666,0,2,1,1,1
36095,179,4142,77,34,69,0,0,8,77,3,24,16,29,27,45,114,213,1,387,21,0,2,1,1,0
36096,179,4142,712,438,573,51,9,84,763,14,102,71,128,116,199,733,1364,8,11988,666,0,2,1,1,0
36100,2,26,6,4,4,0,0,2,6,1,4,2,4,5,6,8,13,0,6,0,0,3,5,5,1
36105,2,26,6,4,4,0,0,2,6,1,4,2,4,5,6,8,13,0,6,0,0,3,5,5,0
36107,322,6615,1457,730,1242,11,6,188,1468,10,292,166,329,302,495,2424,4078,5,22973,1276,1,2,2,4,0
36108,322,6615,74,35,59,1,0,14,75,3,14,7,14,17,21,58,85,1,128,7,0,2,2,4,0
36109,322,6615,245,125,200,5,7,34,250,7,30,17,34,37,51,166,265,3,1053,58,0,2,2,4,0
36111,238,5264,4293,999,3693,19,54,507,4312,9,155,88,170,164,258,1156,1898,4,9368,520,0,2,4,6,0
36112,238,5264,1482,859,1002,125,135,219,1607,16,219,134,251,235,385,1766,3032,9,27804,1544,1,2,4,6,0
36113,320,6843,72,33,56,0,4,12,72,1,1,1,1,2,2,0,2,0,1,0,0,2,2,2,0
36114,320,6843,1454,835,1044,76,110,219,1530,17,275,158,296,292,454,2297,3718,9,34017,1889,1,2,2,2,0
36115,77,3179,1289,550,1043,56,32,155,1345,10,167,93,185,177,278,1266,2075,5,11498,638,0,2,0,48,0
36116,5,162,75,38,59,1,3,12,76,2,4,2,4,6,6,10,15,1,15,0,0,0,55,0,0
36117,146,6675,139,89,101,2,0,35,141,7,54,34,62,61,96,330,569,4,2287,127,0,2,1,2,0
36118,146,6675,7,5,5,0,0,2,7,1,2,1,2,3,3,2,4,0,2,0,0,2,1,2,0
36119,14,811,442,244,305,14,16,103,456,11,68,45,75,79,120,452,756,6,4588,254,0,2,0,1,0
36166,238,5264,4293,999,3693,19,54,507,4312,9,155,88,170,164,258,1156,1898,4,9368,520,0,2,1,1,0
36167,238,5264,1482,859,1002,125,135,219,1607,16,219,134,251,235,385,1766,3032,9,27804,1544,1,2,1,1,0
36168,238,5264,4293,999,3693,19,54,507,4312,9,155,88,170,164,258,1156,1898,4,9368,520,0,2,1,1,1
36169,238,5264,1482,859,1002,125,135,219,1607,16,219,134,251,235,385,1766,3032,9,27804,1544,1,2,1,1,1
36170,177,3648,1943,715,1694,26,18,214,1969,12,185,120,237,197,357,1436,2721,7,20915,1161,0,2,2,10,1
36171,177,3648,1168,838,957,57,25,144,1225,19,348,224,416,367,640,3018,5452,11,61921,3440,1,2,2,10,1
36172,207,4433,182,127,129,0,0,53,182,5,39,21,42,44,63,217,343,2,926,51,0,2,2,1,1
36173,207,4433,1165,710,800,67,119,181,1232,18,243,153,282,261,435,2000,3492,10,36473,2026,1,2,2,1,1
36174,135,6349,1392,870,1177,35,17,170,1427,14,494,280,531,508,811,4473,7289,7,54850,3047,2,2,68,38,1
36175,135,6409,1392,870,1177,35,17,170,1427,14,494,280,531,508,811,4473,7289,7,54850,3047,2,2,44,34,1
36176,322,6887,72,33,56,0,4,12,72,1,1,1,1,2,2,0,2,0,1,0,0,2,11,1,1
36177,322,6887,1454,835,1044,76,110,219,1530,17,275,158,296,292,454,2297,3718,9,34017,1889,1,2,11,1,1
36178,147,6711,139,89,101,2,0,35,141,7,54,34,62,61,96,330,569,4,2287,127,0,2,7,0,1
36179,147,6711,7,5,5,0,0,2,7,1,2,1,2,3,3,2,4,0,2,0,0,2,7,0,1
36180,207,4433,182,127,129,0,0,53,182,5,39,21,42,44,63,217,343,2,926,51,0,2,2,1,0
36181,207,4433,1165,710,800,67,119,181,1232,18,243,153,282,261,435,2000,3492,10,36473,2026,1,2,2,1,0
36182,135,6409,1392,870,1177,35,17,170,1427,14,494,280,531,508,811,4473,7289,7,54850,3047,2,2,112,72,0
36183,322,6887,72,33,56,0,4,12,72,1,1,1,1,2,2,0,2,0,1,0,0,2,11,1,0
36184,322,6887,1454,835,1044,76,110,219,1530,17,275,158,296,292,454,2297,3718,9,34017,1889,1,2,11,1,0
36185,147,6711,139,89,101,2,0,35,141,7,54,34,62,61,96,330,569,4,2287,127,0,2,7,0,0
36186,147,6711,7,5,5,0,0,2,7,1,2,1,2,3,3,2,4,0,2,0,0,2,7,0,0
36187,240,5292,4293,999,3693,19,54,507,4312,9,155,88,170,164,258,1156,1898,4,9368,520,0,2,12,1,1
36188,240,5292,1482,859,1002,125,135,219,1607,16,219,134,251,235,385,1766,3032,9,27804,1544,1,2,12,1,1
36189,321,6880,72,33,56,0,4,12,72,1,1,1,1,2,2,0,2,0,1,0,0,2,2,3,1
36190,321,6880,1454,835,1044,76,110,219,1530,17,275,158,296,292,454,2297,3718,9,34017,1889,1,2,2,3,1
36191,147,6722,139,89,101,2,0,35,141,7,54,34,62,61,96,330,569,4,2287,127,0,2,1,0,1
36192,147,6722,7,5,5,0,0,2,7,1,2,1,2,3,3,2,4,0,2,0,0,2,1,0,1
36193,240,5292,4293,999,3693,19,54,507,4312,9,155,88,170,164,258,1156,1898,4,9368,520,0,2,12,1,0
36194,240,5292,1482,859,1002,125,135,219,1607,16,219,134,251,235,385,1766,3032,9,27804,1544,1,2,12,1,0
36195,321,6880,72,33,56,0,4,12,72,1,1,1,1,2,2,0,2,0,1,0,0,2,2,3,0
36196,321,6880,1454,835,1044,76,110,219,1530,17,275,158,296,292,454,2297,3718,9,34017,1889,1,2,2,3,0
36197,147,6722,139,89,101,2,0,35,141,7,54,34,62,61,96,330,569,4,2287,127,0,2,1,0,0
36198,147,6722,7,5,5,0,0,2,7,1,2,1,2,3,3,2,4,0,2,0,0,2,1,0,0
36199,12,228,127,75,83,2,11,30,129,4,14,7,14,18,21,61,87,2,175,9,0,2,2,2,0
36200,12,228,652,304,544,16,6,88,668,6,89,51,101,95,152,591,998,3,3399,188,0,2,2,2,0
36201,12,228,2,2,2,0,0,0,2,0,0,0,0,0,0,0,0,0,0,0,0,2,2,2,0
36202,12,228,8,5,5,0,0,3,8,0,0,0,0,0,0,0,0,0,0,0,0,2,2,2,0
36205,12,228,14,8,8,0,0,6,14,0,0,0,0,0,0,0,0,0,0,0,0,2,2,2,0
36206,12,228,6,4,4,0,0,2,6,0,0,0,0,0,0,0,0,0,0,0,0,2,2,2,0
36207,12,228,6,4,4,0,0,2,6,1,2,1,2,3,3,2,4,0,2,0,0,2,2,2,0
36209,12,228,7,5,5,0,0,2,7,0,0,0,0,0,0,0,0,0,0,0,0,2,2,2,0
36211,12,228,10,6,6,0,0,4,10,0,0,0,0,0,0,0,0,0,0,0,0,2,2,2,0
36212,12,228,1,1,1,0,0,0,1,0,0,0,0,0,0,0,0,0,0,0,0,2,2,2,0
36214,12,228,14,10,10,0,0,4,14,1,1,1,1,2,2,0,2,0,1,0,0,2,2,2,0
36215,12,228,46,26,30,3,0,12,49,3,6,3,6,9,9,20,28,1,42,2,0,2,2,2,0
36216,71,3611,1943,715,1694,26,18,214,1969,12,185,120,237,197,357,1436,2721,7,20915,1161,0,2,1,1,1
36234,177,3648,1943,715,1694,26,18,214,1969,12,185,120,237,197,357,1436,2721,7,20915,1161,0,2,2,10,0
36235,177,3648,1168,838,957,57,25,144,1225,19,348,224,416,367,640,3018,5452,11,61921,3440,1,2,2,10,0
36236,71,3611,1943,715,1694,26,18,214,1969,12,185,120,237,197,357,1436,2721,7,20915,1161,0,2,1,1,0
36237,240,5295,4293,999,3693,19,54,507,4312,9,155,88,170,164,258,1156,1898,4,9368,520,0,2,1,1,1
36238,240,5295,1482,859,1002,125,135,219,1607,16,219,134,251,235,385,1766,3032,9,27804,1544,1,2,1,1,1
36239,147,6728,139,89,101,2,0,35,141,7,54,34,62,61,96,330,569,4,2287,127,0,2,18,1,1
36240,147,6728,7,5,5,0,0,2,7,1,2,1,2,3,3,2,4,0,2,0,0,2,18,1,1
36241,240,5295,4293,999,3693,19,54,507,4312,9,155,88,170,164,258,1156,1898,4,9368,520,0,2,1,1,0
36242,240,5295,1482,859,1002,125,135,219,1607,16,219,134,251,235,385,1766,3032,9,27804,1544,1,2,1,1,0
36243,147,6728,139,89,101,2,0,35,141,7,54,34,62,61,96,330,569,4,2287,127,0,2,18,1,0
36244,147,6728,7,5,5,0,0,2,7,1,2,1,2,3,3,2,4,0,2,0,0,2,18,1,0
36247,32,595,2,2,2,0,0,0,2,0,0,0,0,0,0,0,0,0,0,0,0,2,5,4,1
36261,32,595,99,48,90,1,3,5,100,0,0,0,0,0,0,0,0,0,0,0,0,2,5,4,1
36262,32,595,8,5,5,2,0,1,10,0,0,0,0,0,0,0,0,0,0,0,0,2,5,4,1
36263,32,595,1217,716,841,84,126,174,1301,14,185,118,215,199,333,1446,2542,8,20687,1149,0,2,5,4,1
36264,32,595,160,89,115,0,13,31,160,7,15,11,17,22,28,78,124,3,495,27,0,2,5,4,1
36265,32,595,10,10,9,9,0,0,19,0,0,0,0,0,0,0,0,0,0,0,0,2,5,4,1
36266,32,595,173,84,99,8,29,36,181,5,12,7,13,17,20,54,81,2,221,12,0,2,5,4,1
36267,32,595,3,1,1,3,0,0,6,0,0,0,0,0,0,0,0,0,0,0,0,2,5,4,1
36268,159,5031,1660,832,1314,41,38,274,1701,20,312,209,395,332,604,2671,5058,12,64042,3557,1,2,20,18,1
36269,159,5031,1057,646,719,113,100,145,1170,18,215,134,248,233,382,1740,3004,10,31186,1732,1,2,20,18,1
36270,141,3738,1660,832,1314,41,38,274,1701,20,312,209,395,332,604,2671,5058,12,64042,3557,1,2,10,0,1
36273,32,595,2,2,2,0,0,0,2,0,0,0,0,0,0,0,0,0,0,0,0,2,5,4,0
36287,32,595,99,48,90,1,3,5,100,0,0,0,0,0,0,0,0,0,0,0,0,2,5,4,0
36288,32,595,8,5,5,2,0,1,10,0,0,0,0,0,0,0,0,0,0,0,0,2,5,4,0
36289,32,595,1217,716,841,84,126,174,1301,14,185,118,215,199,333,1446,2542,8,20687,1149,0,2,5,4,0
36290,32,595,160,89,115,0,13,31,160,7,15,11,17,22,28,78,124,3,495,27,0,2,5,4,0
36291,32,595,10,10,9,9,0,0,19,0,0,0,0,0,0,0,0,0,0,0,0,2,5,4,0
36292,32,595,173,84,99,8,29,36,181,5,12,7,13,17,20,54,81,2,221,12,0,2,5,4,0
36293,32,595,3,1,1,3,0,0,6,0,0,0,0,0,0,0,0,0,0,0,0,2,5,4,0
36294,159,5031,1660,832,1314,41,38,274,1701,20,312,209,395,332,604,2671,5058,12,64042,3557,1,2,20,18,0
36295,159,5031,1057,646,719,113,100,145,1170,18,215,134,248,233,382,1740,3004,10,31186,1732,1,2,20,18,0
36296,141,3738,1660,832,1314,41,38,274,1701,20,312,209,395,332,604,2671,5058,12,64042,3557,1,2,10,0,0
36297,7,298,72,33,56,0,4,12,72,1,1,1,1,2,2,0,2,0,1,0,0,2,1,1,1
36298,7,298,72,33,56,0,4,12,72,1,1,1,1,2,2,0,2,0,1,0,0,2,1,1,0
36299,123,2695,1043,504,840,53,9,147,1096,9,180,112,198,189,310,1377,2344,4,11604,644,0,2,14,0,1
36300,123,2695,383,288,292,26,6,62,409,11,65,38,67,76,105,429,656,5,3719,206,0,2,14,0,1
36301,66,2714,1043,504,840,53,9,147,1096,9,180,112,198,189,310,1377,2344,4,11604,644,0,2,26,0,1
36302,70,2065,1523,757,1297,19,12,193,1542,12,193,117,230,205,347,1508,2664,7,19053,1058,0,2,3,6,1
36303,70,2065,701,378,504,33,58,109,734,13,110,68,126,123,194,794,1346,7,10027,557,0,2,3,6,1
36304,127,2753,1043,504,840,53,9,147,1096,9,180,112,198,189,310,1377,2344,4,11604,644,0,2,16,0,1
36305,127,2753,383,288,292,26,6,62,409,11,65,38,67,76,105,429,656,5,3719,206,0,2,16,0,1
36306,68,2807,1043,504,840,53,9,147,1096,9,180,112,198,189,310,1377,2344,4,11604,644,0,2,44,5,1
36307,127,2753,1043,504,840,53,9,147,1096,9,180,112,198,189,310,1377,2344,4,11604,644,0,2,4,2,0
36308,127,2753,383,288,292,26,6,62,409,11,65,38,67,76,105,429,656,5,3719,206,0,2,4,2,0
36309,321,6894,72,33,56,0,4,12,72,1,1,1,1,2,2,0,2,0,1,0,0,2,11,3,1
36310,321,6894,1454,835,1044,76,110,219,1530,17,275,158,296,292,454,2297,3718,9,34017,1889,1,2,11,3,1
36311,90,4091,1338,495,1086,10,64,173,1348,11,122,82,157,133,239,883,1686,7,11934,663,0,2,9,0,1
36312,102,1935,1178,367,1042,6,15,115,1184,9,94,51,95,103,146,644,976,4,4439,246,0,2,9,3,0
36313,102,1935,177,108,140,8,0,27,185,6,30,16,32,36,48,162,248,3,794,44,0,2,9,3,0
36314,310,6308,1457,730,1242,11,6,188,1468,10,292,166,329,302,495,2424,4078,5,22973,1276,1,2,19,4,1
36315,310,6308,74,35,59,1,0,14,75,3,14,7,14,17,21,58,85,1,128,7,0,2,19,4,1
36316,310,6308,245,125,200,5,7,34,250,7,30,17,34,37,51,166,265,3,1053,58,0,2,19,4,1
36317,54,3013,1296,573,1062,40,33,157,1336,8,201,118,231,209,349,1561,2689,4,12365,686,0,2,4,2,1
36318,65,3295,1457,730,1242,11,6,188,1468,10,292,166,329,302,495,2424,4078,5,22973,1276,1,2,39,3,1
36319,310,6308,1457,730,1242,11,6,188,1468,10,292,166,329,302,495,2424,4078,5,22973,1276,1,2,19,4,0
36320,310,6308,74,35,59,1,0,14,75,3,14,7,14,17,21,58,85,1,128,7,0,2,19,4,0
36321,310,6308,245,125,200,5,7,34,250,7,30,17,34,37,51,166,265,3,1053,58,0,2,19,4,0
36322,54,3013,1296,573,1062,40,33,157,1336,8,201,118,231,209,349,1561,2689,4,12365,686,0,2,4,2,0
36323,65,3295,1457,730,1242,11,6,188,1468,10,292,166,329,302,495,2424,4078,5,22973,1276,1,2,39,3,0
36324,330,6735,1457,730,1242,11,6,188,1468,10,292,166,329,302,495,2424,4078,5,22973,1276,1,2,19,4,1
36325,330,6735,74,35,59,1,0,14,75,3,14,7,14,17,21,58,85,1,128,7,0,2,19,4,1
36326,330,6735,245,125,200,5,7,34,250,7,30,17,34,37,51,166,265,3,1053,58,0,2,19,4,1
36332,59,3286,1296,573,1062,40,33,157,1336,8,201,118,231,209,349,1561,2689,4,12365,686,0,2,4,2,1
36333,72,3606,1457,730,1242,11,6,188,1468,10,292,166,329,302,495,2424,4078,5,22973,1276,1,2,43,4,1
36334,330,6735,1457,730,1242,11,6,188,1468,10,292,166,329,302,495,2424,4078,5,22973,1276,1,2,19,4,0
36335,330,6735,74,35,59,1,0,14,75,3,14,7,14,17,21,58,85,1,128,7,0,2,19,4,0
36336,330,6735,245,125,200,5,7,34,250,7,30,17,34,37,51,166,265,3,1053,58,0,2,19,4,0
36342,59,3286,1296,573,1062,40,33,157,1336,8,201,118,231,209,349,1561,2689,4,12365,686,0,2,4,2,0
36343,72,3606,1457,730,1242,11,6,188,1468,10,292,166,329,302,495,2424,4078,5,22973,1276,1,2,43,4,0
36344,70,2065,1523,757,1297,19,12,193,1542,12,193,117,230,205,347,1508,2664,7,19053,1058,0,2,3,6,0
36345,70,2065,701,378,504,33,58,109,734,13,110,68,126,123,194,794,1346,7,10027,557,0,2,3,6,0
36346,321,6894,72,33,56,0,4,12,72,1,1,1,1,2,2,0,2,0,1,0,0,2,11,3,0
36347,321,6894,1454,835,1044,76,110,219,1530,17,275,158,296,292,454,2297,3718,9,34017,1889,1,2,11,3,0
36348,127,2753,1043,504,840,53,9,147,1096,9,180,112,198,189,310,1377,2344,4,11604,644,0,2,34,2,0
36349,127,2753,383,288,292,26,6,62,409,11,65,38,67,76,105,429,656,5,3719,206,0,2,34,2,0
36350,90,4091,1338,495,1086,10,64,173,1348,11,122,82,157,133,239,883,1686,7,11934,663,0,2,9,0,0
36351,68,2807,1043,504,840,53,9,147,1096,9,180,112,198,189,310,1377,2344,4,11604,644,0,2,65,0,0
36352,67,2000,1523,757,1297,19,12,193,1542,12,193,117,230,205,347,1508,2664,7,19053,1058,0,2,1,1,1
36353,67,2000,701,378,504,33,58,109,734,13,110,68,126,123,194,794,1346,7,10027,557,0,2,1,1,1
36354,74,3538,1523,757,1297,19,12,193,1542,12,193,117,230,205,347,1508,2664,7,19053,1058,0,2,24,3,1
36355,67,2000,1523,757,1297,19,12,193,1542,12,193,117,230,205,347,1508,2664,7,19053,1058,0,2,1,1,0
36356,67,2000,701,378,504,33,58,109,734,13,110,68,126,123,194,794,1346,7,10027,557,0,2,1,1,0
36357,74,3538,1523,757,1297,19,12,193,1542,12,193,117,230,205,347,1508,2664,7,19053,1058,0,2,24,3,0
36358,39,1562,1098,241,925,5,10,155,1103,7,46,25,49,53,74,273,423,3,1580,87,0,2,22,8,1
36359,103,1947,1178,367,1042,6,15,115,1184,9,94,51,95,103,146,644,976,4,4439,246,0,2,7,4,0
36360,103,1947,177,108,140,8,0,27,185,6,30,16,32,36,48,162,248,3,794,44,0,2,7,4,0
36361,39,1564,1098,241,925,5,10,155,1103,7,46,25,49,53,74,273,423,3,1580,87,0,2,1,0,0
36362,103,1960,1178,367,1042,6,15,115,1184,9,94,51,95,103,146,644,976,4,4439,246,0,2,3,1,0
36363,103,1960,177,108,140,8,0,27,185,6,30,16,32,36,48,162,248,3,794,44,0,2,3,1,0
36364,49,573,647,139,84,35,284,233,682,0,0,0,0,0,0,0,0,0,0,0,0,2,1,1,0
36365,177,3652,1943,715,1694,26,18,214,1969,12,185,120,237,197,357,1436,2721,7,20915,1161,0,2,2,1,0
36366,177,3652,1168,838,957,57,25,144,1225,19,348,224,416,367,640,3018,5452,11,61921,3440,1,2,2,1,0
36367,71,3611,1943,715,1694,26,18,214,1969,12,185,120,237,197,357,1436,2721,7,20915,1161,0,2,3,1,0
36368,175,4048,77,34,69,0,0,8,77,3,24,16,29,27,45,114,213,1,387,21,0,2,1,1,1
36369,175,4048,712,438,573,51,9,84,763,14,102,71,128,116,199,733,1364,8,11988,666,0,2,1,1,1
36370,65,3297,1457,730,1242,11,6,188,1468,10,292,166,329,302,495,2424,4078,5,22973,1276,1,2,3,2,1
36371,524,11280,72,33,56,0,4,12,72,1,1,1,1,2,2,0,2,0,1,0,0,2,10,8,0
36372,524,11280,1454,835,1044,76,110,219,1530,17,275,158,296,292,454,2297,3718,9,34017,1889,1,2,10,8,0
36373,148,6631,139,89,101,2,0,35,141,7,54,34,62,61,96,330,569,4,2287,127,0,2,5,4,0
36374,148,6631,7,5,5,0,0,2,7,1,2,1,2,3,3,2,4,0,2,0,0,2,5,4,0
36383,175,4048,77,34,69,0,0,8,77,3,24,16,29,27,45,114,213,1,387,21,0,2,1,1,0
36384,175,4048,712,438,573,51,9,84,763,14,102,71,128,116,199,733,1364,8,11988,666,0,2,1,1,0
36385,65,3297,1457,730,1242,11,6,188,1468,10,292,166,329,302,495,2424,4078,5,22973,1276,1,2,3,2,0
36386,73,3480,1523,757,1297,19,12,193,1542,12,193,117,230,205,347,1508,2664,7,19053,1058,0,2,1,1,0
36388,30,649,215,129,180,6,0,29,221,8,65,43,72,73,115,415,711,4,3153,175,0,2,4,1,1
36389,30,649,97,69,77,3,3,16,100,6,22,13,23,28,36,113,173,3,542,30,0,2,4,1,1
36390,6,219,75,38,59,1,3,12,76,2,4,2,4,6,6,10,15,1,15,0,0,2,12,0,1
36392,30,649,215,129,180,6,0,29,221,8,65,43,72,73,115,415,711,4,3153,175,0,2,4,1,0
36393,30,649,97,69,77,3,3,16,100,6,22,13,23,28,36,113,173,3,542,30,0,2,4,1,0
36394,6,219,75,38,59,1,3,12,76,2,4,2,4,6,6,10,15,1,15,0,0,2,12,0,0
36395,225,5008,4293,999,3693,19,54,507,4312,9,155,88,170,164,258,1156,1898,4,9368,520,0,2,26,83,1
36396,225,5008,1482,859,1002,125,135,219,1607,16,219,134,251,235,385,1766,3032,9,27804,1544,1,2,26,83,1
36397,46,949,447,308,343,6,5,95,453,7,96,59,111,103,170,651,1136,4,4600,255,0,2,1,3,1
36398,46,949,322,174,179,16,74,51,338,10,41,26,46,51,72,252,408,5,2291,127,0,2,1,3,1
36399,321,6872,72,33,56,0,4,12,72,1,1,1,1,2,2,0,2,0,1,0,0,2,3,7,1
36400,321,6872,1454,835,1044,76,110,219,1530,17,275,158,296,292,454,2297,3718,9,34017,1889,1,2,3,7,1
36401,146,6681,139,89,101,2,0,35,141,7,54,34,62,61,96,330,569,4,2287,127,0,2,1,9,1
36402,146,6681,7,5,5,0,0,2,7,1,2,1,2,3,3,2,4,0,2,0,0,2,1,9,1
36403,38,1616,447,308,343,6,5,95,453,7,96,59,111,103,170,651,1136,4,4600,255,0,2,0,30,1
36404,334,6788,1457,730,1242,11,6,188,1468,10,292,166,329,302,495,2424,4078,5,22973,1276,1,2,20,7,1
36405,334,6788,74,35,59,1,0,14,75,3,14,7,14,17,21,58,85,1,128,7,0,2,20,7,1
36406,334,6788,245,125,200,5,7,34,250,7,30,17,34,37,51,166,265,3,1053,58,0,2,20,7,1
36408,24,834,74,35,59,1,0,14,75,3,14,7,14,17,21,58,85,1,128,7,0,2,0,1,1
36409,24,834,245,125,200,5,7,34,250,7,30,17,34,37,51,166,265,3,1053,58,0,2,0,1,1
36410,6,195,75,38,59,1,3,12,76,2,4,2,4,6,6,10,15,1,15,0,0,2,9,0,1
36411,72,3655,1457,730,1242,11,6,188,1468,10,292,166,329,302,495,2424,4078,5,22973,1276,1,2,20,16,1
36412,225,5008,4293,999,3693,19,54,507,4312,9,155,88,170,164,258,1156,1898,4,9368,520,0,2,26,83,0
36413,225,5008,1482,859,1002,125,135,219,1607,16,219,134,251,235,385,1766,3032,9,27804,1544,1,2,26,83,0
36414,46,949,447,308,343,6,5,95,453,7,96,59,111,103,170,651,1136,4,4600,255,0,2,1,3,0
36415,46,949,322,174,179,16,74,51,338,10,41,26,46,51,72,252,408,5,2291,127,0,2,1,3,0
36416,321,6886,72,33,56,0,4,12,72,1,1,1,1,2,2,0,2,0,1,0,0,2,3,7,0
36417,321,6886,1454,835,1044,76,110,219,1530,17,275,158,296,292,454,2297,3718,9,34017,1889,1,2,3,7,0
36418,146,6681,139,89,101,2,0,35,141,7,54,34,62,61,96,330,569,4,2287,127,0,2,1,9,0
36419,146,6681,7,5,5,0,0,2,7,1,2,1,2,3,3,2,4,0,2,0,0,2,1,9,0
36420,38,1616,447,308,343,6,5,95,453,7,96,59,111,103,170,651,1136,4,4600,255,0,2,0,30,0
36421,334,6788,1457,730,1242,11,6,188,1468,10,292,166,329,302,495,2424,4078,5,22973,1276,1,2,20,7,0
36422,334,6788,74,35,59,1,0,14,75,3,14,7,14,17,21,58,85,1,128,7,0,2,20,7,0
36423,334,6788,245,125,200,5,7,34,250,7,30,17,34,37,51,166,265,3,1053,58,0,2,20,7,0
36425,24,834,74,35,59,1,0,14,75,3,14,7,14,17,21,58,85,1,128,7,0,2,0,1,0
36426,24,834,245,125,200,5,7,34,250,7,30,17,34,37,51,166,265,3,1053,58,0,2,0,1,0
36427,7,252,75,38,59,1,3,12,76,2,4,2,4,6,6,10,15,1,15,0,0,2,9,0,0
36428,72,3655,1457,730,1242,11,6,188,1468,10,292,166,329,302,495,2424,4078,5,22973,1276,1,2,20,16,0
36429,74,3550,1523,757,1297,19,12,193,1542,12,193,117,230,205,347,1508,2664,7,19053,1058,0,2,21,4,0
36430,67,2902,1178,367,1042,6,15,115,1184,9,94,51,95,103,146,644,976,4,4439,246,0,2,16,2,0
36443,65,3297,1457,730,1242,11,6,188,1468,10,292,166,329,302,495,2424,4078,5,22973,1276,1,2,42,5,0
36444,75,3608,1523,757,1297,19,12,193,1542,12,193,117,230,205,347,1508,2664,7,19053,1058,0,2,24,3,0
36445,67,2902,1178,367,1042,6,15,115,1184,9,94,51,95,103,146,644,976,4,4439,246,0,2,2,2,0
36446,75,3608,1523,757,1297,19,12,193,1542,12,193,117,230,205,347,1508,2664,7,19053,1058,0,2,5,2,0
36447,85,4578,1782,648,1425,9,47,279,1791,8,171,97,189,179,286,1292,2140,4,9462,525,0,2,6,5,0
36448,85,4578,1782,648,1425,9,47,279,1791,8,171,97,189,179,286,1292,2140,4,9462,525,0,2,1,1,0
36449,105,1995,1178,367,1042,6,15,115,1184,9,94,51,95,103,146,644,976,4,4439,246,0,2,17,3,0
36450,105,1995,177,108,140,8,0,27,185,6,30,16,32,36,48,162,248,3,794,44,0,2,17,3,0
36451,45,1696,1098,241,925,5,10,155,1103,7,46,25,49,53,74,273,423,3,1580,87,0,2,44,19,0
36452,65,3307,1457,730,1242,11,6,188,1468,10,292,166,329,302,495,2424,4078,5,22973,1276,1,2,2,0,0
36453,105,1995,1178,367,1042,6,15,115,1184,9,94,51,95,103,146,644,976,4,4439,246,0,2,31,6,0
36454,105,1995,177,108,140,8,0,27,185,6,30,16,32,36,48,162,248,3,794,44,0,2,31,6,0
36457,75,3608,1523,757,1297,19,12,193,1542,12,193,117,230,205,347,1508,2664,7,19053,1058,0,2,27,7,0
36459,45,1696,1098,241,925,5,10,155,1103,7,46,25,49,53,74,273,423,3,1580,87,0,2,54,14,0
36460,225,5040,4293,999,3693,19,54,507,4312,9,155,88,170,164,258,1156,1898,4,9368,520,0,2,11,7,1
36461,225,5040,1482,859,1002,125,135,219,1607,16,219,134,251,235,385,1766,3032,9,27804,1544,1,2,11,7,1
36462,70,2072,1523,757,1297,19,12,193,1542,12,193,117,230,205,347,1508,2664,7,19053,1058,0,2,1,1,1
36463,70,2072,701,378,504,33,58,109,734,13,110,68,126,123,194,794,1346,7,10027,557,0,2,1,1,1
36464,179,4150,77,34,69,0,0,8,77,3,24,16,29,27,45,114,213,1,387,21,0,2,1,1,1
36465,179,4150,712,438,573,51,9,84,763,14,102,71,128,116,199,733,1364,8,11988,666,0,2,1,1,1
36466,321,6886,72,33,56,0,4,12,72,1,1,1,1,2,2,0,2,0,1,0,0,2,0,1,1
36467,321,6886,1454,835,1044,76,110,219,1530,17,275,158,296,292,454,2297,3718,9,34017,1889,1,2,0,1,1
36468,104,1979,1178,367,1042,6,15,115,1184,9,94,51,95,103,146,644,976,4,4439,246,0,2,31,6,1
36469,104,1979,177,108,140,8,0,27,185,6,30,16,32,36,48,162,248,3,794,44,0,2,31,6,1
36470,146,6683,139,89,101,2,0,35,141,7,54,34,62,61,96,330,569,4,2287,127,0,2,5,5,1
36471,146,6683,7,5,5,0,0,2,7,1,2,1,2,3,3,2,4,0,2,0,0,2,5,5,1
36472,94,4971,1782,648,1425,9,47,279,1791,8,171,97,189,179,286,1292,2140,4,9462,525,0,2,6,5,1
36473,72,3657,1457,730,1242,11,6,188,1468,10,292,166,329,302,495,2424,4078,5,22973,1276,1,2,4,2,1
36474,78,3868,1523,757,1297,19,12,193,1542,12,193,117,230,205,347,1508,2664,7,19053,1058,0,2,49,8,1
36475,68,2926,1178,367,1042,6,15,115,1184,9,94,51,95,103,146,644,976,4,4439,246,0,2,16,2,1
36476,46,1725,1098,241,925,5,10,155,1103,7,46,25,49,53,74,273,423,3,1580,87,0,2,54,14,1
36477,41,791,207,111,150,11,0,50,218,5,26,19,36,31,55,133,272,3,943,52,0,2,15,0,1
36478,41,791,410,198,237,31,55,97,441,11,63,38,72,74,110,414,683,6,4293,238,0,2,15,0,1
36479,103,1969,1178,367,1042,6,15,115,1184,9,94,51,95,103,146,644,976,4,4439,246,0,2,1,12,1
36480,103,1969,177,108,140,8,0,27,185,6,30,16,32,36,48,162,248,3,794,44,0,2,1,12,1
36481,46,1725,1098,241,925,5,10,155,1103,7,46,25,49,53,74,273,423,3,1580,87,0,2,2,2,1
36482,41,791,207,111,150,11,0,50,218,5,26,19,36,31,55,133,272,3,943,52,0,2,0,2,0
36483,41,791,410,198,237,31,55,97,441,11,63,38,72,74,110,414,683,6,4293,238,0,2,0,2,0
36484,41,791,207,111,150,11,0,50,218,5,26,19,36,31,55,133,272,3,943,52,0,2,13,0,0
36485,41,791,410,198,237,31,55,97,441,11,63,38,72,74,110,414,683,6,4293,238,0,2,13,0,0
36486,225,5040,4293,999,3693,19,54,507,4312,9,155,88,170,164,258,1156,1898,4,9368,520,0,2,11,7,0
36487,225,5040,1482,859,1002,125,135,219,1607,16,219,134,251,235,385,1766,3032,9,27804,1544,1,2,11,7,0
36488,70,2072,1523,757,1297,19,12,193,1542,12,193,117,230,205,347,1508,2664,7,19053,1058,0,2,1,1,0
36489,70,2072,701,378,504,33,58,109,734,13,110,68,126,123,194,794,1346,7,10027,557,0,2,1,1,0
36490,179,4150,77,34,69,0,0,8,77,3,24,16,29,27,45,114,213,1,387,21,0,2,1,1,0
36491,179,4150,712,438,573,51,9,84,763,14,102,71,128,116,199,733,1364,8,11988,666,0,2,1,1,0
36492,321,6886,72,33,56,0,4,12,72,1,1,1,1,2,2,0,2,0,1,0,0,2,0,1,0
36493,321,6886,1454,835,1044,76,110,219,1530,17,275,158,296,292,454,2297,3718,9,34017,1889,1,2,0,1,0
36494,103,1969,1178,367,1042,6,15,115,1184,9,94,51,95,103,146,644,976,4,4439,246,0,2,20,6,0
36495,103,1969,177,108,140,8,0,27,185,6,30,16,32,36,48,162,248,3,794,44,0,2,20,6,0
36496,146,6683,139,89,101,2,0,35,141,7,54,34,62,61,96,330,569,4,2287,127,0,2,5,5,0
36497,146,6683,7,5,5,0,0,2,7,1,2,1,2,3,3,2,4,0,2,0,0,2,5,5,0
36498,94,4971,1782,648,1425,9,47,279,1791,8,171,97,189,179,286,1292,2140,4,9462,525,0,2,6,5,0
36499,72,3657,1457,730,1242,11,6,188,1468,10,292,166,329,302,495,2424,4078,5,22973,1276,1,2,4,2,0
36500,78,3868,1523,757,1297,19,12,193,1542,12,193,117,230,205,347,1508,2664,7,19053,1058,0,2,49,8,0
36501,68,2926,1178,367,1042,6,15,115,1184,9,94,51,95,103,146,644,976,4,4439,246,0,2,16,2,0
36502,46,1725,1098,241,925,5,10,155,1103,7,46,25,49,53,74,273,423,3,1580,87,0,2,54,14,0
36595,322,6894,72,33,56,0,4,12,72,1,1,1,1,2,2,0,2,0,1,0,0,2,3,1,1
36596,322,6894,1454,835,1044,76,110,219,1530,17,275,158,296,292,454,2297,3718,9,34017,1889,1,2,3,1,1
36597,128,2805,1043,504,840,53,9,147,1096,9,180,112,198,189,310,1377,2344,4,11604,644,0,2,12,5,1
36598,128,2805,383,288,292,26,6,62,409,11,65,38,67,76,105,429,656,5,3719,206,0,2,12,5,1
36599,69,2837,1043,504,840,53,9,147,1096,9,180,112,198,189,310,1377,2344,4,11604,644,0,2,13,0,1
36600,322,6894,72,33,56,0,4,12,72,1,1,1,1,2,2,0,2,0,1,0,0,2,3,1,0
36601,322,6894,1454,835,1044,76,110,219,1530,17,275,158,296,292,454,2297,3718,9,34017,1889,1,2,3,1,0
36602,128,2805,1043,504,840,53,9,147,1096,9,180,112,198,189,310,1377,2344,4,11604,644,0,2,12,5,0
36603,128,2805,383,288,292,26,6,62,409,11,65,38,67,76,105,429,656,5,3719,206,0,2,12,5,0
36604,69,2837,1043,504,840,53,9,147,1096,9,180,112,198,189,310,1377,2344,4,11604,644,0,2,13,0,0
36605,321,6886,72,33,56,0,4,12,72,1,1,1,1,2,2,0,2,0,1,0,0,2,2,2,0
36606,321,6886,1454,835,1044,76,110,219,1530,17,275,158,296,292,454,2297,3718,9,34017,1889,1,2,2,2,0
36607,68,2926,1178,367,1042,6,15,115,1184,9,94,51,95,103,146,644,976,4,4439,246,0,2,1,1,0
36608,128,2805,1043,504,840,53,9,147,1096,9,180,112,198,189,310,1377,2344,4,11604,644,0,2,1,1,1
36609,128,2805,383,288,292,26,6,62,409,11,65,38,67,76,105,429,656,5,3719,206,0,2,1,1,1
36610,128,2805,1043,504,840,53,9,147,1096,9,180,112,198,189,310,1377,2344,4,11604,644,0,2,1,1,0
36611,128,2805,383,288,292,26,6,62,409,11,65,38,67,76,105,429,656,5,3719,206,0,2,1,1,0
36612,322,6894,72,33,56,0,4,12,72,1,1,1,1,2,2,0,2,0,1,0,0,2,2,2,0
36613,322,6894,1454,835,1044,76,110,219,1530,17,275,158,296,292,454,2297,3718,9,34017,1889,1,2,2,2,0
36615,70,1304,1020,354,843,12,15,144,1032,8,134,77,144,142,221,970,1580,4,6792,377,0,2,15,0,1
36616,321,6850,72,33,56,0,4,12,72,1,1,1,1,2,2,0,2,0,1,0,0,2,13,18,1
36617,321,6850,1454,835,1044,76,110,219,1530,17,275,158,296,292,454,2297,3718,9,34017,1889,1,2,13,18,1
36618,179,4151,77,34,69,0,0,8,77,3,24,16,29,27,45,114,213,1,387,21,0,2,1,1,1
36619,179,4151,712,438,573,51,9,84,763,14,102,71,128,116,199,733,1364,8,11988,666,0,2,1,1,1
36620,70,1304,1020,354,843,12,15,144,1032,8,134,77,144,142,221,970,1580,4,6792,377,0,2,15,0,0
36621,321,6850,72,33,56,0,4,12,72,1,1,1,1,2,2,0,2,0,1,0,0,2,13,18,0
36622,321,6850,1454,835,1044,76,110,219,1530,17,275,158,296,292,454,2297,3718,9,34017,1889,1,2,13,18,0
36623,78,3291,1289,550,1043,56,32,155,1345,10,167,93,185,177,278,1266,2075,5,11498,638,0,2,18,0,0
36624,179,4151,77,34,69,0,0,8,77,3,24,16,29,27,45,114,213,1,387,21,0,2,1,1,0
36625,179,4151,712,438,573,51,9,84,763,14,102,71,128,116,199,733,1364,8,11988,666,0,2,1,1,0
36627,326,6911,72,33,56,0,4,12,72,1,1,1,1,2,2,0,2,0,1,0,0,2,26,8,1
36628,326,6911,1454,835,1044,76,110,219,1530,17,275,158,296,292,454,2297,3718,9,34017,1889,1,2,26,8,1
36629,98,5099,1782,648,1425,9,47,279,1791,8,171,97,189,179,286,1292,2140,4,9462,525,0,2,119,37,1
36630,334,6788,1457,730,1242,11,6,188,1468,10,292,166,329,302,495,2424,4078,5,22973,1276,1,2,1,1,0
36631,334,6788,74,35,59,1,0,14,75,3,14,7,14,17,21,58,85,1,128,7,0,2,1,1,0
36632,334,6788,245,125,200,5,7,34,250,7,30,17,34,37,51,166,265,3,1053,58,0,2,1,1,0
36633,326,6911,72,33,56,0,4,12,72,1,1,1,1,2,2,0,2,0,1,0,0,2,26,8,0
36634,326,6911,1454,835,1044,76,110,219,1530,17,275,158,296,292,454,2297,3718,9,34017,1889,1,2,26,8,0
36635,98,5099,1782,648,1425,9,47,279,1791,8,171,97,189,179,286,1292,2140,4,9462,525,0,2,119,37,0
36636,327,6920,72,33,56,0,4,12,72,1,1,1,1,2,2,0,2,0,1,0,0,2,1,1,0
36637,327,6920,1454,835,1044,76,110,219,1530,17,275,158,296,292,454,2297,3718,9,34017,1889,1,2,1,1,0
36638,100,5163,1782,648,1425,9,47,279,1791,8,171,97,189,179,286,1292,2140,4,9462,525,0,2,27,0,0
36714,327,6920,72,33,56,0,4,12,72,1,1,1,1,2,2,0,2,0,1,0,0,2,45,30,0
36715,327,6920,1454,835,1044,76,110,219,1530,17,275,158,296,292,454,2297,3718,9,34017,1889,1,2,45,30,0
36719,100,5163,1782,648,1425,9,47,279,1791,8,171,97,189,179,286,1292,2140,4,9462,525,0,2,146,37,0
36722,330,6968,72,33,56,0,4,12,72,1,1,1,1,2,2,0,2,0,1,0,0,2,9,3,1
36723,330,6968,1454,835,1044,76,110,219,1530,17,275,158,296,292,454,2297,3718,9,34017,1889,1,2,9,3,1
36724,101,5195,1782,648,1425,9,47,279,1791,8,171,97,189,179,286,1292,2140,4,9462,525,0,2,12,0,1
36736,330,6968,72,33,56,0,4,12,72,1,1,1,1,2,2,0,2,0,1,0,0,2,9,3,0
36737,330,6968,1454,835,1044,76,110,219,1530,17,275,158,296,292,454,2297,3718,9,34017,1889,1,2,9,3,0
36738,101,5195,1782,648,1425,9,47,279,1791,8,171,97,189,179,286,1292,2140,4,9462,525,0,2,12,0,0
36739,334,6788,1457,730,1242,11,6,188,1468,10,292,166,329,302,495,2424,4078,5,22973,1276,1,2,1,1,1
36740,334,6788,74,35,59,1,0,14,75,3,14,7,14,17,21,58,85,1,128,7,0,2,1,1,1
36741,334,6788,245,125,200,5,7,34,250,7,30,17,34,37,51,166,265,3,1053,58,0,2,1,1,1
36742,119,2397,1513,682,1277,25,13,200,1538,11,199,116,219,210,335,1557,2584,6,15641,868,0,2,7,0,1
36743,119,2397,819,519,539,24,98,155,843,15,96,57,106,111,163,690,1107,8,9171,509,0,2,7,0,1
36744,116,4563,1513,682,1277,25,13,200,1538,11,199,116,219,210,335,1557,2584,6,15641,868,0,2,22,0,1
36745,119,2397,1513,682,1277,25,13,200,1538,11,199,116,219,210,335,1557,2584,6,15641,868,0,2,7,0,0
36746,119,2397,819,519,539,24,98,155,843,15,96,57,106,111,163,690,1107,8,9171,509,0,2,7,0,0
36747,116,4563,1513,682,1277,25,13,200,1538,11,199,116,219,210,335,1557,2584,6,15641,868,0,2,22,0,0
36748,71,2088,1523,757,1297,19,12,193,1542,12,193,117,230,205,347,1508,2664,7,19053,1058,0,2,2,0,0
36749,71,2088,701,378,504,33,58,109,734,13,110,68,126,123,194,794,1346,7,10027,557,0,2,2,0,0
36750,79,3991,1523,757,1297,19,12,193,1542,12,193,117,230,205,347,1508,2664,7,19053,1058,0,2,25,0,0
36751,207,4437,182,127,129,0,0,53,182,5,39,21,42,44,63,217,343,2,926,51,0,2,1,1,1
36752,207,4437,1165,710,800,67,119,181,1232,18,243,153,282,261,435,2000,3492,10,36473,2026,1,2,1,1,1
36753,87,3140,1450,624,1228,12,26,181,1462,14,306,186,354,320,540,2580,4493,8,36391,2021,1,2,9,0,1
36754,207,4437,182,127,129,0,0,53,182,5,39,21,42,44,63,217,343,2,926,51,0,2,1,1,0
36755,207,4437,1165,710,800,67,119,181,1232,18,243,153,282,261,435,2000,3492,10,36473,2026,1,2,1,1,0
36756,87,3140,1450,624,1228,12,26,181,1462,14,306,186,354,320,540,2580,4493,8,36391,2021,1,2,9,0,0
36757,330,6968,72,33,56,0,4,12,72,1,1,1,1,2,2,0,2,0,1,0,0,2,11,16,1
36758,330,6968,1454,835,1044,76,110,219,1530,17,275,158,296,292,454,2297,3718,9,34017,1889,1,2,11,16,1
36759,1,310,382,65,130,157,2,92,539,4,10,5,10,14,15,41,57,2,114,6,0,2,2,2,1
36760,330,6968,72,33,56,0,4,12,72,1,1,1,1,2,2,0,2,0,1,0,0,2,11,16,0
36761,330,6968,1454,835,1044,76,110,219,1530,17,275,158,296,292,454,2297,3718,9,34017,1889,1,2,11,16,0
36762,1,310,382,65,130,157,2,92,539,4,10,5,10,14,15,41,57,2,114,6,0,2,2,2,0
36763,23,680,339,213,244,17,9,65,356,10,42,26,48,52,74,259,421,5,2410,133,0,2,1,1,0
36765,55,1112,1098,241,925,5,10,155,1103,7,46,25,49,53,74,273,423,3,1580,87,0,2,6,1,0
36766,55,1112,282,202,222,14,2,44,296,8,42,24,43,50,67,250,378,4,1548,86,0,2,6,1,0
36772,330,6968,72,33,56,0,4,12,72,1,1,1,1,2,2,0,2,0,1,0,0,2,20,19,0
36773,330,6968,1454,835,1044,76,110,219,1530,17,275,158,296,292,454,2297,3718,9,34017,1889,1,2,20,19,0
36780,34,625,2,2,2,0,0,0,2,0,0,0,0,0,0,0,0,0,0,0,0,2,6,0,1
36794,34,625,99,48,90,1,3,5,100,0,0,0,0,0,0,0,0,0,0,0,0,2,6,0,1
36795,34,625,8,5,5,2,0,1,10,0,0,0,0,0,0,0,0,0,0,0,0,2,6,0,1
36796,34,625,1217,716,841,84,126,174,1301,14,185,118,215,199,333,1446,2542,8,20687,1149,0,2,6,0,1
36797,34,625,160,89,115,0,13,31,160,7,15,11,17,22,28,78,124,3,495,27,0,2,6,0,1
36798,34,625,10,10,9,9,0,0,19,0,0,0,0,0,0,0,0,0,0,0,0,2,6,0,1
36799,34,625,173,84,99,8,29,36,181,5,12,7,13,17,20,54,81,2,221,12,0,2,6,0,1
36800,34,625,3,1,1,3,0,0,6,0,0,0,0,0,0,0,0,0,0,0,0,2,6,0,1
36801,335,6801,1457,730,1242,11,6,188,1468,10,292,166,329,302,495,2424,4078,5,22973,1276,1,2,2,0,1
36802,335,6801,74,35,59,1,0,14,75,3,14,7,14,17,21,58,85,1,128,7,0,2,2,0,1
36803,335,6801,245,125,200,5,7,34,250,7,30,17,34,37,51,166,265,3,1053,58,0,2,2,0,1
36804,90,3249,1450,624,1228,12,26,181,1462,14,306,186,354,320,540,2580,4493,8,36391,2021,1,2,29,0,1
36807,34,625,2,2,2,0,0,0,2,0,0,0,0,0,0,0,0,0,0,0,0,2,6,0,0
36821,34,625,99,48,90,1,3,5,100,0,0,0,0,0,0,0,0,0,0,0,0,2,6,0,0
36822,34,625,8,5,5,2,0,1,10,0,0,0,0,0,0,0,0,0,0,0,0,2,6,0,0
36823,34,625,1217,716,841,84,126,174,1301,14,185,118,215,199,333,1446,2542,8,20687,1149,0,2,6,0,0
36824,34,625,160,89,115,0,13,31,160,7,15,11,17,22,28,78,124,3,495,27,0,2,6,0,0
36825,34,625,10,10,9,9,0,0,19,0,0,0,0,0,0,0,0,0,0,0,0,2,6,0,0
36826,34,625,173,84,99,8,29,36,181,5,12,7,13,17,20,54,81,2,221,12,0,2,6,0,0
36827,34,625,3,1,1,3,0,0,6,0,0,0,0,0,0,0,0,0,0,0,0,2,6,0,0
36828,335,6801,1457,730,1242,11,6,188,1468,10,292,166,329,302,495,2424,4078,5,22973,1276,1,2,2,0,0
36829,335,6801,74,35,59,1,0,14,75,3,14,7,14,17,21,58,85,1,128,7,0,2,2,0,0
36830,335,6801,245,125,200,5,7,34,250,7,30,17,34,37,51,166,265,3,1053,58,0,2,2,0,0
36831,90,3249,1450,624,1228,12,26,181,1462,14,306,186,354,320,540,2580,4493,8,36391,2021,1,2,29,0,0
36832,40,1472,1293,570,1093,25,15,163,1318,10,195,123,241,205,364,1516,2795,6,17273,959,0,2,19,0,0
36860,55,1112,1098,241,925,5,10,155,1103,7,46,25,49,53,74,273,423,3,1580,87,0,2,1,1,1
36861,55,1112,282,202,222,14,2,44,296,8,42,24,43,50,67,250,378,4,1548,86,0,2,1,1,1
36862,40,1472,1293,570,1093,25,15,163,1318,10,195,123,241,205,364,1516,2795,6,17273,959,0,2,2,2,1
36889,56,1576,1455,414,1257,16,76,112,1471,5,41,23,46,46,69,231,381,2,1069,59,0,2,1,1,0
36890,56,1576,669,365,481,22,61,110,691,15,103,63,122,118,185,747,1273,8,11311,628,0,2,1,1,0
37011,56,1576,1455,414,1257,16,76,112,1471,5,41,23,46,46,69,231,381,2,1069,59,0,2,1,1,1
37012,56,1576,669,365,481,22,61,110,691,15,103,63,122,118,185,747,1273,8,11311,628,0,2,1,1,1
37013,55,1112,1098,241,925,5,10,155,1103,7,46,25,49,53,74,273,423,3,1580,87,0,2,6,1,1
37014,55,1112,282,202,222,14,2,44,296,8,42,24,43,50,67,250,378,4,1548,86,0,2,6,1,1
37016,40,1472,1293,570,1093,25,15,163,1318,10,195,123,241,205,364,1516,2795,6,17273,959,0,2,19,0,1
37072,330,6972,72,33,56,0,4,12,72,1,1,1,1,2,2,0,2,0,1,0,0,2,1,1,1
37073,330,6972,1454,835,1044,76,110,219,1530,17,275,158,296,292,454,2297,3718,9,34017,1889,1,2,1,1,1
37074,103,5262,1782,648,1425,9,47,279,1791,8,171,97,189,179,286,1292,2140,4,9462,525,0,2,8,0,1
37075,70,1304,1020,354,843,12,15,144,1032,8,134,77,144,142,221,970,1580,4,6792,377,0,2,1,1,1
37076,70,1304,1020,354,843,12,15,144,1032,8,134,77,144,142,221,970,1580,4,6792,377,0,2,1,1,0
37077,330,6963,72,33,56,0,4,12,72,1,1,1,1,2,2,0,2,0,1,0,0,2,2,1,0
37078,330,6963,1454,835,1044,76,110,219,1530,17,275,158,296,292,454,2297,3718,9,34017,1889,1,2,2,1,0
37079,178,4126,77,34,69,0,0,8,77,3,24,16,29,27,45,114,213,1,387,21,0,2,0,4,1
37080,178,4126,712,438,573,51,9,84,763,14,102,71,128,116,199,733,1364,8,11988,666,0,2,0,4,1
37081,224,5018,722,423,573,19,0,135,741,12,172,101,199,184,300,1320,2257,6,15668,870,0,2,7,1,1
37082,224,5018,1508,847,911,44,250,301,1552,14,148,88,169,162,257,1120,1886,7,15077,837,0,2,7,1,1
37083,128,2812,1043,504,840,53,9,147,1096,9,180,112,198,189,310,1377,2344,4,11604,644,0,2,3,2,1
37084,128,2812,383,288,292,26,6,62,409,11,65,38,67,76,105,429,656,5,3719,206,0,2,3,2,1
37085,330,6972,72,33,56,0,4,12,72,1,1,1,1,2,2,0,2,0,1,0,0,2,1,1,0
37086,330,6972,1454,835,1044,76,110,219,1530,17,275,158,296,292,454,2297,3718,9,34017,1889,1,2,1,1,0
37087,103,5262,1782,648,1425,9,47,279,1791,8,171,97,189,179,286,1292,2140,4,9462,525,0,2,8,0,0
37088,82,1794,477,336,357,30,23,73,507,16,194,134,250,210,384,1538,2962,10,30538,1696,0,2,1,1,0
37089,320,6878,72,33,56,0,4,12,72,1,1,1,1,2,2,0,2,0,1,0,0,2,0,6,0
37090,320,6878,1454,835,1044,76,110,219,1530,17,275,158,296,292,454,2297,3718,9,34017,1889,1,2,0,6,0
37091,15,340,256,139,192,9,7,47,265,4,23,12,24,27,36,112,171,2,357,19,0,2,0,8,0
37092,1,300,382,65,130,157,2,92,539,4,10,5,10,14,15,41,57,2,114,6,0,2,2,5,0
37094,329,6952,72,33,56,0,4,12,72,1,1,1,1,2,2,0,2,0,1,0,0,2,0,6,0
37095,329,6952,1454,835,1044,76,110,219,1530,17,275,158,296,292,454,2297,3718,9,34017,1889,1,2,0,6,0
37098,179,4155,77,34,69,0,0,8,77,3,24,16,29,27,45,114,213,1,387,21,0,2,1,1,1
37099,179,4155,712,438,573,51,9,84,763,14,102,71,128,116,199,733,1364,8,11988,666,0,2,1,1,1
37100,69,1346,1020,354,843,12,15,144,1032,8,134,77,144,142,221,970,1580,4,6792,377,0,2,46,37,1
37101,103,1956,1178,367,1042,6,15,115,1184,9,94,51,95,103,146,644,976,4,4439,246,0,2,3,5,1
37102,103,1956,177,108,140,8,0,27,185,6,30,16,32,36,48,162,248,3,794,44,0,2,3,5,1
37103,66,2750,1020,354,843,12,15,144,1032,8,134,77,144,142,221,970,1580,4,6792,377,0,2,2,2,1
37104,41,798,207,111,150,11,0,50,218,5,26,19,36,31,55,133,272,3,943,52,0,2,4,2,1
37105,41,798,410,198,237,31,55,97,441,11,63,38,72,74,110,414,683,6,4293,238,0,2,4,2,1
37106,69,1347,1020,354,843,12,15,144,1032,8,134,77,144,142,221,970,1580,4,6792,377,0,2,1,1,1
37107,41,798,207,111,150,11,0,50,218,5,26,19,36,31,55,133,272,3,943,52,0,2,1,1,1
37108,41,798,410,198,237,31,55,97,441,11,63,38,72,74,110,414,683,6,4293,238,0,2,1,1,1
37109,336,6810,1457,730,1242,11,6,188,1468,10,292,166,329,302,495,2424,4078,5,22973,1276,1,2,15,10,1
37110,336,6810,74,35,59,1,0,14,75,3,14,7,14,17,21,58,85,1,128,7,0,2,15,10,1
37111,336,6810,245,125,200,5,7,34,250,7,30,17,34,37,51,166,265,3,1053,58,0,2,15,10,1
37112,90,3273,1450,624,1228,12,26,181,1462,14,306,186,354,320,540,2580,4493,8,36391,2021,1,2,14,4,1
37113,336,6810,1457,730,1242,11,6,188,1468,10,292,166,329,302,495,2424,4078,5,22973,1276,1,2,15,10,0
37114,336,6810,74,35,59,1,0,14,75,3,14,7,14,17,21,58,85,1,128,7,0,2,15,10,0
37115,336,6810,245,125,200,5,7,34,250,7,30,17,34,37,51,166,265,3,1053,58,0,2,15,10,0
37116,90,3273,1450,624,1228,12,26,181,1462,14,306,186,354,320,540,2580,4493,8,36391,2021,1,2,14,4,0
37117,336,6810,1457,730,1242,11,6,188,1468,10,292,166,329,302,495,2424,4078,5,22973,1276,1,2,1,1,0
37118,336,6810,74,35,59,1,0,14,75,3,14,7,14,17,21,58,85,1,128,7,0,2,1,1,0
37119,336,6810,245,125,200,5,7,34,250,7,30,17,34,37,51,166,265,3,1053,58,0,2,1,1,0
37120,178,4126,77,34,69,0,0,8,77,3,24,16,29,27,45,114,213,1,387,21,0,2,0,4,0
37121,178,4126,712,438,573,51,9,84,763,14,102,71,128,116,199,733,1364,8,11988,666,0,2,0,4,0
37122,224,5018,722,423,573,19,0,135,741,12,172,101,199,184,300,1320,2257,6,15668,870,0,2,7,1,0
37123,224,5018,1508,847,911,44,250,301,1552,14,148,88,169,162,257,1120,1886,7,15077,837,0,2,7,1,0
37124,329,6947,72,33,56,0,4,12,72,1,1,1,1,2,2,0,2,0,1,0,0,2,2,1,0
37125,329,6947,1454,835,1044,76,110,219,1530,17,275,158,296,292,454,2297,3718,9,34017,1889,1,2,2,1,0
37126,128,2812,1043,504,840,53,9,147,1096,9,180,112,198,189,310,1377,2344,4,11604,644,0,2,3,2,0
37127,128,2812,383,288,292,26,6,62,409,11,65,38,67,76,105,429,656,5,3719,206,0,2,3,2,0
37131,82,1795,477,336,357,30,23,73,507,16,194,134,250,210,384,1538,2962,10,30538,1696,0,2,2,2,0
37132,91,3316,1450,624,1228,12,26,181,1462,14,306,186,354,320,540,2580,4493,8,36391,2021,1,2,10,2,0
37135,34,643,2,2,2,0,0,0,2,0,0,0,0,0,0,0,0,0,0,0,0,2,11,4,0
37149,34,643,99,48,90,1,3,5,100,0,0,0,0,0,0,0,0,0,0,0,0,2,11,4,0
37150,34,643,8,5,5,2,0,1,10,0,0,0,0,0,0,0,0,0,0,0,0,2,11,4,0
37151,34,643,1217,716,841,84,126,174,1301,14,185,118,215,199,333,1446,2542,8,20687,1149,0,2,11,4,0
37152,34,643,160,89,115,0,13,31,160,7,15,11,17,22,28,78,124,3,495,27,0,2,11,4,0
37153,34,643,10,10,9,9,0,0,19,0,0,0,0,0,0,0,0,0,0,0,0,2,11,4,0
37154,34,643,173,84,99,8,29,36,181,5,12,7,13,17,20,54,81,2,221,12,0,2,11,4,0
37155,34,643,3,1,1,3,0,0,6,0,0,0,0,0,0,0,0,0,0,0,0,2,11,4,0
37156,41,798,207,111,150,11,0,50,218,5,26,19,36,31,55,133,272,3,943,52,0,2,4,2,0
37157,41,798,410,198,237,31,55,97,441,11,63,38,72,74,110,414,683,6,4293,238,0,2,4,2,0
37158,178,4130,77,34,69,0,0,8,77,3,24,16,29,27,45,114,213,1,387,21,0,2,1,1,0
37159,178,4130,712,438,573,51,9,84,763,14,102,71,128,116,199,733,1364,8,11988,666,0,2,1,1,0
37160,69,1347,1020,354,843,12,15,144,1032,8,134,77,144,142,221,970,1580,4,6792,377,0,2,46,37,0
37161,103,1956,1178,367,1042,6,15,115,1184,9,94,51,95,103,146,644,976,4,4439,246,0,2,3,5,0
37162,103,1956,177,108,140,8,0,27,185,6,30,16,32,36,48,162,248,3,794,44,0,2,3,5,0
37163,66,2750,1020,354,843,12,15,144,1032,8,134,77,144,142,221,970,1580,4,6792,377,0,2,2,2,0
37189,330,6978,72,33,56,0,4,12,72,1,1,1,1,2,2,0,2,0,1,0,0,2,3,4,0
37190,330,6978,1454,835,1044,76,110,219,1530,17,275,158,296,292,454,2297,3718,9,34017,1889,1,2,3,4,0
37191,91,3313,1450,624,1228,12,26,181,1462,14,306,186,354,320,540,2580,4493,8,36391,2021,1,2,12,0,0
37195,22,673,339,213,244,17,9,65,356,10,42,26,48,52,74,259,421,5,2410,133,0,2,9,8,0
37196,42,1533,1293,570,1093,25,15,163,1318,10,195,123,241,205,364,1516,2795,6,17273,959,0,2,31,15,0
37197,44,1603,1293,570,1093,25,15,163,1318,10,195,123,241,205,364,1516,2795,6,17273,959,0,2,19,0,1
37198,228,5101,4293,999,3693,19,54,507,4312,9,155,88,170,164,258,1156,1898,4,9368,520,0,2,23,1,1
37199,228,5101,1482,859,1002,125,135,219,1607,16,219,134,251,235,385,1766,3032,9,27804,1544,1,2,23,1,1
37200,330,6987,72,33,56,0,4,12,72,1,1,1,1,2,2,0,2,0,1,0,0,2,3,2,1
37201,330,6987,1454,835,1044,76,110,219,1530,17,275,158,296,292,454,2297,3718,9,34017,1889,1,2,3,2,1
37202,147,6715,139,89,101,2,0,35,141,7,54,34,62,61,96,330,569,4,2287,127,0,2,16,0,1
37203,147,6715,7,5,5,0,0,2,7,1,2,1,2,3,3,2,4,0,2,0,0,2,16,0,1
37204,106,5313,1782,648,1425,9,47,279,1791,8,171,97,189,179,286,1292,2140,4,9462,525,0,2,8,0,1
37205,228,5101,4293,999,3693,19,54,507,4312,9,155,88,170,164,258,1156,1898,4,9368,520,0,2,23,1,0
37206,228,5101,1482,859,1002,125,135,219,1607,16,219,134,251,235,385,1766,3032,9,27804,1544,1,2,23,1,0
37207,330,6987,72,33,56,0,4,12,72,1,1,1,1,2,2,0,2,0,1,0,0,2,3,2,0
37208,330,6987,1454,835,1044,76,110,219,1530,17,275,158,296,292,454,2297,3718,9,34017,1889,1,2,3,2,0
37209,147,6715,139,89,101,2,0,35,141,7,54,34,62,61,96,330,569,4,2287,127,0,2,16,0,0
37210,147,6715,7,5,5,0,0,2,7,1,2,1,2,3,3,2,4,0,2,0,0,2,16,0,0
37211,106,5313,1782,648,1425,9,47,279,1791,8,171,97,189,179,286,1292,2140,4,9462,525,0,2,8,0,0
37212,208,4450,182,127,129,0,0,53,182,5,39,21,42,44,63,217,343,2,926,51,0,2,4,0,1
37213,208,4450,1165,710,800,67,119,181,1232,18,243,153,282,261,435,2000,3492,10,36473,2026,1,2,4,0,1
37214,101,2153,773,419,590,28,0,166,801,10,204,113,217,214,330,1598,2554,5,13587,754,0,2,3,0,1
37215,101,2153,421,273,302,44,34,57,465,17,81,59,107,98,166,583,1098,11,12329,684,0,2,3,0,1
37216,82,1800,477,336,357,30,23,73,507,16,194,134,250,210,384,1538,2962,10,30538,1696,0,2,1,1,1
37217,332,7010,72,33,56,0,4,12,72,1,1,1,1,2,2,0,2,0,1,0,0,2,6,0,1
37218,332,7010,1454,835,1044,76,110,219,1530,17,275,158,296,292,454,2297,3718,9,34017,1889,1,2,6,0,1
37219,207,4440,182,127,129,0,0,53,182,5,39,21,42,44,63,217,343,2,926,51,0,2,1,2,1
37220,207,4440,1165,710,800,67,119,181,1232,18,243,153,282,261,435,2000,3492,10,36473,2026,1,2,1,2,1
37221,100,2143,773,419,590,28,0,166,801,10,204,113,217,214,330,1598,2554,5,13587,754,0,2,1,2,1
37222,100,2143,421,273,302,44,34,57,465,17,81,59,107,98,166,583,1098,11,12329,684,0,2,1,2,1
37223,330,6984,72,33,56,0,4,12,72,1,1,1,1,2,2,0,2,0,1,0,0,2,2,4,1
37224,330,6984,1454,835,1044,76,110,219,1530,17,275,158,296,292,454,2297,3718,9,34017,1889,1,2,2,4,1
37225,207,4440,182,127,129,0,0,53,182,5,39,21,42,44,63,217,343,2,926,51,0,2,3,0,0
37226,207,4440,1165,710,800,67,119,181,1232,18,243,153,282,261,435,2000,3492,10,36473,2026,1,2,3,0,0
37227,100,2143,773,419,590,28,0,166,801,10,204,113,217,214,330,1598,2554,5,13587,754,0,2,2,0,0
37228,100,2143,421,273,302,44,34,57,465,17,81,59,107,98,166,583,1098,11,12329,684,0,2,2,0,0
37229,82,1800,477,336,357,30,23,73,507,16,194,134,250,210,384,1538,2962,10,30538,1696,0,2,1,1,0
37230,330,6993,72,33,56,0,4,12,72,1,1,1,1,2,2,0,2,0,1,0,0,2,4,0,0
37231,330,6993,1454,835,1044,76,110,219,1530,17,275,158,296,292,454,2297,3718,9,34017,1889,1,2,4,0,0
37232,99,2124,773,419,590,28,0,166,801,10,204,113,217,214,330,1598,2554,5,13587,754,0,2,3,6,0
37233,99,2124,421,273,302,44,34,57,465,17,81,59,107,98,166,583,1098,11,12329,684,0,2,3,6,0
37237,44,1603,1293,570,1093,25,15,163,1318,10,195,123,241,205,364,1516,2795,6,17273,959,0,2,50,15,0
37238,119,2401,1513,682,1277,25,13,200,1538,11,199,116,219,210,335,1557,2584,6,15641,868,0,2,2,1,0
37239,119,2401,819,519,539,24,98,155,843,15,96,57,106,111,163,690,1107,8,9171,509,0,2,2,1,0
37240,119,2402,1513,682,1277,25,13,200,1538,11,199,116,219,210,335,1557,2584,6,15641,868,0,2,2,1,0
37241,119,2402,819,519,539,24,98,155,843,15,96,57,106,111,163,690,1107,8,9171,509,0,2,2,1,0
37244,99,2124,773,419,590,28,0,166,801,10,204,113,217,214,330,1598,2554,5,13587,754,0,2,5,6,0
37245,99,2124,421,273,302,44,34,57,465,17,81,59,107,98,166,583,1098,11,12329,684,0,2,5,6,0
37246,82,1792,477,336,357,30,23,73,507,16,194,134,250,210,384,1538,2962,10,30538,1696,0,2,1,1,0
37247,336,6810,1457,730,1242,11,6,188,1468,10,292,166,329,302,495,2424,4078,5,22973,1276,1,2,16,11,0
37248,336,6810,74,35,59,1,0,14,75,3,14,7,14,17,21,58,85,1,128,7,0,2,16,11,0
37249,336,6810,245,125,200,5,7,34,250,7,30,17,34,37,51,166,265,3,1053,58,0,2,16,11,0
37252,69,1347,1020,354,843,12,15,144,1032,8,134,77,144,142,221,970,1580,4,6792,377,0,2,1,1,0
37253,329,6972,72,33,56,0,4,12,72,1,1,1,1,2,2,0,2,0,1,0,0,2,11,7,0
37254,329,6972,1454,835,1044,76,110,219,1530,17,275,158,296,292,454,2297,3718,9,34017,1889,1,2,11,7,0
37258,106,5313,1782,648,1425,9,47,279,1791,8,171,97,189,179,286,1292,2140,4,9462,525,0,2,16,0,0
37259,92,3380,1450,624,1228,12,26,181,1462,14,306,186,354,320,540,2580,4493,8,36391,2021,1,2,26,4,0
37329,330,6993,72,33,56,0,4,12,72,1,1,1,1,2,2,0,2,0,1,0,0,2,3,3,1
37330,330,6993,1454,835,1044,76,110,219,1530,17,275,158,296,292,454,2297,3718,9,34017,1889,1,2,3,3,1
37332,330,6993,72,33,56,0,4,12,72,1,1,1,1,2,2,0,2,0,1,0,0,2,3,3,0
37333,330,6993,1454,835,1044,76,110,219,1530,17,275,158,296,292,454,2297,3718,9,34017,1889,1,2,3,3,0
37335,329,7012,72,33,56,0,4,12,72,1,1,1,1,2,2,0,2,0,1,0,0,2,8,5,0
37336,329,7012,1454,835,1044,76,110,219,1530,17,275,158,296,292,454,2297,3718,9,34017,1889,1,2,8,5,0
37337,78,3291,1289,550,1043,56,32,155,1345,10,167,93,185,177,278,1266,2075,5,11498,638,0,2,1,1,0
37338,91,4149,1338,495,1086,10,64,173,1348,11,122,82,157,133,239,883,1686,7,11934,663,0,2,21,1,0
37339,58,3234,1296,573,1062,40,33,157,1336,8,201,118,231,209,349,1561,2689,4,12365,686,0,2,0,11,0
37341,332,7078,72,33,56,0,4,12,72,1,1,1,1,2,2,0,2,0,1,0,0,2,14,7,1
37342,332,7078,1454,835,1044,76,110,219,1530,17,275,158,296,292,454,2297,3718,9,34017,1889,1,2,14,7,1
37343,93,4223,1338,495,1086,10,64,173,1348,11,122,82,157,133,239,883,1686,7,11934,663,0,2,17,4,1
37344,24,834,74,35,59,1,0,14,75,3,14,7,14,17,21,58,85,1,128,7,0,2,2,2,0
37345,24,834,245,125,200,5,7,34,250,7,30,17,34,37,51,166,265,3,1053,58,0,2,2,2,0
37348,332,7078,72,33,56,0,4,12,72,1,1,1,1,2,2,0,2,0,1,0,0,2,17,7,0
37349,332,7078,1454,835,1044,76,110,219,1530,17,275,158,296,292,454,2297,3718,9,34017,1889,1,2,17,7,0
37351,93,4223,1338,495,1086,10,64,173,1348,11,122,82,157,133,239,883,1686,7,11934,663,0,2,34,1,0
37356,28,547,2,2,2,0,0,0,2,0,0,0,0,0,0,0,0,0,0,0,0,2,4,23,1
37370,28,547,99,48,90,1,3,5,100,0,0,0,0,0,0,0,0,0,0,0,0,2,4,23,1
37371,28,547,8,5,5,2,0,1,10,0,0,0,0,0,0,0,0,0,0,0,0,2,4,23,1
37372,28,547,1217,716,841,84,126,174,1301,14,185,118,215,199,333,1446,2542,8,20687,1149,0,2,4,23,1
37373,28,547,160,89,115,0,13,31,160,7,15,11,17,22,28,78,124,3,495,27,0,2,4,23,1
37374,28,547,10,10,9,9,0,0,19,0,0,0,0,0,0,0,0,0,0,0,0,2,4,23,1
37375,28,547,173,84,99,8,29,36,181,5,12,7,13,17,20,54,81,2,221,12,0,2,4,23,1
37376,28,547,3,1,1,3,0,0,6,0,0,0,0,0,0,0,0,0,0,0,0,2,4,23,1
37377,17,341,95,58,50,9,16,20,104,12,33,24,45,45,69,209,378,8,3100,172,0,0,102,0,1
37378,105,3912,1450,624,1228,12,26,181,1462,14,306,186,354,320,540,2580,4493,8,36391,2021,1,2,106,35,1
37381,28,545,2,2,2,0,0,0,2,0,0,0,0,0,0,0,0,0,0,0,0,2,0,1,0
37395,28,545,99,48,90,1,3,5,100,0,0,0,0,0,0,0,0,0,0,0,0,2,0,1,0
37396,28,545,8,5,5,2,0,1,10,0,0,0,0,0,0,0,0,0,0,0,0,2,0,1,0
37397,28,545,1217,716,841,84,126,174,1301,14,185,118,215,199,333,1446,2542,8,20687,1149,0,2,0,1,0
37398,28,545,160,89,115,0,13,31,160,7,15,11,17,22,28,78,124,3,495,27,0,2,0,1,0
37399,28,545,10,10,9,9,0,0,19,0,0,0,0,0,0,0,0,0,0,0,0,2,0,1,0
37400,28,545,173,84,99,8,29,36,181,5,12,7,13,17,20,54,81,2,221,12,0,2,0,1,0
37401,28,545,3,1,1,3,0,0,6,0,0,0,0,0,0,0,0,0,0,0,0,2,0,1,0
37402,105,3912,1450,624,1228,12,26,181,1462,14,306,186,354,320,540,2580,4493,8,36391,2021,1,2,1,1,0
37403,44,837,207,111,150,11,0,50,218,5,26,19,36,31,55,133,272,3,943,52,0,2,15,1,1
37404,44,837,410,198,237,31,55,97,441,11,63,38,72,74,110,414,683,6,4293,238,0,2,15,1,1
37405,336,6824,1457,730,1242,11,6,188,1468,10,292,166,329,302,495,2424,4078,5,22973,1276,1,2,2,1,1
37406,336,6824,74,35,59,1,0,14,75,3,14,7,14,17,21,58,85,1,128,7,0,2,2,1,1
37407,336,6824,245,125,200,5,7,34,250,7,30,17,34,37,51,166,265,3,1053,58,0,2,2,1,1
37408,35,1824,384,251,317,7,8,52,391,11,70,44,84,81,128,467,811,6,5355,297,0,2,9,3,1
37409,105,3908,1450,624,1228,12,26,181,1462,14,306,186,354,320,540,2580,4493,8,36391,2021,1,2,2,2,0
37410,44,837,207,111,150,11,0,50,218,5,26,19,36,31,55,133,272,3,943,52,0,2,15,1,0
37411,44,837,410,198,237,31,55,97,441,11,63,38,72,74,110,414,683,6,4293,238,0,2,15,1,0
37412,336,6824,1457,730,1242,11,6,188,1468,10,292,166,329,302,495,2424,4078,5,22973,1276,1,2,2,1,0
37413,336,6824,74,35,59,1,0,14,75,3,14,7,14,17,21,58,85,1,128,7,0,2,2,1,0
37414,336,6824,245,125,200,5,7,34,250,7,30,17,34,37,51,166,265,3,1053,58,0,2,2,1,0
37415,35,1824,384,251,317,7,8,52,391,11,70,44,84,81,128,467,811,6,5355,297,0,2,9,3,0
37416,336,6826,1457,730,1242,11,6,188,1468,10,292,166,329,302,495,2424,4078,5,22973,1276,1,2,1,1,1
37417,336,6826,74,35,59,1,0,14,75,3,14,7,14,17,21,58,85,1,128,7,0,2,1,1,1
37418,336,6826,245,125,200,5,7,34,250,7,30,17,34,37,51,166,265,3,1053,58,0,2,1,1,1
37419,40,2349,334,251,279,10,4,40,344,5,127,74,143,132,217,899,1528,2,4303,239,0,2,13,1,1
37420,336,6826,1457,730,1242,11,6,188,1468,10,292,166,329,302,495,2424,4078,5,22973,1276,1,2,1,1,0
37421,336,6826,74,35,59,1,0,14,75,3,14,7,14,17,21,58,85,1,128,7,0,2,1,1,0
37422,336,6826,245,125,200,5,7,34,250,7,30,17,34,37,51,166,265,3,1053,58,0,2,1,1,0
37423,40,2349,334,251,279,10,4,40,344,5,127,74,143,132,217,899,1528,2,4303,239,0,2,13,1,0
37424,161,5059,1660,832,1314,41,38,274,1701,20,312,209,395,332,604,2671,5058,12,64042,3557,1,2,6,1,1
37425,161,5059,1057,646,719,113,100,145,1170,18,215,134,248,233,382,1740,3004,10,31186,1732,1,2,6,1,1
37426,142,3828,1660,832,1314,41,38,274,1701,20,312,209,395,332,604,2671,5058,12,64042,3557,1,2,16,0,1
37427,44,844,207,111,150,11,0,50,218,5,26,19,36,31,55,133,272,3,943,52,0,2,14,0,0
37428,44,844,410,198,237,31,55,97,441,11,63,38,72,74,110,414,683,6,4293,238,0,2,14,0,0
37429,336,6826,1457,730,1242,11,6,188,1468,10,292,166,329,302,495,2424,4078,5,22973,1276,1,2,3,2,0
37430,336,6826,74,35,59,1,0,14,75,3,14,7,14,17,21,58,85,1,128,7,0,2,3,2,0
37431,336,6826,245,125,200,5,7,34,250,7,30,17,34,37,51,166,265,3,1053,58,0,2,3,2,0
37434,331,7057,72,33,56,0,4,12,72,1,1,1,1,2,2,0,2,0,1,0,0,2,20,10,0
37435,331,7057,1454,835,1044,76,110,219,1530,17,275,158,296,292,454,2297,3718,9,34017,1889,1,2,20,10,0
37443,332,7078,72,33,56,0,4,12,72,1,1,1,1,2,2,0,2,0,1,0,0,2,13,9,1
37444,332,7078,1454,835,1044,76,110,219,1530,17,275,158,296,292,454,2297,3718,9,34017,1889,1,2,13,9,1
37445,41,951,386,256,301,16,9,68,402,4,59,35,69,63,104,355,621,2,1453,80,0,2,6,1,1
37446,41,951,264,131,164,11,41,46,275,6,38,22,40,44,62,214,338,3,1068,59,0,2,6,1,1
37447,29,1414,1293,570,1093,25,15,163,1318,10,195,123,241,205,364,1516,2795,6,17273,959,0,2,16,24,0
37448,29,1416,1293,570,1093,25,15,163,1318,10,195,123,241,205,364,1516,2795,6,17273,959,0,2,2,2,0
37449,222,4970,722,423,573,19,0,135,741,12,172,101,199,184,300,1320,2257,6,15668,870,0,2,0,2,1
37450,222,4970,1508,847,911,44,250,301,1552,14,148,88,169,162,257,1120,1886,7,15077,837,0,2,0,2,1
37451,30,1428,1293,570,1093,25,15,163,1318,10,195,123,241,205,364,1516,2795,6,17273,959,0,2,3,0,1
37452,222,4970,722,423,573,19,0,135,741,12,172,101,199,184,300,1320,2257,6,15668,870,0,2,0,2,0
37453,222,4970,1508,847,911,44,250,301,1552,14,148,88,169,162,257,1120,1886,7,15077,837,0,2,0,2,0
37454,30,1428,1293,570,1093,25,15,163,1318,10,195,123,241,205,364,1516,2795,6,17273,959,0,2,21,26,0
37455,9,360,601,196,481,2,23,85,603,8,63,36,72,71,108,400,664,4,3036,168,0,2,68,0,1
37456,9,360,601,196,481,2,23,85,603,8,63,36,72,71,108,400,664,4,3036,168,0,2,68,0,0
37485,332,7078,72,33,56,0,4,12,72,1,1,1,1,2,2,0,2,0,1,0,0,2,13,9,0
37486,332,7078,1454,835,1044,76,110,219,1530,17,275,158,296,292,454,2297,3718,9,34017,1889,1,2,13,9,0
37487,41,951,386,256,301,16,9,68,402,4,59,35,69,63,104,355,621,2,1453,80,0,2,6,1,0
37488,41,951,264,131,164,11,41,46,275,6,38,22,40,44,62,214,338,3,1068,59,0,2,6,1,0
37489,161,5059,1660,832,1314,41,38,274,1701,20,312,209,395,332,604,2671,5058,12,64042,3557,1,2,6,1,0
37490,161,5059,1057,646,719,113,100,145,1170,18,215,134,248,233,382,1740,3004,10,31186,1732,1,2,6,1,0
37491,142,3828,1660,832,1314,41,38,274,1701,20,312,209,395,332,604,2671,5058,12,64042,3557,1,2,16,0,0
37492,119,2402,1513,682,1277,25,13,200,1538,11,199,116,219,210,335,1557,2584,6,15641,868,0,2,3,1,0
37493,119,2402,819,519,539,24,98,155,843,15,96,57,106,111,163,690,1107,8,9171,509,0,2,3,1,0
37494,40,922,386,256,301,16,9,68,402,4,59,35,69,63,104,355,621,2,1453,80,0,2,5,10,0
37495,40,922,264,131,164,11,41,46,275,6,38,22,40,44,62,214,338,3,1068,59,0,2,5,10,0
37496,29,1224,386,256,301,16,9,68,402,4,59,35,69,63,104,355,621,2,1453,80,0,2,3,0,0
37497,184,3741,1943,715,1694,26,18,214,1969,12,185,120,237,197,357,1436,2721,7,20915,1161,0,2,12,0,1
37498,184,3741,1168,838,957,57,25,144,1225,19,348,224,416,367,640,3018,5452,11,61921,3440,1,2,12,0,1
37499,72,3658,1943,715,1694,26,18,214,1969,12,185,120,237,197,357,1436,2721,7,20915,1161,0,2,25,0,1
37500,184,3741,1943,715,1694,26,18,214,1969,12,185,120,237,197,357,1436,2721,7,20915,1161,0,2,12,0,0
37501,184,3741,1168,838,957,57,25,144,1225,19,348,224,416,367,640,3018,5452,11,61921,3440,1,2,12,0,0
37502,72,3658,1943,715,1694,26,18,214,1969,12,185,120,237,197,357,1436,2721,7,20915,1161,0,2,25,0,0
37506,71,2092,1523,757,1297,19,12,193,1542,12,193,117,230,205,347,1508,2664,7,19053,1058,0,2,5,1,1
37507,71,2092,701,378,504,33,58,109,734,13,110,68,126,123,194,794,1346,7,10027,557,0,2,5,1,1
37508,79,3954,1523,757,1297,19,12,193,1542,12,193,117,230,205,347,1508,2664,7,19053,1058,0,2,24,0,1
37509,71,2092,1523,757,1297,19,12,193,1542,12,193,117,230,205,347,1508,2664,7,19053,1058,0,2,5,1,0
37510,71,2092,701,378,504,33,58,109,734,13,110,68,126,123,194,794,1346,7,10027,557,0,2,5,1,0
37511,79,3954,1523,757,1297,19,12,193,1542,12,193,117,230,205,347,1508,2664,7,19053,1058,0,2,24,0,0
37512,210,4482,182,127,129,0,0,53,182,5,39,21,42,44,63,217,343,2,926,51,0,2,11,4,1
37513,210,4482,1165,710,800,67,119,181,1232,18,243,153,282,261,435,2000,3492,10,36473,2026,1,2,11,4,1
37514,137,6580,1392,870,1177,35,17,170,1427,14,494,280,531,508,811,4473,7289,7,54850,3047,2,2,44,0,1
37515,92,3384,1450,624,1228,12,26,181,1462,14,306,186,354,320,540,2580,4493,8,36391,2021,1,2,31,0,1
37516,210,4482,182,127,129,0,0,53,182,5,39,21,42,44,63,217,343,2,926,51,0,2,11,4,0
37517,210,4482,1165,710,800,67,119,181,1232,18,243,153,282,261,435,2000,3492,10,36473,2026,1,2,11,4,0
37518,137,6580,1392,870,1177,35,17,170,1427,14,494,280,531,508,811,4473,7289,7,54850,3047,2,2,44,0,0
37519,92,3384,1450,624,1228,12,26,181,1462,14,306,186,354,320,540,2580,4493,8,36391,2021,1,2,31,0,0
37566,55,1122,1098,241,925,5,10,155,1103,7,46,25,49,53,74,273,423,3,1580,87,0,2,3,0,1
37567,55,1122,282,202,222,14,2,44,296,8,42,24,43,50,67,250,378,4,1548,86,0,2,3,0,1
37568,48,1773,1098,241,925,5,10,155,1103,7,46,25,49,53,74,273,423,3,1580,87,0,2,23,0,1
37569,55,1122,1098,241,925,5,10,155,1103,7,46,25,49,53,74,273,423,3,1580,87,0,2,3,0,0
37570,55,1122,282,202,222,14,2,44,296,8,42,24,43,50,67,250,378,4,1548,86,0,2,3,0,0
37571,48,1773,1098,241,925,5,10,155,1103,7,46,25,49,53,74,273,423,3,1580,87,0,2,23,0,0
37572,211,4499,182,127,129,0,0,53,182,5,39,21,42,44,63,217,343,2,926,51,0,2,3,2,1
37573,211,4499,1165,710,800,67,119,181,1232,18,243,153,282,261,435,2000,3492,10,36473,2026,1,2,3,2,1
37574,19,443,256,139,192,9,7,47,265,4,23,12,24,27,36,112,171,2,357,19,0,2,18,0,0
37575,334,7098,72,33,56,0,4,12,72,1,1,1,1,2,2,0,2,0,1,0,0,2,5,1,1
37576,334,7098,1454,835,1044,76,110,219,1530,17,275,158,296,292,454,2297,3718,9,34017,1889,1,2,5,1,1
37577,20,468,256,139,192,9,7,47,265,4,23,12,24,27,36,112,171,2,357,19,0,2,17,5,1
37578,211,4499,182,127,129,0,0,53,182,5,39,21,42,44,63,217,343,2,926,51,0,2,3,2,0
37579,211,4499,1165,710,800,67,119,181,1232,18,243,153,282,261,435,2000,3492,10,36473,2026,1,2,3,2,0
37580,334,7098,72,33,56,0,4,12,72,1,1,1,1,2,2,0,2,0,1,0,0,2,5,1,0
37581,334,7098,1454,835,1044,76,110,219,1530,17,275,158,296,292,454,2297,3718,9,34017,1889,1,2,5,1,0
37582,20,468,256,139,192,9,7,47,265,4,23,12,24,27,36,112,171,2,357,19,0,2,30,0,0
37606,14,474,42,7,35,4,0,5,46,1,2,1,2,3,3,2,4,0,2,0,0,2,1,0,0
37607,14,474,11,6,10,0,0,1,11,2,4,2,4,6,6,10,15,1,15,0,0,2,1,0,0
37656,211,4499,182,127,129,0,0,53,182,5,39,21,42,44,63,217,343,2,926,51,0,2,14,6,0
37657,211,4499,1165,710,800,67,119,181,1232,18,243,153,282,261,435,2000,3492,10,36473,2026,1,2,14,6,0
37660,72,2108,1523,757,1297,19,12,193,1542,12,193,117,230,205,347,1508,2664,7,19053,1058,0,2,5,1,0
37661,72,2108,701,378,504,33,58,109,734,13,110,68,126,123,194,794,1346,7,10027,557,0,2,5,1,0
37662,223,5005,722,423,573,19,0,135,741,12,172,101,199,184,300,1320,2257,6,15668,870,0,2,0,2,0
37663,223,5005,1508,847,911,44,250,301,1552,14,148,88,169,162,257,1120,1886,7,15077,837,0,2,0,2,0
37664,333,7077,72,33,56,0,4,12,72,1,1,1,1,2,2,0,2,0,1,0,0,2,18,10,0
37665,333,7077,1454,835,1044,76,110,219,1530,17,275,158,296,292,454,2297,3718,9,34017,1889,1,2,18,10,0
37666,40,922,386,256,301,16,9,68,402,4,59,35,69,63,104,355,621,2,1453,80,0,2,6,1,0
37667,40,922,264,131,164,11,41,46,275,6,38,22,40,44,62,214,338,3,1068,59,0,2,6,1,0
37675,19,446,256,139,192,9,7,47,265,4,23,12,24,27,36,112,171,2,357,19,0,2,30,0,0
37676,93,3451,1450,624,1228,12,26,181,1462,14,306,186,354,320,540,2580,4493,8,36391,2021,1,2,31,0,0
37678,80,4077,1523,757,1297,19,12,193,1542,12,193,117,230,205,347,1508,2664,7,19053,1058,0,2,24,0,0
37679,34,1559,1293,570,1093,25,15,163,1318,10,195,123,241,205,364,1516,2795,6,17273,959,0,2,21,26,0
37710,28,545,2,2,2,0,0,0,2,0,0,0,0,0,0,0,0,0,0,0,0,2,4,24,0
37724,28,545,99,48,90,1,3,5,100,0,0,0,0,0,0,0,0,0,0,0,0,2,4,24,0
37725,28,545,8,5,5,2,0,1,10,0,0,0,0,0,0,0,0,0,0,0,0,2,4,24,0
37726,28,545,1217,716,841,84,126,174,1301,14,185,118,215,199,333,1446,2542,8,20687,1149,0,2,4,24,0
37727,28,545,160,89,115,0,13,31,160,7,15,11,17,22,28,78,124,3,495,27,0,2,4,24,0
37728,28,545,10,10,9,9,0,0,19,0,0,0,0,0,0,0,0,0,0,0,0,2,4,24,0
37729,28,545,173,84,99,8,29,36,181,5,12,7,13,17,20,54,81,2,221,12,0,2,4,24,0
37730,28,545,3,1,1,3,0,0,6,0,0,0,0,0,0,0,0,0,0,0,0,2,4,24,0
37731,17,341,95,58,50,9,16,20,104,12,33,24,45,45,69,209,378,8,3100,172,0,0,102,0,0
37732,106,3979,1450,624,1228,12,26,181,1462,14,306,186,354,320,540,2580,4493,8,36391,2021,1,2,106,35,0
37733,162,5072,1660,832,1314,41,38,274,1701,20,312,209,395,332,604,2671,5058,12,64042,3557,1,2,6,1,0
37734,162,5072,1057,646,719,113,100,145,1170,18,215,134,248,233,382,1740,3004,10,31186,1732,1,2,6,1,0
37735,146,3937,1660,832,1314,41,38,274,1701,20,312,209,395,332,604,2671,5058,12,64042,3557,1,2,28,0,0
37736,9,220,19,8,11,5,0,4,24,2,5,3,6,7,9,13,25,1,30,1,0,2,1,0,1
37737,9,220,102,59,69,5,3,24,107,6,22,15,28,28,43,113,206,3,789,43,0,2,1,0,1
37738,9,220,106,40,36,3,49,17,109,8,17,13,23,25,36,93,167,5,904,50,0,2,1,0,1
37739,211,4499,182,127,129,0,0,53,182,5,39,21,42,44,63,217,343,2,926,51,0,2,2,0,1
37740,211,4499,1165,710,800,67,119,181,1232,18,243,153,282,261,435,2000,3492,10,36473,2026,1,2,2,0,1
37741,99,2124,773,419,590,28,0,166,801,10,204,113,217,214,330,1598,2554,5,13587,754,0,2,3,0,1
37742,99,2124,421,273,302,44,34,57,465,17,81,59,107,98,166,583,1098,11,12329,684,0,2,3,0,1
37745,34,625,2,2,2,0,0,0,2,0,0,0,0,0,0,0,0,0,0,0,0,2,2,0,1
37759,34,625,99,48,90,1,3,5,100,0,0,0,0,0,0,0,0,0,0,0,0,2,2,0,1
37760,34,625,8,5,5,2,0,1,10,0,0,0,0,0,0,0,0,0,0,0,0,2,2,0,1
37761,34,625,1217,716,841,84,126,174,1301,14,185,118,215,199,333,1446,2542,8,20687,1149,0,2,2,0,1
37762,34,625,160,89,115,0,13,31,160,7,15,11,17,22,28,78,124,3,495,27,0,2,2,0,1
37763,34,625,10,10,9,9,0,0,19,0,0,0,0,0,0,0,0,0,0,0,0,2,2,0,1
37764,34,625,173,84,99,8,29,36,181,5,12,7,13,17,20,54,81,2,221,12,0,2,2,0,1
37765,34,625,3,1,1,3,0,0,6,0,0,0,0,0,0,0,0,0,0,0,0,2,2,0,1
37766,161,5059,1660,832,1314,41,38,274,1701,20,312,209,395,332,604,2671,5058,12,64042,3557,1,2,1,0,1
37767,161,5059,1057,646,719,113,100,145,1170,18,215,134,248,233,382,1740,3004,10,31186,1732,1,2,1,0,1
37768,119,2397,1513,682,1277,25,13,200,1538,11,199,116,219,210,335,1557,2584,6,15641,868,0,2,1,0,1
37769,119,2397,819,519,539,24,98,155,843,15,96,57,106,111,163,690,1107,8,9171,509,0,2,1,0,1
37770,336,6826,1457,730,1242,11,6,188,1468,10,292,166,329,302,495,2424,4078,5,22973,1276,1,2,6,0,1
37771,336,6826,74,35,59,1,0,14,75,3,14,7,14,17,21,58,85,1,128,7,0,2,6,0,1
37772,336,6826,245,125,200,5,7,34,250,7,30,17,34,37,51,166,265,3,1053,58,0,2,6,0,1
37773,23,680,339,213,244,17,9,65,356,10,42,26,48,52,74,259,421,5,2410,133,0,2,2,0,1
37774,228,5101,4293,999,3693,19,54,507,4312,9,155,88,170,164,258,1156,1898,4,9368,520,0,2,2,0,1
37775,228,5101,1482,859,1002,125,135,219,1607,16,219,134,251,235,385,1766,3032,9,27804,1544,1,2,2,0,1
37776,24,834,74,35,59,1,0,14,75,3,14,7,14,17,21,58,85,1,128,7,0,2,2,0,1
37777,24,834,245,125,200,5,7,34,250,7,30,17,34,37,51,166,265,3,1053,58,0,2,2,0,1
37778,71,2092,1523,757,1297,19,12,193,1542,12,193,117,230,205,347,1508,2664,7,19053,1058,0,2,1,0,1
37779,71,2092,701,378,504,33,58,109,734,13,110,68,126,123,194,794,1346,7,10027,557,0,2,1,0,1
37780,70,1304,1020,354,843,12,15,144,1032,8,134,77,144,142,221,970,1580,4,6792,377,0,2,2,0,1
37781,17,510,184,100,137,2,15,30,186,6,38,20,39,44,59,214,322,3,991,55,0,2,6,0,1
37782,17,510,103,65,74,8,5,16,111,7,17,9,17,24,26,89,119,3,417,23,0,2,6,0,1
37783,222,4970,722,423,573,19,0,135,741,12,172,101,199,184,300,1320,2257,6,15668,870,0,2,8,0,1
37784,222,4970,1508,847,911,44,250,301,1552,14,148,88,169,162,257,1120,1886,7,15077,837,0,2,8,0,1
37785,334,7098,72,33,56,0,4,12,72,1,1,1,1,2,2,0,2,0,1,0,0,2,3,0,1
37786,334,7098,1454,835,1044,76,110,219,1530,17,275,158,296,292,454,2297,3718,9,34017,1889,1,2,3,0,1
37787,128,2805,1043,504,840,53,9,147,1096,9,180,112,198,189,310,1377,2344,4,11604,644,0,2,7,0,1
37788,128,2805,383,288,292,26,6,62,409,11,65,38,67,76,105,429,656,5,3719,206,0,2,7,0,1
37789,103,1969,1178,367,1042,6,15,115,1184,9,94,51,95,103,146,644,976,4,4439,246,0,2,4,0,1
37790,103,1969,177,108,140,8,0,27,185,6,30,16,32,36,48,162,248,3,794,44,0,2,4,0,1
37791,16,468,442,244,305,14,16,103,456,11,68,45,75,79,120,452,756,6,4588,254,0,2,1,0,1
37792,16,468,182,102,99,11,40,35,193,3,11,6,11,14,17,42,64,1,97,5,0,2,1,0,1
37793,55,1122,1098,241,925,5,10,155,1103,7,46,25,49,53,74,273,423,3,1580,87,0,2,2,0,1
37794,55,1122,282,202,222,14,2,44,296,8,42,24,43,50,67,250,378,4,1548,86,0,2,2,0,1
37795,34,980,182,127,129,0,0,53,182,5,39,21,42,44,63,217,343,2,926,51,0,2,5,0,1
37796,137,6580,1392,870,1177,35,17,170,1427,14,494,280,531,508,811,4473,7289,7,54850,3047,2,2,21,2,1
37797,93,4223,1338,495,1086,10,64,173,1348,11,122,82,157,133,239,883,1686,7,11934,663,0,2,6,0,1
37798,147,6715,139,89,101,2,0,35,141,7,54,34,62,61,96,330,569,4,2287,127,0,2,10,0,1
37799,147,6715,7,5,5,0,0,2,7,1,2,1,2,3,3,2,4,0,2,0,0,2,10,0,1
37800,32,933,465,148,393,5,8,60,470,4,31,20,31,35,51,161,261,2,523,29,0,2,10,0,1
37801,32,933,16,12,9,0,0,6,16,1,2,1,2,3,3,2,4,0,2,0,0,2,10,0,1
37802,106,5313,1782,648,1425,9,47,279,1791,8,171,97,189,179,286,1292,2140,4,9462,525,0,2,12,0,1
37803,92,3384,1450,624,1228,12,26,181,1462,14,306,186,354,320,540,2580,4493,8,36391,2021,1,2,3,0,1
37804,142,3828,1660,832,1314,41,38,274,1701,20,312,209,395,332,604,2671,5058,12,64042,3557,1,2,97,0,1
37805,58,3234,1296,573,1062,40,33,157,1336,8,201,118,231,209,349,1561,2689,4,12365,686,0,2,5,0,1
37806,72,3657,1457,730,1242,11,6,188,1468,10,292,166,329,302,495,2424,4078,5,22973,1276,1,2,25,0,1
37807,37,2210,652,304,544,16,6,88,668,6,89,51,101,95,152,591,998,3,3399,188,0,2,2,0,1
37808,66,2745,1020,354,843,12,15,144,1032,8,134,77,144,142,221,970,1580,4,6792,377,0,2,20,1,1
37809,21,647,424,94,331,4,0,89,428,1,5,5,5,6,10,11,25,0,12,0,0,2,4,0,1
37810,40,2349,334,251,279,10,4,40,344,5,127,74,143,132,217,899,1528,2,4303,239,0,2,4,1,1
37811,12,475,184,100,137,2,15,30,186,6,38,20,39,44,59,214,322,3,991,55,0,2,2,0,1
37812,30,1428,1293,570,1093,25,15,163,1318,10,195,123,241,205,364,1516,2795,6,17273,959,0,2,2,0,1
37813,35,1824,384,251,317,7,8,52,391,11,70,44,84,81,128,467,811,6,5355,297,0,2,4,0,1
37814,14,581,722,423,573,19,0,135,741,12,172,101,199,184,300,1320,2257,6,15668,870,0,2,4,0,1
37815,69,2837,1043,504,840,53,9,147,1096,9,180,112,198,189,310,1377,2344,4,11604,644,0,2,10,0,1
37816,137,6580,1392,870,1177,35,17,170,1427,14,494,280,531,508,811,4473,7289,7,54850,3047,2,2,1,1,0
37845,16,476,2,2,2,0,0,0,2,0,0,0,0,0,0,0,0,0,0,0,0,0,83,0,0
37859,16,476,99,48,90,1,3,5,100,0,0,0,0,0,0,0,0,0,0,0,0,0,83,0,0
37860,16,476,8,5,5,2,0,1,10,0,0,0,0,0,0,0,0,0,0,0,0,0,83,0,0
37861,16,476,1217,716,841,84,126,174,1301,14,185,118,215,199,333,1446,2542,8,20687,1149,0,0,83,0,0
37862,16,476,160,89,115,0,13,31,160,7,15,11,17,22,28,78,124,3,495,27,0,0,83,0,0
37863,16,476,10,10,9,9,0,0,19,0,0,0,0,0,0,0,0,0,0,0,0,0,83,0,0
37864,16,476,173,84,99,8,29,36,181,5,12,7,13,17,20,54,81,2,221,12,0,0,83,0,0
37865,16,476,3,1,1,3,0,0,6,0,0,0,0,0,0,0,0,0,0,0,0,0,83,0,0
37868,9,360,601,196,481,2,23,85,603,8,63,36,72,71,108,400,664,4,3036,168,0,0,95,0,0
37877,8,213,601,196,481,2,23,85,603,8,63,36,72,71,108,400,664,4,3036,168,0,0,60,0,1
37884,9,220,19,8,11,5,0,4,24,2,5,3,6,7,9,13,25,1,30,1,0,2,1,0,0
37885,9,220,102,59,69,5,3,24,107,6,22,15,28,28,43,113,206,3,789,43,0,2,1,0,0
37886,9,220,106,40,36,3,49,17,109,8,17,13,23,25,36,93,167,5,904,50,0,2,1,0,0
37887,211,4499,182,127,129,0,0,53,182,5,39,21,42,44,63,217,343,2,926,51,0,2,2,0,0
37888,211,4499,1165,710,800,67,119,181,1232,18,243,153,282,261,435,2000,3492,10,36473,2026,1,2,2,0,0
37889,99,2124,773,419,590,28,0,166,801,10,204,113,217,214,330,1598,2554,5,13587,754,0,2,3,0,0
37890,99,2124,421,273,302,44,34,57,465,17,81,59,107,98,166,583,1098,11,12329,684,0,2,3,0,0
37893,34,625,2,2,2,0,0,0,2,0,0,0,0,0,0,0,0,0,0,0,0,2,2,0,0
37907,34,625,99,48,90,1,3,5,100,0,0,0,0,0,0,0,0,0,0,0,0,2,2,0,0
37908,34,625,8,5,5,2,0,1,10,0,0,0,0,0,0,0,0,0,0,0,0,2,2,0,0
37909,34,625,1217,716,841,84,126,174,1301,14,185,118,215,199,333,1446,2542,8,20687,1149,0,2,2,0,0
37910,34,625,160,89,115,0,13,31,160,7,15,11,17,22,28,78,124,3,495,27,0,2,2,0,0
37911,34,625,10,10,9,9,0,0,19,0,0,0,0,0,0,0,0,0,0,0,0,2,2,0,0
37912,34,625,173,84,99,8,29,36,181,5,12,7,13,17,20,54,81,2,221,12,0,2,2,0,0
37913,34,625,3,1,1,3,0,0,6,0,0,0,0,0,0,0,0,0,0,0,0,2,2,0,0
37914,161,5059,1660,832,1314,41,38,274,1701,20,312,209,395,332,604,2671,5058,12,64042,3557,1,2,1,0,0
37915,161,5059,1057,646,719,113,100,145,1170,18,215,134,248,233,382,1740,3004,10,31186,1732,1,2,1,0,0
37916,119,2397,1513,682,1277,25,13,200,1538,11,199,116,219,210,335,1557,2584,6,15641,868,0,2,1,0,0
37917,119,2397,819,519,539,24,98,155,843,15,96,57,106,111,163,690,1107,8,9171,509,0,2,1,0,0
37918,336,6826,1457,730,1242,11,6,188,1468,10,292,166,329,302,495,2424,4078,5,22973,1276,1,2,6,0,0
37919,336,6826,74,35,59,1,0,14,75,3,14,7,14,17,21,58,85,1,128,7,0,2,6,0,0
37920,336,6826,245,125,200,5,7,34,250,7,30,17,34,37,51,166,265,3,1053,58,0,2,6,0,0
37921,23,680,339,213,244,17,9,65,356,10,42,26,48,52,74,259,421,5,2410,133,0,2,2,0,0
37922,228,5101,4293,999,3693,19,54,507,4312,9,155,88,170,164,258,1156,1898,4,9368,520,0,2,2,0,0
37923,228,5101,1482,859,1002,125,135,219,1607,16,219,134,251,235,385,1766,3032,9,27804,1544,1,2,2,0,0
37924,24,834,74,35,59,1,0,14,75,3,14,7,14,17,21,58,85,1,128,7,0,2,2,0,0
37925,24,834,245,125,200,5,7,34,250,7,30,17,34,37,51,166,265,3,1053,58,0,2,2,0,0
37926,71,2092,1523,757,1297,19,12,193,1542,12,193,117,230,205,347,1508,2664,7,19053,1058,0,2,1,0,0
37927,71,2092,701,378,504,33,58,109,734,13,110,68,126,123,194,794,1346,7,10027,557,0,2,1,0,0
37928,70,1304,1020,354,843,12,15,144,1032,8,134,77,144,142,221,970,1580,4,6792,377,0,2,2,0,0
37929,17,510,184,100,137,2,15,30,186,6,38,20,39,44,59,214,322,3,991,55,0,2,6,0,0
37930,17,510,103,65,74,8,5,16,111,7,17,9,17,24,26,89,119,3,417,23,0,2,6,0,0
37931,222,4970,722,423,573,19,0,135,741,12,172,101,199,184,300,1320,2257,6,15668,870,0,2,8,0,0
37932,222,4970,1508,847,911,44,250,301,1552,14,148,88,169,162,257,1120,1886,7,15077,837,0,2,8,0,0
37933,334,7098,72,33,56,0,4,12,72,1,1,1,1,2,2,0,2,0,1,0,0,2,3,0,0
37934,334,7098,1454,835,1044,76,110,219,1530,17,275,158,296,292,454,2297,3718,9,34017,1889,1,2,3,0,0
37935,128,2805,1043,504,840,53,9,147,1096,9,180,112,198,189,310,1377,2344,4,11604,644,0,2,7,0,0
37936,128,2805,383,288,292,26,6,62,409,11,65,38,67,76,105,429,656,5,3719,206,0,2,7,0,0
37937,103,1969,1178,367,1042,6,15,115,1184,9,94,51,95,103,146,644,976,4,4439,246,0,2,4,0,0
37938,103,1969,177,108,140,8,0,27,185,6,30,16,32,36,48,162,248,3,794,44,0,2,4,0,0
37939,16,468,442,244,305,14,16,103,456,11,68,45,75,79,120,452,756,6,4588,254,0,2,1,0,0
37940,16,468,182,102,99,11,40,35,193,3,11,6,11,14,17,42,64,1,97,5,0,2,1,0,0
37941,55,1122,1098,241,925,5,10,155,1103,7,46,25,49,53,74,273,423,3,1580,87,0,2,2,0,0
37942,55,1122,282,202,222,14,2,44,296,8,42,24,43,50,67,250,378,4,1548,86,0,2,2,0,0
37943,34,980,182,127,129,0,0,53,182,5,39,21,42,44,63,217,343,2,926,51,0,2,5,0,0
37944,137,6580,1392,870,1177,35,17,170,1427,14,494,280,531,508,811,4473,7289,7,54850,3047,2,2,22,3,0
37945,93,4223,1338,495,1086,10,64,173,1348,11,122,82,157,133,239,883,1686,7,11934,663,0,2,6,0,0
37946,147,6715,139,89,101,2,0,35,141,7,54,34,62,61,96,330,569,4,2287,127,0,2,10,0,0
37947,147,6715,7,5,5,0,0,2,7,1,2,1,2,3,3,2,4,0,2,0,0,2,10,0,0
37948,32,933,465,148,393,5,8,60,470,4,31,20,31,35,51,161,261,2,523,29,0,2,10,0,0
37949,32,933,16,12,9,0,0,6,16,1,2,1,2,3,3,2,4,0,2,0,0,2,10,0,0
37950,106,5313,1782,648,1425,9,47,279,1791,8,171,97,189,179,286,1292,2140,4,9462,525,0,2,12,0,0
37951,92,3384,1450,624,1228,12,26,181,1462,14,306,186,354,320,540,2580,4493,8,36391,2021,1,2,3,0,0
37952,142,3828,1660,832,1314,41,38,274,1701,20,312,209,395,332,604,2671,5058,12,64042,3557,1,2,97,0,0
37953,58,3234,1296,573,1062,40,33,157,1336,8,201,118,231,209,349,1561,2689,4,12365,686,0,2,5,0,0
37954,72,3657,1457,730,1242,11,6,188,1468,10,292,166,329,302,495,2424,4078,5,22973,1276,1,2,25,0,0
37955,37,2210,652,304,544,16,6,88,668,6,89,51,101,95,152,591,998,3,3399,188,0,2,2,0,0
37956,66,2745,1020,354,843,12,15,144,1032,8,134,77,144,142,221,970,1580,4,6792,377,0,2,20,1,0
37957,21,647,424,94,331,4,0,89,428,1,5,5,5,6,10,11,25,0,12,0,0,2,4,0,0
37958,40,2349,334,251,279,10,4,40,344,5,127,74,143,132,217,899,1528,2,4303,239,0,2,4,1,0
37959,12,475,184,100,137,2,15,30,186,6,38,20,39,44,59,214,322,3,991,55,0,2,2,0,0
37960,30,1428,1293,570,1093,25,15,163,1318,10,195,123,241,205,364,1516,2795,6,17273,959,0,2,2,0,0
37961,35,1824,384,251,317,7,8,52,391,11,70,44,84,81,128,467,811,6,5355,297,0,2,4,0,0
37962,14,581,722,423,573,19,0,135,741,12,172,101,199,184,300,1320,2257,6,15668,870,0,2,4,0,0
37963,69,2837,1043,504,840,53,9,147,1096,9,180,112,198,189,310,1377,2344,4,11604,644,0,2,10,0,0
37973,28,545,2,2,2,0,0,0,2,0,0,0,0,0,0,0,0,0,0,0,0,2,2,0,0
37987,28,545,99,48,90,1,3,5,100,0,0,0,0,0,0,0,0,0,0,0,0,2,2,0,0
37988,28,545,8,5,5,2,0,1,10,0,0,0,0,0,0,0,0,0,0,0,0,2,2,0,0
37989,28,545,1217,716,841,84,126,174,1301,14,185,118,215,199,333,1446,2542,8,20687,1149,0,2,2,0,0
37990,28,545,160,89,115,0,13,31,160,7,15,11,17,22,28,78,124,3,495,27,0,2,2,0,0
37991,28,545,10,10,9,9,0,0,19,0,0,0,0,0,0,0,0,0,0,0,0,2,2,0,0
37992,28,545,173,84,99,8,29,36,181,5,12,7,13,17,20,54,81,2,221,12,0,2,2,0,0
37993,28,545,3,1,1,3,0,0,6,0,0,0,0,0,0,0,0,0,0,0,0,2,2,0,0
37996,119,2402,1513,682,1277,25,13,200,1538,11,199,116,219,210,335,1557,2584,6,15641,868,0,2,1,0,0
37997,119,2402,819,519,539,24,98,155,843,15,96,57,106,111,163,690,1107,8,9171,509,0,2,1,0,0
37998,336,6826,1457,730,1242,11,6,188,1468,10,292,166,329,302,495,2424,4078,5,22973,1276,1,2,7,1,0
37999,336,6826,74,35,59,1,0,14,75,3,14,7,14,17,21,58,85,1,128,7,0,2,7,1,0
38000,336,6826,245,125,200,5,7,34,250,7,30,17,34,37,51,166,265,3,1053,58,0,2,7,1,0
38001,22,673,339,213,244,17,9,65,356,10,42,26,48,52,74,259,421,5,2410,133,0,2,2,0,0
38006,72,2108,1523,757,1297,19,12,193,1542,12,193,117,230,205,347,1508,2664,7,19053,1058,0,2,1,0,0
38007,72,2108,701,378,504,33,58,109,734,13,110,68,126,123,194,794,1346,7,10027,557,0,2,1,0,0
38008,69,1347,1020,354,843,12,15,144,1032,8,134,77,144,142,221,970,1580,4,6792,377,0,2,2,0,0
38011,223,5005,722,423,573,19,0,135,741,12,172,101,199,184,300,1320,2257,6,15668,870,0,2,8,0,0
38012,223,5005,1508,847,911,44,250,301,1552,14,148,88,169,162,257,1120,1886,7,15077,837,0,2,8,0,0
38013,333,7077,72,33,56,0,4,12,72,1,1,1,1,2,2,0,2,0,1,0,0,2,3,0,0
38014,333,7077,1454,835,1044,76,110,219,1530,17,275,158,296,292,454,2297,3718,9,34017,1889,1,2,3,0,0
38015,128,2812,1043,504,840,53,9,147,1096,9,180,112,198,189,310,1377,2344,4,11604,644,0,2,7,0,0
38016,128,2812,383,288,292,26,6,62,409,11,65,38,67,76,105,429,656,5,3719,206,0,2,7,0,0
38017,103,1956,1178,367,1042,6,15,115,1184,9,94,51,95,103,146,644,976,4,4439,246,0,2,4,0,0
38018,103,1956,177,108,140,8,0,27,185,6,30,16,32,36,48,162,248,3,794,44,0,2,4,0,0
38031,106,3979,1450,624,1228,12,26,181,1462,14,306,186,354,320,540,2580,4493,8,36391,2021,1,2,3,0,0
38036,66,2750,1020,354,843,12,15,144,1032,8,134,77,144,142,221,970,1580,4,6792,377,0,2,20,1,0
38040,34,1559,1293,570,1093,25,15,163,1318,10,195,123,241,205,364,1516,2795,6,17273,959,0,2,2,0,0
38127,338,6856,1457,730,1242,11,6,188,1468,10,292,166,329,302,495,2424,4078,5,22973,1276,1,2,5,1,1
38128,338,6856,74,35,59,1,0,14,75,3,14,7,14,17,21,58,85,1,128,7,0,2,5,1,1
38129,338,6856,245,125,200,5,7,34,250,7,30,17,34,37,51,166,265,3,1053,58,0,2,5,1,1
38130,73,3766,1457,730,1242,11,6,188,1468,10,292,166,329,302,495,2424,4078,5,22973,1276,1,2,9,0,1
38131,338,6856,1457,730,1242,11,6,188,1468,10,292,166,329,302,495,2424,4078,5,22973,1276,1,2,5,1,0
38132,338,6856,74,35,59,1,0,14,75,3,14,7,14,17,21,58,85,1,128,7,0,2,5,1,0
38133,338,6856,245,125,200,5,7,34,250,7,30,17,34,37,51,166,265,3,1053,58,0,2,5,1,0
38134,73,3766,1457,730,1242,11,6,188,1468,10,292,166,329,302,495,2424,4078,5,22973,1276,1,2,9,0,0
38135,335,7115,72,33,56,0,4,12,72,1,1,1,1,2,2,0,2,0,1,0,0,2,3,0,1
38136,335,7115,1454,835,1044,76,110,219,1530,17,275,158,296,292,454,2297,3718,9,34017,1889,1,2,3,0,1
38137,43,2321,520,294,400,33,13,81,553,10,261,204,367,271,571,2128,4614,7,32445,1802,1,2,1,0,1
38138,335,7115,72,33,56,0,4,12,72,1,1,1,1,2,2,0,2,0,1,0,0,2,3,0,0
38139,335,7115,1454,835,1044,76,110,219,1530,17,275,158,296,292,454,2297,3718,9,34017,1889,1,2,3,0,0
38140,43,2321,520,294,400,33,13,81,553,10,261,204,367,271,571,2128,4614,7,32445,1802,1,2,1,0,0
38141,179,4156,77,34,69,0,0,8,77,3,24,16,29,27,45,114,213,1,387,21,0,2,2,3,1
38142,179,4156,712,438,573,51,9,84,763,14,102,71,128,116,199,733,1364,8,11988,666,0,2,2,3,1
38143,179,4156,77,34,69,0,0,8,77,3,24,16,29,27,45,114,213,1,387,21,0,2,2,3,0
38144,179,4156,712,438,573,51,9,84,763,14,102,71,128,116,199,733,1364,8,11988,666,0,2,2,3,0
38145,80,3999,1523,757,1297,19,12,193,1542,12,193,117,230,205,347,1508,2664,7,19053,1058,0,2,12,0,0
38147,179,4170,77,34,69,0,0,8,77,3,24,16,29,27,45,114,213,1,387,21,0,2,3,1,1
38148,179,4170,712,438,573,51,9,84,763,14,102,71,128,116,199,733,1364,8,11988,666,0,2,3,1,1
38149,179,4175,77,34,69,0,0,8,77,3,24,16,29,27,45,114,213,1,387,21,0,2,1,1,1
38150,179,4175,712,438,573,51,9,84,763,14,102,71,128,116,199,733,1364,8,11988,666,0,2,1,1,1
38151,179,4175,77,34,69,0,0,8,77,3,24,16,29,27,45,114,213,1,387,21,0,2,3,1,0
38152,179,4175,712,438,573,51,9,84,763,14,102,71,128,116,199,733,1364,8,11988,666,0,2,3,1,0
38158,178,4154,77,34,69,0,0,8,77,3,24,16,29,27,45,114,213,1,387,21,0,2,5,4,0
38159,178,4154,712,438,573,51,9,84,763,14,102,71,128,116,199,733,1364,8,11988,666,0,2,5,4,0
38160,334,7094,72,33,56,0,4,12,72,1,1,1,1,2,2,0,2,0,1,0,0,2,3,0,0
38161,334,7094,1454,835,1044,76,110,219,1530,17,275,158,296,292,454,2297,3718,9,34017,1889,1,2,3,0,0
38165,81,4122,1523,757,1297,19,12,193,1542,12,193,117,230,205,347,1508,2664,7,19053,1058,0,2,12,0,0
38179,340,6900,1457,730,1242,11,6,188,1468,10,292,166,329,302,495,2424,4078,5,22973,1276,1,2,23,4,1
38180,340,6900,74,35,59,1,0,14,75,3,14,7,14,17,21,58,85,1,128,7,0,2,23,4,1
38181,340,6900,245,125,200,5,7,34,250,7,30,17,34,37,51,166,265,3,1053,58,0,2,23,4,1
38182,71,2113,1523,757,1297,19,12,193,1542,12,193,117,230,205,347,1508,2664,7,19053,1058,0,2,3,0,1
38183,71,2113,701,378,504,33,58,109,734,13,110,68,126,123,194,794,1346,7,10027,557,0,2,3,0,1
38184,179,4196,77,34,69,0,0,8,77,3,24,16,29,27,45,114,213,1,387,21,0,2,3,1,1
38185,179,4196,712,438,573,51,9,84,763,14,102,71,128,116,199,733,1364,8,11988,666,0,2,3,1,1
38186,81,4024,1523,757,1297,19,12,193,1542,12,193,117,230,205,347,1508,2664,7,19053,1058,0,2,4,0,1
38187,20,400,294,64,250,0,0,43,294,1,20,10,20,21,30,86,131,0,65,3,0,2,2,2,0
38188,20,400,78,46,62,3,0,14,81,3,8,4,8,11,12,28,41,1,62,3,0,2,2,2,0
38189,340,6900,1457,730,1242,11,6,188,1468,10,292,166,329,302,495,2424,4078,5,22973,1276,1,2,23,4,0
38190,340,6900,74,35,59,1,0,14,75,3,14,7,14,17,21,58,85,1,128,7,0,2,23,4,0
38191,340,6900,245,125,200,5,7,34,250,7,30,17,34,37,51,166,265,3,1053,58,0,2,23,4,0
38192,71,2113,1523,757,1297,19,12,193,1542,12,193,117,230,205,347,1508,2664,7,19053,1058,0,2,3,0,0
38193,71,2113,701,378,504,33,58,109,734,13,110,68,126,123,194,794,1346,7,10027,557,0,2,3,0,0
38194,179,4196,77,34,69,0,0,8,77,3,24,16,29,27,45,114,213,1,387,21,0,2,3,1,0
38195,179,4196,712,438,573,51,9,84,763,14,102,71,128,116,199,733,1364,8,11988,666,0,2,3,1,0
38196,81,4024,1523,757,1297,19,12,193,1542,12,193,117,230,205,347,1508,2664,7,19053,1058,0,2,4,0,0
38199,56,1608,1455,414,1257,16,76,112,1471,5,41,23,46,46,69,231,381,2,1069,59,0,2,5,1,0
38200,56,1608,669,365,481,22,61,110,691,15,103,63,122,118,185,747,1273,8,11311,628,0,2,5,1,0
38201,223,5009,722,423,573,19,0,135,741,12,172,101,199,184,300,1320,2257,6,15668,870,0,2,2,2,1
38202,223,5009,1508,847,911,44,250,301,1552,14,148,88,169,162,257,1120,1886,7,15077,837,0,2,2,2,1
38203,64,2862,1455,414,1257,16,76,112,1471,5,41,23,46,46,69,231,381,2,1069,59,0,2,46,0,1
38204,64,2864,1455,414,1257,16,76,112,1471,5,41,23,46,46,69,231,381,2,1069,59,0,2,6,6,0
38205,56,1599,1455,414,1257,16,76,112,1471,5,41,23,46,46,69,231,381,2,1069,59,0,2,3,6,1
38206,56,1599,669,365,481,22,61,110,691,15,103,63,122,118,185,747,1273,8,11311,628,0,2,3,6,1
38207,62,2825,1455,414,1257,16,76,112,1471,5,41,23,46,46,69,231,381,2,1069,59,0,2,19,38,1
38208,62,2825,1455,414,1257,16,76,112,1471,5,41,23,46,46,69,231,381,2,1069,59,0,2,2,2,0
38209,44,844,207,111,150,11,0,50,218,5,26,19,36,31,55,133,272,3,943,52,0,2,1,1,0
38210,44,844,410,198,237,31,55,97,441,11,63,38,72,74,110,414,683,6,4293,238,0,2,1,1,0
38211,335,7110,72,33,56,0,4,12,72,1,1,1,1,2,2,0,2,0,1,0,0,2,2,0,0
38212,335,7110,1454,835,1044,76,110,219,1530,17,275,158,296,292,454,2297,3718,9,34017,1889,1,2,2,0,0
38213,59,3269,1296,573,1062,40,33,157,1336,8,201,118,231,209,349,1561,2689,4,12365,686,0,2,16,0,0
38219,56,1599,1455,414,1257,16,76,112,1471,5,41,23,46,46,69,231,381,2,1069,59,0,2,3,2,0
38220,56,1599,669,365,481,22,61,110,691,15,103,63,122,118,185,747,1273,8,11311,628,0,2,3,2,0
38221,223,5009,722,423,573,19,0,135,741,12,172,101,199,184,300,1320,2257,6,15668,870,0,2,2,2,0
38222,223,5009,1508,847,911,44,250,301,1552,14,148,88,169,162,257,1120,1886,7,15077,837,0,2,2,2,0
38223,62,2825,1455,414,1257,16,76,112,1471,5,41,23,46,46,69,231,381,2,1069,59,0,2,27,0,0
38224,99,2079,773,419,590,28,0,166,801,10,204,113,217,214,330,1598,2554,5,13587,754,0,2,0,8,0
38225,99,2079,421,273,302,44,34,57,465,17,81,59,107,98,166,583,1098,11,12329,684,0,2,0,8,0
38226,99,2075,773,419,590,28,0,166,801,10,204,113,217,214,330,1598,2554,5,13587,754,0,2,0,1,0
38227,99,2075,421,273,302,44,34,57,465,17,81,59,107,98,166,583,1098,11,12329,684,0,2,0,1,0
38228,99,2075,773,419,590,28,0,166,801,10,204,113,217,214,330,1598,2554,5,13587,754,0,2,0,9,0
38229,99,2075,421,273,302,44,34,57,465,17,81,59,107,98,166,583,1098,11,12329,684,0,2,0,9,0
38230,341,6910,1457,730,1242,11,6,188,1468,10,292,166,329,302,495,2424,4078,5,22973,1276,1,2,4,1,1
38231,341,6910,74,35,59,1,0,14,75,3,14,7,14,17,21,58,85,1,128,7,0,2,4,1,1
38232,341,6910,245,125,200,5,7,34,250,7,30,17,34,37,51,166,265,3,1053,58,0,2,4,1,1
38233,24,834,74,35,59,1,0,14,75,3,14,7,14,17,21,58,85,1,128,7,0,2,1,1,1
38234,24,834,245,125,200,5,7,34,250,7,30,17,34,37,51,166,265,3,1053,58,0,2,1,1,1
38235,74,3802,1457,730,1242,11,6,188,1468,10,292,166,329,302,495,2424,4078,5,22973,1276,1,2,9,1,1
38236,341,6910,1457,730,1242,11,6,188,1468,10,292,166,329,302,495,2424,4078,5,22973,1276,1,2,4,1,0
38237,341,6910,74,35,59,1,0,14,75,3,14,7,14,17,21,58,85,1,128,7,0,2,4,1,0
38238,341,6910,245,125,200,5,7,34,250,7,30,17,34,37,51,166,265,3,1053,58,0,2,4,1,0
38239,24,834,74,35,59,1,0,14,75,3,14,7,14,17,21,58,85,1,128,7,0,2,1,1,0
38240,24,834,245,125,200,5,7,34,250,7,30,17,34,37,51,166,265,3,1053,58,0,2,1,1,0
38241,74,3802,1457,730,1242,11,6,188,1468,10,292,166,329,302,495,2424,4078,5,22973,1276,1,2,9,1,0
38242,162,5067,1660,832,1314,41,38,274,1701,20,312,209,395,332,604,2671,5058,12,64042,3557,1,2,4,5,1
38243,162,5067,1057,646,719,113,100,145,1170,18,215,134,248,233,382,1740,3004,10,31186,1732,1,2,4,5,1
38244,147,4008,1660,832,1314,41,38,274,1701,20,312,209,395,332,604,2671,5058,12,64042,3557,1,2,13,0,1
38245,162,5067,1660,832,1314,41,38,274,1701,20,312,209,395,332,604,2671,5058,12,64042,3557,1,2,4,5,0
38246,162,5067,1057,646,719,113,100,145,1170,18,215,134,248,233,382,1740,3004,10,31186,1732,1,2,4,5,0
38247,147,4008,1660,832,1314,41,38,274,1701,20,312,209,395,332,604,2671,5058,12,64042,3557,1,2,13,0,0
38248,178,4170,77,34,69,0,0,8,77,3,24,16,29,27,45,114,213,1,387,21,0,2,12,18,0
38249,178,4170,712,438,573,51,9,84,763,14,102,71,128,116,199,733,1364,8,11988,666,0,2,12,18,0
38250,222,4979,722,423,573,19,0,135,741,12,172,101,199,184,300,1320,2257,6,15668,870,0,2,1,0,0
38251,222,4979,1508,847,911,44,250,301,1552,14,148,88,169,162,257,1120,1886,7,15077,837,0,2,1,0,0
38252,38,2269,652,304,544,16,6,88,668,6,89,51,101,95,152,591,998,3,3399,188,0,2,25,0,0
38253,36,1940,384,251,317,7,8,52,391,11,70,44,84,81,128,467,811,6,5355,297,0,2,21,1,0
38262,34,625,2,2,2,0,0,0,2,0,0,0,0,0,0,0,0,0,0,0,0,2,1,1,0
38276,34,625,99,48,90,1,3,5,100,0,0,0,0,0,0,0,0,0,0,0,0,2,1,1,0
38277,34,625,8,5,5,2,0,1,10,0,0,0,0,0,0,0,0,0,0,0,0,2,1,1,0
38278,34,625,1217,716,841,84,126,174,1301,14,185,118,215,199,333,1446,2542,8,20687,1149,0,2,1,1,0
38279,34,625,160,89,115,0,13,31,160,7,15,11,17,22,28,78,124,3,495,27,0,2,1,1,0
38280,34,625,10,10,9,9,0,0,19,0,0,0,0,0,0,0,0,0,0,0,0,2,1,1,0
38281,34,625,173,84,99,8,29,36,181,5,12,7,13,17,20,54,81,2,221,12,0,2,1,1,0
38282,34,625,3,1,1,3,0,0,6,0,0,0,0,0,0,0,0,0,0,0,0,2,1,1,0
38283,335,7116,72,33,56,0,4,12,72,1,1,1,1,2,2,0,2,0,1,0,0,2,2,8,1
38284,335,7116,1454,835,1044,76,110,219,1530,17,275,158,296,292,454,2297,3718,9,34017,1889,1,2,2,8,1
38285,47,2495,520,294,400,33,13,81,553,10,261,204,367,271,571,2128,4614,7,32445,1802,1,2,33,8,1
38286,335,7116,72,33,56,0,4,12,72,1,1,1,1,2,2,0,2,0,1,0,0,2,2,8,0
38287,335,7116,1454,835,1044,76,110,219,1530,17,275,158,296,292,454,2297,3718,9,34017,1889,1,2,2,8,0
38288,47,2495,520,294,400,33,13,81,553,10,261,204,367,271,571,2128,4614,7,32445,1802,1,2,33,8,0
38358,179,4222,77,34,69,0,0,8,77,3,24,16,29,27,45,114,213,1,387,21,0,2,30,17,1
38359,179,4222,712,438,573,51,9,84,763,14,102,71,128,116,199,733,1364,8,11988,666,0,2,30,17,1
38360,228,5105,4293,999,3693,19,54,507,4312,9,155,88,170,164,258,1156,1898,4,9368,520,0,2,4,4,1
38361,228,5105,1482,859,1002,125,135,219,1607,16,219,134,251,235,385,1766,3032,9,27804,1544,1,2,4,4,1
38362,149,6801,139,89,101,2,0,35,141,7,54,34,62,61,96,330,569,4,2287,127,0,2,45,0,1
38363,149,6801,7,5,5,0,0,2,7,1,2,1,2,3,3,2,4,0,2,0,0,2,45,0,1
38364,45,853,207,111,150,11,0,50,218,5,26,19,36,31,55,133,272,3,943,52,0,2,10,5,1
38365,45,853,410,198,237,31,55,97,441,11,63,38,72,74,110,414,683,6,4293,238,0,2,10,5,1
38383,3,34,207,111,150,11,0,50,218,5,26,19,36,31,55,133,272,3,943,52,0,0,12,0,1
38401,5,123,207,111,150,11,0,50,218,5,26,19,36,31,55,133,272,3,943,52,0,2,37,0,1
38402,47,867,207,111,150,11,0,50,218,5,26,19,36,31,55,133,272,3,943,52,0,2,11,8,1
38403,47,867,410,198,237,31,55,97,441,11,63,38,72,74,110,414,683,6,4293,238,0,2,11,8,1
38404,5,138,207,111,150,11,0,50,218,5,26,19,36,31,55,133,272,3,943,52,0,2,3,2,1
38405,14,476,42,7,35,4,0,5,46,1,2,1,2,3,3,2,4,0,2,0,0,2,1,1,1
38406,14,476,11,6,10,0,0,1,11,2,4,2,4,6,6,10,15,1,15,0,0,2,1,1,1
38407,228,5110,4293,999,3693,19,54,507,4312,9,155,88,170,164,258,1156,1898,4,9368,520,0,2,3,1,1
38408,228,5110,1482,859,1002,125,135,219,1607,16,219,134,251,235,385,1766,3032,9,27804,1544,1,2,3,1,1
38409,42,969,386,256,301,16,9,68,402,4,59,35,69,63,104,355,621,2,1453,80,0,2,4,1,1
38410,42,969,264,131,164,11,41,46,275,6,38,22,40,44,62,214,338,3,1068,59,0,2,4,1,1
38411,30,1334,386,256,301,16,9,68,402,4,59,35,69,63,104,355,621,2,1453,80,0,2,28,5,1
38412,42,969,386,256,301,16,9,68,402,4,59,35,69,63,104,355,621,2,1453,80,0,2,4,1,0
38413,42,969,264,131,164,11,41,46,275,6,38,22,40,44,62,214,338,3,1068,59,0,2,4,1,0
38414,30,1334,386,256,301,16,9,68,402,4,59,35,69,63,104,355,621,2,1453,80,0,2,28,5,0
38415,344,6953,1457,730,1242,11,6,188,1468,10,292,166,329,302,495,2424,4078,5,22973,1276,1,2,31,16,0
38416,344,6953,74,35,59,1,0,14,75,3,14,7,14,17,21,58,85,1,128,7,0,2,31,16,0
38417,344,6953,245,125,200,5,7,34,250,7,30,17,34,37,51,166,265,3,1053,58,0,2,31,16,0
38418,75,3862,1457,730,1242,11,6,188,1468,10,292,166,329,302,495,2424,4078,5,22973,1276,1,2,23,0,0
38419,61,2763,1455,414,1257,16,76,112,1471,5,41,23,46,46,69,231,381,2,1069,59,0,2,7,3,0
38424,44,859,207,111,150,11,0,50,218,5,26,19,36,31,55,133,272,3,943,52,0,2,3,0,0
38425,44,859,410,198,237,31,55,97,441,11,63,38,72,74,110,414,683,6,4293,238,0,2,3,0,0
38426,61,2747,1455,414,1257,16,76,112,1471,5,41,23,46,46,69,231,381,2,1069,59,0,2,1,3,0
38427,14,476,42,7,35,4,0,5,46,1,2,1,2,3,3,2,4,0,2,0,0,2,1,1,0
38428,14,476,11,6,10,0,0,1,11,2,4,2,4,6,6,10,15,1,15,0,0,2,1,1,0
38429,47,867,207,111,150,11,0,50,218,5,26,19,36,31,55,133,272,3,943,52,0,2,13,5,0
38430,47,867,410,198,237,31,55,97,441,11,63,38,72,74,110,414,683,6,4293,238,0,2,13,5,0
38431,5,138,207,111,150,11,0,50,218,5,26,19,36,31,55,133,272,3,943,52,0,0,50,0,0
38432,47,889,207,111,150,11,0,50,218,5,26,19,36,31,55,133,272,3,943,52,0,2,3,0,0
38433,47,889,410,198,237,31,55,97,441,11,63,38,72,74,110,414,683,6,4293,238,0,2,3,0,0
38434,61,2747,1455,414,1257,16,76,112,1471,5,41,23,46,46,69,231,381,2,1069,59,0,2,5,3,0
38439,28,545,2,2,2,0,0,0,2,0,0,0,0,0,0,0,0,0,0,0,0,2,1,1,0
38453,28,545,99,48,90,1,3,5,100,0,0,0,0,0,0,0,0,0,0,0,0,2,1,1,0
38454,28,545,8,5,5,2,0,1,10,0,0,0,0,0,0,0,0,0,0,0,0,2,1,1,0
38455,28,545,1217,716,841,84,126,174,1301,14,185,118,215,199,333,1446,2542,8,20687,1149,0,2,1,1,0
38456,28,545,160,89,115,0,13,31,160,7,15,11,17,22,28,78,124,3,495,27,0,2,1,1,0
38457,28,545,10,10,9,9,0,0,19,0,0,0,0,0,0,0,0,0,0,0,0,2,1,1,0
38458,28,545,173,84,99,8,29,36,181,5,12,7,13,17,20,54,81,2,221,12,0,2,1,1,0
38459,28,545,3,1,1,3,0,0,6,0,0,0,0,0,0,0,0,0,0,0,0,2,1,1,0
38462,47,896,207,111,150,11,0,50,218,5,26,19,36,31,55,133,272,3,943,52,0,2,16,5,0
38463,47,896,410,198,237,31,55,97,441,11,63,38,72,74,110,414,683,6,4293,238,0,2,16,5,0
38464,344,6953,1457,730,1242,11,6,188,1468,10,292,166,329,302,495,2424,4078,5,22973,1276,1,2,58,21,0
38465,344,6953,74,35,59,1,0,14,75,3,14,7,14,17,21,58,85,1,128,7,0,2,58,21,0
38466,344,6953,245,125,200,5,7,34,250,7,30,17,34,37,51,166,265,3,1053,58,0,2,58,21,0
38469,72,2129,1523,757,1297,19,12,193,1542,12,193,117,230,205,347,1508,2664,7,19053,1058,0,2,3,0,0
38470,72,2129,701,378,504,33,58,109,734,13,110,68,126,123,194,794,1346,7,10027,557,0,2,3,0,0
38471,177,4149,77,34,69,0,0,8,77,3,24,16,29,27,45,114,213,1,387,21,0,2,15,19,0
38472,177,4149,712,438,573,51,9,84,763,14,102,71,128,116,199,733,1364,8,11988,666,0,2,15,19,0
38473,223,5018,722,423,573,19,0,135,741,12,172,101,199,184,300,1320,2257,6,15668,870,0,2,1,0,0
38474,223,5018,1508,847,911,44,250,301,1552,14,148,88,169,162,257,1120,1886,7,15077,837,0,2,1,0,0
38475,335,7111,72,33,56,0,4,12,72,1,1,1,1,2,2,0,2,0,1,0,0,2,2,8,0
38476,335,7111,1454,835,1044,76,110,219,1530,17,275,158,296,292,454,2297,3718,9,34017,1889,1,2,2,8,0
38477,41,940,386,256,301,16,9,68,402,4,59,35,69,63,104,355,621,2,1453,80,0,2,4,1,0
38478,41,940,264,131,164,11,41,46,275,6,38,22,40,44,62,214,338,3,1068,59,0,2,4,1,0
38486,75,3862,1457,730,1242,11,6,188,1468,10,292,166,329,302,495,2424,4078,5,22973,1276,1,2,32,1,0
38488,62,2852,1455,414,1257,16,76,112,1471,5,41,23,46,46,69,231,381,2,1069,59,0,2,5,3,0
38489,82,4147,1523,757,1297,19,12,193,1542,12,193,117,230,205,347,1508,2664,7,19053,1058,0,2,4,0,0
38491,30,1362,386,256,301,16,9,68,402,4,59,35,69,63,104,355,621,2,1453,80,0,2,28,5,0
38549,1,300,382,65,130,157,2,92,539,4,10,5,10,14,15,41,57,2,114,6,0,2,1,1,1
38550,1,300,382,65,130,157,2,92,539,4,10,5,10,14,15,41,57,2,114,6,0,2,1,1,0
38551,335,7133,72,33,56,0,4,12,72,1,1,1,1,2,2,0,2,0,1,0,0,2,8,3,1
38552,335,7133,1454,835,1044,76,110,219,1530,17,275,158,296,292,454,2297,3718,9,34017,1889,1,2,8,3,1
38553,108,5395,1782,648,1425,9,47,279,1791,8,171,97,189,179,286,1292,2140,4,9462,525,0,2,49,9,1
38554,103,1969,1178,367,1042,6,15,115,1184,9,94,51,95,103,146,644,976,4,4439,246,0,2,1,1,1
38555,103,1969,177,108,140,8,0,27,185,6,30,16,32,36,48,162,248,3,794,44,0,2,1,1,1
38556,335,7133,72,33,56,0,4,12,72,1,1,1,1,2,2,0,2,0,1,0,0,2,8,3,0
38557,335,7133,1454,835,1044,76,110,219,1530,17,275,158,296,292,454,2297,3718,9,34017,1889,1,2,8,3,0
38558,108,5395,1782,648,1425,9,47,279,1791,8,171,97,189,179,286,1292,2140,4,9462,525,0,2,49,9,0
38559,42,947,386,256,301,16,9,68,402,4,59,35,69,63,104,355,621,2,1453,80,0,2,2,1,1
38560,42,947,264,131,164,11,41,46,275,6,38,22,40,44,62,214,338,3,1068,59,0,2,2,1,1
38561,31,1425,386,256,301,16,9,68,402,4,59,35,69,63,104,355,621,2,1453,80,0,2,10,0,1
38562,31,1500,386,256,301,16,9,68,402,4,59,35,69,63,104,355,621,2,1453,80,0,2,11,0,1
38563,31,1500,386,256,301,16,9,68,402,4,59,35,69,63,104,355,621,2,1453,80,0,2,1,0,0
38564,41,943,386,256,301,16,9,68,402,4,59,35,69,63,104,355,621,2,1453,80,0,2,2,2,0
38565,41,943,264,131,164,11,41,46,275,6,38,22,40,44,62,214,338,3,1068,59,0,2,2,2,0
38566,46,945,447,308,343,6,5,95,453,7,96,59,111,103,170,651,1136,4,4600,255,0,2,3,3,0
38567,46,945,322,174,179,16,74,51,338,10,41,26,46,51,72,252,408,5,2291,127,0,2,3,3,0
38568,37,1604,447,308,343,6,5,95,453,7,96,59,111,103,170,651,1136,4,4600,255,0,2,4,10,0
38572,9,223,19,8,11,5,0,4,24,2,5,3,6,7,9,13,25,1,30,1,0,2,1,1,1
38573,9,223,102,59,69,5,3,24,107,6,22,15,28,28,43,113,206,3,789,43,0,2,1,1,1
38574,9,223,106,40,36,3,49,17,109,8,17,13,23,25,36,93,167,5,904,50,0,2,1,1,1
38577,28,548,2,2,2,0,0,0,2,0,0,0,0,0,0,0,0,0,0,0,0,2,1,1,1
38591,28,548,99,48,90,1,3,5,100,0,0,0,0,0,0,0,0,0,0,0,0,2,1,1,1
38592,28,548,8,5,5,2,0,1,10,0,0,0,0,0,0,0,0,0,0,0,0,2,1,1,1
38593,28,548,1217,716,841,84,126,174,1301,14,185,118,215,199,333,1446,2542,8,20687,1149,0,2,1,1,1
38594,28,548,160,89,115,0,13,31,160,7,15,11,17,22,28,78,124,3,495,27,0,2,1,1,1
38595,28,548,10,10,9,9,0,0,19,0,0,0,0,0,0,0,0,0,0,0,0,2,1,1,1
38596,28,548,173,84,99,8,29,36,181,5,12,7,13,17,20,54,81,2,221,12,0,2,1,1,1
38597,28,548,3,1,1,3,0,0,6,0,0,0,0,0,0,0,0,0,0,0,0,2,1,1,1
38598,60,1254,996,429,845,24,10,117,1020,7,76,50,88,83,138,494,879,4,3565,198,0,2,1,1,1
38599,60,1254,456,277,329,12,42,72,468,13,85,50,97,98,147,592,972,7,7212,400,0,2,1,1,1
38600,119,2420,1513,682,1277,25,13,200,1538,11,199,116,219,210,335,1557,2584,6,15641,868,0,2,6,6,1
38601,119,2420,819,519,539,24,98,155,843,15,96,57,106,111,163,690,1107,8,9171,509,0,2,6,6,1
38602,344,6968,1457,730,1242,11,6,188,1468,10,292,166,329,302,495,2424,4078,5,22973,1276,1,2,5,5,1
38603,344,6968,74,35,59,1,0,14,75,3,14,7,14,17,21,58,85,1,128,7,0,2,5,5,1
38604,344,6968,245,125,200,5,7,34,250,7,30,17,34,37,51,166,265,3,1053,58,0,2,5,5,1
38605,22,679,339,213,244,17,9,65,356,10,42,26,48,52,74,259,421,5,2410,133,0,2,2,2,1
38606,228,5119,4293,999,3693,19,54,507,4312,9,155,88,170,164,258,1156,1898,4,9368,520,0,2,6,6,1
38607,228,5119,1482,859,1002,125,135,219,1607,16,219,134,251,235,385,1766,3032,9,27804,1544,1,2,6,6,1
38608,177,4152,77,34,69,0,0,8,77,3,24,16,29,27,45,114,213,1,387,21,0,2,1,1,1
38609,177,4152,712,438,573,51,9,84,763,14,102,71,128,116,199,733,1364,8,11988,666,0,2,1,1,1
38610,69,1359,1020,354,843,12,15,144,1032,8,134,77,144,142,221,970,1580,4,6792,377,0,2,4,4,1
38611,46,955,447,308,343,6,5,95,453,7,96,59,111,103,170,651,1136,4,4600,255,0,2,2,2,1
38612,46,955,322,174,179,16,74,51,338,10,41,26,46,51,72,252,408,5,2291,127,0,2,2,2,1
38613,223,5051,722,423,573,19,0,135,741,12,172,101,199,184,300,1320,2257,6,15668,870,0,2,11,11,1
38614,223,5051,1508,847,911,44,250,301,1552,14,148,88,169,162,257,1120,1886,7,15077,837,0,2,11,11,1
38615,128,2818,1043,504,840,53,9,147,1096,9,180,112,198,189,310,1377,2344,4,11604,644,0,2,2,2,1
38616,128,2818,383,288,292,26,6,62,409,11,65,38,67,76,105,429,656,5,3719,206,0,2,2,2,1
38617,103,1959,1178,367,1042,6,15,115,1184,9,94,51,95,103,146,644,976,4,4439,246,0,2,1,1,1
38618,103,1959,177,108,140,8,0,27,185,6,30,16,32,36,48,162,248,3,794,44,0,2,1,1,1
38619,184,3747,1943,715,1694,26,18,214,1969,12,185,120,237,197,357,1436,2721,7,20915,1161,0,2,2,2,1
38620,184,3747,1168,838,957,57,25,144,1225,19,348,224,416,367,640,3018,5452,11,61921,3440,1,2,2,2,1
38621,16,471,442,244,305,14,16,103,456,11,68,45,75,79,120,452,756,6,4588,254,0,2,1,1,1
38622,16,471,182,102,99,11,40,35,193,3,11,6,11,14,17,42,64,1,97,5,0,2,1,1,1
38623,9,223,19,8,11,5,0,4,24,2,5,3,6,7,9,13,25,1,30,1,0,2,1,1,0
38624,9,223,102,59,69,5,3,24,107,6,22,15,28,28,43,113,206,3,789,43,0,2,1,1,0
38625,9,223,106,40,36,3,49,17,109,8,17,13,23,25,36,93,167,5,904,50,0,2,1,1,0
38628,28,548,2,2,2,0,0,0,2,0,0,0,0,0,0,0,0,0,0,0,0,2,1,1,0
38642,28,548,99,48,90,1,3,5,100,0,0,0,0,0,0,0,0,0,0,0,0,2,1,1,0
38643,28,548,8,5,5,2,0,1,10,0,0,0,0,0,0,0,0,0,0,0,0,2,1,1,0
38644,28,548,1217,716,841,84,126,174,1301,14,185,118,215,199,333,1446,2542,8,20687,1149,0,2,1,1,0
38645,28,548,160,89,115,0,13,31,160,7,15,11,17,22,28,78,124,3,495,27,0,2,1,1,0
38646,28,548,10,10,9,9,0,0,19,0,0,0,0,0,0,0,0,0,0,0,0,2,1,1,0
38647,28,548,173,84,99,8,29,36,181,5,12,7,13,17,20,54,81,2,221,12,0,2,1,1,0
38648,28,548,3,1,1,3,0,0,6,0,0,0,0,0,0,0,0,0,0,0,0,2,1,1,0
38649,60,1254,996,429,845,24,10,117,1020,7,76,50,88,83,138,494,879,4,3565,198,0,2,1,1,0
38650,60,1254,456,277,329,12,42,72,468,13,85,50,97,98,147,592,972,7,7212,400,0,2,1,1,0
38651,119,2420,1513,682,1277,25,13,200,1538,11,199,116,219,210,335,1557,2584,6,15641,868,0,2,6,6,0
38652,119,2420,819,519,539,24,98,155,843,15,96,57,106,111,163,690,1107,8,9171,509,0,2,6,6,0
38653,344,6968,1457,730,1242,11,6,188,1468,10,292,166,329,302,495,2424,4078,5,22973,1276,1,2,5,5,0
38654,344,6968,74,35,59,1,0,14,75,3,14,7,14,17,21,58,85,1,128,7,0,2,5,5,0
38655,344,6968,245,125,200,5,7,34,250,7,30,17,34,37,51,166,265,3,1053,58,0,2,5,5,0
38656,22,679,339,213,244,17,9,65,356,10,42,26,48,52,74,259,421,5,2410,133,0,2,2,2,0
38657,228,5119,4293,999,3693,19,54,507,4312,9,155,88,170,164,258,1156,1898,4,9368,520,0,2,6,6,0
38658,228,5119,1482,859,1002,125,135,219,1607,16,219,134,251,235,385,1766,3032,9,27804,1544,1,2,6,6,0
38659,177,4152,77,34,69,0,0,8,77,3,24,16,29,27,45,114,213,1,387,21,0,2,1,1,0
38660,177,4152,712,438,573,51,9,84,763,14,102,71,128,116,199,733,1364,8,11988,666,0,2,1,1,0
38661,69,1359,1020,354,843,12,15,144,1032,8,134,77,144,142,221,970,1580,4,6792,377,0,2,4,4,0
38662,46,955,447,308,343,6,5,95,453,7,96,59,111,103,170,651,1136,4,4600,255,0,2,2,2,0
38663,46,955,322,174,179,16,74,51,338,10,41,26,46,51,72,252,408,5,2291,127,0,2,2,2,0
38664,223,5051,722,423,573,19,0,135,741,12,172,101,199,184,300,1320,2257,6,15668,870,0,2,11,11,0
38665,223,5051,1508,847,911,44,250,301,1552,14,148,88,169,162,257,1120,1886,7,15077,837,0,2,11,11,0
38666,128,2818,1043,504,840,53,9,147,1096,9,180,112,198,189,310,1377,2344,4,11604,644,0,2,2,2,0
38667,128,2818,383,288,292,26,6,62,409,11,65,38,67,76,105,429,656,5,3719,206,0,2,2,2,0
38668,103,1959,1178,367,1042,6,15,115,1184,9,94,51,95,103,146,644,976,4,4439,246,0,2,1,1,0
38669,103,1959,177,108,140,8,0,27,185,6,30,16,32,36,48,162,248,3,794,44,0,2,1,1,0
38670,184,3747,1943,715,1694,26,18,214,1969,12,185,120,237,197,357,1436,2721,7,20915,1161,0,2,2,2,0
38671,184,3747,1168,838,957,57,25,144,1225,19,348,224,416,367,640,3018,5452,11,61921,3440,1,2,2,2,0
38672,16,471,442,244,305,14,16,103,456,11,68,45,75,79,120,452,756,6,4588,254,0,2,1,1,0
38673,16,471,182,102,99,11,40,35,193,3,11,6,11,14,17,42,64,1,97,5,0,2,1,1,0
38674,222,4984,722,423,573,19,0,135,741,12,172,101,199,184,300,1320,2257,6,15668,870,0,2,1,0,1
38675,222,4984,1508,847,911,44,250,301,1552,14,148,88,169,162,257,1120,1886,7,15077,837,0,2,1,0,1
38676,15,621,722,423,573,19,0,135,741,12,172,101,199,184,300,1320,2257,6,15668,870,0,2,7,0,1
38677,345,6966,1457,730,1242,11,6,188,1468,10,292,166,329,302,495,2424,4078,5,22973,1276,1,2,5,2,1
38678,345,6966,74,35,59,1,0,14,75,3,14,7,14,17,21,58,85,1,128,7,0,2,5,2,1
38679,345,6966,245,125,200,5,7,34,250,7,30,17,34,37,51,166,265,3,1053,58,0,2,5,2,1
38680,148,4073,1660,832,1314,41,38,274,1701,20,312,209,395,332,604,2671,5058,12,64042,3557,1,2,17,1,1
38681,346,6990,1457,730,1242,11,6,188,1468,10,292,166,329,302,495,2424,4078,5,22973,1276,1,2,24,14,0
38682,346,6990,74,35,59,1,0,14,75,3,14,7,14,17,21,58,85,1,128,7,0,2,24,14,0
38683,346,6990,245,125,200,5,7,34,250,7,30,17,34,37,51,166,265,3,1053,58,0,2,24,14,0
38684,76,3974,1457,730,1242,11,6,188,1468,10,292,166,329,302,495,2424,4078,5,22973,1276,1,2,15,0,0
38685,346,6990,1457,730,1242,11,6,188,1468,10,292,166,329,302,495,2424,4078,5,22973,1276,1,2,24,11,0
38686,346,6990,74,35,59,1,0,14,75,3,14,7,14,17,21,58,85,1,128,7,0,2,24,11,0
38687,346,6990,245,125,200,5,7,34,250,7,30,17,34,37,51,166,265,3,1053,58,0,2,24,11,0
38688,148,4073,1660,832,1314,41,38,274,1701,20,312,209,395,332,604,2671,5058,12,64042,3557,1,2,17,1,0
38690,48,934,207,111,150,11,0,50,218,5,26,19,36,31,55,133,272,3,943,52,0,2,10,2,1
38691,48,934,410,198,237,31,55,97,441,11,63,38,72,74,110,414,683,6,4293,238,0,2,10,2,1
38692,10,228,207,111,150,11,0,50,218,5,26,19,36,31,55,133,272,3,943,52,0,2,29,4,1
38693,48,948,207,111,150,11,0,50,218,5,26,19,36,31,55,133,272,3,943,52,0,2,3,1,0
38694,48,948,410,198,237,31,55,97,441,11,63,38,72,74,110,414,683,6,4293,238,0,2,3,1,0
38695,222,4983,722,423,573,19,0,135,741,12,172,101,199,184,300,1320,2257,6,15668,870,0,2,3,3,0
38696,222,4983,1508,847,911,44,250,301,1552,14,148,88,169,162,257,1120,1886,7,15077,837,0,2,3,3,0
38697,346,6990,1457,730,1242,11,6,188,1468,10,292,166,329,302,495,2424,4078,5,22973,1276,1,2,1,1,0
38698,346,6990,74,35,59,1,0,14,75,3,14,7,14,17,21,58,85,1,128,7,0,2,1,1,0
38699,346,6990,245,125,200,5,7,34,250,7,30,17,34,37,51,166,265,3,1053,58,0,2,1,1,0
38700,93,3417,1450,624,1228,12,26,181,1462,14,306,186,354,320,540,2580,4493,8,36391,2021,1,2,17,0,0
38701,48,948,207,111,150,11,0,50,218,5,26,19,36,31,55,133,272,3,943,52,0,2,12,2,0
38702,48,948,410,198,237,31,55,97,441,11,63,38,72,74,110,414,683,6,4293,238,0,2,12,2,0
38703,10,228,207,111,150,11,0,50,218,5,26,19,36,31,55,133,272,3,943,52,0,2,29,4,0
38704,222,4984,722,423,573,19,0,135,741,12,172,101,199,184,300,1320,2257,6,15668,870,0,2,1,0,0
38705,222,4984,1508,847,911,44,250,301,1552,14,148,88,169,162,257,1120,1886,7,15077,837,0,2,1,0,0
38706,15,621,722,423,573,19,0,135,741,12,172,101,199,184,300,1320,2257,6,15668,870,0,2,7,0,0
38711,179,4178,77,34,69,0,0,8,77,3,24,16,29,27,45,114,213,1,387,21,0,2,9,8,0
38712,179,4178,712,438,573,51,9,84,763,14,102,71,128,116,199,733,1364,8,11988,666,0,2,9,8,0
38716,222,4988,722,423,573,19,0,135,741,12,172,101,199,184,300,1320,2257,6,15668,870,0,2,1,0,0
38717,222,4988,1508,847,911,44,250,301,1552,14,148,88,169,162,257,1120,1886,7,15077,837,0,2,1,0,0
38720,222,4988,722,423,573,19,0,135,741,12,172,101,199,184,300,1320,2257,6,15668,870,0,2,3,3,0
38721,222,4988,1508,847,911,44,250,301,1552,14,148,88,169,162,257,1120,1886,7,15077,837,0,2,3,3,0
38722,179,4176,77,34,69,0,0,8,77,3,24,16,29,27,45,114,213,1,387,21,0,2,0,2,0
38723,179,4176,712,438,573,51,9,84,763,14,102,71,128,116,199,733,1364,8,11988,666,0,2,0,2,0
38724,179,4176,77,34,69,0,0,8,77,3,24,16,29,27,45,114,213,1,387,21,0,2,30,18,0
38725,179,4176,712,438,573,51,9,84,763,14,102,71,128,116,199,733,1364,8,11988,666,0,2,30,18,0
38726,49,577,647,139,84,35,284,233,682,0,0,0,0,0,0,0,0,0,0,0,0,2,2,1,0
38727,335,7141,72,33,56,0,4,12,72,1,1,1,1,2,2,0,2,0,1,0,0,2,3,2,0
38728,335,7141,1454,835,1044,76,110,219,1530,17,275,158,296,292,454,2297,3718,9,34017,1889,1,2,3,2,0
38729,109,5438,1782,648,1425,9,47,279,1791,8,171,97,189,179,286,1292,2140,4,9462,525,0,2,23,0,0
38730,49,575,647,139,84,35,284,233,682,0,0,0,0,0,0,0,0,0,0,0,0,2,1,1,0
38731,109,5438,1782,648,1425,9,47,279,1791,8,171,97,189,179,286,1292,2140,4,9462,525,0,2,5,5,0
38757,14,472,42,7,35,4,0,5,46,1,2,1,2,3,3,2,4,0,2,0,0,2,0,1,0
38758,14,472,11,6,10,0,0,1,11,2,4,2,4,6,6,10,15,1,15,0,0,2,0,1,0
38805,103,1969,1178,367,1042,6,15,115,1184,9,94,51,95,103,146,644,976,4,4439,246,0,2,1,1,0
38806,103,1969,177,108,140,8,0,27,185,6,30,16,32,36,48,162,248,3,794,44,0,2,1,1,0
38809,14,472,42,7,35,4,0,5,46,1,2,1,2,3,3,2,4,0,2,0,0,2,1,1,0
38810,14,472,11,6,10,0,0,1,11,2,4,2,4,6,6,10,15,1,15,0,0,2,1,1,0
38813,49,575,647,139,84,35,284,233,682,0,0,0,0,0,0,0,0,0,0,0,0,2,2,1,0
38817,346,7005,1457,730,1242,11,6,188,1468,10,292,166,329,302,495,2424,4078,5,22973,1276,1,2,24,11,0
38818,346,7005,74,35,59,1,0,14,75,3,14,7,14,17,21,58,85,1,128,7,0,2,24,11,0
38819,346,7005,245,125,200,5,7,34,250,7,30,17,34,37,51,166,265,3,1053,58,0,2,24,11,0
38820,178,4158,77,34,69,0,0,8,77,3,24,16,29,27,45,114,213,1,387,21,0,2,30,18,0
38821,178,4158,712,438,573,51,9,84,763,14,102,71,128,116,199,733,1364,8,11988,666,0,2,30,18,0
38822,46,951,447,308,343,6,5,95,453,7,96,59,111,103,170,651,1136,4,4600,255,0,2,3,3,0
38823,46,951,322,174,179,16,74,51,338,10,41,26,46,51,72,252,408,5,2291,127,0,2,3,3,0
38824,223,5060,722,423,573,19,0,135,741,12,172,101,199,184,300,1320,2257,6,15668,870,0,2,4,3,0
38825,223,5060,1508,847,911,44,250,301,1552,14,148,88,169,162,257,1120,1886,7,15077,837,0,2,4,3,0
38829,14,472,42,7,35,4,0,5,46,1,2,1,2,3,3,2,4,0,2,0,0,2,1,2,0
38830,14,472,11,6,10,0,0,1,11,2,4,2,4,6,6,10,15,1,15,0,0,2,1,2,0
38831,107,4012,1450,624,1228,12,26,181,1462,14,306,186,354,320,540,2580,4493,8,36391,2021,1,2,17,0,0
38855,59,1216,1098,241,925,5,10,155,1103,7,46,25,49,53,74,273,423,3,1580,87,0,2,12,2,1
38856,59,1216,282,202,222,14,2,44,296,8,42,24,43,50,67,250,378,4,1548,86,0,2,12,2,1
38857,31,1477,1293,570,1093,25,15,163,1318,10,195,123,241,205,364,1516,2795,6,17273,959,0,2,14,0,1
38858,59,1216,1098,241,925,5,10,155,1103,7,46,25,49,53,74,273,423,3,1580,87,0,2,2,2,0
38859,59,1216,282,202,222,14,2,44,296,8,42,24,43,50,67,250,378,4,1548,86,0,2,2,2,0
38860,335,7115,72,33,56,0,4,12,72,1,1,1,1,2,2,0,2,0,1,0,0,2,1,1,0
38861,335,7115,1454,835,1044,76,110,219,1530,17,275,158,296,292,454,2297,3718,9,34017,1889,1,2,1,1,0
38866,62,1244,1098,241,925,5,10,155,1103,7,46,25,49,53,74,273,423,3,1580,87,0,2,19,11,1
38867,62,1244,282,202,222,14,2,44,296,8,42,24,43,50,67,250,378,4,1548,86,0,2,19,11,1
38868,31,1478,1293,570,1093,25,15,163,1318,10,195,123,241,205,364,1516,2795,6,17273,959,0,2,1,0,1
38869,337,7189,72,33,56,0,4,12,72,1,1,1,1,2,2,0,2,0,1,0,0,2,20,4,0
38870,337,7189,1454,835,1044,76,110,219,1530,17,275,158,296,292,454,2297,3718,9,34017,1889,1,2,20,4,0
38871,20,535,256,139,192,9,7,47,265,4,23,12,24,27,36,112,171,2,357,19,0,2,15,0,0
38872,31,1490,386,256,301,16,9,68,402,4,59,35,69,63,104,355,621,2,1453,80,0,2,1,2,0
38873,20,535,256,139,192,9,7,47,265,4,23,12,24,27,36,112,171,2,357,19,0,2,1,1,0
38878,104,1979,1178,367,1042,6,15,115,1184,9,94,51,95,103,146,644,976,4,4439,246,0,2,2,1,1
38879,104,1979,177,108,140,8,0,27,185,6,30,16,32,36,48,162,248,3,794,44,0,2,2,1,1
38880,71,2977,1178,367,1042,6,15,115,1184,9,94,51,95,103,146,644,976,4,4439,246,0,2,23,0,0
38883,104,1979,1178,367,1042,6,15,115,1184,9,94,51,95,103,146,644,976,4,4439,246,0,2,2,1,0
38884,104,1979,177,108,140,8,0,27,185,6,30,16,32,36,48,162,248,3,794,44,0,2,2,1,0
38886,227,5097,4293,999,3693,19,54,507,4312,9,155,88,170,164,258,1156,1898,4,9368,520,0,2,0,2,0
38887,227,5097,1482,859,1002,125,135,219,1607,16,219,134,251,235,385,1766,3032,9,27804,1544,1,2,0,2,0
38888,227,5099,4293,999,3693,19,54,507,4312,9,155,88,170,164,258,1156,1898,4,9368,520,0,2,4,1,0
38889,227,5099,1482,859,1002,125,135,219,1607,16,219,134,251,235,385,1766,3032,9,27804,1544,1,2,4,1,0
38890,94,4250,1338,495,1086,10,64,173,1348,11,122,82,157,133,239,883,1686,7,11934,663,0,2,10,0,0
38891,227,5099,4293,999,3693,19,54,507,4312,9,155,88,170,164,258,1156,1898,4,9368,520,0,2,4,3,0
38892,227,5099,1482,859,1002,125,135,219,1607,16,219,134,251,235,385,1766,3032,9,27804,1544,1,2,4,3,0
38896,104,1979,1178,367,1042,6,15,115,1184,9,94,51,95,103,146,644,976,4,4439,246,0,2,3,2,0
38897,104,1979,177,108,140,8,0,27,185,6,30,16,32,36,48,162,248,3,794,44,0,2,3,2,0
38900,62,1244,1098,241,925,5,10,155,1103,7,46,25,49,53,74,273,423,3,1580,87,0,2,20,2,0
38901,62,1244,282,202,222,14,2,44,296,8,42,24,43,50,67,250,378,4,1548,86,0,2,20,2,0
38902,31,1478,1293,570,1093,25,15,163,1318,10,195,123,241,205,364,1516,2795,6,17273,959,0,2,15,0,0
38903,346,6994,1457,730,1242,11,6,188,1468,10,292,166,329,302,495,2424,4078,5,22973,1276,1,2,10,9,1
38904,346,6994,74,35,59,1,0,14,75,3,14,7,14,17,21,58,85,1,128,7,0,2,10,9,1
38905,346,6994,245,125,200,5,7,34,250,7,30,17,34,37,51,166,265,3,1053,58,0,2,10,9,1
38906,78,4037,1457,730,1242,11,6,188,1468,10,292,166,329,302,495,2424,4078,5,22973,1276,1,2,15,0,1
38907,163,5074,1660,832,1314,41,38,274,1701,20,312,209,395,332,604,2671,5058,12,64042,3557,1,2,2,1,0
38908,163,5074,1057,646,719,113,100,145,1170,18,215,134,248,233,382,1740,3004,10,31186,1732,1,2,2,1,0
38909,178,4160,77,34,69,0,0,8,77,3,24,16,29,27,45,114,213,1,387,21,0,2,1,1,1
38910,178,4160,712,438,573,51,9,84,763,14,102,71,128,116,199,733,1364,8,11988,666,0,2,1,1,1
38911,222,4989,722,423,573,19,0,135,741,12,172,101,199,184,300,1320,2257,6,15668,870,0,2,1,1,0
38912,222,4989,1508,847,911,44,250,301,1552,14,148,88,169,162,257,1120,1886,7,15077,837,0,2,1,1,0
38913,16,469,442,244,305,14,16,103,456,11,68,45,75,79,120,452,756,6,4588,254,0,2,1,1,0
38914,16,469,182,102,99,11,40,35,193,3,11,6,11,14,17,42,64,1,97,5,0,2,1,1,0
38917,49,573,647,139,84,35,284,233,682,0,0,0,0,0,0,0,0,0,0,0,0,2,1,1,1
38918,179,4176,77,34,69,0,0,8,77,3,24,16,29,27,45,114,213,1,387,21,0,2,1,1,1
38919,179,4176,712,438,573,51,9,84,763,14,102,71,128,116,199,733,1364,8,11988,666,0,2,1,1,1
38921,222,4988,722,423,573,19,0,135,741,12,172,101,199,184,300,1320,2257,6,15668,870,0,2,3,3,1
38922,222,4988,1508,847,911,44,250,301,1552,14,148,88,169,162,257,1120,1886,7,15077,837,0,2,3,3,1
38923,335,7115,72,33,56,0,4,12,72,1,1,1,1,2,2,0,2,0,1,0,0,2,1,1,1
38924,335,7115,1454,835,1044,76,110,219,1530,17,275,158,296,292,454,2297,3718,9,34017,1889,1,2,1,1,1
38925,62,1244,1098,241,925,5,10,155,1103,7,46,25,49,53,74,273,423,3,1580,87,0,2,1,1,1
38926,62,1244,282,202,222,14,2,44,296,8,42,24,43,50,67,250,378,4,1548,86,0,2,1,1,1
38927,93,3417,1450,624,1228,12,26,181,1462,14,306,186,354,320,540,2580,4493,8,36391,2021,1,2,1,1,1
38928,148,4073,1660,832,1314,41,38,274,1701,20,312,209,395,332,604,2671,5058,12,64042,3557,1,2,1,1,1
38929,116,4563,1513,682,1277,25,13,200,1538,11,199,116,219,210,335,1557,2584,6,15641,868,0,2,1,1,1
38930,25,1016,373,158,315,8,0,51,381,5,76,44,79,81,123,486,779,2,2026,112,0,2,1,1,1
38931,178,4160,77,34,69,0,0,8,77,3,24,16,29,27,45,114,213,1,387,21,0,2,1,1,0
38932,178,4160,712,438,573,51,9,84,763,14,102,71,128,116,199,733,1364,8,11988,666,0,2,1,1,0
38933,346,6994,1457,730,1242,11,6,188,1468,10,292,166,329,302,495,2424,4078,5,22973,1276,1,2,10,9,0
38934,346,6994,74,35,59,1,0,14,75,3,14,7,14,17,21,58,85,1,128,7,0,2,10,9,0
38935,346,6994,245,125,200,5,7,34,250,7,30,17,34,37,51,166,265,3,1053,58,0,2,10,9,0
38936,78,4037,1457,730,1242,11,6,188,1468,10,292,166,329,302,495,2424,4078,5,22973,1276,1,2,15,0,0
38941,60,1251,996,429,845,24,10,117,1020,7,76,50,88,83,138,494,879,4,3565,198,0,2,1,1,0
38942,60,1251,456,277,329,12,42,72,468,13,85,50,97,98,147,592,972,7,7212,400,0,2,1,1,0
38944,179,4176,77,34,69,0,0,8,77,3,24,16,29,27,45,114,213,1,387,21,0,2,1,1,0
38945,179,4176,712,438,573,51,9,84,763,14,102,71,128,116,199,733,1364,8,11988,666,0,2,1,1,0
38947,222,4989,722,423,573,19,0,135,741,12,172,101,199,184,300,1320,2257,6,15668,870,0,2,3,3,0
38948,222,4989,1508,847,911,44,250,301,1552,14,148,88,169,162,257,1120,1886,7,15077,837,0,2,3,3,0
38951,62,1244,1098,241,925,5,10,155,1103,7,46,25,49,53,74,273,423,3,1580,87,0,2,1,1,0
38952,62,1244,282,202,222,14,2,44,296,8,42,24,43,50,67,250,378,4,1548,86,0,2,1,1,0
38953,93,3417,1450,624,1228,12,26,181,1462,14,306,186,354,320,540,2580,4493,8,36391,2021,1,2,1,1,0
38954,148,4073,1660,832,1314,41,38,274,1701,20,312,209,395,332,604,2671,5058,12,64042,3557,1,2,1,1,0
38955,116,4563,1513,682,1277,25,13,200,1538,11,199,116,219,210,335,1557,2584,6,15641,868,0,2,1,1,0
38956,25,1016,373,158,315,8,0,51,381,5,76,44,79,81,123,486,779,2,2026,112,0,2,1,1,0
38957,60,1092,282,196,195,3,0,86,285,8,130,71,141,138,212,936,1507,4,6538,363,0,2,6,6,1
38958,7,114,44,19,17,0,16,11,44,3,14,7,14,17,21,58,85,1,128,7,0,2,1,1,1
38976,7,301,72,33,56,0,4,12,72,1,1,1,1,2,2,0,2,0,1,0,0,2,1,1,1
38977,3,26,14,7,7,2,0,5,16,0,0,0,0,0,0,0,0,0,0,0,0,2,1,1,1
38978,78,3306,1289,550,1043,56,32,155,1345,10,167,93,185,177,278,1266,2075,5,11498,638,0,2,5,5,1
38979,34,989,182,127,129,0,0,53,182,5,39,21,42,44,63,217,343,2,926,51,0,2,3,3,1
38980,137,6592,1392,870,1177,35,17,170,1427,14,494,280,531,508,811,4473,7289,7,54850,3047,2,2,4,4,1
38981,91,3003,773,419,590,28,0,166,801,10,204,113,217,214,330,1598,2554,5,13587,754,0,2,11,11,1
38982,7,255,75,38,59,1,3,12,76,2,4,2,4,6,6,10,15,1,15,0,0,2,1,1,1
38983,47,2498,520,294,400,33,13,81,553,10,261,204,367,271,571,2128,4614,7,32445,1802,1,2,1,1,1
38984,93,4253,1338,495,1086,10,64,173,1348,11,122,82,157,133,239,883,1686,7,11934,663,0,2,24,24,1
38985,147,6760,139,89,101,2,0,35,141,7,54,34,62,61,96,330,569,4,2287,127,0,2,49,49,1
38986,147,6760,7,5,5,0,0,2,7,1,2,1,2,3,3,2,4,0,2,0,0,2,49,49,1
38987,32,948,465,148,393,5,8,60,470,4,31,20,31,35,51,161,261,2,523,29,0,2,9,9,1
38988,32,948,16,12,9,0,0,6,16,1,2,1,2,3,3,2,4,0,2,0,0,2,9,9,1
38989,109,5462,1782,648,1425,9,47,279,1791,8,171,97,189,179,286,1292,2140,4,9462,525,0,2,16,16,1
38990,20,541,256,139,192,9,7,47,265,4,23,12,24,27,36,112,171,2,357,19,0,2,2,2,1
38991,23,597,102,59,69,5,3,24,107,6,22,15,28,28,43,113,206,3,789,43,0,2,1,1,1
38992,107,4030,1450,624,1228,12,26,181,1462,14,306,186,354,320,540,2580,4493,8,36391,2021,1,2,8,8,1
38993,148,4080,1660,832,1314,41,38,274,1701,20,312,209,395,332,604,2671,5058,12,64042,3557,1,2,5,5,1
38994,116,4587,1513,682,1277,25,13,200,1538,11,199,116,219,210,335,1557,2584,6,15641,868,0,2,8,8,1
38995,59,3302,1296,573,1062,40,33,157,1336,8,201,118,231,209,349,1561,2689,4,12365,686,0,2,19,19,1
38996,76,4022,1457,730,1242,11,6,188,1468,10,292,166,329,302,495,2424,4078,5,22973,1276,1,2,16,16,1
38997,38,2278,652,304,544,16,6,88,668,6,89,51,101,95,152,591,998,3,3399,188,0,2,4,4,1
38998,62,2870,1455,414,1257,16,76,112,1471,5,41,23,46,46,69,231,381,2,1069,59,0,2,9,9,1
38999,82,4156,1523,757,1297,19,12,193,1542,12,193,117,230,205,347,1508,2664,7,19053,1058,0,2,6,6,1
39000,66,2759,1020,354,843,12,15,144,1032,8,134,77,144,142,221,970,1580,4,6792,377,0,2,15,15,1
39001,37,1616,447,308,343,6,5,95,453,7,96,59,111,103,170,651,1136,4,4600,255,0,2,4,4,1
39002,21,653,424,94,331,4,0,89,428,1,5,5,5,6,10,11,25,0,12,0,0,2,5,5,1
39003,40,2355,334,251,279,10,4,40,344,5,127,74,143,132,217,899,1528,2,4303,239,0,2,2,2,1
39004,12,484,184,100,137,2,15,30,186,6,38,20,39,44,59,214,322,3,991,55,0,2,3,3,1
39005,34,1565,1293,570,1093,25,15,163,1318,10,195,123,241,205,364,1516,2795,6,17273,959,0,2,3,3,1
39006,36,1970,384,251,317,7,8,52,391,11,70,44,84,81,128,467,811,6,5355,297,0,2,10,10,1
39007,15,630,722,423,573,19,0,135,741,12,172,101,199,184,300,1320,2257,6,15668,870,0,2,3,3,1
39008,16,1201,215,129,180,6,0,29,221,8,65,43,72,73,115,415,711,4,3153,175,0,2,1,1,1
39009,69,2852,1043,504,840,53,9,147,1096,9,180,112,198,189,310,1377,2344,4,11604,644,0,2,9,9,1
39010,14,520,295,56,236,0,4,54,295,2,9,5,10,11,15,30,51,1,57,3,0,2,8,8,1
39011,25,1019,373,158,315,8,0,51,381,5,76,44,79,81,123,486,779,2,2026,112,0,2,6,6,1
39012,68,2947,1178,367,1042,6,15,115,1184,9,94,51,95,103,146,644,976,4,4439,246,0,2,10,10,1
39013,72,3682,1943,715,1694,26,18,214,1969,12,185,120,237,197,357,1436,2721,7,20915,1161,0,2,13,13,1
39014,14,817,442,244,305,14,16,103,456,11,68,45,75,79,120,452,756,6,4588,254,0,2,2,2,1
39015,48,1776,1098,241,925,5,10,155,1103,7,46,25,49,53,74,273,423,3,1580,87,0,2,2,2,1
39016,60,1092,282,196,195,3,0,86,285,8,130,71,141,138,212,936,1507,4,6538,363,0,2,6,6,0
39017,7,114,44,19,17,0,16,11,44,3,14,7,14,17,21,58,85,1,128,7,0,2,1,1,0
39018,3,66,127,75,83,2,11,30,129,4,14,7,14,18,21,61,87,2,175,9,0,2,1,1,0
39019,3,66,652,304,544,16,6,88,668,6,89,51,101,95,152,591,998,3,3399,188,0,2,1,1,0
39020,3,66,2,2,2,0,0,0,2,0,0,0,0,0,0,0,0,0,0,0,0,2,1,1,0
39021,3,66,8,5,5,0,0,3,8,0,0,0,0,0,0,0,0,0,0,0,0,2,1,1,0
39024,3,66,14,8,8,0,0,6,14,0,0,0,0,0,0,0,0,0,0,0,0,2,1,1,0
39025,3,66,6,4,4,0,0,2,6,0,0,0,0,0,0,0,0,0,0,0,0,2,1,1,0
39026,3,66,6,4,4,0,0,2,6,1,2,1,2,3,3,2,4,0,2,0,0,2,1,1,0
39028,3,66,7,5,5,0,0,2,7,0,0,0,0,0,0,0,0,0,0,0,0,2,1,1,0
39030,3,66,10,6,6,0,0,4,10,0,0,0,0,0,0,0,0,0,0,0,0,2,1,1,0
39031,3,66,1,1,1,0,0,0,1,0,0,0,0,0,0,0,0,0,0,0,0,2,1,1,0
39033,3,66,14,10,10,0,0,4,14,1,1,1,1,2,2,0,2,0,1,0,0,2,1,1,0
39034,3,66,46,26,30,3,0,12,49,3,6,3,6,9,9,20,28,1,42,2,0,2,1,1,0
39035,7,301,72,33,56,0,4,12,72,1,1,1,1,2,2,0,2,0,1,0,0,2,1,1,0
39036,3,26,14,7,7,2,0,5,16,0,0,0,0,0,0,0,0,0,0,0,0,2,1,1,0
39037,78,3306,1289,550,1043,56,32,155,1345,10,167,93,185,177,278,1266,2075,5,11498,638,0,2,5,5,0
39038,34,989,182,127,129,0,0,53,182,5,39,21,42,44,63,217,343,2,926,51,0,2,3,3,0
39039,137,6592,1392,870,1177,35,17,170,1427,14,494,280,531,508,811,4473,7289,7,54850,3047,2,2,4,4,0
39040,91,3003,773,419,590,28,0,166,801,10,204,113,217,214,330,1598,2554,5,13587,754,0,2,11,11,0
39041,7,255,75,38,59,1,3,12,76,2,4,2,4,6,6,10,15,1,15,0,0,2,1,1,0
39042,47,2498,520,294,400,33,13,81,553,10,261,204,367,271,571,2128,4614,7,32445,1802,1,2,1,1,0
39043,93,4253,1338,495,1086,10,64,173,1348,11,122,82,157,133,239,883,1686,7,11934,663,0,2,24,24,0
39044,147,6760,139,89,101,2,0,35,141,7,54,34,62,61,96,330,569,4,2287,127,0,2,49,49,0
39045,147,6760,7,5,5,0,0,2,7,1,2,1,2,3,3,2,4,0,2,0,0,2,49,49,0
39046,32,948,465,148,393,5,8,60,470,4,31,20,31,35,51,161,261,2,523,29,0,2,9,9,0
39047,32,948,16,12,9,0,0,6,16,1,2,1,2,3,3,2,4,0,2,0,0,2,9,9,0
39048,109,5462,1782,648,1425,9,47,279,1791,8,171,97,189,179,286,1292,2140,4,9462,525,0,2,16,16,0
39049,20,541,256,139,192,9,7,47,265,4,23,12,24,27,36,112,171,2,357,19,0,2,2,2,0
39050,23,597,102,59,69,5,3,24,107,6,22,15,28,28,43,113,206,3,789,43,0,2,1,1,0
39051,107,4030,1450,624,1228,12,26,181,1462,14,306,186,354,320,540,2580,4493,8,36391,2021,1,2,8,8,0
39052,148,4080,1660,832,1314,41,38,274,1701,20,312,209,395,332,604,2671,5058,12,64042,3557,1,2,5,5,0
39053,116,4587,1513,682,1277,25,13,200,1538,11,199,116,219,210,335,1557,2584,6,15641,868,0,2,8,8,0
39054,59,3302,1296,573,1062,40,33,157,1336,8,201,118,231,209,349,1561,2689,4,12365,686,0,2,19,19,0
39055,76,4022,1457,730,1242,11,6,188,1468,10,292,166,329,302,495,2424,4078,5,22973,1276,1,2,16,16,0
39056,38,2278,652,304,544,16,6,88,668,6,89,51,101,95,152,591,998,3,3399,188,0,2,4,4,0
39057,62,2870,1455,414,1257,16,76,112,1471,5,41,23,46,46,69,231,381,2,1069,59,0,2,9,9,0
39058,82,4156,1523,757,1297,19,12,193,1542,12,193,117,230,205,347,1508,2664,7,19053,1058,0,2,6,6,0
39059,66,2759,1020,354,843,12,15,144,1032,8,134,77,144,142,221,970,1580,4,6792,377,0,2,15,15,0
39060,37,1616,447,308,343,6,5,95,453,7,96,59,111,103,170,651,1136,4,4600,255,0,2,4,4,0
39061,21,653,424,94,331,4,0,89,428,1,5,5,5,6,10,11,25,0,12,0,0,2,5,5,0
39062,40,2355,334,251,279,10,4,40,344,5,127,74,143,132,217,899,1528,2,4303,239,0,2,2,2,0
39063,12,484,184,100,137,2,15,30,186,6,38,20,39,44,59,214,322,3,991,55,0,2,3,3,0
39064,34,1565,1293,570,1093,25,15,163,1318,10,195,123,241,205,364,1516,2795,6,17273,959,0,2,3,3,0
39065,36,1970,384,251,317,7,8,52,391,11,70,44,84,81,128,467,811,6,5355,297,0,2,10,10,0
39066,15,630,722,423,573,19,0,135,741,12,172,101,199,184,300,1320,2257,6,15668,870,0,2,3,3,0
39067,16,1201,215,129,180,6,0,29,221,8,65,43,72,73,115,415,711,4,3153,175,0,2,1,1,0
39068,69,2852,1043,504,840,53,9,147,1096,9,180,112,198,189,310,1377,2344,4,11604,644,0,2,9,9,0
39069,14,520,295,56,236,0,4,54,295,2,9,5,10,11,15,30,51,1,57,3,0,2,8,8,0
39070,25,1019,373,158,315,8,0,51,381,5,76,44,79,81,123,486,779,2,2026,112,0,2,6,6,0
39071,68,2947,1178,367,1042,6,15,115,1184,9,94,51,95,103,146,644,976,4,4439,246,0,2,10,10,0
39072,72,3682,1943,715,1694,26,18,214,1969,12,185,120,237,197,357,1436,2721,7,20915,1161,0,2,13,13,0
39073,14,817,442,244,305,14,16,103,456,11,68,45,75,79,120,452,756,6,4588,254,0,2,2,2,0
39074,48,1776,1098,241,925,5,10,155,1103,7,46,25,49,53,74,273,423,3,1580,87,0,2,2,2,0
39076,49,573,647,139,84,35,284,233,682,0,0,0,0,0,0,0,0,0,0,0,0,2,8,1,0
39077,49,573,647,139,84,35,284,233,682,0,0,0,0,0,0,0,0,0,0,0,0,2,9,2,0
39085,28,548,2,2,2,0,0,0,2,0,0,0,0,0,0,0,0,0,0,0,0,2,2,2,0
39099,28,548,99,48,90,1,3,5,100,0,0,0,0,0,0,0,0,0,0,0,0,2,2,2,0
39100,28,548,8,5,5,2,0,1,10,0,0,0,0,0,0,0,0,0,0,0,0,2,2,2,0
39101,28,548,1217,716,841,84,126,174,1301,14,185,118,215,199,333,1446,2542,8,20687,1149,0,2,2,2,0
39102,28,548,160,89,115,0,13,31,160,7,15,11,17,22,28,78,124,3,495,27,0,2,2,2,0
39103,28,548,10,10,9,9,0,0,19,0,0,0,0,0,0,0,0,0,0,0,0,2,2,2,0
39104,28,548,173,84,99,8,29,36,181,5,12,7,13,17,20,54,81,2,221,12,0,2,2,2,0
39105,28,548,3,1,1,3,0,0,6,0,0,0,0,0,0,0,0,0,0,0,0,2,2,2,0
39106,162,5067,1660,832,1314,41,38,274,1701,20,312,209,395,332,604,2671,5058,12,64042,3557,1,2,10,6,0
39107,162,5067,1057,646,719,113,100,145,1170,18,215,134,248,233,382,1740,3004,10,31186,1732,1,2,10,6,0
39112,48,948,207,111,150,11,0,50,218,5,26,19,36,31,55,133,272,3,943,52,0,2,29,8,0
39113,48,948,410,198,237,31,55,97,441,11,63,38,72,74,110,414,683,6,4293,238,0,2,29,8,0
39114,346,7005,1457,730,1242,11,6,188,1468,10,292,166,329,302,495,2424,4078,5,22973,1276,1,2,87,33,0
39115,346,7005,74,35,59,1,0,14,75,3,14,7,14,17,21,58,85,1,128,7,0,2,87,33,0
39116,346,7005,245,125,200,5,7,34,250,7,30,17,34,37,51,166,265,3,1053,58,0,2,87,33,0
39127,178,4160,77,34,69,0,0,8,77,3,24,16,29,27,45,114,213,1,387,21,0,2,49,40,0
39128,178,4160,712,438,573,51,9,84,763,14,102,71,128,116,199,733,1364,8,11988,666,0,2,49,40,0
39130,46,951,447,308,343,6,5,95,453,7,96,59,111,103,170,651,1136,4,4600,255,0,2,5,5,0
39131,46,951,322,174,179,16,74,51,338,10,41,26,46,51,72,252,408,5,2291,127,0,2,5,5,0
39132,223,5060,722,423,573,19,0,135,741,12,172,101,199,184,300,1320,2257,6,15668,870,0,2,18,16,0
39133,223,5060,1508,847,911,44,250,301,1552,14,148,88,169,162,257,1120,1886,7,15077,837,0,2,18,16,0
39134,337,7189,72,33,56,0,4,12,72,1,1,1,1,2,2,0,2,0,1,0,0,2,38,17,0
39135,337,7189,1454,835,1044,76,110,219,1530,17,275,158,296,292,454,2297,3718,9,34017,1889,1,2,38,17,0
39136,41,943,386,256,301,16,9,68,402,4,59,35,69,63,104,355,621,2,1453,80,0,2,6,2,0
39137,41,943,264,131,164,11,41,46,275,6,38,22,40,44,62,214,338,3,1068,59,0,2,6,2,0
39142,103,1959,1178,367,1042,6,15,115,1184,9,94,51,95,103,146,644,976,4,4439,246,0,2,2,2,0
39143,103,1959,177,108,140,8,0,27,185,6,30,16,32,36,48,162,248,3,794,44,0,2,2,2,0
39170,14,472,42,7,35,4,0,5,46,1,2,1,2,3,3,2,4,0,2,0,0,2,2,3,0
39171,14,472,11,6,10,0,0,1,11,2,4,2,4,6,6,10,15,1,15,0,0,2,2,3,0
39177,47,2498,520,294,400,33,13,81,553,10,261,204,367,271,571,2128,4614,7,32445,1802,1,2,34,8,0
39183,109,5462,1782,648,1425,9,47,279,1791,8,171,97,189,179,286,1292,2140,4,9462,525,0,2,88,25,0
39184,20,541,256,139,192,9,7,47,265,4,23,12,24,27,36,112,171,2,357,19,0,2,17,2,0
39186,107,4030,1450,624,1228,12,26,181,1462,14,306,186,354,320,540,2580,4493,8,36391,2021,1,2,25,8,0
39187,148,4080,1660,832,1314,41,38,274,1701,20,312,209,395,332,604,2671,5058,12,64042,3557,1,2,62,5,0
39189,59,3302,1296,573,1062,40,33,157,1336,8,201,118,231,209,349,1561,2689,4,12365,686,0,2,34,18,0
39190,10,228,207,111,150,11,0,50,218,5,26,19,36,31,55,133,272,3,943,52,0,0,75,0,0
39191,76,4022,1457,730,1242,11,6,188,1468,10,292,166,329,302,495,2424,4078,5,22973,1276,1,2,72,17,0
39192,38,2278,652,304,544,16,6,88,668,6,89,51,101,95,152,591,998,3,3399,188,0,2,29,4,0
39193,62,2870,1455,414,1257,16,76,112,1471,5,41,23,46,46,69,231,381,2,1069,59,0,2,41,12,0
39194,82,4156,1523,757,1297,19,12,193,1542,12,193,117,230,205,347,1508,2664,7,19053,1058,0,2,22,6,0
39196,37,1616,447,308,343,6,5,95,453,7,96,59,111,103,170,651,1136,4,4600,255,0,2,8,14,0
39201,36,1970,384,251,317,7,8,52,391,11,70,44,84,81,128,467,811,6,5355,297,0,2,31,11,0
39202,15,630,722,423,573,19,0,135,741,12,172,101,199,184,300,1320,2257,6,15668,870,0,2,10,3,0
39203,31,1490,386,256,301,16,9,68,402,4,59,35,69,63,104,355,621,2,1453,80,0,2,50,6,0
39212,14,367,601,196,481,2,23,85,603,8,63,36,72,71,108,400,664,4,3036,168,0,2,5,23,1
39213,14,367,156,79,106,5,16,28,161,5,14,8,15,19,23,64,97,2,261,14,0,2,5,23,1
39214,8,213,601,196,481,2,23,85,603,8,63,36,72,71,108,400,664,4,3036,168,0,2,3,3,1
39215,71,2109,1523,757,1297,19,12,193,1542,12,193,117,230,205,347,1508,2664,7,19053,1058,0,2,4,5,0
39216,71,2109,701,378,504,33,58,109,734,13,110,68,126,123,194,794,1346,7,10027,557,0,2,4,5,0
39217,82,4086,1523,757,1297,19,12,193,1542,12,193,117,230,205,347,1508,2664,7,19053,1058,0,2,19,0,0
39221,119,2420,1513,682,1277,25,13,200,1538,11,199,116,219,210,335,1557,2584,6,15641,868,0,2,2,2,1
39222,119,2420,819,519,539,24,98,155,843,15,96,57,106,111,163,690,1107,8,9171,509,0,2,2,2,1
39223,50,1024,207,111,150,11,0,50,218,5,26,19,36,31,55,133,272,3,943,52,0,2,16,0,1
39224,50,1024,410,198,237,31,55,97,441,11,63,38,72,74,110,414,683,6,4293,238,0,2,16,0,1
39225,117,4639,1513,682,1277,25,13,200,1538,11,199,116,219,210,335,1557,2584,6,15641,868,0,2,18,6,1
39226,223,5077,722,423,573,19,0,135,741,12,172,101,199,184,300,1320,2257,6,15668,870,0,2,5,2,0
39227,223,5077,1508,847,911,44,250,301,1552,14,148,88,169,162,257,1120,1886,7,15077,837,0,2,5,2,0
39228,119,2420,1513,682,1277,25,13,200,1538,11,199,116,219,210,335,1557,2584,6,15641,868,0,2,2,2,0
39229,119,2420,819,519,539,24,98,155,843,15,96,57,106,111,163,690,1107,8,9171,509,0,2,2,2,0
39230,50,1024,207,111,150,11,0,50,218,5,26,19,36,31,55,133,272,3,943,52,0,2,16,0,0
39231,50,1024,410,198,237,31,55,97,441,11,63,38,72,74,110,414,683,6,4293,238,0,2,16,0,0
39234,117,4639,1513,682,1277,25,13,200,1538,11,199,116,219,210,335,1557,2584,6,15641,868,0,2,18,6,0
39240,49,573,647,139,84,35,284,233,682,0,0,0,0,0,0,0,0,0,0,0,0,2,10,3,0
39246,222,4989,722,423,573,19,0,135,741,12,172,101,199,184,300,1320,2257,6,15668,870,0,2,4,4,0
39247,222,4989,1508,847,911,44,250,301,1552,14,148,88,169,162,257,1120,1886,7,15077,837,0,2,4,4,0
39262,83,2325,1523,757,1297,19,12,193,1542,12,193,117,230,205,347,1508,2664,7,19053,1058,0,2,36,2,1
39263,83,2325,701,378,504,33,58,109,734,13,110,68,126,123,194,794,1346,7,10027,557,0,2,36,2,1
39264,86,4261,1523,757,1297,19,12,193,1542,12,193,117,230,205,347,1508,2664,7,19053,1058,0,2,23,0,1
39265,83,2325,1523,757,1297,19,12,193,1542,12,193,117,230,205,347,1508,2664,7,19053,1058,0,2,36,2,0
39266,83,2325,701,378,504,33,58,109,734,13,110,68,126,123,194,794,1346,7,10027,557,0,2,36,2,0
39267,86,4261,1523,757,1297,19,12,193,1542,12,193,117,230,205,347,1508,2664,7,19053,1058,0,2,23,0,0
39268,211,4515,182,127,129,0,0,53,182,5,39,21,42,44,63,217,343,2,926,51,0,2,4,2,1
39269,211,4515,1165,710,800,67,119,181,1232,18,243,153,282,261,435,2000,3492,10,36473,2026,1,2,4,2,1
39270,95,3480,1450,624,1228,12,26,181,1462,14,306,186,354,320,540,2580,4493,8,36391,2021,1,2,19,0,1
39271,211,4515,182,127,129,0,0,53,182,5,39,21,42,44,63,217,343,2,926,51,0,2,4,2,0
39272,211,4515,1165,710,800,67,119,181,1232,18,243,153,282,261,435,2000,3492,10,36473,2026,1,2,4,2,0
39273,95,3480,1450,624,1228,12,26,181,1462,14,306,186,354,320,540,2580,4493,8,36391,2021,1,2,19,0,0
39274,185,3749,1943,715,1694,26,18,214,1969,12,185,120,237,197,357,1436,2721,7,20915,1161,0,2,12,10,1
39275,185,3749,1168,838,957,57,25,144,1225,19,348,224,416,367,640,3018,5452,11,61921,3440,1,2,12,10,1
39276,13,319,601,196,481,2,23,85,603,8,63,36,72,71,108,400,664,4,3036,168,0,2,2,8,1
39277,13,319,156,79,106,5,16,28,161,5,14,8,15,19,23,64,97,2,261,14,0,2,2,8,1
39278,8,214,601,196,481,2,23,85,603,8,63,36,72,71,108,400,664,4,3036,168,0,2,7,7,1
39279,16,383,601,196,481,2,23,85,603,8,63,36,72,71,108,400,664,4,3036,168,0,2,29,3,1
39280,16,383,156,79,106,5,16,28,161,5,14,8,15,19,23,64,97,2,261,14,0,2,29,3,1
39281,9,258,601,196,481,2,23,85,603,8,63,36,72,71,108,400,664,4,3036,168,0,2,28,0,1
39282,185,3749,1943,715,1694,26,18,214,1969,12,185,120,237,197,357,1436,2721,7,20915,1161,0,2,3,3,0
39283,185,3749,1168,838,957,57,25,144,1225,19,348,224,416,367,640,3018,5452,11,61921,3440,1,2,3,3,0
39284,185,3775,1943,715,1694,26,18,214,1969,12,185,120,237,197,357,1436,2721,7,20915,1161,0,2,12,10,1
39285,185,3775,1168,838,957,57,25,144,1225,19,348,224,416,367,640,3018,5452,11,61921,3440,1,2,12,10,1
39286,16,377,601,196,481,2,23,85,603,8,63,36,72,71,108,400,664,4,3036,168,0,2,1,1,1
39287,16,377,156,79,106,5,16,28,161,5,14,8,15,19,23,64,97,2,261,14,0,2,1,1,1
39288,9,317,601,196,481,2,23,85,603,8,63,36,72,71,108,400,664,4,3036,168,0,2,31,10,1
39289,184,3743,1943,715,1694,26,18,214,1969,12,185,120,237,197,357,1436,2721,7,20915,1161,0,2,2,2,0
39290,184,3743,1168,838,957,57,25,144,1225,19,348,224,416,367,640,3018,5452,11,61921,3440,1,2,2,2,0
39291,78,4037,1457,730,1242,11,6,188,1468,10,292,166,329,302,495,2424,4078,5,22973,1276,1,2,1,1,0
39292,73,3706,1943,715,1694,26,18,214,1969,12,185,120,237,197,357,1436,2721,7,20915,1161,0,2,9,0,0
39303,346,7009,1457,730,1242,11,6,188,1468,10,292,166,329,302,495,2424,4078,5,22973,1276,1,2,10,9,0
39304,346,7009,74,35,59,1,0,14,75,3,14,7,14,17,21,58,85,1,128,7,0,2,10,9,0
39305,346,7009,245,125,200,5,7,34,250,7,30,17,34,37,51,166,265,3,1053,58,0,2,10,9,0
39306,227,5117,4293,999,3693,19,54,507,4312,9,155,88,170,164,258,1156,1898,4,9368,520,0,2,4,3,0
39307,227,5117,1482,859,1002,125,135,219,1607,16,219,134,251,235,385,1766,3032,9,27804,1544,1,2,4,3,0
39308,49,575,647,139,84,35,284,233,682,0,0,0,0,0,0,0,0,0,0,0,0,2,10,3,0
39309,83,2321,1523,757,1297,19,12,193,1542,12,193,117,230,205,347,1508,2664,7,19053,1058,0,2,4,5,0
39310,83,2321,701,378,504,33,58,109,734,13,110,68,126,123,194,794,1346,7,10027,557,0,2,4,5,0
39313,69,1359,1020,354,843,12,15,144,1032,8,134,77,144,142,221,970,1580,4,6792,377,0,2,1,1,0
39314,223,5078,722,423,573,19,0,135,741,12,172,101,199,184,300,1320,2257,6,15668,870,0,2,4,4,0
39315,223,5078,1508,847,911,44,250,301,1552,14,148,88,169,162,257,1120,1886,7,15077,837,0,2,4,4,0
39316,337,7188,72,33,56,0,4,12,72,1,1,1,1,2,2,0,2,0,1,0,0,2,2,2,0
39317,337,7188,1454,835,1044,76,110,219,1530,17,275,158,296,292,454,2297,3718,9,34017,1889,1,2,2,2,0
39318,104,1969,1178,367,1042,6,15,115,1184,9,94,51,95,103,146,644,976,4,4439,246,0,2,3,2,0
39319,104,1969,177,108,140,8,0,27,185,6,30,16,32,36,48,162,248,3,794,44,0,2,3,2,0
39320,184,3749,1943,715,1694,26,18,214,1969,12,185,120,237,197,357,1436,2721,7,20915,1161,0,2,2,2,0
39321,184,3749,1168,838,957,57,25,144,1225,19,348,224,416,367,640,3018,5452,11,61921,3440,1,2,2,2,0
39322,16,472,442,244,305,14,16,103,456,11,68,45,75,79,120,452,756,6,4588,254,0,2,1,1,0
39323,16,472,182,102,99,11,40,35,193,3,11,6,11,14,17,42,64,1,97,5,0,2,1,1,0
39324,62,1244,1098,241,925,5,10,155,1103,7,46,25,49,53,74,273,423,3,1580,87,0,2,21,3,0
39325,62,1244,282,202,222,14,2,44,296,8,42,24,43,50,67,250,378,4,1548,86,0,2,21,3,0
39326,94,4280,1338,495,1086,10,64,173,1348,11,122,82,157,133,239,883,1686,7,11934,663,0,2,10,0,0
39327,109,4093,1450,624,1228,12,26,181,1462,14,306,186,354,320,540,2580,4493,8,36391,2021,1,2,20,1,0
39328,148,4080,1660,832,1314,41,38,274,1701,20,312,209,395,332,604,2671,5058,12,64042,3557,1,2,1,1,0
39329,117,4639,1513,682,1277,25,13,200,1538,11,199,116,219,210,335,1557,2584,6,15641,868,0,2,1,1,0
39330,78,4085,1457,730,1242,11,6,188,1468,10,292,166,329,302,495,2424,4078,5,22973,1276,1,2,16,1,0
39331,87,4323,1523,757,1297,19,12,193,1542,12,193,117,230,205,347,1508,2664,7,19053,1058,0,2,19,0,0
39332,35,1615,1293,570,1093,25,15,163,1318,10,195,123,241,205,364,1516,2795,6,17273,959,0,2,15,0,0
39333,25,1019,373,158,315,8,0,51,381,5,76,44,79,81,123,486,779,2,2026,112,0,2,1,1,0
39334,71,2998,1178,367,1042,6,15,115,1184,9,94,51,95,103,146,644,976,4,4439,246,0,2,23,0,0
39335,73,3730,1943,715,1694,26,18,214,1969,12,185,120,237,197,357,1436,2721,7,20915,1161,0,2,9,0,0
39375,39,808,386,256,301,16,9,68,402,4,59,35,69,63,104,355,621,2,1453,80,0,2,9,33,1
39376,39,808,264,131,164,11,41,46,275,6,38,22,40,44,62,214,338,3,1068,59,0,2,9,33,1
39377,31,1462,386,256,301,16,9,68,402,4,59,35,69,63,104,355,621,2,1453,80,0,2,0,4,1
39401,31,1431,386,256,301,16,9,68,402,4,59,35,69,63,104,355,621,2,1453,80,0,2,2,10,1
39450,116,4567,1513,682,1277,25,13,200,1538,11,199,116,219,210,335,1557,2584,6,15641,868,0,2,2,1,0
39454,39,808,386,256,301,16,9,68,402,4,59,35,69,63,104,355,621,2,1453,80,0,2,9,33,0
39455,39,808,264,131,164,11,41,46,275,6,38,22,40,44,62,214,338,3,1068,59,0,2,9,33,0
39456,31,1431,386,256,301,16,9,68,402,4,59,35,69,63,104,355,621,2,1453,80,0,2,2,14,0
39458,107,4030,1450,624,1228,12,26,181,1462,14,306,186,354,320,540,2580,4493,8,36391,2021,1,2,1,1,1
39459,76,4022,1457,730,1242,11,6,188,1468,10,292,166,329,302,495,2424,4078,5,22973,1276,1,2,4,3,1
39460,82,4161,1523,757,1297,19,12,193,1542,12,193,117,230,205,347,1508,2664,7,19053,1058,0,2,5,2,1
39461,36,1970,384,251,317,7,8,52,391,11,70,44,84,81,128,467,811,6,5355,297,0,2,2,2,1
39462,72,3682,1943,715,1694,26,18,214,1969,12,185,120,237,197,357,1436,2721,7,20915,1161,0,2,8,8,1
39463,9,317,601,196,481,2,23,85,603,8,63,36,72,71,108,400,664,4,3036,168,0,2,0,1,1
39480,83,2321,1523,757,1297,19,12,193,1542,12,193,117,230,205,347,1508,2664,7,19053,1058,0,2,40,7,0
39481,83,2321,701,378,504,33,58,109,734,13,110,68,126,123,194,794,1346,7,10027,557,0,2,40,7,0
39485,223,5078,722,423,573,19,0,135,741,12,172,101,199,184,300,1320,2257,6,15668,870,0,2,9,6,0
39486,223,5078,1508,847,911,44,250,301,1552,14,148,88,169,162,257,1120,1886,7,15077,837,0,2,9,6,0
39493,185,3777,1943,715,1694,26,18,214,1969,12,185,120,237,197,357,1436,2721,7,20915,1161,0,2,2,2,0
39494,185,3777,1168,838,957,57,25,144,1225,19,348,224,416,367,640,3018,5452,11,61921,3440,1,2,2,2,0
39502,117,4639,1513,682,1277,25,13,200,1538,11,199,116,219,210,335,1557,2584,6,15641,868,0,2,19,7,0
39504,87,4328,1523,757,1297,19,12,193,1542,12,193,117,230,205,347,1508,2664,7,19053,1058,0,2,42,0,0
39510,39,784,386,256,301,16,9,68,402,4,59,35,69,63,104,355,621,2,1453,80,0,2,0,2,0
39511,39,784,264,131,164,11,41,46,275,6,38,22,40,44,62,214,338,3,1068,59,0,2,0,2,0
39512,14,331,601,196,481,2,23,85,603,8,63,36,72,71,108,400,664,4,3036,168,0,2,7,21,0
39513,14,331,156,79,106,5,16,28,161,5,14,8,15,19,23,64,97,2,261,14,0,2,7,21,0
39514,31,1431,386,256,301,16,9,68,402,4,59,35,69,63,104,355,621,2,1453,80,0,2,3,1,0
39515,346,7013,1457,730,1242,11,6,188,1468,10,292,166,329,302,495,2424,4078,5,22973,1276,1,2,2,2,1
39516,346,7013,74,35,59,1,0,14,75,3,14,7,14,17,21,58,85,1,128,7,0,2,2,2,1
39517,346,7013,245,125,200,5,7,34,250,7,30,17,34,37,51,166,265,3,1053,58,0,2,2,2,1
39518,227,5121,4293,999,3693,19,54,507,4312,9,155,88,170,164,258,1156,1898,4,9368,520,0,2,1,1,1
39519,227,5121,1482,859,1002,125,135,219,1607,16,219,134,251,235,385,1766,3032,9,27804,1544,1,2,1,1,1
39520,191,3884,1943,715,1694,26,18,214,1969,12,185,120,237,197,357,1436,2721,7,20915,1161,0,2,36,7,1
39521,191,3884,1168,838,957,57,25,144,1225,19,348,224,416,367,640,3018,5452,11,61921,3440,1,2,36,7,1
39523,94,4283,1338,495,1086,10,64,173,1348,11,122,82,157,133,239,883,1686,7,11934,663,0,2,5,5,1
39524,109,4098,1450,624,1228,12,26,181,1462,14,306,186,354,320,540,2580,4493,8,36391,2021,1,2,4,1,1
39525,78,4085,1457,730,1242,11,6,188,1468,10,292,166,329,302,495,2424,4078,5,22973,1276,1,2,1,1,1
39526,87,4328,1523,757,1297,19,12,193,1542,12,193,117,230,205,347,1508,2664,7,19053,1058,0,2,1,1,1
39527,9,317,601,196,481,2,23,85,603,8,63,36,72,71,108,400,664,4,3036,168,0,2,4,4,1
39528,9,231,19,8,11,5,0,4,24,2,5,3,6,7,9,13,25,1,30,1,0,2,1,1,1
39529,9,231,102,59,69,5,3,24,107,6,22,15,28,28,43,113,206,3,789,43,0,2,1,1,1
39530,9,231,106,40,36,3,49,17,109,8,17,13,23,25,36,93,167,5,904,50,0,2,1,1,1
39554,211,4523,182,127,129,0,0,53,182,5,39,21,42,44,63,217,343,2,926,51,0,2,1,0,1
39555,211,4523,1165,710,800,67,119,181,1232,18,243,153,282,261,435,2000,3492,10,36473,2026,1,2,1,0,1
39556,99,2081,773,419,590,28,0,166,801,10,204,113,217,214,330,1598,2554,5,13587,754,0,2,1,1,1
39557,99,2081,421,273,302,44,34,57,465,17,81,59,107,98,166,583,1098,11,12329,684,0,2,1,1,1
39560,28,556,2,2,2,0,0,0,2,0,0,0,0,0,0,0,0,0,0,0,0,2,1,0,1
39574,28,556,99,48,90,1,3,5,100,0,0,0,0,0,0,0,0,0,0,0,0,2,1,0,1
39575,28,556,8,5,5,2,0,1,10,0,0,0,0,0,0,0,0,0,0,0,0,2,1,0,1
39576,28,556,1217,716,841,84,126,174,1301,14,185,118,215,199,333,1446,2542,8,20687,1149,0,2,1,0,1
39577,28,556,160,89,115,0,13,31,160,7,15,11,17,22,28,78,124,3,495,27,0,2,1,0,1
39578,28,556,10,10,9,9,0,0,19,0,0,0,0,0,0,0,0,0,0,0,0,2,1,0,1
39579,28,556,173,84,99,8,29,36,181,5,12,7,13,17,20,54,81,2,221,12,0,2,1,0,1
39580,28,556,3,1,1,3,0,0,6,0,0,0,0,0,0,0,0,0,0,0,0,2,1,0,1
39581,163,5082,1660,832,1314,41,38,274,1701,20,312,209,395,332,604,2671,5058,12,64042,3557,1,2,1,1,1
39582,163,5082,1057,646,719,113,100,145,1170,18,215,134,248,233,382,1740,3004,10,31186,1732,1,2,1,1,1
39583,17,349,95,58,50,9,16,20,104,12,33,24,45,45,69,209,378,8,3100,172,0,2,1,1,1
39584,82,1800,477,336,357,30,23,73,507,16,194,134,250,210,384,1538,2962,10,30538,1696,0,2,1,0,1
39585,60,1262,996,429,845,24,10,117,1020,7,76,50,88,83,138,494,879,4,3565,198,0,2,1,1,1
39586,60,1262,456,277,329,12,42,72,468,13,85,50,97,98,147,592,972,7,7212,400,0,2,1,1,1
39587,119,2424,1513,682,1277,25,13,200,1538,11,199,116,219,210,335,1557,2584,6,15641,868,0,2,1,1,1
39588,119,2424,819,519,539,24,98,155,843,15,96,57,106,111,163,690,1107,8,9171,509,0,2,1,1,1
39589,50,1032,207,111,150,11,0,50,218,5,26,19,36,31,55,133,272,3,943,52,0,2,1,0,1
39590,50,1032,410,198,237,31,55,97,441,11,63,38,72,74,110,414,683,6,4293,238,0,2,1,0,1
39591,346,7017,1457,730,1242,11,6,188,1468,10,292,166,329,302,495,2424,4078,5,22973,1276,1,2,1,0,1
39592,346,7017,74,35,59,1,0,14,75,3,14,7,14,17,21,58,85,1,128,7,0,2,1,0,1
39593,346,7017,245,125,200,5,7,34,250,7,30,17,34,37,51,166,265,3,1053,58,0,2,1,0,1
39594,22,683,339,213,244,17,9,65,356,10,42,26,48,52,74,259,421,5,2410,133,0,2,1,1,1
39596,56,1603,1455,414,1257,16,76,112,1471,5,41,23,46,46,69,231,381,2,1069,59,0,2,1,1,1
39597,56,1603,669,365,481,22,61,110,691,15,103,63,122,118,185,747,1273,8,11311,628,0,2,1,1,1
39598,227,5125,4293,999,3693,19,54,507,4312,9,155,88,170,164,258,1156,1898,4,9368,520,0,2,1,0,1
39599,227,5125,1482,859,1002,125,135,219,1607,16,219,134,251,235,385,1766,3032,9,27804,1544,1,2,1,0,1
39600,7,147,44,22,19,0,19,6,44,2,10,6,12,12,18,35,64,1,77,4,0,2,3,1,1
39601,24,842,74,35,59,1,0,14,75,3,14,7,14,17,21,58,85,1,128,7,0,2,2,0,1
39602,24,842,245,125,200,5,7,34,250,7,30,17,34,37,51,166,265,3,1053,58,0,2,2,0,1
39603,83,2329,1523,757,1297,19,12,193,1542,12,193,117,230,205,347,1508,2664,7,19053,1058,0,2,4,2,1
39604,83,2329,701,378,504,33,58,109,734,13,110,68,126,123,194,794,1346,7,10027,557,0,2,4,2,1
39605,178,4168,77,34,69,0,0,8,77,3,24,16,29,27,45,114,213,1,387,21,0,2,2,0,1
39606,178,4168,712,438,573,51,9,84,763,14,102,71,128,116,199,733,1364,8,11988,666,0,2,2,0,1
39607,69,1367,1020,354,843,12,15,144,1032,8,134,77,144,142,221,970,1580,4,6792,377,0,2,2,0,1
39608,46,959,447,308,343,6,5,95,453,7,96,59,111,103,170,651,1136,4,4600,255,0,2,1,0,1
39609,46,959,322,174,179,16,74,51,338,10,41,26,46,51,72,252,408,5,2291,127,0,2,1,0,1
39610,23,382,424,94,331,4,0,89,428,1,5,5,5,6,10,11,25,0,12,0,0,2,1,0,1
39611,23,382,38,23,23,6,0,8,44,3,11,7,11,14,18,42,68,1,102,5,0,2,1,0,1
39612,17,518,184,100,137,2,15,30,186,6,38,20,39,44,59,214,322,3,991,55,0,2,2,0,1
39613,17,518,103,65,74,8,5,16,111,7,17,9,17,24,26,89,119,3,417,23,0,2,2,0,1
39614,223,5086,722,423,573,19,0,135,741,12,172,101,199,184,300,1320,2257,6,15668,870,0,2,2,0,1
39615,223,5086,1508,847,911,44,250,301,1552,14,148,88,169,162,257,1120,1886,7,15077,837,0,2,2,0,1
39616,337,7196,72,33,56,0,4,12,72,1,1,1,1,2,2,0,2,0,1,0,0,2,1,0,1
39617,337,7196,1454,835,1044,76,110,219,1530,17,275,158,296,292,454,2297,3718,9,34017,1889,1,2,1,0,1
39618,39,816,386,256,301,16,9,68,402,4,59,35,69,63,104,355,621,2,1453,80,0,2,2,0,1
39619,39,816,264,131,164,11,41,46,275,6,38,22,40,44,62,214,338,3,1068,59,0,2,2,0,1
39620,30,657,215,129,180,6,0,29,221,8,65,43,72,73,115,415,711,4,3153,175,0,2,1,0,1
39621,30,657,97,69,77,3,3,16,100,6,22,13,23,28,36,113,173,3,542,30,0,2,1,0,1
39622,128,2826,1043,504,840,53,9,147,1096,9,180,112,198,189,310,1377,2344,4,11604,644,0,2,2,0,1
39623,128,2826,383,288,292,26,6,62,409,11,65,38,67,76,105,429,656,5,3719,206,0,2,2,0,1
39624,20,408,294,64,250,0,0,43,294,1,20,10,20,21,30,86,131,0,65,3,0,2,2,0,1
39625,20,408,78,46,62,3,0,14,81,3,8,4,8,11,12,28,41,1,62,3,0,2,2,0,1
39626,5,118,110,30,77,3,13,16,113,4,21,15,30,25,45,100,208,2,597,33,0,2,2,0,1
39627,5,118,28,15,21,1,0,6,29,0,0,0,0,0,0,0,0,0,0,0,0,2,2,0,1
39628,104,1977,1178,367,1042,6,15,115,1184,9,94,51,95,103,146,644,976,4,4439,246,0,2,2,0,1
39629,104,1977,177,108,140,8,0,27,185,6,30,16,32,36,48,162,248,3,794,44,0,2,2,0,1
39630,184,3757,1943,715,1694,26,18,214,1969,12,185,120,237,197,357,1436,2721,7,20915,1161,0,2,2,0,1
39631,184,3757,1168,838,957,57,25,144,1225,19,348,224,416,367,640,3018,5452,11,61921,3440,1,2,2,0,1
39632,16,480,442,244,305,14,16,103,456,11,68,45,75,79,120,452,756,6,4588,254,0,2,2,0,1
39633,16,480,182,102,99,11,40,35,193,3,11,6,11,14,17,42,64,1,97,5,0,2,2,0,1
39634,62,1248,1098,241,925,5,10,155,1103,7,46,25,49,53,74,273,423,3,1580,87,0,2,1,1,1
39635,62,1248,282,202,222,14,2,44,296,8,42,24,43,50,67,250,378,4,1548,86,0,2,1,1,1
39636,78,3314,1289,550,1043,56,32,155,1345,10,167,93,185,177,278,1266,2075,5,11498,638,0,2,1,0,1
39637,34,997,182,127,129,0,0,53,182,5,39,21,42,44,63,217,343,2,926,51,0,2,1,0,1
39638,137,6600,1392,870,1177,35,17,170,1427,14,494,280,531,508,811,4473,7289,7,54850,3047,2,2,1,0,1
39639,91,3011,773,419,590,28,0,166,801,10,204,113,217,214,330,1598,2554,5,13587,754,0,2,1,0,1
39640,7,263,75,38,59,1,3,12,76,2,4,2,4,6,6,10,15,1,15,0,0,2,1,0,1
39641,23,601,102,59,69,5,3,24,107,6,22,15,28,28,43,113,206,3,789,43,0,2,1,1,1
39642,109,4101,1450,624,1228,12,26,181,1462,14,306,186,354,320,540,2580,4493,8,36391,2021,1,2,1,0,1
39643,148,4088,1660,832,1314,41,38,274,1701,20,312,209,395,332,604,2671,5058,12,64042,3557,1,2,1,0,1
39644,117,4647,1513,682,1277,25,13,200,1538,11,199,116,219,210,335,1557,2584,6,15641,868,0,2,1,0,1
39645,59,3310,1296,573,1062,40,33,157,1336,8,201,118,231,209,349,1561,2689,4,12365,686,0,2,1,0,1
39646,10,236,207,111,150,11,0,50,218,5,26,19,36,31,55,133,272,3,943,52,0,2,1,0,1
39647,78,4093,1457,730,1242,11,6,188,1468,10,292,166,329,302,495,2424,4078,5,22973,1276,1,2,1,0,1
39648,38,2286,652,304,544,16,6,88,668,6,89,51,101,95,152,591,998,3,3399,188,0,2,1,0,1
39649,62,2878,1455,414,1257,16,76,112,1471,5,41,23,46,46,69,231,381,2,1069,59,0,2,1,0,1
39650,2,75,7,6,5,0,0,2,7,1,1,1,2,2,3,0,3,1,3,0,0,2,1,0,1
39651,8,273,74,35,59,1,0,14,75,3,14,7,14,17,21,58,85,1,128,7,0,2,1,0,1
39652,87,4331,1523,757,1297,19,12,193,1542,12,193,117,230,205,347,1508,2664,7,19053,1058,0,2,2,2,1
39653,66,2767,1020,354,843,12,15,144,1032,8,134,77,144,142,221,970,1580,4,6792,377,0,2,1,0,1
39654,37,1624,447,308,343,6,5,95,453,7,96,59,111,103,170,651,1136,4,4600,255,0,2,1,0,1
39655,21,661,424,94,331,4,0,89,428,1,5,5,5,6,10,11,25,0,12,0,0,2,1,0,1
39656,40,2359,334,251,279,10,4,40,344,5,127,74,143,132,217,899,1528,2,4303,239,0,2,1,1,1
39657,12,492,184,100,137,2,15,30,186,6,38,20,39,44,59,214,322,3,991,55,0,2,1,0,1
39658,35,1623,1293,570,1093,25,15,163,1318,10,195,123,241,205,364,1516,2795,6,17273,959,0,2,1,0,1
39659,36,1978,384,251,317,7,8,52,391,11,70,44,84,81,128,467,811,6,5355,297,0,2,1,0,1
39660,15,638,722,423,573,19,0,135,741,12,172,101,199,184,300,1320,2257,6,15668,870,0,2,1,0,1
39661,31,1439,386,256,301,16,9,68,402,4,59,35,69,63,104,355,621,2,1453,80,0,2,1,0,1
39662,16,1209,215,129,180,6,0,29,221,8,65,43,72,73,115,415,711,4,3153,175,0,2,1,0,1
39663,69,2856,1043,504,840,53,9,147,1096,9,180,112,198,189,310,1377,2344,4,11604,644,0,2,1,1,1
39664,14,529,295,56,236,0,4,54,295,2,9,5,10,11,15,30,51,1,57,3,0,2,5,3,1
39665,25,1027,373,158,315,8,0,51,381,5,76,44,79,81,123,486,779,2,2026,112,0,2,1,0,1
39666,71,3006,1178,367,1042,6,15,115,1184,9,94,51,95,103,146,644,976,4,4439,246,0,2,1,0,1
39667,73,3738,1943,715,1694,26,18,214,1969,12,185,120,237,197,357,1436,2721,7,20915,1161,0,2,1,0,1
39668,14,825,442,244,305,14,16,103,456,11,68,45,75,79,120,452,756,6,4588,254,0,2,1,0,1
39669,48,1784,1098,241,925,5,10,155,1103,7,46,25,49,53,74,273,423,3,1580,87,0,2,1,0,1
39670,223,5076,722,423,573,19,0,135,741,12,172,101,199,184,300,1320,2257,6,15668,870,0,2,7,9,1
39671,223,5076,1508,847,911,44,250,301,1552,14,148,88,169,162,257,1120,1886,7,15077,837,0,2,7,9,1
39672,30,649,215,129,180,6,0,29,221,8,65,43,72,73,115,415,711,4,3153,175,0,2,2,2,1
39673,30,649,97,69,77,3,3,16,100,6,22,13,23,28,36,113,173,3,542,30,0,2,2,2,1
39674,94,4280,1338,495,1086,10,64,173,1348,11,122,82,157,133,239,883,1686,7,11934,663,0,2,6,4,1
39675,117,4641,1513,682,1277,25,13,200,1538,11,199,116,219,210,335,1557,2584,6,15641,868,0,2,3,3,1
39676,66,2763,1020,354,843,12,15,144,1032,8,134,77,144,142,221,970,1580,4,6792,377,0,2,1,1,1
39677,137,6599,1392,870,1177,35,17,170,1427,14,494,280,531,508,811,4473,7289,7,54850,3047,2,2,1,1,0
39678,9,231,19,8,11,5,0,4,24,2,5,3,6,7,9,13,25,1,30,1,0,2,1,1,0
39679,9,231,102,59,69,5,3,24,107,6,22,15,28,28,43,113,206,3,789,43,0,2,1,1,0
39680,9,231,106,40,36,3,49,17,109,8,17,13,23,25,36,93,167,5,904,50,0,2,1,1,0
39704,211,4523,182,127,129,0,0,53,182,5,39,21,42,44,63,217,343,2,926,51,0,2,1,0,0
39705,211,4523,1165,710,800,67,119,181,1232,18,243,153,282,261,435,2000,3492,10,36473,2026,1,2,1,0,0
39706,99,2081,773,419,590,28,0,166,801,10,204,113,217,214,330,1598,2554,5,13587,754,0,2,1,1,0
39707,99,2081,421,273,302,44,34,57,465,17,81,59,107,98,166,583,1098,11,12329,684,0,2,1,1,0
39710,28,556,2,2,2,0,0,0,2,0,0,0,0,0,0,0,0,0,0,0,0,2,1,0,0
39724,28,556,99,48,90,1,3,5,100,0,0,0,0,0,0,0,0,0,0,0,0,2,1,0,0
39725,28,556,8,5,5,2,0,1,10,0,0,0,0,0,0,0,0,0,0,0,0,2,1,0,0
39726,28,556,1217,716,841,84,126,174,1301,14,185,118,215,199,333,1446,2542,8,20687,1149,0,2,1,0,0
39727,28,556,160,89,115,0,13,31,160,7,15,11,17,22,28,78,124,3,495,27,0,2,1,0,0
39728,28,556,10,10,9,9,0,0,19,0,0,0,0,0,0,0,0,0,0,0,0,2,1,0,0
39729,28,556,173,84,99,8,29,36,181,5,12,7,13,17,20,54,81,2,221,12,0,2,1,0,0
39730,28,556,3,1,1,3,0,0,6,0,0,0,0,0,0,0,0,0,0,0,0,2,1,0,0
39731,163,5082,1660,832,1314,41,38,274,1701,20,312,209,395,332,604,2671,5058,12,64042,3557,1,2,1,1,0
39732,163,5082,1057,646,719,113,100,145,1170,18,215,134,248,233,382,1740,3004,10,31186,1732,1,2,1,1,0
39733,17,349,95,58,50,9,16,20,104,12,33,24,45,45,69,209,378,8,3100,172,0,2,1,1,0
39734,82,1800,477,336,357,30,23,73,507,16,194,134,250,210,384,1538,2962,10,30538,1696,0,2,1,0,0
39735,60,1262,996,429,845,24,10,117,1020,7,76,50,88,83,138,494,879,4,3565,198,0,2,1,1,0
39736,60,1262,456,277,329,12,42,72,468,13,85,50,97,98,147,592,972,7,7212,400,0,2,1,1,0
39737,119,2424,1513,682,1277,25,13,200,1538,11,199,116,219,210,335,1557,2584,6,15641,868,0,2,1,1,0
39738,119,2424,819,519,539,24,98,155,843,15,96,57,106,111,163,690,1107,8,9171,509,0,2,1,1,0
39739,50,1032,207,111,150,11,0,50,218,5,26,19,36,31,55,133,272,3,943,52,0,2,1,0,0
39740,50,1032,410,198,237,31,55,97,441,11,63,38,72,74,110,414,683,6,4293,238,0,2,1,0,0
39741,346,7017,1457,730,1242,11,6,188,1468,10,292,166,329,302,495,2424,4078,5,22973,1276,1,2,1,0,0
39742,346,7017,74,35,59,1,0,14,75,3,14,7,14,17,21,58,85,1,128,7,0,2,1,0,0
39743,346,7017,245,125,200,5,7,34,250,7,30,17,34,37,51,166,265,3,1053,58,0,2,1,0,0
39744,22,683,339,213,244,17,9,65,356,10,42,26,48,52,74,259,421,5,2410,133,0,2,1,1,0
39746,56,1603,1455,414,1257,16,76,112,1471,5,41,23,46,46,69,231,381,2,1069,59,0,2,1,1,0
39747,56,1603,669,365,481,22,61,110,691,15,103,63,122,118,185,747,1273,8,11311,628,0,2,1,1,0
39748,227,5125,4293,999,3693,19,54,507,4312,9,155,88,170,164,258,1156,1898,4,9368,520,0,2,1,0,0
39749,227,5125,1482,859,1002,125,135,219,1607,16,219,134,251,235,385,1766,3032,9,27804,1544,1,2,1,0,0
39750,7,147,44,22,19,0,19,6,44,2,10,6,12,12,18,35,64,1,77,4,0,2,3,1,0
39751,24,842,74,35,59,1,0,14,75,3,14,7,14,17,21,58,85,1,128,7,0,2,2,0,0
39752,24,842,245,125,200,5,7,34,250,7,30,17,34,37,51,166,265,3,1053,58,0,2,2,0,0
39753,83,2329,1523,757,1297,19,12,193,1542,12,193,117,230,205,347,1508,2664,7,19053,1058,0,2,4,2,0
39754,83,2329,701,378,504,33,58,109,734,13,110,68,126,123,194,794,1346,7,10027,557,0,2,4,2,0
39755,178,4168,77,34,69,0,0,8,77,3,24,16,29,27,45,114,213,1,387,21,0,2,2,0,0
39756,178,4168,712,438,573,51,9,84,763,14,102,71,128,116,199,733,1364,8,11988,666,0,2,2,0,0
39757,69,1367,1020,354,843,12,15,144,1032,8,134,77,144,142,221,970,1580,4,6792,377,0,2,2,0,0
39758,46,959,447,308,343,6,5,95,453,7,96,59,111,103,170,651,1136,4,4600,255,0,2,1,0,0
39759,46,959,322,174,179,16,74,51,338,10,41,26,46,51,72,252,408,5,2291,127,0,2,1,0,0
39760,23,382,424,94,331,4,0,89,428,1,5,5,5,6,10,11,25,0,12,0,0,2,1,0,0
39761,23,382,38,23,23,6,0,8,44,3,11,7,11,14,18,42,68,1,102,5,0,2,1,0,0
39762,17,518,184,100,137,2,15,30,186,6,38,20,39,44,59,214,322,3,991,55,0,2,2,0,0
39763,17,518,103,65,74,8,5,16,111,7,17,9,17,24,26,89,119,3,417,23,0,2,2,0,0
39764,223,5076,722,423,573,19,0,135,741,12,172,101,199,184,300,1320,2257,6,15668,870,0,2,9,9,0
39765,223,5076,1508,847,911,44,250,301,1552,14,148,88,169,162,257,1120,1886,7,15077,837,0,2,9,9,0
39766,337,7196,72,33,56,0,4,12,72,1,1,1,1,2,2,0,2,0,1,0,0,2,1,0,0
39767,337,7196,1454,835,1044,76,110,219,1530,17,275,158,296,292,454,2297,3718,9,34017,1889,1,2,1,0,0
39768,39,816,386,256,301,16,9,68,402,4,59,35,69,63,104,355,621,2,1453,80,0,2,2,0,0
39769,39,816,264,131,164,11,41,46,275,6,38,22,40,44,62,214,338,3,1068,59,0,2,2,0,0
39770,30,649,215,129,180,6,0,29,221,8,65,43,72,73,115,415,711,4,3153,175,0,2,3,2,0
39771,30,649,97,69,77,3,3,16,100,6,22,13,23,28,36,113,173,3,542,30,0,2,3,2,0
39772,128,2826,1043,504,840,53,9,147,1096,9,180,112,198,189,310,1377,2344,4,11604,644,0,2,2,0,0
39773,128,2826,383,288,292,26,6,62,409,11,65,38,67,76,105,429,656,5,3719,206,0,2,2,0,0
39774,20,408,294,64,250,0,0,43,294,1,20,10,20,21,30,86,131,0,65,3,0,2,2,0,0
39775,20,408,78,46,62,3,0,14,81,3,8,4,8,11,12,28,41,1,62,3,0,2,2,0,0
39776,5,118,110,30,77,3,13,16,113,4,21,15,30,25,45,100,208,2,597,33,0,2,2,0,0
39777,5,118,28,15,21,1,0,6,29,0,0,0,0,0,0,0,0,0,0,0,0,2,2,0,0
39778,104,1977,1178,367,1042,6,15,115,1184,9,94,51,95,103,146,644,976,4,4439,246,0,2,2,0,0
39779,104,1977,177,108,140,8,0,27,185,6,30,16,32,36,48,162,248,3,794,44,0,2,2,0,0
39780,184,3757,1943,715,1694,26,18,214,1969,12,185,120,237,197,357,1436,2721,7,20915,1161,0,2,2,0,0
39781,184,3757,1168,838,957,57,25,144,1225,19,348,224,416,367,640,3018,5452,11,61921,3440,1,2,2,0,0
39782,16,480,442,244,305,14,16,103,456,11,68,45,75,79,120,452,756,6,4588,254,0,2,2,0,0
39783,16,480,182,102,99,11,40,35,193,3,11,6,11,14,17,42,64,1,97,5,0,2,2,0,0
39784,62,1248,1098,241,925,5,10,155,1103,7,46,25,49,53,74,273,423,3,1580,87,0,2,1,1,0
39785,62,1248,282,202,222,14,2,44,296,8,42,24,43,50,67,250,378,4,1548,86,0,2,1,1,0
39786,78,3314,1289,550,1043,56,32,155,1345,10,167,93,185,177,278,1266,2075,5,11498,638,0,2,1,0,0
39787,34,997,182,127,129,0,0,53,182,5,39,21,42,44,63,217,343,2,926,51,0,2,1,0,0
39788,137,6599,1392,870,1177,35,17,170,1427,14,494,280,531,508,811,4473,7289,7,54850,3047,2,2,2,1,0
39789,91,3011,773,419,590,28,0,166,801,10,204,113,217,214,330,1598,2554,5,13587,754,0,2,1,0,0
39790,7,263,75,38,59,1,3,12,76,2,4,2,4,6,6,10,15,1,15,0,0,2,1,0,0
39791,94,4280,1338,495,1086,10,64,173,1348,11,122,82,157,133,239,883,1686,7,11934,663,0,2,6,4,0
39792,23,601,102,59,69,5,3,24,107,6,22,15,28,28,43,113,206,3,789,43,0,2,1,1,0
39793,109,4101,1450,624,1228,12,26,181,1462,14,306,186,354,320,540,2580,4493,8,36391,2021,1,2,1,0,0
39794,148,4088,1660,832,1314,41,38,274,1701,20,312,209,395,332,604,2671,5058,12,64042,3557,1,2,1,0,0
39795,117,4641,1513,682,1277,25,13,200,1538,11,199,116,219,210,335,1557,2584,6,15641,868,0,2,4,3,0
39796,59,3310,1296,573,1062,40,33,157,1336,8,201,118,231,209,349,1561,2689,4,12365,686,0,2,1,0,0
39797,10,236,207,111,150,11,0,50,218,5,26,19,36,31,55,133,272,3,943,52,0,2,1,0,0
39798,78,4093,1457,730,1242,11,6,188,1468,10,292,166,329,302,495,2424,4078,5,22973,1276,1,2,1,0,0
39799,38,2286,652,304,544,16,6,88,668,6,89,51,101,95,152,591,998,3,3399,188,0,2,1,0,0
39800,62,2878,1455,414,1257,16,76,112,1471,5,41,23,46,46,69,231,381,2,1069,59,0,2,1,0,0
39801,2,75,7,6,5,0,0,2,7,1,1,1,2,2,3,0,3,1,3,0,0,2,1,0,0
39802,8,273,74,35,59,1,0,14,75,3,14,7,14,17,21,58,85,1,128,7,0,2,1,0,0
39803,87,4331,1523,757,1297,19,12,193,1542,12,193,117,230,205,347,1508,2664,7,19053,1058,0,2,2,2,0
39804,66,2763,1020,354,843,12,15,144,1032,8,134,77,144,142,221,970,1580,4,6792,377,0,2,2,1,0
39805,37,1624,447,308,343,6,5,95,453,7,96,59,111,103,170,651,1136,4,4600,255,0,2,1,0,0
39806,21,661,424,94,331,4,0,89,428,1,5,5,5,6,10,11,25,0,12,0,0,2,1,0,0
39807,40,2359,334,251,279,10,4,40,344,5,127,74,143,132,217,899,1528,2,4303,239,0,2,1,1,0
39808,12,492,184,100,137,2,15,30,186,6,38,20,39,44,59,214,322,3,991,55,0,2,1,0,0
39809,35,1623,1293,570,1093,25,15,163,1318,10,195,123,241,205,364,1516,2795,6,17273,959,0,2,1,0,0
39810,36,1978,384,251,317,7,8,52,391,11,70,44,84,81,128,467,811,6,5355,297,0,2,1,0,0
39811,15,638,722,423,573,19,0,135,741,12,172,101,199,184,300,1320,2257,6,15668,870,0,2,1,0,0
39812,31,1439,386,256,301,16,9,68,402,4,59,35,69,63,104,355,621,2,1453,80,0,2,1,0,0
39813,16,1209,215,129,180,6,0,29,221,8,65,43,72,73,115,415,711,4,3153,175,0,2,1,0,0
39814,69,2856,1043,504,840,53,9,147,1096,9,180,112,198,189,310,1377,2344,4,11604,644,0,2,1,1,0
39815,14,529,295,56,236,0,4,54,295,2,9,5,10,11,15,30,51,1,57,3,0,2,5,3,0
39816,25,1027,373,158,315,8,0,51,381,5,76,44,79,81,123,486,779,2,2026,112,0,2,1,0,0
39817,71,3006,1178,367,1042,6,15,115,1184,9,94,51,95,103,146,644,976,4,4439,246,0,2,1,0,0
39818,73,3738,1943,715,1694,26,18,214,1969,12,185,120,237,197,357,1436,2721,7,20915,1161,0,2,1,0,0
39819,14,825,442,244,305,14,16,103,456,11,68,45,75,79,120,452,756,6,4588,254,0,2,1,0,0
39820,48,1784,1098,241,925,5,10,155,1103,7,46,25,49,53,74,273,423,3,1580,87,0,2,1,0,0
39821,79,1563,1020,354,843,12,15,144,1032,8,134,77,144,142,221,970,1580,4,6792,377,0,2,62,15,1
39822,336,7198,72,33,56,0,4,12,72,1,1,1,1,2,2,0,2,0,1,0,0,2,36,35,1
39823,336,7198,1454,835,1044,76,110,219,1530,17,275,158,296,292,454,2297,3718,9,34017,1889,1,2,36,35,1
39824,112,5702,1782,648,1425,9,47,279,1791,8,171,97,189,179,286,1292,2140,4,9462,525,0,2,68,31,1
39825,67,2928,1020,354,843,12,15,144,1032,8,134,77,144,142,221,970,1580,4,6792,377,0,2,22,6,1
39826,79,1563,1020,354,843,12,15,144,1032,8,134,77,144,142,221,970,1580,4,6792,377,0,2,62,15,0
39827,336,7198,72,33,56,0,4,12,72,1,1,1,1,2,2,0,2,0,1,0,0,2,36,35,0
39828,336,7198,1454,835,1044,76,110,219,1530,17,275,158,296,292,454,2297,3718,9,34017,1889,1,2,36,35,0
39829,112,5702,1782,648,1425,9,47,279,1791,8,171,97,189,179,286,1292,2140,4,9462,525,0,2,68,31,0
39830,67,2928,1020,354,843,12,15,144,1032,8,134,77,144,142,221,970,1580,4,6792,377,0,2,22,6,0
39894,346,7021,1457,730,1242,11,6,188,1468,10,292,166,329,302,495,2424,4078,5,22973,1276,1,2,1,0,0
39895,346,7021,74,35,59,1,0,14,75,3,14,7,14,17,21,58,85,1,128,7,0,2,1,0,0
39896,346,7021,245,125,200,5,7,34,250,7,30,17,34,37,51,166,265,3,1053,58,0,2,1,0,0
39901,227,5129,4293,999,3693,19,54,507,4312,9,155,88,170,164,258,1156,1898,4,9368,520,0,2,1,0,0
39902,227,5129,1482,859,1002,125,135,219,1607,16,219,134,251,235,385,1766,3032,9,27804,1544,1,2,1,0,0
39910,79,1563,1020,354,843,12,15,144,1032,8,134,77,144,142,221,970,1580,4,6792,377,0,2,64,15,0
39919,336,7198,72,33,56,0,4,12,72,1,1,1,1,2,2,0,2,0,1,0,0,2,37,35,0
39920,336,7198,1454,835,1044,76,110,219,1530,17,275,158,296,292,454,2297,3718,9,34017,1889,1,2,37,35,0
39921,39,792,386,256,301,16,9,68,402,4,59,35,69,63,104,355,621,2,1453,80,0,2,2,0,0
39922,39,792,264,131,164,11,41,46,275,6,38,22,40,44,62,214,338,3,1068,59,0,2,2,0,0
39933,191,3892,1943,715,1694,26,18,214,1969,12,185,120,237,197,357,1436,2721,7,20915,1161,0,2,2,1,0
39934,191,3892,1168,838,957,57,25,144,1225,19,348,224,416,367,640,3018,5452,11,61921,3440,1,2,2,1,0
39944,94,4283,1338,495,1086,10,64,173,1348,11,122,82,157,133,239,883,1686,7,11934,663,0,2,6,4,0
39947,109,4106,1450,624,1228,12,26,181,1462,14,306,186,354,320,540,2580,4493,8,36391,2021,1,2,1,0,0
39957,87,4336,1523,757,1297,19,12,193,1542,12,193,117,230,205,347,1508,2664,7,19053,1058,0,2,1,1,0
39958,67,2928,1020,354,843,12,15,144,1032,8,134,77,144,142,221,970,1580,4,6792,377,0,2,24,7,0
39975,14,339,601,196,481,2,23,85,603,8,63,36,72,71,108,400,664,4,3036,168,0,2,3,1,0
39976,14,339,156,79,106,5,16,28,161,5,14,8,15,19,23,64,97,2,261,14,0,2,3,1,0
39977,14,339,601,196,481,2,23,85,603,8,63,36,72,71,108,400,664,4,3036,168,0,2,1,1,0
39978,14,339,156,79,106,5,16,28,161,5,14,8,15,19,23,64,97,2,261,14,0,2,1,1,0
39979,336,7200,72,33,56,0,4,12,72,1,1,1,1,2,2,0,2,0,1,0,0,2,1,1,1
39980,336,7200,1454,835,1044,76,110,219,1530,17,275,158,296,292,454,2297,3718,9,34017,1889,1,2,1,1,1
39981,78,3324,1289,550,1043,56,32,155,1345,10,167,93,185,177,278,1266,2075,5,11498,638,0,2,9,3,1
39982,147,6797,139,89,101,2,0,35,141,7,54,34,62,61,96,330,569,4,2287,127,0,2,26,15,1
39983,147,6797,7,5,5,0,0,2,7,1,2,1,2,3,3,2,4,0,2,0,0,2,26,15,1
39984,112,5710,1782,648,1425,9,47,279,1791,8,171,97,189,179,286,1292,2140,4,9462,525,0,2,2,1,1
39985,78,4093,1457,730,1242,11,6,188,1468,10,292,166,329,302,495,2424,4078,5,22973,1276,1,2,1,1,1
39986,40,2367,334,251,279,10,4,40,344,5,127,74,143,132,217,899,1528,2,4303,239,0,2,8,7,1
39987,223,5076,722,423,573,19,0,135,741,12,172,101,199,184,300,1320,2257,6,15668,870,0,2,1,1,1
39988,223,5076,1508,847,911,44,250,301,1552,14,148,88,169,162,257,1120,1886,7,15077,837,0,2,1,1,1
39989,128,2841,1043,504,840,53,9,147,1096,9,180,112,198,189,310,1377,2344,4,11604,644,0,2,12,5,1
39990,128,2841,383,288,292,26,6,62,409,11,65,38,67,76,105,429,656,5,3719,206,0,2,12,5,1
39991,78,3341,1289,550,1043,56,32,155,1345,10,167,93,185,177,278,1266,2075,5,11498,638,0,2,6,1,0
39992,346,7021,1457,730,1242,11,6,188,1468,10,292,166,329,302,495,2424,4078,5,22973,1276,1,2,3,3,0
39993,346,7021,74,35,59,1,0,14,75,3,14,7,14,17,21,58,85,1,128,7,0,2,3,3,0
39994,346,7021,245,125,200,5,7,34,250,7,30,17,34,37,51,166,265,3,1053,58,0,2,3,3,0
39995,227,5129,4293,999,3693,19,54,507,4312,9,155,88,170,164,258,1156,1898,4,9368,520,0,2,1,1,0
39996,227,5129,1482,859,1002,125,135,219,1607,16,219,134,251,235,385,1766,3032,9,27804,1544,1,2,1,1,0
39997,223,5076,722,423,573,19,0,135,741,12,172,101,199,184,300,1320,2257,6,15668,870,0,2,1,1,0
39998,223,5076,1508,847,911,44,250,301,1552,14,148,88,169,162,257,1120,1886,7,15077,837,0,2,1,1,0
39999,336,7200,72,33,56,0,4,12,72,1,1,1,1,2,2,0,2,0,1,0,0,2,1,1,0
40000,336,7200,1454,835,1044,76,110,219,1530,17,275,158,296,292,454,2297,3718,9,34017,1889,1,2,1,1,0
40001,39,792,386,256,301,16,9,68,402,4,59,35,69,63,104,355,621,2,1453,80,0,2,0,2,0
40002,39,792,264,131,164,11,41,46,275,6,38,22,40,44,62,214,338,3,1068,59,0,2,0,2,0
40003,128,2841,1043,504,840,53,9,147,1096,9,180,112,198,189,310,1377,2344,4,11604,644,0,2,12,5,0
40004,128,2841,383,288,292,26,6,62,409,11,65,38,67,76,105,429,656,5,3719,206,0,2,12,5,0
40005,191,3892,1943,715,1694,26,18,214,1969,12,185,120,237,197,357,1436,2721,7,20915,1161,0,2,51,19,0
40006,191,3892,1168,838,957,57,25,144,1225,19,348,224,416,367,640,3018,5452,11,61921,3440,1,2,51,19,0
40007,14,339,601,196,481,2,23,85,603,8,63,36,72,71,108,400,664,4,3036,168,0,0,73,0,0
40008,14,339,156,79,106,5,16,28,161,5,14,8,15,19,23,64,97,2,261,14,0,0,73,0,0
40009,78,3341,1289,550,1043,56,32,155,1345,10,167,93,185,177,278,1266,2075,5,11498,638,0,2,15,4,0
40010,7,263,75,38,59,1,3,12,76,2,4,2,4,6,6,10,15,1,15,0,0,2,1,1,0
40011,94,4283,1338,495,1086,10,64,173,1348,11,122,82,157,133,239,883,1686,7,11934,663,0,2,5,5,0
40012,147,6797,139,89,101,2,0,35,141,7,54,34,62,61,96,330,569,4,2287,127,0,2,26,15,0
40013,147,6797,7,5,5,0,0,2,7,1,2,1,2,3,3,2,4,0,2,0,0,2,26,15,0
40014,112,5710,1782,648,1425,9,47,279,1791,8,171,97,189,179,286,1292,2140,4,9462,525,0,2,2,1,0
40015,109,4106,1450,624,1228,12,26,181,1462,14,306,186,354,320,540,2580,4493,8,36391,2021,1,2,4,1,0
40016,78,4093,1457,730,1242,11,6,188,1468,10,292,166,329,302,495,2424,4078,5,22973,1276,1,2,5,4,0
40017,87,4336,1523,757,1297,19,12,193,1542,12,193,117,230,205,347,1508,2664,7,19053,1058,0,2,4,1,0
40018,40,2367,334,251,279,10,4,40,344,5,127,74,143,132,217,899,1528,2,4303,239,0,2,8,7,0
40019,36,1978,384,251,317,7,8,52,391,11,70,44,84,81,128,467,811,6,5355,297,0,2,2,2,0
40020,31,1439,386,256,301,16,9,68,402,4,59,35,69,63,104,355,621,2,1453,80,0,2,3,1,0
40021,73,3738,1943,715,1694,26,18,214,1969,12,185,120,237,197,357,1436,2721,7,20915,1161,0,2,8,8,0
40022,9,317,601,196,481,2,23,85,603,8,63,36,72,71,108,400,664,4,3036,168,0,0,108,0,0
40025,27,545,2,2,2,0,0,0,2,0,0,0,0,0,0,0,0,0,0,0,0,2,0,3,1
40039,27,545,99,48,90,1,3,5,100,0,0,0,0,0,0,0,0,0,0,0,0,2,0,3,1
40040,27,545,8,5,5,2,0,1,10,0,0,0,0,0,0,0,0,0,0,0,0,2,0,3,1
40041,27,545,1217,716,841,84,126,174,1301,14,185,118,215,199,333,1446,2542,8,20687,1149,0,2,0,3,1
40042,27,545,160,89,115,0,13,31,160,7,15,11,17,22,28,78,124,3,495,27,0,2,0,3,1
40043,27,545,10,10,9,9,0,0,19,0,0,0,0,0,0,0,0,0,0,0,0,2,0,3,1
40044,27,545,173,84,99,8,29,36,181,5,12,7,13,17,20,54,81,2,221,12,0,2,0,3,1
40045,27,545,3,1,1,3,0,0,6,0,0,0,0,0,0,0,0,0,0,0,0,2,0,3,1
40046,346,7021,1457,730,1242,11,6,188,1468,10,292,166,329,302,495,2424,4078,5,22973,1276,1,2,1,0,1
40047,346,7021,74,35,59,1,0,14,75,3,14,7,14,17,21,58,85,1,128,7,0,2,1,0,1
40048,346,7021,245,125,200,5,7,34,250,7,30,17,34,37,51,166,265,3,1053,58,0,2,1,0,1
40049,6,136,44,22,19,0,19,6,44,2,10,6,12,12,18,35,64,1,77,4,0,2,0,3,1
40050,21,670,339,213,244,17,9,65,356,10,42,26,48,52,74,259,421,5,2410,133,0,2,8,8,1
40051,227,5121,4293,999,3693,19,54,507,4312,9,155,88,170,164,258,1156,1898,4,9368,520,0,2,0,2,1
40052,227,5121,1482,859,1002,125,135,219,1607,16,219,134,251,235,385,1766,3032,9,27804,1544,1,2,0,2,1
40053,38,777,386,256,301,16,9,68,402,4,59,35,69,63,104,355,621,2,1453,80,0,2,0,5,1
40054,38,777,264,131,164,11,41,46,275,6,38,22,40,44,62,214,338,3,1068,59,0,2,0,5,1
40055,127,2817,1043,504,840,53,9,147,1096,9,180,112,198,189,310,1377,2344,4,11604,644,0,2,0,7,1
40056,127,2817,383,288,292,26,6,62,409,11,65,38,67,76,105,429,656,5,3719,206,0,2,0,7,1
40057,80,1581,1020,354,843,12,15,144,1032,8,134,77,144,142,221,970,1580,4,6792,377,0,2,13,5,1
40058,103,1965,1178,367,1042,6,15,115,1184,9,94,51,95,103,146,644,976,4,4439,246,0,2,0,4,1
40059,103,1965,177,108,140,8,0,27,185,6,30,16,32,36,48,162,248,3,794,44,0,2,0,4,1
40060,49,575,647,139,84,35,284,233,682,0,0,0,0,0,0,0,0,0,0,0,0,2,3,1,1
40061,80,1586,1020,354,843,12,15,144,1032,8,134,77,144,142,221,970,1580,4,6792,377,0,2,1,1,1
40062,52,1103,207,111,150,11,0,50,218,5,26,19,36,31,55,133,272,3,943,52,0,2,23,0,1
40063,52,1103,410,198,237,31,55,97,441,11,63,38,72,74,110,414,683,6,4293,238,0,2,23,0,1
40064,227,5114,4293,999,3693,19,54,507,4312,9,155,88,170,164,258,1156,1898,4,9368,520,0,2,1,3,1
40065,227,5114,1482,859,1002,125,135,219,1607,16,219,134,251,235,385,1766,3032,9,27804,1544,1,2,1,3,1
40066,177,4136,77,34,69,0,0,8,77,3,24,16,29,27,45,114,213,1,387,21,0,2,0,5,1
40067,177,4136,712,438,573,51,9,84,763,14,102,71,128,116,199,733,1364,8,11988,666,0,2,0,5,1
40068,335,7153,72,33,56,0,4,12,72,1,1,1,1,2,2,0,2,0,1,0,0,2,6,16,1
40069,335,7153,1454,835,1044,76,110,219,1530,17,275,158,296,292,454,2297,3718,9,34017,1889,1,2,6,16,1
40070,226,5106,4293,999,3693,19,54,507,4312,9,155,88,170,164,258,1156,1898,4,9368,520,0,2,5,9,1
40071,226,5106,1482,859,1002,125,135,219,1607,16,219,134,251,235,385,1766,3032,9,27804,1544,1,2,5,9,1
40072,53,1123,207,111,150,11,0,50,218,5,26,19,36,31,55,133,272,3,943,52,0,2,9,0,1
40073,53,1123,410,198,237,31,55,97,441,11,63,38,72,74,110,414,683,6,4293,238,0,2,9,0,1
40074,21,668,339,213,244,17,9,65,356,10,42,26,48,52,74,259,421,5,2410,133,0,2,2,3,1
40075,225,5104,4293,999,3693,19,54,507,4312,9,155,88,170,164,258,1156,1898,4,9368,520,0,2,15,24,1
40076,225,5104,1482,859,1002,125,135,219,1607,16,219,134,251,235,385,1766,3032,9,27804,1544,1,2,15,24,1
40077,177,4124,77,34,69,0,0,8,77,3,24,16,29,27,45,114,213,1,387,21,0,2,28,22,1
40078,177,4124,712,438,573,51,9,84,763,14,102,71,128,116,199,733,1364,8,11988,666,0,2,28,22,1
40079,46,961,447,308,343,6,5,95,453,7,96,59,111,103,170,651,1136,4,4600,255,0,2,4,4,1
40080,46,961,322,174,179,16,74,51,338,10,41,26,46,51,72,252,408,5,2291,127,0,2,4,4,1
40081,335,7158,72,33,56,0,4,12,72,1,1,1,1,2,2,0,2,0,1,0,0,2,11,10,1
40082,335,7158,1454,835,1044,76,110,219,1530,17,275,158,296,292,454,2297,3718,9,34017,1889,1,2,11,10,1
40083,38,783,386,256,301,16,9,68,402,4,59,35,69,63,104,355,621,2,1453,80,0,2,8,6,1
40084,38,783,264,131,164,11,41,46,275,6,38,22,40,44,62,214,338,3,1068,59,0,2,8,6,1
40085,127,2813,1043,504,840,53,9,147,1096,9,180,112,198,189,310,1377,2344,4,11604,644,0,2,1,2,1
40086,127,2813,383,288,292,26,6,62,409,11,65,38,67,76,105,429,656,5,3719,206,0,2,1,2,1
40087,103,1960,1178,367,1042,6,15,115,1184,9,94,51,95,103,146,644,976,4,4439,246,0,2,20,18,1
40088,103,1960,177,108,140,8,0,27,185,6,30,16,32,36,48,162,248,3,794,44,0,2,20,18,1
40089,225,5102,4293,999,3693,19,54,507,4312,9,155,88,170,164,258,1156,1898,4,9368,520,0,2,3,2,1
40090,225,5102,1482,859,1002,125,135,219,1607,16,219,134,251,235,385,1766,3032,9,27804,1544,1,2,3,2,1
40091,335,7158,72,33,56,0,4,12,72,1,1,1,1,2,2,0,2,0,1,0,0,2,1,1,1
40092,335,7158,1454,835,1044,76,110,219,1530,17,275,158,296,292,454,2297,3718,9,34017,1889,1,2,1,1,1
40093,38,783,386,256,301,16,9,68,402,4,59,35,69,63,104,355,621,2,1453,80,0,2,0,1,1
40094,38,783,264,131,164,11,41,46,275,6,38,22,40,44,62,214,338,3,1068,59,0,2,0,1,1
40095,103,1956,1178,367,1042,6,15,115,1184,9,94,51,95,103,146,644,976,4,4439,246,0,2,11,5,1
40096,103,1956,177,108,140,8,0,27,185,6,30,16,32,36,48,162,248,3,794,44,0,2,11,5,1
40097,177,4127,77,34,69,0,0,8,77,3,24,16,29,27,45,114,213,1,387,21,0,2,1,1,1
40098,177,4127,712,438,573,51,9,84,763,14,102,71,128,116,199,733,1364,8,11988,666,0,2,1,1,1
40099,225,5106,4293,999,3693,19,54,507,4312,9,155,88,170,164,258,1156,1898,4,9368,520,0,2,3,3,0
40100,225,5106,1482,859,1002,125,135,219,1607,16,219,134,251,235,385,1766,3032,9,27804,1544,1,2,3,3,0
40101,23,388,424,94,331,4,0,89,428,1,5,5,5,6,10,11,25,0,12,0,0,2,9,9,1
40102,23,388,38,23,23,6,0,8,44,3,11,7,11,14,18,42,68,1,102,5,0,2,9,9,1
40103,62,1240,1098,241,925,5,10,155,1103,7,46,25,49,53,74,273,423,3,1580,87,0,2,25,21,1
40104,62,1240,282,202,222,14,2,44,296,8,42,24,43,50,67,250,378,4,1548,86,0,2,25,21,1
40105,335,7154,72,33,56,0,4,12,72,1,1,1,1,2,2,0,2,0,1,0,0,2,8,5,1
40106,335,7154,1454,835,1044,76,110,219,1530,17,275,158,296,292,454,2297,3718,9,34017,1889,1,2,8,5,1
40107,80,1593,1020,354,843,12,15,144,1032,8,134,77,144,142,221,970,1580,4,6792,377,0,2,2,4,1
40108,178,4136,77,34,69,0,0,8,77,3,24,16,29,27,45,114,213,1,387,21,0,2,10,0,1
40109,178,4136,712,438,573,51,9,84,763,14,102,71,128,116,199,733,1364,8,11988,666,0,2,10,0,1
40110,48,904,207,111,150,11,0,50,218,5,26,19,36,31,55,133,272,3,943,52,0,2,2,0,0
40111,48,904,410,198,237,31,55,97,441,11,63,38,72,74,110,414,683,6,4293,238,0,2,2,0,0
40112,335,7113,72,33,56,0,4,12,72,1,1,1,1,2,2,0,2,0,1,0,0,2,2,2,0
40113,335,7113,1454,835,1044,76,110,219,1530,17,275,158,296,292,454,2297,3718,9,34017,1889,1,2,2,2,0
40114,95,4294,1338,495,1086,10,64,173,1348,11,122,82,157,133,239,883,1686,7,11934,663,0,2,17,0,0
40115,48,904,207,111,150,11,0,50,218,5,26,19,36,31,55,133,272,3,943,52,0,2,1,1,0
40116,48,904,410,198,237,31,55,97,441,11,63,38,72,74,110,414,683,6,4293,238,0,2,1,1,0
40117,48,904,207,111,150,11,0,50,218,5,26,19,36,31,55,133,272,3,943,52,0,2,3,1,0
40118,48,904,410,198,237,31,55,97,441,11,63,38,72,74,110,414,683,6,4293,238,0,2,3,1,0
40122,346,7035,1457,730,1242,11,6,188,1468,10,292,166,329,302,495,2424,4078,5,22973,1276,1,2,2,1,1
40123,346,7035,74,35,59,1,0,14,75,3,14,7,14,17,21,58,85,1,128,7,0,2,2,1,1
40124,346,7035,245,125,200,5,7,34,250,7,30,17,34,37,51,166,265,3,1053,58,0,2,2,1,1
40125,79,3381,1289,550,1043,56,32,155,1345,10,167,93,185,177,278,1266,2075,5,11498,638,0,2,14,0,1
40126,346,7035,1457,730,1242,11,6,188,1468,10,292,166,329,302,495,2424,4078,5,22973,1276,1,2,2,1,0
40127,346,7035,74,35,59,1,0,14,75,3,14,7,14,17,21,58,85,1,128,7,0,2,2,1,0
40128,346,7035,245,125,200,5,7,34,250,7,30,17,34,37,51,166,265,3,1053,58,0,2,2,1,0
40129,79,3381,1289,550,1043,56,32,155,1345,10,167,93,185,177,278,1266,2075,5,11498,638,0,2,14,0,0
40130,163,5086,1660,832,1314,41,38,274,1701,20,312,209,395,332,604,2671,5058,12,64042,3557,1,2,1,1,0
40131,163,5086,1057,646,719,113,100,145,1170,18,215,134,248,233,382,1740,3004,10,31186,1732,1,2,1,1,0
40132,149,4136,1660,832,1314,41,38,274,1701,20,312,209,395,332,604,2671,5058,12,64042,3557,1,2,18,0,0
40159,211,4515,182,127,129,0,0,53,182,5,39,21,42,44,63,217,343,2,926,51,0,2,23,8,1
40160,211,4515,1165,710,800,67,119,181,1232,18,243,153,282,261,435,2000,3492,10,36473,2026,1,2,23,8,1
40161,99,2075,773,419,590,28,0,166,801,10,204,113,217,214,330,1598,2554,5,13587,754,0,2,8,15,1
40162,99,2075,421,273,302,44,34,57,465,17,81,59,107,98,166,583,1098,11,12329,684,0,2,8,15,1
40165,34,625,2,2,2,0,0,0,2,0,0,0,0,0,0,0,0,0,0,0,0,2,3,1,1
40179,34,625,99,48,90,1,3,5,100,0,0,0,0,0,0,0,0,0,0,0,0,2,3,1,1
40180,34,625,8,5,5,2,0,1,10,0,0,0,0,0,0,0,0,0,0,0,0,2,3,1,1
40181,34,625,1217,716,841,84,126,174,1301,14,185,118,215,199,333,1446,2542,8,20687,1149,0,2,3,1,1
40182,34,625,160,89,115,0,13,31,160,7,15,11,17,22,28,78,124,3,495,27,0,2,3,1,1
40183,34,625,10,10,9,9,0,0,19,0,0,0,0,0,0,0,0,0,0,0,0,2,3,1,1
40184,34,625,173,84,99,8,29,36,181,5,12,7,13,17,20,54,81,2,221,12,0,2,3,1,1
40185,34,625,3,1,1,3,0,0,6,0,0,0,0,0,0,0,0,0,0,0,0,2,3,1,1
40186,163,5074,1660,832,1314,41,38,274,1701,20,312,209,395,332,604,2671,5058,12,64042,3557,1,2,17,6,1
40187,163,5074,1057,646,719,113,100,145,1170,18,215,134,248,233,382,1740,3004,10,31186,1732,1,2,17,6,1
40191,119,2401,1513,682,1277,25,13,200,1538,11,199,116,219,210,335,1557,2584,6,15641,868,0,2,3,1,1
40192,119,2401,819,519,539,24,98,155,843,15,96,57,106,111,163,690,1107,8,9171,509,0,2,3,1,1
40193,48,904,207,111,150,11,0,50,218,5,26,19,36,31,55,133,272,3,943,52,0,2,33,6,1
40194,48,904,410,198,237,31,55,97,441,11,63,38,72,74,110,414,683,6,4293,238,0,2,33,6,1
40195,346,6994,1457,730,1242,11,6,188,1468,10,292,166,329,302,495,2424,4078,5,22973,1276,1,2,98,36,1
40196,346,6994,74,35,59,1,0,14,75,3,14,7,14,17,21,58,85,1,128,7,0,2,98,36,1
40197,346,6994,245,125,200,5,7,34,250,7,30,17,34,37,51,166,265,3,1053,58,0,2,98,36,1
40199,227,5099,4293,999,3693,19,54,507,4312,9,155,88,170,164,258,1156,1898,4,9368,520,0,2,29,4,1
40200,227,5099,1482,859,1002,125,135,219,1607,16,219,134,251,235,385,1766,3032,9,27804,1544,1,2,29,4,1
40201,24,834,74,35,59,1,0,14,75,3,14,7,14,17,21,58,85,1,128,7,0,2,5,3,1
40202,24,834,245,125,200,5,7,34,250,7,30,17,34,37,51,166,265,3,1053,58,0,2,5,3,1
40203,49,573,647,139,84,35,284,233,682,0,0,0,0,0,0,0,0,0,0,0,0,2,10,3,1
40204,71,2109,1523,757,1297,19,12,193,1542,12,193,117,230,205,347,1508,2664,7,19053,1058,0,2,13,6,1
40205,71,2109,701,378,504,33,58,109,734,13,110,68,126,123,194,794,1346,7,10027,557,0,2,13,6,1
40206,179,4176,77,34,69,0,0,8,77,3,24,16,29,27,45,114,213,1,387,21,0,2,48,39,1
40207,179,4176,712,438,573,51,9,84,763,14,102,71,128,116,199,733,1364,8,11988,666,0,2,48,39,1
40208,70,1304,1020,354,843,12,15,144,1032,8,134,77,144,142,221,970,1580,4,6792,377,0,2,3,1,1
40209,46,945,447,308,343,6,5,95,453,7,96,59,111,103,170,651,1136,4,4600,255,0,2,3,3,1
40210,46,945,322,174,179,16,74,51,338,10,41,26,46,51,72,252,408,5,2291,127,0,2,3,3,1
40213,222,4989,722,423,573,19,0,135,741,12,172,101,199,184,300,1320,2257,6,15668,870,0,2,17,9,1
40214,222,4989,1508,847,911,44,250,301,1552,14,148,88,169,162,257,1120,1886,7,15077,837,0,2,17,9,1
40215,335,7113,72,33,56,0,4,12,72,1,1,1,1,2,2,0,2,0,1,0,0,2,59,37,1
40216,335,7113,1454,835,1044,76,110,219,1530,17,275,158,296,292,454,2297,3718,9,34017,1889,1,2,59,37,1
40217,42,969,386,256,301,16,9,68,402,4,59,35,69,63,104,355,621,2,1453,80,0,2,10,2,1
40218,42,969,264,131,164,11,41,46,275,6,38,22,40,44,62,214,338,3,1068,59,0,2,10,2,1
40221,20,400,294,64,250,0,0,43,294,1,20,10,20,21,30,86,131,0,65,3,0,2,2,2,1
40222,20,400,78,46,62,3,0,14,81,3,8,4,8,11,12,28,41,1,62,3,0,2,2,2,1
40223,104,1979,1178,367,1042,6,15,115,1184,9,94,51,95,103,146,644,976,4,4439,246,0,2,8,3,1
40224,104,1979,177,108,140,8,0,27,185,6,30,16,32,36,48,162,248,3,794,44,0,2,8,3,1
40225,184,3743,1943,715,1694,26,18,214,1969,12,185,120,237,197,357,1436,2721,7,20915,1161,0,2,14,2,1
40226,184,3743,1168,838,957,57,25,144,1225,19,348,224,416,367,640,3018,5452,11,61921,3440,1,2,14,2,1
40227,16,469,442,244,305,14,16,103,456,11,68,45,75,79,120,452,756,6,4588,254,0,2,2,1,1
40228,16,469,182,102,99,11,40,35,193,3,11,6,11,14,17,42,64,1,97,5,0,2,2,1,1
40229,62,1244,1098,241,925,5,10,155,1103,7,46,25,49,53,74,273,423,3,1580,87,0,2,26,3,1
40230,62,1244,282,202,222,14,2,44,296,8,42,24,43,50,67,250,378,4,1548,86,0,2,26,3,1
40232,14,472,42,7,35,4,0,5,46,1,2,1,2,3,3,2,4,0,2,0,0,2,3,3,1
40233,14,472,11,6,10,0,0,1,11,2,4,2,4,6,6,10,15,1,15,0,0,2,3,3,1
40234,78,3291,1289,550,1043,56,32,155,1345,10,167,93,185,177,278,1266,2075,5,11498,638,0,2,1,1,1
40236,137,6580,1392,870,1177,35,17,170,1427,14,494,280,531,508,811,4473,7289,7,54850,3047,2,2,66,3,1
40237,47,2495,520,294,400,33,13,81,553,10,261,204,367,271,571,2128,4614,7,32445,1802,1,2,33,7,1
40238,95,4294,1338,495,1086,10,64,173,1348,11,122,82,157,133,239,883,1686,7,11934,663,0,2,67,1,1
40239,147,6715,139,89,101,2,0,35,141,7,54,34,62,61,96,330,569,4,2287,127,0,2,26,0,1
40240,147,6715,7,5,5,0,0,2,7,1,2,1,2,3,3,2,4,0,2,0,0,2,26,0,1
40243,106,5313,1782,648,1425,9,47,279,1791,8,171,97,189,179,286,1292,2140,4,9462,525,0,2,20,0,1
40244,20,468,256,139,192,9,7,47,265,4,23,12,24,27,36,112,171,2,357,19,0,2,30,0,1
40245,95,3480,1450,624,1228,12,26,181,1462,14,306,186,354,320,540,2580,4493,8,36391,2021,1,2,83,1,1
40246,148,4073,1660,832,1314,41,38,274,1701,20,312,209,395,332,604,2671,5058,12,64042,3557,1,2,171,1,1
40247,116,4567,1513,682,1277,25,13,200,1538,11,199,116,219,210,335,1557,2584,6,15641,868,0,2,3,2,1
40248,58,3234,1296,573,1062,40,33,157,1336,8,201,118,231,209,349,1561,2689,4,12365,686,0,2,5,11,1
40249,5,138,207,111,150,11,0,50,218,5,26,19,36,31,55,133,272,3,943,52,0,0,50,0,1
40250,78,4037,1457,730,1242,11,6,188,1468,10,292,166,329,302,495,2424,4078,5,22973,1276,1,2,97,2,1
40251,38,2269,652,304,544,16,6,88,668,6,89,51,101,95,152,591,998,3,3399,188,0,2,27,0,1
40252,61,2747,1455,414,1257,16,76,112,1471,5,41,23,46,46,69,231,381,2,1069,59,0,2,5,3,1
40253,82,4086,1523,757,1297,19,12,193,1542,12,193,117,230,205,347,1508,2664,7,19053,1058,0,2,59,0,1
40255,37,1604,447,308,343,6,5,95,453,7,96,59,111,103,170,651,1136,4,4600,255,0,2,4,10,1
40257,40,2349,334,251,279,10,4,40,344,5,127,74,143,132,217,899,1528,2,4303,239,0,2,17,2,1
40259,31,1478,1293,570,1093,25,15,163,1318,10,195,123,241,205,364,1516,2795,6,17273,959,0,2,38,26,1
40260,36,1940,384,251,317,7,8,52,391,11,70,44,84,81,128,467,811,6,5355,297,0,2,34,4,1
40261,15,621,722,423,573,19,0,135,741,12,172,101,199,184,300,1320,2257,6,15668,870,0,2,11,0,1
40265,71,2977,1178,367,1042,6,15,115,1184,9,94,51,95,103,146,644,976,4,4439,246,0,2,24,1,1
40266,73,3706,1943,715,1694,26,18,214,1969,12,185,120,237,197,357,1436,2721,7,20915,1161,0,2,35,1,1
40268,227,5099,4293,999,3693,19,54,507,4312,9,155,88,170,164,258,1156,1898,4,9368,520,0,2,10,10,1
40269,227,5099,1482,859,1002,125,135,219,1607,16,219,134,251,235,385,1766,3032,9,27804,1544,1,2,10,10,1
40270,227,5099,4293,999,3693,19,54,507,4312,9,155,88,170,164,258,1156,1898,4,9368,520,0,2,10,10,0
40271,227,5099,1482,859,1002,125,135,219,1607,16,219,134,251,235,385,1766,3032,9,27804,1544,1,2,10,10,0
40272,60,1262,996,429,845,24,10,117,1020,7,76,50,88,83,138,494,879,4,3565,198,0,2,3,3,1
40273,60,1262,456,277,329,12,42,72,468,13,85,50,97,98,147,592,972,7,7212,400,0,2,3,3,1
40274,60,1262,996,429,845,24,10,117,1020,7,76,50,88,83,138,494,879,4,3565,198,0,2,3,3,0
40275,60,1262,456,277,329,12,42,72,468,13,85,50,97,98,147,592,972,7,7212,400,0,2,3,3,0
40279,346,7028,1457,730,1242,11,6,188,1468,10,292,166,329,302,495,2424,4078,5,22973,1276,1,2,0,1,1
40280,346,7028,74,35,59,1,0,14,75,3,14,7,14,17,21,58,85,1,128,7,0,2,0,1,1
40281,346,7028,245,125,200,5,7,34,250,7,30,17,34,37,51,166,265,3,1053,58,0,2,0,1,1
40282,178,4177,77,34,69,0,0,8,77,3,24,16,29,27,45,114,213,1,387,21,0,2,1,0,1
40283,178,4177,712,438,573,51,9,84,763,14,102,71,128,116,199,733,1364,8,11988,666,0,2,1,0,1
40284,80,3429,1289,550,1043,56,32,155,1345,10,167,93,185,177,278,1266,2075,5,11498,638,0,2,28,0,1
40285,8,273,74,35,59,1,0,14,75,3,14,7,14,17,21,58,85,1,128,7,0,2,1,1,0
40288,211,4485,182,127,129,0,0,53,182,5,39,21,42,44,63,217,343,2,926,51,0,2,6,5,1
40289,211,4485,1165,710,800,67,119,181,1232,18,243,153,282,261,435,2000,3492,10,36473,2026,1,2,6,5,1
40290,48,919,207,111,150,11,0,50,218,5,26,19,36,31,55,133,272,3,943,52,0,2,1,0,1
40291,48,919,410,198,237,31,55,97,441,11,63,38,72,74,110,414,683,6,4293,238,0,2,1,0,1
40292,211,4485,182,127,129,0,0,53,182,5,39,21,42,44,63,217,343,2,926,51,0,2,6,5,0
40293,211,4485,1165,710,800,67,119,181,1232,18,243,153,282,261,435,2000,3492,10,36473,2026,1,2,6,5,0
40294,48,919,207,111,150,11,0,50,218,5,26,19,36,31,55,133,272,3,943,52,0,2,1,0,0
40295,48,919,410,198,237,31,55,97,441,11,63,38,72,74,110,414,683,6,4293,238,0,2,1,0,0
40296,223,5080,722,423,573,19,0,135,741,12,172,101,199,184,300,1320,2257,6,15668,870,0,2,2,1,0
40297,223,5080,1508,847,911,44,250,301,1552,14,148,88,169,162,257,1120,1886,7,15077,837,0,2,2,1,0
40298,178,4158,77,34,69,0,0,8,77,3,24,16,29,27,45,114,213,1,387,21,0,2,0,3,0
40299,178,4158,712,438,573,51,9,84,763,14,102,71,128,116,199,733,1364,8,11988,666,0,2,0,3,0
40300,191,3896,1943,715,1694,26,18,214,1969,12,185,120,237,197,357,1436,2721,7,20915,1161,0,2,3,3,0
40301,191,3896,1168,838,957,57,25,144,1225,19,348,224,416,367,640,3018,5452,11,61921,3440,1,2,3,3,0
40302,346,7028,1457,730,1242,11,6,188,1468,10,292,166,329,302,495,2424,4078,5,22973,1276,1,2,0,1,0
40303,346,7028,74,35,59,1,0,14,75,3,14,7,14,17,21,58,85,1,128,7,0,2,0,1,0
40304,346,7028,245,125,200,5,7,34,250,7,30,17,34,37,51,166,265,3,1053,58,0,2,0,1,0
40305,178,4158,77,34,69,0,0,8,77,3,24,16,29,27,45,114,213,1,387,21,0,2,1,3,0
40306,178,4158,712,438,573,51,9,84,763,14,102,71,128,116,199,733,1364,8,11988,666,0,2,1,3,0
40307,223,5080,722,423,573,19,0,135,741,12,172,101,199,184,300,1320,2257,6,15668,870,0,2,3,2,0
40308,223,5080,1508,847,911,44,250,301,1552,14,148,88,169,162,257,1120,1886,7,15077,837,0,2,3,2,0
40311,80,3429,1289,550,1043,56,32,155,1345,10,167,93,185,177,278,1266,2075,5,11498,638,0,2,28,0,0
40336,11,401,42,7,35,4,0,5,46,1,2,1,2,3,3,2,4,0,2,0,0,2,4,10,0
40337,11,401,11,6,10,0,0,1,11,2,4,2,4,6,6,10,15,1,15,0,0,2,4,10,0
40361,11,396,42,7,35,4,0,5,46,1,2,1,2,3,3,2,4,0,2,0,0,2,1,3,1
40362,11,396,11,6,10,0,0,1,11,2,4,2,4,6,6,10,15,1,15,0,0,2,1,3,1
40363,335,7113,72,33,56,0,4,12,72,1,1,1,1,2,2,0,2,0,1,0,0,2,2,2,1
40364,335,7113,1454,835,1044,76,110,219,1530,17,275,158,296,292,454,2297,3718,9,34017,1889,1,2,2,2,1
40365,96,4332,1338,495,1086,10,64,173,1348,11,122,82,157,133,239,883,1686,7,11934,663,0,2,28,0,1
40391,96,4332,1338,495,1086,10,64,173,1348,11,122,82,157,133,239,883,1686,7,11934,663,0,2,28,0,0
40394,27,545,2,2,2,0,0,0,2,0,0,0,0,0,0,0,0,0,0,0,0,2,0,3,0
40408,27,545,99,48,90,1,3,5,100,0,0,0,0,0,0,0,0,0,0,0,0,2,0,3,0
40409,27,545,8,5,5,2,0,1,10,0,0,0,0,0,0,0,0,0,0,0,0,2,0,3,0
40410,27,545,1217,716,841,84,126,174,1301,14,185,118,215,199,333,1446,2542,8,20687,1149,0,2,0,3,0
40411,27,545,160,89,115,0,13,31,160,7,15,11,17,22,28,78,124,3,495,27,0,2,0,3,0
40412,27,545,10,10,9,9,0,0,19,0,0,0,0,0,0,0,0,0,0,0,0,2,0,3,0
40413,27,545,173,84,99,8,29,36,181,5,12,7,13,17,20,54,81,2,221,12,0,2,0,3,0
40414,27,545,3,1,1,3,0,0,6,0,0,0,0,0,0,0,0,0,0,0,0,2,0,3,0
40415,53,1123,207,111,150,11,0,50,218,5,26,19,36,31,55,133,272,3,943,52,0,2,32,0,0
40416,53,1123,410,198,237,31,55,97,441,11,63,38,72,74,110,414,683,6,4293,238,0,2,32,0,0
40417,346,7028,1457,730,1242,11,6,188,1468,10,292,166,329,302,495,2424,4078,5,22973,1276,1,2,1,0,0
40418,346,7028,74,35,59,1,0,14,75,3,14,7,14,17,21,58,85,1,128,7,0,2,1,0,0
40419,346,7028,245,125,200,5,7,34,250,7,30,17,34,37,51,166,265,3,1053,58,0,2,1,0,0
40420,21,668,339,213,244,17,9,65,356,10,42,26,48,52,74,259,421,5,2410,133,0,2,10,11,0
40421,225,5106,4293,999,3693,19,54,507,4312,9,155,88,170,164,258,1156,1898,4,9368,520,0,2,20,36,0
40422,225,5106,1482,859,1002,125,135,219,1607,16,219,134,251,235,385,1766,3032,9,27804,1544,1,2,20,36,0
40423,6,136,44,22,19,0,19,6,44,2,10,6,12,12,18,35,64,1,77,4,0,2,0,3,0
40424,49,575,647,139,84,35,284,233,682,0,0,0,0,0,0,0,0,0,0,0,0,2,3,1,0
40425,178,4126,77,34,69,0,0,8,77,3,24,16,29,27,45,114,213,1,387,21,0,2,35,24,0
40426,178,4126,712,438,573,51,9,84,763,14,102,71,128,116,199,733,1364,8,11988,666,0,2,35,24,0
40427,80,1593,1020,354,843,12,15,144,1032,8,134,77,144,142,221,970,1580,4,6792,377,0,2,15,9,0
40428,46,961,447,308,343,6,5,95,453,7,96,59,111,103,170,651,1136,4,4600,255,0,2,4,4,0
40429,46,961,322,174,179,16,74,51,338,10,41,26,46,51,72,252,408,5,2291,127,0,2,4,4,0
40430,23,388,424,94,331,4,0,89,428,1,5,5,5,6,10,11,25,0,12,0,0,2,9,9,0
40431,23,388,38,23,23,6,0,8,44,3,11,7,11,14,18,42,68,1,102,5,0,2,9,9,0
40432,335,7154,72,33,56,0,4,12,72,1,1,1,1,2,2,0,2,0,1,0,0,2,25,31,0
40433,335,7154,1454,835,1044,76,110,219,1530,17,275,158,296,292,454,2297,3718,9,34017,1889,1,2,25,31,0
40434,38,783,386,256,301,16,9,68,402,4,59,35,69,63,104,355,621,2,1453,80,0,2,7,11,0
40435,38,783,264,131,164,11,41,46,275,6,38,22,40,44,62,214,338,3,1068,59,0,2,7,11,0
40436,127,2813,1043,504,840,53,9,147,1096,9,180,112,198,189,310,1377,2344,4,11604,644,0,2,1,9,0
40437,127,2813,383,288,292,26,6,62,409,11,65,38,67,76,105,429,656,5,3719,206,0,2,1,9,0
40438,103,1956,1178,367,1042,6,15,115,1184,9,94,51,95,103,146,644,976,4,4439,246,0,2,31,27,0
40439,103,1956,177,108,140,8,0,27,185,6,30,16,32,36,48,162,248,3,794,44,0,2,31,27,0
40440,62,1240,1098,241,925,5,10,155,1103,7,46,25,49,53,74,273,423,3,1580,87,0,2,25,21,0
40441,62,1240,282,202,222,14,2,44,296,8,42,24,43,50,67,250,378,4,1548,86,0,2,25,21,0
40465,11,402,42,7,35,4,0,5,46,1,2,1,2,3,3,2,4,0,2,0,0,2,19,13,1
40466,11,402,11,6,10,0,0,1,11,2,4,2,4,6,6,10,15,1,15,0,0,2,19,13,1
40513,11,402,42,7,35,4,0,5,46,1,2,1,2,3,3,2,4,0,2,0,0,2,20,22,0
40514,11,402,11,6,10,0,0,1,11,2,4,2,4,6,6,10,15,1,15,0,0,2,20,22,0
40515,336,7127,72,33,56,0,4,12,72,1,1,1,1,2,2,0,2,0,1,0,0,2,5,1,0
40516,336,7127,1454,835,1044,76,110,219,1530,17,275,158,296,292,454,2297,3718,9,34017,1889,1,2,5,1,0
40517,67,2779,1020,354,843,12,15,144,1032,8,134,77,144,142,221,970,1580,4,6792,377,0,2,17,0,0
40521,222,4989,722,423,573,19,0,135,741,12,172,101,199,184,300,1320,2257,6,15668,870,0,2,4,3,1
40522,222,4989,1508,847,911,44,250,301,1552,14,148,88,169,162,257,1120,1886,7,15077,837,0,2,4,3,1
40523,222,4989,722,423,573,19,0,135,741,12,172,101,199,184,300,1320,2257,6,15668,870,0,2,4,3,0
40524,222,4989,1508,847,911,44,250,301,1552,14,148,88,169,162,257,1120,1886,7,15077,837,0,2,4,3,0
40525,211,4493,182,127,129,0,0,53,182,5,39,21,42,44,63,217,343,2,926,51,0,2,6,5,0
40526,211,4493,1165,710,800,67,119,181,1232,18,243,153,282,261,435,2000,3492,10,36473,2026,1,2,6,5,0
40527,54,1153,207,111,150,11,0,50,218,5,26,19,36,31,55,133,272,3,943,52,0,2,4,1,0
40528,54,1153,410,198,237,31,55,97,441,11,63,38,72,74,110,414,683,6,4293,238,0,2,4,1,0
40529,225,5106,4293,999,3693,19,54,507,4312,9,155,88,170,164,258,1156,1898,4,9368,520,0,2,10,10,0
40530,225,5106,1482,859,1002,125,135,219,1607,16,219,134,251,235,385,1766,3032,9,27804,1544,1,2,10,10,0
40531,223,5080,722,423,573,19,0,135,741,12,172,101,199,184,300,1320,2257,6,15668,870,0,2,4,3,0
40532,223,5080,1508,847,911,44,250,301,1552,14,148,88,169,162,257,1120,1886,7,15077,837,0,2,4,3,0
40533,336,7168,72,33,56,0,4,12,72,1,1,1,1,2,2,0,2,0,1,0,0,2,9,5,0
40534,336,7168,1454,835,1044,76,110,219,1530,17,275,158,296,292,454,2297,3718,9,34017,1889,1,2,9,5,0
40535,96,4365,1338,495,1086,10,64,173,1348,11,122,82,157,133,239,883,1686,7,11934,663,0,2,44,0,0
40536,117,4645,1513,682,1277,25,13,200,1538,11,199,116,219,210,335,1557,2584,6,15641,868,0,2,2,1,0
40537,68,2962,1020,354,843,12,15,144,1032,8,134,77,144,142,221,970,1580,4,6792,377,0,2,17,0,0
40551,346,7030,1457,730,1242,11,6,188,1468,10,292,166,329,302,495,2424,4078,5,22973,1276,1,2,6,4,0
40552,346,7030,74,35,59,1,0,14,75,3,14,7,14,17,21,58,85,1,128,7,0,2,6,4,0
40553,346,7030,245,125,200,5,7,34,250,7,30,17,34,37,51,166,265,3,1053,58,0,2,6,4,0
40600,83,2370,1523,757,1297,19,12,193,1542,12,193,117,230,205,347,1508,2664,7,19053,1058,0,2,10,3,1
40601,83,2370,701,378,504,33,58,109,734,13,110,68,126,123,194,794,1346,7,10027,557,0,2,10,3,1
40602,89,4427,1523,757,1297,19,12,193,1542,12,193,117,230,205,347,1508,2664,7,19053,1058,0,2,27,0,1
40603,83,2359,1523,757,1297,19,12,193,1542,12,193,117,230,205,347,1508,2664,7,19053,1058,0,2,2,7,1
40604,83,2359,701,378,504,33,58,109,734,13,110,68,126,123,194,794,1346,7,10027,557,0,2,2,7,1
40605,89,4432,1523,757,1297,19,12,193,1542,12,193,117,230,205,347,1508,2664,7,19053,1058,0,2,3,2,1
40606,90,4427,1523,757,1297,19,12,193,1542,12,193,117,230,205,347,1508,2664,7,19053,1058,0,2,14,16,0
40610,83,2359,1523,757,1297,19,12,193,1542,12,193,117,230,205,347,1508,2664,7,19053,1058,0,2,5,3,0
40611,83,2359,701,378,504,33,58,109,734,13,110,68,126,123,194,794,1346,7,10027,557,0,2,5,3,0
40612,90,4427,1523,757,1297,19,12,193,1542,12,193,117,230,205,347,1508,2664,7,19053,1058,0,2,26,0,0
40619,9,228,19,8,11,5,0,4,24,2,5,3,6,7,9,13,25,1,30,1,0,2,1,1,1
40620,9,228,102,59,69,5,3,24,107,6,22,15,28,28,43,113,206,3,789,43,0,2,1,1,1
40621,9,228,106,40,36,3,49,17,109,8,17,13,23,25,36,93,167,5,904,50,0,2,1,1,1
40624,27,542,2,2,2,0,0,0,2,0,0,0,0,0,0,0,0,0,0,0,0,2,1,1,1
40638,27,542,99,48,90,1,3,5,100,0,0,0,0,0,0,0,0,0,0,0,0,2,1,1,1
40639,27,542,8,5,5,2,0,1,10,0,0,0,0,0,0,0,0,0,0,0,0,2,1,1,1
40640,27,542,1217,716,841,84,126,174,1301,14,185,118,215,199,333,1446,2542,8,20687,1149,0,2,1,1,1
40641,27,542,160,89,115,0,13,31,160,7,15,11,17,22,28,78,124,3,495,27,0,2,1,1,1
40642,27,542,10,10,9,9,0,0,19,0,0,0,0,0,0,0,0,0,0,0,0,2,1,1,1
40643,27,542,173,84,99,8,29,36,181,5,12,7,13,17,20,54,81,2,221,12,0,2,1,1,1
40644,27,542,3,1,1,3,0,0,6,0,0,0,0,0,0,0,0,0,0,0,0,2,1,1,1
40645,60,1259,996,429,845,24,10,117,1020,7,76,50,88,83,138,494,879,4,3565,198,0,2,1,1,1
40646,60,1259,456,277,329,12,42,72,468,13,85,50,97,98,147,592,972,7,7212,400,0,2,1,1,1
40647,119,2406,1513,682,1277,25,13,200,1538,11,199,116,219,210,335,1557,2584,6,15641,868,0,2,6,6,1
40648,119,2406,819,519,539,24,98,155,843,15,96,57,106,111,163,690,1107,8,9171,509,0,2,6,6,1
40649,346,7015,1457,730,1242,11,6,188,1468,10,292,166,329,302,495,2424,4078,5,22973,1276,1,2,5,5,1
40650,346,7015,74,35,59,1,0,14,75,3,14,7,14,17,21,58,85,1,128,7,0,2,5,5,1
40651,346,7015,245,125,200,5,7,34,250,7,30,17,34,37,51,166,265,3,1053,58,0,2,5,5,1
40652,21,662,339,213,244,17,9,65,356,10,42,26,48,52,74,259,421,5,2410,133,0,2,2,3,1
40653,225,5091,4293,999,3693,19,54,507,4312,9,155,88,170,164,258,1156,1898,4,9368,520,0,2,5,5,1
40654,225,5091,1482,859,1002,125,135,219,1607,16,219,134,251,235,385,1766,3032,9,27804,1544,1,2,5,5,1
40655,178,4123,77,34,69,0,0,8,77,3,24,16,29,27,45,114,213,1,387,21,0,2,1,1,1
40656,178,4123,712,438,573,51,9,84,763,14,102,71,128,116,199,733,1364,8,11988,666,0,2,1,1,1
40657,80,1581,1020,354,843,12,15,144,1032,8,134,77,144,142,221,970,1580,4,6792,377,0,2,4,5,1
40660,223,5047,722,423,573,19,0,135,741,12,172,101,199,184,300,1320,2257,6,15668,870,0,2,11,11,1
40661,223,5047,1508,847,911,44,250,301,1552,14,148,88,169,162,257,1120,1886,7,15077,837,0,2,11,11,1
40662,127,2807,1043,504,840,53,9,147,1096,9,180,112,198,189,310,1377,2344,4,11604,644,0,2,2,2,1
40663,127,2807,383,288,292,26,6,62,409,11,65,38,67,76,105,429,656,5,3719,206,0,2,2,2,1
40664,103,1953,1178,367,1042,6,15,115,1184,9,94,51,95,103,146,644,976,4,4439,246,0,2,1,1,1
40665,103,1953,177,108,140,8,0,27,185,6,30,16,32,36,48,162,248,3,794,44,0,2,1,1,1
40666,191,3890,1943,715,1694,26,18,214,1969,12,185,120,237,197,357,1436,2721,7,20915,1161,0,2,2,2,1
40667,191,3890,1168,838,957,57,25,144,1225,19,348,224,416,367,640,3018,5452,11,61921,3440,1,2,2,2,1
40668,16,477,442,244,305,14,16,103,456,11,68,45,75,79,120,452,756,6,4588,254,0,2,1,1,1
40669,16,477,182,102,99,11,40,35,193,3,11,6,11,14,17,42,64,1,97,5,0,2,1,1,1
40670,9,228,19,8,11,5,0,4,24,2,5,3,6,7,9,13,25,1,30,1,0,2,1,1,0
40671,9,228,102,59,69,5,3,24,107,6,22,15,28,28,43,113,206,3,789,43,0,2,1,1,0
40672,9,228,106,40,36,3,49,17,109,8,17,13,23,25,36,93,167,5,904,50,0,2,1,1,0
40675,27,542,2,2,2,0,0,0,2,0,0,0,0,0,0,0,0,0,0,0,0,2,1,1,0
40689,27,542,99,48,90,1,3,5,100,0,0,0,0,0,0,0,0,0,0,0,0,2,1,1,0
40690,27,542,8,5,5,2,0,1,10,0,0,0,0,0,0,0,0,0,0,0,0,2,1,1,0
40691,27,542,1217,716,841,84,126,174,1301,14,185,118,215,199,333,1446,2542,8,20687,1149,0,2,1,1,0
40692,27,542,160,89,115,0,13,31,160,7,15,11,17,22,28,78,124,3,495,27,0,2,1,1,0
40693,27,542,10,10,9,9,0,0,19,0,0,0,0,0,0,0,0,0,0,0,0,2,1,1,0
40694,27,542,173,84,99,8,29,36,181,5,12,7,13,17,20,54,81,2,221,12,0,2,1,1,0
40695,27,542,3,1,1,3,0,0,6,0,0,0,0,0,0,0,0,0,0,0,0,2,1,1,0
40696,60,1259,996,429,845,24,10,117,1020,7,76,50,88,83,138,494,879,4,3565,198,0,2,1,1,0
40697,60,1259,456,277,329,12,42,72,468,13,85,50,97,98,147,592,972,7,7212,400,0,2,1,1,0
40698,119,2406,1513,682,1277,25,13,200,1538,11,199,116,219,210,335,1557,2584,6,15641,868,0,2,6,6,0
40699,119,2406,819,519,539,24,98,155,843,15,96,57,106,111,163,690,1107,8,9171,509,0,2,6,6,0
40700,346,7015,1457,730,1242,11,6,188,1468,10,292,166,329,302,495,2424,4078,5,22973,1276,1,2,5,5,0
40701,346,7015,74,35,59,1,0,14,75,3,14,7,14,17,21,58,85,1,128,7,0,2,5,5,0
40702,346,7015,245,125,200,5,7,34,250,7,30,17,34,37,51,166,265,3,1053,58,0,2,5,5,0
40703,21,662,339,213,244,17,9,65,356,10,42,26,48,52,74,259,421,5,2410,133,0,2,2,3,0
40704,225,5091,4293,999,3693,19,54,507,4312,9,155,88,170,164,258,1156,1898,4,9368,520,0,2,5,5,0
40705,225,5091,1482,859,1002,125,135,219,1607,16,219,134,251,235,385,1766,3032,9,27804,1544,1,2,5,5,0
40706,178,4123,77,34,69,0,0,8,77,3,24,16,29,27,45,114,213,1,387,21,0,2,1,1,0
40707,178,4123,712,438,573,51,9,84,763,14,102,71,128,116,199,733,1364,8,11988,666,0,2,1,1,0
40708,80,1581,1020,354,843,12,15,144,1032,8,134,77,144,142,221,970,1580,4,6792,377,0,2,4,5,0
40711,223,5047,722,423,573,19,0,135,741,12,172,101,199,184,300,1320,2257,6,15668,870,0,2,11,11,0
40712,223,5047,1508,847,911,44,250,301,1552,14,148,88,169,162,257,1120,1886,7,15077,837,0,2,11,11,0
40713,127,2807,1043,504,840,53,9,147,1096,9,180,112,198,189,310,1377,2344,4,11604,644,0,2,2,2,0
40714,127,2807,383,288,292,26,6,62,409,11,65,38,67,76,105,429,656,5,3719,206,0,2,2,2,0
40715,103,1953,1178,367,1042,6,15,115,1184,9,94,51,95,103,146,644,976,4,4439,246,0,2,1,1,0
40716,103,1953,177,108,140,8,0,27,185,6,30,16,32,36,48,162,248,3,794,44,0,2,1,1,0
40717,191,3890,1943,715,1694,26,18,214,1969,12,185,120,237,197,357,1436,2721,7,20915,1161,0,2,2,2,0
40718,191,3890,1168,838,957,57,25,144,1225,19,348,224,416,367,640,3018,5452,11,61921,3440,1,2,2,2,0
40719,16,477,442,244,305,14,16,103,456,11,68,45,75,79,120,452,756,6,4588,254,0,2,1,1,0
40720,16,477,182,102,99,11,40,35,193,3,11,6,11,14,17,42,64,1,97,5,0,2,1,1,0
40721,347,7008,1457,730,1242,11,6,188,1468,10,292,166,329,302,495,2424,4078,5,22973,1276,1,2,4,1,1
40722,347,7008,74,35,59,1,0,14,75,3,14,7,14,17,21,58,85,1,128,7,0,2,4,1,1
40723,347,7008,245,125,200,5,7,34,250,7,30,17,34,37,51,166,265,3,1053,58,0,2,4,1,1
40724,347,7009,1457,730,1242,11,6,188,1468,10,292,166,329,302,495,2424,4078,5,22973,1276,1,2,23,18,0
40725,347,7009,74,35,59,1,0,14,75,3,14,7,14,17,21,58,85,1,128,7,0,2,23,18,0
40726,347,7009,245,125,200,5,7,34,250,7,30,17,34,37,51,166,265,3,1053,58,0,2,23,18,0
40727,348,7017,1457,730,1242,11,6,188,1468,10,292,166,329,302,495,2424,4078,5,22973,1276,1,2,15,7,0
40728,348,7017,74,35,59,1,0,14,75,3,14,7,14,17,21,58,85,1,128,7,0,2,15,7,0
40729,348,7017,245,125,200,5,7,34,250,7,30,17,34,37,51,166,265,3,1053,58,0,2,15,7,0
40730,348,7017,1457,730,1242,11,6,188,1468,10,292,166,329,302,495,2424,4078,5,22973,1276,1,2,9,9,1
40731,348,7017,74,35,59,1,0,14,75,3,14,7,14,17,21,58,85,1,128,7,0,2,9,9,1
40732,348,7017,245,125,200,5,7,34,250,7,30,17,34,37,51,166,265,3,1053,58,0,2,9,9,1
40733,348,7014,1457,730,1242,11,6,188,1468,10,292,166,329,302,495,2424,4078,5,22973,1276,1,2,3,4,1
40734,348,7014,74,35,59,1,0,14,75,3,14,7,14,17,21,58,85,1,128,7,0,2,3,4,1
40735,348,7014,245,125,200,5,7,34,250,7,30,17,34,37,51,166,265,3,1053,58,0,2,3,4,1
40736,348,7007,1457,730,1242,11,6,188,1468,10,292,166,329,302,495,2424,4078,5,22973,1276,1,2,3,4,0
40737,348,7007,74,35,59,1,0,14,75,3,14,7,14,17,21,58,85,1,128,7,0,2,3,4,0
40738,348,7007,245,125,200,5,7,34,250,7,30,17,34,37,51,166,265,3,1053,58,0,2,3,4,0
40739,348,7007,1457,730,1242,11,6,188,1468,10,292,166,329,302,495,2424,4078,5,22973,1276,1,2,36,22,0
40740,348,7007,74,35,59,1,0,14,75,3,14,7,14,17,21,58,85,1,128,7,0,2,36,22,0
40741,348,7007,245,125,200,5,7,34,250,7,30,17,34,37,51,166,265,3,1053,58,0,2,36,22,0
40791,211,4493,182,127,129,0,0,53,182,5,39,21,42,44,63,217,343,2,926,51,0,2,1,0,0
40792,211,4493,1165,710,800,67,119,181,1232,18,243,153,282,261,435,2000,3492,10,36473,2026,1,2,1,0,0
40797,27,542,2,2,2,0,0,0,2,0,0,0,0,0,0,0,0,0,0,0,0,2,5,20,0
40811,27,542,99,48,90,1,3,5,100,0,0,0,0,0,0,0,0,0,0,0,0,2,5,20,0
40812,27,542,8,5,5,2,0,1,10,0,0,0,0,0,0,0,0,0,0,0,0,2,5,20,0
40813,27,542,1217,716,841,84,126,174,1301,14,185,118,215,199,333,1446,2542,8,20687,1149,0,2,5,20,0
40814,27,542,160,89,115,0,13,31,160,7,15,11,17,22,28,78,124,3,495,27,0,2,5,20,0
40815,27,542,10,10,9,9,0,0,19,0,0,0,0,0,0,0,0,0,0,0,0,2,5,20,0
40816,27,542,173,84,99,8,29,36,181,5,12,7,13,17,20,54,81,2,221,12,0,2,5,20,0
40817,27,542,3,1,1,3,0,0,6,0,0,0,0,0,0,0,0,0,0,0,0,2,5,20,0
40818,163,5086,1660,832,1314,41,38,274,1701,20,312,209,395,332,604,2671,5058,12,64042,3557,1,2,2,2,0
40819,163,5086,1057,646,719,113,100,145,1170,18,215,134,248,233,382,1740,3004,10,31186,1732,1,2,2,2,0
40820,17,349,95,58,50,9,16,20,104,12,33,24,45,45,69,209,378,8,3100,172,0,0,102,0,0
40821,82,1800,477,336,357,30,23,73,507,16,194,134,250,210,384,1538,2962,10,30538,1696,0,2,4,3,0
40822,60,1259,996,429,845,24,10,117,1020,7,76,50,88,83,138,494,879,4,3565,198,0,2,4,4,0
40823,60,1259,456,277,329,12,42,72,468,13,85,50,97,98,147,592,972,7,7212,400,0,2,4,4,0
40824,119,2406,1513,682,1277,25,13,200,1538,11,199,116,219,210,335,1557,2584,6,15641,868,0,2,6,5,0
40825,119,2406,819,519,539,24,98,155,843,15,96,57,106,111,163,690,1107,8,9171,509,0,2,6,5,0
40826,54,1153,207,111,150,11,0,50,218,5,26,19,36,31,55,133,272,3,943,52,0,2,65,4,0
40827,54,1153,410,198,237,31,55,97,441,11,63,38,72,74,110,414,683,6,4293,238,0,2,65,4,0
40828,348,7028,1457,730,1242,11,6,188,1468,10,292,166,329,302,495,2424,4078,5,22973,1276,1,2,13,9,0
40829,348,7028,74,35,59,1,0,14,75,3,14,7,14,17,21,58,85,1,128,7,0,2,13,9,0
40830,348,7028,245,125,200,5,7,34,250,7,30,17,34,37,51,166,265,3,1053,58,0,2,13,9,0
40831,21,662,339,213,244,17,9,65,356,10,42,26,48,52,74,259,421,5,2410,133,0,2,19,20,0
40833,56,1603,1455,414,1257,16,76,112,1471,5,41,23,46,46,69,231,381,2,1069,59,0,2,4,3,0
40834,56,1603,669,365,481,22,61,110,691,15,103,63,122,118,185,747,1273,8,11311,628,0,2,4,3,0
40835,225,5091,4293,999,3693,19,54,507,4312,9,155,88,170,164,258,1156,1898,4,9368,520,0,2,22,37,0
40836,225,5091,1482,859,1002,125,135,219,1607,16,219,134,251,235,385,1766,3032,9,27804,1544,1,2,22,37,0
40837,6,136,44,22,19,0,19,6,44,2,10,6,12,12,18,35,64,1,77,4,0,2,2,3,0
40840,49,575,647,139,84,35,284,233,682,0,0,0,0,0,0,0,0,0,0,0,0,2,5,2,0
40841,83,2359,1523,757,1297,19,12,193,1542,12,193,117,230,205,347,1508,2664,7,19053,1058,0,2,47,7,0
40842,83,2359,701,378,504,33,58,109,734,13,110,68,126,123,194,794,1346,7,10027,557,0,2,47,7,0
40843,178,4123,77,34,69,0,0,8,77,3,24,16,29,27,45,114,213,1,387,21,0,2,39,32,0
40844,178,4123,712,438,573,51,9,84,763,14,102,71,128,116,199,733,1364,8,11988,666,0,2,39,32,0
40845,80,1581,1020,354,843,12,15,144,1032,8,134,77,144,142,221,970,1580,4,6792,377,0,2,119,56,0
40846,46,955,447,308,343,6,5,95,453,7,96,59,111,103,170,651,1136,4,4600,255,0,2,5,4,0
40847,46,955,322,174,179,16,74,51,338,10,41,26,46,51,72,252,408,5,2291,127,0,2,5,4,0
40848,23,388,424,94,331,4,0,89,428,1,5,5,5,6,10,11,25,0,12,0,0,2,10,9,0
40849,23,388,38,23,23,6,0,8,44,3,11,7,11,14,18,42,68,1,102,5,0,2,10,9,0
40852,223,5047,722,423,573,19,0,135,741,12,172,101,199,184,300,1320,2257,6,15668,870,0,2,26,16,0
40853,223,5047,1508,847,911,44,250,301,1552,14,148,88,169,162,257,1120,1886,7,15077,837,0,2,26,16,0
40854,336,7168,72,33,56,0,4,12,72,1,1,1,1,2,2,0,2,0,1,0,0,2,95,80,0
40855,336,7168,1454,835,1044,76,110,219,1530,17,275,158,296,292,454,2297,3718,9,34017,1889,1,2,95,80,0
40856,38,783,386,256,301,16,9,68,402,4,59,35,69,63,104,355,621,2,1453,80,0,2,19,51,0
40857,38,783,264,131,164,11,41,46,275,6,38,22,40,44,62,214,338,3,1068,59,0,2,19,51,0
40860,127,2807,1043,504,840,53,9,147,1096,9,180,112,198,189,310,1377,2344,4,11604,644,0,2,18,16,0
40861,127,2807,383,288,292,26,6,62,409,11,65,38,67,76,105,429,656,5,3719,206,0,2,18,16,0
40866,103,1953,1178,367,1042,6,15,115,1184,9,94,51,95,103,146,644,976,4,4439,246,0,2,36,32,0
40867,103,1953,177,108,140,8,0,27,185,6,30,16,32,36,48,162,248,3,794,44,0,2,36,32,0
40868,191,3890,1943,715,1694,26,18,214,1969,12,185,120,237,197,357,1436,2721,7,20915,1161,0,2,53,19,0
40869,191,3890,1168,838,957,57,25,144,1225,19,348,224,416,367,640,3018,5452,11,61921,3440,1,2,53,19,0
40870,16,477,442,244,305,14,16,103,456,11,68,45,75,79,120,452,756,6,4588,254,0,2,2,0,0
40871,16,477,182,102,99,11,40,35,193,3,11,6,11,14,17,42,64,1,97,5,0,2,2,0,0
40872,62,1240,1098,241,925,5,10,155,1103,7,46,25,49,53,74,273,423,3,1580,87,0,2,26,22,0
40873,62,1240,282,202,222,14,2,44,296,8,42,24,43,50,67,250,378,4,1548,86,0,2,26,22,0
40922,80,3429,1289,550,1043,56,32,155,1345,10,167,93,185,177,278,1266,2075,5,11498,638,0,2,63,9,0
40923,34,997,182,127,129,0,0,53,182,5,39,21,42,44,63,217,343,2,926,51,0,2,4,3,0
40924,137,6599,1392,870,1177,35,17,170,1427,14,494,280,531,508,811,4473,7289,7,54850,3047,2,2,6,5,0
40925,91,3011,773,419,590,28,0,166,801,10,204,113,217,214,330,1598,2554,5,13587,754,0,2,12,11,0
40926,7,263,75,38,59,1,3,12,76,2,4,2,4,6,6,10,15,1,15,0,0,2,3,2,0
40928,96,4365,1338,495,1086,10,64,173,1348,11,122,82,157,133,239,883,1686,7,11934,663,0,2,35,34,0
40929,147,6797,139,89,101,2,0,35,141,7,54,34,62,61,96,330,569,4,2287,127,0,2,75,64,0
40930,147,6797,7,5,5,0,0,2,7,1,2,1,2,3,3,2,4,0,2,0,0,2,75,64,0
40933,112,5710,1782,648,1425,9,47,279,1791,8,171,97,189,179,286,1292,2140,4,9462,525,0,2,154,53,0
40934,20,541,256,139,192,9,7,47,265,4,23,12,24,27,36,112,171,2,357,19,0,2,17,10,0
40935,23,601,102,59,69,5,3,24,107,6,22,15,28,28,43,113,206,3,789,43,0,2,2,2,0
40936,109,4106,1450,624,1228,12,26,181,1462,14,306,186,354,320,540,2580,4493,8,36391,2021,1,2,128,45,0
40937,149,4136,1660,832,1314,41,38,274,1701,20,312,209,395,332,604,2671,5058,12,64042,3557,1,2,24,5,0
40938,117,4645,1513,682,1277,25,13,200,1538,11,199,116,219,210,335,1557,2584,6,15641,868,0,2,29,16,0
40939,59,3310,1296,573,1062,40,33,157,1336,8,201,118,231,209,349,1561,2689,4,12365,686,0,2,35,18,0
40940,10,236,207,111,150,11,0,50,218,5,26,19,36,31,55,133,272,3,943,52,0,2,30,4,0
40941,78,4093,1457,730,1242,11,6,188,1468,10,292,166,329,302,495,2424,4078,5,22973,1276,1,2,22,20,0
40942,38,2286,652,304,544,16,6,88,668,6,89,51,101,95,152,591,998,3,3399,188,0,2,5,4,0
40943,62,2878,1455,414,1257,16,76,112,1471,5,41,23,46,46,69,231,381,2,1069,59,0,2,37,9,0
40945,8,273,74,35,59,1,0,14,75,3,14,7,14,17,21,58,85,1,128,7,0,2,2,1,0
40946,90,4427,1523,757,1297,19,12,193,1542,12,193,117,230,205,347,1508,2664,7,19053,1058,0,2,85,8,0
40947,68,2962,1020,354,843,12,15,144,1032,8,134,77,144,142,221,970,1580,4,6792,377,0,2,41,24,0
40948,37,1624,447,308,343,6,5,95,453,7,96,59,111,103,170,651,1136,4,4600,255,0,2,5,4,0
40949,21,661,424,94,331,4,0,89,428,1,5,5,5,6,10,11,25,0,12,0,0,2,6,5,0
40950,40,2367,334,251,279,10,4,40,344,5,127,74,143,132,217,899,1528,2,4303,239,0,2,11,10,0
40951,12,492,184,100,137,2,15,30,186,6,38,20,39,44,59,214,322,3,991,55,0,2,4,3,0
40952,35,1623,1293,570,1093,25,15,163,1318,10,195,123,241,205,364,1516,2795,6,17273,959,0,2,52,16,0
40953,36,1978,384,251,317,7,8,52,391,11,70,44,84,81,128,467,811,6,5355,297,0,2,13,12,0
40954,15,638,722,423,573,19,0,135,741,12,172,101,199,184,300,1320,2257,6,15668,870,0,2,4,3,0
40955,31,1439,386,256,301,16,9,68,402,4,59,35,69,63,104,355,621,2,1453,80,0,2,29,14,0
40956,16,1209,215,129,180,6,0,29,221,8,65,43,72,73,115,415,711,4,3153,175,0,2,2,1,0
40957,69,2856,1043,504,840,53,9,147,1096,9,180,112,198,189,310,1377,2344,4,11604,644,0,2,10,10,0
40958,14,529,295,56,236,0,4,54,295,2,9,5,10,11,15,30,51,1,57,3,0,2,13,11,0
40959,25,1027,373,158,315,8,0,51,381,5,76,44,79,81,123,486,779,2,2026,112,0,2,7,6,0
40960,71,3006,1178,367,1042,6,15,115,1184,9,94,51,95,103,146,644,976,4,4439,246,0,2,11,10,0
40961,73,3738,1943,715,1694,26,18,214,1969,12,185,120,237,197,357,1436,2721,7,20915,1161,0,2,22,21,0
40962,14,825,442,244,305,14,16,103,456,11,68,45,75,79,120,452,756,6,4588,254,0,2,3,2,0
40963,48,1784,1098,241,925,5,10,155,1103,7,46,25,49,53,74,273,423,3,1580,87,0,2,3,2,0
40965,60,1265,996,429,845,24,10,117,1020,7,76,50,88,83,138,494,879,4,3565,198,0,2,2,2,0
40966,60,1265,456,277,329,12,42,72,468,13,85,50,97,98,147,592,972,7,7212,400,0,2,2,2,0
40969,14,348,601,196,481,2,23,85,603,8,63,36,72,71,108,400,664,4,3036,168,0,2,3,1,1
40970,14,348,156,79,106,5,16,28,161,5,14,8,15,19,23,64,97,2,261,14,0,2,3,1,1
40971,10,361,601,196,481,2,23,85,603,8,63,36,72,71,108,400,664,4,3036,168,0,2,29,0,1
40972,54,1161,207,111,150,11,0,50,218,5,26,19,36,31,55,133,272,3,943,52,0,2,2,0,1
40973,54,1161,410,198,237,31,55,97,441,11,63,38,72,74,110,414,683,6,4293,238,0,2,2,0,1
40974,19,407,601,196,481,2,23,85,603,8,63,36,72,71,108,400,664,4,3036,168,0,2,14,1,1
40975,19,407,156,79,106,5,16,28,161,5,14,8,15,19,23,64,97,2,261,14,0,2,14,1,1
40976,11,447,601,196,481,2,23,85,603,8,63,36,72,71,108,400,664,4,3036,168,0,2,31,0,1
40977,54,1161,207,111,150,11,0,50,218,5,26,19,36,31,55,133,272,3,943,52,0,2,2,0,0
40978,54,1161,410,198,237,31,55,97,441,11,63,38,72,74,110,414,683,6,4293,238,0,2,2,0,0
40979,19,407,601,196,481,2,23,85,603,8,63,36,72,71,108,400,664,4,3036,168,0,2,16,1,0
40980,19,407,156,79,106,5,16,28,161,5,14,8,15,19,23,64,97,2,261,14,0,2,16,1,0
40981,11,447,601,196,481,2,23,85,603,8,63,36,72,71,108,400,664,4,3036,168,0,2,60,0,0
40982,60,1689,1455,414,1257,16,76,112,1471,5,41,23,46,46,69,231,381,2,1069,59,0,2,29,0,1
40983,60,1689,669,365,481,22,61,110,691,15,103,63,122,118,185,747,1273,8,11311,628,0,2,29,0,1
40984,63,2918,1455,414,1257,16,76,112,1471,5,41,23,46,46,69,231,381,2,1069,59,0,2,22,0,1
40985,60,1689,1455,414,1257,16,76,112,1471,5,41,23,46,46,69,231,381,2,1069,59,0,2,29,0,0
40986,60,1689,669,365,481,22,61,110,691,15,103,63,122,118,185,747,1273,8,11311,628,0,2,29,0,0
40987,63,2918,1455,414,1257,16,76,112,1471,5,41,23,46,46,69,231,381,2,1069,59,0,2,22,0,0
40998,38,787,386,256,301,16,9,68,402,4,59,35,69,63,104,355,621,2,1453,80,0,2,1,1,0
40999,38,787,264,131,164,11,41,46,275,6,38,22,40,44,62,214,338,3,1068,59,0,2,1,1,0
41000,31,1467,386,256,301,16,9,68,402,4,59,35,69,63,104,355,621,2,1453,80,0,2,10,7,0
41004,19,401,601,196,481,2,23,85,603,8,63,36,72,71,108,400,664,4,3036,168,0,2,0,1,1
41005,19,401,156,79,106,5,16,28,161,5,14,8,15,19,23,64,97,2,261,14,0,2,0,1,1
41006,32,1464,386,256,301,16,9,68,402,4,59,35,69,63,104,355,621,2,1453,80,0,2,8,3,1
41007,12,476,601,196,481,2,23,85,603,8,63,36,72,71,108,400,664,4,3036,168,0,2,34,12,1
41008,19,401,601,196,481,2,23,85,603,8,63,36,72,71,108,400,664,4,3036,168,0,2,0,1,0
41009,19,401,156,79,106,5,16,28,161,5,14,8,15,19,23,64,97,2,261,14,0,2,0,1,0
41010,32,1492,386,256,301,16,9,68,402,4,59,35,69,63,104,355,621,2,1453,80,0,2,8,3,0
41011,12,476,601,196,481,2,23,85,603,8,63,36,72,71,108,400,664,4,3036,168,0,2,34,12,0
41012,150,4203,1660,832,1314,41,38,274,1701,20,312,209,395,332,604,2671,5058,12,64042,3557,1,2,14,0,1
41013,163,5080,1660,832,1314,41,38,274,1701,20,312,209,395,332,604,2671,5058,12,64042,3557,1,2,1,2,0
41014,163,5080,1057,646,719,113,100,145,1170,18,215,134,248,233,382,1740,3004,10,31186,1732,1,2,1,2,0
41015,11,402,42,7,35,4,0,5,46,1,2,1,2,3,3,2,4,0,2,0,0,2,1,1,1
41016,11,402,11,6,10,0,0,1,11,2,4,2,4,6,6,10,15,1,15,0,0,2,1,1,1
41021,32,1492,386,256,301,16,9,68,402,4,59,35,69,63,104,355,621,2,1453,80,0,2,18,10,0
41025,11,402,42,7,35,4,0,5,46,1,2,1,2,3,3,2,4,0,2,0,0,2,1,1,0
41026,11,402,11,6,10,0,0,1,11,2,4,2,4,6,6,10,15,1,15,0,0,2,1,1,0
41027,150,4203,1660,832,1314,41,38,274,1701,20,312,209,395,332,604,2671,5058,12,64042,3557,1,2,14,0,0
41028,349,7049,1457,730,1242,11,6,188,1468,10,292,166,329,302,495,2424,4078,5,22973,1276,1,2,17,7,1
41029,349,7049,74,35,59,1,0,14,75,3,14,7,14,17,21,58,85,1,128,7,0,2,17,7,1
41030,349,7049,245,125,200,5,7,34,250,7,30,17,34,37,51,166,265,3,1053,58,0,2,17,7,1
41031,27,953,74,35,59,1,0,14,75,3,14,7,14,17,21,58,85,1,128,7,0,2,26,1,1
41032,27,953,245,125,200,5,7,34,250,7,30,17,34,37,51,166,265,3,1053,58,0,2,26,1,1
41033,39,2355,652,304,544,16,6,88,668,6,89,51,101,95,152,591,998,3,3399,188,0,2,12,0,1
41034,27,954,74,35,59,1,0,14,75,3,14,7,14,17,21,58,85,1,128,7,0,2,8,0,0
41035,27,954,245,125,200,5,7,34,250,7,30,17,34,37,51,166,265,3,1053,58,0,2,8,0,0
41036,349,7049,1457,730,1242,11,6,188,1468,10,292,166,329,302,495,2424,4078,5,22973,1276,1,2,17,7,0
41037,349,7049,74,35,59,1,0,14,75,3,14,7,14,17,21,58,85,1,128,7,0,2,17,7,0
41038,349,7049,245,125,200,5,7,34,250,7,30,17,34,37,51,166,265,3,1053,58,0,2,17,7,0
41039,27,954,74,35,59,1,0,14,75,3,14,7,14,17,21,58,85,1,128,7,0,2,34,1,0
41040,27,954,245,125,200,5,7,34,250,7,30,17,34,37,51,166,265,3,1053,58,0,2,34,1,0
41041,39,2355,652,304,544,16,6,88,668,6,89,51,101,95,152,591,998,3,3399,188,0,2,12,0,0
41042,128,2606,1513,682,1277,25,13,200,1538,11,199,116,219,210,335,1557,2584,6,15641,868,0,2,50,1,1
41043,128,2606,819,519,539,24,98,155,843,15,96,57,106,111,163,690,1107,8,9171,509,0,2,50,1,1
41044,128,2606,1513,682,1277,25,13,200,1538,11,199,116,219,210,335,1557,2584,6,15641,868,0,2,1,1,0
41045,128,2606,819,519,539,24,98,155,843,15,96,57,106,111,163,690,1107,8,9171,509,0,2,1,1,0
41046,128,2606,1513,682,1277,25,13,200,1538,11,199,116,219,210,335,1557,2584,6,15641,868,0,2,50,1,0
41047,128,2606,819,519,539,24,98,155,843,15,96,57,106,111,163,690,1107,8,9171,509,0,2,50,1,0
41048,178,4125,77,34,69,0,0,8,77,3,24,16,29,27,45,114,213,1,387,21,0,2,5,1,1
41049,178,4125,712,438,573,51,9,84,763,14,102,71,128,116,199,733,1364,8,11988,666,0,2,5,1,1
41050,80,3427,1289,550,1043,56,32,155,1345,10,167,93,185,177,278,1266,2075,5,11498,638,0,2,2,2,1
41051,66,3414,1296,573,1062,40,33,157,1336,8,201,118,231,209,349,1561,2689,4,12365,686,0,2,14,5,1
41052,192,3902,1943,715,1694,26,18,214,1969,12,185,120,237,197,357,1436,2721,7,20915,1161,0,2,1,1,0
41053,192,3902,1168,838,957,57,25,144,1225,19,348,224,416,367,640,3018,5452,11,61921,3440,1,2,1,1,0
41054,69,2856,1043,504,840,53,9,147,1096,9,180,112,198,189,310,1377,2344,4,11604,644,0,2,2,2,0
41055,74,3770,1943,715,1694,26,18,214,1969,12,185,120,237,197,357,1436,2721,7,20915,1161,0,2,9,0,0
41056,19,408,601,196,481,2,23,85,603,8,63,36,72,71,108,400,664,4,3036,168,0,2,5,4,1
41057,19,408,156,79,106,5,16,28,161,5,14,8,15,19,23,64,97,2,261,14,0,2,5,4,1
41058,12,476,601,196,481,2,23,85,603,8,63,36,72,71,108,400,664,4,3036,168,0,2,1,1,1
41059,349,7049,1457,730,1242,11,6,188,1468,10,292,166,329,302,495,2424,4078,5,22973,1276,1,2,3,3,1
41060,349,7049,74,35,59,1,0,14,75,3,14,7,14,17,21,58,85,1,128,7,0,2,3,3,1
41061,349,7049,245,125,200,5,7,34,250,7,30,17,34,37,51,166,265,3,1053,58,0,2,3,3,1
41062,49,575,647,139,84,35,284,233,682,0,0,0,0,0,0,0,0,0,0,0,0,2,1,1,1
41063,349,7049,1457,730,1242,11,6,188,1468,10,292,166,329,302,495,2424,4078,5,22973,1276,1,2,3,3,0
41064,349,7049,74,35,59,1,0,14,75,3,14,7,14,17,21,58,85,1,128,7,0,2,3,3,0
41065,349,7049,245,125,200,5,7,34,250,7,30,17,34,37,51,166,265,3,1053,58,0,2,3,3,0
41071,349,7049,1457,730,1242,11,6,188,1468,10,292,166,329,302,495,2424,4078,5,22973,1276,1,2,20,10,0
41072,349,7049,74,35,59,1,0,14,75,3,14,7,14,17,21,58,85,1,128,7,0,2,20,10,0
41073,349,7049,245,125,200,5,7,34,250,7,30,17,34,37,51,166,265,3,1053,58,0,2,20,10,0
41081,40,834,386,256,301,16,9,68,402,4,59,35,69,63,104,355,621,2,1453,80,0,2,35,29,1
41082,40,834,264,131,164,11,41,46,275,6,38,22,40,44,62,214,338,3,1068,59,0,2,35,29,1
41083,38,1637,386,256,301,16,9,68,402,4,59,35,69,63,104,355,621,2,1453,80,0,2,48,10,1
41084,19,408,601,196,481,2,23,85,603,8,63,36,72,71,108,400,664,4,3036,168,0,2,5,4,0
41085,19,408,156,79,106,5,16,28,161,5,14,8,15,19,23,64,97,2,261,14,0,2,5,4,0
41086,12,476,601,196,481,2,23,85,603,8,63,36,72,71,108,400,664,4,3036,168,0,2,1,1,0
41087,212,4584,182,127,129,0,0,53,182,5,39,21,42,44,63,217,343,2,926,51,0,2,34,7,1
41088,212,4584,1165,710,800,67,119,181,1232,18,243,153,282,261,435,2000,3492,10,36473,2026,1,2,34,7,1
41089,143,6718,1392,870,1177,35,17,170,1427,14,494,280,531,508,811,4473,7289,7,54850,3047,2,2,33,0,1
41090,212,4584,182,127,129,0,0,53,182,5,39,21,42,44,63,217,343,2,926,51,0,2,34,7,0
41091,212,4584,1165,710,800,67,119,181,1232,18,243,153,282,261,435,2000,3492,10,36473,2026,1,2,34,7,0
41092,143,6718,1392,870,1177,35,17,170,1427,14,494,280,531,508,811,4473,7289,7,54850,3047,2,2,33,0,0
41099,213,4595,182,127,129,0,0,53,182,5,39,21,42,44,63,217,343,2,926,51,0,2,5,2,1
41100,213,4595,1165,710,800,67,119,181,1232,18,243,153,282,261,435,2000,3492,10,36473,2026,1,2,5,2,1
41101,147,6814,1392,870,1177,35,17,170,1427,14,494,280,531,508,811,4473,7289,7,54850,3047,2,2,23,0,1
41102,306,6621,72,33,56,0,4,12,72,1,1,1,1,2,2,0,2,0,1,0,0,2,0,250,0
41103,306,6621,1454,835,1044,76,110,219,1530,17,275,158,296,292,454,2297,3718,9,34017,1889,1,2,0,250,0
41104,286,6178,72,33,56,0,4,12,72,1,1,1,1,2,2,0,2,0,1,0,0,2,0,174,1
41105,286,6178,1454,835,1044,76,110,219,1530,17,275,158,296,292,454,2297,3718,9,34017,1889,1,2,0,174,1
41106,50,1010,757,253,292,73,244,162,830,13,61,38,67,74,105,409,651,7,4654,258,0,0,430,0,1
41107,286,6178,72,33,56,0,4,12,72,1,1,1,1,2,2,0,2,0,1,0,0,2,0,424,0
41108,286,6178,1454,835,1044,76,110,219,1530,17,275,158,296,292,454,2297,3718,9,34017,1889,1,2,0,424,0
41109,50,1010,757,253,292,73,244,162,830,13,61,38,67,74,105,409,651,7,4654,258,0,0,430,0,0
41110,361,7632,72,33,56,0,4,12,72,1,1,1,1,2,2,0,2,0,1,0,0,2,295,137,1
41111,361,7632,1454,835,1044,76,110,219,1530,17,275,158,296,292,454,2297,3718,9,34017,1889,1,2,295,137,1
41112,56,3288,520,294,400,33,13,81,553,10,261,204,367,271,571,2128,4614,7,32445,1802,1,2,105,26,1
41113,286,6178,72,33,56,0,4,12,72,1,1,1,1,2,2,0,2,0,1,0,0,2,0,582,1
41114,286,6178,1454,835,1044,76,110,219,1530,17,275,158,296,292,454,2297,3718,9,34017,1889,1,2,0,582,1
41115,75,1474,757,253,292,73,244,162,830,13,61,38,67,74,105,409,651,7,4654,258,0,0,588,0,1
41116,227,5124,4293,999,3693,19,54,507,4312,9,155,88,170,164,258,1156,1898,4,9368,520,0,2,8,2,1
41117,227,5124,1482,859,1002,125,135,219,1607,16,219,134,251,235,385,1766,3032,9,27804,1544,1,2,8,2,1
41118,148,6830,139,89,101,2,0,35,141,7,54,34,62,61,96,330,569,4,2287,127,0,2,26,0,1
41119,148,6830,7,5,5,0,0,2,7,1,2,1,2,3,3,2,4,0,2,0,0,2,26,0,1
41120,49,575,647,139,84,35,284,233,682,0,0,0,0,0,0,0,0,0,0,0,0,2,44,15,1
41121,49,575,647,139,84,35,284,233,682,0,0,0,0,0,0,0,0,0,0,0,0,2,44,15,0
41122,60,1673,1455,414,1257,16,76,112,1471,5,41,23,46,46,69,231,381,2,1069,59,0,2,4,5,1
41123,60,1673,669,365,481,22,61,110,691,15,103,63,122,118,185,747,1273,8,11311,628,0,2,4,5,1
41124,64,2957,1455,414,1257,16,76,112,1471,5,41,23,46,46,69,231,381,2,1069,59,0,2,19,0,1
41125,227,5129,4293,999,3693,19,54,507,4312,9,155,88,170,164,258,1156,1898,4,9368,520,0,2,4,1,1
41126,227,5129,1482,859,1002,125,135,219,1607,16,219,134,251,235,385,1766,3032,9,27804,1544,1,2,4,1,1
41127,148,6832,139,89,101,2,0,35,141,7,54,34,62,61,96,330,569,4,2287,127,0,2,13,6,1
41128,148,6832,7,5,5,0,0,2,7,1,2,1,2,3,3,2,4,0,2,0,0,2,13,6,1
41129,227,5129,4293,999,3693,19,54,507,4312,9,155,88,170,164,258,1156,1898,4,9368,520,0,2,11,2,0
41130,227,5129,1482,859,1002,125,135,219,1607,16,219,134,251,235,385,1766,3032,9,27804,1544,1,2,11,2,0
41131,148,6832,139,89,101,2,0,35,141,7,54,34,62,61,96,330,569,4,2287,127,0,2,33,0,0
41132,148,6832,7,5,5,0,0,2,7,1,2,1,2,3,3,2,4,0,2,0,0,2,33,0,0
41133,163,5080,1660,832,1314,41,38,274,1701,20,312,209,395,332,604,2671,5058,12,64042,3557,1,2,0,4,0
41134,163,5080,1057,646,719,113,100,145,1170,18,215,134,248,233,382,1740,3004,10,31186,1732,1,2,0,4,0
41135,60,1673,1455,414,1257,16,76,112,1471,5,41,23,46,46,69,231,381,2,1069,59,0,2,4,5,0
41136,60,1673,669,365,481,22,61,110,691,15,103,63,122,118,185,747,1273,8,11311,628,0,2,4,5,0
41137,64,2957,1455,414,1257,16,76,112,1471,5,41,23,46,46,69,231,381,2,1069,59,0,2,19,0,0
41138,178,4125,77,34,69,0,0,8,77,3,24,16,29,27,45,114,213,1,387,21,0,2,5,1,0
41139,178,4125,712,438,573,51,9,84,763,14,102,71,128,116,199,733,1364,8,11988,666,0,2,5,1,0
41142,80,3427,1289,550,1043,56,32,155,1345,10,167,93,185,177,278,1266,2075,5,11498,638,0,2,2,2,0
41143,66,3414,1296,573,1062,40,33,157,1336,8,201,118,231,209,349,1561,2689,4,12365,686,0,2,14,5,0
41146,54,1166,207,111,150,11,0,50,218,5,26,19,36,31,55,133,272,3,943,52,0,2,2,1,1
41147,54,1166,410,198,237,31,55,97,441,11,63,38,72,74,110,414,683,6,4293,238,0,2,2,1,1
41148,74,1464,757,253,292,73,244,162,830,13,61,38,67,74,105,409,651,7,4654,258,0,2,149,121,1
41149,53,3332,520,294,400,33,13,81,553,10,261,204,367,271,571,2128,4614,7,32445,1802,1,2,23,31,1
41150,74,1464,757,253,292,73,244,162,830,13,61,38,67,74,105,409,651,7,4654,258,0,2,2,1,1
41151,53,3320,520,294,400,33,13,81,553,10,261,204,367,271,571,2128,4614,7,32445,1802,1,2,1,2,1
41152,74,1467,757,253,292,73,244,162,830,13,61,38,67,74,105,409,651,7,4654,258,0,2,3,3,1
41153,74,1473,757,253,292,73,244,162,830,13,61,38,67,74,105,409,651,7,4654,258,0,2,1,1,0
41154,90,1694,1020,354,843,12,15,144,1032,8,134,77,144,142,221,970,1580,4,6792,377,0,2,29,0,1
41155,276,6071,72,33,56,0,4,12,72,1,1,1,1,2,2,0,2,0,1,0,0,2,1,30,1
41156,276,6071,1454,835,1044,76,110,219,1530,17,275,158,296,292,454,2297,3718,9,34017,1889,1,2,1,30,1
41157,90,1746,1020,354,843,12,15,144,1032,8,134,77,144,142,221,970,1580,4,6792,377,0,2,40,30,1
41158,90,1754,1020,354,843,12,15,144,1032,8,134,77,144,142,221,970,1580,4,6792,377,0,2,1,0,1
41159,70,3035,1020,354,843,12,15,144,1032,8,134,77,144,142,221,970,1580,4,6792,377,0,2,23,1,1
41160,213,4595,182,127,129,0,0,53,182,5,39,21,42,44,63,217,343,2,926,51,0,2,5,2,0
41161,213,4595,1165,710,800,67,119,181,1232,18,243,153,282,261,435,2000,3492,10,36473,2026,1,2,5,2,0
41162,147,6814,1392,870,1177,35,17,170,1427,14,494,280,531,508,811,4473,7289,7,54850,3047,2,2,23,0,0
41163,40,837,386,256,301,16,9,68,402,4,59,35,69,63,104,355,621,2,1453,80,0,2,2,1,0
41164,40,837,264,131,164,11,41,46,275,6,38,22,40,44,62,214,338,3,1068,59,0,2,2,1,0
41166,92,1807,1020,354,843,12,15,144,1032,8,134,77,144,142,221,970,1580,4,6792,377,0,2,12,6,1
41167,40,837,386,256,301,16,9,68,402,4,59,35,69,63,104,355,621,2,1453,80,0,2,36,29,0
41168,40,837,264,131,164,11,41,46,275,6,38,22,40,44,62,214,338,3,1068,59,0,2,36,29,0
41169,38,1637,386,256,301,16,9,68,402,4,59,35,69,63,104,355,621,2,1453,80,0,2,48,10,0
41171,93,1798,1020,354,843,12,15,144,1032,8,134,77,144,142,221,970,1580,4,6792,377,0,2,31,23,1
41172,276,6071,72,33,56,0,4,12,72,1,1,1,1,2,2,0,2,0,1,0,0,2,1,0,0
41173,276,6071,1454,835,1044,76,110,219,1530,17,275,158,296,292,454,2297,3718,9,34017,1889,1,2,1,0,0
41175,93,1798,1020,354,843,12,15,144,1032,8,134,77,144,142,221,970,1580,4,6792,377,0,2,75,21,0
41176,276,6071,72,33,56,0,4,12,72,1,1,1,1,2,2,0,2,0,1,0,0,2,1,29,0
41177,276,6071,1454,835,1044,76,110,219,1530,17,275,158,296,292,454,2297,3718,9,34017,1889,1,2,1,29,0
41178,70,3035,1020,354,843,12,15,144,1032,8,134,77,144,142,221,970,1580,4,6792,377,0,2,23,1,0
41226,94,1809,1020,354,843,12,15,144,1032,8,134,77,144,142,221,970,1580,4,6792,377,0,2,4,1,1
41228,94,1809,1020,354,843,12,15,144,1032,8,134,77,144,142,221,970,1580,4,6792,377,0,2,4,1,0
41276,178,4127,77,34,69,0,0,8,77,3,24,16,29,27,45,114,213,1,387,21,0,2,2,3,0
41277,178,4127,712,438,573,51,9,84,763,14,102,71,128,116,199,733,1364,8,11988,666,0,2,2,3,0
41325,278,6113,72,33,56,0,4,12,72,1,1,1,1,2,2,0,2,0,1,0,0,2,13,4,1
41326,278,6113,1454,835,1044,76,110,219,1530,17,275,158,296,292,454,2297,3718,9,34017,1889,1,2,13,4,1
41327,98,4425,1338,495,1086,10,64,173,1348,11,122,82,157,133,239,883,1686,7,11934,663,0,2,20,0,1
41328,278,6113,72,33,56,0,4,12,72,1,1,1,1,2,2,0,2,0,1,0,0,2,13,4,0
41329,278,6113,1454,835,1044,76,110,219,1530,17,275,158,296,292,454,2297,3718,9,34017,1889,1,2,13,4,0
41330,98,4425,1338,495,1086,10,64,173,1348,11,122,82,157,133,239,883,1686,7,11934,663,0,2,20,0,0
41331,178,4129,77,34,69,0,0,8,77,3,24,16,29,27,45,114,213,1,387,21,0,2,2,3,0
41332,178,4129,712,438,573,51,9,84,763,14,102,71,128,116,199,733,1364,8,11988,666,0,2,2,3,0
41333,74,1479,757,253,292,73,244,162,830,13,61,38,67,74,105,409,651,7,4654,258,0,2,3,3,1
41334,53,3320,520,294,400,33,13,81,553,10,261,204,367,271,571,2128,4614,7,32445,1802,1,2,4,4,1
41335,76,1520,757,253,292,73,244,162,830,13,61,38,67,74,105,409,651,7,4654,258,0,2,16,9,0
41338,76,1520,757,253,292,73,244,162,830,13,61,38,67,74,105,409,651,7,4654,258,0,2,1,1,0
41339,178,4129,77,34,69,0,0,8,77,3,24,16,29,27,45,114,213,1,387,21,0,2,1,1,1
41340,178,4129,712,438,573,51,9,84,763,14,102,71,128,116,199,733,1364,8,11988,666,0,2,1,1,1
41341,71,3006,1178,367,1042,6,15,115,1184,9,94,51,95,103,146,644,976,4,4439,246,0,2,1,1,1
41342,178,4129,77,34,69,0,0,8,77,3,24,16,29,27,45,114,213,1,387,21,0,2,1,1,0
41343,178,4129,712,438,573,51,9,84,763,14,102,71,128,116,199,733,1364,8,11988,666,0,2,1,1,0
41344,71,3006,1178,367,1042,6,15,115,1184,9,94,51,95,103,146,644,976,4,4439,246,0,2,1,1,0
41345,49,575,647,139,84,35,284,233,682,0,0,0,0,0,0,0,0,0,0,0,0,2,11,3,0
41347,54,1166,207,111,150,11,0,50,218,5,26,19,36,31,55,133,272,3,943,52,0,2,2,1,0
41348,54,1166,410,198,237,31,55,97,441,11,63,38,72,74,110,414,683,6,4293,238,0,2,2,1,0
41349,76,1520,757,253,292,73,244,162,830,13,61,38,67,74,105,409,651,7,4654,258,0,2,328,134,0
41350,53,3320,520,294,400,33,13,81,553,10,261,204,367,271,571,2128,4614,7,32445,1802,1,2,109,39,0
41351,62,1345,996,429,845,24,10,117,1020,7,76,50,88,83,138,494,879,4,3565,198,0,2,15,1,0
41352,62,1345,456,277,329,12,42,72,468,13,85,50,97,98,147,592,972,7,7212,400,0,2,15,1,0
41353,54,1161,207,111,150,11,0,50,218,5,26,19,36,31,55,133,272,3,943,52,0,2,2,2,1
41354,54,1161,410,198,237,31,55,97,441,11,63,38,72,74,110,414,683,6,4293,238,0,2,2,2,1
41355,336,7168,72,33,56,0,4,12,72,1,1,1,1,2,2,0,2,0,1,0,0,2,5,5,1
41356,336,7168,1454,835,1044,76,110,219,1530,17,275,158,296,292,454,2297,3718,9,34017,1889,1,2,5,5,1
41357,336,7160,72,33,56,0,4,12,72,1,1,1,1,2,2,0,2,0,1,0,0,2,1,1,1
41358,336,7160,1454,835,1044,76,110,219,1530,17,275,158,296,292,454,2297,3718,9,34017,1889,1,2,1,1,1
41359,7,278,75,38,59,1,3,12,76,2,4,2,4,6,6,10,15,1,15,0,0,2,4,0,1
41362,54,1161,207,111,150,11,0,50,218,5,26,19,36,31,55,133,272,3,943,52,0,2,2,2,0
41363,54,1161,410,198,237,31,55,97,441,11,63,38,72,74,110,414,683,6,4293,238,0,2,2,2,0
41364,336,7168,72,33,56,0,4,12,72,1,1,1,1,2,2,0,2,0,1,0,0,2,5,5,0
41365,336,7168,1454,835,1044,76,110,219,1530,17,275,158,296,292,454,2297,3718,9,34017,1889,1,2,5,5,0
41366,54,1166,207,111,150,11,0,50,218,5,26,19,36,31,55,133,272,3,943,52,0,2,2,2,0
41367,54,1166,410,198,237,31,55,97,441,11,63,38,72,74,110,414,683,6,4293,238,0,2,2,2,0
41371,278,6113,72,33,56,0,4,12,72,1,1,1,1,2,2,0,2,0,1,0,0,2,5,5,0
41372,278,6113,1454,835,1044,76,110,219,1530,17,275,158,296,292,454,2297,3718,9,34017,1889,1,2,5,5,0
41374,180,4191,77,34,69,0,0,8,77,3,24,16,29,27,45,114,213,1,387,21,0,2,12,0,1
41375,180,4191,712,438,573,51,9,84,763,14,102,71,128,116,199,733,1364,8,11988,666,0,2,12,0,1
41376,180,4191,77,34,69,0,0,8,77,3,24,16,29,27,45,114,213,1,387,21,0,2,1,1,1
41377,180,4191,712,438,573,51,9,84,763,14,102,71,128,116,199,733,1364,8,11988,666,0,2,1,1,1
41378,184,4250,77,34,69,0,0,8,77,3,24,16,29,27,45,114,213,1,387,21,0,2,14,4,0
41379,184,4250,712,438,573,51,9,84,763,14,102,71,128,116,199,733,1364,8,11988,666,0,2,14,4,0
41380,178,4130,77,34,69,0,0,8,77,3,24,16,29,27,45,114,213,1,387,21,0,2,15,0,0
41381,178,4130,712,438,573,51,9,84,763,14,102,71,128,116,199,733,1364,8,11988,666,0,2,15,0,0
41382,184,4240,77,34,69,0,0,8,77,3,24,16,29,27,45,114,213,1,387,21,0,2,2,6,1
41383,184,4240,712,438,573,51,9,84,763,14,102,71,128,116,199,733,1364,8,11988,666,0,2,2,6,1
41384,72,3755,1296,573,1062,40,33,157,1336,8,201,118,231,209,349,1561,2689,4,12365,686,0,2,48,1,1
41385,184,4240,77,34,69,0,0,8,77,3,24,16,29,27,45,114,213,1,387,21,0,2,18,0,0
41386,184,4240,712,438,573,51,9,84,763,14,102,71,128,116,199,733,1364,8,11988,666,0,2,18,0,0
41387,72,3755,1296,573,1062,40,33,157,1336,8,201,118,231,209,349,1561,2689,4,12365,686,0,2,48,1,0
41388,336,7160,72,33,56,0,4,12,72,1,1,1,1,2,2,0,2,0,1,0,0,2,1,1,0
41389,336,7160,1454,835,1044,76,110,219,1530,17,275,158,296,292,454,2297,3718,9,34017,1889,1,2,1,1,0
41390,7,278,75,38,59,1,3,12,76,2,4,2,4,6,6,10,15,1,15,0,0,2,4,0,0
41393,192,3908,1943,715,1694,26,18,214,1969,12,185,120,237,197,357,1436,2721,7,20915,1161,0,2,3,0,0
41394,192,3908,1168,838,957,57,25,144,1225,19,348,224,416,367,640,3018,5452,11,61921,3440,1,2,3,0,0
41397,339,7202,72,33,56,0,4,12,72,1,1,1,1,2,2,0,2,0,1,0,0,2,20,6,1
41398,339,7202,1454,835,1044,76,110,219,1530,17,275,158,296,292,454,2297,3718,9,34017,1889,1,2,20,6,1
41399,151,6958,139,89,101,2,0,35,141,7,54,34,62,61,96,330,569,4,2287,127,0,2,61,4,1
41400,151,6958,7,5,5,0,0,2,7,1,2,1,2,3,3,2,4,0,2,0,0,2,61,4,1
41401,55,1182,207,111,150,11,0,50,218,5,26,19,36,31,55,133,272,3,943,52,0,2,10,1,1
41402,55,1182,410,198,237,31,55,97,441,11,63,38,72,74,110,414,683,6,4293,238,0,2,10,1,1
41403,118,4686,1513,682,1277,25,13,200,1538,11,199,116,219,210,335,1557,2584,6,15641,868,0,2,9,0,1
41404,213,4595,182,127,129,0,0,53,182,5,39,21,42,44,63,217,343,2,926,51,0,2,1,1,1
41405,213,4595,1165,710,800,67,119,181,1232,18,243,153,282,261,435,2000,3492,10,36473,2026,1,2,1,1,1
41406,99,2081,773,419,590,28,0,166,801,10,204,113,217,214,330,1598,2554,5,13587,754,0,2,0,2,1
41407,99,2081,421,273,302,44,34,57,465,17,81,59,107,98,166,583,1098,11,12329,684,0,2,0,2,1
41408,227,5129,4293,999,3693,19,54,507,4312,9,155,88,170,164,258,1156,1898,4,9368,520,0,2,0,1,1
41409,227,5129,1482,859,1002,125,135,219,1607,16,219,134,251,235,385,1766,3032,9,27804,1544,1,2,0,1,1
41410,91,3010,773,419,590,28,0,166,801,10,204,113,217,214,330,1598,2554,5,13587,754,0,2,4,1,1
41413,2,26,6,4,4,0,0,2,6,1,4,2,4,5,6,8,13,0,6,0,0,2,1,1,1
41415,47,2498,520,294,400,33,13,81,553,10,261,204,367,271,571,2128,4614,7,32445,1802,1,2,0,1,1
41416,148,6832,139,89,101,2,0,35,141,7,54,34,62,61,96,330,569,4,2287,127,0,2,0,3,1
41417,148,6832,7,5,5,0,0,2,7,1,2,1,2,3,3,2,4,0,2,0,0,2,0,3,1
41418,78,4093,1457,730,1242,11,6,188,1468,10,292,166,329,302,495,2424,4078,5,22973,1276,1,2,0,1,1
41419,64,2957,1455,414,1257,16,76,112,1471,5,41,23,46,46,69,231,381,2,1069,59,0,2,0,1,1
41420,90,4427,1523,757,1297,19,12,193,1542,12,193,117,230,205,347,1508,2664,7,19053,1058,0,2,0,1,1
41421,12,492,184,100,137,2,15,30,186,6,38,20,39,44,59,214,322,3,991,55,0,2,0,2,1
41422,16,1209,215,129,180,6,0,29,221,8,65,43,72,73,115,415,711,4,3153,175,0,2,0,2,1
41423,69,2856,1043,504,840,53,9,147,1096,9,180,112,198,189,310,1377,2344,4,11604,644,0,2,0,2,1
41424,60,1673,1455,414,1257,16,76,112,1471,5,41,23,46,46,69,231,381,2,1069,59,0,2,1,1,0
41425,60,1673,669,365,481,22,61,110,691,15,103,63,122,118,185,747,1273,8,11311,628,0,2,1,1,0
41426,223,5047,722,423,573,19,0,135,741,12,172,101,199,184,300,1320,2257,6,15668,870,0,2,5,5,0
41427,223,5047,1508,847,911,44,250,301,1552,14,148,88,169,162,257,1120,1886,7,15077,837,0,2,5,5,0
41430,39,2355,652,304,544,16,6,88,668,6,89,51,101,95,152,591,998,3,3399,188,0,2,4,4,0
41431,64,2957,1455,414,1257,16,76,112,1471,5,41,23,46,46,69,231,381,2,1069,59,0,2,1,1,0
41432,37,1624,447,308,343,6,5,95,453,7,96,59,111,103,170,651,1136,4,4600,255,0,2,1,1,0
41433,48,1784,1098,241,925,5,10,155,1103,7,46,25,49,53,74,273,423,3,1580,87,0,2,1,1,0
41434,12,476,601,196,481,2,23,85,603,8,63,36,72,71,108,400,664,4,3036,168,0,2,2,2,0
41437,40,837,386,256,301,16,9,68,402,4,59,35,69,63,104,355,621,2,1453,80,0,2,1,1,0
41438,40,837,264,131,164,11,41,46,275,6,38,22,40,44,62,214,338,3,1068,59,0,2,1,1,0
41439,127,2807,1043,504,840,53,9,147,1096,9,180,112,198,189,310,1377,2344,4,11604,644,0,2,1,1,0
41440,127,2807,383,288,292,26,6,62,409,11,65,38,67,76,105,429,656,5,3719,206,0,2,1,1,0
41441,47,2498,520,294,400,33,13,81,553,10,261,204,367,271,571,2128,4614,7,32445,1802,1,2,9,9,0
41442,148,6832,139,89,101,2,0,35,141,7,54,34,62,61,96,330,569,4,2287,127,0,2,6,8,0
41443,148,6832,7,5,5,0,0,2,7,1,2,1,2,3,3,2,4,0,2,0,0,2,6,8,0
41444,74,3770,1943,715,1694,26,18,214,1969,12,185,120,237,197,357,1436,2721,7,20915,1161,0,2,3,3,0
41445,349,7049,1457,730,1242,11,6,188,1468,10,292,166,329,302,495,2424,4078,5,22973,1276,1,2,2,2,0
41446,349,7049,74,35,59,1,0,14,75,3,14,7,14,17,21,58,85,1,128,7,0,2,2,2,0
41447,349,7049,245,125,200,5,7,34,250,7,30,17,34,37,51,166,265,3,1053,58,0,2,2,2,0
41448,27,954,74,35,59,1,0,14,75,3,14,7,14,17,21,58,85,1,128,7,0,2,3,3,0
41449,27,954,245,125,200,5,7,34,250,7,30,17,34,37,51,166,265,3,1053,58,0,2,3,3,0
41450,148,6832,139,89,101,2,0,35,141,7,54,34,62,61,96,330,569,4,2287,127,0,2,1,1,0
41451,148,6832,7,5,5,0,0,2,7,1,2,1,2,3,3,2,4,0,2,0,0,2,1,1,0
41452,150,4203,1660,832,1314,41,38,274,1701,20,312,209,395,332,604,2671,5058,12,64042,3557,1,2,1,1,0
41453,74,3770,1943,715,1694,26,18,214,1969,12,185,120,237,197,357,1436,2721,7,20915,1161,0,2,2,2,0
41456,69,2856,1043,504,840,53,9,147,1096,9,180,112,198,189,310,1377,2344,4,11604,644,0,2,5,5,0
41457,74,3770,1943,715,1694,26,18,214,1969,12,185,120,237,197,357,1436,2721,7,20915,1161,0,2,5,5,0
41458,336,7160,72,33,56,0,4,12,72,1,1,1,1,2,2,0,2,0,1,0,0,2,2,2,0
41459,336,7160,1454,835,1044,76,110,219,1530,17,275,158,296,292,454,2297,3718,9,34017,1889,1,2,2,2,0
41460,103,1953,1178,367,1042,6,15,115,1184,9,94,51,95,103,146,644,976,4,4439,246,0,2,3,3,0
41461,103,1953,177,108,140,8,0,27,185,6,30,16,32,36,48,162,248,3,794,44,0,2,3,3,0
41462,80,3427,1289,550,1043,56,32,155,1345,10,167,93,185,177,278,1266,2075,5,11498,638,0,2,1,1,0
41463,147,6814,1392,870,1177,35,17,170,1427,14,494,280,531,508,811,4473,7289,7,54850,3047,2,2,1,1,0
41464,112,5710,1782,648,1425,9,47,279,1791,8,171,97,189,179,286,1292,2140,4,9462,525,0,2,3,3,0
41466,74,3770,1943,715,1694,26,18,214,1969,12,185,120,237,197,357,1436,2721,7,20915,1161,0,2,1,1,0
41467,213,4595,182,127,129,0,0,53,182,5,39,21,42,44,63,217,343,2,926,51,0,2,2,2,1
41468,213,4595,1165,710,800,67,119,181,1232,18,243,153,282,261,435,2000,3492,10,36473,2026,1,2,2,2,1
41469,227,5129,4293,999,3693,19,54,507,4312,9,155,88,170,164,258,1156,1898,4,9368,520,0,2,1,1,1
41470,227,5129,1482,859,1002,125,135,219,1607,16,219,134,251,235,385,1766,3032,9,27804,1544,1,2,1,1,1
41471,212,5047,722,423,573,19,0,135,741,12,172,101,199,184,300,1320,2257,6,15668,870,0,2,2,2,1
41472,212,5047,1508,847,911,44,250,301,1552,14,148,88,169,162,257,1120,1886,7,15077,837,0,2,2,2,1
41473,310,7160,72,33,56,0,4,12,72,1,1,1,1,2,2,0,2,0,1,0,0,2,1,1,1
41474,310,7160,1454,835,1044,76,110,219,1530,17,275,158,296,292,454,2297,3718,9,34017,1889,1,2,1,1,1
41477,62,1240,1098,241,925,5,10,155,1103,7,46,25,49,53,74,273,423,3,1580,87,0,2,1,1,1
41478,62,1240,282,202,222,14,2,44,296,8,42,24,43,50,67,250,378,4,1548,86,0,2,1,1,1
41479,349,7049,1457,730,1242,11,6,188,1468,10,292,166,329,302,495,2424,4078,5,22973,1276,1,2,6,6,1
41480,349,7049,74,35,59,1,0,14,75,3,14,7,14,17,21,58,85,1,128,7,0,2,6,6,1
41481,349,7049,245,125,200,5,7,34,250,7,30,17,34,37,51,166,265,3,1053,58,0,2,6,6,1
41483,227,5129,4293,999,3693,19,54,507,4312,9,155,88,170,164,258,1156,1898,4,9368,520,0,2,5,5,1
41484,227,5129,1482,859,1002,125,135,219,1607,16,219,134,251,235,385,1766,3032,9,27804,1544,1,2,5,5,1
41485,83,2359,1523,757,1297,19,12,193,1542,12,193,117,230,205,347,1508,2664,7,19053,1058,0,2,4,4,1
41486,83,2359,701,378,504,33,58,109,734,13,110,68,126,123,194,794,1346,7,10027,557,0,2,4,4,1
41487,46,955,447,308,343,6,5,95,453,7,96,59,111,103,170,651,1136,4,4600,255,0,2,3,3,1
41488,46,955,322,174,179,16,74,51,338,10,41,26,46,51,72,252,408,5,2291,127,0,2,3,3,1
41491,310,7160,72,33,56,0,4,12,72,1,1,1,1,2,2,0,2,0,1,0,0,2,2,2,1
41492,310,7160,1454,835,1044,76,110,219,1530,17,275,158,296,292,454,2297,3718,9,34017,1889,1,2,2,2,1
41493,127,2807,1043,504,840,53,9,147,1096,9,180,112,198,189,310,1377,2344,4,11604,644,0,2,4,4,1
41494,127,2807,383,288,292,26,6,62,409,11,65,38,67,76,105,429,656,5,3719,206,0,2,4,4,1
41495,91,3010,773,419,590,28,0,166,801,10,204,113,217,214,330,1598,2554,5,13587,754,0,2,1,1,1
41496,47,2498,520,294,400,33,13,81,553,10,261,204,367,271,571,2128,4614,7,32445,1802,1,2,28,28,1
41497,109,4106,1450,624,1228,12,26,181,1462,14,306,186,354,320,540,2580,4493,8,36391,2021,1,2,1,1,1
41498,68,2962,1020,354,843,12,15,144,1032,8,134,77,144,142,221,970,1580,4,6792,377,0,2,4,4,1
41499,36,1978,384,251,317,7,8,52,391,11,70,44,84,81,128,467,811,6,5355,297,0,2,1,1,1
41500,16,1209,215,129,180,6,0,29,221,8,65,43,72,73,115,415,711,4,3153,175,0,2,1,1,1
41501,163,5080,1660,832,1314,41,38,274,1701,20,312,209,395,332,604,2671,5058,12,64042,3557,1,2,1,1,1
41502,163,5080,1057,646,719,113,100,145,1170,18,215,134,248,233,382,1740,3004,10,31186,1732,1,2,1,1,1
41503,54,1161,207,111,150,11,0,50,218,5,26,19,36,31,55,133,272,3,943,52,0,2,1,1,1
41504,54,1161,410,198,237,31,55,97,441,11,63,38,72,74,110,414,683,6,4293,238,0,2,1,1,1
41505,349,7049,1457,730,1242,11,6,188,1468,10,292,166,329,302,495,2424,4078,5,22973,1276,1,2,1,1,1
41506,349,7049,74,35,59,1,0,14,75,3,14,7,14,17,21,58,85,1,128,7,0,2,1,1,1
41507,349,7049,245,125,200,5,7,34,250,7,30,17,34,37,51,166,265,3,1053,58,0,2,1,1,1
41508,60,1673,1455,414,1257,16,76,112,1471,5,41,23,46,46,69,231,381,2,1069,59,0,2,1,1,1
41509,60,1673,669,365,481,22,61,110,691,15,103,63,122,118,185,747,1273,8,11311,628,0,2,1,1,1
41510,83,2359,1523,757,1297,19,12,193,1542,12,193,117,230,205,347,1508,2664,7,19053,1058,0,2,2,2,1
41511,83,2359,701,378,504,33,58,109,734,13,110,68,126,123,194,794,1346,7,10027,557,0,2,2,2,1
41512,212,5047,722,423,573,19,0,135,741,12,172,101,199,184,300,1320,2257,6,15668,870,0,2,1,1,1
41513,212,5047,1508,847,911,44,250,301,1552,14,148,88,169,162,257,1120,1886,7,15077,837,0,2,1,1,1
41516,147,6814,1392,870,1177,35,17,170,1427,14,494,280,531,508,811,4473,7289,7,54850,3047,2,2,1,1,1
41517,32,948,465,148,393,5,8,60,470,4,31,20,31,35,51,161,261,2,523,29,0,2,1,1,1
41518,32,948,16,12,9,0,0,6,16,1,2,1,2,3,3,2,4,0,2,0,0,2,1,1,1
41519,66,3414,1296,573,1062,40,33,157,1336,8,201,118,231,209,349,1561,2689,4,12365,686,0,2,1,1,1
41520,40,2367,334,251,279,10,4,40,344,5,127,74,143,132,217,899,1528,2,4303,239,0,2,1,1,1
41521,213,4595,182,127,129,0,0,53,182,5,39,21,42,44,63,217,343,2,926,51,0,2,4,4,1
41522,213,4595,1165,710,800,67,119,181,1232,18,243,153,282,261,435,2000,3492,10,36473,2026,1,2,4,4,1
41525,60,1265,996,429,845,24,10,117,1020,7,76,50,88,83,138,494,879,4,3565,198,0,2,1,1,1
41526,60,1265,456,277,329,12,42,72,468,13,85,50,97,98,147,592,972,7,7212,400,0,2,1,1,1
41529,349,7049,1457,730,1242,11,6,188,1468,10,292,166,329,302,495,2424,4078,5,22973,1276,1,2,9,9,1
41530,349,7049,74,35,59,1,0,14,75,3,14,7,14,17,21,58,85,1,128,7,0,2,9,9,1
41531,349,7049,245,125,200,5,7,34,250,7,30,17,34,37,51,166,265,3,1053,58,0,2,9,9,1
41532,60,1673,1455,414,1257,16,76,112,1471,5,41,23,46,46,69,231,381,2,1069,59,0,2,15,15,1
41533,60,1673,669,365,481,22,61,110,691,15,103,63,122,118,185,747,1273,8,11311,628,0,2,15,15,1
41536,27,954,74,35,59,1,0,14,75,3,14,7,14,17,21,58,85,1,128,7,0,2,16,16,1
41537,27,954,245,125,200,5,7,34,250,7,30,17,34,37,51,166,265,3,1053,58,0,2,16,16,1
41538,178,4130,77,34,69,0,0,8,77,3,24,16,29,27,45,114,213,1,387,21,0,2,22,22,1
41539,178,4130,712,438,573,51,9,84,763,14,102,71,128,116,199,733,1364,8,11988,666,0,2,22,22,1
41540,17,518,184,100,137,2,15,30,186,6,38,20,39,44,59,214,322,3,991,55,0,2,3,3,1
41541,17,518,103,65,74,8,5,16,111,7,17,9,17,24,26,89,119,3,417,23,0,2,3,3,1
41542,212,5047,722,423,573,19,0,135,741,12,172,101,199,184,300,1320,2257,6,15668,870,0,2,10,10,1
41543,212,5047,1508,847,911,44,250,301,1552,14,148,88,169,162,257,1120,1886,7,15077,837,0,2,10,10,1
41544,310,7160,72,33,56,0,4,12,72,1,1,1,1,2,2,0,2,0,1,0,0,2,27,27,1
41545,310,7160,1454,835,1044,76,110,219,1530,17,275,158,296,292,454,2297,3718,9,34017,1889,1,2,27,27,1
41548,127,2807,1043,504,840,53,9,147,1096,9,180,112,198,189,310,1377,2344,4,11604,644,0,2,6,6,1
41549,127,2807,383,288,292,26,6,62,409,11,65,38,67,76,105,429,656,5,3719,206,0,2,6,6,1
41550,103,1953,1178,367,1042,6,15,115,1184,9,94,51,95,103,146,644,976,4,4439,246,0,2,17,17,1
41551,103,1953,177,108,140,8,0,27,185,6,30,16,32,36,48,162,248,3,794,44,0,2,17,17,1
41552,192,3908,1943,715,1694,26,18,214,1969,12,185,120,237,197,357,1436,2721,7,20915,1161,0,2,18,18,1
41553,192,3908,1168,838,957,57,25,144,1225,19,348,224,416,367,640,3018,5452,11,61921,3440,1,2,18,18,1
41556,62,1240,1098,241,925,5,10,155,1103,7,46,25,49,53,74,273,423,3,1580,87,0,2,2,2,1
41557,62,1240,282,202,222,14,2,44,296,8,42,24,43,50,67,250,378,4,1548,86,0,2,2,2,1
41559,96,4365,1338,495,1086,10,64,173,1348,11,122,82,157,133,239,883,1686,7,11934,663,0,2,3,3,1
41560,112,5710,1782,648,1425,9,47,279,1791,8,171,97,189,179,286,1292,2140,4,9462,525,0,2,4,4,1
41561,23,601,102,59,69,5,3,24,107,6,22,15,28,28,43,113,206,3,789,43,0,2,4,4,1
41562,150,4203,1660,832,1314,41,38,274,1701,20,312,209,395,332,604,2671,5058,12,64042,3557,1,2,1,1,1
41563,117,4645,1513,682,1277,25,13,200,1538,11,199,116,219,210,335,1557,2584,6,15641,868,0,2,1,1,1
41565,64,2957,1455,414,1257,16,76,112,1471,5,41,23,46,46,69,231,381,2,1069,59,0,2,4,4,1
41568,74,3770,1943,715,1694,26,18,214,1969,12,185,120,237,197,357,1436,2721,7,20915,1161,0,2,4,4,1
41569,213,4595,182,127,129,0,0,53,182,5,39,21,42,44,63,217,343,2,926,51,0,2,1,1,0
41570,213,4595,1165,710,800,67,119,181,1232,18,243,153,282,261,435,2000,3492,10,36473,2026,1,2,1,1,0
41571,163,5080,1660,832,1314,41,38,274,1701,20,312,209,395,332,604,2671,5058,12,64042,3557,1,2,1,1,0
41572,163,5080,1057,646,719,113,100,145,1170,18,215,134,248,233,382,1740,3004,10,31186,1732,1,2,1,1,0
41573,62,1240,1098,241,925,5,10,155,1103,7,46,25,49,53,74,273,423,3,1580,87,0,2,1,1,0
41574,62,1240,282,202,222,14,2,44,296,8,42,24,43,50,67,250,378,4,1548,86,0,2,1,1,0
41580,40,837,386,256,301,16,9,68,402,4,59,35,69,63,104,355,621,2,1453,80,0,2,1,1,1
41581,40,837,264,131,164,11,41,46,275,6,38,22,40,44,62,214,338,3,1068,59,0,2,1,1,1
41582,147,6814,1392,870,1177,35,17,170,1427,14,494,280,531,508,811,4473,7289,7,54850,3047,2,2,3,3,1
41583,47,2498,520,294,400,33,13,81,553,10,261,204,367,271,571,2128,4614,7,32445,1802,1,2,40,40,1
41584,109,4106,1450,624,1228,12,26,181,1462,14,306,186,354,320,540,2580,4493,8,36391,2021,1,2,5,5,1
41585,68,2962,1020,354,843,12,15,144,1032,8,134,77,144,142,221,970,1580,4,6792,377,0,2,9,9,1
41587,74,3770,1943,715,1694,26,18,214,1969,12,185,120,237,197,357,1436,2721,7,20915,1161,0,2,1,1,1
41591,112,5710,1782,648,1425,9,47,279,1791,8,171,97,189,179,286,1292,2140,4,9462,525,0,2,1,1,0
41597,150,4203,1660,832,1314,41,38,274,1701,20,312,209,395,332,604,2671,5058,12,64042,3557,1,2,9,9,0
41602,19,408,601,196,481,2,23,85,603,8,63,36,72,71,108,400,664,4,3036,168,0,2,1,1,1
41603,19,408,156,79,106,5,16,28,161,5,14,8,15,19,23,64,97,2,261,14,0,2,1,1,1
41604,147,6814,1392,870,1177,35,17,170,1427,14,494,280,531,508,811,4473,7289,7,54850,3047,2,2,10,10,1
41605,213,4595,182,127,129,0,0,53,182,5,39,21,42,44,63,217,343,2,926,51,0,2,2,2,0
41606,213,4595,1165,710,800,67,119,181,1232,18,243,153,282,261,435,2000,3492,10,36473,2026,1,2,2,2,0
41609,349,7049,1457,730,1242,11,6,188,1468,10,292,166,329,302,495,2424,4078,5,22973,1276,1,2,1,1,0
41610,349,7049,74,35,59,1,0,14,75,3,14,7,14,17,21,58,85,1,128,7,0,2,1,1,0
41611,349,7049,245,125,200,5,7,34,250,7,30,17,34,37,51,166,265,3,1053,58,0,2,1,1,0
41612,227,5129,4293,999,3693,19,54,507,4312,9,155,88,170,164,258,1156,1898,4,9368,520,0,2,4,4,0
41613,227,5129,1482,859,1002,125,135,219,1607,16,219,134,251,235,385,1766,3032,9,27804,1544,1,2,4,4,0
41614,66,3414,1296,573,1062,40,33,157,1336,8,201,118,231,209,349,1561,2689,4,12365,686,0,2,3,3,0
41615,213,4595,182,127,129,0,0,53,182,5,39,21,42,44,63,217,343,2,926,51,0,2,7,7,1
41616,213,4595,1165,710,800,67,119,181,1232,18,243,153,282,261,435,2000,3492,10,36473,2026,1,2,7,7,1
41624,227,5129,4293,999,3693,19,54,507,4312,9,155,88,170,164,258,1156,1898,4,9368,520,0,2,2,2,1
41625,227,5129,1482,859,1002,125,135,219,1607,16,219,134,251,235,385,1766,3032,9,27804,1544,1,2,2,2,1
41626,27,954,74,35,59,1,0,14,75,3,14,7,14,17,21,58,85,1,128,7,0,2,3,3,1
41627,27,954,245,125,200,5,7,34,250,7,30,17,34,37,51,166,265,3,1053,58,0,2,3,3,1
41628,178,4130,77,34,69,0,0,8,77,3,24,16,29,27,45,114,213,1,387,21,0,2,3,3,1
41629,178,4130,712,438,573,51,9,84,763,14,102,71,128,116,199,733,1364,8,11988,666,0,2,3,3,1
41630,17,518,184,100,137,2,15,30,186,6,38,20,39,44,59,214,322,3,991,55,0,2,1,1,1
41631,17,518,103,65,74,8,5,16,111,7,17,9,17,24,26,89,119,3,417,23,0,2,1,1,1
41632,212,5047,722,423,573,19,0,135,741,12,172,101,199,184,300,1320,2257,6,15668,870,0,2,3,3,1
41633,212,5047,1508,847,911,44,250,301,1552,14,148,88,169,162,257,1120,1886,7,15077,837,0,2,3,3,1
41634,310,7160,72,33,56,0,4,12,72,1,1,1,1,2,2,0,2,0,1,0,0,2,6,6,1
41635,310,7160,1454,835,1044,76,110,219,1530,17,275,158,296,292,454,2297,3718,9,34017,1889,1,2,6,6,1
41638,80,3427,1289,550,1043,56,32,155,1345,10,167,93,185,177,278,1266,2075,5,11498,638,0,2,1,1,1
41639,91,3010,773,419,590,28,0,166,801,10,204,113,217,214,330,1598,2554,5,13587,754,0,2,2,2,1
41640,148,6832,139,89,101,2,0,35,141,7,54,34,62,61,96,330,569,4,2287,127,0,2,2,2,1
41641,148,6832,7,5,5,0,0,2,7,1,2,1,2,3,3,2,4,0,2,0,0,2,2,2,1
41643,39,2355,652,304,544,16,6,88,668,6,89,51,101,95,152,591,998,3,3399,188,0,2,3,3,1
41645,35,1623,1293,570,1093,25,15,163,1318,10,195,123,241,205,364,1516,2795,6,17273,959,0,2,1,1,1
41647,213,4595,182,127,129,0,0,53,182,5,39,21,42,44,63,217,343,2,926,51,0,2,8,8,1
41648,213,4595,1165,710,800,67,119,181,1232,18,243,153,282,261,435,2000,3492,10,36473,2026,1,2,8,8,1
41649,99,2081,773,419,590,28,0,166,801,10,204,113,217,214,330,1598,2554,5,13587,754,0,2,7,7,1
41650,99,2081,421,273,302,44,34,57,465,17,81,59,107,98,166,583,1098,11,12329,684,0,2,7,7,1
41651,82,1800,477,336,357,30,23,73,507,16,194,134,250,210,384,1538,2962,10,30538,1696,0,2,5,5,1
41657,227,5129,4293,999,3693,19,54,507,4312,9,155,88,170,164,258,1156,1898,4,9368,520,0,2,6,6,1
41658,227,5129,1482,859,1002,125,135,219,1607,16,219,134,251,235,385,1766,3032,9,27804,1544,1,2,6,6,1
41659,178,4130,77,34,69,0,0,8,77,3,24,16,29,27,45,114,213,1,387,21,0,2,1,1,1
41660,178,4130,712,438,573,51,9,84,763,14,102,71,128,116,199,733,1364,8,11988,666,0,2,1,1,1
41665,127,2807,1043,504,840,53,9,147,1096,9,180,112,198,189,310,1377,2344,4,11604,644,0,2,1,1,1
41666,127,2807,383,288,292,26,6,62,409,11,65,38,67,76,105,429,656,5,3719,206,0,2,1,1,1
41668,147,6814,1392,870,1177,35,17,170,1427,14,494,280,531,508,811,4473,7289,7,54850,3047,2,2,5,5,1
41670,109,4106,1450,624,1228,12,26,181,1462,14,306,186,354,320,540,2580,4493,8,36391,2021,1,2,8,8,1
41673,14,529,295,56,236,0,4,54,295,2,9,5,10,11,15,30,51,1,57,3,0,2,1,1,1
41675,99,2081,773,419,590,28,0,166,801,10,204,113,217,214,330,1598,2554,5,13587,754,0,2,2,2,1
41676,99,2081,421,273,302,44,34,57,465,17,81,59,107,98,166,583,1098,11,12329,684,0,2,2,2,1
41677,163,5080,1660,832,1314,41,38,274,1701,20,312,209,395,332,604,2671,5058,12,64042,3557,1,2,2,2,1
41678,163,5080,1057,646,719,113,100,145,1170,18,215,134,248,233,382,1740,3004,10,31186,1732,1,2,2,2,1
41679,128,2606,1513,682,1277,25,13,200,1538,11,199,116,219,210,335,1557,2584,6,15641,868,0,2,1,1,1
41680,128,2606,819,519,539,24,98,155,843,15,96,57,106,111,163,690,1107,8,9171,509,0,2,1,1,1
41686,27,954,74,35,59,1,0,14,75,3,14,7,14,17,21,58,85,1,128,7,0,2,1,1,1
41687,27,954,245,125,200,5,7,34,250,7,30,17,34,37,51,166,265,3,1053,58,0,2,1,1,1
41688,310,7160,72,33,56,0,4,12,72,1,1,1,1,2,2,0,2,0,1,0,0,2,4,4,1
41689,310,7160,1454,835,1044,76,110,219,1530,17,275,158,296,292,454,2297,3718,9,34017,1889,1,2,4,4,1
41692,192,3908,1943,715,1694,26,18,214,1969,12,185,120,237,197,357,1436,2721,7,20915,1161,0,2,3,3,1
41693,192,3908,1168,838,957,57,25,144,1225,19,348,224,416,367,640,3018,5452,11,61921,3440,1,2,3,3,1
41696,91,3010,773,419,590,28,0,166,801,10,204,113,217,214,330,1598,2554,5,13587,754,0,2,5,5,1
41698,96,4365,1338,495,1086,10,64,173,1348,11,122,82,157,133,239,883,1686,7,11934,663,0,2,4,4,1
41699,148,6832,139,89,101,2,0,35,141,7,54,34,62,61,96,330,569,4,2287,127,0,2,9,9,1
41700,148,6832,7,5,5,0,0,2,7,1,2,1,2,3,3,2,4,0,2,0,0,2,9,9,1
41701,112,5710,1782,648,1425,9,47,279,1791,8,171,97,189,179,286,1292,2140,4,9462,525,0,2,22,22,1
41702,23,601,102,59,69,5,3,24,107,6,22,15,28,28,43,113,206,3,789,43,0,2,5,5,1
41703,109,4106,1450,624,1228,12,26,181,1462,14,306,186,354,320,540,2580,4493,8,36391,2021,1,2,2,2,1
41706,66,3414,1296,573,1062,40,33,157,1336,8,201,118,231,209,349,1561,2689,4,12365,686,0,2,3,3,1
41708,39,2355,652,304,544,16,6,88,668,6,89,51,101,95,152,591,998,3,3399,188,0,2,1,1,1
41709,68,2962,1020,354,843,12,15,144,1032,8,134,77,144,142,221,970,1580,4,6792,377,0,2,1,1,1
41710,40,2367,334,251,279,10,4,40,344,5,127,74,143,132,217,899,1528,2,4303,239,0,2,3,3,1
41711,12,492,184,100,137,2,15,30,186,6,38,20,39,44,59,214,322,3,991,55,0,2,2,2,1
41713,74,3770,1943,715,1694,26,18,214,1969,12,185,120,237,197,357,1436,2721,7,20915,1161,0,2,5,5,1
41714,212,5047,722,423,573,19,0,135,741,12,172,101,199,184,300,1320,2257,6,15668,870,0,2,4,4,0
41715,212,5047,1508,847,911,44,250,301,1552,14,148,88,169,162,257,1120,1886,7,15077,837,0,2,4,4,0
41716,39,2355,652,304,544,16,6,88,668,6,89,51,101,95,152,591,998,3,3399,188,0,2,16,16,0
41717,64,2957,1455,414,1257,16,76,112,1471,5,41,23,46,46,69,231,381,2,1069,59,0,2,3,3,0
41718,101,2081,773,419,590,28,0,166,801,10,204,113,217,214,330,1598,2554,5,13587,754,0,2,1,2,0
41719,101,2081,421,273,302,44,34,57,465,17,81,59,107,98,166,583,1098,11,12329,684,0,2,1,2,0
41720,27,954,74,35,59,1,0,14,75,3,14,7,14,17,21,58,85,1,128,7,0,2,1,1,0
41721,27,954,245,125,200,5,7,34,250,7,30,17,34,37,51,166,265,3,1053,58,0,2,1,1,0
41722,212,5047,722,423,573,19,0,135,741,12,172,101,199,184,300,1320,2257,6,15668,870,0,2,1,1,0
41723,212,5047,1508,847,911,44,250,301,1552,14,148,88,169,162,257,1120,1886,7,15077,837,0,2,1,1,0
41724,310,7160,72,33,56,0,4,12,72,1,1,1,1,2,2,0,2,0,1,0,0,2,1,2,0
41725,310,7160,1454,835,1044,76,110,219,1530,17,275,158,296,292,454,2297,3718,9,34017,1889,1,2,1,2,0
41726,78,4093,1457,730,1242,11,6,188,1468,10,292,166,329,302,495,2424,4078,5,22973,1276,1,2,1,1,0
41727,40,2367,334,251,279,10,4,40,344,5,127,74,143,132,217,899,1528,2,4303,239,0,2,1,1,0
41728,16,1209,215,129,180,6,0,29,221,8,65,43,72,73,115,415,711,4,3153,175,0,2,4,4,0
41734,101,2081,773,419,590,28,0,166,801,10,204,113,217,214,330,1598,2554,5,13587,754,0,2,4,4,1
41735,101,2081,421,273,302,44,34,57,465,17,81,59,107,98,166,583,1098,11,12329,684,0,2,4,4,1
41736,163,5080,1660,832,1314,41,38,274,1701,20,312,209,395,332,604,2671,5058,12,64042,3557,1,2,4,4,1
41737,163,5080,1057,646,719,113,100,145,1170,18,215,134,248,233,382,1740,3004,10,31186,1732,1,2,4,4,1
41740,349,7049,1457,730,1242,11,6,188,1468,10,292,166,329,302,495,2424,4078,5,22973,1276,1,2,4,4,1
41741,349,7049,74,35,59,1,0,14,75,3,14,7,14,17,21,58,85,1,128,7,0,2,4,4,1
41742,349,7049,245,125,200,5,7,34,250,7,30,17,34,37,51,166,265,3,1053,58,0,2,4,4,1
41747,80,1581,1020,354,843,12,15,144,1032,8,134,77,144,142,221,970,1580,4,6792,377,0,2,1,1,1
41748,212,5047,722,423,573,19,0,135,741,12,172,101,199,184,300,1320,2257,6,15668,870,0,2,4,4,1
41749,212,5047,1508,847,911,44,250,301,1552,14,148,88,169,162,257,1120,1886,7,15077,837,0,2,4,4,1
41758,80,3427,1289,550,1043,56,32,155,1345,10,167,93,185,177,278,1266,2075,5,11498,638,0,2,3,3,1
41759,147,6814,1392,870,1177,35,17,170,1427,14,494,280,531,508,811,4473,7289,7,54850,3047,2,2,6,6,1
41761,96,4365,1338,495,1086,10,64,173,1348,11,122,82,157,133,239,883,1686,7,11934,663,0,2,2,2,1
41762,148,6832,139,89,101,2,0,35,141,7,54,34,62,61,96,330,569,4,2287,127,0,2,1,1,1
41763,148,6832,7,5,5,0,0,2,7,1,2,1,2,3,3,2,4,0,2,0,0,2,1,1,1
41764,32,948,465,148,393,5,8,60,470,4,31,20,31,35,51,161,261,2,523,29,0,2,2,2,1
41765,32,948,16,12,9,0,0,6,16,1,2,1,2,3,3,2,4,0,2,0,0,2,2,2,1
41768,35,1623,1293,570,1093,25,15,163,1318,10,195,123,241,205,364,1516,2795,6,17273,959,0,2,4,4,1
41770,69,2856,1043,504,840,53,9,147,1096,9,180,112,198,189,310,1377,2344,4,11604,644,0,2,2,2,1
41771,25,1027,373,158,315,8,0,51,381,5,76,44,79,81,123,486,779,2,2026,112,0,2,2,2,1
41774,213,4595,182,127,129,0,0,53,182,5,39,21,42,44,63,217,343,2,926,51,0,2,6,6,0
41775,213,4595,1165,710,800,67,119,181,1232,18,243,153,282,261,435,2000,3492,10,36473,2026,1,2,6,6,0
41776,101,2081,773,419,590,28,0,166,801,10,204,113,217,214,330,1598,2554,5,13587,754,0,2,1,1,0
41777,101,2081,421,273,302,44,34,57,465,17,81,59,107,98,166,583,1098,11,12329,684,0,2,1,1,0
41778,60,1265,996,429,845,24,10,117,1020,7,76,50,88,83,138,494,879,4,3565,198,0,2,1,1,0
41779,60,1265,456,277,329,12,42,72,468,13,85,50,97,98,147,592,972,7,7212,400,0,2,1,1,0
41782,54,1161,207,111,150,11,0,50,218,5,26,19,36,31,55,133,272,3,943,52,0,2,1,1,0
41783,54,1161,410,198,237,31,55,97,441,11,63,38,72,74,110,414,683,6,4293,238,0,2,1,1,0
41787,178,4130,77,34,69,0,0,8,77,3,24,16,29,27,45,114,213,1,387,21,0,2,2,2,0
41788,178,4130,712,438,573,51,9,84,763,14,102,71,128,116,199,733,1364,8,11988,666,0,2,2,2,0
41789,23,388,424,94,331,4,0,89,428,1,5,5,5,6,10,11,25,0,12,0,0,2,2,2,0
41790,23,388,38,23,23,6,0,8,44,3,11,7,11,14,18,42,68,1,102,5,0,2,2,2,0
41791,212,5047,722,423,573,19,0,135,741,12,172,101,199,184,300,1320,2257,6,15668,870,0,2,5,5,0
41792,212,5047,1508,847,911,44,250,301,1552,14,148,88,169,162,257,1120,1886,7,15077,837,0,2,5,5,0
41793,310,7160,72,33,56,0,4,12,72,1,1,1,1,2,2,0,2,0,1,0,0,2,3,3,0
41794,310,7160,1454,835,1044,76,110,219,1530,17,275,158,296,292,454,2297,3718,9,34017,1889,1,2,3,3,0
41799,192,3908,1943,715,1694,26,18,214,1969,12,185,120,237,197,357,1436,2721,7,20915,1161,0,2,4,4,0
41800,192,3908,1168,838,957,57,25,144,1225,19,348,224,416,367,640,3018,5452,11,61921,3440,1,2,4,4,0
41803,80,3427,1289,550,1043,56,32,155,1345,10,167,93,185,177,278,1266,2075,5,11498,638,0,2,3,3,0
41804,147,6814,1392,870,1177,35,17,170,1427,14,494,280,531,508,811,4473,7289,7,54850,3047,2,2,5,5,0
41805,91,3010,773,419,590,28,0,166,801,10,204,113,217,214,330,1598,2554,5,13587,754,0,2,7,7,0
41808,109,4106,1450,624,1228,12,26,181,1462,14,306,186,354,320,540,2580,4493,8,36391,2021,1,2,1,1,0
41809,117,4645,1513,682,1277,25,13,200,1538,11,199,116,219,210,335,1557,2584,6,15641,868,0,2,1,1,0
41811,39,2355,652,304,544,16,6,88,668,6,89,51,101,95,152,591,998,3,3399,188,0,2,1,1,0
41814,35,1623,1293,570,1093,25,15,163,1318,10,195,123,241,205,364,1516,2795,6,17273,959,0,2,2,2,0
41815,36,1978,384,251,317,7,8,52,391,11,70,44,84,81,128,467,811,6,5355,297,0,2,3,3,0
41816,16,1209,215,129,180,6,0,29,221,8,65,43,72,73,115,415,711,4,3153,175,0,2,1,1,0
41817,69,2856,1043,504,840,53,9,147,1096,9,180,112,198,189,310,1377,2344,4,11604,644,0,2,22,22,0
41818,25,1027,373,158,315,8,0,51,381,5,76,44,79,81,123,486,779,2,2026,112,0,2,5,5,0
41819,71,3006,1178,367,1042,6,15,115,1184,9,94,51,95,103,146,644,976,4,4439,246,0,2,3,3,0
41826,9,228,19,8,11,5,0,4,24,2,5,3,6,7,9,13,25,1,30,1,0,2,1,0,0
41827,9,228,102,59,69,5,3,24,107,6,22,15,28,28,43,113,206,3,789,43,0,2,1,0,0
41828,9,228,106,40,36,3,49,17,109,8,17,13,23,25,36,93,167,5,904,50,0,2,1,0,0
41829,213,4595,182,127,129,0,0,53,182,5,39,21,42,44,63,217,343,2,926,51,0,2,2,0,0
41830,213,4595,1165,710,800,67,119,181,1232,18,243,153,282,261,435,2000,3492,10,36473,2026,1,2,2,0,0
41831,101,2081,773,419,590,28,0,166,801,10,204,113,217,214,330,1598,2554,5,13587,754,0,2,1,0,0
41832,101,2081,421,273,302,44,34,57,465,17,81,59,107,98,166,583,1098,11,12329,684,0,2,1,0,0
41833,60,1265,996,429,845,24,10,117,1020,7,76,50,88,83,138,494,879,4,3565,198,0,2,1,0,0
41834,60,1265,456,277,329,12,42,72,468,13,85,50,97,98,147,592,972,7,7212,400,0,2,1,0,0
41835,128,2606,1513,682,1277,25,13,200,1538,11,199,116,219,210,335,1557,2584,6,15641,868,0,2,1,0,0
41836,128,2606,819,519,539,24,98,155,843,15,96,57,106,111,163,690,1107,8,9171,509,0,2,1,0,0
41837,349,7049,1457,730,1242,11,6,188,1468,10,292,166,329,302,495,2424,4078,5,22973,1276,1,2,5,0,0
41838,349,7049,74,35,59,1,0,14,75,3,14,7,14,17,21,58,85,1,128,7,0,2,5,0,0
41839,349,7049,245,125,200,5,7,34,250,7,30,17,34,37,51,166,265,3,1053,58,0,2,5,0,0
41840,227,5129,4293,999,3693,19,54,507,4312,9,155,88,170,164,258,1156,1898,4,9368,520,0,2,3,0,0
41841,227,5129,1482,859,1002,125,135,219,1607,16,219,134,251,235,385,1766,3032,9,27804,1544,1,2,3,0,0
41842,80,1581,1020,354,843,12,15,144,1032,8,134,77,144,142,221,970,1580,4,6792,377,0,2,4,0,0
41843,212,5047,722,423,573,19,0,135,741,12,172,101,199,184,300,1320,2257,6,15668,870,0,2,2,0,0
41844,212,5047,1508,847,911,44,250,301,1552,14,148,88,169,162,257,1120,1886,7,15077,837,0,2,2,0,0
41845,310,7160,72,33,56,0,4,12,72,1,1,1,1,2,2,0,2,0,1,0,0,2,3,0,0
41846,310,7160,1454,835,1044,76,110,219,1530,17,275,158,296,292,454,2297,3718,9,34017,1889,1,2,3,0,0
41847,127,2807,1043,504,840,53,9,147,1096,9,180,112,198,189,310,1377,2344,4,11604,644,0,2,7,0,0
41848,127,2807,383,288,292,26,6,62,409,11,65,38,67,76,105,429,656,5,3719,206,0,2,7,0,0
41849,192,3908,1943,715,1694,26,18,214,1969,12,185,120,237,197,357,1436,2721,7,20915,1161,0,2,1,0,0
41850,192,3908,1168,838,957,57,25,144,1225,19,348,224,416,367,640,3018,5452,11,61921,3440,1,2,1,0,0
41851,80,3427,1289,550,1043,56,32,155,1345,10,167,93,185,177,278,1266,2075,5,11498,638,0,2,1,0,0
41852,147,6814,1392,870,1177,35,17,170,1427,14,494,280,531,508,811,4473,7289,7,54850,3047,2,2,5,0,0
41853,91,3010,773,419,590,28,0,166,801,10,204,113,217,214,330,1598,2554,5,13587,754,0,2,1,0,0
41854,112,5710,1782,648,1425,9,47,279,1791,8,171,97,189,179,286,1292,2140,4,9462,525,0,2,1,0,0
41855,23,601,102,59,69,5,3,24,107,6,22,15,28,28,43,113,206,3,789,43,0,2,1,0,0
41857,74,3770,1943,715,1694,26,18,214,1969,12,185,120,237,197,357,1436,2721,7,20915,1161,0,2,1,0,0
41861,213,4595,182,127,129,0,0,53,182,5,39,21,42,44,63,217,343,2,926,51,0,2,11,0,0
41862,213,4595,1165,710,800,67,119,181,1232,18,243,153,282,261,435,2000,3492,10,36473,2026,1,2,11,0,0
41863,101,2081,773,419,590,28,0,166,801,10,204,113,217,214,330,1598,2554,5,13587,754,0,2,2,0,0
41864,101,2081,421,273,302,44,34,57,465,17,81,59,107,98,166,583,1098,11,12329,684,0,2,2,0,0
41865,163,5080,1660,832,1314,41,38,274,1701,20,312,209,395,332,604,2671,5058,12,64042,3557,1,2,7,0,0
41866,163,5080,1057,646,719,113,100,145,1170,18,215,134,248,233,382,1740,3004,10,31186,1732,1,2,7,0,0
41867,128,2606,1513,682,1277,25,13,200,1538,11,199,116,219,210,335,1557,2584,6,15641,868,0,2,3,0,0
41868,128,2606,819,519,539,24,98,155,843,15,96,57,106,111,163,690,1107,8,9171,509,0,2,3,0,0
41869,54,1161,207,111,150,11,0,50,218,5,26,19,36,31,55,133,272,3,943,52,0,2,1,0,0
41870,54,1161,410,198,237,31,55,97,441,11,63,38,72,74,110,414,683,6,4293,238,0,2,1,0,0
41871,349,7049,1457,730,1242,11,6,188,1468,10,292,166,329,302,495,2424,4078,5,22973,1276,1,2,8,0,0
41872,349,7049,74,35,59,1,0,14,75,3,14,7,14,17,21,58,85,1,128,7,0,2,8,0,0
41873,349,7049,245,125,200,5,7,34,250,7,30,17,34,37,51,166,265,3,1053,58,0,2,8,0,0
41874,21,662,339,213,244,17,9,65,356,10,42,26,48,52,74,259,421,5,2410,133,0,2,1,0,0
41875,60,1673,1455,414,1257,16,76,112,1471,5,41,23,46,46,69,231,381,2,1069,59,0,2,2,0,0
41876,60,1673,669,365,481,22,61,110,691,15,103,63,122,118,185,747,1273,8,11311,628,0,2,2,0,0
41877,227,5129,4293,999,3693,19,54,507,4312,9,155,88,170,164,258,1156,1898,4,9368,520,0,2,5,0,0
41878,227,5129,1482,859,1002,125,135,219,1607,16,219,134,251,235,385,1766,3032,9,27804,1544,1,2,5,0,0
41879,27,954,74,35,59,1,0,14,75,3,14,7,14,17,21,58,85,1,128,7,0,2,4,0,0
41880,27,954,245,125,200,5,7,34,250,7,30,17,34,37,51,166,265,3,1053,58,0,2,4,0,0
41881,49,575,647,139,84,35,284,233,682,0,0,0,0,0,0,0,0,0,0,0,0,2,45,0,0
41882,178,4130,77,34,69,0,0,8,77,3,24,16,29,27,45,114,213,1,387,21,0,2,8,0,0
41883,178,4130,712,438,573,51,9,84,763,14,102,71,128,116,199,733,1364,8,11988,666,0,2,8,0,0
41884,80,1581,1020,354,843,12,15,144,1032,8,134,77,144,142,221,970,1580,4,6792,377,0,2,1,0,0
41885,23,388,424,94,331,4,0,89,428,1,5,5,5,6,10,11,25,0,12,0,0,2,1,0,0
41886,23,388,38,23,23,6,0,8,44,3,11,7,11,14,18,42,68,1,102,5,0,2,1,0,0
41887,212,5047,722,423,573,19,0,135,741,12,172,101,199,184,300,1320,2257,6,15668,870,0,2,8,0,0
41888,212,5047,1508,847,911,44,250,301,1552,14,148,88,169,162,257,1120,1886,7,15077,837,0,2,8,0,0
41889,310,7160,72,33,56,0,4,12,72,1,1,1,1,2,2,0,2,0,1,0,0,2,8,0,0
41890,310,7160,1454,835,1044,76,110,219,1530,17,275,158,296,292,454,2297,3718,9,34017,1889,1,2,8,0,0
41891,30,649,215,129,180,6,0,29,221,8,65,43,72,73,115,415,711,4,3153,175,0,2,5,0,0
41892,30,649,97,69,77,3,3,16,100,6,22,13,23,28,36,113,173,3,542,30,0,2,5,0,0
41893,127,2807,1043,504,840,53,9,147,1096,9,180,112,198,189,310,1377,2344,4,11604,644,0,2,26,1,0
41894,127,2807,383,288,292,26,6,62,409,11,65,38,67,76,105,429,656,5,3719,206,0,2,26,1,0
41895,103,1953,1178,367,1042,6,15,115,1184,9,94,51,95,103,146,644,976,4,4439,246,0,2,5,0,0
41896,103,1953,177,108,140,8,0,27,185,6,30,16,32,36,48,162,248,3,794,44,0,2,5,0,0
41897,192,3908,1943,715,1694,26,18,214,1969,12,185,120,237,197,357,1436,2721,7,20915,1161,0,2,6,0,0
41898,192,3908,1168,838,957,57,25,144,1225,19,348,224,416,367,640,3018,5452,11,61921,3440,1,2,6,0,0
41899,34,997,182,127,129,0,0,53,182,5,39,21,42,44,63,217,343,2,926,51,0,2,8,0,0
41900,147,6814,1392,870,1177,35,17,170,1427,14,494,280,531,508,811,4473,7289,7,54850,3047,2,2,20,0,0
41901,91,3010,773,419,590,28,0,166,801,10,204,113,217,214,330,1598,2554,5,13587,754,0,2,37,0,0
41902,2,26,6,4,4,0,0,2,6,1,4,2,4,5,6,8,13,0,6,0,0,2,1,0,0
41903,96,4365,1338,495,1086,10,64,173,1348,11,122,82,157,133,239,883,1686,7,11934,663,0,2,3,0,0
41904,148,6832,139,89,101,2,0,35,141,7,54,34,62,61,96,330,569,4,2287,127,0,2,8,0,0
41905,148,6832,7,5,5,0,0,2,7,1,2,1,2,3,3,2,4,0,2,0,0,2,8,0,0
41906,32,948,465,148,393,5,8,60,470,4,31,20,31,35,51,161,261,2,523,29,0,2,2,0,0
41907,32,948,16,12,9,0,0,6,16,1,2,1,2,3,3,2,4,0,2,0,0,2,2,0,0
41908,23,601,102,59,69,5,3,24,107,6,22,15,28,28,43,113,206,3,789,43,0,2,5,0,0
41909,109,4106,1450,624,1228,12,26,181,1462,14,306,186,354,320,540,2580,4493,8,36391,2021,1,2,17,0,0
41910,150,4203,1660,832,1314,41,38,274,1701,20,312,209,395,332,604,2671,5058,12,64042,3557,1,2,2,0,0
41911,117,4645,1513,682,1277,25,13,200,1538,11,199,116,219,210,335,1557,2584,6,15641,868,0,2,5,0,0
41912,66,3414,1296,573,1062,40,33,157,1336,8,201,118,231,209,349,1561,2689,4,12365,686,0,2,6,0,0
41913,78,4093,1457,730,1242,11,6,188,1468,10,292,166,329,302,495,2424,4078,5,22973,1276,1,2,7,0,0
41914,39,2355,652,304,544,16,6,88,668,6,89,51,101,95,152,591,998,3,3399,188,0,2,15,0,0
41915,8,273,74,35,59,1,0,14,75,3,14,7,14,17,21,58,85,1,128,7,0,2,7,0,0
41916,90,4427,1523,757,1297,19,12,193,1542,12,193,117,230,205,347,1508,2664,7,19053,1058,0,2,3,0,0
41917,68,2962,1020,354,843,12,15,144,1032,8,134,77,144,142,221,970,1580,4,6792,377,0,2,7,0,0
41919,21,661,424,94,331,4,0,89,428,1,5,5,5,6,10,11,25,0,12,0,0,2,10,0,0
41920,40,2367,334,251,279,10,4,40,344,5,127,74,143,132,217,899,1528,2,4303,239,0,2,2,0,0
41922,36,1978,384,251,317,7,8,52,391,11,70,44,84,81,128,467,811,6,5355,297,0,2,2,0,0
41923,15,638,722,423,573,19,0,135,741,12,172,101,199,184,300,1320,2257,6,15668,870,0,2,3,0,0
41924,16,1209,215,129,180,6,0,29,221,8,65,43,72,73,115,415,711,4,3153,175,0,2,2,0,0
41925,69,2856,1043,504,840,53,9,147,1096,9,180,112,198,189,310,1377,2344,4,11604,644,0,2,15,0,0
41926,14,529,295,56,236,0,4,54,295,2,9,5,10,11,15,30,51,1,57,3,0,2,12,0,0
41927,25,1027,373,158,315,8,0,51,381,5,76,44,79,81,123,486,779,2,2026,112,0,2,5,0,0
41928,71,3006,1178,367,1042,6,15,115,1184,9,94,51,95,103,146,644,976,4,4439,246,0,2,12,0,0
41929,74,3770,1943,715,1694,26,18,214,1969,12,185,120,237,197,357,1436,2721,7,20915,1161,0,2,13,0,0
41930,14,825,442,244,305,14,16,103,456,11,68,45,75,79,120,452,756,6,4588,254,0,2,5,0,0
41931,48,1784,1098,241,925,5,10,155,1103,7,46,25,49,53,74,273,423,3,1580,87,0,2,23,0,0
41932,12,476,601,196,481,2,23,85,603,8,63,36,72,71,108,400,664,4,3036,168,0,2,1,0,0
41935,27,542,2,2,2,0,0,0,2,0,0,0,0,0,0,0,0,0,0,0,0,2,0,1,0
41949,27,542,99,48,90,1,3,5,100,0,0,0,0,0,0,0,0,0,0,0,0,2,0,1,0
41950,27,542,8,5,5,2,0,1,10,0,0,0,0,0,0,0,0,0,0,0,0,2,0,1,0
41951,27,542,1217,716,841,84,126,174,1301,14,185,118,215,199,333,1446,2542,8,20687,1149,0,2,0,1,0
41952,27,542,160,89,115,0,13,31,160,7,15,11,17,22,28,78,124,3,495,27,0,2,0,1,0
41953,27,542,10,10,9,9,0,0,19,0,0,0,0,0,0,0,0,0,0,0,0,2,0,1,0
41954,27,542,173,84,99,8,29,36,181,5,12,7,13,17,20,54,81,2,221,12,0,2,0,1,0
41955,27,542,3,1,1,3,0,0,6,0,0,0,0,0,0,0,0,0,0,0,0,2,0,1,0
41956,163,5080,1660,832,1314,41,38,274,1701,20,312,209,395,332,604,2671,5058,12,64042,3557,1,2,0,3,0
41957,163,5080,1057,646,719,113,100,145,1170,18,215,134,248,233,382,1740,3004,10,31186,1732,1,2,0,3,0
41958,60,1265,996,429,845,24,10,117,1020,7,76,50,88,83,138,494,879,4,3565,198,0,2,0,1,0
41959,60,1265,456,277,329,12,42,72,468,13,85,50,97,98,147,592,972,7,7212,400,0,2,0,1,0
41960,54,1161,207,111,150,11,0,50,218,5,26,19,36,31,55,133,272,3,943,52,0,2,0,2,0
41961,54,1161,410,198,237,31,55,97,441,11,63,38,72,74,110,414,683,6,4293,238,0,2,0,2,0
41962,349,7049,1457,730,1242,11,6,188,1468,10,292,166,329,302,495,2424,4078,5,22973,1276,1,2,0,1,0
41963,349,7049,74,35,59,1,0,14,75,3,14,7,14,17,21,58,85,1,128,7,0,2,0,1,0
41964,349,7049,245,125,200,5,7,34,250,7,30,17,34,37,51,166,265,3,1053,58,0,2,0,1,0
41965,21,662,339,213,244,17,9,65,356,10,42,26,48,52,74,259,421,5,2410,133,0,2,0,1,0
41966,227,5129,4293,999,3693,19,54,507,4312,9,155,88,170,164,258,1156,1898,4,9368,520,0,2,0,7,0
41967,227,5129,1482,859,1002,125,135,219,1607,16,219,134,251,235,385,1766,3032,9,27804,1544,1,2,0,7,0
41968,6,136,44,22,19,0,19,6,44,2,10,6,12,12,18,35,64,1,77,4,0,2,0,1,0
41969,178,4130,77,34,69,0,0,8,77,3,24,16,29,27,45,114,213,1,387,21,0,2,0,2,0
41970,178,4130,712,438,573,51,9,84,763,14,102,71,128,116,199,733,1364,8,11988,666,0,2,0,2,0
41971,80,1581,1020,354,843,12,15,144,1032,8,134,77,144,142,221,970,1580,4,6792,377,0,2,0,4,0
41972,212,5047,722,423,573,19,0,135,741,12,172,101,199,184,300,1320,2257,6,15668,870,0,2,0,1,0
41973,212,5047,1508,847,911,44,250,301,1552,14,148,88,169,162,257,1120,1886,7,15077,837,0,2,0,1,0
41974,310,7160,72,33,56,0,4,12,72,1,1,1,1,2,2,0,2,0,1,0,0,2,0,2,0
41975,310,7160,1454,835,1044,76,110,219,1530,17,275,158,296,292,454,2297,3718,9,34017,1889,1,2,0,2,0
41976,192,3908,1943,715,1694,26,18,214,1969,12,185,120,237,197,357,1436,2721,7,20915,1161,0,2,0,1,0
41977,192,3908,1168,838,957,57,25,144,1225,19,348,224,416,367,640,3018,5452,11,61921,3440,1,2,0,1,0
41978,80,3427,1289,550,1043,56,32,155,1345,10,167,93,185,177,278,1266,2075,5,11498,638,0,2,0,3,0
41979,147,6814,1392,870,1177,35,17,170,1427,14,494,280,531,508,811,4473,7289,7,54850,3047,2,2,0,3,0
41980,91,3010,773,419,590,28,0,166,801,10,204,113,217,214,330,1598,2554,5,13587,754,0,2,0,1,0
41981,96,4365,1338,495,1086,10,64,173,1348,11,122,82,157,133,239,883,1686,7,11934,663,0,2,0,4,0
41982,148,6832,139,89,101,2,0,35,141,7,54,34,62,61,96,330,569,4,2287,127,0,2,0,8,0
41983,148,6832,7,5,5,0,0,2,7,1,2,1,2,3,3,2,4,0,2,0,0,2,0,8,0
41984,112,5710,1782,648,1425,9,47,279,1791,8,171,97,189,179,286,1292,2140,4,9462,525,0,2,0,5,0
41985,20,541,256,139,192,9,7,47,265,4,23,12,24,27,36,112,171,2,357,19,0,2,0,1,0
41986,117,4645,1513,682,1277,25,13,200,1538,11,199,116,219,210,335,1557,2584,6,15641,868,0,2,0,2,0
41987,66,3414,1296,573,1062,40,33,157,1336,8,201,118,231,209,349,1561,2689,4,12365,686,0,2,0,1,0
41988,78,4093,1457,730,1242,11,6,188,1468,10,292,166,329,302,495,2424,4078,5,22973,1276,1,2,0,1,0
41989,64,2957,1455,414,1257,16,76,112,1471,5,41,23,46,46,69,231,381,2,1069,59,0,2,0,1,0
41990,68,2962,1020,354,843,12,15,144,1032,8,134,77,144,142,221,970,1580,4,6792,377,0,2,0,2,0
41991,35,1623,1293,570,1093,25,15,163,1318,10,195,123,241,205,364,1516,2795,6,17273,959,0,2,0,2,0
41992,38,1637,386,256,301,16,9,68,402,4,59,35,69,63,104,355,621,2,1453,80,0,2,0,1,0
41993,71,3006,1178,367,1042,6,15,115,1184,9,94,51,95,103,146,644,976,4,4439,246,0,2,0,1,0
41994,74,3770,1943,715,1694,26,18,214,1969,12,185,120,237,197,357,1436,2721,7,20915,1161,0,2,0,1,0
41995,12,476,601,196,481,2,23,85,603,8,63,36,72,71,108,400,664,4,3036,168,0,2,0,1,0
41996,101,2081,773,419,590,28,0,166,801,10,204,113,217,214,330,1598,2554,5,13587,754,0,2,2,1,0
41997,101,2081,421,273,302,44,34,57,465,17,81,59,107,98,166,583,1098,11,12329,684,0,2,2,1,0
41998,27,954,74,35,59,1,0,14,75,3,14,7,14,17,21,58,85,1,128,7,0,2,2,1,0
41999,27,954,245,125,200,5,7,34,250,7,30,17,34,37,51,166,265,3,1053,58,0,2,2,1,0
42000,23,601,102,59,69,5,3,24,107,6,22,15,28,28,43,113,206,3,789,43,0,2,2,1,0
42001,66,3414,1296,573,1062,40,33,157,1336,8,201,118,231,209,349,1561,2689,4,12365,686,0,2,2,1,0
42002,78,4093,1457,730,1242,11,6,188,1468,10,292,166,329,302,495,2424,4078,5,22973,1276,1,2,2,1,0
42003,40,2367,334,251,279,10,4,40,344,5,127,74,143,132,217,899,1528,2,4303,239,0,2,2,1,0
42004,147,6812,1392,870,1177,35,17,170,1427,14,494,280,531,508,811,4473,7289,7,54850,3047,2,2,4,4,0
42005,150,4203,1660,832,1314,41,38,274,1701,20,312,209,395,332,604,2671,5058,12,64042,3557,1,2,6,6,0
42006,349,7049,1457,730,1242,11,6,188,1468,10,292,166,329,302,495,2424,4078,5,22973,1276,1,2,2,1,1
42007,349,7049,74,35,59,1,0,14,75,3,14,7,14,17,21,58,85,1,128,7,0,2,2,1,1
42008,349,7049,245,125,200,5,7,34,250,7,30,17,34,37,51,166,265,3,1053,58,0,2,2,1,1
42009,178,4132,77,34,69,0,0,8,77,3,24,16,29,27,45,114,213,1,387,21,0,2,4,2,1
42010,178,4132,712,438,573,51,9,84,763,14,102,71,128,116,199,733,1364,8,11988,666,0,2,4,2,1
42011,47,2498,520,294,400,33,13,81,553,10,261,204,367,271,571,2128,4614,7,32445,1802,1,2,2,1,1
42012,112,5711,1782,648,1425,9,47,279,1791,8,171,97,189,179,286,1292,2140,4,9462,525,0,2,21,5,1
42013,34,997,182,127,129,0,0,53,182,5,39,21,42,44,63,217,343,2,926,51,0,2,10,6,1
42014,147,6812,1392,870,1177,35,17,170,1427,14,494,280,531,508,811,4473,7289,7,54850,3047,2,2,4,2,1
42015,114,5711,1782,648,1425,9,47,279,1791,8,171,97,189,179,286,1292,2140,4,9462,525,0,2,4,2,1
42016,38,1637,386,256,301,16,9,68,402,4,59,35,69,63,104,355,621,2,1453,80,0,2,4,2,1
42017,10,228,19,8,11,5,0,4,24,2,5,3,6,7,9,13,25,1,30,1,0,2,2,1,1
42018,10,228,102,59,69,5,3,24,107,6,22,15,28,28,43,113,206,3,789,43,0,2,2,1,1
42019,10,228,106,40,36,3,49,17,109,8,17,13,23,25,36,93,167,5,904,50,0,2,2,1,1
42020,153,6832,139,89,101,2,0,35,141,7,54,34,62,61,96,330,569,4,2287,127,0,2,10,5,1
42021,153,6832,7,5,5,0,0,2,7,1,2,1,2,3,3,2,4,0,2,0,0,2,10,5,1
42022,132,5711,1782,648,1425,9,47,279,1791,8,171,97,189,179,286,1292,2140,4,9462,525,0,2,48,24,1
42023,72,2856,1043,504,840,53,9,147,1096,9,180,112,198,189,310,1377,2344,4,11604,644,0,2,10,5,1
42026,40,2367,334,251,279,10,4,40,344,5,127,74,143,132,217,899,1528,2,4303,239,0,2,4,4,0
42027,102,2083,773,419,590,28,0,166,801,10,204,113,217,214,330,1598,2554,5,13587,754,0,2,2,1,0
42028,102,2083,421,273,302,44,34,57,465,17,81,59,107,98,166,583,1098,11,12329,684,0,2,2,1,0
42029,164,5082,1660,832,1314,41,38,274,1701,20,312,209,395,332,604,2671,5058,12,64042,3557,1,2,2,1,0
42030,164,5082,1057,646,719,113,100,145,1170,18,215,134,248,233,382,1740,3004,10,31186,1732,1,2,2,1,0
42031,86,1808,477,336,357,30,23,73,507,16,194,134,250,210,384,1538,2962,10,30538,1696,0,2,11,5,0
42032,312,7164,72,33,56,0,4,12,72,1,1,1,1,2,2,0,2,0,1,0,0,2,6,2,0
42033,312,7164,1454,835,1044,76,110,219,1530,17,275,158,296,292,454,2297,3718,9,34017,1889,1,2,6,2,0
42034,26,1029,373,158,315,8,0,51,381,5,76,44,79,81,123,486,779,2,2026,112,0,2,4,1,0
42035,339,7202,72,33,56,0,4,12,72,1,1,1,1,2,2,0,2,0,1,0,0,2,20,6,0
42036,339,7202,1454,835,1044,76,110,219,1530,17,275,158,296,292,454,2297,3718,9,34017,1889,1,2,20,6,0
42037,151,6958,139,89,101,2,0,35,141,7,54,34,62,61,96,330,569,4,2287,127,0,2,61,4,0
42038,151,6958,7,5,5,0,0,2,7,1,2,1,2,3,3,2,4,0,2,0,0,2,61,4,0
42039,10,228,19,8,11,5,0,4,24,2,5,3,6,7,9,13,25,1,30,1,0,2,5,2,0
42040,10,228,102,59,69,5,3,24,107,6,22,15,28,28,43,113,206,3,789,43,0,2,5,2,0
42041,10,228,106,40,36,3,49,17,109,8,17,13,23,25,36,93,167,5,904,50,0,2,5,2,0
42042,213,4595,182,127,129,0,0,53,182,5,39,21,42,44,63,217,343,2,926,51,0,2,41,28,0
42043,213,4595,1165,710,800,67,119,181,1232,18,243,153,282,261,435,2000,3492,10,36473,2026,1,2,41,28,0
42044,102,2083,773,419,590,28,0,166,801,10,204,113,217,214,330,1598,2554,5,13587,754,0,2,24,22,0
42045,102,2083,421,273,302,44,34,57,465,17,81,59,107,98,166,583,1098,11,12329,684,0,2,24,22,0
42069,164,5082,1660,832,1314,41,38,274,1701,20,312,209,395,332,604,2671,5058,12,64042,3557,1,2,17,12,0
42070,164,5082,1057,646,719,113,100,145,1170,18,215,134,248,233,382,1740,3004,10,31186,1732,1,2,17,12,0
42071,86,1808,477,336,357,30,23,73,507,16,194,134,250,210,384,1538,2962,10,30538,1696,0,2,16,10,0
42072,62,1345,996,429,845,24,10,117,1020,7,76,50,88,83,138,494,879,4,3565,198,0,2,3,3,0
42073,62,1345,456,277,329,12,42,72,468,13,85,50,97,98,147,592,972,7,7212,400,0,2,3,3,0
42074,128,2606,1513,682,1277,25,13,200,1538,11,199,116,219,210,335,1557,2584,6,15641,868,0,2,7,3,0
42075,128,2606,819,519,539,24,98,155,843,15,96,57,106,111,163,690,1107,8,9171,509,0,2,7,3,0
42076,54,1166,207,111,150,11,0,50,218,5,26,19,36,31,55,133,272,3,943,52,0,2,7,8,0
42077,54,1166,410,198,237,31,55,97,441,11,63,38,72,74,110,414,683,6,4293,238,0,2,7,8,0
42078,349,7049,1457,730,1242,11,6,188,1468,10,292,166,329,302,495,2424,4078,5,22973,1276,1,2,54,41,0
42079,349,7049,74,35,59,1,0,14,75,3,14,7,14,17,21,58,85,1,128,7,0,2,54,41,0
42080,349,7049,245,125,200,5,7,34,250,7,30,17,34,37,51,166,265,3,1053,58,0,2,54,41,0
42081,21,662,339,213,244,17,9,65,356,10,42,26,48,52,74,259,421,5,2410,133,0,2,1,1,0
42083,60,1673,1455,414,1257,16,76,112,1471,5,41,23,46,46,69,231,381,2,1069,59,0,2,19,17,0
42084,60,1673,669,365,481,22,61,110,691,15,103,63,122,118,185,747,1273,8,11311,628,0,2,19,17,0
42085,227,5129,4293,999,3693,19,54,507,4312,9,155,88,170,164,258,1156,1898,4,9368,520,0,2,32,32,0
42086,227,5129,1482,859,1002,125,135,219,1607,16,219,134,251,235,385,1766,3032,9,27804,1544,1,2,32,32,0
42088,27,954,74,35,59,1,0,14,75,3,14,7,14,17,21,58,85,1,128,7,0,2,25,20,0
42089,27,954,245,125,200,5,7,34,250,7,30,17,34,37,51,166,265,3,1053,58,0,2,25,20,0
42091,83,2359,1523,757,1297,19,12,193,1542,12,193,117,230,205,347,1508,2664,7,19053,1058,0,2,6,6,0
42092,83,2359,701,378,504,33,58,109,734,13,110,68,126,123,194,794,1346,7,10027,557,0,2,6,6,0
42093,178,4132,77,34,69,0,0,8,77,3,24,16,29,27,45,114,213,1,387,21,0,2,57,34,0
42094,178,4132,712,438,573,51,9,84,763,14,102,71,128,116,199,733,1364,8,11988,666,0,2,57,34,0
42095,94,1809,1020,354,843,12,15,144,1032,8,134,77,144,142,221,970,1580,4,6792,377,0,2,6,2,0
42096,46,955,447,308,343,6,5,95,453,7,96,59,111,103,170,651,1136,4,4600,255,0,2,3,3,0
42097,46,955,322,174,179,16,74,51,338,10,41,26,46,51,72,252,408,5,2291,127,0,2,3,3,0
42098,23,388,424,94,331,4,0,89,428,1,5,5,5,6,10,11,25,0,12,0,0,2,3,2,0
42099,23,388,38,23,23,6,0,8,44,3,11,7,11,14,18,42,68,1,102,5,0,2,3,2,0
42100,17,518,184,100,137,2,15,30,186,6,38,20,39,44,59,214,322,3,991,55,0,2,4,4,0
42101,17,518,103,65,74,8,5,16,111,7,17,9,17,24,26,89,119,3,417,23,0,2,4,4,0
42102,212,5047,722,423,573,19,0,135,741,12,172,101,199,184,300,1320,2257,6,15668,870,0,2,47,38,0
42103,212,5047,1508,847,911,44,250,301,1552,14,148,88,169,162,257,1120,1886,7,15077,837,0,2,47,38,0
42104,304,7099,72,33,56,0,4,12,72,1,1,1,1,2,2,0,2,0,1,0,0,2,487,52,0
42105,304,7099,1454,835,1044,76,110,219,1530,17,275,158,296,292,454,2297,3718,9,34017,1889,1,2,487,52,0
42106,40,837,386,256,301,16,9,68,402,4,59,35,69,63,104,355,621,2,1453,80,0,2,2,2,0
42107,40,837,264,131,164,11,41,46,275,6,38,22,40,44,62,214,338,3,1068,59,0,2,2,2,0
42108,30,649,215,129,180,6,0,29,221,8,65,43,72,73,115,415,711,4,3153,175,0,2,9,4,0
42109,30,649,97,69,77,3,3,16,100,6,22,13,23,28,36,113,173,3,542,30,0,2,9,4,0
42110,127,2807,1043,504,840,53,9,147,1096,9,180,112,198,189,310,1377,2344,4,11604,644,0,2,53,21,0
42111,127,2807,383,288,292,26,6,62,409,11,65,38,67,76,105,429,656,5,3719,206,0,2,53,21,0
42112,103,1953,1178,367,1042,6,15,115,1184,9,94,51,95,103,146,644,976,4,4439,246,0,2,29,24,0
42113,103,1953,177,108,140,8,0,27,185,6,30,16,32,36,48,162,248,3,794,44,0,2,29,24,0
42114,192,3908,1943,715,1694,26,18,214,1969,12,185,120,237,197,357,1436,2721,7,20915,1161,0,2,38,29,0
42115,192,3908,1168,838,957,57,25,144,1225,19,348,224,416,367,640,3018,5452,11,61921,3440,1,2,38,29,0
42116,16,477,442,244,305,14,16,103,456,11,68,45,75,79,120,452,756,6,4588,254,0,2,2,2,0
42117,16,477,182,102,99,11,40,35,193,3,11,6,11,14,17,42,64,1,97,5,0,2,2,2,0
42118,62,1240,1098,241,925,5,10,155,1103,7,46,25,49,53,74,273,423,3,1580,87,0,2,3,3,0
42119,62,1240,282,202,222,14,2,44,296,8,42,24,43,50,67,250,378,4,1548,86,0,2,3,3,0
42120,19,408,601,196,481,2,23,85,603,8,63,36,72,71,108,400,664,4,3036,168,0,2,1,1,0
42121,19,408,156,79,106,5,16,28,161,5,14,8,15,19,23,64,97,2,261,14,0,2,1,1,0
42122,80,3427,1289,550,1043,56,32,155,1345,10,167,93,185,177,278,1266,2075,5,11498,638,0,2,11,13,0
42123,34,997,182,127,129,0,0,53,182,5,39,21,42,44,63,217,343,2,926,51,0,2,18,6,0
42124,147,6812,1392,870,1177,35,17,170,1427,14,494,280,531,508,811,4473,7289,7,54850,3047,2,2,67,43,0
42125,91,3010,773,419,590,28,0,166,801,10,204,113,217,214,330,1598,2554,5,13587,754,0,2,59,19,0
42129,2,26,6,4,4,0,0,2,6,1,4,2,4,5,6,8,13,0,6,0,0,2,2,1,0
42131,53,3287,520,294,400,33,13,81,553,10,261,204,367,271,571,2128,4614,7,32445,1802,1,2,67,68,0
42132,98,4425,1338,495,1086,10,64,173,1348,11,122,82,157,133,239,883,1686,7,11934,663,0,2,12,13,0
42133,153,6832,139,89,101,2,0,35,141,7,54,34,62,61,96,330,569,4,2287,127,0,2,39,39,0
42134,153,6832,7,5,5,0,0,2,7,1,2,1,2,3,3,2,4,0,2,0,0,2,39,39,0
42135,32,948,465,148,393,5,8,60,470,4,31,20,31,35,51,161,261,2,523,29,0,2,5,3,0
42136,32,948,16,12,9,0,0,6,16,1,2,1,2,3,3,2,4,0,2,0,0,2,5,3,0
42137,132,5711,1782,648,1425,9,47,279,1791,8,171,97,189,179,286,1292,2140,4,9462,525,0,2,100,62,0
42139,23,601,102,59,69,5,3,24,107,6,22,15,28,28,43,113,206,3,789,43,0,2,18,11,0
42140,109,4106,1450,624,1228,12,26,181,1462,14,306,186,354,320,540,2580,4493,8,36391,2021,1,2,41,24,0
42141,150,4203,1660,832,1314,41,38,274,1701,20,312,209,395,332,604,2671,5058,12,64042,3557,1,2,22,20,0
42142,117,4645,1513,682,1277,25,13,200,1538,11,199,116,219,210,335,1557,2584,6,15641,868,0,2,8,5,0
42143,66,3414,1296,573,1062,40,33,157,1336,8,201,118,231,209,349,1561,2689,4,12365,686,0,2,18,12,0
42144,78,4093,1457,730,1242,11,6,188,1468,10,292,166,329,302,495,2424,4078,5,22973,1276,1,2,13,7,0
42145,39,2355,652,304,544,16,6,88,668,6,89,51,101,95,152,591,998,3,3399,188,0,2,46,31,0
42146,64,2957,1455,414,1257,16,76,112,1471,5,41,23,46,46,69,231,381,2,1069,59,0,2,9,11,0
42147,8,273,74,35,59,1,0,14,75,3,14,7,14,17,21,58,85,1,128,7,0,2,8,1,0
42148,90,4427,1523,757,1297,19,12,193,1542,12,193,117,230,205,347,1508,2664,7,19053,1058,0,2,3,1,0
42149,70,3035,1020,354,843,12,15,144,1032,8,134,77,144,142,221,970,1580,4,6792,377,0,2,21,16,0
42150,37,1624,447,308,343,6,5,95,453,7,96,59,111,103,170,651,1136,4,4600,255,0,2,2,1,0
42152,40,2367,334,251,279,10,4,40,344,5,127,74,143,132,217,899,1528,2,4303,239,0,2,16,13,0
42153,12,492,184,100,137,2,15,30,186,6,38,20,39,44,59,214,322,3,991,55,0,2,3,4,0
42154,35,1623,1293,570,1093,25,15,163,1318,10,195,123,241,205,364,1516,2795,6,17273,959,0,2,7,9,0
42155,36,1978,384,251,317,7,8,52,391,11,70,44,84,81,128,467,811,6,5355,297,0,2,7,5,0
42156,15,638,722,423,573,19,0,135,741,12,172,101,199,184,300,1320,2257,6,15668,870,0,2,4,0,0
42157,38,1637,386,256,301,16,9,68,402,4,59,35,69,63,104,355,621,2,1453,80,0,2,4,3,0
42158,16,1209,215,129,180,6,0,29,221,8,65,43,72,73,115,415,711,4,3153,175,0,2,10,10,0
42159,72,2856,1043,504,840,53,9,147,1096,9,180,112,198,189,310,1377,2344,4,11604,644,0,2,56,38,0
42160,14,529,295,56,236,0,4,54,295,2,9,5,10,11,15,30,51,1,57,3,0,2,13,1,0
42161,26,1029,373,158,315,8,0,51,381,5,76,44,79,81,123,486,779,2,2026,112,0,2,16,8,0
42162,71,3006,1178,367,1042,6,15,115,1184,9,94,51,95,103,146,644,976,4,4439,246,0,2,18,7,0
42163,74,3770,1943,715,1694,26,18,214,1969,12,185,120,237,197,357,1436,2721,7,20915,1161,0,2,34,21,0
42165,48,1784,1098,241,925,5,10,155,1103,7,46,25,49,53,74,273,423,3,1580,87,0,2,24,1,0
42166,12,476,601,196,481,2,23,85,603,8,63,36,72,71,108,400,664,4,3036,168,0,2,3,3,0
42168,94,1809,1020,354,843,12,15,144,1032,8,134,77,144,142,221,970,1580,4,6792,377,0,2,2,0,1
42169,304,7104,72,33,56,0,4,12,72,1,1,1,1,2,2,0,2,0,1,0,0,2,5,1,1
42170,304,7104,1454,835,1044,76,110,219,1530,17,275,158,296,292,454,2297,3718,9,34017,1889,1,2,5,1,1
42171,77,1522,757,253,292,73,244,162,830,13,61,38,67,74,105,409,651,7,4654,258,0,2,7,6,1
42172,147,6812,1392,870,1177,35,17,170,1427,14,494,280,531,508,811,4473,7289,7,54850,3047,2,2,8,8,1
42173,91,3010,773,419,590,28,0,166,801,10,204,113,217,214,330,1598,2554,5,13587,754,0,2,3,4,1
42174,53,3287,520,294,400,33,13,81,553,10,261,204,367,271,571,2128,4614,7,32445,1802,1,2,15,14,1
42175,98,4425,1338,495,1086,10,64,173,1348,11,122,82,157,133,239,883,1686,7,11934,663,0,2,1,1,1
42176,117,4645,1513,682,1277,25,13,200,1538,11,199,116,219,210,335,1557,2584,6,15641,868,0,2,13,13,1
42177,39,2355,652,304,544,16,6,88,668,6,89,51,101,95,152,591,998,3,3399,188,0,2,2,2,1
42178,70,3035,1020,354,843,12,15,144,1032,8,134,77,144,142,221,970,1580,4,6792,377,0,2,1,2,1
42179,72,2856,1043,504,840,53,9,147,1096,9,180,112,198,189,310,1377,2344,4,11604,644,0,2,2,2,1
42180,94,1795,1020,354,843,12,15,144,1032,8,134,77,144,142,221,970,1580,4,6792,377,0,2,4,4,0
42182,129,2875,1043,504,840,53,9,147,1096,9,180,112,198,189,310,1377,2344,4,11604,644,0,2,19,0,1
42183,129,2875,383,288,292,26,6,62,409,11,65,38,67,76,105,429,656,5,3719,206,0,2,19,0,1
42184,70,2942,1043,504,840,53,9,147,1096,9,180,112,198,189,310,1377,2344,4,11604,644,0,2,27,0,1
42185,129,2875,1043,504,840,53,9,147,1096,9,180,112,198,189,310,1377,2344,4,11604,644,0,2,19,0,0
42186,129,2875,383,288,292,26,6,62,409,11,65,38,67,76,105,429,656,5,3719,206,0,2,19,0,0
42187,70,2942,1043,504,840,53,9,147,1096,9,180,112,198,189,310,1377,2344,4,11604,644,0,2,27,0,0
42221,60,1265,996,429,845,24,10,117,1020,7,76,50,88,83,138,494,879,4,3565,198,0,2,3,3,0
42222,60,1265,456,277,329,12,42,72,468,13,85,50,97,98,147,592,972,7,7212,400,0,2,3,3,0
42225,54,1161,207,111,150,11,0,50,218,5,26,19,36,31,55,133,272,3,943,52,0,2,7,8,0
42226,54,1161,410,198,237,31,55,97,441,11,63,38,72,74,110,414,683,6,4293,238,0,2,7,8,0
42242,178,4132,77,34,69,0,0,8,77,3,24,16,29,27,45,114,213,1,387,21,0,2,42,34,0
42243,178,4132,712,438,573,51,9,84,763,14,102,71,128,116,199,733,1364,8,11988,666,0,2,42,34,0
42244,80,1581,1020,354,843,12,15,144,1032,8,134,77,144,142,221,970,1580,4,6792,377,0,2,6,5,0
42253,315,7206,72,33,56,0,4,12,72,1,1,1,1,2,2,0,2,0,1,0,0,2,66,54,0
42254,315,7206,1454,835,1044,76,110,219,1530,17,275,158,296,292,454,2297,3718,9,34017,1889,1,2,66,54,0
42263,192,3908,1943,715,1694,26,18,214,1969,12,185,120,237,197,357,1436,2721,7,20915,1161,0,2,35,29,0
42264,192,3908,1168,838,957,57,25,144,1225,19,348,224,416,367,640,3018,5452,11,61921,3440,1,2,35,29,0
42279,47,2498,520,294,400,33,13,81,553,10,261,204,367,271,571,2128,4614,7,32445,1802,1,2,80,80,0
42280,96,4365,1338,495,1086,10,64,173,1348,11,122,82,157,133,239,883,1686,7,11934,663,0,2,12,13,0
42281,156,6958,139,89,101,2,0,35,141,7,54,34,62,61,96,330,569,4,2287,127,0,2,39,39,0
42282,156,6958,7,5,5,0,0,2,7,1,2,1,2,3,3,2,4,0,2,0,0,2,39,39,0
42297,68,2962,1020,354,843,12,15,144,1032,8,134,77,144,142,221,970,1580,4,6792,377,0,2,21,16,0
42315,184,4243,77,34,69,0,0,8,77,3,24,16,29,27,45,114,213,1,387,21,0,2,18,0,0
42316,184,4243,712,438,573,51,9,84,763,14,102,71,128,116,199,733,1364,8,11988,666,0,2,18,0,0
42318,129,2875,1043,504,840,53,9,147,1096,9,180,112,198,189,310,1377,2344,4,11604,644,0,2,18,0,0
42319,129,2875,383,288,292,26,6,62,409,11,65,38,67,76,105,429,656,5,3719,206,0,2,18,0,0
42321,73,2942,1043,504,840,53,9,147,1096,9,180,112,198,189,310,1377,2344,4,11604,644,0,2,27,0,0
42322,91,3010,773,419,590,28,0,166,801,10,204,113,217,214,330,1598,2554,5,13587,754,0,2,2,1,0
42323,53,3320,520,294,400,33,13,81,553,10,261,204,367,271,571,2128,4614,7,32445,1802,1,2,3,1,0
42324,307,7146,72,33,56,0,4,12,72,1,1,1,1,2,2,0,2,0,1,0,0,2,20,6,0
42325,307,7146,1454,835,1044,76,110,219,1530,17,275,158,296,292,454,2297,3718,9,34017,1889,1,2,20,6,0
42326,156,6958,139,89,101,2,0,35,141,7,54,34,62,61,96,330,569,4,2287,127,0,2,61,4,0
42327,156,6958,7,5,5,0,0,2,7,1,2,1,2,3,3,2,4,0,2,0,0,2,61,4,0
42328,55,1182,207,111,150,11,0,50,218,5,26,19,36,31,55,133,272,3,943,52,0,2,10,1,0
42329,55,1182,410,198,237,31,55,97,441,11,63,38,72,74,110,414,683,6,4293,238,0,2,10,1,0
42330,118,4686,1513,682,1277,25,13,200,1538,11,199,116,219,210,335,1557,2584,6,15641,868,0,2,9,0,0
42385,184,4243,77,34,69,0,0,8,77,3,24,16,29,27,45,114,213,1,387,21,0,2,59,36,0
42386,184,4243,712,438,573,51,9,84,763,14,102,71,128,116,199,733,1364,8,11988,666,0,2,59,36,0
42387,94,1795,1020,354,843,12,15,144,1032,8,134,77,144,142,221,970,1580,4,6792,377,0,2,8,2,0
42396,307,7146,72,33,56,0,4,12,72,1,1,1,1,2,2,0,2,0,1,0,0,2,512,59,0
42397,307,7146,1454,835,1044,76,110,219,1530,17,275,158,296,292,454,2297,3718,9,34017,1889,1,2,512,59,0
42398,77,1522,757,253,292,73,244,162,830,13,61,38,67,74,105,409,651,7,4654,258,0,2,7,6,0
42403,129,2875,1043,504,840,53,9,147,1096,9,180,112,198,189,310,1377,2344,4,11604,644,0,2,52,21,0
42404,129,2875,383,288,292,26,6,62,409,11,65,38,67,76,105,429,656,5,3719,206,0,2,52,21,0
42417,147,6812,1392,870,1177,35,17,170,1427,14,494,280,531,508,811,4473,7289,7,54850,3047,2,2,73,49,0
42418,91,3010,773,419,590,28,0,166,801,10,204,113,217,214,330,1598,2554,5,13587,754,0,2,61,21,0
42424,53,3320,520,294,400,33,13,81,553,10,261,204,367,271,571,2128,4614,7,32445,1802,1,2,84,82,0
42425,98,4425,1338,495,1086,10,64,173,1348,11,122,82,157,133,239,883,1686,7,11934,663,0,2,13,14,0
42426,156,6958,139,89,101,2,0,35,141,7,54,34,62,61,96,330,569,4,2287,127,0,2,99,42,0
42427,156,6958,7,5,5,0,0,2,7,1,2,1,2,3,3,2,4,0,2,0,0,2,99,42,0
42435,117,4645,1513,682,1277,25,13,200,1538,11,199,116,219,210,335,1557,2584,6,15641,868,0,2,21,18,0
42436,72,3755,1296,573,1062,40,33,157,1336,8,201,118,231,209,349,1561,2689,4,12365,686,0,2,18,12,0
42438,39,2355,652,304,544,16,6,88,668,6,89,51,101,95,152,591,998,3,3399,188,0,2,48,33,0
42442,70,3035,1020,354,843,12,15,144,1032,8,134,77,144,142,221,970,1580,4,6792,377,0,2,22,18,0
42452,73,2942,1043,504,840,53,9,147,1096,9,180,112,198,189,310,1377,2344,4,11604,644,0,2,59,41,0
42460,55,1182,207,111,150,11,0,50,218,5,26,19,36,31,55,133,272,3,943,52,0,2,0,1,1
42461,55,1182,410,198,237,31,55,97,441,11,63,38,72,74,110,414,683,6,4293,238,0,2,0,1,1
42462,118,4694,1513,682,1277,25,13,200,1538,11,199,116,219,210,335,1557,2584,6,15641,868,0,2,1,1,1
42463,55,1187,207,111,150,11,0,50,218,5,26,19,36,31,55,133,272,3,943,52,0,2,9,1,0
42464,55,1187,410,198,237,31,55,97,441,11,63,38,72,74,110,414,683,6,4293,238,0,2,9,1,0
42465,118,4694,1513,682,1277,25,13,200,1538,11,199,116,219,210,335,1557,2584,6,15641,868,0,2,10,1,0
42467,87,2932,773,419,590,28,0,166,801,10,204,113,217,214,330,1598,2554,5,13587,754,0,2,2,17,1
42468,118,4695,1513,682,1277,25,13,200,1538,11,199,116,219,210,335,1557,2584,6,15641,868,0,2,14,14,1
42471,21,432,601,196,481,2,23,85,603,8,63,36,72,71,108,400,664,4,3036,168,0,2,5,0,1
42472,21,432,156,79,106,5,16,28,161,5,14,8,15,19,23,64,97,2,261,14,0,2,5,0,1
42473,15,541,601,196,481,2,23,85,603,8,63,36,72,71,108,400,664,4,3036,168,0,2,29,0,1
42474,21,432,601,196,481,2,23,85,603,8,63,36,72,71,108,400,664,4,3036,168,0,2,5,0,0
42475,21,432,156,79,106,5,16,28,161,5,14,8,15,19,23,64,97,2,261,14,0,2,5,0,0
42476,15,541,601,196,481,2,23,85,603,8,63,36,72,71,108,400,664,4,3036,168,0,2,29,0,0
42477,147,6812,1392,870,1177,35,17,170,1427,14,494,280,531,508,811,4473,7289,7,54850,3047,2,2,8,8,0
42478,87,2932,773,419,590,28,0,166,801,10,204,113,217,214,330,1598,2554,5,13587,754,0,2,2,17,0
42479,118,4695,1513,682,1277,25,13,200,1538,11,199,116,219,210,335,1557,2584,6,15641,868,0,2,14,14,0
42480,39,2355,652,304,544,16,6,88,668,6,89,51,101,95,152,591,998,3,3399,188,0,2,2,2,0
42481,72,2856,1043,504,840,53,9,147,1096,9,180,112,198,189,310,1377,2344,4,11604,644,0,2,2,2,0
42482,349,7042,1457,730,1242,11,6,188,1468,10,292,166,329,302,495,2424,4078,5,22973,1276,1,2,0,1,1
42483,349,7042,74,35,59,1,0,14,75,3,14,7,14,17,21,58,85,1,128,7,0,2,0,1,1
42484,349,7042,245,125,200,5,7,34,250,7,30,17,34,37,51,166,265,3,1053,58,0,2,0,1,1
42485,95,1819,1020,354,843,12,15,144,1032,8,134,77,144,142,221,970,1580,4,6792,377,0,2,12,3,0
42486,72,3105,1020,354,843,12,15,144,1032,8,134,77,144,142,221,970,1580,4,6792,377,0,2,13,0,0
42487,19,409,601,196,481,2,23,85,603,8,63,36,72,71,108,400,664,4,3036,168,0,2,3,2,0
42488,19,409,156,79,106,5,16,28,161,5,14,8,15,19,23,64,97,2,261,14,0,2,3,2,0
42493,212,5063,722,423,573,19,0,135,741,12,172,101,199,184,300,1320,2257,6,15668,870,0,2,5,2,0
42494,212,5063,1508,847,911,44,250,301,1552,14,148,88,169,162,257,1120,1886,7,15077,837,0,2,5,2,0
42495,74,1418,757,253,292,73,244,162,830,13,61,38,67,74,105,409,651,7,4654,258,0,2,8,54,1
42496,255,6154,72,33,56,0,4,12,72,1,1,1,1,2,2,0,2,0,1,0,0,2,0,432,0
42497,255,6154,1454,835,1044,76,110,219,1530,17,275,158,296,292,454,2297,3718,9,34017,1889,1,2,0,432,0
42498,74,1418,757,253,292,73,244,162,830,13,61,38,67,74,105,409,651,7,4654,258,0,2,1,1,0
42499,255,6152,72,33,56,0,4,12,72,1,1,1,1,2,2,0,2,0,1,0,0,2,0,1,0
42500,255,6152,1454,835,1044,76,110,219,1530,17,275,158,296,292,454,2297,3718,9,34017,1889,1,2,0,1,0
42501,255,6152,72,33,56,0,4,12,72,1,1,1,1,2,2,0,2,0,1,0,0,2,0,433,0
42502,255,6152,1454,835,1044,76,110,219,1530,17,275,158,296,292,454,2297,3718,9,34017,1889,1,2,0,433,0
42503,74,1418,757,253,292,73,244,162,830,13,61,38,67,74,105,409,651,7,4654,258,0,2,8,54,0
42504,98,4449,1338,495,1086,10,64,173,1348,11,122,82,157,133,239,883,1686,7,11934,663,0,2,11,1,1
42505,132,5719,1782,648,1425,9,47,279,1791,8,171,97,189,179,286,1292,2140,4,9462,525,0,2,2,1,1
42506,72,3114,1020,354,843,12,15,144,1032,8,134,77,144,142,221,970,1580,4,6792,377,0,2,1,0,1
42507,36,1591,386,256,301,16,9,68,402,4,59,35,69,63,104,355,621,2,1453,80,0,2,1,27,1
42508,48,1784,1098,241,925,5,10,155,1103,7,46,25,49,53,74,273,423,3,1580,87,0,2,7,7,1
42509,15,568,601,196,481,2,23,85,603,8,63,36,72,71,108,400,664,4,3036,168,0,2,4,0,1
42510,48,1795,1098,241,925,5,10,155,1103,7,46,25,49,53,74,273,423,3,1580,87,0,2,50,55,0
42511,98,4449,1338,495,1086,10,64,173,1348,11,122,82,157,133,239,883,1686,7,11934,663,0,2,11,1,0
42512,132,5719,1782,648,1425,9,47,279,1791,8,171,97,189,179,286,1292,2140,4,9462,525,0,2,2,1,0
42513,72,3114,1020,354,843,12,15,144,1032,8,134,77,144,142,221,970,1580,4,6792,377,0,2,1,0,0
42514,36,1591,386,256,301,16,9,68,402,4,59,35,69,63,104,355,621,2,1453,80,0,2,1,27,0
42515,48,1795,1098,241,925,5,10,155,1103,7,46,25,49,53,74,273,423,3,1580,87,0,2,57,62,0
42516,15,568,601,196,481,2,23,85,603,8,63,36,72,71,108,400,664,4,3036,168,0,2,4,0,0
42517,60,1677,1455,414,1257,16,76,112,1471,5,41,23,46,46,69,231,381,2,1069,59,0,2,1,1,0
42518,60,1677,669,365,481,22,61,110,691,15,103,63,122,118,185,747,1273,8,11311,628,0,2,1,1,0
42519,131,2635,1513,682,1277,25,13,200,1538,11,199,116,219,210,335,1557,2584,6,15641,868,0,2,19,0,1
42520,131,2635,819,519,539,24,98,155,843,15,96,57,106,111,163,690,1107,8,9171,509,0,2,19,0,1
42521,349,7042,1457,730,1242,11,6,188,1468,10,292,166,329,302,495,2424,4078,5,22973,1276,1,2,0,1,0
42522,349,7042,74,35,59,1,0,14,75,3,14,7,14,17,21,58,85,1,128,7,0,2,0,1,0
42523,349,7042,245,125,200,5,7,34,250,7,30,17,34,37,51,166,265,3,1053,58,0,2,0,1,0
42524,131,2635,1513,682,1277,25,13,200,1538,11,199,116,219,210,335,1557,2584,6,15641,868,0,2,1,1,0
42525,131,2635,819,519,539,24,98,155,843,15,96,57,106,111,163,690,1107,8,9171,509,0,2,1,1,0
42529,131,2635,1513,682,1277,25,13,200,1538,11,199,116,219,210,335,1557,2584,6,15641,868,0,2,19,0,0
42530,131,2635,819,519,539,24,98,155,843,15,96,57,106,111,163,690,1107,8,9171,509,0,2,19,0,0
42531,65,3005,1455,414,1257,16,76,112,1471,5,41,23,46,46,69,231,381,2,1069,59,0,2,16,0,0
42542,21,433,601,196,481,2,23,85,603,8,63,36,72,71,108,400,664,4,3036,168,0,2,3,2,0
42543,21,433,156,79,106,5,16,28,161,5,14,8,15,19,23,64,97,2,261,14,0,2,3,2,0
42544,87,2932,773,419,590,28,0,166,801,10,204,113,217,214,330,1598,2554,5,13587,754,0,2,0,15,0
42545,118,4695,1513,682,1277,25,13,200,1538,11,199,116,219,210,335,1557,2584,6,15641,868,0,2,1,1,0
42547,315,7207,72,33,56,0,4,12,72,1,1,1,1,2,2,0,2,0,1,0,0,2,4,3,0
42548,315,7207,1454,835,1044,76,110,219,1530,17,275,158,296,292,454,2297,3718,9,34017,1889,1,2,4,3,0
42549,103,1955,1178,367,1042,6,15,115,1184,9,94,51,95,103,146,644,976,4,4439,246,0,2,1,1,1
42550,103,1955,177,108,140,8,0,27,185,6,30,16,32,36,48,162,248,3,794,44,0,2,1,1,1
42554,103,1955,1178,367,1042,6,15,115,1184,9,94,51,95,103,146,644,976,4,4439,246,0,2,1,1,0
42555,103,1955,177,108,140,8,0,27,185,6,30,16,32,36,48,162,248,3,794,44,0,2,1,1,0
42557,132,2651,1513,682,1277,25,13,200,1538,11,199,116,219,210,335,1557,2584,6,15641,868,0,2,5,0,0
42558,132,2651,819,519,539,24,98,155,843,15,96,57,106,111,163,690,1107,8,9171,509,0,2,5,0,0
42559,118,4765,1513,682,1277,25,13,200,1538,11,199,116,219,210,335,1557,2584,6,15641,868,0,2,10,0,0
42560,78,1458,757,253,292,73,244,162,830,13,61,38,67,74,105,409,651,7,4654,258,0,2,28,1,0
42561,78,1458,757,253,292,73,244,162,830,13,61,38,67,74,105,409,651,7,4654,258,0,2,2,2,0
42562,78,1458,757,253,292,73,244,162,830,13,61,38,67,74,105,409,651,7,4654,258,0,2,1,0,0
42563,75,1461,757,253,292,73,244,162,830,13,61,38,67,74,105,409,651,7,4654,258,0,2,24,15,0
42564,54,3424,520,294,400,33,13,81,553,10,261,204,367,271,571,2128,4614,7,32445,1802,1,2,14,0,0
42567,161,7070,139,89,101,2,0,35,141,7,54,34,62,61,96,330,569,4,2287,127,0,2,34,0,1
42568,161,7070,7,5,5,0,0,2,7,1,2,1,2,3,3,2,4,0,2,0,0,2,34,0,1
42572,229,5170,4293,999,3693,19,54,507,4312,9,155,88,170,164,258,1156,1898,4,9368,520,0,2,13,8,1
42573,229,5170,1482,859,1002,125,135,219,1607,16,219,134,251,235,385,1766,3032,9,27804,1544,1,2,13,8,1
42574,161,7059,139,89,101,2,0,35,141,7,54,34,62,61,96,330,569,4,2287,127,0,2,0,1,1
42575,161,7059,7,5,5,0,0,2,7,1,2,1,2,3,3,2,4,0,2,0,0,2,0,1,1
42576,11,410,42,7,35,4,0,5,46,1,2,1,2,3,3,2,4,0,2,0,0,2,2,1,1
42577,11,410,11,6,10,0,0,1,11,2,4,2,4,6,6,10,15,1,15,0,0,2,2,1,1
42582,255,6153,72,33,56,0,4,12,72,1,1,1,1,2,2,0,2,0,1,0,0,2,4,3,0
42583,255,6153,1454,835,1044,76,110,219,1530,17,275,158,296,292,454,2297,3718,9,34017,1889,1,2,4,3,0
42588,132,2651,1513,682,1277,25,13,200,1538,11,199,116,219,210,335,1557,2584,6,15641,868,0,2,24,0,0
42589,132,2651,819,519,539,24,98,155,843,15,96,57,106,111,163,690,1107,8,9171,509,0,2,24,0,0
42604,118,4765,1513,682,1277,25,13,200,1538,11,199,116,219,210,335,1557,2584,6,15641,868,0,2,11,1,0
42607,50,586,647,139,84,35,284,233,682,0,0,0,0,0,0,0,0,0,0,0,0,2,15,1,0
42608,192,3949,1943,715,1694,26,18,214,1969,12,185,120,237,197,357,1436,2721,7,20915,1161,0,2,6,4,0
42609,192,3949,1168,838,957,57,25,144,1225,19,348,224,416,367,640,3018,5452,11,61921,3440,1,2,6,4,0
42610,75,3810,1943,715,1694,26,18,214,1969,12,185,120,237,197,357,1436,2721,7,20915,1161,0,2,17,0,0
42615,57,1306,996,429,845,24,10,117,1020,7,76,50,88,83,138,494,879,4,3565,198,0,2,11,15,0
42616,57,1306,456,277,329,12,42,72,468,13,85,50,97,98,147,592,972,7,7212,400,0,2,11,15,0
42617,58,1312,996,429,845,24,10,117,1020,7,76,50,88,83,138,494,879,4,3565,198,0,2,1,1,0
42618,58,1312,456,277,329,12,42,72,468,13,85,50,97,98,147,592,972,7,7212,400,0,2,1,1,0
42619,58,1312,996,429,845,24,10,117,1020,7,76,50,88,83,138,494,879,4,3565,198,0,2,11,15,0
42620,58,1312,456,277,329,12,42,72,468,13,85,50,97,98,147,592,972,7,7212,400,0,2,11,15,0
42621,59,1352,996,429,845,24,10,117,1020,7,76,50,88,83,138,494,879,4,3565,198,0,2,9,4,0
42622,59,1352,456,277,329,12,42,72,468,13,85,50,97,98,147,592,972,7,7212,400,0,2,9,4,0
42623,50,586,647,139,84,35,284,233,682,0,0,0,0,0,0,0,0,0,0,0,0,2,4,1,0
42624,50,586,647,139,84,35,284,233,682,0,0,0,0,0,0,0,0,0,0,0,0,2,1,1,0
42625,227,5131,4293,999,3693,19,54,507,4312,9,155,88,170,164,258,1156,1898,4,9368,520,0,2,3,3,1
42626,227,5131,1482,859,1002,125,135,219,1607,16,219,134,251,235,385,1766,3032,9,27804,1544,1,2,3,3,1
42627,184,4247,77,34,69,0,0,8,77,3,24,16,29,27,45,114,213,1,387,21,0,2,2,1,1
42628,184,4247,712,438,573,51,9,84,763,14,102,71,128,116,199,733,1364,8,11988,666,0,2,2,1,1
42629,18,466,205,80,86,16,53,53,221,7,18,10,19,25,29,94,134,3,497,27,0,0,141,0,1
42630,255,6153,72,33,56,0,4,12,72,1,1,1,1,2,2,0,2,0,1,0,0,2,1,1,1
42631,255,6153,1454,835,1044,76,110,219,1530,17,275,158,296,292,454,2297,3718,9,34017,1889,1,2,1,1,1
42632,74,1418,757,253,292,73,244,162,830,13,61,38,67,74,105,409,651,7,4654,258,0,2,1,1,1
42633,40,837,386,256,301,16,9,68,402,4,59,35,69,63,104,355,621,2,1453,80,0,2,2,2,1
42634,40,837,264,131,164,11,41,46,275,6,38,22,40,44,62,214,338,3,1068,59,0,2,2,2,1
42635,112,2470,1043,504,840,53,9,147,1096,9,180,112,198,189,310,1377,2344,4,11604,644,0,2,3,122,1
42636,112,2470,383,288,292,26,6,62,409,11,65,38,67,76,105,429,656,5,3719,206,0,2,3,122,1
42637,102,1930,1178,367,1042,6,15,115,1184,9,94,51,95,103,146,644,976,4,4439,246,0,2,3,15,1
42638,102,1930,177,108,140,8,0,27,185,6,30,16,32,36,48,162,248,3,794,44,0,2,3,15,1
42641,75,2972,1043,504,840,53,9,147,1096,9,180,112,198,189,310,1377,2344,4,11604,644,0,2,11,2,1
42642,18,466,205,80,86,16,53,53,221,7,18,10,19,25,29,94,134,3,497,27,0,2,5,6,0
42643,40,837,386,256,301,16,9,68,402,4,59,35,69,63,104,355,621,2,1453,80,0,2,1,0,0
42644,40,837,264,131,164,11,41,46,275,6,38,22,40,44,62,214,338,3,1068,59,0,2,1,0,0
42645,112,2470,1043,504,840,53,9,147,1096,9,180,112,198,189,310,1377,2344,4,11604,644,0,2,1,4,0
42646,112,2470,383,288,292,26,6,62,409,11,65,38,67,76,105,429,656,5,3719,206,0,2,1,4,0
42647,102,1930,1178,367,1042,6,15,115,1184,9,94,51,95,103,146,644,976,4,4439,246,0,2,0,1,0
42648,102,1930,177,108,140,8,0,27,185,6,30,16,32,36,48,162,248,3,794,44,0,2,0,1,0
42649,75,2972,1043,504,840,53,9,147,1096,9,180,112,198,189,310,1377,2344,4,11604,644,0,2,0,1,0
42653,214,4602,182,127,129,0,0,53,182,5,39,21,42,44,63,217,343,2,926,51,0,2,1,1,1
42654,214,4602,1165,710,800,67,119,181,1232,18,243,153,282,261,435,2000,3492,10,36473,2026,1,2,1,1,1
42655,149,6984,1392,870,1177,35,17,170,1427,14,494,280,531,508,811,4473,7289,7,54850,3047,2,2,30,0,1
42656,229,5170,4293,999,3693,19,54,507,4312,9,155,88,170,164,258,1156,1898,4,9368,520,0,2,13,8,0
42657,229,5170,1482,859,1002,125,135,219,1607,16,219,134,251,235,385,1766,3032,9,27804,1544,1,2,13,8,0
42658,11,410,42,7,35,4,0,5,46,1,2,1,2,3,3,2,4,0,2,0,0,2,2,1,0
42659,11,410,11,6,10,0,0,1,11,2,4,2,4,6,6,10,15,1,15,0,0,2,2,1,0
42660,161,7059,139,89,101,2,0,35,141,7,54,34,62,61,96,330,569,4,2287,127,0,2,33,0,0
42661,161,7059,7,5,5,0,0,2,7,1,2,1,2,3,3,2,4,0,2,0,0,2,33,0,0
42662,214,4602,182,127,129,0,0,53,182,5,39,21,42,44,63,217,343,2,926,51,0,2,1,1,0
42663,214,4602,1165,710,800,67,119,181,1232,18,243,153,282,261,435,2000,3492,10,36473,2026,1,2,1,1,0
42664,149,6984,1392,870,1177,35,17,170,1427,14,494,280,531,508,811,4473,7289,7,54850,3047,2,2,30,0,0
42665,229,5172,4293,999,3693,19,54,507,4312,9,155,88,170,164,258,1156,1898,4,9368,520,0,2,3,3,0
42666,229,5172,1482,859,1002,125,135,219,1607,16,219,134,251,235,385,1766,3032,9,27804,1544,1,2,3,3,0
42667,184,4247,77,34,69,0,0,8,77,3,24,16,29,27,45,114,213,1,387,21,0,2,2,1,0
42668,184,4247,712,438,573,51,9,84,763,14,102,71,128,116,199,733,1364,8,11988,666,0,2,2,1,0
42669,18,466,205,80,86,16,53,53,221,7,18,10,19,25,29,94,134,3,497,27,0,0,140,0,0
42670,255,6153,72,33,56,0,4,12,72,1,1,1,1,2,2,0,2,0,1,0,0,2,1,1,0
42671,255,6153,1454,835,1044,76,110,219,1530,17,275,158,296,292,454,2297,3718,9,34017,1889,1,2,1,1,0
42675,112,2470,1043,504,840,53,9,147,1096,9,180,112,198,189,310,1377,2344,4,11604,644,0,2,4,126,0
42676,112,2470,383,288,292,26,6,62,409,11,65,38,67,76,105,429,656,5,3719,206,0,2,4,126,0
42677,102,1930,1178,367,1042,6,15,115,1184,9,94,51,95,103,146,644,976,4,4439,246,0,2,3,16,0
42678,102,1930,177,108,140,8,0,27,185,6,30,16,32,36,48,162,248,3,794,44,0,2,3,16,0
42679,62,1240,1098,241,925,5,10,155,1103,7,46,25,49,53,74,273,423,3,1580,87,0,2,2,2,0
42680,62,1240,282,202,222,14,2,44,296,8,42,24,43,50,67,250,378,4,1548,86,0,2,2,2,0
42681,75,2972,1043,504,840,53,9,147,1096,9,180,112,198,189,310,1377,2344,4,11604,644,0,2,10,2,0
42682,75,1461,757,253,292,73,244,162,830,13,61,38,67,74,105,409,651,7,4654,258,0,2,37,0,0
42684,347,7012,1457,730,1242,11,6,188,1468,10,292,166,329,302,495,2424,4078,5,22973,1276,1,2,0,9,0
42685,347,7012,74,35,59,1,0,14,75,3,14,7,14,17,21,58,85,1,128,7,0,2,0,9,0
42686,347,7012,245,125,200,5,7,34,250,7,30,17,34,37,51,166,265,3,1053,58,0,2,0,9,0
42687,183,4238,77,34,69,0,0,8,77,3,24,16,29,27,45,114,213,1,387,21,0,2,0,9,0
42688,183,4238,712,438,573,51,9,84,763,14,102,71,128,116,199,733,1364,8,11988,666,0,2,0,9,0
42689,179,4137,77,34,69,0,0,8,77,3,24,16,29,27,45,114,213,1,387,21,0,2,0,18,0
42690,179,4137,712,438,573,51,9,84,763,14,102,71,128,116,199,733,1364,8,11988,666,0,2,0,18,0
42691,211,5051,722,423,573,19,0,135,741,12,172,101,199,184,300,1320,2257,6,15668,870,0,2,7,9,0
42692,211,5051,1508,847,911,44,250,301,1552,14,148,88,169,162,257,1120,1886,7,15077,837,0,2,7,9,0
42693,211,5051,722,423,573,19,0,135,741,12,172,101,199,184,300,1320,2257,6,15668,870,0,2,0,1,0
42694,211,5051,1508,847,911,44,250,301,1552,14,148,88,169,162,257,1120,1886,7,15077,837,0,2,0,1,0
42697,211,5051,722,423,573,19,0,135,741,12,172,101,199,184,300,1320,2257,6,15668,870,0,2,6,9,0
42698,211,5051,1508,847,911,44,250,301,1552,14,148,88,169,162,257,1120,1886,7,15077,837,0,2,6,9,0
42702,178,4128,77,34,69,0,0,8,77,3,24,16,29,27,45,114,213,1,387,21,0,2,0,9,0
42703,178,4128,712,438,573,51,9,84,763,14,102,71,128,116,199,733,1364,8,11988,666,0,2,0,9,0
42706,59,1352,996,429,845,24,10,117,1020,7,76,50,88,83,138,494,879,4,3565,198,0,2,34,19,0
42707,59,1352,456,277,329,12,42,72,468,13,85,50,97,98,147,592,972,7,7212,400,0,2,34,19,0
42708,55,1187,207,111,150,11,0,50,218,5,26,19,36,31,55,133,272,3,943,52,0,2,2,1,0
42709,55,1187,410,198,237,31,55,97,441,11,63,38,72,74,110,414,683,6,4293,238,0,2,2,1,0
42711,229,5172,4293,999,3693,19,54,507,4312,9,155,88,170,164,258,1156,1898,4,9368,520,0,2,16,11,0
42712,229,5172,1482,859,1002,125,135,219,1607,16,219,134,251,235,385,1766,3032,9,27804,1544,1,2,16,11,0
42713,50,586,647,139,84,35,284,233,682,0,0,0,0,0,0,0,0,0,0,0,0,2,18,1,0
42714,184,4247,77,34,69,0,0,8,77,3,24,16,29,27,45,114,213,1,387,21,0,2,20,1,0
42715,184,4247,712,438,573,51,9,84,763,14,102,71,128,116,199,733,1364,8,11988,666,0,2,20,1,0
42716,95,1819,1020,354,843,12,15,144,1032,8,134,77,144,142,221,970,1580,4,6792,377,0,2,91,20,0
42718,255,6153,72,33,56,0,4,12,72,1,1,1,1,2,2,0,2,0,1,0,0,2,18,467,0
42719,255,6153,1454,835,1044,76,110,219,1530,17,275,158,296,292,454,2297,3718,9,34017,1889,1,2,18,467,0
42720,75,1461,757,253,292,73,244,162,830,13,61,38,67,74,105,409,651,7,4654,258,0,0,616,0,0
42723,112,2470,1043,504,840,53,9,147,1096,9,180,112,198,189,310,1377,2344,4,11604,644,0,2,22,126,0
42724,112,2470,383,288,292,26,6,62,409,11,65,38,67,76,105,429,656,5,3719,206,0,2,22,126,0
42731,21,433,601,196,481,2,23,85,603,8,63,36,72,71,108,400,664,4,3036,168,0,2,5,0,0
42732,21,433,156,79,106,5,16,28,161,5,14,8,15,19,23,64,97,2,261,14,0,2,5,0,0
42736,54,3424,520,294,400,33,13,81,553,10,261,204,367,271,571,2128,4614,7,32445,1802,1,2,124,38,0
42737,98,4449,1338,495,1086,10,64,173,1348,11,122,82,157,133,239,883,1686,7,11934,663,0,2,31,1,0
42742,72,3114,1020,354,843,12,15,144,1032,8,134,77,144,142,221,970,1580,4,6792,377,0,2,36,1,0
42744,75,2972,1043,504,840,53,9,147,1096,9,180,112,198,189,310,1377,2344,4,11604,644,0,2,37,2,0
42747,15,568,601,196,481,2,23,85,603,8,63,36,72,71,108,400,664,4,3036,168,0,2,33,0,0
42748,212,5103,722,423,573,19,0,135,741,12,172,101,199,184,300,1320,2257,6,15668,870,0,2,8,4,0
42749,212,5103,1508,847,911,44,250,301,1552,14,148,88,169,162,257,1120,1886,7,15077,837,0,2,8,4,0
42750,113,2497,1043,504,840,53,9,147,1096,9,180,112,198,189,310,1377,2344,4,11604,644,0,2,6,1,0
42751,113,2497,383,288,292,26,6,62,409,11,65,38,67,76,105,429,656,5,3719,206,0,2,6,1,0
42752,81,3461,1289,550,1043,56,32,155,1345,10,167,93,185,177,278,1266,2075,5,11498,638,0,2,14,1,0
42753,113,2492,1043,504,840,53,9,147,1096,9,180,112,198,189,310,1377,2344,4,11604,644,0,2,2,2,0
42754,113,2492,383,288,292,26,6,62,409,11,65,38,67,76,105,429,656,5,3719,206,0,2,2,2,0
42757,113,2492,1043,504,840,53,9,147,1096,9,180,112,198,189,310,1377,2344,4,11604,644,0,2,6,1,0
42758,113,2492,383,288,292,26,6,62,409,11,65,38,67,76,105,429,656,5,3719,206,0,2,6,1,0
42760,193,3988,1943,715,1694,26,18,214,1969,12,185,120,237,197,357,1436,2721,7,20915,1161,0,2,17,6,1
42761,193,3988,1168,838,957,57,25,144,1225,19,348,224,416,367,640,3018,5452,11,61921,3440,1,2,17,6,1
42762,76,3899,1943,715,1694,26,18,214,1969,12,185,120,237,197,357,1436,2721,7,20915,1161,0,2,10,0,1
42763,213,4579,182,127,129,0,0,53,182,5,39,21,42,44,63,217,343,2,926,51,0,2,1,3,1
42764,213,4579,1165,710,800,67,119,181,1232,18,243,153,282,261,435,2000,3492,10,36473,2026,1,2,1,3,1
42765,102,2083,773,419,590,28,0,166,801,10,204,113,217,214,330,1598,2554,5,13587,754,0,2,2,1,1
42766,102,2083,421,273,302,44,34,57,465,17,81,59,107,98,166,583,1098,11,12329,684,0,2,2,1,1
42769,27,540,2,2,2,0,0,0,2,0,0,0,0,0,0,0,0,0,0,0,0,2,2,2,1
42783,27,540,99,48,90,1,3,5,100,0,0,0,0,0,0,0,0,0,0,0,0,2,2,2,1
42784,27,540,8,5,5,2,0,1,10,0,0,0,0,0,0,0,0,0,0,0,0,2,2,2,1
42785,27,540,1217,716,841,84,126,174,1301,14,185,118,215,199,333,1446,2542,8,20687,1149,0,2,2,2,1
42786,27,540,160,89,115,0,13,31,160,7,15,11,17,22,28,78,124,3,495,27,0,2,2,2,1
42787,27,540,10,10,9,9,0,0,19,0,0,0,0,0,0,0,0,0,0,0,0,2,2,2,1
42788,27,540,173,84,99,8,29,36,181,5,12,7,13,17,20,54,81,2,221,12,0,2,2,2,1
42789,27,540,3,1,1,3,0,0,6,0,0,0,0,0,0,0,0,0,0,0,0,2,2,2,1
42790,164,5068,1660,832,1314,41,38,274,1701,20,312,209,395,332,604,2671,5058,12,64042,3557,1,2,12,11,1
42791,164,5068,1057,646,719,113,100,145,1170,18,215,134,248,233,382,1740,3004,10,31186,1732,1,2,12,11,1
42792,17,345,95,58,50,9,16,20,104,12,33,24,45,45,69,209,378,8,3100,172,0,2,3,3,1
42793,86,1804,477,336,357,30,23,73,507,16,194,134,250,210,384,1538,2962,10,30538,1696,0,2,4,3,1
42794,132,2644,1513,682,1277,25,13,200,1538,11,199,116,219,210,335,1557,2584,6,15641,868,0,2,4,5,1
42795,132,2644,819,519,539,24,98,155,843,15,96,57,106,111,163,690,1107,8,9171,509,0,2,4,5,1
42796,349,7034,1457,730,1242,11,6,188,1468,10,292,166,329,302,495,2424,4078,5,22973,1276,1,2,5,4,1
42797,349,7034,74,35,59,1,0,14,75,3,14,7,14,17,21,58,85,1,128,7,0,2,5,4,1
42798,349,7034,245,125,200,5,7,34,250,7,30,17,34,37,51,166,265,3,1053,58,0,2,5,4,1
42799,184,4243,77,34,69,0,0,8,77,3,24,16,29,27,45,114,213,1,387,21,0,2,2,1,1
42800,184,4243,712,438,573,51,9,84,763,14,102,71,128,116,199,733,1364,8,11988,666,0,2,2,1,1
42801,46,957,447,308,343,6,5,95,453,7,96,59,111,103,170,651,1136,4,4600,255,0,2,4,5,1
42802,46,957,322,174,179,16,74,51,338,10,41,26,46,51,72,252,408,5,2291,127,0,2,4,5,1
42803,23,382,424,94,331,4,0,89,428,1,5,5,5,6,10,11,25,0,12,0,0,2,1,2,1
42804,23,382,38,23,23,6,0,8,44,3,11,7,11,14,18,42,68,1,102,5,0,2,1,2,1
42805,17,518,184,100,137,2,15,30,186,6,38,20,39,44,59,214,322,3,991,55,0,2,2,2,1
42806,17,518,103,65,74,8,5,16,111,7,17,9,17,24,26,89,119,3,417,23,0,2,2,2,1
42807,212,5055,722,423,573,19,0,135,741,12,172,101,199,184,300,1320,2257,6,15668,870,0,2,6,5,1
42808,212,5055,1508,847,911,44,250,301,1552,14,148,88,169,162,257,1120,1886,7,15077,837,0,2,6,5,1
42809,255,6147,72,33,56,0,4,12,72,1,1,1,1,2,2,0,2,0,1,0,0,2,4,3,1
42810,255,6147,1454,835,1044,76,110,219,1530,17,275,158,296,292,454,2297,3718,9,34017,1889,1,2,4,3,1
42811,129,2871,1043,504,840,53,9,147,1096,9,180,112,198,189,310,1377,2344,4,11604,644,0,2,1,1,1
42812,129,2871,383,288,292,26,6,62,409,11,65,38,67,76,105,429,656,5,3719,206,0,2,1,1,1
42813,103,1953,1178,367,1042,6,15,115,1184,9,94,51,95,103,146,644,976,4,4439,246,0,2,2,2,1
42814,103,1953,177,108,140,8,0,27,185,6,30,16,32,36,48,162,248,3,794,44,0,2,2,2,1
42815,192,3947,1943,715,1694,26,18,214,1969,12,185,120,237,197,357,1436,2721,7,20915,1161,0,2,4,3,1
42816,192,3947,1168,838,957,57,25,144,1225,19,348,224,416,367,640,3018,5452,11,61921,3440,1,2,4,3,1
42817,11,404,42,7,35,4,0,5,46,1,2,1,2,3,3,2,4,0,2,0,0,2,1,1,1
42818,11,404,11,6,10,0,0,1,11,2,4,2,4,6,6,10,15,1,15,0,0,2,1,1,1
42819,214,4586,182,127,129,0,0,53,182,5,39,21,42,44,63,217,343,2,926,51,0,2,1,3,0
42820,214,4586,1165,710,800,67,119,181,1232,18,243,153,282,261,435,2000,3492,10,36473,2026,1,2,1,3,0
42825,27,540,2,2,2,0,0,0,2,0,0,0,0,0,0,0,0,0,0,0,0,2,2,2,0
42839,27,540,99,48,90,1,3,5,100,0,0,0,0,0,0,0,0,0,0,0,0,2,2,2,0
42840,27,540,8,5,5,2,0,1,10,0,0,0,0,0,0,0,0,0,0,0,0,2,2,2,0
42841,27,540,1217,716,841,84,126,174,1301,14,185,118,215,199,333,1446,2542,8,20687,1149,0,2,2,2,0
42842,27,540,160,89,115,0,13,31,160,7,15,11,17,22,28,78,124,3,495,27,0,2,2,2,0
42843,27,540,10,10,9,9,0,0,19,0,0,0,0,0,0,0,0,0,0,0,0,2,2,2,0
42844,27,540,173,84,99,8,29,36,181,5,12,7,13,17,20,54,81,2,221,12,0,2,2,2,0
42845,27,540,3,1,1,3,0,0,6,0,0,0,0,0,0,0,0,0,0,0,0,2,2,2,0
42846,164,5068,1660,832,1314,41,38,274,1701,20,312,209,395,332,604,2671,5058,12,64042,3557,1,2,12,11,0
42847,164,5068,1057,646,719,113,100,145,1170,18,215,134,248,233,382,1740,3004,10,31186,1732,1,2,12,11,0
42848,17,345,95,58,50,9,16,20,104,12,33,24,45,45,69,209,378,8,3100,172,0,2,3,3,0
42849,86,1804,477,336,357,30,23,73,507,16,194,134,250,210,384,1538,2962,10,30538,1696,0,2,4,3,0
42850,132,2644,1513,682,1277,25,13,200,1538,11,199,116,219,210,335,1557,2584,6,15641,868,0,2,4,5,0
42851,132,2644,819,519,539,24,98,155,843,15,96,57,106,111,163,690,1107,8,9171,509,0,2,4,5,0
42852,347,7004,1457,730,1242,11,6,188,1468,10,292,166,329,302,495,2424,4078,5,22973,1276,1,2,5,4,0
42853,347,7004,74,35,59,1,0,14,75,3,14,7,14,17,21,58,85,1,128,7,0,2,5,4,0
42854,347,7004,245,125,200,5,7,34,250,7,30,17,34,37,51,166,265,3,1053,58,0,2,5,4,0
42855,178,4128,77,34,69,0,0,8,77,3,24,16,29,27,45,114,213,1,387,21,0,2,2,1,0
42856,178,4128,712,438,573,51,9,84,763,14,102,71,128,116,199,733,1364,8,11988,666,0,2,2,1,0
42857,46,957,447,308,343,6,5,95,453,7,96,59,111,103,170,651,1136,4,4600,255,0,2,4,5,0
42858,46,957,322,174,179,16,74,51,338,10,41,26,46,51,72,252,408,5,2291,127,0,2,4,5,0
42859,23,382,424,94,331,4,0,89,428,1,5,5,5,6,10,11,25,0,12,0,0,2,1,2,0
42860,23,382,38,23,23,6,0,8,44,3,11,7,11,14,18,42,68,1,102,5,0,2,1,2,0
42861,17,518,184,100,137,2,15,30,186,6,38,20,39,44,59,214,322,3,991,55,0,2,2,2,0
42862,17,518,103,65,74,8,5,16,111,7,17,9,17,24,26,89,119,3,417,23,0,2,2,2,0
42863,211,5043,722,423,573,19,0,135,741,12,172,101,199,184,300,1320,2257,6,15668,870,0,2,6,5,0
42864,211,5043,1508,847,911,44,250,301,1552,14,148,88,169,162,257,1120,1886,7,15077,837,0,2,6,5,0
42865,255,6147,72,33,56,0,4,12,72,1,1,1,1,2,2,0,2,0,1,0,0,2,4,3,0
42866,255,6147,1454,835,1044,76,110,219,1530,17,275,158,296,292,454,2297,3718,9,34017,1889,1,2,4,3,0
42867,112,2466,1043,504,840,53,9,147,1096,9,180,112,198,189,310,1377,2344,4,11604,644,0,2,1,1,0
42868,112,2466,383,288,292,26,6,62,409,11,65,38,67,76,105,429,656,5,3719,206,0,2,1,1,0
42869,102,1928,1178,367,1042,6,15,115,1184,9,94,51,95,103,146,644,976,4,4439,246,0,2,2,2,0
42870,102,1928,177,108,140,8,0,27,185,6,30,16,32,36,48,162,248,3,794,44,0,2,2,2,0
42871,192,3947,1943,715,1694,26,18,214,1969,12,185,120,237,197,357,1436,2721,7,20915,1161,0,2,4,3,0
42872,192,3947,1168,838,957,57,25,144,1225,19,348,224,416,367,640,3018,5452,11,61921,3440,1,2,4,3,0
42873,11,412,42,7,35,4,0,5,46,1,2,1,2,3,3,2,4,0,2,0,0,2,1,1,0
42874,11,412,11,6,10,0,0,1,11,2,4,2,4,6,6,10,15,1,15,0,0,2,1,1,0
42875,193,3988,1943,715,1694,26,18,214,1969,12,185,120,237,197,357,1436,2721,7,20915,1161,0,2,17,6,0
42876,193,3988,1168,838,957,57,25,144,1225,19,348,224,416,367,640,3018,5452,11,61921,3440,1,2,17,6,0
42877,76,3899,1943,715,1694,26,18,214,1969,12,185,120,237,197,357,1436,2721,7,20915,1161,0,2,10,0,0
42878,351,7048,1457,730,1242,11,6,188,1468,10,292,166,329,302,495,2424,4078,5,22973,1276,1,2,15,10,0
42879,351,7048,74,35,59,1,0,14,75,3,14,7,14,17,21,58,85,1,128,7,0,2,15,10,0
42880,351,7048,245,125,200,5,7,34,250,7,30,17,34,37,51,166,265,3,1053,58,0,2,15,10,0
42881,79,4191,1457,730,1242,11,6,188,1468,10,292,166,329,302,495,2424,4078,5,22973,1276,1,2,11,1,0
42886,133,2659,1513,682,1277,25,13,200,1538,11,199,116,219,210,335,1557,2584,6,15641,868,0,2,11,4,0
42887,133,2659,819,519,539,24,98,155,843,15,96,57,106,111,163,690,1107,8,9171,509,0,2,11,4,0
42888,120,4833,1513,682,1277,25,13,200,1538,11,199,116,219,210,335,1557,2584,6,15641,868,0,2,17,0,0
42892,93,1794,1020,354,843,12,15,144,1032,8,134,77,144,142,221,970,1580,4,6792,377,0,2,0,4,1
42893,255,6154,72,33,56,0,4,12,72,1,1,1,1,2,2,0,2,0,1,0,0,2,14,8,1
42894,255,6154,1454,835,1044,76,110,219,1530,17,275,158,296,292,454,2297,3718,9,34017,1889,1,2,14,8,1
42895,132,5724,1782,648,1425,9,47,279,1791,8,171,97,189,179,286,1292,2140,4,9462,525,0,2,1,1,1
42896,229,5176,4293,999,3693,19,54,507,4312,9,155,88,170,164,258,1156,1898,4,9368,520,0,2,2,1,0
42897,229,5176,1482,859,1002,125,135,219,1607,16,219,134,251,235,385,1766,3032,9,27804,1544,1,2,2,1,0
42900,106,1993,1178,367,1042,6,15,115,1184,9,94,51,95,103,146,644,976,4,4439,246,0,2,14,3,0
42901,106,1993,177,108,140,8,0,27,185,6,30,16,32,36,48,162,248,3,794,44,0,2,14,3,0
42902,72,3050,1178,367,1042,6,15,115,1184,9,94,51,95,103,146,644,976,4,4439,246,0,2,22,0,0
42903,93,1794,1020,354,843,12,15,144,1032,8,134,77,144,142,221,970,1580,4,6792,377,0,2,0,4,0
42904,255,6154,72,33,56,0,4,12,72,1,1,1,1,2,2,0,2,0,1,0,0,2,14,8,0
42905,255,6154,1454,835,1044,76,110,219,1530,17,275,158,296,292,454,2297,3718,9,34017,1889,1,2,14,8,0
42906,132,5724,1782,648,1425,9,47,279,1791,8,171,97,189,179,286,1292,2140,4,9462,525,0,2,1,1,0
42910,75,1461,757,253,292,73,244,162,830,13,61,38,67,74,105,409,651,7,4654,258,0,2,12,3,0
42912,58,1227,207,111,150,11,0,50,218,5,26,19,36,31,55,133,272,3,943,52,0,2,4,1,1
42913,58,1227,410,198,237,31,55,97,441,11,63,38,72,74,110,414,683,6,4293,238,0,2,4,1,1
42914,228,5164,4293,999,3693,19,54,507,4312,9,155,88,170,164,258,1156,1898,4,9368,520,0,2,1,5,1
42915,228,5164,1482,859,1002,125,135,219,1607,16,219,134,251,235,385,1766,3032,9,27804,1544,1,2,1,5,1
42916,98,4450,1338,495,1086,10,64,173,1348,11,122,82,157,133,239,883,1686,7,11934,663,0,2,12,2,1
42917,162,7089,139,89,101,2,0,35,141,7,54,34,62,61,96,330,569,4,2287,127,0,2,6,0,1
42918,162,7089,7,5,5,0,0,2,7,1,2,1,2,3,3,2,4,0,2,0,0,2,6,0,1
42919,55,1193,207,111,150,11,0,50,218,5,26,19,36,31,55,133,272,3,943,52,0,2,5,2,1
42920,55,1193,410,198,237,31,55,97,441,11,63,38,72,74,110,414,683,6,4293,238,0,2,5,2,1
42921,14,341,207,111,150,11,0,50,218,5,26,19,36,31,55,133,272,3,943,52,0,2,26,1,1
42945,11,414,42,7,35,4,0,5,46,1,2,1,2,3,3,2,4,0,2,0,0,2,1,1,0
42946,11,414,11,6,10,0,0,1,11,2,4,2,4,6,6,10,15,1,15,0,0,2,1,1,0
42949,347,7004,1457,730,1242,11,6,188,1468,10,292,166,329,302,495,2424,4078,5,22973,1276,1,2,2,2,0
42950,347,7004,74,35,59,1,0,14,75,3,14,7,14,17,21,58,85,1,128,7,0,2,2,2,0
42951,347,7004,245,125,200,5,7,34,250,7,30,17,34,37,51,166,265,3,1053,58,0,2,2,2,0
42952,347,7002,1457,730,1242,11,6,188,1468,10,292,166,329,302,495,2424,4078,5,22973,1276,1,2,3,3,0
42953,347,7002,74,35,59,1,0,14,75,3,14,7,14,17,21,58,85,1,128,7,0,2,3,3,0
42954,347,7002,245,125,200,5,7,34,250,7,30,17,34,37,51,166,265,3,1053,58,0,2,3,3,0
42955,50,584,647,139,84,35,284,233,682,0,0,0,0,0,0,0,0,0,0,0,0,2,1,1,0
42956,255,6150,72,33,56,0,4,12,72,1,1,1,1,2,2,0,2,0,1,0,0,2,1,1,0
42957,255,6150,1454,835,1044,76,110,219,1530,17,275,158,296,292,454,2297,3718,9,34017,1889,1,2,1,1,0
42958,192,3943,1943,715,1694,26,18,214,1969,12,185,120,237,197,357,1436,2721,7,20915,1161,0,2,1,2,0
42959,192,3943,1168,838,957,57,25,144,1225,19,348,224,416,367,640,3018,5452,11,61921,3440,1,2,1,2,0
42960,75,3806,1943,715,1694,26,18,214,1969,12,185,120,237,197,357,1436,2721,7,20915,1161,0,2,1,1,0
42994,11,412,42,7,35,4,0,5,46,1,2,1,2,3,3,2,4,0,2,0,0,2,2,2,0
42995,11,412,11,6,10,0,0,1,11,2,4,2,4,6,6,10,15,1,15,0,0,2,2,2,0
42997,54,1170,207,111,150,11,0,50,218,5,26,19,36,31,55,133,272,3,943,52,0,2,1,8,0
42998,54,1170,410,198,237,31,55,97,441,11,63,38,72,74,110,414,683,6,4293,238,0,2,1,8,0
42999,214,4608,182,127,129,0,0,53,182,5,39,21,42,44,63,217,343,2,926,51,0,2,1,1,1
43000,214,4608,1165,710,800,67,119,181,1232,18,243,153,282,261,435,2000,3492,10,36473,2026,1,2,1,1,1
43001,36,1085,182,127,129,0,0,53,182,5,39,21,42,44,63,217,343,2,926,51,0,2,22,0,1
43002,55,1193,207,111,150,11,0,50,218,5,26,19,36,31,55,133,272,3,943,52,0,2,5,2,0
43003,55,1193,410,198,237,31,55,97,441,11,63,38,72,74,110,414,683,6,4293,238,0,2,5,2,0
43004,14,341,207,111,150,11,0,50,218,5,26,19,36,31,55,133,272,3,943,52,0,2,26,1,0
43005,214,4608,182,127,129,0,0,53,182,5,39,21,42,44,63,217,343,2,926,51,0,2,1,1,0
43006,214,4608,1165,710,800,67,119,181,1232,18,243,153,282,261,435,2000,3492,10,36473,2026,1,2,1,1,0
43007,36,1085,182,127,129,0,0,53,182,5,39,21,42,44,63,217,343,2,926,51,0,2,22,0,0
43008,212,5013,722,423,573,19,0,135,741,12,172,101,199,184,300,1320,2257,6,15668,870,0,2,11,16,1
43009,212,5013,1508,847,911,44,250,301,1552,14,148,88,169,162,257,1120,1886,7,15077,837,0,2,11,16,1
43010,16,677,722,423,573,19,0,135,741,12,172,101,199,184,300,1320,2257,6,15668,870,0,2,11,0,1
43012,7,281,75,38,59,1,3,12,76,2,4,2,4,6,6,10,15,1,15,0,0,2,4,1,0
43015,212,5013,722,423,573,19,0,135,741,12,172,101,199,184,300,1320,2257,6,15668,870,0,2,11,16,0
43016,212,5013,1508,847,911,44,250,301,1552,14,148,88,169,162,257,1120,1886,7,15077,837,0,2,11,16,0
43017,16,677,722,423,573,19,0,135,741,12,172,101,199,184,300,1320,2257,6,15668,870,0,2,11,0,0
43018,12,424,42,7,35,4,0,5,46,1,2,1,2,3,3,2,4,0,2,0,0,2,5,1,0
43019,12,424,11,6,10,0,0,1,11,2,4,2,4,6,6,10,15,1,15,0,0,2,5,1,0
43020,345,6927,1457,730,1242,11,6,188,1468,10,292,166,329,302,495,2424,4078,5,22973,1276,1,2,0,11,1
43021,345,6927,74,35,59,1,0,14,75,3,14,7,14,17,21,58,85,1,128,7,0,2,0,11,1
43022,345,6927,245,125,200,5,7,34,250,7,30,17,34,37,51,166,265,3,1053,58,0,2,0,11,1
43023,98,4449,1338,495,1086,10,64,173,1348,11,122,82,157,133,239,883,1686,7,11934,663,0,2,5,3,1
43024,72,3755,1296,573,1062,40,33,157,1336,8,201,118,231,209,349,1561,2689,4,12365,686,0,2,5,3,1
43025,33,1889,384,251,317,7,8,52,391,11,70,44,84,81,128,467,811,6,5355,297,0,2,0,17,1
43026,75,2972,1043,504,840,53,9,147,1096,9,180,112,198,189,310,1377,2344,4,11604,644,0,2,7,5,1
43027,48,1795,1098,241,925,5,10,155,1103,7,46,25,49,53,74,273,423,3,1580,87,0,2,4,2,1
43028,39,1758,386,256,301,16,9,68,402,4,59,35,69,63,104,355,621,2,1453,80,0,2,22,0,1
43029,57,1218,207,111,150,11,0,50,218,5,26,19,36,31,55,133,272,3,943,52,0,2,15,1,0
43030,57,1218,410,198,237,31,55,97,441,11,63,38,72,74,110,414,683,6,4293,238,0,2,15,1,0
43031,210,4982,722,423,573,19,0,135,741,12,172,101,199,184,300,1320,2257,6,15668,870,0,2,1,9,0
43032,210,4982,1508,847,911,44,250,301,1552,14,148,88,169,162,257,1120,1886,7,15077,837,0,2,1,9,0
43033,72,3743,1296,573,1062,40,33,157,1336,8,201,118,231,209,349,1561,2689,4,12365,686,0,2,0,1,0
43037,72,3755,1296,573,1062,40,33,157,1336,8,201,118,231,209,349,1561,2689,4,12365,686,0,2,1,1,0
43038,58,1228,207,111,150,11,0,50,218,5,26,19,36,31,55,133,272,3,943,52,0,2,5,0,1
43039,58,1228,410,198,237,31,55,97,441,11,63,38,72,74,110,414,683,6,4293,238,0,2,5,0,1
43040,214,4592,182,127,129,0,0,53,182,5,39,21,42,44,63,217,343,2,926,51,0,2,1,1,0
43041,214,4592,1165,710,800,67,119,181,1232,18,243,153,282,261,435,2000,3492,10,36473,2026,1,2,1,1,0
43042,133,2652,1513,682,1277,25,13,200,1538,11,199,116,219,210,335,1557,2584,6,15641,868,0,2,11,4,0
43043,133,2652,819,519,539,24,98,155,843,15,96,57,106,111,163,690,1107,8,9171,509,0,2,11,4,0
43046,349,7008,1457,730,1242,11,6,188,1468,10,292,166,329,302,495,2424,4078,5,22973,1276,1,2,15,10,0
43047,349,7008,74,35,59,1,0,14,75,3,14,7,14,17,21,58,85,1,128,7,0,2,15,10,0
43048,349,7008,245,125,200,5,7,34,250,7,30,17,34,37,51,166,265,3,1053,58,0,2,15,10,0
43052,210,5022,722,423,573,19,0,135,741,12,172,101,199,184,300,1320,2257,6,15668,870,0,2,8,4,0
43053,210,5022,1508,847,911,44,250,301,1552,14,148,88,169,162,257,1120,1886,7,15077,837,0,2,8,4,0
43055,113,2488,1043,504,840,53,9,147,1096,9,180,112,198,189,310,1377,2344,4,11604,644,0,2,6,1,0
43056,113,2488,383,288,292,26,6,62,409,11,65,38,67,76,105,429,656,5,3719,206,0,2,6,1,0
43057,193,3982,1943,715,1694,26,18,214,1969,12,185,120,237,197,357,1436,2721,7,20915,1161,0,2,17,6,0
43058,193,3982,1168,838,957,57,25,144,1225,19,348,224,416,367,640,3018,5452,11,61921,3440,1,2,17,6,0
43065,76,3895,1943,715,1694,26,18,214,1969,12,185,120,237,197,357,1436,2721,7,20915,1161,0,2,10,0,0
43066,57,1224,207,111,150,11,0,50,218,5,26,19,36,31,55,133,272,3,943,52,0,2,15,8,0
43067,57,1224,410,198,237,31,55,97,441,11,63,38,72,74,110,414,683,6,4293,238,0,2,15,8,0
43068,58,1234,207,111,150,11,0,50,218,5,26,19,36,31,55,133,272,3,943,52,0,2,9,1,0
43069,58,1234,410,198,237,31,55,97,441,11,63,38,72,74,110,414,683,6,4293,238,0,2,9,1,0
43070,228,5164,4293,999,3693,19,54,507,4312,9,155,88,170,164,258,1156,1898,4,9368,520,0,2,1,5,0
43071,228,5164,1482,859,1002,125,135,219,1607,16,219,134,251,235,385,1766,3032,9,27804,1544,1,2,1,5,0
43072,98,4450,1338,495,1086,10,64,173,1348,11,122,82,157,133,239,883,1686,7,11934,663,0,2,12,2,0
43073,162,7089,139,89,101,2,0,35,141,7,54,34,62,61,96,330,569,4,2287,127,0,2,6,0,0
43074,162,7089,7,5,5,0,0,2,7,1,2,1,2,3,3,2,4,0,2,0,0,2,6,0,0
43079,57,1224,207,111,150,11,0,50,218,5,26,19,36,31,55,133,272,3,943,52,0,2,20,10,0
43080,57,1224,410,198,237,31,55,97,441,11,63,38,72,74,110,414,683,6,4293,238,0,2,20,10,0
43081,347,6933,1457,730,1242,11,6,188,1468,10,292,166,329,302,495,2424,4078,5,22973,1276,1,2,15,10,0
43082,347,6933,74,35,59,1,0,14,75,3,14,7,14,17,21,58,85,1,128,7,0,2,15,10,0
43083,347,6933,245,125,200,5,7,34,250,7,30,17,34,37,51,166,265,3,1053,58,0,2,15,10,0
43087,210,5022,722,423,573,19,0,135,741,12,172,101,199,184,300,1320,2257,6,15668,870,0,2,9,13,0
43088,210,5022,1508,847,911,44,250,301,1552,14,148,88,169,162,257,1120,1886,7,15077,837,0,2,9,13,0
43102,347,6933,1457,730,1242,11,6,188,1468,10,292,166,329,302,495,2424,4078,5,22973,1276,1,2,0,11,0
43103,347,6933,74,35,59,1,0,14,75,3,14,7,14,17,21,58,85,1,128,7,0,2,0,11,0
43104,347,6933,245,125,200,5,7,34,250,7,30,17,34,37,51,166,265,3,1053,58,0,2,0,11,0
43107,98,4449,1338,495,1086,10,64,173,1348,11,122,82,157,133,239,883,1686,7,11934,663,0,2,5,3,0
43108,72,3743,1296,573,1062,40,33,157,1336,8,201,118,231,209,349,1561,2689,4,12365,686,0,2,5,3,0
43109,33,1889,384,251,317,7,8,52,391,11,70,44,84,81,128,467,811,6,5355,297,0,2,0,17,0
43110,75,2972,1043,504,840,53,9,147,1096,9,180,112,198,189,310,1377,2344,4,11604,644,0,2,7,5,0
43111,48,1795,1098,241,925,5,10,155,1103,7,46,25,49,53,74,273,423,3,1580,87,0,2,4,2,0
43112,46,954,386,256,301,16,9,68,402,4,59,35,69,63,104,355,621,2,1453,80,0,2,22,5,1
43113,46,954,264,131,164,11,41,46,275,6,38,22,40,44,62,214,338,3,1068,59,0,2,22,5,1
43114,39,1774,386,256,301,16,9,68,402,4,59,35,69,63,104,355,621,2,1453,80,0,2,10,8,1
43115,46,954,386,256,301,16,9,68,402,4,59,35,69,63,104,355,621,2,1453,80,0,2,16,0,0
43116,46,954,264,131,164,11,41,46,275,6,38,22,40,44,62,214,338,3,1068,59,0,2,16,0,0
43117,46,954,386,256,301,16,9,68,402,4,59,35,69,63,104,355,621,2,1453,80,0,2,38,5,0
43118,46,954,264,131,164,11,41,46,275,6,38,22,40,44,62,214,338,3,1068,59,0,2,38,5,0
43119,39,1774,386,256,301,16,9,68,402,4,59,35,69,63,104,355,621,2,1453,80,0,2,24,0,0
43120,11,235,19,8,11,5,0,4,24,2,5,3,6,7,9,13,25,1,30,1,0,2,3,2,0
43121,11,235,102,59,69,5,3,24,107,6,22,15,28,28,43,113,206,3,789,43,0,2,3,2,0
43122,11,235,106,40,36,3,49,17,109,8,17,13,23,25,36,93,167,5,904,50,0,2,3,2,0
43123,23,607,102,59,69,5,3,24,107,6,22,15,28,28,43,113,206,3,789,43,0,2,1,1,0
43124,60,1265,207,111,150,11,0,50,218,5,26,19,36,31,55,133,272,3,943,52,0,2,9,1,0
43125,60,1265,410,198,237,31,55,97,441,11,63,38,72,74,110,414,683,6,4293,238,0,2,9,1,0
43131,96,1828,1020,354,843,12,15,144,1032,8,134,77,144,142,221,970,1580,4,6792,377,0,2,1,1,1
43132,73,3219,1020,354,843,12,15,144,1032,8,134,77,144,142,221,970,1580,4,6792,377,0,2,12,0,1
43133,96,1828,1020,354,843,12,15,144,1032,8,134,77,144,142,221,970,1580,4,6792,377,0,2,1,1,0
43134,73,3219,1020,354,843,12,15,144,1032,8,134,77,144,142,221,970,1580,4,6792,377,0,2,12,0,0
43135,87,2923,773,419,590,28,0,166,801,10,204,113,217,214,330,1598,2554,5,13587,754,0,2,0,1,0
43137,189,4316,77,34,69,0,0,8,77,3,24,16,29,27,45,114,213,1,387,21,0,2,10,0,0
43138,189,4316,712,438,573,51,9,84,763,14,102,71,128,116,199,733,1364,8,11988,666,0,2,10,0,0
43139,81,3472,1289,550,1043,56,32,155,1345,10,167,93,185,177,278,1266,2075,5,11498,638,0,2,3,1,0
43147,94,1803,1020,354,843,12,15,144,1032,8,134,77,144,142,221,970,1580,4,6792,377,0,2,1,1,0
43151,98,4450,1338,495,1086,10,64,173,1348,11,122,82,157,133,239,883,1686,7,11934,663,0,2,1,1,1
43152,256,6158,72,33,56,0,4,12,72,1,1,1,1,2,2,0,2,0,1,0,0,2,18,20,0
43153,256,6158,1454,835,1044,76,110,219,1530,17,275,158,296,292,454,2297,3718,9,34017,1889,1,2,18,20,0
43154,6,329,180,34,164,0,0,16,180,1,12,6,12,13,18,43,66,0,33,1,0,2,21,0,0
43155,345,6924,1457,730,1242,11,6,188,1468,10,292,166,329,302,495,2424,4078,5,22973,1276,1,2,6,6,0
43156,345,6924,74,35,59,1,0,14,75,3,14,7,14,17,21,58,85,1,128,7,0,2,6,6,0
43157,345,6924,245,125,200,5,7,34,250,7,30,17,34,37,51,166,265,3,1053,58,0,2,6,6,0
43158,33,1914,384,251,317,7,8,52,391,11,70,44,84,81,128,467,811,6,5355,297,0,2,8,3,1
43167,98,4450,1338,495,1086,10,64,173,1348,11,122,82,157,133,239,883,1686,7,11934,663,0,2,1,1,0
43170,347,6933,1457,730,1242,11,6,188,1468,10,292,166,329,302,495,2424,4078,5,22973,1276,1,2,1,1,1
43171,347,6933,74,35,59,1,0,14,75,3,14,7,14,17,21,58,85,1,128,7,0,2,1,1,1
43172,347,6933,245,125,200,5,7,34,250,7,30,17,34,37,51,166,265,3,1053,58,0,2,1,1,1
43173,67,1798,773,422,505,30,103,129,803,14,77,46,83,91,129,535,839,7,6334,351,0,0,459,0,1
43174,67,1800,773,422,505,30,103,129,803,14,77,46,83,91,129,535,839,7,6334,351,0,2,1,1,0
43175,1,142,127,75,83,2,11,30,129,4,14,7,14,18,21,61,87,2,175,9,0,0,33,0,0
43176,1,142,652,304,544,16,6,88,668,6,89,51,101,95,152,591,998,3,3399,188,0,0,33,0,0
43177,1,142,2,2,2,0,0,0,2,0,0,0,0,0,0,0,0,0,0,0,0,0,33,0,0
43178,1,142,8,5,5,0,0,3,8,0,0,0,0,0,0,0,0,0,0,0,0,0,33,0,0
43181,1,142,14,8,8,0,0,6,14,0,0,0,0,0,0,0,0,0,0,0,0,0,33,0,0
43182,1,142,6,4,4,0,0,2,6,0,0,0,0,0,0,0,0,0,0,0,0,0,33,0,0
43183,1,142,6,4,4,0,0,2,6,1,2,1,2,3,3,2,4,0,2,0,0,0,33,0,0
43185,1,142,7,5,5,0,0,2,7,0,0,0,0,0,0,0,0,0,0,0,0,0,33,0,0
43187,1,142,10,6,6,0,0,4,10,0,0,0,0,0,0,0,0,0,0,0,0,0,33,0,0
43188,1,142,1,1,1,0,0,0,1,0,0,0,0,0,0,0,0,0,0,0,0,0,33,0,0
43190,1,142,14,10,10,0,0,4,14,1,1,1,1,2,2,0,2,0,1,0,0,0,33,0,0
43191,1,142,46,26,30,3,0,12,49,3,6,3,6,9,9,20,28,1,42,2,0,0,33,0,0
43192,3,143,207,111,150,11,0,50,218,5,26,19,36,31,55,133,272,3,943,52,0,0,80,0,0
43193,9,464,139,89,101,2,0,35,141,7,54,34,62,61,96,330,569,4,2287,127,0,0,99,0,0
43194,21,1023,1157,318,931,29,22,177,1186,6,104,63,125,110,188,712,1274,3,4596,255,0,0,398,0,0
43214,120,4833,1513,682,1277,25,13,200,1538,11,199,116,219,210,335,1557,2584,6,15641,868,0,2,0,2,0
43215,67,1769,773,422,505,30,103,129,803,14,77,46,83,91,129,535,839,7,6334,351,0,2,21,40,0
43216,67,1769,773,422,505,30,103,129,803,14,77,46,83,91,129,535,839,7,6334,351,0,2,2,2,0
43217,120,4833,1513,682,1277,25,13,200,1538,11,199,116,219,210,335,1557,2584,6,15641,868,0,2,0,1,0
43218,64,1733,773,422,505,30,103,129,803,14,77,46,83,91,129,535,839,7,6334,351,0,2,4,9,0
43219,63,1708,773,422,505,30,103,129,803,14,77,46,83,91,129,535,839,7,6334,351,0,2,16,23,0
43220,63,1707,773,422,505,30,103,129,803,14,77,46,83,91,129,535,839,7,6334,351,0,2,0,3,0
43221,62,1696,773,422,505,30,103,129,803,14,77,46,83,91,129,535,839,7,6334,351,0,2,20,18,1
43222,62,1696,773,422,505,30,103,129,803,14,77,46,83,91,129,535,839,7,6334,351,0,2,4,4,0
43223,62,1692,773,422,505,30,103,129,803,14,77,46,83,91,129,535,839,7,6334,351,0,2,4,4,0
43224,62,1704,773,422,505,30,103,129,803,14,77,46,83,91,129,535,839,7,6334,351,0,2,4,4,0
43225,62,1710,773,422,505,30,103,129,803,14,77,46,83,91,129,535,839,7,6334,351,0,2,7,4,0
43226,62,1694,773,422,505,30,103,129,803,14,77,46,83,91,129,535,839,7,6334,351,0,2,1,3,0
43227,62,1696,773,422,505,30,103,129,803,14,77,46,83,91,129,535,839,7,6334,351,0,2,7,8,1
43228,60,1687,773,422,505,30,103,129,803,14,77,46,83,91,129,535,839,7,6334,351,0,2,16,16,0
43229,60,1685,773,422,505,30,103,129,803,14,77,46,83,91,129,535,839,7,6334,351,0,2,1,1,0
43230,48,1364,773,422,505,30,103,129,803,14,77,46,83,91,129,535,839,7,6334,351,0,2,6,75,0
43231,7,392,139,89,101,2,0,35,141,7,54,34,62,61,96,330,569,4,2287,127,0,2,0,26,0
43232,135,2719,1513,682,1277,25,13,200,1538,11,199,116,219,210,335,1557,2584,6,15641,868,0,2,60,19,1
43233,135,2719,819,519,539,24,98,155,843,15,96,57,106,111,163,690,1107,8,9171,509,0,2,60,19,1
43234,121,4909,1513,682,1277,25,13,200,1538,11,199,116,219,210,335,1557,2584,6,15641,868,0,2,34,0,1
43235,135,2721,1513,682,1277,25,13,200,1538,11,199,116,219,210,335,1557,2584,6,15641,868,0,2,31,30,1
43236,135,2721,819,519,539,24,98,155,843,15,96,57,106,111,163,690,1107,8,9171,509,0,2,31,30,1
43237,21,662,339,213,244,17,9,65,356,10,42,26,48,52,74,259,421,5,2410,133,0,2,2,2,1
43238,20,408,294,64,250,0,0,43,294,1,20,10,20,21,30,86,131,0,65,3,0,2,2,2,1
43239,20,408,78,46,62,3,0,14,81,3,8,4,8,11,12,28,41,1,62,3,0,2,2,2,1
43240,121,4909,1513,682,1277,25,13,200,1538,11,199,116,219,210,335,1557,2584,6,15641,868,0,2,10,10,1
43241,347,6933,1457,730,1242,11,6,188,1468,10,292,166,329,302,495,2424,4078,5,22973,1276,1,2,1,1,0
43242,347,6933,74,35,59,1,0,14,75,3,14,7,14,17,21,58,85,1,128,7,0,2,1,1,0
43243,347,6933,245,125,200,5,7,34,250,7,30,17,34,37,51,166,265,3,1053,58,0,2,1,1,0
43247,17,518,184,100,137,2,15,30,186,6,38,20,39,44,59,214,322,3,991,55,0,2,3,3,0
43248,17,518,103,65,74,8,5,16,111,7,17,9,17,24,26,89,119,3,417,23,0,2,3,3,0
43249,106,1993,1178,367,1042,6,15,115,1184,9,94,51,95,103,146,644,976,4,4439,246,0,2,2,2,0
43250,106,1993,177,108,140,8,0,27,185,6,30,16,32,36,48,162,248,3,794,44,0,2,2,2,0
43251,195,4023,1943,715,1694,26,18,214,1969,12,185,120,237,197,357,1436,2721,7,20915,1161,0,2,62,48,0
43252,195,4023,1168,838,957,57,25,144,1225,19,348,224,416,367,640,3018,5452,11,61921,3440,1,2,62,48,0
43265,188,4296,77,34,69,0,0,8,77,3,24,16,29,27,45,114,213,1,387,21,0,2,2,5,0
43266,188,4296,712,438,573,51,9,84,763,14,102,71,128,116,199,733,1364,8,11988,666,0,2,2,5,0
43267,135,2731,1513,682,1277,25,13,200,1538,11,199,116,219,210,335,1557,2584,6,15641,868,0,2,3,1,1
43268,135,2731,819,519,539,24,98,155,843,15,96,57,106,111,163,690,1107,8,9171,509,0,2,3,1,1
43269,123,4965,1513,682,1277,25,13,200,1538,11,199,116,219,210,335,1557,2584,6,15641,868,0,2,12,2,1
43270,96,1829,1020,354,843,12,15,144,1032,8,134,77,144,142,221,970,1580,4,6792,377,0,2,2,1,0
43272,20,509,205,80,86,16,53,53,221,7,18,10,19,25,29,94,134,3,497,27,0,2,9,2,0
43273,74,3107,1178,367,1042,6,15,115,1184,9,94,51,95,103,146,644,976,4,4439,246,0,2,34,0,0
43274,20,509,205,80,86,16,53,53,221,7,18,10,19,25,29,94,134,3,497,27,0,2,2,2,0
43275,21,438,601,196,481,2,23,85,603,8,63,36,72,71,108,400,664,4,3036,168,0,2,2,2,0
43276,21,438,156,79,106,5,16,28,161,5,14,8,15,19,23,64,97,2,261,14,0,2,2,2,0
43277,16,610,601,196,481,2,23,85,603,8,63,36,72,71,108,400,664,4,3036,168,0,2,21,1,0
43278,60,1265,207,111,150,11,0,50,218,5,26,19,36,31,55,133,272,3,943,52,0,2,2,2,1
43279,60,1265,410,198,237,31,55,97,441,11,63,38,72,74,110,414,683,6,4293,238,0,2,2,2,1
43280,255,6150,72,33,56,0,4,12,72,1,1,1,1,2,2,0,2,0,1,0,0,2,5,5,1
43281,255,6150,1454,835,1044,76,110,219,1530,17,275,158,296,292,454,2297,3718,9,34017,1889,1,2,5,5,1
43282,21,436,601,196,481,2,23,85,603,8,63,36,72,71,108,400,664,4,3036,168,0,2,1,1,1
43283,21,436,156,79,106,5,16,28,161,5,14,8,15,19,23,64,97,2,261,14,0,2,1,1,1
43284,16,610,601,196,481,2,23,85,603,8,63,36,72,71,108,400,664,4,3036,168,0,2,1,1,1
43285,60,1265,207,111,150,11,0,50,218,5,26,19,36,31,55,133,272,3,943,52,0,2,2,2,0
43286,60,1265,410,198,237,31,55,97,441,11,63,38,72,74,110,414,683,6,4293,238,0,2,2,2,0
43287,255,6150,72,33,56,0,4,12,72,1,1,1,1,2,2,0,2,0,1,0,0,2,5,5,0
43288,255,6150,1454,835,1044,76,110,219,1530,17,275,158,296,292,454,2297,3718,9,34017,1889,1,2,5,5,0
43289,21,436,601,196,481,2,23,85,603,8,63,36,72,71,108,400,664,4,3036,168,0,2,2,2,0
43290,21,436,156,79,106,5,16,28,161,5,14,8,15,19,23,64,97,2,261,14,0,2,2,2,0
43292,94,1804,1020,354,843,12,15,144,1032,8,134,77,144,142,221,970,1580,4,6792,377,0,2,2,1,0
43293,256,6155,72,33,56,0,4,12,72,1,1,1,1,2,2,0,2,0,1,0,0,2,18,20,0
43294,256,6155,1454,835,1044,76,110,219,1530,17,275,158,296,292,454,2297,3718,9,34017,1889,1,2,18,20,0
43296,106,2001,1178,367,1042,6,15,115,1184,9,94,51,95,103,146,644,976,4,4439,246,0,2,2,1,0
43297,106,2001,177,108,140,8,0,27,185,6,30,16,32,36,48,162,248,3,794,44,0,2,2,1,0
43298,74,3124,1178,367,1042,6,15,115,1184,9,94,51,95,103,146,644,976,4,4439,246,0,2,8,3,0
43299,62,1228,1098,241,925,5,10,155,1103,7,46,25,49,53,74,273,423,3,1580,87,0,2,1,2,0
43300,62,1228,282,202,222,14,2,44,296,8,42,24,43,50,67,250,378,4,1548,86,0,2,1,2,0
43301,62,1222,1098,241,925,5,10,155,1103,7,46,25,49,53,74,273,423,3,1580,87,0,2,0,1,0
43302,62,1222,282,202,222,14,2,44,296,8,42,24,43,50,67,250,378,4,1548,86,0,2,0,1,0
43303,106,1987,1178,367,1042,6,15,115,1184,9,94,51,95,103,146,644,976,4,4439,246,0,2,4,5,1
43304,106,1987,177,108,140,8,0,27,185,6,30,16,32,36,48,162,248,3,794,44,0,2,4,5,1
43305,62,1222,1098,241,925,5,10,155,1103,7,46,25,49,53,74,273,423,3,1580,87,0,2,1,1,1
43306,62,1222,282,202,222,14,2,44,296,8,42,24,43,50,67,250,378,4,1548,86,0,2,1,1,1
43307,110,2074,1178,367,1042,6,15,115,1184,9,94,51,95,103,146,644,976,4,4439,246,0,2,59,39,1
43308,110,2074,177,108,140,8,0,27,185,6,30,16,32,36,48,162,248,3,794,44,0,2,59,39,1
43309,110,2074,1178,367,1042,6,15,115,1184,9,94,51,95,103,146,644,976,4,4439,246,0,2,1,1,0
43310,110,2074,177,108,140,8,0,27,185,6,30,16,32,36,48,162,248,3,794,44,0,2,1,1,0
43311,108,2058,1178,367,1042,6,15,115,1184,9,94,51,95,103,146,644,976,4,4439,246,0,2,3,9,0
43312,108,2058,177,108,140,8,0,27,185,6,30,16,32,36,48,162,248,3,794,44,0,2,3,9,0
43313,229,5184,4293,999,3693,19,54,507,4312,9,155,88,170,164,258,1156,1898,4,9368,520,0,2,6,2,0
43314,229,5184,1482,859,1002,125,135,219,1607,16,219,134,251,235,385,1766,3032,9,27804,1544,1,2,6,2,0
43315,229,5193,4293,999,3693,19,54,507,4312,9,155,88,170,164,258,1156,1898,4,9368,520,0,2,2,1,0
43316,229,5193,1482,859,1002,125,135,219,1607,16,219,134,251,235,385,1766,3032,9,27804,1544,1,2,2,1,0
43317,74,3250,1020,354,843,12,15,144,1032,8,134,77,144,142,221,970,1580,4,6792,377,0,2,18,0,0
43318,229,5193,4293,999,3693,19,54,507,4312,9,155,88,170,164,258,1156,1898,4,9368,520,0,2,7,2,0
43319,229,5193,1482,859,1002,125,135,219,1607,16,219,134,251,235,385,1766,3032,9,27804,1544,1,2,7,2,0
43321,135,2731,1513,682,1277,25,13,200,1538,11,199,116,219,210,335,1557,2584,6,15641,868,0,2,91,47,0
43322,135,2731,819,519,539,24,98,155,843,15,96,57,106,111,163,690,1107,8,9171,509,0,2,91,47,0
43323,21,662,339,213,244,17,9,65,356,10,42,26,48,52,74,259,421,5,2410,133,0,2,2,2,0
43324,20,408,294,64,250,0,0,43,294,1,20,10,20,21,30,86,131,0,65,3,0,2,2,2,0
43325,20,408,78,46,62,3,0,14,81,3,8,4,8,11,12,28,41,1,62,3,0,2,2,2,0
43326,123,4965,1513,682,1277,25,13,200,1538,11,199,116,219,210,335,1557,2584,6,15641,868,0,2,56,12,0
43327,11,394,42,7,35,4,0,5,46,1,2,1,2,3,3,2,4,0,2,0,0,2,9,8,1
43328,11,394,11,6,10,0,0,1,11,2,4,2,4,6,6,10,15,1,15,0,0,2,9,8,1
43329,108,2058,1178,367,1042,6,15,115,1184,9,94,51,95,103,146,644,976,4,4439,246,0,2,57,44,0
43330,108,2058,177,108,140,8,0,27,185,6,30,16,32,36,48,162,248,3,794,44,0,2,57,44,0
43331,62,1222,1098,241,925,5,10,155,1103,7,46,25,49,53,74,273,423,3,1580,87,0,2,1,3,0
43332,62,1222,282,202,222,14,2,44,296,8,42,24,43,50,67,250,378,4,1548,86,0,2,1,3,0
43333,58,1219,207,111,150,11,0,50,218,5,26,19,36,31,55,133,272,3,943,52,0,2,1,15,0
43334,58,1219,410,198,237,31,55,97,441,11,63,38,72,74,110,414,683,6,4293,238,0,2,1,15,0
43337,11,394,42,7,35,4,0,5,46,1,2,1,2,3,3,2,4,0,2,0,0,2,9,8,0
43338,11,394,11,6,10,0,0,1,11,2,4,2,4,6,6,10,15,1,15,0,0,2,9,8,0
43339,11,235,19,8,11,5,0,4,24,2,5,3,6,7,9,13,25,1,30,1,0,2,0,3,1
43340,11,235,102,59,69,5,3,24,107,6,22,15,28,28,43,113,206,3,789,43,0,2,0,3,1
43341,11,235,106,40,36,3,49,17,109,8,17,13,23,25,36,93,167,5,904,50,0,2,0,3,1
43342,101,2069,773,419,590,28,0,166,801,10,204,113,217,214,330,1598,2554,5,13587,754,0,2,0,2,1
43343,101,2069,421,273,302,44,34,57,465,17,81,59,107,98,166,583,1098,11,12329,684,0,2,0,2,1
43346,26,524,2,2,2,0,0,0,2,0,0,0,0,0,0,0,0,0,0,0,0,2,2,4,1
43360,26,524,99,48,90,1,3,5,100,0,0,0,0,0,0,0,0,0,0,0,0,2,2,4,1
43361,26,524,8,5,5,2,0,1,10,0,0,0,0,0,0,0,0,0,0,0,0,2,2,4,1
43362,26,524,1217,716,841,84,126,174,1301,14,185,118,215,199,333,1446,2542,8,20687,1149,0,2,2,4,1
43363,26,524,160,89,115,0,13,31,160,7,15,11,17,22,28,78,124,3,495,27,0,2,2,4,1
43364,26,524,10,10,9,9,0,0,19,0,0,0,0,0,0,0,0,0,0,0,0,2,2,4,1
43365,26,524,173,84,99,8,29,36,181,5,12,7,13,17,20,54,81,2,221,12,0,2,2,4,1
43366,26,524,3,1,1,3,0,0,6,0,0,0,0,0,0,0,0,0,0,0,0,2,2,4,1
43367,163,5028,1660,832,1314,41,38,274,1701,20,312,209,395,332,604,2671,5058,12,64042,3557,1,2,0,5,1
43368,163,5028,1057,646,719,113,100,145,1170,18,215,134,248,233,382,1740,3004,10,31186,1732,1,2,0,5,1
43369,228,5143,4293,999,3693,19,54,507,4312,9,155,88,170,164,258,1156,1898,4,9368,520,0,2,1,4,1
43370,228,5143,1482,859,1002,125,135,219,1607,16,219,134,251,235,385,1766,3032,9,27804,1544,1,2,1,4,1
43371,210,5003,722,423,573,19,0,135,741,12,172,101,199,184,300,1320,2257,6,15668,870,0,2,2,6,1
43372,210,5003,1508,847,911,44,250,301,1552,14,148,88,169,162,257,1120,1886,7,15077,837,0,2,2,6,1
43373,73,1421,757,253,292,73,244,162,830,13,61,38,67,74,105,409,651,7,4654,258,0,2,1,9,1
43374,7,299,72,33,56,0,4,12,72,1,1,1,1,2,2,0,2,0,1,0,0,2,1,1,1
43375,11,394,42,7,35,4,0,5,46,1,2,1,2,3,3,2,4,0,2,0,0,2,1,1,1
43376,11,394,11,6,10,0,0,1,11,2,4,2,4,6,6,10,15,1,15,0,0,2,1,1,1
43377,81,3461,1289,550,1043,56,32,155,1345,10,167,93,185,177,278,1266,2075,5,11498,638,0,2,1,1,1
43378,147,6935,1392,870,1177,35,17,170,1427,14,494,280,531,508,811,4473,7289,7,54850,3047,2,2,2,8,1
43379,87,2905,773,419,590,28,0,166,801,10,204,113,217,214,330,1598,2554,5,13587,754,0,2,0,2,1
43380,52,3380,520,294,400,33,13,81,553,10,261,204,367,271,571,2128,4614,7,32445,1802,1,2,0,6,1
43381,97,4424,1338,495,1086,10,64,173,1348,11,122,82,157,133,239,883,1686,7,11934,663,0,2,4,11,1
43383,79,4191,1457,730,1242,11,6,188,1468,10,292,166,329,302,495,2424,4078,5,22973,1276,1,2,1,1,1
43384,38,2303,334,251,279,10,4,40,344,5,127,74,143,132,217,899,1528,2,4303,239,0,2,1,7,1
43385,48,1750,1098,241,925,5,10,155,1103,7,46,25,49,53,74,273,423,3,1580,87,0,2,0,5,1
43386,147,6933,1392,870,1177,35,17,170,1427,14,494,280,531,508,811,4473,7289,7,54850,3047,2,2,0,1,0
43387,11,235,19,8,11,5,0,4,24,2,5,3,6,7,9,13,25,1,30,1,0,2,0,3,0
43388,11,235,102,59,69,5,3,24,107,6,22,15,28,28,43,113,206,3,789,43,0,2,0,3,0
43389,11,235,106,40,36,3,49,17,109,8,17,13,23,25,36,93,167,5,904,50,0,2,0,3,0
43390,101,2069,773,419,590,28,0,166,801,10,204,113,217,214,330,1598,2554,5,13587,754,0,2,0,2,0
43391,101,2069,421,273,302,44,34,57,465,17,81,59,107,98,166,583,1098,11,12329,684,0,2,0,2,0
43394,26,524,2,2,2,0,0,0,2,0,0,0,0,0,0,0,0,0,0,0,0,2,2,4,0
43408,26,524,99,48,90,1,3,5,100,0,0,0,0,0,0,0,0,0,0,0,0,2,2,4,0
43409,26,524,8,5,5,2,0,1,10,0,0,0,0,0,0,0,0,0,0,0,0,2,2,4,0
43410,26,524,1217,716,841,84,126,174,1301,14,185,118,215,199,333,1446,2542,8,20687,1149,0,2,2,4,0
43411,26,524,160,89,115,0,13,31,160,7,15,11,17,22,28,78,124,3,495,27,0,2,2,4,0
43412,26,524,10,10,9,9,0,0,19,0,0,0,0,0,0,0,0,0,0,0,0,2,2,4,0
43413,26,524,173,84,99,8,29,36,181,5,12,7,13,17,20,54,81,2,221,12,0,2,2,4,0
43414,26,524,3,1,1,3,0,0,6,0,0,0,0,0,0,0,0,0,0,0,0,2,2,4,0
43415,163,5028,1660,832,1314,41,38,274,1701,20,312,209,395,332,604,2671,5058,12,64042,3557,1,2,0,5,0
43416,163,5028,1057,646,719,113,100,145,1170,18,215,134,248,233,382,1740,3004,10,31186,1732,1,2,0,5,0
43417,228,5143,4293,999,3693,19,54,507,4312,9,155,88,170,164,258,1156,1898,4,9368,520,0,2,1,4,0
43418,228,5143,1482,859,1002,125,135,219,1607,16,219,134,251,235,385,1766,3032,9,27804,1544,1,2,1,4,0
43419,210,5003,722,423,573,19,0,135,741,12,172,101,199,184,300,1320,2257,6,15668,870,0,2,2,6,0
43420,210,5003,1508,847,911,44,250,301,1552,14,148,88,169,162,257,1120,1886,7,15077,837,0,2,2,6,0
43421,73,1421,757,253,292,73,244,162,830,13,61,38,67,74,105,409,651,7,4654,258,0,2,1,9,0
43422,7,299,72,33,56,0,4,12,72,1,1,1,1,2,2,0,2,0,1,0,0,2,1,1,0
43423,11,394,42,7,35,4,0,5,46,1,2,1,2,3,3,2,4,0,2,0,0,2,1,1,0
43424,11,394,11,6,10,0,0,1,11,2,4,2,4,6,6,10,15,1,15,0,0,2,1,1,0
43425,81,3461,1289,550,1043,56,32,155,1345,10,167,93,185,177,278,1266,2075,5,11498,638,0,2,1,1,0
43426,147,6933,1392,870,1177,35,17,170,1427,14,494,280,531,508,811,4473,7289,7,54850,3047,2,2,2,9,0
43427,87,2905,773,419,590,28,0,166,801,10,204,113,217,214,330,1598,2554,5,13587,754,0,2,0,2,0
43428,52,3380,520,294,400,33,13,81,553,10,261,204,367,271,571,2128,4614,7,32445,1802,1,2,0,6,0
43429,97,4424,1338,495,1086,10,64,173,1348,11,122,82,157,133,239,883,1686,7,11934,663,0,2,4,11,0
43431,79,4191,1457,730,1242,11,6,188,1468,10,292,166,329,302,495,2424,4078,5,22973,1276,1,2,1,1,0
43432,38,2303,334,251,279,10,4,40,344,5,127,74,143,132,217,899,1528,2,4303,239,0,2,1,7,0
43433,48,1750,1098,241,925,5,10,155,1103,7,46,25,49,53,74,273,423,3,1580,87,0,2,0,5,0
43434,348,6936,1457,730,1242,11,6,188,1468,10,292,166,329,302,495,2424,4078,5,22973,1276,1,2,2,1,0
43435,348,6936,74,35,59,1,0,14,75,3,14,7,14,17,21,58,85,1,128,7,0,2,2,1,0
43436,348,6936,245,125,200,5,7,34,250,7,30,17,34,37,51,166,265,3,1053,58,0,2,2,1,0
43437,80,4257,1457,730,1242,11,6,188,1468,10,292,166,329,302,495,2424,4078,5,22973,1276,1,2,8,0,0
43438,80,4250,1457,730,1242,11,6,188,1468,10,292,166,329,302,495,2424,4078,5,22973,1276,1,2,1,1,0
43439,47,1325,773,422,505,30,103,129,803,14,77,46,83,91,129,535,839,7,6334,351,0,2,32,41,0
43440,45,1298,773,422,505,30,103,129,803,14,77,46,83,91,129,535,839,7,6334,351,0,2,2,12,0
43441,7,353,139,89,101,2,0,35,141,7,54,34,62,61,96,330,569,4,2287,127,0,2,4,7,0
43442,45,1298,773,422,505,30,103,129,803,14,77,46,83,91,129,535,839,7,6334,351,0,2,2,1,0
43443,21,1023,1157,318,931,29,22,177,1186,6,104,63,125,110,188,712,1274,3,4596,255,0,2,7,7,0
43444,45,1298,773,422,505,30,103,129,803,14,77,46,83,91,129,535,839,7,6334,351,0,2,1,0,0
43445,119,4767,1513,682,1277,25,13,200,1538,11,199,116,219,210,335,1557,2584,6,15641,868,0,2,0,17,0
43446,45,1297,773,422,505,30,103,129,803,14,77,46,83,91,129,535,839,7,6334,351,0,2,7,11,0
43448,108,2066,1178,367,1042,6,15,115,1184,9,94,51,95,103,146,644,976,4,4439,246,0,2,2,1,0
43449,108,2066,177,108,140,8,0,27,185,6,30,16,32,36,48,162,248,3,794,44,0,2,2,1,0
43450,74,3124,1178,367,1042,6,15,115,1184,9,94,51,95,103,146,644,976,4,4439,246,0,2,42,3,0
43454,45,1297,773,422,505,30,103,129,803,14,77,46,83,91,129,535,839,7,6334,351,0,0,337,0,0
43457,7,353,139,89,101,2,0,35,141,7,54,34,62,61,96,330,569,4,2287,127,0,0,70,0,0
43459,122,4899,1513,682,1277,25,13,200,1538,11,199,116,219,210,335,1557,2584,6,15641,868,0,2,0,20,0
43460,64,1733,1455,414,1257,16,76,112,1471,5,41,23,46,46,69,231,381,2,1069,59,0,2,9,1,0
43461,64,1733,669,365,481,22,61,110,691,15,103,63,122,118,185,747,1273,8,11311,628,0,2,9,1,0
43462,64,1721,1455,414,1257,16,76,112,1471,5,41,23,46,46,69,231,381,2,1069,59,0,2,1,2,0
43463,64,1721,669,365,481,22,61,110,691,15,103,63,122,118,185,747,1273,8,11311,628,0,2,1,2,0
43464,67,3083,1455,414,1257,16,76,112,1471,5,41,23,46,46,69,231,381,2,1069,59,0,2,28,0,0
43465,64,1721,1455,414,1257,16,76,112,1471,5,41,23,46,46,69,231,381,2,1069,59,0,2,8,1,0
43466,64,1721,669,365,481,22,61,110,691,15,103,63,122,118,185,747,1273,8,11311,628,0,2,8,1,0
43468,181,4179,77,34,69,0,0,8,77,3,24,16,29,27,45,114,213,1,387,21,0,2,13,1,0
43469,181,4179,712,438,573,51,9,84,763,14,102,71,128,116,199,733,1364,8,11988,666,0,2,13,1,0
43470,72,3739,1296,573,1062,40,33,157,1336,8,201,118,231,209,349,1561,2689,4,12365,686,0,2,2,4,0
43471,76,3893,1943,715,1694,26,18,214,1969,12,185,120,237,197,357,1436,2721,7,20915,1161,0,2,0,1,0
43472,96,1829,1020,354,843,12,15,144,1032,8,134,77,144,142,221,970,1580,4,6792,377,0,2,1,1,0
43474,228,5144,4293,999,3693,19,54,507,4312,9,155,88,170,164,258,1156,1898,4,9368,520,0,2,4,0,0
43475,228,5144,1482,859,1002,125,135,219,1607,16,219,134,251,235,385,1766,3032,9,27804,1544,1,2,4,0,0
43479,80,4250,1457,730,1242,11,6,188,1468,10,292,166,329,302,495,2424,4078,5,22973,1276,1,2,8,0,0
43484,52,1094,207,111,150,11,0,50,218,5,26,19,36,31,55,133,272,3,943,52,0,2,52,43,1
43485,52,1094,410,198,237,31,55,97,441,11,63,38,72,74,110,414,683,6,4293,238,0,2,52,43,1
43486,228,5136,4293,999,3693,19,54,507,4312,9,155,88,170,164,258,1156,1898,4,9368,520,0,2,1,2,1
43487,228,5136,1482,859,1002,125,135,219,1607,16,219,134,251,235,385,1766,3032,9,27804,1544,1,2,1,2,1
43488,12,419,42,7,35,4,0,5,46,1,2,1,2,3,3,2,4,0,2,0,0,2,4,1,1
43489,12,419,11,6,10,0,0,1,11,2,4,2,4,6,6,10,15,1,15,0,0,2,4,1,1
43490,161,7064,139,89,101,2,0,35,141,7,54,34,62,61,96,330,569,4,2287,127,0,2,1,4,1
43491,161,7064,7,5,5,0,0,2,7,1,2,1,2,3,3,2,4,0,2,0,0,2,1,4,1
43492,161,7062,139,89,101,2,0,35,141,7,54,34,62,61,96,330,569,4,2287,127,0,2,0,1,0
43493,161,7062,7,5,5,0,0,2,7,1,2,1,2,3,3,2,4,0,2,0,0,2,0,1,0
43494,52,1094,207,111,150,11,0,50,218,5,26,19,36,31,55,133,272,3,943,52,0,2,52,43,0
43495,52,1094,410,198,237,31,55,97,441,11,63,38,72,74,110,414,683,6,4293,238,0,2,52,43,0
43496,228,5136,4293,999,3693,19,54,507,4312,9,155,88,170,164,258,1156,1898,4,9368,520,0,2,1,2,0
43497,228,5136,1482,859,1002,125,135,219,1607,16,219,134,251,235,385,1766,3032,9,27804,1544,1,2,1,2,0
43498,12,419,42,7,35,4,0,5,46,1,2,1,2,3,3,2,4,0,2,0,0,2,4,1,0
43499,12,419,11,6,10,0,0,1,11,2,4,2,4,6,6,10,15,1,15,0,0,2,4,1,0
43500,161,7062,139,89,101,2,0,35,141,7,54,34,62,61,96,330,569,4,2287,127,0,2,1,5,0
43501,161,7062,7,5,5,0,0,2,7,1,2,1,2,3,3,2,4,0,2,0,0,2,1,5,0
43502,73,3848,1296,573,1062,40,33,157,1336,8,201,118,231,209,349,1561,2689,4,12365,686,0,2,26,0,1
43503,73,3850,1296,573,1062,40,33,157,1336,8,201,118,231,209,349,1561,2689,4,12365,686,0,2,2,2,0
43504,235,5317,4293,999,3693,19,54,507,4312,9,155,88,170,164,258,1156,1898,4,9368,520,0,2,35,1,1
43505,235,5317,1482,859,1002,125,135,219,1607,16,219,134,251,235,385,1766,3032,9,27804,1544,1,2,35,1,1
43506,234,5311,4293,999,3693,19,54,507,4312,9,155,88,170,164,258,1156,1898,4,9368,520,0,2,4,5,0
43507,234,5311,1482,859,1002,125,135,219,1607,16,219,134,251,235,385,1766,3032,9,27804,1544,1,2,4,5,0
43508,232,5292,4293,999,3693,19,54,507,4312,9,155,88,170,164,258,1156,1898,4,9368,520,0,2,10,10,1
43509,232,5292,1482,859,1002,125,135,219,1607,16,219,134,251,235,385,1766,3032,9,27804,1544,1,2,10,10,1
43510,232,5292,4293,999,3693,19,54,507,4312,9,155,88,170,164,258,1156,1898,4,9368,520,0,2,1,1,1
43511,232,5292,1482,859,1002,125,135,219,1607,16,219,134,251,235,385,1766,3032,9,27804,1544,1,2,1,1,1
43512,229,5195,4293,999,3693,19,54,507,4312,9,155,88,170,164,258,1156,1898,4,9368,520,0,2,8,39,1
43513,229,5195,1482,859,1002,125,135,219,1607,16,219,134,251,235,385,1766,3032,9,27804,1544,1,2,8,39,1
43514,4,95,53,23,39,0,0,13,53,2,8,4,8,10,12,26,39,1,39,2,0,0,37,0,1
43515,4,95,515,298,307,33,80,99,548,12,63,44,77,75,121,419,753,7,5527,307,0,0,37,0,1
43516,1,106,53,23,39,0,0,13,53,2,8,4,8,10,12,26,39,1,39,2,0,3,3,3,1
43517,75,1461,757,253,292,73,244,162,830,13,61,38,67,74,105,409,651,7,4654,258,0,2,2,1,1
43518,229,5199,4293,999,3693,19,54,507,4312,9,155,88,170,164,258,1156,1898,4,9368,520,0,2,4,4,0
43519,229,5199,1482,859,1002,125,135,219,1607,16,219,134,251,235,385,1766,3032,9,27804,1544,1,2,4,4,0
43520,83,2365,1523,757,1297,19,12,193,1542,12,193,117,230,205,347,1508,2664,7,19053,1058,0,2,2,1,0
43521,83,2365,701,378,504,33,58,109,734,13,110,68,126,123,194,794,1346,7,10027,557,0,2,2,1,0
43522,184,4257,77,34,69,0,0,8,77,3,24,16,29,27,45,114,213,1,387,21,0,2,5,4,0
43523,184,4257,712,438,573,51,9,84,763,14,102,71,128,116,199,733,1364,8,11988,666,0,2,5,4,0
43524,4,92,53,23,39,0,0,13,53,2,8,4,8,10,12,26,39,1,39,2,0,2,4,1,0
43525,4,92,515,298,307,33,80,99,548,12,63,44,77,75,121,419,753,7,5527,307,0,2,4,1,0
43526,193,3994,1943,715,1694,26,18,214,1969,12,185,120,237,197,357,1436,2721,7,20915,1161,0,2,2,1,0
43527,193,3994,1168,838,957,57,25,144,1225,19,348,224,416,367,640,3018,5452,11,61921,3440,1,2,2,1,0
43528,75,1461,757,253,292,73,244,162,830,13,61,38,67,74,105,409,651,7,4654,258,0,2,2,1,0
43529,4,90,53,23,39,0,0,13,53,2,8,4,8,10,12,26,39,1,39,2,0,2,0,3,0
43530,4,90,515,298,307,33,80,99,548,12,63,44,77,75,121,419,753,7,5527,307,0,2,0,3,0
43531,96,1835,1020,354,843,12,15,144,1032,8,134,77,144,142,221,970,1580,4,6792,377,0,2,3,2,1
43532,75,3288,1020,354,843,12,15,144,1032,8,134,77,144,142,221,970,1580,4,6792,377,0,2,17,0,1
43533,229,5199,4293,999,3693,19,54,507,4312,9,155,88,170,164,258,1156,1898,4,9368,520,0,2,10,8,0
43534,229,5199,1482,859,1002,125,135,219,1607,16,219,134,251,235,385,1766,3032,9,27804,1544,1,2,10,8,0
43539,4,90,53,23,39,0,0,13,53,2,8,4,8,10,12,26,39,1,39,2,0,0,37,0,0
43540,4,90,515,298,307,33,80,99,548,12,63,44,77,75,121,419,753,7,5527,307,0,0,37,0,0
43544,73,3850,1296,573,1062,40,33,157,1336,8,201,118,231,209,349,1561,2689,4,12365,686,0,2,26,0,0
43545,1,106,53,23,39,0,0,13,53,2,8,4,8,10,12,26,39,1,39,2,0,0,18,0,0
43546,229,5171,4293,999,3693,19,54,507,4312,9,155,88,170,164,258,1156,1898,4,9368,520,0,2,17,10,0
43547,229,5171,1482,859,1002,125,135,219,1607,16,219,134,251,235,385,1766,3032,9,27804,1544,1,2,17,10,0
43550,181,4189,77,34,69,0,0,8,77,3,24,16,29,27,45,114,213,1,387,21,0,2,5,4,0
43551,181,4189,712,438,573,51,9,84,763,14,102,71,128,116,199,733,1364,8,11988,666,0,2,5,4,0
43552,94,1804,1020,354,843,12,15,144,1032,8,134,77,144,142,221,970,1580,4,6792,377,0,2,1,1,0
43555,73,1421,757,253,292,73,244,162,830,13,61,38,67,74,105,409,651,7,4654,258,0,2,2,1,0
43556,195,4029,1943,715,1694,26,18,214,1969,12,185,120,237,197,357,1436,2721,7,20915,1161,0,2,3,2,0
43557,195,4029,1168,838,957,57,25,144,1225,19,348,224,416,367,640,3018,5452,11,61921,3440,1,2,3,2,0
43558,73,3834,1296,573,1062,40,33,157,1336,8,201,118,231,209,349,1561,2689,4,12365,686,0,2,26,0,0
43561,96,1835,1020,354,843,12,15,144,1032,8,134,77,144,142,221,970,1580,4,6792,377,0,2,3,2,0
43562,75,3288,1020,354,843,12,15,144,1032,8,134,77,144,142,221,970,1580,4,6792,377,0,2,17,0,0
43563,52,1088,207,111,150,11,0,50,218,5,26,19,36,31,55,133,272,3,943,52,0,2,4,8,0
43564,52,1088,410,198,237,31,55,97,441,11,63,38,72,74,110,414,683,6,4293,238,0,2,4,8,0
43565,210,5003,722,423,573,19,0,135,741,12,172,101,199,184,300,1320,2257,6,15668,870,0,2,1,3,0
43566,210,5003,1508,847,911,44,250,301,1552,14,148,88,169,162,257,1120,1886,7,15077,837,0,2,1,3,0
43567,46,954,386,256,301,16,9,68,402,4,59,35,69,63,104,355,621,2,1453,80,0,2,2,4,0
43568,46,954,264,131,164,11,41,46,275,6,38,22,40,44,62,214,338,3,1068,59,0,2,2,4,0
43569,7,353,139,89,101,2,0,35,141,7,54,34,62,61,96,330,569,4,2287,127,0,2,1,1,0
43570,52,1082,207,111,150,11,0,50,218,5,26,19,36,31,55,133,272,3,943,52,0,2,0,2,0
43571,52,1082,410,198,237,31,55,97,441,11,63,38,72,74,110,414,683,6,4293,238,0,2,0,2,0
43572,94,1805,1020,354,843,12,15,144,1032,8,134,77,144,142,221,970,1580,4,6792,377,0,2,2,2,0
43573,73,1425,757,253,292,73,244,162,830,13,61,38,67,74,105,409,651,7,4654,258,0,2,3,2,0
43574,346,6927,1457,730,1242,11,6,188,1468,10,292,166,329,302,495,2424,4078,5,22973,1276,1,2,6,6,0
43575,346,6927,74,35,59,1,0,14,75,3,14,7,14,17,21,58,85,1,128,7,0,2,6,6,0
43576,346,6927,245,125,200,5,7,34,250,7,30,17,34,37,51,166,265,3,1053,58,0,2,6,6,0
43577,33,1914,384,251,317,7,8,52,391,11,70,44,84,81,128,467,811,6,5355,297,0,2,8,3,0
43578,52,1082,207,111,150,11,0,50,218,5,26,19,36,31,55,133,272,3,943,52,0,2,4,10,0
43579,52,1082,410,198,237,31,55,97,441,11,63,38,72,74,110,414,683,6,4293,238,0,2,4,10,0
43586,94,1805,1020,354,843,12,15,144,1032,8,134,77,144,142,221,970,1580,4,6792,377,0,2,3,3,0
43591,73,1425,757,253,292,73,244,162,830,13,61,38,67,74,105,409,651,7,4654,258,0,2,5,3,0
43600,167,5123,1660,832,1314,41,38,274,1701,20,312,209,395,332,604,2671,5058,12,64042,3557,1,2,8,3,0
43601,167,5123,1057,646,719,113,100,145,1170,18,215,134,248,233,382,1740,3004,10,31186,1732,1,2,8,3,0
43602,153,4268,1660,832,1314,41,38,274,1701,20,312,209,395,332,604,2671,5058,12,64042,3557,1,2,21,13,0
43603,167,5122,1660,832,1314,41,38,274,1701,20,312,209,395,332,604,2671,5058,12,64042,3557,1,2,3,2,0
43604,167,5122,1057,646,719,113,100,145,1170,18,215,134,248,233,382,1740,3004,10,31186,1732,1,2,3,2,0
43605,155,4372,1660,832,1314,41,38,274,1701,20,312,209,395,332,604,2671,5058,12,64042,3557,1,2,11,0,0
43606,155,4372,1660,832,1314,41,38,274,1701,20,312,209,395,332,604,2671,5058,12,64042,3557,1,2,3,0,0
43607,167,5122,1660,832,1314,41,38,274,1701,20,312,209,395,332,604,2671,5058,12,64042,3557,1,2,11,5,0
43608,167,5122,1057,646,719,113,100,145,1170,18,215,134,248,233,382,1740,3004,10,31186,1732,1,2,11,5,0
43609,155,4372,1660,832,1314,41,38,274,1701,20,312,209,395,332,604,2671,5058,12,64042,3557,1,2,35,13,0
43610,155,4372,1660,832,1314,41,38,274,1701,20,312,209,395,332,604,2671,5058,12,64042,3557,1,2,1,1,0
43611,100,1967,1020,354,843,12,15,144,1032,8,134,77,144,142,221,970,1580,4,6792,377,0,2,25,0,1
43612,256,6030,72,33,56,0,4,12,72,1,1,1,1,2,2,0,2,0,1,0,0,2,3,21,1
43613,256,6030,1454,835,1044,76,110,219,1530,17,275,158,296,292,454,2297,3718,9,34017,1889,1,2,3,21,1
43614,135,2748,1513,682,1277,25,13,200,1538,11,199,116,219,210,335,1557,2584,6,15641,868,0,2,6,2,0
43615,135,2748,819,519,539,24,98,155,843,15,96,57,106,111,163,690,1107,8,9171,509,0,2,6,2,0
43616,124,4990,1513,682,1277,25,13,200,1538,11,199,116,219,210,335,1557,2584,6,15641,868,0,2,16,0,0
43617,60,1682,1455,414,1257,16,76,112,1471,5,41,23,46,46,69,231,381,2,1069,59,0,2,1,1,0
43618,60,1682,669,365,481,22,61,110,691,15,103,63,122,118,185,747,1273,8,11311,628,0,2,1,1,0
43619,66,3053,1455,414,1257,16,76,112,1471,5,41,23,46,46,69,231,381,2,1069,59,0,2,28,2,0
43627,257,6191,72,33,56,0,4,12,72,1,1,1,1,2,2,0,2,0,1,0,0,2,8,1,0
43628,257,6191,1454,835,1044,76,110,219,1530,17,275,158,296,292,454,2297,3718,9,34017,1889,1,2,8,1,0
43630,231,5221,4293,999,3693,19,54,507,4312,9,155,88,170,164,258,1156,1898,4,9368,520,0,2,16,7,1
43631,231,5221,1482,859,1002,125,135,219,1607,16,219,134,251,235,385,1766,3032,9,27804,1544,1,2,16,7,1
43632,93,1852,1020,354,843,12,15,144,1032,8,134,77,144,142,221,970,1580,4,6792,377,0,2,29,21,1
43633,12,422,42,7,35,4,0,5,46,1,2,1,2,3,3,2,4,0,2,0,0,2,6,1,1
43634,12,422,11,6,10,0,0,1,11,2,4,2,4,6,6,10,15,1,15,0,0,2,6,1,1
43636,166,5068,1660,832,1314,41,38,274,1701,20,312,209,395,332,604,2671,5058,12,64042,3557,1,2,11,5,1
43637,166,5068,1057,646,719,113,100,145,1170,18,215,134,248,233,382,1740,3004,10,31186,1732,1,2,11,5,1
43638,64,1726,1455,414,1257,16,76,112,1471,5,41,23,46,46,69,231,381,2,1069,59,0,2,1,1,1
43639,64,1726,669,365,481,22,61,110,691,15,103,63,122,118,185,747,1273,8,11311,628,0,2,1,1,1
43640,94,1811,1020,354,843,12,15,144,1032,8,134,77,144,142,221,970,1580,4,6792,377,0,2,3,2,1
43641,155,4372,1660,832,1314,41,38,274,1701,20,312,209,395,332,604,2671,5058,12,64042,3557,1,2,35,13,1
43642,68,3131,1455,414,1257,16,76,112,1471,5,41,23,46,46,69,231,381,2,1069,59,0,2,28,2,1
43644,100,1967,1020,354,843,12,15,144,1032,8,134,77,144,142,221,970,1580,4,6792,377,0,2,25,0,0
43645,256,6030,72,33,56,0,4,12,72,1,1,1,1,2,2,0,2,0,1,0,0,2,3,21,0
43646,256,6030,1454,835,1044,76,110,219,1530,17,275,158,296,292,454,2297,3718,9,34017,1889,1,2,3,21,0
43648,257,6066,72,33,56,0,4,12,72,1,1,1,1,2,2,0,2,0,1,0,0,2,8,1,0
43649,257,6066,1454,835,1044,76,110,219,1530,17,275,158,296,292,454,2297,3718,9,34017,1889,1,2,8,1,0
43650,166,5068,1660,832,1314,41,38,274,1701,20,312,209,395,332,604,2671,5058,12,64042,3557,1,2,11,5,0
43651,166,5068,1057,646,719,113,100,145,1170,18,215,134,248,233,382,1740,3004,10,31186,1732,1,2,11,5,0
43652,64,1726,1455,414,1257,16,76,112,1471,5,41,23,46,46,69,231,381,2,1069,59,0,2,1,1,0
43653,64,1726,669,365,481,22,61,110,691,15,103,63,122,118,185,747,1273,8,11311,628,0,2,1,1,0
43654,100,1973,1020,354,843,12,15,144,1032,8,134,77,144,142,221,970,1580,4,6792,377,0,2,3,2,0
43656,68,3131,1455,414,1257,16,76,112,1471,5,41,23,46,46,69,231,381,2,1069,59,0,2,28,2,0
43663,99,2020,1020,354,843,12,15,144,1032,8,134,77,144,142,221,970,1580,4,6792,377,0,2,28,2,0
43664,257,6066,72,33,56,0,4,12,72,1,1,1,1,2,2,0,2,0,1,0,0,2,11,22,0
43665,257,6066,1454,835,1044,76,110,219,1530,17,275,158,296,292,454,2297,3718,9,34017,1889,1,2,11,22,0
43669,214,4608,182,127,129,0,0,53,182,5,39,21,42,44,63,217,343,2,926,51,0,2,4,4,1
43670,214,4608,1165,710,800,67,119,181,1232,18,243,153,282,261,435,2000,3492,10,36473,2026,1,2,4,4,1
43671,102,2083,773,419,590,28,0,166,801,10,204,113,217,214,330,1598,2554,5,13587,754,0,2,8,8,1
43672,102,2083,421,273,302,44,34,57,465,17,81,59,107,98,166,583,1098,11,12329,684,0,2,8,8,1
43673,86,1808,477,336,357,30,23,73,507,16,194,134,250,210,384,1538,2962,10,30538,1696,0,2,4,4,1
43674,351,7048,1457,730,1242,11,6,188,1468,10,292,166,329,302,495,2424,4078,5,22973,1276,1,2,6,6,1
43675,351,7048,74,35,59,1,0,14,75,3,14,7,14,17,21,58,85,1,128,7,0,2,6,6,1
43676,351,7048,245,125,200,5,7,34,250,7,30,17,34,37,51,166,265,3,1053,58,0,2,6,6,1
43677,229,5199,4293,999,3693,19,54,507,4312,9,155,88,170,164,258,1156,1898,4,9368,520,0,2,4,4,1
43678,229,5199,1482,859,1002,125,135,219,1607,16,219,134,251,235,385,1766,3032,9,27804,1544,1,2,4,4,1
43679,96,1835,1020,354,843,12,15,144,1032,8,134,77,144,142,221,970,1580,4,6792,377,0,2,2,2,1
43680,212,5103,722,423,573,19,0,135,741,12,172,101,199,184,300,1320,2257,6,15668,870,0,2,14,14,1
43681,212,5103,1508,847,911,44,250,301,1552,14,148,88,169,162,257,1120,1886,7,15077,837,0,2,14,14,1
43682,256,6158,72,33,56,0,4,12,72,1,1,1,1,2,2,0,2,0,1,0,0,2,7,7,1
43683,256,6158,1454,835,1044,76,110,219,1530,17,275,158,296,292,454,2297,3718,9,34017,1889,1,2,7,7,1
43684,102,1930,1178,367,1042,6,15,115,1184,9,94,51,95,103,146,644,976,4,4439,246,0,2,3,3,1
43685,102,1930,177,108,140,8,0,27,185,6,30,16,32,36,48,162,248,3,794,44,0,2,3,3,1
43686,193,3994,1943,715,1694,26,18,214,1969,12,185,120,237,197,357,1436,2721,7,20915,1161,0,2,12,12,1
43687,193,3994,1168,838,957,57,25,144,1225,19,348,224,416,367,640,3018,5452,11,61921,3440,1,2,12,12,1
43688,62,1240,1098,241,925,5,10,155,1103,7,46,25,49,53,74,273,423,3,1580,87,0,2,4,4,1
43689,62,1240,282,202,222,14,2,44,296,8,42,24,43,50,67,250,378,4,1548,86,0,2,4,4,1
43690,149,6984,1392,870,1177,35,17,170,1427,14,494,280,531,508,811,4473,7289,7,54850,3047,2,2,2,2,1
43691,87,2923,773,419,590,28,0,166,801,10,204,113,217,214,330,1598,2554,5,13587,754,0,2,4,4,1
43692,98,4450,1338,495,1086,10,64,173,1348,11,122,82,157,133,239,883,1686,7,11934,663,0,2,4,4,1
43693,162,7089,139,89,101,2,0,35,141,7,54,34,62,61,96,330,569,4,2287,127,0,2,201,201,1
43694,162,7089,7,5,5,0,0,2,7,1,2,1,2,3,3,2,4,0,2,0,0,2,201,201,1
43695,32,948,465,148,393,5,8,60,470,4,31,20,31,35,51,161,261,2,523,29,0,2,4,4,1
43696,32,948,16,12,9,0,0,6,16,1,2,1,2,3,3,2,4,0,2,0,0,2,4,4,1
43697,132,5719,1782,648,1425,9,47,279,1791,8,171,97,189,179,286,1292,2140,4,9462,525,0,2,3,3,1
43698,109,4106,1450,624,1228,12,26,181,1462,14,306,186,354,320,540,2580,4493,8,36391,2021,1,2,6,6,1
43699,155,4372,1660,832,1314,41,38,274,1701,20,312,209,395,332,604,2671,5058,12,64042,3557,1,2,2,2,1
43700,73,3850,1296,573,1062,40,33,157,1336,8,201,118,231,209,349,1561,2689,4,12365,686,0,2,3,3,1
43701,79,4191,1457,730,1242,11,6,188,1468,10,292,166,329,302,495,2424,4078,5,22973,1276,1,2,35,35,1
43702,39,2355,652,304,544,16,6,88,668,6,89,51,101,95,152,591,998,3,3399,188,0,2,14,14,1
43703,75,3288,1020,354,843,12,15,144,1032,8,134,77,144,142,221,970,1580,4,6792,377,0,2,14,14,1
43704,21,661,424,94,331,4,0,89,428,1,5,5,5,6,10,11,25,0,12,0,0,2,35,35,1
43705,36,1978,384,251,317,7,8,52,391,11,70,44,84,81,128,467,811,6,5355,297,0,2,18,18,1
43706,36,1591,386,256,301,16,9,68,402,4,59,35,69,63,104,355,621,2,1453,80,0,2,2,2,1
43707,75,2972,1043,504,840,53,9,147,1096,9,180,112,198,189,310,1377,2344,4,11604,644,0,2,4,4,1
43708,14,529,295,56,236,0,4,54,295,2,9,5,10,11,15,30,51,1,57,3,0,2,4,4,1
43709,26,1029,373,158,315,8,0,51,381,5,76,44,79,81,123,486,779,2,2026,112,0,2,14,14,1
43710,71,3006,1178,367,1042,6,15,115,1184,9,94,51,95,103,146,644,976,4,4439,246,0,2,3,3,1
43711,76,3899,1943,715,1694,26,18,214,1969,12,185,120,237,197,357,1436,2721,7,20915,1161,0,2,4,4,1
43712,48,1795,1098,241,925,5,10,155,1103,7,46,25,49,53,74,273,423,3,1580,87,0,2,11,11,1
43713,214,4608,182,127,129,0,0,53,182,5,39,21,42,44,63,217,343,2,926,51,0,2,3,3,1
43714,214,4608,1165,710,800,67,119,181,1232,18,243,153,282,261,435,2000,3492,10,36473,2026,1,2,3,3,1
43715,102,2083,773,419,590,28,0,166,801,10,204,113,217,214,330,1598,2554,5,13587,754,0,2,1,1,1
43716,102,2083,421,273,302,44,34,57,465,17,81,59,107,98,166,583,1098,11,12329,684,0,2,1,1,1
43717,167,5122,1660,832,1314,41,38,274,1701,20,312,209,395,332,604,2671,5058,12,64042,3557,1,2,1,1,1
43718,167,5122,1057,646,719,113,100,145,1170,18,215,134,248,233,382,1740,3004,10,31186,1732,1,2,1,1,1
43719,229,5199,4293,999,3693,19,54,507,4312,9,155,88,170,164,258,1156,1898,4,9368,520,0,2,1,1,1
43720,229,5199,1482,859,1002,125,135,219,1607,16,219,134,251,235,385,1766,3032,9,27804,1544,1,2,1,1,1
43721,184,4257,77,34,69,0,0,8,77,3,24,16,29,27,45,114,213,1,387,21,0,2,2,2,1
43722,184,4257,712,438,573,51,9,84,763,14,102,71,128,116,199,733,1364,8,11988,666,0,2,2,2,1
43723,75,1461,757,253,292,73,244,162,830,13,61,38,67,74,105,409,651,7,4654,258,0,2,1,1,1
43724,113,2492,1043,504,840,53,9,147,1096,9,180,112,198,189,310,1377,2344,4,11604,644,0,2,1,1,1
43725,113,2492,383,288,292,26,6,62,409,11,65,38,67,76,105,429,656,5,3719,206,0,2,1,1,1
43728,149,6984,1392,870,1177,35,17,170,1427,14,494,280,531,508,811,4473,7289,7,54850,3047,2,2,4,4,1
43729,231,5221,4293,999,3693,19,54,507,4312,9,155,88,170,164,258,1156,1898,4,9368,520,0,2,16,7,0
43730,231,5221,1482,859,1002,125,135,219,1607,16,219,134,251,235,385,1766,3032,9,27804,1544,1,2,16,7,0
43731,99,2020,1020,354,843,12,15,144,1032,8,134,77,144,142,221,970,1580,4,6792,377,0,2,29,21,0
43732,12,422,42,7,35,4,0,5,46,1,2,1,2,3,3,2,4,0,2,0,0,2,6,1,0
43733,12,422,11,6,10,0,0,1,11,2,4,2,4,6,6,10,15,1,15,0,0,2,6,1,0
43734,17,604,601,196,481,2,23,85,603,8,63,36,72,71,108,400,664,4,3036,168,0,2,2,0,0
43735,230,5220,4293,999,3693,19,54,507,4312,9,155,88,170,164,258,1156,1898,4,9368,520,0,2,2,2,0
43736,230,5220,1482,859,1002,125,135,219,1607,16,219,134,251,235,385,1766,3032,9,27804,1544,1,2,2,2,0
43737,112,2476,1043,504,840,53,9,147,1096,9,180,112,198,189,310,1377,2344,4,11604,644,0,2,0,5,0
43738,112,2476,383,288,292,26,6,62,409,11,65,38,67,76,105,429,656,5,3719,206,0,2,0,5,0
43739,214,4608,182,127,129,0,0,53,182,5,39,21,42,44,63,217,343,2,926,51,0,2,7,7,0
43740,214,4608,1165,710,800,67,119,181,1232,18,243,153,282,261,435,2000,3492,10,36473,2026,1,2,7,7,0
43741,102,2083,773,419,590,28,0,166,801,10,204,113,217,214,330,1598,2554,5,13587,754,0,2,9,9,0
43742,102,2083,421,273,302,44,34,57,465,17,81,59,107,98,166,583,1098,11,12329,684,0,2,9,9,0
43743,167,5122,1660,832,1314,41,38,274,1701,20,312,209,395,332,604,2671,5058,12,64042,3557,1,2,1,1,0
43744,167,5122,1057,646,719,113,100,145,1170,18,215,134,248,233,382,1740,3004,10,31186,1732,1,2,1,1,0
43745,86,1808,477,336,357,30,23,73,507,16,194,134,250,210,384,1538,2962,10,30538,1696,0,2,4,4,0
43746,351,7048,1457,730,1242,11,6,188,1468,10,292,166,329,302,495,2424,4078,5,22973,1276,1,2,6,6,0
43747,351,7048,74,35,59,1,0,14,75,3,14,7,14,17,21,58,85,1,128,7,0,2,6,6,0
43748,351,7048,245,125,200,5,7,34,250,7,30,17,34,37,51,166,265,3,1053,58,0,2,6,6,0
43749,229,5199,4293,999,3693,19,54,507,4312,9,155,88,170,164,258,1156,1898,4,9368,520,0,2,5,5,0
43750,229,5199,1482,859,1002,125,135,219,1607,16,219,134,251,235,385,1766,3032,9,27804,1544,1,2,5,5,0
43751,184,4257,77,34,69,0,0,8,77,3,24,16,29,27,45,114,213,1,387,21,0,2,2,2,0
43752,184,4257,712,438,573,51,9,84,763,14,102,71,128,116,199,733,1364,8,11988,666,0,2,2,2,0
43753,96,1835,1020,354,843,12,15,144,1032,8,134,77,144,142,221,970,1580,4,6792,377,0,2,2,2,0
43754,212,5103,722,423,573,19,0,135,741,12,172,101,199,184,300,1320,2257,6,15668,870,0,2,14,14,0
43755,212,5103,1508,847,911,44,250,301,1552,14,148,88,169,162,257,1120,1886,7,15077,837,0,2,14,14,0
43756,256,6158,72,33,56,0,4,12,72,1,1,1,1,2,2,0,2,0,1,0,0,2,7,7,0
43757,256,6158,1454,835,1044,76,110,219,1530,17,275,158,296,292,454,2297,3718,9,34017,1889,1,2,7,7,0
43758,75,1461,757,253,292,73,244,162,830,13,61,38,67,74,105,409,651,7,4654,258,0,2,1,1,0
43759,113,2492,1043,504,840,53,9,147,1096,9,180,112,198,189,310,1377,2344,4,11604,644,0,2,1,1,0
43760,113,2492,383,288,292,26,6,62,409,11,65,38,67,76,105,429,656,5,3719,206,0,2,1,1,0
43761,102,1930,1178,367,1042,6,15,115,1184,9,94,51,95,103,146,644,976,4,4439,246,0,2,3,3,0
43762,102,1930,177,108,140,8,0,27,185,6,30,16,32,36,48,162,248,3,794,44,0,2,3,3,0
43763,193,3994,1943,715,1694,26,18,214,1969,12,185,120,237,197,357,1436,2721,7,20915,1161,0,2,12,12,0
43764,193,3994,1168,838,957,57,25,144,1225,19,348,224,416,367,640,3018,5452,11,61921,3440,1,2,12,12,0
43765,62,1240,1098,241,925,5,10,155,1103,7,46,25,49,53,74,273,423,3,1580,87,0,2,5,5,0
43766,62,1240,282,202,222,14,2,44,296,8,42,24,43,50,67,250,378,4,1548,86,0,2,5,5,0
43767,149,6984,1392,870,1177,35,17,170,1427,14,494,280,531,508,811,4473,7289,7,54850,3047,2,2,6,6,0
43768,87,2923,773,419,590,28,0,166,801,10,204,113,217,214,330,1598,2554,5,13587,754,0,2,4,4,0
43769,98,4450,1338,495,1086,10,64,173,1348,11,122,82,157,133,239,883,1686,7,11934,663,0,2,4,4,0
43770,162,7089,139,89,101,2,0,35,141,7,54,34,62,61,96,330,569,4,2287,127,0,2,201,201,0
43771,162,7089,7,5,5,0,0,2,7,1,2,1,2,3,3,2,4,0,2,0,0,2,201,201,0
43772,32,948,465,148,393,5,8,60,470,4,31,20,31,35,51,161,261,2,523,29,0,2,4,4,0
43773,32,948,16,12,9,0,0,6,16,1,2,1,2,3,3,2,4,0,2,0,0,2,4,4,0
43774,132,5719,1782,648,1425,9,47,279,1791,8,171,97,189,179,286,1292,2140,4,9462,525,0,2,3,3,0
43775,109,4106,1450,624,1228,12,26,181,1462,14,306,186,354,320,540,2580,4493,8,36391,2021,1,2,6,6,0
43776,155,4372,1660,832,1314,41,38,274,1701,20,312,209,395,332,604,2671,5058,12,64042,3557,1,2,2,2,0
43777,73,3850,1296,573,1062,40,33,157,1336,8,201,118,231,209,349,1561,2689,4,12365,686,0,2,3,3,0
43778,79,4191,1457,730,1242,11,6,188,1468,10,292,166,329,302,495,2424,4078,5,22973,1276,1,2,35,35,0
43779,39,2355,652,304,544,16,6,88,668,6,89,51,101,95,152,591,998,3,3399,188,0,2,14,14,0
43780,75,3288,1020,354,843,12,15,144,1032,8,134,77,144,142,221,970,1580,4,6792,377,0,2,14,14,0
43781,21,661,424,94,331,4,0,89,428,1,5,5,5,6,10,11,25,0,12,0,0,2,35,35,0
43782,36,1978,384,251,317,7,8,52,391,11,70,44,84,81,128,467,811,6,5355,297,0,2,18,18,0
43783,36,1591,386,256,301,16,9,68,402,4,59,35,69,63,104,355,621,2,1453,80,0,2,2,2,0
43784,75,2972,1043,504,840,53,9,147,1096,9,180,112,198,189,310,1377,2344,4,11604,644,0,2,4,4,0
43785,14,529,295,56,236,0,4,54,295,2,9,5,10,11,15,30,51,1,57,3,0,2,4,4,0
43786,26,1029,373,158,315,8,0,51,381,5,76,44,79,81,123,486,779,2,2026,112,0,2,14,14,0
43788,76,3899,1943,715,1694,26,18,214,1969,12,185,120,237,197,357,1436,2721,7,20915,1161,0,2,4,4,0
43789,48,1795,1098,241,925,5,10,155,1103,7,46,25,49,53,74,273,423,3,1580,87,0,2,11,11,0
43791,214,4592,182,127,129,0,0,53,182,5,39,21,42,44,63,217,343,2,926,51,0,2,7,7,0
43792,214,4592,1165,710,800,67,119,181,1232,18,243,153,282,261,435,2000,3492,10,36473,2026,1,2,7,7,0
43793,101,2069,773,419,590,28,0,166,801,10,204,113,217,214,330,1598,2554,5,13587,754,0,2,9,9,0
43794,101,2069,421,273,302,44,34,57,465,17,81,59,107,98,166,583,1098,11,12329,684,0,2,9,9,0
43795,166,5068,1660,832,1314,41,38,274,1701,20,312,209,395,332,604,2671,5058,12,64042,3557,1,2,1,1,0
43796,166,5068,1057,646,719,113,100,145,1170,18,215,134,248,233,382,1740,3004,10,31186,1732,1,2,1,1,0
43797,86,1804,477,336,357,30,23,73,507,16,194,134,250,210,384,1538,2962,10,30538,1696,0,2,4,4,0
43801,231,5221,4293,999,3693,19,54,507,4312,9,155,88,170,164,258,1156,1898,4,9368,520,0,2,5,5,0
43802,231,5221,1482,859,1002,125,135,219,1607,16,219,134,251,235,385,1766,3032,9,27804,1544,1,2,5,5,0
43803,181,4189,77,34,69,0,0,8,77,3,24,16,29,27,45,114,213,1,387,21,0,2,1,1,0
43804,181,4189,712,438,573,51,9,84,763,14,102,71,128,116,199,733,1364,8,11988,666,0,2,1,1,0
43805,99,2020,1020,354,843,12,15,144,1032,8,134,77,144,142,221,970,1580,4,6792,377,0,2,2,2,0
43806,210,5003,722,423,573,19,0,135,741,12,172,101,199,184,300,1320,2257,6,15668,870,0,2,14,14,0
43807,210,5003,1508,847,911,44,250,301,1552,14,148,88,169,162,257,1120,1886,7,15077,837,0,2,14,14,0
43808,257,6066,72,33,56,0,4,12,72,1,1,1,1,2,2,0,2,0,1,0,0,2,7,7,0
43809,257,6066,1454,835,1044,76,110,219,1530,17,275,158,296,292,454,2297,3718,9,34017,1889,1,2,7,7,0
43810,73,1425,757,253,292,73,244,162,830,13,61,38,67,74,105,409,651,7,4654,258,0,2,1,1,0
43811,113,2488,1043,504,840,53,9,147,1096,9,180,112,198,189,310,1377,2344,4,11604,644,0,2,1,1,0
43812,113,2488,383,288,292,26,6,62,409,11,65,38,67,76,105,429,656,5,3719,206,0,2,1,1,0
43813,108,2066,1178,367,1042,6,15,115,1184,9,94,51,95,103,146,644,976,4,4439,246,0,2,3,3,0
43814,108,2066,177,108,140,8,0,27,185,6,30,16,32,36,48,162,248,3,794,44,0,2,3,3,0
43815,195,4029,1943,715,1694,26,18,214,1969,12,185,120,237,197,357,1436,2721,7,20915,1161,0,2,12,12,0
43816,195,4029,1168,838,957,57,25,144,1225,19,348,224,416,367,640,3018,5452,11,61921,3440,1,2,12,12,0
43817,62,1222,1098,241,925,5,10,155,1103,7,46,25,49,53,74,273,423,3,1580,87,0,2,5,5,0
43818,62,1222,282,202,222,14,2,44,296,8,42,24,43,50,67,250,378,4,1548,86,0,2,5,5,0
43819,147,6933,1392,870,1177,35,17,170,1427,14,494,280,531,508,811,4473,7289,7,54850,3047,2,2,6,6,0
43820,87,2905,773,419,590,28,0,166,801,10,204,113,217,214,330,1598,2554,5,13587,754,0,2,4,4,0
43821,97,4424,1338,495,1086,10,64,173,1348,11,122,82,157,133,239,883,1686,7,11934,663,0,2,4,4,0
43822,161,7062,139,89,101,2,0,35,141,7,54,34,62,61,96,330,569,4,2287,127,0,2,201,201,0
43823,161,7062,7,5,5,0,0,2,7,1,2,1,2,3,3,2,4,0,2,0,0,2,201,201,0
43826,132,5724,1782,648,1425,9,47,279,1791,8,171,97,189,179,286,1292,2140,4,9462,525,0,2,3,3,0
43829,73,3834,1296,573,1062,40,33,157,1336,8,201,118,231,209,349,1561,2689,4,12365,686,0,2,3,3,0
43830,80,4250,1457,730,1242,11,6,188,1468,10,292,166,329,302,495,2424,4078,5,22973,1276,1,2,35,35,0
43834,33,1914,384,251,317,7,8,52,391,11,70,44,84,81,128,467,811,6,5355,297,0,2,18,18,0
43835,39,1774,386,256,301,16,9,68,402,4,59,35,69,63,104,355,621,2,1453,80,0,2,2,2,0
43839,74,3124,1178,367,1042,6,15,115,1184,9,94,51,95,103,146,644,976,4,4439,246,0,2,3,3,0
43840,76,3893,1943,715,1694,26,18,214,1969,12,185,120,237,197,357,1436,2721,7,20915,1161,0,2,4,4,0
43841,48,1750,1098,241,925,5,10,155,1103,7,46,25,49,53,74,273,423,3,1580,87,0,2,11,11,0
43842,18,646,601,196,481,2,23,85,603,8,63,36,72,71,108,400,664,4,3036,168,0,2,2,0,0
43847,230,5208,4293,999,3693,19,54,507,4312,9,155,88,170,164,258,1156,1898,4,9368,520,0,2,3,1,0
43848,230,5208,1482,859,1002,125,135,219,1607,16,219,134,251,235,385,1766,3032,9,27804,1544,1,2,3,1,0
43861,230,5220,4293,999,3693,19,54,507,4312,9,155,88,170,164,258,1156,1898,4,9368,520,0,2,5,5,0
43862,230,5220,1482,859,1002,125,135,219,1607,16,219,134,251,235,385,1766,3032,9,27804,1544,1,2,5,5,0
43910,167,5122,1660,832,1314,41,38,274,1701,20,312,209,395,332,604,2671,5058,12,64042,3557,1,2,12,6,0
43911,167,5122,1057,646,719,113,100,145,1170,18,215,134,248,233,382,1740,3004,10,31186,1732,1,2,12,6,0
43918,230,5208,4293,999,3693,19,54,507,4312,9,155,88,170,164,258,1156,1898,4,9368,520,0,2,25,16,0
43919,230,5208,1482,859,1002,125,135,219,1607,16,219,134,251,235,385,1766,3032,9,27804,1544,1,2,25,16,0
43922,188,4306,77,34,69,0,0,8,77,3,24,16,29,27,45,114,213,1,387,21,0,2,8,6,0
43923,188,4306,712,438,573,51,9,84,763,14,102,71,128,116,199,733,1364,8,11988,666,0,2,8,6,0
43924,96,1835,1020,354,843,12,15,144,1032,8,134,77,144,142,221,970,1580,4,6792,377,0,2,8,6,0
43929,256,6158,72,33,56,0,4,12,72,1,1,1,1,2,2,0,2,0,1,0,0,2,25,27,0
43930,256,6158,1454,835,1044,76,110,219,1530,17,275,158,296,292,454,2297,3718,9,34017,1889,1,2,25,27,0
43931,75,1461,757,253,292,73,244,162,830,13,61,38,67,74,105,409,651,7,4654,258,0,2,3,2,0
43932,112,2476,1043,504,840,53,9,147,1096,9,180,112,198,189,310,1377,2344,4,11604,644,0,2,1,6,0
43933,112,2476,383,288,292,26,6,62,409,11,65,38,67,76,105,429,656,5,3719,206,0,2,1,6,0
43936,193,3994,1943,715,1694,26,18,214,1969,12,185,120,237,197,357,1436,2721,7,20915,1161,0,2,14,13,0
43937,193,3994,1168,838,957,57,25,144,1225,19,348,224,416,367,640,3018,5452,11,61921,3440,1,2,14,13,0
43951,155,4372,1660,832,1314,41,38,274,1701,20,312,209,395,332,604,2671,5058,12,64042,3557,1,2,37,15,0
43952,73,3850,1296,573,1062,40,33,157,1336,8,201,118,231,209,349,1561,2689,4,12365,686,0,2,29,3,0
43956,75,3288,1020,354,843,12,15,144,1032,8,134,77,144,142,221,970,1580,4,6792,377,0,2,49,14,0
43968,188,4306,77,34,69,0,0,8,77,3,24,16,29,27,45,114,213,1,387,21,0,2,8,0,0
43969,188,4306,712,438,573,51,9,84,763,14,102,71,128,116,199,733,1364,8,11988,666,0,2,8,0,0
43994,11,235,19,8,11,5,0,4,24,2,5,3,6,7,9,13,25,1,30,1,0,2,9,5,0
43995,11,235,102,59,69,5,3,24,107,6,22,15,28,28,43,113,206,3,789,43,0,2,9,5,0
43996,11,235,106,40,36,3,49,17,109,8,17,13,23,25,36,93,167,5,904,50,0,2,9,5,0
44020,214,4608,182,127,129,0,0,53,182,5,39,21,42,44,63,217,343,2,926,51,0,2,94,47,0
44021,214,4608,1165,710,800,67,119,181,1232,18,243,153,282,261,435,2000,3492,10,36473,2026,1,2,94,47,0
44022,102,2083,773,419,590,28,0,166,801,10,204,113,217,214,330,1598,2554,5,13587,754,0,2,34,32,0
44023,102,2083,421,273,302,44,34,57,465,17,81,59,107,98,166,583,1098,11,12329,684,0,2,34,32,0
44026,27,542,2,2,2,0,0,0,2,0,0,0,0,0,0,0,0,0,0,0,0,2,5,21,0
44040,27,542,99,48,90,1,3,5,100,0,0,0,0,0,0,0,0,0,0,0,0,2,5,21,0
44041,27,542,8,5,5,2,0,1,10,0,0,0,0,0,0,0,0,0,0,0,0,2,5,21,0
44042,27,542,1217,716,841,84,126,174,1301,14,185,118,215,199,333,1446,2542,8,20687,1149,0,2,5,21,0
44043,27,542,160,89,115,0,13,31,160,7,15,11,17,22,28,78,124,3,495,27,0,2,5,21,0
44044,27,542,10,10,9,9,0,0,19,0,0,0,0,0,0,0,0,0,0,0,0,2,5,21,0
44045,27,542,173,84,99,8,29,36,181,5,12,7,13,17,20,54,81,2,221,12,0,2,5,21,0
44046,27,542,3,1,1,3,0,0,6,0,0,0,0,0,0,0,0,0,0,0,0,2,5,21,0
44047,167,5122,1660,832,1314,41,38,274,1701,20,312,209,395,332,604,2671,5058,12,64042,3557,1,2,34,27,0
44048,167,5122,1057,646,719,113,100,145,1170,18,215,134,248,233,382,1740,3004,10,31186,1732,1,2,34,27,0
44050,86,1808,477,336,357,30,23,73,507,16,194,134,250,210,384,1538,2962,10,30538,1696,0,2,24,17,0
44051,59,1352,996,429,845,24,10,117,1020,7,76,50,88,83,138,494,879,4,3565,198,0,2,43,28,0
44052,59,1352,456,277,329,12,42,72,468,13,85,50,97,98,147,592,972,7,7212,400,0,2,43,28,0
44053,133,2659,1513,682,1277,25,13,200,1538,11,199,116,219,210,335,1557,2584,6,15641,868,0,2,94,8,0
44054,133,2659,819,519,539,24,98,155,843,15,96,57,106,111,163,690,1107,8,9171,509,0,2,94,8,0
44055,58,1234,207,111,150,11,0,50,218,5,26,19,36,31,55,133,272,3,943,52,0,2,118,22,0
44056,58,1234,410,198,237,31,55,97,441,11,63,38,72,74,110,414,683,6,4293,238,0,2,118,22,0
44057,351,7048,1457,730,1242,11,6,188,1468,10,292,166,329,302,495,2424,4078,5,22973,1276,1,2,197,123,0
44058,351,7048,74,35,59,1,0,14,75,3,14,7,14,17,21,58,85,1,128,7,0,2,197,123,0
44059,351,7048,245,125,200,5,7,34,250,7,30,17,34,37,51,166,265,3,1053,58,0,2,197,123,0
44060,21,662,339,213,244,17,9,65,356,10,42,26,48,52,74,259,421,5,2410,133,0,2,20,21,0
44062,60,1682,1455,414,1257,16,76,112,1471,5,41,23,46,46,69,231,381,2,1069,59,0,2,52,21,0
44063,60,1682,669,365,481,22,61,110,691,15,103,63,122,118,185,747,1273,8,11311,628,0,2,52,21,0
44064,230,5217,4293,999,3693,19,54,507,4312,9,155,88,170,164,258,1156,1898,4,9368,520,0,2,119,113,0
44065,230,5217,1482,859,1002,125,135,219,1607,16,219,134,251,235,385,1766,3032,9,27804,1544,1,2,119,113,0
44066,6,136,44,22,19,0,19,6,44,2,10,6,12,12,18,35,64,1,77,4,0,2,2,4,0
44067,27,954,74,35,59,1,0,14,75,3,14,7,14,17,21,58,85,1,128,7,0,2,61,21,0
44068,27,954,245,125,200,5,7,34,250,7,30,17,34,37,51,166,265,3,1053,58,0,2,61,21,0
44069,50,586,647,139,84,35,284,233,682,0,0,0,0,0,0,0,0,0,0,0,0,2,133,24,0
44070,83,2365,1523,757,1297,19,12,193,1542,12,193,117,230,205,347,1508,2664,7,19053,1058,0,2,57,17,0
44071,83,2365,701,378,504,33,58,109,734,13,110,68,126,123,194,794,1346,7,10027,557,0,2,57,17,0
44072,188,4306,77,34,69,0,0,8,77,3,24,16,29,27,45,114,213,1,387,21,0,2,159,86,0
44073,188,4306,712,438,573,51,9,84,763,14,102,71,128,116,199,733,1364,8,11988,666,0,2,159,86,0
44074,96,1835,1020,354,843,12,15,144,1032,8,134,77,144,142,221,970,1580,4,6792,377,0,2,214,77,0
44075,46,955,447,308,343,6,5,95,453,7,96,59,111,103,170,651,1136,4,4600,255,0,2,11,10,0
44076,46,955,322,174,179,16,74,51,338,10,41,26,46,51,72,252,408,5,2291,127,0,2,11,10,0
44079,23,388,424,94,331,4,0,89,428,1,5,5,5,6,10,11,25,0,12,0,0,2,13,11,0
44080,23,388,38,23,23,6,0,8,44,3,11,7,11,14,18,42,68,1,102,5,0,2,13,11,0
44082,17,518,184,100,137,2,15,30,186,6,38,20,39,44,59,214,322,3,991,55,0,2,6,4,0
44083,17,518,103,65,74,8,5,16,111,7,17,9,17,24,26,89,119,3,417,23,0,2,6,4,0
44084,212,5103,722,423,573,19,0,135,741,12,172,101,199,184,300,1320,2257,6,15668,870,0,2,106,78,0
44085,212,5103,1508,847,911,44,250,301,1552,14,148,88,169,162,257,1120,1886,7,15077,837,0,2,106,78,0
44086,256,6158,72,33,56,0,4,12,72,1,1,1,1,2,2,0,2,0,1,0,0,2,201,606,0
44087,256,6158,1454,835,1044,76,110,219,1530,17,275,158,296,292,454,2297,3718,9,34017,1889,1,2,201,606,0
44088,75,1461,757,253,292,73,244,162,830,13,61,38,67,74,105,409,651,7,4654,258,0,0,626,0,0
44089,40,837,386,256,301,16,9,68,402,4,59,35,69,63,104,355,621,2,1453,80,0,2,56,77,0
44090,40,837,264,131,164,11,41,46,275,6,38,22,40,44,62,214,338,3,1068,59,0,2,56,77,0
44091,30,649,215,129,180,6,0,29,221,8,65,43,72,73,115,415,711,4,3153,175,0,2,12,6,0
44092,30,649,97,69,77,3,3,16,100,6,22,13,23,28,36,113,173,3,542,30,0,2,12,6,0
44093,112,2476,1043,504,840,53,9,147,1096,9,180,112,198,189,310,1377,2344,4,11604,644,0,2,77,147,0
44094,112,2476,383,288,292,26,6,62,409,11,65,38,67,76,105,429,656,5,3719,206,0,2,77,147,0
44099,102,1930,1178,367,1042,6,15,115,1184,9,94,51,95,103,146,644,976,4,4439,246,0,2,72,75,0
44100,102,1930,177,108,140,8,0,27,185,6,30,16,32,36,48,162,248,3,794,44,0,2,72,75,0
44101,193,3994,1943,715,1694,26,18,214,1969,12,185,120,237,197,357,1436,2721,7,20915,1161,0,2,125,68,0
44102,193,3994,1168,838,957,57,25,144,1225,19,348,224,416,367,640,3018,5452,11,61921,3440,1,2,125,68,0
44103,16,477,442,244,305,14,16,103,456,11,68,45,75,79,120,452,756,6,4588,254,0,2,5,3,0
44104,16,477,182,102,99,11,40,35,193,3,11,6,11,14,17,42,64,1,97,5,0,2,5,3,0
44105,62,1240,1098,241,925,5,10,155,1103,7,46,25,49,53,74,273,423,3,1580,87,0,2,51,29,0
44106,62,1240,282,202,222,14,2,44,296,8,42,24,43,50,67,250,378,4,1548,86,0,2,51,29,0
44107,21,433,601,196,481,2,23,85,603,8,63,36,72,71,108,400,664,4,3036,168,0,0,94,0,0
44108,21,433,156,79,106,5,16,28,161,5,14,8,15,19,23,64,97,2,261,14,0,0,94,0,0
44131,11,410,42,7,35,4,0,5,46,1,2,1,2,3,3,2,4,0,2,0,0,2,23,25,0
44132,11,410,11,6,10,0,0,1,11,2,4,2,4,6,6,10,15,1,15,0,0,2,23,25,0
44156,81,3472,1289,550,1043,56,32,155,1345,10,167,93,185,177,278,1266,2075,5,11498,638,0,2,93,26,0
44157,36,1085,182,127,129,0,0,53,182,5,39,21,42,44,63,217,343,2,926,51,0,2,44,9,0
44158,149,6984,1392,870,1177,35,17,170,1427,14,494,280,531,508,811,4473,7289,7,54850,3047,2,2,169,58,0
44159,87,2923,773,419,590,28,0,166,801,10,204,113,217,214,330,1598,2554,5,13587,754,0,2,73,48,0
44160,7,281,75,38,59,1,3,12,76,2,4,2,4,6,6,10,15,1,15,0,0,2,11,3,0
44165,54,3424,520,294,400,33,13,81,553,10,261,204,367,271,571,2128,4614,7,32445,1802,1,2,190,104,0
44166,98,4450,1338,495,1086,10,64,173,1348,11,122,82,157,133,239,883,1686,7,11934,663,0,2,145,50,0
44167,164,7175,139,89,101,2,0,35,141,7,54,34,62,61,96,330,569,4,2287,127,0,2,437,294,0
44168,164,7175,7,5,5,0,0,2,7,1,2,1,2,3,3,2,4,0,2,0,0,2,437,294,0
44169,32,948,465,148,393,5,8,60,470,4,31,20,31,35,51,161,261,2,523,29,0,2,18,16,0
44170,32,948,16,12,9,0,0,6,16,1,2,1,2,3,3,2,4,0,2,0,0,2,18,16,0
44171,132,5719,1782,648,1425,9,47,279,1791,8,171,97,189,179,286,1292,2140,4,9462,525,0,2,253,113,0
44172,20,541,256,139,192,9,7,47,265,4,23,12,24,27,36,112,171,2,357,19,0,2,16,10,0
44174,23,607,102,59,69,5,3,24,107,6,22,15,28,28,43,113,206,3,789,43,0,2,21,14,0
44175,109,4106,1450,624,1228,12,26,181,1462,14,306,186,354,320,540,2580,4493,8,36391,2021,1,2,204,68,0
44176,155,4372,1660,832,1314,41,38,274,1701,20,312,209,395,332,604,2671,5058,12,64042,3557,1,2,115,42,0
44177,120,4833,1513,682,1277,25,13,200,1538,11,199,116,219,210,335,1557,2584,6,15641,868,0,2,91,38,0
44178,73,3850,1296,573,1062,40,33,157,1336,8,201,118,231,209,349,1561,2689,4,12365,686,0,2,144,39,0
44179,14,341,207,111,150,11,0,50,218,5,26,19,36,31,55,133,272,3,943,52,0,0,101,0,0
44180,79,4191,1457,730,1242,11,6,188,1468,10,292,166,329,302,495,2424,4078,5,22973,1276,1,2,135,64,0
44181,39,2355,652,304,544,16,6,88,668,6,89,51,101,95,152,591,998,3,3399,188,0,2,79,51,0
44182,66,3053,1455,414,1257,16,76,112,1471,5,41,23,46,46,69,231,381,2,1069,59,0,2,132,21,0
44184,8,273,74,35,59,1,0,14,75,3,14,7,14,17,21,58,85,1,128,7,0,2,10,2,0
44185,90,4427,1523,757,1297,19,12,193,1542,12,193,117,230,205,347,1508,2664,7,19053,1058,0,2,106,8,0
44186,75,3288,1020,354,843,12,15,144,1032,8,134,77,144,142,221,970,1580,4,6792,377,0,2,174,53,0
44187,37,1624,447,308,343,6,5,95,453,7,96,59,111,103,170,651,1136,4,4600,255,0,2,11,15,0
44189,21,661,424,94,331,4,0,89,428,1,5,5,5,6,10,11,25,0,12,0,0,2,51,40,0
44190,40,2367,334,251,279,10,4,40,344,5,127,74,143,132,217,899,1528,2,4303,239,0,2,27,23,0
44191,12,492,184,100,137,2,15,30,186,6,38,20,39,44,59,214,322,3,991,55,0,2,7,7,0
44192,35,1623,1293,570,1093,25,15,163,1318,10,195,123,241,205,364,1516,2795,6,17273,959,0,2,73,24,0
44193,36,1978,384,251,317,7,8,52,391,11,70,44,84,81,128,467,811,6,5355,297,0,2,38,35,0
44194,15,638,722,423,573,19,0,135,741,12,172,101,199,184,300,1320,2257,6,15668,870,0,2,15,3,0
44195,36,1591,386,256,301,16,9,68,402,4,59,35,69,63,104,355,621,2,1453,80,0,2,109,50,0
44196,16,1209,215,129,180,6,0,29,221,8,65,43,72,73,115,415,711,4,3153,175,0,2,12,11,0
44197,75,2972,1043,504,840,53,9,147,1096,9,180,112,198,189,310,1377,2344,4,11604,644,0,2,111,58,0
44198,14,529,295,56,236,0,4,54,295,2,9,5,10,11,15,30,51,1,57,3,0,2,30,16,0
44199,26,1029,373,158,315,8,0,51,381,5,76,44,79,81,123,486,779,2,2026,112,0,2,38,29,0
44200,71,3006,1178,367,1042,6,15,115,1184,9,94,51,95,103,146,644,976,4,4439,246,0,2,57,22,0
44201,76,3899,1943,715,1694,26,18,214,1969,12,185,120,237,197,357,1436,2721,7,20915,1161,0,2,105,46,0
44202,14,825,442,244,305,14,16,103,456,11,68,45,75,79,120,452,756,6,4588,254,0,2,8,2,0
44203,48,1795,1098,241,925,5,10,155,1103,7,46,25,49,53,74,273,423,3,1580,87,0,2,94,75,0
44204,17,604,601,196,481,2,23,85,603,8,63,36,72,71,108,400,664,4,3036,168,0,0,225,0,0
44205,230,5248,4293,999,3693,19,54,507,4312,9,155,88,170,164,258,1156,1898,4,9368,520,0,2,10,9,0
44206,230,5248,1482,859,1002,125,135,219,1607,16,219,134,251,235,385,1766,3032,9,27804,1544,1,2,10,9,0
44207,50,588,647,139,84,35,284,233,682,0,0,0,0,0,0,0,0,0,0,0,0,2,1,1,0
44208,163,7149,139,89,101,2,0,35,141,7,54,34,62,61,96,330,569,4,2287,127,0,2,30,38,0
44209,163,7149,7,5,5,0,0,2,7,1,2,1,2,3,3,2,4,0,2,0,0,2,30,38,0
44213,214,4592,182,127,129,0,0,53,182,5,39,21,42,44,63,217,343,2,926,51,0,2,1,3,0
44214,214,4592,1165,710,800,67,119,181,1232,18,243,153,282,261,435,2000,3492,10,36473,2026,1,2,1,3,0
44215,101,2069,773,419,590,28,0,166,801,10,204,113,217,214,330,1598,2554,5,13587,754,0,2,2,3,0
44216,101,2069,421,273,302,44,34,57,465,17,81,59,107,98,166,583,1098,11,12329,684,0,2,2,3,0
44219,26,524,2,2,2,0,0,0,2,0,0,0,0,0,0,0,0,0,0,0,0,2,4,6,0
44233,26,524,99,48,90,1,3,5,100,0,0,0,0,0,0,0,0,0,0,0,0,2,4,6,0
44234,26,524,8,5,5,2,0,1,10,0,0,0,0,0,0,0,0,0,0,0,0,2,4,6,0
44235,26,524,1217,716,841,84,126,174,1301,14,185,118,215,199,333,1446,2542,8,20687,1149,0,2,4,6,0
44236,26,524,160,89,115,0,13,31,160,7,15,11,17,22,28,78,124,3,495,27,0,2,4,6,0
44237,26,524,10,10,9,9,0,0,19,0,0,0,0,0,0,0,0,0,0,0,0,2,4,6,0
44238,26,524,173,84,99,8,29,36,181,5,12,7,13,17,20,54,81,2,221,12,0,2,4,6,0
44239,26,524,3,1,1,3,0,0,6,0,0,0,0,0,0,0,0,0,0,0,0,2,4,6,0
44240,166,5068,1660,832,1314,41,38,274,1701,20,312,209,395,332,604,2671,5058,12,64042,3557,1,2,12,16,0
44241,166,5068,1057,646,719,113,100,145,1170,18,215,134,248,233,382,1740,3004,10,31186,1732,1,2,12,16,0
44244,135,2748,1513,682,1277,25,13,200,1538,11,199,116,219,210,335,1557,2584,6,15641,868,0,2,101,54,0
44245,135,2748,819,519,539,24,98,155,843,15,96,57,106,111,163,690,1107,8,9171,509,0,2,101,54,0
44246,52,1082,207,111,150,11,0,50,218,5,26,19,36,31,55,133,272,3,943,52,0,2,68,72,0
44247,52,1082,410,198,237,31,55,97,441,11,63,38,72,74,110,414,683,6,4293,238,0,2,68,72,0
44248,346,6927,1457,730,1242,11,6,188,1468,10,292,166,329,302,495,2424,4078,5,22973,1276,1,2,18,36,0
44249,346,6927,74,35,59,1,0,14,75,3,14,7,14,17,21,58,85,1,128,7,0,2,18,36,0
44250,346,6927,245,125,200,5,7,34,250,7,30,17,34,37,51,166,265,3,1053,58,0,2,18,36,0
44251,21,662,339,213,244,17,9,65,356,10,42,26,48,52,74,259,421,5,2410,133,0,2,3,3,0
44253,64,1726,1455,414,1257,16,76,112,1471,5,41,23,46,46,69,231,381,2,1069,59,0,2,8,1,0
44254,64,1726,669,365,481,22,61,110,691,15,103,63,122,118,185,747,1273,8,11311,628,0,2,8,1,0
44255,231,5269,4293,999,3693,19,54,507,4312,9,155,88,170,164,258,1156,1898,4,9368,520,0,2,20,15,0
44256,231,5269,1482,859,1002,125,135,219,1607,16,219,134,251,235,385,1766,3032,9,27804,1544,1,2,20,15,0
44261,185,4238,77,34,69,0,0,8,77,3,24,16,29,27,45,114,213,1,387,21,0,2,15,29,0
44262,185,4238,712,438,573,51,9,84,763,14,102,71,128,116,199,733,1364,8,11988,666,0,2,15,29,0
44263,99,2020,1020,354,843,12,15,144,1032,8,134,77,144,142,221,970,1580,4,6792,377,0,2,55,26,0
44269,17,518,184,100,137,2,15,30,186,6,38,20,39,44,59,214,322,3,991,55,0,2,5,5,0
44270,17,518,103,65,74,8,5,16,111,7,17,9,17,24,26,89,119,3,417,23,0,2,5,5,0
44271,210,5003,722,423,573,19,0,135,741,12,172,101,199,184,300,1320,2257,6,15668,870,0,2,19,40,0
44272,210,5003,1508,847,911,44,250,301,1552,14,148,88,169,162,257,1120,1886,7,15077,837,0,2,19,40,0
44273,257,6066,72,33,56,0,4,12,72,1,1,1,1,2,2,0,2,0,1,0,0,2,35,39,0
44274,257,6066,1454,835,1044,76,110,219,1530,17,275,158,296,292,454,2297,3718,9,34017,1889,1,2,35,39,0
44275,73,1425,757,253,292,73,244,162,830,13,61,38,67,74,105,409,651,7,4654,258,0,2,4,11,0
44276,46,954,386,256,301,16,9,68,402,4,59,35,69,63,104,355,621,2,1453,80,0,2,36,5,0
44277,46,954,264,131,164,11,41,46,275,6,38,22,40,44,62,214,338,3,1068,59,0,2,36,5,0
44278,112,2472,1043,504,840,53,9,147,1096,9,180,112,198,189,310,1377,2344,4,11604,644,0,2,1,1,0
44279,112,2472,383,288,292,26,6,62,409,11,65,38,67,76,105,429,656,5,3719,206,0,2,1,1,0
44282,108,2066,1178,367,1042,6,15,115,1184,9,94,51,95,103,146,644,976,4,4439,246,0,2,75,50,0
44283,108,2066,177,108,140,8,0,27,185,6,30,16,32,36,48,162,248,3,794,44,0,2,75,50,0
44284,195,4029,1943,715,1694,26,18,214,1969,12,185,120,237,197,357,1436,2721,7,20915,1161,0,2,65,51,0
44285,195,4029,1168,838,957,57,25,144,1225,19,348,224,416,367,640,3018,5452,11,61921,3440,1,2,65,51,0
44314,12,422,42,7,35,4,0,5,46,1,2,1,2,3,3,2,4,0,2,0,0,2,23,10,0
44315,12,422,11,6,10,0,0,1,11,2,4,2,4,6,6,10,15,1,15,0,0,2,23,10,0
44316,81,3472,1289,550,1043,56,32,155,1345,10,167,93,185,177,278,1266,2075,5,11498,638,0,2,1,1,0
44322,97,4424,1338,495,1086,10,64,173,1348,11,122,82,157,133,239,883,1686,7,11934,663,0,2,10,15,0
44323,162,7122,139,89,101,2,0,35,141,7,54,34,62,61,96,330,569,4,2287,127,0,2,1,5,0
44324,162,7122,7,5,5,0,0,2,7,1,2,1,2,3,3,2,4,0,2,0,0,2,1,5,0
44327,124,4990,1513,682,1277,25,13,200,1538,11,199,116,219,210,335,1557,2584,6,15641,868,0,2,72,32,0
44328,73,3834,1296,573,1062,40,33,157,1336,8,201,118,231,209,349,1561,2689,4,12365,686,0,2,7,8,0
44329,80,4250,1457,730,1242,11,6,188,1468,10,292,166,329,302,495,2424,4078,5,22973,1276,1,2,9,1,0
44330,68,3131,1455,414,1257,16,76,112,1471,5,41,23,46,46,69,231,381,2,1069,59,0,2,28,0,0
44332,33,1914,384,251,317,7,8,52,391,11,70,44,84,81,128,467,811,6,5355,297,0,2,8,20,0
44336,74,3124,1178,367,1042,6,15,115,1184,9,94,51,95,103,146,644,976,4,4439,246,0,2,64,3,0
44337,76,3893,1943,715,1694,26,18,214,1969,12,185,120,237,197,357,1436,2721,7,20915,1161,0,2,1,2,0
44338,48,1750,1098,241,925,5,10,155,1103,7,46,25,49,53,74,273,423,3,1580,87,0,2,4,7,0
44339,18,646,601,196,481,2,23,85,603,8,63,36,72,71,108,400,664,4,3036,168,0,2,21,1,0
44340,231,5270,4293,999,3693,19,54,507,4312,9,155,88,170,164,258,1156,1898,4,9368,520,0,2,1,1,0
44341,231,5270,1482,859,1002,125,135,219,1607,16,219,134,251,235,385,1766,3032,9,27804,1544,1,2,1,1,0
44342,231,5276,4293,999,3693,19,54,507,4312,9,155,88,170,164,258,1156,1898,4,9368,520,0,2,1,0,0
44343,231,5276,1482,859,1002,125,135,219,1607,16,219,134,251,235,385,1766,3032,9,27804,1544,1,2,1,0,0
44344,231,5276,4293,999,3693,19,54,507,4312,9,155,88,170,164,258,1156,1898,4,9368,520,0,2,8,10,1
44345,231,5276,1482,859,1002,125,135,219,1607,16,219,134,251,235,385,1766,3032,9,27804,1544,1,2,8,10,1
44346,11,410,42,7,35,4,0,5,46,1,2,1,2,3,3,2,4,0,2,0,0,2,1,1,0
44347,11,410,11,6,10,0,0,1,11,2,4,2,4,6,6,10,15,1,15,0,0,2,1,1,0
44348,231,5276,4293,999,3693,19,54,507,4312,9,155,88,170,164,258,1156,1898,4,9368,520,0,2,22,18,0
44349,231,5276,1482,859,1002,125,135,219,1607,16,219,134,251,235,385,1766,3032,9,27804,1544,1,2,22,18,0
44351,185,4238,77,34,69,0,0,8,77,3,24,16,29,27,45,114,213,1,387,21,0,2,8,0,0
44352,185,4238,712,438,573,51,9,84,763,14,102,71,128,116,199,733,1364,8,11988,666,0,2,8,0,0
44353,112,2472,1043,504,840,53,9,147,1096,9,180,112,198,189,310,1377,2344,4,11604,644,0,2,0,5,0
44354,112,2472,383,288,292,26,6,62,409,11,65,38,67,76,105,429,656,5,3719,206,0,2,0,5,0
44356,162,7122,139,89,101,2,0,35,141,7,54,34,62,61,96,330,569,4,2287,127,0,2,40,0,0
44357,162,7122,7,5,5,0,0,2,7,1,2,1,2,3,3,2,4,0,2,0,0,2,40,0,0
44360,12,422,42,7,35,4,0,5,46,1,2,1,2,3,3,2,4,0,2,0,0,2,1,1,0
44361,12,422,11,6,10,0,0,1,11,2,4,2,4,6,6,10,15,1,15,0,0,2,1,1,0
44362,138,2871,1513,682,1277,25,13,200,1538,11,199,116,219,210,335,1557,2584,6,15641,868,0,2,56,20,1
44363,138,2871,819,519,539,24,98,155,843,15,96,57,106,111,163,690,1107,8,9171,509,0,2,56,20,1
44364,126,5054,1513,682,1277,25,13,200,1538,11,199,116,219,210,335,1557,2584,6,15641,868,0,2,26,2,1
44367,12,426,42,7,35,4,0,5,46,1,2,1,2,3,3,2,4,0,2,0,0,2,1,0,0
44368,12,426,11,6,10,0,0,1,11,2,4,2,4,6,6,10,15,1,15,0,0,2,1,0,0
44375,12,426,42,7,35,4,0,5,46,1,2,1,2,3,3,2,4,0,2,0,0,2,1,1,0
44376,12,426,11,6,10,0,0,1,11,2,4,2,4,6,6,10,15,1,15,0,0,2,1,1,0
44378,258,6089,72,33,56,0,4,12,72,1,1,1,1,2,2,0,2,0,1,0,0,2,9,3,0
44379,258,6089,1454,835,1044,76,110,219,1530,17,275,158,296,292,454,2297,3718,9,34017,1889,1,2,9,3,0
44380,8,329,75,38,59,1,3,12,76,2,4,2,4,6,6,10,15,1,15,0,0,2,17,0,0
44387,138,2871,1513,682,1277,25,13,200,1538,11,199,116,219,210,335,1557,2584,6,15641,868,0,2,56,20,0
44388,138,2871,819,519,539,24,98,155,843,15,96,57,106,111,163,690,1107,8,9171,509,0,2,56,20,0
44389,126,5054,1513,682,1277,25,13,200,1538,11,199,116,219,210,335,1557,2584,6,15641,868,0,2,26,2,0
44390,141,2959,1513,682,1277,25,13,200,1538,11,199,116,219,210,335,1557,2584,6,15641,868,0,2,28,5,1
44391,141,2959,819,519,539,24,98,155,843,15,96,57,106,111,163,690,1107,8,9171,509,0,2,28,5,1
44392,128,5156,1513,682,1277,25,13,200,1538,11,199,116,219,210,335,1557,2584,6,15641,868,0,2,33,1,1
44393,141,2959,1513,682,1277,25,13,200,1538,11,199,116,219,210,335,1557,2584,6,15641,868,0,2,28,5,0
44394,141,2959,819,519,539,24,98,155,843,15,96,57,106,111,163,690,1107,8,9171,509,0,2,28,5,0
44395,128,5156,1513,682,1277,25,13,200,1538,11,199,116,219,210,335,1557,2584,6,15641,868,0,2,33,1,0
44398,204,4267,1943,715,1694,26,18,214,1969,12,185,120,237,197,357,1436,2721,7,20915,1161,0,2,49,7,1
44399,204,4267,1168,838,957,57,25,144,1225,19,348,224,416,367,640,3018,5452,11,61921,3440,1,2,49,7,1
44400,81,3472,1289,550,1043,56,32,155,1345,10,167,93,185,177,278,1266,2075,5,11498,638,0,2,5,5,1
44401,162,7134,139,89,101,2,0,35,141,7,54,34,62,61,96,330,569,4,2287,127,0,2,8,0,1
44402,162,7134,7,5,5,0,0,2,7,1,2,1,2,3,3,2,4,0,2,0,0,2,8,0,1
44403,132,5730,1782,648,1425,9,47,279,1791,8,171,97,189,179,286,1292,2140,4,9462,525,0,2,9,5,1
44405,128,5156,1513,682,1277,25,13,200,1538,11,199,116,219,210,335,1557,2584,6,15641,868,0,2,1,1,1
44406,76,3893,1943,715,1694,26,18,214,1969,12,185,120,237,197,357,1436,2721,7,20915,1161,0,2,6,6,1
44407,214,5107,722,423,573,19,0,135,741,12,172,101,199,184,300,1320,2257,6,15668,870,0,2,46,5,1
44408,214,5107,1508,847,911,44,250,301,1552,14,148,88,169,162,257,1120,1886,7,15077,837,0,2,46,5,1
44409,203,4282,1943,715,1694,26,18,214,1969,12,185,120,237,197,357,1436,2721,7,20915,1161,0,2,2,2,0
44410,203,4282,1168,838,957,57,25,144,1225,19,348,224,416,367,640,3018,5452,11,61921,3440,1,2,2,2,0
44411,204,4297,1943,715,1694,26,18,214,1969,12,185,120,237,197,357,1436,2721,7,20915,1161,0,2,5,2,0
44412,204,4297,1168,838,957,57,25,144,1225,19,348,224,416,367,640,3018,5452,11,61921,3440,1,2,5,2,0
44413,81,4076,1943,715,1694,26,18,214,1969,12,185,120,237,197,357,1436,2721,7,20915,1161,0,2,55,0,0
44414,168,5128,1660,832,1314,41,38,274,1701,20,312,209,395,332,604,2671,5058,12,64042,3557,1,2,1,1,0
44415,168,5128,1057,646,719,113,100,145,1170,18,215,134,248,233,382,1740,3004,10,31186,1732,1,2,1,1,0
44416,110,4156,1450,624,1228,12,26,181,1462,14,306,186,354,320,540,2580,4493,8,36391,2021,1,2,18,0,0
44417,204,4299,1943,715,1694,26,18,214,1969,12,185,120,237,197,357,1436,2721,7,20915,1161,0,2,1,1,0
44418,204,4299,1168,838,957,57,25,144,1225,19,348,224,416,367,640,3018,5452,11,61921,3440,1,2,1,1,0
44419,81,4076,1943,715,1694,26,18,214,1969,12,185,120,237,197,357,1436,2721,7,20915,1161,0,2,1,1,0
44423,97,1855,1020,354,843,12,15,144,1032,8,134,77,144,142,221,970,1580,4,6792,377,0,2,4,2,0
44424,76,3351,1020,354,843,12,15,144,1032,8,134,77,144,142,221,970,1580,4,6792,377,0,2,17,0,0
44427,214,5107,722,423,573,19,0,135,741,12,172,101,199,184,300,1320,2257,6,15668,870,0,2,2,2,1
44428,214,5107,1508,847,911,44,250,301,1552,14,148,88,169,162,257,1120,1886,7,15077,837,0,2,2,2,1
44429,81,4076,1943,715,1694,26,18,214,1969,12,185,120,237,197,357,1436,2721,7,20915,1161,0,2,4,4,0
44430,214,5107,722,423,573,19,0,135,741,12,172,101,199,184,300,1320,2257,6,15668,870,0,2,46,5,0
44431,214,5107,1508,847,911,44,250,301,1552,14,148,88,169,162,257,1120,1886,7,15077,837,0,2,46,5,0
44432,204,4299,1943,715,1694,26,18,214,1969,12,185,120,237,197,357,1436,2721,7,20915,1161,0,2,54,9,0
44433,204,4299,1168,838,957,57,25,144,1225,19,348,224,416,367,640,3018,5452,11,61921,3440,1,2,54,9,0
44436,81,3472,1289,550,1043,56,32,155,1345,10,167,93,185,177,278,1266,2075,5,11498,638,0,2,5,5,0
44437,162,7134,139,89,101,2,0,35,141,7,54,34,62,61,96,330,569,4,2287,127,0,2,8,0,0
44438,162,7134,7,5,5,0,0,2,7,1,2,1,2,3,3,2,4,0,2,0,0,2,8,0,0
44439,132,5730,1782,648,1425,9,47,279,1791,8,171,97,189,179,286,1292,2140,4,9462,525,0,2,9,5,0
44440,109,4106,1450,624,1228,12,26,181,1462,14,306,186,354,320,540,2580,4493,8,36391,2021,1,2,2,2,0
44441,128,5156,1513,682,1277,25,13,200,1538,11,199,116,219,210,335,1557,2584,6,15641,868,0,2,1,1,0
44442,81,4076,1943,715,1694,26,18,214,1969,12,185,120,237,197,357,1436,2721,7,20915,1161,0,2,62,7,0
44443,167,5074,1660,832,1314,41,38,274,1701,20,312,209,395,332,604,2671,5058,12,64042,3557,1,2,1,1,0
44444,167,5074,1057,646,719,113,100,145,1170,18,215,134,248,233,382,1740,3004,10,31186,1732,1,2,1,1,0
44445,100,2040,1020,354,843,12,15,144,1032,8,134,77,144,142,221,970,1580,4,6792,377,0,2,4,2,0
44471,346,6927,1457,730,1242,11,6,188,1468,10,292,166,329,302,495,2424,4078,5,22973,1276,1,2,1,1,0
44472,346,6927,74,35,59,1,0,14,75,3,14,7,14,17,21,58,85,1,128,7,0,2,1,1,0
44473,346,6927,245,125,200,5,7,34,250,7,30,17,34,37,51,166,265,3,1053,58,0,2,1,1,0
44479,108,2066,1178,367,1042,6,15,115,1184,9,94,51,95,103,146,644,976,4,4439,246,0,2,2,2,0
44480,108,2066,177,108,140,8,0,27,185,6,30,16,32,36,48,162,248,3,794,44,0,2,2,2,0
44481,202,4260,1943,715,1694,26,18,214,1969,12,185,120,237,197,357,1436,2721,7,20915,1161,0,2,44,55,0
44482,202,4260,1168,838,957,57,25,144,1225,19,348,224,416,367,640,3018,5452,11,61921,3440,1,2,44,55,0
44483,76,3351,1020,354,843,12,15,144,1032,8,134,77,144,142,221,970,1580,4,6792,377,0,2,1,1,0
44485,347,6940,1457,730,1242,11,6,188,1468,10,292,166,329,302,495,2424,4078,5,22973,1276,1,2,4,0,0
44486,347,6940,74,35,59,1,0,14,75,3,14,7,14,17,21,58,85,1,128,7,0,2,4,0,0
44487,347,6940,245,125,200,5,7,34,250,7,30,17,34,37,51,166,265,3,1053,58,0,2,4,0,0
44488,9,367,75,38,59,1,3,12,76,2,4,2,4,6,6,10,15,1,15,0,0,2,13,0,0
44491,168,5128,1660,832,1314,41,38,274,1701,20,312,209,395,332,604,2671,5058,12,64042,3557,1,2,6,6,0
44492,168,5128,1057,646,719,113,100,145,1170,18,215,134,248,233,382,1740,3004,10,31186,1732,1,2,6,6,0
44493,351,7048,1457,730,1242,11,6,188,1468,10,292,166,329,302,495,2424,4078,5,22973,1276,1,2,2,2,0
44494,351,7048,74,35,59,1,0,14,75,3,14,7,14,17,21,58,85,1,128,7,0,2,2,2,0
44495,351,7048,245,125,200,5,7,34,250,7,30,17,34,37,51,166,265,3,1053,58,0,2,2,2,0
44496,212,5103,722,423,573,19,0,135,741,12,172,101,199,184,300,1320,2257,6,15668,870,0,2,1,1,0
44497,212,5103,1508,847,911,44,250,301,1552,14,148,88,169,162,257,1120,1886,7,15077,837,0,2,1,1,0
44498,110,4156,1450,624,1228,12,26,181,1462,14,306,186,354,320,540,2580,4493,8,36391,2021,1,2,1,1,0
44509,347,6940,1457,730,1242,11,6,188,1468,10,292,166,329,302,495,2424,4078,5,22973,1276,1,2,5,1,0
44510,347,6940,74,35,59,1,0,14,75,3,14,7,14,17,21,58,85,1,128,7,0,2,5,1,0
44511,347,6940,245,125,200,5,7,34,250,7,30,17,34,37,51,166,265,3,1053,58,0,2,5,1,0
44549,76,3351,1020,354,843,12,15,144,1032,8,134,77,144,142,221,970,1580,4,6792,377,0,2,18,1,0
44581,167,5074,1660,832,1314,41,38,274,1701,20,312,209,395,332,604,2671,5058,12,64042,3557,1,2,12,16,0
44582,167,5074,1057,646,719,113,100,145,1170,18,215,134,248,233,382,1740,3004,10,31186,1732,1,2,12,16,0
44585,141,2959,1513,682,1277,25,13,200,1538,11,199,116,219,210,335,1557,2584,6,15641,868,0,2,183,77,0
44586,141,2959,819,519,539,24,98,155,843,15,96,57,106,111,163,690,1107,8,9171,509,0,2,183,77,0
44589,347,6940,1457,730,1242,11,6,188,1468,10,292,166,329,302,495,2424,4078,5,22973,1276,1,2,21,35,0
44590,347,6940,74,35,59,1,0,14,75,3,14,7,14,17,21,58,85,1,128,7,0,2,21,35,0
44591,347,6940,245,125,200,5,7,34,250,7,30,17,34,37,51,166,265,3,1053,58,0,2,21,35,0
44596,231,5276,4293,999,3693,19,54,507,4312,9,155,88,170,164,258,1156,1898,4,9368,520,0,2,37,30,0
44597,231,5276,1482,859,1002,125,135,219,1607,16,219,134,251,235,385,1766,3032,9,27804,1544,1,2,37,30,0
44598,50,586,647,139,84,35,284,233,682,0,0,0,0,0,0,0,0,0,0,0,0,2,2,2,0
44602,100,2040,1020,354,843,12,15,144,1032,8,134,77,144,142,221,970,1580,4,6792,377,0,2,55,26,0
44610,214,5107,722,423,573,19,0,135,741,12,172,101,199,184,300,1320,2257,6,15668,870,0,2,65,45,0
44611,214,5107,1508,847,911,44,250,301,1552,14,148,88,169,162,257,1120,1886,7,15077,837,0,2,65,45,0
44612,258,6089,72,33,56,0,4,12,72,1,1,1,1,2,2,0,2,0,1,0,0,2,44,42,0
44613,258,6089,1454,835,1044,76,110,219,1530,17,275,158,296,292,454,2297,3718,9,34017,1889,1,2,44,42,0
44621,108,2066,1178,367,1042,6,15,115,1184,9,94,51,95,103,146,644,976,4,4439,246,0,2,73,48,0
44622,108,2066,177,108,140,8,0,27,185,6,30,16,32,36,48,162,248,3,794,44,0,2,73,48,0
44623,202,4260,1943,715,1694,26,18,214,1969,12,185,120,237,197,357,1436,2721,7,20915,1161,0,2,70,22,0
44624,202,4260,1168,838,957,57,25,144,1225,19,348,224,416,367,640,3018,5452,11,61921,3440,1,2,70,22,0
44653,12,426,42,7,35,4,0,5,46,1,2,1,2,3,3,2,4,0,2,0,0,2,24,10,0
44654,12,426,11,6,10,0,0,1,11,2,4,2,4,6,6,10,15,1,15,0,0,2,24,10,0
44678,81,3472,1289,550,1043,56,32,155,1345,10,167,93,185,177,278,1266,2075,5,11498,638,0,2,6,6,0
44681,9,367,75,38,59,1,3,12,76,2,4,2,4,6,6,10,15,1,15,0,0,2,30,0,0
44686,162,7134,139,89,101,2,0,35,141,7,54,34,62,61,96,330,569,4,2287,127,0,2,49,5,0
44687,162,7134,7,5,5,0,0,2,7,1,2,1,2,3,3,2,4,0,2,0,0,2,49,5,0
44688,132,5730,1782,648,1425,9,47,279,1791,8,171,97,189,179,286,1292,2140,4,9462,525,0,2,10,6,0
44689,110,4156,1450,624,1228,12,26,181,1462,14,306,186,354,320,540,2580,4493,8,36391,2021,1,2,2,2,0
44691,128,5156,1513,682,1277,25,13,200,1538,11,199,116,219,210,335,1557,2584,6,15641,868,0,2,132,36,0
44702,81,4076,1943,715,1694,26,18,214,1969,12,185,120,237,197,357,1436,2721,7,20915,1161,0,2,64,10,0
44705,22,453,601,196,481,2,23,85,603,8,63,36,72,71,108,400,664,4,3036,168,0,2,3,1,1
44706,22,453,156,79,106,5,16,28,161,5,14,8,15,19,23,64,97,2,261,14,0,2,3,1,1
44707,19,679,601,196,481,2,23,85,603,8,63,36,72,71,108,400,664,4,3036,168,0,2,13,0,1
44708,22,453,601,196,481,2,23,85,603,8,63,36,72,71,108,400,664,4,3036,168,0,2,3,1,0
44709,22,453,156,79,106,5,16,28,161,5,14,8,15,19,23,64,97,2,261,14,0,2,3,1,0
44710,19,679,601,196,481,2,23,85,603,8,63,36,72,71,108,400,664,4,3036,168,0,2,13,0,0
44711,348,6947,1457,730,1242,11,6,188,1468,10,292,166,329,302,495,2424,4078,5,22973,1276,1,2,1,1,0
44712,348,6947,74,35,59,1,0,14,75,3,14,7,14,17,21,58,85,1,128,7,0,2,1,1,0
44713,348,6947,245,125,200,5,7,34,250,7,30,17,34,37,51,166,265,3,1053,58,0,2,1,1,0
44714,80,4253,1457,730,1242,11,6,188,1468,10,292,166,329,302,495,2424,4078,5,22973,1276,1,2,6,2,0
44715,80,4253,1457,730,1242,11,6,188,1468,10,292,166,329,302,495,2424,4078,5,22973,1276,1,2,0,3,0
44716,111,2463,1043,504,840,53,9,147,1096,9,180,112,198,189,310,1377,2344,4,11604,644,0,2,2,4,1
44717,111,2463,383,288,292,26,6,62,409,11,65,38,67,76,105,429,656,5,3719,206,0,2,2,4,1
44718,81,3472,1289,550,1043,56,32,155,1345,10,167,93,185,177,278,1266,2075,5,11498,638,0,2,3,3,1
44719,82,4311,1457,730,1242,11,6,188,1468,10,292,166,329,302,495,2424,4078,5,22973,1276,1,2,12,4,0
44720,203,4272,1943,715,1694,26,18,214,1969,12,185,120,237,197,357,1436,2721,7,20915,1161,0,2,5,2,0
44721,203,4272,1168,838,957,57,25,144,1225,19,348,224,416,367,640,3018,5452,11,61921,3440,1,2,5,2,0
44722,82,4120,1943,715,1694,26,18,214,1969,12,185,120,237,197,357,1436,2721,7,20915,1161,0,2,18,0,0
44723,111,2463,1043,504,840,53,9,147,1096,9,180,112,198,189,310,1377,2344,4,11604,644,0,2,2,4,0
44724,111,2463,383,288,292,26,6,62,409,11,65,38,67,76,105,429,656,5,3719,206,0,2,2,4,0
44725,81,3472,1289,550,1043,56,32,155,1345,10,167,93,185,177,278,1266,2075,5,11498,638,0,2,3,3,0
44729,82,4311,1457,730,1242,11,6,188,1468,10,292,166,329,302,495,2424,4078,5,22973,1276,1,2,14,5,0
44730,259,6096,72,33,56,0,4,12,72,1,1,1,1,2,2,0,2,0,1,0,0,2,1,1,0
44731,259,6096,1454,835,1044,76,110,219,1530,17,275,158,296,292,454,2297,3718,9,34017,1889,1,2,1,1,0
44732,231,5287,4293,999,3693,19,54,507,4312,9,155,88,170,164,258,1156,1898,4,9368,520,0,2,1,1,0
44733,231,5287,1482,859,1002,125,135,219,1607,16,219,134,251,235,385,1766,3032,9,27804,1544,1,2,1,1,0
44734,135,5789,1782,648,1425,9,47,279,1791,8,171,97,189,179,286,1292,2140,4,9462,525,0,2,14,0,0
44735,135,5789,1782,648,1425,9,47,279,1791,8,171,97,189,179,286,1292,2140,4,9462,525,0,2,7,2,0
44740,135,5789,1782,648,1425,9,47,279,1791,8,171,97,189,179,286,1292,2140,4,9462,525,0,2,19,0,0
44741,202,4267,1943,715,1694,26,18,214,1969,12,185,120,237,197,357,1436,2721,7,20915,1161,0,2,2,0,0
44742,202,4267,1168,838,957,57,25,144,1225,19,348,224,416,367,640,3018,5452,11,61921,3440,1,2,2,0,0
44743,11,406,75,38,59,1,3,12,76,2,4,2,4,6,6,10,15,1,15,0,0,2,13,0,0
44747,203,4279,1943,715,1694,26,18,214,1969,12,185,120,237,197,357,1436,2721,7,20915,1161,0,2,2,0,0
44748,203,4279,1168,838,957,57,25,144,1225,19,348,224,416,367,640,3018,5452,11,61921,3440,1,2,2,0,0
44750,348,6963,1457,730,1242,11,6,188,1468,10,292,166,329,302,495,2424,4078,5,22973,1276,1,2,4,3,0
44751,348,6963,74,35,59,1,0,14,75,3,14,7,14,17,21,58,85,1,128,7,0,2,4,3,0
44752,348,6963,245,125,200,5,7,34,250,7,30,17,34,37,51,166,265,3,1053,58,0,2,4,3,0
44753,11,428,75,38,59,1,3,12,76,2,4,2,4,6,6,10,15,1,15,0,0,2,5,4,0
44763,203,4279,1943,715,1694,26,18,214,1969,12,185,120,237,197,357,1436,2721,7,20915,1161,0,2,7,2,0
44764,203,4279,1168,838,957,57,25,144,1225,19,348,224,416,367,640,3018,5452,11,61921,3440,1,2,7,2,0
44765,11,428,75,38,59,1,3,12,76,2,4,2,4,6,6,10,15,1,15,0,0,2,18,4,0
44767,191,4342,77,34,69,0,0,8,77,3,24,16,29,27,45,114,213,1,387,21,0,2,19,0,1
44768,191,4342,712,438,573,51,9,84,763,14,102,71,128,116,199,733,1364,8,11988,666,0,2,19,0,1
44769,87,3758,1289,550,1043,56,32,155,1345,10,167,93,185,177,278,1266,2075,5,11498,638,0,2,65,0,1
44770,41,1265,773,422,505,30,103,129,803,14,77,46,83,91,129,535,839,7,6334,351,0,2,14,24,0
44771,214,5107,722,423,573,19,0,135,741,12,172,101,199,184,300,1320,2257,6,15668,870,0,2,159,160,1
44772,214,5107,1508,847,911,44,250,301,1552,14,148,88,169,162,257,1120,1886,7,15077,837,0,2,159,160,1
44773,214,5107,722,423,573,19,0,135,741,12,172,101,199,184,300,1320,2257,6,15668,870,0,2,0,7,0
44774,214,5107,1508,847,911,44,250,301,1552,14,148,88,169,162,257,1120,1886,7,15077,837,0,2,0,7,0
44775,214,5106,722,423,573,19,0,135,741,12,172,101,199,184,300,1320,2257,6,15668,870,0,2,2,2,0
44776,214,5106,1508,847,911,44,250,301,1552,14,148,88,169,162,257,1120,1886,7,15077,837,0,2,2,2,0
44777,81,3468,1289,550,1043,56,32,155,1345,10,167,93,185,177,278,1266,2075,5,11498,638,0,2,2,2,0
44778,39,2351,652,304,544,16,6,88,668,6,89,51,101,95,152,591,998,3,3399,188,0,2,1,1,0
44779,35,1623,1293,570,1093,25,15,163,1318,10,195,123,241,205,364,1516,2795,6,17273,959,0,2,1,1,0
44781,81,3468,1289,550,1043,56,32,155,1345,10,167,93,185,177,278,1266,2075,5,11498,638,0,2,5,5,0
44782,16,677,722,423,573,19,0,135,741,12,172,101,199,184,300,1320,2257,6,15668,870,0,2,1,1,1
44783,39,2342,652,304,544,16,6,88,668,6,89,51,101,95,152,591,998,3,3399,188,0,2,1,5,0
44784,100,2053,773,419,590,28,0,166,801,10,204,113,217,214,330,1598,2554,5,13587,754,0,2,5,9,0
44785,100,2053,421,273,302,44,34,57,465,17,81,59,107,98,166,583,1098,11,12329,684,0,2,5,9,0
44786,167,5072,1660,832,1314,41,38,274,1701,20,312,209,395,332,604,2671,5058,12,64042,3557,1,2,2,3,0
44787,167,5072,1057,646,719,113,100,145,1170,18,215,134,248,233,382,1740,3004,10,31186,1732,1,2,2,3,0
44788,87,2883,773,419,590,28,0,166,801,10,204,113,217,214,330,1598,2554,5,13587,754,0,2,2,5,0
44789,86,1796,477,336,357,30,23,73,507,16,194,134,250,210,384,1538,2962,10,30538,1696,0,2,1,5,1
44790,86,1788,477,336,357,30,23,73,507,16,194,134,250,210,384,1538,2962,10,30538,1696,0,2,1,1,0
44795,86,1788,477,336,357,30,23,73,507,16,194,134,250,210,384,1538,2962,10,30538,1696,0,2,2,6,0
44797,214,5106,722,423,573,19,0,135,741,12,172,101,199,184,300,1320,2257,6,15668,870,0,2,161,169,0
44798,214,5106,1508,847,911,44,250,301,1552,14,148,88,169,162,257,1120,1886,7,15077,837,0,2,161,169,0
44799,81,3468,1289,550,1043,56,32,155,1345,10,167,93,185,177,278,1266,2075,5,11498,638,0,2,9,9,0
44800,39,2342,652,304,544,16,6,88,668,6,89,51,101,95,152,591,998,3,3399,188,0,2,2,6,0
44802,16,677,722,423,573,19,0,135,741,12,172,101,199,184,300,1320,2257,6,15668,870,0,2,1,1,0
44815,87,3752,1289,550,1043,56,32,155,1345,10,167,93,185,177,278,1266,2075,5,11498,638,0,2,3,3,0
44816,193,4386,77,34,69,0,0,8,77,3,24,16,29,27,45,114,213,1,387,21,0,2,43,20,0
44817,193,4386,712,438,573,51,9,84,763,14,102,71,128,116,199,733,1364,8,11988,666,0,2,43,20,0
44818,193,4386,77,34,69,0,0,8,77,3,24,16,29,27,45,114,213,1,387,21,0,2,40,38,0
44819,193,4386,712,438,573,51,9,84,763,14,102,71,128,116,199,733,1364,8,11988,666,0,2,40,38,0
44820,50,586,647,139,84,35,284,233,682,0,0,0,0,0,0,0,0,0,0,0,0,2,95,30,1
44821,167,5087,1660,832,1314,41,38,274,1701,20,312,209,395,332,604,2671,5058,12,64042,3557,1,2,8,6,1
44822,167,5087,1057,646,719,113,100,145,1170,18,215,134,248,233,382,1740,3004,10,31186,1732,1,2,8,6,1
44823,214,5106,722,423,573,19,0,135,741,12,172,101,199,184,300,1320,2257,6,15668,870,0,2,1,1,1
44824,214,5106,1508,847,911,44,250,301,1552,14,148,88,169,162,257,1120,1886,7,15077,837,0,2,1,1,1
44825,156,4422,1660,832,1314,41,38,274,1701,20,312,209,395,332,604,2671,5058,12,64042,3557,1,2,10,0,1
44826,167,5085,1660,832,1314,41,38,274,1701,20,312,209,395,332,604,2671,5058,12,64042,3557,1,2,3,2,0
44827,167,5085,1057,646,719,113,100,145,1170,18,215,134,248,233,382,1740,3004,10,31186,1732,1,2,3,2,0
44829,167,5085,1660,832,1314,41,38,274,1701,20,312,209,395,332,604,2671,5058,12,64042,3557,1,2,9,6,0
44830,167,5085,1057,646,719,113,100,145,1170,18,215,134,248,233,382,1740,3004,10,31186,1732,1,2,9,6,0
44831,214,5106,722,423,573,19,0,135,741,12,172,101,199,184,300,1320,2257,6,15668,870,0,2,1,1,0
44832,214,5106,1508,847,911,44,250,301,1552,14,148,88,169,162,257,1120,1886,7,15077,837,0,2,1,1,0
44833,156,4422,1660,832,1314,41,38,274,1701,20,312,209,395,332,604,2671,5058,12,64042,3557,1,2,10,0,0
44834,50,586,647,139,84,35,284,233,682,0,0,0,0,0,0,0,0,0,0,0,0,2,95,30,0
44835,193,4386,77,34,69,0,0,8,77,3,24,16,29,27,45,114,213,1,387,21,0,2,47,3,0
44836,193,4386,712,438,573,51,9,84,763,14,102,71,128,116,199,733,1364,8,11988,666,0,2,47,3,0
44837,87,3748,1289,550,1043,56,32,155,1345,10,167,93,185,177,278,1266,2075,5,11498,638,0,2,65,0,0
44838,45,1258,773,422,505,30,103,129,803,14,77,46,83,91,129,535,839,7,6334,351,0,2,8,9,0
44839,231,5261,4293,999,3693,19,54,507,4312,9,155,88,170,164,258,1156,1898,4,9368,520,0,2,10,7,0
44840,231,5261,1482,859,1002,125,135,219,1607,16,219,134,251,235,385,1766,3032,9,27804,1544,1,2,10,7,0
44841,88,3778,1289,550,1043,56,32,155,1345,10,167,93,185,177,278,1266,2075,5,11498,638,0,2,43,0,0
44846,89,3806,1289,550,1043,56,32,155,1345,10,167,93,185,177,278,1266,2075,5,11498,638,0,2,7,0,0
44847,204,4292,1943,715,1694,26,18,214,1969,12,185,120,237,197,357,1436,2721,7,20915,1161,0,2,2,1,0
44848,204,4292,1168,838,957,57,25,144,1225,19,348,224,416,367,640,3018,5452,11,61921,3440,1,2,2,1,0
44849,83,4156,1943,715,1694,26,18,214,1969,12,185,120,237,197,357,1436,2721,7,20915,1161,0,2,8,0,0
44855,45,1258,773,422,505,30,103,129,803,14,77,46,83,91,129,535,839,7,6334,351,0,2,16,27,0
44862,88,3778,1289,550,1043,56,32,155,1345,10,167,93,185,177,278,1266,2075,5,11498,638,0,2,108,0,0
44865,90,3836,1289,550,1043,56,32,155,1345,10,167,93,185,177,278,1266,2075,5,11498,638,0,2,7,0,0
44866,51,1398,773,422,505,30,103,129,803,14,77,46,83,91,129,535,839,7,6334,351,0,2,35,7,0
44867,221,5235,722,423,573,19,0,135,741,12,172,101,199,184,300,1320,2257,6,15668,870,0,2,46,21,1
44868,221,5235,1508,847,911,44,250,301,1552,14,148,88,169,162,257,1120,1886,7,15077,837,0,2,46,21,1
44869,222,5253,722,423,573,19,0,135,741,12,172,101,199,184,300,1320,2257,6,15668,870,0,2,52,39,1
44870,222,5253,1508,847,911,44,250,301,1552,14,148,88,169,162,257,1120,1886,7,15077,837,0,2,52,39,1
44871,88,3790,1289,550,1043,56,32,155,1345,10,167,93,185,177,278,1266,2075,5,11498,638,0,2,3,3,1
44872,11,423,75,38,59,1,3,12,76,2,4,2,4,6,6,10,15,1,15,0,0,2,0,1,1
44873,45,2193,722,423,573,19,0,135,741,12,172,101,199,184,300,1320,2257,6,15668,870,0,2,238,9,1
44874,52,1417,773,422,505,30,103,129,803,14,77,46,83,91,129,535,839,7,6334,351,0,2,15,9,0
44875,51,1398,773,422,505,30,103,129,803,14,77,46,83,91,129,535,839,7,6334,351,0,2,9,15,0
44876,45,1258,773,422,505,30,103,129,803,14,77,46,83,91,129,535,839,7,6334,351,0,2,7,35,0
44877,45,1258,773,422,505,30,103,129,803,14,77,46,83,91,129,535,839,7,6334,351,0,2,7,41,0
44878,231,5265,4293,999,3693,19,54,507,4312,9,155,88,170,164,258,1156,1898,4,9368,520,0,2,2,1,1
44879,231,5265,1482,859,1002,125,135,219,1607,16,219,134,251,235,385,1766,3032,9,27804,1544,1,2,2,1,1
44880,50,586,647,139,84,35,284,233,682,0,0,0,0,0,0,0,0,0,0,0,0,2,1,1,1
44881,117,2801,77,34,69,0,0,8,77,3,24,16,29,27,45,114,213,1,387,21,0,2,8,362,1
44882,117,2801,712,438,573,51,9,84,763,14,102,71,128,116,199,733,1364,8,11988,666,0,2,8,362,1
44883,80,1686,53,23,39,0,0,13,53,2,8,4,8,10,12,26,39,1,39,2,0,2,361,0,1
44884,80,1686,515,298,307,33,80,99,548,12,63,44,77,75,121,419,753,7,5527,307,0,2,361,0,1
44885,259,6096,72,33,56,0,4,12,72,1,1,1,1,2,2,0,2,0,1,0,0,2,4,4,1
44886,259,6096,1454,835,1044,76,110,219,1530,17,275,158,296,292,454,2297,3718,9,34017,1889,1,2,4,4,1
44887,97,4426,1338,495,1086,10,64,173,1348,11,122,82,157,133,239,883,1686,7,11934,663,0,2,2,5,1
44889,79,1686,53,23,39,0,0,13,53,2,8,4,8,10,12,26,39,1,39,2,0,2,5,3,0
44890,79,1686,515,298,307,33,80,99,548,12,63,44,77,75,121,419,753,7,5527,307,0,2,5,3,0
44891,215,5118,722,423,573,19,0,135,741,12,172,101,199,184,300,1320,2257,6,15668,870,0,2,7,0,0
44892,215,5118,1508,847,911,44,250,301,1552,14,148,88,169,162,257,1120,1886,7,15077,837,0,2,7,0,0
44893,222,5253,722,423,573,19,0,135,741,12,172,101,199,184,300,1320,2257,6,15668,870,0,2,97,59,0
44894,222,5253,1508,847,911,44,250,301,1552,14,148,88,169,162,257,1120,1886,7,15077,837,0,2,97,59,0
44895,88,3790,1289,550,1043,56,32,155,1345,10,167,93,185,177,278,1266,2075,5,11498,638,0,2,3,3,0
44896,11,423,75,38,59,1,3,12,76,2,4,2,4,6,6,10,15,1,15,0,0,2,0,1,0
44897,45,2193,722,423,573,19,0,135,741,12,172,101,199,184,300,1320,2257,6,15668,870,0,2,238,9,0
44898,231,5265,4293,999,3693,19,54,507,4312,9,155,88,170,164,258,1156,1898,4,9368,520,0,2,2,1,0
44899,231,5265,1482,859,1002,125,135,219,1607,16,219,134,251,235,385,1766,3032,9,27804,1544,1,2,2,1,0
44901,117,2801,77,34,69,0,0,8,77,3,24,16,29,27,45,114,213,1,387,21,0,2,8,362,0
44902,117,2801,712,438,573,51,9,84,763,14,102,71,128,116,199,733,1364,8,11988,666,0,2,8,362,0
44903,79,1686,53,23,39,0,0,13,53,2,8,4,8,10,12,26,39,1,39,2,0,2,363,0,0
44904,79,1686,515,298,307,33,80,99,548,12,63,44,77,75,121,419,753,7,5527,307,0,2,363,0,0
44905,259,6096,72,33,56,0,4,12,72,1,1,1,1,2,2,0,2,0,1,0,0,2,4,4,0
44906,259,6096,1454,835,1044,76,110,219,1530,17,275,158,296,292,454,2297,3718,9,34017,1889,1,2,4,4,0
44907,97,4426,1338,495,1086,10,64,173,1348,11,122,82,157,133,239,883,1686,7,11934,663,0,2,2,5,0
44911,147,6933,1392,870,1177,35,17,170,1427,14,494,280,531,508,811,4473,7289,7,54850,3047,2,2,1,1,0
44912,75,2972,1043,504,840,53,9,147,1096,9,180,112,198,189,310,1377,2344,4,11604,644,0,2,2,2,0
44913,74,3124,1178,367,1042,6,15,115,1184,9,94,51,95,103,146,644,976,4,4439,246,0,2,1,1,0
44917,108,2071,1178,367,1042,6,15,115,1184,9,94,51,95,103,146,644,976,4,4439,246,0,2,1,1,0
44918,108,2071,177,108,140,8,0,27,185,6,30,16,32,36,48,162,248,3,794,44,0,2,1,1,0
44919,50,586,647,139,84,35,284,233,682,0,0,0,0,0,0,0,0,0,0,0,0,2,13,2,0
44922,258,6107,72,33,56,0,4,12,72,1,1,1,1,2,2,0,2,0,1,0,0,2,14,7,0
44923,258,6107,1454,835,1044,76,110,219,1530,17,275,158,296,292,454,2297,3718,9,34017,1889,1,2,14,7,0
44924,15,466,42,7,35,4,0,5,46,1,2,1,2,3,3,2,4,0,2,0,0,2,21,6,0
44925,15,466,11,6,10,0,0,1,11,2,4,2,4,6,6,10,15,1,15,0,0,2,21,6,0
44930,223,5265,722,423,573,19,0,135,741,12,172,101,199,184,300,1320,2257,6,15668,870,0,2,7,0,0
44931,223,5265,1508,847,911,44,250,301,1552,14,148,88,169,162,257,1120,1886,7,15077,837,0,2,7,0,0
44932,259,6114,72,33,56,0,4,12,72,1,1,1,1,2,2,0,2,0,1,0,0,2,14,7,0
44933,259,6114,1454,835,1044,76,110,219,1530,17,275,158,296,292,454,2297,3718,9,34017,1889,1,2,14,7,0
44938,90,3848,1289,550,1043,56,32,155,1345,10,167,93,185,177,278,1266,2075,5,11498,638,0,2,7,0,0
44942,214,4584,182,127,129,0,0,53,182,5,39,21,42,44,63,217,343,2,926,51,0,2,6,4,1
44943,214,4584,1165,710,800,67,119,181,1232,18,243,153,282,261,435,2000,3492,10,36473,2026,1,2,6,4,1
44944,100,2037,773,419,590,28,0,166,801,10,204,113,217,214,330,1598,2554,5,13587,754,0,2,4,4,1
44945,100,2037,421,273,302,44,34,57,465,17,81,59,107,98,166,583,1098,11,12329,684,0,2,4,4,1
44946,60,1084,282,196,195,3,0,86,285,8,130,71,141,138,212,936,1507,4,6538,363,0,2,2,2,1
44947,17,384,85,59,61,8,0,16,93,5,18,10,18,23,28,86,126,2,316,17,0,2,0,1,1
44948,90,3814,1289,550,1043,56,32,155,1345,10,167,93,185,177,278,1266,2075,5,11498,638,0,2,7,6,1
44949,147,6905,1392,870,1177,35,17,170,1427,14,494,280,531,508,811,4473,7289,7,54850,3047,2,2,10,8,1
44950,87,2871,773,419,590,28,0,166,801,10,204,113,217,214,330,1598,2554,5,13587,754,0,2,4,4,1
44951,97,4414,1338,495,1086,10,64,173,1348,11,122,82,157,133,239,883,1686,7,11934,663,0,2,2,3,1
44952,132,5730,1782,648,1425,9,47,279,1791,8,171,97,189,179,286,1292,2140,4,9462,525,0,2,2,2,1
44953,23,577,102,59,69,5,3,24,107,6,22,15,28,28,43,113,206,3,789,43,0,2,10,9,1
44954,156,4416,1660,832,1314,41,38,274,1701,20,312,209,395,332,604,2671,5058,12,64042,3557,1,2,3,2,1
44955,73,3804,1296,573,1062,40,33,157,1336,8,201,118,231,209,349,1561,2689,4,12365,686,0,2,10,9,1
44956,82,4295,1457,730,1242,11,6,188,1468,10,292,166,329,302,495,2424,4078,5,22973,1276,1,2,5,5,1
44957,39,2324,652,304,544,16,6,88,668,6,89,51,101,95,152,591,998,3,3399,188,0,2,3,3,1
44958,38,2301,334,251,279,10,4,40,344,5,127,74,143,132,217,899,1528,2,4303,239,0,2,2,1,1
44959,33,1886,384,251,317,7,8,52,391,11,70,44,84,81,128,467,811,6,5355,297,0,2,11,9,1
44960,39,1724,386,256,301,16,9,68,402,4,59,35,69,63,104,355,621,2,1453,80,0,2,14,15,1
44961,75,2952,1043,504,840,53,9,147,1096,9,180,112,198,189,310,1377,2344,4,11604,644,0,2,10,8,1
44962,82,4108,1943,715,1694,26,18,214,1969,12,185,120,237,197,357,1436,2721,7,20915,1161,0,2,3,3,1
44963,51,595,647,139,84,35,284,233,682,0,0,0,0,0,0,0,0,0,0,0,0,2,20,2,1
44964,111,2482,1043,504,840,53,9,147,1096,9,180,112,198,189,310,1377,2344,4,11604,644,0,2,3,0,1
44965,111,2482,383,288,292,26,6,62,409,11,65,38,67,76,105,429,656,5,3719,206,0,2,3,0,1
44966,78,3035,1043,504,840,53,9,147,1096,9,180,112,198,189,310,1377,2344,4,11604,644,0,2,12,0,1
44967,214,4584,182,127,129,0,0,53,182,5,39,21,42,44,63,217,343,2,926,51,0,2,6,4,0
44968,214,4584,1165,710,800,67,119,181,1232,18,243,153,282,261,435,2000,3492,10,36473,2026,1,2,6,4,0
44969,100,2037,773,419,590,28,0,166,801,10,204,113,217,214,330,1598,2554,5,13587,754,0,2,4,4,0
44970,100,2037,421,273,302,44,34,57,465,17,81,59,107,98,166,583,1098,11,12329,684,0,2,4,4,0
44971,60,1084,282,196,195,3,0,86,285,8,130,71,141,138,212,936,1507,4,6538,363,0,2,2,2,0
44972,17,384,85,59,61,8,0,16,93,5,18,10,18,23,28,86,126,2,316,17,0,2,0,1,0
44973,90,3814,1289,550,1043,56,32,155,1345,10,167,93,185,177,278,1266,2075,5,11498,638,0,2,7,6,0
44974,147,6905,1392,870,1177,35,17,170,1427,14,494,280,531,508,811,4473,7289,7,54850,3047,2,2,10,8,0
44975,87,2871,773,419,590,28,0,166,801,10,204,113,217,214,330,1598,2554,5,13587,754,0,2,4,4,0
44976,97,4414,1338,495,1086,10,64,173,1348,11,122,82,157,133,239,883,1686,7,11934,663,0,2,2,3,0
44977,132,5730,1782,648,1425,9,47,279,1791,8,171,97,189,179,286,1292,2140,4,9462,525,0,2,2,2,0
44978,23,577,102,59,69,5,3,24,107,6,22,15,28,28,43,113,206,3,789,43,0,2,10,9,0
44979,156,4416,1660,832,1314,41,38,274,1701,20,312,209,395,332,604,2671,5058,12,64042,3557,1,2,3,2,0
44980,73,3804,1296,573,1062,40,33,157,1336,8,201,118,231,209,349,1561,2689,4,12365,686,0,2,10,9,0
44981,82,4295,1457,730,1242,11,6,188,1468,10,292,166,329,302,495,2424,4078,5,22973,1276,1,2,5,5,0
44982,39,2324,652,304,544,16,6,88,668,6,89,51,101,95,152,591,998,3,3399,188,0,2,3,3,0
44983,38,2301,334,251,279,10,4,40,344,5,127,74,143,132,217,899,1528,2,4303,239,0,2,2,1,0
44984,33,1886,384,251,317,7,8,52,391,11,70,44,84,81,128,467,811,6,5355,297,0,2,11,9,0
44985,39,1724,386,256,301,16,9,68,402,4,59,35,69,63,104,355,621,2,1453,80,0,2,14,15,0
44986,75,2952,1043,504,840,53,9,147,1096,9,180,112,198,189,310,1377,2344,4,11604,644,0,2,10,8,0
44987,82,4108,1943,715,1694,26,18,214,1969,12,185,120,237,197,357,1436,2721,7,20915,1161,0,2,3,3,0
44988,51,595,647,139,84,35,284,233,682,0,0,0,0,0,0,0,0,0,0,0,0,2,20,2,0
44989,111,2482,1043,504,840,53,9,147,1096,9,180,112,198,189,310,1377,2344,4,11604,644,0,2,3,0,0
44990,111,2482,383,288,292,26,6,62,409,11,65,38,67,76,105,429,656,5,3719,206,0,2,3,0,0
44991,78,3035,1043,504,840,53,9,147,1096,9,180,112,198,189,310,1377,2344,4,11604,644,0,2,12,0,0
44993,227,5227,4293,999,3693,19,54,507,4312,9,155,88,170,164,258,1156,1898,4,9368,520,0,2,42,48,1
44994,227,5227,1482,859,1002,125,135,219,1607,16,219,134,251,235,385,1766,3032,9,27804,1544,1,2,42,48,1
44995,230,5249,4293,999,3693,19,54,507,4312,9,155,88,170,164,258,1156,1898,4,9368,520,0,2,12,17,1
44996,230,5249,1482,859,1002,125,135,219,1607,16,219,134,251,235,385,1766,3032,9,27804,1544,1,2,12,17,1
44997,206,4323,1943,715,1694,26,18,214,1969,12,185,120,237,197,357,1436,2721,7,20915,1161,0,2,18,21,1
44998,206,4323,1168,838,957,57,25,144,1225,19,348,224,416,367,640,3018,5452,11,61921,3440,1,2,18,21,1
44999,90,4382,1943,715,1694,26,18,214,1969,12,185,120,237,197,357,1436,2721,7,20915,1161,0,2,81,6,1
45000,207,4339,1943,715,1694,26,18,214,1969,12,185,120,237,197,357,1436,2721,7,20915,1161,0,2,11,2,0
45001,207,4339,1168,838,957,57,25,144,1225,19,348,224,416,367,640,3018,5452,11,61921,3440,1,2,11,2,0
45002,207,4339,1943,715,1694,26,18,214,1969,12,185,120,237,197,357,1436,2721,7,20915,1161,0,2,27,21,0
45003,207,4339,1168,838,957,57,25,144,1225,19,348,224,416,367,640,3018,5452,11,61921,3440,1,2,27,21,0
45004,90,4382,1943,715,1694,26,18,214,1969,12,185,120,237,197,357,1436,2721,7,20915,1161,0,2,81,6,0
45005,34,1617,1293,570,1093,25,15,163,1318,10,195,123,241,205,364,1516,2795,6,17273,959,0,2,1,2,0
45006,103,2142,1020,354,843,12,15,144,1032,8,134,77,144,142,221,970,1580,4,6792,377,0,2,13,1,1
45007,77,3417,1020,354,843,12,15,144,1032,8,134,77,144,142,221,970,1580,4,6792,377,0,2,15,0,1
45008,104,2098,1020,354,843,12,15,144,1032,8,134,77,144,142,221,970,1580,4,6792,377,0,2,5,7,1
45009,104,2104,1020,354,843,12,15,144,1032,8,134,77,144,142,221,970,1580,4,6792,377,0,2,4,2,0
45010,77,3416,1020,354,843,12,15,144,1032,8,134,77,144,142,221,970,1580,4,6792,377,0,2,3,3,0
45011,348,6977,1457,730,1242,11,6,188,1468,10,292,166,329,302,495,2424,4078,5,22973,1276,1,2,2,1,0
45012,348,6977,74,35,59,1,0,14,75,3,14,7,14,17,21,58,85,1,128,7,0,2,2,1,0
45013,348,6977,245,125,200,5,7,34,250,7,30,17,34,37,51,166,265,3,1053,58,0,2,2,1,0
45017,104,2104,1020,354,843,12,15,144,1032,8,134,77,144,142,221,970,1580,4,6792,377,0,2,13,1,0
45018,77,3416,1020,354,843,12,15,144,1032,8,134,77,144,142,221,970,1580,4,6792,377,0,2,15,0,0
45019,120,2925,77,34,69,0,0,8,77,3,24,16,29,27,45,114,213,1,387,21,0,2,19,0,1
45020,120,2925,712,438,573,51,9,84,763,14,102,71,128,116,199,733,1364,8,11988,666,0,2,19,0,1
45021,28,1220,373,158,315,8,0,51,381,5,76,44,79,81,123,486,779,2,2026,112,0,2,32,0,1
45022,28,1210,373,158,315,8,0,51,381,5,76,44,79,81,123,486,779,2,2026,112,0,2,0,1,0
45023,48,1310,773,422,505,30,103,129,803,14,77,46,83,91,129,535,839,7,6334,351,0,2,12,0,0
45024,12,489,139,89,101,2,0,35,141,7,54,34,62,61,96,330,569,4,2287,127,0,2,21,0,0
45027,50,1354,773,422,505,30,103,129,803,14,77,46,83,91,129,535,839,7,6334,351,0,2,28,18,1
45028,24,1115,1157,318,931,29,22,177,1186,6,104,63,125,110,188,712,1274,3,4596,255,0,2,29,0,1
45029,50,1361,773,422,505,30,103,129,803,14,77,46,83,91,129,535,839,7,6334,351,0,2,15,17,1
45030,23,1137,1157,318,931,29,22,177,1186,6,104,63,125,110,188,712,1274,3,4596,255,0,2,20,15,1
45031,51,1412,773,422,505,30,103,129,803,14,77,46,83,91,129,535,839,7,6334,351,0,2,28,12,0
45032,13,565,139,89,101,2,0,35,141,7,54,34,62,61,96,330,569,4,2287,127,0,2,28,0,0
45033,53,1452,773,422,505,30,103,129,803,14,77,46,83,91,129,535,839,7,6334,351,0,2,26,19,1
45034,23,1145,1157,318,931,29,22,177,1186,6,104,63,125,110,188,712,1274,3,4596,255,0,2,18,14,1
45035,53,1452,773,422,505,30,103,129,803,14,77,46,83,91,129,535,839,7,6334,351,0,2,1,0,0
45036,23,1101,1157,318,931,29,22,177,1186,6,104,63,125,110,188,712,1274,3,4596,255,0,2,5,19,0
45037,57,1539,773,422,505,30,103,129,803,14,77,46,83,91,129,535,839,7,6334,351,0,2,23,1,0
45038,23,1108,1157,318,931,29,22,177,1186,6,104,63,125,110,188,712,1274,3,4596,255,0,2,6,1,0
45039,57,1539,773,422,505,30,103,129,803,14,77,46,83,91,129,535,839,7,6334,351,0,2,11,24,0
45040,17,1072,1157,318,931,29,22,177,1186,6,104,63,125,110,188,712,1274,3,4596,255,0,2,3,18,0
45041,63,1639,773,422,505,30,103,129,803,14,77,46,83,91,129,535,839,7,6334,351,0,2,32,8,1
45042,24,1310,1157,318,931,29,22,177,1186,6,104,63,125,110,188,712,1274,3,4596,255,0,2,85,0,1
45043,23,1297,1157,318,931,29,22,177,1186,6,104,63,125,110,188,712,1274,3,4596,255,0,2,2,9,0
45044,13,571,139,89,101,2,0,35,141,7,54,34,62,61,96,330,569,4,2287,127,0,2,1,0,0
45045,63,1639,773,422,505,30,103,129,803,14,77,46,83,91,129,535,839,7,6334,351,0,2,3,1,0
45046,352,7047,1457,730,1242,11,6,188,1468,10,292,166,329,302,495,2424,4078,5,22973,1276,1,2,11,2,1
45047,352,7047,74,35,59,1,0,14,75,3,14,7,14,17,21,58,85,1,128,7,0,2,11,2,1
45048,352,7047,245,125,200,5,7,34,250,7,30,17,34,37,51,166,265,3,1053,58,0,2,11,2,1
45049,117,2821,77,34,69,0,0,8,77,3,24,16,29,27,45,114,213,1,387,21,0,2,1,14,1
45050,117,2821,712,438,573,51,9,84,763,14,102,71,128,116,199,733,1364,8,11988,666,0,2,1,14,1
45051,27,1108,373,158,315,8,0,51,381,5,76,44,79,81,123,486,779,2,2026,112,0,2,0,18,1
45052,50,586,647,139,84,35,284,233,682,0,0,0,0,0,0,0,0,0,0,0,0,2,9,1,0
45053,50,586,647,139,84,35,284,233,682,0,0,0,0,0,0,0,0,0,0,0,0,2,20,1,0
45056,67,1738,773,422,505,30,103,129,803,14,77,46,83,91,129,535,839,7,6334,351,0,2,17,7,0
45057,25,1443,1157,318,931,29,22,177,1186,6,104,63,125,110,188,712,1274,3,4596,255,0,2,62,8,0
45058,87,2475,1523,757,1297,19,12,193,1542,12,193,117,230,205,347,1508,2664,7,19053,1058,0,2,26,0,1
45059,87,2475,701,378,504,33,58,109,734,13,110,68,126,123,194,794,1346,7,10027,557,0,2,26,0,1
45060,91,4494,1523,757,1297,19,12,193,1542,12,193,117,230,205,347,1508,2664,7,19053,1058,0,2,21,0,1
45061,69,1729,773,422,505,30,103,129,803,14,77,46,83,91,129,535,839,7,6334,351,0,2,12,9,0
45062,25,1433,1157,318,931,29,22,177,1186,6,104,63,125,110,188,712,1274,3,4596,255,0,2,1,4,0
45063,25,1432,1157,318,931,29,22,177,1186,6,104,63,125,110,188,712,1274,3,4596,255,0,2,2,2,0
45064,68,1718,773,422,505,30,103,129,803,14,77,46,83,91,129,535,839,7,6334,351,0,2,1,2,0
45066,68,1718,773,422,505,30,103,129,803,14,77,46,83,91,129,535,839,7,6334,351,0,2,1,1,0
45068,349,6987,1457,730,1242,11,6,188,1468,10,292,166,329,302,495,2424,4078,5,22973,1276,1,2,4,1,0
45069,349,6987,74,35,59,1,0,14,75,3,14,7,14,17,21,58,85,1,128,7,0,2,4,1,0
45070,349,6987,245,125,200,5,7,34,250,7,30,17,34,37,51,166,265,3,1053,58,0,2,4,1,0
45071,84,4398,1457,730,1242,11,6,188,1468,10,292,166,329,302,495,2424,4078,5,22973,1276,1,2,37,0,0
45072,83,4348,1457,730,1242,11,6,188,1468,10,292,166,329,302,495,2424,4078,5,22973,1276,1,2,8,36,0
45073,83,4374,1457,730,1242,11,6,188,1468,10,292,166,329,302,495,2424,4078,5,22973,1276,1,2,9,4,0
45074,347,6972,1457,730,1242,11,6,188,1468,10,292,166,329,302,495,2424,4078,5,22973,1276,1,2,8,12,1
45075,347,6972,74,35,59,1,0,14,75,3,14,7,14,17,21,58,85,1,128,7,0,2,8,12,1
45076,347,6972,245,125,200,5,7,34,250,7,30,17,34,37,51,166,265,3,1053,58,0,2,8,12,1
45077,27,950,74,35,59,1,0,14,75,3,14,7,14,17,21,58,85,1,128,7,0,2,2,2,1
45078,27,950,245,125,200,5,7,34,250,7,30,17,34,37,51,166,265,3,1053,58,0,2,2,2,1
45079,84,4416,1457,730,1242,11,6,188,1468,10,292,166,329,302,495,2424,4078,5,22973,1276,1,2,36,16,1
45080,11,238,19,8,11,5,0,4,24,2,5,3,6,7,9,13,25,1,30,1,0,2,1,1,1
45081,11,238,102,59,69,5,3,24,107,6,22,15,28,28,43,113,206,3,789,43,0,2,1,1,1
45082,11,238,106,40,36,3,49,17,109,8,17,13,23,25,36,93,167,5,904,50,0,2,1,1,1
45085,26,527,2,2,2,0,0,0,2,0,0,0,0,0,0,0,0,0,0,0,0,2,1,1,1
45099,26,527,99,48,90,1,3,5,100,0,0,0,0,0,0,0,0,0,0,0,0,2,1,1,1
45100,26,527,8,5,5,2,0,1,10,0,0,0,0,0,0,0,0,0,0,0,0,2,1,1,1
45101,26,527,1217,716,841,84,126,174,1301,14,185,118,215,199,333,1446,2542,8,20687,1149,0,2,1,1,1
45102,26,527,160,89,115,0,13,31,160,7,15,11,17,22,28,78,124,3,495,27,0,2,1,1,1
45103,26,527,10,10,9,9,0,0,19,0,0,0,0,0,0,0,0,0,0,0,0,2,1,1,1
45104,26,527,173,84,99,8,29,36,181,5,12,7,13,17,20,54,81,2,221,12,0,2,1,1,1
45105,26,527,3,1,1,3,0,0,6,0,0,0,0,0,0,0,0,0,0,0,0,2,1,1,1
45106,59,1355,996,429,845,24,10,117,1020,7,76,50,88,83,138,494,879,4,3565,198,0,2,1,1,1
45107,59,1355,456,277,329,12,42,72,468,13,85,50,97,98,147,592,972,7,7212,400,0,2,1,1,1
45108,141,2977,1513,682,1277,25,13,200,1538,11,199,116,219,210,335,1557,2584,6,15641,868,0,2,6,6,1
45109,141,2977,819,519,539,24,98,155,843,15,96,57,106,111,163,690,1107,8,9171,509,0,2,6,6,1
45110,348,6992,1457,730,1242,11,6,188,1468,10,292,166,329,302,495,2424,4078,5,22973,1276,1,2,5,5,1
45111,348,6992,74,35,59,1,0,14,75,3,14,7,14,17,21,58,85,1,128,7,0,2,5,5,1
45112,348,6992,245,125,200,5,7,34,250,7,30,17,34,37,51,166,265,3,1053,58,0,2,5,5,1
45113,21,668,339,213,244,17,9,65,356,10,42,26,48,52,74,259,421,5,2410,133,0,2,2,2,1
45114,231,5277,4293,999,3693,19,54,507,4312,9,155,88,170,164,258,1156,1898,4,9368,520,0,2,4,4,1
45115,231,5277,1482,859,1002,125,135,219,1607,16,219,134,251,235,385,1766,3032,9,27804,1544,1,2,4,4,1
45116,117,2804,77,34,69,0,0,8,77,3,24,16,29,27,45,114,213,1,387,21,0,2,1,1,1
45117,117,2804,712,438,573,51,9,84,763,14,102,71,128,116,199,733,1364,8,11988,666,0,2,1,1,1
45118,104,2107,1020,354,843,12,15,144,1032,8,134,77,144,142,221,970,1580,4,6792,377,0,2,1,1,1
45119,46,963,447,308,343,6,5,95,453,7,96,59,111,103,170,651,1136,4,4600,255,0,2,2,2,1
45120,46,963,322,174,179,16,74,51,338,10,41,26,46,51,72,252,408,5,2291,127,0,2,2,2,1
45121,223,5307,722,423,573,19,0,135,741,12,172,101,199,184,300,1320,2257,6,15668,870,0,2,14,14,1
45122,223,5307,1508,847,911,44,250,301,1552,14,148,88,169,162,257,1120,1886,7,15077,837,0,2,14,14,1
45123,111,2485,1043,504,840,53,9,147,1096,9,180,112,198,189,310,1377,2344,4,11604,644,0,2,1,1,1
45124,111,2485,383,288,292,26,6,62,409,11,65,38,67,76,105,429,656,5,3719,206,0,2,1,1,1
45125,207,4345,1943,715,1694,26,18,214,1969,12,185,120,237,197,357,1436,2721,7,20915,1161,0,2,2,2,1
45126,207,4345,1168,838,957,57,25,144,1225,19,348,224,416,367,640,3018,5452,11,61921,3440,1,2,2,2,1
45127,16,480,442,244,305,14,16,103,456,11,68,45,75,79,120,452,756,6,4588,254,0,2,1,1,1
45128,16,480,182,102,99,11,40,35,193,3,11,6,11,14,17,42,64,1,97,5,0,2,1,1,1
45129,90,3848,1289,550,1043,56,32,155,1345,10,167,93,185,177,278,1266,2075,5,11498,638,0,2,1,1,1
45130,97,4426,1338,495,1086,10,64,173,1348,11,122,82,157,133,239,883,1686,7,11934,663,0,2,2,2,1
45131,162,7134,139,89,101,2,0,35,141,7,54,34,62,61,96,330,569,4,2287,127,0,2,1,1,1
45132,162,7134,7,5,5,0,0,2,7,1,2,1,2,3,3,2,4,0,2,0,0,2,1,1,1
45133,135,5792,1782,648,1425,9,47,279,1791,8,171,97,189,179,286,1292,2140,4,9462,525,0,2,1,1,1
45134,128,5159,1513,682,1277,25,13,200,1538,11,199,116,219,210,335,1557,2584,6,15641,868,0,2,1,1,1
45135,45,2208,722,423,573,19,0,135,741,12,172,101,199,184,300,1320,2257,6,15668,870,0,2,5,5,1
45136,90,4388,1943,715,1694,26,18,214,1969,12,185,120,237,197,357,1436,2721,7,20915,1161,0,2,2,2,1
45137,69,1731,773,422,505,30,103,129,803,14,77,46,83,91,129,535,839,7,6334,351,0,2,15,4,0
45138,13,563,139,89,101,2,0,35,141,7,54,34,62,61,96,330,569,4,2287,127,0,2,4,4,0
45139,347,6972,1457,730,1242,11,6,188,1468,10,292,166,329,302,495,2424,4078,5,22973,1276,1,2,8,9,0
45140,347,6972,74,35,59,1,0,14,75,3,14,7,14,17,21,58,85,1,128,7,0,2,8,9,0
45141,347,6972,245,125,200,5,7,34,250,7,30,17,34,37,51,166,265,3,1053,58,0,2,8,9,0
45142,27,950,74,35,59,1,0,14,75,3,14,7,14,17,21,58,85,1,128,7,0,2,2,2,0
45143,27,950,245,125,200,5,7,34,250,7,30,17,34,37,51,166,265,3,1053,58,0,2,2,2,0
45144,84,4416,1457,730,1242,11,6,188,1468,10,292,166,329,302,495,2424,4078,5,22973,1276,1,2,39,5,0
45145,11,238,19,8,11,5,0,4,24,2,5,3,6,7,9,13,25,1,30,1,0,2,1,1,0
45146,11,238,102,59,69,5,3,24,107,6,22,15,28,28,43,113,206,3,789,43,0,2,1,1,0
45147,11,238,106,40,36,3,49,17,109,8,17,13,23,25,36,93,167,5,904,50,0,2,1,1,0
45150,26,527,2,2,2,0,0,0,2,0,0,0,0,0,0,0,0,0,0,0,0,2,1,1,0
45164,26,527,99,48,90,1,3,5,100,0,0,0,0,0,0,0,0,0,0,0,0,2,1,1,0
45165,26,527,8,5,5,2,0,1,10,0,0,0,0,0,0,0,0,0,0,0,0,2,1,1,0
45166,26,527,1217,716,841,84,126,174,1301,14,185,118,215,199,333,1446,2542,8,20687,1149,0,2,1,1,0
45167,26,527,160,89,115,0,13,31,160,7,15,11,17,22,28,78,124,3,495,27,0,2,1,1,0
45168,26,527,10,10,9,9,0,0,19,0,0,0,0,0,0,0,0,0,0,0,0,2,1,1,0
45169,26,527,173,84,99,8,29,36,181,5,12,7,13,17,20,54,81,2,221,12,0,2,1,1,0
45170,26,527,3,1,1,3,0,0,6,0,0,0,0,0,0,0,0,0,0,0,0,2,1,1,0
45171,59,1355,996,429,845,24,10,117,1020,7,76,50,88,83,138,494,879,4,3565,198,0,2,1,1,0
45172,59,1355,456,277,329,12,42,72,468,13,85,50,97,98,147,592,972,7,7212,400,0,2,1,1,0
45173,141,2977,1513,682,1277,25,13,200,1538,11,199,116,219,210,335,1557,2584,6,15641,868,0,2,6,6,0
45174,141,2977,819,519,539,24,98,155,843,15,96,57,106,111,163,690,1107,8,9171,509,0,2,6,6,0
45175,347,6987,1457,730,1242,11,6,188,1468,10,292,166,329,302,495,2424,4078,5,22973,1276,1,2,5,5,0
45176,347,6987,74,35,59,1,0,14,75,3,14,7,14,17,21,58,85,1,128,7,0,2,5,5,0
45177,347,6987,245,125,200,5,7,34,250,7,30,17,34,37,51,166,265,3,1053,58,0,2,5,5,0
45178,21,668,339,213,244,17,9,65,356,10,42,26,48,52,74,259,421,5,2410,133,0,2,2,2,0
45179,231,5277,4293,999,3693,19,54,507,4312,9,155,88,170,164,258,1156,1898,4,9368,520,0,2,4,4,0
45180,231,5277,1482,859,1002,125,135,219,1607,16,219,134,251,235,385,1766,3032,9,27804,1544,1,2,4,4,0
45181,117,2804,77,34,69,0,0,8,77,3,24,16,29,27,45,114,213,1,387,21,0,2,1,1,0
45182,117,2804,712,438,573,51,9,84,763,14,102,71,128,116,199,733,1364,8,11988,666,0,2,1,1,0
45183,104,2107,1020,354,843,12,15,144,1032,8,134,77,144,142,221,970,1580,4,6792,377,0,2,1,1,0
45184,46,963,447,308,343,6,5,95,453,7,96,59,111,103,170,651,1136,4,4600,255,0,2,2,2,0
45185,46,963,322,174,179,16,74,51,338,10,41,26,46,51,72,252,408,5,2291,127,0,2,2,2,0
45186,223,5307,722,423,573,19,0,135,741,12,172,101,199,184,300,1320,2257,6,15668,870,0,2,14,14,0
45187,223,5307,1508,847,911,44,250,301,1552,14,148,88,169,162,257,1120,1886,7,15077,837,0,2,14,14,0
45188,111,2485,1043,504,840,53,9,147,1096,9,180,112,198,189,310,1377,2344,4,11604,644,0,2,1,1,0
45189,111,2485,383,288,292,26,6,62,409,11,65,38,67,76,105,429,656,5,3719,206,0,2,1,1,0
45190,207,4345,1943,715,1694,26,18,214,1969,12,185,120,237,197,357,1436,2721,7,20915,1161,0,2,2,2,0
45191,207,4345,1168,838,957,57,25,144,1225,19,348,224,416,367,640,3018,5452,11,61921,3440,1,2,2,2,0
45192,16,480,442,244,305,14,16,103,456,11,68,45,75,79,120,452,756,6,4588,254,0,2,1,1,0
45193,16,480,182,102,99,11,40,35,193,3,11,6,11,14,17,42,64,1,97,5,0,2,1,1,0
45194,90,3848,1289,550,1043,56,32,155,1345,10,167,93,185,177,278,1266,2075,5,11498,638,0,2,1,1,0
45195,97,4426,1338,495,1086,10,64,173,1348,11,122,82,157,133,239,883,1686,7,11934,663,0,2,2,2,0
45196,162,7134,139,89,101,2,0,35,141,7,54,34,62,61,96,330,569,4,2287,127,0,2,1,1,0
45197,162,7134,7,5,5,0,0,2,7,1,2,1,2,3,3,2,4,0,2,0,0,2,1,1,0
45198,135,5792,1782,648,1425,9,47,279,1791,8,171,97,189,179,286,1292,2140,4,9462,525,0,2,1,1,0
45199,128,5159,1513,682,1277,25,13,200,1538,11,199,116,219,210,335,1557,2584,6,15641,868,0,2,1,1,0
45200,45,2208,722,423,573,19,0,135,741,12,172,101,199,184,300,1320,2257,6,15668,870,0,2,5,5,0
45201,90,4388,1943,715,1694,26,18,214,1969,12,185,120,237,197,357,1436,2721,7,20915,1161,0,2,2,2,0
45202,28,1141,373,158,315,8,0,51,381,5,76,44,79,81,123,486,779,2,2026,112,0,2,16,4,1
45203,352,7034,1457,730,1242,11,6,188,1468,10,292,166,329,302,495,2424,4078,5,22973,1276,1,2,0,1,0
45204,352,7034,74,35,59,1,0,14,75,3,14,7,14,17,21,58,85,1,128,7,0,2,0,1,0
45205,352,7034,245,125,200,5,7,34,250,7,30,17,34,37,51,166,265,3,1053,58,0,2,0,1,0
45206,59,1355,996,429,845,24,10,117,1020,7,76,50,88,83,138,494,879,4,3565,198,0,2,3,2,0
45207,59,1355,456,277,329,12,42,72,468,13,85,50,97,98,147,592,972,7,7212,400,0,2,3,2,0
45208,22,666,339,213,244,17,9,65,356,10,42,26,48,52,74,259,421,5,2410,133,0,2,11,7,0
45209,105,2128,1020,354,843,12,15,144,1032,8,134,77,144,142,221,970,1580,4,6792,377,0,2,10,5,1
45210,259,6118,72,33,56,0,4,12,72,1,1,1,1,2,2,0,2,0,1,0,0,2,1,1,1
45211,259,6118,1454,835,1044,76,110,219,1530,17,275,158,296,292,454,2297,3718,9,34017,1889,1,2,1,1,1
45212,108,2217,1020,354,843,12,15,144,1032,8,134,77,144,142,221,970,1580,4,6792,377,0,2,19,2,0
45213,82,3538,1020,354,843,12,15,144,1032,8,134,77,144,142,221,970,1580,4,6792,377,0,2,23,0,0
45214,138,5836,1782,648,1425,9,47,279,1791,8,171,97,189,179,286,1292,2140,4,9462,525,0,2,15,3,1
45215,82,3550,1020,354,843,12,15,144,1032,8,134,77,144,142,221,970,1580,4,6792,377,0,2,1,1,0
45216,69,1731,773,422,505,30,103,129,803,14,77,46,83,91,129,535,839,7,6334,351,0,2,154,64,0
45217,13,563,139,89,101,2,0,35,141,7,54,34,62,61,96,330,569,4,2287,127,0,2,33,4,0
45218,25,1432,1157,318,931,29,22,177,1186,6,104,63,125,110,188,712,1274,3,4596,255,0,2,193,50,0
45219,108,2217,1020,354,843,12,15,144,1032,8,134,77,144,142,221,970,1580,4,6792,377,0,2,2,2,0
45220,108,2217,1020,354,843,12,15,144,1032,8,134,77,144,142,221,970,1580,4,6792,377,0,2,1,1,0
45221,82,3556,1020,354,843,12,15,144,1032,8,134,77,144,142,221,970,1580,4,6792,377,0,2,3,3,0
45222,108,2218,1020,354,843,12,15,144,1032,8,134,77,144,142,221,970,1580,4,6792,377,0,2,7,6,0
45223,82,3566,1020,354,843,12,15,144,1032,8,134,77,144,142,221,970,1580,4,6792,377,0,2,6,2,0
45226,108,2218,1020,354,843,12,15,144,1032,8,134,77,144,142,221,970,1580,4,6792,377,0,2,28,5,0
45227,259,6118,72,33,56,0,4,12,72,1,1,1,1,2,2,0,2,0,1,0,0,2,1,1,0
45228,259,6118,1454,835,1044,76,110,219,1530,17,275,158,296,292,454,2297,3718,9,34017,1889,1,2,1,1,0
45229,138,5836,1782,648,1425,9,47,279,1791,8,171,97,189,179,286,1292,2140,4,9462,525,0,2,15,3,0
45230,82,3566,1020,354,843,12,15,144,1032,8,134,77,144,142,221,970,1580,4,6792,377,0,2,28,1,0
45235,51,595,647,139,84,35,284,233,682,0,0,0,0,0,0,0,0,0,0,0,0,2,42,4,0
45238,90,3826,1289,550,1043,56,32,155,1345,10,167,93,185,177,278,1266,2075,5,11498,638,0,2,7,6,0
45241,97,4416,1338,495,1086,10,64,173,1348,11,122,82,157,133,239,883,1686,7,11934,663,0,2,2,3,0
45242,138,5836,1782,648,1425,9,47,279,1791,8,171,97,189,179,286,1292,2140,4,9462,525,0,2,2,2,0
45246,84,4400,1457,730,1242,11,6,188,1468,10,292,166,329,302,495,2424,4078,5,22973,1276,1,2,5,5,0
45252,78,3015,1043,504,840,53,9,147,1096,9,180,112,198,189,310,1377,2344,4,11604,644,0,2,10,8,0
45253,90,4376,1943,715,1694,26,18,214,1969,12,185,120,237,197,357,1436,2721,7,20915,1161,0,2,3,3,0
45254,230,5261,4293,999,3693,19,54,507,4312,9,155,88,170,164,258,1156,1898,4,9368,520,0,2,36,47,0
45255,230,5261,1482,859,1002,125,135,219,1607,16,219,134,251,235,385,1766,3032,9,27804,1544,1,2,36,47,0
45256,59,1355,996,429,845,24,10,117,1020,7,76,50,88,83,138,494,879,4,3565,198,0,2,5,5,0
45257,59,1355,456,277,329,12,42,72,468,13,85,50,97,98,147,592,972,7,7212,400,0,2,5,5,0
45262,87,2475,1523,757,1297,19,12,193,1542,12,193,117,230,205,347,1508,2664,7,19053,1058,0,2,26,0,0
45263,87,2475,701,378,504,33,58,109,734,13,110,68,126,123,194,794,1346,7,10027,557,0,2,26,0,0
45264,91,4494,1523,757,1297,19,12,193,1542,12,193,117,230,205,347,1508,2664,7,19053,1058,0,2,21,0,0
45265,78,2063,773,422,505,30,103,129,803,14,77,46,83,91,129,535,839,7,6334,351,0,2,59,1,0
45266,1,135,149,67,118,4,0,27,153,1,17,14,28,18,42,69,175,0,144,8,0,0,29,0,0
45269,60,1088,282,196,195,3,0,86,285,8,130,71,141,138,212,936,1507,4,6538,363,0,2,2,0,0
45271,100,2042,1020,354,843,12,15,144,1032,8,134,77,144,142,221,970,1580,4,6792,377,0,2,1,1,0
45272,258,6111,72,33,56,0,4,12,72,1,1,1,1,2,2,0,2,0,1,0,0,2,2,2,0
45273,258,6111,1454,835,1044,76,110,219,1530,17,275,158,296,292,454,2297,3718,9,34017,1889,1,2,2,2,0
45300,59,1355,996,429,845,24,10,117,1020,7,76,50,88,83,138,494,879,4,3565,198,0,2,8,7,0
45301,59,1355,456,277,329,12,42,72,468,13,85,50,97,98,147,592,972,7,7212,400,0,2,8,7,0
45304,347,6987,1457,730,1242,11,6,188,1468,10,292,166,329,302,495,2424,4078,5,22973,1276,1,2,15,15,0
45305,347,6987,74,35,59,1,0,14,75,3,14,7,14,17,21,58,85,1,128,7,0,2,15,15,0
45306,347,6987,245,125,200,5,7,34,250,7,30,17,34,37,51,166,265,3,1053,58,0,2,15,15,0
45308,230,5261,4293,999,3693,19,54,507,4312,9,155,88,170,164,258,1156,1898,4,9368,520,0,2,42,52,0
45309,230,5261,1482,859,1002,125,135,219,1607,16,219,134,251,235,385,1766,3032,9,27804,1544,1,2,42,52,0
45312,51,595,647,139,84,35,284,233,682,0,0,0,0,0,0,0,0,0,0,0,0,2,21,3,0
45315,78,2063,773,422,505,30,103,129,803,14,77,46,83,91,129,535,839,7,6334,351,0,2,220,60,0
45316,117,2804,77,34,69,0,0,8,77,3,24,16,29,27,45,114,213,1,387,21,0,2,9,363,0
45317,117,2804,712,438,573,51,9,84,763,14,102,71,128,116,199,733,1364,8,11988,666,0,2,9,363,0
45318,108,2218,1020,354,843,12,15,144,1032,8,134,77,144,142,221,970,1580,4,6792,377,0,2,41,6,0
45323,223,5307,722,423,573,19,0,135,741,12,172,101,199,184,300,1320,2257,6,15668,870,0,2,106,68,0
45324,223,5307,1508,847,911,44,250,301,1552,14,148,88,169,162,257,1120,1886,7,15077,837,0,2,106,68,0
45325,259,6118,72,33,56,0,4,12,72,1,1,1,1,2,2,0,2,0,1,0,0,2,6,5,0
45326,259,6118,1454,835,1044,76,110,219,1530,17,275,158,296,292,454,2297,3718,9,34017,1889,1,2,6,5,0
45327,111,2485,1043,504,840,53,9,147,1096,9,180,112,198,189,310,1377,2344,4,11604,644,0,2,4,1,0
45328,111,2485,383,288,292,26,6,62,409,11,65,38,67,76,105,429,656,5,3719,206,0,2,4,1,0
45329,207,4345,1943,715,1694,26,18,214,1969,12,185,120,237,197,357,1436,2721,7,20915,1161,0,2,29,22,0
45330,207,4345,1168,838,957,57,25,144,1225,19,348,224,416,367,640,3018,5452,11,61921,3440,1,2,29,22,0
45334,90,3826,1289,550,1043,56,32,155,1345,10,167,93,185,177,278,1266,2075,5,11498,638,0,2,4,4,0
45336,13,563,139,89,101,2,0,35,141,7,54,34,62,61,96,330,569,4,2287,127,0,2,50,0,0
45339,97,4416,1338,495,1086,10,64,173,1348,11,122,82,157,133,239,883,1686,7,11934,663,0,2,4,7,0
45342,138,5836,1782,648,1425,9,47,279,1791,8,171,97,189,179,286,1292,2140,4,9462,525,0,2,34,3,0
45343,32,2401,996,429,845,24,10,117,1020,7,76,50,88,83,138,494,879,4,3565,198,0,3,9,9,0
45345,84,4400,1457,730,1242,11,6,188,1468,10,292,166,329,302,495,2424,4078,5,22973,1276,1,2,39,5,0
45347,82,3566,1020,354,843,12,15,144,1032,8,134,77,144,142,221,970,1580,4,6792,377,0,2,43,1,0
45348,45,2208,722,423,573,19,0,135,741,12,172,101,199,184,300,1320,2257,6,15668,870,0,2,238,9,0
45350,78,3015,1043,504,840,53,9,147,1096,9,180,112,198,189,310,1377,2344,4,11604,644,0,2,12,0,0
45351,90,4376,1943,715,1694,26,18,214,1969,12,185,120,237,197,357,1436,2721,7,20915,1161,0,2,89,6,0
45352,39,1724,386,256,301,16,9,68,402,4,59,35,69,63,104,355,621,2,1453,80,0,2,2,2,0
45353,108,2218,1020,354,843,12,15,144,1032,8,134,77,144,142,221,970,1580,4,6792,377,0,2,1,1,0
45354,259,6118,72,33,56,0,4,12,72,1,1,1,1,2,2,0,2,0,1,0,0,2,2,1,0
45355,259,6118,1454,835,1044,76,110,219,1530,17,275,158,296,292,454,2297,3718,9,34017,1889,1,2,2,1,0
45356,209,4372,1943,715,1694,26,18,214,1969,12,185,120,237,197,357,1436,2721,7,20915,1161,0,2,5,0,1
45357,209,4372,1168,838,957,57,25,144,1225,19,348,224,416,367,640,3018,5452,11,61921,3440,1,2,5,0,1
45358,91,4435,1943,715,1694,26,18,214,1969,12,185,120,237,197,357,1436,2721,7,20915,1161,0,2,13,0,1
45359,351,7022,1457,730,1242,11,6,188,1468,10,292,166,329,302,495,2424,4078,5,22973,1276,1,2,0,2,0
45360,351,7022,74,35,59,1,0,14,75,3,14,7,14,17,21,58,85,1,128,7,0,2,0,2,0
45361,351,7022,245,125,200,5,7,34,250,7,30,17,34,37,51,166,265,3,1053,58,0,2,0,2,0
45362,30,1214,373,158,315,8,0,51,381,5,76,44,79,81,123,486,779,2,2026,112,0,2,14,7,0
45397,350,7046,1457,730,1242,11,6,188,1468,10,292,166,329,302,495,2424,4078,5,22973,1276,1,2,15,15,0
45398,350,7046,74,35,59,1,0,14,75,3,14,7,14,17,21,58,85,1,128,7,0,2,15,15,0
45399,350,7046,245,125,200,5,7,34,250,7,30,17,34,37,51,166,265,3,1053,58,0,2,15,15,0
45401,230,5261,4293,999,3693,19,54,507,4312,9,155,88,170,164,258,1156,1898,4,9368,520,0,2,40,51,0
45402,230,5261,1482,859,1002,125,135,219,1607,16,219,134,251,235,385,1766,3032,9,27804,1544,1,2,40,51,0
45409,117,2824,77,34,69,0,0,8,77,3,24,16,29,27,45,114,213,1,387,21,0,2,1,1,0
45410,117,2824,712,438,573,51,9,84,763,14,102,71,128,116,199,733,1364,8,11988,666,0,2,1,1,0
45411,108,2218,1020,354,843,12,15,144,1032,8,134,77,144,142,221,970,1580,4,6792,377,0,2,42,7,0
45424,60,1088,282,196,195,3,0,86,285,8,130,71,141,138,212,936,1507,4,6538,363,0,2,4,2,0
45426,90,3826,1289,550,1043,56,32,155,1345,10,167,93,185,177,278,1266,2075,5,11498,638,0,2,8,7,0
45432,97,4416,1338,495,1086,10,64,173,1348,11,122,82,157,133,239,883,1686,7,11934,663,0,2,4,5,0
45435,138,5836,1782,648,1425,9,47,279,1791,8,171,97,189,179,286,1292,2140,4,9462,525,0,2,18,6,0
45438,32,2401,996,429,845,24,10,117,1020,7,76,50,88,83,138,494,879,4,3565,198,0,3,15,15,0
45441,84,4400,1457,730,1242,11,6,188,1468,10,292,166,329,302,495,2424,4078,5,22973,1276,1,2,44,10,0
45451,90,4376,1943,715,1694,26,18,214,1969,12,185,120,237,197,357,1436,2721,7,20915,1161,0,2,5,5,0
45452,30,1193,373,158,315,8,0,51,381,5,76,44,79,81,123,486,779,2,2026,112,0,2,5,3,0
45453,350,7046,1457,730,1242,11,6,188,1468,10,292,166,329,302,495,2424,4078,5,22973,1276,1,2,3,3,0
45454,350,7046,74,35,59,1,0,14,75,3,14,7,14,17,21,58,85,1,128,7,0,2,3,3,0
45455,350,7046,245,125,200,5,7,34,250,7,30,17,34,37,51,166,265,3,1053,58,0,2,3,3,0
45456,28,1170,373,158,315,8,0,51,381,5,76,44,79,81,123,486,779,2,2026,112,0,2,6,10,0
45457,234,5320,4293,999,3693,19,54,507,4312,9,155,88,170,164,258,1156,1898,4,9368,520,0,2,15,7,0
45458,234,5320,1482,859,1002,125,135,219,1607,16,219,134,251,235,385,1766,3032,9,27804,1544,1,2,15,7,0
45459,163,7176,139,89,101,2,0,35,141,7,54,34,62,61,96,330,569,4,2287,127,0,2,41,0,0
45460,163,7176,7,5,5,0,0,2,7,1,2,1,2,3,3,2,4,0,2,0,0,2,41,0,0
45462,15,466,42,7,35,4,0,5,46,1,2,1,2,3,3,2,4,0,2,0,0,2,1,1,0
45463,15,466,11,6,10,0,0,1,11,2,4,2,4,6,6,10,15,1,15,0,0,2,1,1,0
45464,97,2643,1523,757,1297,19,12,193,1542,12,193,117,230,205,347,1508,2664,7,19053,1058,0,2,48,5,0
45465,97,2643,701,378,504,33,58,109,734,13,110,68,126,123,194,794,1346,7,10027,557,0,2,48,5,0
45466,113,2514,1043,504,840,53,9,147,1096,9,180,112,198,189,310,1377,2344,4,11604,644,0,2,8,0,0
45467,113,2514,383,288,292,26,6,62,409,11,65,38,67,76,105,429,656,5,3719,206,0,2,8,0,0
45468,94,4604,1523,757,1297,19,12,193,1542,12,193,117,230,205,347,1508,2664,7,19053,1058,0,2,20,3,0
45469,34,1626,1293,570,1093,25,15,163,1318,10,195,123,241,205,364,1516,2795,6,17273,959,0,2,4,0,0
45470,34,1634,1293,570,1093,25,15,163,1318,10,195,123,241,205,364,1516,2795,6,17273,959,0,2,1,1,1
45471,21,662,339,213,244,17,9,65,356,10,42,26,48,52,74,259,421,5,2410,133,0,2,7,11,0
45472,34,1634,1293,570,1093,25,15,163,1318,10,195,123,241,205,364,1516,2795,6,17273,959,0,2,4,0,0
45473,21,668,339,213,244,17,9,65,356,10,42,26,48,52,74,259,421,5,2410,133,0,2,3,3,0
45476,79,2067,773,422,505,30,103,129,803,14,77,46,83,91,129,535,839,7,6334,351,0,2,1,1,0
45477,26,1513,1157,318,931,29,22,177,1186,6,104,63,125,110,188,712,1274,3,4596,255,0,2,54,0,0
45478,113,2514,1043,504,840,53,9,147,1096,9,180,112,198,189,310,1377,2344,4,11604,644,0,2,1,1,0
45479,113,2514,383,288,292,26,6,62,409,11,65,38,67,76,105,429,656,5,3719,206,0,2,1,1,0
45480,80,2120,773,422,505,30,103,129,803,14,77,46,83,91,129,535,839,7,6334,351,0,2,14,1,0
45481,25,1456,1157,318,931,29,22,177,1186,6,104,63,125,110,188,712,1274,3,4596,255,0,2,22,1,0
45482,210,4402,1943,715,1694,26,18,214,1969,12,185,120,237,197,357,1436,2721,7,20915,1161,0,2,7,4,1
45483,210,4402,1168,838,957,57,25,144,1225,19,348,224,416,367,640,3018,5452,11,61921,3440,1,2,7,4,1
45484,91,4486,1943,715,1694,26,18,214,1969,12,185,120,237,197,357,1436,2721,7,20915,1161,0,2,11,3,1
45496,350,7046,1457,730,1242,11,6,188,1468,10,292,166,329,302,495,2424,4078,5,22973,1276,1,2,8,2,0
45497,350,7046,74,35,59,1,0,14,75,3,14,7,14,17,21,58,85,1,128,7,0,2,8,2,0
45498,350,7046,245,125,200,5,7,34,250,7,30,17,34,37,51,166,265,3,1053,58,0,2,8,2,0
45499,117,2824,77,34,69,0,0,8,77,3,24,16,29,27,45,114,213,1,387,21,0,2,6,0,0
45500,117,2824,712,438,573,51,9,84,763,14,102,71,128,116,199,733,1364,8,11988,666,0,2,6,0,0
45501,28,1170,373,158,315,8,0,51,381,5,76,44,79,81,123,486,779,2,2026,112,0,2,30,0,0
45502,83,2161,773,422,505,30,103,129,803,14,77,46,83,91,129,535,839,7,6334,351,0,2,9,2,1
45503,27,1578,1157,318,931,29,22,177,1186,6,104,63,125,110,188,712,1274,3,4596,255,0,2,42,0,1
45504,82,2143,773,422,505,30,103,129,803,14,77,46,83,91,129,535,839,7,6334,351,0,2,8,8,0
45505,210,4422,1943,715,1694,26,18,214,1969,12,185,120,237,197,357,1436,2721,7,20915,1161,0,2,7,4,0
45506,210,4422,1168,838,957,57,25,144,1225,19,348,224,416,367,640,3018,5452,11,61921,3440,1,2,7,4,0
45507,91,4548,1943,715,1694,26,18,214,1969,12,185,120,237,197,357,1436,2721,7,20915,1161,0,2,8,0,0
45508,82,2143,773,422,505,30,103,129,803,14,77,46,83,91,129,535,839,7,6334,351,0,2,1,1,0
45509,82,2143,773,422,505,30,103,129,803,14,77,46,83,91,129,535,839,7,6334,351,0,2,9,2,0
45510,27,1578,1157,318,931,29,22,177,1186,6,104,63,125,110,188,712,1274,3,4596,255,0,2,42,0,0
45511,84,2178,773,422,505,30,103,129,803,14,77,46,83,91,129,535,839,7,6334,351,0,2,8,1,0
45512,28,1711,1157,318,931,29,22,177,1186,6,104,63,125,110,188,712,1274,3,4596,255,0,2,59,0,0
45513,210,4412,1943,715,1694,26,18,214,1969,12,185,120,237,197,357,1436,2721,7,20915,1161,0,2,0,1,0
45514,210,4412,1168,838,957,57,25,144,1225,19,348,224,416,367,640,3018,5452,11,61921,3440,1,2,0,1,0
45515,210,4418,1943,715,1694,26,18,214,1969,12,185,120,237,197,357,1436,2721,7,20915,1161,0,2,10,0,0
45516,210,4418,1168,838,957,57,25,144,1225,19,348,224,416,367,640,3018,5452,11,61921,3440,1,2,10,0,0
45517,91,4542,1943,715,1694,26,18,214,1969,12,185,120,237,197,357,1436,2721,7,20915,1161,0,2,29,0,0
45518,73,1425,757,253,292,73,244,162,830,13,61,38,67,74,105,409,651,7,4654,258,0,2,4,0,0
45520,54,1096,207,111,150,11,0,50,218,5,26,19,36,31,55,133,272,3,943,52,0,2,4,3,1
45521,54,1096,410,198,237,31,55,97,441,11,63,38,72,74,110,414,683,6,4293,238,0,2,4,3,1
45522,33,991,465,148,393,5,8,60,470,4,31,20,31,35,51,161,261,2,523,29,0,2,22,0,1
45523,33,991,16,12,9,0,0,6,16,1,2,1,2,3,3,2,4,0,2,0,0,2,22,0,1
45524,23,722,339,213,244,17,9,65,356,10,42,26,48,52,74,259,421,5,2410,133,0,2,11,0,1
45525,36,1762,1293,570,1093,25,15,163,1318,10,195,123,241,205,364,1516,2795,6,17273,959,0,2,35,4,1
45526,66,1783,1455,414,1257,16,76,112,1471,5,41,23,46,46,69,231,381,2,1069,59,0,2,12,0,0
45527,66,1783,669,365,481,22,61,110,691,15,103,63,122,118,185,747,1273,8,11311,628,0,2,12,0,0
45541,34,1617,1293,570,1093,25,15,163,1318,10,195,123,241,205,364,1516,2795,6,17273,959,0,2,0,4,0
45542,72,1639,996,429,845,24,10,117,1020,7,76,50,88,83,138,494,879,4,3565,198,0,2,42,0,1
45543,72,1639,456,277,329,12,42,72,468,13,85,50,97,98,147,592,972,7,7212,400,0,2,42,0,1
45544,34,2781,996,429,845,24,10,117,1020,7,76,50,88,83,138,494,879,4,3565,198,0,2,117,4,1
45545,209,4409,1943,715,1694,26,18,214,1969,12,185,120,237,197,357,1436,2721,7,20915,1161,0,2,4,6,0
45546,209,4409,1168,838,957,57,25,144,1225,19,348,224,416,367,640,3018,5452,11,61921,3440,1,2,4,6,0
45547,32,2401,996,429,845,24,10,117,1020,7,76,50,88,83,138,494,879,4,3565,198,0,2,1,1,0
45548,92,4598,1943,715,1694,26,18,214,1969,12,185,120,237,197,357,1436,2721,7,20915,1161,0,2,26,1,0
45549,67,1795,1455,414,1257,16,76,112,1471,5,41,23,46,46,69,231,381,2,1069,59,0,2,3,0,0
45550,67,1795,669,365,481,22,61,110,691,15,103,63,122,118,185,747,1273,8,11311,628,0,2,3,0,0
45551,73,1417,757,253,292,73,244,162,830,13,61,38,67,74,105,409,651,7,4654,258,0,2,0,1,0
45552,74,1419,757,253,292,73,244,162,830,13,61,38,67,74,105,409,651,7,4654,258,0,2,1,1,0
45553,21,572,256,139,192,9,7,47,265,4,23,12,24,27,36,112,171,2,357,19,0,2,10,0,0
45554,67,1795,1455,414,1257,16,76,112,1471,5,41,23,46,46,69,231,381,2,1069,59,0,2,2,2,0
45555,67,1795,669,365,481,22,61,110,691,15,103,63,122,118,185,747,1273,8,11311,628,0,2,2,2,0
45556,230,5261,4293,999,3693,19,54,507,4312,9,155,88,170,164,258,1156,1898,4,9368,520,0,2,2,2,1
45557,230,5261,1482,859,1002,125,135,219,1607,16,219,134,251,235,385,1766,3032,9,27804,1544,1,2,2,2,1
45558,15,466,42,7,35,4,0,5,46,1,2,1,2,3,3,2,4,0,2,0,0,2,1,1,1
45559,15,466,11,6,10,0,0,1,11,2,4,2,4,6,6,10,15,1,15,0,0,2,1,1,1
45560,54,1096,207,111,150,11,0,50,218,5,26,19,36,31,55,133,272,3,943,52,0,2,4,3,0
45561,54,1096,410,198,237,31,55,97,441,11,63,38,72,74,110,414,683,6,4293,238,0,2,4,3,0
45562,33,991,465,148,393,5,8,60,470,4,31,20,31,35,51,161,261,2,523,29,0,2,22,0,0
45563,33,991,16,12,9,0,0,6,16,1,2,1,2,3,3,2,4,0,2,0,0,2,22,0,0
45564,23,722,339,213,244,17,9,65,356,10,42,26,48,52,74,259,421,5,2410,133,0,2,11,0,0
45565,36,1779,1293,570,1093,25,15,163,1318,10,195,123,241,205,364,1516,2795,6,17273,959,0,2,35,4,0
45566,123,2925,77,34,69,0,0,8,77,3,24,16,29,27,45,114,213,1,387,21,0,2,20,0,0
45567,123,2925,712,438,573,51,9,84,763,14,102,71,128,116,199,733,1364,8,11988,666,0,2,20,0,0
45568,30,1233,373,158,315,8,0,51,381,5,76,44,79,81,123,486,779,2,2026,112,0,2,14,0,0
45580,29,1792,1157,318,931,29,22,177,1186,6,104,63,125,110,188,712,1274,3,4596,255,0,2,54,0,0
45583,23,722,339,213,244,17,9,65,356,10,42,26,48,52,74,259,421,5,2410,133,0,2,14,3,0
45586,85,2182,773,422,505,30,103,129,803,14,77,46,83,91,129,535,839,7,6334,351,0,2,1,1,0
45597,36,1779,1293,570,1093,25,15,163,1318,10,195,123,241,205,364,1516,2795,6,17273,959,0,2,39,4,0
45618,67,1795,1455,414,1257,16,76,112,1471,5,41,23,46,46,69,231,381,2,1069,59,0,2,1,1,0
45619,67,1795,669,365,481,22,61,110,691,15,103,63,122,118,185,747,1273,8,11311,628,0,2,1,1,0
45622,24,749,339,213,244,17,9,65,356,10,42,26,48,52,74,259,421,5,2410,133,0,2,5,0,1
45623,37,1850,1293,570,1093,25,15,163,1318,10,195,123,241,205,364,1516,2795,6,17273,959,0,2,16,0,1
45624,67,1795,1455,414,1257,16,76,112,1471,5,41,23,46,46,69,231,381,2,1069,59,0,2,15,0,0
45625,67,1795,669,365,481,22,61,110,691,15,103,63,122,118,185,747,1273,8,11311,628,0,2,15,0,0
45626,36,1762,1293,570,1093,25,15,163,1318,10,195,123,241,205,364,1516,2795,6,17273,959,0,2,0,4,0
45627,234,5320,4293,999,3693,19,54,507,4312,9,155,88,170,164,258,1156,1898,4,9368,520,0,2,2,2,0
45628,234,5320,1482,859,1002,125,135,219,1607,16,219,134,251,235,385,1766,3032,9,27804,1544,1,2,2,2,0
45631,74,1419,757,253,292,73,244,162,830,13,61,38,67,74,105,409,651,7,4654,258,0,2,1,2,0
45633,25,753,339,213,244,17,9,65,356,10,42,26,48,52,74,259,421,5,2410,133,0,2,10,14,1
45634,209,4399,1943,715,1694,26,18,214,1969,12,185,120,237,197,357,1436,2721,7,20915,1161,0,2,7,7,1
45635,209,4399,1168,838,957,57,25,144,1225,19,348,224,416,367,640,3018,5452,11,61921,3440,1,2,7,7,1
45636,38,1882,1293,570,1093,25,15,163,1318,10,195,123,241,205,364,1516,2795,6,17273,959,0,2,7,5,1
45637,92,4613,1943,715,1694,26,18,214,1969,12,185,120,237,197,357,1436,2721,7,20915,1161,0,2,34,18,1
45638,84,2139,773,422,505,30,103,129,803,14,77,46,83,91,129,535,839,7,6334,351,0,2,3,10,1
45639,27,1631,1157,318,931,29,22,177,1186,6,104,63,125,110,188,712,1274,3,4596,255,0,2,0,54,1
45640,85,2182,773,422,505,30,103,129,803,14,77,46,83,91,129,535,839,7,6334,351,0,2,10,3,0
45642,25,753,339,213,244,17,9,65,356,10,42,26,48,52,74,259,421,5,2410,133,0,2,10,9,0
45643,209,4399,1943,715,1694,26,18,214,1969,12,185,120,237,197,357,1436,2721,7,20915,1161,0,2,7,7,0
45644,209,4399,1168,838,957,57,25,144,1225,19,348,224,416,367,640,3018,5452,11,61921,3440,1,2,7,7,0
45645,38,1882,1293,570,1093,25,15,163,1318,10,195,123,241,205,364,1516,2795,6,17273,959,0,2,18,0,0
45646,92,4613,1943,715,1694,26,18,214,1969,12,185,120,237,197,357,1436,2721,7,20915,1161,0,2,34,18,0
45648,98,2673,1523,757,1297,19,12,193,1542,12,193,117,230,205,347,1508,2664,7,19053,1058,0,2,29,15,1
45649,98,2673,701,378,504,33,58,109,734,13,110,68,126,123,194,794,1346,7,10027,557,0,2,29,15,1
45650,79,1692,53,23,39,0,0,13,53,2,8,4,8,10,12,26,39,1,39,2,0,2,4,0,1
45651,79,1692,515,298,307,33,80,99,548,12,63,44,77,75,121,419,753,7,5527,307,0,2,4,0,1
45652,113,2525,1043,504,840,53,9,147,1096,9,180,112,198,189,310,1377,2344,4,11604,644,0,2,7,1,1
45653,113,2525,383,288,292,26,6,62,409,11,65,38,67,76,105,429,656,5,3719,206,0,2,7,1,1
45654,94,4604,1523,757,1297,19,12,193,1542,12,193,117,230,205,347,1508,2664,7,19053,1058,0,2,8,8,1
45659,38,1865,1293,570,1093,25,15,163,1318,10,195,123,241,205,364,1516,2795,6,17273,959,0,2,0,4,0
45660,91,4587,1943,715,1694,26,18,214,1969,12,185,120,237,197,357,1436,2721,7,20915,1161,0,2,17,12,0
45661,98,2670,1523,757,1297,19,12,193,1542,12,193,117,230,205,347,1508,2664,7,19053,1058,0,2,2,2,0
45662,98,2670,701,378,504,33,58,109,734,13,110,68,126,123,194,794,1346,7,10027,557,0,2,2,2,0
45663,113,2530,1043,504,840,53,9,147,1096,9,180,112,198,189,310,1377,2344,4,11604,644,0,2,2,4,0
45664,113,2530,383,288,292,26,6,62,409,11,65,38,67,76,105,429,656,5,3719,206,0,2,2,4,0
45665,75,1466,757,253,292,73,244,162,830,13,61,38,67,74,105,409,651,7,4654,258,0,2,14,2,1
45666,52,3387,520,294,400,33,13,81,553,10,261,204,367,271,571,2128,4614,7,32445,1802,1,2,1,0,1
45668,234,5333,4293,999,3693,19,54,507,4312,9,155,88,170,164,258,1156,1898,4,9368,520,0,2,6,5,0
45669,234,5333,1482,859,1002,125,135,219,1607,16,219,134,251,235,385,1766,3032,9,27804,1544,1,2,6,5,0
45670,75,1466,757,253,292,73,244,162,830,13,61,38,67,74,105,409,651,7,4654,258,0,2,14,2,0
45671,52,3387,520,294,400,33,13,81,553,10,261,204,367,271,571,2128,4614,7,32445,1802,1,2,1,0,0
45673,98,2670,1523,757,1297,19,12,193,1542,12,193,117,230,205,347,1508,2664,7,19053,1058,0,2,29,15,0
45674,98,2670,701,378,504,33,58,109,734,13,110,68,126,123,194,794,1346,7,10027,557,0,2,29,15,0
45675,79,1692,53,23,39,0,0,13,53,2,8,4,8,10,12,26,39,1,39,2,0,2,4,0,0
45676,79,1692,515,298,307,33,80,99,548,12,63,44,77,75,121,419,753,7,5527,307,0,2,4,0,0
45677,113,2530,1043,504,840,53,9,147,1096,9,180,112,198,189,310,1377,2344,4,11604,644,0,2,6,2,0
45678,113,2530,383,288,292,26,6,62,409,11,65,38,67,76,105,429,656,5,3719,206,0,2,6,2,0
45679,94,4604,1523,757,1297,19,12,193,1542,12,193,117,230,205,347,1508,2664,7,19053,1058,0,2,8,8,0
45680,164,7205,139,89,101,2,0,35,141,7,54,34,62,61,96,330,569,4,2287,127,0,2,35,0,1
45681,164,7205,7,5,5,0,0,2,7,1,2,1,2,3,3,2,4,0,2,0,0,2,35,0,1
45682,234,5348,4293,999,3693,19,54,507,4312,9,155,88,170,164,258,1156,1898,4,9368,520,0,2,6,2,0
45683,234,5348,1482,859,1002,125,135,219,1607,16,219,134,251,235,385,1766,3032,9,27804,1544,1,2,6,2,0
45686,108,2220,2,2,2,0,0,0,2,0,0,0,0,0,0,0,0,0,0,0,0,3,2,2,0
45700,108,2220,99,48,90,1,3,5,100,0,0,0,0,0,0,0,0,0,0,0,0,3,2,2,0
45701,108,2220,8,5,5,2,0,1,10,0,0,0,0,0,0,0,0,0,0,0,0,3,2,2,0
45702,108,2220,1217,716,841,84,126,174,1301,14,185,118,215,199,333,1446,2542,8,20687,1149,0,3,2,2,0
45703,108,2220,160,89,115,0,13,31,160,7,15,11,17,22,28,78,124,3,495,27,0,3,2,2,0
45704,108,2220,10,10,9,9,0,0,19,0,0,0,0,0,0,0,0,0,0,0,0,3,2,2,0
45705,108,2220,173,84,99,8,29,36,181,5,12,7,13,17,20,54,81,2,221,12,0,3,2,2,0
45706,108,2220,3,1,1,3,0,0,6,0,0,0,0,0,0,0,0,0,0,0,0,3,2,2,0
45707,33,701,125,97,103,3,0,19,128,9,25,17,27,34,44,144,223,4,1087,60,0,0,126,0,1
45708,75,1390,1178,367,1042,6,15,115,1184,9,94,51,95,103,146,644,976,4,4439,246,0,2,2,123,1
45709,75,1390,177,108,140,8,0,27,185,6,30,16,32,36,48,162,248,3,794,44,0,2,2,123,1
45710,71,1417,1178,367,1042,6,15,115,1184,9,94,51,95,103,146,644,976,4,4439,246,0,2,21,12,0
45711,71,1417,177,108,140,8,0,27,185,6,30,16,32,36,48,162,248,3,794,44,0,2,21,12,0
45712,15,468,42,7,35,4,0,5,46,1,2,1,2,3,3,2,4,0,2,0,0,2,1,1,0
45713,15,468,11,6,10,0,0,1,11,2,4,2,4,6,6,10,15,1,15,0,0,2,1,1,0
45716,85,1879,2,2,2,0,0,0,2,0,0,0,0,0,0,0,0,0,0,0,0,2,1,84,1
45730,85,1879,99,48,90,1,3,5,100,0,0,0,0,0,0,0,0,0,0,0,0,2,1,84,1
45731,85,1879,8,5,5,2,0,1,10,0,0,0,0,0,0,0,0,0,0,0,0,2,1,84,1
45732,85,1879,1217,716,841,84,126,174,1301,14,185,118,215,199,333,1446,2542,8,20687,1149,0,2,1,84,1
45733,85,1879,160,89,115,0,13,31,160,7,15,11,17,22,28,78,124,3,495,27,0,2,1,84,1
45734,85,1879,10,10,9,9,0,0,19,0,0,0,0,0,0,0,0,0,0,0,0,2,1,84,1
45735,85,1879,173,84,99,8,29,36,181,5,12,7,13,17,20,54,81,2,221,12,0,2,1,84,1
45736,85,1879,3,1,1,3,0,0,6,0,0,0,0,0,0,0,0,0,0,0,0,2,1,84,1
45737,23,363,102,57,55,5,16,25,107,5,17,10,18,22,28,81,124,2,330,18,0,0,93,0,1
45738,24,380,102,57,55,5,16,25,107,5,17,10,18,22,28,81,124,2,330,18,0,2,22,18,1
45741,22,528,2,2,2,0,0,0,2,0,0,0,0,0,0,0,0,0,0,0,0,2,5,330,1
45755,22,528,99,48,90,1,3,5,100,0,0,0,0,0,0,0,0,0,0,0,0,2,5,330,1
45756,22,528,8,5,5,2,0,1,10,0,0,0,0,0,0,0,0,0,0,0,0,2,5,330,1
45757,22,528,1217,716,841,84,126,174,1301,14,185,118,215,199,333,1446,2542,8,20687,1149,0,2,5,330,1
45758,22,528,160,89,115,0,13,31,160,7,15,11,17,22,28,78,124,3,495,27,0,2,5,330,1
45759,22,528,10,10,9,9,0,0,19,0,0,0,0,0,0,0,0,0,0,0,0,2,5,330,1
45760,22,528,173,84,99,8,29,36,181,5,12,7,13,17,20,54,81,2,221,12,0,2,5,330,1
45761,22,528,3,1,1,3,0,0,6,0,0,0,0,0,0,0,0,0,0,0,0,2,5,330,1
45762,63,1378,402,202,227,24,74,80,426,12,52,33,61,64,94,339,564,7,3969,220,0,0,330,0,1
45763,259,6120,72,33,56,0,4,12,72,1,1,1,1,2,2,0,2,0,1,0,0,2,1,1,1
45764,259,6120,1454,835,1044,76,110,219,1530,17,275,158,296,292,454,2297,3718,9,34017,1889,1,2,1,1,1
45767,24,588,2,2,2,0,0,0,2,0,0,0,0,0,0,0,0,0,0,0,0,2,26,12,0
45781,24,588,99,48,90,1,3,5,100,0,0,0,0,0,0,0,0,0,0,0,0,2,26,12,0
45782,24,588,8,5,5,2,0,1,10,0,0,0,0,0,0,0,0,0,0,0,0,2,26,12,0
45783,24,588,1217,716,841,84,126,174,1301,14,185,118,215,199,333,1446,2542,8,20687,1149,0,2,26,12,0
45784,24,588,160,89,115,0,13,31,160,7,15,11,17,22,28,78,124,3,495,27,0,2,26,12,0
45785,24,588,10,10,9,9,0,0,19,0,0,0,0,0,0,0,0,0,0,0,0,2,26,12,0
45786,24,588,173,84,99,8,29,36,181,5,12,7,13,17,20,54,81,2,221,12,0,2,26,12,0
45787,24,588,3,1,1,3,0,0,6,0,0,0,0,0,0,0,0,0,0,0,0,2,26,12,0
45790,24,599,2,2,2,0,0,0,2,0,0,0,0,0,0,0,0,0,0,0,0,2,6,2,0
45804,24,599,99,48,90,1,3,5,100,0,0,0,0,0,0,0,0,0,0,0,0,2,6,2,0
45805,24,599,8,5,5,2,0,1,10,0,0,0,0,0,0,0,0,0,0,0,0,2,6,2,0
45806,24,599,1217,716,841,84,126,174,1301,14,185,118,215,199,333,1446,2542,8,20687,1149,0,2,6,2,0
45807,24,599,160,89,115,0,13,31,160,7,15,11,17,22,28,78,124,3,495,27,0,2,6,2,0
45808,24,599,10,10,9,9,0,0,19,0,0,0,0,0,0,0,0,0,0,0,0,2,6,2,0
45809,24,599,173,84,99,8,29,36,181,5,12,7,13,17,20,54,81,2,221,12,0,2,6,2,0
45810,24,599,3,1,1,3,0,0,6,0,0,0,0,0,0,0,0,0,0,0,0,2,6,2,0
45811,259,6120,72,33,56,0,4,12,72,1,1,1,1,2,2,0,2,0,1,0,0,2,1,1,0
45812,259,6120,1454,835,1044,76,110,219,1530,17,275,158,296,292,454,2297,3718,9,34017,1889,1,2,1,1,0
45813,39,1946,1293,570,1093,25,15,163,1318,10,195,123,241,205,364,1516,2795,6,17273,959,0,2,18,0,1
45814,33,701,125,97,103,3,0,19,128,9,25,17,27,34,44,144,223,4,1087,60,0,2,0,1,0
45815,234,5348,4293,999,3693,19,54,507,4312,9,155,88,170,164,258,1156,1898,4,9368,520,0,2,9,4,0
45816,234,5348,1482,859,1002,125,135,219,1607,16,219,134,251,235,385,1766,3032,9,27804,1544,1,2,9,4,0
45817,164,7205,139,89,101,2,0,35,141,7,54,34,62,61,96,330,569,4,2287,127,0,2,35,0,0
45818,164,7205,7,5,5,0,0,2,7,1,2,1,2,3,3,2,4,0,2,0,0,2,35,0,0
45819,39,1946,1293,570,1093,25,15,163,1318,10,195,123,241,205,364,1516,2795,6,17273,959,0,2,18,0,0
45820,82,2133,1455,414,1257,16,76,112,1471,5,41,23,46,46,69,231,381,2,1069,59,0,2,141,45,0
45821,82,2133,669,365,481,22,61,110,691,15,103,63,122,118,185,747,1273,8,11311,628,0,2,141,45,0
45822,69,3191,1455,414,1257,16,76,112,1471,5,41,23,46,46,69,231,381,2,1069,59,0,2,19,0,0
45832,70,1621,996,429,845,24,10,117,1020,7,76,50,88,83,138,494,879,4,3565,198,0,2,19,18,1
45833,70,1621,456,277,329,12,42,72,468,13,85,50,97,98,147,592,972,7,7212,400,0,2,19,18,1
45834,34,2709,996,429,845,24,10,117,1020,7,76,50,88,83,138,494,879,4,3565,198,0,2,30,34,1
45837,25,753,339,213,244,17,9,65,356,10,42,26,48,52,74,259,421,5,2410,133,0,2,15,3,0
45841,234,5320,4293,999,3693,19,54,507,4312,9,155,88,170,164,258,1156,1898,4,9368,520,0,2,17,9,0
45842,234,5320,1482,859,1002,125,135,219,1607,16,219,134,251,235,385,1766,3032,9,27804,1544,1,2,17,9,0
45845,85,2182,773,422,505,30,103,129,803,14,77,46,83,91,129,535,839,7,6334,351,0,2,9,2,0
45853,74,1419,757,253,292,73,244,162,830,13,61,38,67,74,105,409,651,7,4654,258,0,2,5,2,0
45856,209,4399,1943,715,1694,26,18,214,1969,12,185,120,237,197,357,1436,2721,7,20915,1161,0,2,11,13,0
45857,209,4399,1168,838,957,57,25,144,1225,19,348,224,416,367,640,3018,5452,11,61921,3440,1,2,11,13,0
45858,15,466,42,7,35,4,0,5,46,1,2,1,2,3,3,2,4,0,2,0,0,2,2,2,0
45859,15,466,11,6,10,0,0,1,11,2,4,2,4,6,6,10,15,1,15,0,0,2,2,2,0
45860,29,1792,1157,318,931,29,22,177,1186,6,104,63,125,110,188,712,1274,3,4596,255,0,2,113,0,0
45866,34,2709,996,429,845,24,10,117,1020,7,76,50,88,83,138,494,879,4,3565,198,0,2,1,1,0
45868,39,1946,1293,570,1093,25,15,163,1318,10,195,123,241,205,364,1516,2795,6,17273,959,0,2,71,4,0
45871,91,4587,1943,715,1694,26,18,214,1969,12,185,120,237,197,357,1436,2721,7,20915,1161,0,2,77,31,0
45872,82,2133,1455,414,1257,16,76,112,1471,5,41,23,46,46,69,231,381,2,1069,59,0,2,0,22,0
45873,82,2133,669,365,481,22,61,110,691,15,103,63,122,118,185,747,1273,8,11311,628,0,2,0,22,0
45874,69,3182,1455,414,1257,16,76,112,1471,5,41,23,46,46,69,231,381,2,1069,59,0,2,7,5,0
45875,83,2145,1455,414,1257,16,76,112,1471,5,41,23,46,46,69,231,381,2,1069,59,0,2,25,16,0
45876,83,2145,669,365,481,22,61,110,691,15,103,63,122,118,185,747,1273,8,11311,628,0,2,25,16,0
45877,69,3184,1455,414,1257,16,76,112,1471,5,41,23,46,46,69,231,381,2,1069,59,0,2,1,1,0
45880,24,599,2,2,2,0,0,0,2,0,0,0,0,0,0,0,0,0,0,0,0,0,141,0,0
45894,24,599,99,48,90,1,3,5,100,0,0,0,0,0,0,0,0,0,0,0,0,0,141,0,0
45895,24,599,8,5,5,2,0,1,10,0,0,0,0,0,0,0,0,0,0,0,0,0,141,0,0
45896,24,599,1217,716,841,84,126,174,1301,14,185,118,215,199,333,1446,2542,8,20687,1149,0,0,141,0,0
45897,24,599,160,89,115,0,13,31,160,7,15,11,17,22,28,78,124,3,495,27,0,0,141,0,0
45898,24,599,10,10,9,9,0,0,19,0,0,0,0,0,0,0,0,0,0,0,0,0,141,0,0
45899,24,599,173,84,99,8,29,36,181,5,12,7,13,17,20,54,81,2,221,12,0,0,141,0,0
45900,24,599,3,1,1,3,0,0,6,0,0,0,0,0,0,0,0,0,0,0,0,0,141,0,0
45901,33,701,125,97,103,3,0,19,128,9,25,17,27,34,44,144,223,4,1087,60,0,0,125,0,0
45902,24,380,102,57,55,5,16,25,107,5,17,10,18,22,28,81,124,2,330,18,0,0,97,0,0
45903,63,1378,402,202,227,24,74,80,426,12,52,33,61,64,94,339,564,7,3969,220,0,3,83,284,0
45906,71,1417,1178,367,1042,6,15,115,1184,9,94,51,95,103,146,644,976,4,4439,246,0,2,23,135,0
45907,71,1417,177,108,140,8,0,27,185,6,30,16,32,36,48,162,248,3,794,44,0,2,23,135,0
45910,33,707,125,97,103,3,0,19,128,9,25,17,27,34,44,144,223,4,1087,60,0,2,2,1,0
45911,75,3157,1178,367,1042,6,15,115,1184,9,94,51,95,103,146,644,976,4,4439,246,0,2,10,0,0
45912,208,4359,1943,715,1694,26,18,214,1969,12,185,120,237,197,357,1436,2721,7,20915,1161,0,2,2,0,0
45913,208,4359,1168,838,957,57,25,144,1225,19,348,224,416,367,640,3018,5452,11,61921,3440,1,2,2,0,0
45914,90,4387,1943,715,1694,26,18,214,1969,12,185,120,237,197,357,1436,2721,7,20915,1161,0,2,1,0,0
45915,90,4395,1943,715,1694,26,18,214,1969,12,185,120,237,197,357,1436,2721,7,20915,1161,0,2,2,0,0
45916,51,597,647,139,84,35,284,233,682,0,0,0,0,0,0,0,0,0,0,0,0,2,10,2,1
45917,71,1415,1178,367,1042,6,15,115,1184,9,94,51,95,103,146,644,976,4,4439,246,0,2,10,8,1
45918,71,1415,177,108,140,8,0,27,185,6,30,16,32,36,48,162,248,3,794,44,0,2,10,8,1
45919,210,4421,1943,715,1694,26,18,214,1969,12,185,120,237,197,357,1436,2721,7,20915,1161,0,2,9,4,1
45920,210,4421,1168,838,957,57,25,144,1225,19,348,224,416,367,640,3018,5452,11,61921,3440,1,2,9,4,1
45921,75,3160,1178,367,1042,6,15,115,1184,9,94,51,95,103,146,644,976,4,4439,246,0,2,15,0,1
45922,76,3201,1178,367,1042,6,15,115,1184,9,94,51,95,103,146,644,976,4,4439,246,0,2,15,0,0
45923,76,3201,1178,367,1042,6,15,115,1184,9,94,51,95,103,146,644,976,4,4439,246,0,2,1,1,0
45924,72,1450,757,253,292,73,244,162,830,13,61,38,67,74,105,409,651,7,4654,258,0,2,6,9,1
45925,15,468,42,7,35,4,0,5,46,1,2,1,2,3,3,2,4,0,2,0,0,2,1,0,1
45926,15,468,11,6,10,0,0,1,11,2,4,2,4,6,6,10,15,1,15,0,0,2,1,0,1
45927,51,595,647,139,84,35,284,233,682,0,0,0,0,0,0,0,0,0,0,0,0,2,1,2,0
45928,210,4415,1943,715,1694,26,18,214,1969,12,185,120,237,197,357,1436,2721,7,20915,1161,0,2,0,1,0
45929,210,4415,1168,838,957,57,25,144,1225,19,348,224,416,367,640,3018,5452,11,61921,3440,1,2,0,1,0
45932,90,4395,1943,715,1694,26,18,214,1969,12,185,120,237,197,357,1436,2721,7,20915,1161,0,2,3,0,0
45933,83,2145,1455,414,1257,16,76,112,1471,5,41,23,46,46,69,231,381,2,1069,59,0,2,128,45,0
45934,83,2145,669,365,481,22,61,110,691,15,103,63,122,118,185,747,1273,8,11311,628,0,2,128,45,0
45935,69,3184,1455,414,1257,16,76,112,1471,5,41,23,46,46,69,231,381,2,1069,59,0,2,21,0,0
45937,76,3201,1178,367,1042,6,15,115,1184,9,94,51,95,103,146,644,976,4,4439,246,0,2,25,0,0
45938,352,7039,1457,730,1242,11,6,188,1468,10,292,166,329,302,495,2424,4078,5,22973,1276,1,2,11,4,0
45939,352,7039,74,35,59,1,0,14,75,3,14,7,14,17,21,58,85,1,128,7,0,2,11,4,0
45940,352,7039,245,125,200,5,7,34,250,7,30,17,34,37,51,166,265,3,1053,58,0,2,11,4,0
45941,84,4429,1457,730,1242,11,6,188,1468,10,292,166,329,302,495,2424,4078,5,22973,1276,1,2,7,0,0
45942,352,7048,1457,730,1242,11,6,188,1468,10,292,166,329,302,495,2424,4078,5,22973,1276,1,2,3,2,0
45943,352,7048,74,35,59,1,0,14,75,3,14,7,14,17,21,58,85,1,128,7,0,2,3,2,0
45944,352,7048,245,125,200,5,7,34,250,7,30,17,34,37,51,166,265,3,1053,58,0,2,3,2,0
45945,349,7017,1457,730,1242,11,6,188,1468,10,292,166,329,302,495,2424,4078,5,22973,1276,1,2,0,4,0
45946,349,7017,74,35,59,1,0,14,75,3,14,7,14,17,21,58,85,1,128,7,0,2,0,4,0
45947,349,7017,245,125,200,5,7,34,250,7,30,17,34,37,51,166,265,3,1053,58,0,2,0,4,0
45948,51,595,647,139,84,35,284,233,682,0,0,0,0,0,0,0,0,0,0,0,0,2,8,1,0
45949,71,1415,1178,367,1042,6,15,115,1184,9,94,51,95,103,146,644,976,4,4439,246,0,2,10,8,0
45950,71,1415,177,108,140,8,0,27,185,6,30,16,32,36,48,162,248,3,794,44,0,2,10,8,0
45951,210,4415,1943,715,1694,26,18,214,1969,12,185,120,237,197,357,1436,2721,7,20915,1161,0,2,8,4,0
45952,210,4415,1168,838,957,57,25,144,1225,19,348,224,416,367,640,3018,5452,11,61921,3440,1,2,8,4,0
45953,77,3237,1178,367,1042,6,15,115,1184,9,94,51,95,103,146,644,976,4,4439,246,0,2,15,0,0
45954,349,7017,1457,730,1242,11,6,188,1468,10,292,166,329,302,495,2424,4078,5,22973,1276,1,2,8,4,0
45955,349,7017,74,35,59,1,0,14,75,3,14,7,14,17,21,58,85,1,128,7,0,2,8,4,0
45956,349,7017,245,125,200,5,7,34,250,7,30,17,34,37,51,166,265,3,1053,58,0,2,8,4,0
45958,352,7076,1457,730,1242,11,6,188,1468,10,292,166,329,302,495,2424,4078,5,22973,1276,1,2,8,4,0
45959,352,7076,74,35,59,1,0,14,75,3,14,7,14,17,21,58,85,1,128,7,0,2,8,4,0
45960,352,7076,245,125,200,5,7,34,250,7,30,17,34,37,51,166,265,3,1053,58,0,2,8,4,0
45964,211,4429,1943,715,1694,26,18,214,1969,12,185,120,237,197,357,1436,2721,7,20915,1161,0,2,2,0,0
45965,211,4429,1168,838,957,57,25,144,1225,19,348,224,416,367,640,3018,5452,11,61921,3440,1,2,2,0,0
45970,91,4606,1943,715,1694,26,18,214,1969,12,185,120,237,197,357,1436,2721,7,20915,1161,0,2,3,0,0
45971,77,3237,1178,367,1042,6,15,115,1184,9,94,51,95,103,146,644,976,4,4439,246,0,2,1,1,0
45986,72,1450,757,253,292,73,244,162,830,13,61,38,67,74,105,409,651,7,4654,258,0,2,6,9,0
45987,15,468,42,7,35,4,0,5,46,1,2,1,2,3,3,2,4,0,2,0,0,2,1,0,0
45988,15,468,11,6,10,0,0,1,11,2,4,2,4,6,6,10,15,1,15,0,0,2,1,0,0
45989,355,7107,1457,730,1242,11,6,188,1468,10,292,166,329,302,495,2424,4078,5,22973,1276,1,2,4,0,0
45990,355,7107,74,35,59,1,0,14,75,3,14,7,14,17,21,58,85,1,128,7,0,2,4,0,0
45991,355,7107,245,125,200,5,7,34,250,7,30,17,34,37,51,166,265,3,1053,58,0,2,4,0,0
45992,12,459,75,38,59,1,3,12,76,2,4,2,4,6,6,10,15,1,15,0,0,2,9,0,0
45993,355,7114,1457,730,1242,11,6,188,1468,10,292,166,329,302,495,2424,4078,5,22973,1276,1,2,4,4,0
45994,355,7114,74,35,59,1,0,14,75,3,14,7,14,17,21,58,85,1,128,7,0,2,4,4,0
45995,355,7114,245,125,200,5,7,34,250,7,30,17,34,37,51,166,265,3,1053,58,0,2,4,4,0
45997,355,7114,1457,730,1242,11,6,188,1468,10,292,166,329,302,495,2424,4078,5,22973,1276,1,2,6,2,0
45998,355,7114,74,35,59,1,0,14,75,3,14,7,14,17,21,58,85,1,128,7,0,2,6,2,0
45999,355,7114,245,125,200,5,7,34,250,7,30,17,34,37,51,166,265,3,1053,58,0,2,6,2,0
46002,70,1621,996,429,845,24,10,117,1020,7,76,50,88,83,138,494,879,4,3565,198,0,2,43,0,0
46003,70,1621,456,277,329,12,42,72,468,13,85,50,97,98,147,592,972,7,7212,400,0,2,43,0,0
46004,34,2709,996,429,845,24,10,117,1020,7,76,50,88,83,138,494,879,4,3565,198,0,2,113,4,0
46005,79,2068,773,422,505,30,103,129,803,14,77,46,83,91,129,535,839,7,6334,351,0,2,1,0,0
46011,75,1466,757,253,292,73,244,162,830,13,61,38,67,74,105,409,651,7,4654,258,0,2,9,6,0
46012,15,466,42,7,35,4,0,5,46,1,2,1,2,3,3,2,4,0,2,0,0,2,0,1,0
46013,15,466,11,6,10,0,0,1,11,2,4,2,4,6,6,10,15,1,15,0,0,2,0,1,0
46014,85,2183,773,422,505,30,103,129,803,14,77,46,83,91,129,535,839,7,6334,351,0,2,1,0,0
46015,123,2925,77,34,69,0,0,8,77,3,24,16,29,27,45,114,213,1,387,21,0,2,1,1,0
46016,123,2925,712,438,573,51,9,84,763,14,102,71,128,116,199,733,1364,8,11988,666,0,2,1,1,0
46018,15,470,42,7,35,4,0,5,46,1,2,1,2,3,3,2,4,0,2,0,0,2,1,0,0
46019,15,470,11,6,10,0,0,1,11,2,4,2,4,6,6,10,15,1,15,0,0,2,1,0,0
46029,353,7096,1457,730,1242,11,6,188,1468,10,292,166,329,302,495,2424,4078,5,22973,1276,1,2,3,4,0
46030,353,7096,74,35,59,1,0,14,75,3,14,7,14,17,21,58,85,1,128,7,0,2,3,4,0
46031,353,7096,245,125,200,5,7,34,250,7,30,17,34,37,51,166,265,3,1053,58,0,2,3,4,0
46032,355,7107,1457,730,1242,11,6,188,1468,10,292,166,329,302,495,2424,4078,5,22973,1276,1,2,25,19,0
46033,355,7107,74,35,59,1,0,14,75,3,14,7,14,17,21,58,85,1,128,7,0,2,25,19,0
46034,355,7107,245,125,200,5,7,34,250,7,30,17,34,37,51,166,265,3,1053,58,0,2,25,19,0
46035,355,7107,1457,730,1242,11,6,188,1468,10,292,166,329,302,495,2424,4078,5,22973,1276,1,2,28,23,0
46036,355,7107,74,35,59,1,0,14,75,3,14,7,14,17,21,58,85,1,128,7,0,2,28,23,0
46037,355,7107,245,125,200,5,7,34,250,7,30,17,34,37,51,166,265,3,1053,58,0,2,28,23,0
46038,1,301,382,65,130,157,2,92,539,4,10,5,10,14,15,41,57,2,114,6,0,2,6,5,0
46039,141,2980,1513,682,1277,25,13,200,1538,11,199,116,219,210,335,1557,2584,6,15641,868,0,2,14,4,1
46040,141,2980,819,519,539,24,98,155,843,15,96,57,106,111,163,690,1107,8,9171,509,0,2,14,4,1
46041,234,5348,4293,999,3693,19,54,507,4312,9,155,88,170,164,258,1156,1898,4,9368,520,0,2,1,1,1
46042,234,5348,1482,859,1002,125,135,219,1607,16,219,134,251,235,385,1766,3032,9,27804,1544,1,2,1,1,1
46045,234,5348,4293,999,3693,19,54,507,4312,9,155,88,170,164,258,1156,1898,4,9368,520,0,2,9,1,1
46046,234,5348,1482,859,1002,125,135,219,1607,16,219,134,251,235,385,1766,3032,9,27804,1544,1,2,9,1,1
46047,87,2475,1523,757,1297,19,12,193,1542,12,193,117,230,205,347,1508,2664,7,19053,1058,0,2,5,0,1
46048,87,2475,701,378,504,33,58,109,734,13,110,68,126,123,194,794,1346,7,10027,557,0,2,5,0,1
46049,75,1466,757,253,292,73,244,162,830,13,61,38,67,74,105,409,651,7,4654,258,0,2,3,2,0
46050,46,954,386,256,301,16,9,68,402,4,59,35,69,63,104,355,621,2,1453,80,0,2,5,8,0
46051,46,954,264,131,164,11,41,46,275,6,38,22,40,44,62,214,338,3,1068,59,0,2,5,8,0
46054,108,2219,1020,354,843,12,15,144,1032,8,134,77,144,142,221,970,1580,4,6792,377,0,2,15,0,0
46057,141,2980,1513,682,1277,25,13,200,1538,11,199,116,219,210,335,1557,2584,6,15641,868,0,2,2,3,1
46058,141,2980,819,519,539,24,98,155,843,15,96,57,106,111,163,690,1107,8,9171,509,0,2,2,3,1
46059,349,7017,1457,730,1242,11,6,188,1468,10,292,166,329,302,495,2424,4078,5,22973,1276,1,2,1,1,0
46060,349,7017,74,35,59,1,0,14,75,3,14,7,14,17,21,58,85,1,128,7,0,2,1,1,0
46061,349,7017,245,125,200,5,7,34,250,7,30,17,34,37,51,166,265,3,1053,58,0,2,1,1,0
46062,211,4427,1943,715,1694,26,18,214,1969,12,185,120,237,197,357,1436,2721,7,20915,1161,0,2,2,2,0
46063,211,4427,1168,838,957,57,25,144,1225,19,348,224,416,367,640,3018,5452,11,61921,3440,1,2,2,2,0
46064,79,1689,53,23,39,0,0,13,53,2,8,4,8,10,12,26,39,1,39,2,0,2,0,1,0
46065,79,1689,515,298,307,33,80,99,548,12,63,44,77,75,121,419,753,7,5527,307,0,2,0,1,0
46066,74,1565,402,202,227,24,74,80,426,12,52,33,61,64,94,339,564,7,3969,220,0,2,37,1,1
46067,68,1508,53,23,39,0,0,13,53,2,8,4,8,10,12,26,39,1,39,2,0,2,1,38,1
46068,68,1508,515,298,307,33,80,99,548,12,63,44,77,75,121,419,753,7,5527,307,0,2,1,38,1
46069,122,2921,77,34,69,0,0,8,77,3,24,16,29,27,45,114,213,1,387,21,0,2,1,4,1
46070,122,2921,712,438,573,51,9,84,763,14,102,71,128,116,199,733,1364,8,11988,666,0,2,1,4,1
46071,69,1540,53,23,39,0,0,13,53,2,8,4,8,10,12,26,39,1,39,2,0,2,29,25,1
46072,69,1540,515,298,307,33,80,99,548,12,63,44,77,75,121,419,753,7,5527,307,0,2,29,25,1
46073,16,1213,215,129,180,6,0,29,221,8,65,43,72,73,115,415,711,4,3153,175,0,2,1,1,1
46074,98,2008,773,419,590,28,0,166,801,10,204,113,217,214,330,1598,2554,5,13587,754,0,2,5,11,0
46075,98,2008,421,273,302,44,34,57,465,17,81,59,107,98,166,583,1098,11,12329,684,0,2,5,11,0
46076,213,4606,182,127,129,0,0,53,182,5,39,21,42,44,63,217,343,2,926,51,0,2,9,7,0
46077,213,4606,1165,710,800,67,119,181,1232,18,243,153,282,261,435,2000,3492,10,36473,2026,1,2,9,7,0
46078,74,1569,402,202,227,24,74,80,426,12,52,33,61,64,94,339,564,7,3969,220,0,2,14,13,0
46079,86,1823,773,419,590,28,0,166,801,10,204,113,217,214,330,1598,2554,5,13587,754,0,2,2,40,0
46080,86,1823,421,273,302,44,34,57,465,17,81,59,107,98,166,583,1098,11,12329,684,0,2,2,40,0
46081,85,1818,773,419,590,28,0,166,801,10,204,113,217,214,330,1598,2554,5,13587,754,0,2,0,2,0
46082,85,1818,421,273,302,44,34,57,465,17,81,59,107,98,166,583,1098,11,12329,684,0,2,0,2,0
46083,84,1807,773,419,590,28,0,166,801,10,204,113,217,214,330,1598,2554,5,13587,754,0,2,5,5,0
46084,84,1807,421,273,302,44,34,57,465,17,81,59,107,98,166,583,1098,11,12329,684,0,2,5,5,0
46085,84,1807,773,419,590,28,0,166,801,10,204,113,217,214,330,1598,2554,5,13587,754,0,2,1,2,0
46086,84,1807,421,273,302,44,34,57,465,17,81,59,107,98,166,583,1098,11,12329,684,0,2,1,2,0
46087,84,1807,773,419,590,28,0,166,801,10,204,113,217,214,330,1598,2554,5,13587,754,0,2,1,0,0
46088,84,1807,421,273,302,44,34,57,465,17,81,59,107,98,166,583,1098,11,12329,684,0,2,1,0,0
46089,357,7141,1457,730,1242,11,6,188,1468,10,292,166,329,302,495,2424,4078,5,22973,1276,1,2,6,0,0
46090,357,7141,74,35,59,1,0,14,75,3,14,7,14,17,21,58,85,1,128,7,0,2,6,0,0
46091,357,7141,245,125,200,5,7,34,250,7,30,17,34,37,51,166,265,3,1053,58,0,2,6,0,0
46093,15,742,75,38,59,1,3,12,76,2,4,2,4,6,6,10,15,1,15,0,0,2,67,0,0
46094,71,1698,996,429,845,24,10,117,1020,7,76,50,88,83,138,494,879,4,3565,198,0,2,29,18,1
46095,71,1698,456,277,329,12,42,72,468,13,85,50,97,98,147,592,972,7,7212,400,0,2,29,18,1
46096,36,2884,996,429,845,24,10,117,1020,7,76,50,88,83,138,494,879,4,3565,198,0,2,30,0,1
46097,46,963,447,308,343,6,5,95,453,7,96,59,111,103,170,651,1136,4,4600,255,0,2,1,1,0
46098,46,963,322,174,179,16,74,51,338,10,41,26,46,51,72,252,408,5,2291,127,0,2,1,1,0
46101,122,2921,77,34,69,0,0,8,77,3,24,16,29,27,45,114,213,1,387,21,0,2,1,4,0
46102,122,2921,712,438,573,51,9,84,763,14,102,71,128,116,199,733,1364,8,11988,666,0,2,1,4,0
46103,74,1569,402,202,227,24,74,80,426,12,52,33,61,64,94,339,564,7,3969,220,0,2,45,8,0
46104,69,1540,53,23,39,0,0,13,53,2,8,4,8,10,12,26,39,1,39,2,0,2,29,63,0
46105,69,1540,515,298,307,33,80,99,548,12,63,44,77,75,121,419,753,7,5527,307,0,2,29,63,0
46108,16,1213,215,129,180,6,0,29,221,8,65,43,72,73,115,415,711,4,3153,175,0,2,1,1,0
46109,13,572,139,89,101,2,0,35,141,7,54,34,62,61,96,330,569,4,2287,127,0,2,2,0,0
46110,80,2091,773,422,505,30,103,129,803,14,77,46,83,91,129,535,839,7,6334,351,0,2,11,2,0
46113,84,1807,773,419,590,28,0,166,801,10,204,113,217,214,330,1598,2554,5,13587,754,0,2,13,59,0
46114,84,1807,421,273,302,44,34,57,465,17,81,59,107,98,166,583,1098,11,12329,684,0,2,13,59,0
46115,213,4560,1943,715,1694,26,18,214,1969,12,185,120,237,197,357,1436,2721,7,20915,1161,0,2,37,5,0
46116,213,4560,1168,838,957,57,25,144,1225,19,348,224,416,367,640,3018,5452,11,61921,3440,1,2,37,5,0
46119,352,7059,1457,730,1242,11,6,188,1468,10,292,166,329,302,495,2424,4078,5,22973,1276,1,2,6,18,0
46120,352,7059,74,35,59,1,0,14,75,3,14,7,14,17,21,58,85,1,128,7,0,2,6,18,0
46121,352,7059,245,125,200,5,7,34,250,7,30,17,34,37,51,166,265,3,1053,58,0,2,6,18,0
46124,144,3005,1513,682,1277,25,13,200,1538,11,199,116,219,210,335,1557,2584,6,15641,868,0,2,13,2,1
46125,144,3005,819,519,539,24,98,155,843,15,96,57,106,111,163,690,1107,8,9171,509,0,2,13,2,1
46126,129,5195,1513,682,1277,25,13,200,1538,11,199,116,219,210,335,1557,2584,6,15641,868,0,2,24,0,1
46130,144,3005,1513,682,1277,25,13,200,1538,11,199,116,219,210,335,1557,2584,6,15641,868,0,2,13,2,0
46131,144,3005,819,519,539,24,98,155,843,15,96,57,106,111,163,690,1107,8,9171,509,0,2,13,2,0
46132,129,5195,1513,682,1277,25,13,200,1538,11,199,116,219,210,335,1557,2584,6,15641,868,0,2,24,0,0
46133,76,1523,757,253,292,73,244,162,830,13,61,38,67,74,105,409,651,7,4654,258,0,2,21,4,1
46134,53,3494,520,294,400,33,13,81,553,10,261,204,367,271,571,2128,4614,7,32445,1802,1,2,11,0,1
46135,80,1573,757,253,292,73,244,162,830,13,61,38,67,74,105,409,651,7,4654,258,0,2,10,5,1
46136,54,3601,520,294,400,33,13,81,553,10,261,204,367,271,571,2128,4614,7,32445,1802,1,2,11,0,1
46137,80,1590,757,253,292,73,244,162,830,13,61,38,67,74,105,409,651,7,4654,258,0,2,5,11,0
46138,144,3008,1513,682,1277,25,13,200,1538,11,199,116,219,210,335,1557,2584,6,15641,868,0,2,13,4,0
46139,144,3008,819,519,539,24,98,155,843,15,96,57,106,111,163,690,1107,8,9171,509,0,2,13,4,0
46145,234,5348,4293,999,3693,19,54,507,4312,9,155,88,170,164,258,1156,1898,4,9368,520,0,2,10,2,0
46146,234,5348,1482,859,1002,125,135,219,1607,16,219,134,251,235,385,1766,3032,9,27804,1544,1,2,10,2,0
46147,87,2475,1523,757,1297,19,12,193,1542,12,193,117,230,205,347,1508,2664,7,19053,1058,0,2,5,0,0
46148,87,2475,701,378,504,33,58,109,734,13,110,68,126,123,194,794,1346,7,10027,557,0,2,5,0,0
46158,80,1599,757,253,292,73,244,162,830,13,61,38,67,74,105,409,651,7,4654,258,0,2,8,4,0
46159,129,5207,1513,682,1277,25,13,200,1538,11,199,116,219,210,335,1557,2584,6,15641,868,0,2,4,2,0
46160,145,3016,1513,682,1277,25,13,200,1538,11,199,116,219,210,335,1557,2584,6,15641,868,0,2,4,1,0
46161,145,3016,819,519,539,24,98,155,843,15,96,57,106,111,163,690,1107,8,9171,509,0,2,4,1,0
46162,145,3018,1513,682,1277,25,13,200,1538,11,199,116,219,210,335,1557,2584,6,15641,868,0,2,1,1,0
46163,145,3018,819,519,539,24,98,155,843,15,96,57,106,111,163,690,1107,8,9171,509,0,2,1,1,0
46164,80,2091,773,422,505,30,103,129,803,14,77,46,83,91,129,535,839,7,6334,351,0,2,1,2,0
46166,77,1551,757,253,292,73,244,162,830,13,61,38,67,74,105,409,651,7,4654,258,0,2,8,12,1
46167,145,3018,1513,682,1277,25,13,200,1538,11,199,116,219,210,335,1557,2584,6,15641,868,0,2,5,2,0
46168,145,3018,819,519,539,24,98,155,843,15,96,57,106,111,163,690,1107,8,9171,509,0,2,5,2,0
46170,145,3018,1513,682,1277,25,13,200,1538,11,199,116,219,210,335,1557,2584,6,15641,868,0,2,31,8,0
46171,145,3018,819,519,539,24,98,155,843,15,96,57,106,111,163,690,1107,8,9171,509,0,2,31,8,0
46172,352,7059,1457,730,1242,11,6,188,1468,10,292,166,329,302,495,2424,4078,5,22973,1276,1,2,1,1,0
46173,352,7059,74,35,59,1,0,14,75,3,14,7,14,17,21,58,85,1,128,7,0,2,1,1,0
46174,352,7059,245,125,200,5,7,34,250,7,30,17,34,37,51,166,265,3,1053,58,0,2,1,1,0
46175,83,2145,1455,414,1257,16,76,112,1471,5,41,23,46,46,69,231,381,2,1069,59,0,2,1,1,0
46176,83,2145,669,365,481,22,61,110,691,15,103,63,122,118,185,747,1273,8,11311,628,0,2,1,1,0
46179,98,2670,1523,757,1297,19,12,193,1542,12,193,117,230,205,347,1508,2664,7,19053,1058,0,2,7,1,0
46180,98,2670,701,378,504,33,58,109,734,13,110,68,126,123,194,794,1346,7,10027,557,0,2,7,1,0
46181,86,2206,773,422,505,30,103,129,803,14,77,46,83,91,129,535,839,7,6334,351,0,2,10,2,0
46184,24,600,2,2,2,0,0,0,2,0,0,0,0,0,0,0,0,0,0,0,0,2,15,0,0
46198,24,600,99,48,90,1,3,5,100,0,0,0,0,0,0,0,0,0,0,0,0,2,15,0,0
46199,24,600,8,5,5,2,0,1,10,0,0,0,0,0,0,0,0,0,0,0,0,2,15,0,0
46200,24,600,1217,716,841,84,126,174,1301,14,185,118,215,199,333,1446,2542,8,20687,1149,0,2,15,0,0
46201,24,600,160,89,115,0,13,31,160,7,15,11,17,22,28,78,124,3,495,27,0,2,15,0,0
46202,24,600,10,10,9,9,0,0,19,0,0,0,0,0,0,0,0,0,0,0,0,2,15,0,0
46203,24,600,173,84,99,8,29,36,181,5,12,7,13,17,20,54,81,2,221,12,0,2,15,0,0
46204,24,600,3,1,1,3,0,0,6,0,0,0,0,0,0,0,0,0,0,0,0,2,15,0,0
46209,72,1450,757,253,292,73,244,162,830,13,61,38,67,74,105,409,651,7,4654,258,0,2,3,2,0
46216,129,5207,1513,682,1277,25,13,200,1538,11,199,116,219,210,335,1557,2584,6,15641,868,0,2,28,2,0
46217,77,1551,757,253,292,73,244,162,830,13,61,38,67,74,105,409,651,7,4654,258,0,2,34,18,0
46218,54,3601,520,294,400,33,13,81,553,10,261,204,367,271,571,2128,4614,7,32445,1802,1,2,22,0,0
46258,77,1551,757,253,292,73,244,162,830,13,61,38,67,74,105,409,651,7,4654,258,0,2,3,2,0
46360,71,1698,996,429,845,24,10,117,1020,7,76,50,88,83,138,494,879,4,3565,198,0,2,29,18,0
46361,71,1698,456,277,329,12,42,72,468,13,85,50,97,98,147,592,972,7,7212,400,0,2,29,18,0
46362,36,2884,996,429,845,24,10,117,1020,7,76,50,88,83,138,494,879,4,3565,198,0,2,30,0,0
46363,164,7206,139,89,101,2,0,35,141,7,54,34,62,61,96,330,569,4,2287,127,0,2,13,13,1
46364,164,7206,7,5,5,0,0,2,7,1,2,1,2,3,3,2,4,0,2,0,0,2,13,13,1
46365,236,5368,4293,999,3693,19,54,507,4312,9,155,88,170,164,258,1156,1898,4,9368,520,0,2,10,3,1
46366,236,5368,1482,859,1002,125,135,219,1607,16,219,134,251,235,385,1766,3032,9,27804,1544,1,2,10,3,1
46367,91,3852,1289,550,1043,56,32,155,1345,10,167,93,185,177,278,1266,2075,5,11498,638,0,2,24,0,1
46368,170,7554,139,89,101,2,0,35,141,7,54,34,62,61,96,330,569,4,2287,127,0,2,198,13,1
46369,170,7554,7,5,5,0,0,2,7,1,2,1,2,3,3,2,4,0,2,0,0,2,198,13,1
46370,354,7093,1457,730,1242,11,6,188,1468,10,292,166,329,302,495,2424,4078,5,22973,1276,1,2,6,0,0
46371,354,7093,74,35,59,1,0,14,75,3,14,7,14,17,21,58,85,1,128,7,0,2,6,0,0
46372,354,7093,245,125,200,5,7,34,250,7,30,17,34,37,51,166,265,3,1053,58,0,2,6,0,0
46375,236,5368,4293,999,3693,19,54,507,4312,9,155,88,170,164,258,1156,1898,4,9368,520,0,2,10,3,0
46376,236,5368,1482,859,1002,125,135,219,1607,16,219,134,251,235,385,1766,3032,9,27804,1544,1,2,10,3,0
46377,91,3852,1289,550,1043,56,32,155,1345,10,167,93,185,177,278,1266,2075,5,11498,638,0,2,24,0,0
46378,170,7554,139,89,101,2,0,35,141,7,54,34,62,61,96,330,569,4,2287,127,0,2,199,14,0
46379,170,7554,7,5,5,0,0,2,7,1,2,1,2,3,3,2,4,0,2,0,0,2,199,14,0
46427,209,4527,1943,715,1694,26,18,214,1969,12,185,120,237,197,357,1436,2721,7,20915,1161,0,2,2,10,0
46428,209,4527,1168,838,957,57,25,144,1225,19,348,224,416,367,640,3018,5452,11,61921,3440,1,2,2,10,0
46429,23,737,339,213,244,17,9,65,356,10,42,26,48,52,74,259,421,5,2410,133,0,2,6,0,0
46430,46,1902,1293,570,1093,25,15,163,1318,10,195,123,241,205,364,1516,2795,6,17273,959,0,2,25,0,0
46484,71,1698,996,429,845,24,10,117,1020,7,76,50,88,83,138,494,879,4,3565,198,0,2,72,18,0
46485,71,1698,456,277,329,12,42,72,468,13,85,50,97,98,147,592,972,7,7212,400,0,2,72,18,0
46486,354,7093,1457,730,1242,11,6,188,1468,10,292,166,329,302,495,2424,4078,5,22973,1276,1,2,54,45,0
46487,354,7093,74,35,59,1,0,14,75,3,14,7,14,17,21,58,85,1,128,7,0,2,54,45,0
46488,354,7093,245,125,200,5,7,34,250,7,30,17,34,37,51,166,265,3,1053,58,0,2,54,45,0
46493,236,5368,4293,999,3693,19,54,507,4312,9,155,88,170,164,258,1156,1898,4,9368,520,0,2,12,5,0
46494,236,5368,1482,859,1002,125,135,219,1607,16,219,134,251,235,385,1766,3032,9,27804,1544,1,2,12,5,0
46496,98,2670,1523,757,1297,19,12,193,1542,12,193,117,230,205,347,1508,2664,7,19053,1058,0,2,78,20,0
46497,98,2670,701,378,504,33,58,109,734,13,110,68,126,123,194,794,1346,7,10027,557,0,2,78,20,0
46498,86,2206,773,422,505,30,103,129,803,14,77,46,83,91,129,535,839,7,6334,351,0,2,30,3,0
46499,122,2921,77,34,69,0,0,8,77,3,24,16,29,27,45,114,213,1,387,21,0,2,27,4,0
46500,122,2921,712,438,573,51,9,84,763,14,102,71,128,116,199,733,1364,8,11988,666,0,2,27,4,0
46503,24,600,2,2,2,0,0,0,2,0,0,0,0,0,0,0,0,0,0,0,0,0,156,0,0
46517,24,600,99,48,90,1,3,5,100,0,0,0,0,0,0,0,0,0,0,0,0,0,156,0,0
46518,24,600,8,5,5,2,0,1,10,0,0,0,0,0,0,0,0,0,0,0,0,0,156,0,0
46519,24,600,1217,716,841,84,126,174,1301,14,185,118,215,199,333,1446,2542,8,20687,1149,0,0,156,0,0
46520,24,600,160,89,115,0,13,31,160,7,15,11,17,22,28,78,124,3,495,27,0,0,156,0,0
46521,24,600,10,10,9,9,0,0,19,0,0,0,0,0,0,0,0,0,0,0,0,0,156,0,0
46522,24,600,173,84,99,8,29,36,181,5,12,7,13,17,20,54,81,2,221,12,0,0,156,0,0
46523,24,600,3,1,1,3,0,0,6,0,0,0,0,0,0,0,0,0,0,0,0,0,156,0,0
46524,33,707,125,97,103,3,0,19,128,9,25,17,27,34,44,144,223,4,1087,60,0,0,126,0,0
46526,74,1569,402,202,227,24,74,80,426,12,52,33,61,64,94,339,564,7,3969,220,0,3,123,302,0
46527,69,1540,53,23,39,0,0,13,53,2,8,4,8,10,12,26,39,1,39,2,0,2,33,63,0
46528,69,1540,515,298,307,33,80,99,548,12,63,44,77,75,121,419,753,7,5527,307,0,2,33,63,0
46531,77,1551,757,253,292,73,244,162,830,13,61,38,67,74,105,409,651,7,4654,258,0,2,40,27,0
46532,113,2530,1043,504,840,53,9,147,1096,9,180,112,198,189,310,1377,2344,4,11604,644,0,2,14,2,0
46533,113,2530,383,288,292,26,6,62,409,11,65,38,67,76,105,429,656,5,3719,206,0,2,14,2,0
46534,71,1415,1178,367,1042,6,15,115,1184,9,94,51,95,103,146,644,976,4,4439,246,0,2,33,143,0
46535,71,1415,177,108,140,8,0,27,185,6,30,16,32,36,48,162,248,3,794,44,0,2,33,143,0
46536,209,4527,1943,715,1694,26,18,214,1969,12,185,120,237,197,357,1436,2721,7,20915,1161,0,2,61,25,0
46537,209,4527,1168,838,957,57,25,144,1225,19,348,224,416,367,640,3018,5452,11,61921,3440,1,2,61,25,0
46538,15,470,42,7,35,4,0,5,46,1,2,1,2,3,3,2,4,0,2,0,0,2,3,2,0
46539,15,470,11,6,10,0,0,1,11,2,4,2,4,6,6,10,15,1,15,0,0,2,3,2,0
46541,15,742,75,38,59,1,3,12,76,2,4,2,4,6,6,10,15,1,15,0,0,2,76,0,0
46542,29,1792,1157,318,931,29,22,177,1186,6,104,63,125,110,188,712,1274,3,4596,255,0,2,123,1,0
46546,36,2884,996,429,845,24,10,117,1020,7,76,50,88,83,138,494,879,4,3565,198,0,2,144,5,0
46548,94,4604,1523,757,1297,19,12,193,1542,12,193,117,230,205,347,1508,2664,7,19053,1058,0,2,28,11,0
46549,39,1946,1293,570,1093,25,15,163,1318,10,195,123,241,205,364,1516,2795,6,17273,959,0,2,36,0,0
46551,30,1233,373,158,315,8,0,51,381,5,76,44,79,81,123,486,779,2,2026,112,0,2,44,0,0
46552,77,3237,1178,367,1042,6,15,115,1184,9,94,51,95,103,146,644,976,4,4439,246,0,2,40,0,0
46553,91,4606,1943,715,1694,26,18,214,1969,12,185,120,237,197,357,1436,2721,7,20915,1161,0,2,88,13,0
46554,48,2177,1293,570,1093,25,15,163,1318,10,195,123,241,205,364,1516,2795,6,17273,959,0,2,75,6,1
46555,25,773,339,213,244,17,9,65,356,10,42,26,48,52,74,259,421,5,2410,133,0,2,8,0,0
46556,26,776,339,213,244,17,9,65,356,10,42,26,48,52,74,259,421,5,2410,133,0,2,2,1,0
46557,55,2398,1293,570,1093,25,15,163,1318,10,195,123,241,205,364,1516,2795,6,17273,959,0,2,53,0,0
46558,54,2391,1293,570,1093,25,15,163,1318,10,195,123,241,205,364,1516,2795,6,17273,959,0,2,8,14,1
46559,54,2391,1293,570,1093,25,15,163,1318,10,195,123,241,205,364,1516,2795,6,17273,959,0,2,1,1,0
46560,85,2188,773,422,505,30,103,129,803,14,77,46,83,91,129,535,839,7,6334,351,0,2,1,1,0
46561,31,1981,1157,318,931,29,22,177,1186,6,104,63,125,110,188,712,1274,3,4596,255,0,2,61,1,0
46562,26,776,339,213,244,17,9,65,356,10,42,26,48,52,74,259,421,5,2410,133,0,2,1,1,0
46563,54,2368,1293,570,1093,25,15,163,1318,10,195,123,241,205,364,1516,2795,6,17273,959,0,2,22,21,0
46564,86,2211,773,422,505,30,103,129,803,14,77,46,83,91,129,535,839,7,6334,351,0,2,1,1,0
46566,55,2425,1293,570,1093,25,15,163,1318,10,195,123,241,205,364,1516,2795,6,17273,959,0,2,24,0,0
46567,78,1583,757,253,292,73,244,162,830,13,61,38,67,74,105,409,651,7,4654,258,0,2,4,0,0
46568,22,606,256,139,192,9,7,47,265,4,23,12,24,27,36,112,171,2,357,19,0,2,5,0,0
46569,39,1724,386,256,301,16,9,68,402,4,59,35,69,63,104,355,621,2,1453,80,0,2,1,1,0
46570,78,1574,757,253,292,73,244,162,830,13,61,38,67,74,105,409,651,7,4654,258,0,2,1,1,0
46571,78,1574,757,253,292,73,244,162,830,13,61,38,67,74,105,409,651,7,4654,258,0,2,4,0,0
46574,55,2461,1293,570,1093,25,15,163,1318,10,195,123,241,205,364,1516,2795,6,17273,959,0,2,13,4,0
46577,24,600,2,2,2,0,0,0,2,0,0,0,0,0,0,0,0,0,0,0,0,2,2,1,0
46591,24,600,99,48,90,1,3,5,100,0,0,0,0,0,0,0,0,0,0,0,0,2,2,1,0
46592,24,600,8,5,5,2,0,1,10,0,0,0,0,0,0,0,0,0,0,0,0,2,2,1,0
46593,24,600,1217,716,841,84,126,174,1301,14,185,118,215,199,333,1446,2542,8,20687,1149,0,2,2,1,0
46594,24,600,160,89,115,0,13,31,160,7,15,11,17,22,28,78,124,3,495,27,0,2,2,1,0
46595,24,600,10,10,9,9,0,0,19,0,0,0,0,0,0,0,0,0,0,0,0,2,2,1,0
46596,24,600,173,84,99,8,29,36,181,5,12,7,13,17,20,54,81,2,221,12,0,2,2,1,0
46597,24,600,3,1,1,3,0,0,6,0,0,0,0,0,0,0,0,0,0,0,0,2,2,1,0
46598,56,2400,1293,570,1093,25,15,163,1318,10,195,123,241,205,364,1516,2795,6,17273,959,0,2,29,49,0
46622,80,1688,402,202,227,24,74,80,426,12,52,33,61,64,94,339,564,7,3969,220,0,2,25,0,1
46623,68,1556,53,23,39,0,0,13,53,2,8,4,8,10,12,26,39,1,39,2,0,2,9,6,1
46624,68,1556,515,298,307,33,80,99,548,12,63,44,77,75,121,419,753,7,5527,307,0,2,9,6,1
46625,260,6185,72,33,56,0,4,12,72,1,1,1,1,2,2,0,2,0,1,0,0,2,9,1,1
46626,260,6185,1454,835,1044,76,110,219,1530,17,275,158,296,292,454,2297,3718,9,34017,1889,1,2,9,1,1
46627,235,5354,4293,999,3693,19,54,507,4312,9,155,88,170,164,258,1156,1898,4,9368,520,0,2,1,4,0
46628,235,5354,1482,859,1002,125,135,219,1607,16,219,134,251,235,385,1766,3032,9,27804,1544,1,2,1,4,0
46629,30,655,125,97,103,3,0,19,128,9,25,17,27,34,44,144,223,4,1087,60,0,2,1,10,0
46630,82,3555,1020,354,843,12,15,144,1032,8,134,77,144,142,221,970,1580,4,6792,377,0,2,0,1,0
46631,82,3557,1020,354,843,12,15,144,1032,8,134,77,144,142,221,970,1580,4,6792,377,0,2,2,2,0
46632,30,657,125,97,103,3,0,19,128,9,25,17,27,34,44,144,223,4,1087,60,0,2,2,1,0
46634,237,5377,4293,999,3693,19,54,507,4312,9,155,88,170,164,258,1156,1898,4,9368,520,0,2,5,2,1
46635,237,5377,1482,859,1002,125,135,219,1607,16,219,134,251,235,385,1766,3032,9,27804,1544,1,2,5,2,1
46636,80,1706,402,202,227,24,74,80,426,12,52,33,61,64,94,339,564,7,3969,220,0,2,6,6,1
46637,261,6242,72,33,56,0,4,12,72,1,1,1,1,2,2,0,2,0,1,0,0,2,30,11,1
46638,261,6242,1454,835,1044,76,110,219,1530,17,275,158,296,292,454,2297,3718,9,34017,1889,1,2,30,11,1
46639,70,1373,1178,367,1042,6,15,115,1184,9,94,51,95,103,146,644,976,4,4439,246,0,2,6,10,1
46640,70,1373,177,108,140,8,0,27,185,6,30,16,32,36,48,162,248,3,794,44,0,2,6,10,1
46641,170,7555,139,89,101,2,0,35,141,7,54,34,62,61,96,330,569,4,2287,127,0,2,3,1,1
46642,170,7555,7,5,5,0,0,2,7,1,2,1,2,3,3,2,4,0,2,0,0,2,3,1,1
46643,138,5857,1782,648,1425,9,47,279,1791,8,171,97,189,179,286,1292,2140,4,9462,525,0,2,7,1,1
46644,82,3581,1020,354,843,12,15,144,1032,8,134,77,144,142,221,970,1580,4,6792,377,0,2,9,0,1
46645,262,6251,72,33,56,0,4,12,72,1,1,1,1,2,2,0,2,0,1,0,0,2,1,1,0
46646,262,6251,1454,835,1044,76,110,219,1530,17,275,158,296,292,454,2297,3718,9,34017,1889,1,2,1,1,0
46647,138,5861,1782,648,1425,9,47,279,1791,8,171,97,189,179,286,1292,2140,4,9462,525,0,2,6,6,0
46648,262,6251,72,33,56,0,4,12,72,1,1,1,1,2,2,0,2,0,1,0,0,2,2,1,1
46649,262,6251,1454,835,1044,76,110,219,1530,17,275,158,296,292,454,2297,3718,9,34017,1889,1,2,2,1,1
46650,78,1663,402,202,227,24,74,80,426,12,52,33,61,64,94,339,564,7,3969,220,0,2,3,9,0
46651,70,1570,53,23,39,0,0,13,53,2,8,4,8,10,12,26,39,1,39,2,0,2,4,2,0
46652,70,1570,515,298,307,33,80,99,548,12,63,44,77,75,121,419,753,7,5527,307,0,2,4,2,0
46653,78,1664,402,202,227,24,74,80,426,12,52,33,61,64,94,339,564,7,3969,220,0,2,8,0,1
46654,70,1570,53,23,39,0,0,13,53,2,8,4,8,10,12,26,39,1,39,2,0,2,4,1,1
46655,70,1570,515,298,307,33,80,99,548,12,63,44,77,75,121,419,753,7,5527,307,0,2,4,1,1
46656,78,1701,402,202,227,24,74,80,426,12,52,33,61,64,94,339,564,7,3969,220,0,2,14,7,1
46657,71,1575,53,23,39,0,0,13,53,2,8,4,8,10,12,26,39,1,39,2,0,2,4,3,1
46658,71,1575,515,298,307,33,80,99,548,12,63,44,77,75,121,419,753,7,5527,307,0,2,4,3,1
46659,22,452,601,196,481,2,23,85,603,8,63,36,72,71,108,400,664,4,3036,168,0,2,1,2,1
46660,22,452,156,79,106,5,16,28,161,5,14,8,15,19,23,64,97,2,261,14,0,2,1,2,1
46661,82,3585,1020,354,843,12,15,144,1032,8,134,77,144,142,221,970,1580,4,6792,377,0,2,2,1,1
46662,71,1575,53,23,39,0,0,13,53,2,8,4,8,10,12,26,39,1,39,2,0,2,1,0,0
46663,71,1575,515,298,307,33,80,99,548,12,63,44,77,75,121,419,753,7,5527,307,0,2,1,0,0
46664,236,5371,4293,999,3693,19,54,507,4312,9,155,88,170,164,258,1156,1898,4,9368,520,0,2,1,2,1
46665,236,5371,1482,859,1002,125,135,219,1607,16,219,134,251,235,385,1766,3032,9,27804,1544,1,2,1,2,1
46666,262,6251,72,33,56,0,4,12,72,1,1,1,1,2,2,0,2,0,1,0,0,2,4,0,0
46667,262,6251,1454,835,1044,76,110,219,1530,17,275,158,296,292,454,2297,3718,9,34017,1889,1,2,4,0,0
46668,79,1714,402,202,227,24,74,80,426,12,52,33,61,64,94,339,564,7,3969,220,0,2,3,0,0
46669,73,1606,53,23,39,0,0,13,53,2,8,4,8,10,12,26,39,1,39,2,0,2,14,1,0
46670,73,1606,515,298,307,33,80,99,548,12,63,44,77,75,121,419,753,7,5527,307,0,2,14,1,0
46671,77,1666,53,23,39,0,0,13,53,2,8,4,8,10,12,26,39,1,39,2,0,2,19,3,0
46672,77,1666,515,298,307,33,80,99,548,12,63,44,77,75,121,419,753,7,5527,307,0,2,19,3,0
46673,237,5376,4293,999,3693,19,54,507,4312,9,155,88,170,164,258,1156,1898,4,9368,520,0,2,1,1,1
46674,237,5376,1482,859,1002,125,135,219,1607,16,219,134,251,235,385,1766,3032,9,27804,1544,1,2,1,1,1
46675,32,665,125,97,103,3,0,19,128,9,25,17,27,34,44,144,223,4,1087,60,0,2,1,1,1
46676,75,1595,53,23,39,0,0,13,53,2,8,4,8,10,12,26,39,1,39,2,0,2,8,25,1
46677,75,1595,515,298,307,33,80,99,548,12,63,44,77,75,121,419,753,7,5527,307,0,2,8,25,1
46678,263,6257,72,33,56,0,4,12,72,1,1,1,1,2,2,0,2,0,1,0,0,2,6,5,1
46679,263,6257,1454,835,1044,76,110,219,1530,17,275,158,296,292,454,2297,3718,9,34017,1889,1,2,6,5,1
46680,71,1380,1178,367,1042,6,15,115,1184,9,94,51,95,103,146,644,976,4,4439,246,0,2,3,1,1
46681,71,1380,177,108,140,8,0,27,185,6,30,16,32,36,48,162,248,3,794,44,0,2,3,1,1
46682,23,458,601,196,481,2,23,85,603,8,63,36,72,71,108,400,664,4,3036,168,0,2,4,3,1
46683,23,458,156,79,106,5,16,28,161,5,14,8,15,19,23,64,97,2,261,14,0,2,4,3,1
46684,84,3593,1020,354,843,12,15,144,1032,8,134,77,144,142,221,970,1580,4,6792,377,0,2,1,1,1
46685,86,1809,477,336,357,30,23,73,507,16,194,134,250,210,384,1538,2962,10,30538,1696,0,2,5,1,1
46686,74,1594,402,202,227,24,74,80,426,12,52,33,61,64,94,339,564,7,3969,220,0,2,6,1,1
46687,86,1790,477,336,357,30,23,73,507,16,194,134,250,210,384,1538,2962,10,30538,1696,0,2,1,5,0
46688,54,1125,207,111,150,11,0,50,218,5,26,19,36,31,55,133,272,3,943,52,0,2,8,0,0
46689,54,1125,410,198,237,31,55,97,441,11,63,38,72,74,110,414,683,6,4293,238,0,2,8,0,0
46690,74,1567,402,202,227,24,74,80,426,12,52,33,61,64,94,339,564,7,3969,220,0,2,4,9,0
46691,51,595,647,139,84,35,284,233,682,0,0,0,0,0,0,0,0,0,0,0,0,2,3,2,0
46692,54,1125,207,111,150,11,0,50,218,5,26,19,36,31,55,133,272,3,943,52,0,2,2,2,0
46693,54,1125,410,198,237,31,55,97,441,11,63,38,72,74,110,414,683,6,4293,238,0,2,2,2,0
46695,263,6260,72,33,56,0,4,12,72,1,1,1,1,2,2,0,2,0,1,0,0,2,2,0,0
46696,263,6260,1454,835,1044,76,110,219,1530,17,275,158,296,292,454,2297,3718,9,34017,1889,1,2,2,0,0
46697,98,2655,1523,757,1297,19,12,193,1542,12,193,117,230,205,347,1508,2664,7,19053,1058,0,2,0,5,0
46698,98,2655,701,378,504,33,58,109,734,13,110,68,126,123,194,794,1346,7,10027,557,0,2,0,5,0
46699,86,1790,477,336,357,30,23,73,507,16,194,134,250,210,384,1538,2962,10,30538,1696,0,2,1,1,0
46702,74,1567,402,202,227,24,74,80,426,12,52,33,61,64,94,339,564,7,3969,220,0,2,4,4,0
46703,55,2371,1293,570,1093,25,15,163,1318,10,195,123,241,205,364,1516,2795,6,17273,959,0,2,0,7,0
46705,94,4602,1523,757,1297,19,12,193,1542,12,193,117,230,205,347,1508,2664,7,19053,1058,0,2,0,1,0
46706,55,2369,1293,570,1093,25,15,163,1318,10,195,123,241,205,364,1516,2795,6,17273,959,0,2,1,1,0
46707,15,470,42,7,35,4,0,5,46,1,2,1,2,3,3,2,4,0,2,0,0,2,1,1,1
46708,15,470,11,6,10,0,0,1,11,2,4,2,4,6,6,10,15,1,15,0,0,2,1,1,1
46709,15,470,42,7,35,4,0,5,46,1,2,1,2,3,3,2,4,0,2,0,0,2,1,1,0
46710,15,470,11,6,10,0,0,1,11,2,4,2,4,6,6,10,15,1,15,0,0,2,1,1,0
46711,113,2553,1043,504,840,53,9,147,1096,9,180,112,198,189,310,1377,2344,4,11604,644,0,2,2,1,1
46712,113,2553,383,288,292,26,6,62,409,11,65,38,67,76,105,429,656,5,3719,206,0,2,2,1,1
46713,79,3054,1043,504,840,53,9,147,1096,9,180,112,198,189,310,1377,2344,4,11604,644,0,2,14,5,1
46714,94,4591,1523,757,1297,19,12,193,1542,12,193,117,230,205,347,1508,2664,7,19053,1058,0,2,1,4,0
46715,79,1724,402,202,227,24,74,80,426,12,52,33,61,64,94,339,564,7,3969,220,0,2,13,3,0
46718,94,4591,1523,757,1297,19,12,193,1542,12,193,117,230,205,347,1508,2664,7,19053,1058,0,2,1,5,0
46719,79,1583,757,253,292,73,244,162,830,13,61,38,67,74,105,409,651,7,4654,258,0,2,5,4,1
46720,25,685,256,139,192,9,7,47,265,4,23,12,24,27,36,112,171,2,357,19,0,2,18,0,1
46721,80,1589,757,253,292,73,244,162,830,13,61,38,67,74,105,409,651,7,4654,258,0,2,1,1,0
46722,78,1591,757,253,292,73,244,162,830,13,61,38,67,74,105,409,651,7,4654,258,0,2,6,5,0
46723,78,1591,757,253,292,73,244,162,830,13,61,38,67,74,105,409,651,7,4654,258,0,2,1,1,0
46724,78,1591,757,253,292,73,244,162,830,13,61,38,67,74,105,409,651,7,4654,258,0,2,3,1,0
46725,25,685,256,139,192,9,7,47,265,4,23,12,24,27,36,112,171,2,357,19,0,2,18,0,0
46727,237,5376,4293,999,3693,19,54,507,4312,9,155,88,170,164,258,1156,1898,4,9368,520,0,2,6,7,0
46728,237,5376,1482,859,1002,125,135,219,1607,16,219,134,251,235,385,1766,3032,9,27804,1544,1,2,6,7,0
46729,32,665,125,97,103,3,0,19,128,9,25,17,27,34,44,144,223,4,1087,60,0,2,3,11,0
46730,79,1724,402,202,227,24,74,80,426,12,52,33,61,64,94,339,564,7,3969,220,0,2,63,16,0
46731,75,1595,53,23,39,0,0,13,53,2,8,4,8,10,12,26,39,1,39,2,0,2,29,7,0
46732,75,1595,515,298,307,33,80,99,548,12,63,44,77,75,121,419,753,7,5527,307,0,2,29,7,0
46733,263,6260,72,33,56,0,4,12,72,1,1,1,1,2,2,0,2,0,1,0,0,2,47,12,0
46734,263,6260,1454,835,1044,76,110,219,1530,17,275,158,296,292,454,2297,3718,9,34017,1889,1,2,47,12,0
46735,71,1380,1178,367,1042,6,15,115,1184,9,94,51,95,103,146,644,976,4,4439,246,0,2,8,10,0
46736,71,1380,177,108,140,8,0,27,185,6,30,16,32,36,48,162,248,3,794,44,0,2,8,10,0
46737,23,458,601,196,481,2,23,85,603,8,63,36,72,71,108,400,664,4,3036,168,0,2,4,4,0
46738,23,458,156,79,106,5,16,28,161,5,14,8,15,19,23,64,97,2,261,14,0,2,4,4,0
46739,170,7555,139,89,101,2,0,35,141,7,54,34,62,61,96,330,569,4,2287,127,0,2,3,1,0
46740,170,7555,7,5,5,0,0,2,7,1,2,1,2,3,3,2,4,0,2,0,0,2,3,1,0
46741,138,5861,1782,648,1425,9,47,279,1791,8,171,97,189,179,286,1292,2140,4,9462,525,0,2,8,2,0
46742,84,3593,1020,354,843,12,15,144,1032,8,134,77,144,142,221,970,1580,4,6792,377,0,2,13,4,0
46743,28,807,339,213,244,17,9,65,356,10,42,26,48,52,74,259,421,5,2410,133,0,2,15,0,0
46744,58,2553,1293,570,1093,25,15,163,1318,10,195,123,241,205,364,1516,2795,6,17273,959,0,2,148,0,0
46745,92,3882,1289,550,1043,56,32,155,1345,10,167,93,185,177,278,1266,2075,5,11498,638,0,2,30,0,0
46746,48,991,447,308,343,6,5,95,453,7,96,59,111,103,170,651,1136,4,4600,255,0,2,10,0,0
46747,48,991,322,174,179,16,74,51,338,10,41,26,46,51,72,252,408,5,2291,127,0,2,10,0,0
46748,38,1651,447,308,343,6,5,95,453,7,96,59,111,103,170,651,1136,4,4600,255,0,2,13,0,0
46778,79,1722,402,202,227,24,74,80,426,12,52,33,61,64,94,339,564,7,3969,220,0,2,3,3,0
46779,78,1591,757,253,292,73,244,162,830,13,61,38,67,74,105,409,651,7,4654,258,0,2,7,1,0
46782,25,685,256,139,192,9,7,47,265,4,23,12,24,27,36,112,171,2,357,19,0,2,23,0,0
46785,238,5409,4293,999,3693,19,54,507,4312,9,155,88,170,164,258,1156,1898,4,9368,520,0,2,7,3,1
46786,238,5409,1482,859,1002,125,135,219,1607,16,219,134,251,235,385,1766,3032,9,27804,1544,1,2,7,3,1
46787,131,3042,77,34,69,0,0,8,77,3,24,16,29,27,45,114,213,1,387,21,0,2,22,9,1
46788,131,3042,712,438,573,51,9,84,763,14,102,71,128,116,199,733,1364,8,11988,666,0,2,22,9,1
46789,279,6562,72,33,56,0,4,12,72,1,1,1,1,2,2,0,2,0,1,0,0,2,46,1,1
46790,279,6562,1454,835,1044,76,110,219,1530,17,275,158,296,292,454,2297,3718,9,34017,1889,1,2,46,1,1
46791,171,7658,139,89,101,2,0,35,141,7,54,34,62,61,96,330,569,4,2287,127,0,2,33,0,1
46792,171,7658,7,5,5,0,0,2,7,1,2,1,2,3,3,2,4,0,2,0,0,2,33,0,1
46793,73,3804,1296,573,1062,40,33,157,1336,8,201,118,231,209,349,1561,2689,4,12365,686,0,2,1,1,1
46794,30,1233,373,158,315,8,0,51,381,5,76,44,79,81,123,486,779,2,2026,112,0,2,1,1,1
46795,279,6562,72,33,56,0,4,12,72,1,1,1,1,2,2,0,2,0,1,0,0,2,1,0,0
46796,279,6562,1454,835,1044,76,110,219,1530,17,275,158,296,292,454,2297,3718,9,34017,1889,1,2,1,0,0
46797,15,483,42,7,35,4,0,5,46,1,2,1,2,3,3,2,4,0,2,0,0,2,4,0,0
46798,15,483,11,6,10,0,0,1,11,2,4,2,4,6,6,10,15,1,15,0,0,2,4,0,0
46837,113,2553,1043,504,840,53,9,147,1096,9,180,112,198,189,310,1377,2344,4,11604,644,0,2,2,1,0
46838,113,2553,383,288,292,26,6,62,409,11,65,38,67,76,105,429,656,5,3719,206,0,2,2,1,0
46840,79,3054,1043,504,840,53,9,147,1096,9,180,112,198,189,310,1377,2344,4,11604,644,0,2,14,5,0
46841,164,5028,1660,832,1314,41,38,274,1701,20,312,209,395,332,604,2671,5058,12,64042,3557,1,2,14,27,1
46842,164,5028,1057,646,719,113,100,145,1170,18,215,134,248,233,382,1740,3004,10,31186,1732,1,2,14,27,1
46843,15,472,42,7,35,4,0,5,46,1,2,1,2,3,3,2,4,0,2,0,0,2,1,0,1
46844,15,472,11,6,10,0,0,1,11,2,4,2,4,6,6,10,15,1,15,0,0,2,1,0,1
46845,155,4419,1660,832,1314,41,38,274,1701,20,312,209,395,332,604,2671,5058,12,64042,3557,1,2,6,6,1
46846,164,5028,1660,832,1314,41,38,274,1701,20,312,209,395,332,604,2671,5058,12,64042,3557,1,2,14,27,0
46847,164,5028,1057,646,719,113,100,145,1170,18,215,134,248,233,382,1740,3004,10,31186,1732,1,2,14,27,0
46848,15,472,42,7,35,4,0,5,46,1,2,1,2,3,3,2,4,0,2,0,0,2,1,0,0
46849,15,472,11,6,10,0,0,1,11,2,4,2,4,6,6,10,15,1,15,0,0,2,1,0,0
46850,155,4419,1660,832,1314,41,38,274,1701,20,312,209,395,332,604,2671,5058,12,64042,3557,1,2,6,6,0
46851,48,992,447,308,343,6,5,95,453,7,96,59,111,103,170,651,1136,4,4600,255,0,2,15,0,0
46852,48,992,322,174,179,16,74,51,338,10,41,26,46,51,72,252,408,5,2291,127,0,2,15,0,0
46853,38,1676,447,308,343,6,5,95,453,7,96,59,111,103,170,651,1136,4,4600,255,0,2,8,9,0
46854,27,951,74,35,59,1,0,14,75,3,14,7,14,17,21,58,85,1,128,7,0,2,2,1,1
46855,27,951,245,125,200,5,7,34,250,7,30,17,34,37,51,166,265,3,1053,58,0,2,2,1,1
46856,259,6121,72,33,56,0,4,12,72,1,1,1,1,2,2,0,2,0,1,0,0,2,2,1,1
46857,259,6121,1454,835,1044,76,110,219,1530,17,275,158,296,292,454,2297,3718,9,34017,1889,1,2,2,1,1
46858,58,1174,207,111,150,11,0,50,218,5,26,19,36,31,55,133,272,3,943,52,0,2,8,0,0
46859,58,1174,410,198,237,31,55,97,441,11,63,38,72,74,110,414,683,6,4293,238,0,2,8,0,0
46860,259,6152,72,33,56,0,4,12,72,1,1,1,1,2,2,0,2,0,1,0,0,2,11,7,0
46861,259,6152,1454,835,1044,76,110,219,1530,17,275,158,296,292,454,2297,3718,9,34017,1889,1,2,11,7,0
46862,139,5869,1782,648,1425,9,47,279,1791,8,171,97,189,179,286,1292,2140,4,9462,525,0,2,13,0,0
46863,27,951,74,35,59,1,0,14,75,3,14,7,14,17,21,58,85,1,128,7,0,2,2,1,0
46864,27,951,245,125,200,5,7,34,250,7,30,17,34,37,51,166,265,3,1053,58,0,2,2,1,0
46865,259,6121,72,33,56,0,4,12,72,1,1,1,1,2,2,0,2,0,1,0,0,2,2,1,0
46866,259,6121,1454,835,1044,76,110,219,1530,17,275,158,296,292,454,2297,3718,9,34017,1889,1,2,2,1,0
46867,132,3068,77,34,69,0,0,8,77,3,24,16,29,27,45,114,213,1,387,21,0,2,5,2,0
46868,132,3068,712,438,573,51,9,84,763,14,102,71,128,116,199,733,1364,8,11988,666,0,2,5,2,0
46869,97,4416,1338,495,1086,10,64,173,1348,11,122,82,157,133,239,883,1686,7,11934,663,0,2,1,1,0
46870,73,3806,1296,573,1062,40,33,157,1336,8,201,118,231,209,349,1561,2689,4,12365,686,0,2,1,1,0
46871,86,2206,773,422,505,30,103,129,803,14,77,46,83,91,129,535,839,7,6334,351,0,2,3,3,0
46915,15,472,42,7,35,4,0,5,46,1,2,1,2,3,3,2,4,0,2,0,0,2,2,1,0
46916,15,472,11,6,10,0,0,1,11,2,4,2,4,6,6,10,15,1,15,0,0,2,2,1,0
46921,122,2921,77,34,69,0,0,8,77,3,24,16,29,27,45,114,213,1,387,21,0,2,1,1,0
46922,122,2921,712,438,573,51,9,84,763,14,102,71,128,116,199,733,1364,8,11988,666,0,2,1,1,0
46925,48,992,447,308,343,6,5,95,453,7,96,59,111,103,170,651,1136,4,4600,255,0,2,25,0,0
46926,48,992,322,174,179,16,74,51,338,10,41,26,46,51,72,252,408,5,2291,127,0,2,25,0,0
46927,38,1676,447,308,343,6,5,95,453,7,96,59,111,103,170,651,1136,4,4600,255,0,2,12,0,0
46929,243,5487,4293,999,3693,19,54,507,4312,9,155,88,170,164,258,1156,1898,4,9368,520,0,2,16,1,1
46930,243,5487,1482,859,1002,125,135,219,1607,16,219,134,251,235,385,1766,3032,9,27804,1544,1,2,16,1,1
46931,75,1601,53,23,39,0,0,13,53,2,8,4,8,10,12,26,39,1,39,2,0,2,1,0,1
46932,75,1601,515,298,307,33,80,99,548,12,63,44,77,75,121,419,753,7,5527,307,0,2,1,0,1
46933,288,6751,72,33,56,0,4,12,72,1,1,1,1,2,2,0,2,0,1,0,0,2,34,3,1
46934,288,6751,1454,835,1044,76,110,219,1530,17,275,158,296,292,454,2297,3718,9,34017,1889,1,2,34,3,1
46938,244,5496,4293,999,3693,19,54,507,4312,9,155,88,170,164,258,1156,1898,4,9368,520,0,2,4,3,0
46939,244,5496,1482,859,1002,125,135,219,1607,16,219,134,251,235,385,1766,3032,9,27804,1544,1,2,4,3,0
46940,244,5495,4293,999,3693,19,54,507,4312,9,155,88,170,164,258,1156,1898,4,9368,520,0,2,2,2,0
46941,244,5495,1482,859,1002,125,135,219,1607,16,219,134,251,235,385,1766,3032,9,27804,1544,1,2,2,2,0
46942,140,3230,77,34,69,0,0,8,77,3,24,16,29,27,45,114,213,1,387,21,0,2,46,13,1
46943,140,3230,712,438,573,51,9,84,763,14,102,71,128,116,199,733,1364,8,11988,666,0,2,46,13,1
46945,76,1603,53,23,39,0,0,13,53,2,8,4,8,10,12,26,39,1,39,2,0,2,1,1,0
46946,76,1603,515,298,307,33,80,99,548,12,63,44,77,75,121,419,753,7,5527,307,0,2,1,1,0
46949,259,6153,72,33,56,0,4,12,72,1,1,1,1,2,2,0,2,0,1,0,0,2,11,7,0
46950,259,6153,1454,835,1044,76,110,219,1530,17,275,158,296,292,454,2297,3718,9,34017,1889,1,2,11,7,0
46952,150,6861,139,89,101,2,0,35,141,7,54,34,62,61,96,330,569,4,2287,127,0,2,8,0,1
46953,150,6861,7,5,5,0,0,2,7,1,2,1,2,3,3,2,4,0,2,0,0,2,8,0,1
46954,11,238,19,8,11,5,0,4,24,2,5,3,6,7,9,13,25,1,30,1,0,2,9,8,0
46955,11,238,102,59,69,5,3,24,107,6,22,15,28,28,43,113,206,3,789,43,0,2,9,8,0
46956,11,238,106,40,36,3,49,17,109,8,17,13,23,25,36,93,167,5,904,50,0,2,9,8,0
46957,213,4606,182,127,129,0,0,53,182,5,39,21,42,44,63,217,343,2,926,51,0,2,65,50,0
46958,213,4606,1165,710,800,67,119,181,1232,18,243,153,282,261,435,2000,3492,10,36473,2026,1,2,65,50,0
46959,84,1807,773,419,590,28,0,166,801,10,204,113,217,214,330,1598,2554,5,13587,754,0,2,51,100,0
46960,84,1807,421,273,302,44,34,57,465,17,81,59,107,98,166,583,1098,11,12329,684,0,2,51,100,0
46963,26,527,2,2,2,0,0,0,2,0,0,0,0,0,0,0,0,0,0,0,0,2,5,8,0
46977,26,527,99,48,90,1,3,5,100,0,0,0,0,0,0,0,0,0,0,0,0,2,5,8,0
46978,26,527,8,5,5,2,0,1,10,0,0,0,0,0,0,0,0,0,0,0,0,2,5,8,0
46979,26,527,1217,716,841,84,126,174,1301,14,185,118,215,199,333,1446,2542,8,20687,1149,0,2,5,8,0
46980,26,527,160,89,115,0,13,31,160,7,15,11,17,22,28,78,124,3,495,27,0,2,5,8,0
46981,26,527,10,10,9,9,0,0,19,0,0,0,0,0,0,0,0,0,0,0,0,2,5,8,0
46982,26,527,173,84,99,8,29,36,181,5,12,7,13,17,20,54,81,2,221,12,0,2,5,8,0
46983,26,527,3,1,1,3,0,0,6,0,0,0,0,0,0,0,0,0,0,0,0,2,5,8,0
46984,164,5028,1660,832,1314,41,38,274,1701,20,312,209,395,332,604,2671,5058,12,64042,3557,1,2,69,73,0
46985,164,5028,1057,646,719,113,100,145,1170,18,215,134,248,233,382,1740,3004,10,31186,1732,1,2,69,73,0
46987,86,1790,477,336,357,30,23,73,507,16,194,134,250,210,384,1538,2962,10,30538,1696,0,2,25,22,0
46988,71,1698,996,429,845,24,10,117,1020,7,76,50,88,83,138,494,879,4,3565,198,0,2,110,40,0
46989,71,1698,456,277,329,12,42,72,468,13,85,50,97,98,147,592,972,7,7212,400,0,2,110,40,0
46990,145,3018,1513,682,1277,25,13,200,1538,11,199,116,219,210,335,1557,2584,6,15641,868,0,2,257,93,0
46991,145,3018,819,519,539,24,98,155,843,15,96,57,106,111,163,690,1107,8,9171,509,0,2,257,93,0
46992,54,1125,207,111,150,11,0,50,218,5,26,19,36,31,55,133,272,3,943,52,0,2,98,74,0
46993,54,1125,410,198,237,31,55,97,441,11,63,38,72,74,110,414,683,6,4293,238,0,2,98,74,0
46994,354,7093,1457,730,1242,11,6,188,1468,10,292,166,329,302,495,2424,4078,5,22973,1276,1,2,167,150,0
46995,354,7093,74,35,59,1,0,14,75,3,14,7,14,17,21,58,85,1,128,7,0,2,167,150,0
46996,354,7093,245,125,200,5,7,34,250,7,30,17,34,37,51,166,265,3,1053,58,0,2,167,150,0
46997,28,807,339,213,244,17,9,65,356,10,42,26,48,52,74,259,421,5,2410,133,0,2,34,7,0
46999,83,2145,1455,414,1257,16,76,112,1471,5,41,23,46,46,69,231,381,2,1069,59,0,2,170,63,0
47000,83,2145,669,365,481,22,61,110,691,15,103,63,122,118,185,747,1273,8,11311,628,0,2,170,63,0
47001,238,5391,4293,999,3693,19,54,507,4312,9,155,88,170,164,258,1156,1898,4,9368,520,0,2,195,156,0
47002,238,5391,1482,859,1002,125,135,219,1607,16,219,134,251,235,385,1766,3032,9,27804,1544,1,2,195,156,0
47004,27,950,74,35,59,1,0,14,75,3,14,7,14,17,21,58,85,1,128,7,0,2,27,22,0
47005,27,950,245,125,200,5,7,34,250,7,30,17,34,37,51,166,265,3,1053,58,0,2,27,22,0
47006,51,595,647,139,84,35,284,233,682,0,0,0,0,0,0,0,0,0,0,0,0,2,237,38,0
47007,98,2655,1523,757,1297,19,12,193,1542,12,193,117,230,205,347,1508,2664,7,19053,1058,0,2,103,18,0
47008,98,2655,701,378,504,33,58,109,734,13,110,68,126,123,194,794,1346,7,10027,557,0,2,103,18,0
47009,86,2211,773,422,505,30,103,129,803,14,77,46,83,91,129,535,839,7,6334,351,0,0,522,0,0
47010,122,2921,77,34,69,0,0,8,77,3,24,16,29,27,45,114,213,1,387,21,0,2,148,399,0
47011,122,2921,712,438,573,51,9,84,763,14,102,71,128,116,199,733,1364,8,11988,666,0,2,148,399,0
47014,24,600,2,2,2,0,0,0,2,0,0,0,0,0,0,0,0,0,0,0,0,0,157,0,0
47028,24,600,99,48,90,1,3,5,100,0,0,0,0,0,0,0,0,0,0,0,0,0,157,0,0
47029,24,600,8,5,5,2,0,1,10,0,0,0,0,0,0,0,0,0,0,0,0,0,157,0,0
47030,24,600,1217,716,841,84,126,174,1301,14,185,118,215,199,333,1446,2542,8,20687,1149,0,0,157,0,0
47031,24,600,160,89,115,0,13,31,160,7,15,11,17,22,28,78,124,3,495,27,0,0,157,0,0
47032,24,600,10,10,9,9,0,0,19,0,0,0,0,0,0,0,0,0,0,0,0,0,157,0,0
47033,24,600,173,84,99,8,29,36,181,5,12,7,13,17,20,54,81,2,221,12,0,0,157,0,0
47034,24,600,3,1,1,3,0,0,6,0,0,0,0,0,0,0,0,0,0,0,0,0,157,0,0
47035,32,665,125,97,103,3,0,19,128,9,25,17,27,34,44,144,223,4,1087,60,0,0,118,0,0
47037,79,1722,402,202,227,24,74,80,426,12,52,33,61,64,94,339,564,7,3969,220,0,3,222,256,0
47038,48,992,447,308,343,6,5,95,453,7,96,59,111,103,170,651,1136,4,4600,255,0,2,34,10,0
47039,48,992,322,174,179,16,74,51,338,10,41,26,46,51,72,252,408,5,2291,127,0,2,34,10,0
47040,75,1595,53,23,39,0,0,13,53,2,8,4,8,10,12,26,39,1,39,2,0,0,392,0,0
47041,75,1595,515,298,307,33,80,99,548,12,63,44,77,75,121,419,753,7,5527,307,0,0,392,0,0
47042,23,382,424,94,331,4,0,89,428,1,5,5,5,6,10,11,25,0,12,0,0,2,4,4,0
47043,23,382,38,23,23,6,0,8,44,3,11,7,11,14,18,42,68,1,102,5,0,2,4,4,0
47044,20,509,205,80,86,16,53,53,221,7,18,10,19,25,29,94,134,3,497,27,0,0,147,0,0
47045,17,518,184,100,137,2,15,30,186,6,38,20,39,44,59,214,322,3,991,55,0,2,6,6,0
47046,17,518,103,65,74,8,5,16,111,7,17,9,17,24,26,89,119,3,417,23,0,2,6,6,0
47047,223,5307,722,423,573,19,0,135,741,12,172,101,199,184,300,1320,2257,6,15668,870,0,2,384,311,0
47048,223,5307,1508,847,911,44,250,301,1552,14,148,88,169,162,257,1120,1886,7,15077,837,0,2,384,311,0
47049,263,6260,72,33,56,0,4,12,72,1,1,1,1,2,2,0,2,0,1,0,0,2,233,160,0
47050,263,6260,1454,835,1044,76,110,219,1530,17,275,158,296,292,454,2297,3718,9,34017,1889,1,2,233,160,0
47051,78,1591,757,253,292,73,244,162,830,13,61,38,67,74,105,409,651,7,4654,258,0,2,377,153,0
47052,46,954,386,256,301,16,9,68,402,4,59,35,69,63,104,355,621,2,1453,80,0,2,45,16,0
47053,46,954,264,131,164,11,41,46,275,6,38,22,40,44,62,214,338,3,1068,59,0,2,45,16,0
47056,113,2530,1043,504,840,53,9,147,1096,9,180,112,198,189,310,1377,2344,4,11604,644,0,2,88,147,0
47057,113,2530,383,288,292,26,6,62,409,11,65,38,67,76,105,429,656,5,3719,206,0,2,88,147,0
47060,71,1380,1178,367,1042,6,15,115,1184,9,94,51,95,103,146,644,976,4,4439,246,0,2,91,186,0
47061,71,1380,177,108,140,8,0,27,185,6,30,16,32,36,48,162,248,3,794,44,0,2,91,186,0
47062,209,4527,1943,715,1694,26,18,214,1969,12,185,120,237,197,357,1436,2721,7,20915,1161,0,2,209,88,0
47063,209,4527,1168,838,957,57,25,144,1225,19,348,224,416,367,640,3018,5452,11,61921,3440,1,2,209,88,0
47064,16,480,442,244,305,14,16,103,456,11,68,45,75,79,120,452,756,6,4588,254,0,2,5,3,0
47065,16,480,182,102,99,11,40,35,193,3,11,6,11,14,17,42,64,1,97,5,0,2,5,3,0
47066,62,1222,1098,241,925,5,10,155,1103,7,46,25,49,53,74,273,423,3,1580,87,0,2,10,12,0
47067,62,1222,282,202,222,14,2,44,296,8,42,24,43,50,67,250,378,4,1548,86,0,2,10,12,0
47091,23,458,601,196,481,2,23,85,603,8,63,36,72,71,108,400,664,4,3036,168,0,2,13,5,0
47092,23,458,156,79,106,5,16,28,161,5,14,8,15,19,23,64,97,2,261,14,0,2,13,5,0
47144,15,472,42,7,35,4,0,5,46,1,2,1,2,3,3,2,4,0,2,0,0,2,47,15,0
47145,15,472,11,6,10,0,0,1,11,2,4,2,4,6,6,10,15,1,15,0,0,2,47,15,0
47169,91,3852,1289,550,1043,56,32,155,1345,10,167,93,185,177,278,1266,2075,5,11498,638,0,2,191,38,0
47170,36,1085,182,127,129,0,0,53,182,5,39,21,42,44,63,217,343,2,926,51,0,2,40,6,0
47171,147,6905,1392,870,1177,35,17,170,1427,14,494,280,531,508,811,4473,7289,7,54850,3047,2,2,121,72,0
47172,87,2871,773,419,590,28,0,166,801,10,204,113,217,214,330,1598,2554,5,13587,754,0,2,68,49,0
47173,15,742,75,38,59,1,3,12,76,2,4,2,4,6,6,10,15,1,15,0,0,2,128,2,0
47178,13,572,139,89,101,2,0,35,141,7,54,34,62,61,96,330,569,4,2287,127,0,0,122,0,0
47180,31,1981,1157,318,931,29,22,177,1186,6,104,63,125,110,188,712,1274,3,4596,255,0,0,777,0,0
47181,54,3601,520,294,400,33,13,81,553,10,261,204,367,271,571,2128,4614,7,32445,1802,1,2,212,109,0
47182,97,4416,1338,495,1086,10,64,173,1348,11,122,82,157,133,239,883,1686,7,11934,663,0,2,60,30,0
47183,172,7584,139,89,101,2,0,35,141,7,54,34,62,61,96,330,569,4,2287,127,0,2,656,253,0
47184,172,7584,7,5,5,0,0,2,7,1,2,1,2,3,3,2,4,0,2,0,0,2,656,253,0
47185,33,991,465,148,393,5,8,60,470,4,31,20,31,35,51,161,261,2,523,29,0,2,31,7,0
47186,33,991,16,12,9,0,0,6,16,1,2,1,2,3,3,2,4,0,2,0,0,2,31,7,0
47187,138,5861,1782,648,1425,9,47,279,1791,8,171,97,189,179,286,1292,2140,4,9462,525,0,2,158,78,0
47188,25,685,256,139,192,9,7,47,265,4,23,12,24,27,36,112,171,2,357,19,0,2,33,1,0
47190,23,577,102,59,69,5,3,24,107,6,22,15,28,28,43,113,206,3,789,43,0,2,26,18,0
47191,110,4156,1450,624,1228,12,26,181,1462,14,306,186,354,320,540,2580,4493,8,36391,2021,1,2,68,33,0
47192,155,4419,1660,832,1314,41,38,274,1701,20,312,209,395,332,604,2671,5058,12,64042,3557,1,2,78,43,0
47193,36,2884,996,429,845,24,10,117,1020,7,76,50,88,83,138,494,879,4,3565,198,0,0,744,0,0
47194,129,5207,1513,682,1277,25,13,200,1538,11,199,116,219,210,335,1557,2584,6,15641,868,0,2,218,57,0
47195,73,3804,1296,573,1062,40,33,157,1336,8,201,118,231,209,349,1561,2689,4,12365,686,0,2,108,29,0
47197,84,4429,1457,730,1242,11,6,188,1468,10,292,166,329,302,495,2424,4078,5,22973,1276,1,2,129,55,0
47198,39,2324,652,304,544,16,6,88,668,6,89,51,101,95,152,591,998,3,3399,188,0,2,67,56,0
47199,69,3184,1455,414,1257,16,76,112,1471,5,41,23,46,46,69,231,381,2,1069,59,0,2,102,13,0
47201,94,4591,1523,757,1297,19,12,193,1542,12,193,117,230,205,347,1508,2664,7,19053,1058,0,2,52,16,0
47202,84,3593,1020,354,843,12,15,144,1032,8,134,77,144,142,221,970,1580,4,6792,377,0,2,169,36,0
47203,38,1676,447,308,343,6,5,95,453,7,96,59,111,103,170,651,1136,4,4600,255,0,2,14,1,0
47205,21,661,424,94,331,4,0,89,428,1,5,5,5,6,10,11,25,0,12,0,0,2,45,35,0
47206,38,2301,334,251,279,10,4,40,344,5,127,74,143,132,217,899,1528,2,4303,239,0,2,17,19,0
47208,58,2553,1293,570,1093,25,15,163,1318,10,195,123,241,205,364,1516,2795,6,17273,959,0,2,227,15,0
47209,33,1886,384,251,317,7,8,52,391,11,70,44,84,81,128,467,811,6,5355,297,0,2,42,50,0
47210,45,2208,722,423,573,19,0,135,741,12,172,101,199,184,300,1320,2257,6,15668,870,0,2,254,10,0
47211,39,1724,386,256,301,16,9,68,402,4,59,35,69,63,104,355,621,2,1453,80,0,2,48,50,0
47212,16,1213,215,129,180,6,0,29,221,8,65,43,72,73,115,415,711,4,3153,175,0,2,12,12,0
47213,78,3015,1043,504,840,53,9,147,1096,9,180,112,198,189,310,1377,2344,4,11604,644,0,2,127,58,0
47214,14,529,295,56,236,0,4,54,295,2,9,5,10,11,15,30,51,1,57,3,0,2,17,5,0
47215,30,1233,373,158,315,8,0,51,381,5,76,44,79,81,123,486,779,2,2026,112,0,2,74,22,0
47216,77,3237,1178,367,1042,6,15,115,1184,9,94,51,95,103,146,644,976,4,4439,246,0,2,126,14,0
47217,91,4606,1943,715,1694,26,18,214,1969,12,185,120,237,197,357,1436,2721,7,20915,1161,0,2,321,48,0
47219,48,1750,1098,241,925,5,10,155,1103,7,46,25,49,53,74,273,423,3,1580,87,0,2,95,80,0
47220,19,679,601,196,481,2,23,85,603,8,63,36,72,71,108,400,664,4,3036,168,0,2,72,4,0
47221,238,5391,4293,999,3693,19,54,507,4312,9,155,88,170,164,258,1156,1898,4,9368,520,0,2,5,0,0
47222,238,5391,1482,859,1002,125,135,219,1607,16,219,134,251,235,385,1766,3032,9,27804,1544,1,2,5,0,0
47223,172,7584,139,89,101,2,0,35,141,7,54,34,62,61,96,330,569,4,2287,127,0,2,8,0,0
47224,172,7584,7,5,5,0,0,2,7,1,2,1,2,3,3,2,4,0,2,0,0,2,8,0,0
47225,172,7751,139,89,101,2,0,35,141,7,54,34,62,61,96,330,569,4,2287,127,0,2,47,5,1
47226,172,7751,7,5,5,0,0,2,7,1,2,1,2,3,3,2,4,0,2,0,0,2,47,5,1
47227,245,5510,4293,999,3693,19,54,507,4312,9,155,88,170,164,258,1156,1898,4,9368,520,0,2,5,0,0
47228,245,5510,1482,859,1002,125,135,219,1607,16,219,134,251,235,385,1766,3032,9,27804,1544,1,2,5,0,0
47229,174,7780,139,89,101,2,0,35,141,7,54,34,62,61,96,330,569,4,2287,127,0,2,8,0,0
47230,174,7780,7,5,5,0,0,2,7,1,2,1,2,3,3,2,4,0,2,0,0,2,8,0,0
47235,86,2211,773,422,505,30,103,129,803,14,77,46,83,91,129,535,839,7,6334,351,0,2,3,3,0
47238,263,6293,72,33,56,0,4,12,72,1,1,1,1,2,2,0,2,0,1,0,0,2,13,8,0
47239,263,6293,1454,835,1044,76,110,219,1530,17,275,158,296,292,454,2297,3718,9,34017,1889,1,2,13,8,0
47242,15,485,42,7,35,4,0,5,46,1,2,1,2,3,3,2,4,0,2,0,0,2,4,0,0
47243,15,485,11,6,10,0,0,1,11,2,4,2,4,6,6,10,15,1,15,0,0,2,4,0,0
47245,139,5894,1782,648,1425,9,47,279,1791,8,171,97,189,179,286,1292,2140,4,9462,525,0,2,13,0,0
47263,245,5514,4293,999,3693,19,54,507,4312,9,155,88,170,164,258,1156,1898,4,9368,520,0,2,1,1,0
47264,245,5514,1482,859,1002,125,135,219,1607,16,219,134,251,235,385,1766,3032,9,27804,1544,1,2,1,1,0
47270,140,3230,77,34,69,0,0,8,77,3,24,16,29,27,45,114,213,1,387,21,0,2,1,1,0
47271,140,3230,712,438,573,51,9,84,763,14,102,71,128,116,199,733,1364,8,11988,666,0,2,1,1,0
47272,288,6784,72,33,56,0,4,12,72,1,1,1,1,2,2,0,2,0,1,0,0,2,13,8,0
47273,288,6784,1454,835,1044,76,110,219,1530,17,275,158,296,292,454,2297,3718,9,34017,1889,1,2,13,8,0
47281,288,6780,72,33,56,0,4,12,72,1,1,1,1,2,2,0,2,0,1,0,0,2,1,1,0
47282,288,6780,1454,835,1044,76,110,219,1530,17,275,158,296,292,454,2297,3718,9,34017,1889,1,2,1,1,0
47283,245,5516,4293,999,3693,19,54,507,4312,9,155,88,170,164,258,1156,1898,4,9368,520,0,2,2,1,0
47284,245,5516,1482,859,1002,125,135,219,1607,16,219,134,251,235,385,1766,3032,9,27804,1544,1,2,2,1,0
47285,76,1597,53,23,39,0,0,13,53,2,8,4,8,10,12,26,39,1,39,2,0,2,0,1,0
47286,76,1597,515,298,307,33,80,99,548,12,63,44,77,75,121,419,753,7,5527,307,0,2,0,1,0
47287,28,807,339,213,244,17,9,65,356,10,42,26,48,52,74,259,421,5,2410,133,0,2,1,1,1
47288,114,2580,1043,504,840,53,9,147,1096,9,180,112,198,189,310,1377,2344,4,11604,644,0,2,8,4,1
47289,114,2580,383,288,292,26,6,62,409,11,65,38,67,76,105,429,656,5,3719,206,0,2,8,4,1
47290,59,2584,1293,570,1093,25,15,163,1318,10,195,123,241,205,364,1516,2795,6,17273,959,0,2,9,0,1
47291,59,2582,1293,570,1093,25,15,163,1318,10,195,123,241,205,364,1516,2795,6,17273,959,0,2,0,1,0
47292,22,351,102,57,55,5,16,25,107,5,17,10,18,22,28,81,124,2,330,18,0,2,3,8,0
47293,84,3593,1020,354,843,12,15,144,1032,8,134,77,144,142,221,970,1580,4,6792,377,0,2,1,1,0
47294,28,807,339,213,244,17,9,65,356,10,42,26,48,52,74,259,421,5,2410,133,0,2,1,1,0
47295,114,2580,1043,504,840,53,9,147,1096,9,180,112,198,189,310,1377,2344,4,11604,644,0,2,8,4,0
47296,114,2580,383,288,292,26,6,62,409,11,65,38,67,76,105,429,656,5,3719,206,0,2,8,4,0
47297,59,2582,1293,570,1093,25,15,163,1318,10,195,123,241,205,364,1516,2795,6,17273,959,0,2,8,0,0
47298,85,3690,1020,354,843,12,15,144,1032,8,134,77,144,142,221,970,1580,4,6792,377,0,2,32,0,0
47300,85,3690,1020,354,843,12,15,144,1032,8,134,77,144,142,221,970,1580,4,6792,377,0,2,33,1,0
47301,89,1841,477,336,357,30,23,73,507,16,194,134,250,210,384,1538,2962,10,30538,1696,0,2,18,2,1
47302,111,4196,1450,624,1228,12,26,181,1462,14,306,186,354,320,540,2580,4493,8,36391,2021,1,2,12,0,1
47303,89,1841,477,336,357,30,23,73,507,16,194,134,250,210,384,1538,2962,10,30538,1696,0,2,4,4,0
47304,89,1841,477,336,357,30,23,73,507,16,194,134,250,210,384,1538,2962,10,30538,1696,0,2,18,2,0
47305,111,4196,1450,624,1228,12,26,181,1462,14,306,186,354,320,540,2580,4493,8,36391,2021,1,2,12,0,0
47306,170,7554,139,89,101,2,0,35,141,7,54,34,62,61,96,330,569,4,2287,127,0,2,2,1,1
47307,170,7554,7,5,5,0,0,2,7,1,2,1,2,3,3,2,4,0,2,0,0,2,2,1,1
47308,170,7554,139,89,101,2,0,35,141,7,54,34,62,61,96,330,569,4,2287,127,0,2,2,1,0
47309,170,7554,7,5,5,0,0,2,7,1,2,1,2,3,3,2,4,0,2,0,0,2,2,1,0
47310,237,5388,4293,999,3693,19,54,507,4312,9,155,88,170,164,258,1156,1898,4,9368,520,0,2,1,1,0
47311,237,5388,1482,859,1002,125,135,219,1607,16,219,134,251,235,385,1766,3032,9,27804,1544,1,2,1,1,0
47312,30,659,125,97,103,3,0,19,128,9,25,17,27,34,44,144,223,4,1087,60,0,2,1,1,0
47313,76,1643,53,23,39,0,0,13,53,2,8,4,8,10,12,26,39,1,39,2,0,2,17,5,0
47314,76,1643,515,298,307,33,80,99,548,12,63,44,77,75,121,419,753,7,5527,307,0,2,17,5,0
47315,262,6289,72,33,56,0,4,12,72,1,1,1,1,2,2,0,2,0,1,0,0,2,2,3,0
47316,262,6289,1454,835,1044,76,110,219,1530,17,275,158,296,292,454,2297,3718,9,34017,1889,1,2,2,3,0
47317,70,1375,1178,367,1042,6,15,115,1184,9,94,51,95,103,146,644,976,4,4439,246,0,2,1,3,0
47318,70,1375,177,108,140,8,0,27,185,6,30,16,32,36,48,162,248,3,794,44,0,2,1,3,0
47319,22,454,601,196,481,2,23,85,603,8,63,36,72,71,108,400,664,4,3036,168,0,2,3,4,0
47320,22,454,156,79,106,5,16,28,161,5,14,8,15,19,23,64,97,2,261,14,0,2,3,4,0
47321,87,3808,1020,354,843,12,15,144,1032,8,134,77,144,142,221,970,1580,4,6792,377,0,2,30,3,0
47322,84,1807,773,419,590,28,0,166,801,10,204,113,217,214,330,1598,2554,5,13587,754,0,2,1,1,0
47323,84,1807,421,273,302,44,34,57,465,17,81,59,107,98,166,583,1098,11,12329,684,0,2,1,1,0
47326,58,1174,207,111,150,11,0,50,218,5,26,19,36,31,55,133,272,3,943,52,0,2,1,1,0
47327,58,1174,410,198,237,31,55,97,441,11,63,38,72,74,110,414,683,6,4293,238,0,2,1,1,0
47330,236,5368,4293,999,3693,19,54,507,4312,9,155,88,170,164,258,1156,1898,4,9368,520,0,2,2,2,0
47331,236,5368,1482,859,1002,125,135,219,1607,16,219,134,251,235,385,1766,3032,9,27804,1544,1,2,2,2,0
47332,122,2921,77,34,69,0,0,8,77,3,24,16,29,27,45,114,213,1,387,21,0,2,2,2,0
47333,122,2921,712,438,573,51,9,84,763,14,102,71,128,116,199,733,1364,8,11988,666,0,2,2,2,0
47334,74,1567,402,202,227,24,74,80,426,12,52,33,61,64,94,339,564,7,3969,220,0,2,2,2,0
47335,20,509,205,80,86,16,53,53,221,7,18,10,19,25,29,94,134,3,497,27,0,2,1,1,0
47336,259,6153,72,33,56,0,4,12,72,1,1,1,1,2,2,0,2,0,1,0,0,2,1,1,0
47337,259,6153,1454,835,1044,76,110,219,1530,17,275,158,296,292,454,2297,3718,9,34017,1889,1,2,1,1,0
47338,147,6905,1392,870,1177,35,17,170,1427,14,494,280,531,508,811,4473,7289,7,54850,3047,2,2,1,1,0
47339,170,7554,139,89,101,2,0,35,141,7,54,34,62,61,96,330,569,4,2287,127,0,2,1,1,0
47340,170,7554,7,5,5,0,0,2,7,1,2,1,2,3,3,2,4,0,2,0,0,2,1,1,0
47341,111,4196,1450,624,1228,12,26,181,1462,14,306,186,354,320,540,2580,4493,8,36391,2021,1,2,1,1,0
47342,129,5207,1513,682,1277,25,13,200,1538,11,199,116,219,210,335,1557,2584,6,15641,868,0,2,1,1,0
47343,39,2324,652,304,544,16,6,88,668,6,89,51,101,95,152,591,998,3,3399,188,0,2,1,1,0
47344,21,661,424,94,331,4,0,89,428,1,5,5,5,6,10,11,25,0,12,0,0,2,1,1,0
47345,6,136,44,22,19,0,19,6,44,2,10,6,12,12,18,35,64,1,77,4,0,2,1,1,0
47346,223,5307,722,423,573,19,0,135,741,12,172,101,199,184,300,1320,2257,6,15668,870,0,2,2,2,0
47347,223,5307,1508,847,911,44,250,301,1552,14,148,88,169,162,257,1120,1886,7,15077,837,0,2,2,2,0
47348,1,319,382,65,130,157,2,92,539,4,10,5,10,14,15,41,57,2,114,6,0,2,3,1,0
47376,76,1643,53,23,39,0,0,13,53,2,8,4,8,10,12,26,39,1,39,2,0,2,8,4,0
47377,76,1643,515,298,307,33,80,99,548,12,63,44,77,75,121,419,753,7,5527,307,0,2,8,4,0
47378,139,5880,1782,648,1425,9,47,279,1791,8,171,97,189,179,286,1292,2140,4,9462,525,0,2,1,0,0
47381,356,7105,1457,730,1242,11,6,188,1468,10,292,166,329,302,495,2424,4078,5,22973,1276,1,2,6,1,0
47382,356,7105,74,35,59,1,0,14,75,3,14,7,14,17,21,58,85,1,128,7,0,2,6,1,0
47383,356,7105,245,125,200,5,7,34,250,7,30,17,34,37,51,166,265,3,1053,58,0,2,6,1,0
47393,238,5391,4293,999,3693,19,54,507,4312,9,155,88,170,164,258,1156,1898,4,9368,520,0,2,2,2,0
47394,238,5391,1482,859,1002,125,135,219,1607,16,219,134,251,235,385,1766,3032,9,27804,1544,1,2,2,2,0
47398,79,1722,402,202,227,24,74,80,426,12,52,33,61,64,94,339,564,7,3969,220,0,2,2,2,0
47402,263,6293,72,33,56,0,4,12,72,1,1,1,1,2,2,0,2,0,1,0,0,2,1,1,0
47403,263,6293,1454,835,1044,76,110,219,1530,17,275,158,296,292,454,2297,3718,9,34017,1889,1,2,1,1,0
47406,172,7584,139,89,101,2,0,35,141,7,54,34,62,61,96,330,569,4,2287,127,0,2,3,2,0
47407,172,7584,7,5,5,0,0,2,7,1,2,1,2,3,3,2,4,0,2,0,0,2,3,2,0
47408,139,5905,1782,648,1425,9,47,279,1791,8,171,97,189,179,286,1292,2140,4,9462,525,0,2,1,0,0
47409,111,4196,1450,624,1228,12,26,181,1462,14,306,186,354,320,540,2580,4493,8,36391,2021,1,2,13,1,0
47446,76,1643,53,23,39,0,0,13,53,2,8,4,8,10,12,26,39,1,39,2,0,2,24,8,0
47447,76,1643,515,298,307,33,80,99,548,12,63,44,77,75,121,419,753,7,5527,307,0,2,24,8,0
47458,58,1178,207,111,150,11,0,50,218,5,26,19,36,31,55,133,272,3,943,52,0,2,2,2,0
47459,58,1178,410,198,237,31,55,97,441,11,63,38,72,74,110,414,683,6,4293,238,0,2,2,2,0
47460,78,1593,757,253,292,73,244,162,830,13,61,38,67,74,105,409,651,7,4654,258,0,2,1,1,0
47476,213,4606,182,127,129,0,0,53,182,5,39,21,42,44,63,217,343,2,926,51,0,2,1,1,1
47477,213,4606,1165,710,800,67,119,181,1232,18,243,153,282,261,435,2000,3492,10,36473,2026,1,2,1,1,1
47478,164,5028,1660,832,1314,41,38,274,1701,20,312,209,395,332,604,2671,5058,12,64042,3557,1,2,2,2,1
47479,164,5028,1057,646,719,113,100,145,1170,18,215,134,248,233,382,1740,3004,10,31186,1732,1,2,2,2,1
47481,89,1831,477,336,357,30,23,73,507,16,194,134,250,210,384,1538,2962,10,30538,1696,0,2,4,4,1
47482,145,3014,1513,682,1277,25,13,200,1538,11,199,116,219,210,335,1557,2584,6,15641,868,0,2,2,2,1
47483,145,3014,819,519,539,24,98,155,843,15,96,57,106,111,163,690,1107,8,9171,509,0,2,2,2,1
47484,356,7105,1457,730,1242,11,6,188,1468,10,292,166,329,302,495,2424,4078,5,22973,1276,1,2,4,4,1
47485,356,7105,74,35,59,1,0,14,75,3,14,7,14,17,21,58,85,1,128,7,0,2,4,4,1
47486,356,7105,245,125,200,5,7,34,250,7,30,17,34,37,51,166,265,3,1053,58,0,2,4,4,1
47487,237,5388,4293,999,3693,19,54,507,4312,9,155,88,170,164,258,1156,1898,4,9368,520,0,2,7,7,1
47488,237,5388,1482,859,1002,125,135,219,1607,16,219,134,251,235,385,1766,3032,9,27804,1544,1,2,7,7,1
47489,86,2211,773,422,505,30,103,129,803,14,77,46,83,91,129,535,839,7,6334,351,0,2,2,2,1
47490,122,2921,77,34,69,0,0,8,77,3,24,16,29,27,45,114,213,1,387,21,0,2,1,1,1
47491,122,2921,712,438,573,51,9,84,763,14,102,71,128,116,199,733,1364,8,11988,666,0,2,1,1,1
47492,22,350,102,57,55,5,16,25,107,5,17,10,18,22,28,81,124,2,330,18,0,2,1,1,1
47493,79,1722,402,202,227,24,74,80,426,12,52,33,61,64,94,339,564,7,3969,220,0,2,1,1,1
47494,20,509,205,80,86,16,53,53,221,7,18,10,19,25,29,94,134,3,497,27,0,2,1,1,1
47495,223,5301,722,423,573,19,0,135,741,12,172,101,199,184,300,1320,2257,6,15668,870,0,2,1,1,1
47496,223,5301,1508,847,911,44,250,301,1552,14,148,88,169,162,257,1120,1886,7,15077,837,0,2,1,1,1
47497,262,6289,72,33,56,0,4,12,72,1,1,1,1,2,2,0,2,0,1,0,0,2,6,6,1
47498,262,6289,1454,835,1044,76,110,219,1530,17,275,158,296,292,454,2297,3718,9,34017,1889,1,2,6,6,1
47499,78,1590,757,253,292,73,244,162,830,13,61,38,67,74,105,409,651,7,4654,258,0,2,9,9,1
47500,46,954,386,256,301,16,9,68,402,4,59,35,69,63,104,355,621,2,1453,80,0,2,5,5,1
47501,46,954,264,131,164,11,41,46,275,6,38,22,40,44,62,214,338,3,1068,59,0,2,5,5,1
47502,114,2575,1043,504,840,53,9,147,1096,9,180,112,198,189,310,1377,2344,4,11604,644,0,2,3,3,1
47503,114,2575,383,288,292,26,6,62,409,11,65,38,67,76,105,429,656,5,3719,206,0,2,3,3,1
47506,70,1375,1178,367,1042,6,15,115,1184,9,94,51,95,103,146,644,976,4,4439,246,0,2,2,2,1
47507,70,1375,177,108,140,8,0,27,185,6,30,16,32,36,48,162,248,3,794,44,0,2,2,2,1
47508,60,1082,282,196,195,3,0,86,285,8,130,71,141,138,212,936,1507,4,6538,363,0,2,1,1,1
47509,92,3882,1289,550,1043,56,32,155,1345,10,167,93,185,177,278,1266,2075,5,11498,638,0,2,2,2,1
47510,147,6905,1392,870,1177,35,17,170,1427,14,494,280,531,508,811,4473,7289,7,54850,3047,2,2,2,2,1
47511,15,742,75,38,59,1,3,12,76,2,4,2,4,6,6,10,15,1,15,0,0,2,1,1,1
47512,31,1981,1157,318,931,29,22,177,1186,6,104,63,125,110,188,712,1274,3,4596,255,0,2,4,4,1
47513,54,3601,520,294,400,33,13,81,553,10,261,204,367,271,571,2128,4614,7,32445,1802,1,2,1,1,1
47514,172,7584,139,89,101,2,0,35,141,7,54,34,62,61,96,330,569,4,2287,127,0,2,9,9,1
47515,172,7584,7,5,5,0,0,2,7,1,2,1,2,3,3,2,4,0,2,0,0,2,9,9,1
47516,139,5902,1782,648,1425,9,47,279,1791,8,171,97,189,179,286,1292,2140,4,9462,525,0,2,3,3,1
47517,25,685,256,139,192,9,7,47,265,4,23,12,24,27,36,112,171,2,357,19,0,2,3,3,1
47518,111,4179,1450,624,1228,12,26,181,1462,14,306,186,354,320,540,2580,4493,8,36391,2021,1,2,6,6,1
47519,84,4426,1457,730,1242,11,6,188,1468,10,292,166,329,302,495,2424,4078,5,22973,1276,1,2,1,1,1
47520,69,3180,1455,414,1257,16,76,112,1471,5,41,23,46,46,69,231,381,2,1069,59,0,2,5,5,1
47521,94,4585,1523,757,1297,19,12,193,1542,12,193,117,230,205,347,1508,2664,7,19053,1058,0,2,3,3,1
47522,87,3802,1020,354,843,12,15,144,1032,8,134,77,144,142,221,970,1580,4,6792,377,0,2,3,3,1
47523,38,2298,334,251,279,10,4,40,344,5,127,74,143,132,217,899,1528,2,4303,239,0,2,1,1,1
47524,3,42,14,8,8,0,0,6,14,0,0,0,0,0,0,0,0,0,0,0,0,2,0,1,0
47525,7,114,44,19,17,0,16,11,44,3,14,7,14,17,21,58,85,1,128,7,0,2,0,1,0
47526,6,71,127,75,83,2,11,30,129,4,14,7,14,18,21,61,87,2,175,9,0,2,0,3,0
47527,6,71,652,304,544,16,6,88,668,6,89,51,101,95,152,591,998,3,3399,188,0,2,0,3,0
47528,6,71,2,2,2,0,0,0,2,0,0,0,0,0,0,0,0,0,0,0,0,2,0,3,0
47529,6,71,8,5,5,0,0,3,8,0,0,0,0,0,0,0,0,0,0,0,0,2,0,3,0
47532,6,71,14,8,8,0,0,6,14,0,0,0,0,0,0,0,0,0,0,0,0,2,0,3,0
47533,6,71,6,4,4,0,0,2,6,0,0,0,0,0,0,0,0,0,0,0,0,2,0,3,0
47534,6,71,6,4,4,0,0,2,6,1,2,1,2,3,3,2,4,0,2,0,0,2,0,3,0
47536,6,71,7,5,5,0,0,2,7,0,0,0,0,0,0,0,0,0,0,0,0,2,0,3,0
47538,6,71,10,6,6,0,0,4,10,0,0,0,0,0,0,0,0,0,0,0,0,2,0,3,0
47539,6,71,1,1,1,0,0,0,1,0,0,0,0,0,0,0,0,0,0,0,0,2,0,3,0
47541,6,71,14,10,10,0,0,4,14,1,1,1,1,2,2,0,2,0,1,0,0,2,0,3,0
47542,6,71,46,26,30,3,0,12,49,3,6,3,6,9,9,20,28,1,42,2,0,2,0,3,0
47544,237,5388,4293,999,3693,19,54,507,4312,9,155,88,170,164,258,1156,1898,4,9368,520,0,2,4,4,0
47545,237,5388,1482,859,1002,125,135,219,1607,16,219,134,251,235,385,1766,3032,9,27804,1544,1,2,4,4,0
47546,46,954,386,256,301,16,9,68,402,4,59,35,69,63,104,355,621,2,1453,80,0,2,6,4,0
47547,46,954,264,131,164,11,41,46,275,6,38,22,40,44,62,214,338,3,1068,59,0,2,6,4,0
47548,87,3802,1020,354,843,12,15,144,1032,8,134,77,144,142,221,970,1580,4,6792,377,0,2,4,2,0
47572,11,238,19,8,11,5,0,4,24,2,5,3,6,7,9,13,25,1,30,1,0,2,10,6,1
47573,11,238,102,59,69,5,3,24,107,6,22,15,28,28,43,113,206,3,789,43,0,2,10,6,1
47574,11,238,106,40,36,3,49,17,109,8,17,13,23,25,36,93,167,5,904,50,0,2,10,6,1
47575,213,4611,182,127,129,0,0,53,182,5,39,21,42,44,63,217,343,2,926,51,0,2,121,61,1
47576,213,4611,1165,710,800,67,119,181,1232,18,243,153,282,261,435,2000,3492,10,36473,2026,1,2,121,61,1
47577,83,1808,773,419,590,28,0,166,801,10,204,113,217,214,330,1598,2554,5,13587,754,0,2,32,18,1
47578,83,1808,421,273,302,44,34,57,465,17,81,59,107,98,166,583,1098,11,12329,684,0,2,32,18,1
47581,26,525,2,2,2,0,0,0,2,0,0,0,0,0,0,0,0,0,0,0,0,2,21,16,1
47595,26,525,99,48,90,1,3,5,100,0,0,0,0,0,0,0,0,0,0,0,0,2,21,16,1
47596,26,525,8,5,5,2,0,1,10,0,0,0,0,0,0,0,0,0,0,0,0,2,21,16,1
47597,26,525,1217,716,841,84,126,174,1301,14,185,118,215,199,333,1446,2542,8,20687,1149,0,2,21,16,1
47598,26,525,160,89,115,0,13,31,160,7,15,11,17,22,28,78,124,3,495,27,0,2,21,16,1
47599,26,525,10,10,9,9,0,0,19,0,0,0,0,0,0,0,0,0,0,0,0,2,21,16,1
47600,26,525,173,84,99,8,29,36,181,5,12,7,13,17,20,54,81,2,221,12,0,2,21,16,1
47601,26,525,3,1,1,3,0,0,6,0,0,0,0,0,0,0,0,0,0,0,0,2,21,16,1
47602,164,5032,1660,832,1314,41,38,274,1701,20,312,209,395,332,604,2671,5058,12,64042,3557,1,2,76,56,1
47603,164,5032,1057,646,719,113,100,145,1170,18,215,134,248,233,382,1740,3004,10,31186,1732,1,2,76,56,1
47604,17,344,95,58,50,9,16,20,104,12,33,24,45,45,69,209,378,8,3100,172,0,2,6,9,1
47605,89,1830,477,336,357,30,23,73,507,16,194,134,250,210,384,1538,2962,10,30538,1696,0,2,79,61,1
47606,71,1702,996,429,845,24,10,117,1020,7,76,50,88,83,138,494,879,4,3565,198,0,2,65,41,1
47607,71,1702,456,277,329,12,42,72,468,13,85,50,97,98,147,592,972,7,7212,400,0,2,65,41,1
47608,145,3016,1513,682,1277,25,13,200,1538,11,199,116,219,210,335,1557,2584,6,15641,868,0,2,58,40,1
47609,145,3016,819,519,539,24,98,155,843,15,96,57,106,111,163,690,1107,8,9171,509,0,2,58,40,1
47610,58,1177,207,111,150,11,0,50,218,5,26,19,36,31,55,133,272,3,943,52,0,2,77,47,1
47611,58,1177,410,198,237,31,55,97,441,11,63,38,72,74,110,414,683,6,4293,238,0,2,77,47,1
47612,356,7117,1457,730,1242,11,6,188,1468,10,292,166,329,302,495,2424,4078,5,22973,1276,1,2,248,177,1
47613,356,7117,74,35,59,1,0,14,75,3,14,7,14,17,21,58,85,1,128,7,0,2,248,177,1
47614,356,7117,245,125,200,5,7,34,250,7,30,17,34,37,51,166,265,3,1053,58,0,2,248,177,1
47615,28,809,339,213,244,17,9,65,356,10,42,26,48,52,74,259,421,5,2410,133,0,2,23,11,1
47617,84,2154,1455,414,1257,16,76,112,1471,5,41,23,46,46,69,231,381,2,1069,59,0,2,138,85,1
47618,84,2154,669,365,481,22,61,110,691,15,103,63,122,118,185,747,1273,8,11311,628,0,2,138,85,1
47619,237,5395,4293,999,3693,19,54,507,4312,9,155,88,170,164,258,1156,1898,4,9368,520,0,2,139,82,1
47620,237,5395,1482,859,1002,125,135,219,1607,16,219,134,251,235,385,1766,3032,9,27804,1544,1,2,139,82,1
47621,6,136,44,22,19,0,19,6,44,2,10,6,12,12,18,35,64,1,77,4,0,2,5,3,1
47622,27,959,74,35,59,1,0,14,75,3,14,7,14,17,21,58,85,1,128,7,0,2,77,50,1
47623,27,959,245,125,200,5,7,34,250,7,30,17,34,37,51,166,265,3,1053,58,0,2,77,50,1
47624,51,595,647,139,84,35,284,233,682,0,0,0,0,0,0,0,0,0,0,0,0,2,11,0,1
47625,98,2661,1523,757,1297,19,12,193,1542,12,193,117,230,205,347,1508,2664,7,19053,1058,0,2,142,110,1
47626,98,2661,701,378,504,33,58,109,734,13,110,68,126,123,194,794,1346,7,10027,557,0,2,142,110,1
47627,86,2225,773,422,505,30,103,129,803,14,77,46,83,91,129,535,839,7,6334,351,0,2,155,102,1
47628,122,2937,77,34,69,0,0,8,77,3,24,16,29,27,45,114,213,1,387,21,0,2,152,75,1
47629,122,2937,712,438,573,51,9,84,763,14,102,71,128,116,199,733,1364,8,11988,666,0,2,152,75,1
47632,24,605,2,2,2,0,0,0,2,0,0,0,0,0,0,0,0,0,0,0,0,2,45,28,1
47646,24,605,99,48,90,1,3,5,100,0,0,0,0,0,0,0,0,0,0,0,0,2,45,28,1
47647,24,605,8,5,5,2,0,1,10,0,0,0,0,0,0,0,0,0,0,0,0,2,45,28,1
47648,24,605,1217,716,841,84,126,174,1301,14,185,118,215,199,333,1446,2542,8,20687,1149,0,2,45,28,1
47649,24,605,160,89,115,0,13,31,160,7,15,11,17,22,28,78,124,3,495,27,0,2,45,28,1
47650,24,605,10,10,9,9,0,0,19,0,0,0,0,0,0,0,0,0,0,0,0,2,45,28,1
47651,24,605,173,84,99,8,29,36,181,5,12,7,13,17,20,54,81,2,221,12,0,2,45,28,1
47652,24,605,3,1,1,3,0,0,6,0,0,0,0,0,0,0,0,0,0,0,0,2,45,28,1
47653,30,658,125,97,103,3,0,19,128,9,25,17,27,34,44,144,223,4,1087,60,0,2,23,20,1
47654,22,350,102,57,55,5,16,25,107,5,17,10,18,22,28,81,124,2,330,18,0,2,7,2,1
47655,79,1721,402,202,227,24,74,80,426,12,52,33,61,64,94,339,564,7,3969,220,0,2,36,33,1
47656,48,992,447,308,343,6,5,95,453,7,96,59,111,103,170,651,1136,4,4600,255,0,2,17,17,1
47657,48,992,322,174,179,16,74,51,338,10,41,26,46,51,72,252,408,5,2291,127,0,2,17,17,1
47658,72,1644,53,23,39,0,0,13,53,2,8,4,8,10,12,26,39,1,39,2,0,2,27,16,1
47659,72,1644,515,298,307,33,80,99,548,12,63,44,77,75,121,419,753,7,5527,307,0,2,27,16,1
47660,23,381,424,94,331,4,0,89,428,1,5,5,5,6,10,11,25,0,12,0,0,2,14,14,1
47661,23,381,38,23,23,6,0,8,44,3,11,7,11,14,18,42,68,1,102,5,0,2,14,14,1
47662,20,511,205,80,86,16,53,53,221,7,18,10,19,25,29,94,134,3,497,27,0,2,23,13,1
47663,17,519,184,100,137,2,15,30,186,6,38,20,39,44,59,214,322,3,991,55,0,2,30,21,1
47664,17,519,103,65,74,8,5,16,111,7,17,9,17,24,26,89,119,3,417,23,0,2,30,21,1
47665,226,5309,722,423,573,19,0,135,741,12,172,101,199,184,300,1320,2257,6,15668,870,0,2,124,76,1
47666,226,5309,1508,847,911,44,250,301,1552,14,148,88,169,162,257,1120,1886,7,15077,837,0,2,124,76,1
47667,285,6295,72,33,56,0,4,12,72,1,1,1,1,2,2,0,2,0,1,0,0,2,275,166,1
47668,285,6295,1454,835,1044,76,110,219,1530,17,275,158,296,292,454,2297,3718,9,34017,1889,1,2,275,166,1
47669,78,1590,757,253,292,73,244,162,830,13,61,38,67,74,105,409,651,7,4654,258,0,2,42,24,1
47670,46,955,386,256,301,16,9,68,402,4,59,35,69,63,104,355,621,2,1453,80,0,2,21,13,1
47671,46,955,264,131,164,11,41,46,275,6,38,22,40,44,62,214,338,3,1068,59,0,2,21,13,1
47672,30,650,215,129,180,6,0,29,221,8,65,43,72,73,115,415,711,4,3153,175,0,2,25,18,1
47673,30,650,97,69,77,3,3,16,100,6,22,13,23,28,36,113,173,3,542,30,0,2,25,18,1
47674,115,2577,1043,504,840,53,9,147,1096,9,180,112,198,189,310,1377,2344,4,11604,644,0,2,88,53,1
47675,115,2577,383,288,292,26,6,62,409,11,65,38,67,76,105,429,656,5,3719,206,0,2,88,53,1
47676,20,411,294,64,250,0,0,43,294,1,20,10,20,21,30,86,131,0,65,3,0,2,30,20,1
47677,20,411,78,46,62,3,0,14,81,3,8,4,8,11,12,28,41,1,62,3,0,2,30,20,1
47678,5,119,110,30,77,3,13,16,113,4,21,15,30,25,45,100,208,2,597,33,0,2,7,3,1
47679,5,119,28,15,21,1,0,6,29,0,0,0,0,0,0,0,0,0,0,0,0,2,7,3,1
47680,70,1380,1178,367,1042,6,15,115,1184,9,94,51,95,103,146,644,976,4,4439,246,0,2,75,65,1
47681,70,1380,177,108,140,8,0,27,185,6,30,16,32,36,48,162,248,3,794,44,0,2,75,65,1
47682,209,4543,1943,715,1694,26,18,214,1969,12,185,120,237,197,357,1436,2721,7,20915,1161,0,2,215,134,1
47683,209,4543,1168,838,957,57,25,144,1225,19,348,224,416,367,640,3018,5452,11,61921,3440,1,2,215,134,1
47684,16,480,442,244,305,14,16,103,456,11,68,45,75,79,120,452,756,6,4588,254,0,2,11,8,1
47685,16,480,182,102,99,11,40,35,193,3,11,6,11,14,17,42,64,1,97,5,0,2,11,8,1
47686,62,1223,1098,241,925,5,10,155,1103,7,46,25,49,53,74,273,423,3,1580,87,0,2,42,27,1
47687,62,1223,282,202,222,14,2,44,296,8,42,24,43,50,67,250,378,4,1548,86,0,2,42,27,1
47688,22,460,601,196,481,2,23,85,603,8,63,36,72,71,108,400,664,4,3036,168,0,2,34,17,1
47689,22,460,156,79,106,5,16,28,161,5,14,8,15,19,23,64,97,2,261,14,0,2,34,17,1
47693,3,42,14,8,8,0,0,6,14,0,0,0,0,0,0,0,0,0,0,0,0,2,5,1,1
47694,2,34,9,6,6,0,0,3,9,0,0,0,0,0,0,0,0,0,0,0,0,2,1,0,1
47695,2,34,13,9,8,0,0,4,13,0,0,0,0,0,0,0,0,0,0,0,0,2,1,0,1
47697,1,324,382,65,130,157,2,92,539,4,10,5,10,14,15,41,57,2,114,6,0,2,117,100,1
47698,60,1081,282,196,195,3,0,86,285,8,130,71,141,138,212,936,1507,4,6538,363,0,2,84,46,1
47699,4,77,127,75,83,2,11,30,129,4,14,7,14,18,21,61,87,2,175,9,0,2,4,2,1
47700,4,77,652,304,544,16,6,88,668,6,89,51,101,95,152,591,998,3,3399,188,0,2,4,2,1
47701,4,77,2,2,2,0,0,0,2,0,0,0,0,0,0,0,0,0,0,0,0,2,4,2,1
47702,4,77,8,5,5,0,0,3,8,0,0,0,0,0,0,0,0,0,0,0,0,2,4,2,1
47705,4,77,14,8,8,0,0,6,14,0,0,0,0,0,0,0,0,0,0,0,0,2,4,2,1
47706,4,77,6,4,4,0,0,2,6,0,0,0,0,0,0,0,0,0,0,0,0,2,4,2,1
47707,4,77,6,4,4,0,0,2,6,1,2,1,2,3,3,2,4,0,2,0,0,2,4,2,1
47709,4,77,7,5,5,0,0,2,7,0,0,0,0,0,0,0,0,0,0,0,0,2,4,2,1
47711,4,77,10,6,6,0,0,4,10,0,0,0,0,0,0,0,0,0,0,0,0,2,4,2,1
47712,4,77,1,1,1,0,0,0,1,0,0,0,0,0,0,0,0,0,0,0,0,2,4,2,1
47714,4,77,14,10,10,0,0,4,14,1,1,1,1,2,2,0,2,0,1,0,0,2,4,2,1
47715,4,77,46,26,30,3,0,12,49,3,6,3,6,9,9,20,28,1,42,2,0,2,4,2,1
47716,1,9,5,3,3,0,0,2,5,0,0,0,0,0,0,0,0,0,0,0,0,2,1,0,1
47717,1,88,13,10,10,0,0,3,13,1,2,1,2,3,3,2,4,0,2,0,0,2,5,5,1
47718,7,114,44,19,17,0,16,11,44,3,14,7,14,17,21,58,85,1,128,7,0,2,4,0,1
47719,3,66,127,75,83,2,11,30,129,4,14,7,14,18,21,61,87,2,175,9,0,2,5,1,1
47720,3,66,652,304,544,16,6,88,668,6,89,51,101,95,152,591,998,3,3399,188,0,2,5,1,1
47721,3,66,2,2,2,0,0,0,2,0,0,0,0,0,0,0,0,0,0,0,0,2,5,1,1
47722,3,66,8,5,5,0,0,3,8,0,0,0,0,0,0,0,0,0,0,0,0,2,5,1,1
47725,3,66,14,8,8,0,0,6,14,0,0,0,0,0,0,0,0,0,0,0,0,2,5,1,1
47726,3,66,6,4,4,0,0,2,6,0,0,0,0,0,0,0,0,0,0,0,0,2,5,1,1
47727,3,66,6,4,4,0,0,2,6,1,2,1,2,3,3,2,4,0,2,0,0,2,5,1,1
47729,3,66,7,5,5,0,0,2,7,0,0,0,0,0,0,0,0,0,0,0,0,2,5,1,1
47731,3,66,10,6,6,0,0,4,10,0,0,0,0,0,0,0,0,0,0,0,0,2,5,1,1
47732,3,66,1,1,1,0,0,0,1,0,0,0,0,0,0,0,0,0,0,0,0,2,5,1,1
47734,3,66,14,10,10,0,0,4,14,1,1,1,1,2,2,0,2,0,1,0,0,2,5,1,1
47735,3,66,46,26,30,3,0,12,49,3,6,3,6,9,9,20,28,1,42,2,0,2,5,1,1
47736,7,298,72,33,56,0,4,12,72,1,1,1,1,2,2,0,2,0,1,0,0,2,27,10,1
47737,12,229,127,75,83,2,11,30,129,4,14,7,14,18,21,61,87,2,175,9,0,2,15,6,1
47738,12,229,652,304,544,16,6,88,668,6,89,51,101,95,152,591,998,3,3399,188,0,2,15,6,1
47739,12,229,2,2,2,0,0,0,2,0,0,0,0,0,0,0,0,0,0,0,0,2,15,6,1
47740,12,229,8,5,5,0,0,3,8,0,0,0,0,0,0,0,0,0,0,0,0,2,15,6,1
47743,12,229,14,8,8,0,0,6,14,0,0,0,0,0,0,0,0,0,0,0,0,2,15,6,1
47744,12,229,6,4,4,0,0,2,6,0,0,0,0,0,0,0,0,0,0,0,0,2,15,6,1
47745,12,229,6,4,4,0,0,2,6,1,2,1,2,3,3,2,4,0,2,0,0,2,15,6,1
47747,12,229,7,5,5,0,0,2,7,0,0,0,0,0,0,0,0,0,0,0,0,2,15,6,1
47749,12,229,10,6,6,0,0,4,10,0,0,0,0,0,0,0,0,0,0,0,0,2,15,6,1
47750,12,229,1,1,1,0,0,0,1,0,0,0,0,0,0,0,0,0,0,0,0,2,15,6,1
47752,12,229,14,10,10,0,0,4,14,1,1,1,1,2,2,0,2,0,1,0,0,2,15,6,1
47753,12,229,46,26,30,3,0,12,49,3,6,3,6,9,9,20,28,1,42,2,0,2,15,6,1
47754,6,71,127,75,83,2,11,30,129,4,14,7,14,18,21,61,87,2,175,9,0,2,3,0,1
47755,6,71,652,304,544,16,6,88,668,6,89,51,101,95,152,591,998,3,3399,188,0,2,3,0,1
47756,6,71,2,2,2,0,0,0,2,0,0,0,0,0,0,0,0,0,0,0,0,2,3,0,1
47757,6,71,8,5,5,0,0,3,8,0,0,0,0,0,0,0,0,0,0,0,0,2,3,0,1
47760,6,71,14,8,8,0,0,6,14,0,0,0,0,0,0,0,0,0,0,0,0,2,3,0,1
47761,6,71,6,4,4,0,0,2,6,0,0,0,0,0,0,0,0,0,0,0,0,2,3,0,1
47762,6,71,6,4,4,0,0,2,6,1,2,1,2,3,3,2,4,0,2,0,0,2,3,0,1
47764,6,71,7,5,5,0,0,2,7,0,0,0,0,0,0,0,0,0,0,0,0,2,3,0,1
47766,6,71,10,6,6,0,0,4,10,0,0,0,0,0,0,0,0,0,0,0,0,2,3,0,1
47767,6,71,1,1,1,0,0,0,1,0,0,0,0,0,0,0,0,0,0,0,0,2,3,0,1
47769,6,71,14,10,10,0,0,4,14,1,1,1,1,2,2,0,2,0,1,0,0,2,3,0,1
47770,6,71,46,26,30,3,0,12,49,3,6,3,6,9,9,20,28,1,42,2,0,2,3,0,1
47771,3,26,14,7,7,2,0,5,16,0,0,0,0,0,0,0,0,0,0,0,0,2,3,0,1
47772,7,103,38,23,23,0,0,15,38,0,0,0,0,0,0,0,0,0,0,0,0,2,8,0,1
47773,17,384,85,59,61,8,0,16,93,5,18,10,18,23,28,86,126,2,316,17,0,2,18,15,1
47774,15,484,42,7,35,4,0,5,46,1,2,1,2,3,3,2,4,0,2,0,0,2,49,50,1
47775,15,484,11,6,10,0,0,1,11,2,4,2,4,6,6,10,15,1,15,0,0,2,49,50,1
47799,92,3866,1289,550,1043,56,32,155,1345,10,167,93,185,177,278,1266,2075,5,11498,638,0,2,316,270,1
47800,36,1084,182,127,129,0,0,53,182,5,39,21,42,44,63,217,343,2,926,51,0,2,42,29,1
47801,147,6916,1392,870,1177,35,17,170,1427,14,494,280,531,508,811,4473,7289,7,54850,3047,2,2,280,169,1
47802,88,2881,773,419,590,28,0,166,801,10,204,113,217,214,330,1598,2554,5,13587,754,0,2,164,83,1
47803,15,742,75,38,59,1,3,12,76,2,4,2,4,6,6,10,15,1,15,0,0,2,138,76,1
47806,2,26,6,4,4,0,0,2,6,1,4,2,4,5,6,8,13,0,6,0,0,2,2,3,1
47808,13,570,139,89,101,2,0,35,141,7,54,34,62,61,96,330,569,4,2287,127,0,2,45,48,1
47809,1,138,149,67,118,4,0,27,153,1,17,14,28,18,42,69,175,0,144,8,0,2,15,7,1
47810,31,1983,1157,318,931,29,22,177,1186,6,104,63,125,110,188,712,1274,3,4596,255,0,2,368,271,1
47811,54,3598,520,294,400,33,13,81,553,10,261,204,367,271,571,2128,4614,7,32445,1802,1,2,81,90,1
47812,97,4401,1338,495,1086,10,64,173,1348,11,122,82,157,133,239,883,1686,7,11934,663,0,2,446,289,1
47813,172,7590,139,89,101,2,0,35,141,7,54,34,62,61,96,330,569,4,2287,127,0,2,1162,594,1
47814,172,7590,7,5,5,0,0,2,7,1,2,1,2,3,3,2,4,0,2,0,0,2,1162,594,1
47815,33,989,465,148,393,5,8,60,470,4,31,20,31,35,51,161,261,2,523,29,0,2,97,53,1
47816,33,989,16,12,9,0,0,6,16,1,2,1,2,3,3,2,4,0,2,0,0,2,97,53,1
47817,139,5899,1782,648,1425,9,47,279,1791,8,171,97,189,179,286,1292,2140,4,9462,525,0,2,528,372,1
47818,25,684,256,139,192,9,7,47,265,4,23,12,24,27,36,112,171,2,357,19,0,2,31,21,1
47819,6,328,180,34,164,0,0,16,180,1,12,6,12,13,18,43,66,0,33,1,0,2,89,64,1
47820,23,578,102,59,69,5,3,24,107,6,22,15,28,28,43,113,206,3,789,43,0,2,32,21,1
47821,111,4186,1450,624,1228,12,26,181,1462,14,306,186,354,320,540,2580,4493,8,36391,2021,1,2,478,384,1
47822,155,4437,1660,832,1314,41,38,274,1701,20,312,209,395,332,604,2671,5058,12,64042,3557,1,2,295,164,1
47823,36,2873,996,429,845,24,10,117,1020,7,76,50,88,83,138,494,879,4,3565,198,0,2,391,315,1
47824,129,5198,1513,682,1277,25,13,200,1538,11,199,116,219,210,335,1557,2584,6,15641,868,0,2,379,270,1
47825,73,3803,1296,573,1062,40,33,157,1336,8,201,118,231,209,349,1561,2689,4,12365,686,0,2,277,191,1
47826,14,341,207,111,150,11,0,50,218,5,26,19,36,31,55,133,272,3,943,52,0,2,24,15,1
47827,84,4433,1457,730,1242,11,6,188,1468,10,292,166,329,302,495,2424,4078,5,22973,1276,1,2,439,270,1
47828,39,2323,652,304,544,16,6,88,668,6,89,51,101,95,152,591,998,3,3399,188,0,2,180,111,1
47829,69,3174,1455,414,1257,16,76,112,1471,5,41,23,46,46,69,231,381,2,1069,59,0,2,511,345,1
47830,2,75,7,6,5,0,0,2,7,1,1,1,2,2,3,0,3,1,3,0,0,2,4,4,1
47831,8,271,74,35,59,1,0,14,75,3,14,7,14,17,21,58,85,1,128,7,0,2,19,24,1
47832,94,4592,1523,757,1297,19,12,193,1542,12,193,117,230,205,347,1508,2664,7,19053,1058,0,2,309,193,1
47833,87,3811,1020,354,843,12,15,144,1032,8,134,77,144,142,221,970,1580,4,6792,377,0,2,355,220,1
47834,38,1676,447,308,343,6,5,95,453,7,96,59,111,103,170,651,1136,4,4600,255,0,2,99,72,1
47835,1,107,53,23,39,0,0,13,53,2,8,4,8,10,12,26,39,1,39,2,0,2,13,10,1
47836,21,658,424,94,331,4,0,89,428,1,5,5,5,6,10,11,25,0,12,0,0,2,83,59,1
47837,38,2302,334,251,279,10,4,40,344,5,127,74,143,132,217,899,1528,2,4303,239,0,2,123,97,1
47838,12,493,184,100,137,2,15,30,186,6,38,20,39,44,59,214,322,3,991,55,0,2,47,32,1
47839,59,2582,1293,570,1093,25,15,163,1318,10,195,123,241,205,364,1516,2795,6,17273,959,0,2,198,124,1
47840,33,1883,384,251,317,7,8,52,391,11,70,44,84,81,128,467,811,6,5355,297,0,2,78,55,1
47841,45,2208,722,423,573,19,0,135,741,12,172,101,199,184,300,1320,2257,6,15668,870,0,2,61,38,1
47842,39,1727,386,256,301,16,9,68,402,4,59,35,69,63,104,355,621,2,1453,80,0,2,90,52,1
47843,16,1214,215,129,180,6,0,29,221,8,65,43,72,73,115,415,711,4,3153,175,0,2,75,60,1
47844,79,3060,1043,504,840,53,9,147,1096,9,180,112,198,189,310,1377,2344,4,11604,644,0,2,245,148,1
47845,14,530,295,56,236,0,4,54,295,2,9,5,10,11,15,30,51,1,57,3,0,2,85,52,1
47846,30,1241,373,158,315,8,0,51,381,5,76,44,79,81,123,486,779,2,2026,112,0,2,88,44,1
47847,77,3211,1178,367,1042,6,15,115,1184,9,94,51,95,103,146,644,976,4,4439,246,0,2,460,373,1
47848,91,4584,1943,715,1694,26,18,214,1969,12,185,120,237,197,357,1436,2721,7,20915,1161,0,2,582,518,1
47849,14,826,442,244,305,14,16,103,456,11,68,45,75,79,120,452,756,6,4588,254,0,2,58,34,1
47850,48,1744,1098,241,925,5,10,155,1103,7,46,25,49,53,74,273,423,3,1580,87,0,2,269,172,1
47851,19,682,601,196,481,2,23,85,603,8,63,36,72,71,108,400,664,4,3036,168,0,2,139,107,1
47852,213,4615,182,127,129,0,0,53,182,5,39,21,42,44,63,217,343,2,926,51,0,2,2,2,1
47853,213,4615,1165,710,800,67,119,181,1232,18,243,153,282,261,435,2000,3492,10,36473,2026,1,2,2,2,1
47854,58,1183,207,111,150,11,0,50,218,5,26,19,36,31,55,133,272,3,943,52,0,2,7,5,1
47855,58,1183,410,198,237,31,55,97,441,11,63,38,72,74,110,414,683,6,4293,238,0,2,7,5,1
47856,237,5397,4293,999,3693,19,54,507,4312,9,155,88,170,164,258,1156,1898,4,9368,520,0,2,3,2,1
47857,237,5397,1482,859,1002,125,135,219,1607,16,219,134,251,235,385,1766,3032,9,27804,1544,1,2,3,2,1
47858,285,6294,72,33,56,0,4,12,72,1,1,1,1,2,2,0,2,0,1,0,0,2,1,1,1
47859,285,6294,1454,835,1044,76,110,219,1530,17,275,158,296,292,454,2297,3718,9,34017,1889,1,2,1,1,1
47860,78,1580,757,253,292,73,244,162,830,13,61,38,67,74,105,409,651,7,4654,258,0,2,8,6,1
47863,2,40,9,6,6,0,0,3,9,0,0,0,0,0,0,0,0,0,0,0,0,2,2,2,1
47864,2,40,13,9,8,0,0,4,13,0,0,0,0,0,0,0,0,0,0,0,0,2,2,2,1
47865,60,1081,282,196,195,3,0,86,285,8,130,71,141,138,212,936,1507,4,6538,363,0,2,10,10,1
47866,4,77,127,75,83,2,11,30,129,4,14,7,14,18,21,61,87,2,175,9,0,2,2,1,1
47867,4,77,652,304,544,16,6,88,668,6,89,51,101,95,152,591,998,3,3399,188,0,2,2,1,1
47868,4,77,2,2,2,0,0,0,2,0,0,0,0,0,0,0,0,0,0,0,0,2,2,1,1
47869,4,77,8,5,5,0,0,3,8,0,0,0,0,0,0,0,0,0,0,0,0,2,2,1,1
47872,4,77,14,8,8,0,0,6,14,0,0,0,0,0,0,0,0,0,0,0,0,2,2,1,1
47873,4,77,6,4,4,0,0,2,6,0,0,0,0,0,0,0,0,0,0,0,0,2,2,1,1
47874,4,77,6,4,4,0,0,2,6,1,2,1,2,3,3,2,4,0,2,0,0,2,2,1,1
47876,4,77,7,5,5,0,0,2,7,0,0,0,0,0,0,0,0,0,0,0,0,2,2,1,1
47878,4,77,10,6,6,0,0,4,10,0,0,0,0,0,0,0,0,0,0,0,0,2,2,1,1
47879,4,77,1,1,1,0,0,0,1,0,0,0,0,0,0,0,0,0,0,0,0,2,2,1,1
47881,4,77,14,10,10,0,0,4,14,1,1,1,1,2,2,0,2,0,1,0,0,2,2,1,1
47882,4,77,46,26,30,3,0,12,49,3,6,3,6,9,9,20,28,1,42,2,0,2,2,1,1
47883,3,26,14,7,7,2,0,5,16,0,0,0,0,0,0,0,0,0,0,0,0,2,2,1,1
47884,17,378,85,59,61,8,0,16,93,5,18,10,18,23,28,86,126,2,316,17,0,2,2,3,1
47885,36,1088,182,127,129,0,0,53,182,5,39,21,42,44,63,217,343,2,926,51,0,2,3,2,1
47886,97,4401,1338,495,1086,10,64,173,1348,11,122,82,157,133,239,883,1686,7,11934,663,0,2,1,1,1
47887,125,5129,1513,682,1277,25,13,200,1538,11,199,116,219,210,335,1557,2584,6,15641,868,0,2,13,28,1
47888,73,3803,1296,573,1062,40,33,157,1336,8,201,118,231,209,349,1561,2689,4,12365,686,0,2,1,1,1
47889,88,2881,773,419,590,28,0,166,801,10,204,113,217,214,330,1598,2554,5,13587,754,0,2,4,4,0
47890,98,2655,1523,757,1297,19,12,193,1542,12,193,117,230,205,347,1508,2664,7,19053,1058,0,2,1,1,0
47891,98,2655,701,378,504,33,58,109,734,13,110,68,126,123,194,794,1346,7,10027,557,0,2,1,1,0
47892,95,4653,1523,757,1297,19,12,193,1542,12,193,117,230,205,347,1508,2664,7,19053,1058,0,2,17,0,0
47893,95,4653,1523,757,1297,19,12,193,1542,12,193,117,230,205,347,1508,2664,7,19053,1058,0,2,1,1,0
47894,49,1844,1098,241,925,5,10,155,1103,7,46,25,49,53,74,273,423,3,1580,87,0,2,47,0,0
47895,49,1845,1098,241,925,5,10,155,1103,7,46,25,49,53,74,273,423,3,1580,87,0,2,15,1,0
47896,237,5390,4293,999,3693,19,54,507,4312,9,155,88,170,164,258,1156,1898,4,9368,520,0,2,1,1,0
47897,237,5390,1482,859,1002,125,135,219,1607,16,219,134,251,235,385,1766,3032,9,27804,1544,1,2,1,1,0
47898,262,6287,72,33,56,0,4,12,72,1,1,1,1,2,2,0,2,0,1,0,0,2,1,1,0
47899,262,6287,1454,835,1044,76,110,219,1530,17,275,158,296,292,454,2297,3718,9,34017,1889,1,2,1,1,0
47900,62,1229,1098,241,925,5,10,155,1103,7,46,25,49,53,74,273,423,3,1580,87,0,2,2,1,0
47901,62,1229,282,202,222,14,2,44,296,8,42,24,43,50,67,250,378,4,1548,86,0,2,2,1,0
47908,49,1845,1098,241,925,5,10,155,1103,7,46,25,49,53,74,273,423,3,1580,87,0,2,61,0,0
47912,163,5014,1660,832,1314,41,38,274,1701,20,312,209,395,332,604,2671,5058,12,64042,3557,1,2,1,4,0
47913,163,5014,1057,646,719,113,100,145,1170,18,215,134,248,233,382,1740,3004,10,31186,1732,1,2,1,4,0
47914,237,5399,4293,999,3693,19,54,507,4312,9,155,88,170,164,258,1156,1898,4,9368,520,0,2,1,1,0
47915,237,5399,1482,859,1002,125,135,219,1607,16,219,134,251,235,385,1766,3032,9,27804,1544,1,2,1,1,0
47916,98,2661,1523,757,1297,19,12,193,1542,12,193,117,230,205,347,1508,2664,7,19053,1058,0,2,2,1,0
47917,98,2661,701,378,504,33,58,109,734,13,110,68,126,123,194,794,1346,7,10027,557,0,2,2,1,0
47918,285,6292,72,33,56,0,4,12,72,1,1,1,1,2,2,0,2,0,1,0,0,2,1,1,0
47919,285,6292,1454,835,1044,76,110,219,1530,17,275,158,296,292,454,2297,3718,9,34017,1889,1,2,1,1,0
47920,62,1230,1098,241,925,5,10,155,1103,7,46,25,49,53,74,273,423,3,1580,87,0,2,2,1,0
47921,62,1230,282,202,222,14,2,44,296,8,42,24,43,50,67,250,378,4,1548,86,0,2,2,1,0
47922,95,4654,1523,757,1297,19,12,193,1542,12,193,117,230,205,347,1508,2664,7,19053,1058,0,2,17,0,0
47923,49,1839,1098,241,925,5,10,155,1103,7,46,25,49,53,74,273,423,3,1580,87,0,2,61,0,0
47924,98,2661,1523,757,1297,19,12,193,1542,12,193,117,230,205,347,1508,2664,7,19053,1058,0,2,0,1,0
47925,98,2661,701,378,504,33,58,109,734,13,110,68,126,123,194,794,1346,7,10027,557,0,2,0,1,0
47926,95,4654,1523,757,1297,19,12,193,1542,12,193,117,230,205,347,1508,2664,7,19053,1058,0,2,6,4,0
47927,49,1838,1098,241,925,5,10,155,1103,7,46,25,49,53,74,273,423,3,1580,87,0,2,15,11,0
47951,11,238,19,8,11,5,0,4,24,2,5,3,6,7,9,13,25,1,30,1,0,2,10,6,0
47952,11,238,102,59,69,5,3,24,107,6,22,15,28,28,43,113,206,3,789,43,0,2,10,6,0
47953,11,238,106,40,36,3,49,17,109,8,17,13,23,25,36,93,167,5,904,50,0,2,10,6,0
47954,213,4615,182,127,129,0,0,53,182,5,39,21,42,44,63,217,343,2,926,51,0,2,123,63,0
47955,213,4615,1165,710,800,67,119,181,1232,18,243,153,282,261,435,2000,3492,10,36473,2026,1,2,123,63,0
47956,83,1808,773,419,590,28,0,166,801,10,204,113,217,214,330,1598,2554,5,13587,754,0,2,32,18,0
47957,83,1808,421,273,302,44,34,57,465,17,81,59,107,98,166,583,1098,11,12329,684,0,2,32,18,0
47960,26,525,2,2,2,0,0,0,2,0,0,0,0,0,0,0,0,0,0,0,0,2,21,16,0
47974,26,525,99,48,90,1,3,5,100,0,0,0,0,0,0,0,0,0,0,0,0,2,21,16,0
47975,26,525,8,5,5,2,0,1,10,0,0,0,0,0,0,0,0,0,0,0,0,2,21,16,0
47976,26,525,1217,716,841,84,126,174,1301,14,185,118,215,199,333,1446,2542,8,20687,1149,0,2,21,16,0
47977,26,525,160,89,115,0,13,31,160,7,15,11,17,22,28,78,124,3,495,27,0,2,21,16,0
47978,26,525,10,10,9,9,0,0,19,0,0,0,0,0,0,0,0,0,0,0,0,2,21,16,0
47979,26,525,173,84,99,8,29,36,181,5,12,7,13,17,20,54,81,2,221,12,0,2,21,16,0
47980,26,525,3,1,1,3,0,0,6,0,0,0,0,0,0,0,0,0,0,0,0,2,21,16,0
47981,164,5032,1660,832,1314,41,38,274,1701,20,312,209,395,332,604,2671,5058,12,64042,3557,1,2,78,58,0
47982,164,5032,1057,646,719,113,100,145,1170,18,215,134,248,233,382,1740,3004,10,31186,1732,1,2,78,58,0
47983,17,344,95,58,50,9,16,20,104,12,33,24,45,45,69,209,378,8,3100,172,0,2,6,9,0
47984,89,1830,477,336,357,30,23,73,507,16,194,134,250,210,384,1538,2962,10,30538,1696,0,2,81,63,0
47985,71,1702,996,429,845,24,10,117,1020,7,76,50,88,83,138,494,879,4,3565,198,0,2,65,41,0
47986,71,1702,456,277,329,12,42,72,468,13,85,50,97,98,147,592,972,7,7212,400,0,2,65,41,0
47987,145,3016,1513,682,1277,25,13,200,1538,11,199,116,219,210,335,1557,2584,6,15641,868,0,2,59,41,0
47988,145,3016,819,519,539,24,98,155,843,15,96,57,106,111,163,690,1107,8,9171,509,0,2,59,41,0
47989,58,1183,207,111,150,11,0,50,218,5,26,19,36,31,55,133,272,3,943,52,0,2,84,52,0
47990,58,1183,410,198,237,31,55,97,441,11,63,38,72,74,110,414,683,6,4293,238,0,2,84,52,0
47991,356,7117,1457,730,1242,11,6,188,1468,10,292,166,329,302,495,2424,4078,5,22973,1276,1,2,250,179,0
47992,356,7117,74,35,59,1,0,14,75,3,14,7,14,17,21,58,85,1,128,7,0,2,250,179,0
47993,356,7117,245,125,200,5,7,34,250,7,30,17,34,37,51,166,265,3,1053,58,0,2,250,179,0
47994,28,809,339,213,244,17,9,65,356,10,42,26,48,52,74,259,421,5,2410,133,0,2,23,11,0
47996,84,2154,1455,414,1257,16,76,112,1471,5,41,23,46,46,69,231,381,2,1069,59,0,2,138,85,0
47997,84,2154,669,365,481,22,61,110,691,15,103,63,122,118,185,747,1273,8,11311,628,0,2,138,85,0
47998,237,5399,4293,999,3693,19,54,507,4312,9,155,88,170,164,258,1156,1898,4,9368,520,0,2,145,87,0
47999,237,5399,1482,859,1002,125,135,219,1607,16,219,134,251,235,385,1766,3032,9,27804,1544,1,2,145,87,0
48000,6,136,44,22,19,0,19,6,44,2,10,6,12,12,18,35,64,1,77,4,0,2,5,3,0
48001,27,959,74,35,59,1,0,14,75,3,14,7,14,17,21,58,85,1,128,7,0,2,77,50,0
48002,27,959,245,125,200,5,7,34,250,7,30,17,34,37,51,166,265,3,1053,58,0,2,77,50,0
48003,51,595,647,139,84,35,284,233,682,0,0,0,0,0,0,0,0,0,0,0,0,2,11,0,0
48004,98,2661,1523,757,1297,19,12,193,1542,12,193,117,230,205,347,1508,2664,7,19053,1058,0,2,142,110,0
48005,98,2661,701,378,504,33,58,109,734,13,110,68,126,123,194,794,1346,7,10027,557,0,2,142,110,0
48006,86,2225,773,422,505,30,103,129,803,14,77,46,83,91,129,535,839,7,6334,351,0,2,157,104,0
48007,122,2937,77,34,69,0,0,8,77,3,24,16,29,27,45,114,213,1,387,21,0,2,152,75,0
48008,122,2937,712,438,573,51,9,84,763,14,102,71,128,116,199,733,1364,8,11988,666,0,2,152,75,0
48011,24,605,2,2,2,0,0,0,2,0,0,0,0,0,0,0,0,0,0,0,0,2,45,28,0
48025,24,605,99,48,90,1,3,5,100,0,0,0,0,0,0,0,0,0,0,0,0,2,45,28,0
48026,24,605,8,5,5,2,0,1,10,0,0,0,0,0,0,0,0,0,0,0,0,2,45,28,0
48027,24,605,1217,716,841,84,126,174,1301,14,185,118,215,199,333,1446,2542,8,20687,1149,0,2,45,28,0
48028,24,605,160,89,115,0,13,31,160,7,15,11,17,22,28,78,124,3,495,27,0,2,45,28,0
48029,24,605,10,10,9,9,0,0,19,0,0,0,0,0,0,0,0,0,0,0,0,2,45,28,0
48030,24,605,173,84,99,8,29,36,181,5,12,7,13,17,20,54,81,2,221,12,0,2,45,28,0
48031,24,605,3,1,1,3,0,0,6,0,0,0,0,0,0,0,0,0,0,0,0,2,45,28,0
48032,30,658,125,97,103,3,0,19,128,9,25,17,27,34,44,144,223,4,1087,60,0,2,23,20,0
48033,22,350,102,57,55,5,16,25,107,5,17,10,18,22,28,81,124,2,330,18,0,2,8,3,0
48034,79,1721,402,202,227,24,74,80,426,12,52,33,61,64,94,339,564,7,3969,220,0,2,37,34,0
48035,48,992,447,308,343,6,5,95,453,7,96,59,111,103,170,651,1136,4,4600,255,0,2,17,17,0
48036,48,992,322,174,179,16,74,51,338,10,41,26,46,51,72,252,408,5,2291,127,0,2,17,17,0
48037,72,1644,53,23,39,0,0,13,53,2,8,4,8,10,12,26,39,1,39,2,0,2,27,16,0
48038,72,1644,515,298,307,33,80,99,548,12,63,44,77,75,121,419,753,7,5527,307,0,2,27,16,0
48039,23,381,424,94,331,4,0,89,428,1,5,5,5,6,10,11,25,0,12,0,0,2,14,14,0
48040,23,381,38,23,23,6,0,8,44,3,11,7,11,14,18,42,68,1,102,5,0,2,14,14,0
48041,20,511,205,80,86,16,53,53,221,7,18,10,19,25,29,94,134,3,497,27,0,2,23,13,0
48042,17,519,184,100,137,2,15,30,186,6,38,20,39,44,59,214,322,3,991,55,0,2,30,21,0
48043,17,519,103,65,74,8,5,16,111,7,17,9,17,24,26,89,119,3,417,23,0,2,30,21,0
48044,226,5309,722,423,573,19,0,135,741,12,172,101,199,184,300,1320,2257,6,15668,870,0,2,125,77,0
48045,226,5309,1508,847,911,44,250,301,1552,14,148,88,169,162,257,1120,1886,7,15077,837,0,2,125,77,0
48046,285,6292,72,33,56,0,4,12,72,1,1,1,1,2,2,0,2,0,1,0,0,2,277,168,0
48047,285,6292,1454,835,1044,76,110,219,1530,17,275,158,296,292,454,2297,3718,9,34017,1889,1,2,277,168,0
48048,78,1580,757,253,292,73,244,162,830,13,61,38,67,74,105,409,651,7,4654,258,0,2,52,32,0
48049,46,955,386,256,301,16,9,68,402,4,59,35,69,63,104,355,621,2,1453,80,0,2,25,15,0
48050,46,955,264,131,164,11,41,46,275,6,38,22,40,44,62,214,338,3,1068,59,0,2,25,15,0
48051,30,650,215,129,180,6,0,29,221,8,65,43,72,73,115,415,711,4,3153,175,0,2,25,18,0
48052,30,650,97,69,77,3,3,16,100,6,22,13,23,28,36,113,173,3,542,30,0,2,25,18,0
48053,115,2577,1043,504,840,53,9,147,1096,9,180,112,198,189,310,1377,2344,4,11604,644,0,2,89,54,0
48054,115,2577,383,288,292,26,6,62,409,11,65,38,67,76,105,429,656,5,3719,206,0,2,89,54,0
48055,20,411,294,64,250,0,0,43,294,1,20,10,20,21,30,86,131,0,65,3,0,2,30,20,0
48056,20,411,78,46,62,3,0,14,81,3,8,4,8,11,12,28,41,1,62,3,0,2,30,20,0
48057,5,119,110,30,77,3,13,16,113,4,21,15,30,25,45,100,208,2,597,33,0,2,7,3,0
48058,5,119,28,15,21,1,0,6,29,0,0,0,0,0,0,0,0,0,0,0,0,2,7,3,0
48059,70,1380,1178,367,1042,6,15,115,1184,9,94,51,95,103,146,644,976,4,4439,246,0,2,77,67,0
48060,70,1380,177,108,140,8,0,27,185,6,30,16,32,36,48,162,248,3,794,44,0,2,77,67,0
48061,209,4543,1943,715,1694,26,18,214,1969,12,185,120,237,197,357,1436,2721,7,20915,1161,0,2,215,134,0
48062,209,4543,1168,838,957,57,25,144,1225,19,348,224,416,367,640,3018,5452,11,61921,3440,1,2,215,134,0
48063,16,480,442,244,305,14,16,103,456,11,68,45,75,79,120,452,756,6,4588,254,0,2,11,8,0
48064,16,480,182,102,99,11,40,35,193,3,11,6,11,14,17,42,64,1,97,5,0,2,11,8,0
48065,62,1230,1098,241,925,5,10,155,1103,7,46,25,49,53,74,273,423,3,1580,87,0,2,42,27,0
48066,62,1230,282,202,222,14,2,44,296,8,42,24,43,50,67,250,378,4,1548,86,0,2,42,27,0
48067,22,460,601,196,481,2,23,85,603,8,63,36,72,71,108,400,664,4,3036,168,0,2,34,17,0
48068,22,460,156,79,106,5,16,28,161,5,14,8,15,19,23,64,97,2,261,14,0,2,34,17,0
48072,3,42,14,8,8,0,0,6,14,0,0,0,0,0,0,0,0,0,0,0,0,2,5,2,0
48073,2,40,9,6,6,0,0,3,9,0,0,0,0,0,0,0,0,0,0,0,0,2,3,2,0
48074,2,40,13,9,8,0,0,4,13,0,0,0,0,0,0,0,0,0,0,0,0,2,3,2,0
48076,1,324,382,65,130,157,2,92,539,4,10,5,10,14,15,41,57,2,114,6,0,2,117,100,0
48077,60,1081,282,196,195,3,0,86,285,8,130,71,141,138,212,936,1507,4,6538,363,0,2,88,50,0
48078,4,77,127,75,83,2,11,30,129,4,14,7,14,18,21,61,87,2,175,9,0,2,6,3,0
48079,4,77,652,304,544,16,6,88,668,6,89,51,101,95,152,591,998,3,3399,188,0,2,6,3,0
48080,4,77,2,2,2,0,0,0,2,0,0,0,0,0,0,0,0,0,0,0,0,2,6,3,0
48081,4,77,8,5,5,0,0,3,8,0,0,0,0,0,0,0,0,0,0,0,0,2,6,3,0
48084,4,77,14,8,8,0,0,6,14,0,0,0,0,0,0,0,0,0,0,0,0,2,6,3,0
48085,4,77,6,4,4,0,0,2,6,0,0,0,0,0,0,0,0,0,0,0,0,2,6,3,0
48086,4,77,6,4,4,0,0,2,6,1,2,1,2,3,3,2,4,0,2,0,0,2,6,3,0
48088,4,77,7,5,5,0,0,2,7,0,0,0,0,0,0,0,0,0,0,0,0,2,6,3,0
48090,4,77,10,6,6,0,0,4,10,0,0,0,0,0,0,0,0,0,0,0,0,2,6,3,0
48091,4,77,1,1,1,0,0,0,1,0,0,0,0,0,0,0,0,0,0,0,0,2,6,3,0
48093,4,77,14,10,10,0,0,4,14,1,1,1,1,2,2,0,2,0,1,0,0,2,6,3,0
48094,4,77,46,26,30,3,0,12,49,3,6,3,6,9,9,20,28,1,42,2,0,2,6,3,0
48095,1,9,5,3,3,0,0,2,5,0,0,0,0,0,0,0,0,0,0,0,0,2,1,0,0
48096,1,88,13,10,10,0,0,3,13,1,2,1,2,3,3,2,4,0,2,0,0,2,5,5,0
48097,7,114,44,19,17,0,16,11,44,3,14,7,14,17,21,58,85,1,128,7,0,2,4,1,0
48098,3,66,127,75,83,2,11,30,129,4,14,7,14,18,21,61,87,2,175,9,0,2,5,1,0
48099,3,66,652,304,544,16,6,88,668,6,89,51,101,95,152,591,998,3,3399,188,0,2,5,1,0
48100,3,66,2,2,2,0,0,0,2,0,0,0,0,0,0,0,0,0,0,0,0,2,5,1,0
48101,3,66,8,5,5,0,0,3,8,0,0,0,0,0,0,0,0,0,0,0,0,2,5,1,0
48104,3,66,14,8,8,0,0,6,14,0,0,0,0,0,0,0,0,0,0,0,0,2,5,1,0
48105,3,66,6,4,4,0,0,2,6,0,0,0,0,0,0,0,0,0,0,0,0,2,5,1,0
48106,3,66,6,4,4,0,0,2,6,1,2,1,2,3,3,2,4,0,2,0,0,2,5,1,0
48108,3,66,7,5,5,0,0,2,7,0,0,0,0,0,0,0,0,0,0,0,0,2,5,1,0
48110,3,66,10,6,6,0,0,4,10,0,0,0,0,0,0,0,0,0,0,0,0,2,5,1,0
48111,3,66,1,1,1,0,0,0,1,0,0,0,0,0,0,0,0,0,0,0,0,2,5,1,0
48113,3,66,14,10,10,0,0,4,14,1,1,1,1,2,2,0,2,0,1,0,0,2,5,1,0
48114,3,66,46,26,30,3,0,12,49,3,6,3,6,9,9,20,28,1,42,2,0,2,5,1,0
48115,7,298,72,33,56,0,4,12,72,1,1,1,1,2,2,0,2,0,1,0,0,2,27,10,0
48116,12,229,127,75,83,2,11,30,129,4,14,7,14,18,21,61,87,2,175,9,0,2,15,6,0
48117,12,229,652,304,544,16,6,88,668,6,89,51,101,95,152,591,998,3,3399,188,0,2,15,6,0
48118,12,229,2,2,2,0,0,0,2,0,0,0,0,0,0,0,0,0,0,0,0,2,15,6,0
48119,12,229,8,5,5,0,0,3,8,0,0,0,0,0,0,0,0,0,0,0,0,2,15,6,0
48122,12,229,14,8,8,0,0,6,14,0,0,0,0,0,0,0,0,0,0,0,0,2,15,6,0
48123,12,229,6,4,4,0,0,2,6,0,0,0,0,0,0,0,0,0,0,0,0,2,15,6,0
48124,12,229,6,4,4,0,0,2,6,1,2,1,2,3,3,2,4,0,2,0,0,2,15,6,0
48126,12,229,7,5,5,0,0,2,7,0,0,0,0,0,0,0,0,0,0,0,0,2,15,6,0
48128,12,229,10,6,6,0,0,4,10,0,0,0,0,0,0,0,0,0,0,0,0,2,15,6,0
48129,12,229,1,1,1,0,0,0,1,0,0,0,0,0,0,0,0,0,0,0,0,2,15,6,0
48131,12,229,14,10,10,0,0,4,14,1,1,1,1,2,2,0,2,0,1,0,0,2,15,6,0
48132,12,229,46,26,30,3,0,12,49,3,6,3,6,9,9,20,28,1,42,2,0,2,15,6,0
48133,6,71,127,75,83,2,11,30,129,4,14,7,14,18,21,61,87,2,175,9,0,2,3,3,0
48134,6,71,652,304,544,16,6,88,668,6,89,51,101,95,152,591,998,3,3399,188,0,2,3,3,0
48135,6,71,2,2,2,0,0,0,2,0,0,0,0,0,0,0,0,0,0,0,0,2,3,3,0
48136,6,71,8,5,5,0,0,3,8,0,0,0,0,0,0,0,0,0,0,0,0,2,3,3,0
48139,6,71,14,8,8,0,0,6,14,0,0,0,0,0,0,0,0,0,0,0,0,2,3,3,0
48140,6,71,6,4,4,0,0,2,6,0,0,0,0,0,0,0,0,0,0,0,0,2,3,3,0
48141,6,71,6,4,4,0,0,2,6,1,2,1,2,3,3,2,4,0,2,0,0,2,3,3,0
48143,6,71,7,5,5,0,0,2,7,0,0,0,0,0,0,0,0,0,0,0,0,2,3,3,0
48145,6,71,10,6,6,0,0,4,10,0,0,0,0,0,0,0,0,0,0,0,0,2,3,3,0
48146,6,71,1,1,1,0,0,0,1,0,0,0,0,0,0,0,0,0,0,0,0,2,3,3,0
48148,6,71,14,10,10,0,0,4,14,1,1,1,1,2,2,0,2,0,1,0,0,2,3,3,0
48149,6,71,46,26,30,3,0,12,49,3,6,3,6,9,9,20,28,1,42,2,0,2,3,3,0
48150,3,26,14,7,7,2,0,5,16,0,0,0,0,0,0,0,0,0,0,0,0,2,5,1,0
48151,7,103,38,23,23,0,0,15,38,0,0,0,0,0,0,0,0,0,0,0,0,2,8,0,0
48152,17,378,85,59,61,8,0,16,93,5,18,10,18,23,28,86,126,2,316,17,0,2,20,19,0
48153,15,484,42,7,35,4,0,5,46,1,2,1,2,3,3,2,4,0,2,0,0,2,49,50,0
48154,15,484,11,6,10,0,0,1,11,2,4,2,4,6,6,10,15,1,15,0,0,2,49,50,0
48178,92,3866,1289,550,1043,56,32,155,1345,10,167,93,185,177,278,1266,2075,5,11498,638,0,2,316,270,0
48179,36,1088,182,127,129,0,0,53,182,5,39,21,42,44,63,217,343,2,926,51,0,2,45,31,0
48180,147,6916,1392,870,1177,35,17,170,1427,14,494,280,531,508,811,4473,7289,7,54850,3047,2,2,280,169,0
48181,88,2881,773,419,590,28,0,166,801,10,204,113,217,214,330,1598,2554,5,13587,754,0,2,167,86,0
48182,15,742,75,38,59,1,3,12,76,2,4,2,4,6,6,10,15,1,15,0,0,2,139,77,0
48185,2,26,6,4,4,0,0,2,6,1,4,2,4,5,6,8,13,0,6,0,0,2,2,3,0
48187,13,570,139,89,101,2,0,35,141,7,54,34,62,61,96,330,569,4,2287,127,0,2,45,48,0
48188,1,138,149,67,118,4,0,27,153,1,17,14,28,18,42,69,175,0,144,8,0,2,15,7,0
48189,31,1983,1157,318,931,29,22,177,1186,6,104,63,125,110,188,712,1274,3,4596,255,0,2,370,273,0
48190,54,3598,520,294,400,33,13,81,553,10,261,204,367,271,571,2128,4614,7,32445,1802,1,2,81,90,0
48191,97,4401,1338,495,1086,10,64,173,1348,11,122,82,157,133,239,883,1686,7,11934,663,0,2,447,290,0
48192,172,7590,139,89,101,2,0,35,141,7,54,34,62,61,96,330,569,4,2287,127,0,2,1171,603,0
48193,172,7590,7,5,5,0,0,2,7,1,2,1,2,3,3,2,4,0,2,0,0,2,1171,603,0
48194,33,989,465,148,393,5,8,60,470,4,31,20,31,35,51,161,261,2,523,29,0,2,97,53,0
48195,33,989,16,12,9,0,0,6,16,1,2,1,2,3,3,2,4,0,2,0,0,2,97,53,0
48196,139,5899,1782,648,1425,9,47,279,1791,8,171,97,189,179,286,1292,2140,4,9462,525,0,2,529,373,0
48197,25,684,256,139,192,9,7,47,265,4,23,12,24,27,36,112,171,2,357,19,0,2,33,23,0
48198,6,328,180,34,164,0,0,16,180,1,12,6,12,13,18,43,66,0,33,1,0,2,89,64,0
48199,23,578,102,59,69,5,3,24,107,6,22,15,28,28,43,113,206,3,789,43,0,2,32,21,0
48200,111,4186,1450,624,1228,12,26,181,1462,14,306,186,354,320,540,2580,4493,8,36391,2021,1,2,482,388,0
48201,155,4437,1660,832,1314,41,38,274,1701,20,312,209,395,332,604,2671,5058,12,64042,3557,1,2,295,164,0
48202,36,2873,996,429,845,24,10,117,1020,7,76,50,88,83,138,494,879,4,3565,198,0,2,391,315,0
48203,125,5129,1513,682,1277,25,13,200,1538,11,199,116,219,210,335,1557,2584,6,15641,868,0,2,386,292,0
48204,73,3803,1296,573,1062,40,33,157,1336,8,201,118,231,209,349,1561,2689,4,12365,686,0,2,278,192,0
48205,14,341,207,111,150,11,0,50,218,5,26,19,36,31,55,133,272,3,943,52,0,2,24,15,0
48206,84,4433,1457,730,1242,11,6,188,1468,10,292,166,329,302,495,2424,4078,5,22973,1276,1,2,439,270,0
48207,39,2323,652,304,544,16,6,88,668,6,89,51,101,95,152,591,998,3,3399,188,0,2,180,111,0
48208,69,3174,1455,414,1257,16,76,112,1471,5,41,23,46,46,69,231,381,2,1069,59,0,2,515,349,0
48209,2,75,7,6,5,0,0,2,7,1,1,1,2,2,3,0,3,1,3,0,0,2,4,4,0
48210,8,271,74,35,59,1,0,14,75,3,14,7,14,17,21,58,85,1,128,7,0,2,19,24,0
48211,95,4654,1523,757,1297,19,12,193,1542,12,193,117,230,205,347,1508,2664,7,19053,1058,0,2,318,200,0
48212,87,3811,1020,354,843,12,15,144,1032,8,134,77,144,142,221,970,1580,4,6792,377,0,2,358,221,0
48213,38,1676,447,308,343,6,5,95,453,7,96,59,111,103,170,651,1136,4,4600,255,0,2,99,72,0
48214,1,107,53,23,39,0,0,13,53,2,8,4,8,10,12,26,39,1,39,2,0,2,13,10,0
48215,21,658,424,94,331,4,0,89,428,1,5,5,5,6,10,11,25,0,12,0,0,2,83,59,0
48216,38,2302,334,251,279,10,4,40,344,5,127,74,143,132,217,899,1528,2,4303,239,0,2,124,98,0
48217,12,493,184,100,137,2,15,30,186,6,38,20,39,44,59,214,322,3,991,55,0,2,47,32,0
48218,59,2582,1293,570,1093,25,15,163,1318,10,195,123,241,205,364,1516,2795,6,17273,959,0,2,198,124,0
48219,33,1883,384,251,317,7,8,52,391,11,70,44,84,81,128,467,811,6,5355,297,0,2,78,55,0
48220,45,2208,722,423,573,19,0,135,741,12,172,101,199,184,300,1320,2257,6,15668,870,0,2,61,38,0
48221,39,1727,386,256,301,16,9,68,402,4,59,35,69,63,104,355,621,2,1453,80,0,2,90,52,0
48222,16,1214,215,129,180,6,0,29,221,8,65,43,72,73,115,415,711,4,3153,175,0,2,75,60,0
48223,79,3060,1043,504,840,53,9,147,1096,9,180,112,198,189,310,1377,2344,4,11604,644,0,2,245,148,0
48224,14,530,295,56,236,0,4,54,295,2,9,5,10,11,15,30,51,1,57,3,0,2,85,52,0
48225,30,1241,373,158,315,8,0,51,381,5,76,44,79,81,123,486,779,2,2026,112,0,2,88,44,0
48226,77,3211,1178,367,1042,6,15,115,1184,9,94,51,95,103,146,644,976,4,4439,246,0,2,460,373,0
48227,91,4584,1943,715,1694,26,18,214,1969,12,185,120,237,197,357,1436,2721,7,20915,1161,0,2,582,518,0
48228,14,826,442,244,305,14,16,103,456,11,68,45,75,79,120,452,756,6,4588,254,0,2,58,34,0
48229,49,1838,1098,241,925,5,10,155,1103,7,46,25,49,53,74,273,423,3,1580,87,0,2,284,183,0
48230,19,682,601,196,481,2,23,85,603,8,63,36,72,71,108,400,664,4,3036,168,0,2,139,107,0
48231,163,5018,1660,832,1314,41,38,274,1701,20,312,209,395,332,604,2671,5058,12,64042,3557,1,2,1,4,0
48232,163,5018,1057,646,719,113,100,145,1170,18,215,134,248,233,382,1740,3004,10,31186,1732,1,2,1,4,0
48233,15,492,42,7,35,4,0,5,46,1,2,1,2,3,3,2,4,0,2,0,0,2,8,4,0
48234,15,492,11,6,10,0,0,1,11,2,4,2,4,6,6,10,15,1,15,0,0,2,8,4,0
48565,111,4174,1450,624,1228,12,26,181,1462,14,306,186,354,320,540,2580,4493,8,36391,2021,1,2,3,3,0
48566,58,1178,207,111,150,11,0,50,218,5,26,19,36,31,55,133,272,3,943,52,0,2,1,1,0
48567,58,1178,410,198,237,31,55,97,441,11,63,38,72,74,110,414,683,6,4293,238,0,2,1,1,0
48568,236,5393,4293,999,3693,19,54,507,4312,9,155,88,170,164,258,1156,1898,4,9368,520,0,2,1,2,0
48569,236,5393,1482,859,1002,125,135,219,1607,16,219,134,251,235,385,1766,3032,9,27804,1544,1,2,1,2,0
48570,147,6910,1392,870,1177,35,17,170,1427,14,494,280,531,508,811,4473,7289,7,54850,3047,2,2,1,2,0
48571,157,4456,1660,832,1314,41,38,274,1701,20,312,209,395,332,604,2671,5058,12,64042,3557,1,2,23,7,1
48572,154,4341,1660,832,1314,41,38,274,1701,20,312,209,395,332,604,2671,5058,12,64042,3557,1,2,15,25,1
48579,154,4341,1660,832,1314,41,38,274,1701,20,312,209,395,332,604,2671,5058,12,64042,3557,1,2,28,22,0
48580,15,495,42,7,35,4,0,5,46,1,2,1,2,3,3,2,4,0,2,0,0,2,7,1,0
48581,15,495,11,6,10,0,0,1,11,2,4,2,4,6,6,10,15,1,15,0,0,2,7,1,0
48607,356,7161,2,2,2,0,0,0,2,0,0,0,0,0,0,0,0,0,0,0,0,2,27,5,0
48621,356,7161,99,48,90,1,3,5,100,0,0,0,0,0,0,0,0,0,0,0,0,2,27,5,0
48622,356,7161,8,5,5,2,0,1,10,0,0,0,0,0,0,0,0,0,0,0,0,2,27,5,0
48623,356,7161,1217,716,841,84,126,174,1301,14,185,118,215,199,333,1446,2542,8,20687,1149,0,2,27,5,0
48624,356,7161,160,89,115,0,13,31,160,7,15,11,17,22,28,78,124,3,495,27,0,2,27,5,0
48625,356,7161,10,10,9,9,0,0,19,0,0,0,0,0,0,0,0,0,0,0,0,2,27,5,0
48626,356,7161,173,84,99,8,29,36,181,5,12,7,13,17,20,54,81,2,221,12,0,2,27,5,0
48627,356,7161,3,1,1,3,0,0,6,0,0,0,0,0,0,0,0,0,0,0,0,2,27,5,0
48630,262,5263,2,2,2,0,0,0,2,0,0,0,0,0,0,0,0,0,0,0,0,2,2,390,1
48644,262,5263,99,48,90,1,3,5,100,0,0,0,0,0,0,0,0,0,0,0,0,2,2,390,1
48645,262,5263,8,5,5,2,0,1,10,0,0,0,0,0,0,0,0,0,0,0,0,2,2,390,1
48646,262,5263,1217,716,841,84,126,174,1301,14,185,118,215,199,333,1446,2542,8,20687,1149,0,2,2,390,1
48647,262,5263,160,89,115,0,13,31,160,7,15,11,17,22,28,78,124,3,495,27,0,2,2,390,1
48648,262,5263,10,10,9,9,0,0,19,0,0,0,0,0,0,0,0,0,0,0,0,2,2,390,1
48649,262,5263,173,84,99,8,29,36,181,5,12,7,13,17,20,54,81,2,221,12,0,2,2,390,1
48650,262,5263,3,1,1,3,0,0,6,0,0,0,0,0,0,0,0,0,0,0,0,2,2,390,1
48651,94,1911,463,295,324,28,62,57,491,12,134,82,154,146,236,989,1696,6,11700,650,0,0,394,0,1
48654,211,4544,2,2,2,0,0,0,2,0,0,0,0,0,0,0,0,0,0,0,0,2,2,147,1
48668,211,4544,99,48,90,1,3,5,100,0,0,0,0,0,0,0,0,0,0,0,0,2,2,147,1
48669,211,4544,8,5,5,2,0,1,10,0,0,0,0,0,0,0,0,0,0,0,0,2,2,147,1
48670,211,4544,1217,716,841,84,126,174,1301,14,185,118,215,199,333,1446,2542,8,20687,1149,0,2,2,147,1
48671,211,4544,160,89,115,0,13,31,160,7,15,11,17,22,28,78,124,3,495,27,0,2,2,147,1
48672,211,4544,10,10,9,9,0,0,19,0,0,0,0,0,0,0,0,0,0,0,0,2,2,147,1
48673,211,4544,173,84,99,8,29,36,181,5,12,7,13,17,20,54,81,2,221,12,0,2,2,147,1
48674,211,4544,3,1,1,3,0,0,6,0,0,0,0,0,0,0,0,0,0,0,0,2,2,147,1
48676,51,727,167,116,138,4,5,22,171,8,48,30,56,56,86,292,499,4,2330,129,0,0,140,0,1
48677,125,5131,1513,682,1277,25,13,200,1538,11,199,116,219,210,335,1557,2584,6,15641,868,0,2,1,1,0
48678,84,4436,1457,730,1242,11,6,188,1468,10,292,166,329,302,495,2424,4078,5,22973,1276,1,2,2,6,0
48679,38,2304,334,251,279,10,4,40,344,5,127,74,143,132,217,899,1528,2,4303,239,0,2,1,1,0
48680,209,4543,1943,715,1694,26,18,214,1969,12,185,120,237,197,357,1436,2721,7,20915,1161,0,2,2,2,0
48681,209,4543,1168,838,957,57,25,144,1225,19,348,224,416,367,640,3018,5452,11,61921,3440,1,2,2,2,0
48682,91,4584,1943,715,1694,26,18,214,1969,12,185,120,237,197,357,1436,2721,7,20915,1161,0,2,1,1,0
48686,10,379,42,7,35,4,0,5,46,1,2,1,2,3,3,2,4,0,2,0,0,2,1,21,0
48687,10,379,11,6,10,0,0,1,11,2,4,2,4,6,6,10,15,1,15,0,0,2,1,21,0
48690,115,2582,1043,504,840,53,9,147,1096,9,180,112,198,189,310,1377,2344,4,11604,644,0,2,1,0,0
48691,115,2582,383,288,292,26,6,62,409,11,65,38,67,76,105,429,656,5,3719,206,0,2,1,0,0
48692,79,3058,1043,504,840,53,9,147,1096,9,180,112,198,189,310,1377,2344,4,11604,644,0,2,1,1,0
48696,115,2577,1043,504,840,53,9,147,1096,9,180,112,198,189,310,1377,2344,4,11604,644,0,2,0,1,0
48697,115,2577,383,288,292,26,6,62,409,11,65,38,67,76,105,429,656,5,3719,206,0,2,0,1,0
48698,79,3060,1043,504,840,53,9,147,1096,9,180,112,198,189,310,1377,2344,4,11604,644,0,2,1,1,0
48699,209,4545,1943,715,1694,26,18,214,1969,12,185,120,237,197,357,1436,2721,7,20915,1161,0,2,1,1,0
48700,209,4545,1168,838,957,57,25,144,1225,19,348,224,416,367,640,3018,5452,11,61921,3440,1,2,1,1,0
48701,91,4597,1943,715,1694,26,18,214,1969,12,185,120,237,197,357,1436,2721,7,20915,1161,0,2,4,1,0
48705,172,7590,139,89,101,2,0,35,141,7,54,34,62,61,96,330,569,4,2287,127,0,2,2,2,1
48706,172,7590,7,5,5,0,0,2,7,1,2,1,2,3,3,2,4,0,2,0,0,2,2,2,1
48710,172,7590,139,89,101,2,0,35,141,7,54,34,62,61,96,330,569,4,2287,127,0,2,2,2,0
48711,172,7590,7,5,5,0,0,2,7,1,2,1,2,3,3,2,4,0,2,0,0,2,2,2,0
48712,118,2609,1043,504,840,53,9,147,1096,9,180,112,198,189,310,1377,2344,4,11604,644,0,2,10,1,1
48713,118,2609,383,288,292,26,6,62,409,11,65,38,67,76,105,429,656,5,3719,206,0,2,10,1,1
48714,82,3156,1043,504,840,53,9,147,1096,9,180,112,198,189,310,1377,2344,4,11604,644,0,2,17,0,1
48715,82,3156,1043,504,840,53,9,147,1096,9,180,112,198,189,310,1377,2344,4,11604,644,0,2,1,0,0
48716,82,3160,1043,504,840,53,9,147,1096,9,180,112,198,189,310,1377,2344,4,11604,644,0,2,1,1,0
48717,118,2609,1043,504,840,53,9,147,1096,9,180,112,198,189,310,1377,2344,4,11604,644,0,2,10,1,0
48718,118,2609,383,288,292,26,6,62,409,11,65,38,67,76,105,429,656,5,3719,206,0,2,10,1,0
48719,82,3160,1043,504,840,53,9,147,1096,9,180,112,198,189,310,1377,2344,4,11604,644,0,2,18,0,0
48720,82,1757,402,202,227,24,74,80,426,12,52,33,61,64,94,339,564,7,3969,220,0,2,8,1,1
48721,72,1650,53,23,39,0,0,13,53,2,8,4,8,10,12,26,39,1,39,2,0,2,4,2,1
48722,72,1650,515,298,307,33,80,99,548,12,63,44,77,75,121,419,753,7,5527,307,0,2,4,2,1
48723,88,3885,1020,354,843,12,15,144,1032,8,134,77,144,142,221,970,1580,4,6792,377,0,2,10,1,1
48724,82,1767,402,202,227,24,74,80,426,12,52,33,61,64,94,339,564,7,3969,220,0,2,5,1,1
48725,72,1646,53,23,39,0,0,13,53,2,8,4,8,10,12,26,39,1,39,2,0,2,3,5,1
48726,72,1646,515,298,307,33,80,99,548,12,63,44,77,75,121,419,753,7,5527,307,0,2,3,5,1
48727,33,1004,465,148,393,5,8,60,470,4,31,20,31,35,51,161,261,2,523,29,0,2,3,0,0
48728,33,1004,16,12,9,0,0,6,16,1,2,1,2,3,3,2,4,0,2,0,0,2,3,0,0
48729,82,1767,402,202,227,24,74,80,426,12,52,33,61,64,94,339,564,7,3969,220,0,2,12,1,0
48730,72,1646,53,23,39,0,0,13,53,2,8,4,8,10,12,26,39,1,39,2,0,2,3,3,0
48731,72,1646,515,298,307,33,80,99,548,12,63,44,77,75,121,419,753,7,5527,307,0,2,3,3,0
48734,88,3885,1020,354,843,12,15,144,1032,8,134,77,144,142,221,970,1580,4,6792,377,0,2,10,1,0
48735,73,1667,53,23,39,0,0,13,53,2,8,4,8,10,12,26,39,1,39,2,0,2,7,2,0
48736,73,1667,515,298,307,33,80,99,548,12,63,44,77,75,121,419,753,7,5527,307,0,2,7,2,0
48737,90,3963,1020,354,843,12,15,144,1032,8,134,77,144,142,221,970,1580,4,6792,377,0,2,9,0,0
48738,73,1667,53,23,39,0,0,13,53,2,8,4,8,10,12,26,39,1,39,2,0,2,4,3,1
48739,73,1667,515,298,307,33,80,99,548,12,63,44,77,75,121,419,753,7,5527,307,0,2,4,3,1
48740,73,1667,53,23,39,0,0,13,53,2,8,4,8,10,12,26,39,1,39,2,0,2,1,1,0
48741,73,1667,515,298,307,33,80,99,548,12,63,44,77,75,121,419,753,7,5527,307,0,2,1,1,0
48743,73,1667,53,23,39,0,0,13,53,2,8,4,8,10,12,26,39,1,39,2,0,2,10,4,0
48744,73,1667,515,298,307,33,80,99,548,12,63,44,77,75,121,419,753,7,5527,307,0,2,10,4,0
48747,90,3963,1020,354,843,12,15,144,1032,8,134,77,144,142,221,970,1580,4,6792,377,0,2,19,1,0
48748,88,2248,773,422,505,30,103,129,803,14,77,46,83,91,129,535,839,7,6334,351,0,2,16,0,0
48749,15,703,139,89,101,2,0,35,141,7,54,34,62,61,96,330,569,4,2287,127,0,2,21,0,0
48752,8,183,51,25,36,0,0,15,51,3,11,6,12,14,18,42,68,1,112,6,0,0,34,0,1
48753,8,263,51,25,36,0,0,15,51,3,11,6,12,14,18,42,68,1,112,6,0,2,17,1,0
48754,8,265,51,25,36,0,0,15,51,3,11,6,12,14,18,42,68,1,112,6,0,2,34,30,0
48755,70,3212,1455,414,1257,16,76,112,1471,5,41,23,46,46,69,231,381,2,1069,59,0,2,16,0,1
48756,85,2161,1455,414,1257,16,76,112,1471,5,41,23,46,46,69,231,381,2,1069,59,0,2,1,1,0
48757,85,2161,669,365,481,22,61,110,691,15,103,63,122,118,185,747,1273,8,11311,628,0,2,1,1,0
48758,10,382,42,7,35,4,0,5,46,1,2,1,2,3,3,2,4,0,2,0,0,2,7,1,0
48759,10,382,11,6,10,0,0,1,11,2,4,2,4,6,6,10,15,1,15,0,0,2,7,1,0
48762,211,4544,2,2,2,0,0,0,2,0,0,0,0,0,0,0,0,0,0,0,0,3,31,542,0
48776,211,4544,99,48,90,1,3,5,100,0,0,0,0,0,0,0,0,0,0,0,0,3,31,542,0
48777,211,4544,8,5,5,2,0,1,10,0,0,0,0,0,0,0,0,0,0,0,0,3,31,542,0
48778,211,4544,1217,716,841,84,126,174,1301,14,185,118,215,199,333,1446,2542,8,20687,1149,0,3,31,542,0
48779,211,4544,160,89,115,0,13,31,160,7,15,11,17,22,28,78,124,3,495,27,0,3,31,542,0
48780,211,4544,10,10,9,9,0,0,19,0,0,0,0,0,0,0,0,0,0,0,0,3,31,542,0
48781,211,4544,173,84,99,8,29,36,181,5,12,7,13,17,20,54,81,2,221,12,0,3,31,542,0
48782,211,4544,3,1,1,3,0,0,6,0,0,0,0,0,0,0,0,0,0,0,0,3,31,542,0
48783,94,1911,463,295,324,28,62,57,491,12,134,82,154,146,236,989,1696,6,11700,650,0,0,394,0,0
48785,51,727,167,116,138,4,5,22,171,8,48,30,56,56,86,292,499,4,2330,129,0,0,140,0,0
48789,8,265,51,25,36,0,0,15,51,3,11,6,12,14,18,42,68,1,112,6,0,0,54,0,0
48790,78,1581,757,253,292,73,244,162,830,13,61,38,67,74,105,409,651,7,4654,258,0,2,1,1,0
48791,46,956,386,256,301,16,9,68,402,4,59,35,69,63,104,355,621,2,1453,80,0,2,1,1,0
48792,46,956,264,131,164,11,41,46,275,6,38,22,40,44,62,214,338,3,1068,59,0,2,1,1,0
48798,70,3212,1455,414,1257,16,76,112,1471,5,41,23,46,46,69,231,381,2,1069,59,0,2,16,0,0
48799,285,6275,72,33,56,0,4,12,72,1,1,1,1,2,2,0,2,0,1,0,0,2,2,4,0
48800,285,6275,1454,835,1044,76,110,219,1530,17,275,158,296,292,454,2297,3718,9,34017,1889,1,2,2,4,0
48803,74,1755,996,429,845,24,10,117,1020,7,76,50,88,83,138,494,879,4,3565,198,0,2,16,0,1
48804,74,1755,456,277,329,12,42,72,468,13,85,50,97,98,147,592,972,7,7212,400,0,2,16,0,1
48805,74,1755,996,429,845,24,10,117,1020,7,76,50,88,83,138,494,879,4,3565,198,0,2,3,6,1
48806,74,1755,456,277,329,12,42,72,468,13,85,50,97,98,147,592,972,7,7212,400,0,2,3,6,1
48807,74,1755,996,429,845,24,10,117,1020,7,76,50,88,83,138,494,879,4,3565,198,0,2,5,2,0
48808,74,1755,456,277,329,12,42,72,468,13,85,50,97,98,147,592,972,7,7212,400,0,2,5,2,0
48809,74,1762,996,429,845,24,10,117,1020,7,76,50,88,83,138,494,879,4,3565,198,0,2,10,5,0
48810,74,1762,456,277,329,12,42,72,468,13,85,50,97,98,147,592,972,7,7212,400,0,2,10,5,0
48811,39,2970,996,429,845,24,10,117,1020,7,76,50,88,83,138,494,879,4,3565,198,0,2,29,1,0
48812,82,1769,402,202,227,24,74,80,426,12,52,33,61,64,94,339,564,7,3969,220,0,2,2,1,0
48814,74,1762,996,429,845,24,10,117,1020,7,76,50,88,83,138,494,879,4,3565,198,0,2,1,1,0
48815,74,1762,456,277,329,12,42,72,468,13,85,50,97,98,147,592,972,7,7212,400,0,2,1,1,0
48816,74,1762,996,429,845,24,10,117,1020,7,76,50,88,83,138,494,879,4,3565,198,0,2,21,0,0
48817,74,1762,456,277,329,12,42,72,468,13,85,50,97,98,147,592,972,7,7212,400,0,2,21,0,0
48819,10,393,42,7,35,4,0,5,46,1,2,1,2,3,3,2,4,0,2,0,0,2,3,1,1
48820,10,393,11,6,10,0,0,1,11,2,4,2,4,6,6,10,15,1,15,0,0,2,3,1,1
48821,73,1672,996,429,845,24,10,117,1020,7,76,50,88,83,138,494,879,4,3565,198,0,2,48,53,1
48822,73,1672,456,277,329,12,42,72,468,13,85,50,97,98,147,592,972,7,7212,400,0,2,48,53,1
48823,58,1187,207,111,150,11,0,50,218,5,26,19,36,31,55,133,272,3,943,52,0,2,3,0,1
48824,58,1187,410,198,237,31,55,97,441,11,63,38,72,74,110,414,683,6,4293,238,0,2,3,0,1
48825,39,2971,996,429,845,24,10,117,1020,7,76,50,88,83,138,494,879,4,3565,198,0,2,3,1,1
48826,2,71,167,116,138,4,5,22,171,8,48,30,56,56,86,292,499,4,2330,129,0,0,13,0,0
48827,73,1672,996,429,845,24,10,117,1020,7,76,50,88,83,138,494,879,4,3565,198,0,2,2,2,0
48828,73,1672,456,277,329,12,42,72,468,13,85,50,97,98,147,592,972,7,7212,400,0,2,2,2,0
48829,58,1191,207,111,150,11,0,50,218,5,26,19,36,31,55,133,272,3,943,52,0,2,1,1,0
48830,58,1191,410,198,237,31,55,97,441,11,63,38,72,74,110,414,683,6,4293,238,0,2,1,1,0
48831,76,1730,996,429,845,24,10,117,1020,7,76,50,88,83,138,494,879,4,3565,198,0,2,12,12,0
48832,76,1730,456,277,329,12,42,72,468,13,85,50,97,98,147,592,972,7,7212,400,0,2,12,12,0
48833,11,410,42,7,35,4,0,5,46,1,2,1,2,3,3,2,4,0,2,0,0,2,4,2,0
48834,11,410,11,6,10,0,0,1,11,2,4,2,4,6,6,10,15,1,15,0,0,2,4,2,0
48835,58,1196,207,111,150,11,0,50,218,5,26,19,36,31,55,133,272,3,943,52,0,2,6,3,0
48836,58,1196,410,198,237,31,55,97,441,11,63,38,72,74,110,414,683,6,4293,238,0,2,6,3,0
48837,11,410,42,7,35,4,0,5,46,1,2,1,2,3,3,2,4,0,2,0,0,2,3,3,1
48838,11,410,11,6,10,0,0,1,11,2,4,2,4,6,6,10,15,1,15,0,0,2,3,3,1
48839,58,1196,207,111,150,11,0,50,218,5,26,19,36,31,55,133,272,3,943,52,0,2,1,1,1
48840,58,1196,410,198,237,31,55,97,441,11,63,38,72,74,110,414,683,6,4293,238,0,2,1,1,1
48841,76,1711,996,429,845,24,10,117,1020,7,76,50,88,83,138,494,879,4,3565,198,0,2,18,19,0
48842,76,1711,456,277,329,12,42,72,468,13,85,50,97,98,147,592,972,7,7212,400,0,2,18,19,0
48843,39,2971,996,429,845,24,10,117,1020,7,76,50,88,83,138,494,879,4,3565,198,0,2,2,2,0
48844,74,1700,996,429,845,24,10,117,1020,7,76,50,88,83,138,494,879,4,3565,198,0,2,4,4,0
48845,74,1700,456,277,329,12,42,72,468,13,85,50,97,98,147,592,972,7,7212,400,0,2,4,4,0
48846,74,1693,996,429,845,24,10,117,1020,7,76,50,88,83,138,494,879,4,3565,198,0,2,1,1,0
48847,74,1693,456,277,329,12,42,72,468,13,85,50,97,98,147,592,972,7,7212,400,0,2,1,1,0
48848,164,5065,1660,832,1314,41,38,274,1701,20,312,209,395,332,604,2671,5058,12,64042,3557,1,2,10,0,0
48849,164,5065,1057,646,719,113,100,145,1170,18,215,134,248,233,382,1740,3004,10,31186,1732,1,2,10,0,0
48850,88,3896,1020,354,843,12,15,144,1032,8,134,77,144,142,221,970,1580,4,6792,377,0,2,5,1,0
48854,11,410,42,7,35,4,0,5,46,1,2,1,2,3,3,2,4,0,2,0,0,2,4,0,0
48855,11,410,11,6,10,0,0,1,11,2,4,2,4,6,6,10,15,1,15,0,0,2,4,0,0
48856,74,1693,996,429,845,24,10,117,1020,7,76,50,88,83,138,494,879,4,3565,198,0,2,68,74,0
48857,74,1693,456,277,329,12,42,72,468,13,85,50,97,98,147,592,972,7,7212,400,0,2,68,74,0
48858,58,1196,207,111,150,11,0,50,218,5,26,19,36,31,55,133,272,3,943,52,0,2,7,1,0
48859,58,1196,410,198,237,31,55,97,441,11,63,38,72,74,110,414,683,6,4293,238,0,2,7,1,0
48861,39,2971,996,429,845,24,10,117,1020,7,76,50,88,83,138,494,879,4,3565,198,0,2,5,3,0
48862,78,1601,757,253,292,73,244,162,830,13,61,38,67,74,105,409,651,7,4654,258,0,2,5,3,0
48863,56,3691,520,294,400,33,13,81,553,10,261,204,367,271,571,2128,4614,7,32445,1802,1,2,17,2,0
48866,60,1081,282,196,195,3,0,86,285,8,130,71,141,138,212,936,1507,4,6538,363,0,2,0,17,1
48867,1,90,13,10,10,0,0,3,13,1,2,1,2,3,3,2,4,0,2,0,0,2,1,1,1
48868,7,114,44,19,17,0,16,11,44,3,14,7,14,17,21,58,85,1,128,7,0,2,0,1,1
48869,3,66,127,75,83,2,11,30,129,4,14,7,14,18,21,61,87,2,175,9,0,2,0,1,1
48870,3,66,652,304,544,16,6,88,668,6,89,51,101,95,152,591,998,3,3399,188,0,2,0,1,1
48871,3,66,2,2,2,0,0,0,2,0,0,0,0,0,0,0,0,0,0,0,0,2,0,1,1
48872,3,66,8,5,5,0,0,3,8,0,0,0,0,0,0,0,0,0,0,0,0,2,0,1,1
48875,3,66,14,8,8,0,0,6,14,0,0,0,0,0,0,0,0,0,0,0,0,2,0,1,1
48876,3,66,6,4,4,0,0,2,6,0,0,0,0,0,0,0,0,0,0,0,0,2,0,1,1
48877,3,66,6,4,4,0,0,2,6,1,2,1,2,3,3,2,4,0,2,0,0,2,0,1,1
48879,3,66,7,5,5,0,0,2,7,0,0,0,0,0,0,0,0,0,0,0,0,2,0,1,1
48881,3,66,10,6,6,0,0,4,10,0,0,0,0,0,0,0,0,0,0,0,0,2,0,1,1
48882,3,66,1,1,1,0,0,0,1,0,0,0,0,0,0,0,0,0,0,0,0,2,0,1,1
48884,3,66,14,10,10,0,0,4,14,1,1,1,1,2,2,0,2,0,1,0,0,2,0,1,1
48885,3,66,46,26,30,3,0,12,49,3,6,3,6,9,9,20,28,1,42,2,0,2,0,1,1
48886,7,298,72,33,56,0,4,12,72,1,1,1,1,2,2,0,2,0,1,0,0,2,0,1,1
48887,12,229,127,75,83,2,11,30,129,4,14,7,14,18,21,61,87,2,175,9,0,2,0,2,1
48888,12,229,652,304,544,16,6,88,668,6,89,51,101,95,152,591,998,3,3399,188,0,2,0,2,1
48889,12,229,2,2,2,0,0,0,2,0,0,0,0,0,0,0,0,0,0,0,0,2,0,2,1
48890,12,229,8,5,5,0,0,3,8,0,0,0,0,0,0,0,0,0,0,0,0,2,0,2,1
48893,12,229,14,8,8,0,0,6,14,0,0,0,0,0,0,0,0,0,0,0,0,2,0,2,1
48894,12,229,6,4,4,0,0,2,6,0,0,0,0,0,0,0,0,0,0,0,0,2,0,2,1
48895,12,229,6,4,4,0,0,2,6,1,2,1,2,3,3,2,4,0,2,0,0,2,0,2,1
48897,12,229,7,5,5,0,0,2,7,0,0,0,0,0,0,0,0,0,0,0,0,2,0,2,1
48899,12,229,10,6,6,0,0,4,10,0,0,0,0,0,0,0,0,0,0,0,0,2,0,2,1
48900,12,229,1,1,1,0,0,0,1,0,0,0,0,0,0,0,0,0,0,0,0,2,0,2,1
48902,12,229,14,10,10,0,0,4,14,1,1,1,1,2,2,0,2,0,1,0,0,2,0,2,1
48903,12,229,46,26,30,3,0,12,49,3,6,3,6,9,9,20,28,1,42,2,0,2,0,2,1
48904,6,71,127,75,83,2,11,30,129,4,14,7,14,18,21,61,87,2,175,9,0,2,0,1,1
48905,6,71,652,304,544,16,6,88,668,6,89,51,101,95,152,591,998,3,3399,188,0,2,0,1,1
48906,6,71,2,2,2,0,0,0,2,0,0,0,0,0,0,0,0,0,0,0,0,2,0,1,1
48907,6,71,8,5,5,0,0,3,8,0,0,0,0,0,0,0,0,0,0,0,0,2,0,1,1
48910,6,71,14,8,8,0,0,6,14,0,0,0,0,0,0,0,0,0,0,0,0,2,0,1,1
48911,6,71,6,4,4,0,0,2,6,0,0,0,0,0,0,0,0,0,0,0,0,2,0,1,1
48912,6,71,6,4,4,0,0,2,6,1,2,1,2,3,3,2,4,0,2,0,0,2,0,1,1
48914,6,71,7,5,5,0,0,2,7,0,0,0,0,0,0,0,0,0,0,0,0,2,0,1,1
48916,6,71,10,6,6,0,0,4,10,0,0,0,0,0,0,0,0,0,0,0,0,2,0,1,1
48917,6,71,1,1,1,0,0,0,1,0,0,0,0,0,0,0,0,0,0,0,0,2,0,1,1
48919,6,71,14,10,10,0,0,4,14,1,1,1,1,2,2,0,2,0,1,0,0,2,0,1,1
48920,6,71,46,26,30,3,0,12,49,3,6,3,6,9,9,20,28,1,42,2,0,2,0,1,1
48921,3,26,14,7,7,2,0,5,16,0,0,0,0,0,0,0,0,0,0,0,0,2,0,1,1
48922,213,4619,182,127,129,0,0,53,182,5,39,21,42,44,63,217,343,2,926,51,0,2,20,19,1
48923,213,4619,1165,710,800,67,119,181,1232,18,243,153,282,261,435,2000,3492,10,36473,2026,1,2,20,19,1
48924,83,1808,773,419,590,28,0,166,801,10,204,113,217,214,330,1598,2554,5,13587,754,0,2,4,3,1
48925,83,1808,421,273,302,44,34,57,465,17,81,59,107,98,166,583,1098,11,12329,684,0,2,4,3,1
48926,164,5065,1660,832,1314,41,38,274,1701,20,312,209,395,332,604,2671,5058,12,64042,3557,1,2,1,1,1
48927,164,5065,1057,646,719,113,100,145,1170,18,215,134,248,233,382,1740,3004,10,31186,1732,1,2,1,1,1
48928,89,1830,477,336,357,30,23,73,507,16,194,134,250,210,384,1538,2962,10,30538,1696,0,2,1,1,1
48929,71,1702,996,429,845,24,10,117,1020,7,76,50,88,83,138,494,879,4,3565,198,0,2,1,4,1
48930,71,1702,456,277,329,12,42,72,468,13,85,50,97,98,147,592,972,7,7212,400,0,2,1,4,1
48931,145,3016,1513,682,1277,25,13,200,1538,11,199,116,219,210,335,1557,2584,6,15641,868,0,2,0,2,1
48932,145,3016,819,519,539,24,98,155,843,15,96,57,106,111,163,690,1107,8,9171,509,0,2,0,2,1
48933,58,1174,207,111,150,11,0,50,218,5,26,19,36,31,55,133,272,3,943,52,0,2,5,15,1
48934,58,1174,410,198,237,31,55,97,441,11,63,38,72,74,110,414,683,6,4293,238,0,2,5,15,1
48937,211,4551,2,2,2,0,0,0,2,0,0,0,0,0,0,0,0,0,0,0,0,2,15,10,1
48951,211,4551,99,48,90,1,3,5,100,0,0,0,0,0,0,0,0,0,0,0,0,2,15,10,1
48952,211,4551,8,5,5,2,0,1,10,0,0,0,0,0,0,0,0,0,0,0,0,2,15,10,1
48953,211,4551,1217,716,841,84,126,174,1301,14,185,118,215,199,333,1446,2542,8,20687,1149,0,2,15,10,1
48954,211,4551,160,89,115,0,13,31,160,7,15,11,17,22,28,78,124,3,495,27,0,2,15,10,1
48955,211,4551,10,10,9,9,0,0,19,0,0,0,0,0,0,0,0,0,0,0,0,2,15,10,1
48956,211,4551,173,84,99,8,29,36,181,5,12,7,13,17,20,54,81,2,221,12,0,2,15,10,1
48957,211,4551,3,1,1,3,0,0,6,0,0,0,0,0,0,0,0,0,0,0,0,2,15,10,1
48958,94,1909,463,295,324,28,62,57,491,12,134,82,154,146,236,989,1696,6,11700,650,0,2,3,5,1
48960,51,727,167,116,138,4,5,22,171,8,48,30,56,56,86,292,499,4,2330,129,0,2,0,1,1
48961,28,810,339,213,244,17,9,65,356,10,42,26,48,52,74,259,421,5,2410,133,0,2,4,4,1
48963,85,2161,1455,414,1257,16,76,112,1471,5,41,23,46,46,69,231,381,2,1069,59,0,2,3,12,1
48964,85,2161,669,365,481,22,61,110,691,15,103,63,122,118,185,747,1273,8,11311,628,0,2,3,12,1
48965,236,5392,4293,999,3693,19,54,507,4312,9,155,88,170,164,258,1156,1898,4,9368,520,0,2,6,8,1
48966,236,5392,1482,859,1002,125,135,219,1607,16,219,134,251,235,385,1766,3032,9,27804,1544,1,2,6,8,1
48967,27,959,74,35,59,1,0,14,75,3,14,7,14,17,21,58,85,1,128,7,0,2,1,1,1
48968,27,959,245,125,200,5,7,34,250,7,30,17,34,37,51,166,265,3,1053,58,0,2,1,1,1
48969,98,2661,1523,757,1297,19,12,193,1542,12,193,117,230,205,347,1508,2664,7,19053,1058,0,2,1,6,1
48970,98,2661,701,378,504,33,58,109,734,13,110,68,126,123,194,794,1346,7,10027,557,0,2,1,6,1
48971,86,2225,773,422,505,30,103,129,803,14,77,46,83,91,129,535,839,7,6334,351,0,2,1,3,1
48972,122,2937,77,34,69,0,0,8,77,3,24,16,29,27,45,114,213,1,387,21,0,2,1,1,1
48973,122,2937,712,438,573,51,9,84,763,14,102,71,128,116,199,733,1364,8,11988,666,0,2,1,1,1
48974,30,658,125,97,103,3,0,19,128,9,25,17,27,34,44,144,223,4,1087,60,0,2,0,1,1
48975,82,1776,402,202,227,24,74,80,426,12,52,33,61,64,94,339,564,7,3969,220,0,2,12,8,1
48976,48,992,447,308,343,6,5,95,453,7,96,59,111,103,170,651,1136,4,4600,255,0,2,0,1,1
48977,48,992,322,174,179,16,74,51,338,10,41,26,46,51,72,252,408,5,2291,127,0,2,0,1,1
48978,72,1646,53,23,39,0,0,13,53,2,8,4,8,10,12,26,39,1,39,2,0,2,2,2,1
48979,72,1646,515,298,307,33,80,99,548,12,63,44,77,75,121,419,753,7,5527,307,0,2,2,2,1
48980,20,511,205,80,86,16,53,53,221,7,18,10,19,25,29,94,134,3,497,27,0,2,1,0,1
48981,226,5306,722,423,573,19,0,135,741,12,172,101,199,184,300,1320,2257,6,15668,870,0,2,7,14,1
48982,226,5306,1508,847,911,44,250,301,1552,14,148,88,169,162,257,1120,1886,7,15077,837,0,2,7,14,1
48983,285,6283,72,33,56,0,4,12,72,1,1,1,1,2,2,0,2,0,1,0,0,2,14,15,1
48984,285,6283,1454,835,1044,76,110,219,1530,17,275,158,296,292,454,2297,3718,9,34017,1889,1,2,14,15,1
48985,78,1601,757,253,292,73,244,162,830,13,61,38,67,74,105,409,651,7,4654,258,0,2,2,4,1
48986,46,954,386,256,301,16,9,68,402,4,59,35,69,63,104,355,621,2,1453,80,0,2,1,4,1
48987,46,954,264,131,164,11,41,46,275,6,38,22,40,44,62,214,338,3,1068,59,0,2,1,4,1
48988,30,650,215,129,180,6,0,29,221,8,65,43,72,73,115,415,711,4,3153,175,0,2,0,1,1
48989,30,650,97,69,77,3,3,16,100,6,22,13,23,28,36,113,173,3,542,30,0,2,0,1,1
48990,118,2612,1043,504,840,53,9,147,1096,9,180,112,198,189,310,1377,2344,4,11604,644,0,2,13,8,1
48991,118,2612,383,288,292,26,6,62,409,11,65,38,67,76,105,429,656,5,3719,206,0,2,13,8,1
48992,70,1382,1178,367,1042,6,15,115,1184,9,94,51,95,103,146,644,976,4,4439,246,0,2,5,4,1
48993,70,1382,177,108,140,8,0,27,185,6,30,16,32,36,48,162,248,3,794,44,0,2,5,4,1
48994,209,4552,1943,715,1694,26,18,214,1969,12,185,120,237,197,357,1436,2721,7,20915,1161,0,2,15,12,1
48995,209,4552,1168,838,957,57,25,144,1225,19,348,224,416,367,640,3018,5452,11,61921,3440,1,2,15,12,1
48996,62,1226,1098,241,925,5,10,155,1103,7,46,25,49,53,74,273,423,3,1580,87,0,2,5,7,1
48997,62,1226,282,202,222,14,2,44,296,8,42,24,43,50,67,250,378,4,1548,86,0,2,5,7,1
48998,22,458,601,196,481,2,23,85,603,8,63,36,72,71,108,400,664,4,3036,168,0,2,2,3,1
48999,22,458,156,79,106,5,16,28,161,5,14,8,15,19,23,64,97,2,261,14,0,2,2,3,1
49000,92,3868,1289,550,1043,56,32,155,1345,10,167,93,185,177,278,1266,2075,5,11498,638,0,2,4,7,1
49001,36,1088,182,127,129,0,0,53,182,5,39,21,42,44,63,217,343,2,926,51,0,2,0,8,1
49002,147,6910,1392,870,1177,35,17,170,1427,14,494,280,531,508,811,4473,7289,7,54850,3047,2,2,0,15,1
49003,88,2881,773,419,590,28,0,166,801,10,204,113,217,214,330,1598,2554,5,13587,754,0,2,0,12,1
49004,15,744,75,38,59,1,3,12,76,2,4,2,4,6,6,10,15,1,15,0,0,2,4,4,1
49005,1,136,149,67,118,4,0,27,153,1,17,14,28,18,42,69,175,0,144,8,0,2,2,4,1
49006,31,1986,1157,318,931,29,22,177,1186,6,104,63,125,110,188,712,1274,3,4596,255,0,2,20,15,1
49007,56,3685,520,294,400,33,13,81,553,10,261,204,367,271,571,2128,4614,7,32445,1802,1,2,10,15,1
49008,97,4403,1338,495,1086,10,64,173,1348,11,122,82,157,133,239,883,1686,7,11934,663,0,2,4,11,1
49009,172,7588,139,89,101,2,0,35,141,7,54,34,62,61,96,330,569,4,2287,127,0,2,12,30,1
49010,172,7588,7,5,5,0,0,2,7,1,2,1,2,3,3,2,4,0,2,0,0,2,12,30,1
49011,33,1004,465,148,393,5,8,60,470,4,31,20,31,35,51,161,261,2,523,29,0,2,0,8,1
49012,33,1004,16,12,9,0,0,6,16,1,2,1,2,3,3,2,4,0,2,0,0,2,0,8,1
49013,139,5895,1782,648,1425,9,47,279,1791,8,171,97,189,179,286,1292,2140,4,9462,525,0,2,28,58,1
49014,25,684,256,139,192,9,7,47,265,4,23,12,24,27,36,112,171,2,357,19,0,2,0,5,1
49015,23,578,102,59,69,5,3,24,107,6,22,15,28,28,43,113,206,3,789,43,0,2,0,1,1
49016,111,4174,1450,624,1228,12,26,181,1462,14,306,186,354,320,540,2580,4493,8,36391,2021,1,2,12,25,1
49017,154,4337,1660,832,1314,41,38,274,1701,20,312,209,395,332,604,2671,5058,12,64042,3557,1,2,4,30,1
49018,36,2870,996,429,845,24,10,117,1020,7,76,50,88,83,138,494,879,4,3565,198,0,2,11,16,1
49019,125,5131,1513,682,1277,25,13,200,1538,11,199,116,219,210,335,1557,2584,6,15641,868,0,2,0,6,1
49020,73,3803,1296,573,1062,40,33,157,1336,8,201,118,231,209,349,1561,2689,4,12365,686,0,2,0,11,1
49021,14,341,207,111,150,11,0,50,218,5,26,19,36,31,55,133,272,3,943,52,0,2,0,4,1
49022,84,4438,1457,730,1242,11,6,188,1468,10,292,166,329,302,495,2424,4078,5,22973,1276,1,2,3,14,1
49023,39,2323,652,304,544,16,6,88,668,6,89,51,101,95,152,591,998,3,3399,188,0,2,0,4,1
49024,70,3212,1455,414,1257,16,76,112,1471,5,41,23,46,46,69,231,381,2,1069,59,0,2,0,4,1
49025,95,4652,1523,757,1297,19,12,193,1542,12,193,117,230,205,347,1508,2664,7,19053,1058,0,2,9,16,1
49026,88,3896,1020,354,843,12,15,144,1032,8,134,77,144,142,221,970,1580,4,6792,377,0,2,0,6,1
49027,38,1676,447,308,343,6,5,95,453,7,96,59,111,103,170,651,1136,4,4600,255,0,2,0,4,1
49028,21,658,424,94,331,4,0,89,428,1,5,5,5,6,10,11,25,0,12,0,0,2,0,1,1
49029,38,2302,334,251,279,10,4,40,344,5,127,74,143,132,217,899,1528,2,4303,239,0,2,5,14,1
49030,12,493,184,100,137,2,15,30,186,6,38,20,39,44,59,214,322,3,991,55,0,2,0,3,1
49031,59,2582,1293,570,1093,25,15,163,1318,10,195,123,241,205,364,1516,2795,6,17273,959,0,2,0,4,1
49032,33,1883,384,251,317,7,8,52,391,11,70,44,84,81,128,467,811,6,5355,297,0,2,0,8,1
49033,45,2209,722,423,573,19,0,135,741,12,172,101,199,184,300,1320,2257,6,15668,870,0,2,2,7,1
49034,39,1727,386,256,301,16,9,68,402,4,59,35,69,63,104,355,621,2,1453,80,0,2,0,2,1
49035,82,3157,1043,504,840,53,9,147,1096,9,180,112,198,189,310,1377,2344,4,11604,644,0,2,9,17,1
49036,30,1241,373,158,315,8,0,51,381,5,76,44,79,81,123,486,779,2,2026,112,0,2,0,2,1
49037,77,3213,1178,367,1042,6,15,115,1184,9,94,51,95,103,146,644,976,4,4439,246,0,2,4,7,1
49038,91,4597,1943,715,1694,26,18,214,1969,12,185,120,237,197,357,1436,2721,7,20915,1161,0,2,0,8,1
49039,14,826,442,244,305,14,16,103,456,11,68,45,75,79,120,452,756,6,4588,254,0,2,0,2,1
49040,49,1838,1098,241,925,5,10,155,1103,7,46,25,49,53,74,273,423,3,1580,87,0,2,0,1,1
49041,19,680,601,196,481,2,23,85,603,8,63,36,72,71,108,400,664,4,3036,168,0,2,2,3,1
49042,88,2881,773,419,590,28,0,166,801,10,204,113,217,214,330,1598,2554,5,13587,754,0,2,2,2,0
49043,60,1081,282,196,195,3,0,86,285,8,130,71,141,138,212,936,1507,4,6538,363,0,2,0,17,0
49044,1,90,13,10,10,0,0,3,13,1,2,1,2,3,3,2,4,0,2,0,0,2,1,1,0
49046,3,66,127,75,83,2,11,30,129,4,14,7,14,18,21,61,87,2,175,9,0,2,0,1,0
49047,3,66,652,304,544,16,6,88,668,6,89,51,101,95,152,591,998,3,3399,188,0,2,0,1,0
49048,3,66,2,2,2,0,0,0,2,0,0,0,0,0,0,0,0,0,0,0,0,2,0,1,0
49049,3,66,8,5,5,0,0,3,8,0,0,0,0,0,0,0,0,0,0,0,0,2,0,1,0
49052,3,66,14,8,8,0,0,6,14,0,0,0,0,0,0,0,0,0,0,0,0,2,0,1,0
49053,3,66,6,4,4,0,0,2,6,0,0,0,0,0,0,0,0,0,0,0,0,2,0,1,0
49054,3,66,6,4,4,0,0,2,6,1,2,1,2,3,3,2,4,0,2,0,0,2,0,1,0
49056,3,66,7,5,5,0,0,2,7,0,0,0,0,0,0,0,0,0,0,0,0,2,0,1,0
49058,3,66,10,6,6,0,0,4,10,0,0,0,0,0,0,0,0,0,0,0,0,2,0,1,0
49059,3,66,1,1,1,0,0,0,1,0,0,0,0,0,0,0,0,0,0,0,0,2,0,1,0
49061,3,66,14,10,10,0,0,4,14,1,1,1,1,2,2,0,2,0,1,0,0,2,0,1,0
49062,3,66,46,26,30,3,0,12,49,3,6,3,6,9,9,20,28,1,42,2,0,2,0,1,0
49063,7,298,72,33,56,0,4,12,72,1,1,1,1,2,2,0,2,0,1,0,0,2,0,1,0
49064,12,229,127,75,83,2,11,30,129,4,14,7,14,18,21,61,87,2,175,9,0,2,0,2,0
49065,12,229,652,304,544,16,6,88,668,6,89,51,101,95,152,591,998,3,3399,188,0,2,0,2,0
49066,12,229,2,2,2,0,0,0,2,0,0,0,0,0,0,0,0,0,0,0,0,2,0,2,0
49067,12,229,8,5,5,0,0,3,8,0,0,0,0,0,0,0,0,0,0,0,0,2,0,2,0
49070,12,229,14,8,8,0,0,6,14,0,0,0,0,0,0,0,0,0,0,0,0,2,0,2,0
49071,12,229,6,4,4,0,0,2,6,0,0,0,0,0,0,0,0,0,0,0,0,2,0,2,0
49072,12,229,6,4,4,0,0,2,6,1,2,1,2,3,3,2,4,0,2,0,0,2,0,2,0
49074,12,229,7,5,5,0,0,2,7,0,0,0,0,0,0,0,0,0,0,0,0,2,0,2,0
49076,12,229,10,6,6,0,0,4,10,0,0,0,0,0,0,0,0,0,0,0,0,2,0,2,0
49077,12,229,1,1,1,0,0,0,1,0,0,0,0,0,0,0,0,0,0,0,0,2,0,2,0
49079,12,229,14,10,10,0,0,4,14,1,1,1,1,2,2,0,2,0,1,0,0,2,0,2,0
49080,12,229,46,26,30,3,0,12,49,3,6,3,6,9,9,20,28,1,42,2,0,2,0,2,0
49081,6,71,127,75,83,2,11,30,129,4,14,7,14,18,21,61,87,2,175,9,0,2,0,1,0
49082,6,71,652,304,544,16,6,88,668,6,89,51,101,95,152,591,998,3,3399,188,0,2,0,1,0
49083,6,71,2,2,2,0,0,0,2,0,0,0,0,0,0,0,0,0,0,0,0,2,0,1,0
49084,6,71,8,5,5,0,0,3,8,0,0,0,0,0,0,0,0,0,0,0,0,2,0,1,0
49087,6,71,14,8,8,0,0,6,14,0,0,0,0,0,0,0,0,0,0,0,0,2,0,1,0
49088,6,71,6,4,4,0,0,2,6,0,0,0,0,0,0,0,0,0,0,0,0,2,0,1,0
49089,6,71,6,4,4,0,0,2,6,1,2,1,2,3,3,2,4,0,2,0,0,2,0,1,0
49091,6,71,7,5,5,0,0,2,7,0,0,0,0,0,0,0,0,0,0,0,0,2,0,1,0
49093,6,71,10,6,6,0,0,4,10,0,0,0,0,0,0,0,0,0,0,0,0,2,0,1,0
49094,6,71,1,1,1,0,0,0,1,0,0,0,0,0,0,0,0,0,0,0,0,2,0,1,0
49096,6,71,14,10,10,0,0,4,14,1,1,1,1,2,2,0,2,0,1,0,0,2,0,1,0
49097,6,71,46,26,30,3,0,12,49,3,6,3,6,9,9,20,28,1,42,2,0,2,0,1,0
49098,3,26,14,7,7,2,0,5,16,0,0,0,0,0,0,0,0,0,0,0,0,2,0,1,0
49099,213,4619,182,127,129,0,0,53,182,5,39,21,42,44,63,217,343,2,926,51,0,2,20,19,0
49100,213,4619,1165,710,800,67,119,181,1232,18,243,153,282,261,435,2000,3492,10,36473,2026,1,2,20,19,0
49101,83,1808,773,419,590,28,0,166,801,10,204,113,217,214,330,1598,2554,5,13587,754,0,2,4,3,0
49102,83,1808,421,273,302,44,34,57,465,17,81,59,107,98,166,583,1098,11,12329,684,0,2,4,3,0
49103,164,5065,1660,832,1314,41,38,274,1701,20,312,209,395,332,604,2671,5058,12,64042,3557,1,2,1,1,0
49104,164,5065,1057,646,719,113,100,145,1170,18,215,134,248,233,382,1740,3004,10,31186,1732,1,2,1,1,0
49105,89,1830,477,336,357,30,23,73,507,16,194,134,250,210,384,1538,2962,10,30538,1696,0,2,1,1,0
49106,71,1702,996,429,845,24,10,117,1020,7,76,50,88,83,138,494,879,4,3565,198,0,2,1,4,0
49107,71,1702,456,277,329,12,42,72,468,13,85,50,97,98,147,592,972,7,7212,400,0,2,1,4,0
49108,145,3016,1513,682,1277,25,13,200,1538,11,199,116,219,210,335,1557,2584,6,15641,868,0,2,0,2,0
49109,145,3016,819,519,539,24,98,155,843,15,96,57,106,111,163,690,1107,8,9171,509,0,2,0,2,0
49110,58,1174,207,111,150,11,0,50,218,5,26,19,36,31,55,133,272,3,943,52,0,2,5,15,0
49111,58,1174,410,198,237,31,55,97,441,11,63,38,72,74,110,414,683,6,4293,238,0,2,5,15,0
49114,211,4551,2,2,2,0,0,0,2,0,0,0,0,0,0,0,0,0,0,0,0,2,15,10,0
49128,211,4551,99,48,90,1,3,5,100,0,0,0,0,0,0,0,0,0,0,0,0,2,15,10,0
49129,211,4551,8,5,5,2,0,1,10,0,0,0,0,0,0,0,0,0,0,0,0,2,15,10,0
49130,211,4551,1217,716,841,84,126,174,1301,14,185,118,215,199,333,1446,2542,8,20687,1149,0,2,15,10,0
49131,211,4551,160,89,115,0,13,31,160,7,15,11,17,22,28,78,124,3,495,27,0,2,15,10,0
49132,211,4551,10,10,9,9,0,0,19,0,0,0,0,0,0,0,0,0,0,0,0,2,15,10,0
49133,211,4551,173,84,99,8,29,36,181,5,12,7,13,17,20,54,81,2,221,12,0,2,15,10,0
49134,211,4551,3,1,1,3,0,0,6,0,0,0,0,0,0,0,0,0,0,0,0,2,15,10,0
49135,94,1909,463,295,324,28,62,57,491,12,134,82,154,146,236,989,1696,6,11700,650,0,2,3,5,0
49137,51,727,167,116,138,4,5,22,171,8,48,30,56,56,86,292,499,4,2330,129,0,2,0,1,0
49138,28,810,339,213,244,17,9,65,356,10,42,26,48,52,74,259,421,5,2410,133,0,2,4,4,0
49140,85,2161,1455,414,1257,16,76,112,1471,5,41,23,46,46,69,231,381,2,1069,59,0,2,3,12,0
49141,85,2161,669,365,481,22,61,110,691,15,103,63,122,118,185,747,1273,8,11311,628,0,2,3,12,0
49142,236,5392,4293,999,3693,19,54,507,4312,9,155,88,170,164,258,1156,1898,4,9368,520,0,2,6,8,0
49143,236,5392,1482,859,1002,125,135,219,1607,16,219,134,251,235,385,1766,3032,9,27804,1544,1,2,6,8,0
49144,27,959,74,35,59,1,0,14,75,3,14,7,14,17,21,58,85,1,128,7,0,2,1,1,0
49145,27,959,245,125,200,5,7,34,250,7,30,17,34,37,51,166,265,3,1053,58,0,2,1,1,0
49146,98,2661,1523,757,1297,19,12,193,1542,12,193,117,230,205,347,1508,2664,7,19053,1058,0,2,1,6,0
49147,98,2661,701,378,504,33,58,109,734,13,110,68,126,123,194,794,1346,7,10027,557,0,2,1,6,0
49148,86,2225,773,422,505,30,103,129,803,14,77,46,83,91,129,535,839,7,6334,351,0,2,1,3,0
49149,122,2937,77,34,69,0,0,8,77,3,24,16,29,27,45,114,213,1,387,21,0,2,1,1,0
49150,122,2937,712,438,573,51,9,84,763,14,102,71,128,116,199,733,1364,8,11988,666,0,2,1,1,0
49151,30,658,125,97,103,3,0,19,128,9,25,17,27,34,44,144,223,4,1087,60,0,2,0,1,0
49152,82,1776,402,202,227,24,74,80,426,12,52,33,61,64,94,339,564,7,3969,220,0,2,12,8,0
49153,48,992,447,308,343,6,5,95,453,7,96,59,111,103,170,651,1136,4,4600,255,0,2,0,1,0
49154,48,992,322,174,179,16,74,51,338,10,41,26,46,51,72,252,408,5,2291,127,0,2,0,1,0
49155,72,1646,53,23,39,0,0,13,53,2,8,4,8,10,12,26,39,1,39,2,0,2,2,2,0
49156,72,1646,515,298,307,33,80,99,548,12,63,44,77,75,121,419,753,7,5527,307,0,2,2,2,0
49157,20,511,205,80,86,16,53,53,221,7,18,10,19,25,29,94,134,3,497,27,0,2,1,0,0
49158,226,5306,722,423,573,19,0,135,741,12,172,101,199,184,300,1320,2257,6,15668,870,0,2,7,14,0
49159,226,5306,1508,847,911,44,250,301,1552,14,148,88,169,162,257,1120,1886,7,15077,837,0,2,7,14,0
49160,285,6283,72,33,56,0,4,12,72,1,1,1,1,2,2,0,2,0,1,0,0,2,14,15,0
49161,285,6283,1454,835,1044,76,110,219,1530,17,275,158,296,292,454,2297,3718,9,34017,1889,1,2,14,15,0
49162,78,1601,757,253,292,73,244,162,830,13,61,38,67,74,105,409,651,7,4654,258,0,2,2,4,0
49163,46,954,386,256,301,16,9,68,402,4,59,35,69,63,104,355,621,2,1453,80,0,2,1,4,0
49164,46,954,264,131,164,11,41,46,275,6,38,22,40,44,62,214,338,3,1068,59,0,2,1,4,0
49165,30,650,215,129,180,6,0,29,221,8,65,43,72,73,115,415,711,4,3153,175,0,2,0,1,0
49166,30,650,97,69,77,3,3,16,100,6,22,13,23,28,36,113,173,3,542,30,0,2,0,1,0
49167,118,2612,1043,504,840,53,9,147,1096,9,180,112,198,189,310,1377,2344,4,11604,644,0,2,13,8,0
49168,118,2612,383,288,292,26,6,62,409,11,65,38,67,76,105,429,656,5,3719,206,0,2,13,8,0
49169,70,1382,1178,367,1042,6,15,115,1184,9,94,51,95,103,146,644,976,4,4439,246,0,2,5,4,0
49170,70,1382,177,108,140,8,0,27,185,6,30,16,32,36,48,162,248,3,794,44,0,2,5,4,0
49171,209,4552,1943,715,1694,26,18,214,1969,12,185,120,237,197,357,1436,2721,7,20915,1161,0,2,15,12,0
49172,209,4552,1168,838,957,57,25,144,1225,19,348,224,416,367,640,3018,5452,11,61921,3440,1,2,15,12,0
49173,62,1226,1098,241,925,5,10,155,1103,7,46,25,49,53,74,273,423,3,1580,87,0,2,5,7,0
49174,62,1226,282,202,222,14,2,44,296,8,42,24,43,50,67,250,378,4,1548,86,0,2,5,7,0
49175,22,458,601,196,481,2,23,85,603,8,63,36,72,71,108,400,664,4,3036,168,0,2,2,3,0
49176,22,458,156,79,106,5,16,28,161,5,14,8,15,19,23,64,97,2,261,14,0,2,2,3,0
49177,92,3868,1289,550,1043,56,32,155,1345,10,167,93,185,177,278,1266,2075,5,11498,638,0,2,4,7,0
49178,36,1088,182,127,129,0,0,53,182,5,39,21,42,44,63,217,343,2,926,51,0,2,0,8,0
49179,147,6910,1392,870,1177,35,17,170,1427,14,494,280,531,508,811,4473,7289,7,54850,3047,2,2,0,15,0
49180,88,2881,773,419,590,28,0,166,801,10,204,113,217,214,330,1598,2554,5,13587,754,0,2,2,14,0
49181,15,744,75,38,59,1,3,12,76,2,4,2,4,6,6,10,15,1,15,0,0,2,4,4,0
49182,1,136,149,67,118,4,0,27,153,1,17,14,28,18,42,69,175,0,144,8,0,2,2,4,0
49183,31,1986,1157,318,931,29,22,177,1186,6,104,63,125,110,188,712,1274,3,4596,255,0,2,20,15,0
49184,56,3685,520,294,400,33,13,81,553,10,261,204,367,271,571,2128,4614,7,32445,1802,1,2,10,15,0
49185,97,4403,1338,495,1086,10,64,173,1348,11,122,82,157,133,239,883,1686,7,11934,663,0,2,4,11,0
49186,172,7588,139,89,101,2,0,35,141,7,54,34,62,61,96,330,569,4,2287,127,0,2,12,30,0
49187,172,7588,7,5,5,0,0,2,7,1,2,1,2,3,3,2,4,0,2,0,0,2,12,30,0
49188,33,1004,465,148,393,5,8,60,470,4,31,20,31,35,51,161,261,2,523,29,0,2,0,8,0
49189,33,1004,16,12,9,0,0,6,16,1,2,1,2,3,3,2,4,0,2,0,0,2,0,8,0
49190,139,5895,1782,648,1425,9,47,279,1791,8,171,97,189,179,286,1292,2140,4,9462,525,0,2,28,58,0
49191,25,684,256,139,192,9,7,47,265,4,23,12,24,27,36,112,171,2,357,19,0,2,0,5,0
49192,23,578,102,59,69,5,3,24,107,6,22,15,28,28,43,113,206,3,789,43,0,2,0,1,0
49193,111,4174,1450,624,1228,12,26,181,1462,14,306,186,354,320,540,2580,4493,8,36391,2021,1,2,12,25,0
49194,154,4337,1660,832,1314,41,38,274,1701,20,312,209,395,332,604,2671,5058,12,64042,3557,1,2,4,30,0
49195,36,2870,996,429,845,24,10,117,1020,7,76,50,88,83,138,494,879,4,3565,198,0,2,11,16,0
49196,125,5131,1513,682,1277,25,13,200,1538,11,199,116,219,210,335,1557,2584,6,15641,868,0,2,0,6,0
49197,73,3803,1296,573,1062,40,33,157,1336,8,201,118,231,209,349,1561,2689,4,12365,686,0,2,0,11,0
49198,14,341,207,111,150,11,0,50,218,5,26,19,36,31,55,133,272,3,943,52,0,2,0,4,0
49199,84,4438,1457,730,1242,11,6,188,1468,10,292,166,329,302,495,2424,4078,5,22973,1276,1,2,3,14,0
49200,39,2323,652,304,544,16,6,88,668,6,89,51,101,95,152,591,998,3,3399,188,0,2,0,4,0
49201,70,3212,1455,414,1257,16,76,112,1471,5,41,23,46,46,69,231,381,2,1069,59,0,2,0,4,0
49202,95,4652,1523,757,1297,19,12,193,1542,12,193,117,230,205,347,1508,2664,7,19053,1058,0,2,9,16,0
49203,88,3896,1020,354,843,12,15,144,1032,8,134,77,144,142,221,970,1580,4,6792,377,0,2,0,6,0
49204,38,1676,447,308,343,6,5,95,453,7,96,59,111,103,170,651,1136,4,4600,255,0,2,0,4,0
49205,21,658,424,94,331,4,0,89,428,1,5,5,5,6,10,11,25,0,12,0,0,2,0,1,0
49206,38,2302,334,251,279,10,4,40,344,5,127,74,143,132,217,899,1528,2,4303,239,0,2,5,14,0
49207,12,493,184,100,137,2,15,30,186,6,38,20,39,44,59,214,322,3,991,55,0,2,0,3,0
49208,59,2582,1293,570,1093,25,15,163,1318,10,195,123,241,205,364,1516,2795,6,17273,959,0,2,0,4,0
49209,33,1883,384,251,317,7,8,52,391,11,70,44,84,81,128,467,811,6,5355,297,0,2,0,8,0
49210,45,2209,722,423,573,19,0,135,741,12,172,101,199,184,300,1320,2257,6,15668,870,0,2,2,7,0
49211,39,1727,386,256,301,16,9,68,402,4,59,35,69,63,104,355,621,2,1453,80,0,2,0,2,0
49212,82,3157,1043,504,840,53,9,147,1096,9,180,112,198,189,310,1377,2344,4,11604,644,0,2,9,17,0
49213,30,1241,373,158,315,8,0,51,381,5,76,44,79,81,123,486,779,2,2026,112,0,2,0,2,0
49214,77,3213,1178,367,1042,6,15,115,1184,9,94,51,95,103,146,644,976,4,4439,246,0,2,4,7,0
49215,91,4597,1943,715,1694,26,18,214,1969,12,185,120,237,197,357,1436,2721,7,20915,1161,0,2,0,8,0
49216,14,826,442,244,305,14,16,103,456,11,68,45,75,79,120,452,756,6,4588,254,0,2,0,2,0
49217,49,1838,1098,241,925,5,10,155,1103,7,46,25,49,53,74,273,423,3,1580,87,0,2,0,1,0
49218,19,680,601,196,481,2,23,85,603,8,63,36,72,71,108,400,664,4,3036,168,0,2,2,3,0
49275,11,413,42,7,35,4,0,5,46,1,2,1,2,3,3,2,4,0,2,0,0,2,7,1,0
49276,11,413,11,6,10,0,0,1,11,2,4,2,4,6,6,10,15,1,15,0,0,2,7,1,0
49281,164,5065,1660,832,1314,41,38,274,1701,20,312,209,395,332,604,2671,5058,12,64042,3557,1,2,11,1,0
49282,164,5065,1057,646,719,113,100,145,1170,18,215,134,248,233,382,1740,3004,10,31186,1732,1,2,11,1,0
49284,74,1693,996,429,845,24,10,117,1020,7,76,50,88,83,138,494,879,4,3565,198,0,2,1,4,0
49285,74,1693,456,277,329,12,42,72,468,13,85,50,97,98,147,592,972,7,7212,400,0,2,1,4,0
49288,58,1192,207,111,150,11,0,50,218,5,26,19,36,31,55,133,272,3,943,52,0,2,5,15,0
49289,58,1192,410,198,237,31,55,97,441,11,63,38,72,74,110,414,683,6,4293,238,0,2,5,15,0
49292,211,4551,2,2,2,0,0,0,2,0,0,0,0,0,0,0,0,0,0,0,0,3,46,552,0
49306,211,4551,99,48,90,1,3,5,100,0,0,0,0,0,0,0,0,0,0,0,0,3,46,552,0
49307,211,4551,8,5,5,2,0,1,10,0,0,0,0,0,0,0,0,0,0,0,0,3,46,552,0
49308,211,4551,1217,716,841,84,126,174,1301,14,185,118,215,199,333,1446,2542,8,20687,1149,0,3,46,552,0
49309,211,4551,160,89,115,0,13,31,160,7,15,11,17,22,28,78,124,3,495,27,0,3,46,552,0
49310,211,4551,10,10,9,9,0,0,19,0,0,0,0,0,0,0,0,0,0,0,0,3,46,552,0
49311,211,4551,173,84,99,8,29,36,181,5,12,7,13,17,20,54,81,2,221,12,0,3,46,552,0
49312,211,4551,3,1,1,3,0,0,6,0,0,0,0,0,0,0,0,0,0,0,0,3,46,552,0
49313,94,1909,463,295,324,28,62,57,491,12,134,82,154,146,236,989,1696,6,11700,650,0,0,392,0,0
49315,51,727,167,116,138,4,5,22,171,8,48,30,56,56,86,292,499,4,2330,129,0,0,139,0,0
49318,85,2161,1455,414,1257,16,76,112,1471,5,41,23,46,46,69,231,381,2,1069,59,0,2,4,13,0
49319,85,2161,669,365,481,22,61,110,691,15,103,63,122,118,185,747,1273,8,11311,628,0,2,4,13,0
49326,88,2248,773,422,505,30,103,129,803,14,77,46,83,91,129,535,839,7,6334,351,0,2,1,3,0
49330,82,1776,402,202,227,24,74,80,426,12,52,33,61,64,94,339,564,7,3969,220,0,2,14,9,0
49333,73,1667,53,23,39,0,0,13,53,2,8,4,8,10,12,26,39,1,39,2,0,2,2,2,0
49334,73,1667,515,298,307,33,80,99,548,12,63,44,77,75,121,419,753,7,5527,307,0,2,2,2,0
49338,285,6283,72,33,56,0,4,12,72,1,1,1,1,2,2,0,2,0,1,0,0,2,16,19,0
49339,285,6283,1454,835,1044,76,110,219,1530,17,275,158,296,292,454,2297,3718,9,34017,1889,1,2,16,19,0
49340,78,1601,757,253,292,73,244,162,830,13,61,38,67,74,105,409,651,7,4654,258,0,2,8,8,0
49341,46,954,386,256,301,16,9,68,402,4,59,35,69,63,104,355,621,2,1453,80,0,2,2,5,0
49342,46,954,264,131,164,11,41,46,275,6,38,22,40,44,62,214,338,3,1068,59,0,2,2,5,0
49360,8,263,51,25,36,0,0,15,51,3,11,6,12,14,18,42,68,1,112,6,0,2,12,15,0
49363,56,3685,520,294,400,33,13,81,553,10,261,204,367,271,571,2128,4614,7,32445,1802,1,2,26,16,0
49374,39,2966,996,429,845,24,10,117,1020,7,76,50,88,83,138,494,879,4,3565,198,0,2,10,16,0
49375,125,5131,1513,682,1277,25,13,200,1538,11,199,116,219,210,335,1557,2584,6,15641,868,0,2,1,7,0
49378,84,4438,1457,730,1242,11,6,188,1468,10,292,166,329,302,495,2424,4078,5,22973,1276,1,2,5,20,0
49380,70,3212,1455,414,1257,16,76,112,1471,5,41,23,46,46,69,231,381,2,1069,59,0,2,16,4,0
49382,90,3974,1020,354,843,12,15,144,1032,8,134,77,144,142,221,970,1580,4,6792,377,0,2,5,7,0
49385,38,2302,334,251,279,10,4,40,344,5,127,74,143,132,217,899,1528,2,4303,239,0,2,6,15,0
49577,89,3932,1020,354,843,12,15,144,1032,8,134,77,144,142,221,970,1580,4,6792,377,0,2,38,0,0
49578,89,3941,1020,354,843,12,15,144,1032,8,134,77,144,142,221,970,1580,4,6792,377,0,2,2,1,1
49579,83,1787,402,202,227,24,74,80,426,12,52,33,61,64,94,339,564,7,3969,220,0,2,4,1,1
49580,285,6294,72,33,56,0,4,12,72,1,1,1,1,2,2,0,2,0,1,0,0,2,7,3,1
49581,285,6294,1454,835,1044,76,110,219,1530,17,275,158,296,292,454,2297,3718,9,34017,1889,1,2,7,3,1
49582,89,3941,1020,354,843,12,15,144,1032,8,134,77,144,142,221,970,1580,4,6792,377,0,2,1,1,1
49583,83,1788,402,202,227,24,74,80,426,12,52,33,61,64,94,339,564,7,3969,220,0,2,6,0,0
49584,28,699,466,257,367,18,25,50,484,7,126,86,171,133,257,898,1813,4,8612,478,0,0,192,0,1
49585,28,699,507,281,342,29,59,88,536,10,53,29,57,63,86,336,514,5,2764,153,0,0,192,0,1
49586,97,2135,1043,504,840,53,9,147,1096,9,180,112,198,189,310,1377,2344,4,11604,644,0,2,37,189,1
49587,97,2135,383,288,292,26,6,62,409,11,65,38,67,76,105,429,656,5,3719,206,0,2,37,189,1
49588,95,4640,1523,757,1297,19,12,193,1542,12,193,117,230,205,347,1508,2664,7,19053,1058,0,2,2,3,1
49589,82,3159,1043,504,840,53,9,147,1096,9,180,112,198,189,310,1377,2344,4,11604,644,0,2,5,5,1
49590,28,702,466,257,367,18,25,50,484,7,126,86,171,133,257,898,1813,4,8612,478,0,2,10,6,0
49591,28,702,507,281,342,29,59,88,536,10,53,29,57,63,86,336,514,5,2764,153,0,2,10,6,0
49592,90,1927,1043,504,840,53,9,147,1096,9,180,112,198,189,310,1377,2344,4,11604,644,0,2,0,40,0
49593,90,1927,383,288,292,26,6,62,409,11,65,38,67,76,105,429,656,5,3719,206,0,2,0,40,0
49594,227,5367,722,423,573,19,0,135,741,12,172,101,199,184,300,1320,2257,6,15668,870,0,2,9,0,1
49595,227,5367,1508,847,911,44,250,301,1552,14,148,88,169,162,257,1120,1886,7,15077,837,0,2,9,0,1
49596,229,5396,722,423,573,19,0,135,741,12,172,101,199,184,300,1320,2257,6,15668,870,0,2,4,1,1
49597,229,5396,1508,847,911,44,250,301,1552,14,148,88,169,162,257,1120,1886,7,15077,837,0,2,4,1,1
49598,92,3868,1289,550,1043,56,32,155,1345,10,167,93,185,177,278,1266,2075,5,11498,638,0,2,2,19,1
49599,1,15,127,75,83,2,11,30,129,4,14,7,14,18,21,61,87,2,175,9,0,0,4,0,1
49600,1,15,652,304,544,16,6,88,668,6,89,51,101,95,152,591,998,3,3399,188,0,0,4,0,1
49601,1,15,2,2,2,0,0,0,2,0,0,0,0,0,0,0,0,0,0,0,0,0,4,0,1
49602,1,15,8,5,5,0,0,3,8,0,0,0,0,0,0,0,0,0,0,0,0,0,4,0,1
49605,1,15,14,8,8,0,0,6,14,0,0,0,0,0,0,0,0,0,0,0,0,0,4,0,1
49606,1,15,6,4,4,0,0,2,6,0,0,0,0,0,0,0,0,0,0,0,0,0,4,0,1
49607,1,15,6,4,4,0,0,2,6,1,2,1,2,3,3,2,4,0,2,0,0,0,4,0,1
49609,1,15,7,5,5,0,0,2,7,0,0,0,0,0,0,0,0,0,0,0,0,0,4,0,1
49611,1,15,10,6,6,0,0,4,10,0,0,0,0,0,0,0,0,0,0,0,0,0,4,0,1
49612,1,15,1,1,1,0,0,0,1,0,0,0,0,0,0,0,0,0,0,0,0,0,4,0,1
49614,1,15,14,10,10,0,0,4,14,1,1,1,1,2,2,0,2,0,1,0,0,0,4,0,1
49615,1,15,46,26,30,3,0,12,49,3,6,3,6,9,9,20,28,1,42,2,0,0,4,0,1
49616,2,51,127,75,83,2,11,30,129,4,14,7,14,18,21,61,87,2,175,9,0,0,14,0,1
49617,2,51,652,304,544,16,6,88,668,6,89,51,101,95,152,591,998,3,3399,188,0,0,14,0,1
49618,2,51,2,2,2,0,0,0,2,0,0,0,0,0,0,0,0,0,0,0,0,0,14,0,1
49619,2,51,8,5,5,0,0,3,8,0,0,0,0,0,0,0,0,0,0,0,0,0,14,0,1
49622,2,51,14,8,8,0,0,6,14,0,0,0,0,0,0,0,0,0,0,0,0,0,14,0,1
49623,2,51,6,4,4,0,0,2,6,0,0,0,0,0,0,0,0,0,0,0,0,0,14,0,1
49624,2,51,6,4,4,0,0,2,6,1,2,1,2,3,3,2,4,0,2,0,0,0,14,0,1
49626,2,51,7,5,5,0,0,2,7,0,0,0,0,0,0,0,0,0,0,0,0,0,14,0,1
49628,2,51,10,6,6,0,0,4,10,0,0,0,0,0,0,0,0,0,0,0,0,0,14,0,1
49629,2,51,1,1,1,0,0,0,1,0,0,0,0,0,0,0,0,0,0,0,0,0,14,0,1
49631,2,51,14,10,10,0,0,4,14,1,1,1,1,2,2,0,2,0,1,0,0,0,14,0,1
49632,2,51,46,26,30,3,0,12,49,3,6,3,6,9,9,20,28,1,42,2,0,0,14,0,1
49633,1,6,2,2,2,0,0,0,2,0,0,0,0,0,0,0,0,0,0,0,0,0,2,0,1
49634,1,18,3,3,3,0,0,0,3,0,0,0,0,0,0,0,0,0,0,0,0,0,3,0,1
49635,83,1788,402,202,227,24,74,80,426,12,52,33,61,64,94,339,564,7,3969,220,0,2,10,1,0
49636,285,6294,72,33,56,0,4,12,72,1,1,1,1,2,2,0,2,0,1,0,0,2,7,3,0
49637,285,6294,1454,835,1044,76,110,219,1530,17,275,158,296,292,454,2297,3718,9,34017,1889,1,2,7,3,0
49638,89,3941,1020,354,843,12,15,144,1032,8,134,77,144,142,221,970,1580,4,6792,377,0,2,39,0,0
49639,231,5436,722,423,573,19,0,135,741,12,172,101,199,184,300,1320,2257,6,15668,870,0,2,9,1,1
49640,231,5436,1508,847,911,44,250,301,1552,14,148,88,169,162,257,1120,1886,7,15077,837,0,2,9,1,1
49641,231,5436,722,423,573,19,0,135,741,12,172,101,199,184,300,1320,2257,6,15668,870,0,2,20,0,0
49642,231,5436,1508,847,911,44,250,301,1552,14,148,88,169,162,257,1120,1886,7,15077,837,0,2,20,0,0
49643,92,3868,1289,550,1043,56,32,155,1345,10,167,93,185,177,278,1266,2075,5,11498,638,0,2,2,19,0
49644,1,15,127,75,83,2,11,30,129,4,14,7,14,18,21,61,87,2,175,9,0,0,4,0,0
49645,1,15,652,304,544,16,6,88,668,6,89,51,101,95,152,591,998,3,3399,188,0,0,4,0,0
49646,1,15,2,2,2,0,0,0,2,0,0,0,0,0,0,0,0,0,0,0,0,0,4,0,0
49647,1,15,8,5,5,0,0,3,8,0,0,0,0,0,0,0,0,0,0,0,0,0,4,0,0
49650,1,15,14,8,8,0,0,6,14,0,0,0,0,0,0,0,0,0,0,0,0,0,4,0,0
49651,1,15,6,4,4,0,0,2,6,0,0,0,0,0,0,0,0,0,0,0,0,0,4,0,0
49652,1,15,6,4,4,0,0,2,6,1,2,1,2,3,3,2,4,0,2,0,0,0,4,0,0
49654,1,15,7,5,5,0,0,2,7,0,0,0,0,0,0,0,0,0,0,0,0,0,4,0,0
49656,1,15,10,6,6,0,0,4,10,0,0,0,0,0,0,0,0,0,0,0,0,0,4,0,0
49657,1,15,1,1,1,0,0,0,1,0,0,0,0,0,0,0,0,0,0,0,0,0,4,0,0
49659,1,15,14,10,10,0,0,4,14,1,1,1,1,2,2,0,2,0,1,0,0,0,4,0,0
49660,1,15,46,26,30,3,0,12,49,3,6,3,6,9,9,20,28,1,42,2,0,0,4,0,0
49661,2,51,127,75,83,2,11,30,129,4,14,7,14,18,21,61,87,2,175,9,0,0,14,0,0
49662,2,51,652,304,544,16,6,88,668,6,89,51,101,95,152,591,998,3,3399,188,0,0,14,0,0
49663,2,51,2,2,2,0,0,0,2,0,0,0,0,0,0,0,0,0,0,0,0,0,14,0,0
49664,2,51,8,5,5,0,0,3,8,0,0,0,0,0,0,0,0,0,0,0,0,0,14,0,0
49667,2,51,14,8,8,0,0,6,14,0,0,0,0,0,0,0,0,0,0,0,0,0,14,0,0
49668,2,51,6,4,4,0,0,2,6,0,0,0,0,0,0,0,0,0,0,0,0,0,14,0,0
49669,2,51,6,4,4,0,0,2,6,1,2,1,2,3,3,2,4,0,2,0,0,0,14,0,0
49671,2,51,7,5,5,0,0,2,7,0,0,0,0,0,0,0,0,0,0,0,0,0,14,0,0
49673,2,51,10,6,6,0,0,4,10,0,0,0,0,0,0,0,0,0,0,0,0,0,14,0,0
49674,2,51,1,1,1,0,0,0,1,0,0,0,0,0,0,0,0,0,0,0,0,0,14,0,0
49676,2,51,14,10,10,0,0,4,14,1,1,1,1,2,2,0,2,0,1,0,0,0,14,0,0
49677,2,51,46,26,30,3,0,12,49,3,6,3,6,9,9,20,28,1,42,2,0,0,14,0,0
49678,1,6,2,2,2,0,0,0,2,0,0,0,0,0,0,0,0,0,0,0,0,0,2,0,0
49679,1,18,3,3,3,0,0,0,3,0,0,0,0,0,0,0,0,0,0,0,0,0,3,0,0
49680,28,702,466,257,367,18,25,50,484,7,126,86,171,133,257,898,1813,4,8612,478,0,0,196,0,0
49681,28,702,507,281,342,29,59,88,536,10,53,29,57,63,86,336,514,5,2764,153,0,0,196,0,0
49682,90,1927,1043,504,840,53,9,147,1096,9,180,112,198,189,310,1377,2344,4,11604,644,0,2,3,195,0
49683,90,1927,383,288,292,26,6,62,409,11,65,38,67,76,105,429,656,5,3719,206,0,2,3,195,0
49684,95,4640,1523,757,1297,19,12,193,1542,12,193,117,230,205,347,1508,2664,7,19053,1058,0,2,2,3,0
49685,82,3159,1043,504,840,53,9,147,1096,9,180,112,198,189,310,1377,2344,4,11604,644,0,2,5,5,0
49686,240,5520,4293,999,3693,19,54,507,4312,9,155,88,170,164,258,1156,1898,4,9368,520,0,2,50,9,1
49687,240,5520,1482,859,1002,125,135,219,1607,16,219,134,251,235,385,1766,3032,9,27804,1544,1,2,50,9,1
49688,285,6299,72,33,56,0,4,12,72,1,1,1,1,2,2,0,2,0,1,0,0,2,5,0,1
49689,285,6299,1454,835,1044,76,110,219,1530,17,275,158,296,292,454,2297,3718,9,34017,1889,1,2,5,0,1
49690,98,4433,1338,495,1086,10,64,173,1348,11,122,82,157,133,239,883,1686,7,11934,663,0,2,31,0,1
49691,240,5514,4293,999,3693,19,54,507,4312,9,155,88,170,164,258,1156,1898,4,9368,520,0,2,1,3,0
49692,240,5514,1482,859,1002,125,135,219,1607,16,219,134,251,235,385,1766,3032,9,27804,1544,1,2,1,3,0
49696,91,4019,1020,354,843,12,15,144,1032,8,134,77,144,142,221,970,1580,4,6792,377,0,2,39,0,0
49701,240,5514,4293,999,3693,19,54,507,4312,9,155,88,170,164,258,1156,1898,4,9368,520,0,2,48,9,0
49702,240,5514,1482,859,1002,125,135,219,1607,16,219,134,251,235,385,1766,3032,9,27804,1544,1,2,48,9,0
49703,285,6299,72,33,56,0,4,12,72,1,1,1,1,2,2,0,2,0,1,0,0,2,5,0,0
49704,285,6299,1454,835,1044,76,110,219,1530,17,275,158,296,292,454,2297,3718,9,34017,1889,1,2,5,0,0
49705,98,4433,1338,495,1086,10,64,173,1348,11,122,82,157,133,239,883,1686,7,11934,663,0,2,31,0,0
49706,173,7581,139,89,101,2,0,35,141,7,54,34,62,61,96,330,569,4,2287,127,0,2,40,32,0
49707,173,7581,7,5,5,0,0,2,7,1,2,1,2,3,3,2,4,0,2,0,0,2,40,32,0
49708,173,7528,139,89,101,2,0,35,141,7,54,34,62,61,96,330,569,4,2287,127,0,2,20,30,1
49709,173,7528,7,5,5,0,0,2,7,1,2,1,2,3,3,2,4,0,2,0,0,2,20,30,1
49710,173,7537,139,89,101,2,0,35,141,7,54,34,62,61,96,330,569,4,2287,127,0,2,16,7,1
49711,173,7537,7,5,5,0,0,2,7,1,2,1,2,3,3,2,4,0,2,0,0,2,16,7,1
49712,173,7537,139,89,101,2,0,35,141,7,54,34,62,61,96,330,569,4,2287,127,0,2,1,1,0
49713,173,7537,7,5,5,0,0,2,7,1,2,1,2,3,3,2,4,0,2,0,0,2,1,1,0
49714,236,5588,722,423,573,19,0,135,741,12,172,101,199,184,300,1320,2257,6,15668,870,0,2,37,9,1
49715,236,5588,1508,847,911,44,250,301,1552,14,148,88,169,162,257,1120,1886,7,15077,837,0,2,37,9,1
49739,1,26,127,75,83,2,11,30,129,4,14,7,14,18,21,61,87,2,175,9,0,0,7,0,1
49740,1,26,652,304,544,16,6,88,668,6,89,51,101,95,152,591,998,3,3399,188,0,0,7,0,1
49741,1,26,2,2,2,0,0,0,2,0,0,0,0,0,0,0,0,0,0,0,0,0,7,0,1
49742,1,26,8,5,5,0,0,3,8,0,0,0,0,0,0,0,0,0,0,0,0,0,7,0,1
49745,1,26,14,8,8,0,0,6,14,0,0,0,0,0,0,0,0,0,0,0,0,0,7,0,1
49746,1,26,6,4,4,0,0,2,6,0,0,0,0,0,0,0,0,0,0,0,0,0,7,0,1
49747,1,26,6,4,4,0,0,2,6,1,2,1,2,3,3,2,4,0,2,0,0,0,7,0,1
49749,1,26,7,5,5,0,0,2,7,0,0,0,0,0,0,0,0,0,0,0,0,0,7,0,1
49751,1,26,10,6,6,0,0,4,10,0,0,0,0,0,0,0,0,0,0,0,0,0,7,0,1
49752,1,26,1,1,1,0,0,0,1,0,0,0,0,0,0,0,0,0,0,0,0,0,7,0,1
49754,1,26,14,10,10,0,0,4,14,1,1,1,1,2,2,0,2,0,1,0,0,0,7,0,1
49755,1,26,46,26,30,3,0,12,49,3,6,3,6,9,9,20,28,1,42,2,0,0,7,0,1
49756,1,7,2,2,2,0,0,0,2,0,0,0,0,0,0,0,0,0,0,0,0,0,2,0,1
49780,1,20,127,75,83,2,11,30,129,4,14,7,14,18,21,61,87,2,175,9,0,0,7,0,1
49781,1,20,652,304,544,16,6,88,668,6,89,51,101,95,152,591,998,3,3399,188,0,0,7,0,1
49782,1,20,2,2,2,0,0,0,2,0,0,0,0,0,0,0,0,0,0,0,0,0,7,0,1
49783,1,20,8,5,5,0,0,3,8,0,0,0,0,0,0,0,0,0,0,0,0,0,7,0,1
49786,1,20,14,8,8,0,0,6,14,0,0,0,0,0,0,0,0,0,0,0,0,0,7,0,1
49787,1,20,6,4,4,0,0,2,6,0,0,0,0,0,0,0,0,0,0,0,0,0,7,0,1
49788,1,20,6,4,4,0,0,2,6,1,2,1,2,3,3,2,4,0,2,0,0,0,7,0,1
49790,1,20,7,5,5,0,0,2,7,0,0,0,0,0,0,0,0,0,0,0,0,0,7,0,1
49792,1,20,10,6,6,0,0,4,10,0,0,0,0,0,0,0,0,0,0,0,0,0,7,0,1
49793,1,20,1,1,1,0,0,0,1,0,0,0,0,0,0,0,0,0,0,0,0,0,7,0,1
49795,1,20,14,10,10,0,0,4,14,1,1,1,1,2,2,0,2,0,1,0,0,0,7,0,1
49796,1,20,46,26,30,3,0,12,49,3,6,3,6,9,9,20,28,1,42,2,0,0,7,0,1
49798,1,13,127,75,83,2,11,30,129,4,14,7,14,18,21,61,87,2,175,9,0,0,6,0,1
49799,1,13,652,304,544,16,6,88,668,6,89,51,101,95,152,591,998,3,3399,188,0,0,6,0,1
49800,1,13,2,2,2,0,0,0,2,0,0,0,0,0,0,0,0,0,0,0,0,0,6,0,1
49801,1,13,8,5,5,0,0,3,8,0,0,0,0,0,0,0,0,0,0,0,0,0,6,0,1
49804,1,13,14,8,8,0,0,6,14,0,0,0,0,0,0,0,0,0,0,0,0,0,6,0,1
49805,1,13,6,4,4,0,0,2,6,0,0,0,0,0,0,0,0,0,0,0,0,0,6,0,1
49806,1,13,6,4,4,0,0,2,6,1,2,1,2,3,3,2,4,0,2,0,0,0,6,0,1
49808,1,13,7,5,5,0,0,2,7,0,0,0,0,0,0,0,0,0,0,0,0,0,6,0,1
49810,1,13,10,6,6,0,0,4,10,0,0,0,0,0,0,0,0,0,0,0,0,0,6,0,1
49811,1,13,1,1,1,0,0,0,1,0,0,0,0,0,0,0,0,0,0,0,0,0,6,0,1
49813,1,13,14,10,10,0,0,4,14,1,1,1,1,2,2,0,2,0,1,0,0,0,6,0,1
49814,1,13,46,26,30,3,0,12,49,3,6,3,6,9,9,20,28,1,42,2,0,0,6,0,1
49838,1,16,127,75,83,2,11,30,129,4,14,7,14,18,21,61,87,2,175,9,0,0,6,0,1
49839,1,16,652,304,544,16,6,88,668,6,89,51,101,95,152,591,998,3,3399,188,0,0,6,0,1
49840,1,16,2,2,2,0,0,0,2,0,0,0,0,0,0,0,0,0,0,0,0,0,6,0,1
49841,1,16,8,5,5,0,0,3,8,0,0,0,0,0,0,0,0,0,0,0,0,0,6,0,1
49844,1,16,14,8,8,0,0,6,14,0,0,0,0,0,0,0,0,0,0,0,0,0,6,0,1
49845,1,16,6,4,4,0,0,2,6,0,0,0,0,0,0,0,0,0,0,0,0,0,6,0,1
49846,1,16,6,4,4,0,0,2,6,1,2,1,2,3,3,2,4,0,2,0,0,0,6,0,1
49848,1,16,7,5,5,0,0,2,7,0,0,0,0,0,0,0,0,0,0,0,0,0,6,0,1
49850,1,16,10,6,6,0,0,4,10,0,0,0,0,0,0,0,0,0,0,0,0,0,6,0,1
49851,1,16,1,1,1,0,0,0,1,0,0,0,0,0,0,0,0,0,0,0,0,0,6,0,1
49853,1,16,14,10,10,0,0,4,14,1,1,1,1,2,2,0,2,0,1,0,0,0,6,0,1
49854,1,16,46,26,30,3,0,12,49,3,6,3,6,9,9,20,28,1,42,2,0,0,6,0,1
49855,1,10,2,2,2,0,0,0,2,1,2,1,2,3,3,2,4,0,2,0,0,0,2,0,1
49873,2,26,10,6,6,0,0,4,10,2,4,2,4,6,6,10,15,1,15,0,0,0,10,0,1
49874,3,47,15,10,10,0,0,5,15,2,4,2,4,6,6,10,15,1,15,0,0,0,15,0,1
49875,3,39,15,9,9,0,0,6,15,0,0,0,0,0,0,0,0,0,0,0,0,0,16,0,1
49876,2,36,10,7,7,0,0,3,10,1,2,1,2,3,3,2,4,0,2,0,0,0,11,0,1
49877,3,46,15,9,9,0,0,6,15,1,4,2,4,5,6,8,13,0,6,0,0,0,15,0,1
49878,2,21,10,6,6,0,0,4,10,0,0,0,0,0,0,0,0,0,0,0,0,0,10,0,1
49879,173,7444,139,89,101,2,0,35,141,7,54,34,62,61,96,330,569,4,2287,127,0,2,18,151,1
49880,173,7444,7,5,5,0,0,2,7,1,2,1,2,3,3,2,4,0,2,0,0,2,18,151,1
49881,84,1794,402,202,227,24,74,80,426,12,52,33,61,64,94,339,564,7,3969,220,0,2,1,1,0
49882,92,3984,1020,354,843,12,15,144,1032,8,134,77,144,142,221,970,1580,4,6792,377,0,2,13,0,0
49883,86,2229,773,422,505,30,103,129,803,14,77,46,83,91,129,535,839,7,6334,351,0,2,3,1,0
49884,32,2074,1157,318,931,29,22,177,1186,6,104,63,125,110,188,712,1274,3,4596,255,0,2,34,0,0
49885,32,2078,1157,318,931,29,22,177,1186,6,104,63,125,110,188,712,1274,3,4596,255,0,2,1,0,0
49886,32,2083,1157,318,931,29,22,177,1186,6,104,63,125,110,188,712,1274,3,4596,255,0,2,5,2,0
49887,32,2079,1157,318,931,29,22,177,1186,6,104,63,125,110,188,712,1274,3,4596,255,0,2,1,1,0
49889,32,2079,1157,318,931,29,22,177,1186,6,104,63,125,110,188,712,1274,3,4596,255,0,2,38,0,0
49892,32,938,339,213,244,17,9,65,356,10,42,26,48,52,74,259,421,5,2410,133,0,2,29,3,1
49893,60,2660,1293,570,1093,25,15,163,1318,10,195,123,241,205,364,1516,2795,6,17273,959,0,2,17,0,1
49894,32,948,339,213,244,17,9,65,356,10,42,26,48,52,74,259,421,5,2410,133,0,2,2,0,0
49895,60,2660,1293,570,1093,25,15,163,1318,10,195,123,241,205,364,1516,2795,6,17273,959,0,2,2,2,0
49896,33,960,339,213,244,17,9,65,356,10,42,26,48,52,74,259,421,5,2410,133,0,2,6,2,0
49897,33,960,339,213,244,17,9,65,356,10,42,26,48,52,74,259,421,5,2410,133,0,2,3,3,0
49898,60,2658,1293,570,1093,25,15,163,1318,10,195,123,241,205,364,1516,2795,6,17273,959,0,2,2,2,0
49899,60,2658,1293,570,1093,25,15,163,1318,10,195,123,241,205,364,1516,2795,6,17273,959,0,2,1,0,0
49900,48,992,447,308,343,6,5,95,453,7,96,59,111,103,170,651,1136,4,4600,255,0,2,1,1,0
49901,48,992,322,174,179,16,74,51,338,10,41,26,46,51,72,252,408,5,2291,127,0,2,1,1,0
49904,33,961,339,213,244,17,9,65,356,10,42,26,48,52,74,259,421,5,2410,133,0,2,1,1,0
49905,34,983,339,213,244,17,9,65,356,10,42,26,48,52,74,259,421,5,2410,133,0,2,24,23,1
49906,61,2743,1293,570,1093,25,15,163,1318,10,195,123,241,205,364,1516,2795,6,17273,959,0,2,21,0,1
49907,61,2743,1293,570,1093,25,15,163,1318,10,195,123,241,205,364,1516,2795,6,17273,959,0,2,1,1,0
49908,61,2731,1293,570,1093,25,15,163,1318,10,195,123,241,205,364,1516,2795,6,17273,959,0,2,0,2,0
49909,34,995,339,213,244,17,9,65,356,10,42,26,48,52,74,259,421,5,2410,133,0,2,3,1,0
49910,61,2731,1293,570,1093,25,15,163,1318,10,195,123,241,205,364,1516,2795,6,17273,959,0,2,1,1,0
49920,88,2252,773,422,505,30,103,129,803,14,77,46,83,91,129,535,839,7,6334,351,0,2,3,1,0
49921,84,1794,402,202,227,24,74,80,426,12,52,33,61,64,94,339,564,7,3969,220,0,2,2,2,0
49925,94,4062,1020,354,843,12,15,144,1032,8,134,77,144,142,221,970,1580,4,6792,377,0,2,13,0,0
49935,3,42,14,8,8,0,0,6,14,0,0,0,0,0,0,0,0,0,0,0,0,2,5,2,1
49936,2,40,9,6,6,0,0,3,9,0,0,0,0,0,0,0,0,0,0,0,0,2,3,2,1
49937,2,40,13,9,8,0,0,4,13,0,0,0,0,0,0,0,0,0,0,0,0,2,3,2,1
49939,1,324,382,65,130,157,2,92,539,4,10,5,10,14,15,41,57,2,114,6,0,2,119,100,1
49940,60,1081,282,196,195,3,0,86,285,8,130,71,141,138,212,936,1507,4,6538,363,0,2,72,51,1
49941,4,77,127,75,83,2,11,30,129,4,14,7,14,18,21,61,87,2,175,9,0,2,6,3,1
49942,4,77,652,304,544,16,6,88,668,6,89,51,101,95,152,591,998,3,3399,188,0,2,6,3,1
49943,4,77,2,2,2,0,0,0,2,0,0,0,0,0,0,0,0,0,0,0,0,2,6,3,1
49944,4,77,8,5,5,0,0,3,8,0,0,0,0,0,0,0,0,0,0,0,0,2,6,3,1
49947,4,77,14,8,8,0,0,6,14,0,0,0,0,0,0,0,0,0,0,0,0,2,6,3,1
49948,4,77,6,4,4,0,0,2,6,0,0,0,0,0,0,0,0,0,0,0,0,2,6,3,1
49949,4,77,6,4,4,0,0,2,6,1,2,1,2,3,3,2,4,0,2,0,0,2,6,3,1
49951,4,77,7,5,5,0,0,2,7,0,0,0,0,0,0,0,0,0,0,0,0,2,6,3,1
49953,4,77,10,6,6,0,0,4,10,0,0,0,0,0,0,0,0,0,0,0,0,2,6,3,1
49954,4,77,1,1,1,0,0,0,1,0,0,0,0,0,0,0,0,0,0,0,0,2,6,3,1
49956,4,77,14,10,10,0,0,4,14,1,1,1,1,2,2,0,2,0,1,0,0,2,6,3,1
49957,4,77,46,26,30,3,0,12,49,3,6,3,6,9,9,20,28,1,42,2,0,2,6,3,1
49959,1,90,13,10,10,0,0,3,13,1,2,1,2,3,3,2,4,0,2,0,0,2,5,5,1
49960,7,114,44,19,17,0,16,11,44,3,14,7,14,17,21,58,85,1,128,7,0,2,3,1,1
49961,3,66,127,75,83,2,11,30,129,4,14,7,14,18,21,61,87,2,175,9,0,2,4,1,1
49962,3,66,652,304,544,16,6,88,668,6,89,51,101,95,152,591,998,3,3399,188,0,2,4,1,1
49963,3,66,2,2,2,0,0,0,2,0,0,0,0,0,0,0,0,0,0,0,0,2,4,1,1
49964,3,66,8,5,5,0,0,3,8,0,0,0,0,0,0,0,0,0,0,0,0,2,4,1,1
49967,3,66,14,8,8,0,0,6,14,0,0,0,0,0,0,0,0,0,0,0,0,2,4,1,1
49968,3,66,6,4,4,0,0,2,6,0,0,0,0,0,0,0,0,0,0,0,0,2,4,1,1
49969,3,66,6,4,4,0,0,2,6,1,2,1,2,3,3,2,4,0,2,0,0,2,4,1,1
49971,3,66,7,5,5,0,0,2,7,0,0,0,0,0,0,0,0,0,0,0,0,2,4,1,1
49973,3,66,10,6,6,0,0,4,10,0,0,0,0,0,0,0,0,0,0,0,0,2,4,1,1
49974,3,66,1,1,1,0,0,0,1,0,0,0,0,0,0,0,0,0,0,0,0,2,4,1,1
49976,3,66,14,10,10,0,0,4,14,1,1,1,1,2,2,0,2,0,1,0,0,2,4,1,1
49977,3,66,46,26,30,3,0,12,49,3,6,3,6,9,9,20,28,1,42,2,0,2,4,1,1
49978,7,298,72,33,56,0,4,12,72,1,1,1,1,2,2,0,2,0,1,0,0,2,26,10,1
49979,12,229,127,75,83,2,11,30,129,4,14,7,14,18,21,61,87,2,175,9,0,2,13,6,1
49980,12,229,652,304,544,16,6,88,668,6,89,51,101,95,152,591,998,3,3399,188,0,2,13,6,1
49981,12,229,2,2,2,0,0,0,2,0,0,0,0,0,0,0,0,0,0,0,0,2,13,6,1
49982,12,229,8,5,5,0,0,3,8,0,0,0,0,0,0,0,0,0,0,0,0,2,13,6,1
49985,12,229,14,8,8,0,0,6,14,0,0,0,0,0,0,0,0,0,0,0,0,2,13,6,1
49986,12,229,6,4,4,0,0,2,6,0,0,0,0,0,0,0,0,0,0,0,0,2,13,6,1
49987,12,229,6,4,4,0,0,2,6,1,2,1,2,3,3,2,4,0,2,0,0,2,13,6,1
49989,12,229,7,5,5,0,0,2,7,0,0,0,0,0,0,0,0,0,0,0,0,2,13,6,1
49991,12,229,10,6,6,0,0,4,10,0,0,0,0,0,0,0,0,0,0,0,0,2,13,6,1
49992,12,229,1,1,1,0,0,0,1,0,0,0,0,0,0,0,0,0,0,0,0,2,13,6,1
49994,12,229,14,10,10,0,0,4,14,1,1,1,1,2,2,0,2,0,1,0,0,2,13,6,1
49995,12,229,46,26,30,3,0,12,49,3,6,3,6,9,9,20,28,1,42,2,0,2,13,6,1
49996,6,71,127,75,83,2,11,30,129,4,14,7,14,18,21,61,87,2,175,9,0,2,2,3,1
49997,6,71,652,304,544,16,6,88,668,6,89,51,101,95,152,591,998,3,3399,188,0,2,2,3,1
49998,6,71,2,2,2,0,0,0,2,0,0,0,0,0,0,0,0,0,0,0,0,2,2,3,1
49999,6,71,8,5,5,0,0,3,8,0,0,0,0,0,0,0,0,0,0,0,0,2,2,3,1
50002,6,71,14,8,8,0,0,6,14,0,0,0,0,0,0,0,0,0,0,0,0,2,2,3,1
50003,6,71,6,4,4,0,0,2,6,0,0,0,0,0,0,0,0,0,0,0,0,2,2,3,1
50004,6,71,6,4,4,0,0,2,6,1,2,1,2,3,3,2,4,0,2,0,0,2,2,3,1
50006,6,71,7,5,5,0,0,2,7,0,0,0,0,0,0,0,0,0,0,0,0,2,2,3,1
50008,6,71,10,6,6,0,0,4,10,0,0,0,0,0,0,0,0,0,0,0,0,2,2,3,1
50009,6,71,1,1,1,0,0,0,1,0,0,0,0,0,0,0,0,0,0,0,0,2,2,3,1
50011,6,71,14,10,10,0,0,4,14,1,1,1,1,2,2,0,2,0,1,0,0,2,2,3,1
50012,6,71,46,26,30,3,0,12,49,3,6,3,6,9,9,20,28,1,42,2,0,2,2,3,1
50013,3,26,14,7,7,2,0,5,16,0,0,0,0,0,0,0,0,0,0,0,0,2,4,1,1
50015,17,378,85,59,61,8,0,16,93,5,18,10,18,23,28,86,126,2,316,17,0,2,20,19,1
50016,11,413,42,7,35,4,0,5,46,1,2,1,2,3,3,2,4,0,2,0,0,2,59,66,1
50017,11,413,11,6,10,0,0,1,11,2,4,2,4,6,6,10,15,1,15,0,0,2,59,66,1
50041,11,238,19,8,11,5,0,4,24,2,5,3,6,7,9,13,25,1,30,1,0,3,10,6,1
50042,11,238,102,59,69,5,3,24,107,6,22,15,28,28,43,113,206,3,789,43,0,3,10,6,1
50043,11,238,106,40,36,3,49,17,109,8,17,13,23,25,36,93,167,5,904,50,0,3,10,6,1
50067,213,4619,182,127,129,0,0,53,182,5,39,21,42,44,63,217,343,2,926,51,0,3,128,67,1
50068,213,4619,1165,710,800,67,119,181,1232,18,243,153,282,261,435,2000,3492,10,36473,2026,1,3,128,67,1
50069,83,1808,773,419,590,28,0,166,801,10,204,113,217,214,330,1598,2554,5,13587,754,0,3,37,22,1
50070,83,1808,421,273,302,44,34,57,465,17,81,59,107,98,166,583,1098,11,12329,684,0,3,37,22,1
50073,26,525,2,2,2,0,0,0,2,0,0,0,0,0,0,0,0,0,0,0,0,3,21,16,1
50087,26,525,99,48,90,1,3,5,100,0,0,0,0,0,0,0,0,0,0,0,0,3,21,16,1
50088,26,525,8,5,5,2,0,1,10,0,0,0,0,0,0,0,0,0,0,0,0,3,21,16,1
50089,26,525,1217,716,841,84,126,174,1301,14,185,118,215,199,333,1446,2542,8,20687,1149,0,3,21,16,1
50090,26,525,160,89,115,0,13,31,160,7,15,11,17,22,28,78,124,3,495,27,0,3,21,16,1
50091,26,525,10,10,9,9,0,0,19,0,0,0,0,0,0,0,0,0,0,0,0,3,21,16,1
50092,26,525,173,84,99,8,29,36,181,5,12,7,13,17,20,54,81,2,221,12,0,3,21,16,1
50093,26,525,3,1,1,3,0,0,6,0,0,0,0,0,0,0,0,0,0,0,0,3,21,16,1
50094,164,5065,1660,832,1314,41,38,274,1701,20,312,209,395,332,604,2671,5058,12,64042,3557,1,3,89,62,1
50095,164,5065,1057,646,719,113,100,145,1170,18,215,134,248,233,382,1740,3004,10,31186,1732,1,3,89,62,1
50096,17,344,95,58,50,9,16,20,104,12,33,24,45,45,69,209,378,8,3100,172,0,3,6,9,1
50097,89,1830,477,336,357,30,23,73,507,16,194,134,250,210,384,1538,2962,10,30538,1696,0,3,97,63,1
50098,74,1693,996,429,845,24,10,117,1020,7,76,50,88,83,138,494,879,4,3565,198,0,3,127,91,1
50099,74,1693,456,277,329,12,42,72,468,13,85,50,97,98,147,592,972,7,7212,400,0,3,127,91,1
50100,145,3016,1513,682,1277,25,13,200,1538,11,199,116,219,210,335,1557,2584,6,15641,868,0,3,58,42,1
50101,145,3016,819,519,539,24,98,155,843,15,96,57,106,111,163,690,1107,8,9171,509,0,3,58,42,1
50102,58,1192,207,111,150,11,0,50,218,5,26,19,36,31,55,133,272,3,943,52,0,3,87,59,1
50103,58,1192,410,198,237,31,55,97,441,11,63,38,72,74,110,414,683,6,4293,238,0,3,87,59,1
50106,211,4551,2,2,2,0,0,0,2,0,0,0,0,0,0,0,0,0,0,0,0,3,185,615,1
50120,211,4551,99,48,90,1,3,5,100,0,0,0,0,0,0,0,0,0,0,0,0,3,185,615,1
50121,211,4551,8,5,5,2,0,1,10,0,0,0,0,0,0,0,0,0,0,0,0,3,185,615,1
50122,211,4551,1217,716,841,84,126,174,1301,14,185,118,215,199,333,1446,2542,8,20687,1149,0,3,185,615,1
50123,211,4551,160,89,115,0,13,31,160,7,15,11,17,22,28,78,124,3,495,27,0,3,185,615,1
50124,211,4551,10,10,9,9,0,0,19,0,0,0,0,0,0,0,0,0,0,0,0,3,185,615,1
50125,211,4551,173,84,99,8,29,36,181,5,12,7,13,17,20,54,81,2,221,12,0,3,185,615,1
50126,211,4551,3,1,1,3,0,0,6,0,0,0,0,0,0,0,0,0,0,0,0,3,185,615,1
50127,94,1909,463,295,324,28,62,57,491,12,134,82,154,146,236,989,1696,6,11700,650,0,0,392,0,1
50129,51,727,167,116,138,4,5,22,171,8,48,30,56,56,86,292,499,4,2330,129,0,0,139,0,1
50130,28,810,339,213,244,17,9,65,356,10,42,26,48,52,74,259,421,5,2410,133,0,3,23,11,1
50132,85,2161,1455,414,1257,16,76,112,1471,5,41,23,46,46,69,231,381,2,1069,59,0,3,133,89,1
50133,85,2161,669,365,481,22,61,110,691,15,103,63,122,118,185,747,1273,8,11311,628,0,3,133,89,1
50134,247,5639,4293,999,3693,19,54,507,4312,9,155,88,170,164,258,1156,1898,4,9368,520,0,3,203,107,1
50135,247,5639,1482,859,1002,125,135,219,1607,16,219,134,251,235,385,1766,3032,9,27804,1544,1,3,203,107,1
50136,6,136,44,22,19,0,19,6,44,2,10,6,12,12,18,35,64,1,77,4,0,3,6,4,1
50137,27,959,74,35,59,1,0,14,75,3,14,7,14,17,21,58,85,1,128,7,0,3,78,51,1
50138,27,959,245,125,200,5,7,34,250,7,30,17,34,37,51,166,265,3,1053,58,0,3,78,51,1
50139,51,595,647,139,84,35,284,233,682,0,0,0,0,0,0,0,0,0,0,0,0,3,11,0,1
50140,98,2661,1523,757,1297,19,12,193,1542,12,193,117,230,205,347,1508,2664,7,19053,1058,0,3,138,111,1
50141,98,2661,701,378,504,33,58,109,734,13,110,68,126,123,194,794,1346,7,10027,557,0,3,138,111,1
50142,88,2252,773,422,505,30,103,129,803,14,77,46,83,91,129,535,839,7,6334,351,0,3,173,104,1
50143,140,3246,77,34,69,0,0,8,77,3,24,16,29,27,45,114,213,1,387,21,0,3,154,77,1
50144,140,3246,712,438,573,51,9,84,763,14,102,71,128,116,199,733,1364,8,11988,666,0,3,154,77,1
50147,24,605,2,2,2,0,0,0,2,0,0,0,0,0,0,0,0,0,0,0,0,3,45,28,1
50161,24,605,99,48,90,1,3,5,100,0,0,0,0,0,0,0,0,0,0,0,0,3,45,28,1
50162,24,605,8,5,5,2,0,1,10,0,0,0,0,0,0,0,0,0,0,0,0,3,45,28,1
50163,24,605,1217,716,841,84,126,174,1301,14,185,118,215,199,333,1446,2542,8,20687,1149,0,3,45,28,1
50164,24,605,160,89,115,0,13,31,160,7,15,11,17,22,28,78,124,3,495,27,0,3,45,28,1
50165,24,605,10,10,9,9,0,0,19,0,0,0,0,0,0,0,0,0,0,0,0,3,45,28,1
50166,24,605,173,84,99,8,29,36,181,5,12,7,13,17,20,54,81,2,221,12,0,3,45,28,1
50167,24,605,3,1,1,3,0,0,6,0,0,0,0,0,0,0,0,0,0,0,0,3,45,28,1
50168,30,658,125,97,103,3,0,19,128,9,25,17,27,34,44,144,223,4,1087,60,0,3,23,21,1
50169,22,350,102,57,55,5,16,25,107,5,17,10,18,22,28,81,124,2,330,18,0,3,10,10,1
50170,84,1794,402,202,227,24,74,80,426,12,52,33,61,64,94,339,564,7,3969,220,0,3,70,42,1
50171,48,992,447,308,343,6,5,95,453,7,96,59,111,103,170,651,1136,4,4600,255,0,3,17,18,1
50172,48,992,322,174,179,16,74,51,338,10,41,26,46,51,72,252,408,5,2291,127,0,3,17,18,1
50173,74,1669,53,23,39,0,0,13,53,2,8,4,8,10,12,26,39,1,39,2,0,3,61,28,1
50174,74,1669,515,298,307,33,80,99,548,12,63,44,77,75,121,419,753,7,5527,307,0,3,61,28,1
50175,23,381,424,94,331,4,0,89,428,1,5,5,5,6,10,11,25,0,12,0,0,3,14,14,1
50176,23,381,38,23,23,6,0,8,44,3,11,7,11,14,18,42,68,1,102,5,0,3,14,14,1
50177,20,511,205,80,86,16,53,53,221,7,18,10,19,25,29,94,134,3,497,27,0,3,25,14,1
50178,17,519,184,100,137,2,15,30,186,6,38,20,39,44,59,214,322,3,991,55,0,3,30,21,1
50179,17,519,103,65,74,8,5,16,111,7,17,9,17,24,26,89,119,3,417,23,0,3,30,21,1
50180,2,71,167,116,138,4,5,22,171,8,48,30,56,56,86,292,499,4,2330,129,0,0,13,0,1
50181,231,5436,722,423,573,19,0,135,741,12,172,101,199,184,300,1320,2257,6,15668,870,0,3,140,79,1
50182,231,5436,1508,847,911,44,250,301,1552,14,148,88,169,162,257,1120,1886,7,15077,837,0,3,140,79,1
50183,310,6786,72,33,56,0,4,12,72,1,1,1,1,2,2,0,2,0,1,0,0,3,298,186,1
50184,310,6786,1454,835,1044,76,110,219,1530,17,275,158,296,292,454,2297,3718,9,34017,1889,1,3,298,186,1
50185,78,1601,757,253,292,73,244,162,830,13,61,38,67,74,105,409,651,7,4654,258,0,3,53,33,1
50186,46,954,386,256,301,16,9,68,402,4,59,35,69,63,104,355,621,2,1453,80,0,3,23,16,1
50187,46,954,264,131,164,11,41,46,275,6,38,22,40,44,62,214,338,3,1068,59,0,3,23,16,1
50188,28,702,466,257,367,18,25,50,484,7,126,86,171,133,257,898,1813,4,8612,478,0,0,196,0,1
50189,28,702,507,281,342,29,59,88,536,10,53,29,57,63,86,336,514,5,2764,153,0,0,196,0,1
50190,30,650,215,129,180,6,0,29,221,8,65,43,72,73,115,415,711,4,3153,175,0,3,24,18,1
50191,30,650,97,69,77,3,3,16,100,6,22,13,23,28,36,113,173,3,542,30,0,3,24,18,1
50192,90,1927,1043,504,840,53,9,147,1096,9,180,112,198,189,310,1377,2344,4,11604,644,0,3,77,216,1
50193,90,1927,383,288,292,26,6,62,409,11,65,38,67,76,105,429,656,5,3719,206,0,3,77,216,1
50194,20,411,294,64,250,0,0,43,294,1,20,10,20,21,30,86,131,0,65,3,0,3,30,20,1
50195,20,411,78,46,62,3,0,14,81,3,8,4,8,11,12,28,41,1,62,3,0,3,30,20,1
50196,5,119,110,30,77,3,13,16,113,4,21,15,30,25,45,100,208,2,597,33,0,3,7,3,1
50197,5,119,28,15,21,1,0,6,29,0,0,0,0,0,0,0,0,0,0,0,0,3,7,3,1
50198,70,1382,1178,367,1042,6,15,115,1184,9,94,51,95,103,146,644,976,4,4439,246,0,3,78,69,1
50199,70,1382,177,108,140,8,0,27,185,6,30,16,32,36,48,162,248,3,794,44,0,3,78,69,1
50200,209,4552,1943,715,1694,26,18,214,1969,12,185,120,237,197,357,1436,2721,7,20915,1161,0,3,222,138,1
50201,209,4552,1168,838,957,57,25,144,1225,19,348,224,416,367,640,3018,5452,11,61921,3440,1,3,222,138,1
50202,16,480,442,244,305,14,16,103,456,11,68,45,75,79,120,452,756,6,4588,254,0,3,11,8,1
50203,16,480,182,102,99,11,40,35,193,3,11,6,11,14,17,42,64,1,97,5,0,3,11,8,1
50204,62,1226,1098,241,925,5,10,155,1103,7,46,25,49,53,74,273,423,3,1580,87,0,3,42,28,1
50205,62,1226,282,202,222,14,2,44,296,8,42,24,43,50,67,250,378,4,1548,86,0,3,42,28,1
50206,22,458,601,196,481,2,23,85,603,8,63,36,72,71,108,400,664,4,3036,168,0,3,35,20,1
50207,22,458,156,79,106,5,16,28,161,5,14,8,15,19,23,64,97,2,261,14,0,3,35,20,1
50231,92,3868,1289,550,1043,56,32,155,1345,10,167,93,185,177,278,1266,2075,5,11498,638,0,2,307,281,1
50232,36,1088,182,127,129,0,0,53,182,5,39,21,42,44,63,217,343,2,926,51,0,2,40,34,1
50233,147,6910,1392,870,1177,35,17,170,1427,14,494,280,531,508,811,4473,7289,7,54850,3047,2,2,268,173,1
50234,88,2881,773,419,590,28,0,166,801,10,204,113,217,214,330,1598,2554,5,13587,754,0,2,153,84,1
50235,15,744,75,38,59,1,3,12,76,2,4,2,4,6,6,10,15,1,15,0,0,2,139,77,1
50271,8,263,51,25,36,0,0,15,51,3,11,6,12,14,18,42,68,1,112,6,0,0,51,0,1
50277,15,703,139,89,101,2,0,35,141,7,54,34,62,61,96,330,569,4,2287,127,0,2,66,48,1
50278,1,136,149,67,118,4,0,27,153,1,17,14,28,18,42,69,175,0,144,8,0,2,13,7,1
50279,32,2079,1157,318,931,29,22,177,1186,6,104,63,125,110,188,712,1274,3,4596,255,0,2,414,274,1
50280,56,3685,520,294,400,33,13,81,553,10,261,204,367,271,571,2128,4614,7,32445,1802,1,2,94,93,1
50281,98,4433,1338,495,1086,10,64,173,1348,11,122,82,157,133,239,883,1686,7,11934,663,0,2,472,291,1
50282,174,7788,139,89,101,2,0,35,141,7,54,34,62,61,96,330,569,4,2287,127,0,2,1208,625,1
50283,174,7788,7,5,5,0,0,2,7,1,2,1,2,3,3,2,4,0,2,0,0,2,1208,625,1
50284,33,1004,465,148,393,5,8,60,470,4,31,20,31,35,51,161,261,2,523,29,0,2,94,55,1
50285,33,1004,16,12,9,0,0,6,16,1,2,1,2,3,3,2,4,0,2,0,0,2,94,55,1
50286,139,5895,1782,648,1425,9,47,279,1791,8,171,97,189,179,286,1292,2140,4,9462,525,0,2,485,358,1
50287,25,684,256,139,192,9,7,47,265,4,23,12,24,27,36,112,171,2,357,19,0,2,28,23,1
50289,23,578,102,59,69,5,3,24,107,6,22,15,28,28,43,113,206,3,789,43,0,2,31,21,1
50290,111,4174,1450,624,1228,12,26,181,1462,14,306,186,354,320,540,2580,4493,8,36391,2021,1,2,479,386,1
50291,154,4337,1660,832,1314,41,38,274,1701,20,312,209,395,332,604,2671,5058,12,64042,3557,1,2,303,192,1
50292,39,2966,996,429,845,24,10,117,1020,7,76,50,88,83,138,494,879,4,3565,198,0,2,418,318,1
50293,125,5131,1513,682,1277,25,13,200,1538,11,199,116,219,210,335,1557,2584,6,15641,868,0,2,382,294,1
50294,73,3805,1296,573,1062,40,33,157,1336,8,201,118,231,209,349,1561,2689,4,12365,686,0,2,268,193,1
50295,14,341,207,111,150,11,0,50,218,5,26,19,36,31,55,133,272,3,943,52,0,2,21,16,1
50296,84,4438,1457,730,1242,11,6,188,1468,10,292,166,329,302,495,2424,4078,5,22973,1276,1,2,425,271,1
50297,39,2323,652,304,544,16,6,88,668,6,89,51,101,95,152,591,998,3,3399,188,0,2,177,112,1
50298,70,3212,1455,414,1257,16,76,112,1471,5,41,23,46,46,69,231,381,2,1069,59,0,2,529,351,1
50301,95,4640,1523,757,1297,19,12,193,1542,12,193,117,230,205,347,1508,2664,7,19053,1058,0,2,324,197,1
50302,94,4062,1020,354,843,12,15,144,1032,8,134,77,144,142,221,970,1580,4,6792,377,0,2,478,214,1
50303,38,1676,447,308,343,6,5,95,453,7,96,59,111,103,170,651,1136,4,4600,255,0,2,95,72,1
50305,21,658,424,94,331,4,0,89,428,1,5,5,5,6,10,11,25,0,12,0,0,2,83,60,1
50306,38,2302,334,251,279,10,4,40,344,5,127,74,143,132,217,899,1528,2,4303,239,0,2,114,97,1
50307,12,493,184,100,137,2,15,30,186,6,38,20,39,44,59,214,322,3,991,55,0,2,46,34,1
50308,59,2582,1293,570,1093,25,15,163,1318,10,195,123,241,205,364,1516,2795,6,17273,959,0,2,202,124,1
50309,33,1883,384,251,317,7,8,52,391,11,70,44,84,81,128,467,811,6,5355,297,0,2,70,55,1
50310,45,2209,722,423,573,19,0,135,741,12,172,101,199,184,300,1320,2257,6,15668,870,0,2,56,38,1
50311,39,1727,386,256,301,16,9,68,402,4,59,35,69,63,104,355,621,2,1453,80,0,2,88,52,1
50313,82,3159,1043,504,840,53,9,147,1096,9,180,112,198,189,310,1377,2344,4,11604,644,0,2,259,152,1
50315,30,1241,373,158,315,8,0,51,381,5,76,44,79,81,123,486,779,2,2026,112,0,2,87,45,1
50316,77,3213,1178,367,1042,6,15,115,1184,9,94,51,95,103,146,644,976,4,4439,246,0,2,459,375,1
50317,91,4597,1943,715,1694,26,18,214,1969,12,185,120,237,197,357,1436,2721,7,20915,1161,0,2,578,519,1
50318,14,826,442,244,305,14,16,103,456,11,68,45,75,79,120,452,756,6,4588,254,0,2,56,34,1
50319,49,1838,1098,241,925,5,10,155,1103,7,46,25,49,53,74,273,423,3,1580,87,0,2,333,172,1
50320,19,680,601,196,481,2,23,85,603,8,63,36,72,71,108,400,664,4,3036,168,0,2,138,107,1
50321,247,5639,4293,999,3693,19,54,507,4312,9,155,88,170,164,258,1156,1898,4,9368,520,0,2,17,10,0
50322,247,5639,1482,859,1002,125,135,219,1607,16,219,134,251,235,385,1766,3032,9,27804,1544,1,2,17,10,0
50323,247,5639,4293,999,3693,19,54,507,4312,9,155,88,170,164,258,1156,1898,4,9368,520,0,2,44,14,0
50324,247,5639,1482,859,1002,125,135,219,1607,16,219,134,251,235,385,1766,3032,9,27804,1544,1,2,44,14,0
50325,140,3246,77,34,69,0,0,8,77,3,24,16,29,27,45,114,213,1,387,21,0,2,58,9,0
50326,140,3246,712,438,573,51,9,84,763,14,102,71,128,116,199,733,1364,8,11988,666,0,2,58,9,0
50327,74,1669,53,23,39,0,0,13,53,2,8,4,8,10,12,26,39,1,39,2,0,2,1,1,0
50328,74,1669,515,298,307,33,80,99,548,12,63,44,77,75,121,419,753,7,5527,307,0,2,1,1,0
50329,310,6786,72,33,56,0,4,12,72,1,1,1,1,2,2,0,2,0,1,0,0,2,76,1,0
50330,310,6786,1454,835,1044,76,110,219,1530,17,275,158,296,292,454,2297,3718,9,34017,1889,1,2,76,1,0
50331,98,4433,1338,495,1086,10,64,173,1348,11,122,82,157,133,239,883,1686,7,11934,663,0,2,1,1,0
50332,174,7788,139,89,101,2,0,35,141,7,54,34,62,61,96,330,569,4,2287,127,0,2,112,5,0
50333,174,7788,7,5,5,0,0,2,7,1,2,1,2,3,3,2,4,0,2,0,0,2,112,5,0
50334,73,3805,1296,573,1062,40,33,157,1336,8,201,118,231,209,349,1561,2689,4,12365,686,0,2,2,2,0
50335,34,995,339,213,244,17,9,65,356,10,42,26,48,52,74,259,421,5,2410,133,0,2,37,2,0
50336,61,2731,1293,570,1093,25,15,163,1318,10,195,123,241,205,364,1516,2795,6,17273,959,0,2,37,0,0
50337,226,5282,722,423,573,19,0,135,741,12,172,101,199,184,300,1320,2257,6,15668,870,0,2,1,8,1
50338,226,5282,1508,847,911,44,250,301,1552,14,148,88,169,162,257,1120,1886,7,15077,837,0,2,1,8,1
50339,46,2234,722,423,573,19,0,135,741,12,172,101,199,184,300,1320,2257,6,15668,870,0,2,5,0,1
50340,226,5282,722,423,573,19,0,135,741,12,172,101,199,184,300,1320,2257,6,15668,870,0,2,1,8,0
50341,226,5282,1508,847,911,44,250,301,1552,14,148,88,169,162,257,1120,1886,7,15077,837,0,2,1,8,0
50342,46,2234,722,423,573,19,0,135,741,12,172,101,199,184,300,1320,2257,6,15668,870,0,2,5,0,0
50343,84,1801,773,419,590,28,0,166,801,10,204,113,217,214,330,1598,2554,5,13587,754,0,2,3,10,0
50344,84,1801,421,273,302,44,34,57,465,17,81,59,107,98,166,583,1098,11,12329,684,0,2,3,10,0
50345,25,684,256,139,192,9,7,47,265,4,23,12,24,27,36,112,171,2,357,19,0,2,1,2,0
50346,154,4337,1660,832,1314,41,38,274,1701,20,312,209,395,332,604,2671,5058,12,64042,3557,1,2,3,3,0
50347,125,5127,1513,682,1277,25,13,200,1538,11,199,116,219,210,335,1557,2584,6,15641,868,0,2,0,1,0
50353,92,2959,773,419,590,28,0,166,801,10,204,113,217,214,330,1598,2554,5,13587,754,0,2,16,0,0
50354,58,1174,207,111,150,11,0,50,218,5,26,19,36,31,55,133,272,3,943,52,0,2,2,2,0
50355,58,1174,410,198,237,31,55,97,441,11,63,38,72,74,110,414,683,6,4293,238,0,2,2,2,0
50358,211,4551,2,2,2,0,0,0,2,0,0,0,0,0,0,0,0,0,0,0,0,2,1,1,0
50372,211,4551,99,48,90,1,3,5,100,0,0,0,0,0,0,0,0,0,0,0,0,2,1,1,0
50373,211,4551,8,5,5,2,0,1,10,0,0,0,0,0,0,0,0,0,0,0,0,2,1,1,0
50374,211,4551,1217,716,841,84,126,174,1301,14,185,118,215,199,333,1446,2542,8,20687,1149,0,2,1,1,0
50375,211,4551,160,89,115,0,13,31,160,7,15,11,17,22,28,78,124,3,495,27,0,2,1,1,0
50376,211,4551,10,10,9,9,0,0,19,0,0,0,0,0,0,0,0,0,0,0,0,2,1,1,0
50377,211,4551,173,84,99,8,29,36,181,5,12,7,13,17,20,54,81,2,221,12,0,2,1,1,0
50378,211,4551,3,1,1,3,0,0,6,0,0,0,0,0,0,0,0,0,0,0,0,2,1,1,0
50379,154,4337,1660,832,1314,41,38,274,1701,20,312,209,395,332,604,2671,5058,12,64042,3557,1,2,1,1,0
50380,46,2233,722,423,573,19,0,135,741,12,172,101,199,184,300,1320,2257,6,15668,870,0,2,1,4,0
50441,154,4337,1660,832,1314,41,38,274,1701,20,312,209,395,332,604,2671,5058,12,64042,3557,1,2,4,4,0
50443,46,2233,722,423,573,19,0,135,741,12,172,101,199,184,300,1320,2257,6,15668,870,0,2,6,4,0
50444,288,6363,72,33,56,0,4,12,72,1,1,1,1,2,2,0,2,0,1,0,0,2,90,46,0
50445,288,6363,1454,835,1044,76,110,219,1530,17,275,158,296,292,454,2297,3718,9,34017,1889,1,2,90,46,0
50446,86,1828,402,202,227,24,74,80,426,12,52,33,61,64,94,339,564,7,3969,220,0,2,13,1,0
50447,287,6329,72,33,56,0,4,12,72,1,1,1,1,2,2,0,2,0,1,0,0,2,4,13,0
50448,287,6329,1454,835,1044,76,110,219,1530,17,275,158,296,292,454,2297,3718,9,34017,1889,1,2,4,13,0
50449,236,5588,722,423,573,19,0,135,741,12,172,101,199,184,300,1320,2257,6,15668,870,0,2,37,9,0
50450,236,5588,1508,847,911,44,250,301,1552,14,148,88,169,162,257,1120,1886,7,15077,837,0,2,37,9,0
50474,1,26,127,75,83,2,11,30,129,4,14,7,14,18,21,61,87,2,175,9,0,0,7,0,0
50475,1,26,652,304,544,16,6,88,668,6,89,51,101,95,152,591,998,3,3399,188,0,0,7,0,0
50476,1,26,2,2,2,0,0,0,2,0,0,0,0,0,0,0,0,0,0,0,0,0,7,0,0
50477,1,26,8,5,5,0,0,3,8,0,0,0,0,0,0,0,0,0,0,0,0,0,7,0,0
50480,1,26,14,8,8,0,0,6,14,0,0,0,0,0,0,0,0,0,0,0,0,0,7,0,0
50481,1,26,6,4,4,0,0,2,6,0,0,0,0,0,0,0,0,0,0,0,0,0,7,0,0
50482,1,26,6,4,4,0,0,2,6,1,2,1,2,3,3,2,4,0,2,0,0,0,7,0,0
50484,1,26,7,5,5,0,0,2,7,0,0,0,0,0,0,0,0,0,0,0,0,0,7,0,0
50486,1,26,10,6,6,0,0,4,10,0,0,0,0,0,0,0,0,0,0,0,0,0,7,0,0
50487,1,26,1,1,1,0,0,0,1,0,0,0,0,0,0,0,0,0,0,0,0,0,7,0,0
50489,1,26,14,10,10,0,0,4,14,1,1,1,1,2,2,0,2,0,1,0,0,0,7,0,0
50490,1,26,46,26,30,3,0,12,49,3,6,3,6,9,9,20,28,1,42,2,0,0,7,0,0
50491,1,7,2,2,2,0,0,0,2,0,0,0,0,0,0,0,0,0,0,0,0,0,2,0,0
50515,1,20,127,75,83,2,11,30,129,4,14,7,14,18,21,61,87,2,175,9,0,0,7,0,0
50516,1,20,652,304,544,16,6,88,668,6,89,51,101,95,152,591,998,3,3399,188,0,0,7,0,0
50517,1,20,2,2,2,0,0,0,2,0,0,0,0,0,0,0,0,0,0,0,0,0,7,0,0
50518,1,20,8,5,5,0,0,3,8,0,0,0,0,0,0,0,0,0,0,0,0,0,7,0,0
50521,1,20,14,8,8,0,0,6,14,0,0,0,0,0,0,0,0,0,0,0,0,0,7,0,0
50522,1,20,6,4,4,0,0,2,6,0,0,0,0,0,0,0,0,0,0,0,0,0,7,0,0
50523,1,20,6,4,4,0,0,2,6,1,2,1,2,3,3,2,4,0,2,0,0,0,7,0,0
50525,1,20,7,5,5,0,0,2,7,0,0,0,0,0,0,0,0,0,0,0,0,0,7,0,0
50527,1,20,10,6,6,0,0,4,10,0,0,0,0,0,0,0,0,0,0,0,0,0,7,0,0
50528,1,20,1,1,1,0,0,0,1,0,0,0,0,0,0,0,0,0,0,0,0,0,7,0,0
50530,1,20,14,10,10,0,0,4,14,1,1,1,1,2,2,0,2,0,1,0,0,0,7,0,0
50531,1,20,46,26,30,3,0,12,49,3,6,3,6,9,9,20,28,1,42,2,0,0,7,0,0
50533,1,13,127,75,83,2,11,30,129,4,14,7,14,18,21,61,87,2,175,9,0,0,6,0,0
50534,1,13,652,304,544,16,6,88,668,6,89,51,101,95,152,591,998,3,3399,188,0,0,6,0,0
50535,1,13,2,2,2,0,0,0,2,0,0,0,0,0,0,0,0,0,0,0,0,0,6,0,0
50536,1,13,8,5,5,0,0,3,8,0,0,0,0,0,0,0,0,0,0,0,0,0,6,0,0
50539,1,13,14,8,8,0,0,6,14,0,0,0,0,0,0,0,0,0,0,0,0,0,6,0,0
50540,1,13,6,4,4,0,0,2,6,0,0,0,0,0,0,0,0,0,0,0,0,0,6,0,0
50541,1,13,6,4,4,0,0,2,6,1,2,1,2,3,3,2,4,0,2,0,0,0,6,0,0
50543,1,13,7,5,5,0,0,2,7,0,0,0,0,0,0,0,0,0,0,0,0,0,6,0,0
50545,1,13,10,6,6,0,0,4,10,0,0,0,0,0,0,0,0,0,0,0,0,0,6,0,0
50546,1,13,1,1,1,0,0,0,1,0,0,0,0,0,0,0,0,0,0,0,0,0,6,0,0
50548,1,13,14,10,10,0,0,4,14,1,1,1,1,2,2,0,2,0,1,0,0,0,6,0,0
50549,1,13,46,26,30,3,0,12,49,3,6,3,6,9,9,20,28,1,42,2,0,0,6,0,0
50573,1,16,127,75,83,2,11,30,129,4,14,7,14,18,21,61,87,2,175,9,0,0,6,0,0
50574,1,16,652,304,544,16,6,88,668,6,89,51,101,95,152,591,998,3,3399,188,0,0,6,0,0
50575,1,16,2,2,2,0,0,0,2,0,0,0,0,0,0,0,0,0,0,0,0,0,6,0,0
50576,1,16,8,5,5,0,0,3,8,0,0,0,0,0,0,0,0,0,0,0,0,0,6,0,0
50579,1,16,14,8,8,0,0,6,14,0,0,0,0,0,0,0,0,0,0,0,0,0,6,0,0
50580,1,16,6,4,4,0,0,2,6,0,0,0,0,0,0,0,0,0,0,0,0,0,6,0,0
50581,1,16,6,4,4,0,0,2,6,1,2,1,2,3,3,2,4,0,2,0,0,0,6,0,0
50583,1,16,7,5,5,0,0,2,7,0,0,0,0,0,0,0,0,0,0,0,0,0,6,0,0
50585,1,16,10,6,6,0,0,4,10,0,0,0,0,0,0,0,0,0,0,0,0,0,6,0,0
50586,1,16,1,1,1,0,0,0,1,0,0,0,0,0,0,0,0,0,0,0,0,0,6,0,0
50588,1,16,14,10,10,0,0,4,14,1,1,1,1,2,2,0,2,0,1,0,0,0,6,0,0
50589,1,16,46,26,30,3,0,12,49,3,6,3,6,9,9,20,28,1,42,2,0,0,6,0,0
50590,1,10,2,2,2,0,0,0,2,1,2,1,2,3,3,2,4,0,2,0,0,0,2,0,0
50608,2,26,10,6,6,0,0,4,10,2,4,2,4,6,6,10,15,1,15,0,0,0,10,0,0
50609,3,47,15,10,10,0,0,5,15,2,4,2,4,6,6,10,15,1,15,0,0,0,15,0,0
50610,3,39,15,9,9,0,0,6,15,0,0,0,0,0,0,0,0,0,0,0,0,0,16,0,0
50611,2,36,10,7,7,0,0,3,10,1,2,1,2,3,3,2,4,0,2,0,0,0,11,0,0
50612,3,46,15,9,9,0,0,6,15,1,4,2,4,5,6,8,13,0,6,0,0,0,15,0,0
50613,2,21,10,6,6,0,0,4,10,0,0,0,0,0,0,0,0,0,0,0,0,0,10,0,0
50614,175,7644,139,89,101,2,0,35,141,7,54,34,62,61,96,330,569,4,2287,127,0,2,94,220,0
50615,175,7644,7,5,5,0,0,2,7,1,2,1,2,3,3,2,4,0,2,0,0,2,94,220,0
50617,287,6329,72,33,56,0,4,12,72,1,1,1,1,2,2,0,2,0,1,0,0,2,86,51,0
50618,287,6329,1454,835,1044,76,110,219,1530,17,275,158,296,292,454,2297,3718,9,34017,1889,1,2,86,51,0
50619,12,509,124,78,88,2,3,26,126,4,13,7,13,17,20,56,81,2,163,9,0,3,38,45,1
50643,86,1822,402,202,227,24,74,80,426,12,52,33,61,64,94,339,564,7,3969,220,0,2,2,2,1
50644,214,4654,182,127,129,0,0,53,182,5,39,21,42,44,63,217,343,2,926,51,0,2,8,1,1
50645,214,4654,1165,710,800,67,119,181,1232,18,243,153,282,261,435,2000,3492,10,36473,2026,1,2,8,1,1
50646,75,1692,53,23,39,0,0,13,53,2,8,4,8,10,12,26,39,1,39,2,0,2,6,0,1
50647,75,1692,515,298,307,33,80,99,548,12,63,44,77,75,121,419,753,7,5527,307,0,2,6,0,1
50648,149,6994,1392,870,1177,35,17,170,1427,14,494,280,531,508,811,4473,7289,7,54850,3047,2,2,12,0,1
50649,12,509,124,78,88,2,3,26,126,4,13,7,13,17,20,56,81,2,163,9,0,3,38,45,0
50673,86,1822,402,202,227,24,74,80,426,12,52,33,61,64,94,339,564,7,3969,220,0,2,2,2,0
50677,58,1192,207,111,150,11,0,50,218,5,26,19,36,31,55,133,272,3,943,52,0,2,2,2,0
50678,58,1192,410,198,237,31,55,97,441,11,63,38,72,74,110,414,683,6,4293,238,0,2,2,2,0
50702,86,1822,402,202,227,24,74,80,426,12,52,33,61,64,94,339,564,7,3969,220,0,2,15,3,0
50703,236,5564,722,423,573,19,0,135,741,12,172,101,199,184,300,1320,2257,6,15668,870,0,2,1,8,0
50704,236,5564,1508,847,911,44,250,301,1552,14,148,88,169,162,257,1120,1886,7,15077,837,0,2,1,8,0
50705,312,6821,72,33,56,0,4,12,72,1,1,1,1,2,2,0,2,0,1,0,0,2,86,51,0
50706,312,6821,1454,835,1044,76,110,219,1530,17,275,158,296,292,454,2297,3718,9,34017,1889,1,2,86,51,0
50735,214,4654,182,127,129,0,0,53,182,5,39,21,42,44,63,217,343,2,926,51,0,2,8,1,0
50736,214,4654,1165,710,800,67,119,181,1232,18,243,153,282,261,435,2000,3492,10,36473,2026,1,2,8,1,0
50737,75,1692,53,23,39,0,0,13,53,2,8,4,8,10,12,26,39,1,39,2,0,2,6,0,0
50738,75,1692,515,298,307,33,80,99,548,12,63,44,77,75,121,419,753,7,5527,307,0,2,6,0,0
50739,149,6994,1392,870,1177,35,17,170,1427,14,494,280,531,508,811,4473,7289,7,54850,3047,2,2,12,0,0
50801,78,1609,757,253,292,73,244,162,830,13,61,38,67,74,105,409,651,7,4654,258,0,2,4,1,0
50802,247,5655,4293,999,3693,19,54,507,4312,9,155,88,170,164,258,1156,1898,4,9368,520,0,2,15,12,1
50803,247,5655,1482,859,1002,125,135,219,1607,16,219,134,251,235,385,1766,3032,9,27804,1544,1,2,15,12,1
50804,248,5674,4293,999,3693,19,54,507,4312,9,155,88,170,164,258,1156,1898,4,9368,520,0,2,17,9,0
50805,248,5674,1482,859,1002,125,135,219,1607,16,219,134,251,235,385,1766,3032,9,27804,1544,1,2,17,9,0
50806,245,5645,4293,999,3693,19,54,507,4312,9,155,88,170,164,258,1156,1898,4,9368,520,0,2,1,7,0
50807,245,5645,1482,859,1002,125,135,219,1607,16,219,134,251,235,385,1766,3032,9,27804,1544,1,2,1,7,0
50808,245,5645,4293,999,3693,19,54,507,4312,9,155,88,170,164,258,1156,1898,4,9368,520,0,2,33,28,0
50809,245,5645,1482,859,1002,125,135,219,1607,16,219,134,251,235,385,1766,3032,9,27804,1544,1,2,33,28,0
50810,1,319,382,65,130,157,2,92,539,4,10,5,10,14,15,41,57,2,114,6,0,2,1,1,0
50812,57,3792,520,294,400,33,13,81,553,10,261,204,367,271,571,2128,4614,7,32445,1802,1,2,14,0,0
50813,78,1602,757,253,292,73,244,162,830,13,61,38,67,74,105,409,651,7,4654,258,0,2,3,4,0
50814,57,3898,520,294,400,33,13,81,553,10,261,204,367,271,571,2128,4614,7,32445,1802,1,2,8,1,0
50815,58,1198,207,111,150,11,0,50,218,5,26,19,36,31,55,133,272,3,943,52,0,2,1,0,1
50816,58,1198,410,198,237,31,55,97,441,11,63,38,72,74,110,414,683,6,4293,238,0,2,1,0,1
50818,255,5847,4293,999,3693,19,54,507,4312,9,155,88,170,164,258,1156,1898,4,9368,520,0,2,51,1,1
50819,255,5847,1482,859,1002,125,135,219,1607,16,219,134,251,235,385,1766,3032,9,27804,1544,1,2,51,1,1
50820,237,5596,722,423,573,19,0,135,741,12,172,101,199,184,300,1320,2257,6,15668,870,0,2,5,0,1
50821,237,5596,1508,847,911,44,250,301,1552,14,148,88,169,162,257,1120,1886,7,15077,837,0,2,5,0,1
50822,17,774,75,38,59,1,3,12,76,2,4,2,4,6,6,10,15,1,15,0,0,2,14,0,1
50823,1,41,7,5,5,0,0,2,7,1,2,1,2,3,3,2,4,0,2,0,0,0,7,0,1
50824,175,7644,139,89,101,2,0,35,141,7,54,34,62,61,96,330,569,4,2287,127,0,2,6,3,1
50825,175,7644,7,5,5,0,0,2,7,1,2,1,2,3,3,2,4,0,2,0,0,2,6,3,1
50826,111,4178,1450,624,1228,12,26,181,1462,14,306,186,354,320,540,2580,4493,8,36391,2021,1,2,6,7,1
50827,39,2321,652,304,544,16,6,88,668,6,89,51,101,95,152,591,998,3,3399,188,0,2,1,3,1
50828,14,717,442,244,305,14,16,103,456,11,68,45,75,79,120,452,756,6,4588,254,0,2,3,28,1
50829,139,5919,1782,648,1425,9,47,279,1791,8,171,97,189,179,286,1292,2140,4,9462,525,0,2,3,0,1
50830,236,5564,722,423,573,19,0,135,741,12,172,101,199,184,300,1320,2257,6,15668,870,0,2,0,5,0
50831,236,5564,1508,847,911,44,250,301,1552,14,148,88,169,162,257,1120,1886,7,15077,837,0,2,0,5,0
50832,14,725,442,244,305,14,16,103,456,11,68,45,75,79,120,452,756,6,4588,254,0,2,2,1,0
50833,79,1591,757,253,292,73,244,162,830,13,61,38,67,74,105,409,651,7,4654,258,0,2,1,3,0
50834,58,1198,207,111,150,11,0,50,218,5,26,19,36,31,55,133,272,3,943,52,0,2,1,0,0
50835,58,1198,410,198,237,31,55,97,441,11,63,38,72,74,110,414,683,6,4293,238,0,2,1,0,0
50837,255,5847,4293,999,3693,19,54,507,4312,9,155,88,170,164,258,1156,1898,4,9368,520,0,2,51,1,0
50838,255,5847,1482,859,1002,125,135,219,1607,16,219,134,251,235,385,1766,3032,9,27804,1544,1,2,51,1,0
50839,17,774,75,38,59,1,3,12,76,2,4,2,4,6,6,10,15,1,15,0,0,2,14,0,0
50840,1,41,7,5,5,0,0,2,7,1,2,1,2,3,3,2,4,0,2,0,0,0,7,0,0
50841,175,7644,139,89,101,2,0,35,141,7,54,34,62,61,96,330,569,4,2287,127,0,2,6,3,0
50842,175,7644,7,5,5,0,0,2,7,1,2,1,2,3,3,2,4,0,2,0,0,2,6,3,0
50843,139,5919,1782,648,1425,9,47,279,1791,8,171,97,189,179,286,1292,2140,4,9462,525,0,2,3,0,0
50844,111,4178,1450,624,1228,12,26,181,1462,14,306,186,354,320,540,2580,4493,8,36391,2021,1,2,6,7,0
50845,39,2321,652,304,544,16,6,88,668,6,89,51,101,95,152,591,998,3,3399,188,0,2,1,3,0
50846,14,725,442,244,305,14,16,103,456,11,68,45,75,79,120,452,756,6,4588,254,0,2,4,28,0
50847,79,1593,757,253,292,73,244,162,830,13,61,38,67,74,105,409,651,7,4654,258,0,2,1,1,0
50848,10,382,42,7,35,4,0,5,46,1,2,1,2,3,3,2,4,0,2,0,0,2,1,1,0
50849,10,382,11,6,10,0,0,1,11,2,4,2,4,6,6,10,15,1,15,0,0,2,1,1,0
50853,11,413,42,7,35,4,0,5,46,1,2,1,2,3,3,2,4,0,2,0,0,2,1,1,0
50854,11,413,11,6,10,0,0,1,11,2,4,2,4,6,6,10,15,1,15,0,0,2,1,1,0
50857,51,608,647,139,84,35,284,233,682,0,0,0,0,0,0,0,0,0,0,0,0,2,13,2,0
50858,60,4055,520,294,400,33,13,81,553,10,261,204,367,271,571,2128,4614,7,32445,1802,1,2,42,15,0
50859,62,4177,520,294,400,33,13,81,553,10,261,204,367,271,571,2128,4614,7,32445,1802,1,2,14,0,0
50863,51,608,647,139,84,35,284,233,682,0,0,0,0,0,0,0,0,0,0,0,0,2,9,2,1
50864,33,1892,384,251,317,7,8,52,391,11,70,44,84,81,128,467,811,6,5355,297,0,2,1,0,1
50866,51,604,647,139,84,35,284,233,682,0,0,0,0,0,0,0,0,0,0,0,0,2,3,7,0
50870,51,604,647,139,84,35,284,233,682,0,0,0,0,0,0,0,0,0,0,0,0,2,16,2,0
50871,33,1892,384,251,317,7,8,52,391,11,70,44,84,81,128,467,811,6,5355,297,0,2,1,0,0
50873,62,4177,520,294,400,33,13,81,553,10,261,204,367,271,571,2128,4614,7,32445,1802,1,2,62,0,0
50878,81,1607,757,253,292,73,244,162,830,13,61,38,67,74,105,409,651,7,4654,258,0,2,9,5,0
50879,63,4221,520,294,400,33,13,81,553,10,261,204,367,271,571,2128,4614,7,32445,1802,1,2,12,10,0
50880,81,1608,757,253,292,73,244,162,830,13,61,38,67,74,105,409,651,7,4654,258,0,2,9,5,0
50881,92,1762,757,253,292,73,244,162,830,13,61,38,67,74,105,409,651,7,4654,258,0,2,49,19,0
50882,64,4282,520,294,400,33,13,81,553,10,261,204,367,271,571,2128,4614,7,32445,1802,1,2,7,0,0
50883,92,1762,757,253,292,73,244,162,830,13,61,38,67,74,105,409,651,7,4654,258,0,2,34,22,0
50884,64,4283,520,294,400,33,13,81,553,10,261,204,367,271,571,2128,4614,7,32445,1802,1,2,10,7,0
50885,92,1758,757,253,292,73,244,162,830,13,61,38,67,74,105,409,651,7,4654,258,0,2,0,2,0
50886,2,36,127,75,83,2,11,30,129,4,14,7,14,18,21,61,87,2,175,9,0,0,10,0,0
50887,2,36,652,304,544,16,6,88,668,6,89,51,101,95,152,591,998,3,3399,188,0,0,10,0,0
50888,2,36,2,2,2,0,0,0,2,0,0,0,0,0,0,0,0,0,0,0,0,0,10,0,0
50889,2,36,8,5,5,0,0,3,8,0,0,0,0,0,0,0,0,0,0,0,0,0,10,0,0
50892,2,36,14,8,8,0,0,6,14,0,0,0,0,0,0,0,0,0,0,0,0,0,10,0,0
50893,2,36,6,4,4,0,0,2,6,0,0,0,0,0,0,0,0,0,0,0,0,0,10,0,0
50894,2,36,6,4,4,0,0,2,6,1,2,1,2,3,3,2,4,0,2,0,0,0,10,0,0
50896,2,36,7,5,5,0,0,2,7,0,0,0,0,0,0,0,0,0,0,0,0,0,10,0,0
50898,2,36,10,6,6,0,0,4,10,0,0,0,0,0,0,0,0,0,0,0,0,0,10,0,0
50899,2,36,1,1,1,0,0,0,1,0,0,0,0,0,0,0,0,0,0,0,0,0,10,0,0
50901,2,36,14,10,10,0,0,4,14,1,1,1,1,2,2,0,2,0,1,0,0,0,10,0,0
50902,2,36,46,26,30,3,0,12,49,3,6,3,6,9,9,20,28,1,42,2,0,0,10,0,0
50930,176,7674,139,89,101,2,0,35,141,7,54,34,62,61,96,330,569,4,2287,127,0,2,5,0,0
50931,176,7674,7,5,5,0,0,2,7,1,2,1,2,3,3,2,4,0,2,0,0,2,5,0,0
50932,141,3259,77,34,69,0,0,8,77,3,24,16,29,27,45,114,213,1,387,21,0,2,3,1,1
50933,141,3259,712,438,573,51,9,84,763,14,102,71,128,116,199,733,1364,8,11988,666,0,2,3,1,1
50935,92,1761,757,253,292,73,244,162,830,13,61,38,67,74,105,409,651,7,4654,258,0,2,3,1,0
50936,92,1761,757,253,292,73,244,162,830,13,61,38,67,74,105,409,651,7,4654,258,0,2,2,2,0
50937,75,1704,996,429,845,24,10,117,1020,7,76,50,88,83,138,494,879,4,3565,198,0,2,9,2,0
50938,75,1704,456,277,329,12,42,72,468,13,85,50,97,98,147,592,972,7,7212,400,0,2,9,2,0
50939,40,3026,996,429,845,24,10,117,1020,7,76,50,88,83,138,494,879,4,3565,198,0,2,26,0,0
50940,11,413,42,7,35,4,0,5,46,1,2,1,2,3,3,2,4,0,2,0,0,2,3,3,0
50941,11,413,11,6,10,0,0,1,11,2,4,2,4,6,6,10,15,1,15,0,0,2,3,3,0
50942,93,1841,757,253,292,73,244,162,830,13,61,38,67,74,105,409,651,7,4654,258,0,2,21,20,0
50943,63,4272,520,294,400,33,13,81,553,10,261,204,367,271,571,2128,4614,7,32445,1802,1,2,14,15,0
50944,93,1841,757,253,292,73,244,162,830,13,61,38,67,74,105,409,651,7,4654,258,0,2,2,2,0
50948,91,1827,757,253,292,73,244,162,830,13,61,38,67,74,105,409,651,7,4654,258,0,2,4,10,0
50949,91,1827,757,253,292,73,244,162,830,13,61,38,67,74,105,409,651,7,4654,258,0,2,7,7,0
50950,63,4320,520,294,400,33,13,81,553,10,261,204,367,271,571,2128,4614,7,32445,1802,1,2,9,1,0
50951,79,1593,757,253,292,73,244,162,830,13,61,38,67,74,105,409,651,7,4654,258,0,2,1,1,1
50954,91,1827,757,253,292,73,244,162,830,13,61,38,67,74,105,409,651,7,4654,258,0,2,3,3,0
50955,79,1596,757,253,292,73,244,162,830,13,61,38,67,74,105,409,651,7,4654,258,0,2,3,1,0
50956,63,1255,207,111,150,11,0,50,218,5,26,19,36,31,55,133,272,3,943,52,0,2,15,0,1
50957,63,1255,410,198,237,31,55,97,441,11,63,38,72,74,110,414,683,6,4293,238,0,2,15,0,1
50958,254,5825,4293,999,3693,19,54,507,4312,9,155,88,170,164,258,1156,1898,4,9368,520,0,2,13,14,1
50959,254,5825,1482,859,1002,125,135,219,1607,16,219,134,251,235,385,1766,3032,9,27804,1544,1,2,13,14,1
50960,17,774,75,38,59,1,3,12,76,2,4,2,4,6,6,10,15,1,15,0,0,2,0,1,1
50961,175,7644,139,89,101,2,0,35,141,7,54,34,62,61,96,330,569,4,2287,127,0,2,3,4,1
50962,175,7644,7,5,5,0,0,2,7,1,2,1,2,3,3,2,4,0,2,0,0,2,3,4,1
50963,164,5055,1660,832,1314,41,38,274,1701,20,312,209,395,332,604,2671,5058,12,64042,3557,1,2,12,14,1
50964,164,5055,1057,646,719,113,100,145,1170,18,215,134,248,233,382,1740,3004,10,31186,1732,1,2,12,14,1
50965,155,4396,1660,832,1314,41,38,274,1701,20,312,209,395,332,604,2671,5058,12,64042,3557,1,2,9,0,1
50966,91,1827,757,253,292,73,244,162,830,13,61,38,67,74,105,409,651,7,4654,258,0,2,86,41,0
50967,63,4320,520,294,400,33,13,81,553,10,261,204,367,271,571,2128,4614,7,32445,1802,1,2,29,10,0
50968,91,1830,757,253,292,73,244,162,830,13,61,38,67,74,105,409,651,7,4654,258,0,2,3,1,0
50969,63,1255,207,111,150,11,0,50,218,5,26,19,36,31,55,133,272,3,943,52,0,2,15,0,0
50970,63,1255,410,198,237,31,55,97,441,11,63,38,72,74,110,414,683,6,4293,238,0,2,15,0,0
50971,254,5825,4293,999,3693,19,54,507,4312,9,155,88,170,164,258,1156,1898,4,9368,520,0,2,13,14,0
50972,254,5825,1482,859,1002,125,135,219,1607,16,219,134,251,235,385,1766,3032,9,27804,1544,1,2,13,14,0
50973,17,774,75,38,59,1,3,12,76,2,4,2,4,6,6,10,15,1,15,0,0,2,0,1,0
50974,175,7644,139,89,101,2,0,35,141,7,54,34,62,61,96,330,569,4,2287,127,0,2,3,4,0
50975,175,7644,7,5,5,0,0,2,7,1,2,1,2,3,3,2,4,0,2,0,0,2,3,4,0
50976,164,5055,1660,832,1314,41,38,274,1701,20,312,209,395,332,604,2671,5058,12,64042,3557,1,2,12,14,0
50977,164,5055,1057,646,719,113,100,145,1170,18,215,134,248,233,382,1740,3004,10,31186,1732,1,2,12,14,0
50978,155,4396,1660,832,1314,41,38,274,1701,20,312,209,395,332,604,2671,5058,12,64042,3557,1,2,9,0,0
50979,141,3259,77,34,69,0,0,8,77,3,24,16,29,27,45,114,213,1,387,21,0,2,3,1,0
50980,141,3259,712,438,573,51,9,84,763,14,102,71,128,116,199,733,1364,8,11988,666,0,2,3,1,0
51027,73,3803,1296,573,1062,40,33,157,1336,8,201,118,231,209,349,1561,2689,4,12365,686,0,2,1,1,0
51028,1,8,127,75,83,2,11,30,129,4,14,7,14,18,21,61,87,2,175,9,0,0,2,0,0
51029,1,8,652,304,544,16,6,88,668,6,89,51,101,95,152,591,998,3,3399,188,0,0,2,0,0
51030,1,8,2,2,2,0,0,0,2,0,0,0,0,0,0,0,0,0,0,0,0,0,2,0,0
51031,1,8,8,5,5,0,0,3,8,0,0,0,0,0,0,0,0,0,0,0,0,0,2,0,0
51034,1,8,14,8,8,0,0,6,14,0,0,0,0,0,0,0,0,0,0,0,0,0,2,0,0
51035,1,8,6,4,4,0,0,2,6,0,0,0,0,0,0,0,0,0,0,0,0,0,2,0,0
51036,1,8,6,4,4,0,0,2,6,1,2,1,2,3,3,2,4,0,2,0,0,0,2,0,0
51038,1,8,7,5,5,0,0,2,7,0,0,0,0,0,0,0,0,0,0,0,0,0,2,0,0
51040,1,8,10,6,6,0,0,4,10,0,0,0,0,0,0,0,0,0,0,0,0,0,2,0,0
51041,1,8,1,1,1,0,0,0,1,0,0,0,0,0,0,0,0,0,0,0,0,0,2,0,0
51043,1,8,14,10,10,0,0,4,14,1,1,1,1,2,2,0,2,0,1,0,0,0,2,0,0
51044,1,8,46,26,30,3,0,12,49,3,6,3,6,9,9,20,28,1,42,2,0,0,2,0,0
51069,99,4460,1338,495,1086,10,64,173,1348,11,122,82,157,133,239,883,1686,7,11934,663,0,2,6,0,0
51070,314,6831,72,33,56,0,4,12,72,1,1,1,1,2,2,0,2,0,1,0,0,2,6,3,1
51071,314,6831,1454,835,1044,76,110,219,1530,17,275,158,296,292,454,2297,3718,9,34017,1889,1,2,6,3,1
51072,64,1275,207,111,150,11,0,50,218,5,26,19,36,31,55,133,272,3,943,52,0,2,7,0,1
51073,64,1275,410,198,237,31,55,97,441,11,63,38,72,74,110,414,683,6,4293,238,0,2,7,0,1
51074,254,5830,4293,999,3693,19,54,507,4312,9,155,88,170,164,258,1156,1898,4,9368,520,0,2,4,3,1
51075,254,5830,1482,859,1002,125,135,219,1607,16,219,134,251,235,385,1766,3032,9,27804,1544,1,2,4,3,1
51076,93,3899,1289,550,1043,56,32,155,1345,10,167,93,185,177,278,1266,2075,5,11498,638,0,2,7,0,1
51077,2,56,16,12,9,0,0,6,16,1,2,1,2,3,3,2,4,0,2,0,0,0,17,0,1
51078,20,439,207,111,150,11,0,50,218,5,26,19,36,31,55,133,272,3,943,52,0,2,32,0,1
51081,212,4563,2,2,2,0,0,0,2,0,0,0,0,0,0,0,0,0,0,0,0,2,5,0,1
51095,212,4563,99,48,90,1,3,5,100,0,0,0,0,0,0,0,0,0,0,0,0,2,5,0,1
51096,212,4563,8,5,5,2,0,1,10,0,0,0,0,0,0,0,0,0,0,0,0,2,5,0,1
51097,212,4563,1217,716,841,84,126,174,1301,14,185,118,215,199,333,1446,2542,8,20687,1149,0,2,5,0,1
51098,212,4563,160,89,115,0,13,31,160,7,15,11,17,22,28,78,124,3,495,27,0,2,5,0,1
51099,212,4563,10,10,9,9,0,0,19,0,0,0,0,0,0,0,0,0,0,0,0,2,5,0,1
51100,212,4563,173,84,99,8,29,36,181,5,12,7,13,17,20,54,81,2,221,12,0,2,5,0,1
51101,212,4563,3,1,1,3,0,0,6,0,0,0,0,0,0,0,0,0,0,0,0,2,5,0,1
51123,86,4507,1457,730,1242,11,6,188,1468,10,292,166,329,302,495,2424,4078,5,22973,1276,1,2,18,0,1
51126,212,4563,2,2,2,0,0,0,2,0,0,0,0,0,0,0,0,0,0,0,0,2,5,0,0
51140,212,4563,99,48,90,1,3,5,100,0,0,0,0,0,0,0,0,0,0,0,0,2,5,0,0
51141,212,4563,8,5,5,2,0,1,10,0,0,0,0,0,0,0,0,0,0,0,0,2,5,0,0
51142,212,4563,1217,716,841,84,126,174,1301,14,185,118,215,199,333,1446,2542,8,20687,1149,0,2,5,0,0
51143,212,4563,160,89,115,0,13,31,160,7,15,11,17,22,28,78,124,3,495,27,0,2,5,0,0
51144,212,4563,10,10,9,9,0,0,19,0,0,0,0,0,0,0,0,0,0,0,0,2,5,0,0
51145,212,4563,173,84,99,8,29,36,181,5,12,7,13,17,20,54,81,2,221,12,0,2,5,0,0
51146,212,4563,3,1,1,3,0,0,6,0,0,0,0,0,0,0,0,0,0,0,0,2,5,0,0
51168,86,4507,1457,730,1242,11,6,188,1468,10,292,166,329,302,495,2424,4078,5,22973,1276,1,2,18,0,0
51169,314,6831,72,33,56,0,4,12,72,1,1,1,1,2,2,0,2,0,1,0,0,2,6,3,0
51170,314,6831,1454,835,1044,76,110,219,1530,17,275,158,296,292,454,2297,3718,9,34017,1889,1,2,6,3,0
51215,213,4573,2,2,2,0,0,0,2,0,0,0,0,0,0,0,0,0,0,0,0,2,8,1,1
51229,213,4573,99,48,90,1,3,5,100,0,0,0,0,0,0,0,0,0,0,0,0,2,8,1,1
51230,213,4573,8,5,5,2,0,1,10,0,0,0,0,0,0,0,0,0,0,0,0,2,8,1,1
51231,213,4573,1217,716,841,84,126,174,1301,14,185,118,215,199,333,1446,2542,8,20687,1149,0,2,8,1,1
51232,213,4573,160,89,115,0,13,31,160,7,15,11,17,22,28,78,124,3,495,27,0,2,8,1,1
51233,213,4573,10,10,9,9,0,0,19,0,0,0,0,0,0,0,0,0,0,0,0,2,8,1,1
51234,213,4573,173,84,99,8,29,36,181,5,12,7,13,17,20,54,81,2,221,12,0,2,8,1,1
51235,213,4573,3,1,1,3,0,0,6,0,0,0,0,0,0,0,0,0,0,0,0,2,8,1,1
51236,27,965,74,35,59,1,0,14,75,3,14,7,14,17,21,58,85,1,128,7,0,2,1,0,1
51237,27,965,245,125,200,5,7,34,250,7,30,17,34,37,51,166,265,3,1053,58,0,2,1,0,1
51238,86,4564,1457,730,1242,11,6,188,1468,10,292,166,329,302,495,2424,4078,5,22973,1276,1,2,20,0,1
51239,62,1229,1098,241,925,5,10,155,1103,7,46,25,49,53,74,273,423,3,1580,87,0,2,1,0,0
51240,62,1229,282,202,222,14,2,44,296,8,42,24,43,50,67,250,378,4,1548,86,0,2,1,0,0
51241,50,1879,1098,241,925,5,10,155,1103,7,46,25,49,53,74,273,423,3,1580,87,0,2,21,0,0
51242,50,1879,1098,241,925,5,10,155,1103,7,46,25,49,53,74,273,423,3,1580,87,0,2,1,1,0
51245,213,4573,2,2,2,0,0,0,2,0,0,0,0,0,0,0,0,0,0,0,0,2,8,1,0
51259,213,4573,99,48,90,1,3,5,100,0,0,0,0,0,0,0,0,0,0,0,0,2,8,1,0
51260,213,4573,8,5,5,2,0,1,10,0,0,0,0,0,0,0,0,0,0,0,0,2,8,1,0
51261,213,4573,1217,716,841,84,126,174,1301,14,185,118,215,199,333,1446,2542,8,20687,1149,0,2,8,1,0
51262,213,4573,160,89,115,0,13,31,160,7,15,11,17,22,28,78,124,3,495,27,0,2,8,1,0
51263,213,4573,10,10,9,9,0,0,19,0,0,0,0,0,0,0,0,0,0,0,0,2,8,1,0
51264,213,4573,173,84,99,8,29,36,181,5,12,7,13,17,20,54,81,2,221,12,0,2,8,1,0
51265,213,4573,3,1,1,3,0,0,6,0,0,0,0,0,0,0,0,0,0,0,0,2,8,1,0
51266,27,965,74,35,59,1,0,14,75,3,14,7,14,17,21,58,85,1,128,7,0,2,1,0,0
51267,27,965,245,125,200,5,7,34,250,7,30,17,34,37,51,166,265,3,1053,58,0,2,1,0,0
51268,86,4564,1457,730,1242,11,6,188,1468,10,292,166,329,302,495,2424,4078,5,22973,1276,1,2,20,0,0
51272,65,1299,207,111,150,11,0,50,218,5,26,19,36,31,55,133,272,3,943,52,0,2,14,2,0
51273,65,1299,410,198,237,31,55,97,441,11,63,38,72,74,110,414,683,6,4293,238,0,2,14,2,0
51274,254,5835,4293,999,3693,19,54,507,4312,9,155,88,170,164,258,1156,1898,4,9368,520,0,2,2,1,0
51275,254,5835,1482,859,1002,125,135,219,1607,16,219,134,251,235,385,1766,3032,9,27804,1544,1,2,2,1,0
51276,19,437,207,111,150,11,0,50,218,5,26,19,36,31,55,133,272,3,943,52,0,2,2,4,0
51277,65,1299,207,111,150,11,0,50,218,5,26,19,36,31,55,133,272,3,943,52,0,2,19,0,0
51278,65,1299,410,198,237,31,55,97,441,11,63,38,72,74,110,414,683,6,4293,238,0,2,19,0,0
51279,254,5835,4293,999,3693,19,54,507,4312,9,155,88,170,164,258,1156,1898,4,9368,520,0,2,5,3,0
51280,254,5835,1482,859,1002,125,135,219,1607,16,219,134,251,235,385,1766,3032,9,27804,1544,1,2,5,3,0
51281,93,3899,1289,550,1043,56,32,155,1345,10,167,93,185,177,278,1266,2075,5,11498,638,0,2,7,0,0
51282,2,56,16,12,9,0,0,6,16,1,2,1,2,3,3,2,4,0,2,0,0,0,17,0,0
51283,19,437,207,111,150,11,0,50,218,5,26,19,36,31,55,133,272,3,943,52,0,2,31,1,0
51284,314,6843,72,33,56,0,4,12,72,1,1,1,1,2,2,0,2,0,1,0,0,2,1,0,0
51285,314,6843,1454,835,1044,76,110,219,1530,17,275,158,296,292,454,2297,3718,9,34017,1889,1,2,1,0,0
51286,141,3263,77,34,69,0,0,8,77,3,24,16,29,27,45,114,213,1,387,21,0,2,3,2,0
51287,141,3263,712,438,573,51,9,84,763,14,102,71,128,116,199,733,1364,8,11988,666,0,2,3,2,0
51288,73,3805,1296,573,1062,40,33,157,1336,8,201,118,231,209,349,1561,2689,4,12365,686,0,2,1,1,0
51289,94,1909,463,295,324,28,62,57,491,12,134,82,154,146,236,989,1696,6,11700,650,0,2,7,7,0
51290,309,6791,72,33,56,0,4,12,72,1,1,1,1,2,2,0,2,0,1,0,0,2,10,15,1
51291,309,6791,1454,835,1044,76,110,219,1530,17,275,158,296,292,454,2297,3718,9,34017,1889,1,2,10,15,1
51292,73,3806,1296,573,1062,40,33,157,1336,8,201,118,231,209,349,1561,2689,4,12365,686,0,2,4,0,0
51293,73,3830,1296,573,1062,40,33,157,1336,8,201,118,231,209,349,1561,2689,4,12365,686,0,2,7,4,0
51294,100,4602,1338,495,1086,10,64,173,1348,11,122,82,157,133,239,883,1686,7,11934,663,0,2,40,0,0
51295,314,6831,72,33,56,0,4,12,72,1,1,1,1,2,2,0,2,0,1,0,0,2,2,1,0
51296,314,6831,1454,835,1044,76,110,219,1530,17,275,158,296,292,454,2297,3718,9,34017,1889,1,2,2,1,0
51300,23,474,601,196,481,2,23,85,603,8,63,36,72,71,108,400,664,4,3036,168,0,2,8,0,1
51301,23,474,156,79,106,5,16,28,161,5,14,8,15,19,23,64,97,2,261,14,0,2,8,0,1
51302,20,707,601,196,481,2,23,85,603,8,63,36,72,71,108,400,664,4,3036,168,0,2,15,0,1
51303,20,707,601,196,481,2,23,85,603,8,63,36,72,71,108,400,664,4,3036,168,0,2,2,2,0
51304,23,474,601,196,481,2,23,85,603,8,63,36,72,71,108,400,664,4,3036,168,0,2,8,0,0
51305,23,474,156,79,106,5,16,28,161,5,14,8,15,19,23,64,97,2,261,14,0,2,8,0,0
51306,20,707,601,196,481,2,23,85,603,8,63,36,72,71,108,400,664,4,3036,168,0,2,15,0,0
51307,309,6791,72,33,56,0,4,12,72,1,1,1,1,2,2,0,2,0,1,0,0,2,10,15,0
51308,309,6791,1454,835,1044,76,110,219,1530,17,275,158,296,292,454,2297,3718,9,34017,1889,1,2,10,15,0
51310,215,4676,182,127,129,0,0,53,182,5,39,21,42,44,63,217,343,2,926,51,0,2,3,1,1
51311,215,4676,1165,710,800,67,119,181,1232,18,243,153,282,261,435,2000,3492,10,36473,2026,1,2,3,1,1
51312,152,7085,1392,870,1177,35,17,170,1427,14,494,280,531,508,811,4473,7289,7,54850,3047,2,2,45,0,1
51315,73,3830,1296,573,1062,40,33,157,1336,8,201,118,231,209,349,1561,2689,4,12365,686,0,2,9,2,0
51316,215,4676,182,127,129,0,0,53,182,5,39,21,42,44,63,217,343,2,926,51,0,2,3,1,0
51317,215,4676,1165,710,800,67,119,181,1232,18,243,153,282,261,435,2000,3492,10,36473,2026,1,2,3,1,0
51318,152,7085,1392,870,1177,35,17,170,1427,14,494,280,531,508,811,4473,7289,7,54850,3047,2,2,45,0,0
51319,126,5153,1513,682,1277,25,13,200,1538,11,199,116,219,210,335,1557,2584,6,15641,868,0,2,28,0,1
51320,149,3076,1513,682,1277,25,13,200,1538,11,199,116,219,210,335,1557,2584,6,15641,868,0,2,14,2,1
51321,149,3076,819,519,539,24,98,155,843,15,96,57,106,111,163,690,1107,8,9171,509,0,2,14,2,1
51322,88,2266,773,422,505,30,103,129,803,14,77,46,83,91,129,535,839,7,6334,351,0,2,2,0,1
51323,34,2119,1157,318,931,29,22,177,1186,6,104,63,125,110,188,712,1274,3,4596,255,0,2,8,0,0
51324,126,5153,1513,682,1277,25,13,200,1538,11,199,116,219,210,335,1557,2584,6,15641,868,0,2,3,0,0
51325,149,3116,1513,682,1277,25,13,200,1538,11,199,116,219,210,335,1557,2584,6,15641,868,0,2,21,10,1
51326,149,3116,819,519,539,24,98,155,843,15,96,57,106,111,163,690,1107,8,9171,509,0,2,21,10,1
51327,86,2245,773,422,505,30,103,129,803,14,77,46,83,91,129,535,839,7,6334,351,0,2,5,7,1
51328,31,2079,1157,318,931,29,22,177,1186,6,104,63,125,110,188,712,1274,3,4596,255,0,2,7,17,1
51329,254,5829,4293,999,3693,19,54,507,4312,9,155,88,170,164,258,1156,1898,4,9368,520,0,2,2,2,1
51330,254,5829,1482,859,1002,125,135,219,1607,16,219,134,251,235,385,1766,3032,9,27804,1544,1,2,2,2,1
51331,149,3083,1513,682,1277,25,13,200,1538,11,199,116,219,210,335,1557,2584,6,15641,868,0,2,17,17,1
51332,149,3083,819,519,539,24,98,155,843,15,96,57,106,111,163,690,1107,8,9171,509,0,2,17,17,1
51333,150,3111,1513,682,1277,25,13,200,1538,11,199,116,219,210,335,1557,2584,6,15641,868,0,2,8,7,1
51334,150,3111,819,519,539,24,98,155,843,15,96,57,106,111,163,690,1107,8,9171,509,0,2,8,7,1
51335,86,2238,773,422,505,30,103,129,803,14,77,46,83,91,129,535,839,7,6334,351,0,2,1,5,1
51336,150,3111,1513,682,1277,25,13,200,1538,11,199,116,219,210,335,1557,2584,6,15641,868,0,2,1,1,1
51337,150,3111,819,519,539,24,98,155,843,15,96,57,106,111,163,690,1107,8,9171,509,0,2,1,1,1
51338,86,2240,773,422,505,30,103,129,803,14,77,46,83,91,129,535,839,7,6334,351,0,2,5,1,1
51339,150,3126,1513,682,1277,25,13,200,1538,11,199,116,219,210,335,1557,2584,6,15641,868,0,2,3,0,1
51340,150,3126,819,519,539,24,98,155,843,15,96,57,106,111,163,690,1107,8,9171,509,0,2,3,0,1
51341,149,3115,1513,682,1277,25,13,200,1538,11,199,116,219,210,335,1557,2584,6,15641,868,0,2,2,7,1
51342,149,3115,819,519,539,24,98,155,843,15,96,57,106,111,163,690,1107,8,9171,509,0,2,2,7,1
51343,66,1312,207,111,150,11,0,50,218,5,26,19,36,31,55,133,272,3,943,52,0,2,8,0,1
51344,66,1312,410,198,237,31,55,97,441,11,63,38,72,74,110,414,683,6,4293,238,0,2,8,0,1
51345,85,2238,773,422,505,30,103,129,803,14,77,46,83,91,129,535,839,7,6334,351,0,2,3,7,1
51346,149,3116,1513,682,1277,25,13,200,1538,11,199,116,219,210,335,1557,2584,6,15641,868,0,2,7,6,1
51347,149,3116,819,519,539,24,98,155,843,15,96,57,106,111,163,690,1107,8,9171,509,0,2,7,6,1
51348,85,2238,773,422,505,30,103,129,803,14,77,46,83,91,129,535,839,7,6334,351,0,2,1,1,1
51349,31,2079,1157,318,931,29,22,177,1186,6,104,63,125,110,188,712,1274,3,4596,255,0,2,1,1,1
51350,254,5829,4293,999,3693,19,54,507,4312,9,155,88,170,164,258,1156,1898,4,9368,520,0,2,2,2,0
51351,254,5829,1482,859,1002,125,135,219,1607,16,219,134,251,235,385,1766,3032,9,27804,1544,1,2,2,2,0
51352,149,3116,1513,682,1277,25,13,200,1538,11,199,116,219,210,335,1557,2584,6,15641,868,0,2,30,7,0
51353,149,3116,819,519,539,24,98,155,843,15,96,57,106,111,163,690,1107,8,9171,509,0,2,30,7,0
51354,66,1312,207,111,150,11,0,50,218,5,26,19,36,31,55,133,272,3,943,52,0,2,8,0,0
51355,66,1312,410,198,237,31,55,97,441,11,63,38,72,74,110,414,683,6,4293,238,0,2,8,0,0
51356,85,2238,773,422,505,30,103,129,803,14,77,46,83,91,129,535,839,7,6334,351,0,2,8,12,0
51357,31,2079,1157,318,931,29,22,177,1186,6,104,63,125,110,188,712,1274,3,4596,255,0,2,7,9,0
51358,126,5153,1513,682,1277,25,13,200,1538,11,199,116,219,210,335,1557,2584,6,15641,868,0,2,31,0,0
51359,149,3110,1513,682,1277,25,13,200,1538,11,199,116,219,210,335,1557,2584,6,15641,868,0,2,0,1,0
51360,149,3110,819,519,539,24,98,155,843,15,96,57,106,111,163,690,1107,8,9171,509,0,2,0,1,0
51361,127,5180,1513,682,1277,25,13,200,1538,11,199,116,219,210,335,1557,2584,6,15641,868,0,2,20,0,0
51362,149,3215,1513,682,1277,25,13,200,1538,11,199,116,219,210,335,1557,2584,6,15641,868,0,2,28,8,1
51363,149,3215,819,519,539,24,98,155,843,15,96,57,106,111,163,690,1107,8,9171,509,0,2,28,8,1
51364,127,5207,1513,682,1277,25,13,200,1538,11,199,116,219,210,335,1557,2584,6,15641,868,0,2,28,20,1
51369,66,1312,207,111,150,11,0,50,218,5,26,19,36,31,55,133,272,3,943,52,0,2,27,0,0
51370,66,1312,410,198,237,31,55,97,441,11,63,38,72,74,110,414,683,6,4293,238,0,2,27,0,0
51373,214,4585,2,2,2,0,0,0,2,0,0,0,0,0,0,0,0,0,0,0,0,2,5,0,0
51387,214,4585,99,48,90,1,3,5,100,0,0,0,0,0,0,0,0,0,0,0,0,2,5,0,0
51388,214,4585,8,5,5,2,0,1,10,0,0,0,0,0,0,0,0,0,0,0,0,2,5,0,0
51389,214,4585,1217,716,841,84,126,174,1301,14,185,118,215,199,333,1446,2542,8,20687,1149,0,2,5,0,0
51390,214,4585,160,89,115,0,13,31,160,7,15,11,17,22,28,78,124,3,495,27,0,2,5,0,0
51391,214,4585,10,10,9,9,0,0,19,0,0,0,0,0,0,0,0,0,0,0,0,2,5,0,0
51392,214,4585,173,84,99,8,29,36,181,5,12,7,13,17,20,54,81,2,221,12,0,2,5,0,0
51393,214,4585,3,1,1,3,0,0,6,0,0,0,0,0,0,0,0,0,0,0,0,2,5,0,0
51395,254,5829,4293,999,3693,19,54,507,4312,9,155,88,170,164,258,1156,1898,4,9368,520,0,2,7,5,0
51396,254,5829,1482,859,1002,125,135,219,1607,16,219,134,251,235,385,1766,3032,9,27804,1544,1,2,7,5,0
51400,309,6791,72,33,56,0,4,12,72,1,1,1,1,2,2,0,2,0,1,0,0,2,18,19,0
51401,309,6791,1454,835,1044,76,110,219,1530,17,275,158,296,292,454,2297,3718,9,34017,1889,1,2,18,19,0
51472,100,4602,1338,495,1086,10,64,173,1348,11,122,82,157,133,239,883,1686,7,11934,663,0,2,46,0,0
51476,88,4633,1457,730,1242,11,6,188,1468,10,292,166,329,302,495,2424,4078,5,22973,1276,1,2,18,0,0
51593,155,3182,1513,682,1277,25,13,200,1538,11,199,116,219,210,335,1557,2584,6,15641,868,0,2,77,58,1
51594,155,3182,819,519,539,24,98,155,843,15,96,57,106,111,163,690,1107,8,9171,509,0,2,77,58,1
51595,126,5159,1513,682,1277,25,13,200,1538,11,199,116,219,210,335,1557,2584,6,15641,868,0,2,33,4,0
51596,126,5221,1513,682,1277,25,13,200,1538,11,199,116,219,210,335,1557,2584,6,15641,868,0,2,24,14,0
51597,154,3165,1513,682,1277,25,13,200,1538,11,199,116,219,210,335,1557,2584,6,15641,868,0,2,4,6,0
51598,154,3165,819,519,539,24,98,155,843,15,96,57,106,111,163,690,1107,8,9171,509,0,2,4,6,0
51599,34,1000,339,213,244,17,9,65,356,10,42,26,48,52,74,259,421,5,2410,133,0,2,2,1,0
51600,20,416,294,64,250,0,0,43,294,1,20,10,20,21,30,86,131,0,65,3,0,2,2,1,0
51601,20,416,78,46,62,3,0,14,81,3,8,4,8,11,12,28,41,1,62,3,0,2,2,1,0
51602,31,2071,1157,318,931,29,22,177,1186,6,104,63,125,110,188,712,1274,3,4596,255,0,2,0,4,0
51603,126,5241,1513,682,1277,25,13,200,1538,11,199,116,219,210,335,1557,2584,6,15641,868,0,2,8,4,0
51604,154,3163,1513,682,1277,25,13,200,1538,11,199,116,219,210,335,1557,2584,6,15641,868,0,2,1,2,0
51605,154,3163,819,519,539,24,98,155,843,15,96,57,106,111,163,690,1107,8,9171,509,0,2,1,2,0
51606,31,2065,1157,318,931,29,22,177,1186,6,104,63,125,110,188,712,1274,3,4596,255,0,2,0,1,0
51607,126,5241,1513,682,1277,25,13,200,1538,11,199,116,219,210,335,1557,2584,6,15641,868,0,2,5,3,0
51608,236,5565,722,423,573,19,0,135,741,12,172,101,199,184,300,1320,2257,6,15668,870,0,2,12,8,0
51609,236,5565,1508,847,911,44,250,301,1552,14,148,88,169,162,257,1120,1886,7,15077,837,0,2,12,8,0
51610,236,5605,722,423,573,19,0,135,741,12,172,101,199,184,300,1320,2257,6,15668,870,0,2,14,4,1
51611,236,5605,1508,847,911,44,250,301,1552,14,148,88,169,162,257,1120,1886,7,15077,837,0,2,14,4,1
51612,49,2332,722,423,573,19,0,135,741,12,172,101,199,184,300,1320,2257,6,15668,870,0,2,51,0,1
51615,127,5289,1513,682,1277,25,13,200,1538,11,199,116,219,210,335,1557,2584,6,15641,868,0,2,36,16,0
51616,154,3163,1513,682,1277,25,13,200,1538,11,199,116,219,210,335,1557,2584,6,15641,868,0,2,4,4,1
51617,154,3163,819,519,539,24,98,155,843,15,96,57,106,111,163,690,1107,8,9171,509,0,2,4,4,1
51618,34,1000,339,213,244,17,9,65,356,10,42,26,48,52,74,259,421,5,2410,133,0,2,1,1,1
51619,20,416,294,64,250,0,0,43,294,1,20,10,20,21,30,86,131,0,65,3,0,2,1,1,1
51620,20,416,78,46,62,3,0,14,81,3,8,4,8,11,12,28,41,1,62,3,0,2,1,1,1
51621,127,5289,1513,682,1277,25,13,200,1538,11,199,116,219,210,335,1557,2584,6,15641,868,0,2,4,4,1
51622,149,3215,1513,682,1277,25,13,200,1538,11,199,116,219,210,335,1557,2584,6,15641,868,0,2,27,8,0
51623,149,3215,819,519,539,24,98,155,843,15,96,57,106,111,163,690,1107,8,9171,509,0,2,27,8,0
51624,127,5207,1513,682,1277,25,13,200,1538,11,199,116,219,210,335,1557,2584,6,15641,868,0,2,28,0,0
51625,212,4578,1943,715,1694,26,18,214,1969,12,185,120,237,197,357,1436,2721,7,20915,1161,0,2,5,0,0
51626,212,4578,1168,838,957,57,25,144,1225,19,348,224,416,367,640,3018,5452,11,61921,3440,1,2,5,0,0
51627,92,4733,1943,715,1694,26,18,214,1969,12,185,120,237,197,357,1436,2721,7,20915,1161,0,2,40,0,0
51628,236,5605,722,423,573,19,0,135,741,12,172,101,199,184,300,1320,2257,6,15668,870,0,2,14,4,0
51629,236,5605,1508,847,911,44,250,301,1552,14,148,88,169,162,257,1120,1886,7,15077,837,0,2,14,4,0
51630,49,2332,722,423,573,19,0,135,741,12,172,101,199,184,300,1320,2257,6,15668,870,0,2,51,0,0
51631,154,3262,1513,682,1277,25,13,200,1538,11,199,116,219,210,335,1557,2584,6,15641,868,0,2,73,57,0
51632,154,3262,819,519,539,24,98,155,843,15,96,57,106,111,163,690,1107,8,9171,509,0,2,73,57,0
51636,31,2065,1157,318,931,29,22,177,1186,6,104,63,125,110,188,712,1274,3,4596,255,0,2,0,5,0
51637,128,5343,1513,682,1277,25,13,200,1538,11,199,116,219,210,335,1557,2584,6,15641,868,0,2,77,12,0
51638,141,3269,77,34,69,0,0,8,77,3,24,16,29,27,45,114,213,1,387,21,0,2,4,3,0
51639,141,3269,712,438,573,51,9,84,763,14,102,71,128,116,199,733,1364,8,11988,666,0,2,4,3,0
51640,94,3940,1289,550,1043,56,32,155,1345,10,167,93,185,177,278,1266,2075,5,11498,638,0,2,10,0,0
51644,235,5544,722,423,573,19,0,135,741,12,172,101,199,184,300,1320,2257,6,15668,870,0,2,12,14,0
51645,235,5544,1508,847,911,44,250,301,1552,14,148,88,169,162,257,1120,1886,7,15077,837,0,2,12,14,0
51649,47,2258,722,423,573,19,0,135,741,12,172,101,199,184,300,1320,2257,6,15668,870,0,2,6,1,1
51650,47,2258,722,423,573,19,0,135,741,12,172,101,199,184,300,1320,2257,6,15668,870,0,2,1,1,0
51651,96,1940,463,295,324,28,62,57,491,12,134,82,154,146,236,989,1696,6,11700,650,0,2,5,2,1
51652,2,67,16,12,9,0,0,6,16,1,2,1,2,3,3,2,4,0,2,0,0,2,4,1,0
51670,7,296,72,33,56,0,4,12,72,1,1,1,1,2,2,0,2,0,1,0,0,2,26,23,1
51671,94,3942,1289,550,1043,56,32,155,1345,10,167,93,185,177,278,1266,2075,5,11498,638,0,2,3,3,1
51672,152,7086,1392,870,1177,35,17,170,1427,14,494,280,531,508,811,4473,7289,7,54850,3047,2,2,1,1,1
51673,23,579,102,59,69,5,3,24,107,6,22,15,28,28,43,113,206,3,789,43,0,2,1,1,1
51674,155,4397,1660,832,1314,41,38,274,1701,20,312,209,395,332,604,2671,5058,12,64042,3557,1,2,1,1,1
51675,8,271,74,35,59,1,0,14,75,3,14,7,14,17,21,58,85,1,128,7,0,2,3,1,1
51676,38,2302,334,251,279,10,4,40,344,5,127,74,143,132,217,899,1528,2,4303,239,0,2,1,1,1
51677,61,2733,1293,570,1093,25,15,163,1318,10,195,123,241,205,364,1516,2795,6,17273,959,0,2,4,2,1
51678,92,4735,1943,715,1694,26,18,214,1969,12,185,120,237,197,357,1436,2721,7,20915,1161,0,2,2,2,1
51681,154,3262,1513,682,1277,25,13,200,1538,11,199,116,219,210,335,1557,2584,6,15641,868,0,2,108,50,0
51682,154,3262,819,519,539,24,98,155,843,15,96,57,106,111,163,690,1107,8,9171,509,0,2,108,50,0
51690,141,3269,77,34,69,0,0,8,77,3,24,16,29,27,45,114,213,1,387,21,0,2,7,5,0
51691,141,3269,712,438,573,51,9,84,763,14,102,71,128,116,199,733,1364,8,11988,666,0,2,7,5,0
51694,309,6803,72,33,56,0,4,12,72,1,1,1,1,2,2,0,2,0,1,0,0,2,12,16,0
51695,309,6803,1454,835,1044,76,110,219,1530,17,275,158,296,292,454,2297,3718,9,34017,1889,1,2,12,16,0
51704,31,2065,1157,318,931,29,22,177,1186,6,104,63,125,110,188,712,1274,3,4596,255,0,2,7,14,0
51706,128,5343,1513,682,1277,25,13,200,1538,11,199,116,219,210,335,1557,2584,6,15641,868,0,2,128,4,0
51710,312,6826,72,33,56,0,4,12,72,1,1,1,1,2,2,0,2,0,1,0,0,2,10,5,0
51711,312,6826,1454,835,1044,76,110,219,1530,17,275,158,296,292,454,2297,3718,9,34017,1889,1,2,10,5,0
51712,101,4715,1338,495,1086,10,64,173,1348,11,122,82,157,133,239,883,1686,7,11934,663,0,2,37,0,0
51713,20,507,205,80,86,16,53,53,221,7,18,10,19,25,29,94,134,3,497,27,0,2,1,2,1
51714,309,6789,72,33,56,0,4,12,72,1,1,1,1,2,2,0,2,0,1,0,0,2,1,1,1
51715,309,6789,1454,835,1044,76,110,219,1530,17,275,158,296,292,454,2297,3718,9,34017,1889,1,2,1,1,1
51716,36,1070,182,127,129,0,0,53,182,5,39,21,42,44,63,217,343,2,926,51,0,2,2,3,1
51717,152,7069,1392,870,1177,35,17,170,1427,14,494,280,531,508,811,4473,7289,7,54850,3047,2,2,4,3,1
51718,139,5902,1782,648,1425,9,47,279,1791,8,171,97,189,179,286,1292,2140,4,9462,525,0,2,2,6,1
51719,111,4132,1450,624,1228,12,26,181,1462,14,306,186,354,320,540,2580,4493,8,36391,2021,1,2,6,6,1
51720,155,4385,1660,832,1314,41,38,274,1701,20,312,209,395,332,604,2671,5058,12,64042,3557,1,2,2,4,1
51721,128,5327,1513,682,1277,25,13,200,1538,11,199,116,219,210,335,1557,2584,6,15641,868,0,2,4,3,1
51722,95,4632,1523,757,1297,19,12,193,1542,12,193,117,230,205,347,1508,2664,7,19053,1058,0,2,1,1,1
51724,60,1079,282,196,195,3,0,86,285,8,130,71,141,138,212,936,1507,4,6538,363,0,2,2,2,0
51725,215,4676,182,127,129,0,0,53,182,5,39,21,42,44,63,217,343,2,926,51,0,2,2,1,0
51726,215,4676,1165,710,800,67,119,181,1232,18,243,153,282,261,435,2000,3492,10,36473,2026,1,2,2,1,0
51727,164,5053,1660,832,1314,41,38,274,1701,20,312,209,395,332,604,2671,5058,12,64042,3557,1,2,1,1,0
51728,164,5053,1057,646,719,113,100,145,1170,18,215,134,248,233,382,1740,3004,10,31186,1732,1,2,1,1,0
51729,91,1828,757,253,292,73,244,162,830,13,61,38,67,74,105,409,651,7,4654,258,0,2,3,3,0
51730,46,952,386,256,301,16,9,68,402,4,59,35,69,63,104,355,621,2,1453,80,0,2,3,3,0
51731,46,952,264,131,164,11,41,46,275,6,38,22,40,44,62,214,338,3,1068,59,0,2,3,3,0
51732,92,2955,773,419,590,28,0,166,801,10,204,113,217,214,330,1598,2554,5,13587,754,0,2,3,3,0
51733,155,4385,1660,832,1314,41,38,274,1701,20,312,209,395,332,604,2671,5058,12,64042,3557,1,2,2,1,0
51734,111,4132,1450,624,1228,12,26,181,1462,14,306,186,354,320,540,2580,4493,8,36391,2021,1,2,2,1,0
51735,254,5825,4293,999,3693,19,54,507,4312,9,155,88,170,164,258,1156,1898,4,9368,520,0,2,2,2,0
51736,254,5825,1482,859,1002,125,135,219,1607,16,219,134,251,235,385,1766,3032,9,27804,1544,1,2,2,2,0
51737,90,1921,1043,504,840,53,9,147,1096,9,180,112,198,189,310,1377,2344,4,11604,644,0,2,4,4,0
51738,90,1921,383,288,292,26,6,62,409,11,65,38,67,76,105,429,656,5,3719,206,0,2,4,4,0
51739,152,7067,1392,870,1177,35,17,170,1427,14,494,280,531,508,811,4473,7289,7,54850,3047,2,2,1,1,0
51748,20,507,205,80,86,16,53,53,221,7,18,10,19,25,29,94,134,3,497,27,0,2,1,2,0
51749,309,6789,72,33,56,0,4,12,72,1,1,1,1,2,2,0,2,0,1,0,0,2,1,1,0
51750,309,6789,1454,835,1044,76,110,219,1530,17,275,158,296,292,454,2297,3718,9,34017,1889,1,2,1,1,0
51756,36,1070,182,127,129,0,0,53,182,5,39,21,42,44,63,217,343,2,926,51,0,2,2,3,0
51757,152,7067,1392,870,1177,35,17,170,1427,14,494,280,531,508,811,4473,7289,7,54850,3047,2,2,5,4,0
51759,139,5902,1782,648,1425,9,47,279,1791,8,171,97,189,179,286,1292,2140,4,9462,525,0,2,2,6,0
51760,111,4132,1450,624,1228,12,26,181,1462,14,306,186,354,320,540,2580,4493,8,36391,2021,1,2,8,7,0
51761,155,4385,1660,832,1314,41,38,274,1701,20,312,209,395,332,604,2671,5058,12,64042,3557,1,2,4,5,0
51762,128,5327,1513,682,1277,25,13,200,1538,11,199,116,219,210,335,1557,2584,6,15641,868,0,2,4,3,0
51763,95,4632,1523,757,1297,19,12,193,1542,12,193,117,230,205,347,1508,2664,7,19053,1058,0,2,1,1,0
51764,94,3936,1289,550,1043,56,32,155,1345,10,167,93,185,177,278,1266,2075,5,11498,638,0,2,10,10,0
51765,35,1052,182,127,129,0,0,53,182,5,39,21,42,44,63,217,343,2,926,51,0,2,3,6,0
51766,152,7065,1392,870,1177,35,17,170,1427,14,494,280,531,508,811,4473,7289,7,54850,3047,2,2,4,4,0
51767,100,4589,1338,495,1086,10,64,173,1348,11,122,82,157,133,239,883,1686,7,11934,663,0,2,69,68,0
51768,176,7684,139,89,101,2,0,35,141,7,54,34,62,61,96,330,569,4,2287,127,0,2,217,219,0
51769,176,7684,7,5,5,0,0,2,7,1,2,1,2,3,3,2,4,0,2,0,0,2,217,219,0
51770,139,5896,1782,648,1425,9,47,279,1791,8,171,97,189,179,286,1292,2140,4,9462,525,0,2,9,9,0
51771,155,4383,1660,832,1314,41,38,274,1701,20,312,209,395,332,604,2671,5058,12,64042,3557,1,2,7,7,0
51772,40,3016,996,429,845,24,10,117,1020,7,76,50,88,83,138,494,879,4,3565,198,0,2,36,36,0
51773,128,5326,1513,682,1277,25,13,200,1538,11,199,116,219,210,335,1557,2584,6,15641,868,0,2,48,47,0
51774,73,3826,1296,573,1062,40,33,157,1336,8,201,118,231,209,349,1561,2689,4,12365,686,0,2,7,7,0
51775,86,4499,1457,730,1242,11,6,188,1468,10,292,166,329,302,495,2424,4078,5,22973,1276,1,2,18,18,0
51776,39,2317,652,304,544,16,6,88,668,6,89,51,101,95,152,591,998,3,3399,188,0,2,93,96,0
51777,70,3204,1455,414,1257,16,76,112,1471,5,41,23,46,46,69,231,381,2,1069,59,0,2,24,24,0
51778,92,4727,1943,715,1694,26,18,214,1969,12,185,120,237,197,357,1436,2721,7,20915,1161,0,2,12,12,0
51794,96,1940,463,295,324,28,62,57,491,12,134,82,154,146,236,989,1696,6,11700,650,0,2,5,2,0
51797,47,2258,722,423,573,19,0,135,741,12,172,101,199,184,300,1320,2257,6,15668,870,0,2,6,1,0
51799,4,77,127,75,83,2,11,30,129,4,14,7,14,18,21,61,87,2,175,9,0,2,1,1,0
51800,4,77,652,304,544,16,6,88,668,6,89,51,101,95,152,591,998,3,3399,188,0,2,1,1,0
51801,4,77,2,2,2,0,0,0,2,0,0,0,0,0,0,0,0,0,0,0,0,2,1,1,0
51802,4,77,8,5,5,0,0,3,8,0,0,0,0,0,0,0,0,0,0,0,0,2,1,1,0
51805,4,77,14,8,8,0,0,6,14,0,0,0,0,0,0,0,0,0,0,0,0,2,1,1,0
51806,4,77,6,4,4,0,0,2,6,0,0,0,0,0,0,0,0,0,0,0,0,2,1,1,0
51807,4,77,6,4,4,0,0,2,6,1,2,1,2,3,3,2,4,0,2,0,0,2,1,1,0
51809,4,77,7,5,5,0,0,2,7,0,0,0,0,0,0,0,0,0,0,0,0,2,1,1,0
51811,4,77,10,6,6,0,0,4,10,0,0,0,0,0,0,0,0,0,0,0,0,2,1,1,0
51812,4,77,1,1,1,0,0,0,1,0,0,0,0,0,0,0,0,0,0,0,0,2,1,1,0
51814,4,77,14,10,10,0,0,4,14,1,1,1,1,2,2,0,2,0,1,0,0,2,1,1,0
51815,4,77,46,26,30,3,0,12,49,3,6,3,6,9,9,20,28,1,42,2,0,2,1,1,0
51816,7,296,72,33,56,0,4,12,72,1,1,1,1,2,2,0,2,0,1,0,0,2,26,23,0
51817,94,3938,1289,550,1043,56,32,155,1345,10,167,93,185,177,278,1266,2075,5,11498,638,0,2,3,3,0
51818,152,7066,1392,870,1177,35,17,170,1427,14,494,280,531,508,811,4473,7289,7,54850,3047,2,2,1,1,0
51819,23,579,102,59,69,5,3,24,107,6,22,15,28,28,43,113,206,3,789,43,0,2,1,1,0
51820,155,4384,1660,832,1314,41,38,274,1701,20,312,209,395,332,604,2671,5058,12,64042,3557,1,2,1,1,0
51821,8,271,74,35,59,1,0,14,75,3,14,7,14,17,21,58,85,1,128,7,0,2,3,1,0
51822,38,2302,334,251,279,10,4,40,344,5,127,74,143,132,217,899,1528,2,4303,239,0,2,1,1,0
51823,61,2733,1293,570,1093,25,15,163,1318,10,195,123,241,205,364,1516,2795,6,17273,959,0,2,4,2,0
51824,92,4729,1943,715,1694,26,18,214,1969,12,185,120,237,197,357,1436,2721,7,20915,1161,0,2,2,2,0
51825,164,5047,1660,832,1314,41,38,274,1701,20,312,209,395,332,604,2671,5058,12,64042,3557,1,2,6,8,1
51826,164,5047,1057,646,719,113,100,145,1170,18,215,134,248,233,382,1740,3004,10,31186,1732,1,2,6,8,1
51827,89,1826,477,336,357,30,23,73,507,16,194,134,250,210,384,1538,2962,10,30538,1696,0,2,2,2,1
51828,128,5324,1513,682,1277,25,13,200,1538,11,199,116,219,210,335,1557,2584,6,15641,868,0,2,3,3,1
51829,312,6826,72,33,56,0,4,12,72,1,1,1,1,2,2,0,2,0,1,0,0,2,6,4,1
51830,312,6826,1454,835,1044,76,110,219,1530,17,275,158,296,292,454,2297,3718,9,34017,1889,1,2,6,4,1
51831,177,7801,139,89,101,2,0,35,141,7,54,34,62,61,96,330,569,4,2287,127,0,2,68,0,1
51832,177,7801,7,5,5,0,0,2,7,1,2,1,2,3,3,2,4,0,2,0,0,2,68,0,1
51833,211,4632,1943,715,1694,26,18,214,1969,12,185,120,237,197,357,1436,2721,7,20915,1161,0,2,18,4,1
51834,211,4632,1168,838,957,57,25,144,1225,19,348,224,416,367,640,3018,5452,11,61921,3440,1,2,18,4,1
51835,94,4715,1943,715,1694,26,18,214,1969,12,185,120,237,197,357,1436,2721,7,20915,1161,0,2,35,0,1
51836,312,6828,72,33,56,0,4,12,72,1,1,1,1,2,2,0,2,0,1,0,0,2,5,2,1
51837,312,6828,1454,835,1044,76,110,219,1530,17,275,158,296,292,454,2297,3718,9,34017,1889,1,2,5,2,1
51838,94,4715,1943,715,1694,26,18,214,1969,12,185,120,237,197,357,1436,2721,7,20915,1161,0,2,5,3,1
51839,164,5047,1660,832,1314,41,38,274,1701,20,312,209,395,332,604,2671,5058,12,64042,3557,1,2,6,8,0
51840,164,5047,1057,646,719,113,100,145,1170,18,215,134,248,233,382,1740,3004,10,31186,1732,1,2,6,8,0
51841,89,1826,477,336,357,30,23,73,507,16,194,134,250,210,384,1538,2962,10,30538,1696,0,2,2,2,0
51842,128,5324,1513,682,1277,25,13,200,1538,11,199,116,219,210,335,1557,2584,6,15641,868,0,2,3,3,0
51865,164,5047,1660,832,1314,41,38,274,1701,20,312,209,395,332,604,2671,5058,12,64042,3557,1,2,7,9,0
51866,164,5047,1057,646,719,113,100,145,1170,18,215,134,248,233,382,1740,3004,10,31186,1732,1,2,7,9,0
51874,312,6826,72,33,56,0,4,12,72,1,1,1,1,2,2,0,2,0,1,0,0,2,1,1,0
51875,312,6826,1454,835,1044,76,110,219,1530,17,275,158,296,292,454,2297,3718,9,34017,1889,1,2,1,1,0
51881,94,3938,1289,550,1043,56,32,155,1345,10,167,93,185,177,278,1266,2075,5,11498,638,0,2,13,13,0
51882,35,1052,182,127,129,0,0,53,182,5,39,21,42,44,63,217,343,2,926,51,0,2,5,9,0
51883,152,7066,1392,870,1177,35,17,170,1427,14,494,280,531,508,811,4473,7289,7,54850,3047,2,2,10,9,0
51886,101,4702,1338,495,1086,10,64,173,1348,11,122,82,157,133,239,883,1686,7,11934,663,0,2,69,68,0
51887,177,7811,139,89,101,2,0,35,141,7,54,34,62,61,96,330,569,4,2287,127,0,2,217,219,0
51888,177,7811,7,5,5,0,0,2,7,1,2,1,2,3,3,2,4,0,2,0,0,2,217,219,0
51889,139,5896,1782,648,1425,9,47,279,1791,8,171,97,189,179,286,1292,2140,4,9462,525,0,2,11,15,0
51892,155,4384,1660,832,1314,41,38,274,1701,20,312,209,395,332,604,2671,5058,12,64042,3557,1,2,12,13,0
51894,128,5324,1513,682,1277,25,13,200,1538,11,199,116,219,210,335,1557,2584,6,15641,868,0,2,55,53,0
51904,92,4729,1943,715,1694,26,18,214,1969,12,185,120,237,197,357,1436,2721,7,20915,1161,0,2,14,14,0
51905,177,7819,139,89,101,2,0,35,141,7,54,34,62,61,96,330,569,4,2287,127,0,2,4,4,0
51906,177,7819,7,5,5,0,0,2,7,1,2,1,2,3,3,2,4,0,2,0,0,2,4,4,0
51907,177,7819,139,89,101,2,0,35,141,7,54,34,62,61,96,330,569,4,2287,127,0,2,1,0,0
51908,177,7819,7,5,5,0,0,2,7,1,2,1,2,3,3,2,4,0,2,0,0,2,1,0,0
51909,177,7819,139,89,101,2,0,35,141,7,54,34,62,61,96,330,569,4,2287,127,0,2,2,2,0
51910,177,7819,7,5,5,0,0,2,7,1,2,1,2,3,3,2,4,0,2,0,0,2,2,2,0
51911,101,4702,1338,495,1086,10,64,173,1348,11,122,82,157,133,239,883,1686,7,11934,663,0,2,7,7,0
51912,101,4691,1338,495,1086,10,64,173,1348,11,122,82,157,133,239,883,1686,7,11934,663,0,2,7,9,0
51913,254,5822,4293,999,3693,19,54,507,4312,9,155,88,170,164,258,1156,1898,4,9368,520,0,2,1,1,0
51914,254,5822,1482,859,1002,125,135,219,1607,16,219,134,251,235,385,1766,3032,9,27804,1544,1,2,1,1,0
51915,254,5820,4293,999,3693,19,54,507,4312,9,155,88,170,164,258,1156,1898,4,9368,520,0,2,0,1,0
51916,254,5820,1482,859,1002,125,135,219,1607,16,219,134,251,235,385,1766,3032,9,27804,1544,1,2,0,1,0
51917,254,5820,4293,999,3693,19,54,507,4312,9,155,88,170,164,258,1156,1898,4,9368,520,0,2,1,2,0
51918,254,5820,1482,859,1002,125,135,219,1607,16,219,134,251,235,385,1766,3032,9,27804,1544,1,2,1,2,0
51919,312,6826,72,33,56,0,4,12,72,1,1,1,1,2,2,0,2,0,1,0,0,2,15,4,0
51920,312,6826,1454,835,1044,76,110,219,1530,17,275,158,296,292,454,2297,3718,9,34017,1889,1,2,15,4,0
51921,101,4691,1338,495,1086,10,64,173,1348,11,122,82,157,133,239,883,1686,7,11934,663,0,2,35,0,0
51922,177,7819,139,89,101,2,0,35,141,7,54,34,62,61,96,330,569,4,2287,127,0,2,69,0,0
51923,177,7819,7,5,5,0,0,2,7,1,2,1,2,3,3,2,4,0,2,0,0,2,69,0,0
51924,235,5549,722,423,573,19,0,135,741,12,172,101,199,184,300,1320,2257,6,15668,870,0,2,3,1,0
51925,235,5549,1508,847,911,44,250,301,1552,14,148,88,169,162,257,1120,1886,7,15077,837,0,2,3,1,0
51926,315,6881,72,33,56,0,4,12,72,1,1,1,1,2,2,0,2,0,1,0,0,2,13,4,0
51927,315,6881,1454,835,1044,76,110,219,1530,17,275,158,296,292,454,2297,3718,9,34017,1889,1,2,13,4,0
51944,1,6,99,48,90,1,3,5,100,0,0,0,0,0,0,0,0,0,0,0,0,0,2,0,0
51945,1,6,8,5,5,2,0,1,10,0,0,0,0,0,0,0,0,0,0,0,0,0,2,0,0
51946,1,6,1217,716,841,84,126,174,1301,14,185,118,215,199,333,1446,2542,8,20687,1149,0,0,2,0,0
51947,1,6,160,89,115,0,13,31,160,7,15,11,17,22,28,78,124,3,495,27,0,0,2,0,0
51948,1,6,10,10,9,9,0,0,19,0,0,0,0,0,0,0,0,0,0,0,0,0,2,0,0
51949,1,6,173,84,99,8,29,36,181,5,12,7,13,17,20,54,81,2,221,12,0,0,2,0,0
51950,1,6,3,1,1,3,0,0,6,0,0,0,0,0,0,0,0,0,0,0,0,0,2,0,0
51955,74,3868,1296,573,1062,40,33,157,1336,8,201,118,231,209,349,1561,2689,4,12365,686,0,2,14,0,0
51956,33,1885,384,251,317,7,8,52,391,11,70,44,84,81,128,467,811,6,5355,297,0,2,1,3,0
51957,39,1696,447,308,343,6,5,95,453,7,96,59,111,103,170,651,1136,4,4600,255,0,2,9,5,0
51958,41,2010,722,423,573,19,0,135,741,12,172,101,199,184,300,1320,2257,6,15668,870,0,2,0,51,0
51959,94,4731,1943,715,1694,26,18,214,1969,12,185,120,237,197,357,1436,2721,7,20915,1161,0,2,7,0,1
51960,94,4721,1943,715,1694,26,18,214,1969,12,185,120,237,197,357,1436,2721,7,20915,1161,0,2,0,1,0
52021,154,3262,1513,682,1277,25,13,200,1538,11,199,116,219,210,335,1557,2584,6,15641,868,0,2,100,65,0
52022,154,3262,819,519,539,24,98,155,843,15,96,57,106,111,163,690,1107,8,9171,509,0,2,100,65,0
52025,254,5820,4293,999,3693,19,54,507,4312,9,155,88,170,164,258,1156,1898,4,9368,520,0,2,3,4,0
52026,254,5820,1482,859,1002,125,135,219,1607,16,219,134,251,235,385,1766,3032,9,27804,1544,1,2,3,4,0
52030,235,5590,722,423,573,19,0,135,741,12,172,101,199,184,300,1320,2257,6,15668,870,0,2,27,23,0
52031,235,5590,1508,847,911,44,250,301,1552,14,148,88,169,162,257,1120,1886,7,15077,837,0,2,27,23,0
52032,315,6881,72,33,56,0,4,12,72,1,1,1,1,2,2,0,2,0,1,0,0,2,29,9,0
52033,315,6881,1454,835,1044,76,110,219,1530,17,275,158,296,292,454,2297,3718,9,34017,1889,1,2,29,9,0
52043,94,3938,1289,550,1043,56,32,155,1345,10,167,93,185,177,278,1266,2075,5,11498,638,0,2,23,13,0
52076,101,4691,1338,495,1086,10,64,173,1348,11,122,82,157,133,239,883,1686,7,11934,663,0,2,104,68,0
52077,177,7819,139,89,101,2,0,35,141,7,54,34,62,61,96,330,569,4,2287,127,0,2,286,219,0
52078,177,7819,7,5,5,0,0,2,7,1,2,1,2,3,3,2,4,0,2,0,0,2,286,219,0
52084,128,5324,1513,682,1277,25,13,200,1538,11,199,116,219,210,335,1557,2584,6,15641,868,0,2,159,64,0
52085,74,3868,1296,573,1062,40,33,157,1336,8,201,118,231,209,349,1561,2689,4,12365,686,0,2,21,7,0
52086,88,4625,1457,730,1242,11,6,188,1468,10,292,166,329,302,495,2424,4078,5,22973,1276,1,2,18,18,0
52095,44,2109,722,423,573,19,0,135,741,12,172,101,199,184,300,1320,2257,6,15668,870,0,2,6,52,0
52096,92,4729,1943,715,1694,26,18,214,1969,12,185,120,237,197,357,1436,2721,7,20915,1161,0,2,54,14,0
52097,213,4582,1943,715,1694,26,18,214,1969,12,185,120,237,197,357,1436,2721,7,20915,1161,0,2,3,3,0
52098,213,4582,1168,838,957,57,25,144,1225,19,348,224,416,367,640,3018,5452,11,61921,3440,1,2,3,3,0
52099,96,4914,1943,715,1694,26,18,214,1969,12,185,120,237,197,357,1436,2721,7,20915,1161,0,2,50,3,0
52100,76,1715,996,429,845,24,10,117,1020,7,76,50,88,83,138,494,879,4,3565,198,0,2,1,1,0
52101,76,1715,456,277,329,12,42,72,468,13,85,50,97,98,147,592,972,7,7212,400,0,2,1,1,0
52102,43,3113,996,429,845,24,10,117,1020,7,76,50,88,83,138,494,879,4,3565,198,0,2,13,0,0
52204,35,1068,182,127,129,0,0,53,182,5,39,21,42,44,63,217,343,2,926,51,0,2,15,14,0
52205,91,2944,773,419,590,28,0,166,801,10,204,113,217,214,330,1598,2554,5,13587,754,0,2,5,8,0
52209,213,4683,1943,715,1694,26,18,214,1969,12,185,120,237,197,357,1436,2721,7,20915,1161,0,2,15,6,0
52210,213,4683,1168,838,957,57,25,144,1225,19,348,224,416,367,640,3018,5452,11,61921,3440,1,2,15,6,0
52211,94,4721,1943,715,1694,26,18,214,1969,12,185,120,237,197,357,1436,2721,7,20915,1161,0,2,3,3,0
52214,85,2166,1455,414,1257,16,76,112,1471,5,41,23,46,46,69,231,381,2,1069,59,0,2,2,1,0
52215,85,2166,669,365,481,22,61,110,691,15,103,63,122,118,185,747,1273,8,11311,628,0,2,2,1,0
52219,177,7829,139,89,101,2,0,35,141,7,54,34,62,61,96,330,569,4,2287,127,0,2,1,0,0
52220,177,7829,7,5,5,0,0,2,7,1,2,1,2,3,3,2,4,0,2,0,0,2,1,0,0
52221,166,5073,1660,832,1314,41,38,274,1701,20,312,209,395,332,604,2671,5058,12,64042,3557,1,2,10,1,0
52222,166,5073,1057,646,719,113,100,145,1170,18,215,134,248,233,382,1740,3004,10,31186,1732,1,2,10,1,0
52223,157,4508,1660,832,1314,41,38,274,1701,20,312,209,395,332,604,2671,5058,12,64042,3557,1,2,29,0,0
52224,212,4659,1943,715,1694,26,18,214,1969,12,185,120,237,197,357,1436,2721,7,20915,1161,0,2,5,16,0
52225,212,4659,1168,838,957,57,25,144,1225,19,348,224,416,367,640,3018,5452,11,61921,3440,1,2,5,16,0
52226,94,4721,1943,715,1694,26,18,214,1969,12,185,120,237,197,357,1436,2721,7,20915,1161,0,2,7,7,0
52227,215,4685,1943,715,1694,26,18,214,1969,12,185,120,237,197,357,1436,2721,7,20915,1161,0,2,20,8,0
52228,215,4685,1168,838,957,57,25,144,1225,19,348,224,416,367,640,3018,5452,11,61921,3440,1,2,20,8,0
52229,95,4853,1943,715,1694,26,18,214,1969,12,185,120,237,197,357,1436,2721,7,20915,1161,0,2,43,0,0
52239,315,6882,72,33,56,0,4,12,72,1,1,1,1,2,2,0,2,0,1,0,0,2,4,3,0
52240,315,6882,1454,835,1044,76,110,219,1530,17,275,158,296,292,454,2297,3718,9,34017,1889,1,2,4,3,0
52241,70,1382,1178,367,1042,6,15,115,1184,9,94,51,95,103,146,644,976,4,4439,246,0,2,2,2,0
52242,70,1382,177,108,140,8,0,27,185,6,30,16,32,36,48,162,248,3,794,44,0,2,2,2,0
52243,213,4582,1943,715,1694,26,18,214,1969,12,185,120,237,197,357,1436,2721,7,20915,1161,0,2,1,1,0
52244,213,4582,1168,838,957,57,25,144,1225,19,348,224,416,367,640,3018,5452,11,61921,3440,1,2,1,1,0
52245,23,474,601,196,481,2,23,85,603,8,63,36,72,71,108,400,664,4,3036,168,0,2,1,1,0
52246,23,474,156,79,106,5,16,28,161,5,14,8,15,19,23,64,97,2,261,14,0,2,1,1,0
52247,17,774,75,38,59,1,3,12,76,2,4,2,4,6,6,10,15,1,15,0,0,2,1,1,0
52259,75,1694,996,429,845,24,10,117,1020,7,76,50,88,83,138,494,879,4,3565,198,0,2,6,9,0
52260,75,1694,456,277,329,12,42,72,468,13,85,50,97,98,147,592,972,7,7212,400,0,2,6,9,0
52261,42,3095,996,429,845,24,10,117,1020,7,76,50,88,83,138,494,879,4,3565,198,0,2,12,7,0
52269,76,1705,996,429,845,24,10,117,1020,7,76,50,88,83,138,494,879,4,3565,198,0,2,1,1,0
52270,76,1705,456,277,329,12,42,72,468,13,85,50,97,98,147,592,972,7,7212,400,0,2,1,1,0
52277,216,4689,1943,715,1694,26,18,214,1969,12,185,120,237,197,357,1436,2721,7,20915,1161,0,2,4,4,0
52278,216,4689,1168,838,957,57,25,144,1225,19,348,224,416,367,640,3018,5452,11,61921,3440,1,2,4,4,0
52287,45,3192,996,429,845,24,10,117,1020,7,76,50,88,83,138,494,879,4,3565,198,0,2,13,0,0
52288,99,5038,1943,715,1694,26,18,214,1969,12,185,120,237,197,357,1436,2721,7,20915,1161,0,2,50,3,0
52291,213,4576,1943,715,1694,26,18,214,1969,12,185,120,237,197,357,1436,2721,7,20915,1161,0,2,3,5,0
52292,213,4576,1168,838,957,57,25,144,1225,19,348,224,416,367,640,3018,5452,11,61921,3440,1,2,3,5,0
52295,215,4604,1943,715,1694,26,18,214,1969,12,185,120,237,197,357,1436,2721,7,20915,1161,0,2,12,5,0
52296,215,4604,1168,838,957,57,25,144,1225,19,348,224,416,367,640,3018,5452,11,61921,3440,1,2,12,5,0
52299,215,4602,1943,715,1694,26,18,214,1969,12,185,120,237,197,357,1436,2721,7,20915,1161,0,2,10,9,0
52300,215,4602,1168,838,957,57,25,144,1225,19,348,224,416,367,640,3018,5452,11,61921,3440,1,2,10,9,0
52301,43,3130,996,429,845,24,10,117,1020,7,76,50,88,83,138,494,879,4,3565,198,0,2,7,14,0
52324,43,3130,996,429,845,24,10,117,1020,7,76,50,88,83,138,494,879,4,3565,198,0,2,7,1,0
52326,175,5294,1660,832,1314,41,38,274,1701,20,312,209,395,332,604,2671,5058,12,64042,3557,1,2,55,15,0
52327,175,5294,1057,646,719,113,100,145,1170,18,215,134,248,233,382,1740,3004,10,31186,1732,1,2,55,15,0
52328,141,3272,77,34,69,0,0,8,77,3,24,16,29,27,45,114,213,1,387,21,0,2,3,2,0
52329,141,3272,712,438,573,51,9,84,763,14,102,71,128,116,199,733,1364,8,11988,666,0,2,3,2,0
52333,215,4602,1943,715,1694,26,18,214,1969,12,185,120,237,197,357,1436,2721,7,20915,1161,0,2,14,8,0
52334,215,4602,1168,838,957,57,25,144,1225,19,348,224,416,367,640,3018,5452,11,61921,3440,1,2,14,8,0
52336,179,5366,1660,832,1314,41,38,274,1701,20,312,209,395,332,604,2671,5058,12,64042,3557,1,2,24,7,0
52337,179,5366,1057,646,719,113,100,145,1170,18,215,134,248,233,382,1740,3004,10,31186,1732,1,2,24,7,0
52338,141,3279,77,34,69,0,0,8,77,3,24,16,29,27,45,114,213,1,387,21,0,2,1,1,0
52339,141,3279,712,438,573,51,9,84,763,14,102,71,128,116,199,733,1364,8,11988,666,0,2,1,1,0
52340,162,4813,1660,832,1314,41,38,274,1701,20,312,209,395,332,604,2671,5058,12,64042,3557,1,2,93,14,0
52343,212,4569,2,2,2,0,0,0,2,0,0,0,0,0,0,0,0,0,0,0,0,2,3,1,0
52357,212,4569,99,48,90,1,3,5,100,0,0,0,0,0,0,0,0,0,0,0,0,2,3,1,0
52358,212,4569,8,5,5,2,0,1,10,0,0,0,0,0,0,0,0,0,0,0,0,2,3,1,0
52359,212,4569,1217,716,841,84,126,174,1301,14,185,118,215,199,333,1446,2542,8,20687,1149,0,2,3,1,0
52360,212,4569,160,89,115,0,13,31,160,7,15,11,17,22,28,78,124,3,495,27,0,2,3,1,0
52361,212,4569,10,10,9,9,0,0,19,0,0,0,0,0,0,0,0,0,0,0,0,2,3,1,0
52362,212,4569,173,84,99,8,29,36,181,5,12,7,13,17,20,54,81,2,221,12,0,2,3,1,0
52363,212,4569,3,1,1,3,0,0,6,0,0,0,0,0,0,0,0,0,0,0,0,2,3,1,0
52387,20,507,205,80,86,16,53,53,221,7,18,10,19,25,29,94,134,3,497,27,0,2,24,8,0
52389,97,1999,463,295,324,28,62,57,491,12,134,82,154,146,236,989,1696,6,11700,650,0,2,15,0,0
52390,95,3958,1289,550,1043,56,32,155,1345,10,167,93,185,177,278,1266,2075,5,11498,638,0,2,5,0,0
52391,179,5366,1660,832,1314,41,38,274,1701,20,312,209,395,332,604,2671,5058,12,64042,3557,1,2,1,1,0
52392,179,5366,1057,646,719,113,100,145,1170,18,215,134,248,233,382,1740,3004,10,31186,1732,1,2,1,1,0
52393,235,5582,722,423,573,19,0,135,741,12,172,101,199,184,300,1320,2257,6,15668,870,0,2,0,1,0
52394,235,5582,1508,847,911,44,250,301,1552,14,148,88,169,162,257,1120,1886,7,15077,837,0,2,0,1,0
52395,52,622,647,139,84,35,284,233,682,0,0,0,0,0,0,0,0,0,0,0,0,2,19,0,0
52396,24,513,601,196,481,2,23,85,603,8,63,36,72,71,108,400,664,4,3036,168,0,2,31,31,0
52397,24,513,156,79,106,5,16,28,161,5,14,8,15,19,23,64,97,2,261,14,0,2,31,31,0
52398,22,807,601,196,481,2,23,85,603,8,63,36,72,71,108,400,664,4,3036,168,0,2,19,0,0
52399,52,622,647,139,84,35,284,233,682,0,0,0,0,0,0,0,0,0,0,0,0,2,3,3,0
52400,76,1707,53,23,39,0,0,13,53,2,8,4,8,10,12,26,39,1,39,2,0,2,13,3,0
52401,76,1707,515,298,307,33,80,99,548,12,63,44,77,75,121,419,753,7,5527,307,0,2,13,3,0
52402,216,4748,1943,715,1694,26,18,214,1969,12,185,120,237,197,357,1436,2721,7,20915,1161,0,2,26,16,0
52403,216,4748,1168,838,957,57,25,144,1225,19,348,224,416,367,640,3018,5452,11,61921,3440,1,2,26,16,0
52404,24,500,601,196,481,2,23,85,603,8,63,36,72,71,108,400,664,4,3036,168,0,2,15,11,0
52405,24,500,156,79,106,5,16,28,161,5,14,8,15,19,23,64,97,2,261,14,0,2,15,11,0
52406,22,807,601,196,481,2,23,85,603,8,63,36,72,71,108,400,664,4,3036,168,0,2,2,2,0
52407,314,6858,72,33,56,0,4,12,72,1,1,1,1,2,2,0,2,0,1,0,0,2,0,5,0
52408,314,6858,1454,835,1044,76,110,219,1530,17,275,158,296,292,454,2297,3718,9,34017,1889,1,2,0,5,0
52409,217,4757,1943,715,1694,26,18,214,1969,12,185,120,237,197,357,1436,2721,7,20915,1161,0,2,4,2,1
52410,217,4757,1168,838,957,57,25,144,1225,19,348,224,416,367,640,3018,5452,11,61921,3440,1,2,4,2,1
52411,26,557,601,196,481,2,23,85,603,8,63,36,72,71,108,400,664,4,3036,168,0,2,21,11,1
52412,26,557,156,79,106,5,16,28,161,5,14,8,15,19,23,64,97,2,261,14,0,2,21,11,1
52413,23,855,601,196,481,2,23,85,603,8,63,36,72,71,108,400,664,4,3036,168,0,2,25,0,1
52415,79,1795,53,23,39,0,0,13,53,2,8,4,8,10,12,26,39,1,39,2,0,2,17,4,0
52416,79,1795,515,298,307,33,80,99,548,12,63,44,77,75,121,419,753,7,5527,307,0,2,17,4,0
52417,314,6864,72,33,56,0,4,12,72,1,1,1,1,2,2,0,2,0,1,0,0,2,13,7,0
52418,314,6864,1454,835,1044,76,110,219,1530,17,275,158,296,292,454,2297,3718,9,34017,1889,1,2,13,7,0
52419,217,4758,1943,715,1694,26,18,214,1969,12,185,120,237,197,357,1436,2721,7,20915,1161,0,2,3,4,0
52420,217,4758,1168,838,957,57,25,144,1225,19,348,224,416,367,640,3018,5452,11,61921,3440,1,2,3,4,0
52423,94,4062,1020,354,843,12,15,144,1032,8,134,77,144,142,221,970,1580,4,6792,377,0,2,1,1,0
52424,86,1832,402,202,227,24,74,80,426,12,52,33,61,64,94,339,564,7,3969,220,0,2,7,4,1
52425,79,1799,53,23,39,0,0,13,53,2,8,4,8,10,12,26,39,1,39,2,0,2,1,1,1
52426,79,1799,515,298,307,33,80,99,548,12,63,44,77,75,121,419,753,7,5527,307,0,2,1,1,1
52427,314,6871,72,33,56,0,4,12,72,1,1,1,1,2,2,0,2,0,1,0,0,2,5,1,1
52428,314,6871,1454,835,1044,76,110,219,1530,17,275,158,296,292,454,2297,3718,9,34017,1889,1,2,5,1,1
52429,128,5332,1513,682,1277,25,13,200,1538,11,199,116,219,210,335,1557,2584,6,15641,868,0,2,4,3,1
52432,214,4605,2,2,2,0,0,0,2,0,0,0,0,0,0,0,0,0,0,0,0,2,8,1,0
52446,214,4605,99,48,90,1,3,5,100,0,0,0,0,0,0,0,0,0,0,0,0,2,8,1,0
52447,214,4605,8,5,5,2,0,1,10,0,0,0,0,0,0,0,0,0,0,0,0,2,8,1,0
52448,214,4605,1217,716,841,84,126,174,1301,14,185,118,215,199,333,1446,2542,8,20687,1149,0,2,8,1,0
52449,214,4605,160,89,115,0,13,31,160,7,15,11,17,22,28,78,124,3,495,27,0,2,8,1,0
52450,214,4605,10,10,9,9,0,0,19,0,0,0,0,0,0,0,0,0,0,0,0,2,8,1,0
52451,214,4605,173,84,99,8,29,36,181,5,12,7,13,17,20,54,81,2,221,12,0,2,8,1,0
52452,214,4605,3,1,1,3,0,0,6,0,0,0,0,0,0,0,0,0,0,0,0,2,8,1,0
52454,87,1837,402,202,227,24,74,80,426,12,52,33,61,64,94,339,564,7,3969,220,0,2,1,1,0
52455,315,6924,72,33,56,0,4,12,72,1,1,1,1,2,2,0,2,0,1,0,0,2,20,18,0
52456,315,6924,1454,835,1044,76,110,219,1530,17,275,158,296,292,454,2297,3718,9,34017,1889,1,2,20,18,0
52459,27,596,601,196,481,2,23,85,603,8,63,36,72,71,108,400,664,4,3036,168,0,2,8,1,0
52460,27,596,156,79,106,5,16,28,161,5,14,8,15,19,23,64,97,2,261,14,0,2,8,1,0
52461,20,864,75,38,59,1,3,12,76,2,4,2,4,6,6,10,15,1,15,0,0,2,32,8,0
52462,136,5760,1782,648,1425,9,47,279,1791,8,171,97,189,179,286,1292,2140,4,9462,525,0,2,4,40,0
52463,99,5044,1943,715,1694,26,18,214,1969,12,185,120,237,197,357,1436,2721,7,20915,1161,0,2,5,4,0
52464,165,5078,1660,832,1314,41,38,274,1701,20,312,209,395,332,604,2671,5058,12,64042,3557,1,2,14,7,1
52465,165,5078,1057,646,719,113,100,145,1170,18,215,134,248,233,382,1740,3004,10,31186,1732,1,2,14,7,1
52466,76,1699,996,429,845,24,10,117,1020,7,76,50,88,83,138,494,879,4,3565,198,0,2,7,3,1
52467,76,1699,456,277,329,12,42,72,468,13,85,50,97,98,147,592,972,7,7212,400,0,2,7,3,1
52470,217,4679,2,2,2,0,0,0,2,0,0,0,0,0,0,0,0,0,0,0,0,2,23,3,1
52484,217,4679,99,48,90,1,3,5,100,0,0,0,0,0,0,0,0,0,0,0,0,2,23,3,1
52485,217,4679,8,5,5,2,0,1,10,0,0,0,0,0,0,0,0,0,0,0,0,2,23,3,1
52486,217,4679,1217,716,841,84,126,174,1301,14,185,118,215,199,333,1446,2542,8,20687,1149,0,2,23,3,1
52487,217,4679,160,89,115,0,13,31,160,7,15,11,17,22,28,78,124,3,495,27,0,2,23,3,1
52488,217,4679,10,10,9,9,0,0,19,0,0,0,0,0,0,0,0,0,0,0,0,2,23,3,1
52489,217,4679,173,84,99,8,29,36,181,5,12,7,13,17,20,54,81,2,221,12,0,2,23,3,1
52490,217,4679,3,1,1,3,0,0,6,0,0,0,0,0,0,0,0,0,0,0,0,2,23,3,1
52491,49,729,167,116,138,4,5,22,171,8,48,30,56,56,86,292,499,4,2330,129,0,2,18,9,1
52492,254,5836,4293,999,3693,19,54,507,4312,9,155,88,170,164,258,1156,1898,4,9368,520,0,2,6,2,1
52493,254,5836,1482,859,1002,125,135,219,1607,16,219,134,251,235,385,1766,3032,9,27804,1544,1,2,6,2,1
52494,98,2668,1523,757,1297,19,12,193,1542,12,193,117,230,205,347,1508,2664,7,19053,1058,0,2,5,2,1
52495,98,2668,701,378,504,33,58,109,734,13,110,68,126,123,194,794,1346,7,10027,557,0,2,5,2,1
52496,80,1826,53,23,39,0,0,13,53,2,8,4,8,10,12,26,39,1,39,2,0,2,30,4,1
52497,80,1826,515,298,307,33,80,99,548,12,63,44,77,75,121,419,753,7,5527,307,0,2,30,4,1
52498,315,6944,72,33,56,0,4,12,72,1,1,1,1,2,2,0,2,0,1,0,0,2,14,6,1
52499,315,6944,1454,835,1044,76,110,219,1530,17,275,158,296,292,454,2297,3718,9,34017,1889,1,2,14,6,1
52500,30,658,215,129,180,6,0,29,221,8,65,43,72,73,115,415,711,4,3153,175,0,2,3,1,1
52501,30,658,97,69,77,3,3,16,100,6,22,13,23,28,36,113,173,3,542,30,0,2,3,1,1
52502,94,3940,1289,550,1043,56,32,155,1345,10,167,93,185,177,278,1266,2075,5,11498,638,0,2,1,1,1
52503,20,968,75,38,59,1,3,12,76,2,4,2,4,6,6,10,15,1,15,0,0,2,22,6,1
52504,101,4718,1338,495,1086,10,64,173,1348,11,122,82,157,133,239,883,1686,7,11934,663,0,2,11,3,1
52505,136,5760,1782,648,1425,9,47,279,1791,8,171,97,189,179,286,1292,2140,4,9462,525,0,2,2,2,1
52506,111,4139,1450,624,1228,12,26,181,1462,14,306,186,354,320,540,2580,4493,8,36391,2021,1,2,2,1,1
52507,156,4476,1660,832,1314,41,38,274,1701,20,312,209,395,332,604,2671,5058,12,64042,3557,1,2,4,8,1
52508,43,3139,996,429,845,24,10,117,1020,7,76,50,88,83,138,494,879,4,3565,198,0,2,1,0,1
52509,90,4662,1457,730,1242,11,6,188,1468,10,292,166,329,302,495,2424,4078,5,22973,1276,1,2,22,15,1
52510,95,4642,1523,757,1297,19,12,193,1542,12,193,117,230,205,347,1508,2664,7,19053,1058,0,2,5,1,1
52511,16,1224,215,129,180,6,0,29,221,8,65,43,72,73,115,415,711,4,3153,175,0,2,3,0,1
52512,23,855,601,196,481,2,23,85,603,8,63,36,72,71,108,400,664,4,3036,168,0,2,1,1,1
52515,217,4679,2,2,2,0,0,0,2,0,0,0,0,0,0,0,0,0,0,0,0,2,2,2,0
52529,217,4679,99,48,90,1,3,5,100,0,0,0,0,0,0,0,0,0,0,0,0,2,2,2,0
52530,217,4679,8,5,5,2,0,1,10,0,0,0,0,0,0,0,0,0,0,0,0,2,2,2,0
52531,217,4679,1217,716,841,84,126,174,1301,14,185,118,215,199,333,1446,2542,8,20687,1149,0,2,2,2,0
52532,217,4679,160,89,115,0,13,31,160,7,15,11,17,22,28,78,124,3,495,27,0,2,2,2,0
52533,217,4679,10,10,9,9,0,0,19,0,0,0,0,0,0,0,0,0,0,0,0,2,2,2,0
52534,217,4679,173,84,99,8,29,36,181,5,12,7,13,17,20,54,81,2,221,12,0,2,2,2,0
52535,217,4679,3,1,1,3,0,0,6,0,0,0,0,0,0,0,0,0,0,0,0,2,2,2,0
52536,315,6939,72,33,56,0,4,12,72,1,1,1,1,2,2,0,2,0,1,0,0,2,3,7,0
52537,315,6939,1454,835,1044,76,110,219,1530,17,275,158,296,292,454,2297,3718,9,34017,1889,1,2,3,7,0
52540,156,4472,1660,832,1314,41,38,274,1701,20,312,209,395,332,604,2671,5058,12,64042,3557,1,2,1,2,0
52544,30,634,601,196,481,2,23,85,603,8,63,36,72,71,108,400,664,4,3036,168,0,2,8,0,0
52545,30,634,156,79,106,5,16,28,161,5,14,8,15,19,23,64,97,2,261,14,0,2,8,0,0
52546,102,4744,1338,495,1086,10,64,173,1348,11,122,82,157,133,239,883,1686,7,11934,663,0,2,20,23,0
52547,29,1088,601,196,481,2,23,85,603,8,63,36,72,71,108,400,664,4,3036,168,0,2,73,0,0
52548,33,1200,601,196,481,2,23,85,603,8,63,36,72,71,108,400,664,4,3036,168,0,2,40,0,0
52551,217,4692,2,2,2,0,0,0,2,0,0,0,0,0,0,0,0,0,0,0,0,2,6,4,1
52565,217,4692,99,48,90,1,3,5,100,0,0,0,0,0,0,0,0,0,0,0,0,2,6,4,1
52566,217,4692,8,5,5,2,0,1,10,0,0,0,0,0,0,0,0,0,0,0,0,2,6,4,1
52567,217,4692,1217,716,841,84,126,174,1301,14,185,118,215,199,333,1446,2542,8,20687,1149,0,2,6,4,1
52568,217,4692,160,89,115,0,13,31,160,7,15,11,17,22,28,78,124,3,495,27,0,2,6,4,1
52569,217,4692,10,10,9,9,0,0,19,0,0,0,0,0,0,0,0,0,0,0,0,2,6,4,1
52570,217,4692,173,84,99,8,29,36,181,5,12,7,13,17,20,54,81,2,221,12,0,2,6,4,1
52571,217,4692,3,1,1,3,0,0,6,0,0,0,0,0,0,0,0,0,0,0,0,2,6,4,1
52572,51,767,167,116,138,4,5,22,171,8,48,30,56,56,86,292,499,4,2330,129,0,2,20,19,1
52573,52,622,647,139,84,35,284,233,682,0,0,0,0,0,0,0,0,0,0,0,0,2,14,2,1
52574,30,663,215,129,180,6,0,29,221,8,65,43,72,73,115,415,711,4,3153,175,0,2,2,2,1
52575,30,663,97,69,77,3,3,16,100,6,22,13,23,28,36,113,173,3,542,30,0,2,2,2,1
52576,31,704,601,196,481,2,23,85,603,8,63,36,72,71,108,400,664,4,3036,168,0,2,17,0,1
52577,31,704,156,79,106,5,16,28,161,5,14,8,15,19,23,64,97,2,261,14,0,2,17,0,1
52578,20,911,75,38,59,1,3,12,76,2,4,2,4,6,6,10,15,1,15,0,0,2,3,15,1
52579,165,5086,1660,832,1314,41,38,274,1701,20,312,209,395,332,604,2671,5058,12,64042,3557,1,2,4,3,1
52580,165,5086,1057,646,719,113,100,145,1170,18,215,134,248,233,382,1740,3004,10,31186,1732,1,2,4,3,1
52582,98,2666,1523,757,1297,19,12,193,1542,12,193,117,230,205,347,1508,2664,7,19053,1058,0,2,2,3,1
52583,98,2666,701,378,504,33,58,109,734,13,110,68,126,123,194,794,1346,7,10027,557,0,2,2,3,1
52584,235,5586,722,423,573,19,0,135,741,12,172,101,199,184,300,1320,2257,6,15668,870,0,2,1,1,1
52585,235,5586,1508,847,911,44,250,301,1552,14,148,88,169,162,257,1120,1886,7,15077,837,0,2,1,1,1
52586,220,4815,1943,715,1694,26,18,214,1969,12,185,120,237,197,357,1436,2721,7,20915,1161,0,2,21,6,1
52587,220,4815,1168,838,957,57,25,144,1225,19,348,224,416,367,640,3018,5452,11,61921,3440,1,2,21,6,1
52588,156,4471,1660,832,1314,41,38,274,1701,20,312,209,395,332,604,2671,5058,12,64042,3557,1,2,10,5,1
52589,95,4639,1523,757,1297,19,12,193,1542,12,193,117,230,205,347,1508,2664,7,19053,1058,0,2,1,4,1
52590,33,1183,601,196,481,2,23,85,603,8,63,36,72,71,108,400,664,4,3036,168,0,2,2,5,1
52591,235,5588,722,423,573,19,0,135,741,12,172,101,199,184,300,1320,2257,6,15668,870,0,2,4,2,0
52592,235,5588,1508,847,911,44,250,301,1552,14,148,88,169,162,257,1120,1886,7,15077,837,0,2,4,2,0
52593,1,54,37,13,25,0,6,6,37,1,2,1,2,3,3,2,4,0,2,0,0,2,17,0,0
52594,1,54,133,47,40,1,43,49,134,0,0,0,0,0,0,0,0,0,0,0,0,2,17,0,0
52595,235,5588,722,423,573,19,0,135,741,12,172,101,199,184,300,1320,2257,6,15668,870,0,2,1,1,0
52596,235,5588,1508,847,911,44,250,301,1552,14,148,88,169,162,257,1120,1886,7,15077,837,0,2,1,1,0
52597,1,54,37,13,25,0,6,6,37,1,2,1,2,3,3,2,4,0,2,0,0,2,1,1,0
52598,1,54,133,47,40,1,43,49,134,0,0,0,0,0,0,0,0,0,0,0,0,2,1,1,0
52599,315,6939,72,33,56,0,4,12,72,1,1,1,1,2,2,0,2,0,1,0,0,2,0,5,0
52600,315,6939,1454,835,1044,76,110,219,1530,17,275,158,296,292,454,2297,3718,9,34017,1889,1,2,0,5,0
52601,31,704,601,196,481,2,23,85,603,8,63,36,72,71,108,400,664,4,3036,168,0,2,1,0,0
52602,31,704,156,79,106,5,16,28,161,5,14,8,15,19,23,64,97,2,261,14,0,2,1,0,0
52603,80,1826,53,23,39,0,0,13,53,2,8,4,8,10,12,26,39,1,39,2,0,2,1,0,0
52604,80,1826,515,298,307,33,80,99,548,12,63,44,77,75,121,419,753,7,5527,307,0,2,1,0,0
52607,165,5085,1660,832,1314,41,38,274,1701,20,312,209,395,332,604,2671,5058,12,64042,3557,1,2,1,1,0
52608,165,5085,1057,646,719,113,100,145,1170,18,215,134,248,233,382,1740,3004,10,31186,1732,1,2,1,1,0
52609,166,5096,1660,832,1314,41,38,274,1701,20,312,209,395,332,604,2671,5058,12,64042,3557,1,2,1,1,0
52610,166,5096,1057,646,719,113,100,145,1170,18,215,134,248,233,382,1740,3004,10,31186,1732,1,2,1,1,0
52611,111,4170,1450,624,1228,12,26,181,1462,14,306,186,354,320,540,2580,4493,8,36391,2021,1,2,12,3,0
52612,76,1699,996,429,845,24,10,117,1020,7,76,50,88,83,138,494,879,4,3565,198,0,2,1,1,0
52613,76,1699,456,277,329,12,42,72,468,13,85,50,97,98,147,592,972,7,7212,400,0,2,1,1,0
52616,217,4683,2,2,2,0,0,0,2,0,0,0,0,0,0,0,0,0,0,0,0,2,4,5,1
52630,217,4683,99,48,90,1,3,5,100,0,0,0,0,0,0,0,0,0,0,0,0,2,4,5,1
52631,217,4683,8,5,5,2,0,1,10,0,0,0,0,0,0,0,0,0,0,0,0,2,4,5,1
52632,217,4683,1217,716,841,84,126,174,1301,14,185,118,215,199,333,1446,2542,8,20687,1149,0,2,4,5,1
52633,217,4683,160,89,115,0,13,31,160,7,15,11,17,22,28,78,124,3,495,27,0,2,4,5,1
52634,217,4683,10,10,9,9,0,0,19,0,0,0,0,0,0,0,0,0,0,0,0,2,4,5,1
52635,217,4683,173,84,99,8,29,36,181,5,12,7,13,17,20,54,81,2,221,12,0,2,4,5,1
52636,217,4683,3,1,1,3,0,0,6,0,0,0,0,0,0,0,0,0,0,0,0,2,4,5,1
52638,254,5836,4293,999,3693,19,54,507,4312,9,155,88,170,164,258,1156,1898,4,9368,520,0,2,2,1,1
52639,254,5836,1482,859,1002,125,135,219,1607,16,219,134,251,235,385,1766,3032,9,27804,1544,1,2,2,1,1
52640,98,2660,1523,757,1297,19,12,193,1542,12,193,117,230,205,347,1508,2664,7,19053,1058,0,2,2,3,1
52641,98,2660,701,378,504,33,58,109,734,13,110,68,126,123,194,794,1346,7,10027,557,0,2,2,3,1
52642,87,1836,402,202,227,24,74,80,426,12,52,33,61,64,94,339,564,7,3969,220,0,2,7,5,1
52643,80,1834,53,23,39,0,0,13,53,2,8,4,8,10,12,26,39,1,39,2,0,2,14,12,1
52644,80,1834,515,298,307,33,80,99,548,12,63,44,77,75,121,419,753,7,5527,307,0,2,14,12,1
52645,235,5585,722,423,573,19,0,135,741,12,172,101,199,184,300,1320,2257,6,15668,870,0,2,3,5,1
52646,235,5585,1508,847,911,44,250,301,1552,14,148,88,169,162,257,1120,1886,7,15077,837,0,2,3,5,1
52647,314,6932,72,33,56,0,4,12,72,1,1,1,1,2,2,0,2,0,1,0,0,2,15,18,1
52648,314,6932,1454,835,1044,76,110,219,1530,17,275,158,296,292,454,2297,3718,9,34017,1889,1,2,15,18,1
52649,1,62,37,13,25,0,6,6,37,1,2,1,2,3,3,2,4,0,2,0,0,2,3,0,1
52650,1,62,133,47,40,1,43,49,134,0,0,0,0,0,0,0,0,0,0,0,0,2,3,0,1
52651,31,716,601,196,481,2,23,85,603,8,63,36,72,71,108,400,664,4,3036,168,0,2,3,3,1
52652,31,716,156,79,106,5,16,28,161,5,14,8,15,19,23,64,97,2,261,14,0,2,3,3,1
52653,94,3938,1289,550,1043,56,32,155,1345,10,167,93,185,177,278,1266,2075,5,11498,638,0,2,1,1,1
52654,20,918,75,38,59,1,3,12,76,2,4,2,4,6,6,10,15,1,15,0,0,2,2,1,1
52655,136,5782,1782,648,1425,9,47,279,1791,8,171,97,189,179,286,1292,2140,4,9462,525,0,2,4,4,1
52656,95,4080,1020,354,843,12,15,144,1032,8,134,77,144,142,221,970,1580,4,6792,377,0,2,5,1,1
52657,2,145,53,23,39,0,0,13,53,2,8,4,8,10,12,26,39,1,39,2,0,2,11,0,1
52658,31,712,601,196,481,2,23,85,603,8,63,36,72,71,108,400,664,4,3036,168,0,2,1,1,0
52659,31,712,156,79,106,5,16,28,161,5,14,8,15,19,23,64,97,2,261,14,0,2,1,1,0
52660,43,3157,996,429,845,24,10,117,1020,7,76,50,88,83,138,494,879,4,3565,198,0,2,2,0,1
52663,43,3157,996,429,845,24,10,117,1020,7,76,50,88,83,138,494,879,4,3565,198,0,2,3,1,0
52665,98,2660,1523,757,1297,19,12,193,1542,12,193,117,230,205,347,1508,2664,7,19053,1058,0,2,2,4,1
52666,98,2660,701,378,504,33,58,109,734,13,110,68,126,123,194,794,1346,7,10027,557,0,2,2,4,1
52667,87,1836,402,202,227,24,74,80,426,12,52,33,61,64,94,339,564,7,3969,220,0,2,1,1,1
52668,82,1862,53,23,39,0,0,13,53,2,8,4,8,10,12,26,39,1,39,2,0,2,40,5,1
52669,82,1862,515,298,307,33,80,99,548,12,63,44,77,75,121,419,753,7,5527,307,0,2,40,5,1
52670,235,5585,722,423,573,19,0,135,741,12,172,101,199,184,300,1320,2257,6,15668,870,0,2,1,1,1
52671,235,5585,1508,847,911,44,250,301,1552,14,148,88,169,162,257,1120,1886,7,15077,837,0,2,1,1,1
52672,314,6932,72,33,56,0,4,12,72,1,1,1,1,2,2,0,2,0,1,0,0,2,5,5,1
52673,314,6932,1454,835,1044,76,110,219,1530,17,275,158,296,292,454,2297,3718,9,34017,1889,1,2,5,5,1
52674,90,4662,1457,730,1242,11,6,188,1468,10,292,166,329,302,495,2424,4078,5,22973,1276,1,2,1,1,1
52675,95,4080,1020,354,843,12,15,144,1032,8,134,77,144,142,221,970,1580,4,6792,377,0,2,1,1,1
52676,2,145,53,23,39,0,0,13,53,2,8,4,8,10,12,26,39,1,39,2,0,2,1,1,1
52677,52,622,647,139,84,35,284,233,682,0,0,0,0,0,0,0,0,0,0,0,0,2,5,2,0
52678,33,814,601,196,481,2,23,85,603,8,63,36,72,71,108,400,664,4,3036,168,0,2,28,6,0
52679,33,814,156,79,106,5,16,28,161,5,14,8,15,19,23,64,97,2,261,14,0,2,28,6,0
52680,34,1230,601,196,481,2,23,85,603,8,63,36,72,71,108,400,664,4,3036,168,0,2,32,4,0
52681,76,1714,996,429,845,24,10,117,1020,7,76,50,88,83,138,494,879,4,3565,198,0,2,5,4,0
52682,76,1714,456,277,329,12,42,72,468,13,85,50,97,98,147,592,972,7,7212,400,0,2,5,4,0
52683,166,5101,1660,832,1314,41,38,274,1701,20,312,209,395,332,604,2671,5058,12,64042,3557,1,2,2,2,1
52684,166,5101,1057,646,719,113,100,145,1170,18,215,134,248,233,382,1740,3004,10,31186,1732,1,2,2,2,1
52687,217,4685,2,2,2,0,0,0,2,0,0,0,0,0,0,0,0,0,0,0,0,2,5,4,1
52701,217,4685,99,48,90,1,3,5,100,0,0,0,0,0,0,0,0,0,0,0,0,2,5,4,1
52702,217,4685,8,5,5,2,0,1,10,0,0,0,0,0,0,0,0,0,0,0,0,2,5,4,1
52703,217,4685,1217,716,841,84,126,174,1301,14,185,118,215,199,333,1446,2542,8,20687,1149,0,2,5,4,1
52704,217,4685,160,89,115,0,13,31,160,7,15,11,17,22,28,78,124,3,495,27,0,2,5,4,1
52705,217,4685,10,10,9,9,0,0,19,0,0,0,0,0,0,0,0,0,0,0,0,2,5,4,1
52706,217,4685,173,84,99,8,29,36,181,5,12,7,13,17,20,54,81,2,221,12,0,2,5,4,1
52707,217,4685,3,1,1,3,0,0,6,0,0,0,0,0,0,0,0,0,0,0,0,2,5,4,1
52709,254,5841,4293,999,3693,19,54,507,4312,9,155,88,170,164,258,1156,1898,4,9368,520,0,2,4,2,1
52710,254,5841,1482,859,1002,125,135,219,1607,16,219,134,251,235,385,1766,3032,9,27804,1544,1,2,4,2,1
52711,314,6935,72,33,56,0,4,12,72,1,1,1,1,2,2,0,2,0,1,0,0,2,4,2,1
52712,314,6935,1454,835,1044,76,110,219,1530,17,275,158,296,292,454,2297,3718,9,34017,1889,1,2,4,2,1
52713,20,927,75,38,59,1,3,12,76,2,4,2,4,6,6,10,15,1,15,0,0,2,3,3,1
52714,86,1893,53,23,39,0,0,13,53,2,8,4,8,10,12,26,39,1,39,2,0,2,10,2,0
52715,86,1893,515,298,307,33,80,99,548,12,63,44,77,75,121,419,753,7,5527,307,0,2,10,2,0
52716,92,4702,1457,730,1242,11,6,188,1468,10,292,166,329,302,495,2424,4078,5,22973,1276,1,2,8,3,0
52717,313,6932,72,33,56,0,4,12,72,1,1,1,1,2,2,0,2,0,1,0,0,2,1,2,0
52718,313,6932,1454,835,1044,76,110,219,1530,17,275,158,296,292,454,2297,3718,9,34017,1889,1,2,1,2,0
52719,313,6930,72,33,56,0,4,12,72,1,1,1,1,2,2,0,2,0,1,0,0,2,3,3,0
52720,313,6930,1454,835,1044,76,110,219,1530,17,275,158,296,292,454,2297,3718,9,34017,1889,1,2,3,3,0
52721,136,5790,1782,648,1425,9,47,279,1791,8,171,97,189,179,286,1292,2140,4,9462,525,0,2,2,2,0
52722,52,622,647,139,84,35,284,233,682,0,0,0,0,0,0,0,0,0,0,0,0,2,2,5,0
52723,31,726,601,196,481,2,23,85,603,8,63,36,72,71,108,400,664,4,3036,168,0,2,2,18,0
52724,31,726,156,79,106,5,16,28,161,5,14,8,15,19,23,64,97,2,261,14,0,2,2,18,0
52725,34,1230,601,196,481,2,23,85,603,8,63,36,72,71,108,400,664,4,3036,168,0,2,3,3,0
52726,39,1718,386,256,301,16,9,68,402,4,59,35,69,63,104,355,621,2,1453,80,0,2,3,3,0
52727,136,5794,1782,648,1425,9,47,279,1791,8,171,97,189,179,286,1292,2140,4,9462,525,0,2,1,1,0
52728,86,1893,53,23,39,0,0,13,53,2,8,4,8,10,12,26,39,1,39,2,0,2,10,6,0
52729,86,1893,515,298,307,33,80,99,548,12,63,44,77,75,121,419,753,7,5527,307,0,2,10,6,0
52730,95,4101,1020,354,843,12,15,144,1032,8,134,77,144,142,221,970,1580,4,6792,377,0,2,7,2,0
52731,179,5366,1660,832,1314,41,38,274,1701,20,312,209,395,332,604,2671,5058,12,64042,3557,1,2,64,7,0
52732,179,5366,1057,646,719,113,100,145,1170,18,215,134,248,233,382,1740,3004,10,31186,1732,1,2,64,7,0
52733,141,3279,77,34,69,0,0,8,77,3,24,16,29,27,45,114,213,1,387,21,0,2,4,3,0
52734,141,3279,712,438,573,51,9,84,763,14,102,71,128,116,199,733,1364,8,11988,666,0,2,4,3,0
52736,31,726,601,196,481,2,23,85,603,8,63,36,72,71,108,400,664,4,3036,168,0,2,1,1,0
52737,31,726,156,79,106,5,16,28,161,5,14,8,15,19,23,64,97,2,261,14,0,2,1,1,0
52738,35,1271,601,196,481,2,23,85,603,8,63,36,72,71,108,400,664,4,3036,168,0,2,16,0,0
52739,166,5101,1660,832,1314,41,38,274,1701,20,312,209,395,332,604,2671,5058,12,64042,3557,1,2,16,8,0
52740,166,5101,1057,646,719,113,100,145,1170,18,215,134,248,233,382,1740,3004,10,31186,1732,1,2,16,8,0
52741,76,1714,996,429,845,24,10,117,1020,7,76,50,88,83,138,494,879,4,3565,198,0,2,8,3,0
52742,76,1714,456,277,329,12,42,72,468,13,85,50,97,98,147,592,972,7,7212,400,0,2,8,3,0
52745,217,4685,2,2,2,0,0,0,2,0,0,0,0,0,0,0,0,0,0,0,0,2,33,4,0
52759,217,4685,99,48,90,1,3,5,100,0,0,0,0,0,0,0,0,0,0,0,0,2,33,4,0
52760,217,4685,8,5,5,2,0,1,10,0,0,0,0,0,0,0,0,0,0,0,0,2,33,4,0
52761,217,4685,1217,716,841,84,126,174,1301,14,185,118,215,199,333,1446,2542,8,20687,1149,0,2,33,4,0
52762,217,4685,160,89,115,0,13,31,160,7,15,11,17,22,28,78,124,3,495,27,0,2,33,4,0
52763,217,4685,10,10,9,9,0,0,19,0,0,0,0,0,0,0,0,0,0,0,0,2,33,4,0
52764,217,4685,173,84,99,8,29,36,181,5,12,7,13,17,20,54,81,2,221,12,0,2,33,4,0
52765,217,4685,3,1,1,3,0,0,6,0,0,0,0,0,0,0,0,0,0,0,0,2,33,4,0
52766,51,767,167,116,138,4,5,22,171,8,48,30,56,56,86,292,499,4,2330,129,0,2,24,14,0
52768,254,5841,4293,999,3693,19,54,507,4312,9,155,88,170,164,258,1156,1898,4,9368,520,0,2,10,3,0
52769,254,5841,1482,859,1002,125,135,219,1607,16,219,134,251,235,385,1766,3032,9,27804,1544,1,2,10,3,0
52770,52,622,647,139,84,35,284,233,682,0,0,0,0,0,0,0,0,0,0,0,0,2,32,1,0
52771,98,2660,1523,757,1297,19,12,193,1542,12,193,117,230,205,347,1508,2664,7,19053,1058,0,2,5,6,0
52772,98,2660,701,378,504,33,58,109,734,13,110,68,126,123,194,794,1346,7,10027,557,0,2,5,6,0
52773,87,1836,402,202,227,24,74,80,426,12,52,33,61,64,94,339,564,7,3969,220,0,2,10,5,0
52774,86,1893,53,23,39,0,0,13,53,2,8,4,8,10,12,26,39,1,39,2,0,2,105,6,0
52775,86,1893,515,298,307,33,80,99,548,12,63,44,77,75,121,419,753,7,5527,307,0,2,105,6,0
52776,235,5585,722,423,573,19,0,135,741,12,172,101,199,184,300,1320,2257,6,15668,870,0,2,3,4,0
52777,235,5585,1508,847,911,44,250,301,1552,14,148,88,169,162,257,1120,1886,7,15077,837,0,2,3,4,0
52778,313,6930,72,33,56,0,4,12,72,1,1,1,1,2,2,0,2,0,1,0,0,2,40,36,0
52779,313,6930,1454,835,1044,76,110,219,1530,17,275,158,296,292,454,2297,3718,9,34017,1889,1,2,40,36,0
52780,30,663,215,129,180,6,0,29,221,8,65,43,72,73,115,415,711,4,3153,175,0,2,3,1,0
52781,30,663,97,69,77,3,3,16,100,6,22,13,23,28,36,113,173,3,542,30,0,2,3,1,0
52782,220,4815,1943,715,1694,26,18,214,1969,12,185,120,237,197,357,1436,2721,7,20915,1161,0,2,45,19,0
52783,220,4815,1168,838,957,57,25,144,1225,19,348,224,416,367,640,3018,5452,11,61921,3440,1,2,45,19,0
52784,1,62,37,13,25,0,6,6,37,1,2,1,2,3,3,2,4,0,2,0,0,0,42,0,0
52785,1,62,133,47,40,1,43,49,134,0,0,0,0,0,0,0,0,0,0,0,0,0,42,0,0
52786,31,726,601,196,481,2,23,85,603,8,63,36,72,71,108,400,664,4,3036,168,0,2,94,41,0
52787,31,726,156,79,106,5,16,28,161,5,14,8,15,19,23,64,97,2,261,14,0,2,94,41,0
52788,20,927,75,38,59,1,3,12,76,2,4,2,4,6,6,10,15,1,15,0,0,2,46,17,0
52789,102,4744,1338,495,1086,10,64,173,1348,11,122,82,157,133,239,883,1686,7,11934,663,0,2,31,26,0
52790,136,5794,1782,648,1425,9,47,279,1791,8,171,97,189,179,286,1292,2140,4,9462,525,0,2,8,44,0
52791,111,4170,1450,624,1228,12,26,181,1462,14,306,186,354,320,540,2580,4493,8,36391,2021,1,2,13,3,0
52792,156,4471,1660,832,1314,41,38,274,1701,20,312,209,395,332,604,2671,5058,12,64042,3557,1,2,10,10,0
52793,43,3157,996,429,845,24,10,117,1020,7,76,50,88,83,138,494,879,4,3565,198,0,2,5,0,0
52794,128,5332,1513,682,1277,25,13,200,1538,11,199,116,219,210,335,1557,2584,6,15641,868,0,2,4,3,0
52795,92,4702,1457,730,1242,11,6,188,1468,10,292,166,329,302,495,2424,4078,5,22973,1276,1,2,30,18,0
52796,95,4639,1523,757,1297,19,12,193,1542,12,193,117,230,205,347,1508,2664,7,19053,1058,0,2,2,1,0
52797,95,4101,1020,354,843,12,15,144,1032,8,134,77,144,142,221,970,1580,4,6792,377,0,2,12,3,0
52798,2,145,53,23,39,0,0,13,53,2,8,4,8,10,12,26,39,1,39,2,0,2,11,0,0
52800,16,1224,215,129,180,6,0,29,221,8,65,43,72,73,115,415,711,4,3153,175,0,2,3,0,0
52802,35,1271,601,196,481,2,23,85,603,8,63,36,72,71,108,400,664,4,3036,168,0,2,203,5,0
52806,179,5394,1660,832,1314,41,38,274,1701,20,312,209,395,332,604,2671,5058,12,64042,3557,1,2,64,7,0
52807,179,5394,1057,646,719,113,100,145,1170,18,215,134,248,233,382,1740,3004,10,31186,1732,1,2,64,7,0
52810,217,4691,2,2,2,0,0,0,2,0,0,0,0,0,0,0,0,0,0,0,0,2,3,1,0
52824,217,4691,99,48,90,1,3,5,100,0,0,0,0,0,0,0,0,0,0,0,0,2,3,1,0
52825,217,4691,8,5,5,2,0,1,10,0,0,0,0,0,0,0,0,0,0,0,0,2,3,1,0
52826,217,4691,1217,716,841,84,126,174,1301,14,185,118,215,199,333,1446,2542,8,20687,1149,0,2,3,1,0
52827,217,4691,160,89,115,0,13,31,160,7,15,11,17,22,28,78,124,3,495,27,0,2,3,1,0
52828,217,4691,10,10,9,9,0,0,19,0,0,0,0,0,0,0,0,0,0,0,0,2,3,1,0
52829,217,4691,173,84,99,8,29,36,181,5,12,7,13,17,20,54,81,2,221,12,0,2,3,1,0
52830,217,4691,3,1,1,3,0,0,6,0,0,0,0,0,0,0,0,0,0,0,0,2,3,1,0
52834,222,4835,1943,715,1694,26,18,214,1969,12,185,120,237,197,357,1436,2721,7,20915,1161,0,2,14,8,0
52835,222,4835,1168,838,957,57,25,144,1225,19,348,224,416,367,640,3018,5452,11,61921,3440,1,2,14,8,0
52836,161,4776,1660,832,1314,41,38,274,1701,20,312,209,395,332,604,2671,5058,12,64042,3557,1,2,93,14,0
52871,179,5394,1660,832,1314,41,38,274,1701,20,312,209,395,332,604,2671,5058,12,64042,3557,1,2,16,8,0
52872,179,5394,1057,646,719,113,100,145,1170,18,215,134,248,233,382,1740,3004,10,31186,1732,1,2,16,8,0
52873,76,1714,996,429,845,24,10,117,1020,7,76,50,88,83,138,494,879,4,3565,198,0,2,14,12,0
52874,76,1714,456,277,329,12,42,72,468,13,85,50,97,98,147,592,972,7,7212,400,0,2,14,12,0
52877,217,4691,2,2,2,0,0,0,2,0,0,0,0,0,0,0,0,0,0,0,0,2,41,5,0
52891,217,4691,99,48,90,1,3,5,100,0,0,0,0,0,0,0,0,0,0,0,0,2,41,5,0
52892,217,4691,8,5,5,2,0,1,10,0,0,0,0,0,0,0,0,0,0,0,0,2,41,5,0
52893,217,4691,1217,716,841,84,126,174,1301,14,185,118,215,199,333,1446,2542,8,20687,1149,0,2,41,5,0
52894,217,4691,160,89,115,0,13,31,160,7,15,11,17,22,28,78,124,3,495,27,0,2,41,5,0
52895,217,4691,10,10,9,9,0,0,19,0,0,0,0,0,0,0,0,0,0,0,0,2,41,5,0
52896,217,4691,173,84,99,8,29,36,181,5,12,7,13,17,20,54,81,2,221,12,0,2,41,5,0
52897,217,4691,3,1,1,3,0,0,6,0,0,0,0,0,0,0,0,0,0,0,0,2,41,5,0
52911,235,5585,722,423,573,19,0,135,741,12,172,101,199,184,300,1320,2257,6,15668,870,0,2,17,8,0
52912,235,5585,1508,847,911,44,250,301,1552,14,148,88,169,162,257,1120,1886,7,15077,837,0,2,17,8,0
52917,222,4835,1943,715,1694,26,18,214,1969,12,185,120,237,197,357,1436,2721,7,20915,1161,0,2,65,27,0
52918,222,4835,1168,838,957,57,25,144,1225,19,348,224,416,367,640,3018,5452,11,61921,3440,1,2,65,27,0
52928,161,4776,1660,832,1314,41,38,274,1701,20,312,209,395,332,604,2671,5058,12,64042,3557,1,2,10,10,0
52929,43,3157,996,429,845,24,10,117,1020,7,76,50,88,83,138,494,879,4,3565,198,0,2,23,20,0
52931,92,4702,1457,730,1242,11,6,188,1468,10,292,166,329,302,495,2424,4078,5,22973,1276,1,2,50,18,0
52935,44,2109,722,423,573,19,0,135,741,12,172,101,199,184,300,1320,2257,6,15668,870,0,2,51,0,0
52938,99,5044,1943,715,1694,26,18,214,1969,12,185,120,237,197,357,1436,2721,7,20915,1161,0,2,48,4,0
52940,139,5872,1782,648,1425,9,47,279,1791,8,171,97,189,179,286,1292,2140,4,9462,525,0,2,0,3,0
53010,136,5770,1782,648,1425,9,47,279,1791,8,171,97,189,179,286,1292,2140,4,9462,525,0,2,0,3,0
53012,31,729,601,196,481,2,23,85,603,8,63,36,72,71,108,400,664,4,3036,168,0,2,7,5,0
53013,31,729,156,79,106,5,16,28,161,5,14,8,15,19,23,64,97,2,261,14,0,2,7,5,0
53014,39,1392,601,196,481,2,23,85,603,8,63,36,72,71,108,400,664,4,3036,168,0,2,44,0,0
53015,35,1079,182,127,129,0,0,53,182,5,39,21,42,44,63,217,343,2,926,51,0,2,8,2,1
53016,35,1079,182,127,129,0,0,53,182,5,39,21,42,44,63,217,343,2,926,51,0,2,8,2,0
53017,313,6898,72,33,56,0,4,12,72,1,1,1,1,2,2,0,2,0,1,0,0,2,4,5,1
53018,313,6898,1454,835,1044,76,110,219,1530,17,275,158,296,292,454,2297,3718,9,34017,1889,1,2,4,5,1
53019,62,1231,1098,241,925,5,10,155,1103,7,46,25,49,53,74,273,423,3,1580,87,0,2,2,1,1
53020,62,1231,282,202,222,14,2,44,296,8,42,24,43,50,67,250,378,4,1548,86,0,2,2,1,1
53021,136,5770,1782,648,1425,9,47,279,1791,8,171,97,189,179,286,1292,2140,4,9462,525,0,2,2,6,1
53025,86,1927,53,23,39,0,0,13,53,2,8,4,8,10,12,26,39,1,39,2,0,2,8,5,0
53026,86,1927,515,298,307,33,80,99,548,12,63,44,77,75,121,419,753,7,5527,307,0,2,8,5,0
53027,313,6928,72,33,56,0,4,12,72,1,1,1,1,2,2,0,2,0,1,0,0,2,1,1,0
53028,313,6928,1454,835,1044,76,110,219,1530,17,275,158,296,292,454,2297,3718,9,34017,1889,1,2,1,1,0
53029,21,960,75,38,59,1,3,12,76,2,4,2,4,6,6,10,15,1,15,0,0,2,17,0,0
53030,254,5860,4293,999,3693,19,54,507,4312,9,155,88,170,164,258,1156,1898,4,9368,520,0,2,5,0,0
53031,254,5860,1482,859,1002,125,135,219,1607,16,219,134,251,235,385,1766,3032,9,27804,1544,1,2,5,0,0
53032,22,992,75,38,59,1,3,12,76,2,4,2,4,6,6,10,15,1,15,0,0,2,21,0,0
53033,177,7847,139,89,101,2,0,35,141,7,54,34,62,61,96,330,569,4,2287,127,0,2,2,0,0
53034,177,7847,7,5,5,0,0,2,7,1,2,1,2,3,3,2,4,0,2,0,0,2,2,0,0
53035,86,1955,53,23,39,0,0,13,53,2,8,4,8,10,12,26,39,1,39,2,0,2,7,4,0
53036,86,1955,515,298,307,33,80,99,548,12,63,44,77,75,121,419,753,7,5527,307,0,2,7,4,0
53037,23,1030,75,38,59,1,3,12,76,2,4,2,4,6,6,10,15,1,15,0,0,2,30,0,0
53038,313,6940,72,33,56,0,4,12,72,1,1,1,1,2,2,0,2,0,1,0,0,2,4,1,1
53039,313,6940,1454,835,1044,76,110,219,1530,17,275,158,296,292,454,2297,3718,9,34017,1889,1,2,4,1,1
53040,102,4762,1338,495,1086,10,64,173,1348,11,122,82,157,133,239,883,1686,7,11934,663,0,2,6,0,1
53041,313,6898,72,33,56,0,4,12,72,1,1,1,1,2,2,0,2,0,1,0,0,2,4,5,0
53042,313,6898,1454,835,1044,76,110,219,1530,17,275,158,296,292,454,2297,3718,9,34017,1889,1,2,4,5,0
53043,62,1231,1098,241,925,5,10,155,1103,7,46,25,49,53,74,273,423,3,1580,87,0,2,2,1,0
53044,62,1231,282,202,222,14,2,44,296,8,42,24,43,50,67,250,378,4,1548,86,0,2,2,1,0
53045,136,5770,1782,648,1425,9,47,279,1791,8,171,97,189,179,286,1292,2140,4,9462,525,0,2,2,6,0
53047,254,5857,4293,999,3693,19,54,507,4312,9,155,88,170,164,258,1156,1898,4,9368,520,0,2,3,5,0
53048,254,5857,1482,859,1002,125,135,219,1607,16,219,134,251,235,385,1766,3032,9,27804,1544,1,2,3,5,0
53049,86,1965,53,23,39,0,0,13,53,2,8,4,8,10,12,26,39,1,39,2,0,2,10,9,0
53050,86,1965,515,298,307,33,80,99,548,12,63,44,77,75,121,419,753,7,5527,307,0,2,10,9,0
53051,51,757,167,116,138,4,5,22,171,8,48,30,56,56,86,292,499,4,2330,129,0,2,3,6,1
53052,1,210,42,7,23,2,8,9,44,0,0,0,0,0,0,0,0,0,0,0,0,2,40,12,1
53053,254,5844,4293,999,3693,19,54,507,4312,9,155,88,170,164,258,1156,1898,4,9368,520,0,2,6,7,1
53054,254,5844,1482,859,1002,125,135,219,1607,16,219,134,251,235,385,1766,3032,9,27804,1544,1,2,6,7,1
53055,86,1952,53,23,39,0,0,13,53,2,8,4,8,10,12,26,39,1,39,2,0,2,2,10,1
53056,86,1952,515,298,307,33,80,99,548,12,63,44,77,75,121,419,753,7,5527,307,0,2,2,10,1
53057,30,654,215,129,180,6,0,29,221,8,65,43,72,73,115,415,711,4,3153,175,0,2,1,2,1
53058,30,654,97,69,77,3,3,16,100,6,22,13,23,28,36,113,173,3,542,30,0,2,1,2,1
53059,76,1736,996,429,845,24,10,117,1020,7,76,50,88,83,138,494,879,4,3565,198,0,2,6,3,0
53060,76,1736,456,277,329,12,42,72,468,13,85,50,97,98,147,592,972,7,7212,400,0,2,6,3,0
53061,44,3214,996,429,845,24,10,117,1020,7,76,50,88,83,138,494,879,4,3565,198,0,2,11,0,0
53062,177,7850,139,89,101,2,0,35,141,7,54,34,62,61,96,330,569,4,2287,127,0,2,18,14,1
53063,177,7850,7,5,5,0,0,2,7,1,2,1,2,3,3,2,4,0,2,0,0,2,18,14,1
53065,2,114,37,13,25,0,6,6,37,1,2,1,2,3,3,2,4,0,2,0,0,2,18,0,1
53066,2,114,133,47,40,1,43,49,134,0,0,0,0,0,0,0,0,0,0,0,0,2,18,0,1
53067,313,6905,72,33,56,0,4,12,72,1,1,1,1,2,2,0,2,0,1,0,0,2,10,5,0
53068,313,6905,1454,835,1044,76,110,219,1530,17,275,158,296,292,454,2297,3718,9,34017,1889,1,2,10,5,0
53069,139,6150,1782,648,1425,9,47,279,1791,8,171,97,189,179,286,1292,2140,4,9462,525,0,2,79,0,0
53070,51,757,167,116,138,4,5,22,171,8,48,30,56,56,86,292,499,4,2330,129,0,2,3,6,0
53072,254,5844,4293,999,3693,19,54,507,4312,9,155,88,170,164,258,1156,1898,4,9368,520,0,2,9,7,0
53073,254,5844,1482,859,1002,125,135,219,1607,16,219,134,251,235,385,1766,3032,9,27804,1544,1,2,9,7,0
53074,86,1952,53,23,39,0,0,13,53,2,8,4,8,10,12,26,39,1,39,2,0,2,8,9,0
53075,86,1952,515,298,307,33,80,99,548,12,63,44,77,75,121,419,753,7,5527,307,0,2,8,9,0
53076,313,6940,72,33,56,0,4,12,72,1,1,1,1,2,2,0,2,0,1,0,0,2,4,1,0
53077,313,6940,1454,835,1044,76,110,219,1530,17,275,158,296,292,454,2297,3718,9,34017,1889,1,2,4,1,0
53078,30,654,215,129,180,6,0,29,221,8,65,43,72,73,115,415,711,4,3153,175,0,2,1,2,0
53079,30,654,97,69,77,3,3,16,100,6,22,13,23,28,36,113,173,3,542,30,0,2,1,2,0
53080,2,114,37,13,25,0,6,6,37,1,2,1,2,3,3,2,4,0,2,0,0,2,18,0,0
53081,2,114,133,47,40,1,43,49,134,0,0,0,0,0,0,0,0,0,0,0,0,2,18,0,0
53082,23,1030,75,38,59,1,3,12,76,2,4,2,4,6,6,10,15,1,15,0,0,2,68,0,0
53083,102,4762,1338,495,1086,10,64,173,1348,11,122,82,157,133,239,883,1686,7,11934,663,0,2,6,0,0
53088,177,7850,139,89,101,2,0,35,141,7,54,34,62,61,96,330,569,4,2287,127,0,2,18,14,0
53089,177,7850,7,5,5,0,0,2,7,1,2,1,2,3,3,2,4,0,2,0,0,2,18,14,0
53093,24,607,2,2,2,0,0,0,2,0,0,0,0,0,0,0,0,0,0,0,0,2,2,2,0
53107,24,607,99,48,90,1,3,5,100,0,0,0,0,0,0,0,0,0,0,0,0,2,2,2,0
53108,24,607,8,5,5,2,0,1,10,0,0,0,0,0,0,0,0,0,0,0,0,2,2,2,0
53109,24,607,1217,716,841,84,126,174,1301,14,185,118,215,199,333,1446,2542,8,20687,1149,0,2,2,2,0
53110,24,607,160,89,115,0,13,31,160,7,15,11,17,22,28,78,124,3,495,27,0,2,2,2,0
53111,24,607,10,10,9,9,0,0,19,0,0,0,0,0,0,0,0,0,0,0,0,2,2,2,0
53112,24,607,173,84,99,8,29,36,181,5,12,7,13,17,20,54,81,2,221,12,0,2,2,2,0
53113,24,607,3,1,1,3,0,0,6,0,0,0,0,0,0,0,0,0,0,0,0,2,2,2,0
53114,88,1873,402,202,227,24,74,80,426,12,52,33,61,64,94,339,564,7,3969,220,0,2,8,0,0
53115,96,4196,1020,354,843,12,15,144,1032,8,134,77,144,142,221,970,1580,4,6792,377,0,2,37,2,0
53116,180,5401,1660,832,1314,41,38,274,1701,20,312,209,395,332,604,2671,5058,12,64042,3557,1,2,5,1,0
53117,180,5401,1057,646,719,113,100,145,1170,18,215,134,248,233,382,1740,3004,10,31186,1732,1,2,5,1,0
53118,162,4835,1660,832,1314,41,38,274,1701,20,312,209,395,332,604,2671,5058,12,64042,3557,1,2,24,0,0
53119,178,5362,1660,832,1314,41,38,274,1701,20,312,209,395,332,604,2671,5058,12,64042,3557,1,2,4,15,0
53120,178,5362,1057,646,719,113,100,145,1170,18,215,134,248,233,382,1740,3004,10,31186,1732,1,2,4,15,0
53121,67,1349,207,111,150,11,0,50,218,5,26,19,36,31,55,133,272,3,943,52,0,2,11,3,0
53122,67,1349,410,198,237,31,55,97,441,11,63,38,72,74,110,414,683,6,4293,238,0,2,11,3,0
53123,7,164,167,116,138,4,5,22,171,8,48,30,56,56,86,292,499,4,2330,129,0,2,37,2,0
53149,88,2299,773,422,505,30,103,129,803,14,77,46,83,91,129,535,839,7,6334,351,0,2,26,15,0
53150,32,2102,1157,318,931,29,22,177,1186,6,104,63,125,110,188,712,1274,3,4596,255,0,2,20,0,0
53151,33,2202,1157,318,931,29,22,177,1186,6,104,63,125,110,188,712,1274,3,4596,255,0,2,38,0,0
53152,7,164,167,116,138,4,5,22,171,8,48,30,56,56,86,292,499,4,2330,129,0,2,4,0,0
53153,7,164,167,116,138,4,5,22,171,8,48,30,56,56,86,292,499,4,2330,129,0,2,1,1,0
53154,88,2299,773,422,505,30,103,129,803,14,77,46,83,91,129,535,839,7,6334,351,0,2,1,1,0
53155,85,2238,773,422,505,30,103,129,803,14,77,46,83,91,129,535,839,7,6334,351,0,2,1,1,0
53156,62,2790,1293,570,1093,25,15,163,1318,10,195,123,241,205,364,1516,2795,6,17273,959,0,2,18,0,0
53157,178,5362,1660,832,1314,41,38,274,1701,20,312,209,395,332,604,2671,5058,12,64042,3557,1,2,5,12,0
53158,178,5362,1057,646,719,113,100,145,1170,18,215,134,248,233,382,1740,3004,10,31186,1732,1,2,5,12,0
53161,7,164,167,116,138,4,5,22,171,8,48,30,56,56,86,292,499,4,2330,129,0,2,41,2,0
53164,33,2202,1157,318,931,29,22,177,1186,6,104,63,125,110,188,712,1274,3,4596,255,0,2,58,0,0
53170,180,5384,1660,832,1314,41,38,274,1701,20,312,209,395,332,604,2671,5058,12,64042,3557,1,2,9,4,1
53171,180,5384,1057,646,719,113,100,145,1170,18,215,134,248,233,382,1740,3004,10,31186,1732,1,2,9,4,1
53172,165,4899,1660,832,1314,41,38,274,1701,20,312,209,395,332,604,2671,5058,12,64042,3557,1,2,17,1,1
53173,180,5384,1660,832,1314,41,38,274,1701,20,312,209,395,332,604,2671,5058,12,64042,3557,1,2,9,4,0
53174,180,5384,1057,646,719,113,100,145,1170,18,215,134,248,233,382,1740,3004,10,31186,1732,1,2,9,4,0
53175,165,4899,1660,832,1314,41,38,274,1701,20,312,209,395,332,604,2671,5058,12,64042,3557,1,2,17,1,0
53176,141,3284,77,34,69,0,0,8,77,3,24,16,29,27,45,114,213,1,387,21,0,2,4,3,0
53177,141,3284,712,438,573,51,9,84,763,14,102,71,128,116,199,733,1364,8,11988,666,0,2,4,3,0
53205,103,4779,1338,495,1086,10,64,173,1348,11,122,82,157,133,239,883,1686,7,11934,663,0,2,7,0,0
53236,48,992,447,308,343,6,5,95,453,7,96,59,111,103,170,651,1136,4,4600,255,0,2,2,2,0
53237,48,992,322,174,179,16,74,51,338,10,41,26,46,51,72,252,408,5,2291,127,0,2,2,2,0
53240,29,716,601,196,481,2,23,85,603,8,63,36,72,71,108,400,664,4,3036,168,0,2,5,7,0
53241,29,716,156,79,106,5,16,28,161,5,14,8,15,19,23,64,97,2,261,14,0,2,5,7,0
53242,40,1425,601,196,481,2,23,85,603,8,63,36,72,71,108,400,664,4,3036,168,0,2,22,4,0
53243,180,5384,1660,832,1314,41,38,274,1701,20,312,209,395,332,604,2671,5058,12,64042,3557,1,2,14,16,0
53244,180,5384,1057,646,719,113,100,145,1170,18,215,134,248,233,382,1740,3004,10,31186,1732,1,2,14,16,0
53255,313,6915,72,33,56,0,4,12,72,1,1,1,1,2,2,0,2,0,1,0,0,2,14,10,0
53256,313,6915,1454,835,1044,76,110,219,1530,17,275,158,296,292,454,2297,3718,9,34017,1889,1,2,14,10,0
53287,103,4797,1338,495,1086,10,64,173,1348,11,122,82,157,133,239,883,1686,7,11934,663,0,2,7,0,0
53288,177,7868,139,89,101,2,0,35,141,7,54,34,62,61,96,330,569,4,2287,127,0,2,18,14,0
53289,177,7868,7,5,5,0,0,2,7,1,2,1,2,3,3,2,4,0,2,0,0,2,18,14,0
53290,139,6150,1782,648,1425,9,47,279,1791,8,171,97,189,179,286,1292,2140,4,9462,525,0,2,81,6,0
53291,165,4899,1660,832,1314,41,38,274,1701,20,312,209,395,332,604,2671,5058,12,64042,3557,1,2,41,1,0
53348,180,5387,1660,832,1314,41,38,274,1701,20,312,209,395,332,604,2671,5058,12,64042,3557,1,2,10,10,0
53349,180,5387,1057,646,719,113,100,145,1170,18,215,134,248,233,382,1740,3004,10,31186,1732,1,2,10,10,0
53350,166,4970,1660,832,1314,41,38,274,1701,20,312,209,395,332,604,2671,5058,12,64042,3557,1,2,42,0,0
53354,31,946,339,213,244,17,9,65,356,10,42,26,48,52,74,259,421,5,2410,133,0,2,0,16,1
53355,62,2798,1293,570,1093,25,15,163,1318,10,195,123,241,205,364,1516,2795,6,17273,959,0,2,7,1,1
53356,52,622,647,139,84,35,284,233,682,0,0,0,0,0,0,0,0,0,0,0,0,2,3,0,0
53357,223,4840,1943,715,1694,26,18,214,1969,12,185,120,237,197,357,1436,2721,7,20915,1161,0,2,4,3,0
53358,223,4840,1168,838,957,57,25,144,1225,19,348,224,416,367,640,3018,5452,11,61921,3440,1,2,4,3,0
53359,28,725,466,257,367,18,25,50,484,7,126,86,171,133,257,898,1813,4,8612,478,0,2,6,1,0
53360,28,725,507,281,342,29,59,88,536,10,53,29,57,63,86,336,514,5,2764,153,0,2,6,1,0
53361,28,707,466,257,367,18,25,50,484,7,126,86,171,133,257,898,1813,4,8612,478,0,2,1,6,0
53362,28,707,507,281,342,29,59,88,536,10,53,29,57,63,86,336,514,5,2764,153,0,2,1,6,0
53363,99,5070,1943,715,1694,26,18,214,1969,12,185,120,237,197,357,1436,2721,7,20915,1161,0,2,11,3,0
53364,20,893,75,38,59,1,3,12,76,2,4,2,4,6,6,10,15,1,15,0,0,2,4,13,0
53367,218,4705,2,2,2,0,0,0,2,0,0,0,0,0,0,0,0,0,0,0,0,2,6,1,0
53381,218,4705,99,48,90,1,3,5,100,0,0,0,0,0,0,0,0,0,0,0,0,2,6,1,0
53382,218,4705,8,5,5,2,0,1,10,0,0,0,0,0,0,0,0,0,0,0,0,2,6,1,0
53383,218,4705,1217,716,841,84,126,174,1301,14,185,118,215,199,333,1446,2542,8,20687,1149,0,2,6,1,0
53384,218,4705,160,89,115,0,13,31,160,7,15,11,17,22,28,78,124,3,495,27,0,2,6,1,0
53385,218,4705,10,10,9,9,0,0,19,0,0,0,0,0,0,0,0,0,0,0,0,2,6,1,0
53386,218,4705,173,84,99,8,29,36,181,5,12,7,13,17,20,54,81,2,221,12,0,2,6,1,0
53387,218,4705,3,1,1,3,0,0,6,0,0,0,0,0,0,0,0,0,0,0,0,2,6,1,0
53388,21,1042,75,38,59,1,3,12,76,2,4,2,4,6,6,10,15,1,15,0,0,2,29,1,0
53389,39,2322,652,304,544,16,6,88,668,6,89,51,101,95,152,591,998,3,3399,188,0,2,1,0,0
53393,28,707,466,257,367,18,25,50,484,7,126,86,171,133,257,898,1813,4,8612,478,0,2,2,2,0
53394,28,707,507,281,342,29,59,88,536,10,53,29,57,63,86,336,514,5,2764,153,0,2,2,2,0
53419,21,1042,75,38,59,1,3,12,76,2,4,2,4,6,6,10,15,1,15,0,0,2,33,14,0
53421,23,367,102,57,55,5,16,25,107,5,17,10,18,22,28,81,124,2,330,18,0,2,4,1,0
53422,92,4051,1020,354,843,12,15,144,1032,8,134,77,144,142,221,970,1580,4,6792,377,0,2,12,0,0
53424,96,4133,1020,354,843,12,15,144,1032,8,134,77,144,142,221,970,1580,4,6792,377,0,2,12,0,0
53425,51,1046,447,308,343,6,5,95,453,7,96,59,111,103,170,651,1136,4,4600,255,0,2,14,0,0
53426,51,1046,322,174,179,16,74,51,338,10,41,26,46,51,72,252,408,5,2291,127,0,2,14,0,0
53427,41,1806,447,308,343,6,5,95,453,7,96,59,111,103,170,651,1136,4,4600,255,0,2,26,0,0
53428,91,2946,773,419,590,28,0,166,801,10,204,113,217,214,330,1598,2554,5,13587,754,0,2,1,1,0
53429,46,955,386,256,301,16,9,68,402,4,59,35,69,63,104,355,621,2,1453,80,0,2,2,0,0
53430,46,955,264,131,164,11,41,46,275,6,38,22,40,44,62,214,338,3,1068,59,0,2,2,0,0
53431,52,1071,447,308,343,6,5,95,453,7,96,59,111,103,170,651,1136,4,4600,255,0,2,9,1,1
53432,52,1071,322,174,179,16,74,51,338,10,41,26,46,51,72,252,408,5,2291,127,0,2,9,1,1
53433,95,3964,1289,550,1043,56,32,155,1345,10,167,93,185,177,278,1266,2075,5,11498,638,0,2,2,2,1
53434,44,3226,996,429,845,24,10,117,1020,7,76,50,88,83,138,494,879,4,3565,198,0,2,7,7,1
53435,95,4642,1523,757,1297,19,12,193,1542,12,193,117,230,205,347,1508,2664,7,19053,1058,0,2,1,1,1
53436,42,1899,447,308,343,6,5,95,453,7,96,59,111,103,170,651,1136,4,4600,255,0,2,20,7,1
53437,52,1071,447,308,343,6,5,95,453,7,96,59,111,103,170,651,1136,4,4600,255,0,2,23,1,0
53438,52,1071,322,174,179,16,74,51,338,10,41,26,46,51,72,252,408,5,2291,127,0,2,23,1,0
53441,95,3964,1289,550,1043,56,32,155,1345,10,167,93,185,177,278,1266,2075,5,11498,638,0,2,2,2,0
53443,44,3226,996,429,845,24,10,117,1020,7,76,50,88,83,138,494,879,4,3565,198,0,2,7,7,0
53444,95,4642,1523,757,1297,19,12,193,1542,12,193,117,230,205,347,1508,2664,7,19053,1058,0,2,1,1,0
53445,42,1899,447,308,343,6,5,95,453,7,96,59,111,103,170,651,1136,4,4600,255,0,2,42,3,0
53483,24,1145,75,38,59,1,3,12,76,2,4,2,4,6,6,10,15,1,15,0,0,2,33,14,0
53488,97,4228,1020,354,843,12,15,144,1032,8,134,77,144,142,221,970,1580,4,6792,377,0,2,12,0,0
53491,68,1571,773,419,590,28,0,166,801,10,204,113,217,214,330,1598,2554,5,13587,754,0,2,2,46,0
53492,68,1571,421,273,302,44,34,57,465,17,81,59,107,98,166,583,1098,11,12329,684,0,2,2,46,0
53493,91,2922,773,419,590,28,0,166,801,10,204,113,217,214,330,1598,2554,5,13587,754,0,2,9,15,0
53539,90,2885,773,419,590,28,0,166,801,10,204,113,217,214,330,1598,2554,5,13587,754,0,2,2,10,0
53540,68,1561,773,419,590,28,0,166,801,10,204,113,217,214,330,1598,2554,5,13587,754,0,2,4,11,0
53541,68,1561,421,273,302,44,34,57,465,17,81,59,107,98,166,583,1098,11,12329,684,0,2,4,11,0
53542,254,5861,4293,999,3693,19,54,507,4312,9,155,88,170,164,258,1156,1898,4,9368,520,0,2,4,2,0
53543,254,5861,1482,859,1002,125,135,219,1607,16,219,134,251,235,385,1766,3032,9,27804,1544,1,2,4,2,0
53544,4,61,20,12,12,0,0,8,20,1,2,1,2,3,3,2,4,0,2,0,0,0,20,0,0
53545,178,7880,139,89,101,2,0,35,141,7,54,34,62,61,96,330,569,4,2287,127,0,2,6,0,0
53546,178,7880,7,5,5,0,0,2,7,1,2,1,2,3,3,2,4,0,2,0,0,2,6,0,0
53547,256,5900,4293,999,3693,19,54,507,4312,9,155,88,170,164,258,1156,1898,4,9368,520,0,2,18,3,0
53548,256,5900,1482,859,1002,125,135,219,1607,16,219,134,251,235,385,1766,3032,9,27804,1544,1,2,18,3,0
53549,2,51,14,9,9,0,0,5,14,0,0,0,0,0,0,0,0,0,0,0,0,0,13,0,0
53550,177,7850,139,89,101,2,0,35,141,7,54,34,62,61,96,330,569,4,2287,127,0,2,8,4,0
53551,177,7850,7,5,5,0,0,2,7,1,2,1,2,3,3,2,4,0,2,0,0,2,8,4,0
53552,51,1913,1098,241,925,5,10,155,1103,7,46,25,49,53,74,273,423,3,1580,87,0,2,12,0,0
53553,68,1561,773,419,590,28,0,166,801,10,204,113,217,214,330,1598,2554,5,13587,754,0,2,6,57,0
53554,68,1561,421,273,302,44,34,57,465,17,81,59,107,98,166,583,1098,11,12329,684,0,2,6,57,0
53555,90,2885,773,419,590,28,0,166,801,10,204,113,217,214,330,1598,2554,5,13587,754,0,2,9,23,0
53556,11,415,42,7,35,4,0,5,46,1,2,1,2,3,3,2,4,0,2,0,0,2,1,0,1
53557,11,415,11,6,10,0,0,1,11,2,4,2,4,6,6,10,15,1,15,0,0,2,1,0,1
53558,242,5716,722,423,573,19,0,135,741,12,172,101,199,184,300,1320,2257,6,15668,870,0,2,33,3,1
53559,242,5716,1508,847,911,44,250,301,1552,14,148,88,169,162,257,1120,1886,7,15077,837,0,2,33,3,1
53560,46,2172,722,423,573,19,0,135,741,12,172,101,199,184,300,1320,2257,6,15668,870,0,2,18,0,1
53561,242,5718,722,423,573,19,0,135,741,12,172,101,199,184,300,1320,2257,6,15668,870,0,2,1,1,0
53562,242,5718,1508,847,911,44,250,301,1552,14,148,88,169,162,257,1120,1886,7,15077,837,0,2,1,1,0
53570,46,2170,722,423,573,19,0,135,741,12,172,101,199,184,300,1320,2257,6,15668,870,0,2,1,2,0
53571,11,413,42,7,35,4,0,5,46,1,2,1,2,3,3,2,4,0,2,0,0,2,0,1,0
53572,11,413,11,6,10,0,0,1,11,2,4,2,4,6,6,10,15,1,15,0,0,2,0,1,0
53573,242,5716,722,423,573,19,0,135,741,12,172,101,199,184,300,1320,2257,6,15668,870,0,2,2,3,0
53574,242,5716,1508,847,911,44,250,301,1552,14,148,88,169,162,257,1120,1886,7,15077,837,0,2,2,3,0
53575,242,5735,722,423,573,19,0,135,741,12,172,101,199,184,300,1320,2257,6,15668,870,0,2,8,2,0
53576,242,5735,1508,847,911,44,250,301,1552,14,148,88,169,162,257,1120,1886,7,15077,837,0,2,8,2,0
53577,243,5749,722,423,573,19,0,135,741,12,172,101,199,184,300,1320,2257,6,15668,870,0,2,11,6,0
53578,243,5749,1508,847,911,44,250,301,1552,14,148,88,169,162,257,1120,1886,7,15077,837,0,2,11,6,0
53579,243,5757,722,423,573,19,0,135,741,12,172,101,199,184,300,1320,2257,6,15668,870,0,2,3,1,1
53580,243,5757,1508,847,911,44,250,301,1552,14,148,88,169,162,257,1120,1886,7,15077,837,0,2,3,1,1
53581,47,2227,722,423,573,19,0,135,741,12,172,101,199,184,300,1320,2257,6,15668,870,0,2,13,0,1
53582,47,2225,722,423,573,19,0,135,741,12,172,101,199,184,300,1320,2257,6,15668,870,0,2,1,1,0
53583,242,5792,722,423,573,19,0,135,741,12,172,101,199,184,300,1320,2257,6,15668,870,0,2,21,14,0
53584,242,5792,1508,847,911,44,250,301,1552,14,148,88,169,162,257,1120,1886,7,15077,837,0,2,21,14,0
53585,241,5777,722,423,573,19,0,135,741,12,172,101,199,184,300,1320,2257,6,15668,870,0,2,1,6,0
53586,241,5777,1508,847,911,44,250,301,1552,14,148,88,169,162,257,1120,1886,7,15077,837,0,2,1,6,0
53587,243,5819,722,423,573,19,0,135,741,12,172,101,199,184,300,1320,2257,6,15668,870,0,2,12,2,1
53588,243,5819,1508,847,911,44,250,301,1552,14,148,88,169,162,257,1120,1886,7,15077,837,0,2,12,2,1
53589,243,5819,722,423,573,19,0,135,741,12,172,101,199,184,300,1320,2257,6,15668,870,0,2,0,1,0
53590,243,5819,1508,847,911,44,250,301,1552,14,148,88,169,162,257,1120,1886,7,15077,837,0,2,0,1,0
53591,244,5784,722,423,573,19,0,135,741,12,172,101,199,184,300,1320,2257,6,15668,870,0,2,14,21,0
53592,244,5784,1508,847,911,44,250,301,1552,14,148,88,169,162,257,1120,1886,7,15077,837,0,2,14,21,0
53593,244,5775,722,423,573,19,0,135,741,12,172,101,199,184,300,1320,2257,6,15668,870,0,2,1,4,1
53594,244,5775,1508,847,911,44,250,301,1552,14,148,88,169,162,257,1120,1886,7,15077,837,0,2,1,4,1
53596,244,5775,722,423,573,19,0,135,741,12,172,101,199,184,300,1320,2257,6,15668,870,0,2,8,0,0
53597,244,5775,1508,847,911,44,250,301,1552,14,148,88,169,162,257,1120,1886,7,15077,837,0,2,8,0,0
53598,244,5770,722,423,573,19,0,135,741,12,172,101,199,184,300,1320,2257,6,15668,870,0,2,1,2,0
53599,244,5770,1508,847,911,44,250,301,1552,14,148,88,169,162,257,1120,1886,7,15077,837,0,2,1,2,0
53600,256,5920,4293,999,3693,19,54,507,4312,9,155,88,170,164,258,1156,1898,4,9368,520,0,2,18,3,0
53601,256,5920,1482,859,1002,125,135,219,1607,16,219,134,251,235,385,1766,3032,9,27804,1544,1,2,18,3,0
53603,178,7880,139,89,101,2,0,35,141,7,54,34,62,61,96,330,569,4,2287,127,0,2,8,4,0
53604,178,7880,7,5,5,0,0,2,7,1,2,1,2,3,3,2,4,0,2,0,0,2,8,4,0
53606,244,5779,722,423,573,19,0,135,741,12,172,101,199,184,300,1320,2257,6,15668,870,0,2,6,0,0
53607,244,5779,1508,847,911,44,250,301,1552,14,148,88,169,162,257,1120,1886,7,15077,837,0,2,6,0,0
53609,244,5779,722,423,573,19,0,135,741,12,172,101,199,184,300,1320,2257,6,15668,870,0,2,59,3,0
53610,244,5779,1508,847,911,44,250,301,1552,14,148,88,169,162,257,1120,1886,7,15077,837,0,2,59,3,0
53611,47,2225,722,423,573,19,0,135,741,12,172,101,199,184,300,1320,2257,6,15668,870,0,2,30,0,0
53612,92,1945,1043,504,840,53,9,147,1096,9,180,112,198,189,310,1377,2344,4,11604,644,0,2,3,0,0
53613,92,1945,383,288,292,26,6,62,409,11,65,38,67,76,105,429,656,5,3719,206,0,2,3,0,0
53614,101,4044,1289,550,1043,56,32,155,1345,10,167,93,185,177,278,1266,2075,5,11498,638,0,2,23,9,0
53616,3,42,14,8,8,0,0,6,14,0,0,0,0,0,0,0,0,0,0,0,0,2,0,1,1
53617,60,1079,282,196,195,3,0,86,285,8,130,71,141,138,212,936,1507,4,6538,363,0,2,3,3,1
53618,1,9,5,3,3,0,0,2,5,0,0,0,0,0,0,0,0,0,0,0,0,2,0,1,1
53619,1,90,13,10,10,0,0,3,13,1,2,1,2,3,3,2,4,0,2,0,0,2,0,1,1
53637,11,238,19,8,11,5,0,4,24,2,5,3,6,7,9,13,25,1,30,1,0,2,0,1,1
53638,11,238,102,59,69,5,3,24,107,6,22,15,28,28,43,113,206,3,789,43,0,2,0,1,1
53639,11,238,106,40,36,3,49,17,109,8,17,13,23,25,36,93,167,5,904,50,0,2,0,1,1
53642,218,4706,2,2,2,0,0,0,2,0,0,0,0,0,0,0,0,0,0,0,0,2,1,1,1
53656,218,4706,99,48,90,1,3,5,100,0,0,0,0,0,0,0,0,0,0,0,0,2,1,1,1
53657,218,4706,8,5,5,2,0,1,10,0,0,0,0,0,0,0,0,0,0,0,0,2,1,1,1
53658,218,4706,1217,716,841,84,126,174,1301,14,185,118,215,199,333,1446,2542,8,20687,1149,0,2,1,1,1
53659,218,4706,160,89,115,0,13,31,160,7,15,11,17,22,28,78,124,3,495,27,0,2,1,1,1
53660,218,4706,10,10,9,9,0,0,19,0,0,0,0,0,0,0,0,0,0,0,0,2,1,1,1
53661,218,4706,173,84,99,8,29,36,181,5,12,7,13,17,20,54,81,2,221,12,0,2,1,1,1
53662,218,4706,3,1,1,3,0,0,6,0,0,0,0,0,0,0,0,0,0,0,0,2,1,1,1
53663,98,2660,1523,757,1297,19,12,193,1542,12,193,117,230,205,347,1508,2664,7,19053,1058,0,2,1,1,1
53664,98,2660,701,378,504,33,58,109,734,13,110,68,126,123,194,794,1346,7,10027,557,0,2,1,1,1
53665,85,2240,773,422,505,30,103,129,803,14,77,46,83,91,129,535,839,7,6334,351,0,2,3,1,1
53666,30,660,125,97,103,3,0,19,128,9,25,17,27,34,44,144,223,4,1087,60,0,2,4,1,1
53667,1,20,127,75,83,2,11,30,129,4,14,7,14,18,21,61,87,2,175,9,0,2,0,1,1
53668,1,20,652,304,544,16,6,88,668,6,89,51,101,95,152,591,998,3,3399,188,0,2,0,1,1
53669,1,20,2,2,2,0,0,0,2,0,0,0,0,0,0,0,0,0,0,0,0,2,0,1,1
53670,1,20,8,5,5,0,0,3,8,0,0,0,0,0,0,0,0,0,0,0,0,2,0,1,1
53673,1,20,14,8,8,0,0,6,14,0,0,0,0,0,0,0,0,0,0,0,0,2,0,1,1
53674,1,20,6,4,4,0,0,2,6,0,0,0,0,0,0,0,0,0,0,0,0,2,0,1,1
53675,1,20,6,4,4,0,0,2,6,1,2,1,2,3,3,2,4,0,2,0,0,2,0,1,1
53677,1,20,7,5,5,0,0,2,7,0,0,0,0,0,0,0,0,0,0,0,0,2,0,1,1
53679,1,20,10,6,6,0,0,4,10,0,0,0,0,0,0,0,0,0,0,0,0,2,0,1,1
53680,1,20,1,1,1,0,0,0,1,0,0,0,0,0,0,0,0,0,0,0,0,2,0,1,1
53682,1,20,14,10,10,0,0,4,14,1,1,1,1,2,2,0,2,0,1,0,0,2,0,1,1
53683,1,20,46,26,30,3,0,12,49,3,6,3,6,9,9,20,28,1,42,2,0,2,0,1,1
53684,3,39,15,9,9,0,0,6,15,0,0,0,0,0,0,0,0,0,0,0,0,2,0,1,1
53685,2,36,10,7,7,0,0,3,10,1,2,1,2,3,3,2,4,0,2,0,0,2,0,1,1
53686,8,263,51,25,36,0,0,15,51,3,11,6,12,14,18,42,68,1,112,6,0,2,0,1,1
53687,63,4331,520,294,400,33,13,81,553,10,261,204,367,271,571,2128,4614,7,32445,1802,1,2,9,9,1
53688,44,2109,722,423,573,19,0,135,741,12,172,101,199,184,300,1320,2257,6,15668,870,0,2,1,1,1
53689,85,2238,773,422,505,30,103,129,803,14,77,46,83,91,129,535,839,7,6334,351,0,2,2,3,1
53690,151,7095,1392,870,1177,35,17,170,1427,14,494,280,531,508,811,4473,7289,7,54850,3047,2,2,26,26,1
53691,15,703,139,89,101,2,0,35,141,7,54,34,62,61,96,330,569,4,2287,127,0,2,1,1,1
53692,151,7095,1392,870,1177,35,17,170,1427,14,494,280,531,508,811,4473,7289,7,54850,3047,2,2,2,2,0
53693,151,7095,1392,870,1177,35,17,170,1427,14,494,280,531,508,811,4473,7289,7,54850,3047,2,2,1,1,0
53694,151,7095,1392,870,1177,35,17,170,1427,14,494,280,531,508,811,4473,7289,7,54850,3047,2,2,26,26,0
53695,15,703,139,89,101,2,0,35,141,7,54,34,62,61,96,330,569,4,2287,127,0,2,1,1,0
53696,47,2228,722,423,573,19,0,135,741,12,172,101,199,184,300,1320,2257,6,15668,870,0,2,4,2,0
53699,60,1079,282,196,195,3,0,86,285,8,130,71,141,138,212,936,1507,4,6538,363,0,2,3,3,0
53700,1,9,5,3,3,0,0,2,5,0,0,0,0,0,0,0,0,0,0,0,0,2,0,1,0
53701,1,90,13,10,10,0,0,3,13,1,2,1,2,3,3,2,4,0,2,0,0,2,0,1,0
53719,11,238,19,8,11,5,0,4,24,2,5,3,6,7,9,13,25,1,30,1,0,2,0,1,0
53720,11,238,102,59,69,5,3,24,107,6,22,15,28,28,43,113,206,3,789,43,0,2,0,1,0
53721,11,238,106,40,36,3,49,17,109,8,17,13,23,25,36,93,167,5,904,50,0,2,0,1,0
53724,218,4706,2,2,2,0,0,0,2,0,0,0,0,0,0,0,0,0,0,0,0,2,1,1,0
53738,218,4706,99,48,90,1,3,5,100,0,0,0,0,0,0,0,0,0,0,0,0,2,1,1,0
53739,218,4706,8,5,5,2,0,1,10,0,0,0,0,0,0,0,0,0,0,0,0,2,1,1,0
53740,218,4706,1217,716,841,84,126,174,1301,14,185,118,215,199,333,1446,2542,8,20687,1149,0,2,1,1,0
53741,218,4706,160,89,115,0,13,31,160,7,15,11,17,22,28,78,124,3,495,27,0,2,1,1,0
53742,218,4706,10,10,9,9,0,0,19,0,0,0,0,0,0,0,0,0,0,0,0,2,1,1,0
53743,218,4706,173,84,99,8,29,36,181,5,12,7,13,17,20,54,81,2,221,12,0,2,1,1,0
53744,218,4706,3,1,1,3,0,0,6,0,0,0,0,0,0,0,0,0,0,0,0,2,1,1,0
53745,98,2660,1523,757,1297,19,12,193,1542,12,193,117,230,205,347,1508,2664,7,19053,1058,0,2,1,1,0
53746,98,2660,701,378,504,33,58,109,734,13,110,68,126,123,194,794,1346,7,10027,557,0,2,1,1,0
53747,85,2238,773,422,505,30,103,129,803,14,77,46,83,91,129,535,839,7,6334,351,0,2,2,1,0
53748,30,660,125,97,103,3,0,19,128,9,25,17,27,34,44,144,223,4,1087,60,0,2,4,1,0
53749,1,20,127,75,83,2,11,30,129,4,14,7,14,18,21,61,87,2,175,9,0,2,0,1,0
53750,1,20,652,304,544,16,6,88,668,6,89,51,101,95,152,591,998,3,3399,188,0,2,0,1,0
53751,1,20,2,2,2,0,0,0,2,0,0,0,0,0,0,0,0,0,0,0,0,2,0,1,0
53752,1,20,8,5,5,0,0,3,8,0,0,0,0,0,0,0,0,0,0,0,0,2,0,1,0
53755,1,20,14,8,8,0,0,6,14,0,0,0,0,0,0,0,0,0,0,0,0,2,0,1,0
53756,1,20,6,4,4,0,0,2,6,0,0,0,0,0,0,0,0,0,0,0,0,2,0,1,0
53757,1,20,6,4,4,0,0,2,6,1,2,1,2,3,3,2,4,0,2,0,0,2,0,1,0
53759,1,20,7,5,5,0,0,2,7,0,0,0,0,0,0,0,0,0,0,0,0,2,0,1,0
53761,1,20,10,6,6,0,0,4,10,0,0,0,0,0,0,0,0,0,0,0,0,2,0,1,0
53762,1,20,1,1,1,0,0,0,1,0,0,0,0,0,0,0,0,0,0,0,0,2,0,1,0
53764,1,20,14,10,10,0,0,4,14,1,1,1,1,2,2,0,2,0,1,0,0,2,0,1,0
53765,1,20,46,26,30,3,0,12,49,3,6,3,6,9,9,20,28,1,42,2,0,2,0,1,0
53766,3,39,15,9,9,0,0,6,15,0,0,0,0,0,0,0,0,0,0,0,0,2,0,1,0
53767,2,36,10,7,7,0,0,3,10,1,2,1,2,3,3,2,4,0,2,0,0,2,0,1,0
53768,8,263,51,25,36,0,0,15,51,3,11,6,12,14,18,42,68,1,112,6,0,2,0,1,0
53769,63,4331,520,294,400,33,13,81,553,10,261,204,367,271,571,2128,4614,7,32445,1802,1,2,9,9,0
53770,44,2109,722,423,573,19,0,135,741,12,172,101,199,184,300,1320,2257,6,15668,870,0,2,1,1,0
53774,218,4705,2,2,2,0,0,0,2,0,0,0,0,0,0,0,0,0,0,0,0,2,1,1,0
53788,218,4705,99,48,90,1,3,5,100,0,0,0,0,0,0,0,0,0,0,0,0,2,1,1,0
53789,218,4705,8,5,5,2,0,1,10,0,0,0,0,0,0,0,0,0,0,0,0,2,1,1,0
53790,218,4705,1217,716,841,84,126,174,1301,14,185,118,215,199,333,1446,2542,8,20687,1149,0,2,1,1,0
53791,218,4705,160,89,115,0,13,31,160,7,15,11,17,22,28,78,124,3,495,27,0,2,1,1,0
53792,218,4705,10,10,9,9,0,0,19,0,0,0,0,0,0,0,0,0,0,0,0,2,1,1,0
53793,218,4705,173,84,99,8,29,36,181,5,12,7,13,17,20,54,81,2,221,12,0,2,1,1,0
53794,218,4705,3,1,1,3,0,0,6,0,0,0,0,0,0,0,0,0,0,0,0,2,1,1,0
53845,256,5923,4293,999,3693,19,54,507,4312,9,155,88,170,164,258,1156,1898,4,9368,520,0,2,22,5,0
53846,256,5923,1482,859,1002,125,135,219,1607,16,219,134,251,235,385,1766,3032,9,27804,1544,1,2,22,5,0
53849,88,2299,773,422,505,30,103,129,803,14,77,46,83,91,129,535,839,7,6334,351,0,2,2,1,0
53877,178,7898,139,89,101,2,0,35,141,7,54,34,62,61,96,330,569,4,2287,127,0,2,14,4,0
53878,178,7898,7,5,5,0,0,2,7,1,2,1,2,3,3,2,4,0,2,0,0,2,14,4,0
53879,47,2228,722,423,573,19,0,135,741,12,172,101,199,184,300,1320,2257,6,15668,870,0,2,1,1,0
53944,38,779,386,256,301,16,9,68,402,4,59,35,69,63,104,355,621,2,1453,80,0,2,5,39,1
53945,38,779,264,131,164,11,41,46,275,6,38,22,40,44,62,214,338,3,1068,59,0,2,5,39,1
53946,40,1789,386,256,301,16,9,68,402,4,59,35,69,63,104,355,621,2,1453,80,0,2,14,7,1
53947,254,5844,4293,999,3693,19,54,507,4312,9,155,88,170,164,258,1156,1898,4,9368,520,0,2,1,1,0
53948,254,5844,1482,859,1002,125,135,219,1607,16,219,134,251,235,385,1766,3032,9,27804,1544,1,2,1,1,0
53949,41,830,386,256,301,16,9,68,402,4,59,35,69,63,104,355,621,2,1453,80,0,2,13,0,1
53950,41,830,264,131,164,11,41,46,275,6,38,22,40,44,62,214,338,3,1068,59,0,2,13,0,1
53951,42,1848,386,256,301,16,9,68,402,4,59,35,69,63,104,355,621,2,1453,80,0,2,10,0,1
53952,244,5785,722,423,573,19,0,135,741,12,172,101,199,184,300,1320,2257,6,15668,870,0,2,2,0,0
53953,244,5785,1508,847,911,44,250,301,1552,14,148,88,169,162,257,1120,1886,7,15077,837,0,2,2,0,0
53954,60,1078,282,196,195,3,0,86,285,8,130,71,141,138,212,936,1507,4,6538,363,0,2,1,1,0
53955,89,1825,477,336,357,30,23,73,507,16,194,134,250,210,384,1538,2962,10,30538,1696,0,2,1,1,0
53956,76,1735,996,429,845,24,10,117,1020,7,76,50,88,83,138,494,879,4,3565,198,0,2,1,1,0
53957,76,1735,456,277,329,12,42,72,468,13,85,50,97,98,147,592,972,7,7212,400,0,2,1,1,0
53958,154,3261,1513,682,1277,25,13,200,1538,11,199,116,219,210,335,1557,2584,6,15641,868,0,2,1,1,0
53959,154,3261,819,519,539,24,98,155,843,15,96,57,106,111,163,690,1107,8,9171,509,0,2,1,1,0
53960,67,1348,207,111,150,11,0,50,218,5,26,19,36,31,55,133,272,3,943,52,0,2,1,1,0
53961,67,1348,410,198,237,31,55,97,441,11,63,38,72,74,110,414,683,6,4293,238,0,2,1,1,0
53963,27,964,74,35,59,1,0,14,75,3,14,7,14,17,21,58,85,1,128,7,0,2,1,1,0
53964,27,964,245,125,200,5,7,34,250,7,30,17,34,37,51,166,265,3,1053,58,0,2,1,1,0
53965,313,6904,72,33,56,0,4,12,72,1,1,1,1,2,2,0,2,0,1,0,0,2,1,1,0
53966,313,6904,1454,835,1044,76,110,219,1530,17,275,158,296,292,454,2297,3718,9,34017,1889,1,2,1,1,0
53967,46,954,386,256,301,16,9,68,402,4,59,35,69,63,104,355,621,2,1453,80,0,2,1,1,0
53968,46,954,264,131,164,11,41,46,275,6,38,22,40,44,62,214,338,3,1068,59,0,2,1,1,0
53969,223,4839,1943,715,1694,26,18,214,1969,12,185,120,237,197,357,1436,2721,7,20915,1161,0,2,1,1,0
53970,223,4839,1168,838,957,57,25,144,1225,19,348,224,416,367,640,3018,5452,11,61921,3440,1,2,1,1,0
53971,95,3960,1289,550,1043,56,32,155,1345,10,167,93,185,177,278,1266,2075,5,11498,638,0,2,3,3,0
53972,1,134,149,67,118,4,0,27,153,1,17,14,28,18,42,69,175,0,144,8,0,2,2,2,0
53973,95,4641,1523,757,1297,19,12,193,1542,12,193,117,230,205,347,1508,2664,7,19053,1058,0,2,1,1,0
53974,62,2789,1293,570,1093,25,15,163,1318,10,195,123,241,205,364,1516,2795,6,17273,959,0,2,1,1,0
53975,256,5923,4293,999,3693,19,54,507,4312,9,155,88,170,164,258,1156,1898,4,9368,520,0,2,1,1,0
53976,256,5923,1482,859,1002,125,135,219,1607,16,219,134,251,235,385,1766,3032,9,27804,1544,1,2,1,1,0
53977,62,2790,1293,570,1093,25,15,163,1318,10,195,123,241,205,364,1516,2795,6,17273,959,0,2,19,19,0
53978,62,2808,1293,570,1093,25,15,163,1318,10,195,123,241,205,364,1516,2795,6,17273,959,0,2,3,0,0
53983,218,4703,2,2,2,0,0,0,2,0,0,0,0,0,0,0,0,0,0,0,0,2,19,17,1
53997,218,4703,99,48,90,1,3,5,100,0,0,0,0,0,0,0,0,0,0,0,0,2,19,17,1
53998,218,4703,8,5,5,2,0,1,10,0,0,0,0,0,0,0,0,0,0,0,0,2,19,17,1
53999,218,4703,1217,716,841,84,126,174,1301,14,185,118,215,199,333,1446,2542,8,20687,1149,0,2,19,17,1
54000,218,4703,160,89,115,0,13,31,160,7,15,11,17,22,28,78,124,3,495,27,0,2,19,17,1
54001,218,4703,10,10,9,9,0,0,19,0,0,0,0,0,0,0,0,0,0,0,0,2,19,17,1
54002,218,4703,173,84,99,8,29,36,181,5,12,7,13,17,20,54,81,2,221,12,0,2,19,17,1
54003,218,4703,3,1,1,3,0,0,6,0,0,0,0,0,0,0,0,0,0,0,0,2,19,17,1
54004,88,1878,402,202,227,24,74,80,426,12,52,33,61,64,94,339,564,7,3969,220,0,2,1,1,0
54005,256,5936,4293,999,3693,19,54,507,4312,9,155,88,170,164,258,1156,1898,4,9368,520,0,2,9,6,1
54006,256,5936,1482,859,1002,125,135,219,1607,16,219,134,251,235,385,1766,3032,9,27804,1544,1,2,9,6,1
54009,24,600,2,2,2,0,0,0,2,0,0,0,0,0,0,0,0,0,0,0,0,2,0,5,1
54023,24,600,99,48,90,1,3,5,100,0,0,0,0,0,0,0,0,0,0,0,0,2,0,5,1
54024,24,600,8,5,5,2,0,1,10,0,0,0,0,0,0,0,0,0,0,0,0,2,0,5,1
54025,24,600,1217,716,841,84,126,174,1301,14,185,118,215,199,333,1446,2542,8,20687,1149,0,2,0,5,1
54026,24,600,160,89,115,0,13,31,160,7,15,11,17,22,28,78,124,3,495,27,0,2,0,5,1
54027,24,600,10,10,9,9,0,0,19,0,0,0,0,0,0,0,0,0,0,0,0,2,0,5,1
54028,24,600,173,84,99,8,29,36,181,5,12,7,13,17,20,54,81,2,221,12,0,2,0,5,1
54029,24,600,3,1,1,3,0,0,6,0,0,0,0,0,0,0,0,0,0,0,0,2,0,5,1
54030,88,1887,402,202,227,24,74,80,426,12,52,33,61,64,94,339,564,7,3969,220,0,2,2,1,1
54031,88,1985,53,23,39,0,0,13,53,2,8,4,8,10,12,26,39,1,39,2,0,2,4,0,1
54032,88,1985,515,298,307,33,80,99,548,12,63,44,77,75,121,419,753,7,5527,307,0,2,4,0,1
54033,310,6900,72,33,56,0,4,12,72,1,1,1,1,2,2,0,2,0,1,0,0,2,27,23,1
54034,310,6900,1454,835,1044,76,110,219,1530,17,275,158,296,292,454,2297,3718,9,34017,1889,1,2,27,23,1
54035,178,7961,139,89,101,2,0,35,141,7,54,34,62,61,96,330,569,4,2287,127,0,2,39,42,1
54036,178,7961,7,5,5,0,0,2,7,1,2,1,2,3,3,2,4,0,2,0,0,2,39,42,1
54037,138,6146,1782,648,1425,9,47,279,1791,8,171,97,189,179,286,1292,2140,4,9462,525,0,2,19,19,1
54038,97,4228,1020,354,843,12,15,144,1032,8,134,77,144,142,221,970,1580,4,6792,377,0,2,2,2,1
54039,83,3201,1043,504,840,53,9,147,1096,9,180,112,198,189,310,1377,2344,4,11604,644,0,2,17,1,1
54040,41,830,386,256,301,16,9,68,402,4,59,35,69,63,104,355,621,2,1453,80,0,2,4,4,1
54041,41,830,264,131,164,11,41,46,275,6,38,22,40,44,62,214,338,3,1068,59,0,2,4,4,1
54042,60,1078,282,196,195,3,0,86,285,8,130,71,141,138,212,936,1507,4,6538,363,0,2,3,3,0
54043,223,4839,1943,715,1694,26,18,214,1969,12,185,120,237,197,357,1436,2721,7,20915,1161,0,2,1,3,0
54044,223,4839,1168,838,957,57,25,144,1225,19,348,224,416,367,640,3018,5452,11,61921,3440,1,2,1,3,0
54045,62,2789,1293,570,1093,25,15,163,1318,10,195,123,241,205,364,1516,2795,6,17273,959,0,2,1,3,0
54046,141,3287,77,34,69,0,0,8,77,3,24,16,29,27,45,114,213,1,387,21,0,2,4,1,0
54047,141,3287,712,438,573,51,9,84,763,14,102,71,128,116,199,733,1364,8,11988,666,0,2,4,1,0
54048,26,755,442,244,305,14,16,103,456,11,68,45,75,79,120,452,756,6,4588,254,0,2,101,44,0
54049,26,755,182,102,99,11,40,35,193,3,11,6,11,14,17,42,64,1,97,5,0,2,101,44,0
54050,14,732,442,244,305,14,16,103,456,11,68,45,75,79,120,452,756,6,4588,254,0,2,2,2,0
54051,26,761,442,244,305,14,16,103,456,11,68,45,75,79,120,452,756,6,4588,254,0,2,4,2,0
54052,26,761,182,102,99,11,40,35,193,3,11,6,11,14,17,42,64,1,97,5,0,2,4,2,0
54053,38,1045,442,244,305,14,16,103,456,11,68,45,75,79,120,452,756,6,4588,254,0,2,74,18,1
54054,38,1045,182,102,99,11,40,35,193,3,11,6,11,14,17,42,64,1,97,5,0,2,74,18,1
54055,38,1039,442,244,305,14,16,103,456,11,68,45,75,79,120,452,756,6,4588,254,0,2,6,6,1
54056,38,1039,182,102,99,11,40,35,193,3,11,6,11,14,17,42,64,1,97,5,0,2,6,6,1
54057,14,732,442,244,305,14,16,103,456,11,68,45,75,79,120,452,756,6,4588,254,0,2,1,1,0
54058,50,1304,442,244,305,14,16,103,456,11,68,45,75,79,120,452,756,6,4588,254,0,2,84,29,1
54059,50,1304,182,102,99,11,40,35,193,3,11,6,11,14,17,42,64,1,97,5,0,2,84,29,1
54060,19,987,442,244,305,14,16,103,456,11,68,45,75,79,120,452,756,6,4588,254,0,2,57,0,1
54061,50,1308,442,244,305,14,16,103,456,11,68,45,75,79,120,452,756,6,4588,254,0,2,5,5,0
54062,50,1308,182,102,99,11,40,35,193,3,11,6,11,14,17,42,64,1,97,5,0,2,5,5,0
54063,56,1403,442,244,305,14,16,103,456,11,68,45,75,79,120,452,756,6,4588,254,0,2,35,17,1
54064,56,1403,182,102,99,11,40,35,193,3,11,6,11,14,17,42,64,1,97,5,0,2,35,17,1
54065,20,1078,442,244,305,14,16,103,456,11,68,45,75,79,120,452,756,6,4588,254,0,2,12,0,1
54066,56,1403,442,244,305,14,16,103,456,11,68,45,75,79,120,452,756,6,4588,254,0,2,9,9,1
54067,56,1403,182,102,99,11,40,35,193,3,11,6,11,14,17,42,64,1,97,5,0,2,9,9,1
54068,56,1416,442,244,305,14,16,103,456,11,68,45,75,79,120,452,756,6,4588,254,0,2,9,5,0
54069,56,1416,182,102,99,11,40,35,193,3,11,6,11,14,17,42,64,1,97,5,0,2,9,5,0
54070,20,1083,442,244,305,14,16,103,456,11,68,45,75,79,120,452,756,6,4588,254,0,2,11,3,0
54071,56,1420,442,244,305,14,16,103,456,11,68,45,75,79,120,452,756,6,4588,254,0,2,1,1,0
54072,56,1420,182,102,99,11,40,35,193,3,11,6,11,14,17,42,64,1,97,5,0,2,1,1,0
54073,180,5391,1660,832,1314,41,38,274,1701,20,312,209,395,332,604,2671,5058,12,64042,3557,1,2,2,1,1
54074,180,5391,1057,646,719,113,100,145,1170,18,215,134,248,233,382,1740,3004,10,31186,1732,1,2,2,1,1
54075,76,1739,996,429,845,24,10,117,1020,7,76,50,88,83,138,494,879,4,3565,198,0,2,2,1,1
54076,76,1739,456,277,329,12,42,72,468,13,85,50,97,98,147,592,972,7,7212,400,0,2,2,1,1
54077,67,1325,207,111,150,11,0,50,218,5,26,19,36,31,55,133,272,3,943,52,0,2,0,7,1
54078,67,1325,410,198,237,31,55,97,441,11,63,38,72,74,110,414,683,6,4293,238,0,2,0,7,1
54079,37,833,91,45,69,0,3,18,91,3,9,6,10,12,16,33,57,1,95,5,0,0,183,0,1
54080,37,833,367,234,237,17,34,68,384,16,55,34,61,71,95,381,584,8,5183,287,0,0,183,0,1
54081,7,164,167,116,138,4,5,22,171,8,48,30,56,56,86,292,499,4,2330,129,0,2,1,1,1
54082,244,5785,722,423,573,19,0,135,741,12,172,101,199,184,300,1320,2257,6,15668,870,0,2,4,3,1
54083,244,5785,1508,847,911,44,250,301,1552,14,148,88,169,162,257,1120,1886,7,15077,837,0,2,4,3,1
54084,19,622,442,244,305,14,16,103,456,11,68,45,75,79,120,452,756,6,4588,254,0,2,1,173,1
54085,19,622,182,102,99,11,40,35,193,3,11,6,11,14,17,42,64,1,97,5,0,2,1,173,1
54086,20,1083,442,244,305,14,16,103,456,11,68,45,75,79,120,452,756,6,4588,254,0,2,9,9,1
54087,178,7898,139,89,101,2,0,35,141,7,54,34,62,61,96,330,569,4,2287,127,0,2,1,1,0
54088,178,7898,7,5,5,0,0,2,7,1,2,1,2,3,3,2,4,0,2,0,0,2,1,1,0
54089,180,5391,1660,832,1314,41,38,274,1701,20,312,209,395,332,604,2671,5058,12,64042,3557,1,2,1,1,0
54090,180,5391,1057,646,719,113,100,145,1170,18,215,134,248,233,382,1740,3004,10,31186,1732,1,2,1,1,0
54091,76,1735,996,429,845,24,10,117,1020,7,76,50,88,83,138,494,879,4,3565,198,0,2,2,3,0
54092,76,1735,456,277,329,12,42,72,468,13,85,50,97,98,147,592,972,7,7212,400,0,2,2,3,0
54093,44,988,91,45,69,0,3,18,91,3,9,6,10,12,16,33,57,1,95,5,0,2,49,0,0
54094,44,988,367,234,237,17,34,68,384,16,55,34,61,71,95,381,584,8,5183,287,0,2,49,0,0
54096,76,1734,996,429,845,24,10,117,1020,7,76,50,88,83,138,494,879,4,3565,198,0,2,2,3,1
54097,76,1734,456,277,329,12,42,72,468,13,85,50,97,98,147,592,972,7,7212,400,0,2,2,3,1
54098,49,1088,91,45,69,0,3,18,91,3,9,6,10,12,16,33,57,1,95,5,0,2,46,2,1
54099,49,1088,367,234,237,17,34,68,384,16,55,34,61,71,95,381,584,8,5183,287,0,2,46,2,1
54100,18,608,442,244,305,14,16,103,456,11,68,45,75,79,120,452,756,6,4588,254,0,2,7,5,1
54101,18,608,182,102,99,11,40,35,193,3,11,6,11,14,17,42,64,1,97,5,0,2,7,5,1
54102,21,1150,442,244,305,14,16,103,456,11,68,45,75,79,120,452,756,6,4588,254,0,2,16,0,1
54103,49,1103,91,45,69,0,3,18,91,3,9,6,10,12,16,33,57,1,95,5,0,2,13,8,0
54104,49,1103,367,234,237,17,34,68,384,16,55,34,61,71,95,381,584,8,5183,287,0,2,13,8,0
54105,18,611,442,244,305,14,16,103,456,11,68,45,75,79,120,452,756,6,4588,254,0,2,25,8,0
54106,18,611,182,102,99,11,40,35,193,3,11,6,11,14,17,42,64,1,97,5,0,2,25,8,0
54107,244,5821,722,423,573,19,0,135,741,12,172,101,199,184,300,1320,2257,6,15668,870,0,2,3,0,1
54108,244,5821,1508,847,911,44,250,301,1552,14,148,88,169,162,257,1120,1886,7,15077,837,0,2,3,0,1
54109,19,625,442,244,305,14,16,103,456,11,68,45,75,79,120,452,756,6,4588,254,0,2,3,1,1
54110,19,625,182,102,99,11,40,35,193,3,11,6,11,14,17,42,64,1,97,5,0,2,3,1,1
54111,21,1128,442,244,305,14,16,103,456,11,68,45,75,79,120,452,756,6,4588,254,0,2,0,2,1
54112,244,5824,722,423,573,19,0,135,741,12,172,101,199,184,300,1320,2257,6,15668,870,0,2,1,1,0
54113,244,5824,1508,847,911,44,250,301,1552,14,148,88,169,162,257,1120,1886,7,15077,837,0,2,1,1,0
54114,19,627,442,244,305,14,16,103,456,11,68,45,75,79,120,452,756,6,4588,254,0,2,2,1,0
54115,19,627,182,102,99,11,40,35,193,3,11,6,11,14,17,42,64,1,97,5,0,2,2,1,0
54116,19,628,442,244,305,14,16,103,456,11,68,45,75,79,120,452,756,6,4588,254,0,2,1,0,0
54117,19,628,182,102,99,11,40,35,193,3,11,6,11,14,17,42,64,1,97,5,0,2,1,0,0
54119,19,669,442,244,305,14,16,103,456,11,68,45,75,79,120,452,756,6,4588,254,0,2,26,14,1
54120,19,669,182,102,99,11,40,35,193,3,11,6,11,14,17,42,64,1,97,5,0,2,26,14,1
54121,62,2808,1293,570,1093,25,15,163,1318,10,195,123,241,205,364,1516,2795,6,17273,959,0,2,22,19,0
54124,218,4703,2,2,2,0,0,0,2,0,0,0,0,0,0,0,0,0,0,0,0,2,19,17,0
54138,218,4703,99,48,90,1,3,5,100,0,0,0,0,0,0,0,0,0,0,0,0,2,19,17,0
54139,218,4703,8,5,5,2,0,1,10,0,0,0,0,0,0,0,0,0,0,0,0,2,19,17,0
54140,218,4703,1217,716,841,84,126,174,1301,14,185,118,215,199,333,1446,2542,8,20687,1149,0,2,19,17,0
54141,218,4703,160,89,115,0,13,31,160,7,15,11,17,22,28,78,124,3,495,27,0,2,19,17,0
54142,218,4703,10,10,9,9,0,0,19,0,0,0,0,0,0,0,0,0,0,0,0,2,19,17,0
54143,218,4703,173,84,99,8,29,36,181,5,12,7,13,17,20,54,81,2,221,12,0,2,19,17,0
54144,218,4703,3,1,1,3,0,0,6,0,0,0,0,0,0,0,0,0,0,0,0,2,19,17,0
54145,41,830,386,256,301,16,9,68,402,4,59,35,69,63,104,355,621,2,1453,80,0,2,18,39,0
54146,41,830,264,131,164,11,41,46,275,6,38,22,40,44,62,214,338,3,1068,59,0,2,18,39,0
54147,42,1848,386,256,301,16,9,68,402,4,59,35,69,63,104,355,621,2,1453,80,0,2,24,7,0
54148,19,669,442,244,305,14,16,103,456,11,68,45,75,79,120,452,756,6,4588,254,0,2,6,6,1
54149,19,669,182,102,99,11,40,35,193,3,11,6,11,14,17,42,64,1,97,5,0,2,6,6,1
54170,62,2807,1293,570,1093,25,15,163,1318,10,195,123,241,205,364,1516,2795,6,17273,959,0,2,1,3,0
54171,256,5936,4293,999,3693,19,54,507,4312,9,155,88,170,164,258,1156,1898,4,9368,520,0,2,9,6,0
54172,256,5936,1482,859,1002,125,135,219,1607,16,219,134,251,235,385,1766,3032,9,27804,1544,1,2,9,6,0
54175,24,600,2,2,2,0,0,0,2,0,0,0,0,0,0,0,0,0,0,0,0,2,0,5,0
54189,24,600,99,48,90,1,3,5,100,0,0,0,0,0,0,0,0,0,0,0,0,2,0,5,0
54190,24,600,8,5,5,2,0,1,10,0,0,0,0,0,0,0,0,0,0,0,0,2,0,5,0
54191,24,600,1217,716,841,84,126,174,1301,14,185,118,215,199,333,1446,2542,8,20687,1149,0,2,0,5,0
54192,24,600,160,89,115,0,13,31,160,7,15,11,17,22,28,78,124,3,495,27,0,2,0,5,0
54193,24,600,10,10,9,9,0,0,19,0,0,0,0,0,0,0,0,0,0,0,0,2,0,5,0
54194,24,600,173,84,99,8,29,36,181,5,12,7,13,17,20,54,81,2,221,12,0,2,0,5,0
54195,24,600,3,1,1,3,0,0,6,0,0,0,0,0,0,0,0,0,0,0,0,2,0,5,0
54196,88,1887,402,202,227,24,74,80,426,12,52,33,61,64,94,339,564,7,3969,220,0,2,3,2,0
54197,88,1985,53,23,39,0,0,13,53,2,8,4,8,10,12,26,39,1,39,2,0,2,4,0,0
54198,88,1985,515,298,307,33,80,99,548,12,63,44,77,75,121,419,753,7,5527,307,0,2,4,0,0
54199,310,6900,72,33,56,0,4,12,72,1,1,1,1,2,2,0,2,0,1,0,0,2,27,23,0
54200,310,6900,1454,835,1044,76,110,219,1530,17,275,158,296,292,454,2297,3718,9,34017,1889,1,2,27,23,0
54201,178,7961,139,89,101,2,0,35,141,7,54,34,62,61,96,330,569,4,2287,127,0,2,39,42,0
54202,178,7961,7,5,5,0,0,2,7,1,2,1,2,3,3,2,4,0,2,0,0,2,39,42,0
54203,138,6146,1782,648,1425,9,47,279,1791,8,171,97,189,179,286,1292,2140,4,9462,525,0,2,19,19,0
54204,97,4228,1020,354,843,12,15,144,1032,8,134,77,144,142,221,970,1580,4,6792,377,0,2,2,2,0
54205,83,3201,1043,504,840,53,9,147,1096,9,180,112,198,189,310,1377,2344,4,11604,644,0,2,17,1,0
54206,180,5391,1660,832,1314,41,38,274,1701,20,312,209,395,332,604,2671,5058,12,64042,3557,1,2,3,2,0
54207,180,5391,1057,646,719,113,100,145,1170,18,215,134,248,233,382,1740,3004,10,31186,1732,1,2,3,2,0
54208,76,1734,996,429,845,24,10,117,1020,7,76,50,88,83,138,494,879,4,3565,198,0,2,4,5,0
54209,76,1734,456,277,329,12,42,72,468,13,85,50,97,98,147,592,972,7,7212,400,0,2,4,5,0
54210,67,1325,207,111,150,11,0,50,218,5,26,19,36,31,55,133,272,3,943,52,0,2,0,7,0
54211,67,1325,410,198,237,31,55,97,441,11,63,38,72,74,110,414,683,6,4293,238,0,2,0,7,0
54215,49,1103,91,45,69,0,3,18,91,3,9,6,10,12,16,33,57,1,95,5,0,0,281,0,0
54216,49,1103,367,234,237,17,34,68,384,16,55,34,61,71,95,381,584,8,5183,287,0,0,281,0,0
54218,244,5824,722,423,573,19,0,135,741,12,172,101,199,184,300,1320,2257,6,15668,870,0,2,7,3,0
54219,244,5824,1508,847,911,44,250,301,1552,14,148,88,169,162,257,1120,1886,7,15077,837,0,2,7,3,0
54220,19,669,442,244,305,14,16,103,456,11,68,45,75,79,120,452,756,6,4588,254,0,2,113,58,0
54221,19,669,182,102,99,11,40,35,193,3,11,6,11,14,17,42,64,1,97,5,0,2,113,58,0
54222,178,7961,139,89,101,2,0,35,141,7,54,34,62,61,96,330,569,4,2287,127,0,2,1,1,0
54223,178,7961,7,5,5,0,0,2,7,1,2,1,2,3,3,2,4,0,2,0,0,2,1,1,0
54224,21,1128,442,244,305,14,16,103,456,11,68,45,75,79,120,452,756,6,4588,254,0,2,94,3,0
54225,217,4704,182,127,129,0,0,53,182,5,39,21,42,44,63,217,343,2,926,51,0,2,35,7,1
54226,217,4704,1165,710,800,67,119,181,1232,18,243,153,282,261,435,2000,3492,10,36473,2026,1,2,35,7,1
54227,152,7140,1392,870,1177,35,17,170,1427,14,494,280,531,508,811,4473,7289,7,54850,3047,2,2,15,5,1
54230,219,4763,2,2,2,0,0,0,2,0,0,0,0,0,0,0,0,0,0,0,0,2,16,2,0
54244,219,4763,99,48,90,1,3,5,100,0,0,0,0,0,0,0,0,0,0,0,0,2,16,2,0
54245,219,4763,8,5,5,2,0,1,10,0,0,0,0,0,0,0,0,0,0,0,0,2,16,2,0
54246,219,4763,1217,716,841,84,126,174,1301,14,185,118,215,199,333,1446,2542,8,20687,1149,0,2,16,2,0
54247,219,4763,160,89,115,0,13,31,160,7,15,11,17,22,28,78,124,3,495,27,0,2,16,2,0
54248,219,4763,10,10,9,9,0,0,19,0,0,0,0,0,0,0,0,0,0,0,0,2,16,2,0
54249,219,4763,173,84,99,8,29,36,181,5,12,7,13,17,20,54,81,2,221,12,0,2,16,2,0
54250,219,4763,3,1,1,3,0,0,6,0,0,0,0,0,0,0,0,0,0,0,0,2,16,2,0
54251,97,4034,1289,550,1043,56,32,155,1345,10,167,93,185,177,278,1266,2075,5,11498,638,0,2,25,5,0
54275,222,4841,182,127,129,0,0,53,182,5,39,21,42,44,63,217,343,2,926,51,0,2,35,0,0
54276,222,4841,1165,710,800,67,119,181,1232,18,243,153,282,261,435,2000,3492,10,36473,2026,1,2,35,0,0
54279,219,4759,2,2,2,0,0,0,2,0,0,0,0,0,0,0,0,0,0,0,0,2,1,4,0
54293,219,4759,99,48,90,1,3,5,100,0,0,0,0,0,0,0,0,0,0,0,0,2,1,4,0
54294,219,4759,8,5,5,2,0,1,10,0,0,0,0,0,0,0,0,0,0,0,0,2,1,4,0
54295,219,4759,1217,716,841,84,126,174,1301,14,185,118,215,199,333,1446,2542,8,20687,1149,0,2,1,4,0
54296,219,4759,160,89,115,0,13,31,160,7,15,11,17,22,28,78,124,3,495,27,0,2,1,4,0
54297,219,4759,10,10,9,9,0,0,19,0,0,0,0,0,0,0,0,0,0,0,0,2,1,4,0
54298,219,4759,173,84,99,8,29,36,181,5,12,7,13,17,20,54,81,2,221,12,0,2,1,4,0
54299,219,4759,3,1,1,3,0,0,6,0,0,0,0,0,0,0,0,0,0,0,0,2,1,4,0
54300,305,6771,72,33,56,0,4,12,72,1,1,1,1,2,2,0,2,0,1,0,0,2,1,32,0
54301,305,6771,1454,835,1044,76,110,219,1530,17,275,158,296,292,454,2297,3718,9,34017,1889,1,2,1,32,0
54304,218,4716,2,2,2,0,0,0,2,0,0,0,0,0,0,0,0,0,0,0,0,2,0,10,0
54318,218,4716,99,48,90,1,3,5,100,0,0,0,0,0,0,0,0,0,0,0,0,2,0,10,0
54319,218,4716,8,5,5,2,0,1,10,0,0,0,0,0,0,0,0,0,0,0,0,2,0,10,0
54320,218,4716,1217,716,841,84,126,174,1301,14,185,118,215,199,333,1446,2542,8,20687,1149,0,2,0,10,0
54321,218,4716,160,89,115,0,13,31,160,7,15,11,17,22,28,78,124,3,495,27,0,2,0,10,0
54322,218,4716,10,10,9,9,0,0,19,0,0,0,0,0,0,0,0,0,0,0,0,2,0,10,0
54323,218,4716,173,84,99,8,29,36,181,5,12,7,13,17,20,54,81,2,221,12,0,2,0,10,0
54324,218,4716,3,1,1,3,0,0,6,0,0,0,0,0,0,0,0,0,0,0,0,2,0,10,0
54327,76,1733,996,429,845,24,10,117,1020,7,76,50,88,83,138,494,879,4,3565,198,0,2,1,1,0
54328,76,1733,456,277,329,12,42,72,468,13,85,50,97,98,147,592,972,7,7212,400,0,2,1,1,0
54331,67,1324,207,111,150,11,0,50,218,5,26,19,36,31,55,133,272,3,943,52,0,2,1,1,0
54332,67,1324,410,198,237,31,55,97,441,11,63,38,72,74,110,414,683,6,4293,238,0,2,1,1,0
54336,310,6899,72,33,56,0,4,12,72,1,1,1,1,2,2,0,2,0,1,0,0,2,1,1,0
54337,310,6899,1454,835,1044,76,110,219,1530,17,275,158,296,292,454,2297,3718,9,34017,1889,1,2,1,1,0
54338,41,829,386,256,301,16,9,68,402,4,59,35,69,63,104,355,621,2,1453,80,0,2,1,1,0
54339,41,829,264,131,164,11,41,46,275,6,38,22,40,44,62,214,338,3,1068,59,0,2,1,1,0
54345,62,2807,1293,570,1093,25,15,163,1318,10,195,123,241,205,364,1516,2795,6,17273,959,0,2,23,22,0
54369,222,4841,182,127,129,0,0,53,182,5,39,21,42,44,63,217,343,2,926,51,0,2,70,7,0
54370,222,4841,1165,710,800,67,119,181,1232,18,243,153,282,261,435,2000,3492,10,36473,2026,1,2,70,7,0
54373,218,4716,2,2,2,0,0,0,2,0,0,0,0,0,0,0,0,0,0,0,0,2,13,12,0
54387,218,4716,99,48,90,1,3,5,100,0,0,0,0,0,0,0,0,0,0,0,0,2,13,12,0
54388,218,4716,8,5,5,2,0,1,10,0,0,0,0,0,0,0,0,0,0,0,0,2,13,12,0
54389,218,4716,1217,716,841,84,126,174,1301,14,185,118,215,199,333,1446,2542,8,20687,1149,0,2,13,12,0
54390,218,4716,160,89,115,0,13,31,160,7,15,11,17,22,28,78,124,3,495,27,0,2,13,12,0
54391,218,4716,10,10,9,9,0,0,19,0,0,0,0,0,0,0,0,0,0,0,0,2,13,12,0
54392,218,4716,173,84,99,8,29,36,181,5,12,7,13,17,20,54,81,2,221,12,0,2,13,12,0
54393,218,4716,3,1,1,3,0,0,6,0,0,0,0,0,0,0,0,0,0,0,0,2,13,12,0
54397,152,7140,1392,870,1177,35,17,170,1427,14,494,280,531,508,811,4473,7289,7,54850,3047,2,2,15,5,0
54398,95,3960,1289,550,1043,56,32,155,1345,10,167,93,185,177,278,1266,2075,5,11498,638,0,2,2,2,0
54399,90,3892,1289,550,1043,56,32,155,1345,10,167,93,185,177,278,1266,2075,5,11498,638,0,2,15,25,0
54411,305,6770,72,33,56,0,4,12,72,1,1,1,1,2,2,0,2,0,1,0,0,2,1,1,0
54412,305,6770,1454,835,1044,76,110,219,1530,17,275,158,296,292,454,2297,3718,9,34017,1889,1,2,1,1,0
54417,97,4030,1289,550,1043,56,32,155,1345,10,167,93,185,177,278,1266,2075,5,11498,638,0,2,3,3,0
54421,256,5918,4293,999,3693,19,54,507,4312,9,155,88,170,164,258,1156,1898,4,9368,520,0,2,2,3,0
54422,256,5918,1482,859,1002,125,135,219,1607,16,219,134,251,235,385,1766,3032,9,27804,1544,1,2,2,3,0
54423,141,3282,77,34,69,0,0,8,77,3,24,16,29,27,45,114,213,1,387,21,0,2,2,5,0
54424,141,3282,712,438,573,51,9,84,763,14,102,71,128,116,199,733,1364,8,11988,666,0,2,2,5,0
54425,235,5587,722,423,573,19,0,135,741,12,172,101,199,184,300,1320,2257,6,15668,870,0,2,2,2,1
54426,235,5587,1508,847,911,44,250,301,1552,14,148,88,169,162,257,1120,1886,7,15077,837,0,2,2,2,1
54427,90,3892,1289,550,1043,56,32,155,1345,10,167,93,185,177,278,1266,2075,5,11498,638,0,2,17,27,0
54432,235,5587,722,423,573,19,0,135,741,12,172,101,199,184,300,1320,2257,6,15668,870,0,2,2,2,0
54433,235,5587,1508,847,911,44,250,301,1552,14,148,88,169,162,257,1120,1886,7,15077,837,0,2,2,2,0
54434,92,1951,1043,504,840,53,9,147,1096,9,180,112,198,189,310,1377,2344,4,11604,644,0,2,1,0,0
54435,92,1951,383,288,292,26,6,62,409,11,65,38,67,76,105,429,656,5,3719,206,0,2,1,0,0
54436,92,1951,1043,504,840,53,9,147,1096,9,180,112,198,189,310,1377,2344,4,11604,644,0,2,1,1,0
54437,92,1951,383,288,292,26,6,62,409,11,65,38,67,76,105,429,656,5,3719,206,0,2,1,1,0
54438,62,2807,1293,570,1093,25,15,163,1318,10,195,123,241,205,364,1516,2795,6,17273,959,0,2,7,7,0
54439,92,1957,1043,504,840,53,9,147,1096,9,180,112,198,189,310,1377,2344,4,11604,644,0,2,2,1,1
54440,92,1957,383,288,292,26,6,62,409,11,65,38,67,76,105,429,656,5,3719,206,0,2,2,1,1
54441,101,4065,1289,550,1043,56,32,155,1345,10,167,93,185,177,278,1266,2075,5,11498,638,0,2,4,0,1
54442,33,970,339,213,244,17,9,65,356,10,42,26,48,52,74,259,421,5,2410,133,0,2,0,3,0
54443,64,2837,1293,570,1093,25,15,163,1318,10,195,123,241,205,364,1516,2795,6,17273,959,0,2,5,1,0
54444,256,5940,4293,999,3693,19,54,507,4312,9,155,88,170,164,258,1156,1898,4,9368,520,0,2,1,1,1
54445,256,5940,1482,859,1002,125,135,219,1607,16,219,134,251,235,385,1766,3032,9,27804,1544,1,2,1,1,1
54446,141,3291,77,34,69,0,0,8,77,3,24,16,29,27,45,114,213,1,387,21,0,2,1,1,1
54447,141,3291,712,438,573,51,9,84,763,14,102,71,128,116,199,733,1364,8,11988,666,0,2,1,1,1
54448,98,4059,1289,550,1043,56,32,155,1345,10,167,93,185,177,278,1266,2075,5,11498,638,0,2,17,7,1
54449,40,2477,652,304,544,16,6,88,668,6,89,51,101,95,152,591,998,3,3399,188,0,2,47,1,1
54450,35,1016,339,213,244,17,9,65,356,10,42,26,48,52,74,259,421,5,2410,133,0,2,6,2,1
54451,62,2819,1293,570,1093,25,15,163,1318,10,195,123,241,205,364,1516,2795,6,17273,959,0,2,12,3,1
54452,64,2839,1293,570,1093,25,15,163,1318,10,195,123,241,205,364,1516,2795,6,17273,959,0,2,10,2,0
54453,92,1957,1043,504,840,53,9,147,1096,9,180,112,198,189,310,1377,2344,4,11604,644,0,2,5,0,0
54454,92,1957,383,288,292,26,6,62,409,11,65,38,67,76,105,429,656,5,3719,206,0,2,5,0,0
54455,96,3993,1289,550,1043,56,32,155,1345,10,167,93,185,177,278,1266,2075,5,11498,638,0,2,27,9,0
54457,64,2839,1293,570,1093,25,15,163,1318,10,195,123,241,205,364,1516,2795,6,17273,959,0,2,20,8,0
54458,34,986,339,213,244,17,9,65,356,10,42,26,48,52,74,259,421,5,2410,133,0,2,6,2,0
54459,64,2851,1293,570,1093,25,15,163,1318,10,195,123,241,205,364,1516,2795,6,17273,959,0,2,12,3,0
54460,256,5940,4293,999,3693,19,54,507,4312,9,155,88,170,164,258,1156,1898,4,9368,520,0,2,1,1,0
54461,256,5940,1482,859,1002,125,135,219,1607,16,219,134,251,235,385,1766,3032,9,27804,1544,1,2,1,1,0
54462,141,3291,77,34,69,0,0,8,77,3,24,16,29,27,45,114,213,1,387,21,0,2,1,1,0
54463,141,3291,712,438,573,51,9,84,763,14,102,71,128,116,199,733,1364,8,11988,666,0,2,1,1,0
54464,98,4059,1289,550,1043,56,32,155,1345,10,167,93,185,177,278,1266,2075,5,11498,638,0,2,17,7,0
54465,40,2477,652,304,544,16,6,88,668,6,89,51,101,95,152,591,998,3,3399,188,0,2,47,1,0
54466,96,3982,1289,550,1043,56,32,155,1345,10,167,93,185,177,278,1266,2075,5,11498,638,0,2,0,1,0
54467,21,521,205,80,86,16,53,53,221,7,18,10,19,25,29,94,134,3,497,27,0,2,5,2,0
54468,85,3247,1043,504,840,53,9,147,1096,9,180,112,198,189,310,1377,2344,4,11604,644,0,2,9,0,0
54469,179,7896,139,89,101,2,0,35,141,7,54,34,62,61,96,330,569,4,2287,127,0,2,6,0,0
54470,179,7896,7,5,5,0,0,2,7,1,2,1,2,3,3,2,4,0,2,0,0,2,6,0,0
54471,50,1112,91,45,69,0,3,18,91,3,9,6,10,12,16,33,57,1,95,5,0,2,2,0,1
54472,50,1112,367,234,237,17,34,68,384,16,55,34,61,71,95,381,584,8,5183,287,0,2,2,0,1
54473,23,1181,442,244,305,14,16,103,456,11,68,45,75,79,120,452,756,6,4588,254,0,2,9,1,1
54474,20,522,205,80,86,16,53,53,221,7,18,10,19,25,29,94,134,3,497,27,0,2,3,5,0
54475,141,3301,77,34,69,0,0,8,77,3,24,16,29,27,45,114,213,1,387,21,0,2,4,2,1
54476,141,3301,712,438,573,51,9,84,763,14,102,71,128,116,199,733,1364,8,11988,666,0,2,4,2,1
54477,84,3226,1043,504,840,53,9,147,1096,9,180,112,198,189,310,1377,2344,4,11604,644,0,2,10,7,1
54478,2,173,42,7,35,4,0,5,46,1,2,1,2,3,3,2,4,0,2,0,0,2,4,77,1
54479,2,173,11,6,10,0,0,1,11,2,4,2,4,6,6,10,15,1,15,0,0,2,4,77,1
54480,20,522,205,80,86,16,53,53,221,7,18,10,19,25,29,94,134,3,497,27,0,2,5,1,0
54481,27,1218,442,244,305,14,16,103,456,11,68,45,75,79,120,452,756,6,4588,254,0,2,17,7,0
54485,20,522,205,80,86,16,53,53,221,7,18,10,19,25,29,94,134,3,497,27,0,2,1,1,0
54486,142,3311,77,34,69,0,0,8,77,3,24,16,29,27,45,114,213,1,387,21,0,2,2,1,0
54487,142,3311,712,438,573,51,9,84,763,14,102,71,128,116,199,733,1364,8,11988,666,0,2,2,1,0
54488,20,522,205,80,86,16,53,53,221,7,18,10,19,25,29,94,134,3,497,27,0,2,2,1,0
54490,180,5393,1660,832,1314,41,38,274,1701,20,312,209,395,332,604,2671,5058,12,64042,3557,1,2,1,1,0
54491,180,5393,1057,646,719,113,100,145,1170,18,215,134,248,233,382,1740,3004,10,31186,1732,1,2,1,1,0
54492,50,1112,91,45,69,0,3,18,91,3,9,6,10,12,16,33,57,1,95,5,0,2,2,0,0
54493,50,1112,367,234,237,17,34,68,384,16,55,34,61,71,95,381,584,8,5183,287,0,2,2,0,0
54494,27,1218,442,244,305,14,16,103,456,11,68,45,75,79,120,452,756,6,4588,254,0,2,25,7,0
54495,1,86,42,7,35,4,0,5,46,1,2,1,2,3,3,2,4,0,2,0,0,2,23,42,1
54496,1,86,11,6,10,0,0,1,11,2,4,2,4,6,6,10,15,1,15,0,0,2,23,42,1
54497,142,3311,77,34,69,0,0,8,77,3,24,16,29,27,45,114,213,1,387,21,0,2,5,2,0
54498,142,3311,712,438,573,51,9,84,763,14,102,71,128,116,199,733,1364,8,11988,666,0,2,5,2,0
54499,20,522,205,80,86,16,53,53,221,7,18,10,19,25,29,94,134,3,497,27,0,2,10,4,0
54500,84,3226,1043,504,840,53,9,147,1096,9,180,112,198,189,310,1377,2344,4,11604,644,0,2,12,0,0
54501,1,86,42,7,35,4,0,5,46,1,2,1,2,3,3,2,4,0,2,0,0,2,19,111,0
54502,1,86,11,6,10,0,0,1,11,2,4,2,4,6,6,10,15,1,15,0,0,2,19,111,0
54505,180,5397,1660,832,1314,41,38,274,1701,20,312,209,395,332,604,2671,5058,12,64042,3557,1,2,1,1,0
54506,180,5397,1057,646,719,113,100,145,1170,18,215,134,248,233,382,1740,3004,10,31186,1732,1,2,1,1,0
54507,34,986,339,213,244,17,9,65,356,10,42,26,48,52,74,259,421,5,2410,133,0,2,6,5,0
54508,256,5938,4293,999,3693,19,54,507,4312,9,155,88,170,164,258,1156,1898,4,9368,520,0,2,2,3,0
54509,256,5938,1482,859,1002,125,135,219,1607,16,219,134,251,235,385,1766,3032,9,27804,1544,1,2,2,3,0
54510,142,3309,77,34,69,0,0,8,77,3,24,16,29,27,45,114,213,1,387,21,0,2,2,5,0
54511,142,3309,712,438,573,51,9,84,763,14,102,71,128,116,199,733,1364,8,11988,666,0,2,2,5,0
54512,244,5826,722,423,573,19,0,135,741,12,172,101,199,184,300,1320,2257,6,15668,870,0,2,2,2,0
54513,244,5826,1508,847,911,44,250,301,1552,14,148,88,169,162,257,1120,1886,7,15077,837,0,2,2,2,0
54516,99,4081,1289,550,1043,56,32,155,1345,10,167,93,185,177,278,1266,2075,5,11498,638,0,2,43,36,0
54517,179,7977,139,89,101,2,0,35,141,7,54,34,62,61,96,330,569,4,2287,127,0,2,6,0,0
54518,179,7977,7,5,5,0,0,2,7,1,2,1,2,3,3,2,4,0,2,0,0,2,6,0,0
54519,64,2851,1293,570,1093,25,15,163,1318,10,195,123,241,205,364,1516,2795,6,17273,959,0,2,32,11,0
54520,224,4845,1943,715,1694,26,18,214,1969,12,185,120,237,197,357,1436,2721,7,20915,1161,0,2,3,1,0
54521,224,4845,1168,838,957,57,25,144,1225,19,348,224,416,367,640,3018,5452,11,61921,3440,1,2,3,1,0
54522,98,4059,1289,550,1043,56,32,155,1345,10,167,93,185,177,278,1266,2075,5,11498,638,0,2,2,2,0
54523,99,5070,1943,715,1694,26,18,214,1969,12,185,120,237,197,357,1436,2721,7,20915,1161,0,2,2,2,0
54617,218,4718,2,2,2,0,0,0,2,0,0,0,0,0,0,0,0,0,0,0,0,2,1,0,0
54631,218,4718,99,48,90,1,3,5,100,0,0,0,0,0,0,0,0,0,0,0,0,2,1,0,0
54632,218,4718,8,5,5,2,0,1,10,0,0,0,0,0,0,0,0,0,0,0,0,2,1,0,0
54633,218,4718,1217,716,841,84,126,174,1301,14,185,118,215,199,333,1446,2542,8,20687,1149,0,2,1,0,0
54634,218,4718,160,89,115,0,13,31,160,7,15,11,17,22,28,78,124,3,495,27,0,2,1,0,0
54635,218,4718,10,10,9,9,0,0,19,0,0,0,0,0,0,0,0,0,0,0,0,2,1,0,0
54636,218,4718,173,84,99,8,29,36,181,5,12,7,13,17,20,54,81,2,221,12,0,2,1,0,0
54637,218,4718,3,1,1,3,0,0,6,0,0,0,0,0,0,0,0,0,0,0,0,2,1,0,0
54638,25,412,219,78,157,11,5,46,230,3,24,20,34,27,54,114,256,2,545,30,0,2,7,8,0
54639,25,412,108,64,79,9,0,20,117,5,15,11,19,20,30,70,129,3,410,22,0,2,7,8,0
54640,10,454,219,78,157,11,5,46,230,3,24,20,34,27,54,114,256,2,545,30,0,2,6,6,0
54641,25,418,219,78,157,11,5,46,230,3,24,20,34,27,54,114,256,2,545,30,0,2,28,15,0
54642,25,418,108,64,79,9,0,20,117,5,15,11,19,20,30,70,129,3,410,22,0,2,28,15,0
54643,10,454,219,78,157,11,5,46,230,3,24,20,34,27,54,114,256,2,545,30,0,2,53,40,0
54644,9,441,219,78,157,11,5,46,230,3,24,20,34,27,54,114,256,2,545,30,0,2,1,4,0
54645,25,418,219,78,157,11,5,46,230,3,24,20,34,27,54,114,256,2,545,30,0,2,1,1,0
54646,25,418,108,64,79,9,0,20,117,5,15,11,19,20,30,70,129,3,410,22,0,2,1,1,0
54662,44,3226,996,429,845,24,10,117,1020,7,76,50,88,83,138,494,879,4,3565,198,0,2,2,1,1
54663,98,2666,1523,757,1297,19,12,193,1542,12,193,117,230,205,347,1508,2664,7,19053,1058,0,2,5,3,0
54664,98,2666,701,378,504,33,58,109,734,13,110,68,126,123,194,794,1346,7,10027,557,0,2,5,3,0
54665,96,4691,1523,757,1297,19,12,193,1542,12,193,117,230,205,347,1508,2664,7,19053,1058,0,2,16,0,0
54668,99,4081,1289,550,1043,56,32,155,1345,10,167,93,185,177,278,1266,2075,5,11498,638,0,2,2,2,0
54700,180,5397,1660,832,1314,41,38,274,1701,20,312,209,395,332,604,2671,5058,12,64042,3557,1,2,3,2,0
54701,180,5397,1057,646,719,113,100,145,1170,18,215,134,248,233,382,1740,3004,10,31186,1732,1,2,3,2,0
54702,76,1733,996,429,845,24,10,117,1020,7,76,50,88,83,138,494,879,4,3565,198,0,2,4,5,0
54703,76,1733,456,277,329,12,42,72,468,13,85,50,97,98,147,592,972,7,7212,400,0,2,4,5,0
54704,67,1324,207,111,150,11,0,50,218,5,26,19,36,31,55,133,272,3,943,52,0,2,0,7,0
54705,67,1324,410,198,237,31,55,97,441,11,63,38,72,74,110,414,683,6,4293,238,0,2,0,7,0
54708,218,4716,2,2,2,0,0,0,2,0,0,0,0,0,0,0,0,0,0,0,0,2,32,29,0
54722,218,4716,99,48,90,1,3,5,100,0,0,0,0,0,0,0,0,0,0,0,0,2,32,29,0
54723,218,4716,8,5,5,2,0,1,10,0,0,0,0,0,0,0,0,0,0,0,0,2,32,29,0
54724,218,4716,1217,716,841,84,126,174,1301,14,185,118,215,199,333,1446,2542,8,20687,1149,0,2,32,29,0
54725,218,4716,160,89,115,0,13,31,160,7,15,11,17,22,28,78,124,3,495,27,0,2,32,29,0
54726,218,4716,10,10,9,9,0,0,19,0,0,0,0,0,0,0,0,0,0,0,0,2,32,29,0
54727,218,4716,173,84,99,8,29,36,181,5,12,7,13,17,20,54,81,2,221,12,0,2,32,29,0
54728,218,4716,3,1,1,3,0,0,6,0,0,0,0,0,0,0,0,0,0,0,0,2,32,29,0
54731,256,5938,4293,999,3693,19,54,507,4312,9,155,88,170,164,258,1156,1898,4,9368,520,0,2,20,15,0
54732,256,5938,1482,859,1002,125,135,219,1607,16,219,134,251,235,385,1766,3032,9,27804,1544,1,2,20,15,0
54734,142,3309,77,34,69,0,0,8,77,3,24,16,29,27,45,114,213,1,387,21,0,2,10,4,0
54735,142,3309,712,438,573,51,9,84,763,14,102,71,128,116,199,733,1364,8,11988,666,0,2,10,4,0
54738,24,600,2,2,2,0,0,0,2,0,0,0,0,0,0,0,0,0,0,0,0,2,2,7,0
54752,24,600,99,48,90,1,3,5,100,0,0,0,0,0,0,0,0,0,0,0,0,2,2,7,0
54753,24,600,8,5,5,2,0,1,10,0,0,0,0,0,0,0,0,0,0,0,0,2,2,7,0
54754,24,600,1217,716,841,84,126,174,1301,14,185,118,215,199,333,1446,2542,8,20687,1149,0,2,2,7,0
54755,24,600,160,89,115,0,13,31,160,7,15,11,17,22,28,78,124,3,495,27,0,2,2,7,0
54756,24,600,10,10,9,9,0,0,19,0,0,0,0,0,0,0,0,0,0,0,0,2,2,7,0
54757,24,600,173,84,99,8,29,36,181,5,12,7,13,17,20,54,81,2,221,12,0,2,2,7,0
54758,24,600,3,1,1,3,0,0,6,0,0,0,0,0,0,0,0,0,0,0,0,2,2,7,0
54759,88,1887,402,202,227,24,74,80,426,12,52,33,61,64,94,339,564,7,3969,220,0,2,11,2,0
54760,88,1985,53,23,39,0,0,13,53,2,8,4,8,10,12,26,39,1,39,2,0,2,12,9,0
54761,88,1985,515,298,307,33,80,99,548,12,63,44,77,75,121,419,753,7,5527,307,0,2,12,9,0
54763,50,1112,91,45,69,0,3,18,91,3,9,6,10,12,16,33,57,1,95,5,0,0,283,0,0
54764,50,1112,367,234,237,17,34,68,384,16,55,34,61,71,95,381,584,8,5183,287,0,0,283,0,0
54766,244,5826,722,423,573,19,0,135,741,12,172,101,199,184,300,1320,2257,6,15668,870,0,2,68,6,0
54767,244,5826,1508,847,911,44,250,301,1552,14,148,88,169,162,257,1120,1886,7,15077,837,0,2,68,6,0
54768,305,6770,72,33,56,0,4,12,72,1,1,1,1,2,2,0,2,0,1,0,0,2,32,56,0
54769,305,6770,1454,835,1044,76,110,219,1530,17,275,158,296,292,454,2297,3718,9,34017,1889,1,2,32,56,0
54770,41,829,386,256,301,16,9,68,402,4,59,35,69,63,104,355,621,2,1453,80,0,2,18,39,0
54771,41,829,264,131,164,11,41,46,275,6,38,22,40,44,62,214,338,3,1068,59,0,2,18,39,0
54780,29,716,601,196,481,2,23,85,603,8,63,36,72,71,108,400,664,4,3036,168,0,2,10,10,0
54781,29,716,156,79,106,5,16,28,161,5,14,8,15,19,23,64,97,2,261,14,0,2,10,10,0
54782,99,4081,1289,550,1043,56,32,155,1345,10,167,93,185,177,278,1266,2075,5,11498,638,0,2,42,12,0
54784,24,1145,75,38,59,1,3,12,76,2,4,2,4,6,6,10,15,1,15,0,0,2,68,0,0
54786,103,4797,1338,495,1086,10,64,173,1348,11,122,82,157,133,239,883,1686,7,11934,663,0,2,6,0,0
54787,179,7977,139,89,101,2,0,35,141,7,54,34,62,61,96,330,569,4,2287,127,0,2,42,43,0
54788,179,7977,7,5,5,0,0,2,7,1,2,1,2,3,3,2,4,0,2,0,0,2,42,43,0
54791,97,4228,1020,354,843,12,15,144,1032,8,134,77,144,142,221,970,1580,4,6792,377,0,2,39,4,0
54792,47,2228,722,423,573,19,0,135,741,12,172,101,199,184,300,1320,2257,6,15668,870,0,2,32,0,0
54794,84,3226,1043,504,840,53,9,147,1096,9,180,112,198,189,310,1377,2344,4,11604,644,0,2,29,1,0
54796,27,1218,442,244,305,14,16,103,456,11,68,45,75,79,120,452,756,6,4588,254,0,2,118,9,0
54797,40,1425,601,196,481,2,23,85,603,8,63,36,72,71,108,400,664,4,3036,168,0,2,66,4,0
54924,1,86,42,7,35,4,0,5,46,1,2,1,2,3,3,2,4,0,2,0,0,2,1,1,0
54925,1,86,11,6,10,0,0,1,11,2,4,2,4,6,6,10,15,1,15,0,0,2,1,1,0
54926,53,1164,91,45,69,0,3,18,91,3,9,6,10,12,16,33,57,1,95,5,0,2,21,0,1
54927,53,1164,367,234,237,17,34,68,384,16,55,34,61,71,95,381,584,8,5183,287,0,2,21,0,1
54928,27,1248,442,244,305,14,16,103,456,11,68,45,75,79,120,452,756,6,4588,254,0,2,4,0,1
54929,29,1261,442,244,305,14,16,103,456,11,68,45,75,79,120,452,756,6,4588,254,0,2,1,1,0
54930,30,1268,442,244,305,14,16,103,456,11,68,45,75,79,120,452,756,6,4588,254,0,2,4,2,0
54931,25,397,219,78,157,11,5,46,230,3,24,20,34,27,54,114,256,2,545,30,0,2,1,3,0
54932,25,397,108,64,79,9,0,20,117,5,15,11,19,20,30,70,129,3,410,22,0,2,1,3,0
54933,30,1268,442,244,305,14,16,103,456,11,68,45,75,79,120,452,756,6,4588,254,0,2,5,3,0
54934,53,1164,91,45,69,0,3,18,91,3,9,6,10,12,16,33,57,1,95,5,0,2,21,0,0
54935,53,1164,367,234,237,17,34,68,384,16,55,34,61,71,95,381,584,8,5183,287,0,2,21,0,0
54936,30,1268,442,244,305,14,16,103,456,11,68,45,75,79,120,452,756,6,4588,254,0,2,7,1,0
54937,224,4857,1943,715,1694,26,18,214,1969,12,185,120,237,197,357,1436,2721,7,20915,1161,0,2,13,13,0
54938,224,4857,1168,838,957,57,25,144,1225,19,348,224,416,367,640,3018,5452,11,61921,3440,1,2,13,13,0
54939,41,843,386,256,301,16,9,68,402,4,59,35,69,63,104,355,621,2,1453,80,0,2,2,0,1
54940,41,843,264,131,164,11,41,46,275,6,38,22,40,44,62,214,338,3,1068,59,0,2,2,0,1
54941,43,1873,386,256,301,16,9,68,402,4,59,35,69,63,104,355,621,2,1453,80,0,2,6,0,1
54946,43,898,386,256,301,16,9,68,402,4,59,35,69,63,104,355,621,2,1453,80,0,2,12,1,1
54947,43,898,264,131,164,11,41,46,275,6,38,22,40,44,62,214,338,3,1068,59,0,2,12,1,1
54957,68,1356,207,111,150,11,0,50,218,5,26,19,36,31,55,133,272,3,943,52,0,2,10,2,0
54958,68,1356,410,198,237,31,55,97,441,11,63,38,72,74,110,414,683,6,4293,238,0,2,10,2,0
54959,75,3898,1296,573,1062,40,33,157,1336,8,201,118,231,209,349,1561,2689,4,12365,686,0,2,20,0,0
54960,43,898,386,256,301,16,9,68,402,4,59,35,69,63,104,355,621,2,1453,80,0,2,14,1,0
54961,43,898,264,131,164,11,41,46,275,6,38,22,40,44,62,214,338,3,1068,59,0,2,14,1,0
54962,43,1873,386,256,301,16,9,68,402,4,59,35,69,63,104,355,621,2,1453,80,0,2,6,0,0
54963,29,724,601,196,481,2,23,85,603,8,63,36,72,71,108,400,664,4,3036,168,0,2,1,1,0
54964,29,724,156,79,106,5,16,28,161,5,14,8,15,19,23,64,97,2,261,14,0,2,1,1,0
54965,41,1472,601,196,481,2,23,85,603,8,63,36,72,71,108,400,664,4,3036,168,0,2,29,0,0
54972,94,2434,773,422,505,30,103,129,803,14,77,46,83,91,129,535,839,7,6334,351,0,2,23,0,0
54973,34,2285,1157,318,931,29,22,177,1186,6,104,63,125,110,188,712,1274,3,4596,255,0,2,36,0,0
54992,224,4857,1943,715,1694,26,18,214,1969,12,185,120,237,197,357,1436,2721,7,20915,1161,0,2,16,14,0
54993,224,4857,1168,838,957,57,25,144,1225,19,348,224,416,367,640,3018,5452,11,61921,3440,1,2,16,14,0
54994,99,4081,1289,550,1043,56,32,155,1345,10,167,93,185,177,278,1266,2075,5,11498,638,0,2,45,38,0
55001,256,5953,4293,999,3693,19,54,507,4312,9,155,88,170,164,258,1156,1898,4,9368,520,0,2,10,5,0
55002,256,5953,1482,859,1002,125,135,219,1607,16,219,134,251,235,385,1766,3032,9,27804,1544,1,2,10,5,0
55003,3,33,15,9,9,0,0,6,15,0,0,0,0,0,0,0,0,0,0,0,0,0,15,0,0
55004,180,8007,139,89,101,2,0,35,141,7,54,34,62,61,96,330,569,4,2287,127,0,2,7,0,0
55005,180,8007,7,5,5,0,0,2,7,1,2,1,2,3,3,2,4,0,2,0,0,2,7,0,0
55009,258,5960,4293,999,3693,19,54,507,4312,9,155,88,170,164,258,1156,1898,4,9368,520,0,2,4,1,1
55010,258,5960,1482,859,1002,125,135,219,1607,16,219,134,251,235,385,1766,3032,9,27804,1544,1,2,4,1,1
55011,25,1183,75,38,59,1,3,12,76,2,4,2,4,6,6,10,15,1,15,0,0,2,12,0,1
55012,2,18,10,6,6,0,0,4,10,0,0,0,0,0,0,0,0,0,0,0,0,0,10,0,1
55019,258,5960,4293,999,3693,19,54,507,4312,9,155,88,170,164,258,1156,1898,4,9368,520,0,2,4,1,0
55020,258,5960,1482,859,1002,125,135,219,1607,16,219,134,251,235,385,1766,3032,9,27804,1544,1,2,4,1,0
55021,25,1183,75,38,59,1,3,12,76,2,4,2,4,6,6,10,15,1,15,0,0,2,12,0,0
55022,2,18,10,6,6,0,0,4,10,0,0,0,0,0,0,0,0,0,0,0,0,0,10,0,0
55023,180,5397,1660,832,1314,41,38,274,1701,20,312,209,395,332,604,2671,5058,12,64042,3557,1,2,1,2,0
55024,180,5397,1057,646,719,113,100,145,1170,18,215,134,248,233,382,1740,3004,10,31186,1732,1,2,1,2,0
55025,53,1166,91,45,69,0,3,18,91,3,9,6,10,12,16,33,57,1,95,5,0,2,2,2,0
55026,53,1166,367,234,237,17,34,68,384,16,55,34,61,71,95,381,584,8,5183,287,0,2,2,2,0
55033,218,4720,2,2,2,0,0,0,2,0,0,0,0,0,0,0,0,0,0,0,0,2,1,1,0
55047,218,4720,99,48,90,1,3,5,100,0,0,0,0,0,0,0,0,0,0,0,0,2,1,1,0
55048,218,4720,8,5,5,2,0,1,10,0,0,0,0,0,0,0,0,0,0,0,0,2,1,1,0
55049,218,4720,1217,716,841,84,126,174,1301,14,185,118,215,199,333,1446,2542,8,20687,1149,0,2,1,1,0
55050,218,4720,160,89,115,0,13,31,160,7,15,11,17,22,28,78,124,3,495,27,0,2,1,1,0
55051,218,4720,10,10,9,9,0,0,19,0,0,0,0,0,0,0,0,0,0,0,0,2,1,1,0
55052,218,4720,173,84,99,8,29,36,181,5,12,7,13,17,20,54,81,2,221,12,0,2,1,1,0
55053,218,4720,3,1,1,3,0,0,6,0,0,0,0,0,0,0,0,0,0,0,0,2,1,1,0
55054,40,2509,652,304,544,16,6,88,668,6,89,51,101,95,152,591,998,3,3399,188,0,2,7,1,0
55055,52,1137,91,45,69,0,3,18,91,3,9,6,10,12,16,33,57,1,95,5,0,2,2,10,0
55056,52,1137,367,234,237,17,34,68,384,16,55,34,61,71,95,381,584,8,5183,287,0,2,2,10,0
55083,227,4920,1943,715,1694,26,18,214,1969,12,185,120,237,197,357,1436,2721,7,20915,1161,0,2,13,2,1
55084,227,4920,1168,838,957,57,25,144,1225,19,348,224,416,367,640,3018,5452,11,61921,3440,1,2,13,2,1
55087,218,4727,2,2,2,0,0,0,2,0,0,0,0,0,0,0,0,0,0,0,0,2,2,0,0
55101,218,4727,99,48,90,1,3,5,100,0,0,0,0,0,0,0,0,0,0,0,0,2,2,0,0
55102,218,4727,8,5,5,2,0,1,10,0,0,0,0,0,0,0,0,0,0,0,0,2,2,0,0
55103,218,4727,1217,716,841,84,126,174,1301,14,185,118,215,199,333,1446,2542,8,20687,1149,0,2,2,0,0
55104,218,4727,160,89,115,0,13,31,160,7,15,11,17,22,28,78,124,3,495,27,0,2,2,0,0
55105,218,4727,10,10,9,9,0,0,19,0,0,0,0,0,0,0,0,0,0,0,0,2,2,0,0
55106,218,4727,173,84,99,8,29,36,181,5,12,7,13,17,20,54,81,2,221,12,0,2,2,0,0
55107,218,4727,3,1,1,3,0,0,6,0,0,0,0,0,0,0,0,0,0,0,0,2,2,0,0
55108,227,4920,1943,715,1694,26,18,214,1969,12,185,120,237,197,357,1436,2721,7,20915,1161,0,2,13,2,0
55109,227,4920,1168,838,957,57,25,144,1225,19,348,224,416,367,640,3018,5452,11,61921,3440,1,2,13,2,0
55137,258,5975,4293,999,3693,19,54,507,4312,9,155,88,170,164,258,1156,1898,4,9368,520,0,2,10,5,0
55138,258,5975,1482,859,1002,125,135,219,1607,16,219,134,251,235,385,1766,3032,9,27804,1544,1,2,10,5,0
55140,52,1139,91,45,69,0,3,18,91,3,9,6,10,12,16,33,57,1,95,5,0,2,2,2,0
55141,52,1139,367,234,237,17,34,68,384,16,55,34,61,71,95,381,584,8,5183,287,0,2,2,2,0
55154,31,934,339,213,244,17,9,65,356,10,42,26,48,52,74,259,421,5,2410,133,0,2,0,15,0
55155,64,2859,1293,570,1093,25,15,163,1318,10,195,123,241,205,364,1516,2795,6,17273,959,0,2,7,1,0
55200,31,932,339,213,244,17,9,65,356,10,42,26,48,52,74,259,421,5,2410,133,0,2,0,1,0
55202,223,4835,1943,715,1694,26,18,214,1969,12,185,120,237,197,357,1436,2721,7,20915,1161,0,2,2,3,0
55203,223,4835,1168,838,957,57,25,144,1225,19,348,224,416,367,640,3018,5452,11,61921,3440,1,2,2,3,0
55204,41,1474,601,196,481,2,23,85,603,8,63,36,72,71,108,400,664,4,3036,168,0,2,3,2,0
55205,94,2434,773,422,505,30,103,129,803,14,77,46,83,91,129,535,839,7,6334,351,0,2,2,2,0
55208,218,4736,2,2,2,0,0,0,2,0,0,0,0,0,0,0,0,0,0,0,0,2,4,1,0
55222,218,4736,99,48,90,1,3,5,100,0,0,0,0,0,0,0,0,0,0,0,0,2,4,1,0
55223,218,4736,8,5,5,2,0,1,10,0,0,0,0,0,0,0,0,0,0,0,0,2,4,1,0
55224,218,4736,1217,716,841,84,126,174,1301,14,185,118,215,199,333,1446,2542,8,20687,1149,0,2,4,1,0
55225,218,4736,160,89,115,0,13,31,160,7,15,11,17,22,28,78,124,3,495,27,0,2,4,1,0
55226,218,4736,10,10,9,9,0,0,19,0,0,0,0,0,0,0,0,0,0,0,0,2,4,1,0
55227,218,4736,173,84,99,8,29,36,181,5,12,7,13,17,20,54,81,2,221,12,0,2,4,1,0
55228,218,4736,3,1,1,3,0,0,6,0,0,0,0,0,0,0,0,0,0,0,0,2,4,1,0
55232,218,4740,2,2,2,0,0,0,2,0,0,0,0,0,0,0,0,0,0,0,0,2,5,0,0
55246,218,4740,99,48,90,1,3,5,100,0,0,0,0,0,0,0,0,0,0,0,0,2,5,0,0
55247,218,4740,8,5,5,2,0,1,10,0,0,0,0,0,0,0,0,0,0,0,0,2,5,0,0
55248,218,4740,1217,716,841,84,126,174,1301,14,185,118,215,199,333,1446,2542,8,20687,1149,0,2,5,0,0
55249,218,4740,160,89,115,0,13,31,160,7,15,11,17,22,28,78,124,3,495,27,0,2,5,0,0
55250,218,4740,10,10,9,9,0,0,19,0,0,0,0,0,0,0,0,0,0,0,0,2,5,0,0
55251,218,4740,173,84,99,8,29,36,181,5,12,7,13,17,20,54,81,2,221,12,0,2,5,0,0
55252,218,4740,3,1,1,3,0,0,6,0,0,0,0,0,0,0,0,0,0,0,0,2,5,0,0
55257,2,40,9,6,6,0,0,3,9,0,0,0,0,0,0,0,0,0,0,0,0,2,1,0,1
55258,2,40,13,9,8,0,0,4,13,0,0,0,0,0,0,0,0,0,0,0,0,2,1,0,1
55260,1,319,382,65,130,157,2,92,539,4,10,5,10,14,15,41,57,2,114,6,0,2,1,3,1
55261,60,1078,282,196,195,3,0,86,285,8,130,71,141,138,212,936,1507,4,6538,363,0,2,3,2,1
55279,7,296,72,33,56,0,4,12,72,1,1,1,1,2,2,0,2,0,1,0,0,2,1,0,1
55280,12,229,127,75,83,2,11,30,129,4,14,7,14,18,21,61,87,2,175,9,0,2,0,1,1
55281,12,229,652,304,544,16,6,88,668,6,89,51,101,95,152,591,998,3,3399,188,0,2,0,1,1
55282,12,229,2,2,2,0,0,0,2,0,0,0,0,0,0,0,0,0,0,0,0,2,0,1,1
55283,12,229,8,5,5,0,0,3,8,0,0,0,0,0,0,0,0,0,0,0,0,2,0,1,1
55286,12,229,14,8,8,0,0,6,14,0,0,0,0,0,0,0,0,0,0,0,0,2,0,1,1
55287,12,229,6,4,4,0,0,2,6,0,0,0,0,0,0,0,0,0,0,0,0,2,0,1,1
55288,12,229,6,4,4,0,0,2,6,1,2,1,2,3,3,2,4,0,2,0,0,2,0,1,1
55290,12,229,7,5,5,0,0,2,7,0,0,0,0,0,0,0,0,0,0,0,0,2,0,1,1
55292,12,229,10,6,6,0,0,4,10,0,0,0,0,0,0,0,0,0,0,0,0,2,0,1,1
55293,12,229,1,1,1,0,0,0,1,0,0,0,0,0,0,0,0,0,0,0,0,2,0,1,1
55295,12,229,14,10,10,0,0,4,14,1,1,1,1,2,2,0,2,0,1,0,0,2,0,1,1
55296,12,229,46,26,30,3,0,12,49,3,6,3,6,9,9,20,28,1,42,2,0,2,0,1,1
55297,6,71,127,75,83,2,11,30,129,4,14,7,14,18,21,61,87,2,175,9,0,2,1,0,1
55298,6,71,652,304,544,16,6,88,668,6,89,51,101,95,152,591,998,3,3399,188,0,2,1,0,1
55299,6,71,2,2,2,0,0,0,2,0,0,0,0,0,0,0,0,0,0,0,0,2,1,0,1
55300,6,71,8,5,5,0,0,3,8,0,0,0,0,0,0,0,0,0,0,0,0,2,1,0,1
55303,6,71,14,8,8,0,0,6,14,0,0,0,0,0,0,0,0,0,0,0,0,2,1,0,1
55304,6,71,6,4,4,0,0,2,6,0,0,0,0,0,0,0,0,0,0,0,0,2,1,0,1
55305,6,71,6,4,4,0,0,2,6,1,2,1,2,3,3,2,4,0,2,0,0,2,1,0,1
55307,6,71,7,5,5,0,0,2,7,0,0,0,0,0,0,0,0,0,0,0,0,2,1,0,1
55309,6,71,10,6,6,0,0,4,10,0,0,0,0,0,0,0,0,0,0,0,0,2,1,0,1
55310,6,71,1,1,1,0,0,0,1,0,0,0,0,0,0,0,0,0,0,0,0,2,1,0,1
55312,6,71,14,10,10,0,0,4,14,1,1,1,1,2,2,0,2,0,1,0,0,2,1,0,1
55313,6,71,46,26,30,3,0,12,49,3,6,3,6,9,9,20,28,1,42,2,0,2,1,0,1
55314,17,378,85,59,61,8,0,16,93,5,18,10,18,23,28,86,126,2,316,17,0,2,1,0,1
55315,12,515,124,78,88,2,3,26,126,4,13,7,13,17,20,56,81,2,163,9,0,2,6,2,1
55316,1,86,42,7,35,4,0,5,46,1,2,1,2,3,3,2,4,0,2,0,0,2,1,0,1
55317,1,86,11,6,10,0,0,1,11,2,4,2,4,6,6,10,15,1,15,0,0,2,1,0,1
55318,11,242,19,8,11,5,0,4,24,2,5,3,6,7,9,13,25,1,30,1,0,2,5,2,1
55319,11,242,102,59,69,5,3,24,107,6,22,15,28,28,43,113,206,3,789,43,0,2,5,2,1
55320,11,242,106,40,36,3,49,17,109,8,17,13,23,25,36,93,167,5,904,50,0,2,5,2,1
55344,222,4859,182,127,129,0,0,53,182,5,39,21,42,44,63,217,343,2,926,51,0,2,15,7,1
55345,222,4859,1165,710,800,67,119,181,1232,18,243,153,282,261,435,2000,3492,10,36473,2026,1,2,15,7,1
55346,68,1565,773,419,590,28,0,166,801,10,204,113,217,214,330,1598,2554,5,13587,754,0,2,8,5,1
55347,68,1565,421,273,302,44,34,57,465,17,81,59,107,98,166,583,1098,11,12329,684,0,2,8,5,1
55350,26,529,2,2,2,0,0,0,2,0,0,0,0,0,0,0,0,0,0,0,0,2,6,2,1
55364,26,529,99,48,90,1,3,5,100,0,0,0,0,0,0,0,0,0,0,0,0,2,6,2,1
55365,26,529,8,5,5,2,0,1,10,0,0,0,0,0,0,0,0,0,0,0,0,2,6,2,1
55366,26,529,1217,716,841,84,126,174,1301,14,185,118,215,199,333,1446,2542,8,20687,1149,0,2,6,2,1
55367,26,529,160,89,115,0,13,31,160,7,15,11,17,22,28,78,124,3,495,27,0,2,6,2,1
55368,26,529,10,10,9,9,0,0,19,0,0,0,0,0,0,0,0,0,0,0,0,2,6,2,1
55369,26,529,173,84,99,8,29,36,181,5,12,7,13,17,20,54,81,2,221,12,0,2,6,2,1
55370,26,529,3,1,1,3,0,0,6,0,0,0,0,0,0,0,0,0,0,0,0,2,6,2,1
55371,180,5401,1660,832,1314,41,38,274,1701,20,312,209,395,332,604,2671,5058,12,64042,3557,1,2,7,4,1
55372,180,5401,1057,646,719,113,100,145,1170,18,215,134,248,233,382,1740,3004,10,31186,1732,1,2,7,4,1
55373,17,348,95,58,50,9,16,20,104,12,33,24,45,45,69,209,378,8,3100,172,0,2,4,1,1
55374,89,1829,477,336,357,30,23,73,507,16,194,134,250,210,384,1538,2962,10,30538,1696,0,2,6,2,1
55375,76,1743,996,429,845,24,10,117,1020,7,76,50,88,83,138,494,879,4,3565,198,0,2,9,5,1
55376,76,1743,456,277,329,12,42,72,468,13,85,50,97,98,147,592,972,7,7212,400,0,2,9,5,1
55377,154,3265,1513,682,1277,25,13,200,1538,11,199,116,219,210,335,1557,2584,6,15641,868,0,2,6,3,1
55378,154,3265,819,519,539,24,98,155,843,15,96,57,106,111,163,690,1107,8,9171,509,0,2,6,3,1
55379,68,1364,207,111,150,11,0,50,218,5,26,19,36,31,55,133,272,3,943,52,0,2,7,4,1
55380,68,1364,410,198,237,31,55,97,441,11,63,38,72,74,110,414,683,6,4293,238,0,2,7,4,1
55383,218,4738,2,2,2,0,0,0,2,0,0,0,0,0,0,0,0,0,0,0,0,2,20,13,1
55397,218,4738,99,48,90,1,3,5,100,0,0,0,0,0,0,0,0,0,0,0,0,2,20,13,1
55398,218,4738,8,5,5,2,0,1,10,0,0,0,0,0,0,0,0,0,0,0,0,2,20,13,1
55399,218,4738,1217,716,841,84,126,174,1301,14,185,118,215,199,333,1446,2542,8,20687,1149,0,2,20,13,1
55400,218,4738,160,89,115,0,13,31,160,7,15,11,17,22,28,78,124,3,495,27,0,2,20,13,1
55401,218,4738,10,10,9,9,0,0,19,0,0,0,0,0,0,0,0,0,0,0,0,2,20,13,1
55402,218,4738,173,84,99,8,29,36,181,5,12,7,13,17,20,54,81,2,221,12,0,2,20,13,1
55403,218,4738,3,1,1,3,0,0,6,0,0,0,0,0,0,0,0,0,0,0,0,2,20,13,1
55404,97,1999,463,295,324,28,62,57,491,12,134,82,154,146,236,989,1696,6,11700,650,0,2,3,4,1
55405,51,757,167,116,138,4,5,22,171,8,48,30,56,56,86,292,499,4,2330,129,0,2,3,1,1
55406,31,936,339,213,244,17,9,65,356,10,42,26,48,52,74,259,421,5,2410,133,0,2,3,1,1
55408,85,2182,1455,414,1257,16,76,112,1471,5,41,23,46,46,69,231,381,2,1069,59,0,2,8,4,1
55409,85,2182,669,365,481,22,61,110,691,15,103,63,122,118,185,747,1273,8,11311,628,0,2,8,4,1
55410,256,6014,4293,999,3693,19,54,507,4312,9,155,88,170,164,258,1156,1898,4,9368,520,0,2,24,22,1
55411,256,6014,1482,859,1002,125,135,219,1607,16,219,134,251,235,385,1766,3032,9,27804,1544,1,2,24,22,1
55412,6,140,44,22,19,0,19,6,44,2,10,6,12,12,18,35,64,1,77,4,0,2,3,1,1
55413,27,968,74,35,59,1,0,14,75,3,14,7,14,17,21,58,85,1,128,7,0,2,8,4,1
55414,27,968,245,125,200,5,7,34,250,7,30,17,34,37,51,166,265,3,1053,58,0,2,8,4,1
55415,52,622,647,139,84,35,284,233,682,0,0,0,0,0,0,0,0,0,0,0,0,2,1,1,1
55416,98,2670,1523,757,1297,19,12,193,1542,12,193,117,230,205,347,1508,2664,7,19053,1058,0,2,6,2,1
55417,98,2670,701,378,504,33,58,109,734,13,110,68,126,123,194,794,1346,7,10027,557,0,2,6,2,1
55418,94,2438,773,422,505,30,103,129,803,14,77,46,83,91,129,535,839,7,6334,351,0,2,7,4,1
55419,142,3319,77,34,69,0,0,8,77,3,24,16,29,27,45,114,213,1,387,21,0,2,9,6,1
55420,142,3319,712,438,573,51,9,84,763,14,102,71,128,116,199,733,1364,8,11988,666,0,2,9,6,1
55423,24,628,2,2,2,0,0,0,2,0,0,0,0,0,0,0,0,0,0,0,0,2,15,13,1
55437,24,628,99,48,90,1,3,5,100,0,0,0,0,0,0,0,0,0,0,0,0,2,15,13,1
55438,24,628,8,5,5,2,0,1,10,0,0,0,0,0,0,0,0,0,0,0,0,2,15,13,1
55439,24,628,1217,716,841,84,126,174,1301,14,185,118,215,199,333,1446,2542,8,20687,1149,0,2,15,13,1
55440,24,628,160,89,115,0,13,31,160,7,15,11,17,22,28,78,124,3,495,27,0,2,15,13,1
55441,24,628,10,10,9,9,0,0,19,0,0,0,0,0,0,0,0,0,0,0,0,2,15,13,1
55442,24,628,173,84,99,8,29,36,181,5,12,7,13,17,20,54,81,2,221,12,0,2,15,13,1
55443,24,628,3,1,1,3,0,0,6,0,0,0,0,0,0,0,0,0,0,0,0,2,15,13,1
55444,30,664,125,97,103,3,0,19,128,9,25,17,27,34,44,144,223,4,1087,60,0,2,5,3,1
55445,23,367,102,57,55,5,16,25,107,5,17,10,18,22,28,81,124,2,330,18,0,2,2,1,1
55446,88,1899,402,202,227,24,74,80,426,12,52,33,61,64,94,339,564,7,3969,220,0,2,6,3,1
55447,52,1075,447,308,343,6,5,95,453,7,96,59,111,103,170,651,1136,4,4600,255,0,2,4,2,1
55448,52,1075,322,174,179,16,74,51,338,10,41,26,46,51,72,252,408,5,2291,127,0,2,4,2,1
55449,88,1993,53,23,39,0,0,13,53,2,8,4,8,10,12,26,39,1,39,2,0,2,8,6,1
55450,88,1993,515,298,307,33,80,99,548,12,63,44,77,75,121,419,753,7,5527,307,0,2,8,6,1
55451,23,389,424,94,331,4,0,89,428,1,5,5,5,6,10,11,25,0,12,0,0,2,6,2,1
55452,23,389,38,23,23,6,0,8,44,3,11,7,11,14,18,42,68,1,102,5,0,2,6,2,1
55453,20,526,205,80,86,16,53,53,221,7,18,10,19,25,29,94,134,3,497,27,0,2,4,1,1
55454,17,523,184,100,137,2,15,30,186,6,38,20,39,44,59,214,322,3,991,55,0,2,7,3,1
55455,17,523,103,65,74,8,5,16,111,7,17,9,17,24,26,89,119,3,417,23,0,2,7,3,1
55456,53,1178,91,45,69,0,3,18,91,3,9,6,10,12,16,33,57,1,95,5,0,2,14,11,1
55457,53,1178,367,234,237,17,34,68,384,16,55,34,61,71,95,381,584,8,5183,287,0,2,14,11,1
55458,244,5842,722,423,573,19,0,135,741,12,172,101,199,184,300,1320,2257,6,15668,870,0,2,13,9,1
55459,244,5842,1508,847,911,44,250,301,1552,14,148,88,169,162,257,1120,1886,7,15077,837,0,2,13,9,1
55460,305,6844,72,33,56,0,4,12,72,1,1,1,1,2,2,0,2,0,1,0,0,2,30,32,1
55461,305,6844,1454,835,1044,76,110,219,1530,17,275,158,296,292,454,2297,3718,9,34017,1889,1,2,30,32,1
55462,91,1836,757,253,292,73,244,162,830,13,61,38,67,74,105,409,651,7,4654,258,0,2,6,6,1
55463,43,902,386,256,301,16,9,68,402,4,59,35,69,63,104,355,621,2,1453,80,0,2,4,3,1
55464,43,902,264,131,164,11,41,46,275,6,38,22,40,44,62,214,338,3,1068,59,0,2,4,3,1
55465,28,707,466,257,367,18,25,50,484,7,126,86,171,133,257,898,1813,4,8612,478,0,2,1,0,1
55466,28,707,507,281,342,29,59,88,536,10,53,29,57,63,86,336,514,5,2764,153,0,2,1,0,1
55467,30,658,215,129,180,6,0,29,221,8,65,43,72,73,115,415,711,4,3153,175,0,2,5,2,1
55468,30,658,97,69,77,3,3,16,100,6,22,13,23,28,36,113,173,3,542,30,0,2,5,2,1
55469,92,1975,1043,504,840,53,9,147,1096,9,180,112,198,189,310,1377,2344,4,11604,644,0,2,10,4,1
55470,92,1975,383,288,292,26,6,62,409,11,65,38,67,76,105,429,656,5,3719,206,0,2,10,4,1
55471,20,420,294,64,250,0,0,43,294,1,20,10,20,21,30,86,131,0,65,3,0,2,5,2,1
55472,20,420,78,46,62,3,0,14,81,3,8,4,8,11,12,28,41,1,62,3,0,2,5,2,1
55473,5,123,110,30,77,3,13,16,113,4,21,15,30,25,45,100,208,2,597,33,0,2,3,1,1
55474,5,123,28,15,21,1,0,6,29,0,0,0,0,0,0,0,0,0,0,0,0,2,3,1,1
55475,70,1394,1178,367,1042,6,15,115,1184,9,94,51,95,103,146,644,976,4,4439,246,0,2,6,2,1
55476,70,1394,177,108,140,8,0,27,185,6,30,16,32,36,48,162,248,3,794,44,0,2,6,2,1
55477,223,4852,1943,715,1694,26,18,214,1969,12,185,120,237,197,357,1436,2721,7,20915,1161,0,2,9,11,1
55478,223,4852,1168,838,957,57,25,144,1225,19,348,224,416,367,640,3018,5452,11,61921,3440,1,2,9,11,1
55479,19,682,442,244,305,14,16,103,456,11,68,45,75,79,120,452,756,6,4588,254,0,2,13,12,1
55480,19,682,182,102,99,11,40,35,193,3,11,6,11,14,17,42,64,1,97,5,0,2,13,12,1
55481,62,1255,1098,241,925,5,10,155,1103,7,46,25,49,53,74,273,423,3,1580,87,0,2,11,5,1
55482,62,1255,282,202,222,14,2,44,296,8,42,24,43,50,67,250,378,4,1548,86,0,2,11,5,1
55483,29,728,601,196,481,2,23,85,603,8,63,36,72,71,108,400,664,4,3036,168,0,2,3,2,1
55484,29,728,156,79,106,5,16,28,161,5,14,8,15,19,23,64,97,2,261,14,0,2,3,2,1
55485,99,4089,1289,550,1043,56,32,155,1345,10,167,93,185,177,278,1266,2075,5,11498,638,0,2,7,3,1
55486,35,1083,182,127,129,0,0,53,182,5,39,21,42,44,63,217,343,2,926,51,0,2,6,4,1
55487,152,7159,1392,870,1177,35,17,170,1427,14,494,280,531,508,811,4473,7289,7,54850,3047,2,2,11,10,1
55488,90,2889,773,419,590,28,0,166,801,10,204,113,217,214,330,1598,2554,5,13587,754,0,2,6,2,1
55489,24,1149,75,38,59,1,3,12,76,2,4,2,4,6,6,10,15,1,15,0,0,2,3,1,1
55490,8,263,51,25,36,0,0,15,51,3,11,6,12,14,18,42,68,1,112,6,0,2,2,1,1
55491,2,51,14,9,9,0,0,5,14,0,0,0,0,0,0,0,0,0,0,0,0,2,2,1,1
55492,1,134,149,67,118,4,0,27,153,1,17,14,28,18,42,69,175,0,144,8,0,2,1,0,1
55493,34,2285,1157,318,931,29,22,177,1186,6,104,63,125,110,188,712,1274,3,4596,255,0,2,1,1,1
55494,63,4333,520,294,400,33,13,81,553,10,261,204,367,271,571,2128,4614,7,32445,1802,1,2,6,5,1
55495,180,8011,139,89,101,2,0,35,141,7,54,34,62,61,96,330,569,4,2287,127,0,2,3,2,1
55496,180,8011,7,5,5,0,0,2,7,1,2,1,2,3,3,2,4,0,2,0,0,2,3,2,1
55497,138,6148,1782,648,1425,9,47,279,1791,8,171,97,189,179,286,1292,2140,4,9462,525,0,2,5,3,1
55498,25,684,256,139,192,9,7,47,265,4,23,12,24,27,36,112,171,2,357,19,0,2,3,2,1
55499,23,583,102,59,69,5,3,24,107,6,22,15,28,28,43,113,206,3,789,43,0,2,5,1,1
55500,111,4174,1450,624,1228,12,26,181,1462,14,306,186,354,320,540,2580,4493,8,36391,2021,1,2,8,4,1
55501,166,4983,1660,832,1314,41,38,274,1701,20,312,209,395,332,604,2671,5058,12,64042,3557,1,2,8,7,1
55502,44,3230,996,429,845,24,10,117,1020,7,76,50,88,83,138,494,879,4,3565,198,0,2,6,3,1
55503,128,5336,1513,682,1277,25,13,200,1538,11,199,116,219,210,335,1557,2584,6,15641,868,0,2,10,6,1
55504,75,3910,1296,573,1062,40,33,157,1336,8,201,118,231,209,349,1561,2689,4,12365,686,0,2,8,3,1
55505,19,453,207,111,150,11,0,50,218,5,26,19,36,31,55,133,272,3,943,52,0,2,8,2,1
55506,92,4718,1457,730,1242,11,6,188,1468,10,292,166,329,302,495,2424,4078,5,22973,1276,1,2,8,3,1
55507,40,2521,652,304,544,16,6,88,668,6,89,51,101,95,152,591,998,3,3399,188,0,2,8,2,1
55508,70,3216,1455,414,1257,16,76,112,1471,5,41,23,46,46,69,231,381,2,1069,59,0,2,9,3,1
55509,2,79,7,6,5,0,0,2,7,1,1,1,2,2,3,0,3,1,3,0,0,2,4,1,1
55510,8,275,74,35,59,1,0,14,75,3,14,7,14,17,21,58,85,1,128,7,0,2,5,2,1
55511,96,4695,1523,757,1297,19,12,193,1542,12,193,117,230,205,347,1508,2664,7,19053,1058,0,2,9,5,1
55512,97,4232,1020,354,843,12,15,144,1032,8,134,77,144,142,221,970,1580,4,6792,377,0,2,4,1,1
55513,42,1903,447,308,343,6,5,95,453,7,96,59,111,103,170,651,1136,4,4600,255,0,2,4,1,1
55514,2,145,53,23,39,0,0,13,53,2,8,4,8,10,12,26,39,1,39,2,0,2,0,1,1
55515,21,662,424,94,331,4,0,89,428,1,5,5,5,6,10,11,25,0,12,0,0,2,4,1,1
55516,38,2306,334,251,279,10,4,40,344,5,127,74,143,132,217,899,1528,2,4303,239,0,2,7,2,1
55517,12,497,184,100,137,2,15,30,186,6,38,20,39,44,59,214,322,3,991,55,0,2,5,1,1
55518,64,2863,1293,570,1093,25,15,163,1318,10,195,123,241,205,364,1516,2795,6,17273,959,0,2,6,3,1
55519,33,1897,384,251,317,7,8,52,391,11,70,44,84,81,128,467,811,6,5355,297,0,2,9,4,1
55520,47,2248,722,423,573,19,0,135,741,12,172,101,199,184,300,1320,2257,6,15668,870,0,2,15,6,1
55521,43,1877,386,256,301,16,9,68,402,4,59,35,69,63,104,355,621,2,1453,80,0,2,5,2,1
55522,16,1245,215,129,180,6,0,29,221,8,65,43,72,73,115,415,711,4,3153,175,0,2,13,9,1
55523,84,3236,1043,504,840,53,9,147,1096,9,180,112,198,189,310,1377,2344,4,11604,644,0,2,12,5,1
55524,14,534,295,56,236,0,4,54,295,2,9,5,10,11,15,30,51,1,57,3,0,2,4,1,1
55525,30,1245,373,158,315,8,0,51,381,5,76,44,79,81,123,486,779,2,2026,112,0,2,3,2,1
55526,77,3225,1178,367,1042,6,15,115,1184,9,94,51,95,103,146,644,976,4,4439,246,0,2,8,3,1
55527,99,5086,1943,715,1694,26,18,214,1969,12,185,120,237,197,357,1436,2721,7,20915,1161,0,2,10,3,1
55528,30,1272,442,244,305,14,16,103,456,11,68,45,75,79,120,452,756,6,4588,254,0,2,4,1,1
55529,51,1917,1098,241,925,5,10,155,1103,7,46,25,49,53,74,273,423,3,1580,87,0,2,7,3,1
55530,40,1147,339,213,244,17,9,65,356,10,42,26,48,52,74,259,421,5,2410,133,0,2,37,1,1
55531,53,629,647,139,84,35,284,233,682,0,0,0,0,0,0,0,0,0,0,0,0,2,10,0,1
55532,64,2924,1293,570,1093,25,15,163,1318,10,195,123,241,205,364,1516,2795,6,17273,959,0,2,22,6,1
55533,40,1155,339,213,244,17,9,65,356,10,42,26,48,52,74,259,421,5,2410,133,0,2,4,2,0
55534,53,633,647,139,84,35,284,233,682,0,0,0,0,0,0,0,0,0,0,0,0,2,4,2,0
55535,64,2924,1293,570,1093,25,15,163,1318,10,195,123,241,205,364,1516,2795,6,17273,959,0,2,12,2,0
55537,2,40,9,6,6,0,0,3,9,0,0,0,0,0,0,0,0,0,0,0,0,2,1,0,0
55538,2,40,13,9,8,0,0,4,13,0,0,0,0,0,0,0,0,0,0,0,0,2,1,0,0
55540,1,319,382,65,130,157,2,92,539,4,10,5,10,14,15,41,57,2,114,6,0,2,1,3,0
55541,60,1078,282,196,195,3,0,86,285,8,130,71,141,138,212,936,1507,4,6538,363,0,2,3,2,0
55542,4,77,127,75,83,2,11,30,129,4,14,7,14,18,21,61,87,2,175,9,0,2,2,1,0
55543,4,77,652,304,544,16,6,88,668,6,89,51,101,95,152,591,998,3,3399,188,0,2,2,1,0
55544,4,77,2,2,2,0,0,0,2,0,0,0,0,0,0,0,0,0,0,0,0,2,2,1,0
55545,4,77,8,5,5,0,0,3,8,0,0,0,0,0,0,0,0,0,0,0,0,2,2,1,0
55548,4,77,14,8,8,0,0,6,14,0,0,0,0,0,0,0,0,0,0,0,0,2,2,1,0
55549,4,77,6,4,4,0,0,2,6,0,0,0,0,0,0,0,0,0,0,0,0,2,2,1,0
55550,4,77,6,4,4,0,0,2,6,1,2,1,2,3,3,2,4,0,2,0,0,2,2,1,0
55552,4,77,7,5,5,0,0,2,7,0,0,0,0,0,0,0,0,0,0,0,0,2,2,1,0
55554,4,77,10,6,6,0,0,4,10,0,0,0,0,0,0,0,0,0,0,0,0,2,2,1,0
55555,4,77,1,1,1,0,0,0,1,0,0,0,0,0,0,0,0,0,0,0,0,2,2,1,0
55557,4,77,14,10,10,0,0,4,14,1,1,1,1,2,2,0,2,0,1,0,0,2,2,1,0
55558,4,77,46,26,30,3,0,12,49,3,6,3,6,9,9,20,28,1,42,2,0,2,2,1,0
55559,7,296,72,33,56,0,4,12,72,1,1,1,1,2,2,0,2,0,1,0,0,2,1,0,0
55560,12,229,127,75,83,2,11,30,129,4,14,7,14,18,21,61,87,2,175,9,0,2,0,1,0
55561,12,229,652,304,544,16,6,88,668,6,89,51,101,95,152,591,998,3,3399,188,0,2,0,1,0
55562,12,229,2,2,2,0,0,0,2,0,0,0,0,0,0,0,0,0,0,0,0,2,0,1,0
55563,12,229,8,5,5,0,0,3,8,0,0,0,0,0,0,0,0,0,0,0,0,2,0,1,0
55566,12,229,14,8,8,0,0,6,14,0,0,0,0,0,0,0,0,0,0,0,0,2,0,1,0
55567,12,229,6,4,4,0,0,2,6,0,0,0,0,0,0,0,0,0,0,0,0,2,0,1,0
55568,12,229,6,4,4,0,0,2,6,1,2,1,2,3,3,2,4,0,2,0,0,2,0,1,0
55570,12,229,7,5,5,0,0,2,7,0,0,0,0,0,0,0,0,0,0,0,0,2,0,1,0
55572,12,229,10,6,6,0,0,4,10,0,0,0,0,0,0,0,0,0,0,0,0,2,0,1,0
55573,12,229,1,1,1,0,0,0,1,0,0,0,0,0,0,0,0,0,0,0,0,2,0,1,0
55575,12,229,14,10,10,0,0,4,14,1,1,1,1,2,2,0,2,0,1,0,0,2,0,1,0
55576,12,229,46,26,30,3,0,12,49,3,6,3,6,9,9,20,28,1,42,2,0,2,0,1,0
55577,6,71,127,75,83,2,11,30,129,4,14,7,14,18,21,61,87,2,175,9,0,2,1,0,0
55578,6,71,652,304,544,16,6,88,668,6,89,51,101,95,152,591,998,3,3399,188,0,2,1,0,0
55579,6,71,2,2,2,0,0,0,2,0,0,0,0,0,0,0,0,0,0,0,0,2,1,0,0
55580,6,71,8,5,5,0,0,3,8,0,0,0,0,0,0,0,0,0,0,0,0,2,1,0,0
55583,6,71,14,8,8,0,0,6,14,0,0,0,0,0,0,0,0,0,0,0,0,2,1,0,0
55584,6,71,6,4,4,0,0,2,6,0,0,0,0,0,0,0,0,0,0,0,0,2,1,0,0
55585,6,71,6,4,4,0,0,2,6,1,2,1,2,3,3,2,4,0,2,0,0,2,1,0,0
55587,6,71,7,5,5,0,0,2,7,0,0,0,0,0,0,0,0,0,0,0,0,2,1,0,0
55589,6,71,10,6,6,0,0,4,10,0,0,0,0,0,0,0,0,0,0,0,0,2,1,0,0
55590,6,71,1,1,1,0,0,0,1,0,0,0,0,0,0,0,0,0,0,0,0,2,1,0,0
55592,6,71,14,10,10,0,0,4,14,1,1,1,1,2,2,0,2,0,1,0,0,2,1,0,0
55593,6,71,46,26,30,3,0,12,49,3,6,3,6,9,9,20,28,1,42,2,0,2,1,0,0
55594,17,378,85,59,61,8,0,16,93,5,18,10,18,23,28,86,126,2,316,17,0,2,1,0,0
55595,12,515,124,78,88,2,3,26,126,4,13,7,13,17,20,56,81,2,163,9,0,2,6,2,0
55596,1,86,42,7,35,4,0,5,46,1,2,1,2,3,3,2,4,0,2,0,0,2,1,0,0
55597,1,86,11,6,10,0,0,1,11,2,4,2,4,6,6,10,15,1,15,0,0,2,1,0,0
55598,11,242,19,8,11,5,0,4,24,2,5,3,6,7,9,13,25,1,30,1,0,2,5,2,0
55599,11,242,102,59,69,5,3,24,107,6,22,15,28,28,43,113,206,3,789,43,0,2,5,2,0
55600,11,242,106,40,36,3,49,17,109,8,17,13,23,25,36,93,167,5,904,50,0,2,5,2,0
55624,222,4859,182,127,129,0,0,53,182,5,39,21,42,44,63,217,343,2,926,51,0,2,15,7,0
55625,222,4859,1165,710,800,67,119,181,1232,18,243,153,282,261,435,2000,3492,10,36473,2026,1,2,15,7,0
55626,68,1565,773,419,590,28,0,166,801,10,204,113,217,214,330,1598,2554,5,13587,754,0,2,8,5,0
55627,68,1565,421,273,302,44,34,57,465,17,81,59,107,98,166,583,1098,11,12329,684,0,2,8,5,0
55630,26,529,2,2,2,0,0,0,2,0,0,0,0,0,0,0,0,0,0,0,0,2,6,2,0
55644,26,529,99,48,90,1,3,5,100,0,0,0,0,0,0,0,0,0,0,0,0,2,6,2,0
55645,26,529,8,5,5,2,0,1,10,0,0,0,0,0,0,0,0,0,0,0,0,2,6,2,0
55646,26,529,1217,716,841,84,126,174,1301,14,185,118,215,199,333,1446,2542,8,20687,1149,0,2,6,2,0
55647,26,529,160,89,115,0,13,31,160,7,15,11,17,22,28,78,124,3,495,27,0,2,6,2,0
55648,26,529,10,10,9,9,0,0,19,0,0,0,0,0,0,0,0,0,0,0,0,2,6,2,0
55649,26,529,173,84,99,8,29,36,181,5,12,7,13,17,20,54,81,2,221,12,0,2,6,2,0
55650,26,529,3,1,1,3,0,0,6,0,0,0,0,0,0,0,0,0,0,0,0,2,6,2,0
55651,180,5401,1660,832,1314,41,38,274,1701,20,312,209,395,332,604,2671,5058,12,64042,3557,1,2,7,4,0
55652,180,5401,1057,646,719,113,100,145,1170,18,215,134,248,233,382,1740,3004,10,31186,1732,1,2,7,4,0
55653,17,348,95,58,50,9,16,20,104,12,33,24,45,45,69,209,378,8,3100,172,0,2,4,1,0
55654,89,1829,477,336,357,30,23,73,507,16,194,134,250,210,384,1538,2962,10,30538,1696,0,2,6,2,0
55655,76,1743,996,429,845,24,10,117,1020,7,76,50,88,83,138,494,879,4,3565,198,0,2,9,5,0
55656,76,1743,456,277,329,12,42,72,468,13,85,50,97,98,147,592,972,7,7212,400,0,2,9,5,0
55657,154,3265,1513,682,1277,25,13,200,1538,11,199,116,219,210,335,1557,2584,6,15641,868,0,2,6,3,0
55658,154,3265,819,519,539,24,98,155,843,15,96,57,106,111,163,690,1107,8,9171,509,0,2,6,3,0
55659,68,1364,207,111,150,11,0,50,218,5,26,19,36,31,55,133,272,3,943,52,0,2,7,4,0
55660,68,1364,410,198,237,31,55,97,441,11,63,38,72,74,110,414,683,6,4293,238,0,2,7,4,0
55663,218,4738,2,2,2,0,0,0,2,0,0,0,0,0,0,0,0,0,0,0,0,2,20,13,0
55677,218,4738,99,48,90,1,3,5,100,0,0,0,0,0,0,0,0,0,0,0,0,2,20,13,0
55678,218,4738,8,5,5,2,0,1,10,0,0,0,0,0,0,0,0,0,0,0,0,2,20,13,0
55679,218,4738,1217,716,841,84,126,174,1301,14,185,118,215,199,333,1446,2542,8,20687,1149,0,2,20,13,0
55680,218,4738,160,89,115,0,13,31,160,7,15,11,17,22,28,78,124,3,495,27,0,2,20,13,0
55681,218,4738,10,10,9,9,0,0,19,0,0,0,0,0,0,0,0,0,0,0,0,2,20,13,0
55682,218,4738,173,84,99,8,29,36,181,5,12,7,13,17,20,54,81,2,221,12,0,2,20,13,0
55683,218,4738,3,1,1,3,0,0,6,0,0,0,0,0,0,0,0,0,0,0,0,2,20,13,0
55684,97,1999,463,295,324,28,62,57,491,12,134,82,154,146,236,989,1696,6,11700,650,0,2,3,4,0
55685,51,757,167,116,138,4,5,22,171,8,48,30,56,56,86,292,499,4,2330,129,0,2,3,1,0
55686,31,936,339,213,244,17,9,65,356,10,42,26,48,52,74,259,421,5,2410,133,0,2,3,1,0
55688,85,2182,1455,414,1257,16,76,112,1471,5,41,23,46,46,69,231,381,2,1069,59,0,2,8,4,0
55689,85,2182,669,365,481,22,61,110,691,15,103,63,122,118,185,747,1273,8,11311,628,0,2,8,4,0
55690,256,6014,4293,999,3693,19,54,507,4312,9,155,88,170,164,258,1156,1898,4,9368,520,0,2,24,22,0
55691,256,6014,1482,859,1002,125,135,219,1607,16,219,134,251,235,385,1766,3032,9,27804,1544,1,2,24,22,0
55692,6,140,44,22,19,0,19,6,44,2,10,6,12,12,18,35,64,1,77,4,0,2,3,1,0
55693,27,968,74,35,59,1,0,14,75,3,14,7,14,17,21,58,85,1,128,7,0,2,8,4,0
55694,27,968,245,125,200,5,7,34,250,7,30,17,34,37,51,166,265,3,1053,58,0,2,8,4,0
55695,52,622,647,139,84,35,284,233,682,0,0,0,0,0,0,0,0,0,0,0,0,2,1,1,0
55696,98,2670,1523,757,1297,19,12,193,1542,12,193,117,230,205,347,1508,2664,7,19053,1058,0,2,6,2,0
55697,98,2670,701,378,504,33,58,109,734,13,110,68,126,123,194,794,1346,7,10027,557,0,2,6,2,0
55698,94,2438,773,422,505,30,103,129,803,14,77,46,83,91,129,535,839,7,6334,351,0,2,7,4,0
55699,142,3319,77,34,69,0,0,8,77,3,24,16,29,27,45,114,213,1,387,21,0,2,9,6,0
55700,142,3319,712,438,573,51,9,84,763,14,102,71,128,116,199,733,1364,8,11988,666,0,2,9,6,0
55703,24,628,2,2,2,0,0,0,2,0,0,0,0,0,0,0,0,0,0,0,0,2,15,13,0
55717,24,628,99,48,90,1,3,5,100,0,0,0,0,0,0,0,0,0,0,0,0,2,15,13,0
55718,24,628,8,5,5,2,0,1,10,0,0,0,0,0,0,0,0,0,0,0,0,2,15,13,0
55719,24,628,1217,716,841,84,126,174,1301,14,185,118,215,199,333,1446,2542,8,20687,1149,0,2,15,13,0
55720,24,628,160,89,115,0,13,31,160,7,15,11,17,22,28,78,124,3,495,27,0,2,15,13,0
55721,24,628,10,10,9,9,0,0,19,0,0,0,0,0,0,0,0,0,0,0,0,2,15,13,0
55722,24,628,173,84,99,8,29,36,181,5,12,7,13,17,20,54,81,2,221,12,0,2,15,13,0
55723,24,628,3,1,1,3,0,0,6,0,0,0,0,0,0,0,0,0,0,0,0,2,15,13,0
55724,30,664,125,97,103,3,0,19,128,9,25,17,27,34,44,144,223,4,1087,60,0,2,5,3,0
55725,23,367,102,57,55,5,16,25,107,5,17,10,18,22,28,81,124,2,330,18,0,2,2,1,0
55726,88,1899,402,202,227,24,74,80,426,12,52,33,61,64,94,339,564,7,3969,220,0,2,6,3,0
55727,52,1075,447,308,343,6,5,95,453,7,96,59,111,103,170,651,1136,4,4600,255,0,2,4,2,0
55728,52,1075,322,174,179,16,74,51,338,10,41,26,46,51,72,252,408,5,2291,127,0,2,4,2,0
55729,88,1993,53,23,39,0,0,13,53,2,8,4,8,10,12,26,39,1,39,2,0,2,8,6,0
55730,88,1993,515,298,307,33,80,99,548,12,63,44,77,75,121,419,753,7,5527,307,0,2,8,6,0
55731,23,389,424,94,331,4,0,89,428,1,5,5,5,6,10,11,25,0,12,0,0,2,6,2,0
55732,23,389,38,23,23,6,0,8,44,3,11,7,11,14,18,42,68,1,102,5,0,2,6,2,0
55733,20,526,205,80,86,16,53,53,221,7,18,10,19,25,29,94,134,3,497,27,0,2,4,1,0
55734,17,523,184,100,137,2,15,30,186,6,38,20,39,44,59,214,322,3,991,55,0,2,7,3,0
55735,17,523,103,65,74,8,5,16,111,7,17,9,17,24,26,89,119,3,417,23,0,2,7,3,0
55736,53,1178,91,45,69,0,3,18,91,3,9,6,10,12,16,33,57,1,95,5,0,2,14,11,0
55737,53,1178,367,234,237,17,34,68,384,16,55,34,61,71,95,381,584,8,5183,287,0,2,14,11,0
55738,244,5842,722,423,573,19,0,135,741,12,172,101,199,184,300,1320,2257,6,15668,870,0,2,13,9,0
55739,244,5842,1508,847,911,44,250,301,1552,14,148,88,169,162,257,1120,1886,7,15077,837,0,2,13,9,0
55740,305,6844,72,33,56,0,4,12,72,1,1,1,1,2,2,0,2,0,1,0,0,2,30,32,0
55741,305,6844,1454,835,1044,76,110,219,1530,17,275,158,296,292,454,2297,3718,9,34017,1889,1,2,30,32,0
55742,91,1836,757,253,292,73,244,162,830,13,61,38,67,74,105,409,651,7,4654,258,0,2,6,6,0
55743,43,902,386,256,301,16,9,68,402,4,59,35,69,63,104,355,621,2,1453,80,0,2,4,3,0
55744,43,902,264,131,164,11,41,46,275,6,38,22,40,44,62,214,338,3,1068,59,0,2,4,3,0
55745,28,707,466,257,367,18,25,50,484,7,126,86,171,133,257,898,1813,4,8612,478,0,2,1,0,0
55746,28,707,507,281,342,29,59,88,536,10,53,29,57,63,86,336,514,5,2764,153,0,2,1,0,0
55747,30,658,215,129,180,6,0,29,221,8,65,43,72,73,115,415,711,4,3153,175,0,2,5,2,0
55748,30,658,97,69,77,3,3,16,100,6,22,13,23,28,36,113,173,3,542,30,0,2,5,2,0
55749,92,1975,1043,504,840,53,9,147,1096,9,180,112,198,189,310,1377,2344,4,11604,644,0,2,10,4,0
55750,92,1975,383,288,292,26,6,62,409,11,65,38,67,76,105,429,656,5,3719,206,0,2,10,4,0
55751,20,420,294,64,250,0,0,43,294,1,20,10,20,21,30,86,131,0,65,3,0,2,5,2,0
55752,20,420,78,46,62,3,0,14,81,3,8,4,8,11,12,28,41,1,62,3,0,2,5,2,0
55753,5,123,110,30,77,3,13,16,113,4,21,15,30,25,45,100,208,2,597,33,0,2,3,1,0
55754,5,123,28,15,21,1,0,6,29,0,0,0,0,0,0,0,0,0,0,0,0,2,3,1,0
55755,70,1394,1178,367,1042,6,15,115,1184,9,94,51,95,103,146,644,976,4,4439,246,0,2,6,2,0
55756,70,1394,177,108,140,8,0,27,185,6,30,16,32,36,48,162,248,3,794,44,0,2,6,2,0
55757,223,4852,1943,715,1694,26,18,214,1969,12,185,120,237,197,357,1436,2721,7,20915,1161,0,2,9,11,0
55758,223,4852,1168,838,957,57,25,144,1225,19,348,224,416,367,640,3018,5452,11,61921,3440,1,2,9,11,0
55759,19,682,442,244,305,14,16,103,456,11,68,45,75,79,120,452,756,6,4588,254,0,2,13,12,0
55760,19,682,182,102,99,11,40,35,193,3,11,6,11,14,17,42,64,1,97,5,0,2,13,12,0
55761,62,1255,1098,241,925,5,10,155,1103,7,46,25,49,53,74,273,423,3,1580,87,0,2,11,5,0
55762,62,1255,282,202,222,14,2,44,296,8,42,24,43,50,67,250,378,4,1548,86,0,2,11,5,0
55763,29,728,601,196,481,2,23,85,603,8,63,36,72,71,108,400,664,4,3036,168,0,2,3,2,0
55764,29,728,156,79,106,5,16,28,161,5,14,8,15,19,23,64,97,2,261,14,0,2,3,2,0
55765,99,4089,1289,550,1043,56,32,155,1345,10,167,93,185,177,278,1266,2075,5,11498,638,0,2,7,3,0
55766,35,1083,182,127,129,0,0,53,182,5,39,21,42,44,63,217,343,2,926,51,0,2,6,4,0
55767,152,7159,1392,870,1177,35,17,170,1427,14,494,280,531,508,811,4473,7289,7,54850,3047,2,2,11,10,0
55768,90,2889,773,419,590,28,0,166,801,10,204,113,217,214,330,1598,2554,5,13587,754,0,2,6,2,0
55769,24,1149,75,38,59,1,3,12,76,2,4,2,4,6,6,10,15,1,15,0,0,2,3,1,0
55770,8,263,51,25,36,0,0,15,51,3,11,6,12,14,18,42,68,1,112,6,0,2,2,1,0
55771,2,51,14,9,9,0,0,5,14,0,0,0,0,0,0,0,0,0,0,0,0,2,2,1,0
55772,1,134,149,67,118,4,0,27,153,1,17,14,28,18,42,69,175,0,144,8,0,2,1,0,0
55773,34,2285,1157,318,931,29,22,177,1186,6,104,63,125,110,188,712,1274,3,4596,255,0,2,1,1,0
55774,63,4333,520,294,400,33,13,81,553,10,261,204,367,271,571,2128,4614,7,32445,1802,1,2,6,5,0
55775,180,8011,139,89,101,2,0,35,141,7,54,34,62,61,96,330,569,4,2287,127,0,2,3,2,0
55776,180,8011,7,5,5,0,0,2,7,1,2,1,2,3,3,2,4,0,2,0,0,2,3,2,0
55777,138,6148,1782,648,1425,9,47,279,1791,8,171,97,189,179,286,1292,2140,4,9462,525,0,2,5,3,0
55778,25,684,256,139,192,9,7,47,265,4,23,12,24,27,36,112,171,2,357,19,0,2,3,2,0
55779,23,583,102,59,69,5,3,24,107,6,22,15,28,28,43,113,206,3,789,43,0,2,5,1,0
55780,111,4174,1450,624,1228,12,26,181,1462,14,306,186,354,320,540,2580,4493,8,36391,2021,1,2,8,4,0
55781,166,4983,1660,832,1314,41,38,274,1701,20,312,209,395,332,604,2671,5058,12,64042,3557,1,2,8,7,0
55782,44,3230,996,429,845,24,10,117,1020,7,76,50,88,83,138,494,879,4,3565,198,0,2,6,3,0
55783,128,5336,1513,682,1277,25,13,200,1538,11,199,116,219,210,335,1557,2584,6,15641,868,0,2,10,6,0
55784,75,3910,1296,573,1062,40,33,157,1336,8,201,118,231,209,349,1561,2689,4,12365,686,0,2,8,3,0
55785,19,453,207,111,150,11,0,50,218,5,26,19,36,31,55,133,272,3,943,52,0,2,8,2,0
55786,92,4718,1457,730,1242,11,6,188,1468,10,292,166,329,302,495,2424,4078,5,22973,1276,1,2,8,3,0
55787,40,2521,652,304,544,16,6,88,668,6,89,51,101,95,152,591,998,3,3399,188,0,2,8,2,0
55788,70,3216,1455,414,1257,16,76,112,1471,5,41,23,46,46,69,231,381,2,1069,59,0,2,9,3,0
55789,2,79,7,6,5,0,0,2,7,1,1,1,2,2,3,0,3,1,3,0,0,2,4,1,0
55790,8,275,74,35,59,1,0,14,75,3,14,7,14,17,21,58,85,1,128,7,0,2,5,2,0
55791,96,4695,1523,757,1297,19,12,193,1542,12,193,117,230,205,347,1508,2664,7,19053,1058,0,2,9,5,0
55792,97,4232,1020,354,843,12,15,144,1032,8,134,77,144,142,221,970,1580,4,6792,377,0,2,4,1,0
55793,42,1903,447,308,343,6,5,95,453,7,96,59,111,103,170,651,1136,4,4600,255,0,2,4,1,0
55794,2,145,53,23,39,0,0,13,53,2,8,4,8,10,12,26,39,1,39,2,0,2,0,1,0
55795,21,662,424,94,331,4,0,89,428,1,5,5,5,6,10,11,25,0,12,0,0,2,4,1,0
55796,38,2306,334,251,279,10,4,40,344,5,127,74,143,132,217,899,1528,2,4303,239,0,2,7,2,0
55797,12,497,184,100,137,2,15,30,186,6,38,20,39,44,59,214,322,3,991,55,0,2,5,1,0
55798,64,2863,1293,570,1093,25,15,163,1318,10,195,123,241,205,364,1516,2795,6,17273,959,0,2,6,3,0
55799,33,1897,384,251,317,7,8,52,391,11,70,44,84,81,128,467,811,6,5355,297,0,2,9,4,0
55800,47,2248,722,423,573,19,0,135,741,12,172,101,199,184,300,1320,2257,6,15668,870,0,2,15,6,0
55801,43,1877,386,256,301,16,9,68,402,4,59,35,69,63,104,355,621,2,1453,80,0,2,5,2,0
55802,16,1245,215,129,180,6,0,29,221,8,65,43,72,73,115,415,711,4,3153,175,0,2,13,9,0
55803,84,3236,1043,504,840,53,9,147,1096,9,180,112,198,189,310,1377,2344,4,11604,644,0,2,12,5,0
55804,14,534,295,56,236,0,4,54,295,2,9,5,10,11,15,30,51,1,57,3,0,2,4,1,0
55805,30,1245,373,158,315,8,0,51,381,5,76,44,79,81,123,486,779,2,2026,112,0,2,3,2,0
55806,77,3225,1178,367,1042,6,15,115,1184,9,94,51,95,103,146,644,976,4,4439,246,0,2,8,3,0
55807,99,5086,1943,715,1694,26,18,214,1969,12,185,120,237,197,357,1436,2721,7,20915,1161,0,2,10,3,0
55808,30,1272,442,244,305,14,16,103,456,11,68,45,75,79,120,452,756,6,4588,254,0,2,4,1,0
55809,51,1917,1098,241,925,5,10,155,1103,7,46,25,49,53,74,273,423,3,1580,87,0,2,7,3,0
55810,40,1155,339,213,244,17,9,65,356,10,42,26,48,52,74,259,421,5,2410,133,0,2,40,2,0
55811,53,633,647,139,84,35,284,233,682,0,0,0,0,0,0,0,0,0,0,0,0,2,13,1,0
55812,64,2924,1293,570,1093,25,15,163,1318,10,195,123,241,205,364,1516,2795,6,17273,959,0,2,33,7,0
55813,70,1387,207,111,150,11,0,50,218,5,26,19,36,31,55,133,272,3,943,52,0,2,13,0,0
55814,70,1387,410,198,237,31,55,97,441,11,63,38,72,74,110,414,683,6,4293,238,0,2,13,0,0
55817,218,4733,2,2,2,0,0,0,2,0,0,0,0,0,0,0,0,0,0,0,0,2,2,5,0
55831,218,4733,99,48,90,1,3,5,100,0,0,0,0,0,0,0,0,0,0,0,0,2,2,5,0
55832,218,4733,8,5,5,2,0,1,10,0,0,0,0,0,0,0,0,0,0,0,0,2,2,5,0
55833,218,4733,1217,716,841,84,126,174,1301,14,185,118,215,199,333,1446,2542,8,20687,1149,0,2,2,5,0
55834,218,4733,160,89,115,0,13,31,160,7,15,11,17,22,28,78,124,3,495,27,0,2,2,5,0
55835,218,4733,10,10,9,9,0,0,19,0,0,0,0,0,0,0,0,0,0,0,0,2,2,5,0
55836,218,4733,173,84,99,8,29,36,181,5,12,7,13,17,20,54,81,2,221,12,0,2,2,5,0
55837,218,4733,3,1,1,3,0,0,6,0,0,0,0,0,0,0,0,0,0,0,0,2,2,5,0
55865,218,4738,2,2,2,0,0,0,2,0,0,0,0,0,0,0,0,0,0,0,0,2,6,6,0
55879,218,4738,99,48,90,1,3,5,100,0,0,0,0,0,0,0,0,0,0,0,0,2,6,6,0
55880,218,4738,8,5,5,2,0,1,10,0,0,0,0,0,0,0,0,0,0,0,0,2,6,6,0
55881,218,4738,1217,716,841,84,126,174,1301,14,185,118,215,199,333,1446,2542,8,20687,1149,0,2,6,6,0
55882,218,4738,160,89,115,0,13,31,160,7,15,11,17,22,28,78,124,3,495,27,0,2,6,6,0
55883,218,4738,10,10,9,9,0,0,19,0,0,0,0,0,0,0,0,0,0,0,0,2,6,6,0
55884,218,4738,173,84,99,8,29,36,181,5,12,7,13,17,20,54,81,2,221,12,0,2,6,6,0
55885,218,4738,3,1,1,3,0,0,6,0,0,0,0,0,0,0,0,0,0,0,0,2,6,6,0
55886,142,3314,77,34,69,0,0,8,77,3,24,16,29,27,45,114,213,1,387,21,0,2,10,9,0
55887,142,3314,712,438,573,51,9,84,763,14,102,71,128,116,199,733,1364,8,11988,666,0,2,10,9,0
55888,303,6728,72,33,56,0,4,12,72,1,1,1,1,2,2,0,2,0,1,0,0,2,0,9,0
55889,303,6728,1454,835,1044,76,110,219,1530,17,275,158,296,292,454,2297,3718,9,34017,1889,1,2,0,9,0
55890,30,1241,373,158,315,8,0,51,381,5,76,44,79,81,123,486,779,2,2026,112,0,2,1,1,0
55891,4,163,27,21,21,0,0,6,27,3,6,3,6,9,9,20,28,1,42,2,0,0,28,0,0
56016,70,1395,207,111,150,11,0,50,218,5,26,19,36,31,55,133,272,3,943,52,0,2,7,4,1
56017,70,1395,410,198,237,31,55,97,441,11,63,38,72,74,110,414,683,6,4293,238,0,2,7,4,1
56020,218,4751,2,2,2,0,0,0,2,0,0,0,0,0,0,0,0,0,0,0,0,2,20,13,1
56034,218,4751,99,48,90,1,3,5,100,0,0,0,0,0,0,0,0,0,0,0,0,2,20,13,1
56035,218,4751,8,5,5,2,0,1,10,0,0,0,0,0,0,0,0,0,0,0,0,2,20,13,1
56036,218,4751,1217,716,841,84,126,174,1301,14,185,118,215,199,333,1446,2542,8,20687,1149,0,2,20,13,1
56037,218,4751,160,89,115,0,13,31,160,7,15,11,17,22,28,78,124,3,495,27,0,2,20,13,1
56038,218,4751,10,10,9,9,0,0,19,0,0,0,0,0,0,0,0,0,0,0,0,2,20,13,1
56039,218,4751,173,84,99,8,29,36,181,5,12,7,13,17,20,54,81,2,221,12,0,2,20,13,1
56040,218,4751,3,1,1,3,0,0,6,0,0,0,0,0,0,0,0,0,0,0,0,2,20,13,1
56043,37,1105,339,213,244,17,9,65,356,10,42,26,48,52,74,259,421,5,2410,133,0,2,3,17,1
56047,258,6040,4293,999,3693,19,54,507,4312,9,155,88,170,164,258,1156,1898,4,9368,520,0,2,26,23,1
56048,258,6040,1482,859,1002,125,135,219,1607,16,219,134,251,235,385,1766,3032,9,27804,1544,1,2,26,23,1
56052,53,633,647,139,84,35,284,233,682,0,0,0,0,0,0,0,0,0,0,0,0,2,1,1,1
56055,94,2438,773,422,505,30,103,129,803,14,77,46,83,91,129,535,839,7,6334,351,0,2,9,6,1
56093,52,1151,91,45,69,0,3,18,91,3,9,6,10,12,16,33,57,1,95,5,0,2,13,10,1
56094,52,1151,367,234,237,17,34,68,384,16,55,34,61,71,95,381,584,8,5183,287,0,2,13,10,1
56114,226,4927,1943,715,1694,26,18,214,1969,12,185,120,237,197,357,1436,2721,7,20915,1161,0,2,11,14,1
56115,226,4927,1168,838,957,57,25,144,1225,19,348,224,416,367,640,3018,5452,11,61921,3440,1,2,11,14,1
56126,25,1187,75,38,59,1,3,12,76,2,4,2,4,6,6,10,15,1,15,0,0,2,3,1,1
56155,64,2936,1293,570,1093,25,15,163,1318,10,195,123,241,205,364,1516,2795,6,17273,959,0,2,13,4,1
56167,41,1474,601,196,481,2,23,85,603,8,63,36,72,71,108,400,664,4,3036,168,0,2,3,2,1
56291,70,1395,207,111,150,11,0,50,218,5,26,19,36,31,55,133,272,3,943,52,0,2,7,4,0
56292,70,1395,410,198,237,31,55,97,441,11,63,38,72,74,110,414,683,6,4293,238,0,2,7,4,0
56295,218,4751,2,2,2,0,0,0,2,0,0,0,0,0,0,0,0,0,0,0,0,2,20,13,0
56309,218,4751,99,48,90,1,3,5,100,0,0,0,0,0,0,0,0,0,0,0,0,2,20,13,0
56310,218,4751,8,5,5,2,0,1,10,0,0,0,0,0,0,0,0,0,0,0,0,2,20,13,0
56311,218,4751,1217,716,841,84,126,174,1301,14,185,118,215,199,333,1446,2542,8,20687,1149,0,2,20,13,0
56312,218,4751,160,89,115,0,13,31,160,7,15,11,17,22,28,78,124,3,495,27,0,2,20,13,0
56313,218,4751,10,10,9,9,0,0,19,0,0,0,0,0,0,0,0,0,0,0,0,2,20,13,0
56314,218,4751,173,84,99,8,29,36,181,5,12,7,13,17,20,54,81,2,221,12,0,2,20,13,0
56315,218,4751,3,1,1,3,0,0,6,0,0,0,0,0,0,0,0,0,0,0,0,2,20,13,0
56318,37,1105,339,213,244,17,9,65,356,10,42,26,48,52,74,259,421,5,2410,133,0,2,3,17,0
56322,258,6040,4293,999,3693,19,54,507,4312,9,155,88,170,164,258,1156,1898,4,9368,520,0,2,26,23,0
56323,258,6040,1482,859,1002,125,135,219,1607,16,219,134,251,235,385,1766,3032,9,27804,1544,1,2,26,23,0
56327,53,633,647,139,84,35,284,233,682,0,0,0,0,0,0,0,0,0,0,0,0,2,1,1,0
56330,94,2438,773,422,505,30,103,129,803,14,77,46,83,91,129,535,839,7,6334,351,0,2,9,6,0
56368,52,1151,91,45,69,0,3,18,91,3,9,6,10,12,16,33,57,1,95,5,0,2,13,10,0
56369,52,1151,367,234,237,17,34,68,384,16,55,34,61,71,95,381,584,8,5183,287,0,2,13,10,0
56389,226,4927,1943,715,1694,26,18,214,1969,12,185,120,237,197,357,1436,2721,7,20915,1161,0,2,11,14,0
56390,226,4927,1168,838,957,57,25,144,1225,19,348,224,416,367,640,3018,5452,11,61921,3440,1,2,11,14,0
56401,25,1187,75,38,59,1,3,12,76,2,4,2,4,6,6,10,15,1,15,0,0,2,3,1,0
56430,64,2936,1293,570,1093,25,15,163,1318,10,195,123,241,205,364,1516,2795,6,17273,959,0,2,13,4,0
56443,45,919,386,256,301,16,9,68,402,4,59,35,69,63,104,355,621,2,1453,80,0,2,12,6,1
56444,45,919,264,131,164,11,41,46,275,6,38,22,40,44,62,214,338,3,1068,59,0,2,12,6,1
56445,44,1910,386,256,301,16,9,68,402,4,59,35,69,63,104,355,621,2,1453,80,0,2,6,0,1
56446,142,3324,77,34,69,0,0,8,77,3,24,16,29,27,45,114,213,1,387,21,0,2,10,9,0
56447,142,3324,712,438,573,51,9,84,763,14,102,71,128,116,199,733,1364,8,11988,666,0,2,10,9,0
56448,303,6802,72,33,56,0,4,12,72,1,1,1,1,2,2,0,2,0,1,0,0,2,0,9,0
56449,303,6802,1454,835,1044,76,110,219,1530,17,275,158,296,292,454,2297,3718,9,34017,1889,1,2,0,9,0
56450,30,1245,373,158,315,8,0,51,381,5,76,44,79,81,123,486,779,2,2026,112,0,2,1,1,0
56451,45,919,386,256,301,16,9,68,402,4,59,35,69,63,104,355,621,2,1453,80,0,2,12,6,0
56452,45,919,264,131,164,11,41,46,275,6,38,22,40,44,62,214,338,3,1068,59,0,2,12,6,0
56453,44,1910,386,256,301,16,9,68,402,4,59,35,69,63,104,355,621,2,1453,80,0,2,6,0,0
56454,54,1174,91,45,69,0,3,18,91,3,9,6,10,12,16,33,57,1,95,5,0,2,10,4,0
56455,54,1174,367,234,237,17,34,68,384,16,55,34,61,71,95,381,584,8,5183,287,0,2,10,4,0
56456,31,1314,442,244,305,14,16,103,456,11,68,45,75,79,120,452,756,6,4588,254,0,2,8,1,0
56480,53,1176,91,45,69,0,3,18,91,3,9,6,10,12,16,33,57,1,95,5,0,2,1,1,1
56481,53,1176,367,234,237,17,34,68,384,16,55,34,61,71,95,381,584,8,5183,287,0,2,1,1,1
56482,303,6803,72,33,56,0,4,12,72,1,1,1,1,2,2,0,2,0,1,0,0,2,9,12,1
56483,303,6803,1454,835,1044,76,110,219,1530,17,275,158,296,292,454,2297,3718,9,34017,1889,1,2,9,12,1
56484,54,1188,91,45,69,0,3,18,91,3,9,6,10,12,16,33,57,1,95,5,0,2,10,4,0
56485,54,1188,367,234,237,17,34,68,384,16,55,34,61,71,95,381,584,8,5183,287,0,2,10,4,0
56486,31,1318,442,244,305,14,16,103,456,11,68,45,75,79,120,452,756,6,4588,254,0,2,8,1,0
56487,54,1186,91,45,69,0,3,18,91,3,9,6,10,12,16,33,57,1,95,5,0,2,1,1,0
56488,54,1186,367,234,237,17,34,68,384,16,55,34,61,71,95,381,584,8,5183,287,0,2,1,1,0
56491,303,6803,72,33,56,0,4,12,72,1,1,1,1,2,2,0,2,0,1,0,0,2,9,12,0
56492,303,6803,1454,835,1044,76,110,219,1530,17,275,158,296,292,454,2297,3718,9,34017,1889,1,2,9,12,0
56495,218,4753,2,2,2,0,0,0,2,0,0,0,0,0,0,0,0,0,0,0,0,2,1,0,0
56509,218,4753,99,48,90,1,3,5,100,0,0,0,0,0,0,0,0,0,0,0,0,2,1,0,0
56510,218,4753,8,5,5,2,0,1,10,0,0,0,0,0,0,0,0,0,0,0,0,2,1,0,0
56511,218,4753,1217,716,841,84,126,174,1301,14,185,118,215,199,333,1446,2542,8,20687,1149,0,2,1,0,0
56512,218,4753,160,89,115,0,13,31,160,7,15,11,17,22,28,78,124,3,495,27,0,2,1,0,0
56513,218,4753,10,10,9,9,0,0,19,0,0,0,0,0,0,0,0,0,0,0,0,2,1,0,0
56514,218,4753,173,84,99,8,29,36,181,5,12,7,13,17,20,54,81,2,221,12,0,2,1,0,0
56515,218,4753,3,1,1,3,0,0,6,0,0,0,0,0,0,0,0,0,0,0,0,2,1,0,0
56516,25,397,219,78,157,11,5,46,230,3,24,20,34,27,54,114,256,2,545,30,0,0,102,0,0
56517,25,397,108,64,79,9,0,20,117,5,15,11,19,20,30,70,129,3,410,22,0,0,102,0,0
56518,44,3230,996,429,845,24,10,117,1020,7,76,50,88,83,138,494,879,4,3565,198,0,2,2,1,0
56519,9,441,219,78,157,11,5,46,230,3,24,20,34,27,54,114,256,2,545,30,0,0,148,0,0
56522,218,4753,2,2,2,0,0,0,2,0,0,0,0,0,0,0,0,0,0,0,0,2,6,6,0
56536,218,4753,99,48,90,1,3,5,100,0,0,0,0,0,0,0,0,0,0,0,0,2,6,6,0
56537,218,4753,8,5,5,2,0,1,10,0,0,0,0,0,0,0,0,0,0,0,0,2,6,6,0
56538,218,4753,1217,716,841,84,126,174,1301,14,185,118,215,199,333,1446,2542,8,20687,1149,0,2,6,6,0
56539,218,4753,160,89,115,0,13,31,160,7,15,11,17,22,28,78,124,3,495,27,0,2,6,6,0
56540,218,4753,10,10,9,9,0,0,19,0,0,0,0,0,0,0,0,0,0,0,0,2,6,6,0
56541,218,4753,173,84,99,8,29,36,181,5,12,7,13,17,20,54,81,2,221,12,0,2,6,6,0
56542,218,4753,3,1,1,3,0,0,6,0,0,0,0,0,0,0,0,0,0,0,0,2,6,6,0
56543,53,1159,91,45,69,0,3,18,91,3,9,6,10,12,16,33,57,1,95,5,0,2,11,5,0
56544,53,1159,367,234,237,17,34,68,384,16,55,34,61,71,95,381,584,8,5183,287,0,2,11,5,0
56582,68,1562,773,419,590,28,0,166,801,10,204,113,217,214,330,1598,2554,5,13587,754,0,2,3,5,1
56583,68,1562,421,273,302,44,34,57,465,17,81,59,107,98,166,583,1098,11,12329,684,0,2,3,5,1
56584,68,1577,773,419,590,28,0,166,801,10,204,113,217,214,330,1598,2554,5,13587,754,0,2,6,1,1
56585,68,1577,421,273,302,44,34,57,465,17,81,59,107,98,166,583,1098,11,12329,684,0,2,6,1,1
56586,154,3265,1513,682,1277,25,13,200,1538,11,199,116,219,210,335,1557,2584,6,15641,868,0,2,1,1,0
56587,154,3265,819,519,539,24,98,155,843,15,96,57,106,111,163,690,1107,8,9171,509,0,2,1,1,0
56588,97,1999,463,295,324,28,62,57,491,12,134,82,154,146,236,989,1696,6,11700,650,0,2,1,1,0
56589,256,6014,4293,999,3693,19,54,507,4312,9,155,88,170,164,258,1156,1898,4,9368,520,0,2,1,1,0
56590,256,6014,1482,859,1002,125,135,219,1607,16,219,134,251,235,385,1766,3032,9,27804,1544,1,2,1,1,0
56591,52,622,647,139,84,35,284,233,682,0,0,0,0,0,0,0,0,0,0,0,0,2,2,2,0
56592,88,1899,402,202,227,24,74,80,426,12,52,33,61,64,94,339,564,7,3969,220,0,2,1,1,0
56593,54,1186,91,45,69,0,3,18,91,3,9,6,10,12,16,33,57,1,95,5,0,2,5,5,0
56594,54,1186,367,234,237,17,34,68,384,16,55,34,61,71,95,381,584,8,5183,287,0,2,5,5,0
56595,305,6844,72,33,56,0,4,12,72,1,1,1,1,2,2,0,2,0,1,0,0,2,2,2,0
56596,305,6844,1454,835,1044,76,110,219,1530,17,275,158,296,292,454,2297,3718,9,34017,1889,1,2,2,2,0
56597,68,1577,773,419,590,28,0,166,801,10,204,113,217,214,330,1598,2554,5,13587,754,0,2,8,5,0
56598,68,1577,421,273,302,44,34,57,465,17,81,59,107,98,166,583,1098,11,12329,684,0,2,8,5,0
56599,147,3371,77,34,69,0,0,8,77,3,24,16,29,27,45,114,213,1,387,21,0,2,21,8,0
56600,147,3371,712,438,573,51,9,84,763,14,102,71,128,116,199,733,1364,8,11988,666,0,2,21,8,0
56601,304,6811,72,33,56,0,4,12,72,1,1,1,1,2,2,0,2,0,1,0,0,2,8,6,0
56602,304,6811,1454,835,1044,76,110,219,1530,17,275,158,296,292,454,2297,3718,9,34017,1889,1,2,8,6,0
56612,54,1186,91,45,69,0,3,18,91,3,9,6,10,12,16,33,57,1,95,5,0,2,6,6,0
56613,54,1186,367,234,237,17,34,68,384,16,55,34,61,71,95,381,584,8,5183,287,0,2,6,6,0
56620,57,1214,91,45,69,0,3,18,91,3,9,6,10,12,16,33,57,1,95,5,0,2,17,7,0
56621,57,1214,367,234,237,17,34,68,384,16,55,34,61,71,95,381,584,8,5183,287,0,2,17,7,0
56622,8,377,91,45,69,0,3,18,91,3,9,6,10,12,16,33,57,1,95,5,0,3,18,0,0
56623,77,1753,996,429,845,24,10,117,1020,7,76,50,88,83,138,494,879,4,3565,198,0,2,2,1,1
56624,77,1753,456,277,329,12,42,72,468,13,85,50,97,98,147,592,972,7,7212,400,0,2,2,1,1
56628,7,298,72,33,56,0,4,12,72,1,1,1,1,2,2,0,2,0,1,0,0,2,2,2,0
56629,257,6042,4293,999,3693,19,54,507,4312,9,155,88,170,164,258,1156,1898,4,9368,520,0,2,8,0,0
56630,257,6042,1482,859,1002,125,135,219,1607,16,219,134,251,235,385,1766,3032,9,27804,1544,1,2,8,0,0
56634,155,3277,1513,682,1277,25,13,200,1538,11,199,116,219,210,335,1557,2584,6,15641,868,0,2,3,0,1
56635,155,3277,819,519,539,24,98,155,843,15,96,57,106,111,163,690,1107,8,9171,509,0,2,3,0,1
56636,40,1143,339,213,244,17,9,65,356,10,42,26,48,52,74,259,421,5,2410,133,0,2,8,2,1
56637,65,3000,1293,570,1093,25,15,163,1318,10,195,123,241,205,364,1516,2795,6,17273,959,0,2,16,0,1
56638,52,1096,447,308,343,6,5,95,453,7,96,59,111,103,170,651,1136,4,4600,255,0,2,5,3,1
56639,52,1096,322,174,179,16,74,51,338,10,41,26,46,51,72,252,408,5,2291,127,0,2,5,3,1
56640,42,1907,447,308,343,6,5,95,453,7,96,59,111,103,170,651,1136,4,4600,255,0,2,5,3,1
56643,219,4759,2,2,2,0,0,0,2,0,0,0,0,0,0,0,0,0,0,0,0,2,28,25,1
56657,219,4759,99,48,90,1,3,5,100,0,0,0,0,0,0,0,0,0,0,0,0,2,28,25,1
56658,219,4759,8,5,5,2,0,1,10,0,0,0,0,0,0,0,0,0,0,0,0,2,28,25,1
56659,219,4759,1217,716,841,84,126,174,1301,14,185,118,215,199,333,1446,2542,8,20687,1149,0,2,28,25,1
56660,219,4759,160,89,115,0,13,31,160,7,15,11,17,22,28,78,124,3,495,27,0,2,28,25,1
56661,219,4759,10,10,9,9,0,0,19,0,0,0,0,0,0,0,0,0,0,0,0,2,28,25,1
56662,219,4759,173,84,99,8,29,36,181,5,12,7,13,17,20,54,81,2,221,12,0,2,28,25,1
56663,219,4759,3,1,1,3,0,0,6,0,0,0,0,0,0,0,0,0,0,0,0,2,28,25,1
56664,40,2521,652,304,544,16,6,88,668,6,89,51,101,95,152,591,998,3,3399,188,0,2,5,5,1
56665,155,3277,1513,682,1277,25,13,200,1538,11,199,116,219,210,335,1557,2584,6,15641,868,0,2,3,0,0
56666,155,3277,819,519,539,24,98,155,843,15,96,57,106,111,163,690,1107,8,9171,509,0,2,3,0,0
56667,40,1143,339,213,244,17,9,65,356,10,42,26,48,52,74,259,421,5,2410,133,0,2,8,2,0
56668,65,3000,1293,570,1093,25,15,163,1318,10,195,123,241,205,364,1516,2795,6,17273,959,0,2,16,0,0
56671,219,4759,2,2,2,0,0,0,2,0,0,0,0,0,0,0,0,0,0,0,0,2,28,25,0
56685,219,4759,99,48,90,1,3,5,100,0,0,0,0,0,0,0,0,0,0,0,0,2,28,25,0
56686,219,4759,8,5,5,2,0,1,10,0,0,0,0,0,0,0,0,0,0,0,0,2,28,25,0
56687,219,4759,1217,716,841,84,126,174,1301,14,185,118,215,199,333,1446,2542,8,20687,1149,0,2,28,25,0
56688,219,4759,160,89,115,0,13,31,160,7,15,11,17,22,28,78,124,3,495,27,0,2,28,25,0
56689,219,4759,10,10,9,9,0,0,19,0,0,0,0,0,0,0,0,0,0,0,0,2,28,25,0
56690,219,4759,173,84,99,8,29,36,181,5,12,7,13,17,20,54,81,2,221,12,0,2,28,25,0
56691,219,4759,3,1,1,3,0,0,6,0,0,0,0,0,0,0,0,0,0,0,0,2,28,25,0
56692,40,2521,652,304,544,16,6,88,668,6,89,51,101,95,152,591,998,3,3399,188,0,2,5,5,0
56693,77,1753,996,429,845,24,10,117,1020,7,76,50,88,83,138,494,879,4,3565,198,0,2,2,1,0
56694,77,1753,456,277,329,12,42,72,468,13,85,50,97,98,147,592,972,7,7212,400,0,2,2,1,0
56695,42,1906,447,308,343,6,5,95,453,7,96,59,111,103,170,651,1136,4,4600,255,0,2,1,1,0
56701,75,3937,1296,573,1062,40,33,157,1336,8,201,118,231,209,349,1561,2689,4,12365,686,0,2,9,0,0
56702,75,4003,1296,573,1062,40,33,157,1336,8,201,118,231,209,349,1561,2689,4,12365,686,0,2,6,0,0
56703,143,3347,77,34,69,0,0,8,77,3,24,16,29,27,45,114,213,1,387,21,0,2,9,1,1
56704,143,3347,712,438,573,51,9,84,763,14,102,71,128,116,199,733,1364,8,11988,666,0,2,9,1,1
56705,70,1383,207,111,150,11,0,50,218,5,26,19,36,31,55,133,272,3,943,52,0,2,8,0,1
56706,70,1383,410,198,237,31,55,97,441,11,63,38,72,74,110,414,683,6,4293,238,0,2,8,0,1
56707,305,6850,72,33,56,0,4,12,72,1,1,1,1,2,2,0,2,0,1,0,0,2,2,1,1
56708,305,6850,1454,835,1044,76,110,219,1530,17,275,158,296,292,454,2297,3718,9,34017,1889,1,2,2,1,1
56709,28,800,256,139,192,9,7,47,265,4,23,12,24,27,36,112,171,2,357,19,0,2,24,0,1
56710,76,3946,1296,573,1062,40,33,157,1336,8,201,118,231,209,349,1561,2689,4,12365,686,0,2,27,0,1
56711,21,498,207,111,150,11,0,50,218,5,26,19,36,31,55,133,272,3,943,52,0,2,12,0,1
56712,70,1383,207,111,150,11,0,50,218,5,26,19,36,31,55,133,272,3,943,52,0,2,8,0,0
56713,70,1383,410,198,237,31,55,97,441,11,63,38,72,74,110,414,683,6,4293,238,0,2,8,0,0
56714,305,6850,72,33,56,0,4,12,72,1,1,1,1,2,2,0,2,0,1,0,0,2,2,1,0
56715,305,6850,1454,835,1044,76,110,219,1530,17,275,158,296,292,454,2297,3718,9,34017,1889,1,2,2,1,0
56716,28,800,256,139,192,9,7,47,265,4,23,12,24,27,36,112,171,2,357,19,0,2,24,0,0
56717,76,3946,1296,573,1062,40,33,157,1336,8,201,118,231,209,349,1561,2689,4,12365,686,0,2,27,0,0
56718,21,498,207,111,150,11,0,50,218,5,26,19,36,31,55,133,272,3,943,52,0,2,12,0,0
56719,52,1096,447,308,343,6,5,95,453,7,96,59,111,103,170,651,1136,4,4600,255,0,2,5,3,0
56720,52,1096,322,174,179,16,74,51,338,10,41,26,46,51,72,252,408,5,2291,127,0,2,5,3,0
56721,42,1906,447,308,343,6,5,95,453,7,96,59,111,103,170,651,1136,4,4600,255,0,2,4,2,0
56722,143,3347,77,34,69,0,0,8,77,3,24,16,29,27,45,114,213,1,387,21,0,2,19,10,0
56723,143,3347,712,438,573,51,9,84,763,14,102,71,128,116,199,733,1364,8,11988,666,0,2,19,10,0
56724,303,6808,72,33,56,0,4,12,72,1,1,1,1,2,2,0,2,0,1,0,0,2,0,9,0
56725,303,6808,1454,835,1044,76,110,219,1530,17,275,158,296,292,454,2297,3718,9,34017,1889,1,2,0,9,0
56726,76,4039,1296,573,1062,40,33,157,1336,8,201,118,231,209,349,1561,2689,4,12365,686,0,2,15,0,0
56728,147,3379,77,34,69,0,0,8,77,3,24,16,29,27,45,114,213,1,387,21,0,2,5,4,0
56729,147,3379,712,438,573,51,9,84,763,14,102,71,128,116,199,733,1364,8,11988,666,0,2,5,4,0
56730,56,1200,91,45,69,0,3,18,91,3,9,6,10,12,16,33,57,1,95,5,0,2,5,0,0
56731,56,1200,367,234,237,17,34,68,384,16,55,34,61,71,95,381,584,8,5183,287,0,2,5,0,0
56732,301,6795,72,33,56,0,4,12,72,1,1,1,1,2,2,0,2,0,1,0,0,2,3,6,0
56733,301,6795,1454,835,1044,76,110,219,1530,17,275,158,296,292,454,2297,3718,9,34017,1889,1,2,3,6,0
56734,147,3364,77,34,69,0,0,8,77,3,24,16,29,27,45,114,213,1,387,21,0,2,7,4,1
56735,147,3364,712,438,573,51,9,84,763,14,102,71,128,116,199,733,1364,8,11988,666,0,2,7,4,1
56736,304,6818,72,33,56,0,4,12,72,1,1,1,1,2,2,0,2,0,1,0,0,2,4,0,1
56737,304,6818,1454,835,1044,76,110,219,1530,17,275,158,296,292,454,2297,3718,9,34017,1889,1,2,4,0,1
56738,148,3384,77,34,69,0,0,8,77,3,24,16,29,27,45,114,213,1,387,21,0,2,11,7,0
56739,148,3384,712,438,573,51,9,84,763,14,102,71,128,116,199,733,1364,8,11988,666,0,2,11,7,0
56740,146,3375,77,34,69,0,0,8,77,3,24,16,29,27,45,114,213,1,387,21,0,2,4,6,0
56741,146,3375,712,438,573,51,9,84,763,14,102,71,128,116,199,733,1364,8,11988,666,0,2,4,6,0
56742,56,1200,91,45,69,0,3,18,91,3,9,6,10,12,16,33,57,1,95,5,0,2,1,1,0
56743,56,1200,367,234,237,17,34,68,384,16,55,34,61,71,95,381,584,8,5183,287,0,2,1,1,0
56744,31,958,339,213,244,17,9,65,356,10,42,26,48,52,74,259,421,5,2410,133,0,2,15,7,1
56745,65,2927,1293,570,1093,25,15,163,1318,10,195,123,241,205,364,1516,2795,6,17273,959,0,2,27,0,1
56746,146,3375,77,34,69,0,0,8,77,3,24,16,29,27,45,114,213,1,387,21,0,2,18,12,0
56747,146,3375,712,438,573,51,9,84,763,14,102,71,128,116,199,733,1364,8,11988,666,0,2,18,12,0
56750,304,6818,72,33,56,0,4,12,72,1,1,1,1,2,2,0,2,0,1,0,0,2,3,2,0
56751,304,6818,1454,835,1044,76,110,219,1530,17,275,158,296,292,454,2297,3718,9,34017,1889,1,2,3,2,0
56755,155,3277,1513,682,1277,25,13,200,1538,11,199,116,219,210,335,1557,2584,6,15641,868,0,2,1,1,0
56756,155,3277,819,519,539,24,98,155,843,15,96,57,106,111,163,690,1107,8,9171,509,0,2,1,1,0
56757,72,1414,207,111,150,11,0,50,218,5,26,19,36,31,55,133,272,3,943,52,0,2,8,0,0
56758,72,1414,410,198,237,31,55,97,441,11,63,38,72,74,110,414,683,6,4293,238,0,2,8,0,0
56760,259,6068,4293,999,3693,19,54,507,4312,9,155,88,170,164,258,1156,1898,4,9368,520,0,2,9,1,0
56761,259,6068,1482,859,1002,125,135,219,1607,16,219,134,251,235,385,1766,3032,9,27804,1544,1,2,9,1,0
56762,53,633,647,139,84,35,284,233,682,0,0,0,0,0,0,0,0,0,0,0,0,2,2,2,0
56763,147,3398,77,34,69,0,0,8,77,3,24,16,29,27,45,114,213,1,387,21,0,2,9,1,0
56764,147,3398,712,438,573,51,9,84,763,14,102,71,128,116,199,733,1364,8,11988,666,0,2,9,1,0
56768,59,1228,91,45,69,0,3,18,91,3,9,6,10,12,16,33,57,1,95,5,0,2,23,13,0
56769,59,1228,367,234,237,17,34,68,384,16,55,34,61,71,95,381,584,8,5183,287,0,2,23,13,0
56770,304,6824,72,33,56,0,4,12,72,1,1,1,1,2,2,0,2,0,1,0,0,2,4,3,0
56771,304,6824,1454,835,1044,76,110,219,1530,17,275,158,296,292,454,2297,3718,9,34017,1889,1,2,4,3,0
56773,76,4039,1296,573,1062,40,33,157,1336,8,201,118,231,209,349,1561,2689,4,12365,686,0,2,42,0,0
56778,31,958,339,213,244,17,9,65,356,10,42,26,48,52,74,259,421,5,2410,133,0,2,15,7,0
56779,65,2927,1293,570,1093,25,15,163,1318,10,195,123,241,205,364,1516,2795,6,17273,959,0,2,27,0,0
56785,72,1414,207,111,150,11,0,50,218,5,26,19,36,31,55,133,272,3,943,52,0,2,13,0,0
56786,72,1414,410,198,237,31,55,97,441,11,63,38,72,74,110,414,683,6,4293,238,0,2,13,0,0
56789,219,4759,2,2,2,0,0,0,2,0,0,0,0,0,0,0,0,0,0,0,0,2,30,24,0
56803,219,4759,99,48,90,1,3,5,100,0,0,0,0,0,0,0,0,0,0,0,0,2,30,24,0
56804,219,4759,8,5,5,2,0,1,10,0,0,0,0,0,0,0,0,0,0,0,0,2,30,24,0
56805,219,4759,1217,716,841,84,126,174,1301,14,185,118,215,199,333,1446,2542,8,20687,1149,0,2,30,24,0
56806,219,4759,160,89,115,0,13,31,160,7,15,11,17,22,28,78,124,3,495,27,0,2,30,24,0
56807,219,4759,10,10,9,9,0,0,19,0,0,0,0,0,0,0,0,0,0,0,0,2,30,24,0
56808,219,4759,173,84,99,8,29,36,181,5,12,7,13,17,20,54,81,2,221,12,0,2,30,24,0
56809,219,4759,3,1,1,3,0,0,6,0,0,0,0,0,0,0,0,0,0,0,0,2,30,24,0
56810,40,1165,339,213,244,17,9,65,356,10,42,26,48,52,74,259,421,5,2410,133,0,2,47,3,0
56812,259,6068,4293,999,3693,19,54,507,4312,9,155,88,170,164,258,1156,1898,4,9368,520,0,2,4,0,0
56813,259,6068,1482,859,1002,125,135,219,1607,16,219,134,251,235,385,1766,3032,9,27804,1544,1,2,4,0,0
56815,147,3398,77,34,69,0,0,8,77,3,24,16,29,27,45,114,213,1,387,21,0,2,39,20,0
56816,147,3398,712,438,573,51,9,84,763,14,102,71,128,116,199,733,1364,8,11988,666,0,2,39,20,0
56817,59,1228,91,45,69,0,3,18,91,3,9,6,10,12,16,33,57,1,95,5,0,2,7,10,0
56818,59,1228,367,234,237,17,34,68,384,16,55,34,61,71,95,381,584,8,5183,287,0,2,7,10,0
56819,304,6824,72,33,56,0,4,12,72,1,1,1,1,2,2,0,2,0,1,0,0,2,18,18,0
56820,304,6824,1454,835,1044,76,110,219,1530,17,275,158,296,292,454,2297,3718,9,34017,1889,1,2,18,18,0
56823,226,4927,1943,715,1694,26,18,214,1969,12,185,120,237,197,357,1436,2721,7,20915,1161,0,2,26,15,0
56824,226,4927,1168,838,957,57,25,144,1225,19,348,224,416,367,640,3018,5452,11,61921,3440,1,2,26,15,0
56825,25,1187,75,38,59,1,3,12,76,2,4,2,4,6,6,10,15,1,15,0,0,2,12,0,0
56829,66,3064,1293,570,1093,25,15,163,1318,10,195,123,241,205,364,1516,2795,6,17273,959,0,2,49,7,0
56839,40,1165,339,213,244,17,9,65,356,10,42,26,48,52,74,259,421,5,2410,133,0,2,15,7,0
56857,66,3064,1293,570,1093,25,15,163,1318,10,195,123,241,205,364,1516,2795,6,17273,959,0,2,27,0,0
56860,220,4770,2,2,2,0,0,0,2,0,0,0,0,0,0,0,0,0,0,0,0,2,2,0,0
56874,220,4770,99,48,90,1,3,5,100,0,0,0,0,0,0,0,0,0,0,0,0,2,2,0,0
56875,220,4770,8,5,5,2,0,1,10,0,0,0,0,0,0,0,0,0,0,0,0,2,2,0,0
56876,220,4770,1217,716,841,84,126,174,1301,14,185,118,215,199,333,1446,2542,8,20687,1149,0,2,2,0,0
56877,220,4770,160,89,115,0,13,31,160,7,15,11,17,22,28,78,124,3,495,27,0,2,2,0,0
56878,220,4770,10,10,9,9,0,0,19,0,0,0,0,0,0,0,0,0,0,0,0,2,2,0,0
56879,220,4770,173,84,99,8,29,36,181,5,12,7,13,17,20,54,81,2,221,12,0,2,2,0,0
56880,220,4770,3,1,1,3,0,0,6,0,0,0,0,0,0,0,0,0,0,0,0,2,2,0,0
56881,123,5254,1513,682,1277,25,13,200,1538,11,199,116,219,210,335,1557,2584,6,15641,868,0,2,15,32,0
56882,34,1970,384,251,317,7,8,52,391,11,70,44,84,81,128,467,811,6,5355,297,0,2,17,0,0
56885,220,4770,2,2,2,0,0,0,2,0,0,0,0,0,0,0,0,0,0,0,0,2,1,0,0
56899,220,4770,99,48,90,1,3,5,100,0,0,0,0,0,0,0,0,0,0,0,0,2,1,0,0
56900,220,4770,8,5,5,2,0,1,10,0,0,0,0,0,0,0,0,0,0,0,0,2,1,0,0
56901,220,4770,1217,716,841,84,126,174,1301,14,185,118,215,199,333,1446,2542,8,20687,1149,0,2,1,0,0
56902,220,4770,160,89,115,0,13,31,160,7,15,11,17,22,28,78,124,3,495,27,0,2,1,0,0
56903,220,4770,10,10,9,9,0,0,19,0,0,0,0,0,0,0,0,0,0,0,0,2,1,0,0
56904,220,4770,173,84,99,8,29,36,181,5,12,7,13,17,20,54,81,2,221,12,0,2,1,0,0
56905,220,4770,3,1,1,3,0,0,6,0,0,0,0,0,0,0,0,0,0,0,0,2,1,0,0
56906,123,5258,1513,682,1277,25,13,200,1538,11,199,116,219,210,335,1557,2584,6,15641,868,0,2,15,32,0
56909,219,4755,2,2,2,0,0,0,2,0,0,0,0,0,0,0,0,0,0,0,0,2,2,3,0
56923,219,4755,99,48,90,1,3,5,100,0,0,0,0,0,0,0,0,0,0,0,0,2,2,3,0
56924,219,4755,8,5,5,2,0,1,10,0,0,0,0,0,0,0,0,0,0,0,0,2,2,3,0
56925,219,4755,1217,716,841,84,126,174,1301,14,185,118,215,199,333,1446,2542,8,20687,1149,0,2,2,3,0
56926,219,4755,160,89,115,0,13,31,160,7,15,11,17,22,28,78,124,3,495,27,0,2,2,3,0
56927,219,4755,10,10,9,9,0,0,19,0,0,0,0,0,0,0,0,0,0,0,0,2,2,3,0
56928,219,4755,173,84,99,8,29,36,181,5,12,7,13,17,20,54,81,2,221,12,0,2,2,3,0
56929,219,4755,3,1,1,3,0,0,6,0,0,0,0,0,0,0,0,0,0,0,0,2,2,3,0
56930,89,1778,477,336,357,30,23,73,507,16,194,134,250,210,384,1538,2962,10,30538,1696,0,2,34,42,1
56931,155,3275,1513,682,1277,25,13,200,1538,11,199,116,219,210,335,1557,2584,6,15641,868,0,2,2,2,1
56932,155,3275,819,519,539,24,98,155,843,15,96,57,106,111,163,690,1107,8,9171,509,0,2,2,2,1
56933,110,4151,1450,624,1228,12,26,181,1462,14,306,186,354,320,540,2580,4493,8,36391,2021,1,2,2,5,1
56934,89,1778,477,336,357,30,23,73,507,16,194,134,250,210,384,1538,2962,10,30538,1696,0,2,34,42,0
56935,155,3275,1513,682,1277,25,13,200,1538,11,199,116,219,210,335,1557,2584,6,15641,868,0,2,2,2,0
56936,155,3275,819,519,539,24,98,155,843,15,96,57,106,111,163,690,1107,8,9171,509,0,2,2,2,0
56937,110,4151,1450,624,1228,12,26,181,1462,14,306,186,354,320,540,2580,4493,8,36391,2021,1,2,2,5,0
56940,220,4776,2,2,2,0,0,0,2,0,0,0,0,0,0,0,0,0,0,0,0,2,3,1,0
56954,220,4776,99,48,90,1,3,5,100,0,0,0,0,0,0,0,0,0,0,0,0,2,3,1,0
56955,220,4776,8,5,5,2,0,1,10,0,0,0,0,0,0,0,0,0,0,0,0,2,3,1,0
56956,220,4776,1217,716,841,84,126,174,1301,14,185,118,215,199,333,1446,2542,8,20687,1149,0,2,3,1,0
56957,220,4776,160,89,115,0,13,31,160,7,15,11,17,22,28,78,124,3,495,27,0,2,3,1,0
56958,220,4776,10,10,9,9,0,0,19,0,0,0,0,0,0,0,0,0,0,0,0,2,3,1,0
56959,220,4776,173,84,99,8,29,36,181,5,12,7,13,17,20,54,81,2,221,12,0,2,3,1,0
56960,220,4776,3,1,1,3,0,0,6,0,0,0,0,0,0,0,0,0,0,0,0,2,3,1,0
56961,149,3468,77,34,69,0,0,8,77,3,24,16,29,27,45,114,213,1,387,21,0,2,16,0,1
56962,149,3468,712,438,573,51,9,84,763,14,102,71,128,116,199,733,1364,8,11988,666,0,2,16,0,1
56963,87,1953,53,23,39,0,0,13,53,2,8,4,8,10,12,26,39,1,39,2,0,2,1,7,1
56964,87,1953,515,298,307,33,80,99,548,12,63,44,77,75,121,419,753,7,5527,307,0,2,1,7,1
56988,149,3468,77,34,69,0,0,8,77,3,24,16,29,27,45,114,213,1,387,21,0,2,16,0,0
56989,149,3468,712,438,573,51,9,84,763,14,102,71,128,116,199,733,1364,8,11988,666,0,2,16,0,0
56990,87,1953,53,23,39,0,0,13,53,2,8,4,8,10,12,26,39,1,39,2,0,2,1,7,0
56991,87,1953,515,298,307,33,80,99,548,12,63,44,77,75,121,419,753,7,5527,307,0,2,1,7,0
56994,219,4765,2,2,2,0,0,0,2,0,0,0,0,0,0,0,0,0,0,0,0,2,3,3,0
57008,219,4765,99,48,90,1,3,5,100,0,0,0,0,0,0,0,0,0,0,0,0,2,3,3,0
57009,219,4765,8,5,5,2,0,1,10,0,0,0,0,0,0,0,0,0,0,0,0,2,3,3,0
57010,219,4765,1217,716,841,84,126,174,1301,14,185,118,215,199,333,1446,2542,8,20687,1149,0,2,3,3,0
57011,219,4765,160,89,115,0,13,31,160,7,15,11,17,22,28,78,124,3,495,27,0,2,3,3,0
57012,219,4765,10,10,9,9,0,0,19,0,0,0,0,0,0,0,0,0,0,0,0,2,3,3,0
57013,219,4765,173,84,99,8,29,36,181,5,12,7,13,17,20,54,81,2,221,12,0,2,3,3,0
57014,219,4765,3,1,1,3,0,0,6,0,0,0,0,0,0,0,0,0,0,0,0,2,3,3,0
57015,77,4118,1296,573,1062,40,33,157,1336,8,201,118,231,209,349,1561,2689,4,12365,686,0,2,24,0,0
57016,148,3423,77,34,69,0,0,8,77,3,24,16,29,27,45,114,213,1,387,21,0,2,15,14,0
57017,148,3423,712,438,573,51,9,84,763,14,102,71,128,116,199,733,1364,8,11988,666,0,2,15,14,0
57018,308,6881,72,33,56,0,4,12,72,1,1,1,1,2,2,0,2,0,1,0,0,2,14,1,0
57019,308,6881,1454,835,1044,76,110,219,1530,17,275,158,296,292,454,2297,3718,9,34017,1889,1,2,14,1,0
57020,76,4080,1296,573,1062,40,33,157,1336,8,201,118,231,209,349,1561,2689,4,12365,686,0,2,24,8,0
57021,148,3409,77,34,69,0,0,8,77,3,24,16,29,27,45,114,213,1,387,21,0,2,3,4,0
57022,148,3409,712,438,573,51,9,84,763,14,102,71,128,116,199,733,1364,8,11988,666,0,2,3,4,0
57023,76,4115,1296,573,1062,40,33,157,1336,8,201,118,231,209,349,1561,2689,4,12365,686,0,2,13,0,0
57024,76,4117,1296,573,1062,40,33,157,1336,8,201,118,231,209,349,1561,2689,4,12365,686,0,2,11,8,0
57025,150,3460,77,34,69,0,0,8,77,3,24,16,29,27,45,114,213,1,387,21,0,2,11,6,0
57026,150,3460,712,438,573,51,9,84,763,14,102,71,128,116,199,733,1364,8,11988,666,0,2,11,6,0
57027,147,3410,77,34,69,0,0,8,77,3,24,16,29,27,45,114,213,1,387,21,0,2,8,12,0
57028,147,3410,712,438,573,51,9,84,763,14,102,71,128,116,199,733,1364,8,11988,666,0,2,8,12,0
57029,150,3446,77,34,69,0,0,8,77,3,24,16,29,27,45,114,213,1,387,21,0,2,15,5,0
57030,150,3446,712,438,573,51,9,84,763,14,102,71,128,116,199,733,1364,8,11988,666,0,2,15,5,0
57031,148,3413,77,34,69,0,0,8,77,3,24,16,29,27,45,114,213,1,387,21,0,2,6,15,0
57032,148,3413,712,438,573,51,9,84,763,14,102,71,128,116,199,733,1364,8,11988,666,0,2,6,15,0
57033,34,1970,384,251,317,7,8,52,391,11,70,44,84,81,128,467,811,6,5355,297,0,2,5,4,0
57034,148,3413,77,34,69,0,0,8,77,3,24,16,29,27,45,114,213,1,387,21,0,2,34,32,0
57035,148,3413,712,438,573,51,9,84,763,14,102,71,128,116,199,733,1364,8,11988,666,0,2,34,32,0
57038,76,4117,1296,573,1062,40,33,157,1336,8,201,118,231,209,349,1561,2689,4,12365,686,0,2,42,10,0
57063,227,4936,1943,715,1694,26,18,214,1969,12,185,120,237,197,357,1436,2721,7,20915,1161,0,2,4,1,0
57064,227,4936,1168,838,957,57,25,144,1225,19,348,224,416,367,640,3018,5452,11,61921,3440,1,2,4,1,0
57070,219,4761,2,2,2,0,0,0,2,0,0,0,0,0,0,0,0,0,0,0,0,2,2,3,0
57084,219,4761,99,48,90,1,3,5,100,0,0,0,0,0,0,0,0,0,0,0,0,2,2,3,0
57085,219,4761,8,5,5,2,0,1,10,0,0,0,0,0,0,0,0,0,0,0,0,2,2,3,0
57086,219,4761,1217,716,841,84,126,174,1301,14,185,118,215,199,333,1446,2542,8,20687,1149,0,2,2,3,0
57087,219,4761,160,89,115,0,13,31,160,7,15,11,17,22,28,78,124,3,495,27,0,2,2,3,0
57088,219,4761,10,10,9,9,0,0,19,0,0,0,0,0,0,0,0,0,0,0,0,2,2,3,0
57089,219,4761,173,84,99,8,29,36,181,5,12,7,13,17,20,54,81,2,221,12,0,2,2,3,0
57090,219,4761,3,1,1,3,0,0,6,0,0,0,0,0,0,0,0,0,0,0,0,2,2,3,0
57091,150,3483,77,34,69,0,0,8,77,3,24,16,29,27,45,114,213,1,387,21,0,2,34,32,0
57092,150,3483,712,438,573,51,9,84,763,14,102,71,128,116,199,733,1364,8,11988,666,0,2,34,32,0
57097,77,4196,1296,573,1062,40,33,157,1336,8,201,118,231,209,349,1561,2689,4,12365,686,0,2,42,10,0
57133,220,4775,2,2,2,0,0,0,2,0,0,0,0,0,0,0,0,0,0,0,0,2,6,4,1
57147,220,4775,99,48,90,1,3,5,100,0,0,0,0,0,0,0,0,0,0,0,0,2,6,4,1
57148,220,4775,8,5,5,2,0,1,10,0,0,0,0,0,0,0,0,0,0,0,0,2,6,4,1
57149,220,4775,1217,716,841,84,126,174,1301,14,185,118,215,199,333,1446,2542,8,20687,1149,0,2,6,4,1
57150,220,4775,160,89,115,0,13,31,160,7,15,11,17,22,28,78,124,3,495,27,0,2,6,4,1
57151,220,4775,10,10,9,9,0,0,19,0,0,0,0,0,0,0,0,0,0,0,0,2,6,4,1
57152,220,4775,173,84,99,8,29,36,181,5,12,7,13,17,20,54,81,2,221,12,0,2,6,4,1
57153,220,4775,3,1,1,3,0,0,6,0,0,0,0,0,0,0,0,0,0,0,0,2,6,4,1
57154,77,4244,1296,573,1062,40,33,157,1336,8,201,118,231,209,349,1561,2689,4,12365,686,0,2,14,1,1
57159,220,4772,2,2,2,0,0,0,2,0,0,0,0,0,0,0,0,0,0,0,0,2,5,0,0
57173,220,4772,99,48,90,1,3,5,100,0,0,0,0,0,0,0,0,0,0,0,0,2,5,0,0
57174,220,4772,8,5,5,2,0,1,10,0,0,0,0,0,0,0,0,0,0,0,0,2,5,0,0
57175,220,4772,1217,716,841,84,126,174,1301,14,185,118,215,199,333,1446,2542,8,20687,1149,0,2,5,0,0
57176,220,4772,160,89,115,0,13,31,160,7,15,11,17,22,28,78,124,3,495,27,0,2,5,0,0
57177,220,4772,10,10,9,9,0,0,19,0,0,0,0,0,0,0,0,0,0,0,0,2,5,0,0
57178,220,4772,173,84,99,8,29,36,181,5,12,7,13,17,20,54,81,2,221,12,0,2,5,0,0
57179,220,4772,3,1,1,3,0,0,6,0,0,0,0,0,0,0,0,0,0,0,0,2,5,0,0
57180,34,1970,384,251,317,7,8,52,391,11,70,44,84,81,128,467,811,6,5355,297,0,2,18,0,0
57183,220,4775,2,2,2,0,0,0,2,0,0,0,0,0,0,0,0,0,0,0,0,2,6,4,0
57197,220,4775,99,48,90,1,3,5,100,0,0,0,0,0,0,0,0,0,0,0,0,2,6,4,0
57198,220,4775,8,5,5,2,0,1,10,0,0,0,0,0,0,0,0,0,0,0,0,2,6,4,0
57199,220,4775,1217,716,841,84,126,174,1301,14,185,118,215,199,333,1446,2542,8,20687,1149,0,2,6,4,0
57200,220,4775,160,89,115,0,13,31,160,7,15,11,17,22,28,78,124,3,495,27,0,2,6,4,0
57201,220,4775,10,10,9,9,0,0,19,0,0,0,0,0,0,0,0,0,0,0,0,2,6,4,0
57202,220,4775,173,84,99,8,29,36,181,5,12,7,13,17,20,54,81,2,221,12,0,2,6,4,0
57203,220,4775,3,1,1,3,0,0,6,0,0,0,0,0,0,0,0,0,0,0,0,2,6,4,0
57204,77,4244,1296,573,1062,40,33,157,1336,8,201,118,231,209,349,1561,2689,4,12365,686,0,2,14,1,0
57205,259,6068,4293,999,3693,19,54,507,4312,9,155,88,170,164,258,1156,1898,4,9368,520,0,2,1,1,0
57206,259,6068,1482,859,1002,125,135,219,1607,16,219,134,251,235,385,1766,3032,9,27804,1544,1,2,1,1,0
57207,99,4099,1289,550,1043,56,32,155,1345,10,167,93,185,177,278,1266,2075,5,11498,638,0,2,2,1,0
57208,2,25,127,75,83,2,11,30,129,4,14,7,14,18,21,61,87,2,175,9,0,2,4,0,0
57209,2,25,652,304,544,16,6,88,668,6,89,51,101,95,152,591,998,3,3399,188,0,2,4,0,0
57210,2,25,2,2,2,0,0,0,2,0,0,0,0,0,0,0,0,0,0,0,0,2,4,0,0
57211,2,25,8,5,5,0,0,3,8,0,0,0,0,0,0,0,0,0,0,0,0,2,4,0,0
57214,2,25,14,8,8,0,0,6,14,0,0,0,0,0,0,0,0,0,0,0,0,2,4,0,0
57215,2,25,6,4,4,0,0,2,6,0,0,0,0,0,0,0,0,0,0,0,0,2,4,0,0
57216,2,25,6,4,4,0,0,2,6,1,2,1,2,3,3,2,4,0,2,0,0,2,4,0,0
57218,2,25,7,5,5,0,0,2,7,0,0,0,0,0,0,0,0,0,0,0,0,2,4,0,0
57220,2,25,10,6,6,0,0,4,10,0,0,0,0,0,0,0,0,0,0,0,0,2,4,0,0
57221,2,25,1,1,1,0,0,0,1,0,0,0,0,0,0,0,0,0,0,0,0,2,4,0,0
57223,2,25,14,10,10,0,0,4,14,1,1,1,1,2,2,0,2,0,1,0,0,2,4,0,0
57224,2,25,46,26,30,3,0,12,49,3,6,3,6,9,9,20,28,1,42,2,0,2,4,0,0
57225,148,3416,77,34,69,0,0,8,77,3,24,16,29,27,45,114,213,1,387,21,0,2,2,2,0
57226,148,3416,712,438,573,51,9,84,763,14,102,71,128,116,199,733,1364,8,11988,666,0,2,2,2,0
57227,148,3416,77,34,69,0,0,8,77,3,24,16,29,27,45,114,213,1,387,21,0,2,1,1,0
57228,148,3416,712,438,573,51,9,84,763,14,102,71,128,116,199,733,1364,8,11988,666,0,2,1,1,0
57230,92,4718,1457,730,1242,11,6,188,1468,10,292,166,329,302,495,2424,4078,5,22973,1276,1,2,1,1,1
57231,244,5842,722,423,573,19,0,135,741,12,172,101,199,184,300,1320,2257,6,15668,870,0,2,4,4,0
57232,244,5842,1508,847,911,44,250,301,1552,14,148,88,169,162,257,1120,1886,7,15077,837,0,2,4,4,0
57233,78,1782,996,429,845,24,10,117,1020,7,76,50,88,83,138,494,879,4,3565,198,0,2,5,1,0
57234,78,1782,456,277,329,12,42,72,468,13,85,50,97,98,147,592,972,7,7212,400,0,2,5,1,0
57235,47,3342,996,429,845,24,10,117,1020,7,76,50,88,83,138,494,879,4,3565,198,0,2,21,8,0
57238,148,3416,77,34,69,0,0,8,77,3,24,16,29,27,45,114,213,1,387,21,0,2,3,3,0
57239,148,3416,712,438,573,51,9,84,763,14,102,71,128,116,199,733,1364,8,11988,666,0,2,3,3,0
57261,92,4718,1457,730,1242,11,6,188,1468,10,292,166,329,302,495,2424,4078,5,22973,1276,1,2,1,1,0
57267,221,4792,2,2,2,0,0,0,2,0,0,0,0,0,0,0,0,0,0,0,0,2,5,0,0
57281,221,4792,99,48,90,1,3,5,100,0,0,0,0,0,0,0,0,0,0,0,0,2,5,0,0
57282,221,4792,8,5,5,2,0,1,10,0,0,0,0,0,0,0,0,0,0,0,0,2,5,0,0
57283,221,4792,1217,716,841,84,126,174,1301,14,185,118,215,199,333,1446,2542,8,20687,1149,0,2,5,0,0
57284,221,4792,160,89,115,0,13,31,160,7,15,11,17,22,28,78,124,3,495,27,0,2,5,0,0
57285,221,4792,10,10,9,9,0,0,19,0,0,0,0,0,0,0,0,0,0,0,0,2,5,0,0
57286,221,4792,173,84,99,8,29,36,181,5,12,7,13,17,20,54,81,2,221,12,0,2,5,0,0
57287,221,4792,3,1,1,3,0,0,6,0,0,0,0,0,0,0,0,0,0,0,0,2,5,0,0
57290,150,3486,77,34,69,0,0,8,77,3,24,16,29,27,45,114,213,1,387,21,0,2,3,3,0
57291,150,3486,712,438,573,51,9,84,763,14,102,71,128,116,199,733,1364,8,11988,666,0,2,3,3,0
57317,88,1991,53,23,39,0,0,13,53,2,8,4,8,10,12,26,39,1,39,2,0,2,1,1,0
57318,88,1991,515,298,307,33,80,99,548,12,63,44,77,75,121,419,753,7,5527,307,0,2,1,1,0
57319,99,4099,1289,550,1043,56,32,155,1345,10,167,93,185,177,278,1266,2075,5,11498,638,0,2,5,5,0
57320,3,229,53,23,39,0,0,13,53,2,8,4,8,10,12,26,39,1,39,2,0,2,22,0,0
57321,30,1248,373,158,315,8,0,51,381,5,76,44,79,81,123,486,779,2,2026,112,0,2,5,1,0
57379,23,613,102,59,69,5,3,24,107,6,22,15,28,28,43,113,206,3,789,43,0,2,10,4,0
57380,87,1963,53,23,39,0,0,13,53,2,8,4,8,10,12,26,39,1,39,2,0,2,7,5,0
57381,87,1963,515,298,307,33,80,99,548,12,63,44,77,75,121,419,753,7,5527,307,0,2,7,5,0
57382,92,1965,1043,504,840,53,9,147,1096,9,180,112,198,189,310,1377,2344,4,11604,644,0,2,1,2,0
57383,92,1965,383,288,292,26,6,62,409,11,65,38,67,76,105,429,656,5,3719,206,0,2,1,2,0
57384,227,4916,1943,715,1694,26,18,214,1969,12,185,120,237,197,357,1436,2721,7,20915,1161,0,2,2,4,0
57385,227,4916,1168,838,957,57,25,144,1225,19,348,224,416,367,640,3018,5452,11,61921,3440,1,2,2,4,0
57386,77,4237,1296,573,1062,40,33,157,1336,8,201,118,231,209,349,1561,2689,4,12365,686,0,2,3,8,0
57387,2,145,53,23,39,0,0,13,53,2,8,4,8,10,12,26,39,1,39,2,0,2,4,4,0
57388,30,1248,373,158,315,8,0,51,381,5,76,44,79,81,123,486,779,2,2026,112,0,2,12,2,0
57389,228,4924,1943,715,1694,26,18,214,1969,12,185,120,237,197,357,1436,2721,7,20915,1161,0,2,2,2,0
57390,228,4924,1168,838,957,57,25,144,1225,19,348,224,416,367,640,3018,5452,11,61921,3440,1,2,2,2,0
57391,103,4795,1338,495,1086,10,64,173,1348,11,122,82,157,133,239,883,1686,7,11934,663,0,2,1,3,0
57397,228,4924,1943,715,1694,26,18,214,1969,12,185,120,237,197,357,1436,2721,7,20915,1161,0,2,4,6,0
57398,228,4924,1168,838,957,57,25,144,1225,19,348,224,416,367,640,3018,5452,11,61921,3440,1,2,4,6,0
57405,78,4335,1296,573,1062,40,33,157,1336,8,201,118,231,209,349,1561,2689,4,12365,686,0,2,54,0,0
57406,148,3404,77,34,69,0,0,8,77,3,24,16,29,27,45,114,213,1,387,21,0,2,2,2,0
57407,148,3404,712,438,573,51,9,84,763,14,102,71,128,116,199,733,1364,8,11988,666,0,2,2,2,0
57413,109,2070,477,336,357,30,23,73,507,16,194,134,250,210,384,1538,2962,10,30538,1696,0,2,46,0,1
57414,111,2091,477,336,357,30,23,73,507,16,194,134,250,210,384,1538,2962,10,30538,1696,0,2,5,6,1
57415,122,4845,1450,624,1228,12,26,181,1462,14,306,186,354,320,540,2580,4493,8,36391,2021,1,2,139,0,1
57416,122,4887,1450,624,1228,12,26,181,1462,14,306,186,354,320,540,2580,4493,8,36391,2021,1,2,2,0,0
57417,62,1174,282,196,195,3,0,86,285,8,130,71,141,138,212,936,1507,4,6538,363,0,2,24,0,0
57419,111,2091,477,336,357,30,23,73,507,16,194,134,250,210,384,1538,2962,10,30538,1696,0,2,2,2,0
57420,122,4887,1450,624,1228,12,26,181,1462,14,306,186,354,320,540,2580,4493,8,36391,2021,1,2,8,8,0
57421,111,2094,477,336,357,30,23,73,507,16,194,134,250,210,384,1538,2962,10,30538,1696,0,2,1,1,0
57422,122,4939,1450,624,1228,12,26,181,1462,14,306,186,354,320,540,2580,4493,8,36391,2021,1,2,23,23,0
57423,111,2104,477,336,357,30,23,73,507,16,194,134,250,210,384,1538,2962,10,30538,1696,0,2,2,2,0
57424,108,2074,477,336,357,30,23,73,507,16,194,134,250,210,384,1538,2962,10,30538,1696,0,2,7,9,0
57425,108,2070,477,336,357,30,23,73,507,16,194,134,250,210,384,1538,2962,10,30538,1696,0,2,4,4,0
57426,122,4959,1450,624,1228,12,26,181,1462,14,306,186,354,320,540,2580,4493,8,36391,2021,1,2,10,10,0
57427,58,1067,282,196,195,3,0,86,285,8,130,71,141,138,212,936,1507,4,6538,363,0,2,2,5,1
57428,29,743,601,196,481,2,23,85,603,8,63,36,72,71,108,400,664,4,3036,168,0,2,4,0,1
57429,29,743,156,79,106,5,16,28,161,5,14,8,15,19,23,64,97,2,261,14,0,2,4,0,1
57430,99,4109,1289,550,1043,56,32,155,1345,10,167,93,185,177,278,1266,2075,5,11498,638,0,2,5,2,1
57431,25,1181,75,38,59,1,3,12,76,2,4,2,4,6,6,10,15,1,15,0,0,2,9,10,1
57432,103,4810,1338,495,1086,10,64,173,1348,11,122,82,157,133,239,883,1686,7,11934,663,0,2,6,5,1
57433,180,8032,139,89,101,2,0,35,141,7,54,34,62,61,96,330,569,4,2287,127,0,2,11,8,1
57434,180,8032,7,5,5,0,0,2,7,1,2,1,2,3,3,2,4,0,2,0,0,2,11,8,1
57435,138,6179,1782,648,1425,9,47,279,1791,8,171,97,189,179,286,1292,2140,4,9462,525,0,2,17,16,1
57436,92,4728,1457,730,1242,11,6,188,1468,10,292,166,329,302,495,2424,4078,5,22973,1276,1,2,6,3,1
57437,97,4242,1020,354,843,12,15,144,1032,8,134,77,144,142,221,970,1580,4,6792,377,0,2,5,3,1
57438,21,670,424,94,331,4,0,89,428,1,5,5,5,6,10,11,25,0,12,0,0,2,2,1,1
57439,66,3075,1293,570,1093,25,15,163,1318,10,195,123,241,205,364,1516,2795,6,17273,959,0,2,4,1,1
57440,14,546,295,56,236,0,4,54,295,2,9,5,10,11,15,30,51,1,57,3,0,2,5,2,1
57441,99,5096,1943,715,1694,26,18,214,1969,12,185,120,237,197,357,1436,2721,7,20915,1161,0,2,3,3,1
57442,31,1326,442,244,305,14,16,103,456,11,68,45,75,79,120,452,756,6,4588,254,0,2,2,1,1
57443,45,1575,601,196,481,2,23,85,603,8,63,36,72,71,108,400,664,4,3036,168,0,2,31,0,1
57444,9,447,219,78,157,11,5,46,230,3,24,20,34,27,54,114,256,2,545,30,0,2,8,0,0
57445,1,55,14,12,10,0,0,4,14,1,2,1,2,3,3,2,4,0,2,0,0,0,14,0,0
57446,1,58,14,12,10,0,0,4,14,1,2,1,2,3,3,2,4,0,2,0,0,0,14,0,0
57448,1,77,19,18,14,0,0,5,19,1,2,1,2,3,3,2,4,0,2,0,0,0,19,0,0
57449,120,4779,1450,624,1228,12,26,181,1462,14,306,186,354,320,540,2580,4493,8,36391,2021,1,2,35,66,0
57450,92,1983,1043,504,840,53,9,147,1096,9,180,112,198,189,310,1377,2344,4,11604,644,0,2,2,1,0
57451,92,1983,383,288,292,26,6,62,409,11,65,38,67,76,105,429,656,5,3719,206,0,2,2,1,0
57452,86,3304,1043,504,840,53,9,147,1096,9,180,112,198,189,310,1377,2344,4,11604,644,0,2,13,0,0
57453,244,5852,722,423,573,19,0,135,741,12,172,101,199,184,300,1320,2257,6,15668,870,0,2,1,0,0
57454,244,5852,1508,847,911,44,250,301,1552,14,148,88,169,162,257,1120,1886,7,15077,837,0,2,1,0,0
57455,45,3296,996,429,845,24,10,117,1020,7,76,50,88,83,138,494,879,4,3565,198,0,2,0,11,0
57456,58,1067,282,196,195,3,0,86,285,8,130,71,141,138,212,936,1507,4,6538,363,0,2,2,5,0
57457,29,743,601,196,481,2,23,85,603,8,63,36,72,71,108,400,664,4,3036,168,0,2,4,0,0
57458,29,743,156,79,106,5,16,28,161,5,14,8,15,19,23,64,97,2,261,14,0,2,4,0,0
57459,99,4109,1289,550,1043,56,32,155,1345,10,167,93,185,177,278,1266,2075,5,11498,638,0,2,5,2,0
57460,25,1181,75,38,59,1,3,12,76,2,4,2,4,6,6,10,15,1,15,0,0,2,9,10,0
57461,103,4810,1338,495,1086,10,64,173,1348,11,122,82,157,133,239,883,1686,7,11934,663,0,2,6,5,0
57462,180,8032,139,89,101,2,0,35,141,7,54,34,62,61,96,330,569,4,2287,127,0,2,11,8,0
57463,180,8032,7,5,5,0,0,2,7,1,2,1,2,3,3,2,4,0,2,0,0,2,11,8,0
57464,138,6179,1782,648,1425,9,47,279,1791,8,171,97,189,179,286,1292,2140,4,9462,525,0,2,17,16,0
57465,92,4728,1457,730,1242,11,6,188,1468,10,292,166,329,302,495,2424,4078,5,22973,1276,1,2,6,3,0
57466,97,4242,1020,354,843,12,15,144,1032,8,134,77,144,142,221,970,1580,4,6792,377,0,2,5,3,0
57467,21,670,424,94,331,4,0,89,428,1,5,5,5,6,10,11,25,0,12,0,0,2,2,1,0
57468,66,3075,1293,570,1093,25,15,163,1318,10,195,123,241,205,364,1516,2795,6,17273,959,0,2,4,1,0
57469,14,546,295,56,236,0,4,54,295,2,9,5,10,11,15,30,51,1,57,3,0,2,5,2,0
57471,99,5096,1943,715,1694,26,18,214,1969,12,185,120,237,197,357,1436,2721,7,20915,1161,0,2,3,3,0
57472,31,1326,442,244,305,14,16,103,456,11,68,45,75,79,120,452,756,6,4588,254,0,2,2,1,0
57473,45,1575,601,196,481,2,23,85,603,8,63,36,72,71,108,400,664,4,3036,168,0,2,31,0,0
57474,150,3474,77,34,69,0,0,8,77,3,24,16,29,27,45,114,213,1,387,21,0,2,4,4,0
57475,150,3474,712,438,573,51,9,84,763,14,102,71,128,116,199,733,1364,8,11988,666,0,2,4,4,0
57476,87,1961,53,23,39,0,0,13,53,2,8,4,8,10,12,26,39,1,39,2,0,2,1,1,0
57477,87,1961,515,298,307,33,80,99,548,12,63,44,77,75,121,419,753,7,5527,307,0,2,1,1,0
57478,99,4109,1289,550,1043,56,32,155,1345,10,167,93,185,177,278,1266,2075,5,11498,638,0,2,5,5,0
57480,79,4449,1296,573,1062,40,33,157,1336,8,201,118,231,209,349,1561,2689,4,12365,686,0,2,53,0,0
57482,30,1251,373,158,315,8,0,51,381,5,76,44,79,81,123,486,779,2,2026,112,0,2,5,1,0
57486,108,2057,477,336,357,30,23,73,507,16,194,134,250,210,384,1538,2962,10,30538,1696,0,2,3,5,0
57487,120,4779,1450,624,1228,12,26,181,1462,14,306,186,354,320,540,2580,4493,8,36391,2021,1,2,6,6,0
57493,221,4792,2,2,2,0,0,0,2,0,0,0,0,0,0,0,0,0,0,0,0,2,1,1,0
57507,221,4792,99,48,90,1,3,5,100,0,0,0,0,0,0,0,0,0,0,0,0,2,1,1,0
57508,221,4792,8,5,5,2,0,1,10,0,0,0,0,0,0,0,0,0,0,0,0,2,1,1,0
57509,221,4792,1217,716,841,84,126,174,1301,14,185,118,215,199,333,1446,2542,8,20687,1149,0,2,1,1,0
57510,221,4792,160,89,115,0,13,31,160,7,15,11,17,22,28,78,124,3,495,27,0,2,1,1,0
57511,221,4792,10,10,9,9,0,0,19,0,0,0,0,0,0,0,0,0,0,0,0,2,1,1,0
57512,221,4792,173,84,99,8,29,36,181,5,12,7,13,17,20,54,81,2,221,12,0,2,1,1,0
57513,221,4792,3,1,1,3,0,0,6,0,0,0,0,0,0,0,0,0,0,0,0,2,1,1,0
57514,55,783,167,116,138,4,5,22,171,8,48,30,56,56,86,292,499,4,2330,129,0,2,16,10,0
57524,92,1973,1043,504,840,53,9,147,1096,9,180,112,198,189,310,1377,2344,4,11604,644,0,2,2,1,0
57525,92,1973,383,288,292,26,6,62,409,11,65,38,67,76,105,429,656,5,3719,206,0,2,2,1,0
57532,221,4792,2,2,2,0,0,0,2,0,0,0,0,0,0,0,0,0,0,0,0,2,6,4,0
57546,221,4792,99,48,90,1,3,5,100,0,0,0,0,0,0,0,0,0,0,0,0,2,6,4,0
57547,221,4792,8,5,5,2,0,1,10,0,0,0,0,0,0,0,0,0,0,0,0,2,6,4,0
57548,221,4792,1217,716,841,84,126,174,1301,14,185,118,215,199,333,1446,2542,8,20687,1149,0,2,6,4,0
57549,221,4792,160,89,115,0,13,31,160,7,15,11,17,22,28,78,124,3,495,27,0,2,6,4,0
57550,221,4792,10,10,9,9,0,0,19,0,0,0,0,0,0,0,0,0,0,0,0,2,6,4,0
57551,221,4792,173,84,99,8,29,36,181,5,12,7,13,17,20,54,81,2,221,12,0,2,6,4,0
57552,221,4792,3,1,1,3,0,0,6,0,0,0,0,0,0,0,0,0,0,0,0,2,6,4,0
57553,150,3474,77,34,69,0,0,8,77,3,24,16,29,27,45,114,213,1,387,21,0,2,16,0,0
57554,150,3474,712,438,573,51,9,84,763,14,102,71,128,116,199,733,1364,8,11988,666,0,2,16,0,0
57555,87,1961,53,23,39,0,0,13,53,2,8,4,8,10,12,26,39,1,39,2,0,2,8,12,0
57556,87,1961,515,298,307,33,80,99,548,12,63,44,77,75,121,419,753,7,5527,307,0,2,8,12,0
57559,92,1973,1043,504,840,53,9,147,1096,9,180,112,198,189,310,1377,2344,4,11604,644,0,2,1,2,0
57560,92,1973,383,288,292,26,6,62,409,11,65,38,67,76,105,429,656,5,3719,206,0,2,1,2,0
57567,103,4810,1338,495,1086,10,64,173,1348,11,122,82,157,133,239,883,1686,7,11934,663,0,2,7,8,0
57571,45,3296,996,429,845,24,10,117,1020,7,76,50,88,83,138,494,879,4,3565,198,0,2,10,8,0
57572,79,4449,1296,573,1062,40,33,157,1336,8,201,118,231,209,349,1561,2689,4,12365,686,0,2,39,8,0
57575,3,229,53,23,39,0,0,13,53,2,8,4,8,10,12,26,39,1,39,2,0,2,4,4,0
57579,30,1251,373,158,315,8,0,51,381,5,76,44,79,81,123,486,779,2,2026,112,0,2,12,2,0
57584,81,1820,996,429,845,24,10,117,1020,7,76,50,88,83,138,494,879,4,3565,198,0,2,9,2,0
57585,81,1820,456,277,329,12,42,72,468,13,85,50,97,98,147,592,972,7,7212,400,0,2,9,2,0
57586,46,3385,996,429,845,24,10,117,1020,7,76,50,88,83,138,494,879,4,3565,198,0,2,25,2,0
57590,308,6877,72,33,56,0,4,12,72,1,1,1,1,2,2,0,2,0,1,0,0,2,5,5,0
57591,308,6877,1454,835,1044,76,110,219,1530,17,275,158,296,292,454,2297,3718,9,34017,1889,1,2,5,5,0
57592,30,1260,373,158,315,8,0,51,381,5,76,44,79,81,123,486,779,2,2026,112,0,2,3,1,0
57593,245,5865,722,423,573,19,0,135,741,12,172,101,199,184,300,1320,2257,6,15668,870,0,2,3,0,0
57594,245,5865,1508,847,911,44,250,301,1552,14,148,88,169,162,257,1120,1886,7,15077,837,0,2,3,0,0
57597,220,4772,2,2,2,0,0,0,2,0,0,0,0,0,0,0,0,0,0,0,0,2,1,4,0
57611,220,4772,99,48,90,1,3,5,100,0,0,0,0,0,0,0,0,0,0,0,0,2,1,4,0
57612,220,4772,8,5,5,2,0,1,10,0,0,0,0,0,0,0,0,0,0,0,0,2,1,4,0
57613,220,4772,1217,716,841,84,126,174,1301,14,185,118,215,199,333,1446,2542,8,20687,1149,0,2,1,4,0
57614,220,4772,160,89,115,0,13,31,160,7,15,11,17,22,28,78,124,3,495,27,0,2,1,4,0
57615,220,4772,10,10,9,9,0,0,19,0,0,0,0,0,0,0,0,0,0,0,0,2,1,4,0
57616,220,4772,173,84,99,8,29,36,181,5,12,7,13,17,20,54,81,2,221,12,0,2,1,4,0
57617,220,4772,3,1,1,3,0,0,6,0,0,0,0,0,0,0,0,0,0,0,0,2,1,4,0
57618,80,4548,1296,573,1062,40,33,157,1336,8,201,118,231,209,349,1561,2689,4,12365,686,0,2,22,0,0
57643,180,5413,1660,832,1314,41,38,274,1701,20,312,209,395,332,604,2671,5058,12,64042,3557,1,2,2,1,0
57644,180,5413,1057,646,719,113,100,145,1170,18,215,134,248,233,382,1740,3004,10,31186,1732,1,2,2,1,0
57645,167,5019,1660,832,1314,41,38,274,1701,20,312,209,395,332,604,2671,5058,12,64042,3557,1,2,13,0,0
57652,1,104,42,7,35,4,0,5,46,1,2,1,2,3,3,2,4,0,2,0,0,2,10,0,0
57653,1,104,11,6,10,0,0,1,11,2,4,2,4,6,6,10,15,1,15,0,0,2,10,0,0
57682,72,1422,207,111,150,11,0,50,218,5,26,19,36,31,55,133,272,3,943,52,0,2,2,2,0
57683,72,1422,410,198,237,31,55,97,441,11,63,38,72,74,110,414,683,6,4293,238,0,2,2,2,0
57684,92,1851,757,253,292,73,244,162,830,13,61,38,67,74,105,409,651,7,4654,258,0,2,9,4,0
57685,66,4389,520,294,400,33,13,81,553,10,261,204,367,271,571,2128,4614,7,32445,1802,1,2,10,0,0
57686,66,4392,520,294,400,33,13,81,553,10,261,204,367,271,571,2128,4614,7,32445,1802,1,2,4,3,0
57721,41,1220,339,213,244,17,9,65,356,10,42,26,48,52,74,259,421,5,2410,133,0,2,18,10,1
57722,67,3166,1293,570,1093,25,15,163,1318,10,195,123,241,205,364,1516,2795,6,17273,959,0,2,30,1,1
57725,220,4765,2,2,2,0,0,0,2,0,0,0,0,0,0,0,0,0,0,0,0,2,0,7,0
57739,220,4765,99,48,90,1,3,5,100,0,0,0,0,0,0,0,0,0,0,0,0,2,0,7,0
57740,220,4765,8,5,5,2,0,1,10,0,0,0,0,0,0,0,0,0,0,0,0,2,0,7,0
57741,220,4765,1217,716,841,84,126,174,1301,14,185,118,215,199,333,1446,2542,8,20687,1149,0,2,0,7,0
57742,220,4765,160,89,115,0,13,31,160,7,15,11,17,22,28,78,124,3,495,27,0,2,0,7,0
57743,220,4765,10,10,9,9,0,0,19,0,0,0,0,0,0,0,0,0,0,0,0,2,0,7,0
57744,220,4765,173,84,99,8,29,36,181,5,12,7,13,17,20,54,81,2,221,12,0,2,0,7,0
57745,220,4765,3,1,1,3,0,0,6,0,0,0,0,0,0,0,0,0,0,0,0,2,0,7,0
57747,52,611,647,139,84,35,284,233,682,0,0,0,0,0,0,0,0,0,0,0,0,2,0,28,0
57748,31,1865,384,251,317,7,8,52,391,11,70,44,84,81,128,467,811,6,5355,297,0,2,0,42,0
57785,220,4770,2,2,2,0,0,0,2,0,0,0,0,0,0,0,0,0,0,0,0,2,2,2,0
57799,220,4770,99,48,90,1,3,5,100,0,0,0,0,0,0,0,0,0,0,0,0,2,2,2,0
57800,220,4770,8,5,5,2,0,1,10,0,0,0,0,0,0,0,0,0,0,0,0,2,2,2,0
57801,220,4770,1217,716,841,84,126,174,1301,14,185,118,215,199,333,1446,2542,8,20687,1149,0,2,2,2,0
57802,220,4770,160,89,115,0,13,31,160,7,15,11,17,22,28,78,124,3,495,27,0,2,2,2,0
57803,220,4770,10,10,9,9,0,0,19,0,0,0,0,0,0,0,0,0,0,0,0,2,2,2,0
57804,220,4770,173,84,99,8,29,36,181,5,12,7,13,17,20,54,81,2,221,12,0,2,2,2,0
57805,220,4770,3,1,1,3,0,0,6,0,0,0,0,0,0,0,0,0,0,0,0,2,2,2,0
57808,219,4745,2,2,2,0,0,0,2,0,0,0,0,0,0,0,0,0,0,0,0,2,0,7,0
57822,219,4745,99,48,90,1,3,5,100,0,0,0,0,0,0,0,0,0,0,0,0,2,0,7,0
57823,219,4745,8,5,5,2,0,1,10,0,0,0,0,0,0,0,0,0,0,0,0,2,0,7,0
57824,219,4745,1217,716,841,84,126,174,1301,14,185,118,215,199,333,1446,2542,8,20687,1149,0,2,0,7,0
57825,219,4745,160,89,115,0,13,31,160,7,15,11,17,22,28,78,124,3,495,27,0,2,0,7,0
57826,219,4745,10,10,9,9,0,0,19,0,0,0,0,0,0,0,0,0,0,0,0,2,0,7,0
57827,219,4745,173,84,99,8,29,36,181,5,12,7,13,17,20,54,81,2,221,12,0,2,0,7,0
57828,219,4745,3,1,1,3,0,0,6,0,0,0,0,0,0,0,0,0,0,0,0,2,0,7,0
57832,73,1482,207,111,150,11,0,50,218,5,26,19,36,31,55,133,272,3,943,52,0,2,16,5,0
57833,73,1482,410,198,237,31,55,97,441,11,63,38,72,74,110,414,683,6,4293,238,0,2,16,5,0
57834,138,6248,1782,648,1425,9,47,279,1791,8,171,97,189,179,286,1292,2140,4,9462,525,0,2,17,5,0
57835,89,1926,402,202,227,24,74,80,426,12,52,33,61,64,94,339,564,7,3969,220,0,2,7,4,0
57836,100,4333,1020,354,843,12,15,144,1032,8,134,77,144,142,221,970,1580,4,6792,377,0,2,24,8,0
57837,89,1938,402,202,227,24,74,80,426,12,52,33,61,64,94,339,564,7,3969,220,0,2,2,0,0
57838,139,6303,1782,648,1425,9,47,279,1791,8,171,97,189,179,286,1292,2140,4,9462,525,0,2,12,0,0
57839,73,1512,207,111,150,11,0,50,218,5,26,19,36,31,55,133,272,3,943,52,0,2,3,0,0
57840,73,1512,410,198,237,31,55,97,441,11,63,38,72,74,110,414,683,6,4293,238,0,2,3,0,0
57841,139,6326,1782,648,1425,9,47,279,1791,8,171,97,189,179,286,1292,2140,4,9462,525,0,2,3,1,0
57865,73,1512,207,111,150,11,0,50,218,5,26,19,36,31,55,133,272,3,943,52,0,2,19,5,0
57866,73,1512,410,198,237,31,55,97,441,11,63,38,72,74,110,414,683,6,4293,238,0,2,19,5,0
57867,89,1938,402,202,227,24,74,80,426,12,52,33,61,64,94,339,564,7,3969,220,0,2,9,4,0
57868,139,6326,1782,648,1425,9,47,279,1791,8,171,97,189,179,286,1292,2140,4,9462,525,0,2,31,5,0
57870,53,1120,447,308,343,6,5,95,453,7,96,59,111,103,170,651,1136,4,4600,255,0,2,5,1,1
57871,53,1120,322,174,179,16,74,51,338,10,41,26,46,51,72,252,408,5,2291,127,0,2,5,1,1
57872,19,699,442,244,305,14,16,103,456,11,68,45,75,79,120,452,756,6,4588,254,0,2,4,2,1
57873,19,699,182,102,99,11,40,35,193,3,11,6,11,14,17,42,64,1,97,5,0,2,4,2,1
57874,35,1433,442,244,305,14,16,103,456,11,68,45,75,79,120,452,756,6,4588,254,0,2,30,3,1
57875,155,3263,1513,682,1277,25,13,200,1538,11,199,116,219,210,335,1557,2584,6,15641,868,0,2,3,3,0
57876,155,3263,819,519,539,24,98,155,843,15,96,57,106,111,163,690,1107,8,9171,509,0,2,3,3,0
57877,19,702,442,244,305,14,16,103,456,11,68,45,75,79,120,452,756,6,4588,254,0,2,3,1,0
57878,19,702,182,102,99,11,40,35,193,3,11,6,11,14,17,42,64,1,97,5,0,2,3,1,0
57879,19,709,442,244,305,14,16,103,456,11,68,45,75,79,120,452,756,6,4588,254,0,2,6,2,0
57880,19,709,182,102,99,11,40,35,193,3,11,6,11,14,17,42,64,1,97,5,0,2,6,2,0
57881,19,709,442,244,305,14,16,103,456,11,68,45,75,79,120,452,756,6,4588,254,0,2,2,2,0
57882,19,709,182,102,99,11,40,35,193,3,11,6,11,14,17,42,64,1,97,5,0,2,2,2,0
57885,17,378,85,59,61,8,0,16,93,5,18,10,18,23,28,86,126,2,316,17,0,2,2,2,0
57886,99,4109,1289,550,1043,56,32,155,1345,10,167,93,185,177,278,1266,2075,5,11498,638,0,2,3,3,0
57887,180,8032,139,89,101,2,0,35,141,7,54,34,62,61,96,330,569,4,2287,127,0,2,11,11,0
57888,180,8032,7,5,5,0,0,2,7,1,2,1,2,3,3,2,4,0,2,0,0,2,11,11,0
57889,33,1004,465,148,393,5,8,60,470,4,31,20,31,35,51,161,261,2,523,29,0,2,1,1,0
57890,33,1004,16,12,9,0,0,6,16,1,2,1,2,3,3,2,4,0,2,0,0,2,1,1,0
57891,28,800,256,139,192,9,7,47,265,4,23,12,24,27,36,112,171,2,357,19,0,2,1,1,0
57892,123,5258,1513,682,1277,25,13,200,1538,11,199,116,219,210,335,1557,2584,6,15641,868,0,2,26,26,0
57893,96,4695,1523,757,1297,19,12,193,1542,12,193,117,230,205,347,1508,2664,7,19053,1058,0,2,2,2,0
57894,97,4242,1020,354,843,12,15,144,1032,8,134,77,144,142,221,970,1580,4,6792,377,0,2,1,1,0
57895,21,670,424,94,331,4,0,89,428,1,5,5,5,6,10,11,25,0,12,0,0,2,10,10,0
57896,14,546,295,56,236,0,4,54,295,2,9,5,10,11,15,30,51,1,57,3,0,2,4,4,0
57897,99,5096,1943,715,1694,26,18,214,1969,12,185,120,237,197,357,1436,2721,7,20915,1161,0,2,9,9,0
57898,51,1917,1098,241,925,5,10,155,1103,7,46,25,49,53,74,273,423,3,1580,87,0,2,6,6,0
57899,228,4926,1943,715,1694,26,18,214,1969,12,185,120,237,197,357,1436,2721,7,20915,1161,0,2,2,3,0
57900,228,4926,1168,838,957,57,25,144,1225,19,348,224,416,367,640,3018,5452,11,61921,3440,1,2,2,3,0
57903,35,1441,442,244,305,14,16,103,456,11,68,45,75,79,120,452,756,6,4588,254,0,2,1,1,0
57904,180,5417,1660,832,1314,41,38,274,1701,20,312,209,395,332,604,2671,5058,12,64042,3557,1,2,1,0,0
57905,180,5417,1057,646,719,113,100,145,1170,18,215,134,248,233,382,1740,3004,10,31186,1732,1,2,1,0,0
57906,78,1787,996,429,845,24,10,117,1020,7,76,50,88,83,138,494,879,4,3565,198,0,2,3,1,0
57907,78,1787,456,277,329,12,42,72,468,13,85,50,97,98,147,592,972,7,7212,400,0,2,3,1,0
57910,220,4774,2,2,2,0,0,0,2,0,0,0,0,0,0,0,0,0,0,0,0,2,1,1,0
57924,220,4774,99,48,90,1,3,5,100,0,0,0,0,0,0,0,0,0,0,0,0,2,1,1,0
57925,220,4774,8,5,5,2,0,1,10,0,0,0,0,0,0,0,0,0,0,0,0,2,1,1,0
57926,220,4774,1217,716,841,84,126,174,1301,14,185,118,215,199,333,1446,2542,8,20687,1149,0,2,1,1,0
57927,220,4774,160,89,115,0,13,31,160,7,15,11,17,22,28,78,124,3,495,27,0,2,1,1,0
57928,220,4774,10,10,9,9,0,0,19,0,0,0,0,0,0,0,0,0,0,0,0,2,1,1,0
57929,220,4774,173,84,99,8,29,36,181,5,12,7,13,17,20,54,81,2,221,12,0,2,1,1,0
57930,220,4774,3,1,1,3,0,0,6,0,0,0,0,0,0,0,0,0,0,0,0,2,1,1,0
57931,51,766,167,116,138,4,5,22,171,8,48,30,56,56,86,292,499,4,2330,129,0,2,4,1,0
57932,30,662,215,129,180,6,0,29,221,8,65,43,72,73,115,415,711,4,3153,175,0,2,1,1,0
57933,30,662,97,69,77,3,3,16,100,6,22,13,23,28,36,113,173,3,542,30,0,2,1,1,0
57934,29,745,601,196,481,2,23,85,603,8,63,36,72,71,108,400,664,4,3036,168,0,2,3,2,0
57935,29,745,156,79,106,5,16,28,161,5,14,8,15,19,23,64,97,2,261,14,0,2,3,2,0
57936,45,1575,601,196,481,2,23,85,603,8,63,36,72,71,108,400,664,4,3036,168,0,2,1,1,0
57937,53,1120,447,308,343,6,5,95,453,7,96,59,111,103,170,651,1136,4,4600,255,0,2,5,1,0
57938,53,1120,322,174,179,16,74,51,338,10,41,26,46,51,72,252,408,5,2291,127,0,2,5,1,0
57939,19,709,442,244,305,14,16,103,456,11,68,45,75,79,120,452,756,6,4588,254,0,2,10,2,0
57940,19,709,182,102,99,11,40,35,193,3,11,6,11,14,17,42,64,1,97,5,0,2,10,2,0
57941,35,1441,442,244,305,14,16,103,456,11,68,45,75,79,120,452,756,6,4588,254,0,2,30,3,0
57956,224,4878,182,127,129,0,0,53,182,5,39,21,42,44,63,217,343,2,926,51,0,2,11,4,0
57957,224,4878,1165,710,800,67,119,181,1232,18,243,153,282,261,435,2000,3492,10,36473,2026,1,2,11,4,0
57958,29,843,256,139,192,9,7,47,265,4,23,12,24,27,36,112,171,2,357,19,0,2,12,0,0
57992,231,4983,182,127,129,0,0,53,182,5,39,21,42,44,63,217,343,2,926,51,0,2,69,22,1
57993,231,4983,1165,710,800,67,119,181,1232,18,243,153,282,261,435,2000,3492,10,36473,2026,1,2,69,22,1
57994,89,1780,477,336,357,30,23,73,507,16,194,134,250,210,384,1538,2962,10,30538,1696,0,2,1,1,1
57995,150,3478,77,34,69,0,0,8,77,3,24,16,29,27,45,114,213,1,387,21,0,2,2,2,1
57996,150,3478,712,438,573,51,9,84,763,14,102,71,128,116,199,733,1364,8,11988,666,0,2,2,2,1
57997,308,6881,72,33,56,0,4,12,72,1,1,1,1,2,2,0,2,0,1,0,0,2,2,2,1
57998,308,6881,1454,835,1044,76,110,219,1530,17,275,158,296,292,454,2297,3718,9,34017,1889,1,2,2,2,1
57999,91,1839,757,253,292,73,244,162,830,13,61,38,67,74,105,409,651,7,4654,258,0,2,3,3,1
58000,92,1977,1043,504,840,53,9,147,1096,9,180,112,198,189,310,1377,2344,4,11604,644,0,2,2,2,1
58001,92,1977,383,288,292,26,6,62,409,11,65,38,67,76,105,429,656,5,3719,206,0,2,2,2,1
58002,62,1263,1098,241,925,5,10,155,1103,7,46,25,49,53,74,273,423,3,1580,87,0,2,5,1,1
58003,62,1263,282,202,222,14,2,44,296,8,42,24,43,50,67,250,378,4,1548,86,0,2,5,1,1
58004,35,1087,182,127,129,0,0,53,182,5,39,21,42,44,63,217,343,2,926,51,0,2,2,2,1
58005,153,7207,1392,870,1177,35,17,170,1427,14,494,280,531,508,811,4473,7289,7,54850,3047,2,2,17,11,1
58006,16,1247,215,129,180,6,0,29,221,8,65,43,72,73,115,415,711,4,3153,175,0,2,1,1,1
58007,84,3302,1043,504,840,53,9,147,1096,9,180,112,198,189,310,1377,2344,4,11604,644,0,2,8,12,1
58008,231,4983,182,127,129,0,0,53,182,5,39,21,42,44,63,217,343,2,926,51,0,2,5,6,0
58009,231,4983,1165,710,800,67,119,181,1232,18,243,153,282,261,435,2000,3492,10,36473,2026,1,2,5,6,0
58010,29,850,256,139,192,9,7,47,265,4,23,12,24,27,36,112,171,2,357,19,0,2,7,2,0
58011,60,1163,282,196,195,3,0,86,285,8,130,71,141,138,212,936,1507,4,6538,363,0,2,24,0,0
58013,108,2057,477,336,357,30,23,73,507,16,194,134,250,210,384,1538,2962,10,30538,1696,0,2,41,0,0
58018,120,4779,1450,624,1228,12,26,181,1462,14,306,186,354,320,540,2580,4493,8,36391,2021,1,2,110,0,0
58019,46,3395,996,429,845,24,10,117,1020,7,76,50,88,83,138,494,879,4,3565,198,0,2,3,2,0
58020,81,1825,996,429,845,24,10,117,1020,7,76,50,88,83,138,494,879,4,3565,198,0,2,9,2,0
58021,81,1825,456,277,329,12,42,72,468,13,85,50,97,98,147,592,972,7,7212,400,0,2,9,2,0
58022,46,3395,996,429,845,24,10,117,1020,7,76,50,88,83,138,494,879,4,3565,198,0,2,26,2,0
58025,29,850,256,139,192,9,7,47,265,4,23,12,24,27,36,112,171,2,357,19,0,2,17,0,0
58026,231,4983,182,127,129,0,0,53,182,5,39,21,42,44,63,217,343,2,926,51,0,2,68,22,0
58027,231,4983,1165,710,800,67,119,181,1232,18,243,153,282,261,435,2000,3492,10,36473,2026,1,2,68,22,0
58028,108,2059,477,336,357,30,23,73,507,16,194,134,250,210,384,1538,2962,10,30538,1696,0,2,1,1,0
58029,150,3478,77,34,69,0,0,8,77,3,24,16,29,27,45,114,213,1,387,21,0,2,2,2,0
58030,150,3478,712,438,573,51,9,84,763,14,102,71,128,116,199,733,1364,8,11988,666,0,2,2,2,0
58031,308,6881,72,33,56,0,4,12,72,1,1,1,1,2,2,0,2,0,1,0,0,2,2,2,0
58032,308,6881,1454,835,1044,76,110,219,1530,17,275,158,296,292,454,2297,3718,9,34017,1889,1,2,2,2,0
58033,91,1839,757,253,292,73,244,162,830,13,61,38,67,74,105,409,651,7,4654,258,0,2,3,3,0
58034,92,1977,1043,504,840,53,9,147,1096,9,180,112,198,189,310,1377,2344,4,11604,644,0,2,2,2,0
58035,92,1977,383,288,292,26,6,62,409,11,65,38,67,76,105,429,656,5,3719,206,0,2,2,2,0
58036,62,1263,1098,241,925,5,10,155,1103,7,46,25,49,53,74,273,423,3,1580,87,0,2,5,1,0
58037,62,1263,282,202,222,14,2,44,296,8,42,24,43,50,67,250,378,4,1548,86,0,2,5,1,0
58038,35,1087,182,127,129,0,0,53,182,5,39,21,42,44,63,217,343,2,926,51,0,2,2,2,0
58039,153,7207,1392,870,1177,35,17,170,1427,14,494,280,531,508,811,4473,7289,7,54850,3047,2,2,17,11,0
58040,16,1247,215,129,180,6,0,29,221,8,65,43,72,73,115,415,711,4,3153,175,0,2,1,1,0
58041,84,3302,1043,504,840,53,9,147,1096,9,180,112,198,189,310,1377,2344,4,11604,644,0,2,8,12,0
58042,230,4971,1943,715,1694,26,18,214,1969,12,185,120,237,197,357,1436,2721,7,20915,1161,0,2,13,3,0
58043,230,4971,1168,838,957,57,25,144,1225,19,348,224,416,367,640,3018,5452,11,61921,3440,1,2,13,3,0
58044,99,5127,1943,715,1694,26,18,214,1969,12,185,120,237,197,357,1436,2721,7,20915,1161,0,2,18,2,0
58048,231,4976,1943,715,1694,26,18,214,1969,12,185,120,237,197,357,1436,2721,7,20915,1161,0,2,2,0,0
58049,231,4976,1168,838,957,57,25,144,1225,19,348,224,416,367,640,3018,5452,11,61921,3440,1,2,2,0,0
58050,100,5223,1943,715,1694,26,18,214,1969,12,185,120,237,197,357,1436,2721,7,20915,1161,0,2,28,1,0
58051,91,1839,757,253,292,73,244,162,830,13,61,38,67,74,105,409,651,7,4654,258,0,2,1,1,0
58052,30,878,256,139,192,9,7,47,265,4,23,12,24,27,36,112,171,2,357,19,0,2,4,0,0
58059,81,1825,996,429,845,24,10,117,1020,7,76,50,88,83,138,494,879,4,3565,198,0,2,12,3,0
58060,81,1825,456,277,329,12,42,72,468,13,85,50,97,98,147,592,972,7,7212,400,0,2,12,3,0
58063,219,4747,2,2,2,0,0,0,2,0,0,0,0,0,0,0,0,0,0,0,0,2,3,3,0
58077,219,4747,99,48,90,1,3,5,100,0,0,0,0,0,0,0,0,0,0,0,0,2,3,3,0
58078,219,4747,8,5,5,2,0,1,10,0,0,0,0,0,0,0,0,0,0,0,0,2,3,3,0
58079,219,4747,1217,716,841,84,126,174,1301,14,185,118,215,199,333,1446,2542,8,20687,1149,0,2,3,3,0
58080,219,4747,160,89,115,0,13,31,160,7,15,11,17,22,28,78,124,3,495,27,0,2,3,3,0
58081,219,4747,10,10,9,9,0,0,19,0,0,0,0,0,0,0,0,0,0,0,0,2,3,3,0
58082,219,4747,173,84,99,8,29,36,181,5,12,7,13,17,20,54,81,2,221,12,0,2,3,3,0
58083,219,4747,3,1,1,3,0,0,6,0,0,0,0,0,0,0,0,0,0,0,0,2,3,3,0
58084,55,792,167,116,138,4,5,22,171,8,48,30,56,56,86,292,499,4,2330,129,0,2,4,1,0
58089,231,4976,1943,715,1694,26,18,214,1969,12,185,120,237,197,357,1436,2721,7,20915,1161,0,2,17,6,0
58090,231,4976,1168,838,957,57,25,144,1225,19,348,224,416,367,640,3018,5452,11,61921,3440,1,2,17,6,0
58100,29,850,256,139,192,9,7,47,265,4,23,12,24,27,36,112,171,2,357,19,0,2,18,1,0
58104,100,4333,1020,354,843,12,15,144,1032,8,134,77,144,142,221,970,1580,4,6792,377,0,2,1,1,0
58107,100,5223,1943,715,1694,26,18,214,1969,12,185,120,237,197,357,1436,2721,7,20915,1161,0,2,54,11,0
58113,1,321,382,65,130,157,2,92,539,4,10,5,10,14,15,41,57,2,114,6,0,2,1,0,0
58114,180,8032,139,89,101,2,0,35,141,7,54,34,62,61,96,330,569,4,2287,127,0,2,3,10,0
58115,180,8032,7,5,5,0,0,2,7,1,2,1,2,3,3,2,4,0,2,0,0,2,3,10,0
58118,91,1842,757,253,292,73,244,162,830,13,61,38,67,74,105,409,651,7,4654,258,0,2,1,1,0
58164,180,8032,139,89,101,2,0,35,141,7,54,34,62,61,96,330,569,4,2287,127,0,2,14,21,0
58165,180,8032,7,5,5,0,0,2,7,1,2,1,2,3,3,2,4,0,2,0,0,2,14,21,0
58168,30,878,256,139,192,9,7,47,265,4,23,12,24,27,36,112,171,2,357,19,0,2,22,1,0
58179,87,1961,53,23,39,0,0,13,53,2,8,4,8,10,12,26,39,1,39,2,0,2,1,1,1
58180,87,1961,515,298,307,33,80,99,548,12,63,44,77,75,121,419,753,7,5527,307,0,2,1,1,1
58181,105,4860,1338,495,1086,10,64,173,1348,11,122,82,157,133,239,883,1686,7,11934,663,0,2,13,5,1
58182,139,6326,1782,648,1425,9,47,279,1791,8,171,97,189,179,286,1292,2140,4,9462,525,0,2,3,3,1
58183,80,4548,1296,573,1062,40,33,157,1336,8,201,118,231,209,349,1561,2689,4,12365,686,0,2,20,20,1
58184,100,5223,1943,715,1694,26,18,214,1969,12,185,120,237,197,357,1436,2721,7,20915,1161,0,2,5,6,1
58187,105,4860,1338,495,1086,10,64,173,1348,11,122,82,157,133,239,883,1686,7,11934,663,0,2,13,5,0
58188,139,6326,1782,648,1425,9,47,279,1791,8,171,97,189,179,286,1292,2140,4,9462,525,0,2,3,3,0
58189,80,4548,1296,573,1062,40,33,157,1336,8,201,118,231,209,349,1561,2689,4,12365,686,0,2,20,20,0
58190,100,5223,1943,715,1694,26,18,214,1969,12,185,120,237,197,357,1436,2721,7,20915,1161,0,2,5,6,0
58193,60,1167,282,196,195,3,0,86,285,8,130,71,141,138,212,936,1507,4,6538,363,0,2,3,3,1
58195,91,1864,757,253,292,73,244,162,830,13,61,38,67,74,105,409,651,7,4654,258,0,2,7,10,1
58196,45,935,386,256,301,16,9,68,402,4,59,35,69,63,104,355,621,2,1453,80,0,2,2,0,1
58197,45,935,264,131,164,11,41,46,275,6,38,22,40,44,62,214,338,3,1068,59,0,2,2,0,1
58198,35,1093,182,127,129,0,0,53,182,5,39,21,42,44,63,217,343,2,926,51,0,2,1,1,1
58199,153,7221,1392,870,1177,35,17,170,1427,14,494,280,531,508,811,4473,7289,7,54850,3047,2,2,4,2,1
58200,92,2899,773,419,590,28,0,166,801,10,204,113,217,214,330,1598,2554,5,13587,754,0,2,9,16,1
58201,1,24,127,75,83,2,11,30,129,4,14,7,14,18,21,61,87,2,175,9,0,2,1,1,1
58202,1,24,652,304,544,16,6,88,668,6,89,51,101,95,152,591,998,3,3399,188,0,2,1,1,1
58203,1,24,2,2,2,0,0,0,2,0,0,0,0,0,0,0,0,0,0,0,0,2,1,1,1
58204,1,24,8,5,5,0,0,3,8,0,0,0,0,0,0,0,0,0,0,0,0,2,1,1,1
58207,1,24,14,8,8,0,0,6,14,0,0,0,0,0,0,0,0,0,0,0,0,2,1,1,1
58208,1,24,6,4,4,0,0,2,6,0,0,0,0,0,0,0,0,0,0,0,0,2,1,1,1
58209,1,24,6,4,4,0,0,2,6,1,2,1,2,3,3,2,4,0,2,0,0,2,1,1,1
58211,1,24,7,5,5,0,0,2,7,0,0,0,0,0,0,0,0,0,0,0,0,2,1,1,1
58213,1,24,10,6,6,0,0,4,10,0,0,0,0,0,0,0,0,0,0,0,0,2,1,1,1
58214,1,24,1,1,1,0,0,0,1,0,0,0,0,0,0,0,0,0,0,0,0,2,1,1,1
58216,1,24,14,10,10,0,0,4,14,1,1,1,1,2,2,0,2,0,1,0,0,2,1,1,1
58217,1,24,46,26,30,3,0,12,49,3,6,3,6,9,9,20,28,1,42,2,0,2,1,1,1
58218,105,4868,1338,495,1086,10,64,173,1348,11,122,82,157,133,239,883,1686,7,11934,663,0,2,3,2,1
58219,180,8038,139,89,101,2,0,35,141,7,54,34,62,61,96,330,569,4,2287,127,0,2,2,1,1
58220,180,8038,7,5,5,0,0,2,7,1,2,1,2,3,3,2,4,0,2,0,0,2,2,1,1
58221,139,6352,1782,648,1425,9,47,279,1791,8,171,97,189,179,286,1292,2140,4,9462,525,0,2,4,4,1
58222,30,938,256,139,192,9,7,47,265,4,23,12,24,27,36,112,171,2,357,19,0,2,12,5,1
58223,123,5266,1513,682,1277,25,13,200,1538,11,199,116,219,210,335,1557,2584,6,15641,868,0,2,5,5,1
58224,92,4741,1457,730,1242,11,6,188,1468,10,292,166,329,302,495,2424,4078,5,22973,1276,1,2,4,3,1
58225,42,1932,447,308,343,6,5,95,453,7,96,59,111,103,170,651,1136,4,4600,255,0,2,4,4,1
58226,38,2315,334,251,279,10,4,40,344,5,127,74,143,132,217,899,1528,2,4303,239,0,2,1,5,1
58227,31,1885,384,251,317,7,8,52,391,11,70,44,84,81,128,467,811,6,5355,297,0,2,5,5,1
58228,47,2254,722,423,573,19,0,135,741,12,172,101,199,184,300,1320,2257,6,15668,870,0,2,2,2,1
58229,45,1961,386,256,301,16,9,68,402,4,59,35,69,63,104,355,621,2,1453,80,0,2,13,4,1
58230,84,3328,1043,504,840,53,9,147,1096,9,180,112,198,189,310,1377,2344,4,11604,644,0,2,5,12,1
58231,30,1267,373,158,315,8,0,51,381,5,76,44,79,81,123,486,779,2,2026,112,0,2,2,6,1
58232,100,5228,1943,715,1694,26,18,214,1969,12,185,120,237,197,357,1436,2721,7,20915,1161,0,2,2,1,1
58233,60,1167,282,196,195,3,0,86,285,8,130,71,141,138,212,936,1507,4,6538,363,0,2,3,3,0
58235,91,1864,757,253,292,73,244,162,830,13,61,38,67,74,105,409,651,7,4654,258,0,2,7,10,0
58236,45,935,386,256,301,16,9,68,402,4,59,35,69,63,104,355,621,2,1453,80,0,2,2,0,0
58237,45,935,264,131,164,11,41,46,275,6,38,22,40,44,62,214,338,3,1068,59,0,2,2,0,0
58238,35,1093,182,127,129,0,0,53,182,5,39,21,42,44,63,217,343,2,926,51,0,2,1,1,0
58239,153,7221,1392,870,1177,35,17,170,1427,14,494,280,531,508,811,4473,7289,7,54850,3047,2,2,4,2,0
58240,92,2899,773,419,590,28,0,166,801,10,204,113,217,214,330,1598,2554,5,13587,754,0,2,9,16,0
58241,1,24,127,75,83,2,11,30,129,4,14,7,14,18,21,61,87,2,175,9,0,2,1,1,0
58242,1,24,652,304,544,16,6,88,668,6,89,51,101,95,152,591,998,3,3399,188,0,2,1,1,0
58243,1,24,2,2,2,0,0,0,2,0,0,0,0,0,0,0,0,0,0,0,0,2,1,1,0
58244,1,24,8,5,5,0,0,3,8,0,0,0,0,0,0,0,0,0,0,0,0,2,1,1,0
58247,1,24,14,8,8,0,0,6,14,0,0,0,0,0,0,0,0,0,0,0,0,2,1,1,0
58248,1,24,6,4,4,0,0,2,6,0,0,0,0,0,0,0,0,0,0,0,0,2,1,1,0
58249,1,24,6,4,4,0,0,2,6,1,2,1,2,3,3,2,4,0,2,0,0,2,1,1,0
58251,1,24,7,5,5,0,0,2,7,0,0,0,0,0,0,0,0,0,0,0,0,2,1,1,0
58253,1,24,10,6,6,0,0,4,10,0,0,0,0,0,0,0,0,0,0,0,0,2,1,1,0
58254,1,24,1,1,1,0,0,0,1,0,0,0,0,0,0,0,0,0,0,0,0,2,1,1,0
58256,1,24,14,10,10,0,0,4,14,1,1,1,1,2,2,0,2,0,1,0,0,2,1,1,0
58257,1,24,46,26,30,3,0,12,49,3,6,3,6,9,9,20,28,1,42,2,0,2,1,1,0
58258,105,4868,1338,495,1086,10,64,173,1348,11,122,82,157,133,239,883,1686,7,11934,663,0,2,3,2,0
58259,180,8038,139,89,101,2,0,35,141,7,54,34,62,61,96,330,569,4,2287,127,0,2,2,1,0
58260,180,8038,7,5,5,0,0,2,7,1,2,1,2,3,3,2,4,0,2,0,0,2,2,1,0
58261,139,6352,1782,648,1425,9,47,279,1791,8,171,97,189,179,286,1292,2140,4,9462,525,0,2,4,4,0
58262,30,938,256,139,192,9,7,47,265,4,23,12,24,27,36,112,171,2,357,19,0,2,12,5,0
58263,123,5266,1513,682,1277,25,13,200,1538,11,199,116,219,210,335,1557,2584,6,15641,868,0,2,5,5,0
58264,92,4741,1457,730,1242,11,6,188,1468,10,292,166,329,302,495,2424,4078,5,22973,1276,1,2,4,3,0
58265,42,1932,447,308,343,6,5,95,453,7,96,59,111,103,170,651,1136,4,4600,255,0,2,4,4,0
58266,38,2315,334,251,279,10,4,40,344,5,127,74,143,132,217,899,1528,2,4303,239,0,2,1,5,0
58267,31,1885,384,251,317,7,8,52,391,11,70,44,84,81,128,467,811,6,5355,297,0,2,5,5,0
58268,47,2254,722,423,573,19,0,135,741,12,172,101,199,184,300,1320,2257,6,15668,870,0,2,2,2,0
58269,45,1961,386,256,301,16,9,68,402,4,59,35,69,63,104,355,621,2,1453,80,0,2,13,4,0
58270,84,3328,1043,504,840,53,9,147,1096,9,180,112,198,189,310,1377,2344,4,11604,644,0,2,5,12,0
58271,30,1267,373,158,315,8,0,51,381,5,76,44,79,81,123,486,779,2,2026,112,0,2,2,6,0
58272,100,5228,1943,715,1694,26,18,214,1969,12,185,120,237,197,357,1436,2721,7,20915,1161,0,2,2,1,0
58273,73,1510,207,111,150,11,0,50,218,5,26,19,36,31,55,133,272,3,943,52,0,2,0,1,1
58274,73,1510,410,198,237,31,55,97,441,11,63,38,72,74,110,414,683,6,4293,238,0,2,0,1,1
58276,258,6040,4293,999,3693,19,54,507,4312,9,155,88,170,164,258,1156,1898,4,9368,520,0,2,0,6,1
58277,258,6040,1482,859,1002,125,135,219,1607,16,219,134,251,235,385,1766,3032,9,27804,1544,1,2,0,6,1
58278,83,1769,53,23,39,0,0,13,53,2,8,4,8,10,12,26,39,1,39,2,0,2,0,35,1
58279,83,1769,515,298,307,33,80,99,548,12,63,44,77,75,121,419,753,7,5527,307,0,2,0,35,1
58280,18,304,424,94,331,4,0,89,428,1,5,5,5,6,10,11,25,0,12,0,0,2,0,12,1
58281,18,304,38,23,23,6,0,8,44,3,11,7,11,14,18,42,68,1,102,5,0,2,0,12,1
58282,300,6660,72,33,56,0,4,12,72,1,1,1,1,2,2,0,2,0,1,0,0,2,9,53,1
58283,300,6660,1454,835,1044,76,110,219,1530,17,275,158,296,292,454,2297,3718,9,34017,1889,1,2,9,53,1
58284,22,1058,75,38,59,1,3,12,76,2,4,2,4,6,6,10,15,1,15,0,0,2,0,71,1
58285,91,4033,1338,495,1086,10,64,173,1348,11,122,82,157,133,239,883,1686,7,11934,663,0,2,0,293,1
58286,179,8008,139,89,101,2,0,35,141,7,54,34,62,61,96,330,569,4,2287,127,0,2,0,18,1
58287,179,8008,7,5,5,0,0,2,7,1,2,1,2,3,3,2,4,0,2,0,0,2,0,18,1
58288,79,4485,1296,573,1062,40,33,157,1336,8,201,118,231,209,349,1561,2689,4,12365,686,0,2,0,14,1
58289,20,626,424,94,331,4,0,89,428,1,5,5,5,6,10,11,25,0,12,0,0,2,0,68,1
58290,65,2991,1293,570,1093,25,15,163,1318,10,195,123,241,205,364,1516,2795,6,17273,959,0,2,0,22,1
58291,12,478,295,56,236,0,4,54,295,2,9,5,10,11,15,30,51,1,57,3,0,2,0,59,1
58292,29,1210,373,158,315,8,0,51,381,5,76,44,79,81,123,486,779,2,2026,112,0,2,0,14,1
58293,102,5247,1943,715,1694,26,18,214,1969,12,185,120,237,197,357,1436,2721,7,20915,1161,0,2,17,7,1
58294,73,1510,207,111,150,11,0,50,218,5,26,19,36,31,55,133,272,3,943,52,0,2,0,1,0
58295,73,1510,410,198,237,31,55,97,441,11,63,38,72,74,110,414,683,6,4293,238,0,2,0,1,0
58297,258,6040,4293,999,3693,19,54,507,4312,9,155,88,170,164,258,1156,1898,4,9368,520,0,2,0,6,0
58298,258,6040,1482,859,1002,125,135,219,1607,16,219,134,251,235,385,1766,3032,9,27804,1544,1,2,0,6,0
58299,83,1769,53,23,39,0,0,13,53,2,8,4,8,10,12,26,39,1,39,2,0,2,0,35,0
58300,83,1769,515,298,307,33,80,99,548,12,63,44,77,75,121,419,753,7,5527,307,0,2,0,35,0
58301,18,304,424,94,331,4,0,89,428,1,5,5,5,6,10,11,25,0,12,0,0,2,0,12,0
58302,18,304,38,23,23,6,0,8,44,3,11,7,11,14,18,42,68,1,102,5,0,2,0,12,0
58303,300,6660,72,33,56,0,4,12,72,1,1,1,1,2,2,0,2,0,1,0,0,2,9,53,0
58304,300,6660,1454,835,1044,76,110,219,1530,17,275,158,296,292,454,2297,3718,9,34017,1889,1,2,9,53,0
58305,22,1058,75,38,59,1,3,12,76,2,4,2,4,6,6,10,15,1,15,0,0,2,0,71,0
58306,91,4033,1338,495,1086,10,64,173,1348,11,122,82,157,133,239,883,1686,7,11934,663,0,2,0,293,0
58307,179,8008,139,89,101,2,0,35,141,7,54,34,62,61,96,330,569,4,2287,127,0,2,0,18,0
58308,179,8008,7,5,5,0,0,2,7,1,2,1,2,3,3,2,4,0,2,0,0,2,0,18,0
58309,79,4485,1296,573,1062,40,33,157,1336,8,201,118,231,209,349,1561,2689,4,12365,686,0,2,0,14,0
58310,20,626,424,94,331,4,0,89,428,1,5,5,5,6,10,11,25,0,12,0,0,2,0,68,0
58311,65,2991,1293,570,1093,25,15,163,1318,10,195,123,241,205,364,1516,2795,6,17273,959,0,2,0,22,0
58312,12,478,295,56,236,0,4,54,295,2,9,5,10,11,15,30,51,1,57,3,0,2,0,59,0
58313,29,1210,373,158,315,8,0,51,381,5,76,44,79,81,123,486,779,2,2026,112,0,2,0,14,0
58314,102,5247,1943,715,1694,26,18,214,1969,12,185,120,237,197,357,1436,2721,7,20915,1161,0,2,17,7,0
58315,18,306,424,94,331,4,0,89,428,1,5,5,5,6,10,11,25,0,12,0,0,2,3,1,0
58316,18,306,38,23,23,6,0,8,44,3,11,7,11,14,18,42,68,1,102,5,0,2,3,1,0
58317,95,2070,1043,504,840,53,9,147,1096,9,180,112,198,189,310,1377,2344,4,11604,644,0,2,38,23,0
58318,95,2070,383,288,292,26,6,62,409,11,65,38,67,76,105,429,656,5,3719,206,0,2,38,23,0
58319,82,3278,1043,504,840,53,9,147,1096,9,180,112,198,189,310,1377,2344,4,11604,644,0,2,2,12,0
58326,60,1167,282,196,195,3,0,86,285,8,130,71,141,138,212,936,1507,4,6538,363,0,2,27,3,0
58333,108,2059,477,336,357,30,23,73,507,16,194,134,250,210,384,1538,2962,10,30538,1696,0,2,42,1,0
58369,83,1769,53,23,39,0,0,13,53,2,8,4,8,10,12,26,39,1,39,2,0,2,1,36,0
58370,83,1769,515,298,307,33,80,99,548,12,63,44,77,75,121,419,753,7,5527,307,0,2,1,36,0
58371,18,306,424,94,331,4,0,89,428,1,5,5,5,6,10,11,25,0,12,0,0,2,3,13,0
58372,18,306,38,23,23,6,0,8,44,3,11,7,11,14,18,42,68,1,102,5,0,2,3,13,0
58373,300,6660,72,33,56,0,4,12,72,1,1,1,1,2,2,0,2,0,1,0,0,2,11,55,0
58374,300,6660,1454,835,1044,76,110,219,1530,17,275,158,296,292,454,2297,3718,9,34017,1889,1,2,11,55,0
58375,91,1864,757,253,292,73,244,162,830,13,61,38,67,74,105,409,651,7,4654,258,0,2,11,14,0
58391,35,1093,182,127,129,0,0,53,182,5,39,21,42,44,63,217,343,2,926,51,0,2,3,3,0
58392,153,7221,1392,870,1177,35,17,170,1427,14,494,280,531,508,811,4473,7289,7,54850,3047,2,2,21,13,0
58416,91,4033,1338,495,1086,10,64,173,1348,11,122,82,157,133,239,883,1686,7,11934,663,0,2,15,299,0
58417,179,8008,139,89,101,2,0,35,141,7,54,34,62,61,96,330,569,4,2287,127,0,2,16,40,0
58418,179,8008,7,5,5,0,0,2,7,1,2,1,2,3,3,2,4,0,2,0,0,2,16,40,0
58421,139,6352,1782,648,1425,9,47,279,1791,8,171,97,189,179,286,1292,2140,4,9462,525,0,2,7,7,0
58422,30,938,256,139,192,9,7,47,265,4,23,12,24,27,36,112,171,2,357,19,0,2,32,4,0
58425,123,5266,1513,682,1277,25,13,200,1538,11,199,116,219,210,335,1557,2584,6,15641,868,0,2,31,31,0
58426,79,4485,1296,573,1062,40,33,157,1336,8,201,118,231,209,349,1561,2689,4,12365,686,0,2,20,34,0
58431,20,626,424,94,331,4,0,89,428,1,5,5,5,6,10,11,25,0,12,0,0,2,6,74,0
58438,82,3278,1043,504,840,53,9,147,1096,9,180,112,198,189,310,1377,2344,4,11604,644,0,2,15,36,0
58440,29,1210,373,158,315,8,0,51,381,5,76,44,79,81,123,486,779,2,2026,112,0,2,2,20,0
58441,102,5247,1943,715,1694,26,18,214,1969,12,185,120,237,197,357,1436,2721,7,20915,1161,0,2,78,25,0
58446,22,1058,75,38,59,1,3,12,76,2,4,2,4,6,6,10,15,1,15,0,0,2,2,2,0
58448,253,5893,4293,999,3693,19,54,507,4312,9,155,88,170,164,258,1156,1898,4,9368,520,0,2,0,37,0
58449,253,5893,1482,859,1002,125,135,219,1607,16,219,134,251,235,385,1766,3032,9,27804,1544,1,2,0,37,0
58450,21,1025,75,38,59,1,3,12,76,2,4,2,4,6,6,10,15,1,15,0,0,2,0,21,0
58451,168,7511,139,89,101,2,0,35,141,7,54,34,62,61,96,330,569,4,2287,127,0,2,2,186,0
58452,168,7511,7,5,5,0,0,2,7,1,2,1,2,3,3,2,4,0,2,0,0,2,2,186,0
58454,253,5889,4293,999,3693,19,54,507,4312,9,155,88,170,164,258,1156,1898,4,9368,520,0,2,1,2,0
58455,253,5889,1482,859,1002,125,135,219,1607,16,219,134,251,235,385,1766,3032,9,27804,1544,1,2,1,2,0
58456,292,6512,72,33,56,0,4,12,72,1,1,1,1,2,2,0,2,0,1,0,0,2,0,42,0
58457,292,6512,1454,835,1044,76,110,219,1530,17,275,158,296,292,454,2297,3718,9,34017,1889,1,2,0,42,0
58458,99,4109,1289,550,1043,56,32,155,1345,10,167,93,185,177,278,1266,2075,5,11498,638,0,2,2,3,0
58459,20,985,75,38,59,1,3,12,76,2,4,2,4,6,6,10,15,1,15,0,0,2,0,17,0
58460,125,5615,1782,648,1425,9,47,279,1791,8,171,97,189,179,286,1292,2140,4,9462,525,0,2,7,157,0
58464,253,5889,4293,999,3693,19,54,507,4312,9,155,88,170,164,258,1156,1898,4,9368,520,0,2,1,39,0
58465,253,5889,1482,859,1002,125,135,219,1607,16,219,134,251,235,385,1766,3032,9,27804,1544,1,2,1,39,0
58469,20,985,75,38,59,1,3,12,76,2,4,2,4,6,6,10,15,1,15,0,0,2,0,38,0
58473,156,3283,1513,682,1277,25,13,200,1538,11,199,116,219,210,335,1557,2584,6,15641,868,0,2,4,1,0
58474,156,3283,819,519,539,24,98,155,843,15,96,57,106,111,163,690,1107,8,9171,509,0,2,4,1,0
58477,123,5258,1513,682,1277,25,13,200,1538,11,199,116,219,210,335,1557,2584,6,15641,868,0,2,11,11,0
58478,124,5321,1513,682,1277,25,13,200,1538,11,199,116,219,210,335,1557,2584,6,15641,868,0,2,29,0,0
58479,124,5323,1513,682,1277,25,13,200,1538,11,199,116,219,210,335,1557,2584,6,15641,868,0,2,7,2,0
58481,154,3591,77,34,69,0,0,8,77,3,24,16,29,27,45,114,213,1,387,21,0,2,19,1,0
58482,154,3591,712,438,573,51,9,84,763,14,102,71,128,116,199,733,1364,8,11988,666,0,2,19,1,0
58483,102,5249,1943,715,1694,26,18,214,1969,12,185,120,237,197,357,1436,2721,7,20915,1161,0,2,2,2,0
58484,124,5323,1513,682,1277,25,13,200,1538,11,199,116,219,210,335,1557,2584,6,15641,868,0,2,45,11,0
58489,82,1853,996,429,845,24,10,117,1020,7,76,50,88,83,138,494,879,4,3565,198,0,2,11,0,0
58490,82,1853,456,277,329,12,42,72,468,13,85,50,97,98,147,592,972,7,7212,400,0,2,11,0,0
58491,47,3455,996,429,845,24,10,117,1020,7,76,50,88,83,138,494,879,4,3565,198,0,2,12,0,0
58492,49,1683,601,196,481,2,23,85,603,8,63,36,72,71,108,400,664,4,3036,168,0,2,35,0,0
58493,51,1739,601,196,481,2,23,85,603,8,63,36,72,71,108,400,664,4,3036,168,0,2,29,6,0
58494,183,5668,1660,832,1314,41,38,274,1701,20,312,209,395,332,604,2671,5058,12,64042,3557,1,2,58,0,0
58495,183,5668,1057,646,719,113,100,145,1170,18,215,134,248,233,382,1740,3004,10,31186,1732,1,2,58,0,0
58496,51,1754,601,196,481,2,23,85,603,8,63,36,72,71,108,400,664,4,3036,168,0,2,11,12,1
58497,183,5584,1660,832,1314,41,38,274,1701,20,312,209,395,332,604,2671,5058,12,64042,3557,1,2,17,23,1
58498,183,5584,1057,646,719,113,100,145,1170,18,215,134,248,233,382,1740,3004,10,31186,1732,1,2,17,23,1
58499,183,5584,1660,832,1314,41,38,274,1701,20,312,209,395,332,604,2671,5058,12,64042,3557,1,2,1,1,0
58500,183,5584,1057,646,719,113,100,145,1170,18,215,134,248,233,382,1740,3004,10,31186,1732,1,2,1,1,0
58501,51,1740,601,196,481,2,23,85,603,8,63,36,72,71,108,400,664,4,3036,168,0,2,4,4,0
58502,183,5583,1660,832,1314,41,38,274,1701,20,312,209,395,332,604,2671,5058,12,64042,3557,1,2,2,3,0
58503,183,5583,1057,646,719,113,100,145,1170,18,215,134,248,233,382,1740,3004,10,31186,1732,1,2,2,3,0
58504,183,5583,1660,832,1314,41,38,274,1701,20,312,209,395,332,604,2671,5058,12,64042,3557,1,2,4,10,1
58505,183,5583,1057,646,719,113,100,145,1170,18,215,134,248,233,382,1740,3004,10,31186,1732,1,2,4,10,1
58506,184,5591,1660,832,1314,41,38,274,1701,20,312,209,395,332,604,2671,5058,12,64042,3557,1,2,6,5,0
58507,184,5591,1057,646,719,113,100,145,1170,18,215,134,248,233,382,1740,3004,10,31186,1732,1,2,6,5,0
58510,51,1747,601,196,481,2,23,85,603,8,63,36,72,71,108,400,664,4,3036,168,0,2,8,5,0
58511,184,5591,1660,832,1314,41,38,274,1701,20,312,209,395,332,604,2671,5058,12,64042,3557,1,2,47,0,0
58512,184,5591,1057,646,719,113,100,145,1170,18,215,134,248,233,382,1740,3004,10,31186,1732,1,2,47,0,0
58513,51,1747,601,196,481,2,23,85,603,8,63,36,72,71,108,400,664,4,3036,168,0,2,60,0,0
58514,110,4163,1450,624,1228,12,26,181,1462,14,306,186,354,320,540,2580,4493,8,36391,2021,1,2,2,1,0
58515,92,4758,1457,730,1242,11,6,188,1468,10,292,166,329,302,495,2424,4078,5,22973,1276,1,2,3,0,0
58516,96,4707,1523,757,1297,19,12,193,1542,12,193,117,230,205,347,1508,2664,7,19053,1058,0,2,2,1,0
58517,100,5271,1943,715,1694,26,18,214,1969,12,185,120,237,197,357,1436,2721,7,20915,1161,0,2,8,4,0
58520,222,4823,2,2,2,0,0,0,2,0,0,0,0,0,0,0,0,0,0,0,0,2,11,2,0
58534,222,4823,99,48,90,1,3,5,100,0,0,0,0,0,0,0,0,0,0,0,0,2,11,2,0
58535,222,4823,8,5,5,2,0,1,10,0,0,0,0,0,0,0,0,0,0,0,0,2,11,2,0
58536,222,4823,1217,716,841,84,126,174,1301,14,185,118,215,199,333,1446,2542,8,20687,1149,0,2,11,2,0
58537,222,4823,160,89,115,0,13,31,160,7,15,11,17,22,28,78,124,3,495,27,0,2,11,2,0
58538,222,4823,10,10,9,9,0,0,19,0,0,0,0,0,0,0,0,0,0,0,0,2,11,2,0
58539,222,4823,173,84,99,8,29,36,181,5,12,7,13,17,20,54,81,2,221,12,0,2,11,2,0
58540,222,4823,3,1,1,3,0,0,6,0,0,0,0,0,0,0,0,0,0,0,0,2,11,2,0
58541,94,4851,1457,730,1242,11,6,188,1468,10,292,166,329,302,495,2424,4078,5,22973,1276,1,2,27,0,0
58566,156,3271,1513,682,1277,25,13,200,1538,11,199,116,219,210,335,1557,2584,6,15641,868,0,2,4,1,0
58567,156,3271,819,519,539,24,98,155,843,15,96,57,106,111,163,690,1107,8,9171,509,0,2,4,1,0
58570,221,4796,2,2,2,0,0,0,2,0,0,0,0,0,0,0,0,0,0,0,0,2,11,2,0
58584,221,4796,99,48,90,1,3,5,100,0,0,0,0,0,0,0,0,0,0,0,0,2,11,2,0
58585,221,4796,8,5,5,2,0,1,10,0,0,0,0,0,0,0,0,0,0,0,0,2,11,2,0
58586,221,4796,1217,716,841,84,126,174,1301,14,185,118,215,199,333,1446,2542,8,20687,1149,0,2,11,2,0
58587,221,4796,160,89,115,0,13,31,160,7,15,11,17,22,28,78,124,3,495,27,0,2,11,2,0
58588,221,4796,10,10,9,9,0,0,19,0,0,0,0,0,0,0,0,0,0,0,0,2,11,2,0
58589,221,4796,173,84,99,8,29,36,181,5,12,7,13,17,20,54,81,2,221,12,0,2,11,2,0
58590,221,4796,3,1,1,3,0,0,6,0,0,0,0,0,0,0,0,0,0,0,0,2,11,2,0
58591,124,5331,1513,682,1277,25,13,200,1538,11,199,116,219,210,335,1557,2584,6,15641,868,0,2,45,11,0
58592,94,4864,1457,730,1242,11,6,188,1468,10,292,166,329,302,495,2424,4078,5,22973,1276,1,2,27,0,0
58593,30,880,256,139,192,9,7,47,265,4,23,12,24,27,36,112,171,2,357,19,0,2,2,1,0
58594,30,940,256,139,192,9,7,47,265,4,23,12,24,27,36,112,171,2,357,19,0,2,2,1,0
58624,154,3597,77,34,69,0,0,8,77,3,24,16,29,27,45,114,213,1,387,21,0,2,1,1,1
58625,154,3597,712,438,573,51,9,84,763,14,102,71,128,116,199,733,1364,8,11988,666,0,2,1,1,1
58626,20,526,205,80,86,16,53,53,221,7,18,10,19,25,29,94,134,3,497,27,0,2,3,3,1
58627,95,2085,1043,504,840,53,9,147,1096,9,180,112,198,189,310,1377,2344,4,11604,644,0,2,5,3,1
58628,95,2085,383,288,292,26,6,62,409,11,65,38,67,76,105,429,656,5,3719,206,0,2,5,3,1
58629,82,3282,1043,504,840,53,9,147,1096,9,180,112,198,189,310,1377,2344,4,11604,644,0,2,1,1,1
58632,223,4836,2,2,2,0,0,0,2,0,0,0,0,0,0,0,0,0,0,0,0,2,15,4,1
58646,223,4836,99,48,90,1,3,5,100,0,0,0,0,0,0,0,0,0,0,0,0,2,15,4,1
58647,223,4836,8,5,5,2,0,1,10,0,0,0,0,0,0,0,0,0,0,0,0,2,15,4,1
58648,223,4836,1217,716,841,84,126,174,1301,14,185,118,215,199,333,1446,2542,8,20687,1149,0,2,15,4,1
58649,223,4836,160,89,115,0,13,31,160,7,15,11,17,22,28,78,124,3,495,27,0,2,15,4,1
58650,223,4836,10,10,9,9,0,0,19,0,0,0,0,0,0,0,0,0,0,0,0,2,15,4,1
58651,223,4836,173,84,99,8,29,36,181,5,12,7,13,17,20,54,81,2,221,12,0,2,15,4,1
58652,223,4836,3,1,1,3,0,0,6,0,0,0,0,0,0,0,0,0,0,0,0,2,15,4,1
58653,31,1922,384,251,317,7,8,52,391,11,70,44,84,81,128,467,811,6,5355,297,0,2,6,0,1
58657,41,1220,339,213,244,17,9,65,356,10,42,26,48,52,74,259,421,5,2410,133,0,2,18,10,0
58658,66,3082,1293,570,1093,25,15,163,1318,10,195,123,241,205,364,1516,2795,6,17273,959,0,2,30,1,0
58659,97,2016,463,295,324,28,62,57,491,12,134,82,154,146,236,989,1696,6,11700,650,0,2,5,2,0
58660,39,2361,334,251,279,10,4,40,344,5,127,74,143,132,217,899,1528,2,4303,239,0,2,6,0,0
58663,223,4836,2,2,2,0,0,0,2,0,0,0,0,0,0,0,0,0,0,0,0,2,15,4,0
58677,223,4836,99,48,90,1,3,5,100,0,0,0,0,0,0,0,0,0,0,0,0,2,15,4,0
58678,223,4836,8,5,5,2,0,1,10,0,0,0,0,0,0,0,0,0,0,0,0,2,15,4,0
58679,223,4836,1217,716,841,84,126,174,1301,14,185,118,215,199,333,1446,2542,8,20687,1149,0,2,15,4,0
58680,223,4836,160,89,115,0,13,31,160,7,15,11,17,22,28,78,124,3,495,27,0,2,15,4,0
58681,223,4836,10,10,9,9,0,0,19,0,0,0,0,0,0,0,0,0,0,0,0,2,15,4,0
58682,223,4836,173,84,99,8,29,36,181,5,12,7,13,17,20,54,81,2,221,12,0,2,15,4,0
58683,223,4836,3,1,1,3,0,0,6,0,0,0,0,0,0,0,0,0,0,0,0,2,15,4,0
58684,31,1922,384,251,317,7,8,52,391,11,70,44,84,81,128,467,811,6,5355,297,0,2,6,0,0
58687,101,2731,1523,757,1297,19,12,193,1542,12,193,117,230,205,347,1508,2664,7,19053,1058,0,2,17,3,0
58688,101,2731,701,378,504,33,58,109,734,13,110,68,126,123,194,794,1346,7,10027,557,0,2,17,3,0
58689,97,4762,1523,757,1297,19,12,193,1542,12,193,117,230,205,347,1508,2664,7,19053,1058,0,2,19,0,0
58690,101,2732,1523,757,1297,19,12,193,1542,12,193,117,230,205,347,1508,2664,7,19053,1058,0,2,8,4,0
58691,101,2732,701,378,504,33,58,109,734,13,110,68,126,123,194,794,1346,7,10027,557,0,2,8,4,0
58692,231,4976,1943,715,1694,26,18,214,1969,12,185,120,237,197,357,1436,2721,7,20915,1161,0,2,1,1,0
58693,231,4976,1168,838,957,57,25,144,1225,19,348,224,416,367,640,3018,5452,11,61921,3440,1,2,1,1,0
58694,77,3228,1178,367,1042,6,15,115,1184,9,94,51,95,103,146,644,976,4,4439,246,0,2,12,1,0
58695,97,4762,1523,757,1297,19,12,193,1542,12,193,117,230,205,347,1508,2664,7,19053,1058,0,2,1,1,0
58696,100,2714,1523,757,1297,19,12,193,1542,12,193,117,230,205,347,1508,2664,7,19053,1058,0,2,11,16,0
58697,100,2714,701,378,504,33,58,109,734,13,110,68,126,123,194,794,1346,7,10027,557,0,2,11,16,0
58698,97,4761,1523,757,1297,19,12,193,1542,12,193,117,230,205,347,1508,2664,7,19053,1058,0,2,1,2,0
58699,97,4761,1523,757,1297,19,12,193,1542,12,193,117,230,205,347,1508,2664,7,19053,1058,0,2,4,4,0
58701,291,6482,72,33,56,0,4,12,72,1,1,1,1,2,2,0,2,0,1,0,0,2,0,4,0
58702,291,6482,1454,835,1044,76,110,219,1530,17,275,158,296,292,454,2297,3718,9,34017,1889,1,2,0,4,0
58703,17,910,75,38,59,1,3,12,76,2,4,2,4,6,6,10,15,1,15,0,0,2,0,20,0
58704,91,4033,1338,495,1086,10,64,173,1348,11,122,82,157,133,239,883,1686,7,11934,663,0,2,1,1,0
58706,94,4881,1457,730,1242,11,6,188,1468,10,292,166,329,302,495,2424,4078,5,22973,1276,1,2,3,0,0
58709,54,1145,447,308,343,6,5,95,453,7,96,59,111,103,170,651,1136,4,4600,255,0,2,7,1,0
58710,54,1145,322,174,179,16,74,51,338,10,41,26,46,51,72,252,408,5,2291,127,0,2,7,1,0
58711,45,2011,447,308,343,6,5,95,453,7,96,59,111,103,170,651,1136,4,4600,255,0,2,27,0,0
58717,54,1145,447,308,343,6,5,95,453,7,96,59,111,103,170,651,1136,4,4600,255,0,2,1,1,0
58718,54,1145,322,174,179,16,74,51,338,10,41,26,46,51,72,252,408,5,2291,127,0,2,1,1,0
58720,31,911,256,139,192,9,7,47,265,4,23,12,24,27,36,112,171,2,357,19,0,2,5,0,0
58722,91,1876,757,253,292,73,244,162,830,13,61,38,67,74,105,409,651,7,4654,258,0,2,39,34,0
58723,18,939,75,38,59,1,3,12,76,2,4,2,4,6,6,10,15,1,15,0,0,2,6,0,0
58724,30,948,256,139,192,9,7,47,265,4,23,12,24,27,36,112,171,2,357,19,0,2,3,2,0
58725,47,2254,722,423,573,19,0,135,741,12,172,101,199,184,300,1320,2257,6,15668,870,0,2,1,1,0
58736,154,3597,77,34,69,0,0,8,77,3,24,16,29,27,45,114,213,1,387,21,0,2,1,1,0
58737,154,3597,712,438,573,51,9,84,763,14,102,71,128,116,199,733,1364,8,11988,666,0,2,1,1,0
58738,20,526,205,80,86,16,53,53,221,7,18,10,19,25,29,94,134,3,497,27,0,2,3,3,0
58739,95,2085,1043,504,840,53,9,147,1096,9,180,112,198,189,310,1377,2344,4,11604,644,0,2,5,3,0
58740,95,2085,383,288,292,26,6,62,409,11,65,38,67,76,105,429,656,5,3719,206,0,2,5,3,0
58741,82,3282,1043,504,840,53,9,147,1096,9,180,112,198,189,310,1377,2344,4,11604,644,0,2,1,1,0
58742,100,2714,1523,757,1297,19,12,193,1542,12,193,117,230,205,347,1508,2664,7,19053,1058,0,2,16,3,0
58743,100,2714,701,378,504,33,58,109,734,13,110,68,126,123,194,794,1346,7,10027,557,0,2,16,3,0
58744,97,4761,1523,757,1297,19,12,193,1542,12,193,117,230,205,347,1508,2664,7,19053,1058,0,2,18,0,0
58747,222,4829,2,2,2,0,0,0,2,0,0,0,0,0,0,0,0,0,0,0,0,2,2,2,0
58761,222,4829,99,48,90,1,3,5,100,0,0,0,0,0,0,0,0,0,0,0,0,2,2,2,0
58762,222,4829,8,5,5,2,0,1,10,0,0,0,0,0,0,0,0,0,0,0,0,2,2,2,0
58763,222,4829,1217,716,841,84,126,174,1301,14,185,118,215,199,333,1446,2542,8,20687,1149,0,2,2,2,0
58764,222,4829,160,89,115,0,13,31,160,7,15,11,17,22,28,78,124,3,495,27,0,2,2,2,0
58765,222,4829,10,10,9,9,0,0,19,0,0,0,0,0,0,0,0,0,0,0,0,2,2,2,0
58766,222,4829,173,84,99,8,29,36,181,5,12,7,13,17,20,54,81,2,221,12,0,2,2,2,0
58767,222,4829,3,1,1,3,0,0,6,0,0,0,0,0,0,0,0,0,0,0,0,2,2,2,0
58769,250,5779,4293,999,3693,19,54,507,4312,9,155,88,170,164,258,1156,1898,4,9368,520,0,2,4,27,0
58770,250,5779,1482,859,1002,125,135,219,1607,16,219,134,251,235,385,1766,3032,9,27804,1544,1,2,4,27,0
58771,17,901,75,38,59,1,3,12,76,2,4,2,4,6,6,10,15,1,15,0,0,2,0,22,0
58772,167,7471,139,89,101,2,0,35,141,7,54,34,62,61,96,330,569,4,2287,127,0,2,0,19,0
58773,167,7471,7,5,5,0,0,2,7,1,2,1,2,3,3,2,4,0,2,0,0,2,0,19,0
58803,184,5593,1660,832,1314,41,38,274,1701,20,312,209,395,332,604,2671,5058,12,64042,3557,1,2,3,3,1
58804,184,5593,1057,646,719,113,100,145,1170,18,215,134,248,233,382,1740,3004,10,31186,1732,1,2,3,3,1
58805,82,1855,996,429,845,24,10,117,1020,7,76,50,88,83,138,494,879,4,3565,198,0,2,3,3,1
58806,82,1855,456,277,329,12,42,72,468,13,85,50,97,98,147,592,972,7,7212,400,0,2,3,3,1
58809,217,4669,2,2,2,0,0,0,2,0,0,0,0,0,0,0,0,0,0,0,0,2,27,55,1
58823,217,4669,99,48,90,1,3,5,100,0,0,0,0,0,0,0,0,0,0,0,0,2,27,55,1
58824,217,4669,8,5,5,2,0,1,10,0,0,0,0,0,0,0,0,0,0,0,0,2,27,55,1
58825,217,4669,1217,716,841,84,126,174,1301,14,185,118,215,199,333,1446,2542,8,20687,1149,0,2,27,55,1
58826,217,4669,160,89,115,0,13,31,160,7,15,11,17,22,28,78,124,3,495,27,0,2,27,55,1
58827,217,4669,10,10,9,9,0,0,19,0,0,0,0,0,0,0,0,0,0,0,0,2,27,55,1
58828,217,4669,173,84,99,8,29,36,181,5,12,7,13,17,20,54,81,2,221,12,0,2,27,55,1
58829,217,4669,3,1,1,3,0,0,6,0,0,0,0,0,0,0,0,0,0,0,0,2,27,55,1
58830,55,796,167,116,138,4,5,22,171,8,48,30,56,56,86,292,499,4,2330,129,0,2,6,6,1
58832,52,621,647,139,84,35,284,233,682,0,0,0,0,0,0,0,0,0,0,0,0,2,3,1,1
58833,76,1637,53,23,39,0,0,13,53,2,8,4,8,10,12,26,39,1,39,2,0,2,5,66,1
58834,76,1637,515,298,307,33,80,99,548,12,63,44,77,75,121,419,753,7,5527,307,0,2,5,66,1
58835,30,664,215,129,180,6,0,29,221,8,65,43,72,73,115,415,711,4,3153,175,0,2,2,2,1
58836,30,664,97,69,77,3,3,16,100,6,22,13,23,28,36,113,173,3,542,30,0,2,2,2,1
58837,230,4915,1943,715,1694,26,18,214,1969,12,185,120,237,197,357,1436,2721,7,20915,1161,0,2,1,11,1
58838,230,4915,1168,838,957,57,25,144,1225,19,348,224,416,367,640,3018,5452,11,61921,3440,1,2,1,11,1
58839,29,743,601,196,481,2,23,85,603,8,63,36,72,71,108,400,664,4,3036,168,0,2,3,3,1
58840,29,743,156,79,106,5,16,28,161,5,14,8,15,19,23,64,97,2,261,14,0,2,3,3,1
58841,99,4118,1289,550,1043,56,32,155,1345,10,167,93,185,177,278,1266,2075,5,11498,638,0,2,1,0,1
58842,18,948,75,38,59,1,3,12,76,2,4,2,4,6,6,10,15,1,15,0,0,2,1,0,1
58843,167,5017,1660,832,1314,41,38,274,1701,20,312,209,395,332,604,2671,5058,12,64042,3557,1,2,3,1,1
58844,90,4699,1457,730,1242,11,6,188,1468,10,292,166,329,302,495,2424,4078,5,22973,1276,1,2,0,61,1
58845,28,1839,384,251,317,7,8,52,391,11,70,44,84,81,128,467,811,6,5355,297,0,2,4,20,1
58846,47,2254,722,423,573,19,0,135,741,12,172,101,199,184,300,1320,2257,6,15668,870,0,2,1,1,1
58847,51,1747,601,196,481,2,23,85,603,8,63,36,72,71,108,400,664,4,3036,168,0,2,2,2,1
58848,100,2715,1523,757,1297,19,12,193,1542,12,193,117,230,205,347,1508,2664,7,19053,1058,0,2,4,2,0
58849,100,2715,701,378,504,33,58,109,734,13,110,68,126,123,194,794,1346,7,10027,557,0,2,4,2,0
58850,97,4761,1523,757,1297,19,12,193,1542,12,193,117,230,205,347,1508,2664,7,19053,1058,0,2,2,2,0
58851,91,1879,757,253,292,73,244,162,830,13,61,38,67,74,105,409,651,7,4654,258,0,2,1,1,0
58852,31,979,256,139,192,9,7,47,265,4,23,12,24,27,36,112,171,2,357,19,0,2,5,0,0
58853,120,4791,1450,624,1228,12,26,181,1462,14,306,186,354,320,540,2580,4493,8,36391,2021,1,2,2,1,0
58854,94,4894,1457,730,1242,11,6,188,1468,10,292,166,329,302,495,2424,4078,5,22973,1276,1,2,3,0,0
58855,97,4773,1523,757,1297,19,12,193,1542,12,193,117,230,205,347,1508,2664,7,19053,1058,0,2,2,1,0
58856,102,5297,1943,715,1694,26,18,214,1969,12,185,120,237,197,357,1436,2721,7,20915,1161,0,2,8,4,0
58858,99,2685,1523,757,1297,19,12,193,1542,12,193,117,230,205,347,1508,2664,7,19053,1058,0,2,0,10,0
58859,99,2685,701,378,504,33,58,109,734,13,110,68,126,123,194,794,1346,7,10027,557,0,2,0,10,0
58862,221,4803,2,2,2,0,0,0,2,0,0,0,0,0,0,0,0,0,0,0,0,2,2,5,1
58876,221,4803,99,48,90,1,3,5,100,0,0,0,0,0,0,0,0,0,0,0,0,2,2,5,1
58877,221,4803,8,5,5,2,0,1,10,0,0,0,0,0,0,0,0,0,0,0,0,2,2,5,1
58878,221,4803,1217,716,841,84,126,174,1301,14,185,118,215,199,333,1446,2542,8,20687,1149,0,2,2,5,1
58879,221,4803,160,89,115,0,13,31,160,7,15,11,17,22,28,78,124,3,495,27,0,2,2,5,1
58880,221,4803,10,10,9,9,0,0,19,0,0,0,0,0,0,0,0,0,0,0,0,2,2,5,1
58881,221,4803,173,84,99,8,29,36,181,5,12,7,13,17,20,54,81,2,221,12,0,2,2,5,1
58882,221,4803,3,1,1,3,0,0,6,0,0,0,0,0,0,0,0,0,0,0,0,2,2,5,1
58884,99,4088,1289,550,1043,56,32,155,1345,10,167,93,185,177,278,1266,2075,5,11498,638,0,2,5,6,1
58885,15,827,75,38,59,1,3,12,76,2,4,2,4,6,6,10,15,1,15,0,0,2,0,19,1
58886,291,6479,72,33,56,0,4,12,72,1,1,1,1,2,2,0,2,0,1,0,0,2,4,7,0
58887,291,6479,1454,835,1044,76,110,219,1530,17,275,158,296,292,454,2297,3718,9,34017,1889,1,2,4,7,0
58888,125,5597,1782,648,1425,9,47,279,1791,8,171,97,189,179,286,1292,2140,4,9462,525,0,2,3,7,0
58897,97,4773,1523,757,1297,19,12,193,1542,12,193,117,230,205,347,1508,2664,7,19053,1058,0,2,2,2,0
58900,221,4803,2,2,2,0,0,0,2,0,0,0,0,0,0,0,0,0,0,0,0,2,2,5,0
58914,221,4803,99,48,90,1,3,5,100,0,0,0,0,0,0,0,0,0,0,0,0,2,2,5,0
58915,221,4803,8,5,5,2,0,1,10,0,0,0,0,0,0,0,0,0,0,0,0,2,2,5,0
58916,221,4803,1217,716,841,84,126,174,1301,14,185,118,215,199,333,1446,2542,8,20687,1149,0,2,2,5,0
58917,221,4803,160,89,115,0,13,31,160,7,15,11,17,22,28,78,124,3,495,27,0,2,2,5,0
58918,221,4803,10,10,9,9,0,0,19,0,0,0,0,0,0,0,0,0,0,0,0,2,2,5,0
58919,221,4803,173,84,99,8,29,36,181,5,12,7,13,17,20,54,81,2,221,12,0,2,2,5,0
58920,221,4803,3,1,1,3,0,0,6,0,0,0,0,0,0,0,0,0,0,0,0,2,2,5,0
58922,99,2686,1523,757,1297,19,12,193,1542,12,193,117,230,205,347,1508,2664,7,19053,1058,0,2,0,10,0
58923,99,2686,701,378,504,33,58,109,734,13,110,68,126,123,194,794,1346,7,10027,557,0,2,0,10,0
58924,99,4088,1289,550,1043,56,32,155,1345,10,167,93,185,177,278,1266,2075,5,11498,638,0,2,5,6,0
58925,15,827,75,38,59,1,3,12,76,2,4,2,4,6,6,10,15,1,15,0,0,2,0,19,0
58931,215,4636,2,2,2,0,0,0,2,0,0,0,0,0,0,0,0,0,0,0,0,2,4,7,0
58945,215,4636,99,48,90,1,3,5,100,0,0,0,0,0,0,0,0,0,0,0,0,2,4,7,0
58946,215,4636,8,5,5,2,0,1,10,0,0,0,0,0,0,0,0,0,0,0,0,2,4,7,0
58947,215,4636,1217,716,841,84,126,174,1301,14,185,118,215,199,333,1446,2542,8,20687,1149,0,2,4,7,0
58948,215,4636,160,89,115,0,13,31,160,7,15,11,17,22,28,78,124,3,495,27,0,2,4,7,0
58949,215,4636,10,10,9,9,0,0,19,0,0,0,0,0,0,0,0,0,0,0,0,2,4,7,0
58950,215,4636,173,84,99,8,29,36,181,5,12,7,13,17,20,54,81,2,221,12,0,2,4,7,0
58951,215,4636,3,1,1,3,0,0,6,0,0,0,0,0,0,0,0,0,0,0,0,2,4,7,0
58955,99,2686,1523,757,1297,19,12,193,1542,12,193,117,230,205,347,1508,2664,7,19053,1058,0,2,4,12,0
58956,99,2686,701,378,504,33,58,109,734,13,110,68,126,123,194,794,1346,7,10027,557,0,2,4,12,0
58960,99,4097,1289,550,1043,56,32,155,1345,10,167,93,185,177,278,1266,2075,5,11498,638,0,2,5,6,0
58961,15,836,75,38,59,1,3,12,76,2,4,2,4,6,6,10,15,1,15,0,0,2,0,41,0
58967,90,4729,1457,730,1242,11,6,188,1468,10,292,166,329,302,495,2424,4078,5,22973,1276,1,2,3,0,0
58968,97,4773,1523,757,1297,19,12,193,1542,12,193,117,230,205,347,1508,2664,7,19053,1058,0,2,4,3,0
58970,73,1518,207,111,150,11,0,50,218,5,26,19,36,31,55,133,272,3,943,52,0,2,2,2,0
58971,73,1518,410,198,237,31,55,97,441,11,63,38,72,74,110,414,683,6,4293,238,0,2,2,2,0
58972,92,1894,757,253,292,73,244,162,830,13,61,38,67,74,105,409,651,7,4654,258,0,2,9,4,0
58973,66,4392,520,294,400,33,13,81,553,10,261,204,367,271,571,2128,4614,7,32445,1802,1,2,11,0,0
58974,184,5593,1660,832,1314,41,38,274,1701,20,312,209,395,332,604,2671,5058,12,64042,3557,1,2,3,3,0
58975,184,5593,1057,646,719,113,100,145,1170,18,215,134,248,233,382,1740,3004,10,31186,1732,1,2,3,3,0
58976,82,1855,996,429,845,24,10,117,1020,7,76,50,88,83,138,494,879,4,3565,198,0,2,3,3,0
58977,82,1855,456,277,329,12,42,72,468,13,85,50,97,98,147,592,972,7,7212,400,0,2,3,3,0
58980,215,4636,2,2,2,0,0,0,2,0,0,0,0,0,0,0,0,0,0,0,0,2,27,55,0
58994,215,4636,99,48,90,1,3,5,100,0,0,0,0,0,0,0,0,0,0,0,0,2,27,55,0
58995,215,4636,8,5,5,2,0,1,10,0,0,0,0,0,0,0,0,0,0,0,0,2,27,55,0
58996,215,4636,1217,716,841,84,126,174,1301,14,185,118,215,199,333,1446,2542,8,20687,1149,0,2,27,55,0
58997,215,4636,160,89,115,0,13,31,160,7,15,11,17,22,28,78,124,3,495,27,0,2,27,55,0
58998,215,4636,10,10,9,9,0,0,19,0,0,0,0,0,0,0,0,0,0,0,0,2,27,55,0
58999,215,4636,173,84,99,8,29,36,181,5,12,7,13,17,20,54,81,2,221,12,0,2,27,55,0
59000,215,4636,3,1,1,3,0,0,6,0,0,0,0,0,0,0,0,0,0,0,0,2,27,55,0
59001,55,796,167,116,138,4,5,22,171,8,48,30,56,56,86,292,499,4,2330,129,0,2,6,6,0
59003,52,621,647,139,84,35,284,233,682,0,0,0,0,0,0,0,0,0,0,0,0,2,3,1,0
59004,76,1637,53,23,39,0,0,13,53,2,8,4,8,10,12,26,39,1,39,2,0,2,5,66,0
59005,76,1637,515,298,307,33,80,99,548,12,63,44,77,75,121,419,753,7,5527,307,0,2,5,66,0
59006,30,664,215,129,180,6,0,29,221,8,65,43,72,73,115,415,711,4,3153,175,0,2,2,2,0
59007,30,664,97,69,77,3,3,16,100,6,22,13,23,28,36,113,173,3,542,30,0,2,2,2,0
59008,230,4915,1943,715,1694,26,18,214,1969,12,185,120,237,197,357,1436,2721,7,20915,1161,0,2,1,11,0
59009,230,4915,1168,838,957,57,25,144,1225,19,348,224,416,367,640,3018,5452,11,61921,3440,1,2,1,11,0
59010,29,743,601,196,481,2,23,85,603,8,63,36,72,71,108,400,664,4,3036,168,0,2,3,3,0
59011,29,743,156,79,106,5,16,28,161,5,14,8,15,19,23,64,97,2,261,14,0,2,3,3,0
59012,99,4097,1289,550,1043,56,32,155,1345,10,167,93,185,177,278,1266,2075,5,11498,638,0,2,1,0,0
59013,15,836,75,38,59,1,3,12,76,2,4,2,4,6,6,10,15,1,15,0,0,2,1,0,0
59014,167,5017,1660,832,1314,41,38,274,1701,20,312,209,395,332,604,2671,5058,12,64042,3557,1,2,3,1,0
59015,90,4729,1457,730,1242,11,6,188,1468,10,292,166,329,302,495,2424,4078,5,22973,1276,1,2,0,61,0
59016,28,1839,384,251,317,7,8,52,391,11,70,44,84,81,128,467,811,6,5355,297,0,2,4,20,0
59018,51,1747,601,196,481,2,23,85,603,8,63,36,72,71,108,400,664,4,3036,168,0,2,2,2,0
59020,246,5700,4293,999,3693,19,54,507,4312,9,155,88,170,164,258,1156,1898,4,9368,520,0,2,8,25,1
59021,246,5700,1482,859,1002,125,135,219,1607,16,219,134,251,235,385,1766,3032,9,27804,1544,1,2,8,25,1
59022,13,806,75,38,59,1,3,12,76,2,4,2,4,6,6,10,15,1,15,0,0,2,0,11,1
59023,169,7506,139,89,101,2,0,35,141,7,54,34,62,61,96,330,569,4,2287,127,0,2,11,0,1
59024,169,7506,7,5,5,0,0,2,7,1,2,1,2,3,3,2,4,0,2,0,0,2,11,0,1
59026,246,5700,4293,999,3693,19,54,507,4312,9,155,88,170,164,258,1156,1898,4,9368,520,0,2,8,25,0
59027,246,5700,1482,859,1002,125,135,219,1607,16,219,134,251,235,385,1766,3032,9,27804,1544,1,2,8,25,0
59028,13,806,75,38,59,1,3,12,76,2,4,2,4,6,6,10,15,1,15,0,0,2,0,11,0
59029,169,7506,139,89,101,2,0,35,141,7,54,34,62,61,96,330,569,4,2287,127,0,2,11,0,0
59030,169,7506,7,5,5,0,0,2,7,1,2,1,2,3,3,2,4,0,2,0,0,2,11,0,0
59031,99,4845,1523,757,1297,19,12,193,1542,12,193,117,230,205,347,1508,2664,7,19053,1058,0,2,24,11,0
59032,55,770,167,116,138,4,5,22,171,8,48,30,56,56,86,292,499,4,2330,129,0,2,8,17,0
59034,13,788,75,38,59,1,3,12,76,2,4,2,4,6,6,10,15,1,15,0,0,2,6,12,0
59037,215,4638,2,2,2,0,0,0,2,0,0,0,0,0,0,0,0,0,0,0,0,2,6,5,0
59051,215,4638,99,48,90,1,3,5,100,0,0,0,0,0,0,0,0,0,0,0,0,2,6,5,0
59052,215,4638,8,5,5,2,0,1,10,0,0,0,0,0,0,0,0,0,0,0,0,2,6,5,0
59053,215,4638,1217,716,841,84,126,174,1301,14,185,118,215,199,333,1446,2542,8,20687,1149,0,2,6,5,0
59054,215,4638,160,89,115,0,13,31,160,7,15,11,17,22,28,78,124,3,495,27,0,2,6,5,0
59055,215,4638,10,10,9,9,0,0,19,0,0,0,0,0,0,0,0,0,0,0,0,2,6,5,0
59056,215,4638,173,84,99,8,29,36,181,5,12,7,13,17,20,54,81,2,221,12,0,2,6,5,0
59057,215,4638,3,1,1,3,0,0,6,0,0,0,0,0,0,0,0,0,0,0,0,2,6,5,0
59059,13,808,75,38,59,1,3,12,76,2,4,2,4,6,6,10,15,1,15,0,0,2,8,14,0
59085,13,808,75,38,59,1,3,12,76,2,4,2,4,6,6,10,15,1,15,0,0,2,14,26,0
59088,84,1876,402,202,227,24,74,80,426,12,52,33,61,64,94,339,564,7,3969,220,0,2,21,33,0
59089,90,3983,1338,495,1086,10,64,173,1348,11,122,82,157,133,239,883,1686,7,11934,663,0,2,17,25,0
59090,125,5588,1782,648,1425,9,47,279,1791,8,171,97,189,179,286,1292,2140,4,9462,525,0,2,11,10,0
59091,98,4153,1020,354,843,12,15,144,1032,8,134,77,144,142,221,970,1580,4,6792,377,0,2,4,33,0
59099,217,4661,2,2,2,0,0,0,2,0,0,0,0,0,0,0,0,0,0,0,0,2,4,1,0
59113,217,4661,99,48,90,1,3,5,100,0,0,0,0,0,0,0,0,0,0,0,0,2,4,1,0
59114,217,4661,8,5,5,2,0,1,10,0,0,0,0,0,0,0,0,0,0,0,0,2,4,1,0
59115,217,4661,1217,716,841,84,126,174,1301,14,185,118,215,199,333,1446,2542,8,20687,1149,0,2,4,1,0
59116,217,4661,160,89,115,0,13,31,160,7,15,11,17,22,28,78,124,3,495,27,0,2,4,1,0
59117,217,4661,10,10,9,9,0,0,19,0,0,0,0,0,0,0,0,0,0,0,0,2,4,1,0
59118,217,4661,173,84,99,8,29,36,181,5,12,7,13,17,20,54,81,2,221,12,0,2,4,1,0
59119,217,4661,3,1,1,3,0,0,6,0,0,0,0,0,0,0,0,0,0,0,0,2,4,1,0
59120,245,5671,4293,999,3693,19,54,507,4312,9,155,88,170,164,258,1156,1898,4,9368,520,0,2,13,12,0
59121,245,5671,1482,859,1002,125,135,219,1607,16,219,134,251,235,385,1766,3032,9,27804,1544,1,2,13,12,0
59124,24,613,2,2,2,0,0,0,2,0,0,0,0,0,0,0,0,0,0,0,0,2,1,10,0
59138,24,613,99,48,90,1,3,5,100,0,0,0,0,0,0,0,0,0,0,0,0,2,1,10,0
59139,24,613,8,5,5,2,0,1,10,0,0,0,0,0,0,0,0,0,0,0,0,2,1,10,0
59140,24,613,1217,716,841,84,126,174,1301,14,185,118,215,199,333,1446,2542,8,20687,1149,0,2,1,10,0
59141,24,613,160,89,115,0,13,31,160,7,15,11,17,22,28,78,124,3,495,27,0,2,1,10,0
59142,24,613,10,10,9,9,0,0,19,0,0,0,0,0,0,0,0,0,0,0,0,2,1,10,0
59143,24,613,173,84,99,8,29,36,181,5,12,7,13,17,20,54,81,2,221,12,0,2,1,10,0
59144,24,613,3,1,1,3,0,0,6,0,0,0,0,0,0,0,0,0,0,0,0,2,1,10,0
59145,69,1497,402,202,227,24,74,80,426,12,52,33,61,64,94,339,564,7,3969,220,0,2,8,93,0
59146,74,1599,53,23,39,0,0,13,53,2,8,4,8,10,12,26,39,1,39,2,0,2,0,15,0
59147,74,1599,515,298,307,33,80,99,548,12,63,44,77,75,121,419,753,7,5527,307,0,2,0,15,0
59148,291,6500,72,33,56,0,4,12,72,1,1,1,1,2,2,0,2,0,1,0,0,2,15,5,0
59149,291,6500,1454,835,1044,76,110,219,1530,17,275,158,296,292,454,2297,3718,9,34017,1889,1,2,15,5,0
59150,62,1233,1098,241,925,5,10,155,1103,7,46,25,49,53,74,273,423,3,1580,87,0,2,0,4,0
59151,62,1233,282,202,222,14,2,44,296,8,42,24,43,50,67,250,378,4,1548,86,0,2,0,4,0
59152,68,3066,1020,354,843,12,15,144,1032,8,134,77,144,142,221,970,1580,4,6792,377,0,2,11,281,0
59155,220,4688,2,2,2,0,0,0,2,0,0,0,0,0,0,0,0,0,0,0,0,2,8,3,0
59169,220,4688,99,48,90,1,3,5,100,0,0,0,0,0,0,0,0,0,0,0,0,2,8,3,0
59170,220,4688,8,5,5,2,0,1,10,0,0,0,0,0,0,0,0,0,0,0,0,2,8,3,0
59171,220,4688,1217,716,841,84,126,174,1301,14,185,118,215,199,333,1446,2542,8,20687,1149,0,2,8,3,0
59172,220,4688,160,89,115,0,13,31,160,7,15,11,17,22,28,78,124,3,495,27,0,2,8,3,0
59173,220,4688,10,10,9,9,0,0,19,0,0,0,0,0,0,0,0,0,0,0,0,2,8,3,0
59174,220,4688,173,84,99,8,29,36,181,5,12,7,13,17,20,54,81,2,221,12,0,2,8,3,0
59175,220,4688,3,1,1,3,0,0,6,0,0,0,0,0,0,0,0,0,0,0,0,2,8,3,0
59178,220,4688,2,2,2,0,0,0,2,0,0,0,0,0,0,0,0,0,0,0,0,2,2,0,0
59192,220,4688,99,48,90,1,3,5,100,0,0,0,0,0,0,0,0,0,0,0,0,2,2,0,0
59193,220,4688,8,5,5,2,0,1,10,0,0,0,0,0,0,0,0,0,0,0,0,2,2,0,0
59194,220,4688,1217,716,841,84,126,174,1301,14,185,118,215,199,333,1446,2542,8,20687,1149,0,2,2,0,0
59195,220,4688,160,89,115,0,13,31,160,7,15,11,17,22,28,78,124,3,495,27,0,2,2,0,0
59196,220,4688,10,10,9,9,0,0,19,0,0,0,0,0,0,0,0,0,0,0,0,2,2,0,0
59197,220,4688,173,84,99,8,29,36,181,5,12,7,13,17,20,54,81,2,221,12,0,2,2,0,0
59198,220,4688,3,1,1,3,0,0,6,0,0,0,0,0,0,0,0,0,0,0,0,2,2,0,0
59199,291,6500,72,33,56,0,4,12,72,1,1,1,1,2,2,0,2,0,1,0,0,2,2,0,0
59200,291,6500,1454,835,1044,76,110,219,1530,17,275,158,296,292,454,2297,3718,9,34017,1889,1,2,2,0,0
59203,220,4688,2,2,2,0,0,0,2,0,0,0,0,0,0,0,0,0,0,0,0,2,14,4,0
59217,220,4688,99,48,90,1,3,5,100,0,0,0,0,0,0,0,0,0,0,0,0,2,14,4,0
59218,220,4688,8,5,5,2,0,1,10,0,0,0,0,0,0,0,0,0,0,0,0,2,14,4,0
59219,220,4688,1217,716,841,84,126,174,1301,14,185,118,215,199,333,1446,2542,8,20687,1149,0,2,14,4,0
59220,220,4688,160,89,115,0,13,31,160,7,15,11,17,22,28,78,124,3,495,27,0,2,14,4,0
59221,220,4688,10,10,9,9,0,0,19,0,0,0,0,0,0,0,0,0,0,0,0,2,14,4,0
59222,220,4688,173,84,99,8,29,36,181,5,12,7,13,17,20,54,81,2,221,12,0,2,14,4,0
59223,220,4688,3,1,1,3,0,0,6,0,0,0,0,0,0,0,0,0,0,0,0,2,14,4,0
59252,291,6500,72,33,56,0,4,12,72,1,1,1,1,2,2,0,2,0,1,0,0,2,17,5,0
59253,291,6500,1454,835,1044,76,110,219,1530,17,275,158,296,292,454,2297,3718,9,34017,1889,1,2,17,5,0
59257,234,4977,1943,715,1694,26,18,214,1969,12,185,120,237,197,357,1436,2721,7,20915,1161,0,2,4,0,0
59258,234,4977,1168,838,957,57,25,144,1225,19,348,224,416,367,640,3018,5452,11,61921,3440,1,2,4,0,0
59259,103,5339,1943,715,1694,26,18,214,1969,12,185,120,237,197,357,1436,2721,7,20915,1161,0,2,12,0,0
59263,1,323,382,65,130,157,2,92,539,4,10,5,10,14,15,41,57,2,114,6,0,2,2,1,0
59264,1,321,382,65,130,157,2,92,539,4,10,5,10,14,15,41,57,2,114,6,0,2,1,1,0
59265,21,538,205,80,86,16,53,53,221,7,18,10,19,25,29,94,134,3,497,27,0,2,4,2,0
59266,83,3323,1043,504,840,53,9,147,1096,9,180,112,198,189,310,1377,2344,4,11604,644,0,2,16,0,1
59267,21,538,205,80,86,16,53,53,221,7,18,10,19,25,29,94,134,3,497,27,0,2,8,3,0
59268,21,538,205,80,86,16,53,53,221,7,18,10,19,25,29,94,134,3,497,27,0,2,12,5,0
59269,83,3323,1043,504,840,53,9,147,1096,9,180,112,198,189,310,1377,2344,4,11604,644,0,2,16,0,0
59273,231,4983,182,127,129,0,0,53,182,5,39,21,42,44,63,217,343,2,926,51,0,2,71,32,0
59274,231,4983,1165,710,800,67,119,181,1232,18,243,153,282,261,435,2000,3492,10,36473,2026,1,2,71,32,0
59275,184,5593,1660,832,1314,41,38,274,1701,20,312,209,395,332,604,2671,5058,12,64042,3557,1,2,50,3,0
59276,184,5593,1057,646,719,113,100,145,1170,18,215,134,248,233,382,1740,3004,10,31186,1732,1,2,50,3,0
59278,82,1855,996,429,845,24,10,117,1020,7,76,50,88,83,138,494,879,4,3565,198,0,2,14,3,0
59279,82,1855,456,277,329,12,42,72,468,13,85,50,97,98,147,592,972,7,7212,400,0,2,14,3,0
59280,156,3271,1513,682,1277,25,13,200,1538,11,199,116,219,210,335,1557,2584,6,15641,868,0,2,3,3,0
59281,156,3271,819,519,539,24,98,155,843,15,96,57,106,111,163,690,1107,8,9171,509,0,2,3,3,0
59282,73,1518,207,111,150,11,0,50,218,5,26,19,36,31,55,133,272,3,943,52,0,2,21,8,0
59283,73,1518,410,198,237,31,55,97,441,11,63,38,72,74,110,414,683,6,4293,238,0,2,21,8,0
59286,220,4688,2,2,2,0,0,0,2,0,0,0,0,0,0,0,0,0,0,0,0,2,67,83,0
59300,220,4688,99,48,90,1,3,5,100,0,0,0,0,0,0,0,0,0,0,0,0,2,67,83,0
59301,220,4688,8,5,5,2,0,1,10,0,0,0,0,0,0,0,0,0,0,0,0,2,67,83,0
59302,220,4688,1217,716,841,84,126,174,1301,14,185,118,215,199,333,1446,2542,8,20687,1149,0,2,67,83,0
59303,220,4688,160,89,115,0,13,31,160,7,15,11,17,22,28,78,124,3,495,27,0,2,67,83,0
59304,220,4688,10,10,9,9,0,0,19,0,0,0,0,0,0,0,0,0,0,0,0,2,67,83,0
59305,220,4688,173,84,99,8,29,36,181,5,12,7,13,17,20,54,81,2,221,12,0,2,67,83,0
59306,220,4688,3,1,1,3,0,0,6,0,0,0,0,0,0,0,0,0,0,0,0,2,67,83,0
59308,55,770,167,116,138,4,5,22,171,8,48,30,56,56,86,292,499,4,2330,129,0,2,24,27,0
59311,245,5671,4293,999,3693,19,54,507,4312,9,155,88,170,164,258,1156,1898,4,9368,520,0,2,26,109,0
59312,245,5671,1482,859,1002,125,135,219,1607,16,219,134,251,235,385,1766,3032,9,27804,1544,1,2,26,109,0
59313,52,621,647,139,84,35,284,233,682,0,0,0,0,0,0,0,0,0,0,0,0,2,2,28,0
59314,99,2686,1523,757,1297,19,12,193,1542,12,193,117,230,205,347,1508,2664,7,19053,1058,0,2,18,13,0
59315,99,2686,701,378,504,33,58,109,734,13,110,68,126,123,194,794,1346,7,10027,557,0,2,18,13,0
59316,154,3597,77,34,69,0,0,8,77,3,24,16,29,27,45,114,213,1,387,21,0,2,22,4,0
59317,154,3597,712,438,573,51,9,84,763,14,102,71,128,116,199,733,1364,8,11988,666,0,2,22,4,0
59341,69,1497,402,202,227,24,74,80,426,12,52,33,61,64,94,339,564,7,3969,220,0,2,38,130,0
59342,74,1599,53,23,39,0,0,13,53,2,8,4,8,10,12,26,39,1,39,2,0,2,6,117,0
59343,74,1599,515,298,307,33,80,99,548,12,63,44,77,75,121,419,753,7,5527,307,0,2,6,117,0
59346,21,538,205,80,86,16,53,53,221,7,18,10,19,25,29,94,134,3,497,27,0,2,15,8,0
59347,291,6500,72,33,56,0,4,12,72,1,1,1,1,2,2,0,2,0,1,0,0,2,32,113,0
59348,291,6500,1454,835,1044,76,110,219,1530,17,275,158,296,292,454,2297,3718,9,34017,1889,1,2,32,113,0
59349,92,1894,757,253,292,73,244,162,830,13,61,38,67,74,105,409,651,7,4654,258,0,2,55,48,0
59354,95,2085,1043,504,840,53,9,147,1096,9,180,112,198,189,310,1377,2344,4,11604,644,0,2,42,25,0
59355,95,2085,383,288,292,26,6,62,409,11,65,38,67,76,105,429,656,5,3719,206,0,2,42,25,0
59356,234,4977,1943,715,1694,26,18,214,1969,12,185,120,237,197,357,1436,2721,7,20915,1161,0,2,6,12,0
59357,234,4977,1168,838,957,57,25,144,1225,19,348,224,416,367,640,3018,5452,11,61921,3440,1,2,6,12,0
59358,62,1233,1098,241,925,5,10,155,1103,7,46,25,49,53,74,273,423,3,1580,87,0,2,5,5,0
59359,62,1233,282,202,222,14,2,44,296,8,42,24,43,50,67,250,378,4,1548,86,0,2,5,5,0
59362,99,4097,1289,550,1043,56,32,155,1345,10,167,93,185,177,278,1266,2075,5,11498,638,0,2,8,9,0
59366,13,808,75,38,59,1,3,12,76,2,4,2,4,6,6,10,15,1,15,0,0,2,23,209,0
59389,90,3983,1338,495,1086,10,64,173,1348,11,122,82,157,133,239,883,1686,7,11934,663,0,2,33,325,0
59390,169,7506,139,89,101,2,0,35,141,7,54,34,62,61,96,330,569,4,2287,127,0,2,15,224,0
59391,169,7506,7,5,5,0,0,2,7,1,2,1,2,3,3,2,4,0,2,0,0,2,15,224,0
59392,125,5588,1782,648,1425,9,47,279,1791,8,171,97,189,179,286,1292,2140,4,9462,525,0,2,52,179,0
59393,31,979,256,139,192,9,7,47,265,4,23,12,24,27,36,112,171,2,357,19,0,2,15,7,0
59394,120,4791,1450,624,1228,12,26,181,1462,14,306,186,354,320,540,2580,4493,8,36391,2021,1,2,110,0,0
59397,124,5331,1513,682,1277,25,13,200,1538,11,199,116,219,210,335,1557,2584,6,15641,868,0,2,5,5,0
59399,90,4729,1457,730,1242,11,6,188,1468,10,292,166,329,302,495,2424,4078,5,22973,1276,1,2,4,64,0
59400,99,4845,1523,757,1297,19,12,193,1542,12,193,117,230,205,347,1508,2664,7,19053,1058,0,2,31,0,0
59401,68,3066,1020,354,843,12,15,144,1032,8,134,77,144,142,221,970,1580,4,6792,377,0,2,37,320,0
59404,39,2361,334,251,279,10,4,40,344,5,127,74,143,132,217,899,1528,2,4303,239,0,2,7,5,0
59405,66,3082,1293,570,1093,25,15,163,1318,10,195,123,241,205,364,1516,2795,6,17273,959,0,2,30,23,0
59406,28,1839,384,251,317,7,8,52,391,11,70,44,84,81,128,467,811,6,5355,297,0,2,15,67,0
59407,47,2254,722,423,573,19,0,135,741,12,172,101,199,184,300,1320,2257,6,15668,870,0,2,4,4,0
59410,83,3323,1043,504,840,53,9,147,1096,9,180,112,198,189,310,1377,2344,4,11604,644,0,2,31,36,0
59414,103,5339,1943,715,1694,26,18,214,1969,12,185,120,237,197,357,1436,2721,7,20915,1161,0,2,38,16,0
59415,51,1747,601,196,481,2,23,85,603,8,63,36,72,71,108,400,664,4,3036,168,0,2,62,2,0
59416,112,2133,477,336,357,30,23,73,507,16,194,134,250,210,384,1538,2962,10,30538,1696,0,2,14,0,1
59417,123,4932,1450,624,1228,12,26,181,1462,14,306,186,354,320,540,2580,4493,8,36391,2021,1,2,24,0,1
59418,52,1777,601,196,481,2,23,85,603,8,63,36,72,71,108,400,664,4,3036,168,0,2,24,0,0
59419,45,940,386,256,301,16,9,68,402,4,59,35,69,63,104,355,621,2,1453,80,0,2,4,0,0
59420,45,940,264,131,164,11,41,46,275,6,38,22,40,44,62,214,338,3,1068,59,0,2,4,0,0
59421,45,940,386,256,301,16,9,68,402,4,59,35,69,63,104,355,621,2,1453,80,0,2,1,1,0
59422,45,940,264,131,164,11,41,46,275,6,38,22,40,44,62,214,338,3,1068,59,0,2,1,1,0
59426,52,1785,601,196,481,2,23,85,603,8,63,36,72,71,108,400,664,4,3036,168,0,2,7,21,0
59428,94,2363,1455,414,1257,16,76,112,1471,5,41,23,46,46,69,231,381,2,1069,59,0,2,55,2,0
59429,94,2363,669,365,481,22,61,110,691,15,103,63,122,118,185,747,1273,8,11311,628,0,2,55,2,0
59430,71,3276,1455,414,1257,16,76,112,1471,5,41,23,46,46,69,231,381,2,1069,59,0,2,19,0,0
59431,314,6855,72,33,56,0,4,12,72,1,1,1,1,2,2,0,2,0,1,0,0,2,142,46,1
59432,314,6855,1454,835,1044,76,110,219,1530,17,275,158,296,292,454,2297,3718,9,34017,1889,1,2,142,46,1
59433,68,1302,1098,241,925,5,10,155,1103,7,46,25,49,53,74,273,423,3,1580,87,0,2,45,19,1
59434,68,1302,282,202,222,14,2,44,296,8,42,24,43,50,67,250,378,4,1548,86,0,2,45,19,1
59435,90,3974,1338,495,1086,10,64,173,1348,11,122,82,157,133,239,883,1686,7,11934,663,0,2,0,3,1
59436,170,7538,139,89,101,2,0,35,141,7,54,34,62,61,96,330,569,4,2287,127,0,2,39,0,1
59437,170,7538,7,5,5,0,0,2,7,1,2,1,2,3,3,2,4,0,2,0,0,2,39,0,1
59442,112,2133,477,336,357,30,23,73,507,16,194,134,250,210,384,1538,2962,10,30538,1696,0,2,14,0,0
59443,123,4932,1450,624,1228,12,26,181,1462,14,306,186,354,320,540,2580,4493,8,36391,2021,1,2,24,0,0
59447,172,5098,1660,832,1314,41,38,274,1701,20,312,209,395,332,604,2671,5058,12,64042,3557,1,2,21,0,0
59448,185,5602,1660,832,1314,41,38,274,1701,20,312,209,395,332,604,2671,5058,12,64042,3557,1,2,7,1,0
59449,185,5602,1057,646,719,113,100,145,1170,18,215,134,248,233,382,1740,3004,10,31186,1732,1,2,7,1,0
59454,231,4977,182,127,129,0,0,53,182,5,39,21,42,44,63,217,343,2,926,51,0,2,0,5,1
59455,231,4977,1165,710,800,67,119,181,1232,18,243,153,282,261,435,2000,3492,10,36473,2026,1,2,0,5,1
59456,182,5535,1660,832,1314,41,38,274,1701,20,312,209,395,332,604,2671,5058,12,64042,3557,1,2,0,13,1
59457,182,5535,1057,646,719,113,100,145,1170,18,215,134,248,233,382,1740,3004,10,31186,1732,1,2,0,13,1
59458,245,5664,4293,999,3693,19,54,507,4312,9,155,88,170,164,258,1156,1898,4,9368,520,0,2,0,6,1
59459,245,5664,1482,859,1002,125,135,219,1607,16,219,134,251,235,385,1766,3032,9,27804,1544,1,2,0,6,1
59460,99,2671,1523,757,1297,19,12,193,1542,12,193,117,230,205,347,1508,2664,7,19053,1058,0,2,7,10,1
59461,99,2671,701,378,504,33,58,109,734,13,110,68,126,123,194,794,1346,7,10027,557,0,2,7,10,1
59462,290,6477,72,33,56,0,4,12,72,1,1,1,1,2,2,0,2,0,1,0,0,2,0,5,1
59463,290,6477,1454,835,1044,76,110,219,1530,17,275,158,296,292,454,2297,3718,9,34017,1889,1,2,0,5,1
59464,27,665,466,257,367,18,25,50,484,7,126,86,171,133,257,898,1813,4,8612,478,0,2,0,10,1
59465,27,665,507,281,342,29,59,88,536,10,53,29,57,63,86,336,514,5,2764,153,0,2,0,10,1
59466,25,546,215,129,180,6,0,29,221,8,65,43,72,73,115,415,711,4,3153,175,0,2,0,24,1
59467,25,546,97,69,77,3,3,16,100,6,22,13,23,28,36,113,173,3,542,30,0,2,0,24,1
59468,231,4941,1943,715,1694,26,18,214,1969,12,185,120,237,197,357,1436,2721,7,20915,1161,0,2,0,9,1
59469,231,4941,1168,838,957,57,25,144,1225,19,348,224,416,367,640,3018,5452,11,61921,3440,1,2,0,9,1
59470,125,5588,1782,648,1425,9,47,279,1791,8,171,97,189,179,286,1292,2140,4,9462,525,0,2,0,1,1
59471,15,1066,215,129,180,6,0,29,221,8,65,43,72,73,115,415,711,4,3153,175,0,2,0,29,1
59472,83,3318,1043,504,840,53,9,147,1096,9,180,112,198,189,310,1377,2344,4,11604,644,0,2,1,6,1
59473,29,1210,373,158,315,8,0,51,381,5,76,44,79,81,123,486,779,2,2026,112,0,2,0,1,1
59474,101,5272,1943,715,1694,26,18,214,1969,12,185,120,237,197,357,1436,2721,7,20915,1161,0,2,0,11,1
59475,92,1891,757,253,292,73,244,162,830,13,61,38,67,74,105,409,651,7,4654,258,0,2,2,2,0
59476,231,4977,182,127,129,0,0,53,182,5,39,21,42,44,63,217,343,2,926,51,0,2,0,5,0
59477,231,4977,1165,710,800,67,119,181,1232,18,243,153,282,261,435,2000,3492,10,36473,2026,1,2,0,5,0
59478,182,5535,1660,832,1314,41,38,274,1701,20,312,209,395,332,604,2671,5058,12,64042,3557,1,2,0,13,0
59479,182,5535,1057,646,719,113,100,145,1170,18,215,134,248,233,382,1740,3004,10,31186,1732,1,2,0,13,0
59480,245,5664,4293,999,3693,19,54,507,4312,9,155,88,170,164,258,1156,1898,4,9368,520,0,2,0,6,0
59481,245,5664,1482,859,1002,125,135,219,1607,16,219,134,251,235,385,1766,3032,9,27804,1544,1,2,0,6,0
59482,99,2671,1523,757,1297,19,12,193,1542,12,193,117,230,205,347,1508,2664,7,19053,1058,0,2,7,10,0
59483,99,2671,701,378,504,33,58,109,734,13,110,68,126,123,194,794,1346,7,10027,557,0,2,7,10,0
59484,290,6477,72,33,56,0,4,12,72,1,1,1,1,2,2,0,2,0,1,0,0,2,0,5,0
59485,290,6477,1454,835,1044,76,110,219,1530,17,275,158,296,292,454,2297,3718,9,34017,1889,1,2,0,5,0
59486,27,665,466,257,367,18,25,50,484,7,126,86,171,133,257,898,1813,4,8612,478,0,2,0,10,0
59487,27,665,507,281,342,29,59,88,536,10,53,29,57,63,86,336,514,5,2764,153,0,2,0,10,0
59488,25,546,215,129,180,6,0,29,221,8,65,43,72,73,115,415,711,4,3153,175,0,2,0,24,0
59489,25,546,97,69,77,3,3,16,100,6,22,13,23,28,36,113,173,3,542,30,0,2,0,24,0
59490,231,4941,1943,715,1694,26,18,214,1969,12,185,120,237,197,357,1436,2721,7,20915,1161,0,2,0,9,0
59491,231,4941,1168,838,957,57,25,144,1225,19,348,224,416,367,640,3018,5452,11,61921,3440,1,2,0,9,0
59492,125,5588,1782,648,1425,9,47,279,1791,8,171,97,189,179,286,1292,2140,4,9462,525,0,2,0,1,0
59493,15,1066,215,129,180,6,0,29,221,8,65,43,72,73,115,415,711,4,3153,175,0,2,0,29,0
59494,83,3318,1043,504,840,53,9,147,1096,9,180,112,198,189,310,1377,2344,4,11604,644,0,2,1,6,0
59495,29,1210,373,158,315,8,0,51,381,5,76,44,79,81,123,486,779,2,2026,112,0,2,0,1,0
59496,101,5272,1943,715,1694,26,18,214,1969,12,185,120,237,197,357,1436,2721,7,20915,1161,0,2,0,11,0
59499,183,5544,1660,832,1314,41,38,274,1701,20,312,209,395,332,604,2671,5058,12,64042,3557,1,2,7,1,0
59500,183,5544,1057,646,719,113,100,145,1170,18,215,134,248,233,382,1740,3004,10,31186,1732,1,2,7,1,0
59520,98,2641,1523,757,1297,19,12,193,1542,12,193,117,230,205,347,1508,2664,7,19053,1058,0,2,3,9,0
59521,98,2641,701,378,504,33,58,109,734,13,110,68,126,123,194,794,1346,7,10027,557,0,2,3,9,0
59522,99,4689,1523,757,1297,19,12,193,1542,12,193,117,230,205,347,1508,2664,7,19053,1058,0,2,31,95,0
59523,98,2660,1523,757,1297,19,12,193,1542,12,193,117,230,205,347,1508,2664,7,19053,1058,0,2,4,0,0
59524,98,2660,701,378,504,33,58,109,734,13,110,68,126,123,194,794,1346,7,10027,557,0,2,4,0,0
59525,106,2921,1523,757,1297,19,12,193,1542,12,193,117,230,205,347,1508,2664,7,19053,1058,0,2,54,10,0
59526,106,2921,701,378,504,33,58,109,734,13,110,68,126,123,194,794,1346,7,10027,557,0,2,54,10,0
59527,106,2923,1523,757,1297,19,12,193,1542,12,193,117,230,205,347,1508,2664,7,19053,1058,0,2,17,9,0
59528,106,2923,701,378,504,33,58,109,734,13,110,68,126,123,194,794,1346,7,10027,557,0,2,17,9,0
59529,106,2923,1523,757,1297,19,12,193,1542,12,193,117,230,205,347,1508,2664,7,19053,1058,0,2,1,1,0
59530,106,2923,701,378,504,33,58,109,734,13,110,68,126,123,194,794,1346,7,10027,557,0,2,1,1,0
59531,107,2933,1523,757,1297,19,12,193,1542,12,193,117,230,205,347,1508,2664,7,19053,1058,0,2,26,19,0
59532,107,2933,701,378,504,33,58,109,734,13,110,68,126,123,194,794,1346,7,10027,557,0,2,26,19,0
59533,100,4747,1523,757,1297,19,12,193,1542,12,193,117,230,205,347,1508,2664,7,19053,1058,0,2,38,0,0
59534,107,2933,1523,757,1297,19,12,193,1542,12,193,117,230,205,347,1508,2664,7,19053,1058,0,2,2,3,0
59535,107,2933,701,378,504,33,58,109,734,13,110,68,126,123,194,794,1346,7,10027,557,0,2,2,3,0
59536,108,2938,1523,757,1297,19,12,193,1542,12,193,117,230,205,347,1508,2664,7,19053,1058,0,2,1,1,0
59537,108,2938,701,378,504,33,58,109,734,13,110,68,126,123,194,794,1346,7,10027,557,0,2,1,1,0
59540,45,2037,447,308,343,6,5,95,453,7,96,59,111,103,170,651,1136,4,4600,255,0,2,27,0,0
59541,19,713,442,244,305,14,16,103,456,11,68,45,75,79,120,452,756,6,4588,254,0,2,1,1,0
59542,19,713,182,102,99,11,40,35,193,3,11,6,11,14,17,42,64,1,97,5,0,2,1,1,0
59543,36,1510,442,244,305,14,16,103,456,11,68,45,75,79,120,452,756,6,4588,254,0,2,16,0,0
59544,22,373,102,57,55,5,16,25,107,5,17,10,18,22,28,81,124,2,330,18,0,2,5,4,0
59562,1,14,6,4,4,0,0,2,6,0,0,0,0,0,0,0,0,0,0,0,0,0,6,0,0
59563,69,3105,1020,354,843,12,15,144,1032,8,134,77,144,142,221,970,1580,4,6792,377,0,2,7,0,0
59587,42,1241,339,213,244,17,9,65,356,10,42,26,48,52,74,259,421,5,2410,133,0,2,7,3,1
59588,21,541,205,80,86,16,53,53,221,7,18,10,19,25,29,94,134,3,497,27,0,2,3,3,1
59589,65,3082,1293,570,1093,25,15,163,1318,10,195,123,241,205,364,1516,2795,6,17273,959,0,2,71,55,1
59590,67,1570,773,419,590,28,0,166,801,10,204,113,217,214,330,1598,2554,5,13587,754,0,2,1,3,0
59591,67,1570,421,273,302,44,34,57,465,17,81,59,107,98,166,583,1098,11,12329,684,0,2,1,3,0
59592,185,5602,1660,832,1314,41,38,274,1701,20,312,209,395,332,604,2671,5058,12,64042,3557,1,2,1,1,0
59593,185,5602,1057,646,719,113,100,145,1170,18,215,134,248,233,382,1740,3004,10,31186,1732,1,2,1,1,0
59594,90,3983,1338,495,1086,10,64,173,1348,11,122,82,157,133,239,883,1686,7,11934,663,0,2,2,2,0
59595,124,4939,1450,624,1228,12,26,181,1462,14,306,186,354,320,540,2580,4493,8,36391,2021,1,2,6,4,0
59625,14,429,149,95,105,2,0,41,151,8,54,28,55,62,83,334,494,4,2013,111,0,0,71,0,1
59626,14,429,82,56,54,0,13,15,82,4,13,8,16,17,24,56,98,2,241,13,0,0,71,0,1
59627,16,436,149,95,105,2,0,41,151,8,54,28,55,62,83,334,494,4,2013,111,0,0,75,0,1
59628,12,387,149,95,105,2,0,41,151,8,54,28,55,62,83,334,494,4,2013,111,0,2,28,27,1
59629,12,387,82,56,54,0,13,15,82,4,13,8,16,17,24,56,98,2,241,13,0,2,28,27,1
59630,12,318,149,95,105,2,0,41,151,8,54,28,55,62,83,334,494,4,2013,111,0,2,63,72,1
59631,231,4979,182,127,129,0,0,53,182,5,39,21,42,44,63,217,343,2,926,51,0,2,4,3,1
59632,231,4979,1165,710,800,67,119,181,1232,18,243,153,282,261,435,2000,3492,10,36473,2026,1,2,4,3,1
59633,185,5602,1660,832,1314,41,38,274,1701,20,312,209,395,332,604,2671,5058,12,64042,3557,1,2,5,4,1
59634,185,5602,1057,646,719,113,100,145,1170,18,215,134,248,233,382,1740,3004,10,31186,1732,1,2,5,4,1
59635,112,2103,477,336,357,30,23,73,507,16,194,134,250,210,384,1538,2962,10,30538,1696,0,2,9,11,1
59636,73,1518,207,111,150,11,0,50,218,5,26,19,36,31,55,133,272,3,943,52,0,2,2,1,1
59637,73,1518,410,198,237,31,55,97,441,11,63,38,72,74,110,414,683,6,4293,238,0,2,2,1,1
59638,245,5869,722,423,573,19,0,135,741,12,172,101,199,184,300,1320,2257,6,15668,870,0,2,2,3,1
59639,245,5869,1508,847,911,44,250,301,1552,14,148,88,169,162,257,1120,1886,7,15077,837,0,2,2,3,1
59640,231,4979,182,127,129,0,0,53,182,5,39,21,42,44,63,217,343,2,926,51,0,2,4,3,0
59641,231,4979,1165,710,800,67,119,181,1232,18,243,153,282,261,435,2000,3492,10,36473,2026,1,2,4,3,0
59665,12,387,149,95,105,2,0,41,151,8,54,28,55,62,83,334,494,4,2013,111,0,0,72,0,0
59666,12,387,82,56,54,0,13,15,82,4,13,8,16,17,24,56,98,2,241,13,0,0,72,0,0
59667,185,5602,1660,832,1314,41,38,274,1701,20,312,209,395,332,604,2671,5058,12,64042,3557,1,2,5,4,0
59668,185,5602,1057,646,719,113,100,145,1170,18,215,134,248,233,382,1740,3004,10,31186,1732,1,2,5,4,0
59669,112,2103,477,336,357,30,23,73,507,16,194,134,250,210,384,1538,2962,10,30538,1696,0,2,9,11,0
59670,73,1518,207,111,150,11,0,50,218,5,26,19,36,31,55,133,272,3,943,52,0,2,2,1,0
59671,73,1518,410,198,237,31,55,97,441,11,63,38,72,74,110,414,683,6,4293,238,0,2,2,1,0
59672,245,5869,722,423,573,19,0,135,741,12,172,101,199,184,300,1320,2257,6,15668,870,0,2,2,3,0
59673,245,5869,1508,847,911,44,250,301,1552,14,148,88,169,162,257,1120,1886,7,15077,837,0,2,2,3,0
59674,12,318,149,95,105,2,0,41,151,8,54,28,55,62,83,334,494,4,2013,111,0,0,66,0,0
59675,232,4964,1943,715,1694,26,18,214,1969,12,185,120,237,197,357,1436,2721,7,20915,1161,0,2,3,0,0
59676,232,4964,1168,838,957,57,25,144,1225,19,348,224,416,367,640,3018,5452,11,61921,3440,1,2,3,0,0
59677,7,296,72,33,56,0,4,12,72,1,1,1,1,2,2,0,2,0,1,0,0,2,5,5,1
59678,245,5671,4293,999,3693,19,54,507,4312,9,155,88,170,164,258,1156,1898,4,9368,520,0,2,1,1,1
59679,245,5671,1482,859,1002,125,135,219,1607,16,219,134,251,235,385,1766,3032,9,27804,1544,1,2,1,1,1
59680,245,5880,722,423,573,19,0,135,741,12,172,101,199,184,300,1320,2257,6,15668,870,0,2,5,7,1
59681,245,5880,1508,847,911,44,250,301,1552,14,148,88,169,162,257,1120,1886,7,15077,837,0,2,5,7,1
59682,291,6502,72,33,56,0,4,12,72,1,1,1,1,2,2,0,2,0,1,0,0,2,1,1,1
59683,291,6502,1454,835,1044,76,110,219,1530,17,275,158,296,292,454,2297,3718,9,34017,1889,1,2,1,1,1
59684,124,5347,1513,682,1277,25,13,200,1538,11,199,116,219,210,335,1557,2584,6,15641,868,0,2,12,10,1
59685,39,2363,334,251,279,10,4,40,344,5,127,74,143,132,217,899,1528,2,4303,239,0,2,2,1,1
59686,7,296,72,33,56,0,4,12,72,1,1,1,1,2,2,0,2,0,1,0,0,2,5,5,0
59687,245,5671,4293,999,3693,19,54,507,4312,9,155,88,170,164,258,1156,1898,4,9368,520,0,2,1,1,0
59688,245,5671,1482,859,1002,125,135,219,1607,16,219,134,251,235,385,1766,3032,9,27804,1544,1,2,1,1,0
59689,245,5880,722,423,573,19,0,135,741,12,172,101,199,184,300,1320,2257,6,15668,870,0,2,5,7,0
59690,245,5880,1508,847,911,44,250,301,1552,14,148,88,169,162,257,1120,1886,7,15077,837,0,2,5,7,0
59691,291,6502,72,33,56,0,4,12,72,1,1,1,1,2,2,0,2,0,1,0,0,2,1,1,0
59692,291,6502,1454,835,1044,76,110,219,1530,17,275,158,296,292,454,2297,3718,9,34017,1889,1,2,1,1,0
59693,124,5347,1513,682,1277,25,13,200,1538,11,199,116,219,210,335,1557,2584,6,15641,868,0,2,12,10,0
59694,39,2363,334,251,279,10,4,40,344,5,127,74,143,132,217,899,1528,2,4303,239,0,2,2,1,0
59695,123,5301,1513,682,1277,25,13,200,1538,11,199,116,219,210,335,1557,2584,6,15641,868,0,2,0,9,0
59697,235,4993,1943,715,1694,26,18,214,1969,12,185,120,237,197,357,1436,2721,7,20915,1161,0,2,21,21,0
59698,235,4993,1168,838,957,57,25,144,1225,19,348,224,416,367,640,3018,5452,11,61921,3440,1,2,21,21,0
59699,3,49,16,9,9,0,0,7,16,0,0,0,0,0,0,0,0,0,0,0,0,0,16,0,0
59700,53,1862,601,196,481,2,23,85,603,8,63,36,72,71,108,400,664,4,3036,168,0,2,19,0,0
59701,313,6832,72,33,56,0,4,12,72,1,1,1,1,2,2,0,2,0,1,0,0,2,142,46,0
59702,313,6832,1454,835,1044,76,110,219,1530,17,275,158,296,292,454,2297,3718,9,34017,1889,1,2,142,46,0
59703,68,1302,1098,241,925,5,10,155,1103,7,46,25,49,53,74,273,423,3,1580,87,0,2,45,19,0
59704,68,1302,282,202,222,14,2,44,296,8,42,24,43,50,67,250,378,4,1548,86,0,2,45,19,0
59705,90,3974,1338,495,1086,10,64,173,1348,11,122,82,157,133,239,883,1686,7,11934,663,0,2,0,3,0
59706,170,7538,139,89,101,2,0,35,141,7,54,34,62,61,96,330,569,4,2287,127,0,2,39,0,0
59707,170,7538,7,5,5,0,0,2,7,1,2,1,2,3,3,2,4,0,2,0,0,2,39,0,0
59708,232,4966,1943,715,1694,26,18,214,1969,12,185,120,237,197,357,1436,2721,7,20915,1161,0,2,1,1,0
59709,232,4966,1168,838,957,57,25,144,1225,19,348,224,416,367,640,3018,5452,11,61921,3440,1,2,1,1,0
59710,47,3455,996,429,845,24,10,117,1020,7,76,50,88,83,138,494,879,4,3565,198,0,2,1,1,0
59711,101,5272,1943,715,1694,26,18,214,1969,12,185,120,237,197,357,1436,2721,7,20915,1161,0,2,2,2,0
59712,99,2681,1523,757,1297,19,12,193,1542,12,193,117,230,205,347,1508,2664,7,19053,1058,0,2,1,1,1
59713,99,2681,701,378,504,33,58,109,734,13,110,68,126,123,194,794,1346,7,10027,557,0,2,1,1,1
59714,28,713,466,257,367,18,25,50,484,7,126,86,171,133,257,898,1813,4,8612,478,0,2,4,0,1
59715,28,713,507,281,342,29,59,88,536,10,53,29,57,63,86,336,514,5,2764,153,0,2,4,0,1
59716,71,1445,1178,367,1042,6,15,115,1184,9,94,51,95,103,146,644,976,4,4439,246,0,2,26,25,1
59717,71,1445,177,108,140,8,0,27,185,6,30,16,32,36,48,162,248,3,794,44,0,2,26,25,1
59718,237,5000,1943,715,1694,26,18,214,1969,12,185,120,237,197,357,1436,2721,7,20915,1161,0,2,5,3,1
59719,237,5000,1168,838,957,57,25,144,1225,19,348,224,416,367,640,3018,5452,11,61921,3440,1,2,5,3,1
59720,99,4102,1289,550,1043,56,32,155,1345,10,167,93,185,177,278,1266,2075,5,11498,638,0,2,2,2,1
59721,77,3228,1178,367,1042,6,15,115,1184,9,94,51,95,103,146,644,976,4,4439,246,0,2,1,1,1
59722,103,5339,1943,715,1694,26,18,214,1969,12,185,120,237,197,357,1436,2721,7,20915,1161,0,2,1,1,1
59723,245,5864,722,423,573,19,0,135,741,12,172,101,199,184,300,1320,2257,6,15668,870,0,2,5,8,0
59724,245,5864,1508,847,911,44,250,301,1552,14,148,88,169,162,257,1120,1886,7,15077,837,0,2,5,8,0
59725,71,1439,1178,367,1042,6,15,115,1184,9,94,51,95,103,146,644,976,4,4439,246,0,2,5,2,0
59726,71,1439,177,108,140,8,0,27,185,6,30,16,32,36,48,162,248,3,794,44,0,2,5,2,0
59727,77,3233,1178,367,1042,6,15,115,1184,9,94,51,95,103,146,644,976,4,4439,246,0,2,1,0,0
59728,99,2681,1523,757,1297,19,12,193,1542,12,193,117,230,205,347,1508,2664,7,19053,1058,0,2,1,1,0
59729,99,2681,701,378,504,33,58,109,734,13,110,68,126,123,194,794,1346,7,10027,557,0,2,1,1,0
59732,28,713,466,257,367,18,25,50,484,7,126,86,171,133,257,898,1813,4,8612,478,0,2,4,0,0
59733,28,713,507,281,342,29,59,88,536,10,53,29,57,63,86,336,514,5,2764,153,0,2,4,0,0
59734,71,1439,1178,367,1042,6,15,115,1184,9,94,51,95,103,146,644,976,4,4439,246,0,2,31,27,0
59735,71,1439,177,108,140,8,0,27,185,6,30,16,32,36,48,162,248,3,794,44,0,2,31,27,0
59736,237,5000,1943,715,1694,26,18,214,1969,12,185,120,237,197,357,1436,2721,7,20915,1161,0,2,5,3,0
59737,237,5000,1168,838,957,57,25,144,1225,19,348,224,416,367,640,3018,5452,11,61921,3440,1,2,5,3,0
59738,99,4102,1289,550,1043,56,32,155,1345,10,167,93,185,177,278,1266,2075,5,11498,638,0,2,2,2,0
59739,77,3233,1178,367,1042,6,15,115,1184,9,94,51,95,103,146,644,976,4,4439,246,0,2,2,1,0
59740,103,5339,1943,715,1694,26,18,214,1969,12,185,120,237,197,357,1436,2721,7,20915,1161,0,2,1,1,0
59741,238,5016,1943,715,1694,26,18,214,1969,12,185,120,237,197,357,1436,2721,7,20915,1161,0,2,21,21,0
59742,238,5016,1168,838,957,57,25,144,1225,19,348,224,416,367,640,3018,5452,11,61921,3440,1,2,21,21,0
59745,232,4966,1943,715,1694,26,18,214,1969,12,185,120,237,197,357,1436,2721,7,20915,1161,0,2,3,0,0
59746,232,4966,1168,838,957,57,25,144,1225,19,348,224,416,367,640,3018,5452,11,61921,3440,1,2,3,0,0
59749,108,2938,1523,757,1297,19,12,193,1542,12,193,117,230,205,347,1508,2664,7,19053,1058,0,2,66,10,0
59750,108,2938,701,378,504,33,58,109,734,13,110,68,126,123,194,794,1346,7,10027,557,0,2,66,10,0
59751,100,4747,1523,757,1297,19,12,193,1542,12,193,117,230,205,347,1508,2664,7,19053,1058,0,2,69,95,0
59754,36,1456,442,244,305,14,16,103,456,11,68,45,75,79,120,452,756,6,4588,254,0,2,4,0,0
59755,19,717,442,244,305,14,16,103,456,11,68,45,75,79,120,452,756,6,4588,254,0,2,2,2,0
59756,19,717,182,102,99,11,40,35,193,3,11,6,11,14,17,42,64,1,97,5,0,2,2,2,0
59757,170,7538,139,89,101,2,0,35,141,7,54,34,62,61,96,330,569,4,2287,127,0,2,1,1,0
59758,170,7538,7,5,5,0,0,2,7,1,2,1,2,3,3,2,4,0,2,0,0,2,1,1,0
59759,93,1905,757,253,292,73,244,162,830,13,61,38,67,74,105,409,651,7,4654,258,0,2,30,0,0
59760,33,1041,256,139,192,9,7,47,265,4,23,12,24,27,36,112,171,2,357,19,0,2,40,0,0
59761,93,1905,757,253,292,73,244,162,830,13,61,38,67,74,105,409,651,7,4654,258,0,2,19,6,0
59762,33,1041,256,139,192,9,7,47,265,4,23,12,24,27,36,112,171,2,357,19,0,2,0,2,0
59763,92,1891,757,253,292,73,244,162,830,13,61,38,67,74,105,409,651,7,4654,258,0,2,0,35,0
59764,33,1041,256,139,192,9,7,47,265,4,23,12,24,27,36,112,171,2,357,19,0,2,14,4,0
59765,18,310,424,94,331,4,0,89,428,1,5,5,5,6,10,11,25,0,12,0,0,2,3,1,1
59766,18,310,38,23,23,6,0,8,44,3,11,7,11,14,18,42,68,1,102,5,0,2,3,1,1
59767,21,653,424,94,331,4,0,89,428,1,5,5,5,6,10,11,25,0,12,0,0,2,15,0,1
59768,18,310,424,94,331,4,0,89,428,1,5,5,5,6,10,11,25,0,12,0,0,2,3,1,0
59769,18,310,38,23,23,6,0,8,44,3,11,7,11,14,18,42,68,1,102,5,0,2,3,1,0
59770,21,653,424,94,331,4,0,89,428,1,5,5,5,6,10,11,25,0,12,0,0,2,15,0,0
59771,52,623,647,139,84,35,284,233,682,0,0,0,0,0,0,0,0,0,0,0,0,2,3,1,0
59772,25,552,215,129,180,6,0,29,221,8,65,43,72,73,115,415,711,4,3153,175,0,2,3,1,0
59773,25,552,97,69,77,3,3,16,100,6,22,13,23,28,36,113,173,3,542,30,0,2,3,1,0
59774,232,4972,1943,715,1694,26,18,214,1969,12,185,120,237,197,357,1436,2721,7,20915,1161,0,2,1,1,0
59775,232,4972,1168,838,957,57,25,144,1225,19,348,224,416,367,640,3018,5452,11,61921,3440,1,2,1,1,0
59781,52,625,647,139,84,35,284,233,682,0,0,0,0,0,0,0,0,0,0,0,0,2,3,2,0
59782,232,4978,1943,715,1694,26,18,214,1969,12,185,120,237,197,357,1436,2721,7,20915,1161,0,2,1,1,0
59783,232,4978,1168,838,957,57,25,144,1225,19,348,224,416,367,640,3018,5452,11,61921,3440,1,2,1,1,0
59784,19,720,442,244,305,14,16,103,456,11,68,45,75,79,120,452,756,6,4588,254,0,2,2,1,0
59785,19,720,182,102,99,11,40,35,193,3,11,6,11,14,17,42,64,1,97,5,0,2,2,1,0
59786,19,720,442,244,305,14,16,103,456,11,68,45,75,79,120,452,756,6,4588,254,0,2,4,3,0
59787,19,720,182,102,99,11,40,35,193,3,11,6,11,14,17,42,64,1,97,5,0,2,4,3,0
59791,236,5073,1943,715,1694,26,18,214,1969,12,185,120,237,197,357,1436,2721,7,20915,1161,0,2,15,0,0
59792,236,5073,1168,838,957,57,25,144,1225,19,348,224,416,367,640,3018,5452,11,61921,3440,1,2,15,0,0
59793,100,4116,1289,550,1043,56,32,155,1345,10,167,93,185,177,278,1266,2075,5,11498,638,0,2,3,1,0
59794,16,895,75,38,59,1,3,12,76,2,4,2,4,6,6,10,15,1,15,0,0,2,19,0,0
59795,42,1241,339,213,244,17,9,65,356,10,42,26,48,52,74,259,421,5,2410,133,0,2,7,3,0
59796,21,541,205,80,86,16,53,53,221,7,18,10,19,25,29,94,134,3,497,27,0,2,3,3,0
59797,65,3082,1293,570,1093,25,15,163,1318,10,195,123,241,205,364,1516,2795,6,17273,959,0,2,71,55,0
59799,231,4973,182,127,129,0,0,53,182,5,39,21,42,44,63,217,343,2,926,51,0,2,4,3,0
59800,231,4973,1165,710,800,67,119,181,1232,18,243,153,282,261,435,2000,3492,10,36473,2026,1,2,4,3,0
59828,183,5544,1660,832,1314,41,38,274,1701,20,312,209,395,332,604,2671,5058,12,64042,3557,1,2,6,5,0
59829,183,5544,1057,646,719,113,100,145,1170,18,215,134,248,233,382,1740,3004,10,31186,1732,1,2,6,5,0
59833,245,5664,4293,999,3693,19,54,507,4312,9,155,88,170,164,258,1156,1898,4,9368,520,0,2,1,1,0
59834,245,5664,1482,859,1002,125,135,219,1607,16,219,134,251,235,385,1766,3032,9,27804,1544,1,2,1,1,0
59835,108,2933,1523,757,1297,19,12,193,1542,12,193,117,230,205,347,1508,2664,7,19053,1058,0,2,1,1,0
59836,108,2933,701,378,504,33,58,109,734,13,110,68,126,123,194,794,1346,7,10027,557,0,2,1,1,0
59842,245,5864,722,423,573,19,0,135,741,12,172,101,199,184,300,1320,2257,6,15668,870,0,2,12,18,0
59843,245,5864,1508,847,911,44,250,301,1552,14,148,88,169,162,257,1120,1886,7,15077,837,0,2,12,18,0
59844,313,6834,72,33,56,0,4,12,72,1,1,1,1,2,2,0,2,0,1,0,0,2,1,1,0
59845,313,6834,1454,835,1044,76,110,219,1530,17,275,158,296,292,454,2297,3718,9,34017,1889,1,2,1,1,0
59846,27,671,466,257,367,18,25,50,484,7,126,86,171,133,257,898,1813,4,8612,478,0,2,4,0,0
59847,27,671,507,281,342,29,59,88,536,10,53,29,57,63,86,336,514,5,2764,153,0,2,4,0,0
59850,236,5011,1943,715,1694,26,18,214,1969,12,185,120,237,197,357,1436,2721,7,20915,1161,0,2,26,24,0
59851,236,5011,1168,838,957,57,25,144,1225,19,348,224,416,367,640,3018,5452,11,61921,3440,1,2,26,24,0
59873,90,3974,1338,495,1086,10,64,173,1348,11,122,82,157,133,239,883,1686,7,11934,663,0,2,2,2,0
59875,123,5301,1513,682,1277,25,13,200,1538,11,199,116,219,210,335,1557,2584,6,15641,868,0,2,11,18,0
59881,101,5272,1943,715,1694,26,18,214,1969,12,185,120,237,197,357,1436,2721,7,20915,1161,0,2,1,1,0
59882,37,1525,442,244,305,14,16,103,456,11,68,45,75,79,120,452,756,6,4588,254,0,2,16,0,0
59887,245,5671,4293,999,3693,19,54,507,4312,9,155,88,170,164,258,1156,1898,4,9368,520,0,2,2,2,0
59888,245,5671,1482,859,1002,125,135,219,1607,16,219,134,251,235,385,1766,3032,9,27804,1544,1,2,2,2,0
59889,94,2438,773,422,505,30,103,129,803,14,77,46,83,91,129,535,839,7,6334,351,0,2,1,1,0
59890,69,1497,402,202,227,24,74,80,426,12,52,33,61,64,94,339,564,7,3969,220,0,2,2,2,0
59891,95,2085,1043,504,840,53,9,147,1096,9,180,112,198,189,310,1377,2344,4,11604,644,0,2,1,1,0
59892,95,2085,383,288,292,26,6,62,409,11,65,38,67,76,105,429,656,5,3719,206,0,2,1,1,0
59895,220,4689,2,2,2,0,0,0,2,0,0,0,0,0,0,0,0,0,0,0,0,2,1,1,0
59909,220,4689,99,48,90,1,3,5,100,0,0,0,0,0,0,0,0,0,0,0,0,2,1,1,0
59910,220,4689,8,5,5,2,0,1,10,0,0,0,0,0,0,0,0,0,0,0,0,2,1,1,0
59911,220,4689,1217,716,841,84,126,174,1301,14,185,118,215,199,333,1446,2542,8,20687,1149,0,2,1,1,0
59912,220,4689,160,89,115,0,13,31,160,7,15,11,17,22,28,78,124,3,495,27,0,2,1,1,0
59913,220,4689,10,10,9,9,0,0,19,0,0,0,0,0,0,0,0,0,0,0,0,2,1,1,0
59914,220,4689,173,84,99,8,29,36,181,5,12,7,13,17,20,54,81,2,221,12,0,2,1,1,0
59915,220,4689,3,1,1,3,0,0,6,0,0,0,0,0,0,0,0,0,0,0,0,2,1,1,0
59916,236,5079,1943,715,1694,26,18,214,1969,12,185,120,237,197,357,1436,2721,7,20915,1161,0,2,15,0,0
59917,236,5079,1168,838,957,57,25,144,1225,19,348,224,416,367,640,3018,5452,11,61921,3440,1,2,15,0,0
59949,71,1445,1178,367,1042,6,15,115,1184,9,94,51,95,103,146,644,976,4,4439,246,0,2,1,1,0
59950,71,1445,177,108,140,8,0,27,185,6,30,16,32,36,48,162,248,3,794,44,0,2,1,1,0
59974,245,5664,4293,999,3693,19,54,507,4312,9,155,88,170,164,258,1156,1898,4,9368,520,0,2,2,2,0
59975,245,5664,1482,859,1002,125,135,219,1607,16,219,134,251,235,385,1766,3032,9,27804,1544,1,2,2,2,0
59981,240,5118,1943,715,1694,26,18,214,1969,12,185,120,237,197,357,1436,2721,7,20915,1161,0,2,16,1,0
59982,240,5118,1168,838,957,57,25,144,1225,19,348,224,416,367,640,3018,5452,11,61921,3440,1,2,16,1,0
59983,100,4121,1289,550,1043,56,32,155,1345,10,167,93,185,177,278,1266,2075,5,11498,638,0,2,3,1,0
60043,245,5664,4293,999,3693,19,54,507,4312,9,155,88,170,164,258,1156,1898,4,9368,520,0,2,3,3,0
60044,245,5664,1482,859,1002,125,135,219,1607,16,219,134,251,235,385,1766,3032,9,27804,1544,1,2,3,3,0
60062,71,1445,1178,367,1042,6,15,115,1184,9,94,51,95,103,146,644,976,4,4439,246,0,2,31,27,0
60063,71,1445,177,108,140,8,0,27,185,6,30,16,32,36,48,162,248,3,794,44,0,2,31,27,0
60064,240,5118,1943,715,1694,26,18,214,1969,12,185,120,237,197,357,1436,2721,7,20915,1161,0,2,26,24,0
60065,240,5118,1168,838,957,57,25,144,1225,19,348,224,416,367,640,3018,5452,11,61921,3440,1,2,26,24,0
60066,100,4121,1289,550,1043,56,32,155,1345,10,167,93,185,177,278,1266,2075,5,11498,638,0,2,2,2,0
60098,231,4973,182,127,129,0,0,53,182,5,39,21,42,44,63,217,343,2,926,51,0,2,0,5,0
60099,231,4973,1165,710,800,67,119,181,1232,18,243,153,282,261,435,2000,3492,10,36473,2026,1,2,0,5,0
60100,183,5544,1660,832,1314,41,38,274,1701,20,312,209,395,332,604,2671,5058,12,64042,3557,1,2,0,13,0
60101,183,5544,1057,646,719,113,100,145,1170,18,215,134,248,233,382,1740,3004,10,31186,1732,1,2,0,13,0
60105,52,625,647,139,84,35,284,233,682,0,0,0,0,0,0,0,0,0,0,0,0,2,6,3,0
60106,108,2933,1523,757,1297,19,12,193,1542,12,193,117,230,205,347,1508,2664,7,19053,1058,0,2,73,20,0
60107,108,2933,701,378,504,33,58,109,734,13,110,68,126,123,194,794,1346,7,10027,557,0,2,73,20,0
60109,313,6834,72,33,56,0,4,12,72,1,1,1,1,2,2,0,2,0,1,0,0,2,142,51,0
60110,313,6834,1454,835,1044,76,110,219,1530,17,275,158,296,292,454,2297,3718,9,34017,1889,1,2,142,51,0
60111,27,671,466,257,367,18,25,50,484,7,126,86,171,133,257,898,1813,4,8612,478,0,2,0,10,0
60112,27,671,507,281,342,29,59,88,536,10,53,29,57,63,86,336,514,5,2764,153,0,2,0,10,0
60113,25,552,215,129,180,6,0,29,221,8,65,43,72,73,115,415,711,4,3153,175,0,2,3,25,0
60114,25,552,97,69,77,3,3,16,100,6,22,13,23,28,36,113,173,3,542,30,0,2,3,25,0
60117,240,5118,1943,715,1694,26,18,214,1969,12,185,120,237,197,357,1436,2721,7,20915,1161,0,2,20,11,0
60118,240,5118,1168,838,957,57,25,144,1225,19,348,224,416,367,640,3018,5452,11,61921,3440,1,2,20,11,0
60119,19,720,442,244,305,14,16,103,456,11,68,45,75,79,120,452,756,6,4588,254,0,2,3,2,0
60120,19,720,182,102,99,11,40,35,193,3,11,6,11,14,17,42,64,1,97,5,0,2,3,2,0
60126,170,7538,139,89,101,2,0,35,141,7,54,34,62,61,96,330,569,4,2287,127,0,2,40,1,0
60127,170,7538,7,5,5,0,0,2,7,1,2,1,2,3,3,2,4,0,2,0,0,2,40,1,0
60135,101,5272,1943,715,1694,26,18,214,1969,12,185,120,237,197,357,1436,2721,7,20915,1161,0,2,2,13,0
60136,37,1525,442,244,305,14,16,103,456,11,68,45,75,79,120,452,756,6,4588,254,0,2,4,0,0
60137,69,1323,1098,241,925,5,10,155,1103,7,46,25,49,53,74,273,423,3,1580,87,0,2,3,0,0
60138,69,1323,282,202,222,14,2,44,296,8,42,24,43,50,67,250,378,4,1548,86,0,2,3,0,0
60139,2,40,13,9,8,0,0,4,13,0,0,0,0,0,0,0,0,0,0,0,0,0,13,0,0
60140,2,42,14,10,9,0,0,4,14,0,0,0,0,0,0,0,0,0,0,0,0,0,14,0,0
60141,2,33,12,8,7,0,0,4,12,0,0,0,0,0,0,0,0,0,0,0,0,0,12,0,0
60142,52,1990,1098,241,925,5,10,155,1103,7,46,25,49,53,74,273,423,3,1580,87,0,2,15,0,0
60149,92,1891,757,253,292,73,244,162,830,13,61,38,67,74,105,409,651,7,4654,258,0,2,8,0,0
60150,33,1041,256,139,192,9,7,47,265,4,23,12,24,27,36,112,171,2,357,19,0,2,48,0,0
60151,169,5034,1660,832,1314,41,38,274,1701,20,312,209,395,332,604,2671,5058,12,64042,3557,1,2,13,36,0
60153,94,2466,773,422,505,30,103,129,803,14,77,46,83,91,129,535,839,7,6334,351,0,2,51,47,0
60156,221,4701,2,2,2,0,0,0,2,0,0,0,0,0,0,0,0,0,0,0,0,2,2,2,0
60170,221,4701,99,48,90,1,3,5,100,0,0,0,0,0,0,0,0,0,0,0,0,2,2,2,0
60171,221,4701,8,5,5,2,0,1,10,0,0,0,0,0,0,0,0,0,0,0,0,2,2,2,0
60172,221,4701,1217,716,841,84,126,174,1301,14,185,118,215,199,333,1446,2542,8,20687,1149,0,2,2,2,0
60173,221,4701,160,89,115,0,13,31,160,7,15,11,17,22,28,78,124,3,495,27,0,2,2,2,0
60174,221,4701,10,10,9,9,0,0,19,0,0,0,0,0,0,0,0,0,0,0,0,2,2,2,0
60175,221,4701,173,84,99,8,29,36,181,5,12,7,13,17,20,54,81,2,221,12,0,2,2,2,0
60176,221,4701,3,1,1,3,0,0,6,0,0,0,0,0,0,0,0,0,0,0,0,2,2,2,0
60177,101,4167,1289,550,1043,56,32,155,1345,10,167,93,185,177,278,1266,2075,5,11498,638,0,2,14,0,0
60178,158,3681,77,34,69,0,0,8,77,3,24,16,29,27,45,114,213,1,387,21,0,2,18,0,0
60179,158,3681,712,438,573,51,9,84,763,14,102,71,128,116,199,733,1364,8,11988,666,0,2,18,0,0
60180,30,1324,373,158,315,8,0,51,381,5,76,44,79,81,123,486,779,2,2026,112,0,2,15,0,0
60205,241,5125,1943,715,1694,26,18,214,1969,12,185,120,237,197,357,1436,2721,7,20915,1161,0,2,8,7,0
60206,241,5125,1168,838,957,57,25,144,1225,19,348,224,416,367,640,3018,5452,11,61921,3440,1,2,8,7,0
60207,101,5303,1943,715,1694,26,18,214,1969,12,185,120,237,197,357,1436,2721,7,20915,1161,0,2,5,2,0
60208,159,3699,77,34,69,0,0,8,77,3,24,16,29,27,45,114,213,1,387,21,0,2,4,1,0
60209,159,3699,712,438,573,51,9,84,763,14,102,71,128,116,199,733,1364,8,11988,666,0,2,4,1,0
60210,80,4558,1296,573,1062,40,33,157,1336,8,201,118,231,209,349,1561,2689,4,12365,686,0,2,20,0,0
60213,45,955,386,256,301,16,9,68,402,4,59,35,69,63,104,355,621,2,1453,80,0,2,8,5,0
60214,45,955,264,131,164,11,41,46,275,6,38,22,40,44,62,214,338,3,1068,59,0,2,8,5,0
60215,17,930,75,38,59,1,3,12,76,2,4,2,4,6,6,10,15,1,15,0,0,2,9,0,0
60221,221,4705,2,2,2,0,0,0,2,0,0,0,0,0,0,0,0,0,0,0,0,2,1,1,1
60235,221,4705,99,48,90,1,3,5,100,0,0,0,0,0,0,0,0,0,0,0,0,2,1,1,1
60236,221,4705,8,5,5,2,0,1,10,0,0,0,0,0,0,0,0,0,0,0,0,2,1,1,1
60237,221,4705,1217,716,841,84,126,174,1301,14,185,118,215,199,333,1446,2542,8,20687,1149,0,2,1,1,1
60238,221,4705,160,89,115,0,13,31,160,7,15,11,17,22,28,78,124,3,495,27,0,2,1,1,1
60239,221,4705,10,10,9,9,0,0,19,0,0,0,0,0,0,0,0,0,0,0,0,2,1,1,1
60240,221,4705,173,84,99,8,29,36,181,5,12,7,13,17,20,54,81,2,221,12,0,2,1,1,1
60241,221,4705,3,1,1,3,0,0,6,0,0,0,0,0,0,0,0,0,0,0,0,2,1,1,1
60242,43,2676,652,304,544,16,6,88,668,6,89,51,101,95,152,591,998,3,3399,188,0,2,36,0,1
60249,221,4705,2,2,2,0,0,0,2,0,0,0,0,0,0,0,0,0,0,0,0,2,3,0,0
60263,221,4705,99,48,90,1,3,5,100,0,0,0,0,0,0,0,0,0,0,0,0,2,3,0,0
60264,221,4705,8,5,5,2,0,1,10,0,0,0,0,0,0,0,0,0,0,0,0,2,3,0,0
60265,221,4705,1217,716,841,84,126,174,1301,14,185,118,215,199,333,1446,2542,8,20687,1149,0,2,3,0,0
60266,221,4705,160,89,115,0,13,31,160,7,15,11,17,22,28,78,124,3,495,27,0,2,3,0,0
60267,221,4705,10,10,9,9,0,0,19,0,0,0,0,0,0,0,0,0,0,0,0,2,3,0,0
60268,221,4705,173,84,99,8,29,36,181,5,12,7,13,17,20,54,81,2,221,12,0,2,3,0,0
60269,221,4705,3,1,1,3,0,0,6,0,0,0,0,0,0,0,0,0,0,0,0,2,3,0,0
60270,94,2454,773,422,505,30,103,129,803,14,77,46,83,91,129,535,839,7,6334,351,0,2,43,44,0
60272,313,6832,72,33,56,0,4,12,72,1,1,1,1,2,2,0,2,0,1,0,0,2,4,6,0
60273,313,6832,1454,835,1044,76,110,219,1530,17,275,158,296,292,454,2297,3718,9,34017,1889,1,2,4,6,0
60274,126,5612,1782,648,1425,9,47,279,1791,8,171,97,189,179,286,1292,2140,4,9462,525,0,2,15,0,0
60275,94,2418,773,422,505,30,103,129,803,14,77,46,83,91,129,535,839,7,6334,351,0,2,0,7,0
60276,247,5178,1943,715,1694,26,18,214,1969,12,185,120,237,197,357,1436,2721,7,20915,1161,0,2,23,4,0
60277,247,5178,1168,838,957,57,25,144,1225,19,348,224,416,367,640,3018,5452,11,61921,3440,1,2,23,4,0
60281,154,3603,77,34,69,0,0,8,77,3,24,16,29,27,45,114,213,1,387,21,0,2,1,0,1
60282,154,3603,712,438,573,51,9,84,763,14,102,71,128,116,199,733,1364,8,11988,666,0,2,1,0,1
60283,313,6841,72,33,56,0,4,12,72,1,1,1,1,2,2,0,2,0,1,0,0,2,7,5,1
60284,313,6841,1454,835,1044,76,110,219,1530,17,275,158,296,292,454,2297,3718,9,34017,1889,1,2,7,5,1
60285,80,4551,1296,573,1062,40,33,157,1336,8,201,118,231,209,349,1561,2689,4,12365,686,0,2,13,0,1
60286,153,3603,77,34,69,0,0,8,77,3,24,16,29,27,45,114,213,1,387,21,0,2,13,11,0
60287,153,3603,712,438,573,51,9,84,763,14,102,71,128,116,199,733,1364,8,11988,666,0,2,13,11,0
60311,94,2454,773,422,505,30,103,129,803,14,77,46,83,91,129,535,839,7,6334,351,0,2,50,47,0
60328,154,3603,77,34,69,0,0,8,77,3,24,16,29,27,45,114,213,1,387,21,0,2,1,0,0
60329,154,3603,712,438,573,51,9,84,763,14,102,71,128,116,199,733,1364,8,11988,666,0,2,1,0,0
60330,313,6841,72,33,56,0,4,12,72,1,1,1,1,2,2,0,2,0,1,0,0,2,7,5,0
60331,313,6841,1454,835,1044,76,110,219,1530,17,275,158,296,292,454,2297,3718,9,34017,1889,1,2,7,5,0
60332,80,4551,1296,573,1062,40,33,157,1336,8,201,118,231,209,349,1561,2689,4,12365,686,0,2,13,0,0
60364,313,6841,72,33,56,0,4,12,72,1,1,1,1,2,2,0,2,0,1,0,0,2,11,11,0
60365,313,6841,1454,835,1044,76,110,219,1530,17,275,158,296,292,454,2297,3718,9,34017,1889,1,2,11,11,0
60381,153,3609,77,34,69,0,0,8,77,3,24,16,29,27,45,114,213,1,387,21,0,2,13,11,0
60382,153,3609,712,438,573,51,9,84,763,14,102,71,128,116,199,733,1364,8,11988,666,0,2,13,11,0
60385,221,4705,2,2,2,0,0,0,2,0,0,0,0,0,0,0,0,0,0,0,0,2,4,1,0
60399,221,4705,99,48,90,1,3,5,100,0,0,0,0,0,0,0,0,0,0,0,0,2,4,1,0
60400,221,4705,8,5,5,2,0,1,10,0,0,0,0,0,0,0,0,0,0,0,0,2,4,1,0
60401,221,4705,1217,716,841,84,126,174,1301,14,185,118,215,199,333,1446,2542,8,20687,1149,0,2,4,1,0
60402,221,4705,160,89,115,0,13,31,160,7,15,11,17,22,28,78,124,3,495,27,0,2,4,1,0
60403,221,4705,10,10,9,9,0,0,19,0,0,0,0,0,0,0,0,0,0,0,0,2,4,1,0
60404,221,4705,173,84,99,8,29,36,181,5,12,7,13,17,20,54,81,2,221,12,0,2,4,1,0
60405,221,4705,3,1,1,3,0,0,6,0,0,0,0,0,0,0,0,0,0,0,0,2,4,1,0
60406,43,2676,652,304,544,16,6,88,668,6,89,51,101,95,152,591,998,3,3399,188,0,2,36,0,0
60407,246,5902,722,423,573,19,0,135,741,12,172,101,199,184,300,1320,2257,6,15668,870,0,2,6,0,0
60408,246,5902,1508,847,911,44,250,301,1552,14,148,88,169,162,257,1120,1886,7,15077,837,0,2,6,0,0
60409,48,2297,722,423,573,19,0,135,741,12,172,101,199,184,300,1320,2257,6,15668,870,0,2,11,0,0
60410,159,3705,77,34,69,0,0,8,77,3,24,16,29,27,45,114,213,1,387,21,0,2,21,0,0
60411,159,3705,712,438,573,51,9,84,763,14,102,71,128,116,199,733,1364,8,11988,666,0,2,21,0,0
60412,81,4624,1296,573,1062,40,33,157,1336,8,201,118,231,209,349,1561,2689,4,12365,686,0,2,20,0,0
60420,245,5880,722,423,573,19,0,135,741,12,172,101,199,184,300,1320,2257,6,15668,870,0,2,5,1,0
60421,245,5880,1508,847,911,44,250,301,1552,14,148,88,169,162,257,1120,1886,7,15077,837,0,2,5,1,0
60422,45,1291,339,213,244,17,9,65,356,10,42,26,48,52,74,259,421,5,2410,133,0,2,22,13,1
60423,66,3225,1293,570,1093,25,15,163,1318,10,195,123,241,205,364,1516,2795,6,17273,959,0,2,70,0,1
60424,153,3613,77,34,69,0,0,8,77,3,24,16,29,27,45,114,213,1,387,21,0,2,1,1,0
60425,153,3613,712,438,573,51,9,84,763,14,102,71,128,116,199,733,1364,8,11988,666,0,2,1,1,0
60426,81,4663,1296,573,1062,40,33,157,1336,8,201,118,231,209,349,1561,2689,4,12365,686,0,2,29,0,0
60432,228,4801,2,2,2,0,0,0,2,0,0,0,0,0,0,0,0,0,0,0,0,2,38,8,0
60446,228,4801,99,48,90,1,3,5,100,0,0,0,0,0,0,0,0,0,0,0,0,2,38,8,0
60447,228,4801,8,5,5,2,0,1,10,0,0,0,0,0,0,0,0,0,0,0,0,2,38,8,0
60448,228,4801,1217,716,841,84,126,174,1301,14,185,118,215,199,333,1446,2542,8,20687,1149,0,2,38,8,0
60449,228,4801,160,89,115,0,13,31,160,7,15,11,17,22,28,78,124,3,495,27,0,2,38,8,0
60450,228,4801,10,10,9,9,0,0,19,0,0,0,0,0,0,0,0,0,0,0,0,2,38,8,0
60451,228,4801,173,84,99,8,29,36,181,5,12,7,13,17,20,54,81,2,221,12,0,2,38,8,0
60452,228,4801,3,1,1,3,0,0,6,0,0,0,0,0,0,0,0,0,0,0,0,2,38,8,0
60453,98,2019,463,295,324,28,62,57,491,12,134,82,154,146,236,989,1696,6,11700,650,0,2,8,11,0
60454,28,978,74,35,59,1,0,14,75,3,14,7,14,17,21,58,85,1,128,7,0,2,12,8,0
60455,28,978,245,125,200,5,7,34,250,7,30,17,34,37,51,166,265,3,1053,58,0,2,12,8,0
60456,92,4896,1457,730,1242,11,6,188,1468,10,292,166,329,302,495,2424,4078,5,22973,1276,1,2,73,3,0
60457,39,2350,334,251,279,10,4,40,344,5,127,74,143,132,217,899,1528,2,4303,239,0,2,3,4,0
60462,221,4705,2,2,2,0,0,0,2,0,0,0,0,0,0,0,0,0,0,0,0,2,1,1,0
60476,221,4705,99,48,90,1,3,5,100,0,0,0,0,0,0,0,0,0,0,0,0,2,1,1,0
60477,221,4705,8,5,5,2,0,1,10,0,0,0,0,0,0,0,0,0,0,0,0,2,1,1,0
60478,221,4705,1217,716,841,84,126,174,1301,14,185,118,215,199,333,1446,2542,8,20687,1149,0,2,1,1,0
60479,221,4705,160,89,115,0,13,31,160,7,15,11,17,22,28,78,124,3,495,27,0,2,1,1,0
60480,221,4705,10,10,9,9,0,0,19,0,0,0,0,0,0,0,0,0,0,0,0,2,1,1,0
60481,221,4705,173,84,99,8,29,36,181,5,12,7,13,17,20,54,81,2,221,12,0,2,1,1,0
60482,221,4705,3,1,1,3,0,0,6,0,0,0,0,0,0,0,0,0,0,0,0,2,1,1,0
60483,1,106,42,7,35,4,0,5,46,1,2,1,2,3,3,2,4,0,2,0,0,2,2,1,0
60484,1,106,11,6,10,0,0,1,11,2,4,2,4,6,6,10,15,1,15,0,0,2,2,1,0
60485,237,5024,1943,715,1694,26,18,214,1969,12,185,120,237,197,357,1436,2721,7,20915,1161,0,2,0,15,0
60486,237,5024,1168,838,957,57,25,144,1225,19,348,224,416,367,640,3018,5452,11,61921,3440,1,2,0,15,0
60487,100,4148,1289,550,1043,56,32,155,1345,10,167,93,185,177,278,1266,2075,5,11498,638,0,2,1,3,0
60488,14,843,75,38,59,1,3,12,76,2,4,2,4,6,6,10,15,1,15,0,0,2,0,19,0
60489,245,5666,4293,999,3693,19,54,507,4312,9,155,88,170,164,258,1156,1898,4,9368,520,0,2,2,2,0
60490,245,5666,1482,859,1002,125,135,219,1607,16,219,134,251,235,385,1766,3032,9,27804,1544,1,2,2,2,0
60521,45,1291,339,213,244,17,9,65,356,10,42,26,48,52,74,259,421,5,2410,133,0,2,22,13,0
60522,66,3225,1293,570,1093,25,15,163,1318,10,195,123,241,205,364,1516,2795,6,17273,959,0,2,70,0,0
60533,228,4805,2,2,2,0,0,0,2,0,0,0,0,0,0,0,0,0,0,0,0,2,4,1,0
60547,228,4805,99,48,90,1,3,5,100,0,0,0,0,0,0,0,0,0,0,0,0,2,4,1,0
60548,228,4805,8,5,5,2,0,1,10,0,0,0,0,0,0,0,0,0,0,0,0,2,4,1,0
60549,228,4805,1217,716,841,84,126,174,1301,14,185,118,215,199,333,1446,2542,8,20687,1149,0,2,4,1,0
60550,228,4805,160,89,115,0,13,31,160,7,15,11,17,22,28,78,124,3,495,27,0,2,4,1,0
60551,228,4805,10,10,9,9,0,0,19,0,0,0,0,0,0,0,0,0,0,0,0,2,4,1,0
60552,228,4805,173,84,99,8,29,36,181,5,12,7,13,17,20,54,81,2,221,12,0,2,4,1,0
60553,228,4805,3,1,1,3,0,0,6,0,0,0,0,0,0,0,0,0,0,0,0,2,4,1,0
60558,158,3715,77,34,69,0,0,8,77,3,24,16,29,27,45,114,213,1,387,21,0,2,14,12,0
60559,158,3715,712,438,573,51,9,84,763,14,102,71,128,116,199,733,1364,8,11988,666,0,2,14,12,0
60560,246,5918,722,423,573,19,0,135,741,12,172,101,199,184,300,1320,2257,6,15668,870,0,2,5,1,0
60561,246,5918,1508,847,911,44,250,301,1552,14,148,88,169,162,257,1120,1886,7,15077,837,0,2,5,1,0
60562,243,5077,1943,715,1694,26,18,214,1969,12,185,120,237,197,357,1436,2721,7,20915,1161,0,2,23,4,0
60563,243,5077,1168,838,957,57,25,144,1225,19,348,224,416,367,640,3018,5452,11,61921,3440,1,2,23,4,0
60564,82,4736,1296,573,1062,40,33,157,1336,8,201,118,231,209,349,1561,2689,4,12365,686,0,2,29,0,0
60605,153,3638,77,34,69,0,0,8,77,3,24,16,29,27,45,114,213,1,387,21,0,2,6,1,0
60606,153,3638,712,438,573,51,9,84,763,14,102,71,128,116,199,733,1364,8,11988,666,0,2,6,1,0
60607,314,6872,72,33,56,0,4,12,72,1,1,1,1,2,2,0,2,0,1,0,0,2,14,6,0
60608,314,6872,1454,835,1044,76,110,219,1530,17,275,158,296,292,454,2297,3718,9,34017,1889,1,2,14,6,0
60609,83,4788,1296,573,1062,40,33,157,1336,8,201,118,231,209,349,1561,2689,4,12365,686,0,2,27,0,0
60610,19,720,442,244,305,14,16,103,456,11,68,45,75,79,120,452,756,6,4588,254,0,2,1,1,0
60611,19,720,182,102,99,11,40,35,193,3,11,6,11,14,17,42,64,1,97,5,0,2,1,1,0
60619,74,1599,53,23,39,0,0,13,53,2,8,4,8,10,12,26,39,1,39,2,0,2,2,1,0
60620,74,1599,515,298,307,33,80,99,548,12,63,44,77,75,121,419,753,7,5527,307,0,2,2,1,0
60621,99,2610,773,422,505,30,103,129,803,14,77,46,83,91,129,535,839,7,6334,351,0,2,41,11,0
60622,35,2389,1157,318,931,29,22,177,1186,6,104,63,125,110,188,712,1274,3,4596,255,0,2,48,0,0
60623,248,5184,1943,715,1694,26,18,214,1969,12,185,120,237,197,357,1436,2721,7,20915,1161,0,2,3,1,1
60624,248,5184,1168,838,957,57,25,144,1225,19,348,224,416,367,640,3018,5452,11,61921,3440,1,2,3,1,1
60625,170,5066,1660,832,1314,41,38,274,1701,20,312,209,395,332,604,2671,5058,12,64042,3557,1,2,10,3,1
60626,248,5184,1943,715,1694,26,18,214,1969,12,185,120,237,197,357,1436,2721,7,20915,1161,0,2,3,1,0
60627,248,5184,1168,838,957,57,25,144,1225,19,348,224,416,367,640,3018,5452,11,61921,3440,1,2,3,1,0
60628,170,5066,1660,832,1314,41,38,274,1701,20,312,209,395,332,604,2671,5058,12,64042,3557,1,2,10,3,0
60631,99,2574,773,422,505,30,103,129,803,14,77,46,83,91,129,535,839,7,6334,351,0,2,41,11,0
60633,158,3740,77,34,69,0,0,8,77,3,24,16,29,27,45,114,213,1,387,21,0,2,6,1,0
60634,158,3740,712,438,573,51,9,84,763,14,102,71,128,116,199,733,1364,8,11988,666,0,2,6,1,0
60639,244,5083,1943,715,1694,26,18,214,1969,12,185,120,237,197,357,1436,2721,7,20915,1161,0,2,3,1,0
60640,244,5083,1168,838,957,57,25,144,1225,19,348,224,416,367,640,3018,5452,11,61921,3440,1,2,3,1,0
60644,84,4861,1296,573,1062,40,33,157,1336,8,201,118,231,209,349,1561,2689,4,12365,686,0,2,27,0,0
60645,95,2929,773,419,590,28,0,166,801,10,204,113,217,214,330,1598,2554,5,13587,754,0,2,8,3,0
60646,81,3273,1178,367,1042,6,15,115,1184,9,94,51,95,103,146,644,976,4,4439,246,0,2,4,1,0
60651,228,4805,2,2,2,0,0,0,2,0,0,0,0,0,0,0,0,0,0,0,0,2,38,8,0
60665,228,4805,99,48,90,1,3,5,100,0,0,0,0,0,0,0,0,0,0,0,0,2,38,8,0
60666,228,4805,8,5,5,2,0,1,10,0,0,0,0,0,0,0,0,0,0,0,0,2,38,8,0
60667,228,4805,1217,716,841,84,126,174,1301,14,185,118,215,199,333,1446,2542,8,20687,1149,0,2,38,8,0
60668,228,4805,160,89,115,0,13,31,160,7,15,11,17,22,28,78,124,3,495,27,0,2,38,8,0
60669,228,4805,10,10,9,9,0,0,19,0,0,0,0,0,0,0,0,0,0,0,0,2,38,8,0
60670,228,4805,173,84,99,8,29,36,181,5,12,7,13,17,20,54,81,2,221,12,0,2,38,8,0
60671,228,4805,3,1,1,3,0,0,6,0,0,0,0,0,0,0,0,0,0,0,0,2,38,8,0
60677,158,3740,77,34,69,0,0,8,77,3,24,16,29,27,45,114,213,1,387,21,0,2,21,0,0
60678,158,3740,712,438,573,51,9,84,763,14,102,71,128,116,199,733,1364,8,11988,666,0,2,21,0,0
60679,246,5918,722,423,573,19,0,135,741,12,172,101,199,184,300,1320,2257,6,15668,870,0,2,6,0,0
60680,246,5918,1508,847,911,44,250,301,1552,14,148,88,169,162,257,1120,1886,7,15077,837,0,2,6,0,0
60683,244,5083,1943,715,1694,26,18,214,1969,12,185,120,237,197,357,1436,2721,7,20915,1161,0,2,0,15,0
60684,244,5083,1168,838,957,57,25,144,1225,19,348,224,416,367,640,3018,5452,11,61921,3440,1,2,0,15,0
60686,14,843,75,38,59,1,3,12,76,2,4,2,4,6,6,10,15,1,15,0,0,2,7,17,0
60688,84,4861,1296,573,1062,40,33,157,1336,8,201,118,231,209,349,1561,2689,4,12365,686,0,2,20,0,0
60709,100,2600,773,422,505,30,103,129,803,14,77,46,83,91,129,535,839,7,6334,351,0,2,5,0,0
60710,36,2459,1157,318,931,29,22,177,1186,6,104,63,125,110,188,712,1274,3,4596,255,0,2,34,0,0
60713,124,4939,1450,624,1228,12,26,181,1462,14,306,186,354,320,540,2580,4493,8,36391,2021,1,2,1,1,0
60714,92,4912,1457,730,1242,11,6,188,1468,10,292,166,329,302,495,2424,4078,5,22973,1276,1,2,7,7,0
60727,1,106,42,7,35,4,0,5,46,1,2,1,2,3,3,2,4,0,2,0,0,2,1,1,0
60728,1,106,11,6,10,0,0,1,11,2,4,2,4,6,6,10,15,1,15,0,0,2,1,1,0
60733,230,4829,2,2,2,0,0,0,2,0,0,0,0,0,0,0,0,0,0,0,0,2,17,9,0
60747,230,4829,99,48,90,1,3,5,100,0,0,0,0,0,0,0,0,0,0,0,0,2,17,9,0
60748,230,4829,8,5,5,2,0,1,10,0,0,0,0,0,0,0,0,0,0,0,0,2,17,9,0
60749,230,4829,1217,716,841,84,126,174,1301,14,185,118,215,199,333,1446,2542,8,20687,1149,0,2,17,9,0
60750,230,4829,160,89,115,0,13,31,160,7,15,11,17,22,28,78,124,3,495,27,0,2,17,9,0
60751,230,4829,10,10,9,9,0,0,19,0,0,0,0,0,0,0,0,0,0,0,0,2,17,9,0
60752,230,4829,173,84,99,8,29,36,181,5,12,7,13,17,20,54,81,2,221,12,0,2,17,9,0
60753,230,4829,3,1,1,3,0,0,6,0,0,0,0,0,0,0,0,0,0,0,0,2,17,9,0
60754,28,978,74,35,59,1,0,14,75,3,14,7,14,17,21,58,85,1,128,7,0,2,1,1,0
60755,28,978,245,125,200,5,7,34,250,7,30,17,34,37,51,166,265,3,1053,58,0,2,1,1,0
60756,111,4421,1289,550,1043,56,32,155,1345,10,167,93,185,177,278,1266,2075,5,11498,638,0,2,55,0,0
60757,96,4991,1457,730,1242,11,6,188,1468,10,292,166,329,302,495,2424,4078,5,22973,1276,1,2,24,1,0
60789,1,108,42,7,35,4,0,5,46,1,2,1,2,3,3,2,4,0,2,0,0,2,1,0,0
60790,1,108,11,6,10,0,0,1,11,2,4,2,4,6,6,10,15,1,15,0,0,2,1,0,0
60791,38,2327,334,251,279,10,4,40,344,5,127,74,143,132,217,899,1528,2,4303,239,0,2,6,5,0
60795,48,1340,339,213,244,17,9,65,356,10,42,26,48,52,74,259,421,5,2410,133,0,2,22,5,1
60796,67,3269,1293,570,1093,25,15,163,1318,10,195,123,241,205,364,1516,2795,6,17273,959,0,2,14,0,1
60797,157,3295,1513,682,1277,25,13,200,1538,11,199,116,219,210,335,1557,2584,6,15641,868,0,2,5,0,1
60798,157,3295,819,519,539,24,98,155,843,15,96,57,106,111,163,690,1107,8,9171,509,0,2,5,0,1
60799,125,5375,1513,682,1277,25,13,200,1538,11,199,116,219,210,335,1557,2584,6,15641,868,0,2,24,0,1
60800,157,3295,1513,682,1277,25,13,200,1538,11,199,116,219,210,335,1557,2584,6,15641,868,0,2,5,0,0
60801,157,3295,819,519,539,24,98,155,843,15,96,57,106,111,163,690,1107,8,9171,509,0,2,5,0,0
60802,125,5375,1513,682,1277,25,13,200,1538,11,199,116,219,210,335,1557,2584,6,15641,868,0,2,24,0,0
60803,183,5547,1660,832,1314,41,38,274,1701,20,312,209,395,332,604,2671,5058,12,64042,3557,1,2,3,3,0
60804,183,5547,1057,646,719,113,100,145,1170,18,215,134,248,233,382,1740,3004,10,31186,1732,1,2,3,3,0
60805,2,40,9,6,6,0,0,3,9,0,0,0,0,0,0,0,0,0,0,0,0,2,0,1,0
60806,2,40,13,9,8,0,0,4,13,0,0,0,0,0,0,0,0,0,0,0,0,2,0,1,0
60807,1,108,42,7,35,4,0,5,46,1,2,1,2,3,3,2,4,0,2,0,0,2,0,1,0
60808,1,108,11,6,10,0,0,1,11,2,4,2,4,6,6,10,15,1,15,0,0,2,0,1,0
60809,17,348,95,58,50,9,16,20,104,12,33,24,45,45,69,209,378,8,3100,172,0,2,0,1,0
60811,52,625,647,139,84,35,284,233,682,0,0,0,0,0,0,0,0,0,0,0,0,2,0,1,0
60812,100,2600,773,422,505,30,103,129,803,14,77,46,83,91,129,535,839,7,6334,351,0,2,0,1,0
60813,158,3740,77,34,69,0,0,8,77,3,24,16,29,27,45,114,213,1,387,21,0,2,0,1,0
60814,158,3740,712,438,573,51,9,84,763,14,102,71,128,116,199,733,1364,8,11988,666,0,2,0,1,0
60815,69,1497,402,202,227,24,74,80,426,12,52,33,61,64,94,339,564,7,3969,220,0,2,0,1,0
60816,59,1228,91,45,69,0,3,18,91,3,9,6,10,12,16,33,57,1,95,5,0,2,0,1,0
60817,59,1228,367,234,237,17,34,68,384,16,55,34,61,71,95,381,584,8,5183,287,0,2,0,1,0
60818,95,2929,773,419,590,28,0,166,801,10,204,113,217,214,330,1598,2554,5,13587,754,0,2,0,1,0
60819,4,163,27,21,21,0,0,6,27,3,6,3,6,9,9,20,28,1,42,2,0,2,0,1,0
60820,15,1066,215,129,180,6,0,29,221,8,65,43,72,73,115,415,711,4,3153,175,0,2,0,1,0
60821,53,1862,601,196,481,2,23,85,603,8,63,36,72,71,108,400,664,4,3036,168,0,2,0,1,0
60824,49,1371,339,213,244,17,9,65,356,10,42,26,48,52,74,259,421,5,2410,133,0,2,24,17,1
60825,68,3294,1293,570,1093,25,15,163,1318,10,195,123,241,205,364,1516,2795,6,17273,959,0,2,11,6,1
60826,49,1371,339,213,244,17,9,65,356,10,42,26,48,52,74,259,421,5,2410,133,0,2,29,5,0
60827,68,3294,1293,570,1093,25,15,163,1318,10,195,123,241,205,364,1516,2795,6,17273,959,0,2,19,0,0
60828,246,5928,722,423,573,19,0,135,741,12,172,101,199,184,300,1320,2257,6,15668,870,0,2,1,0,0
60829,246,5928,1508,847,911,44,250,301,1552,14,148,88,169,162,257,1120,1886,7,15077,837,0,2,1,0,0
60849,78,1822,996,429,845,24,10,117,1020,7,76,50,88,83,138,494,879,4,3565,198,0,2,10,13,0
60850,78,1822,456,277,329,12,42,72,468,13,85,50,97,98,147,592,972,7,7212,400,0,2,10,13,0
60853,248,5735,4293,999,3693,19,54,507,4312,9,155,88,170,164,258,1156,1898,4,9368,520,0,2,18,5,1
60854,248,5735,1482,859,1002,125,135,219,1607,16,219,134,251,235,385,1766,3032,9,27804,1544,1,2,18,5,1
60855,95,2086,1043,504,840,53,9,147,1096,9,180,112,198,189,310,1377,2344,4,11604,644,0,2,1,0,1
60856,95,2086,383,288,292,26,6,62,409,11,65,38,67,76,105,429,656,5,3719,206,0,2,1,0,1
60857,170,7538,139,89,101,2,0,35,141,7,54,34,62,61,96,330,569,4,2287,127,0,2,1,1,1
60858,170,7538,7,5,5,0,0,2,7,1,2,1,2,3,3,2,4,0,2,0,0,2,1,1,1
60861,171,7568,4293,999,3693,19,54,507,4312,9,155,88,170,164,258,1156,1898,4,9368,520,0,2,38,0,0
60862,171,7568,1482,859,1002,125,135,219,1607,16,219,134,251,235,385,1766,3032,9,27804,1544,1,2,38,0,0
60863,248,5735,4293,999,3693,19,54,507,4312,9,155,88,170,164,258,1156,1898,4,9368,520,0,2,0,1,0
60864,248,5735,1482,859,1002,125,135,219,1607,16,219,134,251,235,385,1766,3032,9,27804,1544,1,2,0,1,0
60865,95,2085,1043,504,840,53,9,147,1096,9,180,112,198,189,310,1377,2344,4,11604,644,0,2,0,1,0
60866,95,2085,383,288,292,26,6,62,409,11,65,38,67,76,105,429,656,5,3719,206,0,2,0,1,0
60867,171,7568,4293,999,3693,19,54,507,4312,9,155,88,170,164,258,1156,1898,4,9368,520,0,2,1,1,0
60868,171,7568,1482,859,1002,125,135,219,1607,16,219,134,251,235,385,1766,3032,9,27804,1544,1,2,1,1,0
60869,247,5132,1943,715,1694,26,18,214,1969,12,185,120,237,197,357,1436,2721,7,20915,1161,0,2,6,1,1
60870,247,5132,1168,838,957,57,25,144,1225,19,348,224,416,367,640,3018,5452,11,61921,3440,1,2,6,1,1
60871,102,5395,1943,715,1694,26,18,214,1969,12,185,120,237,197,357,1436,2721,7,20915,1161,0,2,20,0,1
60872,247,5125,1943,715,1694,26,18,214,1969,12,185,120,237,197,357,1436,2721,7,20915,1161,0,2,7,7,0
60873,247,5125,1168,838,957,57,25,144,1225,19,348,224,416,367,640,3018,5452,11,61921,3440,1,2,7,7,0
60874,96,4991,1457,730,1242,11,6,188,1468,10,292,166,329,302,495,2424,4078,5,22973,1276,1,2,3,3,0
60875,30,1324,373,158,315,8,0,51,381,5,76,44,79,81,123,486,779,2,2026,112,0,2,1,1,0
60876,101,5370,1943,715,1694,26,18,214,1969,12,185,120,237,197,357,1436,2721,7,20915,1161,0,2,10,10,0
60877,247,5125,1943,715,1694,26,18,214,1969,12,185,120,237,197,357,1436,2721,7,20915,1161,0,2,11,6,0
60878,247,5125,1168,838,957,57,25,144,1225,19,348,224,416,367,640,3018,5452,11,61921,3440,1,2,11,6,0
60881,101,5370,1943,715,1694,26,18,214,1969,12,185,120,237,197,357,1436,2721,7,20915,1161,0,2,29,9,0
60882,1,94,42,7,35,4,0,5,46,1,2,1,2,3,3,2,4,0,2,0,0,2,1,8,0
60883,1,94,11,6,10,0,0,1,11,2,4,2,4,6,6,10,15,1,15,0,0,2,1,8,0
60886,171,7568,4293,999,3693,19,54,507,4312,9,155,88,170,164,258,1156,1898,4,9368,520,0,2,3,3,0
60887,171,7568,1482,859,1002,125,135,219,1607,16,219,134,251,235,385,1766,3032,9,27804,1544,1,2,3,3,0
60888,248,5735,4293,999,3693,19,54,507,4312,9,155,88,170,164,258,1156,1898,4,9368,520,0,2,17,5,0
60889,248,5735,1482,859,1002,125,135,219,1607,16,219,134,251,235,385,1766,3032,9,27804,1544,1,2,17,5,0
60890,171,7568,4293,999,3693,19,54,507,4312,9,155,88,170,164,258,1156,1898,4,9368,520,0,3,38,0,0
60891,171,7568,1482,859,1002,125,135,219,1607,16,219,134,251,235,385,1766,3032,9,27804,1544,1,3,38,0,0
60892,125,5391,1513,682,1277,25,13,200,1538,11,199,116,219,210,335,1557,2584,6,15641,868,0,2,14,6,0
60894,169,5066,1660,832,1314,41,38,274,1701,20,312,209,395,332,604,2671,5058,12,64042,3557,1,2,1,2,1
60895,169,5066,1660,832,1314,41,38,274,1701,20,312,209,395,332,604,2671,5058,12,64042,3557,1,2,1,2,0
60898,1,94,42,7,35,4,0,5,46,1,2,1,2,3,3,2,4,0,2,0,0,2,2,9,0
60899,1,94,11,6,10,0,0,1,11,2,4,2,4,6,6,10,15,1,15,0,0,2,2,9,0
60914,125,5391,1513,682,1277,25,13,200,1538,11,199,116,219,210,335,1557,2584,6,15641,868,0,2,38,6,0
60920,228,4805,2,2,2,0,0,0,2,0,0,0,0,0,0,0,0,0,0,0,0,2,1,1,0
60934,228,4805,99,48,90,1,3,5,100,0,0,0,0,0,0,0,0,0,0,0,0,2,1,1,0
60935,228,4805,8,5,5,2,0,1,10,0,0,0,0,0,0,0,0,0,0,0,0,2,1,1,0
60936,228,4805,1217,716,841,84,126,174,1301,14,185,118,215,199,333,1446,2542,8,20687,1149,0,2,1,1,0
60937,228,4805,160,89,115,0,13,31,160,7,15,11,17,22,28,78,124,3,495,27,0,2,1,1,0
60938,228,4805,10,10,9,9,0,0,19,0,0,0,0,0,0,0,0,0,0,0,0,2,1,1,0
60939,228,4805,173,84,99,8,29,36,181,5,12,7,13,17,20,54,81,2,221,12,0,2,1,1,0
60940,228,4805,3,1,1,3,0,0,6,0,0,0,0,0,0,0,0,0,0,0,0,2,1,1,0
60963,233,5719,722,423,573,19,0,135,741,12,172,101,199,184,300,1320,2257,6,15668,870,0,2,0,42,0
60964,233,5719,1508,847,911,44,250,301,1552,14,148,88,169,162,257,1120,1886,7,15077,837,0,2,0,42,0
60967,313,6859,72,33,56,0,4,12,72,1,1,1,1,2,2,0,2,0,1,0,0,2,16,17,1
60968,313,6859,1454,835,1044,76,110,219,1530,17,275,158,296,292,454,2297,3718,9,34017,1889,1,2,16,17,1
60969,313,6859,72,33,56,0,4,12,72,1,1,1,1,2,2,0,2,0,1,0,0,2,2,2,0
60970,313,6859,1454,835,1044,76,110,219,1530,17,275,158,296,292,454,2297,3718,9,34017,1889,1,2,2,2,0
60971,313,6859,72,33,56,0,4,12,72,1,1,1,1,2,2,0,2,0,1,0,0,2,16,17,0
60972,313,6859,1454,835,1044,76,110,219,1530,17,275,158,296,292,454,2297,3718,9,34017,1889,1,2,16,17,0
60973,246,5918,722,423,573,19,0,135,741,12,172,101,199,184,300,1320,2257,6,15668,870,0,2,1,1,0
60974,246,5918,1508,847,911,44,250,301,1552,14,148,88,169,162,257,1120,1886,7,15077,837,0,2,1,1,0
60977,183,5550,1660,832,1314,41,38,274,1701,20,312,209,395,332,604,2671,5058,12,64042,3557,1,2,3,3,0
60978,183,5550,1057,646,719,113,100,145,1170,18,215,134,248,233,382,1740,3004,10,31186,1732,1,2,3,3,0
60979,84,4869,1296,573,1062,40,33,157,1336,8,201,118,231,209,349,1561,2689,4,12365,686,0,2,2,1,0
60981,48,1338,339,213,244,17,9,65,356,10,42,26,48,52,74,259,421,5,2410,133,0,2,6,11,1
60982,311,6810,72,33,56,0,4,12,72,1,1,1,1,2,2,0,2,0,1,0,0,2,9,22,1
60983,311,6810,1454,835,1044,76,110,219,1530,17,275,158,296,292,454,2297,3718,9,34017,1889,1,2,9,22,1
60984,48,1338,339,213,244,17,9,65,356,10,42,26,48,52,74,259,421,5,2410,133,0,2,1,1,0
60985,309,6777,72,33,56,0,4,12,72,1,1,1,1,2,2,0,2,0,1,0,0,2,0,5,0
60986,309,6777,1454,835,1044,76,110,219,1530,17,275,158,296,292,454,2297,3718,9,34017,1889,1,2,0,5,0
60987,48,1338,339,213,244,17,9,65,356,10,42,26,48,52,74,259,421,5,2410,133,0,2,6,11,0
60988,309,6777,72,33,56,0,4,12,72,1,1,1,1,2,2,0,2,0,1,0,0,2,4,22,0
60989,309,6777,1454,835,1044,76,110,219,1530,17,275,158,296,292,454,2297,3718,9,34017,1889,1,2,4,22,0
60990,183,5550,1660,832,1314,41,38,274,1701,20,312,209,395,332,604,2671,5058,12,64042,3557,1,2,2,0,0
60991,183,5550,1057,646,719,113,100,145,1170,18,215,134,248,233,382,1740,3004,10,31186,1732,1,2,2,0,0
60992,183,5550,1660,832,1314,41,38,274,1701,20,312,209,395,332,604,2671,5058,12,64042,3557,1,2,5,3,0
60993,183,5550,1057,646,719,113,100,145,1170,18,215,134,248,233,382,1740,3004,10,31186,1732,1,2,5,3,0
60994,230,4967,182,127,129,0,0,53,182,5,39,21,42,44,63,217,343,2,926,51,0,2,7,12,0
60995,230,4967,1165,710,800,67,119,181,1232,18,243,153,282,261,435,2000,3492,10,36473,2026,1,2,7,12,0
60996,1,323,382,65,130,157,2,92,539,4,10,5,10,14,15,41,57,2,114,6,0,2,1,1,0
60997,170,5135,1660,832,1314,41,38,274,1701,20,312,209,395,332,604,2671,5058,12,64042,3557,1,2,23,0,0
61002,66,3225,1293,570,1093,25,15,163,1318,10,195,123,241,205,364,1516,2795,6,17273,959,0,2,2,4,0
61003,66,3254,1293,570,1093,25,15,163,1318,10,195,123,241,205,364,1516,2795,6,17273,959,0,2,10,3,1
61004,48,1341,339,213,244,17,9,65,356,10,42,26,48,52,74,259,421,5,2410,133,0,2,2,2,0
61005,311,6841,72,33,56,0,4,12,72,1,1,1,1,2,2,0,2,0,1,0,0,2,10,0,0
61006,311,6841,1454,835,1044,76,110,219,1530,17,275,158,296,292,454,2297,3718,9,34017,1889,1,2,10,0,0
61007,112,4510,1289,550,1043,56,32,155,1345,10,167,93,185,177,278,1266,2075,5,11498,638,0,2,28,0,0
61009,66,3254,1293,570,1093,25,15,163,1318,10,195,123,241,205,364,1516,2795,6,17273,959,0,2,12,7,0
61011,183,5553,1660,832,1314,41,38,274,1701,20,312,209,395,332,604,2671,5058,12,64042,3557,1,2,5,3,0
61012,183,5553,1057,646,719,113,100,145,1170,18,215,134,248,233,382,1740,3004,10,31186,1732,1,2,5,3,0
61015,230,4829,2,2,2,0,0,0,2,0,0,0,0,0,0,0,0,0,0,0,0,2,1,1,0
61029,230,4829,99,48,90,1,3,5,100,0,0,0,0,0,0,0,0,0,0,0,0,2,1,1,0
61030,230,4829,8,5,5,2,0,1,10,0,0,0,0,0,0,0,0,0,0,0,0,2,1,1,0
61031,230,4829,1217,716,841,84,126,174,1301,14,185,118,215,199,333,1446,2542,8,20687,1149,0,2,1,1,0
61032,230,4829,160,89,115,0,13,31,160,7,15,11,17,22,28,78,124,3,495,27,0,2,1,1,0
61033,230,4829,10,10,9,9,0,0,19,0,0,0,0,0,0,0,0,0,0,0,0,2,1,1,0
61034,230,4829,173,84,99,8,29,36,181,5,12,7,13,17,20,54,81,2,221,12,0,2,1,1,0
61035,230,4829,3,1,1,3,0,0,6,0,0,0,0,0,0,0,0,0,0,0,0,2,1,1,0
61036,233,5719,722,423,573,19,0,135,741,12,172,101,199,184,300,1320,2257,6,15668,870,0,2,1,1,0
61037,233,5719,1508,847,911,44,250,301,1552,14,148,88,169,162,257,1120,1886,7,15077,837,0,2,1,1,0
61038,308,6764,72,33,56,0,4,12,72,1,1,1,1,2,2,0,2,0,1,0,0,2,16,17,0
61039,308,6764,1454,835,1044,76,110,219,1530,17,275,158,296,292,454,2297,3718,9,34017,1889,1,2,16,17,0
61042,68,3323,1293,570,1093,25,15,163,1318,10,195,123,241,205,364,1516,2795,6,17273,959,0,2,12,7,0
61076,95,2385,1455,414,1257,16,76,112,1471,5,41,23,46,46,69,231,381,2,1069,59,0,2,3,0,0
61077,95,2385,669,365,481,22,61,110,691,15,103,63,122,118,185,747,1273,8,11311,628,0,2,3,0,0
61078,245,5668,4293,999,3693,19,54,507,4312,9,155,88,170,164,258,1156,1898,4,9368,520,0,2,1,1,0
61079,245,5668,1482,859,1002,125,135,219,1607,16,219,134,251,235,385,1766,3032,9,27804,1544,1,2,1,1,0
61080,170,7538,139,89,101,2,0,35,141,7,54,34,62,61,96,330,569,4,2287,127,0,2,2,2,0
61081,170,7538,7,5,5,0,0,2,7,1,2,1,2,3,3,2,4,0,2,0,0,2,2,2,0
61082,72,3308,1455,414,1257,16,76,112,1471,5,41,23,46,46,69,231,381,2,1069,59,0,2,12,0,0
61083,21,541,205,80,86,16,53,53,221,7,18,10,19,25,29,94,134,3,497,27,0,2,5,1,0
61084,21,541,205,80,86,16,53,53,221,7,18,10,19,25,29,94,134,3,497,27,0,2,1,1,0
61090,310,6828,72,33,56,0,4,12,72,1,1,1,1,2,2,0,2,0,1,0,0,2,10,0,0
61091,310,6828,1454,835,1044,76,110,219,1530,17,275,158,296,292,454,2297,3718,9,34017,1889,1,2,10,0,0
61093,233,5732,722,423,573,19,0,135,741,12,172,101,199,184,300,1320,2257,6,15668,870,0,2,2,0,1
61094,233,5732,1508,847,911,44,250,301,1552,14,148,88,169,162,257,1120,1886,7,15077,837,0,2,2,0,1
61095,49,2385,722,423,573,19,0,135,741,12,172,101,199,184,300,1320,2257,6,15668,870,0,2,16,0,1
61096,233,5732,722,423,573,19,0,135,741,12,172,101,199,184,300,1320,2257,6,15668,870,0,2,2,0,0
61097,233,5732,1508,847,911,44,250,301,1552,14,148,88,169,162,257,1120,1886,7,15077,837,0,2,2,0,0
61098,49,2385,722,423,573,19,0,135,741,12,172,101,199,184,300,1320,2257,6,15668,870,0,2,16,0,0
61101,233,4889,2,2,2,0,0,0,2,0,0,0,0,0,0,0,0,0,0,0,0,2,8,0,0
61115,233,4889,99,48,90,1,3,5,100,0,0,0,0,0,0,0,0,0,0,0,0,2,8,0,0
61116,233,4889,8,5,5,2,0,1,10,0,0,0,0,0,0,0,0,0,0,0,0,2,8,0,0
61117,233,4889,1217,716,841,84,126,174,1301,14,185,118,215,199,333,1446,2542,8,20687,1149,0,2,8,0,0
61118,233,4889,160,89,115,0,13,31,160,7,15,11,17,22,28,78,124,3,495,27,0,2,8,0,0
61119,233,4889,10,10,9,9,0,0,19,0,0,0,0,0,0,0,0,0,0,0,0,2,8,0,0
61120,233,4889,173,84,99,8,29,36,181,5,12,7,13,17,20,54,81,2,221,12,0,2,8,0,0
61121,233,4889,3,1,1,3,0,0,6,0,0,0,0,0,0,0,0,0,0,0,0,2,8,0,0
61122,29,1886,384,251,317,7,8,52,391,11,70,44,84,81,128,467,811,6,5355,297,0,2,7,0,0
61148,157,3301,1513,682,1277,25,13,200,1538,11,199,116,219,210,335,1557,2584,6,15641,868,0,2,4,1,0
61149,157,3301,819,519,539,24,98,155,843,15,96,57,106,111,163,690,1107,8,9171,509,0,2,4,1,0
61150,125,5391,1513,682,1277,25,13,200,1538,11,199,116,219,210,335,1557,2584,6,15641,868,0,2,8,1,0
61153,24,614,2,2,2,0,0,0,2,0,0,0,0,0,0,0,0,0,0,0,0,2,1,0,0
61167,24,614,99,48,90,1,3,5,100,0,0,0,0,0,0,0,0,0,0,0,0,2,1,0,0
61168,24,614,8,5,5,2,0,1,10,0,0,0,0,0,0,0,0,0,0,0,0,2,1,0,0
61169,24,614,1217,716,841,84,126,174,1301,14,185,118,215,199,333,1446,2542,8,20687,1149,0,2,1,0,0
61170,24,614,160,89,115,0,13,31,160,7,15,11,17,22,28,78,124,3,495,27,0,2,1,0,0
61171,24,614,10,10,9,9,0,0,19,0,0,0,0,0,0,0,0,0,0,0,0,2,1,0,0
61172,24,614,173,84,99,8,29,36,181,5,12,7,13,17,20,54,81,2,221,12,0,2,1,0,0
61173,24,614,3,1,1,3,0,0,6,0,0,0,0,0,0,0,0,0,0,0,0,2,1,0,0
61178,233,5758,722,423,573,19,0,135,741,12,172,101,199,184,300,1320,2257,6,15668,870,0,2,2,0,0
61179,233,5758,1508,847,911,44,250,301,1552,14,148,88,169,162,257,1120,1886,7,15077,837,0,2,2,0,0
61180,100,4734,1523,757,1297,19,12,193,1542,12,193,117,230,205,347,1508,2664,7,19053,1058,0,2,1,5,0
61181,68,3312,1293,570,1093,25,15,163,1318,10,195,123,241,205,364,1516,2795,6,17273,959,0,2,0,3,0
61190,159,3342,1513,682,1277,25,13,200,1538,11,199,116,219,210,335,1557,2584,6,15641,868,0,2,39,26,0
61191,159,3342,819,519,539,24,98,155,843,15,96,57,106,111,163,690,1107,8,9171,509,0,2,39,26,0
61192,125,5391,1513,682,1277,25,13,200,1538,11,199,116,219,210,335,1557,2584,6,15641,868,0,2,1,1,0
61193,159,3338,1513,682,1277,25,13,200,1538,11,199,116,219,210,335,1557,2584,6,15641,868,0,2,10,14,0
61194,159,3338,819,519,539,24,98,155,843,15,96,57,106,111,163,690,1107,8,9171,509,0,2,10,14,0
61199,37,940,466,257,367,18,25,50,484,7,126,86,171,133,257,898,1813,4,8612,478,0,2,83,0,0
61200,37,940,507,281,342,29,59,88,536,10,53,29,57,63,86,336,514,5,2764,153,0,2,83,0,0
61201,89,1894,1043,504,840,53,9,147,1096,9,180,112,198,189,310,1377,2344,4,11604,644,0,2,1,37,0
61202,89,1894,383,288,292,26,6,62,409,11,65,38,67,76,105,429,656,5,3719,206,0,2,1,37,0
61203,249,5128,1943,715,1694,26,18,214,1969,12,185,120,237,197,357,1436,2721,7,20915,1161,0,2,22,17,0
61204,249,5128,1168,838,957,57,25,144,1225,19,348,224,416,367,640,3018,5452,11,61921,3440,1,2,22,17,0
61205,102,5449,1943,715,1694,26,18,214,1969,12,185,120,237,197,357,1436,2721,7,20915,1161,0,2,15,0,0
61213,159,3344,1513,682,1277,25,13,200,1538,11,199,116,219,210,335,1557,2584,6,15641,868,0,2,49,40,0
61214,159,3344,819,519,539,24,98,155,843,15,96,57,106,111,163,690,1107,8,9171,509,0,2,49,40,0
61216,233,5797,722,423,573,19,0,135,741,12,172,101,199,184,300,1320,2257,6,15668,870,0,2,10,2,0
61217,233,5797,1508,847,911,44,250,301,1552,14,148,88,169,162,257,1120,1886,7,15077,837,0,2,10,2,0
61218,100,4747,1523,757,1297,19,12,193,1542,12,193,117,230,205,347,1508,2664,7,19053,1058,0,2,2,1,0
61228,234,4906,2,2,2,0,0,0,2,0,0,0,0,0,0,0,0,0,0,0,0,2,8,3,0
61242,234,4906,99,48,90,1,3,5,100,0,0,0,0,0,0,0,0,0,0,0,0,2,8,3,0
61243,234,4906,8,5,5,2,0,1,10,0,0,0,0,0,0,0,0,0,0,0,0,2,8,3,0
61244,234,4906,1217,716,841,84,126,174,1301,14,185,118,215,199,333,1446,2542,8,20687,1149,0,2,8,3,0
61245,234,4906,160,89,115,0,13,31,160,7,15,11,17,22,28,78,124,3,495,27,0,2,8,3,0
61246,234,4906,10,10,9,9,0,0,19,0,0,0,0,0,0,0,0,0,0,0,0,2,8,3,0
61247,234,4906,173,84,99,8,29,36,181,5,12,7,13,17,20,54,81,2,221,12,0,2,8,3,0
61248,234,4906,3,1,1,3,0,0,6,0,0,0,0,0,0,0,0,0,0,0,0,2,8,3,0
61249,97,5074,1457,730,1242,11,6,188,1468,10,292,166,329,302,495,2424,4078,5,22973,1276,1,2,13,0,0
61250,249,5132,1943,715,1694,26,18,214,1969,12,185,120,237,197,357,1436,2721,7,20915,1161,0,2,2,2,0
61251,249,5132,1168,838,957,57,25,144,1225,19,348,224,416,367,640,3018,5452,11,61921,3440,1,2,2,2,0
61252,97,5072,1457,730,1242,11,6,188,1468,10,292,166,329,302,495,2424,4078,5,22973,1276,1,2,1,1,0
61253,248,5116,1943,715,1694,26,18,214,1969,12,185,120,237,197,357,1436,2721,7,20915,1161,0,2,0,2,0
61254,248,5116,1168,838,957,57,25,144,1225,19,348,224,416,367,640,3018,5452,11,61921,3440,1,2,0,2,0
61278,248,5116,1943,715,1694,26,18,214,1969,12,185,120,237,197,357,1436,2721,7,20915,1161,0,2,1,3,0
61279,248,5116,1168,838,957,57,25,144,1225,19,348,224,416,367,640,3018,5452,11,61921,3440,1,2,1,3,0
61280,97,5072,1457,730,1242,11,6,188,1468,10,292,166,329,302,495,2424,4078,5,22973,1276,1,2,13,0,0
61281,78,1822,996,429,845,24,10,117,1020,7,76,50,88,83,138,494,879,4,3565,198,0,2,3,4,0
61282,78,1822,456,277,329,12,42,72,468,13,85,50,97,98,147,592,972,7,7212,400,0,2,3,4,0
61285,248,5119,1943,715,1694,26,18,214,1969,12,185,120,237,197,357,1436,2721,7,20915,1161,0,2,3,1,0
61286,248,5119,1168,838,957,57,25,144,1225,19,348,224,416,367,640,3018,5452,11,61921,3440,1,2,3,1,0
61287,103,5526,1943,715,1694,26,18,214,1969,12,185,120,237,197,357,1436,2721,7,20915,1161,0,2,25,0,0
61293,234,4911,2,2,2,0,0,0,2,0,0,0,0,0,0,0,0,0,0,0,0,2,1,1,0
61307,234,4911,99,48,90,1,3,5,100,0,0,0,0,0,0,0,0,0,0,0,0,2,1,1,0
61308,234,4911,8,5,5,2,0,1,10,0,0,0,0,0,0,0,0,0,0,0,0,2,1,1,0
61309,234,4911,1217,716,841,84,126,174,1301,14,185,118,215,199,333,1446,2542,8,20687,1149,0,2,1,1,0
61310,234,4911,160,89,115,0,13,31,160,7,15,11,17,22,28,78,124,3,495,27,0,2,1,1,0
61311,234,4911,10,10,9,9,0,0,19,0,0,0,0,0,0,0,0,0,0,0,0,2,1,1,0
61312,234,4911,173,84,99,8,29,36,181,5,12,7,13,17,20,54,81,2,221,12,0,2,1,1,0
61313,234,4911,3,1,1,3,0,0,6,0,0,0,0,0,0,0,0,0,0,0,0,2,1,1,0
61314,158,3743,77,34,69,0,0,8,77,3,24,16,29,27,45,114,213,1,387,21,0,2,1,1,0
61315,158,3743,712,438,573,51,9,84,763,14,102,71,128,116,199,733,1364,8,11988,666,0,2,1,1,0
61316,89,1902,1043,504,840,53,9,147,1096,9,180,112,198,189,310,1377,2344,4,11604,644,0,2,3,3,0
61317,89,1902,383,288,292,26,6,62,409,11,65,38,67,76,105,429,656,5,3719,206,0,2,3,3,0
61318,248,5121,1943,715,1694,26,18,214,1969,12,185,120,237,197,357,1436,2721,7,20915,1161,0,2,1,1,0
61319,248,5121,1168,838,957,57,25,144,1225,19,348,224,416,367,640,3018,5452,11,61921,3440,1,2,1,1,0
61320,100,5227,1457,730,1242,11,6,188,1468,10,292,166,329,302,495,2424,4078,5,22973,1276,1,2,39,0,0
61353,235,4912,2,2,2,0,0,0,2,0,0,0,0,0,0,0,0,0,0,0,0,2,4,1,0
61367,235,4912,99,48,90,1,3,5,100,0,0,0,0,0,0,0,0,0,0,0,0,2,4,1,0
61368,235,4912,8,5,5,2,0,1,10,0,0,0,0,0,0,0,0,0,0,0,0,2,4,1,0
61369,235,4912,1217,716,841,84,126,174,1301,14,185,118,215,199,333,1446,2542,8,20687,1149,0,2,4,1,0
61370,235,4912,160,89,115,0,13,31,160,7,15,11,17,22,28,78,124,3,495,27,0,2,4,1,0
61371,235,4912,10,10,9,9,0,0,19,0,0,0,0,0,0,0,0,0,0,0,0,2,4,1,0
61372,235,4912,173,84,99,8,29,36,181,5,12,7,13,17,20,54,81,2,221,12,0,2,4,1,0
61373,235,4912,3,1,1,3,0,0,6,0,0,0,0,0,0,0,0,0,0,0,0,2,4,1,0
61374,29,1894,384,251,317,7,8,52,391,11,70,44,84,81,128,467,811,6,5355,297,0,2,3,0,0
61377,235,4917,2,2,2,0,0,0,2,0,0,0,0,0,0,0,0,0,0,0,0,2,4,1,0
61391,235,4917,99,48,90,1,3,5,100,0,0,0,0,0,0,0,0,0,0,0,0,2,4,1,0
61392,235,4917,8,5,5,2,0,1,10,0,0,0,0,0,0,0,0,0,0,0,0,2,4,1,0
61393,235,4917,1217,716,841,84,126,174,1301,14,185,118,215,199,333,1446,2542,8,20687,1149,0,2,4,1,0
61394,235,4917,160,89,115,0,13,31,160,7,15,11,17,22,28,78,124,3,495,27,0,2,4,1,0
61395,235,4917,10,10,9,9,0,0,19,0,0,0,0,0,0,0,0,0,0,0,0,2,4,1,0
61396,235,4917,173,84,99,8,29,36,181,5,12,7,13,17,20,54,81,2,221,12,0,2,4,1,0
61397,235,4917,3,1,1,3,0,0,6,0,0,0,0,0,0,0,0,0,0,0,0,2,4,1,0
61422,176,5282,1660,832,1314,41,38,274,1701,20,312,209,395,332,604,2671,5058,12,64042,3557,1,2,52,17,0
61426,112,4510,1289,550,1043,56,32,155,1345,10,167,93,185,177,278,1266,2075,5,11498,638,0,2,2,0,0
61427,54,1156,447,308,343,6,5,95,453,7,96,59,111,103,170,651,1136,4,4600,255,0,2,5,0,1
61428,54,1156,322,174,179,16,74,51,338,10,41,26,46,51,72,252,408,5,2291,127,0,2,5,0,1
61429,47,2152,447,308,343,6,5,95,453,7,96,59,111,103,170,651,1136,4,4600,255,0,2,25,0,1
61430,90,3956,1338,495,1086,10,64,173,1348,11,122,82,157,133,239,883,1686,7,11934,663,0,2,0,2,0
61431,170,5125,1660,832,1314,41,38,274,1701,20,312,209,395,332,604,2671,5058,12,64042,3557,1,2,1,1,0
61432,233,5808,722,423,573,19,0,135,741,12,172,101,199,184,300,1320,2257,6,15668,870,0,2,7,2,1
61433,233,5808,1508,847,911,44,250,301,1552,14,148,88,169,162,257,1120,1886,7,15077,837,0,2,7,2,1
61434,232,5798,722,423,573,19,0,135,741,12,172,101,199,184,300,1320,2257,6,15668,870,0,2,3,5,1
61435,232,5798,1508,847,911,44,250,301,1552,14,148,88,169,162,257,1120,1886,7,15077,837,0,2,3,5,1
61436,29,1879,384,251,317,7,8,52,391,11,70,44,84,81,128,467,811,6,5355,297,0,2,4,5,0
61437,21,500,207,111,150,11,0,50,218,5,26,19,36,31,55,133,272,3,943,52,0,2,13,8,1
61438,29,1306,373,158,315,8,0,51,381,5,76,44,79,81,123,486,779,2,2026,112,0,2,2,4,1
61439,230,4977,182,127,129,0,0,53,182,5,39,21,42,44,63,217,343,2,926,51,0,2,1,0,0
61440,230,4977,1165,710,800,67,119,181,1232,18,243,153,282,261,435,2000,3492,10,36473,2026,1,2,1,0,0
61441,36,1120,182,127,129,0,0,53,182,5,39,21,42,44,63,217,343,2,926,51,0,2,4,0,0
61442,112,4514,1289,550,1043,56,32,155,1345,10,167,93,185,177,278,1266,2075,5,11498,638,0,2,2,2,0
61443,14,845,75,38,59,1,3,12,76,2,4,2,4,6,6,10,15,1,15,0,0,2,1,1,0
61444,36,2461,1157,318,931,29,22,177,1186,6,104,63,125,110,188,712,1274,3,4596,255,0,2,1,1,0
61445,90,3992,1338,495,1086,10,64,173,1348,11,122,82,157,133,239,883,1686,7,11934,663,0,2,9,9,0
61446,171,7580,4293,999,3693,19,54,507,4312,9,155,88,170,164,258,1156,1898,4,9368,520,0,2,6,6,0
61447,171,7580,1482,859,1002,125,135,219,1607,16,219,134,251,235,385,1766,3032,9,27804,1544,1,2,6,6,0
61448,170,5149,1660,832,1314,41,38,274,1701,20,312,209,395,332,604,2671,5058,12,64042,3557,1,2,7,7,0
61449,47,3469,996,429,845,24,10,117,1020,7,76,50,88,83,138,494,879,4,3565,198,0,2,7,7,0
61450,125,5393,1513,682,1277,25,13,200,1538,11,199,116,219,210,335,1557,2584,6,15641,868,0,2,1,1,0
61451,84,4877,1296,573,1062,40,33,157,1336,8,201,118,231,209,349,1561,2689,4,12365,686,0,2,4,4,0
61452,100,5229,1457,730,1242,11,6,188,1468,10,292,166,329,302,495,2424,4078,5,22973,1276,1,2,1,1,0
61453,72,3310,1455,414,1257,16,76,112,1471,5,41,23,46,46,69,231,381,2,1069,59,0,2,1,1,0
61454,21,655,424,94,331,4,0,89,428,1,5,5,5,6,10,11,25,0,12,0,0,2,1,1,0
61455,83,3328,1043,504,840,53,9,147,1096,9,180,112,198,189,310,1377,2344,4,11604,644,0,2,5,5,0
61456,81,3287,1178,367,1042,6,15,115,1184,9,94,51,95,103,146,644,976,4,4439,246,0,2,9,7,0
61457,37,1527,442,244,305,14,16,103,456,11,68,45,75,79,120,452,756,6,4588,254,0,2,1,1,0
61458,52,1994,1098,241,925,5,10,155,1103,7,46,25,49,53,74,273,423,3,1580,87,0,2,2,2,0
61459,125,5396,1513,682,1277,25,13,200,1538,11,199,116,219,210,335,1557,2584,6,15641,868,0,2,11,1,0
61460,159,3781,77,34,69,0,0,8,77,3,24,16,29,27,45,114,213,1,387,21,0,2,9,0,0
61461,159,3781,712,438,573,51,9,84,763,14,102,71,128,116,199,733,1364,8,11988,666,0,2,9,0,0
61462,170,7547,139,89,101,2,0,35,141,7,54,34,62,61,96,330,569,4,2287,127,0,2,1,0,0
61463,170,7547,7,5,5,0,0,2,7,1,2,1,2,3,3,2,4,0,2,0,0,2,1,0,0
61464,30,1324,373,158,315,8,0,51,381,5,76,44,79,81,123,486,779,2,2026,112,0,2,2,1,0
61465,30,1342,373,158,315,8,0,51,381,5,76,44,79,81,123,486,779,2,2026,112,0,2,2,2,0
61466,53,1862,601,196,481,2,23,85,603,8,63,36,72,71,108,400,664,4,3036,168,0,2,4,2,0
61467,29,743,601,196,481,2,23,85,603,8,63,36,72,71,108,400,664,4,3036,168,0,2,2,1,0
61468,29,743,156,79,106,5,16,28,161,5,14,8,15,19,23,64,97,2,261,14,0,2,2,1,0
61469,36,2459,1157,318,931,29,22,177,1186,6,104,63,125,110,188,712,1274,3,4596,255,0,2,1,0,0
61470,103,5526,1943,715,1694,26,18,214,1969,12,185,120,237,197,357,1436,2721,7,20915,1161,0,2,0,1,0
61471,36,2434,1157,318,931,29,22,177,1186,6,104,63,125,110,188,712,1274,3,4596,255,0,2,6,7,0
61472,36,2425,1157,318,931,29,22,177,1186,6,104,63,125,110,188,712,1274,3,4596,255,0,2,4,4,0
61473,75,1617,53,23,39,0,0,13,53,2,8,4,8,10,12,26,39,1,39,2,0,2,8,1,1
61474,75,1617,515,298,307,33,80,99,548,12,63,44,77,75,121,419,753,7,5527,307,0,2,8,1,1
61475,85,4928,1296,573,1062,40,33,157,1336,8,201,118,231,209,349,1561,2689,4,12365,686,0,2,18,0,1
61478,21,500,207,111,150,11,0,50,218,5,26,19,36,31,55,133,272,3,943,52,0,2,13,8,0
61479,29,1306,373,158,315,8,0,51,381,5,76,44,79,81,123,486,779,2,2026,112,0,2,2,4,0
61480,52,625,647,139,84,35,284,233,682,0,0,0,0,0,0,0,0,0,0,0,0,2,2,1,0
61481,54,1156,447,308,343,6,5,95,453,7,96,59,111,103,170,651,1136,4,4600,255,0,2,5,0,0
61482,54,1156,322,174,179,16,74,51,338,10,41,26,46,51,72,252,408,5,2291,127,0,2,5,0,0
61483,232,5798,722,423,573,19,0,135,741,12,172,101,199,184,300,1320,2257,6,15668,870,0,2,10,7,0
61484,232,5798,1508,847,911,44,250,301,1552,14,148,88,169,162,257,1120,1886,7,15077,837,0,2,10,7,0
61487,47,2152,447,308,343,6,5,95,453,7,96,59,111,103,170,651,1136,4,4600,255,0,2,25,0,0
61495,90,3974,1338,495,1086,10,64,173,1348,11,122,82,157,133,239,883,1686,7,11934,663,0,2,9,9,0
61498,170,5139,1660,832,1314,41,38,274,1701,20,312,209,395,332,604,2671,5058,12,64042,3557,1,2,7,7,0
61509,176,5286,1660,832,1314,41,38,274,1701,20,312,209,395,332,604,2671,5058,12,64042,3557,1,2,52,17,0
61511,60,1610,466,257,367,18,25,50,484,7,126,86,171,133,257,898,1813,4,8612,478,0,2,132,0,1
61512,60,1610,507,281,342,29,59,88,536,10,53,29,57,63,86,336,514,5,2764,153,0,2,132,0,1
61513,21,1078,466,257,367,18,25,50,484,7,126,86,171,133,257,898,1813,4,8612,478,0,0,183,0,1
61516,235,4919,2,2,2,0,0,0,2,0,0,0,0,0,0,0,0,0,0,0,0,2,1,0,0
61530,235,4919,99,48,90,1,3,5,100,0,0,0,0,0,0,0,0,0,0,0,0,2,1,0,0
61531,235,4919,8,5,5,2,0,1,10,0,0,0,0,0,0,0,0,0,0,0,0,2,1,0,0
61532,235,4919,1217,716,841,84,126,174,1301,14,185,118,215,199,333,1446,2542,8,20687,1149,0,2,1,0,0
61533,235,4919,160,89,115,0,13,31,160,7,15,11,17,22,28,78,124,3,495,27,0,2,1,0,0
61534,235,4919,10,10,9,9,0,0,19,0,0,0,0,0,0,0,0,0,0,0,0,2,1,0,0
61535,235,4919,173,84,99,8,29,36,181,5,12,7,13,17,20,54,81,2,221,12,0,2,1,0,0
61536,235,4919,3,1,1,3,0,0,6,0,0,0,0,0,0,0,0,0,0,0,0,2,1,0,0
61537,54,657,647,139,84,35,284,233,682,0,0,0,0,0,0,0,0,0,0,0,0,2,35,0,0
61538,66,1698,466,257,367,18,25,50,484,7,126,86,171,133,257,898,1813,4,8612,478,0,2,16,0,0
61539,66,1698,507,281,342,29,59,88,536,10,53,29,57,63,86,336,514,5,2764,153,0,2,16,0,0
61540,25,1292,466,257,367,18,25,50,484,7,126,86,171,133,257,898,1813,4,8612,478,0,2,50,0,0
61541,66,1701,466,257,367,18,25,50,484,7,126,86,171,133,257,898,1813,4,8612,478,0,2,2,0,0
61542,66,1701,507,281,342,29,59,88,536,10,53,29,57,63,86,336,514,5,2764,153,0,2,2,0,0
61543,54,657,647,139,84,35,284,233,682,0,0,0,0,0,0,0,0,0,0,0,0,2,2,2,0
61544,66,1702,466,257,367,18,25,50,484,7,126,86,171,133,257,898,1813,4,8612,478,0,2,1,1,0
61545,66,1702,507,281,342,29,59,88,536,10,53,29,57,63,86,336,514,5,2764,153,0,2,1,1,0
61546,25,1299,466,257,367,18,25,50,484,7,126,86,171,133,257,898,1813,4,8612,478,0,2,23,4,0
61547,66,1712,466,257,367,18,25,50,484,7,126,86,171,133,257,898,1813,4,8612,478,0,2,2,1,1
61548,66,1712,507,281,342,29,59,88,536,10,53,29,57,63,86,336,514,5,2764,153,0,2,2,1,1
61549,26,1396,466,257,367,18,25,50,484,7,126,86,171,133,257,898,1813,4,8612,478,0,2,21,3,1
61550,66,1712,466,257,367,18,25,50,484,7,126,86,171,133,257,898,1813,4,8612,478,0,2,2,2,1
61551,66,1712,507,281,342,29,59,88,536,10,53,29,57,63,86,336,514,5,2764,153,0,2,2,2,1
61552,27,1494,466,257,367,18,25,50,484,7,126,86,171,133,257,898,1813,4,8612,478,0,2,23,0,1
61557,159,3781,77,34,69,0,0,8,77,3,24,16,29,27,45,114,213,1,387,21,0,2,1,1,0
61558,159,3781,712,438,573,51,9,84,763,14,102,71,128,116,199,733,1364,8,11988,666,0,2,1,1,0
61561,112,4514,1289,550,1043,56,32,155,1345,10,167,93,185,177,278,1266,2075,5,11498,638,0,2,2,0,0
61562,36,2427,1157,318,931,29,22,177,1186,6,104,63,125,110,188,712,1274,3,4596,255,0,2,11,11,0
61563,47,3469,996,429,845,24,10,117,1020,7,76,50,88,83,138,494,879,4,3565,198,0,2,1,1,0
61564,29,1324,373,158,315,8,0,51,381,5,76,44,79,81,123,486,779,2,2026,112,0,2,2,2,0
61566,112,2106,477,336,357,30,23,73,507,16,194,134,250,210,384,1538,2962,10,30538,1696,0,2,9,9,1
61567,78,1824,996,429,845,24,10,117,1020,7,76,50,88,83,138,494,879,4,3565,198,0,2,1,1,1
61568,78,1824,456,277,329,12,42,72,468,13,85,50,97,98,147,592,972,7,7212,400,0,2,1,1,1
61569,248,5735,4293,999,3693,19,54,507,4312,9,155,88,170,164,258,1156,1898,4,9368,520,0,2,1,1,1
61570,248,5735,1482,859,1002,125,135,219,1607,16,219,134,251,235,385,1766,3032,9,27804,1544,1,2,1,1,1
61571,100,2601,773,422,505,30,103,129,803,14,77,46,83,91,129,535,839,7,6334,351,0,2,1,1,1
61572,103,5544,1943,715,1694,26,18,214,1969,12,185,120,237,197,357,1436,2721,7,20915,1161,0,2,10,9,1
61573,113,2113,477,336,357,30,23,73,507,16,194,134,250,210,384,1538,2962,10,30538,1696,0,2,34,24,1
61574,126,4991,1450,624,1228,12,26,181,1462,14,306,186,354,320,540,2580,4493,8,36391,2021,1,2,11,0,1
61575,248,5737,4293,999,3693,19,54,507,4312,9,155,88,170,164,258,1156,1898,4,9368,520,0,2,1,1,0
61576,248,5737,1482,859,1002,125,135,219,1607,16,219,134,251,235,385,1766,3032,9,27804,1544,1,2,1,1,0
61600,171,7589,4293,999,3693,19,54,507,4312,9,155,88,170,164,258,1156,1898,4,9368,520,0,2,3,2,0
61601,171,7589,1482,859,1002,125,135,219,1607,16,219,134,251,235,385,1766,3032,9,27804,1544,1,2,3,2,0
61602,125,5398,1513,682,1277,25,13,200,1538,11,199,116,219,210,335,1557,2584,6,15641,868,0,2,11,1,0
61603,29,1324,373,158,315,8,0,51,381,5,76,44,79,81,123,486,779,2,2026,112,0,2,2,1,0
61635,28,452,219,78,157,11,5,46,230,3,24,20,34,27,54,114,256,2,545,30,0,2,14,2,0
61636,28,452,108,64,79,9,0,20,117,5,15,11,19,20,30,70,129,3,410,22,0,2,14,2,0
61637,72,1466,1178,367,1042,6,15,115,1184,9,94,51,95,103,146,644,976,4,4439,246,0,2,19,11,0
61638,72,1466,177,108,140,8,0,27,185,6,30,16,32,36,48,162,248,3,794,44,0,2,19,11,0
61639,66,1714,466,257,367,18,25,50,484,7,126,86,171,133,257,898,1813,4,8612,478,0,2,3,1,0
61640,66,1714,507,281,342,29,59,88,536,10,53,29,57,63,86,336,514,5,2764,153,0,2,3,1,0
61641,28,1596,466,257,367,18,25,50,484,7,126,86,171,133,257,898,1813,4,8612,478,0,2,22,2,0
61642,101,2611,773,422,505,30,103,129,803,14,77,46,83,91,129,535,839,7,6334,351,0,2,9,2,0
61645,75,1617,53,23,39,0,0,13,53,2,8,4,8,10,12,26,39,1,39,2,0,2,8,1,0
61646,75,1617,515,298,307,33,80,99,548,12,63,44,77,75,121,419,753,7,5527,307,0,2,8,1,0
61647,85,4936,1296,573,1062,40,33,157,1336,8,201,118,231,209,349,1561,2689,4,12365,686,0,2,18,0,0
61648,112,2106,477,336,357,30,23,73,507,16,194,134,250,210,384,1538,2962,10,30538,1696,0,2,9,9,0
61649,78,1824,996,429,845,24,10,117,1020,7,76,50,88,83,138,494,879,4,3565,198,0,2,1,1,0
61650,78,1824,456,277,329,12,42,72,468,13,85,50,97,98,147,592,972,7,7212,400,0,2,1,1,0
61653,101,2612,773,422,505,30,103,129,803,14,77,46,83,91,129,535,839,7,6334,351,0,2,1,1,0
61654,103,5544,1943,715,1694,26,18,214,1969,12,185,120,237,197,357,1436,2721,7,20915,1161,0,2,10,9,0
61655,113,2116,477,336,357,30,23,73,507,16,194,134,250,210,384,1538,2962,10,30538,1696,0,2,34,24,0
61656,126,4991,1450,624,1228,12,26,181,1462,14,306,186,354,320,540,2580,4493,8,36391,2021,1,2,11,0,0
61657,313,6885,72,33,56,0,4,12,72,1,1,1,1,2,2,0,2,0,1,0,0,2,18,1,0
61658,313,6885,1454,835,1044,76,110,219,1530,17,275,158,296,292,454,2297,3718,9,34017,1889,1,2,18,1,0
61659,313,6885,72,33,56,0,4,12,72,1,1,1,1,2,2,0,2,0,1,0,0,2,2,2,0
61660,313,6885,1454,835,1044,76,110,219,1530,17,275,158,296,292,454,2297,3718,9,34017,1889,1,2,2,2,0
61661,67,1570,773,419,590,28,0,166,801,10,204,113,217,214,330,1598,2554,5,13587,754,0,2,3,1,0
61662,67,1570,421,273,302,44,34,57,465,17,81,59,107,98,166,583,1098,11,12329,684,0,2,3,1,0
61663,69,1499,402,202,227,24,74,80,426,12,52,33,61,64,94,339,564,7,3969,220,0,2,1,1,0
61664,69,3122,1020,354,843,12,15,144,1032,8,134,77,144,142,221,970,1580,4,6792,377,0,2,25,10,0
61673,247,5945,722,423,573,19,0,135,741,12,172,101,199,184,300,1320,2257,6,15668,870,0,2,9,0,1
61674,247,5945,1508,847,911,44,250,301,1552,14,148,88,169,162,257,1120,1886,7,15077,837,0,2,9,0,1
61675,92,4888,1457,730,1242,11,6,188,1468,10,292,166,329,302,495,2424,4078,5,22973,1276,1,2,8,16,1
61676,28,1833,384,251,317,7,8,52,391,11,70,44,84,81,128,467,811,6,5355,297,0,2,6,7,1
61677,247,5945,722,423,573,19,0,135,741,12,172,101,199,184,300,1320,2257,6,15668,870,0,2,9,0,0
61678,247,5945,1508,847,911,44,250,301,1552,14,148,88,169,162,257,1120,1886,7,15077,837,0,2,9,0,0
61679,92,4888,1457,730,1242,11,6,188,1468,10,292,166,329,302,495,2424,4078,5,22973,1276,1,2,8,16,0
61680,28,1833,384,251,317,7,8,52,391,11,70,44,84,81,128,467,811,6,5355,297,0,2,6,7,0
61681,164,3436,1513,682,1277,25,13,200,1538,11,199,116,219,210,335,1557,2584,6,15641,868,0,2,18,0,0
61682,164,3436,819,519,539,24,98,155,843,15,96,57,106,111,163,690,1107,8,9171,509,0,2,18,0,0
61683,50,1389,339,213,244,17,9,65,356,10,42,26,48,52,74,259,421,5,2410,133,0,2,25,6,0
61684,69,3465,1293,570,1093,25,15,163,1318,10,195,123,241,205,364,1516,2795,6,17273,959,0,2,49,0,0
61685,50,1396,339,213,244,17,9,65,356,10,42,26,48,52,74,259,421,5,2410,133,0,2,8,5,0
61686,69,3468,1293,570,1093,25,15,163,1318,10,195,123,241,205,364,1516,2795,6,17273,959,0,2,2,1,0
61687,73,3679,1293,570,1093,25,15,163,1318,10,195,123,241,205,364,1516,2795,6,17273,959,0,2,51,0,0
61688,164,3417,1513,682,1277,25,13,200,1538,11,199,116,219,210,335,1557,2584,6,15641,868,0,2,3,5,0
61689,164,3417,819,519,539,24,98,155,843,15,96,57,106,111,163,690,1107,8,9171,509,0,2,3,5,0
61690,72,3663,1293,570,1093,25,15,163,1318,10,195,123,241,205,364,1516,2795,6,17273,959,0,2,58,17,0
61691,50,1402,339,213,244,17,9,65,356,10,42,26,48,52,74,259,421,5,2410,133,0,2,11,9,0
61692,54,657,647,139,84,35,284,233,682,0,0,0,0,0,0,0,0,0,0,0,0,2,3,3,0
61693,66,1714,466,257,367,18,25,50,484,7,126,86,171,133,257,898,1813,4,8612,478,0,2,2,2,0
61694,66,1714,507,281,342,29,59,88,536,10,53,29,57,63,86,336,514,5,2764,153,0,2,2,2,0
61695,28,1596,466,257,367,18,25,50,484,7,126,86,171,133,257,898,1813,4,8612,478,0,2,6,6,0
61720,66,1714,466,257,367,18,25,50,484,7,126,86,171,133,257,898,1813,4,8612,478,0,2,153,0,0
61721,66,1714,507,281,342,29,59,88,536,10,53,29,57,63,86,336,514,5,2764,153,0,2,153,0,0
61722,28,1596,466,257,367,18,25,50,484,7,126,86,171,133,257,898,1813,4,8612,478,0,0,313,0,0
61725,52,625,647,139,84,35,284,233,682,0,0,0,0,0,0,0,0,0,0,0,0,2,2,2,0
61726,164,3417,1513,682,1277,25,13,200,1538,11,199,116,219,210,335,1557,2584,6,15641,868,0,2,21,5,0
61727,164,3417,819,519,539,24,98,155,843,15,96,57,106,111,163,690,1107,8,9171,509,0,2,21,5,0
61728,50,1402,339,213,244,17,9,65,356,10,42,26,48,52,74,259,421,5,2410,133,0,2,33,9,0
61729,72,3663,1293,570,1093,25,15,163,1318,10,195,123,241,205,364,1516,2795,6,17273,959,0,2,143,1,0
61731,55,770,167,116,138,4,5,22,171,8,48,30,56,56,86,292,499,4,2330,129,0,2,6,6,0
61732,101,5285,1457,730,1242,11,6,188,1468,10,292,166,329,302,495,2424,4078,5,22973,1276,1,2,16,0,0
61733,51,1410,339,213,244,17,9,65,356,10,42,26,48,52,74,259,421,5,2410,133,0,2,8,1,0
61734,72,3697,1293,570,1093,25,15,163,1318,10,195,123,241,205,364,1516,2795,6,17273,959,0,2,12,3,0
61735,54,657,647,139,84,35,284,233,682,0,0,0,0,0,0,0,0,0,0,0,0,2,2,1,0
61736,233,5825,722,423,573,19,0,135,741,12,172,101,199,184,300,1320,2257,6,15668,870,0,2,9,0,0
61737,233,5825,1508,847,911,44,250,301,1552,14,148,88,169,162,257,1120,1886,7,15077,837,0,2,9,0,0
61738,100,5205,1457,730,1242,11,6,188,1468,10,292,166,329,302,495,2424,4078,5,22973,1276,1,2,8,16,0
61739,29,1873,384,251,317,7,8,52,391,11,70,44,84,81,128,467,811,6,5355,297,0,2,6,7,0
61740,52,1439,339,213,244,17,9,65,356,10,42,26,48,52,74,259,421,5,2410,133,0,2,10,0,0
61741,73,3713,1293,570,1093,25,15,163,1318,10,195,123,241,205,364,1516,2795,6,17273,959,0,2,14,0,0
61747,101,5261,1457,730,1242,11,6,188,1468,10,292,166,329,302,495,2424,4078,5,22973,1276,1,2,8,16,0
61751,69,1499,402,202,227,24,74,80,426,12,52,33,61,64,94,339,564,7,3969,220,0,2,2,2,0
61752,233,5835,722,423,573,19,0,135,741,12,172,101,199,184,300,1320,2257,6,15668,870,0,2,6,0,0
61753,233,5835,1508,847,911,44,250,301,1552,14,148,88,169,162,257,1120,1886,7,15077,837,0,2,6,0,0
61754,171,7601,4293,999,3693,19,54,507,4312,9,155,88,170,164,258,1156,1898,4,9368,520,0,2,4,4,0
61755,171,7601,1482,859,1002,125,135,219,1607,16,219,134,251,235,385,1766,3032,9,27804,1544,1,2,4,4,0
61756,33,1007,465,148,393,5,8,60,470,4,31,20,31,35,51,161,261,2,523,29,0,2,1,1,0
61757,33,1007,16,12,9,0,0,6,16,1,2,1,2,3,3,2,4,0,2,0,0,2,1,1,0
61758,126,5666,1782,648,1425,9,47,279,1791,8,171,97,189,179,286,1292,2140,4,9462,525,0,2,18,18,0
61759,125,5401,1513,682,1277,25,13,200,1538,11,199,116,219,210,335,1557,2584,6,15641,868,0,2,1,1,0
61760,43,2679,652,304,544,16,6,88,668,6,89,51,101,95,152,591,998,3,3399,188,0,2,1,1,0
61761,69,3128,1020,354,843,12,15,144,1032,8,134,77,144,142,221,970,1580,4,6792,377,0,2,2,2,0
61762,1,94,42,7,35,4,0,5,46,1,2,1,2,3,3,2,4,0,2,0,0,2,2,2,0
61763,1,94,11,6,10,0,0,1,11,2,4,2,4,6,6,10,15,1,15,0,0,2,2,2,0
61764,230,4977,182,127,129,0,0,53,182,5,39,21,42,44,63,217,343,2,926,51,0,2,8,12,0
61765,230,4977,1165,710,800,67,119,181,1232,18,243,153,282,261,435,2000,3492,10,36473,2026,1,2,8,12,0
61768,183,5553,1660,832,1314,41,38,274,1701,20,312,209,395,332,604,2671,5058,12,64042,3557,1,2,3,3,0
61769,183,5553,1057,646,719,113,100,145,1170,18,215,134,248,233,382,1740,3004,10,31186,1732,1,2,3,3,0
61770,113,2116,477,336,357,30,23,73,507,16,194,134,250,210,384,1538,2962,10,30538,1696,0,2,43,33,0
61771,78,1824,996,429,845,24,10,117,1020,7,76,50,88,83,138,494,879,4,3565,198,0,2,11,15,0
61772,78,1824,456,277,329,12,42,72,468,13,85,50,97,98,147,592,972,7,7212,400,0,2,11,15,0
61773,164,3417,1513,682,1277,25,13,200,1538,11,199,116,219,210,335,1557,2584,6,15641,868,0,2,69,44,0
61774,164,3417,819,519,539,24,98,155,843,15,96,57,106,111,163,690,1107,8,9171,509,0,2,69,44,0
61777,235,4919,2,2,2,0,0,0,2,0,0,0,0,0,0,0,0,0,0,0,0,2,39,14,0
61791,235,4919,99,48,90,1,3,5,100,0,0,0,0,0,0,0,0,0,0,0,0,2,39,14,0
61792,235,4919,8,5,5,2,0,1,10,0,0,0,0,0,0,0,0,0,0,0,0,2,39,14,0
61793,235,4919,1217,716,841,84,126,174,1301,14,185,118,215,199,333,1446,2542,8,20687,1149,0,2,39,14,0
61794,235,4919,160,89,115,0,13,31,160,7,15,11,17,22,28,78,124,3,495,27,0,2,39,14,0
61795,235,4919,10,10,9,9,0,0,19,0,0,0,0,0,0,0,0,0,0,0,0,2,39,14,0
61796,235,4919,173,84,99,8,29,36,181,5,12,7,13,17,20,54,81,2,221,12,0,2,39,14,0
61797,235,4919,3,1,1,3,0,0,6,0,0,0,0,0,0,0,0,0,0,0,0,2,39,14,0
61799,51,1410,339,213,244,17,9,65,356,10,42,26,48,52,74,259,421,5,2410,133,0,2,78,28,0
61802,248,5737,4293,999,3693,19,54,507,4312,9,155,88,170,164,258,1156,1898,4,9368,520,0,2,18,6,0
61803,248,5737,1482,859,1002,125,135,219,1607,16,219,134,251,235,385,1766,3032,9,27804,1544,1,2,18,6,0
61807,101,2612,773,422,505,30,103,129,803,14,77,46,83,91,129,535,839,7,6334,351,0,2,10,3,0
61808,159,3781,77,34,69,0,0,8,77,3,24,16,29,27,45,114,213,1,387,21,0,2,11,2,0
61809,159,3781,712,438,573,51,9,84,763,14,102,71,128,116,199,733,1364,8,11988,666,0,2,11,2,0
61816,233,5825,722,423,573,19,0,135,741,12,172,101,199,184,300,1320,2257,6,15668,870,0,2,23,49,0
61817,233,5825,1508,847,911,44,250,301,1552,14,148,88,169,162,257,1120,1886,7,15077,837,0,2,23,49,0
61818,313,6885,72,33,56,0,4,12,72,1,1,1,1,2,2,0,2,0,1,0,0,2,32,23,0
61819,313,6885,1454,835,1044,76,110,219,1530,17,275,158,296,292,454,2297,3718,9,34017,1889,1,2,32,23,0
61820,66,1714,466,257,367,18,25,50,484,7,126,86,171,133,257,898,1813,4,8612,478,0,2,237,1,0
61821,66,1714,507,281,342,29,59,88,536,10,53,29,57,63,86,336,514,5,2764,153,0,2,237,1,0
61822,89,1902,1043,504,840,53,9,147,1096,9,180,112,198,189,310,1377,2344,4,11604,644,0,2,4,40,0
61823,89,1902,383,288,292,26,6,62,409,11,65,38,67,76,105,429,656,5,3719,206,0,2,4,40,0
61828,248,5121,1943,715,1694,26,18,214,1969,12,185,120,237,197,357,1436,2721,7,20915,1161,0,2,38,28,0
61829,248,5121,1168,838,957,57,25,144,1225,19,348,224,416,367,640,3018,5452,11,61921,3440,1,2,38,28,0
61832,112,4514,1289,550,1043,56,32,155,1345,10,167,93,185,177,278,1266,2075,5,11498,638,0,2,87,2,0
61835,36,2427,1157,318,931,29,22,177,1186,6,104,63,125,110,188,712,1274,3,4596,255,0,2,12,12,0
61836,90,3974,1338,495,1086,10,64,173,1348,11,122,82,157,133,239,883,1686,7,11934,663,0,2,9,11,0
61837,171,7589,4293,999,3693,19,54,507,4312,9,155,88,170,164,258,1156,1898,4,9368,520,0,3,43,5,0
61838,171,7589,1482,859,1002,125,135,219,1607,16,219,134,251,235,385,1766,3032,9,27804,1544,1,3,43,5,0
61840,176,5286,1660,832,1314,41,38,274,1701,20,312,209,395,332,604,2671,5058,12,64042,3557,1,2,60,25,0
61841,47,3469,996,429,845,24,10,117,1020,7,76,50,88,83,138,494,879,4,3565,198,0,2,8,8,0
61842,125,5398,1513,682,1277,25,13,200,1538,11,199,116,219,210,335,1557,2584,6,15641,868,0,2,2,2,0
61843,85,4936,1296,573,1062,40,33,157,1336,8,201,118,231,209,349,1561,2689,4,12365,686,0,2,22,4,0
61845,101,5261,1457,730,1242,11,6,188,1468,10,292,166,329,302,495,2424,4078,5,22973,1276,1,2,96,5,0
61846,72,3310,1455,414,1257,16,76,112,1471,5,41,23,46,46,69,231,381,2,1069,59,0,2,13,1,0
61847,100,4747,1523,757,1297,19,12,193,1542,12,193,117,230,205,347,1508,2664,7,19053,1058,0,2,0,3,0
61851,72,3697,1293,570,1093,25,15,163,1318,10,195,123,241,205,364,1516,2795,6,17273,959,0,2,174,7,0
61852,29,1873,384,251,317,7,8,52,391,11,70,44,84,81,128,467,811,6,5355,297,0,2,14,5,0
61856,29,1324,373,158,315,8,0,51,381,5,76,44,79,81,123,486,779,2,2026,112,0,2,5,7,0
61858,103,5544,1943,715,1694,26,18,214,1969,12,185,120,237,197,357,1436,2721,7,20915,1161,0,2,76,16,0
61874,23,607,2,2,2,0,0,0,2,0,0,0,0,0,0,0,0,0,0,0,0,2,1,2,1
61888,23,607,99,48,90,1,3,5,100,0,0,0,0,0,0,0,0,0,0,0,0,2,1,2,1
61889,23,607,8,5,5,2,0,1,10,0,0,0,0,0,0,0,0,0,0,0,0,2,1,2,1
61890,23,607,1217,716,841,84,126,174,1301,14,185,118,215,199,333,1446,2542,8,20687,1149,0,2,1,2,1
61891,23,607,160,89,115,0,13,31,160,7,15,11,17,22,28,78,124,3,495,27,0,2,1,2,1
61892,23,607,10,10,9,9,0,0,19,0,0,0,0,0,0,0,0,0,0,0,0,2,1,2,1
61893,23,607,173,84,99,8,29,36,181,5,12,7,13,17,20,54,81,2,221,12,0,2,1,2,1
61894,23,607,3,1,1,3,0,0,6,0,0,0,0,0,0,0,0,0,0,0,0,2,1,2,1
61895,69,1509,402,202,227,24,74,80,426,12,52,33,61,64,94,339,564,7,3969,220,0,2,24,14,1
61896,69,1509,402,202,227,24,74,80,426,12,52,33,61,64,94,339,564,7,3969,220,0,2,5,5,0
61897,2,121,37,13,25,0,6,6,37,1,2,1,2,3,3,2,4,0,2,0,0,2,9,0,0
61898,2,121,133,47,40,1,43,49,134,0,0,0,0,0,0,0,0,0,0,0,0,2,9,0,0
61899,68,1497,402,202,227,24,74,80,426,12,52,33,61,64,94,339,564,7,3969,220,0,2,20,19,0
61902,23,607,2,2,2,0,0,0,2,0,0,0,0,0,0,0,0,0,0,0,0,2,1,2,0
61916,23,607,99,48,90,1,3,5,100,0,0,0,0,0,0,0,0,0,0,0,0,2,1,2,0
61917,23,607,8,5,5,2,0,1,10,0,0,0,0,0,0,0,0,0,0,0,0,2,1,2,0
61918,23,607,1217,716,841,84,126,174,1301,14,185,118,215,199,333,1446,2542,8,20687,1149,0,2,1,2,0
61919,23,607,160,89,115,0,13,31,160,7,15,11,17,22,28,78,124,3,495,27,0,2,1,2,0
61920,23,607,10,10,9,9,0,0,19,0,0,0,0,0,0,0,0,0,0,0,0,2,1,2,0
61921,23,607,173,84,99,8,29,36,181,5,12,7,13,17,20,54,81,2,221,12,0,2,1,2,0
61922,23,607,3,1,1,3,0,0,6,0,0,0,0,0,0,0,0,0,0,0,0,2,1,2,0
61923,68,1497,402,202,227,24,74,80,426,12,52,33,61,64,94,339,564,7,3969,220,0,2,27,16,0
61926,162,3389,1513,682,1277,25,13,200,1538,11,199,116,219,210,335,1557,2584,6,15641,868,0,2,0,7,0
61927,162,3389,819,519,539,24,98,155,843,15,96,57,106,111,163,690,1107,8,9171,509,0,2,0,7,0
61930,236,4937,2,2,2,0,0,0,2,0,0,0,0,0,0,0,0,0,0,0,0,2,10,4,0
61944,236,4937,99,48,90,1,3,5,100,0,0,0,0,0,0,0,0,0,0,0,0,2,10,4,0
61945,236,4937,8,5,5,2,0,1,10,0,0,0,0,0,0,0,0,0,0,0,0,2,10,4,0
61946,236,4937,1217,716,841,84,126,174,1301,14,185,118,215,199,333,1446,2542,8,20687,1149,0,2,10,4,0
61947,236,4937,160,89,115,0,13,31,160,7,15,11,17,22,28,78,124,3,495,27,0,2,10,4,0
61948,236,4937,10,10,9,9,0,0,19,0,0,0,0,0,0,0,0,0,0,0,0,2,10,4,0
61949,236,4937,173,84,99,8,29,36,181,5,12,7,13,17,20,54,81,2,221,12,0,2,10,4,0
61950,236,4937,3,1,1,3,0,0,6,0,0,0,0,0,0,0,0,0,0,0,0,2,10,4,0
61951,248,5130,1943,715,1694,26,18,214,1969,12,185,120,237,197,357,1436,2721,7,20915,1161,0,2,1,0,0
61952,248,5130,1168,838,957,57,25,144,1225,19,348,224,416,367,640,3018,5452,11,61921,3440,1,2,1,0,0
61953,103,5260,1457,730,1242,11,6,188,1468,10,292,166,329,302,495,2424,4078,5,22973,1276,1,2,10,16,0
61954,29,1903,384,251,317,7,8,52,391,11,70,44,84,81,128,467,811,6,5355,297,0,2,4,0,0
61984,159,3782,77,34,69,0,0,8,77,3,24,16,29,27,45,114,213,1,387,21,0,2,5,2,1
61985,159,3782,712,438,573,51,9,84,763,14,102,71,128,116,199,733,1364,8,11988,666,0,2,5,2,1
61986,72,3698,1293,570,1093,25,15,163,1318,10,195,123,241,205,364,1516,2795,6,17273,959,0,2,2,1,1
61987,83,3389,1043,504,840,53,9,147,1096,9,180,112,198,189,310,1377,2344,4,11604,644,0,2,16,0,1
61988,248,5737,4293,999,3693,19,54,507,4312,9,155,88,170,164,258,1156,1898,4,9368,520,0,2,1,0,0
61989,248,5737,1482,859,1002,125,135,219,1607,16,219,134,251,235,385,1766,3032,9,27804,1544,1,2,1,0,0
61990,18,312,424,94,331,4,0,89,428,1,5,5,5,6,10,11,25,0,12,0,0,2,2,1,0
61991,18,312,38,23,23,6,0,8,44,3,11,7,11,14,18,42,68,1,102,5,0,2,2,1,0
61992,89,1894,1043,504,840,53,9,147,1096,9,180,112,198,189,310,1377,2344,4,11604,644,0,2,1,2,0
61993,89,1894,383,288,292,26,6,62,409,11,65,38,67,76,105,429,656,5,3719,206,0,2,1,2,0
62000,233,5831,722,423,573,19,0,135,741,12,172,101,199,184,300,1320,2257,6,15668,870,0,2,13,9,1
62001,233,5831,1508,847,911,44,250,301,1552,14,148,88,169,162,257,1120,1886,7,15077,837,0,2,13,9,1
62002,51,2434,722,423,573,19,0,135,741,12,172,101,199,184,300,1320,2257,6,15668,870,0,2,13,0,1
62003,233,5831,722,423,573,19,0,135,741,12,172,101,199,184,300,1320,2257,6,15668,870,0,2,13,9,0
62004,233,5831,1508,847,911,44,250,301,1552,14,148,88,169,162,257,1120,1886,7,15077,837,0,2,13,9,0
62005,51,2434,722,423,573,19,0,135,741,12,172,101,199,184,300,1320,2257,6,15668,870,0,2,13,0,0
62006,77,1854,996,429,845,24,10,117,1020,7,76,50,88,83,138,494,879,4,3565,198,0,2,30,21,0
62007,77,1854,456,277,329,12,42,72,468,13,85,50,97,98,147,592,972,7,7212,400,0,2,30,21,0
62008,47,3494,996,429,845,24,10,117,1020,7,76,50,88,83,138,494,879,4,3565,198,0,2,23,3,0
62009,233,5841,722,423,573,19,0,135,741,12,172,101,199,184,300,1320,2257,6,15668,870,0,2,13,9,0
62010,233,5841,1508,847,911,44,250,301,1552,14,148,88,169,162,257,1120,1886,7,15077,837,0,2,13,9,0
62012,53,1447,339,213,244,17,9,65,356,10,42,26,48,52,74,259,421,5,2410,133,0,2,10,0,0
62013,73,3747,1293,570,1093,25,15,163,1318,10,195,123,241,205,364,1516,2795,6,17273,959,0,2,14,0,0
62014,52,1451,339,213,244,17,9,65,356,10,42,26,48,52,74,259,421,5,2410,133,0,2,23,17,1
62015,73,3779,1293,570,1093,25,15,163,1318,10,195,123,241,205,364,1516,2795,6,17273,959,0,2,37,7,1
62016,52,1451,339,213,244,17,9,65,356,10,42,26,48,52,74,259,421,5,2410,133,0,2,23,17,0
62017,73,3779,1293,570,1093,25,15,163,1318,10,195,123,241,205,364,1516,2795,6,17273,959,0,2,37,7,0
62018,159,3782,77,34,69,0,0,8,77,3,24,16,29,27,45,114,213,1,387,21,0,2,5,2,0
62019,159,3782,712,438,573,51,9,84,763,14,102,71,128,116,199,733,1364,8,11988,666,0,2,5,2,0
62020,73,3748,1293,570,1093,25,15,163,1318,10,195,123,241,205,364,1516,2795,6,17273,959,0,2,2,1,0
62021,83,3389,1043,504,840,53,9,147,1096,9,180,112,198,189,310,1377,2344,4,11604,644,0,2,16,0,0
62025,176,5309,1660,832,1314,41,38,274,1701,20,312,209,395,332,604,2671,5058,12,64042,3557,1,2,3,0,0
62029,113,2119,477,336,357,30,23,73,507,16,194,134,250,210,384,1538,2962,10,30538,1696,0,2,10,7,0
62030,113,2123,477,336,357,30,23,73,507,16,194,134,250,210,384,1538,2962,10,30538,1696,0,2,7,5,0
62031,117,2176,477,336,357,30,23,73,507,16,194,134,250,210,384,1538,2962,10,30538,1696,0,2,29,14,1
62032,128,5170,1450,624,1228,12,26,181,1462,14,306,186,354,320,540,2580,4493,8,36391,2021,1,2,44,0,1
62033,78,1883,996,429,845,24,10,117,1020,7,76,50,88,83,138,494,879,4,3565,198,0,2,15,6,0
62034,78,1883,456,277,329,12,42,72,468,13,85,50,97,98,147,592,972,7,7212,400,0,2,15,6,0
62035,47,3558,996,429,845,24,10,117,1020,7,76,50,88,83,138,494,879,4,3565,198,0,2,26,6,0
62036,75,1547,1178,367,1042,6,15,115,1184,9,94,51,95,103,146,644,976,4,4439,246,0,2,19,1,0
62037,75,1547,177,108,140,8,0,27,185,6,30,16,32,36,48,162,248,3,794,44,0,2,19,1,0
62038,112,4514,1289,550,1043,56,32,155,1345,10,167,93,185,177,278,1266,2075,5,11498,638,0,2,3,1,0
62039,81,3287,1178,367,1042,6,15,115,1184,9,94,51,95,103,146,644,976,4,4439,246,0,2,1,1,0
62040,103,5555,1943,715,1694,26,18,214,1969,12,185,120,237,197,357,1436,2721,7,20915,1161,0,2,9,3,0
62041,78,1611,1178,367,1042,6,15,115,1184,9,94,51,95,103,146,644,976,4,4439,246,0,2,38,20,0
62042,78,1611,177,108,140,8,0,27,185,6,30,16,32,36,48,162,248,3,794,44,0,2,38,20,0
62043,84,3507,1178,367,1042,6,15,115,1184,9,94,51,95,103,146,644,976,4,4439,246,0,2,44,0,0
62044,103,5555,1943,715,1694,26,18,214,1969,12,185,120,237,197,357,1436,2721,7,20915,1161,0,2,1,1,0
62045,110,2979,1523,757,1297,19,12,193,1542,12,193,117,230,205,347,1508,2664,7,19053,1058,0,2,12,0,0
62046,110,2979,701,378,504,33,58,109,734,13,110,68,126,123,194,794,1346,7,10027,557,0,2,12,0,0
62047,101,4811,1523,757,1297,19,12,193,1542,12,193,117,230,205,347,1508,2664,7,19053,1058,0,2,27,0,0
62051,44,2727,652,304,544,16,6,88,668,6,89,51,101,95,152,591,998,3,3399,188,0,2,22,11,1
62052,44,2733,652,304,544,16,6,88,668,6,89,51,101,95,152,591,998,3,3399,188,0,2,2,2,0
62053,234,5861,722,423,573,19,0,135,741,12,172,101,199,184,300,1320,2257,6,15668,870,0,2,9,0,0
62054,234,5861,1508,847,911,44,250,301,1552,14,148,88,169,162,257,1120,1886,7,15077,837,0,2,9,0,0
62055,112,4516,1289,550,1043,56,32,155,1345,10,167,93,185,177,278,1266,2075,5,11498,638,0,2,1,1,0
62056,153,7223,1392,870,1177,35,17,170,1427,14,494,280,531,508,811,4473,7289,7,54850,3047,2,2,1,1,0
62057,95,2931,773,419,590,28,0,166,801,10,204,113,217,214,330,1598,2554,5,13587,754,0,2,1,1,0
62058,101,5269,1457,730,1242,11,6,188,1468,10,292,166,329,302,495,2424,4078,5,22973,1276,1,2,4,4,0
62059,43,2695,652,304,544,16,6,88,668,6,89,51,101,95,152,591,998,3,3399,188,0,2,2,12,0
62060,116,2173,477,336,357,30,23,73,507,16,194,134,250,210,384,1538,2962,10,30538,1696,0,2,1,1,0
62061,78,1607,1178,367,1042,6,15,115,1184,9,94,51,95,103,146,644,976,4,4439,246,0,2,6,10,0
62062,78,1607,177,108,140,8,0,27,185,6,30,16,32,36,48,162,248,3,794,44,0,2,6,10,0
62063,84,3507,1178,367,1042,6,15,115,1184,9,94,51,95,103,146,644,976,4,4439,246,0,2,10,10,0
62065,116,2173,477,336,357,30,23,73,507,16,194,134,250,210,384,1538,2962,10,30538,1696,0,2,38,18,0
62066,128,5170,1450,624,1228,12,26,181,1462,14,306,186,354,320,540,2580,4493,8,36391,2021,1,2,44,0,0
62067,28,981,74,35,59,1,0,14,75,3,14,7,14,17,21,58,85,1,128,7,0,2,2,1,0
62068,28,981,245,125,200,5,7,34,250,7,30,17,34,37,51,166,265,3,1053,58,0,2,2,1,0
62069,84,3547,1178,367,1042,6,15,115,1184,9,94,51,95,103,146,644,976,4,4439,246,0,2,8,0,0
62072,1,96,42,7,35,4,0,5,46,1,2,1,2,3,3,2,4,0,2,0,0,2,1,0,1
62073,1,96,11,6,10,0,0,1,11,2,4,2,4,6,6,10,15,1,15,0,0,2,1,0,1
62074,79,1627,1178,367,1042,6,15,115,1184,9,94,51,95,103,146,644,976,4,4439,246,0,2,9,3,1
62075,79,1627,177,108,140,8,0,27,185,6,30,16,32,36,48,162,248,3,794,44,0,2,9,3,1
62076,87,3601,1178,367,1042,6,15,115,1184,9,94,51,95,103,146,644,976,4,4439,246,0,2,45,28,1
62077,54,1488,339,213,244,17,9,65,356,10,42,26,48,52,74,259,421,5,2410,133,0,2,23,17,0
62078,74,3830,1293,570,1093,25,15,163,1318,10,195,123,241,205,364,1516,2795,6,17273,959,0,2,37,7,0
62081,239,5959,722,423,573,19,0,135,741,12,172,101,199,184,300,1320,2257,6,15668,870,0,2,32,6,1
62082,239,5959,1508,847,911,44,250,301,1552,14,148,88,169,162,257,1120,1886,7,15077,837,0,2,32,6,1
62083,54,2723,722,423,573,19,0,135,741,12,172,101,199,184,300,1320,2257,6,15668,870,0,2,58,0,1
62084,235,5967,722,423,573,19,0,135,741,12,172,101,199,184,300,1320,2257,6,15668,870,0,2,8,1,1
62085,235,5967,1508,847,911,44,250,301,1552,14,148,88,169,162,257,1120,1886,7,15077,837,0,2,8,1,1
62086,55,2800,722,423,573,19,0,135,741,12,172,101,199,184,300,1320,2257,6,15668,870,0,2,19,0,1
62087,87,3622,1178,367,1042,6,15,115,1184,9,94,51,95,103,146,644,976,4,4439,246,0,2,15,12,0
62088,87,3625,1178,367,1042,6,15,115,1184,9,94,51,95,103,146,644,976,4,4439,246,0,2,1,0,0
62089,248,5130,1943,715,1694,26,18,214,1969,12,185,120,237,197,357,1436,2721,7,20915,1161,0,2,4,4,0
62090,248,5130,1168,838,957,57,25,144,1225,19,348,224,416,367,640,3018,5452,11,61921,3440,1,2,4,4,0
62091,248,5135,1943,715,1694,26,18,214,1969,12,185,120,237,197,357,1436,2721,7,20915,1161,0,2,7,4,0
62092,248,5135,1168,838,957,57,25,144,1225,19,348,224,416,367,640,3018,5452,11,61921,3440,1,2,7,4,0
62093,103,5558,1943,715,1694,26,18,214,1969,12,185,120,237,197,357,1436,2721,7,20915,1161,0,2,3,0,0
62094,103,5579,1943,715,1694,26,18,214,1969,12,185,120,237,197,357,1436,2721,7,20915,1161,0,2,8,2,0
62095,41,821,1178,367,1042,6,15,115,1184,9,94,51,95,103,146,644,976,4,4439,246,0,2,0,125,0
62096,41,821,177,108,140,8,0,27,185,6,30,16,32,36,48,162,248,3,794,44,0,2,0,125,0
62097,279,5775,1943,715,1694,26,18,214,1969,12,185,120,237,197,357,1436,2721,7,20915,1161,0,2,122,0,0
62098,279,5775,1168,838,957,57,25,144,1225,19,348,224,416,367,640,3018,5452,11,61921,3440,1,2,122,0,0
62099,80,3144,1178,367,1042,6,15,115,1184,9,94,51,95,103,146,644,976,4,4439,246,0,2,0,35,0
62100,104,5687,1943,715,1694,26,18,214,1969,12,185,120,237,197,357,1436,2721,7,20915,1161,0,2,35,0,0
62101,7,107,127,75,83,2,11,30,129,4,14,7,14,18,21,61,87,2,175,9,0,0,26,0,1
62102,7,107,652,304,544,16,6,88,668,6,89,51,101,95,152,591,998,3,3399,188,0,0,26,0,1
62103,7,107,2,2,2,0,0,0,2,0,0,0,0,0,0,0,0,0,0,0,0,0,26,0,1
62104,7,107,8,5,5,0,0,3,8,0,0,0,0,0,0,0,0,0,0,0,0,0,26,0,1
62107,7,107,14,8,8,0,0,6,14,0,0,0,0,0,0,0,0,0,0,0,0,0,26,0,1
62108,7,107,6,4,4,0,0,2,6,0,0,0,0,0,0,0,0,0,0,0,0,0,26,0,1
62109,7,107,6,4,4,0,0,2,6,1,2,1,2,3,3,2,4,0,2,0,0,0,26,0,1
62111,7,107,7,5,5,0,0,2,7,0,0,0,0,0,0,0,0,0,0,0,0,0,26,0,1
62113,7,107,10,6,6,0,0,4,10,0,0,0,0,0,0,0,0,0,0,0,0,0,26,0,1
62114,7,107,1,1,1,0,0,0,1,0,0,0,0,0,0,0,0,0,0,0,0,0,26,0,1
62116,7,107,14,10,10,0,0,4,14,1,1,1,1,2,2,0,2,0,1,0,0,0,26,0,1
62117,7,107,46,26,30,3,0,12,49,3,6,3,6,9,9,20,28,1,42,2,0,0,26,0,1
62118,280,5752,1943,715,1694,26,18,214,1969,12,185,120,237,197,357,1436,2721,7,20915,1161,0,2,94,101,0
62119,280,5752,1168,838,957,57,25,144,1225,19,348,224,416,367,640,3018,5452,11,61921,3440,1,2,94,101,0
62120,104,5687,1943,715,1694,26,18,214,1969,12,185,120,237,197,357,1436,2721,7,20915,1161,0,2,2,2,0
62121,278,5743,1943,715,1694,26,18,214,1969,12,185,120,237,197,357,1436,2721,7,20915,1161,0,2,6,11,0
62122,278,5743,1168,838,957,57,25,144,1225,19,348,224,416,367,640,3018,5452,11,61921,3440,1,2,6,11,0
62123,275,5744,1943,715,1694,26,18,214,1969,12,185,120,237,197,357,1436,2721,7,20915,1161,0,2,33,41,1
62124,275,5744,1168,838,957,57,25,144,1225,19,348,224,416,367,640,3018,5452,11,61921,3440,1,2,33,41,1
62125,54,1488,339,213,244,17,9,65,356,10,42,26,48,52,74,259,421,5,2410,133,0,2,1,1,1
62126,74,3867,1293,570,1093,25,15,163,1318,10,195,123,241,205,364,1516,2795,6,17273,959,0,2,13,2,1
62127,248,5130,1943,715,1694,26,18,214,1969,12,185,120,237,197,357,1436,2721,7,20915,1161,0,2,1,1,0
62128,248,5130,1168,838,957,57,25,144,1225,19,348,224,416,367,640,3018,5452,11,61921,3440,1,2,1,1,0
62129,249,5128,1943,715,1694,26,18,214,1969,12,185,120,237,197,357,1436,2721,7,20915,1161,0,2,11,8,0
62130,249,5128,1168,838,957,57,25,144,1225,19,348,224,416,367,640,3018,5452,11,61921,3440,1,2,11,8,0
62131,54,1488,339,213,244,17,9,65,356,10,42,26,48,52,74,259,421,5,2410,133,0,2,1,1,0
62132,74,3867,1293,570,1093,25,15,163,1318,10,195,123,241,205,364,1516,2795,6,17273,959,0,2,13,2,0
62133,235,5973,722,423,573,19,0,135,741,12,172,101,199,184,300,1320,2257,6,15668,870,0,2,5,5,0
62134,235,5973,1508,847,911,44,250,301,1552,14,148,88,169,162,257,1120,1886,7,15077,837,0,2,5,5,0
62135,234,5944,722,423,573,19,0,135,741,12,172,101,199,184,300,1320,2257,6,15668,870,0,2,1,6,0
62136,234,5944,1508,847,911,44,250,301,1552,14,148,88,169,162,257,1120,1886,7,15077,837,0,2,1,6,0
62137,55,2800,722,423,573,19,0,135,741,12,172,101,199,184,300,1320,2257,6,15668,870,0,2,1,1,0
62138,7,107,127,75,83,2,11,30,129,4,14,7,14,18,21,61,87,2,175,9,0,0,26,0,0
62139,7,107,652,304,544,16,6,88,668,6,89,51,101,95,152,591,998,3,3399,188,0,0,26,0,0
62140,7,107,2,2,2,0,0,0,2,0,0,0,0,0,0,0,0,0,0,0,0,0,26,0,0
62141,7,107,8,5,5,0,0,3,8,0,0,0,0,0,0,0,0,0,0,0,0,0,26,0,0
62144,7,107,14,8,8,0,0,6,14,0,0,0,0,0,0,0,0,0,0,0,0,0,26,0,0
62145,7,107,6,4,4,0,0,2,6,0,0,0,0,0,0,0,0,0,0,0,0,0,26,0,0
62146,7,107,6,4,4,0,0,2,6,1,2,1,2,3,3,2,4,0,2,0,0,0,26,0,0
62148,7,107,7,5,5,0,0,2,7,0,0,0,0,0,0,0,0,0,0,0,0,0,26,0,0
62150,7,107,10,6,6,0,0,4,10,0,0,0,0,0,0,0,0,0,0,0,0,0,26,0,0
62151,7,107,1,1,1,0,0,0,1,0,0,0,0,0,0,0,0,0,0,0,0,0,26,0,0
62153,7,107,14,10,10,0,0,4,14,1,1,1,1,2,2,0,2,0,1,0,0,0,26,0,0
62154,7,107,46,26,30,3,0,12,49,3,6,3,6,9,9,20,28,1,42,2,0,0,26,0,0
62157,249,5128,1943,715,1694,26,18,214,1969,12,185,120,237,197,357,1436,2721,7,20915,1161,0,2,1,1,0
62158,249,5128,1168,838,957,57,25,144,1225,19,348,224,416,367,640,3018,5452,11,61921,3440,1,2,1,1,0
62159,234,5944,722,423,573,19,0,135,741,12,172,101,199,184,300,1320,2257,6,15668,870,0,2,34,6,0
62160,234,5944,1508,847,911,44,250,301,1552,14,148,88,169,162,257,1120,1886,7,15077,837,0,2,34,6,0
62161,55,2800,722,423,573,19,0,135,741,12,172,101,199,184,300,1320,2257,6,15668,870,0,2,77,0,0
62162,233,5970,722,423,573,19,0,135,741,12,172,101,199,184,300,1320,2257,6,15668,870,0,2,16,9,0
62163,233,5970,1508,847,911,44,250,301,1552,14,148,88,169,162,257,1120,1886,7,15077,837,0,2,16,9,0
62164,125,5397,1513,682,1277,25,13,200,1538,11,199,116,219,210,335,1557,2584,6,15641,868,0,2,3,3,0
62171,43,2695,652,304,544,16,6,88,668,6,89,51,101,95,152,591,998,3,3399,188,0,2,15,14,0
62174,276,5742,1943,715,1694,26,18,214,1969,12,185,120,237,197,357,1436,2721,7,20915,1161,0,2,102,0,0
62175,276,5742,1168,838,957,57,25,144,1225,19,348,224,416,367,640,3018,5452,11,61921,3440,1,2,102,0,0
62181,234,6000,722,423,573,19,0,135,741,12,172,101,199,184,300,1320,2257,6,15668,870,0,2,9,0,0
62182,234,6000,1508,847,911,44,250,301,1552,14,148,88,169,162,257,1120,1886,7,15077,837,0,2,9,0,0
62186,103,5268,1457,730,1242,11,6,188,1468,10,292,166,329,302,495,2424,4078,5,22973,1276,1,2,4,4,0
62187,43,2698,652,304,544,16,6,88,668,6,89,51,101,95,152,591,998,3,3399,188,0,2,15,14,0
62195,109,2961,1523,757,1297,19,12,193,1542,12,193,117,230,205,347,1508,2664,7,19053,1058,0,2,8,1,0
62196,109,2961,701,378,504,33,58,109,734,13,110,68,126,123,194,794,1346,7,10027,557,0,2,8,1,0
62197,101,4838,1523,757,1297,19,12,193,1542,12,193,117,230,205,347,1508,2664,7,19053,1058,0,2,19,1,0
62198,81,1651,1178,367,1042,6,15,115,1184,9,94,51,95,103,146,644,976,4,4439,246,0,2,11,0,0
62199,81,1651,177,108,140,8,0,27,185,6,30,16,32,36,48,162,248,3,794,44,0,2,11,0,0
62203,276,5747,1943,715,1694,26,18,214,1969,12,185,120,237,197,357,1436,2721,7,20915,1161,0,2,10,7,0
62204,276,5747,1168,838,957,57,25,144,1225,19,348,224,416,367,640,3018,5452,11,61921,3440,1,2,10,7,0
62205,104,5722,1943,715,1694,26,18,214,1969,12,185,120,237,197,357,1436,2721,7,20915,1161,0,2,11,2,0
62207,248,5739,4293,999,3693,19,54,507,4312,9,155,88,170,164,258,1156,1898,4,9368,520,0,2,3,1,1
62208,248,5739,1482,859,1002,125,135,219,1607,16,219,134,251,235,385,1766,3032,9,27804,1544,1,2,3,1,1
62209,234,5859,722,423,573,19,0,135,741,12,172,101,199,184,300,1320,2257,6,15668,870,0,2,1,1,1
62210,234,5859,1508,847,911,44,250,301,1552,14,148,88,169,162,257,1120,1886,7,15077,837,0,2,1,1,1
62211,171,7587,4293,999,3693,19,54,507,4312,9,155,88,170,164,258,1156,1898,4,9368,520,0,2,1,3,1
62212,171,7587,1482,859,1002,125,135,219,1607,16,219,134,251,235,385,1766,3032,9,27804,1544,1,2,1,3,1
62214,248,5739,4293,999,3693,19,54,507,4312,9,155,88,170,164,258,1156,1898,4,9368,520,0,2,3,1,0
62215,248,5739,1482,859,1002,125,135,219,1607,16,219,134,251,235,385,1766,3032,9,27804,1544,1,2,3,1,0
62216,234,5859,722,423,573,19,0,135,741,12,172,101,199,184,300,1320,2257,6,15668,870,0,2,1,1,0
62217,234,5859,1508,847,911,44,250,301,1552,14,148,88,169,162,257,1120,1886,7,15077,837,0,2,1,1,0
62218,171,7587,4293,999,3693,19,54,507,4312,9,155,88,170,164,258,1156,1898,4,9368,520,0,2,1,3,0
62219,171,7587,1482,859,1002,125,135,219,1607,16,219,134,251,235,385,1766,3032,9,27804,1544,1,2,1,3,0
62221,70,1528,402,202,227,24,74,80,426,12,52,33,61,64,94,339,564,7,3969,220,0,2,9,3,0
62222,20,531,205,80,86,16,53,53,221,7,18,10,19,25,29,94,134,3,497,27,0,2,1,2,0
62223,92,1890,757,253,292,73,244,162,830,13,61,38,67,74,105,409,651,7,4654,258,0,2,1,1,0
62224,70,3188,1020,354,843,12,15,144,1032,8,134,77,144,142,221,970,1580,4,6792,377,0,2,13,0,0
62230,55,1174,447,308,343,6,5,95,453,7,96,59,111,103,170,651,1136,4,4600,255,0,2,12,0,0
62231,55,1174,322,174,179,16,74,51,338,10,41,26,46,51,72,252,408,5,2291,127,0,2,12,0,0
62232,232,5822,722,423,573,19,0,135,741,12,172,101,199,184,300,1320,2257,6,15668,870,0,2,1,18,0
62233,232,5822,1508,847,911,44,250,301,1552,14,148,88,169,162,257,1120,1886,7,15077,837,0,2,1,18,0
62234,47,2189,447,308,343,6,5,95,453,7,96,59,111,103,170,651,1136,4,4600,255,0,2,7,0,0
62240,276,5755,1943,715,1694,26,18,214,1969,12,185,120,237,197,357,1436,2721,7,20915,1161,0,2,1,1,0
62241,276,5755,1168,838,957,57,25,144,1225,19,348,224,416,367,640,3018,5452,11,61921,3440,1,2,1,1,0
62244,24,612,2,2,2,0,0,0,2,0,0,0,0,0,0,0,0,0,0,0,0,2,3,0,0
62258,24,612,99,48,90,1,3,5,100,0,0,0,0,0,0,0,0,0,0,0,0,2,3,0,0
62259,24,612,8,5,5,2,0,1,10,0,0,0,0,0,0,0,0,0,0,0,0,2,3,0,0
62260,24,612,1217,716,841,84,126,174,1301,14,185,118,215,199,333,1446,2542,8,20687,1149,0,2,3,0,0
62261,24,612,160,89,115,0,13,31,160,7,15,11,17,22,28,78,124,3,495,27,0,2,3,0,0
62262,24,612,10,10,9,9,0,0,19,0,0,0,0,0,0,0,0,0,0,0,0,2,3,0,0
62263,24,612,173,84,99,8,29,36,181,5,12,7,13,17,20,54,81,2,221,12,0,2,3,0,0
62264,24,612,3,1,1,3,0,0,6,0,0,0,0,0,0,0,0,0,0,0,0,2,3,0,0
62265,86,3411,1043,504,840,53,9,147,1096,9,180,112,198,189,310,1377,2344,4,11604,644,0,2,8,1,1
62266,234,6000,722,423,573,19,0,135,741,12,172,101,199,184,300,1320,2257,6,15668,870,0,2,1,1,0
62267,234,6000,1508,847,911,44,250,301,1552,14,148,88,169,162,257,1120,1886,7,15077,837,0,2,1,1,0
62268,233,6008,722,423,573,19,0,135,741,12,172,101,199,184,300,1320,2257,6,15668,870,0,2,2,1,0
62269,233,6008,1508,847,911,44,250,301,1552,14,148,88,169,162,257,1120,1886,7,15077,837,0,2,2,1,0
62270,275,5744,1943,715,1694,26,18,214,1969,12,185,120,237,197,357,1436,2721,7,20915,1161,0,2,8,9,0
62271,275,5744,1168,838,957,57,25,144,1225,19,348,224,416,367,640,3018,5452,11,61921,3440,1,2,8,9,0
62272,274,5752,1943,715,1694,26,18,214,1969,12,185,120,237,197,357,1436,2721,7,20915,1161,0,2,2,1,1
62273,274,5752,1168,838,957,57,25,144,1225,19,348,224,416,367,640,3018,5452,11,61921,3440,1,2,2,1,1
62278,69,1526,402,202,227,24,74,80,426,12,52,33,61,64,94,339,564,7,3969,220,0,2,9,3,0
62282,232,5961,722,423,573,19,0,135,741,12,172,101,199,184,300,1320,2257,6,15668,870,0,2,2,19,0
62283,232,5961,1508,847,911,44,250,301,1552,14,148,88,169,162,257,1120,1886,7,15077,837,0,2,2,19,0
62285,171,7599,4293,999,3693,19,54,507,4312,9,155,88,170,164,258,1156,1898,4,9368,520,0,2,1,3,0
62286,171,7599,1482,859,1002,125,135,219,1607,16,219,134,251,235,385,1766,3032,9,27804,1544,1,2,1,3,0
62287,70,3194,1020,354,843,12,15,144,1032,8,134,77,144,142,221,970,1580,4,6792,377,0,2,13,0,0
62289,86,3411,1043,504,840,53,9,147,1096,9,180,112,198,189,310,1377,2344,4,11604,644,0,2,1,1,0
62290,78,1883,996,429,845,24,10,117,1020,7,76,50,88,83,138,494,879,4,3565,198,0,2,37,37,0
62291,78,1883,456,277,329,12,42,72,468,13,85,50,97,98,147,592,972,7,7212,400,0,2,37,37,0
62292,68,1497,402,202,227,24,74,80,426,12,52,33,61,64,94,339,564,7,3969,220,0,2,1,1,0
62293,276,5747,1943,715,1694,26,18,214,1969,12,185,120,237,197,357,1436,2721,7,20915,1161,0,2,2,2,0
62294,276,5747,1168,838,957,57,25,144,1225,19,348,224,416,367,640,3018,5452,11,61921,3440,1,2,2,2,0
62297,236,4937,2,2,2,0,0,0,2,0,0,0,0,0,0,0,0,0,0,0,0,2,0,1,0
62311,236,4937,99,48,90,1,3,5,100,0,0,0,0,0,0,0,0,0,0,0,0,2,0,1,0
62312,236,4937,8,5,5,2,0,1,10,0,0,0,0,0,0,0,0,0,0,0,0,2,0,1,0
62313,236,4937,1217,716,841,84,126,174,1301,14,185,118,215,199,333,1446,2542,8,20687,1149,0,2,0,1,0
62314,236,4937,160,89,115,0,13,31,160,7,15,11,17,22,28,78,124,3,495,27,0,2,0,1,0
62315,236,4937,10,10,9,9,0,0,19,0,0,0,0,0,0,0,0,0,0,0,0,2,0,1,0
62316,236,4937,173,84,99,8,29,36,181,5,12,7,13,17,20,54,81,2,221,12,0,2,0,1,0
62317,236,4937,3,1,1,3,0,0,6,0,0,0,0,0,0,0,0,0,0,0,0,2,0,1,0
62318,54,657,647,139,84,35,284,233,682,0,0,0,0,0,0,0,0,0,0,0,0,2,1,1,0
62319,66,1720,466,257,367,18,25,50,484,7,126,86,171,133,257,898,1813,4,8612,478,0,2,2,1,0
62320,66,1720,507,281,342,29,59,88,536,10,53,29,57,63,86,336,514,5,2764,153,0,2,2,1,0
62321,277,5779,1943,715,1694,26,18,214,1969,12,185,120,237,197,357,1436,2721,7,20915,1161,0,2,11,6,0
62322,277,5779,1168,838,957,57,25,144,1225,19,348,224,416,367,640,3018,5452,11,61921,3440,1,2,11,6,0
62324,69,3128,1020,354,843,12,15,144,1032,8,134,77,144,142,221,970,1580,4,6792,377,0,2,1,1,0
62340,69,1526,402,202,227,24,74,80,426,12,52,33,61,64,94,339,564,7,3969,220,0,2,1,1,0
62341,70,3194,1020,354,843,12,15,144,1032,8,134,77,144,142,221,970,1580,4,6792,377,0,2,1,1,0
62342,86,3411,1043,504,840,53,9,147,1096,9,180,112,198,189,310,1377,2344,4,11604,644,0,2,8,1,0
62347,276,5747,1943,715,1694,26,18,214,1969,12,185,120,237,197,357,1436,2721,7,20915,1161,0,2,1,1,0
62348,276,5747,1168,838,957,57,25,144,1225,19,348,224,416,367,640,3018,5452,11,61921,3440,1,2,1,1,0
62349,104,5724,1943,715,1694,26,18,214,1969,12,185,120,237,197,357,1436,2721,7,20915,1161,0,2,11,3,0
62377,277,5779,1943,715,1694,26,18,214,1969,12,185,120,237,197,357,1436,2721,7,20915,1161,0,2,2,2,0
62378,277,5779,1168,838,957,57,25,144,1225,19,348,224,416,367,640,3018,5452,11,61921,3440,1,2,2,2,0
62379,276,5746,1943,715,1694,26,18,214,1969,12,185,120,237,197,357,1436,2721,7,20915,1161,0,2,4,4,0
62380,276,5746,1168,838,957,57,25,144,1225,19,348,224,416,367,640,3018,5452,11,61921,3440,1,2,4,4,0
62381,67,1744,466,257,367,18,25,50,484,7,126,86,171,133,257,898,1813,4,8612,478,0,2,6,0,0
62382,67,1744,507,281,342,29,59,88,536,10,53,29,57,63,86,336,514,5,2764,153,0,2,6,0,0
62383,275,5715,1943,715,1694,26,18,214,1969,12,185,120,237,197,357,1436,2721,7,20915,1161,0,2,4,10,0
62384,275,5715,1168,838,957,57,25,144,1225,19,348,224,416,367,640,3018,5452,11,61921,3440,1,2,4,10,0
62385,277,5778,1943,715,1694,26,18,214,1969,12,185,120,237,197,357,1436,2721,7,20915,1161,0,2,4,4,0
62386,277,5778,1168,838,957,57,25,144,1225,19,348,224,416,367,640,3018,5452,11,61921,3440,1,2,4,4,0
62387,277,5778,1943,715,1694,26,18,214,1969,12,185,120,237,197,357,1436,2721,7,20915,1161,0,2,1,1,0
62388,277,5778,1168,838,957,57,25,144,1225,19,348,224,416,367,640,3018,5452,11,61921,3440,1,2,1,1,0
62390,231,5969,722,423,573,19,0,135,741,12,172,101,199,184,300,1320,2257,6,15668,870,0,2,3,2,0
62391,231,5969,1508,847,911,44,250,301,1552,14,148,88,169,162,257,1120,1886,7,15077,837,0,2,3,2,0
62392,273,5733,1943,715,1694,26,18,214,1969,12,185,120,237,197,357,1436,2721,7,20915,1161,0,2,1,4,0
62393,273,5733,1168,838,957,57,25,144,1225,19,348,224,416,367,640,3018,5452,11,61921,3440,1,2,1,4,0
62394,274,5764,1943,715,1694,26,18,214,1969,12,185,120,237,197,357,1436,2721,7,20915,1161,0,2,10,13,0
62395,274,5764,1168,838,957,57,25,144,1225,19,348,224,416,367,640,3018,5452,11,61921,3440,1,2,10,13,0
62396,183,5551,1660,832,1314,41,38,274,1701,20,312,209,395,332,604,2671,5058,12,64042,3557,1,2,7,7,0
62397,183,5551,1057,646,719,113,100,145,1170,18,215,134,248,233,382,1740,3004,10,31186,1732,1,2,7,7,0
62398,67,1750,466,257,367,18,25,50,484,7,126,86,171,133,257,898,1813,4,8612,478,0,2,6,0,0
62399,67,1750,507,281,342,29,59,88,536,10,53,29,57,63,86,336,514,5,2764,153,0,2,6,0,0
62400,273,5732,1943,715,1694,26,18,214,1969,12,185,120,237,197,357,1436,2721,7,20915,1161,0,2,4,10,0
62401,273,5732,1168,838,957,57,25,144,1225,19,348,224,416,367,640,3018,5452,11,61921,3440,1,2,4,10,0
62404,78,1883,996,429,845,24,10,117,1020,7,76,50,88,83,138,494,879,4,3565,198,0,2,52,43,0
62405,78,1883,456,277,329,12,42,72,468,13,85,50,97,98,147,592,972,7,7212,400,0,2,52,43,0
62429,54,1488,339,213,244,17,9,65,356,10,42,26,48,52,74,259,421,5,2410,133,0,2,24,18,0
62438,69,1526,402,202,227,24,74,80,426,12,52,33,61,64,94,339,564,7,3969,220,0,2,11,5,0
62442,231,5969,722,423,573,19,0,135,741,12,172,101,199,184,300,1320,2257,6,15668,870,0,2,64,36,0
62443,231,5969,1508,847,911,44,250,301,1552,14,148,88,169,162,257,1120,1886,7,15077,837,0,2,64,36,0
62445,67,1750,466,257,367,18,25,50,484,7,126,86,171,133,257,898,1813,4,8612,478,0,2,8,1,0
62446,67,1750,507,281,342,29,59,88,536,10,53,29,57,63,86,336,514,5,2764,153,0,2,8,1,0
62447,41,821,1178,367,1042,6,15,115,1184,9,94,51,95,103,146,644,976,4,4439,246,0,2,0,173,0
62448,41,821,177,108,140,8,0,27,185,6,30,16,32,36,48,162,248,3,794,44,0,2,0,173,0
62449,283,5921,1943,715,1694,26,18,214,1969,12,185,120,237,197,357,1436,2721,7,20915,1161,0,2,190,36,0
62450,283,5921,1168,838,957,57,25,144,1225,19,348,224,416,367,640,3018,5452,11,61921,3440,1,2,190,36,0
62479,70,3194,1020,354,843,12,15,144,1032,8,134,77,144,142,221,970,1580,4,6792,377,0,2,14,1,0
62481,74,3867,1293,570,1093,25,15,163,1318,10,195,123,241,205,364,1516,2795,6,17273,959,0,2,48,7,0
62484,86,3482,1178,367,1042,6,15,115,1184,9,94,51,95,103,146,644,976,4,4439,246,0,2,0,35,0
62485,104,5735,1943,715,1694,26,18,214,1969,12,185,120,237,197,357,1436,2721,7,20915,1161,0,2,57,5,0
62486,80,3144,1178,367,1042,6,15,115,1184,9,94,51,95,103,146,644,976,4,4439,246,0,2,0,72,1
62487,110,6063,1943,715,1694,26,18,214,1969,12,185,120,237,197,357,1436,2721,7,20915,1161,0,2,70,0,1
62490,235,4924,2,2,2,0,0,0,2,0,0,0,0,0,0,0,0,0,0,0,0,2,1,1,1
62504,235,4924,99,48,90,1,3,5,100,0,0,0,0,0,0,0,0,0,0,0,0,2,1,1,1
62505,235,4924,8,5,5,2,0,1,10,0,0,0,0,0,0,0,0,0,0,0,0,2,1,1,1
62506,235,4924,1217,716,841,84,126,174,1301,14,185,118,215,199,333,1446,2542,8,20687,1149,0,2,1,1,1
62507,235,4924,160,89,115,0,13,31,160,7,15,11,17,22,28,78,124,3,495,27,0,2,1,1,1
62508,235,4924,10,10,9,9,0,0,19,0,0,0,0,0,0,0,0,0,0,0,0,2,1,1,1
62509,235,4924,173,84,99,8,29,36,181,5,12,7,13,17,20,54,81,2,221,12,0,2,1,1,1
62510,235,4924,3,1,1,3,0,0,6,0,0,0,0,0,0,0,0,0,0,0,0,2,1,1,1
62511,75,1629,53,23,39,0,0,13,53,2,8,4,8,10,12,26,39,1,39,2,0,2,4,4,1
62512,75,1629,515,298,307,33,80,99,548,12,63,44,77,75,121,419,753,7,5527,307,0,2,4,4,1
62513,313,6894,72,33,56,0,4,12,72,1,1,1,1,2,2,0,2,0,1,0,0,2,3,3,1
62514,313,6894,1454,835,1044,76,110,219,1530,17,275,158,296,292,454,2297,3718,9,34017,1889,1,2,3,3,1
62515,66,1717,466,257,367,18,25,50,484,7,126,86,171,133,257,898,1813,4,8612,478,0,2,1,1,1
62516,66,1717,507,281,342,29,59,88,536,10,53,29,57,63,86,336,514,5,2764,153,0,2,1,1,1
62517,101,5325,1457,730,1242,11,6,188,1468,10,292,166,329,302,495,2424,4078,5,22973,1276,1,2,9,2,1
62545,235,4924,2,2,2,0,0,0,2,0,0,0,0,0,0,0,0,0,0,0,0,2,1,1,0
62559,235,4924,99,48,90,1,3,5,100,0,0,0,0,0,0,0,0,0,0,0,0,2,1,1,0
62560,235,4924,8,5,5,2,0,1,10,0,0,0,0,0,0,0,0,0,0,0,0,2,1,1,0
62561,235,4924,1217,716,841,84,126,174,1301,14,185,118,215,199,333,1446,2542,8,20687,1149,0,2,1,1,0
62562,235,4924,160,89,115,0,13,31,160,7,15,11,17,22,28,78,124,3,495,27,0,2,1,1,0
62563,235,4924,10,10,9,9,0,0,19,0,0,0,0,0,0,0,0,0,0,0,0,2,1,1,0
62564,235,4924,173,84,99,8,29,36,181,5,12,7,13,17,20,54,81,2,221,12,0,2,1,1,0
62565,235,4924,3,1,1,3,0,0,6,0,0,0,0,0,0,0,0,0,0,0,0,2,1,1,0
62566,75,1629,53,23,39,0,0,13,53,2,8,4,8,10,12,26,39,1,39,2,0,2,4,4,0
62567,75,1629,515,298,307,33,80,99,548,12,63,44,77,75,121,419,753,7,5527,307,0,2,4,4,0
62568,313,6894,72,33,56,0,4,12,72,1,1,1,1,2,2,0,2,0,1,0,0,2,3,3,0
62569,313,6894,1454,835,1044,76,110,219,1530,17,275,158,296,292,454,2297,3718,9,34017,1889,1,2,3,3,0
62570,66,1717,466,257,367,18,25,50,484,7,126,86,171,133,257,898,1813,4,8612,478,0,2,1,1,0
62571,66,1717,507,281,342,29,59,88,536,10,53,29,57,63,86,336,514,5,2764,153,0,2,1,1,0
62572,101,5325,1457,730,1242,11,6,188,1468,10,292,166,329,302,495,2424,4078,5,22973,1276,1,2,9,2,0
62573,159,3787,77,34,69,0,0,8,77,3,24,16,29,27,45,114,213,1,387,21,0,2,1,0,0
62574,159,3787,712,438,573,51,9,84,763,14,102,71,128,116,199,733,1364,8,11988,666,0,2,1,0,0
62575,112,4538,1289,550,1043,56,32,155,1345,10,167,93,185,177,278,1266,2075,5,11498,638,0,2,11,0,0
62576,163,3497,1513,682,1277,25,13,200,1538,11,199,116,219,210,335,1557,2584,6,15641,868,0,2,33,4,0
62577,163,3497,819,519,539,24,98,155,843,15,96,57,106,111,163,690,1107,8,9171,509,0,2,33,4,0
62578,125,5397,1513,682,1277,25,13,200,1538,11,199,116,219,210,335,1557,2584,6,15641,868,0,2,4,5,0
62579,7,123,127,75,83,2,11,30,129,4,14,7,14,18,21,61,87,2,175,9,0,2,11,1,0
62580,7,123,652,304,544,16,6,88,668,6,89,51,101,95,152,591,998,3,3399,188,0,2,11,1,0
62581,7,123,2,2,2,0,0,0,2,0,0,0,0,0,0,0,0,0,0,0,0,2,11,1,0
62582,7,123,8,5,5,0,0,3,8,0,0,0,0,0,0,0,0,0,0,0,0,2,11,1,0
62585,7,123,14,8,8,0,0,6,14,0,0,0,0,0,0,0,0,0,0,0,0,2,11,1,0
62586,7,123,6,4,4,0,0,2,6,0,0,0,0,0,0,0,0,0,0,0,0,2,11,1,0
62587,7,123,6,4,4,0,0,2,6,1,2,1,2,3,3,2,4,0,2,0,0,2,11,1,0
62589,7,123,7,5,5,0,0,2,7,0,0,0,0,0,0,0,0,0,0,0,0,2,11,1,0
62591,7,123,10,6,6,0,0,4,10,0,0,0,0,0,0,0,0,0,0,0,0,2,11,1,0
62592,7,123,1,1,1,0,0,0,1,0,0,0,0,0,0,0,0,0,0,0,0,2,11,1,0
62594,7,123,14,10,10,0,0,4,14,1,1,1,1,2,2,0,2,0,1,0,0,2,11,1,0
62595,7,123,46,26,30,3,0,12,49,3,6,3,6,9,9,20,28,1,42,2,0,2,11,1,0
62619,229,4964,182,127,129,0,0,53,182,5,39,21,42,44,63,217,343,2,926,51,0,2,4,7,1
62620,229,4964,1165,710,800,67,119,181,1232,18,243,153,282,261,435,2000,3492,10,36473,2026,1,2,4,7,1
62621,14,411,149,95,105,2,0,41,151,8,54,28,55,62,83,334,494,4,2013,111,0,2,33,23,1
62622,14,411,82,56,54,0,13,15,82,4,13,8,16,17,24,56,98,2,241,13,0,2,33,23,1
62623,158,7390,1392,870,1177,35,17,170,1427,14,494,280,531,508,811,4473,7289,7,54850,3047,2,2,29,0,1
62624,30,1440,373,158,315,8,0,51,381,5,76,44,79,81,123,486,779,2,2026,112,0,2,24,0,1
62625,229,4964,182,127,129,0,0,53,182,5,39,21,42,44,63,217,343,2,926,51,0,2,4,7,0
62626,229,4964,1165,710,800,67,119,181,1232,18,243,153,282,261,435,2000,3492,10,36473,2026,1,2,4,7,0
62627,14,411,149,95,105,2,0,41,151,8,54,28,55,62,83,334,494,4,2013,111,0,2,33,23,0
62628,14,411,82,56,54,0,13,15,82,4,13,8,16,17,24,56,98,2,241,13,0,2,33,23,0
62629,158,7390,1392,870,1177,35,17,170,1427,14,494,280,531,508,811,4473,7289,7,54850,3047,2,2,29,0,0
62630,30,1440,373,158,315,8,0,51,381,5,76,44,79,81,123,486,779,2,2026,112,0,2,24,0,0
62631,159,3778,77,34,69,0,0,8,77,3,24,16,29,27,45,114,213,1,387,21,0,2,1,1,0
62632,159,3778,712,438,573,51,9,84,763,14,102,71,128,116,199,733,1364,8,11988,666,0,2,1,1,0
62633,273,5728,1943,715,1694,26,18,214,1969,12,185,120,237,197,357,1436,2721,7,20915,1161,0,2,1,1,0
62634,273,5728,1168,838,957,57,25,144,1225,19,348,224,416,367,640,3018,5452,11,61921,3440,1,2,1,1,0
62641,236,4942,2,2,2,0,0,0,2,0,0,0,0,0,0,0,0,0,0,0,0,2,1,1,0
62655,236,4942,99,48,90,1,3,5,100,0,0,0,0,0,0,0,0,0,0,0,0,2,1,1,0
62656,236,4942,8,5,5,2,0,1,10,0,0,0,0,0,0,0,0,0,0,0,0,2,1,1,0
62657,236,4942,1217,716,841,84,126,174,1301,14,185,118,215,199,333,1446,2542,8,20687,1149,0,2,1,1,0
62658,236,4942,160,89,115,0,13,31,160,7,15,11,17,22,28,78,124,3,495,27,0,2,1,1,0
62659,236,4942,10,10,9,9,0,0,19,0,0,0,0,0,0,0,0,0,0,0,0,2,1,1,0
62660,236,4942,173,84,99,8,29,36,181,5,12,7,13,17,20,54,81,2,221,12,0,2,1,1,0
62661,236,4942,3,1,1,3,0,0,6,0,0,0,0,0,0,0,0,0,0,0,0,2,1,1,0
62666,67,1753,466,257,367,18,25,50,484,7,126,86,171,133,257,898,1813,4,8612,478,0,2,1,1,0
62667,67,1753,507,281,342,29,59,88,536,10,53,29,57,63,86,336,514,5,2764,153,0,2,1,1,0
62669,103,5324,1457,730,1242,11,6,188,1468,10,292,166,329,302,495,2424,4078,5,22973,1276,1,2,9,2,0
62707,52,1451,339,213,244,17,9,65,356,10,42,26,48,52,74,259,421,5,2410,133,0,2,0,10,0
62708,73,3817,1293,570,1093,25,15,163,1318,10,195,123,241,205,364,1516,2795,6,17273,959,0,2,0,14,0
62734,103,5336,1457,730,1242,11,6,188,1468,10,292,166,329,302,495,2424,4078,5,22973,1276,1,2,6,4,0
62759,69,1526,402,202,227,24,74,80,426,12,52,33,61,64,94,339,564,7,3969,220,0,2,2,2,0
62760,2,121,37,13,25,0,6,6,37,1,2,1,2,3,3,2,4,0,2,0,0,2,1,1,0
62761,2,121,133,47,40,1,43,49,134,0,0,0,0,0,0,0,0,0,0,0,0,2,1,1,0
62762,183,5551,1660,832,1314,41,38,274,1701,20,312,209,395,332,604,2671,5058,12,64042,3557,1,2,10,6,0
62763,183,5551,1057,646,719,113,100,145,1170,18,215,134,248,233,382,1740,3004,10,31186,1732,1,2,10,6,0
62764,78,1883,996,429,845,24,10,117,1020,7,76,50,88,83,138,494,879,4,3565,198,0,2,2,2,0
62765,78,1883,456,277,329,12,42,72,468,13,85,50,97,98,147,592,972,7,7212,400,0,2,2,2,0
62768,236,4942,2,2,2,0,0,0,2,0,0,0,0,0,0,0,0,0,0,0,0,2,4,4,0
62782,236,4942,99,48,90,1,3,5,100,0,0,0,0,0,0,0,0,0,0,0,0,2,4,4,0
62783,236,4942,8,5,5,2,0,1,10,0,0,0,0,0,0,0,0,0,0,0,0,2,4,4,0
62784,236,4942,1217,716,841,84,126,174,1301,14,185,118,215,199,333,1446,2542,8,20687,1149,0,2,4,4,0
62785,236,4942,160,89,115,0,13,31,160,7,15,11,17,22,28,78,124,3,495,27,0,2,4,4,0
62786,236,4942,10,10,9,9,0,0,19,0,0,0,0,0,0,0,0,0,0,0,0,2,4,4,0
62787,236,4942,173,84,99,8,29,36,181,5,12,7,13,17,20,54,81,2,221,12,0,2,4,4,0
62788,236,4942,3,1,1,3,0,0,6,0,0,0,0,0,0,0,0,0,0,0,0,2,4,4,0
62789,109,2963,1523,757,1297,19,12,193,1542,12,193,117,230,205,347,1508,2664,7,19053,1058,0,2,4,2,0
62790,109,2963,701,378,504,33,58,109,734,13,110,68,126,123,194,794,1346,7,10027,557,0,2,4,2,0
62791,313,6900,72,33,56,0,4,12,72,1,1,1,1,2,2,0,2,0,1,0,0,2,7,6,0
62792,313,6900,1454,835,1044,76,110,219,1530,17,275,158,296,292,454,2297,3718,9,34017,1889,1,2,7,6,0
62793,2,156,37,13,25,0,6,6,37,1,2,1,2,3,3,2,4,0,2,0,0,2,51,9,0
62794,2,156,133,47,40,1,43,49,134,0,0,0,0,0,0,0,0,0,0,0,0,2,51,9,0
62795,53,1862,601,196,481,2,23,85,603,8,63,36,72,71,108,400,664,4,3036,168,0,2,1,1,0
62797,89,2050,996,429,845,24,10,117,1020,7,76,50,88,83,138,494,879,4,3565,198,0,2,39,2,1
62798,89,2050,456,277,329,12,42,72,468,13,85,50,97,98,147,592,972,7,7212,400,0,2,39,2,1
62799,48,3659,996,429,845,24,10,117,1020,7,76,50,88,83,138,494,879,4,3565,198,0,2,56,4,1
62800,89,2050,996,429,845,24,10,117,1020,7,76,50,88,83,138,494,879,4,3565,198,0,2,39,2,0
62801,89,2050,456,277,329,12,42,72,468,13,85,50,97,98,147,592,972,7,7212,400,0,2,39,2,0
62802,48,3659,996,429,845,24,10,117,1020,7,76,50,88,83,138,494,879,4,3565,198,0,2,56,4,0
62803,275,5732,1943,715,1694,26,18,214,1969,12,185,120,237,197,357,1436,2721,7,20915,1161,0,2,2,4,0
62804,275,5732,1168,838,957,57,25,144,1225,19,348,224,416,367,640,3018,5452,11,61921,3440,1,2,2,4,0
62805,105,5773,1943,715,1694,26,18,214,1969,12,185,120,237,197,357,1436,2721,7,20915,1161,0,2,31,0,0
62807,52,1451,339,213,244,17,9,65,356,10,42,26,48,52,74,259,421,5,2410,133,0,2,6,6,0
62808,272,5717,1943,715,1694,26,18,214,1969,12,185,120,237,197,357,1436,2721,7,20915,1161,0,2,2,4,0
62809,272,5717,1168,838,957,57,25,144,1225,19,348,224,416,367,640,3018,5452,11,61921,3440,1,2,2,4,0
62810,105,5775,1943,715,1694,26,18,214,1969,12,185,120,237,197,357,1436,2721,7,20915,1161,0,2,31,0,0
62813,89,2050,996,429,845,24,10,117,1020,7,76,50,88,83,138,494,879,4,3565,198,0,2,2,2,0
62814,89,2050,456,277,329,12,42,72,468,13,85,50,97,98,147,592,972,7,7212,400,0,2,2,2,0
62847,159,3783,77,34,69,0,0,8,77,3,24,16,29,27,45,114,213,1,387,21,0,2,1,1,0
62848,159,3783,712,438,573,51,9,84,763,14,102,71,128,116,199,733,1364,8,11988,666,0,2,1,1,0
62849,272,5713,1943,715,1694,26,18,214,1969,12,185,120,237,197,357,1436,2721,7,20915,1161,0,2,1,1,0
62850,272,5713,1168,838,957,57,25,144,1225,19,348,224,416,367,640,3018,5452,11,61921,3440,1,2,1,1,0
62851,72,1466,1178,367,1042,6,15,115,1184,9,94,51,95,103,146,644,976,4,4439,246,0,2,1,1,0
62852,72,1466,177,108,140,8,0,27,185,6,30,16,32,36,48,162,248,3,794,44,0,2,1,1,0
62855,54,657,647,139,84,35,284,233,682,0,0,0,0,0,0,0,0,0,0,0,0,2,7,4,0
62857,272,5721,1943,715,1694,26,18,214,1969,12,185,120,237,197,357,1436,2721,7,20915,1161,0,2,1,1,0
62858,272,5721,1168,838,957,57,25,144,1225,19,348,224,416,367,640,3018,5452,11,61921,3440,1,2,1,1,0
62861,41,821,1178,367,1042,6,15,115,1184,9,94,51,95,103,146,644,976,4,4439,246,0,2,1,1,0
62862,41,821,177,108,140,8,0,27,185,6,30,16,32,36,48,162,248,3,794,44,0,2,1,1,0
62867,110,3013,1523,757,1297,19,12,193,1542,12,193,117,230,205,347,1508,2664,7,19053,1058,0,2,21,10,0
62868,110,3013,701,378,504,33,58,109,734,13,110,68,126,123,194,794,1346,7,10027,557,0,2,21,10,0
62869,103,4933,1523,757,1297,19,12,193,1542,12,193,117,230,205,347,1508,2664,7,19053,1058,0,2,36,14,0
62870,110,6063,1943,715,1694,26,18,214,1969,12,185,120,237,197,357,1436,2721,7,20915,1161,0,2,1,0,0
62871,283,5921,1943,715,1694,26,18,214,1969,12,185,120,237,197,357,1436,2721,7,20915,1161,0,2,1,0,0
62872,283,5921,1168,838,957,57,25,144,1225,19,348,224,416,367,640,3018,5452,11,61921,3440,1,2,1,0,0
62873,110,6071,1943,715,1694,26,18,214,1969,12,185,120,237,197,357,1436,2721,7,20915,1161,0,2,3,3,0
62877,92,1890,757,253,292,73,244,162,830,13,61,38,67,74,105,409,651,7,4654,258,0,2,2,1,0
62879,92,1890,757,253,292,73,244,162,830,13,61,38,67,74,105,409,651,7,4654,258,0,2,7,1,0
62881,92,1890,757,253,292,73,244,162,830,13,61,38,67,74,105,409,651,7,4654,258,0,2,5,5,0
62884,60,1163,282,196,195,3,0,86,285,8,130,71,141,138,212,936,1507,4,6538,363,0,2,1,3,0
62885,229,4960,182,127,129,0,0,53,182,5,39,21,42,44,63,217,343,2,926,51,0,2,1,2,0
62886,229,4960,1165,710,800,67,119,181,1232,18,243,153,282,261,435,2000,3492,10,36473,2026,1,2,1,2,0
62887,183,5551,1660,832,1314,41,38,274,1701,20,312,209,395,332,604,2671,5058,12,64042,3557,1,2,1,1,0
62888,183,5551,1057,646,719,113,100,145,1170,18,215,134,248,233,382,1740,3004,10,31186,1732,1,2,1,1,0
62889,92,1886,757,253,292,73,244,162,830,13,61,38,67,74,105,409,651,7,4654,258,0,2,1,2,0
62890,45,953,386,256,301,16,9,68,402,4,59,35,69,63,104,355,621,2,1453,80,0,2,1,1,0
62891,45,953,264,131,164,11,41,46,275,6,38,22,40,44,62,214,338,3,1068,59,0,2,1,1,0
62892,95,2927,773,419,590,28,0,166,801,10,204,113,217,214,330,1598,2554,5,13587,754,0,2,2,2,0
62893,176,5284,1660,832,1314,41,38,274,1701,20,312,209,395,332,604,2671,5058,12,64042,3557,1,2,1,1,0
62905,176,5307,1660,832,1314,41,38,274,1701,20,312,209,395,332,604,2671,5058,12,64042,3557,1,2,1,1,0
62906,314,6930,72,33,56,0,4,12,72,1,1,1,1,2,2,0,2,0,1,0,0,2,6,4,0
62907,314,6930,1454,835,1044,76,110,219,1530,17,275,158,296,292,454,2297,3718,9,34017,1889,1,2,6,4,0
62908,171,7609,4293,999,3693,19,54,507,4312,9,155,88,170,164,258,1156,1898,4,9368,520,0,2,16,2,0
62909,171,7609,1482,859,1002,125,135,219,1607,16,219,134,251,235,385,1766,3032,9,27804,1544,1,2,16,2,0
62910,282,5913,1943,715,1694,26,18,214,1969,12,185,120,237,197,357,1436,2721,7,20915,1161,0,2,1,2,0
62911,282,5913,1168,838,957,57,25,144,1225,19,348,224,416,367,640,3018,5452,11,61921,3440,1,2,1,2,0
62916,1,94,42,7,35,4,0,5,46,1,2,1,2,3,3,2,4,0,2,0,0,2,1,1,0
62917,1,94,11,6,10,0,0,1,11,2,4,2,4,6,6,10,15,1,15,0,0,2,1,1,0
62921,36,2427,1157,318,931,29,22,177,1186,6,104,63,125,110,188,712,1274,3,4596,255,0,2,7,7,0
62924,1,96,42,7,35,4,0,5,46,1,2,1,2,3,3,2,4,0,2,0,0,2,1,0,0
62925,1,96,11,6,10,0,0,1,11,2,4,2,4,6,6,10,15,1,15,0,0,2,1,0,0
62926,41,821,1178,367,1042,6,15,115,1184,9,94,51,95,103,146,644,976,4,4439,246,0,2,1,0,0
62927,41,821,177,108,140,8,0,27,185,6,30,16,32,36,48,162,248,3,794,44,0,2,1,0,0
62928,281,5902,1943,715,1694,26,18,214,1969,12,185,120,237,197,357,1436,2721,7,20915,1161,0,2,57,7,0
62929,281,5902,1168,838,957,57,25,144,1225,19,348,224,416,367,640,3018,5452,11,61921,3440,1,2,57,7,0
62930,112,4538,1289,550,1043,56,32,155,1345,10,167,93,185,177,278,1266,2075,5,11498,638,0,2,3,1,0
62931,80,3144,1178,367,1042,6,15,115,1184,9,94,51,95,103,146,644,976,4,4439,246,0,2,2,1,0
62932,111,6122,1943,715,1694,26,18,214,1969,12,185,120,237,197,357,1436,2721,7,20915,1161,0,2,80,3,0
62935,52,1464,339,213,244,17,9,65,356,10,42,26,48,52,74,259,421,5,2410,133,0,2,8,2,0
62936,75,3895,1293,570,1093,25,15,163,1318,10,195,123,241,205,364,1516,2795,6,17273,959,0,2,30,2,0
62937,248,5737,4293,999,3693,19,54,507,4312,9,155,88,170,164,258,1156,1898,4,9368,520,0,2,2,4,0
62938,248,5737,1482,859,1002,125,135,219,1607,16,219,134,251,235,385,1766,3032,9,27804,1544,1,2,2,4,0
62945,1,96,42,7,35,4,0,5,46,1,2,1,2,3,3,2,4,0,2,0,0,2,1,1,0
62946,1,96,11,6,10,0,0,1,11,2,4,2,4,6,6,10,15,1,15,0,0,2,1,1,0
62949,183,5549,1660,832,1314,41,38,274,1701,20,312,209,395,332,604,2671,5058,12,64042,3557,1,2,1,1,0
62950,183,5549,1057,646,719,113,100,145,1170,18,215,134,248,233,382,1740,3004,10,31186,1732,1,2,1,1,0
62951,92,1886,757,253,292,73,244,162,830,13,61,38,67,74,105,409,651,7,4654,258,0,2,10,4,0
62955,176,5307,1660,832,1314,41,38,274,1701,20,312,209,395,332,604,2671,5058,12,64042,3557,1,2,4,1,0
62956,159,3785,77,34,69,0,0,8,77,3,24,16,29,27,45,114,213,1,387,21,0,2,2,6,0
62957,159,3785,712,438,573,51,9,84,763,14,102,71,128,116,199,733,1364,8,11988,666,0,2,2,6,0
62958,69,1527,402,202,227,24,74,80,426,12,52,33,61,64,94,339,564,7,3969,220,0,2,5,2,0
62959,70,3211,1020,354,843,12,15,144,1032,8,134,77,144,142,221,970,1580,4,6792,377,0,2,8,5,0
62960,9,449,219,78,157,11,5,46,230,3,24,20,34,27,54,114,256,2,545,30,0,2,21,8,0
62962,171,7566,4293,999,3693,19,54,507,4312,9,155,88,170,164,258,1156,1898,4,9368,520,0,2,4,5,0
62963,171,7566,1482,859,1002,125,135,219,1607,16,219,134,251,235,385,1766,3032,9,27804,1544,1,2,4,5,0
62964,33,999,465,148,393,5,8,60,470,4,31,20,31,35,51,161,261,2,523,29,0,2,2,1,0
62965,33,999,16,12,9,0,0,6,16,1,2,1,2,3,3,2,4,0,2,0,0,2,2,1,0
62966,126,5520,1782,648,1425,9,47,279,1791,8,171,97,189,179,286,1292,2140,4,9462,525,0,2,26,18,0
62967,125,5389,1513,682,1277,25,13,200,1538,11,199,116,219,210,335,1557,2584,6,15641,868,0,2,1,1,0
62968,43,2690,652,304,544,16,6,88,668,6,89,51,101,95,152,591,998,3,3399,188,0,2,1,1,0
62969,70,3187,1020,354,843,12,15,144,1032,8,134,77,144,142,221,970,1580,4,6792,377,0,2,3,3,0
62970,45,1953,386,256,301,16,9,68,402,4,59,35,69,63,104,355,621,2,1453,80,0,2,1,1,0
62971,37,1519,442,244,305,14,16,103,456,11,68,45,75,79,120,452,756,6,4588,254,0,2,1,1,0
62972,52,1986,1098,241,925,5,10,155,1103,7,46,25,49,53,74,273,423,3,1580,87,0,2,1,1,0
62973,158,7384,1392,870,1177,35,17,170,1427,14,494,280,531,508,811,4473,7289,7,54850,3047,2,2,0,2,0
62974,95,2916,773,419,590,28,0,166,801,10,204,113,217,214,330,1598,2554,5,13587,754,0,2,0,4,0
62975,70,3187,1020,354,843,12,15,144,1032,8,134,77,144,142,221,970,1580,4,6792,377,0,2,8,8,0
62989,115,3128,1523,757,1297,19,12,193,1542,12,193,117,230,205,347,1508,2664,7,19053,1058,0,2,43,1,0
62990,115,3128,701,378,504,33,58,109,734,13,110,68,126,123,194,794,1346,7,10027,557,0,2,43,1,0
62991,107,5109,1523,757,1297,19,12,193,1542,12,193,117,230,205,347,1508,2664,7,19053,1058,0,2,47,0,0
62999,95,2912,773,419,590,28,0,166,801,10,204,113,217,214,330,1598,2554,5,13587,754,0,2,0,4,0
63007,70,3187,1020,354,843,12,15,144,1032,8,134,77,144,142,221,970,1580,4,6792,377,0,2,19,16,0
63015,183,5549,1660,832,1314,41,38,274,1701,20,312,209,395,332,604,2671,5058,12,64042,3557,1,2,17,13,0
63016,183,5549,1057,646,719,113,100,145,1170,18,215,134,248,233,382,1740,3004,10,31186,1732,1,2,17,13,0
63018,89,2050,996,429,845,24,10,117,1020,7,76,50,88,83,138,494,879,4,3565,198,0,2,90,35,0
63019,89,2050,456,277,329,12,42,72,468,13,85,50,97,98,147,592,972,7,7212,400,0,2,90,35,0
63020,163,3497,1513,682,1277,25,13,200,1538,11,199,116,219,210,335,1557,2584,6,15641,868,0,2,33,11,0
63021,163,3497,819,519,539,24,98,155,843,15,96,57,106,111,163,690,1107,8,9171,509,0,2,33,11,0
63024,236,4942,2,2,2,0,0,0,2,0,0,0,0,0,0,0,0,0,0,0,0,2,14,9,0
63038,236,4942,99,48,90,1,3,5,100,0,0,0,0,0,0,0,0,0,0,0,0,2,14,9,0
63039,236,4942,8,5,5,2,0,1,10,0,0,0,0,0,0,0,0,0,0,0,0,2,14,9,0
63040,236,4942,1217,716,841,84,126,174,1301,14,185,118,215,199,333,1446,2542,8,20687,1149,0,2,14,9,0
63041,236,4942,160,89,115,0,13,31,160,7,15,11,17,22,28,78,124,3,495,27,0,2,14,9,0
63042,236,4942,10,10,9,9,0,0,19,0,0,0,0,0,0,0,0,0,0,0,0,2,14,9,0
63043,236,4942,173,84,99,8,29,36,181,5,12,7,13,17,20,54,81,2,221,12,0,2,14,9,0
63044,236,4942,3,1,1,3,0,0,6,0,0,0,0,0,0,0,0,0,0,0,0,2,14,9,0
63045,52,1464,339,213,244,17,9,65,356,10,42,26,48,52,74,259,421,5,2410,133,0,2,14,8,0
63046,248,5739,4293,999,3693,19,54,507,4312,9,155,88,170,164,258,1156,1898,4,9368,520,0,2,1,0,0
63047,248,5739,1482,859,1002,125,135,219,1607,16,219,134,251,235,385,1766,3032,9,27804,1544,1,2,1,0,0
63051,115,3128,1523,757,1297,19,12,193,1542,12,193,117,230,205,347,1508,2664,7,19053,1058,0,2,75,13,0
63052,115,3128,701,378,504,33,58,109,734,13,110,68,126,123,194,794,1346,7,10027,557,0,2,75,13,0
63054,159,3785,77,34,69,0,0,8,77,3,24,16,29,27,45,114,213,1,387,21,0,2,9,9,0
63055,159,3785,712,438,573,51,9,84,763,14,102,71,128,116,199,733,1364,8,11988,666,0,2,9,9,0
63058,24,612,2,2,2,0,0,0,2,0,0,0,0,0,0,0,0,0,0,0,0,2,4,2,0
63072,24,612,99,48,90,1,3,5,100,0,0,0,0,0,0,0,0,0,0,0,0,2,4,2,0
63073,24,612,8,5,5,2,0,1,10,0,0,0,0,0,0,0,0,0,0,0,0,2,4,2,0
63074,24,612,1217,716,841,84,126,174,1301,14,185,118,215,199,333,1446,2542,8,20687,1149,0,2,4,2,0
63075,24,612,160,89,115,0,13,31,160,7,15,11,17,22,28,78,124,3,495,27,0,2,4,2,0
63076,24,612,10,10,9,9,0,0,19,0,0,0,0,0,0,0,0,0,0,0,0,2,4,2,0
63077,24,612,173,84,99,8,29,36,181,5,12,7,13,17,20,54,81,2,221,12,0,2,4,2,0
63078,24,612,3,1,1,3,0,0,6,0,0,0,0,0,0,0,0,0,0,0,0,2,4,2,0
63079,69,1527,402,202,227,24,74,80,426,12,52,33,61,64,94,339,564,7,3969,220,0,2,32,18,0
63082,231,5969,722,423,573,19,0,135,741,12,172,101,199,184,300,1320,2257,6,15668,870,0,2,59,17,0
63083,231,5969,1508,847,911,44,250,301,1552,14,148,88,169,162,257,1120,1886,7,15077,837,0,2,59,17,0
63084,314,6930,72,33,56,0,4,12,72,1,1,1,1,2,2,0,2,0,1,0,0,2,13,10,0
63085,314,6930,1454,835,1044,76,110,219,1530,17,275,158,296,292,454,2297,3718,9,34017,1889,1,2,13,10,0
63086,67,1753,466,257,367,18,25,50,484,7,126,86,171,133,257,898,1813,4,8612,478,0,2,8,1,0
63087,67,1753,507,281,342,29,59,88,536,10,53,29,57,63,86,336,514,5,2764,153,0,2,8,1,0
63090,41,821,1178,367,1042,6,15,115,1184,9,94,51,95,103,146,644,976,4,4439,246,0,2,1,125,0
63091,41,821,177,108,140,8,0,27,185,6,30,16,32,36,48,162,248,3,794,44,0,2,1,125,0
63092,281,5902,1943,715,1694,26,18,214,1969,12,185,120,237,197,357,1436,2721,7,20915,1161,0,2,195,42,0
63093,281,5902,1168,838,957,57,25,144,1225,19,348,224,416,367,640,3018,5452,11,61921,3440,1,2,195,42,0
63094,2,156,37,13,25,0,6,6,37,1,2,1,2,3,3,2,4,0,2,0,0,2,57,6,0
63095,2,156,133,47,40,1,43,49,134,0,0,0,0,0,0,0,0,0,0,0,0,2,57,6,0
63096,112,4538,1289,550,1043,56,32,155,1345,10,167,93,185,177,278,1266,2075,5,11498,638,0,2,14,1,0
63099,7,123,127,75,83,2,11,30,129,4,14,7,14,18,21,61,87,2,175,9,0,0,36,0,0
63100,7,123,652,304,544,16,6,88,668,6,89,51,101,95,152,591,998,3,3399,188,0,0,36,0,0
63101,7,123,2,2,2,0,0,0,2,0,0,0,0,0,0,0,0,0,0,0,0,0,36,0,0
63102,7,123,8,5,5,0,0,3,8,0,0,0,0,0,0,0,0,0,0,0,0,0,36,0,0
63105,7,123,14,8,8,0,0,6,14,0,0,0,0,0,0,0,0,0,0,0,0,0,36,0,0
63106,7,123,6,4,4,0,0,2,6,0,0,0,0,0,0,0,0,0,0,0,0,0,36,0,0
63107,7,123,6,4,4,0,0,2,6,1,2,1,2,3,3,2,4,0,2,0,0,0,36,0,0
63109,7,123,7,5,5,0,0,2,7,0,0,0,0,0,0,0,0,0,0,0,0,0,36,0,0
63111,7,123,10,6,6,0,0,4,10,0,0,0,0,0,0,0,0,0,0,0,0,0,36,0,0
63112,7,123,1,1,1,0,0,0,1,0,0,0,0,0,0,0,0,0,0,0,0,0,36,0,0
63114,7,123,14,10,10,0,0,4,14,1,1,1,1,2,2,0,2,0,1,0,0,0,36,0,0
63115,7,123,46,26,30,3,0,12,49,3,6,3,6,9,9,20,28,1,42,2,0,0,36,0,0
63117,171,7566,4293,999,3693,19,54,507,4312,9,155,88,170,164,258,1156,1898,4,9368,520,0,2,20,7,0
63118,171,7566,1482,859,1002,125,135,219,1607,16,219,134,251,235,385,1766,3032,9,27804,1544,1,2,20,7,0
63123,48,3659,996,429,845,24,10,117,1020,7,76,50,88,83,138,494,879,4,3565,198,0,2,105,13,0
63124,125,5389,1513,682,1277,25,13,200,1538,11,199,116,219,210,335,1557,2584,6,15641,868,0,2,8,9,0
63125,103,5336,1457,730,1242,11,6,188,1468,10,292,166,329,302,495,2424,4078,5,22973,1276,1,2,8,12,0
63127,107,5109,1523,757,1297,19,12,193,1542,12,193,117,230,205,347,1508,2664,7,19053,1058,0,2,102,15,0
63129,75,3895,1293,570,1093,25,15,163,1318,10,195,123,241,205,364,1516,2795,6,17273,959,0,2,45,5,0
63133,86,3411,1043,504,840,53,9,147,1096,9,180,112,198,189,310,1377,2344,4,11604,644,0,2,23,0,0
63134,80,3144,1178,367,1042,6,15,115,1184,9,94,51,95,103,146,644,976,4,4439,246,0,2,2,36,0
63136,111,6122,1943,715,1694,26,18,214,1969,12,185,120,237,197,357,1436,2721,7,20915,1161,0,2,168,8,0
63139,53,1862,601,196,481,2,23,85,603,8,63,36,72,71,108,400,664,4,3036,168,0,2,2,2,0
63140,76,3910,1293,570,1093,25,15,163,1318,10,195,123,241,205,364,1516,2795,6,17273,959,0,2,16,12,0
63142,75,3895,1293,570,1093,25,15,163,1318,10,195,123,241,205,364,1516,2795,6,17273,959,0,2,4,4,0
63143,30,1440,373,158,315,8,0,51,381,5,76,44,79,81,123,486,779,2,2026,112,0,2,1,1,0
63144,164,3518,1513,682,1277,25,13,200,1538,11,199,116,219,210,335,1557,2584,6,15641,868,0,2,4,0,0
63145,164,3518,819,519,539,24,98,155,843,15,96,57,106,111,163,690,1107,8,9171,509,0,2,4,0,0
63146,126,5406,1513,682,1277,25,13,200,1538,11,199,116,219,210,335,1557,2584,6,15641,868,0,2,3,0,0
63149,112,4538,1289,550,1043,56,32,155,1345,10,167,93,185,177,278,1266,2075,5,11498,638,0,2,1,1,0
63150,158,7384,1392,870,1177,35,17,170,1427,14,494,280,531,508,811,4473,7289,7,54850,3047,2,2,1,1,0
63151,95,2912,773,419,590,28,0,166,801,10,204,113,217,214,330,1598,2554,5,13587,754,0,2,1,1,0
63152,12,318,149,95,105,2,0,41,151,8,54,28,55,62,83,334,494,4,2013,111,0,2,1,1,0
63154,36,2427,1157,318,931,29,22,177,1186,6,104,63,125,110,188,712,1274,3,4596,255,0,2,2,2,0
63155,90,3974,1338,495,1086,10,64,173,1348,11,122,82,157,133,239,883,1686,7,11934,663,0,2,3,3,0
63156,171,7566,4293,999,3693,19,54,507,4312,9,155,88,170,164,258,1156,1898,4,9368,520,0,2,1,1,0
63157,171,7566,1482,859,1002,125,135,219,1607,16,219,134,251,235,385,1766,3032,9,27804,1544,1,2,1,1,0
63158,126,5520,1782,648,1425,9,47,279,1791,8,171,97,189,179,286,1292,2140,4,9462,525,0,2,1,1,0
63159,6,328,180,34,164,0,0,16,180,1,12,6,12,13,18,43,66,0,33,1,0,2,1,1,0
63160,128,5170,1450,624,1228,12,26,181,1462,14,306,186,354,320,540,2580,4493,8,36391,2021,1,2,2,2,0
63161,176,5307,1660,832,1314,41,38,274,1701,20,312,209,395,332,604,2671,5058,12,64042,3557,1,2,4,4,0
63162,125,5389,1513,682,1277,25,13,200,1538,11,199,116,219,210,335,1557,2584,6,15641,868,0,2,2,2,0
63164,107,5109,1523,757,1297,19,12,193,1542,12,193,117,230,205,347,1508,2664,7,19053,1058,0,2,1,1,0
63165,29,1903,384,251,317,7,8,52,391,11,70,44,84,81,128,467,811,6,5355,297,0,2,2,2,0
63167,86,3411,1043,504,840,53,9,147,1096,9,180,112,198,189,310,1377,2344,4,11604,644,0,2,2,2,0
63168,80,3144,1178,367,1042,6,15,115,1184,9,94,51,95,103,146,644,976,4,4439,246,0,2,1,1,0
63169,53,1862,601,196,481,2,23,85,603,8,63,36,72,71,108,400,664,4,3036,168,0,2,4,4,0
63173,3,42,14,8,8,0,0,6,14,0,0,0,0,0,0,0,0,0,0,0,0,2,1,0,0
63194,60,1163,282,196,195,3,0,86,285,8,130,71,141,138,212,936,1507,4,6538,363,0,2,1,0,0
63195,4,77,127,75,83,2,11,30,129,4,14,7,14,18,21,61,87,2,175,9,0,2,1,0,0
63196,4,77,652,304,544,16,6,88,668,6,89,51,101,95,152,591,998,3,3399,188,0,2,1,0,0
63197,4,77,2,2,2,0,0,0,2,0,0,0,0,0,0,0,0,0,0,0,0,2,1,0,0
63198,4,77,8,5,5,0,0,3,8,0,0,0,0,0,0,0,0,0,0,0,0,2,1,0,0
63201,4,77,14,8,8,0,0,6,14,0,0,0,0,0,0,0,0,0,0,0,0,2,1,0,0
63202,4,77,6,4,4,0,0,2,6,0,0,0,0,0,0,0,0,0,0,0,0,2,1,0,0
63203,4,77,6,4,4,0,0,2,6,1,2,1,2,3,3,2,4,0,2,0,0,2,1,0,0
63205,4,77,7,5,5,0,0,2,7,0,0,0,0,0,0,0,0,0,0,0,0,2,1,0,0
63207,4,77,10,6,6,0,0,4,10,0,0,0,0,0,0,0,0,0,0,0,0,2,1,0,0
63208,4,77,1,1,1,0,0,0,1,0,0,0,0,0,0,0,0,0,0,0,0,2,1,0,0
63210,4,77,14,10,10,0,0,4,14,1,1,1,1,2,2,0,2,0,1,0,0,2,1,0,0
63211,4,77,46,26,30,3,0,12,49,3,6,3,6,9,9,20,28,1,42,2,0,2,1,0,0
63213,1,90,13,10,10,0,0,3,13,1,2,1,2,3,3,2,4,0,2,0,0,2,1,0,0
63214,7,114,44,19,17,0,16,11,44,3,14,7,14,17,21,58,85,1,128,7,0,2,1,0,0
63232,3,66,127,75,83,2,11,30,129,4,14,7,14,18,21,61,87,2,175,9,0,2,1,0,0
63233,3,66,652,304,544,16,6,88,668,6,89,51,101,95,152,591,998,3,3399,188,0,2,1,0,0
63234,3,66,2,2,2,0,0,0,2,0,0,0,0,0,0,0,0,0,0,0,0,2,1,0,0
63235,3,66,8,5,5,0,0,3,8,0,0,0,0,0,0,0,0,0,0,0,0,2,1,0,0
63238,3,66,14,8,8,0,0,6,14,0,0,0,0,0,0,0,0,0,0,0,0,2,1,0,0
63239,3,66,6,4,4,0,0,2,6,0,0,0,0,0,0,0,0,0,0,0,0,2,1,0,0
63240,3,66,6,4,4,0,0,2,6,1,2,1,2,3,3,2,4,0,2,0,0,2,1,0,0
63242,3,66,7,5,5,0,0,2,7,0,0,0,0,0,0,0,0,0,0,0,0,2,1,0,0
63244,3,66,10,6,6,0,0,4,10,0,0,0,0,0,0,0,0,0,0,0,0,2,1,0,0
63245,3,66,1,1,1,0,0,0,1,0,0,0,0,0,0,0,0,0,0,0,0,2,1,0,0
63247,3,66,14,10,10,0,0,4,14,1,1,1,1,2,2,0,2,0,1,0,0,2,1,0,0
63248,3,66,46,26,30,3,0,12,49,3,6,3,6,9,9,20,28,1,42,2,0,2,1,0,0
63296,12,229,127,75,83,2,11,30,129,4,14,7,14,18,21,61,87,2,175,9,0,2,1,0,0
63297,12,229,652,304,544,16,6,88,668,6,89,51,101,95,152,591,998,3,3399,188,0,2,1,0,0
63298,12,229,2,2,2,0,0,0,2,0,0,0,0,0,0,0,0,0,0,0,0,2,1,0,0
63299,12,229,8,5,5,0,0,3,8,0,0,0,0,0,0,0,0,0,0,0,0,2,1,0,0
63302,12,229,14,8,8,0,0,6,14,0,0,0,0,0,0,0,0,0,0,0,0,2,1,0,0
63303,12,229,6,4,4,0,0,2,6,0,0,0,0,0,0,0,0,0,0,0,0,2,1,0,0
63304,12,229,6,4,4,0,0,2,6,1,2,1,2,3,3,2,4,0,2,0,0,2,1,0,0
63306,12,229,7,5,5,0,0,2,7,0,0,0,0,0,0,0,0,0,0,0,0,2,1,0,0
63308,12,229,10,6,6,0,0,4,10,0,0,0,0,0,0,0,0,0,0,0,0,2,1,0,0
63309,12,229,1,1,1,0,0,0,1,0,0,0,0,0,0,0,0,0,0,0,0,2,1,0,0
63311,12,229,14,10,10,0,0,4,14,1,1,1,1,2,2,0,2,0,1,0,0,2,1,0,0
63312,12,229,46,26,30,3,0,12,49,3,6,3,6,9,9,20,28,1,42,2,0,2,1,0,0
63330,3,26,14,7,7,2,0,5,16,0,0,0,0,0,0,0,0,0,0,0,0,2,1,0,0
63331,7,103,38,23,23,0,0,15,38,0,0,0,0,0,0,0,0,0,0,0,0,2,1,0,0
63335,12,515,124,78,88,2,3,26,126,4,13,7,13,17,20,56,81,2,163,9,0,2,1,0,0
63361,11,242,19,8,11,5,0,4,24,2,5,3,6,7,9,13,25,1,30,1,0,2,1,0,0
63362,11,242,102,59,69,5,3,24,107,6,22,15,28,28,43,113,206,3,789,43,0,2,1,0,0
63363,11,242,106,40,36,3,49,17,109,8,17,13,23,25,36,93,167,5,904,50,0,2,1,0,0
63387,229,4960,182,127,129,0,0,53,182,5,39,21,42,44,63,217,343,2,926,51,0,2,1,0,0
63388,229,4960,1165,710,800,67,119,181,1232,18,243,153,282,261,435,2000,3492,10,36473,2026,1,2,1,0,0
63389,67,1570,773,419,590,28,0,166,801,10,204,113,217,214,330,1598,2554,5,13587,754,0,2,1,0,0
63390,67,1570,421,273,302,44,34,57,465,17,81,59,107,98,166,583,1098,11,12329,684,0,2,1,0,0
63391,14,411,149,95,105,2,0,41,151,8,54,28,55,62,83,334,494,4,2013,111,0,2,1,0,0
63392,14,411,82,56,54,0,13,15,82,4,13,8,16,17,24,56,98,2,241,13,0,2,1,0,0
63395,26,529,2,2,2,0,0,0,2,0,0,0,0,0,0,0,0,0,0,0,0,2,1,0,0
63409,26,529,99,48,90,1,3,5,100,0,0,0,0,0,0,0,0,0,0,0,0,2,1,0,0
63410,26,529,8,5,5,2,0,1,10,0,0,0,0,0,0,0,0,0,0,0,0,2,1,0,0
63411,26,529,1217,716,841,84,126,174,1301,14,185,118,215,199,333,1446,2542,8,20687,1149,0,2,1,0,0
63412,26,529,160,89,115,0,13,31,160,7,15,11,17,22,28,78,124,3,495,27,0,2,1,0,0
63413,26,529,10,10,9,9,0,0,19,0,0,0,0,0,0,0,0,0,0,0,0,2,1,0,0
63414,26,529,173,84,99,8,29,36,181,5,12,7,13,17,20,54,81,2,221,12,0,2,1,0,0
63415,26,529,3,1,1,3,0,0,6,0,0,0,0,0,0,0,0,0,0,0,0,2,1,0,0
63416,183,5549,1660,832,1314,41,38,274,1701,20,312,209,395,332,604,2671,5058,12,64042,3557,1,2,1,0,0
63417,183,5549,1057,646,719,113,100,145,1170,18,215,134,248,233,382,1740,3004,10,31186,1732,1,2,1,0,0
63418,17,348,95,58,50,9,16,20,104,12,33,24,45,45,69,209,378,8,3100,172,0,2,1,0,0
63419,116,2173,477,336,357,30,23,73,507,16,194,134,250,210,384,1538,2962,10,30538,1696,0,2,1,0,0
63420,89,2050,996,429,845,24,10,117,1020,7,76,50,88,83,138,494,879,4,3565,198,0,2,1,0,0
63421,89,2050,456,277,329,12,42,72,468,13,85,50,97,98,147,592,972,7,7212,400,0,2,1,0,0
63422,163,3497,1513,682,1277,25,13,200,1538,11,199,116,219,210,335,1557,2584,6,15641,868,0,2,1,0,0
63423,163,3497,819,519,539,24,98,155,843,15,96,57,106,111,163,690,1107,8,9171,509,0,2,1,0,0
63424,73,1518,207,111,150,11,0,50,218,5,26,19,36,31,55,133,272,3,943,52,0,2,1,0,0
63425,73,1518,410,198,237,31,55,97,441,11,63,38,72,74,110,414,683,6,4293,238,0,2,1,0,0
63428,236,4942,2,2,2,0,0,0,2,0,0,0,0,0,0,0,0,0,0,0,0,2,1,0,0
63442,236,4942,99,48,90,1,3,5,100,0,0,0,0,0,0,0,0,0,0,0,0,2,1,0,0
63443,236,4942,8,5,5,2,0,1,10,0,0,0,0,0,0,0,0,0,0,0,0,2,1,0,0
63444,236,4942,1217,716,841,84,126,174,1301,14,185,118,215,199,333,1446,2542,8,20687,1149,0,2,1,0,0
63445,236,4942,160,89,115,0,13,31,160,7,15,11,17,22,28,78,124,3,495,27,0,2,1,0,0
63446,236,4942,10,10,9,9,0,0,19,0,0,0,0,0,0,0,0,0,0,0,0,2,1,0,0
63447,236,4942,173,84,99,8,29,36,181,5,12,7,13,17,20,54,81,2,221,12,0,2,1,0,0
63448,236,4942,3,1,1,3,0,0,6,0,0,0,0,0,0,0,0,0,0,0,0,2,1,0,0
63449,98,2019,463,295,324,28,62,57,491,12,134,82,154,146,236,989,1696,6,11700,650,0,2,1,0,0
63451,55,770,167,116,138,4,5,22,171,8,48,30,56,56,86,292,499,4,2330,129,0,2,1,0,0
63452,52,1464,339,213,244,17,9,65,356,10,42,26,48,52,74,259,421,5,2410,133,0,2,1,0,0
63454,95,2385,1455,414,1257,16,76,112,1471,5,41,23,46,46,69,231,381,2,1069,59,0,2,1,0,0
63455,95,2385,669,365,481,22,61,110,691,15,103,63,122,118,185,747,1273,8,11311,628,0,2,1,0,0
63458,6,140,44,22,19,0,19,6,44,2,10,6,12,12,18,35,64,1,77,4,0,2,1,0,0
63459,28,981,74,35,59,1,0,14,75,3,14,7,14,17,21,58,85,1,128,7,0,2,1,0,0
63460,28,981,245,125,200,5,7,34,250,7,30,17,34,37,51,166,265,3,1053,58,0,2,1,0,0
63461,54,657,647,139,84,35,284,233,682,0,0,0,0,0,0,0,0,0,0,0,0,2,1,0,0
63462,115,3128,1523,757,1297,19,12,193,1542,12,193,117,230,205,347,1508,2664,7,19053,1058,0,2,1,0,0
63463,115,3128,701,378,504,33,58,109,734,13,110,68,126,123,194,794,1346,7,10027,557,0,2,1,0,0
63464,101,2612,773,422,505,30,103,129,803,14,77,46,83,91,129,535,839,7,6334,351,0,2,1,0,0
63465,159,3785,77,34,69,0,0,8,77,3,24,16,29,27,45,114,213,1,387,21,0,2,1,0,0
63466,159,3785,712,438,573,51,9,84,763,14,102,71,128,116,199,733,1364,8,11988,666,0,2,1,0,0
63469,24,612,2,2,2,0,0,0,2,0,0,0,0,0,0,0,0,0,0,0,0,2,1,0,0
63483,24,612,99,48,90,1,3,5,100,0,0,0,0,0,0,0,0,0,0,0,0,2,1,0,0
63484,24,612,8,5,5,2,0,1,10,0,0,0,0,0,0,0,0,0,0,0,0,2,1,0,0
63485,24,612,1217,716,841,84,126,174,1301,14,185,118,215,199,333,1446,2542,8,20687,1149,0,2,1,0,0
63486,24,612,160,89,115,0,13,31,160,7,15,11,17,22,28,78,124,3,495,27,0,2,1,0,0
63487,24,612,10,10,9,9,0,0,19,0,0,0,0,0,0,0,0,0,0,0,0,2,1,0,0
63488,24,612,173,84,99,8,29,36,181,5,12,7,13,17,20,54,81,2,221,12,0,2,1,0,0
63489,24,612,3,1,1,3,0,0,6,0,0,0,0,0,0,0,0,0,0,0,0,2,1,0,0
63490,30,664,125,97,103,3,0,19,128,9,25,17,27,34,44,144,223,4,1087,60,0,2,1,0,0
63491,22,373,102,57,55,5,16,25,107,5,17,10,18,22,28,81,124,2,330,18,0,2,1,0,0
63492,69,1527,402,202,227,24,74,80,426,12,52,33,61,64,94,339,564,7,3969,220,0,2,1,0,0
63493,55,1174,447,308,343,6,5,95,453,7,96,59,111,103,170,651,1136,4,4600,255,0,2,1,0,0
63494,55,1174,322,174,179,16,74,51,338,10,41,26,46,51,72,252,408,5,2291,127,0,2,1,0,0
63495,75,1629,53,23,39,0,0,13,53,2,8,4,8,10,12,26,39,1,39,2,0,2,1,0,0
63496,75,1629,515,298,307,33,80,99,548,12,63,44,77,75,121,419,753,7,5527,307,0,2,1,0,0
63497,18,312,424,94,331,4,0,89,428,1,5,5,5,6,10,11,25,0,12,0,0,2,1,0,0
63498,18,312,38,23,23,6,0,8,44,3,11,7,11,14,18,42,68,1,102,5,0,2,1,0,0
63499,20,531,205,80,86,16,53,53,221,7,18,10,19,25,29,94,134,3,497,27,0,2,1,0,0
63500,17,523,184,100,137,2,15,30,186,6,38,20,39,44,59,214,322,3,991,55,0,2,1,0,0
63501,17,523,103,65,74,8,5,16,111,7,17,9,17,24,26,89,119,3,417,23,0,2,1,0,0
63502,59,1228,91,45,69,0,3,18,91,3,9,6,10,12,16,33,57,1,95,5,0,2,1,0,0
63503,59,1228,367,234,237,17,34,68,384,16,55,34,61,71,95,381,584,8,5183,287,0,2,1,0,0
63504,231,5969,722,423,573,19,0,135,741,12,172,101,199,184,300,1320,2257,6,15668,870,0,2,1,0,0
63505,231,5969,1508,847,911,44,250,301,1552,14,148,88,169,162,257,1120,1886,7,15077,837,0,2,1,0,0
63506,314,6930,72,33,56,0,4,12,72,1,1,1,1,2,2,0,2,0,1,0,0,2,1,0,0
63507,314,6930,1454,835,1044,76,110,219,1530,17,275,158,296,292,454,2297,3718,9,34017,1889,1,2,1,0,0
63508,92,1886,757,253,292,73,244,162,830,13,61,38,67,74,105,409,651,7,4654,258,0,2,1,0,0
63509,45,953,386,256,301,16,9,68,402,4,59,35,69,63,104,355,621,2,1453,80,0,2,1,0,0
63510,45,953,264,131,164,11,41,46,275,6,38,22,40,44,62,214,338,3,1068,59,0,2,1,0,0
63511,67,1753,466,257,367,18,25,50,484,7,126,86,171,133,257,898,1813,4,8612,478,0,2,1,0,0
63512,67,1753,507,281,342,29,59,88,536,10,53,29,57,63,86,336,514,5,2764,153,0,2,1,0,0
63513,25,552,215,129,180,6,0,29,221,8,65,43,72,73,115,415,711,4,3153,175,0,2,1,0,0
63514,25,552,97,69,77,3,3,16,100,6,22,13,23,28,36,113,173,3,542,30,0,2,1,0,0
63515,89,1894,1043,504,840,53,9,147,1096,9,180,112,198,189,310,1377,2344,4,11604,644,0,2,1,0,0
63516,89,1894,383,288,292,26,6,62,409,11,65,38,67,76,105,429,656,5,3719,206,0,2,1,0,0
63517,20,420,294,64,250,0,0,43,294,1,20,10,20,21,30,86,131,0,65,3,0,2,1,0,0
63518,20,420,78,46,62,3,0,14,81,3,8,4,8,11,12,28,41,1,62,3,0,2,1,0,0
63519,5,123,110,30,77,3,13,16,113,4,21,15,30,25,45,100,208,2,597,33,0,2,1,0,0
63520,5,123,28,15,21,1,0,6,29,0,0,0,0,0,0,0,0,0,0,0,0,2,1,0,0
63523,28,452,219,78,157,11,5,46,230,3,24,20,34,27,54,114,256,2,545,30,0,2,1,0,0
63524,28,452,108,64,79,9,0,20,117,5,15,11,19,20,30,70,129,3,410,22,0,2,1,0,0
63525,281,5902,1943,715,1694,26,18,214,1969,12,185,120,237,197,357,1436,2721,7,20915,1161,0,2,1,1,0
63526,281,5902,1168,838,957,57,25,144,1225,19,348,224,416,367,640,3018,5452,11,61921,3440,1,2,1,1,0
63527,19,720,442,244,305,14,16,103,456,11,68,45,75,79,120,452,756,6,4588,254,0,2,1,0,0
63528,19,720,182,102,99,11,40,35,193,3,11,6,11,14,17,42,64,1,97,5,0,2,1,0,0
63529,69,1323,1098,241,925,5,10,155,1103,7,46,25,49,53,74,273,423,3,1580,87,0,2,1,0,0
63530,69,1323,282,202,222,14,2,44,296,8,42,24,43,50,67,250,378,4,1548,86,0,2,1,0,0
63531,2,156,37,13,25,0,6,6,37,1,2,1,2,3,3,2,4,0,2,0,0,2,1,0,0
63532,2,156,133,47,40,1,43,49,134,0,0,0,0,0,0,0,0,0,0,0,0,2,1,0,0
63533,29,743,601,196,481,2,23,85,603,8,63,36,72,71,108,400,664,4,3036,168,0,2,1,0,0
63534,29,743,156,79,106,5,16,28,161,5,14,8,15,19,23,64,97,2,261,14,0,2,1,0,0
63536,36,1120,182,127,129,0,0,53,182,5,39,21,42,44,63,217,343,2,926,51,0,2,1,1,0
63539,7,123,127,75,83,2,11,30,129,4,14,7,14,18,21,61,87,2,175,9,0,2,1,0,0
63540,7,123,652,304,544,16,6,88,668,6,89,51,101,95,152,591,998,3,3399,188,0,2,1,0,0
63541,7,123,2,2,2,0,0,0,2,0,0,0,0,0,0,0,0,0,0,0,0,2,1,0,0
63542,7,123,8,5,5,0,0,3,8,0,0,0,0,0,0,0,0,0,0,0,0,2,1,0,0
63545,7,123,14,8,8,0,0,6,14,0,0,0,0,0,0,0,0,0,0,0,0,2,1,0,0
63546,7,123,6,4,4,0,0,2,6,0,0,0,0,0,0,0,0,0,0,0,0,2,1,0,0
63547,7,123,6,4,4,0,0,2,6,1,2,1,2,3,3,2,4,0,2,0,0,2,1,0,0
63549,7,123,7,5,5,0,0,2,7,0,0,0,0,0,0,0,0,0,0,0,0,2,1,0,0
63551,7,123,10,6,6,0,0,4,10,0,0,0,0,0,0,0,0,0,0,0,0,2,1,0,0
63552,7,123,1,1,1,0,0,0,1,0,0,0,0,0,0,0,0,0,0,0,0,2,1,0,0
63554,7,123,14,10,10,0,0,4,14,1,1,1,1,2,2,0,2,0,1,0,0,2,1,0,0
63555,7,123,46,26,30,3,0,12,49,3,6,3,6,9,9,20,28,1,42,2,0,2,1,0,0
63556,14,845,75,38,59,1,3,12,76,2,4,2,4,6,6,10,15,1,15,0,0,2,1,0,0
63557,2,67,16,12,9,0,0,6,16,1,2,1,2,3,3,2,4,0,2,0,0,2,1,0,0
63560,1,6,2,2,2,0,0,0,2,0,0,0,0,0,0,0,0,0,0,0,0,2,1,0,0
63574,1,6,99,48,90,1,3,5,100,0,0,0,0,0,0,0,0,0,0,0,0,2,1,0,0
63575,1,6,8,5,5,2,0,1,10,0,0,0,0,0,0,0,0,0,0,0,0,2,1,0,0
63576,1,6,1217,716,841,84,126,174,1301,14,185,118,215,199,333,1446,2542,8,20687,1149,0,2,1,0,0
63577,1,6,160,89,115,0,13,31,160,7,15,11,17,22,28,78,124,3,495,27,0,2,1,0,0
63578,1,6,10,10,9,9,0,0,19,0,0,0,0,0,0,0,0,0,0,0,0,2,1,0,0
63579,1,6,173,84,99,8,29,36,181,5,12,7,13,17,20,54,81,2,221,12,0,2,1,0,0
63580,1,6,3,1,1,3,0,0,6,0,0,0,0,0,0,0,0,0,0,0,0,2,1,0,0
63585,1,8,127,75,83,2,11,30,129,4,14,7,14,18,21,61,87,2,175,9,0,2,1,0,0
63586,1,8,652,304,544,16,6,88,668,6,89,51,101,95,152,591,998,3,3399,188,0,2,1,0,0
63587,1,8,2,2,2,0,0,0,2,0,0,0,0,0,0,0,0,0,0,0,0,2,1,0,0
63588,1,8,8,5,5,0,0,3,8,0,0,0,0,0,0,0,0,0,0,0,0,2,1,0,0
63591,1,8,14,8,8,0,0,6,14,0,0,0,0,0,0,0,0,0,0,0,0,2,1,0,0
63592,1,8,6,4,4,0,0,2,6,0,0,0,0,0,0,0,0,0,0,0,0,2,1,0,0
63593,1,8,6,4,4,0,0,2,6,1,2,1,2,3,3,2,4,0,2,0,0,2,1,0,0
63595,1,8,7,5,5,0,0,2,7,0,0,0,0,0,0,0,0,0,0,0,0,2,1,0,0
63597,1,8,10,6,6,0,0,4,10,0,0,0,0,0,0,0,0,0,0,0,0,2,1,0,0
63598,1,8,1,1,1,0,0,0,1,0,0,0,0,0,0,0,0,0,0,0,0,2,1,0,0
63600,1,8,14,10,10,0,0,4,14,1,1,1,1,2,2,0,2,0,1,0,0,2,1,0,0
63601,1,8,46,26,30,3,0,12,49,3,6,3,6,9,9,20,28,1,42,2,0,2,1,0,0
63628,2,25,127,75,83,2,11,30,129,4,14,7,14,18,21,61,87,2,175,9,0,2,1,0,0
63629,2,25,652,304,544,16,6,88,668,6,89,51,101,95,152,591,998,3,3399,188,0,2,1,0,0
63630,2,25,2,2,2,0,0,0,2,0,0,0,0,0,0,0,0,0,0,0,0,2,1,0,0
63631,2,25,8,5,5,0,0,3,8,0,0,0,0,0,0,0,0,0,0,0,0,2,1,0,0
63634,2,25,14,8,8,0,0,6,14,0,0,0,0,0,0,0,0,0,0,0,0,2,1,0,0
63635,2,25,6,4,4,0,0,2,6,0,0,0,0,0,0,0,0,0,0,0,0,2,1,0,0
63636,2,25,6,4,4,0,0,2,6,1,2,1,2,3,3,2,4,0,2,0,0,2,1,0,0
63638,2,25,7,5,5,0,0,2,7,0,0,0,0,0,0,0,0,0,0,0,0,2,1,0,0
63640,2,25,10,6,6,0,0,4,10,0,0,0,0,0,0,0,0,0,0,0,0,2,1,0,0
63641,2,25,1,1,1,0,0,0,1,0,0,0,0,0,0,0,0,0,0,0,0,2,1,0,0
63643,2,25,14,10,10,0,0,4,14,1,1,1,1,2,2,0,2,0,1,0,0,2,1,0,0
63644,2,25,46,26,30,3,0,12,49,3,6,3,6,9,9,20,28,1,42,2,0,2,1,0,0
63645,1,55,14,12,10,0,0,4,14,1,2,1,2,3,3,2,4,0,2,0,0,2,1,0,0
63646,1,58,14,12,10,0,0,4,14,1,2,1,2,3,3,2,4,0,2,0,0,2,1,0,0
63648,1,77,19,18,14,0,0,5,19,1,2,1,2,3,3,2,4,0,2,0,0,2,1,0,0
63649,2,18,10,6,6,0,0,4,10,0,0,0,0,0,0,0,0,0,0,0,0,2,1,0,0
63650,2,36,127,75,83,2,11,30,129,4,14,7,14,18,21,61,87,2,175,9,0,2,1,0,0
63651,2,36,652,304,544,16,6,88,668,6,89,51,101,95,152,591,998,3,3399,188,0,2,1,0,0
63652,2,36,2,2,2,0,0,0,2,0,0,0,0,0,0,0,0,0,0,0,0,2,1,0,0
63653,2,36,8,5,5,0,0,3,8,0,0,0,0,0,0,0,0,0,0,0,0,2,1,0,0
63656,2,36,14,8,8,0,0,6,14,0,0,0,0,0,0,0,0,0,0,0,0,2,1,0,0
63657,2,36,6,4,4,0,0,2,6,0,0,0,0,0,0,0,0,0,0,0,0,2,1,0,0
63658,2,36,6,4,4,0,0,2,6,1,2,1,2,3,3,2,4,0,2,0,0,2,1,0,0
63660,2,36,7,5,5,0,0,2,7,0,0,0,0,0,0,0,0,0,0,0,0,2,1,0,0
63662,2,36,10,6,6,0,0,4,10,0,0,0,0,0,0,0,0,0,0,0,0,2,1,0,0
63663,2,36,1,1,1,0,0,0,1,0,0,0,0,0,0,0,0,0,0,0,0,2,1,0,0
63665,2,36,14,10,10,0,0,4,14,1,1,1,1,2,2,0,2,0,1,0,0,2,1,0,0
63666,2,36,46,26,30,3,0,12,49,3,6,3,6,9,9,20,28,1,42,2,0,2,1,0,0
63671,1,26,127,75,83,2,11,30,129,4,14,7,14,18,21,61,87,2,175,9,0,2,1,0,0
63672,1,26,652,304,544,16,6,88,668,6,89,51,101,95,152,591,998,3,3399,188,0,2,1,0,0
63673,1,26,2,2,2,0,0,0,2,0,0,0,0,0,0,0,0,0,0,0,0,2,1,0,0
63674,1,26,8,5,5,0,0,3,8,0,0,0,0,0,0,0,0,0,0,0,0,2,1,0,0
63677,1,26,14,8,8,0,0,6,14,0,0,0,0,0,0,0,0,0,0,0,0,2,1,0,0
63678,1,26,6,4,4,0,0,2,6,0,0,0,0,0,0,0,0,0,0,0,0,2,1,0,0
63679,1,26,6,4,4,0,0,2,6,1,2,1,2,3,3,2,4,0,2,0,0,2,1,0,0
63681,1,26,7,5,5,0,0,2,7,0,0,0,0,0,0,0,0,0,0,0,0,2,1,0,0
63683,1,26,10,6,6,0,0,4,10,0,0,0,0,0,0,0,0,0,0,0,0,2,1,0,0
63684,1,26,1,1,1,0,0,0,1,0,0,0,0,0,0,0,0,0,0,0,0,2,1,0,0
63686,1,26,14,10,10,0,0,4,14,1,1,1,1,2,2,0,2,0,1,0,0,2,1,0,0
63687,1,26,46,26,30,3,0,12,49,3,6,3,6,9,9,20,28,1,42,2,0,2,1,0,0
63688,1,7,2,2,2,0,0,0,2,0,0,0,0,0,0,0,0,0,0,0,0,2,1,0,0
63689,1,24,127,75,83,2,11,30,129,4,14,7,14,18,21,61,87,2,175,9,0,2,1,0,0
63690,1,24,652,304,544,16,6,88,668,6,89,51,101,95,152,591,998,3,3399,188,0,2,1,0,0
63691,1,24,2,2,2,0,0,0,2,0,0,0,0,0,0,0,0,0,0,0,0,2,1,0,0
63692,1,24,8,5,5,0,0,3,8,0,0,0,0,0,0,0,0,0,0,0,0,2,1,0,0
63695,1,24,14,8,8,0,0,6,14,0,0,0,0,0,0,0,0,0,0,0,0,2,1,0,0
63696,1,24,6,4,4,0,0,2,6,0,0,0,0,0,0,0,0,0,0,0,0,2,1,0,0
63697,1,24,6,4,4,0,0,2,6,1,2,1,2,3,3,2,4,0,2,0,0,2,1,0,0
63699,1,24,7,5,5,0,0,2,7,0,0,0,0,0,0,0,0,0,0,0,0,2,1,0,0
63701,1,24,10,6,6,0,0,4,10,0,0,0,0,0,0,0,0,0,0,0,0,2,1,0,0
63702,1,24,1,1,1,0,0,0,1,0,0,0,0,0,0,0,0,0,0,0,0,2,1,0,0
63704,1,24,14,10,10,0,0,4,14,1,1,1,1,2,2,0,2,0,1,0,0,2,1,0,0
63705,1,24,46,26,30,3,0,12,49,3,6,3,6,9,9,20,28,1,42,2,0,2,1,0,0
63707,3,33,15,9,9,0,0,6,15,0,0,0,0,0,0,0,0,0,0,0,0,2,1,0,0
63708,1,13,127,75,83,2,11,30,129,4,14,7,14,18,21,61,87,2,175,9,0,2,1,0,0
63709,1,13,652,304,544,16,6,88,668,6,89,51,101,95,152,591,998,3,3399,188,0,2,1,0,0
63710,1,13,2,2,2,0,0,0,2,0,0,0,0,0,0,0,0,0,0,0,0,2,1,0,0
63711,1,13,8,5,5,0,0,3,8,0,0,0,0,0,0,0,0,0,0,0,0,2,1,0,0
63714,1,13,14,8,8,0,0,6,14,0,0,0,0,0,0,0,0,0,0,0,0,2,1,0,0
63715,1,13,6,4,4,0,0,2,6,0,0,0,0,0,0,0,0,0,0,0,0,2,1,0,0
63716,1,13,6,4,4,0,0,2,6,1,2,1,2,3,3,2,4,0,2,0,0,2,1,0,0
63718,1,13,7,5,5,0,0,2,7,0,0,0,0,0,0,0,0,0,0,0,0,2,1,0,0
63720,1,13,10,6,6,0,0,4,10,0,0,0,0,0,0,0,0,0,0,0,0,2,1,0,0
63721,1,13,1,1,1,0,0,0,1,0,0,0,0,0,0,0,0,0,0,0,0,2,1,0,0
63723,1,13,14,10,10,0,0,4,14,1,1,1,1,2,2,0,2,0,1,0,0,2,1,0,0
63724,1,13,46,26,30,3,0,12,49,3,6,3,6,9,9,20,28,1,42,2,0,2,1,0,0
63725,1,16,127,75,83,2,11,30,129,4,14,7,14,18,21,61,87,2,175,9,0,2,1,0,0
63726,1,16,652,304,544,16,6,88,668,6,89,51,101,95,152,591,998,3,3399,188,0,2,1,0,0
63727,1,16,2,2,2,0,0,0,2,0,0,0,0,0,0,0,0,0,0,0,0,2,1,0,0
63728,1,16,8,5,5,0,0,3,8,0,0,0,0,0,0,0,0,0,0,0,0,2,1,0,0
63731,1,16,14,8,8,0,0,6,14,0,0,0,0,0,0,0,0,0,0,0,0,2,1,0,0
63732,1,16,6,4,4,0,0,2,6,0,0,0,0,0,0,0,0,0,0,0,0,2,1,0,0
63733,1,16,6,4,4,0,0,2,6,1,2,1,2,3,3,2,4,0,2,0,0,2,1,0,0
63735,1,16,7,5,5,0,0,2,7,0,0,0,0,0,0,0,0,0,0,0,0,2,1,0,0
63737,1,16,10,6,6,0,0,4,10,0,0,0,0,0,0,0,0,0,0,0,0,2,1,0,0
63738,1,16,1,1,1,0,0,0,1,0,0,0,0,0,0,0,0,0,0,0,0,2,1,0,0
63740,1,16,14,10,10,0,0,4,14,1,1,1,1,2,2,0,2,0,1,0,0,2,1,0,0
63741,1,16,46,26,30,3,0,12,49,3,6,3,6,9,9,20,28,1,42,2,0,2,1,0,0
63742,1,10,2,2,2,0,0,0,2,1,2,1,2,3,3,2,4,0,2,0,0,2,1,0,0
63760,2,26,10,6,6,0,0,4,10,2,4,2,4,6,6,10,15,1,15,0,0,2,1,0,0
63761,3,47,15,10,10,0,0,5,15,2,4,2,4,6,6,10,15,1,15,0,0,2,1,0,0
63762,3,39,15,9,9,0,0,6,15,0,0,0,0,0,0,0,0,0,0,0,0,2,1,0,0
63763,2,36,10,7,7,0,0,3,10,1,2,1,2,3,3,2,4,0,2,0,0,2,1,0,0
63764,3,46,15,9,9,0,0,6,15,1,4,2,4,5,6,8,13,0,6,0,0,2,1,0,0
63765,2,21,10,6,6,0,0,4,10,0,0,0,0,0,0,0,0,0,0,0,0,2,1,0,0
63766,4,61,20,12,12,0,0,8,20,1,2,1,2,3,3,2,4,0,2,0,0,2,1,0,0
63767,2,51,127,75,83,2,11,30,129,4,14,7,14,18,21,61,87,2,175,9,0,2,1,0,0
63768,2,51,652,304,544,16,6,88,668,6,89,51,101,95,152,591,998,3,3399,188,0,2,1,0,0
63769,2,51,2,2,2,0,0,0,2,0,0,0,0,0,0,0,0,0,0,0,0,2,1,0,0
63770,2,51,8,5,5,0,0,3,8,0,0,0,0,0,0,0,0,0,0,0,0,2,1,0,0
63773,2,51,14,8,8,0,0,6,14,0,0,0,0,0,0,0,0,0,0,0,0,2,1,0,0
63774,2,51,6,4,4,0,0,2,6,0,0,0,0,0,0,0,0,0,0,0,0,2,1,0,0
63775,2,51,6,4,4,0,0,2,6,1,2,1,2,3,3,2,4,0,2,0,0,2,1,0,0
63777,2,51,7,5,5,0,0,2,7,0,0,0,0,0,0,0,0,0,0,0,0,2,1,0,0
63779,2,51,10,6,6,0,0,4,10,0,0,0,0,0,0,0,0,0,0,0,0,2,1,0,0
63780,2,51,1,1,1,0,0,0,1,0,0,0,0,0,0,0,0,0,0,0,0,2,1,0,0
63782,2,51,14,10,10,0,0,4,14,1,1,1,1,2,2,0,2,0,1,0,0,2,1,0,0
63783,2,51,46,26,30,3,0,12,49,3,6,3,6,9,9,20,28,1,42,2,0,2,1,0,0
63785,8,263,51,25,36,0,0,15,51,3,11,6,12,14,18,42,68,1,112,6,0,2,1,0,0
63786,1,14,6,4,4,0,0,2,6,0,0,0,0,0,0,0,0,0,0,0,0,2,1,0,0
63787,4,163,27,21,21,0,0,6,27,3,6,3,6,9,9,20,28,1,42,2,0,2,1,0,0
63789,1,41,7,5,5,0,0,2,7,1,2,1,2,3,3,2,4,0,2,0,0,2,1,0,0
63790,2,51,14,9,9,0,0,5,14,0,0,0,0,0,0,0,0,0,0,0,0,2,1,0,0
63792,2,42,14,10,9,0,0,4,14,0,0,0,0,0,0,0,0,0,0,0,0,2,1,0,0
63793,2,33,12,8,7,0,0,4,12,0,0,0,0,0,0,0,0,0,0,0,0,2,1,0,0
63794,3,49,16,9,9,0,0,7,16,0,0,0,0,0,0,0,0,0,0,0,0,2,1,0,0
63795,1,18,3,3,3,0,0,0,3,0,0,0,0,0,0,0,0,0,0,0,0,2,1,0,0
63804,66,4392,520,294,400,33,13,81,553,10,261,204,367,271,571,2128,4614,7,32445,1802,1,2,1,1,0
63808,33,999,465,148,393,5,8,60,470,4,31,20,31,35,51,161,261,2,523,29,0,2,1,0,0
63809,33,999,16,12,9,0,0,6,16,1,2,1,2,3,3,2,4,0,2,0,0,2,1,0,0
63811,33,1041,256,139,192,9,7,47,265,4,23,12,24,27,36,112,171,2,357,19,0,2,1,0,0
63813,23,613,102,59,69,5,3,24,107,6,22,15,28,28,43,113,206,3,789,43,0,2,1,0,0
63816,48,3659,996,429,845,24,10,117,1020,7,76,50,88,83,138,494,879,4,3565,198,0,2,1,0,0
63818,85,4936,1296,573,1062,40,33,157,1336,8,201,118,231,209,349,1561,2689,4,12365,686,0,2,1,0,0
63819,21,500,207,111,150,11,0,50,218,5,26,19,36,31,55,133,272,3,943,52,0,2,1,0,0
63820,103,5336,1457,730,1242,11,6,188,1468,10,292,166,329,302,495,2424,4078,5,22973,1276,1,2,1,0,0
63821,43,2690,652,304,544,16,6,88,668,6,89,51,101,95,152,591,998,3,3399,188,0,2,1,0,0
63822,72,3310,1455,414,1257,16,76,112,1471,5,41,23,46,46,69,231,381,2,1069,59,0,2,3,3,0
63823,2,79,7,6,5,0,0,2,7,1,1,1,2,2,3,0,3,1,3,0,0,2,1,0,0
63824,8,275,74,35,59,1,0,14,75,3,14,7,14,17,21,58,85,1,128,7,0,2,1,0,0
63826,70,3187,1020,354,843,12,15,144,1032,8,134,77,144,142,221,970,1580,4,6792,377,0,2,1,0,0
63827,47,2189,447,308,343,6,5,95,453,7,96,59,111,103,170,651,1136,4,4600,255,0,2,1,0,0
63828,3,229,53,23,39,0,0,13,53,2,8,4,8,10,12,26,39,1,39,2,0,2,1,0,0
63829,21,655,424,94,331,4,0,89,428,1,5,5,5,6,10,11,25,0,12,0,0,2,2,2,0
63830,38,2327,334,251,279,10,4,40,344,5,127,74,143,132,217,899,1528,2,4303,239,0,2,1,0,0
63831,12,497,184,100,137,2,15,30,186,6,38,20,39,44,59,214,322,3,991,55,0,2,2,2,0
63832,8,377,91,45,69,0,3,18,91,3,9,6,10,12,16,33,57,1,95,5,0,2,1,0,0
63833,75,3895,1293,570,1093,25,15,163,1318,10,195,123,241,205,364,1516,2795,6,17273,959,0,2,1,0,0
63836,45,1953,386,256,301,16,9,68,402,4,59,35,69,63,104,355,621,2,1453,80,0,2,1,0,0
63837,28,1596,466,257,367,18,25,50,484,7,126,86,171,133,257,898,1813,4,8612,478,0,2,1,0,0
63838,15,1066,215,129,180,6,0,29,221,8,65,43,72,73,115,415,711,4,3153,175,0,2,1,0,0
63839,86,3411,1043,504,840,53,9,147,1096,9,180,112,198,189,310,1377,2344,4,11604,644,0,2,3,3,0
63840,12,478,295,56,236,0,4,54,295,2,9,5,10,11,15,30,51,1,57,3,0,2,1,0,0
63841,30,1440,373,158,315,8,0,51,381,5,76,44,79,81,123,486,779,2,2026,112,0,2,1,0,0
63843,9,449,219,78,157,11,5,46,230,3,24,20,34,27,54,114,256,2,545,30,0,2,1,0,0
63844,111,6122,1943,715,1694,26,18,214,1969,12,185,120,237,197,357,1436,2721,7,20915,1161,0,2,1,1,0
63845,37,1519,442,244,305,14,16,103,456,11,68,45,75,79,120,452,756,6,4588,254,0,2,1,0,0
63846,52,1986,1098,241,925,5,10,155,1103,7,46,25,49,53,74,273,423,3,1580,87,0,2,1,0,0
63851,282,5915,1943,715,1694,26,18,214,1969,12,185,120,237,197,357,1436,2721,7,20915,1161,0,2,9,1,0
63852,282,5915,1168,838,957,57,25,144,1225,19,348,224,416,367,640,3018,5452,11,61921,3440,1,2,9,1,0
63865,129,5191,1450,624,1228,12,26,181,1462,14,306,186,354,320,540,2580,4493,8,36391,2021,1,2,4,1,0
63866,184,5563,1660,832,1314,41,38,274,1701,20,312,209,395,332,604,2671,5058,12,64042,3557,1,2,4,1,0
63867,184,5563,1057,646,719,113,100,145,1170,18,215,134,248,233,382,1740,3004,10,31186,1732,1,2,4,1,0
63870,236,4942,2,2,2,0,0,0,2,0,0,0,0,0,0,0,0,0,0,0,0,2,3,3,0
63884,236,4942,99,48,90,1,3,5,100,0,0,0,0,0,0,0,0,0,0,0,0,2,3,3,0
63885,236,4942,8,5,5,2,0,1,10,0,0,0,0,0,0,0,0,0,0,0,0,2,3,3,0
63886,236,4942,1217,716,841,84,126,174,1301,14,185,118,215,199,333,1446,2542,8,20687,1149,0,2,3,3,0
63887,236,4942,160,89,115,0,13,31,160,7,15,11,17,22,28,78,124,3,495,27,0,2,3,3,0
63888,236,4942,10,10,9,9,0,0,19,0,0,0,0,0,0,0,0,0,0,0,0,2,3,3,0
63889,236,4942,173,84,99,8,29,36,181,5,12,7,13,17,20,54,81,2,221,12,0,2,3,3,0
63890,236,4942,3,1,1,3,0,0,6,0,0,0,0,0,0,0,0,0,0,0,0,2,3,3,0
63891,249,5765,4293,999,3693,19,54,507,4312,9,155,88,170,164,258,1156,1898,4,9368,520,0,2,9,0,0
63892,249,5765,1482,859,1002,125,135,219,1607,16,219,134,251,235,385,1766,3032,9,27804,1544,1,2,9,0,0
63893,314,6910,72,33,56,0,4,12,72,1,1,1,1,2,2,0,2,0,1,0,0,2,1,6,0
63894,314,6910,1454,835,1044,76,110,219,1530,17,275,158,296,292,454,2297,3718,9,34017,1889,1,2,1,6,0
63895,104,5361,1457,730,1242,11,6,188,1468,10,292,166,329,302,495,2424,4078,5,22973,1276,1,2,11,0,0
63896,229,4960,182,127,129,0,0,53,182,5,39,21,42,44,63,217,343,2,926,51,0,2,5,4,0
63897,229,4960,1165,710,800,67,119,181,1232,18,243,153,282,261,435,2000,3492,10,36473,2026,1,2,5,4,0
63898,92,1886,757,253,292,73,244,162,830,13,61,38,67,74,105,409,651,7,4654,258,0,2,1,1,0
63902,20,534,205,80,86,16,53,53,221,7,18,10,19,25,29,94,134,3,497,27,0,2,5,5,0
63903,81,3172,1178,367,1042,6,15,115,1184,9,94,51,95,103,146,644,976,4,4439,246,0,2,8,0,0
63904,314,6932,72,33,56,0,4,12,72,1,1,1,1,2,2,0,2,0,1,0,0,2,1,1,0
63905,314,6932,1454,835,1044,76,110,219,1530,17,275,158,296,292,454,2297,3718,9,34017,1889,1,2,1,1,0
63906,144,5944,1782,648,1425,9,47,279,1791,8,171,97,189,179,286,1292,2140,4,9462,525,0,2,96,0,0
63910,51,1442,339,213,244,17,9,65,356,10,42,26,48,52,74,259,421,5,2410,133,0,2,12,15,0
63911,77,3944,1293,570,1093,25,15,163,1318,10,195,123,241,205,364,1516,2795,6,17273,959,0,2,15,5,0
63912,166,3529,1513,682,1277,25,13,200,1538,11,199,116,219,210,335,1557,2584,6,15641,868,0,2,5,4,0
63913,166,3529,819,519,539,24,98,155,843,15,96,57,106,111,163,690,1107,8,9171,509,0,2,5,4,0
63914,31,1087,74,35,59,1,0,14,75,3,14,7,14,17,21,58,85,1,128,7,0,2,28,4,0
63915,31,1087,245,125,200,5,7,34,250,7,30,17,34,37,51,166,265,3,1053,58,0,2,28,4,0
63916,282,5915,1943,715,1694,26,18,214,1969,12,185,120,237,197,357,1436,2721,7,20915,1161,0,2,1,1,0
63917,282,5915,1168,838,957,57,25,144,1225,19,348,224,416,367,640,3018,5452,11,61921,3440,1,2,1,1,0
63946,314,6912,72,33,56,0,4,12,72,1,1,1,1,2,2,0,2,0,1,0,0,2,1,6,0
63947,314,6912,1454,835,1044,76,110,219,1530,17,275,158,296,292,454,2297,3718,9,34017,1889,1,2,1,6,0
64198,184,5563,1660,832,1314,41,38,274,1701,20,312,209,395,332,604,2671,5058,12,64042,3557,1,2,1,0,0
64199,184,5563,1057,646,719,113,100,145,1170,18,215,134,248,233,382,1740,3004,10,31186,1732,1,2,1,0,0
64204,164,3518,1513,682,1277,25,13,200,1538,11,199,116,219,210,335,1557,2584,6,15641,868,0,2,1,0,0
64205,164,3518,819,519,539,24,98,155,843,15,96,57,106,111,163,690,1107,8,9171,509,0,2,1,0,0
64238,249,5765,4293,999,3693,19,54,507,4312,9,155,88,170,164,258,1156,1898,4,9368,520,0,2,1,0,0
64239,249,5765,1482,859,1002,125,135,219,1607,16,219,134,251,235,385,1766,3032,9,27804,1544,1,2,1,0,0
64288,314,6912,72,33,56,0,4,12,72,1,1,1,1,2,2,0,2,0,1,0,0,2,1,0,0
64289,314,6912,1454,835,1044,76,110,219,1530,17,275,158,296,292,454,2297,3718,9,34017,1889,1,2,1,0,0
64581,90,3974,1338,495,1086,10,64,173,1348,11,122,82,157,133,239,883,1686,7,11934,663,0,2,1,1,0
64587,126,5406,1513,682,1277,25,13,200,1538,11,199,116,219,210,335,1557,2584,6,15641,868,0,2,1,1,0
64590,104,5361,1457,730,1242,11,6,188,1468,10,292,166,329,302,495,2424,4078,5,22973,1276,1,2,1,0,0
64623,104,2698,773,422,505,30,103,129,803,14,77,46,83,91,129,535,839,7,6334,351,0,2,15,0,0
64624,101,2612,773,422,505,30,103,129,803,14,77,46,83,91,129,535,839,7,6334,351,0,2,0,15,0
64628,179,5318,1660,832,1314,41,38,274,1701,20,312,209,395,332,604,2671,5058,12,64042,3557,1,2,6,0,0
64629,186,5684,1660,832,1314,41,38,274,1701,20,312,209,395,332,604,2671,5058,12,64042,3557,1,2,18,0,0
64630,186,5684,1057,646,719,113,100,145,1170,18,215,134,248,233,382,1740,3004,10,31186,1732,1,2,18,0,0
64631,186,5709,1660,832,1314,41,38,274,1701,20,312,209,395,332,604,2671,5058,12,64042,3557,1,2,11,6,0
64632,186,5709,1057,646,719,113,100,145,1170,18,215,134,248,233,382,1740,3004,10,31186,1732,1,2,11,6,0
64633,182,5417,1660,832,1314,41,38,274,1701,20,312,209,395,332,604,2671,5058,12,64042,3557,1,2,47,0,0
64634,277,5793,1943,715,1694,26,18,214,1969,12,185,120,237,197,357,1436,2721,7,20915,1161,0,2,6,0,0
64635,277,5793,1168,838,957,57,25,144,1225,19,348,224,416,367,640,3018,5452,11,61921,3440,1,2,6,0,0
64636,105,5755,1943,715,1694,26,18,214,1969,12,185,120,237,197,357,1436,2721,7,20915,1161,0,2,9,0,0
64637,105,5753,1943,715,1694,26,18,214,1969,12,185,120,237,197,357,1436,2721,7,20915,1161,0,2,1,1,0
64638,276,5747,1943,715,1694,26,18,214,1969,12,185,120,237,197,357,1436,2721,7,20915,1161,0,2,0,6,0
64639,276,5747,1168,838,957,57,25,144,1225,19,348,224,416,367,640,3018,5452,11,61921,3440,1,2,0,6,0
64640,104,5722,1943,715,1694,26,18,214,1969,12,185,120,237,197,357,1436,2721,7,20915,1161,0,2,0,9,0
64641,187,5720,1660,832,1314,41,38,274,1701,20,312,209,395,332,604,2671,5058,12,64042,3557,1,2,1,1,0
64642,187,5720,1057,646,719,113,100,145,1170,18,215,134,248,233,382,1740,3004,10,31186,1732,1,2,1,1,0
64643,187,5730,1660,832,1314,41,38,274,1701,20,312,209,395,332,604,2671,5058,12,64042,3557,1,2,2,2,0
64644,187,5730,1057,646,719,113,100,145,1170,18,215,134,248,233,382,1740,3004,10,31186,1732,1,2,2,2,0
64645,182,5417,1660,832,1314,41,38,274,1701,20,312,209,395,332,604,2671,5058,12,64042,3557,1,2,2,2,0
64649,187,5730,1660,832,1314,41,38,274,1701,20,312,209,395,332,604,2671,5058,12,64042,3557,1,2,1,1,0
64650,187,5730,1057,646,719,113,100,145,1170,18,215,134,248,233,382,1740,3004,10,31186,1732,1,2,1,1,0
64651,189,5757,1660,832,1314,41,38,274,1701,20,312,209,395,332,604,2671,5058,12,64042,3557,1,2,2,0,0
64652,189,5757,1057,646,719,113,100,145,1170,18,215,134,248,233,382,1740,3004,10,31186,1732,1,2,2,0,0
64655,76,3910,1293,570,1093,25,15,163,1318,10,195,123,241,205,364,1516,2795,6,17273,959,0,2,4,4,0
64657,52,1442,339,213,244,17,9,65,356,10,42,26,48,52,74,259,421,5,2410,133,0,2,33,29,0
64658,77,3947,1293,570,1093,25,15,163,1318,10,195,123,241,205,364,1516,2795,6,17273,959,0,2,4,3,0
64659,1,98,42,7,35,4,0,5,46,1,2,1,2,3,3,2,4,0,2,0,0,2,3,2,1
64660,1,98,11,6,10,0,0,1,11,2,4,2,4,6,6,10,15,1,15,0,0,2,3,2,1
64661,181,5514,1660,832,1314,41,38,274,1701,20,312,209,395,332,604,2671,5058,12,64042,3557,1,2,0,19,1
64662,181,5514,1057,646,719,113,100,145,1170,18,215,134,248,233,382,1740,3004,10,31186,1732,1,2,0,19,1
64665,237,4939,2,2,2,0,0,0,2,0,0,0,0,0,0,0,0,0,0,0,0,2,7,14,1
64679,237,4939,99,48,90,1,3,5,100,0,0,0,0,0,0,0,0,0,0,0,0,2,7,14,1
64680,237,4939,8,5,5,2,0,1,10,0,0,0,0,0,0,0,0,0,0,0,0,2,7,14,1
64681,237,4939,1217,716,841,84,126,174,1301,14,185,118,215,199,333,1446,2542,8,20687,1149,0,2,7,14,1
64682,237,4939,160,89,115,0,13,31,160,7,15,11,17,22,28,78,124,3,495,27,0,2,7,14,1
64683,237,4939,10,10,9,9,0,0,19,0,0,0,0,0,0,0,0,0,0,0,0,2,7,14,1
64684,237,4939,173,84,99,8,29,36,181,5,12,7,13,17,20,54,81,2,221,12,0,2,7,14,1
64685,237,4939,3,1,1,3,0,0,6,0,0,0,0,0,0,0,0,0,0,0,0,2,7,14,1
64686,19,513,205,80,86,16,53,53,221,7,18,10,19,25,29,94,134,3,497,27,0,2,3,9,1
64687,106,4498,1289,550,1043,56,32,155,1345,10,167,93,185,177,278,1266,2075,5,11498,638,0,2,10,21,1
64688,129,5167,1450,624,1228,12,26,181,1462,14,306,186,354,320,540,2580,4493,8,36391,2021,1,2,20,36,1
64689,97,5225,1457,730,1242,11,6,188,1468,10,292,166,329,302,495,2424,4078,5,22973,1276,1,2,47,74,1
64690,2,56,7,6,5,0,0,2,7,1,1,1,2,2,3,0,3,1,3,0,0,2,4,10,1
64691,1,98,42,7,35,4,0,5,46,1,2,1,2,3,3,2,4,0,2,0,0,2,3,2,0
64692,1,98,11,6,10,0,0,1,11,2,4,2,4,6,6,10,15,1,15,0,0,2,3,2,0
64693,181,5514,1660,832,1314,41,38,274,1701,20,312,209,395,332,604,2671,5058,12,64042,3557,1,2,0,19,0
64694,181,5514,1057,646,719,113,100,145,1170,18,215,134,248,233,382,1740,3004,10,31186,1732,1,2,0,19,0
64697,237,4939,2,2,2,0,0,0,2,0,0,0,0,0,0,0,0,0,0,0,0,2,7,14,0
64711,237,4939,99,48,90,1,3,5,100,0,0,0,0,0,0,0,0,0,0,0,0,2,7,14,0
64712,237,4939,8,5,5,2,0,1,10,0,0,0,0,0,0,0,0,0,0,0,0,2,7,14,0
64713,237,4939,1217,716,841,84,126,174,1301,14,185,118,215,199,333,1446,2542,8,20687,1149,0,2,7,14,0
64714,237,4939,160,89,115,0,13,31,160,7,15,11,17,22,28,78,124,3,495,27,0,2,7,14,0
64715,237,4939,10,10,9,9,0,0,19,0,0,0,0,0,0,0,0,0,0,0,0,2,7,14,0
64716,237,4939,173,84,99,8,29,36,181,5,12,7,13,17,20,54,81,2,221,12,0,2,7,14,0
64717,237,4939,3,1,1,3,0,0,6,0,0,0,0,0,0,0,0,0,0,0,0,2,7,14,0
64718,19,513,205,80,86,16,53,53,221,7,18,10,19,25,29,94,134,3,497,27,0,2,3,9,0
64719,106,4498,1289,550,1043,56,32,155,1345,10,167,93,185,177,278,1266,2075,5,11498,638,0,2,10,21,0
64720,129,5167,1450,624,1228,12,26,181,1462,14,306,186,354,320,540,2580,4493,8,36391,2021,1,2,20,36,0
64721,97,5225,1457,730,1242,11,6,188,1468,10,292,166,329,302,495,2424,4078,5,22973,1276,1,2,47,74,0
64722,2,56,7,6,5,0,0,2,7,1,1,1,2,2,3,0,3,1,3,0,0,2,4,10,0
64723,187,5718,1660,832,1314,41,38,274,1701,20,312,209,395,332,604,2671,5058,12,64042,3557,1,2,25,0,0
64724,187,5718,1057,646,719,113,100,145,1170,18,215,134,248,233,382,1740,3004,10,31186,1732,1,2,25,0,0
64725,182,5438,1660,832,1314,41,38,274,1701,20,312,209,395,332,604,2671,5058,12,64042,3557,1,2,53,0,0
64894,1,98,42,7,35,4,0,5,46,1,2,1,2,3,3,2,4,0,2,0,0,2,1,0,0
64895,1,98,11,6,10,0,0,1,11,2,4,2,4,6,6,10,15,1,15,0,0,2,1,0,0
64945,229,4960,182,127,129,0,0,53,182,5,39,21,42,44,63,217,343,2,926,51,0,2,6,4,0
64946,229,4960,1165,710,800,67,119,181,1232,18,243,153,282,261,435,2000,3492,10,36473,2026,1,2,6,4,0
64974,188,5732,1660,832,1314,41,38,274,1701,20,312,209,395,332,604,2671,5058,12,64042,3557,1,2,5,1,0
64975,188,5732,1057,646,719,113,100,145,1170,18,215,134,248,233,382,1740,3004,10,31186,1732,1,2,5,1,0
64980,166,3529,1513,682,1277,25,13,200,1538,11,199,116,219,210,335,1557,2584,6,15641,868,0,2,6,4,0
64981,166,3529,819,519,539,24,98,155,843,15,96,57,106,111,163,690,1107,8,9171,509,0,2,6,4,0
64986,237,4939,2,2,2,0,0,0,2,0,0,0,0,0,0,0,0,0,0,0,0,2,4,3,0
65000,237,4939,99,48,90,1,3,5,100,0,0,0,0,0,0,0,0,0,0,0,0,2,4,3,0
65001,237,4939,8,5,5,2,0,1,10,0,0,0,0,0,0,0,0,0,0,0,0,2,4,3,0
65002,237,4939,1217,716,841,84,126,174,1301,14,185,118,215,199,333,1446,2542,8,20687,1149,0,2,4,3,0
65003,237,4939,160,89,115,0,13,31,160,7,15,11,17,22,28,78,124,3,495,27,0,2,4,3,0
65004,237,4939,10,10,9,9,0,0,19,0,0,0,0,0,0,0,0,0,0,0,0,2,4,3,0
65005,237,4939,173,84,99,8,29,36,181,5,12,7,13,17,20,54,81,2,221,12,0,2,4,3,0
65006,237,4939,3,1,1,3,0,0,6,0,0,0,0,0,0,0,0,0,0,0,0,2,4,3,0
65010,52,1442,339,213,244,17,9,65,356,10,42,26,48,52,74,259,421,5,2410,133,0,2,46,44,0
65014,249,5763,4293,999,3693,19,54,507,4312,9,155,88,170,164,258,1156,1898,4,9368,520,0,2,10,0,0
65015,249,5763,1482,859,1002,125,135,219,1607,16,219,134,251,235,385,1766,3032,9,27804,1544,1,2,10,0,0
65017,31,1087,74,35,59,1,0,14,75,3,14,7,14,17,21,58,85,1,128,7,0,2,1,0,0
65018,31,1087,245,125,200,5,7,34,250,7,30,17,34,37,51,166,265,3,1053,58,0,2,1,0,0
65057,19,513,205,80,86,16,53,53,221,7,18,10,19,25,29,94,134,3,497,27,0,2,1,0,0
65064,314,6912,72,33,56,0,4,12,72,1,1,1,1,2,2,0,2,0,1,0,0,2,3,7,0
65065,314,6912,1454,835,1044,76,110,219,1530,17,275,158,296,292,454,2297,3718,9,34017,1889,1,2,3,7,0
65066,92,1886,757,253,292,73,244,162,830,13,61,38,67,74,105,409,651,7,4654,258,0,2,2,1,0
65367,98,5250,1457,730,1242,11,6,188,1468,10,292,166,329,302,495,2424,4078,5,22973,1276,1,2,12,0,0
65370,2,56,7,6,5,0,0,2,7,1,1,1,2,2,3,0,3,1,3,0,0,2,1,0,0
65379,78,3962,1293,570,1093,25,15,163,1318,10,195,123,241,205,364,1516,2795,6,17273,959,0,2,20,8,0
65387,81,3172,1178,367,1042,6,15,115,1184,9,94,51,95,103,146,644,976,4,4439,246,0,2,1,1,0
66060,73,1512,207,111,150,11,0,50,218,5,26,19,36,31,55,133,272,3,943,52,0,2,0,1,0
66061,73,1512,410,198,237,31,55,97,441,11,63,38,72,74,110,414,683,6,4293,238,0,2,0,1,0
66062,315,6908,72,33,56,0,4,12,72,1,1,1,1,2,2,0,2,0,1,0,0,2,1,2,0
66063,315,6908,1454,835,1044,76,110,219,1530,17,275,158,296,292,454,2297,3718,9,34017,1889,1,2,1,2,0
66064,19,721,442,244,305,14,16,103,456,11,68,45,75,79,120,452,756,6,4588,254,0,2,21,21,0
66065,19,721,182,102,99,11,40,35,193,3,11,6,11,14,17,42,64,1,97,5,0,2,21,21,0
66068,6,151,127,75,83,2,11,30,129,4,14,7,14,18,21,61,87,2,175,9,0,2,9,4,1
66069,6,151,652,304,544,16,6,88,668,6,89,51,101,95,152,591,998,3,3399,188,0,2,9,4,1
66070,6,151,2,2,2,0,0,0,2,0,0,0,0,0,0,0,0,0,0,0,0,2,9,4,1
66071,6,151,8,5,5,0,0,3,8,0,0,0,0,0,0,0,0,0,0,0,0,2,9,4,1
66074,6,151,14,8,8,0,0,6,14,0,0,0,0,0,0,0,0,0,0,0,0,2,9,4,1
66075,6,151,6,4,4,0,0,2,6,0,0,0,0,0,0,0,0,0,0,0,0,2,9,4,1
66076,6,151,6,4,4,0,0,2,6,1,2,1,2,3,3,2,4,0,2,0,0,2,9,4,1
66078,6,151,7,5,5,0,0,2,7,0,0,0,0,0,0,0,0,0,0,0,0,2,9,4,1
66080,6,151,10,6,6,0,0,4,10,0,0,0,0,0,0,0,0,0,0,0,0,2,9,4,1
66081,6,151,1,1,1,0,0,0,1,0,0,0,0,0,0,0,0,0,0,0,0,2,9,4,1
66083,6,151,14,10,10,0,0,4,14,1,1,1,1,2,2,0,2,0,1,0,0,2,9,4,1
66084,6,151,46,26,30,3,0,12,49,3,6,3,6,9,9,20,28,1,42,2,0,2,9,4,1
66085,103,2661,773,422,505,30,103,129,803,14,77,46,83,91,129,535,839,7,6334,351,0,2,26,19,0
66086,38,2498,1157,318,931,29,22,177,1186,6,104,63,125,110,188,712,1274,3,4596,255,0,2,45,0,0
66093,6,151,127,75,83,2,11,30,129,4,14,7,14,18,21,61,87,2,175,9,0,2,9,4,0
66094,6,151,652,304,544,16,6,88,668,6,89,51,101,95,152,591,998,3,3399,188,0,2,9,4,0
66095,6,151,2,2,2,0,0,0,2,0,0,0,0,0,0,0,0,0,0,0,0,2,9,4,0
66096,6,151,8,5,5,0,0,3,8,0,0,0,0,0,0,0,0,0,0,0,0,2,9,4,0
66099,6,151,14,8,8,0,0,6,14,0,0,0,0,0,0,0,0,0,0,0,0,2,9,4,0
66100,6,151,6,4,4,0,0,2,6,0,0,0,0,0,0,0,0,0,0,0,0,2,9,4,0
66101,6,151,6,4,4,0,0,2,6,1,2,1,2,3,3,2,4,0,2,0,0,2,9,4,0
66103,6,151,7,5,5,0,0,2,7,0,0,0,0,0,0,0,0,0,0,0,0,2,9,4,0
66105,6,151,10,6,6,0,0,4,10,0,0,0,0,0,0,0,0,0,0,0,0,2,9,4,0
66106,6,151,1,1,1,0,0,0,1,0,0,0,0,0,0,0,0,0,0,0,0,2,9,4,0
66108,6,151,14,10,10,0,0,4,14,1,1,1,1,2,2,0,2,0,1,0,0,2,9,4,0
66109,6,151,46,26,30,3,0,12,49,3,6,3,6,9,9,20,28,1,42,2,0,2,9,4,0
66110,6,153,127,75,83,2,11,30,129,4,14,7,14,18,21,61,87,2,175,9,0,2,3,3,0
66111,6,153,652,304,544,16,6,88,668,6,89,51,101,95,152,591,998,3,3399,188,0,2,3,3,0
66112,6,153,2,2,2,0,0,0,2,0,0,0,0,0,0,0,0,0,0,0,0,2,3,3,0
66113,6,153,8,5,5,0,0,3,8,0,0,0,0,0,0,0,0,0,0,0,0,2,3,3,0
66116,6,153,14,8,8,0,0,6,14,0,0,0,0,0,0,0,0,0,0,0,0,2,3,3,0
66117,6,153,6,4,4,0,0,2,6,0,0,0,0,0,0,0,0,0,0,0,0,2,3,3,0
66118,6,153,6,4,4,0,0,2,6,1,2,1,2,3,3,2,4,0,2,0,0,2,3,3,0
66120,6,153,7,5,5,0,0,2,7,0,0,0,0,0,0,0,0,0,0,0,0,2,3,3,0
66122,6,153,10,6,6,0,0,4,10,0,0,0,0,0,0,0,0,0,0,0,0,2,3,3,0
66123,6,153,1,1,1,0,0,0,1,0,0,0,0,0,0,0,0,0,0,0,0,2,3,3,0
66125,6,153,14,10,10,0,0,4,14,1,1,1,1,2,2,0,2,0,1,0,0,2,3,3,0
66126,6,153,46,26,30,3,0,12,49,3,6,3,6,9,9,20,28,1,42,2,0,2,3,3,0
66144,6,153,127,75,83,2,11,30,129,4,14,7,14,18,21,61,87,2,175,9,0,2,10,5,0
66145,6,153,652,304,544,16,6,88,668,6,89,51,101,95,152,591,998,3,3399,188,0,2,10,5,0
66146,6,153,2,2,2,0,0,0,2,0,0,0,0,0,0,0,0,0,0,0,0,2,10,5,0
66147,6,153,8,5,5,0,0,3,8,0,0,0,0,0,0,0,0,0,0,0,0,2,10,5,0
66150,6,153,14,8,8,0,0,6,14,0,0,0,0,0,0,0,0,0,0,0,0,2,10,5,0
66151,6,153,6,4,4,0,0,2,6,0,0,0,0,0,0,0,0,0,0,0,0,2,10,5,0
66152,6,153,6,4,4,0,0,2,6,1,2,1,2,3,3,2,4,0,2,0,0,2,10,5,0
66154,6,153,7,5,5,0,0,2,7,0,0,0,0,0,0,0,0,0,0,0,0,2,10,5,0
66156,6,153,10,6,6,0,0,4,10,0,0,0,0,0,0,0,0,0,0,0,0,2,10,5,0
66157,6,153,1,1,1,0,0,0,1,0,0,0,0,0,0,0,0,0,0,0,0,2,10,5,0
66159,6,153,14,10,10,0,0,4,14,1,1,1,1,2,2,0,2,0,1,0,0,2,10,5,0
66160,6,153,46,26,30,3,0,12,49,3,6,3,6,9,9,20,28,1,42,2,0,2,10,5,0
66163,90,2054,996,429,845,24,10,117,1020,7,76,50,88,83,138,494,879,4,3565,198,0,2,1,0,1
66164,90,2054,456,277,329,12,42,72,468,13,85,50,97,98,147,592,972,7,7212,400,0,2,1,0,1
66165,49,3737,996,429,845,24,10,117,1020,7,76,50,88,83,138,494,879,4,3565,198,0,2,20,0,1
66166,107,2805,773,422,505,30,103,129,803,14,77,46,83,91,129,535,839,7,6334,351,0,2,33,0,0
66167,2,235,149,67,118,4,0,27,153,1,17,14,28,18,42,69,175,0,144,8,0,2,30,0,0
66168,91,2069,996,429,845,24,10,117,1020,7,76,50,88,83,138,494,879,4,3565,198,0,2,8,11,0
66169,91,2069,456,277,329,12,42,72,468,13,85,50,97,98,147,592,972,7,7212,400,0,2,8,11,0
66170,49,3805,996,429,845,24,10,117,1020,7,76,50,88,83,138,494,879,4,3565,198,0,2,23,1,0
66171,91,2063,996,429,845,24,10,117,1020,7,76,50,88,83,138,494,879,4,3565,198,0,2,4,3,0
66172,91,2063,456,277,329,12,42,72,468,13,85,50,97,98,147,592,972,7,7212,400,0,2,4,3,0
66173,91,2055,996,429,845,24,10,117,1020,7,76,50,88,83,138,494,879,4,3565,198,0,2,8,12,0
66174,91,2055,456,277,329,12,42,72,468,13,85,50,97,98,147,592,972,7,7212,400,0,2,8,12,0
66175,49,3805,996,429,845,24,10,117,1020,7,76,50,88,83,138,494,879,4,3565,198,0,2,1,1,0
66176,91,2055,996,429,845,24,10,117,1020,7,76,50,88,83,138,494,879,4,3565,198,0,2,20,25,0
66177,91,2055,456,277,329,12,42,72,468,13,85,50,97,98,147,592,972,7,7212,400,0,2,20,25,0
66178,49,3805,996,429,845,24,10,117,1020,7,76,50,88,83,138,494,879,4,3565,198,0,2,42,0,0
66196,117,3174,1523,757,1297,19,12,193,1542,12,193,117,230,205,347,1508,2664,7,19053,1058,0,2,12,0,0
66197,117,3174,701,378,504,33,58,109,734,13,110,68,126,123,194,794,1346,7,10027,557,0,2,12,0,0
66198,108,5173,1523,757,1297,19,12,193,1542,12,193,117,230,205,347,1508,2664,7,19053,1058,0,2,27,0,0
66199,57,1522,339,213,244,17,9,65,356,10,42,26,48,52,74,259,421,5,2410,133,0,2,132,120,0
66200,79,4018,1293,570,1093,25,15,163,1318,10,195,123,241,205,364,1516,2795,6,17273,959,0,2,39,10,0
66201,76,3947,1293,570,1093,25,15,163,1318,10,195,123,241,205,364,1516,2795,6,17273,959,0,2,3,3,0
66202,76,3942,1293,570,1093,25,15,163,1318,10,195,123,241,205,364,1516,2795,6,17273,959,0,2,0,1,0
66203,76,3942,1293,570,1093,25,15,163,1318,10,195,123,241,205,364,1516,2795,6,17273,959,0,2,3,4,0
66207,77,3957,1293,570,1093,25,15,163,1318,10,195,123,241,205,364,1516,2795,6,17273,959,0,2,3,4,0
66210,6,163,127,75,83,2,11,30,129,4,14,7,14,18,21,61,87,2,175,9,0,2,1,0,0
66211,6,163,652,304,544,16,6,88,668,6,89,51,101,95,152,591,998,3,3399,188,0,2,1,0,0
66212,6,163,2,2,2,0,0,0,2,0,0,0,0,0,0,0,0,0,0,0,0,2,1,0,0
66213,6,163,8,5,5,0,0,3,8,0,0,0,0,0,0,0,0,0,0,0,0,2,1,0,0
66216,6,163,14,8,8,0,0,6,14,0,0,0,0,0,0,0,0,0,0,0,0,2,1,0,0
66217,6,163,6,4,4,0,0,2,6,0,0,0,0,0,0,0,0,0,0,0,0,2,1,0,0
66218,6,163,6,4,4,0,0,2,6,1,2,1,2,3,3,2,4,0,2,0,0,2,1,0,0
66220,6,163,7,5,5,0,0,2,7,0,0,0,0,0,0,0,0,0,0,0,0,2,1,0,0
66222,6,163,10,6,6,0,0,4,10,0,0,0,0,0,0,0,0,0,0,0,0,2,1,0,0
66223,6,163,1,1,1,0,0,0,1,0,0,0,0,0,0,0,0,0,0,0,0,2,1,0,0
66225,6,163,14,10,10,0,0,4,14,1,1,1,1,2,2,0,2,0,1,0,0,2,1,0,0
66226,6,163,46,26,30,3,0,12,49,3,6,3,6,9,9,20,28,1,42,2,0,2,1,0,0
66227,231,5945,722,423,573,19,0,135,741,12,172,101,199,184,300,1320,2257,6,15668,870,0,2,0,9,0
66228,231,5945,1508,847,911,44,250,301,1552,14,148,88,169,162,257,1120,1886,7,15077,837,0,2,0,9,0
66229,314,6928,72,33,56,0,4,12,72,1,1,1,1,2,2,0,2,0,1,0,0,2,4,2,0
66230,314,6928,1454,835,1044,76,110,219,1530,17,275,158,296,292,454,2297,3718,9,34017,1889,1,2,4,2,0
66231,91,4008,1338,495,1086,10,64,173,1348,11,122,82,157,133,239,883,1686,7,11934,663,0,2,18,1,0
66254,78,4013,1293,570,1093,25,15,163,1318,10,195,123,241,205,364,1516,2795,6,17273,959,0,2,3,4,0
66255,231,5978,722,423,573,19,0,135,741,12,172,101,199,184,300,1320,2257,6,15668,870,0,2,7,1,1
66256,231,5978,1508,847,911,44,250,301,1552,14,148,88,169,162,257,1120,1886,7,15077,837,0,2,7,1,1
66257,56,2875,722,423,573,19,0,135,741,12,172,101,199,184,300,1320,2257,6,15668,870,0,2,23,0,1
66258,232,5970,722,423,573,19,0,135,741,12,172,101,199,184,300,1320,2257,6,15668,870,0,2,8,7,0
66259,232,5970,1508,847,911,44,250,301,1552,14,148,88,169,162,257,1120,1886,7,15077,837,0,2,8,7,0
66260,56,2883,722,423,573,19,0,135,741,12,172,101,199,184,300,1320,2257,6,15668,870,0,2,3,0,0
66264,232,5970,722,423,573,19,0,135,741,12,172,101,199,184,300,1320,2257,6,15668,870,0,2,13,6,0
66265,232,5970,1508,847,911,44,250,301,1552,14,148,88,169,162,257,1120,1886,7,15077,837,0,2,13,6,0
66266,56,2883,722,423,573,19,0,135,741,12,172,101,199,184,300,1320,2257,6,15668,870,0,2,26,0,0
66267,253,5855,4293,999,3693,19,54,507,4312,9,155,88,170,164,258,1156,1898,4,9368,520,0,2,26,2,1
66268,253,5855,1482,859,1002,125,135,219,1607,16,219,134,251,235,385,1766,3032,9,27804,1544,1,2,26,2,1
66269,70,1557,402,202,227,24,74,80,426,12,52,33,61,64,94,339,564,7,3969,220,0,2,10,2,1
66270,172,7635,4293,999,3693,19,54,507,4312,9,155,88,170,164,258,1156,1898,4,9368,520,0,2,43,0,1
66271,172,7635,1482,859,1002,125,135,219,1607,16,219,134,251,235,385,1766,3032,9,27804,1544,1,2,43,0,1
66272,253,5855,4293,999,3693,19,54,507,4312,9,155,88,170,164,258,1156,1898,4,9368,520,0,2,26,2,0
66273,253,5855,1482,859,1002,125,135,219,1607,16,219,134,251,235,385,1766,3032,9,27804,1544,1,2,26,2,0
66274,70,1557,402,202,227,24,74,80,426,12,52,33,61,64,94,339,564,7,3969,220,0,2,10,2,0
66275,172,7635,4293,999,3693,19,54,507,4312,9,155,88,170,164,258,1156,1898,4,9368,520,0,2,43,0,0
66276,172,7635,1482,859,1002,125,135,219,1607,16,219,134,251,235,385,1766,3032,9,27804,1544,1,2,43,0,0
66279,253,5853,4293,999,3693,19,54,507,4312,9,155,88,170,164,258,1156,1898,4,9368,520,0,2,26,2,0
66280,253,5853,1482,859,1002,125,135,219,1607,16,219,134,251,235,385,1766,3032,9,27804,1544,1,2,26,2,0
66282,315,6924,72,33,56,0,4,12,72,1,1,1,1,2,2,0,2,0,1,0,0,2,4,2,0
66283,315,6924,1454,835,1044,76,110,219,1530,17,275,158,296,292,454,2297,3718,9,34017,1889,1,2,4,2,0
66297,188,5732,1660,832,1314,41,38,274,1701,20,312,209,395,332,604,2671,5058,12,64042,3557,1,2,25,19,0
66298,188,5732,1057,646,719,113,100,145,1170,18,215,134,248,233,382,1740,3004,10,31186,1732,1,2,25,19,0
66325,253,5853,4293,999,3693,19,54,507,4312,9,155,88,170,164,258,1156,1898,4,9368,520,0,2,2,4,0
66326,253,5853,1482,859,1002,125,135,219,1607,16,219,134,251,235,385,1766,3032,9,27804,1544,1,2,2,4,0
66331,107,2805,773,422,505,30,103,129,803,14,77,46,83,91,129,535,839,7,6334,351,0,2,59,19,0
66332,19,513,205,80,86,16,53,53,221,7,18,10,19,25,29,94,134,3,497,27,0,2,8,14,0
66333,232,5970,722,423,573,19,0,135,741,12,172,101,199,184,300,1320,2257,6,15668,870,0,2,13,15,0
66334,232,5970,1508,847,911,44,250,301,1552,14,148,88,169,162,257,1120,1886,7,15077,837,0,2,13,15,0
66335,315,6924,72,33,56,0,4,12,72,1,1,1,1,2,2,0,2,0,1,0,0,2,1,2,0
66336,315,6924,1454,835,1044,76,110,219,1530,17,275,158,296,292,454,2297,3718,9,34017,1889,1,2,1,2,0
66361,129,5167,1450,624,1228,12,26,181,1462,14,306,186,354,320,540,2580,4493,8,36391,2021,1,2,24,37,0
66363,98,5250,1457,730,1242,11,6,188,1468,10,292,166,329,302,495,2424,4078,5,22973,1276,1,2,47,74,0
66366,78,4013,1293,570,1093,25,15,163,1318,10,195,123,241,205,364,1516,2795,6,17273,959,0,2,59,26,0
66371,71,1576,402,202,227,24,74,80,426,12,52,33,61,64,94,339,564,7,3969,220,0,2,7,3,0
66372,71,3226,1020,354,843,12,15,144,1032,8,134,77,144,142,221,970,1580,4,6792,377,0,2,22,0,0
66375,189,5744,1660,832,1314,41,38,274,1701,20,312,209,395,332,604,2671,5058,12,64042,3557,1,2,12,4,0
66376,189,5744,1057,646,719,113,100,145,1170,18,215,134,248,233,382,1740,3004,10,31186,1732,1,2,12,4,0
66377,184,5506,1660,832,1314,41,38,274,1701,20,312,209,395,332,604,2671,5058,12,64042,3557,1,2,27,2,0
66381,1,94,42,7,35,4,0,5,46,1,2,1,2,3,3,2,4,0,2,0,0,2,2,4,1
66382,1,94,11,6,10,0,0,1,11,2,4,2,4,6,6,10,15,1,15,0,0,2,2,4,1
66383,221,4758,182,127,129,0,0,53,182,5,39,21,42,44,63,217,343,2,926,51,0,2,47,95,1
66384,221,4758,1165,710,800,67,119,181,1232,18,243,153,282,261,435,2000,3492,10,36473,2026,1,2,47,95,1
66387,25,514,2,2,2,0,0,0,2,0,0,0,0,0,0,0,0,0,0,0,0,2,0,4,1
66401,25,514,99,48,90,1,3,5,100,0,0,0,0,0,0,0,0,0,0,0,0,2,0,4,1
66402,25,514,8,5,5,2,0,1,10,0,0,0,0,0,0,0,0,0,0,0,0,2,0,4,1
66403,25,514,1217,716,841,84,126,174,1301,14,185,118,215,199,333,1446,2542,8,20687,1149,0,2,0,4,1
66404,25,514,160,89,115,0,13,31,160,7,15,11,17,22,28,78,124,3,495,27,0,2,0,4,1
66405,25,514,10,10,9,9,0,0,19,0,0,0,0,0,0,0,0,0,0,0,0,2,0,4,1
66406,25,514,173,84,99,8,29,36,181,5,12,7,13,17,20,54,81,2,221,12,0,2,0,4,1
66407,25,514,3,1,1,3,0,0,6,0,0,0,0,0,0,0,0,0,0,0,0,2,0,4,1
66408,174,5298,1660,832,1314,41,38,274,1701,20,312,209,395,332,604,2671,5058,12,64042,3557,1,2,9,93,1
66409,174,5298,1057,646,719,113,100,145,1170,18,215,134,248,233,382,1740,3004,10,31186,1732,1,2,9,93,1
66410,116,2173,477,336,357,30,23,73,507,16,194,134,250,210,384,1538,2962,10,30538,1696,0,2,1,1,1
66411,90,2044,996,429,845,24,10,117,1020,7,76,50,88,83,138,494,879,4,3565,198,0,2,1,2,1
66412,90,2044,456,277,329,12,42,72,468,13,85,50,97,98,147,592,972,7,7212,400,0,2,1,2,1
66413,160,3459,1513,682,1277,25,13,200,1538,11,199,116,219,210,335,1557,2584,6,15641,868,0,2,4,23,1
66414,160,3459,819,519,539,24,98,155,843,15,96,57,106,111,163,690,1107,8,9171,509,0,2,4,23,1
66415,59,1120,207,111,150,11,0,50,218,5,26,19,36,31,55,133,272,3,943,52,0,2,34,157,1
66416,59,1120,410,198,237,31,55,97,441,11,63,38,72,74,110,414,683,6,4293,238,0,2,34,157,1
66419,235,4913,2,2,2,0,0,0,2,0,0,0,0,0,0,0,0,0,0,0,0,2,3,10,1
66433,235,4913,99,48,90,1,3,5,100,0,0,0,0,0,0,0,0,0,0,0,0,2,3,10,1
66434,235,4913,8,5,5,2,0,1,10,0,0,0,0,0,0,0,0,0,0,0,0,2,3,10,1
66435,235,4913,1217,716,841,84,126,174,1301,14,185,118,215,199,333,1446,2542,8,20687,1149,0,2,3,10,1
66436,235,4913,160,89,115,0,13,31,160,7,15,11,17,22,28,78,124,3,495,27,0,2,3,10,1
66437,235,4913,10,10,9,9,0,0,19,0,0,0,0,0,0,0,0,0,0,0,0,2,3,10,1
66438,235,4913,173,84,99,8,29,36,181,5,12,7,13,17,20,54,81,2,221,12,0,2,3,10,1
66439,235,4913,3,1,1,3,0,0,6,0,0,0,0,0,0,0,0,0,0,0,0,2,3,10,1
66440,90,2308,1455,414,1257,16,76,112,1471,5,41,23,46,46,69,231,381,2,1069,59,0,2,0,27,1
66441,90,2308,669,365,481,22,61,110,691,15,103,63,122,118,185,747,1273,8,11311,628,0,2,0,27,1
66442,251,5838,4293,999,3693,19,54,507,4312,9,155,88,170,164,258,1156,1898,4,9368,520,0,2,1,5,1
66443,251,5838,1482,859,1002,125,135,219,1607,16,219,134,251,235,385,1766,3032,9,27804,1544,1,2,1,5,1
66444,117,3160,1523,757,1297,19,12,193,1542,12,193,117,230,205,347,1508,2664,7,19053,1058,0,2,0,4,1
66445,117,3160,701,378,504,33,58,109,734,13,110,68,126,123,194,794,1346,7,10027,557,0,2,0,4,1
66446,105,2779,773,422,505,30,103,129,803,14,77,46,83,91,129,535,839,7,6334,351,0,2,2,8,1
66447,149,3603,77,34,69,0,0,8,77,3,24,16,29,27,45,114,213,1,387,21,0,2,5,56,1
66448,149,3603,712,438,573,51,9,84,763,14,102,71,128,116,199,733,1364,8,11988,666,0,2,5,56,1
66449,71,1576,402,202,227,24,74,80,426,12,52,33,61,64,94,339,564,7,3969,220,0,2,2,2,1
66450,51,1113,447,308,343,6,5,95,453,7,96,59,111,103,170,651,1136,4,4600,255,0,2,2,14,1
66451,51,1113,322,174,179,16,74,51,338,10,41,26,46,51,72,252,408,5,2291,127,0,2,2,14,1
66452,15,490,184,100,137,2,15,30,186,6,38,20,39,44,59,214,322,3,991,55,0,2,3,12,1
66453,15,490,103,65,74,8,5,16,111,7,17,9,17,24,26,89,119,3,417,23,0,2,3,12,1
66454,58,1203,91,45,69,0,3,18,91,3,9,6,10,12,16,33,57,1,95,5,0,2,3,16,1
66455,58,1203,367,234,237,17,34,68,384,16,55,34,61,71,95,381,584,8,5183,287,0,2,3,16,1
66456,228,5903,722,423,573,19,0,135,741,12,172,101,199,184,300,1320,2257,6,15668,870,0,2,3,18,1
66457,228,5903,1508,847,911,44,250,301,1552,14,148,88,169,162,257,1120,1886,7,15077,837,0,2,3,18,1
66458,315,6914,72,33,56,0,4,12,72,1,1,1,1,2,2,0,2,0,1,0,0,2,2,3,1
66459,315,6914,1454,835,1044,76,110,219,1530,17,275,158,296,292,454,2297,3718,9,34017,1889,1,2,2,3,1
66460,89,1819,757,253,292,73,244,162,830,13,61,38,67,74,105,409,651,7,4654,258,0,2,4,15,1
66461,38,814,386,256,301,16,9,68,402,4,59,35,69,63,104,355,621,2,1453,80,0,2,1,34,1
66462,38,814,264,131,164,11,41,46,275,6,38,22,40,44,62,214,338,3,1068,59,0,2,1,34,1
66463,40,796,1178,367,1042,6,15,115,1184,9,94,51,95,103,146,644,976,4,4439,246,0,2,2,6,1
66464,40,796,177,108,140,8,0,27,185,6,30,16,32,36,48,162,248,3,794,44,0,2,2,6,1
66465,280,5888,1943,715,1694,26,18,214,1969,12,185,120,237,197,357,1436,2721,7,20915,1161,0,2,0,15,1
66466,280,5888,1168,838,957,57,25,144,1225,19,348,224,416,367,640,3018,5452,11,61921,3440,1,2,0,15,1
66467,19,717,442,244,305,14,16,103,456,11,68,45,75,79,120,452,756,6,4588,254,0,2,1,4,1
66468,19,717,182,102,99,11,40,35,193,3,11,6,11,14,17,42,64,1,97,5,0,2,1,4,1
66469,65,1263,1098,241,925,5,10,155,1103,7,46,25,49,53,74,273,423,3,1580,87,0,2,1,20,1
66470,65,1263,282,202,222,14,2,44,296,8,42,24,43,50,67,250,378,4,1548,86,0,2,1,20,1
66471,23,642,601,196,481,2,23,85,603,8,63,36,72,71,108,400,664,4,3036,168,0,2,1,22,1
66472,23,642,156,79,106,5,16,28,161,5,14,8,15,19,23,64,97,2,261,14,0,2,1,22,1
66473,104,4436,1289,550,1043,56,32,155,1345,10,167,93,185,177,278,1266,2075,5,11498,638,0,2,2,12,1
66474,31,994,182,127,129,0,0,53,182,5,39,21,42,44,63,217,343,2,926,51,0,2,6,27,1
66475,151,7251,1392,870,1177,35,17,170,1427,14,494,280,531,508,811,4473,7289,7,54850,3047,2,2,12,25,1
66476,95,2896,773,419,590,28,0,166,801,10,204,113,217,214,330,1598,2554,5,13587,754,0,2,1,3,1
66477,2,58,16,12,9,0,0,6,16,1,2,1,2,3,3,2,4,0,2,0,0,2,1,5,1
66478,65,4378,520,294,400,33,13,81,553,10,261,204,367,271,571,2128,4614,7,32445,1802,1,2,1,2,1
66479,90,3988,1338,495,1086,10,64,173,1348,11,122,82,157,133,239,883,1686,7,11934,663,0,2,0,2,1
66480,144,5933,1782,648,1425,9,47,279,1791,8,171,97,189,179,286,1292,2140,4,9462,525,0,2,0,2,1
66481,32,982,256,139,192,9,7,47,265,4,23,12,24,27,36,112,171,2,357,19,0,2,4,15,1
66482,19,517,102,59,69,5,3,24,107,6,22,15,28,28,43,113,206,3,789,43,0,2,1,13,1
66483,119,4920,1450,624,1228,12,26,181,1462,14,306,186,354,320,540,2580,4493,8,36391,2021,1,2,4,64,1
66484,176,5162,1660,832,1314,41,38,274,1701,20,312,209,395,332,604,2671,5058,12,64042,3557,1,2,7,91,1
66485,120,5123,1513,682,1277,25,13,200,1538,11,199,116,219,210,335,1557,2584,6,15641,868,0,2,7,66,1
66486,84,4916,1296,573,1062,40,33,157,1336,8,201,118,231,209,349,1561,2689,4,12365,686,0,2,0,2,1
66487,20,467,207,111,150,11,0,50,218,5,26,19,36,31,55,133,272,3,943,52,0,2,0,7,1
66488,98,5241,1457,730,1242,11,6,188,1468,10,292,166,329,302,495,2424,4078,5,22973,1276,1,2,0,3,1
66489,72,3266,1455,414,1257,16,76,112,1471,5,41,23,46,46,69,231,381,2,1069,59,0,2,3,7,1
66490,107,5160,1523,757,1297,19,12,193,1542,12,193,117,230,205,347,1508,2664,7,19053,1058,0,2,1,3,1
66491,70,3204,1020,354,843,12,15,144,1032,8,134,77,144,142,221,970,1580,4,6792,377,0,2,2,11,1
66492,44,2058,447,308,343,6,5,95,453,7,96,59,111,103,170,651,1136,4,4600,255,0,2,2,22,1
66493,9,444,184,100,137,2,15,30,186,6,38,20,39,44,59,214,322,3,991,55,0,2,4,14,1
66494,75,3960,1293,570,1093,25,15,163,1318,10,195,123,241,205,364,1516,2795,6,17273,959,0,2,5,19,1
66495,85,3387,1043,504,840,53,9,147,1096,9,180,112,198,189,310,1377,2344,4,11604,644,0,2,1,4,1
66496,79,3101,1178,367,1042,6,15,115,1184,9,94,51,95,103,146,644,976,4,4439,246,0,2,1,20,1
66497,35,1497,442,244,305,14,16,103,456,11,68,45,75,79,120,452,756,6,4588,254,0,2,0,3,1
66498,48,1943,1098,241,925,5,10,155,1103,7,46,25,49,53,74,273,423,3,1580,87,0,2,4,14,1
66499,48,1649,601,196,481,2,23,85,603,8,63,36,72,71,108,400,664,4,3036,168,0,2,0,95,1
66500,1,94,42,7,35,4,0,5,46,1,2,1,2,3,3,2,4,0,2,0,0,2,2,4,0
66501,1,94,11,6,10,0,0,1,11,2,4,2,4,6,6,10,15,1,15,0,0,2,2,4,0
66502,221,4758,182,127,129,0,0,53,182,5,39,21,42,44,63,217,343,2,926,51,0,2,47,95,0
66503,221,4758,1165,710,800,67,119,181,1232,18,243,153,282,261,435,2000,3492,10,36473,2026,1,2,47,95,0
66506,25,514,2,2,2,0,0,0,2,0,0,0,0,0,0,0,0,0,0,0,0,2,0,4,0
66520,25,514,99,48,90,1,3,5,100,0,0,0,0,0,0,0,0,0,0,0,0,2,0,4,0
66521,25,514,8,5,5,2,0,1,10,0,0,0,0,0,0,0,0,0,0,0,0,2,0,4,0
66522,25,514,1217,716,841,84,126,174,1301,14,185,118,215,199,333,1446,2542,8,20687,1149,0,2,0,4,0
66523,25,514,160,89,115,0,13,31,160,7,15,11,17,22,28,78,124,3,495,27,0,2,0,4,0
66524,25,514,10,10,9,9,0,0,19,0,0,0,0,0,0,0,0,0,0,0,0,2,0,4,0
66525,25,514,173,84,99,8,29,36,181,5,12,7,13,17,20,54,81,2,221,12,0,2,0,4,0
66526,25,514,3,1,1,3,0,0,6,0,0,0,0,0,0,0,0,0,0,0,0,2,0,4,0
66527,174,5298,1660,832,1314,41,38,274,1701,20,312,209,395,332,604,2671,5058,12,64042,3557,1,2,9,93,0
66528,174,5298,1057,646,719,113,100,145,1170,18,215,134,248,233,382,1740,3004,10,31186,1732,1,2,9,93,0
66530,90,2044,996,429,845,24,10,117,1020,7,76,50,88,83,138,494,879,4,3565,198,0,2,1,2,0
66531,90,2044,456,277,329,12,42,72,468,13,85,50,97,98,147,592,972,7,7212,400,0,2,1,2,0
66532,160,3459,1513,682,1277,25,13,200,1538,11,199,116,219,210,335,1557,2584,6,15641,868,0,2,4,23,0
66533,160,3459,819,519,539,24,98,155,843,15,96,57,106,111,163,690,1107,8,9171,509,0,2,4,23,0
66534,59,1120,207,111,150,11,0,50,218,5,26,19,36,31,55,133,272,3,943,52,0,2,34,157,0
66535,59,1120,410,198,237,31,55,97,441,11,63,38,72,74,110,414,683,6,4293,238,0,2,34,157,0
66538,235,4913,2,2,2,0,0,0,2,0,0,0,0,0,0,0,0,0,0,0,0,2,3,10,0
66552,235,4913,99,48,90,1,3,5,100,0,0,0,0,0,0,0,0,0,0,0,0,2,3,10,0
66553,235,4913,8,5,5,2,0,1,10,0,0,0,0,0,0,0,0,0,0,0,0,2,3,10,0
66554,235,4913,1217,716,841,84,126,174,1301,14,185,118,215,199,333,1446,2542,8,20687,1149,0,2,3,10,0
66555,235,4913,160,89,115,0,13,31,160,7,15,11,17,22,28,78,124,3,495,27,0,2,3,10,0
66556,235,4913,10,10,9,9,0,0,19,0,0,0,0,0,0,0,0,0,0,0,0,2,3,10,0
66557,235,4913,173,84,99,8,29,36,181,5,12,7,13,17,20,54,81,2,221,12,0,2,3,10,0
66558,235,4913,3,1,1,3,0,0,6,0,0,0,0,0,0,0,0,0,0,0,0,2,3,10,0
66559,90,2308,1455,414,1257,16,76,112,1471,5,41,23,46,46,69,231,381,2,1069,59,0,2,0,27,0
66560,90,2308,669,365,481,22,61,110,691,15,103,63,122,118,185,747,1273,8,11311,628,0,2,0,27,0
66561,251,5838,4293,999,3693,19,54,507,4312,9,155,88,170,164,258,1156,1898,4,9368,520,0,2,1,5,0
66562,251,5838,1482,859,1002,125,135,219,1607,16,219,134,251,235,385,1766,3032,9,27804,1544,1,2,1,5,0
66563,117,3160,1523,757,1297,19,12,193,1542,12,193,117,230,205,347,1508,2664,7,19053,1058,0,2,0,4,0
66564,117,3160,701,378,504,33,58,109,734,13,110,68,126,123,194,794,1346,7,10027,557,0,2,0,4,0
66565,105,2779,773,422,505,30,103,129,803,14,77,46,83,91,129,535,839,7,6334,351,0,2,2,8,0
66566,149,3603,77,34,69,0,0,8,77,3,24,16,29,27,45,114,213,1,387,21,0,2,5,56,0
66567,149,3603,712,438,573,51,9,84,763,14,102,71,128,116,199,733,1364,8,11988,666,0,2,5,56,0
66568,71,1576,402,202,227,24,74,80,426,12,52,33,61,64,94,339,564,7,3969,220,0,2,2,2,0
66569,51,1113,447,308,343,6,5,95,453,7,96,59,111,103,170,651,1136,4,4600,255,0,2,2,14,0
66570,51,1113,322,174,179,16,74,51,338,10,41,26,46,51,72,252,408,5,2291,127,0,2,2,14,0
66571,15,490,184,100,137,2,15,30,186,6,38,20,39,44,59,214,322,3,991,55,0,2,3,12,0
66572,15,490,103,65,74,8,5,16,111,7,17,9,17,24,26,89,119,3,417,23,0,2,3,12,0
66573,58,1203,91,45,69,0,3,18,91,3,9,6,10,12,16,33,57,1,95,5,0,2,3,16,0
66574,58,1203,367,234,237,17,34,68,384,16,55,34,61,71,95,381,584,8,5183,287,0,2,3,16,0
66575,228,5903,722,423,573,19,0,135,741,12,172,101,199,184,300,1320,2257,6,15668,870,0,2,3,18,0
66576,228,5903,1508,847,911,44,250,301,1552,14,148,88,169,162,257,1120,1886,7,15077,837,0,2,3,18,0
66577,315,6914,72,33,56,0,4,12,72,1,1,1,1,2,2,0,2,0,1,0,0,2,2,3,0
66578,315,6914,1454,835,1044,76,110,219,1530,17,275,158,296,292,454,2297,3718,9,34017,1889,1,2,2,3,0
66579,89,1819,757,253,292,73,244,162,830,13,61,38,67,74,105,409,651,7,4654,258,0,2,4,15,0
66580,38,814,386,256,301,16,9,68,402,4,59,35,69,63,104,355,621,2,1453,80,0,2,1,34,0
66581,38,814,264,131,164,11,41,46,275,6,38,22,40,44,62,214,338,3,1068,59,0,2,1,34,0
66582,40,796,1178,367,1042,6,15,115,1184,9,94,51,95,103,146,644,976,4,4439,246,0,2,2,6,0
66583,40,796,177,108,140,8,0,27,185,6,30,16,32,36,48,162,248,3,794,44,0,2,2,6,0
66584,280,5888,1943,715,1694,26,18,214,1969,12,185,120,237,197,357,1436,2721,7,20915,1161,0,2,0,15,0
66585,280,5888,1168,838,957,57,25,144,1225,19,348,224,416,367,640,3018,5452,11,61921,3440,1,2,0,15,0
66586,19,717,442,244,305,14,16,103,456,11,68,45,75,79,120,452,756,6,4588,254,0,2,1,4,0
66587,19,717,182,102,99,11,40,35,193,3,11,6,11,14,17,42,64,1,97,5,0,2,1,4,0
66588,65,1263,1098,241,925,5,10,155,1103,7,46,25,49,53,74,273,423,3,1580,87,0,2,1,20,0
66589,65,1263,282,202,222,14,2,44,296,8,42,24,43,50,67,250,378,4,1548,86,0,2,1,20,0
66590,23,642,601,196,481,2,23,85,603,8,63,36,72,71,108,400,664,4,3036,168,0,2,1,22,0
66591,23,642,156,79,106,5,16,28,161,5,14,8,15,19,23,64,97,2,261,14,0,2,1,22,0
66592,104,4436,1289,550,1043,56,32,155,1345,10,167,93,185,177,278,1266,2075,5,11498,638,0,2,2,12,0
66593,31,994,182,127,129,0,0,53,182,5,39,21,42,44,63,217,343,2,926,51,0,2,6,27,0
66594,151,7251,1392,870,1177,35,17,170,1427,14,494,280,531,508,811,4473,7289,7,54850,3047,2,2,12,25,0
66595,95,2896,773,419,590,28,0,166,801,10,204,113,217,214,330,1598,2554,5,13587,754,0,2,1,3,0
66596,2,58,16,12,9,0,0,6,16,1,2,1,2,3,3,2,4,0,2,0,0,2,1,5,0
66597,65,4378,520,294,400,33,13,81,553,10,261,204,367,271,571,2128,4614,7,32445,1802,1,2,1,2,0
66598,90,3988,1338,495,1086,10,64,173,1348,11,122,82,157,133,239,883,1686,7,11934,663,0,2,0,2,0
66599,144,5933,1782,648,1425,9,47,279,1791,8,171,97,189,179,286,1292,2140,4,9462,525,0,2,0,2,0
66600,32,982,256,139,192,9,7,47,265,4,23,12,24,27,36,112,171,2,357,19,0,2,4,15,0
66601,19,517,102,59,69,5,3,24,107,6,22,15,28,28,43,113,206,3,789,43,0,2,1,13,0
66602,119,4920,1450,624,1228,12,26,181,1462,14,306,186,354,320,540,2580,4493,8,36391,2021,1,2,4,64,0
66603,176,5162,1660,832,1314,41,38,274,1701,20,312,209,395,332,604,2671,5058,12,64042,3557,1,2,7,91,0
66604,120,5123,1513,682,1277,25,13,200,1538,11,199,116,219,210,335,1557,2584,6,15641,868,0,2,7,66,0
66605,84,4916,1296,573,1062,40,33,157,1336,8,201,118,231,209,349,1561,2689,4,12365,686,0,2,0,2,0
66606,20,467,207,111,150,11,0,50,218,5,26,19,36,31,55,133,272,3,943,52,0,2,0,7,0
66607,98,5241,1457,730,1242,11,6,188,1468,10,292,166,329,302,495,2424,4078,5,22973,1276,1,2,0,3,0
66608,72,3266,1455,414,1257,16,76,112,1471,5,41,23,46,46,69,231,381,2,1069,59,0,2,3,7,0
66609,107,5160,1523,757,1297,19,12,193,1542,12,193,117,230,205,347,1508,2664,7,19053,1058,0,2,1,3,0
66610,70,3204,1020,354,843,12,15,144,1032,8,134,77,144,142,221,970,1580,4,6792,377,0,2,2,11,0
66611,44,2058,447,308,343,6,5,95,453,7,96,59,111,103,170,651,1136,4,4600,255,0,2,2,22,0
66612,9,444,184,100,137,2,15,30,186,6,38,20,39,44,59,214,322,3,991,55,0,2,4,14,0
66613,75,3960,1293,570,1093,25,15,163,1318,10,195,123,241,205,364,1516,2795,6,17273,959,0,2,5,19,0
66614,85,3387,1043,504,840,53,9,147,1096,9,180,112,198,189,310,1377,2344,4,11604,644,0,2,1,4,0
66615,79,3101,1178,367,1042,6,15,115,1184,9,94,51,95,103,146,644,976,4,4439,246,0,2,1,20,0
66616,35,1497,442,244,305,14,16,103,456,11,68,45,75,79,120,452,756,6,4588,254,0,2,0,3,0
66617,48,1943,1098,241,925,5,10,155,1103,7,46,25,49,53,74,273,423,3,1580,87,0,2,4,14,0
66618,48,1649,601,196,481,2,23,85,603,8,63,36,72,71,108,400,664,4,3036,168,0,2,0,95,0
66619,7,296,72,33,56,0,4,12,72,1,1,1,1,2,2,0,2,0,1,0,0,2,1,1,0
66621,105,2779,773,422,505,30,103,129,803,14,77,46,83,91,129,535,839,7,6334,351,0,2,1,1,0
66622,3,330,149,67,118,4,0,27,153,1,17,14,28,18,42,69,175,0,144,8,0,2,25,0,0
66632,1,323,382,65,130,157,2,92,539,4,10,5,10,14,15,41,57,2,114,6,0,2,0,1,0
66650,60,1163,282,196,195,3,0,86,285,8,130,71,141,138,212,936,1507,4,6538,363,0,2,0,1,0
66651,4,77,127,75,83,2,11,30,129,4,14,7,14,18,21,61,87,2,175,9,0,2,0,1,0
66652,4,77,652,304,544,16,6,88,668,6,89,51,101,95,152,591,998,3,3399,188,0,2,0,1,0
66653,4,77,2,2,2,0,0,0,2,0,0,0,0,0,0,0,0,0,0,0,0,2,0,1,0
66654,4,77,8,5,5,0,0,3,8,0,0,0,0,0,0,0,0,0,0,0,0,2,0,1,0
66657,4,77,14,8,8,0,0,6,14,0,0,0,0,0,0,0,0,0,0,0,0,2,0,1,0
66658,4,77,6,4,4,0,0,2,6,0,0,0,0,0,0,0,0,0,0,0,0,2,0,1,0
66659,4,77,6,4,4,0,0,2,6,1,2,1,2,3,3,2,4,0,2,0,0,2,0,1,0
66661,4,77,7,5,5,0,0,2,7,0,0,0,0,0,0,0,0,0,0,0,0,2,0,1,0
66663,4,77,10,6,6,0,0,4,10,0,0,0,0,0,0,0,0,0,0,0,0,2,0,1,0
66664,4,77,1,1,1,0,0,0,1,0,0,0,0,0,0,0,0,0,0,0,0,2,0,1,0
66666,4,77,14,10,10,0,0,4,14,1,1,1,1,2,2,0,2,0,1,0,0,2,0,1,0
66667,4,77,46,26,30,3,0,12,49,3,6,3,6,9,9,20,28,1,42,2,0,2,0,1,0
66751,7,296,72,33,56,0,4,12,72,1,1,1,1,2,2,0,2,0,1,0,0,2,0,1,0
66787,7,103,38,23,23,0,0,15,38,0,0,0,0,0,0,0,0,0,0,0,0,2,0,1,0
66788,17,378,85,59,61,8,0,16,93,5,18,10,18,23,28,86,126,2,316,17,0,2,0,1,0
66791,12,515,124,78,88,2,3,26,126,4,13,7,13,17,20,56,81,2,163,9,0,2,0,1,0
66792,1,94,42,7,35,4,0,5,46,1,2,1,2,3,3,2,4,0,2,0,0,2,0,1,0
66793,1,94,11,6,10,0,0,1,11,2,4,2,4,6,6,10,15,1,15,0,0,2,0,1,0
66817,11,242,19,8,11,5,0,4,24,2,5,3,6,7,9,13,25,1,30,1,0,2,0,1,0
66818,11,242,102,59,69,5,3,24,107,6,22,15,28,28,43,113,206,3,789,43,0,2,0,1,0
66819,11,242,106,40,36,3,49,17,109,8,17,13,23,25,36,93,167,5,904,50,0,2,0,1,0
66843,221,4758,182,127,129,0,0,53,182,5,39,21,42,44,63,217,343,2,926,51,0,2,0,1,0
66844,221,4758,1165,710,800,67,119,181,1232,18,243,153,282,261,435,2000,3492,10,36473,2026,1,2,0,1,0
66845,67,1570,773,419,590,28,0,166,801,10,204,113,217,214,330,1598,2554,5,13587,754,0,2,0,1,0
66846,67,1570,421,273,302,44,34,57,465,17,81,59,107,98,166,583,1098,11,12329,684,0,2,0,1,0
66847,14,411,149,95,105,2,0,41,151,8,54,28,55,62,83,334,494,4,2013,111,0,2,0,1,0
66848,14,411,82,56,54,0,13,15,82,4,13,8,16,17,24,56,98,2,241,13,0,2,0,1,0
66851,25,514,2,2,2,0,0,0,2,0,0,0,0,0,0,0,0,0,0,0,0,2,0,1,0
66865,25,514,99,48,90,1,3,5,100,0,0,0,0,0,0,0,0,0,0,0,0,2,0,1,0
66866,25,514,8,5,5,2,0,1,10,0,0,0,0,0,0,0,0,0,0,0,0,2,0,1,0
66867,25,514,1217,716,841,84,126,174,1301,14,185,118,215,199,333,1446,2542,8,20687,1149,0,2,0,1,0
66868,25,514,160,89,115,0,13,31,160,7,15,11,17,22,28,78,124,3,495,27,0,2,0,1,0
66869,25,514,10,10,9,9,0,0,19,0,0,0,0,0,0,0,0,0,0,0,0,2,0,1,0
66870,25,514,173,84,99,8,29,36,181,5,12,7,13,17,20,54,81,2,221,12,0,2,0,1,0
66871,25,514,3,1,1,3,0,0,6,0,0,0,0,0,0,0,0,0,0,0,0,2,0,1,0
66872,174,5298,1660,832,1314,41,38,274,1701,20,312,209,395,332,604,2671,5058,12,64042,3557,1,2,0,1,0
66873,174,5298,1057,646,719,113,100,145,1170,18,215,134,248,233,382,1740,3004,10,31186,1732,1,2,0,1,0
66875,116,2173,477,336,357,30,23,73,507,16,194,134,250,210,384,1538,2962,10,30538,1696,0,2,0,1,0
66876,90,2044,996,429,845,24,10,117,1020,7,76,50,88,83,138,494,879,4,3565,198,0,2,0,1,0
66877,90,2044,456,277,329,12,42,72,468,13,85,50,97,98,147,592,972,7,7212,400,0,2,0,1,0
66878,160,3459,1513,682,1277,25,13,200,1538,11,199,116,219,210,335,1557,2584,6,15641,868,0,2,0,1,0
66879,160,3459,819,519,539,24,98,155,843,15,96,57,106,111,163,690,1107,8,9171,509,0,2,0,1,0
66880,59,1120,207,111,150,11,0,50,218,5,26,19,36,31,55,133,272,3,943,52,0,2,0,1,0
66881,59,1120,410,198,237,31,55,97,441,11,63,38,72,74,110,414,683,6,4293,238,0,2,0,1,0
66884,235,4913,2,2,2,0,0,0,2,0,0,0,0,0,0,0,0,0,0,0,0,2,0,1,0
66898,235,4913,99,48,90,1,3,5,100,0,0,0,0,0,0,0,0,0,0,0,0,2,0,1,0
66899,235,4913,8,5,5,2,0,1,10,0,0,0,0,0,0,0,0,0,0,0,0,2,0,1,0
66900,235,4913,1217,716,841,84,126,174,1301,14,185,118,215,199,333,1446,2542,8,20687,1149,0,2,0,1,0
66901,235,4913,160,89,115,0,13,31,160,7,15,11,17,22,28,78,124,3,495,27,0,2,0,1,0
66902,235,4913,10,10,9,9,0,0,19,0,0,0,0,0,0,0,0,0,0,0,0,2,0,1,0
66903,235,4913,173,84,99,8,29,36,181,5,12,7,13,17,20,54,81,2,221,12,0,2,0,1,0
66904,235,4913,3,1,1,3,0,0,6,0,0,0,0,0,0,0,0,0,0,0,0,2,0,1,0
66905,98,2019,463,295,324,28,62,57,491,12,134,82,154,146,236,989,1696,6,11700,650,0,2,0,1,0
66907,55,770,167,116,138,4,5,22,171,8,48,30,56,56,86,292,499,4,2330,129,0,2,0,1,0
66908,57,1522,339,213,244,17,9,65,356,10,42,26,48,52,74,259,421,5,2410,133,0,2,0,1,0
66910,90,2308,1455,414,1257,16,76,112,1471,5,41,23,46,46,69,231,381,2,1069,59,0,2,0,1,0
66911,90,2308,669,365,481,22,61,110,691,15,103,63,122,118,185,747,1273,8,11311,628,0,2,0,1,0
66912,251,5838,4293,999,3693,19,54,507,4312,9,155,88,170,164,258,1156,1898,4,9368,520,0,2,0,1,0
66913,251,5838,1482,859,1002,125,135,219,1607,16,219,134,251,235,385,1766,3032,9,27804,1544,1,2,0,1,0
66914,6,140,44,22,19,0,19,6,44,2,10,6,12,12,18,35,64,1,77,4,0,2,0,1,0
66915,31,1087,74,35,59,1,0,14,75,3,14,7,14,17,21,58,85,1,128,7,0,2,0,1,0
66916,31,1087,245,125,200,5,7,34,250,7,30,17,34,37,51,166,265,3,1053,58,0,2,0,1,0
66917,54,657,647,139,84,35,284,233,682,0,0,0,0,0,0,0,0,0,0,0,0,2,0,1,0
66918,117,3160,1523,757,1297,19,12,193,1542,12,193,117,230,205,347,1508,2664,7,19053,1058,0,2,0,1,0
66919,117,3160,701,378,504,33,58,109,734,13,110,68,126,123,194,794,1346,7,10027,557,0,2,0,1,0
66920,105,2779,773,422,505,30,103,129,803,14,77,46,83,91,129,535,839,7,6334,351,0,2,0,1,0
66921,149,3603,77,34,69,0,0,8,77,3,24,16,29,27,45,114,213,1,387,21,0,2,0,1,0
66922,149,3603,712,438,573,51,9,84,763,14,102,71,128,116,199,733,1364,8,11988,666,0,2,0,1,0
66925,24,612,2,2,2,0,0,0,2,0,0,0,0,0,0,0,0,0,0,0,0,2,0,1,0
66939,24,612,99,48,90,1,3,5,100,0,0,0,0,0,0,0,0,0,0,0,0,2,0,1,0
66940,24,612,8,5,5,2,0,1,10,0,0,0,0,0,0,0,0,0,0,0,0,2,0,1,0
66941,24,612,1217,716,841,84,126,174,1301,14,185,118,215,199,333,1446,2542,8,20687,1149,0,2,0,1,0
66942,24,612,160,89,115,0,13,31,160,7,15,11,17,22,28,78,124,3,495,27,0,2,0,1,0
66943,24,612,10,10,9,9,0,0,19,0,0,0,0,0,0,0,0,0,0,0,0,2,0,1,0
66944,24,612,173,84,99,8,29,36,181,5,12,7,13,17,20,54,81,2,221,12,0,2,0,1,0
66945,24,612,3,1,1,3,0,0,6,0,0,0,0,0,0,0,0,0,0,0,0,2,0,1,0
66946,30,664,125,97,103,3,0,19,128,9,25,17,27,34,44,144,223,4,1087,60,0,2,0,1,0
66947,22,373,102,57,55,5,16,25,107,5,17,10,18,22,28,81,124,2,330,18,0,2,0,1,0
66948,71,1576,402,202,227,24,74,80,426,12,52,33,61,64,94,339,564,7,3969,220,0,2,0,1,0
66949,51,1113,447,308,343,6,5,95,453,7,96,59,111,103,170,651,1136,4,4600,255,0,2,0,1,0
66950,51,1113,322,174,179,16,74,51,338,10,41,26,46,51,72,252,408,5,2291,127,0,2,0,1,0
66951,75,1629,53,23,39,0,0,13,53,2,8,4,8,10,12,26,39,1,39,2,0,2,0,1,0
66952,75,1629,515,298,307,33,80,99,548,12,63,44,77,75,121,419,753,7,5527,307,0,2,0,1,0
66953,18,312,424,94,331,4,0,89,428,1,5,5,5,6,10,11,25,0,12,0,0,2,0,1,0
66954,18,312,38,23,23,6,0,8,44,3,11,7,11,14,18,42,68,1,102,5,0,2,0,1,0
66955,19,513,205,80,86,16,53,53,221,7,18,10,19,25,29,94,134,3,497,27,0,2,0,1,0
66956,15,490,184,100,137,2,15,30,186,6,38,20,39,44,59,214,322,3,991,55,0,2,0,1,0
66957,15,490,103,65,74,8,5,16,111,7,17,9,17,24,26,89,119,3,417,23,0,2,0,1,0
66958,58,1203,91,45,69,0,3,18,91,3,9,6,10,12,16,33,57,1,95,5,0,2,0,1,0
66959,58,1203,367,234,237,17,34,68,384,16,55,34,61,71,95,381,584,8,5183,287,0,2,0,1,0
66960,228,5903,722,423,573,19,0,135,741,12,172,101,199,184,300,1320,2257,6,15668,870,0,2,0,1,0
66961,228,5903,1508,847,911,44,250,301,1552,14,148,88,169,162,257,1120,1886,7,15077,837,0,2,0,1,0
66962,315,6914,72,33,56,0,4,12,72,1,1,1,1,2,2,0,2,0,1,0,0,2,0,1,0
66963,315,6914,1454,835,1044,76,110,219,1530,17,275,158,296,292,454,2297,3718,9,34017,1889,1,2,0,1,0
66964,89,1819,757,253,292,73,244,162,830,13,61,38,67,74,105,409,651,7,4654,258,0,2,0,1,0
66965,38,814,386,256,301,16,9,68,402,4,59,35,69,63,104,355,621,2,1453,80,0,2,0,1,0
66966,38,814,264,131,164,11,41,46,275,6,38,22,40,44,62,214,338,3,1068,59,0,2,0,1,0
66967,67,1753,466,257,367,18,25,50,484,7,126,86,171,133,257,898,1813,4,8612,478,0,2,0,1,0
66968,67,1753,507,281,342,29,59,88,536,10,53,29,57,63,86,336,514,5,2764,153,0,2,0,1,0
66969,25,552,215,129,180,6,0,29,221,8,65,43,72,73,115,415,711,4,3153,175,0,2,0,1,0
66970,25,552,97,69,77,3,3,16,100,6,22,13,23,28,36,113,173,3,542,30,0,2,0,1,0
66971,89,1894,1043,504,840,53,9,147,1096,9,180,112,198,189,310,1377,2344,4,11604,644,0,2,0,1,0
66972,89,1894,383,288,292,26,6,62,409,11,65,38,67,76,105,429,656,5,3719,206,0,2,0,1,0
66973,20,420,294,64,250,0,0,43,294,1,20,10,20,21,30,86,131,0,65,3,0,2,0,1,0
66974,20,420,78,46,62,3,0,14,81,3,8,4,8,11,12,28,41,1,62,3,0,2,0,1,0
66975,5,123,110,30,77,3,13,16,113,4,21,15,30,25,45,100,208,2,597,33,0,2,0,1,0
66976,5,123,28,15,21,1,0,6,29,0,0,0,0,0,0,0,0,0,0,0,0,2,0,1,0
66977,40,796,1178,367,1042,6,15,115,1184,9,94,51,95,103,146,644,976,4,4439,246,0,2,0,1,0
66978,40,796,177,108,140,8,0,27,185,6,30,16,32,36,48,162,248,3,794,44,0,2,0,1,0
66979,28,452,219,78,157,11,5,46,230,3,24,20,34,27,54,114,256,2,545,30,0,2,0,1,0
66980,28,452,108,64,79,9,0,20,117,5,15,11,19,20,30,70,129,3,410,22,0,2,0,1,0
66981,280,5888,1943,715,1694,26,18,214,1969,12,185,120,237,197,357,1436,2721,7,20915,1161,0,2,0,1,0
66982,280,5888,1168,838,957,57,25,144,1225,19,348,224,416,367,640,3018,5452,11,61921,3440,1,2,0,1,0
66983,19,717,442,244,305,14,16,103,456,11,68,45,75,79,120,452,756,6,4588,254,0,2,0,1,0
66984,19,717,182,102,99,11,40,35,193,3,11,6,11,14,17,42,64,1,97,5,0,2,0,1,0
66985,65,1263,1098,241,925,5,10,155,1103,7,46,25,49,53,74,273,423,3,1580,87,0,2,0,1,0
66986,65,1263,282,202,222,14,2,44,296,8,42,24,43,50,67,250,378,4,1548,86,0,2,0,1,0
66987,2,156,37,13,25,0,6,6,37,1,2,1,2,3,3,2,4,0,2,0,0,2,0,1,0
66988,2,156,133,47,40,1,43,49,134,0,0,0,0,0,0,0,0,0,0,0,0,2,0,1,0
66989,23,642,601,196,481,2,23,85,603,8,63,36,72,71,108,400,664,4,3036,168,0,2,0,1,0
66990,23,642,156,79,106,5,16,28,161,5,14,8,15,19,23,64,97,2,261,14,0,2,0,1,0
66991,104,4436,1289,550,1043,56,32,155,1345,10,167,93,185,177,278,1266,2075,5,11498,638,0,2,0,1,0
66992,31,994,182,127,129,0,0,53,182,5,39,21,42,44,63,217,343,2,926,51,0,2,0,1,0
66993,151,7251,1392,870,1177,35,17,170,1427,14,494,280,531,508,811,4473,7289,7,54850,3047,2,2,0,1,0
66994,95,2896,773,419,590,28,0,166,801,10,204,113,217,214,330,1598,2554,5,13587,754,0,2,0,1,0
66995,6,163,127,75,83,2,11,30,129,4,14,7,14,18,21,61,87,2,175,9,0,2,0,1,0
66996,6,163,652,304,544,16,6,88,668,6,89,51,101,95,152,591,998,3,3399,188,0,2,0,1,0
66997,6,163,2,2,2,0,0,0,2,0,0,0,0,0,0,0,0,0,0,0,0,2,0,1,0
66998,6,163,8,5,5,0,0,3,8,0,0,0,0,0,0,0,0,0,0,0,0,2,0,1,0
67001,6,163,14,8,8,0,0,6,14,0,0,0,0,0,0,0,0,0,0,0,0,2,0,1,0
67002,6,163,6,4,4,0,0,2,6,0,0,0,0,0,0,0,0,0,0,0,0,2,0,1,0
67003,6,163,6,4,4,0,0,2,6,1,2,1,2,3,3,2,4,0,2,0,0,2,0,1,0
67005,6,163,7,5,5,0,0,2,7,0,0,0,0,0,0,0,0,0,0,0,0,2,0,1,0
67007,6,163,10,6,6,0,0,4,10,0,0,0,0,0,0,0,0,0,0,0,0,2,0,1,0
67008,6,163,1,1,1,0,0,0,1,0,0,0,0,0,0,0,0,0,0,0,0,2,0,1,0
67010,6,163,14,10,10,0,0,4,14,1,1,1,1,2,2,0,2,0,1,0,0,2,0,1,0
67011,6,163,46,26,30,3,0,12,49,3,6,3,6,9,9,20,28,1,42,2,0,2,0,1,0
67012,14,845,75,38,59,1,3,12,76,2,4,2,4,6,6,10,15,1,15,0,0,2,0,1,0
67013,2,58,16,12,9,0,0,6,16,1,2,1,2,3,3,2,4,0,2,0,0,2,0,1,0
67016,1,6,2,2,2,0,0,0,2,0,0,0,0,0,0,0,0,0,0,0,0,2,0,1,0
67030,1,6,99,48,90,1,3,5,100,0,0,0,0,0,0,0,0,0,0,0,0,2,0,1,0
67031,1,6,8,5,5,2,0,1,10,0,0,0,0,0,0,0,0,0,0,0,0,2,0,1,0
67032,1,6,1217,716,841,84,126,174,1301,14,185,118,215,199,333,1446,2542,8,20687,1149,0,2,0,1,0
67033,1,6,160,89,115,0,13,31,160,7,15,11,17,22,28,78,124,3,495,27,0,2,0,1,0
67034,1,6,10,10,9,9,0,0,19,0,0,0,0,0,0,0,0,0,0,0,0,2,0,1,0
67035,1,6,173,84,99,8,29,36,181,5,12,7,13,17,20,54,81,2,221,12,0,2,0,1,0
67036,1,6,3,1,1,3,0,0,6,0,0,0,0,0,0,0,0,0,0,0,0,2,0,1,0
67041,1,8,127,75,83,2,11,30,129,4,14,7,14,18,21,61,87,2,175,9,0,2,0,1,0
67042,1,8,652,304,544,16,6,88,668,6,89,51,101,95,152,591,998,3,3399,188,0,2,0,1,0
67043,1,8,2,2,2,0,0,0,2,0,0,0,0,0,0,0,0,0,0,0,0,2,0,1,0
67044,1,8,8,5,5,0,0,3,8,0,0,0,0,0,0,0,0,0,0,0,0,2,0,1,0
67047,1,8,14,8,8,0,0,6,14,0,0,0,0,0,0,0,0,0,0,0,0,2,0,1,0
67048,1,8,6,4,4,0,0,2,6,0,0,0,0,0,0,0,0,0,0,0,0,2,0,1,0
67049,1,8,6,4,4,0,0,2,6,1,2,1,2,3,3,2,4,0,2,0,0,2,0,1,0
67051,1,8,7,5,5,0,0,2,7,0,0,0,0,0,0,0,0,0,0,0,0,2,0,1,0
67053,1,8,10,6,6,0,0,4,10,0,0,0,0,0,0,0,0,0,0,0,0,2,0,1,0
67054,1,8,1,1,1,0,0,0,1,0,0,0,0,0,0,0,0,0,0,0,0,2,0,1,0
67056,1,8,14,10,10,0,0,4,14,1,1,1,1,2,2,0,2,0,1,0,0,2,0,1,0
67057,1,8,46,26,30,3,0,12,49,3,6,3,6,9,9,20,28,1,42,2,0,2,0,1,0
67084,2,25,127,75,83,2,11,30,129,4,14,7,14,18,21,61,87,2,175,9,0,2,0,1,0
67085,2,25,652,304,544,16,6,88,668,6,89,51,101,95,152,591,998,3,3399,188,0,2,0,1,0
67086,2,25,2,2,2,0,0,0,2,0,0,0,0,0,0,0,0,0,0,0,0,2,0,1,0
67087,2,25,8,5,5,0,0,3,8,0,0,0,0,0,0,0,0,0,0,0,0,2,0,1,0
67090,2,25,14,8,8,0,0,6,14,0,0,0,0,0,0,0,0,0,0,0,0,2,0,1,0
67091,2,25,6,4,4,0,0,2,6,0,0,0,0,0,0,0,0,0,0,0,0,2,0,1,0
67092,2,25,6,4,4,0,0,2,6,1,2,1,2,3,3,2,4,0,2,0,0,2,0,1,0
67094,2,25,7,5,5,0,0,2,7,0,0,0,0,0,0,0,0,0,0,0,0,2,0,1,0
67096,2,25,10,6,6,0,0,4,10,0,0,0,0,0,0,0,0,0,0,0,0,2,0,1,0
67097,2,25,1,1,1,0,0,0,1,0,0,0,0,0,0,0,0,0,0,0,0,2,0,1,0
67099,2,25,14,10,10,0,0,4,14,1,1,1,1,2,2,0,2,0,1,0,0,2,0,1,0
67100,2,25,46,26,30,3,0,12,49,3,6,3,6,9,9,20,28,1,42,2,0,2,0,1,0
67101,1,55,14,12,10,0,0,4,14,1,2,1,2,3,3,2,4,0,2,0,0,2,0,1,0
67102,1,58,14,12,10,0,0,4,14,1,2,1,2,3,3,2,4,0,2,0,0,2,0,1,0
67104,1,77,19,18,14,0,0,5,19,1,2,1,2,3,3,2,4,0,2,0,0,2,0,1,0
67105,2,18,10,6,6,0,0,4,10,0,0,0,0,0,0,0,0,0,0,0,0,2,0,1,0
67106,2,36,127,75,83,2,11,30,129,4,14,7,14,18,21,61,87,2,175,9,0,2,0,1,0
67107,2,36,652,304,544,16,6,88,668,6,89,51,101,95,152,591,998,3,3399,188,0,2,0,1,0
67108,2,36,2,2,2,0,0,0,2,0,0,0,0,0,0,0,0,0,0,0,0,2,0,1,0
67109,2,36,8,5,5,0,0,3,8,0,0,0,0,0,0,0,0,0,0,0,0,2,0,1,0
67112,2,36,14,8,8,0,0,6,14,0,0,0,0,0,0,0,0,0,0,0,0,2,0,1,0
67113,2,36,6,4,4,0,0,2,6,0,0,0,0,0,0,0,0,0,0,0,0,2,0,1,0
67114,2,36,6,4,4,0,0,2,6,1,2,1,2,3,3,2,4,0,2,0,0,2,0,1,0
67116,2,36,7,5,5,0,0,2,7,0,0,0,0,0,0,0,0,0,0,0,0,2,0,1,0
67118,2,36,10,6,6,0,0,4,10,0,0,0,0,0,0,0,0,0,0,0,0,2,0,1,0
67119,2,36,1,1,1,0,0,0,1,0,0,0,0,0,0,0,0,0,0,0,0,2,0,1,0
67121,2,36,14,10,10,0,0,4,14,1,1,1,1,2,2,0,2,0,1,0,0,2,0,1,0
67122,2,36,46,26,30,3,0,12,49,3,6,3,6,9,9,20,28,1,42,2,0,2,0,1,0
67127,1,26,127,75,83,2,11,30,129,4,14,7,14,18,21,61,87,2,175,9,0,2,0,1,0
67128,1,26,652,304,544,16,6,88,668,6,89,51,101,95,152,591,998,3,3399,188,0,2,0,1,0
67129,1,26,2,2,2,0,0,0,2,0,0,0,0,0,0,0,0,0,0,0,0,2,0,1,0
67130,1,26,8,5,5,0,0,3,8,0,0,0,0,0,0,0,0,0,0,0,0,2,0,1,0
67133,1,26,14,8,8,0,0,6,14,0,0,0,0,0,0,0,0,0,0,0,0,2,0,1,0
67134,1,26,6,4,4,0,0,2,6,0,0,0,0,0,0,0,0,0,0,0,0,2,0,1,0
67135,1,26,6,4,4,0,0,2,6,1,2,1,2,3,3,2,4,0,2,0,0,2,0,1,0
67137,1,26,7,5,5,0,0,2,7,0,0,0,0,0,0,0,0,0,0,0,0,2,0,1,0
67139,1,26,10,6,6,0,0,4,10,0,0,0,0,0,0,0,0,0,0,0,0,2,0,1,0
67140,1,26,1,1,1,0,0,0,1,0,0,0,0,0,0,0,0,0,0,0,0,2,0,1,0
67142,1,26,14,10,10,0,0,4,14,1,1,1,1,2,2,0,2,0,1,0,0,2,0,1,0
67143,1,26,46,26,30,3,0,12,49,3,6,3,6,9,9,20,28,1,42,2,0,2,0,1,0
67144,1,7,2,2,2,0,0,0,2,0,0,0,0,0,0,0,0,0,0,0,0,2,0,1,0
67145,1,24,127,75,83,2,11,30,129,4,14,7,14,18,21,61,87,2,175,9,0,2,0,1,0
67146,1,24,652,304,544,16,6,88,668,6,89,51,101,95,152,591,998,3,3399,188,0,2,0,1,0
67147,1,24,2,2,2,0,0,0,2,0,0,0,0,0,0,0,0,0,0,0,0,2,0,1,0
67148,1,24,8,5,5,0,0,3,8,0,0,0,0,0,0,0,0,0,0,0,0,2,0,1,0
67151,1,24,14,8,8,0,0,6,14,0,0,0,0,0,0,0,0,0,0,0,0,2,0,1,0
67152,1,24,6,4,4,0,0,2,6,0,0,0,0,0,0,0,0,0,0,0,0,2,0,1,0
67153,1,24,6,4,4,0,0,2,6,1,2,1,2,3,3,2,4,0,2,0,0,2,0,1,0
67155,1,24,7,5,5,0,0,2,7,0,0,0,0,0,0,0,0,0,0,0,0,2,0,1,0
67157,1,24,10,6,6,0,0,4,10,0,0,0,0,0,0,0,0,0,0,0,0,2,0,1,0
67158,1,24,1,1,1,0,0,0,1,0,0,0,0,0,0,0,0,0,0,0,0,2,0,1,0
67160,1,24,14,10,10,0,0,4,14,1,1,1,1,2,2,0,2,0,1,0,0,2,0,1,0
67161,1,24,46,26,30,3,0,12,49,3,6,3,6,9,9,20,28,1,42,2,0,2,0,1,0
67163,3,33,15,9,9,0,0,6,15,0,0,0,0,0,0,0,0,0,0,0,0,2,0,1,0
67164,1,13,127,75,83,2,11,30,129,4,14,7,14,18,21,61,87,2,175,9,0,2,0,1,0
67165,1,13,652,304,544,16,6,88,668,6,89,51,101,95,152,591,998,3,3399,188,0,2,0,1,0
67166,1,13,2,2,2,0,0,0,2,0,0,0,0,0,0,0,0,0,0,0,0,2,0,1,0
67167,1,13,8,5,5,0,0,3,8,0,0,0,0,0,0,0,0,0,0,0,0,2,0,1,0
67170,1,13,14,8,8,0,0,6,14,0,0,0,0,0,0,0,0,0,0,0,0,2,0,1,0
67171,1,13,6,4,4,0,0,2,6,0,0,0,0,0,0,0,0,0,0,0,0,2,0,1,0
67172,1,13,6,4,4,0,0,2,6,1,2,1,2,3,3,2,4,0,2,0,0,2,0,1,0
67174,1,13,7,5,5,0,0,2,7,0,0,0,0,0,0,0,0,0,0,0,0,2,0,1,0
67176,1,13,10,6,6,0,0,4,10,0,0,0,0,0,0,0,0,0,0,0,0,2,0,1,0
67177,1,13,1,1,1,0,0,0,1,0,0,0,0,0,0,0,0,0,0,0,0,2,0,1,0
67179,1,13,14,10,10,0,0,4,14,1,1,1,1,2,2,0,2,0,1,0,0,2,0,1,0
67180,1,13,46,26,30,3,0,12,49,3,6,3,6,9,9,20,28,1,42,2,0,2,0,1,0
67181,1,16,127,75,83,2,11,30,129,4,14,7,14,18,21,61,87,2,175,9,0,2,0,1,0
67182,1,16,652,304,544,16,6,88,668,6,89,51,101,95,152,591,998,3,3399,188,0,2,0,1,0
67183,1,16,2,2,2,0,0,0,2,0,0,0,0,0,0,0,0,0,0,0,0,2,0,1,0
67184,1,16,8,5,5,0,0,3,8,0,0,0,0,0,0,0,0,0,0,0,0,2,0,1,0
67187,1,16,14,8,8,0,0,6,14,0,0,0,0,0,0,0,0,0,0,0,0,2,0,1,0
67188,1,16,6,4,4,0,0,2,6,0,0,0,0,0,0,0,0,0,0,0,0,2,0,1,0
67189,1,16,6,4,4,0,0,2,6,1,2,1,2,3,3,2,4,0,2,0,0,2,0,1,0
67191,1,16,7,5,5,0,0,2,7,0,0,0,0,0,0,0,0,0,0,0,0,2,0,1,0
67193,1,16,10,6,6,0,0,4,10,0,0,0,0,0,0,0,0,0,0,0,0,2,0,1,0
67194,1,16,1,1,1,0,0,0,1,0,0,0,0,0,0,0,0,0,0,0,0,2,0,1,0
67196,1,16,14,10,10,0,0,4,14,1,1,1,1,2,2,0,2,0,1,0,0,2,0,1,0
67197,1,16,46,26,30,3,0,12,49,3,6,3,6,9,9,20,28,1,42,2,0,2,0,1,0
67198,1,10,2,2,2,0,0,0,2,1,2,1,2,3,3,2,4,0,2,0,0,2,0,1,0
67216,2,26,10,6,6,0,0,4,10,2,4,2,4,6,6,10,15,1,15,0,0,2,0,1,0
67217,3,47,15,10,10,0,0,5,15,2,4,2,4,6,6,10,15,1,15,0,0,2,0,1,0
67220,3,46,15,9,9,0,0,6,15,1,4,2,4,5,6,8,13,0,6,0,0,2,0,1,0
67221,2,21,10,6,6,0,0,4,10,0,0,0,0,0,0,0,0,0,0,0,0,2,0,1,0
67222,4,61,20,12,12,0,0,8,20,1,2,1,2,3,3,2,4,0,2,0,0,2,0,1,0
67223,2,51,127,75,83,2,11,30,129,4,14,7,14,18,21,61,87,2,175,9,0,2,0,1,0
67224,2,51,652,304,544,16,6,88,668,6,89,51,101,95,152,591,998,3,3399,188,0,2,0,1,0
67225,2,51,2,2,2,0,0,0,2,0,0,0,0,0,0,0,0,0,0,0,0,2,0,1,0
67226,2,51,8,5,5,0,0,3,8,0,0,0,0,0,0,0,0,0,0,0,0,2,0,1,0
67229,2,51,14,8,8,0,0,6,14,0,0,0,0,0,0,0,0,0,0,0,0,2,0,1,0
67230,2,51,6,4,4,0,0,2,6,0,0,0,0,0,0,0,0,0,0,0,0,2,0,1,0
67231,2,51,6,4,4,0,0,2,6,1,2,1,2,3,3,2,4,0,2,0,0,2,0,1,0
67233,2,51,7,5,5,0,0,2,7,0,0,0,0,0,0,0,0,0,0,0,0,2,0,1,0
67235,2,51,10,6,6,0,0,4,10,0,0,0,0,0,0,0,0,0,0,0,0,2,0,1,0
67236,2,51,1,1,1,0,0,0,1,0,0,0,0,0,0,0,0,0,0,0,0,2,0,1,0
67238,2,51,14,10,10,0,0,4,14,1,1,1,1,2,2,0,2,0,1,0,0,2,0,1,0
67239,2,51,46,26,30,3,0,12,49,3,6,3,6,9,9,20,28,1,42,2,0,2,0,1,0
67242,1,14,6,4,4,0,0,2,6,0,0,0,0,0,0,0,0,0,0,0,0,2,0,1,0
67245,1,41,7,5,5,0,0,2,7,1,2,1,2,3,3,2,4,0,2,0,0,2,0,1,0
67246,2,51,14,9,9,0,0,5,14,0,0,0,0,0,0,0,0,0,0,0,0,2,0,1,0
67248,2,42,14,10,9,0,0,4,14,0,0,0,0,0,0,0,0,0,0,0,0,2,0,1,0
67249,2,33,12,8,7,0,0,4,12,0,0,0,0,0,0,0,0,0,0,0,0,2,0,1,0
67250,3,49,16,9,9,0,0,7,16,0,0,0,0,0,0,0,0,0,0,0,0,2,0,1,0
67251,1,18,3,3,3,0,0,0,3,0,0,0,0,0,0,0,0,0,0,0,0,2,0,1,0
67254,2,26,6,4,4,0,0,2,6,1,4,2,4,5,6,8,13,0,6,0,0,2,0,1,0
67256,12,318,149,95,105,2,0,41,151,8,54,28,55,62,83,334,494,4,2013,111,0,2,0,1,0
67257,15,703,139,89,101,2,0,35,141,7,54,34,62,61,96,330,569,4,2287,127,0,2,0,1,0
67258,3,330,149,67,118,4,0,27,153,1,17,14,28,18,42,69,175,0,144,8,0,2,0,1,0
67259,38,2498,1157,318,931,29,22,177,1186,6,104,63,125,110,188,712,1274,3,4596,255,0,2,0,1,0
67260,65,4378,520,294,400,33,13,81,553,10,261,204,367,271,571,2128,4614,7,32445,1802,1,2,0,1,0
67261,90,3988,1338,495,1086,10,64,173,1348,11,122,82,157,133,239,883,1686,7,11934,663,0,2,0,1,0
67262,172,7635,4293,999,3693,19,54,507,4312,9,155,88,170,164,258,1156,1898,4,9368,520,0,2,0,1,0
67263,172,7635,1482,859,1002,125,135,219,1607,16,219,134,251,235,385,1766,3032,9,27804,1544,1,2,0,1,0
67264,33,999,465,148,393,5,8,60,470,4,31,20,31,35,51,161,261,2,523,29,0,2,0,1,0
67265,33,999,16,12,9,0,0,6,16,1,2,1,2,3,3,2,4,0,2,0,0,2,0,1,0
67266,144,5933,1782,648,1425,9,47,279,1791,8,171,97,189,179,286,1292,2140,4,9462,525,0,2,0,1,0
67267,32,982,256,139,192,9,7,47,265,4,23,12,24,27,36,112,171,2,357,19,0,2,0,1,0
67268,6,328,180,34,164,0,0,16,180,1,12,6,12,13,18,43,66,0,33,1,0,2,0,1,0
67269,19,517,102,59,69,5,3,24,107,6,22,15,28,28,43,113,206,3,789,43,0,2,0,1,0
67270,119,4920,1450,624,1228,12,26,181,1462,14,306,186,354,320,540,2580,4493,8,36391,2021,1,2,0,1,0
67271,176,5162,1660,832,1314,41,38,274,1701,20,312,209,395,332,604,2671,5058,12,64042,3557,1,2,0,1,0
67272,49,3805,996,429,845,24,10,117,1020,7,76,50,88,83,138,494,879,4,3565,198,0,2,0,1,0
67273,120,5123,1513,682,1277,25,13,200,1538,11,199,116,219,210,335,1557,2584,6,15641,868,0,2,0,1,0
67274,84,4916,1296,573,1062,40,33,157,1336,8,201,118,231,209,349,1561,2689,4,12365,686,0,2,0,1,0
67275,20,467,207,111,150,11,0,50,218,5,26,19,36,31,55,133,272,3,943,52,0,2,0,1,0
67276,98,5241,1457,730,1242,11,6,188,1468,10,292,166,329,302,495,2424,4078,5,22973,1276,1,2,0,1,0
67277,43,2690,652,304,544,16,6,88,668,6,89,51,101,95,152,591,998,3,3399,188,0,2,0,1,0
67278,72,3266,1455,414,1257,16,76,112,1471,5,41,23,46,46,69,231,381,2,1069,59,0,2,0,1,0
67279,2,56,7,6,5,0,0,2,7,1,1,1,2,2,3,0,3,1,3,0,0,2,0,1,0
67280,8,275,74,35,59,1,0,14,75,3,14,7,14,17,21,58,85,1,128,7,0,2,0,1,0
67281,107,5160,1523,757,1297,19,12,193,1542,12,193,117,230,205,347,1508,2664,7,19053,1058,0,2,0,1,0
67282,70,3204,1020,354,843,12,15,144,1032,8,134,77,144,142,221,970,1580,4,6792,377,0,2,0,1,0
67283,44,2058,447,308,343,6,5,95,453,7,96,59,111,103,170,651,1136,4,4600,255,0,2,0,1,0
67284,3,229,53,23,39,0,0,13,53,2,8,4,8,10,12,26,39,1,39,2,0,2,0,1,0
67285,21,655,424,94,331,4,0,89,428,1,5,5,5,6,10,11,25,0,12,0,0,2,0,1,0
67286,38,2327,334,251,279,10,4,40,344,5,127,74,143,132,217,899,1528,2,4303,239,0,2,0,1,0
67287,9,444,184,100,137,2,15,30,186,6,38,20,39,44,59,214,322,3,991,55,0,2,0,1,0
67288,8,377,91,45,69,0,3,18,91,3,9,6,10,12,16,33,57,1,95,5,0,2,0,1,0
67289,75,3960,1293,570,1093,25,15,163,1318,10,195,123,241,205,364,1516,2795,6,17273,959,0,2,0,1,0
67290,29,1903,384,251,317,7,8,52,391,11,70,44,84,81,128,467,811,6,5355,297,0,2,0,1,0
67291,56,2883,722,423,573,19,0,135,741,12,172,101,199,184,300,1320,2257,6,15668,870,0,2,0,1,0
67292,45,1953,386,256,301,16,9,68,402,4,59,35,69,63,104,355,621,2,1453,80,0,2,0,1,0
67293,28,1596,466,257,367,18,25,50,484,7,126,86,171,133,257,898,1813,4,8612,478,0,2,0,1,0
67295,85,3387,1043,504,840,53,9,147,1096,9,180,112,198,189,310,1377,2344,4,11604,644,0,2,0,1,0
67296,12,478,295,56,236,0,4,54,295,2,9,5,10,11,15,30,51,1,57,3,0,2,0,1,0
67297,30,1440,373,158,315,8,0,51,381,5,76,44,79,81,123,486,779,2,2026,112,0,2,0,1,0
67298,79,3101,1178,367,1042,6,15,115,1184,9,94,51,95,103,146,644,976,4,4439,246,0,2,0,1,0
67299,9,449,219,78,157,11,5,46,230,3,24,20,34,27,54,114,256,2,545,30,0,2,0,1,0
67300,111,6122,1943,715,1694,26,18,214,1969,12,185,120,237,197,357,1436,2721,7,20915,1161,0,2,0,1,0
67301,35,1497,442,244,305,14,16,103,456,11,68,45,75,79,120,452,756,6,4588,254,0,2,0,1,0
67302,48,1943,1098,241,925,5,10,155,1103,7,46,25,49,53,74,273,423,3,1580,87,0,2,0,1,0
67303,48,1649,601,196,481,2,23,85,603,8,63,36,72,71,108,400,664,4,3036,168,0,2,0,1,0
67304,2,34,9,6,6,0,0,3,9,0,0,0,0,0,0,0,0,0,0,0,0,2,0,2,0
67305,2,34,13,9,8,0,0,4,13,0,0,0,0,0,0,0,0,0,0,0,0,2,0,2,0
67306,11,230,19,8,11,5,0,4,24,2,5,3,6,7,9,13,25,1,30,1,0,2,0,4,0
67307,11,230,102,59,69,5,3,24,107,6,22,15,28,28,43,113,206,3,789,43,0,2,0,4,0
67308,11,230,106,40,36,3,49,17,109,8,17,13,23,25,36,93,167,5,904,50,0,2,0,4,0
67332,221,4746,182,127,129,0,0,53,182,5,39,21,42,44,63,217,343,2,926,51,0,2,0,4,0
67333,221,4746,1165,710,800,67,119,181,1232,18,243,153,282,261,435,2000,3492,10,36473,2026,1,2,0,4,0
67334,67,1558,773,419,590,28,0,166,801,10,204,113,217,214,330,1598,2554,5,13587,754,0,2,0,4,0
67335,67,1558,421,273,302,44,34,57,465,17,81,59,107,98,166,583,1098,11,12329,684,0,2,0,4,0
67336,14,407,149,95,105,2,0,41,151,8,54,28,55,62,83,334,494,4,2013,111,0,2,1,2,0
67337,14,407,82,56,54,0,13,15,82,4,13,8,16,17,24,56,98,2,241,13,0,2,1,2,0
67340,25,502,2,2,2,0,0,0,2,0,0,0,0,0,0,0,0,0,0,0,0,2,0,4,0
67354,25,502,99,48,90,1,3,5,100,0,0,0,0,0,0,0,0,0,0,0,0,2,0,4,0
67355,25,502,8,5,5,2,0,1,10,0,0,0,0,0,0,0,0,0,0,0,0,2,0,4,0
67356,25,502,1217,716,841,84,126,174,1301,14,185,118,215,199,333,1446,2542,8,20687,1149,0,2,0,4,0
67357,25,502,160,89,115,0,13,31,160,7,15,11,17,22,28,78,124,3,495,27,0,2,0,4,0
67358,25,502,10,10,9,9,0,0,19,0,0,0,0,0,0,0,0,0,0,0,0,2,0,4,0
67359,25,502,173,84,99,8,29,36,181,5,12,7,13,17,20,54,81,2,221,12,0,2,0,4,0
67360,25,502,3,1,1,3,0,0,6,0,0,0,0,0,0,0,0,0,0,0,0,2,0,4,0
67361,174,5286,1660,832,1314,41,38,274,1701,20,312,209,395,332,604,2671,5058,12,64042,3557,1,2,0,4,0
67362,174,5286,1057,646,719,113,100,145,1170,18,215,134,248,233,382,1740,3004,10,31186,1732,1,2,0,4,0
67363,17,336,95,58,50,9,16,20,104,12,33,24,45,45,69,209,378,8,3100,172,0,2,0,4,0
67364,116,2161,477,336,357,30,23,73,507,16,194,134,250,210,384,1538,2962,10,30538,1696,0,2,0,4,0
67365,90,2032,996,429,845,24,10,117,1020,7,76,50,88,83,138,494,879,4,3565,198,0,2,0,4,0
67366,90,2032,456,277,329,12,42,72,468,13,85,50,97,98,147,592,972,7,7212,400,0,2,0,4,0
67367,160,3447,1513,682,1277,25,13,200,1538,11,199,116,219,210,335,1557,2584,6,15641,868,0,2,0,4,0
67368,160,3447,819,519,539,24,98,155,843,15,96,57,106,111,163,690,1107,8,9171,509,0,2,0,4,0
67369,59,1108,207,111,150,11,0,50,218,5,26,19,36,31,55,133,272,3,943,52,0,2,0,4,0
67370,59,1108,410,198,237,31,55,97,441,11,63,38,72,74,110,414,683,6,4293,238,0,2,0,4,0
67373,235,4901,2,2,2,0,0,0,2,0,0,0,0,0,0,0,0,0,0,0,0,2,0,4,0
67387,235,4901,99,48,90,1,3,5,100,0,0,0,0,0,0,0,0,0,0,0,0,2,0,4,0
67388,235,4901,8,5,5,2,0,1,10,0,0,0,0,0,0,0,0,0,0,0,0,2,0,4,0
67389,235,4901,1217,716,841,84,126,174,1301,14,185,118,215,199,333,1446,2542,8,20687,1149,0,2,0,4,0
67390,235,4901,160,89,115,0,13,31,160,7,15,11,17,22,28,78,124,3,495,27,0,2,0,4,0
67391,235,4901,10,10,9,9,0,0,19,0,0,0,0,0,0,0,0,0,0,0,0,2,0,4,0
67392,235,4901,173,84,99,8,29,36,181,5,12,7,13,17,20,54,81,2,221,12,0,2,0,4,0
67393,235,4901,3,1,1,3,0,0,6,0,0,0,0,0,0,0,0,0,0,0,0,2,0,4,0
67394,57,1510,339,213,244,17,9,65,356,10,42,26,48,52,74,259,421,5,2410,133,0,2,0,4,0
67396,90,2296,1455,414,1257,16,76,112,1471,5,41,23,46,46,69,231,381,2,1069,59,0,2,0,4,0
67397,90,2296,669,365,481,22,61,110,691,15,103,63,122,118,185,747,1273,8,11311,628,0,2,0,4,0
67398,251,5826,4293,999,3693,19,54,507,4312,9,155,88,170,164,258,1156,1898,4,9368,520,0,2,0,4,0
67399,251,5826,1482,859,1002,125,135,219,1607,16,219,134,251,235,385,1766,3032,9,27804,1544,1,2,0,4,0
67400,6,128,44,22,19,0,19,6,44,2,10,6,12,12,18,35,64,1,77,4,0,2,0,3,0
67401,31,1075,74,35,59,1,0,14,75,3,14,7,14,17,21,58,85,1,128,7,0,2,0,4,0
67402,31,1075,245,125,200,5,7,34,250,7,30,17,34,37,51,166,265,3,1053,58,0,2,0,4,0
67403,117,3148,1523,757,1297,19,12,193,1542,12,193,117,230,205,347,1508,2664,7,19053,1058,0,2,0,4,0
67404,117,3148,701,378,504,33,58,109,734,13,110,68,126,123,194,794,1346,7,10027,557,0,2,0,4,0
67405,105,2767,773,422,505,30,103,129,803,14,77,46,83,91,129,535,839,7,6334,351,0,2,0,4,0
67406,149,3591,77,34,69,0,0,8,77,3,24,16,29,27,45,114,213,1,387,21,0,2,0,4,0
67407,149,3591,712,438,573,51,9,84,763,14,102,71,128,116,199,733,1364,8,11988,666,0,2,0,4,0
67410,24,600,2,2,2,0,0,0,2,0,0,0,0,0,0,0,0,0,0,0,0,2,0,4,0
67424,24,600,99,48,90,1,3,5,100,0,0,0,0,0,0,0,0,0,0,0,0,2,0,4,0
67425,24,600,8,5,5,2,0,1,10,0,0,0,0,0,0,0,0,0,0,0,0,2,0,4,0
67426,24,600,1217,716,841,84,126,174,1301,14,185,118,215,199,333,1446,2542,8,20687,1149,0,2,0,4,0
67427,24,600,160,89,115,0,13,31,160,7,15,11,17,22,28,78,124,3,495,27,0,2,0,4,0
67428,24,600,10,10,9,9,0,0,19,0,0,0,0,0,0,0,0,0,0,0,0,2,0,4,0
67429,24,600,173,84,99,8,29,36,181,5,12,7,13,17,20,54,81,2,221,12,0,2,0,4,0
67430,24,600,3,1,1,3,0,0,6,0,0,0,0,0,0,0,0,0,0,0,0,2,0,4,0
67431,51,1101,447,308,343,6,5,95,453,7,96,59,111,103,170,651,1136,4,4600,255,0,2,0,4,0
67432,51,1101,322,174,179,16,74,51,338,10,41,26,46,51,72,252,408,5,2291,127,0,2,0,4,0
67433,75,1617,53,23,39,0,0,13,53,2,8,4,8,10,12,26,39,1,39,2,0,2,0,4,0
67434,75,1617,515,298,307,33,80,99,548,12,63,44,77,75,121,419,753,7,5527,307,0,2,0,4,0
67435,18,300,424,94,331,4,0,89,428,1,5,5,5,6,10,11,25,0,12,0,0,2,0,4,0
67436,18,300,38,23,23,6,0,8,44,3,11,7,11,14,18,42,68,1,102,5,0,2,0,4,0
67437,19,501,205,80,86,16,53,53,221,7,18,10,19,25,29,94,134,3,497,27,0,2,0,4,0
67438,15,478,184,100,137,2,15,30,186,6,38,20,39,44,59,214,322,3,991,55,0,2,0,4,0
67439,15,478,103,65,74,8,5,16,111,7,17,9,17,24,26,89,119,3,417,23,0,2,0,4,0
67440,58,1197,91,45,69,0,3,18,91,3,9,6,10,12,16,33,57,1,95,5,0,2,0,1,0
67441,58,1197,367,234,237,17,34,68,384,16,55,34,61,71,95,381,584,8,5183,287,0,2,0,1,0
67442,228,5891,722,423,573,19,0,135,741,12,172,101,199,184,300,1320,2257,6,15668,870,0,2,0,4,0
67443,228,5891,1508,847,911,44,250,301,1552,14,148,88,169,162,257,1120,1886,7,15077,837,0,2,0,4,0
67444,315,6902,72,33,56,0,4,12,72,1,1,1,1,2,2,0,2,0,1,0,0,2,0,4,0
67445,315,6902,1454,835,1044,76,110,219,1530,17,275,158,296,292,454,2297,3718,9,34017,1889,1,2,0,4,0
67446,89,1807,757,253,292,73,244,162,830,13,61,38,67,74,105,409,651,7,4654,258,0,2,1,4,0
67447,38,802,386,256,301,16,9,68,402,4,59,35,69,63,104,355,621,2,1453,80,0,2,0,4,0
67448,38,802,264,131,164,11,41,46,275,6,38,22,40,44,62,214,338,3,1068,59,0,2,0,4,0
67449,25,540,215,129,180,6,0,29,221,8,65,43,72,73,115,415,711,4,3153,175,0,2,0,4,0
67450,25,540,97,69,77,3,3,16,100,6,22,13,23,28,36,113,173,3,542,30,0,2,0,4,0
67451,89,1882,1043,504,840,53,9,147,1096,9,180,112,198,189,310,1377,2344,4,11604,644,0,2,0,4,0
67452,89,1882,383,288,292,26,6,62,409,11,65,38,67,76,105,429,656,5,3719,206,0,2,0,4,0
67453,20,408,294,64,250,0,0,43,294,1,20,10,20,21,30,86,131,0,65,3,0,2,0,4,0
67454,20,408,78,46,62,3,0,14,81,3,8,4,8,11,12,28,41,1,62,3,0,2,0,4,0
67455,5,111,110,30,77,3,13,16,113,4,21,15,30,25,45,100,208,2,597,33,0,2,0,4,0
67456,5,111,28,15,21,1,0,6,29,0,0,0,0,0,0,0,0,0,0,0,0,2,0,4,0
67457,40,784,1178,367,1042,6,15,115,1184,9,94,51,95,103,146,644,976,4,4439,246,0,2,0,4,0
67458,40,784,177,108,140,8,0,27,185,6,30,16,32,36,48,162,248,3,794,44,0,2,0,4,0
67459,280,5876,1943,715,1694,26,18,214,1969,12,185,120,237,197,357,1436,2721,7,20915,1161,0,2,0,4,0
67460,280,5876,1168,838,957,57,25,144,1225,19,348,224,416,367,640,3018,5452,11,61921,3440,1,2,0,4,0
67461,19,705,442,244,305,14,16,103,456,11,68,45,75,79,120,452,756,6,4588,254,0,2,0,4,0
67462,19,705,182,102,99,11,40,35,193,3,11,6,11,14,17,42,64,1,97,5,0,2,0,4,0
67463,65,1251,1098,241,925,5,10,155,1103,7,46,25,49,53,74,273,423,3,1580,87,0,2,0,4,0
67464,65,1251,282,202,222,14,2,44,296,8,42,24,43,50,67,250,378,4,1548,86,0,2,0,4,0
67465,23,630,601,196,481,2,23,85,603,8,63,36,72,71,108,400,664,4,3036,168,0,2,0,4,0
67466,23,630,156,79,106,5,16,28,161,5,14,8,15,19,23,64,97,2,261,14,0,2,0,4,0
67467,104,4424,1289,550,1043,56,32,155,1345,10,167,93,185,177,278,1266,2075,5,11498,638,0,2,0,4,0
67468,31,982,182,127,129,0,0,53,182,5,39,21,42,44,63,217,343,2,926,51,0,2,0,4,0
67469,151,7235,1392,870,1177,35,17,170,1427,14,494,280,531,508,811,4473,7289,7,54850,3047,2,2,1,5,0
67470,95,2884,773,419,590,28,0,166,801,10,204,113,217,214,330,1598,2554,5,13587,754,0,2,0,4,0
67471,14,833,75,38,59,1,3,12,76,2,4,2,4,6,6,10,15,1,15,0,0,2,0,4,0
67472,19,505,102,59,69,5,3,24,107,6,22,15,28,28,43,113,206,3,789,43,0,2,0,4,0
67473,119,4908,1450,624,1228,12,26,181,1462,14,306,186,354,320,540,2580,4493,8,36391,2021,1,2,0,4,0
67474,176,5150,1660,832,1314,41,38,274,1701,20,312,209,395,332,604,2671,5058,12,64042,3557,1,2,0,4,0
67475,49,3793,996,429,845,24,10,117,1020,7,76,50,88,83,138,494,879,4,3565,198,0,2,0,4,0
67476,120,5111,1513,682,1277,25,13,200,1538,11,199,116,219,210,335,1557,2584,6,15641,868,0,2,0,4,0
67477,84,4904,1296,573,1062,40,33,157,1336,8,201,118,231,209,349,1561,2689,4,12365,686,0,2,0,4,0
67478,20,455,207,111,150,11,0,50,218,5,26,19,36,31,55,133,272,3,943,52,0,2,0,4,0
67479,98,5229,1457,730,1242,11,6,188,1468,10,292,166,329,302,495,2424,4078,5,22973,1276,1,2,0,4,0
67480,43,2678,652,304,544,16,6,88,668,6,89,51,101,95,152,591,998,3,3399,188,0,2,0,4,0
67481,72,3254,1455,414,1257,16,76,112,1471,5,41,23,46,46,69,231,381,2,1069,59,0,2,0,4,0
67482,2,44,7,6,5,0,0,2,7,1,1,1,2,2,3,0,3,1,3,0,0,2,0,4,0
67483,8,263,74,35,59,1,0,14,75,3,14,7,14,17,21,58,85,1,128,7,0,2,0,4,0
67484,107,5148,1523,757,1297,19,12,193,1542,12,193,117,230,205,347,1508,2664,7,19053,1058,0,2,0,4,0
67485,70,3192,1020,354,843,12,15,144,1032,8,134,77,144,142,221,970,1580,4,6792,377,0,2,0,4,0
67486,44,2046,447,308,343,6,5,95,453,7,96,59,111,103,170,651,1136,4,4600,255,0,2,0,4,0
67487,21,643,424,94,331,4,0,89,428,1,5,5,5,6,10,11,25,0,12,0,0,2,0,4,0
67488,38,2315,334,251,279,10,4,40,344,5,127,74,143,132,217,899,1528,2,4303,239,0,2,0,4,0
67489,9,432,184,100,137,2,15,30,186,6,38,20,39,44,59,214,322,3,991,55,0,2,0,4,0
67490,75,3948,1293,570,1093,25,15,163,1318,10,195,123,241,205,364,1516,2795,6,17273,959,0,2,0,4,0
67491,29,1891,384,251,317,7,8,52,391,11,70,44,84,81,128,467,811,6,5355,297,0,2,0,4,0
67492,56,2871,722,423,573,19,0,135,741,12,172,101,199,184,300,1320,2257,6,15668,870,0,2,0,4,0
67493,45,1941,386,256,301,16,9,68,402,4,59,35,69,63,104,355,621,2,1453,80,0,2,0,4,0
67494,15,1054,215,129,180,6,0,29,221,8,65,43,72,73,115,415,711,4,3153,175,0,2,0,4,0
67495,85,3375,1043,504,840,53,9,147,1096,9,180,112,198,189,310,1377,2344,4,11604,644,0,2,0,4,0
67496,12,466,295,56,236,0,4,54,295,2,9,5,10,11,15,30,51,1,57,3,0,2,0,4,0
67497,30,1428,373,158,315,8,0,51,381,5,76,44,79,81,123,486,779,2,2026,112,0,2,0,4,0
67498,79,3089,1178,367,1042,6,15,115,1184,9,94,51,95,103,146,644,976,4,4439,246,0,2,0,4,0
67499,111,6110,1943,715,1694,26,18,214,1969,12,185,120,237,197,357,1436,2721,7,20915,1161,0,2,0,4,0
67500,35,1485,442,244,305,14,16,103,456,11,68,45,75,79,120,452,756,6,4588,254,0,2,0,4,0
67501,48,1931,1098,241,925,5,10,155,1103,7,46,25,49,53,74,273,423,3,1580,87,0,2,0,4,0
67502,48,1645,601,196,481,2,23,85,603,8,63,36,72,71,108,400,664,4,3036,168,0,2,0,2,0
67503,1,313,382,65,130,157,2,92,539,4,10,5,10,14,15,41,57,2,114,6,0,2,9,9,1
67504,60,1118,282,196,195,3,0,86,285,8,130,71,141,138,212,936,1507,4,6538,363,0,2,15,15,1
67506,3,63,127,75,83,2,11,30,129,4,14,7,14,18,21,61,87,2,175,9,0,2,1,1,1
67507,3,63,652,304,544,16,6,88,668,6,89,51,101,95,152,591,998,3,3399,188,0,2,1,1,1
67508,3,63,2,2,2,0,0,0,2,0,0,0,0,0,0,0,0,0,0,0,0,2,1,1,1
67509,3,63,8,5,5,0,0,3,8,0,0,0,0,0,0,0,0,0,0,0,0,2,1,1,1
67512,3,63,14,8,8,0,0,6,14,0,0,0,0,0,0,0,0,0,0,0,0,2,1,1,1
67513,3,63,6,4,4,0,0,2,6,0,0,0,0,0,0,0,0,0,0,0,0,2,1,1,1
67514,3,63,6,4,4,0,0,2,6,1,2,1,2,3,3,2,4,0,2,0,0,2,1,1,1
67516,3,63,7,5,5,0,0,2,7,0,0,0,0,0,0,0,0,0,0,0,0,2,1,1,1
67518,3,63,10,6,6,0,0,4,10,0,0,0,0,0,0,0,0,0,0,0,0,2,1,1,1
67519,3,63,1,1,1,0,0,0,1,0,0,0,0,0,0,0,0,0,0,0,0,2,1,1,1
67521,3,63,14,10,10,0,0,4,14,1,1,1,1,2,2,0,2,0,1,0,0,2,1,1,1
67522,3,63,46,26,30,3,0,12,49,3,6,3,6,9,9,20,28,1,42,2,0,2,1,1,1
67523,7,293,72,33,56,0,4,12,72,1,1,1,1,2,2,0,2,0,1,0,0,2,1,1,1
67524,12,226,127,75,83,2,11,30,129,4,14,7,14,18,21,61,87,2,175,9,0,2,1,1,1
67525,12,226,652,304,544,16,6,88,668,6,89,51,101,95,152,591,998,3,3399,188,0,2,1,1,1
67526,12,226,2,2,2,0,0,0,2,0,0,0,0,0,0,0,0,0,0,0,0,2,1,1,1
67527,12,226,8,5,5,0,0,3,8,0,0,0,0,0,0,0,0,0,0,0,0,2,1,1,1
67530,12,226,14,8,8,0,0,6,14,0,0,0,0,0,0,0,0,0,0,0,0,2,1,1,1
67531,12,226,6,4,4,0,0,2,6,0,0,0,0,0,0,0,0,0,0,0,0,2,1,1,1
67532,12,226,6,4,4,0,0,2,6,1,2,1,2,3,3,2,4,0,2,0,0,2,1,1,1
67534,12,226,7,5,5,0,0,2,7,0,0,0,0,0,0,0,0,0,0,0,0,2,1,1,1
67536,12,226,10,6,6,0,0,4,10,0,0,0,0,0,0,0,0,0,0,0,0,2,1,1,1
67537,12,226,1,1,1,0,0,0,1,0,0,0,0,0,0,0,0,0,0,0,0,2,1,1,1
67539,12,226,14,10,10,0,0,4,14,1,1,1,1,2,2,0,2,0,1,0,0,2,1,1,1
67540,12,226,46,26,30,3,0,12,49,3,6,3,6,9,9,20,28,1,42,2,0,2,1,1,1
67542,11,227,19,8,11,5,0,4,24,2,5,3,6,7,9,13,25,1,30,1,0,2,1,1,1
67543,11,227,102,59,69,5,3,24,107,6,22,15,28,28,43,113,206,3,789,43,0,2,1,1,1
67544,11,227,106,40,36,3,49,17,109,8,17,13,23,25,36,93,167,5,904,50,0,2,1,1,1
67545,221,4718,182,127,129,0,0,53,182,5,39,21,42,44,63,217,343,2,926,51,0,2,19,17,1
67546,221,4718,1165,710,800,67,119,181,1232,18,243,153,282,261,435,2000,3492,10,36473,2026,1,2,19,17,1
67547,67,1551,773,419,590,28,0,166,801,10,204,113,217,214,330,1598,2554,5,13587,754,0,2,2,3,1
67548,67,1551,421,273,302,44,34,57,465,17,81,59,107,98,166,583,1098,11,12329,684,0,2,2,3,1
67549,14,404,149,95,105,2,0,41,151,8,54,28,55,62,83,334,494,4,2013,111,0,2,5,8,1
67550,14,404,82,56,54,0,13,15,82,4,13,8,16,17,24,56,98,2,241,13,0,2,5,8,1
67553,25,489,2,2,2,0,0,0,2,0,0,0,0,0,0,0,0,0,0,0,0,2,3,5,1
67567,25,489,99,48,90,1,3,5,100,0,0,0,0,0,0,0,0,0,0,0,0,2,3,5,1
67568,25,489,8,5,5,2,0,1,10,0,0,0,0,0,0,0,0,0,0,0,0,2,3,5,1
67569,25,489,1217,716,841,84,126,174,1301,14,185,118,215,199,333,1446,2542,8,20687,1149,0,2,3,5,1
67570,25,489,160,89,115,0,13,31,160,7,15,11,17,22,28,78,124,3,495,27,0,2,3,5,1
67571,25,489,10,10,9,9,0,0,19,0,0,0,0,0,0,0,0,0,0,0,0,2,3,5,1
67572,25,489,173,84,99,8,29,36,181,5,12,7,13,17,20,54,81,2,221,12,0,2,3,5,1
67573,25,489,3,1,1,3,0,0,6,0,0,0,0,0,0,0,0,0,0,0,0,2,3,5,1
67574,174,5271,1660,832,1314,41,38,274,1701,20,312,209,395,332,604,2671,5058,12,64042,3557,1,2,33,29,1
67575,174,5271,1057,646,719,113,100,145,1170,18,215,134,248,233,382,1740,3004,10,31186,1732,1,2,33,29,1
67576,17,327,95,58,50,9,16,20,104,12,33,24,45,45,69,209,378,8,3100,172,0,2,1,3,1
67577,116,2120,477,336,357,30,23,73,507,16,194,134,250,210,384,1538,2962,10,30538,1696,0,2,43,41,1
67578,90,2017,996,429,845,24,10,117,1020,7,76,50,88,83,138,494,879,4,3565,198,0,2,7,8,1
67579,90,2017,456,277,329,12,42,72,468,13,85,50,97,98,147,592,972,7,7212,400,0,2,7,8,1
67580,160,3411,1513,682,1277,25,13,200,1538,11,199,116,219,210,335,1557,2584,6,15641,868,0,2,19,28,1
67581,160,3411,819,519,539,24,98,155,843,15,96,57,106,111,163,690,1107,8,9171,509,0,2,19,28,1
67582,59,1095,207,111,150,11,0,50,218,5,26,19,36,31,55,133,272,3,943,52,0,2,5,7,1
67583,59,1095,410,198,237,31,55,97,441,11,63,38,72,74,110,414,683,6,4293,238,0,2,5,7,1
67586,235,4869,2,2,2,0,0,0,2,0,0,0,0,0,0,0,0,0,0,0,0,2,20,24,1
67600,235,4869,99,48,90,1,3,5,100,0,0,0,0,0,0,0,0,0,0,0,0,2,20,24,1
67601,235,4869,8,5,5,2,0,1,10,0,0,0,0,0,0,0,0,0,0,0,0,2,20,24,1
67602,235,4869,1217,716,841,84,126,174,1301,14,185,118,215,199,333,1446,2542,8,20687,1149,0,2,20,24,1
67603,235,4869,160,89,115,0,13,31,160,7,15,11,17,22,28,78,124,3,495,27,0,2,20,24,1
67604,235,4869,10,10,9,9,0,0,19,0,0,0,0,0,0,0,0,0,0,0,0,2,20,24,1
67605,235,4869,173,84,99,8,29,36,181,5,12,7,13,17,20,54,81,2,221,12,0,2,20,24,1
67606,235,4869,3,1,1,3,0,0,6,0,0,0,0,0,0,0,0,0,0,0,0,2,20,24,1
67607,98,2010,463,295,324,28,62,57,491,12,134,82,154,146,236,989,1696,6,11700,650,0,2,8,9,1
67608,57,1484,339,213,244,17,9,65,356,10,42,26,48,52,74,259,421,5,2410,133,0,2,11,11,1
67609,90,2288,1455,414,1257,16,76,112,1471,5,41,23,46,46,69,231,381,2,1069,59,0,2,4,4,1
67610,90,2288,669,365,481,22,61,110,691,15,103,63,122,118,185,747,1273,8,11311,628,0,2,4,4,1
67611,251,5813,4293,999,3693,19,54,507,4312,9,155,88,170,164,258,1156,1898,4,9368,520,0,2,13,15,1
67612,251,5813,1482,859,1002,125,135,219,1607,16,219,134,251,235,385,1766,3032,9,27804,1544,1,2,13,15,1
67613,31,1078,74,35,59,1,0,14,75,3,14,7,14,17,21,58,85,1,128,7,0,2,9,7,1
67614,31,1078,245,125,200,5,7,34,250,7,30,17,34,37,51,166,265,3,1053,58,0,2,9,7,1
67615,117,3127,1523,757,1297,19,12,193,1542,12,193,117,230,205,347,1508,2664,7,19053,1058,0,2,10,11,1
67616,117,3127,701,378,504,33,58,109,734,13,110,68,126,123,194,794,1346,7,10027,557,0,2,10,11,1
67617,105,2753,773,422,505,30,103,129,803,14,77,46,83,91,129,535,839,7,6334,351,0,2,5,5,1
67618,146,3571,77,34,69,0,0,8,77,3,24,16,29,27,45,114,213,1,387,21,0,2,13,21,1
67619,146,3571,712,438,573,51,9,84,763,14,102,71,128,116,199,733,1364,8,11988,666,0,2,13,21,1
67620,30,657,125,97,103,3,0,19,128,9,25,17,27,34,44,144,223,4,1087,60,0,2,2,4,1
67621,22,367,102,57,55,5,16,25,107,5,17,10,18,22,28,81,124,2,330,18,0,2,2,2,1
67622,71,1560,402,202,227,24,74,80,426,12,52,33,61,64,94,339,564,7,3969,220,0,2,7,8,1
67623,51,1090,447,308,343,6,5,95,453,7,96,59,111,103,170,651,1136,4,4600,255,0,2,13,11,1
67624,51,1090,322,174,179,16,74,51,338,10,41,26,46,51,72,252,408,5,2291,127,0,2,13,11,1
67625,75,1603,53,23,39,0,0,13,53,2,8,4,8,10,12,26,39,1,39,2,0,2,6,9,1
67626,75,1603,515,298,307,33,80,99,548,12,63,44,77,75,121,419,753,7,5527,307,0,2,6,9,1
67627,18,296,424,94,331,4,0,89,428,1,5,5,5,6,10,11,25,0,12,0,0,2,1,3,1
67628,18,296,38,23,23,6,0,8,44,3,11,7,11,14,18,42,68,1,102,5,0,2,1,3,1
67629,19,499,205,80,86,16,53,53,221,7,18,10,19,25,29,94,134,3,497,27,0,2,3,3,1
67630,15,476,184,100,137,2,15,30,186,6,38,20,39,44,59,214,322,3,991,55,0,2,3,5,1
67631,15,476,103,65,74,8,5,16,111,7,17,9,17,24,26,89,119,3,417,23,0,2,3,5,1
67632,58,1189,91,45,69,0,3,18,91,3,9,6,10,12,16,33,57,1,95,5,0,2,5,6,1
67633,58,1189,367,234,237,17,34,68,384,16,55,34,61,71,95,381,584,8,5183,287,0,2,5,6,1
67634,228,5843,722,423,573,19,0,135,741,12,172,101,199,184,300,1320,2257,6,15668,870,0,2,34,33,1
67635,228,5843,1508,847,911,44,250,301,1552,14,148,88,169,162,257,1120,1886,7,15077,837,0,2,34,33,1
67636,314,6872,72,33,56,0,4,12,72,1,1,1,1,2,2,0,2,0,1,0,0,2,20,23,1
67637,314,6872,1454,835,1044,76,110,219,1530,17,275,158,296,292,454,2297,3718,9,34017,1889,1,2,20,23,1
67638,89,1801,757,253,292,73,244,162,830,13,61,38,67,74,105,409,651,7,4654,258,0,2,2,2,1
67639,38,787,386,256,301,16,9,68,402,4,59,35,69,63,104,355,621,2,1453,80,0,2,5,5,1
67640,38,787,264,131,164,11,41,46,275,6,38,22,40,44,62,214,338,3,1068,59,0,2,5,5,1
67641,67,1747,466,257,367,18,25,50,484,7,126,86,171,133,257,898,1813,4,8612,478,0,2,9,18,1
67642,67,1747,507,281,342,29,59,88,536,10,53,29,57,63,86,336,514,5,2764,153,0,2,9,18,1
67643,25,538,215,129,180,6,0,29,221,8,65,43,72,73,115,415,711,4,3153,175,0,2,2,2,1
67644,25,538,97,69,77,3,3,16,100,6,22,13,23,28,36,113,173,3,542,30,0,2,2,2,1
67645,89,1877,1043,504,840,53,9,147,1096,9,180,112,198,189,310,1377,2344,4,11604,644,0,2,3,3,1
67646,89,1877,383,288,292,26,6,62,409,11,65,38,67,76,105,429,656,5,3719,206,0,2,3,3,1
67647,280,5869,1943,715,1694,26,18,214,1969,12,185,120,237,197,357,1436,2721,7,20915,1161,0,2,19,22,1
67648,280,5869,1168,838,957,57,25,144,1225,19,348,224,416,367,640,3018,5452,11,61921,3440,1,2,19,22,1
67649,19,699,442,244,305,14,16,103,456,11,68,45,75,79,120,452,756,6,4588,254,0,2,2,2,1
67650,19,699,182,102,99,11,40,35,193,3,11,6,11,14,17,42,64,1,97,5,0,2,2,2,1
67651,2,153,37,13,25,0,6,6,37,1,2,1,2,3,3,2,4,0,2,0,0,2,1,1,1
67652,2,153,133,47,40,1,43,49,134,0,0,0,0,0,0,0,0,0,0,0,0,2,1,1,1
67653,23,630,601,196,481,2,23,85,603,8,63,36,72,71,108,400,664,4,3036,168,0,2,2,2,1
67654,23,630,156,79,106,5,16,28,161,5,14,8,15,19,23,64,97,2,261,14,0,2,2,2,1
67655,104,4398,1289,550,1043,56,32,155,1345,10,167,93,185,177,278,1266,2075,5,11498,638,0,2,9,10,1
67656,31,963,182,127,129,0,0,53,182,5,39,21,42,44,63,217,343,2,926,51,0,2,7,8,1
67657,151,7198,1392,870,1177,35,17,170,1427,14,494,280,531,508,811,4473,7289,7,54850,3047,2,2,14,15,1
67658,95,2841,773,419,590,28,0,166,801,10,204,113,217,214,330,1598,2554,5,13587,754,0,2,16,16,1
67676,1,52,14,12,10,0,0,4,14,1,2,1,2,3,3,2,4,0,2,0,0,2,1,1,1
67677,1,55,14,12,10,0,0,4,14,1,2,1,2,3,3,2,4,0,2,0,0,2,1,1,1
67679,1,71,19,18,14,0,0,5,19,1,2,1,2,3,3,2,4,0,2,0,0,2,2,2,1
67680,3,44,15,10,10,0,0,5,15,2,4,2,4,6,6,10,15,1,15,0,0,2,1,1,1
67681,2,33,10,7,7,0,0,3,10,1,2,1,2,3,3,2,4,0,2,0,0,2,1,1,1
67682,3,43,15,9,9,0,0,6,15,1,4,2,4,5,6,8,13,0,6,0,0,2,1,1,1
67683,12,313,149,95,105,2,0,41,151,8,54,28,55,62,83,334,494,4,2013,111,0,2,3,3,1
67684,15,699,139,89,101,2,0,35,141,7,54,34,62,61,96,330,569,4,2287,127,0,2,4,4,1
67685,3,324,149,67,118,4,0,27,153,1,17,14,28,18,42,69,175,0,144,8,0,2,2,2,1
67686,38,2497,1157,318,931,29,22,177,1186,6,104,63,125,110,188,712,1274,3,4596,255,0,2,1,1,1
67687,65,4371,520,294,400,33,13,81,553,10,261,204,367,271,571,2128,4614,7,32445,1802,1,2,3,3,1
67688,90,3959,1338,495,1086,10,64,173,1348,11,122,82,157,133,239,883,1686,7,11934,663,0,2,11,11,1
67689,172,7590,4293,999,3693,19,54,507,4312,9,155,88,170,164,258,1156,1898,4,9368,520,0,2,15,15,1
67690,172,7590,1482,859,1002,125,135,219,1607,16,219,134,251,235,385,1766,3032,9,27804,1544,1,2,15,15,1
67691,33,984,465,148,393,5,8,60,470,4,31,20,31,35,51,161,261,2,523,29,0,2,5,5,1
67692,33,984,16,12,9,0,0,6,16,1,2,1,2,3,3,2,4,0,2,0,0,2,5,5,1
67693,144,5870,1782,648,1425,9,47,279,1791,8,171,97,189,179,286,1292,2140,4,9462,525,0,2,30,31,1
67694,32,968,256,139,192,9,7,47,265,4,23,12,24,27,36,112,171,2,357,19,0,2,4,7,1
67695,6,328,180,34,164,0,0,16,180,1,12,6,12,13,18,43,66,0,33,1,0,2,0,2,1
67696,19,499,102,59,69,5,3,24,107,6,22,15,28,28,43,113,206,3,789,43,0,2,2,2,1
67697,119,4854,1450,624,1228,12,26,181,1462,14,306,186,354,320,540,2580,4493,8,36391,2021,1,2,23,24,1
67698,176,5109,1660,832,1314,41,38,274,1701,20,312,209,395,332,604,2671,5058,12,64042,3557,1,2,14,15,1
67699,49,3780,996,429,845,24,10,117,1020,7,76,50,88,83,138,494,879,4,3565,198,0,2,5,5,1
67700,120,5083,1513,682,1277,25,13,200,1538,11,199,116,219,210,335,1557,2584,6,15641,868,0,2,10,10,1
67701,84,4871,1296,573,1062,40,33,157,1336,8,201,118,231,209,349,1561,2689,4,12365,686,0,2,11,11,1
67702,20,449,207,111,150,11,0,50,218,5,26,19,36,31,55,133,272,3,943,52,0,2,2,2,1
67703,98,5169,1457,730,1242,11,6,188,1468,10,292,166,329,302,495,2424,4078,5,22973,1276,1,2,20,20,1
67704,43,2669,652,304,544,16,6,88,668,6,89,51,101,95,152,591,998,3,3399,188,0,2,3,3,1
67705,72,3231,1455,414,1257,16,76,112,1471,5,41,23,46,46,69,231,381,2,1069,59,0,2,9,9,1
67706,107,5128,1523,757,1297,19,12,193,1542,12,193,117,230,205,347,1508,2664,7,19053,1058,0,2,12,12,1
67707,70,3177,1020,354,843,12,15,144,1032,8,134,77,144,142,221,970,1580,4,6792,377,0,2,5,5,1
67708,44,2024,447,308,343,6,5,95,453,7,96,59,111,103,170,651,1136,4,4600,255,0,2,8,8,1
67709,21,637,424,94,331,4,0,89,428,1,5,5,5,6,10,11,25,0,12,0,0,2,2,2,1
67710,38,2309,334,251,279,10,4,40,344,5,127,74,143,132,217,899,1528,2,4303,239,0,2,2,2,1
67711,9,423,184,100,137,2,15,30,186,6,38,20,39,44,59,214,322,3,991,55,0,2,3,3,1
67712,75,3937,1293,570,1093,25,15,163,1318,10,195,123,241,205,364,1516,2795,6,17273,959,0,2,5,5,1
67713,29,1873,384,251,317,7,8,52,391,11,70,44,84,81,128,467,811,6,5355,297,0,2,6,6,1
67714,56,2846,722,423,573,19,0,135,741,12,172,101,199,184,300,1320,2257,6,15668,870,0,2,10,10,1
67715,45,1932,386,256,301,16,9,68,402,4,59,35,69,63,104,355,621,2,1453,80,0,2,3,3,1
67716,28,1590,466,257,367,18,25,50,484,7,126,86,171,133,257,898,1813,4,8612,478,0,2,2,2,1
67717,15,1051,215,129,180,6,0,29,221,8,65,43,72,73,115,415,711,4,3153,175,0,2,1,1,1
67718,85,3359,1043,504,840,53,9,147,1096,9,180,112,198,189,310,1377,2344,4,11604,644,0,2,6,6,1
67719,30,1422,373,158,315,8,0,51,381,5,76,44,79,81,123,486,779,2,2026,112,0,2,2,2,1
67720,79,3071,1178,367,1042,6,15,115,1184,9,94,51,95,103,146,644,976,4,4439,246,0,2,6,6,1
67721,111,6048,1943,715,1694,26,18,214,1969,12,185,120,237,197,357,1436,2721,7,20915,1161,0,2,26,26,1
67722,35,1473,442,244,305,14,16,103,456,11,68,45,75,79,120,452,756,6,4588,254,0,2,4,4,1
67723,48,1928,1098,241,925,5,10,155,1103,7,46,25,49,53,74,273,423,3,1580,87,0,2,1,1,1
67724,48,1639,601,196,481,2,23,85,603,8,63,36,72,71,108,400,664,4,3036,168,0,2,1,1,1
67725,104,4398,1289,550,1043,56,32,155,1345,10,167,93,185,177,278,1266,2075,5,11498,638,0,2,2,3,1
67726,38,2497,1157,318,931,29,22,177,1186,6,104,63,125,110,188,712,1274,3,4596,255,0,2,2,4,1
67727,90,3959,1338,495,1086,10,64,173,1348,11,122,82,157,133,239,883,1686,7,11934,663,0,2,2,13,1
67728,172,7590,4293,999,3693,19,54,507,4312,9,155,88,170,164,258,1156,1898,4,9368,520,0,2,0,5,1
67729,172,7590,1482,859,1002,125,135,219,1607,16,219,134,251,235,385,1766,3032,9,27804,1544,1,2,0,5,1
67730,119,4854,1450,624,1228,12,26,181,1462,14,306,186,354,320,540,2580,4493,8,36391,2021,1,2,2,3,1
67731,120,5083,1513,682,1277,25,13,200,1538,11,199,116,219,210,335,1557,2584,6,15641,868,0,2,2,5,1
67732,72,3231,1455,414,1257,16,76,112,1471,5,41,23,46,46,69,231,381,2,1069,59,0,2,2,6,1
67733,107,5128,1523,757,1297,19,12,193,1542,12,193,117,230,205,347,1508,2664,7,19053,1058,0,2,2,2,1
67734,70,3177,1020,354,843,12,15,144,1032,8,134,77,144,142,221,970,1580,4,6792,377,0,2,0,1,1
67735,21,637,424,94,331,4,0,89,428,1,5,5,5,6,10,11,25,0,12,0,0,2,2,3,1
67736,9,423,184,100,137,2,15,30,186,6,38,20,39,44,59,214,322,3,991,55,0,2,2,3,1
67737,29,1873,384,251,317,7,8,52,391,11,70,44,84,81,128,467,811,6,5355,297,0,2,3,4,1
67738,85,3359,1043,504,840,53,9,147,1096,9,180,112,198,189,310,1377,2344,4,11604,644,0,2,4,6,1
67739,48,1639,601,196,481,2,23,85,603,8,63,36,72,71,108,400,664,4,3036,168,0,2,2,3,1
67740,228,5833,722,423,573,19,0,135,741,12,172,101,199,184,300,1320,2257,6,15668,870,0,2,4,5,0
67741,228,5833,1508,847,911,44,250,301,1552,14,148,88,169,162,257,1120,1886,7,15077,837,0,2,4,5,0
67742,38,2493,1157,318,931,29,22,177,1186,6,104,63,125,110,188,712,1274,3,4596,255,0,2,0,1,0
67743,1,92,42,7,35,4,0,5,46,1,2,1,2,3,3,2,4,0,2,0,0,2,0,1,0
67744,1,92,11,6,10,0,0,1,11,2,4,2,4,6,6,10,15,1,15,0,0,2,0,1,0
67745,174,5263,1660,832,1314,41,38,274,1701,20,312,209,395,332,604,2671,5058,12,64042,3557,1,2,1,2,0
67746,174,5263,1057,646,719,113,100,145,1170,18,215,134,248,233,382,1740,3004,10,31186,1732,1,2,1,2,0
67747,251,5822,4293,999,3693,19,54,507,4312,9,155,88,170,164,258,1156,1898,4,9368,520,0,2,5,5,0
67748,251,5822,1482,859,1002,125,135,219,1607,16,219,134,251,235,385,1766,3032,9,27804,1544,1,2,5,5,0
67749,104,2739,773,422,505,30,103,129,803,14,77,46,83,91,129,535,839,7,6334,351,0,2,23,28,0
67750,89,1896,1043,504,840,53,9,147,1096,9,180,112,198,189,310,1377,2344,4,11604,644,0,2,6,4,0
67751,89,1896,383,288,292,26,6,62,409,11,65,38,67,76,105,429,656,5,3719,206,0,2,6,4,0
67752,95,2839,773,419,590,28,0,166,801,10,204,113,217,214,330,1598,2554,5,13587,754,0,2,0,2,0
67753,3,305,149,67,118,4,0,27,153,1,17,14,28,18,42,69,175,0,144,8,0,2,0,5,0
67754,38,2493,1157,318,931,29,22,177,1186,6,104,63,125,110,188,712,1274,3,4596,255,0,2,2,3,0
67755,172,7590,4293,999,3693,19,54,507,4312,9,155,88,170,164,258,1156,1898,4,9368,520,0,2,2,3,0
67756,172,7590,1482,859,1002,125,135,219,1607,16,219,134,251,235,385,1766,3032,9,27804,1544,1,2,2,3,0
67757,144,5870,1782,648,1425,9,47,279,1791,8,171,97,189,179,286,1292,2140,4,9462,525,0,2,2,2,0
67758,48,1928,1098,241,925,5,10,155,1103,7,46,25,49,53,74,273,423,3,1580,87,0,2,1,1,0
67759,48,1639,601,196,481,2,23,85,603,8,63,36,72,71,108,400,664,4,3036,168,0,2,1,1,0
67760,95,2843,773,419,590,28,0,166,801,10,204,113,217,214,330,1598,2554,5,13587,754,0,2,1,1,0
67761,3,299,149,67,118,4,0,27,153,1,17,14,28,18,42,69,175,0,144,8,0,2,2,2,0
67766,2,34,9,6,6,0,0,3,9,0,0,0,0,0,0,0,0,0,0,0,0,2,0,3,0
67767,2,34,13,9,8,0,0,4,13,0,0,0,0,0,0,0,0,0,0,0,0,2,0,3,0
67769,1,313,382,65,130,157,2,92,539,4,10,5,10,14,15,41,57,2,114,6,0,2,9,10,0
67787,60,1118,282,196,195,3,0,86,285,8,130,71,141,138,212,936,1507,4,6538,363,0,2,15,16,0
67807,7,111,44,19,17,0,16,11,44,3,14,7,14,17,21,58,85,1,128,7,0,2,1,2,0
67825,3,63,127,75,83,2,11,30,129,4,14,7,14,18,21,61,87,2,175,9,0,2,1,2,0
67826,3,63,652,304,544,16,6,88,668,6,89,51,101,95,152,591,998,3,3399,188,0,2,1,2,0
67827,3,63,2,2,2,0,0,0,2,0,0,0,0,0,0,0,0,0,0,0,0,2,1,2,0
67828,3,63,8,5,5,0,0,3,8,0,0,0,0,0,0,0,0,0,0,0,0,2,1,2,0
67831,3,63,14,8,8,0,0,6,14,0,0,0,0,0,0,0,0,0,0,0,0,2,1,2,0
67832,3,63,6,4,4,0,0,2,6,0,0,0,0,0,0,0,0,0,0,0,0,2,1,2,0
67833,3,63,6,4,4,0,0,2,6,1,2,1,2,3,3,2,4,0,2,0,0,2,1,2,0
67835,3,63,7,5,5,0,0,2,7,0,0,0,0,0,0,0,0,0,0,0,0,2,1,2,0
67837,3,63,10,6,6,0,0,4,10,0,0,0,0,0,0,0,0,0,0,0,0,2,1,2,0
67838,3,63,1,1,1,0,0,0,1,0,0,0,0,0,0,0,0,0,0,0,0,2,1,2,0
67840,3,63,14,10,10,0,0,4,14,1,1,1,1,2,2,0,2,0,1,0,0,2,1,2,0
67841,3,63,46,26,30,3,0,12,49,3,6,3,6,9,9,20,28,1,42,2,0,2,1,2,0
67888,7,293,72,33,56,0,4,12,72,1,1,1,1,2,2,0,2,0,1,0,0,2,1,2,0
67889,12,226,127,75,83,2,11,30,129,4,14,7,14,18,21,61,87,2,175,9,0,2,1,2,0
67890,12,226,652,304,544,16,6,88,668,6,89,51,101,95,152,591,998,3,3399,188,0,2,1,2,0
67891,12,226,2,2,2,0,0,0,2,0,0,0,0,0,0,0,0,0,0,0,0,2,1,2,0
67892,12,226,8,5,5,0,0,3,8,0,0,0,0,0,0,0,0,0,0,0,0,2,1,2,0
67895,12,226,14,8,8,0,0,6,14,0,0,0,0,0,0,0,0,0,0,0,0,2,1,2,0
67896,12,226,6,4,4,0,0,2,6,0,0,0,0,0,0,0,0,0,0,0,0,2,1,2,0
67897,12,226,6,4,4,0,0,2,6,1,2,1,2,3,3,2,4,0,2,0,0,2,1,2,0
67899,12,226,7,5,5,0,0,2,7,0,0,0,0,0,0,0,0,0,0,0,0,2,1,2,0
67901,12,226,10,6,6,0,0,4,10,0,0,0,0,0,0,0,0,0,0,0,0,2,1,2,0
67902,12,226,1,1,1,0,0,0,1,0,0,0,0,0,0,0,0,0,0,0,0,2,1,2,0
67904,12,226,14,10,10,0,0,4,14,1,1,1,1,2,2,0,2,0,1,0,0,2,1,2,0
67905,12,226,46,26,30,3,0,12,49,3,6,3,6,9,9,20,28,1,42,2,0,2,1,2,0
67923,3,23,14,7,7,2,0,5,16,0,0,0,0,0,0,0,0,0,0,0,0,2,1,2,0
67929,1,92,42,7,35,4,0,5,46,1,2,1,2,3,3,2,4,0,2,0,0,2,0,2,0
67930,1,92,11,6,10,0,0,1,11,2,4,2,4,6,6,10,15,1,15,0,0,2,0,2,0
67954,11,227,19,8,11,5,0,4,24,2,5,3,6,7,9,13,25,1,30,1,0,2,1,6,0
67955,11,227,102,59,69,5,3,24,107,6,22,15,28,28,43,113,206,3,789,43,0,2,1,6,0
67956,11,227,106,40,36,3,49,17,109,8,17,13,23,25,36,93,167,5,904,50,0,2,1,6,0
67980,221,4718,182,127,129,0,0,53,182,5,39,21,42,44,63,217,343,2,926,51,0,2,19,22,0
67981,221,4718,1165,710,800,67,119,181,1232,18,243,153,282,261,435,2000,3492,10,36473,2026,1,2,19,22,0
67982,67,1551,773,419,590,28,0,166,801,10,204,113,217,214,330,1598,2554,5,13587,754,0,2,2,8,0
67983,67,1551,421,273,302,44,34,57,465,17,81,59,107,98,166,583,1098,11,12329,684,0,2,2,8,0
67984,14,404,149,95,105,2,0,41,151,8,54,28,55,62,83,334,494,4,2013,111,0,2,6,11,0
67985,14,404,82,56,54,0,13,15,82,4,13,8,16,17,24,56,98,2,241,13,0,2,6,11,0
67988,25,489,2,2,2,0,0,0,2,0,0,0,0,0,0,0,0,0,0,0,0,2,3,10,0
68002,25,489,99,48,90,1,3,5,100,0,0,0,0,0,0,0,0,0,0,0,0,2,3,10,0
68003,25,489,8,5,5,2,0,1,10,0,0,0,0,0,0,0,0,0,0,0,0,2,3,10,0
68004,25,489,1217,716,841,84,126,174,1301,14,185,118,215,199,333,1446,2542,8,20687,1149,0,2,3,10,0
68005,25,489,160,89,115,0,13,31,160,7,15,11,17,22,28,78,124,3,495,27,0,2,3,10,0
68006,25,489,10,10,9,9,0,0,19,0,0,0,0,0,0,0,0,0,0,0,0,2,3,10,0
68007,25,489,173,84,99,8,29,36,181,5,12,7,13,17,20,54,81,2,221,12,0,2,3,10,0
68008,25,489,3,1,1,3,0,0,6,0,0,0,0,0,0,0,0,0,0,0,0,2,3,10,0
68009,174,5263,1660,832,1314,41,38,274,1701,20,312,209,395,332,604,2671,5058,12,64042,3557,1,2,34,36,0
68010,174,5263,1057,646,719,113,100,145,1170,18,215,134,248,233,382,1740,3004,10,31186,1732,1,2,34,36,0
68011,17,327,95,58,50,9,16,20,104,12,33,24,45,45,69,209,378,8,3100,172,0,2,1,8,0
68012,116,2120,477,336,357,30,23,73,507,16,194,134,250,210,384,1538,2962,10,30538,1696,0,2,43,46,0
68013,90,2017,996,429,845,24,10,117,1020,7,76,50,88,83,138,494,879,4,3565,198,0,2,7,13,0
68014,90,2017,456,277,329,12,42,72,468,13,85,50,97,98,147,592,972,7,7212,400,0,2,7,13,0
68015,160,3411,1513,682,1277,25,13,200,1538,11,199,116,219,210,335,1557,2584,6,15641,868,0,2,19,33,0
68016,160,3411,819,519,539,24,98,155,843,15,96,57,106,111,163,690,1107,8,9171,509,0,2,19,33,0
68017,59,1095,207,111,150,11,0,50,218,5,26,19,36,31,55,133,272,3,943,52,0,2,5,12,0
68018,59,1095,410,198,237,31,55,97,441,11,63,38,72,74,110,414,683,6,4293,238,0,2,5,12,0
68021,235,4869,2,2,2,0,0,0,2,0,0,0,0,0,0,0,0,0,0,0,0,2,20,29,0
68035,235,4869,99,48,90,1,3,5,100,0,0,0,0,0,0,0,0,0,0,0,0,2,20,29,0
68036,235,4869,8,5,5,2,0,1,10,0,0,0,0,0,0,0,0,0,0,0,0,2,20,29,0
68037,235,4869,1217,716,841,84,126,174,1301,14,185,118,215,199,333,1446,2542,8,20687,1149,0,2,20,29,0
68038,235,4869,160,89,115,0,13,31,160,7,15,11,17,22,28,78,124,3,495,27,0,2,20,29,0
68039,235,4869,10,10,9,9,0,0,19,0,0,0,0,0,0,0,0,0,0,0,0,2,20,29,0
68040,235,4869,173,84,99,8,29,36,181,5,12,7,13,17,20,54,81,2,221,12,0,2,20,29,0
68041,235,4869,3,1,1,3,0,0,6,0,0,0,0,0,0,0,0,0,0,0,0,2,20,29,0
68042,98,2010,463,295,324,28,62,57,491,12,134,82,154,146,236,989,1696,6,11700,650,0,2,8,10,0
68045,57,1484,339,213,244,17,9,65,356,10,42,26,48,52,74,259,421,5,2410,133,0,2,11,16,0
68047,90,2288,1455,414,1257,16,76,112,1471,5,41,23,46,46,69,231,381,2,1069,59,0,2,4,9,0
68048,90,2288,669,365,481,22,61,110,691,15,103,63,122,118,185,747,1273,8,11311,628,0,2,4,9,0
68049,251,5822,4293,999,3693,19,54,507,4312,9,155,88,170,164,258,1156,1898,4,9368,520,0,2,18,25,0
68050,251,5822,1482,859,1002,125,135,219,1607,16,219,134,251,235,385,1766,3032,9,27804,1544,1,2,18,25,0
68051,6,128,44,22,19,0,19,6,44,2,10,6,12,12,18,35,64,1,77,4,0,2,0,4,0
68052,31,1078,74,35,59,1,0,14,75,3,14,7,14,17,21,58,85,1,128,7,0,2,9,12,0
68053,31,1078,245,125,200,5,7,34,250,7,30,17,34,37,51,166,265,3,1053,58,0,2,9,12,0
68055,117,3127,1523,757,1297,19,12,193,1542,12,193,117,230,205,347,1508,2664,7,19053,1058,0,2,10,16,0
68056,117,3127,701,378,504,33,58,109,734,13,110,68,126,123,194,794,1346,7,10027,557,0,2,10,16,0
68057,104,2739,773,422,505,30,103,129,803,14,77,46,83,91,129,535,839,7,6334,351,0,2,28,38,0
68058,146,3571,77,34,69,0,0,8,77,3,24,16,29,27,45,114,213,1,387,21,0,2,13,26,0
68059,146,3571,712,438,573,51,9,84,763,14,102,71,128,116,199,733,1364,8,11988,666,0,2,13,26,0
68083,30,657,125,97,103,3,0,19,128,9,25,17,27,34,44,144,223,4,1087,60,0,2,2,5,0
68084,22,367,102,57,55,5,16,25,107,5,17,10,18,22,28,81,124,2,330,18,0,2,2,3,0
68085,71,1560,402,202,227,24,74,80,426,12,52,33,61,64,94,339,564,7,3969,220,0,2,7,9,0
68086,51,1090,447,308,343,6,5,95,453,7,96,59,111,103,170,651,1136,4,4600,255,0,2,13,16,0
68087,51,1090,322,174,179,16,74,51,338,10,41,26,46,51,72,252,408,5,2291,127,0,2,13,16,0
68088,75,1603,53,23,39,0,0,13,53,2,8,4,8,10,12,26,39,1,39,2,0,2,6,14,0
68089,75,1603,515,298,307,33,80,99,548,12,63,44,77,75,121,419,753,7,5527,307,0,2,6,14,0
68090,18,296,424,94,331,4,0,89,428,1,5,5,5,6,10,11,25,0,12,0,0,2,1,8,0
68091,18,296,38,23,23,6,0,8,44,3,11,7,11,14,18,42,68,1,102,5,0,2,1,8,0
68092,19,499,205,80,86,16,53,53,221,7,18,10,19,25,29,94,134,3,497,27,0,2,3,8,0
68093,15,476,184,100,137,2,15,30,186,6,38,20,39,44,59,214,322,3,991,55,0,2,3,10,0
68094,15,476,103,65,74,8,5,16,111,7,17,9,17,24,26,89,119,3,417,23,0,2,3,10,0
68095,58,1189,91,45,69,0,3,18,91,3,9,6,10,12,16,33,57,1,95,5,0,2,5,8,0
68096,58,1189,367,234,237,17,34,68,384,16,55,34,61,71,95,381,584,8,5183,287,0,2,5,8,0
68097,228,5833,722,423,573,19,0,135,741,12,172,101,199,184,300,1320,2257,6,15668,870,0,2,38,43,0
68098,228,5833,1508,847,911,44,250,301,1552,14,148,88,169,162,257,1120,1886,7,15077,837,0,2,38,43,0
68099,314,6872,72,33,56,0,4,12,72,1,1,1,1,2,2,0,2,0,1,0,0,2,20,28,0
68100,314,6872,1454,835,1044,76,110,219,1530,17,275,158,296,292,454,2297,3718,9,34017,1889,1,2,20,28,0
68101,89,1801,757,253,292,73,244,162,830,13,61,38,67,74,105,409,651,7,4654,258,0,2,3,7,0
68102,38,787,386,256,301,16,9,68,402,4,59,35,69,63,104,355,621,2,1453,80,0,2,5,10,0
68103,38,787,264,131,164,11,41,46,275,6,38,22,40,44,62,214,338,3,1068,59,0,2,5,10,0
68104,67,1747,466,257,367,18,25,50,484,7,126,86,171,133,257,898,1813,4,8612,478,0,2,9,19,0
68105,67,1747,507,281,342,29,59,88,536,10,53,29,57,63,86,336,514,5,2764,153,0,2,9,19,0
68106,25,538,215,129,180,6,0,29,221,8,65,43,72,73,115,415,711,4,3153,175,0,2,2,7,0
68107,25,538,97,69,77,3,3,16,100,6,22,13,23,28,36,113,173,3,542,30,0,2,2,7,0
68108,89,1896,1043,504,840,53,9,147,1096,9,180,112,198,189,310,1377,2344,4,11604,644,0,2,9,12,0
68109,89,1896,383,288,292,26,6,62,409,11,65,38,67,76,105,429,656,5,3719,206,0,2,9,12,0
68110,20,408,294,64,250,0,0,43,294,1,20,10,20,21,30,86,131,0,65,3,0,2,0,5,0
68111,20,408,78,46,62,3,0,14,81,3,8,4,8,11,12,28,41,1,62,3,0,2,0,5,0
68112,5,111,110,30,77,3,13,16,113,4,21,15,30,25,45,100,208,2,597,33,0,2,0,5,0
68113,5,111,28,15,21,1,0,6,29,0,0,0,0,0,0,0,0,0,0,0,0,2,0,5,0
68114,40,784,1178,367,1042,6,15,115,1184,9,94,51,95,103,146,644,976,4,4439,246,0,2,0,5,0
68115,40,784,177,108,140,8,0,27,185,6,30,16,32,36,48,162,248,3,794,44,0,2,0,5,0
68118,280,5869,1943,715,1694,26,18,214,1969,12,185,120,237,197,357,1436,2721,7,20915,1161,0,2,19,27,0
68119,280,5869,1168,838,957,57,25,144,1225,19,348,224,416,367,640,3018,5452,11,61921,3440,1,2,19,27,0
68120,19,699,442,244,305,14,16,103,456,11,68,45,75,79,120,452,756,6,4588,254,0,2,2,7,0
68121,19,699,182,102,99,11,40,35,193,3,11,6,11,14,17,42,64,1,97,5,0,2,2,7,0
68122,65,1251,1098,241,925,5,10,155,1103,7,46,25,49,53,74,273,423,3,1580,87,0,2,0,5,0
68123,65,1251,282,202,222,14,2,44,296,8,42,24,43,50,67,250,378,4,1548,86,0,2,0,5,0
68124,2,153,37,13,25,0,6,6,37,1,2,1,2,3,3,2,4,0,2,0,0,2,1,2,0
68125,2,153,133,47,40,1,43,49,134,0,0,0,0,0,0,0,0,0,0,0,0,2,1,2,0
68126,23,630,601,196,481,2,23,85,603,8,63,36,72,71,108,400,664,4,3036,168,0,2,2,7,0
68127,23,630,156,79,106,5,16,28,161,5,14,8,15,19,23,64,97,2,261,14,0,2,2,7,0
68128,104,4398,1289,550,1043,56,32,155,1345,10,167,93,185,177,278,1266,2075,5,11498,638,0,2,10,17,0
68129,31,963,182,127,129,0,0,53,182,5,39,21,42,44,63,217,343,2,926,51,0,2,7,13,0
68130,151,7198,1392,870,1177,35,17,170,1427,14,494,280,531,508,811,4473,7289,7,54850,3047,2,2,15,21,0
68131,95,2843,773,419,590,28,0,166,801,10,204,113,217,214,330,1598,2554,5,13587,754,0,2,17,24,0
68149,14,833,75,38,59,1,3,12,76,2,4,2,4,6,6,10,15,1,15,0,0,2,0,5,0
68238,1,52,14,12,10,0,0,4,14,1,2,1,2,3,3,2,4,0,2,0,0,2,1,2,0
68239,1,55,14,12,10,0,0,4,14,1,2,1,2,3,3,2,4,0,2,0,0,2,1,2,0
68241,1,71,19,18,14,0,0,5,19,1,2,1,2,3,3,2,4,0,2,0,0,2,2,3,0
68354,3,44,15,10,10,0,0,5,15,2,4,2,4,6,6,10,15,1,15,0,0,2,1,2,0
68356,2,33,10,7,7,0,0,3,10,1,2,1,2,3,3,2,4,0,2,0,0,2,1,2,0
68357,3,43,15,9,9,0,0,6,15,1,4,2,4,5,6,8,13,0,6,0,0,2,1,2,0
68393,12,313,149,95,105,2,0,41,151,8,54,28,55,62,83,334,494,4,2013,111,0,2,3,4,0
68394,15,699,139,89,101,2,0,35,141,7,54,34,62,61,96,330,569,4,2287,127,0,2,4,5,0
68395,3,299,149,67,118,4,0,27,153,1,17,14,28,18,42,69,175,0,144,8,0,2,4,10,0
68396,38,2493,1157,318,931,29,22,177,1186,6,104,63,125,110,188,712,1274,3,4596,255,0,2,5,10,0
68397,65,4371,520,294,400,33,13,81,553,10,261,204,367,271,571,2128,4614,7,32445,1802,1,2,3,4,0
68398,90,3959,1338,495,1086,10,64,173,1348,11,122,82,157,133,239,883,1686,7,11934,663,0,2,11,23,0
68399,172,7590,4293,999,3693,19,54,507,4312,9,155,88,170,164,258,1156,1898,4,9368,520,0,2,17,24,0
68400,172,7590,1482,859,1002,125,135,219,1607,16,219,134,251,235,385,1766,3032,9,27804,1544,1,2,17,24,0
68401,33,984,465,148,393,5,8,60,470,4,31,20,31,35,51,161,261,2,523,29,0,2,5,6,0
68402,33,984,16,12,9,0,0,6,16,1,2,1,2,3,3,2,4,0,2,0,0,2,5,6,0
68403,144,5870,1782,648,1425,9,47,279,1791,8,171,97,189,179,286,1292,2140,4,9462,525,0,2,32,34,0
68404,32,968,256,139,192,9,7,47,265,4,23,12,24,27,36,112,171,2,357,19,0,2,4,8,0
68405,6,328,180,34,164,0,0,16,180,1,12,6,12,13,18,43,66,0,33,1,0,2,0,3,0
68406,19,499,102,59,69,5,3,24,107,6,22,15,28,28,43,113,206,3,789,43,0,2,2,7,0
68407,119,4854,1450,624,1228,12,26,181,1462,14,306,186,354,320,540,2580,4493,8,36391,2021,1,2,24,31,0
68408,176,5109,1660,832,1314,41,38,274,1701,20,312,209,395,332,604,2671,5058,12,64042,3557,1,2,14,20,0
68409,49,3780,996,429,845,24,10,117,1020,7,76,50,88,83,138,494,879,4,3565,198,0,2,5,10,0
68410,120,5083,1513,682,1277,25,13,200,1538,11,199,116,219,210,335,1557,2584,6,15641,868,0,2,12,20,0
68411,84,4871,1296,573,1062,40,33,157,1336,8,201,118,231,209,349,1561,2689,4,12365,686,0,2,11,16,0
68412,20,449,207,111,150,11,0,50,218,5,26,19,36,31,55,133,272,3,943,52,0,2,2,7,0
68413,98,5169,1457,730,1242,11,6,188,1468,10,292,166,329,302,495,2424,4078,5,22973,1276,1,2,20,25,0
68414,43,2669,652,304,544,16,6,88,668,6,89,51,101,95,152,591,998,3,3399,188,0,2,3,8,0
68415,72,3231,1455,414,1257,16,76,112,1471,5,41,23,46,46,69,231,381,2,1069,59,0,2,10,19,0
68416,2,44,7,6,5,0,0,2,7,1,1,1,2,2,3,0,3,1,3,0,0,2,0,5,0
68417,8,263,74,35,59,1,0,14,75,3,14,7,14,17,21,58,85,1,128,7,0,2,0,5,0
68418,107,5128,1523,757,1297,19,12,193,1542,12,193,117,230,205,347,1508,2664,7,19053,1058,0,2,14,19,0
68419,70,3177,1020,354,843,12,15,144,1032,8,134,77,144,142,221,970,1580,4,6792,377,0,2,5,11,0
68420,44,2024,447,308,343,6,5,95,453,7,96,59,111,103,170,651,1136,4,4600,255,0,2,8,13,0
68422,21,637,424,94,331,4,0,89,428,1,5,5,5,6,10,11,25,0,12,0,0,2,4,10,0
68423,38,2309,334,251,279,10,4,40,344,5,127,74,143,132,217,899,1528,2,4303,239,0,2,2,7,0
68424,9,423,184,100,137,2,15,30,186,6,38,20,39,44,59,214,322,3,991,55,0,2,5,11,0
68426,75,3937,1293,570,1093,25,15,163,1318,10,195,123,241,205,364,1516,2795,6,17273,959,0,2,5,10,0
68427,29,1873,384,251,317,7,8,52,391,11,70,44,84,81,128,467,811,6,5355,297,0,2,9,15,0
68428,56,2846,722,423,573,19,0,135,741,12,172,101,199,184,300,1320,2257,6,15668,870,0,2,10,15,0
68429,45,1932,386,256,301,16,9,68,402,4,59,35,69,63,104,355,621,2,1453,80,0,2,3,8,0
68430,28,1590,466,257,367,18,25,50,484,7,126,86,171,133,257,898,1813,4,8612,478,0,2,2,3,0
68431,15,1051,215,129,180,6,0,29,221,8,65,43,72,73,115,415,711,4,3153,175,0,2,1,6,0
68432,85,3359,1043,504,840,53,9,147,1096,9,180,112,198,189,310,1377,2344,4,11604,644,0,2,9,16,0
68433,12,466,295,56,236,0,4,54,295,2,9,5,10,11,15,30,51,1,57,3,0,2,0,5,0
68434,30,1422,373,158,315,8,0,51,381,5,76,44,79,81,123,486,779,2,2026,112,0,2,2,7,0
68435,79,3071,1178,367,1042,6,15,115,1184,9,94,51,95,103,146,644,976,4,4439,246,0,2,6,11,0
68437,111,6048,1943,715,1694,26,18,214,1969,12,185,120,237,197,357,1436,2721,7,20915,1161,0,2,26,31,0
68438,35,1473,442,244,305,14,16,103,456,11,68,45,75,79,120,452,756,6,4588,254,0,2,4,9,0
68439,48,1928,1098,241,925,5,10,155,1103,7,46,25,49,53,74,273,423,3,1580,87,0,2,2,7,0
68440,48,1639,601,196,481,2,23,85,603,8,63,36,72,71,108,400,664,4,3036,168,0,2,4,8,0
68441,172,5239,1660,832,1314,41,38,274,1701,20,312,209,395,332,604,2671,5058,12,64042,3557,1,2,3,11,0
68442,172,5239,1057,646,719,113,100,145,1170,18,215,134,248,233,382,1740,3004,10,31186,1732,1,2,3,11,0
68443,174,5041,1660,832,1314,41,38,274,1701,20,312,209,395,332,604,2671,5058,12,64042,3557,1,2,2,27,0
68444,168,5062,1660,832,1314,41,38,274,1701,20,312,209,395,332,604,2671,5058,12,64042,3557,1,2,0,23,0
68445,168,5062,1057,646,719,113,100,145,1170,18,215,134,248,233,382,1740,3004,10,31186,1732,1,2,0,23,0
68446,168,4910,1660,832,1314,41,38,274,1701,20,312,209,395,332,604,2671,5058,12,64042,3557,1,2,0,53,0
68573,7,293,72,33,56,0,4,12,72,1,1,1,1,2,2,0,2,0,1,0,0,2,2,3,0
68614,1,92,42,7,35,4,0,5,46,1,2,1,2,3,3,2,4,0,2,0,0,2,2,6,0
68615,1,92,11,6,10,0,0,1,11,2,4,2,4,6,6,10,15,1,15,0,0,2,2,6,0
68665,221,4718,182,127,129,0,0,53,182,5,39,21,42,44,63,217,343,2,926,51,0,2,65,116,0
68666,221,4718,1165,710,800,67,119,181,1232,18,243,153,282,261,435,2000,3492,10,36473,2026,1,2,65,116,0
68673,25,489,2,2,2,0,0,0,2,0,0,0,0,0,0,0,0,0,0,0,0,2,3,14,0
68687,25,489,99,48,90,1,3,5,100,0,0,0,0,0,0,0,0,0,0,0,0,2,3,14,0
68688,25,489,8,5,5,2,0,1,10,0,0,0,0,0,0,0,0,0,0,0,0,2,3,14,0
68689,25,489,1217,716,841,84,126,174,1301,14,185,118,215,199,333,1446,2542,8,20687,1149,0,2,3,14,0
68690,25,489,160,89,115,0,13,31,160,7,15,11,17,22,28,78,124,3,495,27,0,2,3,14,0
68691,25,489,10,10,9,9,0,0,19,0,0,0,0,0,0,0,0,0,0,0,0,2,3,14,0
68692,25,489,173,84,99,8,29,36,181,5,12,7,13,17,20,54,81,2,221,12,0,2,3,14,0
68693,25,489,3,1,1,3,0,0,6,0,0,0,0,0,0,0,0,0,0,0,0,2,3,14,0
68694,174,5263,1660,832,1314,41,38,274,1701,20,312,209,395,332,604,2671,5058,12,64042,3557,1,2,54,132,0
68695,174,5263,1057,646,719,113,100,145,1170,18,215,134,248,233,382,1740,3004,10,31186,1732,1,2,54,132,0
68697,116,2120,477,336,357,30,23,73,507,16,194,134,250,210,384,1538,2962,10,30538,1696,0,2,44,47,0
68698,90,2017,996,429,845,24,10,117,1020,7,76,50,88,83,138,494,879,4,3565,198,0,2,8,15,0
68699,90,2017,456,277,329,12,42,72,468,13,85,50,97,98,147,592,972,7,7212,400,0,2,8,15,0
68700,160,3411,1513,682,1277,25,13,200,1538,11,199,116,219,210,335,1557,2584,6,15641,868,0,2,23,56,0
68701,160,3411,819,519,539,24,98,155,843,15,96,57,106,111,163,690,1107,8,9171,509,0,2,23,56,0
68702,59,1095,207,111,150,11,0,50,218,5,26,19,36,31,55,133,272,3,943,52,0,2,36,166,0
68703,59,1095,410,198,237,31,55,97,441,11,63,38,72,74,110,414,683,6,4293,238,0,2,36,166,0
68706,235,4869,2,2,2,0,0,0,2,0,0,0,0,0,0,0,0,0,0,0,0,2,22,38,0
68720,235,4869,99,48,90,1,3,5,100,0,0,0,0,0,0,0,0,0,0,0,0,2,22,38,0
68721,235,4869,8,5,5,2,0,1,10,0,0,0,0,0,0,0,0,0,0,0,0,2,22,38,0
68722,235,4869,1217,716,841,84,126,174,1301,14,185,118,215,199,333,1446,2542,8,20687,1149,0,2,22,38,0
68723,235,4869,160,89,115,0,13,31,160,7,15,11,17,22,28,78,124,3,495,27,0,2,22,38,0
68724,235,4869,10,10,9,9,0,0,19,0,0,0,0,0,0,0,0,0,0,0,0,2,22,38,0
68725,235,4869,173,84,99,8,29,36,181,5,12,7,13,17,20,54,81,2,221,12,0,2,22,38,0
68726,235,4869,3,1,1,3,0,0,6,0,0,0,0,0,0,0,0,0,0,0,0,2,22,38,0
68732,90,2288,1455,414,1257,16,76,112,1471,5,41,23,46,46,69,231,381,2,1069,59,0,2,4,36,0
68733,90,2288,669,365,481,22,61,110,691,15,103,63,122,118,185,747,1273,8,11311,628,0,2,4,36,0
68734,251,5822,4293,999,3693,19,54,507,4312,9,155,88,170,164,258,1156,1898,4,9368,520,0,2,19,30,0
68735,251,5822,1482,859,1002,125,135,219,1607,16,219,134,251,235,385,1766,3032,9,27804,1544,1,2,19,30,0
68740,117,3127,1523,757,1297,19,12,193,1542,12,193,117,230,205,347,1508,2664,7,19053,1058,0,2,10,20,0
68741,117,3127,701,378,504,33,58,109,734,13,110,68,126,123,194,794,1346,7,10027,557,0,2,10,20,0
68742,104,2739,773,422,505,30,103,129,803,14,77,46,83,91,129,535,839,7,6334,351,0,2,31,47,0
68743,146,3571,77,34,69,0,0,8,77,3,24,16,29,27,45,114,213,1,387,21,0,2,18,82,0
68744,146,3571,712,438,573,51,9,84,763,14,102,71,128,116,199,733,1364,8,11988,666,0,2,18,82,0
68770,71,1560,402,202,227,24,74,80,426,12,52,33,61,64,94,339,564,7,3969,220,0,2,16,14,0
68771,51,1090,447,308,343,6,5,95,453,7,96,59,111,103,170,651,1136,4,4600,255,0,2,15,30,0
68772,51,1090,322,174,179,16,74,51,338,10,41,26,46,51,72,252,408,5,2291,127,0,2,15,30,0
68778,15,476,184,100,137,2,15,30,186,6,38,20,39,44,59,214,322,3,991,55,0,2,6,22,0
68779,15,476,103,65,74,8,5,16,111,7,17,9,17,24,26,89,119,3,417,23,0,2,6,22,0
68780,58,1189,91,45,69,0,3,18,91,3,9,6,10,12,16,33,57,1,95,5,0,2,8,24,0
68781,58,1189,367,234,237,17,34,68,384,16,55,34,61,71,95,381,584,8,5183,287,0,2,8,24,0
68782,228,5833,722,423,573,19,0,135,741,12,172,101,199,184,300,1320,2257,6,15668,870,0,2,41,61,0
68783,228,5833,1508,847,911,44,250,301,1552,14,148,88,169,162,257,1120,1886,7,15077,837,0,2,41,61,0
68784,314,6872,72,33,56,0,4,12,72,1,1,1,1,2,2,0,2,0,1,0,0,2,22,31,0
68785,314,6872,1454,835,1044,76,110,219,1530,17,275,158,296,292,454,2297,3718,9,34017,1889,1,2,22,31,0
68786,89,1801,757,253,292,73,244,162,830,13,61,38,67,74,105,409,651,7,4654,258,0,2,7,22,0
68787,38,787,386,256,301,16,9,68,402,4,59,35,69,63,104,355,621,2,1453,80,0,2,6,44,0
68788,38,787,264,131,164,11,41,46,275,6,38,22,40,44,62,214,338,3,1068,59,0,2,6,44,0
68799,40,784,1178,367,1042,6,15,115,1184,9,94,51,95,103,146,644,976,4,4439,246,0,2,2,11,0
68800,40,784,177,108,140,8,0,27,185,6,30,16,32,36,48,162,248,3,794,44,0,2,2,11,0
68803,280,5869,1943,715,1694,26,18,214,1969,12,185,120,237,197,357,1436,2721,7,20915,1161,0,2,19,42,0
68804,280,5869,1168,838,957,57,25,144,1225,19,348,224,416,367,640,3018,5452,11,61921,3440,1,2,19,42,0
68805,19,699,442,244,305,14,16,103,456,11,68,45,75,79,120,452,756,6,4588,254,0,2,3,11,0
68806,19,699,182,102,99,11,40,35,193,3,11,6,11,14,17,42,64,1,97,5,0,2,3,11,0
68807,65,1251,1098,241,925,5,10,155,1103,7,46,25,49,53,74,273,423,3,1580,87,0,2,1,25,0
68808,65,1251,282,202,222,14,2,44,296,8,42,24,43,50,67,250,378,4,1548,86,0,2,1,25,0
68811,23,630,601,196,481,2,23,85,603,8,63,36,72,71,108,400,664,4,3036,168,0,2,3,29,0
68812,23,630,156,79,106,5,16,28,161,5,14,8,15,19,23,64,97,2,261,14,0,2,3,29,0
68813,104,4398,1289,550,1043,56,32,155,1345,10,167,93,185,177,278,1266,2075,5,11498,638,0,2,12,29,0
68814,31,963,182,127,129,0,0,53,182,5,39,21,42,44,63,217,343,2,926,51,0,2,12,39,0
68815,151,7198,1392,870,1177,35,17,170,1427,14,494,280,531,508,811,4473,7289,7,54850,3047,2,2,27,46,0
68816,95,2843,773,419,590,28,0,166,801,10,204,113,217,214,330,1598,2554,5,13587,754,0,2,17,26,0
68835,2,58,16,12,9,0,0,6,16,1,2,1,2,3,3,2,4,0,2,0,0,2,1,6,0
69080,3,299,149,67,118,4,0,27,153,1,17,14,28,18,42,69,175,0,144,8,0,2,27,8,0
69082,65,4371,520,294,400,33,13,81,553,10,261,204,367,271,571,2128,4614,7,32445,1802,1,2,3,5,0
69083,90,3959,1338,495,1086,10,64,173,1348,11,122,82,157,133,239,883,1686,7,11934,663,0,2,11,25,0
69088,144,5870,1782,648,1425,9,47,279,1791,8,171,97,189,179,286,1292,2140,4,9462,525,0,2,32,36,0
69089,32,968,256,139,192,9,7,47,265,4,23,12,24,27,36,112,171,2,357,19,0,2,8,23,0
69091,19,499,102,59,69,5,3,24,107,6,22,15,28,28,43,113,206,3,789,43,0,2,3,20,0
69092,119,4854,1450,624,1228,12,26,181,1462,14,306,186,354,320,540,2580,4493,8,36391,2021,1,2,28,95,0
69093,176,5109,1660,832,1314,41,38,274,1701,20,312,209,395,332,604,2671,5058,12,64042,3557,1,2,48,113,0
69095,120,5083,1513,682,1277,25,13,200,1538,11,199,116,219,210,335,1557,2584,6,15641,868,0,2,19,86,0
69096,84,4871,1296,573,1062,40,33,157,1336,8,201,118,231,209,349,1561,2689,4,12365,686,0,2,11,18,0
69097,20,449,207,111,150,11,0,50,218,5,26,19,36,31,55,133,272,3,943,52,0,2,2,14,0
69098,98,5169,1457,730,1242,11,6,188,1468,10,292,166,329,302,495,2424,4078,5,22973,1276,1,2,20,28,0
69100,72,3231,1455,414,1257,16,76,112,1471,5,41,23,46,46,69,231,381,2,1069,59,0,2,13,26,0
69103,107,5128,1523,757,1297,19,12,193,1542,12,193,117,230,205,347,1508,2664,7,19053,1058,0,2,15,22,0
69104,70,3177,1020,354,843,12,15,144,1032,8,134,77,144,142,221,970,1580,4,6792,377,0,2,29,22,0
69105,44,2024,447,308,343,6,5,95,453,7,96,59,111,103,170,651,1136,4,4600,255,0,2,10,35,0
69109,9,423,184,100,137,2,15,30,186,6,38,20,39,44,59,214,322,3,991,55,0,2,9,25,0
69111,75,3937,1293,570,1093,25,15,163,1318,10,195,123,241,205,364,1516,2795,6,17273,959,0,2,10,29,0
69117,85,3359,1043,504,840,53,9,147,1096,9,180,112,198,189,310,1377,2344,4,11604,644,0,2,10,20,0
69120,79,3071,1178,367,1042,6,15,115,1184,9,94,51,95,103,146,644,976,4,4439,246,0,2,7,31,0
69123,35,1473,442,244,305,14,16,103,456,11,68,45,75,79,120,452,756,6,4588,254,0,2,4,12,0
69124,48,1928,1098,241,925,5,10,155,1103,7,46,25,49,53,74,273,423,3,1580,87,0,2,6,21,0
69125,48,1639,601,196,481,2,23,85,603,8,63,36,72,71,108,400,664,4,3036,168,0,2,4,103,0
69126,168,5062,1660,832,1314,41,38,274,1701,20,312,209,395,332,604,2671,5058,12,64042,3557,1,2,0,31,0
69127,168,5062,1057,646,719,113,100,145,1170,18,215,134,248,233,382,1740,3004,10,31186,1732,1,2,0,31,0
69128,168,4910,1660,832,1314,41,38,274,1701,20,312,209,395,332,604,2671,5058,12,64042,3557,1,2,0,78,0
69131,236,4872,2,2,2,0,0,0,2,0,0,0,0,0,0,0,0,0,0,0,0,2,1,1,0
69145,236,4872,99,48,90,1,3,5,100,0,0,0,0,0,0,0,0,0,0,0,0,2,1,1,0
69146,236,4872,8,5,5,2,0,1,10,0,0,0,0,0,0,0,0,0,0,0,0,2,1,1,0
69147,236,4872,1217,716,841,84,126,174,1301,14,185,118,215,199,333,1446,2542,8,20687,1149,0,2,1,1,0
69148,236,4872,160,89,115,0,13,31,160,7,15,11,17,22,28,78,124,3,495,27,0,2,1,1,0
69149,236,4872,10,10,9,9,0,0,19,0,0,0,0,0,0,0,0,0,0,0,0,2,1,1,0
69150,236,4872,173,84,99,8,29,36,181,5,12,7,13,17,20,54,81,2,221,12,0,2,1,1,0
69151,236,4872,3,1,1,3,0,0,6,0,0,0,0,0,0,0,0,0,0,0,0,2,1,1,0
69152,101,5251,1457,730,1242,11,6,188,1468,10,292,166,329,302,495,2424,4078,5,22973,1276,1,2,23,0,0
69153,65,1270,1098,241,925,5,10,155,1103,7,46,25,49,53,74,273,423,3,1580,87,0,2,2,0,0
69154,65,1270,282,202,222,14,2,44,296,8,42,24,43,50,67,250,378,4,1548,86,0,2,2,0,0
69155,49,1964,1098,241,925,5,10,155,1103,7,46,25,49,53,74,273,423,3,1580,87,0,2,23,0,0
69180,18,476,205,80,86,16,53,53,221,7,18,10,19,25,29,94,134,3,497,27,0,2,1,4,0
69181,226,5756,722,423,573,19,0,135,741,12,172,101,199,184,300,1320,2257,6,15668,870,0,2,10,26,0
69182,226,5756,1508,847,911,44,250,301,1552,14,148,88,169,162,257,1120,1886,7,15077,837,0,2,10,26,0
69186,163,4979,1660,832,1314,41,38,274,1701,20,312,209,395,332,604,2671,5058,12,64042,3557,1,2,3,15,1
69187,163,4979,1057,646,719,113,100,145,1170,18,215,134,248,233,382,1740,3004,10,31186,1732,1,2,3,15,1
69188,114,2084,477,336,357,30,23,73,507,16,194,134,250,210,384,1538,2962,10,30538,1696,0,2,2,11,1
69189,59,1095,207,111,150,11,0,50,218,5,26,19,36,31,55,133,272,3,943,52,0,2,1,1,1
69190,59,1095,410,198,237,31,55,97,441,11,63,38,72,74,110,414,683,6,4293,238,0,2,1,1,1
69191,57,1176,91,45,69,0,3,18,91,3,9,6,10,12,16,33,57,1,95,5,0,2,1,3,1
69192,57,1176,367,234,237,17,34,68,384,16,55,34,61,71,95,381,584,8,5183,287,0,2,1,3,1
69193,104,4398,1289,550,1043,56,32,155,1345,10,167,93,185,177,278,1266,2075,5,11498,638,0,2,3,11,1
69194,95,2843,773,419,590,28,0,166,801,10,204,113,217,214,330,1598,2554,5,13587,754,0,2,1,1,1
69195,90,3959,1338,495,1086,10,64,173,1348,11,122,82,157,133,239,883,1686,7,11934,663,0,2,1,1,1
69196,119,4854,1450,624,1228,12,26,181,1462,14,306,186,354,320,540,2580,4493,8,36391,2021,1,2,1,1,1
69197,120,5083,1513,682,1277,25,13,200,1538,11,199,116,219,210,335,1557,2584,6,15641,868,0,2,7,7,1
69198,72,3231,1455,414,1257,16,76,112,1471,5,41,23,46,46,69,231,381,2,1069,59,0,2,2,2,1
69199,107,5128,1523,757,1297,19,12,193,1542,12,193,117,230,205,347,1508,2664,7,19053,1058,0,2,3,3,1
69200,21,637,424,94,331,4,0,89,428,1,5,5,5,6,10,11,25,0,12,0,0,2,1,1,1
69201,56,2845,722,423,573,19,0,135,741,12,172,101,199,184,300,1320,2257,6,15668,870,0,2,3,5,1
69202,85,3340,1043,504,840,53,9,147,1096,9,180,112,198,189,310,1377,2344,4,11604,644,0,2,3,5,1
69203,111,6048,1943,715,1694,26,18,214,1969,12,185,120,237,197,357,1436,2721,7,20915,1161,0,2,0,1,1
69204,48,1639,601,196,481,2,23,85,603,8,63,36,72,71,108,400,664,4,3036,168,0,2,4,4,1
69208,163,4979,1660,832,1314,41,38,274,1701,20,312,209,395,332,604,2671,5058,12,64042,3557,1,2,3,15,0
69209,163,4979,1057,646,719,113,100,145,1170,18,215,134,248,233,382,1740,3004,10,31186,1732,1,2,3,15,0
69210,114,2084,477,336,357,30,23,73,507,16,194,134,250,210,384,1538,2962,10,30538,1696,0,2,2,11,0
69211,59,1095,207,111,150,11,0,50,218,5,26,19,36,31,55,133,272,3,943,52,0,2,1,1,0
69212,59,1095,410,198,237,31,55,97,441,11,63,38,72,74,110,414,683,6,4293,238,0,2,1,1,0
69213,57,1176,91,45,69,0,3,18,91,3,9,6,10,12,16,33,57,1,95,5,0,2,1,3,0
69214,57,1176,367,234,237,17,34,68,384,16,55,34,61,71,95,381,584,8,5183,287,0,2,1,3,0
69215,104,4398,1289,550,1043,56,32,155,1345,10,167,93,185,177,278,1266,2075,5,11498,638,0,2,3,11,0
69217,90,3959,1338,495,1086,10,64,173,1348,11,122,82,157,133,239,883,1686,7,11934,663,0,2,1,1,0
69218,119,4854,1450,624,1228,12,26,181,1462,14,306,186,354,320,540,2580,4493,8,36391,2021,1,2,1,1,0
69219,120,5083,1513,682,1277,25,13,200,1538,11,199,116,219,210,335,1557,2584,6,15641,868,0,2,7,7,0
69220,72,3231,1455,414,1257,16,76,112,1471,5,41,23,46,46,69,231,381,2,1069,59,0,2,2,2,0
69221,107,5128,1523,757,1297,19,12,193,1542,12,193,117,230,205,347,1508,2664,7,19053,1058,0,2,3,3,0
69222,21,637,424,94,331,4,0,89,428,1,5,5,5,6,10,11,25,0,12,0,0,2,1,1,0
69223,56,2845,722,423,573,19,0,135,741,12,172,101,199,184,300,1320,2257,6,15668,870,0,2,3,5,0
69224,85,3340,1043,504,840,53,9,147,1096,9,180,112,198,189,310,1377,2344,4,11604,644,0,2,3,5,0
69225,111,6048,1943,715,1694,26,18,214,1969,12,185,120,237,197,357,1436,2721,7,20915,1161,0,2,0,1,0
69226,48,1639,601,196,481,2,23,85,603,8,63,36,72,71,108,400,664,4,3036,168,0,2,4,4,0
69227,8,210,127,75,83,2,11,30,129,4,14,7,14,18,21,61,87,2,175,9,0,2,15,0,0
69228,8,210,652,304,544,16,6,88,668,6,89,51,101,95,152,591,998,3,3399,188,0,2,15,0,0
69229,8,210,2,2,2,0,0,0,2,0,0,0,0,0,0,0,0,0,0,0,0,2,15,0,0
69230,8,210,8,5,5,0,0,3,8,0,0,0,0,0,0,0,0,0,0,0,0,2,15,0,0
69233,8,210,14,8,8,0,0,6,14,0,0,0,0,0,0,0,0,0,0,0,0,2,15,0,0
69234,8,210,6,4,4,0,0,2,6,0,0,0,0,0,0,0,0,0,0,0,0,2,15,0,0
69235,8,210,6,4,4,0,0,2,6,1,2,1,2,3,3,2,4,0,2,0,0,2,15,0,0
69237,8,210,7,5,5,0,0,2,7,0,0,0,0,0,0,0,0,0,0,0,0,2,15,0,0
69239,8,210,10,6,6,0,0,4,10,0,0,0,0,0,0,0,0,0,0,0,0,2,15,0,0
69240,8,210,1,1,1,0,0,0,1,0,0,0,0,0,0,0,0,0,0,0,0,2,15,0,0
69242,8,210,14,10,10,0,0,4,14,1,1,1,1,2,2,0,2,0,1,0,0,2,15,0,0
69243,8,210,46,26,30,3,0,12,49,3,6,3,6,9,9,20,28,1,42,2,0,2,15,0,0
69261,23,642,601,196,481,2,23,85,603,8,63,36,72,71,108,400,664,4,3036,168,0,2,1,0,1
69262,23,642,156,79,106,5,16,28,161,5,14,8,15,19,23,64,97,2,261,14,0,2,1,0,1
69263,172,7582,4293,999,3693,19,54,507,4312,9,155,88,170,164,258,1156,1898,4,9368,520,0,2,1,2,1
69264,172,7582,1482,859,1002,125,135,219,1607,16,219,134,251,235,385,1766,3032,9,27804,1544,1,2,1,2,1
69265,52,1740,601,196,481,2,23,85,603,8,63,36,72,71,108,400,664,4,3036,168,0,2,31,0,1
69266,105,2754,773,422,505,30,103,129,803,14,77,46,83,91,129,535,839,7,6334,351,0,2,9,4,0
69267,42,2613,1157,318,931,29,22,177,1186,6,104,63,125,110,188,712,1274,3,4596,255,0,2,37,6,0
69270,23,642,601,196,481,2,23,85,603,8,63,36,72,71,108,400,664,4,3036,168,0,2,1,0,0
69271,23,642,156,79,106,5,16,28,161,5,14,8,15,19,23,64,97,2,261,14,0,2,1,0,0
69272,172,7582,4293,999,3693,19,54,507,4312,9,155,88,170,164,258,1156,1898,4,9368,520,0,2,1,2,0
69273,172,7582,1482,859,1002,125,135,219,1607,16,219,134,251,235,385,1766,3032,9,27804,1544,1,2,1,2,0
69274,52,1740,601,196,481,2,23,85,603,8,63,36,72,71,108,400,664,4,3036,168,0,2,31,0,0
69275,219,4666,182,127,129,0,0,53,182,5,39,21,42,44,63,217,343,2,926,51,0,2,0,7,0
69276,219,4666,1165,710,800,67,119,181,1232,18,243,153,282,261,435,2000,3492,10,36473,2026,1,2,0,7,0
69277,150,7150,1392,870,1177,35,17,170,1427,14,494,280,531,508,811,4473,7289,7,54850,3047,2,2,3,11,0
69278,114,2073,477,336,357,30,23,73,507,16,194,134,250,210,384,1538,2962,10,30538,1696,0,2,2,9,0
69279,18,474,205,80,86,16,53,53,221,7,18,10,19,25,29,94,134,3,497,27,0,2,1,1,0
69280,12,314,149,95,105,2,0,41,151,8,54,28,55,62,83,334,494,4,2013,111,0,2,1,1,0
69281,172,7582,4293,999,3693,19,54,507,4312,9,155,88,170,164,258,1156,1898,4,9368,520,0,2,2,2,0
69282,172,7582,1482,859,1002,125,135,219,1607,16,219,134,251,235,385,1766,3032,9,27804,1544,1,2,2,2,0
69283,32,965,256,139,192,9,7,47,265,4,23,12,24,27,36,112,171,2,357,19,0,2,1,1,0
69284,55,2831,722,423,573,19,0,135,741,12,172,101,199,184,300,1320,2257,6,15668,870,0,2,1,6,0
69285,35,1463,442,244,305,14,16,103,456,11,68,45,75,79,120,452,756,6,4588,254,0,2,0,1,0
69299,219,4666,182,127,129,0,0,53,182,5,39,21,42,44,63,217,343,2,926,51,0,2,0,1,0
69300,219,4666,1165,710,800,67,119,181,1232,18,243,153,282,261,435,2000,3492,10,36473,2026,1,2,0,1,0
69301,92,2323,1455,414,1257,16,76,112,1471,5,41,23,46,46,69,231,381,2,1069,59,0,2,13,3,0
69302,92,2323,669,365,481,22,61,110,691,15,103,63,122,118,185,747,1273,8,11311,628,0,2,13,3,0
69303,74,3363,1455,414,1257,16,76,112,1471,5,41,23,46,46,69,231,381,2,1069,59,0,2,24,0,0
69305,14,833,75,38,59,1,3,12,76,2,4,2,4,6,6,10,15,1,15,0,0,2,1,1,0
69310,9,449,219,78,157,11,5,46,230,3,24,20,34,27,54,114,256,2,545,30,0,2,1,1,0
69311,29,461,219,78,157,11,5,46,230,3,24,20,34,27,54,114,256,2,545,30,0,2,2,1,0
69312,29,461,108,64,79,9,0,20,117,5,15,11,19,20,30,70,129,3,410,22,0,2,2,1,0
69313,11,488,219,78,157,11,5,46,230,3,24,20,34,27,54,114,256,2,545,30,0,2,15,11,0
69314,26,435,219,78,157,11,5,46,230,3,24,20,34,27,54,114,256,2,545,30,0,2,0,6,0
69315,26,435,108,64,79,9,0,20,117,5,15,11,19,20,30,70,129,3,410,22,0,2,0,6,0
69316,10,475,219,78,157,11,5,46,230,3,24,20,34,27,54,114,256,2,545,30,0,2,1,7,0
69319,235,4840,2,2,2,0,0,0,2,0,0,0,0,0,0,0,0,0,0,0,0,2,0,11,0
69333,235,4840,99,48,90,1,3,5,100,0,0,0,0,0,0,0,0,0,0,0,0,2,0,11,0
69334,235,4840,8,5,5,2,0,1,10,0,0,0,0,0,0,0,0,0,0,0,0,2,0,11,0
69335,235,4840,1217,716,841,84,126,174,1301,14,185,118,215,199,333,1446,2542,8,20687,1149,0,2,0,11,0
69336,235,4840,160,89,115,0,13,31,160,7,15,11,17,22,28,78,124,3,495,27,0,2,0,11,0
69337,235,4840,10,10,9,9,0,0,19,0,0,0,0,0,0,0,0,0,0,0,0,2,0,11,0
69338,235,4840,173,84,99,8,29,36,181,5,12,7,13,17,20,54,81,2,221,12,0,2,0,11,0
69339,235,4840,3,1,1,3,0,0,6,0,0,0,0,0,0,0,0,0,0,0,0,2,0,11,0
69340,10,475,219,78,157,11,5,46,230,3,24,20,34,27,54,114,256,2,545,30,0,2,2,2,0
69366,235,4842,2,2,2,0,0,0,2,0,0,0,0,0,0,0,0,0,0,0,0,2,2,2,0
69380,235,4842,99,48,90,1,3,5,100,0,0,0,0,0,0,0,0,0,0,0,0,2,2,2,0
69381,235,4842,8,5,5,2,0,1,10,0,0,0,0,0,0,0,0,0,0,0,0,2,2,2,0
69382,235,4842,1217,716,841,84,126,174,1301,14,185,118,215,199,333,1446,2542,8,20687,1149,0,2,2,2,0
69383,235,4842,160,89,115,0,13,31,160,7,15,11,17,22,28,78,124,3,495,27,0,2,2,2,0
69384,235,4842,10,10,9,9,0,0,19,0,0,0,0,0,0,0,0,0,0,0,0,2,2,2,0
69385,235,4842,173,84,99,8,29,36,181,5,12,7,13,17,20,54,81,2,221,12,0,2,2,2,0
69386,235,4842,3,1,1,3,0,0,6,0,0,0,0,0,0,0,0,0,0,0,0,2,2,2,0
69387,146,3595,77,34,69,0,0,8,77,3,24,16,29,27,45,114,213,1,387,21,0,2,17,13,0
69388,146,3595,712,438,573,51,9,84,763,14,102,71,128,116,199,733,1364,8,11988,666,0,2,17,13,0
69389,226,5756,722,423,573,19,0,135,741,12,172,101,199,184,300,1320,2257,6,15668,870,0,2,5,6,0
69390,226,5756,1508,847,911,44,250,301,1552,14,148,88,169,162,257,1120,1886,7,15077,837,0,2,5,6,0
69391,280,5857,1943,715,1694,26,18,214,1969,12,185,120,237,197,357,1436,2721,7,20915,1161,0,2,7,11,0
69392,280,5857,1168,838,957,57,25,144,1225,19,348,224,416,367,640,3018,5452,11,61921,3440,1,2,7,11,0
69393,104,4414,1289,550,1043,56,32,155,1345,10,167,93,185,177,278,1266,2075,5,11498,638,0,2,14,15,0
69394,90,3963,1338,495,1086,10,64,173,1348,11,122,82,157,133,239,883,1686,7,11934,663,0,2,3,3,0
69395,168,4914,1660,832,1314,41,38,274,1701,20,312,209,395,332,604,2671,5058,12,64042,3557,1,2,3,3,0
69396,49,3782,996,429,845,24,10,117,1020,7,76,50,88,83,138,494,879,4,3565,198,0,2,2,2,0
69397,120,5085,1513,682,1277,25,13,200,1538,11,199,116,219,210,335,1557,2584,6,15641,868,0,2,2,2,0
69398,84,4875,1296,573,1062,40,33,157,1336,8,201,118,231,209,349,1561,2689,4,12365,686,0,2,6,7,0
69399,101,5249,1457,730,1242,11,6,188,1468,10,292,166,329,302,495,2424,4078,5,22973,1276,1,2,11,14,0
69400,43,2669,652,304,544,16,6,88,668,6,89,51,101,95,152,591,998,3,3399,188,0,2,7,9,0
69401,8,269,74,35,59,1,0,14,75,3,14,7,14,17,21,58,85,1,128,7,0,2,4,4,0
69402,70,3179,1020,354,843,12,15,144,1032,8,134,77,144,142,221,970,1580,4,6792,377,0,2,2,2,0
69403,29,1875,384,251,317,7,8,52,391,11,70,44,84,81,128,467,811,6,5355,297,0,2,2,2,0
69404,55,2829,722,423,573,19,0,135,741,12,172,101,199,184,300,1320,2257,6,15668,870,0,2,6,8,0
69405,85,3346,1043,504,840,53,9,147,1096,9,180,112,198,189,310,1377,2344,4,11604,644,0,2,3,3,0
69406,30,1424,373,158,315,8,0,51,381,5,76,44,79,81,123,486,779,2,2026,112,0,2,2,2,0
69407,111,6050,1943,715,1694,26,18,214,1969,12,185,120,237,197,357,1436,2721,7,20915,1161,0,2,2,2,0
69408,49,1968,1098,241,925,5,10,155,1103,7,46,25,49,53,74,273,423,3,1580,87,0,2,3,3,0
69409,58,1091,207,111,150,11,0,50,218,5,26,19,36,31,55,133,272,3,943,52,0,2,15,14,0
69410,58,1091,410,198,237,31,55,97,441,11,63,38,72,74,110,414,683,6,4293,238,0,2,15,14,0
69411,251,5809,4293,999,3693,19,54,507,4312,9,155,88,170,164,258,1156,1898,4,9368,520,0,2,1,7,0
69412,251,5809,1482,859,1002,125,135,219,1607,16,219,134,251,235,385,1766,3032,9,27804,1544,1,2,1,7,0
69413,105,2754,773,422,505,30,103,129,803,14,77,46,83,91,129,535,839,7,6334,351,0,2,3,3,0
69414,314,6868,72,33,56,0,4,12,72,1,1,1,1,2,2,0,2,0,1,0,0,2,2,4,0
69415,314,6868,1454,835,1044,76,110,219,1530,17,275,158,296,292,454,2297,3718,9,34017,1889,1,2,2,4,0
69416,89,1799,757,253,292,73,244,162,830,13,61,38,67,74,105,409,651,7,4654,258,0,2,4,2,0
69417,314,6853,72,33,56,0,4,12,72,1,1,1,1,2,2,0,2,0,1,0,0,2,0,2,0
69418,314,6853,1454,835,1044,76,110,219,1530,17,275,158,296,292,454,2297,3718,9,34017,1889,1,2,0,2,0
69419,88,1782,757,253,292,73,244,162,830,13,61,38,67,74,105,409,651,7,4654,258,0,2,0,14,0
69420,144,5870,1782,648,1425,9,47,279,1791,8,171,97,189,179,286,1292,2140,4,9462,525,0,2,1,1,0
69421,111,2037,477,336,357,30,23,73,507,16,194,134,250,210,384,1538,2962,10,30538,1696,0,2,3,11,0
69422,2,183,37,13,25,0,6,6,37,1,2,1,2,3,3,2,4,0,2,0,0,2,20,0,0
69423,2,183,133,47,40,1,43,49,134,0,0,0,0,0,0,0,0,0,0,0,0,2,20,0,0
69424,2,103,37,13,25,0,6,6,37,1,2,1,2,3,3,2,4,0,2,0,0,0,37,0,0
69425,146,3596,77,34,69,0,0,8,77,3,24,16,29,27,45,114,213,1,387,21,0,2,10,2,0
69426,146,3596,712,438,573,51,9,84,763,14,102,71,128,116,199,733,1364,8,11988,666,0,2,10,2,0
69427,146,3596,77,34,69,0,0,8,77,3,24,16,29,27,45,114,213,1,387,21,0,2,1,0,0
69428,146,3596,712,438,573,51,9,84,763,14,102,71,128,116,199,733,1364,8,11988,666,0,2,1,0,0
69432,146,3596,77,34,69,0,0,8,77,3,24,16,29,27,45,114,213,1,387,21,0,2,3,2,0
69433,146,3596,712,438,573,51,9,84,763,14,102,71,128,116,199,733,1364,8,11988,666,0,2,3,2,0
69457,146,3596,77,34,69,0,0,8,77,3,24,16,29,27,45,114,213,1,387,21,0,2,28,14,0
69458,146,3596,712,438,573,51,9,84,763,14,102,71,128,116,199,733,1364,8,11988,666,0,2,28,14,0
69488,314,6853,72,33,56,0,4,12,72,1,1,1,1,2,2,0,2,0,1,0,0,2,2,6,0
69489,314,6853,1454,835,1044,76,110,219,1530,17,275,158,296,292,454,2297,3718,9,34017,1889,1,2,2,6,0
69490,88,1782,757,253,292,73,244,162,830,13,61,38,67,74,105,409,651,7,4654,258,0,2,4,16,0
69492,26,435,219,78,157,11,5,46,230,3,24,20,34,27,54,114,256,2,545,30,0,2,2,7,0
69493,26,435,108,64,79,9,0,20,117,5,15,11,19,20,30,70,129,3,410,22,0,2,2,7,0
69494,10,475,219,78,157,11,5,46,230,3,24,20,34,27,54,114,256,2,545,30,0,2,9,11,0
69495,146,3596,77,34,69,0,0,8,77,3,24,16,29,27,45,114,213,1,387,21,0,2,2,2,0
69496,146,3596,712,438,573,51,9,84,763,14,102,71,128,116,199,733,1364,8,11988,666,0,2,2,2,0
69497,226,5756,722,423,573,19,0,135,741,12,172,101,199,184,300,1320,2257,6,15668,870,0,2,1,1,0
69498,226,5756,1508,847,911,44,250,301,1552,14,148,88,169,162,257,1120,1886,7,15077,837,0,2,1,1,0
69505,236,4874,2,2,2,0,0,0,2,0,0,0,0,0,0,0,0,0,0,0,0,2,2,1,1
69519,236,4874,99,48,90,1,3,5,100,0,0,0,0,0,0,0,0,0,0,0,0,2,2,1,1
69520,236,4874,8,5,5,2,0,1,10,0,0,0,0,0,0,0,0,0,0,0,0,2,2,1,1
69521,236,4874,1217,716,841,84,126,174,1301,14,185,118,215,199,333,1446,2542,8,20687,1149,0,2,2,1,1
69522,236,4874,160,89,115,0,13,31,160,7,15,11,17,22,28,78,124,3,495,27,0,2,2,1,1
69523,236,4874,10,10,9,9,0,0,19,0,0,0,0,0,0,0,0,0,0,0,0,2,2,1,1
69524,236,4874,173,84,99,8,29,36,181,5,12,7,13,17,20,54,81,2,221,12,0,2,2,1,1
69525,236,4874,3,1,1,3,0,0,6,0,0,0,0,0,0,0,0,0,0,0,0,2,2,1,1
69527,15,340,103,47,73,2,12,15,105,5,16,9,17,21,26,75,114,2,303,16,0,0,102,0,1
69528,15,340,86,50,52,8,5,21,94,3,5,3,6,8,9,16,27,1,48,2,0,0,102,0,1
69529,14,833,75,38,59,1,3,12,76,2,4,2,4,6,6,10,15,1,15,0,0,2,8,15,1
69530,8,304,103,47,73,2,12,15,105,5,16,9,17,21,26,75,114,2,303,16,0,0,99,0,1
69531,13,278,103,47,73,2,12,15,105,5,16,9,17,21,26,75,114,2,303,16,0,2,24,40,0
69532,13,278,86,50,52,8,5,21,94,3,5,3,6,8,9,16,27,1,48,2,0,2,24,40,0
69533,8,310,103,47,73,2,12,15,105,5,16,9,17,21,26,75,114,2,303,16,0,2,8,4,0
69534,280,5856,1943,715,1694,26,18,214,1969,12,185,120,237,197,357,1436,2721,7,20915,1161,0,2,1,2,0
69535,280,5856,1168,838,957,57,25,144,1225,19,348,224,416,367,640,3018,5452,11,61921,3440,1,2,1,2,0
69536,1,94,42,7,35,4,0,5,46,1,2,1,2,3,3,2,4,0,2,0,0,2,1,0,1
69537,1,94,11,6,10,0,0,1,11,2,4,2,4,6,6,10,15,1,15,0,0,2,1,0,1
69540,27,542,2,2,2,0,0,0,2,0,0,0,0,0,0,0,0,0,0,0,0,2,7,1,1
69554,27,542,99,48,90,1,3,5,100,0,0,0,0,0,0,0,0,0,0,0,0,2,7,1,1
69555,27,542,8,5,5,2,0,1,10,0,0,0,0,0,0,0,0,0,0,0,0,2,7,1,1
69556,27,542,1217,716,841,84,126,174,1301,14,185,118,215,199,333,1446,2542,8,20687,1149,0,2,7,1,1
69557,27,542,160,89,115,0,13,31,160,7,15,11,17,22,28,78,124,3,495,27,0,2,7,1,1
69558,27,542,10,10,9,9,0,0,19,0,0,0,0,0,0,0,0,0,0,0,0,2,7,1,1
69559,27,542,173,84,99,8,29,36,181,5,12,7,13,17,20,54,81,2,221,12,0,2,7,1,1
69560,27,542,3,1,1,3,0,0,6,0,0,0,0,0,0,0,0,0,0,0,0,2,7,1,1
69561,170,5244,1660,832,1314,41,38,274,1701,20,312,209,395,332,604,2671,5058,12,64042,3557,1,2,66,23,1
69562,170,5244,1057,646,719,113,100,145,1170,18,215,134,248,233,382,1740,3004,10,31186,1732,1,2,66,23,1
69563,111,2040,477,336,357,30,23,73,507,16,194,134,250,210,384,1538,2962,10,30538,1696,0,2,4,0,1
69564,55,670,647,139,84,35,284,233,682,0,0,0,0,0,0,0,0,0,0,0,0,2,15,0,1
69565,103,4384,1289,550,1043,56,32,155,1345,10,167,93,185,177,278,1266,2075,5,11498,638,0,2,0,45,1
69566,32,968,256,139,192,9,7,47,265,4,23,12,24,27,36,112,171,2,357,19,0,2,3,0,1
69567,171,5019,1660,832,1314,41,38,274,1701,20,312,209,395,332,604,2671,5058,12,64042,3557,1,2,51,0,1
69568,170,5218,1660,832,1314,41,38,274,1701,20,312,209,395,332,604,2671,5058,12,64042,3557,1,2,0,5,0
69569,170,5218,1057,646,719,113,100,145,1170,18,215,134,248,233,382,1740,3004,10,31186,1732,1,2,0,5,0
69570,148,4602,1660,832,1314,41,38,274,1701,20,312,209,395,332,604,2671,5058,12,64042,3557,1,2,78,159,1
69571,148,4602,1057,646,719,113,100,145,1170,18,215,134,248,233,382,1740,3004,10,31186,1732,1,2,78,159,1
69572,146,3588,77,34,69,0,0,8,77,3,24,16,29,27,45,114,213,1,387,21,0,2,8,14,1
69573,146,3588,712,438,573,51,9,84,763,14,102,71,128,116,199,733,1364,8,11988,666,0,2,8,14,1
69574,59,1205,91,45,69,0,3,18,91,3,9,6,10,12,16,33,57,1,95,5,0,2,2,0,1
69575,59,1205,367,234,237,17,34,68,384,16,55,34,61,71,95,381,584,8,5183,287,0,2,2,0,1
69576,225,5725,722,423,573,19,0,135,741,12,172,101,199,184,300,1320,2257,6,15668,870,0,2,6,13,1
69577,225,5725,1508,847,911,44,250,301,1552,14,148,88,169,162,257,1120,1886,7,15077,837,0,2,6,13,1
69578,105,4490,1289,550,1043,56,32,155,1345,10,167,93,185,177,278,1266,2075,5,11498,638,0,2,13,0,1
69579,119,4854,1450,624,1228,12,26,181,1462,14,306,186,354,320,540,2580,4493,8,36391,2021,1,2,2,2,1
69580,168,5033,1660,832,1314,41,38,274,1701,20,312,209,395,332,604,2671,5058,12,64042,3557,1,2,62,53,1
69581,9,413,91,45,69,0,3,18,91,3,9,6,10,12,16,33,57,1,95,5,0,2,5,0,1
69582,148,4602,1660,832,1314,41,38,274,1701,20,312,209,395,332,604,2671,5058,12,64042,3557,1,2,78,159,0
69583,148,4602,1057,646,719,113,100,145,1170,18,215,134,248,233,382,1740,3004,10,31186,1732,1,2,78,159,0
69584,146,3588,77,34,69,0,0,8,77,3,24,16,29,27,45,114,213,1,387,21,0,2,8,14,0
69585,146,3588,712,438,573,51,9,84,763,14,102,71,128,116,199,733,1364,8,11988,666,0,2,8,14,0
69586,59,1205,91,45,69,0,3,18,91,3,9,6,10,12,16,33,57,1,95,5,0,2,2,0,0
69587,59,1205,367,234,237,17,34,68,384,16,55,34,61,71,95,381,584,8,5183,287,0,2,2,0,0
69588,225,5725,722,423,573,19,0,135,741,12,172,101,199,184,300,1320,2257,6,15668,870,0,2,6,13,0
69589,225,5725,1508,847,911,44,250,301,1552,14,148,88,169,162,257,1120,1886,7,15077,837,0,2,6,13,0
69590,105,4490,1289,550,1043,56,32,155,1345,10,167,93,185,177,278,1266,2075,5,11498,638,0,2,13,0,0
69591,119,4854,1450,624,1228,12,26,181,1462,14,306,186,354,320,540,2580,4493,8,36391,2021,1,2,2,2,0
69592,168,5033,1660,832,1314,41,38,274,1701,20,312,209,395,332,604,2671,5058,12,64042,3557,1,2,62,53,0
69593,9,413,91,45,69,0,3,18,91,3,9,6,10,12,16,33,57,1,95,5,0,2,5,0,0
69594,17,467,205,80,86,16,53,53,221,7,18,10,19,25,29,94,134,3,497,27,0,2,3,7,0
69600,235,4844,2,2,2,0,0,0,2,0,0,0,0,0,0,0,0,0,0,0,0,2,2,1,0
69614,235,4844,99,48,90,1,3,5,100,0,0,0,0,0,0,0,0,0,0,0,0,2,2,1,0
69615,235,4844,8,5,5,2,0,1,10,0,0,0,0,0,0,0,0,0,0,0,0,2,2,1,0
69616,235,4844,1217,716,841,84,126,174,1301,14,185,118,215,199,333,1446,2542,8,20687,1149,0,2,2,1,0
69617,235,4844,160,89,115,0,13,31,160,7,15,11,17,22,28,78,124,3,495,27,0,2,2,1,0
69618,235,4844,10,10,9,9,0,0,19,0,0,0,0,0,0,0,0,0,0,0,0,2,2,1,0
69619,235,4844,173,84,99,8,29,36,181,5,12,7,13,17,20,54,81,2,221,12,0,2,2,1,0
69620,235,4844,3,1,1,3,0,0,6,0,0,0,0,0,0,0,0,0,0,0,0,2,2,1,0
69622,13,278,103,47,73,2,12,15,105,5,16,9,17,21,26,75,114,2,303,16,0,0,86,0,0
69623,13,278,86,50,52,8,5,21,94,3,5,3,6,8,9,16,27,1,48,2,0,0,86,0,0
69624,14,833,75,38,59,1,3,12,76,2,4,2,4,6,6,10,15,1,15,0,0,2,8,15,0
69625,8,310,103,47,73,2,12,15,105,5,16,9,17,21,26,75,114,2,303,16,0,0,103,0,0
69626,148,4610,1660,832,1314,41,38,274,1701,20,312,209,395,332,604,2671,5058,12,64042,3557,1,2,2,1,0
69627,148,4610,1057,646,719,113,100,145,1170,18,215,134,248,233,382,1740,3004,10,31186,1732,1,2,2,1,0
69628,169,5104,1660,832,1314,41,38,274,1701,20,312,209,395,332,604,2671,5058,12,64042,3557,1,2,18,0,0
69629,71,1562,402,202,227,24,74,80,426,12,52,33,61,64,94,339,564,7,3969,220,0,2,1,4,0
69630,145,5899,1782,648,1425,9,47,279,1791,8,171,97,189,179,286,1292,2140,4,9462,525,0,2,13,0,0
69633,17,382,85,59,61,8,0,16,93,5,18,10,18,23,28,86,126,2,316,17,0,2,1,1,1
69634,12,518,124,78,88,2,3,26,126,4,13,7,13,17,20,56,81,2,163,9,0,2,1,1,1
69635,113,2243,463,295,324,28,62,57,491,12,134,82,154,146,236,989,1696,6,11700,650,0,2,39,0,1
69636,104,4398,1289,550,1043,56,32,155,1345,10,167,93,185,177,278,1266,2075,5,11498,638,0,2,1,1,1
69637,4,166,27,21,21,0,0,6,27,3,6,3,6,9,9,20,28,1,42,2,0,2,1,1,1
69638,120,5083,1513,682,1277,25,13,200,1538,11,199,116,219,210,335,1557,2584,6,15641,868,0,2,1,1,1
69639,38,2301,334,251,279,10,4,40,344,5,127,74,143,132,217,899,1528,2,4303,239,0,2,3,5,1
69640,9,423,184,100,137,2,15,30,186,6,38,20,39,44,59,214,322,3,991,55,0,2,1,1,1
69641,55,670,647,139,84,35,284,233,682,0,0,0,0,0,0,0,0,0,0,0,0,2,7,0,0
69642,169,5193,1660,832,1314,41,38,274,1701,20,312,209,395,332,604,2671,5058,12,64042,3557,1,2,2,7,0
69643,169,5193,1057,646,719,113,100,145,1170,18,215,134,248,233,382,1740,3004,10,31186,1732,1,2,2,7,0
69646,27,542,2,2,2,0,0,0,2,0,0,0,0,0,0,0,0,0,0,0,0,2,5,1,0
69660,27,542,99,48,90,1,3,5,100,0,0,0,0,0,0,0,0,0,0,0,0,2,5,1,0
69661,27,542,8,5,5,2,0,1,10,0,0,0,0,0,0,0,0,0,0,0,0,2,5,1,0
69662,27,542,1217,716,841,84,126,174,1301,14,185,118,215,199,333,1446,2542,8,20687,1149,0,2,5,1,0
69663,27,542,160,89,115,0,13,31,160,7,15,11,17,22,28,78,124,3,495,27,0,2,5,1,0
69664,27,542,10,10,9,9,0,0,19,0,0,0,0,0,0,0,0,0,0,0,0,2,5,1,0
69665,27,542,173,84,99,8,29,36,181,5,12,7,13,17,20,54,81,2,221,12,0,2,5,1,0
69666,27,542,3,1,1,3,0,0,6,0,0,0,0,0,0,0,0,0,0,0,0,2,5,1,0
69667,171,5019,1660,832,1314,41,38,274,1701,20,312,209,395,332,604,2671,5058,12,64042,3557,1,2,3,3,0
69668,17,382,85,59,61,8,0,16,93,5,18,10,18,23,28,86,126,2,316,17,0,2,1,1,0
69669,12,518,124,78,88,2,3,26,126,4,13,7,13,17,20,56,81,2,163,9,0,2,1,1,0
69670,113,2243,463,295,324,28,62,57,491,12,134,82,154,146,236,989,1696,6,11700,650,0,2,39,0,0
69671,104,4398,1289,550,1043,56,32,155,1345,10,167,93,185,177,278,1266,2075,5,11498,638,0,2,1,1,0
69672,4,166,27,21,21,0,0,6,27,3,6,3,6,9,9,20,28,1,42,2,0,2,1,1,0
69673,120,5083,1513,682,1277,25,13,200,1538,11,199,116,219,210,335,1557,2584,6,15641,868,0,2,1,1,0
69674,38,2301,334,251,279,10,4,40,344,5,127,74,143,132,217,899,1528,2,4303,239,0,2,3,5,0
69675,9,423,184,100,137,2,15,30,186,6,38,20,39,44,59,214,322,3,991,55,0,2,1,1,0
69676,149,4616,1660,832,1314,41,38,274,1701,20,312,209,395,332,604,2671,5058,12,64042,3557,1,2,2,0,0
69677,149,4616,1057,646,719,113,100,145,1170,18,215,134,248,233,382,1740,3004,10,31186,1732,1,2,2,0,0
69684,105,4490,1289,550,1043,56,32,155,1345,10,167,93,185,177,278,1266,2075,5,11498,638,0,2,1,1,0
69686,120,5085,1513,682,1277,25,13,200,1538,11,199,116,219,210,335,1557,2584,6,15641,868,0,2,1,1,0
69689,104,4414,1289,550,1043,56,32,155,1345,10,167,93,185,177,278,1266,2075,5,11498,638,0,2,45,0,0
69690,104,4414,1289,550,1043,56,32,155,1345,10,167,93,185,177,278,1266,2075,5,11498,638,0,2,4,1,0
69693,27,566,2,2,2,0,0,0,2,0,0,0,0,0,0,0,0,0,0,0,0,2,8,0,1
69707,27,566,99,48,90,1,3,5,100,0,0,0,0,0,0,0,0,0,0,0,0,2,8,0,1
69708,27,566,8,5,5,2,0,1,10,0,0,0,0,0,0,0,0,0,0,0,0,2,8,0,1
69709,27,566,1217,716,841,84,126,174,1301,14,185,118,215,199,333,1446,2542,8,20687,1149,0,2,8,0,1
69710,27,566,160,89,115,0,13,31,160,7,15,11,17,22,28,78,124,3,495,27,0,2,8,0,1
69711,27,566,10,10,9,9,0,0,19,0,0,0,0,0,0,0,0,0,0,0,0,2,8,0,1
69712,27,566,173,84,99,8,29,36,181,5,12,7,13,17,20,54,81,2,221,12,0,2,8,0,1
69713,27,566,3,1,1,3,0,0,6,0,0,0,0,0,0,0,0,0,0,0,0,2,8,0,1
69714,173,5396,1660,832,1314,41,38,274,1701,20,312,209,395,332,604,2671,5058,12,64042,3557,1,2,66,35,1
69715,173,5396,1057,646,719,113,100,145,1170,18,215,134,248,233,382,1740,3004,10,31186,1732,1,2,66,35,1
69718,235,4848,2,2,2,0,0,0,2,0,0,0,0,0,0,0,0,0,0,0,0,2,4,2,1
69732,235,4848,99,48,90,1,3,5,100,0,0,0,0,0,0,0,0,0,0,0,0,2,4,2,1
69733,235,4848,8,5,5,2,0,1,10,0,0,0,0,0,0,0,0,0,0,0,0,2,4,2,1
69734,235,4848,1217,716,841,84,126,174,1301,14,185,118,215,199,333,1446,2542,8,20687,1149,0,2,4,2,1
69735,235,4848,160,89,115,0,13,31,160,7,15,11,17,22,28,78,124,3,495,27,0,2,4,2,1
69736,235,4848,10,10,9,9,0,0,19,0,0,0,0,0,0,0,0,0,0,0,0,2,4,2,1
69737,235,4848,173,84,99,8,29,36,181,5,12,7,13,17,20,54,81,2,221,12,0,2,4,2,1
69738,235,4848,3,1,1,3,0,0,6,0,0,0,0,0,0,0,0,0,0,0,0,2,4,2,1
69739,55,670,647,139,84,35,284,233,682,0,0,0,0,0,0,0,0,0,0,0,0,2,2,0,1
69740,173,5082,1660,832,1314,41,38,274,1701,20,312,209,395,332,604,2671,5058,12,64042,3557,1,2,33,2,1
69741,55,670,647,139,84,35,284,233,682,0,0,0,0,0,0,0,0,0,0,0,0,2,1,0,0
69742,17,378,85,59,61,8,0,16,93,5,18,10,18,23,28,86,126,2,316,17,0,2,1,1,0
69743,12,515,124,78,88,2,3,26,126,4,13,7,13,17,20,56,81,2,163,9,0,2,1,1,0
69744,4,163,27,21,21,0,0,6,27,3,6,3,6,9,9,20,28,1,42,2,0,2,1,1,0
69745,58,1109,207,111,150,11,0,50,218,5,26,19,36,31,55,133,272,3,943,52,0,2,4,0,0
69746,58,1109,410,198,237,31,55,97,441,11,63,38,72,74,110,414,683,6,4293,238,0,2,4,0,0
69748,251,5809,4293,999,3693,19,54,507,4312,9,155,88,170,164,258,1156,1898,4,9368,520,0,2,1,1,0
69749,251,5809,1482,859,1002,125,135,219,1607,16,219,134,251,235,385,1766,3032,9,27804,1544,1,2,1,1,0
69750,172,7582,4293,999,3693,19,54,507,4312,9,155,88,170,164,258,1156,1898,4,9368,520,0,2,7,4,0
69751,172,7582,1482,859,1002,125,135,219,1607,16,219,134,251,235,385,1766,3032,9,27804,1544,1,2,7,4,0
69752,145,5899,1782,648,1425,9,47,279,1791,8,171,97,189,179,286,1292,2140,4,9462,525,0,2,1,1,0
69758,112,2047,477,336,357,30,23,73,507,16,194,134,250,210,384,1538,2962,10,30538,1696,0,2,4,1,0
69759,121,4896,1450,624,1228,12,26,181,1462,14,306,186,354,320,540,2580,4493,8,36391,2021,1,2,12,0,0
69760,114,2088,477,336,357,30,23,73,507,16,194,134,250,210,384,1538,2962,10,30538,1696,0,2,20,2,0
69761,121,4918,1450,624,1228,12,26,181,1462,14,306,186,354,320,540,2580,4493,8,36391,2021,1,2,19,10,0
69762,149,4624,1660,832,1314,41,38,274,1701,20,312,209,395,332,604,2671,5058,12,64042,3557,1,2,2,0,0
69763,149,4624,1057,646,719,113,100,145,1170,18,215,134,248,233,382,1740,3004,10,31186,1732,1,2,2,0,0
69764,114,2088,477,336,357,30,23,73,507,16,194,134,250,210,384,1538,2962,10,30538,1696,0,2,23,2,0
69765,121,4918,1450,624,1228,12,26,181,1462,14,306,186,354,320,540,2580,4493,8,36391,2021,1,2,21,0,0
69766,173,5396,1660,832,1314,41,38,274,1701,20,312,209,395,332,604,2671,5058,12,64042,3557,1,2,1,1,0
69767,173,5396,1057,646,719,113,100,145,1170,18,215,134,248,233,382,1740,3004,10,31186,1732,1,2,1,1,0
69768,148,4610,1660,832,1314,41,38,274,1701,20,312,209,395,332,604,2671,5058,12,64042,3557,1,2,1,1,0
69769,148,4610,1057,646,719,113,100,145,1170,18,215,134,248,233,382,1740,3004,10,31186,1732,1,2,1,1,0
69770,149,4624,1660,832,1314,41,38,274,1701,20,312,209,395,332,604,2671,5058,12,64042,3557,1,2,1,1,0
69771,149,4624,1057,646,719,113,100,145,1170,18,215,134,248,233,382,1740,3004,10,31186,1732,1,2,1,1,0
69797,27,562,2,2,2,0,0,0,2,0,0,0,0,0,0,0,0,0,0,0,0,2,4,5,0
69811,27,562,99,48,90,1,3,5,100,0,0,0,0,0,0,0,0,0,0,0,0,2,4,5,0
69812,27,562,8,5,5,2,0,1,10,0,0,0,0,0,0,0,0,0,0,0,0,2,4,5,0
69813,27,562,1217,716,841,84,126,174,1301,14,185,118,215,199,333,1446,2542,8,20687,1149,0,2,4,5,0
69814,27,562,160,89,115,0,13,31,160,7,15,11,17,22,28,78,124,3,495,27,0,2,4,5,0
69815,27,562,10,10,9,9,0,0,19,0,0,0,0,0,0,0,0,0,0,0,0,2,4,5,0
69816,27,562,173,84,99,8,29,36,181,5,12,7,13,17,20,54,81,2,221,12,0,2,4,5,0
69817,27,562,3,1,1,3,0,0,6,0,0,0,0,0,0,0,0,0,0,0,0,2,4,5,0
69818,174,5392,1660,832,1314,41,38,274,1701,20,312,209,395,332,604,2671,5058,12,64042,3557,1,2,7,3,0
69819,174,5392,1057,646,719,113,100,145,1170,18,215,134,248,233,382,1740,3004,10,31186,1732,1,2,7,3,0
69820,55,670,647,139,84,35,284,233,682,0,0,0,0,0,0,0,0,0,0,0,0,2,1,1,0
69821,173,5098,1660,832,1314,41,38,274,1701,20,312,209,395,332,604,2671,5058,12,64042,3557,1,2,19,2,0
69822,174,5392,1660,832,1314,41,38,274,1701,20,312,209,395,332,604,2671,5058,12,64042,3557,1,2,3,1,0
69823,174,5392,1057,646,719,113,100,145,1170,18,215,134,248,233,382,1740,3004,10,31186,1732,1,2,3,1,0
69824,173,5098,1660,832,1314,41,38,274,1701,20,312,209,395,332,604,2671,5058,12,64042,3557,1,2,12,7,0
69827,235,4842,2,2,2,0,0,0,2,0,0,0,0,0,0,0,0,0,0,0,0,2,2,4,0
69841,235,4842,99,48,90,1,3,5,100,0,0,0,0,0,0,0,0,0,0,0,0,2,2,4,0
69842,235,4842,8,5,5,2,0,1,10,0,0,0,0,0,0,0,0,0,0,0,0,2,2,4,0
69843,235,4842,1217,716,841,84,126,174,1301,14,185,118,215,199,333,1446,2542,8,20687,1149,0,2,2,4,0
69844,235,4842,160,89,115,0,13,31,160,7,15,11,17,22,28,78,124,3,495,27,0,2,2,4,0
69845,235,4842,10,10,9,9,0,0,19,0,0,0,0,0,0,0,0,0,0,0,0,2,2,4,0
69846,235,4842,173,84,99,8,29,36,181,5,12,7,13,17,20,54,81,2,221,12,0,2,2,4,0
69847,235,4842,3,1,1,3,0,0,6,0,0,0,0,0,0,0,0,0,0,0,0,2,2,4,0
69848,174,5414,1660,832,1314,41,38,274,1701,20,312,209,395,332,604,2671,5058,12,64042,3557,1,2,18,9,0
69849,174,5414,1057,646,719,113,100,145,1170,18,215,134,248,233,382,1740,3004,10,31186,1732,1,2,18,9,0
69850,160,5064,1660,832,1314,41,38,274,1701,20,312,209,395,332,604,2671,5058,12,64042,3557,1,2,82,159,0
69851,160,5064,1057,646,719,113,100,145,1170,18,215,134,248,233,382,1740,3004,10,31186,1732,1,2,82,159,0
69852,114,2091,477,336,357,30,23,73,507,16,194,134,250,210,384,1538,2962,10,30538,1696,0,2,23,2,0
69890,105,4490,1289,550,1043,56,32,155,1345,10,167,93,185,177,278,1266,2075,5,11498,638,0,2,14,1,0
69893,121,4918,1450,624,1228,12,26,181,1462,14,306,186,354,320,540,2580,4493,8,36391,2021,1,2,23,2,0
69894,174,5288,1660,832,1314,41,38,274,1701,20,312,209,395,332,604,2671,5058,12,64042,3557,1,2,80,53,0
69900,160,5080,1660,832,1314,41,38,274,1701,20,312,209,395,332,604,2671,5058,12,64042,3557,1,2,7,7,0
69901,160,5080,1057,646,719,113,100,145,1170,18,215,134,248,233,382,1740,3004,10,31186,1732,1,2,7,7,0
69902,160,5080,1660,832,1314,41,38,274,1701,20,312,209,395,332,604,2671,5058,12,64042,3557,1,2,1,1,0
69903,160,5080,1057,646,719,113,100,145,1170,18,215,134,248,233,382,1740,3004,10,31186,1732,1,2,1,1,0
69906,27,562,2,2,2,0,0,0,2,0,0,0,0,0,0,0,0,0,0,0,0,2,1,1,0
69920,27,562,99,48,90,1,3,5,100,0,0,0,0,0,0,0,0,0,0,0,0,2,1,1,0
69921,27,562,8,5,5,2,0,1,10,0,0,0,0,0,0,0,0,0,0,0,0,2,1,1,0
69922,27,562,1217,716,841,84,126,174,1301,14,185,118,215,199,333,1446,2542,8,20687,1149,0,2,1,1,0
69923,27,562,160,89,115,0,13,31,160,7,15,11,17,22,28,78,124,3,495,27,0,2,1,1,0
69924,27,562,10,10,9,9,0,0,19,0,0,0,0,0,0,0,0,0,0,0,0,2,1,1,0
69925,27,562,173,84,99,8,29,36,181,5,12,7,13,17,20,54,81,2,221,12,0,2,1,1,0
69926,27,562,3,1,1,3,0,0,6,0,0,0,0,0,0,0,0,0,0,0,0,2,1,1,0
69927,175,5312,1660,832,1314,41,38,274,1701,20,312,209,395,332,604,2671,5058,12,64042,3557,1,2,4,0,0
69928,160,5086,1660,832,1314,41,38,274,1701,20,312,209,395,332,604,2671,5058,12,64042,3557,1,2,1,1,0
69929,160,5086,1057,646,719,113,100,145,1170,18,215,134,248,233,382,1740,3004,10,31186,1732,1,2,1,1,0
69930,55,670,647,139,84,35,284,233,682,0,0,0,0,0,0,0,0,0,0,0,0,2,18,7,0
69931,160,5078,1660,832,1314,41,38,274,1701,20,312,209,395,332,604,2671,5058,12,64042,3557,1,2,4,4,0
69932,160,5078,1057,646,719,113,100,145,1170,18,215,134,248,233,382,1740,3004,10,31186,1732,1,2,4,4,0
69942,1,94,42,7,35,4,0,5,46,1,2,1,2,3,3,2,4,0,2,0,0,2,1,0,0
69943,1,94,11,6,10,0,0,1,11,2,4,2,4,6,6,10,15,1,15,0,0,2,1,0,0
69946,27,562,2,2,2,0,0,0,2,0,0,0,0,0,0,0,0,0,0,0,0,2,18,1,0
69960,27,562,99,48,90,1,3,5,100,0,0,0,0,0,0,0,0,0,0,0,0,2,18,1,0
69961,27,562,8,5,5,2,0,1,10,0,0,0,0,0,0,0,0,0,0,0,0,2,18,1,0
69962,27,562,1217,716,841,84,126,174,1301,14,185,118,215,199,333,1446,2542,8,20687,1149,0,2,18,1,0
69963,27,562,160,89,115,0,13,31,160,7,15,11,17,22,28,78,124,3,495,27,0,2,18,1,0
69964,27,562,10,10,9,9,0,0,19,0,0,0,0,0,0,0,0,0,0,0,0,2,18,1,0
69965,27,562,173,84,99,8,29,36,181,5,12,7,13,17,20,54,81,2,221,12,0,2,18,1,0
69966,27,562,3,1,1,3,0,0,6,0,0,0,0,0,0,0,0,0,0,0,0,2,18,1,0
69967,160,5078,1660,832,1314,41,38,274,1701,20,312,209,395,332,604,2671,5058,12,64042,3557,1,2,116,36,0
69968,160,5078,1057,646,719,113,100,145,1170,18,215,134,248,233,382,1740,3004,10,31186,1732,1,2,116,36,0
69969,114,2091,477,336,357,30,23,73,507,16,194,134,250,210,384,1538,2962,10,30538,1696,0,2,4,0,0
69970,55,670,647,139,84,35,284,233,682,0,0,0,0,0,0,0,0,0,0,0,0,2,36,0,0
69971,105,4490,1289,550,1043,56,32,155,1345,10,167,93,185,177,278,1266,2075,5,11498,638,0,2,4,1,0
69972,32,968,256,139,192,9,7,47,265,4,23,12,24,27,36,112,171,2,357,19,0,2,3,0,0
69973,175,5312,1660,832,1314,41,38,274,1701,20,312,209,395,332,604,2671,5058,12,64042,3557,1,2,112,0,0
69974,159,5037,1660,832,1314,41,38,274,1701,20,312,209,395,332,604,2671,5058,12,64042,3557,1,2,8,20,0
69975,159,5037,1057,646,719,113,100,145,1170,18,215,134,248,233,382,1740,3004,10,31186,1732,1,2,8,20,0
69978,146,3590,77,34,69,0,0,8,77,3,24,16,29,27,45,114,213,1,387,21,0,2,4,1,0
69979,146,3590,712,438,573,51,9,84,763,14,102,71,128,116,199,733,1364,8,11988,666,0,2,4,1,0
69980,106,4541,1289,550,1043,56,32,155,1345,10,167,93,185,177,278,1266,2075,5,11498,638,0,2,6,0,0
69984,75,1605,53,23,39,0,0,13,53,2,8,4,8,10,12,26,39,1,39,2,0,2,1,1,0
69985,75,1605,515,298,307,33,80,99,548,12,63,44,77,75,121,419,753,7,5527,307,0,2,1,1,0
69986,102,5281,1457,730,1242,11,6,188,1468,10,292,166,329,302,495,2424,4078,5,22973,1276,1,2,8,2,0
69990,91,2310,1455,414,1257,16,76,112,1471,5,41,23,46,46,69,231,381,2,1069,59,0,2,19,22,0
69991,91,2310,669,365,481,22,61,110,691,15,103,63,122,118,185,747,1273,8,11311,628,0,2,19,22,0
69992,1,92,42,7,35,4,0,5,46,1,2,1,2,3,3,2,4,0,2,0,0,2,0,1,1
69993,1,92,11,6,10,0,0,1,11,2,4,2,4,6,6,10,15,1,15,0,0,2,0,1,1
69994,180,5373,1660,832,1314,41,38,274,1701,20,312,209,395,332,604,2671,5058,12,64042,3557,1,2,66,6,1
69995,180,5373,1057,646,719,113,100,145,1170,18,215,134,248,233,382,1740,3004,10,31186,1732,1,2,66,6,1
69996,179,5679,1660,832,1314,41,38,274,1701,20,312,209,395,332,604,2671,5058,12,64042,3557,1,2,131,47,1
69999,180,5373,1660,832,1314,41,38,274,1701,20,312,209,395,332,604,2671,5058,12,64042,3557,1,2,66,6,0
70000,180,5373,1057,646,719,113,100,145,1170,18,215,134,248,233,382,1740,3004,10,31186,1732,1,2,66,6,0
70001,179,5679,1660,832,1314,41,38,274,1701,20,312,209,395,332,604,2671,5058,12,64042,3557,1,2,131,47,0
70002,60,1136,282,196,195,3,0,86,285,8,130,71,141,138,212,936,1507,4,6538,363,0,2,3,2,0
70003,7,289,72,33,56,0,4,12,72,1,1,1,1,2,2,0,2,0,1,0,0,2,2,2,0
70012,219,4666,182,127,129,0,0,53,182,5,39,21,42,44,63,217,343,2,926,51,0,2,0,8,0
70013,219,4666,1165,710,800,67,119,181,1232,18,243,153,282,261,435,2000,3492,10,36473,2026,1,2,0,8,0
70037,180,5373,1660,832,1314,41,38,274,1701,20,312,209,395,332,604,2671,5058,12,64042,3557,1,2,259,252,0
70038,180,5373,1057,646,719,113,100,145,1170,18,215,134,248,233,382,1740,3004,10,31186,1732,1,2,259,252,0
70039,114,2091,477,336,357,30,23,73,507,16,194,134,250,210,384,1538,2962,10,30538,1696,0,2,33,32,0
70040,58,1109,207,111,150,11,0,50,218,5,26,19,36,31,55,133,272,3,943,52,0,2,20,15,0
70041,58,1109,410,198,237,31,55,97,441,11,63,38,72,74,110,414,683,6,4293,238,0,2,20,15,0
70044,235,4844,2,2,2,0,0,0,2,0,0,0,0,0,0,0,0,0,0,0,0,2,5,15,0
70058,235,4844,99,48,90,1,3,5,100,0,0,0,0,0,0,0,0,0,0,0,0,2,5,15,0
70059,235,4844,8,5,5,2,0,1,10,0,0,0,0,0,0,0,0,0,0,0,0,2,5,15,0
70060,235,4844,1217,716,841,84,126,174,1301,14,185,118,215,199,333,1446,2542,8,20687,1149,0,2,5,15,0
70061,235,4844,160,89,115,0,13,31,160,7,15,11,17,22,28,78,124,3,495,27,0,2,5,15,0
70062,235,4844,10,10,9,9,0,0,19,0,0,0,0,0,0,0,0,0,0,0,0,2,5,15,0
70063,235,4844,173,84,99,8,29,36,181,5,12,7,13,17,20,54,81,2,221,12,0,2,5,15,0
70064,235,4844,3,1,1,3,0,0,6,0,0,0,0,0,0,0,0,0,0,0,0,2,5,15,0
70066,91,2310,1455,414,1257,16,76,112,1471,5,41,23,46,46,69,231,381,2,1069,59,0,2,20,13,0
70067,91,2310,669,365,481,22,61,110,691,15,103,63,122,118,185,747,1273,8,11311,628,0,2,20,13,0
70070,251,5809,4293,999,3693,19,54,507,4312,9,155,88,170,164,258,1156,1898,4,9368,520,0,2,2,8,0
70071,251,5809,1482,859,1002,125,135,219,1607,16,219,134,251,235,385,1766,3032,9,27804,1544,1,2,2,8,0
70073,105,2754,773,422,505,30,103,129,803,14,77,46,83,91,129,535,839,7,6334,351,0,2,12,7,0
70074,146,3590,77,34,69,0,0,8,77,3,24,16,29,27,45,114,213,1,387,21,0,2,39,28,0
70075,146,3590,712,438,573,51,9,84,763,14,102,71,128,116,199,733,1364,8,11988,666,0,2,39,28,0
70079,17,467,205,80,86,16,53,53,221,7,18,10,19,25,29,94,134,3,497,27,0,2,5,12,0
70080,59,1205,91,45,69,0,3,18,91,3,9,6,10,12,16,33,57,1,95,5,0,2,3,3,0
70081,59,1205,367,234,237,17,34,68,384,16,55,34,61,71,95,381,584,8,5183,287,0,2,3,3,0
70082,225,5725,722,423,573,19,0,135,741,12,172,101,199,184,300,1320,2257,6,15668,870,0,2,19,43,0
70083,225,5725,1508,847,911,44,250,301,1552,14,148,88,169,162,257,1120,1886,7,15077,837,0,2,19,43,0
70089,280,5856,1943,715,1694,26,18,214,1969,12,185,120,237,197,357,1436,2721,7,20915,1161,0,2,8,13,0
70090,280,5856,1168,838,957,57,25,144,1225,19,348,224,416,367,640,3018,5452,11,61921,3440,1,2,8,13,0
70097,106,4541,1289,550,1043,56,32,155,1345,10,167,93,185,177,278,1266,2075,5,11498,638,0,2,40,27,0
70117,14,833,75,38,59,1,3,12,76,2,4,2,4,6,6,10,15,1,15,0,0,2,9,16,0
70121,90,3963,1338,495,1086,10,64,173,1348,11,122,82,157,133,239,883,1686,7,11934,663,0,2,4,4,0
70122,172,7582,4293,999,3693,19,54,507,4312,9,155,88,170,164,258,1156,1898,4,9368,520,0,2,10,8,0
70123,172,7582,1482,859,1002,125,135,219,1607,16,219,134,251,235,385,1766,3032,9,27804,1544,1,2,10,8,0
70124,145,5899,1782,648,1425,9,47,279,1791,8,171,97,189,179,286,1292,2140,4,9462,525,0,2,15,2,0
70125,32,968,256,139,192,9,7,47,265,4,23,12,24,27,36,112,171,2,357,19,0,2,4,1,0
70126,121,4918,1450,624,1228,12,26,181,1462,14,306,186,354,320,540,2580,4493,8,36391,2021,1,2,24,3,0
70127,179,5679,1660,832,1314,41,38,274,1701,20,312,209,395,332,604,2671,5058,12,64042,3557,1,2,297,152,0
70129,120,5085,1513,682,1277,25,13,200,1538,11,199,116,219,210,335,1557,2584,6,15641,868,0,2,9,9,0
70131,102,5281,1457,730,1242,11,6,188,1468,10,292,166,329,302,495,2424,4078,5,22973,1276,1,2,42,16,0
70133,74,3363,1455,414,1257,16,76,112,1471,5,41,23,46,46,69,231,381,2,1069,59,0,2,26,2,0
70141,55,2829,722,423,573,19,0,135,741,12,172,101,199,184,300,1320,2257,6,15668,870,0,2,10,19,0
70142,85,3346,1043,504,840,53,9,147,1096,9,180,112,198,189,310,1377,2344,4,11604,644,0,2,6,8,0
70145,111,6050,1943,715,1694,26,18,214,1969,12,185,120,237,197,357,1436,2721,7,20915,1161,0,2,2,3,0
70147,49,1968,1098,241,925,5,10,155,1103,7,46,25,49,53,74,273,423,3,1580,87,0,2,26,3,0
70149,52,1740,601,196,481,2,23,85,603,8,63,36,72,71,108,400,664,4,3036,168,0,2,35,4,0
70150,113,2243,463,295,324,28,62,57,491,12,134,82,154,146,236,989,1696,6,11700,650,0,2,1,1,0
70153,250,5777,4293,999,3693,19,54,507,4312,9,155,88,170,164,258,1156,1898,4,9368,520,0,2,0,7,0
70154,250,5777,1482,859,1002,125,135,219,1607,16,219,134,251,235,385,1766,3032,9,27804,1544,1,2,0,7,0
70155,13,817,75,38,59,1,3,12,76,2,4,2,4,6,6,10,15,1,15,0,0,2,0,4,0
70156,170,7532,4293,999,3693,19,54,507,4312,9,155,88,170,164,258,1156,1898,4,9368,520,0,2,16,30,0
70157,170,7532,1482,859,1002,125,135,219,1607,16,219,134,251,235,385,1766,3032,9,27804,1544,1,2,16,30,0
70159,87,1703,757,253,292,73,244,162,830,13,61,38,67,74,105,409,651,7,4654,258,0,2,4,16,1
70160,38,712,386,256,301,16,9,68,402,4,59,35,69,63,104,355,621,2,1453,80,0,2,4,14,1
70161,38,712,264,131,164,11,41,46,275,6,38,22,40,44,62,214,338,3,1068,59,0,2,4,14,1
70162,30,879,256,139,192,9,7,47,265,4,23,12,24,27,36,112,171,2,357,19,0,2,8,22,1
70163,70,3178,1020,354,843,12,15,144,1032,8,134,77,144,142,221,970,1580,4,6792,377,0,2,2,1,1
70164,45,1930,386,256,301,16,9,68,402,4,59,35,69,63,104,355,621,2,1453,80,0,2,10,16,1
70166,86,1672,757,253,292,73,244,162,830,13,61,38,67,74,105,409,651,7,4654,258,0,2,0,7,0
70167,12,788,75,38,59,1,3,12,76,2,4,2,4,6,6,10,15,1,15,0,0,2,0,6,0
70168,28,820,256,139,192,9,7,47,265,4,23,12,24,27,36,112,171,2,357,19,0,2,0,12,0
70170,70,1518,402,202,227,24,74,80,426,12,52,33,61,64,94,339,564,7,3969,220,0,2,6,14,0
70171,85,1663,757,253,292,73,244,162,830,13,61,38,67,74,105,409,651,7,4654,258,0,2,3,5,0
70172,38,702,386,256,301,16,9,68,402,4,59,35,69,63,104,355,621,2,1453,80,0,2,6,7,0
70173,38,702,264,131,164,11,41,46,275,6,38,22,40,44,62,214,338,3,1068,59,0,2,6,7,0
70174,11,753,75,38,59,1,3,12,76,2,4,2,4,6,6,10,15,1,15,0,0,2,0,9,0
70175,69,3112,1020,354,843,12,15,144,1032,8,134,77,144,142,221,970,1580,4,6792,377,0,2,0,13,0
70178,236,4859,2,2,2,0,0,0,2,0,0,0,0,0,0,0,0,0,0,0,0,2,14,10,0
70192,236,4859,99,48,90,1,3,5,100,0,0,0,0,0,0,0,0,0,0,0,0,2,14,10,0
70193,236,4859,8,5,5,2,0,1,10,0,0,0,0,0,0,0,0,0,0,0,0,2,14,10,0
70194,236,4859,1217,716,841,84,126,174,1301,14,185,118,215,199,333,1446,2542,8,20687,1149,0,2,14,10,0
70195,236,4859,160,89,115,0,13,31,160,7,15,11,17,22,28,78,124,3,495,27,0,2,14,10,0
70196,236,4859,10,10,9,9,0,0,19,0,0,0,0,0,0,0,0,0,0,0,0,2,14,10,0
70197,236,4859,173,84,99,8,29,36,181,5,12,7,13,17,20,54,81,2,221,12,0,2,14,10,0
70198,236,4859,3,1,1,3,0,0,6,0,0,0,0,0,0,0,0,0,0,0,0,2,14,10,0
70200,7,287,75,38,59,1,3,12,76,2,4,2,4,6,6,10,15,1,15,0,0,2,0,118,0
70201,106,5687,1457,730,1242,11,6,188,1468,10,292,166,329,302,495,2424,4078,5,22973,1276,1,2,114,0,0
70202,55,761,167,116,138,4,5,22,171,8,48,30,56,56,86,292,499,4,2330,129,0,2,3,4,0
70204,5,216,75,38,59,1,3,12,76,2,4,2,4,6,6,10,15,1,15,0,0,2,0,24,0
70205,108,5765,1457,730,1242,11,6,188,1468,10,292,166,329,302,495,2424,4078,5,22973,1276,1,2,24,0,0
70207,141,3466,77,34,69,0,0,8,77,3,24,16,29,27,45,114,213,1,387,21,0,2,0,22,0
70208,141,3466,712,438,573,51,9,84,763,14,102,71,128,116,199,733,1364,8,11988,666,0,2,0,22,0
70209,55,2824,722,423,573,19,0,135,741,12,172,101,199,184,300,1320,2257,6,15668,870,0,2,1,2,0
70211,18,638,442,244,305,14,16,103,456,11,68,45,75,79,120,452,756,6,4588,254,0,2,0,15,0
70212,18,638,182,102,99,11,40,35,193,3,11,6,11,14,17,42,64,1,97,5,0,2,0,15,0
70213,34,1434,442,244,305,14,16,103,456,11,68,45,75,79,120,452,756,6,4588,254,0,2,6,10,0
70215,314,6847,72,33,56,0,4,12,72,1,1,1,1,2,2,0,2,0,1,0,0,2,3,2,0
70216,314,6847,1454,835,1044,76,110,219,1530,17,275,158,296,292,454,2297,3718,9,34017,1889,1,2,3,2,0
70218,54,640,647,139,84,35,284,233,682,0,0,0,0,0,0,0,0,0,0,0,0,2,0,22,0
70219,2,173,37,13,25,0,6,6,37,1,2,1,2,3,3,2,4,0,2,0,0,2,0,10,0
70220,2,173,133,47,40,1,43,49,134,0,0,0,0,0,0,0,0,0,0,0,0,2,0,10,0
70221,23,615,601,196,481,2,23,85,603,8,63,36,72,71,108,400,664,4,3036,168,0,2,0,5,0
70222,23,615,156,79,106,5,16,28,161,5,14,8,15,19,23,64,97,2,261,14,0,2,0,5,0
70223,106,4531,1289,550,1043,56,32,155,1345,10,167,93,185,177,278,1266,2075,5,11498,638,0,2,2,5,0
70224,170,7525,4293,999,3693,19,54,507,4312,9,155,88,170,164,258,1156,1898,4,9368,520,0,2,1,2,0
70225,170,7525,1482,859,1002,125,135,219,1607,16,219,134,251,235,385,1766,3032,9,27804,1544,1,2,1,2,0
70226,145,5874,1782,648,1425,9,47,279,1791,8,171,97,189,179,286,1292,2140,4,9462,525,0,2,13,14,0
70227,69,3090,1020,354,843,12,15,144,1032,8,134,77,144,142,221,970,1580,4,6792,377,0,2,3,9,0
70228,34,1424,442,244,305,14,16,103,456,11,68,45,75,79,120,452,756,6,4588,254,0,2,1,4,0
70229,48,1651,601,196,481,2,23,85,603,8,63,36,72,71,108,400,664,4,3036,168,0,2,8,31,0
70231,250,5776,4293,999,3693,19,54,507,4312,9,155,88,170,164,258,1156,1898,4,9368,520,0,2,6,4,0
70232,250,5776,1482,859,1002,125,135,219,1607,16,219,134,251,235,385,1766,3032,9,27804,1544,1,2,6,4,0
70233,59,1116,207,111,150,11,0,50,218,5,26,19,36,31,55,133,272,3,943,52,0,2,2,2,1
70234,59,1116,410,198,237,31,55,97,441,11,63,38,72,74,110,414,683,6,4293,238,0,2,2,2,1
70237,236,4863,2,2,2,0,0,0,2,0,0,0,0,0,0,0,0,0,0,0,0,2,1,0,1
70251,236,4863,99,48,90,1,3,5,100,0,0,0,0,0,0,0,0,0,0,0,0,2,1,0,1
70252,236,4863,8,5,5,2,0,1,10,0,0,0,0,0,0,0,0,0,0,0,0,2,1,0,1
70253,236,4863,1217,716,841,84,126,174,1301,14,185,118,215,199,333,1446,2542,8,20687,1149,0,2,1,0,1
70254,236,4863,160,89,115,0,13,31,160,7,15,11,17,22,28,78,124,3,495,27,0,2,1,0,1
70255,236,4863,10,10,9,9,0,0,19,0,0,0,0,0,0,0,0,0,0,0,0,2,1,0,1
70256,236,4863,173,84,99,8,29,36,181,5,12,7,13,17,20,54,81,2,221,12,0,2,1,0,1
70257,236,4863,3,1,1,3,0,0,6,0,0,0,0,0,0,0,0,0,0,0,0,2,1,0,1
70259,250,5782,4293,999,3693,19,54,507,4312,9,155,88,170,164,258,1156,1898,4,9368,520,0,2,7,3,1
70260,250,5782,1482,859,1002,125,135,219,1607,16,219,134,251,235,385,1766,3032,9,27804,1544,1,2,7,3,1
70261,4,178,75,38,59,1,3,12,76,2,4,2,4,6,6,10,15,1,15,0,0,2,0,12,1
70263,170,7527,4293,999,3693,19,54,507,4312,9,155,88,170,164,258,1156,1898,4,9368,520,0,2,11,15,1
70264,170,7527,1482,859,1002,125,135,219,1607,16,219,134,251,235,385,1766,3032,9,27804,1544,1,2,11,15,1
70265,12,226,127,75,83,2,11,30,129,4,14,7,14,18,21,61,87,2,175,9,0,2,1,1,0
70266,12,226,652,304,544,16,6,88,668,6,89,51,101,95,152,591,998,3,3399,188,0,2,1,1,0
70267,12,226,2,2,2,0,0,0,2,0,0,0,0,0,0,0,0,0,0,0,0,2,1,1,0
70268,12,226,8,5,5,0,0,3,8,0,0,0,0,0,0,0,0,0,0,0,0,2,1,1,0
70271,12,226,14,8,8,0,0,6,14,0,0,0,0,0,0,0,0,0,0,0,0,2,1,1,0
70272,12,226,6,4,4,0,0,2,6,0,0,0,0,0,0,0,0,0,0,0,0,2,1,1,0
70273,12,226,6,4,4,0,0,2,6,1,2,1,2,3,3,2,4,0,2,0,0,2,1,1,0
70275,12,226,7,5,5,0,0,2,7,0,0,0,0,0,0,0,0,0,0,0,0,2,1,1,0
70277,12,226,10,6,6,0,0,4,10,0,0,0,0,0,0,0,0,0,0,0,0,2,1,1,0
70278,12,226,1,1,1,0,0,0,1,0,0,0,0,0,0,0,0,0,0,0,0,2,1,1,0
70280,12,226,14,10,10,0,0,4,14,1,1,1,1,2,2,0,2,0,1,0,0,2,1,1,0
70281,12,226,46,26,30,3,0,12,49,3,6,3,6,9,9,20,28,1,42,2,0,2,1,1,0
70282,84,1645,757,253,292,73,244,162,830,13,61,38,67,74,105,409,651,7,4654,258,0,2,3,6,0
70283,37,680,386,256,301,16,9,68,402,4,59,35,69,63,104,355,621,2,1453,80,0,2,1,6,0
70284,37,680,264,131,164,11,41,46,275,6,38,22,40,44,62,214,338,3,1068,59,0,2,1,6,0
70302,219,4669,182,127,129,0,0,53,182,5,39,21,42,44,63,217,343,2,926,51,0,2,1,1,0
70303,219,4669,1165,710,800,67,119,181,1232,18,243,153,282,261,435,2000,3492,10,36473,2026,1,2,1,1,0
70304,33,1013,256,139,192,9,7,47,265,4,23,12,24,27,36,112,171,2,357,19,0,2,8,1,0
70306,1,92,42,7,35,4,0,5,46,1,2,1,2,3,3,2,4,0,2,0,0,2,1,1,0
70307,1,92,11,6,10,0,0,1,11,2,4,2,4,6,6,10,15,1,15,0,0,2,1,1,0
70308,58,1130,207,111,150,11,0,50,218,5,26,19,36,31,55,133,272,3,943,52,0,2,6,0,0
70309,58,1130,410,198,237,31,55,97,441,11,63,38,72,74,110,414,683,6,4293,238,0,2,6,0,0
70312,235,4848,2,2,2,0,0,0,2,0,0,0,0,0,0,0,0,0,0,0,0,2,1,1,0
70326,235,4848,99,48,90,1,3,5,100,0,0,0,0,0,0,0,0,0,0,0,0,2,1,1,0
70327,235,4848,8,5,5,2,0,1,10,0,0,0,0,0,0,0,0,0,0,0,0,2,1,1,0
70328,235,4848,1217,716,841,84,126,174,1301,14,185,118,215,199,333,1446,2542,8,20687,1149,0,2,1,1,0
70329,235,4848,160,89,115,0,13,31,160,7,15,11,17,22,28,78,124,3,495,27,0,2,1,1,0
70330,235,4848,10,10,9,9,0,0,19,0,0,0,0,0,0,0,0,0,0,0,0,2,1,1,0
70331,235,4848,173,84,99,8,29,36,181,5,12,7,13,17,20,54,81,2,221,12,0,2,1,1,0
70332,235,4848,3,1,1,3,0,0,6,0,0,0,0,0,0,0,0,0,0,0,0,2,1,1,0
70333,106,4545,1289,550,1043,56,32,155,1345,10,167,93,185,177,278,1266,2075,5,11498,638,0,2,1,1,0
70334,121,4918,1450,624,1228,12,26,181,1462,14,306,186,354,320,540,2580,4493,8,36391,2021,1,2,2,1,0
70335,102,5285,1457,730,1242,11,6,188,1468,10,292,166,329,302,495,2424,4078,5,22973,1276,1,2,1,2,0
70336,2,48,7,6,5,0,0,2,7,1,1,1,2,2,3,0,3,1,3,0,0,2,1,1,0
70340,25,429,219,78,157,11,5,46,230,3,24,20,34,27,54,114,256,2,545,30,0,2,1,1,1
70341,25,429,108,64,79,9,0,20,117,5,15,11,19,20,30,70,129,3,410,22,0,2,1,1,1
70342,11,631,219,78,157,11,5,46,230,3,24,20,34,27,54,114,256,2,545,30,0,2,53,0,1
70343,25,429,219,78,157,11,5,46,230,3,24,20,34,27,54,114,256,2,545,30,0,2,1,1,0
70344,25,429,108,64,79,9,0,20,117,5,15,11,19,20,30,70,129,3,410,22,0,2,1,1,0
70345,11,631,219,78,157,11,5,46,230,3,24,20,34,27,54,114,256,2,545,30,0,2,53,0,0
70401,25,429,219,78,157,11,5,46,230,3,24,20,34,27,54,114,256,2,545,30,0,2,0,1,0
70402,25,429,108,64,79,9,0,20,117,5,15,11,19,20,30,70,129,3,410,22,0,2,0,1,0
70405,117,3137,1523,757,1297,19,12,193,1542,12,193,117,230,205,347,1508,2664,7,19053,1058,0,2,10,11,0
70406,117,3137,701,378,504,33,58,109,734,13,110,68,126,123,194,794,1346,7,10027,557,0,2,10,11,0
70407,111,5221,1523,757,1297,19,12,193,1542,12,193,117,230,205,347,1508,2664,7,19053,1058,0,2,27,3,0
70408,14,836,75,38,59,1,3,12,76,2,4,2,4,6,6,10,15,1,15,0,0,2,1,1,0
70411,235,4868,2,2,2,0,0,0,2,0,0,0,0,0,0,0,0,0,0,0,0,2,20,6,0
70425,235,4868,99,48,90,1,3,5,100,0,0,0,0,0,0,0,0,0,0,0,0,2,20,6,0
70426,235,4868,8,5,5,2,0,1,10,0,0,0,0,0,0,0,0,0,0,0,0,2,20,6,0
70427,235,4868,1217,716,841,84,126,174,1301,14,185,118,215,199,333,1446,2542,8,20687,1149,0,2,20,6,0
70428,235,4868,160,89,115,0,13,31,160,7,15,11,17,22,28,78,124,3,495,27,0,2,20,6,0
70429,235,4868,10,10,9,9,0,0,19,0,0,0,0,0,0,0,0,0,0,0,0,2,20,6,0
70430,235,4868,173,84,99,8,29,36,181,5,12,7,13,17,20,54,81,2,221,12,0,2,20,6,0
70431,235,4868,3,1,1,3,0,0,6,0,0,0,0,0,0,0,0,0,0,0,0,2,20,6,0
70432,103,5394,1457,730,1242,11,6,188,1468,10,292,166,329,302,495,2424,4078,5,22973,1276,1,2,22,0,0
70435,237,4975,2,2,2,0,0,0,2,0,0,0,0,0,0,0,0,0,0,0,0,2,38,12,0
70449,237,4975,99,48,90,1,3,5,100,0,0,0,0,0,0,0,0,0,0,0,0,2,38,12,0
70450,237,4975,8,5,5,2,0,1,10,0,0,0,0,0,0,0,0,0,0,0,0,2,38,12,0
70451,237,4975,1217,716,841,84,126,174,1301,14,185,118,215,199,333,1446,2542,8,20687,1149,0,2,38,12,0
70452,237,4975,160,89,115,0,13,31,160,7,15,11,17,22,28,78,124,3,495,27,0,2,38,12,0
70453,237,4975,10,10,9,9,0,0,19,0,0,0,0,0,0,0,0,0,0,0,0,2,38,12,0
70454,237,4975,173,84,99,8,29,36,181,5,12,7,13,17,20,54,81,2,221,12,0,2,38,12,0
70455,237,4975,3,1,1,3,0,0,6,0,0,0,0,0,0,0,0,0,0,0,0,2,38,12,0
70456,103,5415,1457,730,1242,11,6,188,1468,10,292,166,329,302,495,2424,4078,5,22973,1276,1,2,4,2,0
70459,237,4975,2,2,2,0,0,0,2,0,0,0,0,0,0,0,0,0,0,0,0,2,9,1,0
70473,237,4975,99,48,90,1,3,5,100,0,0,0,0,0,0,0,0,0,0,0,0,2,9,1,0
70474,237,4975,8,5,5,2,0,1,10,0,0,0,0,0,0,0,0,0,0,0,0,2,9,1,0
70475,237,4975,1217,716,841,84,126,174,1301,14,185,118,215,199,333,1446,2542,8,20687,1149,0,2,9,1,0
70476,237,4975,160,89,115,0,13,31,160,7,15,11,17,22,28,78,124,3,495,27,0,2,9,1,0
70477,237,4975,10,10,9,9,0,0,19,0,0,0,0,0,0,0,0,0,0,0,0,2,9,1,0
70478,237,4975,173,84,99,8,29,36,181,5,12,7,13,17,20,54,81,2,221,12,0,2,9,1,0
70479,237,4975,3,1,1,3,0,0,6,0,0,0,0,0,0,0,0,0,0,0,0,2,9,1,0
70480,103,5418,1457,730,1242,11,6,188,1468,10,292,166,329,302,495,2424,4078,5,22973,1276,1,2,2,2,0
70481,1,302,382,65,130,157,2,92,539,4,10,5,10,14,15,41,57,2,114,6,0,2,1,2,0
70482,1,313,382,65,130,157,2,92,539,4,10,5,10,14,15,41,57,2,114,6,0,2,2,2,0
70483,101,2578,1455,414,1257,16,76,112,1471,5,41,23,46,46,69,231,381,2,1069,59,0,2,91,24,1
70484,101,2578,669,365,481,22,61,110,691,15,103,63,122,118,185,747,1273,8,11311,628,0,2,91,24,1
70485,81,3701,1455,414,1257,16,76,112,1471,5,41,23,46,46,69,231,381,2,1069,59,0,2,144,0,1
70509,1,300,382,65,130,157,2,92,539,4,10,5,10,14,15,41,57,2,114,6,0,2,0,1,0
70511,1,300,382,65,130,157,2,92,539,4,10,5,10,14,15,41,57,2,114,6,0,2,1,3,0
70512,1,300,382,65,130,157,2,92,539,4,10,5,10,14,15,41,57,2,114,6,0,2,2,2,0
70514,11,231,19,8,11,5,0,4,24,2,5,3,6,7,9,13,25,1,30,1,0,2,2,1,1
70515,11,231,102,59,69,5,3,24,107,6,22,15,28,28,43,113,206,3,789,43,0,2,2,1,1
70516,11,231,106,40,36,3,49,17,109,8,17,13,23,25,36,93,167,5,904,50,0,2,2,1,1
70517,219,4648,182,127,129,0,0,53,182,5,39,21,42,44,63,217,343,2,926,51,0,2,7,6,1
70518,219,4648,1165,710,800,67,119,181,1232,18,243,153,282,261,435,2000,3492,10,36473,2026,1,2,7,6,1
70519,67,1551,773,419,590,28,0,166,801,10,204,113,217,214,330,1598,2554,5,13587,754,0,2,2,1,1
70520,67,1551,421,273,302,44,34,57,465,17,81,59,107,98,166,583,1098,11,12329,684,0,2,2,1,1
70521,180,5401,1660,832,1314,41,38,274,1701,20,312,209,395,332,604,2671,5058,12,64042,3557,1,2,15,10,1
70522,180,5401,1057,646,719,113,100,145,1170,18,215,134,248,233,382,1740,3004,10,31186,1732,1,2,15,10,1
70523,160,3425,1513,682,1277,25,13,200,1538,11,199,116,219,210,335,1557,2584,6,15641,868,0,2,8,4,1
70524,160,3425,819,519,539,24,98,155,843,15,96,57,106,111,163,690,1107,8,9171,509,0,2,8,4,1
70525,57,1484,339,213,244,17,9,65,356,10,42,26,48,52,74,259,421,5,2410,133,0,2,1,1,1
70526,251,5824,4293,999,3693,19,54,507,4312,9,155,88,170,164,258,1156,1898,4,9368,520,0,2,9,3,1
70527,251,5824,1482,859,1002,125,135,219,1607,16,219,134,251,235,385,1766,3032,9,27804,1544,1,2,9,3,1
70530,24,600,2,2,2,0,0,0,2,0,0,0,0,0,0,0,0,0,0,0,0,2,2,1,1
70544,24,600,99,48,90,1,3,5,100,0,0,0,0,0,0,0,0,0,0,0,0,2,2,1,1
70545,24,600,8,5,5,2,0,1,10,0,0,0,0,0,0,0,0,0,0,0,0,2,2,1,1
70546,24,600,1217,716,841,84,126,174,1301,14,185,118,215,199,333,1446,2542,8,20687,1149,0,2,2,1,1
70547,24,600,160,89,115,0,13,31,160,7,15,11,17,22,28,78,124,3,495,27,0,2,2,1,1
70548,24,600,10,10,9,9,0,0,19,0,0,0,0,0,0,0,0,0,0,0,0,2,2,1,1
70549,24,600,173,84,99,8,29,36,181,5,12,7,13,17,20,54,81,2,221,12,0,2,2,1,1
70550,24,600,3,1,1,3,0,0,6,0,0,0,0,0,0,0,0,0,0,0,0,2,2,1,1
70551,71,1566,402,202,227,24,74,80,426,12,52,33,61,64,94,339,564,7,3969,220,0,2,2,1,1
70552,76,1623,53,23,39,0,0,13,53,2,8,4,8,10,12,26,39,1,39,2,0,2,2,1,1
70553,76,1623,515,298,307,33,80,99,548,12,63,44,77,75,121,419,753,7,5527,307,0,2,2,1,1
70554,17,467,205,80,86,16,53,53,221,7,18,10,19,25,29,94,134,3,497,27,0,2,8,4,1
70555,88,1786,757,253,292,73,244,162,830,13,61,38,67,74,105,409,651,7,4654,258,0,2,10,5,1
70556,67,1751,466,257,367,18,25,50,484,7,126,86,171,133,257,898,1813,4,8612,478,0,2,2,1,1
70557,67,1751,507,281,342,29,59,88,536,10,53,29,57,63,86,336,514,5,2764,153,0,2,2,1,1
70558,19,699,442,244,305,14,16,103,456,11,68,45,75,79,120,452,756,6,4588,254,0,2,4,1,1
70559,19,699,182,102,99,11,40,35,193,3,11,6,11,14,17,42,64,1,97,5,0,2,4,1,1
70560,150,7150,1392,870,1177,35,17,170,1427,14,494,280,531,508,811,4473,7289,7,54850,3047,2,2,2,1,1
70561,32,968,256,139,192,9,7,47,265,4,23,12,24,27,36,112,171,2,357,19,0,2,2,1,1
70562,20,449,207,111,150,11,0,50,218,5,26,19,36,31,55,133,272,3,943,52,0,2,2,1,1
70563,75,3937,1293,570,1093,25,15,163,1318,10,195,123,241,205,364,1516,2795,6,17273,959,0,2,2,1,1
70565,11,231,19,8,11,5,0,4,24,2,5,3,6,7,9,13,25,1,30,1,0,2,2,1,0
70566,11,231,102,59,69,5,3,24,107,6,22,15,28,28,43,113,206,3,789,43,0,2,2,1,0
70567,11,231,106,40,36,3,49,17,109,8,17,13,23,25,36,93,167,5,904,50,0,2,2,1,0
70568,219,4651,182,127,129,0,0,53,182,5,39,21,42,44,63,217,343,2,926,51,0,2,7,6,0
70569,219,4651,1165,710,800,67,119,181,1232,18,243,153,282,261,435,2000,3492,10,36473,2026,1,2,7,6,0
70570,67,1551,773,419,590,28,0,166,801,10,204,113,217,214,330,1598,2554,5,13587,754,0,2,2,1,0
70571,67,1551,421,273,302,44,34,57,465,17,81,59,107,98,166,583,1098,11,12329,684,0,2,2,1,0
70572,180,5401,1660,832,1314,41,38,274,1701,20,312,209,395,332,604,2671,5058,12,64042,3557,1,2,15,10,0
70573,180,5401,1057,646,719,113,100,145,1170,18,215,134,248,233,382,1740,3004,10,31186,1732,1,2,15,10,0
70574,160,3425,1513,682,1277,25,13,200,1538,11,199,116,219,210,335,1557,2584,6,15641,868,0,2,8,4,0
70575,160,3425,819,519,539,24,98,155,843,15,96,57,106,111,163,690,1107,8,9171,509,0,2,8,4,0
70576,57,1484,339,213,244,17,9,65,356,10,42,26,48,52,74,259,421,5,2410,133,0,2,1,1,0
70577,251,5824,4293,999,3693,19,54,507,4312,9,155,88,170,164,258,1156,1898,4,9368,520,0,2,9,3,0
70578,251,5824,1482,859,1002,125,135,219,1607,16,219,134,251,235,385,1766,3032,9,27804,1544,1,2,9,3,0
70602,71,1566,402,202,227,24,74,80,426,12,52,33,61,64,94,339,564,7,3969,220,0,2,2,1,0
70603,76,1623,53,23,39,0,0,13,53,2,8,4,8,10,12,26,39,1,39,2,0,2,2,1,0
70604,76,1623,515,298,307,33,80,99,548,12,63,44,77,75,121,419,753,7,5527,307,0,2,2,1,0
70605,17,467,205,80,86,16,53,53,221,7,18,10,19,25,29,94,134,3,497,27,0,2,8,4,0
70606,88,1786,757,253,292,73,244,162,830,13,61,38,67,74,105,409,651,7,4654,258,0,2,10,5,0
70607,67,1751,466,257,367,18,25,50,484,7,126,86,171,133,257,898,1813,4,8612,478,0,2,2,1,0
70608,67,1751,507,281,342,29,59,88,536,10,53,29,57,63,86,336,514,5,2764,153,0,2,2,1,0
70609,19,699,442,244,305,14,16,103,456,11,68,45,75,79,120,452,756,6,4588,254,0,2,4,1,0
70610,19,699,182,102,99,11,40,35,193,3,11,6,11,14,17,42,64,1,97,5,0,2,4,1,0
70611,150,7150,1392,870,1177,35,17,170,1427,14,494,280,531,508,811,4473,7289,7,54850,3047,2,2,2,1,0
70612,33,1013,256,139,192,9,7,47,265,4,23,12,24,27,36,112,171,2,357,19,0,2,2,1,0
70613,20,449,207,111,150,11,0,50,218,5,26,19,36,31,55,133,272,3,943,52,0,2,2,1,0
70614,75,3937,1293,570,1093,25,15,163,1318,10,195,123,241,205,364,1516,2795,6,17273,959,0,2,2,1,0
70666,18,486,205,80,86,16,53,53,221,7,18,10,19,25,29,94,134,3,497,27,0,2,7,4,1
70667,87,3393,1043,504,840,53,9,147,1096,9,180,112,198,189,310,1377,2344,4,11604,644,0,2,16,0,1
70668,79,3071,1178,367,1042,6,15,115,1184,9,94,51,95,103,146,644,976,4,4439,246,0,2,2,1,1
70669,59,1137,207,111,150,11,0,50,218,5,26,19,36,31,55,133,272,3,943,52,0,2,2,2,0
70670,59,1137,410,198,237,31,55,97,441,11,63,38,72,74,110,414,683,6,4293,238,0,2,2,2,0
70673,236,4867,2,2,2,0,0,0,2,0,0,0,0,0,0,0,0,0,0,0,0,2,15,10,0
70687,236,4867,99,48,90,1,3,5,100,0,0,0,0,0,0,0,0,0,0,0,0,2,15,10,0
70688,236,4867,8,5,5,2,0,1,10,0,0,0,0,0,0,0,0,0,0,0,0,2,15,10,0
70689,236,4867,1217,716,841,84,126,174,1301,14,185,118,215,199,333,1446,2542,8,20687,1149,0,2,15,10,0
70690,236,4867,160,89,115,0,13,31,160,7,15,11,17,22,28,78,124,3,495,27,0,2,15,10,0
70691,236,4867,10,10,9,9,0,0,19,0,0,0,0,0,0,0,0,0,0,0,0,2,15,10,0
70692,236,4867,173,84,99,8,29,36,181,5,12,7,13,17,20,54,81,2,221,12,0,2,15,10,0
70693,236,4867,3,1,1,3,0,0,6,0,0,0,0,0,0,0,0,0,0,0,0,2,15,10,0
70696,250,5797,4293,999,3693,19,54,507,4312,9,155,88,170,164,258,1156,1898,4,9368,520,0,2,13,14,0
70697,250,5797,1482,859,1002,125,135,219,1607,16,219,134,251,235,385,1766,3032,9,27804,1544,1,2,13,14,0
70701,70,1522,402,202,227,24,74,80,426,12,52,33,61,64,94,339,564,7,3969,220,0,2,6,14,0
70704,84,1649,757,253,292,73,244,162,830,13,61,38,67,74,105,409,651,7,4654,258,0,2,8,32,0
70705,37,680,386,256,301,16,9,68,402,4,59,35,69,63,104,355,621,2,1453,80,0,2,6,22,0
70706,37,680,264,131,164,11,41,46,275,6,38,22,40,44,62,214,338,3,1068,59,0,2,6,22,0
70713,106,4535,1289,550,1043,56,32,155,1345,10,167,93,185,177,278,1266,2075,5,11498,638,0,2,2,5,0
70714,4,178,75,38,59,1,3,12,76,2,4,2,4,6,6,10,15,1,15,0,0,2,0,173,0
70716,170,7527,4293,999,3693,19,54,507,4312,9,155,88,170,164,258,1156,1898,4,9368,520,0,2,28,47,0
70717,170,7527,1482,859,1002,125,135,219,1607,16,219,134,251,235,385,1766,3032,9,27804,1544,1,2,28,47,0
70719,29,865,256,139,192,9,7,47,265,4,23,12,24,27,36,112,171,2,357,19,0,2,8,34,0
70720,108,5769,1457,730,1242,11,6,188,1468,10,292,166,329,302,495,2424,4078,5,22973,1276,1,2,138,0,0
70721,69,3090,1020,354,843,12,15,144,1032,8,134,77,144,142,221,970,1580,4,6792,377,0,2,5,23,0
70723,45,1930,386,256,301,16,9,68,402,4,59,35,69,63,104,355,621,2,1453,80,0,2,10,16,0
70724,34,1424,442,244,305,14,16,103,456,11,68,45,75,79,120,452,756,6,4588,254,0,2,4,11,0
70726,18,486,205,80,86,16,53,53,221,7,18,10,19,25,29,94,134,3,497,27,0,2,7,4,0
70727,87,3393,1043,504,840,53,9,147,1096,9,180,112,198,189,310,1377,2344,4,11604,644,0,2,16,0,0
70728,79,3071,1178,367,1042,6,15,115,1184,9,94,51,95,103,146,644,976,4,4439,246,0,2,2,1,0
70731,238,4994,2,2,2,0,0,0,2,0,0,0,0,0,0,0,0,0,0,0,0,2,58,10,0
70745,238,4994,99,48,90,1,3,5,100,0,0,0,0,0,0,0,0,0,0,0,0,2,58,10,0
70746,238,4994,8,5,5,2,0,1,10,0,0,0,0,0,0,0,0,0,0,0,0,2,58,10,0
70747,238,4994,1217,716,841,84,126,174,1301,14,185,118,215,199,333,1446,2542,8,20687,1149,0,2,58,10,0
70748,238,4994,160,89,115,0,13,31,160,7,15,11,17,22,28,78,124,3,495,27,0,2,58,10,0
70749,238,4994,10,10,9,9,0,0,19,0,0,0,0,0,0,0,0,0,0,0,0,2,58,10,0
70750,238,4994,173,84,99,8,29,36,181,5,12,7,13,17,20,54,81,2,221,12,0,2,58,10,0
70751,238,4994,3,1,1,3,0,0,6,0,0,0,0,0,0,0,0,0,0,0,0,2,58,10,0
70752,109,5902,1457,730,1242,11,6,188,1468,10,292,166,329,302,495,2424,4078,5,22973,1276,1,2,24,0,0
70794,18,486,205,80,86,16,53,53,221,7,18,10,19,25,29,94,134,3,497,27,0,2,8,4,0
70804,84,1646,757,253,292,73,244,162,830,13,61,38,67,74,105,409,651,7,4654,258,0,2,1,4,0
70805,37,680,386,256,301,16,9,68,402,4,59,35,69,63,104,355,621,2,1453,80,0,2,1,1,0
70806,37,680,264,131,164,11,41,46,275,6,38,22,40,44,62,214,338,3,1068,59,0,2,1,1,0
70807,81,3712,1455,414,1257,16,76,112,1471,5,41,23,46,46,69,231,381,2,1069,59,0,2,4,2,0
70808,81,3729,1455,414,1257,16,76,112,1471,5,41,23,46,46,69,231,381,2,1069,59,0,2,3,0,0
70809,101,2578,1455,414,1257,16,76,112,1471,5,41,23,46,46,69,231,381,2,1069,59,0,2,91,24,0
70810,101,2578,669,365,481,22,61,110,691,15,103,63,122,118,185,747,1273,8,11311,628,0,2,91,24,0
70811,81,3729,1455,414,1257,16,76,112,1471,5,41,23,46,46,69,231,381,2,1069,59,0,2,149,0,0
70812,90,2013,996,429,845,24,10,117,1020,7,76,50,88,83,138,494,879,4,3565,198,0,2,2,2,0
70813,90,2013,456,277,329,12,42,72,468,13,85,50,97,98,147,592,972,7,7212,400,0,2,2,2,0
70814,64,1298,91,45,69,0,3,18,91,3,9,6,10,12,16,33,57,1,95,5,0,2,36,9,0
70815,64,1298,367,234,237,17,34,68,384,16,55,34,61,71,95,381,584,8,5183,287,0,2,36,9,0
70816,38,1654,442,244,305,14,16,103,456,11,68,45,75,79,120,452,756,6,4588,254,0,2,57,3,0
70822,12,177,424,94,331,4,0,89,428,1,5,5,5,6,10,11,25,0,12,0,0,2,0,25,0
70823,12,177,38,23,23,6,0,8,44,3,11,7,11,14,18,42,68,1,102,5,0,2,0,25,0
70824,90,1912,1043,504,840,53,9,147,1096,9,180,112,198,189,310,1377,2344,4,11604,644,0,2,5,4,0
70825,90,1912,383,288,292,26,6,62,409,11,65,38,67,76,105,429,656,5,3719,206,0,2,5,4,0
70826,68,1337,1098,241,925,5,10,155,1103,7,46,25,49,53,74,273,423,3,1580,87,0,2,9,0,0
70827,68,1337,282,202,222,14,2,44,296,8,42,24,43,50,67,250,378,4,1548,86,0,2,9,0,0
70828,49,1966,1098,241,925,5,10,155,1103,7,46,25,49,53,74,273,423,3,1580,87,0,2,1,3,0
70829,64,1298,91,45,69,0,3,18,91,3,9,6,10,12,16,33,57,1,95,5,0,2,2,2,0
70830,64,1298,367,234,237,17,34,68,384,16,55,34,61,71,95,381,584,8,5183,287,0,2,2,2,0
70831,313,6823,72,33,56,0,4,12,72,1,1,1,1,2,2,0,2,0,1,0,0,2,0,3,0
70832,313,6823,1454,835,1044,76,110,219,1530,17,275,158,296,292,454,2297,3718,9,34017,1889,1,2,0,3,0
70833,313,6817,72,33,56,0,4,12,72,1,1,1,1,2,2,0,2,0,1,0,0,2,5,8,0
70834,313,6817,1454,835,1044,76,110,219,1530,17,275,158,296,292,454,2297,3718,9,34017,1889,1,2,5,8,0
70844,312,6802,72,33,56,0,4,12,72,1,1,1,1,2,2,0,2,0,1,0,0,2,2,6,0
70845,312,6802,1454,835,1044,76,110,219,1530,17,275,158,296,292,454,2297,3718,9,34017,1889,1,2,2,6,0
70846,307,6733,72,33,56,0,4,12,72,1,1,1,1,2,2,0,2,0,1,0,0,2,0,21,0
70847,307,6733,1454,835,1044,76,110,219,1530,17,275,158,296,292,454,2297,3718,9,34017,1889,1,2,0,21,0
70851,307,6751,72,33,56,0,4,12,72,1,1,1,1,2,2,0,2,0,1,0,0,2,13,8,0
70852,307,6751,1454,835,1044,76,110,219,1530,17,275,158,296,292,454,2297,3718,9,34017,1889,1,2,13,8,0
70853,147,5933,1782,648,1425,9,47,279,1791,8,171,97,189,179,286,1292,2140,4,9462,525,0,2,11,0,0
70854,305,6729,72,33,56,0,4,12,72,1,1,1,1,2,2,0,2,0,1,0,0,2,23,21,0
70855,305,6729,1454,835,1044,76,110,219,1530,17,275,158,296,292,454,2297,3718,9,34017,1889,1,2,23,21,0
70856,7,140,38,22,22,1,0,15,39,1,2,1,2,3,3,2,4,0,2,0,0,0,38,0,1
70857,7,140,38,22,22,1,0,15,39,1,2,1,2,3,3,2,4,0,2,0,0,0,38,0,0
70858,85,1664,757,253,292,73,244,162,830,13,61,38,67,74,105,409,651,7,4654,258,0,2,6,3,1
70859,38,702,386,256,301,16,9,68,402,4,59,35,69,63,104,355,621,2,1453,80,0,2,6,1,1
70860,38,702,264,131,164,11,41,46,275,6,38,22,40,44,62,214,338,3,1068,59,0,2,6,1,1
70861,30,903,256,139,192,9,7,47,265,4,23,12,24,27,36,112,171,2,357,19,0,2,6,0,1
70862,46,1968,386,256,301,16,9,68,402,4,59,35,69,63,104,355,621,2,1453,80,0,2,6,0,1
70863,11,553,205,80,86,16,53,53,221,7,18,10,19,25,29,94,134,3,497,27,0,2,23,9,0
70864,20,993,386,256,301,16,9,68,402,4,59,35,69,63,104,355,621,2,1453,80,0,2,87,23,1
70865,20,993,264,131,164,11,41,46,275,6,38,22,40,44,62,214,338,3,1068,59,0,2,87,23,1
70866,219,4842,182,127,129,0,0,53,182,5,39,21,42,44,63,217,343,2,926,51,0,2,50,25,1
70867,219,4842,1165,710,800,67,119,181,1232,18,243,153,282,261,435,2000,3492,10,36473,2026,1,2,50,25,1
70868,79,1897,757,253,292,73,244,162,830,13,61,38,67,74,105,409,651,7,4654,258,0,2,56,7,1
70869,214,4866,182,127,129,0,0,53,182,5,39,21,42,44,63,217,343,2,926,51,0,2,13,8,0
70870,214,4866,1165,710,800,67,119,181,1232,18,243,153,282,261,435,2000,3492,10,36473,2026,1,2,13,8,0
70871,79,1947,757,253,292,73,244,162,830,13,61,38,67,74,105,409,651,7,4654,258,0,2,20,13,0
70872,215,4899,182,127,129,0,0,53,182,5,39,21,42,44,63,217,343,2,926,51,0,2,5,0,0
70873,215,4899,1165,710,800,67,119,181,1232,18,243,153,282,261,435,2000,3492,10,36473,2026,1,2,5,0,0
70874,79,1959,757,253,292,73,244,162,830,13,61,38,67,74,105,409,651,7,4654,258,0,2,9,5,0
70875,216,4938,182,127,129,0,0,53,182,5,39,21,42,44,63,217,343,2,926,51,0,2,32,13,0
70876,216,4938,1165,710,800,67,119,181,1232,18,243,153,282,261,435,2000,3492,10,36473,2026,1,2,32,13,0
70877,79,1967,757,253,292,73,244,162,830,13,61,38,67,74,105,409,651,7,4654,258,0,2,5,5,0
70878,152,7195,1392,870,1177,35,17,170,1427,14,494,280,531,508,811,4473,7289,7,54850,3047,2,2,9,1,0
70879,9,261,149,95,105,2,0,41,151,8,54,28,55,62,83,334,494,4,2013,111,0,2,0,18,0
70880,9,261,82,56,54,0,13,15,82,4,13,8,16,17,24,56,98,2,241,13,0,2,0,18,0
70881,10,274,149,95,105,2,0,41,151,8,54,28,55,62,83,334,494,4,2013,111,0,2,7,6,0
70882,10,274,82,56,54,0,13,15,82,4,13,8,16,17,24,56,98,2,241,13,0,2,7,6,0
70883,12,315,149,95,105,2,0,41,151,8,54,28,55,62,83,334,494,4,2013,111,0,2,1,1,0
70884,10,269,149,95,105,2,0,41,151,8,54,28,55,62,83,334,494,4,2013,111,0,2,0,1,0
70885,10,269,82,56,54,0,13,15,82,4,13,8,16,17,24,56,98,2,241,13,0,2,0,1,0
70886,305,6729,72,33,56,0,4,12,72,1,1,1,1,2,2,0,2,0,1,0,0,2,43,67,0
70887,305,6729,1454,835,1044,76,110,219,1530,17,275,158,296,292,454,2297,3718,9,34017,1889,1,2,43,67,0
70889,12,280,149,95,105,2,0,41,151,8,54,28,55,62,83,334,494,4,2013,111,0,2,30,23,0
70890,12,280,82,56,54,0,13,15,82,4,13,8,16,17,24,56,98,2,241,13,0,2,30,23,0
70891,14,343,149,95,105,2,0,41,151,8,54,28,55,62,83,334,494,4,2013,111,0,2,11,0,0
70892,71,1566,402,202,227,24,74,80,426,12,52,33,61,64,94,339,564,7,3969,220,0,2,12,11,0
70893,88,1786,757,253,292,73,244,162,830,13,61,38,67,74,105,409,651,7,4654,258,0,2,1,1,0
70894,33,966,465,148,393,5,8,60,470,4,31,20,31,35,51,161,261,2,523,29,0,2,0,3,0
70895,33,966,16,12,9,0,0,6,16,1,2,1,2,3,3,2,4,0,2,0,0,2,0,3,0
70896,32,954,465,148,393,5,8,60,470,4,31,20,31,35,51,161,261,2,523,29,0,2,5,11,0
70897,32,954,16,12,9,0,0,6,16,1,2,1,2,3,3,2,4,0,2,0,0,2,5,11,0
70898,32,954,465,148,393,5,8,60,470,4,31,20,31,35,51,161,261,2,523,29,0,2,5,14,0
70899,32,954,16,12,9,0,0,6,16,1,2,1,2,3,3,2,4,0,2,0,0,2,5,14,0
70900,12,280,149,95,105,2,0,41,151,8,54,28,55,62,83,334,494,4,2013,111,0,2,36,47,0
70901,12,280,82,56,54,0,13,15,82,4,13,8,16,17,24,56,98,2,241,13,0,2,36,47,0
70902,14,343,149,95,105,2,0,41,151,8,54,28,55,62,83,334,494,4,2013,111,0,2,12,1,0
70903,216,4938,182,127,129,0,0,53,182,5,39,21,42,44,63,217,343,2,926,51,0,2,85,31,0
70904,216,4938,1165,710,800,67,119,181,1232,18,243,153,282,261,435,2000,3492,10,36473,2026,1,2,85,31,0
70906,79,1967,757,253,292,73,244,162,830,13,61,38,67,74,105,409,651,7,4654,258,0,2,80,20,0
70907,20,993,386,256,301,16,9,68,402,4,59,35,69,63,104,355,621,2,1453,80,0,2,94,25,0
70908,20,993,264,131,164,11,41,46,275,6,38,22,40,44,62,214,338,3,1068,59,0,2,94,25,0
70910,30,903,256,139,192,9,7,47,265,4,23,12,24,27,36,112,171,2,357,19,0,2,6,0,0
70911,46,1968,386,256,301,16,9,68,402,4,59,35,69,63,104,355,621,2,1453,80,0,2,6,0,0
70914,216,4948,182,127,129,0,0,53,182,5,39,21,42,44,63,217,343,2,926,51,0,2,3,1,0
70915,216,4948,1165,710,800,67,119,181,1232,18,243,153,282,261,435,2000,3492,10,36473,2026,1,2,3,1,0
70916,11,562,205,80,86,16,53,53,221,7,18,10,19,25,29,94,134,3,497,27,0,2,4,1,1
70917,304,6724,72,33,56,0,4,12,72,1,1,1,1,2,2,0,2,0,1,0,0,2,1,1,0
70918,304,6724,1454,835,1044,76,110,219,1530,17,275,158,296,292,454,2297,3718,9,34017,1889,1,2,1,1,0
70919,87,1891,1043,504,840,53,9,147,1096,9,180,112,198,189,310,1377,2344,4,11604,644,0,2,3,9,0
70920,87,1891,383,288,292,26,6,62,409,11,65,38,67,76,105,429,656,5,3719,206,0,2,3,9,0
70921,10,530,205,80,86,16,53,53,221,7,18,10,19,25,29,94,134,3,497,27,0,2,2,8,0
70922,102,2603,1455,414,1257,16,76,112,1471,5,41,23,46,46,69,231,381,2,1069,59,0,2,4,0,1
70923,102,2603,669,365,481,22,61,110,691,15,103,63,122,118,185,747,1273,8,11311,628,0,2,4,0,1
70924,76,4016,1293,570,1093,25,15,163,1318,10,195,123,241,205,364,1516,2795,6,17273,959,0,2,23,1,1
70927,10,530,205,80,86,16,53,53,221,7,18,10,19,25,29,94,134,3,497,27,0,2,1,4,0
70932,67,1304,1098,241,925,5,10,155,1103,7,46,25,49,53,74,273,423,3,1580,87,0,2,6,0,0
70933,67,1304,282,202,222,14,2,44,296,8,42,24,43,50,67,250,378,4,1548,86,0,2,6,0,0
70934,51,2027,1098,241,925,5,10,155,1103,7,46,25,49,53,74,273,423,3,1580,87,0,2,36,0,0
70935,55,2829,722,423,573,19,0,135,741,12,172,101,199,184,300,1320,2257,6,15668,870,0,2,1,1,0
70936,33,992,465,148,393,5,8,60,470,4,31,20,31,35,51,161,261,2,523,29,0,2,28,0,0
70937,33,992,16,12,9,0,0,6,16,1,2,1,2,3,3,2,4,0,2,0,0,2,28,0,0
70938,56,1107,207,111,150,11,0,50,218,5,26,19,36,31,55,133,272,3,943,52,0,2,12,7,0
70939,56,1107,410,198,237,31,55,97,441,11,63,38,72,74,110,414,683,6,4293,238,0,2,12,7,0
70943,238,4997,2,2,2,0,0,0,2,0,0,0,0,0,0,0,0,0,0,0,0,2,3,3,0
70957,238,4997,99,48,90,1,3,5,100,0,0,0,0,0,0,0,0,0,0,0,0,2,3,3,0
70958,238,4997,8,5,5,2,0,1,10,0,0,0,0,0,0,0,0,0,0,0,0,2,3,3,0
70959,238,4997,1217,716,841,84,126,174,1301,14,185,118,215,199,333,1446,2542,8,20687,1149,0,2,3,3,0
70960,238,4997,160,89,115,0,13,31,160,7,15,11,17,22,28,78,124,3,495,27,0,2,3,3,0
70961,238,4997,10,10,9,9,0,0,19,0,0,0,0,0,0,0,0,0,0,0,0,2,3,3,0
70962,238,4997,173,84,99,8,29,36,181,5,12,7,13,17,20,54,81,2,221,12,0,2,3,3,0
70963,238,4997,3,1,1,3,0,0,6,0,0,0,0,0,0,0,0,0,0,0,0,2,3,3,0
70964,31,1080,74,35,59,1,0,14,75,3,14,7,14,17,21,58,85,1,128,7,0,2,1,1,0
70965,31,1080,245,125,200,5,7,34,250,7,30,17,34,37,51,166,265,3,1053,58,0,2,1,1,0
70966,109,5904,1457,730,1242,11,6,188,1468,10,292,166,329,302,495,2424,4078,5,22973,1276,1,2,2,2,0
70967,71,1566,402,202,227,24,74,80,426,12,52,33,61,64,94,339,564,7,3969,220,0,2,1,3,0
70972,51,2030,1098,241,925,5,10,155,1103,7,46,25,49,53,74,273,423,3,1580,87,0,2,3,3,1
70975,51,2030,1098,241,925,5,10,155,1103,7,46,25,49,53,74,273,423,3,1580,87,0,2,36,0,0
70976,56,789,167,116,138,4,5,22,171,8,48,30,56,56,86,292,499,4,2330,129,0,2,5,1,0
70977,103,5325,1457,730,1242,11,6,188,1468,10,292,166,329,302,495,2424,4078,5,22973,1276,1,2,8,0,0
70978,103,5325,1457,730,1242,11,6,188,1468,10,292,166,329,302,495,2424,4078,5,22973,1276,1,2,2,4,0
71006,103,5325,1457,730,1242,11,6,188,1468,10,292,166,329,302,495,2424,4078,5,22973,1276,1,2,6,0,0
71007,51,2034,1098,241,925,5,10,155,1103,7,46,25,49,53,74,273,423,3,1580,87,0,2,1,1,0
71013,71,1566,402,202,227,24,74,80,426,12,52,33,61,64,94,339,564,7,3969,220,0,2,13,14,0
71017,33,992,465,148,393,5,8,60,470,4,31,20,31,35,51,161,261,2,523,29,0,2,33,14,0
71018,33,992,16,12,9,0,0,6,16,1,2,1,2,3,3,2,4,0,2,0,0,2,33,14,0
71021,51,2034,1098,241,925,5,10,155,1103,7,46,25,49,53,74,273,423,3,1580,87,0,2,36,0,0
71022,12,645,219,78,157,11,5,46,230,3,24,20,34,27,54,114,256,2,545,30,0,2,2,1,1
71023,12,645,219,78,157,11,5,46,230,3,24,20,34,27,54,114,256,2,545,30,0,2,2,1,0
71024,280,5856,1943,715,1694,26,18,214,1969,12,185,120,237,197,357,1436,2721,7,20915,1161,0,2,1,1,0
71025,280,5856,1168,838,957,57,25,144,1225,19,348,224,416,367,640,3018,5452,11,61921,3440,1,2,1,1,0
71026,280,5856,1943,715,1694,26,18,214,1969,12,185,120,237,197,357,1436,2721,7,20915,1161,0,2,2,2,0
71027,280,5856,1168,838,957,57,25,144,1225,19,348,224,416,367,640,3018,5452,11,61921,3440,1,2,2,2,0
71028,111,6050,1943,715,1694,26,18,214,1969,12,185,120,237,197,357,1436,2721,7,20915,1161,0,2,1,1,0
71029,150,7150,1392,870,1177,35,17,170,1427,14,494,280,531,508,811,4473,7289,7,54850,3047,2,2,1,1,0
71030,107,5128,1523,757,1297,19,12,193,1542,12,193,117,230,205,347,1508,2664,7,19053,1058,0,2,1,1,0
71032,70,3179,1020,354,843,12,15,144,1032,8,134,77,144,142,221,970,1580,4,6792,377,0,2,1,1,0
71040,107,5128,1523,757,1297,19,12,193,1542,12,193,117,230,205,347,1508,2664,7,19053,1058,0,2,2,2,0
71043,76,1637,53,23,39,0,0,13,53,2,8,4,8,10,12,26,39,1,39,2,0,2,5,2,0
71044,76,1637,515,298,307,33,80,99,548,12,63,44,77,75,121,419,753,7,5527,307,0,2,5,2,0
71047,65,1368,91,45,69,0,3,18,91,3,9,6,10,12,16,33,57,1,95,5,0,2,38,26,0
71048,65,1368,367,234,237,17,34,68,384,16,55,34,61,71,95,381,584,8,5183,287,0,2,38,26,0
71049,40,1809,442,244,305,14,16,103,456,11,68,45,75,79,120,452,756,6,4588,254,0,2,46,16,0
71053,1,300,382,65,130,157,2,92,539,4,10,5,10,14,15,41,57,2,114,6,0,2,3,5,0
71057,57,1135,207,111,150,11,0,50,218,5,26,19,36,31,55,133,272,3,943,52,0,2,12,7,0
71058,57,1135,410,198,237,31,55,97,441,11,63,38,72,74,110,414,683,6,4293,238,0,2,12,7,0
71060,56,780,167,116,138,4,5,22,171,8,48,30,56,56,86,292,499,4,2330,129,0,2,5,1,0
71061,70,1522,402,202,227,24,74,80,426,12,52,33,61,64,94,339,564,7,3969,220,0,2,13,14,0
71064,12,572,205,80,86,16,53,53,221,7,18,10,19,25,29,94,134,3,497,27,0,2,6,0,0
71065,65,1368,91,45,69,0,3,18,91,3,9,6,10,12,16,33,57,1,95,5,0,2,50,11,0
71066,65,1368,367,234,237,17,34,68,384,16,55,34,61,71,95,381,584,8,5183,287,0,2,50,11,0
71067,79,1967,757,253,292,73,244,162,830,13,61,38,67,74,105,409,651,7,4654,258,0,2,1,1,0
71072,70,1371,1098,241,925,5,10,155,1103,7,46,25,49,53,74,273,423,3,1580,87,0,2,6,0,0
71073,70,1371,282,202,222,14,2,44,296,8,42,24,43,50,67,250,378,4,1548,86,0,2,6,0,0
71074,152,7195,1392,870,1177,35,17,170,1427,14,494,280,531,508,811,4473,7289,7,54850,3047,2,2,1,1,0
71075,4,181,75,38,59,1,3,12,76,2,4,2,4,6,6,10,15,1,15,0,0,2,1,1,0
71078,110,5948,1457,730,1242,11,6,188,1468,10,292,166,329,302,495,2424,4078,5,22973,1276,1,2,6,0,0
71079,111,5221,1523,757,1297,19,12,193,1542,12,193,117,230,205,347,1508,2664,7,19053,1058,0,2,2,2,0
71080,69,3090,1020,354,843,12,15,144,1032,8,134,77,144,142,221,970,1580,4,6792,377,0,2,1,1,0
71082,55,2824,722,423,573,19,0,135,741,12,172,101,199,184,300,1320,2257,6,15668,870,0,2,1,1,0
71087,39,1770,442,244,305,14,16,103,456,11,68,45,75,79,120,452,756,6,4588,254,0,2,97,13,0
71088,51,2032,1098,241,925,5,10,155,1103,7,46,25,49,53,74,273,423,3,1580,87,0,2,36,0,0
71089,183,5400,1660,832,1314,41,38,274,1701,20,312,209,395,332,604,2671,5058,12,64042,3557,1,2,28,18,1
71090,183,5400,1057,646,719,113,100,145,1170,18,215,134,248,233,382,1740,3004,10,31186,1732,1,2,28,18,1
71091,63,1284,91,45,69,0,3,18,91,3,9,6,10,12,16,33,57,1,95,5,0,2,2,9,1
71092,63,1284,367,234,237,17,34,68,384,16,55,34,61,71,95,381,584,8,5183,287,0,2,2,9,1
71093,181,5925,1660,832,1314,41,38,274,1701,20,312,209,395,332,604,2671,5058,12,64042,3557,1,2,42,0,1
71130,117,3166,1523,757,1297,19,12,193,1542,12,193,117,230,205,347,1508,2664,7,19053,1058,0,2,4,0,0
71131,117,3166,701,378,504,33,58,109,734,13,110,68,126,123,194,794,1346,7,10027,557,0,2,4,0,0
71132,113,5329,1523,757,1297,19,12,193,1542,12,193,117,230,205,347,1508,2664,7,19053,1058,0,2,26,0,0
71133,183,5400,1660,832,1314,41,38,274,1701,20,312,209,395,332,604,2671,5058,12,64042,3557,1,2,28,18,0
71134,183,5400,1057,646,719,113,100,145,1170,18,215,134,248,233,382,1740,3004,10,31186,1732,1,2,28,18,0
71135,64,1354,91,45,69,0,3,18,91,3,9,6,10,12,16,33,57,1,95,5,0,2,2,9,0
71136,64,1354,367,234,237,17,34,68,384,16,55,34,61,71,95,381,584,8,5183,287,0,2,2,9,0
71137,181,5925,1660,832,1314,41,38,274,1701,20,312,209,395,332,604,2671,5058,12,64042,3557,1,2,42,0,0
71141,147,3596,77,34,69,0,0,8,77,3,24,16,29,27,45,114,213,1,387,21,0,2,7,1,0
71142,147,3596,712,438,573,51,9,84,763,14,102,71,128,116,199,733,1364,8,11988,666,0,2,7,1,0
71143,85,4953,1296,573,1062,40,33,157,1336,8,201,118,231,209,349,1561,2689,4,12365,686,0,2,12,0,0
71149,142,3472,77,34,69,0,0,8,77,3,24,16,29,27,45,114,213,1,387,21,0,2,7,1,0
71150,142,3472,712,438,573,51,9,84,763,14,102,71,128,116,199,733,1364,8,11988,666,0,2,7,1,0
71163,90,3963,1338,495,1086,10,64,173,1348,11,122,82,157,133,239,883,1686,7,11934,663,0,2,1,1,0
71165,1,93,42,7,35,4,0,5,46,1,2,1,2,3,3,2,4,0,2,0,0,2,2,3,1
71166,1,93,11,6,10,0,0,1,11,2,4,2,4,6,6,10,15,1,15,0,0,2,2,3,1
71167,113,5706,1523,757,1297,19,12,193,1542,12,193,117,230,205,347,1508,2664,7,19053,1058,0,2,189,116,1
71168,113,5691,1523,757,1297,19,12,193,1542,12,193,117,230,205,347,1508,2664,7,19053,1058,0,2,0,1,0
71169,299,6647,72,33,56,0,4,12,72,1,1,1,1,2,2,0,2,0,1,0,0,2,0,12,0
71170,299,6647,1454,835,1044,76,110,219,1530,17,275,158,296,292,454,2297,3718,9,34017,1889,1,2,0,12,0
71171,1,93,42,7,35,4,0,5,46,1,2,1,2,3,3,2,4,0,2,0,0,2,2,3,0
71172,1,93,11,6,10,0,0,1,11,2,4,2,4,6,6,10,15,1,15,0,0,2,2,3,0
71173,113,5691,1523,757,1297,19,12,193,1542,12,193,117,230,205,347,1508,2664,7,19053,1058,0,2,189,117,0
71177,18,486,205,80,86,16,53,53,221,7,18,10,19,25,29,94,134,3,497,27,0,2,13,6,0
71179,225,5726,722,423,573,19,0,135,741,12,172,101,199,184,300,1320,2257,6,15668,870,0,2,6,0,1
71180,225,5726,1508,847,911,44,250,301,1552,14,148,88,169,162,257,1120,1886,7,15077,837,0,2,6,0,1
71181,225,5726,722,423,573,19,0,135,741,12,172,101,199,184,300,1320,2257,6,15668,870,0,2,1,1,0
71182,225,5726,1508,847,911,44,250,301,1552,14,148,88,169,162,257,1120,1886,7,15077,837,0,2,1,1,0
71183,225,5726,722,423,573,19,0,135,741,12,172,101,199,184,300,1320,2257,6,15668,870,0,2,6,0,0
71184,225,5726,1508,847,911,44,250,301,1552,14,148,88,169,162,257,1120,1886,7,15077,837,0,2,6,0,0
71185,224,5729,722,423,573,19,0,135,741,12,172,101,199,184,300,1320,2257,6,15668,870,0,2,8,8,1
71186,224,5729,1508,847,911,44,250,301,1552,14,148,88,169,162,257,1120,1886,7,15077,837,0,2,8,8,1
71187,282,5904,1943,715,1694,26,18,214,1969,12,185,120,237,197,357,1436,2721,7,20915,1161,0,2,11,1,1
71188,282,5904,1168,838,957,57,25,144,1225,19,348,224,416,367,640,3018,5452,11,61921,3440,1,2,11,1,1
71189,42,2613,1157,318,931,29,22,177,1186,6,104,63,125,110,188,712,1274,3,4596,255,0,2,1,1,1
71190,55,2824,722,423,573,19,0,135,741,12,172,101,199,184,300,1320,2257,6,15668,870,0,2,1,1,1
71191,112,6136,1943,715,1694,26,18,214,1969,12,185,120,237,197,357,1436,2721,7,20915,1161,0,2,18,1,1
71193,9,432,184,100,137,2,15,30,186,6,38,20,39,44,59,214,322,3,991,55,0,2,2,1,0
71194,224,5729,722,423,573,19,0,135,741,12,172,101,199,184,300,1320,2257,6,15668,870,0,2,8,8,0
71195,224,5729,1508,847,911,44,250,301,1552,14,148,88,169,162,257,1120,1886,7,15077,837,0,2,8,8,0
71196,282,5904,1943,715,1694,26,18,214,1969,12,185,120,237,197,357,1436,2721,7,20915,1161,0,2,11,1,0
71197,282,5904,1168,838,957,57,25,144,1225,19,348,224,416,367,640,3018,5452,11,61921,3440,1,2,11,1,0
71198,42,2613,1157,318,931,29,22,177,1186,6,104,63,125,110,188,712,1274,3,4596,255,0,2,1,1,0
71200,112,6136,1943,715,1694,26,18,214,1969,12,185,120,237,197,357,1436,2721,7,20915,1161,0,2,18,1,0
71201,114,2087,477,336,357,30,23,73,507,16,194,134,250,210,384,1538,2962,10,30538,1696,0,2,3,3,0
71202,183,5967,1660,832,1314,41,38,274,1701,20,312,209,395,332,604,2671,5058,12,64042,3557,1,2,10,0,0
71203,183,5396,1660,832,1314,41,38,274,1701,20,312,209,395,332,604,2671,5058,12,64042,3557,1,2,4,4,1
71204,183,5396,1057,646,719,113,100,145,1170,18,215,134,248,233,382,1740,3004,10,31186,1732,1,2,4,4,1
71205,60,1139,282,196,195,3,0,86,285,8,130,71,141,138,212,936,1507,4,6538,363,0,2,1,1,0
71206,7,292,72,33,56,0,4,12,72,1,1,1,1,2,2,0,2,0,1,0,0,2,1,1,0
71224,183,5396,1660,832,1314,41,38,274,1701,20,312,209,395,332,604,2671,5058,12,64042,3557,1,2,4,4,0
71225,183,5396,1057,646,719,113,100,145,1170,18,215,134,248,233,382,1740,3004,10,31186,1732,1,2,4,4,0
71248,225,5744,722,423,573,19,0,135,741,12,172,101,199,184,300,1320,2257,6,15668,870,0,2,2,0,0
71249,225,5744,1508,847,911,44,250,301,1552,14,148,88,169,162,257,1120,1886,7,15077,837,0,2,2,0,0
71254,235,4857,2,2,2,0,0,0,2,0,0,0,0,0,0,0,0,0,0,0,0,2,3,1,0
71268,235,4857,99,48,90,1,3,5,100,0,0,0,0,0,0,0,0,0,0,0,0,2,3,1,0
71269,235,4857,8,5,5,2,0,1,10,0,0,0,0,0,0,0,0,0,0,0,0,2,3,1,0
71270,235,4857,1217,716,841,84,126,174,1301,14,185,118,215,199,333,1446,2542,8,20687,1149,0,2,3,1,0
71271,235,4857,160,89,115,0,13,31,160,7,15,11,17,22,28,78,124,3,495,27,0,2,3,1,0
71272,235,4857,10,10,9,9,0,0,19,0,0,0,0,0,0,0,0,0,0,0,0,2,3,1,0
71273,235,4857,173,84,99,8,29,36,181,5,12,7,13,17,20,54,81,2,221,12,0,2,3,1,0
71274,235,4857,3,1,1,3,0,0,6,0,0,0,0,0,0,0,0,0,0,0,0,2,3,1,0
71275,53,1795,601,196,481,2,23,85,603,8,63,36,72,71,108,400,664,4,3036,168,0,2,18,0,0
71276,55,1098,207,111,150,11,0,50,218,5,26,19,36,31,55,133,272,3,943,52,0,2,8,6,0
71277,55,1098,410,198,237,31,55,97,441,11,63,38,72,74,110,414,683,6,4293,238,0,2,8,6,0
71278,315,6863,72,33,56,0,4,12,72,1,1,1,1,2,2,0,2,0,1,0,0,2,6,4,0
71279,315,6863,1454,835,1044,76,110,219,1530,17,275,158,296,292,454,2297,3718,9,34017,1889,1,2,6,4,0
71280,107,4626,1289,550,1043,56,32,155,1345,10,167,93,185,177,278,1266,2075,5,11498,638,0,2,30,2,0
71281,21,478,207,111,150,11,0,50,218,5,26,19,36,31,55,133,272,3,943,52,0,2,23,3,0
71282,57,1122,207,111,150,11,0,50,218,5,26,19,36,31,55,133,272,3,943,52,0,2,8,4,1
71283,57,1122,410,198,237,31,55,97,441,11,63,38,72,74,110,414,683,6,4293,238,0,2,8,4,1
71284,251,5834,4293,999,3693,19,54,507,4312,9,155,88,170,164,258,1156,1898,4,9368,520,0,2,2,2,1
71285,251,5834,1482,859,1002,125,135,219,1607,16,219,134,251,235,385,1766,3032,9,27804,1544,1,2,2,2,1
71286,89,3931,1338,495,1086,10,64,173,1348,11,122,82,157,133,239,883,1686,7,11934,663,0,2,0,46,1
71287,178,7721,4293,999,3693,19,54,507,4312,9,155,88,170,164,258,1156,1898,4,9368,520,0,2,43,3,1
71288,178,7721,1482,859,1002,125,135,219,1607,16,219,134,251,235,385,1766,3032,9,27804,1544,1,2,43,3,1
71289,22,484,207,111,150,11,0,50,218,5,26,19,36,31,55,133,272,3,943,52,0,2,11,0,1
71320,318,6891,72,33,56,0,4,12,72,1,1,1,1,2,2,0,2,0,1,0,0,2,10,5,0
71321,318,6891,1454,835,1044,76,110,219,1530,17,275,158,296,292,454,2297,3718,9,34017,1889,1,2,10,5,0
71322,107,4630,1289,550,1043,56,32,155,1345,10,167,93,185,177,278,1266,2075,5,11498,638,0,2,8,2,0
71323,56,1113,207,111,150,11,0,50,218,5,26,19,36,31,55,133,272,3,943,52,0,2,8,4,0
71324,56,1113,410,198,237,31,55,97,441,11,63,38,72,74,110,414,683,6,4293,238,0,2,8,4,0
71325,251,5834,4293,999,3693,19,54,507,4312,9,155,88,170,164,258,1156,1898,4,9368,520,0,2,2,2,0
71326,251,5834,1482,859,1002,125,135,219,1607,16,219,134,251,235,385,1766,3032,9,27804,1544,1,2,2,2,0
71327,89,3931,1338,495,1086,10,64,173,1348,11,122,82,157,133,239,883,1686,7,11934,663,0,2,0,46,0
71328,178,7721,4293,999,3693,19,54,507,4312,9,155,88,170,164,258,1156,1898,4,9368,520,0,2,43,3,0
71329,178,7721,1482,859,1002,125,135,219,1607,16,219,134,251,235,385,1766,3032,9,27804,1544,1,2,43,3,0
71330,23,513,207,111,150,11,0,50,218,5,26,19,36,31,55,133,272,3,943,52,0,2,11,0,0
71353,57,1141,207,111,150,11,0,50,218,5,26,19,36,31,55,133,272,3,943,52,0,2,16,10,0
71354,57,1141,410,198,237,31,55,97,441,11,63,38,72,74,110,414,683,6,4293,238,0,2,16,10,0
71357,238,5010,2,2,2,0,0,0,2,0,0,0,0,0,0,0,0,0,0,0,0,2,3,1,0
71371,238,5010,99,48,90,1,3,5,100,0,0,0,0,0,0,0,0,0,0,0,0,2,3,1,0
71372,238,5010,8,5,5,2,0,1,10,0,0,0,0,0,0,0,0,0,0,0,0,2,3,1,0
71373,238,5010,1217,716,841,84,126,174,1301,14,185,118,215,199,333,1446,2542,8,20687,1149,0,2,3,1,0
71374,238,5010,160,89,115,0,13,31,160,7,15,11,17,22,28,78,124,3,495,27,0,2,3,1,0
71375,238,5010,10,10,9,9,0,0,19,0,0,0,0,0,0,0,0,0,0,0,0,2,3,1,0
71376,238,5010,173,84,99,8,29,36,181,5,12,7,13,17,20,54,81,2,221,12,0,2,3,1,0
71377,238,5010,3,1,1,3,0,0,6,0,0,0,0,0,0,0,0,0,0,0,0,2,3,1,0
71378,250,5807,4293,999,3693,19,54,507,4312,9,155,88,170,164,258,1156,1898,4,9368,520,0,2,2,2,0
71379,250,5807,1482,859,1002,125,135,219,1607,16,219,134,251,235,385,1766,3032,9,27804,1544,1,2,2,2,0
71380,12,572,205,80,86,16,53,53,221,7,18,10,19,25,29,94,134,3,497,27,0,2,13,6,0
71381,225,5745,722,423,573,19,0,135,741,12,172,101,199,184,300,1320,2257,6,15668,870,0,2,6,0,0
71382,225,5745,1508,847,911,44,250,301,1552,14,148,88,169,162,257,1120,1886,7,15077,837,0,2,6,0,0
71383,303,6685,72,33,56,0,4,12,72,1,1,1,1,2,2,0,2,0,1,0,0,2,13,6,0
71384,303,6685,1454,835,1044,76,110,219,1530,17,275,158,296,292,454,2297,3718,9,34017,1889,1,2,13,6,0
71385,107,4624,1289,550,1043,56,32,155,1345,10,167,93,185,177,278,1266,2075,5,11498,638,0,2,37,3,0
71387,176,7666,4293,999,3693,19,54,507,4312,9,155,88,170,164,258,1156,1898,4,9368,520,0,2,43,3,0
71388,176,7666,1482,859,1002,125,135,219,1607,16,219,134,251,235,385,1766,3032,9,27804,1544,1,2,43,3,0
71389,23,513,207,111,150,11,0,50,218,5,26,19,36,31,55,133,272,3,943,52,0,2,34,3,0
71391,49,1706,601,196,481,2,23,85,603,8,63,36,72,71,108,400,664,4,3036,168,0,2,18,0,0
71392,12,572,205,80,86,16,53,53,221,7,18,10,19,25,29,94,134,3,497,27,0,2,1,1,0
71393,225,5745,722,423,573,19,0,135,741,12,172,101,199,184,300,1320,2257,6,15668,870,0,2,1,1,0
71394,225,5745,1508,847,911,44,250,301,1552,14,148,88,169,162,257,1120,1886,7,15077,837,0,2,1,1,0
71453,178,7750,4293,999,3693,19,54,507,4312,9,155,88,170,164,258,1156,1898,4,9368,520,0,2,10,10,0
71454,178,7750,1482,859,1002,125,135,219,1607,16,219,134,251,235,385,1766,3032,9,27804,1544,1,2,10,10,0
71457,1,93,42,7,35,4,0,5,46,1,2,1,2,3,3,2,4,0,2,0,0,2,3,4,0
71458,1,93,11,6,10,0,0,1,11,2,4,2,4,6,6,10,15,1,15,0,0,2,3,4,0
71459,216,4948,182,127,129,0,0,53,182,5,39,21,42,44,63,217,343,2,926,51,0,2,87,31,0
71460,216,4948,1165,710,800,67,119,181,1232,18,243,153,282,261,435,2000,3492,10,36473,2026,1,2,87,31,0
71466,57,1141,207,111,150,11,0,50,218,5,26,19,36,31,55,133,272,3,943,52,0,2,8,2,0
71467,57,1141,410,198,237,31,55,97,441,11,63,38,72,74,110,414,683,6,4293,238,0,2,8,2,0
71470,238,5010,2,2,2,0,0,0,2,0,0,0,0,0,0,0,0,0,0,0,0,2,75,22,0
71484,238,5010,99,48,90,1,3,5,100,0,0,0,0,0,0,0,0,0,0,0,0,2,75,22,0
71485,238,5010,8,5,5,2,0,1,10,0,0,0,0,0,0,0,0,0,0,0,0,2,75,22,0
71486,238,5010,1217,716,841,84,126,174,1301,14,185,118,215,199,333,1446,2542,8,20687,1149,0,2,75,22,0
71487,238,5010,160,89,115,0,13,31,160,7,15,11,17,22,28,78,124,3,495,27,0,2,75,22,0
71488,238,5010,10,10,9,9,0,0,19,0,0,0,0,0,0,0,0,0,0,0,0,2,75,22,0
71489,238,5010,173,84,99,8,29,36,181,5,12,7,13,17,20,54,81,2,221,12,0,2,75,22,0
71490,238,5010,3,1,1,3,0,0,6,0,0,0,0,0,0,0,0,0,0,0,0,2,75,22,0
71491,56,780,167,116,138,4,5,22,171,8,48,30,56,56,86,292,499,4,2330,129,0,2,3,4,0
71495,250,5807,4293,999,3693,19,54,507,4312,9,155,88,170,164,258,1156,1898,4,9368,520,0,2,13,14,0
71496,250,5807,1482,859,1002,125,135,219,1607,16,219,134,251,235,385,1766,3032,9,27804,1544,1,2,13,14,0
71500,117,3166,1523,757,1297,19,12,193,1542,12,193,117,230,205,347,1508,2664,7,19053,1058,0,2,14,11,0
71501,117,3166,701,378,504,33,58,109,734,13,110,68,126,123,194,794,1346,7,10027,557,0,2,14,11,0
71502,142,3472,77,34,69,0,0,8,77,3,24,16,29,27,45,114,213,1,387,21,0,2,0,22,0
71503,142,3472,712,438,573,51,9,84,763,14,102,71,128,116,199,733,1364,8,11988,666,0,2,0,22,0
71507,12,572,205,80,86,16,53,53,221,7,18,10,19,25,29,94,134,3,497,27,0,2,24,10,0
71508,225,5745,722,423,573,19,0,135,741,12,172,101,199,184,300,1320,2257,6,15668,870,0,2,11,9,0
71509,225,5745,1508,847,911,44,250,301,1552,14,148,88,169,162,257,1120,1886,7,15077,837,0,2,11,9,0
71510,303,6685,72,33,56,0,4,12,72,1,1,1,1,2,2,0,2,0,1,0,0,2,47,82,0
71511,303,6685,1454,835,1044,76,110,219,1530,17,275,158,296,292,454,2297,3718,9,34017,1889,1,2,47,82,0
71512,79,1967,757,253,292,73,244,162,830,13,61,38,67,74,105,409,651,7,4654,258,0,2,80,44,0
71513,20,993,386,256,301,16,9,68,402,4,59,35,69,63,104,355,621,2,1453,80,0,2,97,44,0
71514,20,993,264,131,164,11,41,46,275,6,38,22,40,44,62,214,338,3,1068,59,0,2,97,44,0
71515,87,1891,1043,504,840,53,9,147,1096,9,180,112,198,189,310,1377,2344,4,11604,644,0,2,8,13,0
71516,87,1891,383,288,292,26,6,62,409,11,65,38,67,76,105,429,656,5,3719,206,0,2,8,13,0
71521,70,1371,1098,241,925,5,10,155,1103,7,46,25,49,53,74,273,423,3,1580,87,0,2,9,0,0
71522,70,1371,282,202,222,14,2,44,296,8,42,24,43,50,67,250,378,4,1548,86,0,2,9,0,0
71527,107,4624,1289,550,1043,56,32,155,1345,10,167,93,185,177,278,1266,2075,5,11498,638,0,2,3,6,0
71529,4,181,75,38,59,1,3,12,76,2,4,2,4,6,6,10,15,1,15,0,0,2,0,173,0
71533,176,7695,4293,999,3693,19,54,507,4312,9,155,88,170,164,258,1156,1898,4,9368,520,0,2,28,47,0
71534,176,7695,1482,859,1002,125,135,219,1607,16,219,134,251,235,385,1766,3032,9,27804,1544,1,2,28,47,0
71535,147,5933,1782,648,1425,9,47,279,1791,8,171,97,189,179,286,1292,2140,4,9462,525,0,2,24,14,0
71536,30,903,256,139,192,9,7,47,265,4,23,12,24,27,36,112,171,2,357,19,0,2,14,34,0
71539,110,5948,1457,730,1242,11,6,188,1468,10,292,166,329,302,495,2424,4078,5,22973,1276,1,2,165,4,0
71542,113,5691,1523,757,1297,19,12,193,1542,12,193,117,230,205,347,1508,2664,7,19053,1058,0,2,236,114,0
71544,55,2824,722,423,573,19,0,135,741,12,172,101,199,184,300,1320,2257,6,15668,870,0,2,2,3,0
71545,46,1968,386,256,301,16,9,68,402,4,59,35,69,63,104,355,621,2,1453,80,0,2,16,16,0
71547,39,1770,442,244,305,14,16,103,456,11,68,45,75,79,120,452,756,6,4588,254,0,2,4,11,0
71548,51,2032,1098,241,925,5,10,155,1103,7,46,25,49,53,74,273,423,3,1580,87,0,2,1,3,0
71549,49,1706,601,196,481,2,23,85,603,8,63,36,72,71,108,400,664,4,3036,168,0,2,8,31,0
71550,183,5407,1660,832,1314,41,38,274,1701,20,312,209,395,332,604,2671,5058,12,64042,3557,1,2,2,1,0
71551,183,5407,1057,646,719,113,100,145,1170,18,215,134,248,233,382,1740,3004,10,31186,1732,1,2,2,1,0
71552,216,4979,182,127,129,0,0,53,182,5,39,21,42,44,63,217,343,2,926,51,0,2,17,10,1
71553,216,4979,1165,710,800,67,119,181,1232,18,243,153,282,261,435,2000,3492,10,36473,2026,1,2,17,10,1
71554,67,1549,773,419,590,28,0,166,801,10,204,113,217,214,330,1598,2554,5,13587,754,0,2,7,6,1
71555,67,1549,421,273,302,44,34,57,465,17,81,59,107,98,166,583,1098,11,12329,684,0,2,7,6,1
71558,27,568,2,2,2,0,0,0,2,0,0,0,0,0,0,0,0,0,0,0,0,2,8,3,1
71572,27,568,99,48,90,1,3,5,100,0,0,0,0,0,0,0,0,0,0,0,0,2,8,3,1
71573,27,568,8,5,5,2,0,1,10,0,0,0,0,0,0,0,0,0,0,0,0,2,8,3,1
71574,27,568,1217,716,841,84,126,174,1301,14,185,118,215,199,333,1446,2542,8,20687,1149,0,2,8,3,1
71575,27,568,160,89,115,0,13,31,160,7,15,11,17,22,28,78,124,3,495,27,0,2,8,3,1
71576,27,568,10,10,9,9,0,0,19,0,0,0,0,0,0,0,0,0,0,0,0,2,8,3,1
71577,27,568,173,84,99,8,29,36,181,5,12,7,13,17,20,54,81,2,221,12,0,2,8,3,1
71578,27,568,3,1,1,3,0,0,6,0,0,0,0,0,0,0,0,0,0,0,0,2,8,3,1
71579,183,5421,1660,832,1314,41,38,274,1701,20,312,209,395,332,604,2671,5058,12,64042,3557,1,2,26,21,1
71580,183,5421,1057,646,719,113,100,145,1170,18,215,134,248,233,382,1740,3004,10,31186,1732,1,2,26,21,1
71581,114,2099,477,336,357,30,23,73,507,16,194,134,250,210,384,1538,2962,10,30538,1696,0,2,9,6,1
71584,238,5067,2,2,2,0,0,0,2,0,0,0,0,0,0,0,0,0,0,0,0,2,33,17,1
71598,238,5067,99,48,90,1,3,5,100,0,0,0,0,0,0,0,0,0,0,0,0,2,33,17,1
71599,238,5067,8,5,5,2,0,1,10,0,0,0,0,0,0,0,0,0,0,0,0,2,33,17,1
71600,238,5067,1217,716,841,84,126,174,1301,14,185,118,215,199,333,1446,2542,8,20687,1149,0,2,33,17,1
71601,238,5067,160,89,115,0,13,31,160,7,15,11,17,22,28,78,124,3,495,27,0,2,33,17,1
71602,238,5067,10,10,9,9,0,0,19,0,0,0,0,0,0,0,0,0,0,0,0,2,33,17,1
71603,238,5067,173,84,99,8,29,36,181,5,12,7,13,17,20,54,81,2,221,12,0,2,33,17,1
71604,238,5067,3,1,1,3,0,0,6,0,0,0,0,0,0,0,0,0,0,0,0,2,33,17,1
71605,111,2283,463,295,324,28,62,57,491,12,134,82,154,146,236,989,1696,6,11700,650,0,2,24,14,1
71606,37,813,167,116,138,4,5,22,171,8,48,30,56,56,86,292,499,4,2330,129,0,2,11,1,1
71607,30,669,125,97,103,3,0,19,128,9,25,17,27,34,44,144,223,4,1087,60,0,2,2,0,1
71608,70,1526,402,202,227,24,74,80,426,12,52,33,61,64,94,339,564,7,3969,220,0,2,1,1,1
71609,73,1707,53,23,39,0,0,13,53,2,8,4,8,10,12,26,39,1,39,2,0,2,35,17,1
71610,73,1707,515,298,307,33,80,99,548,12,63,44,77,75,121,419,753,7,5527,307,0,2,35,17,1
71611,67,1752,466,257,367,18,25,50,484,7,126,86,171,133,257,898,1813,4,8612,478,0,2,4,3,1
71612,67,1752,507,281,342,29,59,88,536,10,53,29,57,63,86,336,514,5,2764,153,0,2,4,3,1
71613,87,1935,1043,504,840,53,9,147,1096,9,180,112,198,189,310,1377,2344,4,11604,644,0,2,17,5,1
71614,87,1935,383,288,292,26,6,62,409,11,65,38,67,76,105,429,656,5,3719,206,0,2,17,5,1
71615,216,4943,182,127,129,0,0,53,182,5,39,21,42,44,63,217,343,2,926,51,0,2,1,1,0
71616,216,4943,1165,710,800,67,119,181,1232,18,243,153,282,261,435,2000,3492,10,36473,2026,1,2,1,1,0
71617,80,1982,757,253,292,73,244,162,830,13,61,38,67,74,105,409,651,7,4654,258,0,2,12,5,0
71618,21,1008,386,256,301,16,9,68,402,4,59,35,69,63,104,355,621,2,1453,80,0,2,12,6,0
71619,21,1008,264,131,164,11,41,46,275,6,38,22,40,44,62,214,338,3,1068,59,0,2,12,6,0
71620,115,2286,463,295,324,28,62,57,491,12,134,82,154,146,236,989,1696,6,11700,650,0,2,6,0,1
71621,111,6022,1457,730,1242,11,6,188,1468,10,292,166,329,302,495,2424,4078,5,22973,1276,1,2,15,0,1
71622,183,5390,1660,832,1314,41,38,274,1701,20,312,209,395,332,604,2671,5058,12,64042,3557,1,2,1,4,0
71623,183,5390,1057,646,719,113,100,145,1170,18,215,134,248,233,382,1740,3004,10,31186,1732,1,2,1,4,0
71624,122,4961,1450,624,1228,12,26,181,1462,14,306,186,354,320,540,2580,4493,8,36391,2021,1,2,20,0,0
71625,122,4963,1450,624,1228,12,26,181,1462,14,306,186,354,320,540,2580,4493,8,36391,2021,1,2,7,5,0
71626,115,2286,463,295,324,28,62,57,491,12,134,82,154,146,236,989,1696,6,11700,650,0,2,6,0,0
71627,111,6022,1457,730,1242,11,6,188,1468,10,292,166,329,302,495,2424,4078,5,22973,1276,1,2,15,0,0
71630,122,4963,1450,624,1228,12,26,181,1462,14,306,186,354,320,540,2580,4493,8,36391,2021,1,2,27,5,0
71631,57,1141,207,111,150,11,0,50,218,5,26,19,36,31,55,133,272,3,943,52,0,2,2,2,1
71632,57,1141,410,198,237,31,55,97,441,11,63,38,72,74,110,414,683,6,4293,238,0,2,2,2,1
71633,57,1141,207,111,150,11,0,50,218,5,26,19,36,31,55,133,272,3,943,52,0,2,2,2,0
71634,57,1141,410,198,237,31,55,97,441,11,63,38,72,74,110,414,683,6,4293,238,0,2,2,2,0
71635,58,1166,207,111,150,11,0,50,218,5,26,19,36,31,55,133,272,3,943,52,0,2,7,0,0
71636,58,1166,410,198,237,31,55,97,441,11,63,38,72,74,110,414,683,6,4293,238,0,2,7,0,0
71637,79,1961,757,253,292,73,244,162,830,13,61,38,67,74,105,409,651,7,4654,258,0,2,1,7,0
71638,20,987,386,256,301,16,9,68,402,4,59,35,69,63,104,355,621,2,1453,80,0,2,1,7,0
71639,20,987,264,131,164,11,41,46,275,6,38,22,40,44,62,214,338,3,1068,59,0,2,1,7,0
71640,252,5831,4293,999,3693,19,54,507,4312,9,155,88,170,164,258,1156,1898,4,9368,520,0,2,4,0,0
71641,252,5831,1482,859,1002,125,135,219,1607,16,219,134,251,235,385,1766,3032,9,27804,1544,1,2,4,0,0
71642,177,7730,4293,999,3693,19,54,507,4312,9,155,88,170,164,258,1156,1898,4,9368,520,0,2,29,0,0
71643,177,7730,1482,859,1002,125,135,219,1607,16,219,134,251,235,385,1766,3032,9,27804,1544,1,2,29,0,0
71644,30,911,256,139,192,9,7,47,265,4,23,12,24,27,36,112,171,2,357,19,0,2,8,9,0
71645,30,919,256,139,192,9,7,47,265,4,23,12,24,27,36,112,171,2,357,19,0,2,3,2,0
71646,58,1166,207,111,150,11,0,50,218,5,26,19,36,31,55,133,272,3,943,52,0,2,1,1,0
71647,58,1166,410,198,237,31,55,97,441,11,63,38,72,74,110,414,683,6,4293,238,0,2,1,1,0
71648,30,919,256,139,192,9,7,47,265,4,23,12,24,27,36,112,171,2,357,19,0,2,1,1,0
71649,216,4979,182,127,129,0,0,53,182,5,39,21,42,44,63,217,343,2,926,51,0,2,17,10,0
71650,216,4979,1165,710,800,67,119,181,1232,18,243,153,282,261,435,2000,3492,10,36473,2026,1,2,17,10,0
71651,67,1549,773,419,590,28,0,166,801,10,204,113,217,214,330,1598,2554,5,13587,754,0,2,7,6,0
71652,67,1549,421,273,302,44,34,57,465,17,81,59,107,98,166,583,1098,11,12329,684,0,2,7,6,0
71655,27,568,2,2,2,0,0,0,2,0,0,0,0,0,0,0,0,0,0,0,0,2,8,3,0
71669,27,568,99,48,90,1,3,5,100,0,0,0,0,0,0,0,0,0,0,0,0,2,8,3,0
71670,27,568,8,5,5,2,0,1,10,0,0,0,0,0,0,0,0,0,0,0,0,2,8,3,0
71671,27,568,1217,716,841,84,126,174,1301,14,185,118,215,199,333,1446,2542,8,20687,1149,0,2,8,3,0
71672,27,568,160,89,115,0,13,31,160,7,15,11,17,22,28,78,124,3,495,27,0,2,8,3,0
71673,27,568,10,10,9,9,0,0,19,0,0,0,0,0,0,0,0,0,0,0,0,2,8,3,0
71674,27,568,173,84,99,8,29,36,181,5,12,7,13,17,20,54,81,2,221,12,0,2,8,3,0
71675,27,568,3,1,1,3,0,0,6,0,0,0,0,0,0,0,0,0,0,0,0,2,8,3,0
71676,183,5421,1660,832,1314,41,38,274,1701,20,312,209,395,332,604,2671,5058,12,64042,3557,1,2,28,22,0
71677,183,5421,1057,646,719,113,100,145,1170,18,215,134,248,233,382,1740,3004,10,31186,1732,1,2,28,22,0
71678,114,2099,477,336,357,30,23,73,507,16,194,134,250,210,384,1538,2962,10,30538,1696,0,2,9,6,0
71681,238,5067,2,2,2,0,0,0,2,0,0,0,0,0,0,0,0,0,0,0,0,2,33,17,0
71695,238,5067,99,48,90,1,3,5,100,0,0,0,0,0,0,0,0,0,0,0,0,2,33,17,0
71696,238,5067,8,5,5,2,0,1,10,0,0,0,0,0,0,0,0,0,0,0,0,2,33,17,0
71697,238,5067,1217,716,841,84,126,174,1301,14,185,118,215,199,333,1446,2542,8,20687,1149,0,2,33,17,0
71698,238,5067,160,89,115,0,13,31,160,7,15,11,17,22,28,78,124,3,495,27,0,2,33,17,0
71699,238,5067,10,10,9,9,0,0,19,0,0,0,0,0,0,0,0,0,0,0,0,2,33,17,0
71700,238,5067,173,84,99,8,29,36,181,5,12,7,13,17,20,54,81,2,221,12,0,2,33,17,0
71701,238,5067,3,1,1,3,0,0,6,0,0,0,0,0,0,0,0,0,0,0,0,2,33,17,0
71702,113,2326,463,295,324,28,62,57,491,12,134,82,154,146,236,989,1696,6,11700,650,0,2,24,14,0
71703,37,813,167,116,138,4,5,22,171,8,48,30,56,56,86,292,499,4,2330,129,0,2,11,1,0
71704,30,669,125,97,103,3,0,19,128,9,25,17,27,34,44,144,223,4,1087,60,0,2,2,0,0
71705,70,1526,402,202,227,24,74,80,426,12,52,33,61,64,94,339,564,7,3969,220,0,2,1,1,0
71706,73,1707,53,23,39,0,0,13,53,2,8,4,8,10,12,26,39,1,39,2,0,2,35,17,0
71707,73,1707,515,298,307,33,80,99,548,12,63,44,77,75,121,419,753,7,5527,307,0,2,35,17,0
71708,67,1752,466,257,367,18,25,50,484,7,126,86,171,133,257,898,1813,4,8612,478,0,2,4,3,0
71709,67,1752,507,281,342,29,59,88,536,10,53,29,57,63,86,336,514,5,2764,153,0,2,4,3,0
71710,87,1935,1043,504,840,53,9,147,1096,9,180,112,198,189,310,1377,2344,4,11604,644,0,2,17,5,0
71711,87,1935,383,288,292,26,6,62,409,11,65,38,67,76,105,429,656,5,3719,206,0,2,17,5,0
71716,79,1961,757,253,292,73,244,162,830,13,61,38,67,74,105,409,651,7,4654,258,0,2,7,6,0
71717,20,987,386,256,301,16,9,68,402,4,59,35,69,63,104,355,621,2,1453,80,0,2,7,7,0
71718,20,987,264,131,164,11,41,46,275,6,38,22,40,44,62,214,338,3,1068,59,0,2,7,7,0
71719,30,919,256,139,192,9,7,47,265,4,23,12,24,27,36,112,171,2,357,19,0,2,8,8,0
71720,15,481,184,100,137,2,15,30,186,6,38,20,39,44,59,214,322,3,991,55,0,2,1,1,0
71721,15,481,103,65,74,8,5,16,111,7,17,9,17,24,26,89,119,3,417,23,0,2,1,1,0
71722,11,492,184,100,137,2,15,30,186,6,38,20,39,44,59,214,322,3,991,55,0,2,12,0,0
71726,75,1811,466,257,367,18,25,50,484,7,126,86,171,133,257,898,1813,4,8612,478,0,2,116,89,0
71727,75,1811,507,281,342,29,59,88,536,10,53,29,57,63,86,336,514,5,2764,153,0,2,116,89,0
71728,31,956,182,127,129,0,0,53,182,5,39,21,42,44,63,217,343,2,926,51,0,2,3,7,0
71729,146,7027,1392,870,1177,35,17,170,1427,14,494,280,531,508,811,4473,7289,7,54850,3047,2,2,158,196,0
71730,15,359,127,75,83,2,11,30,129,4,14,7,14,18,21,61,87,2,175,9,0,2,33,0,0
71731,15,359,652,304,544,16,6,88,668,6,89,51,101,95,152,591,998,3,3399,188,0,2,33,0,0
71732,15,359,2,2,2,0,0,0,2,0,0,0,0,0,0,0,0,0,0,0,0,2,33,0,0
71733,15,359,8,5,5,0,0,3,8,0,0,0,0,0,0,0,0,0,0,0,0,2,33,0,0
71736,15,359,14,8,8,0,0,6,14,0,0,0,0,0,0,0,0,0,0,0,0,2,33,0,0
71737,15,359,6,4,4,0,0,2,6,0,0,0,0,0,0,0,0,0,0,0,0,2,33,0,0
71738,15,359,6,4,4,0,0,2,6,1,2,1,2,3,3,2,4,0,2,0,0,2,33,0,0
71740,15,359,7,5,5,0,0,2,7,0,0,0,0,0,0,0,0,0,0,0,0,2,33,0,0
71742,15,359,10,6,6,0,0,4,10,0,0,0,0,0,0,0,0,0,0,0,0,2,33,0,0
71743,15,359,1,1,1,0,0,0,1,0,0,0,0,0,0,0,0,0,0,0,0,2,33,0,0
71745,15,359,14,10,10,0,0,4,14,1,1,1,1,2,2,0,2,0,1,0,0,2,33,0,0
71746,15,359,46,26,30,3,0,12,49,3,6,3,6,9,9,20,28,1,42,2,0,2,33,0,0
71749,239,5045,2,2,2,0,0,0,2,0,0,0,0,0,0,0,0,0,0,0,0,2,13,6,1
71763,239,5045,99,48,90,1,3,5,100,0,0,0,0,0,0,0,0,0,0,0,0,2,13,6,1
71764,239,5045,8,5,5,2,0,1,10,0,0,0,0,0,0,0,0,0,0,0,0,2,13,6,1
71765,239,5045,1217,716,841,84,126,174,1301,14,185,118,215,199,333,1446,2542,8,20687,1149,0,2,13,6,1
71766,239,5045,160,89,115,0,13,31,160,7,15,11,17,22,28,78,124,3,495,27,0,2,13,6,1
71767,239,5045,10,10,9,9,0,0,19,0,0,0,0,0,0,0,0,0,0,0,0,2,13,6,1
71768,239,5045,173,84,99,8,29,36,181,5,12,7,13,17,20,54,81,2,221,12,0,2,13,6,1
71769,239,5045,3,1,1,3,0,0,6,0,0,0,0,0,0,0,0,0,0,0,0,2,13,6,1
71770,45,2802,652,304,544,16,6,88,668,6,89,51,101,95,152,591,998,3,3399,188,0,2,24,5,1
71771,216,4974,182,127,129,0,0,53,182,5,39,21,42,44,63,217,343,2,926,51,0,2,1,1,0
71772,216,4974,1165,710,800,67,119,181,1232,18,243,153,282,261,435,2000,3492,10,36473,2026,1,2,1,1,0
71773,183,5415,1660,832,1314,41,38,274,1701,20,312,209,395,332,604,2671,5058,12,64042,3557,1,2,1,4,0
71774,183,5415,1057,646,719,113,100,145,1170,18,215,134,248,233,382,1740,3004,10,31186,1732,1,2,1,4,0
71775,58,1166,207,111,150,11,0,50,218,5,26,19,36,31,55,133,272,3,943,52,0,2,9,2,0
71776,58,1166,410,198,237,31,55,97,441,11,63,38,72,74,110,414,683,6,4293,238,0,2,9,2,0
71782,176,7695,4293,999,3693,19,54,507,4312,9,155,88,170,164,258,1156,1898,4,9368,520,0,2,10,10,0
71783,176,7695,1482,859,1002,125,135,219,1607,16,219,134,251,235,385,1766,3032,9,27804,1544,1,2,10,10,0
71803,16,491,184,100,137,2,15,30,186,6,38,20,39,44,59,214,322,3,991,55,0,2,9,4,0
71804,16,491,103,65,74,8,5,16,111,7,17,9,17,24,26,89,119,3,417,23,0,2,9,4,0
71805,18,697,184,100,137,2,15,30,186,6,38,20,39,44,59,214,322,3,991,55,0,2,55,1,0
71806,45,2806,652,304,544,16,6,88,668,6,89,51,101,95,152,591,998,3,3399,188,0,2,6,8,1
71809,238,5023,2,2,2,0,0,0,2,0,0,0,0,0,0,0,0,0,0,0,0,2,4,7,1
71823,238,5023,99,48,90,1,3,5,100,0,0,0,0,0,0,0,0,0,0,0,0,2,4,7,1
71824,238,5023,8,5,5,2,0,1,10,0,0,0,0,0,0,0,0,0,0,0,0,2,4,7,1
71825,238,5023,1217,716,841,84,126,174,1301,14,185,118,215,199,333,1446,2542,8,20687,1149,0,2,4,7,1
71826,238,5023,160,89,115,0,13,31,160,7,15,11,17,22,28,78,124,3,495,27,0,2,4,7,1
71827,238,5023,10,10,9,9,0,0,19,0,0,0,0,0,0,0,0,0,0,0,0,2,4,7,1
71828,238,5023,173,84,99,8,29,36,181,5,12,7,13,17,20,54,81,2,221,12,0,2,4,7,1
71829,238,5023,3,1,1,3,0,0,6,0,0,0,0,0,0,0,0,0,0,0,0,2,4,7,1
71830,65,1385,91,45,69,0,3,18,91,3,9,6,10,12,16,33,57,1,95,5,0,2,10,0,1
71831,65,1385,367,234,237,17,34,68,384,16,55,34,61,71,95,381,584,8,5183,287,0,2,10,0,1
71832,45,2806,652,304,544,16,6,88,668,6,89,51,101,95,152,591,998,3,3399,188,0,2,5,5,1
71835,238,5023,2,2,2,0,0,0,2,0,0,0,0,0,0,0,0,0,0,0,0,2,10,6,0
71849,238,5023,99,48,90,1,3,5,100,0,0,0,0,0,0,0,0,0,0,0,0,2,10,6,0
71850,238,5023,8,5,5,2,0,1,10,0,0,0,0,0,0,0,0,0,0,0,0,2,10,6,0
71851,238,5023,1217,716,841,84,126,174,1301,14,185,118,215,199,333,1446,2542,8,20687,1149,0,2,10,6,0
71852,238,5023,160,89,115,0,13,31,160,7,15,11,17,22,28,78,124,3,495,27,0,2,10,6,0
71853,238,5023,10,10,9,9,0,0,19,0,0,0,0,0,0,0,0,0,0,0,0,2,10,6,0
71854,238,5023,173,84,99,8,29,36,181,5,12,7,13,17,20,54,81,2,221,12,0,2,10,6,0
71855,238,5023,3,1,1,3,0,0,6,0,0,0,0,0,0,0,0,0,0,0,0,2,10,6,0
71856,65,1385,91,45,69,0,3,18,91,3,9,6,10,12,16,33,57,1,95,5,0,2,10,0,0
71857,65,1385,367,234,237,17,34,68,384,16,55,34,61,71,95,381,584,8,5183,287,0,2,10,0,0
71858,45,2806,652,304,544,16,6,88,668,6,89,51,101,95,152,591,998,3,3399,188,0,2,21,4,0
71859,252,5837,4293,999,3693,19,54,507,4312,9,155,88,170,164,258,1156,1898,4,9368,520,0,2,5,2,0
71860,252,5837,1482,859,1002,125,135,219,1607,16,219,134,251,235,385,1766,3032,9,27804,1544,1,2,5,2,0
71861,177,7722,4293,999,3693,19,54,507,4312,9,155,88,170,164,258,1156,1898,4,9368,520,0,2,44,1,0
71862,177,7722,1482,859,1002,125,135,219,1607,16,219,134,251,235,385,1766,3032,9,27804,1544,1,2,44,1,0
71863,79,1938,466,257,367,18,25,50,484,7,126,86,171,133,257,898,1813,4,8612,478,0,2,46,19,0
71864,79,1938,507,281,342,29,59,88,536,10,53,29,57,63,86,336,514,5,2764,153,0,2,46,19,0
71865,31,1843,466,257,367,18,25,50,484,7,126,86,171,133,257,898,1813,4,8612,478,0,2,72,2,0
71869,79,1938,466,257,367,18,25,50,484,7,126,86,171,133,257,898,1813,4,8612,478,0,2,143,89,0
71870,79,1938,507,281,342,29,59,88,536,10,53,29,57,63,86,336,514,5,2764,153,0,2,143,89,0
71891,177,7723,4293,999,3693,19,54,507,4312,9,155,88,170,164,258,1156,1898,4,9368,520,0,2,28,18,0
71892,177,7723,1482,859,1002,125,135,219,1607,16,219,134,251,235,385,1766,3032,9,27804,1544,1,2,28,18,0
71893,252,5831,4293,999,3693,19,54,507,4312,9,155,88,170,164,258,1156,1898,4,9368,520,0,2,2,0,0
71894,252,5831,1482,859,1002,125,135,219,1607,16,219,134,251,235,385,1766,3032,9,27804,1544,1,2,2,0,0
71895,177,7731,4293,999,3693,19,54,507,4312,9,155,88,170,164,258,1156,1898,4,9368,520,0,2,3,0,0
71896,177,7731,1482,859,1002,125,135,219,1607,16,219,134,251,235,385,1766,3032,9,27804,1544,1,2,3,0,0
71958,177,7723,4293,999,3693,19,54,507,4312,9,155,88,170,164,258,1156,1898,4,9368,520,0,2,54,1,0
71959,177,7723,1482,859,1002,125,135,219,1607,16,219,134,251,235,385,1766,3032,9,27804,1544,1,2,54,1,0
71960,254,5861,4293,999,3693,19,54,507,4312,9,155,88,170,164,258,1156,1898,4,9368,520,0,2,6,0,0
71961,254,5861,1482,859,1002,125,135,219,1607,16,219,134,251,235,385,1766,3032,9,27804,1544,1,2,6,0,0
71962,178,7759,4293,999,3693,19,54,507,4312,9,155,88,170,164,258,1156,1898,4,9368,520,0,2,32,0,0
71963,178,7759,1482,859,1002,125,135,219,1607,16,219,134,251,235,385,1766,3032,9,27804,1544,1,2,32,0,0
71964,16,491,184,100,137,2,15,30,186,6,38,20,39,44,59,214,322,3,991,55,0,2,1,1,0
71965,16,491,103,65,74,8,5,16,111,7,17,9,17,24,26,89,119,3,417,23,0,2,1,1,0
71966,18,697,184,100,137,2,15,30,186,6,38,20,39,44,59,214,322,3,991,55,0,2,1,1,0
71967,3,65,127,75,83,2,11,30,129,4,14,7,14,18,21,61,87,2,175,9,0,2,1,1,1
71968,3,65,652,304,544,16,6,88,668,6,89,51,101,95,152,591,998,3,3399,188,0,2,1,1,1
71969,3,65,2,2,2,0,0,0,2,0,0,0,0,0,0,0,0,0,0,0,0,2,1,1,1
71970,3,65,8,5,5,0,0,3,8,0,0,0,0,0,0,0,0,0,0,0,0,2,1,1,1
71973,3,65,14,8,8,0,0,6,14,0,0,0,0,0,0,0,0,0,0,0,0,2,1,1,1
71974,3,65,6,4,4,0,0,2,6,0,0,0,0,0,0,0,0,0,0,0,0,2,1,1,1
71975,3,65,6,4,4,0,0,2,6,1,2,1,2,3,3,2,4,0,2,0,0,2,1,1,1
71977,3,65,7,5,5,0,0,2,7,0,0,0,0,0,0,0,0,0,0,0,0,2,1,1,1
71979,3,65,10,6,6,0,0,4,10,0,0,0,0,0,0,0,0,0,0,0,0,2,1,1,1
71980,3,65,1,1,1,0,0,0,1,0,0,0,0,0,0,0,0,0,0,0,0,2,1,1,1
71982,3,65,14,10,10,0,0,4,14,1,1,1,1,2,2,0,2,0,1,0,0,2,1,1,1
71983,3,65,46,26,30,3,0,12,49,3,6,3,6,9,9,20,28,1,42,2,0,2,1,1,1
71985,260,6091,4293,999,3693,19,54,507,4312,9,155,88,170,164,258,1156,1898,4,9368,520,0,2,73,6,1
71986,260,6091,1482,859,1002,125,135,219,1607,16,219,134,251,235,385,1766,3032,9,27804,1544,1,2,73,6,1
71987,180,7835,4293,999,3693,19,54,507,4312,9,155,88,170,164,258,1156,1898,4,9368,520,0,2,113,0,1
71988,180,7835,1482,859,1002,125,135,219,1607,16,219,134,251,235,385,1766,3032,9,27804,1544,1,2,113,0,1
71992,74,3931,1293,570,1093,25,15,163,1318,10,195,123,241,205,364,1516,2795,6,17273,959,0,2,1,1,0
71994,161,3434,1513,682,1277,25,13,200,1538,11,199,116,219,210,335,1557,2584,6,15641,868,0,2,5,1,0
71995,161,3434,819,519,539,24,98,155,843,15,96,57,106,111,163,690,1107,8,9171,509,0,2,5,1,0
71998,257,6183,4293,999,3693,19,54,507,4312,9,155,88,170,164,258,1156,1898,4,9368,520,0,2,44,5,0
71999,257,6183,1482,859,1002,125,135,219,1607,16,219,134,251,235,385,1766,3032,9,27804,1544,1,2,44,5,0
72002,238,5010,2,2,2,0,0,0,2,0,0,0,0,0,0,0,0,0,0,0,0,2,6,10,0
72016,238,5010,99,48,90,1,3,5,100,0,0,0,0,0,0,0,0,0,0,0,0,2,6,10,0
72017,238,5010,8,5,5,2,0,1,10,0,0,0,0,0,0,0,0,0,0,0,0,2,6,10,0
72018,238,5010,1217,716,841,84,126,174,1301,14,185,118,215,199,333,1446,2542,8,20687,1149,0,2,6,10,0
72019,238,5010,160,89,115,0,13,31,160,7,15,11,17,22,28,78,124,3,495,27,0,2,6,10,0
72020,238,5010,10,10,9,9,0,0,19,0,0,0,0,0,0,0,0,0,0,0,0,2,6,10,0
72021,238,5010,173,84,99,8,29,36,181,5,12,7,13,17,20,54,81,2,221,12,0,2,6,10,0
72022,238,5010,3,1,1,3,0,0,6,0,0,0,0,0,0,0,0,0,0,0,0,2,6,10,0
72023,64,1354,91,45,69,0,3,18,91,3,9,6,10,12,16,33,57,1,95,5,0,2,0,10,0
72024,64,1354,367,234,237,17,34,68,384,16,55,34,61,71,95,381,584,8,5183,287,0,2,0,10,0
72025,43,2669,652,304,544,16,6,88,668,6,89,51,101,95,152,591,998,3,3399,188,0,2,4,21,0
72028,238,5019,2,2,2,0,0,0,2,0,0,0,0,0,0,0,0,0,0,0,0,2,9,6,0
72042,238,5019,99,48,90,1,3,5,100,0,0,0,0,0,0,0,0,0,0,0,0,2,9,6,0
72043,238,5019,8,5,5,2,0,1,10,0,0,0,0,0,0,0,0,0,0,0,0,2,9,6,0
72044,238,5019,1217,716,841,84,126,174,1301,14,185,118,215,199,333,1446,2542,8,20687,1149,0,2,9,6,0
72045,238,5019,160,89,115,0,13,31,160,7,15,11,17,22,28,78,124,3,495,27,0,2,9,6,0
72046,238,5019,10,10,9,9,0,0,19,0,0,0,0,0,0,0,0,0,0,0,0,2,9,6,0
72047,238,5019,173,84,99,8,29,36,181,5,12,7,13,17,20,54,81,2,221,12,0,2,9,6,0
72048,238,5019,3,1,1,3,0,0,6,0,0,0,0,0,0,0,0,0,0,0,0,2,9,6,0
72049,46,2854,652,304,544,16,6,88,668,6,89,51,101,95,152,591,998,3,3399,188,0,2,30,2,0
72052,238,5019,2,2,2,0,0,0,2,0,0,0,0,0,0,0,0,0,0,0,0,2,8,9,0
72066,238,5019,99,48,90,1,3,5,100,0,0,0,0,0,0,0,0,0,0,0,0,2,8,9,0
72067,238,5019,8,5,5,2,0,1,10,0,0,0,0,0,0,0,0,0,0,0,0,2,8,9,0
72068,238,5019,1217,716,841,84,126,174,1301,14,185,118,215,199,333,1446,2542,8,20687,1149,0,2,8,9,0
72069,238,5019,160,89,115,0,13,31,160,7,15,11,17,22,28,78,124,3,495,27,0,2,8,9,0
72070,238,5019,10,10,9,9,0,0,19,0,0,0,0,0,0,0,0,0,0,0,0,2,8,9,0
72071,238,5019,173,84,99,8,29,36,181,5,12,7,13,17,20,54,81,2,221,12,0,2,8,9,0
72072,238,5019,3,1,1,3,0,0,6,0,0,0,0,0,0,0,0,0,0,0,0,2,8,9,0
72075,46,2854,652,304,544,16,6,88,668,6,89,51,101,95,152,591,998,3,3399,188,0,2,19,8,0
72076,76,1631,53,23,39,0,0,13,53,2,8,4,8,10,12,26,39,1,39,2,0,2,1,3,0
72077,76,1631,515,298,307,33,80,99,548,12,63,44,77,75,121,419,753,7,5527,307,0,2,1,3,0
72078,146,7064,1392,870,1177,35,17,170,1427,14,494,280,531,508,811,4473,7289,7,54850,3047,2,2,7,0,0
72086,238,5076,2,2,2,0,0,0,2,0,0,0,0,0,0,0,0,0,0,0,0,2,9,6,0
72100,238,5076,99,48,90,1,3,5,100,0,0,0,0,0,0,0,0,0,0,0,0,2,9,6,0
72101,238,5076,8,5,5,2,0,1,10,0,0,0,0,0,0,0,0,0,0,0,0,2,9,6,0
72102,238,5076,1217,716,841,84,126,174,1301,14,185,118,215,199,333,1446,2542,8,20687,1149,0,2,9,6,0
72103,238,5076,160,89,115,0,13,31,160,7,15,11,17,22,28,78,124,3,495,27,0,2,9,6,0
72104,238,5076,10,10,9,9,0,0,19,0,0,0,0,0,0,0,0,0,0,0,0,2,9,6,0
72105,238,5076,173,84,99,8,29,36,181,5,12,7,13,17,20,54,81,2,221,12,0,2,9,6,0
72106,238,5076,3,1,1,3,0,0,6,0,0,0,0,0,0,0,0,0,0,0,0,2,9,6,0
72107,254,5861,4293,999,3693,19,54,507,4312,9,155,88,170,164,258,1156,1898,4,9368,520,0,2,11,2,0
72108,254,5861,1482,859,1002,125,135,219,1607,16,219,134,251,235,385,1766,3032,9,27804,1544,1,2,11,2,0
72109,73,1701,53,23,39,0,0,13,53,2,8,4,8,10,12,26,39,1,39,2,0,2,1,3,0
72110,73,1701,515,298,307,33,80,99,548,12,63,44,77,75,121,419,753,7,5527,307,0,2,1,3,0
72111,79,1942,466,257,367,18,25,50,484,7,126,86,171,133,257,898,1813,4,8612,478,0,2,143,88,0
72112,79,1942,507,281,342,29,59,88,536,10,53,29,57,63,86,336,514,5,2764,153,0,2,143,88,0
72114,146,7064,1392,870,1177,35,17,170,1427,14,494,280,531,508,811,4473,7289,7,54850,3047,2,2,165,196,0
72132,178,7759,4293,999,3693,19,54,507,4312,9,155,88,170,164,258,1156,1898,4,9368,520,0,2,86,1,0
72133,178,7759,1482,859,1002,125,135,219,1607,16,219,134,251,235,385,1766,3032,9,27804,1544,1,2,86,1,0
72217,261,6237,4293,999,3693,19,54,507,4312,9,155,88,170,164,258,1156,1898,4,9368,520,0,2,11,2,0
72218,261,6237,1482,859,1002,125,135,219,1607,16,219,134,251,235,385,1766,3032,9,27804,1544,1,2,11,2,0
72244,182,7900,4293,999,3693,19,54,507,4312,9,155,88,170,164,258,1156,1898,4,9368,520,0,2,87,2,0
72245,182,7900,1482,859,1002,125,135,219,1607,16,219,134,251,235,385,1766,3032,9,27804,1544,1,2,87,2,0
72250,184,7983,4293,999,3693,19,54,507,4312,9,155,88,170,164,258,1156,1898,4,9368,520,0,2,17,37,0
72251,184,7983,1482,859,1002,125,135,219,1607,16,219,134,251,235,385,1766,3032,9,27804,1544,1,2,17,37,0
72252,184,7975,4293,999,3693,19,54,507,4312,9,155,88,170,164,258,1156,1898,4,9368,520,0,2,5,5,0
72253,184,7975,1482,859,1002,125,135,219,1607,16,219,134,251,235,385,1766,3032,9,27804,1544,1,2,5,5,0
72272,261,6237,4293,999,3693,19,54,507,4312,9,155,88,170,164,258,1156,1898,4,9368,520,0,2,112,6,0
72273,261,6237,1482,859,1002,125,135,219,1607,16,219,134,251,235,385,1766,3032,9,27804,1544,1,2,112,6,0
72274,184,7975,4293,999,3693,19,54,507,4312,9,155,88,170,164,258,1156,1898,4,9368,520,0,2,94,1,0
72275,184,7975,1482,859,1002,125,135,219,1607,16,219,134,251,235,385,1766,3032,9,27804,1544,1,2,94,1,0
72276,38,2308,334,251,279,10,4,40,344,5,127,74,143,132,217,899,1528,2,4303,239,0,2,5,1,0
72295,216,4974,182,127,129,0,0,53,182,5,39,21,42,44,63,217,343,2,926,51,0,2,17,10,0
72296,216,4974,1165,710,800,67,119,181,1232,18,243,153,282,261,435,2000,3492,10,36473,2026,1,2,17,10,0
72322,183,5415,1660,832,1314,41,38,274,1701,20,312,209,395,332,604,2671,5058,12,64042,3557,1,2,28,22,0
72323,183,5415,1057,646,719,113,100,145,1170,18,215,134,248,233,382,1740,3004,10,31186,1732,1,2,28,22,0
72327,238,5076,2,2,2,0,0,0,2,0,0,0,0,0,0,0,0,0,0,0,0,2,33,17,0
72341,238,5076,99,48,90,1,3,5,100,0,0,0,0,0,0,0,0,0,0,0,0,2,33,17,0
72342,238,5076,8,5,5,2,0,1,10,0,0,0,0,0,0,0,0,0,0,0,0,2,33,17,0
72343,238,5076,1217,716,841,84,126,174,1301,14,185,118,215,199,333,1446,2542,8,20687,1149,0,2,33,17,0
72344,238,5076,160,89,115,0,13,31,160,7,15,11,17,22,28,78,124,3,495,27,0,2,33,17,0
72345,238,5076,10,10,9,9,0,0,19,0,0,0,0,0,0,0,0,0,0,0,0,2,33,17,0
72346,238,5076,173,84,99,8,29,36,181,5,12,7,13,17,20,54,81,2,221,12,0,2,33,17,0
72347,238,5076,3,1,1,3,0,0,6,0,0,0,0,0,0,0,0,0,0,0,0,2,33,17,0
72348,113,2326,463,295,324,28,62,57,491,12,134,82,154,146,236,989,1696,6,11700,650,0,2,30,14,0
72355,73,1701,53,23,39,0,0,13,53,2,8,4,8,10,12,26,39,1,39,2,0,2,35,17,0
72356,73,1701,515,298,307,33,80,99,548,12,63,44,77,75,121,419,753,7,5527,307,0,2,35,17,0
72357,16,491,184,100,137,2,15,30,186,6,38,20,39,44,59,214,322,3,991,55,0,2,10,5,0
72358,16,491,103,65,74,8,5,16,111,7,17,9,17,24,26,89,119,3,417,23,0,2,10,5,0
72359,79,1942,466,257,367,18,25,50,484,7,126,86,171,133,257,898,1813,4,8612,478,0,2,4,2,0
72360,79,1942,507,281,342,29,59,88,536,10,53,29,57,63,86,336,514,5,2764,153,0,2,4,2,0
72366,18,697,184,100,137,2,15,30,186,6,38,20,39,44,59,214,322,3,991,55,0,2,56,2,0
72367,38,2315,334,251,279,10,4,40,344,5,127,74,143,132,217,899,1528,2,4303,239,0,2,2,1,0
72369,87,1935,1043,504,840,53,9,147,1096,9,180,112,198,189,310,1377,2344,4,11604,644,0,2,2,2,0
72370,87,1935,383,288,292,26,6,62,409,11,65,38,67,76,105,429,656,5,3719,206,0,2,2,2,0
72371,16,386,127,75,83,2,11,30,129,4,14,7,14,18,21,61,87,2,175,9,0,2,27,0,0
72372,16,386,652,304,544,16,6,88,668,6,89,51,101,95,152,591,998,3,3399,188,0,2,27,0,0
72373,16,386,2,2,2,0,0,0,2,0,0,0,0,0,0,0,0,0,0,0,0,2,27,0,0
72374,16,386,8,5,5,0,0,3,8,0,0,0,0,0,0,0,0,0,0,0,0,2,27,0,0
72377,16,386,14,8,8,0,0,6,14,0,0,0,0,0,0,0,0,0,0,0,0,2,27,0,0
72378,16,386,6,4,4,0,0,2,6,0,0,0,0,0,0,0,0,0,0,0,0,2,27,0,0
72379,16,386,6,4,4,0,0,2,6,1,2,1,2,3,3,2,4,0,2,0,0,2,27,0,0
72381,16,386,7,5,5,0,0,2,7,0,0,0,0,0,0,0,0,0,0,0,0,2,27,0,0
72383,16,386,10,6,6,0,0,4,10,0,0,0,0,0,0,0,0,0,0,0,0,2,27,0,0
72384,16,386,1,1,1,0,0,0,1,0,0,0,0,0,0,0,0,0,0,0,0,2,27,0,0
72386,16,386,14,10,10,0,0,4,14,1,1,1,1,2,2,0,2,0,1,0,0,2,27,0,0
72387,16,386,46,26,30,3,0,12,49,3,6,3,6,9,9,20,28,1,42,2,0,2,27,0,0
72407,225,5745,722,423,573,19,0,135,741,12,172,101,199,184,300,1320,2257,6,15668,870,0,2,8,9,0
72408,225,5745,1508,847,911,44,250,301,1552,14,148,88,169,162,257,1120,1886,7,15077,837,0,2,8,9,0
72411,116,2131,477,336,357,30,23,73,507,16,194,134,250,210,384,1538,2962,10,30538,1696,0,2,14,1,0
72412,58,1205,207,111,150,11,0,50,218,5,26,19,36,31,55,133,272,3,943,52,0,2,7,0,0
72413,58,1205,410,198,237,31,55,97,441,11,63,38,72,74,110,414,683,6,4293,238,0,2,7,0,0
72414,70,1531,402,202,227,24,74,80,426,12,52,33,61,64,94,339,564,7,3969,220,0,2,2,1,0
72415,122,4968,1450,624,1228,12,26,181,1462,14,306,186,354,320,540,2580,4493,8,36391,2021,1,2,2,1,0
72416,114,2108,477,336,357,30,23,73,507,16,194,134,250,210,384,1538,2962,10,30538,1696,0,2,4,14,0
72417,58,1191,207,111,150,11,0,50,218,5,26,19,36,31,55,133,272,3,943,52,0,2,3,4,0
72418,58,1191,410,198,237,31,55,97,441,11,63,38,72,74,110,414,683,6,4293,238,0,2,3,4,0
72419,70,1535,402,202,227,24,74,80,426,12,52,33,61,64,94,339,564,7,3969,220,0,2,3,2,0
72420,122,4972,1450,624,1228,12,26,181,1462,14,306,186,354,320,540,2580,4493,8,36391,2021,1,2,2,2,0
72421,114,2108,477,336,357,30,23,73,507,16,194,134,250,210,384,1538,2962,10,30538,1696,0,2,4,1,0
72422,58,1191,207,111,150,11,0,50,218,5,26,19,36,31,55,133,272,3,943,52,0,2,6,0,0
72423,58,1191,410,198,237,31,55,97,441,11,63,38,72,74,110,414,683,6,4293,238,0,2,6,0,0
72424,70,1535,402,202,227,24,74,80,426,12,52,33,61,64,94,339,564,7,3969,220,0,2,3,1,0
72425,122,4972,1450,624,1228,12,26,181,1462,14,306,186,354,320,540,2580,4493,8,36391,2021,1,2,2,1,0
72426,1,93,42,7,35,4,0,5,46,1,2,1,2,3,3,2,4,0,2,0,0,2,1,1,0
72427,1,93,11,6,10,0,0,1,11,2,4,2,4,6,6,10,15,1,15,0,0,2,1,1,0
72458,38,2315,334,251,279,10,4,40,344,5,127,74,143,132,217,899,1528,2,4303,239,0,2,6,1,0
72459,57,1488,339,213,244,17,9,65,356,10,42,26,48,52,74,259,421,5,2410,133,0,2,8,2,0
72460,108,4697,1289,550,1043,56,32,155,1345,10,167,93,185,177,278,1266,2075,5,11498,638,0,2,37,0,0
72461,232,5908,722,423,573,19,0,135,741,12,172,101,199,184,300,1320,2257,6,15668,870,0,2,39,4,1
72462,232,5908,1508,847,911,44,250,301,1552,14,148,88,169,162,257,1120,1886,7,15077,837,0,2,39,4,1
72463,59,2994,722,423,573,19,0,135,741,12,172,101,199,184,300,1320,2257,6,15668,870,0,2,46,0,1
72464,107,4615,1289,550,1043,56,32,155,1345,10,167,93,185,177,278,1266,2075,5,11498,638,0,2,3,3,0
72465,146,7058,1392,870,1177,35,17,170,1427,14,494,280,531,508,811,4473,7289,7,54850,3047,2,2,3,2,0
72466,15,696,139,89,101,2,0,35,141,7,54,34,62,61,96,330,569,4,2287,127,0,2,1,1,0
72467,42,2589,1157,318,931,29,22,177,1186,6,104,63,125,110,188,712,1274,3,4596,255,0,2,8,8,0
72468,89,3928,1338,495,1086,10,64,173,1348,11,122,82,157,133,239,883,1686,7,11934,663,0,2,1,1,0
72469,184,7966,4293,999,3693,19,54,507,4312,9,155,88,170,164,258,1156,1898,4,9368,520,0,2,3,3,0
72470,184,7966,1482,859,1002,125,135,219,1607,16,219,134,251,235,385,1766,3032,9,27804,1544,1,2,3,3,0
72471,6,322,180,34,164,0,0,16,180,1,12,6,12,13,18,43,66,0,33,1,0,2,2,2,0
72472,122,4966,1450,624,1228,12,26,181,1462,14,306,186,354,320,540,2580,4493,8,36391,2021,1,2,2,2,0
72473,183,5958,1660,832,1314,41,38,274,1701,20,312,209,395,332,604,2671,5058,12,64042,3557,1,2,3,3,0
72474,49,3773,996,429,845,24,10,117,1020,7,76,50,88,83,138,494,879,4,3565,198,0,2,3,3,0
72475,120,5064,1513,682,1277,25,13,200,1538,11,199,116,219,210,335,1557,2584,6,15641,868,0,2,7,7,0
72476,85,4935,1296,573,1062,40,33,157,1336,8,201,118,231,209,349,1561,2689,4,12365,686,0,2,6,6,0
72477,46,2848,652,304,544,16,6,88,668,6,89,51,101,95,152,591,998,3,3399,188,0,2,2,2,0
72478,81,3714,1455,414,1257,16,76,112,1471,5,41,23,46,46,69,231,381,2,1069,59,0,2,4,4,0
72479,113,5682,1523,757,1297,19,12,193,1542,12,193,117,230,205,347,1508,2664,7,19053,1058,0,2,3,3,0
72480,87,3375,1043,504,840,53,9,147,1096,9,180,112,198,189,310,1377,2344,4,11604,644,0,2,6,6,0
72481,12,463,295,56,236,0,4,54,295,2,9,5,10,11,15,30,51,1,57,3,0,2,1,1,0
72482,79,3068,1178,367,1042,6,15,115,1184,9,94,51,95,103,146,644,976,4,4439,246,0,2,1,1,0
72483,112,6100,1943,715,1694,26,18,214,1969,12,185,120,237,197,357,1436,2721,7,20915,1161,0,2,12,12,0
72484,51,2017,1098,241,925,5,10,155,1103,7,46,25,49,53,74,273,423,3,1580,87,0,2,5,5,0
72485,3,90,35,12,22,4,5,6,39,1,2,1,2,3,3,2,4,0,2,0,0,0,28,0,0
72488,232,5908,722,423,573,19,0,135,741,12,172,101,199,184,300,1320,2257,6,15668,870,0,2,39,4,0
72489,232,5908,1508,847,911,44,250,301,1552,14,148,88,169,162,257,1120,1886,7,15077,837,0,2,39,4,0
72490,108,4688,1289,550,1043,56,32,155,1345,10,167,93,185,177,278,1266,2075,5,11498,638,0,2,3,3,0
72506,59,2994,722,423,573,19,0,135,741,12,172,101,199,184,300,1320,2257,6,15668,870,0,2,46,0,0
72512,87,3404,1043,504,840,53,9,147,1096,9,180,112,198,189,310,1377,2344,4,11604,644,0,2,18,11,0
72515,123,2323,477,336,357,30,23,73,507,16,194,134,250,210,384,1538,2962,10,30538,1696,0,2,31,1,1
72516,124,5157,1450,624,1228,12,26,181,1462,14,306,186,354,320,540,2580,4493,8,36391,2021,1,2,49,0,1
72517,123,2323,477,336,357,30,23,73,507,16,194,134,250,210,384,1538,2962,10,30538,1696,0,2,31,1,0
72518,124,5157,1450,624,1228,12,26,181,1462,14,306,186,354,320,540,2580,4493,8,36391,2021,1,2,49,0,0
72520,87,3386,1043,504,840,53,9,147,1096,9,180,112,198,189,310,1377,2344,4,11604,644,0,2,18,11,0
72523,216,4987,182,127,129,0,0,53,182,5,39,21,42,44,63,217,343,2,926,51,0,2,3,1,0
72524,216,4987,1165,710,800,67,119,181,1232,18,243,153,282,261,435,2000,3492,10,36473,2026,1,2,3,1,0
72525,148,7105,1392,870,1177,35,17,170,1427,14,494,280,531,508,811,4473,7289,7,54850,3047,2,2,13,2,0
72529,124,5153,1450,624,1228,12,26,181,1462,14,306,186,354,320,540,2580,4493,8,36391,2021,1,2,8,11,0
72531,1,95,42,7,35,4,0,5,46,1,2,1,2,3,3,2,4,0,2,0,0,2,1,0,0
72532,1,95,11,6,10,0,0,1,11,2,4,2,4,6,6,10,15,1,15,0,0,2,1,0,0
72533,261,6237,4293,999,3693,19,54,507,4312,9,155,88,170,164,258,1156,1898,4,9368,520,0,2,3,2,0
72534,261,6237,1482,859,1002,125,135,219,1607,16,219,134,251,235,385,1766,3032,9,27804,1544,1,2,3,2,0
72535,185,8002,4293,999,3693,19,54,507,4312,9,155,88,170,164,258,1156,1898,4,9368,520,0,2,18,0,0
72536,185,8002,1482,859,1002,125,135,219,1607,16,219,134,251,235,385,1766,3032,9,27804,1544,1,2,18,0,0
72537,185,8002,4293,999,3693,19,54,507,4312,9,155,88,170,164,258,1156,1898,4,9368,520,0,2,1,1,0
72538,185,8002,1482,859,1002,125,135,219,1607,16,219,134,251,235,385,1766,3032,9,27804,1544,1,2,1,1,0
72539,261,6225,4293,999,3693,19,54,507,4312,9,155,88,170,164,258,1156,1898,4,9368,520,0,2,1,1,0
72540,261,6225,1482,859,1002,125,135,219,1607,16,219,134,251,235,385,1766,3032,9,27804,1544,1,2,1,1,0
72543,261,6225,4293,999,3693,19,54,507,4312,9,155,88,170,164,258,1156,1898,4,9368,520,0,2,3,2,0
72544,261,6225,1482,859,1002,125,135,219,1607,16,219,134,251,235,385,1766,3032,9,27804,1544,1,2,3,2,0
72547,113,5657,1523,757,1297,19,12,193,1542,12,193,117,230,205,347,1508,2664,7,19053,1058,0,2,14,11,0
72550,105,2754,773,422,505,30,103,129,803,14,77,46,83,91,129,535,839,7,6334,351,0,2,1,0,0
72554,238,5076,2,2,2,0,0,0,2,0,0,0,0,0,0,0,0,0,0,0,0,2,2,0,0
72568,238,5076,99,48,90,1,3,5,100,0,0,0,0,0,0,0,0,0,0,0,0,2,2,0,0
72569,238,5076,8,5,5,2,0,1,10,0,0,0,0,0,0,0,0,0,0,0,0,2,2,0,0
72570,238,5076,1217,716,841,84,126,174,1301,14,185,118,215,199,333,1446,2542,8,20687,1149,0,2,2,0,0
72571,238,5076,160,89,115,0,13,31,160,7,15,11,17,22,28,78,124,3,495,27,0,2,2,0,0
72572,238,5076,10,10,9,9,0,0,19,0,0,0,0,0,0,0,0,0,0,0,0,2,2,0,0
72573,238,5076,173,84,99,8,29,36,181,5,12,7,13,17,20,54,81,2,221,12,0,2,2,0,0
72574,238,5076,3,1,1,3,0,0,6,0,0,0,0,0,0,0,0,0,0,0,0,2,2,0,0
72575,261,6225,4293,999,3693,19,54,507,4312,9,155,88,170,164,258,1156,1898,4,9368,520,0,2,6,2,0
72576,261,6225,1482,859,1002,125,135,219,1607,16,219,134,251,235,385,1766,3032,9,27804,1544,1,2,6,2,0
72577,54,640,647,139,84,35,284,233,682,0,0,0,0,0,0,0,0,0,0,0,0,2,2,0,0
72578,142,3472,77,34,69,0,0,8,77,3,24,16,29,27,45,114,213,1,387,21,0,2,2,0,0
72579,142,3472,712,438,573,51,9,84,763,14,102,71,128,116,199,733,1364,8,11988,666,0,2,2,0,0
72611,1,93,42,7,35,4,0,5,46,1,2,1,2,3,3,2,4,0,2,0,0,2,0,1,0
72612,1,93,11,6,10,0,0,1,11,2,4,2,4,6,6,10,15,1,15,0,0,2,0,1,0
72613,185,8008,4293,999,3693,19,54,507,4312,9,155,88,170,164,258,1156,1898,4,9368,520,0,2,2,0,0
72614,185,8008,1482,859,1002,125,135,219,1607,16,219,134,251,235,385,1766,3032,9,27804,1544,1,2,2,0,0
72619,76,3969,1293,570,1093,25,15,163,1318,10,195,123,241,205,364,1516,2795,6,17273,959,0,2,8,0,0
72644,261,6225,4293,999,3693,19,54,507,4312,9,155,88,170,164,258,1156,1898,4,9368,520,0,2,9,4,0
72645,261,6225,1482,859,1002,125,135,219,1607,16,219,134,251,235,385,1766,3032,9,27804,1544,1,2,9,4,0
72650,185,7999,4293,999,3693,19,54,507,4312,9,155,88,170,164,258,1156,1898,4,9368,520,0,2,20,0,0
72651,185,7999,1482,859,1002,125,135,219,1607,16,219,134,251,235,385,1766,3032,9,27804,1544,1,2,20,0,0
72685,282,5905,1943,715,1694,26,18,214,1969,12,185,120,237,197,357,1436,2721,7,20915,1161,0,2,5,1,0
72686,282,5905,1168,838,957,57,25,144,1225,19,348,224,416,367,640,3018,5452,11,61921,3440,1,2,5,1,0
72689,237,5050,2,2,2,0,0,0,2,0,0,0,0,0,0,0,0,0,0,0,0,2,0,5,0
72703,237,5050,99,48,90,1,3,5,100,0,0,0,0,0,0,0,0,0,0,0,0,2,0,5,0
72704,237,5050,8,5,5,2,0,1,10,0,0,0,0,0,0,0,0,0,0,0,0,2,0,5,0
72705,237,5050,1217,716,841,84,126,174,1301,14,185,118,215,199,333,1446,2542,8,20687,1149,0,2,0,5,0
72706,237,5050,160,89,115,0,13,31,160,7,15,11,17,22,28,78,124,3,495,27,0,2,0,5,0
72707,237,5050,10,10,9,9,0,0,19,0,0,0,0,0,0,0,0,0,0,0,0,2,0,5,0
72708,237,5050,173,84,99,8,29,36,181,5,12,7,13,17,20,54,81,2,221,12,0,2,0,5,0
72709,237,5050,3,1,1,3,0,0,6,0,0,0,0,0,0,0,0,0,0,0,0,2,0,5,0
72735,216,4989,182,127,129,0,0,53,182,5,39,21,42,44,63,217,343,2,926,51,0,2,1,1,0
72736,216,4989,1165,710,800,67,119,181,1232,18,243,153,282,261,435,2000,3492,10,36473,2026,1,2,1,1,0
72737,90,2024,996,429,845,24,10,117,1020,7,76,50,88,83,138,494,879,4,3565,198,0,2,6,2,0
72738,90,2024,456,277,329,12,42,72,468,13,85,50,97,98,147,592,972,7,7212,400,0,2,6,2,0
72739,49,3806,996,429,845,24,10,117,1020,7,76,50,88,83,138,494,879,4,3565,198,0,2,6,1,0
72740,51,2040,1098,241,925,5,10,155,1103,7,46,25,49,53,74,273,423,3,1580,87,0,2,19,7,0
72741,87,1918,1043,504,840,53,9,147,1096,9,180,112,198,189,310,1377,2344,4,11604,644,0,2,3,10,0
72742,87,1918,383,288,292,26,6,62,409,11,65,38,67,76,105,429,656,5,3719,206,0,2,3,10,0
72743,88,3446,1043,504,840,53,9,147,1096,9,180,112,198,189,310,1377,2344,4,11604,644,0,2,11,2,0
72746,20,381,294,64,250,0,0,43,294,1,20,10,20,21,30,86,131,0,65,3,0,2,0,5,0
72747,20,381,78,46,62,3,0,14,81,3,8,4,8,11,12,28,41,1,62,3,0,2,0,5,0
72750,239,5074,2,2,2,0,0,0,2,0,0,0,0,0,0,0,0,0,0,0,0,2,5,6,0
72764,239,5074,99,48,90,1,3,5,100,0,0,0,0,0,0,0,0,0,0,0,0,2,5,6,0
72765,239,5074,8,5,5,2,0,1,10,0,0,0,0,0,0,0,0,0,0,0,0,2,5,6,0
72766,239,5074,1217,716,841,84,126,174,1301,14,185,118,215,199,333,1446,2542,8,20687,1149,0,2,5,6,0
72767,239,5074,160,89,115,0,13,31,160,7,15,11,17,22,28,78,124,3,495,27,0,2,5,6,0
72768,239,5074,10,10,9,9,0,0,19,0,0,0,0,0,0,0,0,0,0,0,0,2,5,6,0
72769,239,5074,173,84,99,8,29,36,181,5,12,7,13,17,20,54,81,2,221,12,0,2,5,6,0
72770,239,5074,3,1,1,3,0,0,6,0,0,0,0,0,0,0,0,0,0,0,0,2,5,6,0
72771,111,6057,1457,730,1242,11,6,188,1468,10,292,166,329,302,495,2424,4078,5,22973,1276,1,2,7,2,0
72799,90,2013,996,429,845,24,10,117,1020,7,76,50,88,83,138,494,879,4,3565,198,0,2,1,1,0
72800,90,2013,456,277,329,12,42,72,468,13,85,50,97,98,147,592,972,7,7212,400,0,2,1,1,0
72801,49,3782,996,429,845,24,10,117,1020,7,76,50,88,83,138,494,879,4,3565,198,0,2,1,1,0
72806,23,615,601,196,481,2,23,85,603,8,63,36,72,71,108,400,664,4,3036,168,0,2,1,1,0
72807,23,615,156,79,106,5,16,28,161,5,14,8,15,19,23,64,97,2,261,14,0,2,1,1,0
72808,20,405,294,64,250,0,0,43,294,1,20,10,20,21,30,86,131,0,65,3,0,2,1,2,0
72809,20,405,78,46,62,3,0,14,81,3,8,4,8,11,12,28,41,1,62,3,0,2,1,2,0
72812,124,2350,477,336,357,30,23,73,507,16,194,134,250,210,384,1538,2962,10,30538,1696,0,2,13,4,0
72813,185,6013,1660,832,1314,41,38,274,1701,20,312,209,395,332,604,2671,5058,12,64042,3557,1,2,15,6,0
72818,238,5048,2,2,2,0,0,0,2,0,0,0,0,0,0,0,0,0,0,0,0,2,0,5,0
72832,238,5048,99,48,90,1,3,5,100,0,0,0,0,0,0,0,0,0,0,0,0,2,0,5,0
72833,238,5048,8,5,5,2,0,1,10,0,0,0,0,0,0,0,0,0,0,0,0,2,0,5,0
72834,238,5048,1217,716,841,84,126,174,1301,14,185,118,215,199,333,1446,2542,8,20687,1149,0,2,0,5,0
72835,238,5048,160,89,115,0,13,31,160,7,15,11,17,22,28,78,124,3,495,27,0,2,0,5,0
72836,238,5048,10,10,9,9,0,0,19,0,0,0,0,0,0,0,0,0,0,0,0,2,0,5,0
72837,238,5048,173,84,99,8,29,36,181,5,12,7,13,17,20,54,81,2,221,12,0,2,0,5,0
72838,238,5048,3,1,1,3,0,0,6,0,0,0,0,0,0,0,0,0,0,0,0,2,0,5,0
72841,49,3773,996,429,845,24,10,117,1020,7,76,50,88,83,138,494,879,4,3565,198,0,2,1,1,0
72842,12,572,294,64,250,0,0,43,294,1,20,10,20,21,30,86,131,0,65,3,0,2,25,0,0
72843,304,6701,72,33,56,0,4,12,72,1,1,1,1,2,2,0,2,0,1,0,0,2,10,6,1
72844,304,6701,1454,835,1044,76,110,219,1530,17,275,158,296,292,454,2297,3718,9,34017,1889,1,2,10,6,1
72845,80,3116,1178,367,1042,6,15,115,1184,9,94,51,95,103,146,644,976,4,4439,246,0,2,23,0,1
72846,306,6750,72,33,56,0,4,12,72,1,1,1,1,2,2,0,2,0,1,0,0,2,10,1,0
72847,306,6750,1454,835,1044,76,110,219,1530,17,275,158,296,292,454,2297,3718,9,34017,1889,1,2,10,1,0
72848,306,6763,72,33,56,0,4,12,72,1,1,1,1,2,2,0,2,0,1,0,0,2,9,10,1
72849,306,6763,1454,835,1044,76,110,219,1530,17,275,158,296,292,454,2297,3718,9,34017,1889,1,2,9,10,1
72850,232,5898,722,423,573,19,0,135,741,12,172,101,199,184,300,1320,2257,6,15668,870,0,2,0,2,0
72851,232,5898,1508,847,911,44,250,301,1552,14,148,88,169,162,257,1120,1886,7,15077,837,0,2,0,2,0
72852,161,3433,1513,682,1277,25,13,200,1538,11,199,116,219,210,335,1557,2584,6,15641,868,0,2,0,7,0
72853,161,3433,819,519,539,24,98,155,843,15,96,57,106,111,163,690,1107,8,9171,509,0,2,0,7,0
72854,288,6093,1943,715,1694,26,18,214,1969,12,185,120,237,197,357,1436,2721,7,20915,1161,0,2,60,23,0
72855,288,6093,1168,838,957,57,25,144,1225,19,348,224,416,367,640,3018,5452,11,61921,3440,1,2,60,23,0
72856,76,3969,1293,570,1093,25,15,163,1318,10,195,123,241,205,364,1516,2795,6,17273,959,0,2,5,5,0
72857,112,6632,1943,715,1694,26,18,214,1969,12,185,120,237,197,357,1436,2721,7,20915,1161,0,2,106,25,0
72887,161,3434,1513,682,1277,25,13,200,1538,11,199,116,219,210,335,1557,2584,6,15641,868,0,2,3,1,0
72888,161,3434,819,519,539,24,98,155,843,15,96,57,106,111,163,690,1107,8,9171,509,0,2,3,1,0
72889,3,96,35,12,22,4,5,6,39,1,2,1,2,3,3,2,4,0,2,0,0,2,1,0,0
72930,216,4989,182,127,129,0,0,53,182,5,39,21,42,44,63,217,343,2,926,51,0,2,25,14,0
72931,216,4989,1165,710,800,67,119,181,1232,18,243,153,282,261,435,2000,3492,10,36473,2026,1,2,25,14,0
72957,183,5415,1660,832,1314,41,38,274,1701,20,312,209,395,332,604,2671,5058,12,64042,3557,1,2,57,44,0
72958,183,5415,1057,646,719,113,100,145,1170,18,215,134,248,233,382,1740,3004,10,31186,1732,1,2,57,44,0
72959,123,2323,477,336,357,30,23,73,507,16,194,134,250,210,384,1538,2962,10,30538,1696,0,2,47,11,0
72960,90,2013,996,429,845,24,10,117,1020,7,76,50,88,83,138,494,879,4,3565,198,0,2,3,3,0
72961,90,2013,456,277,329,12,42,72,468,13,85,50,97,98,147,592,972,7,7212,400,0,2,3,3,0
72964,58,1191,207,111,150,11,0,50,218,5,26,19,36,31,55,133,272,3,943,52,0,2,43,19,0
72965,58,1191,410,198,237,31,55,97,441,11,63,38,72,74,110,414,683,6,4293,238,0,2,43,19,0
72968,238,5048,2,2,2,0,0,0,2,0,0,0,0,0,0,0,0,0,0,0,0,2,54,37,0
72982,238,5048,99,48,90,1,3,5,100,0,0,0,0,0,0,0,0,0,0,0,0,2,54,37,0
72983,238,5048,8,5,5,2,0,1,10,0,0,0,0,0,0,0,0,0,0,0,0,2,54,37,0
72984,238,5048,1217,716,841,84,126,174,1301,14,185,118,215,199,333,1446,2542,8,20687,1149,0,2,54,37,0
72985,238,5048,160,89,115,0,13,31,160,7,15,11,17,22,28,78,124,3,495,27,0,2,54,37,0
72986,238,5048,10,10,9,9,0,0,19,0,0,0,0,0,0,0,0,0,0,0,0,2,54,37,0
72987,238,5048,173,84,99,8,29,36,181,5,12,7,13,17,20,54,81,2,221,12,0,2,54,37,0
72988,238,5048,3,1,1,3,0,0,6,0,0,0,0,0,0,0,0,0,0,0,0,2,54,37,0
72989,113,2326,463,295,324,28,62,57,491,12,134,82,154,146,236,989,1696,6,11700,650,0,2,31,15,0
72990,37,813,167,116,138,4,5,22,171,8,48,30,56,56,86,292,499,4,2330,129,0,2,16,2,0
72993,261,6225,4293,999,3693,19,54,507,4312,9,155,88,170,164,258,1156,1898,4,9368,520,0,2,134,14,0
72994,261,6225,1482,859,1002,125,135,219,1607,16,219,134,251,235,385,1766,3032,9,27804,1544,1,2,134,14,0
73001,142,3472,77,34,69,0,0,8,77,3,24,16,29,27,45,114,213,1,387,21,0,2,9,1,0
73002,142,3472,712,438,573,51,9,84,763,14,102,71,128,116,199,733,1364,8,11988,666,0,2,9,1,0
73004,70,1535,402,202,227,24,74,80,426,12,52,33,61,64,94,339,564,7,3969,220,0,2,17,16,0
73005,73,1701,53,23,39,0,0,13,53,2,8,4,8,10,12,26,39,1,39,2,0,2,41,22,0
73006,73,1701,515,298,307,33,80,99,548,12,63,44,77,75,121,419,753,7,5527,307,0,2,41,22,0
73007,12,572,205,80,86,16,53,53,221,7,18,10,19,25,29,94,134,3,497,27,0,2,20,10,0
73010,64,1354,91,45,69,0,3,18,91,3,9,6,10,12,16,33,57,1,95,5,0,2,52,20,0
73011,64,1354,367,234,237,17,34,68,384,16,55,34,61,71,95,381,584,8,5183,287,0,2,52,20,0
73012,232,5908,722,423,573,19,0,135,741,12,172,101,199,184,300,1320,2257,6,15668,870,0,2,63,21,0
73013,232,5908,1508,847,911,44,250,301,1552,14,148,88,169,162,257,1120,1886,7,15077,837,0,2,63,21,0
73014,303,6685,72,33,56,0,4,12,72,1,1,1,1,2,2,0,2,0,1,0,0,2,14,19,0
73015,303,6685,1454,835,1044,76,110,219,1530,17,275,158,296,292,454,2297,3718,9,34017,1889,1,2,14,19,0
73016,79,1961,757,253,292,73,244,162,830,13,61,38,67,74,105,409,651,7,4654,258,0,2,8,7,0
73019,79,1942,466,257,367,18,25,50,484,7,126,86,171,133,257,898,1813,4,8612,478,0,2,146,90,0
73020,79,1942,507,281,342,29,59,88,536,10,53,29,57,63,86,336,514,5,2764,153,0,2,146,90,0
73021,87,1918,1043,504,840,53,9,147,1096,9,180,112,198,189,310,1377,2344,4,11604,644,0,2,25,26,0
73022,87,1918,383,288,292,26,6,62,409,11,65,38,67,76,105,429,656,5,3719,206,0,2,25,26,0
73027,282,5905,1943,715,1694,26,18,214,1969,12,185,120,237,197,357,1436,2721,7,20915,1161,0,2,17,3,0
73028,282,5905,1168,838,957,57,25,144,1225,19,348,224,416,367,640,3018,5452,11,61921,3440,1,2,17,3,0
73031,108,4688,1289,550,1043,56,32,155,1345,10,167,93,185,177,278,1266,2075,5,11498,638,0,2,77,6,0
73033,148,7105,1392,870,1177,35,17,170,1427,14,494,280,531,508,811,4473,7289,7,54850,3047,2,2,181,200,0
73034,16,386,127,75,83,2,11,30,129,4,14,7,14,18,21,61,87,2,175,9,0,2,60,0,0
73035,16,386,652,304,544,16,6,88,668,6,89,51,101,95,152,591,998,3,3399,188,0,2,60,0,0
73036,16,386,2,2,2,0,0,0,2,0,0,0,0,0,0,0,0,0,0,0,0,2,60,0,0
73037,16,386,8,5,5,0,0,3,8,0,0,0,0,0,0,0,0,0,0,0,0,2,60,0,0
73040,16,386,14,8,8,0,0,6,14,0,0,0,0,0,0,0,0,0,0,0,0,2,60,0,0
73041,16,386,6,4,4,0,0,2,6,0,0,0,0,0,0,0,0,0,0,0,0,2,60,0,0
73042,16,386,6,4,4,0,0,2,6,1,2,1,2,3,3,2,4,0,2,0,0,2,60,0,0
73044,16,386,7,5,5,0,0,2,7,0,0,0,0,0,0,0,0,0,0,0,0,2,60,0,0
73046,16,386,10,6,6,0,0,4,10,0,0,0,0,0,0,0,0,0,0,0,0,2,60,0,0
73047,16,386,1,1,1,0,0,0,1,0,0,0,0,0,0,0,0,0,0,0,0,2,60,0,0
73049,16,386,14,10,10,0,0,4,14,1,1,1,1,2,2,0,2,0,1,0,0,2,60,0,0
73050,16,386,46,26,30,3,0,12,49,3,6,3,6,9,9,20,28,1,42,2,0,2,60,0,0
73053,42,2589,1157,318,931,29,22,177,1186,6,104,63,125,110,188,712,1274,3,4596,255,0,2,9,9,0
73054,89,3928,1338,495,1086,10,64,173,1348,11,122,82,157,133,239,883,1686,7,11934,663,0,2,1,47,0
73055,185,7999,4293,999,3693,19,54,507,4312,9,155,88,170,164,258,1156,1898,4,9368,520,0,2,253,15,0
73056,185,7999,1482,859,1002,125,135,219,1607,16,219,134,251,235,385,1766,3032,9,27804,1544,1,2,253,15,0
73061,124,5153,1450,624,1228,12,26,181,1462,14,306,186,354,320,540,2580,4493,8,36391,2021,1,2,88,19,0
73062,183,5958,1660,832,1314,41,38,274,1701,20,312,209,395,332,604,2671,5058,12,64042,3557,1,2,55,3,0
73063,49,3773,996,429,845,24,10,117,1020,7,76,50,88,83,138,494,879,4,3565,198,0,2,4,4,0
73065,85,4935,1296,573,1062,40,33,157,1336,8,201,118,231,209,349,1561,2689,4,12365,686,0,2,18,6,0
73067,111,6057,1457,730,1242,11,6,188,1468,10,292,166,329,302,495,2424,4078,5,22973,1276,1,2,29,3,0
73068,46,2848,652,304,544,16,6,88,668,6,89,51,101,95,152,591,998,3,3399,188,0,2,32,4,0
73070,113,5657,1523,757,1297,19,12,193,1542,12,193,117,230,205,347,1508,2664,7,19053,1058,0,2,228,127,0
73075,18,697,184,100,137,2,15,30,186,6,38,20,39,44,59,214,322,3,991,55,0,2,69,2,0
73076,77,4048,1293,570,1093,25,15,163,1318,10,195,123,241,205,364,1516,2795,6,17273,959,0,2,9,1,0
73077,59,2994,722,423,573,19,0,135,741,12,172,101,199,184,300,1320,2257,6,15668,870,0,2,48,2,0
73079,88,3446,1043,504,840,53,9,147,1096,9,180,112,198,189,310,1377,2344,4,11604,644,0,2,51,19,0
73081,12,572,294,64,250,0,0,43,294,1,20,10,20,21,30,86,131,0,65,3,0,3,29,4,0
73082,1,43,110,30,77,3,13,16,113,4,21,15,30,25,45,100,208,2,597,33,0,3,3,3,0
73083,79,3068,1178,367,1042,6,15,115,1184,9,94,51,95,103,146,644,976,4,4439,246,0,2,3,2,0
73085,112,6100,1943,715,1694,26,18,214,1969,12,185,120,237,197,357,1436,2721,7,20915,1161,0,2,31,14,0
73087,51,2040,1098,241,925,5,10,155,1103,7,46,25,49,53,74,273,423,3,1580,87,0,2,60,12,0
73094,102,2603,1455,414,1257,16,76,112,1471,5,41,23,46,46,69,231,381,2,1069,59,0,2,4,0,0
73095,102,2603,669,365,481,22,61,110,691,15,103,63,122,118,185,747,1273,8,11311,628,0,2,4,0,0
73096,77,4048,1293,570,1093,25,15,163,1318,10,195,123,241,205,364,1516,2795,6,17273,959,0,2,23,1,0
73097,20,378,294,64,250,0,0,43,294,1,20,10,20,21,30,86,131,0,65,3,0,2,1,2,0
73098,20,378,78,46,62,3,0,14,81,3,8,4,8,11,12,28,41,1,62,3,0,2,1,2,0
73103,103,2613,1455,414,1257,16,76,112,1471,5,41,23,46,46,69,231,381,2,1069,59,0,2,6,0,0
73104,103,2613,669,365,481,22,61,110,691,15,103,63,122,118,185,747,1273,8,11311,628,0,2,6,0,0
73105,106,4670,1289,550,1043,56,32,155,1345,10,167,93,185,177,278,1266,2075,5,11498,638,0,2,15,10,0
73108,77,4048,1293,570,1093,25,15,163,1318,10,195,123,241,205,364,1516,2795,6,17273,959,0,2,5,5,0
73110,77,4048,1293,570,1093,25,15,163,1318,10,195,123,241,205,364,1516,2795,6,17273,959,0,2,1,1,0
73114,239,5069,2,2,2,0,0,0,2,0,0,0,0,0,0,0,0,0,0,0,0,2,10,3,0
73128,239,5069,99,48,90,1,3,5,100,0,0,0,0,0,0,0,0,0,0,0,0,2,10,3,0
73129,239,5069,8,5,5,2,0,1,10,0,0,0,0,0,0,0,0,0,0,0,0,2,10,3,0
73130,239,5069,1217,716,841,84,126,174,1301,14,185,118,215,199,333,1446,2542,8,20687,1149,0,2,10,3,0
73131,239,5069,160,89,115,0,13,31,160,7,15,11,17,22,28,78,124,3,495,27,0,2,10,3,0
73132,239,5069,10,10,9,9,0,0,19,0,0,0,0,0,0,0,0,0,0,0,0,2,10,3,0
73133,239,5069,173,84,99,8,29,36,181,5,12,7,13,17,20,54,81,2,221,12,0,2,10,3,0
73134,239,5069,3,1,1,3,0,0,6,0,0,0,0,0,0,0,0,0,0,0,0,2,10,3,0
73135,232,5896,722,423,573,19,0,135,741,12,172,101,199,184,300,1320,2257,6,15668,870,0,2,3,1,0
73136,232,5896,1508,847,911,44,250,301,1552,14,148,88,169,162,257,1120,1886,7,15077,837,0,2,3,1,0
73137,111,6056,1457,730,1242,11,6,188,1468,10,292,166,329,302,495,2424,4078,5,22973,1276,1,2,1,1,0
73138,88,3442,1043,504,840,53,9,147,1096,9,180,112,198,189,310,1377,2344,4,11604,644,0,2,2,3,0
73162,20,983,386,256,301,16,9,68,402,4,59,35,69,63,104,355,621,2,1453,80,0,2,2,5,0
73163,20,983,264,131,164,11,41,46,275,6,38,22,40,44,62,214,338,3,1068,59,0,2,2,5,0
73164,102,2626,1455,414,1257,16,76,112,1471,5,41,23,46,46,69,231,381,2,1069,59,0,2,6,3,0
73165,102,2626,669,365,481,22,61,110,691,15,103,63,122,118,185,747,1273,8,11311,628,0,2,6,3,0
73169,103,2636,1455,414,1257,16,76,112,1471,5,41,23,46,46,69,231,381,2,1069,59,0,2,6,3,0
73170,103,2636,669,365,481,22,61,110,691,15,103,63,122,118,185,747,1273,8,11311,628,0,2,6,3,0
73173,103,2720,1455,414,1257,16,76,112,1471,5,41,23,46,46,69,231,381,2,1069,59,0,2,61,34,1
73174,103,2720,669,365,481,22,61,110,691,15,103,63,122,118,185,747,1273,8,11311,628,0,2,61,34,1
73175,81,3715,1455,414,1257,16,76,112,1471,5,41,23,46,46,69,231,381,2,1069,59,0,2,4,3,1
73176,105,2793,773,422,505,30,103,129,803,14,77,46,83,91,129,535,839,7,6334,351,0,2,16,11,0
73177,23,625,601,196,481,2,23,85,603,8,63,36,72,71,108,400,664,4,3036,168,0,2,4,0,0
73178,23,625,156,79,106,5,16,28,161,5,14,8,15,19,23,64,97,2,261,14,0,2,4,0,0
73179,85,2046,996,429,845,24,10,117,1020,7,76,50,88,83,138,494,879,4,3565,198,0,2,9,3,0
73180,85,2046,456,277,329,12,42,72,468,13,85,50,97,98,147,592,972,7,7212,400,0,2,9,3,0
73181,288,6168,1943,715,1694,26,18,214,1969,12,185,120,237,197,357,1436,2721,7,20915,1161,0,2,26,16,0
73182,288,6168,1168,838,957,57,25,144,1225,19,348,224,416,367,640,3018,5452,11,61921,3440,1,2,26,16,0
73183,161,3438,1513,682,1277,25,13,200,1538,11,199,116,219,210,335,1557,2584,6,15641,868,0,2,5,5,0
73184,161,3438,819,519,539,24,98,155,843,15,96,57,106,111,163,690,1107,8,9171,509,0,2,5,5,0
73185,120,5074,1513,682,1277,25,13,200,1538,11,199,116,219,210,335,1557,2584,6,15641,868,0,2,4,2,0
73186,65,1379,91,45,69,0,3,18,91,3,9,6,10,12,16,33,57,1,95,5,0,2,22,7,0
73187,65,1379,367,234,237,17,34,68,384,16,55,34,61,71,95,381,584,8,5183,287,0,2,22,7,0
73188,39,1798,442,244,305,14,16,103,456,11,68,45,75,79,120,452,756,6,4588,254,0,2,4,0,0
73189,184,5417,1660,832,1314,41,38,274,1701,20,312,209,395,332,604,2671,5058,12,64042,3557,1,2,3,3,0
73190,184,5417,1057,646,719,113,100,145,1170,18,215,134,248,233,382,1740,3004,10,31186,1732,1,2,3,3,0
73191,103,2720,1455,414,1257,16,76,112,1471,5,41,23,46,46,69,231,381,2,1069,59,0,2,1,3,0
73192,103,2720,669,365,481,22,61,110,691,15,103,63,122,118,185,747,1273,8,11311,628,0,2,1,3,0
73193,73,1701,53,23,39,0,0,13,53,2,8,4,8,10,12,26,39,1,39,2,0,2,1,2,0
73194,73,1701,515,298,307,33,80,99,548,12,63,44,77,75,121,419,753,7,5527,307,0,2,1,2,0
73195,233,5923,722,423,573,19,0,135,741,12,172,101,199,184,300,1320,2257,6,15668,870,0,2,5,2,1
73196,233,5923,1508,847,911,44,250,301,1552,14,148,88,169,162,257,1120,1886,7,15077,837,0,2,5,2,1
73197,59,3032,722,423,573,19,0,135,741,12,172,101,199,184,300,1320,2257,6,15668,870,0,2,19,11,1
73198,233,5913,722,423,573,19,0,135,741,12,172,101,199,184,300,1320,2257,6,15668,870,0,2,5,2,0
73199,233,5913,1508,847,911,44,250,301,1552,14,148,88,169,162,257,1120,1886,7,15077,837,0,2,5,2,0
73200,59,3032,722,423,573,19,0,135,741,12,172,101,199,184,300,1320,2257,6,15668,870,0,2,19,11,0
73201,233,5911,722,423,573,19,0,135,741,12,172,101,199,184,300,1320,2257,6,15668,870,0,2,3,1,0
73202,233,5911,1508,847,911,44,250,301,1552,14,148,88,169,162,257,1120,1886,7,15077,837,0,2,3,1,0
73211,103,2720,1455,414,1257,16,76,112,1471,5,41,23,46,46,69,231,381,2,1069,59,0,2,58,33,0
73212,103,2720,669,365,481,22,61,110,691,15,103,63,122,118,185,747,1273,8,11311,628,0,2,58,33,0
73221,81,3715,1455,414,1257,16,76,112,1471,5,41,23,46,46,69,231,381,2,1069,59,0,2,4,3,0
73222,161,3438,1513,682,1277,25,13,200,1538,11,199,116,219,210,335,1557,2584,6,15641,868,0,2,3,1,0
73223,161,3438,819,519,539,24,98,155,843,15,96,57,106,111,163,690,1107,8,9171,509,0,2,3,1,0
73230,232,5986,722,423,573,19,0,135,741,12,172,101,199,184,300,1320,2257,6,15668,870,0,2,16,9,1
73231,232,5986,1508,847,911,44,250,301,1552,14,148,88,169,162,257,1120,1886,7,15077,837,0,2,16,9,1
73232,60,3137,722,423,573,19,0,135,741,12,172,101,199,184,300,1320,2257,6,15668,870,0,2,44,15,1
73233,233,5989,722,423,573,19,0,135,741,12,172,101,199,184,300,1320,2257,6,15668,870,0,2,16,9,0
73234,233,5989,1508,847,911,44,250,301,1552,14,148,88,169,162,257,1120,1886,7,15077,837,0,2,16,9,0
73235,60,3175,722,423,573,19,0,135,741,12,172,101,199,184,300,1320,2257,6,15668,870,0,2,44,15,0
73236,85,2057,996,429,845,24,10,117,1020,7,76,50,88,83,138,494,879,4,3565,198,0,2,6,2,0
73237,85,2057,456,277,329,12,42,72,468,13,85,50,97,98,147,592,972,7,7212,400,0,2,6,2,0
73240,49,3797,996,429,845,24,10,117,1020,7,76,50,88,83,138,494,879,4,3565,198,0,2,6,1,0
73242,80,1970,757,253,292,73,244,162,830,13,61,38,67,74,105,409,651,7,4654,258,0,2,5,7,0
73243,66,4451,520,294,400,33,13,81,553,10,261,204,367,271,571,2128,4614,7,32445,1802,1,2,15,1,0
73244,65,4328,520,294,400,33,13,81,553,10,261,204,367,271,571,2128,4614,7,32445,1802,1,2,16,35,0
73245,290,6183,1943,715,1694,26,18,214,1969,12,185,120,237,197,357,1436,2721,7,20915,1161,0,2,7,1,0
73246,290,6183,1168,838,957,57,25,144,1225,19,348,224,416,367,640,3018,5452,11,61921,3440,1,2,7,1,0
73247,113,6684,1943,715,1694,26,18,214,1969,12,185,120,237,197,357,1436,2721,7,20915,1161,0,2,17,0,0
73248,117,2936,773,422,505,30,103,129,803,14,77,46,83,91,129,535,839,7,6334,351,0,2,87,12,0
73249,3,501,149,67,118,4,0,27,153,1,17,14,28,18,42,69,175,0,144,8,0,2,66,2,0
73250,80,1970,757,253,292,73,244,162,830,13,61,38,67,74,105,409,651,7,4654,258,0,2,1,1,0
73257,80,1970,757,253,292,73,244,162,830,13,61,38,67,74,105,409,651,7,4654,258,0,2,6,8,0
73258,65,4328,520,294,400,33,13,81,553,10,261,204,367,271,571,2128,4614,7,32445,1802,1,2,31,36,0
73259,187,5471,1660,832,1314,41,38,274,1701,20,312,209,395,332,604,2671,5058,12,64042,3557,1,2,31,15,1
73260,187,5471,1057,646,719,113,100,145,1170,18,215,134,248,233,382,1740,3004,10,31186,1732,1,2,31,15,1
73261,189,6306,1660,832,1314,41,38,274,1701,20,312,209,395,332,604,2671,5058,12,64042,3557,1,2,60,1,1
73263,89,3931,1338,495,1086,10,64,173,1348,11,122,82,157,133,239,883,1686,7,11934,663,0,2,1,1,0
73264,31,1843,466,257,367,18,25,50,484,7,126,86,171,133,257,898,1813,4,8612,478,0,2,5,5,0
73265,216,4974,182,127,129,0,0,53,182,5,39,21,42,44,63,217,343,2,926,51,0,2,2,1,0
73266,216,4974,1165,710,800,67,119,181,1232,18,243,153,282,261,435,2000,3492,10,36473,2026,1,2,2,1,0
73267,105,2748,773,422,505,30,103,129,803,14,77,46,83,91,129,535,839,7,6334,351,0,2,3,4,0
73268,225,5745,722,423,573,19,0,135,741,12,172,101,199,184,300,1320,2257,6,15668,870,0,2,2,1,0
73269,225,5745,1508,847,911,44,250,301,1552,14,148,88,169,162,257,1120,1886,7,15077,837,0,2,2,1,0
73270,79,1942,466,257,367,18,25,50,484,7,126,86,171,133,257,898,1813,4,8612,478,0,2,2,1,0
73271,79,1942,507,281,342,29,59,88,536,10,53,29,57,63,86,336,514,5,2764,153,0,2,2,1,0
73272,120,5083,1513,682,1277,25,13,200,1538,11,199,116,219,210,335,1557,2584,6,15641,868,0,2,4,5,0
73273,15,1033,215,129,180,6,0,29,221,8,65,43,72,73,115,415,711,4,3153,175,0,2,6,7,0
73274,112,6136,1943,715,1694,26,18,214,1969,12,185,120,237,197,357,1436,2721,7,20915,1161,0,2,2,1,0
73275,186,5480,1660,832,1314,41,38,274,1701,20,312,209,395,332,604,2671,5058,12,64042,3557,1,2,16,18,0
73276,186,5480,1057,646,719,113,100,145,1170,18,215,134,248,233,382,1740,3004,10,31186,1732,1,2,16,18,0
73277,59,1223,207,111,150,11,0,50,218,5,26,19,36,31,55,133,272,3,943,52,0,2,14,0,0
73278,59,1223,410,198,237,31,55,97,441,11,63,38,72,74,110,414,683,6,4293,238,0,2,14,0,0
73279,189,6308,1660,832,1314,41,38,274,1701,20,312,209,395,332,604,2671,5058,12,64042,3557,1,2,15,15,0
73280,186,5480,1660,832,1314,41,38,274,1701,20,312,209,395,332,604,2671,5058,12,64042,3557,1,2,39,25,0
73281,186,5480,1057,646,719,113,100,145,1170,18,215,134,248,233,382,1740,3004,10,31186,1732,1,2,39,25,0
73284,189,6308,1660,832,1314,41,38,274,1701,20,312,209,395,332,604,2671,5058,12,64042,3557,1,2,74,15,0
73298,60,1550,91,45,69,0,3,18,91,3,9,6,10,12,16,33,57,1,95,5,0,2,38,23,0
73299,60,1550,367,234,237,17,34,68,384,16,55,34,61,71,95,381,584,8,5183,287,0,2,38,23,0
73300,18,704,442,244,305,14,16,103,456,11,68,45,75,79,120,452,756,6,4588,254,0,2,20,15,0
73301,18,704,182,102,99,11,40,35,193,3,11,6,11,14,17,42,64,1,97,5,0,2,20,15,0
73302,232,5973,722,423,573,19,0,135,741,12,172,101,199,184,300,1320,2257,6,15668,870,0,2,0,2,0
73303,232,5973,1508,847,911,44,250,301,1552,14,148,88,169,162,257,1120,1886,7,15077,837,0,2,0,2,0
73304,216,4989,182,127,129,0,0,53,182,5,39,21,42,44,63,217,343,2,926,51,0,2,2,1,0
73305,216,4989,1165,710,800,67,119,181,1232,18,243,153,282,261,435,2000,3492,10,36473,2026,1,2,2,1,0
73306,105,2787,773,422,505,30,103,129,803,14,77,46,83,91,129,535,839,7,6334,351,0,2,3,4,0
73307,233,5989,722,423,573,19,0,135,741,12,172,101,199,184,300,1320,2257,6,15668,870,0,2,2,1,0
73308,233,5989,1508,847,911,44,250,301,1552,14,148,88,169,162,257,1120,1886,7,15077,837,0,2,2,1,0
73313,120,5072,1513,682,1277,25,13,200,1538,11,199,116,219,210,335,1557,2584,6,15641,868,0,2,4,5,0
73316,112,6632,1943,715,1694,26,18,214,1969,12,185,120,237,197,357,1436,2721,7,20915,1161,0,2,2,1,0
73330,120,5076,1513,682,1277,25,13,200,1538,11,199,116,219,210,335,1557,2584,6,15641,868,0,2,1,5,0
73333,24,608,2,2,2,0,0,0,2,0,0,0,0,0,0,0,0,0,0,0,0,2,2,4,0
73347,24,608,99,48,90,1,3,5,100,0,0,0,0,0,0,0,0,0,0,0,0,2,2,4,0
73348,24,608,8,5,5,2,0,1,10,0,0,0,0,0,0,0,0,0,0,0,0,2,2,4,0
73349,24,608,1217,716,841,84,126,174,1301,14,185,118,215,199,333,1446,2542,8,20687,1149,0,2,2,4,0
73350,24,608,160,89,115,0,13,31,160,7,15,11,17,22,28,78,124,3,495,27,0,2,2,4,0
73351,24,608,10,10,9,9,0,0,19,0,0,0,0,0,0,0,0,0,0,0,0,2,2,4,0
73352,24,608,173,84,99,8,29,36,181,5,12,7,13,17,20,54,81,2,221,12,0,2,2,4,0
73353,24,608,3,1,1,3,0,0,6,0,0,0,0,0,0,0,0,0,0,0,0,2,2,4,0
73377,235,6063,722,423,573,19,0,135,741,12,172,101,199,184,300,1320,2257,6,15668,870,0,2,31,21,0
73378,235,6063,1508,847,911,44,250,301,1552,14,148,88,169,162,257,1120,1886,7,15077,837,0,2,31,21,0
73379,62,3231,722,423,573,19,0,135,741,12,172,101,199,184,300,1320,2257,6,15668,870,0,2,21,0,0
73380,143,3484,77,34,69,0,0,8,77,3,24,16,29,27,45,114,213,1,387,21,0,2,4,1,0
73381,143,3484,712,438,573,51,9,84,763,14,102,71,128,116,199,733,1364,8,11988,666,0,2,4,1,0
73382,292,6223,1943,715,1694,26,18,214,1969,12,185,120,237,197,357,1436,2721,7,20915,1161,0,2,15,2,0
73383,292,6223,1168,838,957,57,25,144,1225,19,348,224,416,367,640,3018,5452,11,61921,3440,1,2,15,2,0
73384,106,4670,1289,550,1043,56,32,155,1345,10,167,93,185,177,278,1266,2075,5,11498,638,0,2,2,2,0
73386,185,7999,4293,999,3693,19,54,507,4312,9,155,88,170,164,258,1156,1898,4,9368,520,0,2,1,1,0
73387,185,7999,1482,859,1002,125,135,219,1607,16,219,134,251,235,385,1766,3032,9,27804,1544,1,2,1,1,0
73388,189,6308,1660,832,1314,41,38,274,1701,20,312,209,395,332,604,2671,5058,12,64042,3557,1,2,1,1,0
73389,120,5072,1513,682,1277,25,13,200,1538,11,199,116,219,210,335,1557,2584,6,15641,868,0,2,1,1,0
73390,85,4935,1296,573,1062,40,33,157,1336,8,201,118,231,209,349,1561,2689,4,12365,686,0,2,3,3,0
73391,81,3715,1455,414,1257,16,76,112,1471,5,41,23,46,46,69,231,381,2,1069,59,0,2,1,1,0
73395,12,645,219,78,157,11,5,46,230,3,24,20,34,27,54,114,256,2,545,30,0,2,1,1,0
73396,112,6661,1943,715,1694,26,18,214,1969,12,185,120,237,197,357,1436,2721,7,20915,1161,0,2,4,7,0
73397,49,1706,601,196,481,2,23,85,603,8,63,36,72,71,108,400,664,4,3036,168,0,2,6,6,0
73398,119,4999,1513,682,1277,25,13,200,1538,11,199,116,219,210,335,1557,2584,6,15641,868,0,2,1,14,0
73401,234,6047,722,423,573,19,0,135,741,12,172,101,199,184,300,1320,2257,6,15668,870,0,2,31,21,0
73402,234,6047,1508,847,911,44,250,301,1552,14,148,88,169,162,257,1120,1886,7,15077,837,0,2,31,21,0
73404,69,4366,520,294,400,33,13,81,553,10,261,204,367,271,571,2128,4614,7,32445,1802,1,2,27,12,0
73405,69,4372,520,294,400,33,13,81,553,10,261,204,367,271,571,2128,4614,7,32445,1802,1,2,5,2,0
73406,17,400,127,75,83,2,11,30,129,4,14,7,14,18,21,61,87,2,175,9,0,2,4,1,0
73407,17,400,652,304,544,16,6,88,668,6,89,51,101,95,152,591,998,3,3399,188,0,2,4,1,0
73408,17,400,2,2,2,0,0,0,2,0,0,0,0,0,0,0,0,0,0,0,0,2,4,1,0
73409,17,400,8,5,5,0,0,3,8,0,0,0,0,0,0,0,0,0,0,0,0,2,4,1,0
73412,17,400,14,8,8,0,0,6,14,0,0,0,0,0,0,0,0,0,0,0,0,2,4,1,0
73413,17,400,6,4,4,0,0,2,6,0,0,0,0,0,0,0,0,0,0,0,0,2,4,1,0
73414,17,400,6,4,4,0,0,2,6,1,2,1,2,3,3,2,4,0,2,0,0,2,4,1,0
73416,17,400,7,5,5,0,0,2,7,0,0,0,0,0,0,0,0,0,0,0,0,2,4,1,0
73418,17,400,10,6,6,0,0,4,10,0,0,0,0,0,0,0,0,0,0,0,0,2,4,1,0
73419,17,400,1,1,1,0,0,0,1,0,0,0,0,0,0,0,0,0,0,0,0,2,4,1,0
73421,17,400,14,10,10,0,0,4,14,1,1,1,1,2,2,0,2,0,1,0,0,2,4,1,0
73422,17,400,46,26,30,3,0,12,49,3,6,3,6,9,9,20,28,1,42,2,0,2,4,1,0
73423,8,310,103,47,73,2,12,15,105,5,16,9,17,21,26,75,114,2,303,16,0,2,2,2,0
73428,120,5072,1513,682,1277,25,13,200,1538,11,199,116,219,210,335,1557,2584,6,15641,868,0,2,1,3,0
73465,40,786,1178,367,1042,6,15,115,1184,9,94,51,95,103,146,644,976,4,4439,246,0,2,2,2,0
73466,40,786,177,108,140,8,0,27,185,6,30,16,32,36,48,162,248,3,794,44,0,2,2,2,0
73467,292,6221,1943,715,1694,26,18,214,1969,12,185,120,237,197,357,1436,2721,7,20915,1161,0,2,1,1,0
73468,292,6221,1168,838,957,57,25,144,1225,19,348,224,416,367,640,3018,5452,11,61921,3440,1,2,1,1,0
73469,79,3071,1178,367,1042,6,15,115,1184,9,94,51,95,103,146,644,976,4,4439,246,0,2,17,3,0
73470,120,5079,1513,682,1277,25,13,200,1538,11,199,116,219,210,335,1557,2584,6,15641,868,0,2,2,2,0
73473,239,5071,2,2,2,0,0,0,2,0,0,0,0,0,0,0,0,0,0,0,0,2,1,0,0
73487,239,5071,99,48,90,1,3,5,100,0,0,0,0,0,0,0,0,0,0,0,0,2,1,0,0
73488,239,5071,8,5,5,2,0,1,10,0,0,0,0,0,0,0,0,0,0,0,0,2,1,0,0
73489,239,5071,1217,716,841,84,126,174,1301,14,185,118,215,199,333,1446,2542,8,20687,1149,0,2,1,0,0
73490,239,5071,160,89,115,0,13,31,160,7,15,11,17,22,28,78,124,3,495,27,0,2,1,0,0
73491,239,5071,10,10,9,9,0,0,19,0,0,0,0,0,0,0,0,0,0,0,0,2,1,0,0
73492,239,5071,173,84,99,8,29,36,181,5,12,7,13,17,20,54,81,2,221,12,0,2,1,0,0
73493,239,5071,3,1,1,3,0,0,6,0,0,0,0,0,0,0,0,0,0,0,0,2,1,0,0
73494,79,1942,466,257,367,18,25,50,484,7,126,86,171,133,257,898,1813,4,8612,478,0,2,5,5,0
73495,79,1942,507,281,342,29,59,88,536,10,53,29,57,63,86,336,514,5,2764,153,0,2,5,5,0
73496,31,1843,466,257,367,18,25,50,484,7,126,86,171,133,257,898,1813,4,8612,478,0,2,3,3,0
73497,54,640,647,139,84,35,284,233,682,0,0,0,0,0,0,0,0,0,0,0,0,2,0,20,0
73527,237,5056,2,2,2,0,0,0,2,0,0,0,0,0,0,0,0,0,0,0,0,2,3,1,0
73541,237,5056,99,48,90,1,3,5,100,0,0,0,0,0,0,0,0,0,0,0,0,2,3,1,0
73542,237,5056,8,5,5,2,0,1,10,0,0,0,0,0,0,0,0,0,0,0,0,2,3,1,0
73543,237,5056,1217,716,841,84,126,174,1301,14,185,118,215,199,333,1446,2542,8,20687,1149,0,2,3,1,0
73544,237,5056,160,89,115,0,13,31,160,7,15,11,17,22,28,78,124,3,495,27,0,2,3,1,0
73545,237,5056,10,10,9,9,0,0,19,0,0,0,0,0,0,0,0,0,0,0,0,2,3,1,0
73546,237,5056,173,84,99,8,29,36,181,5,12,7,13,17,20,54,81,2,221,12,0,2,3,1,0
73547,237,5056,3,1,1,3,0,0,6,0,0,0,0,0,0,0,0,0,0,0,0,2,3,1,0
73548,54,642,647,139,84,35,284,233,682,0,0,0,0,0,0,0,0,0,0,0,0,2,6,1,0
73549,30,1924,384,251,317,7,8,52,391,11,70,44,84,81,128,467,811,6,5355,297,0,2,30,0,0
73550,57,1473,339,213,244,17,9,65,356,10,42,26,48,52,74,259,421,5,2410,133,0,2,11,7,1
73551,78,4151,1293,570,1093,25,15,163,1318,10,195,123,241,205,364,1516,2795,6,17273,959,0,2,45,1,1
73552,57,1473,339,213,244,17,9,65,356,10,42,26,48,52,74,259,421,5,2410,133,0,2,11,7,0
73553,78,4151,1293,570,1093,25,15,163,1318,10,195,123,241,205,364,1516,2795,6,17273,959,0,2,45,1,0
73554,216,4974,182,127,129,0,0,53,182,5,39,21,42,44,63,217,343,2,926,51,0,2,5,5,0
73555,216,4974,1165,710,800,67,119,181,1232,18,243,153,282,261,435,2000,3492,10,36473,2026,1,2,5,5,0
73556,117,3166,1523,757,1297,19,12,193,1542,12,193,117,230,205,347,1508,2664,7,19053,1058,0,2,1,1,0
73557,117,3166,701,378,504,33,58,109,734,13,110,68,126,123,194,794,1346,7,10027,557,0,2,1,1,0
73558,142,3472,77,34,69,0,0,8,77,3,24,16,29,27,45,114,213,1,387,21,0,2,1,1,0
73559,142,3472,712,438,573,51,9,84,763,14,102,71,128,116,199,733,1364,8,11988,666,0,2,1,1,0
73560,30,669,125,97,103,3,0,19,128,9,25,17,27,34,44,144,223,4,1087,60,0,2,1,1,0
73561,22,367,102,57,55,5,16,25,107,5,17,10,18,22,28,81,124,2,330,18,0,2,1,1,0
73562,303,6685,72,33,56,0,4,12,72,1,1,1,1,2,2,0,2,0,1,0,0,2,3,3,0
73563,303,6685,1454,835,1044,76,110,219,1530,17,275,158,296,292,454,2297,3718,9,34017,1889,1,2,3,3,0
73564,40,784,1178,367,1042,6,15,115,1184,9,94,51,95,103,146,644,976,4,4439,246,0,2,2,2,0
73565,40,784,177,108,140,8,0,27,185,6,30,16,32,36,48,162,248,3,794,44,0,2,2,2,0
73566,147,5933,1782,648,1425,9,47,279,1791,8,171,97,189,179,286,1292,2140,4,9462,525,0,2,1,1,0
73569,38,2315,334,251,279,10,4,40,344,5,127,74,143,132,217,899,1528,2,4303,239,0,2,1,1,0
73570,76,3969,1293,570,1093,25,15,163,1318,10,195,123,241,205,364,1516,2795,6,17273,959,0,2,1,1,0
73588,78,4151,1293,570,1093,25,15,163,1318,10,195,123,241,205,364,1516,2795,6,17273,959,0,2,1,1,0
73590,66,1699,53,23,39,0,0,13,53,2,8,4,8,10,12,26,39,1,39,2,0,2,3,2,0
73591,66,1699,515,298,307,33,80,99,548,12,63,44,77,75,121,419,753,7,5527,307,0,2,3,2,0
73593,294,6238,1943,715,1694,26,18,214,1969,12,185,120,237,197,357,1436,2721,7,20915,1161,0,2,7,1,0
73594,294,6238,1168,838,957,57,25,144,1225,19,348,224,416,367,640,3018,5452,11,61921,3440,1,2,7,1,0
73595,113,6713,1943,715,1694,26,18,214,1969,12,185,120,237,197,357,1436,2721,7,20915,1161,0,2,17,0,0
73596,113,6713,1943,715,1694,26,18,214,1969,12,185,120,237,197,357,1436,2721,7,20915,1161,0,2,2,2,0
73597,12,320,149,95,105,2,0,41,151,8,54,28,55,62,83,334,494,4,2013,111,0,2,8,7,0
73598,12,320,82,56,54,0,13,15,82,4,13,8,16,17,24,56,98,2,241,13,0,2,8,7,0
73599,121,2276,477,336,357,30,23,73,507,16,194,134,250,210,384,1538,2962,10,30538,1696,0,2,1,18,0
73600,73,2511,477,336,357,30,23,73,507,16,194,134,250,210,384,1538,2962,10,30538,1696,0,2,42,23,0
73601,49,1715,601,196,481,2,23,85,603,8,63,36,72,71,108,400,664,4,3036,168,0,2,1,0,0
73602,112,6693,1943,715,1694,26,18,214,1969,12,185,120,237,197,357,1436,2721,7,20915,1161,0,2,7,14,0
73605,73,2511,477,336,357,30,23,73,507,16,194,134,250,210,384,1538,2962,10,30538,1696,0,2,43,41,0
73607,296,6307,1943,715,1694,26,18,214,1969,12,185,120,237,197,357,1436,2721,7,20915,1161,0,2,16,5,0
73608,296,6307,1168,838,957,57,25,144,1225,19,348,224,416,367,640,3018,5452,11,61921,3440,1,2,16,5,0
73609,114,6826,1943,715,1694,26,18,214,1969,12,185,120,237,197,357,1436,2721,7,20915,1161,0,2,43,2,0
73610,114,2105,477,336,357,30,23,73,507,16,194,134,250,210,384,1538,2962,10,30538,1696,0,2,0,1,0
73612,217,5035,182,127,129,0,0,53,182,5,39,21,42,44,63,217,343,2,926,51,0,2,20,17,1
73613,217,5035,1165,710,800,67,119,181,1232,18,243,153,282,261,435,2000,3492,10,36473,2026,1,2,20,17,1
73614,103,2729,1455,414,1257,16,76,112,1471,5,41,23,46,46,69,231,381,2,1069,59,0,2,1,1,1
73615,103,2729,669,365,481,22,61,110,691,15,103,63,122,118,185,747,1273,8,11311,628,0,2,1,1,1
73616,261,6241,4293,999,3693,19,54,507,4312,9,155,88,170,164,258,1156,1898,4,9368,520,0,2,10,4,1
73617,261,6241,1482,859,1002,125,135,219,1607,16,219,134,251,235,385,1766,3032,9,27804,1544,1,2,10,4,1
73618,143,3505,77,34,69,0,0,8,77,3,24,16,29,27,45,114,213,1,387,21,0,2,9,4,1
73619,143,3505,712,438,573,51,9,84,763,14,102,71,128,116,199,733,1364,8,11988,666,0,2,9,4,1
73620,63,1828,53,23,39,0,0,13,53,2,8,4,8,10,12,26,39,1,39,2,0,2,39,16,1
73621,63,1828,515,298,307,33,80,99,548,12,63,44,77,75,121,419,753,7,5527,307,0,2,39,16,1
73622,303,6698,72,33,56,0,4,12,72,1,1,1,1,2,2,0,2,0,1,0,0,2,2,1,1
73623,303,6698,1454,835,1044,76,110,219,1530,17,275,158,296,292,454,2297,3718,9,34017,1889,1,2,2,1,1
73624,78,1979,466,257,367,18,25,50,484,7,126,86,171,133,257,898,1813,4,8612,478,0,2,15,5,1
73625,78,1979,507,281,342,29,59,88,536,10,53,29,57,63,86,336,514,5,2764,153,0,2,15,5,1
73626,87,1930,1043,504,840,53,9,147,1096,9,180,112,198,189,310,1377,2344,4,11604,644,0,2,3,3,1
73627,87,1930,383,288,292,26,6,62,409,11,65,38,67,76,105,429,656,5,3719,206,0,2,3,3,1
73628,148,7107,1392,870,1177,35,17,170,1427,14,494,280,531,508,811,4473,7289,7,54850,3047,2,2,1,1,1
73630,217,5035,182,127,129,0,0,53,182,5,39,21,42,44,63,217,343,2,926,51,0,2,20,17,0
73631,217,5035,1165,710,800,67,119,181,1232,18,243,153,282,261,435,2000,3492,10,36473,2026,1,2,20,17,0
73632,103,2729,1455,414,1257,16,76,112,1471,5,41,23,46,46,69,231,381,2,1069,59,0,2,1,1,0
73633,103,2729,669,365,481,22,61,110,691,15,103,63,122,118,185,747,1273,8,11311,628,0,2,1,1,0
73634,261,6241,4293,999,3693,19,54,507,4312,9,155,88,170,164,258,1156,1898,4,9368,520,0,2,10,4,0
73635,261,6241,1482,859,1002,125,135,219,1607,16,219,134,251,235,385,1766,3032,9,27804,1544,1,2,10,4,0
73636,143,3505,77,34,69,0,0,8,77,3,24,16,29,27,45,114,213,1,387,21,0,2,9,4,0
73637,143,3505,712,438,573,51,9,84,763,14,102,71,128,116,199,733,1364,8,11988,666,0,2,9,4,0
73638,63,1828,53,23,39,0,0,13,53,2,8,4,8,10,12,26,39,1,39,2,0,2,39,16,0
73639,63,1828,515,298,307,33,80,99,548,12,63,44,77,75,121,419,753,7,5527,307,0,2,39,16,0
73640,303,6698,72,33,56,0,4,12,72,1,1,1,1,2,2,0,2,0,1,0,0,2,2,1,0
73641,303,6698,1454,835,1044,76,110,219,1530,17,275,158,296,292,454,2297,3718,9,34017,1889,1,2,2,1,0
73642,78,1979,466,257,367,18,25,50,484,7,126,86,171,133,257,898,1813,4,8612,478,0,2,15,5,0
73643,78,1979,507,281,342,29,59,88,536,10,53,29,57,63,86,336,514,5,2764,153,0,2,15,5,0
73644,87,1930,1043,504,840,53,9,147,1096,9,180,112,198,189,310,1377,2344,4,11604,644,0,2,3,3,0
73645,87,1930,383,288,292,26,6,62,409,11,65,38,67,76,105,429,656,5,3719,206,0,2,3,3,0
73646,148,7107,1392,870,1177,35,17,170,1427,14,494,280,531,508,811,4473,7289,7,54850,3047,2,2,1,1,0
73647,49,3865,996,429,845,24,10,117,1020,7,76,50,88,83,138,494,879,4,3565,198,0,2,5,0,0
73648,51,3873,996,429,845,24,10,117,1020,7,76,50,88,83,138,494,879,4,3565,198,0,2,24,16,0
73649,51,3885,996,429,845,24,10,117,1020,7,76,50,88,83,138,494,879,4,3565,198,0,2,4,2,0
73652,113,6806,1943,715,1694,26,18,214,1969,12,185,120,237,197,357,1436,2721,7,20915,1161,0,2,41,0,0
73653,117,2969,773,422,505,30,103,129,803,14,77,46,83,91,129,535,839,7,6334,351,0,2,87,12,0
73655,73,2511,477,336,357,30,23,73,507,16,194,134,250,210,384,1538,2962,10,30538,1696,0,2,5,4,1
73656,125,5319,1450,624,1228,12,26,181,1462,14,306,186,354,320,540,2580,4493,8,36391,2021,1,2,37,0,1
73657,56,1826,53,23,39,0,0,13,53,2,8,4,8,10,12,26,39,1,39,2,0,2,3,2,0
73658,56,1826,515,298,307,33,80,99,548,12,63,44,77,75,121,419,753,7,5527,307,0,2,3,2,0
73659,119,5003,1513,682,1277,25,13,200,1538,11,199,116,219,210,335,1557,2584,6,15641,868,0,2,1,14,0
73660,69,4372,520,294,400,33,13,81,553,10,261,204,367,271,571,2128,4614,7,32445,1802,1,2,30,12,0
73663,296,6305,1943,715,1694,26,18,214,1969,12,185,120,237,197,357,1436,2721,7,20915,1161,0,2,1,1,0
73664,296,6305,1168,838,957,57,25,144,1225,19,348,224,416,367,640,3018,5452,11,61921,3440,1,2,1,1,0
73666,51,3885,996,429,845,24,10,117,1020,7,76,50,88,83,138,494,879,4,3565,198,0,2,29,14,0
73667,217,5035,182,127,129,0,0,53,182,5,39,21,42,44,63,217,343,2,926,51,0,2,5,5,0
73668,217,5035,1165,710,800,67,119,181,1232,18,243,153,282,261,435,2000,3492,10,36473,2026,1,2,5,5,0
73669,73,2508,477,336,357,30,23,73,507,16,194,134,250,210,384,1538,2962,10,30538,1696,0,2,0,1,0
73670,57,1477,339,213,244,17,9,65,356,10,42,26,48,52,74,259,421,5,2410,133,0,2,11,7,0
73673,143,3505,77,34,69,0,0,8,77,3,24,16,29,27,45,114,213,1,387,21,0,2,1,1,0
73674,143,3505,712,438,573,51,9,84,763,14,102,71,128,116,199,733,1364,8,11988,666,0,2,1,1,0
73677,303,6698,72,33,56,0,4,12,72,1,1,1,1,2,2,0,2,0,1,0,0,2,3,3,0
73678,303,6698,1454,835,1044,76,110,219,1530,17,275,158,296,292,454,2297,3718,9,34017,1889,1,2,3,3,0
73685,79,4230,1293,570,1093,25,15,163,1318,10,195,123,241,205,364,1516,2795,6,17273,959,0,2,46,2,0
73687,119,5010,1513,682,1277,25,13,200,1538,11,199,116,219,210,335,1557,2584,6,15641,868,0,2,2,2,0
73690,239,5077,2,2,2,0,0,0,2,0,0,0,0,0,0,0,0,0,0,0,0,2,3,1,0
73704,239,5077,99,48,90,1,3,5,100,0,0,0,0,0,0,0,0,0,0,0,0,2,3,1,0
73705,239,5077,8,5,5,2,0,1,10,0,0,0,0,0,0,0,0,0,0,0,0,2,3,1,0
73706,239,5077,1217,716,841,84,126,174,1301,14,185,118,215,199,333,1446,2542,8,20687,1149,0,2,3,1,0
73707,239,5077,160,89,115,0,13,31,160,7,15,11,17,22,28,78,124,3,495,27,0,2,3,1,0
73708,239,5077,10,10,9,9,0,0,19,0,0,0,0,0,0,0,0,0,0,0,0,2,3,1,0
73709,239,5077,173,84,99,8,29,36,181,5,12,7,13,17,20,54,81,2,221,12,0,2,3,1,0
73710,239,5077,3,1,1,3,0,0,6,0,0,0,0,0,0,0,0,0,0,0,0,2,3,1,0
73713,306,6763,72,33,56,0,4,12,72,1,1,1,1,2,2,0,2,0,1,0,0,2,18,6,0
73714,306,6763,1454,835,1044,76,110,219,1530,17,275,158,296,292,454,2297,3718,9,34017,1889,1,2,18,6,0
73715,80,3116,1178,367,1042,6,15,115,1184,9,94,51,95,103,146,644,976,4,4439,246,0,2,23,0,0
73716,1,319,382,65,130,157,2,92,539,4,10,5,10,14,15,41,57,2,114,6,0,2,13,0,0
73717,13,539,124,78,88,2,3,26,126,4,13,7,13,17,20,56,81,2,163,9,0,2,7,0,0
73718,73,2511,477,336,357,30,23,73,507,16,194,134,250,210,384,1538,2962,10,30538,1696,0,2,5,4,0
73719,125,5319,1450,624,1228,12,26,181,1462,14,306,186,354,320,540,2580,4493,8,36391,2021,1,2,37,0,0
73721,18,382,149,95,105,2,0,41,151,8,54,28,55,62,83,334,494,4,2013,111,0,2,23,9,0
73722,18,382,82,56,54,0,13,15,82,4,13,8,16,17,24,56,98,2,241,13,0,2,23,9,0
73723,148,7107,1392,870,1177,35,17,170,1427,14,494,280,531,508,811,4473,7289,7,54850,3047,2,2,2,2,0
73724,24,691,149,95,105,2,0,41,151,8,54,28,55,62,83,334,494,4,2013,111,0,2,75,3,0
73725,30,1422,373,158,315,8,0,51,381,5,76,44,79,81,123,486,779,2,2026,112,0,2,9,9,0
73726,24,694,149,95,105,2,0,41,151,8,54,28,55,62,83,334,494,4,2013,111,0,2,3,2,0
73727,143,3503,77,34,69,0,0,8,77,3,24,16,29,27,45,114,213,1,387,21,0,2,5,5,0
73728,143,3503,712,438,573,51,9,84,763,14,102,71,128,116,199,733,1364,8,11988,666,0,2,5,5,0
73731,100,2883,773,419,590,28,0,166,801,10,204,113,217,214,330,1598,2554,5,13587,754,0,2,24,19,0
73732,79,4230,1293,570,1093,25,15,163,1318,10,195,123,241,205,364,1516,2795,6,17273,959,0,2,1,1,0
73733,125,5340,1450,624,1228,12,26,181,1462,14,306,186,354,320,540,2580,4493,8,36391,2021,1,2,6,3,0
73734,148,7121,1392,870,1177,35,17,170,1427,14,494,280,531,508,811,4473,7289,7,54850,3047,2,2,4,2,0
73735,143,3505,77,34,69,0,0,8,77,3,24,16,29,27,45,114,213,1,387,21,0,2,0,1,0
73736,143,3505,712,438,573,51,9,84,763,14,102,71,128,116,199,733,1364,8,11988,666,0,2,0,1,0
73737,106,4685,1289,550,1043,56,32,155,1345,10,167,93,185,177,278,1266,2075,5,11498,638,0,2,8,2,0
73744,143,3503,77,34,69,0,0,8,77,3,24,16,29,27,45,114,213,1,387,21,0,2,1,1,0
73745,143,3503,712,438,573,51,9,84,763,14,102,71,128,116,199,733,1364,8,11988,666,0,2,1,1,0
73761,24,694,149,95,105,2,0,41,151,8,54,28,55,62,83,334,494,4,2013,111,0,2,76,3,0
73763,61,1561,91,45,69,0,3,18,91,3,9,6,10,12,16,33,57,1,95,5,0,2,6,5,0
73764,61,1561,367,234,237,17,34,68,384,16,55,34,61,71,95,381,584,8,5183,287,0,2,6,5,0
73765,40,1853,442,244,305,14,16,103,456,11,68,45,75,79,120,452,756,6,4588,254,0,2,7,0,0
73766,61,1561,91,45,69,0,3,18,91,3,9,6,10,12,16,33,57,1,95,5,0,2,1,1,0
73767,61,1561,367,234,237,17,34,68,384,16,55,34,61,71,95,381,584,8,5183,287,0,2,1,1,0
73768,40,1859,442,244,305,14,16,103,456,11,68,45,75,79,120,452,756,6,4588,254,0,2,4,1,0
73769,2,222,37,13,25,0,6,6,37,1,2,1,2,3,3,2,4,0,2,0,0,2,16,5,0
73770,2,222,133,47,40,1,43,49,134,0,0,0,0,0,0,0,0,0,0,0,0,2,16,5,0
73771,58,1732,773,419,590,28,0,166,801,10,204,113,217,214,330,1598,2554,5,13587,754,0,2,50,23,1
73772,58,1732,421,273,302,44,34,57,465,17,81,59,107,98,166,583,1098,11,12329,684,0,2,50,23,1
73773,227,6311,722,423,573,19,0,135,741,12,172,101,199,184,300,1320,2257,6,15668,870,0,2,81,37,0
73774,227,6311,1508,847,911,44,250,301,1552,14,148,88,169,162,257,1120,1886,7,15077,837,0,2,81,37,0
73776,143,3503,77,34,69,0,0,8,77,3,24,16,29,27,45,114,213,1,387,21,0,2,0,1,0
73777,143,3503,712,438,573,51,9,84,763,14,102,71,128,116,199,733,1364,8,11988,666,0,2,0,1,0
73781,58,1732,773,419,590,28,0,166,801,10,204,113,217,214,330,1598,2554,5,13587,754,0,2,50,23,0
73782,58,1732,421,273,302,44,34,57,465,17,81,59,107,98,166,583,1098,11,12329,684,0,2,50,23,0
73789,191,5617,1660,832,1314,41,38,274,1701,20,312,209,395,332,604,2671,5058,12,64042,3557,1,2,50,19,0
73790,191,5617,1057,646,719,113,100,145,1170,18,215,134,248,233,382,1740,3004,10,31186,1732,1,2,50,19,0
73791,191,6340,1660,832,1314,41,38,274,1701,20,312,209,395,332,604,2671,5058,12,64042,3557,1,2,22,12,0
73792,143,3505,77,34,69,0,0,8,77,3,24,16,29,27,45,114,213,1,387,21,0,2,1,0,0
73793,143,3505,712,438,573,51,9,84,763,14,102,71,128,116,199,733,1364,8,11988,666,0,2,1,0,0
73794,85,4935,1296,573,1062,40,33,157,1336,8,201,118,231,209,349,1561,2689,4,12365,686,0,2,2,2,0
73797,28,596,2,2,2,0,0,0,2,0,0,0,0,0,0,0,0,0,0,0,0,2,2,2,0
73811,28,596,99,48,90,1,3,5,100,0,0,0,0,0,0,0,0,0,0,0,0,2,2,2,0
73812,28,596,8,5,5,2,0,1,10,0,0,0,0,0,0,0,0,0,0,0,0,2,2,2,0
73813,28,596,1217,716,841,84,126,174,1301,14,185,118,215,199,333,1446,2542,8,20687,1149,0,2,2,2,0
73814,28,596,160,89,115,0,13,31,160,7,15,11,17,22,28,78,124,3,495,27,0,2,2,2,0
73815,28,596,10,10,9,9,0,0,19,0,0,0,0,0,0,0,0,0,0,0,0,2,2,2,0
73816,28,596,173,84,99,8,29,36,181,5,12,7,13,17,20,54,81,2,221,12,0,2,2,2,0
73817,28,596,3,1,1,3,0,0,6,0,0,0,0,0,0,0,0,0,0,0,0,2,2,2,0
73820,40,1859,442,244,305,14,16,103,456,11,68,45,75,79,120,452,756,6,4588,254,0,2,11,1,0
73852,77,2606,477,336,357,30,23,73,507,16,194,134,250,210,384,1538,2962,10,30538,1696,0,2,23,9,0
73853,127,5419,1450,624,1228,12,26,181,1462,14,306,186,354,320,540,2580,4493,8,36391,2021,1,2,27,6,0
73854,302,6691,72,33,56,0,4,12,72,1,1,1,1,2,2,0,2,0,1,0,0,2,2,1,0
73855,302,6691,1454,835,1044,76,110,219,1530,17,275,158,296,292,454,2297,3718,9,34017,1889,1,2,2,1,0
73856,70,3147,1020,354,843,12,15,144,1032,8,134,77,144,142,221,970,1580,4,6792,377,0,2,15,0,0
73857,68,1510,402,202,227,24,74,80,426,12,52,33,61,64,94,339,564,7,3969,220,0,2,0,3,0
73858,68,1479,402,202,227,24,74,80,426,12,52,33,61,64,94,339,564,7,3969,220,0,2,14,14,0
73859,70,3140,1020,354,843,12,15,144,1032,8,134,77,144,142,221,970,1580,4,6792,377,0,2,6,0,0
73860,68,1479,402,202,227,24,74,80,426,12,52,33,61,64,94,339,564,7,3969,220,0,2,14,17,0
73864,71,3197,1020,354,843,12,15,144,1032,8,134,77,144,142,221,970,1580,4,6792,377,0,2,15,0,0
73865,31,1070,74,35,59,1,0,14,75,3,14,7,14,17,21,58,85,1,128,7,0,2,3,2,0
73866,31,1070,245,125,200,5,7,34,250,7,30,17,34,37,51,166,265,3,1053,58,0,2,3,2,0
73869,78,1993,466,257,367,18,25,50,484,7,126,86,171,133,257,898,1813,4,8612,478,0,2,4,4,1
73870,78,1993,507,281,342,29,59,88,536,10,53,29,57,63,86,336,514,5,2764,153,0,2,4,4,1
73871,296,6372,1943,715,1694,26,18,214,1969,12,185,120,237,197,357,1436,2721,7,20915,1161,0,2,30,20,1
73872,296,6372,1168,838,957,57,25,144,1225,19,348,224,416,367,640,3018,5452,11,61921,3440,1,2,30,20,1
73873,78,1993,466,257,367,18,25,50,484,7,126,86,171,133,257,898,1813,4,8612,478,0,2,4,4,0
73874,78,1993,507,281,342,29,59,88,536,10,53,29,57,63,86,336,514,5,2764,153,0,2,4,4,0
73875,296,6372,1943,715,1694,26,18,214,1969,12,185,120,237,197,357,1436,2721,7,20915,1161,0,2,30,20,0
73876,296,6372,1168,838,957,57,25,144,1225,19,348,224,416,367,640,3018,5452,11,61921,3440,1,2,30,20,0
73877,64,1418,207,111,150,11,0,50,218,5,26,19,36,31,55,133,272,3,943,52,0,2,41,0,1
73878,64,1418,410,198,237,31,55,97,441,11,63,38,72,74,110,414,683,6,4293,238,0,2,41,0,1
73879,55,1815,53,23,39,0,0,13,53,2,8,4,8,10,12,26,39,1,39,2,0,2,6,13,1
73880,55,1815,515,298,307,33,80,99,548,12,63,44,77,75,121,419,753,7,5527,307,0,2,6,13,1
73881,25,591,207,111,150,11,0,50,218,5,26,19,36,31,55,133,272,3,943,52,0,2,21,0,1
73884,56,1884,53,23,39,0,0,13,53,2,8,4,8,10,12,26,39,1,39,2,0,2,20,11,0
73885,56,1884,515,298,307,33,80,99,548,12,63,44,77,75,121,419,753,7,5527,307,0,2,20,11,0
73886,64,1418,207,111,150,11,0,50,218,5,26,19,36,31,55,133,272,3,943,52,0,2,41,0,0
73887,64,1418,410,198,237,31,55,97,441,11,63,38,72,74,110,414,683,6,4293,238,0,2,41,0,0
73888,55,1815,53,23,39,0,0,13,53,2,8,4,8,10,12,26,39,1,39,2,0,2,6,13,0
73889,55,1815,515,298,307,33,80,99,548,12,63,44,77,75,121,419,753,7,5527,307,0,2,6,13,0
73890,25,591,207,111,150,11,0,50,218,5,26,19,36,31,55,133,272,3,943,52,0,2,21,0,0
73891,145,5858,1782,648,1425,9,47,279,1791,8,171,97,189,179,286,1292,2140,4,9462,525,0,2,0,21,0
73892,55,1873,53,23,39,0,0,13,53,2,8,4,8,10,12,26,39,1,39,2,0,2,20,11,0
73893,55,1873,515,298,307,33,80,99,548,12,63,44,77,75,121,419,753,7,5527,307,0,2,20,11,0
73894,227,6314,722,423,573,19,0,135,741,12,172,101,199,184,300,1320,2257,6,15668,870,0,2,2,1,0
73895,227,6314,1508,847,911,44,250,301,1552,14,148,88,169,162,257,1120,1886,7,15077,837,0,2,2,1,0
73898,227,6345,722,423,573,19,0,135,741,12,172,101,199,184,300,1320,2257,6,15668,870,0,2,11,4,0
73899,227,6345,1508,847,911,44,250,301,1552,14,148,88,169,162,257,1120,1886,7,15077,837,0,2,11,4,0
73900,127,5424,1450,624,1228,12,26,181,1462,14,306,186,354,320,540,2580,4493,8,36391,2021,1,2,8,1,0
73901,298,6416,1943,715,1694,26,18,214,1969,12,185,120,237,197,357,1436,2721,7,20915,1161,0,2,5,1,0
73902,298,6416,1168,838,957,57,25,144,1225,19,348,224,416,367,640,3018,5452,11,61921,3440,1,2,5,1,0
73903,85,4946,1296,573,1062,40,33,157,1336,8,201,118,231,209,349,1561,2689,4,12365,686,0,2,9,4,0
73904,114,6852,1943,715,1694,26,18,214,1969,12,185,120,237,197,357,1436,2721,7,20915,1161,0,2,25,1,0
73913,23,625,601,196,481,2,23,85,603,8,63,36,72,71,108,400,664,4,3036,168,0,2,1,1,0
73914,23,625,156,79,106,5,16,28,161,5,14,8,15,19,23,64,97,2,261,14,0,2,1,1,0
73917,239,5077,2,2,2,0,0,0,2,0,0,0,0,0,0,0,0,0,0,0,0,2,1,1,0
73931,239,5077,99,48,90,1,3,5,100,0,0,0,0,0,0,0,0,0,0,0,0,2,1,1,0
73932,239,5077,8,5,5,2,0,1,10,0,0,0,0,0,0,0,0,0,0,0,0,2,1,1,0
73933,239,5077,1217,716,841,84,126,174,1301,14,185,118,215,199,333,1446,2542,8,20687,1149,0,2,1,1,0
73934,239,5077,160,89,115,0,13,31,160,7,15,11,17,22,28,78,124,3,495,27,0,2,1,1,0
73935,239,5077,10,10,9,9,0,0,19,0,0,0,0,0,0,0,0,0,0,0,0,2,1,1,0
73936,239,5077,173,84,99,8,29,36,181,5,12,7,13,17,20,54,81,2,221,12,0,2,1,1,0
73937,239,5077,3,1,1,3,0,0,6,0,0,0,0,0,0,0,0,0,0,0,0,2,1,1,0
73938,113,2326,463,295,324,28,62,57,491,12,134,82,154,146,236,989,1696,6,11700,650,0,2,1,1,0
73939,54,642,647,139,84,35,284,233,682,0,0,0,0,0,0,0,0,0,0,0,0,2,4,4,0
73940,296,6372,1943,715,1694,26,18,214,1969,12,185,120,237,197,357,1436,2721,7,20915,1161,0,2,1,1,0
73941,296,6372,1168,838,957,57,25,144,1225,19,348,224,416,367,640,3018,5452,11,61921,3440,1,2,1,1,0
73943,118,3197,1523,757,1297,19,12,193,1542,12,193,117,230,205,347,1508,2664,7,19053,1058,0,2,8,4,0
73944,118,3197,701,378,504,33,58,109,734,13,110,68,126,123,194,794,1346,7,10027,557,0,2,8,4,0
73945,7,265,75,38,59,1,3,12,76,2,4,2,4,6,6,10,15,1,15,0,0,2,29,0,0
73946,307,6777,72,33,56,0,4,12,72,1,1,1,1,2,2,0,2,0,1,0,0,2,6,0,0
73947,307,6777,1454,835,1044,76,110,219,1530,17,275,158,296,292,454,2297,3718,9,34017,1889,1,2,6,0,0
73948,149,5988,1782,648,1425,9,47,279,1791,8,171,97,189,179,286,1292,2140,4,9462,525,0,2,13,0,0
73977,298,6416,1943,715,1694,26,18,214,1969,12,185,120,237,197,357,1436,2721,7,20915,1161,0,2,1,1,0
73978,298,6416,1168,838,957,57,25,144,1225,19,348,224,416,367,640,3018,5452,11,61921,3440,1,2,1,1,0
73987,239,5075,2,2,2,0,0,0,2,0,0,0,0,0,0,0,0,0,0,0,0,2,0,1,0
74001,239,5075,99,48,90,1,3,5,100,0,0,0,0,0,0,0,0,0,0,0,0,2,0,1,0
74002,239,5075,8,5,5,2,0,1,10,0,0,0,0,0,0,0,0,0,0,0,0,2,0,1,0
74003,239,5075,1217,716,841,84,126,174,1301,14,185,118,215,199,333,1446,2542,8,20687,1149,0,2,0,1,0
74004,239,5075,160,89,115,0,13,31,160,7,15,11,17,22,28,78,124,3,495,27,0,2,0,1,0
74005,239,5075,10,10,9,9,0,0,19,0,0,0,0,0,0,0,0,0,0,0,0,2,0,1,0
74006,239,5075,173,84,99,8,29,36,181,5,12,7,13,17,20,54,81,2,221,12,0,2,0,1,0
74007,239,5075,3,1,1,3,0,0,6,0,0,0,0,0,0,0,0,0,0,0,0,2,0,1,0
74009,7,265,75,38,59,1,3,12,76,2,4,2,4,6,6,10,15,1,15,0,0,2,1,1,0
74010,304,6699,72,33,56,0,4,12,72,1,1,1,1,2,2,0,2,0,1,0,0,2,6,18,0
74011,304,6699,1454,835,1044,76,110,219,1530,17,275,158,296,292,454,2297,3718,9,34017,1889,1,2,6,18,0
74012,79,3071,1178,367,1042,6,15,115,1184,9,94,51,95,103,146,644,976,4,4439,246,0,2,0,23,0
74013,87,5041,1296,573,1062,40,33,157,1336,8,201,118,231,209,349,1561,2689,4,12365,686,0,2,21,0,0
74018,191,5619,1660,832,1314,41,38,274,1701,20,312,209,395,332,604,2671,5058,12,64042,3557,1,2,1,1,0
74019,191,5619,1057,646,719,113,100,145,1170,18,215,134,248,233,382,1740,3004,10,31186,1732,1,2,1,1,0
74022,239,5079,2,2,2,0,0,0,2,0,0,0,0,0,0,0,0,0,0,0,0,2,1,1,0
74036,239,5079,99,48,90,1,3,5,100,0,0,0,0,0,0,0,0,0,0,0,0,2,1,1,0
74037,239,5079,8,5,5,2,0,1,10,0,0,0,0,0,0,0,0,0,0,0,0,2,1,1,0
74038,239,5079,1217,716,841,84,126,174,1301,14,185,118,215,199,333,1446,2542,8,20687,1149,0,2,1,1,0
74039,239,5079,160,89,115,0,13,31,160,7,15,11,17,22,28,78,124,3,495,27,0,2,1,1,0
74040,239,5079,10,10,9,9,0,0,19,0,0,0,0,0,0,0,0,0,0,0,0,2,1,1,0
74041,239,5079,173,84,99,8,29,36,181,5,12,7,13,17,20,54,81,2,221,12,0,2,1,1,0
74042,239,5079,3,1,1,3,0,0,6,0,0,0,0,0,0,0,0,0,0,0,0,2,1,1,0
74043,191,6342,1660,832,1314,41,38,274,1701,20,312,209,395,332,604,2671,5058,12,64042,3557,1,2,1,1,0
74044,111,6058,1457,730,1242,11,6,188,1468,10,292,166,329,302,495,2424,4078,5,22973,1276,1,2,1,1,0
74045,46,2850,652,304,544,16,6,88,668,6,89,51,101,95,152,591,998,3,3399,188,0,2,1,1,0
74046,113,5659,1523,757,1297,19,12,193,1542,12,193,117,230,205,347,1508,2664,7,19053,1058,0,2,1,1,0
74047,51,3885,996,429,845,24,10,117,1020,7,76,50,88,83,138,494,879,4,3565,198,0,2,3,3,0
74077,303,6705,72,33,56,0,4,12,72,1,1,1,1,2,2,0,2,0,1,0,0,2,6,0,0
74078,303,6705,1454,835,1044,76,110,219,1530,17,275,158,296,292,454,2297,3718,9,34017,1889,1,2,6,0,0
74079,147,5913,1782,648,1425,9,47,279,1791,8,171,97,189,179,286,1292,2140,4,9462,525,0,2,13,0,0
74080,87,5034,1296,573,1062,40,33,157,1336,8,201,118,231,209,349,1561,2689,4,12365,686,0,2,21,0,0
74081,304,6689,72,33,56,0,4,12,72,1,1,1,1,2,2,0,2,0,1,0,0,2,1,2,0
74082,304,6689,1454,835,1044,76,110,219,1530,17,275,158,296,292,454,2297,3718,9,34017,1889,1,2,1,2,0
74083,58,1732,773,419,590,28,0,166,801,10,204,113,217,214,330,1598,2554,5,13587,754,0,2,1,1,0
74084,58,1732,421,273,302,44,34,57,465,17,81,59,107,98,166,583,1098,11,12329,684,0,2,1,1,0
74085,191,5619,1660,832,1314,41,38,274,1701,20,312,209,395,332,604,2671,5058,12,64042,3557,1,2,3,2,0
74086,191,5619,1057,646,719,113,100,145,1170,18,215,134,248,233,382,1740,3004,10,31186,1732,1,2,3,2,0
74087,64,1418,207,111,150,11,0,50,218,5,26,19,36,31,55,133,272,3,943,52,0,2,5,2,0
74088,64,1418,410,198,237,31,55,97,441,11,63,38,72,74,110,414,683,6,4293,238,0,2,5,2,0
74090,20,989,386,256,301,16,9,68,402,4,59,35,69,63,104,355,621,2,1453,80,0,2,3,3,0
74091,20,989,264,131,164,11,41,46,275,6,38,22,40,44,62,214,338,3,1068,59,0,2,3,3,0
74092,117,4986,1513,682,1277,25,13,200,1538,11,199,116,219,210,335,1557,2584,6,15641,868,0,2,0,2,0
74093,217,5015,182,127,129,0,0,53,182,5,39,21,42,44,63,217,343,2,926,51,0,2,0,2,0
74094,217,5015,1165,710,800,67,119,181,1232,18,243,153,282,261,435,2000,3492,10,36473,2026,1,2,0,2,0
74095,148,7106,1392,870,1177,35,17,170,1427,14,494,280,531,508,811,4473,7289,7,54850,3047,2,2,3,3,0
74096,100,2878,773,419,590,28,0,166,801,10,204,113,217,214,330,1598,2554,5,13587,754,0,2,1,1,0
74097,63,1383,207,111,150,11,0,50,218,5,26,19,36,31,55,133,272,3,943,52,0,2,0,15,0
74098,63,1383,410,198,237,31,55,97,441,11,63,38,72,74,110,414,683,6,4293,238,0,2,0,15,0
74099,262,6261,4293,999,3693,19,54,507,4312,9,155,88,170,164,258,1156,1898,4,9368,520,0,2,8,2,0
74100,262,6261,1482,859,1002,125,135,219,1607,16,219,134,251,235,385,1766,3032,9,27804,1544,1,2,8,2,0
74101,304,6734,72,33,56,0,4,12,72,1,1,1,1,2,2,0,2,0,1,0,0,2,15,2,0
74102,304,6734,1454,835,1044,76,110,219,1530,17,275,158,296,292,454,2297,3718,9,34017,1889,1,2,15,2,0
74103,217,5010,182,127,129,0,0,53,182,5,39,21,42,44,63,217,343,2,926,51,0,2,1,3,0
74104,217,5010,1165,710,800,67,119,181,1232,18,243,153,282,261,435,2000,3492,10,36473,2026,1,2,1,3,0
74105,143,6926,1392,870,1177,35,17,170,1427,14,494,280,531,508,811,4473,7289,7,54850,3047,2,2,8,55,0
74106,59,1754,773,419,590,28,0,166,801,10,204,113,217,214,330,1598,2554,5,13587,754,0,2,4,0,0
74107,59,1754,421,273,302,44,34,57,465,17,81,59,107,98,166,583,1098,11,12329,684,0,2,4,0,0
74108,53,1495,207,111,150,11,0,50,218,5,26,19,36,31,55,133,272,3,943,52,0,2,29,18,0
74109,53,1495,410,198,237,31,55,97,441,11,63,38,72,74,110,414,683,6,4293,238,0,2,29,18,0
74110,85,2063,996,429,845,24,10,117,1020,7,76,50,88,83,138,494,879,4,3565,198,0,2,2,1,0
74111,85,2063,456,277,329,12,42,72,468,13,85,50,97,98,147,592,972,7,7212,400,0,2,2,1,0
74116,239,5079,2,2,2,0,0,0,2,0,0,0,0,0,0,0,0,0,0,0,0,2,2,2,0
74130,239,5079,99,48,90,1,3,5,100,0,0,0,0,0,0,0,0,0,0,0,0,2,2,2,0
74131,239,5079,8,5,5,2,0,1,10,0,0,0,0,0,0,0,0,0,0,0,0,2,2,2,0
74132,239,5079,1217,716,841,84,126,174,1301,14,185,118,215,199,333,1446,2542,8,20687,1149,0,2,2,2,0
74133,239,5079,160,89,115,0,13,31,160,7,15,11,17,22,28,78,124,3,495,27,0,2,2,2,0
74134,239,5079,10,10,9,9,0,0,19,0,0,0,0,0,0,0,0,0,0,0,0,2,2,2,0
74135,239,5079,173,84,99,8,29,36,181,5,12,7,13,17,20,54,81,2,221,12,0,2,2,2,0
74136,239,5079,3,1,1,3,0,0,6,0,0,0,0,0,0,0,0,0,0,0,0,2,2,2,0
74137,113,2328,463,295,324,28,62,57,491,12,134,82,154,146,236,989,1696,6,11700,650,0,2,1,1,0
74138,227,6346,722,423,573,19,0,135,741,12,172,101,199,184,300,1320,2257,6,15668,870,0,2,1,1,0
74139,227,6346,1508,847,911,44,250,301,1552,14,148,88,169,162,257,1120,1886,7,15077,837,0,2,1,1,0
74140,185,8005,4293,999,3693,19,54,507,4312,9,155,88,170,164,258,1156,1898,4,9368,520,0,2,3,3,0
74141,185,8005,1482,859,1002,125,135,219,1607,16,219,134,251,235,385,1766,3032,9,27804,1544,1,2,3,3,0
74142,30,921,256,139,192,9,7,47,265,4,23,12,24,27,36,112,171,2,357,19,0,2,1,1,0
74143,85,4954,1296,573,1062,40,33,157,1336,8,201,118,231,209,349,1561,2689,4,12365,686,0,2,4,4,0
74144,71,3199,1020,354,843,12,15,144,1032,8,134,77,144,142,221,970,1580,4,6792,377,0,2,1,1,0
74145,79,3073,1178,367,1042,6,15,115,1184,9,94,51,95,103,146,644,976,4,4439,246,0,2,1,1,0
74146,40,1861,442,244,305,14,16,103,456,11,68,45,75,79,120,452,756,6,4588,254,0,2,1,1,0
74147,51,2042,1098,241,925,5,10,155,1103,7,46,25,49,53,74,273,423,3,1580,87,0,2,1,1,0
74182,186,5483,182,127,129,0,0,53,182,5,39,21,42,44,63,217,343,2,926,51,0,2,153,87,1
74183,186,5483,1165,710,800,67,119,181,1232,18,243,153,282,261,435,2000,3492,10,36473,2026,1,2,153,87,1
74184,31,1010,182,127,129,0,0,53,182,5,39,21,42,44,63,217,343,2,926,51,0,2,29,28,1
74185,143,6943,1392,870,1177,35,17,170,1427,14,494,280,531,508,811,4473,7289,7,54850,3047,2,2,11,8,1
74186,100,3088,773,419,590,28,0,166,801,10,204,113,217,214,330,1598,2554,5,13587,754,0,2,106,91,1
74187,51,3863,996,429,845,24,10,117,1020,7,76,50,88,83,138,494,879,4,3565,198,0,2,53,150,0
74188,51,3873,996,429,845,24,10,117,1020,7,76,50,88,83,138,494,879,4,3565,198,0,2,2,1,0
74189,186,5483,182,127,129,0,0,53,182,5,39,21,42,44,63,217,343,2,926,51,0,2,153,91,0
74190,186,5483,1165,710,800,67,119,181,1232,18,243,153,282,261,435,2000,3492,10,36473,2026,1,2,153,91,0
74191,59,1754,773,419,590,28,0,166,801,10,204,113,217,214,330,1598,2554,5,13587,754,0,2,5,1,0
74192,59,1754,421,273,302,44,34,57,465,17,81,59,107,98,166,583,1098,11,12329,684,0,2,5,1,0
74195,53,1495,207,111,150,11,0,50,218,5,26,19,36,31,55,133,272,3,943,52,0,2,34,35,0
74196,53,1495,410,198,237,31,55,97,441,11,63,38,72,74,110,414,683,6,4293,238,0,2,34,35,0
74204,31,1010,182,127,129,0,0,53,182,5,39,21,42,44,63,217,343,2,926,51,0,2,29,28,0
74205,143,6943,1392,870,1177,35,17,170,1427,14,494,280,531,508,811,4473,7289,7,54850,3047,2,2,22,66,0
74206,100,3088,773,419,590,28,0,166,801,10,204,113,217,214,330,1598,2554,5,13587,754,0,2,107,92,0
74208,51,3873,996,429,845,24,10,117,1020,7,76,50,88,83,138,494,879,4,3565,198,0,2,58,154,0
74209,305,6748,72,33,56,0,4,12,72,1,1,1,1,2,2,0,2,0,1,0,0,2,6,0,0
74210,305,6748,1454,835,1044,76,110,219,1530,17,275,158,296,292,454,2297,3718,9,34017,1889,1,2,6,0,0
74212,87,5042,1296,573,1062,40,33,157,1336,8,201,118,231,209,349,1561,2689,4,12365,686,0,2,21,0,0
74213,5,119,110,30,77,3,13,16,113,4,21,15,30,25,45,100,208,2,597,33,0,2,2,1,0
74214,5,119,28,15,21,1,0,6,29,0,0,0,0,0,0,0,0,0,0,0,0,2,2,1,0
74215,305,6741,72,33,56,0,4,12,72,1,1,1,1,2,2,0,2,0,1,0,0,2,0,1,0
74216,305,6741,1454,835,1044,76,110,219,1530,17,275,158,296,292,454,2297,3718,9,34017,1889,1,2,0,1,0
74217,306,6756,72,33,56,0,4,12,72,1,1,1,1,2,2,0,2,0,1,0,0,2,8,5,0
74218,306,6756,1454,835,1044,76,110,219,1530,17,275,158,296,292,454,2297,3718,9,34017,1889,1,2,8,5,0
74219,87,5061,1296,573,1062,40,33,157,1336,8,201,118,231,209,349,1561,2689,4,12365,686,0,2,9,2,0
74222,306,6749,72,33,56,0,4,12,72,1,1,1,1,2,2,0,2,0,1,0,0,2,0,1,0
74223,306,6749,1454,835,1044,76,110,219,1530,17,275,158,296,292,454,2297,3718,9,34017,1889,1,2,0,1,0
74224,305,6740,72,33,56,0,4,12,72,1,1,1,1,2,2,0,2,0,1,0,0,2,10,6,0
74225,305,6740,1454,835,1044,76,110,219,1530,17,275,158,296,292,454,2297,3718,9,34017,1889,1,2,10,6,0
74226,147,5922,1782,648,1425,9,47,279,1791,8,171,97,189,179,286,1292,2140,4,9462,525,0,2,2,2,0
74232,239,5077,2,2,2,0,0,0,2,0,0,0,0,0,0,0,0,0,0,0,0,2,0,1,0
74246,239,5077,99,48,90,1,3,5,100,0,0,0,0,0,0,0,0,0,0,0,0,2,0,1,0
74247,239,5077,8,5,5,2,0,1,10,0,0,0,0,0,0,0,0,0,0,0,0,2,0,1,0
74248,239,5077,1217,716,841,84,126,174,1301,14,185,118,215,199,333,1446,2542,8,20687,1149,0,2,0,1,0
74249,239,5077,160,89,115,0,13,31,160,7,15,11,17,22,28,78,124,3,495,27,0,2,0,1,0
74250,239,5077,10,10,9,9,0,0,19,0,0,0,0,0,0,0,0,0,0,0,0,2,0,1,0
74251,239,5077,173,84,99,8,29,36,181,5,12,7,13,17,20,54,81,2,221,12,0,2,0,1,0
74252,239,5077,3,1,1,3,0,0,6,0,0,0,0,0,0,0,0,0,0,0,0,2,0,1,0
74255,191,5605,1660,832,1314,41,38,274,1701,20,312,209,395,332,604,2671,5058,12,64042,3557,1,2,2,2,0
74256,191,5605,1057,646,719,113,100,145,1170,18,215,134,248,233,382,1740,3004,10,31186,1732,1,2,2,2,0
74262,107,4605,1289,550,1043,56,32,155,1345,10,167,93,185,177,278,1266,2075,5,11498,638,0,2,0,1,0
74265,304,6726,72,33,56,0,4,12,72,1,1,1,1,2,2,0,2,0,1,0,0,2,0,4,0
74266,304,6726,1454,835,1044,76,110,219,1530,17,275,158,296,292,454,2297,3718,9,34017,1889,1,2,0,4,0
74270,69,1500,402,202,227,24,74,80,426,12,52,33,61,64,94,339,564,7,3969,220,0,2,12,7,0
74271,302,6686,72,33,56,0,4,12,72,1,1,1,1,2,2,0,2,0,1,0,0,2,0,10,0
74272,302,6686,1454,835,1044,76,110,219,1530,17,275,158,296,292,454,2297,3718,9,34017,1889,1,2,0,10,0
74273,147,5907,1782,648,1425,9,47,279,1791,8,171,97,189,179,286,1292,2140,4,9462,525,0,2,12,8,0
74274,304,6716,72,33,56,0,4,12,72,1,1,1,1,2,2,0,2,0,1,0,0,2,1,2,0
74275,304,6716,1454,835,1044,76,110,219,1530,17,275,158,296,292,454,2297,3718,9,34017,1889,1,2,1,2,0
74278,106,4666,1289,550,1043,56,32,155,1345,10,167,93,185,177,278,1266,2075,5,11498,638,0,2,0,1,0
74279,87,5062,1296,573,1062,40,33,157,1336,8,201,118,231,209,349,1561,2689,4,12365,686,0,2,9,2,0
74280,12,190,110,30,77,3,13,16,113,4,21,15,30,25,45,100,208,2,597,33,0,2,91,0,0
74281,189,5498,1660,832,1314,41,38,274,1701,20,312,209,395,332,604,2671,5058,12,64042,3557,1,2,0,31,0
74282,189,5498,1057,646,719,113,100,145,1170,18,215,134,248,233,382,1740,3004,10,31186,1732,1,2,0,31,0
74283,45,1597,601,196,481,2,23,85,603,8,63,36,72,71,108,400,664,4,3036,168,0,2,1,43,0
74285,301,6672,72,33,56,0,4,12,72,1,1,1,1,2,2,0,2,0,1,0,0,2,0,10,0
74286,301,6672,1454,835,1044,76,110,219,1530,17,275,158,296,292,454,2297,3718,9,34017,1889,1,2,0,10,0
74288,301,6662,72,33,56,0,4,12,72,1,1,1,1,2,2,0,2,0,1,0,0,2,1,2,0
74289,301,6662,1454,835,1044,76,110,219,1530,17,275,158,296,292,454,2297,3718,9,34017,1889,1,2,1,2,0
74297,186,5483,182,127,129,0,0,53,182,5,39,21,42,44,63,217,343,2,926,51,0,2,177,110,0
74298,186,5483,1165,710,800,67,119,181,1232,18,243,153,282,261,435,2000,3492,10,36473,2026,1,2,177,110,0
74299,59,1754,773,419,590,28,0,166,801,10,204,113,217,214,330,1598,2554,5,13587,754,0,2,54,23,0
74300,59,1754,421,273,302,44,34,57,465,17,81,59,107,98,166,583,1098,11,12329,684,0,2,54,23,0
74301,18,382,149,95,105,2,0,41,151,8,54,28,55,62,83,334,494,4,2013,111,0,2,30,15,0
74302,18,382,82,56,54,0,13,15,82,4,13,8,16,17,24,56,98,2,241,13,0,2,30,15,0
74326,191,5605,1660,832,1314,41,38,274,1701,20,312,209,395,332,604,2671,5058,12,64042,3557,1,2,93,47,0
74327,191,5605,1057,646,719,113,100,145,1170,18,215,134,248,233,382,1740,3004,10,31186,1732,1,2,93,47,0
74328,77,2606,477,336,357,30,23,73,507,16,194,134,250,210,384,1538,2962,10,30538,1696,0,2,101,45,0
74329,85,2063,996,429,845,24,10,117,1020,7,76,50,88,83,138,494,879,4,3565,198,0,2,11,4,0
74330,85,2063,456,277,329,12,42,72,468,13,85,50,97,98,147,592,972,7,7212,400,0,2,11,4,0
74331,161,3438,1513,682,1277,25,13,200,1538,11,199,116,219,210,335,1557,2584,6,15641,868,0,2,8,13,0
74332,161,3438,819,519,539,24,98,155,843,15,96,57,106,111,163,690,1107,8,9171,509,0,2,8,13,0
74333,53,1495,207,111,150,11,0,50,218,5,26,19,36,31,55,133,272,3,943,52,0,2,88,34,0
74334,53,1495,410,198,237,31,55,97,441,11,63,38,72,74,110,414,683,6,4293,238,0,2,88,34,0
74337,239,5077,2,2,2,0,0,0,2,0,0,0,0,0,0,0,0,0,0,0,0,2,22,14,0
74351,239,5077,99,48,90,1,3,5,100,0,0,0,0,0,0,0,0,0,0,0,0,2,22,14,0
74352,239,5077,8,5,5,2,0,1,10,0,0,0,0,0,0,0,0,0,0,0,0,2,22,14,0
74353,239,5077,1217,716,841,84,126,174,1301,14,185,118,215,199,333,1446,2542,8,20687,1149,0,2,22,14,0
74354,239,5077,160,89,115,0,13,31,160,7,15,11,17,22,28,78,124,3,495,27,0,2,22,14,0
74355,239,5077,10,10,9,9,0,0,19,0,0,0,0,0,0,0,0,0,0,0,0,2,22,14,0
74356,239,5077,173,84,99,8,29,36,181,5,12,7,13,17,20,54,81,2,221,12,0,2,22,14,0
74357,239,5077,3,1,1,3,0,0,6,0,0,0,0,0,0,0,0,0,0,0,0,2,22,14,0
74358,113,2328,463,295,324,28,62,57,491,12,134,82,154,146,236,989,1696,6,11700,650,0,2,2,2,0
74359,57,1477,339,213,244,17,9,65,356,10,42,26,48,52,74,259,421,5,2410,133,0,2,8,2,0
74361,103,2729,1455,414,1257,16,76,112,1471,5,41,23,46,46,69,231,381,2,1069,59,0,2,75,37,0
74362,103,2729,669,365,481,22,61,110,691,15,103,63,122,118,185,747,1273,8,11311,628,0,2,75,37,0
74363,262,6261,4293,999,3693,19,54,507,4312,9,155,88,170,164,258,1156,1898,4,9368,520,0,2,18,6,0
74364,262,6261,1482,859,1002,125,135,219,1607,16,219,134,251,235,385,1766,3032,9,27804,1544,1,2,18,6,0
74367,54,642,647,139,84,35,284,233,682,0,0,0,0,0,0,0,0,0,0,0,0,2,10,25,0
74370,117,2969,773,422,505,30,103,129,803,14,77,46,83,91,129,535,839,7,6334,351,0,2,103,23,0
74371,143,3505,77,34,69,0,0,8,77,3,24,16,29,27,45,114,213,1,387,21,0,2,19,11,0
74372,143,3505,712,438,573,51,9,84,763,14,102,71,128,116,199,733,1364,8,11988,666,0,2,19,11,0
74396,69,1500,402,202,227,24,74,80,426,12,52,33,61,64,94,339,564,7,3969,220,0,2,26,24,0
74397,55,1873,53,23,39,0,0,13,53,2,8,4,8,10,12,26,39,1,39,2,0,2,54,29,0
74398,55,1873,515,298,307,33,80,99,548,12,63,44,77,75,121,419,753,7,5527,307,0,2,54,29,0
74399,61,1561,91,45,69,0,3,18,91,3,9,6,10,12,16,33,57,1,95,5,0,2,44,28,0
74400,61,1561,367,234,237,17,34,68,384,16,55,34,61,71,95,381,584,8,5183,287,0,2,44,28,0
74401,227,6346,722,423,573,19,0,135,741,12,172,101,199,184,300,1320,2257,6,15668,870,0,2,182,77,0
74402,227,6346,1508,847,911,44,250,301,1552,14,148,88,169,162,257,1120,1886,7,15077,837,0,2,182,77,0
74403,301,6662,72,33,56,0,4,12,72,1,1,1,1,2,2,0,2,0,1,0,0,2,29,22,0
74404,301,6662,1454,835,1044,76,110,219,1530,17,275,158,296,292,454,2297,3718,9,34017,1889,1,2,29,22,0
74405,80,1970,757,253,292,73,244,162,830,13,61,38,67,74,105,409,651,7,4654,258,0,2,7,9,0
74406,20,989,386,256,301,16,9,68,402,4,59,35,69,63,104,355,621,2,1453,80,0,2,5,8,0
74407,20,989,264,131,164,11,41,46,275,6,38,22,40,44,62,214,338,3,1068,59,0,2,5,8,0
74408,78,1993,466,257,367,18,25,50,484,7,126,86,171,133,257,898,1813,4,8612,478,0,2,24,14,0
74409,78,1993,507,281,342,29,59,88,536,10,53,29,57,63,86,336,514,5,2764,153,0,2,24,14,0
74410,87,1930,1043,504,840,53,9,147,1096,9,180,112,198,189,310,1377,2344,4,11604,644,0,2,6,13,0
74411,87,1930,383,288,292,26,6,62,409,11,65,38,67,76,105,429,656,5,3719,206,0,2,6,13,0
74416,298,6416,1943,715,1694,26,18,214,1969,12,185,120,237,197,357,1436,2721,7,20915,1161,0,2,164,69,0
74417,298,6416,1168,838,957,57,25,144,1225,19,348,224,416,367,640,3018,5452,11,61921,3440,1,2,164,69,0
74422,23,625,601,196,481,2,23,85,603,8,63,36,72,71,108,400,664,4,3036,168,0,2,6,2,0
74423,23,625,156,79,106,5,16,28,161,5,14,8,15,19,23,64,97,2,261,14,0,2,6,2,0
74424,106,4666,1289,550,1043,56,32,155,1345,10,167,93,185,177,278,1266,2075,5,11498,638,0,2,65,17,0
74426,143,6943,1392,870,1177,35,17,170,1427,14,494,280,531,508,811,4473,7289,7,54850,3047,2,2,45,75,0
74427,100,3088,773,419,590,28,0,166,801,10,204,113,217,214,330,1598,2554,5,13587,754,0,2,126,106,0
74445,7,265,75,38,59,1,3,12,76,2,4,2,4,6,6,10,15,1,15,0,0,2,30,1,0
74450,69,4372,520,294,400,33,13,81,553,10,261,204,367,271,571,2128,4614,7,32445,1802,1,2,61,48,0
74451,89,3928,1338,495,1086,10,64,173,1348,11,122,82,157,133,239,883,1686,7,11934,663,0,2,2,2,0
74452,185,8005,4293,999,3693,19,54,507,4312,9,155,88,170,164,258,1156,1898,4,9368,520,0,2,7,7,0
74453,185,8005,1482,859,1002,125,135,219,1607,16,219,134,251,235,385,1766,3032,9,27804,1544,1,2,7,7,0
74454,147,5907,1782,648,1425,9,47,279,1791,8,171,97,189,179,286,1292,2140,4,9462,525,0,2,14,31,0
74457,127,5424,1450,624,1228,12,26,181,1462,14,306,186,354,320,540,2580,4493,8,36391,2021,1,2,131,17,0
74458,191,6342,1660,832,1314,41,38,274,1701,20,312,209,395,332,604,2671,5058,12,64042,3557,1,2,115,37,0
74459,51,3873,996,429,845,24,10,117,1020,7,76,50,88,83,138,494,879,4,3565,198,0,2,84,165,0
74460,117,4986,1513,682,1277,25,13,200,1538,11,199,116,219,210,335,1557,2584,6,15641,868,0,2,17,36,0
74461,87,5062,1296,573,1062,40,33,157,1336,8,201,118,231,209,349,1561,2689,4,12365,686,0,2,24,19,0
74463,111,6058,1457,730,1242,11,6,188,1468,10,292,166,329,302,495,2424,4078,5,22973,1276,1,2,9,4,0
74464,46,2850,652,304,544,16,6,88,668,6,89,51,101,95,152,591,998,3,3399,188,0,2,3,3,0
74465,81,3715,1455,414,1257,16,76,112,1471,5,41,23,46,46,69,231,381,2,1069,59,0,2,9,8,0
74467,113,5659,1523,757,1297,19,12,193,1542,12,193,117,230,205,347,1508,2664,7,19053,1058,0,2,18,15,0
74468,71,3199,1020,354,843,12,15,144,1032,8,134,77,144,142,221,970,1580,4,6792,377,0,2,23,2,0
74470,79,4230,1293,570,1093,25,15,163,1318,10,195,123,241,205,364,1516,2795,6,17273,959,0,2,29,7,0
74472,62,3231,722,423,573,19,0,135,741,12,172,101,199,184,300,1320,2257,6,15668,870,0,2,115,11,0
74474,88,3442,1043,504,840,53,9,147,1096,9,180,112,198,189,310,1377,2344,4,11604,644,0,2,19,11,0
74475,12,463,295,56,236,0,4,54,295,2,9,5,10,11,15,30,51,1,57,3,0,2,2,2,0
74477,12,572,294,64,250,0,0,43,294,1,20,10,20,21,30,86,131,0,65,3,0,3,1,1,0
74479,79,3073,1178,367,1042,6,15,115,1184,9,94,51,95,103,146,644,976,4,4439,246,0,2,20,6,0
74481,114,6852,1943,715,1694,26,18,214,1969,12,185,120,237,197,357,1436,2721,7,20915,1161,0,2,206,53,0
74482,40,1861,442,244,305,14,16,103,456,11,68,45,75,79,120,452,756,6,4588,254,0,2,12,2,0
74483,51,2042,1098,241,925,5,10,155,1103,7,46,25,49,53,74,273,423,3,1580,87,0,2,25,13,0
74484,49,1715,601,196,481,2,23,85,603,8,63,36,72,71,108,400,664,4,3036,168,0,2,7,6,0
74485,227,6367,722,423,573,19,0,135,741,12,172,101,199,184,300,1320,2257,6,15668,870,0,2,21,17,1
74486,227,6367,1508,847,911,44,250,301,1552,14,148,88,169,162,257,1120,1886,7,15077,837,0,2,21,17,1
74487,63,3295,722,423,573,19,0,135,741,12,172,101,199,184,300,1320,2257,6,15668,870,0,2,9,1,1
74488,227,6367,722,423,573,19,0,135,741,12,172,101,199,184,300,1320,2257,6,15668,870,0,2,21,17,0
74489,227,6367,1508,847,911,44,250,301,1552,14,148,88,169,162,257,1120,1886,7,15077,837,0,2,21,17,0
74490,63,3295,722,423,573,19,0,135,741,12,172,101,199,184,300,1320,2257,6,15668,870,0,2,9,1,0
74491,1,303,382,65,130,157,2,92,539,4,10,5,10,14,15,41,57,2,114,6,0,2,1,1,0
74492,227,6370,722,423,573,19,0,135,741,12,172,101,199,184,300,1320,2257,6,15668,870,0,2,1,0,0
74493,227,6370,1508,847,911,44,250,301,1552,14,148,88,169,162,257,1120,1886,7,15077,837,0,2,1,0,0
74498,88,3448,1043,504,840,53,9,147,1096,9,180,112,198,189,310,1377,2344,4,11604,644,0,2,3,3,0
74499,88,1929,1043,504,840,53,9,147,1096,9,180,112,198,189,310,1377,2344,4,11604,644,0,2,6,1,0
74500,88,1929,383,288,292,26,6,62,409,11,65,38,67,76,105,429,656,5,3719,206,0,2,6,1,0
74504,1,322,382,65,130,157,2,92,539,4,10,5,10,14,15,41,57,2,114,6,0,2,1,1,0
74505,145,3551,77,34,69,0,0,8,77,3,24,16,29,27,45,114,213,1,387,21,0,2,10,4,0
74506,145,3551,712,438,573,51,9,84,763,14,102,71,128,116,199,733,1364,8,11988,666,0,2,10,4,0
74507,4,216,77,34,69,0,0,8,77,3,24,16,29,27,45,114,213,1,387,21,0,0,52,0,0
74508,298,6420,1943,715,1694,26,18,214,1969,12,185,120,237,197,357,1436,2721,7,20915,1161,0,2,1,1,0
74509,298,6420,1168,838,957,57,25,144,1225,19,348,224,416,367,640,3018,5452,11,61921,3440,1,2,1,1,0
74515,105,2771,1455,414,1257,16,76,112,1471,5,41,23,46,46,69,231,381,2,1069,59,0,2,10,0,0
74516,105,2771,669,365,481,22,61,110,691,15,103,63,122,118,185,747,1273,8,11311,628,0,2,10,0,0
74517,83,3818,1455,414,1257,16,76,112,1471,5,41,23,46,46,69,231,381,2,1069,59,0,2,60,5,0
74544,118,3203,1523,757,1297,19,12,193,1542,12,193,117,230,205,347,1508,2664,7,19053,1058,0,2,1,0,0
74545,118,3203,701,378,504,33,58,109,734,13,110,68,126,123,194,794,1346,7,10027,557,0,2,1,0,0
74546,114,5827,1523,757,1297,19,12,193,1542,12,193,117,230,205,347,1508,2664,7,19053,1058,0,2,42,0,0
74547,119,3209,1523,757,1297,19,12,193,1542,12,193,117,230,205,347,1508,2664,7,19053,1058,0,2,2,1,0
74548,119,3209,701,378,504,33,58,109,734,13,110,68,126,123,194,794,1346,7,10027,557,0,2,2,1,0
74608,7,458,382,65,130,157,2,92,539,4,10,5,10,14,15,41,57,2,114,6,0,2,29,1,0
74609,14,567,124,78,88,2,3,26,126,4,13,7,13,17,20,56,81,2,163,9,0,2,5,3,0
74612,88,2116,996,429,845,24,10,117,1020,7,76,50,88,83,138,494,879,4,3565,198,0,2,20,7,0
74613,88,2116,456,277,329,12,42,72,468,13,85,50,97,98,147,592,972,7,7212,400,0,2,20,7,0
74614,51,3888,996,429,845,24,10,117,1020,7,76,50,88,83,138,494,879,4,3565,198,0,2,1,0,0
74702,244,5149,2,2,2,0,0,0,2,0,0,0,0,0,0,0,0,0,0,0,0,2,52,1,0
74716,244,5149,99,48,90,1,3,5,100,0,0,0,0,0,0,0,0,0,0,0,0,2,52,1,0
74717,244,5149,8,5,5,2,0,1,10,0,0,0,0,0,0,0,0,0,0,0,0,2,52,1,0
74718,244,5149,1217,716,841,84,126,174,1301,14,185,118,215,199,333,1446,2542,8,20687,1149,0,2,52,1,0
74719,244,5149,160,89,115,0,13,31,160,7,15,11,17,22,28,78,124,3,495,27,0,2,52,1,0
74720,244,5149,10,10,9,9,0,0,19,0,0,0,0,0,0,0,0,0,0,0,0,2,52,1,0
74721,244,5149,173,84,99,8,29,36,181,5,12,7,13,17,20,54,81,2,221,12,0,2,52,1,0
74722,244,5149,3,1,1,3,0,0,6,0,0,0,0,0,0,0,0,0,0,0,0,2,52,1,0
74723,111,6090,1457,730,1242,11,6,188,1468,10,292,166,329,302,495,2424,4078,5,22973,1276,1,2,11,5,0
74748,119,3209,1523,757,1297,19,12,193,1542,12,193,117,230,205,347,1508,2664,7,19053,1058,0,2,2,0,0
74749,119,3209,701,378,504,33,58,109,734,13,110,68,126,123,194,794,1346,7,10027,557,0,2,2,0,0
74753,87,3421,1043,504,840,53,9,147,1096,9,180,112,198,189,310,1377,2344,4,11604,644,0,2,1,4,0
74754,299,6663,72,33,56,0,4,12,72,1,1,1,1,2,2,0,2,0,1,0,0,2,18,8,0
74755,299,6663,1454,835,1044,76,110,219,1530,17,275,158,296,292,454,2297,3718,9,34017,1889,1,2,18,8,0
74758,227,6379,722,423,573,19,0,135,741,12,172,101,199,184,300,1320,2257,6,15668,870,0,2,1,1,1
74759,227,6379,1508,847,911,44,250,301,1552,14,148,88,169,162,257,1120,1886,7,15077,837,0,2,1,1,1
74760,64,3325,722,423,573,19,0,135,741,12,172,101,199,184,300,1320,2257,6,15668,870,0,2,20,0,1
74761,14,367,105,62,62,2,14,27,107,4,12,8,12,16,20,51,80,2,160,8,0,3,8,2,0
74764,227,6379,722,423,573,19,0,135,741,12,172,101,199,184,300,1320,2257,6,15668,870,0,2,1,1,0
74765,227,6379,1508,847,911,44,250,301,1552,14,148,88,169,162,257,1120,1886,7,15077,837,0,2,1,1,0
74766,64,3325,722,423,573,19,0,135,741,12,172,101,199,184,300,1320,2257,6,15668,870,0,2,20,0,0
74767,189,5498,1660,832,1314,41,38,274,1701,20,312,209,395,332,604,2671,5058,12,64042,3557,1,2,6,4,0
74768,189,5498,1057,646,719,113,100,145,1170,18,215,134,248,233,382,1740,3004,10,31186,1732,1,2,6,4,0
74769,228,6397,722,423,573,19,0,135,741,12,172,101,199,184,300,1320,2257,6,15668,870,0,2,9,4,0
74770,228,6397,1508,847,911,44,250,301,1552,14,148,88,169,162,257,1120,1886,7,15077,837,0,2,9,4,0
74771,64,3340,722,423,573,19,0,135,741,12,172,101,199,184,300,1320,2257,6,15668,870,0,2,7,5,0
74777,7,458,382,65,130,157,2,92,539,4,10,5,10,14,15,41,57,2,114,6,0,2,2,2,0
74779,80,2023,466,257,367,18,25,50,484,7,126,86,171,133,257,898,1813,4,8612,478,0,2,10,4,1
74780,80,2023,507,281,342,29,59,88,536,10,53,29,57,63,86,336,514,5,2764,153,0,2,10,4,1
74781,33,2003,466,257,367,18,25,50,484,7,126,86,171,133,257,898,1813,4,8612,478,0,2,62,0,1
74782,33,2003,466,257,367,18,25,50,484,7,126,86,171,133,257,898,1813,4,8612,478,0,2,9,15,1
74783,80,2023,466,257,367,18,25,50,484,7,126,86,171,133,257,898,1813,4,8612,478,0,2,10,4,0
74784,80,2023,507,281,342,29,59,88,536,10,53,29,57,63,86,336,514,5,2764,153,0,2,10,4,0
74785,33,2003,466,257,367,18,25,50,484,7,126,86,171,133,257,898,1813,4,8612,478,0,2,56,0,0
74786,301,6450,1943,715,1694,26,18,214,1969,12,185,120,237,197,357,1436,2721,7,20915,1161,0,2,14,8,0
74787,301,6450,1168,838,957,57,25,144,1225,19,348,224,416,367,640,3018,5452,11,61921,3440,1,2,14,8,0
74788,114,6860,1943,715,1694,26,18,214,1969,12,185,120,237,197,357,1436,2721,7,20915,1161,0,2,11,0,0
74789,11,629,219,78,157,11,5,46,230,3,24,20,34,27,54,114,256,2,545,30,0,2,3,5,0
74790,37,816,167,116,138,4,5,22,171,8,48,30,56,56,86,292,499,4,2330,129,0,2,1,1,0
74791,111,6108,1457,730,1242,11,6,188,1468,10,292,166,329,302,495,2424,4078,5,22973,1276,1,2,9,9,0
74792,186,5483,182,127,129,0,0,53,182,5,39,21,42,44,63,217,343,2,926,51,0,2,1,1,1
74793,186,5483,1165,710,800,67,119,181,1232,18,243,153,282,261,435,2000,3492,10,36473,2026,1,2,1,1,1
74796,28,598,2,2,2,0,0,0,2,0,0,0,0,0,0,0,0,0,0,0,0,2,1,1,1
74810,28,598,99,48,90,1,3,5,100,0,0,0,0,0,0,0,0,0,0,0,0,2,1,1,1
74811,28,598,8,5,5,2,0,1,10,0,0,0,0,0,0,0,0,0,0,0,0,2,1,1,1
74812,28,598,1217,716,841,84,126,174,1301,14,185,118,215,199,333,1446,2542,8,20687,1149,0,2,1,1,1
74813,28,598,160,89,115,0,13,31,160,7,15,11,17,22,28,78,124,3,495,27,0,2,1,1,1
74814,28,598,10,10,9,9,0,0,19,0,0,0,0,0,0,0,0,0,0,0,0,2,1,1,1
74815,28,598,173,84,99,8,29,36,181,5,12,7,13,17,20,54,81,2,221,12,0,2,1,1,1
74816,28,598,3,1,1,3,0,0,6,0,0,0,0,0,0,0,0,0,0,0,0,2,1,1,1
74817,189,5498,1660,832,1314,41,38,274,1701,20,312,209,395,332,604,2671,5058,12,64042,3557,1,2,2,3,1
74818,189,5498,1057,646,719,113,100,145,1170,18,215,134,248,233,382,1740,3004,10,31186,1732,1,2,2,3,1
74819,53,1495,207,111,150,11,0,50,218,5,26,19,36,31,55,133,272,3,943,52,0,2,2,5,1
74820,53,1495,410,198,237,31,55,97,441,11,63,38,72,74,110,414,683,6,4293,238,0,2,2,5,1
74821,105,2773,1455,414,1257,16,76,112,1471,5,41,23,46,46,69,231,381,2,1069,59,0,2,3,1,1
74822,105,2773,669,365,481,22,61,110,691,15,103,63,122,118,185,747,1273,8,11311,628,0,2,3,1,1
74823,228,6399,722,423,573,19,0,135,741,12,172,101,199,184,300,1320,2257,6,15668,870,0,2,1,1,1
74824,228,6399,1508,847,911,44,250,301,1552,14,148,88,169,162,257,1120,1886,7,15077,837,0,2,1,1,1
74825,80,2025,466,257,367,18,25,50,484,7,126,86,171,133,257,898,1813,4,8612,478,0,2,1,1,1
74826,80,2025,507,281,342,29,59,88,536,10,53,29,57,63,86,336,514,5,2764,153,0,2,1,1,1
74827,88,1931,1043,504,840,53,9,147,1096,9,180,112,198,189,310,1377,2344,4,11604,644,0,2,1,1,1
74828,88,1931,383,288,292,26,6,62,409,11,65,38,67,76,105,429,656,5,3719,206,0,2,1,1,1
74829,100,3089,773,419,590,28,0,166,801,10,204,113,217,214,330,1598,2554,5,13587,754,0,2,2,6,1
74832,186,5483,182,127,129,0,0,53,182,5,39,21,42,44,63,217,343,2,926,51,0,2,1,1,0
74833,186,5483,1165,710,800,67,119,181,1232,18,243,153,282,261,435,2000,3492,10,36473,2026,1,2,1,1,0
74836,28,598,2,2,2,0,0,0,2,0,0,0,0,0,0,0,0,0,0,0,0,2,1,1,0
74850,28,598,99,48,90,1,3,5,100,0,0,0,0,0,0,0,0,0,0,0,0,2,1,1,0
74851,28,598,8,5,5,2,0,1,10,0,0,0,0,0,0,0,0,0,0,0,0,2,1,1,0
74852,28,598,1217,716,841,84,126,174,1301,14,185,118,215,199,333,1446,2542,8,20687,1149,0,2,1,1,0
74853,28,598,160,89,115,0,13,31,160,7,15,11,17,22,28,78,124,3,495,27,0,2,1,1,0
74854,28,598,10,10,9,9,0,0,19,0,0,0,0,0,0,0,0,0,0,0,0,2,1,1,0
74855,28,598,173,84,99,8,29,36,181,5,12,7,13,17,20,54,81,2,221,12,0,2,1,1,0
74856,28,598,3,1,1,3,0,0,6,0,0,0,0,0,0,0,0,0,0,0,0,2,1,1,0
74857,189,5498,1660,832,1314,41,38,274,1701,20,312,209,395,332,604,2671,5058,12,64042,3557,1,2,2,3,0
74858,189,5498,1057,646,719,113,100,145,1170,18,215,134,248,233,382,1740,3004,10,31186,1732,1,2,2,3,0
74859,53,1495,207,111,150,11,0,50,218,5,26,19,36,31,55,133,272,3,943,52,0,2,2,5,0
74860,53,1495,410,198,237,31,55,97,441,11,63,38,72,74,110,414,683,6,4293,238,0,2,2,5,0
74861,105,2773,1455,414,1257,16,76,112,1471,5,41,23,46,46,69,231,381,2,1069,59,0,2,3,1,0
74862,105,2773,669,365,481,22,61,110,691,15,103,63,122,118,185,747,1273,8,11311,628,0,2,3,1,0
74863,228,6399,722,423,573,19,0,135,741,12,172,101,199,184,300,1320,2257,6,15668,870,0,2,1,1,0
74864,228,6399,1508,847,911,44,250,301,1552,14,148,88,169,162,257,1120,1886,7,15077,837,0,2,1,1,0
74865,80,2025,466,257,367,18,25,50,484,7,126,86,171,133,257,898,1813,4,8612,478,0,2,1,1,0
74866,80,2025,507,281,342,29,59,88,536,10,53,29,57,63,86,336,514,5,2764,153,0,2,1,1,0
74867,88,1931,1043,504,840,53,9,147,1096,9,180,112,198,189,310,1377,2344,4,11604,644,0,2,1,1,0
74868,88,1931,383,288,292,26,6,62,409,11,65,38,67,76,105,429,656,5,3719,206,0,2,1,1,0
74869,100,3089,773,419,590,28,0,166,801,10,204,113,217,214,330,1598,2554,5,13587,754,0,2,2,6,0
74870,1,101,42,7,35,4,0,5,46,1,2,1,2,3,3,2,4,0,2,0,0,2,4,1,0
74871,1,101,11,6,10,0,0,1,11,2,4,2,4,6,6,10,15,1,15,0,0,2,4,1,0
74872,53,1495,207,111,150,11,0,50,218,5,26,19,36,31,55,133,272,3,943,52,0,2,1,1,0
74873,53,1495,410,198,237,31,55,97,441,11,63,38,72,74,110,414,683,6,4293,238,0,2,1,1,0
74875,1,92,36,13,19,2,6,9,38,1,2,1,2,3,3,2,4,0,2,0,0,0,36,0,0
74876,55,1873,53,23,39,0,0,13,53,2,8,4,8,10,12,26,39,1,39,2,0,2,1,1,0
74877,55,1873,515,298,307,33,80,99,548,12,63,44,77,75,121,419,753,7,5527,307,0,2,1,1,0
74889,26,621,207,111,150,11,0,50,218,5,26,19,36,31,55,133,272,3,943,52,0,2,9,3,0
74891,15,385,105,62,62,2,14,27,107,4,12,8,12,16,20,51,80,2,160,8,0,2,6,4,0
74893,267,6383,4293,999,3693,19,54,507,4312,9,155,88,170,164,258,1156,1898,4,9368,520,0,2,56,3,1
74894,267,6383,1482,859,1002,125,135,219,1607,16,219,134,251,235,385,1766,3032,9,27804,1544,1,2,56,3,1
74895,186,8051,4293,999,3693,19,54,507,4312,9,155,88,170,164,258,1156,1898,4,9368,520,0,2,132,0,1
74896,186,8051,1482,859,1002,125,135,219,1607,16,219,134,251,235,385,1766,3032,9,27804,1544,1,2,132,0,1
74897,267,6383,4293,999,3693,19,54,507,4312,9,155,88,170,164,258,1156,1898,4,9368,520,0,2,56,3,0
74898,267,6383,1482,859,1002,125,135,219,1607,16,219,134,251,235,385,1766,3032,9,27804,1544,1,2,56,3,0
74899,186,8051,4293,999,3693,19,54,507,4312,9,155,88,170,164,258,1156,1898,4,9368,520,0,2,132,0,0
74900,186,8051,1482,859,1002,125,135,219,1607,16,219,134,251,235,385,1766,3032,9,27804,1544,1,2,132,0,0
74901,7,464,382,65,130,157,2,92,539,4,10,5,10,14,15,41,57,2,114,6,0,2,2,1,0
74902,186,5489,182,127,129,0,0,53,182,5,39,21,42,44,63,217,343,2,926,51,0,2,2,1,0
74903,186,5489,1165,710,800,67,119,181,1232,18,243,153,282,261,435,2000,3492,10,36473,2026,1,2,2,1,0
74904,53,1517,207,111,150,11,0,50,218,5,26,19,36,31,55,133,272,3,943,52,0,2,7,1,0
74905,53,1517,410,198,237,31,55,97,441,11,63,38,72,74,110,414,683,6,4293,238,0,2,7,1,0
74908,244,5155,2,2,2,0,0,0,2,0,0,0,0,0,0,0,0,0,0,0,0,2,2,1,0
74922,244,5155,99,48,90,1,3,5,100,0,0,0,0,0,0,0,0,0,0,0,0,2,2,1,0
74923,244,5155,8,5,5,2,0,1,10,0,0,0,0,0,0,0,0,0,0,0,0,2,2,1,0
74924,244,5155,1217,716,841,84,126,174,1301,14,185,118,215,199,333,1446,2542,8,20687,1149,0,2,2,1,0
74925,244,5155,160,89,115,0,13,31,160,7,15,11,17,22,28,78,124,3,495,27,0,2,2,1,0
74926,244,5155,10,10,9,9,0,0,19,0,0,0,0,0,0,0,0,0,0,0,0,2,2,1,0
74927,244,5155,173,84,99,8,29,36,181,5,12,7,13,17,20,54,81,2,221,12,0,2,2,1,0
74928,244,5155,3,1,1,3,0,0,6,0,0,0,0,0,0,0,0,0,0,0,0,2,2,1,0
74929,37,822,167,116,138,4,5,22,171,8,48,30,56,56,86,292,499,4,2330,129,0,2,2,1,0
74930,105,2779,1455,414,1257,16,76,112,1471,5,41,23,46,46,69,231,381,2,1069,59,0,2,2,1,0
74931,105,2779,669,365,481,22,61,110,691,15,103,63,122,118,185,747,1273,8,11311,628,0,2,2,1,0
74932,267,6389,4293,999,3693,19,54,507,4312,9,155,88,170,164,258,1156,1898,4,9368,520,0,2,2,1,0
74933,267,6389,1482,859,1002,125,135,219,1607,16,219,134,251,235,385,1766,3032,9,27804,1544,1,2,2,1,0
74934,55,1879,53,23,39,0,0,13,53,2,8,4,8,10,12,26,39,1,39,2,0,2,2,1,0
74935,55,1879,515,298,307,33,80,99,548,12,63,44,77,75,121,419,753,7,5527,307,0,2,2,1,0
74936,12,575,205,80,86,16,53,53,221,7,18,10,19,25,29,94,134,3,497,27,0,2,3,1,0
74937,228,6405,722,423,573,19,0,135,741,12,172,101,199,184,300,1320,2257,6,15668,870,0,2,3,2,0
74938,228,6405,1508,847,911,44,250,301,1552,14,148,88,169,162,257,1120,1886,7,15077,837,0,2,3,2,0
74939,80,1976,757,253,292,73,244,162,830,13,61,38,67,74,105,409,651,7,4654,258,0,2,2,1,0
74940,20,995,386,256,301,16,9,68,402,4,59,35,69,63,104,355,621,2,1453,80,0,2,2,1,0
74941,20,995,264,131,164,11,41,46,275,6,38,22,40,44,62,214,338,3,1068,59,0,2,2,1,0
74942,88,1937,1043,504,840,53,9,147,1096,9,180,112,198,189,310,1377,2344,4,11604,644,0,2,2,1,0
74943,88,1937,383,288,292,26,6,62,409,11,65,38,67,76,105,429,656,5,3719,206,0,2,2,1,0
74944,2,228,37,13,25,0,6,6,37,1,2,1,2,3,3,2,4,0,2,0,0,2,2,1,0
74945,2,228,133,47,40,1,43,49,134,0,0,0,0,0,0,0,0,0,0,0,0,2,2,1,0
74946,111,6082,1457,730,1242,11,6,188,1468,10,292,166,329,302,495,2424,4078,5,22973,1276,1,2,19,25,0
74992,35,2036,466,257,367,18,25,50,484,7,126,86,171,133,257,898,1813,4,8612,478,0,2,39,12,0
74994,106,4662,1289,550,1043,56,32,155,1345,10,167,93,185,177,278,1266,2075,5,11498,638,0,2,2,2,0
74995,17,398,127,75,83,2,11,30,129,4,14,7,14,18,21,61,87,2,175,9,0,2,1,1,0
74996,17,398,652,304,544,16,6,88,668,6,89,51,101,95,152,591,998,3,3399,188,0,2,1,1,0
74997,17,398,2,2,2,0,0,0,2,0,0,0,0,0,0,0,0,0,0,0,0,2,1,1,0
74998,17,398,8,5,5,0,0,3,8,0,0,0,0,0,0,0,0,0,0,0,0,2,1,1,0
75001,17,398,14,8,8,0,0,6,14,0,0,0,0,0,0,0,0,0,0,0,0,2,1,1,0
75002,17,398,6,4,4,0,0,2,6,0,0,0,0,0,0,0,0,0,0,0,0,2,1,1,0
75003,17,398,6,4,4,0,0,2,6,1,2,1,2,3,3,2,4,0,2,0,0,2,1,1,0
75005,17,398,7,5,5,0,0,2,7,0,0,0,0,0,0,0,0,0,0,0,0,2,1,1,0
75007,17,398,10,6,6,0,0,4,10,0,0,0,0,0,0,0,0,0,0,0,0,2,1,1,0
75008,17,398,1,1,1,0,0,0,1,0,0,0,0,0,0,0,0,0,0,0,0,2,1,1,0
75010,17,398,14,10,10,0,0,4,14,1,1,1,1,2,2,0,2,0,1,0,0,2,1,1,0
75011,17,398,46,26,30,3,0,12,49,3,6,3,6,9,9,20,28,1,42,2,0,2,1,1,0
75012,42,2587,1157,318,931,29,22,177,1186,6,104,63,125,110,188,712,1274,3,4596,255,0,2,1,1,0
75013,89,3918,1338,495,1086,10,64,173,1348,11,122,82,157,133,239,883,1686,7,11934,663,0,2,5,5,0
75014,186,8049,4293,999,3693,19,54,507,4312,9,155,88,170,164,258,1156,1898,4,9368,520,0,2,2,2,0
75015,186,8049,1482,859,1002,125,135,219,1607,16,219,134,251,235,385,1766,3032,9,27804,1544,1,2,2,2,0
75016,147,5899,1782,648,1425,9,47,279,1791,8,171,97,189,179,286,1292,2140,4,9462,525,0,2,4,4,0
75017,127,5420,1450,624,1228,12,26,181,1462,14,306,186,354,320,540,2580,4493,8,36391,2021,1,2,2,2,0
75018,117,4982,1513,682,1277,25,13,200,1538,11,199,116,219,210,335,1557,2584,6,15641,868,0,2,2,2,0
75019,87,5056,1296,573,1062,40,33,157,1336,8,201,118,231,209,349,1561,2689,4,12365,686,0,2,3,3,0
75020,46,2848,652,304,544,16,6,88,668,6,89,51,101,95,152,591,998,3,3399,188,0,2,1,1,0
75021,8,308,103,47,73,2,12,15,105,5,16,9,17,21,26,75,114,2,303,16,0,2,1,1,0
75022,8,267,74,35,59,1,0,14,75,3,14,7,14,17,21,58,85,1,128,7,0,2,1,1,0
75023,71,3197,1020,354,843,12,15,144,1032,8,134,77,144,142,221,970,1580,4,6792,377,0,2,1,1,0
75024,38,2311,334,251,279,10,4,40,344,5,127,74,143,132,217,899,1528,2,4303,239,0,2,2,2,0
75025,79,4224,1293,570,1093,25,15,163,1318,10,195,123,241,205,364,1516,2795,6,17273,959,0,2,3,3,0
75026,30,1922,384,251,317,7,8,52,391,11,70,44,84,81,128,467,811,6,5355,297,0,2,1,1,0
75027,114,6854,1943,715,1694,26,18,214,1969,12,185,120,237,197,357,1436,2721,7,20915,1161,0,2,3,3,0
75062,14,566,124,78,88,2,3,26,126,4,13,7,13,17,20,56,81,2,163,9,0,2,1,1,0
75063,228,6419,722,423,573,19,0,135,741,12,172,101,199,184,300,1320,2257,6,15668,870,0,2,6,2,0
75064,228,6419,1508,847,911,44,250,301,1552,14,148,88,169,162,257,1120,1886,7,15077,837,0,2,6,2,0
75070,267,6395,4293,999,3693,19,54,507,4312,9,155,88,170,164,258,1156,1898,4,9368,520,0,2,1,1,0
75071,267,6395,1482,859,1002,125,135,219,1607,16,219,134,251,235,385,1766,3032,9,27804,1544,1,2,1,1,0
75072,55,1888,53,23,39,0,0,13,53,2,8,4,8,10,12,26,39,1,39,2,0,2,1,1,0
75073,55,1888,515,298,307,33,80,99,548,12,63,44,77,75,121,419,753,7,5527,307,0,2,1,1,0
75074,80,2027,466,257,367,18,25,50,484,7,126,86,171,133,257,898,1813,4,8612,478,0,2,1,1,0
75075,80,2027,507,281,342,29,59,88,536,10,53,29,57,63,86,336,514,5,2764,153,0,2,1,1,0
75082,262,6273,4293,999,3693,19,54,507,4312,9,155,88,170,164,258,1156,1898,4,9368,520,0,2,3,56,0
75083,262,6273,1482,859,1002,125,135,219,1607,16,219,134,251,235,385,1766,3032,9,27804,1544,1,2,3,56,0
75084,185,8003,4293,999,3693,19,54,507,4312,9,155,88,170,164,258,1156,1898,4,9368,520,0,2,0,132,0
75085,185,8003,1482,859,1002,125,135,219,1607,16,219,134,251,235,385,1766,3032,9,27804,1544,1,2,0,132,0
75086,117,4992,1513,682,1277,25,13,200,1538,11,199,116,219,210,335,1557,2584,6,15641,868,0,2,2,0,0
75087,115,6857,1943,715,1694,26,18,214,1969,12,185,120,237,197,357,1436,2721,7,20915,1161,0,2,17,15,0
75090,118,7014,1943,715,1694,26,18,214,1969,12,185,120,237,197,357,1436,2721,7,20915,1161,0,2,65,4,0
75092,143,6921,1392,870,1177,35,17,170,1427,14,494,280,531,508,811,4473,7289,7,54850,3047,2,2,0,2,0
75093,145,3560,77,34,69,0,0,8,77,3,24,16,29,27,45,114,213,1,387,21,0,2,4,0,0
75094,145,3560,712,438,573,51,9,84,763,14,102,71,128,116,199,733,1364,8,11988,666,0,2,4,0,0
75095,55,1890,53,23,39,0,0,13,53,2,8,4,8,10,12,26,39,1,39,2,0,2,1,1,0
75096,55,1890,515,298,307,33,80,99,548,12,63,44,77,75,121,419,753,7,5527,307,0,2,1,1,0
75097,186,5549,182,127,129,0,0,53,182,5,39,21,42,44,63,217,343,2,926,51,0,2,10,10,0
75098,186,5549,1165,710,800,67,119,181,1232,18,243,153,282,261,435,2000,3492,10,36473,2026,1,2,10,10,0
75099,105,2787,1455,414,1257,16,76,112,1471,5,41,23,46,46,69,231,381,2,1069,59,0,2,3,1,0
75100,105,2787,669,365,481,22,61,110,691,15,103,63,122,118,185,747,1273,8,11311,628,0,2,3,1,0
75101,267,6401,4293,999,3693,19,54,507,4312,9,155,88,170,164,258,1156,1898,4,9368,520,0,2,1,1,0
75102,267,6401,1482,859,1002,125,135,219,1607,16,219,134,251,235,385,1766,3032,9,27804,1544,1,2,1,1,0
75103,143,6949,1392,870,1177,35,17,170,1427,14,494,280,531,508,811,4473,7289,7,54850,3047,2,2,1,1,0
75105,186,5491,182,127,129,0,0,53,182,5,39,21,42,44,63,217,343,2,926,51,0,2,1,1,0
75106,186,5491,1165,710,800,67,119,181,1232,18,243,153,282,261,435,2000,3492,10,36473,2026,1,2,1,1,0
75107,88,1967,1043,504,840,53,9,147,1096,9,180,112,198,189,310,1377,2344,4,11604,644,0,2,7,2,0
75108,88,1967,383,288,292,26,6,62,409,11,65,38,67,76,105,429,656,5,3719,206,0,2,7,2,0
75113,53,1523,207,111,150,11,0,50,218,5,26,19,36,31,55,133,272,3,943,52,0,2,4,2,0
75114,53,1523,410,198,237,31,55,97,441,11,63,38,72,74,110,414,683,6,4293,238,0,2,4,2,0
75115,37,822,167,116,138,4,5,22,171,8,48,30,56,56,86,292,499,4,2330,129,0,2,3,1,0
75116,186,5551,182,127,129,0,0,53,182,5,39,21,42,44,63,217,343,2,926,51,0,2,10,10,0
75117,186,5551,1165,710,800,67,119,181,1232,18,243,153,282,261,435,2000,3492,10,36473,2026,1,2,10,10,0
75126,143,6927,1392,870,1177,35,17,170,1427,14,494,280,531,508,811,4473,7289,7,54850,3047,2,2,1,1,0
75130,113,2328,463,295,324,28,62,57,491,12,134,82,154,146,236,989,1696,6,11700,650,0,2,4,4,1
75131,37,865,167,116,138,4,5,22,171,8,48,30,56,56,86,292,499,4,2330,129,0,2,5,2,1
75132,105,2791,1455,414,1257,16,76,112,1471,5,41,23,46,46,69,231,381,2,1069,59,0,2,1,1,1
75133,105,2791,669,365,481,22,61,110,691,15,103,63,122,118,185,747,1273,8,11311,628,0,2,1,1,1
75134,267,6409,4293,999,3693,19,54,507,4312,9,155,88,170,164,258,1156,1898,4,9368,520,0,2,7,4,1
75135,267,6409,1482,859,1002,125,135,219,1607,16,219,134,251,235,385,1766,3032,9,27804,1544,1,2,7,4,1
75136,145,3575,77,34,69,0,0,8,77,3,24,16,29,27,45,114,213,1,387,21,0,2,4,4,1
75137,145,3575,712,438,573,51,9,84,763,14,102,71,128,116,199,733,1364,8,11988,666,0,2,4,4,1
75138,55,1909,53,23,39,0,0,13,53,2,8,4,8,10,12,26,39,1,39,2,0,2,1,0,1
75139,55,1909,515,298,307,33,80,99,548,12,63,44,77,75,121,419,753,7,5527,307,0,2,1,0,1
75140,89,3918,1338,495,1086,10,64,173,1348,11,122,82,157,133,239,883,1686,7,11934,663,0,2,3,3,1
75141,113,2328,463,295,324,28,62,57,491,12,134,82,154,146,236,989,1696,6,11700,650,0,2,4,4,0
75142,37,865,167,116,138,4,5,22,171,8,48,30,56,56,86,292,499,4,2330,129,0,2,5,2,0
75143,105,2791,1455,414,1257,16,76,112,1471,5,41,23,46,46,69,231,381,2,1069,59,0,2,1,1,0
75144,105,2791,669,365,481,22,61,110,691,15,103,63,122,118,185,747,1273,8,11311,628,0,2,1,1,0
75145,267,6409,4293,999,3693,19,54,507,4312,9,155,88,170,164,258,1156,1898,4,9368,520,0,2,7,4,0
75146,267,6409,1482,859,1002,125,135,219,1607,16,219,134,251,235,385,1766,3032,9,27804,1544,1,2,7,4,0
75147,145,3575,77,34,69,0,0,8,77,3,24,16,29,27,45,114,213,1,387,21,0,2,4,4,0
75148,145,3575,712,438,573,51,9,84,763,14,102,71,128,116,199,733,1364,8,11988,666,0,2,4,4,0
75149,55,1909,53,23,39,0,0,13,53,2,8,4,8,10,12,26,39,1,39,2,0,2,1,0,0
75150,55,1909,515,298,307,33,80,99,548,12,63,44,77,75,121,419,753,7,5527,307,0,2,1,0,0
75151,89,3918,1338,495,1086,10,64,173,1348,11,122,82,157,133,239,883,1686,7,11934,663,0,2,3,3,0
75152,59,1750,773,419,590,28,0,166,801,10,204,113,217,214,330,1598,2554,5,13587,754,0,2,2,3,0
75153,59,1750,421,273,302,44,34,57,465,17,81,59,107,98,166,583,1098,11,12329,684,0,2,2,3,0
75154,186,5566,182,127,129,0,0,53,182,5,39,21,42,44,63,217,343,2,926,51,0,2,2,2,1
75155,186,5566,1165,710,800,67,119,181,1232,18,243,153,282,261,435,2000,3492,10,36473,2026,1,2,2,2,1
75156,62,2102,773,419,590,28,0,166,801,10,204,113,217,214,330,1598,2554,5,13587,754,0,2,68,9,1
75157,62,2102,421,273,302,44,34,57,465,17,81,59,107,98,166,583,1098,11,12329,684,0,2,68,9,1
75158,102,3170,773,419,590,28,0,166,801,10,204,113,217,214,330,1598,2554,5,13587,754,0,2,16,0,1
75159,64,3430,722,423,573,19,0,135,741,12,172,101,199,184,300,1320,2257,6,15668,870,0,2,69,65,1
75160,20,1004,386,256,301,16,9,68,402,4,59,35,69,63,104,355,621,2,1453,80,0,2,3,3,0
75161,20,1004,264,131,164,11,41,46,275,6,38,22,40,44,62,214,338,3,1068,59,0,2,3,3,0
75162,46,1995,386,256,301,16,9,68,402,4,59,35,69,63,104,355,621,2,1453,80,0,2,61,57,0
75163,81,2060,466,257,367,18,25,50,484,7,126,86,171,133,257,898,1813,4,8612,478,0,2,8,1,0
75164,81,2060,507,281,342,29,59,88,536,10,53,29,57,63,86,336,514,5,2764,153,0,2,8,1,0
75165,87,3572,1043,504,840,53,9,147,1096,9,180,112,198,189,310,1377,2344,4,11604,644,0,2,95,74,0
75166,186,5566,182,127,129,0,0,53,182,5,39,21,42,44,63,217,343,2,926,51,0,2,2,2,0
75167,186,5566,1165,710,800,67,119,181,1232,18,243,153,282,261,435,2000,3492,10,36473,2026,1,2,2,2,0
75168,62,2102,773,419,590,28,0,166,801,10,204,113,217,214,330,1598,2554,5,13587,754,0,2,70,12,0
75169,62,2102,421,273,302,44,34,57,465,17,81,59,107,98,166,583,1098,11,12329,684,0,2,70,12,0
75174,102,3170,773,419,590,28,0,166,801,10,204,113,217,214,330,1598,2554,5,13587,754,0,2,16,0,0
75175,64,3430,722,423,573,19,0,135,741,12,172,101,199,184,300,1320,2257,6,15668,870,0,2,69,65,0
75178,262,6287,4293,999,3693,19,54,507,4312,9,155,88,170,164,258,1156,1898,4,9368,520,0,2,3,56,0
75179,262,6287,1482,859,1002,125,135,219,1607,16,219,134,251,235,385,1766,3032,9,27804,1544,1,2,3,56,0
75183,37,822,167,116,138,4,5,22,171,8,48,30,56,56,86,292,499,4,2330,129,0,2,2,5,0
75184,105,2787,1455,414,1257,16,76,112,1471,5,41,23,46,46,69,231,381,2,1069,59,0,2,1,1,0
75185,105,2787,669,365,481,22,61,110,691,15,103,63,122,118,185,747,1273,8,11311,628,0,2,1,1,0
75186,262,6279,4293,999,3693,19,54,507,4312,9,155,88,170,164,258,1156,1898,4,9368,520,0,2,4,7,0
75187,262,6279,1482,859,1002,125,135,219,1607,16,219,134,251,235,385,1766,3032,9,27804,1544,1,2,4,7,0
75188,145,3560,77,34,69,0,0,8,77,3,24,16,29,27,45,114,213,1,387,21,0,2,4,4,0
75189,145,3560,712,438,573,51,9,84,763,14,102,71,128,116,199,733,1364,8,11988,666,0,2,4,4,0
75190,55,1890,53,23,39,0,0,13,53,2,8,4,8,10,12,26,39,1,39,2,0,2,0,1,0
75191,55,1890,515,298,307,33,80,99,548,12,63,44,77,75,121,419,753,7,5527,307,0,2,0,1,0
75193,22,666,424,94,331,4,0,89,428,1,5,5,5,6,10,11,25,0,12,0,0,2,14,0,0
75206,186,5566,182,127,129,0,0,53,182,5,39,21,42,44,63,217,343,2,926,51,0,2,3,2,0
75207,186,5566,1165,710,800,67,119,181,1232,18,243,153,282,261,435,2000,3492,10,36473,2026,1,2,3,2,0
75208,62,2105,773,419,590,28,0,166,801,10,204,113,217,214,330,1598,2554,5,13587,754,0,2,1,1,1
75209,62,2105,421,273,302,44,34,57,465,17,81,59,107,98,166,583,1098,11,12329,684,0,2,1,1,1
75212,51,3916,996,429,845,24,10,117,1020,7,76,50,88,83,138,494,879,4,3565,198,0,2,2,0,0
75214,228,6422,722,423,573,19,0,135,741,12,172,101,199,184,300,1320,2257,6,15668,870,0,2,2,0,0
75215,228,6422,1508,847,911,44,250,301,1552,14,148,88,169,162,257,1120,1886,7,15077,837,0,2,2,0,0
75216,64,3443,722,423,573,19,0,135,741,12,172,101,199,184,300,1320,2257,6,15668,870,0,2,3,1,0
75217,87,3578,1043,504,840,53,9,147,1096,9,180,112,198,189,310,1377,2344,4,11604,644,0,2,8,6,0
75222,145,3599,77,34,69,0,0,8,77,3,24,16,29,27,45,114,213,1,387,21,0,2,16,5,0
75223,145,3599,712,438,573,51,9,84,763,14,102,71,128,116,199,733,1364,8,11988,666,0,2,16,5,0
75226,22,703,424,94,331,4,0,89,428,1,5,5,5,6,10,11,25,0,12,0,0,2,33,3,0
75231,262,6287,4293,999,3693,19,54,507,4312,9,155,88,170,164,258,1156,1898,4,9368,520,0,2,7,4,1
75232,262,6287,1482,859,1002,125,135,219,1607,16,219,134,251,235,385,1766,3032,9,27804,1544,1,2,7,4,1
75233,145,3614,77,34,69,0,0,8,77,3,24,16,29,27,45,114,213,1,387,21,0,2,4,4,1
75234,145,3614,712,438,573,51,9,84,763,14,102,71,128,116,199,733,1364,8,11988,666,0,2,4,4,1
75237,56,1916,53,23,39,0,0,13,53,2,8,4,8,10,12,26,39,1,39,2,0,2,4,2,0
75238,56,1916,515,298,307,33,80,99,548,12,63,44,77,75,121,419,753,7,5527,307,0,2,4,2,0
75239,22,710,424,94,331,4,0,89,428,1,5,5,5,6,10,11,25,0,12,0,0,2,4,1,0
75240,53,1539,207,111,150,11,0,50,218,5,26,19,36,31,55,133,272,3,943,52,0,2,1,1,0
75241,53,1539,410,198,237,31,55,97,441,11,63,38,72,74,110,414,683,6,4293,238,0,2,1,1,0
75242,299,6679,72,33,56,0,4,12,72,1,1,1,1,2,2,0,2,0,1,0,0,2,6,4,0
75243,299,6679,1454,835,1044,76,110,219,1530,17,275,158,296,292,454,2297,3718,9,34017,1889,1,2,6,4,0
75244,114,5837,1523,757,1297,19,12,193,1542,12,193,117,230,205,347,1508,2664,7,19053,1058,0,2,2,1,0
75246,89,3913,1338,495,1086,10,64,173,1348,11,122,82,157,133,239,883,1686,7,11934,663,0,2,5,5,0
75247,127,5419,1450,624,1228,12,26,181,1462,14,306,186,354,320,540,2580,4493,8,36391,2021,1,2,1,1,0
75248,51,3915,996,429,845,24,10,117,1020,7,76,50,88,83,138,494,879,4,3565,198,0,2,1,1,0
75249,114,5832,1523,757,1297,19,12,193,1542,12,193,117,230,205,347,1508,2664,7,19053,1058,0,2,4,4,0
75250,30,1920,384,251,317,7,8,52,391,11,70,44,84,81,128,467,811,6,5355,297,0,2,1,1,0
75256,112,6130,1457,730,1242,11,6,188,1468,10,292,166,329,302,495,2424,4078,5,22973,1276,1,2,26,0,0
75320,300,6694,72,33,56,0,4,12,72,1,1,1,1,2,2,0,2,0,1,0,0,2,6,1,0
75321,300,6694,1454,835,1044,76,110,219,1530,17,275,158,296,292,454,2297,3718,9,34017,1889,1,2,6,1,0
75322,62,2105,773,419,590,28,0,166,801,10,204,113,217,214,330,1598,2554,5,13587,754,0,2,1,1,0
75323,62,2105,421,273,302,44,34,57,465,17,81,59,107,98,166,583,1098,11,12329,684,0,2,1,1,0
75387,56,1923,53,23,39,0,0,13,53,2,8,4,8,10,12,26,39,1,39,2,0,2,6,5,0
75388,56,1923,515,298,307,33,80,99,548,12,63,44,77,75,121,419,753,7,5527,307,0,2,6,5,0
75395,262,6287,4293,999,3693,19,54,507,4312,9,155,88,170,164,258,1156,1898,4,9368,520,0,2,7,4,0
75396,262,6287,1482,859,1002,125,135,219,1607,16,219,134,251,235,385,1766,3032,9,27804,1544,1,2,7,4,0
75397,145,3614,77,34,69,0,0,8,77,3,24,16,29,27,45,114,213,1,387,21,0,2,4,4,0
75398,145,3614,712,438,573,51,9,84,763,14,102,71,128,116,199,733,1364,8,11988,666,0,2,4,4,0
75399,56,1923,53,23,39,0,0,13,53,2,8,4,8,10,12,26,39,1,39,2,0,2,6,2,0
75400,56,1923,515,298,307,33,80,99,548,12,63,44,77,75,121,419,753,7,5527,307,0,2,6,2,0
75401,300,6694,72,33,56,0,4,12,72,1,1,1,1,2,2,0,2,0,1,0,0,2,12,5,0
75402,300,6694,1454,835,1044,76,110,219,1530,17,275,158,296,292,454,2297,3718,9,34017,1889,1,2,12,5,0
75403,22,710,424,94,331,4,0,89,428,1,5,5,5,6,10,11,25,0,12,0,0,2,37,4,0
75404,186,5528,182,127,129,0,0,53,182,5,39,21,42,44,63,217,343,2,926,51,0,2,12,11,0
75405,186,5528,1165,710,800,67,119,181,1232,18,243,153,282,261,435,2000,3492,10,36473,2026,1,2,12,11,0
75429,88,2118,996,429,845,24,10,117,1020,7,76,50,88,83,138,494,879,4,3565,198,0,2,2,1,0
75430,88,2118,456,277,329,12,42,72,468,13,85,50,97,98,147,592,972,7,7212,400,0,2,2,1,0
75433,244,5153,2,2,2,0,0,0,2,0,0,0,0,0,0,0,0,0,0,0,0,2,5,4,0
75447,244,5153,99,48,90,1,3,5,100,0,0,0,0,0,0,0,0,0,0,0,0,2,5,4,0
75448,244,5153,8,5,5,2,0,1,10,0,0,0,0,0,0,0,0,0,0,0,0,2,5,4,0
75449,244,5153,1217,716,841,84,126,174,1301,14,185,118,215,199,333,1446,2542,8,20687,1149,0,2,5,4,0
75450,244,5153,160,89,115,0,13,31,160,7,15,11,17,22,28,78,124,3,495,27,0,2,5,4,0
75451,244,5153,10,10,9,9,0,0,19,0,0,0,0,0,0,0,0,0,0,0,0,2,5,4,0
75452,244,5153,173,84,99,8,29,36,181,5,12,7,13,17,20,54,81,2,221,12,0,2,5,4,0
75453,244,5153,3,1,1,3,0,0,6,0,0,0,0,0,0,0,0,0,0,0,0,2,5,4,0
75454,105,2795,1455,414,1257,16,76,112,1471,5,41,23,46,46,69,231,381,2,1069,59,0,2,3,2,0
75455,105,2795,669,365,481,22,61,110,691,15,103,63,122,118,185,747,1273,8,11311,628,0,2,3,2,0
75456,262,6289,4293,999,3693,19,54,507,4312,9,155,88,170,164,258,1156,1898,4,9368,520,0,2,2,1,0
75457,262,6289,1482,859,1002,125,135,219,1607,16,219,134,251,235,385,1766,3032,9,27804,1544,1,2,2,1,0
75458,81,2062,466,257,367,18,25,50,484,7,126,86,171,133,257,898,1813,4,8612,478,0,2,2,1,0
75459,81,2062,507,281,342,29,59,88,536,10,53,29,57,63,86,336,514,5,2764,153,0,2,2,1,0
75460,143,6921,1392,870,1177,35,17,170,1427,14,494,280,531,508,811,4473,7289,7,54850,3047,2,2,4,3,0
75461,3,495,149,67,118,4,0,27,153,1,17,14,28,18,42,69,175,0,144,8,0,2,3,4,0
75520,144,7018,1392,870,1177,35,17,170,1427,14,494,280,531,508,811,4473,7289,7,54850,3047,2,2,33,7,0
75521,186,8037,4293,999,3693,19,54,507,4312,9,155,88,170,164,258,1156,1898,4,9368,520,0,2,35,0,0
75522,186,8037,1482,859,1002,125,135,219,1607,16,219,134,251,235,385,1766,3032,9,27804,1544,1,2,35,0,0
75526,161,3439,1513,682,1277,25,13,200,1538,11,199,116,219,210,335,1557,2584,6,15641,868,0,2,1,1,0
75527,161,3439,819,519,539,24,98,155,843,15,96,57,106,111,163,690,1107,8,9171,509,0,2,1,1,0
75528,118,5010,1513,682,1277,25,13,200,1538,11,199,116,219,210,335,1557,2584,6,15641,868,0,2,5,0,0
75532,145,3612,77,34,69,0,0,8,77,3,24,16,29,27,45,114,213,1,387,21,0,2,2,2,0
75533,145,3612,712,438,573,51,9,84,763,14,102,71,128,116,199,733,1364,8,11988,666,0,2,2,2,0
75537,145,3620,77,34,69,0,0,8,77,3,24,16,29,27,45,114,213,1,387,21,0,2,1,1,0
75538,145,3620,712,438,573,51,9,84,763,14,102,71,128,116,199,733,1364,8,11988,666,0,2,1,1,0
75539,300,6703,72,33,56,0,4,12,72,1,1,1,1,2,2,0,2,0,1,0,0,2,2,2,0
75540,300,6703,1454,835,1044,76,110,219,1530,17,275,158,296,292,454,2297,3718,9,34017,1889,1,2,2,2,0
75541,162,3459,1513,682,1277,25,13,200,1538,11,199,116,219,210,335,1557,2584,6,15641,868,0,2,3,3,1
75542,162,3459,819,519,539,24,98,155,843,15,96,57,106,111,163,690,1107,8,9171,509,0,2,3,3,1
75543,119,5094,1513,682,1277,25,13,200,1538,11,199,116,219,210,335,1557,2584,6,15641,868,0,2,12,0,1
75545,300,6695,72,33,56,0,4,12,72,1,1,1,1,2,2,0,2,0,1,0,0,2,12,4,0
75546,300,6695,1454,835,1044,76,110,219,1530,17,275,158,296,292,454,2297,3718,9,34017,1889,1,2,12,4,0
75547,300,6695,72,33,56,0,4,12,72,1,1,1,1,2,2,0,2,0,1,0,0,2,1,1,0
75548,300,6695,1454,835,1044,76,110,219,1530,17,275,158,296,292,454,2297,3718,9,34017,1889,1,2,1,1,0
75549,137,3410,77,34,69,0,0,8,77,3,24,16,29,27,45,114,213,1,387,21,0,2,1,38,0
75550,137,3410,712,438,573,51,9,84,763,14,102,71,128,116,199,733,1364,8,11988,666,0,2,1,38,0
75551,65,2152,53,23,39,0,0,13,53,2,8,4,8,10,12,26,39,1,39,2,0,2,41,0,0
75552,65,2152,515,298,307,33,80,99,548,12,63,44,77,75,121,419,753,7,5527,307,0,2,41,0,0
75553,294,6553,72,33,56,0,4,12,72,1,1,1,1,2,2,0,2,0,1,0,0,2,1,26,0
75554,294,6553,1454,835,1044,76,110,219,1530,17,275,158,296,292,454,2297,3718,9,34017,1889,1,2,1,26,0
75556,162,3473,1513,682,1277,25,13,200,1538,11,199,116,219,210,335,1557,2584,6,15641,868,0,2,7,8,1
75557,162,3473,819,519,539,24,98,155,843,15,96,57,106,111,163,690,1107,8,9171,509,0,2,7,8,1
75558,119,5100,1513,682,1277,25,13,200,1538,11,199,116,219,210,335,1557,2584,6,15641,868,0,2,2,1,1
75559,119,5113,1513,682,1277,25,13,200,1538,11,199,116,219,210,335,1557,2584,6,15641,868,0,2,2,1,0
75560,119,7063,1943,715,1694,26,18,214,1969,12,185,120,237,197,357,1436,2721,7,20915,1161,0,2,9,0,0
75561,162,3471,1513,682,1277,25,13,200,1538,11,199,116,219,210,335,1557,2584,6,15641,868,0,2,7,7,0
75562,162,3471,819,519,539,24,98,155,843,15,96,57,106,111,163,690,1107,8,9171,509,0,2,7,7,0
75563,66,3522,722,423,573,19,0,135,741,12,172,101,199,184,300,1320,2257,6,15668,870,0,2,10,0,0
75565,137,3416,77,34,69,0,0,8,77,3,24,16,29,27,45,114,213,1,387,21,0,2,1,1,0
75566,137,3416,712,438,573,51,9,84,763,14,102,71,128,116,199,733,1364,8,11988,666,0,2,1,1,0
75567,65,2176,53,23,39,0,0,13,53,2,8,4,8,10,12,26,39,1,39,2,0,2,6,3,0
75568,65,2176,515,298,307,33,80,99,548,12,63,44,77,75,121,419,753,7,5527,307,0,2,6,3,0
75569,294,6559,72,33,56,0,4,12,72,1,1,1,1,2,2,0,2,0,1,0,0,2,1,1,0
75570,294,6559,1454,835,1044,76,110,219,1530,17,275,158,296,292,454,2297,3718,9,34017,1889,1,2,1,1,0
75571,162,3471,1513,682,1277,25,13,200,1538,11,199,116,219,210,335,1557,2584,6,15641,868,0,2,11,12,0
75572,162,3471,819,519,539,24,98,155,843,15,96,57,106,111,163,690,1107,8,9171,509,0,2,11,12,0
75573,119,5113,1513,682,1277,25,13,200,1538,11,199,116,219,210,335,1557,2584,6,15641,868,0,2,15,1,0
75574,228,6434,722,423,573,19,0,135,741,12,172,101,199,184,300,1320,2257,6,15668,870,0,2,4,3,0
75575,228,6434,1508,847,911,44,250,301,1552,14,148,88,169,162,257,1120,1886,7,15077,837,0,2,4,3,0
75576,225,6470,722,423,573,19,0,135,741,12,172,101,199,184,300,1320,2257,6,15668,870,0,2,10,3,0
75577,225,6470,1508,847,911,44,250,301,1552,14,148,88,169,162,257,1120,1886,7,15077,837,0,2,10,3,0
75580,244,5157,2,2,2,0,0,0,2,0,0,0,0,0,0,0,0,0,0,0,0,2,7,0,0
75594,244,5157,99,48,90,1,3,5,100,0,0,0,0,0,0,0,0,0,0,0,0,2,7,0,0
75595,244,5157,8,5,5,2,0,1,10,0,0,0,0,0,0,0,0,0,0,0,0,2,7,0,0
75596,244,5157,1217,716,841,84,126,174,1301,14,185,118,215,199,333,1446,2542,8,20687,1149,0,2,7,0,0
75597,244,5157,160,89,115,0,13,31,160,7,15,11,17,22,28,78,124,3,495,27,0,2,7,0,0
75598,244,5157,10,10,9,9,0,0,19,0,0,0,0,0,0,0,0,0,0,0,0,2,7,0,0
75599,244,5157,173,84,99,8,29,36,181,5,12,7,13,17,20,54,81,2,221,12,0,2,7,0,0
75600,244,5157,3,1,1,3,0,0,6,0,0,0,0,0,0,0,0,0,0,0,0,2,7,0,0
75601,225,6476,722,423,573,19,0,135,741,12,172,101,199,184,300,1320,2257,6,15668,870,0,2,2,1,0
75602,225,6476,1508,847,911,44,250,301,1552,14,148,88,169,162,257,1120,1886,7,15077,837,0,2,2,1,0
75603,87,5086,1296,573,1062,40,33,157,1336,8,201,118,231,209,349,1561,2689,4,12365,686,0,2,8,4,0
75627,225,6476,722,423,573,19,0,135,741,12,172,101,199,184,300,1320,2257,6,15668,870,0,2,14,5,0
75628,225,6476,1508,847,911,44,250,301,1552,14,148,88,169,162,257,1120,1886,7,15077,837,0,2,14,5,0
75630,80,1976,757,253,292,73,244,162,830,13,61,38,67,74,105,409,651,7,4654,258,0,2,1,1,0
75631,186,5527,182,127,129,0,0,53,182,5,39,21,42,44,63,217,343,2,926,51,0,2,2,3,0
75632,186,5527,1165,710,800,67,119,181,1232,18,243,153,282,261,435,2000,3492,10,36473,2026,1,2,2,3,0
75636,120,7094,1943,715,1694,26,18,214,1969,12,185,120,237,197,357,1436,2721,7,20915,1161,0,2,14,7,0
75637,262,6283,4293,999,3693,19,54,507,4312,9,155,88,170,164,258,1156,1898,4,9368,520,0,2,3,2,0
75638,262,6283,1482,859,1002,125,135,219,1607,16,219,134,251,235,385,1766,3032,9,27804,1544,1,2,3,2,0
75639,186,8102,4293,999,3693,19,54,507,4312,9,155,88,170,164,258,1156,1898,4,9368,520,0,2,18,1,0
75640,186,8102,1482,859,1002,125,135,219,1607,16,219,134,251,235,385,1766,3032,9,27804,1544,1,2,18,1,0
75641,262,6280,4293,999,3693,19,54,507,4312,9,155,88,170,164,258,1156,1898,4,9368,520,0,2,1,2,0
75642,262,6280,1482,859,1002,125,135,219,1607,16,219,134,251,235,385,1766,3032,9,27804,1544,1,2,1,2,0
75643,51,1103,447,308,343,6,5,95,453,7,96,59,111,103,170,651,1136,4,4600,255,0,2,2,1,0
75644,51,1103,322,174,179,16,74,51,338,10,41,26,46,51,72,252,408,5,2291,127,0,2,2,1,0
75645,262,6289,4293,999,3693,19,54,507,4312,9,155,88,170,164,258,1156,1898,4,9368,520,0,2,3,1,0
75646,262,6289,1482,859,1002,125,135,219,1607,16,219,134,251,235,385,1766,3032,9,27804,1544,1,2,3,1,0
75647,187,8092,4293,999,3693,19,54,507,4312,9,155,88,170,164,258,1156,1898,4,9368,520,0,2,32,0,0
75648,187,8092,1482,859,1002,125,135,219,1607,16,219,134,251,235,385,1766,3032,9,27804,1544,1,2,32,0,0
75649,262,6280,4293,999,3693,19,54,507,4312,9,155,88,170,164,258,1156,1898,4,9368,520,0,2,4,4,0
75650,262,6280,1482,859,1002,125,135,219,1607,16,219,134,251,235,385,1766,3032,9,27804,1544,1,2,4,4,0
75655,262,6280,4293,999,3693,19,54,507,4312,9,155,88,170,164,258,1156,1898,4,9368,520,0,2,3,1,0
75656,262,6280,1482,859,1002,125,135,219,1607,16,219,134,251,235,385,1766,3032,9,27804,1544,1,2,3,1,0
75657,187,8157,4293,999,3693,19,54,507,4312,9,155,88,170,164,258,1156,1898,4,9368,520,0,2,32,0,0
75658,187,8157,1482,859,1002,125,135,219,1607,16,219,134,251,235,385,1766,3032,9,27804,1544,1,2,32,0,0
75660,33,1148,182,127,129,0,0,53,182,5,39,21,42,44,63,217,343,2,926,51,0,2,33,0,0
75661,100,3049,773,419,590,28,0,166,801,10,204,113,217,214,330,1598,2554,5,13587,754,0,2,0,30,0
75662,33,1151,182,127,129,0,0,53,182,5,39,21,42,44,63,217,343,2,926,51,0,2,1,1,0
75664,33,1151,182,127,129,0,0,53,182,5,39,21,42,44,63,217,343,2,926,51,0,2,33,0,0
75666,33,1085,182,127,129,0,0,53,182,5,39,21,42,44,63,217,343,2,926,51,0,2,24,23,0
75667,15,391,105,62,62,2,14,27,107,4,12,8,12,16,20,51,80,2,160,8,0,2,1,1,0
75670,31,944,182,127,129,0,0,53,182,5,39,21,42,44,63,217,343,2,926,51,0,2,0,33,0
75671,102,3186,773,419,590,28,0,166,801,10,204,113,217,214,330,1598,2554,5,13587,754,0,2,31,1,0
75672,15,391,105,62,62,2,14,27,107,4,12,8,12,16,20,51,80,2,160,8,0,2,3,1,0
75676,137,3416,77,34,69,0,0,8,77,3,24,16,29,27,45,114,213,1,387,21,0,2,2,39,0
75677,137,3416,712,438,573,51,9,84,763,14,102,71,128,116,199,733,1364,8,11988,666,0,2,2,39,0
75678,65,2176,53,23,39,0,0,13,53,2,8,4,8,10,12,26,39,1,39,2,0,2,44,0,0
75679,65,2176,515,298,307,33,80,99,548,12,63,44,77,75,121,419,753,7,5527,307,0,2,44,0,0
75680,294,6559,72,33,56,0,4,12,72,1,1,1,1,2,2,0,2,0,1,0,0,2,14,31,0
75681,294,6559,1454,835,1044,76,110,219,1530,17,275,158,296,292,454,2297,3718,9,34017,1889,1,2,14,31,0
75684,28,617,2,2,2,0,0,0,2,0,0,0,0,0,0,0,0,0,0,0,0,2,5,1,0
75698,28,617,99,48,90,1,3,5,100,0,0,0,0,0,0,0,0,0,0,0,0,2,5,1,0
75699,28,617,8,5,5,2,0,1,10,0,0,0,0,0,0,0,0,0,0,0,0,2,5,1,0
75700,28,617,1217,716,841,84,126,174,1301,14,185,118,215,199,333,1446,2542,8,20687,1149,0,2,5,1,0
75701,28,617,160,89,115,0,13,31,160,7,15,11,17,22,28,78,124,3,495,27,0,2,5,1,0
75702,28,617,10,10,9,9,0,0,19,0,0,0,0,0,0,0,0,0,0,0,0,2,5,1,0
75703,28,617,173,84,99,8,29,36,181,5,12,7,13,17,20,54,81,2,221,12,0,2,5,1,0
75704,28,617,3,1,1,3,0,0,6,0,0,0,0,0,0,0,0,0,0,0,0,2,5,1,0
75705,54,672,647,139,84,35,284,233,682,0,0,0,0,0,0,0,0,0,0,0,0,2,9,1,0
75706,117,2982,773,422,505,30,103,129,803,14,77,46,83,91,129,535,839,7,6334,351,0,2,2,1,0
75707,137,3440,77,34,69,0,0,8,77,3,24,16,29,27,45,114,213,1,387,21,0,2,4,1,0
75708,137,3440,712,438,573,51,9,84,763,14,102,71,128,116,199,733,1364,8,11988,666,0,2,4,1,0
75709,301,6452,1943,715,1694,26,18,214,1969,12,185,120,237,197,357,1436,2721,7,20915,1161,0,2,1,1,0
75710,301,6452,1168,838,957,57,25,144,1225,19,348,224,416,367,640,3018,5452,11,61921,3440,1,2,1,1,0
75711,23,646,601,196,481,2,23,85,603,8,63,36,72,71,108,400,664,4,3036,168,0,2,3,1,0
75712,23,646,156,79,106,5,16,28,161,5,14,8,15,19,23,64,97,2,261,14,0,2,3,1,0
75744,294,6572,72,33,56,0,4,12,72,1,1,1,1,2,2,0,2,0,1,0,0,2,15,12,0
75745,294,6572,1454,835,1044,76,110,219,1530,17,275,158,296,292,454,2297,3718,9,34017,1889,1,2,15,12,0
75748,53,1539,207,111,150,11,0,50,218,5,26,19,36,31,55,133,272,3,943,52,0,2,5,5,0
75749,53,1539,410,198,237,31,55,97,441,11,63,38,72,74,110,414,683,6,4293,238,0,2,5,5,0
75756,7,464,382,65,130,157,2,92,539,4,10,5,10,14,15,41,57,2,114,6,0,2,1,1,0
75757,294,6565,72,33,56,0,4,12,72,1,1,1,1,2,2,0,2,0,1,0,0,2,1,1,0
75758,294,6565,1454,835,1044,76,110,219,1530,17,275,158,296,292,454,2297,3718,9,34017,1889,1,2,1,1,0
75759,124,3469,77,34,69,0,0,8,77,3,24,16,29,27,45,114,213,1,387,21,0,2,12,7,0
75760,124,3469,712,438,573,51,9,84,763,14,102,71,128,116,199,733,1364,8,11988,666,0,2,12,7,0
75761,124,3511,77,34,69,0,0,8,77,3,24,16,29,27,45,114,213,1,387,21,0,2,8,3,0
75762,124,3511,712,438,573,51,9,84,763,14,102,71,128,116,199,733,1364,8,11988,666,0,2,8,3,0
75763,5,319,77,34,69,0,0,8,77,3,24,16,29,27,45,114,213,1,387,21,0,2,25,0,0
75764,3,97,35,12,22,4,5,6,39,1,2,1,2,3,3,2,4,0,2,0,0,2,6,0,0
75765,63,2130,773,419,590,28,0,166,801,10,204,113,217,214,330,1598,2554,5,13587,754,0,2,8,0,1
75766,63,2130,421,273,302,44,34,57,465,17,81,59,107,98,166,583,1098,11,12329,684,0,2,8,0,1
75767,52,1508,207,111,150,11,0,50,218,5,26,19,36,31,55,133,272,3,943,52,0,2,4,8,1
75768,52,1508,410,198,237,31,55,97,441,11,63,38,72,74,110,414,683,6,4293,238,0,2,4,8,1
75769,262,6282,4293,999,3693,19,54,507,4312,9,155,88,170,164,258,1156,1898,4,9368,520,0,2,1,1,1
75770,262,6282,1482,859,1002,125,135,219,1607,16,219,134,251,235,385,1766,3032,9,27804,1544,1,2,1,1,1
75771,69,1502,402,202,227,24,74,80,426,12,52,33,61,64,94,339,564,7,3969,220,0,2,1,1,1
75772,65,2178,53,23,39,0,0,13,53,2,8,4,8,10,12,26,39,1,39,2,0,2,1,1,1
75773,65,2178,515,298,307,33,80,99,548,12,63,44,77,75,121,419,753,7,5527,307,0,2,1,1,1
75774,294,6567,72,33,56,0,4,12,72,1,1,1,1,2,2,0,2,0,1,0,0,2,1,1,1
75775,294,6567,1454,835,1044,76,110,219,1530,17,275,158,296,292,454,2297,3718,9,34017,1889,1,2,1,1,1
75776,187,5537,182,127,129,0,0,53,182,5,39,21,42,44,63,217,343,2,926,51,0,2,2,0,0
75777,187,5537,1165,710,800,67,119,181,1232,18,243,153,282,261,435,2000,3492,10,36473,2026,1,2,2,0,0
75778,103,3235,773,419,590,28,0,166,801,10,204,113,217,214,330,1598,2554,5,13587,754,0,2,8,0,0
75779,63,2124,773,419,590,28,0,166,801,10,204,113,217,214,330,1598,2554,5,13587,754,0,2,5,6,0
75780,63,2124,421,273,302,44,34,57,465,17,81,59,107,98,166,583,1098,11,12329,684,0,2,5,6,0
75781,52,1512,207,111,150,11,0,50,218,5,26,19,36,31,55,133,272,3,943,52,0,2,2,2,0
75782,52,1512,410,198,237,31,55,97,441,11,63,38,72,74,110,414,683,6,4293,238,0,2,2,2,0
75783,51,1472,207,111,150,11,0,50,218,5,26,19,36,31,55,133,272,3,943,52,0,2,0,7,0
75784,51,1472,410,198,237,31,55,97,441,11,63,38,72,74,110,414,683,6,4293,238,0,2,0,7,0
75787,27,637,2,2,2,0,0,0,2,0,0,0,0,0,0,0,0,0,0,0,0,2,6,4,0
75801,27,637,99,48,90,1,3,5,100,0,0,0,0,0,0,0,0,0,0,0,0,2,6,4,0
75802,27,637,8,5,5,2,0,1,10,0,0,0,0,0,0,0,0,0,0,0,0,2,6,4,0
75803,27,637,1217,716,841,84,126,174,1301,14,185,118,215,199,333,1446,2542,8,20687,1149,0,2,6,4,0
75804,27,637,160,89,115,0,13,31,160,7,15,11,17,22,28,78,124,3,495,27,0,2,6,4,0
75805,27,637,10,10,9,9,0,0,19,0,0,0,0,0,0,0,0,0,0,0,0,2,6,4,0
75806,27,637,173,84,99,8,29,36,181,5,12,7,13,17,20,54,81,2,221,12,0,2,6,4,0
75807,27,637,3,1,1,3,0,0,6,0,0,0,0,0,0,0,0,0,0,0,0,2,6,4,0
75810,244,5161,2,2,2,0,0,0,2,0,0,0,0,0,0,0,0,0,0,0,0,2,4,1,0
75824,244,5161,99,48,90,1,3,5,100,0,0,0,0,0,0,0,0,0,0,0,0,2,4,1,0
75825,244,5161,8,5,5,2,0,1,10,0,0,0,0,0,0,0,0,0,0,0,0,2,4,1,0
75826,244,5161,1217,716,841,84,126,174,1301,14,185,118,215,199,333,1446,2542,8,20687,1149,0,2,4,1,0
75827,244,5161,160,89,115,0,13,31,160,7,15,11,17,22,28,78,124,3,495,27,0,2,4,1,0
75828,244,5161,10,10,9,9,0,0,19,0,0,0,0,0,0,0,0,0,0,0,0,2,4,1,0
75829,244,5161,173,84,99,8,29,36,181,5,12,7,13,17,20,54,81,2,221,12,0,2,4,1,0
75830,244,5161,3,1,1,3,0,0,6,0,0,0,0,0,0,0,0,0,0,0,0,2,4,1,0
75831,127,5438,1450,624,1228,12,26,181,1462,14,306,186,354,320,540,2580,4493,8,36391,2021,1,2,13,4,0
75832,106,4668,1289,550,1043,56,32,155,1345,10,167,93,185,177,278,1266,2075,5,11498,638,0,2,2,0,0
75833,18,430,127,75,83,2,11,30,129,4,14,7,14,18,21,61,87,2,175,9,0,2,7,0,0
75834,18,430,652,304,544,16,6,88,668,6,89,51,101,95,152,591,998,3,3399,188,0,2,7,0,0
75835,18,430,2,2,2,0,0,0,2,0,0,0,0,0,0,0,0,0,0,0,0,2,7,0,0
75836,18,430,8,5,5,0,0,3,8,0,0,0,0,0,0,0,0,0,0,0,0,2,7,0,0
75839,18,430,14,8,8,0,0,6,14,0,0,0,0,0,0,0,0,0,0,0,0,2,7,0,0
75840,18,430,6,4,4,0,0,2,6,0,0,0,0,0,0,0,0,0,0,0,0,2,7,0,0
75841,18,430,6,4,4,0,0,2,6,1,2,1,2,3,3,2,4,0,2,0,0,2,7,0,0
75843,18,430,7,5,5,0,0,2,7,0,0,0,0,0,0,0,0,0,0,0,0,2,7,0,0
75845,18,430,10,6,6,0,0,4,10,0,0,0,0,0,0,0,0,0,0,0,0,2,7,0,0
75846,18,430,1,1,1,0,0,0,1,0,0,0,0,0,0,0,0,0,0,0,0,2,7,0,0
75848,18,430,14,10,10,0,0,4,14,1,1,1,1,2,2,0,2,0,1,0,0,2,7,0,0
75849,18,430,46,26,30,3,0,12,49,3,6,3,6,9,9,20,28,1,42,2,0,2,7,0,0
75851,114,5840,1523,757,1297,19,12,193,1542,12,193,117,230,205,347,1508,2664,7,19053,1058,0,2,1,0,0
75852,120,7110,1943,715,1694,26,18,214,1969,12,185,120,237,197,357,1436,2721,7,20915,1161,0,2,2,0,0
75856,63,2124,773,419,590,28,0,166,801,10,204,113,217,214,330,1598,2554,5,13587,754,0,2,13,6,0
75857,63,2124,421,273,302,44,34,57,465,17,81,59,107,98,166,583,1098,11,12329,684,0,2,13,6,0
75858,51,1472,207,111,150,11,0,50,218,5,26,19,36,31,55,133,272,3,943,52,0,2,0,11,0
75859,51,1472,410,198,237,31,55,97,441,11,63,38,72,74,110,414,683,6,4293,238,0,2,0,11,0
75860,262,6282,4293,999,3693,19,54,507,4312,9,155,88,170,164,258,1156,1898,4,9368,520,0,2,1,1,0
75861,262,6282,1482,859,1002,125,135,219,1607,16,219,134,251,235,385,1766,3032,9,27804,1544,1,2,1,1,0
75862,69,1502,402,202,227,24,74,80,426,12,52,33,61,64,94,339,564,7,3969,220,0,2,1,1,0
75863,65,2178,53,23,39,0,0,13,53,2,8,4,8,10,12,26,39,1,39,2,0,2,1,1,0
75864,65,2178,515,298,307,33,80,99,548,12,63,44,77,75,121,419,753,7,5527,307,0,2,1,1,0
75865,294,6567,72,33,56,0,4,12,72,1,1,1,1,2,2,0,2,0,1,0,0,2,1,1,0
75866,294,6567,1454,835,1044,76,110,219,1530,17,275,158,296,292,454,2297,3718,9,34017,1889,1,2,1,1,0
75868,225,6476,722,423,573,19,0,135,741,12,172,101,199,184,300,1320,2257,6,15668,870,0,2,4,4,0
75869,225,6476,1508,847,911,44,250,301,1552,14,148,88,169,162,257,1120,1886,7,15077,837,0,2,4,4,0
75870,119,3209,1523,757,1297,19,12,193,1542,12,193,117,230,205,347,1508,2664,7,19053,1058,0,2,1,1,0
75871,119,3209,701,378,504,33,58,109,734,13,110,68,126,123,194,794,1346,7,10027,557,0,2,1,1,0
75872,124,3511,77,34,69,0,0,8,77,3,24,16,29,27,45,114,213,1,387,21,0,2,20,10,0
75873,124,3511,712,438,573,51,9,84,763,14,102,71,128,116,199,733,1364,8,11988,666,0,2,20,10,0
